"from","to","user_id","weight","dis","sl","seq_min","ordF","ordT","disRevised"
"b613861cecf84ffcab01afb23f660475","b613861cecf84ffcab01afb23f660475",15603897,3,0,1,1,1,1,0
"b613861cecf84ffcab01afb23f660475","e2911e79efc2420eac45d9f671463d4b",15603897,2,3,0,4,1,2,1
"e2911e79efc2420eac45d9f671463d4b","b613861cecf84ffcab01afb23f660475",15603897,1,-3,0,5,2,1,-1
"e2911e79efc2420eac45d9f671463d4b","e2911e79efc2420eac45d9f671463d4b",15603897,1,0,1,7,2,2,0
"e2911e79efc2420eac45d9f671463d4b","519d1b8c59404d67b54e96c5c8a830b2",15603897,1,1,0,8,2,3,1
"519d1b8c59404d67b54e96c5c8a830b2","519d1b8c59404d67b54e96c5c8a830b2",15603897,1,0,1,9,3,3,0
"519d1b8c59404d67b54e96c5c8a830b2","531db53f81f646edb0cdcfe0085b03b7",15603897,1,1,0,10,3,4,1
"531db53f81f646edb0cdcfe0085b03b7","531db53f81f646edb0cdcfe0085b03b7",15603897,1,0,1,11,4,4,0
"531db53f81f646edb0cdcfe0085b03b7","4f5f94b2f95141e0a9d53a61da2276da",15603897,1,1,0,12,4,5,1
"4f5f94b2f95141e0a9d53a61da2276da","4f5f94b2f95141e0a9d53a61da2276da",15603897,1,0,1,13,5,5,0
"4f5f94b2f95141e0a9d53a61da2276da","6d541c89590949f99af293c4f2333f67",15603897,1,1,0,14,5,6,1
"6d541c89590949f99af293c4f2333f67","6d541c89590949f99af293c4f2333f67",15603897,1,0,1,15,6,6,0
"6d541c89590949f99af293c4f2333f67","dd5cf0b9fe4c4f1d8f5ff8e4c04879cb",15603897,1,1,0,16,6,7,1
"dd5cf0b9fe4c4f1d8f5ff8e4c04879cb","dd5cf0b9fe4c4f1d8f5ff8e4c04879cb",15603897,2,0,1,17,7,7,0
"dd5cf0b9fe4c4f1d8f5ff8e4c04879cb","f96261861edc426abe2248be4f0a709a",15603897,2,1,0,18,7,8,1
"f96261861edc426abe2248be4f0a709a","f96261861edc426abe2248be4f0a709a",15603897,2,0,1,19,8,8,0
"f96261861edc426abe2248be4f0a709a","66b5e16f4f75454fb5b8172079f0fa83",15603897,2,1,0,20,8,9,1
"66b5e16f4f75454fb5b8172079f0fa83","66b5e16f4f75454fb5b8172079f0fa83",15603897,3,0,1,21,9,9,0
"66b5e16f4f75454fb5b8172079f0fa83","0680571d4698477995e41842c36a54b2",15603897,2,1,0,23,9,10,1
"0680571d4698477995e41842c36a54b2","0680571d4698477995e41842c36a54b2",15603897,2,0,1,24,10,10,0
"0680571d4698477995e41842c36a54b2","9112f2bffece48e08c6d2287be204085",15603897,2,1,0,25,10,11,1
"9112f2bffece48e08c6d2287be204085","9112f2bffece48e08c6d2287be204085",15603897,2,0,1,26,11,11,0
"9112f2bffece48e08c6d2287be204085","e2911e79efc2420eac45d9f671463d4b",15603897,2,-9,0,27,11,2,-9
"e2911e79efc2420eac45d9f671463d4b","56586aa865414f538729c7f7735d2bc6",15603897,2,12,0,28,2,12,10
"56586aa865414f538729c7f7735d2bc6","56586aa865414f538729c7f7735d2bc6",15603897,2,0,1,29,12,12,0
"56586aa865414f538729c7f7735d2bc6","e2911e79efc2420eac45d9f671463d4b",15603897,1,-12,0,30,12,2,-10
"e2911e79efc2420eac45d9f671463d4b","dd5cf0b9fe4c4f1d8f5ff8e4c04879cb",15603897,1,5,0,31,2,7,5
"56586aa865414f538729c7f7735d2bc6","b7f2b31585d94eb3bf86376714aa7070",15603897,2,2,0,44,12,13,1
"b7f2b31585d94eb3bf86376714aa7070","56586aa865414f538729c7f7735d2bc6",15603897,1,-2,0,45,13,12,-1
"b7f2b31585d94eb3bf86376714aa7070","3f1c815879794b929260d224becaff7e",15603897,1,2,0,47,13,14,1
"3f1c815879794b929260d224becaff7e","56586aa865414f538729c7f7735d2bc6",15603897,1,-4,0,48,14,12,-2
"56586aa865414f538729c7f7735d2bc6","5c5ceeee4562457ba6d41515aeebfbb1",15603897,2,10,0,49,12,17,5
"5c5ceeee4562457ba6d41515aeebfbb1","56586aa865414f538729c7f7735d2bc6",15603897,1,-10,0,50,17,12,-5
"5c5ceeee4562457ba6d41515aeebfbb1","9afd71a5298d4333b6849dfce1b9422c",15603897,1,3,0,52,17,18,1
"9afd71a5298d4333b6849dfce1b9422c","56586aa865414f538729c7f7735d2bc6",15603897,1,-13,0,53,18,12,-6
"56586aa865414f538729c7f7735d2bc6","9afd71a5298d4333b6849dfce1b9422c",15603897,1,13,0,54,12,18,6
"9afd71a5298d4333b6849dfce1b9422c","b7719e26494940efa49512aedd0aac79",15603897,1,4,0,55,18,20,2
"b7719e26494940efa49512aedd0aac79","d4c3b003e8274e429d2fa688d73fde6d",15603897,1,3,0,56,20,22,2
"d4c3b003e8274e429d2fa688d73fde6d","d4f45188d3c84a02ba08454e6403a818",15603897,1,2,0,57,22,24,2
"d4f45188d3c84a02ba08454e6403a818","b7719e26494940efa49512aedd0aac79",15603897,1,-5,0,58,24,20,-4
"b7719e26494940efa49512aedd0aac79","b7719e26494940efa49512aedd0aac79",15603897,1,0,1,59,20,20,0
"b7719e26494940efa49512aedd0aac79","afbf7250b99d47bea07172749483ca97",15603897,1,12,0,60,20,28,8
"afbf7250b99d47bea07172749483ca97","4e51676dc72045d99c19b9fa7b22f8bc",15603897,2,3,0,61,28,29,1
"4e51676dc72045d99c19b9fa7b22f8bc","afbf7250b99d47bea07172749483ca97",15603897,1,-3,0,62,29,28,-1
"4e51676dc72045d99c19b9fa7b22f8bc","c33c17be71ae4d588da7369472e5bb1b",15603897,1,9,0,64,29,34,5
"c33c17be71ae4d588da7369472e5bb1b","51970cfa30e643e894e66ae85c8024cc",15603897,1,-6,0,65,34,31,-3
"51970cfa30e643e894e66ae85c8024cc","4e51676dc72045d99c19b9fa7b22f8bc",15603897,1,-3,0,66,31,29,-2
"4e51676dc72045d99c19b9fa7b22f8bc","93679be414554a11b1893002f2229a93",15603897,1,12,0,67,29,35,6
"93679be414554a11b1893002f2229a93","c33c17be71ae4d588da7369472e5bb1b",15603897,1,-3,0,68,35,34,-1
"c33c17be71ae4d588da7369472e5bb1b","93679be414554a11b1893002f2229a93",15603897,1,3,0,69,34,35,1
"93679be414554a11b1893002f2229a93","7040a13096d746ac84b8fac8d9752058",15603897,1,3,0,70,35,36,1
"7040a13096d746ac84b8fac8d9752058","7040a13096d746ac84b8fac8d9752058",15603897,1,0,1,71,36,36,0
"7040a13096d746ac84b8fac8d9752058","9a0dc646f934470daf08c4b56ccf73db",15603897,1,3,0,72,36,37,1
"9a0dc646f934470daf08c4b56ccf73db","9a0dc646f934470daf08c4b56ccf73db",15603897,1,0,1,73,37,37,0
"9a0dc646f934470daf08c4b56ccf73db","fc0e049d56024bc9a02c9a9c435c3df7",15603897,1,3,0,74,37,38,1
"fc0e049d56024bc9a02c9a9c435c3df7","67a089198fcb4e1c8f2385786c2b296f",15603897,1,4,0,75,38,39,1
"67a089198fcb4e1c8f2385786c2b296f","fc0e049d56024bc9a02c9a9c435c3df7",15603897,1,-4,0,76,39,38,-1
"fc0e049d56024bc9a02c9a9c435c3df7","64d48c6c9c7940639a932219a6c87198",15603897,1,5,0,77,38,40,2
"64d48c6c9c7940639a932219a6c87198","67a089198fcb4e1c8f2385786c2b296f",15603897,1,-1,0,78,40,39,-1
"67a089198fcb4e1c8f2385786c2b296f","b534b89233134e30a9b5645138bfa9ee",15603897,1,4,0,79,39,41,2
"b534b89233134e30a9b5645138bfa9ee","0e37b720d23b4e7f8b313e79313fd107",15603897,1,3,0,80,41,44,3
"0e37b720d23b4e7f8b313e79313fd107","0e37b720d23b4e7f8b313e79313fd107",15603897,4,0,1,81,44,44,0
"0e37b720d23b4e7f8b313e79313fd107","6875d67fdd5f48168b62719df449bebd",15603897,2,1,0,82,44,45,1
"6875d67fdd5f48168b62719df449bebd","6875d67fdd5f48168b62719df449bebd",15603897,2,0,1,83,45,45,0
"6875d67fdd5f48168b62719df449bebd","b534b89233134e30a9b5645138bfa9ee",15603897,2,-4,0,84,45,41,-4
"b534b89233134e30a9b5645138bfa9ee","6e13d61a7bdb44bca949c9f86fab3be5",15603897,2,7,0,85,41,47,6
"6e13d61a7bdb44bca949c9f86fab3be5","195f78799f984cc2b06c48dfe36be751",15603897,1,2,0,86,47,49,2
"195f78799f984cc2b06c48dfe36be751","195f78799f984cc2b06c48dfe36be751",15603897,2,0,1,87,49,49,0
"195f78799f984cc2b06c48dfe36be751","d9c8d8c444a64dadbbb508652c721e17",15603897,1,-3,0,89,49,46,-3
"d9c8d8c444a64dadbbb508652c721e17","0e37b720d23b4e7f8b313e79313fd107",15603897,1,-3,0,90,46,44,-2
"6e13d61a7bdb44bca949c9f86fab3be5","d0c74f735e024943943e40333d6d337f",15603897,1,5,0,98,47,51,4
"d0c74f735e024943943e40333d6d337f","d9c8d8c444a64dadbbb508652c721e17",15603897,1,-6,0,99,51,46,-5
"d9c8d8c444a64dadbbb508652c721e17","983f8ff320594b279a7f4a6fe132f9c5",15603897,1,8,0,100,46,53,7
"983f8ff320594b279a7f4a6fe132f9c5","983f8ff320594b279a7f4a6fe132f9c5",15603897,9,0,1,101,53,53,0
"983f8ff320594b279a7f4a6fe132f9c5","35adfa5d923046aebabfefd98f35ff05",15603897,1,1,0,110,53,54,1
"35adfa5d923046aebabfefd98f35ff05","35adfa5d923046aebabfefd98f35ff05",15603897,5,0,1,111,54,54,0
"35adfa5d923046aebabfefd98f35ff05","b6f8a98476224da1b40e555ececc7ed8",15603897,1,1,0,116,54,55,1
"b6f8a98476224da1b40e555ececc7ed8","b6f8a98476224da1b40e555ececc7ed8",15603897,2,0,1,117,55,55,0
"b6f8a98476224da1b40e555ececc7ed8","86e22cb5fe0e4b47a9489ecddf7ed78f",15603897,1,1,0,119,55,56,1
"86e22cb5fe0e4b47a9489ecddf7ed78f","86e22cb5fe0e4b47a9489ecddf7ed78f",15603897,2,0,1,120,56,56,0
"86e22cb5fe0e4b47a9489ecddf7ed78f","f924752d8a1149668870b1e7698486f7",15603897,1,-6,0,122,56,50,-6
"f924752d8a1149668870b1e7698486f7","78f30e4dcac84e3cbea8b2cc6e0d62b3",15603897,1,10,0,123,50,59,9
"78f30e4dcac84e3cbea8b2cc6e0d62b3","a1f2f12debe5432fb7a70bcd12bacfb9",15603897,1,-1,0,124,59,58,-1
"a1f2f12debe5432fb7a70bcd12bacfb9","b534b89233134e30a9b5645138bfa9ee",15603897,1,-20,0,125,58,41,-17
"b534b89233134e30a9b5645138bfa9ee","a1f2f12debe5432fb7a70bcd12bacfb9",15603897,1,20,0,126,41,58,17
"a1f2f12debe5432fb7a70bcd12bacfb9","78f30e4dcac84e3cbea8b2cc6e0d62b3",15603897,1,1,0,127,58,59,1
"78f30e4dcac84e3cbea8b2cc6e0d62b3","a0a418b8540d479fa6e0f653b701da8b",15603897,1,6,0,128,59,64,5
"a0a418b8540d479fa6e0f653b701da8b","12aa6e1672ac4e7aa6449a7a8609cd72",15603897,1,-8,0,129,64,57,-7
"12aa6e1672ac4e7aa6449a7a8609cd72","bc42d26810654ea9a1df1efe1e58c7d5",15603897,1,7,0,130,57,63,6
"bc42d26810654ea9a1df1efe1e58c7d5","4c943503763e4e349906eea3ed3c8e86",15603897,1,-2,0,131,63,61,-2
"4c943503763e4e349906eea3ed3c8e86","4c943503763e4e349906eea3ed3c8e86",15603897,1,0,1,132,61,61,0
"67a089198fcb4e1c8f2385786c2b296f","b613861cecf84ffcab01afb23f660475",20757153,1,-72,0,1,39,1,-38
"b613861cecf84ffcab01afb23f660475","b613861cecf84ffcab01afb23f660475",20757153,4,0,1,2,1,1,0
"b613861cecf84ffcab01afb23f660475","e2911e79efc2420eac45d9f671463d4b",20757153,1,3,0,6,1,2,1
"e2911e79efc2420eac45d9f671463d4b","e2911e79efc2420eac45d9f671463d4b",20757153,2,0,1,7,2,2,0
"e2911e79efc2420eac45d9f671463d4b","519d1b8c59404d67b54e96c5c8a830b2",20757153,1,1,0,9,2,3,1
"519d1b8c59404d67b54e96c5c8a830b2","519d1b8c59404d67b54e96c5c8a830b2",20757153,1,0,1,10,3,3,0
"519d1b8c59404d67b54e96c5c8a830b2","531db53f81f646edb0cdcfe0085b03b7",20757153,1,1,0,11,3,4,1
"531db53f81f646edb0cdcfe0085b03b7","531db53f81f646edb0cdcfe0085b03b7",20757153,1,0,1,12,4,4,0
"531db53f81f646edb0cdcfe0085b03b7","4f5f94b2f95141e0a9d53a61da2276da",20757153,1,1,0,13,4,5,1
"4f5f94b2f95141e0a9d53a61da2276da","4f5f94b2f95141e0a9d53a61da2276da",20757153,1,0,1,14,5,5,0
"4f5f94b2f95141e0a9d53a61da2276da","6d541c89590949f99af293c4f2333f67",20757153,1,1,0,15,5,6,1
"6d541c89590949f99af293c4f2333f67","6d541c89590949f99af293c4f2333f67",20757153,1,0,1,16,6,6,0
"6d541c89590949f99af293c4f2333f67","dd5cf0b9fe4c4f1d8f5ff8e4c04879cb",20757153,1,1,0,17,6,7,1
"dd5cf0b9fe4c4f1d8f5ff8e4c04879cb","dd5cf0b9fe4c4f1d8f5ff8e4c04879cb",20757153,1,0,1,18,7,7,0
"dd5cf0b9fe4c4f1d8f5ff8e4c04879cb","f96261861edc426abe2248be4f0a709a",20757153,1,1,0,19,7,8,1
"f96261861edc426abe2248be4f0a709a","f96261861edc426abe2248be4f0a709a",20757153,1,0,1,20,8,8,0
"f96261861edc426abe2248be4f0a709a","66b5e16f4f75454fb5b8172079f0fa83",20757153,1,1,0,21,8,9,1
"66b5e16f4f75454fb5b8172079f0fa83","66b5e16f4f75454fb5b8172079f0fa83",20757153,1,0,1,22,9,9,0
"66b5e16f4f75454fb5b8172079f0fa83","0680571d4698477995e41842c36a54b2",20757153,1,1,0,23,9,10,1
"0680571d4698477995e41842c36a54b2","0680571d4698477995e41842c36a54b2",20757153,1,0,1,24,10,10,0
"0680571d4698477995e41842c36a54b2","9112f2bffece48e08c6d2287be204085",20757153,1,1,0,25,10,11,1
"9112f2bffece48e08c6d2287be204085","9112f2bffece48e08c6d2287be204085",20757153,1,0,1,26,11,11,0
"9112f2bffece48e08c6d2287be204085","e2911e79efc2420eac45d9f671463d4b",20757153,1,-9,0,27,11,2,-9
"e2911e79efc2420eac45d9f671463d4b","56586aa865414f538729c7f7735d2bc6",20757153,2,12,0,28,2,12,10
"56586aa865414f538729c7f7735d2bc6","56586aa865414f538729c7f7735d2bc6",20757153,4,0,1,29,12,12,0
"56586aa865414f538729c7f7735d2bc6","e2911e79efc2420eac45d9f671463d4b",20757153,2,-12,0,31,12,2,-10
"e2911e79efc2420eac45d9f671463d4b","f96261861edc426abe2248be4f0a709a",20757153,1,6,0,32,2,8,6
"f96261861edc426abe2248be4f0a709a","9112f2bffece48e08c6d2287be204085",20757153,1,3,0,33,8,11,3
"9112f2bffece48e08c6d2287be204085","0680571d4698477995e41842c36a54b2",20757153,1,-1,0,34,11,10,-1
"0680571d4698477995e41842c36a54b2","dd5cf0b9fe4c4f1d8f5ff8e4c04879cb",20757153,1,-3,0,35,10,7,-3
"dd5cf0b9fe4c4f1d8f5ff8e4c04879cb","4f5f94b2f95141e0a9d53a61da2276da",20757153,1,-2,0,36,7,5,-2
"4f5f94b2f95141e0a9d53a61da2276da","56586aa865414f538729c7f7735d2bc6",20757153,1,9,0,37,5,12,7
"56586aa865414f538729c7f7735d2bc6","b7f2b31585d94eb3bf86376714aa7070",20757153,2,2,0,42,12,13,1
"b7f2b31585d94eb3bf86376714aa7070","b7f2b31585d94eb3bf86376714aa7070",20757153,4,0,1,43,13,13,0
"b7f2b31585d94eb3bf86376714aa7070","3f1c815879794b929260d224becaff7e",20757153,2,2,0,45,13,14,1
"3f1c815879794b929260d224becaff7e","81c864a886d54a6b8ff85f7d736f4f95",20757153,1,2,0,46,14,15,1
"81c864a886d54a6b8ff85f7d736f4f95","5c5ceeee4562457ba6d41515aeebfbb1",20757153,1,4,0,47,15,17,2
"5c5ceeee4562457ba6d41515aeebfbb1","5c5ceeee4562457ba6d41515aeebfbb1",20757153,6,0,1,48,17,17,0
"5c5ceeee4562457ba6d41515aeebfbb1","9afd71a5298d4333b6849dfce1b9422c",20757153,1,3,0,53,17,18,1
"9afd71a5298d4333b6849dfce1b9422c","56586aa865414f538729c7f7735d2bc6",20757153,1,-13,0,54,18,12,-6
"56586aa865414f538729c7f7735d2bc6","9afd71a5298d4333b6849dfce1b9422c",20757153,1,13,0,55,12,18,6
"9afd71a5298d4333b6849dfce1b9422c","b7719e26494940efa49512aedd0aac79",20757153,1,4,0,56,18,20,2
"b7719e26494940efa49512aedd0aac79","d4f45188d3c84a02ba08454e6403a818",20757153,3,5,0,57,20,24,4
"d4f45188d3c84a02ba08454e6403a818","d4c3b003e8274e429d2fa688d73fde6d",20757153,3,-2,0,58,24,22,-2
"d4c3b003e8274e429d2fa688d73fde6d","b7719e26494940efa49512aedd0aac79",20757153,3,-3,0,59,22,20,-2
"d4c3b003e8274e429d2fa688d73fde6d","d4c3b003e8274e429d2fa688d73fde6d",20757153,2,0,1,65,22,22,0
"d4c3b003e8274e429d2fa688d73fde6d","5bc03c8f16354d04bd51f5bb93559ad3",20757153,1,4,0,66,22,26,4
"5bc03c8f16354d04bd51f5bb93559ad3","d4c3b003e8274e429d2fa688d73fde6d",20757153,1,-4,0,67,26,22,-4
"b7719e26494940efa49512aedd0aac79","b7719e26494940efa49512aedd0aac79",20757153,1,0,1,70,20,20,0
"b7719e26494940efa49512aedd0aac79","afbf7250b99d47bea07172749483ca97",20757153,1,12,0,71,20,28,8
"afbf7250b99d47bea07172749483ca97","4e51676dc72045d99c19b9fa7b22f8bc",20757153,2,3,0,72,28,29,1
"4e51676dc72045d99c19b9fa7b22f8bc","afbf7250b99d47bea07172749483ca97",20757153,1,-3,0,73,29,28,-1
"4e51676dc72045d99c19b9fa7b22f8bc","51970cfa30e643e894e66ae85c8024cc",20757153,1,3,0,75,29,31,2
"51970cfa30e643e894e66ae85c8024cc","4e51676dc72045d99c19b9fa7b22f8bc",20757153,1,-3,0,76,31,29,-2
"4e51676dc72045d99c19b9fa7b22f8bc","c33c17be71ae4d588da7369472e5bb1b",20757153,1,9,0,77,29,34,5
"c33c17be71ae4d588da7369472e5bb1b","c33c17be71ae4d588da7369472e5bb1b",20757153,1,0,1,78,34,34,0
"c33c17be71ae4d588da7369472e5bb1b","93679be414554a11b1893002f2229a93",20757153,1,3,0,79,34,35,1
"93679be414554a11b1893002f2229a93","93679be414554a11b1893002f2229a93",20757153,1,0,1,80,35,35,0
"93679be414554a11b1893002f2229a93","7040a13096d746ac84b8fac8d9752058",20757153,1,3,0,81,35,36,1
"7040a13096d746ac84b8fac8d9752058","7040a13096d746ac84b8fac8d9752058",20757153,1,0,1,82,36,36,0
"7040a13096d746ac84b8fac8d9752058","9a0dc646f934470daf08c4b56ccf73db",20757153,1,3,0,83,36,37,1
"9a0dc646f934470daf08c4b56ccf73db","fc0e049d56024bc9a02c9a9c435c3df7",20757153,1,3,0,84,37,38,1
"fc0e049d56024bc9a02c9a9c435c3df7","9a0dc646f934470daf08c4b56ccf73db",20757153,1,-3,0,85,38,37,-1
"9a0dc646f934470daf08c4b56ccf73db","67a089198fcb4e1c8f2385786c2b296f",20757153,1,7,0,86,37,39,2
"67a089198fcb4e1c8f2385786c2b296f","fc0e049d56024bc9a02c9a9c435c3df7",20757153,1,-4,0,87,39,38,-1
"fc0e049d56024bc9a02c9a9c435c3df7","64d48c6c9c7940639a932219a6c87198",20757153,1,5,0,88,38,40,2
"64d48c6c9c7940639a932219a6c87198","b7f2b31585d94eb3bf86376714aa7070",20757153,1,-56,0,89,40,13,-27
"b7f2b31585d94eb3bf86376714aa7070","56586aa865414f538729c7f7735d2bc6",20757153,1,-2,0,90,13,12,-1
"3f1c815879794b929260d224becaff7e","5c5ceeee4562457ba6d41515aeebfbb1",20757153,1,6,0,95,14,17,3
"b613861cecf84ffcab01afb23f660475","b613861cecf84ffcab01afb23f660475",22136774,1,0,1,1,1,1,0
"b613861cecf84ffcab01afb23f660475","e2911e79efc2420eac45d9f671463d4b",22136774,1,3,0,2,1,2,1
"e2911e79efc2420eac45d9f671463d4b","519d1b8c59404d67b54e96c5c8a830b2",22136774,2,1,0,3,2,3,1
"519d1b8c59404d67b54e96c5c8a830b2","e2911e79efc2420eac45d9f671463d4b",22136774,1,-1,0,4,3,2,-1
"519d1b8c59404d67b54e96c5c8a830b2","531db53f81f646edb0cdcfe0085b03b7",22136774,1,1,0,6,3,4,1
"531db53f81f646edb0cdcfe0085b03b7","4f5f94b2f95141e0a9d53a61da2276da",22136774,1,1,0,7,4,5,1
"4f5f94b2f95141e0a9d53a61da2276da","531db53f81f646edb0cdcfe0085b03b7",22136774,1,-1,0,8,5,4,-1
"531db53f81f646edb0cdcfe0085b03b7","6d541c89590949f99af293c4f2333f67",22136774,1,2,0,9,4,6,2
"6d541c89590949f99af293c4f2333f67","4f5f94b2f95141e0a9d53a61da2276da",22136774,1,-1,0,10,6,5,-1
"4f5f94b2f95141e0a9d53a61da2276da","6d541c89590949f99af293c4f2333f67",22136774,1,1,0,11,5,6,1
"6d541c89590949f99af293c4f2333f67","dd5cf0b9fe4c4f1d8f5ff8e4c04879cb",22136774,1,1,0,12,6,7,1
"dd5cf0b9fe4c4f1d8f5ff8e4c04879cb","f96261861edc426abe2248be4f0a709a",22136774,2,1,0,13,7,8,1
"f96261861edc426abe2248be4f0a709a","66b5e16f4f75454fb5b8172079f0fa83",22136774,1,1,0,14,8,9,1
"66b5e16f4f75454fb5b8172079f0fa83","0680571d4698477995e41842c36a54b2",22136774,2,1,0,15,9,10,1
"0680571d4698477995e41842c36a54b2","dd5cf0b9fe4c4f1d8f5ff8e4c04879cb",22136774,1,-3,0,16,10,7,-3
"f96261861edc426abe2248be4f0a709a","9112f2bffece48e08c6d2287be204085",22136774,1,3,0,18,8,11,3
"9112f2bffece48e08c6d2287be204085","66b5e16f4f75454fb5b8172079f0fa83",22136774,1,-2,0,19,11,9,-2
"0680571d4698477995e41842c36a54b2","9112f2bffece48e08c6d2287be204085",22136774,1,1,0,21,10,11,1
"9112f2bffece48e08c6d2287be204085","5c5ceeee4562457ba6d41515aeebfbb1",22136774,1,13,0,22,11,17,6
"5c5ceeee4562457ba6d41515aeebfbb1","56586aa865414f538729c7f7735d2bc6",22136774,1,-10,0,23,17,12,-5
"56586aa865414f538729c7f7735d2bc6","56586aa865414f538729c7f7735d2bc6",22136774,2,0,1,24,12,12,0
"56586aa865414f538729c7f7735d2bc6","b613861cecf84ffcab01afb23f660475",22136774,1,-15,0,26,12,1,-11
"b613861cecf84ffcab01afb23f660475","67a089198fcb4e1c8f2385786c2b296f",22136774,1,72,0,27,1,39,38
"67a089198fcb4e1c8f2385786c2b296f","67a089198fcb4e1c8f2385786c2b296f",22136774,1,0,1,28,39,39,0
"67a089198fcb4e1c8f2385786c2b296f","64d48c6c9c7940639a932219a6c87198",22136774,1,1,0,29,39,40,1
"64d48c6c9c7940639a932219a6c87198","64d48c6c9c7940639a932219a6c87198",22136774,1,0,1,30,40,40,0
"64d48c6c9c7940639a932219a6c87198","b534b89233134e30a9b5645138bfa9ee",22136774,1,3,0,31,40,41,1
"b534b89233134e30a9b5645138bfa9ee","67a089198fcb4e1c8f2385786c2b296f",22136774,1,-4,0,32,41,39,-2
"67a089198fcb4e1c8f2385786c2b296f","0e37b720d23b4e7f8b313e79313fd107",22136774,1,7,0,33,39,44,5
"0e37b720d23b4e7f8b313e79313fd107","0e37b720d23b4e7f8b313e79313fd107",22136774,3,0,1,34,44,44,0
"0e37b720d23b4e7f8b313e79313fd107","6875d67fdd5f48168b62719df449bebd",22136774,1,1,0,37,44,45,1
"6875d67fdd5f48168b62719df449bebd","6875d67fdd5f48168b62719df449bebd",22136774,1,0,1,38,45,45,0
"6875d67fdd5f48168b62719df449bebd","b534b89233134e30a9b5645138bfa9ee",22136774,1,-4,0,39,45,41,-4
"6e13d61a7bdb44bca949c9f86fab3be5","6e13d61a7bdb44bca949c9f86fab3be5",22136774,2,0,1,41,47,47,0
"6e13d61a7bdb44bca949c9f86fab3be5","d9c8d8c444a64dadbbb508652c721e17",22136774,1,-1,0,42,47,46,-1
"d0c74f735e024943943e40333d6d337f","d0c74f735e024943943e40333d6d337f",22136774,1,0,1,44,51,51,0
"d0c74f735e024943943e40333d6d337f","a1f2f12debe5432fb7a70bcd12bacfb9",22136774,1,8,0,45,51,58,7
"a1f2f12debe5432fb7a70bcd12bacfb9","78f30e4dcac84e3cbea8b2cc6e0d62b3",22136774,1,1,0,46,58,59,1
"78f30e4dcac84e3cbea8b2cc6e0d62b3","f924752d8a1149668870b1e7698486f7",22136774,1,-10,0,47,59,50,-9
"f924752d8a1149668870b1e7698486f7","78f30e4dcac84e3cbea8b2cc6e0d62b3",22136774,1,10,0,48,50,59,9
"78f30e4dcac84e3cbea8b2cc6e0d62b3","78f30e4dcac84e3cbea8b2cc6e0d62b3",22136774,11,0,1,49,59,59,0
"78f30e4dcac84e3cbea8b2cc6e0d62b3","b534b89233134e30a9b5645138bfa9ee",22136774,1,-21,0,60,59,41,-18
"6e13d61a7bdb44bca949c9f86fab3be5","a1f2f12debe5432fb7a70bcd12bacfb9",22136774,1,13,0,63,47,58,11
"a1f2f12debe5432fb7a70bcd12bacfb9","a1f2f12debe5432fb7a70bcd12bacfb9",22136774,16,0,1,64,58,58,0
"a1f2f12debe5432fb7a70bcd12bacfb9","d9c8d8c444a64dadbbb508652c721e17",22136774,1,-14,0,65,58,46,-12
"d9c8d8c444a64dadbbb508652c721e17","a1f2f12debe5432fb7a70bcd12bacfb9",22136774,1,14,0,66,46,58,12
"a1f2f12debe5432fb7a70bcd12bacfb9","12aa6e1672ac4e7aa6449a7a8609cd72",22136774,1,-1,0,82,58,57,-1
"12aa6e1672ac4e7aa6449a7a8609cd72","bc42d26810654ea9a1df1efe1e58c7d5",22136774,1,7,0,83,57,63,6
"bc42d26810654ea9a1df1efe1e58c7d5","a0a418b8540d479fa6e0f653b701da8b",22136774,3,1,0,84,63,64,1
"a0a418b8540d479fa6e0f653b701da8b","bc42d26810654ea9a1df1efe1e58c7d5",22136774,2,-1,0,85,64,63,-1
"bc42d26810654ea9a1df1efe1e58c7d5","bc42d26810654ea9a1df1efe1e58c7d5",22136774,5,0,1,86,63,63,0
"a0a418b8540d479fa6e0f653b701da8b","309ccf3cc4fe429d9bfbaef53d3fa479",22136774,1,-4,0,93,64,60,-4
"309ccf3cc4fe429d9bfbaef53d3fa479","7af822066add4e7f8e007e4eee31a8bf",22136774,1,6,0,94,60,65,5
"7af822066add4e7f8e007e4eee31a8bf","a0a418b8540d479fa6e0f653b701da8b",22136774,1,-2,0,95,65,64,-1
"a0a418b8540d479fa6e0f653b701da8b","a0a418b8540d479fa6e0f653b701da8b",22136774,4,0,1,100,64,64,0
"a0a418b8540d479fa6e0f653b701da8b","4c943503763e4e349906eea3ed3c8e86",22136774,1,-3,0,101,64,61,-3
"4c943503763e4e349906eea3ed3c8e86","4c943503763e4e349906eea3ed3c8e86",22136774,1,0,1,102,61,61,0
"4c943503763e4e349906eea3ed3c8e86","309ccf3cc4fe429d9bfbaef53d3fa479",22136774,1,-1,0,103,61,60,-1
"309ccf3cc4fe429d9bfbaef53d3fa479","b534b89233134e30a9b5645138bfa9ee",22136774,1,-23,0,104,60,41,-19
"b534b89233134e30a9b5645138bfa9ee","d646286c8051419bbc2e31dd1db55ca8",22136774,2,33,0,105,41,67,26
"d646286c8051419bbc2e31dd1db55ca8","267f883678b24aed855fde42524975d9",22136774,1,4,0,106,67,71,4
"267f883678b24aed855fde42524975d9","267f883678b24aed855fde42524975d9",22136774,1,0,1,107,71,71,0
"267f883678b24aed855fde42524975d9","88fff56d0342490dbef9040750a20f6c",22136774,1,1,0,108,71,72,1
"88fff56d0342490dbef9040750a20f6c","88fff56d0342490dbef9040750a20f6c",22136774,1,0,1,109,72,72,0
"88fff56d0342490dbef9040750a20f6c","adb17b12b66c4a49a85fd34322f7df70",22136774,1,1,0,110,72,73,1
"adb17b12b66c4a49a85fd34322f7df70","adb17b12b66c4a49a85fd34322f7df70",22136774,1,0,1,111,73,73,0
"adb17b12b66c4a49a85fd34322f7df70","a2becd407db34b189200a32546d9d569",22136774,1,3,0,112,73,75,2
"a2becd407db34b189200a32546d9d569","d646286c8051419bbc2e31dd1db55ca8",22136774,2,-9,0,113,75,67,-8
"d646286c8051419bbc2e31dd1db55ca8","a2becd407db34b189200a32546d9d569",22136774,2,9,0,114,67,75,8
"a2becd407db34b189200a32546d9d569","140d5b27b8574befad82c0a013b59dfa",22136774,1,-1,0,115,75,74,-1
"140d5b27b8574befad82c0a013b59dfa","a2becd407db34b189200a32546d9d569",22136774,1,1,0,116,74,75,1
"a2becd407db34b189200a32546d9d569","d18a9ea32855445f8736581f5cb119ce",22136774,1,8,0,117,75,82,7
"d18a9ea32855445f8736581f5cb119ce","140d5b27b8574befad82c0a013b59dfa",22136774,1,-9,0,118,82,74,-8
"140d5b27b8574befad82c0a013b59dfa","d646286c8051419bbc2e31dd1db55ca8",22136774,1,-8,0,119,74,67,-7
"d646286c8051419bbc2e31dd1db55ca8","b534b89233134e30a9b5645138bfa9ee",22136774,1,-33,0,120,67,41,-26
"b534b89233134e30a9b5645138bfa9ee","6e13d61a7bdb44bca949c9f86fab3be5",22136774,3,7,0,121,41,47,6
"6e13d61a7bdb44bca949c9f86fab3be5","7af822066add4e7f8e007e4eee31a8bf",22136774,1,22,0,122,47,65,18
"7af822066add4e7f8e007e4eee31a8bf","195f78799f984cc2b06c48dfe36be751",22136774,1,-20,0,123,65,49,-16
"195f78799f984cc2b06c48dfe36be751","195f78799f984cc2b06c48dfe36be751",22136774,2,0,1,124,49,49,0
"195f78799f984cc2b06c48dfe36be751","d9c8d8c444a64dadbbb508652c721e17",22136774,1,-3,0,126,49,46,-3
"d9c8d8c444a64dadbbb508652c721e17","d0c74f735e024943943e40333d6d337f",22136774,2,6,0,127,46,51,5
"d0c74f735e024943943e40333d6d337f","983f8ff320594b279a7f4a6fe132f9c5",22136774,1,2,0,128,51,53,2
"983f8ff320594b279a7f4a6fe132f9c5","983f8ff320594b279a7f4a6fe132f9c5",22136774,2,0,1,129,53,53,0
"983f8ff320594b279a7f4a6fe132f9c5","35adfa5d923046aebabfefd98f35ff05",22136774,1,1,0,131,53,54,1
"35adfa5d923046aebabfefd98f35ff05","35adfa5d923046aebabfefd98f35ff05",22136774,5,0,1,132,54,54,0
"35adfa5d923046aebabfefd98f35ff05","b6f8a98476224da1b40e555ececc7ed8",22136774,1,1,0,137,54,55,1
"b6f8a98476224da1b40e555ececc7ed8","b6f8a98476224da1b40e555ececc7ed8",22136774,2,0,1,138,55,55,0
"b6f8a98476224da1b40e555ececc7ed8","86e22cb5fe0e4b47a9489ecddf7ed78f",22136774,1,1,0,140,55,56,1
"86e22cb5fe0e4b47a9489ecddf7ed78f","86e22cb5fe0e4b47a9489ecddf7ed78f",22136774,2,0,1,141,56,56,0
"86e22cb5fe0e4b47a9489ecddf7ed78f","78f30e4dcac84e3cbea8b2cc6e0d62b3",22136774,1,4,0,143,56,59,3
"78f30e4dcac84e3cbea8b2cc6e0d62b3","a1f2f12debe5432fb7a70bcd12bacfb9",22136774,1,-1,0,144,59,58,-1
"a1f2f12debe5432fb7a70bcd12bacfb9","f924752d8a1149668870b1e7698486f7",22136774,1,-9,0,145,58,50,-8
"f924752d8a1149668870b1e7698486f7","12aa6e1672ac4e7aa6449a7a8609cd72",22136774,1,8,0,146,50,57,7
"12aa6e1672ac4e7aa6449a7a8609cd72","b534b89233134e30a9b5645138bfa9ee",22136774,1,-19,0,147,57,41,-16
"d646286c8051419bbc2e31dd1db55ca8","58c22b011d0f4c2ea6d13615edbb9eeb",22136774,1,11,0,151,67,77,10
"58c22b011d0f4c2ea6d13615edbb9eeb","58c22b011d0f4c2ea6d13615edbb9eeb",22136774,11,0,1,152,77,77,0
"58c22b011d0f4c2ea6d13615edbb9eeb","dd76e1861dc9461c830888729d091ee0",22136774,1,1,0,163,77,78,1
"dd76e1861dc9461c830888729d091ee0","dd76e1861dc9461c830888729d091ee0",22136774,5,0,1,164,78,78,0
"dd76e1861dc9461c830888729d091ee0","cd1d828f1a694b87913a7ea66c23803e",22136774,1,1,0,169,78,79,1
"cd1d828f1a694b87913a7ea66c23803e","cd1d828f1a694b87913a7ea66c23803e",22136774,5,0,1,170,79,79,0
"cd1d828f1a694b87913a7ea66c23803e","9176a3c2b4d2465fa8b0c67096c2a97e",22136774,1,1,0,175,79,80,1
"9176a3c2b4d2465fa8b0c67096c2a97e","9176a3c2b4d2465fa8b0c67096c2a97e",22136774,5,0,1,176,80,80,0
"9176a3c2b4d2465fa8b0c67096c2a97e","f8ec6445f7194e25b9101d4fbcb07a18",22136774,1,1,0,181,80,81,1
"f8ec6445f7194e25b9101d4fbcb07a18","f8ec6445f7194e25b9101d4fbcb07a18",22136774,2,0,1,182,81,81,0
"f8ec6445f7194e25b9101d4fbcb07a18","140d5b27b8574befad82c0a013b59dfa",22136774,1,-7,0,184,81,74,-7
"140d5b27b8574befad82c0a013b59dfa","d18a9ea32855445f8736581f5cb119ce",22136774,1,9,0,185,74,82,8
"d18a9ea32855445f8736581f5cb119ce","f564483cbd7a407681aa2fcca518cf5f",22136774,1,4,0,186,82,85,3
"f564483cbd7a407681aa2fcca518cf5f","f564483cbd7a407681aa2fcca518cf5f",22136774,5,0,1,187,85,85,0
"f564483cbd7a407681aa2fcca518cf5f","18fd01350bd5434ca636d59a599d768a",22136774,1,1,0,192,85,86,1
"18fd01350bd5434ca636d59a599d768a","18fd01350bd5434ca636d59a599d768a",22136774,8,0,1,193,86,86,0
"18fd01350bd5434ca636d59a599d768a","6a9f0ef185fb47f0937e29daa1c71ed5",22136774,1,5,0,201,86,90,4
"6a9f0ef185fb47f0937e29daa1c71ed5","ae5ac430ea254e708a6f5deaaf7464ae",22136774,1,-7,0,202,90,84,-6
"ae5ac430ea254e708a6f5deaaf7464ae","6a9f0ef185fb47f0937e29daa1c71ed5",22136774,1,7,0,203,84,90,6
"6a9f0ef185fb47f0937e29daa1c71ed5","6a9f0ef185fb47f0937e29daa1c71ed5",22136774,3,0,1,204,90,90,0
"6a9f0ef185fb47f0937e29daa1c71ed5","d646286c8051419bbc2e31dd1db55ca8",22136774,1,-27,0,207,90,67,-23
"d646286c8051419bbc2e31dd1db55ca8","e20db35ced8544ddac5bc3839145e463",22136774,1,30,0,208,67,91,24
"e20db35ced8544ddac5bc3839145e463","78adeee1fa2c4fe0bc73f7bca9fcee86",22136774,1,85,0,209,91,160,69
"78adeee1fa2c4fe0bc73f7bca9fcee86","65202579580f4ad38d734b4ee39d22a8",22136774,2,5,0,210,160,164,4
"65202579580f4ad38d734b4ee39d22a8","78adeee1fa2c4fe0bc73f7bca9fcee86",22136774,1,-5,0,211,164,160,-4
"65202579580f4ad38d734b4ee39d22a8","65202579580f4ad38d734b4ee39d22a8",22136774,6,0,1,213,164,164,0
"65202579580f4ad38d734b4ee39d22a8","1febb706d7a34005ae8711ed49c76e64",22136774,1,-87,0,219,164,94,-70
"1febb706d7a34005ae8711ed49c76e64","1febb706d7a34005ae8711ed49c76e64",22136774,2,0,1,220,94,94,0
"1febb706d7a34005ae8711ed49c76e64","8f73ba6f5a0042f2850356ac38ac6f24",22136774,1,1,0,222,94,95,1
"8f73ba6f5a0042f2850356ac38ac6f24","8f73ba6f5a0042f2850356ac38ac6f24",22136774,5,0,1,223,95,95,0
"8f73ba6f5a0042f2850356ac38ac6f24","e2260b86653c46d7b14a41fb419dbf8c",22136774,1,1,0,228,95,96,1
"e2260b86653c46d7b14a41fb419dbf8c","e2260b86653c46d7b14a41fb419dbf8c",22136774,2,0,1,229,96,96,0
"e2260b86653c46d7b14a41fb419dbf8c","35eb641ad1d845bbba54915bce75a962",22136774,1,1,0,231,96,97,1
"35eb641ad1d845bbba54915bce75a962","35eb641ad1d845bbba54915bce75a962",22136774,5,0,1,232,97,97,0
"35eb641ad1d845bbba54915bce75a962","08be90ffbeea4795a138cd42ed8db56f",22136774,1,1,0,237,97,98,1
"08be90ffbeea4795a138cd42ed8db56f","08be90ffbeea4795a138cd42ed8db56f",22136774,5,0,1,238,98,98,0
"08be90ffbeea4795a138cd42ed8db56f","3007433c8f584dcbb5ac159c1c5f2be3",22136774,1,1,0,243,98,99,1
"3007433c8f584dcbb5ac159c1c5f2be3","3007433c8f584dcbb5ac159c1c5f2be3",22136774,5,0,1,244,99,99,0
"3007433c8f584dcbb5ac159c1c5f2be3","e20db35ced8544ddac5bc3839145e463",22136774,1,-8,0,249,99,91,-8
"e20db35ced8544ddac5bc3839145e463","00ae5f0c51874a73a41ebea838d95682",22136774,2,11,0,250,91,101,10
"00ae5f0c51874a73a41ebea838d95682","d391c8b6e56a43a7b654e9dee02d904b",22136774,2,2,0,251,101,103,2
"d391c8b6e56a43a7b654e9dee02d904b","00ae5f0c51874a73a41ebea838d95682",22136774,1,-2,0,252,103,101,-2
"00ae5f0c51874a73a41ebea838d95682","e20db35ced8544ddac5bc3839145e463",22136774,1,-11,0,253,101,91,-10
"d391c8b6e56a43a7b654e9dee02d904b","6111116566fc4fd9abba409322bea245",22136774,1,1,0,256,103,104,1
"6111116566fc4fd9abba409322bea245","6111116566fc4fd9abba409322bea245",22136774,2,0,1,257,104,104,0
"6111116566fc4fd9abba409322bea245","a81b2235cb9c499eb9ea8ee0a8dd9725",22136774,1,1,0,259,104,105,1
"a81b2235cb9c499eb9ea8ee0a8dd9725","a81b2235cb9c499eb9ea8ee0a8dd9725",22136774,2,0,1,260,105,105,0
"a81b2235cb9c499eb9ea8ee0a8dd9725","d391c8b6e56a43a7b654e9dee02d904b",22136774,1,-2,0,262,105,103,-2
"d391c8b6e56a43a7b654e9dee02d904b","d391c8b6e56a43a7b654e9dee02d904b",22136774,16,0,1,263,103,103,0
"d391c8b6e56a43a7b654e9dee02d904b","2d4e0ab0ef3b4d73b82c72d4621a7579",22136774,1,3,0,279,103,106,3
"2d4e0ab0ef3b4d73b82c72d4621a7579","2d4e0ab0ef3b4d73b82c72d4621a7579",22136774,5,0,1,280,106,106,0
"2d4e0ab0ef3b4d73b82c72d4621a7579","8bdebf492ebd4e62b0d522e8ab5e5197",22136774,1,1,0,285,106,107,1
"8bdebf492ebd4e62b0d522e8ab5e5197","8bdebf492ebd4e62b0d522e8ab5e5197",22136774,2,0,1,286,107,107,0
"8bdebf492ebd4e62b0d522e8ab5e5197","73039f8c1eb9409cb4caee2cf968001e",22136774,1,-7,0,288,107,100,-7
"73039f8c1eb9409cb4caee2cf968001e","4280927ec4d643238aa49c32f9e06c6c",22136774,1,10,0,289,100,109,9
"4280927ec4d643238aa49c32f9e06c6c","08111f75e22d409998cf8b85bd431f0a",22136774,1,-1,0,290,109,108,-1
"08111f75e22d409998cf8b85bd431f0a","a9ae0a3c070d455bb4369a8996313336",22136774,1,7,0,291,108,114,6
"a9ae0a3c070d455bb4369a8996313336","62bff51286ef4f348717a3cf6fe2318f",22136774,1,7,0,292,114,120,6
"62bff51286ef4f348717a3cf6fe2318f","37319e88176d4aefa91d7a9980dbae91",22136774,1,-9,0,293,120,112,-8
"b613861cecf84ffcab01afb23f660475","b613861cecf84ffcab01afb23f660475",20387421,4,0,1,1,1,1,0
"e2911e79efc2420eac45d9f671463d4b","519d1b8c59404d67b54e96c5c8a830b2",20387421,1,1,0,8,2,3,1
"519d1b8c59404d67b54e96c5c8a830b2","519d1b8c59404d67b54e96c5c8a830b2",20387421,1,0,1,9,3,3,0
"519d1b8c59404d67b54e96c5c8a830b2","531db53f81f646edb0cdcfe0085b03b7",20387421,1,1,0,10,3,4,1
"531db53f81f646edb0cdcfe0085b03b7","531db53f81f646edb0cdcfe0085b03b7",20387421,1,0,1,11,4,4,0
"531db53f81f646edb0cdcfe0085b03b7","4f5f94b2f95141e0a9d53a61da2276da",20387421,1,1,0,12,4,5,1
"4f5f94b2f95141e0a9d53a61da2276da","4f5f94b2f95141e0a9d53a61da2276da",20387421,1,0,1,13,5,5,0
"4f5f94b2f95141e0a9d53a61da2276da","6d541c89590949f99af293c4f2333f67",20387421,1,1,0,14,5,6,1
"6d541c89590949f99af293c4f2333f67","6d541c89590949f99af293c4f2333f67",20387421,1,0,1,15,6,6,0
"6d541c89590949f99af293c4f2333f67","dd5cf0b9fe4c4f1d8f5ff8e4c04879cb",20387421,1,1,0,16,6,7,1
"dd5cf0b9fe4c4f1d8f5ff8e4c04879cb","dd5cf0b9fe4c4f1d8f5ff8e4c04879cb",20387421,1,0,1,17,7,7,0
"dd5cf0b9fe4c4f1d8f5ff8e4c04879cb","f96261861edc426abe2248be4f0a709a",20387421,1,1,0,18,7,8,1
"f96261861edc426abe2248be4f0a709a","f96261861edc426abe2248be4f0a709a",20387421,1,0,1,19,8,8,0
"f96261861edc426abe2248be4f0a709a","66b5e16f4f75454fb5b8172079f0fa83",20387421,1,1,0,20,8,9,1
"66b5e16f4f75454fb5b8172079f0fa83","66b5e16f4f75454fb5b8172079f0fa83",20387421,1,0,1,21,9,9,0
"66b5e16f4f75454fb5b8172079f0fa83","0680571d4698477995e41842c36a54b2",20387421,1,1,0,22,9,10,1
"0680571d4698477995e41842c36a54b2","0680571d4698477995e41842c36a54b2",20387421,1,0,1,23,10,10,0
"0680571d4698477995e41842c36a54b2","9112f2bffece48e08c6d2287be204085",20387421,1,1,0,24,10,11,1
"9112f2bffece48e08c6d2287be204085","9112f2bffece48e08c6d2287be204085",20387421,1,0,1,25,11,11,0
"9112f2bffece48e08c6d2287be204085","56586aa865414f538729c7f7735d2bc6",20387421,1,3,0,26,11,12,1
"56586aa865414f538729c7f7735d2bc6","e2911e79efc2420eac45d9f671463d4b",20387421,3,-12,0,27,12,2,-10
"e2911e79efc2420eac45d9f671463d4b","56586aa865414f538729c7f7735d2bc6",20387421,3,12,0,28,2,12,10
"e2911e79efc2420eac45d9f671463d4b","e2911e79efc2420eac45d9f671463d4b",20387421,4,0,1,30,2,2,0
"56586aa865414f538729c7f7735d2bc6","56586aa865414f538729c7f7735d2bc6",20387421,6,0,1,33,12,12,0
"56586aa865414f538729c7f7735d2bc6","b613861cecf84ffcab01afb23f660475",20387421,1,-15,0,34,12,1,-11
"b613861cecf84ffcab01afb23f660475","e2911e79efc2420eac45d9f671463d4b",20387421,2,3,0,35,1,2,1
"e2911e79efc2420eac45d9f671463d4b","0680571d4698477995e41842c36a54b2",20387421,1,8,0,36,2,10,8
"0680571d4698477995e41842c36a54b2","56586aa865414f538729c7f7735d2bc6",20387421,1,4,0,37,10,12,2
"56586aa865414f538729c7f7735d2bc6","4e51676dc72045d99c19b9fa7b22f8bc",20387421,1,32,0,40,12,29,17
"4e51676dc72045d99c19b9fa7b22f8bc","4e51676dc72045d99c19b9fa7b22f8bc",20387421,2,0,1,41,29,29,0
"4e51676dc72045d99c19b9fa7b22f8bc","51970cfa30e643e894e66ae85c8024cc",20387421,1,3,0,43,29,31,2
"51970cfa30e643e894e66ae85c8024cc","c33c17be71ae4d588da7369472e5bb1b",20387421,1,6,0,44,31,34,3
"c33c17be71ae4d588da7369472e5bb1b","4e51676dc72045d99c19b9fa7b22f8bc",20387421,1,-9,0,45,34,29,-5
"4e51676dc72045d99c19b9fa7b22f8bc","c33c17be71ae4d588da7369472e5bb1b",20387421,1,9,0,46,29,34,5
"c33c17be71ae4d588da7369472e5bb1b","93679be414554a11b1893002f2229a93",20387421,1,3,0,47,34,35,1
"93679be414554a11b1893002f2229a93","7040a13096d746ac84b8fac8d9752058",20387421,1,3,0,48,35,36,1
"7040a13096d746ac84b8fac8d9752058","93679be414554a11b1893002f2229a93",20387421,1,-3,0,49,36,35,-1
"93679be414554a11b1893002f2229a93","9a0dc646f934470daf08c4b56ccf73db",20387421,1,6,0,50,35,37,2
"9a0dc646f934470daf08c4b56ccf73db","7040a13096d746ac84b8fac8d9752058",20387421,1,-3,0,51,37,36,-1
"7040a13096d746ac84b8fac8d9752058","9a0dc646f934470daf08c4b56ccf73db",20387421,2,3,0,52,36,37,1
"9a0dc646f934470daf08c4b56ccf73db","fc0e049d56024bc9a02c9a9c435c3df7",20387421,2,3,0,53,37,38,1
"fc0e049d56024bc9a02c9a9c435c3df7","fc0e049d56024bc9a02c9a9c435c3df7",20387421,1,0,1,54,38,38,0
"fc0e049d56024bc9a02c9a9c435c3df7","67a089198fcb4e1c8f2385786c2b296f",20387421,1,4,0,55,38,39,1
"67a089198fcb4e1c8f2385786c2b296f","64d48c6c9c7940639a932219a6c87198",20387421,2,1,0,56,39,40,1
"64d48c6c9c7940639a932219a6c87198","56586aa865414f538729c7f7735d2bc6",20387421,1,-58,0,57,40,12,-28
"56586aa865414f538729c7f7735d2bc6","b7f2b31585d94eb3bf86376714aa7070",20387421,2,2,0,62,12,13,1
"b7f2b31585d94eb3bf86376714aa7070","56586aa865414f538729c7f7735d2bc6",20387421,1,-2,0,63,13,12,-1
"56586aa865414f538729c7f7735d2bc6","5c5ceeee4562457ba6d41515aeebfbb1",20387421,3,10,0,64,12,17,5
"5c5ceeee4562457ba6d41515aeebfbb1","56586aa865414f538729c7f7735d2bc6",20387421,2,-10,0,65,17,12,-5
"56586aa865414f538729c7f7735d2bc6","9afd71a5298d4333b6849dfce1b9422c",20387421,1,13,0,66,12,18,6
"9afd71a5298d4333b6849dfce1b9422c","b7719e26494940efa49512aedd0aac79",20387421,1,4,0,67,18,20,2
"b7719e26494940efa49512aedd0aac79","b7719e26494940efa49512aedd0aac79",20387421,2,0,1,68,20,20,0
"b7719e26494940efa49512aedd0aac79","d4f45188d3c84a02ba08454e6403a818",20387421,3,5,0,69,20,24,4
"d4f45188d3c84a02ba08454e6403a818","afbf7250b99d47bea07172749483ca97",20387421,1,7,0,70,24,28,4
"afbf7250b99d47bea07172749483ca97","d4c3b003e8274e429d2fa688d73fde6d",20387421,1,-9,0,71,28,22,-6
"d4c3b003e8274e429d2fa688d73fde6d","4e51676dc72045d99c19b9fa7b22f8bc",20387421,1,12,0,72,22,29,7
"4e51676dc72045d99c19b9fa7b22f8bc","7040a13096d746ac84b8fac8d9752058",20387421,1,15,0,73,29,36,7
"fc0e049d56024bc9a02c9a9c435c3df7","56586aa865414f538729c7f7735d2bc6",20387421,1,-53,0,76,38,12,-26
"b7f2b31585d94eb3bf86376714aa7070","5c5ceeee4562457ba6d41515aeebfbb1",20387421,1,8,0,78,13,17,4
"5c5ceeee4562457ba6d41515aeebfbb1","b7719e26494940efa49512aedd0aac79",20387421,1,7,0,82,17,20,3
"d4f45188d3c84a02ba08454e6403a818","d4c3b003e8274e429d2fa688d73fde6d",20387421,2,-2,0,85,24,22,-2
"d4c3b003e8274e429d2fa688d73fde6d","afbf7250b99d47bea07172749483ca97",20387421,1,9,0,86,22,28,6
"afbf7250b99d47bea07172749483ca97","5bc03c8f16354d04bd51f5bb93559ad3",20387421,1,-5,0,87,28,26,-2
"5bc03c8f16354d04bd51f5bb93559ad3","afbf7250b99d47bea07172749483ca97",20387421,1,5,0,88,26,28,2
"afbf7250b99d47bea07172749483ca97","b7719e26494940efa49512aedd0aac79",20387421,1,-12,0,89,28,20,-8
"d4c3b003e8274e429d2fa688d73fde6d","56586aa865414f538729c7f7735d2bc6",20387421,1,-20,0,92,22,12,-10
"5c5ceeee4562457ba6d41515aeebfbb1","5c5ceeee4562457ba6d41515aeebfbb1",20387421,1,0,1,94,17,17,0
"5c5ceeee4562457ba6d41515aeebfbb1","67a089198fcb4e1c8f2385786c2b296f",20387421,1,47,0,95,17,39,22
"64d48c6c9c7940639a932219a6c87198","b534b89233134e30a9b5645138bfa9ee",20387421,1,3,0,97,40,41,1
"b534b89233134e30a9b5645138bfa9ee","b534b89233134e30a9b5645138bfa9ee",20387421,5,0,1,100,41,41,0
"b534b89233134e30a9b5645138bfa9ee","6e13d61a7bdb44bca949c9f86fab3be5",20387421,1,7,0,103,41,47,6
"6e13d61a7bdb44bca949c9f86fab3be5","a1f2f12debe5432fb7a70bcd12bacfb9",20387421,1,13,0,104,47,58,11
"a1f2f12debe5432fb7a70bcd12bacfb9","a0a418b8540d479fa6e0f653b701da8b",20387421,1,7,0,105,58,64,6
"a0a418b8540d479fa6e0f653b701da8b","78f30e4dcac84e3cbea8b2cc6e0d62b3",20387421,1,-6,0,106,64,59,-5
"78f30e4dcac84e3cbea8b2cc6e0d62b3","d0c74f735e024943943e40333d6d337f",20387421,1,-9,0,107,59,51,-8
"d0c74f735e024943943e40333d6d337f","bc42d26810654ea9a1df1efe1e58c7d5",20387421,1,14,0,108,51,63,12
"bc42d26810654ea9a1df1efe1e58c7d5","d646286c8051419bbc2e31dd1db55ca8",20387421,1,7,0,109,63,67,4
"d646286c8051419bbc2e31dd1db55ca8","d646286c8051419bbc2e31dd1db55ca8",20387421,4,0,1,110,67,67,0
"d646286c8051419bbc2e31dd1db55ca8","a2becd407db34b189200a32546d9d569",20387421,1,9,0,114,67,75,8
"a2becd407db34b189200a32546d9d569","e20db35ced8544ddac5bc3839145e463",20387421,1,21,0,115,75,91,16
"e20db35ced8544ddac5bc3839145e463","6a9f0ef185fb47f0937e29daa1c71ed5",20387421,1,-3,0,116,91,90,-1
"6a9f0ef185fb47f0937e29daa1c71ed5","e20db35ced8544ddac5bc3839145e463",20387421,1,3,0,117,90,91,1
"e20db35ced8544ddac5bc3839145e463","e20db35ced8544ddac5bc3839145e463",20387421,5,0,1,118,91,91,0
"e20db35ced8544ddac5bc3839145e463","d391c8b6e56a43a7b654e9dee02d904b",20387421,1,13,0,121,91,103,12
"d391c8b6e56a43a7b654e9dee02d904b","00ae5f0c51874a73a41ebea838d95682",20387421,1,-2,0,122,103,101,-2
"00ae5f0c51874a73a41ebea838d95682","62bff51286ef4f348717a3cf6fe2318f",20387421,1,22,0,123,101,120,19
"62bff51286ef4f348717a3cf6fe2318f","4280927ec4d643238aa49c32f9e06c6c",20387421,1,-13,0,124,120,109,-11
"4280927ec4d643238aa49c32f9e06c6c","779f9ddd1fd14d1e9e69f72219a1fdbd",20387421,1,16,0,125,109,121,12
"779f9ddd1fd14d1e9e69f72219a1fdbd","a9ae0a3c070d455bb4369a8996313336",20387421,1,-10,0,126,121,114,-7
"a9ae0a3c070d455bb4369a8996313336","779f9ddd1fd14d1e9e69f72219a1fdbd",20387421,2,10,0,127,114,121,7
"779f9ddd1fd14d1e9e69f72219a1fdbd","779f9ddd1fd14d1e9e69f72219a1fdbd",20387421,5,0,1,128,121,121,0
"779f9ddd1fd14d1e9e69f72219a1fdbd","a8dd5213034441ac92724b4e83eb0bb2",20387421,2,9,0,130,121,129,8
"a8dd5213034441ac92724b4e83eb0bb2","df1de691dafe4549a18a4398ee9dfaf9",20387421,1,14,0,131,129,139,10
"df1de691dafe4549a18a4398ee9dfaf9","df1de691dafe4549a18a4398ee9dfaf9",20387421,6,0,1,132,139,139,0
"df1de691dafe4549a18a4398ee9dfaf9","6c5ad271a44743479bfaea29b1db8d02",20387421,2,4,0,135,139,143,4
"6c5ad271a44743479bfaea29b1db8d02","8aae34f5ddbb4052a709b12e6b0d40fa",20387421,3,5,0,136,143,147,4
"8aae34f5ddbb4052a709b12e6b0d40fa","78adeee1fa2c4fe0bc73f7bca9fcee86",20387421,1,17,0,137,147,160,13
"78adeee1fa2c4fe0bc73f7bca9fcee86","78adeee1fa2c4fe0bc73f7bca9fcee86",20387421,1,0,1,138,160,160,0
"78adeee1fa2c4fe0bc73f7bca9fcee86","d313cec988a84645bee413e8d4724a4b",20387421,1,-4,0,139,160,158,-2
"d313cec988a84645bee413e8d4724a4b","65202579580f4ad38d734b4ee39d22a8",20387421,1,9,0,140,158,164,6
"65202579580f4ad38d734b4ee39d22a8","65202579580f4ad38d734b4ee39d22a8",20387421,7,0,1,141,164,164,0
"65202579580f4ad38d734b4ee39d22a8","3cbcea2be0984e7dbd5a48195af10ce7",20387421,1,3,0,148,164,165,1
"3cbcea2be0984e7dbd5a48195af10ce7","82e6285962b8400d9d6fc32436022a94",20387421,1,2,0,149,165,167,2
"82e6285962b8400d9d6fc32436022a94","a9ac840f098c4bd0a2ee896214ce29cd",20387421,1,3,0,150,167,168,1
"a9ac840f098c4bd0a2ee896214ce29cd","64d48c6c9c7940639a932219a6c87198",20387421,1,-164,0,151,168,40,-128
"64d48c6c9c7940639a932219a6c87198","6e13d61a7bdb44bca949c9f86fab3be5",20387421,1,10,0,152,40,47,7
"6e13d61a7bdb44bca949c9f86fab3be5","d0c74f735e024943943e40333d6d337f",20387421,1,5,0,153,47,51,4
"d0c74f735e024943943e40333d6d337f","a2becd407db34b189200a32546d9d569",20387421,1,30,0,154,51,75,24
"a2becd407db34b189200a32546d9d569","4280927ec4d643238aa49c32f9e06c6c",20387421,1,41,0,155,75,109,34
"4280927ec4d643238aa49c32f9e06c6c","a9ae0a3c070d455bb4369a8996313336",20387421,1,6,0,156,109,114,5
"a9ae0a3c070d455bb4369a8996313336","a8dd5213034441ac92724b4e83eb0bb2",20387421,1,19,0,157,114,129,15
"a8dd5213034441ac92724b4e83eb0bb2","6c5ad271a44743479bfaea29b1db8d02",20387421,1,18,0,158,129,143,14
"8aae34f5ddbb4052a709b12e6b0d40fa","a9ac840f098c4bd0a2ee896214ce29cd",20387421,1,30,0,160,147,168,21
"a9ac840f098c4bd0a2ee896214ce29cd","0e37b720d23b4e7f8b313e79313fd107",20387421,1,-158,0,161,168,44,-124
"0e37b720d23b4e7f8b313e79313fd107","0e37b720d23b4e7f8b313e79313fd107",20387421,1,0,1,162,44,44,0
"0e37b720d23b4e7f8b313e79313fd107","6875d67fdd5f48168b62719df449bebd",20387421,1,1,0,163,44,45,1
"6875d67fdd5f48168b62719df449bebd","6875d67fdd5f48168b62719df449bebd",20387421,1,0,1,164,45,45,0
"6875d67fdd5f48168b62719df449bebd","195f78799f984cc2b06c48dfe36be751",20387421,1,5,0,165,45,49,4
"195f78799f984cc2b06c48dfe36be751","195f78799f984cc2b06c48dfe36be751",20387421,2,0,1,166,49,49,0
"195f78799f984cc2b06c48dfe36be751","983f8ff320594b279a7f4a6fe132f9c5",20387421,1,5,0,168,49,53,4
"983f8ff320594b279a7f4a6fe132f9c5","983f8ff320594b279a7f4a6fe132f9c5",20387421,2,0,1,169,53,53,0
"983f8ff320594b279a7f4a6fe132f9c5","35adfa5d923046aebabfefd98f35ff05",20387421,1,1,0,171,53,54,1
"35adfa5d923046aebabfefd98f35ff05","35adfa5d923046aebabfefd98f35ff05",20387421,2,0,1,172,54,54,0
"35adfa5d923046aebabfefd98f35ff05","b6f8a98476224da1b40e555ececc7ed8",20387421,1,1,0,174,54,55,1
"b6f8a98476224da1b40e555ececc7ed8","b6f8a98476224da1b40e555ececc7ed8",20387421,2,0,1,175,55,55,0
"b6f8a98476224da1b40e555ececc7ed8","86e22cb5fe0e4b47a9489ecddf7ed78f",20387421,1,1,0,177,55,56,1
"86e22cb5fe0e4b47a9489ecddf7ed78f","86e22cb5fe0e4b47a9489ecddf7ed78f",20387421,2,0,1,178,56,56,0
"86e22cb5fe0e4b47a9489ecddf7ed78f","a1f2f12debe5432fb7a70bcd12bacfb9",20387421,1,3,0,180,56,58,2
"a1f2f12debe5432fb7a70bcd12bacfb9","a1f2f12debe5432fb7a70bcd12bacfb9",20387421,21,0,1,181,58,58,0
"a1f2f12debe5432fb7a70bcd12bacfb9","78f30e4dcac84e3cbea8b2cc6e0d62b3",20387421,1,1,0,202,58,59,1
"78f30e4dcac84e3cbea8b2cc6e0d62b3","78f30e4dcac84e3cbea8b2cc6e0d62b3",20387421,11,0,1,203,59,59,0
"78f30e4dcac84e3cbea8b2cc6e0d62b3","4c943503763e4e349906eea3ed3c8e86",20387421,1,3,0,214,59,61,2
"4c943503763e4e349906eea3ed3c8e86","4c943503763e4e349906eea3ed3c8e86",20387421,1,0,1,215,61,61,0
"4c943503763e4e349906eea3ed3c8e86","bc42d26810654ea9a1df1efe1e58c7d5",20387421,1,2,0,216,61,63,2
"bc42d26810654ea9a1df1efe1e58c7d5","bc42d26810654ea9a1df1efe1e58c7d5",20387421,3,0,1,217,63,63,0
"bc42d26810654ea9a1df1efe1e58c7d5","a0a418b8540d479fa6e0f653b701da8b",20387421,1,1,0,220,63,64,1
"a0a418b8540d479fa6e0f653b701da8b","a0a418b8540d479fa6e0f653b701da8b",20387421,3,0,1,221,64,64,0
"a0a418b8540d479fa6e0f653b701da8b","309ccf3cc4fe429d9bfbaef53d3fa479",20387421,1,-4,0,224,64,60,-4
"309ccf3cc4fe429d9bfbaef53d3fa479","267f883678b24aed855fde42524975d9",20387421,1,14,0,225,60,71,11
"267f883678b24aed855fde42524975d9","267f883678b24aed855fde42524975d9",20387421,5,0,1,226,71,71,0
"267f883678b24aed855fde42524975d9","88fff56d0342490dbef9040750a20f6c",20387421,1,1,0,231,71,72,1
"88fff56d0342490dbef9040750a20f6c","88fff56d0342490dbef9040750a20f6c",20387421,3,0,1,232,72,72,0
"88fff56d0342490dbef9040750a20f6c","adb17b12b66c4a49a85fd34322f7df70",20387421,1,1,0,235,72,73,1
"adb17b12b66c4a49a85fd34322f7df70","adb17b12b66c4a49a85fd34322f7df70",20387421,1,0,1,236,73,73,0
"adb17b12b66c4a49a85fd34322f7df70","a2becd407db34b189200a32546d9d569",20387421,1,3,0,237,73,75,2
"a2becd407db34b189200a32546d9d569","58c22b011d0f4c2ea6d13615edbb9eeb",20387421,1,2,0,238,75,77,2
"58c22b011d0f4c2ea6d13615edbb9eeb","58c22b011d0f4c2ea6d13615edbb9eeb",20387421,11,0,1,239,77,77,0
"58c22b011d0f4c2ea6d13615edbb9eeb","dd76e1861dc9461c830888729d091ee0",20387421,1,1,0,250,77,78,1
"dd76e1861dc9461c830888729d091ee0","dd76e1861dc9461c830888729d091ee0",20387421,8,0,1,251,78,78,0
"dd76e1861dc9461c830888729d091ee0","cd1d828f1a694b87913a7ea66c23803e",20387421,1,1,0,259,78,79,1
"cd1d828f1a694b87913a7ea66c23803e","cd1d828f1a694b87913a7ea66c23803e",20387421,2,0,1,260,79,79,0
"cd1d828f1a694b87913a7ea66c23803e","9176a3c2b4d2465fa8b0c67096c2a97e",20387421,1,1,0,262,79,80,1
"9176a3c2b4d2465fa8b0c67096c2a97e","9176a3c2b4d2465fa8b0c67096c2a97e",20387421,5,0,1,263,80,80,0
"9176a3c2b4d2465fa8b0c67096c2a97e","f8ec6445f7194e25b9101d4fbcb07a18",20387421,1,1,0,268,80,81,1
"f8ec6445f7194e25b9101d4fbcb07a18","f8ec6445f7194e25b9101d4fbcb07a18",20387421,2,0,1,269,81,81,0
"f8ec6445f7194e25b9101d4fbcb07a18","d646286c8051419bbc2e31dd1db55ca8",20387421,1,-15,0,271,81,67,-14
"d646286c8051419bbc2e31dd1db55ca8","f564483cbd7a407681aa2fcca518cf5f",20387421,1,21,0,272,67,85,18
"f564483cbd7a407681aa2fcca518cf5f","f564483cbd7a407681aa2fcca518cf5f",20387421,5,0,1,273,85,85,0
"f564483cbd7a407681aa2fcca518cf5f","18fd01350bd5434ca636d59a599d768a",20387421,1,1,0,278,85,86,1
"18fd01350bd5434ca636d59a599d768a","18fd01350bd5434ca636d59a599d768a",20387421,9,0,1,279,86,86,0
"18fd01350bd5434ca636d59a599d768a","6a9f0ef185fb47f0937e29daa1c71ed5",20387421,1,5,0,288,86,90,4
"6a9f0ef185fb47f0937e29daa1c71ed5","6a9f0ef185fb47f0937e29daa1c71ed5",20387421,3,0,1,289,90,90,0
"6a9f0ef185fb47f0937e29daa1c71ed5","c681290961c94c4caf23b529d1ae6b9a",20387421,1,-2,0,292,90,88,-2
"c681290961c94c4caf23b529d1ae6b9a","c681290961c94c4caf23b529d1ae6b9a",20387421,3,0,1,293,88,88,0
"c681290961c94c4caf23b529d1ae6b9a","1febb706d7a34005ae8711ed49c76e64",20387421,1,8,0,296,88,94,6
"1febb706d7a34005ae8711ed49c76e64","1febb706d7a34005ae8711ed49c76e64",20387421,5,0,1,297,94,94,0
"1febb706d7a34005ae8711ed49c76e64","8f73ba6f5a0042f2850356ac38ac6f24",20387421,1,1,0,302,94,95,1
"8f73ba6f5a0042f2850356ac38ac6f24","8f73ba6f5a0042f2850356ac38ac6f24",20387421,5,0,1,303,95,95,0
"8f73ba6f5a0042f2850356ac38ac6f24","e2260b86653c46d7b14a41fb419dbf8c",20387421,1,1,0,308,95,96,1
"e2260b86653c46d7b14a41fb419dbf8c","e2260b86653c46d7b14a41fb419dbf8c",20387421,2,0,1,309,96,96,0
"e2260b86653c46d7b14a41fb419dbf8c","35eb641ad1d845bbba54915bce75a962",20387421,1,1,0,311,96,97,1
"35eb641ad1d845bbba54915bce75a962","35eb641ad1d845bbba54915bce75a962",20387421,5,0,1,312,97,97,0
"35eb641ad1d845bbba54915bce75a962","08be90ffbeea4795a138cd42ed8db56f",20387421,1,1,0,317,97,98,1
"08be90ffbeea4795a138cd42ed8db56f","08be90ffbeea4795a138cd42ed8db56f",20387421,5,0,1,318,98,98,0
"08be90ffbeea4795a138cd42ed8db56f","3007433c8f584dcbb5ac159c1c5f2be3",20387421,1,1,0,323,98,99,1
"3007433c8f584dcbb5ac159c1c5f2be3","3007433c8f584dcbb5ac159c1c5f2be3",20387421,2,0,1,324,99,99,0
"3007433c8f584dcbb5ac159c1c5f2be3","d391c8b6e56a43a7b654e9dee02d904b",20387421,1,5,0,326,99,103,4
"d391c8b6e56a43a7b654e9dee02d904b","d391c8b6e56a43a7b654e9dee02d904b",20387421,15,0,1,327,103,103,0
"d391c8b6e56a43a7b654e9dee02d904b","6111116566fc4fd9abba409322bea245",20387421,2,1,0,342,103,104,1
"6111116566fc4fd9abba409322bea245","6111116566fc4fd9abba409322bea245",20387421,6,0,1,343,104,104,0
"6111116566fc4fd9abba409322bea245","a81b2235cb9c499eb9ea8ee0a8dd9725",20387421,2,1,0,345,104,105,1
"a81b2235cb9c499eb9ea8ee0a8dd9725","a81b2235cb9c499eb9ea8ee0a8dd9725",20387421,7,0,1,346,105,105,0
"a81b2235cb9c499eb9ea8ee0a8dd9725","2d4e0ab0ef3b4d73b82c72d4621a7579",20387421,2,1,0,351,105,106,1
"2d4e0ab0ef3b4d73b82c72d4621a7579","2d4e0ab0ef3b4d73b82c72d4621a7579",20387421,9,0,1,352,106,106,0
"2d4e0ab0ef3b4d73b82c72d4621a7579","8bdebf492ebd4e62b0d522e8ab5e5197",20387421,2,1,0,354,106,107,1
"8bdebf492ebd4e62b0d522e8ab5e5197","8bdebf492ebd4e62b0d522e8ab5e5197",20387421,7,0,1,355,107,107,0
"8bdebf492ebd4e62b0d522e8ab5e5197","fc44e6a5f7654430af1227838224dceb",20387421,1,5,0,360,107,111,4
"fc44e6a5f7654430af1227838224dceb","fc44e6a5f7654430af1227838224dceb",20387421,2,0,1,361,111,111,0
"fc44e6a5f7654430af1227838224dceb","e20db35ced8544ddac5bc3839145e463",20387421,1,-22,0,363,111,91,-20
"e20db35ced8544ddac5bc3839145e463","4280927ec4d643238aa49c32f9e06c6c",20387421,3,20,0,364,91,109,18
"4280927ec4d643238aa49c32f9e06c6c","00ae5f0c51874a73a41ebea838d95682",20387421,3,-9,0,365,109,101,-8
"00ae5f0c51874a73a41ebea838d95682","08111f75e22d409998cf8b85bd431f0a",20387421,2,8,0,366,101,108,7
"08111f75e22d409998cf8b85bd431f0a","d391c8b6e56a43a7b654e9dee02d904b",20387421,2,-6,0,367,108,103,-5
"d391c8b6e56a43a7b654e9dee02d904b","73039f8c1eb9409cb4caee2cf968001e",20387421,1,-3,0,368,103,100,-3
"73039f8c1eb9409cb4caee2cf968001e","4280927ec4d643238aa49c32f9e06c6c",20387421,1,10,0,369,100,109,9
"4280927ec4d643238aa49c32f9e06c6c","08111f75e22d409998cf8b85bd431f0a",20387421,1,-1,0,370,109,108,-1
"08111f75e22d409998cf8b85bd431f0a","00ae5f0c51874a73a41ebea838d95682",20387421,2,-8,0,371,108,101,-7
"00ae5f0c51874a73a41ebea838d95682","d391c8b6e56a43a7b654e9dee02d904b",20387421,3,2,0,372,101,103,2
"d391c8b6e56a43a7b654e9dee02d904b","e20db35ced8544ddac5bc3839145e463",20387421,1,-13,0,373,103,91,-12
"8bdebf492ebd4e62b0d522e8ab5e5197","2d4e0ab0ef3b4d73b82c72d4621a7579",20387421,1,-1,0,390,107,106,-1
"2d4e0ab0ef3b4d73b82c72d4621a7579","6111116566fc4fd9abba409322bea245",20387421,1,-2,0,396,106,104,-2
"6111116566fc4fd9abba409322bea245","e20db35ced8544ddac5bc3839145e463",20387421,1,-14,0,399,104,91,-13
"d391c8b6e56a43a7b654e9dee02d904b","08111f75e22d409998cf8b85bd431f0a",20387421,1,6,0,403,103,108,5
"00ae5f0c51874a73a41ebea838d95682","e20db35ced8544ddac5bc3839145e463",20387421,1,-11,0,405,101,91,-10
"e20db35ced8544ddac5bc3839145e463","a9ae0a3c070d455bb4369a8996313336",20387421,2,26,0,406,91,114,23
"a9ae0a3c070d455bb4369a8996313336","e20db35ced8544ddac5bc3839145e463",20387421,1,-26,0,407,114,91,-23
"e20db35ced8544ddac5bc3839145e463","00ae5f0c51874a73a41ebea838d95682",20387421,1,11,0,410,91,101,10
"d391c8b6e56a43a7b654e9dee02d904b","62bff51286ef4f348717a3cf6fe2318f",20387421,1,20,0,412,103,120,17
"62bff51286ef4f348717a3cf6fe2318f","a9ae0a3c070d455bb4369a8996313336",20387421,1,-7,0,413,120,114,-6
"a8dd5213034441ac92724b4e83eb0bb2","779f9ddd1fd14d1e9e69f72219a1fdbd",20387421,1,-9,0,418,129,121,-8
"779f9ddd1fd14d1e9e69f72219a1fdbd","df1de691dafe4549a18a4398ee9dfaf9",20387421,1,23,0,419,121,139,18
"8aae34f5ddbb4052a709b12e6b0d40fa","d313cec988a84645bee413e8d4724a4b",20387421,1,13,0,425,147,158,11
"d313cec988a84645bee413e8d4724a4b","00ae5f0c51874a73a41ebea838d95682",20387421,1,-70,0,426,158,101,-57
"00ae5f0c51874a73a41ebea838d95682","a9ae0a3c070d455bb4369a8996313336",20387421,1,15,0,427,101,114,13
"a9ae0a3c070d455bb4369a8996313336","71cec822bcff4f30a20e75dc63ef7b65",20387421,2,2,0,428,114,116,2
"71cec822bcff4f30a20e75dc63ef7b65","71cec822bcff4f30a20e75dc63ef7b65",20387421,2,0,1,429,116,116,0
"71cec822bcff4f30a20e75dc63ef7b65","e20db35ced8544ddac5bc3839145e463",20387421,1,-28,0,430,116,91,-25
"71cec822bcff4f30a20e75dc63ef7b65","b1cd0e7dc3ad4a8eb91a4bfdbeb025b0",20387421,1,3,0,434,116,118,2
"b1cd0e7dc3ad4a8eb91a4bfdbeb025b0","b1cd0e7dc3ad4a8eb91a4bfdbeb025b0",20387421,1,0,1,435,118,118,0
"b1cd0e7dc3ad4a8eb91a4bfdbeb025b0","62bff51286ef4f348717a3cf6fe2318f",20387421,1,2,0,436,118,120,2
"62bff51286ef4f348717a3cf6fe2318f","62bff51286ef4f348717a3cf6fe2318f",20387421,3,0,1,437,120,120,0
"62bff51286ef4f348717a3cf6fe2318f","ae26e6cda8ad4a3f81bd347560d9579f",20387421,1,7,0,440,120,125,5
"ae26e6cda8ad4a3f81bd347560d9579f","ae26e6cda8ad4a3f81bd347560d9579f",20387421,1,0,1,441,125,125,0
"ae26e6cda8ad4a3f81bd347560d9579f","ee48df95832b4374aa273ceb27ec1315",20387421,1,1,0,442,125,126,1
"ee48df95832b4374aa273ceb27ec1315","ee48df95832b4374aa273ceb27ec1315",20387421,1,0,1,443,126,126,0
"ee48df95832b4374aa273ceb27ec1315","7a439da90b394756ad1777fc4c6dead5",20387421,1,1,0,444,126,127,1
"7a439da90b394756ad1777fc4c6dead5","7a439da90b394756ad1777fc4c6dead5",20387421,1,0,1,445,127,127,0
"7a439da90b394756ad1777fc4c6dead5","a8dd5213034441ac92724b4e83eb0bb2",20387421,1,3,0,446,127,129,2
"a8dd5213034441ac92724b4e83eb0bb2","8115eab6556b45f5b415c3b8c26a12e5",20387421,1,2,0,447,129,131,2
"8115eab6556b45f5b415c3b8c26a12e5","8115eab6556b45f5b415c3b8c26a12e5",20387421,2,0,1,448,131,131,0
"8115eab6556b45f5b415c3b8c26a12e5","ec34b06efd844b46a4c4818ecdb9b8f4",20387421,1,1,0,450,131,132,1
"ec34b06efd844b46a4c4818ecdb9b8f4","ec34b06efd844b46a4c4818ecdb9b8f4",20387421,2,0,1,451,132,132,0
"ec34b06efd844b46a4c4818ecdb9b8f4","c2e1c2b9eac64109b343a088584b576b",20387421,1,1,0,453,132,133,1
"c2e1c2b9eac64109b343a088584b576b","c2e1c2b9eac64109b343a088584b576b",20387421,2,0,1,454,133,133,0
"c2e1c2b9eac64109b343a088584b576b","8bc5795d6a984a3eace4e2811e52dd4f",20387421,1,3,0,456,133,135,2
"8bc5795d6a984a3eace4e2811e52dd4f","8bc5795d6a984a3eace4e2811e52dd4f",20387421,1,0,1,457,135,135,0
"8bc5795d6a984a3eace4e2811e52dd4f","779f9ddd1fd14d1e9e69f72219a1fdbd",20387421,1,-16,0,458,135,121,-14
"b613861cecf84ffcab01afb23f660475","b613861cecf84ffcab01afb23f660475",15719564,4,0,1,1,1,1,0
"b613861cecf84ffcab01afb23f660475","e2911e79efc2420eac45d9f671463d4b",15719564,1,3,0,5,1,2,1
"e2911e79efc2420eac45d9f671463d4b","e2911e79efc2420eac45d9f671463d4b",15719564,2,0,1,6,2,2,0
"e2911e79efc2420eac45d9f671463d4b","519d1b8c59404d67b54e96c5c8a830b2",15719564,1,1,0,8,2,3,1
"519d1b8c59404d67b54e96c5c8a830b2","519d1b8c59404d67b54e96c5c8a830b2",15719564,1,0,1,9,3,3,0
"519d1b8c59404d67b54e96c5c8a830b2","531db53f81f646edb0cdcfe0085b03b7",15719564,1,1,0,10,3,4,1
"531db53f81f646edb0cdcfe0085b03b7","531db53f81f646edb0cdcfe0085b03b7",15719564,1,0,1,11,4,4,0
"531db53f81f646edb0cdcfe0085b03b7","4f5f94b2f95141e0a9d53a61da2276da",15719564,1,1,0,12,4,5,1
"4f5f94b2f95141e0a9d53a61da2276da","4f5f94b2f95141e0a9d53a61da2276da",15719564,1,0,1,13,5,5,0
"4f5f94b2f95141e0a9d53a61da2276da","6d541c89590949f99af293c4f2333f67",15719564,1,1,0,14,5,6,1
"6d541c89590949f99af293c4f2333f67","6d541c89590949f99af293c4f2333f67",15719564,1,0,1,15,6,6,0
"6d541c89590949f99af293c4f2333f67","dd5cf0b9fe4c4f1d8f5ff8e4c04879cb",15719564,1,1,0,16,6,7,1
"dd5cf0b9fe4c4f1d8f5ff8e4c04879cb","dd5cf0b9fe4c4f1d8f5ff8e4c04879cb",15719564,1,0,1,17,7,7,0
"dd5cf0b9fe4c4f1d8f5ff8e4c04879cb","f96261861edc426abe2248be4f0a709a",15719564,1,1,0,18,7,8,1
"f96261861edc426abe2248be4f0a709a","f96261861edc426abe2248be4f0a709a",15719564,1,0,1,19,8,8,0
"f96261861edc426abe2248be4f0a709a","66b5e16f4f75454fb5b8172079f0fa83",15719564,1,1,0,20,8,9,1
"66b5e16f4f75454fb5b8172079f0fa83","66b5e16f4f75454fb5b8172079f0fa83",15719564,1,0,1,21,9,9,0
"66b5e16f4f75454fb5b8172079f0fa83","0680571d4698477995e41842c36a54b2",15719564,1,1,0,22,9,10,1
"0680571d4698477995e41842c36a54b2","0680571d4698477995e41842c36a54b2",15719564,1,0,1,23,10,10,0
"0680571d4698477995e41842c36a54b2","9112f2bffece48e08c6d2287be204085",15719564,1,1,0,24,10,11,1
"9112f2bffece48e08c6d2287be204085","9112f2bffece48e08c6d2287be204085",15719564,1,0,1,25,11,11,0
"9112f2bffece48e08c6d2287be204085","e2911e79efc2420eac45d9f671463d4b",15719564,1,-9,0,26,11,2,-9
"e2911e79efc2420eac45d9f671463d4b","56586aa865414f538729c7f7735d2bc6",15719564,1,12,0,27,2,12,10
"56586aa865414f538729c7f7735d2bc6","56586aa865414f538729c7f7735d2bc6",15719564,7,0,1,28,12,12,0
"56586aa865414f538729c7f7735d2bc6","b7f2b31585d94eb3bf86376714aa7070",15719564,1,2,0,35,12,13,1
"b7f2b31585d94eb3bf86376714aa7070","b7f2b31585d94eb3bf86376714aa7070",15719564,10,0,1,36,13,13,0
"b7f2b31585d94eb3bf86376714aa7070","3f1c815879794b929260d224becaff7e",15719564,1,2,0,46,13,14,1
"b613861cecf84ffcab01afb23f660475","b613861cecf84ffcab01afb23f660475",19558289,4,0,1,1,1,1,0
"b613861cecf84ffcab01afb23f660475","e2911e79efc2420eac45d9f671463d4b",19558289,1,3,0,5,1,2,1
"e2911e79efc2420eac45d9f671463d4b","e2911e79efc2420eac45d9f671463d4b",19558289,2,0,1,6,2,2,0
"e2911e79efc2420eac45d9f671463d4b","519d1b8c59404d67b54e96c5c8a830b2",19558289,1,1,0,8,2,3,1
"519d1b8c59404d67b54e96c5c8a830b2","519d1b8c59404d67b54e96c5c8a830b2",19558289,1,0,1,9,3,3,0
"519d1b8c59404d67b54e96c5c8a830b2","531db53f81f646edb0cdcfe0085b03b7",19558289,1,1,0,10,3,4,1
"531db53f81f646edb0cdcfe0085b03b7","531db53f81f646edb0cdcfe0085b03b7",19558289,1,0,1,11,4,4,0
"531db53f81f646edb0cdcfe0085b03b7","4f5f94b2f95141e0a9d53a61da2276da",19558289,1,1,0,12,4,5,1
"4f5f94b2f95141e0a9d53a61da2276da","4f5f94b2f95141e0a9d53a61da2276da",19558289,1,0,1,13,5,5,0
"4f5f94b2f95141e0a9d53a61da2276da","6d541c89590949f99af293c4f2333f67",19558289,1,1,0,14,5,6,1
"6d541c89590949f99af293c4f2333f67","6d541c89590949f99af293c4f2333f67",19558289,1,0,1,15,6,6,0
"6d541c89590949f99af293c4f2333f67","dd5cf0b9fe4c4f1d8f5ff8e4c04879cb",19558289,1,1,0,16,6,7,1
"dd5cf0b9fe4c4f1d8f5ff8e4c04879cb","dd5cf0b9fe4c4f1d8f5ff8e4c04879cb",19558289,1,0,1,17,7,7,0
"dd5cf0b9fe4c4f1d8f5ff8e4c04879cb","f96261861edc426abe2248be4f0a709a",19558289,1,1,0,18,7,8,1
"f96261861edc426abe2248be4f0a709a","f96261861edc426abe2248be4f0a709a",19558289,1,0,1,19,8,8,0
"f96261861edc426abe2248be4f0a709a","66b5e16f4f75454fb5b8172079f0fa83",19558289,1,1,0,20,8,9,1
"66b5e16f4f75454fb5b8172079f0fa83","66b5e16f4f75454fb5b8172079f0fa83",19558289,1,0,1,21,9,9,0
"66b5e16f4f75454fb5b8172079f0fa83","0680571d4698477995e41842c36a54b2",19558289,1,1,0,22,9,10,1
"0680571d4698477995e41842c36a54b2","0680571d4698477995e41842c36a54b2",19558289,1,0,1,23,10,10,0
"0680571d4698477995e41842c36a54b2","9112f2bffece48e08c6d2287be204085",19558289,1,1,0,24,10,11,1
"9112f2bffece48e08c6d2287be204085","9112f2bffece48e08c6d2287be204085",19558289,1,0,1,25,11,11,0
"9112f2bffece48e08c6d2287be204085","e2911e79efc2420eac45d9f671463d4b",19558289,1,-9,0,26,11,2,-9
"e2911e79efc2420eac45d9f671463d4b","56586aa865414f538729c7f7735d2bc6",19558289,1,12,0,27,2,12,10
"56586aa865414f538729c7f7735d2bc6","56586aa865414f538729c7f7735d2bc6",19558289,3,0,1,28,12,12,0
"56586aa865414f538729c7f7735d2bc6","b7f2b31585d94eb3bf86376714aa7070",19558289,1,2,0,31,12,13,1
"b7f2b31585d94eb3bf86376714aa7070","b7f2b31585d94eb3bf86376714aa7070",19558289,1,0,1,32,13,13,0
"b613861cecf84ffcab01afb23f660475","b613861cecf84ffcab01afb23f660475",22850136,4,0,1,1,1,1,0
"b613861cecf84ffcab01afb23f660475","e2911e79efc2420eac45d9f671463d4b",22850136,1,3,0,5,1,2,1
"e2911e79efc2420eac45d9f671463d4b","e2911e79efc2420eac45d9f671463d4b",22850136,2,0,1,6,2,2,0
"e2911e79efc2420eac45d9f671463d4b","519d1b8c59404d67b54e96c5c8a830b2",22850136,1,1,0,8,2,3,1
"519d1b8c59404d67b54e96c5c8a830b2","519d1b8c59404d67b54e96c5c8a830b2",22850136,1,0,1,9,3,3,0
"519d1b8c59404d67b54e96c5c8a830b2","531db53f81f646edb0cdcfe0085b03b7",22850136,1,1,0,10,3,4,1
"531db53f81f646edb0cdcfe0085b03b7","531db53f81f646edb0cdcfe0085b03b7",22850136,1,0,1,11,4,4,0
"531db53f81f646edb0cdcfe0085b03b7","4f5f94b2f95141e0a9d53a61da2276da",22850136,1,1,0,12,4,5,1
"4f5f94b2f95141e0a9d53a61da2276da","4f5f94b2f95141e0a9d53a61da2276da",22850136,1,0,1,13,5,5,0
"4f5f94b2f95141e0a9d53a61da2276da","6d541c89590949f99af293c4f2333f67",22850136,1,1,0,14,5,6,1
"6d541c89590949f99af293c4f2333f67","6d541c89590949f99af293c4f2333f67",22850136,1,0,1,15,6,6,0
"6d541c89590949f99af293c4f2333f67","dd5cf0b9fe4c4f1d8f5ff8e4c04879cb",22850136,1,1,0,16,6,7,1
"dd5cf0b9fe4c4f1d8f5ff8e4c04879cb","dd5cf0b9fe4c4f1d8f5ff8e4c04879cb",22850136,1,0,1,17,7,7,0
"dd5cf0b9fe4c4f1d8f5ff8e4c04879cb","f96261861edc426abe2248be4f0a709a",22850136,1,1,0,18,7,8,1
"f96261861edc426abe2248be4f0a709a","f96261861edc426abe2248be4f0a709a",22850136,1,0,1,19,8,8,0
"f96261861edc426abe2248be4f0a709a","66b5e16f4f75454fb5b8172079f0fa83",22850136,1,1,0,20,8,9,1
"66b5e16f4f75454fb5b8172079f0fa83","66b5e16f4f75454fb5b8172079f0fa83",22850136,1,0,1,21,9,9,0
"66b5e16f4f75454fb5b8172079f0fa83","0680571d4698477995e41842c36a54b2",22850136,1,1,0,22,9,10,1
"0680571d4698477995e41842c36a54b2","0680571d4698477995e41842c36a54b2",22850136,1,0,1,23,10,10,0
"0680571d4698477995e41842c36a54b2","9112f2bffece48e08c6d2287be204085",22850136,1,1,0,24,10,11,1
"9112f2bffece48e08c6d2287be204085","9112f2bffece48e08c6d2287be204085",22850136,1,0,1,25,11,11,0
"9112f2bffece48e08c6d2287be204085","56586aa865414f538729c7f7735d2bc6",22850136,1,3,0,26,11,12,1
"56586aa865414f538729c7f7735d2bc6","e2911e79efc2420eac45d9f671463d4b",22850136,1,-12,0,27,12,2,-10
"e2911e79efc2420eac45d9f671463d4b","56586aa865414f538729c7f7735d2bc6",22850136,1,12,0,28,2,12,10
"56586aa865414f538729c7f7735d2bc6","56586aa865414f538729c7f7735d2bc6",22850136,5,0,1,29,12,12,0
"56586aa865414f538729c7f7735d2bc6","b7f2b31585d94eb3bf86376714aa7070",22850136,2,2,0,34,12,13,1
"b7f2b31585d94eb3bf86376714aa7070","56586aa865414f538729c7f7735d2bc6",22850136,1,-2,0,35,13,12,-1
"b7f2b31585d94eb3bf86376714aa7070","b7f2b31585d94eb3bf86376714aa7070",22850136,1,0,1,37,13,13,0
"b7f2b31585d94eb3bf86376714aa7070","3f1c815879794b929260d224becaff7e",22850136,1,2,0,38,13,14,1
"3f1c815879794b929260d224becaff7e","81c864a886d54a6b8ff85f7d736f4f95",22850136,1,2,0,39,14,15,1
"81c864a886d54a6b8ff85f7d736f4f95","5c5ceeee4562457ba6d41515aeebfbb1",22850136,1,4,0,40,15,17,2
"5c5ceeee4562457ba6d41515aeebfbb1","5c5ceeee4562457ba6d41515aeebfbb1",22850136,1,0,1,41,17,17,0
"5c5ceeee4562457ba6d41515aeebfbb1","56586aa865414f538729c7f7735d2bc6",22850136,1,-10,0,42,17,12,-5
"56586aa865414f538729c7f7735d2bc6","9afd71a5298d4333b6849dfce1b9422c",22850136,1,13,0,43,12,18,6
"9afd71a5298d4333b6849dfce1b9422c","b7719e26494940efa49512aedd0aac79",22850136,1,4,0,44,18,20,2
"b7719e26494940efa49512aedd0aac79","9afd71a5298d4333b6849dfce1b9422c",22850136,1,-4,0,45,20,18,-2
"9afd71a5298d4333b6849dfce1b9422c","d4f45188d3c84a02ba08454e6403a818",22850136,1,9,0,46,18,24,6
"d4f45188d3c84a02ba08454e6403a818","d4c3b003e8274e429d2fa688d73fde6d",22850136,1,-2,0,47,24,22,-2
"d4c3b003e8274e429d2fa688d73fde6d","d4c3b003e8274e429d2fa688d73fde6d",22850136,1,0,1,48,22,22,0
"d4c3b003e8274e429d2fa688d73fde6d","b7719e26494940efa49512aedd0aac79",22850136,1,-3,0,49,22,20,-2
"b7719e26494940efa49512aedd0aac79","b7719e26494940efa49512aedd0aac79",22850136,1,0,1,50,20,20,0
"b7719e26494940efa49512aedd0aac79","afbf7250b99d47bea07172749483ca97",22850136,1,12,0,51,20,28,8
"afbf7250b99d47bea07172749483ca97","afbf7250b99d47bea07172749483ca97",22850136,1,0,1,52,28,28,0
"afbf7250b99d47bea07172749483ca97","4e51676dc72045d99c19b9fa7b22f8bc",22850136,1,3,0,53,28,29,1
"4e51676dc72045d99c19b9fa7b22f8bc","4e51676dc72045d99c19b9fa7b22f8bc",22850136,1,0,1,54,29,29,0
"4e51676dc72045d99c19b9fa7b22f8bc","51970cfa30e643e894e66ae85c8024cc",22850136,1,3,0,55,29,31,2
"51970cfa30e643e894e66ae85c8024cc","4e51676dc72045d99c19b9fa7b22f8bc",22850136,1,-3,0,56,31,29,-2
"4e51676dc72045d99c19b9fa7b22f8bc","c33c17be71ae4d588da7369472e5bb1b",22850136,1,9,0,57,29,34,5
"c33c17be71ae4d588da7369472e5bb1b","c33c17be71ae4d588da7369472e5bb1b",22850136,1,0,1,58,34,34,0
"c33c17be71ae4d588da7369472e5bb1b","93679be414554a11b1893002f2229a93",22850136,1,3,0,59,34,35,1
"93679be414554a11b1893002f2229a93","93679be414554a11b1893002f2229a93",22850136,1,0,1,60,35,35,0
"93679be414554a11b1893002f2229a93","7040a13096d746ac84b8fac8d9752058",22850136,1,3,0,61,35,36,1
"7040a13096d746ac84b8fac8d9752058","7040a13096d746ac84b8fac8d9752058",22850136,1,0,1,62,36,36,0
"7040a13096d746ac84b8fac8d9752058","9a0dc646f934470daf08c4b56ccf73db",22850136,1,3,0,63,36,37,1
"9a0dc646f934470daf08c4b56ccf73db","9a0dc646f934470daf08c4b56ccf73db",22850136,1,0,1,64,37,37,0
"9a0dc646f934470daf08c4b56ccf73db","fc0e049d56024bc9a02c9a9c435c3df7",22850136,1,3,0,65,37,38,1
"fc0e049d56024bc9a02c9a9c435c3df7","fc0e049d56024bc9a02c9a9c435c3df7",22850136,1,0,1,66,38,38,0
"fc0e049d56024bc9a02c9a9c435c3df7","67a089198fcb4e1c8f2385786c2b296f",22850136,1,4,0,67,38,39,1
"67a089198fcb4e1c8f2385786c2b296f","64d48c6c9c7940639a932219a6c87198",22850136,1,1,0,68,39,40,1
"64d48c6c9c7940639a932219a6c87198","64d48c6c9c7940639a932219a6c87198",22850136,1,0,1,69,40,40,0
"64d48c6c9c7940639a932219a6c87198","67a089198fcb4e1c8f2385786c2b296f",22850136,1,-1,0,70,40,39,-1
"67a089198fcb4e1c8f2385786c2b296f","b534b89233134e30a9b5645138bfa9ee",22850136,1,4,0,71,39,41,2
"b534b89233134e30a9b5645138bfa9ee","0e37b720d23b4e7f8b313e79313fd107",22850136,1,3,0,72,41,44,3
"0e37b720d23b4e7f8b313e79313fd107","0e37b720d23b4e7f8b313e79313fd107",22850136,1,0,1,73,44,44,0
"0e37b720d23b4e7f8b313e79313fd107","6875d67fdd5f48168b62719df449bebd",22850136,1,1,0,74,44,45,1
"6875d67fdd5f48168b62719df449bebd","6875d67fdd5f48168b62719df449bebd",22850136,1,0,1,75,45,45,0
"6875d67fdd5f48168b62719df449bebd","6e13d61a7bdb44bca949c9f86fab3be5",22850136,1,3,0,76,45,47,2
"6e13d61a7bdb44bca949c9f86fab3be5","195f78799f984cc2b06c48dfe36be751",22850136,1,2,0,79,47,49,2
"195f78799f984cc2b06c48dfe36be751","195f78799f984cc2b06c48dfe36be751",22850136,2,0,1,80,49,49,0
"195f78799f984cc2b06c48dfe36be751","d9c8d8c444a64dadbbb508652c721e17",22850136,1,-3,0,82,49,46,-3
"d9c8d8c444a64dadbbb508652c721e17","d0c74f735e024943943e40333d6d337f",22850136,1,6,0,83,46,51,5
"d0c74f735e024943943e40333d6d337f","d0c74f735e024943943e40333d6d337f",22850136,1,0,1,84,51,51,0
"d0c74f735e024943943e40333d6d337f","983f8ff320594b279a7f4a6fe132f9c5",22850136,1,2,0,85,51,53,2
"983f8ff320594b279a7f4a6fe132f9c5","983f8ff320594b279a7f4a6fe132f9c5",22850136,2,0,1,86,53,53,0
"983f8ff320594b279a7f4a6fe132f9c5","35adfa5d923046aebabfefd98f35ff05",22850136,1,1,0,88,53,54,1
"35adfa5d923046aebabfefd98f35ff05","35adfa5d923046aebabfefd98f35ff05",22850136,5,0,1,89,54,54,0
"35adfa5d923046aebabfefd98f35ff05","b6f8a98476224da1b40e555ececc7ed8",22850136,1,1,0,94,54,55,1
"b6f8a98476224da1b40e555ececc7ed8","b6f8a98476224da1b40e555ececc7ed8",22850136,2,0,1,95,55,55,0
"b6f8a98476224da1b40e555ececc7ed8","86e22cb5fe0e4b47a9489ecddf7ed78f",22850136,1,1,0,97,55,56,1
"86e22cb5fe0e4b47a9489ecddf7ed78f","86e22cb5fe0e4b47a9489ecddf7ed78f",22850136,2,0,1,98,56,56,0
"86e22cb5fe0e4b47a9489ecddf7ed78f","f924752d8a1149668870b1e7698486f7",22850136,1,-6,0,100,56,50,-6
"f924752d8a1149668870b1e7698486f7","a1f2f12debe5432fb7a70bcd12bacfb9",22850136,1,9,0,101,50,58,8
"a1f2f12debe5432fb7a70bcd12bacfb9","78f30e4dcac84e3cbea8b2cc6e0d62b3",22850136,2,1,0,102,58,59,1
"78f30e4dcac84e3cbea8b2cc6e0d62b3","a1f2f12debe5432fb7a70bcd12bacfb9",22850136,2,-1,0,103,59,58,-1
"a1f2f12debe5432fb7a70bcd12bacfb9","a1f2f12debe5432fb7a70bcd12bacfb9",22850136,30,0,1,104,58,58,0
"a1f2f12debe5432fb7a70bcd12bacfb9","12aa6e1672ac4e7aa6449a7a8609cd72",22850136,1,-1,0,121,58,57,-1
"12aa6e1672ac4e7aa6449a7a8609cd72","d0c74f735e024943943e40333d6d337f",22850136,1,-7,0,122,57,51,-6
"d0c74f735e024943943e40333d6d337f","6e13d61a7bdb44bca949c9f86fab3be5",22850136,1,-5,0,123,51,47,-4
"6e13d61a7bdb44bca949c9f86fab3be5","f924752d8a1149668870b1e7698486f7",22850136,1,4,0,124,47,50,3
"f924752d8a1149668870b1e7698486f7","d9c8d8c444a64dadbbb508652c721e17",22850136,1,-5,0,125,50,46,-4
"d9c8d8c444a64dadbbb508652c721e17","6e13d61a7bdb44bca949c9f86fab3be5",22850136,1,1,0,126,46,47,1
"6e13d61a7bdb44bca949c9f86fab3be5","b534b89233134e30a9b5645138bfa9ee",22850136,2,-7,0,127,47,41,-6
"b534b89233134e30a9b5645138bfa9ee","6e13d61a7bdb44bca949c9f86fab3be5",22850136,2,7,0,128,41,47,6
"6e13d61a7bdb44bca949c9f86fab3be5","78f30e4dcac84e3cbea8b2cc6e0d62b3",22850136,1,14,0,129,47,59,12
"a1f2f12debe5432fb7a70bcd12bacfb9","d9c8d8c444a64dadbbb508652c721e17",22850136,1,-14,0,131,58,46,-12
"d9c8d8c444a64dadbbb508652c721e17","a1f2f12debe5432fb7a70bcd12bacfb9",22850136,1,14,0,132,46,58,12
"78f30e4dcac84e3cbea8b2cc6e0d62b3","78f30e4dcac84e3cbea8b2cc6e0d62b3",22850136,11,0,1,147,59,59,0
"78f30e4dcac84e3cbea8b2cc6e0d62b3","a0a418b8540d479fa6e0f653b701da8b",22850136,1,6,0,158,59,64,5
"a0a418b8540d479fa6e0f653b701da8b","bc42d26810654ea9a1df1efe1e58c7d5",22850136,1,-1,0,159,64,63,-1
"bc42d26810654ea9a1df1efe1e58c7d5","12aa6e1672ac4e7aa6449a7a8609cd72",22850136,1,-7,0,160,63,57,-6
"12aa6e1672ac4e7aa6449a7a8609cd72","4c943503763e4e349906eea3ed3c8e86",22850136,1,5,0,161,57,61,4
"4c943503763e4e349906eea3ed3c8e86","4c943503763e4e349906eea3ed3c8e86",22850136,1,0,1,162,61,61,0
"4c943503763e4e349906eea3ed3c8e86","309ccf3cc4fe429d9bfbaef53d3fa479",22850136,1,-1,0,163,61,60,-1
"309ccf3cc4fe429d9bfbaef53d3fa479","d646286c8051419bbc2e31dd1db55ca8",22850136,1,10,0,164,60,67,7
"d646286c8051419bbc2e31dd1db55ca8","b534b89233134e30a9b5645138bfa9ee",22850136,1,-33,0,165,67,41,-26
"b534b89233134e30a9b5645138bfa9ee","267f883678b24aed855fde42524975d9",22850136,1,37,0,166,41,71,30
"267f883678b24aed855fde42524975d9","267f883678b24aed855fde42524975d9",22850136,1,0,1,167,71,71,0
"267f883678b24aed855fde42524975d9","88fff56d0342490dbef9040750a20f6c",22850136,1,1,0,168,71,72,1
"88fff56d0342490dbef9040750a20f6c","88fff56d0342490dbef9040750a20f6c",22850136,1,0,1,169,72,72,0
"88fff56d0342490dbef9040750a20f6c","adb17b12b66c4a49a85fd34322f7df70",22850136,1,1,0,170,72,73,1
"adb17b12b66c4a49a85fd34322f7df70","adb17b12b66c4a49a85fd34322f7df70",22850136,1,0,1,171,73,73,0
"adb17b12b66c4a49a85fd34322f7df70","d646286c8051419bbc2e31dd1db55ca8",22850136,1,-6,0,172,73,67,-6
"d646286c8051419bbc2e31dd1db55ca8","a2becd407db34b189200a32546d9d569",22850136,1,9,0,173,67,75,8
"a2becd407db34b189200a32546d9d569","58c22b011d0f4c2ea6d13615edbb9eeb",22850136,1,2,0,174,75,77,2
"58c22b011d0f4c2ea6d13615edbb9eeb","58c22b011d0f4c2ea6d13615edbb9eeb",22850136,2,0,1,175,77,77,0
"58c22b011d0f4c2ea6d13615edbb9eeb","dd76e1861dc9461c830888729d091ee0",22850136,1,1,0,177,77,78,1
"dd76e1861dc9461c830888729d091ee0","dd76e1861dc9461c830888729d091ee0",22850136,2,0,1,178,78,78,0
"dd76e1861dc9461c830888729d091ee0","cd1d828f1a694b87913a7ea66c23803e",22850136,1,1,0,180,78,79,1
"cd1d828f1a694b87913a7ea66c23803e","cd1d828f1a694b87913a7ea66c23803e",22850136,5,0,1,181,79,79,0
"cd1d828f1a694b87913a7ea66c23803e","9176a3c2b4d2465fa8b0c67096c2a97e",22850136,1,1,0,186,79,80,1
"9176a3c2b4d2465fa8b0c67096c2a97e","9176a3c2b4d2465fa8b0c67096c2a97e",22850136,11,0,1,187,80,80,0
"9176a3c2b4d2465fa8b0c67096c2a97e","f8ec6445f7194e25b9101d4fbcb07a18",22850136,1,1,0,198,80,81,1
"f8ec6445f7194e25b9101d4fbcb07a18","f8ec6445f7194e25b9101d4fbcb07a18",22850136,2,0,1,199,81,81,0
"f8ec6445f7194e25b9101d4fbcb07a18","140d5b27b8574befad82c0a013b59dfa",22850136,1,-7,0,201,81,74,-7
"140d5b27b8574befad82c0a013b59dfa","d18a9ea32855445f8736581f5cb119ce",22850136,1,9,0,202,74,82,8
"d18a9ea32855445f8736581f5cb119ce","f564483cbd7a407681aa2fcca518cf5f",22850136,1,4,0,203,82,85,3
"f564483cbd7a407681aa2fcca518cf5f","f564483cbd7a407681aa2fcca518cf5f",22850136,1,0,1,204,85,85,0
"f564483cbd7a407681aa2fcca518cf5f","18fd01350bd5434ca636d59a599d768a",22850136,1,1,0,205,85,86,1
"18fd01350bd5434ca636d59a599d768a","18fd01350bd5434ca636d59a599d768a",22850136,8,0,1,206,86,86,0
"18fd01350bd5434ca636d59a599d768a","6a9f0ef185fb47f0937e29daa1c71ed5",22850136,1,5,0,214,86,90,4
"6a9f0ef185fb47f0937e29daa1c71ed5","ae5ac430ea254e708a6f5deaaf7464ae",22850136,1,-7,0,215,90,84,-6
"ae5ac430ea254e708a6f5deaaf7464ae","c681290961c94c4caf23b529d1ae6b9a",22850136,1,5,0,216,84,88,4
"c681290961c94c4caf23b529d1ae6b9a","c681290961c94c4caf23b529d1ae6b9a",22850136,1,0,1,217,88,88,0
"c681290961c94c4caf23b529d1ae6b9a","6a9f0ef185fb47f0937e29daa1c71ed5",22850136,1,2,0,218,88,90,2
"6a9f0ef185fb47f0937e29daa1c71ed5","6a9f0ef185fb47f0937e29daa1c71ed5",22850136,3,0,1,219,90,90,0
"6a9f0ef185fb47f0937e29daa1c71ed5","e20db35ced8544ddac5bc3839145e463",22850136,1,3,0,222,90,91,1
"e20db35ced8544ddac5bc3839145e463","d646286c8051419bbc2e31dd1db55ca8",22850136,1,-30,0,223,91,67,-24
"d646286c8051419bbc2e31dd1db55ca8","1febb706d7a34005ae8711ed49c76e64",22850136,1,33,0,224,67,94,27
"1febb706d7a34005ae8711ed49c76e64","1febb706d7a34005ae8711ed49c76e64",22850136,2,0,1,225,94,94,0
"1febb706d7a34005ae8711ed49c76e64","8f73ba6f5a0042f2850356ac38ac6f24",22850136,1,1,0,227,94,95,1
"8f73ba6f5a0042f2850356ac38ac6f24","8f73ba6f5a0042f2850356ac38ac6f24",22850136,5,0,1,228,95,95,0
"8f73ba6f5a0042f2850356ac38ac6f24","e2260b86653c46d7b14a41fb419dbf8c",22850136,1,1,0,233,95,96,1
"e2260b86653c46d7b14a41fb419dbf8c","e2260b86653c46d7b14a41fb419dbf8c",22850136,2,0,1,234,96,96,0
"e2260b86653c46d7b14a41fb419dbf8c","35eb641ad1d845bbba54915bce75a962",22850136,1,1,0,236,96,97,1
"35eb641ad1d845bbba54915bce75a962","35eb641ad1d845bbba54915bce75a962",22850136,5,0,1,237,97,97,0
"35eb641ad1d845bbba54915bce75a962","08be90ffbeea4795a138cd42ed8db56f",22850136,1,1,0,242,97,98,1
"08be90ffbeea4795a138cd42ed8db56f","08be90ffbeea4795a138cd42ed8db56f",22850136,5,0,1,243,98,98,0
"08be90ffbeea4795a138cd42ed8db56f","3007433c8f584dcbb5ac159c1c5f2be3",22850136,1,1,0,248,98,99,1
"3007433c8f584dcbb5ac159c1c5f2be3","3007433c8f584dcbb5ac159c1c5f2be3",22850136,5,0,1,249,99,99,0
"3007433c8f584dcbb5ac159c1c5f2be3","00ae5f0c51874a73a41ebea838d95682",22850136,1,3,0,254,99,101,2
"00ae5f0c51874a73a41ebea838d95682","e20db35ced8544ddac5bc3839145e463",22850136,1,-11,0,255,101,91,-10
"e20db35ced8544ddac5bc3839145e463","d391c8b6e56a43a7b654e9dee02d904b",22850136,1,13,0,256,91,103,12
"d391c8b6e56a43a7b654e9dee02d904b","4280927ec4d643238aa49c32f9e06c6c",22850136,1,7,0,257,103,109,6
"4280927ec4d643238aa49c32f9e06c6c","73039f8c1eb9409cb4caee2cf968001e",22850136,1,-10,0,258,109,100,-9
"73039f8c1eb9409cb4caee2cf968001e","a9ae0a3c070d455bb4369a8996313336",22850136,1,16,0,259,100,114,14
"a9ae0a3c070d455bb4369a8996313336","08111f75e22d409998cf8b85bd431f0a",22850136,2,-7,0,260,114,108,-6
"08111f75e22d409998cf8b85bd431f0a","37319e88176d4aefa91d7a9980dbae91",22850136,1,5,0,261,108,112,4
"37319e88176d4aefa91d7a9980dbae91","62bff51286ef4f348717a3cf6fe2318f",22850136,2,9,0,262,112,120,8
"62bff51286ef4f348717a3cf6fe2318f","3ec3a3563847406fa73338f9e9999cf3",22850136,1,-3,0,263,120,117,-3
"3ec3a3563847406fa73338f9e9999cf3","00ae5f0c51874a73a41ebea838d95682",22850136,1,-19,0,264,117,101,-16
"00ae5f0c51874a73a41ebea838d95682","d391c8b6e56a43a7b654e9dee02d904b",22850136,1,2,0,265,101,103,2
"d391c8b6e56a43a7b654e9dee02d904b","d391c8b6e56a43a7b654e9dee02d904b",22850136,16,0,1,266,103,103,0
"d391c8b6e56a43a7b654e9dee02d904b","6111116566fc4fd9abba409322bea245",22850136,1,1,0,282,103,104,1
"6111116566fc4fd9abba409322bea245","6111116566fc4fd9abba409322bea245",22850136,2,0,1,283,104,104,0
"6111116566fc4fd9abba409322bea245","a81b2235cb9c499eb9ea8ee0a8dd9725",22850136,1,1,0,285,104,105,1
"a81b2235cb9c499eb9ea8ee0a8dd9725","a81b2235cb9c499eb9ea8ee0a8dd9725",22850136,5,0,1,286,105,105,0
"a81b2235cb9c499eb9ea8ee0a8dd9725","2d4e0ab0ef3b4d73b82c72d4621a7579",22850136,1,1,0,291,105,106,1
"2d4e0ab0ef3b4d73b82c72d4621a7579","2d4e0ab0ef3b4d73b82c72d4621a7579",22850136,2,0,1,292,106,106,0
"2d4e0ab0ef3b4d73b82c72d4621a7579","8bdebf492ebd4e62b0d522e8ab5e5197",22850136,1,1,0,294,106,107,1
"8bdebf492ebd4e62b0d522e8ab5e5197","8bdebf492ebd4e62b0d522e8ab5e5197",22850136,5,0,1,295,107,107,0
"8bdebf492ebd4e62b0d522e8ab5e5197","73039f8c1eb9409cb4caee2cf968001e",22850136,1,-7,0,300,107,100,-7
"73039f8c1eb9409cb4caee2cf968001e","4280927ec4d643238aa49c32f9e06c6c",22850136,1,10,0,301,100,109,9
"4280927ec4d643238aa49c32f9e06c6c","fc44e6a5f7654430af1227838224dceb",22850136,1,2,0,302,109,111,2
"fc44e6a5f7654430af1227838224dceb","fc44e6a5f7654430af1227838224dceb",22850136,2,0,1,303,111,111,0
"fc44e6a5f7654430af1227838224dceb","a9ae0a3c070d455bb4369a8996313336",22850136,1,4,0,305,111,114,3
"08111f75e22d409998cf8b85bd431f0a","71cec822bcff4f30a20e75dc63ef7b65",22850136,1,9,0,307,108,116,8
"71cec822bcff4f30a20e75dc63ef7b65","71cec822bcff4f30a20e75dc63ef7b65",22850136,1,0,1,308,116,116,0
"71cec822bcff4f30a20e75dc63ef7b65","37319e88176d4aefa91d7a9980dbae91",22850136,1,-4,0,309,116,112,-4
"62bff51286ef4f348717a3cf6fe2318f","b1cd0e7dc3ad4a8eb91a4bfdbeb025b0",22850136,1,-2,0,311,120,118,-2
"b1cd0e7dc3ad4a8eb91a4bfdbeb025b0","b1cd0e7dc3ad4a8eb91a4bfdbeb025b0",22850136,1,0,1,312,118,118,0
"b1cd0e7dc3ad4a8eb91a4bfdbeb025b0","62bff51286ef4f348717a3cf6fe2318f",22850136,1,2,0,313,118,120,2
"62bff51286ef4f348717a3cf6fe2318f","62bff51286ef4f348717a3cf6fe2318f",22850136,3,0,1,314,120,120,0
"62bff51286ef4f348717a3cf6fe2318f","e20db35ced8544ddac5bc3839145e463",22850136,1,-33,0,317,120,91,-29
"e20db35ced8544ddac5bc3839145e463","779f9ddd1fd14d1e9e69f72219a1fdbd",22850136,1,36,0,318,91,121,30
"779f9ddd1fd14d1e9e69f72219a1fdbd","ae26e6cda8ad4a3f81bd347560d9579f",22850136,1,4,0,319,121,125,4
"ae26e6cda8ad4a3f81bd347560d9579f","ae26e6cda8ad4a3f81bd347560d9579f",22850136,3,0,1,320,125,125,0
"ae26e6cda8ad4a3f81bd347560d9579f","ee48df95832b4374aa273ceb27ec1315",22850136,1,1,0,323,125,126,1
"ee48df95832b4374aa273ceb27ec1315","ee48df95832b4374aa273ceb27ec1315",22850136,1,0,1,324,126,126,0
"ee48df95832b4374aa273ceb27ec1315","7a439da90b394756ad1777fc4c6dead5",22850136,1,1,0,325,126,127,1
"7a439da90b394756ad1777fc4c6dead5","7a439da90b394756ad1777fc4c6dead5",22850136,1,0,1,326,127,127,0
"7a439da90b394756ad1777fc4c6dead5","a8dd5213034441ac92724b4e83eb0bb2",22850136,1,3,0,327,127,129,2
"a8dd5213034441ac92724b4e83eb0bb2","779f9ddd1fd14d1e9e69f72219a1fdbd",22850136,1,-9,0,328,129,121,-8
"779f9ddd1fd14d1e9e69f72219a1fdbd","8115eab6556b45f5b415c3b8c26a12e5",22850136,1,11,0,329,121,131,10
"8115eab6556b45f5b415c3b8c26a12e5","8115eab6556b45f5b415c3b8c26a12e5",22850136,11,0,1,330,131,131,0
"8115eab6556b45f5b415c3b8c26a12e5","ec34b06efd844b46a4c4818ecdb9b8f4",22850136,1,1,0,341,131,132,1
"ec34b06efd844b46a4c4818ecdb9b8f4","ec34b06efd844b46a4c4818ecdb9b8f4",22850136,8,0,1,342,132,132,0
"ec34b06efd844b46a4c4818ecdb9b8f4","c2e1c2b9eac64109b343a088584b576b",22850136,1,1,0,350,132,133,1
"c2e1c2b9eac64109b343a088584b576b","c2e1c2b9eac64109b343a088584b576b",22850136,5,0,1,351,133,133,0
"c2e1c2b9eac64109b343a088584b576b","579338175e0b4bbb8ef3b712b5d8b54e",22850136,1,-5,0,356,133,128,-5
"579338175e0b4bbb8ef3b712b5d8b54e","8bc5795d6a984a3eace4e2811e52dd4f",22850136,1,8,0,357,128,135,7
"8bc5795d6a984a3eace4e2811e52dd4f","8bc5795d6a984a3eace4e2811e52dd4f",22850136,1,0,1,358,135,135,0
"8bc5795d6a984a3eace4e2811e52dd4f","b416d47c56a742199b5d7c7f19d6503a",22850136,1,-1,0,359,135,134,-1
"b416d47c56a742199b5d7c7f19d6503a","cd4532ad48034873ba8bce2aac0c9808",22850136,1,4,0,360,134,137,3
"cd4532ad48034873ba8bce2aac0c9808","cd4532ad48034873ba8bce2aac0c9808",22850136,1,0,1,361,137,137,0
"cd4532ad48034873ba8bce2aac0c9808","779f9ddd1fd14d1e9e69f72219a1fdbd",22850136,1,-19,0,362,137,121,-16
"779f9ddd1fd14d1e9e69f72219a1fdbd","df1de691dafe4549a18a4398ee9dfaf9",22850136,1,23,0,363,121,139,18
"df1de691dafe4549a18a4398ee9dfaf9","6c5ad271a44743479bfaea29b1db8d02",22850136,1,4,0,364,139,143,4
"6c5ad271a44743479bfaea29b1db8d02","83d311bed5374fee83d8d67a7d9d82dc",22850136,1,1,0,365,143,144,1
"83d311bed5374fee83d8d67a7d9d82dc","83d311bed5374fee83d8d67a7d9d82dc",22850136,1,0,1,366,144,144,0
"83d311bed5374fee83d8d67a7d9d82dc","402bba41861d43acb52a5abb89e8831e",22850136,1,1,0,367,144,145,1
"402bba41861d43acb52a5abb89e8831e","402bba41861d43acb52a5abb89e8831e",22850136,2,0,1,368,145,145,0
"402bba41861d43acb52a5abb89e8831e","8aae34f5ddbb4052a709b12e6b0d40fa",22850136,1,3,0,370,145,147,2
"8aae34f5ddbb4052a709b12e6b0d40fa","df1de691dafe4549a18a4398ee9dfaf9",22850136,1,-9,0,371,147,139,-8
"df1de691dafe4549a18a4398ee9dfaf9","645b3f0249f64f76af2e19eb4d0e55b7",22850136,1,11,0,372,139,149,10
"645b3f0249f64f76af2e19eb4d0e55b7","645b3f0249f64f76af2e19eb4d0e55b7",22850136,2,0,1,373,149,149,0
"645b3f0249f64f76af2e19eb4d0e55b7","7e7b8db5064d4369805ab370aac5ddfb",22850136,1,1,0,375,149,150,1
"7e7b8db5064d4369805ab370aac5ddfb","7e7b8db5064d4369805ab370aac5ddfb",22850136,2,0,1,376,150,150,0
"7e7b8db5064d4369805ab370aac5ddfb","8956d210ae7f41968fada86d4c979d6a",22850136,1,1,0,378,150,151,1
"8956d210ae7f41968fada86d4c979d6a","8956d210ae7f41968fada86d4c979d6a",22850136,2,0,1,379,151,151,0
"8956d210ae7f41968fada86d4c979d6a","f902b0f41b544d4dbf79664fd233648d",22850136,1,-5,0,381,151,146,-5
"f902b0f41b544d4dbf79664fd233648d","ae781e8b775e4ccd93bc800dad5c8376",22850136,1,8,0,382,146,153,7
"ae781e8b775e4ccd93bc800dad5c8376","ae781e8b775e4ccd93bc800dad5c8376",22850136,2,0,1,383,153,153,0
"ae781e8b775e4ccd93bc800dad5c8376","06882a8492d9499aa31555567f575ecb",22850136,1,1,0,385,153,154,1
"06882a8492d9499aa31555567f575ecb","06882a8492d9499aa31555567f575ecb",22850136,1,0,1,386,154,154,0
"06882a8492d9499aa31555567f575ecb","f293c508f409466a8f27ddd7d1e40b20",22850136,1,1,0,387,154,155,1
"f293c508f409466a8f27ddd7d1e40b20","f293c508f409466a8f27ddd7d1e40b20",22850136,8,0,1,388,155,155,0
"f293c508f409466a8f27ddd7d1e40b20","cc4ddef5bbbe48ebb605141b347c4ed1",22850136,1,1,0,396,155,156,1
"cc4ddef5bbbe48ebb605141b347c4ed1","cc4ddef5bbbe48ebb605141b347c4ed1",22850136,3,0,1,397,156,156,0
"cc4ddef5bbbe48ebb605141b347c4ed1","f03480cf4eba413194d7af52fc0e7f28",22850136,1,-4,0,400,156,152,-4
"f03480cf4eba413194d7af52fc0e7f28","d313cec988a84645bee413e8d4724a4b",22850136,1,7,0,401,152,158,6
"d313cec988a84645bee413e8d4724a4b","d313cec988a84645bee413e8d4724a4b",22850136,4,0,1,402,158,158,0
"d313cec988a84645bee413e8d4724a4b","dc60696c76a74368a60f72246e47700d",22850136,1,1,0,406,158,159,1
"dc60696c76a74368a60f72246e47700d","dc60696c76a74368a60f72246e47700d",22850136,1,0,1,407,159,159,0
"dc60696c76a74368a60f72246e47700d","df1de691dafe4549a18a4398ee9dfaf9",22850136,1,-23,0,408,159,139,-20
"df1de691dafe4549a18a4398ee9dfaf9","78adeee1fa2c4fe0bc73f7bca9fcee86",22850136,1,26,0,409,139,160,21
"b613861cecf84ffcab01afb23f660475","b613861cecf84ffcab01afb23f660475",22850298,3,0,1,1,1,1,0
"b613861cecf84ffcab01afb23f660475","e2911e79efc2420eac45d9f671463d4b",22850298,2,3,0,4,1,2,1
"e2911e79efc2420eac45d9f671463d4b","b613861cecf84ffcab01afb23f660475",22850298,1,-3,0,5,2,1,-1
"e2911e79efc2420eac45d9f671463d4b","e2911e79efc2420eac45d9f671463d4b",22850298,1,0,1,7,2,2,0
"e2911e79efc2420eac45d9f671463d4b","519d1b8c59404d67b54e96c5c8a830b2",22850298,1,1,0,8,2,3,1
"519d1b8c59404d67b54e96c5c8a830b2","519d1b8c59404d67b54e96c5c8a830b2",22850298,1,0,1,9,3,3,0
"519d1b8c59404d67b54e96c5c8a830b2","531db53f81f646edb0cdcfe0085b03b7",22850298,1,1,0,10,3,4,1
"531db53f81f646edb0cdcfe0085b03b7","531db53f81f646edb0cdcfe0085b03b7",22850298,1,0,1,11,4,4,0
"531db53f81f646edb0cdcfe0085b03b7","4f5f94b2f95141e0a9d53a61da2276da",22850298,1,1,0,12,4,5,1
"4f5f94b2f95141e0a9d53a61da2276da","4f5f94b2f95141e0a9d53a61da2276da",22850298,1,0,1,13,5,5,0
"4f5f94b2f95141e0a9d53a61da2276da","6d541c89590949f99af293c4f2333f67",22850298,1,1,0,14,5,6,1
"6d541c89590949f99af293c4f2333f67","6d541c89590949f99af293c4f2333f67",22850298,1,0,1,15,6,6,0
"6d541c89590949f99af293c4f2333f67","dd5cf0b9fe4c4f1d8f5ff8e4c04879cb",22850298,1,1,0,16,6,7,1
"dd5cf0b9fe4c4f1d8f5ff8e4c04879cb","dd5cf0b9fe4c4f1d8f5ff8e4c04879cb",22850298,1,0,1,17,7,7,0
"dd5cf0b9fe4c4f1d8f5ff8e4c04879cb","f96261861edc426abe2248be4f0a709a",22850298,1,1,0,18,7,8,1
"f96261861edc426abe2248be4f0a709a","f96261861edc426abe2248be4f0a709a",22850298,1,0,1,19,8,8,0
"f96261861edc426abe2248be4f0a709a","66b5e16f4f75454fb5b8172079f0fa83",22850298,1,1,0,20,8,9,1
"66b5e16f4f75454fb5b8172079f0fa83","66b5e16f4f75454fb5b8172079f0fa83",22850298,1,0,1,21,9,9,0
"66b5e16f4f75454fb5b8172079f0fa83","0680571d4698477995e41842c36a54b2",22850298,1,1,0,22,9,10,1
"0680571d4698477995e41842c36a54b2","0680571d4698477995e41842c36a54b2",22850298,1,0,1,23,10,10,0
"0680571d4698477995e41842c36a54b2","9112f2bffece48e08c6d2287be204085",22850298,1,1,0,24,10,11,1
"9112f2bffece48e08c6d2287be204085","9112f2bffece48e08c6d2287be204085",22850298,1,0,1,25,11,11,0
"9112f2bffece48e08c6d2287be204085","e2911e79efc2420eac45d9f671463d4b",22850298,1,-9,0,26,11,2,-9
"e2911e79efc2420eac45d9f671463d4b","56586aa865414f538729c7f7735d2bc6",22850298,1,12,0,27,2,12,10
"56586aa865414f538729c7f7735d2bc6","56586aa865414f538729c7f7735d2bc6",22850298,7,0,1,28,12,12,0
"56586aa865414f538729c7f7735d2bc6","b7f2b31585d94eb3bf86376714aa7070",22850298,2,2,0,31,12,13,1
"b7f2b31585d94eb3bf86376714aa7070","56586aa865414f538729c7f7735d2bc6",22850298,1,-2,0,32,13,12,-1
"b7f2b31585d94eb3bf86376714aa7070","b7f2b31585d94eb3bf86376714aa7070",22850298,2,0,1,38,13,13,0
"b7f2b31585d94eb3bf86376714aa7070","3f1c815879794b929260d224becaff7e",22850298,1,2,0,40,13,14,1
"3f1c815879794b929260d224becaff7e","5c5ceeee4562457ba6d41515aeebfbb1",22850298,1,6,0,41,14,17,3
"5c5ceeee4562457ba6d41515aeebfbb1","81c864a886d54a6b8ff85f7d736f4f95",22850298,1,-4,0,42,17,15,-2
"81c864a886d54a6b8ff85f7d736f4f95","5c5ceeee4562457ba6d41515aeebfbb1",22850298,1,4,0,43,15,17,2
"5c5ceeee4562457ba6d41515aeebfbb1","56586aa865414f538729c7f7735d2bc6",22850298,1,-10,0,44,17,12,-5
"56586aa865414f538729c7f7735d2bc6","9afd71a5298d4333b6849dfce1b9422c",22850298,1,13,0,45,12,18,6
"9afd71a5298d4333b6849dfce1b9422c","b7719e26494940efa49512aedd0aac79",22850298,1,4,0,46,18,20,2
"b7719e26494940efa49512aedd0aac79","9afd71a5298d4333b6849dfce1b9422c",22850298,1,-4,0,47,20,18,-2
"9afd71a5298d4333b6849dfce1b9422c","d4f45188d3c84a02ba08454e6403a818",22850298,1,9,0,48,18,24,6
"d4f45188d3c84a02ba08454e6403a818","d4c3b003e8274e429d2fa688d73fde6d",22850298,1,-2,0,49,24,22,-2
"d4c3b003e8274e429d2fa688d73fde6d","d4c3b003e8274e429d2fa688d73fde6d",22850298,1,0,1,50,22,22,0
"d4c3b003e8274e429d2fa688d73fde6d","b7719e26494940efa49512aedd0aac79",22850298,1,-3,0,51,22,20,-2
"b7719e26494940efa49512aedd0aac79","b7719e26494940efa49512aedd0aac79",22850298,1,0,1,52,20,20,0
"b7719e26494940efa49512aedd0aac79","afbf7250b99d47bea07172749483ca97",22850298,1,12,0,53,20,28,8
"afbf7250b99d47bea07172749483ca97","afbf7250b99d47bea07172749483ca97",22850298,1,0,1,54,28,28,0
"afbf7250b99d47bea07172749483ca97","4e51676dc72045d99c19b9fa7b22f8bc",22850298,1,3,0,55,28,29,1
"4e51676dc72045d99c19b9fa7b22f8bc","4e51676dc72045d99c19b9fa7b22f8bc",22850298,1,0,1,56,29,29,0
"4e51676dc72045d99c19b9fa7b22f8bc","51970cfa30e643e894e66ae85c8024cc",22850298,1,3,0,57,29,31,2
"51970cfa30e643e894e66ae85c8024cc","c33c17be71ae4d588da7369472e5bb1b",22850298,1,6,0,58,31,34,3
"c33c17be71ae4d588da7369472e5bb1b","4e51676dc72045d99c19b9fa7b22f8bc",22850298,1,-9,0,59,34,29,-5
"4e51676dc72045d99c19b9fa7b22f8bc","93679be414554a11b1893002f2229a93",22850298,1,12,0,60,29,35,6
"93679be414554a11b1893002f2229a93","c33c17be71ae4d588da7369472e5bb1b",22850298,1,-3,0,61,35,34,-1
"c33c17be71ae4d588da7369472e5bb1b","7040a13096d746ac84b8fac8d9752058",22850298,1,6,0,62,34,36,2
"7040a13096d746ac84b8fac8d9752058","93679be414554a11b1893002f2229a93",22850298,1,-3,0,63,36,35,-1
"93679be414554a11b1893002f2229a93","9a0dc646f934470daf08c4b56ccf73db",22850298,1,6,0,64,35,37,2
"9a0dc646f934470daf08c4b56ccf73db","7040a13096d746ac84b8fac8d9752058",22850298,1,-3,0,65,37,36,-1
"7040a13096d746ac84b8fac8d9752058","fc0e049d56024bc9a02c9a9c435c3df7",22850298,1,6,0,66,36,38,2
"fc0e049d56024bc9a02c9a9c435c3df7","9a0dc646f934470daf08c4b56ccf73db",22850298,1,-3,0,67,38,37,-1
"9a0dc646f934470daf08c4b56ccf73db","fc0e049d56024bc9a02c9a9c435c3df7",22850298,1,3,0,68,37,38,1
"fc0e049d56024bc9a02c9a9c435c3df7","67a089198fcb4e1c8f2385786c2b296f",22850298,1,4,0,69,38,39,1
"67a089198fcb4e1c8f2385786c2b296f","64d48c6c9c7940639a932219a6c87198",22850298,1,1,0,70,39,40,1
"64d48c6c9c7940639a932219a6c87198","b534b89233134e30a9b5645138bfa9ee",22850298,1,3,0,71,40,41,1
"b534b89233134e30a9b5645138bfa9ee","b534b89233134e30a9b5645138bfa9ee",22850298,1,0,1,72,41,41,0
"b534b89233134e30a9b5645138bfa9ee","0e37b720d23b4e7f8b313e79313fd107",22850298,1,3,0,73,41,44,3
"0e37b720d23b4e7f8b313e79313fd107","0e37b720d23b4e7f8b313e79313fd107",22850298,1,0,1,74,44,44,0
"0e37b720d23b4e7f8b313e79313fd107","6875d67fdd5f48168b62719df449bebd",22850298,1,1,0,75,44,45,1
"6875d67fdd5f48168b62719df449bebd","6875d67fdd5f48168b62719df449bebd",22850298,1,0,1,76,45,45,0
"6875d67fdd5f48168b62719df449bebd","6e13d61a7bdb44bca949c9f86fab3be5",22850298,1,3,0,77,45,47,2
"6e13d61a7bdb44bca949c9f86fab3be5","b534b89233134e30a9b5645138bfa9ee",22850298,1,-7,0,78,47,41,-6
"b534b89233134e30a9b5645138bfa9ee","6e13d61a7bdb44bca949c9f86fab3be5",22850298,1,7,0,79,41,47,6
"6e13d61a7bdb44bca949c9f86fab3be5","195f78799f984cc2b06c48dfe36be751",22850298,1,2,0,80,47,49,2
"195f78799f984cc2b06c48dfe36be751","195f78799f984cc2b06c48dfe36be751",22850298,2,0,1,81,49,49,0
"195f78799f984cc2b06c48dfe36be751","d9c8d8c444a64dadbbb508652c721e17",22850298,1,-3,0,83,49,46,-3
"d9c8d8c444a64dadbbb508652c721e17","d0c74f735e024943943e40333d6d337f",22850298,1,6,0,84,46,51,5
"d0c74f735e024943943e40333d6d337f","d0c74f735e024943943e40333d6d337f",22850298,1,0,1,85,51,51,0
"d0c74f735e024943943e40333d6d337f","983f8ff320594b279a7f4a6fe132f9c5",22850298,1,2,0,86,51,53,2
"983f8ff320594b279a7f4a6fe132f9c5","983f8ff320594b279a7f4a6fe132f9c5",22850298,2,0,1,87,53,53,0
"983f8ff320594b279a7f4a6fe132f9c5","35adfa5d923046aebabfefd98f35ff05",22850298,1,1,0,89,53,54,1
"35adfa5d923046aebabfefd98f35ff05","35adfa5d923046aebabfefd98f35ff05",22850298,8,0,1,90,54,54,0
"35adfa5d923046aebabfefd98f35ff05","b6f8a98476224da1b40e555ececc7ed8",22850298,1,1,0,98,54,55,1
"b6f8a98476224da1b40e555ececc7ed8","b6f8a98476224da1b40e555ececc7ed8",22850298,2,0,1,100,55,55,0
"b6f8a98476224da1b40e555ececc7ed8","86e22cb5fe0e4b47a9489ecddf7ed78f",22850298,1,1,0,101,55,56,1
"86e22cb5fe0e4b47a9489ecddf7ed78f","86e22cb5fe0e4b47a9489ecddf7ed78f",22850298,2,0,1,102,56,56,0
"86e22cb5fe0e4b47a9489ecddf7ed78f","f924752d8a1149668870b1e7698486f7",22850298,1,-6,0,104,56,50,-6
"f924752d8a1149668870b1e7698486f7","78f30e4dcac84e3cbea8b2cc6e0d62b3",22850298,1,10,0,105,50,59,9
"78f30e4dcac84e3cbea8b2cc6e0d62b3","a1f2f12debe5432fb7a70bcd12bacfb9",22850298,1,-1,0,106,59,58,-1
"a1f2f12debe5432fb7a70bcd12bacfb9","a1f2f12debe5432fb7a70bcd12bacfb9",22850298,30,0,1,107,58,58,0
"a1f2f12debe5432fb7a70bcd12bacfb9","78f30e4dcac84e3cbea8b2cc6e0d62b3",22850298,1,1,0,137,58,59,1
"78f30e4dcac84e3cbea8b2cc6e0d62b3","78f30e4dcac84e3cbea8b2cc6e0d62b3",22850298,11,0,1,138,59,59,0
"78f30e4dcac84e3cbea8b2cc6e0d62b3","a0a418b8540d479fa6e0f653b701da8b",22850298,1,6,0,149,59,64,5
"a0a418b8540d479fa6e0f653b701da8b","bc42d26810654ea9a1df1efe1e58c7d5",22850298,1,-1,0,150,64,63,-1
"bc42d26810654ea9a1df1efe1e58c7d5","12aa6e1672ac4e7aa6449a7a8609cd72",22850298,1,-7,0,151,63,57,-6
"12aa6e1672ac4e7aa6449a7a8609cd72","4c943503763e4e349906eea3ed3c8e86",22850298,1,5,0,152,57,61,4
"4c943503763e4e349906eea3ed3c8e86","4c943503763e4e349906eea3ed3c8e86",22850298,1,0,1,153,61,61,0
"4c943503763e4e349906eea3ed3c8e86","bc42d26810654ea9a1df1efe1e58c7d5",22850298,1,2,0,154,61,63,2
"bc42d26810654ea9a1df1efe1e58c7d5","bc42d26810654ea9a1df1efe1e58c7d5",22850298,3,0,1,155,63,63,0
"bc42d26810654ea9a1df1efe1e58c7d5","a0a418b8540d479fa6e0f653b701da8b",22850298,1,1,0,158,63,64,1
"a0a418b8540d479fa6e0f653b701da8b","a0a418b8540d479fa6e0f653b701da8b",22850298,3,0,1,159,64,64,0
"a0a418b8540d479fa6e0f653b701da8b","309ccf3cc4fe429d9bfbaef53d3fa479",22850298,1,-4,0,162,64,60,-4
"309ccf3cc4fe429d9bfbaef53d3fa479","d646286c8051419bbc2e31dd1db55ca8",22850298,1,10,0,163,60,67,7
"d646286c8051419bbc2e31dd1db55ca8","b534b89233134e30a9b5645138bfa9ee",22850298,1,-33,0,164,67,41,-26
"b534b89233134e30a9b5645138bfa9ee","d646286c8051419bbc2e31dd1db55ca8",22850298,1,33,0,165,41,67,26
"d646286c8051419bbc2e31dd1db55ca8","d646286c8051419bbc2e31dd1db55ca8",22850298,2,0,1,166,67,67,0
"d646286c8051419bbc2e31dd1db55ca8","267f883678b24aed855fde42524975d9",22850298,1,4,0,167,67,71,4
"267f883678b24aed855fde42524975d9","267f883678b24aed855fde42524975d9",22850298,1,0,1,168,71,71,0
"267f883678b24aed855fde42524975d9","88fff56d0342490dbef9040750a20f6c",22850298,1,1,0,169,71,72,1
"88fff56d0342490dbef9040750a20f6c","88fff56d0342490dbef9040750a20f6c",22850298,1,0,1,170,72,72,0
"88fff56d0342490dbef9040750a20f6c","adb17b12b66c4a49a85fd34322f7df70",22850298,1,1,0,171,72,73,1
"adb17b12b66c4a49a85fd34322f7df70","adb17b12b66c4a49a85fd34322f7df70",22850298,1,0,1,172,73,73,0
"adb17b12b66c4a49a85fd34322f7df70","d646286c8051419bbc2e31dd1db55ca8",22850298,1,-6,0,173,73,67,-6
"d646286c8051419bbc2e31dd1db55ca8","a2becd407db34b189200a32546d9d569",22850298,1,9,0,174,67,75,8
"a2becd407db34b189200a32546d9d569","a2becd407db34b189200a32546d9d569",22850298,1,0,1,175,75,75,0
"a2becd407db34b189200a32546d9d569","58c22b011d0f4c2ea6d13615edbb9eeb",22850298,1,2,0,176,75,77,2
"58c22b011d0f4c2ea6d13615edbb9eeb","58c22b011d0f4c2ea6d13615edbb9eeb",22850298,2,0,1,177,77,77,0
"58c22b011d0f4c2ea6d13615edbb9eeb","dd76e1861dc9461c830888729d091ee0",22850298,1,1,0,179,77,78,1
"dd76e1861dc9461c830888729d091ee0","dd76e1861dc9461c830888729d091ee0",22850298,5,0,1,180,78,78,0
"dd76e1861dc9461c830888729d091ee0","cd1d828f1a694b87913a7ea66c23803e",22850298,1,1,0,185,78,79,1
"cd1d828f1a694b87913a7ea66c23803e","cd1d828f1a694b87913a7ea66c23803e",22850298,2,0,1,186,79,79,0
"cd1d828f1a694b87913a7ea66c23803e","9176a3c2b4d2465fa8b0c67096c2a97e",22850298,1,1,0,188,79,80,1
"9176a3c2b4d2465fa8b0c67096c2a97e","9176a3c2b4d2465fa8b0c67096c2a97e",22850298,11,0,1,189,80,80,0
"9176a3c2b4d2465fa8b0c67096c2a97e","f8ec6445f7194e25b9101d4fbcb07a18",22850298,1,1,0,200,80,81,1
"f8ec6445f7194e25b9101d4fbcb07a18","f8ec6445f7194e25b9101d4fbcb07a18",22850298,2,0,1,201,81,81,0
"f8ec6445f7194e25b9101d4fbcb07a18","140d5b27b8574befad82c0a013b59dfa",22850298,1,-7,0,203,81,74,-7
"140d5b27b8574befad82c0a013b59dfa","d646286c8051419bbc2e31dd1db55ca8",22850298,1,-8,0,204,74,67,-7
"d646286c8051419bbc2e31dd1db55ca8","d18a9ea32855445f8736581f5cb119ce",22850298,1,17,0,206,67,82,15
"d18a9ea32855445f8736581f5cb119ce","f564483cbd7a407681aa2fcca518cf5f",22850298,1,4,0,207,82,85,3
"f564483cbd7a407681aa2fcca518cf5f","f564483cbd7a407681aa2fcca518cf5f",22850298,4,0,1,208,85,85,0
"f564483cbd7a407681aa2fcca518cf5f","18fd01350bd5434ca636d59a599d768a",22850298,1,1,0,212,85,86,1
"18fd01350bd5434ca636d59a599d768a","18fd01350bd5434ca636d59a599d768a",22850298,8,0,1,213,86,86,0
"18fd01350bd5434ca636d59a599d768a","6a9f0ef185fb47f0937e29daa1c71ed5",22850298,1,5,0,221,86,90,4
"6a9f0ef185fb47f0937e29daa1c71ed5","ae5ac430ea254e708a6f5deaaf7464ae",22850298,1,-7,0,222,90,84,-6
"ae5ac430ea254e708a6f5deaaf7464ae","c681290961c94c4caf23b529d1ae6b9a",22850298,1,5,0,223,84,88,4
"c681290961c94c4caf23b529d1ae6b9a","c681290961c94c4caf23b529d1ae6b9a",22850298,1,0,1,224,88,88,0
"c681290961c94c4caf23b529d1ae6b9a","6a9f0ef185fb47f0937e29daa1c71ed5",22850298,1,2,0,225,88,90,2
"6a9f0ef185fb47f0937e29daa1c71ed5","6a9f0ef185fb47f0937e29daa1c71ed5",22850298,3,0,1,226,90,90,0
"6a9f0ef185fb47f0937e29daa1c71ed5","d646286c8051419bbc2e31dd1db55ca8",22850298,1,-27,0,229,90,67,-23
"d646286c8051419bbc2e31dd1db55ca8","e20db35ced8544ddac5bc3839145e463",22850298,1,30,0,230,67,91,24
"e20db35ced8544ddac5bc3839145e463","1febb706d7a34005ae8711ed49c76e64",22850298,1,3,0,231,91,94,3
"1febb706d7a34005ae8711ed49c76e64","1febb706d7a34005ae8711ed49c76e64",22850298,2,0,1,232,94,94,0
"1febb706d7a34005ae8711ed49c76e64","8f73ba6f5a0042f2850356ac38ac6f24",22850298,1,1,0,234,94,95,1
"8f73ba6f5a0042f2850356ac38ac6f24","8f73ba6f5a0042f2850356ac38ac6f24",22850298,5,0,1,235,95,95,0
"8f73ba6f5a0042f2850356ac38ac6f24","e2260b86653c46d7b14a41fb419dbf8c",22850298,1,1,0,240,95,96,1
"e2260b86653c46d7b14a41fb419dbf8c","e2260b86653c46d7b14a41fb419dbf8c",22850298,2,0,1,241,96,96,0
"e2260b86653c46d7b14a41fb419dbf8c","35eb641ad1d845bbba54915bce75a962",22850298,1,1,0,243,96,97,1
"35eb641ad1d845bbba54915bce75a962","35eb641ad1d845bbba54915bce75a962",22850298,5,0,1,244,97,97,0
"35eb641ad1d845bbba54915bce75a962","08be90ffbeea4795a138cd42ed8db56f",22850298,1,1,0,249,97,98,1
"08be90ffbeea4795a138cd42ed8db56f","08be90ffbeea4795a138cd42ed8db56f",22850298,5,0,1,250,98,98,0
"08be90ffbeea4795a138cd42ed8db56f","3007433c8f584dcbb5ac159c1c5f2be3",22850298,1,1,0,255,98,99,1
"3007433c8f584dcbb5ac159c1c5f2be3","3007433c8f584dcbb5ac159c1c5f2be3",22850298,5,0,1,256,99,99,0
"3007433c8f584dcbb5ac159c1c5f2be3","00ae5f0c51874a73a41ebea838d95682",22850298,1,3,0,261,99,101,2
"00ae5f0c51874a73a41ebea838d95682","e20db35ced8544ddac5bc3839145e463",22850298,1,-11,0,262,101,91,-10
"e20db35ced8544ddac5bc3839145e463","d391c8b6e56a43a7b654e9dee02d904b",22850298,1,13,0,263,91,103,12
"d391c8b6e56a43a7b654e9dee02d904b","00ae5f0c51874a73a41ebea838d95682",22850298,1,-2,0,264,103,101,-2
"00ae5f0c51874a73a41ebea838d95682","d391c8b6e56a43a7b654e9dee02d904b",22850298,1,2,0,265,101,103,2
"d391c8b6e56a43a7b654e9dee02d904b","d391c8b6e56a43a7b654e9dee02d904b",22850298,15,0,1,266,103,103,0
"d391c8b6e56a43a7b654e9dee02d904b","6111116566fc4fd9abba409322bea245",22850298,1,1,0,281,103,104,1
"6111116566fc4fd9abba409322bea245","6111116566fc4fd9abba409322bea245",22850298,2,0,1,282,104,104,0
"6111116566fc4fd9abba409322bea245","a81b2235cb9c499eb9ea8ee0a8dd9725",22850298,1,1,0,284,104,105,1
"a81b2235cb9c499eb9ea8ee0a8dd9725","a81b2235cb9c499eb9ea8ee0a8dd9725",22850298,5,0,1,285,105,105,0
"a81b2235cb9c499eb9ea8ee0a8dd9725","2d4e0ab0ef3b4d73b82c72d4621a7579",22850298,1,1,0,290,105,106,1
"2d4e0ab0ef3b4d73b82c72d4621a7579","2d4e0ab0ef3b4d73b82c72d4621a7579",22850298,2,0,1,291,106,106,0
"2d4e0ab0ef3b4d73b82c72d4621a7579","8bdebf492ebd4e62b0d522e8ab5e5197",22850298,1,1,0,293,106,107,1
"8bdebf492ebd4e62b0d522e8ab5e5197","8bdebf492ebd4e62b0d522e8ab5e5197",22850298,5,0,1,294,107,107,0
"8bdebf492ebd4e62b0d522e8ab5e5197","4280927ec4d643238aa49c32f9e06c6c",22850298,1,3,0,299,107,109,2
"4280927ec4d643238aa49c32f9e06c6c","73039f8c1eb9409cb4caee2cf968001e",22850298,1,-10,0,300,109,100,-9
"73039f8c1eb9409cb4caee2cf968001e","4280927ec4d643238aa49c32f9e06c6c",22850298,1,10,0,301,100,109,9
"4280927ec4d643238aa49c32f9e06c6c","4280927ec4d643238aa49c32f9e06c6c",22850298,1,0,1,302,109,109,0
"4280927ec4d643238aa49c32f9e06c6c","fc44e6a5f7654430af1227838224dceb",22850298,1,2,0,303,109,111,2
"fc44e6a5f7654430af1227838224dceb","fc44e6a5f7654430af1227838224dceb",22850298,5,0,1,304,111,111,0
"fc44e6a5f7654430af1227838224dceb","08111f75e22d409998cf8b85bd431f0a",22850298,1,-3,0,309,111,108,-3
"08111f75e22d409998cf8b85bd431f0a","a9ae0a3c070d455bb4369a8996313336",22850298,1,7,0,310,108,114,6
"a9ae0a3c070d455bb4369a8996313336","a9ae0a3c070d455bb4369a8996313336",22850298,1,0,1,311,114,114,0
"a9ae0a3c070d455bb4369a8996313336","37319e88176d4aefa91d7a9980dbae91",22850298,1,-2,0,312,114,112,-2
"37319e88176d4aefa91d7a9980dbae91","e20db35ced8544ddac5bc3839145e463",22850298,1,-24,0,313,112,91,-21
"e20db35ced8544ddac5bc3839145e463","a9ae0a3c070d455bb4369a8996313336",22850298,1,26,0,314,91,114,23
"a9ae0a3c070d455bb4369a8996313336","71cec822bcff4f30a20e75dc63ef7b65",22850298,1,2,0,315,114,116,2
"71cec822bcff4f30a20e75dc63ef7b65","71cec822bcff4f30a20e75dc63ef7b65",22850298,5,0,1,316,116,116,0
"71cec822bcff4f30a20e75dc63ef7b65","62bff51286ef4f348717a3cf6fe2318f",22850298,1,5,0,321,116,120,4
"62bff51286ef4f348717a3cf6fe2318f","37319e88176d4aefa91d7a9980dbae91",22850298,1,-9,0,322,120,112,-8
"37319e88176d4aefa91d7a9980dbae91","b1cd0e7dc3ad4a8eb91a4bfdbeb025b0",22850298,1,7,0,323,112,118,6
"b1cd0e7dc3ad4a8eb91a4bfdbeb025b0","b1cd0e7dc3ad4a8eb91a4bfdbeb025b0",22850298,1,0,1,324,118,118,0
"b1cd0e7dc3ad4a8eb91a4bfdbeb025b0","779f9ddd1fd14d1e9e69f72219a1fdbd",22850298,1,5,0,325,118,121,3
"779f9ddd1fd14d1e9e69f72219a1fdbd","e20db35ced8544ddac5bc3839145e463",22850298,1,-36,0,326,121,91,-30
"e20db35ced8544ddac5bc3839145e463","ae26e6cda8ad4a3f81bd347560d9579f",22850298,1,40,0,327,91,125,34
"ae26e6cda8ad4a3f81bd347560d9579f","ae26e6cda8ad4a3f81bd347560d9579f",22850298,3,0,1,328,125,125,0
"ae26e6cda8ad4a3f81bd347560d9579f","ee48df95832b4374aa273ceb27ec1315",22850298,1,1,0,331,125,126,1
"ee48df95832b4374aa273ceb27ec1315","ee48df95832b4374aa273ceb27ec1315",22850298,1,0,1,332,126,126,0
"ee48df95832b4374aa273ceb27ec1315","7a439da90b394756ad1777fc4c6dead5",22850298,1,1,0,333,126,127,1
"7a439da90b394756ad1777fc4c6dead5","7a439da90b394756ad1777fc4c6dead5",22850298,1,0,1,334,127,127,0
"7a439da90b394756ad1777fc4c6dead5","a8dd5213034441ac92724b4e83eb0bb2",22850298,1,3,0,335,127,129,2
"a8dd5213034441ac92724b4e83eb0bb2","779f9ddd1fd14d1e9e69f72219a1fdbd",22850298,1,-9,0,336,129,121,-8
"779f9ddd1fd14d1e9e69f72219a1fdbd","ec34b06efd844b46a4c4818ecdb9b8f4",22850298,1,12,0,337,121,132,11
"ec34b06efd844b46a4c4818ecdb9b8f4","ec34b06efd844b46a4c4818ecdb9b8f4",22850298,5,0,1,338,132,132,0
"ec34b06efd844b46a4c4818ecdb9b8f4","8115eab6556b45f5b415c3b8c26a12e5",22850298,1,-1,0,343,132,131,-1
"8115eab6556b45f5b415c3b8c26a12e5","8115eab6556b45f5b415c3b8c26a12e5",22850298,5,0,1,344,131,131,0
"8115eab6556b45f5b415c3b8c26a12e5","c2e1c2b9eac64109b343a088584b576b",22850298,1,2,0,349,131,133,2
"c2e1c2b9eac64109b343a088584b576b","c2e1c2b9eac64109b343a088584b576b",22850298,2,0,1,350,133,133,0
"c2e1c2b9eac64109b343a088584b576b","579338175e0b4bbb8ef3b712b5d8b54e",22850298,1,-5,0,352,133,128,-5
"579338175e0b4bbb8ef3b712b5d8b54e","8bc5795d6a984a3eace4e2811e52dd4f",22850298,1,8,0,353,128,135,7
"8bc5795d6a984a3eace4e2811e52dd4f","8bc5795d6a984a3eace4e2811e52dd4f",22850298,1,0,1,354,135,135,0
"8bc5795d6a984a3eace4e2811e52dd4f","b416d47c56a742199b5d7c7f19d6503a",22850298,1,-1,0,355,135,134,-1
"b416d47c56a742199b5d7c7f19d6503a","a8dd5213034441ac92724b4e83eb0bb2",22850298,1,-6,0,356,134,129,-5
"a8dd5213034441ac92724b4e83eb0bb2","f661500307d74c908e9207d949ceb4aa",22850298,1,9,0,357,129,136,7
"f661500307d74c908e9207d949ceb4aa","a8dd5213034441ac92724b4e83eb0bb2",22850298,1,-9,0,358,136,129,-7
"a8dd5213034441ac92724b4e83eb0bb2","579338175e0b4bbb8ef3b712b5d8b54e",22850298,1,-1,0,359,129,128,-1
"579338175e0b4bbb8ef3b712b5d8b54e","cd4532ad48034873ba8bce2aac0c9808",22850298,1,11,0,360,128,137,9
"cd4532ad48034873ba8bce2aac0c9808","cd4532ad48034873ba8bce2aac0c9808",22850298,1,0,1,361,137,137,0
"cd4532ad48034873ba8bce2aac0c9808","779f9ddd1fd14d1e9e69f72219a1fdbd",22850298,1,-19,0,362,137,121,-16
"779f9ddd1fd14d1e9e69f72219a1fdbd","df1de691dafe4549a18a4398ee9dfaf9",22850298,1,23,0,363,121,139,18
"df1de691dafe4549a18a4398ee9dfaf9","6c5ad271a44743479bfaea29b1db8d02",22850298,2,4,0,364,139,143,4
"6c5ad271a44743479bfaea29b1db8d02","78adeee1fa2c4fe0bc73f7bca9fcee86",22850298,1,22,0,365,143,160,17
"78adeee1fa2c4fe0bc73f7bca9fcee86","78adeee1fa2c4fe0bc73f7bca9fcee86",22850298,1,0,1,366,160,160,0
"78adeee1fa2c4fe0bc73f7bca9fcee86","67a089198fcb4e1c8f2385786c2b296f",22850298,1,-152,0,367,160,39,-121
"67a089198fcb4e1c8f2385786c2b296f","df1de691dafe4549a18a4398ee9dfaf9",22850298,1,126,0,368,39,139,100
"df1de691dafe4549a18a4398ee9dfaf9","df1de691dafe4549a18a4398ee9dfaf9",22850298,1,0,1,369,139,139,0
"6c5ad271a44743479bfaea29b1db8d02","6c5ad271a44743479bfaea29b1db8d02",22850298,1,0,1,371,143,143,0
"6c5ad271a44743479bfaea29b1db8d02","83d311bed5374fee83d8d67a7d9d82dc",22850298,1,1,0,372,143,144,1
"83d311bed5374fee83d8d67a7d9d82dc","83d311bed5374fee83d8d67a7d9d82dc",22850298,1,0,1,373,144,144,0
"83d311bed5374fee83d8d67a7d9d82dc","402bba41861d43acb52a5abb89e8831e",22850298,1,1,0,374,144,145,1
"402bba41861d43acb52a5abb89e8831e","402bba41861d43acb52a5abb89e8831e",22850298,2,0,1,375,145,145,0
"402bba41861d43acb52a5abb89e8831e","df1de691dafe4549a18a4398ee9dfaf9",22850298,1,-6,0,377,145,139,-6
"df1de691dafe4549a18a4398ee9dfaf9","8aae34f5ddbb4052a709b12e6b0d40fa",22850298,1,9,0,378,139,147,8
"8aae34f5ddbb4052a709b12e6b0d40fa","8aae34f5ddbb4052a709b12e6b0d40fa",22850298,4,0,1,379,147,147,0
"8aae34f5ddbb4052a709b12e6b0d40fa","645b3f0249f64f76af2e19eb4d0e55b7",22850298,1,2,0,383,147,149,2
"645b3f0249f64f76af2e19eb4d0e55b7","645b3f0249f64f76af2e19eb4d0e55b7",22850298,9,0,1,384,149,149,0
"645b3f0249f64f76af2e19eb4d0e55b7","7e7b8db5064d4369805ab370aac5ddfb",22850298,1,1,0,393,149,150,1
"7e7b8db5064d4369805ab370aac5ddfb","7e7b8db5064d4369805ab370aac5ddfb",22850298,2,0,1,394,150,150,0
"7e7b8db5064d4369805ab370aac5ddfb","8956d210ae7f41968fada86d4c979d6a",22850298,1,1,0,396,150,151,1
"8956d210ae7f41968fada86d4c979d6a","8956d210ae7f41968fada86d4c979d6a",22850298,2,0,1,397,151,151,0
"8956d210ae7f41968fada86d4c979d6a","f902b0f41b544d4dbf79664fd233648d",22850298,1,-5,0,399,151,146,-5
"f902b0f41b544d4dbf79664fd233648d","ae781e8b775e4ccd93bc800dad5c8376",22850298,1,8,0,400,146,153,7
"ae781e8b775e4ccd93bc800dad5c8376","ae781e8b775e4ccd93bc800dad5c8376",22850298,2,0,1,401,153,153,0
"ae781e8b775e4ccd93bc800dad5c8376","06882a8492d9499aa31555567f575ecb",22850298,1,1,0,403,153,154,1
"06882a8492d9499aa31555567f575ecb","06882a8492d9499aa31555567f575ecb",22850298,1,0,1,404,154,154,0
"06882a8492d9499aa31555567f575ecb","f293c508f409466a8f27ddd7d1e40b20",22850298,1,1,0,405,154,155,1
"f293c508f409466a8f27ddd7d1e40b20","f293c508f409466a8f27ddd7d1e40b20",22850298,2,0,1,406,155,155,0
"f293c508f409466a8f27ddd7d1e40b20","cc4ddef5bbbe48ebb605141b347c4ed1",22850298,1,1,0,408,155,156,1
"cc4ddef5bbbe48ebb605141b347c4ed1","cc4ddef5bbbe48ebb605141b347c4ed1",22850298,5,0,1,409,156,156,0
"cc4ddef5bbbe48ebb605141b347c4ed1","d313cec988a84645bee413e8d4724a4b",22850298,1,3,0,414,156,158,2
"d313cec988a84645bee413e8d4724a4b","f03480cf4eba413194d7af52fc0e7f28",22850298,1,-7,0,415,158,152,-6
"f03480cf4eba413194d7af52fc0e7f28","d313cec988a84645bee413e8d4724a4b",22850298,1,7,0,416,152,158,6
"d313cec988a84645bee413e8d4724a4b","d313cec988a84645bee413e8d4724a4b",22850298,3,0,1,417,158,158,0
"d313cec988a84645bee413e8d4724a4b","dc60696c76a74368a60f72246e47700d",22850298,1,1,0,420,158,159,1
"dc60696c76a74368a60f72246e47700d","dc60696c76a74368a60f72246e47700d",22850298,1,0,1,421,159,159,0
"dc60696c76a74368a60f72246e47700d","df1de691dafe4549a18a4398ee9dfaf9",22850298,1,-23,0,422,159,139,-20
"df1de691dafe4549a18a4398ee9dfaf9","78adeee1fa2c4fe0bc73f7bca9fcee86",22850298,1,26,0,423,139,160,21
"78adeee1fa2c4fe0bc73f7bca9fcee86","d646286c8051419bbc2e31dd1db55ca8",22850298,1,-115,0,424,160,67,-93
"d646286c8051419bbc2e31dd1db55ca8","8959e6304a0348309a771e4d08d1b64a",22850298,1,119,0,425,67,163,96
"8959e6304a0348309a771e4d08d1b64a","78adeee1fa2c4fe0bc73f7bca9fcee86",22850298,1,-4,0,426,163,160,-3
"78adeee1fa2c4fe0bc73f7bca9fcee86","65202579580f4ad38d734b4ee39d22a8",22850298,1,5,0,427,160,164,4
"65202579580f4ad38d734b4ee39d22a8","65202579580f4ad38d734b4ee39d22a8",22850298,7,0,1,428,164,164,0
"65202579580f4ad38d734b4ee39d22a8","8959e6304a0348309a771e4d08d1b64a",22850298,1,-1,0,435,164,163,-1
"b613861cecf84ffcab01afb23f660475","b613861cecf84ffcab01afb23f660475",22850502,7,0,1,1,1,1,0
"e2911e79efc2420eac45d9f671463d4b","b613861cecf84ffcab01afb23f660475",22850502,1,-3,0,9,2,1,-1
"b613861cecf84ffcab01afb23f660475","e2911e79efc2420eac45d9f671463d4b",22850502,2,3,0,10,1,2,1
"e2911e79efc2420eac45d9f671463d4b","e2911e79efc2420eac45d9f671463d4b",22850502,3,0,1,11,2,2,0
"e2911e79efc2420eac45d9f671463d4b","519d1b8c59404d67b54e96c5c8a830b2",22850502,1,1,0,12,2,3,1
"519d1b8c59404d67b54e96c5c8a830b2","519d1b8c59404d67b54e96c5c8a830b2",22850502,1,0,1,13,3,3,0
"519d1b8c59404d67b54e96c5c8a830b2","531db53f81f646edb0cdcfe0085b03b7",22850502,1,1,0,14,3,4,1
"531db53f81f646edb0cdcfe0085b03b7","531db53f81f646edb0cdcfe0085b03b7",22850502,1,0,1,15,4,4,0
"531db53f81f646edb0cdcfe0085b03b7","4f5f94b2f95141e0a9d53a61da2276da",22850502,1,1,0,16,4,5,1
"4f5f94b2f95141e0a9d53a61da2276da","4f5f94b2f95141e0a9d53a61da2276da",22850502,1,0,1,17,5,5,0
"4f5f94b2f95141e0a9d53a61da2276da","6d541c89590949f99af293c4f2333f67",22850502,1,1,0,18,5,6,1
"6d541c89590949f99af293c4f2333f67","6d541c89590949f99af293c4f2333f67",22850502,1,0,1,19,6,6,0
"6d541c89590949f99af293c4f2333f67","dd5cf0b9fe4c4f1d8f5ff8e4c04879cb",22850502,1,1,0,20,6,7,1
"dd5cf0b9fe4c4f1d8f5ff8e4c04879cb","dd5cf0b9fe4c4f1d8f5ff8e4c04879cb",22850502,1,0,1,21,7,7,0
"dd5cf0b9fe4c4f1d8f5ff8e4c04879cb","f96261861edc426abe2248be4f0a709a",22850502,1,1,0,22,7,8,1
"f96261861edc426abe2248be4f0a709a","f96261861edc426abe2248be4f0a709a",22850502,1,0,1,23,8,8,0
"f96261861edc426abe2248be4f0a709a","66b5e16f4f75454fb5b8172079f0fa83",22850502,1,1,0,24,8,9,1
"66b5e16f4f75454fb5b8172079f0fa83","66b5e16f4f75454fb5b8172079f0fa83",22850502,1,0,1,25,9,9,0
"66b5e16f4f75454fb5b8172079f0fa83","0680571d4698477995e41842c36a54b2",22850502,1,1,0,26,9,10,1
"0680571d4698477995e41842c36a54b2","0680571d4698477995e41842c36a54b2",22850502,1,0,1,27,10,10,0
"0680571d4698477995e41842c36a54b2","9112f2bffece48e08c6d2287be204085",22850502,1,1,0,28,10,11,1
"9112f2bffece48e08c6d2287be204085","9112f2bffece48e08c6d2287be204085",22850502,1,0,1,29,11,11,0
"9112f2bffece48e08c6d2287be204085","e2911e79efc2420eac45d9f671463d4b",22850502,1,-9,0,30,11,2,-9
"e2911e79efc2420eac45d9f671463d4b","56586aa865414f538729c7f7735d2bc6",22850502,2,12,0,31,2,12,10
"56586aa865414f538729c7f7735d2bc6","56586aa865414f538729c7f7735d2bc6",22850502,8,0,1,32,12,12,0
"56586aa865414f538729c7f7735d2bc6","e2911e79efc2420eac45d9f671463d4b",22850502,1,-12,0,33,12,2,-10
"56586aa865414f538729c7f7735d2bc6","b7f2b31585d94eb3bf86376714aa7070",22850502,3,2,0,40,12,13,1
"b7f2b31585d94eb3bf86376714aa7070","56586aa865414f538729c7f7735d2bc6",22850502,1,-2,0,41,13,12,-1
"b7f2b31585d94eb3bf86376714aa7070","3f1c815879794b929260d224becaff7e",22850502,2,2,0,43,13,14,1
"3f1c815879794b929260d224becaff7e","81c864a886d54a6b8ff85f7d736f4f95",22850502,2,2,0,44,14,15,1
"81c864a886d54a6b8ff85f7d736f4f95","5c5ceeee4562457ba6d41515aeebfbb1",22850502,2,4,0,45,15,17,2
"5c5ceeee4562457ba6d41515aeebfbb1","5c5ceeee4562457ba6d41515aeebfbb1",22850502,2,0,1,46,17,17,0
"5c5ceeee4562457ba6d41515aeebfbb1","56586aa865414f538729c7f7735d2bc6",22850502,2,-10,0,47,17,12,-5
"56586aa865414f538729c7f7735d2bc6","9afd71a5298d4333b6849dfce1b9422c",22850502,2,13,0,48,12,18,6
"9afd71a5298d4333b6849dfce1b9422c","56586aa865414f538729c7f7735d2bc6",22850502,1,-13,0,49,18,12,-6
"b7f2b31585d94eb3bf86376714aa7070","b7f2b31585d94eb3bf86376714aa7070",22850502,1,0,1,55,13,13,0
"9afd71a5298d4333b6849dfce1b9422c","4a29443515bb404cb8924e1c60a63b73",22850502,1,370,0,62,18,285,267
"4a29443515bb404cb8924e1c60a63b73","208c9b2796c944db8dacaa96082520ea",22850502,1,3,0,63,285,288,3
"208c9b2796c944db8dacaa96082520ea","0d987bed3ffa4ed0b9a2e62e97b7b30f",22850502,1,-25,0,64,288,272,-16
"0d987bed3ffa4ed0b9a2e62e97b7b30f","bb5a47f5ea01454a8b79455422d3b9da",22850502,1,10,0,65,272,280,8
"bb5a47f5ea01454a8b79455422d3b9da","bb5a47f5ea01454a8b79455422d3b9da",22850502,7,0,1,66,280,280,0
"bb5a47f5ea01454a8b79455422d3b9da","0e37b720d23b4e7f8b313e79313fd107",22850502,1,-307,0,73,280,44,-236
"0e37b720d23b4e7f8b313e79313fd107","6875d67fdd5f48168b62719df449bebd",22850502,1,1,0,74,44,45,1
"67a089198fcb4e1c8f2385786c2b296f","67a089198fcb4e1c8f2385786c2b296f",22851025,2,0,1,1,39,39,0
"67a089198fcb4e1c8f2385786c2b296f","e2911e79efc2420eac45d9f671463d4b",22851025,1,-69,0,2,39,2,-37
"e2911e79efc2420eac45d9f671463d4b","b613861cecf84ffcab01afb23f660475",22851025,1,-3,0,4,2,1,-1
"b613861cecf84ffcab01afb23f660475","b613861cecf84ffcab01afb23f660475",22851025,4,0,1,5,1,1,0
"b613861cecf84ffcab01afb23f660475","e2911e79efc2420eac45d9f671463d4b",22851025,1,3,0,9,1,2,1
"e2911e79efc2420eac45d9f671463d4b","e2911e79efc2420eac45d9f671463d4b",22851025,3,0,1,10,2,2,0
"e2911e79efc2420eac45d9f671463d4b","519d1b8c59404d67b54e96c5c8a830b2",22851025,1,1,0,12,2,3,1
"519d1b8c59404d67b54e96c5c8a830b2","519d1b8c59404d67b54e96c5c8a830b2",22851025,1,0,1,13,3,3,0
"519d1b8c59404d67b54e96c5c8a830b2","531db53f81f646edb0cdcfe0085b03b7",22851025,1,1,0,14,3,4,1
"531db53f81f646edb0cdcfe0085b03b7","531db53f81f646edb0cdcfe0085b03b7",22851025,1,0,1,15,4,4,0
"531db53f81f646edb0cdcfe0085b03b7","4f5f94b2f95141e0a9d53a61da2276da",22851025,1,1,0,16,4,5,1
"4f5f94b2f95141e0a9d53a61da2276da","4f5f94b2f95141e0a9d53a61da2276da",22851025,1,0,1,17,5,5,0
"4f5f94b2f95141e0a9d53a61da2276da","6d541c89590949f99af293c4f2333f67",22851025,1,1,0,18,5,6,1
"6d541c89590949f99af293c4f2333f67","6d541c89590949f99af293c4f2333f67",22851025,1,0,1,19,6,6,0
"6d541c89590949f99af293c4f2333f67","dd5cf0b9fe4c4f1d8f5ff8e4c04879cb",22851025,1,1,0,20,6,7,1
"dd5cf0b9fe4c4f1d8f5ff8e4c04879cb","dd5cf0b9fe4c4f1d8f5ff8e4c04879cb",22851025,1,0,1,21,7,7,0
"dd5cf0b9fe4c4f1d8f5ff8e4c04879cb","f96261861edc426abe2248be4f0a709a",22851025,1,1,0,22,7,8,1
"f96261861edc426abe2248be4f0a709a","f96261861edc426abe2248be4f0a709a",22851025,1,0,1,23,8,8,0
"f96261861edc426abe2248be4f0a709a","66b5e16f4f75454fb5b8172079f0fa83",22851025,1,1,0,24,8,9,1
"66b5e16f4f75454fb5b8172079f0fa83","66b5e16f4f75454fb5b8172079f0fa83",22851025,1,0,1,25,9,9,0
"66b5e16f4f75454fb5b8172079f0fa83","0680571d4698477995e41842c36a54b2",22851025,1,1,0,26,9,10,1
"0680571d4698477995e41842c36a54b2","0680571d4698477995e41842c36a54b2",22851025,1,0,1,27,10,10,0
"0680571d4698477995e41842c36a54b2","9112f2bffece48e08c6d2287be204085",22851025,1,1,0,28,10,11,1
"9112f2bffece48e08c6d2287be204085","9112f2bffece48e08c6d2287be204085",22851025,1,0,1,29,11,11,0
"9112f2bffece48e08c6d2287be204085","e2911e79efc2420eac45d9f671463d4b",22851025,1,-9,0,30,11,2,-9
"e2911e79efc2420eac45d9f671463d4b","56586aa865414f538729c7f7735d2bc6",22851025,1,12,0,31,2,12,10
"56586aa865414f538729c7f7735d2bc6","56586aa865414f538729c7f7735d2bc6",22851025,4,0,1,32,12,12,0
"56586aa865414f538729c7f7735d2bc6","67a089198fcb4e1c8f2385786c2b296f",22851025,1,57,0,34,12,39,27
"67a089198fcb4e1c8f2385786c2b296f","64d48c6c9c7940639a932219a6c87198",22851025,1,1,0,36,39,40,1
"64d48c6c9c7940639a932219a6c87198","64d48c6c9c7940639a932219a6c87198",22851025,1,0,1,37,40,40,0
"64d48c6c9c7940639a932219a6c87198","56586aa865414f538729c7f7735d2bc6",22851025,1,-58,0,38,40,12,-28
"56586aa865414f538729c7f7735d2bc6","b7f2b31585d94eb3bf86376714aa7070",22851025,2,2,0,39,12,13,1
"b7f2b31585d94eb3bf86376714aa7070","b7f2b31585d94eb3bf86376714aa7070",22851025,2,0,1,40,13,13,0
"b7f2b31585d94eb3bf86376714aa7070","b534b89233134e30a9b5645138bfa9ee",22851025,1,59,0,41,13,41,28
"b534b89233134e30a9b5645138bfa9ee","67a089198fcb4e1c8f2385786c2b296f",22851025,1,-4,0,42,41,39,-2
"67a089198fcb4e1c8f2385786c2b296f","0e37b720d23b4e7f8b313e79313fd107",22851025,1,7,0,43,39,44,5
"0e37b720d23b4e7f8b313e79313fd107","0e37b720d23b4e7f8b313e79313fd107",22851025,1,0,1,44,44,44,0
"0e37b720d23b4e7f8b313e79313fd107","6875d67fdd5f48168b62719df449bebd",22851025,1,1,0,45,44,45,1
"6875d67fdd5f48168b62719df449bebd","6875d67fdd5f48168b62719df449bebd",22851025,1,0,1,46,45,45,0
"6875d67fdd5f48168b62719df449bebd","6e13d61a7bdb44bca949c9f86fab3be5",22851025,1,3,0,47,45,47,2
"6e13d61a7bdb44bca949c9f86fab3be5","b534b89233134e30a9b5645138bfa9ee",22851025,1,-7,0,48,47,41,-6
"b534b89233134e30a9b5645138bfa9ee","6e13d61a7bdb44bca949c9f86fab3be5",22851025,2,7,0,49,41,47,6
"6e13d61a7bdb44bca949c9f86fab3be5","b7f2b31585d94eb3bf86376714aa7070",22851025,1,-66,0,50,47,13,-34
"b7f2b31585d94eb3bf86376714aa7070","3f1c815879794b929260d224becaff7e",22851025,2,2,0,51,13,14,1
"3f1c815879794b929260d224becaff7e","56586aa865414f538729c7f7735d2bc6",22851025,1,-4,0,52,14,12,-2
"3f1c815879794b929260d224becaff7e","81c864a886d54a6b8ff85f7d736f4f95",22851025,1,2,0,58,14,15,1
"81c864a886d54a6b8ff85f7d736f4f95","5c5ceeee4562457ba6d41515aeebfbb1",22851025,1,4,0,59,15,17,2
"5c5ceeee4562457ba6d41515aeebfbb1","5c5ceeee4562457ba6d41515aeebfbb1",22851025,2,0,1,60,17,17,0
"5c5ceeee4562457ba6d41515aeebfbb1","195f78799f984cc2b06c48dfe36be751",22851025,1,60,0,62,17,49,32
"195f78799f984cc2b06c48dfe36be751","195f78799f984cc2b06c48dfe36be751",22851025,7,0,1,63,49,49,0
"195f78799f984cc2b06c48dfe36be751","d9c8d8c444a64dadbbb508652c721e17",22851025,1,-3,0,65,49,46,-3
"d9c8d8c444a64dadbbb508652c721e17","b534b89233134e30a9b5645138bfa9ee",22851025,1,-6,0,66,46,41,-5
"6e13d61a7bdb44bca949c9f86fab3be5","195f78799f984cc2b06c48dfe36be751",22851025,1,2,0,68,47,49,2
"195f78799f984cc2b06c48dfe36be751","d0c74f735e024943943e40333d6d337f",22851025,1,3,0,74,49,51,2
"d0c74f735e024943943e40333d6d337f","d9c8d8c444a64dadbbb508652c721e17",22851025,1,-6,0,75,51,46,-5
"b613861cecf84ffcab01afb23f660475","b613861cecf84ffcab01afb23f660475",22851296,5,0,1,1,1,1,0
"b613861cecf84ffcab01afb23f660475","e2911e79efc2420eac45d9f671463d4b",22851296,1,3,0,6,1,2,1
"e2911e79efc2420eac45d9f671463d4b","e2911e79efc2420eac45d9f671463d4b",22851296,4,0,1,10,2,2,0
"e2911e79efc2420eac45d9f671463d4b","519d1b8c59404d67b54e96c5c8a830b2",22851296,1,1,0,11,2,3,1
"519d1b8c59404d67b54e96c5c8a830b2","519d1b8c59404d67b54e96c5c8a830b2",22851296,2,0,1,12,3,3,0
"519d1b8c59404d67b54e96c5c8a830b2","531db53f81f646edb0cdcfe0085b03b7",22851296,1,1,0,14,3,4,1
"531db53f81f646edb0cdcfe0085b03b7","531db53f81f646edb0cdcfe0085b03b7",22851296,2,0,1,15,4,4,0
"531db53f81f646edb0cdcfe0085b03b7","4f5f94b2f95141e0a9d53a61da2276da",22851296,1,1,0,17,4,5,1
"4f5f94b2f95141e0a9d53a61da2276da","4f5f94b2f95141e0a9d53a61da2276da",22851296,2,0,1,18,5,5,0
"4f5f94b2f95141e0a9d53a61da2276da","6d541c89590949f99af293c4f2333f67",22851296,1,1,0,20,5,6,1
"6d541c89590949f99af293c4f2333f67","6d541c89590949f99af293c4f2333f67",22851296,1,0,1,21,6,6,0
"6d541c89590949f99af293c4f2333f67","dd5cf0b9fe4c4f1d8f5ff8e4c04879cb",22851296,1,1,0,22,6,7,1
"dd5cf0b9fe4c4f1d8f5ff8e4c04879cb","dd5cf0b9fe4c4f1d8f5ff8e4c04879cb",22851296,2,0,1,23,7,7,0
"dd5cf0b9fe4c4f1d8f5ff8e4c04879cb","f96261861edc426abe2248be4f0a709a",22851296,1,1,0,25,7,8,1
"f96261861edc426abe2248be4f0a709a","f96261861edc426abe2248be4f0a709a",22851296,2,0,1,26,8,8,0
"f96261861edc426abe2248be4f0a709a","66b5e16f4f75454fb5b8172079f0fa83",22851296,1,1,0,28,8,9,1
"66b5e16f4f75454fb5b8172079f0fa83","66b5e16f4f75454fb5b8172079f0fa83",22851296,2,0,1,29,9,9,0
"66b5e16f4f75454fb5b8172079f0fa83","0680571d4698477995e41842c36a54b2",22851296,1,1,0,31,9,10,1
"0680571d4698477995e41842c36a54b2","0680571d4698477995e41842c36a54b2",22851296,2,0,1,32,10,10,0
"0680571d4698477995e41842c36a54b2","9112f2bffece48e08c6d2287be204085",22851296,1,1,0,34,10,11,1
"9112f2bffece48e08c6d2287be204085","9112f2bffece48e08c6d2287be204085",22851296,2,0,1,35,11,11,0
"9112f2bffece48e08c6d2287be204085","e2911e79efc2420eac45d9f671463d4b",22851296,1,-9,0,37,11,2,-9
"e2911e79efc2420eac45d9f671463d4b","56586aa865414f538729c7f7735d2bc6",22851296,1,12,0,38,2,12,10
"56586aa865414f538729c7f7735d2bc6","56586aa865414f538729c7f7735d2bc6",22851296,5,0,1,39,12,12,0
"56586aa865414f538729c7f7735d2bc6","b7f2b31585d94eb3bf86376714aa7070",22851296,2,2,0,42,12,13,1
"b7f2b31585d94eb3bf86376714aa7070","b7f2b31585d94eb3bf86376714aa7070",22851296,4,0,1,43,13,13,0
"b7f2b31585d94eb3bf86376714aa7070","3f1c815879794b929260d224becaff7e",22851296,2,2,0,46,13,14,1
"3f1c815879794b929260d224becaff7e","5c5ceeee4562457ba6d41515aeebfbb1",22851296,1,6,0,47,14,17,3
"5c5ceeee4562457ba6d41515aeebfbb1","81c864a886d54a6b8ff85f7d736f4f95",22851296,1,-4,0,48,17,15,-2
"81c864a886d54a6b8ff85f7d736f4f95","5c5ceeee4562457ba6d41515aeebfbb1",22851296,2,4,0,49,15,17,2
"5c5ceeee4562457ba6d41515aeebfbb1","56586aa865414f538729c7f7735d2bc6",22851296,2,-10,0,50,17,12,-5
"56586aa865414f538729c7f7735d2bc6","9afd71a5298d4333b6849dfce1b9422c",22851296,2,13,0,51,12,18,6
"9afd71a5298d4333b6849dfce1b9422c","56586aa865414f538729c7f7735d2bc6",22851296,1,-13,0,52,18,12,-6
"3f1c815879794b929260d224becaff7e","81c864a886d54a6b8ff85f7d736f4f95",22851296,1,2,0,58,14,15,1
"9afd71a5298d4333b6849dfce1b9422c","9afd71a5298d4333b6849dfce1b9422c",22851296,2,0,1,62,18,18,0
"9afd71a5298d4333b6849dfce1b9422c","b7719e26494940efa49512aedd0aac79",22851296,2,4,0,63,18,20,2
"b7719e26494940efa49512aedd0aac79","d4f45188d3c84a02ba08454e6403a818",22851296,2,5,0,64,20,24,4
"d4f45188d3c84a02ba08454e6403a818","d4c3b003e8274e429d2fa688d73fde6d",22851296,2,-2,0,65,24,22,-2
"d4c3b003e8274e429d2fa688d73fde6d","d4c3b003e8274e429d2fa688d73fde6d",22851296,1,0,1,66,22,22,0
"d4c3b003e8274e429d2fa688d73fde6d","b7719e26494940efa49512aedd0aac79",22851296,2,-3,0,67,22,20,-2
"b7719e26494940efa49512aedd0aac79","9afd71a5298d4333b6849dfce1b9422c",22851296,1,-4,0,68,20,18,-2
"b7719e26494940efa49512aedd0aac79","afbf7250b99d47bea07172749483ca97",22851296,2,12,0,75,20,28,8
"afbf7250b99d47bea07172749483ca97","4e51676dc72045d99c19b9fa7b22f8bc",22851296,2,3,0,76,28,29,1
"4e51676dc72045d99c19b9fa7b22f8bc","afbf7250b99d47bea07172749483ca97",22851296,1,-3,0,77,29,28,-1
"4e51676dc72045d99c19b9fa7b22f8bc","51970cfa30e643e894e66ae85c8024cc",22851296,1,3,0,79,29,31,2
"51970cfa30e643e894e66ae85c8024cc","c33c17be71ae4d588da7369472e5bb1b",22851296,1,6,0,80,31,34,3
"c33c17be71ae4d588da7369472e5bb1b","4e51676dc72045d99c19b9fa7b22f8bc",22851296,1,-9,0,81,34,29,-5
"4e51676dc72045d99c19b9fa7b22f8bc","93679be414554a11b1893002f2229a93",22851296,1,12,0,82,29,35,6
"93679be414554a11b1893002f2229a93","c33c17be71ae4d588da7369472e5bb1b",22851296,1,-3,0,83,35,34,-1
"c33c17be71ae4d588da7369472e5bb1b","93679be414554a11b1893002f2229a93",22851296,1,3,0,84,34,35,1
"93679be414554a11b1893002f2229a93","7040a13096d746ac84b8fac8d9752058",22851296,1,3,0,85,35,36,1
"7040a13096d746ac84b8fac8d9752058","7040a13096d746ac84b8fac8d9752058",22851296,1,0,1,86,36,36,0
"7040a13096d746ac84b8fac8d9752058","9a0dc646f934470daf08c4b56ccf73db",22851296,2,3,0,87,36,37,1
"9a0dc646f934470daf08c4b56ccf73db","7040a13096d746ac84b8fac8d9752058",22851296,1,-3,0,88,37,36,-1
"b7719e26494940efa49512aedd0aac79","a49d1bb4328949299686242fd0be5584",22851296,1,2,0,94,20,21,1
"a49d1bb4328949299686242fd0be5584","b7719e26494940efa49512aedd0aac79",22851296,1,-2,0,95,21,20,-1
"afbf7250b99d47bea07172749483ca97","fc0e049d56024bc9a02c9a9c435c3df7",22851296,1,24,0,97,28,38,10
"fc0e049d56024bc9a02c9a9c435c3df7","fc0e049d56024bc9a02c9a9c435c3df7",22851296,7,0,1,100,38,38,0
"fc0e049d56024bc9a02c9a9c435c3df7","9a0dc646f934470daf08c4b56ccf73db",22851296,1,-3,0,102,38,37,-1
"9a0dc646f934470daf08c4b56ccf73db","9a0dc646f934470daf08c4b56ccf73db",22851296,1,0,1,103,37,37,0
"9a0dc646f934470daf08c4b56ccf73db","fc0e049d56024bc9a02c9a9c435c3df7",22851296,2,3,0,104,37,38,1
"fc0e049d56024bc9a02c9a9c435c3df7","b7719e26494940efa49512aedd0aac79",22851296,2,-36,0,105,38,20,-18
"b7719e26494940efa49512aedd0aac79","b7719e26494940efa49512aedd0aac79",22851296,2,0,1,106,20,20,0
"b7719e26494940efa49512aedd0aac79","fc0e049d56024bc9a02c9a9c435c3df7",22851296,1,36,0,107,20,38,18
"fc0e049d56024bc9a02c9a9c435c3df7","67a089198fcb4e1c8f2385786c2b296f",22851296,1,4,0,109,38,39,1
"67a089198fcb4e1c8f2385786c2b296f","64d48c6c9c7940639a932219a6c87198",22851296,1,1,0,110,39,40,1
"64d48c6c9c7940639a932219a6c87198","64d48c6c9c7940639a932219a6c87198",22851296,2,0,1,111,40,40,0
"64d48c6c9c7940639a932219a6c87198","67a089198fcb4e1c8f2385786c2b296f",22851296,1,-1,0,113,40,39,-1
"67a089198fcb4e1c8f2385786c2b296f","b534b89233134e30a9b5645138bfa9ee",22851296,1,4,0,114,39,41,2
"b534b89233134e30a9b5645138bfa9ee","b534b89233134e30a9b5645138bfa9ee",22851296,2,0,1,115,41,41,0
"b534b89233134e30a9b5645138bfa9ee","0e37b720d23b4e7f8b313e79313fd107",22851296,1,3,0,117,41,44,3
"0e37b720d23b4e7f8b313e79313fd107","0e37b720d23b4e7f8b313e79313fd107",22851296,3,0,1,118,44,44,0
"0e37b720d23b4e7f8b313e79313fd107","6875d67fdd5f48168b62719df449bebd",22851296,1,1,0,121,44,45,1
"6875d67fdd5f48168b62719df449bebd","6875d67fdd5f48168b62719df449bebd",22851296,1,0,1,122,45,45,0
"6875d67fdd5f48168b62719df449bebd","b534b89233134e30a9b5645138bfa9ee",22851296,1,-4,0,123,45,41,-4
"b534b89233134e30a9b5645138bfa9ee","6e13d61a7bdb44bca949c9f86fab3be5",22851296,3,7,0,124,41,47,6
"6e13d61a7bdb44bca949c9f86fab3be5","6e13d61a7bdb44bca949c9f86fab3be5",22851296,2,0,1,125,47,47,0
"6e13d61a7bdb44bca949c9f86fab3be5","b534b89233134e30a9b5645138bfa9ee",22851296,2,-7,0,126,47,41,-6
"6e13d61a7bdb44bca949c9f86fab3be5","195f78799f984cc2b06c48dfe36be751",22851296,1,2,0,131,47,49,2
"195f78799f984cc2b06c48dfe36be751","195f78799f984cc2b06c48dfe36be751",22851296,5,0,1,132,49,49,0
"195f78799f984cc2b06c48dfe36be751","d9c8d8c444a64dadbbb508652c721e17",22851296,1,-3,0,137,49,46,-3
"d9c8d8c444a64dadbbb508652c721e17","d0c74f735e024943943e40333d6d337f",22851296,1,6,0,138,46,51,5
"d0c74f735e024943943e40333d6d337f","d0c74f735e024943943e40333d6d337f",22851296,1,0,1,139,51,51,0
"d0c74f735e024943943e40333d6d337f","983f8ff320594b279a7f4a6fe132f9c5",22851296,1,2,0,140,51,53,2
"983f8ff320594b279a7f4a6fe132f9c5","983f8ff320594b279a7f4a6fe132f9c5",22851296,2,0,1,141,53,53,0
"983f8ff320594b279a7f4a6fe132f9c5","35adfa5d923046aebabfefd98f35ff05",22851296,1,1,0,143,53,54,1
"35adfa5d923046aebabfefd98f35ff05","35adfa5d923046aebabfefd98f35ff05",22851296,3,0,1,144,54,54,0
"35adfa5d923046aebabfefd98f35ff05","b6f8a98476224da1b40e555ececc7ed8",22851296,1,1,0,147,54,55,1
"b6f8a98476224da1b40e555ececc7ed8","b6f8a98476224da1b40e555ececc7ed8",22851296,8,0,1,148,55,55,0
"b6f8a98476224da1b40e555ececc7ed8","86e22cb5fe0e4b47a9489ecddf7ed78f",22851296,1,1,0,156,55,56,1
"86e22cb5fe0e4b47a9489ecddf7ed78f","86e22cb5fe0e4b47a9489ecddf7ed78f",22851296,5,0,1,157,56,56,0
"86e22cb5fe0e4b47a9489ecddf7ed78f","f924752d8a1149668870b1e7698486f7",22851296,1,-6,0,162,56,50,-6
"f924752d8a1149668870b1e7698486f7","78f30e4dcac84e3cbea8b2cc6e0d62b3",22851296,1,10,0,163,50,59,9
"78f30e4dcac84e3cbea8b2cc6e0d62b3","a1f2f12debe5432fb7a70bcd12bacfb9",22851296,1,-1,0,164,59,58,-1
"a1f2f12debe5432fb7a70bcd12bacfb9","a1f2f12debe5432fb7a70bcd12bacfb9",22851296,20,0,1,165,58,58,0
"a1f2f12debe5432fb7a70bcd12bacfb9","78f30e4dcac84e3cbea8b2cc6e0d62b3",22851296,1,1,0,185,58,59,1
"78f30e4dcac84e3cbea8b2cc6e0d62b3","78f30e4dcac84e3cbea8b2cc6e0d62b3",22851296,19,0,1,186,59,59,0
"78f30e4dcac84e3cbea8b2cc6e0d62b3","bc42d26810654ea9a1df1efe1e58c7d5",22851296,1,5,0,205,59,63,4
"bc42d26810654ea9a1df1efe1e58c7d5","a0a418b8540d479fa6e0f653b701da8b",22851296,1,1,0,206,63,64,1
"a0a418b8540d479fa6e0f653b701da8b","12aa6e1672ac4e7aa6449a7a8609cd72",22851296,1,-8,0,207,64,57,-7
"12aa6e1672ac4e7aa6449a7a8609cd72","b534b89233134e30a9b5645138bfa9ee",22851296,1,-19,0,208,57,41,-16
"b534b89233134e30a9b5645138bfa9ee","a0a418b8540d479fa6e0f653b701da8b",22851296,2,27,0,209,41,64,23
"a0a418b8540d479fa6e0f653b701da8b","bc42d26810654ea9a1df1efe1e58c7d5",22851296,2,-1,0,210,64,63,-1
"bc42d26810654ea9a1df1efe1e58c7d5","b534b89233134e30a9b5645138bfa9ee",22851296,1,-26,0,211,63,41,-22
"b613861cecf84ffcab01afb23f660475","b613861cecf84ffcab01afb23f660475",22851301,7,0,1,1,1,1,0
"e2911e79efc2420eac45d9f671463d4b","67a089198fcb4e1c8f2385786c2b296f",22851301,1,69,0,6,2,39,37
"64d48c6c9c7940639a932219a6c87198","b613861cecf84ffcab01afb23f660475",22851301,1,-73,0,8,40,1,-39
"b613861cecf84ffcab01afb23f660475","e2911e79efc2420eac45d9f671463d4b",22851301,2,3,0,13,1,2,1
"e2911e79efc2420eac45d9f671463d4b","e2911e79efc2420eac45d9f671463d4b",22851301,4,0,1,14,2,2,0
"e2911e79efc2420eac45d9f671463d4b","519d1b8c59404d67b54e96c5c8a830b2",22851301,1,1,0,17,2,3,1
"519d1b8c59404d67b54e96c5c8a830b2","519d1b8c59404d67b54e96c5c8a830b2",22851301,2,0,1,18,3,3,0
"519d1b8c59404d67b54e96c5c8a830b2","531db53f81f646edb0cdcfe0085b03b7",22851301,1,1,0,20,3,4,1
"531db53f81f646edb0cdcfe0085b03b7","531db53f81f646edb0cdcfe0085b03b7",22851301,2,0,1,21,4,4,0
"531db53f81f646edb0cdcfe0085b03b7","4f5f94b2f95141e0a9d53a61da2276da",22851301,1,1,0,23,4,5,1
"4f5f94b2f95141e0a9d53a61da2276da","4f5f94b2f95141e0a9d53a61da2276da",22851301,1,0,1,24,5,5,0
"4f5f94b2f95141e0a9d53a61da2276da","6d541c89590949f99af293c4f2333f67",22851301,1,1,0,25,5,6,1
"6d541c89590949f99af293c4f2333f67","6d541c89590949f99af293c4f2333f67",22851301,1,0,1,26,6,6,0
"6d541c89590949f99af293c4f2333f67","dd5cf0b9fe4c4f1d8f5ff8e4c04879cb",22851301,1,1,0,27,6,7,1
"dd5cf0b9fe4c4f1d8f5ff8e4c04879cb","dd5cf0b9fe4c4f1d8f5ff8e4c04879cb",22851301,1,0,1,28,7,7,0
"dd5cf0b9fe4c4f1d8f5ff8e4c04879cb","f96261861edc426abe2248be4f0a709a",22851301,1,1,0,29,7,8,1
"f96261861edc426abe2248be4f0a709a","f96261861edc426abe2248be4f0a709a",22851301,2,0,1,30,8,8,0
"f96261861edc426abe2248be4f0a709a","66b5e16f4f75454fb5b8172079f0fa83",22851301,1,1,0,32,8,9,1
"66b5e16f4f75454fb5b8172079f0fa83","66b5e16f4f75454fb5b8172079f0fa83",22851301,4,0,1,33,9,9,0
"66b5e16f4f75454fb5b8172079f0fa83","0680571d4698477995e41842c36a54b2",22851301,1,1,0,37,9,10,1
"0680571d4698477995e41842c36a54b2","0680571d4698477995e41842c36a54b2",22851301,2,0,1,38,10,10,0
"0680571d4698477995e41842c36a54b2","9112f2bffece48e08c6d2287be204085",22851301,1,1,0,40,10,11,1
"9112f2bffece48e08c6d2287be204085","9112f2bffece48e08c6d2287be204085",22851301,2,0,1,41,11,11,0
"9112f2bffece48e08c6d2287be204085","e2911e79efc2420eac45d9f671463d4b",22851301,1,-9,0,43,11,2,-9
"e2911e79efc2420eac45d9f671463d4b","56586aa865414f538729c7f7735d2bc6",22851301,1,12,0,44,2,12,10
"56586aa865414f538729c7f7735d2bc6","56586aa865414f538729c7f7735d2bc6",22851301,4,0,1,45,12,12,0
"3f1c815879794b929260d224becaff7e","56586aa865414f538729c7f7735d2bc6",22851301,1,-4,0,54,14,12,-2
"56586aa865414f538729c7f7735d2bc6","5c5ceeee4562457ba6d41515aeebfbb1",22851301,1,10,0,55,12,17,5
"5c5ceeee4562457ba6d41515aeebfbb1","56586aa865414f538729c7f7735d2bc6",22851301,1,-10,0,56,17,12,-5
"56586aa865414f538729c7f7735d2bc6","9afd71a5298d4333b6849dfce1b9422c",22851301,1,13,0,57,12,18,6
"9afd71a5298d4333b6849dfce1b9422c","9afd71a5298d4333b6849dfce1b9422c",22851301,1,0,1,58,18,18,0
"9afd71a5298d4333b6849dfce1b9422c","b7719e26494940efa49512aedd0aac79",22851301,1,4,0,59,18,20,2
"b7719e26494940efa49512aedd0aac79","d4f45188d3c84a02ba08454e6403a818",22851301,1,5,0,60,20,24,4
"afbf7250b99d47bea07172749483ca97","b7719e26494940efa49512aedd0aac79",22851301,1,-12,0,64,28,20,-8
"4e51676dc72045d99c19b9fa7b22f8bc","4e51676dc72045d99c19b9fa7b22f8bc",22851301,1,0,1,67,29,29,0
"51970cfa30e643e894e66ae85c8024cc","c9c52446b6294aa5a9c2abaed536c37e",22851301,1,2,0,69,31,32,1
"c9c52446b6294aa5a9c2abaed536c37e","51970cfa30e643e894e66ae85c8024cc",22851301,1,-2,0,70,32,31,-1
"51970cfa30e643e894e66ae85c8024cc","c33c17be71ae4d588da7369472e5bb1b",22851301,1,6,0,71,31,34,3
"c33c17be71ae4d588da7369472e5bb1b","4e51676dc72045d99c19b9fa7b22f8bc",22851301,1,-9,0,72,34,29,-5
"7040a13096d746ac84b8fac8d9752058","7040a13096d746ac84b8fac8d9752058",22851301,1,0,1,81,36,36,0
"67a089198fcb4e1c8f2385786c2b296f","fc0e049d56024bc9a02c9a9c435c3df7",22851301,1,-4,0,87,39,38,-1
"fc0e049d56024bc9a02c9a9c435c3df7","64d48c6c9c7940639a932219a6c87198",22851301,1,5,0,88,38,40,2
"64d48c6c9c7940639a932219a6c87198","64d48c6c9c7940639a932219a6c87198",22851301,3,0,1,89,40,40,0
"b534b89233134e30a9b5645138bfa9ee","0e37b720d23b4e7f8b313e79313fd107",22851301,1,3,0,94,41,44,3
"0e37b720d23b4e7f8b313e79313fd107","0e37b720d23b4e7f8b313e79313fd107",22851301,2,0,1,95,44,44,0
"0e37b720d23b4e7f8b313e79313fd107","6875d67fdd5f48168b62719df449bebd",22851301,1,1,0,97,44,45,1
"6875d67fdd5f48168b62719df449bebd","6875d67fdd5f48168b62719df449bebd",22851301,1,0,1,98,45,45,0
"6875d67fdd5f48168b62719df449bebd","b534b89233134e30a9b5645138bfa9ee",22851301,1,-4,0,99,45,41,-4
"b534b89233134e30a9b5645138bfa9ee","6e13d61a7bdb44bca949c9f86fab3be5",22851301,3,7,0,100,41,47,6
"6e13d61a7bdb44bca949c9f86fab3be5","6e13d61a7bdb44bca949c9f86fab3be5",22851301,2,0,1,101,47,47,0
"6e13d61a7bdb44bca949c9f86fab3be5","195f78799f984cc2b06c48dfe36be751",22851301,1,2,0,102,47,49,2
"195f78799f984cc2b06c48dfe36be751","195f78799f984cc2b06c48dfe36be751",22851301,2,0,1,103,49,49,0
"195f78799f984cc2b06c48dfe36be751","d9c8d8c444a64dadbbb508652c721e17",22851301,1,-3,0,105,49,46,-3
"d9c8d8c444a64dadbbb508652c721e17","d0c74f735e024943943e40333d6d337f",22851301,1,6,0,106,46,51,5
"d0c74f735e024943943e40333d6d337f","d0c74f735e024943943e40333d6d337f",22851301,1,0,1,107,51,51,0
"d0c74f735e024943943e40333d6d337f","983f8ff320594b279a7f4a6fe132f9c5",22851301,1,2,0,108,51,53,2
"983f8ff320594b279a7f4a6fe132f9c5","983f8ff320594b279a7f4a6fe132f9c5",22851301,2,0,1,109,53,53,0
"983f8ff320594b279a7f4a6fe132f9c5","35adfa5d923046aebabfefd98f35ff05",22851301,1,1,0,111,53,54,1
"35adfa5d923046aebabfefd98f35ff05","35adfa5d923046aebabfefd98f35ff05",22851301,2,0,1,112,54,54,0
"35adfa5d923046aebabfefd98f35ff05","b6f8a98476224da1b40e555ececc7ed8",22851301,1,1,0,114,54,55,1
"b6f8a98476224da1b40e555ececc7ed8","b6f8a98476224da1b40e555ececc7ed8",22851301,2,0,1,115,55,55,0
"b6f8a98476224da1b40e555ececc7ed8","86e22cb5fe0e4b47a9489ecddf7ed78f",22851301,1,1,0,117,55,56,1
"86e22cb5fe0e4b47a9489ecddf7ed78f","86e22cb5fe0e4b47a9489ecddf7ed78f",22851301,2,0,1,118,56,56,0
"86e22cb5fe0e4b47a9489ecddf7ed78f","f924752d8a1149668870b1e7698486f7",22851301,1,-6,0,120,56,50,-6
"f924752d8a1149668870b1e7698486f7","a1f2f12debe5432fb7a70bcd12bacfb9",22851301,1,9,0,121,50,58,8
"a1f2f12debe5432fb7a70bcd12bacfb9","78f30e4dcac84e3cbea8b2cc6e0d62b3",22851301,2,1,0,122,58,59,1
"78f30e4dcac84e3cbea8b2cc6e0d62b3","a1f2f12debe5432fb7a70bcd12bacfb9",22851301,2,-1,0,123,59,58,-1
"a1f2f12debe5432fb7a70bcd12bacfb9","a1f2f12debe5432fb7a70bcd12bacfb9",22851301,32,0,1,124,58,58,0
"78f30e4dcac84e3cbea8b2cc6e0d62b3","78f30e4dcac84e3cbea8b2cc6e0d62b3",22851301,11,0,1,157,59,59,0
"78f30e4dcac84e3cbea8b2cc6e0d62b3","12aa6e1672ac4e7aa6449a7a8609cd72",22851301,1,-2,0,168,59,57,-2
"12aa6e1672ac4e7aa6449a7a8609cd72","a0a418b8540d479fa6e0f653b701da8b",22851301,1,8,0,169,57,64,7
"a0a418b8540d479fa6e0f653b701da8b","bc42d26810654ea9a1df1efe1e58c7d5",22851301,2,-1,0,170,64,63,-1
"bc42d26810654ea9a1df1efe1e58c7d5","4c943503763e4e349906eea3ed3c8e86",22851301,1,-2,0,171,63,61,-2
"4c943503763e4e349906eea3ed3c8e86","4c943503763e4e349906eea3ed3c8e86",22851301,1,0,1,172,61,61,0
"4c943503763e4e349906eea3ed3c8e86","bc42d26810654ea9a1df1efe1e58c7d5",22851301,1,2,0,173,61,63,2
"bc42d26810654ea9a1df1efe1e58c7d5","bc42d26810654ea9a1df1efe1e58c7d5",22851301,5,0,1,174,63,63,0
"bc42d26810654ea9a1df1efe1e58c7d5","a0a418b8540d479fa6e0f653b701da8b",22851301,1,1,0,177,63,64,1
"a0a418b8540d479fa6e0f653b701da8b","a0a418b8540d479fa6e0f653b701da8b",22851301,5,0,1,178,64,64,0
"a0a418b8540d479fa6e0f653b701da8b","309ccf3cc4fe429d9bfbaef53d3fa479",22851301,1,-4,0,181,64,60,-4
"309ccf3cc4fe429d9bfbaef53d3fa479","b534b89233134e30a9b5645138bfa9ee",22851301,2,-23,0,182,60,41,-19
"b534b89233134e30a9b5645138bfa9ee","d646286c8051419bbc2e31dd1db55ca8",22851301,2,33,0,183,41,67,26
"d646286c8051419bbc2e31dd1db55ca8","267f883678b24aed855fde42524975d9",22851301,1,4,0,184,67,71,4
"267f883678b24aed855fde42524975d9","267f883678b24aed855fde42524975d9",22851301,1,0,1,185,71,71,0
"267f883678b24aed855fde42524975d9","88fff56d0342490dbef9040750a20f6c",22851301,1,1,0,186,71,72,1
"88fff56d0342490dbef9040750a20f6c","88fff56d0342490dbef9040750a20f6c",22851301,1,0,1,187,72,72,0
"88fff56d0342490dbef9040750a20f6c","adb17b12b66c4a49a85fd34322f7df70",22851301,1,1,0,188,72,73,1
"adb17b12b66c4a49a85fd34322f7df70","adb17b12b66c4a49a85fd34322f7df70",22851301,1,0,1,189,73,73,0
"adb17b12b66c4a49a85fd34322f7df70","a2becd407db34b189200a32546d9d569",22851301,1,3,0,190,73,75,2
"a2becd407db34b189200a32546d9d569","d646286c8051419bbc2e31dd1db55ca8",22851301,2,-9,0,191,75,67,-8
"d646286c8051419bbc2e31dd1db55ca8","a2becd407db34b189200a32546d9d569",22851301,3,9,0,192,67,75,8
"a2becd407db34b189200a32546d9d569","58c22b011d0f4c2ea6d13615edbb9eeb",22851301,1,2,0,193,75,77,2
"58c22b011d0f4c2ea6d13615edbb9eeb","58c22b011d0f4c2ea6d13615edbb9eeb",22851301,2,0,1,194,77,77,0
"58c22b011d0f4c2ea6d13615edbb9eeb","dd76e1861dc9461c830888729d091ee0",22851301,1,1,0,196,77,78,1
"dd76e1861dc9461c830888729d091ee0","dd76e1861dc9461c830888729d091ee0",22851301,5,0,1,197,78,78,0
"dd76e1861dc9461c830888729d091ee0","cd1d828f1a694b87913a7ea66c23803e",22851301,1,1,0,202,78,79,1
"cd1d828f1a694b87913a7ea66c23803e","cd1d828f1a694b87913a7ea66c23803e",22851301,2,0,1,203,79,79,0
"cd1d828f1a694b87913a7ea66c23803e","9176a3c2b4d2465fa8b0c67096c2a97e",22851301,1,1,0,205,79,80,1
"9176a3c2b4d2465fa8b0c67096c2a97e","9176a3c2b4d2465fa8b0c67096c2a97e",22851301,11,0,1,206,80,80,0
"9176a3c2b4d2465fa8b0c67096c2a97e","f8ec6445f7194e25b9101d4fbcb07a18",22851301,1,1,0,217,80,81,1
"f8ec6445f7194e25b9101d4fbcb07a18","f8ec6445f7194e25b9101d4fbcb07a18",22851301,2,0,1,218,81,81,0
"f8ec6445f7194e25b9101d4fbcb07a18","140d5b27b8574befad82c0a013b59dfa",22851301,1,-7,0,220,81,74,-7
"140d5b27b8574befad82c0a013b59dfa","d18a9ea32855445f8736581f5cb119ce",22851301,2,9,0,221,74,82,8
"d18a9ea32855445f8736581f5cb119ce","f564483cbd7a407681aa2fcca518cf5f",22851301,1,4,0,222,82,85,3
"f564483cbd7a407681aa2fcca518cf5f","f564483cbd7a407681aa2fcca518cf5f",22851301,1,0,1,223,85,85,0
"f564483cbd7a407681aa2fcca518cf5f","18fd01350bd5434ca636d59a599d768a",22851301,1,1,0,224,85,86,1
"18fd01350bd5434ca636d59a599d768a","18fd01350bd5434ca636d59a599d768a",22851301,9,0,1,225,86,86,0
"18fd01350bd5434ca636d59a599d768a","ae5ac430ea254e708a6f5deaaf7464ae",22851301,1,-2,0,234,86,84,-2
"ae5ac430ea254e708a6f5deaaf7464ae","6a9f0ef185fb47f0937e29daa1c71ed5",22851301,2,7,0,235,84,90,6
"6a9f0ef185fb47f0937e29daa1c71ed5","c681290961c94c4caf23b529d1ae6b9a",22851301,1,-2,0,236,90,88,-2
"c681290961c94c4caf23b529d1ae6b9a","c681290961c94c4caf23b529d1ae6b9a",22851301,3,0,1,237,88,88,0
"c681290961c94c4caf23b529d1ae6b9a","6a9f0ef185fb47f0937e29daa1c71ed5",22851301,1,2,0,240,88,90,2
"6a9f0ef185fb47f0937e29daa1c71ed5","6a9f0ef185fb47f0937e29daa1c71ed5",22851301,5,0,1,241,90,90,0
"6a9f0ef185fb47f0937e29daa1c71ed5","d646286c8051419bbc2e31dd1db55ca8",22851301,1,-27,0,244,90,67,-23
"d646286c8051419bbc2e31dd1db55ca8","e20db35ced8544ddac5bc3839145e463",22851301,1,30,0,245,67,91,24
"e20db35ced8544ddac5bc3839145e463","1febb706d7a34005ae8711ed49c76e64",22851301,1,3,0,246,91,94,3
"1febb706d7a34005ae8711ed49c76e64","1febb706d7a34005ae8711ed49c76e64",22851301,2,0,1,247,94,94,0
"1febb706d7a34005ae8711ed49c76e64","8f73ba6f5a0042f2850356ac38ac6f24",22851301,1,1,0,249,94,95,1
"8f73ba6f5a0042f2850356ac38ac6f24","8f73ba6f5a0042f2850356ac38ac6f24",22851301,5,0,1,250,95,95,0
"8f73ba6f5a0042f2850356ac38ac6f24","e2260b86653c46d7b14a41fb419dbf8c",22851301,1,1,0,255,95,96,1
"e2260b86653c46d7b14a41fb419dbf8c","e2260b86653c46d7b14a41fb419dbf8c",22851301,2,0,1,256,96,96,0
"e2260b86653c46d7b14a41fb419dbf8c","35eb641ad1d845bbba54915bce75a962",22851301,1,1,0,258,96,97,1
"35eb641ad1d845bbba54915bce75a962","35eb641ad1d845bbba54915bce75a962",22851301,5,0,1,259,97,97,0
"35eb641ad1d845bbba54915bce75a962","08be90ffbeea4795a138cd42ed8db56f",22851301,1,1,0,264,97,98,1
"08be90ffbeea4795a138cd42ed8db56f","08be90ffbeea4795a138cd42ed8db56f",22851301,6,0,1,265,98,98,0
"08be90ffbeea4795a138cd42ed8db56f","3007433c8f584dcbb5ac159c1c5f2be3",22851301,1,1,0,271,98,99,1
"3007433c8f584dcbb5ac159c1c5f2be3","3007433c8f584dcbb5ac159c1c5f2be3",22851301,2,0,1,272,99,99,0
"3007433c8f584dcbb5ac159c1c5f2be3","e20db35ced8544ddac5bc3839145e463",22851301,1,-8,0,274,99,91,-8
"e20db35ced8544ddac5bc3839145e463","00ae5f0c51874a73a41ebea838d95682",22851301,1,11,0,275,91,101,10
"00ae5f0c51874a73a41ebea838d95682","d391c8b6e56a43a7b654e9dee02d904b",22851301,2,2,0,276,101,103,2
"d391c8b6e56a43a7b654e9dee02d904b","00ae5f0c51874a73a41ebea838d95682",22851301,2,-2,0,277,103,101,-2
"d391c8b6e56a43a7b654e9dee02d904b","d391c8b6e56a43a7b654e9dee02d904b",22851301,15,0,1,279,103,103,0
"d391c8b6e56a43a7b654e9dee02d904b","6111116566fc4fd9abba409322bea245",22851301,1,1,0,294,103,104,1
"6111116566fc4fd9abba409322bea245","6111116566fc4fd9abba409322bea245",22851301,2,0,1,295,104,104,0
"6111116566fc4fd9abba409322bea245","a81b2235cb9c499eb9ea8ee0a8dd9725",22851301,1,1,0,297,104,105,1
"a81b2235cb9c499eb9ea8ee0a8dd9725","a81b2235cb9c499eb9ea8ee0a8dd9725",22851301,2,0,1,298,105,105,0
"a81b2235cb9c499eb9ea8ee0a8dd9725","2d4e0ab0ef3b4d73b82c72d4621a7579",22851301,1,1,0,300,105,106,1
"2d4e0ab0ef3b4d73b82c72d4621a7579","2d4e0ab0ef3b4d73b82c72d4621a7579",22851301,2,0,1,301,106,106,0
"2d4e0ab0ef3b4d73b82c72d4621a7579","8bdebf492ebd4e62b0d522e8ab5e5197",22851301,1,1,0,303,106,107,1
"8bdebf492ebd4e62b0d522e8ab5e5197","8bdebf492ebd4e62b0d522e8ab5e5197",22851301,2,0,1,304,107,107,0
"8bdebf492ebd4e62b0d522e8ab5e5197","73039f8c1eb9409cb4caee2cf968001e",22851301,1,-7,0,306,107,100,-7
"73039f8c1eb9409cb4caee2cf968001e","4280927ec4d643238aa49c32f9e06c6c",22851301,1,10,0,307,100,109,9
"4280927ec4d643238aa49c32f9e06c6c","4280927ec4d643238aa49c32f9e06c6c",22851301,6,0,1,308,109,109,0
"4280927ec4d643238aa49c32f9e06c6c","fc44e6a5f7654430af1227838224dceb",22851301,1,2,0,310,109,111,2
"fc44e6a5f7654430af1227838224dceb","fc44e6a5f7654430af1227838224dceb",22851301,8,0,1,311,111,111,0
"fc44e6a5f7654430af1227838224dceb","08111f75e22d409998cf8b85bd431f0a",22851301,1,-3,0,319,111,108,-3
"08111f75e22d409998cf8b85bd431f0a","a9ae0a3c070d455bb4369a8996313336",22851301,2,7,0,320,108,114,6
"a9ae0a3c070d455bb4369a8996313336","71cec822bcff4f30a20e75dc63ef7b65",22851301,1,2,0,321,114,116,2
"71cec822bcff4f30a20e75dc63ef7b65","71cec822bcff4f30a20e75dc63ef7b65",22851301,5,0,1,322,116,116,0
"71cec822bcff4f30a20e75dc63ef7b65","37319e88176d4aefa91d7a9980dbae91",22851301,1,-4,0,327,116,112,-4
"37319e88176d4aefa91d7a9980dbae91","62bff51286ef4f348717a3cf6fe2318f",22851301,2,9,0,328,112,120,8
"62bff51286ef4f348717a3cf6fe2318f","b1cd0e7dc3ad4a8eb91a4bfdbeb025b0",22851301,1,-2,0,329,120,118,-2
"b1cd0e7dc3ad4a8eb91a4bfdbeb025b0","b1cd0e7dc3ad4a8eb91a4bfdbeb025b0",22851301,1,0,1,330,118,118,0
"b1cd0e7dc3ad4a8eb91a4bfdbeb025b0","62bff51286ef4f348717a3cf6fe2318f",22851301,1,2,0,331,118,120,2
"62bff51286ef4f348717a3cf6fe2318f","62bff51286ef4f348717a3cf6fe2318f",22851301,4,0,1,332,120,120,0
"62bff51286ef4f348717a3cf6fe2318f","e20db35ced8544ddac5bc3839145e463",22851301,2,-33,0,335,120,91,-29
"e20db35ced8544ddac5bc3839145e463","779f9ddd1fd14d1e9e69f72219a1fdbd",22851301,2,36,0,336,91,121,30
"779f9ddd1fd14d1e9e69f72219a1fdbd","ae26e6cda8ad4a3f81bd347560d9579f",22851301,1,4,0,337,121,125,4
"ae26e6cda8ad4a3f81bd347560d9579f","ae26e6cda8ad4a3f81bd347560d9579f",22851301,1,0,1,338,125,125,0
"ae26e6cda8ad4a3f81bd347560d9579f","ee48df95832b4374aa273ceb27ec1315",22851301,1,1,0,339,125,126,1
"ee48df95832b4374aa273ceb27ec1315","ee48df95832b4374aa273ceb27ec1315",22851301,3,0,1,340,126,126,0
"ee48df95832b4374aa273ceb27ec1315","7a439da90b394756ad1777fc4c6dead5",22851301,1,1,0,343,126,127,1
"7a439da90b394756ad1777fc4c6dead5","7a439da90b394756ad1777fc4c6dead5",22851301,1,0,1,344,127,127,0
"7a439da90b394756ad1777fc4c6dead5","a8dd5213034441ac92724b4e83eb0bb2",22851301,1,3,0,345,127,129,2
"a8dd5213034441ac92724b4e83eb0bb2","779f9ddd1fd14d1e9e69f72219a1fdbd",22851301,1,-9,0,346,129,121,-8
"779f9ddd1fd14d1e9e69f72219a1fdbd","8115eab6556b45f5b415c3b8c26a12e5",22851301,1,11,0,347,121,131,10
"8115eab6556b45f5b415c3b8c26a12e5","8115eab6556b45f5b415c3b8c26a12e5",22851301,2,0,1,348,131,131,0
"8115eab6556b45f5b415c3b8c26a12e5","ec34b06efd844b46a4c4818ecdb9b8f4",22851301,1,1,0,350,131,132,1
"ec34b06efd844b46a4c4818ecdb9b8f4","ec34b06efd844b46a4c4818ecdb9b8f4",22851301,5,0,1,351,132,132,0
"ec34b06efd844b46a4c4818ecdb9b8f4","c2e1c2b9eac64109b343a088584b576b",22851301,1,1,0,356,132,133,1
"c2e1c2b9eac64109b343a088584b576b","c2e1c2b9eac64109b343a088584b576b",22851301,5,0,1,357,133,133,0
"c2e1c2b9eac64109b343a088584b576b","579338175e0b4bbb8ef3b712b5d8b54e",22851301,1,-5,0,362,133,128,-5
"579338175e0b4bbb8ef3b712b5d8b54e","8bc5795d6a984a3eace4e2811e52dd4f",22851301,1,8,0,363,128,135,7
"8bc5795d6a984a3eace4e2811e52dd4f","8bc5795d6a984a3eace4e2811e52dd4f",22851301,3,0,1,364,135,135,0
"8bc5795d6a984a3eace4e2811e52dd4f","b416d47c56a742199b5d7c7f19d6503a",22851301,1,-1,0,367,135,134,-1
"b416d47c56a742199b5d7c7f19d6503a","cd4532ad48034873ba8bce2aac0c9808",22851301,1,4,0,368,134,137,3
"cd4532ad48034873ba8bce2aac0c9808","cd4532ad48034873ba8bce2aac0c9808",22851301,1,0,1,369,137,137,0
"cd4532ad48034873ba8bce2aac0c9808","df1de691dafe4549a18a4398ee9dfaf9",22851301,1,4,0,370,137,139,2
"df1de691dafe4549a18a4398ee9dfaf9","779f9ddd1fd14d1e9e69f72219a1fdbd",22851301,2,-23,0,371,139,121,-18
"779f9ddd1fd14d1e9e69f72219a1fdbd","6c5ad271a44743479bfaea29b1db8d02",22851301,2,27,0,372,121,143,22
"6c5ad271a44743479bfaea29b1db8d02","83d311bed5374fee83d8d67a7d9d82dc",22851301,2,1,0,373,143,144,1
"83d311bed5374fee83d8d67a7d9d82dc","83d311bed5374fee83d8d67a7d9d82dc",22851301,4,0,1,374,144,144,0
"83d311bed5374fee83d8d67a7d9d82dc","402bba41861d43acb52a5abb89e8831e",22851301,1,1,0,377,144,145,1
"402bba41861d43acb52a5abb89e8831e","402bba41861d43acb52a5abb89e8831e",22851301,2,0,1,378,145,145,0
"402bba41861d43acb52a5abb89e8831e","df1de691dafe4549a18a4398ee9dfaf9",22851301,1,-6,0,380,145,139,-6
"df1de691dafe4549a18a4398ee9dfaf9","8aae34f5ddbb4052a709b12e6b0d40fa",22851301,2,9,0,381,139,147,8
"8aae34f5ddbb4052a709b12e6b0d40fa","56586aa865414f538729c7f7735d2bc6",22851301,1,-192,0,382,147,12,-135
"56586aa865414f538729c7f7735d2bc6","b7f2b31585d94eb3bf86376714aa7070",22851301,2,2,0,383,12,13,1
"b7f2b31585d94eb3bf86376714aa7070","b7f2b31585d94eb3bf86376714aa7070",22851301,6,0,1,384,13,13,0
"b7f2b31585d94eb3bf86376714aa7070","3f1c815879794b929260d224becaff7e",22851301,2,2,0,387,13,14,1
"3f1c815879794b929260d224becaff7e","81c864a886d54a6b8ff85f7d736f4f95",22851301,1,2,0,388,14,15,1
"81c864a886d54a6b8ff85f7d736f4f95","5c5ceeee4562457ba6d41515aeebfbb1",22851301,1,4,0,389,15,17,2
"5c5ceeee4562457ba6d41515aeebfbb1","5c5ceeee4562457ba6d41515aeebfbb1",22851301,3,0,1,390,17,17,0
"5c5ceeee4562457ba6d41515aeebfbb1","9afd71a5298d4333b6849dfce1b9422c",22851301,1,3,0,393,17,18,1
"9afd71a5298d4333b6849dfce1b9422c","56586aa865414f538729c7f7735d2bc6",22851301,1,-13,0,394,18,12,-6
"56586aa865414f538729c7f7735d2bc6","b7719e26494940efa49512aedd0aac79",22851301,1,17,0,395,12,20,8
"b7719e26494940efa49512aedd0aac79","9afd71a5298d4333b6849dfce1b9422c",22851301,1,-4,0,396,20,18,-2
"9afd71a5298d4333b6849dfce1b9422c","d4f45188d3c84a02ba08454e6403a818",22851301,1,9,0,397,18,24,6
"d4f45188d3c84a02ba08454e6403a818","d4c3b003e8274e429d2fa688d73fde6d",22851301,2,-2,0,398,24,22,-2
"d4c3b003e8274e429d2fa688d73fde6d","d4c3b003e8274e429d2fa688d73fde6d",22851301,10,0,1,399,22,22,0
"d4c3b003e8274e429d2fa688d73fde6d","5bc03c8f16354d04bd51f5bb93559ad3",22851301,1,4,0,401,22,26,4
"5bc03c8f16354d04bd51f5bb93559ad3","d4c3b003e8274e429d2fa688d73fde6d",22851301,1,-4,0,402,26,22,-4
"d4c3b003e8274e429d2fa688d73fde6d","b7719e26494940efa49512aedd0aac79",22851301,2,-3,0,411,22,20,-2
"b7719e26494940efa49512aedd0aac79","b7719e26494940efa49512aedd0aac79",22851301,1,0,1,412,20,20,0
"b7719e26494940efa49512aedd0aac79","afbf7250b99d47bea07172749483ca97",22851301,3,12,0,413,20,28,8
"afbf7250b99d47bea07172749483ca97","4e51676dc72045d99c19b9fa7b22f8bc",22851301,3,3,0,414,28,29,1
"4e51676dc72045d99c19b9fa7b22f8bc","afbf7250b99d47bea07172749483ca97",22851301,1,-3,0,415,29,28,-1
"4e51676dc72045d99c19b9fa7b22f8bc","51970cfa30e643e894e66ae85c8024cc",22851301,2,3,0,417,29,31,2
"51970cfa30e643e894e66ae85c8024cc","4e51676dc72045d99c19b9fa7b22f8bc",22851301,1,-3,0,418,31,29,-2
"4e51676dc72045d99c19b9fa7b22f8bc","c33c17be71ae4d588da7369472e5bb1b",22851301,2,9,0,419,29,34,5
"c33c17be71ae4d588da7369472e5bb1b","c33c17be71ae4d588da7369472e5bb1b",22851301,1,0,1,420,34,34,0
"c33c17be71ae4d588da7369472e5bb1b","93679be414554a11b1893002f2229a93",22851301,6,3,0,421,34,35,1
"93679be414554a11b1893002f2229a93","c33c17be71ae4d588da7369472e5bb1b",22851301,4,-3,0,422,35,34,-1
"93679be414554a11b1893002f2229a93","93679be414554a11b1893002f2229a93",22851301,2,0,1,426,35,35,0
"93679be414554a11b1893002f2229a93","7040a13096d746ac84b8fac8d9752058",22851301,4,3,0,427,35,36,1
"7040a13096d746ac84b8fac8d9752058","93679be414554a11b1893002f2229a93",22851301,2,-3,0,428,36,35,-1
"7040a13096d746ac84b8fac8d9752058","9a0dc646f934470daf08c4b56ccf73db",22851301,2,3,0,432,36,37,1
"9a0dc646f934470daf08c4b56ccf73db","7040a13096d746ac84b8fac8d9752058",22851301,1,-3,0,433,37,36,-1
"7040a13096d746ac84b8fac8d9752058","fc0e049d56024bc9a02c9a9c435c3df7",22851301,1,6,0,434,36,38,2
"fc0e049d56024bc9a02c9a9c435c3df7","9a0dc646f934470daf08c4b56ccf73db",22851301,2,-3,0,435,38,37,-1
"9a0dc646f934470daf08c4b56ccf73db","fc0e049d56024bc9a02c9a9c435c3df7",22851301,3,3,0,436,37,38,1
"fc0e049d56024bc9a02c9a9c435c3df7","67a089198fcb4e1c8f2385786c2b296f",22851301,2,4,0,437,38,39,1
"67a089198fcb4e1c8f2385786c2b296f","64d48c6c9c7940639a932219a6c87198",22851301,2,1,0,438,39,40,1
"64d48c6c9c7940639a932219a6c87198","67a089198fcb4e1c8f2385786c2b296f",22851301,2,-1,0,439,40,39,-1
"67a089198fcb4e1c8f2385786c2b296f","b534b89233134e30a9b5645138bfa9ee",22851301,2,4,0,440,39,41,2
"6e13d61a7bdb44bca949c9f86fab3be5","b534b89233134e30a9b5645138bfa9ee",22851301,1,-7,0,442,47,41,-6
"6e13d61a7bdb44bca949c9f86fab3be5","d0c74f735e024943943e40333d6d337f",22851301,1,5,0,445,47,51,4
"d0c74f735e024943943e40333d6d337f","d9c8d8c444a64dadbbb508652c721e17",22851301,1,-6,0,446,51,46,-5
"d9c8d8c444a64dadbbb508652c721e17","f924752d8a1149668870b1e7698486f7",22851301,1,5,0,447,46,50,4
"f924752d8a1149668870b1e7698486f7","78f30e4dcac84e3cbea8b2cc6e0d62b3",22851301,1,10,0,448,50,59,9
"a1f2f12debe5432fb7a70bcd12bacfb9","a0a418b8540d479fa6e0f653b701da8b",22851301,1,7,0,450,58,64,6
"bc42d26810654ea9a1df1efe1e58c7d5","12aa6e1672ac4e7aa6449a7a8609cd72",22851301,1,-7,0,456,63,57,-6
"12aa6e1672ac4e7aa6449a7a8609cd72","309ccf3cc4fe429d9bfbaef53d3fa479",22851301,1,4,0,457,57,60,3
"a2becd407db34b189200a32546d9d569","140d5b27b8574befad82c0a013b59dfa",22851301,1,-1,0,463,75,74,-1
"d18a9ea32855445f8736581f5cb119ce","ae5ac430ea254e708a6f5deaaf7464ae",22851301,1,3,0,465,82,84,2
"6a9f0ef185fb47f0937e29daa1c71ed5","e20db35ced8544ddac5bc3839145e463",22851301,1,3,0,469,90,91,1
"e20db35ced8544ddac5bc3839145e463","d646286c8051419bbc2e31dd1db55ca8",22851301,1,-30,0,470,91,67,-24
"d646286c8051419bbc2e31dd1db55ca8","00ae5f0c51874a73a41ebea838d95682",22851301,1,41,0,471,67,101,34
"00ae5f0c51874a73a41ebea838d95682","e20db35ced8544ddac5bc3839145e463",22851301,2,-11,0,472,101,91,-10
"e20db35ced8544ddac5bc3839145e463","d391c8b6e56a43a7b654e9dee02d904b",22851301,1,13,0,473,91,103,12
"00ae5f0c51874a73a41ebea838d95682","00ae5f0c51874a73a41ebea838d95682",22851301,2,0,1,475,101,101,0
"e20db35ced8544ddac5bc3839145e463","4280927ec4d643238aa49c32f9e06c6c",22851301,1,20,0,478,91,109,18
"4280927ec4d643238aa49c32f9e06c6c","08111f75e22d409998cf8b85bd431f0a",22851301,1,-1,0,483,109,108,-1
"a9ae0a3c070d455bb4369a8996313336","62bff51286ef4f348717a3cf6fe2318f",22851301,1,7,0,485,114,120,6
"62bff51286ef4f348717a3cf6fe2318f","37319e88176d4aefa91d7a9980dbae91",22851301,1,-9,0,486,120,112,-8
"779f9ddd1fd14d1e9e69f72219a1fdbd","779f9ddd1fd14d1e9e69f72219a1fdbd",22851301,1,0,1,491,121,121,0
"779f9ddd1fd14d1e9e69f72219a1fdbd","a8dd5213034441ac92724b4e83eb0bb2",22851301,1,9,0,492,121,129,8
"a8dd5213034441ac92724b4e83eb0bb2","a8dd5213034441ac92724b4e83eb0bb2",22851301,1,0,1,493,129,129,0
"a8dd5213034441ac92724b4e83eb0bb2","579338175e0b4bbb8ef3b712b5d8b54e",22851301,1,-1,0,494,129,128,-1
"579338175e0b4bbb8ef3b712b5d8b54e","b416d47c56a742199b5d7c7f19d6503a",22851301,1,7,0,495,128,134,6
"b416d47c56a742199b5d7c7f19d6503a","779f9ddd1fd14d1e9e69f72219a1fdbd",22851301,1,-15,0,496,134,121,-13
"779f9ddd1fd14d1e9e69f72219a1fdbd","df1de691dafe4549a18a4398ee9dfaf9",22851301,2,23,0,497,121,139,18
"df1de691dafe4549a18a4398ee9dfaf9","df1de691dafe4549a18a4398ee9dfaf9",22851301,1,0,1,498,139,139,0
"6c5ad271a44743479bfaea29b1db8d02","779f9ddd1fd14d1e9e69f72219a1fdbd",22851301,1,-27,0,501,143,121,-22
"df1de691dafe4549a18a4398ee9dfaf9","6c5ad271a44743479bfaea29b1db8d02",22851301,1,4,0,503,139,143,4
"6c5ad271a44743479bfaea29b1db8d02","6c5ad271a44743479bfaea29b1db8d02",22851301,4,0,1,504,143,143,0
"83d311bed5374fee83d8d67a7d9d82dc","8aae34f5ddbb4052a709b12e6b0d40fa",22851301,1,4,0,510,144,147,3
"8aae34f5ddbb4052a709b12e6b0d40fa","df1de691dafe4549a18a4398ee9dfaf9",22851301,1,-9,0,511,147,139,-8
"8aae34f5ddbb4052a709b12e6b0d40fa","8aae34f5ddbb4052a709b12e6b0d40fa",22851301,1,0,1,513,147,147,0
"8aae34f5ddbb4052a709b12e6b0d40fa","645b3f0249f64f76af2e19eb4d0e55b7",22851301,1,2,0,514,147,149,2
"645b3f0249f64f76af2e19eb4d0e55b7","645b3f0249f64f76af2e19eb4d0e55b7",22851301,2,0,1,515,149,149,0
"645b3f0249f64f76af2e19eb4d0e55b7","7e7b8db5064d4369805ab370aac5ddfb",22851301,1,1,0,517,149,150,1
"7e7b8db5064d4369805ab370aac5ddfb","7e7b8db5064d4369805ab370aac5ddfb",22851301,5,0,1,518,150,150,0
"7e7b8db5064d4369805ab370aac5ddfb","8956d210ae7f41968fada86d4c979d6a",22851301,1,1,0,523,150,151,1
"8956d210ae7f41968fada86d4c979d6a","8956d210ae7f41968fada86d4c979d6a",22851301,2,0,1,524,151,151,0
"8956d210ae7f41968fada86d4c979d6a","f902b0f41b544d4dbf79664fd233648d",22851301,1,-5,0,526,151,146,-5
"f902b0f41b544d4dbf79664fd233648d","ae781e8b775e4ccd93bc800dad5c8376",22851301,1,8,0,527,146,153,7
"ae781e8b775e4ccd93bc800dad5c8376","ae781e8b775e4ccd93bc800dad5c8376",22851301,2,0,1,528,153,153,0
"ae781e8b775e4ccd93bc800dad5c8376","06882a8492d9499aa31555567f575ecb",22851301,1,1,0,530,153,154,1
"06882a8492d9499aa31555567f575ecb","06882a8492d9499aa31555567f575ecb",22851301,3,0,1,531,154,154,0
"06882a8492d9499aa31555567f575ecb","f293c508f409466a8f27ddd7d1e40b20",22851301,1,1,0,534,154,155,1
"f293c508f409466a8f27ddd7d1e40b20","f293c508f409466a8f27ddd7d1e40b20",22851301,3,0,1,535,155,155,0
"f293c508f409466a8f27ddd7d1e40b20","cc4ddef5bbbe48ebb605141b347c4ed1",22851301,1,1,0,538,155,156,1
"cc4ddef5bbbe48ebb605141b347c4ed1","cc4ddef5bbbe48ebb605141b347c4ed1",22851301,1,0,1,539,156,156,0
"cc4ddef5bbbe48ebb605141b347c4ed1","f03480cf4eba413194d7af52fc0e7f28",22851301,1,-4,0,540,156,152,-4
"f03480cf4eba413194d7af52fc0e7f28","d313cec988a84645bee413e8d4724a4b",22851301,1,7,0,541,152,158,6
"d313cec988a84645bee413e8d4724a4b","d313cec988a84645bee413e8d4724a4b",22851301,4,0,1,542,158,158,0
"d313cec988a84645bee413e8d4724a4b","dc60696c76a74368a60f72246e47700d",22851301,1,1,0,546,158,159,1
"dc60696c76a74368a60f72246e47700d","dc60696c76a74368a60f72246e47700d",22851301,3,0,1,547,159,159,0
"dc60696c76a74368a60f72246e47700d","df1de691dafe4549a18a4398ee9dfaf9",22851301,1,-23,0,550,159,139,-20
"df1de691dafe4549a18a4398ee9dfaf9","78adeee1fa2c4fe0bc73f7bca9fcee86",22851301,1,26,0,551,139,160,21
"78adeee1fa2c4fe0bc73f7bca9fcee86","78adeee1fa2c4fe0bc73f7bca9fcee86",22851301,1,0,1,552,160,160,0
"78adeee1fa2c4fe0bc73f7bca9fcee86","65202579580f4ad38d734b4ee39d22a8",22851301,1,5,0,553,160,164,4
"65202579580f4ad38d734b4ee39d22a8","65202579580f4ad38d734b4ee39d22a8",22851301,7,0,1,554,164,164,0
"65202579580f4ad38d734b4ee39d22a8","78adeee1fa2c4fe0bc73f7bca9fcee86",22851301,1,-5,0,561,164,160,-4
"78adeee1fa2c4fe0bc73f7bca9fcee86","3cbcea2be0984e7dbd5a48195af10ce7",22851301,1,8,0,562,160,165,5
"3cbcea2be0984e7dbd5a48195af10ce7","82e6285962b8400d9d6fc32436022a94",22851301,2,2,0,563,165,167,2
"82e6285962b8400d9d6fc32436022a94","3cbcea2be0984e7dbd5a48195af10ce7",22851301,1,-2,0,564,167,165,-2
"3cbcea2be0984e7dbd5a48195af10ce7","a9ac840f098c4bd0a2ee896214ce29cd",22851301,1,5,0,565,165,168,3
"a9ac840f098c4bd0a2ee896214ce29cd","a9ac840f098c4bd0a2ee896214ce29cd",22851301,3,0,1,566,168,168,0
"a9ac840f098c4bd0a2ee896214ce29cd","0c7262dff33c4087bc660ccf40f92f9c",22851301,2,4,0,569,168,169,1
"0c7262dff33c4087bc660ccf40f92f9c","a9ac840f098c4bd0a2ee896214ce29cd",22851301,1,-4,0,570,169,168,-1
"a9ac840f098c4bd0a2ee896214ce29cd","3cbcea2be0984e7dbd5a48195af10ce7",22851301,1,-5,0,571,168,165,-3
"82e6285962b8400d9d6fc32436022a94","a9ac840f098c4bd0a2ee896214ce29cd",22851301,1,3,0,573,167,168,1
"0c7262dff33c4087bc660ccf40f92f9c","b2275c3fad834f8d90737a2d9a6927d6",22851301,2,3,0,575,169,172,3
"b2275c3fad834f8d90737a2d9a6927d6","b2275c3fad834f8d90737a2d9a6927d6",22851301,31,0,1,576,172,172,0
"b2275c3fad834f8d90737a2d9a6927d6","0c7262dff33c4087bc660ccf40f92f9c",22851301,1,-3,0,586,172,169,-3
"b2275c3fad834f8d90737a2d9a6927d6","eb515a26030b41f8a82a1e6114420bad",22851301,1,1,0,609,172,173,1
"eb515a26030b41f8a82a1e6114420bad","eb515a26030b41f8a82a1e6114420bad",22851301,2,0,1,610,173,173,0
"eb515a26030b41f8a82a1e6114420bad","0c7262dff33c4087bc660ccf40f92f9c",22851301,1,-4,0,612,173,169,-4
"0c7262dff33c4087bc660ccf40f92f9c","b42cc17b7de840f181a704558d0bc845",22851301,1,7,0,613,169,175,6
"b613861cecf84ffcab01afb23f660475","b613861cecf84ffcab01afb23f660475",22851681,7,0,1,1,1,1,0
"b613861cecf84ffcab01afb23f660475","e2911e79efc2420eac45d9f671463d4b",22851681,1,3,0,8,1,2,1
"e2911e79efc2420eac45d9f671463d4b","e2911e79efc2420eac45d9f671463d4b",22851681,3,0,1,10,2,2,0
"e2911e79efc2420eac45d9f671463d4b","519d1b8c59404d67b54e96c5c8a830b2",22851681,1,1,0,11,2,3,1
"519d1b8c59404d67b54e96c5c8a830b2","519d1b8c59404d67b54e96c5c8a830b2",22851681,1,0,1,12,3,3,0
"519d1b8c59404d67b54e96c5c8a830b2","e2911e79efc2420eac45d9f671463d4b",22851681,1,-1,0,13,3,2,-1
"e2911e79efc2420eac45d9f671463d4b","531db53f81f646edb0cdcfe0085b03b7",22851681,1,2,0,15,2,4,2
"531db53f81f646edb0cdcfe0085b03b7","531db53f81f646edb0cdcfe0085b03b7",22851681,1,0,1,16,4,4,0
"531db53f81f646edb0cdcfe0085b03b7","4f5f94b2f95141e0a9d53a61da2276da",22851681,1,1,0,17,4,5,1
"4f5f94b2f95141e0a9d53a61da2276da","4f5f94b2f95141e0a9d53a61da2276da",22851681,1,0,1,18,5,5,0
"4f5f94b2f95141e0a9d53a61da2276da","6d541c89590949f99af293c4f2333f67",22851681,1,1,0,19,5,6,1
"6d541c89590949f99af293c4f2333f67","6d541c89590949f99af293c4f2333f67",22851681,1,0,1,20,6,6,0
"6d541c89590949f99af293c4f2333f67","dd5cf0b9fe4c4f1d8f5ff8e4c04879cb",22851681,1,1,0,21,6,7,1
"dd5cf0b9fe4c4f1d8f5ff8e4c04879cb","dd5cf0b9fe4c4f1d8f5ff8e4c04879cb",22851681,1,0,1,22,7,7,0
"dd5cf0b9fe4c4f1d8f5ff8e4c04879cb","f96261861edc426abe2248be4f0a709a",22851681,1,1,0,23,7,8,1
"f96261861edc426abe2248be4f0a709a","f96261861edc426abe2248be4f0a709a",22851681,1,0,1,24,8,8,0
"f96261861edc426abe2248be4f0a709a","66b5e16f4f75454fb5b8172079f0fa83",22851681,1,1,0,25,8,9,1
"66b5e16f4f75454fb5b8172079f0fa83","66b5e16f4f75454fb5b8172079f0fa83",22851681,1,0,1,26,9,9,0
"66b5e16f4f75454fb5b8172079f0fa83","0680571d4698477995e41842c36a54b2",22851681,1,1,0,27,9,10,1
"0680571d4698477995e41842c36a54b2","0680571d4698477995e41842c36a54b2",22851681,1,0,1,28,10,10,0
"0680571d4698477995e41842c36a54b2","9112f2bffece48e08c6d2287be204085",22851681,1,1,0,29,10,11,1
"9112f2bffece48e08c6d2287be204085","9112f2bffece48e08c6d2287be204085",22851681,1,0,1,30,11,11,0
"9112f2bffece48e08c6d2287be204085","e2911e79efc2420eac45d9f671463d4b",22851681,1,-9,0,31,11,2,-9
"e2911e79efc2420eac45d9f671463d4b","56586aa865414f538729c7f7735d2bc6",22851681,1,12,0,32,2,12,10
"56586aa865414f538729c7f7735d2bc6","56586aa865414f538729c7f7735d2bc6",22851681,6,0,1,33,12,12,0
"56586aa865414f538729c7f7735d2bc6","b7f2b31585d94eb3bf86376714aa7070",22851681,1,2,0,39,12,13,1
"b7f2b31585d94eb3bf86376714aa7070","b7f2b31585d94eb3bf86376714aa7070",22851681,4,0,1,40,13,13,0
"b7f2b31585d94eb3bf86376714aa7070","67a089198fcb4e1c8f2385786c2b296f",22851681,1,55,0,44,13,39,26
"64d48c6c9c7940639a932219a6c87198","fc0e049d56024bc9a02c9a9c435c3df7",22851681,1,-5,0,47,40,38,-2
"67a089198fcb4e1c8f2385786c2b296f","fc0e049d56024bc9a02c9a9c435c3df7",22851681,1,-4,0,49,39,38,-1
"67a089198fcb4e1c8f2385786c2b296f","56586aa865414f538729c7f7735d2bc6",22851681,1,-57,0,53,39,12,-27
"56586aa865414f538729c7f7735d2bc6","3f1c815879794b929260d224becaff7e",22851681,3,4,0,54,12,14,2
"3f1c815879794b929260d224becaff7e","3f1c815879794b929260d224becaff7e",22851681,1,0,1,55,14,14,0
"3f1c815879794b929260d224becaff7e","56586aa865414f538729c7f7735d2bc6",22851681,2,-4,0,56,14,12,-2
"3f1c815879794b929260d224becaff7e","81c864a886d54a6b8ff85f7d736f4f95",22851681,2,2,0,58,14,15,1
"81c864a886d54a6b8ff85f7d736f4f95","5c5ceeee4562457ba6d41515aeebfbb1",22851681,2,4,0,59,15,17,2
"5c5ceeee4562457ba6d41515aeebfbb1","0c7262dff33c4087bc660ccf40f92f9c",22851681,1,216,0,60,17,169,152
"b2275c3fad834f8d90737a2d9a6927d6","0c7262dff33c4087bc660ccf40f92f9c",22851681,3,-3,0,62,172,169,-3
"0c7262dff33c4087bc660ccf40f92f9c","a9ac840f098c4bd0a2ee896214ce29cd",22851681,1,-4,0,63,169,168,-1
"a9ac840f098c4bd0a2ee896214ce29cd","67a089198fcb4e1c8f2385786c2b296f",22851681,1,-165,0,64,168,39,-129
"64d48c6c9c7940639a932219a6c87198","a9ac840f098c4bd0a2ee896214ce29cd",22851681,1,164,0,66,40,168,128
"a9ac840f098c4bd0a2ee896214ce29cd","0c7262dff33c4087bc660ccf40f92f9c",22851681,1,4,0,67,168,169,1
"b2275c3fad834f8d90737a2d9a6927d6","3f1c815879794b929260d224becaff7e",22851681,1,-225,0,73,172,14,-158
"5c5ceeee4562457ba6d41515aeebfbb1","5c5ceeee4562457ba6d41515aeebfbb1",22851681,1,0,1,78,17,17,0
"5c5ceeee4562457ba6d41515aeebfbb1","56586aa865414f538729c7f7735d2bc6",22851681,1,-10,0,79,17,12,-5
"56586aa865414f538729c7f7735d2bc6","9afd71a5298d4333b6849dfce1b9422c",22851681,1,13,0,80,12,18,6
"9afd71a5298d4333b6849dfce1b9422c","9afd71a5298d4333b6849dfce1b9422c",22851681,1,0,1,81,18,18,0
"9afd71a5298d4333b6849dfce1b9422c","b7719e26494940efa49512aedd0aac79",22851681,1,4,0,82,18,20,2
"b7719e26494940efa49512aedd0aac79","d4f45188d3c84a02ba08454e6403a818",22851681,1,5,0,83,20,24,4
"d4f45188d3c84a02ba08454e6403a818","d4c3b003e8274e429d2fa688d73fde6d",22851681,1,-2,0,84,24,22,-2
"d4c3b003e8274e429d2fa688d73fde6d","d4c3b003e8274e429d2fa688d73fde6d",22851681,1,0,1,85,22,22,0
"d4c3b003e8274e429d2fa688d73fde6d","b7719e26494940efa49512aedd0aac79",22851681,1,-3,0,86,22,20,-2
"b7719e26494940efa49512aedd0aac79","0c7262dff33c4087bc660ccf40f92f9c",22851681,1,209,0,87,20,169,149
"0c7262dff33c4087bc660ccf40f92f9c","d4f45188d3c84a02ba08454e6403a818",22851681,1,-204,0,88,169,24,-145
"d4f45188d3c84a02ba08454e6403a818","b2275c3fad834f8d90737a2d9a6927d6",22851681,1,207,0,89,24,172,148
"b2275c3fad834f8d90737a2d9a6927d6","d4c3b003e8274e429d2fa688d73fde6d",22851681,1,-209,0,90,172,22,-150
"d4c3b003e8274e429d2fa688d73fde6d","a49d1bb4328949299686242fd0be5584",22851681,1,-1,0,91,22,21,-1
"a49d1bb4328949299686242fd0be5584","b7719e26494940efa49512aedd0aac79",22851681,2,-2,0,92,21,20,-1
"4e51676dc72045d99c19b9fa7b22f8bc","afbf7250b99d47bea07172749483ca97",22851681,1,-3,0,97,29,28,-1
"afbf7250b99d47bea07172749483ca97","a49d1bb4328949299686242fd0be5584",22851681,1,-10,0,98,28,21,-7
"b7719e26494940efa49512aedd0aac79","b7719e26494940efa49512aedd0aac79",22851681,2,0,1,100,20,20,0
"b7719e26494940efa49512aedd0aac79","afbf7250b99d47bea07172749483ca97",22851681,2,12,0,101,20,28,8
"afbf7250b99d47bea07172749483ca97","afbf7250b99d47bea07172749483ca97",22851681,2,0,1,102,28,28,0
"afbf7250b99d47bea07172749483ca97","4e51676dc72045d99c19b9fa7b22f8bc",22851681,2,3,0,103,28,29,1
"4e51676dc72045d99c19b9fa7b22f8bc","4e51676dc72045d99c19b9fa7b22f8bc",22851681,1,0,1,104,29,29,0
"4e51676dc72045d99c19b9fa7b22f8bc","51970cfa30e643e894e66ae85c8024cc",22851681,1,3,0,105,29,31,2
"51970cfa30e643e894e66ae85c8024cc","4e51676dc72045d99c19b9fa7b22f8bc",22851681,1,-3,0,106,31,29,-2
"4e51676dc72045d99c19b9fa7b22f8bc","c33c17be71ae4d588da7369472e5bb1b",22851681,1,9,0,107,29,34,5
"c33c17be71ae4d588da7369472e5bb1b","c33c17be71ae4d588da7369472e5bb1b",22851681,2,0,1,108,34,34,0
"c33c17be71ae4d588da7369472e5bb1b","93679be414554a11b1893002f2229a93",22851681,2,3,0,110,34,35,1
"93679be414554a11b1893002f2229a93","c33c17be71ae4d588da7369472e5bb1b",22851681,1,-3,0,111,35,34,-1
"93679be414554a11b1893002f2229a93","93679be414554a11b1893002f2229a93",22851681,2,0,1,113,35,35,0
"93679be414554a11b1893002f2229a93","7040a13096d746ac84b8fac8d9752058",22851681,2,3,0,115,35,36,1
"7040a13096d746ac84b8fac8d9752058","93679be414554a11b1893002f2229a93",22851681,1,-3,0,116,36,35,-1
"7040a13096d746ac84b8fac8d9752058","7040a13096d746ac84b8fac8d9752058",22851681,2,0,1,118,36,36,0
"7040a13096d746ac84b8fac8d9752058","9a0dc646f934470daf08c4b56ccf73db",22851681,2,3,0,120,36,37,1
"9a0dc646f934470daf08c4b56ccf73db","9a0dc646f934470daf08c4b56ccf73db",22851681,1,0,1,121,37,37,0
"9a0dc646f934470daf08c4b56ccf73db","fc0e049d56024bc9a02c9a9c435c3df7",22851681,3,3,0,122,37,38,1
"fc0e049d56024bc9a02c9a9c435c3df7","fc0e049d56024bc9a02c9a9c435c3df7",22851681,3,0,1,123,38,38,0
"fc0e049d56024bc9a02c9a9c435c3df7","67a089198fcb4e1c8f2385786c2b296f",22851681,5,4,0,124,38,39,1
"67a089198fcb4e1c8f2385786c2b296f","64d48c6c9c7940639a932219a6c87198",22851681,6,1,0,125,39,40,1
"64d48c6c9c7940639a932219a6c87198","67a089198fcb4e1c8f2385786c2b296f",22851681,3,-1,0,126,40,39,-1
"67a089198fcb4e1c8f2385786c2b296f","b534b89233134e30a9b5645138bfa9ee",22851681,2,4,0,127,39,41,2
"b534b89233134e30a9b5645138bfa9ee","9a0dc646f934470daf08c4b56ccf73db",22851681,1,-11,0,128,41,37,-4
"9a0dc646f934470daf08c4b56ccf73db","7040a13096d746ac84b8fac8d9752058",22851681,1,-3,0,129,37,36,-1
"64d48c6c9c7940639a932219a6c87198","64d48c6c9c7940639a932219a6c87198",22851681,2,0,1,135,40,40,0
"64d48c6c9c7940639a932219a6c87198","b534b89233134e30a9b5645138bfa9ee",22851681,1,3,0,136,40,41,1
"b534b89233134e30a9b5645138bfa9ee","67a089198fcb4e1c8f2385786c2b296f",22851681,1,-4,0,137,41,39,-2
"67a089198fcb4e1c8f2385786c2b296f","0e37b720d23b4e7f8b313e79313fd107",22851681,1,7,0,138,39,44,5
"0e37b720d23b4e7f8b313e79313fd107","0e37b720d23b4e7f8b313e79313fd107",22851681,4,0,1,139,44,44,0
"0e37b720d23b4e7f8b313e79313fd107","6875d67fdd5f48168b62719df449bebd",22851681,2,1,0,140,44,45,1
"6875d67fdd5f48168b62719df449bebd","6875d67fdd5f48168b62719df449bebd",22851681,2,0,1,141,45,45,0
"6875d67fdd5f48168b62719df449bebd","b534b89233134e30a9b5645138bfa9ee",22851681,1,-4,0,142,45,41,-4
"b534b89233134e30a9b5645138bfa9ee","6e13d61a7bdb44bca949c9f86fab3be5",22851681,3,7,0,143,41,47,6
"6e13d61a7bdb44bca949c9f86fab3be5","6e13d61a7bdb44bca949c9f86fab3be5",22851681,2,0,1,144,47,47,0
"6e13d61a7bdb44bca949c9f86fab3be5","0e37b720d23b4e7f8b313e79313fd107",22851681,1,-4,0,145,47,44,-3
"6875d67fdd5f48168b62719df449bebd","0e37b720d23b4e7f8b313e79313fd107",22851681,1,-1,0,149,45,44,-1
"0e37b720d23b4e7f8b313e79313fd107","b534b89233134e30a9b5645138bfa9ee",22851681,1,-3,0,152,44,41,-3
"6e13d61a7bdb44bca949c9f86fab3be5","195f78799f984cc2b06c48dfe36be751",22851681,2,2,0,155,47,49,2
"195f78799f984cc2b06c48dfe36be751","195f78799f984cc2b06c48dfe36be751",22851681,4,0,1,156,49,49,0
"195f78799f984cc2b06c48dfe36be751","d0c74f735e024943943e40333d6d337f",22851681,1,3,0,158,49,51,2
"d0c74f735e024943943e40333d6d337f","d9c8d8c444a64dadbbb508652c721e17",22851681,1,-6,0,159,51,46,-5
"d9c8d8c444a64dadbbb508652c721e17","d0c74f735e024943943e40333d6d337f",22851681,4,6,0,160,46,51,5
"d0c74f735e024943943e40333d6d337f","d0c74f735e024943943e40333d6d337f",22851681,4,0,1,161,51,51,0
"d0c74f735e024943943e40333d6d337f","983f8ff320594b279a7f4a6fe132f9c5",22851681,1,2,0,163,51,53,2
"983f8ff320594b279a7f4a6fe132f9c5","983f8ff320594b279a7f4a6fe132f9c5",22851681,2,0,1,164,53,53,0
"983f8ff320594b279a7f4a6fe132f9c5","35adfa5d923046aebabfefd98f35ff05",22851681,1,1,0,166,53,54,1
"35adfa5d923046aebabfefd98f35ff05","35adfa5d923046aebabfefd98f35ff05",22851681,2,0,1,167,54,54,0
"35adfa5d923046aebabfefd98f35ff05","b6f8a98476224da1b40e555ececc7ed8",22851681,1,1,0,169,54,55,1
"b6f8a98476224da1b40e555ececc7ed8","b6f8a98476224da1b40e555ececc7ed8",22851681,2,0,1,170,55,55,0
"b6f8a98476224da1b40e555ececc7ed8","86e22cb5fe0e4b47a9489ecddf7ed78f",22851681,1,1,0,172,55,56,1
"86e22cb5fe0e4b47a9489ecddf7ed78f","86e22cb5fe0e4b47a9489ecddf7ed78f",22851681,2,0,1,173,56,56,0
"86e22cb5fe0e4b47a9489ecddf7ed78f","f924752d8a1149668870b1e7698486f7",22851681,1,-6,0,175,56,50,-6
"f924752d8a1149668870b1e7698486f7","78f30e4dcac84e3cbea8b2cc6e0d62b3",22851681,1,10,0,176,50,59,9
"78f30e4dcac84e3cbea8b2cc6e0d62b3","a1f2f12debe5432fb7a70bcd12bacfb9",22851681,1,-1,0,177,59,58,-1
"a1f2f12debe5432fb7a70bcd12bacfb9","a1f2f12debe5432fb7a70bcd12bacfb9",22851681,11,0,1,178,58,58,0
"a1f2f12debe5432fb7a70bcd12bacfb9","9a0dc646f934470daf08c4b56ccf73db",22851681,1,-31,0,179,58,37,-21
"b534b89233134e30a9b5645138bfa9ee","b534b89233134e30a9b5645138bfa9ee",22851681,1,0,1,186,41,41,0
"6e13d61a7bdb44bca949c9f86fab3be5","d9c8d8c444a64dadbbb508652c721e17",22851681,1,-1,0,188,47,46,-1
"d0c74f735e024943943e40333d6d337f","f924752d8a1149668870b1e7698486f7",22851681,2,-1,0,190,51,50,-1
"f924752d8a1149668870b1e7698486f7","a1f2f12debe5432fb7a70bcd12bacfb9",22851681,2,9,0,191,50,58,8
"a1f2f12debe5432fb7a70bcd12bacfb9","b534b89233134e30a9b5645138bfa9ee",22851681,1,-20,0,193,58,41,-17
"b534b89233134e30a9b5645138bfa9ee","f924752d8a1149668870b1e7698486f7",22851681,1,11,0,194,41,50,9
"f924752d8a1149668870b1e7698486f7","b534b89233134e30a9b5645138bfa9ee",22851681,1,-11,0,195,50,41,-9
"b534b89233134e30a9b5645138bfa9ee","d0c74f735e024943943e40333d6d337f",22851681,1,12,0,196,41,51,10
"d0c74f735e024943943e40333d6d337f","6e13d61a7bdb44bca949c9f86fab3be5",22851681,1,-5,0,198,51,47,-4
"6e13d61a7bdb44bca949c9f86fab3be5","f924752d8a1149668870b1e7698486f7",22851681,1,4,0,199,47,50,3
"f924752d8a1149668870b1e7698486f7","6e13d61a7bdb44bca949c9f86fab3be5",22851681,1,-4,0,200,50,47,-3
"6e13d61a7bdb44bca949c9f86fab3be5","a1f2f12debe5432fb7a70bcd12bacfb9",22851681,1,13,0,201,47,58,11
"a1f2f12debe5432fb7a70bcd12bacfb9","78f30e4dcac84e3cbea8b2cc6e0d62b3",22851681,2,1,0,211,58,59,1
"78f30e4dcac84e3cbea8b2cc6e0d62b3","78f30e4dcac84e3cbea8b2cc6e0d62b3",22851681,32,0,1,212,59,59,0
"78f30e4dcac84e3cbea8b2cc6e0d62b3","d9c8d8c444a64dadbbb508652c721e17",22851681,1,-15,0,224,59,46,-13
"d0c74f735e024943943e40333d6d337f","78f30e4dcac84e3cbea8b2cc6e0d62b3",22851681,1,9,0,227,51,59,8
"78f30e4dcac84e3cbea8b2cc6e0d62b3","a0a418b8540d479fa6e0f653b701da8b",22851681,2,6,0,248,59,64,5
"a0a418b8540d479fa6e0f653b701da8b","bc42d26810654ea9a1df1efe1e58c7d5",22851681,2,-1,0,249,64,63,-1
"bc42d26810654ea9a1df1efe1e58c7d5","12aa6e1672ac4e7aa6449a7a8609cd72",22851681,2,-7,0,250,63,57,-6
"12aa6e1672ac4e7aa6449a7a8609cd72","4c943503763e4e349906eea3ed3c8e86",22851681,1,5,0,251,57,61,4
"4c943503763e4e349906eea3ed3c8e86","4c943503763e4e349906eea3ed3c8e86",22851681,1,0,1,252,61,61,0
"4c943503763e4e349906eea3ed3c8e86","bc42d26810654ea9a1df1efe1e58c7d5",22851681,1,2,0,253,61,63,2
"bc42d26810654ea9a1df1efe1e58c7d5","bc42d26810654ea9a1df1efe1e58c7d5",22851681,4,0,1,254,63,63,0
"bc42d26810654ea9a1df1efe1e58c7d5","a0a418b8540d479fa6e0f653b701da8b",22851681,1,1,0,257,63,64,1
"a0a418b8540d479fa6e0f653b701da8b","a0a418b8540d479fa6e0f653b701da8b",22851681,4,0,1,258,64,64,0
"a0a418b8540d479fa6e0f653b701da8b","309ccf3cc4fe429d9bfbaef53d3fa479",22851681,1,-4,0,261,64,60,-4
"309ccf3cc4fe429d9bfbaef53d3fa479","7af822066add4e7f8e007e4eee31a8bf",22851681,1,6,0,262,60,65,5
"7af822066add4e7f8e007e4eee31a8bf","6e13d61a7bdb44bca949c9f86fab3be5",22851681,1,-22,0,263,65,47,-18
"195f78799f984cc2b06c48dfe36be751","d9c8d8c444a64dadbbb508652c721e17",22851681,1,-3,0,267,49,46,-3
"12aa6e1672ac4e7aa6449a7a8609cd72","bc42d26810654ea9a1df1efe1e58c7d5",22851681,1,7,0,275,57,63,6
"bc42d26810654ea9a1df1efe1e58c7d5","309ccf3cc4fe429d9bfbaef53d3fa479",22851681,1,-3,0,277,63,60,-3
"309ccf3cc4fe429d9bfbaef53d3fa479","a0a418b8540d479fa6e0f653b701da8b",22851681,1,4,0,278,60,64,4
"a0a418b8540d479fa6e0f653b701da8b","b534b89233134e30a9b5645138bfa9ee",22851681,1,-27,0,280,64,41,-23
"b534b89233134e30a9b5645138bfa9ee","d646286c8051419bbc2e31dd1db55ca8",22851681,1,33,0,281,41,67,26
"d646286c8051419bbc2e31dd1db55ca8","267f883678b24aed855fde42524975d9",22851681,1,4,0,282,67,71,4
"267f883678b24aed855fde42524975d9","267f883678b24aed855fde42524975d9",22851681,1,0,1,283,71,71,0
"267f883678b24aed855fde42524975d9","88fff56d0342490dbef9040750a20f6c",22851681,1,1,0,284,71,72,1
"88fff56d0342490dbef9040750a20f6c","88fff56d0342490dbef9040750a20f6c",22851681,1,0,1,285,72,72,0
"88fff56d0342490dbef9040750a20f6c","adb17b12b66c4a49a85fd34322f7df70",22851681,1,1,0,286,72,73,1
"adb17b12b66c4a49a85fd34322f7df70","adb17b12b66c4a49a85fd34322f7df70",22851681,1,0,1,287,73,73,0
"adb17b12b66c4a49a85fd34322f7df70","d646286c8051419bbc2e31dd1db55ca8",22851681,1,-6,0,288,73,67,-6
"d646286c8051419bbc2e31dd1db55ca8","a2becd407db34b189200a32546d9d569",22851681,1,9,0,289,67,75,8
"a2becd407db34b189200a32546d9d569","a2becd407db34b189200a32546d9d569",22851681,12,0,1,290,75,75,0
"a2becd407db34b189200a32546d9d569","58c22b011d0f4c2ea6d13615edbb9eeb",22851681,1,2,0,302,75,77,2
"58c22b011d0f4c2ea6d13615edbb9eeb","58c22b011d0f4c2ea6d13615edbb9eeb",22851681,2,0,1,303,77,77,0
"58c22b011d0f4c2ea6d13615edbb9eeb","dd76e1861dc9461c830888729d091ee0",22851681,1,1,0,305,77,78,1
"dd76e1861dc9461c830888729d091ee0","dd76e1861dc9461c830888729d091ee0",22851681,5,0,1,306,78,78,0
"dd76e1861dc9461c830888729d091ee0","cd1d828f1a694b87913a7ea66c23803e",22851681,1,1,0,311,78,79,1
"cd1d828f1a694b87913a7ea66c23803e","cd1d828f1a694b87913a7ea66c23803e",22851681,2,0,1,312,79,79,0
"cd1d828f1a694b87913a7ea66c23803e","9176a3c2b4d2465fa8b0c67096c2a97e",22851681,1,1,0,314,79,80,1
"9176a3c2b4d2465fa8b0c67096c2a97e","9176a3c2b4d2465fa8b0c67096c2a97e",22851681,5,0,1,315,80,80,0
"9176a3c2b4d2465fa8b0c67096c2a97e","f8ec6445f7194e25b9101d4fbcb07a18",22851681,1,1,0,320,80,81,1
"f8ec6445f7194e25b9101d4fbcb07a18","f8ec6445f7194e25b9101d4fbcb07a18",22851681,2,0,1,321,81,81,0
"f8ec6445f7194e25b9101d4fbcb07a18","140d5b27b8574befad82c0a013b59dfa",22851681,1,-7,0,323,81,74,-7
"140d5b27b8574befad82c0a013b59dfa","67a089198fcb4e1c8f2385786c2b296f",22851681,1,-45,0,324,74,39,-35
"67a089198fcb4e1c8f2385786c2b296f","d18a9ea32855445f8736581f5cb119ce",22851681,1,54,0,325,39,82,43
"d18a9ea32855445f8736581f5cb119ce","f564483cbd7a407681aa2fcca518cf5f",22851681,1,4,0,326,82,85,3
"f564483cbd7a407681aa2fcca518cf5f","f564483cbd7a407681aa2fcca518cf5f",22851681,1,0,1,327,85,85,0
"f564483cbd7a407681aa2fcca518cf5f","18fd01350bd5434ca636d59a599d768a",22851681,1,1,0,328,85,86,1
"18fd01350bd5434ca636d59a599d768a","18fd01350bd5434ca636d59a599d768a",22851681,5,0,1,329,86,86,0
"18fd01350bd5434ca636d59a599d768a","ae5ac430ea254e708a6f5deaaf7464ae",22851681,1,-2,0,334,86,84,-2
"ae5ac430ea254e708a6f5deaaf7464ae","6a9f0ef185fb47f0937e29daa1c71ed5",22851681,1,7,0,335,84,90,6
"6a9f0ef185fb47f0937e29daa1c71ed5","c681290961c94c4caf23b529d1ae6b9a",22851681,1,-2,0,336,90,88,-2
"c681290961c94c4caf23b529d1ae6b9a","c681290961c94c4caf23b529d1ae6b9a",22851681,1,0,1,337,88,88,0
"c681290961c94c4caf23b529d1ae6b9a","6a9f0ef185fb47f0937e29daa1c71ed5",22851681,1,2,0,338,88,90,2
"6a9f0ef185fb47f0937e29daa1c71ed5","6a9f0ef185fb47f0937e29daa1c71ed5",22851681,3,0,1,339,90,90,0
"6a9f0ef185fb47f0937e29daa1c71ed5","d646286c8051419bbc2e31dd1db55ca8",22851681,1,-27,0,342,90,67,-23
"d646286c8051419bbc2e31dd1db55ca8","e20db35ced8544ddac5bc3839145e463",22851681,1,30,0,343,67,91,24
"e20db35ced8544ddac5bc3839145e463","1febb706d7a34005ae8711ed49c76e64",22851681,1,3,0,344,91,94,3
"1febb706d7a34005ae8711ed49c76e64","1febb706d7a34005ae8711ed49c76e64",22851681,2,0,1,345,94,94,0
"1febb706d7a34005ae8711ed49c76e64","8f73ba6f5a0042f2850356ac38ac6f24",22851681,1,1,0,347,94,95,1
"8f73ba6f5a0042f2850356ac38ac6f24","8f73ba6f5a0042f2850356ac38ac6f24",22851681,5,0,1,348,95,95,0
"8f73ba6f5a0042f2850356ac38ac6f24","e2260b86653c46d7b14a41fb419dbf8c",22851681,1,1,0,353,95,96,1
"e2260b86653c46d7b14a41fb419dbf8c","e2260b86653c46d7b14a41fb419dbf8c",22851681,2,0,1,354,96,96,0
"e2260b86653c46d7b14a41fb419dbf8c","fab84b4fab5940efb4ea868ef8d09396",22851681,1,250,0,356,96,284,188
"fab84b4fab5940efb4ea868ef8d09396","e20db35ced8544ddac5bc3839145e463",22851681,1,-255,0,357,284,91,-193
"e20db35ced8544ddac5bc3839145e463","e20db35ced8544ddac5bc3839145e463",22851681,2,0,1,358,91,91,0
"e20db35ced8544ddac5bc3839145e463","35eb641ad1d845bbba54915bce75a962",22851681,1,6,0,359,91,97,6
"35eb641ad1d845bbba54915bce75a962","35eb641ad1d845bbba54915bce75a962",22851681,6,0,1,360,97,97,0
"35eb641ad1d845bbba54915bce75a962","08be90ffbeea4795a138cd42ed8db56f",22851681,1,1,0,366,97,98,1
"08be90ffbeea4795a138cd42ed8db56f","08be90ffbeea4795a138cd42ed8db56f",22851681,2,0,1,367,98,98,0
"08be90ffbeea4795a138cd42ed8db56f","3007433c8f584dcbb5ac159c1c5f2be3",22851681,1,1,0,369,98,99,1
"3007433c8f584dcbb5ac159c1c5f2be3","3007433c8f584dcbb5ac159c1c5f2be3",22851681,5,0,1,370,99,99,0
"3007433c8f584dcbb5ac159c1c5f2be3","e20db35ced8544ddac5bc3839145e463",22851681,1,-8,0,375,99,91,-8
"e20db35ced8544ddac5bc3839145e463","00ae5f0c51874a73a41ebea838d95682",22851681,2,11,0,376,91,101,10
"00ae5f0c51874a73a41ebea838d95682","d391c8b6e56a43a7b654e9dee02d904b",22851681,2,2,0,377,101,103,2
"d391c8b6e56a43a7b654e9dee02d904b","00ae5f0c51874a73a41ebea838d95682",22851681,1,-2,0,378,103,101,-2
"00ae5f0c51874a73a41ebea838d95682","00ae5f0c51874a73a41ebea838d95682",22851681,1,0,1,379,101,101,0
"d391c8b6e56a43a7b654e9dee02d904b","d391c8b6e56a43a7b654e9dee02d904b",22851681,16,0,1,381,103,103,0
"d391c8b6e56a43a7b654e9dee02d904b","6111116566fc4fd9abba409322bea245",22851681,1,1,0,397,103,104,1
"6111116566fc4fd9abba409322bea245","6111116566fc4fd9abba409322bea245",22851681,2,0,1,398,104,104,0
"6111116566fc4fd9abba409322bea245","a81b2235cb9c499eb9ea8ee0a8dd9725",22851681,1,1,0,400,104,105,1
"a81b2235cb9c499eb9ea8ee0a8dd9725","a81b2235cb9c499eb9ea8ee0a8dd9725",22851681,2,0,1,401,105,105,0
"a81b2235cb9c499eb9ea8ee0a8dd9725","2d4e0ab0ef3b4d73b82c72d4621a7579",22851681,1,1,0,403,105,106,1
"2d4e0ab0ef3b4d73b82c72d4621a7579","2d4e0ab0ef3b4d73b82c72d4621a7579",22851681,2,0,1,404,106,106,0
"2d4e0ab0ef3b4d73b82c72d4621a7579","8bdebf492ebd4e62b0d522e8ab5e5197",22851681,1,1,0,406,106,107,1
"8bdebf492ebd4e62b0d522e8ab5e5197","8bdebf492ebd4e62b0d522e8ab5e5197",22851681,2,0,1,407,107,107,0
"8bdebf492ebd4e62b0d522e8ab5e5197","73039f8c1eb9409cb4caee2cf968001e",22851681,1,-7,0,409,107,100,-7
"73039f8c1eb9409cb4caee2cf968001e","4280927ec4d643238aa49c32f9e06c6c",22851681,1,10,0,410,100,109,9
"4280927ec4d643238aa49c32f9e06c6c","4280927ec4d643238aa49c32f9e06c6c",22851681,3,0,1,411,109,109,0
"4280927ec4d643238aa49c32f9e06c6c","fc44e6a5f7654430af1227838224dceb",22851681,1,2,0,414,109,111,2
"fc44e6a5f7654430af1227838224dceb","fc44e6a5f7654430af1227838224dceb",22851681,2,0,1,415,111,111,0
"fc44e6a5f7654430af1227838224dceb","08111f75e22d409998cf8b85bd431f0a",22851681,1,-3,0,417,111,108,-3
"08111f75e22d409998cf8b85bd431f0a","a9ae0a3c070d455bb4369a8996313336",22851681,2,7,0,418,108,114,6
"a9ae0a3c070d455bb4369a8996313336","a9ae0a3c070d455bb4369a8996313336",22851681,10,0,1,419,114,114,0
"a9ae0a3c070d455bb4369a8996313336","e20db35ced8544ddac5bc3839145e463",22851681,2,-26,0,429,114,91,-23
"00ae5f0c51874a73a41ebea838d95682","73039f8c1eb9409cb4caee2cf968001e",22851681,1,-1,0,432,101,100,-1
"73039f8c1eb9409cb4caee2cf968001e","d391c8b6e56a43a7b654e9dee02d904b",22851681,1,3,0,433,100,103,3
"d391c8b6e56a43a7b654e9dee02d904b","08111f75e22d409998cf8b85bd431f0a",22851681,1,6,0,434,103,108,5
"a9ae0a3c070d455bb4369a8996313336","4280927ec4d643238aa49c32f9e06c6c",22851681,1,-6,0,436,114,109,-5
"4280927ec4d643238aa49c32f9e06c6c","71cec822bcff4f30a20e75dc63ef7b65",22851681,1,8,0,437,109,116,7
"71cec822bcff4f30a20e75dc63ef7b65","71cec822bcff4f30a20e75dc63ef7b65",22851681,1,0,1,438,116,116,0
"71cec822bcff4f30a20e75dc63ef7b65","37319e88176d4aefa91d7a9980dbae91",22851681,1,-4,0,439,116,112,-4
"37319e88176d4aefa91d7a9980dbae91","62bff51286ef4f348717a3cf6fe2318f",22851681,1,9,0,440,112,120,8
"62bff51286ef4f348717a3cf6fe2318f","37319e88176d4aefa91d7a9980dbae91",22851681,1,-9,0,441,120,112,-8
"37319e88176d4aefa91d7a9980dbae91","e20db35ced8544ddac5bc3839145e463",22851681,1,-24,0,442,112,91,-21
"e20db35ced8544ddac5bc3839145e463","a9ae0a3c070d455bb4369a8996313336",22851681,1,26,0,443,91,114,23
"e20db35ced8544ddac5bc3839145e463","62bff51286ef4f348717a3cf6fe2318f",22851681,1,33,0,445,91,120,29
"62bff51286ef4f348717a3cf6fe2318f","e20db35ced8544ddac5bc3839145e463",22851681,1,-33,0,446,120,91,-29
"e20db35ced8544ddac5bc3839145e463","b1cd0e7dc3ad4a8eb91a4bfdbeb025b0",22851681,1,31,0,447,91,118,27
"b1cd0e7dc3ad4a8eb91a4bfdbeb025b0","b1cd0e7dc3ad4a8eb91a4bfdbeb025b0",22851681,1,0,1,448,118,118,0
"b1cd0e7dc3ad4a8eb91a4bfdbeb025b0","62bff51286ef4f348717a3cf6fe2318f",22851681,1,2,0,449,118,120,2
"62bff51286ef4f348717a3cf6fe2318f","62bff51286ef4f348717a3cf6fe2318f",22851681,3,0,1,450,120,120,0
"62bff51286ef4f348717a3cf6fe2318f","779f9ddd1fd14d1e9e69f72219a1fdbd",22851681,1,3,0,453,120,121,1
"779f9ddd1fd14d1e9e69f72219a1fdbd","e20db35ced8544ddac5bc3839145e463",22851681,1,-36,0,454,121,91,-30
"e20db35ced8544ddac5bc3839145e463","ae26e6cda8ad4a3f81bd347560d9579f",22851681,1,40,0,455,91,125,34
"ae26e6cda8ad4a3f81bd347560d9579f","ae26e6cda8ad4a3f81bd347560d9579f",22851681,4,0,1,456,125,125,0
"ae26e6cda8ad4a3f81bd347560d9579f","ee48df95832b4374aa273ceb27ec1315",22851681,1,1,0,460,125,126,1
"ee48df95832b4374aa273ceb27ec1315","ee48df95832b4374aa273ceb27ec1315",22851681,1,0,1,461,126,126,0
"ee48df95832b4374aa273ceb27ec1315","7a439da90b394756ad1777fc4c6dead5",22851681,1,1,0,462,126,127,1
"7a439da90b394756ad1777fc4c6dead5","7a439da90b394756ad1777fc4c6dead5",22851681,3,0,1,463,127,127,0
"7a439da90b394756ad1777fc4c6dead5","779f9ddd1fd14d1e9e69f72219a1fdbd",22851681,1,-6,0,466,127,121,-6
"779f9ddd1fd14d1e9e69f72219a1fdbd","a8dd5213034441ac92724b4e83eb0bb2",22851681,1,9,0,467,121,129,8
"a8dd5213034441ac92724b4e83eb0bb2","a8dd5213034441ac92724b4e83eb0bb2",22851681,3,0,1,468,129,129,0
"a8dd5213034441ac92724b4e83eb0bb2","8115eab6556b45f5b415c3b8c26a12e5",22851681,1,2,0,471,129,131,2
"8115eab6556b45f5b415c3b8c26a12e5","8115eab6556b45f5b415c3b8c26a12e5",22851681,2,0,1,472,131,131,0
"8115eab6556b45f5b415c3b8c26a12e5","ec34b06efd844b46a4c4818ecdb9b8f4",22851681,1,1,0,474,131,132,1
"ec34b06efd844b46a4c4818ecdb9b8f4","ec34b06efd844b46a4c4818ecdb9b8f4",22851681,2,0,1,475,132,132,0
"ec34b06efd844b46a4c4818ecdb9b8f4","c2e1c2b9eac64109b343a088584b576b",22851681,1,1,0,477,132,133,1
"c2e1c2b9eac64109b343a088584b576b","c2e1c2b9eac64109b343a088584b576b",22851681,2,0,1,478,133,133,0
"c2e1c2b9eac64109b343a088584b576b","579338175e0b4bbb8ef3b712b5d8b54e",22851681,1,-5,0,480,133,128,-5
"579338175e0b4bbb8ef3b712b5d8b54e","8bc5795d6a984a3eace4e2811e52dd4f",22851681,1,8,0,481,128,135,7
"8bc5795d6a984a3eace4e2811e52dd4f","8bc5795d6a984a3eace4e2811e52dd4f",22851681,1,0,1,482,135,135,0
"8bc5795d6a984a3eace4e2811e52dd4f","b416d47c56a742199b5d7c7f19d6503a",22851681,1,-1,0,483,135,134,-1
"b416d47c56a742199b5d7c7f19d6503a","cd4532ad48034873ba8bce2aac0c9808",22851681,1,4,0,484,134,137,3
"cd4532ad48034873ba8bce2aac0c9808","cd4532ad48034873ba8bce2aac0c9808",22851681,1,0,1,485,137,137,0
"cd4532ad48034873ba8bce2aac0c9808","779f9ddd1fd14d1e9e69f72219a1fdbd",22851681,1,-19,0,486,137,121,-16
"779f9ddd1fd14d1e9e69f72219a1fdbd","df1de691dafe4549a18a4398ee9dfaf9",22851681,1,23,0,487,121,139,18
"df1de691dafe4549a18a4398ee9dfaf9","6c5ad271a44743479bfaea29b1db8d02",22851681,3,4,0,488,139,143,4
"6c5ad271a44743479bfaea29b1db8d02","df1de691dafe4549a18a4398ee9dfaf9",22851681,1,-4,0,489,143,139,-4
"6c5ad271a44743479bfaea29b1db8d02","0c7262dff33c4087bc660ccf40f92f9c",22851681,1,39,0,491,143,169,26
"0c7262dff33c4087bc660ccf40f92f9c","b2275c3fad834f8d90737a2d9a6927d6",22851681,7,3,0,492,169,172,3
"b2275c3fad834f8d90737a2d9a6927d6","df1de691dafe4549a18a4398ee9dfaf9",22851681,1,-46,0,493,172,139,-33
"df1de691dafe4549a18a4398ee9dfaf9","df1de691dafe4549a18a4398ee9dfaf9",22851681,2,0,1,494,139,139,0
"6c5ad271a44743479bfaea29b1db8d02","6c5ad271a44743479bfaea29b1db8d02",22851681,6,0,1,497,143,143,0
"6c5ad271a44743479bfaea29b1db8d02","83d311bed5374fee83d8d67a7d9d82dc",22851681,1,1,0,503,143,144,1
"83d311bed5374fee83d8d67a7d9d82dc","83d311bed5374fee83d8d67a7d9d82dc",22851681,1,0,1,504,144,144,0
"83d311bed5374fee83d8d67a7d9d82dc","402bba41861d43acb52a5abb89e8831e",22851681,1,1,0,505,144,145,1
"402bba41861d43acb52a5abb89e8831e","402bba41861d43acb52a5abb89e8831e",22851681,5,0,1,506,145,145,0
"402bba41861d43acb52a5abb89e8831e","df1de691dafe4549a18a4398ee9dfaf9",22851681,1,-6,0,511,145,139,-6
"df1de691dafe4549a18a4398ee9dfaf9","8aae34f5ddbb4052a709b12e6b0d40fa",22851681,1,9,0,512,139,147,8
"8aae34f5ddbb4052a709b12e6b0d40fa","8aae34f5ddbb4052a709b12e6b0d40fa",22851681,2,0,1,513,147,147,0
"8aae34f5ddbb4052a709b12e6b0d40fa","645b3f0249f64f76af2e19eb4d0e55b7",22851681,1,2,0,515,147,149,2
"645b3f0249f64f76af2e19eb4d0e55b7","645b3f0249f64f76af2e19eb4d0e55b7",22851681,5,0,1,516,149,149,0
"645b3f0249f64f76af2e19eb4d0e55b7","7e7b8db5064d4369805ab370aac5ddfb",22851681,1,1,0,521,149,150,1
"7e7b8db5064d4369805ab370aac5ddfb","7e7b8db5064d4369805ab370aac5ddfb",22851681,5,0,1,522,150,150,0
"7e7b8db5064d4369805ab370aac5ddfb","8956d210ae7f41968fada86d4c979d6a",22851681,1,1,0,527,150,151,1
"8956d210ae7f41968fada86d4c979d6a","8956d210ae7f41968fada86d4c979d6a",22851681,2,0,1,528,151,151,0
"8956d210ae7f41968fada86d4c979d6a","f902b0f41b544d4dbf79664fd233648d",22851681,1,-5,0,530,151,146,-5
"f902b0f41b544d4dbf79664fd233648d","ae781e8b775e4ccd93bc800dad5c8376",22851681,1,8,0,531,146,153,7
"ae781e8b775e4ccd93bc800dad5c8376","ae781e8b775e4ccd93bc800dad5c8376",22851681,2,0,1,532,153,153,0
"ae781e8b775e4ccd93bc800dad5c8376","06882a8492d9499aa31555567f575ecb",22851681,1,1,0,534,153,154,1
"06882a8492d9499aa31555567f575ecb","06882a8492d9499aa31555567f575ecb",22851681,1,0,1,535,154,154,0
"06882a8492d9499aa31555567f575ecb","f293c508f409466a8f27ddd7d1e40b20",22851681,1,1,0,536,154,155,1
"f293c508f409466a8f27ddd7d1e40b20","f293c508f409466a8f27ddd7d1e40b20",22851681,2,0,1,537,155,155,0
"f293c508f409466a8f27ddd7d1e40b20","cc4ddef5bbbe48ebb605141b347c4ed1",22851681,1,1,0,539,155,156,1
"cc4ddef5bbbe48ebb605141b347c4ed1","cc4ddef5bbbe48ebb605141b347c4ed1",22851681,1,0,1,540,156,156,0
"cc4ddef5bbbe48ebb605141b347c4ed1","f03480cf4eba413194d7af52fc0e7f28",22851681,1,-4,0,541,156,152,-4
"f03480cf4eba413194d7af52fc0e7f28","d313cec988a84645bee413e8d4724a4b",22851681,1,7,0,542,152,158,6
"d313cec988a84645bee413e8d4724a4b","d313cec988a84645bee413e8d4724a4b",22851681,4,0,1,543,158,158,0
"d313cec988a84645bee413e8d4724a4b","dc60696c76a74368a60f72246e47700d",22851681,1,1,0,547,158,159,1
"dc60696c76a74368a60f72246e47700d","dc60696c76a74368a60f72246e47700d",22851681,3,0,1,548,159,159,0
"dc60696c76a74368a60f72246e47700d","df1de691dafe4549a18a4398ee9dfaf9",22851681,1,-23,0,551,159,139,-20
"df1de691dafe4549a18a4398ee9dfaf9","78adeee1fa2c4fe0bc73f7bca9fcee86",22851681,1,26,0,552,139,160,21
"78adeee1fa2c4fe0bc73f7bca9fcee86","65202579580f4ad38d734b4ee39d22a8",22851681,2,5,0,553,160,164,4
"65202579580f4ad38d734b4ee39d22a8","65202579580f4ad38d734b4ee39d22a8",22851681,6,0,1,554,164,164,0
"65202579580f4ad38d734b4ee39d22a8","78adeee1fa2c4fe0bc73f7bca9fcee86",22851681,2,-5,0,556,164,160,-4
"78adeee1fa2c4fe0bc73f7bca9fcee86","78adeee1fa2c4fe0bc73f7bca9fcee86",22851681,1,0,1,563,160,160,0
"78adeee1fa2c4fe0bc73f7bca9fcee86","3cbcea2be0984e7dbd5a48195af10ce7",22851681,1,8,0,564,160,165,5
"3cbcea2be0984e7dbd5a48195af10ce7","82e6285962b8400d9d6fc32436022a94",22851681,2,2,0,565,165,167,2
"82e6285962b8400d9d6fc32436022a94","3cbcea2be0984e7dbd5a48195af10ce7",22851681,1,-2,0,566,167,165,-2
"3cbcea2be0984e7dbd5a48195af10ce7","a9ac840f098c4bd0a2ee896214ce29cd",22851681,1,5,0,567,165,168,3
"a9ac840f098c4bd0a2ee896214ce29cd","3cbcea2be0984e7dbd5a48195af10ce7",22851681,1,-5,0,568,168,165,-3
"3cbcea2be0984e7dbd5a48195af10ce7","3cbcea2be0984e7dbd5a48195af10ce7",22851681,1,0,1,569,165,165,0
"82e6285962b8400d9d6fc32436022a94","0c7262dff33c4087bc660ccf40f92f9c",22851681,1,7,0,571,167,169,2
"0c7262dff33c4087bc660ccf40f92f9c","0c7262dff33c4087bc660ccf40f92f9c",22851681,3,0,1,572,169,169,0
"b2275c3fad834f8d90737a2d9a6927d6","b2275c3fad834f8d90737a2d9a6927d6",22851681,100,0,1,574,172,172,0
"b2275c3fad834f8d90737a2d9a6927d6","eb515a26030b41f8a82a1e6114420bad",22851681,1,1,0,674,172,173,1
"eb515a26030b41f8a82a1e6114420bad","eb515a26030b41f8a82a1e6114420bad",22851681,2,0,1,675,173,173,0
"eb515a26030b41f8a82a1e6114420bad","b42cc17b7de840f181a704558d0bc845",22851681,1,3,0,677,173,175,2
"b42cc17b7de840f181a704558d0bc845","0c7262dff33c4087bc660ccf40f92f9c",22851681,2,-7,0,678,175,169,-6
"0c7262dff33c4087bc660ccf40f92f9c","b42cc17b7de840f181a704558d0bc845",22851681,1,7,0,679,169,175,6
"b42cc17b7de840f181a704558d0bc845","b42cc17b7de840f181a704558d0bc845",22851681,2,0,1,680,175,175,0
"b42cc17b7de840f181a704558d0bc845","801f9e9135034f49bf5f8b4bdefedb41",22851681,1,2,0,682,175,177,2
"801f9e9135034f49bf5f8b4bdefedb41","801f9e9135034f49bf5f8b4bdefedb41",22851681,4,0,1,683,177,177,0
"801f9e9135034f49bf5f8b4bdefedb41","362fcb0699a14845ab29b2340093e528",22851681,1,-3,0,687,177,174,-3
"362fcb0699a14845ab29b2340093e528","ea38cc0e6e6e41edbabf210220808bf9",22851681,2,6,0,688,174,179,5
"ea38cc0e6e6e41edbabf210220808bf9","b87c552dd247427abe6ab5795b9c9d43",22851681,3,2,0,689,179,181,2
"b87c552dd247427abe6ab5795b9c9d43","ea38cc0e6e6e41edbabf210220808bf9",22851681,2,-2,0,690,181,179,-2
"ea38cc0e6e6e41edbabf210220808bf9","ea38cc0e6e6e41edbabf210220808bf9",22851681,2,0,1,691,179,179,0
"ea38cc0e6e6e41edbabf210220808bf9","0c7262dff33c4087bc660ccf40f92f9c",22851681,1,-12,0,693,179,169,-10
"b2275c3fad834f8d90737a2d9a6927d6","b42cc17b7de840f181a704558d0bc845",22851681,1,4,0,696,172,175,3
"0c7262dff33c4087bc660ccf40f92f9c","362fcb0699a14845ab29b2340093e528",22851681,1,6,0,698,169,174,5
"b87c552dd247427abe6ab5795b9c9d43","b87c552dd247427abe6ab5795b9c9d43",22851681,14,0,1,701,181,181,0
"b87c552dd247427abe6ab5795b9c9d43","139b097acfca451689d80c9c6eebdf7b",22851681,2,-3,0,715,181,178,-3
"139b097acfca451689d80c9c6eebdf7b","2024b4885bd14338a39b7b509acbbd02",22851681,1,5,0,716,178,182,4
"2024b4885bd14338a39b7b509acbbd02","cf4c280bad6a43e6b131d8385ef9ef3f",22851681,2,3,0,717,182,184,2
"cf4c280bad6a43e6b131d8385ef9ef3f","30f660a1feb34582a739722532524f79",22851681,2,-2,0,718,184,183,-1
"30f660a1feb34582a739722532524f79","30f660a1feb34582a739722532524f79",22851681,8,0,1,719,183,183,0
"30f660a1feb34582a739722532524f79","0c7262dff33c4087bc660ccf40f92f9c",22851681,1,-17,0,722,183,169,-14
"0c7262dff33c4087bc660ccf40f92f9c","139b097acfca451689d80c9c6eebdf7b",22851681,1,11,0,724,169,178,9
"139b097acfca451689d80c9c6eebdf7b","0c7262dff33c4087bc660ccf40f92f9c",22851681,1,-11,0,725,178,169,-9
"0c7262dff33c4087bc660ccf40f92f9c","ea38cc0e6e6e41edbabf210220808bf9",22851681,1,12,0,726,169,179,10
"ea38cc0e6e6e41edbabf210220808bf9","139b097acfca451689d80c9c6eebdf7b",22851681,1,-1,0,729,179,178,-1
"139b097acfca451689d80c9c6eebdf7b","30f660a1feb34582a739722532524f79",22851681,2,6,0,730,178,183,5
"30f660a1feb34582a739722532524f79","ea38cc0e6e6e41edbabf210220808bf9",22851681,1,-5,0,733,183,179,-4
"ea38cc0e6e6e41edbabf210220808bf9","2024b4885bd14338a39b7b509acbbd02",22851681,1,4,0,734,179,182,3
"2024b4885bd14338a39b7b509acbbd02","b87c552dd247427abe6ab5795b9c9d43",22851681,1,-2,0,735,182,181,-1
"30f660a1feb34582a739722532524f79","2024b4885bd14338a39b7b509acbbd02",22851681,2,-1,0,741,183,182,-1
"2024b4885bd14338a39b7b509acbbd02","c3f63fe50d8e487c86bf8ef76c9cadd3",22851681,1,4,0,745,182,185,3
"c3f63fe50d8e487c86bf8ef76c9cadd3","c3f63fe50d8e487c86bf8ef76c9cadd3",22851681,1,0,1,746,185,185,0
"c3f63fe50d8e487c86bf8ef76c9cadd3","0c7262dff33c4087bc660ccf40f92f9c",22851681,1,-20,0,747,185,169,-16
"0c7262dff33c4087bc660ccf40f92f9c","c8e371568a0c4391b25796ae4e91952e",22851681,1,23,0,748,169,186,17
"c8e371568a0c4391b25796ae4e91952e","7d932b23e1c84326ae5aa4d3c0d813d1",22851681,1,2,0,749,186,188,2
"7d932b23e1c84326ae5aa4d3c0d813d1","7d932b23e1c84326ae5aa4d3c0d813d1",22851681,3,0,1,750,188,188,0
"7d932b23e1c84326ae5aa4d3c0d813d1","c8e371568a0c4391b25796ae4e91952e",22851681,1,-2,0,753,188,186,-2
"c8e371568a0c4391b25796ae4e91952e","ab11d94c6c8948ea90b88f19d2cd502b",22851681,1,5,0,754,186,190,4
"ab11d94c6c8948ea90b88f19d2cd502b","ab11d94c6c8948ea90b88f19d2cd502b",22851681,1,0,1,755,190,190,0
"ab11d94c6c8948ea90b88f19d2cd502b","f992451ed6ad4e68bb9e68ad6be7c4be",22851681,1,2,0,756,190,192,2
"f992451ed6ad4e68bb9e68ad6be7c4be","f992451ed6ad4e68bb9e68ad6be7c4be",22851681,1,0,1,757,192,192,0
"f992451ed6ad4e68bb9e68ad6be7c4be","07b44a7a51e94c78b411c753fc39dab0",22851681,1,-3,0,758,192,189,-3
"07b44a7a51e94c78b411c753fc39dab0","6cd2dcaac46847d4a0bc53f296d90375",22851681,1,6,0,759,189,194,5
"6cd2dcaac46847d4a0bc53f296d90375","6cd2dcaac46847d4a0bc53f296d90375",22851681,1,0,1,760,194,194,0
"6cd2dcaac46847d4a0bc53f296d90375","2d2580c9411c4972909db508d6956a58",22851681,1,2,0,761,194,196,2
"2d2580c9411c4972909db508d6956a58","2d2580c9411c4972909db508d6956a58",22851681,5,0,1,762,196,196,0
"2d2580c9411c4972909db508d6956a58","5bddb3d9ed264f3984702f048c7e5340",22851681,1,1,0,767,196,197,1
"5bddb3d9ed264f3984702f048c7e5340","5bddb3d9ed264f3984702f048c7e5340",22851681,2,0,1,768,197,197,0
"5bddb3d9ed264f3984702f048c7e5340","d5e8e2bd12a2466b9d6d90855f0eb079",22851681,1,1,0,770,197,198,1
"d5e8e2bd12a2466b9d6d90855f0eb079","d5e8e2bd12a2466b9d6d90855f0eb079",22851681,2,0,1,771,198,198,0
"d5e8e2bd12a2466b9d6d90855f0eb079","017d7ca8e0394b91aaadc9574df2202c",22851681,1,-5,0,773,198,193,-5
"017d7ca8e0394b91aaadc9574df2202c","54e8e9f0ea3e45c4bf3b8ac799ee31b1",22851681,1,8,0,774,193,200,7
"54e8e9f0ea3e45c4bf3b8ac799ee31b1","54e8e9f0ea3e45c4bf3b8ac799ee31b1",22851681,1,0,1,775,200,200,0
"54e8e9f0ea3e45c4bf3b8ac799ee31b1","c614a00911be4877a075f19315530fb0",22851681,1,1,0,776,200,201,1
"c614a00911be4877a075f19315530fb0","c614a00911be4877a075f19315530fb0",22851681,6,0,1,777,201,201,0
"c614a00911be4877a075f19315530fb0","a6c21bd8b95249c7972820a7a7d76aff",22851681,1,1,0,783,201,202,1
"a6c21bd8b95249c7972820a7a7d76aff","a6c21bd8b95249c7972820a7a7d76aff",22851681,1,0,1,784,202,202,0
"a6c21bd8b95249c7972820a7a7d76aff","bb329d880ab54120adaf203a693bb203",22851681,1,1,0,785,202,203,1
"bb329d880ab54120adaf203a693bb203","bb329d880ab54120adaf203a693bb203",22851681,1,0,1,786,203,203,0
"bb329d880ab54120adaf203a693bb203","f9170dd6bc6442b4acd832747609b09a",22851681,1,-4,0,787,203,199,-4
"f9170dd6bc6442b4acd832747609b09a","334c2344009840079b1d0e1b7ce3d5a7",22851681,1,7,0,788,199,205,6
"334c2344009840079b1d0e1b7ce3d5a7","334c2344009840079b1d0e1b7ce3d5a7",22851681,3,0,1,789,205,205,0
"334c2344009840079b1d0e1b7ce3d5a7","c8e371568a0c4391b25796ae4e91952e",22851681,1,-23,0,792,205,186,-19
"c8e371568a0c4391b25796ae4e91952e","d7f13c8d63ec4e2aa673fbb9cf9c6933",22851681,1,26,0,793,186,206,20
"d7f13c8d63ec4e2aa673fbb9cf9c6933","b9e80f77c3a44349863b19875725c384",22851681,1,1,0,794,206,207,1
"b9e80f77c3a44349863b19875725c384","7108f0e4c2584f1f9c471689ae4c885c",22851681,2,1,0,795,207,208,1
"7108f0e4c2584f1f9c471689ae4c885c","b9e80f77c3a44349863b19875725c384",22851681,1,-1,0,796,208,207,-1
"b9e80f77c3a44349863b19875725c384","b9e80f77c3a44349863b19875725c384",22851681,33,0,1,797,207,207,0
"7108f0e4c2584f1f9c471689ae4c885c","7108f0e4c2584f1f9c471689ae4c885c",22851681,36,0,1,831,208,208,0
"7108f0e4c2584f1f9c471689ae4c885c","d7f13c8d63ec4e2aa673fbb9cf9c6933",22851681,1,-2,0,867,208,206,-2
"d7f13c8d63ec4e2aa673fbb9cf9c6933","09400e101c5d4b439cf9a26b03aae558",22851681,1,5,0,868,206,210,4
"09400e101c5d4b439cf9a26b03aae558","09400e101c5d4b439cf9a26b03aae558",22851681,1,0,1,869,210,210,0
"09400e101c5d4b439cf9a26b03aae558","a88efa7e50ce47159810ab553afa6d3a",22851681,1,2,0,870,210,212,2
"a88efa7e50ce47159810ab553afa6d3a","a88efa7e50ce47159810ab553afa6d3a",22851681,5,0,1,871,212,212,0
"a88efa7e50ce47159810ab553afa6d3a","a875096404ef4a9984b62d74cda916f9",22851681,1,-3,0,876,212,209,-3
"a875096404ef4a9984b62d74cda916f9","be502a7a43c44bf7b682698de79d9369",22851681,1,6,0,877,209,214,5
"be502a7a43c44bf7b682698de79d9369","f7fb1952f56b4189b86a9f8b7862d2b8",22851681,1,1,0,878,214,215,1
"f7fb1952f56b4189b86a9f8b7862d2b8","be502a7a43c44bf7b682698de79d9369",22851681,1,-1,0,879,215,214,-1
"67a089198fcb4e1c8f2385786c2b296f","e2911e79efc2420eac45d9f671463d4b",22851736,1,-69,0,1,39,2,-37
"b613861cecf84ffcab01afb23f660475","b613861cecf84ffcab01afb23f660475",22851736,7,0,1,10,1,1,0
"b613861cecf84ffcab01afb23f660475","e2911e79efc2420eac45d9f671463d4b",22851736,3,3,0,13,1,2,1
"e2911e79efc2420eac45d9f671463d4b","b613861cecf84ffcab01afb23f660475",22851736,3,-3,0,14,2,1,-1
"e2911e79efc2420eac45d9f671463d4b","e2911e79efc2420eac45d9f671463d4b",22851736,3,0,1,16,2,2,0
"e2911e79efc2420eac45d9f671463d4b","519d1b8c59404d67b54e96c5c8a830b2",22851736,1,1,0,17,2,3,1
"519d1b8c59404d67b54e96c5c8a830b2","519d1b8c59404d67b54e96c5c8a830b2",22851736,1,0,1,18,3,3,0
"519d1b8c59404d67b54e96c5c8a830b2","531db53f81f646edb0cdcfe0085b03b7",22851736,1,1,0,19,3,4,1
"531db53f81f646edb0cdcfe0085b03b7","531db53f81f646edb0cdcfe0085b03b7",22851736,1,0,1,20,4,4,0
"531db53f81f646edb0cdcfe0085b03b7","4f5f94b2f95141e0a9d53a61da2276da",22851736,1,1,0,21,4,5,1
"4f5f94b2f95141e0a9d53a61da2276da","4f5f94b2f95141e0a9d53a61da2276da",22851736,1,0,1,22,5,5,0
"4f5f94b2f95141e0a9d53a61da2276da","6d541c89590949f99af293c4f2333f67",22851736,1,1,0,23,5,6,1
"6d541c89590949f99af293c4f2333f67","6d541c89590949f99af293c4f2333f67",22851736,1,0,1,24,6,6,0
"6d541c89590949f99af293c4f2333f67","dd5cf0b9fe4c4f1d8f5ff8e4c04879cb",22851736,1,1,0,25,6,7,1
"dd5cf0b9fe4c4f1d8f5ff8e4c04879cb","dd5cf0b9fe4c4f1d8f5ff8e4c04879cb",22851736,1,0,1,26,7,7,0
"dd5cf0b9fe4c4f1d8f5ff8e4c04879cb","e2911e79efc2420eac45d9f671463d4b",22851736,1,-5,0,27,7,2,-5
"e2911e79efc2420eac45d9f671463d4b","dd5cf0b9fe4c4f1d8f5ff8e4c04879cb",22851736,1,5,0,29,2,7,5
"dd5cf0b9fe4c4f1d8f5ff8e4c04879cb","f96261861edc426abe2248be4f0a709a",22851736,1,1,0,30,7,8,1
"f96261861edc426abe2248be4f0a709a","f96261861edc426abe2248be4f0a709a",22851736,1,0,1,31,8,8,0
"f96261861edc426abe2248be4f0a709a","66b5e16f4f75454fb5b8172079f0fa83",22851736,1,1,0,32,8,9,1
"66b5e16f4f75454fb5b8172079f0fa83","66b5e16f4f75454fb5b8172079f0fa83",22851736,1,0,1,33,9,9,0
"66b5e16f4f75454fb5b8172079f0fa83","0680571d4698477995e41842c36a54b2",22851736,1,1,0,34,9,10,1
"0680571d4698477995e41842c36a54b2","0680571d4698477995e41842c36a54b2",22851736,1,0,1,35,10,10,0
"0680571d4698477995e41842c36a54b2","9112f2bffece48e08c6d2287be204085",22851736,1,1,0,36,10,11,1
"9112f2bffece48e08c6d2287be204085","9112f2bffece48e08c6d2287be204085",22851736,1,0,1,37,11,11,0
"9112f2bffece48e08c6d2287be204085","56586aa865414f538729c7f7735d2bc6",22851736,1,3,0,38,11,12,1
"56586aa865414f538729c7f7735d2bc6","e2911e79efc2420eac45d9f671463d4b",22851736,1,-12,0,39,12,2,-10
"e2911e79efc2420eac45d9f671463d4b","56586aa865414f538729c7f7735d2bc6",22851736,1,12,0,40,2,12,10
"56586aa865414f538729c7f7735d2bc6","56586aa865414f538729c7f7735d2bc6",22851736,1,0,1,41,12,12,0
"56586aa865414f538729c7f7735d2bc6","b7f2b31585d94eb3bf86376714aa7070",22851736,1,2,0,42,12,13,1
"b613861cecf84ffcab01afb23f660475","b613861cecf84ffcab01afb23f660475",22851876,4,0,1,1,1,1,0
"b613861cecf84ffcab01afb23f660475","e2911e79efc2420eac45d9f671463d4b",22851876,1,3,0,5,1,2,1
"e2911e79efc2420eac45d9f671463d4b","e2911e79efc2420eac45d9f671463d4b",22851876,2,0,1,6,2,2,0
"e2911e79efc2420eac45d9f671463d4b","519d1b8c59404d67b54e96c5c8a830b2",22851876,1,1,0,8,2,3,1
"519d1b8c59404d67b54e96c5c8a830b2","519d1b8c59404d67b54e96c5c8a830b2",22851876,1,0,1,9,3,3,0
"519d1b8c59404d67b54e96c5c8a830b2","531db53f81f646edb0cdcfe0085b03b7",22851876,1,1,0,10,3,4,1
"531db53f81f646edb0cdcfe0085b03b7","531db53f81f646edb0cdcfe0085b03b7",22851876,1,0,1,11,4,4,0
"531db53f81f646edb0cdcfe0085b03b7","4f5f94b2f95141e0a9d53a61da2276da",22851876,1,1,0,12,4,5,1
"4f5f94b2f95141e0a9d53a61da2276da","4f5f94b2f95141e0a9d53a61da2276da",22851876,1,0,1,13,5,5,0
"4f5f94b2f95141e0a9d53a61da2276da","6d541c89590949f99af293c4f2333f67",22851876,1,1,0,14,5,6,1
"6d541c89590949f99af293c4f2333f67","6d541c89590949f99af293c4f2333f67",22851876,1,0,1,15,6,6,0
"6d541c89590949f99af293c4f2333f67","dd5cf0b9fe4c4f1d8f5ff8e4c04879cb",22851876,1,1,0,16,6,7,1
"dd5cf0b9fe4c4f1d8f5ff8e4c04879cb","dd5cf0b9fe4c4f1d8f5ff8e4c04879cb",22851876,1,0,1,17,7,7,0
"dd5cf0b9fe4c4f1d8f5ff8e4c04879cb","f96261861edc426abe2248be4f0a709a",22851876,1,1,0,18,7,8,1
"f96261861edc426abe2248be4f0a709a","f96261861edc426abe2248be4f0a709a",22851876,1,0,1,19,8,8,0
"f96261861edc426abe2248be4f0a709a","66b5e16f4f75454fb5b8172079f0fa83",22851876,1,1,0,20,8,9,1
"66b5e16f4f75454fb5b8172079f0fa83","66b5e16f4f75454fb5b8172079f0fa83",22851876,2,0,1,21,9,9,0
"66b5e16f4f75454fb5b8172079f0fa83","f96261861edc426abe2248be4f0a709a",22851876,1,-1,0,23,9,8,-1
"f96261861edc426abe2248be4f0a709a","dd5cf0b9fe4c4f1d8f5ff8e4c04879cb",22851876,1,-1,0,24,8,7,-1
"dd5cf0b9fe4c4f1d8f5ff8e4c04879cb","6d541c89590949f99af293c4f2333f67",22851876,1,-1,0,25,7,6,-1
"6d541c89590949f99af293c4f2333f67","0680571d4698477995e41842c36a54b2",22851876,1,4,0,26,6,10,4
"0680571d4698477995e41842c36a54b2","0680571d4698477995e41842c36a54b2",22851876,2,0,1,27,10,10,0
"0680571d4698477995e41842c36a54b2","9112f2bffece48e08c6d2287be204085",22851876,1,1,0,29,10,11,1
"9112f2bffece48e08c6d2287be204085","9112f2bffece48e08c6d2287be204085",22851876,2,0,1,30,11,11,0
"9112f2bffece48e08c6d2287be204085","e2911e79efc2420eac45d9f671463d4b",22851876,1,-9,0,32,11,2,-9
"e2911e79efc2420eac45d9f671463d4b","56586aa865414f538729c7f7735d2bc6",22851876,1,12,0,33,2,12,10
"56586aa865414f538729c7f7735d2bc6","56586aa865414f538729c7f7735d2bc6",22851876,7,0,1,34,12,12,0
"56586aa865414f538729c7f7735d2bc6","b7f2b31585d94eb3bf86376714aa7070",22851876,1,2,0,41,12,13,1
"b7f2b31585d94eb3bf86376714aa7070","b7f2b31585d94eb3bf86376714aa7070",22851876,3,0,1,42,13,13,0
"b7f2b31585d94eb3bf86376714aa7070","3f1c815879794b929260d224becaff7e",22851876,1,2,0,45,13,14,1
"3f1c815879794b929260d224becaff7e","5c5ceeee4562457ba6d41515aeebfbb1",22851876,1,6,0,46,14,17,3
"5c5ceeee4562457ba6d41515aeebfbb1","81c864a886d54a6b8ff85f7d736f4f95",22851876,1,-4,0,47,17,15,-2
"81c864a886d54a6b8ff85f7d736f4f95","5c5ceeee4562457ba6d41515aeebfbb1",22851876,1,4,0,48,15,17,2
"5c5ceeee4562457ba6d41515aeebfbb1","5c5ceeee4562457ba6d41515aeebfbb1",22851876,1,0,1,49,17,17,0
"5c5ceeee4562457ba6d41515aeebfbb1","56586aa865414f538729c7f7735d2bc6",22851876,1,-10,0,50,17,12,-5
"56586aa865414f538729c7f7735d2bc6","9afd71a5298d4333b6849dfce1b9422c",22851876,1,13,0,51,12,18,6
"9afd71a5298d4333b6849dfce1b9422c","9afd71a5298d4333b6849dfce1b9422c",22851876,2,0,1,52,18,18,0
"9afd71a5298d4333b6849dfce1b9422c","b7719e26494940efa49512aedd0aac79",22851876,1,4,0,54,18,20,2
"b7719e26494940efa49512aedd0aac79","d4f45188d3c84a02ba08454e6403a818",22851876,1,5,0,55,20,24,4
"d4f45188d3c84a02ba08454e6403a818","d4c3b003e8274e429d2fa688d73fde6d",22851876,1,-2,0,56,24,22,-2
"d4c3b003e8274e429d2fa688d73fde6d","d4c3b003e8274e429d2fa688d73fde6d",22851876,2,0,1,57,22,22,0
"d4c3b003e8274e429d2fa688d73fde6d","b7719e26494940efa49512aedd0aac79",22851876,1,-3,0,59,22,20,-2
"b7719e26494940efa49512aedd0aac79","afbf7250b99d47bea07172749483ca97",22851876,1,12,0,60,20,28,8
"afbf7250b99d47bea07172749483ca97","b7719e26494940efa49512aedd0aac79",22851876,1,-12,0,61,28,20,-8
"b7719e26494940efa49512aedd0aac79","4e51676dc72045d99c19b9fa7b22f8bc",22851876,1,15,0,62,20,29,9
"4e51676dc72045d99c19b9fa7b22f8bc","afbf7250b99d47bea07172749483ca97",22851876,1,-3,0,63,29,28,-1
"afbf7250b99d47bea07172749483ca97","4e51676dc72045d99c19b9fa7b22f8bc",22851876,1,3,0,64,28,29,1
"4e51676dc72045d99c19b9fa7b22f8bc","51970cfa30e643e894e66ae85c8024cc",22851876,1,3,0,65,29,31,2
"51970cfa30e643e894e66ae85c8024cc","4e51676dc72045d99c19b9fa7b22f8bc",22851876,1,-3,0,66,31,29,-2
"4e51676dc72045d99c19b9fa7b22f8bc","c33c17be71ae4d588da7369472e5bb1b",22851876,1,9,0,67,29,34,5
"c33c17be71ae4d588da7369472e5bb1b","93679be414554a11b1893002f2229a93",22851876,2,3,0,68,34,35,1
"93679be414554a11b1893002f2229a93","c33c17be71ae4d588da7369472e5bb1b",22851876,1,-3,0,69,35,34,-1
"93679be414554a11b1893002f2229a93","7040a13096d746ac84b8fac8d9752058",22851876,1,3,0,71,35,36,1
"7040a13096d746ac84b8fac8d9752058","9a0dc646f934470daf08c4b56ccf73db",22851876,2,3,0,72,36,37,1
"9a0dc646f934470daf08c4b56ccf73db","7040a13096d746ac84b8fac8d9752058",22851876,1,-3,0,73,37,36,-1
"9a0dc646f934470daf08c4b56ccf73db","fc0e049d56024bc9a02c9a9c435c3df7",22851876,1,3,0,75,37,38,1
"fc0e049d56024bc9a02c9a9c435c3df7","56586aa865414f538729c7f7735d2bc6",22851876,1,-53,0,76,38,12,-26
"56586aa865414f538729c7f7735d2bc6","5c5ceeee4562457ba6d41515aeebfbb1",22851876,1,10,0,77,12,17,5
"5c5ceeee4562457ba6d41515aeebfbb1","9afd71a5298d4333b6849dfce1b9422c",22851876,1,3,0,78,17,18,1
"9afd71a5298d4333b6849dfce1b9422c","56586aa865414f538729c7f7735d2bc6",22851876,1,-13,0,79,18,12,-6
"56586aa865414f538729c7f7735d2bc6","fc0e049d56024bc9a02c9a9c435c3df7",22851876,2,53,0,80,12,38,26
"fc0e049d56024bc9a02c9a9c435c3df7","3f1c815879794b929260d224becaff7e",22851876,1,-49,0,81,38,14,-24
"3f1c815879794b929260d224becaff7e","56586aa865414f538729c7f7735d2bc6",22851876,1,-4,0,82,14,12,-2
"fc0e049d56024bc9a02c9a9c435c3df7","fc0e049d56024bc9a02c9a9c435c3df7",22851876,2,0,1,84,38,38,0
"fc0e049d56024bc9a02c9a9c435c3df7","67a089198fcb4e1c8f2385786c2b296f",22851876,1,4,0,86,38,39,1
"67a089198fcb4e1c8f2385786c2b296f","64d48c6c9c7940639a932219a6c87198",22851876,1,1,0,87,39,40,1
"64d48c6c9c7940639a932219a6c87198","64d48c6c9c7940639a932219a6c87198",22851876,1,0,1,88,40,40,0
"64d48c6c9c7940639a932219a6c87198","67a089198fcb4e1c8f2385786c2b296f",22851876,1,-1,0,89,40,39,-1
"67a089198fcb4e1c8f2385786c2b296f","b534b89233134e30a9b5645138bfa9ee",22851876,1,4,0,90,39,41,2
"b534b89233134e30a9b5645138bfa9ee","0e37b720d23b4e7f8b313e79313fd107",22851876,1,3,0,91,41,44,3
"0e37b720d23b4e7f8b313e79313fd107","0e37b720d23b4e7f8b313e79313fd107",22851876,1,0,1,92,44,44,0
"0e37b720d23b4e7f8b313e79313fd107","6875d67fdd5f48168b62719df449bebd",22851876,1,1,0,93,44,45,1
"6875d67fdd5f48168b62719df449bebd","6875d67fdd5f48168b62719df449bebd",22851876,1,0,1,94,45,45,0
"6875d67fdd5f48168b62719df449bebd","b534b89233134e30a9b5645138bfa9ee",22851876,1,-4,0,95,45,41,-4
"b534b89233134e30a9b5645138bfa9ee","6e13d61a7bdb44bca949c9f86fab3be5",22851876,1,7,0,96,41,47,6
"6e13d61a7bdb44bca949c9f86fab3be5","6e13d61a7bdb44bca949c9f86fab3be5",22851876,7,0,1,100,47,47,0
"6e13d61a7bdb44bca949c9f86fab3be5","195f78799f984cc2b06c48dfe36be751",22851876,1,2,0,104,47,49,2
"195f78799f984cc2b06c48dfe36be751","195f78799f984cc2b06c48dfe36be751",22851876,2,0,1,105,49,49,0
"195f78799f984cc2b06c48dfe36be751","d0c74f735e024943943e40333d6d337f",22851876,1,3,0,107,49,51,2
"d0c74f735e024943943e40333d6d337f","d9c8d8c444a64dadbbb508652c721e17",22851876,1,-6,0,108,51,46,-5
"d9c8d8c444a64dadbbb508652c721e17","d0c74f735e024943943e40333d6d337f",22851876,1,6,0,109,46,51,5
"d0c74f735e024943943e40333d6d337f","983f8ff320594b279a7f4a6fe132f9c5",22851876,1,2,0,110,51,53,2
"983f8ff320594b279a7f4a6fe132f9c5","983f8ff320594b279a7f4a6fe132f9c5",22851876,2,0,1,111,53,53,0
"983f8ff320594b279a7f4a6fe132f9c5","35adfa5d923046aebabfefd98f35ff05",22851876,1,1,0,113,53,54,1
"35adfa5d923046aebabfefd98f35ff05","35adfa5d923046aebabfefd98f35ff05",22851876,2,0,1,114,54,54,0
"35adfa5d923046aebabfefd98f35ff05","b6f8a98476224da1b40e555ececc7ed8",22851876,1,1,0,116,54,55,1
"b6f8a98476224da1b40e555ececc7ed8","b6f8a98476224da1b40e555ececc7ed8",22851876,2,0,1,117,55,55,0
"b6f8a98476224da1b40e555ececc7ed8","86e22cb5fe0e4b47a9489ecddf7ed78f",22851876,1,1,0,119,55,56,1
"86e22cb5fe0e4b47a9489ecddf7ed78f","86e22cb5fe0e4b47a9489ecddf7ed78f",22851876,2,0,1,120,56,56,0
"86e22cb5fe0e4b47a9489ecddf7ed78f","f924752d8a1149668870b1e7698486f7",22851876,1,-6,0,122,56,50,-6
"f924752d8a1149668870b1e7698486f7","a1f2f12debe5432fb7a70bcd12bacfb9",22851876,1,9,0,123,50,58,8
"a1f2f12debe5432fb7a70bcd12bacfb9","78f30e4dcac84e3cbea8b2cc6e0d62b3",22851876,2,1,0,124,58,59,1
"78f30e4dcac84e3cbea8b2cc6e0d62b3","a1f2f12debe5432fb7a70bcd12bacfb9",22851876,1,-1,0,125,59,58,-1
"a1f2f12debe5432fb7a70bcd12bacfb9","a1f2f12debe5432fb7a70bcd12bacfb9",22851876,14,0,1,126,58,58,0
"78f30e4dcac84e3cbea8b2cc6e0d62b3","78f30e4dcac84e3cbea8b2cc6e0d62b3",22851876,11,0,1,141,59,59,0
"78f30e4dcac84e3cbea8b2cc6e0d62b3","12aa6e1672ac4e7aa6449a7a8609cd72",22851876,1,-2,0,152,59,57,-2
"12aa6e1672ac4e7aa6449a7a8609cd72","bc42d26810654ea9a1df1efe1e58c7d5",22851876,1,7,0,153,57,63,6
"bc42d26810654ea9a1df1efe1e58c7d5","a0a418b8540d479fa6e0f653b701da8b",22851876,2,1,0,154,63,64,1
"a0a418b8540d479fa6e0f653b701da8b","4c943503763e4e349906eea3ed3c8e86",22851876,1,-3,0,155,64,61,-3
"4c943503763e4e349906eea3ed3c8e86","4c943503763e4e349906eea3ed3c8e86",22851876,1,0,1,156,61,61,0
"4c943503763e4e349906eea3ed3c8e86","bc42d26810654ea9a1df1efe1e58c7d5",22851876,1,2,0,157,61,63,2
"bc42d26810654ea9a1df1efe1e58c7d5","bc42d26810654ea9a1df1efe1e58c7d5",22851876,3,0,1,158,63,63,0
"a0a418b8540d479fa6e0f653b701da8b","a0a418b8540d479fa6e0f653b701da8b",22851876,3,0,1,162,64,64,0
"a0a418b8540d479fa6e0f653b701da8b","309ccf3cc4fe429d9bfbaef53d3fa479",22851876,1,-4,0,165,64,60,-4
"309ccf3cc4fe429d9bfbaef53d3fa479","d646286c8051419bbc2e31dd1db55ca8",22851876,1,10,0,166,60,67,7
"d646286c8051419bbc2e31dd1db55ca8","b534b89233134e30a9b5645138bfa9ee",22851876,1,-33,0,167,67,41,-26
"b534b89233134e30a9b5645138bfa9ee","267f883678b24aed855fde42524975d9",22851876,1,37,0,168,41,71,30
"267f883678b24aed855fde42524975d9","267f883678b24aed855fde42524975d9",22851876,3,0,1,169,71,71,0
"267f883678b24aed855fde42524975d9","88fff56d0342490dbef9040750a20f6c",22851876,1,1,0,172,71,72,1
"88fff56d0342490dbef9040750a20f6c","88fff56d0342490dbef9040750a20f6c",22851876,1,0,1,173,72,72,0
"88fff56d0342490dbef9040750a20f6c","adb17b12b66c4a49a85fd34322f7df70",22851876,1,1,0,174,72,73,1
"adb17b12b66c4a49a85fd34322f7df70","adb17b12b66c4a49a85fd34322f7df70",22851876,1,0,1,175,73,73,0
"adb17b12b66c4a49a85fd34322f7df70","d646286c8051419bbc2e31dd1db55ca8",22851876,1,-6,0,176,73,67,-6
"d646286c8051419bbc2e31dd1db55ca8","a2becd407db34b189200a32546d9d569",22851876,1,9,0,177,67,75,8
"a2becd407db34b189200a32546d9d569","a2becd407db34b189200a32546d9d569",22851876,1,0,1,178,75,75,0
"a2becd407db34b189200a32546d9d569","58c22b011d0f4c2ea6d13615edbb9eeb",22851876,1,2,0,179,75,77,2
"58c22b011d0f4c2ea6d13615edbb9eeb","58c22b011d0f4c2ea6d13615edbb9eeb",22851876,2,0,1,180,77,77,0
"58c22b011d0f4c2ea6d13615edbb9eeb","dd76e1861dc9461c830888729d091ee0",22851876,1,1,0,182,77,78,1
"dd76e1861dc9461c830888729d091ee0","dd76e1861dc9461c830888729d091ee0",22851876,5,0,1,183,78,78,0
"dd76e1861dc9461c830888729d091ee0","cd1d828f1a694b87913a7ea66c23803e",22851876,1,1,0,188,78,79,1
"cd1d828f1a694b87913a7ea66c23803e","cd1d828f1a694b87913a7ea66c23803e",22851876,2,0,1,189,79,79,0
"cd1d828f1a694b87913a7ea66c23803e","9176a3c2b4d2465fa8b0c67096c2a97e",22851876,1,1,0,191,79,80,1
"9176a3c2b4d2465fa8b0c67096c2a97e","9176a3c2b4d2465fa8b0c67096c2a97e",22851876,11,0,1,192,80,80,0
"9176a3c2b4d2465fa8b0c67096c2a97e","f8ec6445f7194e25b9101d4fbcb07a18",22851876,1,1,0,203,80,81,1
"f8ec6445f7194e25b9101d4fbcb07a18","f8ec6445f7194e25b9101d4fbcb07a18",22851876,2,0,1,204,81,81,0
"f8ec6445f7194e25b9101d4fbcb07a18","140d5b27b8574befad82c0a013b59dfa",22851876,1,-7,0,206,81,74,-7
"140d5b27b8574befad82c0a013b59dfa","d18a9ea32855445f8736581f5cb119ce",22851876,1,9,0,207,74,82,8
"d18a9ea32855445f8736581f5cb119ce","ae5ac430ea254e708a6f5deaaf7464ae",22851876,1,3,0,208,82,84,2
"ae5ac430ea254e708a6f5deaaf7464ae","d18a9ea32855445f8736581f5cb119ce",22851876,1,-3,0,209,84,82,-2
"d18a9ea32855445f8736581f5cb119ce","f564483cbd7a407681aa2fcca518cf5f",22851876,1,4,0,210,82,85,3
"f564483cbd7a407681aa2fcca518cf5f","f564483cbd7a407681aa2fcca518cf5f",22851876,1,0,1,211,85,85,0
"f564483cbd7a407681aa2fcca518cf5f","18fd01350bd5434ca636d59a599d768a",22851876,1,1,0,212,85,86,1
"18fd01350bd5434ca636d59a599d768a","18fd01350bd5434ca636d59a599d768a",22851876,8,0,1,213,86,86,0
"18fd01350bd5434ca636d59a599d768a","ae5ac430ea254e708a6f5deaaf7464ae",22851876,1,-2,0,221,86,84,-2
"ae5ac430ea254e708a6f5deaaf7464ae","6a9f0ef185fb47f0937e29daa1c71ed5",22851876,1,7,0,222,84,90,6
"6a9f0ef185fb47f0937e29daa1c71ed5","c681290961c94c4caf23b529d1ae6b9a",22851876,1,-2,0,223,90,88,-2
"c681290961c94c4caf23b529d1ae6b9a","c681290961c94c4caf23b529d1ae6b9a",22851876,1,0,1,224,88,88,0
"c681290961c94c4caf23b529d1ae6b9a","6a9f0ef185fb47f0937e29daa1c71ed5",22851876,1,2,0,225,88,90,2
"6a9f0ef185fb47f0937e29daa1c71ed5","6a9f0ef185fb47f0937e29daa1c71ed5",22851876,3,0,1,226,90,90,0
"6a9f0ef185fb47f0937e29daa1c71ed5","e20db35ced8544ddac5bc3839145e463",22851876,1,3,0,229,90,91,1
"e20db35ced8544ddac5bc3839145e463","d646286c8051419bbc2e31dd1db55ca8",22851876,1,-30,0,230,91,67,-24
"d646286c8051419bbc2e31dd1db55ca8","1febb706d7a34005ae8711ed49c76e64",22851876,1,33,0,231,67,94,27
"1febb706d7a34005ae8711ed49c76e64","1febb706d7a34005ae8711ed49c76e64",22851876,2,0,1,232,94,94,0
"1febb706d7a34005ae8711ed49c76e64","8f73ba6f5a0042f2850356ac38ac6f24",22851876,1,1,0,234,94,95,1
"8f73ba6f5a0042f2850356ac38ac6f24","8f73ba6f5a0042f2850356ac38ac6f24",22851876,5,0,1,235,95,95,0
"8f73ba6f5a0042f2850356ac38ac6f24","e2260b86653c46d7b14a41fb419dbf8c",22851876,1,1,0,240,95,96,1
"e2260b86653c46d7b14a41fb419dbf8c","e2260b86653c46d7b14a41fb419dbf8c",22851876,2,0,1,241,96,96,0
"e2260b86653c46d7b14a41fb419dbf8c","35eb641ad1d845bbba54915bce75a962",22851876,1,1,0,243,96,97,1
"35eb641ad1d845bbba54915bce75a962","35eb641ad1d845bbba54915bce75a962",22851876,2,0,1,244,97,97,0
"35eb641ad1d845bbba54915bce75a962","08be90ffbeea4795a138cd42ed8db56f",22851876,1,1,0,246,97,98,1
"08be90ffbeea4795a138cd42ed8db56f","08be90ffbeea4795a138cd42ed8db56f",22851876,5,0,1,247,98,98,0
"08be90ffbeea4795a138cd42ed8db56f","3007433c8f584dcbb5ac159c1c5f2be3",22851876,1,1,0,252,98,99,1
"3007433c8f584dcbb5ac159c1c5f2be3","3007433c8f584dcbb5ac159c1c5f2be3",22851876,5,0,1,253,99,99,0
"3007433c8f584dcbb5ac159c1c5f2be3","00ae5f0c51874a73a41ebea838d95682",22851876,1,3,0,258,99,101,2
"00ae5f0c51874a73a41ebea838d95682","e20db35ced8544ddac5bc3839145e463",22851876,1,-11,0,259,101,91,-10
"e20db35ced8544ddac5bc3839145e463","d391c8b6e56a43a7b654e9dee02d904b",22851876,1,13,0,260,91,103,12
"d391c8b6e56a43a7b654e9dee02d904b","73039f8c1eb9409cb4caee2cf968001e",22851876,1,-3,0,261,103,100,-3
"73039f8c1eb9409cb4caee2cf968001e","e20db35ced8544ddac5bc3839145e463",22851876,1,-10,0,262,100,91,-9
"e20db35ced8544ddac5bc3839145e463","73039f8c1eb9409cb4caee2cf968001e",22851876,1,10,0,263,91,100,9
"73039f8c1eb9409cb4caee2cf968001e","00ae5f0c51874a73a41ebea838d95682",22851876,1,1,0,264,100,101,1
"00ae5f0c51874a73a41ebea838d95682","d391c8b6e56a43a7b654e9dee02d904b",22851876,2,2,0,265,101,103,2
"d391c8b6e56a43a7b654e9dee02d904b","00ae5f0c51874a73a41ebea838d95682",22851876,1,-2,0,266,103,101,-2
"00ae5f0c51874a73a41ebea838d95682","00ae5f0c51874a73a41ebea838d95682",22851876,2,0,1,267,101,101,0
"d391c8b6e56a43a7b654e9dee02d904b","d391c8b6e56a43a7b654e9dee02d904b",22851876,49,0,1,270,103,103,0
"d391c8b6e56a43a7b654e9dee02d904b","6111116566fc4fd9abba409322bea245",22851876,1,1,0,319,103,104,1
"6111116566fc4fd9abba409322bea245","6111116566fc4fd9abba409322bea245",22851876,2,0,1,320,104,104,0
"6111116566fc4fd9abba409322bea245","a81b2235cb9c499eb9ea8ee0a8dd9725",22851876,1,1,0,322,104,105,1
"a81b2235cb9c499eb9ea8ee0a8dd9725","a81b2235cb9c499eb9ea8ee0a8dd9725",22851876,2,0,1,323,105,105,0
"a81b2235cb9c499eb9ea8ee0a8dd9725","2d4e0ab0ef3b4d73b82c72d4621a7579",22851876,1,1,0,325,105,106,1
"2d4e0ab0ef3b4d73b82c72d4621a7579","2d4e0ab0ef3b4d73b82c72d4621a7579",22851876,2,0,1,326,106,106,0
"2d4e0ab0ef3b4d73b82c72d4621a7579","8bdebf492ebd4e62b0d522e8ab5e5197",22851876,1,1,0,328,106,107,1
"8bdebf492ebd4e62b0d522e8ab5e5197","8bdebf492ebd4e62b0d522e8ab5e5197",22851876,2,0,1,329,107,107,0
"8bdebf492ebd4e62b0d522e8ab5e5197","73039f8c1eb9409cb4caee2cf968001e",22851876,1,-7,0,331,107,100,-7
"73039f8c1eb9409cb4caee2cf968001e","4280927ec4d643238aa49c32f9e06c6c",22851876,1,10,0,332,100,109,9
"4280927ec4d643238aa49c32f9e06c6c","4280927ec4d643238aa49c32f9e06c6c",22851876,2,0,1,333,109,109,0
"4280927ec4d643238aa49c32f9e06c6c","fc44e6a5f7654430af1227838224dceb",22851876,1,2,0,335,109,111,2
"fc44e6a5f7654430af1227838224dceb","fc44e6a5f7654430af1227838224dceb",22851876,5,0,1,336,111,111,0
"fc44e6a5f7654430af1227838224dceb","08111f75e22d409998cf8b85bd431f0a",22851876,1,-3,0,341,111,108,-3
"08111f75e22d409998cf8b85bd431f0a","a9ae0a3c070d455bb4369a8996313336",22851876,1,7,0,342,108,114,6
"a9ae0a3c070d455bb4369a8996313336","a9ae0a3c070d455bb4369a8996313336",22851876,1,0,1,343,114,114,0
"a9ae0a3c070d455bb4369a8996313336","71cec822bcff4f30a20e75dc63ef7b65",22851876,1,2,0,344,114,116,2
"71cec822bcff4f30a20e75dc63ef7b65","71cec822bcff4f30a20e75dc63ef7b65",22851876,3,0,1,345,116,116,0
"71cec822bcff4f30a20e75dc63ef7b65","37319e88176d4aefa91d7a9980dbae91",22851876,1,-4,0,348,116,112,-4
"37319e88176d4aefa91d7a9980dbae91","62bff51286ef4f348717a3cf6fe2318f",22851876,1,9,0,349,112,120,8
"62bff51286ef4f348717a3cf6fe2318f","b1cd0e7dc3ad4a8eb91a4bfdbeb025b0",22851876,1,-2,0,350,120,118,-2
"b1cd0e7dc3ad4a8eb91a4bfdbeb025b0","b1cd0e7dc3ad4a8eb91a4bfdbeb025b0",22851876,1,0,1,351,118,118,0
"b1cd0e7dc3ad4a8eb91a4bfdbeb025b0","62bff51286ef4f348717a3cf6fe2318f",22851876,1,2,0,352,118,120,2
"62bff51286ef4f348717a3cf6fe2318f","62bff51286ef4f348717a3cf6fe2318f",22851876,3,0,1,353,120,120,0
"62bff51286ef4f348717a3cf6fe2318f","e20db35ced8544ddac5bc3839145e463",22851876,1,-33,0,356,120,91,-29
"e20db35ced8544ddac5bc3839145e463","779f9ddd1fd14d1e9e69f72219a1fdbd",22851876,1,36,0,357,91,121,30
"779f9ddd1fd14d1e9e69f72219a1fdbd","ae26e6cda8ad4a3f81bd347560d9579f",22851876,1,4,0,358,121,125,4
"ae26e6cda8ad4a3f81bd347560d9579f","ae26e6cda8ad4a3f81bd347560d9579f",22851876,1,0,1,359,125,125,0
"ae26e6cda8ad4a3f81bd347560d9579f","ee48df95832b4374aa273ceb27ec1315",22851876,1,1,0,360,125,126,1
"ee48df95832b4374aa273ceb27ec1315","ee48df95832b4374aa273ceb27ec1315",22851876,1,0,1,361,126,126,0
"ee48df95832b4374aa273ceb27ec1315","7a439da90b394756ad1777fc4c6dead5",22851876,1,1,0,362,126,127,1
"7a439da90b394756ad1777fc4c6dead5","7a439da90b394756ad1777fc4c6dead5",22851876,3,0,1,363,127,127,0
"7a439da90b394756ad1777fc4c6dead5","a8dd5213034441ac92724b4e83eb0bb2",22851876,1,3,0,366,127,129,2
"a8dd5213034441ac92724b4e83eb0bb2","779f9ddd1fd14d1e9e69f72219a1fdbd",22851876,1,-9,0,367,129,121,-8
"779f9ddd1fd14d1e9e69f72219a1fdbd","a8dd5213034441ac92724b4e83eb0bb2",22851876,1,9,0,368,121,129,8
"a8dd5213034441ac92724b4e83eb0bb2","a8dd5213034441ac92724b4e83eb0bb2",22851876,2,0,1,369,129,129,0
"a8dd5213034441ac92724b4e83eb0bb2","8115eab6556b45f5b415c3b8c26a12e5",22851876,1,2,0,371,129,131,2
"8115eab6556b45f5b415c3b8c26a12e5","8115eab6556b45f5b415c3b8c26a12e5",22851876,2,0,1,372,131,131,0
"8115eab6556b45f5b415c3b8c26a12e5","ec34b06efd844b46a4c4818ecdb9b8f4",22851876,1,1,0,374,131,132,1
"ec34b06efd844b46a4c4818ecdb9b8f4","ec34b06efd844b46a4c4818ecdb9b8f4",22851876,5,0,1,375,132,132,0
"ec34b06efd844b46a4c4818ecdb9b8f4","c2e1c2b9eac64109b343a088584b576b",22851876,1,1,0,380,132,133,1
"c2e1c2b9eac64109b343a088584b576b","c2e1c2b9eac64109b343a088584b576b",22851876,2,0,1,381,133,133,0
"c2e1c2b9eac64109b343a088584b576b","579338175e0b4bbb8ef3b712b5d8b54e",22851876,1,-5,0,383,133,128,-5
"579338175e0b4bbb8ef3b712b5d8b54e","8bc5795d6a984a3eace4e2811e52dd4f",22851876,1,8,0,384,128,135,7
"8bc5795d6a984a3eace4e2811e52dd4f","8bc5795d6a984a3eace4e2811e52dd4f",22851876,1,0,1,385,135,135,0
"8bc5795d6a984a3eace4e2811e52dd4f","b416d47c56a742199b5d7c7f19d6503a",22851876,1,-1,0,386,135,134,-1
"b416d47c56a742199b5d7c7f19d6503a","cd4532ad48034873ba8bce2aac0c9808",22851876,1,4,0,387,134,137,3
"cd4532ad48034873ba8bce2aac0c9808","cd4532ad48034873ba8bce2aac0c9808",22851876,1,0,1,388,137,137,0
"cd4532ad48034873ba8bce2aac0c9808","df1de691dafe4549a18a4398ee9dfaf9",22851876,1,4,0,389,137,139,2
"df1de691dafe4549a18a4398ee9dfaf9","779f9ddd1fd14d1e9e69f72219a1fdbd",22851876,1,-23,0,390,139,121,-18
"779f9ddd1fd14d1e9e69f72219a1fdbd","6c5ad271a44743479bfaea29b1db8d02",22851876,1,27,0,391,121,143,22
"6c5ad271a44743479bfaea29b1db8d02","6c5ad271a44743479bfaea29b1db8d02",22851876,2,0,1,392,143,143,0
"6c5ad271a44743479bfaea29b1db8d02","83d311bed5374fee83d8d67a7d9d82dc",22851876,1,1,0,394,143,144,1
"83d311bed5374fee83d8d67a7d9d82dc","83d311bed5374fee83d8d67a7d9d82dc",22851876,1,0,1,395,144,144,0
"83d311bed5374fee83d8d67a7d9d82dc","402bba41861d43acb52a5abb89e8831e",22851876,1,1,0,396,144,145,1
"402bba41861d43acb52a5abb89e8831e","402bba41861d43acb52a5abb89e8831e",22851876,5,0,1,397,145,145,0
"402bba41861d43acb52a5abb89e8831e","8aae34f5ddbb4052a709b12e6b0d40fa",22851876,1,3,0,402,145,147,2
"8aae34f5ddbb4052a709b12e6b0d40fa","df1de691dafe4549a18a4398ee9dfaf9",22851876,1,-9,0,403,147,139,-8
"df1de691dafe4549a18a4398ee9dfaf9","8aae34f5ddbb4052a709b12e6b0d40fa",22851876,1,9,0,404,139,147,8
"8aae34f5ddbb4052a709b12e6b0d40fa","645b3f0249f64f76af2e19eb4d0e55b7",22851876,1,2,0,405,147,149,2
"645b3f0249f64f76af2e19eb4d0e55b7","645b3f0249f64f76af2e19eb4d0e55b7",22851876,5,0,1,406,149,149,0
"645b3f0249f64f76af2e19eb4d0e55b7","7e7b8db5064d4369805ab370aac5ddfb",22851876,1,1,0,411,149,150,1
"7e7b8db5064d4369805ab370aac5ddfb","7e7b8db5064d4369805ab370aac5ddfb",22851876,5,0,1,412,150,150,0
"7e7b8db5064d4369805ab370aac5ddfb","8956d210ae7f41968fada86d4c979d6a",22851876,1,1,0,417,150,151,1
"8956d210ae7f41968fada86d4c979d6a","8956d210ae7f41968fada86d4c979d6a",22851876,2,0,1,418,151,151,0
"8956d210ae7f41968fada86d4c979d6a","f902b0f41b544d4dbf79664fd233648d",22851876,1,-5,0,420,151,146,-5
"f902b0f41b544d4dbf79664fd233648d","ae781e8b775e4ccd93bc800dad5c8376",22851876,1,8,0,421,146,153,7
"ae781e8b775e4ccd93bc800dad5c8376","ae781e8b775e4ccd93bc800dad5c8376",22851876,2,0,1,422,153,153,0
"ae781e8b775e4ccd93bc800dad5c8376","06882a8492d9499aa31555567f575ecb",22851876,1,1,0,424,153,154,1
"06882a8492d9499aa31555567f575ecb","06882a8492d9499aa31555567f575ecb",22851876,1,0,1,425,154,154,0
"06882a8492d9499aa31555567f575ecb","f293c508f409466a8f27ddd7d1e40b20",22851876,1,1,0,426,154,155,1
"f293c508f409466a8f27ddd7d1e40b20","f293c508f409466a8f27ddd7d1e40b20",22851876,2,0,1,427,155,155,0
"f293c508f409466a8f27ddd7d1e40b20","cc4ddef5bbbe48ebb605141b347c4ed1",22851876,1,1,0,429,155,156,1
"cc4ddef5bbbe48ebb605141b347c4ed1","cc4ddef5bbbe48ebb605141b347c4ed1",22851876,1,0,1,430,156,156,0
"cc4ddef5bbbe48ebb605141b347c4ed1","d313cec988a84645bee413e8d4724a4b",22851876,1,3,0,431,156,158,2
"d313cec988a84645bee413e8d4724a4b","f03480cf4eba413194d7af52fc0e7f28",22851876,1,-7,0,432,158,152,-6
"f03480cf4eba413194d7af52fc0e7f28","d313cec988a84645bee413e8d4724a4b",22851876,1,7,0,433,152,158,6
"d313cec988a84645bee413e8d4724a4b","d313cec988a84645bee413e8d4724a4b",22851876,3,0,1,434,158,158,0
"d313cec988a84645bee413e8d4724a4b","dc60696c76a74368a60f72246e47700d",22851876,1,1,0,437,158,159,1
"dc60696c76a74368a60f72246e47700d","dc60696c76a74368a60f72246e47700d",22851876,1,0,1,438,159,159,0
"dc60696c76a74368a60f72246e47700d","78adeee1fa2c4fe0bc73f7bca9fcee86",22851876,1,3,0,439,159,160,1
"78adeee1fa2c4fe0bc73f7bca9fcee86","df1de691dafe4549a18a4398ee9dfaf9",22851876,1,-26,0,440,160,139,-21
"df1de691dafe4549a18a4398ee9dfaf9","65202579580f4ad38d734b4ee39d22a8",22851876,1,31,0,441,139,164,25
"65202579580f4ad38d734b4ee39d22a8","65202579580f4ad38d734b4ee39d22a8",22851876,6,0,1,442,164,164,0
"65202579580f4ad38d734b4ee39d22a8","78adeee1fa2c4fe0bc73f7bca9fcee86",22851876,2,-5,0,446,164,160,-4
"78adeee1fa2c4fe0bc73f7bca9fcee86","65202579580f4ad38d734b4ee39d22a8",22851876,1,5,0,447,160,164,4
"78adeee1fa2c4fe0bc73f7bca9fcee86","3cbcea2be0984e7dbd5a48195af10ce7",22851876,1,8,0,451,160,165,5
"3cbcea2be0984e7dbd5a48195af10ce7","82e6285962b8400d9d6fc32436022a94",22851876,1,2,0,452,165,167,2
"82e6285962b8400d9d6fc32436022a94","a9ac840f098c4bd0a2ee896214ce29cd",22851876,1,3,0,453,167,168,1
"a9ac840f098c4bd0a2ee896214ce29cd","3cbcea2be0984e7dbd5a48195af10ce7",22851876,1,-5,0,454,168,165,-3
"3cbcea2be0984e7dbd5a48195af10ce7","a9ac840f098c4bd0a2ee896214ce29cd",22851876,1,5,0,455,165,168,3
"a9ac840f098c4bd0a2ee896214ce29cd","0c7262dff33c4087bc660ccf40f92f9c",22851876,1,4,0,456,168,169,1
"0c7262dff33c4087bc660ccf40f92f9c","b2275c3fad834f8d90737a2d9a6927d6",22851876,1,3,0,457,169,172,3
"b2275c3fad834f8d90737a2d9a6927d6","0d987bed3ffa4ed0b9a2e62e97b7b30f",22851876,1,132,0,458,172,272,100
"b613861cecf84ffcab01afb23f660475","b613861cecf84ffcab01afb23f660475",22852834,4,0,1,1,1,1,0
"b613861cecf84ffcab01afb23f660475","e2911e79efc2420eac45d9f671463d4b",22852834,1,3,0,5,1,2,1
"e2911e79efc2420eac45d9f671463d4b","e2911e79efc2420eac45d9f671463d4b",22852834,2,0,1,6,2,2,0
"e2911e79efc2420eac45d9f671463d4b","519d1b8c59404d67b54e96c5c8a830b2",22852834,1,1,0,8,2,3,1
"519d1b8c59404d67b54e96c5c8a830b2","519d1b8c59404d67b54e96c5c8a830b2",22852834,1,0,1,9,3,3,0
"519d1b8c59404d67b54e96c5c8a830b2","531db53f81f646edb0cdcfe0085b03b7",22852834,1,1,0,10,3,4,1
"531db53f81f646edb0cdcfe0085b03b7","531db53f81f646edb0cdcfe0085b03b7",22852834,1,0,1,11,4,4,0
"531db53f81f646edb0cdcfe0085b03b7","4f5f94b2f95141e0a9d53a61da2276da",22852834,1,1,0,12,4,5,1
"4f5f94b2f95141e0a9d53a61da2276da","4f5f94b2f95141e0a9d53a61da2276da",22852834,1,0,1,13,5,5,0
"4f5f94b2f95141e0a9d53a61da2276da","6d541c89590949f99af293c4f2333f67",22852834,1,1,0,14,5,6,1
"6d541c89590949f99af293c4f2333f67","6d541c89590949f99af293c4f2333f67",22852834,1,0,1,15,6,6,0
"6d541c89590949f99af293c4f2333f67","dd5cf0b9fe4c4f1d8f5ff8e4c04879cb",22852834,1,1,0,16,6,7,1
"dd5cf0b9fe4c4f1d8f5ff8e4c04879cb","dd5cf0b9fe4c4f1d8f5ff8e4c04879cb",22852834,1,0,1,17,7,7,0
"dd5cf0b9fe4c4f1d8f5ff8e4c04879cb","f96261861edc426abe2248be4f0a709a",22852834,1,1,0,18,7,8,1
"f96261861edc426abe2248be4f0a709a","f96261861edc426abe2248be4f0a709a",22852834,1,0,1,19,8,8,0
"f96261861edc426abe2248be4f0a709a","66b5e16f4f75454fb5b8172079f0fa83",22852834,1,1,0,20,8,9,1
"66b5e16f4f75454fb5b8172079f0fa83","66b5e16f4f75454fb5b8172079f0fa83",22852834,1,0,1,21,9,9,0
"66b5e16f4f75454fb5b8172079f0fa83","0680571d4698477995e41842c36a54b2",22852834,1,1,0,22,9,10,1
"0680571d4698477995e41842c36a54b2","0680571d4698477995e41842c36a54b2",22852834,1,0,1,23,10,10,0
"0680571d4698477995e41842c36a54b2","9112f2bffece48e08c6d2287be204085",22852834,1,1,0,24,10,11,1
"9112f2bffece48e08c6d2287be204085","9112f2bffece48e08c6d2287be204085",22852834,1,0,1,25,11,11,0
"9112f2bffece48e08c6d2287be204085","e2911e79efc2420eac45d9f671463d4b",22852834,1,-9,0,26,11,2,-9
"e2911e79efc2420eac45d9f671463d4b","56586aa865414f538729c7f7735d2bc6",22852834,1,12,0,27,2,12,10
"56586aa865414f538729c7f7735d2bc6","56586aa865414f538729c7f7735d2bc6",22852834,2,0,1,28,12,12,0
"56586aa865414f538729c7f7735d2bc6","b7f2b31585d94eb3bf86376714aa7070",22852834,5,2,0,30,12,13,1
"b7f2b31585d94eb3bf86376714aa7070","56586aa865414f538729c7f7735d2bc6",22852834,3,-2,0,31,13,12,-1
"b7f2b31585d94eb3bf86376714aa7070","b7f2b31585d94eb3bf86376714aa7070",22852834,9,0,1,33,13,13,0
"b7f2b31585d94eb3bf86376714aa7070","3f1c815879794b929260d224becaff7e",22852834,2,2,0,45,13,14,1
"3f1c815879794b929260d224becaff7e","56586aa865414f538729c7f7735d2bc6",22852834,1,-4,0,46,14,12,-2
"3f1c815879794b929260d224becaff7e","81c864a886d54a6b8ff85f7d736f4f95",22852834,1,2,0,50,14,15,1
"81c864a886d54a6b8ff85f7d736f4f95","5c5ceeee4562457ba6d41515aeebfbb1",22852834,1,4,0,51,15,17,2
"5c5ceeee4562457ba6d41515aeebfbb1","5c5ceeee4562457ba6d41515aeebfbb1",22852834,1,0,1,52,17,17,0
"5c5ceeee4562457ba6d41515aeebfbb1","9afd71a5298d4333b6849dfce1b9422c",22852834,1,3,0,53,17,18,1
"9afd71a5298d4333b6849dfce1b9422c","56586aa865414f538729c7f7735d2bc6",22852834,1,-13,0,54,18,12,-6
"56586aa865414f538729c7f7735d2bc6","9afd71a5298d4333b6849dfce1b9422c",22852834,1,13,0,55,12,18,6
"9afd71a5298d4333b6849dfce1b9422c","9afd71a5298d4333b6849dfce1b9422c",22852834,1,0,1,56,18,18,0
"9afd71a5298d4333b6849dfce1b9422c","b7719e26494940efa49512aedd0aac79",22852834,1,4,0,57,18,20,2
"b7719e26494940efa49512aedd0aac79","d4f45188d3c84a02ba08454e6403a818",22852834,1,5,0,58,20,24,4
"d4f45188d3c84a02ba08454e6403a818","d4c3b003e8274e429d2fa688d73fde6d",22852834,1,-2,0,59,24,22,-2
"d4c3b003e8274e429d2fa688d73fde6d","d4c3b003e8274e429d2fa688d73fde6d",22852834,1,0,1,60,22,22,0
"d4c3b003e8274e429d2fa688d73fde6d","5bc03c8f16354d04bd51f5bb93559ad3",22852834,1,4,0,61,22,26,4
"5bc03c8f16354d04bd51f5bb93559ad3","b7719e26494940efa49512aedd0aac79",22852834,1,-7,0,62,26,20,-6
"b7719e26494940efa49512aedd0aac79","b7719e26494940efa49512aedd0aac79",22852834,1,0,1,63,20,20,0
"b7719e26494940efa49512aedd0aac79","afbf7250b99d47bea07172749483ca97",22852834,1,12,0,64,20,28,8
"afbf7250b99d47bea07172749483ca97","afbf7250b99d47bea07172749483ca97",22852834,1,0,1,65,28,28,0
"afbf7250b99d47bea07172749483ca97","4e51676dc72045d99c19b9fa7b22f8bc",22852834,1,3,0,66,28,29,1
"4e51676dc72045d99c19b9fa7b22f8bc","4e51676dc72045d99c19b9fa7b22f8bc",22852834,1,0,1,67,29,29,0
"4e51676dc72045d99c19b9fa7b22f8bc","51970cfa30e643e894e66ae85c8024cc",22852834,1,3,0,68,29,31,2
"51970cfa30e643e894e66ae85c8024cc","c33c17be71ae4d588da7369472e5bb1b",22852834,1,6,0,69,31,34,3
"c33c17be71ae4d588da7369472e5bb1b","4e51676dc72045d99c19b9fa7b22f8bc",22852834,1,-9,0,70,34,29,-5
"4e51676dc72045d99c19b9fa7b22f8bc","93679be414554a11b1893002f2229a93",22852834,1,12,0,71,29,35,6
"93679be414554a11b1893002f2229a93","c33c17be71ae4d588da7369472e5bb1b",22852834,1,-3,0,72,35,34,-1
"c33c17be71ae4d588da7369472e5bb1b","7040a13096d746ac84b8fac8d9752058",22852834,1,6,0,73,34,36,2
"7040a13096d746ac84b8fac8d9752058","93679be414554a11b1893002f2229a93",22852834,1,-3,0,74,36,35,-1
"93679be414554a11b1893002f2229a93","7040a13096d746ac84b8fac8d9752058",22852834,1,3,0,75,35,36,1
"7040a13096d746ac84b8fac8d9752058","9a0dc646f934470daf08c4b56ccf73db",22852834,1,3,0,76,36,37,1
"9a0dc646f934470daf08c4b56ccf73db","9a0dc646f934470daf08c4b56ccf73db",22852834,1,0,1,77,37,37,0
"9a0dc646f934470daf08c4b56ccf73db","fc0e049d56024bc9a02c9a9c435c3df7",22852834,1,3,0,78,37,38,1
"fc0e049d56024bc9a02c9a9c435c3df7","fc0e049d56024bc9a02c9a9c435c3df7",22852834,1,0,1,79,38,38,0
"fc0e049d56024bc9a02c9a9c435c3df7","67a089198fcb4e1c8f2385786c2b296f",22852834,1,4,0,80,38,39,1
"67a089198fcb4e1c8f2385786c2b296f","64d48c6c9c7940639a932219a6c87198",22852834,1,1,0,81,39,40,1
"64d48c6c9c7940639a932219a6c87198","64d48c6c9c7940639a932219a6c87198",22852834,1,0,1,82,40,40,0
"64d48c6c9c7940639a932219a6c87198","b534b89233134e30a9b5645138bfa9ee",22852834,1,3,0,83,40,41,1
"b534b89233134e30a9b5645138bfa9ee","67a089198fcb4e1c8f2385786c2b296f",22852834,1,-4,0,84,41,39,-2
"67a089198fcb4e1c8f2385786c2b296f","0e37b720d23b4e7f8b313e79313fd107",22852834,1,7,0,85,39,44,5
"0e37b720d23b4e7f8b313e79313fd107","0e37b720d23b4e7f8b313e79313fd107",22852834,1,0,1,86,44,44,0
"0e37b720d23b4e7f8b313e79313fd107","6875d67fdd5f48168b62719df449bebd",22852834,1,1,0,87,44,45,1
"6875d67fdd5f48168b62719df449bebd","6875d67fdd5f48168b62719df449bebd",22852834,1,0,1,88,45,45,0
"6875d67fdd5f48168b62719df449bebd","6e13d61a7bdb44bca949c9f86fab3be5",22852834,1,3,0,89,45,47,2
"6e13d61a7bdb44bca949c9f86fab3be5","b534b89233134e30a9b5645138bfa9ee",22852834,1,-7,0,90,47,41,-6
"b534b89233134e30a9b5645138bfa9ee","6e13d61a7bdb44bca949c9f86fab3be5",22852834,1,7,0,91,41,47,6
"6e13d61a7bdb44bca949c9f86fab3be5","195f78799f984cc2b06c48dfe36be751",22852834,1,2,0,92,47,49,2
"195f78799f984cc2b06c48dfe36be751","195f78799f984cc2b06c48dfe36be751",22852834,2,0,1,93,49,49,0
"195f78799f984cc2b06c48dfe36be751","d9c8d8c444a64dadbbb508652c721e17",22852834,1,-3,0,95,49,46,-3
"d9c8d8c444a64dadbbb508652c721e17","d0c74f735e024943943e40333d6d337f",22852834,1,6,0,96,46,51,5
"d0c74f735e024943943e40333d6d337f","b534b89233134e30a9b5645138bfa9ee",22852834,1,-12,0,97,51,41,-10
"b534b89233134e30a9b5645138bfa9ee","d0c74f735e024943943e40333d6d337f",22852834,1,12,0,98,41,51,10
"d0c74f735e024943943e40333d6d337f","d0c74f735e024943943e40333d6d337f",22852834,1,0,1,99,51,51,0
"d0c74f735e024943943e40333d6d337f","983f8ff320594b279a7f4a6fe132f9c5",22852834,1,2,0,100,51,53,2
"983f8ff320594b279a7f4a6fe132f9c5","983f8ff320594b279a7f4a6fe132f9c5",22852834,8,0,1,101,53,53,0
"983f8ff320594b279a7f4a6fe132f9c5","35adfa5d923046aebabfefd98f35ff05",22852834,1,1,0,109,53,54,1
"35adfa5d923046aebabfefd98f35ff05","35adfa5d923046aebabfefd98f35ff05",22852834,8,0,1,110,54,54,0
"35adfa5d923046aebabfefd98f35ff05","b6f8a98476224da1b40e555ececc7ed8",22852834,1,1,0,118,54,55,1
"b6f8a98476224da1b40e555ececc7ed8","b6f8a98476224da1b40e555ececc7ed8",22852834,2,0,1,119,55,55,0
"b6f8a98476224da1b40e555ececc7ed8","86e22cb5fe0e4b47a9489ecddf7ed78f",22852834,1,1,0,121,55,56,1
"86e22cb5fe0e4b47a9489ecddf7ed78f","86e22cb5fe0e4b47a9489ecddf7ed78f",22852834,2,0,1,122,56,56,0
"86e22cb5fe0e4b47a9489ecddf7ed78f","f924752d8a1149668870b1e7698486f7",22852834,1,-6,0,124,56,50,-6
"f924752d8a1149668870b1e7698486f7","78f30e4dcac84e3cbea8b2cc6e0d62b3",22852834,1,10,0,125,50,59,9
"78f30e4dcac84e3cbea8b2cc6e0d62b3","a1f2f12debe5432fb7a70bcd12bacfb9",22852834,1,-1,0,126,59,58,-1
"a1f2f12debe5432fb7a70bcd12bacfb9","a1f2f12debe5432fb7a70bcd12bacfb9",22852834,10,0,1,127,58,58,0
"a1f2f12debe5432fb7a70bcd12bacfb9","78f30e4dcac84e3cbea8b2cc6e0d62b3",22852834,1,1,0,137,58,59,1
"78f30e4dcac84e3cbea8b2cc6e0d62b3","78f30e4dcac84e3cbea8b2cc6e0d62b3",22852834,7,0,1,138,59,59,0
"78f30e4dcac84e3cbea8b2cc6e0d62b3","bc42d26810654ea9a1df1efe1e58c7d5",22852834,1,5,0,145,59,63,4
"bc42d26810654ea9a1df1efe1e58c7d5","12aa6e1672ac4e7aa6449a7a8609cd72",22852834,1,-7,0,146,63,57,-6
"12aa6e1672ac4e7aa6449a7a8609cd72","a0a418b8540d479fa6e0f653b701da8b",22852834,1,8,0,147,57,64,7
"a0a418b8540d479fa6e0f653b701da8b","4c943503763e4e349906eea3ed3c8e86",22852834,1,-3,0,148,64,61,-3
"4c943503763e4e349906eea3ed3c8e86","4c943503763e4e349906eea3ed3c8e86",22852834,1,0,1,149,61,61,0
"4c943503763e4e349906eea3ed3c8e86","bc42d26810654ea9a1df1efe1e58c7d5",22852834,1,2,0,150,61,63,2
"bc42d26810654ea9a1df1efe1e58c7d5","bc42d26810654ea9a1df1efe1e58c7d5",22852834,3,0,1,151,63,63,0
"bc42d26810654ea9a1df1efe1e58c7d5","309ccf3cc4fe429d9bfbaef53d3fa479",22852834,1,-3,0,154,63,60,-3
"309ccf3cc4fe429d9bfbaef53d3fa479","b534b89233134e30a9b5645138bfa9ee",22852834,1,-23,0,155,60,41,-19
"b534b89233134e30a9b5645138bfa9ee","d646286c8051419bbc2e31dd1db55ca8",22852834,1,33,0,156,41,67,26
"b613861cecf84ffcab01afb23f660475","b613861cecf84ffcab01afb23f660475",22853622,7,0,1,1,1,1,0
"e2911e79efc2420eac45d9f671463d4b","e2911e79efc2420eac45d9f671463d4b",22853622,12,0,1,10,2,2,0
"e2911e79efc2420eac45d9f671463d4b","519d1b8c59404d67b54e96c5c8a830b2",22853622,1,1,0,11,2,3,1
"519d1b8c59404d67b54e96c5c8a830b2","519d1b8c59404d67b54e96c5c8a830b2",22853622,2,0,1,12,3,3,0
"519d1b8c59404d67b54e96c5c8a830b2","531db53f81f646edb0cdcfe0085b03b7",22853622,1,1,0,14,3,4,1
"531db53f81f646edb0cdcfe0085b03b7","531db53f81f646edb0cdcfe0085b03b7",22853622,1,0,1,15,4,4,0
"531db53f81f646edb0cdcfe0085b03b7","4f5f94b2f95141e0a9d53a61da2276da",22853622,1,1,0,16,4,5,1
"4f5f94b2f95141e0a9d53a61da2276da","4f5f94b2f95141e0a9d53a61da2276da",22853622,7,0,1,17,5,5,0
"4f5f94b2f95141e0a9d53a61da2276da","6d541c89590949f99af293c4f2333f67",22853622,1,1,0,18,5,6,1
"6d541c89590949f99af293c4f2333f67","6d541c89590949f99af293c4f2333f67",22853622,1,0,1,19,6,6,0
"6d541c89590949f99af293c4f2333f67","b613861cecf84ffcab01afb23f660475",22853622,1,-7,0,20,6,1,-5
"b613861cecf84ffcab01afb23f660475","e2911e79efc2420eac45d9f671463d4b",22853622,3,3,0,23,1,2,1
"e2911e79efc2420eac45d9f671463d4b","4f5f94b2f95141e0a9d53a61da2276da",22853622,1,3,0,25,2,5,3
"4f5f94b2f95141e0a9d53a61da2276da","e2911e79efc2420eac45d9f671463d4b",22853622,1,-3,0,32,5,2,-3
"e2911e79efc2420eac45d9f671463d4b","dd5cf0b9fe4c4f1d8f5ff8e4c04879cb",22853622,1,5,0,34,2,7,5
"dd5cf0b9fe4c4f1d8f5ff8e4c04879cb","dd5cf0b9fe4c4f1d8f5ff8e4c04879cb",22853622,1,0,1,35,7,7,0
"dd5cf0b9fe4c4f1d8f5ff8e4c04879cb","9112f2bffece48e08c6d2287be204085",22853622,1,4,0,36,7,11,4
"9112f2bffece48e08c6d2287be204085","9112f2bffece48e08c6d2287be204085",22853622,1,0,1,37,11,11,0
"9112f2bffece48e08c6d2287be204085","b613861cecf84ffcab01afb23f660475",22853622,1,-12,0,38,11,1,-10
"e2911e79efc2420eac45d9f671463d4b","56586aa865414f538729c7f7735d2bc6",22853622,2,12,0,43,2,12,10
"56586aa865414f538729c7f7735d2bc6","e2911e79efc2420eac45d9f671463d4b",22853622,1,-12,0,44,12,2,-10
"e2911e79efc2420eac45d9f671463d4b","f96261861edc426abe2248be4f0a709a",22853622,1,6,0,48,2,8,6
"f96261861edc426abe2248be4f0a709a","f96261861edc426abe2248be4f0a709a",22853622,1,0,1,49,8,8,0
"f96261861edc426abe2248be4f0a709a","66b5e16f4f75454fb5b8172079f0fa83",22853622,1,1,0,50,8,9,1
"66b5e16f4f75454fb5b8172079f0fa83","66b5e16f4f75454fb5b8172079f0fa83",22853622,1,0,1,51,9,9,0
"66b5e16f4f75454fb5b8172079f0fa83","0680571d4698477995e41842c36a54b2",22853622,1,1,0,52,9,10,1
"0680571d4698477995e41842c36a54b2","0680571d4698477995e41842c36a54b2",22853622,1,0,1,53,10,10,0
"0680571d4698477995e41842c36a54b2","e2911e79efc2420eac45d9f671463d4b",22853622,1,-8,0,54,10,2,-8
"56586aa865414f538729c7f7735d2bc6","56586aa865414f538729c7f7735d2bc6",22853622,3,0,1,56,12,12,0
"56586aa865414f538729c7f7735d2bc6","b7f2b31585d94eb3bf86376714aa7070",22853622,1,2,0,59,12,13,1
"b7f2b31585d94eb3bf86376714aa7070","b7f2b31585d94eb3bf86376714aa7070",22853622,4,0,1,60,13,13,0
"b7f2b31585d94eb3bf86376714aa7070","3f1c815879794b929260d224becaff7e",22853622,1,2,0,64,13,14,1
"3f1c815879794b929260d224becaff7e","afbf7250b99d47bea07172749483ca97",22853622,1,25,0,65,14,28,14
"afbf7250b99d47bea07172749483ca97","afbf7250b99d47bea07172749483ca97",22853622,1,0,1,66,28,28,0
"afbf7250b99d47bea07172749483ca97","7040a13096d746ac84b8fac8d9752058",22853622,1,18,0,67,28,36,8
"7040a13096d746ac84b8fac8d9752058","7040a13096d746ac84b8fac8d9752058",22853622,1,0,1,68,36,36,0
"7040a13096d746ac84b8fac8d9752058","c33c17be71ae4d588da7369472e5bb1b",22853622,1,-6,0,69,36,34,-2
"c33c17be71ae4d588da7369472e5bb1b","c33c17be71ae4d588da7369472e5bb1b",22853622,1,0,1,70,34,34,0
"b613861cecf84ffcab01afb23f660475","b613861cecf84ffcab01afb23f660475",22853821,3,0,1,1,1,1,0
"b613861cecf84ffcab01afb23f660475","e2911e79efc2420eac45d9f671463d4b",22853821,2,3,0,4,1,2,1
"e2911e79efc2420eac45d9f671463d4b","b613861cecf84ffcab01afb23f660475",22853821,1,-3,0,5,2,1,-1
"e2911e79efc2420eac45d9f671463d4b","e2911e79efc2420eac45d9f671463d4b",22853821,1,0,1,7,2,2,0
"e2911e79efc2420eac45d9f671463d4b","519d1b8c59404d67b54e96c5c8a830b2",22853821,1,1,0,8,2,3,1
"519d1b8c59404d67b54e96c5c8a830b2","519d1b8c59404d67b54e96c5c8a830b2",22853821,1,0,1,9,3,3,0
"519d1b8c59404d67b54e96c5c8a830b2","531db53f81f646edb0cdcfe0085b03b7",22853821,1,1,0,10,3,4,1
"531db53f81f646edb0cdcfe0085b03b7","531db53f81f646edb0cdcfe0085b03b7",22853821,2,0,1,11,4,4,0
"531db53f81f646edb0cdcfe0085b03b7","519d1b8c59404d67b54e96c5c8a830b2",22853821,1,-1,0,13,4,3,-1
"519d1b8c59404d67b54e96c5c8a830b2","e2911e79efc2420eac45d9f671463d4b",22853821,1,-1,0,14,3,2,-1
"e2911e79efc2420eac45d9f671463d4b","4f5f94b2f95141e0a9d53a61da2276da",22853821,1,3,0,15,2,5,3
"4f5f94b2f95141e0a9d53a61da2276da","4f5f94b2f95141e0a9d53a61da2276da",22853821,2,0,1,16,5,5,0
"4f5f94b2f95141e0a9d53a61da2276da","6d541c89590949f99af293c4f2333f67",22853821,1,1,0,18,5,6,1
"6d541c89590949f99af293c4f2333f67","6d541c89590949f99af293c4f2333f67",22853821,2,0,1,19,6,6,0
"6d541c89590949f99af293c4f2333f67","dd5cf0b9fe4c4f1d8f5ff8e4c04879cb",22853821,1,1,0,21,6,7,1
"dd5cf0b9fe4c4f1d8f5ff8e4c04879cb","dd5cf0b9fe4c4f1d8f5ff8e4c04879cb",22853821,2,0,1,22,7,7,0
"dd5cf0b9fe4c4f1d8f5ff8e4c04879cb","f96261861edc426abe2248be4f0a709a",22853821,1,1,0,24,7,8,1
"f96261861edc426abe2248be4f0a709a","f96261861edc426abe2248be4f0a709a",22853821,2,0,1,25,8,8,0
"f96261861edc426abe2248be4f0a709a","9112f2bffece48e08c6d2287be204085",22853821,1,3,0,27,8,11,3
"9112f2bffece48e08c6d2287be204085","9112f2bffece48e08c6d2287be204085",22853821,2,0,1,28,11,11,0
"9112f2bffece48e08c6d2287be204085","0680571d4698477995e41842c36a54b2",22853821,1,-1,0,30,11,10,-1
"0680571d4698477995e41842c36a54b2","0680571d4698477995e41842c36a54b2",22853821,2,0,1,31,10,10,0
"0680571d4698477995e41842c36a54b2","66b5e16f4f75454fb5b8172079f0fa83",22853821,1,-1,0,33,10,9,-1
"66b5e16f4f75454fb5b8172079f0fa83","66b5e16f4f75454fb5b8172079f0fa83",22853821,1,0,1,34,9,9,0
"66b5e16f4f75454fb5b8172079f0fa83","56586aa865414f538729c7f7735d2bc6",22853821,1,5,0,35,9,12,3
"56586aa865414f538729c7f7735d2bc6","e2911e79efc2420eac45d9f671463d4b",22853821,2,-12,0,36,12,2,-10
"e2911e79efc2420eac45d9f671463d4b","56586aa865414f538729c7f7735d2bc6",22853821,2,12,0,37,2,12,10
"e2911e79efc2420eac45d9f671463d4b","9112f2bffece48e08c6d2287be204085",22853821,1,9,0,39,2,11,9
"9112f2bffece48e08c6d2287be204085","e2911e79efc2420eac45d9f671463d4b",22853821,1,-9,0,40,11,2,-9
"56586aa865414f538729c7f7735d2bc6","56586aa865414f538729c7f7735d2bc6",22853821,2,0,1,42,12,12,0
"56586aa865414f538729c7f7735d2bc6","b7f2b31585d94eb3bf86376714aa7070",22853821,2,2,0,44,12,13,1
"b7f2b31585d94eb3bf86376714aa7070","56586aa865414f538729c7f7735d2bc6",22853821,1,-2,0,45,13,12,-1
"b7f2b31585d94eb3bf86376714aa7070","b7f2b31585d94eb3bf86376714aa7070",22853821,3,0,1,47,13,13,0
"b7f2b31585d94eb3bf86376714aa7070","3f1c815879794b929260d224becaff7e",22853821,1,2,0,50,13,14,1
"3f1c815879794b929260d224becaff7e","56586aa865414f538729c7f7735d2bc6",22853821,1,-4,0,51,14,12,-2
"56586aa865414f538729c7f7735d2bc6","3f1c815879794b929260d224becaff7e",22853821,2,4,0,52,12,14,2
"3f1c815879794b929260d224becaff7e","81c864a886d54a6b8ff85f7d736f4f95",22853821,2,2,0,53,14,15,1
"81c864a886d54a6b8ff85f7d736f4f95","5c5ceeee4562457ba6d41515aeebfbb1",22853821,2,4,0,54,15,17,2
"5c5ceeee4562457ba6d41515aeebfbb1","5c5ceeee4562457ba6d41515aeebfbb1",22853821,2,0,1,55,17,17,0
"5c5ceeee4562457ba6d41515aeebfbb1","56586aa865414f538729c7f7735d2bc6",22853821,2,-10,0,57,17,12,-5
"56586aa865414f538729c7f7735d2bc6","9afd71a5298d4333b6849dfce1b9422c",22853821,2,13,0,58,12,18,6
"9afd71a5298d4333b6849dfce1b9422c","56586aa865414f538729c7f7735d2bc6",22853821,1,-13,0,59,18,12,-6
"9afd71a5298d4333b6849dfce1b9422c","9afd71a5298d4333b6849dfce1b9422c",22853821,1,0,1,65,18,18,0
"9afd71a5298d4333b6849dfce1b9422c","b7719e26494940efa49512aedd0aac79",22853821,1,4,0,66,18,20,2
"b7719e26494940efa49512aedd0aac79","d4f45188d3c84a02ba08454e6403a818",22853821,2,5,0,67,20,24,4
"d4f45188d3c84a02ba08454e6403a818","d4c3b003e8274e429d2fa688d73fde6d",22853821,2,-2,0,68,24,22,-2
"d4c3b003e8274e429d2fa688d73fde6d","d4c3b003e8274e429d2fa688d73fde6d",22853821,2,0,1,69,22,22,0
"d4c3b003e8274e429d2fa688d73fde6d","fab84b4fab5940efb4ea868ef8d09396",22853821,1,359,0,70,22,284,262
"fab84b4fab5940efb4ea868ef8d09396","0c7262dff33c4087bc660ccf40f92f9c",22853821,1,-153,0,71,284,169,-115
"0c7262dff33c4087bc660ccf40f92f9c","a23ae40d7a9e4ee4828cc06415a3218c",22853821,1,-200,0,72,169,27,-142
"a23ae40d7a9e4ee4828cc06415a3218c","b7719e26494940efa49512aedd0aac79",22853821,1,-9,0,73,27,20,-7
"d4c3b003e8274e429d2fa688d73fde6d","b7719e26494940efa49512aedd0aac79",22853821,1,-3,0,77,22,20,-2
"b7719e26494940efa49512aedd0aac79","b7719e26494940efa49512aedd0aac79",22853821,2,0,1,78,20,20,0
"b7719e26494940efa49512aedd0aac79","afbf7250b99d47bea07172749483ca97",22853821,3,12,0,79,20,28,8
"afbf7250b99d47bea07172749483ca97","afbf7250b99d47bea07172749483ca97",22853821,1,0,1,80,28,28,0
"afbf7250b99d47bea07172749483ca97","4e51676dc72045d99c19b9fa7b22f8bc",22853821,1,3,0,81,28,29,1
"4e51676dc72045d99c19b9fa7b22f8bc","4e51676dc72045d99c19b9fa7b22f8bc",22853821,1,0,1,82,29,29,0
"4e51676dc72045d99c19b9fa7b22f8bc","51970cfa30e643e894e66ae85c8024cc",22853821,1,3,0,83,29,31,2
"51970cfa30e643e894e66ae85c8024cc","4e51676dc72045d99c19b9fa7b22f8bc",22853821,1,-3,0,84,31,29,-2
"4e51676dc72045d99c19b9fa7b22f8bc","c33c17be71ae4d588da7369472e5bb1b",22853821,1,9,0,85,29,34,5
"c33c17be71ae4d588da7369472e5bb1b","93679be414554a11b1893002f2229a93",22853821,1,3,0,86,34,35,1
"93679be414554a11b1893002f2229a93","c33c17be71ae4d588da7369472e5bb1b",22853821,1,-3,0,87,35,34,-1
"c33c17be71ae4d588da7369472e5bb1b","7040a13096d746ac84b8fac8d9752058",22853821,1,6,0,88,34,36,2
"7040a13096d746ac84b8fac8d9752058","93679be414554a11b1893002f2229a93",22853821,1,-3,0,89,36,35,-1
"93679be414554a11b1893002f2229a93","9a0dc646f934470daf08c4b56ccf73db",22853821,1,6,0,90,35,37,2
"9a0dc646f934470daf08c4b56ccf73db","7040a13096d746ac84b8fac8d9752058",22853821,1,-3,0,91,37,36,-1
"7040a13096d746ac84b8fac8d9752058","9a0dc646f934470daf08c4b56ccf73db",22853821,1,3,0,92,36,37,1
"9a0dc646f934470daf08c4b56ccf73db","fc0e049d56024bc9a02c9a9c435c3df7",22853821,1,3,0,93,37,38,1
"fc0e049d56024bc9a02c9a9c435c3df7","fc0e049d56024bc9a02c9a9c435c3df7",22853821,1,0,1,94,38,38,0
"fc0e049d56024bc9a02c9a9c435c3df7","67a089198fcb4e1c8f2385786c2b296f",22853821,1,4,0,95,38,39,1
"67a089198fcb4e1c8f2385786c2b296f","64d48c6c9c7940639a932219a6c87198",22853821,1,1,0,96,39,40,1
"64d48c6c9c7940639a932219a6c87198","64d48c6c9c7940639a932219a6c87198",22853821,1,0,1,97,40,40,0
"64d48c6c9c7940639a932219a6c87198","67a089198fcb4e1c8f2385786c2b296f",22853821,1,-1,0,98,40,39,-1
"67a089198fcb4e1c8f2385786c2b296f","b534b89233134e30a9b5645138bfa9ee",22853821,1,4,0,99,39,41,2
"b534b89233134e30a9b5645138bfa9ee","0e37b720d23b4e7f8b313e79313fd107",22853821,1,3,0,100,41,44,3
"0e37b720d23b4e7f8b313e79313fd107","0e37b720d23b4e7f8b313e79313fd107",22853821,1,0,1,101,44,44,0
"0e37b720d23b4e7f8b313e79313fd107","6875d67fdd5f48168b62719df449bebd",22853821,1,1,0,102,44,45,1
"6875d67fdd5f48168b62719df449bebd","6875d67fdd5f48168b62719df449bebd",22853821,1,0,1,103,45,45,0
"6875d67fdd5f48168b62719df449bebd","b534b89233134e30a9b5645138bfa9ee",22853821,1,-4,0,104,45,41,-4
"b534b89233134e30a9b5645138bfa9ee","6e13d61a7bdb44bca949c9f86fab3be5",22853821,4,7,0,105,41,47,6
"6e13d61a7bdb44bca949c9f86fab3be5","195f78799f984cc2b06c48dfe36be751",22853821,1,2,0,106,47,49,2
"195f78799f984cc2b06c48dfe36be751","195f78799f984cc2b06c48dfe36be751",22853821,2,0,1,107,49,49,0
"195f78799f984cc2b06c48dfe36be751","d0c74f735e024943943e40333d6d337f",22853821,1,3,0,109,49,51,2
"d0c74f735e024943943e40333d6d337f","d9c8d8c444a64dadbbb508652c721e17",22853821,3,-6,0,110,51,46,-5
"d9c8d8c444a64dadbbb508652c721e17","983f8ff320594b279a7f4a6fe132f9c5",22853821,1,8,0,111,46,53,7
"983f8ff320594b279a7f4a6fe132f9c5","983f8ff320594b279a7f4a6fe132f9c5",22853821,2,0,1,112,53,53,0
"983f8ff320594b279a7f4a6fe132f9c5","35adfa5d923046aebabfefd98f35ff05",22853821,1,1,0,114,53,54,1
"35adfa5d923046aebabfefd98f35ff05","35adfa5d923046aebabfefd98f35ff05",22853821,8,0,1,115,54,54,0
"35adfa5d923046aebabfefd98f35ff05","b6f8a98476224da1b40e555ececc7ed8",22853821,1,1,0,123,54,55,1
"b6f8a98476224da1b40e555ececc7ed8","b6f8a98476224da1b40e555ececc7ed8",22853821,2,0,1,124,55,55,0
"b6f8a98476224da1b40e555ececc7ed8","86e22cb5fe0e4b47a9489ecddf7ed78f",22853821,1,1,0,126,55,56,1
"86e22cb5fe0e4b47a9489ecddf7ed78f","86e22cb5fe0e4b47a9489ecddf7ed78f",22853821,2,0,1,127,56,56,0
"86e22cb5fe0e4b47a9489ecddf7ed78f","f924752d8a1149668870b1e7698486f7",22853821,1,-6,0,129,56,50,-6
"f924752d8a1149668870b1e7698486f7","78f30e4dcac84e3cbea8b2cc6e0d62b3",22853821,2,10,0,130,50,59,9
"78f30e4dcac84e3cbea8b2cc6e0d62b3","a1f2f12debe5432fb7a70bcd12bacfb9",22853821,2,-1,0,131,59,58,-1
"a1f2f12debe5432fb7a70bcd12bacfb9","a1f2f12debe5432fb7a70bcd12bacfb9",22853821,30,0,1,132,58,58,0
"a1f2f12debe5432fb7a70bcd12bacfb9","b534b89233134e30a9b5645138bfa9ee",22853821,1,-20,0,142,58,41,-17
"6e13d61a7bdb44bca949c9f86fab3be5","b534b89233134e30a9b5645138bfa9ee",22853821,1,-7,0,144,47,41,-6
"b534b89233134e30a9b5645138bfa9ee","d0c74f735e024943943e40333d6d337f",22853821,2,12,0,145,41,51,10
"d9c8d8c444a64dadbbb508652c721e17","a1f2f12debe5432fb7a70bcd12bacfb9",22853821,1,14,0,147,46,58,12
"a1f2f12debe5432fb7a70bcd12bacfb9","f924752d8a1149668870b1e7698486f7",22853821,1,-9,0,148,58,50,-8
"78f30e4dcac84e3cbea8b2cc6e0d62b3","78f30e4dcac84e3cbea8b2cc6e0d62b3",22853821,14,0,1,150,59,59,0
"a1f2f12debe5432fb7a70bcd12bacfb9","fab84b4fab5940efb4ea868ef8d09396",22853821,1,298,0,172,58,284,226
"fab84b4fab5940efb4ea868ef8d09396","d9c8d8c444a64dadbbb508652c721e17",22853821,1,-312,0,173,284,46,-238
"d9c8d8c444a64dadbbb508652c721e17","b534b89233134e30a9b5645138bfa9ee",22853821,2,-6,0,174,46,41,-5
"6e13d61a7bdb44bca949c9f86fab3be5","d9c8d8c444a64dadbbb508652c721e17",22853821,1,-1,0,176,47,46,-1
"d9c8d8c444a64dadbbb508652c721e17","d0c74f735e024943943e40333d6d337f",22853821,1,6,0,177,46,51,5
"d0c74f735e024943943e40333d6d337f","78f30e4dcac84e3cbea8b2cc6e0d62b3",22853821,1,9,0,178,51,59,8
"78f30e4dcac84e3cbea8b2cc6e0d62b3","f924752d8a1149668870b1e7698486f7",22853821,2,-10,0,179,59,50,-9
"f924752d8a1149668870b1e7698486f7","a1f2f12debe5432fb7a70bcd12bacfb9",22853821,3,9,0,180,50,58,8
"a1f2f12debe5432fb7a70bcd12bacfb9","bc42d26810654ea9a1df1efe1e58c7d5",22853821,1,6,0,194,58,63,5
"bc42d26810654ea9a1df1efe1e58c7d5","a0a418b8540d479fa6e0f653b701da8b",22853821,4,1,0,195,63,64,1
"a0a418b8540d479fa6e0f653b701da8b","12aa6e1672ac4e7aa6449a7a8609cd72",22853821,2,-8,0,196,64,57,-7
"12aa6e1672ac4e7aa6449a7a8609cd72","bc42d26810654ea9a1df1efe1e58c7d5",22853821,2,7,0,197,57,63,6
"bc42d26810654ea9a1df1efe1e58c7d5","bc42d26810654ea9a1df1efe1e58c7d5",22853821,6,0,1,198,63,63,0
"a0a418b8540d479fa6e0f653b701da8b","a0a418b8540d479fa6e0f653b701da8b",22853821,8,0,1,202,64,64,0
"a0a418b8540d479fa6e0f653b701da8b","309ccf3cc4fe429d9bfbaef53d3fa479",22853821,1,-4,0,205,64,60,-4
"309ccf3cc4fe429d9bfbaef53d3fa479","bc42d26810654ea9a1df1efe1e58c7d5",22853821,1,3,0,206,60,63,3
"bc42d26810654ea9a1df1efe1e58c7d5","7af822066add4e7f8e007e4eee31a8bf",22853821,1,3,0,208,63,65,2
"7af822066add4e7f8e007e4eee31a8bf","a0a418b8540d479fa6e0f653b701da8b",22853821,1,-2,0,209,65,64,-1
"a0a418b8540d479fa6e0f653b701da8b","bc42d26810654ea9a1df1efe1e58c7d5",22853821,3,-1,0,212,64,63,-1
"bc42d26810654ea9a1df1efe1e58c7d5","4c943503763e4e349906eea3ed3c8e86",22853821,1,-2,0,213,63,61,-2
"4c943503763e4e349906eea3ed3c8e86","4c943503763e4e349906eea3ed3c8e86",22853821,1,0,1,214,61,61,0
"4c943503763e4e349906eea3ed3c8e86","309ccf3cc4fe429d9bfbaef53d3fa479",22853821,1,-1,0,215,61,60,-1
"309ccf3cc4fe429d9bfbaef53d3fa479","d646286c8051419bbc2e31dd1db55ca8",22853821,2,10,0,216,60,67,7
"d646286c8051419bbc2e31dd1db55ca8","b534b89233134e30a9b5645138bfa9ee",22853821,4,-33,0,217,67,41,-26
"b534b89233134e30a9b5645138bfa9ee","267f883678b24aed855fde42524975d9",22853821,1,37,0,218,41,71,30
"267f883678b24aed855fde42524975d9","267f883678b24aed855fde42524975d9",22853821,1,0,1,219,71,71,0
"267f883678b24aed855fde42524975d9","88fff56d0342490dbef9040750a20f6c",22853821,1,1,0,220,71,72,1
"88fff56d0342490dbef9040750a20f6c","88fff56d0342490dbef9040750a20f6c",22853821,1,0,1,221,72,72,0
"88fff56d0342490dbef9040750a20f6c","adb17b12b66c4a49a85fd34322f7df70",22853821,1,1,0,222,72,73,1
"adb17b12b66c4a49a85fd34322f7df70","adb17b12b66c4a49a85fd34322f7df70",22853821,1,0,1,223,73,73,0
"adb17b12b66c4a49a85fd34322f7df70","d646286c8051419bbc2e31dd1db55ca8",22853821,1,-6,0,224,73,67,-6
"d646286c8051419bbc2e31dd1db55ca8","a2becd407db34b189200a32546d9d569",22853821,2,9,0,225,67,75,8
"a2becd407db34b189200a32546d9d569","a2becd407db34b189200a32546d9d569",22853821,6,0,1,226,75,75,0
"a2becd407db34b189200a32546d9d569","58c22b011d0f4c2ea6d13615edbb9eeb",22853821,1,2,0,232,75,77,2
"58c22b011d0f4c2ea6d13615edbb9eeb","58c22b011d0f4c2ea6d13615edbb9eeb",22853821,4,0,1,233,77,77,0
"58c22b011d0f4c2ea6d13615edbb9eeb","dd76e1861dc9461c830888729d091ee0",22853821,1,1,0,235,77,78,1
"dd76e1861dc9461c830888729d091ee0","dd76e1861dc9461c830888729d091ee0",22853821,5,0,1,236,78,78,0
"dd76e1861dc9461c830888729d091ee0","cd1d828f1a694b87913a7ea66c23803e",22853821,1,1,0,241,78,79,1
"cd1d828f1a694b87913a7ea66c23803e","cd1d828f1a694b87913a7ea66c23803e",22853821,2,0,1,242,79,79,0
"cd1d828f1a694b87913a7ea66c23803e","9176a3c2b4d2465fa8b0c67096c2a97e",22853821,1,1,0,244,79,80,1
"9176a3c2b4d2465fa8b0c67096c2a97e","9176a3c2b4d2465fa8b0c67096c2a97e",22853821,11,0,1,245,80,80,0
"9176a3c2b4d2465fa8b0c67096c2a97e","f8ec6445f7194e25b9101d4fbcb07a18",22853821,1,1,0,256,80,81,1
"f8ec6445f7194e25b9101d4fbcb07a18","f8ec6445f7194e25b9101d4fbcb07a18",22853821,2,0,1,257,81,81,0
"f8ec6445f7194e25b9101d4fbcb07a18","58c22b011d0f4c2ea6d13615edbb9eeb",22853821,1,-4,0,259,81,77,-4
"58c22b011d0f4c2ea6d13615edbb9eeb","140d5b27b8574befad82c0a013b59dfa",22853821,1,-3,0,262,77,74,-3
"140d5b27b8574befad82c0a013b59dfa","d18a9ea32855445f8736581f5cb119ce",22853821,2,9,0,263,74,82,8
"d18a9ea32855445f8736581f5cb119ce","ae5ac430ea254e708a6f5deaaf7464ae",22853821,1,3,0,264,82,84,2
"ae5ac430ea254e708a6f5deaaf7464ae","6a9f0ef185fb47f0937e29daa1c71ed5",22853821,2,7,0,265,84,90,6
"6a9f0ef185fb47f0937e29daa1c71ed5","d646286c8051419bbc2e31dd1db55ca8",22853821,2,-27,0,266,90,67,-23
"d646286c8051419bbc2e31dd1db55ca8","e20db35ced8544ddac5bc3839145e463",22853821,2,30,0,267,67,91,24
"e20db35ced8544ddac5bc3839145e463","fab84b4fab5940efb4ea868ef8d09396",22853821,1,255,0,268,91,284,193
"fab84b4fab5940efb4ea868ef8d09396","f924752d8a1149668870b1e7698486f7",22853821,1,-307,0,269,284,50,-234
"f924752d8a1149668870b1e7698486f7","b534b89233134e30a9b5645138bfa9ee",22853821,1,-11,0,270,50,41,-9
"d0c74f735e024943943e40333d6d337f","f924752d8a1149668870b1e7698486f7",22853821,1,-1,0,272,51,50,-1
"a1f2f12debe5432fb7a70bcd12bacfb9","78f30e4dcac84e3cbea8b2cc6e0d62b3",22853821,2,1,0,274,58,59,1
"78f30e4dcac84e3cbea8b2cc6e0d62b3","bc42d26810654ea9a1df1efe1e58c7d5",22853821,1,5,0,275,59,63,4
"bc42d26810654ea9a1df1efe1e58c7d5","309ccf3cc4fe429d9bfbaef53d3fa479",22853821,2,-3,0,282,63,60,-3
"b534b89233134e30a9b5645138bfa9ee","d646286c8051419bbc2e31dd1db55ca8",22853821,3,33,0,285,41,67,26
"a2becd407db34b189200a32546d9d569","140d5b27b8574befad82c0a013b59dfa",22853821,1,-1,0,291,75,74,-1
"d18a9ea32855445f8736581f5cb119ce","f564483cbd7a407681aa2fcca518cf5f",22853821,1,4,0,293,82,85,3
"f564483cbd7a407681aa2fcca518cf5f","f564483cbd7a407681aa2fcca518cf5f",22853821,7,0,1,294,85,85,0
"f564483cbd7a407681aa2fcca518cf5f","18fd01350bd5434ca636d59a599d768a",22853821,1,1,0,301,85,86,1
"18fd01350bd5434ca636d59a599d768a","18fd01350bd5434ca636d59a599d768a",22853821,9,0,1,302,86,86,0
"18fd01350bd5434ca636d59a599d768a","ae5ac430ea254e708a6f5deaaf7464ae",22853821,1,-2,0,311,86,84,-2
"6a9f0ef185fb47f0937e29daa1c71ed5","c681290961c94c4caf23b529d1ae6b9a",22853821,1,-2,0,313,90,88,-2
"c681290961c94c4caf23b529d1ae6b9a","c681290961c94c4caf23b529d1ae6b9a",22853821,2,0,1,314,88,88,0
"c681290961c94c4caf23b529d1ae6b9a","6a9f0ef185fb47f0937e29daa1c71ed5",22853821,1,2,0,316,88,90,2
"6a9f0ef185fb47f0937e29daa1c71ed5","6a9f0ef185fb47f0937e29daa1c71ed5",22853821,3,0,1,317,90,90,0
"e20db35ced8544ddac5bc3839145e463","1febb706d7a34005ae8711ed49c76e64",22853821,1,3,0,322,91,94,3
"1febb706d7a34005ae8711ed49c76e64","1febb706d7a34005ae8711ed49c76e64",22853821,2,0,1,323,94,94,0
"1febb706d7a34005ae8711ed49c76e64","8f73ba6f5a0042f2850356ac38ac6f24",22853821,1,1,0,325,94,95,1
"8f73ba6f5a0042f2850356ac38ac6f24","8f73ba6f5a0042f2850356ac38ac6f24",22853821,6,0,1,326,95,95,0
"8f73ba6f5a0042f2850356ac38ac6f24","e2260b86653c46d7b14a41fb419dbf8c",22853821,1,1,0,332,95,96,1
"e2260b86653c46d7b14a41fb419dbf8c","e2260b86653c46d7b14a41fb419dbf8c",22853821,5,0,1,333,96,96,0
"e2260b86653c46d7b14a41fb419dbf8c","35eb641ad1d845bbba54915bce75a962",22853821,1,1,0,338,96,97,1
"35eb641ad1d845bbba54915bce75a962","35eb641ad1d845bbba54915bce75a962",22853821,3,0,1,339,97,97,0
"35eb641ad1d845bbba54915bce75a962","08be90ffbeea4795a138cd42ed8db56f",22853821,1,1,0,342,97,98,1
"08be90ffbeea4795a138cd42ed8db56f","08be90ffbeea4795a138cd42ed8db56f",22853821,3,0,1,343,98,98,0
"08be90ffbeea4795a138cd42ed8db56f","3007433c8f584dcbb5ac159c1c5f2be3",22853821,1,1,0,346,98,99,1
"3007433c8f584dcbb5ac159c1c5f2be3","3007433c8f584dcbb5ac159c1c5f2be3",22853821,3,0,1,347,99,99,0
"3007433c8f584dcbb5ac159c1c5f2be3","e20db35ced8544ddac5bc3839145e463",22853821,1,-8,0,350,99,91,-8
"e20db35ced8544ddac5bc3839145e463","00ae5f0c51874a73a41ebea838d95682",22853821,1,11,0,351,91,101,10
"00ae5f0c51874a73a41ebea838d95682","d391c8b6e56a43a7b654e9dee02d904b",22853821,2,2,0,352,101,103,2
"d391c8b6e56a43a7b654e9dee02d904b","00ae5f0c51874a73a41ebea838d95682",22853821,2,-2,0,353,103,101,-2
"00ae5f0c51874a73a41ebea838d95682","00ae5f0c51874a73a41ebea838d95682",22853821,6,0,1,354,101,101,0
"d391c8b6e56a43a7b654e9dee02d904b","d391c8b6e56a43a7b654e9dee02d904b",22853821,65,0,1,359,103,103,0
"d391c8b6e56a43a7b654e9dee02d904b","6111116566fc4fd9abba409322bea245",22853821,1,1,0,382,103,104,1
"6111116566fc4fd9abba409322bea245","6111116566fc4fd9abba409322bea245",22853821,2,0,1,383,104,104,0
"6111116566fc4fd9abba409322bea245","a81b2235cb9c499eb9ea8ee0a8dd9725",22853821,1,1,0,385,104,105,1
"a81b2235cb9c499eb9ea8ee0a8dd9725","a81b2235cb9c499eb9ea8ee0a8dd9725",22853821,3,0,1,386,105,105,0
"a81b2235cb9c499eb9ea8ee0a8dd9725","2d4e0ab0ef3b4d73b82c72d4621a7579",22853821,1,1,0,389,105,106,1
"2d4e0ab0ef3b4d73b82c72d4621a7579","2d4e0ab0ef3b4d73b82c72d4621a7579",22853821,2,0,1,390,106,106,0
"2d4e0ab0ef3b4d73b82c72d4621a7579","8bdebf492ebd4e62b0d522e8ab5e5197",22853821,1,1,0,392,106,107,1
"8bdebf492ebd4e62b0d522e8ab5e5197","8bdebf492ebd4e62b0d522e8ab5e5197",22853821,3,0,1,393,107,107,0
"8bdebf492ebd4e62b0d522e8ab5e5197","d391c8b6e56a43a7b654e9dee02d904b",22853821,1,-4,0,396,107,103,-4
"00ae5f0c51874a73a41ebea838d95682","4280927ec4d643238aa49c32f9e06c6c",22853821,1,9,0,442,101,109,8
"4280927ec4d643238aa49c32f9e06c6c","73039f8c1eb9409cb4caee2cf968001e",22853821,1,-10,0,443,109,100,-9
"73039f8c1eb9409cb4caee2cf968001e","4280927ec4d643238aa49c32f9e06c6c",22853821,1,10,0,444,100,109,9
"4280927ec4d643238aa49c32f9e06c6c","fc44e6a5f7654430af1227838224dceb",22853821,1,2,0,445,109,111,2
"fc44e6a5f7654430af1227838224dceb","fc44e6a5f7654430af1227838224dceb",22853821,6,0,1,446,111,111,0
"fc44e6a5f7654430af1227838224dceb","08111f75e22d409998cf8b85bd431f0a",22853821,1,-3,0,452,111,108,-3
"08111f75e22d409998cf8b85bd431f0a","a9ae0a3c070d455bb4369a8996313336",22853821,1,7,0,453,108,114,6
"a9ae0a3c070d455bb4369a8996313336","fab84b4fab5940efb4ea868ef8d09396",22853821,1,229,0,454,114,284,170
"fab84b4fab5940efb4ea868ef8d09396","e20db35ced8544ddac5bc3839145e463",22853821,1,-255,0,455,284,91,-193
"e20db35ced8544ddac5bc3839145e463","f3c44bf91f85487caa6400dfe774e63b",22853821,1,27,0,456,91,115,24
"f3c44bf91f85487caa6400dfe774e63b","f3c44bf91f85487caa6400dfe774e63b",22853821,1,0,1,457,115,115,0
"f3c44bf91f85487caa6400dfe774e63b","a9ae0a3c070d455bb4369a8996313336",22853821,1,-1,0,458,115,114,-1
"a9ae0a3c070d455bb4369a8996313336","71cec822bcff4f30a20e75dc63ef7b65",22853821,1,2,0,459,114,116,2
"71cec822bcff4f30a20e75dc63ef7b65","71cec822bcff4f30a20e75dc63ef7b65",22853821,1,0,1,460,116,116,0
"71cec822bcff4f30a20e75dc63ef7b65","62bff51286ef4f348717a3cf6fe2318f",22853821,1,5,0,461,116,120,4
"62bff51286ef4f348717a3cf6fe2318f","37319e88176d4aefa91d7a9980dbae91",22853821,1,-9,0,462,120,112,-8
"37319e88176d4aefa91d7a9980dbae91","779f9ddd1fd14d1e9e69f72219a1fdbd",22853821,1,12,0,463,112,121,9
"779f9ddd1fd14d1e9e69f72219a1fdbd","e20db35ced8544ddac5bc3839145e463",22853821,1,-36,0,464,121,91,-30
"e20db35ced8544ddac5bc3839145e463","e20db35ced8544ddac5bc3839145e463",22853821,1,0,1,465,91,91,0
"e20db35ced8544ddac5bc3839145e463","779f9ddd1fd14d1e9e69f72219a1fdbd",22853821,2,36,0,466,91,121,30
"779f9ddd1fd14d1e9e69f72219a1fdbd","62bff51286ef4f348717a3cf6fe2318f",22853821,1,-3,0,467,121,120,-1
"62bff51286ef4f348717a3cf6fe2318f","b1cd0e7dc3ad4a8eb91a4bfdbeb025b0",22853821,1,-2,0,468,120,118,-2
"b1cd0e7dc3ad4a8eb91a4bfdbeb025b0","b1cd0e7dc3ad4a8eb91a4bfdbeb025b0",22853821,1,0,1,469,118,118,0
"b1cd0e7dc3ad4a8eb91a4bfdbeb025b0","e20db35ced8544ddac5bc3839145e463",22853821,1,-31,0,470,118,91,-27
"779f9ddd1fd14d1e9e69f72219a1fdbd","779f9ddd1fd14d1e9e69f72219a1fdbd",22853821,1,0,1,472,121,121,0
"779f9ddd1fd14d1e9e69f72219a1fdbd","a8dd5213034441ac92724b4e83eb0bb2",22853821,1,9,0,473,121,129,8
"a8dd5213034441ac92724b4e83eb0bb2","a8dd5213034441ac92724b4e83eb0bb2",22853821,1,0,1,474,129,129,0
"a8dd5213034441ac92724b4e83eb0bb2","579338175e0b4bbb8ef3b712b5d8b54e",22853821,1,-1,0,475,129,128,-1
"579338175e0b4bbb8ef3b712b5d8b54e","b416d47c56a742199b5d7c7f19d6503a",22853821,1,7,0,476,128,134,6
"b416d47c56a742199b5d7c7f19d6503a","779f9ddd1fd14d1e9e69f72219a1fdbd",22853821,1,-15,0,477,134,121,-13
"779f9ddd1fd14d1e9e69f72219a1fdbd","df1de691dafe4549a18a4398ee9dfaf9",22853821,1,23,0,478,121,139,18
"df1de691dafe4549a18a4398ee9dfaf9","6c5ad271a44743479bfaea29b1db8d02",22853821,1,4,0,479,139,143,4
"6c5ad271a44743479bfaea29b1db8d02","6c5ad271a44743479bfaea29b1db8d02",22853821,1,0,1,480,143,143,0
"6c5ad271a44743479bfaea29b1db8d02","8aae34f5ddbb4052a709b12e6b0d40fa",22853821,1,5,0,481,143,147,4
"8aae34f5ddbb4052a709b12e6b0d40fa","df1de691dafe4549a18a4398ee9dfaf9",22853821,1,-9,0,482,147,139,-8
"df1de691dafe4549a18a4398ee9dfaf9","8aae34f5ddbb4052a709b12e6b0d40fa",22853821,1,9,0,483,139,147,8
"8aae34f5ddbb4052a709b12e6b0d40fa","f902b0f41b544d4dbf79664fd233648d",22853821,1,-1,0,484,147,146,-1
"f902b0f41b544d4dbf79664fd233648d","f03480cf4eba413194d7af52fc0e7f28",22853821,1,7,0,485,146,152,6
"f03480cf4eba413194d7af52fc0e7f28","d313cec988a84645bee413e8d4724a4b",22853821,1,7,0,486,152,158,6
"d313cec988a84645bee413e8d4724a4b","78adeee1fa2c4fe0bc73f7bca9fcee86",22853821,1,4,0,487,158,160,2
"78adeee1fa2c4fe0bc73f7bca9fcee86","df1de691dafe4549a18a4398ee9dfaf9",22853821,1,-26,0,488,160,139,-21
"df1de691dafe4549a18a4398ee9dfaf9","65202579580f4ad38d734b4ee39d22a8",22853821,1,31,0,489,139,164,25
"65202579580f4ad38d734b4ee39d22a8","78adeee1fa2c4fe0bc73f7bca9fcee86",22853821,2,-5,0,490,164,160,-4
"78adeee1fa2c4fe0bc73f7bca9fcee86","65202579580f4ad38d734b4ee39d22a8",22853821,1,5,0,491,160,164,4
"65202579580f4ad38d734b4ee39d22a8","65202579580f4ad38d734b4ee39d22a8",22853821,6,0,1,492,164,164,0
"78adeee1fa2c4fe0bc73f7bca9fcee86","3cbcea2be0984e7dbd5a48195af10ce7",22853821,1,8,0,499,160,165,5
"3cbcea2be0984e7dbd5a48195af10ce7","82e6285962b8400d9d6fc32436022a94",22853821,2,2,0,500,165,167,2
"82e6285962b8400d9d6fc32436022a94","3cbcea2be0984e7dbd5a48195af10ce7",22853821,1,-2,0,501,167,165,-2
"3cbcea2be0984e7dbd5a48195af10ce7","a9ac840f098c4bd0a2ee896214ce29cd",22853821,1,5,0,502,165,168,3
"a9ac840f098c4bd0a2ee896214ce29cd","a9ac840f098c4bd0a2ee896214ce29cd",22853821,2,0,1,503,168,168,0
"a9ac840f098c4bd0a2ee896214ce29cd","3cbcea2be0984e7dbd5a48195af10ce7",22853821,1,-5,0,505,168,165,-3
"82e6285962b8400d9d6fc32436022a94","a9ac840f098c4bd0a2ee896214ce29cd",22853821,1,3,0,507,167,168,1
"a9ac840f098c4bd0a2ee896214ce29cd","0c7262dff33c4087bc660ccf40f92f9c",22853821,1,4,0,508,168,169,1
"0c7262dff33c4087bc660ccf40f92f9c","a9ac840f098c4bd0a2ee896214ce29cd",22853821,1,-4,0,509,169,168,-1
"a9ac840f098c4bd0a2ee896214ce29cd","b2275c3fad834f8d90737a2d9a6927d6",22853821,1,7,0,510,168,172,4
"b2275c3fad834f8d90737a2d9a6927d6","d9c8d8c444a64dadbbb508652c721e17",22853821,1,-162,0,511,172,46,-126
"6e13d61a7bdb44bca949c9f86fab3be5","d0c74f735e024943943e40333d6d337f",22853821,1,5,0,514,47,51,4
"d9c8d8c444a64dadbbb508652c721e17","78f30e4dcac84e3cbea8b2cc6e0d62b3",22853821,1,15,0,516,46,59,13
"a1f2f12debe5432fb7a70bcd12bacfb9","12aa6e1672ac4e7aa6449a7a8609cd72",22853821,1,-1,0,519,58,57,-1
"12aa6e1672ac4e7aa6449a7a8609cd72","a0a418b8540d479fa6e0f653b701da8b",22853821,1,8,0,520,57,64,7
"309ccf3cc4fe429d9bfbaef53d3fa479","a1f2f12debe5432fb7a70bcd12bacfb9",22853821,1,-3,0,527,60,58,-2
"78f30e4dcac84e3cbea8b2cc6e0d62b3","0c7262dff33c4087bc660ccf40f92f9c",22853821,1,144,0,529,59,169,110
"0c7262dff33c4087bc660ccf40f92f9c","b2275c3fad834f8d90737a2d9a6927d6",22853821,3,3,0,530,169,172,3
"b2275c3fad834f8d90737a2d9a6927d6","0c7262dff33c4087bc660ccf40f92f9c",22853821,1,-3,0,531,172,169,-3
"0c7262dff33c4087bc660ccf40f92f9c","0c7262dff33c4087bc660ccf40f92f9c",22853821,2,0,1,532,169,169,0
"b2275c3fad834f8d90737a2d9a6927d6","b2275c3fad834f8d90737a2d9a6927d6",22853821,36,0,1,535,172,172,0
"b2275c3fad834f8d90737a2d9a6927d6","eb515a26030b41f8a82a1e6114420bad",22853821,1,1,0,571,172,173,1
"eb515a26030b41f8a82a1e6114420bad","eb515a26030b41f8a82a1e6114420bad",22853821,2,0,1,572,173,173,0
"eb515a26030b41f8a82a1e6114420bad","0c7262dff33c4087bc660ccf40f92f9c",22853821,1,-4,0,574,173,169,-4
"0c7262dff33c4087bc660ccf40f92f9c","b42cc17b7de840f181a704558d0bc845",22853821,2,7,0,575,169,175,6
"b42cc17b7de840f181a704558d0bc845","b42cc17b7de840f181a704558d0bc845",22853821,1,0,1,576,175,175,0
"b42cc17b7de840f181a704558d0bc845","801f9e9135034f49bf5f8b4bdefedb41",22853821,1,2,0,577,175,177,2
"801f9e9135034f49bf5f8b4bdefedb41","801f9e9135034f49bf5f8b4bdefedb41",22853821,4,0,1,578,177,177,0
"801f9e9135034f49bf5f8b4bdefedb41","362fcb0699a14845ab29b2340093e528",22853821,1,-3,0,582,177,174,-3
"362fcb0699a14845ab29b2340093e528","ea38cc0e6e6e41edbabf210220808bf9",22853821,1,6,0,583,174,179,5
"ea38cc0e6e6e41edbabf210220808bf9","b87c552dd247427abe6ab5795b9c9d43",22853821,2,2,0,584,179,181,2
"b87c552dd247427abe6ab5795b9c9d43","ea38cc0e6e6e41edbabf210220808bf9",22853821,2,-2,0,585,181,179,-2
"ea38cc0e6e6e41edbabf210220808bf9","ea38cc0e6e6e41edbabf210220808bf9",22853821,2,0,1,586,179,179,0
"ea38cc0e6e6e41edbabf210220808bf9","0c7262dff33c4087bc660ccf40f92f9c",22853821,1,-12,0,588,179,169,-10
"b2275c3fad834f8d90737a2d9a6927d6","b42cc17b7de840f181a704558d0bc845",22853821,1,4,0,590,172,175,3
"b42cc17b7de840f181a704558d0bc845","0c7262dff33c4087bc660ccf40f92f9c",22853821,1,-7,0,591,175,169,-6
"b42cc17b7de840f181a704558d0bc845","362fcb0699a14845ab29b2340093e528",22853821,1,-1,0,593,175,174,-1
"362fcb0699a14845ab29b2340093e528","b87c552dd247427abe6ab5795b9c9d43",22853821,1,8,0,594,174,181,7
"b87c552dd247427abe6ab5795b9c9d43","b87c552dd247427abe6ab5795b9c9d43",22853821,7,0,1,597,181,181,0
"b87c552dd247427abe6ab5795b9c9d43","139b097acfca451689d80c9c6eebdf7b",22853821,1,-3,0,604,181,178,-3
"139b097acfca451689d80c9c6eebdf7b","30f660a1feb34582a739722532524f79",22853821,1,6,0,605,178,183,5
"30f660a1feb34582a739722532524f79","30f660a1feb34582a739722532524f79",22853821,6,0,1,606,183,183,0
"30f660a1feb34582a739722532524f79","2024b4885bd14338a39b7b509acbbd02",22853821,1,-1,0,612,183,182,-1
"2024b4885bd14338a39b7b509acbbd02","c3f63fe50d8e487c86bf8ef76c9cadd3",22853821,1,4,0,613,182,185,3
"c3f63fe50d8e487c86bf8ef76c9cadd3","c3f63fe50d8e487c86bf8ef76c9cadd3",22853821,3,0,1,614,185,185,0
"c3f63fe50d8e487c86bf8ef76c9cadd3","0c7262dff33c4087bc660ccf40f92f9c",22853821,1,-20,0,617,185,169,-16
"0c7262dff33c4087bc660ccf40f92f9c","c8e371568a0c4391b25796ae4e91952e",22853821,1,23,0,618,169,186,17
"c8e371568a0c4391b25796ae4e91952e","7d932b23e1c84326ae5aa4d3c0d813d1",22853821,1,2,0,619,186,188,2
"7d932b23e1c84326ae5aa4d3c0d813d1","7d932b23e1c84326ae5aa4d3c0d813d1",22853821,1,0,1,620,188,188,0
"7d932b23e1c84326ae5aa4d3c0d813d1","ab11d94c6c8948ea90b88f19d2cd502b",22853821,1,3,0,621,188,190,2
"ab11d94c6c8948ea90b88f19d2cd502b","c8e371568a0c4391b25796ae4e91952e",22853821,1,-5,0,622,190,186,-4
"c8e371568a0c4391b25796ae4e91952e","ab11d94c6c8948ea90b88f19d2cd502b",22853821,1,5,0,623,186,190,4
"ab11d94c6c8948ea90b88f19d2cd502b","f992451ed6ad4e68bb9e68ad6be7c4be",22853821,1,2,0,624,190,192,2
"f992451ed6ad4e68bb9e68ad6be7c4be","f992451ed6ad4e68bb9e68ad6be7c4be",22853821,1,0,1,625,192,192,0
"f992451ed6ad4e68bb9e68ad6be7c4be","6cd2dcaac46847d4a0bc53f296d90375",22853821,1,3,0,626,192,194,2
"6cd2dcaac46847d4a0bc53f296d90375","07b44a7a51e94c78b411c753fc39dab0",22853821,1,-6,0,627,194,189,-5
"07b44a7a51e94c78b411c753fc39dab0","6cd2dcaac46847d4a0bc53f296d90375",22853821,1,6,0,628,189,194,5
"6cd2dcaac46847d4a0bc53f296d90375","2d2580c9411c4972909db508d6956a58",22853821,1,2,0,629,194,196,2
"2d2580c9411c4972909db508d6956a58","2d2580c9411c4972909db508d6956a58",22853821,3,0,1,630,196,196,0
"2d2580c9411c4972909db508d6956a58","5bddb3d9ed264f3984702f048c7e5340",22853821,1,1,0,633,196,197,1
"5bddb3d9ed264f3984702f048c7e5340","5bddb3d9ed264f3984702f048c7e5340",22853821,2,0,1,634,197,197,0
"5bddb3d9ed264f3984702f048c7e5340","d5e8e2bd12a2466b9d6d90855f0eb079",22853821,1,1,0,636,197,198,1
"d5e8e2bd12a2466b9d6d90855f0eb079","d5e8e2bd12a2466b9d6d90855f0eb079",22853821,2,0,1,637,198,198,0
"d5e8e2bd12a2466b9d6d90855f0eb079","017d7ca8e0394b91aaadc9574df2202c",22853821,1,-5,0,639,198,193,-5
"017d7ca8e0394b91aaadc9574df2202c","54e8e9f0ea3e45c4bf3b8ac799ee31b1",22853821,1,8,0,640,193,200,7
"54e8e9f0ea3e45c4bf3b8ac799ee31b1","54e8e9f0ea3e45c4bf3b8ac799ee31b1",22853821,1,0,1,641,200,200,0
"54e8e9f0ea3e45c4bf3b8ac799ee31b1","c614a00911be4877a075f19315530fb0",22853821,1,1,0,642,200,201,1
"c614a00911be4877a075f19315530fb0","c614a00911be4877a075f19315530fb0",22853821,6,0,1,643,201,201,0
"c614a00911be4877a075f19315530fb0","a6c21bd8b95249c7972820a7a7d76aff",22853821,1,1,0,649,201,202,1
"a6c21bd8b95249c7972820a7a7d76aff","a6c21bd8b95249c7972820a7a7d76aff",22853821,1,0,1,650,202,202,0
"a6c21bd8b95249c7972820a7a7d76aff","bb329d880ab54120adaf203a693bb203",22853821,1,1,0,651,202,203,1
"bb329d880ab54120adaf203a693bb203","bb329d880ab54120adaf203a693bb203",22853821,1,0,1,652,203,203,0
"bb329d880ab54120adaf203a693bb203","f9170dd6bc6442b4acd832747609b09a",22853821,1,-4,0,653,203,199,-4
"f9170dd6bc6442b4acd832747609b09a","334c2344009840079b1d0e1b7ce3d5a7",22853821,1,7,0,654,199,205,6
"334c2344009840079b1d0e1b7ce3d5a7","334c2344009840079b1d0e1b7ce3d5a7",22853821,1,0,1,655,205,205,0
"334c2344009840079b1d0e1b7ce3d5a7","d7f13c8d63ec4e2aa673fbb9cf9c6933",22853821,1,3,0,656,205,206,1
"d7f13c8d63ec4e2aa673fbb9cf9c6933","c8e371568a0c4391b25796ae4e91952e",22853821,1,-26,0,657,206,186,-20
"c8e371568a0c4391b25796ae4e91952e","b9e80f77c3a44349863b19875725c384",22853821,1,27,0,658,186,207,21
"b9e80f77c3a44349863b19875725c384","7108f0e4c2584f1f9c471689ae4c885c",22853821,2,1,0,659,207,208,1
"7108f0e4c2584f1f9c471689ae4c885c","b9e80f77c3a44349863b19875725c384",22853821,1,-1,0,660,208,207,-1
"b9e80f77c3a44349863b19875725c384","b9e80f77c3a44349863b19875725c384",22853821,16,0,1,661,207,207,0
"7108f0e4c2584f1f9c471689ae4c885c","7108f0e4c2584f1f9c471689ae4c885c",22853821,11,0,1,678,208,208,0
"7108f0e4c2584f1f9c471689ae4c885c","d7f13c8d63ec4e2aa673fbb9cf9c6933",22853821,1,-2,0,689,208,206,-2
"d7f13c8d63ec4e2aa673fbb9cf9c6933","09400e101c5d4b439cf9a26b03aae558",22853821,1,5,0,690,206,210,4
"09400e101c5d4b439cf9a26b03aae558","09400e101c5d4b439cf9a26b03aae558",22853821,1,0,1,691,210,210,0
"09400e101c5d4b439cf9a26b03aae558","a88efa7e50ce47159810ab553afa6d3a",22853821,1,2,0,692,210,212,2
"a88efa7e50ce47159810ab553afa6d3a","a88efa7e50ce47159810ab553afa6d3a",22853821,6,0,1,693,212,212,0
"a88efa7e50ce47159810ab553afa6d3a","be502a7a43c44bf7b682698de79d9369",22853821,1,3,0,699,212,214,2
"be502a7a43c44bf7b682698de79d9369","a875096404ef4a9984b62d74cda916f9",22853821,1,-6,0,700,214,209,-5
"a875096404ef4a9984b62d74cda916f9","f7fb1952f56b4189b86a9f8b7862d2b8",22853821,1,7,0,701,209,215,6
"f7fb1952f56b4189b86a9f8b7862d2b8","be502a7a43c44bf7b682698de79d9369",22853821,1,-1,0,702,215,214,-1
"be502a7a43c44bf7b682698de79d9369","f7fb1952f56b4189b86a9f8b7862d2b8",22853821,1,1,0,703,214,215,1
"f7fb1952f56b4189b86a9f8b7862d2b8","f7fb1952f56b4189b86a9f8b7862d2b8",22853821,17,0,1,704,215,215,0
"f7fb1952f56b4189b86a9f8b7862d2b8","b860ee85d8bc4a2f97958cfb71be3533",22853821,2,1,0,721,215,216,1
"b860ee85d8bc4a2f97958cfb71be3533","b860ee85d8bc4a2f97958cfb71be3533",22853821,5,0,1,722,216,216,0
"b860ee85d8bc4a2f97958cfb71be3533","ec341f459285443b8361f7f15638ff08",22853821,1,-3,0,724,216,213,-3
"ec341f459285443b8361f7f15638ff08","363837c182e04711840d896ae1e0339c",22853821,1,6,0,725,213,218,5
"363837c182e04711840d896ae1e0339c","363837c182e04711840d896ae1e0339c",22853821,18,0,1,726,218,218,0
"363837c182e04711840d896ae1e0339c","01b2051f8941460d89945e3b02d1ce78",22853821,1,-1,0,744,218,217,-1
"01b2051f8941460d89945e3b02d1ce78","be502a7a43c44bf7b682698de79d9369",22853821,1,-4,0,745,217,214,-3
"be502a7a43c44bf7b682698de79d9369","be95c065e45447c1bd8215ea6f130c7a",22853821,1,7,0,746,214,219,5
"be95c065e45447c1bd8215ea6f130c7a","f7fb1952f56b4189b86a9f8b7862d2b8",22853821,1,-6,0,747,219,215,-4
"b860ee85d8bc4a2f97958cfb71be3533","363837c182e04711840d896ae1e0339c",22853821,1,3,0,752,216,218,2
"363837c182e04711840d896ae1e0339c","ec341f459285443b8361f7f15638ff08",22853821,1,-6,0,753,218,213,-5
"ec341f459285443b8361f7f15638ff08","01b2051f8941460d89945e3b02d1ce78",22853821,1,5,0,754,213,217,4
"01b2051f8941460d89945e3b02d1ce78","d7f13c8d63ec4e2aa673fbb9cf9c6933",22853821,1,-14,0,755,217,206,-11
"d7f13c8d63ec4e2aa673fbb9cf9c6933","1c6721b1f63f4d30ba7746ea8af02a52",22853821,1,21,0,756,206,221,15
"1c6721b1f63f4d30ba7746ea8af02a52","77ecef8eff6b4a2caea7707669bf7475",22853821,1,1,0,757,221,222,1
"77ecef8eff6b4a2caea7707669bf7475","77ecef8eff6b4a2caea7707669bf7475",22853821,12,0,1,758,222,222,0
"77ecef8eff6b4a2caea7707669bf7475","8b9ae98743bd4d4a8a87dff1c1244211",22853821,1,6,0,770,222,227,5
"8b9ae98743bd4d4a8a87dff1c1244211","d03cb855c70044cf8c35d9ec0de696e3",22853821,1,-3,0,771,227,224,-3
"d03cb855c70044cf8c35d9ec0de696e3","1c6721b1f63f4d30ba7746ea8af02a52",22853821,1,-4,0,772,224,221,-3
"1c6721b1f63f4d30ba7746ea8af02a52","d03cb855c70044cf8c35d9ec0de696e3",22853821,1,4,0,773,221,224,3
"d03cb855c70044cf8c35d9ec0de696e3","a49a937d6896486d9a5396654abcf2e1",22853821,1,2,0,774,224,226,2
"a49a937d6896486d9a5396654abcf2e1","a49a937d6896486d9a5396654abcf2e1",22853821,1,0,1,775,226,226,0
"a49a937d6896486d9a5396654abcf2e1","8b9ae98743bd4d4a8a87dff1c1244211",22853821,1,1,0,776,226,227,1
"8b9ae98743bd4d4a8a87dff1c1244211","8b9ae98743bd4d4a8a87dff1c1244211",22853821,31,0,1,777,227,227,0
"8b9ae98743bd4d4a8a87dff1c1244211","2ab1535aac1346ba8801535bf729ef37",22853821,1,3,0,808,227,229,2
"2ab1535aac1346ba8801535bf729ef37","f7906d6f59b9489a91d2ef40db5a474d",22853821,1,-7,0,809,229,223,-6
"f7906d6f59b9489a91d2ef40db5a474d","2ab1535aac1346ba8801535bf729ef37",22853821,1,7,0,810,223,229,6
"2ab1535aac1346ba8801535bf729ef37","2ab1535aac1346ba8801535bf729ef37",22853821,1,0,1,811,229,229,0
"2ab1535aac1346ba8801535bf729ef37","a4f40fb48a8542c8949bae1f002cd9bc",22853821,1,2,0,812,229,231,2
"a4f40fb48a8542c8949bae1f002cd9bc","a4f40fb48a8542c8949bae1f002cd9bc",22853821,9,0,1,813,231,231,0
"a4f40fb48a8542c8949bae1f002cd9bc","8972c23e32044edb8a78fa1eed4e5947",22853821,1,1,0,822,231,232,1
"8972c23e32044edb8a78fa1eed4e5947","8972c23e32044edb8a78fa1eed4e5947",22853821,3,0,1,823,232,232,0
"8972c23e32044edb8a78fa1eed4e5947","92feb4a40f8344d38b6f722e42a53295",22853821,1,1,0,826,232,233,1
"92feb4a40f8344d38b6f722e42a53295","92feb4a40f8344d38b6f722e42a53295",22853821,2,0,1,827,233,233,0
"92feb4a40f8344d38b6f722e42a53295","5152833676bf4c6cb317060be10f68db",22853821,1,-5,0,829,233,228,-5
"5152833676bf4c6cb317060be10f68db","ca3e28f290354c08aefe5b0f769604e6",22853821,1,8,0,830,228,235,7
"ca3e28f290354c08aefe5b0f769604e6","ca3e28f290354c08aefe5b0f769604e6",22853821,9,0,1,831,235,235,0
"ca3e28f290354c08aefe5b0f769604e6","79a35eea833e4c2c9d22fc53c3c6445c",22853821,1,1,0,840,235,236,1
"79a35eea833e4c2c9d22fc53c3c6445c","79a35eea833e4c2c9d22fc53c3c6445c",22853821,15,0,1,841,236,236,0
"79a35eea833e4c2c9d22fc53c3c6445c","cab89fa5c3ed45a5aa550fc0352d6a42",22853821,1,2,0,856,236,238,2
"cab89fa5c3ed45a5aa550fc0352d6a42","cab89fa5c3ed45a5aa550fc0352d6a42",22853821,3,0,1,857,238,238,0
"cab89fa5c3ed45a5aa550fc0352d6a42","0b04c8e2f86d48c7aeb7e225819cd32b",22853821,1,-4,0,860,238,234,-4
"0b04c8e2f86d48c7aeb7e225819cd32b","1c6721b1f63f4d30ba7746ea8af02a52",22853821,1,-16,0,861,234,221,-13
"1c6721b1f63f4d30ba7746ea8af02a52","2ae94c0cea4d480a9d5dca8fb1d7b542",22853821,1,27,0,862,221,242,21
"2ae94c0cea4d480a9d5dca8fb1d7b542","1ebf23f9d994469a85206e4c7b1bf5f5",22853821,1,3,0,863,242,245,3
"1ebf23f9d994469a85206e4c7b1bf5f5","1c6721b1f63f4d30ba7746ea8af02a52",22853821,1,-30,0,864,245,221,-24
"1c6721b1f63f4d30ba7746ea8af02a52","64dbedb3ce544f6aae8e10e0cf10f16d",22853821,1,23,0,865,221,240,19
"64dbedb3ce544f6aae8e10e0cf10f16d","b7719e26494940efa49512aedd0aac79",22853821,1,-302,0,866,240,20,-220
"afbf7250b99d47bea07172749483ca97","b7719e26494940efa49512aedd0aac79",22853821,2,-12,0,869,28,20,-8
"67a089198fcb4e1c8f2385786c2b296f","67a089198fcb4e1c8f2385786c2b296f",5638709,1,0,1,1,39,39,0
"67a089198fcb4e1c8f2385786c2b296f","e2911e79efc2420eac45d9f671463d4b",5638709,1,-69,0,2,39,2,-37
"e2911e79efc2420eac45d9f671463d4b","b613861cecf84ffcab01afb23f660475",5638709,3,-3,0,4,2,1,-1
"b613861cecf84ffcab01afb23f660475","b613861cecf84ffcab01afb23f660475",5638709,1,0,1,7,1,1,0
"b613861cecf84ffcab01afb23f660475","e2911e79efc2420eac45d9f671463d4b",5638709,3,3,0,10,1,2,1
"e2911e79efc2420eac45d9f671463d4b","e2911e79efc2420eac45d9f671463d4b",5638709,3,0,1,11,2,2,0
"e2911e79efc2420eac45d9f671463d4b","519d1b8c59404d67b54e96c5c8a830b2",5638709,1,1,0,13,2,3,1
"519d1b8c59404d67b54e96c5c8a830b2","519d1b8c59404d67b54e96c5c8a830b2",5638709,1,0,1,14,3,3,0
"519d1b8c59404d67b54e96c5c8a830b2","531db53f81f646edb0cdcfe0085b03b7",5638709,1,1,0,15,3,4,1
"531db53f81f646edb0cdcfe0085b03b7","531db53f81f646edb0cdcfe0085b03b7",5638709,1,0,1,16,4,4,0
"531db53f81f646edb0cdcfe0085b03b7","4f5f94b2f95141e0a9d53a61da2276da",5638709,1,1,0,17,4,5,1
"4f5f94b2f95141e0a9d53a61da2276da","4f5f94b2f95141e0a9d53a61da2276da",5638709,1,0,1,18,5,5,0
"4f5f94b2f95141e0a9d53a61da2276da","6d541c89590949f99af293c4f2333f67",5638709,1,1,0,19,5,6,1
"6d541c89590949f99af293c4f2333f67","6d541c89590949f99af293c4f2333f67",5638709,1,0,1,20,6,6,0
"6d541c89590949f99af293c4f2333f67","dd5cf0b9fe4c4f1d8f5ff8e4c04879cb",5638709,1,1,0,21,6,7,1
"dd5cf0b9fe4c4f1d8f5ff8e4c04879cb","dd5cf0b9fe4c4f1d8f5ff8e4c04879cb",5638709,5,0,1,22,7,7,0
"dd5cf0b9fe4c4f1d8f5ff8e4c04879cb","f96261861edc426abe2248be4f0a709a",5638709,2,1,0,24,7,8,1
"f96261861edc426abe2248be4f0a709a","f96261861edc426abe2248be4f0a709a",5638709,3,0,1,25,8,8,0
"f96261861edc426abe2248be4f0a709a","dd5cf0b9fe4c4f1d8f5ff8e4c04879cb",5638709,1,-1,0,27,8,7,-1
"f96261861edc426abe2248be4f0a709a","66b5e16f4f75454fb5b8172079f0fa83",5638709,1,1,0,33,8,9,1
"66b5e16f4f75454fb5b8172079f0fa83","66b5e16f4f75454fb5b8172079f0fa83",5638709,1,0,1,34,9,9,0
"66b5e16f4f75454fb5b8172079f0fa83","0680571d4698477995e41842c36a54b2",5638709,1,1,0,35,9,10,1
"0680571d4698477995e41842c36a54b2","0680571d4698477995e41842c36a54b2",5638709,1,0,1,36,10,10,0
"0680571d4698477995e41842c36a54b2","9112f2bffece48e08c6d2287be204085",5638709,1,1,0,37,10,11,1
"9112f2bffece48e08c6d2287be204085","9112f2bffece48e08c6d2287be204085",5638709,1,0,1,38,11,11,0
"9112f2bffece48e08c6d2287be204085","e2911e79efc2420eac45d9f671463d4b",5638709,1,-9,0,39,11,2,-9
"e2911e79efc2420eac45d9f671463d4b","56586aa865414f538729c7f7735d2bc6",5638709,1,12,0,40,2,12,10
"56586aa865414f538729c7f7735d2bc6","56586aa865414f538729c7f7735d2bc6",5638709,3,0,1,41,12,12,0
"56586aa865414f538729c7f7735d2bc6","b7f2b31585d94eb3bf86376714aa7070",5638709,1,2,0,44,12,13,1
"b7f2b31585d94eb3bf86376714aa7070","b7f2b31585d94eb3bf86376714aa7070",5638709,3,0,1,45,13,13,0
"b7f2b31585d94eb3bf86376714aa7070","3f1c815879794b929260d224becaff7e",5638709,1,2,0,48,13,14,1
"3f1c815879794b929260d224becaff7e","0c7262dff33c4087bc660ccf40f92f9c",5638709,1,222,0,49,14,169,155
"0c7262dff33c4087bc660ccf40f92f9c","b2275c3fad834f8d90737a2d9a6927d6",5638709,1,3,0,50,169,172,3
"b2275c3fad834f8d90737a2d9a6927d6","362fcb0699a14845ab29b2340093e528",5638709,1,3,0,51,172,174,2
"362fcb0699a14845ab29b2340093e528","0c7262dff33c4087bc660ccf40f92f9c",5638709,1,-6,0,52,174,169,-5
"0c7262dff33c4087bc660ccf40f92f9c","b42cc17b7de840f181a704558d0bc845",5638709,1,7,0,53,169,175,6
"b42cc17b7de840f181a704558d0bc845","ea38cc0e6e6e41edbabf210220808bf9",5638709,1,5,0,54,175,179,4
"ea38cc0e6e6e41edbabf210220808bf9","362fcb0699a14845ab29b2340093e528",5638709,1,-6,0,55,179,174,-5
"362fcb0699a14845ab29b2340093e528","b87c552dd247427abe6ab5795b9c9d43",5638709,1,8,0,56,174,181,7
"67a089198fcb4e1c8f2385786c2b296f","e2911e79efc2420eac45d9f671463d4b",22854389,2,-69,0,1,39,2,-37
"e2911e79efc2420eac45d9f671463d4b","b613861cecf84ffcab01afb23f660475",22854389,1,-3,0,3,2,1,-1
"b613861cecf84ffcab01afb23f660475","b613861cecf84ffcab01afb23f660475",22854389,4,0,1,4,1,1,0
"b613861cecf84ffcab01afb23f660475","e2911e79efc2420eac45d9f671463d4b",22854389,1,3,0,8,1,2,1
"e2911e79efc2420eac45d9f671463d4b","e2911e79efc2420eac45d9f671463d4b",22854389,14,0,1,10,2,2,0
"e2911e79efc2420eac45d9f671463d4b","9112f2bffece48e08c6d2287be204085",22854389,2,9,0,11,2,11,9
"9112f2bffece48e08c6d2287be204085","9112f2bffece48e08c6d2287be204085",22854389,11,0,1,12,11,11,0
"9112f2bffece48e08c6d2287be204085","e2911e79efc2420eac45d9f671463d4b",22854389,2,-9,0,15,11,2,-9
"e2911e79efc2420eac45d9f671463d4b","519d1b8c59404d67b54e96c5c8a830b2",22854389,3,1,0,17,2,3,1
"519d1b8c59404d67b54e96c5c8a830b2","519d1b8c59404d67b54e96c5c8a830b2",22854389,2,0,1,18,3,3,0
"519d1b8c59404d67b54e96c5c8a830b2","531db53f81f646edb0cdcfe0085b03b7",22854389,2,1,0,19,3,4,1
"531db53f81f646edb0cdcfe0085b03b7","531db53f81f646edb0cdcfe0085b03b7",22854389,2,0,1,20,4,4,0
"531db53f81f646edb0cdcfe0085b03b7","4f5f94b2f95141e0a9d53a61da2276da",22854389,2,1,0,21,4,5,1
"4f5f94b2f95141e0a9d53a61da2276da","4f5f94b2f95141e0a9d53a61da2276da",22854389,2,0,1,22,5,5,0
"4f5f94b2f95141e0a9d53a61da2276da","6d541c89590949f99af293c4f2333f67",22854389,2,1,0,23,5,6,1
"6d541c89590949f99af293c4f2333f67","6d541c89590949f99af293c4f2333f67",22854389,2,0,1,24,6,6,0
"6d541c89590949f99af293c4f2333f67","dd5cf0b9fe4c4f1d8f5ff8e4c04879cb",22854389,2,1,0,25,6,7,1
"dd5cf0b9fe4c4f1d8f5ff8e4c04879cb","dd5cf0b9fe4c4f1d8f5ff8e4c04879cb",22854389,4,0,1,26,7,7,0
"dd5cf0b9fe4c4f1d8f5ff8e4c04879cb","56586aa865414f538729c7f7735d2bc6",22854389,1,7,0,27,7,12,5
"56586aa865414f538729c7f7735d2bc6","e2911e79efc2420eac45d9f671463d4b",22854389,3,-12,0,28,12,2,-10
"e2911e79efc2420eac45d9f671463d4b","56586aa865414f538729c7f7735d2bc6",22854389,3,12,0,29,2,12,10
"9afd71a5298d4333b6849dfce1b9422c","e2911e79efc2420eac45d9f671463d4b",22854389,1,-25,0,31,18,2,-16
"9112f2bffece48e08c6d2287be204085","dd5cf0b9fe4c4f1d8f5ff8e4c04879cb",22854389,1,-4,0,37,11,7,-4
"dd5cf0b9fe4c4f1d8f5ff8e4c04879cb","6d541c89590949f99af293c4f2333f67",22854389,1,-1,0,39,7,6,-1
"6d541c89590949f99af293c4f2333f67","4f5f94b2f95141e0a9d53a61da2276da",22854389,1,-1,0,41,6,5,-1
"4f5f94b2f95141e0a9d53a61da2276da","531db53f81f646edb0cdcfe0085b03b7",22854389,1,-1,0,43,5,4,-1
"531db53f81f646edb0cdcfe0085b03b7","e2911e79efc2420eac45d9f671463d4b",22854389,1,-2,0,45,4,2,-2
"dd5cf0b9fe4c4f1d8f5ff8e4c04879cb","9112f2bffece48e08c6d2287be204085",22854389,1,4,0,55,7,11,4
"e2911e79efc2420eac45d9f671463d4b","67a089198fcb4e1c8f2385786c2b296f",22854389,1,69,0,66,2,39,37
"519d1b8c59404d67b54e96c5c8a830b2","dd5cf0b9fe4c4f1d8f5ff8e4c04879cb",22854389,1,4,0,72,3,7,4
"dd5cf0b9fe4c4f1d8f5ff8e4c04879cb","f96261861edc426abe2248be4f0a709a",22854389,1,1,0,75,7,8,1
"f96261861edc426abe2248be4f0a709a","f96261861edc426abe2248be4f0a709a",22854389,1,0,1,76,8,8,0
"f96261861edc426abe2248be4f0a709a","9112f2bffece48e08c6d2287be204085",22854389,1,3,0,77,8,11,3
"9112f2bffece48e08c6d2287be204085","66b5e16f4f75454fb5b8172079f0fa83",22854389,1,-2,0,79,11,9,-2
"66b5e16f4f75454fb5b8172079f0fa83","66b5e16f4f75454fb5b8172079f0fa83",22854389,1,0,1,80,9,9,0
"66b5e16f4f75454fb5b8172079f0fa83","9112f2bffece48e08c6d2287be204085",22854389,1,2,0,81,9,11,2
"9112f2bffece48e08c6d2287be204085","0680571d4698477995e41842c36a54b2",22854389,1,-1,0,82,11,10,-1
"0680571d4698477995e41842c36a54b2","0680571d4698477995e41842c36a54b2",22854389,2,0,1,83,10,10,0
"0680571d4698477995e41842c36a54b2","f96261861edc426abe2248be4f0a709a",22854389,1,-2,0,85,10,8,-2
"f96261861edc426abe2248be4f0a709a","56586aa865414f538729c7f7735d2bc6",22854389,1,6,0,86,8,12,4
"56586aa865414f538729c7f7735d2bc6","56586aa865414f538729c7f7735d2bc6",22854389,3,0,1,89,12,12,0
"56586aa865414f538729c7f7735d2bc6","67a089198fcb4e1c8f2385786c2b296f",22854389,1,57,0,91,12,39,27
"64d48c6c9c7940639a932219a6c87198","56586aa865414f538729c7f7735d2bc6",22854389,1,-58,0,93,40,12,-28
"3f1c815879794b929260d224becaff7e","56586aa865414f538729c7f7735d2bc6",22854389,1,-4,0,98,14,12,-2
"56586aa865414f538729c7f7735d2bc6","81c864a886d54a6b8ff85f7d736f4f95",22854389,1,6,0,99,12,15,3
"81c864a886d54a6b8ff85f7d736f4f95","b7f2b31585d94eb3bf86376714aa7070",22854389,1,-4,0,100,15,13,-2
"b7f2b31585d94eb3bf86376714aa7070","56586aa865414f538729c7f7735d2bc6",22854389,1,-2,0,101,13,12,-1
"56586aa865414f538729c7f7735d2bc6","b7f2b31585d94eb3bf86376714aa7070",22854389,2,2,0,102,12,13,1
"b7f2b31585d94eb3bf86376714aa7070","b7f2b31585d94eb3bf86376714aa7070",22854389,2,0,1,103,13,13,0
"b7f2b31585d94eb3bf86376714aa7070","3f1c815879794b929260d224becaff7e",22854389,2,2,0,104,13,14,1
"3f1c815879794b929260d224becaff7e","5c5ceeee4562457ba6d41515aeebfbb1",22854389,1,6,0,105,14,17,3
"5c5ceeee4562457ba6d41515aeebfbb1","81c864a886d54a6b8ff85f7d736f4f95",22854389,1,-4,0,106,17,15,-2
"81c864a886d54a6b8ff85f7d736f4f95","5c5ceeee4562457ba6d41515aeebfbb1",22854389,1,4,0,107,15,17,2
"5c5ceeee4562457ba6d41515aeebfbb1","56586aa865414f538729c7f7735d2bc6",22854389,1,-10,0,108,17,12,-5
"56586aa865414f538729c7f7735d2bc6","9afd71a5298d4333b6849dfce1b9422c",22854389,2,13,0,109,12,18,6
"9afd71a5298d4333b6849dfce1b9422c","b7719e26494940efa49512aedd0aac79",22854389,1,4,0,110,18,20,2
"b7719e26494940efa49512aedd0aac79","9afd71a5298d4333b6849dfce1b9422c",22854389,1,-4,0,111,20,18,-2
"9afd71a5298d4333b6849dfce1b9422c","d4f45188d3c84a02ba08454e6403a818",22854389,1,9,0,112,18,24,6
"d4f45188d3c84a02ba08454e6403a818","d4c3b003e8274e429d2fa688d73fde6d",22854389,1,-2,0,113,24,22,-2
"d4c3b003e8274e429d2fa688d73fde6d","d4c3b003e8274e429d2fa688d73fde6d",22854389,1,0,1,114,22,22,0
"d4c3b003e8274e429d2fa688d73fde6d","5bc03c8f16354d04bd51f5bb93559ad3",22854389,1,4,0,115,22,26,4
"5bc03c8f16354d04bd51f5bb93559ad3","b7719e26494940efa49512aedd0aac79",22854389,1,-7,0,116,26,20,-6
"b7719e26494940efa49512aedd0aac79","afbf7250b99d47bea07172749483ca97",22854389,2,12,0,117,20,28,8
"afbf7250b99d47bea07172749483ca97","b7719e26494940efa49512aedd0aac79",22854389,1,-12,0,118,28,20,-8
"afbf7250b99d47bea07172749483ca97","4e51676dc72045d99c19b9fa7b22f8bc",22854389,1,3,0,120,28,29,1
"4e51676dc72045d99c19b9fa7b22f8bc","4e51676dc72045d99c19b9fa7b22f8bc",22854389,1,0,1,121,29,29,0
"4e51676dc72045d99c19b9fa7b22f8bc","51970cfa30e643e894e66ae85c8024cc",22854389,1,3,0,122,29,31,2
"51970cfa30e643e894e66ae85c8024cc","4e51676dc72045d99c19b9fa7b22f8bc",22854389,1,-3,0,123,31,29,-2
"4e51676dc72045d99c19b9fa7b22f8bc","c33c17be71ae4d588da7369472e5bb1b",22854389,1,9,0,124,29,34,5
"c33c17be71ae4d588da7369472e5bb1b","93679be414554a11b1893002f2229a93",22854389,2,3,0,125,34,35,1
"93679be414554a11b1893002f2229a93","c33c17be71ae4d588da7369472e5bb1b",22854389,1,-3,0,126,35,34,-1
"93679be414554a11b1893002f2229a93","7040a13096d746ac84b8fac8d9752058",22854389,1,3,0,128,35,36,1
"7040a13096d746ac84b8fac8d9752058","7040a13096d746ac84b8fac8d9752058",22854389,1,0,1,129,36,36,0
"7040a13096d746ac84b8fac8d9752058","9a0dc646f934470daf08c4b56ccf73db",22854389,1,3,0,130,36,37,1
"9a0dc646f934470daf08c4b56ccf73db","9a0dc646f934470daf08c4b56ccf73db",22854389,1,0,1,131,37,37,0
"9a0dc646f934470daf08c4b56ccf73db","fc0e049d56024bc9a02c9a9c435c3df7",22854389,1,3,0,132,37,38,1
"fc0e049d56024bc9a02c9a9c435c3df7","67a089198fcb4e1c8f2385786c2b296f",22854389,1,4,0,133,38,39,1
"67a089198fcb4e1c8f2385786c2b296f","fc0e049d56024bc9a02c9a9c435c3df7",22854389,1,-4,0,134,39,38,-1
"fc0e049d56024bc9a02c9a9c435c3df7","64d48c6c9c7940639a932219a6c87198",22854389,1,5,0,135,38,40,2
"64d48c6c9c7940639a932219a6c87198","64d48c6c9c7940639a932219a6c87198",22854389,3,0,1,136,40,40,0
"64d48c6c9c7940639a932219a6c87198","67a089198fcb4e1c8f2385786c2b296f",22854389,2,-1,0,138,40,39,-1
"67a089198fcb4e1c8f2385786c2b296f","64d48c6c9c7940639a932219a6c87198",22854389,3,1,0,139,39,40,1
"64d48c6c9c7940639a932219a6c87198","b534b89233134e30a9b5645138bfa9ee",22854389,1,3,0,140,40,41,1
"b534b89233134e30a9b5645138bfa9ee","67a089198fcb4e1c8f2385786c2b296f",22854389,1,-4,0,141,41,39,-2
"67a089198fcb4e1c8f2385786c2b296f","67a089198fcb4e1c8f2385786c2b296f",22854389,1,0,1,142,39,39,0
"67a089198fcb4e1c8f2385786c2b296f","b534b89233134e30a9b5645138bfa9ee",22854389,1,4,0,146,39,41,2
"b534b89233134e30a9b5645138bfa9ee","0e37b720d23b4e7f8b313e79313fd107",22854389,1,3,0,147,41,44,3
"0e37b720d23b4e7f8b313e79313fd107","0e37b720d23b4e7f8b313e79313fd107",22854389,1,0,1,148,44,44,0
"0e37b720d23b4e7f8b313e79313fd107","6875d67fdd5f48168b62719df449bebd",22854389,1,1,0,149,44,45,1
"6875d67fdd5f48168b62719df449bebd","6875d67fdd5f48168b62719df449bebd",22854389,1,0,1,150,45,45,0
"6875d67fdd5f48168b62719df449bebd","6e13d61a7bdb44bca949c9f86fab3be5",22854389,1,3,0,151,45,47,2
"6e13d61a7bdb44bca949c9f86fab3be5","b534b89233134e30a9b5645138bfa9ee",22854389,1,-7,0,152,47,41,-6
"b534b89233134e30a9b5645138bfa9ee","6e13d61a7bdb44bca949c9f86fab3be5",22854389,1,7,0,153,41,47,6
"6e13d61a7bdb44bca949c9f86fab3be5","6e13d61a7bdb44bca949c9f86fab3be5",22854389,1,0,1,154,47,47,0
"6e13d61a7bdb44bca949c9f86fab3be5","195f78799f984cc2b06c48dfe36be751",22854389,1,2,0,155,47,49,2
"195f78799f984cc2b06c48dfe36be751","195f78799f984cc2b06c48dfe36be751",22854389,2,0,1,156,49,49,0
"195f78799f984cc2b06c48dfe36be751","d9c8d8c444a64dadbbb508652c721e17",22854389,1,-3,0,158,49,46,-3
"d9c8d8c444a64dadbbb508652c721e17","d0c74f735e024943943e40333d6d337f",22854389,1,6,0,159,46,51,5
"d0c74f735e024943943e40333d6d337f","d0c74f735e024943943e40333d6d337f",22854389,2,0,1,160,51,51,0
"d0c74f735e024943943e40333d6d337f","983f8ff320594b279a7f4a6fe132f9c5",22854389,1,2,0,162,51,53,2
"983f8ff320594b279a7f4a6fe132f9c5","983f8ff320594b279a7f4a6fe132f9c5",22854389,5,0,1,163,53,53,0
"983f8ff320594b279a7f4a6fe132f9c5","35adfa5d923046aebabfefd98f35ff05",22854389,1,1,0,168,53,54,1
"35adfa5d923046aebabfefd98f35ff05","35adfa5d923046aebabfefd98f35ff05",22854389,2,0,1,169,54,54,0
"35adfa5d923046aebabfefd98f35ff05","b6f8a98476224da1b40e555ececc7ed8",22854389,1,1,0,171,54,55,1
"b6f8a98476224da1b40e555ececc7ed8","b6f8a98476224da1b40e555ececc7ed8",22854389,2,0,1,172,55,55,0
"b6f8a98476224da1b40e555ececc7ed8","86e22cb5fe0e4b47a9489ecddf7ed78f",22854389,1,1,0,174,55,56,1
"86e22cb5fe0e4b47a9489ecddf7ed78f","86e22cb5fe0e4b47a9489ecddf7ed78f",22854389,2,0,1,175,56,56,0
"86e22cb5fe0e4b47a9489ecddf7ed78f","f924752d8a1149668870b1e7698486f7",22854389,1,-6,0,177,56,50,-6
"f924752d8a1149668870b1e7698486f7","78f30e4dcac84e3cbea8b2cc6e0d62b3",22854389,1,10,0,178,50,59,9
"78f30e4dcac84e3cbea8b2cc6e0d62b3","a1f2f12debe5432fb7a70bcd12bacfb9",22854389,1,-1,0,179,59,58,-1
"a1f2f12debe5432fb7a70bcd12bacfb9","a1f2f12debe5432fb7a70bcd12bacfb9",22854389,11,0,1,180,58,58,0
"a1f2f12debe5432fb7a70bcd12bacfb9","78f30e4dcac84e3cbea8b2cc6e0d62b3",22854389,1,1,0,191,58,59,1
"78f30e4dcac84e3cbea8b2cc6e0d62b3","78f30e4dcac84e3cbea8b2cc6e0d62b3",22854389,11,0,1,192,59,59,0
"78f30e4dcac84e3cbea8b2cc6e0d62b3","12aa6e1672ac4e7aa6449a7a8609cd72",22854389,1,-2,0,203,59,57,-2
"12aa6e1672ac4e7aa6449a7a8609cd72","a0a418b8540d479fa6e0f653b701da8b",22854389,1,8,0,204,57,64,7
"a0a418b8540d479fa6e0f653b701da8b","bc42d26810654ea9a1df1efe1e58c7d5",22854389,1,-1,0,205,64,63,-1
"bc42d26810654ea9a1df1efe1e58c7d5","bc42d26810654ea9a1df1efe1e58c7d5",22854389,4,0,1,206,63,63,0
"bc42d26810654ea9a1df1efe1e58c7d5","a0a418b8540d479fa6e0f653b701da8b",22854389,1,1,0,210,63,64,1
"a0a418b8540d479fa6e0f653b701da8b","a0a418b8540d479fa6e0f653b701da8b",22854389,3,0,1,211,64,64,0
"a0a418b8540d479fa6e0f653b701da8b","4c943503763e4e349906eea3ed3c8e86",22854389,1,-3,0,214,64,61,-3
"4c943503763e4e349906eea3ed3c8e86","4c943503763e4e349906eea3ed3c8e86",22854389,1,0,1,215,61,61,0
"4c943503763e4e349906eea3ed3c8e86","309ccf3cc4fe429d9bfbaef53d3fa479",22854389,1,-1,0,216,61,60,-1
"309ccf3cc4fe429d9bfbaef53d3fa479","d646286c8051419bbc2e31dd1db55ca8",22854389,1,10,0,217,60,67,7
"d646286c8051419bbc2e31dd1db55ca8","b534b89233134e30a9b5645138bfa9ee",22854389,1,-33,0,218,67,41,-26
"b613861cecf84ffcab01afb23f660475","b613861cecf84ffcab01afb23f660475",22855575,3,0,1,1,1,1,0
"b613861cecf84ffcab01afb23f660475","e2911e79efc2420eac45d9f671463d4b",22855575,2,3,0,4,1,2,1
"e2911e79efc2420eac45d9f671463d4b","b613861cecf84ffcab01afb23f660475",22855575,1,-3,0,5,2,1,-1
"e2911e79efc2420eac45d9f671463d4b","e2911e79efc2420eac45d9f671463d4b",22855575,2,0,1,7,2,2,0
"e2911e79efc2420eac45d9f671463d4b","519d1b8c59404d67b54e96c5c8a830b2",22855575,1,1,0,9,2,3,1
"519d1b8c59404d67b54e96c5c8a830b2","519d1b8c59404d67b54e96c5c8a830b2",22855575,1,0,1,10,3,3,0
"519d1b8c59404d67b54e96c5c8a830b2","531db53f81f646edb0cdcfe0085b03b7",22855575,1,1,0,11,3,4,1
"531db53f81f646edb0cdcfe0085b03b7","531db53f81f646edb0cdcfe0085b03b7",22855575,1,0,1,12,4,4,0
"531db53f81f646edb0cdcfe0085b03b7","4f5f94b2f95141e0a9d53a61da2276da",22855575,1,1,0,13,4,5,1
"4f5f94b2f95141e0a9d53a61da2276da","4f5f94b2f95141e0a9d53a61da2276da",22855575,1,0,1,14,5,5,0
"4f5f94b2f95141e0a9d53a61da2276da","6d541c89590949f99af293c4f2333f67",22855575,1,1,0,15,5,6,1
"6d541c89590949f99af293c4f2333f67","6d541c89590949f99af293c4f2333f67",22855575,1,0,1,16,6,6,0
"6d541c89590949f99af293c4f2333f67","dd5cf0b9fe4c4f1d8f5ff8e4c04879cb",22855575,1,1,0,17,6,7,1
"dd5cf0b9fe4c4f1d8f5ff8e4c04879cb","dd5cf0b9fe4c4f1d8f5ff8e4c04879cb",22855575,2,0,1,18,7,7,0
"dd5cf0b9fe4c4f1d8f5ff8e4c04879cb","f96261861edc426abe2248be4f0a709a",22855575,1,1,0,20,7,8,1
"f96261861edc426abe2248be4f0a709a","f96261861edc426abe2248be4f0a709a",22855575,2,0,1,21,8,8,0
"f96261861edc426abe2248be4f0a709a","66b5e16f4f75454fb5b8172079f0fa83",22855575,1,1,0,23,8,9,1
"66b5e16f4f75454fb5b8172079f0fa83","66b5e16f4f75454fb5b8172079f0fa83",22855575,1,0,1,24,9,9,0
"66b5e16f4f75454fb5b8172079f0fa83","0680571d4698477995e41842c36a54b2",22855575,1,1,0,25,9,10,1
"0680571d4698477995e41842c36a54b2","0680571d4698477995e41842c36a54b2",22855575,2,0,1,26,10,10,0
"0680571d4698477995e41842c36a54b2","9112f2bffece48e08c6d2287be204085",22855575,1,1,0,28,10,11,1
"9112f2bffece48e08c6d2287be204085","9112f2bffece48e08c6d2287be204085",22855575,2,0,1,29,11,11,0
"9112f2bffece48e08c6d2287be204085","56586aa865414f538729c7f7735d2bc6",22855575,1,3,0,31,11,12,1
"56586aa865414f538729c7f7735d2bc6","e2911e79efc2420eac45d9f671463d4b",22855575,1,-12,0,32,12,2,-10
"e2911e79efc2420eac45d9f671463d4b","56586aa865414f538729c7f7735d2bc6",22855575,1,12,0,33,2,12,10
"56586aa865414f538729c7f7735d2bc6","56586aa865414f538729c7f7735d2bc6",22855575,1,0,1,34,12,12,0
"56586aa865414f538729c7f7735d2bc6","b7f2b31585d94eb3bf86376714aa7070",22855575,2,2,0,35,12,13,1
"b7f2b31585d94eb3bf86376714aa7070","56586aa865414f538729c7f7735d2bc6",22855575,1,-2,0,36,13,12,-1
"b7f2b31585d94eb3bf86376714aa7070","b7f2b31585d94eb3bf86376714aa7070",22855575,1,0,1,38,13,13,0
"b7f2b31585d94eb3bf86376714aa7070","3f1c815879794b929260d224becaff7e",22855575,1,2,0,39,13,14,1
"3f1c815879794b929260d224becaff7e","81c864a886d54a6b8ff85f7d736f4f95",22855575,1,2,0,40,14,15,1
"81c864a886d54a6b8ff85f7d736f4f95","5c5ceeee4562457ba6d41515aeebfbb1",22855575,1,4,0,41,15,17,2
"5c5ceeee4562457ba6d41515aeebfbb1","5c5ceeee4562457ba6d41515aeebfbb1",22855575,1,0,1,42,17,17,0
"5c5ceeee4562457ba6d41515aeebfbb1","56586aa865414f538729c7f7735d2bc6",22855575,1,-10,0,43,17,12,-5
"56586aa865414f538729c7f7735d2bc6","9afd71a5298d4333b6849dfce1b9422c",22855575,1,13,0,44,12,18,6
"9afd71a5298d4333b6849dfce1b9422c","9afd71a5298d4333b6849dfce1b9422c",22855575,1,0,1,45,18,18,0
"9afd71a5298d4333b6849dfce1b9422c","b7719e26494940efa49512aedd0aac79",22855575,1,4,0,46,18,20,2
"b7719e26494940efa49512aedd0aac79","d4f45188d3c84a02ba08454e6403a818",22855575,1,5,0,47,20,24,4
"d4f45188d3c84a02ba08454e6403a818","d4c3b003e8274e429d2fa688d73fde6d",22855575,1,-2,0,48,24,22,-2
"d4c3b003e8274e429d2fa688d73fde6d","d4c3b003e8274e429d2fa688d73fde6d",22855575,1,0,1,49,22,22,0
"d4c3b003e8274e429d2fa688d73fde6d","b7719e26494940efa49512aedd0aac79",22855575,1,-3,0,50,22,20,-2
"b7719e26494940efa49512aedd0aac79","afbf7250b99d47bea07172749483ca97",22855575,1,12,0,51,20,28,8
"afbf7250b99d47bea07172749483ca97","b7719e26494940efa49512aedd0aac79",22855575,1,-12,0,52,28,20,-8
"b7719e26494940efa49512aedd0aac79","4e51676dc72045d99c19b9fa7b22f8bc",22855575,1,15,0,53,20,29,9
"4e51676dc72045d99c19b9fa7b22f8bc","afbf7250b99d47bea07172749483ca97",22855575,1,-3,0,54,29,28,-1
"afbf7250b99d47bea07172749483ca97","4e51676dc72045d99c19b9fa7b22f8bc",22855575,1,3,0,55,28,29,1
"4e51676dc72045d99c19b9fa7b22f8bc","51970cfa30e643e894e66ae85c8024cc",22855575,1,3,0,56,29,31,2
"51970cfa30e643e894e66ae85c8024cc","c33c17be71ae4d588da7369472e5bb1b",22855575,1,6,0,57,31,34,3
"c33c17be71ae4d588da7369472e5bb1b","4e51676dc72045d99c19b9fa7b22f8bc",22855575,1,-9,0,58,34,29,-5
"4e51676dc72045d99c19b9fa7b22f8bc","c33c17be71ae4d588da7369472e5bb1b",22855575,1,9,0,59,29,34,5
"c33c17be71ae4d588da7369472e5bb1b","93679be414554a11b1893002f2229a93",22855575,1,3,0,60,34,35,1
"93679be414554a11b1893002f2229a93","93679be414554a11b1893002f2229a93",22855575,1,0,1,61,35,35,0
"93679be414554a11b1893002f2229a93","7040a13096d746ac84b8fac8d9752058",22855575,1,3,0,62,35,36,1
"7040a13096d746ac84b8fac8d9752058","9a0dc646f934470daf08c4b56ccf73db",22855575,1,3,0,63,36,37,1
"9a0dc646f934470daf08c4b56ccf73db","7040a13096d746ac84b8fac8d9752058",22855575,1,-3,0,64,37,36,-1
"7040a13096d746ac84b8fac8d9752058","fc0e049d56024bc9a02c9a9c435c3df7",22855575,1,6,0,65,36,38,2
"fc0e049d56024bc9a02c9a9c435c3df7","9a0dc646f934470daf08c4b56ccf73db",22855575,1,-3,0,66,38,37,-1
"9a0dc646f934470daf08c4b56ccf73db","67a089198fcb4e1c8f2385786c2b296f",22855575,1,7,0,67,37,39,2
"67a089198fcb4e1c8f2385786c2b296f","64d48c6c9c7940639a932219a6c87198",22855575,1,1,0,68,39,40,1
"64d48c6c9c7940639a932219a6c87198","64d48c6c9c7940639a932219a6c87198",22855575,1,0,1,69,40,40,0
"64d48c6c9c7940639a932219a6c87198","67a089198fcb4e1c8f2385786c2b296f",22855575,1,-1,0,70,40,39,-1
"67a089198fcb4e1c8f2385786c2b296f","b534b89233134e30a9b5645138bfa9ee",22855575,1,4,0,71,39,41,2
"b534b89233134e30a9b5645138bfa9ee","0e37b720d23b4e7f8b313e79313fd107",22855575,1,3,0,72,41,44,3
"0e37b720d23b4e7f8b313e79313fd107","0e37b720d23b4e7f8b313e79313fd107",22855575,1,0,1,73,44,44,0
"0e37b720d23b4e7f8b313e79313fd107","6875d67fdd5f48168b62719df449bebd",22855575,1,1,0,74,44,45,1
"6875d67fdd5f48168b62719df449bebd","6875d67fdd5f48168b62719df449bebd",22855575,1,0,1,75,45,45,0
"6875d67fdd5f48168b62719df449bebd","6e13d61a7bdb44bca949c9f86fab3be5",22855575,1,3,0,76,45,47,2
"6e13d61a7bdb44bca949c9f86fab3be5","b534b89233134e30a9b5645138bfa9ee",22855575,1,-7,0,77,47,41,-6
"b534b89233134e30a9b5645138bfa9ee","6e13d61a7bdb44bca949c9f86fab3be5",22855575,1,7,0,78,41,47,6
"6e13d61a7bdb44bca949c9f86fab3be5","d9c8d8c444a64dadbbb508652c721e17",22855575,1,-1,0,79,47,46,-1
"d9c8d8c444a64dadbbb508652c721e17","d0c74f735e024943943e40333d6d337f",22855575,1,6,0,80,46,51,5
"d0c74f735e024943943e40333d6d337f","d0c74f735e024943943e40333d6d337f",22855575,1,0,1,81,51,51,0
"d0c74f735e024943943e40333d6d337f","f924752d8a1149668870b1e7698486f7",22855575,1,-1,0,82,51,50,-1
"f924752d8a1149668870b1e7698486f7","a1f2f12debe5432fb7a70bcd12bacfb9",22855575,1,9,0,83,50,58,8
"78f30e4dcac84e3cbea8b2cc6e0d62b3","a1f2f12debe5432fb7a70bcd12bacfb9",22855575,1,-1,0,85,59,58,-1
"a1f2f12debe5432fb7a70bcd12bacfb9","a1f2f12debe5432fb7a70bcd12bacfb9",22855575,17,0,1,100,58,58,0
"a1f2f12debe5432fb7a70bcd12bacfb9","78f30e4dcac84e3cbea8b2cc6e0d62b3",22855575,2,1,0,103,58,59,1
"78f30e4dcac84e3cbea8b2cc6e0d62b3","78f30e4dcac84e3cbea8b2cc6e0d62b3",22855575,7,0,1,104,59,59,0
"78f30e4dcac84e3cbea8b2cc6e0d62b3","12aa6e1672ac4e7aa6449a7a8609cd72",22855575,1,-2,0,111,59,57,-2
"12aa6e1672ac4e7aa6449a7a8609cd72","bc42d26810654ea9a1df1efe1e58c7d5",22855575,1,7,0,112,57,63,6
"bc42d26810654ea9a1df1efe1e58c7d5","a0a418b8540d479fa6e0f653b701da8b",22855575,1,1,0,113,63,64,1
"a0a418b8540d479fa6e0f653b701da8b","4c943503763e4e349906eea3ed3c8e86",22855575,1,-3,0,114,64,61,-3
"4c943503763e4e349906eea3ed3c8e86","4c943503763e4e349906eea3ed3c8e86",22855575,1,0,1,115,61,61,0
"4c943503763e4e349906eea3ed3c8e86","309ccf3cc4fe429d9bfbaef53d3fa479",22855575,1,-1,0,116,61,60,-1
"309ccf3cc4fe429d9bfbaef53d3fa479","b534b89233134e30a9b5645138bfa9ee",22855575,1,-23,0,117,60,41,-19
"b534b89233134e30a9b5645138bfa9ee","d646286c8051419bbc2e31dd1db55ca8",22855575,1,33,0,118,41,67,26
"d646286c8051419bbc2e31dd1db55ca8","267f883678b24aed855fde42524975d9",22855575,1,4,0,119,67,71,4
"267f883678b24aed855fde42524975d9","267f883678b24aed855fde42524975d9",22855575,1,0,1,120,71,71,0
"267f883678b24aed855fde42524975d9","88fff56d0342490dbef9040750a20f6c",22855575,1,1,0,121,71,72,1
"88fff56d0342490dbef9040750a20f6c","88fff56d0342490dbef9040750a20f6c",22855575,1,0,1,122,72,72,0
"88fff56d0342490dbef9040750a20f6c","adb17b12b66c4a49a85fd34322f7df70",22855575,1,1,0,123,72,73,1
"adb17b12b66c4a49a85fd34322f7df70","adb17b12b66c4a49a85fd34322f7df70",22855575,1,0,1,124,73,73,0
"adb17b12b66c4a49a85fd34322f7df70","d646286c8051419bbc2e31dd1db55ca8",22855575,1,-6,0,125,73,67,-6
"d646286c8051419bbc2e31dd1db55ca8","a2becd407db34b189200a32546d9d569",22855575,2,9,0,126,67,75,8
"a2becd407db34b189200a32546d9d569","a2becd407db34b189200a32546d9d569",22855575,1,0,1,127,75,75,0
"a2becd407db34b189200a32546d9d569","140d5b27b8574befad82c0a013b59dfa",22855575,2,-1,0,128,75,74,-1
"140d5b27b8574befad82c0a013b59dfa","d18a9ea32855445f8736581f5cb119ce",22855575,1,9,0,129,74,82,8
"d18a9ea32855445f8736581f5cb119ce","f564483cbd7a407681aa2fcca518cf5f",22855575,1,4,0,130,82,85,3
"f564483cbd7a407681aa2fcca518cf5f","f564483cbd7a407681aa2fcca518cf5f",22855575,10,0,1,131,85,85,0
"f564483cbd7a407681aa2fcca518cf5f","18fd01350bd5434ca636d59a599d768a",22855575,1,1,0,141,85,86,1
"18fd01350bd5434ca636d59a599d768a","18fd01350bd5434ca636d59a599d768a",22855575,9,0,1,142,86,86,0
"18fd01350bd5434ca636d59a599d768a","ae5ac430ea254e708a6f5deaaf7464ae",22855575,1,-2,0,151,86,84,-2
"ae5ac430ea254e708a6f5deaaf7464ae","6a9f0ef185fb47f0937e29daa1c71ed5",22855575,1,7,0,152,84,90,6
"6a9f0ef185fb47f0937e29daa1c71ed5","c681290961c94c4caf23b529d1ae6b9a",22855575,1,-2,0,153,90,88,-2
"c681290961c94c4caf23b529d1ae6b9a","c681290961c94c4caf23b529d1ae6b9a",22855575,1,0,1,154,88,88,0
"c681290961c94c4caf23b529d1ae6b9a","e20db35ced8544ddac5bc3839145e463",22855575,1,5,0,155,88,91,3
"e20db35ced8544ddac5bc3839145e463","d646286c8051419bbc2e31dd1db55ca8",22855575,1,-30,0,156,91,67,-24
"d646286c8051419bbc2e31dd1db55ca8","1febb706d7a34005ae8711ed49c76e64",22855575,1,33,0,157,67,94,27
"1febb706d7a34005ae8711ed49c76e64","1febb706d7a34005ae8711ed49c76e64",22855575,2,0,1,158,94,94,0
"1febb706d7a34005ae8711ed49c76e64","8f73ba6f5a0042f2850356ac38ac6f24",22855575,1,1,0,160,94,95,1
"8f73ba6f5a0042f2850356ac38ac6f24","8f73ba6f5a0042f2850356ac38ac6f24",22855575,5,0,1,161,95,95,0
"8f73ba6f5a0042f2850356ac38ac6f24","e2260b86653c46d7b14a41fb419dbf8c",22855575,1,1,0,166,95,96,1
"e2260b86653c46d7b14a41fb419dbf8c","e2260b86653c46d7b14a41fb419dbf8c",22855575,2,0,1,167,96,96,0
"e2260b86653c46d7b14a41fb419dbf8c","35eb641ad1d845bbba54915bce75a962",22855575,1,1,0,169,96,97,1
"35eb641ad1d845bbba54915bce75a962","35eb641ad1d845bbba54915bce75a962",22855575,2,0,1,170,97,97,0
"35eb641ad1d845bbba54915bce75a962","08be90ffbeea4795a138cd42ed8db56f",22855575,1,1,0,172,97,98,1
"08be90ffbeea4795a138cd42ed8db56f","08be90ffbeea4795a138cd42ed8db56f",22855575,5,0,1,173,98,98,0
"08be90ffbeea4795a138cd42ed8db56f","3007433c8f584dcbb5ac159c1c5f2be3",22855575,1,1,0,178,98,99,1
"3007433c8f584dcbb5ac159c1c5f2be3","3007433c8f584dcbb5ac159c1c5f2be3",22855575,5,0,1,179,99,99,0
"3007433c8f584dcbb5ac159c1c5f2be3","e20db35ced8544ddac5bc3839145e463",22855575,1,-8,0,184,99,91,-8
"e20db35ced8544ddac5bc3839145e463","00ae5f0c51874a73a41ebea838d95682",22855575,3,11,0,185,91,101,10
"00ae5f0c51874a73a41ebea838d95682","d391c8b6e56a43a7b654e9dee02d904b",22855575,3,2,0,186,101,103,2
"d391c8b6e56a43a7b654e9dee02d904b","00ae5f0c51874a73a41ebea838d95682",22855575,2,-2,0,187,103,101,-2
"00ae5f0c51874a73a41ebea838d95682","4280927ec4d643238aa49c32f9e06c6c",22855575,1,9,0,188,101,109,8
"4280927ec4d643238aa49c32f9e06c6c","73039f8c1eb9409cb4caee2cf968001e",22855575,1,-10,0,189,109,100,-9
"73039f8c1eb9409cb4caee2cf968001e","4280927ec4d643238aa49c32f9e06c6c",22855575,3,10,0,190,100,109,9
"4280927ec4d643238aa49c32f9e06c6c","08111f75e22d409998cf8b85bd431f0a",22855575,1,-1,0,191,109,108,-1
"08111f75e22d409998cf8b85bd431f0a","a9ae0a3c070d455bb4369a8996313336",22855575,2,7,0,192,108,114,6
"a9ae0a3c070d455bb4369a8996313336","a9ae0a3c070d455bb4369a8996313336",22855575,1,0,1,193,114,114,0
"a9ae0a3c070d455bb4369a8996313336","71cec822bcff4f30a20e75dc63ef7b65",22855575,1,2,0,194,114,116,2
"71cec822bcff4f30a20e75dc63ef7b65","71cec822bcff4f30a20e75dc63ef7b65",22855575,5,0,1,195,116,116,0
"71cec822bcff4f30a20e75dc63ef7b65","37319e88176d4aefa91d7a9980dbae91",22855575,1,-4,0,200,116,112,-4
"37319e88176d4aefa91d7a9980dbae91","62bff51286ef4f348717a3cf6fe2318f",22855575,2,9,0,201,112,120,8
"62bff51286ef4f348717a3cf6fe2318f","b1cd0e7dc3ad4a8eb91a4bfdbeb025b0",22855575,1,-2,0,202,120,118,-2
"b1cd0e7dc3ad4a8eb91a4bfdbeb025b0","b1cd0e7dc3ad4a8eb91a4bfdbeb025b0",22855575,1,0,1,203,118,118,0
"b1cd0e7dc3ad4a8eb91a4bfdbeb025b0","62bff51286ef4f348717a3cf6fe2318f",22855575,1,2,0,204,118,120,2
"62bff51286ef4f348717a3cf6fe2318f","62bff51286ef4f348717a3cf6fe2318f",22855575,5,0,1,205,120,120,0
"62bff51286ef4f348717a3cf6fe2318f","779f9ddd1fd14d1e9e69f72219a1fdbd",22855575,1,3,0,208,120,121,1
"779f9ddd1fd14d1e9e69f72219a1fdbd","e20db35ced8544ddac5bc3839145e463",22855575,1,-36,0,209,121,91,-30
"e20db35ced8544ddac5bc3839145e463","ae26e6cda8ad4a3f81bd347560d9579f",22855575,1,40,0,210,91,125,34
"ae26e6cda8ad4a3f81bd347560d9579f","ae26e6cda8ad4a3f81bd347560d9579f",22855575,3,0,1,211,125,125,0
"ae26e6cda8ad4a3f81bd347560d9579f","ee48df95832b4374aa273ceb27ec1315",22855575,1,1,0,214,125,126,1
"ee48df95832b4374aa273ceb27ec1315","ee48df95832b4374aa273ceb27ec1315",22855575,1,0,1,215,126,126,0
"ee48df95832b4374aa273ceb27ec1315","7a439da90b394756ad1777fc4c6dead5",22855575,1,1,0,216,126,127,1
"7a439da90b394756ad1777fc4c6dead5","7a439da90b394756ad1777fc4c6dead5",22855575,1,0,1,217,127,127,0
"7a439da90b394756ad1777fc4c6dead5","779f9ddd1fd14d1e9e69f72219a1fdbd",22855575,1,-6,0,218,127,121,-6
"779f9ddd1fd14d1e9e69f72219a1fdbd","a8dd5213034441ac92724b4e83eb0bb2",22855575,2,9,0,219,121,129,8
"a8dd5213034441ac92724b4e83eb0bb2","a8dd5213034441ac92724b4e83eb0bb2",22855575,1,0,1,220,129,129,0
"a8dd5213034441ac92724b4e83eb0bb2","8115eab6556b45f5b415c3b8c26a12e5",22855575,1,2,0,221,129,131,2
"8115eab6556b45f5b415c3b8c26a12e5","8115eab6556b45f5b415c3b8c26a12e5",22855575,8,0,1,222,131,131,0
"8115eab6556b45f5b415c3b8c26a12e5","ec34b06efd844b46a4c4818ecdb9b8f4",22855575,1,1,0,230,131,132,1
"ec34b06efd844b46a4c4818ecdb9b8f4","ec34b06efd844b46a4c4818ecdb9b8f4",22855575,5,0,1,231,132,132,0
"ec34b06efd844b46a4c4818ecdb9b8f4","c2e1c2b9eac64109b343a088584b576b",22855575,1,1,0,236,132,133,1
"c2e1c2b9eac64109b343a088584b576b","c2e1c2b9eac64109b343a088584b576b",22855575,2,0,1,237,133,133,0
"c2e1c2b9eac64109b343a088584b576b","579338175e0b4bbb8ef3b712b5d8b54e",22855575,1,-5,0,239,133,128,-5
"579338175e0b4bbb8ef3b712b5d8b54e","8bc5795d6a984a3eace4e2811e52dd4f",22855575,1,8,0,240,128,135,7
"8bc5795d6a984a3eace4e2811e52dd4f","8bc5795d6a984a3eace4e2811e52dd4f",22855575,1,0,1,241,135,135,0
"8bc5795d6a984a3eace4e2811e52dd4f","b416d47c56a742199b5d7c7f19d6503a",22855575,1,-1,0,242,135,134,-1
"b416d47c56a742199b5d7c7f19d6503a","cd4532ad48034873ba8bce2aac0c9808",22855575,1,4,0,243,134,137,3
"cd4532ad48034873ba8bce2aac0c9808","cd4532ad48034873ba8bce2aac0c9808",22855575,1,0,1,244,137,137,0
"cd4532ad48034873ba8bce2aac0c9808","779f9ddd1fd14d1e9e69f72219a1fdbd",22855575,1,-19,0,245,137,121,-16
"779f9ddd1fd14d1e9e69f72219a1fdbd","df1de691dafe4549a18a4398ee9dfaf9",22855575,1,23,0,246,121,139,18
"df1de691dafe4549a18a4398ee9dfaf9","6c5ad271a44743479bfaea29b1db8d02",22855575,1,4,0,247,139,143,4
"6c5ad271a44743479bfaea29b1db8d02","6c5ad271a44743479bfaea29b1db8d02",22855575,1,0,1,248,143,143,0
"6c5ad271a44743479bfaea29b1db8d02","83d311bed5374fee83d8d67a7d9d82dc",22855575,1,1,0,249,143,144,1
"83d311bed5374fee83d8d67a7d9d82dc","83d311bed5374fee83d8d67a7d9d82dc",22855575,3,0,1,250,144,144,0
"83d311bed5374fee83d8d67a7d9d82dc","402bba41861d43acb52a5abb89e8831e",22855575,1,1,0,253,144,145,1
"402bba41861d43acb52a5abb89e8831e","402bba41861d43acb52a5abb89e8831e",22855575,2,0,1,254,145,145,0
"402bba41861d43acb52a5abb89e8831e","df1de691dafe4549a18a4398ee9dfaf9",22855575,1,-6,0,256,145,139,-6
"df1de691dafe4549a18a4398ee9dfaf9","8aae34f5ddbb4052a709b12e6b0d40fa",22855575,1,9,0,257,139,147,8
"8aae34f5ddbb4052a709b12e6b0d40fa","8aae34f5ddbb4052a709b12e6b0d40fa",22855575,1,0,1,258,147,147,0
"8aae34f5ddbb4052a709b12e6b0d40fa","645b3f0249f64f76af2e19eb4d0e55b7",22855575,1,2,0,259,147,149,2
"645b3f0249f64f76af2e19eb4d0e55b7","645b3f0249f64f76af2e19eb4d0e55b7",22855575,5,0,1,260,149,149,0
"645b3f0249f64f76af2e19eb4d0e55b7","7e7b8db5064d4369805ab370aac5ddfb",22855575,1,1,0,265,149,150,1
"7e7b8db5064d4369805ab370aac5ddfb","7e7b8db5064d4369805ab370aac5ddfb",22855575,5,0,1,266,150,150,0
"7e7b8db5064d4369805ab370aac5ddfb","8956d210ae7f41968fada86d4c979d6a",22855575,1,1,0,271,150,151,1
"8956d210ae7f41968fada86d4c979d6a","8956d210ae7f41968fada86d4c979d6a",22855575,5,0,1,272,151,151,0
"8956d210ae7f41968fada86d4c979d6a","f902b0f41b544d4dbf79664fd233648d",22855575,1,-5,0,277,151,146,-5
"f902b0f41b544d4dbf79664fd233648d","ae781e8b775e4ccd93bc800dad5c8376",22855575,1,8,0,278,146,153,7
"ae781e8b775e4ccd93bc800dad5c8376","ae781e8b775e4ccd93bc800dad5c8376",22855575,8,0,1,279,153,153,0
"ae781e8b775e4ccd93bc800dad5c8376","06882a8492d9499aa31555567f575ecb",22855575,1,1,0,287,153,154,1
"06882a8492d9499aa31555567f575ecb","06882a8492d9499aa31555567f575ecb",22855575,1,0,1,288,154,154,0
"06882a8492d9499aa31555567f575ecb","f293c508f409466a8f27ddd7d1e40b20",22855575,1,1,0,289,154,155,1
"f293c508f409466a8f27ddd7d1e40b20","f293c508f409466a8f27ddd7d1e40b20",22855575,8,0,1,290,155,155,0
"f293c508f409466a8f27ddd7d1e40b20","cc4ddef5bbbe48ebb605141b347c4ed1",22855575,1,1,0,298,155,156,1
"cc4ddef5bbbe48ebb605141b347c4ed1","cc4ddef5bbbe48ebb605141b347c4ed1",22855575,3,0,1,299,156,156,0
"cc4ddef5bbbe48ebb605141b347c4ed1","f03480cf4eba413194d7af52fc0e7f28",22855575,1,-4,0,302,156,152,-4
"f03480cf4eba413194d7af52fc0e7f28","d313cec988a84645bee413e8d4724a4b",22855575,1,7,0,303,152,158,6
"d313cec988a84645bee413e8d4724a4b","d313cec988a84645bee413e8d4724a4b",22855575,6,0,1,304,158,158,0
"d313cec988a84645bee413e8d4724a4b","dc60696c76a74368a60f72246e47700d",22855575,1,1,0,308,158,159,1
"dc60696c76a74368a60f72246e47700d","dc60696c76a74368a60f72246e47700d",22855575,1,0,1,309,159,159,0
"dc60696c76a74368a60f72246e47700d","df1de691dafe4549a18a4398ee9dfaf9",22855575,1,-23,0,310,159,139,-20
"df1de691dafe4549a18a4398ee9dfaf9","78adeee1fa2c4fe0bc73f7bca9fcee86",22855575,1,26,0,311,139,160,21
"78adeee1fa2c4fe0bc73f7bca9fcee86","65202579580f4ad38d734b4ee39d22a8",22855575,5,5,0,312,160,164,4
"65202579580f4ad38d734b4ee39d22a8","65202579580f4ad38d734b4ee39d22a8",22855575,75,0,1,313,164,164,0
"65202579580f4ad38d734b4ee39d22a8","78adeee1fa2c4fe0bc73f7bca9fcee86",22855575,5,-5,0,317,164,160,-4
"65202579580f4ad38d734b4ee39d22a8","3cbcea2be0984e7dbd5a48195af10ce7",22855575,1,3,0,321,164,165,1
"3cbcea2be0984e7dbd5a48195af10ce7","78adeee1fa2c4fe0bc73f7bca9fcee86",22855575,2,-8,0,322,165,160,-5
"78adeee1fa2c4fe0bc73f7bca9fcee86","82e6285962b8400d9d6fc32436022a94",22855575,1,10,0,323,160,167,7
"82e6285962b8400d9d6fc32436022a94","3cbcea2be0984e7dbd5a48195af10ce7",22855575,3,-2,0,324,167,165,-2
"3cbcea2be0984e7dbd5a48195af10ce7","a9ac840f098c4bd0a2ee896214ce29cd",22855575,3,5,0,325,165,168,3
"a9ac840f098c4bd0a2ee896214ce29cd","3cbcea2be0984e7dbd5a48195af10ce7",22855575,1,-5,0,326,168,165,-3
"a9ac840f098c4bd0a2ee896214ce29cd","0c7262dff33c4087bc660ccf40f92f9c",22855575,2,4,0,328,168,169,1
"0c7262dff33c4087bc660ccf40f92f9c","b2275c3fad834f8d90737a2d9a6927d6",22855575,2,3,0,329,169,172,3
"b2275c3fad834f8d90737a2d9a6927d6","b2275c3fad834f8d90737a2d9a6927d6",22855575,28,0,1,330,172,172,0
"b2275c3fad834f8d90737a2d9a6927d6","eb515a26030b41f8a82a1e6114420bad",22855575,1,1,0,358,172,173,1
"eb515a26030b41f8a82a1e6114420bad","eb515a26030b41f8a82a1e6114420bad",22855575,2,0,1,359,173,173,0
"eb515a26030b41f8a82a1e6114420bad","b42cc17b7de840f181a704558d0bc845",22855575,1,3,0,361,173,175,2
"b42cc17b7de840f181a704558d0bc845","0c7262dff33c4087bc660ccf40f92f9c",22855575,1,-7,0,362,175,169,-6
"0c7262dff33c4087bc660ccf40f92f9c","fab84b4fab5940efb4ea868ef8d09396",22855575,1,153,0,363,169,284,115
"fab84b4fab5940efb4ea868ef8d09396","0c7262dff33c4087bc660ccf40f92f9c",22855575,1,-153,0,364,284,169,-115
"0c7262dff33c4087bc660ccf40f92f9c","0c7262dff33c4087bc660ccf40f92f9c",22855575,1,0,1,365,169,169,0
"0c7262dff33c4087bc660ccf40f92f9c","362fcb0699a14845ab29b2340093e528",22855575,1,6,0,366,169,174,5
"362fcb0699a14845ab29b2340093e528","b42cc17b7de840f181a704558d0bc845",22855575,1,1,0,367,174,175,1
"b42cc17b7de840f181a704558d0bc845","b42cc17b7de840f181a704558d0bc845",22855575,1,0,1,368,175,175,0
"b42cc17b7de840f181a704558d0bc845","801f9e9135034f49bf5f8b4bdefedb41",22855575,1,2,0,369,175,177,2
"801f9e9135034f49bf5f8b4bdefedb41","801f9e9135034f49bf5f8b4bdefedb41",22855575,12,0,1,370,177,177,0
"801f9e9135034f49bf5f8b4bdefedb41","ea38cc0e6e6e41edbabf210220808bf9",22855575,1,3,0,382,177,179,2
"ea38cc0e6e6e41edbabf210220808bf9","362fcb0699a14845ab29b2340093e528",22855575,1,-6,0,383,179,174,-5
"362fcb0699a14845ab29b2340093e528","b87c552dd247427abe6ab5795b9c9d43",22855575,2,8,0,384,174,181,7
"b87c552dd247427abe6ab5795b9c9d43","b87c552dd247427abe6ab5795b9c9d43",22855575,10,0,1,385,181,181,0
"b87c552dd247427abe6ab5795b9c9d43","139b097acfca451689d80c9c6eebdf7b",22855575,1,-3,0,395,181,178,-3
"139b097acfca451689d80c9c6eebdf7b","30f660a1feb34582a739722532524f79",22855575,1,6,0,396,178,183,5
"30f660a1feb34582a739722532524f79","30f660a1feb34582a739722532524f79",22855575,5,0,1,397,183,183,0
"30f660a1feb34582a739722532524f79","2024b4885bd14338a39b7b509acbbd02",22855575,1,-1,0,402,183,182,-1
"2024b4885bd14338a39b7b509acbbd02","c3f63fe50d8e487c86bf8ef76c9cadd3",22855575,1,4,0,403,182,185,3
"c3f63fe50d8e487c86bf8ef76c9cadd3","c3f63fe50d8e487c86bf8ef76c9cadd3",22855575,1,0,1,404,185,185,0
"c3f63fe50d8e487c86bf8ef76c9cadd3","0c7262dff33c4087bc660ccf40f92f9c",22855575,1,-20,0,405,185,169,-16
"0c7262dff33c4087bc660ccf40f92f9c","c8e371568a0c4391b25796ae4e91952e",22855575,2,23,0,406,169,186,17
"c8e371568a0c4391b25796ae4e91952e","7d932b23e1c84326ae5aa4d3c0d813d1",22855575,1,2,0,407,186,188,2
"7d932b23e1c84326ae5aa4d3c0d813d1","7d932b23e1c84326ae5aa4d3c0d813d1",22855575,1,0,1,408,188,188,0
"7d932b23e1c84326ae5aa4d3c0d813d1","c8e371568a0c4391b25796ae4e91952e",22855575,1,-2,0,409,188,186,-2
"c8e371568a0c4391b25796ae4e91952e","ab11d94c6c8948ea90b88f19d2cd502b",22855575,3,5,0,410,186,190,4
"ab11d94c6c8948ea90b88f19d2cd502b","f992451ed6ad4e68bb9e68ad6be7c4be",22855575,1,2,0,411,190,192,2
"f992451ed6ad4e68bb9e68ad6be7c4be","f992451ed6ad4e68bb9e68ad6be7c4be",22855575,5,0,1,412,192,192,0
"f992451ed6ad4e68bb9e68ad6be7c4be","07b44a7a51e94c78b411c753fc39dab0",22855575,1,-3,0,417,192,189,-3
"07b44a7a51e94c78b411c753fc39dab0","6cd2dcaac46847d4a0bc53f296d90375",22855575,2,6,0,418,189,194,5
"6cd2dcaac46847d4a0bc53f296d90375","2d2580c9411c4972909db508d6956a58",22855575,1,2,0,419,194,196,2
"2d2580c9411c4972909db508d6956a58","2d2580c9411c4972909db508d6956a58",22855575,2,0,1,420,196,196,0
"2d2580c9411c4972909db508d6956a58","5bddb3d9ed264f3984702f048c7e5340",22855575,1,1,0,422,196,197,1
"5bddb3d9ed264f3984702f048c7e5340","5bddb3d9ed264f3984702f048c7e5340",22855575,2,0,1,423,197,197,0
"5bddb3d9ed264f3984702f048c7e5340","d5e8e2bd12a2466b9d6d90855f0eb079",22855575,1,1,0,425,197,198,1
"d5e8e2bd12a2466b9d6d90855f0eb079","d5e8e2bd12a2466b9d6d90855f0eb079",22855575,2,0,1,426,198,198,0
"d5e8e2bd12a2466b9d6d90855f0eb079","017d7ca8e0394b91aaadc9574df2202c",22855575,1,-5,0,428,198,193,-5
"017d7ca8e0394b91aaadc9574df2202c","54e8e9f0ea3e45c4bf3b8ac799ee31b1",22855575,1,8,0,429,193,200,7
"54e8e9f0ea3e45c4bf3b8ac799ee31b1","54e8e9f0ea3e45c4bf3b8ac799ee31b1",22855575,1,0,1,430,200,200,0
"54e8e9f0ea3e45c4bf3b8ac799ee31b1","c614a00911be4877a075f19315530fb0",22855575,1,1,0,431,200,201,1
"c614a00911be4877a075f19315530fb0","c614a00911be4877a075f19315530fb0",22855575,6,0,1,432,201,201,0
"c614a00911be4877a075f19315530fb0","a6c21bd8b95249c7972820a7a7d76aff",22855575,1,1,0,438,201,202,1
"a6c21bd8b95249c7972820a7a7d76aff","a6c21bd8b95249c7972820a7a7d76aff",22855575,3,0,1,439,202,202,0
"a6c21bd8b95249c7972820a7a7d76aff","c8e371568a0c4391b25796ae4e91952e",22855575,1,-19,0,442,202,186,-16
"c8e371568a0c4391b25796ae4e91952e","c8e371568a0c4391b25796ae4e91952e",22855575,2,0,1,443,186,186,0
"c8e371568a0c4391b25796ae4e91952e","f9170dd6bc6442b4acd832747609b09a",22855575,1,16,0,444,186,199,13
"f9170dd6bc6442b4acd832747609b09a","b54257a550b94ebc9538f3a90eee9d7e",22855575,1,6,0,445,199,204,5
"b54257a550b94ebc9538f3a90eee9d7e","bb329d880ab54120adaf203a693bb203",22855575,1,-2,0,446,204,203,-1
"bb329d880ab54120adaf203a693bb203","bb329d880ab54120adaf203a693bb203",22855575,1,0,1,447,203,203,0
"bb329d880ab54120adaf203a693bb203","f9170dd6bc6442b4acd832747609b09a",22855575,1,-4,0,448,203,199,-4
"f9170dd6bc6442b4acd832747609b09a","334c2344009840079b1d0e1b7ce3d5a7",22855575,1,7,0,449,199,205,6
"334c2344009840079b1d0e1b7ce3d5a7","c8e371568a0c4391b25796ae4e91952e",22855575,1,-23,0,450,205,186,-19
"ab11d94c6c8948ea90b88f19d2cd502b","07b44a7a51e94c78b411c753fc39dab0",22855575,1,-1,0,453,190,189,-1
"6cd2dcaac46847d4a0bc53f296d90375","017d7ca8e0394b91aaadc9574df2202c",22855575,1,-1,0,455,194,193,-1
"017d7ca8e0394b91aaadc9574df2202c","334c2344009840079b1d0e1b7ce3d5a7",22855575,1,14,0,456,193,205,12
"334c2344009840079b1d0e1b7ce3d5a7","334c2344009840079b1d0e1b7ce3d5a7",22855575,1,0,1,457,205,205,0
"334c2344009840079b1d0e1b7ce3d5a7","d7f13c8d63ec4e2aa673fbb9cf9c6933",22855575,1,3,0,458,205,206,1
"d7f13c8d63ec4e2aa673fbb9cf9c6933","c8e371568a0c4391b25796ae4e91952e",22855575,2,-26,0,459,206,186,-20
"c8e371568a0c4391b25796ae4e91952e","7108f0e4c2584f1f9c471689ae4c885c",22855575,2,28,0,460,186,208,22
"7108f0e4c2584f1f9c471689ae4c885c","b9e80f77c3a44349863b19875725c384",22855575,2,-1,0,461,208,207,-1
"b9e80f77c3a44349863b19875725c384","b9e80f77c3a44349863b19875725c384",22855575,20,0,1,462,207,207,0
"b9e80f77c3a44349863b19875725c384","7108f0e4c2584f1f9c471689ae4c885c",22855575,1,1,0,482,207,208,1
"7108f0e4c2584f1f9c471689ae4c885c","7108f0e4c2584f1f9c471689ae4c885c",22855575,16,0,1,483,208,208,0
"7108f0e4c2584f1f9c471689ae4c885c","09400e101c5d4b439cf9a26b03aae558",22855575,1,3,0,499,208,210,2
"09400e101c5d4b439cf9a26b03aae558","d7f13c8d63ec4e2aa673fbb9cf9c6933",22855575,1,-5,0,500,210,206,-4
"d7f13c8d63ec4e2aa673fbb9cf9c6933","78adeee1fa2c4fe0bc73f7bca9fcee86",22855575,1,-66,0,501,206,160,-46
"78adeee1fa2c4fe0bc73f7bca9fcee86","3cbcea2be0984e7dbd5a48195af10ce7",22855575,3,8,0,560,160,165,5
"3cbcea2be0984e7dbd5a48195af10ce7","82e6285962b8400d9d6fc32436022a94",22855575,3,2,0,561,165,167,2
"82e6285962b8400d9d6fc32436022a94","d646286c8051419bbc2e31dd1db55ca8",22855575,1,-125,0,575,167,67,-100
"d646286c8051419bbc2e31dd1db55ca8","6a9f0ef185fb47f0937e29daa1c71ed5",22855575,3,27,0,576,67,90,23
"6a9f0ef185fb47f0937e29daa1c71ed5","42fb58708eaf4e5daa82bfca61b6f5fd",22855575,1,-3,0,577,90,87,-3
"42fb58708eaf4e5daa82bfca61b6f5fd","a2becd407db34b189200a32546d9d569",22855575,1,-15,0,578,87,75,-12
"a2becd407db34b189200a32546d9d569","58c22b011d0f4c2ea6d13615edbb9eeb",22855575,1,2,0,579,75,77,2
"58c22b011d0f4c2ea6d13615edbb9eeb","58c22b011d0f4c2ea6d13615edbb9eeb",22855575,2,0,1,580,77,77,0
"58c22b011d0f4c2ea6d13615edbb9eeb","dd76e1861dc9461c830888729d091ee0",22855575,1,1,0,582,77,78,1
"dd76e1861dc9461c830888729d091ee0","dd76e1861dc9461c830888729d091ee0",22855575,8,0,1,583,78,78,0
"dd76e1861dc9461c830888729d091ee0","cd1d828f1a694b87913a7ea66c23803e",22855575,1,1,0,591,78,79,1
"cd1d828f1a694b87913a7ea66c23803e","cd1d828f1a694b87913a7ea66c23803e",22855575,5,0,1,592,79,79,0
"cd1d828f1a694b87913a7ea66c23803e","9176a3c2b4d2465fa8b0c67096c2a97e",22855575,1,1,0,597,79,80,1
"9176a3c2b4d2465fa8b0c67096c2a97e","9176a3c2b4d2465fa8b0c67096c2a97e",22855575,11,0,1,598,80,80,0
"9176a3c2b4d2465fa8b0c67096c2a97e","f8ec6445f7194e25b9101d4fbcb07a18",22855575,1,1,0,609,80,81,1
"f8ec6445f7194e25b9101d4fbcb07a18","f8ec6445f7194e25b9101d4fbcb07a18",22855575,2,0,1,610,81,81,0
"f8ec6445f7194e25b9101d4fbcb07a18","140d5b27b8574befad82c0a013b59dfa",22855575,1,-7,0,612,81,74,-7
"140d5b27b8574befad82c0a013b59dfa","a2becd407db34b189200a32546d9d569",22855575,1,1,0,613,74,75,1
"a2becd407db34b189200a32546d9d569","d18a9ea32855445f8736581f5cb119ce",22855575,1,8,0,614,75,82,7
"d18a9ea32855445f8736581f5cb119ce","d646286c8051419bbc2e31dd1db55ca8",22855575,1,-17,0,615,82,67,-15
"140d5b27b8574befad82c0a013b59dfa","140d5b27b8574befad82c0a013b59dfa",22855575,2,0,1,618,74,74,0
"140d5b27b8574befad82c0a013b59dfa","6a9f0ef185fb47f0937e29daa1c71ed5",22855575,1,19,0,620,74,90,16
"6a9f0ef185fb47f0937e29daa1c71ed5","d18a9ea32855445f8736581f5cb119ce",22855575,1,-10,0,621,90,82,-8
"d18a9ea32855445f8736581f5cb119ce","6a9f0ef185fb47f0937e29daa1c71ed5",22855575,1,10,0,622,82,90,8
"6a9f0ef185fb47f0937e29daa1c71ed5","6a9f0ef185fb47f0937e29daa1c71ed5",22855575,4,0,1,623,90,90,0
"6a9f0ef185fb47f0937e29daa1c71ed5","d646286c8051419bbc2e31dd1db55ca8",22855575,2,-27,0,626,90,67,-23
"d646286c8051419bbc2e31dd1db55ca8","e20db35ced8544ddac5bc3839145e463",22855575,1,30,0,627,67,91,24
"d391c8b6e56a43a7b654e9dee02d904b","e20db35ced8544ddac5bc3839145e463",22855575,1,-13,0,630,103,91,-12
"d391c8b6e56a43a7b654e9dee02d904b","d391c8b6e56a43a7b654e9dee02d904b",22855575,33,0,1,633,103,103,0
"d391c8b6e56a43a7b654e9dee02d904b","6111116566fc4fd9abba409322bea245",22855575,1,1,0,666,103,104,1
"6111116566fc4fd9abba409322bea245","6111116566fc4fd9abba409322bea245",22855575,2,0,1,667,104,104,0
"6111116566fc4fd9abba409322bea245","a81b2235cb9c499eb9ea8ee0a8dd9725",22855575,1,1,0,669,104,105,1
"a81b2235cb9c499eb9ea8ee0a8dd9725","a81b2235cb9c499eb9ea8ee0a8dd9725",22855575,2,0,1,670,105,105,0
"a81b2235cb9c499eb9ea8ee0a8dd9725","2d4e0ab0ef3b4d73b82c72d4621a7579",22855575,1,1,0,672,105,106,1
"2d4e0ab0ef3b4d73b82c72d4621a7579","2d4e0ab0ef3b4d73b82c72d4621a7579",22855575,2,0,1,673,106,106,0
"2d4e0ab0ef3b4d73b82c72d4621a7579","8bdebf492ebd4e62b0d522e8ab5e5197",22855575,1,1,0,675,106,107,1
"8bdebf492ebd4e62b0d522e8ab5e5197","8bdebf492ebd4e62b0d522e8ab5e5197",22855575,2,0,1,676,107,107,0
"8bdebf492ebd4e62b0d522e8ab5e5197","73039f8c1eb9409cb4caee2cf968001e",22855575,1,-7,0,678,107,100,-7
"4280927ec4d643238aa49c32f9e06c6c","fc44e6a5f7654430af1227838224dceb",22855575,1,2,0,680,109,111,2
"fc44e6a5f7654430af1227838224dceb","fc44e6a5f7654430af1227838224dceb",22855575,8,0,1,681,111,111,0
"fc44e6a5f7654430af1227838224dceb","08111f75e22d409998cf8b85bd431f0a",22855575,1,-3,0,689,111,108,-3
"a9ae0a3c070d455bb4369a8996313336","00ae5f0c51874a73a41ebea838d95682",22855575,1,-15,0,691,114,101,-13
"00ae5f0c51874a73a41ebea838d95682","37319e88176d4aefa91d7a9980dbae91",22855575,1,13,0,692,101,112,11
"37319e88176d4aefa91d7a9980dbae91","d391c8b6e56a43a7b654e9dee02d904b",22855575,1,-11,0,693,112,103,-9
"d391c8b6e56a43a7b654e9dee02d904b","d646286c8051419bbc2e31dd1db55ca8",22855575,1,-43,0,694,103,67,-36
"6a9f0ef185fb47f0937e29daa1c71ed5","e20db35ced8544ddac5bc3839145e463",22855575,1,3,0,699,90,91,1
"e20db35ced8544ddac5bc3839145e463","e20db35ced8544ddac5bc3839145e463",22855575,1,0,1,700,91,91,0
"e20db35ced8544ddac5bc3839145e463","d391c8b6e56a43a7b654e9dee02d904b",22855575,1,13,0,701,91,103,12
"00ae5f0c51874a73a41ebea838d95682","73039f8c1eb9409cb4caee2cf968001e",22855575,1,-1,0,703,101,100,-1
"4280927ec4d643238aa49c32f9e06c6c","a9ae0a3c070d455bb4369a8996313336",22855575,1,6,0,705,109,114,5
"a9ae0a3c070d455bb4369a8996313336","08111f75e22d409998cf8b85bd431f0a",22855575,1,-7,0,706,114,108,-6
"08111f75e22d409998cf8b85bd431f0a","37319e88176d4aefa91d7a9980dbae91",22855575,1,5,0,707,108,112,4
"62bff51286ef4f348717a3cf6fe2318f","e20db35ced8544ddac5bc3839145e463",22855575,1,-33,0,711,120,91,-29
"e20db35ced8544ddac5bc3839145e463","779f9ddd1fd14d1e9e69f72219a1fdbd",22855575,1,36,0,712,91,121,30
"a8dd5213034441ac92724b4e83eb0bb2","779f9ddd1fd14d1e9e69f72219a1fdbd",22855575,1,-9,0,714,129,121,-8
"779f9ddd1fd14d1e9e69f72219a1fdbd","579338175e0b4bbb8ef3b712b5d8b54e",22855575,1,8,0,715,121,128,7
"579338175e0b4bbb8ef3b712b5d8b54e","b416d47c56a742199b5d7c7f19d6503a",22855575,1,7,0,716,128,134,6
"b416d47c56a742199b5d7c7f19d6503a","df1de691dafe4549a18a4398ee9dfaf9",22855575,1,8,0,717,134,139,5
"df1de691dafe4549a18a4398ee9dfaf9","779f9ddd1fd14d1e9e69f72219a1fdbd",22855575,1,-23,0,718,139,121,-18
"779f9ddd1fd14d1e9e69f72219a1fdbd","6c5ad271a44743479bfaea29b1db8d02",22855575,1,27,0,719,121,143,22
"6c5ad271a44743479bfaea29b1db8d02","8aae34f5ddbb4052a709b12e6b0d40fa",22855575,1,5,0,720,143,147,4
"8aae34f5ddbb4052a709b12e6b0d40fa","df1de691dafe4549a18a4398ee9dfaf9",22855575,1,-9,0,721,147,139,-8
"df1de691dafe4549a18a4398ee9dfaf9","f902b0f41b544d4dbf79664fd233648d",22855575,1,8,0,722,139,146,7
"f902b0f41b544d4dbf79664fd233648d","d313cec988a84645bee413e8d4724a4b",22855575,1,14,0,723,146,158,12
"d313cec988a84645bee413e8d4724a4b","f03480cf4eba413194d7af52fc0e7f28",22855575,1,-7,0,726,158,152,-6
"f03480cf4eba413194d7af52fc0e7f28","78adeee1fa2c4fe0bc73f7bca9fcee86",22855575,1,11,0,727,152,160,8
"78adeee1fa2c4fe0bc73f7bca9fcee86","df1de691dafe4549a18a4398ee9dfaf9",22855575,1,-26,0,728,160,139,-21
"df1de691dafe4549a18a4398ee9dfaf9","65202579580f4ad38d734b4ee39d22a8",22855575,1,31,0,729,139,164,25
"a9ac840f098c4bd0a2ee896214ce29cd","a9ac840f098c4bd0a2ee896214ce29cd",22855575,1,0,1,743,168,168,0
"b2275c3fad834f8d90737a2d9a6927d6","0c7262dff33c4087bc660ccf40f92f9c",22855575,1,-3,0,746,172,169,-3
"0c7262dff33c4087bc660ccf40f92f9c","b42cc17b7de840f181a704558d0bc845",22855575,1,7,0,747,169,175,6
"b42cc17b7de840f181a704558d0bc845","362fcb0699a14845ab29b2340093e528",22855575,1,-1,0,748,175,174,-1
"b87c552dd247427abe6ab5795b9c9d43","ea38cc0e6e6e41edbabf210220808bf9",22855575,1,-2,0,750,181,179,-2
"ea38cc0e6e6e41edbabf210220808bf9","139b097acfca451689d80c9c6eebdf7b",22855575,1,-1,0,751,179,178,-1
"139b097acfca451689d80c9c6eebdf7b","0c7262dff33c4087bc660ccf40f92f9c",22855575,1,-11,0,752,178,169,-9
"ab11d94c6c8948ea90b88f19d2cd502b","c8e371568a0c4391b25796ae4e91952e",22855575,1,-5,0,755,190,186,-4
"c8e371568a0c4391b25796ae4e91952e","6cd2dcaac46847d4a0bc53f296d90375",22855575,1,10,0,756,186,194,8
"6cd2dcaac46847d4a0bc53f296d90375","07b44a7a51e94c78b411c753fc39dab0",22855575,1,-6,0,757,194,189,-5
"07b44a7a51e94c78b411c753fc39dab0","017d7ca8e0394b91aaadc9574df2202c",22855575,1,5,0,758,189,193,4
"017d7ca8e0394b91aaadc9574df2202c","f9170dd6bc6442b4acd832747609b09a",22855575,1,7,0,759,193,199,6
"f9170dd6bc6442b4acd832747609b09a","d7f13c8d63ec4e2aa673fbb9cf9c6933",22855575,1,10,0,760,199,206,7
"b9e80f77c3a44349863b19875725c384","be502a7a43c44bf7b682698de79d9369",22855575,1,9,0,764,207,214,7
"be502a7a43c44bf7b682698de79d9369","d7f13c8d63ec4e2aa673fbb9cf9c6933",22855575,1,-10,0,765,214,206,-8
"d7f13c8d63ec4e2aa673fbb9cf9c6933","f7fb1952f56b4189b86a9f8b7862d2b8",22855575,1,11,0,766,206,215,9
"f7fb1952f56b4189b86a9f8b7862d2b8","ec341f459285443b8361f7f15638ff08",22855575,1,-2,0,767,215,213,-2
"ec341f459285443b8361f7f15638ff08","09400e101c5d4b439cf9a26b03aae558",22855575,1,-4,0,768,213,210,-3
"09400e101c5d4b439cf9a26b03aae558","a88efa7e50ce47159810ab553afa6d3a",22855575,1,2,0,769,210,212,2
"a88efa7e50ce47159810ab553afa6d3a","a88efa7e50ce47159810ab553afa6d3a",22855575,22,0,1,770,212,212,0
"a88efa7e50ce47159810ab553afa6d3a","a875096404ef4a9984b62d74cda916f9",22855575,1,-3,0,792,212,209,-3
"a875096404ef4a9984b62d74cda916f9","be502a7a43c44bf7b682698de79d9369",22855575,1,6,0,793,209,214,5
"be502a7a43c44bf7b682698de79d9369","f7fb1952f56b4189b86a9f8b7862d2b8",22855575,1,1,0,794,214,215,1
"f7fb1952f56b4189b86a9f8b7862d2b8","f7fb1952f56b4189b86a9f8b7862d2b8",22855575,12,0,1,795,215,215,0
"f7fb1952f56b4189b86a9f8b7862d2b8","b860ee85d8bc4a2f97958cfb71be3533",22855575,1,1,0,807,215,216,1
"b860ee85d8bc4a2f97958cfb71be3533","b860ee85d8bc4a2f97958cfb71be3533",22855575,5,0,1,808,216,216,0
"b860ee85d8bc4a2f97958cfb71be3533","ec341f459285443b8361f7f15638ff08",22855575,1,-3,0,813,216,213,-3
"ec341f459285443b8361f7f15638ff08","363837c182e04711840d896ae1e0339c",22855575,1,6,0,814,213,218,5
"363837c182e04711840d896ae1e0339c","363837c182e04711840d896ae1e0339c",22855575,16,0,1,815,218,218,0
"363837c182e04711840d896ae1e0339c","01b2051f8941460d89945e3b02d1ce78",22855575,1,-1,0,831,218,217,-1
"01b2051f8941460d89945e3b02d1ce78","91125ca626c5470eb145501f8c37f8db",22855575,1,4,0,832,217,220,3
"91125ca626c5470eb145501f8c37f8db","91125ca626c5470eb145501f8c37f8db",22855575,1,0,1,833,220,220,0
"91125ca626c5470eb145501f8c37f8db","1c6721b1f63f4d30ba7746ea8af02a52",22855575,1,3,0,834,220,221,1
"1c6721b1f63f4d30ba7746ea8af02a52","d7f13c8d63ec4e2aa673fbb9cf9c6933",22855575,1,-21,0,835,221,206,-15
"d7f13c8d63ec4e2aa673fbb9cf9c6933","77ecef8eff6b4a2caea7707669bf7475",22855575,1,22,0,836,206,222,16
"77ecef8eff6b4a2caea7707669bf7475","77ecef8eff6b4a2caea7707669bf7475",22855575,12,0,1,837,222,222,0
"77ecef8eff6b4a2caea7707669bf7475","1c6721b1f63f4d30ba7746ea8af02a52",22855575,3,-1,0,849,222,221,-1
"1c6721b1f63f4d30ba7746ea8af02a52","d03cb855c70044cf8c35d9ec0de696e3",22855575,1,4,0,850,221,224,3
"d03cb855c70044cf8c35d9ec0de696e3","8b9ae98743bd4d4a8a87dff1c1244211",22855575,1,3,0,851,224,227,3
"8b9ae98743bd4d4a8a87dff1c1244211","a49a937d6896486d9a5396654abcf2e1",22855575,1,-1,0,852,227,226,-1
"a49a937d6896486d9a5396654abcf2e1","a49a937d6896486d9a5396654abcf2e1",22855575,5,0,1,853,226,226,0
"a49a937d6896486d9a5396654abcf2e1","8b9ae98743bd4d4a8a87dff1c1244211",22855575,1,1,0,858,226,227,1
"8b9ae98743bd4d4a8a87dff1c1244211","8b9ae98743bd4d4a8a87dff1c1244211",22855575,26,0,1,859,227,227,0
"8b9ae98743bd4d4a8a87dff1c1244211","2ab1535aac1346ba8801535bf729ef37",22855575,1,3,0,885,227,229,2
"2ab1535aac1346ba8801535bf729ef37","f7906d6f59b9489a91d2ef40db5a474d",22855575,1,-7,0,886,229,223,-6
"f7906d6f59b9489a91d2ef40db5a474d","a4f40fb48a8542c8949bae1f002cd9bc",22855575,1,9,0,887,223,231,8
"a4f40fb48a8542c8949bae1f002cd9bc","a4f40fb48a8542c8949bae1f002cd9bc",22855575,2,0,1,888,231,231,0
"a4f40fb48a8542c8949bae1f002cd9bc","8972c23e32044edb8a78fa1eed4e5947",22855575,1,1,0,890,231,232,1
"8972c23e32044edb8a78fa1eed4e5947","8972c23e32044edb8a78fa1eed4e5947",22855575,5,0,1,891,232,232,0
"8972c23e32044edb8a78fa1eed4e5947","92feb4a40f8344d38b6f722e42a53295",22855575,1,1,0,896,232,233,1
"92feb4a40f8344d38b6f722e42a53295","92feb4a40f8344d38b6f722e42a53295",22855575,2,0,1,897,233,233,0
"92feb4a40f8344d38b6f722e42a53295","5152833676bf4c6cb317060be10f68db",22855575,1,-5,0,899,233,228,-5
"5152833676bf4c6cb317060be10f68db","ca3e28f290354c08aefe5b0f769604e6",22855575,1,8,0,900,228,235,7
"ca3e28f290354c08aefe5b0f769604e6","ca3e28f290354c08aefe5b0f769604e6",22855575,9,0,1,901,235,235,0
"ca3e28f290354c08aefe5b0f769604e6","79a35eea833e4c2c9d22fc53c3c6445c",22855575,1,1,0,910,235,236,1
"79a35eea833e4c2c9d22fc53c3c6445c","79a35eea833e4c2c9d22fc53c3c6445c",22855575,4,0,1,911,236,236,0
"79a35eea833e4c2c9d22fc53c3c6445c","8f68228b1518449e9615cdafee41a2bd",22855575,1,1,0,915,236,237,1
"8f68228b1518449e9615cdafee41a2bd","8f68228b1518449e9615cdafee41a2bd",22855575,1,0,1,916,237,237,0
"8f68228b1518449e9615cdafee41a2bd","cab89fa5c3ed45a5aa550fc0352d6a42",22855575,1,1,0,917,237,238,1
"cab89fa5c3ed45a5aa550fc0352d6a42","cab89fa5c3ed45a5aa550fc0352d6a42",22855575,3,0,1,918,238,238,0
"cab89fa5c3ed45a5aa550fc0352d6a42","1c6721b1f63f4d30ba7746ea8af02a52",22855575,1,-20,0,921,238,221,-17
"1c6721b1f63f4d30ba7746ea8af02a52","1c6721b1f63f4d30ba7746ea8af02a52",22855575,1,0,1,922,221,221,0
"1c6721b1f63f4d30ba7746ea8af02a52","77ecef8eff6b4a2caea7707669bf7475",22855575,2,1,0,923,221,222,1
"1c6721b1f63f4d30ba7746ea8af02a52","8b9ae98743bd4d4a8a87dff1c1244211",22855575,1,7,0,925,221,227,6
"8b9ae98743bd4d4a8a87dff1c1244211","d03cb855c70044cf8c35d9ec0de696e3",22855575,1,-3,0,926,227,224,-3
"d03cb855c70044cf8c35d9ec0de696e3","f7906d6f59b9489a91d2ef40db5a474d",22855575,1,-1,0,927,224,223,-1
"f7906d6f59b9489a91d2ef40db5a474d","2ab1535aac1346ba8801535bf729ef37",22855575,1,7,0,928,223,229,6
"2ab1535aac1346ba8801535bf729ef37","5152833676bf4c6cb317060be10f68db",22855575,2,-1,0,929,229,228,-1
"5152833676bf4c6cb317060be10f68db","66d4fad4f1cf4b46be0750a99ad7a35a",22855575,1,12,0,930,228,239,11
"66d4fad4f1cf4b46be0750a99ad7a35a","66d4fad4f1cf4b46be0750a99ad7a35a",22855575,1,0,1,931,239,239,0
"66d4fad4f1cf4b46be0750a99ad7a35a","0b04c8e2f86d48c7aeb7e225819cd32b",22855575,1,-5,0,932,239,234,-5
"0b04c8e2f86d48c7aeb7e225819cd32b","1c6721b1f63f4d30ba7746ea8af02a52",22855575,1,-16,0,933,234,221,-13
"1c6721b1f63f4d30ba7746ea8af02a52","2ab1535aac1346ba8801535bf729ef37",22855575,1,10,0,936,221,229,8
"5152833676bf4c6cb317060be10f68db","f53da5fd9bfe412da4b80d4742563b6c",22855575,1,15,0,938,228,241,13
"f53da5fd9bfe412da4b80d4742563b6c","f53da5fd9bfe412da4b80d4742563b6c",22855575,1,0,1,939,241,241,0
"f53da5fd9bfe412da4b80d4742563b6c","1c6721b1f63f4d30ba7746ea8af02a52",22855575,1,-24,0,940,241,221,-20
"1c6721b1f63f4d30ba7746ea8af02a52","2ae94c0cea4d480a9d5dca8fb1d7b542",22855575,1,27,0,941,221,242,21
"2ae94c0cea4d480a9d5dca8fb1d7b542","1ebf23f9d994469a85206e4c7b1bf5f5",22855575,1,3,0,942,242,245,3
"1ebf23f9d994469a85206e4c7b1bf5f5","1ebf23f9d994469a85206e4c7b1bf5f5",22855575,10,0,1,943,245,245,0
"1ebf23f9d994469a85206e4c7b1bf5f5","85ae675b83e8422da842cfd25596af99",22855575,1,1,0,953,245,246,1
"85ae675b83e8422da842cfd25596af99","85ae675b83e8422da842cfd25596af99",22855575,1,0,1,954,246,246,0
"85ae675b83e8422da842cfd25596af99","2ae94c0cea4d480a9d5dca8fb1d7b542",22855575,1,-4,0,955,246,242,-4
"2ae94c0cea4d480a9d5dca8fb1d7b542","fa235f0f364d47e4ae1c87f47bf8e6ba",22855575,1,12,0,956,242,252,10
"fa235f0f364d47e4ae1c87f47bf8e6ba","79f7845465cc4ed19d8e4f1429541be0",22855575,1,2,0,957,252,254,2
"79f7845465cc4ed19d8e4f1429541be0","79f7845465cc4ed19d8e4f1429541be0",22855575,2,0,1,958,254,254,0
"79f7845465cc4ed19d8e4f1429541be0","6e83e23f56544a19b94067c1c558d9c0",22855575,1,-8,0,960,254,247,-7
"6e83e23f56544a19b94067c1c558d9c0","00f61990949545828dd12f1303d47504",22855575,1,11,0,961,247,256,9
"00f61990949545828dd12f1303d47504","ead7bb4b64e247d2ae632ab8a296b091",22855575,1,2,0,962,256,258,2
"ead7bb4b64e247d2ae632ab8a296b091","ead7bb4b64e247d2ae632ab8a296b091",22855575,5,0,1,963,258,258,0
"ead7bb4b64e247d2ae632ab8a296b091","41b0048dde734bb280bac6116baa8e27",22855575,1,1,0,968,258,259,1
"41b0048dde734bb280bac6116baa8e27","41b0048dde734bb280bac6116baa8e27",22855575,2,0,1,969,259,259,0
"41b0048dde734bb280bac6116baa8e27","b41c5a094a604ee0915327da5cc0beb7",22855575,1,1,0,971,259,260,1
"b41c5a094a604ee0915327da5cc0beb7","b41c5a094a604ee0915327da5cc0beb7",22855575,2,0,1,972,260,260,0
"b41c5a094a604ee0915327da5cc0beb7","d546341988904f069cfa86b21457d9d9",22855575,1,-10,0,974,260,251,-9
"d546341988904f069cfa86b21457d9d9","28c171777c52431ab6b925073bd63d46",22855575,1,15,0,975,251,264,13
"28c171777c52431ab6b925073bd63d46","28c171777c52431ab6b925073bd63d46",22855575,7,0,1,976,264,264,0
"28c171777c52431ab6b925073bd63d46","ac160db940cb49ae8579162b1d52bb5d",22855575,1,2,0,983,264,266,2
"ac160db940cb49ae8579162b1d52bb5d","ac160db940cb49ae8579162b1d52bb5d",22855575,3,0,1,984,266,266,0
"ac160db940cb49ae8579162b1d52bb5d","d989ebcfc12a4b669f0100dc1aa14f1e",22855575,1,-12,0,987,266,255,-11
"d989ebcfc12a4b669f0100dc1aa14f1e","c6fd49b485cc4874b0bbdd9c6171e09c",22855575,1,15,0,988,255,268,13
"c6fd49b485cc4874b0bbdd9c6171e09c","c6fd49b485cc4874b0bbdd9c6171e09c",22855575,12,0,1,1000,268,268,0
"c6fd49b485cc4874b0bbdd9c6171e09c","44240778a97c4af0937817499b75707b",22855575,1,1,0,1001,268,269,1
"44240778a97c4af0937817499b75707b","44240778a97c4af0937817499b75707b",22855575,2,0,1,1002,269,269,0
"44240778a97c4af0937817499b75707b","7aa76d3e993840d8805f097cbdbcd44b",22855575,1,-9,0,1004,269,261,-8
"7aa76d3e993840d8805f097cbdbcd44b","865a4d3b43374da7944dc7d397f566d9",22855575,1,12,0,1005,261,271,10
"865a4d3b43374da7944dc7d397f566d9","865a4d3b43374da7944dc7d397f566d9",22855575,1,0,1,1006,271,271,0
"865a4d3b43374da7944dc7d397f566d9","0d987bed3ffa4ed0b9a2e62e97b7b30f",22855575,1,3,0,1007,271,272,1
"0d987bed3ffa4ed0b9a2e62e97b7b30f","2ae94c0cea4d480a9d5dca8fb1d7b542",22855575,2,-38,0,1008,272,242,-30
"2ae94c0cea4d480a9d5dca8fb1d7b542","0d987bed3ffa4ed0b9a2e62e97b7b30f",22855575,2,38,0,1009,242,272,30
"2ae94c0cea4d480a9d5dca8fb1d7b542","7028800abe7d4e27b613d1d6cbe26bf7",22855575,1,30,0,1011,242,267,25
"7028800abe7d4e27b613d1d6cbe26bf7","7aa76d3e993840d8805f097cbdbcd44b",22855575,1,-7,0,1012,267,261,-6
"7aa76d3e993840d8805f097cbdbcd44b","d989ebcfc12a4b669f0100dc1aa14f1e",22855575,1,-7,0,1013,261,255,-6
"d989ebcfc12a4b669f0100dc1aa14f1e","2ae94c0cea4d480a9d5dca8fb1d7b542",22855575,1,-16,0,1014,255,242,-13
"0d987bed3ffa4ed0b9a2e62e97b7b30f","0d987bed3ffa4ed0b9a2e62e97b7b30f",22855575,1,0,1,1016,272,272,0
"0d987bed3ffa4ed0b9a2e62e97b7b30f","82ae07bc0c9b4570a41799290d1ef399",22855575,1,4,0,1017,272,275,3
"82ae07bc0c9b4570a41799290d1ef399","bb5a47f5ea01454a8b79455422d3b9da",22855575,1,6,0,1018,275,280,5
"bb5a47f5ea01454a8b79455422d3b9da","bb5a47f5ea01454a8b79455422d3b9da",22855575,23,0,1,1019,280,280,0
"0c7262dff33c4087bc660ccf40f92f9c","0c7262dff33c4087bc660ccf40f92f9c",22855693,1,0,1,1,169,169,0
"0c7262dff33c4087bc660ccf40f92f9c","e2911e79efc2420eac45d9f671463d4b",22855693,1,-238,0,2,169,2,-167
"e2911e79efc2420eac45d9f671463d4b","56586aa865414f538729c7f7735d2bc6",22855693,3,12,0,4,2,12,10
"e2911e79efc2420eac45d9f671463d4b","9afd71a5298d4333b6849dfce1b9422c",22855693,1,25,0,10,2,18,16
"9afd71a5298d4333b6849dfce1b9422c","9afd71a5298d4333b6849dfce1b9422c",22855693,2,0,1,11,18,18,0
"9afd71a5298d4333b6849dfce1b9422c","56586aa865414f538729c7f7735d2bc6",22855693,3,-13,0,13,18,12,-6
"56586aa865414f538729c7f7735d2bc6","56586aa865414f538729c7f7735d2bc6",22855693,9,0,1,14,12,12,0
"56586aa865414f538729c7f7735d2bc6","9afd71a5298d4333b6849dfce1b9422c",22855693,2,13,0,16,12,18,6
"56586aa865414f538729c7f7735d2bc6","e2911e79efc2420eac45d9f671463d4b",22855693,4,-12,0,18,12,2,-10
"e2911e79efc2420eac45d9f671463d4b","e2911e79efc2420eac45d9f671463d4b",22855693,5,0,1,19,2,2,0
"e2911e79efc2420eac45d9f671463d4b","b613861cecf84ffcab01afb23f660475",22855693,2,-3,0,20,2,1,-1
"b613861cecf84ffcab01afb23f660475","b613861cecf84ffcab01afb23f660475",22855693,4,0,1,21,1,1,0
"b613861cecf84ffcab01afb23f660475","e2911e79efc2420eac45d9f671463d4b",22855693,2,3,0,25,1,2,1
"e2911e79efc2420eac45d9f671463d4b","519d1b8c59404d67b54e96c5c8a830b2",22855693,1,1,0,29,2,3,1
"519d1b8c59404d67b54e96c5c8a830b2","519d1b8c59404d67b54e96c5c8a830b2",22855693,2,0,1,30,3,3,0
"519d1b8c59404d67b54e96c5c8a830b2","531db53f81f646edb0cdcfe0085b03b7",22855693,1,1,0,32,3,4,1
"531db53f81f646edb0cdcfe0085b03b7","531db53f81f646edb0cdcfe0085b03b7",22855693,1,0,1,33,4,4,0
"531db53f81f646edb0cdcfe0085b03b7","4f5f94b2f95141e0a9d53a61da2276da",22855693,1,1,0,34,4,5,1
"4f5f94b2f95141e0a9d53a61da2276da","4f5f94b2f95141e0a9d53a61da2276da",22855693,3,0,1,35,5,5,0
"4f5f94b2f95141e0a9d53a61da2276da","6d541c89590949f99af293c4f2333f67",22855693,1,1,0,38,5,6,1
"6d541c89590949f99af293c4f2333f67","6d541c89590949f99af293c4f2333f67",22855693,1,0,1,39,6,6,0
"6d541c89590949f99af293c4f2333f67","dd5cf0b9fe4c4f1d8f5ff8e4c04879cb",22855693,1,1,0,40,6,7,1
"dd5cf0b9fe4c4f1d8f5ff8e4c04879cb","dd5cf0b9fe4c4f1d8f5ff8e4c04879cb",22855693,2,0,1,41,7,7,0
"dd5cf0b9fe4c4f1d8f5ff8e4c04879cb","f96261861edc426abe2248be4f0a709a",22855693,1,1,0,43,7,8,1
"f96261861edc426abe2248be4f0a709a","f96261861edc426abe2248be4f0a709a",22855693,1,0,1,44,8,8,0
"f96261861edc426abe2248be4f0a709a","66b5e16f4f75454fb5b8172079f0fa83",22855693,1,1,0,45,8,9,1
"66b5e16f4f75454fb5b8172079f0fa83","66b5e16f4f75454fb5b8172079f0fa83",22855693,1,0,1,46,9,9,0
"66b5e16f4f75454fb5b8172079f0fa83","0680571d4698477995e41842c36a54b2",22855693,1,1,0,47,9,10,1
"0680571d4698477995e41842c36a54b2","0680571d4698477995e41842c36a54b2",22855693,1,0,1,48,10,10,0
"0680571d4698477995e41842c36a54b2","9112f2bffece48e08c6d2287be204085",22855693,1,1,0,49,10,11,1
"9112f2bffece48e08c6d2287be204085","9112f2bffece48e08c6d2287be204085",22855693,1,0,1,50,11,11,0
"9112f2bffece48e08c6d2287be204085","56586aa865414f538729c7f7735d2bc6",22855693,1,3,0,51,11,12,1
"56586aa865414f538729c7f7735d2bc6","b7f2b31585d94eb3bf86376714aa7070",22855693,1,2,0,61,12,13,1
"b7f2b31585d94eb3bf86376714aa7070","b7f2b31585d94eb3bf86376714aa7070",22855693,2,0,1,62,13,13,0
"b7f2b31585d94eb3bf86376714aa7070","3f1c815879794b929260d224becaff7e",22855693,1,2,0,64,13,14,1
"3f1c815879794b929260d224becaff7e","81c864a886d54a6b8ff85f7d736f4f95",22855693,1,2,0,65,14,15,1
"81c864a886d54a6b8ff85f7d736f4f95","5c5ceeee4562457ba6d41515aeebfbb1",22855693,1,4,0,66,15,17,2
"5c5ceeee4562457ba6d41515aeebfbb1","5c5ceeee4562457ba6d41515aeebfbb1",22855693,1,0,1,67,17,17,0
"5c5ceeee4562457ba6d41515aeebfbb1","9afd71a5298d4333b6849dfce1b9422c",22855693,1,3,0,68,17,18,1
"9afd71a5298d4333b6849dfce1b9422c","b7719e26494940efa49512aedd0aac79",22855693,1,4,0,71,18,20,2
"b7719e26494940efa49512aedd0aac79","d4f45188d3c84a02ba08454e6403a818",22855693,1,5,0,72,20,24,4
"d4f45188d3c84a02ba08454e6403a818","d4c3b003e8274e429d2fa688d73fde6d",22855693,1,-2,0,73,24,22,-2
"d4c3b003e8274e429d2fa688d73fde6d","b7719e26494940efa49512aedd0aac79",22855693,1,-3,0,74,22,20,-2
"b7719e26494940efa49512aedd0aac79","b7719e26494940efa49512aedd0aac79",22855693,1,0,1,75,20,20,0
"b7719e26494940efa49512aedd0aac79","afbf7250b99d47bea07172749483ca97",22855693,1,12,0,76,20,28,8
"afbf7250b99d47bea07172749483ca97","afbf7250b99d47bea07172749483ca97",22855693,1,0,1,77,28,28,0
"afbf7250b99d47bea07172749483ca97","4e51676dc72045d99c19b9fa7b22f8bc",22855693,1,3,0,78,28,29,1
"4e51676dc72045d99c19b9fa7b22f8bc","4e51676dc72045d99c19b9fa7b22f8bc",22855693,1,0,1,79,29,29,0
"4e51676dc72045d99c19b9fa7b22f8bc","51970cfa30e643e894e66ae85c8024cc",22855693,1,3,0,80,29,31,2
"51970cfa30e643e894e66ae85c8024cc","c33c17be71ae4d588da7369472e5bb1b",22855693,1,6,0,81,31,34,3
"c33c17be71ae4d588da7369472e5bb1b","4e51676dc72045d99c19b9fa7b22f8bc",22855693,1,-9,0,82,34,29,-5
"4e51676dc72045d99c19b9fa7b22f8bc","93679be414554a11b1893002f2229a93",22855693,1,12,0,83,29,35,6
"93679be414554a11b1893002f2229a93","c33c17be71ae4d588da7369472e5bb1b",22855693,1,-3,0,84,35,34,-1
"c33c17be71ae4d588da7369472e5bb1b","7040a13096d746ac84b8fac8d9752058",22855693,1,6,0,85,34,36,2
"7040a13096d746ac84b8fac8d9752058","93679be414554a11b1893002f2229a93",22855693,1,-3,0,86,36,35,-1
"93679be414554a11b1893002f2229a93","9a0dc646f934470daf08c4b56ccf73db",22855693,1,6,0,87,35,37,2
"9a0dc646f934470daf08c4b56ccf73db","7040a13096d746ac84b8fac8d9752058",22855693,1,-3,0,88,37,36,-1
"7040a13096d746ac84b8fac8d9752058","9a0dc646f934470daf08c4b56ccf73db",22855693,1,3,0,89,36,37,1
"9a0dc646f934470daf08c4b56ccf73db","fc0e049d56024bc9a02c9a9c435c3df7",22855693,1,3,0,90,37,38,1
"fc0e049d56024bc9a02c9a9c435c3df7","fc0e049d56024bc9a02c9a9c435c3df7",22855693,1,0,1,91,38,38,0
"fc0e049d56024bc9a02c9a9c435c3df7","67a089198fcb4e1c8f2385786c2b296f",22855693,1,4,0,92,38,39,1
"b534b89233134e30a9b5645138bfa9ee","296fbfa7fce5408484f55d759d80d7b7",22855693,1,2,0,96,41,43,2
"67a089198fcb4e1c8f2385786c2b296f","296fbfa7fce5408484f55d759d80d7b7",22855693,1,6,0,100,39,43,4
"296fbfa7fce5408484f55d759d80d7b7","296fbfa7fce5408484f55d759d80d7b7",22855693,2,0,1,101,43,43,0
"296fbfa7fce5408484f55d759d80d7b7","b534b89233134e30a9b5645138bfa9ee",22855693,2,-2,0,102,43,41,-2
"b534b89233134e30a9b5645138bfa9ee","67a089198fcb4e1c8f2385786c2b296f",22855693,6,-4,0,103,41,39,-2
"67a089198fcb4e1c8f2385786c2b296f","b534b89233134e30a9b5645138bfa9ee",22855693,7,4,0,104,39,41,2
"b534b89233134e30a9b5645138bfa9ee","b534b89233134e30a9b5645138bfa9ee",22855693,3,0,1,105,41,41,0
"b534b89233134e30a9b5645138bfa9ee","64d48c6c9c7940639a932219a6c87198",22855693,1,-3,0,108,41,40,-1
"64d48c6c9c7940639a932219a6c87198","64d48c6c9c7940639a932219a6c87198",22855693,3,0,1,109,40,40,0
"64d48c6c9c7940639a932219a6c87198","67a089198fcb4e1c8f2385786c2b296f",22855693,3,-1,0,110,40,39,-1
"67a089198fcb4e1c8f2385786c2b296f","67a089198fcb4e1c8f2385786c2b296f",22855693,3,0,1,114,39,39,0
"67a089198fcb4e1c8f2385786c2b296f","64d48c6c9c7940639a932219a6c87198",22855693,3,1,0,115,39,40,1
"64d48c6c9c7940639a932219a6c87198","b534b89233134e30a9b5645138bfa9ee",22855693,1,3,0,116,40,41,1
"67a089198fcb4e1c8f2385786c2b296f","0e37b720d23b4e7f8b313e79313fd107",22855693,1,7,0,118,39,44,5
"0e37b720d23b4e7f8b313e79313fd107","0e37b720d23b4e7f8b313e79313fd107",22855693,1,0,1,119,44,44,0
"0e37b720d23b4e7f8b313e79313fd107","6875d67fdd5f48168b62719df449bebd",22855693,1,1,0,120,44,45,1
"6875d67fdd5f48168b62719df449bebd","6875d67fdd5f48168b62719df449bebd",22855693,1,0,1,121,45,45,0
"6875d67fdd5f48168b62719df449bebd","b534b89233134e30a9b5645138bfa9ee",22855693,1,-4,0,122,45,41,-4
"b534b89233134e30a9b5645138bfa9ee","6e13d61a7bdb44bca949c9f86fab3be5",22855693,3,7,0,123,41,47,6
"6e13d61a7bdb44bca949c9f86fab3be5","6e13d61a7bdb44bca949c9f86fab3be5",22855693,11,0,1,124,47,47,0
"6e13d61a7bdb44bca949c9f86fab3be5","195f78799f984cc2b06c48dfe36be751",22855693,1,2,0,125,47,49,2
"195f78799f984cc2b06c48dfe36be751","195f78799f984cc2b06c48dfe36be751",22855693,2,0,1,126,49,49,0
"195f78799f984cc2b06c48dfe36be751","d9c8d8c444a64dadbbb508652c721e17",22855693,1,-3,0,128,49,46,-3
"d9c8d8c444a64dadbbb508652c721e17","d0c74f735e024943943e40333d6d337f",22855693,2,6,0,129,46,51,5
"d0c74f735e024943943e40333d6d337f","d0c74f735e024943943e40333d6d337f",22855693,3,0,1,130,51,51,0
"d0c74f735e024943943e40333d6d337f","983f8ff320594b279a7f4a6fe132f9c5",22855693,1,2,0,131,51,53,2
"983f8ff320594b279a7f4a6fe132f9c5","983f8ff320594b279a7f4a6fe132f9c5",22855693,2,0,1,132,53,53,0
"983f8ff320594b279a7f4a6fe132f9c5","35adfa5d923046aebabfefd98f35ff05",22855693,1,1,0,134,53,54,1
"35adfa5d923046aebabfefd98f35ff05","35adfa5d923046aebabfefd98f35ff05",22855693,2,0,1,135,54,54,0
"35adfa5d923046aebabfefd98f35ff05","b6f8a98476224da1b40e555ececc7ed8",22855693,1,1,0,137,54,55,1
"b6f8a98476224da1b40e555ececc7ed8","b6f8a98476224da1b40e555ececc7ed8",22855693,2,0,1,138,55,55,0
"b6f8a98476224da1b40e555ececc7ed8","86e22cb5fe0e4b47a9489ecddf7ed78f",22855693,1,1,0,140,55,56,1
"86e22cb5fe0e4b47a9489ecddf7ed78f","86e22cb5fe0e4b47a9489ecddf7ed78f",22855693,2,0,1,141,56,56,0
"86e22cb5fe0e4b47a9489ecddf7ed78f","78f30e4dcac84e3cbea8b2cc6e0d62b3",22855693,1,4,0,143,56,59,3
"78f30e4dcac84e3cbea8b2cc6e0d62b3","a1f2f12debe5432fb7a70bcd12bacfb9",22855693,1,-1,0,144,59,58,-1
"a1f2f12debe5432fb7a70bcd12bacfb9","f924752d8a1149668870b1e7698486f7",22855693,1,-9,0,145,58,50,-8
"f924752d8a1149668870b1e7698486f7","a1f2f12debe5432fb7a70bcd12bacfb9",22855693,2,9,0,146,50,58,8
"a1f2f12debe5432fb7a70bcd12bacfb9","a1f2f12debe5432fb7a70bcd12bacfb9",22855693,33,0,1,147,58,58,0
"a1f2f12debe5432fb7a70bcd12bacfb9","b534b89233134e30a9b5645138bfa9ee",22855693,1,-20,0,172,58,41,-17
"b534b89233134e30a9b5645138bfa9ee","f924752d8a1149668870b1e7698486f7",22855693,2,11,0,174,41,50,9
"f924752d8a1149668870b1e7698486f7","d0c74f735e024943943e40333d6d337f",22855693,2,1,0,175,50,51,1
"d0c74f735e024943943e40333d6d337f","67a089198fcb4e1c8f2385786c2b296f",22855693,1,-16,0,176,51,39,-12
"b534b89233134e30a9b5645138bfa9ee","7af822066add4e7f8e007e4eee31a8bf",22855693,1,29,0,178,41,65,24
"7af822066add4e7f8e007e4eee31a8bf","67a089198fcb4e1c8f2385786c2b296f",22855693,1,-33,0,179,65,39,-26
"b534b89233134e30a9b5645138bfa9ee","d9c8d8c444a64dadbbb508652c721e17",22855693,1,6,0,181,41,46,5
"d9c8d8c444a64dadbbb508652c721e17","6e13d61a7bdb44bca949c9f86fab3be5",22855693,1,1,0,182,46,47,1
"6e13d61a7bdb44bca949c9f86fab3be5","b534b89233134e30a9b5645138bfa9ee",22855693,2,-7,0,183,47,41,-6
"d0c74f735e024943943e40333d6d337f","c33c17be71ae4d588da7369472e5bb1b",22855693,1,-32,0,186,51,34,-17
"c33c17be71ae4d588da7369472e5bb1b","c33c17be71ae4d588da7369472e5bb1b",22855693,2,0,1,187,34,34,0
"c33c17be71ae4d588da7369472e5bb1b","7af822066add4e7f8e007e4eee31a8bf",22855693,1,49,0,188,34,65,31
"7af822066add4e7f8e007e4eee31a8bf","7af822066add4e7f8e007e4eee31a8bf",22855693,1,0,1,189,65,65,0
"7af822066add4e7f8e007e4eee31a8bf","b534b89233134e30a9b5645138bfa9ee",22855693,1,-29,0,190,65,41,-24
"6e13d61a7bdb44bca949c9f86fab3be5","d0c74f735e024943943e40333d6d337f",22855693,1,5,0,211,47,51,4
"d0c74f735e024943943e40333d6d337f","d9c8d8c444a64dadbbb508652c721e17",22855693,1,-6,0,212,51,46,-5
"d0c74f735e024943943e40333d6d337f","a1f2f12debe5432fb7a70bcd12bacfb9",22855693,1,8,0,216,51,58,7
"a1f2f12debe5432fb7a70bcd12bacfb9","78f30e4dcac84e3cbea8b2cc6e0d62b3",22855693,2,1,0,217,58,59,1
"78f30e4dcac84e3cbea8b2cc6e0d62b3","f924752d8a1149668870b1e7698486f7",22855693,1,-10,0,218,59,50,-9
"78f30e4dcac84e3cbea8b2cc6e0d62b3","78f30e4dcac84e3cbea8b2cc6e0d62b3",22855693,7,0,1,229,59,59,0
"78f30e4dcac84e3cbea8b2cc6e0d62b3","12aa6e1672ac4e7aa6449a7a8609cd72",22855693,1,-2,0,236,59,57,-2
"12aa6e1672ac4e7aa6449a7a8609cd72","bc42d26810654ea9a1df1efe1e58c7d5",22855693,1,7,0,237,57,63,6
"bc42d26810654ea9a1df1efe1e58c7d5","a0a418b8540d479fa6e0f653b701da8b",22855693,2,1,0,238,63,64,1
"a0a418b8540d479fa6e0f653b701da8b","4c943503763e4e349906eea3ed3c8e86",22855693,1,-3,0,239,64,61,-3
"4c943503763e4e349906eea3ed3c8e86","4c943503763e4e349906eea3ed3c8e86",22855693,1,0,1,240,61,61,0
"4c943503763e4e349906eea3ed3c8e86","bc42d26810654ea9a1df1efe1e58c7d5",22855693,1,2,0,241,61,63,2
"bc42d26810654ea9a1df1efe1e58c7d5","bc42d26810654ea9a1df1efe1e58c7d5",22855693,3,0,1,242,63,63,0
"a0a418b8540d479fa6e0f653b701da8b","a0a418b8540d479fa6e0f653b701da8b",22855693,3,0,1,246,64,64,0
"a0a418b8540d479fa6e0f653b701da8b","309ccf3cc4fe429d9bfbaef53d3fa479",22855693,1,-4,0,249,64,60,-4
"309ccf3cc4fe429d9bfbaef53d3fa479","d646286c8051419bbc2e31dd1db55ca8",22855693,1,10,0,250,60,67,7
"d646286c8051419bbc2e31dd1db55ca8","b534b89233134e30a9b5645138bfa9ee",22855693,1,-33,0,251,67,41,-26
"b534b89233134e30a9b5645138bfa9ee","267f883678b24aed855fde42524975d9",22855693,1,37,0,252,41,71,30
"267f883678b24aed855fde42524975d9","267f883678b24aed855fde42524975d9",22855693,3,0,1,253,71,71,0
"267f883678b24aed855fde42524975d9","88fff56d0342490dbef9040750a20f6c",22855693,1,1,0,256,71,72,1
"88fff56d0342490dbef9040750a20f6c","88fff56d0342490dbef9040750a20f6c",22855693,1,0,1,257,72,72,0
"88fff56d0342490dbef9040750a20f6c","adb17b12b66c4a49a85fd34322f7df70",22855693,1,1,0,258,72,73,1
"adb17b12b66c4a49a85fd34322f7df70","adb17b12b66c4a49a85fd34322f7df70",22855693,1,0,1,259,73,73,0
"adb17b12b66c4a49a85fd34322f7df70","d646286c8051419bbc2e31dd1db55ca8",22855693,1,-6,0,260,73,67,-6
"d646286c8051419bbc2e31dd1db55ca8","a2becd407db34b189200a32546d9d569",22855693,4,9,0,261,67,75,8
"a2becd407db34b189200a32546d9d569","d646286c8051419bbc2e31dd1db55ca8",22855693,4,-9,0,262,75,67,-8
"d646286c8051419bbc2e31dd1db55ca8","d646286c8051419bbc2e31dd1db55ca8",22855693,1,0,1,263,67,67,0
"d646286c8051419bbc2e31dd1db55ca8","190fc0dbe34c41668fe10597f5802ed4",22855693,1,10,0,266,67,76,9
"190fc0dbe34c41668fe10597f5802ed4","190fc0dbe34c41668fe10597f5802ed4",22855693,1,0,1,267,76,76,0
"190fc0dbe34c41668fe10597f5802ed4","a2becd407db34b189200a32546d9d569",22855693,1,-1,0,268,76,75,-1
"a2becd407db34b189200a32546d9d569","a2becd407db34b189200a32546d9d569",22855693,1,0,1,269,75,75,0
"a2becd407db34b189200a32546d9d569","58c22b011d0f4c2ea6d13615edbb9eeb",22855693,1,2,0,274,75,77,2
"58c22b011d0f4c2ea6d13615edbb9eeb","58c22b011d0f4c2ea6d13615edbb9eeb",22855693,11,0,1,275,77,77,0
"58c22b011d0f4c2ea6d13615edbb9eeb","dd76e1861dc9461c830888729d091ee0",22855693,1,1,0,286,77,78,1
"dd76e1861dc9461c830888729d091ee0","dd76e1861dc9461c830888729d091ee0",22855693,8,0,1,287,78,78,0
"dd76e1861dc9461c830888729d091ee0","cd1d828f1a694b87913a7ea66c23803e",22855693,1,1,0,295,78,79,1
"cd1d828f1a694b87913a7ea66c23803e","cd1d828f1a694b87913a7ea66c23803e",22855693,8,0,1,296,79,79,0
"cd1d828f1a694b87913a7ea66c23803e","9176a3c2b4d2465fa8b0c67096c2a97e",22855693,1,1,0,304,79,80,1
"9176a3c2b4d2465fa8b0c67096c2a97e","9176a3c2b4d2465fa8b0c67096c2a97e",22855693,5,0,1,305,80,80,0
"9176a3c2b4d2465fa8b0c67096c2a97e","f8ec6445f7194e25b9101d4fbcb07a18",22855693,1,1,0,310,80,81,1
"f8ec6445f7194e25b9101d4fbcb07a18","f8ec6445f7194e25b9101d4fbcb07a18",22855693,2,0,1,311,81,81,0
"f8ec6445f7194e25b9101d4fbcb07a18","140d5b27b8574befad82c0a013b59dfa",22855693,1,-7,0,313,81,74,-7
"140d5b27b8574befad82c0a013b59dfa","d18a9ea32855445f8736581f5cb119ce",22855693,1,9,0,314,74,82,8
"d18a9ea32855445f8736581f5cb119ce","ae5ac430ea254e708a6f5deaaf7464ae",22855693,1,3,0,315,82,84,2
"ae5ac430ea254e708a6f5deaaf7464ae","d18a9ea32855445f8736581f5cb119ce",22855693,1,-3,0,316,84,82,-2
"d18a9ea32855445f8736581f5cb119ce","f564483cbd7a407681aa2fcca518cf5f",22855693,1,4,0,317,82,85,3
"f564483cbd7a407681aa2fcca518cf5f","f564483cbd7a407681aa2fcca518cf5f",22855693,4,0,1,318,85,85,0
"f564483cbd7a407681aa2fcca518cf5f","18fd01350bd5434ca636d59a599d768a",22855693,1,1,0,322,85,86,1
"18fd01350bd5434ca636d59a599d768a","18fd01350bd5434ca636d59a599d768a",22855693,9,0,1,323,86,86,0
"18fd01350bd5434ca636d59a599d768a","6a9f0ef185fb47f0937e29daa1c71ed5",22855693,1,5,0,332,86,90,4
"6a9f0ef185fb47f0937e29daa1c71ed5","ae5ac430ea254e708a6f5deaaf7464ae",22855693,1,-7,0,333,90,84,-6
"ae5ac430ea254e708a6f5deaaf7464ae","d646286c8051419bbc2e31dd1db55ca8",22855693,1,-20,0,334,84,67,-17
"d646286c8051419bbc2e31dd1db55ca8","e20db35ced8544ddac5bc3839145e463",22855693,1,30,0,335,67,91,24
"e20db35ced8544ddac5bc3839145e463","1febb706d7a34005ae8711ed49c76e64",22855693,1,3,0,336,91,94,3
"1febb706d7a34005ae8711ed49c76e64","1febb706d7a34005ae8711ed49c76e64",22855693,2,0,1,337,94,94,0
"1febb706d7a34005ae8711ed49c76e64","8f73ba6f5a0042f2850356ac38ac6f24",22855693,1,1,0,339,94,95,1
"8f73ba6f5a0042f2850356ac38ac6f24","8f73ba6f5a0042f2850356ac38ac6f24",22855693,5,0,1,340,95,95,0
"8f73ba6f5a0042f2850356ac38ac6f24","e2260b86653c46d7b14a41fb419dbf8c",22855693,1,1,0,345,95,96,1
"e2260b86653c46d7b14a41fb419dbf8c","e2260b86653c46d7b14a41fb419dbf8c",22855693,2,0,1,346,96,96,0
"e2260b86653c46d7b14a41fb419dbf8c","35eb641ad1d845bbba54915bce75a962",22855693,1,1,0,348,96,97,1
"35eb641ad1d845bbba54915bce75a962","35eb641ad1d845bbba54915bce75a962",22855693,2,0,1,349,97,97,0
"35eb641ad1d845bbba54915bce75a962","08be90ffbeea4795a138cd42ed8db56f",22855693,1,1,0,351,97,98,1
"08be90ffbeea4795a138cd42ed8db56f","08be90ffbeea4795a138cd42ed8db56f",22855693,5,0,1,352,98,98,0
"08be90ffbeea4795a138cd42ed8db56f","3007433c8f584dcbb5ac159c1c5f2be3",22855693,1,1,0,357,98,99,1
"3007433c8f584dcbb5ac159c1c5f2be3","3007433c8f584dcbb5ac159c1c5f2be3",22855693,5,0,1,358,99,99,0
"3007433c8f584dcbb5ac159c1c5f2be3","d391c8b6e56a43a7b654e9dee02d904b",22855693,1,5,0,363,99,103,4
"d391c8b6e56a43a7b654e9dee02d904b","e20db35ced8544ddac5bc3839145e463",22855693,2,-13,0,364,103,91,-12
"e20db35ced8544ddac5bc3839145e463","00ae5f0c51874a73a41ebea838d95682",22855693,2,11,0,365,91,101,10
"00ae5f0c51874a73a41ebea838d95682","e20db35ced8544ddac5bc3839145e463",22855693,3,-11,0,366,101,91,-10
"e20db35ced8544ddac5bc3839145e463","d391c8b6e56a43a7b654e9dee02d904b",22855693,1,13,0,369,91,103,12
"e20db35ced8544ddac5bc3839145e463","73039f8c1eb9409cb4caee2cf968001e",22855693,1,10,0,371,91,100,9
"73039f8c1eb9409cb4caee2cf968001e","73039f8c1eb9409cb4caee2cf968001e",22855693,1,0,1,372,100,100,0
"73039f8c1eb9409cb4caee2cf968001e","00ae5f0c51874a73a41ebea838d95682",22855693,1,1,0,373,100,101,1
"00ae5f0c51874a73a41ebea838d95682","d391c8b6e56a43a7b654e9dee02d904b",22855693,3,2,0,374,101,103,2
"d391c8b6e56a43a7b654e9dee02d904b","00ae5f0c51874a73a41ebea838d95682",22855693,2,-2,0,375,103,101,-2
"00ae5f0c51874a73a41ebea838d95682","00ae5f0c51874a73a41ebea838d95682",22855693,3,0,1,376,101,101,0
"e20db35ced8544ddac5bc3839145e463","b38af1a65bd14ea886d608e701505bcf",22855693,1,12,0,379,91,102,11
"b38af1a65bd14ea886d608e701505bcf","b38af1a65bd14ea886d608e701505bcf",22855693,1,0,1,380,102,102,0
"b38af1a65bd14ea886d608e701505bcf","00ae5f0c51874a73a41ebea838d95682",22855693,1,-1,0,381,102,101,-1
"d391c8b6e56a43a7b654e9dee02d904b","d391c8b6e56a43a7b654e9dee02d904b",22855693,15,0,1,386,103,103,0
"d391c8b6e56a43a7b654e9dee02d904b","6111116566fc4fd9abba409322bea245",22855693,1,1,0,401,103,104,1
"6111116566fc4fd9abba409322bea245","6111116566fc4fd9abba409322bea245",22855693,2,0,1,402,104,104,0
"6111116566fc4fd9abba409322bea245","a81b2235cb9c499eb9ea8ee0a8dd9725",22855693,1,1,0,404,104,105,1
"a81b2235cb9c499eb9ea8ee0a8dd9725","a81b2235cb9c499eb9ea8ee0a8dd9725",22855693,2,0,1,405,105,105,0
"a81b2235cb9c499eb9ea8ee0a8dd9725","2d4e0ab0ef3b4d73b82c72d4621a7579",22855693,1,1,0,407,105,106,1
"2d4e0ab0ef3b4d73b82c72d4621a7579","2d4e0ab0ef3b4d73b82c72d4621a7579",22855693,2,0,1,408,106,106,0
"2d4e0ab0ef3b4d73b82c72d4621a7579","8bdebf492ebd4e62b0d522e8ab5e5197",22855693,1,1,0,410,106,107,1
"8bdebf492ebd4e62b0d522e8ab5e5197","8bdebf492ebd4e62b0d522e8ab5e5197",22855693,5,0,1,411,107,107,0
"8bdebf492ebd4e62b0d522e8ab5e5197","73039f8c1eb9409cb4caee2cf968001e",22855693,1,-7,0,416,107,100,-7
"73039f8c1eb9409cb4caee2cf968001e","4280927ec4d643238aa49c32f9e06c6c",22855693,1,10,0,417,100,109,9
"4280927ec4d643238aa49c32f9e06c6c","4280927ec4d643238aa49c32f9e06c6c",22855693,1,0,1,418,109,109,0
"4280927ec4d643238aa49c32f9e06c6c","fc44e6a5f7654430af1227838224dceb",22855693,1,2,0,419,109,111,2
"fc44e6a5f7654430af1227838224dceb","fc44e6a5f7654430af1227838224dceb",22855693,2,0,1,420,111,111,0
"fc44e6a5f7654430af1227838224dceb","a9ae0a3c070d455bb4369a8996313336",22855693,1,4,0,422,111,114,3
"a9ae0a3c070d455bb4369a8996313336","08111f75e22d409998cf8b85bd431f0a",22855693,1,-7,0,423,114,108,-6
"08111f75e22d409998cf8b85bd431f0a","a9ae0a3c070d455bb4369a8996313336",22855693,1,7,0,424,108,114,6
"a9ae0a3c070d455bb4369a8996313336","71cec822bcff4f30a20e75dc63ef7b65",22855693,1,2,0,425,114,116,2
"71cec822bcff4f30a20e75dc63ef7b65","71cec822bcff4f30a20e75dc63ef7b65",22855693,9,0,1,426,116,116,0
"71cec822bcff4f30a20e75dc63ef7b65","62bff51286ef4f348717a3cf6fe2318f",22855693,1,5,0,435,116,120,4
"62bff51286ef4f348717a3cf6fe2318f","37319e88176d4aefa91d7a9980dbae91",22855693,1,-9,0,436,120,112,-8
"37319e88176d4aefa91d7a9980dbae91","b1cd0e7dc3ad4a8eb91a4bfdbeb025b0",22855693,1,7,0,437,112,118,6
"b1cd0e7dc3ad4a8eb91a4bfdbeb025b0","b1cd0e7dc3ad4a8eb91a4bfdbeb025b0",22855693,1,0,1,438,118,118,0
"b1cd0e7dc3ad4a8eb91a4bfdbeb025b0","779f9ddd1fd14d1e9e69f72219a1fdbd",22855693,1,5,0,439,118,121,3
"779f9ddd1fd14d1e9e69f72219a1fdbd","e20db35ced8544ddac5bc3839145e463",22855693,1,-36,0,440,121,91,-30
"e20db35ced8544ddac5bc3839145e463","ae26e6cda8ad4a3f81bd347560d9579f",22855693,1,40,0,441,91,125,34
"ae26e6cda8ad4a3f81bd347560d9579f","ae26e6cda8ad4a3f81bd347560d9579f",22855693,1,0,1,442,125,125,0
"ae26e6cda8ad4a3f81bd347560d9579f","ee48df95832b4374aa273ceb27ec1315",22855693,1,1,0,443,125,126,1
"ee48df95832b4374aa273ceb27ec1315","ee48df95832b4374aa273ceb27ec1315",22855693,1,0,1,444,126,126,0
"ee48df95832b4374aa273ceb27ec1315","7a439da90b394756ad1777fc4c6dead5",22855693,1,1,0,445,126,127,1
"7a439da90b394756ad1777fc4c6dead5","7a439da90b394756ad1777fc4c6dead5",22855693,1,0,1,446,127,127,0
"7a439da90b394756ad1777fc4c6dead5","779f9ddd1fd14d1e9e69f72219a1fdbd",22855693,1,-6,0,447,127,121,-6
"779f9ddd1fd14d1e9e69f72219a1fdbd","a8dd5213034441ac92724b4e83eb0bb2",22855693,2,9,0,448,121,129,8
"a8dd5213034441ac92724b4e83eb0bb2","a8dd5213034441ac92724b4e83eb0bb2",22855693,5,0,1,449,129,129,0
"a8dd5213034441ac92724b4e83eb0bb2","779f9ddd1fd14d1e9e69f72219a1fdbd",22855693,1,-9,0,452,129,121,-8
"779f9ddd1fd14d1e9e69f72219a1fdbd","779f9ddd1fd14d1e9e69f72219a1fdbd",22855693,2,0,1,453,121,121,0
"a8dd5213034441ac92724b4e83eb0bb2","8115eab6556b45f5b415c3b8c26a12e5",22855693,1,2,0,458,129,131,2
"8115eab6556b45f5b415c3b8c26a12e5","8115eab6556b45f5b415c3b8c26a12e5",22855693,2,0,1,459,131,131,0
"8115eab6556b45f5b415c3b8c26a12e5","ec34b06efd844b46a4c4818ecdb9b8f4",22855693,1,1,0,461,131,132,1
"ec34b06efd844b46a4c4818ecdb9b8f4","ec34b06efd844b46a4c4818ecdb9b8f4",22855693,2,0,1,462,132,132,0
"ec34b06efd844b46a4c4818ecdb9b8f4","c2e1c2b9eac64109b343a088584b576b",22855693,1,1,0,464,132,133,1
"c2e1c2b9eac64109b343a088584b576b","c2e1c2b9eac64109b343a088584b576b",22855693,2,0,1,465,133,133,0
"c2e1c2b9eac64109b343a088584b576b","579338175e0b4bbb8ef3b712b5d8b54e",22855693,1,-5,0,467,133,128,-5
"579338175e0b4bbb8ef3b712b5d8b54e","b416d47c56a742199b5d7c7f19d6503a",22855693,1,7,0,468,128,134,6
"b416d47c56a742199b5d7c7f19d6503a","f661500307d74c908e9207d949ceb4aa",22855693,1,3,0,469,134,136,2
"f661500307d74c908e9207d949ceb4aa","8bc5795d6a984a3eace4e2811e52dd4f",22855693,1,-2,0,470,136,135,-1
"8bc5795d6a984a3eace4e2811e52dd4f","8bc5795d6a984a3eace4e2811e52dd4f",22855693,1,0,1,471,135,135,0
"8bc5795d6a984a3eace4e2811e52dd4f","b416d47c56a742199b5d7c7f19d6503a",22855693,1,-1,0,472,135,134,-1
"b416d47c56a742199b5d7c7f19d6503a","779f9ddd1fd14d1e9e69f72219a1fdbd",22855693,1,-15,0,473,134,121,-13
"779f9ddd1fd14d1e9e69f72219a1fdbd","f661500307d74c908e9207d949ceb4aa",22855693,1,18,0,474,121,136,15
"f661500307d74c908e9207d949ceb4aa","f661500307d74c908e9207d949ceb4aa",22855693,1,0,1,475,136,136,0
"f661500307d74c908e9207d949ceb4aa","cd4532ad48034873ba8bce2aac0c9808",22855693,1,1,0,476,136,137,1
"cd4532ad48034873ba8bce2aac0c9808","cd4532ad48034873ba8bce2aac0c9808",22855693,1,0,1,477,137,137,0
"cd4532ad48034873ba8bce2aac0c9808","779f9ddd1fd14d1e9e69f72219a1fdbd",22855693,1,-19,0,478,137,121,-16
"779f9ddd1fd14d1e9e69f72219a1fdbd","df1de691dafe4549a18a4398ee9dfaf9",22855693,1,23,0,479,121,139,18
"df1de691dafe4549a18a4398ee9dfaf9","6c5ad271a44743479bfaea29b1db8d02",22855693,3,4,0,480,139,143,4
"6c5ad271a44743479bfaea29b1db8d02","e9312892f6234d46afcb2e1369d2d4ed",22855693,1,-3,0,481,143,140,-3
"e9312892f6234d46afcb2e1369d2d4ed","e9312892f6234d46afcb2e1369d2d4ed",22855693,1,0,1,482,140,140,0
"e9312892f6234d46afcb2e1369d2d4ed","df1de691dafe4549a18a4398ee9dfaf9",22855693,1,-1,0,483,140,139,-1
"6c5ad271a44743479bfaea29b1db8d02","6c5ad271a44743479bfaea29b1db8d02",22855693,3,0,1,485,143,143,0
"6c5ad271a44743479bfaea29b1db8d02","83d311bed5374fee83d8d67a7d9d82dc",22855693,1,1,0,488,143,144,1
"83d311bed5374fee83d8d67a7d9d82dc","83d311bed5374fee83d8d67a7d9d82dc",22855693,1,0,1,489,144,144,0
"83d311bed5374fee83d8d67a7d9d82dc","402bba41861d43acb52a5abb89e8831e",22855693,1,1,0,490,144,145,1
"402bba41861d43acb52a5abb89e8831e","402bba41861d43acb52a5abb89e8831e",22855693,2,0,1,491,145,145,0
"402bba41861d43acb52a5abb89e8831e","8aae34f5ddbb4052a709b12e6b0d40fa",22855693,1,3,0,493,145,147,2
"8aae34f5ddbb4052a709b12e6b0d40fa","df1de691dafe4549a18a4398ee9dfaf9",22855693,2,-9,0,494,147,139,-8
"df1de691dafe4549a18a4398ee9dfaf9","df1de691dafe4549a18a4398ee9dfaf9",22855693,1,0,1,495,139,139,0
"6c5ad271a44743479bfaea29b1db8d02","8aae34f5ddbb4052a709b12e6b0d40fa",22855693,1,5,0,497,143,147,4
"df1de691dafe4549a18a4398ee9dfaf9","6cb6ef2fb4224f9f94891094577870fd",22855693,1,10,0,499,139,148,9
"6cb6ef2fb4224f9f94891094577870fd","6cb6ef2fb4224f9f94891094577870fd",22855693,1,0,1,500,148,148,0
"6cb6ef2fb4224f9f94891094577870fd","df1de691dafe4549a18a4398ee9dfaf9",22855693,1,-10,0,501,148,139,-9
"df1de691dafe4549a18a4398ee9dfaf9","8aae34f5ddbb4052a709b12e6b0d40fa",22855693,1,9,0,502,139,147,8
"8aae34f5ddbb4052a709b12e6b0d40fa","8aae34f5ddbb4052a709b12e6b0d40fa",22855693,1,0,1,503,147,147,0
"8aae34f5ddbb4052a709b12e6b0d40fa","645b3f0249f64f76af2e19eb4d0e55b7",22855693,1,2,0,504,147,149,2
"645b3f0249f64f76af2e19eb4d0e55b7","645b3f0249f64f76af2e19eb4d0e55b7",22855693,10,0,1,505,149,149,0
"645b3f0249f64f76af2e19eb4d0e55b7","7e7b8db5064d4369805ab370aac5ddfb",22855693,1,1,0,515,149,150,1
"7e7b8db5064d4369805ab370aac5ddfb","7e7b8db5064d4369805ab370aac5ddfb",22855693,8,0,1,516,150,150,0
"7e7b8db5064d4369805ab370aac5ddfb","8956d210ae7f41968fada86d4c979d6a",22855693,1,1,0,524,150,151,1
"8956d210ae7f41968fada86d4c979d6a","8956d210ae7f41968fada86d4c979d6a",22855693,2,0,1,525,151,151,0
"8956d210ae7f41968fada86d4c979d6a","f902b0f41b544d4dbf79664fd233648d",22855693,1,-5,0,527,151,146,-5
"f902b0f41b544d4dbf79664fd233648d","ae781e8b775e4ccd93bc800dad5c8376",22855693,1,8,0,528,146,153,7
"ae781e8b775e4ccd93bc800dad5c8376","ae781e8b775e4ccd93bc800dad5c8376",22855693,2,0,1,529,153,153,0
"ae781e8b775e4ccd93bc800dad5c8376","06882a8492d9499aa31555567f575ecb",22855693,1,1,0,531,153,154,1
"06882a8492d9499aa31555567f575ecb","06882a8492d9499aa31555567f575ecb",22855693,1,0,1,532,154,154,0
"06882a8492d9499aa31555567f575ecb","f293c508f409466a8f27ddd7d1e40b20",22855693,1,1,0,533,154,155,1
"f293c508f409466a8f27ddd7d1e40b20","f293c508f409466a8f27ddd7d1e40b20",22855693,2,0,1,534,155,155,0
"f293c508f409466a8f27ddd7d1e40b20","cc4ddef5bbbe48ebb605141b347c4ed1",22855693,1,1,0,536,155,156,1
"cc4ddef5bbbe48ebb605141b347c4ed1","cc4ddef5bbbe48ebb605141b347c4ed1",22855693,3,0,1,537,156,156,0
"cc4ddef5bbbe48ebb605141b347c4ed1","f03480cf4eba413194d7af52fc0e7f28",22855693,1,-4,0,540,156,152,-4
"f03480cf4eba413194d7af52fc0e7f28","d313cec988a84645bee413e8d4724a4b",22855693,1,7,0,541,152,158,6
"d313cec988a84645bee413e8d4724a4b","78adeee1fa2c4fe0bc73f7bca9fcee86",22855693,1,4,0,542,158,160,2
"78adeee1fa2c4fe0bc73f7bca9fcee86","df1de691dafe4549a18a4398ee9dfaf9",22855693,1,-26,0,543,160,139,-21
"df1de691dafe4549a18a4398ee9dfaf9","65202579580f4ad38d734b4ee39d22a8",22855693,1,31,0,544,139,164,25
"65202579580f4ad38d734b4ee39d22a8","65202579580f4ad38d734b4ee39d22a8",22855693,26,0,1,545,164,164,0
"65202579580f4ad38d734b4ee39d22a8","78adeee1fa2c4fe0bc73f7bca9fcee86",22855693,3,-5,0,549,164,160,-4
"78adeee1fa2c4fe0bc73f7bca9fcee86","65202579580f4ad38d734b4ee39d22a8",22855693,3,5,0,550,160,164,4
"78adeee1fa2c4fe0bc73f7bca9fcee86","78adeee1fa2c4fe0bc73f7bca9fcee86",22855693,8,0,1,554,160,160,0
"78adeee1fa2c4fe0bc73f7bca9fcee86","8959e6304a0348309a771e4d08d1b64a",22855693,2,4,0,558,160,163,3
"8959e6304a0348309a771e4d08d1b64a","65202579580f4ad38d734b4ee39d22a8",22855693,2,1,0,559,163,164,1
"65202579580f4ad38d734b4ee39d22a8","8959e6304a0348309a771e4d08d1b64a",22855693,1,-1,0,567,164,163,-1
"8959e6304a0348309a771e4d08d1b64a","a9ac840f098c4bd0a2ee896214ce29cd",22855693,1,9,0,568,163,168,5
"a9ac840f098c4bd0a2ee896214ce29cd","a9ac840f098c4bd0a2ee896214ce29cd",22855693,10,0,1,569,168,168,0
"a9ac840f098c4bd0a2ee896214ce29cd","78adeee1fa2c4fe0bc73f7bca9fcee86",22855693,1,-13,0,570,168,160,-8
"65202579580f4ad38d734b4ee39d22a8","a9ac840f098c4bd0a2ee896214ce29cd",22855693,1,8,0,583,164,168,4
"a9ac840f098c4bd0a2ee896214ce29cd","67a089198fcb4e1c8f2385786c2b296f",22855693,2,-165,0,586,168,39,-129
"67a089198fcb4e1c8f2385786c2b296f","a9ac840f098c4bd0a2ee896214ce29cd",22855693,1,165,0,588,39,168,129
"a9ac840f098c4bd0a2ee896214ce29cd","0c7262dff33c4087bc660ccf40f92f9c",22855693,2,4,0,592,168,169,1
"0c7262dff33c4087bc660ccf40f92f9c","b2275c3fad834f8d90737a2d9a6927d6",22855693,2,3,0,593,169,172,3
"b2275c3fad834f8d90737a2d9a6927d6","78adeee1fa2c4fe0bc73f7bca9fcee86",22855693,1,-20,0,594,172,160,-12
"65202579580f4ad38d734b4ee39d22a8","c33c17be71ae4d588da7369472e5bb1b",22855693,1,-173,0,604,164,34,-130
"c33c17be71ae4d588da7369472e5bb1b","a9ac840f098c4bd0a2ee896214ce29cd",22855693,1,181,0,606,34,168,134
"67a089198fcb4e1c8f2385786c2b296f","78adeee1fa2c4fe0bc73f7bca9fcee86",22855693,1,152,0,609,39,160,121
"78adeee1fa2c4fe0bc73f7bca9fcee86","a9ac840f098c4bd0a2ee896214ce29cd",22855693,1,13,0,611,160,168,8
"b2275c3fad834f8d90737a2d9a6927d6","b2275c3fad834f8d90737a2d9a6927d6",22855693,26,0,1,617,172,172,0
"b2275c3fad834f8d90737a2d9a6927d6","eb515a26030b41f8a82a1e6114420bad",22855693,1,1,0,643,172,173,1
"eb515a26030b41f8a82a1e6114420bad","eb515a26030b41f8a82a1e6114420bad",22855693,2,0,1,644,173,173,0
"eb515a26030b41f8a82a1e6114420bad","b42cc17b7de840f181a704558d0bc845",22855693,1,3,0,646,173,175,2
"b42cc17b7de840f181a704558d0bc845","0c7262dff33c4087bc660ccf40f92f9c",22855693,1,-7,0,647,175,169,-6
"0c7262dff33c4087bc660ccf40f92f9c","b42cc17b7de840f181a704558d0bc845",22855693,1,7,0,648,169,175,6
"67a089198fcb4e1c8f2385786c2b296f","67a089198fcb4e1c8f2385786c2b296f",22855683,1,0,1,1,39,39,0
"67a089198fcb4e1c8f2385786c2b296f","e2911e79efc2420eac45d9f671463d4b",22855683,1,-69,0,2,39,2,-37
"e2911e79efc2420eac45d9f671463d4b","b613861cecf84ffcab01afb23f660475",22855683,1,-3,0,4,2,1,-1
"b613861cecf84ffcab01afb23f660475","b613861cecf84ffcab01afb23f660475",22855683,6,0,1,10,1,1,0
"b613861cecf84ffcab01afb23f660475","e2911e79efc2420eac45d9f671463d4b",22855683,1,3,0,11,1,2,1
"e2911e79efc2420eac45d9f671463d4b","e2911e79efc2420eac45d9f671463d4b",22855683,3,0,1,12,2,2,0
"e2911e79efc2420eac45d9f671463d4b","519d1b8c59404d67b54e96c5c8a830b2",22855683,1,1,0,14,2,3,1
"519d1b8c59404d67b54e96c5c8a830b2","519d1b8c59404d67b54e96c5c8a830b2",22855683,1,0,1,15,3,3,0
"519d1b8c59404d67b54e96c5c8a830b2","531db53f81f646edb0cdcfe0085b03b7",22855683,1,1,0,16,3,4,1
"531db53f81f646edb0cdcfe0085b03b7","531db53f81f646edb0cdcfe0085b03b7",22855683,1,0,1,17,4,4,0
"531db53f81f646edb0cdcfe0085b03b7","4f5f94b2f95141e0a9d53a61da2276da",22855683,1,1,0,18,4,5,1
"4f5f94b2f95141e0a9d53a61da2276da","4f5f94b2f95141e0a9d53a61da2276da",22855683,1,0,1,19,5,5,0
"4f5f94b2f95141e0a9d53a61da2276da","6d541c89590949f99af293c4f2333f67",22855683,1,1,0,20,5,6,1
"6d541c89590949f99af293c4f2333f67","6d541c89590949f99af293c4f2333f67",22855683,1,0,1,21,6,6,0
"6d541c89590949f99af293c4f2333f67","dd5cf0b9fe4c4f1d8f5ff8e4c04879cb",22855683,1,1,0,22,6,7,1
"dd5cf0b9fe4c4f1d8f5ff8e4c04879cb","dd5cf0b9fe4c4f1d8f5ff8e4c04879cb",22855683,4,0,1,23,7,7,0
"dd5cf0b9fe4c4f1d8f5ff8e4c04879cb","f96261861edc426abe2248be4f0a709a",22855683,1,1,0,27,7,8,1
"f96261861edc426abe2248be4f0a709a","f96261861edc426abe2248be4f0a709a",22855683,5,0,1,28,8,8,0
"f96261861edc426abe2248be4f0a709a","66b5e16f4f75454fb5b8172079f0fa83",22855683,1,1,0,33,8,9,1
"66b5e16f4f75454fb5b8172079f0fa83","66b5e16f4f75454fb5b8172079f0fa83",22855683,4,0,1,34,9,9,0
"66b5e16f4f75454fb5b8172079f0fa83","0680571d4698477995e41842c36a54b2",22855683,1,1,0,38,9,10,1
"0680571d4698477995e41842c36a54b2","0680571d4698477995e41842c36a54b2",22855683,1,0,1,39,10,10,0
"0680571d4698477995e41842c36a54b2","9112f2bffece48e08c6d2287be204085",22855683,1,1,0,40,10,11,1
"9112f2bffece48e08c6d2287be204085","9112f2bffece48e08c6d2287be204085",22855683,1,0,1,41,11,11,0
"9112f2bffece48e08c6d2287be204085","56586aa865414f538729c7f7735d2bc6",22855683,1,3,0,42,11,12,1
"56586aa865414f538729c7f7735d2bc6","e2911e79efc2420eac45d9f671463d4b",22855683,1,-12,0,43,12,2,-10
"e2911e79efc2420eac45d9f671463d4b","56586aa865414f538729c7f7735d2bc6",22855683,1,12,0,44,2,12,10
"56586aa865414f538729c7f7735d2bc6","56586aa865414f538729c7f7735d2bc6",22855683,5,0,1,45,12,12,0
"56586aa865414f538729c7f7735d2bc6","b7f2b31585d94eb3bf86376714aa7070",22855683,1,2,0,48,12,13,1
"b7f2b31585d94eb3bf86376714aa7070","b7f2b31585d94eb3bf86376714aa7070",22855683,8,0,1,49,13,13,0
"b7f2b31585d94eb3bf86376714aa7070","3f1c815879794b929260d224becaff7e",22855683,1,2,0,57,13,14,1
"3f1c815879794b929260d224becaff7e","81c864a886d54a6b8ff85f7d736f4f95",22855683,1,2,0,58,14,15,1
"81c864a886d54a6b8ff85f7d736f4f95","5c5ceeee4562457ba6d41515aeebfbb1",22855683,1,4,0,59,15,17,2
"5c5ceeee4562457ba6d41515aeebfbb1","5c5ceeee4562457ba6d41515aeebfbb1",22855683,2,0,1,60,17,17,0
"5c5ceeee4562457ba6d41515aeebfbb1","56586aa865414f538729c7f7735d2bc6",22855683,1,-10,0,62,17,12,-5
"56586aa865414f538729c7f7735d2bc6","9afd71a5298d4333b6849dfce1b9422c",22855683,3,13,0,63,12,18,6
"9afd71a5298d4333b6849dfce1b9422c","56586aa865414f538729c7f7735d2bc6",22855683,4,-13,0,64,18,12,-6
"56586aa865414f538729c7f7735d2bc6","5c5ceeee4562457ba6d41515aeebfbb1",22855683,2,10,0,69,12,17,5
"5c5ceeee4562457ba6d41515aeebfbb1","9afd71a5298d4333b6849dfce1b9422c",22855683,2,3,0,70,17,18,1
"9afd71a5298d4333b6849dfce1b9422c","b7719e26494940efa49512aedd0aac79",22855683,3,4,0,71,18,20,2
"b7719e26494940efa49512aedd0aac79","b7719e26494940efa49512aedd0aac79",22855683,1,0,1,72,20,20,0
"b7719e26494940efa49512aedd0aac79","9afd71a5298d4333b6849dfce1b9422c",22855683,2,-4,0,73,20,18,-2
"9afd71a5298d4333b6849dfce1b9422c","9afd71a5298d4333b6849dfce1b9422c",22855683,5,0,1,74,18,18,0
"b7719e26494940efa49512aedd0aac79","d4f45188d3c84a02ba08454e6403a818",22855683,2,5,0,76,20,24,4
"d4f45188d3c84a02ba08454e6403a818","d4c3b003e8274e429d2fa688d73fde6d",22855683,2,-2,0,77,24,22,-2
"d4c3b003e8274e429d2fa688d73fde6d","b7719e26494940efa49512aedd0aac79",22855683,2,-3,0,78,22,20,-2
"d4c3b003e8274e429d2fa688d73fde6d","d4c3b003e8274e429d2fa688d73fde6d",22855683,2,0,1,92,22,22,0
"b7719e26494940efa49512aedd0aac79","afbf7250b99d47bea07172749483ca97",22855683,2,12,0,95,20,28,8
"afbf7250b99d47bea07172749483ca97","b7719e26494940efa49512aedd0aac79",22855683,1,-12,0,96,28,20,-8
"afbf7250b99d47bea07172749483ca97","afbf7250b99d47bea07172749483ca97",22855683,1,0,1,98,28,28,0
"afbf7250b99d47bea07172749483ca97","4e51676dc72045d99c19b9fa7b22f8bc",22855683,1,3,0,99,28,29,1
"4e51676dc72045d99c19b9fa7b22f8bc","4e51676dc72045d99c19b9fa7b22f8bc",22855683,2,0,1,100,29,29,0
"4e51676dc72045d99c19b9fa7b22f8bc","51970cfa30e643e894e66ae85c8024cc",22855683,1,3,0,102,29,31,2
"51970cfa30e643e894e66ae85c8024cc","4e51676dc72045d99c19b9fa7b22f8bc",22855683,1,-3,0,103,31,29,-2
"4e51676dc72045d99c19b9fa7b22f8bc","c33c17be71ae4d588da7369472e5bb1b",22855683,1,9,0,104,29,34,5
"c33c17be71ae4d588da7369472e5bb1b","93679be414554a11b1893002f2229a93",22855683,2,3,0,105,34,35,1
"93679be414554a11b1893002f2229a93","c33c17be71ae4d588da7369472e5bb1b",22855683,1,-3,0,106,35,34,-1
"93679be414554a11b1893002f2229a93","7040a13096d746ac84b8fac8d9752058",22855683,1,3,0,108,35,36,1
"7040a13096d746ac84b8fac8d9752058","7040a13096d746ac84b8fac8d9752058",22855683,1,0,1,109,36,36,0
"7040a13096d746ac84b8fac8d9752058","9a0dc646f934470daf08c4b56ccf73db",22855683,1,3,0,110,36,37,1
"9a0dc646f934470daf08c4b56ccf73db","9a0dc646f934470daf08c4b56ccf73db",22855683,1,0,1,111,37,37,0
"9a0dc646f934470daf08c4b56ccf73db","fc0e049d56024bc9a02c9a9c435c3df7",22855683,1,3,0,112,37,38,1
"fc0e049d56024bc9a02c9a9c435c3df7","fc0e049d56024bc9a02c9a9c435c3df7",22855683,1,0,1,113,38,38,0
"fc0e049d56024bc9a02c9a9c435c3df7","67a089198fcb4e1c8f2385786c2b296f",22855683,1,4,0,114,38,39,1
"67a089198fcb4e1c8f2385786c2b296f","64d48c6c9c7940639a932219a6c87198",22855683,1,1,0,115,39,40,1
"64d48c6c9c7940639a932219a6c87198","fc0e049d56024bc9a02c9a9c435c3df7",22855683,1,-5,0,116,40,38,-2
"67a089198fcb4e1c8f2385786c2b296f","b613861cecf84ffcab01afb23f660475",22856184,1,-72,0,1,39,1,-38
"b613861cecf84ffcab01afb23f660475","b613861cecf84ffcab01afb23f660475",22856184,4,0,1,2,1,1,0
"b613861cecf84ffcab01afb23f660475","e2911e79efc2420eac45d9f671463d4b",22856184,1,3,0,6,1,2,1
"e2911e79efc2420eac45d9f671463d4b","e2911e79efc2420eac45d9f671463d4b",22856184,2,0,1,7,2,2,0
"e2911e79efc2420eac45d9f671463d4b","519d1b8c59404d67b54e96c5c8a830b2",22856184,1,1,0,9,2,3,1
"519d1b8c59404d67b54e96c5c8a830b2","519d1b8c59404d67b54e96c5c8a830b2",22856184,1,0,1,10,3,3,0
"519d1b8c59404d67b54e96c5c8a830b2","531db53f81f646edb0cdcfe0085b03b7",22856184,1,1,0,11,3,4,1
"531db53f81f646edb0cdcfe0085b03b7","531db53f81f646edb0cdcfe0085b03b7",22856184,1,0,1,12,4,4,0
"531db53f81f646edb0cdcfe0085b03b7","4f5f94b2f95141e0a9d53a61da2276da",22856184,1,1,0,13,4,5,1
"4f5f94b2f95141e0a9d53a61da2276da","4f5f94b2f95141e0a9d53a61da2276da",22856184,1,0,1,14,5,5,0
"4f5f94b2f95141e0a9d53a61da2276da","6d541c89590949f99af293c4f2333f67",22856184,1,1,0,15,5,6,1
"6d541c89590949f99af293c4f2333f67","6d541c89590949f99af293c4f2333f67",22856184,1,0,1,16,6,6,0
"6d541c89590949f99af293c4f2333f67","dd5cf0b9fe4c4f1d8f5ff8e4c04879cb",22856184,1,1,0,17,6,7,1
"dd5cf0b9fe4c4f1d8f5ff8e4c04879cb","dd5cf0b9fe4c4f1d8f5ff8e4c04879cb",22856184,1,0,1,18,7,7,0
"dd5cf0b9fe4c4f1d8f5ff8e4c04879cb","f96261861edc426abe2248be4f0a709a",22856184,1,1,0,19,7,8,1
"f96261861edc426abe2248be4f0a709a","f96261861edc426abe2248be4f0a709a",22856184,1,0,1,20,8,8,0
"f96261861edc426abe2248be4f0a709a","66b5e16f4f75454fb5b8172079f0fa83",22856184,1,1,0,21,8,9,1
"66b5e16f4f75454fb5b8172079f0fa83","66b5e16f4f75454fb5b8172079f0fa83",22856184,1,0,1,22,9,9,0
"66b5e16f4f75454fb5b8172079f0fa83","0680571d4698477995e41842c36a54b2",22856184,1,1,0,23,9,10,1
"0680571d4698477995e41842c36a54b2","0680571d4698477995e41842c36a54b2",22856184,1,0,1,24,10,10,0
"0680571d4698477995e41842c36a54b2","9112f2bffece48e08c6d2287be204085",22856184,1,1,0,25,10,11,1
"9112f2bffece48e08c6d2287be204085","9112f2bffece48e08c6d2287be204085",22856184,1,0,1,26,11,11,0
"9112f2bffece48e08c6d2287be204085","e2911e79efc2420eac45d9f671463d4b",22856184,1,-9,0,27,11,2,-9
"e2911e79efc2420eac45d9f671463d4b","56586aa865414f538729c7f7735d2bc6",22856184,1,12,0,28,2,12,10
"56586aa865414f538729c7f7735d2bc6","56586aa865414f538729c7f7735d2bc6",22856184,3,0,1,29,12,12,0
"56586aa865414f538729c7f7735d2bc6","b7f2b31585d94eb3bf86376714aa7070",22856184,2,2,0,32,12,13,1
"b7f2b31585d94eb3bf86376714aa7070","56586aa865414f538729c7f7735d2bc6",22856184,1,-2,0,33,13,12,-1
"b7f2b31585d94eb3bf86376714aa7070","3f1c815879794b929260d224becaff7e",22856184,1,2,0,35,13,14,1
"3f1c815879794b929260d224becaff7e","81c864a886d54a6b8ff85f7d736f4f95",22856184,1,2,0,36,14,15,1
"81c864a886d54a6b8ff85f7d736f4f95","5c5ceeee4562457ba6d41515aeebfbb1",22856184,1,4,0,37,15,17,2
"5c5ceeee4562457ba6d41515aeebfbb1","5c5ceeee4562457ba6d41515aeebfbb1",22856184,2,0,1,38,17,17,0
"5c5ceeee4562457ba6d41515aeebfbb1","56586aa865414f538729c7f7735d2bc6",22856184,1,-10,0,40,17,12,-5
"56586aa865414f538729c7f7735d2bc6","9afd71a5298d4333b6849dfce1b9422c",22856184,1,13,0,41,12,18,6
"9afd71a5298d4333b6849dfce1b9422c","9afd71a5298d4333b6849dfce1b9422c",22856184,2,0,1,42,18,18,0
"9afd71a5298d4333b6849dfce1b9422c","b7719e26494940efa49512aedd0aac79",22856184,1,4,0,44,18,20,2
"b7719e26494940efa49512aedd0aac79","d4f45188d3c84a02ba08454e6403a818",22856184,1,5,0,45,20,24,4
"d4f45188d3c84a02ba08454e6403a818","d4c3b003e8274e429d2fa688d73fde6d",22856184,1,-2,0,46,24,22,-2
"d4c3b003e8274e429d2fa688d73fde6d","d4c3b003e8274e429d2fa688d73fde6d",22856184,4,0,1,47,22,22,0
"d4c3b003e8274e429d2fa688d73fde6d","b7719e26494940efa49512aedd0aac79",22856184,1,-3,0,51,22,20,-2
"b7719e26494940efa49512aedd0aac79","afbf7250b99d47bea07172749483ca97",22856184,1,12,0,52,20,28,8
"afbf7250b99d47bea07172749483ca97","b7719e26494940efa49512aedd0aac79",22856184,1,-12,0,53,28,20,-8
"b7719e26494940efa49512aedd0aac79","4e51676dc72045d99c19b9fa7b22f8bc",22856184,1,15,0,54,20,29,9
"4e51676dc72045d99c19b9fa7b22f8bc","afbf7250b99d47bea07172749483ca97",22856184,1,-3,0,55,29,28,-1
"afbf7250b99d47bea07172749483ca97","4e51676dc72045d99c19b9fa7b22f8bc",22856184,1,3,0,56,28,29,1
"4e51676dc72045d99c19b9fa7b22f8bc","51970cfa30e643e894e66ae85c8024cc",22856184,1,3,0,57,29,31,2
"51970cfa30e643e894e66ae85c8024cc","c33c17be71ae4d588da7369472e5bb1b",22856184,1,6,0,58,31,34,3
"c33c17be71ae4d588da7369472e5bb1b","4e51676dc72045d99c19b9fa7b22f8bc",22856184,1,-9,0,59,34,29,-5
"4e51676dc72045d99c19b9fa7b22f8bc","93679be414554a11b1893002f2229a93",22856184,1,12,0,60,29,35,6
"93679be414554a11b1893002f2229a93","c33c17be71ae4d588da7369472e5bb1b",22856184,1,-3,0,61,35,34,-1
"c33c17be71ae4d588da7369472e5bb1b","93679be414554a11b1893002f2229a93",22856184,1,3,0,62,34,35,1
"93679be414554a11b1893002f2229a93","7040a13096d746ac84b8fac8d9752058",22856184,1,3,0,63,35,36,1
"7040a13096d746ac84b8fac8d9752058","9a0dc646f934470daf08c4b56ccf73db",22856184,2,3,0,64,36,37,1
"9a0dc646f934470daf08c4b56ccf73db","7040a13096d746ac84b8fac8d9752058",22856184,1,-3,0,65,37,36,-1
"9a0dc646f934470daf08c4b56ccf73db","fc0e049d56024bc9a02c9a9c435c3df7",22856184,1,3,0,67,37,38,1
"fc0e049d56024bc9a02c9a9c435c3df7","67a089198fcb4e1c8f2385786c2b296f",22856184,1,4,0,68,38,39,1
"67a089198fcb4e1c8f2385786c2b296f","fc0e049d56024bc9a02c9a9c435c3df7",22856184,1,-4,0,69,39,38,-1
"fc0e049d56024bc9a02c9a9c435c3df7","64d48c6c9c7940639a932219a6c87198",22856184,1,5,0,70,38,40,2
"64d48c6c9c7940639a932219a6c87198","64d48c6c9c7940639a932219a6c87198",22856184,3,0,1,71,40,40,0
"64d48c6c9c7940639a932219a6c87198","67a089198fcb4e1c8f2385786c2b296f",22856184,1,-1,0,74,40,39,-1
"67a089198fcb4e1c8f2385786c2b296f","b534b89233134e30a9b5645138bfa9ee",22856184,1,4,0,75,39,41,2
"b534b89233134e30a9b5645138bfa9ee","b534b89233134e30a9b5645138bfa9ee",22856184,1,0,1,76,41,41,0
"67a089198fcb4e1c8f2385786c2b296f","e2911e79efc2420eac45d9f671463d4b",22298983,1,-69,0,1,39,2,-37
"e2911e79efc2420eac45d9f671463d4b","b613861cecf84ffcab01afb23f660475",22298983,2,-3,0,3,2,1,-1
"b613861cecf84ffcab01afb23f660475","b613861cecf84ffcab01afb23f660475",22298983,3,0,1,4,1,1,0
"b613861cecf84ffcab01afb23f660475","e2911e79efc2420eac45d9f671463d4b",22298983,2,3,0,7,1,2,1
"e2911e79efc2420eac45d9f671463d4b","e2911e79efc2420eac45d9f671463d4b",22298983,4,0,1,10,2,2,0
"e2911e79efc2420eac45d9f671463d4b","519d1b8c59404d67b54e96c5c8a830b2",22298983,2,1,0,11,2,3,1
"519d1b8c59404d67b54e96c5c8a830b2","519d1b8c59404d67b54e96c5c8a830b2",22298983,3,0,1,12,3,3,0
"519d1b8c59404d67b54e96c5c8a830b2","531db53f81f646edb0cdcfe0085b03b7",22298983,3,1,0,13,3,4,1
"531db53f81f646edb0cdcfe0085b03b7","531db53f81f646edb0cdcfe0085b03b7",22298983,10,0,1,14,4,4,0
"531db53f81f646edb0cdcfe0085b03b7","519d1b8c59404d67b54e96c5c8a830b2",22298983,1,-1,0,15,4,3,-1
"531db53f81f646edb0cdcfe0085b03b7","4f5f94b2f95141e0a9d53a61da2276da",22298983,2,1,0,19,4,5,1
"4f5f94b2f95141e0a9d53a61da2276da","4f5f94b2f95141e0a9d53a61da2276da",22298983,6,0,1,20,5,5,0
"4f5f94b2f95141e0a9d53a61da2276da","531db53f81f646edb0cdcfe0085b03b7",22298983,1,-1,0,25,5,4,-1
"531db53f81f646edb0cdcfe0085b03b7","0c7262dff33c4087bc660ccf40f92f9c",22298983,1,236,0,33,4,169,165
"0c7262dff33c4087bc660ccf40f92f9c","0c7262dff33c4087bc660ccf40f92f9c",22298983,1,0,1,34,169,169,0
"0c7262dff33c4087bc660ccf40f92f9c","e2911e79efc2420eac45d9f671463d4b",22298983,1,-238,0,35,169,2,-167
"e2911e79efc2420eac45d9f671463d4b","6d541c89590949f99af293c4f2333f67",22298983,1,4,0,37,2,6,4
"6d541c89590949f99af293c4f2333f67","6d541c89590949f99af293c4f2333f67",22298983,2,0,1,38,6,6,0
"6d541c89590949f99af293c4f2333f67","e2911e79efc2420eac45d9f671463d4b",22298983,1,-4,0,39,6,2,-4
"4f5f94b2f95141e0a9d53a61da2276da","6d541c89590949f99af293c4f2333f67",22298983,1,1,0,47,5,6,1
"6d541c89590949f99af293c4f2333f67","dd5cf0b9fe4c4f1d8f5ff8e4c04879cb",22298983,1,1,0,49,6,7,1
"dd5cf0b9fe4c4f1d8f5ff8e4c04879cb","dd5cf0b9fe4c4f1d8f5ff8e4c04879cb",22298983,1,0,1,50,7,7,0
"dd5cf0b9fe4c4f1d8f5ff8e4c04879cb","f96261861edc426abe2248be4f0a709a",22298983,1,1,0,51,7,8,1
"f96261861edc426abe2248be4f0a709a","f96261861edc426abe2248be4f0a709a",22298983,1,0,1,52,8,8,0
"f96261861edc426abe2248be4f0a709a","66b5e16f4f75454fb5b8172079f0fa83",22298983,1,1,0,53,8,9,1
"66b5e16f4f75454fb5b8172079f0fa83","66b5e16f4f75454fb5b8172079f0fa83",22298983,1,0,1,54,9,9,0
"66b5e16f4f75454fb5b8172079f0fa83","0680571d4698477995e41842c36a54b2",22298983,1,1,0,55,9,10,1
"0680571d4698477995e41842c36a54b2","0680571d4698477995e41842c36a54b2",22298983,1,0,1,56,10,10,0
"0680571d4698477995e41842c36a54b2","56586aa865414f538729c7f7735d2bc6",22298983,1,4,0,57,10,12,2
"56586aa865414f538729c7f7735d2bc6","e2911e79efc2420eac45d9f671463d4b",22298983,3,-12,0,58,12,2,-10
"e2911e79efc2420eac45d9f671463d4b","9112f2bffece48e08c6d2287be204085",22298983,2,9,0,59,2,11,9
"9112f2bffece48e08c6d2287be204085","56586aa865414f538729c7f7735d2bc6",22298983,2,3,0,60,11,12,1
"9112f2bffece48e08c6d2287be204085","9112f2bffece48e08c6d2287be204085",22298983,1,0,1,63,11,11,0
"e2911e79efc2420eac45d9f671463d4b","56586aa865414f538729c7f7735d2bc6",22298983,1,12,0,66,2,12,10
"56586aa865414f538729c7f7735d2bc6","56586aa865414f538729c7f7735d2bc6",22298983,5,0,1,67,12,12,0
"56586aa865414f538729c7f7735d2bc6","b7f2b31585d94eb3bf86376714aa7070",22298983,1,2,0,72,12,13,1
"b7f2b31585d94eb3bf86376714aa7070","b7f2b31585d94eb3bf86376714aa7070",22298983,3,0,1,73,13,13,0
"b7f2b31585d94eb3bf86376714aa7070","3f1c815879794b929260d224becaff7e",22298983,1,2,0,76,13,14,1
"3f1c815879794b929260d224becaff7e","5c5ceeee4562457ba6d41515aeebfbb1",22298983,1,6,0,77,14,17,3
"5c5ceeee4562457ba6d41515aeebfbb1","81c864a886d54a6b8ff85f7d736f4f95",22298983,1,-4,0,78,17,15,-2
"81c864a886d54a6b8ff85f7d736f4f95","5c5ceeee4562457ba6d41515aeebfbb1",22298983,1,4,0,79,15,17,2
"5c5ceeee4562457ba6d41515aeebfbb1","5c5ceeee4562457ba6d41515aeebfbb1",22298983,1,0,1,80,17,17,0
"5c5ceeee4562457ba6d41515aeebfbb1","9afd71a5298d4333b6849dfce1b9422c",22298983,1,3,0,81,17,18,1
"9afd71a5298d4333b6849dfce1b9422c","56586aa865414f538729c7f7735d2bc6",22298983,1,-13,0,82,18,12,-6
"56586aa865414f538729c7f7735d2bc6","9afd71a5298d4333b6849dfce1b9422c",22298983,1,13,0,83,12,18,6
"9afd71a5298d4333b6849dfce1b9422c","b7719e26494940efa49512aedd0aac79",22298983,1,4,0,84,18,20,2
"b7719e26494940efa49512aedd0aac79","d4f45188d3c84a02ba08454e6403a818",22298983,1,5,0,85,20,24,4
"d4f45188d3c84a02ba08454e6403a818","d4c3b003e8274e429d2fa688d73fde6d",22298983,1,-2,0,86,24,22,-2
"d4c3b003e8274e429d2fa688d73fde6d","d4c3b003e8274e429d2fa688d73fde6d",22298983,1,0,1,87,22,22,0
"d4c3b003e8274e429d2fa688d73fde6d","b7719e26494940efa49512aedd0aac79",22298983,1,-3,0,88,22,20,-2
"b7719e26494940efa49512aedd0aac79","b7719e26494940efa49512aedd0aac79",22298983,1,0,1,89,20,20,0
"b7719e26494940efa49512aedd0aac79","afbf7250b99d47bea07172749483ca97",22298983,1,12,0,90,20,28,8
"afbf7250b99d47bea07172749483ca97","afbf7250b99d47bea07172749483ca97",22298983,1,0,1,91,28,28,0
"afbf7250b99d47bea07172749483ca97","4e51676dc72045d99c19b9fa7b22f8bc",22298983,1,3,0,92,28,29,1
"4e51676dc72045d99c19b9fa7b22f8bc","4e51676dc72045d99c19b9fa7b22f8bc",22298983,1,0,1,93,29,29,0
"4e51676dc72045d99c19b9fa7b22f8bc","51970cfa30e643e894e66ae85c8024cc",22298983,1,3,0,94,29,31,2
"51970cfa30e643e894e66ae85c8024cc","4e51676dc72045d99c19b9fa7b22f8bc",22298983,1,-3,0,95,31,29,-2
"4e51676dc72045d99c19b9fa7b22f8bc","c33c17be71ae4d588da7369472e5bb1b",22298983,1,9,0,96,29,34,5
"c33c17be71ae4d588da7369472e5bb1b","c33c17be71ae4d588da7369472e5bb1b",22298983,1,0,1,97,34,34,0
"c33c17be71ae4d588da7369472e5bb1b","93679be414554a11b1893002f2229a93",22298983,1,3,0,98,34,35,1
"93679be414554a11b1893002f2229a93","93679be414554a11b1893002f2229a93",22298983,1,0,1,99,35,35,0
"93679be414554a11b1893002f2229a93","7040a13096d746ac84b8fac8d9752058",22298983,1,3,0,100,35,36,1
"7040a13096d746ac84b8fac8d9752058","7040a13096d746ac84b8fac8d9752058",22298983,1,0,1,101,36,36,0
"7040a13096d746ac84b8fac8d9752058","9a0dc646f934470daf08c4b56ccf73db",22298983,1,3,0,102,36,37,1
"9a0dc646f934470daf08c4b56ccf73db","9a0dc646f934470daf08c4b56ccf73db",22298983,1,0,1,103,37,37,0
"9a0dc646f934470daf08c4b56ccf73db","fc0e049d56024bc9a02c9a9c435c3df7",22298983,1,3,0,104,37,38,1
"fc0e049d56024bc9a02c9a9c435c3df7","fc0e049d56024bc9a02c9a9c435c3df7",22298983,1,0,1,105,38,38,0
"fc0e049d56024bc9a02c9a9c435c3df7","67a089198fcb4e1c8f2385786c2b296f",22298983,1,4,0,106,38,39,1
"67a089198fcb4e1c8f2385786c2b296f","64d48c6c9c7940639a932219a6c87198",22298983,2,1,0,107,39,40,1
"64d48c6c9c7940639a932219a6c87198","64d48c6c9c7940639a932219a6c87198",22298983,4,0,1,108,40,40,0
"64d48c6c9c7940639a932219a6c87198","67a089198fcb4e1c8f2385786c2b296f",22298983,2,-1,0,111,40,39,-1
"67a089198fcb4e1c8f2385786c2b296f","b534b89233134e30a9b5645138bfa9ee",22298983,2,4,0,112,39,41,2
"b534b89233134e30a9b5645138bfa9ee","6e13d61a7bdb44bca949c9f86fab3be5",22298983,2,7,0,113,41,47,6
"6e13d61a7bdb44bca949c9f86fab3be5","b534b89233134e30a9b5645138bfa9ee",22298983,1,-7,0,114,47,41,-6
"b534b89233134e30a9b5645138bfa9ee","67a089198fcb4e1c8f2385786c2b296f",22298983,1,-4,0,115,41,39,-2
"b534b89233134e30a9b5645138bfa9ee","0e37b720d23b4e7f8b313e79313fd107",22298983,1,3,0,120,41,44,3
"0e37b720d23b4e7f8b313e79313fd107","0e37b720d23b4e7f8b313e79313fd107",22298983,2,0,1,121,44,44,0
"0e37b720d23b4e7f8b313e79313fd107","6875d67fdd5f48168b62719df449bebd",22298983,1,1,0,122,44,45,1
"6875d67fdd5f48168b62719df449bebd","6875d67fdd5f48168b62719df449bebd",22298983,3,0,1,123,45,45,0
"6875d67fdd5f48168b62719df449bebd","0e37b720d23b4e7f8b313e79313fd107",22298983,1,-1,0,126,45,44,-1
"0e37b720d23b4e7f8b313e79313fd107","b534b89233134e30a9b5645138bfa9ee",22298983,1,-3,0,128,44,41,-3
"6e13d61a7bdb44bca949c9f86fab3be5","6e13d61a7bdb44bca949c9f86fab3be5",22298983,2,0,1,130,47,47,0
"6e13d61a7bdb44bca949c9f86fab3be5","d9c8d8c444a64dadbbb508652c721e17",22298983,1,-1,0,132,47,46,-1
"d9c8d8c444a64dadbbb508652c721e17","d0c74f735e024943943e40333d6d337f",22298983,1,6,0,133,46,51,5
"d0c74f735e024943943e40333d6d337f","d0c74f735e024943943e40333d6d337f",22298983,3,0,1,134,51,51,0
"d0c74f735e024943943e40333d6d337f","78f30e4dcac84e3cbea8b2cc6e0d62b3",22298983,1,9,0,137,51,59,8
"78f30e4dcac84e3cbea8b2cc6e0d62b3","f924752d8a1149668870b1e7698486f7",22298983,1,-10,0,138,59,50,-9
"f924752d8a1149668870b1e7698486f7","a1f2f12debe5432fb7a70bcd12bacfb9",22298983,1,9,0,139,50,58,8
"a1f2f12debe5432fb7a70bcd12bacfb9","a1f2f12debe5432fb7a70bcd12bacfb9",22298983,5,0,1,140,58,58,0
"a1f2f12debe5432fb7a70bcd12bacfb9","78f30e4dcac84e3cbea8b2cc6e0d62b3",22298983,1,1,0,145,58,59,1
"78f30e4dcac84e3cbea8b2cc6e0d62b3","78f30e4dcac84e3cbea8b2cc6e0d62b3",22298983,20,0,1,146,59,59,0
"b613861cecf84ffcab01afb23f660475","b613861cecf84ffcab01afb23f660475",22857573,4,0,1,1,1,1,0
"b613861cecf84ffcab01afb23f660475","e2911e79efc2420eac45d9f671463d4b",22857573,1,3,0,5,1,2,1
"e2911e79efc2420eac45d9f671463d4b","e2911e79efc2420eac45d9f671463d4b",22857573,3,0,1,6,2,2,0
"e2911e79efc2420eac45d9f671463d4b","519d1b8c59404d67b54e96c5c8a830b2",22857573,1,1,0,9,2,3,1
"519d1b8c59404d67b54e96c5c8a830b2","519d1b8c59404d67b54e96c5c8a830b2",22857573,1,0,1,10,3,3,0
"519d1b8c59404d67b54e96c5c8a830b2","531db53f81f646edb0cdcfe0085b03b7",22857573,1,1,0,11,3,4,1
"531db53f81f646edb0cdcfe0085b03b7","531db53f81f646edb0cdcfe0085b03b7",22857573,1,0,1,12,4,4,0
"531db53f81f646edb0cdcfe0085b03b7","4f5f94b2f95141e0a9d53a61da2276da",22857573,1,1,0,13,4,5,1
"4f5f94b2f95141e0a9d53a61da2276da","4f5f94b2f95141e0a9d53a61da2276da",22857573,1,0,1,14,5,5,0
"4f5f94b2f95141e0a9d53a61da2276da","6d541c89590949f99af293c4f2333f67",22857573,1,1,0,15,5,6,1
"6d541c89590949f99af293c4f2333f67","6d541c89590949f99af293c4f2333f67",22857573,1,0,1,16,6,6,0
"6d541c89590949f99af293c4f2333f67","dd5cf0b9fe4c4f1d8f5ff8e4c04879cb",22857573,1,1,0,17,6,7,1
"dd5cf0b9fe4c4f1d8f5ff8e4c04879cb","dd5cf0b9fe4c4f1d8f5ff8e4c04879cb",22857573,1,0,1,18,7,7,0
"dd5cf0b9fe4c4f1d8f5ff8e4c04879cb","f96261861edc426abe2248be4f0a709a",22857573,1,1,0,19,7,8,1
"f96261861edc426abe2248be4f0a709a","f96261861edc426abe2248be4f0a709a",22857573,1,0,1,20,8,8,0
"f96261861edc426abe2248be4f0a709a","66b5e16f4f75454fb5b8172079f0fa83",22857573,1,1,0,21,8,9,1
"66b5e16f4f75454fb5b8172079f0fa83","66b5e16f4f75454fb5b8172079f0fa83",22857573,1,0,1,22,9,9,0
"66b5e16f4f75454fb5b8172079f0fa83","0680571d4698477995e41842c36a54b2",22857573,1,1,0,23,9,10,1
"0680571d4698477995e41842c36a54b2","0680571d4698477995e41842c36a54b2",22857573,4,0,1,24,10,10,0
"0680571d4698477995e41842c36a54b2","9112f2bffece48e08c6d2287be204085",22857573,1,1,0,28,10,11,1
"9112f2bffece48e08c6d2287be204085","9112f2bffece48e08c6d2287be204085",22857573,1,0,1,29,11,11,0
"9112f2bffece48e08c6d2287be204085","56586aa865414f538729c7f7735d2bc6",22857573,1,3,0,30,11,12,1
"56586aa865414f538729c7f7735d2bc6","e2911e79efc2420eac45d9f671463d4b",22857573,1,-12,0,31,12,2,-10
"e2911e79efc2420eac45d9f671463d4b","56586aa865414f538729c7f7735d2bc6",22857573,1,12,0,32,2,12,10
"56586aa865414f538729c7f7735d2bc6","67a089198fcb4e1c8f2385786c2b296f",22857573,1,57,0,33,12,39,27
"67a089198fcb4e1c8f2385786c2b296f","64d48c6c9c7940639a932219a6c87198",22857573,1,1,0,34,39,40,1
"64d48c6c9c7940639a932219a6c87198","64d48c6c9c7940639a932219a6c87198",22857573,1,0,1,35,40,40,0
"64d48c6c9c7940639a932219a6c87198","b534b89233134e30a9b5645138bfa9ee",22857573,1,3,0,36,40,41,1
"b534b89233134e30a9b5645138bfa9ee","67a089198fcb4e1c8f2385786c2b296f",22857573,1,-4,0,37,41,39,-2
"67a089198fcb4e1c8f2385786c2b296f","b534b89233134e30a9b5645138bfa9ee",22857573,1,4,0,38,39,41,2
"b534b89233134e30a9b5645138bfa9ee","0e37b720d23b4e7f8b313e79313fd107",22857573,1,3,0,39,41,44,3
"0e37b720d23b4e7f8b313e79313fd107","0e37b720d23b4e7f8b313e79313fd107",22857573,1,0,1,40,44,44,0
"0e37b720d23b4e7f8b313e79313fd107","6875d67fdd5f48168b62719df449bebd",22857573,1,1,0,41,44,45,1
"6875d67fdd5f48168b62719df449bebd","6875d67fdd5f48168b62719df449bebd",22857573,1,0,1,42,45,45,0
"6875d67fdd5f48168b62719df449bebd","b534b89233134e30a9b5645138bfa9ee",22857573,1,-4,0,43,45,41,-4
"b534b89233134e30a9b5645138bfa9ee","6e13d61a7bdb44bca949c9f86fab3be5",22857573,1,7,0,44,41,47,6
"6e13d61a7bdb44bca949c9f86fab3be5","6e13d61a7bdb44bca949c9f86fab3be5",22857573,1,0,1,45,47,47,0
"6e13d61a7bdb44bca949c9f86fab3be5","195f78799f984cc2b06c48dfe36be751",22857573,1,2,0,46,47,49,2
"195f78799f984cc2b06c48dfe36be751","195f78799f984cc2b06c48dfe36be751",22857573,2,0,1,47,49,49,0
"195f78799f984cc2b06c48dfe36be751","d0c74f735e024943943e40333d6d337f",22857573,1,3,0,49,49,51,2
"d0c74f735e024943943e40333d6d337f","d9c8d8c444a64dadbbb508652c721e17",22857573,1,-6,0,50,51,46,-5
"d9c8d8c444a64dadbbb508652c721e17","d0c74f735e024943943e40333d6d337f",22857573,1,6,0,51,46,51,5
"d0c74f735e024943943e40333d6d337f","983f8ff320594b279a7f4a6fe132f9c5",22857573,1,2,0,52,51,53,2
"983f8ff320594b279a7f4a6fe132f9c5","983f8ff320594b279a7f4a6fe132f9c5",22857573,5,0,1,53,53,53,0
"983f8ff320594b279a7f4a6fe132f9c5","35adfa5d923046aebabfefd98f35ff05",22857573,1,1,0,58,53,54,1
"35adfa5d923046aebabfefd98f35ff05","35adfa5d923046aebabfefd98f35ff05",22857573,2,0,1,59,54,54,0
"35adfa5d923046aebabfefd98f35ff05","b6f8a98476224da1b40e555ececc7ed8",22857573,1,1,0,61,54,55,1
"b6f8a98476224da1b40e555ececc7ed8","b6f8a98476224da1b40e555ececc7ed8",22857573,2,0,1,62,55,55,0
"b6f8a98476224da1b40e555ececc7ed8","86e22cb5fe0e4b47a9489ecddf7ed78f",22857573,1,1,0,64,55,56,1
"86e22cb5fe0e4b47a9489ecddf7ed78f","86e22cb5fe0e4b47a9489ecddf7ed78f",22857573,2,0,1,65,56,56,0
"86e22cb5fe0e4b47a9489ecddf7ed78f","f924752d8a1149668870b1e7698486f7",22857573,1,-6,0,67,56,50,-6
"f924752d8a1149668870b1e7698486f7","a1f2f12debe5432fb7a70bcd12bacfb9",22857573,1,9,0,68,50,58,8
"a1f2f12debe5432fb7a70bcd12bacfb9","78f30e4dcac84e3cbea8b2cc6e0d62b3",22857573,2,1,0,69,58,59,1
"78f30e4dcac84e3cbea8b2cc6e0d62b3","a1f2f12debe5432fb7a70bcd12bacfb9",22857573,1,-1,0,70,59,58,-1
"a1f2f12debe5432fb7a70bcd12bacfb9","a1f2f12debe5432fb7a70bcd12bacfb9",22857573,10,0,1,71,58,58,0
"78f30e4dcac84e3cbea8b2cc6e0d62b3","78f30e4dcac84e3cbea8b2cc6e0d62b3",22857573,11,0,1,82,59,59,0
"78f30e4dcac84e3cbea8b2cc6e0d62b3","bc42d26810654ea9a1df1efe1e58c7d5",22857573,1,5,0,93,59,63,4
"bc42d26810654ea9a1df1efe1e58c7d5","a0a418b8540d479fa6e0f653b701da8b",22857573,1,1,0,94,63,64,1
"a0a418b8540d479fa6e0f653b701da8b","12aa6e1672ac4e7aa6449a7a8609cd72",22857573,1,-8,0,95,64,57,-7
"12aa6e1672ac4e7aa6449a7a8609cd72","4c943503763e4e349906eea3ed3c8e86",22857573,1,5,0,96,57,61,4
"4c943503763e4e349906eea3ed3c8e86","4c943503763e4e349906eea3ed3c8e86",22857573,3,0,1,97,61,61,0
"4c943503763e4e349906eea3ed3c8e86","309ccf3cc4fe429d9bfbaef53d3fa479",22857573,1,-1,0,100,61,60,-1
"309ccf3cc4fe429d9bfbaef53d3fa479","d646286c8051419bbc2e31dd1db55ca8",22857573,1,10,0,101,60,67,7
"d646286c8051419bbc2e31dd1db55ca8","b534b89233134e30a9b5645138bfa9ee",22857573,1,-33,0,102,67,41,-26
"b534b89233134e30a9b5645138bfa9ee","267f883678b24aed855fde42524975d9",22857573,1,37,0,103,41,71,30
"267f883678b24aed855fde42524975d9","267f883678b24aed855fde42524975d9",22857573,1,0,1,104,71,71,0
"267f883678b24aed855fde42524975d9","88fff56d0342490dbef9040750a20f6c",22857573,1,1,0,105,71,72,1
"88fff56d0342490dbef9040750a20f6c","88fff56d0342490dbef9040750a20f6c",22857573,1,0,1,106,72,72,0
"88fff56d0342490dbef9040750a20f6c","adb17b12b66c4a49a85fd34322f7df70",22857573,1,1,0,107,72,73,1
"adb17b12b66c4a49a85fd34322f7df70","adb17b12b66c4a49a85fd34322f7df70",22857573,1,0,1,108,73,73,0
"adb17b12b66c4a49a85fd34322f7df70","d646286c8051419bbc2e31dd1db55ca8",22857573,1,-6,0,109,73,67,-6
"d646286c8051419bbc2e31dd1db55ca8","a2becd407db34b189200a32546d9d569",22857573,1,9,0,110,67,75,8
"a2becd407db34b189200a32546d9d569","a2becd407db34b189200a32546d9d569",22857573,1,0,1,111,75,75,0
"a2becd407db34b189200a32546d9d569","58c22b011d0f4c2ea6d13615edbb9eeb",22857573,1,2,0,112,75,77,2
"58c22b011d0f4c2ea6d13615edbb9eeb","58c22b011d0f4c2ea6d13615edbb9eeb",22857573,5,0,1,113,77,77,0
"58c22b011d0f4c2ea6d13615edbb9eeb","dd76e1861dc9461c830888729d091ee0",22857573,1,1,0,118,77,78,1
"dd76e1861dc9461c830888729d091ee0","dd76e1861dc9461c830888729d091ee0",22857573,5,0,1,119,78,78,0
"dd76e1861dc9461c830888729d091ee0","cd1d828f1a694b87913a7ea66c23803e",22857573,1,1,0,124,78,79,1
"cd1d828f1a694b87913a7ea66c23803e","cd1d828f1a694b87913a7ea66c23803e",22857573,2,0,1,125,79,79,0
"cd1d828f1a694b87913a7ea66c23803e","9176a3c2b4d2465fa8b0c67096c2a97e",22857573,1,1,0,127,79,80,1
"9176a3c2b4d2465fa8b0c67096c2a97e","9176a3c2b4d2465fa8b0c67096c2a97e",22857573,5,0,1,128,80,80,0
"9176a3c2b4d2465fa8b0c67096c2a97e","f8ec6445f7194e25b9101d4fbcb07a18",22857573,1,1,0,133,80,81,1
"f8ec6445f7194e25b9101d4fbcb07a18","f8ec6445f7194e25b9101d4fbcb07a18",22857573,2,0,1,134,81,81,0
"f8ec6445f7194e25b9101d4fbcb07a18","140d5b27b8574befad82c0a013b59dfa",22857573,1,-7,0,136,81,74,-7
"140d5b27b8574befad82c0a013b59dfa","d18a9ea32855445f8736581f5cb119ce",22857573,1,9,0,137,74,82,8
"d18a9ea32855445f8736581f5cb119ce","f564483cbd7a407681aa2fcca518cf5f",22857573,1,4,0,138,82,85,3
"f564483cbd7a407681aa2fcca518cf5f","f564483cbd7a407681aa2fcca518cf5f",22857573,1,0,1,139,85,85,0
"f564483cbd7a407681aa2fcca518cf5f","18fd01350bd5434ca636d59a599d768a",22857573,1,1,0,140,85,86,1
"18fd01350bd5434ca636d59a599d768a","18fd01350bd5434ca636d59a599d768a",22857573,9,0,1,141,86,86,0
"18fd01350bd5434ca636d59a599d768a","ae5ac430ea254e708a6f5deaaf7464ae",22857573,1,-2,0,150,86,84,-2
"ae5ac430ea254e708a6f5deaaf7464ae","6a9f0ef185fb47f0937e29daa1c71ed5",22857573,1,7,0,151,84,90,6
"6a9f0ef185fb47f0937e29daa1c71ed5","c681290961c94c4caf23b529d1ae6b9a",22857573,1,-2,0,152,90,88,-2
"c681290961c94c4caf23b529d1ae6b9a","c681290961c94c4caf23b529d1ae6b9a",22857573,1,0,1,153,88,88,0
"c681290961c94c4caf23b529d1ae6b9a","6a9f0ef185fb47f0937e29daa1c71ed5",22857573,1,2,0,154,88,90,2
"6a9f0ef185fb47f0937e29daa1c71ed5","6a9f0ef185fb47f0937e29daa1c71ed5",22857573,3,0,1,155,90,90,0
"6a9f0ef185fb47f0937e29daa1c71ed5","e20db35ced8544ddac5bc3839145e463",22857573,1,3,0,158,90,91,1
"e20db35ced8544ddac5bc3839145e463","d646286c8051419bbc2e31dd1db55ca8",22857573,1,-30,0,159,91,67,-24
"d646286c8051419bbc2e31dd1db55ca8","1febb706d7a34005ae8711ed49c76e64",22857573,1,33,0,160,67,94,27
"1febb706d7a34005ae8711ed49c76e64","1febb706d7a34005ae8711ed49c76e64",22857573,2,0,1,161,94,94,0
"1febb706d7a34005ae8711ed49c76e64","8f73ba6f5a0042f2850356ac38ac6f24",22857573,1,1,0,163,94,95,1
"8f73ba6f5a0042f2850356ac38ac6f24","8f73ba6f5a0042f2850356ac38ac6f24",22857573,5,0,1,164,95,95,0
"8f73ba6f5a0042f2850356ac38ac6f24","e2260b86653c46d7b14a41fb419dbf8c",22857573,1,1,0,169,95,96,1
"e2260b86653c46d7b14a41fb419dbf8c","e2260b86653c46d7b14a41fb419dbf8c",22857573,2,0,1,170,96,96,0
"e2260b86653c46d7b14a41fb419dbf8c","35eb641ad1d845bbba54915bce75a962",22857573,1,1,0,172,96,97,1
"35eb641ad1d845bbba54915bce75a962","35eb641ad1d845bbba54915bce75a962",22857573,2,0,1,173,97,97,0
"35eb641ad1d845bbba54915bce75a962","08be90ffbeea4795a138cd42ed8db56f",22857573,1,1,0,175,97,98,1
"08be90ffbeea4795a138cd42ed8db56f","08be90ffbeea4795a138cd42ed8db56f",22857573,5,0,1,176,98,98,0
"08be90ffbeea4795a138cd42ed8db56f","3007433c8f584dcbb5ac159c1c5f2be3",22857573,1,1,0,181,98,99,1
"3007433c8f584dcbb5ac159c1c5f2be3","3007433c8f584dcbb5ac159c1c5f2be3",22857573,5,0,1,182,99,99,0
"3007433c8f584dcbb5ac159c1c5f2be3","e20db35ced8544ddac5bc3839145e463",22857573,1,-8,0,187,99,91,-8
"e20db35ced8544ddac5bc3839145e463","00ae5f0c51874a73a41ebea838d95682",22857573,1,11,0,188,91,101,10
"00ae5f0c51874a73a41ebea838d95682","d391c8b6e56a43a7b654e9dee02d904b",22857573,2,2,0,189,101,103,2
"d391c8b6e56a43a7b654e9dee02d904b","00ae5f0c51874a73a41ebea838d95682",22857573,1,-2,0,190,103,101,-2
"d391c8b6e56a43a7b654e9dee02d904b","d391c8b6e56a43a7b654e9dee02d904b",22857573,15,0,1,192,103,103,0
"d391c8b6e56a43a7b654e9dee02d904b","6111116566fc4fd9abba409322bea245",22857573,1,1,0,207,103,104,1
"6111116566fc4fd9abba409322bea245","6111116566fc4fd9abba409322bea245",22857573,2,0,1,208,104,104,0
"6111116566fc4fd9abba409322bea245","a81b2235cb9c499eb9ea8ee0a8dd9725",22857573,1,1,0,210,104,105,1
"a81b2235cb9c499eb9ea8ee0a8dd9725","a81b2235cb9c499eb9ea8ee0a8dd9725",22857573,5,0,1,211,105,105,0
"a81b2235cb9c499eb9ea8ee0a8dd9725","2d4e0ab0ef3b4d73b82c72d4621a7579",22857573,1,1,0,216,105,106,1
"2d4e0ab0ef3b4d73b82c72d4621a7579","2d4e0ab0ef3b4d73b82c72d4621a7579",22857573,2,0,1,217,106,106,0
"2d4e0ab0ef3b4d73b82c72d4621a7579","8bdebf492ebd4e62b0d522e8ab5e5197",22857573,1,1,0,219,106,107,1
"8bdebf492ebd4e62b0d522e8ab5e5197","8bdebf492ebd4e62b0d522e8ab5e5197",22857573,2,0,1,220,107,107,0
"8bdebf492ebd4e62b0d522e8ab5e5197","4280927ec4d643238aa49c32f9e06c6c",22857573,1,3,0,222,107,109,2
"4280927ec4d643238aa49c32f9e06c6c","73039f8c1eb9409cb4caee2cf968001e",22857573,1,-10,0,223,109,100,-9
"73039f8c1eb9409cb4caee2cf968001e","4280927ec4d643238aa49c32f9e06c6c",22857573,1,10,0,224,100,109,9
"4280927ec4d643238aa49c32f9e06c6c","fc44e6a5f7654430af1227838224dceb",22857573,1,2,0,225,109,111,2
"fc44e6a5f7654430af1227838224dceb","fc44e6a5f7654430af1227838224dceb",22857573,2,0,1,226,111,111,0
"fc44e6a5f7654430af1227838224dceb","08111f75e22d409998cf8b85bd431f0a",22857573,1,-3,0,228,111,108,-3
"08111f75e22d409998cf8b85bd431f0a","a9ae0a3c070d455bb4369a8996313336",22857573,1,7,0,229,108,114,6
"a9ae0a3c070d455bb4369a8996313336","a9ae0a3c070d455bb4369a8996313336",22857573,1,0,1,230,114,114,0
"a9ae0a3c070d455bb4369a8996313336","71cec822bcff4f30a20e75dc63ef7b65",22857573,1,2,0,231,114,116,2
"71cec822bcff4f30a20e75dc63ef7b65","71cec822bcff4f30a20e75dc63ef7b65",22857573,3,0,1,232,116,116,0
"71cec822bcff4f30a20e75dc63ef7b65","62bff51286ef4f348717a3cf6fe2318f",22857573,1,5,0,235,116,120,4
"62bff51286ef4f348717a3cf6fe2318f","37319e88176d4aefa91d7a9980dbae91",22857573,1,-9,0,236,120,112,-8
"37319e88176d4aefa91d7a9980dbae91","b1cd0e7dc3ad4a8eb91a4bfdbeb025b0",22857573,1,7,0,237,112,118,6
"b1cd0e7dc3ad4a8eb91a4bfdbeb025b0","b1cd0e7dc3ad4a8eb91a4bfdbeb025b0",22857573,1,0,1,238,118,118,0
"b1cd0e7dc3ad4a8eb91a4bfdbeb025b0","62bff51286ef4f348717a3cf6fe2318f",22857573,1,2,0,239,118,120,2
"62bff51286ef4f348717a3cf6fe2318f","62bff51286ef4f348717a3cf6fe2318f",22857573,3,0,1,240,120,120,0
"62bff51286ef4f348717a3cf6fe2318f","e20db35ced8544ddac5bc3839145e463",22857573,1,-33,0,243,120,91,-29
"e20db35ced8544ddac5bc3839145e463","779f9ddd1fd14d1e9e69f72219a1fdbd",22857573,1,36,0,244,91,121,30
"779f9ddd1fd14d1e9e69f72219a1fdbd","b534b89233134e30a9b5645138bfa9ee",22857573,1,-99,0,245,121,41,-80
"b534b89233134e30a9b5645138bfa9ee","bc42d26810654ea9a1df1efe1e58c7d5",22857573,1,26,0,246,41,63,22
"bc42d26810654ea9a1df1efe1e58c7d5","7af822066add4e7f8e007e4eee31a8bf",22857573,1,3,0,247,63,65,2
"7af822066add4e7f8e007e4eee31a8bf","a0a418b8540d479fa6e0f653b701da8b",22857573,1,-2,0,248,65,64,-1
"b613861cecf84ffcab01afb23f660475","b613861cecf84ffcab01afb23f660475",22857837,6,0,1,1,1,1,0
"b613861cecf84ffcab01afb23f660475","e2911e79efc2420eac45d9f671463d4b",22857837,2,3,0,6,1,2,1
"e2911e79efc2420eac45d9f671463d4b","b613861cecf84ffcab01afb23f660475",22857837,1,-3,0,7,2,1,-1
"e2911e79efc2420eac45d9f671463d4b","e2911e79efc2420eac45d9f671463d4b",22857837,3,0,1,10,2,2,0
"e2911e79efc2420eac45d9f671463d4b","519d1b8c59404d67b54e96c5c8a830b2",22857837,1,1,0,13,2,3,1
"519d1b8c59404d67b54e96c5c8a830b2","519d1b8c59404d67b54e96c5c8a830b2",22857837,1,0,1,14,3,3,0
"519d1b8c59404d67b54e96c5c8a830b2","531db53f81f646edb0cdcfe0085b03b7",22857837,1,1,0,15,3,4,1
"531db53f81f646edb0cdcfe0085b03b7","531db53f81f646edb0cdcfe0085b03b7",22857837,1,0,1,16,4,4,0
"531db53f81f646edb0cdcfe0085b03b7","4f5f94b2f95141e0a9d53a61da2276da",22857837,1,1,0,17,4,5,1
"4f5f94b2f95141e0a9d53a61da2276da","4f5f94b2f95141e0a9d53a61da2276da",22857837,1,0,1,18,5,5,0
"4f5f94b2f95141e0a9d53a61da2276da","6d541c89590949f99af293c4f2333f67",22857837,1,1,0,19,5,6,1
"6d541c89590949f99af293c4f2333f67","6d541c89590949f99af293c4f2333f67",22857837,2,0,1,20,6,6,0
"6d541c89590949f99af293c4f2333f67","dd5cf0b9fe4c4f1d8f5ff8e4c04879cb",22857837,1,1,0,22,6,7,1
"dd5cf0b9fe4c4f1d8f5ff8e4c04879cb","dd5cf0b9fe4c4f1d8f5ff8e4c04879cb",22857837,2,0,1,23,7,7,0
"dd5cf0b9fe4c4f1d8f5ff8e4c04879cb","f96261861edc426abe2248be4f0a709a",22857837,1,1,0,25,7,8,1
"f96261861edc426abe2248be4f0a709a","f96261861edc426abe2248be4f0a709a",22857837,2,0,1,26,8,8,0
"f96261861edc426abe2248be4f0a709a","66b5e16f4f75454fb5b8172079f0fa83",22857837,1,1,0,28,8,9,1
"66b5e16f4f75454fb5b8172079f0fa83","66b5e16f4f75454fb5b8172079f0fa83",22857837,2,0,1,29,9,9,0
"66b5e16f4f75454fb5b8172079f0fa83","0680571d4698477995e41842c36a54b2",22857837,1,1,0,31,9,10,1
"0680571d4698477995e41842c36a54b2","0680571d4698477995e41842c36a54b2",22857837,2,0,1,32,10,10,0
"0680571d4698477995e41842c36a54b2","9112f2bffece48e08c6d2287be204085",22857837,1,1,0,34,10,11,1
"9112f2bffece48e08c6d2287be204085","9112f2bffece48e08c6d2287be204085",22857837,2,0,1,35,11,11,0
"9112f2bffece48e08c6d2287be204085","e2911e79efc2420eac45d9f671463d4b",22857837,1,-9,0,37,11,2,-9
"e2911e79efc2420eac45d9f671463d4b","56586aa865414f538729c7f7735d2bc6",22857837,1,12,0,38,2,12,10
"56586aa865414f538729c7f7735d2bc6","56586aa865414f538729c7f7735d2bc6",22857837,12,0,1,39,12,12,0
"56586aa865414f538729c7f7735d2bc6","b7f2b31585d94eb3bf86376714aa7070",22857837,4,2,0,43,12,13,1
"b7f2b31585d94eb3bf86376714aa7070","b7f2b31585d94eb3bf86376714aa7070",22857837,4,0,1,44,13,13,0
"b7f2b31585d94eb3bf86376714aa7070","3f1c815879794b929260d224becaff7e",22857837,3,2,0,47,13,14,1
"3f1c815879794b929260d224becaff7e","81c864a886d54a6b8ff85f7d736f4f95",22857837,3,2,0,48,14,15,1
"81c864a886d54a6b8ff85f7d736f4f95","3f1c815879794b929260d224becaff7e",22857837,1,-2,0,49,15,14,-1
"3f1c815879794b929260d224becaff7e","56586aa865414f538729c7f7735d2bc6",22857837,1,-4,0,50,14,12,-2
"81c864a886d54a6b8ff85f7d736f4f95","5c5ceeee4562457ba6d41515aeebfbb1",22857837,2,4,0,57,15,17,2
"5c5ceeee4562457ba6d41515aeebfbb1","56586aa865414f538729c7f7735d2bc6",22857837,3,-10,0,58,17,12,-5
"56586aa865414f538729c7f7735d2bc6","5c5ceeee4562457ba6d41515aeebfbb1",22857837,1,10,0,59,12,17,5
"b7f2b31585d94eb3bf86376714aa7070","56586aa865414f538729c7f7735d2bc6",22857837,1,-2,0,64,13,12,-1
"5c5ceeee4562457ba6d41515aeebfbb1","5c5ceeee4562457ba6d41515aeebfbb1",22857837,1,0,1,69,17,17,0
"56586aa865414f538729c7f7735d2bc6","9afd71a5298d4333b6849dfce1b9422c",22857837,1,13,0,75,12,18,6
"9afd71a5298d4333b6849dfce1b9422c","9afd71a5298d4333b6849dfce1b9422c",22857837,1,0,1,76,18,18,0
"9afd71a5298d4333b6849dfce1b9422c","b7719e26494940efa49512aedd0aac79",22857837,1,4,0,77,18,20,2
"b7719e26494940efa49512aedd0aac79","b7719e26494940efa49512aedd0aac79",22857837,1,0,1,78,20,20,0
"b7719e26494940efa49512aedd0aac79","afbf7250b99d47bea07172749483ca97",22857837,1,12,0,79,20,28,8
"afbf7250b99d47bea07172749483ca97","afbf7250b99d47bea07172749483ca97",22857837,1,0,1,80,28,28,0
"afbf7250b99d47bea07172749483ca97","4e51676dc72045d99c19b9fa7b22f8bc",22857837,1,3,0,81,28,29,1
"4e51676dc72045d99c19b9fa7b22f8bc","4e51676dc72045d99c19b9fa7b22f8bc",22857837,1,0,1,82,29,29,0
"4e51676dc72045d99c19b9fa7b22f8bc","51970cfa30e643e894e66ae85c8024cc",22857837,1,3,0,83,29,31,2
"51970cfa30e643e894e66ae85c8024cc","4e51676dc72045d99c19b9fa7b22f8bc",22857837,1,-3,0,84,31,29,-2
"4e51676dc72045d99c19b9fa7b22f8bc","c33c17be71ae4d588da7369472e5bb1b",22857837,1,9,0,85,29,34,5
"c33c17be71ae4d588da7369472e5bb1b","c33c17be71ae4d588da7369472e5bb1b",22857837,1,0,1,86,34,34,0
"c33c17be71ae4d588da7369472e5bb1b","93679be414554a11b1893002f2229a93",22857837,1,3,0,87,34,35,1
"93679be414554a11b1893002f2229a93","93679be414554a11b1893002f2229a93",22857837,1,0,1,88,35,35,0
"93679be414554a11b1893002f2229a93","7040a13096d746ac84b8fac8d9752058",22857837,1,3,0,89,35,36,1
"7040a13096d746ac84b8fac8d9752058","7040a13096d746ac84b8fac8d9752058",22857837,1,0,1,90,36,36,0
"7040a13096d746ac84b8fac8d9752058","9a0dc646f934470daf08c4b56ccf73db",22857837,1,3,0,91,36,37,1
"9a0dc646f934470daf08c4b56ccf73db","9a0dc646f934470daf08c4b56ccf73db",22857837,1,0,1,92,37,37,0
"9a0dc646f934470daf08c4b56ccf73db","fc0e049d56024bc9a02c9a9c435c3df7",22857837,1,3,0,93,37,38,1
"fc0e049d56024bc9a02c9a9c435c3df7","fc0e049d56024bc9a02c9a9c435c3df7",22857837,2,0,1,94,38,38,0
"fc0e049d56024bc9a02c9a9c435c3df7","67a089198fcb4e1c8f2385786c2b296f",22857837,1,4,0,96,38,39,1
"67a089198fcb4e1c8f2385786c2b296f","67a089198fcb4e1c8f2385786c2b296f",22857837,1,0,1,97,39,39,0
"67a089198fcb4e1c8f2385786c2b296f","64d48c6c9c7940639a932219a6c87198",22857837,1,1,0,98,39,40,1
"64d48c6c9c7940639a932219a6c87198","67a089198fcb4e1c8f2385786c2b296f",22857837,1,-1,0,99,40,39,-1
"67a089198fcb4e1c8f2385786c2b296f","b534b89233134e30a9b5645138bfa9ee",22857837,1,4,0,100,39,41,2
"b534b89233134e30a9b5645138bfa9ee","0e37b720d23b4e7f8b313e79313fd107",22857837,1,3,0,101,41,44,3
"0e37b720d23b4e7f8b313e79313fd107","0e37b720d23b4e7f8b313e79313fd107",22857837,3,0,1,102,44,44,0
"0e37b720d23b4e7f8b313e79313fd107","6875d67fdd5f48168b62719df449bebd",22857837,1,1,0,105,44,45,1
"6875d67fdd5f48168b62719df449bebd","6875d67fdd5f48168b62719df449bebd",22857837,3,0,1,106,45,45,0
"6875d67fdd5f48168b62719df449bebd","b534b89233134e30a9b5645138bfa9ee",22857837,1,-4,0,109,45,41,-4
"b534b89233134e30a9b5645138bfa9ee","6e13d61a7bdb44bca949c9f86fab3be5",22857837,1,7,0,110,41,47,6
"6e13d61a7bdb44bca949c9f86fab3be5","195f78799f984cc2b06c48dfe36be751",22857837,1,2,0,111,47,49,2
"195f78799f984cc2b06c48dfe36be751","195f78799f984cc2b06c48dfe36be751",22857837,9,0,1,112,49,49,0
"195f78799f984cc2b06c48dfe36be751","d9c8d8c444a64dadbbb508652c721e17",22857837,1,-3,0,121,49,46,-3
"d9c8d8c444a64dadbbb508652c721e17","d0c74f735e024943943e40333d6d337f",22857837,1,6,0,122,46,51,5
"d0c74f735e024943943e40333d6d337f","983f8ff320594b279a7f4a6fe132f9c5",22857837,1,2,0,123,51,53,2
"983f8ff320594b279a7f4a6fe132f9c5","983f8ff320594b279a7f4a6fe132f9c5",22857837,5,0,1,124,53,53,0
"983f8ff320594b279a7f4a6fe132f9c5","35adfa5d923046aebabfefd98f35ff05",22857837,1,1,0,129,53,54,1
"35adfa5d923046aebabfefd98f35ff05","35adfa5d923046aebabfefd98f35ff05",22857837,2,0,1,130,54,54,0
"35adfa5d923046aebabfefd98f35ff05","b6f8a98476224da1b40e555ececc7ed8",22857837,1,1,0,132,54,55,1
"b6f8a98476224da1b40e555ececc7ed8","b6f8a98476224da1b40e555ececc7ed8",22857837,2,0,1,133,55,55,0
"b6f8a98476224da1b40e555ececc7ed8","86e22cb5fe0e4b47a9489ecddf7ed78f",22857837,1,1,0,135,55,56,1
"86e22cb5fe0e4b47a9489ecddf7ed78f","86e22cb5fe0e4b47a9489ecddf7ed78f",22857837,2,0,1,136,56,56,0
"86e22cb5fe0e4b47a9489ecddf7ed78f","f924752d8a1149668870b1e7698486f7",22857837,1,-6,0,138,56,50,-6
"f924752d8a1149668870b1e7698486f7","a1f2f12debe5432fb7a70bcd12bacfb9",22857837,1,9,0,139,50,58,8
"a1f2f12debe5432fb7a70bcd12bacfb9","78f30e4dcac84e3cbea8b2cc6e0d62b3",22857837,2,1,0,140,58,59,1
"78f30e4dcac84e3cbea8b2cc6e0d62b3","a1f2f12debe5432fb7a70bcd12bacfb9",22857837,2,-1,0,141,59,58,-1
"a1f2f12debe5432fb7a70bcd12bacfb9","a1f2f12debe5432fb7a70bcd12bacfb9",22857837,26,0,1,142,58,58,0
"78f30e4dcac84e3cbea8b2cc6e0d62b3","78f30e4dcac84e3cbea8b2cc6e0d62b3",22857837,8,0,1,146,59,59,0
"a1f2f12debe5432fb7a70bcd12bacfb9","bc42d26810654ea9a1df1efe1e58c7d5",22857837,1,6,0,178,58,63,5
"bc42d26810654ea9a1df1efe1e58c7d5","a0a418b8540d479fa6e0f653b701da8b",22857837,2,1,0,179,63,64,1
"a0a418b8540d479fa6e0f653b701da8b","12aa6e1672ac4e7aa6449a7a8609cd72",22857837,1,-8,0,180,64,57,-7
"12aa6e1672ac4e7aa6449a7a8609cd72","bc42d26810654ea9a1df1efe1e58c7d5",22857837,1,7,0,181,57,63,6
"bc42d26810654ea9a1df1efe1e58c7d5","bc42d26810654ea9a1df1efe1e58c7d5",22857837,3,0,1,182,63,63,0
"a0a418b8540d479fa6e0f653b701da8b","a0a418b8540d479fa6e0f653b701da8b",22857837,3,0,1,186,64,64,0
"a0a418b8540d479fa6e0f653b701da8b","309ccf3cc4fe429d9bfbaef53d3fa479",22857837,1,-4,0,189,64,60,-4
"309ccf3cc4fe429d9bfbaef53d3fa479","b534b89233134e30a9b5645138bfa9ee",22857837,1,-23,0,190,60,41,-19
"b534b89233134e30a9b5645138bfa9ee","d646286c8051419bbc2e31dd1db55ca8",22857837,1,33,0,191,41,67,26
"d646286c8051419bbc2e31dd1db55ca8","267f883678b24aed855fde42524975d9",22857837,1,4,0,192,67,71,4
"267f883678b24aed855fde42524975d9","267f883678b24aed855fde42524975d9",22857837,5,0,1,193,71,71,0
"267f883678b24aed855fde42524975d9","88fff56d0342490dbef9040750a20f6c",22857837,1,1,0,198,71,72,1
"88fff56d0342490dbef9040750a20f6c","88fff56d0342490dbef9040750a20f6c",22857837,1,0,1,199,72,72,0
"88fff56d0342490dbef9040750a20f6c","adb17b12b66c4a49a85fd34322f7df70",22857837,1,1,0,200,72,73,1
"adb17b12b66c4a49a85fd34322f7df70","adb17b12b66c4a49a85fd34322f7df70",22857837,3,0,1,201,73,73,0
"adb17b12b66c4a49a85fd34322f7df70","d646286c8051419bbc2e31dd1db55ca8",22857837,1,-6,0,204,73,67,-6
"d646286c8051419bbc2e31dd1db55ca8","a2becd407db34b189200a32546d9d569",22857837,1,9,0,205,67,75,8
"a2becd407db34b189200a32546d9d569","58c22b011d0f4c2ea6d13615edbb9eeb",22857837,1,2,0,206,75,77,2
"58c22b011d0f4c2ea6d13615edbb9eeb","58c22b011d0f4c2ea6d13615edbb9eeb",22857837,5,0,1,207,77,77,0
"58c22b011d0f4c2ea6d13615edbb9eeb","dd76e1861dc9461c830888729d091ee0",22857837,1,1,0,212,77,78,1
"dd76e1861dc9461c830888729d091ee0","dd76e1861dc9461c830888729d091ee0",22857837,5,0,1,213,78,78,0
"dd76e1861dc9461c830888729d091ee0","cd1d828f1a694b87913a7ea66c23803e",22857837,1,1,0,218,78,79,1
"cd1d828f1a694b87913a7ea66c23803e","cd1d828f1a694b87913a7ea66c23803e",22857837,8,0,1,219,79,79,0
"cd1d828f1a694b87913a7ea66c23803e","9176a3c2b4d2465fa8b0c67096c2a97e",22857837,1,1,0,227,79,80,1
"9176a3c2b4d2465fa8b0c67096c2a97e","9176a3c2b4d2465fa8b0c67096c2a97e",22857837,11,0,1,228,80,80,0
"9176a3c2b4d2465fa8b0c67096c2a97e","f8ec6445f7194e25b9101d4fbcb07a18",22857837,1,1,0,239,80,81,1
"f8ec6445f7194e25b9101d4fbcb07a18","f8ec6445f7194e25b9101d4fbcb07a18",22857837,2,0,1,240,81,81,0
"f8ec6445f7194e25b9101d4fbcb07a18","140d5b27b8574befad82c0a013b59dfa",22857837,1,-7,0,242,81,74,-7
"140d5b27b8574befad82c0a013b59dfa","d18a9ea32855445f8736581f5cb119ce",22857837,1,9,0,243,74,82,8
"d18a9ea32855445f8736581f5cb119ce","f564483cbd7a407681aa2fcca518cf5f",22857837,1,4,0,244,82,85,3
"f564483cbd7a407681aa2fcca518cf5f","f564483cbd7a407681aa2fcca518cf5f",22857837,3,0,1,245,85,85,0
"f564483cbd7a407681aa2fcca518cf5f","ae5ac430ea254e708a6f5deaaf7464ae",22857837,1,-1,0,248,85,84,-1
"ae5ac430ea254e708a6f5deaaf7464ae","0c7262dff33c4087bc660ccf40f92f9c",22857837,1,112,0,249,84,169,85
"0c7262dff33c4087bc660ccf40f92f9c","b2275c3fad834f8d90737a2d9a6927d6",22857837,1,3,0,250,169,172,3
"b2275c3fad834f8d90737a2d9a6927d6","b2275c3fad834f8d90737a2d9a6927d6",22857837,30,0,1,251,172,172,0
"b2275c3fad834f8d90737a2d9a6927d6","eb515a26030b41f8a82a1e6114420bad",22857837,1,1,0,281,172,173,1
"eb515a26030b41f8a82a1e6114420bad","eb515a26030b41f8a82a1e6114420bad",22857837,2,0,1,282,173,173,0
"eb515a26030b41f8a82a1e6114420bad","b42cc17b7de840f181a704558d0bc845",22857837,1,3,0,284,173,175,2
"b42cc17b7de840f181a704558d0bc845","0c7262dff33c4087bc660ccf40f92f9c",22857837,1,-7,0,285,175,169,-6
"0c7262dff33c4087bc660ccf40f92f9c","801f9e9135034f49bf5f8b4bdefedb41",22857837,1,9,0,286,169,177,8
"801f9e9135034f49bf5f8b4bdefedb41","801f9e9135034f49bf5f8b4bdefedb41",22857837,11,0,1,287,177,177,0
"801f9e9135034f49bf5f8b4bdefedb41","ea38cc0e6e6e41edbabf210220808bf9",22857837,1,3,0,298,177,179,2
"ea38cc0e6e6e41edbabf210220808bf9","362fcb0699a14845ab29b2340093e528",22857837,1,-6,0,299,179,174,-5
"362fcb0699a14845ab29b2340093e528","b87c552dd247427abe6ab5795b9c9d43",22857837,1,8,0,300,174,181,7
"b87c552dd247427abe6ab5795b9c9d43","b87c552dd247427abe6ab5795b9c9d43",22857837,8,0,1,301,181,181,0
"b87c552dd247427abe6ab5795b9c9d43","139b097acfca451689d80c9c6eebdf7b",22857837,1,-3,0,309,181,178,-3
"139b097acfca451689d80c9c6eebdf7b","30f660a1feb34582a739722532524f79",22857837,1,6,0,310,178,183,5
"30f660a1feb34582a739722532524f79","30f660a1feb34582a739722532524f79",22857837,7,0,1,311,183,183,0
"30f660a1feb34582a739722532524f79","2024b4885bd14338a39b7b509acbbd02",22857837,1,-1,0,318,183,182,-1
"2024b4885bd14338a39b7b509acbbd02","c3f63fe50d8e487c86bf8ef76c9cadd3",22857837,1,4,0,319,182,185,3
"c3f63fe50d8e487c86bf8ef76c9cadd3","c3f63fe50d8e487c86bf8ef76c9cadd3",22857837,3,0,1,320,185,185,0
"c3f63fe50d8e487c86bf8ef76c9cadd3","0c7262dff33c4087bc660ccf40f92f9c",22857837,1,-20,0,323,185,169,-16
"0c7262dff33c4087bc660ccf40f92f9c","c8e371568a0c4391b25796ae4e91952e",22857837,1,23,0,324,169,186,17
"c8e371568a0c4391b25796ae4e91952e","7d932b23e1c84326ae5aa4d3c0d813d1",22857837,1,2,0,325,186,188,2
"7d932b23e1c84326ae5aa4d3c0d813d1","7d932b23e1c84326ae5aa4d3c0d813d1",22857837,1,0,1,326,188,188,0
"7d932b23e1c84326ae5aa4d3c0d813d1","c8e371568a0c4391b25796ae4e91952e",22857837,1,-2,0,327,188,186,-2
"c8e371568a0c4391b25796ae4e91952e","ab11d94c6c8948ea90b88f19d2cd502b",22857837,1,5,0,328,186,190,4
"ab11d94c6c8948ea90b88f19d2cd502b","f992451ed6ad4e68bb9e68ad6be7c4be",22857837,1,2,0,329,190,192,2
"f992451ed6ad4e68bb9e68ad6be7c4be","f992451ed6ad4e68bb9e68ad6be7c4be",22857837,5,0,1,330,192,192,0
"f992451ed6ad4e68bb9e68ad6be7c4be","07b44a7a51e94c78b411c753fc39dab0",22857837,1,-3,0,335,192,189,-3
"07b44a7a51e94c78b411c753fc39dab0","6cd2dcaac46847d4a0bc53f296d90375",22857837,1,6,0,336,189,194,5
"6cd2dcaac46847d4a0bc53f296d90375","2d2580c9411c4972909db508d6956a58",22857837,1,2,0,337,194,196,2
"2d2580c9411c4972909db508d6956a58","2d2580c9411c4972909db508d6956a58",22857837,5,0,1,338,196,196,0
"2d2580c9411c4972909db508d6956a58","5bddb3d9ed264f3984702f048c7e5340",22857837,1,1,0,343,196,197,1
"5bddb3d9ed264f3984702f048c7e5340","5bddb3d9ed264f3984702f048c7e5340",22857837,2,0,1,344,197,197,0
"5bddb3d9ed264f3984702f048c7e5340","d5e8e2bd12a2466b9d6d90855f0eb079",22857837,1,1,0,346,197,198,1
"d5e8e2bd12a2466b9d6d90855f0eb079","d5e8e2bd12a2466b9d6d90855f0eb079",22857837,2,0,1,347,198,198,0
"d5e8e2bd12a2466b9d6d90855f0eb079","017d7ca8e0394b91aaadc9574df2202c",22857837,1,-5,0,349,198,193,-5
"017d7ca8e0394b91aaadc9574df2202c","54e8e9f0ea3e45c4bf3b8ac799ee31b1",22857837,1,8,0,350,193,200,7
"54e8e9f0ea3e45c4bf3b8ac799ee31b1","54e8e9f0ea3e45c4bf3b8ac799ee31b1",22857837,3,0,1,351,200,200,0
"54e8e9f0ea3e45c4bf3b8ac799ee31b1","c614a00911be4877a075f19315530fb0",22857837,1,1,0,354,200,201,1
"c614a00911be4877a075f19315530fb0","c614a00911be4877a075f19315530fb0",22857837,6,0,1,355,201,201,0
"b613861cecf84ffcab01afb23f660475","b613861cecf84ffcab01afb23f660475",22858690,4,0,1,1,1,1,0
"b613861cecf84ffcab01afb23f660475","e2911e79efc2420eac45d9f671463d4b",22858690,1,3,0,5,1,2,1
"e2911e79efc2420eac45d9f671463d4b","e2911e79efc2420eac45d9f671463d4b",22858690,2,0,1,6,2,2,0
"e2911e79efc2420eac45d9f671463d4b","519d1b8c59404d67b54e96c5c8a830b2",22858690,1,1,0,8,2,3,1
"519d1b8c59404d67b54e96c5c8a830b2","519d1b8c59404d67b54e96c5c8a830b2",22858690,1,0,1,9,3,3,0
"519d1b8c59404d67b54e96c5c8a830b2","531db53f81f646edb0cdcfe0085b03b7",22858690,1,1,0,10,3,4,1
"531db53f81f646edb0cdcfe0085b03b7","531db53f81f646edb0cdcfe0085b03b7",22858690,1,0,1,11,4,4,0
"531db53f81f646edb0cdcfe0085b03b7","4f5f94b2f95141e0a9d53a61da2276da",22858690,1,1,0,12,4,5,1
"4f5f94b2f95141e0a9d53a61da2276da","4f5f94b2f95141e0a9d53a61da2276da",22858690,1,0,1,13,5,5,0
"4f5f94b2f95141e0a9d53a61da2276da","6d541c89590949f99af293c4f2333f67",22858690,1,1,0,14,5,6,1
"6d541c89590949f99af293c4f2333f67","6d541c89590949f99af293c4f2333f67",22858690,1,0,1,15,6,6,0
"6d541c89590949f99af293c4f2333f67","dd5cf0b9fe4c4f1d8f5ff8e4c04879cb",22858690,1,1,0,16,6,7,1
"dd5cf0b9fe4c4f1d8f5ff8e4c04879cb","dd5cf0b9fe4c4f1d8f5ff8e4c04879cb",22858690,1,0,1,17,7,7,0
"dd5cf0b9fe4c4f1d8f5ff8e4c04879cb","f96261861edc426abe2248be4f0a709a",22858690,1,1,0,18,7,8,1
"f96261861edc426abe2248be4f0a709a","f96261861edc426abe2248be4f0a709a",22858690,1,0,1,19,8,8,0
"f96261861edc426abe2248be4f0a709a","66b5e16f4f75454fb5b8172079f0fa83",22858690,1,1,0,20,8,9,1
"66b5e16f4f75454fb5b8172079f0fa83","66b5e16f4f75454fb5b8172079f0fa83",22858690,1,0,1,21,9,9,0
"66b5e16f4f75454fb5b8172079f0fa83","0680571d4698477995e41842c36a54b2",22858690,1,1,0,22,9,10,1
"0680571d4698477995e41842c36a54b2","0680571d4698477995e41842c36a54b2",22858690,1,0,1,23,10,10,0
"0680571d4698477995e41842c36a54b2","9112f2bffece48e08c6d2287be204085",22858690,1,1,0,24,10,11,1
"9112f2bffece48e08c6d2287be204085","9112f2bffece48e08c6d2287be204085",22858690,1,0,1,25,11,11,0
"9112f2bffece48e08c6d2287be204085","56586aa865414f538729c7f7735d2bc6",22858690,1,3,0,26,11,12,1
"56586aa865414f538729c7f7735d2bc6","e2911e79efc2420eac45d9f671463d4b",22858690,1,-12,0,27,12,2,-10
"e2911e79efc2420eac45d9f671463d4b","56586aa865414f538729c7f7735d2bc6",22858690,1,12,0,28,2,12,10
"56586aa865414f538729c7f7735d2bc6","56586aa865414f538729c7f7735d2bc6",22858690,2,0,1,29,12,12,0
"56586aa865414f538729c7f7735d2bc6","b7f2b31585d94eb3bf86376714aa7070",22858690,1,2,0,31,12,13,1
"b7f2b31585d94eb3bf86376714aa7070","b7f2b31585d94eb3bf86376714aa7070",22858690,2,0,1,32,13,13,0
"b7f2b31585d94eb3bf86376714aa7070","3f1c815879794b929260d224becaff7e",22858690,1,2,0,34,13,14,1
"3f1c815879794b929260d224becaff7e","5c5ceeee4562457ba6d41515aeebfbb1",22858690,1,6,0,35,14,17,3
"5c5ceeee4562457ba6d41515aeebfbb1","81c864a886d54a6b8ff85f7d736f4f95",22858690,1,-4,0,36,17,15,-2
"81c864a886d54a6b8ff85f7d736f4f95","5c5ceeee4562457ba6d41515aeebfbb1",22858690,1,4,0,37,15,17,2
"5c5ceeee4562457ba6d41515aeebfbb1","56586aa865414f538729c7f7735d2bc6",22858690,1,-10,0,38,17,12,-5
"56586aa865414f538729c7f7735d2bc6","9afd71a5298d4333b6849dfce1b9422c",22858690,1,13,0,39,12,18,6
"9afd71a5298d4333b6849dfce1b9422c","9afd71a5298d4333b6849dfce1b9422c",22858690,3,0,1,40,18,18,0
"9afd71a5298d4333b6849dfce1b9422c","b7719e26494940efa49512aedd0aac79",22858690,1,4,0,43,18,20,2
"b7719e26494940efa49512aedd0aac79","d4f45188d3c84a02ba08454e6403a818",22858690,1,5,0,44,20,24,4
"d4f45188d3c84a02ba08454e6403a818","d4c3b003e8274e429d2fa688d73fde6d",22858690,1,-2,0,45,24,22,-2
"d4c3b003e8274e429d2fa688d73fde6d","d4c3b003e8274e429d2fa688d73fde6d",22858690,1,0,1,46,22,22,0
"d4c3b003e8274e429d2fa688d73fde6d","5bc03c8f16354d04bd51f5bb93559ad3",22858690,1,4,0,47,22,26,4
"5bc03c8f16354d04bd51f5bb93559ad3","b7719e26494940efa49512aedd0aac79",22858690,1,-7,0,48,26,20,-6
"b7719e26494940efa49512aedd0aac79","b7719e26494940efa49512aedd0aac79",22858690,1,0,1,49,20,20,0
"b7719e26494940efa49512aedd0aac79","afbf7250b99d47bea07172749483ca97",22858690,1,12,0,50,20,28,8
"afbf7250b99d47bea07172749483ca97","afbf7250b99d47bea07172749483ca97",22858690,1,0,1,51,28,28,0
"afbf7250b99d47bea07172749483ca97","4e51676dc72045d99c19b9fa7b22f8bc",22858690,1,3,0,52,28,29,1
"4e51676dc72045d99c19b9fa7b22f8bc","4e51676dc72045d99c19b9fa7b22f8bc",22858690,1,0,1,53,29,29,0
"4e51676dc72045d99c19b9fa7b22f8bc","51970cfa30e643e894e66ae85c8024cc",22858690,1,3,0,54,29,31,2
"51970cfa30e643e894e66ae85c8024cc","4e51676dc72045d99c19b9fa7b22f8bc",22858690,1,-3,0,55,31,29,-2
"4e51676dc72045d99c19b9fa7b22f8bc","c33c17be71ae4d588da7369472e5bb1b",22858690,1,9,0,56,29,34,5
"c33c17be71ae4d588da7369472e5bb1b","93679be414554a11b1893002f2229a93",22858690,2,3,0,57,34,35,1
"93679be414554a11b1893002f2229a93","c33c17be71ae4d588da7369472e5bb1b",22858690,1,-3,0,58,35,34,-1
"93679be414554a11b1893002f2229a93","7040a13096d746ac84b8fac8d9752058",22858690,1,3,0,60,35,36,1
"7040a13096d746ac84b8fac8d9752058","9a0dc646f934470daf08c4b56ccf73db",22858690,1,3,0,61,36,37,1
"9a0dc646f934470daf08c4b56ccf73db","7040a13096d746ac84b8fac8d9752058",22858690,1,-3,0,62,37,36,-1
"7040a13096d746ac84b8fac8d9752058","fc0e049d56024bc9a02c9a9c435c3df7",22858690,1,6,0,63,36,38,2
"fc0e049d56024bc9a02c9a9c435c3df7","9a0dc646f934470daf08c4b56ccf73db",22858690,1,-3,0,64,38,37,-1
"9a0dc646f934470daf08c4b56ccf73db","67a089198fcb4e1c8f2385786c2b296f",22858690,1,7,0,65,37,39,2
"67a089198fcb4e1c8f2385786c2b296f","fc0e049d56024bc9a02c9a9c435c3df7",22858690,1,-4,0,66,39,38,-1
"fc0e049d56024bc9a02c9a9c435c3df7","64d48c6c9c7940639a932219a6c87198",22858690,1,5,0,67,38,40,2
"64d48c6c9c7940639a932219a6c87198","64d48c6c9c7940639a932219a6c87198",22858690,1,0,1,68,40,40,0
"64d48c6c9c7940639a932219a6c87198","b534b89233134e30a9b5645138bfa9ee",22858690,1,3,0,69,40,41,1
"b534b89233134e30a9b5645138bfa9ee","67a089198fcb4e1c8f2385786c2b296f",22858690,1,-4,0,70,41,39,-2
"67a089198fcb4e1c8f2385786c2b296f","0e37b720d23b4e7f8b313e79313fd107",22858690,1,7,0,71,39,44,5
"0e37b720d23b4e7f8b313e79313fd107","0e37b720d23b4e7f8b313e79313fd107",22858690,1,0,1,72,44,44,0
"0e37b720d23b4e7f8b313e79313fd107","6875d67fdd5f48168b62719df449bebd",22858690,1,1,0,73,44,45,1
"6875d67fdd5f48168b62719df449bebd","6875d67fdd5f48168b62719df449bebd",22858690,1,0,1,74,45,45,0
"6875d67fdd5f48168b62719df449bebd","b534b89233134e30a9b5645138bfa9ee",22858690,1,-4,0,75,45,41,-4
"b534b89233134e30a9b5645138bfa9ee","6e13d61a7bdb44bca949c9f86fab3be5",22858690,1,7,0,76,41,47,6
"6e13d61a7bdb44bca949c9f86fab3be5","6e13d61a7bdb44bca949c9f86fab3be5",22858690,1,0,1,77,47,47,0
"6e13d61a7bdb44bca949c9f86fab3be5","195f78799f984cc2b06c48dfe36be751",22858690,1,2,0,78,47,49,2
"195f78799f984cc2b06c48dfe36be751","195f78799f984cc2b06c48dfe36be751",22858690,2,0,1,79,49,49,0
"195f78799f984cc2b06c48dfe36be751","d0c74f735e024943943e40333d6d337f",22858690,1,3,0,81,49,51,2
"d0c74f735e024943943e40333d6d337f","d9c8d8c444a64dadbbb508652c721e17",22858690,1,-6,0,82,51,46,-5
"d9c8d8c444a64dadbbb508652c721e17","d0c74f735e024943943e40333d6d337f",22858690,1,6,0,83,46,51,5
"d0c74f735e024943943e40333d6d337f","983f8ff320594b279a7f4a6fe132f9c5",22858690,1,2,0,84,51,53,2
"983f8ff320594b279a7f4a6fe132f9c5","983f8ff320594b279a7f4a6fe132f9c5",22858690,2,0,1,85,53,53,0
"983f8ff320594b279a7f4a6fe132f9c5","35adfa5d923046aebabfefd98f35ff05",22858690,1,1,0,87,53,54,1
"35adfa5d923046aebabfefd98f35ff05","35adfa5d923046aebabfefd98f35ff05",22858690,5,0,1,88,54,54,0
"35adfa5d923046aebabfefd98f35ff05","b6f8a98476224da1b40e555ececc7ed8",22858690,1,1,0,93,54,55,1
"b6f8a98476224da1b40e555ececc7ed8","b6f8a98476224da1b40e555ececc7ed8",22858690,2,0,1,94,55,55,0
"b6f8a98476224da1b40e555ececc7ed8","86e22cb5fe0e4b47a9489ecddf7ed78f",22858690,1,1,0,96,55,56,1
"86e22cb5fe0e4b47a9489ecddf7ed78f","86e22cb5fe0e4b47a9489ecddf7ed78f",22858690,2,0,1,97,56,56,0
"86e22cb5fe0e4b47a9489ecddf7ed78f","f924752d8a1149668870b1e7698486f7",22858690,1,-6,0,99,56,50,-6
"f924752d8a1149668870b1e7698486f7","78f30e4dcac84e3cbea8b2cc6e0d62b3",22858690,1,10,0,100,50,59,9
"78f30e4dcac84e3cbea8b2cc6e0d62b3","a1f2f12debe5432fb7a70bcd12bacfb9",22858690,1,-1,0,101,59,58,-1
"a1f2f12debe5432fb7a70bcd12bacfb9","a1f2f12debe5432fb7a70bcd12bacfb9",22858690,14,0,1,102,58,58,0
"a1f2f12debe5432fb7a70bcd12bacfb9","78f30e4dcac84e3cbea8b2cc6e0d62b3",22858690,1,1,0,116,58,59,1
"78f30e4dcac84e3cbea8b2cc6e0d62b3","78f30e4dcac84e3cbea8b2cc6e0d62b3",22858690,7,0,1,117,59,59,0
"78f30e4dcac84e3cbea8b2cc6e0d62b3","a0a418b8540d479fa6e0f653b701da8b",22858690,1,6,0,124,59,64,5
"a0a418b8540d479fa6e0f653b701da8b","bc42d26810654ea9a1df1efe1e58c7d5",22858690,1,-1,0,125,64,63,-1
"bc42d26810654ea9a1df1efe1e58c7d5","12aa6e1672ac4e7aa6449a7a8609cd72",22858690,1,-7,0,126,63,57,-6
"12aa6e1672ac4e7aa6449a7a8609cd72","4c943503763e4e349906eea3ed3c8e86",22858690,1,5,0,127,57,61,4
"4c943503763e4e349906eea3ed3c8e86","4c943503763e4e349906eea3ed3c8e86",22858690,1,0,1,128,61,61,0
"4c943503763e4e349906eea3ed3c8e86","bc42d26810654ea9a1df1efe1e58c7d5",22858690,1,2,0,129,61,63,2
"bc42d26810654ea9a1df1efe1e58c7d5","bc42d26810654ea9a1df1efe1e58c7d5",22858690,3,0,1,130,63,63,0
"bc42d26810654ea9a1df1efe1e58c7d5","a0a418b8540d479fa6e0f653b701da8b",22858690,1,1,0,133,63,64,1
"a0a418b8540d479fa6e0f653b701da8b","a0a418b8540d479fa6e0f653b701da8b",22858690,3,0,1,134,64,64,0
"a0a418b8540d479fa6e0f653b701da8b","309ccf3cc4fe429d9bfbaef53d3fa479",22858690,1,-4,0,137,64,60,-4
"309ccf3cc4fe429d9bfbaef53d3fa479","d646286c8051419bbc2e31dd1db55ca8",22858690,1,10,0,138,60,67,7
"d646286c8051419bbc2e31dd1db55ca8","b534b89233134e30a9b5645138bfa9ee",22858690,1,-33,0,139,67,41,-26
"b534b89233134e30a9b5645138bfa9ee","267f883678b24aed855fde42524975d9",22858690,1,37,0,140,41,71,30
"267f883678b24aed855fde42524975d9","267f883678b24aed855fde42524975d9",22858690,1,0,1,141,71,71,0
"267f883678b24aed855fde42524975d9","88fff56d0342490dbef9040750a20f6c",22858690,1,1,0,142,71,72,1
"88fff56d0342490dbef9040750a20f6c","88fff56d0342490dbef9040750a20f6c",22858690,1,0,1,143,72,72,0
"88fff56d0342490dbef9040750a20f6c","adb17b12b66c4a49a85fd34322f7df70",22858690,1,1,0,144,72,73,1
"adb17b12b66c4a49a85fd34322f7df70","adb17b12b66c4a49a85fd34322f7df70",22858690,1,0,1,145,73,73,0
"adb17b12b66c4a49a85fd34322f7df70","d646286c8051419bbc2e31dd1db55ca8",22858690,1,-6,0,146,73,67,-6
"d646286c8051419bbc2e31dd1db55ca8","a2becd407db34b189200a32546d9d569",22858690,1,9,0,147,67,75,8
"a2becd407db34b189200a32546d9d569","a2becd407db34b189200a32546d9d569",22858690,1,0,1,148,75,75,0
"a2becd407db34b189200a32546d9d569","58c22b011d0f4c2ea6d13615edbb9eeb",22858690,1,2,0,149,75,77,2
"58c22b011d0f4c2ea6d13615edbb9eeb","58c22b011d0f4c2ea6d13615edbb9eeb",22858690,2,0,1,150,77,77,0
"58c22b011d0f4c2ea6d13615edbb9eeb","dd76e1861dc9461c830888729d091ee0",22858690,1,1,0,152,77,78,1
"dd76e1861dc9461c830888729d091ee0","dd76e1861dc9461c830888729d091ee0",22858690,5,0,1,153,78,78,0
"dd76e1861dc9461c830888729d091ee0","cd1d828f1a694b87913a7ea66c23803e",22858690,1,1,0,158,78,79,1
"cd1d828f1a694b87913a7ea66c23803e","cd1d828f1a694b87913a7ea66c23803e",22858690,2,0,1,159,79,79,0
"cd1d828f1a694b87913a7ea66c23803e","9176a3c2b4d2465fa8b0c67096c2a97e",22858690,1,1,0,161,79,80,1
"9176a3c2b4d2465fa8b0c67096c2a97e","9176a3c2b4d2465fa8b0c67096c2a97e",22858690,5,0,1,162,80,80,0
"9176a3c2b4d2465fa8b0c67096c2a97e","f8ec6445f7194e25b9101d4fbcb07a18",22858690,1,1,0,167,80,81,1
"f8ec6445f7194e25b9101d4fbcb07a18","f8ec6445f7194e25b9101d4fbcb07a18",22858690,2,0,1,168,81,81,0
"f8ec6445f7194e25b9101d4fbcb07a18","140d5b27b8574befad82c0a013b59dfa",22858690,1,-7,0,170,81,74,-7
"140d5b27b8574befad82c0a013b59dfa","d18a9ea32855445f8736581f5cb119ce",22858690,1,9,0,171,74,82,8
"d18a9ea32855445f8736581f5cb119ce","f564483cbd7a407681aa2fcca518cf5f",22858690,1,4,0,172,82,85,3
"f564483cbd7a407681aa2fcca518cf5f","f564483cbd7a407681aa2fcca518cf5f",22858690,1,0,1,173,85,85,0
"f564483cbd7a407681aa2fcca518cf5f","18fd01350bd5434ca636d59a599d768a",22858690,1,1,0,174,85,86,1
"18fd01350bd5434ca636d59a599d768a","18fd01350bd5434ca636d59a599d768a",22858690,8,0,1,175,86,86,0
"18fd01350bd5434ca636d59a599d768a","6a9f0ef185fb47f0937e29daa1c71ed5",22858690,1,5,0,183,86,90,4
"6a9f0ef185fb47f0937e29daa1c71ed5","ae5ac430ea254e708a6f5deaaf7464ae",22858690,1,-7,0,184,90,84,-6
"ae5ac430ea254e708a6f5deaaf7464ae","c681290961c94c4caf23b529d1ae6b9a",22858690,1,5,0,185,84,88,4
"c681290961c94c4caf23b529d1ae6b9a","c681290961c94c4caf23b529d1ae6b9a",22858690,3,0,1,186,88,88,0
"c681290961c94c4caf23b529d1ae6b9a","6a9f0ef185fb47f0937e29daa1c71ed5",22858690,1,2,0,189,88,90,2
"6a9f0ef185fb47f0937e29daa1c71ed5","6a9f0ef185fb47f0937e29daa1c71ed5",22858690,3,0,1,190,90,90,0
"6a9f0ef185fb47f0937e29daa1c71ed5","e20db35ced8544ddac5bc3839145e463",22858690,1,3,0,193,90,91,1
"e20db35ced8544ddac5bc3839145e463","d646286c8051419bbc2e31dd1db55ca8",22858690,1,-30,0,194,91,67,-24
"d646286c8051419bbc2e31dd1db55ca8","1febb706d7a34005ae8711ed49c76e64",22858690,1,33,0,195,67,94,27
"1febb706d7a34005ae8711ed49c76e64","1febb706d7a34005ae8711ed49c76e64",22858690,2,0,1,196,94,94,0
"1febb706d7a34005ae8711ed49c76e64","8f73ba6f5a0042f2850356ac38ac6f24",22858690,1,1,0,198,94,95,1
"8f73ba6f5a0042f2850356ac38ac6f24","8f73ba6f5a0042f2850356ac38ac6f24",22858690,5,0,1,199,95,95,0
"8f73ba6f5a0042f2850356ac38ac6f24","e2260b86653c46d7b14a41fb419dbf8c",22858690,1,1,0,204,95,96,1
"e2260b86653c46d7b14a41fb419dbf8c","e2260b86653c46d7b14a41fb419dbf8c",22858690,2,0,1,205,96,96,0
"e2260b86653c46d7b14a41fb419dbf8c","35eb641ad1d845bbba54915bce75a962",22858690,1,1,0,207,96,97,1
"35eb641ad1d845bbba54915bce75a962","35eb641ad1d845bbba54915bce75a962",22858690,5,0,1,208,97,97,0
"35eb641ad1d845bbba54915bce75a962","08be90ffbeea4795a138cd42ed8db56f",22858690,1,1,0,213,97,98,1
"08be90ffbeea4795a138cd42ed8db56f","08be90ffbeea4795a138cd42ed8db56f",22858690,5,0,1,214,98,98,0
"08be90ffbeea4795a138cd42ed8db56f","3007433c8f584dcbb5ac159c1c5f2be3",22858690,1,1,0,219,98,99,1
"3007433c8f584dcbb5ac159c1c5f2be3","3007433c8f584dcbb5ac159c1c5f2be3",22858690,5,0,1,220,99,99,0
"3007433c8f584dcbb5ac159c1c5f2be3","00ae5f0c51874a73a41ebea838d95682",22858690,1,3,0,225,99,101,2
"00ae5f0c51874a73a41ebea838d95682","e20db35ced8544ddac5bc3839145e463",22858690,2,-11,0,226,101,91,-10
"e20db35ced8544ddac5bc3839145e463","d391c8b6e56a43a7b654e9dee02d904b",22858690,2,13,0,227,91,103,12
"d391c8b6e56a43a7b654e9dee02d904b","00ae5f0c51874a73a41ebea838d95682",22858690,2,-2,0,228,103,101,-2
"00ae5f0c51874a73a41ebea838d95682","d391c8b6e56a43a7b654e9dee02d904b",22858690,1,2,0,229,101,103,2
"d391c8b6e56a43a7b654e9dee02d904b","d391c8b6e56a43a7b654e9dee02d904b",22858690,15,0,1,230,103,103,0
"d391c8b6e56a43a7b654e9dee02d904b","6111116566fc4fd9abba409322bea245",22858690,1,1,0,245,103,104,1
"6111116566fc4fd9abba409322bea245","6111116566fc4fd9abba409322bea245",22858690,2,0,1,246,104,104,0
"6111116566fc4fd9abba409322bea245","a81b2235cb9c499eb9ea8ee0a8dd9725",22858690,1,1,0,248,104,105,1
"a81b2235cb9c499eb9ea8ee0a8dd9725","a81b2235cb9c499eb9ea8ee0a8dd9725",22858690,2,0,1,249,105,105,0
"a81b2235cb9c499eb9ea8ee0a8dd9725","2d4e0ab0ef3b4d73b82c72d4621a7579",22858690,1,1,0,251,105,106,1
"2d4e0ab0ef3b4d73b82c72d4621a7579","2d4e0ab0ef3b4d73b82c72d4621a7579",22858690,2,0,1,252,106,106,0
"2d4e0ab0ef3b4d73b82c72d4621a7579","8bdebf492ebd4e62b0d522e8ab5e5197",22858690,1,1,0,254,106,107,1
"8bdebf492ebd4e62b0d522e8ab5e5197","8bdebf492ebd4e62b0d522e8ab5e5197",22858690,2,0,1,255,107,107,0
"8bdebf492ebd4e62b0d522e8ab5e5197","4280927ec4d643238aa49c32f9e06c6c",22858690,1,3,0,257,107,109,2
"4280927ec4d643238aa49c32f9e06c6c","73039f8c1eb9409cb4caee2cf968001e",22858690,1,-10,0,258,109,100,-9
"73039f8c1eb9409cb4caee2cf968001e","4280927ec4d643238aa49c32f9e06c6c",22858690,1,10,0,259,100,109,9
"4280927ec4d643238aa49c32f9e06c6c","fc44e6a5f7654430af1227838224dceb",22858690,1,2,0,260,109,111,2
"fc44e6a5f7654430af1227838224dceb","fc44e6a5f7654430af1227838224dceb",22858690,5,0,1,261,111,111,0
"fc44e6a5f7654430af1227838224dceb","a9ae0a3c070d455bb4369a8996313336",22858690,1,4,0,266,111,114,3
"a9ae0a3c070d455bb4369a8996313336","08111f75e22d409998cf8b85bd431f0a",22858690,1,-7,0,267,114,108,-6
"08111f75e22d409998cf8b85bd431f0a","a9ae0a3c070d455bb4369a8996313336",22858690,1,7,0,268,108,114,6
"a9ae0a3c070d455bb4369a8996313336","e20db35ced8544ddac5bc3839145e463",22858690,1,-26,0,269,114,91,-23
"e20db35ced8544ddac5bc3839145e463","73039f8c1eb9409cb4caee2cf968001e",22858690,1,10,0,273,91,100,9
"73039f8c1eb9409cb4caee2cf968001e","62bff51286ef4f348717a3cf6fe2318f",22858690,1,23,0,274,100,120,20
"62bff51286ef4f348717a3cf6fe2318f","e20db35ced8544ddac5bc3839145e463",22858690,2,-33,0,275,120,91,-29
"e20db35ced8544ddac5bc3839145e463","62bff51286ef4f348717a3cf6fe2318f",22858690,1,33,0,276,91,120,29
"62bff51286ef4f348717a3cf6fe2318f","779f9ddd1fd14d1e9e69f72219a1fdbd",22858690,1,3,0,277,120,121,1
"779f9ddd1fd14d1e9e69f72219a1fdbd","e20db35ced8544ddac5bc3839145e463",22858690,1,-36,0,278,121,91,-30
"e20db35ced8544ddac5bc3839145e463","a8dd5213034441ac92724b4e83eb0bb2",22858690,1,45,0,279,91,129,38
"a8dd5213034441ac92724b4e83eb0bb2","779f9ddd1fd14d1e9e69f72219a1fdbd",22858690,1,-9,0,280,129,121,-8
"779f9ddd1fd14d1e9e69f72219a1fdbd","579338175e0b4bbb8ef3b712b5d8b54e",22858690,1,8,0,281,121,128,7
"579338175e0b4bbb8ef3b712b5d8b54e","a8dd5213034441ac92724b4e83eb0bb2",22858690,1,1,0,282,128,129,1
"a8dd5213034441ac92724b4e83eb0bb2","b416d47c56a742199b5d7c7f19d6503a",22858690,1,6,0,283,129,134,5
"b416d47c56a742199b5d7c7f19d6503a","579338175e0b4bbb8ef3b712b5d8b54e",22858690,1,-7,0,284,134,128,-6
"579338175e0b4bbb8ef3b712b5d8b54e","b416d47c56a742199b5d7c7f19d6503a",22858690,1,7,0,285,128,134,6
"b416d47c56a742199b5d7c7f19d6503a","e20db35ced8544ddac5bc3839145e463",22858690,1,-51,0,286,134,91,-43
"e20db35ced8544ddac5bc3839145e463","779f9ddd1fd14d1e9e69f72219a1fdbd",22858690,2,36,0,287,91,121,30
"779f9ddd1fd14d1e9e69f72219a1fdbd","62bff51286ef4f348717a3cf6fe2318f",22858690,1,-3,0,288,121,120,-1
"62bff51286ef4f348717a3cf6fe2318f","3ec3a3563847406fa73338f9e9999cf3",22858690,1,-3,0,289,120,117,-3
"3ec3a3563847406fa73338f9e9999cf3","a9ae0a3c070d455bb4369a8996313336",22858690,1,-4,0,290,117,114,-3
"a9ae0a3c070d455bb4369a8996313336","71cec822bcff4f30a20e75dc63ef7b65",22858690,1,2,0,291,114,116,2
"71cec822bcff4f30a20e75dc63ef7b65","71cec822bcff4f30a20e75dc63ef7b65",22858690,1,0,1,292,116,116,0
"71cec822bcff4f30a20e75dc63ef7b65","62bff51286ef4f348717a3cf6fe2318f",22858690,1,5,0,293,116,120,4
"62bff51286ef4f348717a3cf6fe2318f","37319e88176d4aefa91d7a9980dbae91",22858690,1,-9,0,294,120,112,-8
"37319e88176d4aefa91d7a9980dbae91","b1cd0e7dc3ad4a8eb91a4bfdbeb025b0",22858690,1,7,0,295,112,118,6
"b1cd0e7dc3ad4a8eb91a4bfdbeb025b0","b1cd0e7dc3ad4a8eb91a4bfdbeb025b0",22858690,1,0,1,296,118,118,0
"b1cd0e7dc3ad4a8eb91a4bfdbeb025b0","62bff51286ef4f348717a3cf6fe2318f",22858690,1,2,0,297,118,120,2
"62bff51286ef4f348717a3cf6fe2318f","62bff51286ef4f348717a3cf6fe2318f",22858690,3,0,1,298,120,120,0
"779f9ddd1fd14d1e9e69f72219a1fdbd","386a0044b3b843cc96cfd11f7f889fda",22858690,1,3,0,303,121,124,3
"386a0044b3b843cc96cfd11f7f889fda","386a0044b3b843cc96cfd11f7f889fda",22858690,1,0,1,304,124,124,0
"386a0044b3b843cc96cfd11f7f889fda","779f9ddd1fd14d1e9e69f72219a1fdbd",22858690,1,-3,0,305,124,121,-3
"779f9ddd1fd14d1e9e69f72219a1fdbd","ae26e6cda8ad4a3f81bd347560d9579f",22858690,1,4,0,306,121,125,4
"ae26e6cda8ad4a3f81bd347560d9579f","ae26e6cda8ad4a3f81bd347560d9579f",22858690,1,0,1,307,125,125,0
"ae26e6cda8ad4a3f81bd347560d9579f","ee48df95832b4374aa273ceb27ec1315",22858690,1,1,0,308,125,126,1
"ee48df95832b4374aa273ceb27ec1315","ee48df95832b4374aa273ceb27ec1315",22858690,1,0,1,309,126,126,0
"ee48df95832b4374aa273ceb27ec1315","7a439da90b394756ad1777fc4c6dead5",22858690,1,1,0,310,126,127,1
"7a439da90b394756ad1777fc4c6dead5","7a439da90b394756ad1777fc4c6dead5",22858690,1,0,1,311,127,127,0
"7a439da90b394756ad1777fc4c6dead5","779f9ddd1fd14d1e9e69f72219a1fdbd",22858690,1,-6,0,312,127,121,-6
"779f9ddd1fd14d1e9e69f72219a1fdbd","a8dd5213034441ac92724b4e83eb0bb2",22858690,1,9,0,313,121,129,8
"a8dd5213034441ac92724b4e83eb0bb2","a8dd5213034441ac92724b4e83eb0bb2",22858690,1,0,1,314,129,129,0
"a8dd5213034441ac92724b4e83eb0bb2","8115eab6556b45f5b415c3b8c26a12e5",22858690,1,2,0,315,129,131,2
"8115eab6556b45f5b415c3b8c26a12e5","8115eab6556b45f5b415c3b8c26a12e5",22858690,2,0,1,316,131,131,0
"8115eab6556b45f5b415c3b8c26a12e5","ec34b06efd844b46a4c4818ecdb9b8f4",22858690,1,1,0,318,131,132,1
"ec34b06efd844b46a4c4818ecdb9b8f4","ec34b06efd844b46a4c4818ecdb9b8f4",22858690,2,0,1,319,132,132,0
"ec34b06efd844b46a4c4818ecdb9b8f4","c2e1c2b9eac64109b343a088584b576b",22858690,1,1,0,321,132,133,1
"c2e1c2b9eac64109b343a088584b576b","c2e1c2b9eac64109b343a088584b576b",22858690,2,0,1,322,133,133,0
"c2e1c2b9eac64109b343a088584b576b","579338175e0b4bbb8ef3b712b5d8b54e",22858690,1,-5,0,324,133,128,-5
"579338175e0b4bbb8ef3b712b5d8b54e","8bc5795d6a984a3eace4e2811e52dd4f",22858690,1,8,0,325,128,135,7
"8bc5795d6a984a3eace4e2811e52dd4f","8bc5795d6a984a3eace4e2811e52dd4f",22858690,1,0,1,326,135,135,0
"8bc5795d6a984a3eace4e2811e52dd4f","b416d47c56a742199b5d7c7f19d6503a",22858690,1,-1,0,327,135,134,-1
"b416d47c56a742199b5d7c7f19d6503a","cd4532ad48034873ba8bce2aac0c9808",22858690,1,4,0,328,134,137,3
"cd4532ad48034873ba8bce2aac0c9808","cd4532ad48034873ba8bce2aac0c9808",22858690,1,0,1,329,137,137,0
"cd4532ad48034873ba8bce2aac0c9808","779f9ddd1fd14d1e9e69f72219a1fdbd",22858690,1,-19,0,330,137,121,-16
"779f9ddd1fd14d1e9e69f72219a1fdbd","df1de691dafe4549a18a4398ee9dfaf9",22858690,1,23,0,331,121,139,18
"df1de691dafe4549a18a4398ee9dfaf9","df1de691dafe4549a18a4398ee9dfaf9",22858690,1,0,1,332,139,139,0
"df1de691dafe4549a18a4398ee9dfaf9","83d311bed5374fee83d8d67a7d9d82dc",22858690,1,5,0,333,139,144,5
"83d311bed5374fee83d8d67a7d9d82dc","83d311bed5374fee83d8d67a7d9d82dc",22858690,1,0,1,334,144,144,0
"83d311bed5374fee83d8d67a7d9d82dc","402bba41861d43acb52a5abb89e8831e",22858690,1,1,0,335,144,145,1
"402bba41861d43acb52a5abb89e8831e","402bba41861d43acb52a5abb89e8831e",22858690,2,0,1,336,145,145,0
"402bba41861d43acb52a5abb89e8831e","df1de691dafe4549a18a4398ee9dfaf9",22858690,1,-6,0,338,145,139,-6
"df1de691dafe4549a18a4398ee9dfaf9","8aae34f5ddbb4052a709b12e6b0d40fa",22858690,1,9,0,339,139,147,8
"8aae34f5ddbb4052a709b12e6b0d40fa","8aae34f5ddbb4052a709b12e6b0d40fa",22858690,1,0,1,340,147,147,0
"8aae34f5ddbb4052a709b12e6b0d40fa","645b3f0249f64f76af2e19eb4d0e55b7",22858690,1,2,0,341,147,149,2
"645b3f0249f64f76af2e19eb4d0e55b7","645b3f0249f64f76af2e19eb4d0e55b7",22858690,5,0,1,342,149,149,0
"645b3f0249f64f76af2e19eb4d0e55b7","7e7b8db5064d4369805ab370aac5ddfb",22858690,1,1,0,347,149,150,1
"7e7b8db5064d4369805ab370aac5ddfb","7e7b8db5064d4369805ab370aac5ddfb",22858690,2,0,1,348,150,150,0
"7e7b8db5064d4369805ab370aac5ddfb","8956d210ae7f41968fada86d4c979d6a",22858690,1,1,0,350,150,151,1
"8956d210ae7f41968fada86d4c979d6a","8956d210ae7f41968fada86d4c979d6a",22858690,2,0,1,351,151,151,0
"8956d210ae7f41968fada86d4c979d6a","f902b0f41b544d4dbf79664fd233648d",22858690,1,-5,0,353,151,146,-5
"f902b0f41b544d4dbf79664fd233648d","ae781e8b775e4ccd93bc800dad5c8376",22858690,1,8,0,354,146,153,7
"ae781e8b775e4ccd93bc800dad5c8376","ae781e8b775e4ccd93bc800dad5c8376",22858690,2,0,1,355,153,153,0
"ae781e8b775e4ccd93bc800dad5c8376","06882a8492d9499aa31555567f575ecb",22858690,1,1,0,357,153,154,1
"06882a8492d9499aa31555567f575ecb","06882a8492d9499aa31555567f575ecb",22858690,1,0,1,358,154,154,0
"06882a8492d9499aa31555567f575ecb","f293c508f409466a8f27ddd7d1e40b20",22858690,1,1,0,359,154,155,1
"f293c508f409466a8f27ddd7d1e40b20","f293c508f409466a8f27ddd7d1e40b20",22858690,2,0,1,360,155,155,0
"f293c508f409466a8f27ddd7d1e40b20","cc4ddef5bbbe48ebb605141b347c4ed1",22858690,1,1,0,362,155,156,1
"cc4ddef5bbbe48ebb605141b347c4ed1","cc4ddef5bbbe48ebb605141b347c4ed1",22858690,1,0,1,363,156,156,0
"cc4ddef5bbbe48ebb605141b347c4ed1","f03480cf4eba413194d7af52fc0e7f28",22858690,1,-4,0,364,156,152,-4
"f03480cf4eba413194d7af52fc0e7f28","d313cec988a84645bee413e8d4724a4b",22858690,1,7,0,365,152,158,6
"d313cec988a84645bee413e8d4724a4b","d313cec988a84645bee413e8d4724a4b",22858690,4,0,1,366,158,158,0
"d313cec988a84645bee413e8d4724a4b","dc60696c76a74368a60f72246e47700d",22858690,1,1,0,370,158,159,1
"dc60696c76a74368a60f72246e47700d","dc60696c76a74368a60f72246e47700d",22858690,1,0,1,371,159,159,0
"dc60696c76a74368a60f72246e47700d","78adeee1fa2c4fe0bc73f7bca9fcee86",22858690,1,3,0,372,159,160,1
"78adeee1fa2c4fe0bc73f7bca9fcee86","df1de691dafe4549a18a4398ee9dfaf9",22858690,1,-26,0,373,160,139,-21
"df1de691dafe4549a18a4398ee9dfaf9","65202579580f4ad38d734b4ee39d22a8",22858690,1,31,0,374,139,164,25
"65202579580f4ad38d734b4ee39d22a8","65202579580f4ad38d734b4ee39d22a8",22858690,51,0,1,375,164,164,0
"65202579580f4ad38d734b4ee39d22a8","78adeee1fa2c4fe0bc73f7bca9fcee86",22858690,2,-5,0,376,164,160,-4
"78adeee1fa2c4fe0bc73f7bca9fcee86","65202579580f4ad38d734b4ee39d22a8",22858690,1,5,0,377,160,164,4
"78adeee1fa2c4fe0bc73f7bca9fcee86","3cbcea2be0984e7dbd5a48195af10ce7",22858690,1,8,0,429,160,165,5
"3cbcea2be0984e7dbd5a48195af10ce7","82e6285962b8400d9d6fc32436022a94",22858690,1,2,0,430,165,167,2
"82e6285962b8400d9d6fc32436022a94","3cbcea2be0984e7dbd5a48195af10ce7",22858690,1,-2,0,431,167,165,-2
"3cbcea2be0984e7dbd5a48195af10ce7","a9ac840f098c4bd0a2ee896214ce29cd",22858690,1,5,0,432,165,168,3
"a9ac840f098c4bd0a2ee896214ce29cd","a9ac840f098c4bd0a2ee896214ce29cd",22858690,1,0,1,433,168,168,0
"a9ac840f098c4bd0a2ee896214ce29cd","0c7262dff33c4087bc660ccf40f92f9c",22858690,1,4,0,434,168,169,1
"0c7262dff33c4087bc660ccf40f92f9c","b2275c3fad834f8d90737a2d9a6927d6",22858690,1,3,0,435,169,172,3
"b2275c3fad834f8d90737a2d9a6927d6","b2275c3fad834f8d90737a2d9a6927d6",22858690,30,0,1,436,172,172,0
"b2275c3fad834f8d90737a2d9a6927d6","eb515a26030b41f8a82a1e6114420bad",22858690,1,1,0,466,172,173,1
"eb515a26030b41f8a82a1e6114420bad","eb515a26030b41f8a82a1e6114420bad",22858690,2,0,1,467,173,173,0
"eb515a26030b41f8a82a1e6114420bad","0c7262dff33c4087bc660ccf40f92f9c",22858690,1,-4,0,469,173,169,-4
"0c7262dff33c4087bc660ccf40f92f9c","b42cc17b7de840f181a704558d0bc845",22858690,1,7,0,470,169,175,6
"b613861cecf84ffcab01afb23f660475","b613861cecf84ffcab01afb23f660475",8685800,3,0,1,1,1,1,0
"b613861cecf84ffcab01afb23f660475","e2911e79efc2420eac45d9f671463d4b",8685800,1,3,0,4,1,2,1
"e2911e79efc2420eac45d9f671463d4b","519d1b8c59404d67b54e96c5c8a830b2",8685800,1,1,0,8,2,3,1
"519d1b8c59404d67b54e96c5c8a830b2","519d1b8c59404d67b54e96c5c8a830b2",8685800,1,0,1,9,3,3,0
"519d1b8c59404d67b54e96c5c8a830b2","531db53f81f646edb0cdcfe0085b03b7",8685800,1,1,0,10,3,4,1
"531db53f81f646edb0cdcfe0085b03b7","531db53f81f646edb0cdcfe0085b03b7",8685800,1,0,1,11,4,4,0
"531db53f81f646edb0cdcfe0085b03b7","4f5f94b2f95141e0a9d53a61da2276da",8685800,1,1,0,12,4,5,1
"4f5f94b2f95141e0a9d53a61da2276da","4f5f94b2f95141e0a9d53a61da2276da",8685800,1,0,1,13,5,5,0
"4f5f94b2f95141e0a9d53a61da2276da","6d541c89590949f99af293c4f2333f67",8685800,1,1,0,14,5,6,1
"6d541c89590949f99af293c4f2333f67","6d541c89590949f99af293c4f2333f67",8685800,1,0,1,15,6,6,0
"6d541c89590949f99af293c4f2333f67","dd5cf0b9fe4c4f1d8f5ff8e4c04879cb",8685800,1,1,0,16,6,7,1
"dd5cf0b9fe4c4f1d8f5ff8e4c04879cb","dd5cf0b9fe4c4f1d8f5ff8e4c04879cb",8685800,1,0,1,17,7,7,0
"dd5cf0b9fe4c4f1d8f5ff8e4c04879cb","f96261861edc426abe2248be4f0a709a",8685800,1,1,0,18,7,8,1
"f96261861edc426abe2248be4f0a709a","f96261861edc426abe2248be4f0a709a",8685800,1,0,1,19,8,8,0
"f96261861edc426abe2248be4f0a709a","66b5e16f4f75454fb5b8172079f0fa83",8685800,1,1,0,20,8,9,1
"66b5e16f4f75454fb5b8172079f0fa83","66b5e16f4f75454fb5b8172079f0fa83",8685800,1,0,1,21,9,9,0
"66b5e16f4f75454fb5b8172079f0fa83","0680571d4698477995e41842c36a54b2",8685800,1,1,0,22,9,10,1
"0680571d4698477995e41842c36a54b2","0680571d4698477995e41842c36a54b2",8685800,1,0,1,23,10,10,0
"0680571d4698477995e41842c36a54b2","56586aa865414f538729c7f7735d2bc6",8685800,1,4,0,24,10,12,2
"56586aa865414f538729c7f7735d2bc6","e2911e79efc2420eac45d9f671463d4b",8685800,1,-12,0,25,12,2,-10
"e2911e79efc2420eac45d9f671463d4b","9afd71a5298d4333b6849dfce1b9422c",8685800,1,25,0,26,2,18,16
"56586aa865414f538729c7f7735d2bc6","9112f2bffece48e08c6d2287be204085",8685800,1,-3,0,28,12,11,-1
"9112f2bffece48e08c6d2287be204085","e2911e79efc2420eac45d9f671463d4b",8685800,1,-9,0,29,11,2,-9
"e2911e79efc2420eac45d9f671463d4b","e2911e79efc2420eac45d9f671463d4b",8685800,5,0,1,30,2,2,0
"e2911e79efc2420eac45d9f671463d4b","56586aa865414f538729c7f7735d2bc6",8685800,1,12,0,32,2,12,10
"56586aa865414f538729c7f7735d2bc6","67a089198fcb4e1c8f2385786c2b296f",8685800,1,57,0,34,12,39,27
"64d48c6c9c7940639a932219a6c87198","64d48c6c9c7940639a932219a6c87198",8685800,1,0,1,36,40,40,0
"64d48c6c9c7940639a932219a6c87198","b534b89233134e30a9b5645138bfa9ee",8685800,1,3,0,37,40,41,1
"b534b89233134e30a9b5645138bfa9ee","67a089198fcb4e1c8f2385786c2b296f",8685800,1,-4,0,38,41,39,-2
"67a089198fcb4e1c8f2385786c2b296f","0e37b720d23b4e7f8b313e79313fd107",8685800,1,7,0,39,39,44,5
"0e37b720d23b4e7f8b313e79313fd107","0e37b720d23b4e7f8b313e79313fd107",8685800,1,0,1,40,44,44,0
"0e37b720d23b4e7f8b313e79313fd107","6875d67fdd5f48168b62719df449bebd",8685800,1,1,0,41,44,45,1
"6875d67fdd5f48168b62719df449bebd","6875d67fdd5f48168b62719df449bebd",8685800,1,0,1,42,45,45,0
"6875d67fdd5f48168b62719df449bebd","b534b89233134e30a9b5645138bfa9ee",8685800,1,-4,0,43,45,41,-4
"6e13d61a7bdb44bca949c9f86fab3be5","195f78799f984cc2b06c48dfe36be751",8685800,1,2,0,46,47,49,2
"195f78799f984cc2b06c48dfe36be751","195f78799f984cc2b06c48dfe36be751",8685800,2,0,1,47,49,49,0
"195f78799f984cc2b06c48dfe36be751","d0c74f735e024943943e40333d6d337f",8685800,1,3,0,49,49,51,2
"d9c8d8c444a64dadbbb508652c721e17","d0c74f735e024943943e40333d6d337f",8685800,1,6,0,51,46,51,5
"d0c74f735e024943943e40333d6d337f","983f8ff320594b279a7f4a6fe132f9c5",8685800,1,2,0,52,51,53,2
"983f8ff320594b279a7f4a6fe132f9c5","983f8ff320594b279a7f4a6fe132f9c5",8685800,2,0,1,53,53,53,0
"983f8ff320594b279a7f4a6fe132f9c5","35adfa5d923046aebabfefd98f35ff05",8685800,1,1,0,55,53,54,1
"35adfa5d923046aebabfefd98f35ff05","35adfa5d923046aebabfefd98f35ff05",8685800,8,0,1,56,54,54,0
"35adfa5d923046aebabfefd98f35ff05","b6f8a98476224da1b40e555ececc7ed8",8685800,1,1,0,64,54,55,1
"b6f8a98476224da1b40e555ececc7ed8","b6f8a98476224da1b40e555ececc7ed8",8685800,2,0,1,65,55,55,0
"b6f8a98476224da1b40e555ececc7ed8","86e22cb5fe0e4b47a9489ecddf7ed78f",8685800,1,1,0,67,55,56,1
"86e22cb5fe0e4b47a9489ecddf7ed78f","86e22cb5fe0e4b47a9489ecddf7ed78f",8685800,2,0,1,68,56,56,0
"86e22cb5fe0e4b47a9489ecddf7ed78f","f924752d8a1149668870b1e7698486f7",8685800,1,-6,0,70,56,50,-6
"f924752d8a1149668870b1e7698486f7","78f30e4dcac84e3cbea8b2cc6e0d62b3",8685800,1,10,0,71,50,59,9
"78f30e4dcac84e3cbea8b2cc6e0d62b3","a1f2f12debe5432fb7a70bcd12bacfb9",8685800,1,-1,0,72,59,58,-1
"a1f2f12debe5432fb7a70bcd12bacfb9","a1f2f12debe5432fb7a70bcd12bacfb9",8685800,15,0,1,73,58,58,0
"a1f2f12debe5432fb7a70bcd12bacfb9","78f30e4dcac84e3cbea8b2cc6e0d62b3",8685800,1,1,0,88,58,59,1
"78f30e4dcac84e3cbea8b2cc6e0d62b3","78f30e4dcac84e3cbea8b2cc6e0d62b3",8685800,7,0,1,89,59,59,0
"78f30e4dcac84e3cbea8b2cc6e0d62b3","a0a418b8540d479fa6e0f653b701da8b",8685800,1,6,0,96,59,64,5
"a0a418b8540d479fa6e0f653b701da8b","bc42d26810654ea9a1df1efe1e58c7d5",8685800,1,-1,0,97,64,63,-1
"bc42d26810654ea9a1df1efe1e58c7d5","12aa6e1672ac4e7aa6449a7a8609cd72",8685800,1,-7,0,98,63,57,-6
"12aa6e1672ac4e7aa6449a7a8609cd72","4c943503763e4e349906eea3ed3c8e86",8685800,1,5,0,99,57,61,4
"4c943503763e4e349906eea3ed3c8e86","4c943503763e4e349906eea3ed3c8e86",8685800,1,0,1,100,61,61,0
"4c943503763e4e349906eea3ed3c8e86","309ccf3cc4fe429d9bfbaef53d3fa479",8685800,1,-1,0,101,61,60,-1
"309ccf3cc4fe429d9bfbaef53d3fa479","67a089198fcb4e1c8f2385786c2b296f",8685800,1,-27,0,102,60,39,-21
"67a089198fcb4e1c8f2385786c2b296f","64d48c6c9c7940639a932219a6c87198",8685800,3,1,0,103,39,40,1
"64d48c6c9c7940639a932219a6c87198","67a089198fcb4e1c8f2385786c2b296f",8685800,2,-1,0,104,40,39,-1
"67a089198fcb4e1c8f2385786c2b296f","b534b89233134e30a9b5645138bfa9ee",8685800,1,4,0,105,39,41,2
"b534b89233134e30a9b5645138bfa9ee","f924752d8a1149668870b1e7698486f7",8685800,1,11,0,106,41,50,9
"f924752d8a1149668870b1e7698486f7","d0c74f735e024943943e40333d6d337f",8685800,1,1,0,107,50,51,1
"d0c74f735e024943943e40333d6d337f","d0c74f735e024943943e40333d6d337f",8685800,20,0,1,108,51,51,0
"d0c74f735e024943943e40333d6d337f","d9c8d8c444a64dadbbb508652c721e17",8685800,2,-6,0,128,51,46,-5
"d9c8d8c444a64dadbbb508652c721e17","b534b89233134e30a9b5645138bfa9ee",8685800,1,-6,0,129,46,41,-5
"b534b89233134e30a9b5645138bfa9ee","6e13d61a7bdb44bca949c9f86fab3be5",8685800,2,7,0,130,41,47,6
"6e13d61a7bdb44bca949c9f86fab3be5","6e13d61a7bdb44bca949c9f86fab3be5",8685800,4,0,1,131,47,47,0
"6e13d61a7bdb44bca949c9f86fab3be5","56586aa865414f538729c7f7735d2bc6",8685800,1,-68,0,134,47,12,-35
"56586aa865414f538729c7f7735d2bc6","56586aa865414f538729c7f7735d2bc6",8685800,13,0,1,135,12,12,0
"56586aa865414f538729c7f7735d2bc6","b7f2b31585d94eb3bf86376714aa7070",8685800,1,2,0,140,12,13,1
"b7f2b31585d94eb3bf86376714aa7070","b7f2b31585d94eb3bf86376714aa7070",8685800,2,0,1,141,13,13,0
"b7f2b31585d94eb3bf86376714aa7070","3f1c815879794b929260d224becaff7e",8685800,1,2,0,143,13,14,1
"3f1c815879794b929260d224becaff7e","5c5ceeee4562457ba6d41515aeebfbb1",8685800,1,6,0,144,14,17,3
"5c5ceeee4562457ba6d41515aeebfbb1","81c864a886d54a6b8ff85f7d736f4f95",8685800,1,-4,0,145,17,15,-2
"81c864a886d54a6b8ff85f7d736f4f95","5c5ceeee4562457ba6d41515aeebfbb1",8685800,1,4,0,146,15,17,2
"5c5ceeee4562457ba6d41515aeebfbb1","5c5ceeee4562457ba6d41515aeebfbb1",8685800,2,0,1,147,17,17,0
"5c5ceeee4562457ba6d41515aeebfbb1","9afd71a5298d4333b6849dfce1b9422c",8685800,1,3,0,149,17,18,1
"9afd71a5298d4333b6849dfce1b9422c","56586aa865414f538729c7f7735d2bc6",8685800,2,-13,0,150,18,12,-6
"56586aa865414f538729c7f7735d2bc6","9afd71a5298d4333b6849dfce1b9422c",8685800,1,13,0,151,12,18,6
"9afd71a5298d4333b6849dfce1b9422c","9afd71a5298d4333b6849dfce1b9422c",8685800,4,0,1,152,18,18,0
"9afd71a5298d4333b6849dfce1b9422c","b7719e26494940efa49512aedd0aac79",8685800,1,4,0,156,18,20,2
"b7719e26494940efa49512aedd0aac79","d4f45188d3c84a02ba08454e6403a818",8685800,1,5,0,157,20,24,4
"d4f45188d3c84a02ba08454e6403a818","d4c3b003e8274e429d2fa688d73fde6d",8685800,1,-2,0,158,24,22,-2
"d4c3b003e8274e429d2fa688d73fde6d","d4c3b003e8274e429d2fa688d73fde6d",8685800,2,0,1,159,22,22,0
"d4c3b003e8274e429d2fa688d73fde6d","5bc03c8f16354d04bd51f5bb93559ad3",8685800,1,4,0,161,22,26,4
"5bc03c8f16354d04bd51f5bb93559ad3","b7719e26494940efa49512aedd0aac79",8685800,1,-7,0,162,26,20,-6
"b7719e26494940efa49512aedd0aac79","afbf7250b99d47bea07172749483ca97",8685800,2,12,0,163,20,28,8
"afbf7250b99d47bea07172749483ca97","b7719e26494940efa49512aedd0aac79",8685800,1,-12,0,164,28,20,-8
"afbf7250b99d47bea07172749483ca97","4e51676dc72045d99c19b9fa7b22f8bc",8685800,1,3,0,166,28,29,1
"4e51676dc72045d99c19b9fa7b22f8bc","4e51676dc72045d99c19b9fa7b22f8bc",8685800,1,0,1,167,29,29,0
"4e51676dc72045d99c19b9fa7b22f8bc","51970cfa30e643e894e66ae85c8024cc",8685800,1,3,0,168,29,31,2
"51970cfa30e643e894e66ae85c8024cc","c33c17be71ae4d588da7369472e5bb1b",8685800,1,6,0,169,31,34,3
"c33c17be71ae4d588da7369472e5bb1b","4e51676dc72045d99c19b9fa7b22f8bc",8685800,1,-9,0,170,34,29,-5
"4e51676dc72045d99c19b9fa7b22f8bc","c33c17be71ae4d588da7369472e5bb1b",8685800,1,9,0,171,29,34,5
"c33c17be71ae4d588da7369472e5bb1b","93679be414554a11b1893002f2229a93",8685800,1,3,0,172,34,35,1
"93679be414554a11b1893002f2229a93","7040a13096d746ac84b8fac8d9752058",8685800,2,3,0,173,35,36,1
"7040a13096d746ac84b8fac8d9752058","93679be414554a11b1893002f2229a93",8685800,1,-3,0,174,36,35,-1
"7040a13096d746ac84b8fac8d9752058","9a0dc646f934470daf08c4b56ccf73db",8685800,1,3,0,176,36,37,1
"9a0dc646f934470daf08c4b56ccf73db","fc0e049d56024bc9a02c9a9c435c3df7",8685800,1,3,0,177,37,38,1
"fc0e049d56024bc9a02c9a9c435c3df7","9a0dc646f934470daf08c4b56ccf73db",8685800,1,-3,0,178,38,37,-1
"9a0dc646f934470daf08c4b56ccf73db","67a089198fcb4e1c8f2385786c2b296f",8685800,1,7,0,179,37,39,2
"67a089198fcb4e1c8f2385786c2b296f","fc0e049d56024bc9a02c9a9c435c3df7",8685800,1,-4,0,180,39,38,-1
"fc0e049d56024bc9a02c9a9c435c3df7","64d48c6c9c7940639a932219a6c87198",8685800,1,5,0,181,38,40,2
"64d48c6c9c7940639a932219a6c87198","56586aa865414f538729c7f7735d2bc6",8685800,1,-58,0,184,40,12,-28
"56586aa865414f538729c7f7735d2bc6","d646286c8051419bbc2e31dd1db55ca8",8685800,1,94,0,187,12,67,55
"d646286c8051419bbc2e31dd1db55ca8","d646286c8051419bbc2e31dd1db55ca8",8685800,1,0,1,188,67,67,0
"d646286c8051419bbc2e31dd1db55ca8","267f883678b24aed855fde42524975d9",8685800,1,4,0,189,67,71,4
"267f883678b24aed855fde42524975d9","267f883678b24aed855fde42524975d9",8685800,1,0,1,190,71,71,0
"267f883678b24aed855fde42524975d9","88fff56d0342490dbef9040750a20f6c",8685800,1,1,0,191,71,72,1
"88fff56d0342490dbef9040750a20f6c","88fff56d0342490dbef9040750a20f6c",8685800,1,0,1,192,72,72,0
"88fff56d0342490dbef9040750a20f6c","adb17b12b66c4a49a85fd34322f7df70",8685800,1,1,0,193,72,73,1
"adb17b12b66c4a49a85fd34322f7df70","adb17b12b66c4a49a85fd34322f7df70",8685800,1,0,1,194,73,73,0
"adb17b12b66c4a49a85fd34322f7df70","d646286c8051419bbc2e31dd1db55ca8",8685800,1,-6,0,195,73,67,-6
"d646286c8051419bbc2e31dd1db55ca8","a2becd407db34b189200a32546d9d569",8685800,1,9,0,196,67,75,8
"a2becd407db34b189200a32546d9d569","a2becd407db34b189200a32546d9d569",8685800,4,0,1,197,75,75,0
"a2becd407db34b189200a32546d9d569","58c22b011d0f4c2ea6d13615edbb9eeb",8685800,1,2,0,201,75,77,2
"58c22b011d0f4c2ea6d13615edbb9eeb","58c22b011d0f4c2ea6d13615edbb9eeb",8685800,2,0,1,202,77,77,0
"58c22b011d0f4c2ea6d13615edbb9eeb","dd76e1861dc9461c830888729d091ee0",8685800,1,1,0,204,77,78,1
"dd76e1861dc9461c830888729d091ee0","dd76e1861dc9461c830888729d091ee0",8685800,5,0,1,205,78,78,0
"dd76e1861dc9461c830888729d091ee0","cd1d828f1a694b87913a7ea66c23803e",8685800,1,1,0,210,78,79,1
"cd1d828f1a694b87913a7ea66c23803e","cd1d828f1a694b87913a7ea66c23803e",8685800,2,0,1,211,79,79,0
"cd1d828f1a694b87913a7ea66c23803e","9176a3c2b4d2465fa8b0c67096c2a97e",8685800,1,1,0,213,79,80,1
"9176a3c2b4d2465fa8b0c67096c2a97e","9176a3c2b4d2465fa8b0c67096c2a97e",8685800,5,0,1,214,80,80,0
"9176a3c2b4d2465fa8b0c67096c2a97e","f8ec6445f7194e25b9101d4fbcb07a18",8685800,1,1,0,219,80,81,1
"f8ec6445f7194e25b9101d4fbcb07a18","f8ec6445f7194e25b9101d4fbcb07a18",8685800,2,0,1,220,81,81,0
"f8ec6445f7194e25b9101d4fbcb07a18","140d5b27b8574befad82c0a013b59dfa",8685800,1,-7,0,222,81,74,-7
"140d5b27b8574befad82c0a013b59dfa","d18a9ea32855445f8736581f5cb119ce",8685800,1,9,0,223,74,82,8
"d18a9ea32855445f8736581f5cb119ce","f564483cbd7a407681aa2fcca518cf5f",8685800,1,4,0,224,82,85,3
"f564483cbd7a407681aa2fcca518cf5f","f564483cbd7a407681aa2fcca518cf5f",8685800,1,0,1,225,85,85,0
"f564483cbd7a407681aa2fcca518cf5f","18fd01350bd5434ca636d59a599d768a",8685800,1,1,0,226,85,86,1
"18fd01350bd5434ca636d59a599d768a","18fd01350bd5434ca636d59a599d768a",8685800,9,0,1,227,86,86,0
"18fd01350bd5434ca636d59a599d768a","6a9f0ef185fb47f0937e29daa1c71ed5",8685800,1,5,0,236,86,90,4
"6a9f0ef185fb47f0937e29daa1c71ed5","ae5ac430ea254e708a6f5deaaf7464ae",8685800,1,-7,0,237,90,84,-6
"ae5ac430ea254e708a6f5deaaf7464ae","c681290961c94c4caf23b529d1ae6b9a",8685800,1,5,0,238,84,88,4
"c681290961c94c4caf23b529d1ae6b9a","c681290961c94c4caf23b529d1ae6b9a",8685800,2,0,1,239,88,88,0
"c681290961c94c4caf23b529d1ae6b9a","6a9f0ef185fb47f0937e29daa1c71ed5",8685800,1,2,0,241,88,90,2
"6a9f0ef185fb47f0937e29daa1c71ed5","6a9f0ef185fb47f0937e29daa1c71ed5",8685800,3,0,1,242,90,90,0
"6a9f0ef185fb47f0937e29daa1c71ed5","d646286c8051419bbc2e31dd1db55ca8",8685800,1,-27,0,245,90,67,-23
"d646286c8051419bbc2e31dd1db55ca8","e20db35ced8544ddac5bc3839145e463",8685800,1,30,0,246,67,91,24
"e20db35ced8544ddac5bc3839145e463","1febb706d7a34005ae8711ed49c76e64",8685800,1,3,0,247,91,94,3
"1febb706d7a34005ae8711ed49c76e64","1febb706d7a34005ae8711ed49c76e64",8685800,2,0,1,248,94,94,0
"1febb706d7a34005ae8711ed49c76e64","8f73ba6f5a0042f2850356ac38ac6f24",8685800,1,1,0,250,94,95,1
"8f73ba6f5a0042f2850356ac38ac6f24","8f73ba6f5a0042f2850356ac38ac6f24",8685800,5,0,1,251,95,95,0
"8f73ba6f5a0042f2850356ac38ac6f24","e2260b86653c46d7b14a41fb419dbf8c",8685800,1,1,0,256,95,96,1
"e2260b86653c46d7b14a41fb419dbf8c","e2260b86653c46d7b14a41fb419dbf8c",8685800,2,0,1,257,96,96,0
"e2260b86653c46d7b14a41fb419dbf8c","35eb641ad1d845bbba54915bce75a962",8685800,1,1,0,259,96,97,1
"35eb641ad1d845bbba54915bce75a962","35eb641ad1d845bbba54915bce75a962",8685800,5,0,1,260,97,97,0
"35eb641ad1d845bbba54915bce75a962","08be90ffbeea4795a138cd42ed8db56f",8685800,1,1,0,265,97,98,1
"08be90ffbeea4795a138cd42ed8db56f","08be90ffbeea4795a138cd42ed8db56f",8685800,5,0,1,266,98,98,0
"08be90ffbeea4795a138cd42ed8db56f","3007433c8f584dcbb5ac159c1c5f2be3",8685800,1,1,0,271,98,99,1
"3007433c8f584dcbb5ac159c1c5f2be3","3007433c8f584dcbb5ac159c1c5f2be3",8685800,5,0,1,272,99,99,0
"3007433c8f584dcbb5ac159c1c5f2be3","00ae5f0c51874a73a41ebea838d95682",8685800,1,3,0,277,99,101,2
"00ae5f0c51874a73a41ebea838d95682","e20db35ced8544ddac5bc3839145e463",8685800,1,-11,0,278,101,91,-10
"e20db35ced8544ddac5bc3839145e463","d391c8b6e56a43a7b654e9dee02d904b",8685800,1,13,0,279,91,103,12
"d391c8b6e56a43a7b654e9dee02d904b","56586aa865414f538729c7f7735d2bc6",8685800,1,-137,0,280,103,12,-91
"56586aa865414f538729c7f7735d2bc6","73039f8c1eb9409cb4caee2cf968001e",8685800,1,134,0,282,12,100,88
"73039f8c1eb9409cb4caee2cf968001e","e20db35ced8544ddac5bc3839145e463",8685800,1,-10,0,283,100,91,-9
"e20db35ced8544ddac5bc3839145e463","00ae5f0c51874a73a41ebea838d95682",8685800,1,11,0,284,91,101,10
"00ae5f0c51874a73a41ebea838d95682","d391c8b6e56a43a7b654e9dee02d904b",8685800,2,2,0,285,101,103,2
"d391c8b6e56a43a7b654e9dee02d904b","00ae5f0c51874a73a41ebea838d95682",8685800,1,-2,0,286,103,101,-2
"00ae5f0c51874a73a41ebea838d95682","00ae5f0c51874a73a41ebea838d95682",8685800,1,0,1,287,101,101,0
"d391c8b6e56a43a7b654e9dee02d904b","d391c8b6e56a43a7b654e9dee02d904b",8685800,15,0,1,289,103,103,0
"d391c8b6e56a43a7b654e9dee02d904b","6111116566fc4fd9abba409322bea245",8685800,1,1,0,304,103,104,1
"6111116566fc4fd9abba409322bea245","6111116566fc4fd9abba409322bea245",8685800,2,0,1,305,104,104,0
"6111116566fc4fd9abba409322bea245","a81b2235cb9c499eb9ea8ee0a8dd9725",8685800,1,1,0,307,104,105,1
"a81b2235cb9c499eb9ea8ee0a8dd9725","a81b2235cb9c499eb9ea8ee0a8dd9725",8685800,5,0,1,308,105,105,0
"a81b2235cb9c499eb9ea8ee0a8dd9725","2d4e0ab0ef3b4d73b82c72d4621a7579",8685800,1,1,0,313,105,106,1
"2d4e0ab0ef3b4d73b82c72d4621a7579","2d4e0ab0ef3b4d73b82c72d4621a7579",8685800,2,0,1,314,106,106,0
"2d4e0ab0ef3b4d73b82c72d4621a7579","8bdebf492ebd4e62b0d522e8ab5e5197",8685800,1,1,0,316,106,107,1
"8bdebf492ebd4e62b0d522e8ab5e5197","8bdebf492ebd4e62b0d522e8ab5e5197",8685800,2,0,1,317,107,107,0
"8bdebf492ebd4e62b0d522e8ab5e5197","73039f8c1eb9409cb4caee2cf968001e",8685800,1,-7,0,319,107,100,-7
"73039f8c1eb9409cb4caee2cf968001e","4280927ec4d643238aa49c32f9e06c6c",8685800,1,10,0,320,100,109,9
"4280927ec4d643238aa49c32f9e06c6c","4280927ec4d643238aa49c32f9e06c6c",8685800,1,0,1,321,109,109,0
"4280927ec4d643238aa49c32f9e06c6c","fc44e6a5f7654430af1227838224dceb",8685800,1,2,0,322,109,111,2
"fc44e6a5f7654430af1227838224dceb","fc44e6a5f7654430af1227838224dceb",8685800,5,0,1,323,111,111,0
"fc44e6a5f7654430af1227838224dceb","a9ae0a3c070d455bb4369a8996313336",8685800,1,4,0,328,111,114,3
"a9ae0a3c070d455bb4369a8996313336","08111f75e22d409998cf8b85bd431f0a",8685800,1,-7,0,329,114,108,-6
"08111f75e22d409998cf8b85bd431f0a","a9ae0a3c070d455bb4369a8996313336",8685800,1,7,0,330,108,114,6
"a9ae0a3c070d455bb4369a8996313336","37319e88176d4aefa91d7a9980dbae91",8685800,1,-2,0,331,114,112,-2
"37319e88176d4aefa91d7a9980dbae91","e20db35ced8544ddac5bc3839145e463",8685800,1,-24,0,332,112,91,-21
"e20db35ced8544ddac5bc3839145e463","a9ae0a3c070d455bb4369a8996313336",8685800,1,26,0,333,91,114,23
"a9ae0a3c070d455bb4369a8996313336","71cec822bcff4f30a20e75dc63ef7b65",8685800,1,2,0,334,114,116,2
"71cec822bcff4f30a20e75dc63ef7b65","71cec822bcff4f30a20e75dc63ef7b65",8685800,1,0,1,335,116,116,0
"71cec822bcff4f30a20e75dc63ef7b65","37319e88176d4aefa91d7a9980dbae91",8685800,1,-4,0,336,116,112,-4
"37319e88176d4aefa91d7a9980dbae91","62bff51286ef4f348717a3cf6fe2318f",8685800,1,9,0,337,112,120,8
"62bff51286ef4f348717a3cf6fe2318f","3ec3a3563847406fa73338f9e9999cf3",8685800,2,-3,0,338,120,117,-3
"3ec3a3563847406fa73338f9e9999cf3","3ec3a3563847406fa73338f9e9999cf3",8685800,1,0,1,339,117,117,0
"3ec3a3563847406fa73338f9e9999cf3","e20db35ced8544ddac5bc3839145e463",8685800,2,-30,0,340,117,91,-26
"e20db35ced8544ddac5bc3839145e463","62bff51286ef4f348717a3cf6fe2318f",8685800,1,33,0,341,91,120,29
"e20db35ced8544ddac5bc3839145e463","3ec3a3563847406fa73338f9e9999cf3",8685800,1,30,0,344,91,117,26
"3ec3a3563847406fa73338f9e9999cf3","62bff51286ef4f348717a3cf6fe2318f",8685800,1,3,0,345,117,120,3
"62bff51286ef4f348717a3cf6fe2318f","b1cd0e7dc3ad4a8eb91a4bfdbeb025b0",8685800,1,-2,0,346,120,118,-2
"b1cd0e7dc3ad4a8eb91a4bfdbeb025b0","b1cd0e7dc3ad4a8eb91a4bfdbeb025b0",8685800,1,0,1,347,118,118,0
"b1cd0e7dc3ad4a8eb91a4bfdbeb025b0","62bff51286ef4f348717a3cf6fe2318f",8685800,1,2,0,348,118,120,2
"62bff51286ef4f348717a3cf6fe2318f","62bff51286ef4f348717a3cf6fe2318f",8685800,3,0,1,349,120,120,0
"62bff51286ef4f348717a3cf6fe2318f","e20db35ced8544ddac5bc3839145e463",8685800,1,-33,0,352,120,91,-29
"e20db35ced8544ddac5bc3839145e463","779f9ddd1fd14d1e9e69f72219a1fdbd",8685800,1,36,0,353,91,121,30
"779f9ddd1fd14d1e9e69f72219a1fdbd","56586aa865414f538729c7f7735d2bc6",8685800,1,-160,0,354,121,12,-109
"56586aa865414f538729c7f7735d2bc6","779f9ddd1fd14d1e9e69f72219a1fdbd",8685800,1,160,0,356,12,121,109
"779f9ddd1fd14d1e9e69f72219a1fdbd","779f9ddd1fd14d1e9e69f72219a1fdbd",8685800,3,0,1,357,121,121,0
"779f9ddd1fd14d1e9e69f72219a1fdbd","ae26e6cda8ad4a3f81bd347560d9579f",8685800,1,4,0,360,121,125,4
"ae26e6cda8ad4a3f81bd347560d9579f","ae26e6cda8ad4a3f81bd347560d9579f",8685800,3,0,1,361,125,125,0
"ae26e6cda8ad4a3f81bd347560d9579f","ee48df95832b4374aa273ceb27ec1315",8685800,1,1,0,364,125,126,1
"ee48df95832b4374aa273ceb27ec1315","ee48df95832b4374aa273ceb27ec1315",8685800,1,0,1,365,126,126,0
"ee48df95832b4374aa273ceb27ec1315","7a439da90b394756ad1777fc4c6dead5",8685800,1,1,0,366,126,127,1
"7a439da90b394756ad1777fc4c6dead5","7a439da90b394756ad1777fc4c6dead5",8685800,1,0,1,367,127,127,0
"7a439da90b394756ad1777fc4c6dead5","779f9ddd1fd14d1e9e69f72219a1fdbd",8685800,1,-6,0,368,127,121,-6
"779f9ddd1fd14d1e9e69f72219a1fdbd","a8dd5213034441ac92724b4e83eb0bb2",8685800,1,9,0,369,121,129,8
"a8dd5213034441ac92724b4e83eb0bb2","a8dd5213034441ac92724b4e83eb0bb2",8685800,2,0,1,370,129,129,0
"a8dd5213034441ac92724b4e83eb0bb2","8115eab6556b45f5b415c3b8c26a12e5",8685800,1,2,0,372,129,131,2
"8115eab6556b45f5b415c3b8c26a12e5","8115eab6556b45f5b415c3b8c26a12e5",8685800,2,0,1,373,131,131,0
"8115eab6556b45f5b415c3b8c26a12e5","ec34b06efd844b46a4c4818ecdb9b8f4",8685800,1,1,0,375,131,132,1
"ec34b06efd844b46a4c4818ecdb9b8f4","ec34b06efd844b46a4c4818ecdb9b8f4",8685800,2,0,1,376,132,132,0
"ec34b06efd844b46a4c4818ecdb9b8f4","c2e1c2b9eac64109b343a088584b576b",8685800,1,1,0,378,132,133,1
"c2e1c2b9eac64109b343a088584b576b","c2e1c2b9eac64109b343a088584b576b",8685800,2,0,1,379,133,133,0
"c2e1c2b9eac64109b343a088584b576b","579338175e0b4bbb8ef3b712b5d8b54e",8685800,1,-5,0,381,133,128,-5
"579338175e0b4bbb8ef3b712b5d8b54e","b416d47c56a742199b5d7c7f19d6503a",8685800,1,7,0,382,128,134,6
"b416d47c56a742199b5d7c7f19d6503a","cd4532ad48034873ba8bce2aac0c9808",8685800,1,4,0,383,134,137,3
"cd4532ad48034873ba8bce2aac0c9808","cd4532ad48034873ba8bce2aac0c9808",8685800,2,0,1,384,137,137,0
"cd4532ad48034873ba8bce2aac0c9808","df1de691dafe4549a18a4398ee9dfaf9",8685800,1,4,0,386,137,139,2
"df1de691dafe4549a18a4398ee9dfaf9","779f9ddd1fd14d1e9e69f72219a1fdbd",8685800,1,-23,0,387,139,121,-18
"779f9ddd1fd14d1e9e69f72219a1fdbd","6c5ad271a44743479bfaea29b1db8d02",8685800,1,27,0,388,121,143,22
"6c5ad271a44743479bfaea29b1db8d02","6c5ad271a44743479bfaea29b1db8d02",8685800,1,0,1,389,143,143,0
"6c5ad271a44743479bfaea29b1db8d02","83d311bed5374fee83d8d67a7d9d82dc",8685800,1,1,0,390,143,144,1
"83d311bed5374fee83d8d67a7d9d82dc","83d311bed5374fee83d8d67a7d9d82dc",8685800,4,0,1,391,144,144,0
"83d311bed5374fee83d8d67a7d9d82dc","402bba41861d43acb52a5abb89e8831e",8685800,1,1,0,395,144,145,1
"402bba41861d43acb52a5abb89e8831e","402bba41861d43acb52a5abb89e8831e",8685800,2,0,1,396,145,145,0
"402bba41861d43acb52a5abb89e8831e","df1de691dafe4549a18a4398ee9dfaf9",8685800,1,-6,0,398,145,139,-6
"df1de691dafe4549a18a4398ee9dfaf9","8aae34f5ddbb4052a709b12e6b0d40fa",8685800,1,9,0,399,139,147,8
"8aae34f5ddbb4052a709b12e6b0d40fa","8aae34f5ddbb4052a709b12e6b0d40fa",8685800,2,0,1,400,147,147,0
"8aae34f5ddbb4052a709b12e6b0d40fa","645b3f0249f64f76af2e19eb4d0e55b7",8685800,1,2,0,402,147,149,2
"645b3f0249f64f76af2e19eb4d0e55b7","645b3f0249f64f76af2e19eb4d0e55b7",8685800,9,0,1,403,149,149,0
"645b3f0249f64f76af2e19eb4d0e55b7","7e7b8db5064d4369805ab370aac5ddfb",8685800,1,1,0,412,149,150,1
"7e7b8db5064d4369805ab370aac5ddfb","7e7b8db5064d4369805ab370aac5ddfb",8685800,2,0,1,413,150,150,0
"7e7b8db5064d4369805ab370aac5ddfb","8956d210ae7f41968fada86d4c979d6a",8685800,1,1,0,415,150,151,1
"8956d210ae7f41968fada86d4c979d6a","8956d210ae7f41968fada86d4c979d6a",8685800,2,0,1,416,151,151,0
"8956d210ae7f41968fada86d4c979d6a","f902b0f41b544d4dbf79664fd233648d",8685800,1,-5,0,418,151,146,-5
"f902b0f41b544d4dbf79664fd233648d","ae781e8b775e4ccd93bc800dad5c8376",8685800,1,8,0,419,146,153,7
"ae781e8b775e4ccd93bc800dad5c8376","ae781e8b775e4ccd93bc800dad5c8376",8685800,2,0,1,420,153,153,0
"ae781e8b775e4ccd93bc800dad5c8376","06882a8492d9499aa31555567f575ecb",8685800,1,1,0,422,153,154,1
"06882a8492d9499aa31555567f575ecb","06882a8492d9499aa31555567f575ecb",8685800,1,0,1,423,154,154,0
"06882a8492d9499aa31555567f575ecb","f293c508f409466a8f27ddd7d1e40b20",8685800,1,1,0,424,154,155,1
"f293c508f409466a8f27ddd7d1e40b20","f293c508f409466a8f27ddd7d1e40b20",8685800,2,0,1,425,155,155,0
"f293c508f409466a8f27ddd7d1e40b20","cc4ddef5bbbe48ebb605141b347c4ed1",8685800,1,1,0,427,155,156,1
"cc4ddef5bbbe48ebb605141b347c4ed1","cc4ddef5bbbe48ebb605141b347c4ed1",8685800,1,0,1,428,156,156,0
"cc4ddef5bbbe48ebb605141b347c4ed1","f03480cf4eba413194d7af52fc0e7f28",8685800,1,-4,0,429,156,152,-4
"f03480cf4eba413194d7af52fc0e7f28","d313cec988a84645bee413e8d4724a4b",8685800,1,7,0,430,152,158,6
"d313cec988a84645bee413e8d4724a4b","dc60696c76a74368a60f72246e47700d",8685800,1,1,0,431,158,159,1
"dc60696c76a74368a60f72246e47700d","dc60696c76a74368a60f72246e47700d",8685800,2,0,1,432,159,159,0
"dc60696c76a74368a60f72246e47700d","78adeee1fa2c4fe0bc73f7bca9fcee86",8685800,1,3,0,434,159,160,1
"78adeee1fa2c4fe0bc73f7bca9fcee86","df1de691dafe4549a18a4398ee9dfaf9",8685800,1,-26,0,435,160,139,-21
"df1de691dafe4549a18a4398ee9dfaf9","65202579580f4ad38d734b4ee39d22a8",8685800,1,31,0,436,139,164,25
"65202579580f4ad38d734b4ee39d22a8","65202579580f4ad38d734b4ee39d22a8",8685800,6,0,1,437,164,164,0
"65202579580f4ad38d734b4ee39d22a8","78adeee1fa2c4fe0bc73f7bca9fcee86",8685800,2,-5,0,439,164,160,-4
"78adeee1fa2c4fe0bc73f7bca9fcee86","65202579580f4ad38d734b4ee39d22a8",8685800,1,5,0,440,160,164,4
"78adeee1fa2c4fe0bc73f7bca9fcee86","3cbcea2be0984e7dbd5a48195af10ce7",8685800,1,8,0,446,160,165,5
"3cbcea2be0984e7dbd5a48195af10ce7","82e6285962b8400d9d6fc32436022a94",8685800,2,2,0,447,165,167,2
"82e6285962b8400d9d6fc32436022a94","56586aa865414f538729c7f7735d2bc6",8685800,1,-219,0,448,167,12,-155
"56586aa865414f538729c7f7735d2bc6","3cbcea2be0984e7dbd5a48195af10ce7",8685800,1,217,0,451,12,165,153
"3cbcea2be0984e7dbd5a48195af10ce7","3cbcea2be0984e7dbd5a48195af10ce7",8685800,1,0,1,452,165,165,0
"82e6285962b8400d9d6fc32436022a94","0c7262dff33c4087bc660ccf40f92f9c",8685800,1,7,0,454,167,169,2
"0c7262dff33c4087bc660ccf40f92f9c","0c7262dff33c4087bc660ccf40f92f9c",8685800,1,0,1,455,169,169,0
"0c7262dff33c4087bc660ccf40f92f9c","b2275c3fad834f8d90737a2d9a6927d6",8685800,1,3,0,456,169,172,3
"b2275c3fad834f8d90737a2d9a6927d6","b2275c3fad834f8d90737a2d9a6927d6",8685800,20,0,1,457,172,172,0
"b2275c3fad834f8d90737a2d9a6927d6","eb515a26030b41f8a82a1e6114420bad",8685800,1,1,0,477,172,173,1
"eb515a26030b41f8a82a1e6114420bad","eb515a26030b41f8a82a1e6114420bad",8685800,2,0,1,478,173,173,0
"eb515a26030b41f8a82a1e6114420bad","0c7262dff33c4087bc660ccf40f92f9c",8685800,1,-4,0,480,173,169,-4
"0c7262dff33c4087bc660ccf40f92f9c","b42cc17b7de840f181a704558d0bc845",8685800,1,7,0,481,169,175,6
"b42cc17b7de840f181a704558d0bc845","b42cc17b7de840f181a704558d0bc845",8685800,1,0,1,482,175,175,0
"b42cc17b7de840f181a704558d0bc845","801f9e9135034f49bf5f8b4bdefedb41",8685800,1,2,0,483,175,177,2
"801f9e9135034f49bf5f8b4bdefedb41","801f9e9135034f49bf5f8b4bdefedb41",8685800,11,0,1,484,177,177,0
"801f9e9135034f49bf5f8b4bdefedb41","362fcb0699a14845ab29b2340093e528",8685800,1,-3,0,495,177,174,-3
"362fcb0699a14845ab29b2340093e528","ea38cc0e6e6e41edbabf210220808bf9",8685800,1,6,0,496,174,179,5
"ea38cc0e6e6e41edbabf210220808bf9","b87c552dd247427abe6ab5795b9c9d43",8685800,2,2,0,497,179,181,2
"b87c552dd247427abe6ab5795b9c9d43","ea38cc0e6e6e41edbabf210220808bf9",8685800,1,-2,0,498,181,179,-2
"b87c552dd247427abe6ab5795b9c9d43","b87c552dd247427abe6ab5795b9c9d43",8685800,7,0,1,500,181,181,0
"b87c552dd247427abe6ab5795b9c9d43","139b097acfca451689d80c9c6eebdf7b",8685800,1,-3,0,507,181,178,-3
"139b097acfca451689d80c9c6eebdf7b","30f660a1feb34582a739722532524f79",8685800,1,6,0,508,178,183,5
"30f660a1feb34582a739722532524f79","30f660a1feb34582a739722532524f79",8685800,5,0,1,509,183,183,0
"30f660a1feb34582a739722532524f79","2024b4885bd14338a39b7b509acbbd02",8685800,1,-1,0,514,183,182,-1
"2024b4885bd14338a39b7b509acbbd02","c3f63fe50d8e487c86bf8ef76c9cadd3",8685800,1,4,0,515,182,185,3
"c3f63fe50d8e487c86bf8ef76c9cadd3","c3f63fe50d8e487c86bf8ef76c9cadd3",8685800,2,0,1,516,185,185,0
"c3f63fe50d8e487c86bf8ef76c9cadd3","0c7262dff33c4087bc660ccf40f92f9c",8685800,1,-20,0,518,185,169,-16
"0c7262dff33c4087bc660ccf40f92f9c","c8e371568a0c4391b25796ae4e91952e",8685800,1,23,0,519,169,186,17
"c8e371568a0c4391b25796ae4e91952e","7d932b23e1c84326ae5aa4d3c0d813d1",8685800,1,2,0,520,186,188,2
"7d932b23e1c84326ae5aa4d3c0d813d1","7d932b23e1c84326ae5aa4d3c0d813d1",8685800,1,0,1,521,188,188,0
"7d932b23e1c84326ae5aa4d3c0d813d1","ab11d94c6c8948ea90b88f19d2cd502b",8685800,1,3,0,522,188,190,2
"ab11d94c6c8948ea90b88f19d2cd502b","c8e371568a0c4391b25796ae4e91952e",8685800,1,-5,0,523,190,186,-4
"c8e371568a0c4391b25796ae4e91952e","ab11d94c6c8948ea90b88f19d2cd502b",8685800,1,5,0,524,186,190,4
"ab11d94c6c8948ea90b88f19d2cd502b","f992451ed6ad4e68bb9e68ad6be7c4be",8685800,1,2,0,525,190,192,2
"f992451ed6ad4e68bb9e68ad6be7c4be","f992451ed6ad4e68bb9e68ad6be7c4be",8685800,1,0,1,526,192,192,0
"f992451ed6ad4e68bb9e68ad6be7c4be","6cd2dcaac46847d4a0bc53f296d90375",8685800,1,3,0,527,192,194,2
"6cd2dcaac46847d4a0bc53f296d90375","07b44a7a51e94c78b411c753fc39dab0",8685800,1,-6,0,528,194,189,-5
"07b44a7a51e94c78b411c753fc39dab0","6cd2dcaac46847d4a0bc53f296d90375",8685800,1,6,0,529,189,194,5
"6cd2dcaac46847d4a0bc53f296d90375","2d2580c9411c4972909db508d6956a58",8685800,1,2,0,530,194,196,2
"2d2580c9411c4972909db508d6956a58","2d2580c9411c4972909db508d6956a58",8685800,2,0,1,531,196,196,0
"2d2580c9411c4972909db508d6956a58","5bddb3d9ed264f3984702f048c7e5340",8685800,1,1,0,533,196,197,1
"5bddb3d9ed264f3984702f048c7e5340","5bddb3d9ed264f3984702f048c7e5340",8685800,2,0,1,534,197,197,0
"5bddb3d9ed264f3984702f048c7e5340","d5e8e2bd12a2466b9d6d90855f0eb079",8685800,1,1,0,536,197,198,1
"d5e8e2bd12a2466b9d6d90855f0eb079","d5e8e2bd12a2466b9d6d90855f0eb079",8685800,2,0,1,537,198,198,0
"d5e8e2bd12a2466b9d6d90855f0eb079","017d7ca8e0394b91aaadc9574df2202c",8685800,1,-5,0,539,198,193,-5
"017d7ca8e0394b91aaadc9574df2202c","54e8e9f0ea3e45c4bf3b8ac799ee31b1",8685800,1,8,0,540,193,200,7
"54e8e9f0ea3e45c4bf3b8ac799ee31b1","54e8e9f0ea3e45c4bf3b8ac799ee31b1",8685800,1,0,1,541,200,200,0
"54e8e9f0ea3e45c4bf3b8ac799ee31b1","c614a00911be4877a075f19315530fb0",8685800,1,1,0,542,200,201,1
"c614a00911be4877a075f19315530fb0","c614a00911be4877a075f19315530fb0",8685800,6,0,1,543,201,201,0
"c614a00911be4877a075f19315530fb0","a6c21bd8b95249c7972820a7a7d76aff",8685800,1,1,0,549,201,202,1
"a6c21bd8b95249c7972820a7a7d76aff","a6c21bd8b95249c7972820a7a7d76aff",8685800,1,0,1,550,202,202,0
"a6c21bd8b95249c7972820a7a7d76aff","bb329d880ab54120adaf203a693bb203",8685800,1,1,0,551,202,203,1
"bb329d880ab54120adaf203a693bb203","bb329d880ab54120adaf203a693bb203",8685800,1,0,1,552,203,203,0
"bb329d880ab54120adaf203a693bb203","f9170dd6bc6442b4acd832747609b09a",8685800,1,-4,0,553,203,199,-4
"f9170dd6bc6442b4acd832747609b09a","334c2344009840079b1d0e1b7ce3d5a7",8685800,1,7,0,554,199,205,6
"334c2344009840079b1d0e1b7ce3d5a7","334c2344009840079b1d0e1b7ce3d5a7",8685800,1,0,1,555,205,205,0
"334c2344009840079b1d0e1b7ce3d5a7","c8e371568a0c4391b25796ae4e91952e",8685800,1,-23,0,556,205,186,-19
"c8e371568a0c4391b25796ae4e91952e","d7f13c8d63ec4e2aa673fbb9cf9c6933",8685800,1,26,0,557,186,206,20
"d7f13c8d63ec4e2aa673fbb9cf9c6933","b9e80f77c3a44349863b19875725c384",8685800,1,1,0,558,206,207,1
"b9e80f77c3a44349863b19875725c384","7108f0e4c2584f1f9c471689ae4c885c",8685800,2,1,0,559,207,208,1
"7108f0e4c2584f1f9c471689ae4c885c","b9e80f77c3a44349863b19875725c384",8685800,1,-1,0,560,208,207,-1
"b9e80f77c3a44349863b19875725c384","b9e80f77c3a44349863b19875725c384",8685800,15,0,1,561,207,207,0
"7108f0e4c2584f1f9c471689ae4c885c","7108f0e4c2584f1f9c471689ae4c885c",8685800,10,0,1,577,208,208,0
"7108f0e4c2584f1f9c471689ae4c885c","d7f13c8d63ec4e2aa673fbb9cf9c6933",8685800,1,-2,0,587,208,206,-2
"d7f13c8d63ec4e2aa673fbb9cf9c6933","09400e101c5d4b439cf9a26b03aae558",8685800,1,5,0,588,206,210,4
"09400e101c5d4b439cf9a26b03aae558","09400e101c5d4b439cf9a26b03aae558",8685800,1,0,1,589,210,210,0
"09400e101c5d4b439cf9a26b03aae558","a88efa7e50ce47159810ab553afa6d3a",8685800,1,2,0,590,210,212,2
"a88efa7e50ce47159810ab553afa6d3a","a88efa7e50ce47159810ab553afa6d3a",8685800,2,0,1,591,212,212,0
"a88efa7e50ce47159810ab553afa6d3a","a875096404ef4a9984b62d74cda916f9",8685800,1,-3,0,593,212,209,-3
"a875096404ef4a9984b62d74cda916f9","be502a7a43c44bf7b682698de79d9369",8685800,1,6,0,594,209,214,5
"be502a7a43c44bf7b682698de79d9369","f7fb1952f56b4189b86a9f8b7862d2b8",8685800,2,1,0,595,214,215,1
"f7fb1952f56b4189b86a9f8b7862d2b8","be502a7a43c44bf7b682698de79d9369",8685800,1,-1,0,596,215,214,-1
"f7fb1952f56b4189b86a9f8b7862d2b8","f7fb1952f56b4189b86a9f8b7862d2b8",8685800,16,0,1,598,215,215,0
"f7fb1952f56b4189b86a9f8b7862d2b8","b860ee85d8bc4a2f97958cfb71be3533",8685800,1,1,0,614,215,216,1
"b860ee85d8bc4a2f97958cfb71be3533","b860ee85d8bc4a2f97958cfb71be3533",8685800,2,0,1,615,216,216,0
"b860ee85d8bc4a2f97958cfb71be3533","ec341f459285443b8361f7f15638ff08",8685800,1,-3,0,617,216,213,-3
"ec341f459285443b8361f7f15638ff08","363837c182e04711840d896ae1e0339c",8685800,1,6,0,618,213,218,5
"363837c182e04711840d896ae1e0339c","363837c182e04711840d896ae1e0339c",8685800,14,0,1,619,218,218,0
"363837c182e04711840d896ae1e0339c","01b2051f8941460d89945e3b02d1ce78",8685800,1,-1,0,633,218,217,-1
"01b2051f8941460d89945e3b02d1ce78","91125ca626c5470eb145501f8c37f8db",8685800,1,4,0,634,217,220,3
"91125ca626c5470eb145501f8c37f8db","91125ca626c5470eb145501f8c37f8db",8685800,1,0,1,635,220,220,0
"91125ca626c5470eb145501f8c37f8db","1c6721b1f63f4d30ba7746ea8af02a52",8685800,1,3,0,636,220,221,1
"1c6721b1f63f4d30ba7746ea8af02a52","d7f13c8d63ec4e2aa673fbb9cf9c6933",8685800,1,-21,0,637,221,206,-15
"d7f13c8d63ec4e2aa673fbb9cf9c6933","77ecef8eff6b4a2caea7707669bf7475",8685800,1,22,0,638,206,222,16
"77ecef8eff6b4a2caea7707669bf7475","77ecef8eff6b4a2caea7707669bf7475",8685800,12,0,1,639,222,222,0
"77ecef8eff6b4a2caea7707669bf7475","8b9ae98743bd4d4a8a87dff1c1244211",8685800,1,6,0,651,222,227,5
"8b9ae98743bd4d4a8a87dff1c1244211","1c6721b1f63f4d30ba7746ea8af02a52",8685800,1,-7,0,652,227,221,-6
"1c6721b1f63f4d30ba7746ea8af02a52","d03cb855c70044cf8c35d9ec0de696e3",8685800,1,4,0,653,221,224,3
"d03cb855c70044cf8c35d9ec0de696e3","d03cb855c70044cf8c35d9ec0de696e3",8685800,1,0,1,654,224,224,0
"d03cb855c70044cf8c35d9ec0de696e3","a49a937d6896486d9a5396654abcf2e1",8685800,1,2,0,655,224,226,2
"a49a937d6896486d9a5396654abcf2e1","a49a937d6896486d9a5396654abcf2e1",8685800,1,0,1,656,226,226,0
"a49a937d6896486d9a5396654abcf2e1","8b9ae98743bd4d4a8a87dff1c1244211",8685800,1,1,0,657,226,227,1
"8b9ae98743bd4d4a8a87dff1c1244211","8b9ae98743bd4d4a8a87dff1c1244211",8685800,17,0,1,658,227,227,0
"8b9ae98743bd4d4a8a87dff1c1244211","f7906d6f59b9489a91d2ef40db5a474d",8685800,1,-4,0,675,227,223,-4
"f7906d6f59b9489a91d2ef40db5a474d","2ab1535aac1346ba8801535bf729ef37",8685800,1,7,0,676,223,229,6
"2ab1535aac1346ba8801535bf729ef37","2ab1535aac1346ba8801535bf729ef37",8685800,1,0,1,677,229,229,0
"2ab1535aac1346ba8801535bf729ef37","a4f40fb48a8542c8949bae1f002cd9bc",8685800,1,2,0,678,229,231,2
"a4f40fb48a8542c8949bae1f002cd9bc","a4f40fb48a8542c8949bae1f002cd9bc",8685800,2,0,1,679,231,231,0
"a4f40fb48a8542c8949bae1f002cd9bc","8972c23e32044edb8a78fa1eed4e5947",8685800,1,1,0,681,231,232,1
"8972c23e32044edb8a78fa1eed4e5947","8972c23e32044edb8a78fa1eed4e5947",8685800,1,0,1,682,232,232,0
"8972c23e32044edb8a78fa1eed4e5947","92feb4a40f8344d38b6f722e42a53295",8685800,1,1,0,683,232,233,1
"92feb4a40f8344d38b6f722e42a53295","92feb4a40f8344d38b6f722e42a53295",8685800,2,0,1,684,233,233,0
"92feb4a40f8344d38b6f722e42a53295","5152833676bf4c6cb317060be10f68db",8685800,1,-5,0,686,233,228,-5
"5152833676bf4c6cb317060be10f68db","ca3e28f290354c08aefe5b0f769604e6",8685800,1,8,0,687,228,235,7
"ca3e28f290354c08aefe5b0f769604e6","ca3e28f290354c08aefe5b0f769604e6",8685800,9,0,1,688,235,235,0
"ca3e28f290354c08aefe5b0f769604e6","79a35eea833e4c2c9d22fc53c3c6445c",8685800,1,1,0,697,235,236,1
"79a35eea833e4c2c9d22fc53c3c6445c","79a35eea833e4c2c9d22fc53c3c6445c",8685800,4,0,1,698,236,236,0
"79a35eea833e4c2c9d22fc53c3c6445c","8f68228b1518449e9615cdafee41a2bd",8685800,1,1,0,702,236,237,1
"8f68228b1518449e9615cdafee41a2bd","8f68228b1518449e9615cdafee41a2bd",8685800,1,0,1,703,237,237,0
"8f68228b1518449e9615cdafee41a2bd","cab89fa5c3ed45a5aa550fc0352d6a42",8685800,1,1,0,704,237,238,1
"cab89fa5c3ed45a5aa550fc0352d6a42","cab89fa5c3ed45a5aa550fc0352d6a42",8685800,1,0,1,705,238,238,0
"cab89fa5c3ed45a5aa550fc0352d6a42","66d4fad4f1cf4b46be0750a99ad7a35a",8685800,1,1,0,706,238,239,1
"66d4fad4f1cf4b46be0750a99ad7a35a","66d4fad4f1cf4b46be0750a99ad7a35a",8685800,1,0,1,707,239,239,0
"66d4fad4f1cf4b46be0750a99ad7a35a","0b04c8e2f86d48c7aeb7e225819cd32b",8685800,1,-5,0,708,239,234,-5
"0b04c8e2f86d48c7aeb7e225819cd32b","f53da5fd9bfe412da4b80d4742563b6c",8685800,1,8,0,709,234,241,7
"f53da5fd9bfe412da4b80d4742563b6c","f53da5fd9bfe412da4b80d4742563b6c",8685800,1,0,1,710,241,241,0
"f53da5fd9bfe412da4b80d4742563b6c","2ae94c0cea4d480a9d5dca8fb1d7b542",8685800,1,3,0,711,241,242,1
"2ae94c0cea4d480a9d5dca8fb1d7b542","1c6721b1f63f4d30ba7746ea8af02a52",8685800,1,-27,0,712,242,221,-21
"1c6721b1f63f4d30ba7746ea8af02a52","1ebf23f9d994469a85206e4c7b1bf5f5",8685800,1,30,0,713,221,245,24
"1ebf23f9d994469a85206e4c7b1bf5f5","2ae94c0cea4d480a9d5dca8fb1d7b542",8685800,1,-3,0,714,245,242,-3
"2ae94c0cea4d480a9d5dca8fb1d7b542","2ae94c0cea4d480a9d5dca8fb1d7b542",8685800,1,0,1,715,242,242,0
"2ae94c0cea4d480a9d5dca8fb1d7b542","1ebf23f9d994469a85206e4c7b1bf5f5",8685800,1,3,0,716,242,245,3
"1ebf23f9d994469a85206e4c7b1bf5f5","1ebf23f9d994469a85206e4c7b1bf5f5",8685800,11,0,1,717,245,245,0
"1ebf23f9d994469a85206e4c7b1bf5f5","fa235f0f364d47e4ae1c87f47bf8e6ba",8685800,1,9,0,728,245,252,7
"fa235f0f364d47e4ae1c87f47bf8e6ba","2ae94c0cea4d480a9d5dca8fb1d7b542",8685800,1,-12,0,729,252,242,-10
"2ae94c0cea4d480a9d5dca8fb1d7b542","56586aa865414f538729c7f7735d2bc6",8685800,1,-323,0,730,242,12,-230
"b613861cecf84ffcab01afb23f660475","b613861cecf84ffcab01afb23f660475",22860074,1,0,1,1,1,1,0
"b613861cecf84ffcab01afb23f660475","e2911e79efc2420eac45d9f671463d4b",22860074,1,3,0,2,1,2,1
"519d1b8c59404d67b54e96c5c8a830b2","519d1b8c59404d67b54e96c5c8a830b2",22860074,1,0,1,7,3,3,0
"519d1b8c59404d67b54e96c5c8a830b2","531db53f81f646edb0cdcfe0085b03b7",22860074,1,1,0,8,3,4,1
"531db53f81f646edb0cdcfe0085b03b7","531db53f81f646edb0cdcfe0085b03b7",22860074,1,0,1,9,4,4,0
"531db53f81f646edb0cdcfe0085b03b7","4f5f94b2f95141e0a9d53a61da2276da",22860074,1,1,0,10,4,5,1
"4f5f94b2f95141e0a9d53a61da2276da","4f5f94b2f95141e0a9d53a61da2276da",22860074,1,0,1,11,5,5,0
"4f5f94b2f95141e0a9d53a61da2276da","6d541c89590949f99af293c4f2333f67",22860074,1,1,0,12,5,6,1
"6d541c89590949f99af293c4f2333f67","6d541c89590949f99af293c4f2333f67",22860074,1,0,1,13,6,6,0
"6d541c89590949f99af293c4f2333f67","dd5cf0b9fe4c4f1d8f5ff8e4c04879cb",22860074,1,1,0,14,6,7,1
"dd5cf0b9fe4c4f1d8f5ff8e4c04879cb","dd5cf0b9fe4c4f1d8f5ff8e4c04879cb",22860074,1,0,1,15,7,7,0
"dd5cf0b9fe4c4f1d8f5ff8e4c04879cb","f96261861edc426abe2248be4f0a709a",22860074,1,1,0,16,7,8,1
"f96261861edc426abe2248be4f0a709a","f96261861edc426abe2248be4f0a709a",22860074,3,0,1,17,8,8,0
"f96261861edc426abe2248be4f0a709a","66b5e16f4f75454fb5b8172079f0fa83",22860074,1,1,0,18,8,9,1
"66b5e16f4f75454fb5b8172079f0fa83","66b5e16f4f75454fb5b8172079f0fa83",22860074,3,0,1,19,9,9,0
"66b5e16f4f75454fb5b8172079f0fa83","0680571d4698477995e41842c36a54b2",22860074,1,1,0,20,9,10,1
"0680571d4698477995e41842c36a54b2","0680571d4698477995e41842c36a54b2",22860074,1,0,1,21,10,10,0
"0680571d4698477995e41842c36a54b2","9112f2bffece48e08c6d2287be204085",22860074,1,1,0,22,10,11,1
"9112f2bffece48e08c6d2287be204085","9112f2bffece48e08c6d2287be204085",22860074,4,0,1,23,11,11,0
"9112f2bffece48e08c6d2287be204085","e2911e79efc2420eac45d9f671463d4b",22860074,1,-9,0,25,11,2,-9
"e2911e79efc2420eac45d9f671463d4b","519d1b8c59404d67b54e96c5c8a830b2",22860074,2,1,0,26,2,3,1
"519d1b8c59404d67b54e96c5c8a830b2","9112f2bffece48e08c6d2287be204085",22860074,1,8,0,27,3,11,8
"9112f2bffece48e08c6d2287be204085","0680571d4698477995e41842c36a54b2",22860074,1,-1,0,30,11,10,-1
"0680571d4698477995e41842c36a54b2","66b5e16f4f75454fb5b8172079f0fa83",22860074,1,-1,0,31,10,9,-1
"66b5e16f4f75454fb5b8172079f0fa83","f96261861edc426abe2248be4f0a709a",22860074,1,-1,0,34,9,8,-1
"f96261861edc426abe2248be4f0a709a","56586aa865414f538729c7f7735d2bc6",22860074,1,6,0,37,8,12,4
"e2911e79efc2420eac45d9f671463d4b","67a089198fcb4e1c8f2385786c2b296f",22860074,1,69,0,42,2,39,37
"67a089198fcb4e1c8f2385786c2b296f","e2911e79efc2420eac45d9f671463d4b",22860074,1,-69,0,43,39,2,-37
"b7f2b31585d94eb3bf86376714aa7070","56586aa865414f538729c7f7735d2bc6",22860074,1,-2,0,53,13,12,-1
"3f1c815879794b929260d224becaff7e","3f1c815879794b929260d224becaff7e",22860074,1,0,1,58,14,14,0
"81c864a886d54a6b8ff85f7d736f4f95","3f1c815879794b929260d224becaff7e",22860074,2,-2,0,60,15,14,-1
"5c5ceeee4562457ba6d41515aeebfbb1","5c5ceeee4562457ba6d41515aeebfbb1",22860074,3,0,1,65,17,17,0
"9afd71a5298d4333b6849dfce1b9422c","9afd71a5298d4333b6849dfce1b9422c",22860074,2,0,1,70,18,18,0
"b7719e26494940efa49512aedd0aac79","d4f45188d3c84a02ba08454e6403a818",22860074,1,5,0,73,20,24,4
"d4c3b003e8274e429d2fa688d73fde6d","d4c3b003e8274e429d2fa688d73fde6d",22860074,4,0,1,75,22,22,0
"d4c3b003e8274e429d2fa688d73fde6d","b7719e26494940efa49512aedd0aac79",22860074,1,-3,0,79,22,20,-2
"51970cfa30e643e894e66ae85c8024cc","c33c17be71ae4d588da7369472e5bb1b",22860074,1,6,0,86,31,34,3
"c33c17be71ae4d588da7369472e5bb1b","4e51676dc72045d99c19b9fa7b22f8bc",22860074,1,-9,0,87,34,29,-5
"4e51676dc72045d99c19b9fa7b22f8bc","93679be414554a11b1893002f2229a93",22860074,1,12,0,88,29,35,6
"93679be414554a11b1893002f2229a93","7040a13096d746ac84b8fac8d9752058",22860074,2,3,0,92,35,36,1
"93679be414554a11b1893002f2229a93","93679be414554a11b1893002f2229a93",22860074,1,0,1,94,35,35,0
"7040a13096d746ac84b8fac8d9752058","7040a13096d746ac84b8fac8d9752058",22860074,1,0,1,96,36,36,0
"9a0dc646f934470daf08c4b56ccf73db","9a0dc646f934470daf08c4b56ccf73db",22860074,1,0,1,98,37,37,0
"fc0e049d56024bc9a02c9a9c435c3df7","fc0e049d56024bc9a02c9a9c435c3df7",22860074,1,0,1,100,38,38,0
"fc0e049d56024bc9a02c9a9c435c3df7","67a089198fcb4e1c8f2385786c2b296f",22860074,2,4,0,101,38,39,1
"67a089198fcb4e1c8f2385786c2b296f","64d48c6c9c7940639a932219a6c87198",22860074,3,1,0,102,39,40,1
"64d48c6c9c7940639a932219a6c87198","64d48c6c9c7940639a932219a6c87198",22860074,1,0,1,103,40,40,0
"64d48c6c9c7940639a932219a6c87198","67a089198fcb4e1c8f2385786c2b296f",22860074,3,-1,0,104,40,39,-1
"67a089198fcb4e1c8f2385786c2b296f","b534b89233134e30a9b5645138bfa9ee",22860074,3,4,0,105,39,41,2
"b534b89233134e30a9b5645138bfa9ee","a49d1bb4328949299686242fd0be5584",22860074,1,-42,0,106,41,21,-20
"a49d1bb4328949299686242fd0be5584","b7719e26494940efa49512aedd0aac79",22860074,2,-2,0,107,21,20,-1
"b7719e26494940efa49512aedd0aac79","afbf7250b99d47bea07172749483ca97",22860074,5,12,0,108,20,28,8
"afbf7250b99d47bea07172749483ca97","b7719e26494940efa49512aedd0aac79",22860074,2,-12,0,109,28,20,-8
"afbf7250b99d47bea07172749483ca97","4e51676dc72045d99c19b9fa7b22f8bc",22860074,3,3,0,111,28,29,1
"4e51676dc72045d99c19b9fa7b22f8bc","4e51676dc72045d99c19b9fa7b22f8bc",22860074,3,0,1,112,29,29,0
"4e51676dc72045d99c19b9fa7b22f8bc","51970cfa30e643e894e66ae85c8024cc",22860074,3,3,0,113,29,31,2
"51970cfa30e643e894e66ae85c8024cc","4e51676dc72045d99c19b9fa7b22f8bc",22860074,2,-3,0,114,31,29,-2
"4e51676dc72045d99c19b9fa7b22f8bc","c33c17be71ae4d588da7369472e5bb1b",22860074,2,9,0,115,29,34,5
"c33c17be71ae4d588da7369472e5bb1b","93679be414554a11b1893002f2229a93",22860074,2,3,0,116,34,35,1
"93679be414554a11b1893002f2229a93","c33c17be71ae4d588da7369472e5bb1b",22860074,3,-3,0,117,35,34,-1
"c33c17be71ae4d588da7369472e5bb1b","b613861cecf84ffcab01afb23f660475",22860074,1,-56,0,118,34,1,-33
"b613861cecf84ffcab01afb23f660475","a49d1bb4328949299686242fd0be5584",22860074,1,34,0,119,1,21,20
"b7719e26494940efa49512aedd0aac79","b7719e26494940efa49512aedd0aac79",22860074,1,0,1,121,20,20,0
"afbf7250b99d47bea07172749483ca97","afbf7250b99d47bea07172749483ca97",22860074,1,0,1,123,28,28,0
"c33c17be71ae4d588da7369472e5bb1b","7040a13096d746ac84b8fac8d9752058",22860074,2,6,0,131,34,36,2
"7040a13096d746ac84b8fac8d9752058","93679be414554a11b1893002f2229a93",22860074,3,-3,0,132,36,35,-1
"93679be414554a11b1893002f2229a93","9a0dc646f934470daf08c4b56ccf73db",22860074,1,6,0,133,35,37,2
"9a0dc646f934470daf08c4b56ccf73db","7040a13096d746ac84b8fac8d9752058",22860074,1,-3,0,134,37,36,-1
"7040a13096d746ac84b8fac8d9752058","9a0dc646f934470daf08c4b56ccf73db",22860074,2,3,0,135,36,37,1
"9a0dc646f934470daf08c4b56ccf73db","fc0e049d56024bc9a02c9a9c435c3df7",22860074,2,3,0,136,37,38,1
"67a089198fcb4e1c8f2385786c2b296f","fc0e049d56024bc9a02c9a9c435c3df7",22860074,1,-4,0,138,39,38,-1
"fc0e049d56024bc9a02c9a9c435c3df7","64d48c6c9c7940639a932219a6c87198",22860074,1,5,0,139,38,40,2
"64d48c6c9c7940639a932219a6c87198","e2911e79efc2420eac45d9f671463d4b",22860074,1,-70,0,140,40,2,-38
"e2911e79efc2420eac45d9f671463d4b","e2911e79efc2420eac45d9f671463d4b",22860074,6,0,1,141,2,2,0
"e2911e79efc2420eac45d9f671463d4b","56586aa865414f538729c7f7735d2bc6",22860074,5,12,0,142,2,12,10
"56586aa865414f538729c7f7735d2bc6","e2911e79efc2420eac45d9f671463d4b",22860074,4,-12,0,143,12,2,-10
"56586aa865414f538729c7f7735d2bc6","56586aa865414f538729c7f7735d2bc6",22860074,3,0,1,145,12,12,0
"56586aa865414f538729c7f7735d2bc6","b7f2b31585d94eb3bf86376714aa7070",22860074,3,2,0,146,12,13,1
"b7f2b31585d94eb3bf86376714aa7070","b7f2b31585d94eb3bf86376714aa7070",22860074,5,0,1,147,13,13,0
"b7f2b31585d94eb3bf86376714aa7070","3f1c815879794b929260d224becaff7e",22860074,2,2,0,148,13,14,1
"3f1c815879794b929260d224becaff7e","81c864a886d54a6b8ff85f7d736f4f95",22860074,4,2,0,149,14,15,1
"81c864a886d54a6b8ff85f7d736f4f95","5c5ceeee4562457ba6d41515aeebfbb1",22860074,2,4,0,150,15,17,2
"5c5ceeee4562457ba6d41515aeebfbb1","56586aa865414f538729c7f7735d2bc6",22860074,2,-10,0,151,17,12,-5
"56586aa865414f538729c7f7735d2bc6","9afd71a5298d4333b6849dfce1b9422c",22860074,2,13,0,152,12,18,6
"9afd71a5298d4333b6849dfce1b9422c","b7719e26494940efa49512aedd0aac79",22860074,2,4,0,153,18,20,2
"b7719e26494940efa49512aedd0aac79","9afd71a5298d4333b6849dfce1b9422c",22860074,1,-4,0,154,20,18,-2
"9afd71a5298d4333b6849dfce1b9422c","d4f45188d3c84a02ba08454e6403a818",22860074,1,9,0,155,18,24,6
"d4f45188d3c84a02ba08454e6403a818","d4c3b003e8274e429d2fa688d73fde6d",22860074,2,-2,0,156,24,22,-2
"d4c3b003e8274e429d2fa688d73fde6d","5bc03c8f16354d04bd51f5bb93559ad3",22860074,1,4,0,157,22,26,4
"5bc03c8f16354d04bd51f5bb93559ad3","f924752d8a1149668870b1e7698486f7",22860074,1,48,0,158,26,50,24
"f924752d8a1149668870b1e7698486f7","b534b89233134e30a9b5645138bfa9ee",22860074,1,-11,0,159,50,41,-9
"b534b89233134e30a9b5645138bfa9ee","d0c74f735e024943943e40333d6d337f",22860074,2,12,0,160,41,51,10
"d0c74f735e024943943e40333d6d337f","d0c74f735e024943943e40333d6d337f",22860074,4,0,1,161,51,51,0
"d0c74f735e024943943e40333d6d337f","983f8ff320594b279a7f4a6fe132f9c5",22860074,1,2,0,163,51,53,2
"983f8ff320594b279a7f4a6fe132f9c5","983f8ff320594b279a7f4a6fe132f9c5",22860074,2,0,1,164,53,53,0
"983f8ff320594b279a7f4a6fe132f9c5","35adfa5d923046aebabfefd98f35ff05",22860074,1,1,0,166,53,54,1
"35adfa5d923046aebabfefd98f35ff05","35adfa5d923046aebabfefd98f35ff05",22860074,5,0,1,167,54,54,0
"35adfa5d923046aebabfefd98f35ff05","b6f8a98476224da1b40e555ececc7ed8",22860074,1,1,0,172,54,55,1
"b6f8a98476224da1b40e555ececc7ed8","b6f8a98476224da1b40e555ececc7ed8",22860074,5,0,1,173,55,55,0
"b6f8a98476224da1b40e555ececc7ed8","86e22cb5fe0e4b47a9489ecddf7ed78f",22860074,1,1,0,178,55,56,1
"86e22cb5fe0e4b47a9489ecddf7ed78f","86e22cb5fe0e4b47a9489ecddf7ed78f",22860074,8,0,1,179,56,56,0
"86e22cb5fe0e4b47a9489ecddf7ed78f","f924752d8a1149668870b1e7698486f7",22860074,1,-6,0,187,56,50,-6
"f924752d8a1149668870b1e7698486f7","78f30e4dcac84e3cbea8b2cc6e0d62b3",22860074,3,10,0,188,50,59,9
"78f30e4dcac84e3cbea8b2cc6e0d62b3","a1f2f12debe5432fb7a70bcd12bacfb9",22860074,3,-1,0,189,59,58,-1
"a1f2f12debe5432fb7a70bcd12bacfb9","a1f2f12debe5432fb7a70bcd12bacfb9",22860074,31,0,1,190,58,58,0
"a1f2f12debe5432fb7a70bcd12bacfb9","78f30e4dcac84e3cbea8b2cc6e0d62b3",22860074,1,1,0,221,58,59,1
"78f30e4dcac84e3cbea8b2cc6e0d62b3","78f30e4dcac84e3cbea8b2cc6e0d62b3",22860074,13,0,1,222,59,59,0
"78f30e4dcac84e3cbea8b2cc6e0d62b3","bc42d26810654ea9a1df1efe1e58c7d5",22860074,1,5,0,235,59,63,4
"bc42d26810654ea9a1df1efe1e58c7d5","12aa6e1672ac4e7aa6449a7a8609cd72",22860074,1,-7,0,236,63,57,-6
"12aa6e1672ac4e7aa6449a7a8609cd72","a0a418b8540d479fa6e0f653b701da8b",22860074,3,8,0,237,57,64,7
"a0a418b8540d479fa6e0f653b701da8b","67a089198fcb4e1c8f2385786c2b296f",22860074,1,-31,0,238,64,39,-25
"b534b89233134e30a9b5645138bfa9ee","b534b89233134e30a9b5645138bfa9ee",22860074,1,0,1,242,41,41,0
"b534b89233134e30a9b5645138bfa9ee","67a089198fcb4e1c8f2385786c2b296f",22860074,1,-4,0,243,41,39,-2
"b534b89233134e30a9b5645138bfa9ee","0e37b720d23b4e7f8b313e79313fd107",22860074,1,3,0,247,41,44,3
"0e37b720d23b4e7f8b313e79313fd107","0e37b720d23b4e7f8b313e79313fd107",22860074,1,0,1,248,44,44,0
"0e37b720d23b4e7f8b313e79313fd107","6875d67fdd5f48168b62719df449bebd",22860074,1,1,0,249,44,45,1
"6875d67fdd5f48168b62719df449bebd","6875d67fdd5f48168b62719df449bebd",22860074,3,0,1,250,45,45,0
"6875d67fdd5f48168b62719df449bebd","6e13d61a7bdb44bca949c9f86fab3be5",22860074,1,3,0,253,45,47,2
"6e13d61a7bdb44bca949c9f86fab3be5","b534b89233134e30a9b5645138bfa9ee",22860074,3,-7,0,254,47,41,-6
"b534b89233134e30a9b5645138bfa9ee","6e13d61a7bdb44bca949c9f86fab3be5",22860074,3,7,0,255,41,47,6
"6e13d61a7bdb44bca949c9f86fab3be5","195f78799f984cc2b06c48dfe36be751",22860074,1,2,0,256,47,49,2
"195f78799f984cc2b06c48dfe36be751","195f78799f984cc2b06c48dfe36be751",22860074,8,0,1,257,49,49,0
"195f78799f984cc2b06c48dfe36be751","d9c8d8c444a64dadbbb508652c721e17",22860074,2,-3,0,265,49,46,-3
"d9c8d8c444a64dadbbb508652c721e17","b534b89233134e30a9b5645138bfa9ee",22860074,1,-6,0,266,46,41,-5
"b534b89233134e30a9b5645138bfa9ee","195f78799f984cc2b06c48dfe36be751",22860074,1,9,0,271,41,49,8
"d9c8d8c444a64dadbbb508652c721e17","d0c74f735e024943943e40333d6d337f",22860074,1,6,0,273,46,51,5
"d0c74f735e024943943e40333d6d337f","f924752d8a1149668870b1e7698486f7",22860074,2,-1,0,274,51,50,-1
"a1f2f12debe5432fb7a70bcd12bacfb9","12aa6e1672ac4e7aa6449a7a8609cd72",22860074,2,-1,0,277,58,57,-1
"a0a418b8540d479fa6e0f653b701da8b","bc42d26810654ea9a1df1efe1e58c7d5",22860074,2,-1,0,279,64,63,-1
"bc42d26810654ea9a1df1efe1e58c7d5","b534b89233134e30a9b5645138bfa9ee",22860074,1,-26,0,280,63,41,-22
"bc42d26810654ea9a1df1efe1e58c7d5","4c943503763e4e349906eea3ed3c8e86",22860074,1,-2,0,290,63,61,-2
"4c943503763e4e349906eea3ed3c8e86","4c943503763e4e349906eea3ed3c8e86",22860074,1,0,1,291,61,61,0
"4c943503763e4e349906eea3ed3c8e86","d0c74f735e024943943e40333d6d337f",22860074,1,-12,0,292,61,51,-10
"d0c74f735e024943943e40333d6d337f","309ccf3cc4fe429d9bfbaef53d3fa479",22860074,1,11,0,293,51,60,9
"309ccf3cc4fe429d9bfbaef53d3fa479","a0a418b8540d479fa6e0f653b701da8b",22860074,1,4,0,294,60,64,4
"a0a418b8540d479fa6e0f653b701da8b","f924752d8a1149668870b1e7698486f7",22860074,1,-16,0,295,64,50,-14
"f924752d8a1149668870b1e7698486f7","bc42d26810654ea9a1df1efe1e58c7d5",22860074,1,15,0,296,50,63,13
"bc42d26810654ea9a1df1efe1e58c7d5","bc42d26810654ea9a1df1efe1e58c7d5",22860074,4,0,1,297,63,63,0
"bc42d26810654ea9a1df1efe1e58c7d5","a0a418b8540d479fa6e0f653b701da8b",22860074,1,1,0,301,63,64,1
"a0a418b8540d479fa6e0f653b701da8b","a0a418b8540d479fa6e0f653b701da8b",22860074,3,0,1,302,64,64,0
"a0a418b8540d479fa6e0f653b701da8b","309ccf3cc4fe429d9bfbaef53d3fa479",22860074,1,-4,0,305,64,60,-4
"309ccf3cc4fe429d9bfbaef53d3fa479","d646286c8051419bbc2e31dd1db55ca8",22860074,1,10,0,306,60,67,7
"d646286c8051419bbc2e31dd1db55ca8","b534b89233134e30a9b5645138bfa9ee",22860074,1,-33,0,307,67,41,-26
"b534b89233134e30a9b5645138bfa9ee","267f883678b24aed855fde42524975d9",22860074,1,37,0,308,41,71,30
"267f883678b24aed855fde42524975d9","267f883678b24aed855fde42524975d9",22860074,1,0,1,309,71,71,0
"267f883678b24aed855fde42524975d9","88fff56d0342490dbef9040750a20f6c",22860074,1,1,0,310,71,72,1
"88fff56d0342490dbef9040750a20f6c","88fff56d0342490dbef9040750a20f6c",22860074,1,0,1,311,72,72,0
"88fff56d0342490dbef9040750a20f6c","adb17b12b66c4a49a85fd34322f7df70",22860074,1,1,0,312,72,73,1
"adb17b12b66c4a49a85fd34322f7df70","adb17b12b66c4a49a85fd34322f7df70",22860074,1,0,1,313,73,73,0
"adb17b12b66c4a49a85fd34322f7df70","d646286c8051419bbc2e31dd1db55ca8",22860074,1,-6,0,314,73,67,-6
"d646286c8051419bbc2e31dd1db55ca8","a2becd407db34b189200a32546d9d569",22860074,1,9,0,315,67,75,8
"a2becd407db34b189200a32546d9d569","a2becd407db34b189200a32546d9d569",22860074,3,0,1,316,75,75,0
"a2becd407db34b189200a32546d9d569","58c22b011d0f4c2ea6d13615edbb9eeb",22860074,1,2,0,319,75,77,2
"58c22b011d0f4c2ea6d13615edbb9eeb","58c22b011d0f4c2ea6d13615edbb9eeb",22860074,5,0,1,320,77,77,0
"58c22b011d0f4c2ea6d13615edbb9eeb","dd76e1861dc9461c830888729d091ee0",22860074,1,1,0,325,77,78,1
"dd76e1861dc9461c830888729d091ee0","dd76e1861dc9461c830888729d091ee0",22860074,2,0,1,326,78,78,0
"dd76e1861dc9461c830888729d091ee0","cd1d828f1a694b87913a7ea66c23803e",22860074,1,1,0,328,78,79,1
"cd1d828f1a694b87913a7ea66c23803e","cd1d828f1a694b87913a7ea66c23803e",22860074,8,0,1,329,79,79,0
"cd1d828f1a694b87913a7ea66c23803e","9176a3c2b4d2465fa8b0c67096c2a97e",22860074,1,1,0,337,79,80,1
"9176a3c2b4d2465fa8b0c67096c2a97e","9176a3c2b4d2465fa8b0c67096c2a97e",22860074,11,0,1,338,80,80,0
"9176a3c2b4d2465fa8b0c67096c2a97e","f8ec6445f7194e25b9101d4fbcb07a18",22860074,1,1,0,349,80,81,1
"f8ec6445f7194e25b9101d4fbcb07a18","f8ec6445f7194e25b9101d4fbcb07a18",22860074,2,0,1,350,81,81,0
"f8ec6445f7194e25b9101d4fbcb07a18","140d5b27b8574befad82c0a013b59dfa",22860074,1,-7,0,352,81,74,-7
"140d5b27b8574befad82c0a013b59dfa","d18a9ea32855445f8736581f5cb119ce",22860074,1,9,0,353,74,82,8
"d18a9ea32855445f8736581f5cb119ce","f564483cbd7a407681aa2fcca518cf5f",22860074,1,4,0,354,82,85,3
"f564483cbd7a407681aa2fcca518cf5f","f564483cbd7a407681aa2fcca518cf5f",22860074,1,0,1,355,85,85,0
"f564483cbd7a407681aa2fcca518cf5f","18fd01350bd5434ca636d59a599d768a",22860074,1,1,0,356,85,86,1
"18fd01350bd5434ca636d59a599d768a","18fd01350bd5434ca636d59a599d768a",22860074,9,0,1,357,86,86,0
"18fd01350bd5434ca636d59a599d768a","ae5ac430ea254e708a6f5deaaf7464ae",22860074,1,-2,0,366,86,84,-2
"ae5ac430ea254e708a6f5deaaf7464ae","6a9f0ef185fb47f0937e29daa1c71ed5",22860074,1,7,0,367,84,90,6
"6a9f0ef185fb47f0937e29daa1c71ed5","6a9f0ef185fb47f0937e29daa1c71ed5",22860074,4,0,1,368,90,90,0
"6a9f0ef185fb47f0937e29daa1c71ed5","d18a9ea32855445f8736581f5cb119ce",22860074,1,-10,0,372,90,82,-8
"d18a9ea32855445f8736581f5cb119ce","d646286c8051419bbc2e31dd1db55ca8",22860074,1,-17,0,373,82,67,-15
"d646286c8051419bbc2e31dd1db55ca8","c681290961c94c4caf23b529d1ae6b9a",22860074,1,25,0,374,67,88,21
"c681290961c94c4caf23b529d1ae6b9a","c681290961c94c4caf23b529d1ae6b9a",22860074,3,0,1,375,88,88,0
"c681290961c94c4caf23b529d1ae6b9a","d646286c8051419bbc2e31dd1db55ca8",22860074,1,-25,0,378,88,67,-21
"d646286c8051419bbc2e31dd1db55ca8","e20db35ced8544ddac5bc3839145e463",22860074,1,30,0,379,67,91,24
"e20db35ced8544ddac5bc3839145e463","67a089198fcb4e1c8f2385786c2b296f",22860074,1,-67,0,380,91,39,-52
"67a089198fcb4e1c8f2385786c2b296f","a9ac840f098c4bd0a2ee896214ce29cd",22860074,1,165,0,381,39,168,129
"a9ac840f098c4bd0a2ee896214ce29cd","a9ac840f098c4bd0a2ee896214ce29cd",22860074,2,0,1,382,168,168,0
"a9ac840f098c4bd0a2ee896214ce29cd","0c7262dff33c4087bc660ccf40f92f9c",22860074,1,4,0,384,168,169,1
"0c7262dff33c4087bc660ccf40f92f9c","b2275c3fad834f8d90737a2d9a6927d6",22860074,1,3,0,385,169,172,3
"b7719e26494940efa49512aedd0aac79","b613861cecf84ffcab01afb23f660475",14092396,1,-32,0,1,20,1,-19
"b613861cecf84ffcab01afb23f660475","b613861cecf84ffcab01afb23f660475",14092396,4,0,1,2,1,1,0
"b613861cecf84ffcab01afb23f660475","e2911e79efc2420eac45d9f671463d4b",14092396,1,3,0,6,1,2,1
"e2911e79efc2420eac45d9f671463d4b","e2911e79efc2420eac45d9f671463d4b",14092396,2,0,1,7,2,2,0
"e2911e79efc2420eac45d9f671463d4b","519d1b8c59404d67b54e96c5c8a830b2",14092396,1,1,0,9,2,3,1
"519d1b8c59404d67b54e96c5c8a830b2","519d1b8c59404d67b54e96c5c8a830b2",14092396,1,0,1,10,3,3,0
"519d1b8c59404d67b54e96c5c8a830b2","531db53f81f646edb0cdcfe0085b03b7",14092396,1,1,0,11,3,4,1
"531db53f81f646edb0cdcfe0085b03b7","531db53f81f646edb0cdcfe0085b03b7",14092396,1,0,1,12,4,4,0
"531db53f81f646edb0cdcfe0085b03b7","4f5f94b2f95141e0a9d53a61da2276da",14092396,1,1,0,13,4,5,1
"4f5f94b2f95141e0a9d53a61da2276da","4f5f94b2f95141e0a9d53a61da2276da",14092396,3,0,1,14,5,5,0
"4f5f94b2f95141e0a9d53a61da2276da","6d541c89590949f99af293c4f2333f67",14092396,2,1,0,16,5,6,1
"6d541c89590949f99af293c4f2333f67","6d541c89590949f99af293c4f2333f67",14092396,2,0,1,17,6,6,0
"6d541c89590949f99af293c4f2333f67","dd5cf0b9fe4c4f1d8f5ff8e4c04879cb",14092396,2,1,0,18,6,7,1
"dd5cf0b9fe4c4f1d8f5ff8e4c04879cb","e2911e79efc2420eac45d9f671463d4b",14092396,1,-5,0,19,7,2,-5
"e2911e79efc2420eac45d9f671463d4b","4f5f94b2f95141e0a9d53a61da2276da",14092396,1,3,0,20,2,5,3
"dd5cf0b9fe4c4f1d8f5ff8e4c04879cb","dd5cf0b9fe4c4f1d8f5ff8e4c04879cb",14092396,1,0,1,25,7,7,0
"dd5cf0b9fe4c4f1d8f5ff8e4c04879cb","f96261861edc426abe2248be4f0a709a",14092396,1,1,0,26,7,8,1
"f96261861edc426abe2248be4f0a709a","f96261861edc426abe2248be4f0a709a",14092396,1,0,1,27,8,8,0
"f96261861edc426abe2248be4f0a709a","66b5e16f4f75454fb5b8172079f0fa83",14092396,1,1,0,28,8,9,1
"66b5e16f4f75454fb5b8172079f0fa83","66b5e16f4f75454fb5b8172079f0fa83",14092396,1,0,1,29,9,9,0
"66b5e16f4f75454fb5b8172079f0fa83","0680571d4698477995e41842c36a54b2",14092396,1,1,0,30,9,10,1
"0680571d4698477995e41842c36a54b2","0680571d4698477995e41842c36a54b2",14092396,1,0,1,31,10,10,0
"0680571d4698477995e41842c36a54b2","9112f2bffece48e08c6d2287be204085",14092396,1,1,0,32,10,11,1
"9112f2bffece48e08c6d2287be204085","9112f2bffece48e08c6d2287be204085",14092396,1,0,1,33,11,11,0
"9112f2bffece48e08c6d2287be204085","56586aa865414f538729c7f7735d2bc6",14092396,1,3,0,34,11,12,1
"56586aa865414f538729c7f7735d2bc6","e2911e79efc2420eac45d9f671463d4b",14092396,1,-12,0,35,12,2,-10
"e2911e79efc2420eac45d9f671463d4b","56586aa865414f538729c7f7735d2bc6",14092396,1,12,0,36,2,12,10
"56586aa865414f538729c7f7735d2bc6","b7f2b31585d94eb3bf86376714aa7070",14092396,2,2,0,37,12,13,1
"b7f2b31585d94eb3bf86376714aa7070","56586aa865414f538729c7f7735d2bc6",14092396,1,-2,0,38,13,12,-1
"b7f2b31585d94eb3bf86376714aa7070","3f1c815879794b929260d224becaff7e",14092396,1,2,0,40,13,14,1
"3f1c815879794b929260d224becaff7e","56586aa865414f538729c7f7735d2bc6",14092396,1,-4,0,41,14,12,-2
"56586aa865414f538729c7f7735d2bc6","5c5ceeee4562457ba6d41515aeebfbb1",14092396,1,10,0,42,12,17,5
"5c5ceeee4562457ba6d41515aeebfbb1","9afd71a5298d4333b6849dfce1b9422c",14092396,1,3,0,43,17,18,1
"9afd71a5298d4333b6849dfce1b9422c","81c864a886d54a6b8ff85f7d736f4f95",14092396,1,-7,0,44,18,15,-3
"81c864a886d54a6b8ff85f7d736f4f95","9afd71a5298d4333b6849dfce1b9422c",14092396,1,7,0,45,15,18,3
"9afd71a5298d4333b6849dfce1b9422c","b7719e26494940efa49512aedd0aac79",14092396,1,4,0,46,18,20,2
"b7719e26494940efa49512aedd0aac79","d4f45188d3c84a02ba08454e6403a818",14092396,1,5,0,47,20,24,4
"d4f45188d3c84a02ba08454e6403a818","d4c3b003e8274e429d2fa688d73fde6d",14092396,1,-2,0,48,24,22,-2
"d4c3b003e8274e429d2fa688d73fde6d","d4f45188d3c84a02ba08454e6403a818",14092396,1,2,0,49,22,24,2
"e2911e79efc2420eac45d9f671463d4b","e2911e79efc2420eac45d9f671463d4b",22880621,6,0,1,1,2,2,0
"e2911e79efc2420eac45d9f671463d4b","56586aa865414f538729c7f7735d2bc6",22880621,4,12,0,2,2,12,10
"56586aa865414f538729c7f7735d2bc6","e2911e79efc2420eac45d9f671463d4b",22880621,4,-12,0,3,12,2,-10
"e2911e79efc2420eac45d9f671463d4b","b613861cecf84ffcab01afb23f660475",22880621,1,-3,0,6,2,1,-1
"b613861cecf84ffcab01afb23f660475","b613861cecf84ffcab01afb23f660475",22880621,8,0,1,10,1,1,0
"b613861cecf84ffcab01afb23f660475","e2911e79efc2420eac45d9f671463d4b",22880621,1,3,0,15,1,2,1
"e2911e79efc2420eac45d9f671463d4b","519d1b8c59404d67b54e96c5c8a830b2",22880621,1,1,0,16,2,3,1
"519d1b8c59404d67b54e96c5c8a830b2","519d1b8c59404d67b54e96c5c8a830b2",22880621,1,0,1,17,3,3,0
"519d1b8c59404d67b54e96c5c8a830b2","e2911e79efc2420eac45d9f671463d4b",22880621,1,-1,0,18,3,2,-1
"e2911e79efc2420eac45d9f671463d4b","531db53f81f646edb0cdcfe0085b03b7",22880621,1,2,0,20,2,4,2
"531db53f81f646edb0cdcfe0085b03b7","4f5f94b2f95141e0a9d53a61da2276da",22880621,2,1,0,21,4,5,1
"4f5f94b2f95141e0a9d53a61da2276da","531db53f81f646edb0cdcfe0085b03b7",22880621,1,-1,0,22,5,4,-1
"4f5f94b2f95141e0a9d53a61da2276da","6d541c89590949f99af293c4f2333f67",22880621,1,1,0,24,5,6,1
"6d541c89590949f99af293c4f2333f67","6d541c89590949f99af293c4f2333f67",22880621,1,0,1,25,6,6,0
"6d541c89590949f99af293c4f2333f67","dd5cf0b9fe4c4f1d8f5ff8e4c04879cb",22880621,1,1,0,26,6,7,1
"dd5cf0b9fe4c4f1d8f5ff8e4c04879cb","dd5cf0b9fe4c4f1d8f5ff8e4c04879cb",22880621,1,0,1,27,7,7,0
"dd5cf0b9fe4c4f1d8f5ff8e4c04879cb","f96261861edc426abe2248be4f0a709a",22880621,1,1,0,28,7,8,1
"f96261861edc426abe2248be4f0a709a","f96261861edc426abe2248be4f0a709a",22880621,2,0,1,29,8,8,0
"f96261861edc426abe2248be4f0a709a","66b5e16f4f75454fb5b8172079f0fa83",22880621,1,1,0,31,8,9,1
"66b5e16f4f75454fb5b8172079f0fa83","66b5e16f4f75454fb5b8172079f0fa83",22880621,1,0,1,32,9,9,0
"66b5e16f4f75454fb5b8172079f0fa83","0680571d4698477995e41842c36a54b2",22880621,1,1,0,33,9,10,1
"0680571d4698477995e41842c36a54b2","0680571d4698477995e41842c36a54b2",22880621,2,0,1,34,10,10,0
"0680571d4698477995e41842c36a54b2","9112f2bffece48e08c6d2287be204085",22880621,1,1,0,36,10,11,1
"9112f2bffece48e08c6d2287be204085","9112f2bffece48e08c6d2287be204085",22880621,1,0,1,37,11,11,0
"9112f2bffece48e08c6d2287be204085","56586aa865414f538729c7f7735d2bc6",22880621,1,3,0,38,11,12,1
"56586aa865414f538729c7f7735d2bc6","56586aa865414f538729c7f7735d2bc6",22880621,2,0,1,47,12,12,0
"56586aa865414f538729c7f7735d2bc6","b7f2b31585d94eb3bf86376714aa7070",22880621,3,2,0,49,12,13,1
"b7f2b31585d94eb3bf86376714aa7070","56586aa865414f538729c7f7735d2bc6",22880621,2,-2,0,50,13,12,-1
"b7f2b31585d94eb3bf86376714aa7070","3f1c815879794b929260d224becaff7e",22880621,2,2,0,52,13,14,1
"3f1c815879794b929260d224becaff7e","81c864a886d54a6b8ff85f7d736f4f95",22880621,1,2,0,53,14,15,1
"81c864a886d54a6b8ff85f7d736f4f95","5c5ceeee4562457ba6d41515aeebfbb1",22880621,1,4,0,54,15,17,2
"5c5ceeee4562457ba6d41515aeebfbb1","5c5ceeee4562457ba6d41515aeebfbb1",22880621,1,0,1,55,17,17,0
"5c5ceeee4562457ba6d41515aeebfbb1","9afd71a5298d4333b6849dfce1b9422c",22880621,1,3,0,56,17,18,1
"9afd71a5298d4333b6849dfce1b9422c","56586aa865414f538729c7f7735d2bc6",22880621,1,-13,0,57,18,12,-6
"56586aa865414f538729c7f7735d2bc6","9afd71a5298d4333b6849dfce1b9422c",22880621,1,13,0,58,12,18,6
"9afd71a5298d4333b6849dfce1b9422c","b7719e26494940efa49512aedd0aac79",22880621,1,4,0,59,18,20,2
"b7719e26494940efa49512aedd0aac79","d4f45188d3c84a02ba08454e6403a818",22880621,1,5,0,60,20,24,4
"d4f45188d3c84a02ba08454e6403a818","d4c3b003e8274e429d2fa688d73fde6d",22880621,1,-2,0,61,24,22,-2
"d4c3b003e8274e429d2fa688d73fde6d","d4c3b003e8274e429d2fa688d73fde6d",22880621,1,0,1,62,22,22,0
"d4c3b003e8274e429d2fa688d73fde6d","5bc03c8f16354d04bd51f5bb93559ad3",22880621,1,4,0,63,22,26,4
"5bc03c8f16354d04bd51f5bb93559ad3","b7719e26494940efa49512aedd0aac79",22880621,1,-7,0,64,26,20,-6
"b7719e26494940efa49512aedd0aac79","b7719e26494940efa49512aedd0aac79",22880621,1,0,1,65,20,20,0
"b7719e26494940efa49512aedd0aac79","afbf7250b99d47bea07172749483ca97",22880621,1,12,0,66,20,28,8
"afbf7250b99d47bea07172749483ca97","afbf7250b99d47bea07172749483ca97",22880621,1,0,1,67,28,28,0
"afbf7250b99d47bea07172749483ca97","4e51676dc72045d99c19b9fa7b22f8bc",22880621,1,3,0,68,28,29,1
"4e51676dc72045d99c19b9fa7b22f8bc","4e51676dc72045d99c19b9fa7b22f8bc",22880621,2,0,1,69,29,29,0
"4e51676dc72045d99c19b9fa7b22f8bc","51970cfa30e643e894e66ae85c8024cc",22880621,1,3,0,70,29,31,2
"51970cfa30e643e894e66ae85c8024cc","4e51676dc72045d99c19b9fa7b22f8bc",22880621,1,-3,0,71,31,29,-2
"4e51676dc72045d99c19b9fa7b22f8bc","c33c17be71ae4d588da7369472e5bb1b",22880621,2,9,0,73,29,34,5
"93679be414554a11b1893002f2229a93","93679be414554a11b1893002f2229a93",22880621,1,0,1,76,35,35,0
"9a0dc646f934470daf08c4b56ccf73db","7040a13096d746ac84b8fac8d9752058",22880621,1,-3,0,79,37,36,-1
"7040a13096d746ac84b8fac8d9752058","fc0e049d56024bc9a02c9a9c435c3df7",22880621,1,6,0,80,36,38,2
"fc0e049d56024bc9a02c9a9c435c3df7","9a0dc646f934470daf08c4b56ccf73db",22880621,1,-3,0,81,38,37,-1
"b534b89233134e30a9b5645138bfa9ee","0c7262dff33c4087bc660ccf40f92f9c",22880621,1,165,0,87,41,169,128
"b2275c3fad834f8d90737a2d9a6927d6","b7f2b31585d94eb3bf86376714aa7070",22880621,1,-227,0,89,172,13,-159
"b7f2b31585d94eb3bf86376714aa7070","b7f2b31585d94eb3bf86376714aa7070",22880621,2,0,1,92,13,13,0
"3f1c815879794b929260d224becaff7e","b613861cecf84ffcab01afb23f660475",22880621,1,-19,0,95,14,1,-13
"b613861cecf84ffcab01afb23f660475","4e51676dc72045d99c19b9fa7b22f8bc",22880621,1,47,0,96,1,29,28
"4e51676dc72045d99c19b9fa7b22f8bc","c9c52446b6294aa5a9c2abaed536c37e",22880621,1,5,0,97,29,32,3
"c9c52446b6294aa5a9c2abaed536c37e","4e51676dc72045d99c19b9fa7b22f8bc",22880621,1,-5,0,98,32,29,-3
"c33c17be71ae4d588da7369472e5bb1b","c33c17be71ae4d588da7369472e5bb1b",22880621,2,0,1,100,34,34,0
"c33c17be71ae4d588da7369472e5bb1b","93679be414554a11b1893002f2229a93",22880621,2,3,0,101,34,35,1
"93679be414554a11b1893002f2229a93","7040a13096d746ac84b8fac8d9752058",22880621,3,3,0,102,35,36,1
"7040a13096d746ac84b8fac8d9752058","93679be414554a11b1893002f2229a93",22880621,1,-3,0,103,36,35,-1
"7040a13096d746ac84b8fac8d9752058","9a0dc646f934470daf08c4b56ccf73db",22880621,2,3,0,105,36,37,1
"9a0dc646f934470daf08c4b56ccf73db","9a0dc646f934470daf08c4b56ccf73db",22880621,1,0,1,106,37,37,0
"9a0dc646f934470daf08c4b56ccf73db","fc0e049d56024bc9a02c9a9c435c3df7",22880621,2,3,0,107,37,38,1
"fc0e049d56024bc9a02c9a9c435c3df7","fc0e049d56024bc9a02c9a9c435c3df7",22880621,1,0,1,108,38,38,0
"fc0e049d56024bc9a02c9a9c435c3df7","67a089198fcb4e1c8f2385786c2b296f",22880621,3,4,0,109,38,39,1
"67a089198fcb4e1c8f2385786c2b296f","fc0e049d56024bc9a02c9a9c435c3df7",22880621,1,-4,0,110,39,38,-1
"67a089198fcb4e1c8f2385786c2b296f","64d48c6c9c7940639a932219a6c87198",22880621,2,1,0,112,39,40,1
"64d48c6c9c7940639a932219a6c87198","64d48c6c9c7940639a932219a6c87198",22880621,1,0,1,113,40,40,0
"64d48c6c9c7940639a932219a6c87198","67a089198fcb4e1c8f2385786c2b296f",22880621,2,-1,0,114,40,39,-1
"67a089198fcb4e1c8f2385786c2b296f","b534b89233134e30a9b5645138bfa9ee",22880621,2,4,0,115,39,41,2
"b534b89233134e30a9b5645138bfa9ee","0e37b720d23b4e7f8b313e79313fd107",22880621,1,3,0,116,41,44,3
"0e37b720d23b4e7f8b313e79313fd107","0e37b720d23b4e7f8b313e79313fd107",22880621,4,0,1,117,44,44,0
"0e37b720d23b4e7f8b313e79313fd107","6875d67fdd5f48168b62719df449bebd",22880621,1,1,0,121,44,45,1
"6875d67fdd5f48168b62719df449bebd","6875d67fdd5f48168b62719df449bebd",22880621,1,0,1,122,45,45,0
"6875d67fdd5f48168b62719df449bebd","b534b89233134e30a9b5645138bfa9ee",22880621,1,-4,0,123,45,41,-4
"b534b89233134e30a9b5645138bfa9ee","6e13d61a7bdb44bca949c9f86fab3be5",22880621,2,7,0,124,41,47,6
"6e13d61a7bdb44bca949c9f86fab3be5","6e13d61a7bdb44bca949c9f86fab3be5",22880621,1,0,1,125,47,47,0
"6e13d61a7bdb44bca949c9f86fab3be5","195f78799f984cc2b06c48dfe36be751",22880621,1,2,0,126,47,49,2
"195f78799f984cc2b06c48dfe36be751","195f78799f984cc2b06c48dfe36be751",22880621,2,0,1,127,49,49,0
"195f78799f984cc2b06c48dfe36be751","d0c74f735e024943943e40333d6d337f",22880621,1,3,0,129,49,51,2
"d0c74f735e024943943e40333d6d337f","d9c8d8c444a64dadbbb508652c721e17",22880621,2,-6,0,130,51,46,-5
"d9c8d8c444a64dadbbb508652c721e17","d0c74f735e024943943e40333d6d337f",22880621,2,6,0,131,46,51,5
"d0c74f735e024943943e40333d6d337f","d0c74f735e024943943e40333d6d337f",22880621,1,0,1,132,51,51,0
"d0c74f735e024943943e40333d6d337f","983f8ff320594b279a7f4a6fe132f9c5",22880621,1,2,0,133,51,53,2
"983f8ff320594b279a7f4a6fe132f9c5","983f8ff320594b279a7f4a6fe132f9c5",22880621,2,0,1,134,53,53,0
"983f8ff320594b279a7f4a6fe132f9c5","35adfa5d923046aebabfefd98f35ff05",22880621,1,1,0,136,53,54,1
"35adfa5d923046aebabfefd98f35ff05","35adfa5d923046aebabfefd98f35ff05",22880621,8,0,1,137,54,54,0
"35adfa5d923046aebabfefd98f35ff05","b6f8a98476224da1b40e555ececc7ed8",22880621,1,1,0,145,54,55,1
"b6f8a98476224da1b40e555ececc7ed8","b6f8a98476224da1b40e555ececc7ed8",22880621,6,0,1,146,55,55,0
"b6f8a98476224da1b40e555ececc7ed8","86e22cb5fe0e4b47a9489ecddf7ed78f",22880621,1,1,0,152,55,56,1
"86e22cb5fe0e4b47a9489ecddf7ed78f","86e22cb5fe0e4b47a9489ecddf7ed78f",22880621,2,0,1,153,56,56,0
"86e22cb5fe0e4b47a9489ecddf7ed78f","f924752d8a1149668870b1e7698486f7",22880621,1,-6,0,155,56,50,-6
"f924752d8a1149668870b1e7698486f7","78f30e4dcac84e3cbea8b2cc6e0d62b3",22880621,1,10,0,156,50,59,9
"78f30e4dcac84e3cbea8b2cc6e0d62b3","a1f2f12debe5432fb7a70bcd12bacfb9",22880621,3,-1,0,157,59,58,-1
"a1f2f12debe5432fb7a70bcd12bacfb9","b534b89233134e30a9b5645138bfa9ee",22880621,2,-20,0,158,58,41,-17
"6e13d61a7bdb44bca949c9f86fab3be5","b534b89233134e30a9b5645138bfa9ee",22880621,1,-7,0,160,47,41,-6
"b534b89233134e30a9b5645138bfa9ee","d0c74f735e024943943e40333d6d337f",22880621,1,12,0,161,41,51,10
"d0c74f735e024943943e40333d6d337f","0c7262dff33c4087bc660ccf40f92f9c",22880621,1,153,0,164,51,169,118
"0c7262dff33c4087bc660ccf40f92f9c","67a089198fcb4e1c8f2385786c2b296f",22880621,1,-169,0,165,169,39,-130
"67a089198fcb4e1c8f2385786c2b296f","b2275c3fad834f8d90737a2d9a6927d6",22880621,1,172,0,166,39,172,133
"b2275c3fad834f8d90737a2d9a6927d6","b534b89233134e30a9b5645138bfa9ee",22880621,1,-168,0,167,172,41,-131
"b534b89233134e30a9b5645138bfa9ee","12aa6e1672ac4e7aa6449a7a8609cd72",22880621,1,19,0,168,41,57,16
"12aa6e1672ac4e7aa6449a7a8609cd72","a1f2f12debe5432fb7a70bcd12bacfb9",22880621,1,1,0,169,57,58,1
"a1f2f12debe5432fb7a70bcd12bacfb9","78f30e4dcac84e3cbea8b2cc6e0d62b3",22880621,2,1,0,170,58,59,1
"b534b89233134e30a9b5645138bfa9ee","78f30e4dcac84e3cbea8b2cc6e0d62b3",22880621,1,21,0,173,41,59,18
"a1f2f12debe5432fb7a70bcd12bacfb9","a1f2f12debe5432fb7a70bcd12bacfb9",22880621,26,0,1,175,58,58,0
"78f30e4dcac84e3cbea8b2cc6e0d62b3","78f30e4dcac84e3cbea8b2cc6e0d62b3",22880621,7,0,1,202,59,59,0
"78f30e4dcac84e3cbea8b2cc6e0d62b3","a0a418b8540d479fa6e0f653b701da8b",22880621,1,6,0,209,59,64,5
"a0a418b8540d479fa6e0f653b701da8b","12aa6e1672ac4e7aa6449a7a8609cd72",22880621,1,-8,0,210,64,57,-7
"12aa6e1672ac4e7aa6449a7a8609cd72","bc42d26810654ea9a1df1efe1e58c7d5",22880621,1,7,0,211,57,63,6
"bc42d26810654ea9a1df1efe1e58c7d5","4c943503763e4e349906eea3ed3c8e86",22880621,1,-2,0,212,63,61,-2
"4c943503763e4e349906eea3ed3c8e86","4c943503763e4e349906eea3ed3c8e86",22880621,1,0,1,213,61,61,0
"4c943503763e4e349906eea3ed3c8e86","a0a418b8540d479fa6e0f653b701da8b",22880621,1,3,0,214,61,64,3
"a0a418b8540d479fa6e0f653b701da8b","a0a418b8540d479fa6e0f653b701da8b",22880621,3,0,1,215,64,64,0
"a0a418b8540d479fa6e0f653b701da8b","309ccf3cc4fe429d9bfbaef53d3fa479",22880621,1,-4,0,218,64,60,-4
"309ccf3cc4fe429d9bfbaef53d3fa479","b534b89233134e30a9b5645138bfa9ee",22880621,1,-23,0,219,60,41,-19
"b534b89233134e30a9b5645138bfa9ee","d646286c8051419bbc2e31dd1db55ca8",22880621,1,33,0,220,41,67,26
"d646286c8051419bbc2e31dd1db55ca8","267f883678b24aed855fde42524975d9",22880621,1,4,0,221,67,71,4
"267f883678b24aed855fde42524975d9","267f883678b24aed855fde42524975d9",22880621,1,0,1,222,71,71,0
"267f883678b24aed855fde42524975d9","88fff56d0342490dbef9040750a20f6c",22880621,1,1,0,223,71,72,1
"88fff56d0342490dbef9040750a20f6c","88fff56d0342490dbef9040750a20f6c",22880621,1,0,1,224,72,72,0
"88fff56d0342490dbef9040750a20f6c","adb17b12b66c4a49a85fd34322f7df70",22880621,1,1,0,225,72,73,1
"adb17b12b66c4a49a85fd34322f7df70","adb17b12b66c4a49a85fd34322f7df70",22880621,1,0,1,226,73,73,0
"adb17b12b66c4a49a85fd34322f7df70","d646286c8051419bbc2e31dd1db55ca8",22880621,1,-6,0,227,73,67,-6
"d646286c8051419bbc2e31dd1db55ca8","a2becd407db34b189200a32546d9d569",22880621,3,9,0,228,67,75,8
"a2becd407db34b189200a32546d9d569","a2becd407db34b189200a32546d9d569",22880621,2,0,1,229,75,75,0
"a2becd407db34b189200a32546d9d569","0c7262dff33c4087bc660ccf40f92f9c",22880621,1,123,0,230,75,169,94
"0c7262dff33c4087bc660ccf40f92f9c","b2275c3fad834f8d90737a2d9a6927d6",22880621,3,3,0,231,169,172,3
"b2275c3fad834f8d90737a2d9a6927d6","d646286c8051419bbc2e31dd1db55ca8",22880621,1,-135,0,232,172,67,-105
"d646286c8051419bbc2e31dd1db55ca8","d646286c8051419bbc2e31dd1db55ca8",22880621,3,0,1,233,67,67,0
"a2becd407db34b189200a32546d9d569","58c22b011d0f4c2ea6d13615edbb9eeb",22880621,1,2,0,237,75,77,2
"58c22b011d0f4c2ea6d13615edbb9eeb","58c22b011d0f4c2ea6d13615edbb9eeb",22880621,5,0,1,238,77,77,0
"58c22b011d0f4c2ea6d13615edbb9eeb","dd76e1861dc9461c830888729d091ee0",22880621,1,1,0,243,77,78,1
"dd76e1861dc9461c830888729d091ee0","dd76e1861dc9461c830888729d091ee0",22880621,2,0,1,244,78,78,0
"dd76e1861dc9461c830888729d091ee0","0c7262dff33c4087bc660ccf40f92f9c",22880621,1,120,0,246,78,169,91
"b2275c3fad834f8d90737a2d9a6927d6","140d5b27b8574befad82c0a013b59dfa",22880621,1,-127,0,248,172,74,-98
"140d5b27b8574befad82c0a013b59dfa","d646286c8051419bbc2e31dd1db55ca8",22880621,1,-8,0,249,74,67,-7
"a2becd407db34b189200a32546d9d569","cd1d828f1a694b87913a7ea66c23803e",22880621,1,4,0,252,75,79,4
"cd1d828f1a694b87913a7ea66c23803e","cd1d828f1a694b87913a7ea66c23803e",22880621,2,0,1,253,79,79,0
"cd1d828f1a694b87913a7ea66c23803e","9176a3c2b4d2465fa8b0c67096c2a97e",22880621,1,1,0,255,79,80,1
"9176a3c2b4d2465fa8b0c67096c2a97e","9176a3c2b4d2465fa8b0c67096c2a97e",22880621,5,0,1,256,80,80,0
"9176a3c2b4d2465fa8b0c67096c2a97e","f8ec6445f7194e25b9101d4fbcb07a18",22880621,1,1,0,261,80,81,1
"f8ec6445f7194e25b9101d4fbcb07a18","f8ec6445f7194e25b9101d4fbcb07a18",22880621,2,0,1,262,81,81,0
"f8ec6445f7194e25b9101d4fbcb07a18","140d5b27b8574befad82c0a013b59dfa",22880621,1,-7,0,264,81,74,-7
"140d5b27b8574befad82c0a013b59dfa","fab84b4fab5940efb4ea868ef8d09396",22880621,1,277,0,265,74,284,210
"fab84b4fab5940efb4ea868ef8d09396","0c7262dff33c4087bc660ccf40f92f9c",22880621,2,-153,0,266,284,169,-115
"0c7262dff33c4087bc660ccf40f92f9c","ae5ac430ea254e708a6f5deaaf7464ae",22880621,1,-112,0,267,169,84,-85
"ae5ac430ea254e708a6f5deaaf7464ae","d646286c8051419bbc2e31dd1db55ca8",22880621,1,-20,0,268,84,67,-17
"d646286c8051419bbc2e31dd1db55ca8","f564483cbd7a407681aa2fcca518cf5f",22880621,1,21,0,269,67,85,18
"f564483cbd7a407681aa2fcca518cf5f","f564483cbd7a407681aa2fcca518cf5f",22880621,9,0,1,270,85,85,0
"f564483cbd7a407681aa2fcca518cf5f","18fd01350bd5434ca636d59a599d768a",22880621,2,1,0,279,85,86,1
"18fd01350bd5434ca636d59a599d768a","18fd01350bd5434ca636d59a599d768a",22880621,5,0,1,280,86,86,0
"18fd01350bd5434ca636d59a599d768a","f564483cbd7a407681aa2fcca518cf5f",22880621,1,-1,0,285,86,85,-1
"18fd01350bd5434ca636d59a599d768a","ae5ac430ea254e708a6f5deaaf7464ae",22880621,1,-2,0,287,86,84,-2
"ae5ac430ea254e708a6f5deaaf7464ae","6a9f0ef185fb47f0937e29daa1c71ed5",22880621,1,7,0,288,84,90,6
"6a9f0ef185fb47f0937e29daa1c71ed5","c681290961c94c4caf23b529d1ae6b9a",22880621,1,-2,0,289,90,88,-2
"c681290961c94c4caf23b529d1ae6b9a","c681290961c94c4caf23b529d1ae6b9a",22880621,1,0,1,290,88,88,0
"c681290961c94c4caf23b529d1ae6b9a","6a9f0ef185fb47f0937e29daa1c71ed5",22880621,1,2,0,291,88,90,2
"6a9f0ef185fb47f0937e29daa1c71ed5","6a9f0ef185fb47f0937e29daa1c71ed5",22880621,3,0,1,292,90,90,0
"6a9f0ef185fb47f0937e29daa1c71ed5","e20db35ced8544ddac5bc3839145e463",22880621,1,3,0,295,90,91,1
"e20db35ced8544ddac5bc3839145e463","d646286c8051419bbc2e31dd1db55ca8",22880621,1,-30,0,296,91,67,-24
"d646286c8051419bbc2e31dd1db55ca8","e20db35ced8544ddac5bc3839145e463",22880621,1,30,0,297,67,91,24
"e20db35ced8544ddac5bc3839145e463","1febb706d7a34005ae8711ed49c76e64",22880621,1,3,0,298,91,94,3
"1febb706d7a34005ae8711ed49c76e64","1febb706d7a34005ae8711ed49c76e64",22880621,2,0,1,299,94,94,0
"1febb706d7a34005ae8711ed49c76e64","8f73ba6f5a0042f2850356ac38ac6f24",22880621,1,1,0,301,94,95,1
"8f73ba6f5a0042f2850356ac38ac6f24","8f73ba6f5a0042f2850356ac38ac6f24",22880621,5,0,1,302,95,95,0
"8f73ba6f5a0042f2850356ac38ac6f24","fab84b4fab5940efb4ea868ef8d09396",22880621,1,251,0,307,95,284,189
"0c7262dff33c4087bc660ccf40f92f9c","0c7262dff33c4087bc660ccf40f92f9c",22880621,1,0,1,309,169,169,0
"0c7262dff33c4087bc660ccf40f92f9c","e20db35ced8544ddac5bc3839145e463",22880621,1,-102,0,310,169,91,-78
"e20db35ced8544ddac5bc3839145e463","e20db35ced8544ddac5bc3839145e463",22880621,5,0,1,311,91,91,0
"e20db35ced8544ddac5bc3839145e463","e2260b86653c46d7b14a41fb419dbf8c",22880621,1,5,0,312,91,96,5
"e2260b86653c46d7b14a41fb419dbf8c","e2260b86653c46d7b14a41fb419dbf8c",22880621,2,0,1,313,96,96,0
"e2260b86653c46d7b14a41fb419dbf8c","35eb641ad1d845bbba54915bce75a962",22880621,1,1,0,315,96,97,1
"35eb641ad1d845bbba54915bce75a962","35eb641ad1d845bbba54915bce75a962",22880621,2,0,1,316,97,97,0
"35eb641ad1d845bbba54915bce75a962","08be90ffbeea4795a138cd42ed8db56f",22880621,1,1,0,318,97,98,1
"08be90ffbeea4795a138cd42ed8db56f","08be90ffbeea4795a138cd42ed8db56f",22880621,2,0,1,319,98,98,0
"08be90ffbeea4795a138cd42ed8db56f","3007433c8f584dcbb5ac159c1c5f2be3",22880621,1,1,0,321,98,99,1
"3007433c8f584dcbb5ac159c1c5f2be3","3007433c8f584dcbb5ac159c1c5f2be3",22880621,2,0,1,322,99,99,0
"3007433c8f584dcbb5ac159c1c5f2be3","e20db35ced8544ddac5bc3839145e463",22880621,1,-8,0,324,99,91,-8
"e20db35ced8544ddac5bc3839145e463","d391c8b6e56a43a7b654e9dee02d904b",22880621,2,13,0,325,91,103,12
"d391c8b6e56a43a7b654e9dee02d904b","00ae5f0c51874a73a41ebea838d95682",22880621,2,-2,0,326,103,101,-2
"00ae5f0c51874a73a41ebea838d95682","e20db35ced8544ddac5bc3839145e463",22880621,1,-11,0,327,101,91,-10
"00ae5f0c51874a73a41ebea838d95682","d391c8b6e56a43a7b654e9dee02d904b",22880621,1,2,0,334,101,103,2
"d391c8b6e56a43a7b654e9dee02d904b","d391c8b6e56a43a7b654e9dee02d904b",22880621,27,0,1,335,103,103,0
"d391c8b6e56a43a7b654e9dee02d904b","6111116566fc4fd9abba409322bea245",22880621,1,1,0,362,103,104,1
"6111116566fc4fd9abba409322bea245","6111116566fc4fd9abba409322bea245",22880621,5,0,1,363,104,104,0
"6111116566fc4fd9abba409322bea245","a81b2235cb9c499eb9ea8ee0a8dd9725",22880621,1,1,0,368,104,105,1
"a81b2235cb9c499eb9ea8ee0a8dd9725","a81b2235cb9c499eb9ea8ee0a8dd9725",22880621,2,0,1,369,105,105,0
"a81b2235cb9c499eb9ea8ee0a8dd9725","2d4e0ab0ef3b4d73b82c72d4621a7579",22880621,1,1,0,371,105,106,1
"2d4e0ab0ef3b4d73b82c72d4621a7579","2d4e0ab0ef3b4d73b82c72d4621a7579",22880621,11,0,1,372,106,106,0
"2d4e0ab0ef3b4d73b82c72d4621a7579","8bdebf492ebd4e62b0d522e8ab5e5197",22880621,1,1,0,383,106,107,1
"8bdebf492ebd4e62b0d522e8ab5e5197","8bdebf492ebd4e62b0d522e8ab5e5197",22880621,2,0,1,384,107,107,0
"8bdebf492ebd4e62b0d522e8ab5e5197","4280927ec4d643238aa49c32f9e06c6c",22880621,1,3,0,386,107,109,2
"4280927ec4d643238aa49c32f9e06c6c","73039f8c1eb9409cb4caee2cf968001e",22880621,1,-10,0,387,109,100,-9
"73039f8c1eb9409cb4caee2cf968001e","fc44e6a5f7654430af1227838224dceb",22880621,1,12,0,388,100,111,11
"fc44e6a5f7654430af1227838224dceb","fc44e6a5f7654430af1227838224dceb",22880621,2,0,1,389,111,111,0
"fc44e6a5f7654430af1227838224dceb","a9ae0a3c070d455bb4369a8996313336",22880621,1,4,0,391,111,114,3
"a9ae0a3c070d455bb4369a8996313336","08111f75e22d409998cf8b85bd431f0a",22880621,1,-7,0,392,114,108,-6
"08111f75e22d409998cf8b85bd431f0a","71cec822bcff4f30a20e75dc63ef7b65",22880621,1,9,0,393,108,116,8
"71cec822bcff4f30a20e75dc63ef7b65","71cec822bcff4f30a20e75dc63ef7b65",22880621,3,0,1,394,116,116,0
"b613861cecf84ffcab01afb23f660475","b613861cecf84ffcab01afb23f660475",15044247,4,0,1,1,1,1,0
"b613861cecf84ffcab01afb23f660475","e2911e79efc2420eac45d9f671463d4b",15044247,1,3,0,5,1,2,1
"e2911e79efc2420eac45d9f671463d4b","e2911e79efc2420eac45d9f671463d4b",15044247,1,0,1,6,2,2,0
"519d1b8c59404d67b54e96c5c8a830b2","e2911e79efc2420eac45d9f671463d4b",15044247,1,-1,0,9,3,2,-1
"e2911e79efc2420eac45d9f671463d4b","519d1b8c59404d67b54e96c5c8a830b2",15044247,2,1,0,10,2,3,1
"519d1b8c59404d67b54e96c5c8a830b2","519d1b8c59404d67b54e96c5c8a830b2",15044247,2,0,1,11,3,3,0
"519d1b8c59404d67b54e96c5c8a830b2","531db53f81f646edb0cdcfe0085b03b7",15044247,1,1,0,12,3,4,1
"531db53f81f646edb0cdcfe0085b03b7","531db53f81f646edb0cdcfe0085b03b7",15044247,1,0,1,13,4,4,0
"531db53f81f646edb0cdcfe0085b03b7","4f5f94b2f95141e0a9d53a61da2276da",15044247,1,1,0,14,4,5,1
"4f5f94b2f95141e0a9d53a61da2276da","4f5f94b2f95141e0a9d53a61da2276da",15044247,1,0,1,15,5,5,0
"4f5f94b2f95141e0a9d53a61da2276da","6d541c89590949f99af293c4f2333f67",15044247,1,1,0,16,5,6,1
"6d541c89590949f99af293c4f2333f67","6d541c89590949f99af293c4f2333f67",15044247,1,0,1,17,6,6,0
"6d541c89590949f99af293c4f2333f67","dd5cf0b9fe4c4f1d8f5ff8e4c04879cb",15044247,1,1,0,18,6,7,1
"dd5cf0b9fe4c4f1d8f5ff8e4c04879cb","dd5cf0b9fe4c4f1d8f5ff8e4c04879cb",15044247,1,0,1,19,7,7,0
"dd5cf0b9fe4c4f1d8f5ff8e4c04879cb","f96261861edc426abe2248be4f0a709a",15044247,1,1,0,20,7,8,1
"f96261861edc426abe2248be4f0a709a","f96261861edc426abe2248be4f0a709a",15044247,1,0,1,21,8,8,0
"f96261861edc426abe2248be4f0a709a","66b5e16f4f75454fb5b8172079f0fa83",15044247,1,1,0,22,8,9,1
"66b5e16f4f75454fb5b8172079f0fa83","66b5e16f4f75454fb5b8172079f0fa83",15044247,1,0,1,23,9,9,0
"66b5e16f4f75454fb5b8172079f0fa83","0680571d4698477995e41842c36a54b2",15044247,1,1,0,24,9,10,1
"0680571d4698477995e41842c36a54b2","0680571d4698477995e41842c36a54b2",15044247,1,0,1,25,10,10,0
"0680571d4698477995e41842c36a54b2","9112f2bffece48e08c6d2287be204085",15044247,1,1,0,26,10,11,1
"9112f2bffece48e08c6d2287be204085","9112f2bffece48e08c6d2287be204085",15044247,1,0,1,27,11,11,0
"9112f2bffece48e08c6d2287be204085","e2911e79efc2420eac45d9f671463d4b",15044247,1,-9,0,28,11,2,-9
"e2911e79efc2420eac45d9f671463d4b","56586aa865414f538729c7f7735d2bc6",15044247,1,12,0,29,2,12,10
"56586aa865414f538729c7f7735d2bc6","56586aa865414f538729c7f7735d2bc6",15044247,3,0,1,30,12,12,0
"56586aa865414f538729c7f7735d2bc6","b7f2b31585d94eb3bf86376714aa7070",15044247,1,2,0,33,12,13,1
"b7f2b31585d94eb3bf86376714aa7070","b7f2b31585d94eb3bf86376714aa7070",15044247,2,0,1,34,13,13,0
"b7f2b31585d94eb3bf86376714aa7070","3f1c815879794b929260d224becaff7e",15044247,1,2,0,36,13,14,1
"3f1c815879794b929260d224becaff7e","81c864a886d54a6b8ff85f7d736f4f95",15044247,1,2,0,37,14,15,1
"81c864a886d54a6b8ff85f7d736f4f95","5c5ceeee4562457ba6d41515aeebfbb1",15044247,1,4,0,38,15,17,2
"5c5ceeee4562457ba6d41515aeebfbb1","5c5ceeee4562457ba6d41515aeebfbb1",15044247,1,0,1,39,17,17,0
"5c5ceeee4562457ba6d41515aeebfbb1","9afd71a5298d4333b6849dfce1b9422c",15044247,1,3,0,40,17,18,1
"9afd71a5298d4333b6849dfce1b9422c","56586aa865414f538729c7f7735d2bc6",15044247,1,-13,0,41,18,12,-6
"56586aa865414f538729c7f7735d2bc6","9afd71a5298d4333b6849dfce1b9422c",15044247,1,13,0,42,12,18,6
"9afd71a5298d4333b6849dfce1b9422c","b7719e26494940efa49512aedd0aac79",15044247,1,4,0,43,18,20,2
"b7719e26494940efa49512aedd0aac79","d4f45188d3c84a02ba08454e6403a818",15044247,1,5,0,44,20,24,4
"d4f45188d3c84a02ba08454e6403a818","d4c3b003e8274e429d2fa688d73fde6d",15044247,1,-2,0,45,24,22,-2
"d4c3b003e8274e429d2fa688d73fde6d","b7719e26494940efa49512aedd0aac79",15044247,1,-3,0,46,22,20,-2
"b7719e26494940efa49512aedd0aac79","b7719e26494940efa49512aedd0aac79",15044247,1,0,1,47,20,20,0
"b7719e26494940efa49512aedd0aac79","afbf7250b99d47bea07172749483ca97",15044247,1,12,0,48,20,28,8
"afbf7250b99d47bea07172749483ca97","afbf7250b99d47bea07172749483ca97",15044247,2,0,1,49,28,28,0
"afbf7250b99d47bea07172749483ca97","4e51676dc72045d99c19b9fa7b22f8bc",15044247,1,3,0,51,28,29,1
"4e51676dc72045d99c19b9fa7b22f8bc","4e51676dc72045d99c19b9fa7b22f8bc",15044247,1,0,1,52,29,29,0
"4e51676dc72045d99c19b9fa7b22f8bc","51970cfa30e643e894e66ae85c8024cc",15044247,2,3,0,53,29,31,2
"51970cfa30e643e894e66ae85c8024cc","4e51676dc72045d99c19b9fa7b22f8bc",15044247,2,-3,0,54,31,29,-2
"4e51676dc72045d99c19b9fa7b22f8bc","c33c17be71ae4d588da7369472e5bb1b",15044247,1,9,0,57,29,34,5
"c33c17be71ae4d588da7369472e5bb1b","93679be414554a11b1893002f2229a93",15044247,2,3,0,58,34,35,1
"93679be414554a11b1893002f2229a93","c33c17be71ae4d588da7369472e5bb1b",15044247,1,-3,0,59,35,34,-1
"93679be414554a11b1893002f2229a93","7040a13096d746ac84b8fac8d9752058",15044247,1,3,0,61,35,36,1
"7040a13096d746ac84b8fac8d9752058","7040a13096d746ac84b8fac8d9752058",15044247,1,0,1,62,36,36,0
"7040a13096d746ac84b8fac8d9752058","9a0dc646f934470daf08c4b56ccf73db",15044247,1,3,0,63,36,37,1
"9a0dc646f934470daf08c4b56ccf73db","fc0e049d56024bc9a02c9a9c435c3df7",15044247,1,3,0,64,37,38,1
"fc0e049d56024bc9a02c9a9c435c3df7","9a0dc646f934470daf08c4b56ccf73db",15044247,1,-3,0,65,38,37,-1
"b613861cecf84ffcab01afb23f660475","b613861cecf84ffcab01afb23f660475",22884842,4,0,1,1,1,1,0
"b613861cecf84ffcab01afb23f660475","e2911e79efc2420eac45d9f671463d4b",22884842,1,3,0,5,1,2,1
"e2911e79efc2420eac45d9f671463d4b","e2911e79efc2420eac45d9f671463d4b",22884842,2,0,1,6,2,2,0
"e2911e79efc2420eac45d9f671463d4b","519d1b8c59404d67b54e96c5c8a830b2",22884842,1,1,0,8,2,3,1
"519d1b8c59404d67b54e96c5c8a830b2","519d1b8c59404d67b54e96c5c8a830b2",22884842,1,0,1,9,3,3,0
"519d1b8c59404d67b54e96c5c8a830b2","531db53f81f646edb0cdcfe0085b03b7",22884842,1,1,0,10,3,4,1
"531db53f81f646edb0cdcfe0085b03b7","531db53f81f646edb0cdcfe0085b03b7",22884842,1,0,1,11,4,4,0
"531db53f81f646edb0cdcfe0085b03b7","4f5f94b2f95141e0a9d53a61da2276da",22884842,1,1,0,12,4,5,1
"4f5f94b2f95141e0a9d53a61da2276da","4f5f94b2f95141e0a9d53a61da2276da",22884842,1,0,1,13,5,5,0
"4f5f94b2f95141e0a9d53a61da2276da","6d541c89590949f99af293c4f2333f67",22884842,1,1,0,14,5,6,1
"6d541c89590949f99af293c4f2333f67","6d541c89590949f99af293c4f2333f67",22884842,1,0,1,15,6,6,0
"6d541c89590949f99af293c4f2333f67","dd5cf0b9fe4c4f1d8f5ff8e4c04879cb",22884842,1,1,0,16,6,7,1
"dd5cf0b9fe4c4f1d8f5ff8e4c04879cb","dd5cf0b9fe4c4f1d8f5ff8e4c04879cb",22884842,1,0,1,17,7,7,0
"dd5cf0b9fe4c4f1d8f5ff8e4c04879cb","f96261861edc426abe2248be4f0a709a",22884842,1,1,0,18,7,8,1
"f96261861edc426abe2248be4f0a709a","f96261861edc426abe2248be4f0a709a",22884842,1,0,1,19,8,8,0
"f96261861edc426abe2248be4f0a709a","66b5e16f4f75454fb5b8172079f0fa83",22884842,1,1,0,20,8,9,1
"66b5e16f4f75454fb5b8172079f0fa83","66b5e16f4f75454fb5b8172079f0fa83",22884842,1,0,1,21,9,9,0
"66b5e16f4f75454fb5b8172079f0fa83","0680571d4698477995e41842c36a54b2",22884842,1,1,0,22,9,10,1
"0680571d4698477995e41842c36a54b2","0680571d4698477995e41842c36a54b2",22884842,1,0,1,23,10,10,0
"0680571d4698477995e41842c36a54b2","9112f2bffece48e08c6d2287be204085",22884842,1,1,0,24,10,11,1
"9112f2bffece48e08c6d2287be204085","9112f2bffece48e08c6d2287be204085",22884842,1,0,1,25,11,11,0
"9112f2bffece48e08c6d2287be204085","56586aa865414f538729c7f7735d2bc6",22884842,1,3,0,26,11,12,1
"56586aa865414f538729c7f7735d2bc6","e2911e79efc2420eac45d9f671463d4b",22884842,1,-12,0,27,12,2,-10
"e2911e79efc2420eac45d9f671463d4b","56586aa865414f538729c7f7735d2bc6",22884842,1,12,0,28,2,12,10
"56586aa865414f538729c7f7735d2bc6","56586aa865414f538729c7f7735d2bc6",22884842,1,0,1,29,12,12,0
"56586aa865414f538729c7f7735d2bc6","b7f2b31585d94eb3bf86376714aa7070",22884842,2,2,0,30,12,13,1
"b7f2b31585d94eb3bf86376714aa7070","56586aa865414f538729c7f7735d2bc6",22884842,1,-2,0,31,13,12,-1
"b7f2b31585d94eb3bf86376714aa7070","b7f2b31585d94eb3bf86376714aa7070",22884842,1,0,1,33,13,13,0
"b7f2b31585d94eb3bf86376714aa7070","3f1c815879794b929260d224becaff7e",22884842,1,2,0,34,13,14,1
"3f1c815879794b929260d224becaff7e","5c5ceeee4562457ba6d41515aeebfbb1",22884842,1,6,0,35,14,17,3
"5c5ceeee4562457ba6d41515aeebfbb1","81c864a886d54a6b8ff85f7d736f4f95",22884842,1,-4,0,36,17,15,-2
"81c864a886d54a6b8ff85f7d736f4f95","5c5ceeee4562457ba6d41515aeebfbb1",22884842,1,4,0,37,15,17,2
"5c5ceeee4562457ba6d41515aeebfbb1","56586aa865414f538729c7f7735d2bc6",22884842,1,-10,0,38,17,12,-5
"56586aa865414f538729c7f7735d2bc6","9afd71a5298d4333b6849dfce1b9422c",22884842,1,13,0,39,12,18,6
"9afd71a5298d4333b6849dfce1b9422c","9afd71a5298d4333b6849dfce1b9422c",22884842,3,0,1,40,18,18,0
"9afd71a5298d4333b6849dfce1b9422c","b7719e26494940efa49512aedd0aac79",22884842,1,4,0,43,18,20,2
"b7719e26494940efa49512aedd0aac79","d4f45188d3c84a02ba08454e6403a818",22884842,1,5,0,44,20,24,4
"d4f45188d3c84a02ba08454e6403a818","d4c3b003e8274e429d2fa688d73fde6d",22884842,1,-2,0,45,24,22,-2
"d4c3b003e8274e429d2fa688d73fde6d","d4c3b003e8274e429d2fa688d73fde6d",22884842,1,0,1,46,22,22,0
"d4c3b003e8274e429d2fa688d73fde6d","b7719e26494940efa49512aedd0aac79",22884842,1,-3,0,47,22,20,-2
"b7719e26494940efa49512aedd0aac79","b7719e26494940efa49512aedd0aac79",22884842,1,0,1,48,20,20,0
"b7719e26494940efa49512aedd0aac79","afbf7250b99d47bea07172749483ca97",22884842,1,12,0,49,20,28,8
"afbf7250b99d47bea07172749483ca97","afbf7250b99d47bea07172749483ca97",22884842,1,0,1,50,28,28,0
"afbf7250b99d47bea07172749483ca97","4e51676dc72045d99c19b9fa7b22f8bc",22884842,1,3,0,51,28,29,1
"4e51676dc72045d99c19b9fa7b22f8bc","4e51676dc72045d99c19b9fa7b22f8bc",22884842,1,0,1,52,29,29,0
"4e51676dc72045d99c19b9fa7b22f8bc","51970cfa30e643e894e66ae85c8024cc",22884842,1,3,0,53,29,31,2
"51970cfa30e643e894e66ae85c8024cc","4e51676dc72045d99c19b9fa7b22f8bc",22884842,1,-3,0,54,31,29,-2
"4e51676dc72045d99c19b9fa7b22f8bc","c33c17be71ae4d588da7369472e5bb1b",22884842,1,9,0,55,29,34,5
"c33c17be71ae4d588da7369472e5bb1b","c33c17be71ae4d588da7369472e5bb1b",22884842,1,0,1,56,34,34,0
"c33c17be71ae4d588da7369472e5bb1b","93679be414554a11b1893002f2229a93",22884842,1,3,0,57,34,35,1
"93679be414554a11b1893002f2229a93","7040a13096d746ac84b8fac8d9752058",22884842,1,3,0,58,35,36,1
"7040a13096d746ac84b8fac8d9752058","93679be414554a11b1893002f2229a93",22884842,1,-3,0,59,36,35,-1
"93679be414554a11b1893002f2229a93","9a0dc646f934470daf08c4b56ccf73db",22884842,1,6,0,60,35,37,2
"9a0dc646f934470daf08c4b56ccf73db","7040a13096d746ac84b8fac8d9752058",22884842,1,-3,0,61,37,36,-1
"7040a13096d746ac84b8fac8d9752058","fc0e049d56024bc9a02c9a9c435c3df7",22884842,1,6,0,62,36,38,2
"fc0e049d56024bc9a02c9a9c435c3df7","9a0dc646f934470daf08c4b56ccf73db",22884842,1,-3,0,63,38,37,-1
"9a0dc646f934470daf08c4b56ccf73db","fc0e049d56024bc9a02c9a9c435c3df7",22884842,1,3,0,64,37,38,1
"fc0e049d56024bc9a02c9a9c435c3df7","67a089198fcb4e1c8f2385786c2b296f",22884842,1,4,0,65,38,39,1
"64d48c6c9c7940639a932219a6c87198","64d48c6c9c7940639a932219a6c87198",22884842,2,0,1,67,40,40,0
"64d48c6c9c7940639a932219a6c87198","b534b89233134e30a9b5645138bfa9ee",22884842,1,3,0,69,40,41,1
"b534b89233134e30a9b5645138bfa9ee","67a089198fcb4e1c8f2385786c2b296f",22884842,1,-4,0,70,41,39,-2
"67a089198fcb4e1c8f2385786c2b296f","0e37b720d23b4e7f8b313e79313fd107",22884842,1,7,0,71,39,44,5
"0e37b720d23b4e7f8b313e79313fd107","0e37b720d23b4e7f8b313e79313fd107",22884842,1,0,1,72,44,44,0
"0e37b720d23b4e7f8b313e79313fd107","6875d67fdd5f48168b62719df449bebd",22884842,1,1,0,73,44,45,1
"6875d67fdd5f48168b62719df449bebd","6875d67fdd5f48168b62719df449bebd",22884842,1,0,1,74,45,45,0
"6875d67fdd5f48168b62719df449bebd","b534b89233134e30a9b5645138bfa9ee",22884842,1,-4,0,75,45,41,-4
"6e13d61a7bdb44bca949c9f86fab3be5","6e13d61a7bdb44bca949c9f86fab3be5",22884842,1,0,1,77,47,47,0
"6e13d61a7bdb44bca949c9f86fab3be5","195f78799f984cc2b06c48dfe36be751",22884842,1,2,0,78,47,49,2
"195f78799f984cc2b06c48dfe36be751","195f78799f984cc2b06c48dfe36be751",22884842,2,0,1,79,49,49,0
"195f78799f984cc2b06c48dfe36be751","d0c74f735e024943943e40333d6d337f",22884842,1,3,0,81,49,51,2
"d9c8d8c444a64dadbbb508652c721e17","d0c74f735e024943943e40333d6d337f",22884842,1,6,0,83,46,51,5
"d0c74f735e024943943e40333d6d337f","983f8ff320594b279a7f4a6fe132f9c5",22884842,1,2,0,84,51,53,2
"983f8ff320594b279a7f4a6fe132f9c5","983f8ff320594b279a7f4a6fe132f9c5",22884842,5,0,1,85,53,53,0
"983f8ff320594b279a7f4a6fe132f9c5","35adfa5d923046aebabfefd98f35ff05",22884842,1,1,0,90,53,54,1
"35adfa5d923046aebabfefd98f35ff05","35adfa5d923046aebabfefd98f35ff05",22884842,2,0,1,91,54,54,0
"35adfa5d923046aebabfefd98f35ff05","b6f8a98476224da1b40e555ececc7ed8",22884842,1,1,0,93,54,55,1
"b6f8a98476224da1b40e555ececc7ed8","b6f8a98476224da1b40e555ececc7ed8",22884842,2,0,1,94,55,55,0
"b6f8a98476224da1b40e555ececc7ed8","86e22cb5fe0e4b47a9489ecddf7ed78f",22884842,1,1,0,96,55,56,1
"86e22cb5fe0e4b47a9489ecddf7ed78f","86e22cb5fe0e4b47a9489ecddf7ed78f",22884842,2,0,1,97,56,56,0
"86e22cb5fe0e4b47a9489ecddf7ed78f","78f30e4dcac84e3cbea8b2cc6e0d62b3",22884842,1,4,0,99,56,59,3
"78f30e4dcac84e3cbea8b2cc6e0d62b3","a1f2f12debe5432fb7a70bcd12bacfb9",22884842,1,-1,0,100,59,58,-1
"a1f2f12debe5432fb7a70bcd12bacfb9","f924752d8a1149668870b1e7698486f7",22884842,1,-9,0,101,58,50,-8
"f924752d8a1149668870b1e7698486f7","a1f2f12debe5432fb7a70bcd12bacfb9",22884842,2,9,0,102,50,58,8
"a1f2f12debe5432fb7a70bcd12bacfb9","a1f2f12debe5432fb7a70bcd12bacfb9",22884842,15,0,1,103,58,58,0
"a1f2f12debe5432fb7a70bcd12bacfb9","78f30e4dcac84e3cbea8b2cc6e0d62b3",22884842,2,1,0,118,58,59,1
"78f30e4dcac84e3cbea8b2cc6e0d62b3","78f30e4dcac84e3cbea8b2cc6e0d62b3",22884842,7,0,1,119,59,59,0
"78f30e4dcac84e3cbea8b2cc6e0d62b3","bc42d26810654ea9a1df1efe1e58c7d5",22884842,1,5,0,126,59,63,4
"bc42d26810654ea9a1df1efe1e58c7d5","12aa6e1672ac4e7aa6449a7a8609cd72",22884842,2,-7,0,127,63,57,-6
"12aa6e1672ac4e7aa6449a7a8609cd72","a0a418b8540d479fa6e0f653b701da8b",22884842,1,8,0,128,57,64,7
"a0a418b8540d479fa6e0f653b701da8b","4c943503763e4e349906eea3ed3c8e86",22884842,1,-3,0,129,64,61,-3
"4c943503763e4e349906eea3ed3c8e86","4c943503763e4e349906eea3ed3c8e86",22884842,1,0,1,130,61,61,0
"4c943503763e4e349906eea3ed3c8e86","bc42d26810654ea9a1df1efe1e58c7d5",22884842,1,2,0,131,61,63,2
"bc42d26810654ea9a1df1efe1e58c7d5","bc42d26810654ea9a1df1efe1e58c7d5",22884842,4,0,1,132,63,63,0
"bc42d26810654ea9a1df1efe1e58c7d5","a0a418b8540d479fa6e0f653b701da8b",22884842,2,1,0,135,63,64,1
"a0a418b8540d479fa6e0f653b701da8b","a0a418b8540d479fa6e0f653b701da8b",22884842,4,0,1,136,64,64,0
"a0a418b8540d479fa6e0f653b701da8b","309ccf3cc4fe429d9bfbaef53d3fa479",22884842,2,-4,0,139,64,60,-4
"309ccf3cc4fe429d9bfbaef53d3fa479","b534b89233134e30a9b5645138bfa9ee",22884842,1,-23,0,140,60,41,-19
"b534b89233134e30a9b5645138bfa9ee","d646286c8051419bbc2e31dd1db55ca8",22884842,2,33,0,141,41,67,26
"d646286c8051419bbc2e31dd1db55ca8","267f883678b24aed855fde42524975d9",22884842,1,4,0,142,67,71,4
"267f883678b24aed855fde42524975d9","267f883678b24aed855fde42524975d9",22884842,1,0,1,143,71,71,0
"267f883678b24aed855fde42524975d9","88fff56d0342490dbef9040750a20f6c",22884842,1,1,0,144,71,72,1
"88fff56d0342490dbef9040750a20f6c","88fff56d0342490dbef9040750a20f6c",22884842,1,0,1,145,72,72,0
"88fff56d0342490dbef9040750a20f6c","adb17b12b66c4a49a85fd34322f7df70",22884842,1,1,0,146,72,73,1
"adb17b12b66c4a49a85fd34322f7df70","adb17b12b66c4a49a85fd34322f7df70",22884842,1,0,1,147,73,73,0
"adb17b12b66c4a49a85fd34322f7df70","a2becd407db34b189200a32546d9d569",22884842,1,3,0,148,73,75,2
"a2becd407db34b189200a32546d9d569","d646286c8051419bbc2e31dd1db55ca8",22884842,1,-9,0,149,75,67,-8
"d646286c8051419bbc2e31dd1db55ca8","a2becd407db34b189200a32546d9d569",22884842,2,9,0,150,67,75,8
"a2becd407db34b189200a32546d9d569","58c22b011d0f4c2ea6d13615edbb9eeb",22884842,1,2,0,151,75,77,2
"58c22b011d0f4c2ea6d13615edbb9eeb","58c22b011d0f4c2ea6d13615edbb9eeb",22884842,2,0,1,152,77,77,0
"58c22b011d0f4c2ea6d13615edbb9eeb","dd76e1861dc9461c830888729d091ee0",22884842,1,1,0,154,77,78,1
"dd76e1861dc9461c830888729d091ee0","dd76e1861dc9461c830888729d091ee0",22884842,5,0,1,155,78,78,0
"dd76e1861dc9461c830888729d091ee0","cd1d828f1a694b87913a7ea66c23803e",22884842,1,1,0,160,78,79,1
"cd1d828f1a694b87913a7ea66c23803e","cd1d828f1a694b87913a7ea66c23803e",22884842,2,0,1,161,79,79,0
"cd1d828f1a694b87913a7ea66c23803e","9176a3c2b4d2465fa8b0c67096c2a97e",22884842,1,1,0,163,79,80,1
"9176a3c2b4d2465fa8b0c67096c2a97e","9176a3c2b4d2465fa8b0c67096c2a97e",22884842,5,0,1,164,80,80,0
"9176a3c2b4d2465fa8b0c67096c2a97e","f8ec6445f7194e25b9101d4fbcb07a18",22884842,1,1,0,169,80,81,1
"f8ec6445f7194e25b9101d4fbcb07a18","f8ec6445f7194e25b9101d4fbcb07a18",22884842,2,0,1,170,81,81,0
"f8ec6445f7194e25b9101d4fbcb07a18","140d5b27b8574befad82c0a013b59dfa",22884842,1,-7,0,172,81,74,-7
"140d5b27b8574befad82c0a013b59dfa","d18a9ea32855445f8736581f5cb119ce",22884842,2,9,0,173,74,82,8
"d18a9ea32855445f8736581f5cb119ce","f564483cbd7a407681aa2fcca518cf5f",22884842,1,4,0,174,82,85,3
"f564483cbd7a407681aa2fcca518cf5f","f564483cbd7a407681aa2fcca518cf5f",22884842,4,0,1,175,85,85,0
"f564483cbd7a407681aa2fcca518cf5f","18fd01350bd5434ca636d59a599d768a",22884842,1,1,0,179,85,86,1
"18fd01350bd5434ca636d59a599d768a","18fd01350bd5434ca636d59a599d768a",22884842,8,0,1,180,86,86,0
"18fd01350bd5434ca636d59a599d768a","ae5ac430ea254e708a6f5deaaf7464ae",22884842,1,-2,0,188,86,84,-2
"ae5ac430ea254e708a6f5deaaf7464ae","6a9f0ef185fb47f0937e29daa1c71ed5",22884842,1,7,0,189,84,90,6
"6a9f0ef185fb47f0937e29daa1c71ed5","c681290961c94c4caf23b529d1ae6b9a",22884842,1,-2,0,190,90,88,-2
"c681290961c94c4caf23b529d1ae6b9a","c681290961c94c4caf23b529d1ae6b9a",22884842,1,0,1,191,88,88,0
"c681290961c94c4caf23b529d1ae6b9a","6a9f0ef185fb47f0937e29daa1c71ed5",22884842,1,2,0,192,88,90,2
"6a9f0ef185fb47f0937e29daa1c71ed5","6a9f0ef185fb47f0937e29daa1c71ed5",22884842,5,0,1,193,90,90,0
"6a9f0ef185fb47f0937e29daa1c71ed5","e20db35ced8544ddac5bc3839145e463",22884842,1,3,0,196,90,91,1
"e20db35ced8544ddac5bc3839145e463","d646286c8051419bbc2e31dd1db55ca8",22884842,1,-30,0,197,91,67,-24
"d646286c8051419bbc2e31dd1db55ca8","00ae5f0c51874a73a41ebea838d95682",22884842,1,41,0,198,67,101,34
"00ae5f0c51874a73a41ebea838d95682","d391c8b6e56a43a7b654e9dee02d904b",22884842,3,2,0,199,101,103,2
"d391c8b6e56a43a7b654e9dee02d904b","e20db35ced8544ddac5bc3839145e463",22884842,1,-13,0,200,103,91,-12
"e20db35ced8544ddac5bc3839145e463","73039f8c1eb9409cb4caee2cf968001e",22884842,1,10,0,201,91,100,9
"73039f8c1eb9409cb4caee2cf968001e","1febb706d7a34005ae8711ed49c76e64",22884842,1,-7,0,202,100,94,-6
"1febb706d7a34005ae8711ed49c76e64","1febb706d7a34005ae8711ed49c76e64",22884842,2,0,1,203,94,94,0
"1febb706d7a34005ae8711ed49c76e64","8f73ba6f5a0042f2850356ac38ac6f24",22884842,1,1,0,205,94,95,1
"8f73ba6f5a0042f2850356ac38ac6f24","8f73ba6f5a0042f2850356ac38ac6f24",22884842,5,0,1,206,95,95,0
"8f73ba6f5a0042f2850356ac38ac6f24","e2260b86653c46d7b14a41fb419dbf8c",22884842,1,1,0,211,95,96,1
"e2260b86653c46d7b14a41fb419dbf8c","e2260b86653c46d7b14a41fb419dbf8c",22884842,2,0,1,212,96,96,0
"e2260b86653c46d7b14a41fb419dbf8c","35eb641ad1d845bbba54915bce75a962",22884842,1,1,0,214,96,97,1
"35eb641ad1d845bbba54915bce75a962","35eb641ad1d845bbba54915bce75a962",22884842,5,0,1,215,97,97,0
"35eb641ad1d845bbba54915bce75a962","08be90ffbeea4795a138cd42ed8db56f",22884842,1,1,0,220,97,98,1
"08be90ffbeea4795a138cd42ed8db56f","08be90ffbeea4795a138cd42ed8db56f",22884842,5,0,1,221,98,98,0
"08be90ffbeea4795a138cd42ed8db56f","3007433c8f584dcbb5ac159c1c5f2be3",22884842,1,1,0,226,98,99,1
"3007433c8f584dcbb5ac159c1c5f2be3","3007433c8f584dcbb5ac159c1c5f2be3",22884842,5,0,1,227,99,99,0
"3007433c8f584dcbb5ac159c1c5f2be3","e20db35ced8544ddac5bc3839145e463",22884842,1,-8,0,232,99,91,-8
"e20db35ced8544ddac5bc3839145e463","00ae5f0c51874a73a41ebea838d95682",22884842,2,11,0,233,91,101,10
"d391c8b6e56a43a7b654e9dee02d904b","00ae5f0c51874a73a41ebea838d95682",22884842,1,-2,0,235,103,101,-2
"00ae5f0c51874a73a41ebea838d95682","00ae5f0c51874a73a41ebea838d95682",22884842,1,0,1,236,101,101,0
"d391c8b6e56a43a7b654e9dee02d904b","d391c8b6e56a43a7b654e9dee02d904b",22884842,15,0,1,238,103,103,0
"d391c8b6e56a43a7b654e9dee02d904b","6111116566fc4fd9abba409322bea245",22884842,1,1,0,253,103,104,1
"6111116566fc4fd9abba409322bea245","6111116566fc4fd9abba409322bea245",22884842,2,0,1,254,104,104,0
"6111116566fc4fd9abba409322bea245","a81b2235cb9c499eb9ea8ee0a8dd9725",22884842,1,1,0,256,104,105,1
"a81b2235cb9c499eb9ea8ee0a8dd9725","a81b2235cb9c499eb9ea8ee0a8dd9725",22884842,2,0,1,257,105,105,0
"a81b2235cb9c499eb9ea8ee0a8dd9725","2d4e0ab0ef3b4d73b82c72d4621a7579",22884842,1,1,0,259,105,106,1
"2d4e0ab0ef3b4d73b82c72d4621a7579","2d4e0ab0ef3b4d73b82c72d4621a7579",22884842,2,0,1,260,106,106,0
"2d4e0ab0ef3b4d73b82c72d4621a7579","8bdebf492ebd4e62b0d522e8ab5e5197",22884842,1,1,0,262,106,107,1
"8bdebf492ebd4e62b0d522e8ab5e5197","8bdebf492ebd4e62b0d522e8ab5e5197",22884842,2,0,1,263,107,107,0
"8bdebf492ebd4e62b0d522e8ab5e5197","73039f8c1eb9409cb4caee2cf968001e",22884842,1,-7,0,265,107,100,-7
"73039f8c1eb9409cb4caee2cf968001e","4280927ec4d643238aa49c32f9e06c6c",22884842,1,10,0,266,100,109,9
"4280927ec4d643238aa49c32f9e06c6c","4280927ec4d643238aa49c32f9e06c6c",22884842,2,0,1,267,109,109,0
"4280927ec4d643238aa49c32f9e06c6c","fc44e6a5f7654430af1227838224dceb",22884842,1,2,0,268,109,111,2
"fc44e6a5f7654430af1227838224dceb","fc44e6a5f7654430af1227838224dceb",22884842,2,0,1,269,111,111,0
"fc44e6a5f7654430af1227838224dceb","08111f75e22d409998cf8b85bd431f0a",22884842,1,-3,0,271,111,108,-3
"08111f75e22d409998cf8b85bd431f0a","a9ae0a3c070d455bb4369a8996313336",22884842,2,7,0,272,108,114,6
"a9ae0a3c070d455bb4369a8996313336","a9ae0a3c070d455bb4369a8996313336",22884842,1,0,1,273,114,114,0
"a9ae0a3c070d455bb4369a8996313336","37319e88176d4aefa91d7a9980dbae91",22884842,1,-2,0,274,114,112,-2
"37319e88176d4aefa91d7a9980dbae91","4280927ec4d643238aa49c32f9e06c6c",22884842,1,-4,0,275,112,109,-3
"4280927ec4d643238aa49c32f9e06c6c","a9ae0a3c070d455bb4369a8996313336",22884842,1,6,0,277,109,114,5
"a9ae0a3c070d455bb4369a8996313336","08111f75e22d409998cf8b85bd431f0a",22884842,1,-7,0,278,114,108,-6
"08111f75e22d409998cf8b85bd431f0a","71cec822bcff4f30a20e75dc63ef7b65",22884842,1,9,0,279,108,116,8
"71cec822bcff4f30a20e75dc63ef7b65","71cec822bcff4f30a20e75dc63ef7b65",22884842,1,0,1,280,116,116,0
"71cec822bcff4f30a20e75dc63ef7b65","37319e88176d4aefa91d7a9980dbae91",22884842,1,-4,0,281,116,112,-4
"37319e88176d4aefa91d7a9980dbae91","62bff51286ef4f348717a3cf6fe2318f",22884842,1,9,0,282,112,120,8
"62bff51286ef4f348717a3cf6fe2318f","b1cd0e7dc3ad4a8eb91a4bfdbeb025b0",22884842,1,-2,0,283,120,118,-2
"b1cd0e7dc3ad4a8eb91a4bfdbeb025b0","b1cd0e7dc3ad4a8eb91a4bfdbeb025b0",22884842,1,0,1,284,118,118,0
"b1cd0e7dc3ad4a8eb91a4bfdbeb025b0","62bff51286ef4f348717a3cf6fe2318f",22884842,1,2,0,285,118,120,2
"62bff51286ef4f348717a3cf6fe2318f","62bff51286ef4f348717a3cf6fe2318f",22884842,5,0,1,286,120,120,0
"62bff51286ef4f348717a3cf6fe2318f","779f9ddd1fd14d1e9e69f72219a1fdbd",22884842,1,3,0,289,120,121,1
"779f9ddd1fd14d1e9e69f72219a1fdbd","e20db35ced8544ddac5bc3839145e463",22884842,2,-36,0,290,121,91,-30
"e20db35ced8544ddac5bc3839145e463","ae26e6cda8ad4a3f81bd347560d9579f",22884842,1,40,0,291,91,125,34
"ae26e6cda8ad4a3f81bd347560d9579f","ae26e6cda8ad4a3f81bd347560d9579f",22884842,3,0,1,292,125,125,0
"ae26e6cda8ad4a3f81bd347560d9579f","ee48df95832b4374aa273ceb27ec1315",22884842,1,1,0,295,125,126,1
"ee48df95832b4374aa273ceb27ec1315","ee48df95832b4374aa273ceb27ec1315",22884842,1,0,1,296,126,126,0
"ee48df95832b4374aa273ceb27ec1315","7a439da90b394756ad1777fc4c6dead5",22884842,1,1,0,297,126,127,1
"7a439da90b394756ad1777fc4c6dead5","7a439da90b394756ad1777fc4c6dead5",22884842,1,0,1,298,127,127,0
"7a439da90b394756ad1777fc4c6dead5","a8dd5213034441ac92724b4e83eb0bb2",22884842,1,3,0,299,127,129,2
"a8dd5213034441ac92724b4e83eb0bb2","779f9ddd1fd14d1e9e69f72219a1fdbd",22884842,2,-9,0,300,129,121,-8
"779f9ddd1fd14d1e9e69f72219a1fdbd","a8dd5213034441ac92724b4e83eb0bb2",22884842,1,9,0,301,121,129,8
"a8dd5213034441ac92724b4e83eb0bb2","8115eab6556b45f5b415c3b8c26a12e5",22884842,1,2,0,302,129,131,2
"8115eab6556b45f5b415c3b8c26a12e5","8115eab6556b45f5b415c3b8c26a12e5",22884842,2,0,1,303,131,131,0
"8115eab6556b45f5b415c3b8c26a12e5","ec34b06efd844b46a4c4818ecdb9b8f4",22884842,1,1,0,305,131,132,1
"ec34b06efd844b46a4c4818ecdb9b8f4","ec34b06efd844b46a4c4818ecdb9b8f4",22884842,5,0,1,306,132,132,0
"ec34b06efd844b46a4c4818ecdb9b8f4","c2e1c2b9eac64109b343a088584b576b",22884842,1,1,0,311,132,133,1
"c2e1c2b9eac64109b343a088584b576b","c2e1c2b9eac64109b343a088584b576b",22884842,2,0,1,312,133,133,0
"c2e1c2b9eac64109b343a088584b576b","579338175e0b4bbb8ef3b712b5d8b54e",22884842,1,-5,0,314,133,128,-5
"579338175e0b4bbb8ef3b712b5d8b54e","8bc5795d6a984a3eace4e2811e52dd4f",22884842,1,8,0,315,128,135,7
"8bc5795d6a984a3eace4e2811e52dd4f","8bc5795d6a984a3eace4e2811e52dd4f",22884842,1,0,1,316,135,135,0
"8bc5795d6a984a3eace4e2811e52dd4f","b416d47c56a742199b5d7c7f19d6503a",22884842,1,-1,0,317,135,134,-1
"b416d47c56a742199b5d7c7f19d6503a","cd4532ad48034873ba8bce2aac0c9808",22884842,1,4,0,318,134,137,3
"cd4532ad48034873ba8bce2aac0c9808","cd4532ad48034873ba8bce2aac0c9808",22884842,1,0,1,319,137,137,0
"cd4532ad48034873ba8bce2aac0c9808","df1de691dafe4549a18a4398ee9dfaf9",22884842,1,4,0,320,137,139,2
"df1de691dafe4549a18a4398ee9dfaf9","779f9ddd1fd14d1e9e69f72219a1fdbd",22884842,2,-23,0,321,139,121,-18
"779f9ddd1fd14d1e9e69f72219a1fdbd","6c5ad271a44743479bfaea29b1db8d02",22884842,1,27,0,322,121,143,22
"6c5ad271a44743479bfaea29b1db8d02","6c5ad271a44743479bfaea29b1db8d02",22884842,1,0,1,323,143,143,0
"6c5ad271a44743479bfaea29b1db8d02","83d311bed5374fee83d8d67a7d9d82dc",22884842,1,1,0,324,143,144,1
"83d311bed5374fee83d8d67a7d9d82dc","83d311bed5374fee83d8d67a7d9d82dc",22884842,3,0,1,325,144,144,0
"83d311bed5374fee83d8d67a7d9d82dc","402bba41861d43acb52a5abb89e8831e",22884842,1,1,0,328,144,145,1
"402bba41861d43acb52a5abb89e8831e","402bba41861d43acb52a5abb89e8831e",22884842,2,0,1,329,145,145,0
"402bba41861d43acb52a5abb89e8831e","8aae34f5ddbb4052a709b12e6b0d40fa",22884842,1,3,0,331,145,147,2
"8aae34f5ddbb4052a709b12e6b0d40fa","df1de691dafe4549a18a4398ee9dfaf9",22884842,2,-9,0,332,147,139,-8
"df1de691dafe4549a18a4398ee9dfaf9","8aae34f5ddbb4052a709b12e6b0d40fa",22884842,1,9,0,333,139,147,8
"8aae34f5ddbb4052a709b12e6b0d40fa","645b3f0249f64f76af2e19eb4d0e55b7",22884842,1,2,0,334,147,149,2
"645b3f0249f64f76af2e19eb4d0e55b7","645b3f0249f64f76af2e19eb4d0e55b7",22884842,2,0,1,335,149,149,0
"645b3f0249f64f76af2e19eb4d0e55b7","7e7b8db5064d4369805ab370aac5ddfb",22884842,1,1,0,337,149,150,1
"7e7b8db5064d4369805ab370aac5ddfb","7e7b8db5064d4369805ab370aac5ddfb",22884842,2,0,1,338,150,150,0
"7e7b8db5064d4369805ab370aac5ddfb","8956d210ae7f41968fada86d4c979d6a",22884842,1,1,0,340,150,151,1
"8956d210ae7f41968fada86d4c979d6a","8956d210ae7f41968fada86d4c979d6a",22884842,2,0,1,341,151,151,0
"8956d210ae7f41968fada86d4c979d6a","f902b0f41b544d4dbf79664fd233648d",22884842,1,-5,0,343,151,146,-5
"f902b0f41b544d4dbf79664fd233648d","ae781e8b775e4ccd93bc800dad5c8376",22884842,1,8,0,344,146,153,7
"ae781e8b775e4ccd93bc800dad5c8376","ae781e8b775e4ccd93bc800dad5c8376",22884842,2,0,1,345,153,153,0
"ae781e8b775e4ccd93bc800dad5c8376","06882a8492d9499aa31555567f575ecb",22884842,1,1,0,347,153,154,1
"06882a8492d9499aa31555567f575ecb","06882a8492d9499aa31555567f575ecb",22884842,1,0,1,348,154,154,0
"06882a8492d9499aa31555567f575ecb","f293c508f409466a8f27ddd7d1e40b20",22884842,1,1,0,349,154,155,1
"f293c508f409466a8f27ddd7d1e40b20","f293c508f409466a8f27ddd7d1e40b20",22884842,2,0,1,350,155,155,0
"f293c508f409466a8f27ddd7d1e40b20","cc4ddef5bbbe48ebb605141b347c4ed1",22884842,1,1,0,352,155,156,1
"cc4ddef5bbbe48ebb605141b347c4ed1","cc4ddef5bbbe48ebb605141b347c4ed1",22884842,1,0,1,353,156,156,0
"cc4ddef5bbbe48ebb605141b347c4ed1","d313cec988a84645bee413e8d4724a4b",22884842,1,3,0,354,156,158,2
"d313cec988a84645bee413e8d4724a4b","f03480cf4eba413194d7af52fc0e7f28",22884842,1,-7,0,355,158,152,-6
"f03480cf4eba413194d7af52fc0e7f28","d313cec988a84645bee413e8d4724a4b",22884842,2,7,0,356,152,158,6
"d313cec988a84645bee413e8d4724a4b","d313cec988a84645bee413e8d4724a4b",22884842,6,0,1,357,158,158,0
"d313cec988a84645bee413e8d4724a4b","78adeee1fa2c4fe0bc73f7bca9fcee86",22884842,2,4,0,360,158,160,2
"78adeee1fa2c4fe0bc73f7bca9fcee86","df1de691dafe4549a18a4398ee9dfaf9",22884842,3,-26,0,361,160,139,-21
"df1de691dafe4549a18a4398ee9dfaf9","78adeee1fa2c4fe0bc73f7bca9fcee86",22884842,2,26,0,362,139,160,21
"df1de691dafe4549a18a4398ee9dfaf9","d313cec988a84645bee413e8d4724a4b",22884842,2,22,0,364,139,158,19
"d313cec988a84645bee413e8d4724a4b","dc60696c76a74368a60f72246e47700d",22884842,1,1,0,367,158,159,1
"dc60696c76a74368a60f72246e47700d","dc60696c76a74368a60f72246e47700d",22884842,1,0,1,368,159,159,0
"dc60696c76a74368a60f72246e47700d","df1de691dafe4549a18a4398ee9dfaf9",22884842,1,-23,0,369,159,139,-20
"78adeee1fa2c4fe0bc73f7bca9fcee86","67a089198fcb4e1c8f2385786c2b296f",22884842,1,-152,0,371,160,39,-121
"67a089198fcb4e1c8f2385786c2b296f","64d48c6c9c7940639a932219a6c87198",22884842,2,1,0,372,39,40,1
"64d48c6c9c7940639a932219a6c87198","67a089198fcb4e1c8f2385786c2b296f",22884842,1,-1,0,373,40,39,-1
"67a089198fcb4e1c8f2385786c2b296f","b534b89233134e30a9b5645138bfa9ee",22884842,1,4,0,374,39,41,2
"b534b89233134e30a9b5645138bfa9ee","6e13d61a7bdb44bca949c9f86fab3be5",22884842,2,7,0,375,41,47,6
"6e13d61a7bdb44bca949c9f86fab3be5","b534b89233134e30a9b5645138bfa9ee",22884842,1,-7,0,376,47,41,-6
"b534b89233134e30a9b5645138bfa9ee","d0c74f735e024943943e40333d6d337f",22884842,1,12,0,377,41,51,10
"d0c74f735e024943943e40333d6d337f","d9c8d8c444a64dadbbb508652c721e17",22884842,2,-6,0,378,51,46,-5
"d9c8d8c444a64dadbbb508652c721e17","f924752d8a1149668870b1e7698486f7",22884842,1,5,0,379,46,50,4
"78f30e4dcac84e3cbea8b2cc6e0d62b3","a0a418b8540d479fa6e0f653b701da8b",22884842,1,6,0,382,59,64,5
"a0a418b8540d479fa6e0f653b701da8b","bc42d26810654ea9a1df1efe1e58c7d5",22884842,1,-1,0,383,64,63,-1
"12aa6e1672ac4e7aa6449a7a8609cd72","bc42d26810654ea9a1df1efe1e58c7d5",22884842,1,7,0,385,57,63,6
"309ccf3cc4fe429d9bfbaef53d3fa479","d646286c8051419bbc2e31dd1db55ca8",22884842,1,10,0,390,60,67,7
"d646286c8051419bbc2e31dd1db55ca8","b534b89233134e30a9b5645138bfa9ee",22884842,1,-33,0,391,67,41,-26
"a2becd407db34b189200a32546d9d569","140d5b27b8574befad82c0a013b59dfa",22884842,1,-1,0,394,75,74,-1
"d18a9ea32855445f8736581f5cb119ce","6a9f0ef185fb47f0937e29daa1c71ed5",22884842,1,10,0,396,82,90,8
"6a9f0ef185fb47f0937e29daa1c71ed5","ae5ac430ea254e708a6f5deaaf7464ae",22884842,1,-7,0,399,90,84,-6
"ae5ac430ea254e708a6f5deaaf7464ae","d646286c8051419bbc2e31dd1db55ca8",22884842,1,-20,0,400,84,67,-17
"d646286c8051419bbc2e31dd1db55ca8","e20db35ced8544ddac5bc3839145e463",22884842,1,30,0,401,67,91,24
"00ae5f0c51874a73a41ebea838d95682","e20db35ced8544ddac5bc3839145e463",22884842,1,-11,0,403,101,91,-10
"e20db35ced8544ddac5bc3839145e463","d391c8b6e56a43a7b654e9dee02d904b",22884842,1,13,0,404,91,103,12
"d391c8b6e56a43a7b654e9dee02d904b","4280927ec4d643238aa49c32f9e06c6c",22884842,1,7,0,405,103,109,6
"4280927ec4d643238aa49c32f9e06c6c","73039f8c1eb9409cb4caee2cf968001e",22884842,1,-10,0,406,109,100,-9
"73039f8c1eb9409cb4caee2cf968001e","08111f75e22d409998cf8b85bd431f0a",22884842,1,9,0,407,100,108,8
"a9ae0a3c070d455bb4369a8996313336","62bff51286ef4f348717a3cf6fe2318f",22884842,1,7,0,409,114,120,6
"62bff51286ef4f348717a3cf6fe2318f","37319e88176d4aefa91d7a9980dbae91",22884842,1,-9,0,412,120,112,-8
"37319e88176d4aefa91d7a9980dbae91","779f9ddd1fd14d1e9e69f72219a1fdbd",22884842,1,12,0,413,112,121,9
"e20db35ced8544ddac5bc3839145e463","a8dd5213034441ac92724b4e83eb0bb2",22884842,1,45,0,415,91,129,38
"779f9ddd1fd14d1e9e69f72219a1fdbd","579338175e0b4bbb8ef3b712b5d8b54e",22884842,1,8,0,417,121,128,7
"579338175e0b4bbb8ef3b712b5d8b54e","df1de691dafe4549a18a4398ee9dfaf9",22884842,1,15,0,418,128,139,11
"779f9ddd1fd14d1e9e69f72219a1fdbd","b416d47c56a742199b5d7c7f19d6503a",22884842,1,15,0,420,121,134,13
"b416d47c56a742199b5d7c7f19d6503a","6c5ad271a44743479bfaea29b1db8d02",22884842,1,12,0,421,134,143,9
"6c5ad271a44743479bfaea29b1db8d02","8aae34f5ddbb4052a709b12e6b0d40fa",22884842,1,5,0,422,143,147,4
"d313cec988a84645bee413e8d4724a4b","f902b0f41b544d4dbf79664fd233648d",22884842,1,-14,0,425,158,146,-12
"f902b0f41b544d4dbf79664fd233648d","f03480cf4eba413194d7af52fc0e7f28",22884842,1,7,0,426,146,152,6
"df1de691dafe4549a18a4398ee9dfaf9","65202579580f4ad38d734b4ee39d22a8",22884842,1,31,0,431,139,164,25
"65202579580f4ad38d734b4ee39d22a8","65202579580f4ad38d734b4ee39d22a8",22884842,51,0,1,432,164,164,0
"65202579580f4ad38d734b4ee39d22a8","78adeee1fa2c4fe0bc73f7bca9fcee86",22884842,2,-5,0,437,164,160,-4
"78adeee1fa2c4fe0bc73f7bca9fcee86","65202579580f4ad38d734b4ee39d22a8",22884842,1,5,0,438,160,164,4
"78adeee1fa2c4fe0bc73f7bca9fcee86","3cbcea2be0984e7dbd5a48195af10ce7",22884842,1,8,0,486,160,165,5
"3cbcea2be0984e7dbd5a48195af10ce7","82e6285962b8400d9d6fc32436022a94",22884842,1,2,0,487,165,167,2
"82e6285962b8400d9d6fc32436022a94","0c7262dff33c4087bc660ccf40f92f9c",22884842,1,7,0,488,167,169,2
"0c7262dff33c4087bc660ccf40f92f9c","b2275c3fad834f8d90737a2d9a6927d6",22884842,1,3,0,489,169,172,3
"b2275c3fad834f8d90737a2d9a6927d6","b2275c3fad834f8d90737a2d9a6927d6",22884842,36,0,1,490,172,172,0
"b2275c3fad834f8d90737a2d9a6927d6","eb515a26030b41f8a82a1e6114420bad",22884842,1,1,0,526,172,173,1
"eb515a26030b41f8a82a1e6114420bad","eb515a26030b41f8a82a1e6114420bad",22884842,2,0,1,527,173,173,0
"eb515a26030b41f8a82a1e6114420bad","b42cc17b7de840f181a704558d0bc845",22884842,1,3,0,529,173,175,2
"b42cc17b7de840f181a704558d0bc845","0c7262dff33c4087bc660ccf40f92f9c",22884842,1,-7,0,530,175,169,-6
"0c7262dff33c4087bc660ccf40f92f9c","b42cc17b7de840f181a704558d0bc845",22884842,1,7,0,531,169,175,6
"b42cc17b7de840f181a704558d0bc845","801f9e9135034f49bf5f8b4bdefedb41",22884842,1,2,0,532,175,177,2
"801f9e9135034f49bf5f8b4bdefedb41","801f9e9135034f49bf5f8b4bdefedb41",22884842,4,0,1,533,177,177,0
"801f9e9135034f49bf5f8b4bdefedb41","ea38cc0e6e6e41edbabf210220808bf9",22884842,1,3,0,537,177,179,2
"ea38cc0e6e6e41edbabf210220808bf9","b87c552dd247427abe6ab5795b9c9d43",22884842,2,2,0,538,179,181,2
"b87c552dd247427abe6ab5795b9c9d43","362fcb0699a14845ab29b2340093e528",22884842,1,-8,0,539,181,174,-7
"362fcb0699a14845ab29b2340093e528","ea38cc0e6e6e41edbabf210220808bf9",22884842,1,6,0,540,174,179,5
"b87c552dd247427abe6ab5795b9c9d43","b87c552dd247427abe6ab5795b9c9d43",22884842,9,0,1,542,181,181,0
"b87c552dd247427abe6ab5795b9c9d43","139b097acfca451689d80c9c6eebdf7b",22884842,1,-3,0,551,181,178,-3
"139b097acfca451689d80c9c6eebdf7b","30f660a1feb34582a739722532524f79",22884842,1,6,0,552,178,183,5
"30f660a1feb34582a739722532524f79","30f660a1feb34582a739722532524f79",22884842,9,0,1,553,183,183,0
"30f660a1feb34582a739722532524f79","2024b4885bd14338a39b7b509acbbd02",22884842,1,-1,0,562,183,182,-1
"2024b4885bd14338a39b7b509acbbd02","c3f63fe50d8e487c86bf8ef76c9cadd3",22884842,1,4,0,563,182,185,3
"c3f63fe50d8e487c86bf8ef76c9cadd3","c3f63fe50d8e487c86bf8ef76c9cadd3",22884842,1,0,1,564,185,185,0
"c3f63fe50d8e487c86bf8ef76c9cadd3","0c7262dff33c4087bc660ccf40f92f9c",22884842,1,-20,0,565,185,169,-16
"0c7262dff33c4087bc660ccf40f92f9c","c8e371568a0c4391b25796ae4e91952e",22884842,1,23,0,566,169,186,17
"b613861cecf84ffcab01afb23f660475","b613861cecf84ffcab01afb23f660475",22886492,3,0,1,1,1,1,0
"b613861cecf84ffcab01afb23f660475","e2911e79efc2420eac45d9f671463d4b",22886492,1,3,0,4,1,2,1
"e2911e79efc2420eac45d9f671463d4b","e2911e79efc2420eac45d9f671463d4b",22886492,2,0,1,5,2,2,0
"e2911e79efc2420eac45d9f671463d4b","519d1b8c59404d67b54e96c5c8a830b2",22886492,1,1,0,7,2,3,1
"519d1b8c59404d67b54e96c5c8a830b2","519d1b8c59404d67b54e96c5c8a830b2",22886492,1,0,1,8,3,3,0
"519d1b8c59404d67b54e96c5c8a830b2","531db53f81f646edb0cdcfe0085b03b7",22886492,1,1,0,9,3,4,1
"531db53f81f646edb0cdcfe0085b03b7","531db53f81f646edb0cdcfe0085b03b7",22886492,1,0,1,10,4,4,0
"531db53f81f646edb0cdcfe0085b03b7","4f5f94b2f95141e0a9d53a61da2276da",22886492,1,1,0,11,4,5,1
"4f5f94b2f95141e0a9d53a61da2276da","4f5f94b2f95141e0a9d53a61da2276da",22886492,1,0,1,12,5,5,0
"4f5f94b2f95141e0a9d53a61da2276da","6d541c89590949f99af293c4f2333f67",22886492,1,1,0,13,5,6,1
"6d541c89590949f99af293c4f2333f67","6d541c89590949f99af293c4f2333f67",22886492,1,0,1,14,6,6,0
"6d541c89590949f99af293c4f2333f67","dd5cf0b9fe4c4f1d8f5ff8e4c04879cb",22886492,1,1,0,15,6,7,1
"dd5cf0b9fe4c4f1d8f5ff8e4c04879cb","dd5cf0b9fe4c4f1d8f5ff8e4c04879cb",22886492,3,0,1,16,7,7,0
"dd5cf0b9fe4c4f1d8f5ff8e4c04879cb","f96261861edc426abe2248be4f0a709a",22886492,1,1,0,19,7,8,1
"f96261861edc426abe2248be4f0a709a","f96261861edc426abe2248be4f0a709a",22886492,1,0,1,20,8,8,0
"f96261861edc426abe2248be4f0a709a","66b5e16f4f75454fb5b8172079f0fa83",22886492,1,1,0,21,8,9,1
"66b5e16f4f75454fb5b8172079f0fa83","66b5e16f4f75454fb5b8172079f0fa83",22886492,1,0,1,22,9,9,0
"66b5e16f4f75454fb5b8172079f0fa83","0680571d4698477995e41842c36a54b2",22886492,1,1,0,23,9,10,1
"0680571d4698477995e41842c36a54b2","0680571d4698477995e41842c36a54b2",22886492,1,0,1,24,10,10,0
"0680571d4698477995e41842c36a54b2","9112f2bffece48e08c6d2287be204085",22886492,1,1,0,25,10,11,1
"9112f2bffece48e08c6d2287be204085","9112f2bffece48e08c6d2287be204085",22886492,1,0,1,26,11,11,0
"9112f2bffece48e08c6d2287be204085","e2911e79efc2420eac45d9f671463d4b",22886492,1,-9,0,27,11,2,-9
"e2911e79efc2420eac45d9f671463d4b","56586aa865414f538729c7f7735d2bc6",22886492,1,12,0,28,2,12,10
"56586aa865414f538729c7f7735d2bc6","56586aa865414f538729c7f7735d2bc6",22886492,10,0,1,29,12,12,0
"56586aa865414f538729c7f7735d2bc6","b7f2b31585d94eb3bf86376714aa7070",22886492,4,2,0,32,12,13,1
"b7f2b31585d94eb3bf86376714aa7070","b7f2b31585d94eb3bf86376714aa7070",22886492,7,0,1,33,13,13,0
"b7f2b31585d94eb3bf86376714aa7070","56586aa865414f538729c7f7735d2bc6",22886492,2,-2,0,35,13,12,-1
"b7f2b31585d94eb3bf86376714aa7070","3f1c815879794b929260d224becaff7e",22886492,2,2,0,39,13,14,1
"3f1c815879794b929260d224becaff7e","5c5ceeee4562457ba6d41515aeebfbb1",22886492,1,6,0,40,14,17,3
"5c5ceeee4562457ba6d41515aeebfbb1","81c864a886d54a6b8ff85f7d736f4f95",22886492,1,-4,0,41,17,15,-2
"81c864a886d54a6b8ff85f7d736f4f95","5c5ceeee4562457ba6d41515aeebfbb1",22886492,2,4,0,42,15,17,2
"5c5ceeee4562457ba6d41515aeebfbb1","5c5ceeee4562457ba6d41515aeebfbb1",22886492,4,0,1,43,17,17,0
"5c5ceeee4562457ba6d41515aeebfbb1","9afd71a5298d4333b6849dfce1b9422c",22886492,1,3,0,46,17,18,1
"9afd71a5298d4333b6849dfce1b9422c","56586aa865414f538729c7f7735d2bc6",22886492,1,-13,0,47,18,12,-6
"3f1c815879794b929260d224becaff7e","81c864a886d54a6b8ff85f7d736f4f95",22886492,1,2,0,62,14,15,1
"5c5ceeee4562457ba6d41515aeebfbb1","56586aa865414f538729c7f7735d2bc6",22886492,1,-10,0,65,17,12,-5
"56586aa865414f538729c7f7735d2bc6","9afd71a5298d4333b6849dfce1b9422c",22886492,1,13,0,66,12,18,6
"9afd71a5298d4333b6849dfce1b9422c","9afd71a5298d4333b6849dfce1b9422c",22886492,1,0,1,67,18,18,0
"9afd71a5298d4333b6849dfce1b9422c","b7719e26494940efa49512aedd0aac79",22886492,1,4,0,68,18,20,2
"b7719e26494940efa49512aedd0aac79","d4f45188d3c84a02ba08454e6403a818",22886492,1,5,0,69,20,24,4
"d4f45188d3c84a02ba08454e6403a818","d4c3b003e8274e429d2fa688d73fde6d",22886492,1,-2,0,70,24,22,-2
"d4c3b003e8274e429d2fa688d73fde6d","d4c3b003e8274e429d2fa688d73fde6d",22886492,1,0,1,71,22,22,0
"d4c3b003e8274e429d2fa688d73fde6d","b7719e26494940efa49512aedd0aac79",22886492,1,-3,0,72,22,20,-2
"b7719e26494940efa49512aedd0aac79","b7719e26494940efa49512aedd0aac79",22886492,1,0,1,73,20,20,0
"b7719e26494940efa49512aedd0aac79","afbf7250b99d47bea07172749483ca97",22886492,1,12,0,74,20,28,8
"afbf7250b99d47bea07172749483ca97","afbf7250b99d47bea07172749483ca97",22886492,1,0,1,75,28,28,0
"afbf7250b99d47bea07172749483ca97","4e51676dc72045d99c19b9fa7b22f8bc",22886492,1,3,0,76,28,29,1
"4e51676dc72045d99c19b9fa7b22f8bc","4e51676dc72045d99c19b9fa7b22f8bc",22886492,1,0,1,77,29,29,0
"4e51676dc72045d99c19b9fa7b22f8bc","51970cfa30e643e894e66ae85c8024cc",22886492,1,3,0,78,29,31,2
"51970cfa30e643e894e66ae85c8024cc","c33c17be71ae4d588da7369472e5bb1b",22886492,1,6,0,79,31,34,3
"c33c17be71ae4d588da7369472e5bb1b","4e51676dc72045d99c19b9fa7b22f8bc",22886492,1,-9,0,80,34,29,-5
"4e51676dc72045d99c19b9fa7b22f8bc","c33c17be71ae4d588da7369472e5bb1b",22886492,1,9,0,81,29,34,5
"c33c17be71ae4d588da7369472e5bb1b","93679be414554a11b1893002f2229a93",22886492,1,3,0,82,34,35,1
"93679be414554a11b1893002f2229a93","93679be414554a11b1893002f2229a93",22886492,1,0,1,83,35,35,0
"93679be414554a11b1893002f2229a93","7040a13096d746ac84b8fac8d9752058",22886492,1,3,0,84,35,36,1
"7040a13096d746ac84b8fac8d9752058","7040a13096d746ac84b8fac8d9752058",22886492,1,0,1,85,36,36,0
"7040a13096d746ac84b8fac8d9752058","9a0dc646f934470daf08c4b56ccf73db",22886492,1,3,0,86,36,37,1
"9a0dc646f934470daf08c4b56ccf73db","9a0dc646f934470daf08c4b56ccf73db",22886492,1,0,1,87,37,37,0
"9a0dc646f934470daf08c4b56ccf73db","fc0e049d56024bc9a02c9a9c435c3df7",22886492,1,3,0,88,37,38,1
"fc0e049d56024bc9a02c9a9c435c3df7","67a089198fcb4e1c8f2385786c2b296f",22886492,1,4,0,89,38,39,1
"67a089198fcb4e1c8f2385786c2b296f","fc0e049d56024bc9a02c9a9c435c3df7",22886492,1,-4,0,90,39,38,-1
"fc0e049d56024bc9a02c9a9c435c3df7","64d48c6c9c7940639a932219a6c87198",22886492,1,5,0,91,38,40,2
"64d48c6c9c7940639a932219a6c87198","64d48c6c9c7940639a932219a6c87198",22886492,1,0,1,92,40,40,0
"64d48c6c9c7940639a932219a6c87198","67a089198fcb4e1c8f2385786c2b296f",22886492,1,-1,0,93,40,39,-1
"67a089198fcb4e1c8f2385786c2b296f","b534b89233134e30a9b5645138bfa9ee",22886492,1,4,0,94,39,41,2
"b534b89233134e30a9b5645138bfa9ee","6875d67fdd5f48168b62719df449bebd",22886492,1,4,0,96,41,45,4
"6875d67fdd5f48168b62719df449bebd","6875d67fdd5f48168b62719df449bebd",22886492,1,0,1,97,45,45,0
"6875d67fdd5f48168b62719df449bebd","0e37b720d23b4e7f8b313e79313fd107",22886492,1,-1,0,98,45,44,-1
"0e37b720d23b4e7f8b313e79313fd107","0e37b720d23b4e7f8b313e79313fd107",22886492,1,0,1,99,44,44,0
"0e37b720d23b4e7f8b313e79313fd107","6e13d61a7bdb44bca949c9f86fab3be5",22886492,1,4,0,100,44,47,3
"6e13d61a7bdb44bca949c9f86fab3be5","b534b89233134e30a9b5645138bfa9ee",22886492,1,-7,0,101,47,41,-6
"b534b89233134e30a9b5645138bfa9ee","d0c74f735e024943943e40333d6d337f",22886492,3,12,0,102,41,51,10
"d0c74f735e024943943e40333d6d337f","d9c8d8c444a64dadbbb508652c721e17",22886492,1,-6,0,103,51,46,-5
"d9c8d8c444a64dadbbb508652c721e17","f924752d8a1149668870b1e7698486f7",22886492,1,5,0,104,46,50,4
"f924752d8a1149668870b1e7698486f7","78f30e4dcac84e3cbea8b2cc6e0d62b3",22886492,1,10,0,105,50,59,9
"78f30e4dcac84e3cbea8b2cc6e0d62b3","a1f2f12debe5432fb7a70bcd12bacfb9",22886492,2,-1,0,106,59,58,-1
"a1f2f12debe5432fb7a70bcd12bacfb9","12aa6e1672ac4e7aa6449a7a8609cd72",22886492,1,-1,0,107,58,57,-1
"12aa6e1672ac4e7aa6449a7a8609cd72","a0a418b8540d479fa6e0f653b701da8b",22886492,1,8,0,108,57,64,7
"a0a418b8540d479fa6e0f653b701da8b","bc42d26810654ea9a1df1efe1e58c7d5",22886492,1,-1,0,109,64,63,-1
"bc42d26810654ea9a1df1efe1e58c7d5","309ccf3cc4fe429d9bfbaef53d3fa479",22886492,2,-3,0,110,63,60,-3
"309ccf3cc4fe429d9bfbaef53d3fa479","b534b89233134e30a9b5645138bfa9ee",22886492,1,-23,0,111,60,41,-19
"b534b89233134e30a9b5645138bfa9ee","d646286c8051419bbc2e31dd1db55ca8",22886492,3,33,0,112,41,67,26
"d646286c8051419bbc2e31dd1db55ca8","d646286c8051419bbc2e31dd1db55ca8",22886492,1,0,1,113,67,67,0
"d646286c8051419bbc2e31dd1db55ca8","b534b89233134e30a9b5645138bfa9ee",22886492,3,-33,0,114,67,41,-26
"b534b89233134e30a9b5645138bfa9ee","b534b89233134e30a9b5645138bfa9ee",22886492,2,0,1,115,41,41,0
"d646286c8051419bbc2e31dd1db55ca8","a0a418b8540d479fa6e0f653b701da8b",22886492,1,-6,0,119,67,64,-3
"a0a418b8540d479fa6e0f653b701da8b","7af822066add4e7f8e007e4eee31a8bf",22886492,1,2,0,120,64,65,1
"7af822066add4e7f8e007e4eee31a8bf","bc42d26810654ea9a1df1efe1e58c7d5",22886492,1,-3,0,121,65,63,-2
"309ccf3cc4fe429d9bfbaef53d3fa479","6e13d61a7bdb44bca949c9f86fab3be5",22886492,1,-16,0,123,60,47,-13
"6e13d61a7bdb44bca949c9f86fab3be5","6e13d61a7bdb44bca949c9f86fab3be5",22886492,1,0,1,124,47,47,0
"6e13d61a7bdb44bca949c9f86fab3be5","195f78799f984cc2b06c48dfe36be751",22886492,1,2,0,125,47,49,2
"195f78799f984cc2b06c48dfe36be751","195f78799f984cc2b06c48dfe36be751",22886492,2,0,1,126,49,49,0
"195f78799f984cc2b06c48dfe36be751","d9c8d8c444a64dadbbb508652c721e17",22886492,1,-3,0,128,49,46,-3
"d9c8d8c444a64dadbbb508652c721e17","d0c74f735e024943943e40333d6d337f",22886492,1,6,0,129,46,51,5
"d0c74f735e024943943e40333d6d337f","d0c74f735e024943943e40333d6d337f",22886492,1,0,1,130,51,51,0
"d0c74f735e024943943e40333d6d337f","983f8ff320594b279a7f4a6fe132f9c5",22886492,1,2,0,131,51,53,2
"983f8ff320594b279a7f4a6fe132f9c5","983f8ff320594b279a7f4a6fe132f9c5",22886492,2,0,1,132,53,53,0
"983f8ff320594b279a7f4a6fe132f9c5","35adfa5d923046aebabfefd98f35ff05",22886492,1,1,0,134,53,54,1
"35adfa5d923046aebabfefd98f35ff05","35adfa5d923046aebabfefd98f35ff05",22886492,2,0,1,135,54,54,0
"35adfa5d923046aebabfefd98f35ff05","b6f8a98476224da1b40e555ececc7ed8",22886492,1,1,0,137,54,55,1
"b6f8a98476224da1b40e555ececc7ed8","b6f8a98476224da1b40e555ececc7ed8",22886492,2,0,1,138,55,55,0
"b6f8a98476224da1b40e555ececc7ed8","86e22cb5fe0e4b47a9489ecddf7ed78f",22886492,1,1,0,140,55,56,1
"86e22cb5fe0e4b47a9489ecddf7ed78f","86e22cb5fe0e4b47a9489ecddf7ed78f",22886492,2,0,1,141,56,56,0
"86e22cb5fe0e4b47a9489ecddf7ed78f","f924752d8a1149668870b1e7698486f7",22886492,1,-6,0,143,56,50,-6
"f924752d8a1149668870b1e7698486f7","a1f2f12debe5432fb7a70bcd12bacfb9",22886492,2,9,0,144,50,58,8
"a1f2f12debe5432fb7a70bcd12bacfb9","78f30e4dcac84e3cbea8b2cc6e0d62b3",22886492,3,1,0,145,58,59,1
"78f30e4dcac84e3cbea8b2cc6e0d62b3","b534b89233134e30a9b5645138bfa9ee",22886492,1,-21,0,146,59,41,-18
"d0c74f735e024943943e40333d6d337f","b534b89233134e30a9b5645138bfa9ee",22886492,1,-12,0,148,51,41,-10
"d0c74f735e024943943e40333d6d337f","f924752d8a1149668870b1e7698486f7",22886492,1,-1,0,150,51,50,-1
"a1f2f12debe5432fb7a70bcd12bacfb9","a1f2f12debe5432fb7a70bcd12bacfb9",22886492,21,0,1,154,58,58,0
"78f30e4dcac84e3cbea8b2cc6e0d62b3","78f30e4dcac84e3cbea8b2cc6e0d62b3",22886492,16,0,1,176,59,59,0
"78f30e4dcac84e3cbea8b2cc6e0d62b3","bc42d26810654ea9a1df1efe1e58c7d5",22886492,1,5,0,192,59,63,4
"bc42d26810654ea9a1df1efe1e58c7d5","a0a418b8540d479fa6e0f653b701da8b",22886492,2,1,0,193,63,64,1
"a0a418b8540d479fa6e0f653b701da8b","12aa6e1672ac4e7aa6449a7a8609cd72",22886492,1,-8,0,194,64,57,-7
"12aa6e1672ac4e7aa6449a7a8609cd72","4c943503763e4e349906eea3ed3c8e86",22886492,1,5,0,195,57,61,4
"4c943503763e4e349906eea3ed3c8e86","4c943503763e4e349906eea3ed3c8e86",22886492,1,0,1,196,61,61,0
"4c943503763e4e349906eea3ed3c8e86","bc42d26810654ea9a1df1efe1e58c7d5",22886492,1,2,0,197,61,63,2
"bc42d26810654ea9a1df1efe1e58c7d5","bc42d26810654ea9a1df1efe1e58c7d5",22886492,3,0,1,198,63,63,0
"a0a418b8540d479fa6e0f653b701da8b","a0a418b8540d479fa6e0f653b701da8b",22886492,3,0,1,202,64,64,0
"a0a418b8540d479fa6e0f653b701da8b","309ccf3cc4fe429d9bfbaef53d3fa479",22886492,1,-4,0,205,64,60,-4
"309ccf3cc4fe429d9bfbaef53d3fa479","d646286c8051419bbc2e31dd1db55ca8",22886492,1,10,0,206,60,67,7
"b534b89233134e30a9b5645138bfa9ee","267f883678b24aed855fde42524975d9",22886492,1,37,0,208,41,71,30
"267f883678b24aed855fde42524975d9","267f883678b24aed855fde42524975d9",22886492,1,0,1,209,71,71,0
"267f883678b24aed855fde42524975d9","88fff56d0342490dbef9040750a20f6c",22886492,1,1,0,210,71,72,1
"88fff56d0342490dbef9040750a20f6c","88fff56d0342490dbef9040750a20f6c",22886492,1,0,1,211,72,72,0
"88fff56d0342490dbef9040750a20f6c","adb17b12b66c4a49a85fd34322f7df70",22886492,1,1,0,212,72,73,1
"adb17b12b66c4a49a85fd34322f7df70","adb17b12b66c4a49a85fd34322f7df70",22886492,1,0,1,213,73,73,0
"adb17b12b66c4a49a85fd34322f7df70","a2becd407db34b189200a32546d9d569",22886492,1,3,0,214,73,75,2
"a2becd407db34b189200a32546d9d569","d646286c8051419bbc2e31dd1db55ca8",22886492,1,-9,0,215,75,67,-8
"d646286c8051419bbc2e31dd1db55ca8","a2becd407db34b189200a32546d9d569",22886492,1,9,0,216,67,75,8
"a2becd407db34b189200a32546d9d569","58c22b011d0f4c2ea6d13615edbb9eeb",22886492,1,2,0,217,75,77,2
"58c22b011d0f4c2ea6d13615edbb9eeb","58c22b011d0f4c2ea6d13615edbb9eeb",22886492,2,0,1,218,77,77,0
"58c22b011d0f4c2ea6d13615edbb9eeb","dd76e1861dc9461c830888729d091ee0",22886492,1,1,0,220,77,78,1
"dd76e1861dc9461c830888729d091ee0","dd76e1861dc9461c830888729d091ee0",22886492,2,0,1,221,78,78,0
"dd76e1861dc9461c830888729d091ee0","cd1d828f1a694b87913a7ea66c23803e",22886492,1,1,0,223,78,79,1
"cd1d828f1a694b87913a7ea66c23803e","cd1d828f1a694b87913a7ea66c23803e",22886492,8,0,1,224,79,79,0
"cd1d828f1a694b87913a7ea66c23803e","9176a3c2b4d2465fa8b0c67096c2a97e",22886492,1,1,0,232,79,80,1
"9176a3c2b4d2465fa8b0c67096c2a97e","9176a3c2b4d2465fa8b0c67096c2a97e",22886492,11,0,1,233,80,80,0
"9176a3c2b4d2465fa8b0c67096c2a97e","f8ec6445f7194e25b9101d4fbcb07a18",22886492,1,1,0,244,80,81,1
"f8ec6445f7194e25b9101d4fbcb07a18","f8ec6445f7194e25b9101d4fbcb07a18",22886492,2,0,1,245,81,81,0
"f8ec6445f7194e25b9101d4fbcb07a18","140d5b27b8574befad82c0a013b59dfa",22886492,1,-7,0,247,81,74,-7
"140d5b27b8574befad82c0a013b59dfa","d18a9ea32855445f8736581f5cb119ce",22886492,1,9,0,248,74,82,8
"d18a9ea32855445f8736581f5cb119ce","f564483cbd7a407681aa2fcca518cf5f",22886492,1,4,0,249,82,85,3
"f564483cbd7a407681aa2fcca518cf5f","f564483cbd7a407681aa2fcca518cf5f",22886492,4,0,1,250,85,85,0
"f564483cbd7a407681aa2fcca518cf5f","18fd01350bd5434ca636d59a599d768a",22886492,1,1,0,254,85,86,1
"18fd01350bd5434ca636d59a599d768a","18fd01350bd5434ca636d59a599d768a",22886492,2,0,1,255,86,86,0
"18fd01350bd5434ca636d59a599d768a","ae5ac430ea254e708a6f5deaaf7464ae",22886492,1,-2,0,257,86,84,-2
"ae5ac430ea254e708a6f5deaaf7464ae","6a9f0ef185fb47f0937e29daa1c71ed5",22886492,1,7,0,258,84,90,6
"6a9f0ef185fb47f0937e29daa1c71ed5","6a9f0ef185fb47f0937e29daa1c71ed5",22886492,4,0,1,259,90,90,0
"6a9f0ef185fb47f0937e29daa1c71ed5","d646286c8051419bbc2e31dd1db55ca8",22886492,1,-27,0,263,90,67,-23
"d646286c8051419bbc2e31dd1db55ca8","e20db35ced8544ddac5bc3839145e463",22886492,1,30,0,264,67,91,24
"e20db35ced8544ddac5bc3839145e463","00ae5f0c51874a73a41ebea838d95682",22886492,1,11,0,265,91,101,10
"00ae5f0c51874a73a41ebea838d95682","e20db35ced8544ddac5bc3839145e463",22886492,1,-11,0,266,101,91,-10
"e20db35ced8544ddac5bc3839145e463","d391c8b6e56a43a7b654e9dee02d904b",22886492,1,13,0,267,91,103,12
"d391c8b6e56a43a7b654e9dee02d904b","73039f8c1eb9409cb4caee2cf968001e",22886492,1,-3,0,268,103,100,-3
"73039f8c1eb9409cb4caee2cf968001e","4280927ec4d643238aa49c32f9e06c6c",22886492,1,10,0,269,100,109,9
"4280927ec4d643238aa49c32f9e06c6c","08111f75e22d409998cf8b85bd431f0a",22886492,1,-1,0,270,109,108,-1
"08111f75e22d409998cf8b85bd431f0a","a9ae0a3c070d455bb4369a8996313336",22886492,1,7,0,271,108,114,6
"a9ae0a3c070d455bb4369a8996313336","37319e88176d4aefa91d7a9980dbae91",22886492,1,-2,0,272,114,112,-2
"37319e88176d4aefa91d7a9980dbae91","62bff51286ef4f348717a3cf6fe2318f",22886492,1,9,0,273,112,120,8
"62bff51286ef4f348717a3cf6fe2318f","779f9ddd1fd14d1e9e69f72219a1fdbd",22886492,1,3,0,274,120,121,1
"779f9ddd1fd14d1e9e69f72219a1fdbd","e20db35ced8544ddac5bc3839145e463",22886492,3,-36,0,275,121,91,-30
"e20db35ced8544ddac5bc3839145e463","779f9ddd1fd14d1e9e69f72219a1fdbd",22886492,2,36,0,276,91,121,30
"e20db35ced8544ddac5bc3839145e463","a8dd5213034441ac92724b4e83eb0bb2",22886492,1,45,0,278,91,129,38
"a8dd5213034441ac92724b4e83eb0bb2","779f9ddd1fd14d1e9e69f72219a1fdbd",22886492,1,-9,0,279,129,121,-8
"779f9ddd1fd14d1e9e69f72219a1fdbd","579338175e0b4bbb8ef3b712b5d8b54e",22886492,1,8,0,280,121,128,7
"579338175e0b4bbb8ef3b712b5d8b54e","b416d47c56a742199b5d7c7f19d6503a",22886492,1,7,0,281,128,134,6
"b416d47c56a742199b5d7c7f19d6503a","779f9ddd1fd14d1e9e69f72219a1fdbd",22886492,2,-15,0,282,134,121,-13
"779f9ddd1fd14d1e9e69f72219a1fdbd","df1de691dafe4549a18a4398ee9dfaf9",22886492,1,23,0,283,121,139,18
"df1de691dafe4549a18a4398ee9dfaf9","6c5ad271a44743479bfaea29b1db8d02",22886492,2,4,0,284,139,143,4
"6c5ad271a44743479bfaea29b1db8d02","df1de691dafe4549a18a4398ee9dfaf9",22886492,3,-4,0,285,143,139,-4
"df1de691dafe4549a18a4398ee9dfaf9","779f9ddd1fd14d1e9e69f72219a1fdbd",22886492,2,-23,0,288,139,121,-18
"779f9ddd1fd14d1e9e69f72219a1fdbd","f661500307d74c908e9207d949ceb4aa",22886492,1,18,0,289,121,136,15
"f661500307d74c908e9207d949ceb4aa","b416d47c56a742199b5d7c7f19d6503a",22886492,1,-3,0,290,136,134,-2
"b416d47c56a742199b5d7c7f19d6503a","a8dd5213034441ac92724b4e83eb0bb2",22886492,1,-6,0,291,134,129,-5
"a8dd5213034441ac92724b4e83eb0bb2","579338175e0b4bbb8ef3b712b5d8b54e",22886492,1,-1,0,292,129,128,-1
"579338175e0b4bbb8ef3b712b5d8b54e","779f9ddd1fd14d1e9e69f72219a1fdbd",22886492,1,-8,0,293,128,121,-7
"e20db35ced8544ddac5bc3839145e463","e20db35ced8544ddac5bc3839145e463",22886492,1,0,1,295,91,91,0
"779f9ddd1fd14d1e9e69f72219a1fdbd","62bff51286ef4f348717a3cf6fe2318f",22886492,1,-3,0,297,121,120,-1
"62bff51286ef4f348717a3cf6fe2318f","b416d47c56a742199b5d7c7f19d6503a",22886492,1,18,0,298,120,134,14
"b416d47c56a742199b5d7c7f19d6503a","b416d47c56a742199b5d7c7f19d6503a",22886492,1,0,1,299,134,134,0
"779f9ddd1fd14d1e9e69f72219a1fdbd","b416d47c56a742199b5d7c7f19d6503a",22886492,1,15,0,301,121,134,13
"b416d47c56a742199b5d7c7f19d6503a","df1de691dafe4549a18a4398ee9dfaf9",22886492,1,8,0,302,134,139,5
"779f9ddd1fd14d1e9e69f72219a1fdbd","6c5ad271a44743479bfaea29b1db8d02",22886492,1,27,0,304,121,143,22
"df1de691dafe4549a18a4398ee9dfaf9","8aae34f5ddbb4052a709b12e6b0d40fa",22886492,1,9,0,306,139,147,8
"8aae34f5ddbb4052a709b12e6b0d40fa","f902b0f41b544d4dbf79664fd233648d",22886492,1,-1,0,307,147,146,-1
"f902b0f41b544d4dbf79664fd233648d","d313cec988a84645bee413e8d4724a4b",22886492,1,14,0,308,146,158,12
"d313cec988a84645bee413e8d4724a4b","f03480cf4eba413194d7af52fc0e7f28",22886492,1,-7,0,309,158,152,-6
"f03480cf4eba413194d7af52fc0e7f28","df1de691dafe4549a18a4398ee9dfaf9",22886492,1,-15,0,310,152,139,-13
"df1de691dafe4549a18a4398ee9dfaf9","78adeee1fa2c4fe0bc73f7bca9fcee86",22886492,1,26,0,311,139,160,21
"78adeee1fa2c4fe0bc73f7bca9fcee86","65202579580f4ad38d734b4ee39d22a8",22886492,2,5,0,312,160,164,4
"65202579580f4ad38d734b4ee39d22a8","65202579580f4ad38d734b4ee39d22a8",22886492,6,0,1,313,164,164,0
"65202579580f4ad38d734b4ee39d22a8","78adeee1fa2c4fe0bc73f7bca9fcee86",22886492,2,-5,0,317,164,160,-4
"78adeee1fa2c4fe0bc73f7bca9fcee86","3cbcea2be0984e7dbd5a48195af10ce7",22886492,1,8,0,322,160,165,5
"3cbcea2be0984e7dbd5a48195af10ce7","82e6285962b8400d9d6fc32436022a94",22886492,1,2,0,323,165,167,2
"82e6285962b8400d9d6fc32436022a94","3cbcea2be0984e7dbd5a48195af10ce7",22886492,1,-2,0,324,167,165,-2
"3cbcea2be0984e7dbd5a48195af10ce7","a9ac840f098c4bd0a2ee896214ce29cd",22886492,1,5,0,325,165,168,3
"a9ac840f098c4bd0a2ee896214ce29cd","a9ac840f098c4bd0a2ee896214ce29cd",22886492,1,0,1,326,168,168,0
"a9ac840f098c4bd0a2ee896214ce29cd","0c7262dff33c4087bc660ccf40f92f9c",22886492,1,4,0,327,168,169,1
"0c7262dff33c4087bc660ccf40f92f9c","b2275c3fad834f8d90737a2d9a6927d6",22886492,1,3,0,328,169,172,3
"b2275c3fad834f8d90737a2d9a6927d6","b2275c3fad834f8d90737a2d9a6927d6",22886492,23,0,1,329,172,172,0
"b2275c3fad834f8d90737a2d9a6927d6","eb515a26030b41f8a82a1e6114420bad",22886492,1,1,0,352,172,173,1
"eb515a26030b41f8a82a1e6114420bad","eb515a26030b41f8a82a1e6114420bad",22886492,1,0,1,353,173,173,0
"67a089198fcb4e1c8f2385786c2b296f","b613861cecf84ffcab01afb23f660475",22887794,1,-72,0,1,39,1,-38
"b613861cecf84ffcab01afb23f660475","b613861cecf84ffcab01afb23f660475",22887794,4,0,1,2,1,1,0
"b613861cecf84ffcab01afb23f660475","e2911e79efc2420eac45d9f671463d4b",22887794,1,3,0,6,1,2,1
"519d1b8c59404d67b54e96c5c8a830b2","519d1b8c59404d67b54e96c5c8a830b2",22887794,1,0,1,10,3,3,0
"519d1b8c59404d67b54e96c5c8a830b2","e2911e79efc2420eac45d9f671463d4b",22887794,1,-1,0,11,3,2,-1
"e2911e79efc2420eac45d9f671463d4b","e2911e79efc2420eac45d9f671463d4b",22887794,4,0,1,12,2,2,0
"e2911e79efc2420eac45d9f671463d4b","519d1b8c59404d67b54e96c5c8a830b2",22887794,2,1,0,14,2,3,1
"519d1b8c59404d67b54e96c5c8a830b2","531db53f81f646edb0cdcfe0085b03b7",22887794,1,1,0,15,3,4,1
"531db53f81f646edb0cdcfe0085b03b7","531db53f81f646edb0cdcfe0085b03b7",22887794,2,0,1,16,4,4,0
"531db53f81f646edb0cdcfe0085b03b7","4f5f94b2f95141e0a9d53a61da2276da",22887794,1,1,0,18,4,5,1
"4f5f94b2f95141e0a9d53a61da2276da","4f5f94b2f95141e0a9d53a61da2276da",22887794,1,0,1,19,5,5,0
"4f5f94b2f95141e0a9d53a61da2276da","6d541c89590949f99af293c4f2333f67",22887794,1,1,0,20,5,6,1
"6d541c89590949f99af293c4f2333f67","6d541c89590949f99af293c4f2333f67",22887794,3,0,1,21,6,6,0
"6d541c89590949f99af293c4f2333f67","dd5cf0b9fe4c4f1d8f5ff8e4c04879cb",22887794,1,1,0,24,6,7,1
"dd5cf0b9fe4c4f1d8f5ff8e4c04879cb","dd5cf0b9fe4c4f1d8f5ff8e4c04879cb",22887794,1,0,1,25,7,7,0
"dd5cf0b9fe4c4f1d8f5ff8e4c04879cb","f96261861edc426abe2248be4f0a709a",22887794,1,1,0,26,7,8,1
"f96261861edc426abe2248be4f0a709a","f96261861edc426abe2248be4f0a709a",22887794,1,0,1,27,8,8,0
"f96261861edc426abe2248be4f0a709a","66b5e16f4f75454fb5b8172079f0fa83",22887794,1,1,0,28,8,9,1
"66b5e16f4f75454fb5b8172079f0fa83","66b5e16f4f75454fb5b8172079f0fa83",22887794,1,0,1,29,9,9,0
"66b5e16f4f75454fb5b8172079f0fa83","0680571d4698477995e41842c36a54b2",22887794,1,1,0,30,9,10,1
"0680571d4698477995e41842c36a54b2","0680571d4698477995e41842c36a54b2",22887794,1,0,1,31,10,10,0
"0680571d4698477995e41842c36a54b2","56586aa865414f538729c7f7735d2bc6",22887794,1,4,0,32,10,12,2
"56586aa865414f538729c7f7735d2bc6","e2911e79efc2420eac45d9f671463d4b",22887794,4,-12,0,33,12,2,-10
"e2911e79efc2420eac45d9f671463d4b","9112f2bffece48e08c6d2287be204085",22887794,1,9,0,34,2,11,9
"9112f2bffece48e08c6d2287be204085","56586aa865414f538729c7f7735d2bc6",22887794,1,3,0,35,11,12,1
"e2911e79efc2420eac45d9f671463d4b","56586aa865414f538729c7f7735d2bc6",22887794,3,12,0,37,2,12,10
"56586aa865414f538729c7f7735d2bc6","56586aa865414f538729c7f7735d2bc6",22887794,2,0,1,40,12,12,0
"56586aa865414f538729c7f7735d2bc6","b7f2b31585d94eb3bf86376714aa7070",22887794,5,2,0,42,12,13,1
"b7f2b31585d94eb3bf86376714aa7070","b7f2b31585d94eb3bf86376714aa7070",22887794,5,0,1,43,13,13,0
"b7f2b31585d94eb3bf86376714aa7070","3f1c815879794b929260d224becaff7e",22887794,3,2,0,44,13,14,1
"3f1c815879794b929260d224becaff7e","56586aa865414f538729c7f7735d2bc6",22887794,3,-4,0,45,14,12,-2
"b7f2b31585d94eb3bf86376714aa7070","56586aa865414f538729c7f7735d2bc6",22887794,2,-2,0,50,13,12,-1
"56586aa865414f538729c7f7735d2bc6","b7719e26494940efa49512aedd0aac79",22887794,1,17,0,62,12,20,8
"b7719e26494940efa49512aedd0aac79","b7719e26494940efa49512aedd0aac79",22887794,1,0,1,63,20,20,0
"b7719e26494940efa49512aedd0aac79","56586aa865414f538729c7f7735d2bc6",22887794,1,-17,0,64,20,12,-8
"56586aa865414f538729c7f7735d2bc6","eb2a0eb537344a9e891c761662e400b6",22887794,1,8,0,65,12,16,4
"eb2a0eb537344a9e891c761662e400b6","5c5ceeee4562457ba6d41515aeebfbb1",22887794,1,2,0,66,16,17,1
"5c5ceeee4562457ba6d41515aeebfbb1","5c5ceeee4562457ba6d41515aeebfbb1",22887794,1,0,1,67,17,17,0
"5c5ceeee4562457ba6d41515aeebfbb1","fab84b4fab5940efb4ea868ef8d09396",22887794,1,369,0,68,17,284,267
"fab84b4fab5940efb4ea868ef8d09396","56586aa865414f538729c7f7735d2bc6",22887794,1,-379,0,69,284,12,-272
"56586aa865414f538729c7f7735d2bc6","5c5ceeee4562457ba6d41515aeebfbb1",22887794,1,10,0,70,12,17,5
"5c5ceeee4562457ba6d41515aeebfbb1","56586aa865414f538729c7f7735d2bc6",22887794,1,-10,0,71,17,12,-5
"56586aa865414f538729c7f7735d2bc6","9afd71a5298d4333b6849dfce1b9422c",22887794,1,13,0,72,12,18,6
"9afd71a5298d4333b6849dfce1b9422c","9afd71a5298d4333b6849dfce1b9422c",22887794,1,0,1,73,18,18,0
"9afd71a5298d4333b6849dfce1b9422c","b7719e26494940efa49512aedd0aac79",22887794,1,4,0,74,18,20,2
"b7719e26494940efa49512aedd0aac79","d4f45188d3c84a02ba08454e6403a818",22887794,1,5,0,75,20,24,4
"d4f45188d3c84a02ba08454e6403a818","d4c3b003e8274e429d2fa688d73fde6d",22887794,1,-2,0,76,24,22,-2
"67a089198fcb4e1c8f2385786c2b296f","67a089198fcb4e1c8f2385786c2b296f",22890823,3,0,1,1,39,39,0
"67a089198fcb4e1c8f2385786c2b296f","e2911e79efc2420eac45d9f671463d4b",22890823,1,-69,0,2,39,2,-37
"e2911e79efc2420eac45d9f671463d4b","b613861cecf84ffcab01afb23f660475",22890823,1,-3,0,4,2,1,-1
"b613861cecf84ffcab01afb23f660475","b613861cecf84ffcab01afb23f660475",22890823,7,0,1,10,1,1,0
"b613861cecf84ffcab01afb23f660475","e2911e79efc2420eac45d9f671463d4b",22890823,1,3,0,11,1,2,1
"e2911e79efc2420eac45d9f671463d4b","9112f2bffece48e08c6d2287be204085",22890823,1,9,0,12,2,11,9
"9112f2bffece48e08c6d2287be204085","9112f2bffece48e08c6d2287be204085",22890823,2,0,1,13,11,11,0
"9112f2bffece48e08c6d2287be204085","0680571d4698477995e41842c36a54b2",22890823,1,-1,0,14,11,10,-1
"0680571d4698477995e41842c36a54b2","0680571d4698477995e41842c36a54b2",22890823,1,0,1,15,10,10,0
"0680571d4698477995e41842c36a54b2","e2911e79efc2420eac45d9f671463d4b",22890823,1,-8,0,16,10,2,-8
"e2911e79efc2420eac45d9f671463d4b","e2911e79efc2420eac45d9f671463d4b",22890823,2,0,1,17,2,2,0
"e2911e79efc2420eac45d9f671463d4b","519d1b8c59404d67b54e96c5c8a830b2",22890823,1,1,0,18,2,3,1
"519d1b8c59404d67b54e96c5c8a830b2","519d1b8c59404d67b54e96c5c8a830b2",22890823,1,0,1,19,3,3,0
"519d1b8c59404d67b54e96c5c8a830b2","531db53f81f646edb0cdcfe0085b03b7",22890823,1,1,0,20,3,4,1
"531db53f81f646edb0cdcfe0085b03b7","531db53f81f646edb0cdcfe0085b03b7",22890823,3,0,1,21,4,4,0
"531db53f81f646edb0cdcfe0085b03b7","4f5f94b2f95141e0a9d53a61da2276da",22890823,1,1,0,24,4,5,1
"4f5f94b2f95141e0a9d53a61da2276da","4f5f94b2f95141e0a9d53a61da2276da",22890823,1,0,1,25,5,5,0
"4f5f94b2f95141e0a9d53a61da2276da","6d541c89590949f99af293c4f2333f67",22890823,1,1,0,26,5,6,1
"6d541c89590949f99af293c4f2333f67","6d541c89590949f99af293c4f2333f67",22890823,1,0,1,27,6,6,0
"6d541c89590949f99af293c4f2333f67","dd5cf0b9fe4c4f1d8f5ff8e4c04879cb",22890823,1,1,0,28,6,7,1
"dd5cf0b9fe4c4f1d8f5ff8e4c04879cb","dd5cf0b9fe4c4f1d8f5ff8e4c04879cb",22890823,1,0,1,29,7,7,0
"dd5cf0b9fe4c4f1d8f5ff8e4c04879cb","f96261861edc426abe2248be4f0a709a",22890823,1,1,0,30,7,8,1
"f96261861edc426abe2248be4f0a709a","f96261861edc426abe2248be4f0a709a",22890823,1,0,1,31,8,8,0
"f96261861edc426abe2248be4f0a709a","66b5e16f4f75454fb5b8172079f0fa83",22890823,1,1,0,32,8,9,1
"66b5e16f4f75454fb5b8172079f0fa83","66b5e16f4f75454fb5b8172079f0fa83",22890823,1,0,1,33,9,9,0
"66b5e16f4f75454fb5b8172079f0fa83","9112f2bffece48e08c6d2287be204085",22890823,1,2,0,34,9,11,2
"9112f2bffece48e08c6d2287be204085","4f5f94b2f95141e0a9d53a61da2276da",22890823,1,-6,0,36,11,5,-6
"4f5f94b2f95141e0a9d53a61da2276da","56586aa865414f538729c7f7735d2bc6",22890823,1,9,0,37,5,12,7
"56586aa865414f538729c7f7735d2bc6","e2911e79efc2420eac45d9f671463d4b",22890823,1,-12,0,38,12,2,-10
"e2911e79efc2420eac45d9f671463d4b","56586aa865414f538729c7f7735d2bc6",22890823,1,12,0,39,2,12,10
"56586aa865414f538729c7f7735d2bc6","67a089198fcb4e1c8f2385786c2b296f",22890823,1,57,0,40,12,39,27
"67a089198fcb4e1c8f2385786c2b296f","64d48c6c9c7940639a932219a6c87198",22890823,3,1,0,42,39,40,1
"64d48c6c9c7940639a932219a6c87198","b613861cecf84ffcab01afb23f660475",22890823,1,-73,0,43,40,1,-39
"b613861cecf84ffcab01afb23f660475","67a089198fcb4e1c8f2385786c2b296f",22890823,1,72,0,45,1,39,38
"64d48c6c9c7940639a932219a6c87198","67a089198fcb4e1c8f2385786c2b296f",22890823,2,-1,0,47,40,39,-1
"67a089198fcb4e1c8f2385786c2b296f","3cbcea2be0984e7dbd5a48195af10ce7",22890823,1,160,0,48,39,165,126
"3cbcea2be0984e7dbd5a48195af10ce7","3cbcea2be0984e7dbd5a48195af10ce7",22890823,1,0,1,49,165,165,0
"3cbcea2be0984e7dbd5a48195af10ce7","82e6285962b8400d9d6fc32436022a94",22890823,1,2,0,50,165,167,2
"82e6285962b8400d9d6fc32436022a94","afbf7250b99d47bea07172749483ca97",22890823,1,-190,0,51,167,28,-139
"afbf7250b99d47bea07172749483ca97","4e51676dc72045d99c19b9fa7b22f8bc",22890823,1,3,0,52,28,29,1
"4e51676dc72045d99c19b9fa7b22f8bc","4e51676dc72045d99c19b9fa7b22f8bc",22890823,1,0,1,53,29,29,0
"4e51676dc72045d99c19b9fa7b22f8bc","51970cfa30e643e894e66ae85c8024cc",22890823,1,3,0,54,29,31,2
"51970cfa30e643e894e66ae85c8024cc","c33c17be71ae4d588da7369472e5bb1b",22890823,1,6,0,55,31,34,3
"c33c17be71ae4d588da7369472e5bb1b","4e51676dc72045d99c19b9fa7b22f8bc",22890823,1,-9,0,56,34,29,-5
"4e51676dc72045d99c19b9fa7b22f8bc","c33c17be71ae4d588da7369472e5bb1b",22890823,1,9,0,57,29,34,5
"c33c17be71ae4d588da7369472e5bb1b","c33c17be71ae4d588da7369472e5bb1b",22890823,1,0,1,58,34,34,0
"c33c17be71ae4d588da7369472e5bb1b","93679be414554a11b1893002f2229a93",22890823,1,3,0,59,34,35,1
"93679be414554a11b1893002f2229a93","93679be414554a11b1893002f2229a93",22890823,1,0,1,60,35,35,0
"93679be414554a11b1893002f2229a93","7040a13096d746ac84b8fac8d9752058",22890823,1,3,0,61,35,36,1
"7040a13096d746ac84b8fac8d9752058","7040a13096d746ac84b8fac8d9752058",22890823,1,0,1,62,36,36,0
"7040a13096d746ac84b8fac8d9752058","9a0dc646f934470daf08c4b56ccf73db",22890823,1,3,0,63,36,37,1
"9a0dc646f934470daf08c4b56ccf73db","9a0dc646f934470daf08c4b56ccf73db",22890823,1,0,1,64,37,37,0
"9a0dc646f934470daf08c4b56ccf73db","fc0e049d56024bc9a02c9a9c435c3df7",22890823,1,3,0,65,37,38,1
"fc0e049d56024bc9a02c9a9c435c3df7","fc0e049d56024bc9a02c9a9c435c3df7",22890823,1,0,1,66,38,38,0
"fc0e049d56024bc9a02c9a9c435c3df7","67a089198fcb4e1c8f2385786c2b296f",22890823,1,4,0,67,38,39,1
"64d48c6c9c7940639a932219a6c87198","64d48c6c9c7940639a932219a6c87198",22890823,4,0,1,69,40,40,0
"64d48c6c9c7940639a932219a6c87198","b534b89233134e30a9b5645138bfa9ee",22890823,1,3,0,70,40,41,1
"b534b89233134e30a9b5645138bfa9ee","67a089198fcb4e1c8f2385786c2b296f",22890823,1,-4,0,71,41,39,-2
"67a089198fcb4e1c8f2385786c2b296f","b534b89233134e30a9b5645138bfa9ee",22890823,2,4,0,73,39,41,2
"b534b89233134e30a9b5645138bfa9ee","64d48c6c9c7940639a932219a6c87198",22890823,1,-3,0,74,41,40,-1
"b534b89233134e30a9b5645138bfa9ee","0e37b720d23b4e7f8b313e79313fd107",22890823,1,3,0,80,41,44,3
"0e37b720d23b4e7f8b313e79313fd107","0e37b720d23b4e7f8b313e79313fd107",22890823,1,0,1,81,44,44,0
"0e37b720d23b4e7f8b313e79313fd107","6875d67fdd5f48168b62719df449bebd",22890823,1,1,0,82,44,45,1
"6875d67fdd5f48168b62719df449bebd","6875d67fdd5f48168b62719df449bebd",22890823,1,0,1,83,45,45,0
"6875d67fdd5f48168b62719df449bebd","b534b89233134e30a9b5645138bfa9ee",22890823,1,-4,0,84,45,41,-4
"b534b89233134e30a9b5645138bfa9ee","6e13d61a7bdb44bca949c9f86fab3be5",22890823,3,7,0,85,41,47,6
"6e13d61a7bdb44bca949c9f86fab3be5","b534b89233134e30a9b5645138bfa9ee",22890823,2,-7,0,86,47,41,-6
"b534b89233134e30a9b5645138bfa9ee","b534b89233134e30a9b5645138bfa9ee",22890823,1,0,1,89,41,41,0
"6e13d61a7bdb44bca949c9f86fab3be5","6e13d61a7bdb44bca949c9f86fab3be5",22890823,1,0,1,91,47,47,0
"6e13d61a7bdb44bca949c9f86fab3be5","195f78799f984cc2b06c48dfe36be751",22890823,1,2,0,92,47,49,2
"195f78799f984cc2b06c48dfe36be751","195f78799f984cc2b06c48dfe36be751",22890823,2,0,1,93,49,49,0
"195f78799f984cc2b06c48dfe36be751","d9c8d8c444a64dadbbb508652c721e17",22890823,1,-3,0,95,49,46,-3
"d9c8d8c444a64dadbbb508652c721e17","d0c74f735e024943943e40333d6d337f",22890823,1,6,0,96,46,51,5
"d0c74f735e024943943e40333d6d337f","d0c74f735e024943943e40333d6d337f",22890823,1,0,1,97,51,51,0
"d0c74f735e024943943e40333d6d337f","983f8ff320594b279a7f4a6fe132f9c5",22890823,1,2,0,98,51,53,2
"983f8ff320594b279a7f4a6fe132f9c5","983f8ff320594b279a7f4a6fe132f9c5",22890823,2,0,1,100,53,53,0
"983f8ff320594b279a7f4a6fe132f9c5","35adfa5d923046aebabfefd98f35ff05",22890823,1,1,0,101,53,54,1
"35adfa5d923046aebabfefd98f35ff05","35adfa5d923046aebabfefd98f35ff05",22890823,8,0,1,102,54,54,0
"35adfa5d923046aebabfefd98f35ff05","b6f8a98476224da1b40e555ececc7ed8",22890823,1,1,0,110,54,55,1
"b6f8a98476224da1b40e555ececc7ed8","b6f8a98476224da1b40e555ececc7ed8",22890823,2,0,1,111,55,55,0
"b6f8a98476224da1b40e555ececc7ed8","86e22cb5fe0e4b47a9489ecddf7ed78f",22890823,1,1,0,113,55,56,1
"86e22cb5fe0e4b47a9489ecddf7ed78f","86e22cb5fe0e4b47a9489ecddf7ed78f",22890823,2,0,1,114,56,56,0
"86e22cb5fe0e4b47a9489ecddf7ed78f","f924752d8a1149668870b1e7698486f7",22890823,1,-6,0,116,56,50,-6
"f924752d8a1149668870b1e7698486f7","78f30e4dcac84e3cbea8b2cc6e0d62b3",22890823,1,10,0,117,50,59,9
"78f30e4dcac84e3cbea8b2cc6e0d62b3","a1f2f12debe5432fb7a70bcd12bacfb9",22890823,1,-1,0,118,59,58,-1
"a1f2f12debe5432fb7a70bcd12bacfb9","a1f2f12debe5432fb7a70bcd12bacfb9",22890823,17,0,1,119,58,58,0
"a1f2f12debe5432fb7a70bcd12bacfb9","78f30e4dcac84e3cbea8b2cc6e0d62b3",22890823,1,1,0,136,58,59,1
"78f30e4dcac84e3cbea8b2cc6e0d62b3","78f30e4dcac84e3cbea8b2cc6e0d62b3",22890823,16,0,1,137,59,59,0
"78f30e4dcac84e3cbea8b2cc6e0d62b3","12aa6e1672ac4e7aa6449a7a8609cd72",22890823,1,-2,0,153,59,57,-2
"12aa6e1672ac4e7aa6449a7a8609cd72","a0a418b8540d479fa6e0f653b701da8b",22890823,1,8,0,154,57,64,7
"a0a418b8540d479fa6e0f653b701da8b","bc42d26810654ea9a1df1efe1e58c7d5",22890823,1,-1,0,155,64,63,-1
"bc42d26810654ea9a1df1efe1e58c7d5","4c943503763e4e349906eea3ed3c8e86",22890823,1,-2,0,156,63,61,-2
"4c943503763e4e349906eea3ed3c8e86","4c943503763e4e349906eea3ed3c8e86",22890823,2,0,1,157,61,61,0
"4c943503763e4e349906eea3ed3c8e86","bc42d26810654ea9a1df1efe1e58c7d5",22890823,1,2,0,159,61,63,2
"bc42d26810654ea9a1df1efe1e58c7d5","bc42d26810654ea9a1df1efe1e58c7d5",22890823,3,0,1,160,63,63,0
"bc42d26810654ea9a1df1efe1e58c7d5","a0a418b8540d479fa6e0f653b701da8b",22890823,1,1,0,163,63,64,1
"a0a418b8540d479fa6e0f653b701da8b","a0a418b8540d479fa6e0f653b701da8b",22890823,3,0,1,164,64,64,0
"a0a418b8540d479fa6e0f653b701da8b","309ccf3cc4fe429d9bfbaef53d3fa479",22890823,1,-4,0,167,64,60,-4
"309ccf3cc4fe429d9bfbaef53d3fa479","b534b89233134e30a9b5645138bfa9ee",22890823,1,-23,0,168,60,41,-19
"b534b89233134e30a9b5645138bfa9ee","d646286c8051419bbc2e31dd1db55ca8",22890823,1,33,0,169,41,67,26
"d646286c8051419bbc2e31dd1db55ca8","267f883678b24aed855fde42524975d9",22890823,1,4,0,170,67,71,4
"267f883678b24aed855fde42524975d9","267f883678b24aed855fde42524975d9",22890823,1,0,1,171,71,71,0
"267f883678b24aed855fde42524975d9","88fff56d0342490dbef9040750a20f6c",22890823,1,1,0,172,71,72,1
"88fff56d0342490dbef9040750a20f6c","88fff56d0342490dbef9040750a20f6c",22890823,1,0,1,173,72,72,0
"88fff56d0342490dbef9040750a20f6c","adb17b12b66c4a49a85fd34322f7df70",22890823,1,1,0,174,72,73,1
"adb17b12b66c4a49a85fd34322f7df70","adb17b12b66c4a49a85fd34322f7df70",22890823,1,0,1,175,73,73,0
"adb17b12b66c4a49a85fd34322f7df70","d646286c8051419bbc2e31dd1db55ca8",22890823,1,-6,0,176,73,67,-6
"d646286c8051419bbc2e31dd1db55ca8","a2becd407db34b189200a32546d9d569",22890823,2,9,0,177,67,75,8
"a2becd407db34b189200a32546d9d569","58c22b011d0f4c2ea6d13615edbb9eeb",22890823,1,2,0,178,75,77,2
"58c22b011d0f4c2ea6d13615edbb9eeb","58c22b011d0f4c2ea6d13615edbb9eeb",22890823,8,0,1,179,77,77,0
"58c22b011d0f4c2ea6d13615edbb9eeb","dd76e1861dc9461c830888729d091ee0",22890823,1,1,0,187,77,78,1
"dd76e1861dc9461c830888729d091ee0","dd76e1861dc9461c830888729d091ee0",22890823,2,0,1,188,78,78,0
"dd76e1861dc9461c830888729d091ee0","cd1d828f1a694b87913a7ea66c23803e",22890823,1,1,0,190,78,79,1
"cd1d828f1a694b87913a7ea66c23803e","cd1d828f1a694b87913a7ea66c23803e",22890823,2,0,1,191,79,79,0
"cd1d828f1a694b87913a7ea66c23803e","9176a3c2b4d2465fa8b0c67096c2a97e",22890823,1,1,0,193,79,80,1
"9176a3c2b4d2465fa8b0c67096c2a97e","9176a3c2b4d2465fa8b0c67096c2a97e",22890823,5,0,1,194,80,80,0
"9176a3c2b4d2465fa8b0c67096c2a97e","f8ec6445f7194e25b9101d4fbcb07a18",22890823,1,1,0,199,80,81,1
"f8ec6445f7194e25b9101d4fbcb07a18","f8ec6445f7194e25b9101d4fbcb07a18",22890823,2,0,1,200,81,81,0
"f8ec6445f7194e25b9101d4fbcb07a18","140d5b27b8574befad82c0a013b59dfa",22890823,1,-7,0,202,81,74,-7
"140d5b27b8574befad82c0a013b59dfa","d18a9ea32855445f8736581f5cb119ce",22890823,1,9,0,203,74,82,8
"d18a9ea32855445f8736581f5cb119ce","f564483cbd7a407681aa2fcca518cf5f",22890823,1,4,0,204,82,85,3
"f564483cbd7a407681aa2fcca518cf5f","f564483cbd7a407681aa2fcca518cf5f",22890823,1,0,1,205,85,85,0
"f564483cbd7a407681aa2fcca518cf5f","18fd01350bd5434ca636d59a599d768a",22890823,1,1,0,206,85,86,1
"18fd01350bd5434ca636d59a599d768a","18fd01350bd5434ca636d59a599d768a",22890823,9,0,1,207,86,86,0
"18fd01350bd5434ca636d59a599d768a","ae5ac430ea254e708a6f5deaaf7464ae",22890823,1,-2,0,216,86,84,-2
"ae5ac430ea254e708a6f5deaaf7464ae","6a9f0ef185fb47f0937e29daa1c71ed5",22890823,1,7,0,217,84,90,6
"6a9f0ef185fb47f0937e29daa1c71ed5","c681290961c94c4caf23b529d1ae6b9a",22890823,1,-2,0,218,90,88,-2
"c681290961c94c4caf23b529d1ae6b9a","c681290961c94c4caf23b529d1ae6b9a",22890823,1,0,1,219,88,88,0
"c681290961c94c4caf23b529d1ae6b9a","6a9f0ef185fb47f0937e29daa1c71ed5",22890823,1,2,0,220,88,90,2
"6a9f0ef185fb47f0937e29daa1c71ed5","6a9f0ef185fb47f0937e29daa1c71ed5",22890823,5,0,1,221,90,90,0
"6a9f0ef185fb47f0937e29daa1c71ed5","d646286c8051419bbc2e31dd1db55ca8",22890823,1,-27,0,224,90,67,-23
"d646286c8051419bbc2e31dd1db55ca8","e20db35ced8544ddac5bc3839145e463",22890823,2,30,0,225,67,91,24
"e20db35ced8544ddac5bc3839145e463","1febb706d7a34005ae8711ed49c76e64",22890823,1,3,0,226,91,94,3
"1febb706d7a34005ae8711ed49c76e64","1febb706d7a34005ae8711ed49c76e64",22890823,5,0,1,227,94,94,0
"1febb706d7a34005ae8711ed49c76e64","8f73ba6f5a0042f2850356ac38ac6f24",22890823,1,1,0,232,94,95,1
"8f73ba6f5a0042f2850356ac38ac6f24","8f73ba6f5a0042f2850356ac38ac6f24",22890823,5,0,1,233,95,95,0
"8f73ba6f5a0042f2850356ac38ac6f24","e2260b86653c46d7b14a41fb419dbf8c",22890823,1,1,0,238,95,96,1
"e2260b86653c46d7b14a41fb419dbf8c","e2260b86653c46d7b14a41fb419dbf8c",22890823,2,0,1,239,96,96,0
"e2260b86653c46d7b14a41fb419dbf8c","35eb641ad1d845bbba54915bce75a962",22890823,1,1,0,241,96,97,1
"35eb641ad1d845bbba54915bce75a962","35eb641ad1d845bbba54915bce75a962",22890823,5,0,1,242,97,97,0
"35eb641ad1d845bbba54915bce75a962","08be90ffbeea4795a138cd42ed8db56f",22890823,1,1,0,247,97,98,1
"08be90ffbeea4795a138cd42ed8db56f","08be90ffbeea4795a138cd42ed8db56f",22890823,2,0,1,248,98,98,0
"08be90ffbeea4795a138cd42ed8db56f","3007433c8f584dcbb5ac159c1c5f2be3",22890823,1,1,0,250,98,99,1
"3007433c8f584dcbb5ac159c1c5f2be3","3007433c8f584dcbb5ac159c1c5f2be3",22890823,3,0,1,251,99,99,0
"3007433c8f584dcbb5ac159c1c5f2be3","00ae5f0c51874a73a41ebea838d95682",22890823,2,3,0,253,99,101,2
"00ae5f0c51874a73a41ebea838d95682","e20db35ced8544ddac5bc3839145e463",22890823,2,-11,0,254,101,91,-10
"e20db35ced8544ddac5bc3839145e463","d391c8b6e56a43a7b654e9dee02d904b",22890823,2,13,0,255,91,103,12
"d391c8b6e56a43a7b654e9dee02d904b","00ae5f0c51874a73a41ebea838d95682",22890823,1,-2,0,256,103,101,-2
"00ae5f0c51874a73a41ebea838d95682","00ae5f0c51874a73a41ebea838d95682",22890823,1,0,1,257,101,101,0
"00ae5f0c51874a73a41ebea838d95682","d391c8b6e56a43a7b654e9dee02d904b",22890823,1,2,0,258,101,103,2
"d391c8b6e56a43a7b654e9dee02d904b","d391c8b6e56a43a7b654e9dee02d904b",22890823,15,0,1,259,103,103,0
"d391c8b6e56a43a7b654e9dee02d904b","6111116566fc4fd9abba409322bea245",22890823,1,1,0,274,103,104,1
"6111116566fc4fd9abba409322bea245","6111116566fc4fd9abba409322bea245",22890823,2,0,1,275,104,104,0
"6111116566fc4fd9abba409322bea245","a81b2235cb9c499eb9ea8ee0a8dd9725",22890823,1,1,0,277,104,105,1
"a81b2235cb9c499eb9ea8ee0a8dd9725","a81b2235cb9c499eb9ea8ee0a8dd9725",22890823,5,0,1,278,105,105,0
"a81b2235cb9c499eb9ea8ee0a8dd9725","2d4e0ab0ef3b4d73b82c72d4621a7579",22890823,1,1,0,283,105,106,1
"2d4e0ab0ef3b4d73b82c72d4621a7579","2d4e0ab0ef3b4d73b82c72d4621a7579",22890823,2,0,1,284,106,106,0
"2d4e0ab0ef3b4d73b82c72d4621a7579","8bdebf492ebd4e62b0d522e8ab5e5197",22890823,1,1,0,286,106,107,1
"8bdebf492ebd4e62b0d522e8ab5e5197","8bdebf492ebd4e62b0d522e8ab5e5197",22890823,2,0,1,287,107,107,0
"8bdebf492ebd4e62b0d522e8ab5e5197","4280927ec4d643238aa49c32f9e06c6c",22890823,1,3,0,289,107,109,2
"4280927ec4d643238aa49c32f9e06c6c","73039f8c1eb9409cb4caee2cf968001e",22890823,2,-10,0,290,109,100,-9
"73039f8c1eb9409cb4caee2cf968001e","e20db35ced8544ddac5bc3839145e463",22890823,1,-10,0,291,100,91,-9
"e20db35ced8544ddac5bc3839145e463","4280927ec4d643238aa49c32f9e06c6c",22890823,1,20,0,292,91,109,18
"4280927ec4d643238aa49c32f9e06c6c","4280927ec4d643238aa49c32f9e06c6c",22890823,1,0,1,293,109,109,0
"4280927ec4d643238aa49c32f9e06c6c","fc44e6a5f7654430af1227838224dceb",22890823,1,2,0,294,109,111,2
"fc44e6a5f7654430af1227838224dceb","fc44e6a5f7654430af1227838224dceb",22890823,2,0,1,295,111,111,0
"fc44e6a5f7654430af1227838224dceb","08111f75e22d409998cf8b85bd431f0a",22890823,1,-3,0,297,111,108,-3
"08111f75e22d409998cf8b85bd431f0a","a9ae0a3c070d455bb4369a8996313336",22890823,2,7,0,298,108,114,6
"a9ae0a3c070d455bb4369a8996313336","a9ae0a3c070d455bb4369a8996313336",22890823,1,0,1,299,114,114,0
"a9ae0a3c070d455bb4369a8996313336","e20db35ced8544ddac5bc3839145e463",22890823,1,-26,0,300,114,91,-23
"e20db35ced8544ddac5bc3839145e463","a9ae0a3c070d455bb4369a8996313336",22890823,2,26,0,301,91,114,23
"a9ae0a3c070d455bb4369a8996313336","71cec822bcff4f30a20e75dc63ef7b65",22890823,2,2,0,302,114,116,2
"71cec822bcff4f30a20e75dc63ef7b65","71cec822bcff4f30a20e75dc63ef7b65",22890823,8,0,1,303,116,116,0
"71cec822bcff4f30a20e75dc63ef7b65","e20db35ced8544ddac5bc3839145e463",22890823,1,-28,0,310,116,91,-25
"a9ae0a3c070d455bb4369a8996313336","37319e88176d4aefa91d7a9980dbae91",22890823,1,-2,0,312,114,112,-2
"37319e88176d4aefa91d7a9980dbae91","4280927ec4d643238aa49c32f9e06c6c",22890823,1,-4,0,313,112,109,-3
"4280927ec4d643238aa49c32f9e06c6c","08111f75e22d409998cf8b85bd431f0a",22890823,1,-1,0,314,109,108,-1
"71cec822bcff4f30a20e75dc63ef7b65","37319e88176d4aefa91d7a9980dbae91",22890823,2,-4,0,318,116,112,-4
"37319e88176d4aefa91d7a9980dbae91","62bff51286ef4f348717a3cf6fe2318f",22890823,2,9,0,319,112,120,8
"62bff51286ef4f348717a3cf6fe2318f","3ec3a3563847406fa73338f9e9999cf3",22890823,1,-3,0,320,120,117,-3
"3ec3a3563847406fa73338f9e9999cf3","a9ae0a3c070d455bb4369a8996313336",22890823,1,-4,0,321,117,114,-3
"a9ae0a3c070d455bb4369a8996313336","4280927ec4d643238aa49c32f9e06c6c",22890823,1,-6,0,322,114,109,-5
"4280927ec4d643238aa49c32f9e06c6c","37319e88176d4aefa91d7a9980dbae91",22890823,1,4,0,323,109,112,3
"37319e88176d4aefa91d7a9980dbae91","00ae5f0c51874a73a41ebea838d95682",22890823,1,-13,0,324,112,101,-11
"00ae5f0c51874a73a41ebea838d95682","08111f75e22d409998cf8b85bd431f0a",22890823,1,8,0,325,101,108,7
"08111f75e22d409998cf8b85bd431f0a","d391c8b6e56a43a7b654e9dee02d904b",22890823,1,-6,0,326,108,103,-5
"d391c8b6e56a43a7b654e9dee02d904b","73039f8c1eb9409cb4caee2cf968001e",22890823,1,-3,0,327,103,100,-3
"73039f8c1eb9409cb4caee2cf968001e","d646286c8051419bbc2e31dd1db55ca8",22890823,1,-40,0,328,100,67,-33
"e20db35ced8544ddac5bc3839145e463","6a9f0ef185fb47f0937e29daa1c71ed5",22890823,1,-3,0,330,91,90,-1
"6a9f0ef185fb47f0937e29daa1c71ed5","140d5b27b8574befad82c0a013b59dfa",22890823,1,-19,0,333,90,74,-16
"140d5b27b8574befad82c0a013b59dfa","d646286c8051419bbc2e31dd1db55ca8",22890823,1,-8,0,334,74,67,-7
"a2becd407db34b189200a32546d9d569","9176a3c2b4d2465fa8b0c67096c2a97e",22890823,1,5,0,336,75,80,5
"9176a3c2b4d2465fa8b0c67096c2a97e","56586aa865414f538729c7f7735d2bc6",22890823,1,-108,0,337,80,12,-68
"56586aa865414f538729c7f7735d2bc6","56586aa865414f538729c7f7735d2bc6",22890823,3,0,1,338,12,12,0
"56586aa865414f538729c7f7735d2bc6","b7f2b31585d94eb3bf86376714aa7070",22890823,1,2,0,341,12,13,1
"b7f2b31585d94eb3bf86376714aa7070","b7f2b31585d94eb3bf86376714aa7070",22890823,1,0,1,342,13,13,0
"b7f2b31585d94eb3bf86376714aa7070","3f1c815879794b929260d224becaff7e",22890823,1,2,0,343,13,14,1
"3f1c815879794b929260d224becaff7e","5c5ceeee4562457ba6d41515aeebfbb1",22890823,1,6,0,344,14,17,3
"5c5ceeee4562457ba6d41515aeebfbb1","81c864a886d54a6b8ff85f7d736f4f95",22890823,1,-4,0,345,17,15,-2
"81c864a886d54a6b8ff85f7d736f4f95","9afd71a5298d4333b6849dfce1b9422c",22890823,1,7,0,346,15,18,3
"9afd71a5298d4333b6849dfce1b9422c","56586aa865414f538729c7f7735d2bc6",22890823,1,-13,0,347,18,12,-6
"56586aa865414f538729c7f7735d2bc6","e20db35ced8544ddac5bc3839145e463",22890823,1,124,0,348,12,91,79
"e20db35ced8544ddac5bc3839145e463","3007433c8f584dcbb5ac159c1c5f2be3",22890823,1,8,0,349,91,99,8
"d391c8b6e56a43a7b654e9dee02d904b","4280927ec4d643238aa49c32f9e06c6c",22890823,1,7,0,354,103,109,6
"73039f8c1eb9409cb4caee2cf968001e","a9ae0a3c070d455bb4369a8996313336",22890823,1,16,0,356,100,114,14
"a9ae0a3c070d455bb4369a8996313336","08111f75e22d409998cf8b85bd431f0a",22890823,1,-7,0,357,114,108,-6
"08111f75e22d409998cf8b85bd431f0a","71cec822bcff4f30a20e75dc63ef7b65",22890823,1,9,0,358,108,116,8
"62bff51286ef4f348717a3cf6fe2318f","b1cd0e7dc3ad4a8eb91a4bfdbeb025b0",22890823,1,-2,0,361,120,118,-2
"b1cd0e7dc3ad4a8eb91a4bfdbeb025b0","b1cd0e7dc3ad4a8eb91a4bfdbeb025b0",22890823,1,0,1,362,118,118,0
"b1cd0e7dc3ad4a8eb91a4bfdbeb025b0","62bff51286ef4f348717a3cf6fe2318f",22890823,1,2,0,363,118,120,2
"62bff51286ef4f348717a3cf6fe2318f","62bff51286ef4f348717a3cf6fe2318f",22890823,3,0,1,364,120,120,0
"62bff51286ef4f348717a3cf6fe2318f","e20db35ced8544ddac5bc3839145e463",22890823,1,-33,0,367,120,91,-29
"e20db35ced8544ddac5bc3839145e463","779f9ddd1fd14d1e9e69f72219a1fdbd",22890823,1,36,0,368,91,121,30
"779f9ddd1fd14d1e9e69f72219a1fdbd","ae26e6cda8ad4a3f81bd347560d9579f",22890823,1,4,0,369,121,125,4
"ae26e6cda8ad4a3f81bd347560d9579f","ae26e6cda8ad4a3f81bd347560d9579f",22890823,1,0,1,370,125,125,0
"ae26e6cda8ad4a3f81bd347560d9579f","ee48df95832b4374aa273ceb27ec1315",22890823,1,1,0,371,125,126,1
"ee48df95832b4374aa273ceb27ec1315","ee48df95832b4374aa273ceb27ec1315",22890823,1,0,1,372,126,126,0
"ee48df95832b4374aa273ceb27ec1315","7a439da90b394756ad1777fc4c6dead5",22890823,1,1,0,373,126,127,1
"7a439da90b394756ad1777fc4c6dead5","7a439da90b394756ad1777fc4c6dead5",22890823,1,0,1,374,127,127,0
"7a439da90b394756ad1777fc4c6dead5","779f9ddd1fd14d1e9e69f72219a1fdbd",22890823,1,-6,0,375,127,121,-6
"779f9ddd1fd14d1e9e69f72219a1fdbd","a8dd5213034441ac92724b4e83eb0bb2",22890823,4,9,0,376,121,129,8
"a8dd5213034441ac92724b4e83eb0bb2","779f9ddd1fd14d1e9e69f72219a1fdbd",22890823,3,-9,0,377,129,121,-8
"779f9ddd1fd14d1e9e69f72219a1fdbd","779f9ddd1fd14d1e9e69f72219a1fdbd",22890823,1,0,1,380,121,121,0
"a8dd5213034441ac92724b4e83eb0bb2","8115eab6556b45f5b415c3b8c26a12e5",22890823,1,2,0,384,129,131,2
"8115eab6556b45f5b415c3b8c26a12e5","8115eab6556b45f5b415c3b8c26a12e5",22890823,2,0,1,385,131,131,0
"8115eab6556b45f5b415c3b8c26a12e5","ec34b06efd844b46a4c4818ecdb9b8f4",22890823,1,1,0,387,131,132,1
"ec34b06efd844b46a4c4818ecdb9b8f4","ec34b06efd844b46a4c4818ecdb9b8f4",22890823,2,0,1,388,132,132,0
"ec34b06efd844b46a4c4818ecdb9b8f4","c2e1c2b9eac64109b343a088584b576b",22890823,1,1,0,390,132,133,1
"c2e1c2b9eac64109b343a088584b576b","c2e1c2b9eac64109b343a088584b576b",22890823,2,0,1,391,133,133,0
"c2e1c2b9eac64109b343a088584b576b","579338175e0b4bbb8ef3b712b5d8b54e",22890823,1,-5,0,393,133,128,-5
"579338175e0b4bbb8ef3b712b5d8b54e","8bc5795d6a984a3eace4e2811e52dd4f",22890823,1,8,0,394,128,135,7
"8bc5795d6a984a3eace4e2811e52dd4f","8bc5795d6a984a3eace4e2811e52dd4f",22890823,2,0,1,395,135,135,0
"8bc5795d6a984a3eace4e2811e52dd4f","b416d47c56a742199b5d7c7f19d6503a",22890823,1,-1,0,397,135,134,-1
"b416d47c56a742199b5d7c7f19d6503a","cd4532ad48034873ba8bce2aac0c9808",22890823,1,4,0,398,134,137,3
"cd4532ad48034873ba8bce2aac0c9808","cd4532ad48034873ba8bce2aac0c9808",22890823,1,0,1,399,137,137,0
"cd4532ad48034873ba8bce2aac0c9808","779f9ddd1fd14d1e9e69f72219a1fdbd",22890823,1,-19,0,400,137,121,-16
"779f9ddd1fd14d1e9e69f72219a1fdbd","df1de691dafe4549a18a4398ee9dfaf9",22890823,1,23,0,401,121,139,18
"df1de691dafe4549a18a4398ee9dfaf9","6c5ad271a44743479bfaea29b1db8d02",22890823,3,4,0,402,139,143,4
"6c5ad271a44743479bfaea29b1db8d02","df1de691dafe4549a18a4398ee9dfaf9",22890823,1,-4,0,403,143,139,-4
"6c5ad271a44743479bfaea29b1db8d02","6c5ad271a44743479bfaea29b1db8d02",22890823,1,0,1,405,143,143,0
"6c5ad271a44743479bfaea29b1db8d02","83d311bed5374fee83d8d67a7d9d82dc",22890823,1,1,0,406,143,144,1
"83d311bed5374fee83d8d67a7d9d82dc","83d311bed5374fee83d8d67a7d9d82dc",22890823,1,0,1,407,144,144,0
"83d311bed5374fee83d8d67a7d9d82dc","402bba41861d43acb52a5abb89e8831e",22890823,1,1,0,408,144,145,1
"402bba41861d43acb52a5abb89e8831e","402bba41861d43acb52a5abb89e8831e",22890823,5,0,1,409,145,145,0
"402bba41861d43acb52a5abb89e8831e","df1de691dafe4549a18a4398ee9dfaf9",22890823,1,-6,0,414,145,139,-6
"df1de691dafe4549a18a4398ee9dfaf9","8aae34f5ddbb4052a709b12e6b0d40fa",22890823,4,9,0,415,139,147,8
"8aae34f5ddbb4052a709b12e6b0d40fa","df1de691dafe4549a18a4398ee9dfaf9",22890823,4,-9,0,416,147,139,-8
"6c5ad271a44743479bfaea29b1db8d02","8aae34f5ddbb4052a709b12e6b0d40fa",22890823,1,5,0,418,143,147,4
"df1de691dafe4549a18a4398ee9dfaf9","df1de691dafe4549a18a4398ee9dfaf9",22890823,1,0,1,420,139,139,0
"8aae34f5ddbb4052a709b12e6b0d40fa","645b3f0249f64f76af2e19eb4d0e55b7",22890823,1,2,0,426,147,149,2
"645b3f0249f64f76af2e19eb4d0e55b7","645b3f0249f64f76af2e19eb4d0e55b7",22890823,6,0,1,427,149,149,0
"645b3f0249f64f76af2e19eb4d0e55b7","7e7b8db5064d4369805ab370aac5ddfb",22890823,1,1,0,433,149,150,1
"7e7b8db5064d4369805ab370aac5ddfb","7e7b8db5064d4369805ab370aac5ddfb",22890823,8,0,1,434,150,150,0
"7e7b8db5064d4369805ab370aac5ddfb","8956d210ae7f41968fada86d4c979d6a",22890823,1,1,0,442,150,151,1
"8956d210ae7f41968fada86d4c979d6a","8956d210ae7f41968fada86d4c979d6a",22890823,2,0,1,443,151,151,0
"8956d210ae7f41968fada86d4c979d6a","f902b0f41b544d4dbf79664fd233648d",22890823,1,-5,0,445,151,146,-5
"f902b0f41b544d4dbf79664fd233648d","ae781e8b775e4ccd93bc800dad5c8376",22890823,1,8,0,446,146,153,7
"ae781e8b775e4ccd93bc800dad5c8376","ae781e8b775e4ccd93bc800dad5c8376",22890823,2,0,1,447,153,153,0
"ae781e8b775e4ccd93bc800dad5c8376","06882a8492d9499aa31555567f575ecb",22890823,1,1,0,449,153,154,1
"06882a8492d9499aa31555567f575ecb","06882a8492d9499aa31555567f575ecb",22890823,1,0,1,450,154,154,0
"06882a8492d9499aa31555567f575ecb","f293c508f409466a8f27ddd7d1e40b20",22890823,1,1,0,451,154,155,1
"f293c508f409466a8f27ddd7d1e40b20","f293c508f409466a8f27ddd7d1e40b20",22890823,8,0,1,452,155,155,0
"f293c508f409466a8f27ddd7d1e40b20","cc4ddef5bbbe48ebb605141b347c4ed1",22890823,1,1,0,460,155,156,1
"cc4ddef5bbbe48ebb605141b347c4ed1","cc4ddef5bbbe48ebb605141b347c4ed1",22890823,6,0,1,461,156,156,0
"cc4ddef5bbbe48ebb605141b347c4ed1","d313cec988a84645bee413e8d4724a4b",22890823,1,3,0,467,156,158,2
"d313cec988a84645bee413e8d4724a4b","f03480cf4eba413194d7af52fc0e7f28",22890823,1,-7,0,468,158,152,-6
"f03480cf4eba413194d7af52fc0e7f28","d313cec988a84645bee413e8d4724a4b",22890823,1,7,0,469,152,158,6
"d313cec988a84645bee413e8d4724a4b","d313cec988a84645bee413e8d4724a4b",22890823,3,0,1,470,158,158,0
"d313cec988a84645bee413e8d4724a4b","dc60696c76a74368a60f72246e47700d",22890823,1,1,0,473,158,159,1
"dc60696c76a74368a60f72246e47700d","dc60696c76a74368a60f72246e47700d",22890823,1,0,1,474,159,159,0
"dc60696c76a74368a60f72246e47700d","df1de691dafe4549a18a4398ee9dfaf9",22890823,1,-23,0,475,159,139,-20
"df1de691dafe4549a18a4398ee9dfaf9","78adeee1fa2c4fe0bc73f7bca9fcee86",22890823,1,26,0,476,139,160,21
"78adeee1fa2c4fe0bc73f7bca9fcee86","65202579580f4ad38d734b4ee39d22a8",22890823,4,5,0,477,160,164,4
"65202579580f4ad38d734b4ee39d22a8","65202579580f4ad38d734b4ee39d22a8",22890823,58,0,1,478,164,164,0
"65202579580f4ad38d734b4ee39d22a8","78adeee1fa2c4fe0bc73f7bca9fcee86",22890823,3,-5,0,481,164,160,-4
"78adeee1fa2c4fe0bc73f7bca9fcee86","78adeee1fa2c4fe0bc73f7bca9fcee86",22890823,2,0,1,500,160,160,0
"65202579580f4ad38d734b4ee39d22a8","3cbcea2be0984e7dbd5a48195af10ce7",22890823,1,3,0,544,164,165,1
"3cbcea2be0984e7dbd5a48195af10ce7","78adeee1fa2c4fe0bc73f7bca9fcee86",22890823,1,-8,0,545,165,160,-5
"78adeee1fa2c4fe0bc73f7bca9fcee86","82e6285962b8400d9d6fc32436022a94",22890823,1,10,0,546,160,167,7
"82e6285962b8400d9d6fc32436022a94","a9ac840f098c4bd0a2ee896214ce29cd",22890823,1,3,0,547,167,168,1
"a9ac840f098c4bd0a2ee896214ce29cd","a9ac840f098c4bd0a2ee896214ce29cd",22890823,1,0,1,548,168,168,0
"a9ac840f098c4bd0a2ee896214ce29cd","0c7262dff33c4087bc660ccf40f92f9c",22890823,1,4,0,549,168,169,1
"0c7262dff33c4087bc660ccf40f92f9c","b2275c3fad834f8d90737a2d9a6927d6",22890823,1,3,0,550,169,172,3
"b2275c3fad834f8d90737a2d9a6927d6","b2275c3fad834f8d90737a2d9a6927d6",22890823,20,0,1,551,172,172,0
"b2275c3fad834f8d90737a2d9a6927d6","eb515a26030b41f8a82a1e6114420bad",22890823,1,1,0,571,172,173,1
"eb515a26030b41f8a82a1e6114420bad","eb515a26030b41f8a82a1e6114420bad",22890823,2,0,1,572,173,173,0
"eb515a26030b41f8a82a1e6114420bad","b42cc17b7de840f181a704558d0bc845",22890823,1,3,0,574,173,175,2
"b42cc17b7de840f181a704558d0bc845","0c7262dff33c4087bc660ccf40f92f9c",22890823,1,-7,0,575,175,169,-6
"0c7262dff33c4087bc660ccf40f92f9c","b42cc17b7de840f181a704558d0bc845",22890823,1,7,0,576,169,175,6
"b42cc17b7de840f181a704558d0bc845","b42cc17b7de840f181a704558d0bc845",22890823,1,0,1,577,175,175,0
"b42cc17b7de840f181a704558d0bc845","801f9e9135034f49bf5f8b4bdefedb41",22890823,1,2,0,578,175,177,2
"801f9e9135034f49bf5f8b4bdefedb41","801f9e9135034f49bf5f8b4bdefedb41",22890823,13,0,1,579,177,177,0
"801f9e9135034f49bf5f8b4bdefedb41","ea38cc0e6e6e41edbabf210220808bf9",22890823,1,3,0,592,177,179,2
"ea38cc0e6e6e41edbabf210220808bf9","362fcb0699a14845ab29b2340093e528",22890823,1,-6,0,593,179,174,-5
"362fcb0699a14845ab29b2340093e528","b87c552dd247427abe6ab5795b9c9d43",22890823,1,8,0,594,174,181,7
"b87c552dd247427abe6ab5795b9c9d43","ea38cc0e6e6e41edbabf210220808bf9",22890823,1,-2,0,595,181,179,-2
"ea38cc0e6e6e41edbabf210220808bf9","b87c552dd247427abe6ab5795b9c9d43",22890823,1,2,0,596,179,181,2
"b87c552dd247427abe6ab5795b9c9d43","b87c552dd247427abe6ab5795b9c9d43",22890823,11,0,1,597,181,181,0
"b87c552dd247427abe6ab5795b9c9d43","139b097acfca451689d80c9c6eebdf7b",22890823,1,-3,0,608,181,178,-3
"139b097acfca451689d80c9c6eebdf7b","30f660a1feb34582a739722532524f79",22890823,1,6,0,609,178,183,5
"30f660a1feb34582a739722532524f79","30f660a1feb34582a739722532524f79",22890823,10,0,1,610,183,183,0
"30f660a1feb34582a739722532524f79","2024b4885bd14338a39b7b509acbbd02",22890823,1,-1,0,620,183,182,-1
"2024b4885bd14338a39b7b509acbbd02","c3f63fe50d8e487c86bf8ef76c9cadd3",22890823,1,4,0,621,182,185,3
"c3f63fe50d8e487c86bf8ef76c9cadd3","c3f63fe50d8e487c86bf8ef76c9cadd3",22890823,2,0,1,622,185,185,0
"c3f63fe50d8e487c86bf8ef76c9cadd3","0c7262dff33c4087bc660ccf40f92f9c",22890823,1,-20,0,624,185,169,-16
"0c7262dff33c4087bc660ccf40f92f9c","c8e371568a0c4391b25796ae4e91952e",22890823,1,23,0,625,169,186,17
"c8e371568a0c4391b25796ae4e91952e","7d932b23e1c84326ae5aa4d3c0d813d1",22890823,1,2,0,626,186,188,2
"7d932b23e1c84326ae5aa4d3c0d813d1","7d932b23e1c84326ae5aa4d3c0d813d1",22890823,3,0,1,627,188,188,0
"7d932b23e1c84326ae5aa4d3c0d813d1","ab11d94c6c8948ea90b88f19d2cd502b",22890823,1,3,0,630,188,190,2
"ab11d94c6c8948ea90b88f19d2cd502b","c8e371568a0c4391b25796ae4e91952e",22890823,1,-5,0,631,190,186,-4
"c8e371568a0c4391b25796ae4e91952e","f992451ed6ad4e68bb9e68ad6be7c4be",22890823,1,7,0,632,186,192,6
"f992451ed6ad4e68bb9e68ad6be7c4be","f992451ed6ad4e68bb9e68ad6be7c4be",22890823,1,0,1,633,192,192,0
"f992451ed6ad4e68bb9e68ad6be7c4be","6cd2dcaac46847d4a0bc53f296d90375",22890823,1,3,0,634,192,194,2
"6cd2dcaac46847d4a0bc53f296d90375","07b44a7a51e94c78b411c753fc39dab0",22890823,1,-6,0,635,194,189,-5
"07b44a7a51e94c78b411c753fc39dab0","2d2580c9411c4972909db508d6956a58",22890823,1,8,0,636,189,196,7
"2d2580c9411c4972909db508d6956a58","2d2580c9411c4972909db508d6956a58",22890823,2,0,1,637,196,196,0
"2d2580c9411c4972909db508d6956a58","5bddb3d9ed264f3984702f048c7e5340",22890823,1,1,0,639,196,197,1
"5bddb3d9ed264f3984702f048c7e5340","5bddb3d9ed264f3984702f048c7e5340",22890823,2,0,1,640,197,197,0
"5bddb3d9ed264f3984702f048c7e5340","d5e8e2bd12a2466b9d6d90855f0eb079",22890823,1,1,0,642,197,198,1
"d5e8e2bd12a2466b9d6d90855f0eb079","d5e8e2bd12a2466b9d6d90855f0eb079",22890823,2,0,1,643,198,198,0
"d5e8e2bd12a2466b9d6d90855f0eb079","017d7ca8e0394b91aaadc9574df2202c",22890823,1,-5,0,645,198,193,-5
"017d7ca8e0394b91aaadc9574df2202c","54e8e9f0ea3e45c4bf3b8ac799ee31b1",22890823,1,8,0,646,193,200,7
"54e8e9f0ea3e45c4bf3b8ac799ee31b1","54e8e9f0ea3e45c4bf3b8ac799ee31b1",22890823,1,0,1,647,200,200,0
"54e8e9f0ea3e45c4bf3b8ac799ee31b1","c614a00911be4877a075f19315530fb0",22890823,1,1,0,648,200,201,1
"c614a00911be4877a075f19315530fb0","c614a00911be4877a075f19315530fb0",22890823,13,0,1,649,201,201,0
"c614a00911be4877a075f19315530fb0","a6c21bd8b95249c7972820a7a7d76aff",22890823,1,1,0,662,201,202,1
"a6c21bd8b95249c7972820a7a7d76aff","a6c21bd8b95249c7972820a7a7d76aff",22890823,1,0,1,663,202,202,0
"a6c21bd8b95249c7972820a7a7d76aff","bb329d880ab54120adaf203a693bb203",22890823,1,1,0,664,202,203,1
"bb329d880ab54120adaf203a693bb203","bb329d880ab54120adaf203a693bb203",22890823,1,0,1,665,203,203,0
"bb329d880ab54120adaf203a693bb203","f9170dd6bc6442b4acd832747609b09a",22890823,1,-4,0,666,203,199,-4
"f9170dd6bc6442b4acd832747609b09a","334c2344009840079b1d0e1b7ce3d5a7",22890823,1,7,0,667,199,205,6
"334c2344009840079b1d0e1b7ce3d5a7","334c2344009840079b1d0e1b7ce3d5a7",22890823,1,0,1,668,205,205,0
"334c2344009840079b1d0e1b7ce3d5a7","c8e371568a0c4391b25796ae4e91952e",22890823,1,-23,0,669,205,186,-19
"c8e371568a0c4391b25796ae4e91952e","d7f13c8d63ec4e2aa673fbb9cf9c6933",22890823,1,26,0,670,186,206,20
"d7f13c8d63ec4e2aa673fbb9cf9c6933","7108f0e4c2584f1f9c471689ae4c885c",22890823,1,2,0,671,206,208,2
"7108f0e4c2584f1f9c471689ae4c885c","b9e80f77c3a44349863b19875725c384",22890823,1,-1,0,672,208,207,-1
"b9e80f77c3a44349863b19875725c384","b9e80f77c3a44349863b19875725c384",22890823,16,0,1,673,207,207,0
"b9e80f77c3a44349863b19875725c384","7108f0e4c2584f1f9c471689ae4c885c",22890823,1,1,0,689,207,208,1
"7108f0e4c2584f1f9c471689ae4c885c","7108f0e4c2584f1f9c471689ae4c885c",22890823,14,0,1,690,208,208,0
"7108f0e4c2584f1f9c471689ae4c885c","09400e101c5d4b439cf9a26b03aae558",22890823,1,3,0,704,208,210,2
"09400e101c5d4b439cf9a26b03aae558","d7f13c8d63ec4e2aa673fbb9cf9c6933",22890823,1,-5,0,705,210,206,-4
"d7f13c8d63ec4e2aa673fbb9cf9c6933","d7f13c8d63ec4e2aa673fbb9cf9c6933",22890823,1,0,1,706,206,206,0
"d7f13c8d63ec4e2aa673fbb9cf9c6933","09400e101c5d4b439cf9a26b03aae558",22890823,1,5,0,707,206,210,4
"09400e101c5d4b439cf9a26b03aae558","09400e101c5d4b439cf9a26b03aae558",22890823,1,0,1,708,210,210,0
"09400e101c5d4b439cf9a26b03aae558","a88efa7e50ce47159810ab553afa6d3a",22890823,1,2,0,709,210,212,2
"a88efa7e50ce47159810ab553afa6d3a","a88efa7e50ce47159810ab553afa6d3a",22890823,5,0,1,710,212,212,0
"a88efa7e50ce47159810ab553afa6d3a","be502a7a43c44bf7b682698de79d9369",22890823,1,3,0,715,212,214,2
"be502a7a43c44bf7b682698de79d9369","f7fb1952f56b4189b86a9f8b7862d2b8",22890823,2,1,0,716,214,215,1
"f7fb1952f56b4189b86a9f8b7862d2b8","a875096404ef4a9984b62d74cda916f9",22890823,1,-7,0,717,215,209,-6
"a875096404ef4a9984b62d74cda916f9","be502a7a43c44bf7b682698de79d9369",22890823,1,6,0,718,209,214,5
"f7fb1952f56b4189b86a9f8b7862d2b8","f7fb1952f56b4189b86a9f8b7862d2b8",22890823,13,0,1,720,215,215,0
"f7fb1952f56b4189b86a9f8b7862d2b8","b860ee85d8bc4a2f97958cfb71be3533",22890823,1,1,0,733,215,216,1
"b860ee85d8bc4a2f97958cfb71be3533","b860ee85d8bc4a2f97958cfb71be3533",22890823,5,0,1,734,216,216,0
"b860ee85d8bc4a2f97958cfb71be3533","ec341f459285443b8361f7f15638ff08",22890823,1,-3,0,739,216,213,-3
"ec341f459285443b8361f7f15638ff08","363837c182e04711840d896ae1e0339c",22890823,1,6,0,740,213,218,5
"363837c182e04711840d896ae1e0339c","363837c182e04711840d896ae1e0339c",22890823,18,0,1,741,218,218,0
"363837c182e04711840d896ae1e0339c","01b2051f8941460d89945e3b02d1ce78",22890823,1,-1,0,759,218,217,-1
"01b2051f8941460d89945e3b02d1ce78","91125ca626c5470eb145501f8c37f8db",22890823,1,4,0,760,217,220,3
"91125ca626c5470eb145501f8c37f8db","91125ca626c5470eb145501f8c37f8db",22890823,1,0,1,761,220,220,0
"91125ca626c5470eb145501f8c37f8db","d7f13c8d63ec4e2aa673fbb9cf9c6933",22890823,1,-18,0,762,220,206,-14
"d7f13c8d63ec4e2aa673fbb9cf9c6933","1c6721b1f63f4d30ba7746ea8af02a52",22890823,1,21,0,763,206,221,15
"1c6721b1f63f4d30ba7746ea8af02a52","77ecef8eff6b4a2caea7707669bf7475",22890823,1,1,0,764,221,222,1
"77ecef8eff6b4a2caea7707669bf7475","77ecef8eff6b4a2caea7707669bf7475",22890823,12,0,1,765,222,222,0
"77ecef8eff6b4a2caea7707669bf7475","1c6721b1f63f4d30ba7746ea8af02a52",22890823,1,-1,0,777,222,221,-1
"1c6721b1f63f4d30ba7746ea8af02a52","d03cb855c70044cf8c35d9ec0de696e3",22890823,1,4,0,778,221,224,3
"d03cb855c70044cf8c35d9ec0de696e3","8b9ae98743bd4d4a8a87dff1c1244211",22890823,1,3,0,779,224,227,3
"8b9ae98743bd4d4a8a87dff1c1244211","d03cb855c70044cf8c35d9ec0de696e3",22890823,1,-3,0,780,227,224,-3
"d03cb855c70044cf8c35d9ec0de696e3","a49a937d6896486d9a5396654abcf2e1",22890823,1,2,0,781,224,226,2
"a49a937d6896486d9a5396654abcf2e1","a49a937d6896486d9a5396654abcf2e1",22890823,3,0,1,782,226,226,0
"a49a937d6896486d9a5396654abcf2e1","8b9ae98743bd4d4a8a87dff1c1244211",22890823,1,1,0,785,226,227,1
"8b9ae98743bd4d4a8a87dff1c1244211","8b9ae98743bd4d4a8a87dff1c1244211",22890823,13,0,1,786,227,227,0
"8b9ae98743bd4d4a8a87dff1c1244211","2ab1535aac1346ba8801535bf729ef37",22890823,1,3,0,799,227,229,2
"2ab1535aac1346ba8801535bf729ef37","f7906d6f59b9489a91d2ef40db5a474d",22890823,1,-7,0,800,229,223,-6
"f7906d6f59b9489a91d2ef40db5a474d","2ab1535aac1346ba8801535bf729ef37",22890823,1,7,0,801,223,229,6
"2ab1535aac1346ba8801535bf729ef37","a4f40fb48a8542c8949bae1f002cd9bc",22890823,1,2,0,802,229,231,2
"a4f40fb48a8542c8949bae1f002cd9bc","a4f40fb48a8542c8949bae1f002cd9bc",22890823,8,0,1,803,231,231,0
"a4f40fb48a8542c8949bae1f002cd9bc","8972c23e32044edb8a78fa1eed4e5947",22890823,1,1,0,811,231,232,1
"8972c23e32044edb8a78fa1eed4e5947","8972c23e32044edb8a78fa1eed4e5947",22890823,3,0,1,812,232,232,0
"8972c23e32044edb8a78fa1eed4e5947","92feb4a40f8344d38b6f722e42a53295",22890823,1,1,0,815,232,233,1
"92feb4a40f8344d38b6f722e42a53295","92feb4a40f8344d38b6f722e42a53295",22890823,2,0,1,816,233,233,0
"92feb4a40f8344d38b6f722e42a53295","5152833676bf4c6cb317060be10f68db",22890823,1,-5,0,818,233,228,-5
"5152833676bf4c6cb317060be10f68db","ca3e28f290354c08aefe5b0f769604e6",22890823,1,8,0,819,228,235,7
"ca3e28f290354c08aefe5b0f769604e6","ca3e28f290354c08aefe5b0f769604e6",22890823,9,0,1,820,235,235,0
"ca3e28f290354c08aefe5b0f769604e6","79a35eea833e4c2c9d22fc53c3c6445c",22890823,1,1,0,829,235,236,1
"79a35eea833e4c2c9d22fc53c3c6445c","79a35eea833e4c2c9d22fc53c3c6445c",22890823,9,0,1,830,236,236,0
"79a35eea833e4c2c9d22fc53c3c6445c","8f68228b1518449e9615cdafee41a2bd",22890823,1,1,0,839,236,237,1
"8f68228b1518449e9615cdafee41a2bd","8f68228b1518449e9615cdafee41a2bd",22890823,1,0,1,840,237,237,0
"8f68228b1518449e9615cdafee41a2bd","cab89fa5c3ed45a5aa550fc0352d6a42",22890823,1,1,0,841,237,238,1
"cab89fa5c3ed45a5aa550fc0352d6a42","cab89fa5c3ed45a5aa550fc0352d6a42",22890823,6,0,1,842,238,238,0
"cab89fa5c3ed45a5aa550fc0352d6a42","66d4fad4f1cf4b46be0750a99ad7a35a",22890823,1,1,0,848,238,239,1
"66d4fad4f1cf4b46be0750a99ad7a35a","66d4fad4f1cf4b46be0750a99ad7a35a",22890823,1,0,1,849,239,239,0
"66d4fad4f1cf4b46be0750a99ad7a35a","0b04c8e2f86d48c7aeb7e225819cd32b",22890823,1,-5,0,850,239,234,-5
"b613861cecf84ffcab01afb23f660475","b613861cecf84ffcab01afb23f660475",22900214,6,0,1,1,1,1,0
"b613861cecf84ffcab01afb23f660475","e2911e79efc2420eac45d9f671463d4b",22900214,1,3,0,7,1,2,1
"e2911e79efc2420eac45d9f671463d4b","e2911e79efc2420eac45d9f671463d4b",22900214,2,0,1,8,2,2,0
"e2911e79efc2420eac45d9f671463d4b","519d1b8c59404d67b54e96c5c8a830b2",22900214,1,1,0,10,2,3,1
"519d1b8c59404d67b54e96c5c8a830b2","519d1b8c59404d67b54e96c5c8a830b2",22900214,1,0,1,11,3,3,0
"519d1b8c59404d67b54e96c5c8a830b2","531db53f81f646edb0cdcfe0085b03b7",22900214,1,1,0,12,3,4,1
"531db53f81f646edb0cdcfe0085b03b7","531db53f81f646edb0cdcfe0085b03b7",22900214,1,0,1,13,4,4,0
"531db53f81f646edb0cdcfe0085b03b7","4f5f94b2f95141e0a9d53a61da2276da",22900214,1,1,0,14,4,5,1
"4f5f94b2f95141e0a9d53a61da2276da","4f5f94b2f95141e0a9d53a61da2276da",22900214,1,0,1,15,5,5,0
"4f5f94b2f95141e0a9d53a61da2276da","6d541c89590949f99af293c4f2333f67",22900214,1,1,0,16,5,6,1
"6d541c89590949f99af293c4f2333f67","6d541c89590949f99af293c4f2333f67",22900214,1,0,1,17,6,6,0
"6d541c89590949f99af293c4f2333f67","dd5cf0b9fe4c4f1d8f5ff8e4c04879cb",22900214,1,1,0,18,6,7,1
"dd5cf0b9fe4c4f1d8f5ff8e4c04879cb","dd5cf0b9fe4c4f1d8f5ff8e4c04879cb",22900214,2,0,1,19,7,7,0
"dd5cf0b9fe4c4f1d8f5ff8e4c04879cb","6d541c89590949f99af293c4f2333f67",22900214,1,-1,0,21,7,6,-1
"6d541c89590949f99af293c4f2333f67","f96261861edc426abe2248be4f0a709a",22900214,1,2,0,22,6,8,2
"f96261861edc426abe2248be4f0a709a","f96261861edc426abe2248be4f0a709a",22900214,2,0,1,23,8,8,0
"f96261861edc426abe2248be4f0a709a","66b5e16f4f75454fb5b8172079f0fa83",22900214,1,1,0,25,8,9,1
"66b5e16f4f75454fb5b8172079f0fa83","66b5e16f4f75454fb5b8172079f0fa83",22900214,2,0,1,26,9,9,0
"66b5e16f4f75454fb5b8172079f0fa83","0680571d4698477995e41842c36a54b2",22900214,1,1,0,28,9,10,1
"0680571d4698477995e41842c36a54b2","0680571d4698477995e41842c36a54b2",22900214,1,0,1,29,10,10,0
"0680571d4698477995e41842c36a54b2","9112f2bffece48e08c6d2287be204085",22900214,1,1,0,30,10,11,1
"9112f2bffece48e08c6d2287be204085","9112f2bffece48e08c6d2287be204085",22900214,1,0,1,31,11,11,0
"9112f2bffece48e08c6d2287be204085","e2911e79efc2420eac45d9f671463d4b",22900214,1,-9,0,32,11,2,-9
"e2911e79efc2420eac45d9f671463d4b","56586aa865414f538729c7f7735d2bc6",22900214,1,12,0,33,2,12,10
"56586aa865414f538729c7f7735d2bc6","56586aa865414f538729c7f7735d2bc6",22900214,2,0,1,34,12,12,0
"56586aa865414f538729c7f7735d2bc6","b7f2b31585d94eb3bf86376714aa7070",22900214,2,2,0,36,12,13,1
"b7f2b31585d94eb3bf86376714aa7070","56586aa865414f538729c7f7735d2bc6",22900214,1,-2,0,37,13,12,-1
"b7f2b31585d94eb3bf86376714aa7070","b7f2b31585d94eb3bf86376714aa7070",22900214,1,0,1,39,13,13,0
"b7f2b31585d94eb3bf86376714aa7070","3f1c815879794b929260d224becaff7e",22900214,1,2,0,40,13,14,1
"3f1c815879794b929260d224becaff7e","81c864a886d54a6b8ff85f7d736f4f95",22900214,1,2,0,41,14,15,1
"81c864a886d54a6b8ff85f7d736f4f95","5c5ceeee4562457ba6d41515aeebfbb1",22900214,1,4,0,42,15,17,2
"5c5ceeee4562457ba6d41515aeebfbb1","5c5ceeee4562457ba6d41515aeebfbb1",22900214,1,0,1,43,17,17,0
"5c5ceeee4562457ba6d41515aeebfbb1","56586aa865414f538729c7f7735d2bc6",22900214,1,-10,0,44,17,12,-5
"56586aa865414f538729c7f7735d2bc6","9afd71a5298d4333b6849dfce1b9422c",22900214,1,13,0,45,12,18,6
"9afd71a5298d4333b6849dfce1b9422c","9afd71a5298d4333b6849dfce1b9422c",22900214,1,0,1,46,18,18,0
"9afd71a5298d4333b6849dfce1b9422c","b7719e26494940efa49512aedd0aac79",22900214,1,4,0,47,18,20,2
"b7719e26494940efa49512aedd0aac79","9afd71a5298d4333b6849dfce1b9422c",22900214,1,-4,0,48,20,18,-2
"9afd71a5298d4333b6849dfce1b9422c","d4f45188d3c84a02ba08454e6403a818",22900214,1,9,0,49,18,24,6
"d4f45188d3c84a02ba08454e6403a818","d4c3b003e8274e429d2fa688d73fde6d",22900214,2,-2,0,50,24,22,-2
"d4c3b003e8274e429d2fa688d73fde6d","d4c3b003e8274e429d2fa688d73fde6d",22900214,2,0,1,51,22,22,0
"d4c3b003e8274e429d2fa688d73fde6d","b7719e26494940efa49512aedd0aac79",22900214,2,-3,0,53,22,20,-2
"b7719e26494940efa49512aedd0aac79","a49d1bb4328949299686242fd0be5584",22900214,1,2,0,54,20,21,1
"a49d1bb4328949299686242fd0be5584","d4f45188d3c84a02ba08454e6403a818",22900214,1,3,0,55,21,24,3
"b7719e26494940efa49512aedd0aac79","afbf7250b99d47bea07172749483ca97",22900214,2,12,0,58,20,28,8
"afbf7250b99d47bea07172749483ca97","b7719e26494940efa49512aedd0aac79",22900214,1,-12,0,59,28,20,-8
"afbf7250b99d47bea07172749483ca97","4e51676dc72045d99c19b9fa7b22f8bc",22900214,1,3,0,61,28,29,1
"4e51676dc72045d99c19b9fa7b22f8bc","4e51676dc72045d99c19b9fa7b22f8bc",22900214,1,0,1,62,29,29,0
"4e51676dc72045d99c19b9fa7b22f8bc","51970cfa30e643e894e66ae85c8024cc",22900214,1,3,0,63,29,31,2
"51970cfa30e643e894e66ae85c8024cc","4e51676dc72045d99c19b9fa7b22f8bc",22900214,1,-3,0,64,31,29,-2
"4e51676dc72045d99c19b9fa7b22f8bc","c33c17be71ae4d588da7369472e5bb1b",22900214,1,9,0,65,29,34,5
"c33c17be71ae4d588da7369472e5bb1b","c33c17be71ae4d588da7369472e5bb1b",22900214,1,0,1,66,34,34,0
"c33c17be71ae4d588da7369472e5bb1b","93679be414554a11b1893002f2229a93",22900214,1,3,0,67,34,35,1
"93679be414554a11b1893002f2229a93","93679be414554a11b1893002f2229a93",22900214,1,0,1,68,35,35,0
"93679be414554a11b1893002f2229a93","7040a13096d746ac84b8fac8d9752058",22900214,1,3,0,69,35,36,1
"7040a13096d746ac84b8fac8d9752058","9a0dc646f934470daf08c4b56ccf73db",22900214,2,3,0,70,36,37,1
"9a0dc646f934470daf08c4b56ccf73db","7040a13096d746ac84b8fac8d9752058",22900214,1,-3,0,71,37,36,-1
"9a0dc646f934470daf08c4b56ccf73db","fc0e049d56024bc9a02c9a9c435c3df7",22900214,1,3,0,73,37,38,1
"fc0e049d56024bc9a02c9a9c435c3df7","fc0e049d56024bc9a02c9a9c435c3df7",22900214,1,0,1,74,38,38,0
"fc0e049d56024bc9a02c9a9c435c3df7","67a089198fcb4e1c8f2385786c2b296f",22900214,1,4,0,75,38,39,1
"67a089198fcb4e1c8f2385786c2b296f","64d48c6c9c7940639a932219a6c87198",22900214,2,1,0,76,39,40,1
"64d48c6c9c7940639a932219a6c87198","78adeee1fa2c4fe0bc73f7bca9fcee86",22900214,1,151,0,77,40,160,120
"78adeee1fa2c4fe0bc73f7bca9fcee86","78adeee1fa2c4fe0bc73f7bca9fcee86",22900214,1,0,1,78,160,160,0
"78adeee1fa2c4fe0bc73f7bca9fcee86","0c7262dff33c4087bc660ccf40f92f9c",22900214,1,17,0,79,160,169,9
"b2275c3fad834f8d90737a2d9a6927d6","0c7262dff33c4087bc660ccf40f92f9c",22900214,1,-3,0,81,172,169,-3
"b2275c3fad834f8d90737a2d9a6927d6","67a089198fcb4e1c8f2385786c2b296f",22900214,1,-172,0,83,172,39,-133
"67a089198fcb4e1c8f2385786c2b296f","67a089198fcb4e1c8f2385786c2b296f",22900214,1,0,1,84,39,39,0
"64d48c6c9c7940639a932219a6c87198","64d48c6c9c7940639a932219a6c87198",22900214,1,0,1,86,40,40,0
"64d48c6c9c7940639a932219a6c87198","b534b89233134e30a9b5645138bfa9ee",22900214,1,3,0,87,40,41,1
"b534b89233134e30a9b5645138bfa9ee","67a089198fcb4e1c8f2385786c2b296f",22900214,1,-4,0,88,41,39,-2
"67a089198fcb4e1c8f2385786c2b296f","0e37b720d23b4e7f8b313e79313fd107",22900214,1,7,0,89,39,44,5
"0e37b720d23b4e7f8b313e79313fd107","0e37b720d23b4e7f8b313e79313fd107",22900214,1,0,1,90,44,44,0
"0e37b720d23b4e7f8b313e79313fd107","6875d67fdd5f48168b62719df449bebd",22900214,1,1,0,91,44,45,1
"6875d67fdd5f48168b62719df449bebd","6875d67fdd5f48168b62719df449bebd",22900214,1,0,1,92,45,45,0
"6875d67fdd5f48168b62719df449bebd","6e13d61a7bdb44bca949c9f86fab3be5",22900214,1,3,0,93,45,47,2
"6e13d61a7bdb44bca949c9f86fab3be5","b534b89233134e30a9b5645138bfa9ee",22900214,1,-7,0,94,47,41,-6
"b534b89233134e30a9b5645138bfa9ee","6e13d61a7bdb44bca949c9f86fab3be5",22900214,1,7,0,95,41,47,6
"6e13d61a7bdb44bca949c9f86fab3be5","6e13d61a7bdb44bca949c9f86fab3be5",22900214,2,0,1,96,47,47,0
"6e13d61a7bdb44bca949c9f86fab3be5","195f78799f984cc2b06c48dfe36be751",22900214,1,2,0,98,47,49,2
"195f78799f984cc2b06c48dfe36be751","195f78799f984cc2b06c48dfe36be751",22900214,2,0,1,100,49,49,0
"195f78799f984cc2b06c48dfe36be751","d9c8d8c444a64dadbbb508652c721e17",22900214,1,-3,0,101,49,46,-3
"d9c8d8c444a64dadbbb508652c721e17","d0c74f735e024943943e40333d6d337f",22900214,1,6,0,102,46,51,5
"d0c74f735e024943943e40333d6d337f","d0c74f735e024943943e40333d6d337f",22900214,1,0,1,103,51,51,0
"d0c74f735e024943943e40333d6d337f","983f8ff320594b279a7f4a6fe132f9c5",22900214,1,2,0,104,51,53,2
"983f8ff320594b279a7f4a6fe132f9c5","983f8ff320594b279a7f4a6fe132f9c5",22900214,2,0,1,105,53,53,0
"983f8ff320594b279a7f4a6fe132f9c5","35adfa5d923046aebabfefd98f35ff05",22900214,1,1,0,107,53,54,1
"35adfa5d923046aebabfefd98f35ff05","35adfa5d923046aebabfefd98f35ff05",22900214,2,0,1,108,54,54,0
"35adfa5d923046aebabfefd98f35ff05","b6f8a98476224da1b40e555ececc7ed8",22900214,1,1,0,110,54,55,1
"b6f8a98476224da1b40e555ececc7ed8","b6f8a98476224da1b40e555ececc7ed8",22900214,2,0,1,111,55,55,0
"b6f8a98476224da1b40e555ececc7ed8","86e22cb5fe0e4b47a9489ecddf7ed78f",22900214,1,1,0,113,55,56,1
"86e22cb5fe0e4b47a9489ecddf7ed78f","86e22cb5fe0e4b47a9489ecddf7ed78f",22900214,2,0,1,114,56,56,0
"86e22cb5fe0e4b47a9489ecddf7ed78f","f924752d8a1149668870b1e7698486f7",22900214,1,-6,0,116,56,50,-6
"f924752d8a1149668870b1e7698486f7","a1f2f12debe5432fb7a70bcd12bacfb9",22900214,1,9,0,117,50,58,8
"a1f2f12debe5432fb7a70bcd12bacfb9","78f30e4dcac84e3cbea8b2cc6e0d62b3",22900214,2,1,0,118,58,59,1
"78f30e4dcac84e3cbea8b2cc6e0d62b3","a1f2f12debe5432fb7a70bcd12bacfb9",22900214,1,-1,0,119,59,58,-1
"a1f2f12debe5432fb7a70bcd12bacfb9","a1f2f12debe5432fb7a70bcd12bacfb9",22900214,16,0,1,120,58,58,0
"78f30e4dcac84e3cbea8b2cc6e0d62b3","78f30e4dcac84e3cbea8b2cc6e0d62b3",22900214,7,0,1,137,59,59,0
"78f30e4dcac84e3cbea8b2cc6e0d62b3","12aa6e1672ac4e7aa6449a7a8609cd72",22900214,1,-2,0,144,59,57,-2
"12aa6e1672ac4e7aa6449a7a8609cd72","bc42d26810654ea9a1df1efe1e58c7d5",22900214,1,7,0,145,57,63,6
"bc42d26810654ea9a1df1efe1e58c7d5","a0a418b8540d479fa6e0f653b701da8b",22900214,1,1,0,146,63,64,1
"a0a418b8540d479fa6e0f653b701da8b","4c943503763e4e349906eea3ed3c8e86",22900214,1,-3,0,147,64,61,-3
"4c943503763e4e349906eea3ed3c8e86","4c943503763e4e349906eea3ed3c8e86",22900214,1,0,1,148,61,61,0
"4c943503763e4e349906eea3ed3c8e86","bc42d26810654ea9a1df1efe1e58c7d5",22900214,1,2,0,149,61,63,2
"bc42d26810654ea9a1df1efe1e58c7d5","bc42d26810654ea9a1df1efe1e58c7d5",22900214,3,0,1,150,63,63,0
"bc42d26810654ea9a1df1efe1e58c7d5","309ccf3cc4fe429d9bfbaef53d3fa479",22900214,1,-3,0,153,63,60,-3
"309ccf3cc4fe429d9bfbaef53d3fa479","b534b89233134e30a9b5645138bfa9ee",22900214,1,-23,0,154,60,41,-19
"b534b89233134e30a9b5645138bfa9ee","d646286c8051419bbc2e31dd1db55ca8",22900214,1,33,0,155,41,67,26
"d646286c8051419bbc2e31dd1db55ca8","267f883678b24aed855fde42524975d9",22900214,1,4,0,156,67,71,4
"267f883678b24aed855fde42524975d9","267f883678b24aed855fde42524975d9",22900214,1,0,1,157,71,71,0
"267f883678b24aed855fde42524975d9","88fff56d0342490dbef9040750a20f6c",22900214,1,1,0,158,71,72,1
"88fff56d0342490dbef9040750a20f6c","88fff56d0342490dbef9040750a20f6c",22900214,1,0,1,159,72,72,0
"88fff56d0342490dbef9040750a20f6c","adb17b12b66c4a49a85fd34322f7df70",22900214,1,1,0,160,72,73,1
"adb17b12b66c4a49a85fd34322f7df70","adb17b12b66c4a49a85fd34322f7df70",22900214,1,0,1,161,73,73,0
"adb17b12b66c4a49a85fd34322f7df70","a2becd407db34b189200a32546d9d569",22900214,1,3,0,162,73,75,2
"a2becd407db34b189200a32546d9d569","d646286c8051419bbc2e31dd1db55ca8",22900214,1,-9,0,163,75,67,-8
"d646286c8051419bbc2e31dd1db55ca8","a2becd407db34b189200a32546d9d569",22900214,1,9,0,164,67,75,8
"a2becd407db34b189200a32546d9d569","58c22b011d0f4c2ea6d13615edbb9eeb",22900214,1,2,0,165,75,77,2
"58c22b011d0f4c2ea6d13615edbb9eeb","58c22b011d0f4c2ea6d13615edbb9eeb",22900214,2,0,1,166,77,77,0
"58c22b011d0f4c2ea6d13615edbb9eeb","dd76e1861dc9461c830888729d091ee0",22900214,1,1,0,168,77,78,1
"dd76e1861dc9461c830888729d091ee0","dd76e1861dc9461c830888729d091ee0",22900214,5,0,1,169,78,78,0
"dd76e1861dc9461c830888729d091ee0","cd1d828f1a694b87913a7ea66c23803e",22900214,1,1,0,174,78,79,1
"cd1d828f1a694b87913a7ea66c23803e","cd1d828f1a694b87913a7ea66c23803e",22900214,2,0,1,175,79,79,0
"cd1d828f1a694b87913a7ea66c23803e","9176a3c2b4d2465fa8b0c67096c2a97e",22900214,1,1,0,177,79,80,1
"9176a3c2b4d2465fa8b0c67096c2a97e","9176a3c2b4d2465fa8b0c67096c2a97e",22900214,5,0,1,178,80,80,0
"9176a3c2b4d2465fa8b0c67096c2a97e","f8ec6445f7194e25b9101d4fbcb07a18",22900214,1,1,0,183,80,81,1
"f8ec6445f7194e25b9101d4fbcb07a18","f8ec6445f7194e25b9101d4fbcb07a18",22900214,2,0,1,184,81,81,0
"f8ec6445f7194e25b9101d4fbcb07a18","140d5b27b8574befad82c0a013b59dfa",22900214,1,-7,0,186,81,74,-7
"140d5b27b8574befad82c0a013b59dfa","d18a9ea32855445f8736581f5cb119ce",22900214,1,9,0,187,74,82,8
"d18a9ea32855445f8736581f5cb119ce","f564483cbd7a407681aa2fcca518cf5f",22900214,1,4,0,188,82,85,3
"f564483cbd7a407681aa2fcca518cf5f","f564483cbd7a407681aa2fcca518cf5f",22900214,4,0,1,189,85,85,0
"f564483cbd7a407681aa2fcca518cf5f","18fd01350bd5434ca636d59a599d768a",22900214,1,1,0,193,85,86,1
"18fd01350bd5434ca636d59a599d768a","18fd01350bd5434ca636d59a599d768a",22900214,9,0,1,194,86,86,0
"18fd01350bd5434ca636d59a599d768a","ae5ac430ea254e708a6f5deaaf7464ae",22900214,1,-2,0,203,86,84,-2
"ae5ac430ea254e708a6f5deaaf7464ae","6a9f0ef185fb47f0937e29daa1c71ed5",22900214,1,7,0,204,84,90,6
"6a9f0ef185fb47f0937e29daa1c71ed5","c681290961c94c4caf23b529d1ae6b9a",22900214,1,-2,0,205,90,88,-2
"c681290961c94c4caf23b529d1ae6b9a","c681290961c94c4caf23b529d1ae6b9a",22900214,1,0,1,206,88,88,0
"c681290961c94c4caf23b529d1ae6b9a","6a9f0ef185fb47f0937e29daa1c71ed5",22900214,1,2,0,207,88,90,2
"6a9f0ef185fb47f0937e29daa1c71ed5","6a9f0ef185fb47f0937e29daa1c71ed5",22900214,3,0,1,208,90,90,0
"6a9f0ef185fb47f0937e29daa1c71ed5","d646286c8051419bbc2e31dd1db55ca8",22900214,1,-27,0,211,90,67,-23
"d646286c8051419bbc2e31dd1db55ca8","e20db35ced8544ddac5bc3839145e463",22900214,1,30,0,212,67,91,24
"e20db35ced8544ddac5bc3839145e463","1febb706d7a34005ae8711ed49c76e64",22900214,1,3,0,213,91,94,3
"1febb706d7a34005ae8711ed49c76e64","1febb706d7a34005ae8711ed49c76e64",22900214,5,0,1,214,94,94,0
"1febb706d7a34005ae8711ed49c76e64","8f73ba6f5a0042f2850356ac38ac6f24",22900214,1,1,0,219,94,95,1
"8f73ba6f5a0042f2850356ac38ac6f24","8f73ba6f5a0042f2850356ac38ac6f24",22900214,5,0,1,220,95,95,0
"8f73ba6f5a0042f2850356ac38ac6f24","e2260b86653c46d7b14a41fb419dbf8c",22900214,1,1,0,225,95,96,1
"e2260b86653c46d7b14a41fb419dbf8c","e2260b86653c46d7b14a41fb419dbf8c",22900214,2,0,1,226,96,96,0
"e2260b86653c46d7b14a41fb419dbf8c","35eb641ad1d845bbba54915bce75a962",22900214,1,1,0,228,96,97,1
"35eb641ad1d845bbba54915bce75a962","35eb641ad1d845bbba54915bce75a962",22900214,5,0,1,229,97,97,0
"35eb641ad1d845bbba54915bce75a962","08be90ffbeea4795a138cd42ed8db56f",22900214,1,1,0,234,97,98,1
"08be90ffbeea4795a138cd42ed8db56f","08be90ffbeea4795a138cd42ed8db56f",22900214,5,0,1,235,98,98,0
"08be90ffbeea4795a138cd42ed8db56f","3007433c8f584dcbb5ac159c1c5f2be3",22900214,1,1,0,240,98,99,1
"3007433c8f584dcbb5ac159c1c5f2be3","3007433c8f584dcbb5ac159c1c5f2be3",22900214,5,0,1,241,99,99,0
"3007433c8f584dcbb5ac159c1c5f2be3","e20db35ced8544ddac5bc3839145e463",22900214,1,-8,0,246,99,91,-8
"e20db35ced8544ddac5bc3839145e463","00ae5f0c51874a73a41ebea838d95682",22900214,1,11,0,247,91,101,10
"00ae5f0c51874a73a41ebea838d95682","d391c8b6e56a43a7b654e9dee02d904b",22900214,2,2,0,248,101,103,2
"d391c8b6e56a43a7b654e9dee02d904b","00ae5f0c51874a73a41ebea838d95682",22900214,1,-2,0,249,103,101,-2
"d391c8b6e56a43a7b654e9dee02d904b","d391c8b6e56a43a7b654e9dee02d904b",22900214,15,0,1,251,103,103,0
"d391c8b6e56a43a7b654e9dee02d904b","6111116566fc4fd9abba409322bea245",22900214,1,1,0,266,103,104,1
"6111116566fc4fd9abba409322bea245","6111116566fc4fd9abba409322bea245",22900214,2,0,1,267,104,104,0
"6111116566fc4fd9abba409322bea245","a81b2235cb9c499eb9ea8ee0a8dd9725",22900214,1,1,0,269,104,105,1
"a81b2235cb9c499eb9ea8ee0a8dd9725","a81b2235cb9c499eb9ea8ee0a8dd9725",22900214,2,0,1,270,105,105,0
"a81b2235cb9c499eb9ea8ee0a8dd9725","2d4e0ab0ef3b4d73b82c72d4621a7579",22900214,1,1,0,272,105,106,1
"2d4e0ab0ef3b4d73b82c72d4621a7579","2d4e0ab0ef3b4d73b82c72d4621a7579",22900214,2,0,1,273,106,106,0
"2d4e0ab0ef3b4d73b82c72d4621a7579","8bdebf492ebd4e62b0d522e8ab5e5197",22900214,1,1,0,275,106,107,1
"8bdebf492ebd4e62b0d522e8ab5e5197","8bdebf492ebd4e62b0d522e8ab5e5197",22900214,2,0,1,276,107,107,0
"8bdebf492ebd4e62b0d522e8ab5e5197","4280927ec4d643238aa49c32f9e06c6c",22900214,1,3,0,278,107,109,2
"4280927ec4d643238aa49c32f9e06c6c","73039f8c1eb9409cb4caee2cf968001e",22900214,1,-10,0,279,109,100,-9
"73039f8c1eb9409cb4caee2cf968001e","4280927ec4d643238aa49c32f9e06c6c",22900214,1,10,0,280,100,109,9
"4280927ec4d643238aa49c32f9e06c6c","4280927ec4d643238aa49c32f9e06c6c",22900214,1,0,1,281,109,109,0
"4280927ec4d643238aa49c32f9e06c6c","fc44e6a5f7654430af1227838224dceb",22900214,1,2,0,282,109,111,2
"fc44e6a5f7654430af1227838224dceb","fc44e6a5f7654430af1227838224dceb",22900214,2,0,1,283,111,111,0
"fc44e6a5f7654430af1227838224dceb","08111f75e22d409998cf8b85bd431f0a",22900214,1,-3,0,285,111,108,-3
"08111f75e22d409998cf8b85bd431f0a","a9ae0a3c070d455bb4369a8996313336",22900214,1,7,0,286,108,114,6
"a9ae0a3c070d455bb4369a8996313336","a9ae0a3c070d455bb4369a8996313336",22900214,1,0,1,287,114,114,0
"a9ae0a3c070d455bb4369a8996313336","71cec822bcff4f30a20e75dc63ef7b65",22900214,1,2,0,288,114,116,2
"71cec822bcff4f30a20e75dc63ef7b65","71cec822bcff4f30a20e75dc63ef7b65",22900214,3,0,1,289,116,116,0
"71cec822bcff4f30a20e75dc63ef7b65","37319e88176d4aefa91d7a9980dbae91",22900214,1,-4,0,292,116,112,-4
"37319e88176d4aefa91d7a9980dbae91","62bff51286ef4f348717a3cf6fe2318f",22900214,1,9,0,293,112,120,8
"62bff51286ef4f348717a3cf6fe2318f","b1cd0e7dc3ad4a8eb91a4bfdbeb025b0",22900214,1,-2,0,294,120,118,-2
"b1cd0e7dc3ad4a8eb91a4bfdbeb025b0","b1cd0e7dc3ad4a8eb91a4bfdbeb025b0",22900214,1,0,1,295,118,118,0
"b1cd0e7dc3ad4a8eb91a4bfdbeb025b0","62bff51286ef4f348717a3cf6fe2318f",22900214,1,2,0,296,118,120,2
"62bff51286ef4f348717a3cf6fe2318f","62bff51286ef4f348717a3cf6fe2318f",22900214,3,0,1,297,120,120,0
"62bff51286ef4f348717a3cf6fe2318f","e20db35ced8544ddac5bc3839145e463",22900214,1,-33,0,300,120,91,-29
"e20db35ced8544ddac5bc3839145e463","779f9ddd1fd14d1e9e69f72219a1fdbd",22900214,1,36,0,301,91,121,30
"779f9ddd1fd14d1e9e69f72219a1fdbd","ae26e6cda8ad4a3f81bd347560d9579f",22900214,1,4,0,302,121,125,4
"ae26e6cda8ad4a3f81bd347560d9579f","ae26e6cda8ad4a3f81bd347560d9579f",22900214,3,0,1,303,125,125,0
"ae26e6cda8ad4a3f81bd347560d9579f","ee48df95832b4374aa273ceb27ec1315",22900214,1,1,0,306,125,126,1
"ee48df95832b4374aa273ceb27ec1315","ee48df95832b4374aa273ceb27ec1315",22900214,1,0,1,307,126,126,0
"ee48df95832b4374aa273ceb27ec1315","7a439da90b394756ad1777fc4c6dead5",22900214,1,1,0,308,126,127,1
"7a439da90b394756ad1777fc4c6dead5","7a439da90b394756ad1777fc4c6dead5",22900214,1,0,1,309,127,127,0
"7a439da90b394756ad1777fc4c6dead5","779f9ddd1fd14d1e9e69f72219a1fdbd",22900214,1,-6,0,310,127,121,-6
"779f9ddd1fd14d1e9e69f72219a1fdbd","a8dd5213034441ac92724b4e83eb0bb2",22900214,1,9,0,311,121,129,8
"a8dd5213034441ac92724b4e83eb0bb2","a8dd5213034441ac92724b4e83eb0bb2",22900214,1,0,1,312,129,129,0
"a8dd5213034441ac92724b4e83eb0bb2","8115eab6556b45f5b415c3b8c26a12e5",22900214,1,2,0,313,129,131,2
"8115eab6556b45f5b415c3b8c26a12e5","8115eab6556b45f5b415c3b8c26a12e5",22900214,2,0,1,314,131,131,0
"8115eab6556b45f5b415c3b8c26a12e5","ec34b06efd844b46a4c4818ecdb9b8f4",22900214,1,1,0,316,131,132,1
"ec34b06efd844b46a4c4818ecdb9b8f4","ec34b06efd844b46a4c4818ecdb9b8f4",22900214,2,0,1,317,132,132,0
"ec34b06efd844b46a4c4818ecdb9b8f4","c2e1c2b9eac64109b343a088584b576b",22900214,1,1,0,319,132,133,1
"c2e1c2b9eac64109b343a088584b576b","c2e1c2b9eac64109b343a088584b576b",22900214,2,0,1,320,133,133,0
"c2e1c2b9eac64109b343a088584b576b","579338175e0b4bbb8ef3b712b5d8b54e",22900214,1,-5,0,322,133,128,-5
"579338175e0b4bbb8ef3b712b5d8b54e","8bc5795d6a984a3eace4e2811e52dd4f",22900214,1,8,0,323,128,135,7
"8bc5795d6a984a3eace4e2811e52dd4f","8bc5795d6a984a3eace4e2811e52dd4f",22900214,1,0,1,324,135,135,0
"8bc5795d6a984a3eace4e2811e52dd4f","b416d47c56a742199b5d7c7f19d6503a",22900214,1,-1,0,325,135,134,-1
"b416d47c56a742199b5d7c7f19d6503a","cd4532ad48034873ba8bce2aac0c9808",22900214,1,4,0,326,134,137,3
"cd4532ad48034873ba8bce2aac0c9808","cd4532ad48034873ba8bce2aac0c9808",22900214,1,0,1,327,137,137,0
"cd4532ad48034873ba8bce2aac0c9808","df1de691dafe4549a18a4398ee9dfaf9",22900214,1,4,0,328,137,139,2
"df1de691dafe4549a18a4398ee9dfaf9","779f9ddd1fd14d1e9e69f72219a1fdbd",22900214,1,-23,0,329,139,121,-18
"779f9ddd1fd14d1e9e69f72219a1fdbd","6c5ad271a44743479bfaea29b1db8d02",22900214,1,27,0,330,121,143,22
"6c5ad271a44743479bfaea29b1db8d02","67a089198fcb4e1c8f2385786c2b296f",22900214,1,-130,0,331,143,39,-104
"67a089198fcb4e1c8f2385786c2b296f","df1de691dafe4549a18a4398ee9dfaf9",22900214,1,126,0,332,39,139,100
"df1de691dafe4549a18a4398ee9dfaf9","6c5ad271a44743479bfaea29b1db8d02",22900214,1,4,0,333,139,143,4
"6c5ad271a44743479bfaea29b1db8d02","6c5ad271a44743479bfaea29b1db8d02",22900214,1,0,1,334,143,143,0
"6c5ad271a44743479bfaea29b1db8d02","83d311bed5374fee83d8d67a7d9d82dc",22900214,1,1,0,335,143,144,1
"83d311bed5374fee83d8d67a7d9d82dc","83d311bed5374fee83d8d67a7d9d82dc",22900214,3,0,1,336,144,144,0
"83d311bed5374fee83d8d67a7d9d82dc","402bba41861d43acb52a5abb89e8831e",22900214,1,1,0,339,144,145,1
"402bba41861d43acb52a5abb89e8831e","402bba41861d43acb52a5abb89e8831e",22900214,2,0,1,340,145,145,0
"402bba41861d43acb52a5abb89e8831e","df1de691dafe4549a18a4398ee9dfaf9",22900214,1,-6,0,342,145,139,-6
"df1de691dafe4549a18a4398ee9dfaf9","8aae34f5ddbb4052a709b12e6b0d40fa",22900214,1,9,0,343,139,147,8
"8aae34f5ddbb4052a709b12e6b0d40fa","8aae34f5ddbb4052a709b12e6b0d40fa",22900214,1,0,1,344,147,147,0
"8aae34f5ddbb4052a709b12e6b0d40fa","645b3f0249f64f76af2e19eb4d0e55b7",22900214,1,2,0,345,147,149,2
"645b3f0249f64f76af2e19eb4d0e55b7","645b3f0249f64f76af2e19eb4d0e55b7",22900214,9,0,1,346,149,149,0
"645b3f0249f64f76af2e19eb4d0e55b7","7e7b8db5064d4369805ab370aac5ddfb",22900214,1,1,0,355,149,150,1
"7e7b8db5064d4369805ab370aac5ddfb","7e7b8db5064d4369805ab370aac5ddfb",22900214,2,0,1,356,150,150,0
"7e7b8db5064d4369805ab370aac5ddfb","8956d210ae7f41968fada86d4c979d6a",22900214,1,1,0,358,150,151,1
"8956d210ae7f41968fada86d4c979d6a","8956d210ae7f41968fada86d4c979d6a",22900214,2,0,1,359,151,151,0
"8956d210ae7f41968fada86d4c979d6a","f902b0f41b544d4dbf79664fd233648d",22900214,1,-5,0,361,151,146,-5
"f902b0f41b544d4dbf79664fd233648d","ae781e8b775e4ccd93bc800dad5c8376",22900214,1,8,0,362,146,153,7
"ae781e8b775e4ccd93bc800dad5c8376","ae781e8b775e4ccd93bc800dad5c8376",22900214,2,0,1,363,153,153,0
"ae781e8b775e4ccd93bc800dad5c8376","06882a8492d9499aa31555567f575ecb",22900214,1,1,0,365,153,154,1
"06882a8492d9499aa31555567f575ecb","06882a8492d9499aa31555567f575ecb",22900214,1,0,1,366,154,154,0
"06882a8492d9499aa31555567f575ecb","f293c508f409466a8f27ddd7d1e40b20",22900214,1,1,0,367,154,155,1
"f293c508f409466a8f27ddd7d1e40b20","f293c508f409466a8f27ddd7d1e40b20",22900214,2,0,1,368,155,155,0
"f293c508f409466a8f27ddd7d1e40b20","cc4ddef5bbbe48ebb605141b347c4ed1",22900214,1,1,0,370,155,156,1
"cc4ddef5bbbe48ebb605141b347c4ed1","cc4ddef5bbbe48ebb605141b347c4ed1",22900214,1,0,1,371,156,156,0
"cc4ddef5bbbe48ebb605141b347c4ed1","d313cec988a84645bee413e8d4724a4b",22900214,1,3,0,372,156,158,2
"d313cec988a84645bee413e8d4724a4b","f03480cf4eba413194d7af52fc0e7f28",22900214,1,-7,0,373,158,152,-6
"f03480cf4eba413194d7af52fc0e7f28","d313cec988a84645bee413e8d4724a4b",22900214,1,7,0,374,152,158,6
"d313cec988a84645bee413e8d4724a4b","d313cec988a84645bee413e8d4724a4b",22900214,3,0,1,375,158,158,0
"d313cec988a84645bee413e8d4724a4b","dc60696c76a74368a60f72246e47700d",22900214,1,1,0,378,158,159,1
"dc60696c76a74368a60f72246e47700d","dc60696c76a74368a60f72246e47700d",22900214,1,0,1,379,159,159,0
"dc60696c76a74368a60f72246e47700d","78adeee1fa2c4fe0bc73f7bca9fcee86",22900214,1,3,0,380,159,160,1
"78adeee1fa2c4fe0bc73f7bca9fcee86","df1de691dafe4549a18a4398ee9dfaf9",22900214,1,-26,0,381,160,139,-21
"df1de691dafe4549a18a4398ee9dfaf9","67a089198fcb4e1c8f2385786c2b296f",22900214,1,-126,0,382,139,39,-100
"67a089198fcb4e1c8f2385786c2b296f","3cbcea2be0984e7dbd5a48195af10ce7",22900214,1,160,0,383,39,165,126
"3cbcea2be0984e7dbd5a48195af10ce7","3cbcea2be0984e7dbd5a48195af10ce7",22900214,1,0,1,384,165,165,0
"3cbcea2be0984e7dbd5a48195af10ce7","82e6285962b8400d9d6fc32436022a94",22900214,1,2,0,385,165,167,2
"82e6285962b8400d9d6fc32436022a94","0c7262dff33c4087bc660ccf40f92f9c",22900214,1,7,0,386,167,169,2
"0c7262dff33c4087bc660ccf40f92f9c","0c7262dff33c4087bc660ccf40f92f9c",22900214,1,0,1,387,169,169,0
"0c7262dff33c4087bc660ccf40f92f9c","b2275c3fad834f8d90737a2d9a6927d6",22900214,3,3,0,388,169,172,3
"b2275c3fad834f8d90737a2d9a6927d6","b2275c3fad834f8d90737a2d9a6927d6",22900214,22,0,1,389,172,172,0
"b2275c3fad834f8d90737a2d9a6927d6","eb515a26030b41f8a82a1e6114420bad",22900214,1,1,0,411,172,173,1
"eb515a26030b41f8a82a1e6114420bad","eb515a26030b41f8a82a1e6114420bad",22900214,2,0,1,412,173,173,0
"eb515a26030b41f8a82a1e6114420bad","b42cc17b7de840f181a704558d0bc845",22900214,1,3,0,414,173,175,2
"b42cc17b7de840f181a704558d0bc845","0c7262dff33c4087bc660ccf40f92f9c",22900214,1,-7,0,415,175,169,-6
"0c7262dff33c4087bc660ccf40f92f9c","b42cc17b7de840f181a704558d0bc845",22900214,1,7,0,416,169,175,6
"b42cc17b7de840f181a704558d0bc845","801f9e9135034f49bf5f8b4bdefedb41",22900214,1,2,0,417,175,177,2
"801f9e9135034f49bf5f8b4bdefedb41","801f9e9135034f49bf5f8b4bdefedb41",22900214,7,0,1,418,177,177,0
"801f9e9135034f49bf5f8b4bdefedb41","362fcb0699a14845ab29b2340093e528",22900214,1,-3,0,425,177,174,-3
"362fcb0699a14845ab29b2340093e528","ea38cc0e6e6e41edbabf210220808bf9",22900214,1,6,0,426,174,179,5
"ea38cc0e6e6e41edbabf210220808bf9","b87c552dd247427abe6ab5795b9c9d43",22900214,2,2,0,427,179,181,2
"b87c552dd247427abe6ab5795b9c9d43","ea38cc0e6e6e41edbabf210220808bf9",22900214,1,-2,0,428,181,179,-2
"b87c552dd247427abe6ab5795b9c9d43","b87c552dd247427abe6ab5795b9c9d43",22900214,7,0,1,430,181,181,0
"b87c552dd247427abe6ab5795b9c9d43","139b097acfca451689d80c9c6eebdf7b",22900214,1,-3,0,437,181,178,-3
"b613861cecf84ffcab01afb23f660475","b613861cecf84ffcab01afb23f660475",22901585,4,0,1,1,1,1,0
"b613861cecf84ffcab01afb23f660475","e2911e79efc2420eac45d9f671463d4b",22901585,1,3,0,5,1,2,1
"e2911e79efc2420eac45d9f671463d4b","e2911e79efc2420eac45d9f671463d4b",22901585,2,0,1,6,2,2,0
"e2911e79efc2420eac45d9f671463d4b","519d1b8c59404d67b54e96c5c8a830b2",22901585,1,1,0,8,2,3,1
"519d1b8c59404d67b54e96c5c8a830b2","519d1b8c59404d67b54e96c5c8a830b2",22901585,1,0,1,9,3,3,0
"519d1b8c59404d67b54e96c5c8a830b2","531db53f81f646edb0cdcfe0085b03b7",22901585,1,1,0,10,3,4,1
"531db53f81f646edb0cdcfe0085b03b7","531db53f81f646edb0cdcfe0085b03b7",22901585,1,0,1,11,4,4,0
"531db53f81f646edb0cdcfe0085b03b7","4f5f94b2f95141e0a9d53a61da2276da",22901585,1,1,0,12,4,5,1
"4f5f94b2f95141e0a9d53a61da2276da","4f5f94b2f95141e0a9d53a61da2276da",22901585,1,0,1,13,5,5,0
"4f5f94b2f95141e0a9d53a61da2276da","6d541c89590949f99af293c4f2333f67",22901585,1,1,0,14,5,6,1
"6d541c89590949f99af293c4f2333f67","6d541c89590949f99af293c4f2333f67",22901585,1,0,1,15,6,6,0
"6d541c89590949f99af293c4f2333f67","dd5cf0b9fe4c4f1d8f5ff8e4c04879cb",22901585,1,1,0,16,6,7,1
"dd5cf0b9fe4c4f1d8f5ff8e4c04879cb","dd5cf0b9fe4c4f1d8f5ff8e4c04879cb",22901585,1,0,1,17,7,7,0
"dd5cf0b9fe4c4f1d8f5ff8e4c04879cb","f96261861edc426abe2248be4f0a709a",22901585,1,1,0,18,7,8,1
"f96261861edc426abe2248be4f0a709a","f96261861edc426abe2248be4f0a709a",22901585,1,0,1,19,8,8,0
"f96261861edc426abe2248be4f0a709a","66b5e16f4f75454fb5b8172079f0fa83",22901585,1,1,0,20,8,9,1
"66b5e16f4f75454fb5b8172079f0fa83","66b5e16f4f75454fb5b8172079f0fa83",22901585,1,0,1,21,9,9,0
"66b5e16f4f75454fb5b8172079f0fa83","0680571d4698477995e41842c36a54b2",22901585,1,1,0,22,9,10,1
"0680571d4698477995e41842c36a54b2","0680571d4698477995e41842c36a54b2",22901585,1,0,1,23,10,10,0
"0680571d4698477995e41842c36a54b2","9112f2bffece48e08c6d2287be204085",22901585,1,1,0,24,10,11,1
"9112f2bffece48e08c6d2287be204085","9112f2bffece48e08c6d2287be204085",22901585,1,0,1,25,11,11,0
"9112f2bffece48e08c6d2287be204085","e2911e79efc2420eac45d9f671463d4b",22901585,1,-9,0,26,11,2,-9
"e2911e79efc2420eac45d9f671463d4b","56586aa865414f538729c7f7735d2bc6",22901585,1,12,0,27,2,12,10
"56586aa865414f538729c7f7735d2bc6","56586aa865414f538729c7f7735d2bc6",22901585,5,0,1,28,12,12,0
"56586aa865414f538729c7f7735d2bc6","b7f2b31585d94eb3bf86376714aa7070",22901585,2,2,0,33,12,13,1
"b7f2b31585d94eb3bf86376714aa7070","56586aa865414f538729c7f7735d2bc6",22901585,1,-2,0,34,13,12,-1
"b7f2b31585d94eb3bf86376714aa7070","b7f2b31585d94eb3bf86376714aa7070",22901585,1,0,1,36,13,13,0
"b7f2b31585d94eb3bf86376714aa7070","3f1c815879794b929260d224becaff7e",22901585,1,2,0,37,13,14,1
"3f1c815879794b929260d224becaff7e","81c864a886d54a6b8ff85f7d736f4f95",22901585,2,2,0,38,14,15,1
"81c864a886d54a6b8ff85f7d736f4f95","3f1c815879794b929260d224becaff7e",22901585,1,-2,0,39,15,14,-1
"81c864a886d54a6b8ff85f7d736f4f95","5c5ceeee4562457ba6d41515aeebfbb1",22901585,1,4,0,41,15,17,2
"5c5ceeee4562457ba6d41515aeebfbb1","5c5ceeee4562457ba6d41515aeebfbb1",22901585,1,0,1,42,17,17,0
"5c5ceeee4562457ba6d41515aeebfbb1","56586aa865414f538729c7f7735d2bc6",22901585,1,-10,0,43,17,12,-5
"56586aa865414f538729c7f7735d2bc6","9afd71a5298d4333b6849dfce1b9422c",22901585,1,13,0,44,12,18,6
"9afd71a5298d4333b6849dfce1b9422c","9afd71a5298d4333b6849dfce1b9422c",22901585,5,0,1,45,18,18,0
"9afd71a5298d4333b6849dfce1b9422c","b7719e26494940efa49512aedd0aac79",22901585,1,4,0,50,18,20,2
"b7719e26494940efa49512aedd0aac79","d4f45188d3c84a02ba08454e6403a818",22901585,1,5,0,51,20,24,4
"d4f45188d3c84a02ba08454e6403a818","d4c3b003e8274e429d2fa688d73fde6d",22901585,1,-2,0,52,24,22,-2
"d4c3b003e8274e429d2fa688d73fde6d","d4c3b003e8274e429d2fa688d73fde6d",22901585,1,0,1,53,22,22,0
"d4c3b003e8274e429d2fa688d73fde6d","b7719e26494940efa49512aedd0aac79",22901585,1,-3,0,54,22,20,-2
"b7719e26494940efa49512aedd0aac79","b7719e26494940efa49512aedd0aac79",22901585,1,0,1,55,20,20,0
"b7719e26494940efa49512aedd0aac79","afbf7250b99d47bea07172749483ca97",22901585,1,12,0,56,20,28,8
"afbf7250b99d47bea07172749483ca97","afbf7250b99d47bea07172749483ca97",22901585,1,0,1,57,28,28,0
"afbf7250b99d47bea07172749483ca97","4e51676dc72045d99c19b9fa7b22f8bc",22901585,1,3,0,58,28,29,1
"4e51676dc72045d99c19b9fa7b22f8bc","4e51676dc72045d99c19b9fa7b22f8bc",22901585,1,0,1,59,29,29,0
"4e51676dc72045d99c19b9fa7b22f8bc","51970cfa30e643e894e66ae85c8024cc",22901585,1,3,0,60,29,31,2
"51970cfa30e643e894e66ae85c8024cc","4e51676dc72045d99c19b9fa7b22f8bc",22901585,1,-3,0,61,31,29,-2
"4e51676dc72045d99c19b9fa7b22f8bc","c33c17be71ae4d588da7369472e5bb1b",22901585,1,9,0,62,29,34,5
"c33c17be71ae4d588da7369472e5bb1b","c33c17be71ae4d588da7369472e5bb1b",22901585,1,0,1,63,34,34,0
"c33c17be71ae4d588da7369472e5bb1b","93679be414554a11b1893002f2229a93",22901585,1,3,0,64,34,35,1
"93679be414554a11b1893002f2229a93","7040a13096d746ac84b8fac8d9752058",22901585,2,3,0,65,35,36,1
"7040a13096d746ac84b8fac8d9752058","93679be414554a11b1893002f2229a93",22901585,1,-3,0,66,36,35,-1
"7040a13096d746ac84b8fac8d9752058","9a0dc646f934470daf08c4b56ccf73db",22901585,3,3,0,68,36,37,1
"9a0dc646f934470daf08c4b56ccf73db","fc0e049d56024bc9a02c9a9c435c3df7",22901585,2,3,0,69,37,38,1
"fc0e049d56024bc9a02c9a9c435c3df7","9a0dc646f934470daf08c4b56ccf73db",22901585,1,-3,0,70,38,37,-1
"9a0dc646f934470daf08c4b56ccf73db","67a089198fcb4e1c8f2385786c2b296f",22901585,1,7,0,71,37,39,2
"67a089198fcb4e1c8f2385786c2b296f","fc0e049d56024bc9a02c9a9c435c3df7",22901585,1,-4,0,72,39,38,-1
"fc0e049d56024bc9a02c9a9c435c3df7","64d48c6c9c7940639a932219a6c87198",22901585,1,5,0,73,38,40,2
"64d48c6c9c7940639a932219a6c87198","7040a13096d746ac84b8fac8d9752058",22901585,1,-11,0,74,40,36,-4
"9a0dc646f934470daf08c4b56ccf73db","7040a13096d746ac84b8fac8d9752058",22901585,1,-3,0,76,37,36,-1
"fc0e049d56024bc9a02c9a9c435c3df7","fc0e049d56024bc9a02c9a9c435c3df7",22901585,1,0,1,79,38,38,0
"fc0e049d56024bc9a02c9a9c435c3df7","67a089198fcb4e1c8f2385786c2b296f",22901585,1,4,0,80,38,39,1
"67a089198fcb4e1c8f2385786c2b296f","64d48c6c9c7940639a932219a6c87198",22901585,2,1,0,81,39,40,1
"64d48c6c9c7940639a932219a6c87198","67a089198fcb4e1c8f2385786c2b296f",22901585,2,-1,0,82,40,39,-1
"67a089198fcb4e1c8f2385786c2b296f","67a089198fcb4e1c8f2385786c2b296f",22901585,1,0,1,83,39,39,0
"64d48c6c9c7940639a932219a6c87198","64d48c6c9c7940639a932219a6c87198",22901585,1,0,1,85,40,40,0
"67a089198fcb4e1c8f2385786c2b296f","b534b89233134e30a9b5645138bfa9ee",22901585,1,4,0,87,39,41,2
"b534b89233134e30a9b5645138bfa9ee","0e37b720d23b4e7f8b313e79313fd107",22901585,1,3,0,88,41,44,3
"0e37b720d23b4e7f8b313e79313fd107","0e37b720d23b4e7f8b313e79313fd107",22901585,1,0,1,89,44,44,0
"0e37b720d23b4e7f8b313e79313fd107","6875d67fdd5f48168b62719df449bebd",22901585,1,1,0,90,44,45,1
"6875d67fdd5f48168b62719df449bebd","6875d67fdd5f48168b62719df449bebd",22901585,1,0,1,91,45,45,0
"6875d67fdd5f48168b62719df449bebd","b534b89233134e30a9b5645138bfa9ee",22901585,1,-4,0,92,45,41,-4
"b534b89233134e30a9b5645138bfa9ee","6e13d61a7bdb44bca949c9f86fab3be5",22901585,1,7,0,93,41,47,6
"6e13d61a7bdb44bca949c9f86fab3be5","6e13d61a7bdb44bca949c9f86fab3be5",22901585,2,0,1,94,47,47,0
"6e13d61a7bdb44bca949c9f86fab3be5","195f78799f984cc2b06c48dfe36be751",22901585,1,2,0,96,47,49,2
"195f78799f984cc2b06c48dfe36be751","195f78799f984cc2b06c48dfe36be751",22901585,3,0,1,97,49,49,0
"195f78799f984cc2b06c48dfe36be751","d0c74f735e024943943e40333d6d337f",22901585,1,3,0,100,49,51,2
"d0c74f735e024943943e40333d6d337f","d9c8d8c444a64dadbbb508652c721e17",22901585,1,-6,0,101,51,46,-5
"d9c8d8c444a64dadbbb508652c721e17","d0c74f735e024943943e40333d6d337f",22901585,1,6,0,102,46,51,5
"d0c74f735e024943943e40333d6d337f","983f8ff320594b279a7f4a6fe132f9c5",22901585,1,2,0,103,51,53,2
"983f8ff320594b279a7f4a6fe132f9c5","983f8ff320594b279a7f4a6fe132f9c5",22901585,2,0,1,104,53,53,0
"983f8ff320594b279a7f4a6fe132f9c5","35adfa5d923046aebabfefd98f35ff05",22901585,1,1,0,106,53,54,1
"35adfa5d923046aebabfefd98f35ff05","35adfa5d923046aebabfefd98f35ff05",22901585,5,0,1,107,54,54,0
"35adfa5d923046aebabfefd98f35ff05","b6f8a98476224da1b40e555ececc7ed8",22901585,1,1,0,112,54,55,1
"b6f8a98476224da1b40e555ececc7ed8","b6f8a98476224da1b40e555ececc7ed8",22901585,2,0,1,113,55,55,0
"b6f8a98476224da1b40e555ececc7ed8","86e22cb5fe0e4b47a9489ecddf7ed78f",22901585,1,1,0,115,55,56,1
"86e22cb5fe0e4b47a9489ecddf7ed78f","86e22cb5fe0e4b47a9489ecddf7ed78f",22901585,2,0,1,116,56,56,0
"86e22cb5fe0e4b47a9489ecddf7ed78f","f924752d8a1149668870b1e7698486f7",22901585,1,-6,0,118,56,50,-6
"f924752d8a1149668870b1e7698486f7","78f30e4dcac84e3cbea8b2cc6e0d62b3",22901585,1,10,0,119,50,59,9
"78f30e4dcac84e3cbea8b2cc6e0d62b3","a1f2f12debe5432fb7a70bcd12bacfb9",22901585,1,-1,0,120,59,58,-1
"a1f2f12debe5432fb7a70bcd12bacfb9","a1f2f12debe5432fb7a70bcd12bacfb9",22901585,11,0,1,121,58,58,0
"a1f2f12debe5432fb7a70bcd12bacfb9","78f30e4dcac84e3cbea8b2cc6e0d62b3",22901585,1,1,0,132,58,59,1
"78f30e4dcac84e3cbea8b2cc6e0d62b3","78f30e4dcac84e3cbea8b2cc6e0d62b3",22901585,8,0,1,133,59,59,0
"78f30e4dcac84e3cbea8b2cc6e0d62b3","a0a418b8540d479fa6e0f653b701da8b",22901585,1,6,0,141,59,64,5
"a0a418b8540d479fa6e0f653b701da8b","12aa6e1672ac4e7aa6449a7a8609cd72",22901585,1,-8,0,142,64,57,-7
"12aa6e1672ac4e7aa6449a7a8609cd72","bc42d26810654ea9a1df1efe1e58c7d5",22901585,1,7,0,143,57,63,6
"bc42d26810654ea9a1df1efe1e58c7d5","bc42d26810654ea9a1df1efe1e58c7d5",22901585,4,0,1,144,63,63,0
"bc42d26810654ea9a1df1efe1e58c7d5","4c943503763e4e349906eea3ed3c8e86",22901585,1,-2,0,148,63,61,-2
"4c943503763e4e349906eea3ed3c8e86","4c943503763e4e349906eea3ed3c8e86",22901585,1,0,1,149,61,61,0
"4c943503763e4e349906eea3ed3c8e86","309ccf3cc4fe429d9bfbaef53d3fa479",22901585,1,-1,0,150,61,60,-1
"309ccf3cc4fe429d9bfbaef53d3fa479","b534b89233134e30a9b5645138bfa9ee",22901585,1,-23,0,151,60,41,-19
"b534b89233134e30a9b5645138bfa9ee","d646286c8051419bbc2e31dd1db55ca8",22901585,1,33,0,152,41,67,26
"d646286c8051419bbc2e31dd1db55ca8","d646286c8051419bbc2e31dd1db55ca8",22901585,2,0,1,153,67,67,0
"d646286c8051419bbc2e31dd1db55ca8","267f883678b24aed855fde42524975d9",22901585,1,4,0,155,67,71,4
"267f883678b24aed855fde42524975d9","267f883678b24aed855fde42524975d9",22901585,1,0,1,156,71,71,0
"267f883678b24aed855fde42524975d9","88fff56d0342490dbef9040750a20f6c",22901585,1,1,0,157,71,72,1
"88fff56d0342490dbef9040750a20f6c","88fff56d0342490dbef9040750a20f6c",22901585,1,0,1,158,72,72,0
"88fff56d0342490dbef9040750a20f6c","adb17b12b66c4a49a85fd34322f7df70",22901585,1,1,0,159,72,73,1
"adb17b12b66c4a49a85fd34322f7df70","adb17b12b66c4a49a85fd34322f7df70",22901585,1,0,1,160,73,73,0
"adb17b12b66c4a49a85fd34322f7df70","d646286c8051419bbc2e31dd1db55ca8",22901585,1,-6,0,161,73,67,-6
"d646286c8051419bbc2e31dd1db55ca8","a2becd407db34b189200a32546d9d569",22901585,1,9,0,162,67,75,8
"a2becd407db34b189200a32546d9d569","a2becd407db34b189200a32546d9d569",22901585,1,0,1,163,75,75,0
"a2becd407db34b189200a32546d9d569","58c22b011d0f4c2ea6d13615edbb9eeb",22901585,1,2,0,164,75,77,2
"58c22b011d0f4c2ea6d13615edbb9eeb","58c22b011d0f4c2ea6d13615edbb9eeb",22901585,2,0,1,165,77,77,0
"58c22b011d0f4c2ea6d13615edbb9eeb","dd76e1861dc9461c830888729d091ee0",22901585,1,1,0,167,77,78,1
"dd76e1861dc9461c830888729d091ee0","dd76e1861dc9461c830888729d091ee0",22901585,5,0,1,168,78,78,0
"dd76e1861dc9461c830888729d091ee0","cd1d828f1a694b87913a7ea66c23803e",22901585,1,1,0,173,78,79,1
"cd1d828f1a694b87913a7ea66c23803e","cd1d828f1a694b87913a7ea66c23803e",22901585,2,0,1,174,79,79,0
"cd1d828f1a694b87913a7ea66c23803e","9176a3c2b4d2465fa8b0c67096c2a97e",22901585,1,1,0,176,79,80,1
"9176a3c2b4d2465fa8b0c67096c2a97e","9176a3c2b4d2465fa8b0c67096c2a97e",22901585,5,0,1,177,80,80,0
"9176a3c2b4d2465fa8b0c67096c2a97e","f8ec6445f7194e25b9101d4fbcb07a18",22901585,1,1,0,182,80,81,1
"f8ec6445f7194e25b9101d4fbcb07a18","f8ec6445f7194e25b9101d4fbcb07a18",22901585,2,0,1,183,81,81,0
"f8ec6445f7194e25b9101d4fbcb07a18","140d5b27b8574befad82c0a013b59dfa",22901585,1,-7,0,185,81,74,-7
"140d5b27b8574befad82c0a013b59dfa","d18a9ea32855445f8736581f5cb119ce",22901585,1,9,0,186,74,82,8
"d18a9ea32855445f8736581f5cb119ce","f564483cbd7a407681aa2fcca518cf5f",22901585,1,4,0,187,82,85,3
"f564483cbd7a407681aa2fcca518cf5f","f564483cbd7a407681aa2fcca518cf5f",22901585,1,0,1,188,85,85,0
"f564483cbd7a407681aa2fcca518cf5f","18fd01350bd5434ca636d59a599d768a",22901585,1,1,0,189,85,86,1
"18fd01350bd5434ca636d59a599d768a","18fd01350bd5434ca636d59a599d768a",22901585,9,0,1,190,86,86,0
"18fd01350bd5434ca636d59a599d768a","ae5ac430ea254e708a6f5deaaf7464ae",22901585,2,-2,0,199,86,84,-2
"ae5ac430ea254e708a6f5deaaf7464ae","d18a9ea32855445f8736581f5cb119ce",22901585,3,-3,0,200,84,82,-2
"d18a9ea32855445f8736581f5cb119ce","ae5ac430ea254e708a6f5deaaf7464ae",22901585,1,3,0,201,82,84,2
"d18a9ea32855445f8736581f5cb119ce","18fd01350bd5434ca636d59a599d768a",22901585,1,5,0,203,82,86,4
"ae5ac430ea254e708a6f5deaaf7464ae","6a9f0ef185fb47f0937e29daa1c71ed5",22901585,1,7,0,205,84,90,6
"6a9f0ef185fb47f0937e29daa1c71ed5","42fb58708eaf4e5daa82bfca61b6f5fd",22901585,2,-3,0,206,90,87,-3
"42fb58708eaf4e5daa82bfca61b6f5fd","6a9f0ef185fb47f0937e29daa1c71ed5",22901585,1,3,0,207,87,90,3
"6a9f0ef185fb47f0937e29daa1c71ed5","ae5ac430ea254e708a6f5deaaf7464ae",22901585,1,-7,0,208,90,84,-6
"ae5ac430ea254e708a6f5deaaf7464ae","c681290961c94c4caf23b529d1ae6b9a",22901585,1,5,0,209,84,88,4
"c681290961c94c4caf23b529d1ae6b9a","c681290961c94c4caf23b529d1ae6b9a",22901585,1,0,1,210,88,88,0
"c681290961c94c4caf23b529d1ae6b9a","6a9f0ef185fb47f0937e29daa1c71ed5",22901585,1,2,0,211,88,90,2
"6a9f0ef185fb47f0937e29daa1c71ed5","6a9f0ef185fb47f0937e29daa1c71ed5",22901585,5,0,1,212,90,90,0
"6a9f0ef185fb47f0937e29daa1c71ed5","d646286c8051419bbc2e31dd1db55ca8",22901585,1,-27,0,215,90,67,-23
"d646286c8051419bbc2e31dd1db55ca8","e20db35ced8544ddac5bc3839145e463",22901585,1,30,0,216,67,91,24
"e20db35ced8544ddac5bc3839145e463","e20db35ced8544ddac5bc3839145e463",22901585,1,0,1,217,91,91,0
"e20db35ced8544ddac5bc3839145e463","1febb706d7a34005ae8711ed49c76e64",22901585,1,3,0,218,91,94,3
"1febb706d7a34005ae8711ed49c76e64","1febb706d7a34005ae8711ed49c76e64",22901585,5,0,1,219,94,94,0
"1febb706d7a34005ae8711ed49c76e64","8f73ba6f5a0042f2850356ac38ac6f24",22901585,1,1,0,224,94,95,1
"8f73ba6f5a0042f2850356ac38ac6f24","8f73ba6f5a0042f2850356ac38ac6f24",22901585,5,0,1,225,95,95,0
"8f73ba6f5a0042f2850356ac38ac6f24","e2260b86653c46d7b14a41fb419dbf8c",22901585,1,1,0,230,95,96,1
"e2260b86653c46d7b14a41fb419dbf8c","e2260b86653c46d7b14a41fb419dbf8c",22901585,2,0,1,231,96,96,0
"e2260b86653c46d7b14a41fb419dbf8c","35eb641ad1d845bbba54915bce75a962",22901585,1,1,0,233,96,97,1
"35eb641ad1d845bbba54915bce75a962","35eb641ad1d845bbba54915bce75a962",22901585,5,0,1,234,97,97,0
"35eb641ad1d845bbba54915bce75a962","08be90ffbeea4795a138cd42ed8db56f",22901585,1,1,0,239,97,98,1
"08be90ffbeea4795a138cd42ed8db56f","08be90ffbeea4795a138cd42ed8db56f",22901585,5,0,1,240,98,98,0
"08be90ffbeea4795a138cd42ed8db56f","3007433c8f584dcbb5ac159c1c5f2be3",22901585,1,1,0,245,98,99,1
"3007433c8f584dcbb5ac159c1c5f2be3","3007433c8f584dcbb5ac159c1c5f2be3",22901585,2,0,1,246,99,99,0
"3007433c8f584dcbb5ac159c1c5f2be3","e20db35ced8544ddac5bc3839145e463",22901585,1,-8,0,248,99,91,-8
"e20db35ced8544ddac5bc3839145e463","00ae5f0c51874a73a41ebea838d95682",22901585,1,11,0,249,91,101,10
"00ae5f0c51874a73a41ebea838d95682","d391c8b6e56a43a7b654e9dee02d904b",22901585,2,2,0,250,101,103,2
"d391c8b6e56a43a7b654e9dee02d904b","00ae5f0c51874a73a41ebea838d95682",22901585,1,-2,0,251,103,101,-2
"d391c8b6e56a43a7b654e9dee02d904b","d391c8b6e56a43a7b654e9dee02d904b",22901585,15,0,1,253,103,103,0
"d391c8b6e56a43a7b654e9dee02d904b","6111116566fc4fd9abba409322bea245",22901585,1,1,0,268,103,104,1
"6111116566fc4fd9abba409322bea245","6111116566fc4fd9abba409322bea245",22901585,2,0,1,269,104,104,0
"6111116566fc4fd9abba409322bea245","a81b2235cb9c499eb9ea8ee0a8dd9725",22901585,1,1,0,271,104,105,1
"a81b2235cb9c499eb9ea8ee0a8dd9725","a81b2235cb9c499eb9ea8ee0a8dd9725",22901585,2,0,1,272,105,105,0
"a81b2235cb9c499eb9ea8ee0a8dd9725","2d4e0ab0ef3b4d73b82c72d4621a7579",22901585,1,1,0,274,105,106,1
"2d4e0ab0ef3b4d73b82c72d4621a7579","2d4e0ab0ef3b4d73b82c72d4621a7579",22901585,2,0,1,275,106,106,0
"2d4e0ab0ef3b4d73b82c72d4621a7579","8bdebf492ebd4e62b0d522e8ab5e5197",22901585,1,1,0,277,106,107,1
"8bdebf492ebd4e62b0d522e8ab5e5197","8bdebf492ebd4e62b0d522e8ab5e5197",22901585,2,0,1,278,107,107,0
"8bdebf492ebd4e62b0d522e8ab5e5197","73039f8c1eb9409cb4caee2cf968001e",22901585,1,-7,0,280,107,100,-7
"73039f8c1eb9409cb4caee2cf968001e","4280927ec4d643238aa49c32f9e06c6c",22901585,1,10,0,281,100,109,9
"4280927ec4d643238aa49c32f9e06c6c","4280927ec4d643238aa49c32f9e06c6c",22901585,1,0,1,282,109,109,0
"4280927ec4d643238aa49c32f9e06c6c","fc44e6a5f7654430af1227838224dceb",22901585,1,2,0,283,109,111,2
"fc44e6a5f7654430af1227838224dceb","fc44e6a5f7654430af1227838224dceb",22901585,2,0,1,284,111,111,0
"fc44e6a5f7654430af1227838224dceb","08111f75e22d409998cf8b85bd431f0a",22901585,1,-3,0,286,111,108,-3
"08111f75e22d409998cf8b85bd431f0a","a9ae0a3c070d455bb4369a8996313336",22901585,1,7,0,287,108,114,6
"a9ae0a3c070d455bb4369a8996313336","a9ae0a3c070d455bb4369a8996313336",22901585,1,0,1,288,114,114,0
"a9ae0a3c070d455bb4369a8996313336","71cec822bcff4f30a20e75dc63ef7b65",22901585,1,2,0,289,114,116,2
"71cec822bcff4f30a20e75dc63ef7b65","71cec822bcff4f30a20e75dc63ef7b65",22901585,3,0,1,290,116,116,0
"71cec822bcff4f30a20e75dc63ef7b65","37319e88176d4aefa91d7a9980dbae91",22901585,1,-4,0,293,116,112,-4
"37319e88176d4aefa91d7a9980dbae91","62bff51286ef4f348717a3cf6fe2318f",22901585,1,9,0,294,112,120,8
"62bff51286ef4f348717a3cf6fe2318f","62bff51286ef4f348717a3cf6fe2318f",22901585,4,0,1,295,120,120,0
"62bff51286ef4f348717a3cf6fe2318f","b1cd0e7dc3ad4a8eb91a4bfdbeb025b0",22901585,1,-2,0,299,120,118,-2
"b1cd0e7dc3ad4a8eb91a4bfdbeb025b0","b1cd0e7dc3ad4a8eb91a4bfdbeb025b0",22901585,1,0,1,300,118,118,0
"b1cd0e7dc3ad4a8eb91a4bfdbeb025b0","779f9ddd1fd14d1e9e69f72219a1fdbd",22901585,1,5,0,301,118,121,3
"779f9ddd1fd14d1e9e69f72219a1fdbd","e20db35ced8544ddac5bc3839145e463",22901585,1,-36,0,302,121,91,-30
"e20db35ced8544ddac5bc3839145e463","78adeee1fa2c4fe0bc73f7bca9fcee86",22901585,1,85,0,303,91,160,69
"78adeee1fa2c4fe0bc73f7bca9fcee86","779f9ddd1fd14d1e9e69f72219a1fdbd",22901585,1,-49,0,304,160,121,-39
"779f9ddd1fd14d1e9e69f72219a1fdbd","779f9ddd1fd14d1e9e69f72219a1fdbd",22901585,1,0,1,305,121,121,0
"779f9ddd1fd14d1e9e69f72219a1fdbd","ae26e6cda8ad4a3f81bd347560d9579f",22901585,1,4,0,306,121,125,4
"ae26e6cda8ad4a3f81bd347560d9579f","ae26e6cda8ad4a3f81bd347560d9579f",22901585,5,0,1,307,125,125,0
"ae26e6cda8ad4a3f81bd347560d9579f","ee48df95832b4374aa273ceb27ec1315",22901585,1,1,0,312,125,126,1
"ee48df95832b4374aa273ceb27ec1315","ee48df95832b4374aa273ceb27ec1315",22901585,1,0,1,313,126,126,0
"ee48df95832b4374aa273ceb27ec1315","7a439da90b394756ad1777fc4c6dead5",22901585,1,1,0,314,126,127,1
"7a439da90b394756ad1777fc4c6dead5","7a439da90b394756ad1777fc4c6dead5",22901585,1,0,1,315,127,127,0
"7a439da90b394756ad1777fc4c6dead5","779f9ddd1fd14d1e9e69f72219a1fdbd",22901585,1,-6,0,316,127,121,-6
"779f9ddd1fd14d1e9e69f72219a1fdbd","a8dd5213034441ac92724b4e83eb0bb2",22901585,1,9,0,317,121,129,8
"a8dd5213034441ac92724b4e83eb0bb2","a8dd5213034441ac92724b4e83eb0bb2",22901585,1,0,1,318,129,129,0
"a8dd5213034441ac92724b4e83eb0bb2","8115eab6556b45f5b415c3b8c26a12e5",22901585,1,2,0,319,129,131,2
"8115eab6556b45f5b415c3b8c26a12e5","8115eab6556b45f5b415c3b8c26a12e5",22901585,2,0,1,320,131,131,0
"8115eab6556b45f5b415c3b8c26a12e5","ec34b06efd844b46a4c4818ecdb9b8f4",22901585,1,1,0,322,131,132,1
"ec34b06efd844b46a4c4818ecdb9b8f4","ec34b06efd844b46a4c4818ecdb9b8f4",22901585,2,0,1,323,132,132,0
"ec34b06efd844b46a4c4818ecdb9b8f4","c2e1c2b9eac64109b343a088584b576b",22901585,1,1,0,325,132,133,1
"c2e1c2b9eac64109b343a088584b576b","c2e1c2b9eac64109b343a088584b576b",22901585,2,0,1,326,133,133,0
"c2e1c2b9eac64109b343a088584b576b","579338175e0b4bbb8ef3b712b5d8b54e",22901585,1,-5,0,328,133,128,-5
"579338175e0b4bbb8ef3b712b5d8b54e","8bc5795d6a984a3eace4e2811e52dd4f",22901585,1,8,0,329,128,135,7
"8bc5795d6a984a3eace4e2811e52dd4f","8bc5795d6a984a3eace4e2811e52dd4f",22901585,3,0,1,330,135,135,0
"8bc5795d6a984a3eace4e2811e52dd4f","b416d47c56a742199b5d7c7f19d6503a",22901585,1,-1,0,333,135,134,-1
"b416d47c56a742199b5d7c7f19d6503a","cd4532ad48034873ba8bce2aac0c9808",22901585,1,4,0,334,134,137,3
"cd4532ad48034873ba8bce2aac0c9808","cd4532ad48034873ba8bce2aac0c9808",22901585,1,0,1,335,137,137,0
"cd4532ad48034873ba8bce2aac0c9808","779f9ddd1fd14d1e9e69f72219a1fdbd",22901585,1,-19,0,336,137,121,-16
"779f9ddd1fd14d1e9e69f72219a1fdbd","df1de691dafe4549a18a4398ee9dfaf9",22901585,1,23,0,337,121,139,18
"df1de691dafe4549a18a4398ee9dfaf9","6c5ad271a44743479bfaea29b1db8d02",22901585,1,4,0,338,139,143,4
"6c5ad271a44743479bfaea29b1db8d02","6c5ad271a44743479bfaea29b1db8d02",22901585,1,0,1,339,143,143,0
"6c5ad271a44743479bfaea29b1db8d02","83d311bed5374fee83d8d67a7d9d82dc",22901585,1,1,0,340,143,144,1
"83d311bed5374fee83d8d67a7d9d82dc","83d311bed5374fee83d8d67a7d9d82dc",22901585,1,0,1,341,144,144,0
"83d311bed5374fee83d8d67a7d9d82dc","402bba41861d43acb52a5abb89e8831e",22901585,1,1,0,342,144,145,1
"402bba41861d43acb52a5abb89e8831e","402bba41861d43acb52a5abb89e8831e",22901585,2,0,1,343,145,145,0
"402bba41861d43acb52a5abb89e8831e","df1de691dafe4549a18a4398ee9dfaf9",22901585,1,-6,0,345,145,139,-6
"df1de691dafe4549a18a4398ee9dfaf9","8aae34f5ddbb4052a709b12e6b0d40fa",22901585,1,9,0,346,139,147,8
"8aae34f5ddbb4052a709b12e6b0d40fa","8aae34f5ddbb4052a709b12e6b0d40fa",22901585,1,0,1,347,147,147,0
"8aae34f5ddbb4052a709b12e6b0d40fa","645b3f0249f64f76af2e19eb4d0e55b7",22901585,1,2,0,348,147,149,2
"645b3f0249f64f76af2e19eb4d0e55b7","645b3f0249f64f76af2e19eb4d0e55b7",22901585,5,0,1,349,149,149,0
"645b3f0249f64f76af2e19eb4d0e55b7","7e7b8db5064d4369805ab370aac5ddfb",22901585,1,1,0,354,149,150,1
"7e7b8db5064d4369805ab370aac5ddfb","7e7b8db5064d4369805ab370aac5ddfb",22901585,2,0,1,355,150,150,0
"7e7b8db5064d4369805ab370aac5ddfb","8956d210ae7f41968fada86d4c979d6a",22901585,1,1,0,357,150,151,1
"8956d210ae7f41968fada86d4c979d6a","8956d210ae7f41968fada86d4c979d6a",22901585,5,0,1,358,151,151,0
"8956d210ae7f41968fada86d4c979d6a","f902b0f41b544d4dbf79664fd233648d",22901585,1,-5,0,363,151,146,-5
"f902b0f41b544d4dbf79664fd233648d","ae781e8b775e4ccd93bc800dad5c8376",22901585,1,8,0,364,146,153,7
"ae781e8b775e4ccd93bc800dad5c8376","ae781e8b775e4ccd93bc800dad5c8376",22901585,2,0,1,365,153,153,0
"ae781e8b775e4ccd93bc800dad5c8376","06882a8492d9499aa31555567f575ecb",22901585,1,1,0,367,153,154,1
"06882a8492d9499aa31555567f575ecb","06882a8492d9499aa31555567f575ecb",22901585,1,0,1,368,154,154,0
"06882a8492d9499aa31555567f575ecb","f293c508f409466a8f27ddd7d1e40b20",22901585,1,1,0,369,154,155,1
"f293c508f409466a8f27ddd7d1e40b20","f293c508f409466a8f27ddd7d1e40b20",22901585,2,0,1,370,155,155,0
"f293c508f409466a8f27ddd7d1e40b20","cc4ddef5bbbe48ebb605141b347c4ed1",22901585,1,1,0,372,155,156,1
"cc4ddef5bbbe48ebb605141b347c4ed1","cc4ddef5bbbe48ebb605141b347c4ed1",22901585,1,0,1,373,156,156,0
"cc4ddef5bbbe48ebb605141b347c4ed1","f03480cf4eba413194d7af52fc0e7f28",22901585,1,-4,0,374,156,152,-4
"f03480cf4eba413194d7af52fc0e7f28","d313cec988a84645bee413e8d4724a4b",22901585,1,7,0,375,152,158,6
"d313cec988a84645bee413e8d4724a4b","d313cec988a84645bee413e8d4724a4b",22901585,4,0,1,376,158,158,0
"d313cec988a84645bee413e8d4724a4b","dc60696c76a74368a60f72246e47700d",22901585,1,1,0,380,158,159,1
"dc60696c76a74368a60f72246e47700d","dc60696c76a74368a60f72246e47700d",22901585,1,0,1,381,159,159,0
"dc60696c76a74368a60f72246e47700d","df1de691dafe4549a18a4398ee9dfaf9",22901585,1,-23,0,382,159,139,-20
"df1de691dafe4549a18a4398ee9dfaf9","78adeee1fa2c4fe0bc73f7bca9fcee86",22901585,1,26,0,383,139,160,21
"78adeee1fa2c4fe0bc73f7bca9fcee86","8959e6304a0348309a771e4d08d1b64a",22901585,1,4,0,384,160,163,3
"8959e6304a0348309a771e4d08d1b64a","78adeee1fa2c4fe0bc73f7bca9fcee86",22901585,2,-4,0,385,163,160,-3
"78adeee1fa2c4fe0bc73f7bca9fcee86","65202579580f4ad38d734b4ee39d22a8",22901585,4,5,0,386,160,164,4
"65202579580f4ad38d734b4ee39d22a8","65202579580f4ad38d734b4ee39d22a8",22901585,65,0,1,387,164,164,0
"65202579580f4ad38d734b4ee39d22a8","8959e6304a0348309a771e4d08d1b64a",22901585,1,-1,0,394,164,163,-1
"78adeee1fa2c4fe0bc73f7bca9fcee86","d646286c8051419bbc2e31dd1db55ca8",22901585,1,-115,0,396,160,67,-93
"d646286c8051419bbc2e31dd1db55ca8","6a9f0ef185fb47f0937e29daa1c71ed5",22901585,1,27,0,397,67,90,23
"42fb58708eaf4e5daa82bfca61b6f5fd","ae5ac430ea254e708a6f5deaaf7464ae",22901585,1,-4,0,401,87,84,-3
"d18a9ea32855445f8736581f5cb119ce","78adeee1fa2c4fe0bc73f7bca9fcee86",22901585,1,98,0,403,82,160,78
"78adeee1fa2c4fe0bc73f7bca9fcee86","78adeee1fa2c4fe0bc73f7bca9fcee86",22901585,1,0,1,404,160,160,0
"65202579580f4ad38d734b4ee39d22a8","78adeee1fa2c4fe0bc73f7bca9fcee86",22901585,3,-5,0,406,164,160,-4
"78adeee1fa2c4fe0bc73f7bca9fcee86","3cbcea2be0984e7dbd5a48195af10ce7",22901585,2,8,0,458,160,165,5
"3cbcea2be0984e7dbd5a48195af10ce7","82e6285962b8400d9d6fc32436022a94",22901585,2,2,0,459,165,167,2
"82e6285962b8400d9d6fc32436022a94","3cbcea2be0984e7dbd5a48195af10ce7",22901585,1,-2,0,460,167,165,-2
"3cbcea2be0984e7dbd5a48195af10ce7","a9ac840f098c4bd0a2ee896214ce29cd",22901585,1,5,0,461,165,168,3
"a9ac840f098c4bd0a2ee896214ce29cd","a9ac840f098c4bd0a2ee896214ce29cd",22901585,1,0,1,462,168,168,0
"a9ac840f098c4bd0a2ee896214ce29cd","0c7262dff33c4087bc660ccf40f92f9c",22901585,1,4,0,463,168,169,1
"0c7262dff33c4087bc660ccf40f92f9c","b2275c3fad834f8d90737a2d9a6927d6",22901585,2,3,0,464,169,172,3
"b2275c3fad834f8d90737a2d9a6927d6","78adeee1fa2c4fe0bc73f7bca9fcee86",22901585,1,-20,0,465,172,160,-12
"82e6285962b8400d9d6fc32436022a94","a9ac840f098c4bd0a2ee896214ce29cd",22901585,1,3,0,479,167,168,1
"a9ac840f098c4bd0a2ee896214ce29cd","3cbcea2be0984e7dbd5a48195af10ce7",22901585,1,-5,0,480,168,165,-3
"3cbcea2be0984e7dbd5a48195af10ce7","0c7262dff33c4087bc660ccf40f92f9c",22901585,1,9,0,481,165,169,4
"0c7262dff33c4087bc660ccf40f92f9c","0c7262dff33c4087bc660ccf40f92f9c",22901585,1,0,1,482,169,169,0
"b2275c3fad834f8d90737a2d9a6927d6","b2275c3fad834f8d90737a2d9a6927d6",22901585,25,0,1,484,172,172,0
"b2275c3fad834f8d90737a2d9a6927d6","eb515a26030b41f8a82a1e6114420bad",22901585,1,1,0,509,172,173,1
"eb515a26030b41f8a82a1e6114420bad","eb515a26030b41f8a82a1e6114420bad",22901585,2,0,1,510,173,173,0
"eb515a26030b41f8a82a1e6114420bad","b42cc17b7de840f181a704558d0bc845",22901585,1,3,0,512,173,175,2
"b42cc17b7de840f181a704558d0bc845","0c7262dff33c4087bc660ccf40f92f9c",22901585,1,-7,0,513,175,169,-6
"0c7262dff33c4087bc660ccf40f92f9c","b42cc17b7de840f181a704558d0bc845",22901585,1,7,0,514,169,175,6
"b42cc17b7de840f181a704558d0bc845","801f9e9135034f49bf5f8b4bdefedb41",22901585,1,2,0,515,175,177,2
"801f9e9135034f49bf5f8b4bdefedb41","801f9e9135034f49bf5f8b4bdefedb41",22901585,4,0,1,516,177,177,0
"801f9e9135034f49bf5f8b4bdefedb41","362fcb0699a14845ab29b2340093e528",22901585,1,-3,0,520,177,174,-3
"362fcb0699a14845ab29b2340093e528","b87c552dd247427abe6ab5795b9c9d43",22901585,1,8,0,521,174,181,7
"b87c552dd247427abe6ab5795b9c9d43","ea38cc0e6e6e41edbabf210220808bf9",22901585,1,-2,0,522,181,179,-2
"ea38cc0e6e6e41edbabf210220808bf9","ea38cc0e6e6e41edbabf210220808bf9",22901585,1,0,1,523,179,179,0
"ea38cc0e6e6e41edbabf210220808bf9","b87c552dd247427abe6ab5795b9c9d43",22901585,1,2,0,524,179,181,2
"b87c552dd247427abe6ab5795b9c9d43","b87c552dd247427abe6ab5795b9c9d43",22901585,8,0,1,525,181,181,0
"b87c552dd247427abe6ab5795b9c9d43","139b097acfca451689d80c9c6eebdf7b",22901585,1,-3,0,533,181,178,-3
"139b097acfca451689d80c9c6eebdf7b","30f660a1feb34582a739722532524f79",22901585,1,6,0,534,178,183,5
"30f660a1feb34582a739722532524f79","30f660a1feb34582a739722532524f79",22901585,5,0,1,535,183,183,0
"30f660a1feb34582a739722532524f79","2024b4885bd14338a39b7b509acbbd02",22901585,1,-1,0,540,183,182,-1
"2024b4885bd14338a39b7b509acbbd02","c3f63fe50d8e487c86bf8ef76c9cadd3",22901585,1,4,0,541,182,185,3
"c3f63fe50d8e487c86bf8ef76c9cadd3","c3f63fe50d8e487c86bf8ef76c9cadd3",22901585,1,0,1,542,185,185,0
"c3f63fe50d8e487c86bf8ef76c9cadd3","c8e371568a0c4391b25796ae4e91952e",22901585,1,3,0,543,185,186,1
"c8e371568a0c4391b25796ae4e91952e","0c7262dff33c4087bc660ccf40f92f9c",22901585,1,-23,0,544,186,169,-17
"0c7262dff33c4087bc660ccf40f92f9c","7d932b23e1c84326ae5aa4d3c0d813d1",22901585,1,25,0,545,169,188,19
"7d932b23e1c84326ae5aa4d3c0d813d1","7d932b23e1c84326ae5aa4d3c0d813d1",22901585,3,0,1,546,188,188,0
"7d932b23e1c84326ae5aa4d3c0d813d1","ab11d94c6c8948ea90b88f19d2cd502b",22901585,1,3,0,549,188,190,2
"ab11d94c6c8948ea90b88f19d2cd502b","c8e371568a0c4391b25796ae4e91952e",22901585,1,-5,0,550,190,186,-4
"c8e371568a0c4391b25796ae4e91952e","ab11d94c6c8948ea90b88f19d2cd502b",22901585,1,5,0,551,186,190,4
"ab11d94c6c8948ea90b88f19d2cd502b","f992451ed6ad4e68bb9e68ad6be7c4be",22901585,1,2,0,552,190,192,2
"f992451ed6ad4e68bb9e68ad6be7c4be","f992451ed6ad4e68bb9e68ad6be7c4be",22901585,1,0,1,553,192,192,0
"f992451ed6ad4e68bb9e68ad6be7c4be","6cd2dcaac46847d4a0bc53f296d90375",22901585,1,3,0,554,192,194,2
"6cd2dcaac46847d4a0bc53f296d90375","07b44a7a51e94c78b411c753fc39dab0",22901585,1,-6,0,555,194,189,-5
"07b44a7a51e94c78b411c753fc39dab0","6cd2dcaac46847d4a0bc53f296d90375",22901585,1,6,0,556,189,194,5
"6cd2dcaac46847d4a0bc53f296d90375","2d2580c9411c4972909db508d6956a58",22901585,1,2,0,557,194,196,2
"2d2580c9411c4972909db508d6956a58","2d2580c9411c4972909db508d6956a58",22901585,2,0,1,558,196,196,0
"2d2580c9411c4972909db508d6956a58","5bddb3d9ed264f3984702f048c7e5340",22901585,1,1,0,560,196,197,1
"5bddb3d9ed264f3984702f048c7e5340","5bddb3d9ed264f3984702f048c7e5340",22901585,2,0,1,561,197,197,0
"5bddb3d9ed264f3984702f048c7e5340","d5e8e2bd12a2466b9d6d90855f0eb079",22901585,1,1,0,563,197,198,1
"d5e8e2bd12a2466b9d6d90855f0eb079","d5e8e2bd12a2466b9d6d90855f0eb079",22901585,2,0,1,564,198,198,0
"d5e8e2bd12a2466b9d6d90855f0eb079","017d7ca8e0394b91aaadc9574df2202c",22901585,1,-5,0,566,198,193,-5
"017d7ca8e0394b91aaadc9574df2202c","54e8e9f0ea3e45c4bf3b8ac799ee31b1",22901585,1,8,0,567,193,200,7
"54e8e9f0ea3e45c4bf3b8ac799ee31b1","54e8e9f0ea3e45c4bf3b8ac799ee31b1",22901585,1,0,1,568,200,200,0
"54e8e9f0ea3e45c4bf3b8ac799ee31b1","c614a00911be4877a075f19315530fb0",22901585,1,1,0,569,200,201,1
"c614a00911be4877a075f19315530fb0","c614a00911be4877a075f19315530fb0",22901585,6,0,1,570,201,201,0
"c614a00911be4877a075f19315530fb0","a6c21bd8b95249c7972820a7a7d76aff",22901585,1,1,0,576,201,202,1
"a6c21bd8b95249c7972820a7a7d76aff","a6c21bd8b95249c7972820a7a7d76aff",22901585,1,0,1,577,202,202,0
"a6c21bd8b95249c7972820a7a7d76aff","bb329d880ab54120adaf203a693bb203",22901585,1,1,0,578,202,203,1
"bb329d880ab54120adaf203a693bb203","bb329d880ab54120adaf203a693bb203",22901585,3,0,1,579,203,203,0
"bb329d880ab54120adaf203a693bb203","f9170dd6bc6442b4acd832747609b09a",22901585,1,-4,0,582,203,199,-4
"f9170dd6bc6442b4acd832747609b09a","334c2344009840079b1d0e1b7ce3d5a7",22901585,1,7,0,583,199,205,6
"334c2344009840079b1d0e1b7ce3d5a7","334c2344009840079b1d0e1b7ce3d5a7",22901585,1,0,1,584,205,205,0
"334c2344009840079b1d0e1b7ce3d5a7","c8e371568a0c4391b25796ae4e91952e",22901585,1,-23,0,585,205,186,-19
"c8e371568a0c4391b25796ae4e91952e","d7f13c8d63ec4e2aa673fbb9cf9c6933",22901585,1,26,0,586,186,206,20
"d7f13c8d63ec4e2aa673fbb9cf9c6933","b9e80f77c3a44349863b19875725c384",22901585,2,1,0,587,206,207,1
"b9e80f77c3a44349863b19875725c384","7108f0e4c2584f1f9c471689ae4c885c",22901585,3,1,0,588,207,208,1
"7108f0e4c2584f1f9c471689ae4c885c","d7f13c8d63ec4e2aa673fbb9cf9c6933",22901585,1,-2,0,589,208,206,-2
"d7f13c8d63ec4e2aa673fbb9cf9c6933","d7f13c8d63ec4e2aa673fbb9cf9c6933",22901585,1,0,1,590,206,206,0
"7108f0e4c2584f1f9c471689ae4c885c","b9e80f77c3a44349863b19875725c384",22901585,1,-1,0,593,208,207,-1
"b9e80f77c3a44349863b19875725c384","b9e80f77c3a44349863b19875725c384",22901585,21,0,1,594,207,207,0
"7108f0e4c2584f1f9c471689ae4c885c","7108f0e4c2584f1f9c471689ae4c885c",22901585,10,0,1,616,208,208,0
"7108f0e4c2584f1f9c471689ae4c885c","09400e101c5d4b439cf9a26b03aae558",22901585,1,3,0,626,208,210,2
"09400e101c5d4b439cf9a26b03aae558","d7f13c8d63ec4e2aa673fbb9cf9c6933",22901585,2,-5,0,627,210,206,-4
"d7f13c8d63ec4e2aa673fbb9cf9c6933","09400e101c5d4b439cf9a26b03aae558",22901585,1,5,0,628,206,210,4
"b613861cecf84ffcab01afb23f660475","b613861cecf84ffcab01afb23f660475",22901966,5,0,1,1,1,1,0
"b613861cecf84ffcab01afb23f660475","e2911e79efc2420eac45d9f671463d4b",22901966,2,3,0,6,1,2,1
"e2911e79efc2420eac45d9f671463d4b","b613861cecf84ffcab01afb23f660475",22901966,1,-3,0,7,2,1,-1
"e2911e79efc2420eac45d9f671463d4b","519d1b8c59404d67b54e96c5c8a830b2",22901966,1,1,0,10,2,3,1
"519d1b8c59404d67b54e96c5c8a830b2","519d1b8c59404d67b54e96c5c8a830b2",22901966,1,0,1,11,3,3,0
"519d1b8c59404d67b54e96c5c8a830b2","531db53f81f646edb0cdcfe0085b03b7",22901966,1,1,0,12,3,4,1
"531db53f81f646edb0cdcfe0085b03b7","531db53f81f646edb0cdcfe0085b03b7",22901966,1,0,1,13,4,4,0
"531db53f81f646edb0cdcfe0085b03b7","4f5f94b2f95141e0a9d53a61da2276da",22901966,1,1,0,14,4,5,1
"4f5f94b2f95141e0a9d53a61da2276da","4f5f94b2f95141e0a9d53a61da2276da",22901966,1,0,1,15,5,5,0
"4f5f94b2f95141e0a9d53a61da2276da","6d541c89590949f99af293c4f2333f67",22901966,1,1,0,16,5,6,1
"6d541c89590949f99af293c4f2333f67","6d541c89590949f99af293c4f2333f67",22901966,1,0,1,17,6,6,0
"6d541c89590949f99af293c4f2333f67","dd5cf0b9fe4c4f1d8f5ff8e4c04879cb",22901966,1,1,0,18,6,7,1
"dd5cf0b9fe4c4f1d8f5ff8e4c04879cb","dd5cf0b9fe4c4f1d8f5ff8e4c04879cb",22901966,1,0,1,19,7,7,0
"dd5cf0b9fe4c4f1d8f5ff8e4c04879cb","e2911e79efc2420eac45d9f671463d4b",22901966,1,-5,0,20,7,2,-5
"e2911e79efc2420eac45d9f671463d4b","f96261861edc426abe2248be4f0a709a",22901966,1,6,0,21,2,8,6
"f96261861edc426abe2248be4f0a709a","f96261861edc426abe2248be4f0a709a",22901966,1,0,1,22,8,8,0
"f96261861edc426abe2248be4f0a709a","66b5e16f4f75454fb5b8172079f0fa83",22901966,1,1,0,23,8,9,1
"66b5e16f4f75454fb5b8172079f0fa83","66b5e16f4f75454fb5b8172079f0fa83",22901966,1,0,1,24,9,9,0
"66b5e16f4f75454fb5b8172079f0fa83","0680571d4698477995e41842c36a54b2",22901966,1,1,0,25,9,10,1
"0680571d4698477995e41842c36a54b2","0680571d4698477995e41842c36a54b2",22901966,1,0,1,26,10,10,0
"0680571d4698477995e41842c36a54b2","9112f2bffece48e08c6d2287be204085",22901966,1,1,0,27,10,11,1
"9112f2bffece48e08c6d2287be204085","9112f2bffece48e08c6d2287be204085",22901966,1,0,1,28,11,11,0
"9112f2bffece48e08c6d2287be204085","e2911e79efc2420eac45d9f671463d4b",22901966,1,-9,0,29,11,2,-9
"e2911e79efc2420eac45d9f671463d4b","56586aa865414f538729c7f7735d2bc6",22901966,2,12,0,30,2,12,10
"56586aa865414f538729c7f7735d2bc6","56586aa865414f538729c7f7735d2bc6",22901966,3,0,1,31,12,12,0
"56586aa865414f538729c7f7735d2bc6","e2911e79efc2420eac45d9f671463d4b",22901966,1,-12,0,32,12,2,-10
"e2911e79efc2420eac45d9f671463d4b","e2911e79efc2420eac45d9f671463d4b",22901966,2,0,1,33,2,2,0
"56586aa865414f538729c7f7735d2bc6","b7f2b31585d94eb3bf86376714aa7070",22901966,2,2,0,37,12,13,1
"b7f2b31585d94eb3bf86376714aa7070","56586aa865414f538729c7f7735d2bc6",22901966,1,-2,0,38,13,12,-1
"b7f2b31585d94eb3bf86376714aa7070","b7f2b31585d94eb3bf86376714aa7070",22901966,1,0,1,40,13,13,0
"b7f2b31585d94eb3bf86376714aa7070","3f1c815879794b929260d224becaff7e",22901966,1,2,0,41,13,14,1
"3f1c815879794b929260d224becaff7e","81c864a886d54a6b8ff85f7d736f4f95",22901966,1,2,0,42,14,15,1
"81c864a886d54a6b8ff85f7d736f4f95","5c5ceeee4562457ba6d41515aeebfbb1",22901966,1,4,0,43,15,17,2
"5c5ceeee4562457ba6d41515aeebfbb1","5c5ceeee4562457ba6d41515aeebfbb1",22901966,1,0,1,44,17,17,0
"5c5ceeee4562457ba6d41515aeebfbb1","56586aa865414f538729c7f7735d2bc6",22901966,1,-10,0,45,17,12,-5
"56586aa865414f538729c7f7735d2bc6","9afd71a5298d4333b6849dfce1b9422c",22901966,1,13,0,46,12,18,6
"9afd71a5298d4333b6849dfce1b9422c","b7719e26494940efa49512aedd0aac79",22901966,1,4,0,47,18,20,2
"b7719e26494940efa49512aedd0aac79","9afd71a5298d4333b6849dfce1b9422c",22901966,1,-4,0,48,20,18,-2
"9afd71a5298d4333b6849dfce1b9422c","d4f45188d3c84a02ba08454e6403a818",22901966,1,9,0,49,18,24,6
"d4f45188d3c84a02ba08454e6403a818","d4c3b003e8274e429d2fa688d73fde6d",22901966,1,-2,0,50,24,22,-2
"d4c3b003e8274e429d2fa688d73fde6d","d4c3b003e8274e429d2fa688d73fde6d",22901966,1,0,1,51,22,22,0
"d4c3b003e8274e429d2fa688d73fde6d","5bc03c8f16354d04bd51f5bb93559ad3",22901966,1,4,0,52,22,26,4
"5bc03c8f16354d04bd51f5bb93559ad3","b7719e26494940efa49512aedd0aac79",22901966,1,-7,0,53,26,20,-6
"b7719e26494940efa49512aedd0aac79","b7719e26494940efa49512aedd0aac79",22901966,1,0,1,54,20,20,0
"b7719e26494940efa49512aedd0aac79","afbf7250b99d47bea07172749483ca97",22901966,1,12,0,55,20,28,8
"afbf7250b99d47bea07172749483ca97","afbf7250b99d47bea07172749483ca97",22901966,1,0,1,56,28,28,0
"afbf7250b99d47bea07172749483ca97","4e51676dc72045d99c19b9fa7b22f8bc",22901966,1,3,0,57,28,29,1
"4e51676dc72045d99c19b9fa7b22f8bc","4e51676dc72045d99c19b9fa7b22f8bc",22901966,1,0,1,58,29,29,0
"4e51676dc72045d99c19b9fa7b22f8bc","51970cfa30e643e894e66ae85c8024cc",22901966,1,3,0,59,29,31,2
"51970cfa30e643e894e66ae85c8024cc","c33c17be71ae4d588da7369472e5bb1b",22901966,1,6,0,60,31,34,3
"c33c17be71ae4d588da7369472e5bb1b","4e51676dc72045d99c19b9fa7b22f8bc",22901966,1,-9,0,61,34,29,-5
"4e51676dc72045d99c19b9fa7b22f8bc","93679be414554a11b1893002f2229a93",22901966,1,12,0,62,29,35,6
"93679be414554a11b1893002f2229a93","c33c17be71ae4d588da7369472e5bb1b",22901966,1,-3,0,63,35,34,-1
"c33c17be71ae4d588da7369472e5bb1b","7040a13096d746ac84b8fac8d9752058",22901966,1,6,0,64,34,36,2
"7040a13096d746ac84b8fac8d9752058","93679be414554a11b1893002f2229a93",22901966,1,-3,0,65,36,35,-1
"93679be414554a11b1893002f2229a93","7040a13096d746ac84b8fac8d9752058",22901966,1,3,0,66,35,36,1
"7040a13096d746ac84b8fac8d9752058","9a0dc646f934470daf08c4b56ccf73db",22901966,1,3,0,67,36,37,1
"9a0dc646f934470daf08c4b56ccf73db","fc0e049d56024bc9a02c9a9c435c3df7",22901966,1,3,0,68,37,38,1
"fc0e049d56024bc9a02c9a9c435c3df7","9a0dc646f934470daf08c4b56ccf73db",22901966,1,-3,0,69,38,37,-1
"9a0dc646f934470daf08c4b56ccf73db","67a089198fcb4e1c8f2385786c2b296f",22901966,1,7,0,70,37,39,2
"67a089198fcb4e1c8f2385786c2b296f","fc0e049d56024bc9a02c9a9c435c3df7",22901966,1,-4,0,71,39,38,-1
"fc0e049d56024bc9a02c9a9c435c3df7","64d48c6c9c7940639a932219a6c87198",22901966,1,5,0,72,38,40,2
"64d48c6c9c7940639a932219a6c87198","64d48c6c9c7940639a932219a6c87198",22901966,1,0,1,73,40,40,0
"64d48c6c9c7940639a932219a6c87198","67a089198fcb4e1c8f2385786c2b296f",22901966,1,-1,0,74,40,39,-1
"67a089198fcb4e1c8f2385786c2b296f","b534b89233134e30a9b5645138bfa9ee",22901966,1,4,0,75,39,41,2
"b534b89233134e30a9b5645138bfa9ee","0e37b720d23b4e7f8b313e79313fd107",22901966,1,3,0,76,41,44,3
"0e37b720d23b4e7f8b313e79313fd107","0e37b720d23b4e7f8b313e79313fd107",22901966,1,0,1,77,44,44,0
"0e37b720d23b4e7f8b313e79313fd107","6875d67fdd5f48168b62719df449bebd",22901966,1,1,0,78,44,45,1
"6875d67fdd5f48168b62719df449bebd","6875d67fdd5f48168b62719df449bebd",22901966,1,0,1,79,45,45,0
"6875d67fdd5f48168b62719df449bebd","b534b89233134e30a9b5645138bfa9ee",22901966,1,-4,0,80,45,41,-4
"b534b89233134e30a9b5645138bfa9ee","6e13d61a7bdb44bca949c9f86fab3be5",22901966,1,7,0,81,41,47,6
"6e13d61a7bdb44bca949c9f86fab3be5","6e13d61a7bdb44bca949c9f86fab3be5",22901966,1,0,1,82,47,47,0
"6e13d61a7bdb44bca949c9f86fab3be5","195f78799f984cc2b06c48dfe36be751",22901966,1,2,0,83,47,49,2
"195f78799f984cc2b06c48dfe36be751","195f78799f984cc2b06c48dfe36be751",22901966,2,0,1,84,49,49,0
"195f78799f984cc2b06c48dfe36be751","d9c8d8c444a64dadbbb508652c721e17",22901966,1,-3,0,86,49,46,-3
"d9c8d8c444a64dadbbb508652c721e17","d0c74f735e024943943e40333d6d337f",22901966,1,6,0,87,46,51,5
"d0c74f735e024943943e40333d6d337f","d0c74f735e024943943e40333d6d337f",22901966,1,0,1,88,51,51,0
"d0c74f735e024943943e40333d6d337f","983f8ff320594b279a7f4a6fe132f9c5",22901966,1,2,0,89,51,53,2
"983f8ff320594b279a7f4a6fe132f9c5","983f8ff320594b279a7f4a6fe132f9c5",22901966,2,0,1,90,53,53,0
"983f8ff320594b279a7f4a6fe132f9c5","35adfa5d923046aebabfefd98f35ff05",22901966,1,1,0,92,53,54,1
"35adfa5d923046aebabfefd98f35ff05","35adfa5d923046aebabfefd98f35ff05",22901966,8,0,1,100,54,54,0
"35adfa5d923046aebabfefd98f35ff05","b6f8a98476224da1b40e555ececc7ed8",22901966,1,1,0,101,54,55,1
"b6f8a98476224da1b40e555ececc7ed8","b6f8a98476224da1b40e555ececc7ed8",22901966,2,0,1,102,55,55,0
"b6f8a98476224da1b40e555ececc7ed8","86e22cb5fe0e4b47a9489ecddf7ed78f",22901966,1,1,0,104,55,56,1
"86e22cb5fe0e4b47a9489ecddf7ed78f","86e22cb5fe0e4b47a9489ecddf7ed78f",22901966,2,0,1,105,56,56,0
"86e22cb5fe0e4b47a9489ecddf7ed78f","f924752d8a1149668870b1e7698486f7",22901966,1,-6,0,107,56,50,-6
"f924752d8a1149668870b1e7698486f7","a1f2f12debe5432fb7a70bcd12bacfb9",22901966,1,9,0,108,50,58,8
"a1f2f12debe5432fb7a70bcd12bacfb9","78f30e4dcac84e3cbea8b2cc6e0d62b3",22901966,2,1,0,109,58,59,1
"78f30e4dcac84e3cbea8b2cc6e0d62b3","a1f2f12debe5432fb7a70bcd12bacfb9",22901966,1,-1,0,110,59,58,-1
"a1f2f12debe5432fb7a70bcd12bacfb9","a1f2f12debe5432fb7a70bcd12bacfb9",22901966,9,0,1,111,58,58,0
"78f30e4dcac84e3cbea8b2cc6e0d62b3","78f30e4dcac84e3cbea8b2cc6e0d62b3",22901966,7,0,1,121,59,59,0
"78f30e4dcac84e3cbea8b2cc6e0d62b3","12aa6e1672ac4e7aa6449a7a8609cd72",22901966,1,-2,0,128,59,57,-2
"12aa6e1672ac4e7aa6449a7a8609cd72","bc42d26810654ea9a1df1efe1e58c7d5",22901966,1,7,0,129,57,63,6
"bc42d26810654ea9a1df1efe1e58c7d5","a0a418b8540d479fa6e0f653b701da8b",22901966,2,1,0,130,63,64,1
"a0a418b8540d479fa6e0f653b701da8b","4c943503763e4e349906eea3ed3c8e86",22901966,1,-3,0,131,64,61,-3
"4c943503763e4e349906eea3ed3c8e86","4c943503763e4e349906eea3ed3c8e86",22901966,1,0,1,132,61,61,0
"4c943503763e4e349906eea3ed3c8e86","bc42d26810654ea9a1df1efe1e58c7d5",22901966,1,2,0,133,61,63,2
"bc42d26810654ea9a1df1efe1e58c7d5","bc42d26810654ea9a1df1efe1e58c7d5",22901966,3,0,1,134,63,63,0
"a0a418b8540d479fa6e0f653b701da8b","a0a418b8540d479fa6e0f653b701da8b",22901966,3,0,1,138,64,64,0
"a0a418b8540d479fa6e0f653b701da8b","309ccf3cc4fe429d9bfbaef53d3fa479",22901966,1,-4,0,141,64,60,-4
"309ccf3cc4fe429d9bfbaef53d3fa479","d646286c8051419bbc2e31dd1db55ca8",22901966,1,10,0,142,60,67,7
"d646286c8051419bbc2e31dd1db55ca8","b534b89233134e30a9b5645138bfa9ee",22901966,1,-33,0,143,67,41,-26
"b534b89233134e30a9b5645138bfa9ee","267f883678b24aed855fde42524975d9",22901966,1,37,0,144,41,71,30
"267f883678b24aed855fde42524975d9","267f883678b24aed855fde42524975d9",22901966,1,0,1,145,71,71,0
"267f883678b24aed855fde42524975d9","88fff56d0342490dbef9040750a20f6c",22901966,1,1,0,146,71,72,1
"88fff56d0342490dbef9040750a20f6c","88fff56d0342490dbef9040750a20f6c",22901966,1,0,1,147,72,72,0
"88fff56d0342490dbef9040750a20f6c","adb17b12b66c4a49a85fd34322f7df70",22901966,1,1,0,148,72,73,1
"adb17b12b66c4a49a85fd34322f7df70","adb17b12b66c4a49a85fd34322f7df70",22901966,1,0,1,149,73,73,0
"adb17b12b66c4a49a85fd34322f7df70","a2becd407db34b189200a32546d9d569",22901966,1,3,0,150,73,75,2
"a2becd407db34b189200a32546d9d569","d646286c8051419bbc2e31dd1db55ca8",22901966,1,-9,0,151,75,67,-8
"d646286c8051419bbc2e31dd1db55ca8","a2becd407db34b189200a32546d9d569",22901966,1,9,0,152,67,75,8
"a2becd407db34b189200a32546d9d569","58c22b011d0f4c2ea6d13615edbb9eeb",22901966,1,2,0,153,75,77,2
"58c22b011d0f4c2ea6d13615edbb9eeb","58c22b011d0f4c2ea6d13615edbb9eeb",22901966,2,0,1,154,77,77,0
"58c22b011d0f4c2ea6d13615edbb9eeb","dd76e1861dc9461c830888729d091ee0",22901966,1,1,0,156,77,78,1
"dd76e1861dc9461c830888729d091ee0","dd76e1861dc9461c830888729d091ee0",22901966,5,0,1,157,78,78,0
"dd76e1861dc9461c830888729d091ee0","cd1d828f1a694b87913a7ea66c23803e",22901966,1,1,0,162,78,79,1
"cd1d828f1a694b87913a7ea66c23803e","cd1d828f1a694b87913a7ea66c23803e",22901966,2,0,1,163,79,79,0
"cd1d828f1a694b87913a7ea66c23803e","9176a3c2b4d2465fa8b0c67096c2a97e",22901966,1,1,0,165,79,80,1
"9176a3c2b4d2465fa8b0c67096c2a97e","9176a3c2b4d2465fa8b0c67096c2a97e",22901966,11,0,1,166,80,80,0
"9176a3c2b4d2465fa8b0c67096c2a97e","f8ec6445f7194e25b9101d4fbcb07a18",22901966,1,1,0,177,80,81,1
"f8ec6445f7194e25b9101d4fbcb07a18","f8ec6445f7194e25b9101d4fbcb07a18",22901966,2,0,1,178,81,81,0
"f8ec6445f7194e25b9101d4fbcb07a18","140d5b27b8574befad82c0a013b59dfa",22901966,1,-7,0,180,81,74,-7
"140d5b27b8574befad82c0a013b59dfa","d18a9ea32855445f8736581f5cb119ce",22901966,1,9,0,181,74,82,8
"d18a9ea32855445f8736581f5cb119ce","f564483cbd7a407681aa2fcca518cf5f",22901966,1,4,0,182,82,85,3
"f564483cbd7a407681aa2fcca518cf5f","f564483cbd7a407681aa2fcca518cf5f",22901966,1,0,1,183,85,85,0
"f564483cbd7a407681aa2fcca518cf5f","18fd01350bd5434ca636d59a599d768a",22901966,1,1,0,184,85,86,1
"18fd01350bd5434ca636d59a599d768a","18fd01350bd5434ca636d59a599d768a",22901966,8,0,1,185,86,86,0
"18fd01350bd5434ca636d59a599d768a","6a9f0ef185fb47f0937e29daa1c71ed5",22901966,1,5,0,193,86,90,4
"6a9f0ef185fb47f0937e29daa1c71ed5","ae5ac430ea254e708a6f5deaaf7464ae",22901966,1,-7,0,194,90,84,-6
"ae5ac430ea254e708a6f5deaaf7464ae","c681290961c94c4caf23b529d1ae6b9a",22901966,1,5,0,195,84,88,4
"c681290961c94c4caf23b529d1ae6b9a","c681290961c94c4caf23b529d1ae6b9a",22901966,1,0,1,196,88,88,0
"c681290961c94c4caf23b529d1ae6b9a","6a9f0ef185fb47f0937e29daa1c71ed5",22901966,1,2,0,197,88,90,2
"6a9f0ef185fb47f0937e29daa1c71ed5","6a9f0ef185fb47f0937e29daa1c71ed5",22901966,5,0,1,198,90,90,0
"6a9f0ef185fb47f0937e29daa1c71ed5","d646286c8051419bbc2e31dd1db55ca8",22901966,1,-27,0,201,90,67,-23
"d646286c8051419bbc2e31dd1db55ca8","e20db35ced8544ddac5bc3839145e463",22901966,2,30,0,202,67,91,24
"e20db35ced8544ddac5bc3839145e463","1febb706d7a34005ae8711ed49c76e64",22901966,1,3,0,203,91,94,3
"1febb706d7a34005ae8711ed49c76e64","1febb706d7a34005ae8711ed49c76e64",22901966,2,0,1,204,94,94,0
"1febb706d7a34005ae8711ed49c76e64","8f73ba6f5a0042f2850356ac38ac6f24",22901966,1,1,0,206,94,95,1
"8f73ba6f5a0042f2850356ac38ac6f24","8f73ba6f5a0042f2850356ac38ac6f24",22901966,5,0,1,207,95,95,0
"8f73ba6f5a0042f2850356ac38ac6f24","e2260b86653c46d7b14a41fb419dbf8c",22901966,1,1,0,212,95,96,1
"e2260b86653c46d7b14a41fb419dbf8c","e2260b86653c46d7b14a41fb419dbf8c",22901966,2,0,1,213,96,96,0
"e2260b86653c46d7b14a41fb419dbf8c","35eb641ad1d845bbba54915bce75a962",22901966,1,1,0,215,96,97,1
"35eb641ad1d845bbba54915bce75a962","35eb641ad1d845bbba54915bce75a962",22901966,2,0,1,216,97,97,0
"35eb641ad1d845bbba54915bce75a962","08be90ffbeea4795a138cd42ed8db56f",22901966,1,1,0,218,97,98,1
"08be90ffbeea4795a138cd42ed8db56f","08be90ffbeea4795a138cd42ed8db56f",22901966,5,0,1,219,98,98,0
"08be90ffbeea4795a138cd42ed8db56f","3007433c8f584dcbb5ac159c1c5f2be3",22901966,1,1,0,224,98,99,1
"3007433c8f584dcbb5ac159c1c5f2be3","3007433c8f584dcbb5ac159c1c5f2be3",22901966,5,0,1,225,99,99,0
"3007433c8f584dcbb5ac159c1c5f2be3","e20db35ced8544ddac5bc3839145e463",22901966,1,-8,0,230,99,91,-8
"e20db35ced8544ddac5bc3839145e463","00ae5f0c51874a73a41ebea838d95682",22901966,3,11,0,231,91,101,10
"00ae5f0c51874a73a41ebea838d95682","d391c8b6e56a43a7b654e9dee02d904b",22901966,3,2,0,232,101,103,2
"d391c8b6e56a43a7b654e9dee02d904b","00ae5f0c51874a73a41ebea838d95682",22901966,1,-2,0,233,103,101,-2
"d391c8b6e56a43a7b654e9dee02d904b","d391c8b6e56a43a7b654e9dee02d904b",22901966,15,0,1,235,103,103,0
"d391c8b6e56a43a7b654e9dee02d904b","6111116566fc4fd9abba409322bea245",22901966,1,1,0,250,103,104,1
"6111116566fc4fd9abba409322bea245","6111116566fc4fd9abba409322bea245",22901966,5,0,1,251,104,104,0
"6111116566fc4fd9abba409322bea245","a81b2235cb9c499eb9ea8ee0a8dd9725",22901966,1,1,0,256,104,105,1
"a81b2235cb9c499eb9ea8ee0a8dd9725","a81b2235cb9c499eb9ea8ee0a8dd9725",22901966,2,0,1,257,105,105,0
"a81b2235cb9c499eb9ea8ee0a8dd9725","2d4e0ab0ef3b4d73b82c72d4621a7579",22901966,1,1,0,259,105,106,1
"2d4e0ab0ef3b4d73b82c72d4621a7579","2d4e0ab0ef3b4d73b82c72d4621a7579",22901966,2,0,1,260,106,106,0
"2d4e0ab0ef3b4d73b82c72d4621a7579","8bdebf492ebd4e62b0d522e8ab5e5197",22901966,1,1,0,262,106,107,1
"8bdebf492ebd4e62b0d522e8ab5e5197","8bdebf492ebd4e62b0d522e8ab5e5197",22901966,2,0,1,263,107,107,0
"8bdebf492ebd4e62b0d522e8ab5e5197","73039f8c1eb9409cb4caee2cf968001e",22901966,1,-7,0,265,107,100,-7
"73039f8c1eb9409cb4caee2cf968001e","4280927ec4d643238aa49c32f9e06c6c",22901966,2,10,0,266,100,109,9
"4280927ec4d643238aa49c32f9e06c6c","4280927ec4d643238aa49c32f9e06c6c",22901966,1,0,1,267,109,109,0
"4280927ec4d643238aa49c32f9e06c6c","fc44e6a5f7654430af1227838224dceb",22901966,1,2,0,268,109,111,2
"fc44e6a5f7654430af1227838224dceb","fc44e6a5f7654430af1227838224dceb",22901966,2,0,1,269,111,111,0
"fc44e6a5f7654430af1227838224dceb","08111f75e22d409998cf8b85bd431f0a",22901966,1,-3,0,271,111,108,-3
"08111f75e22d409998cf8b85bd431f0a","a9ae0a3c070d455bb4369a8996313336",22901966,3,7,0,272,108,114,6
"a9ae0a3c070d455bb4369a8996313336","a9ae0a3c070d455bb4369a8996313336",22901966,1,0,1,273,114,114,0
"a9ae0a3c070d455bb4369a8996313336","e20db35ced8544ddac5bc3839145e463",22901966,2,-26,0,274,114,91,-23
"e20db35ced8544ddac5bc3839145e463","e20db35ced8544ddac5bc3839145e463",22901966,1,0,1,275,91,91,0
"d391c8b6e56a43a7b654e9dee02d904b","73039f8c1eb9409cb4caee2cf968001e",22901966,1,-3,0,278,103,100,-3
"4280927ec4d643238aa49c32f9e06c6c","08111f75e22d409998cf8b85bd431f0a",22901966,1,-1,0,280,109,108,-1
"a9ae0a3c070d455bb4369a8996313336","71cec822bcff4f30a20e75dc63ef7b65",22901966,1,2,0,282,114,116,2
"71cec822bcff4f30a20e75dc63ef7b65","71cec822bcff4f30a20e75dc63ef7b65",22901966,1,0,1,283,116,116,0
"71cec822bcff4f30a20e75dc63ef7b65","62bff51286ef4f348717a3cf6fe2318f",22901966,1,5,0,284,116,120,4
"62bff51286ef4f348717a3cf6fe2318f","37319e88176d4aefa91d7a9980dbae91",22901966,2,-9,0,285,120,112,-8
"37319e88176d4aefa91d7a9980dbae91","3ec3a3563847406fa73338f9e9999cf3",22901966,1,6,0,286,112,117,5
"3ec3a3563847406fa73338f9e9999cf3","a9ae0a3c070d455bb4369a8996313336",22901966,1,-4,0,287,117,114,-3
"a9ae0a3c070d455bb4369a8996313336","4280927ec4d643238aa49c32f9e06c6c",22901966,1,-6,0,288,114,109,-5
"4280927ec4d643238aa49c32f9e06c6c","37319e88176d4aefa91d7a9980dbae91",22901966,1,4,0,289,109,112,3
"37319e88176d4aefa91d7a9980dbae91","e20db35ced8544ddac5bc3839145e463",22901966,1,-24,0,290,112,91,-21
"e20db35ced8544ddac5bc3839145e463","d646286c8051419bbc2e31dd1db55ca8",22901966,4,-30,0,291,91,67,-24
"d646286c8051419bbc2e31dd1db55ca8","08111f75e22d409998cf8b85bd431f0a",22901966,1,49,0,292,67,108,41
"08111f75e22d409998cf8b85bd431f0a","d391c8b6e56a43a7b654e9dee02d904b",22901966,1,-6,0,293,108,103,-5
"d391c8b6e56a43a7b654e9dee02d904b","d646286c8051419bbc2e31dd1db55ca8",22901966,1,-43,0,294,103,67,-36
"d646286c8051419bbc2e31dd1db55ca8","73039f8c1eb9409cb4caee2cf968001e",22901966,1,40,0,295,67,100,33
"73039f8c1eb9409cb4caee2cf968001e","e20db35ced8544ddac5bc3839145e463",22901966,1,-10,0,296,100,91,-9
"00ae5f0c51874a73a41ebea838d95682","e20db35ced8544ddac5bc3839145e463",22901966,2,-11,0,298,101,91,-10
"d646286c8051419bbc2e31dd1db55ca8","6a9f0ef185fb47f0937e29daa1c71ed5",22901966,1,27,0,302,67,90,23
"6a9f0ef185fb47f0937e29daa1c71ed5","e20db35ced8544ddac5bc3839145e463",22901966,1,3,0,305,90,91,1
"d646286c8051419bbc2e31dd1db55ca8","00ae5f0c51874a73a41ebea838d95682",22901966,1,41,0,307,67,101,34
"e20db35ced8544ddac5bc3839145e463","d391c8b6e56a43a7b654e9dee02d904b",22901966,1,13,0,309,91,103,12
"d391c8b6e56a43a7b654e9dee02d904b","62bff51286ef4f348717a3cf6fe2318f",22901966,1,20,0,310,103,120,17
"37319e88176d4aefa91d7a9980dbae91","4280927ec4d643238aa49c32f9e06c6c",22901966,1,-4,0,312,112,109,-3
"4280927ec4d643238aa49c32f9e06c6c","73039f8c1eb9409cb4caee2cf968001e",22901966,1,-10,0,313,109,100,-9
"73039f8c1eb9409cb4caee2cf968001e","08111f75e22d409998cf8b85bd431f0a",22901966,1,9,0,314,100,108,8
"e20db35ced8544ddac5bc3839145e463","779f9ddd1fd14d1e9e69f72219a1fdbd",22901966,2,36,0,317,91,121,30
"779f9ddd1fd14d1e9e69f72219a1fdbd","e20db35ced8544ddac5bc3839145e463",22901966,2,-36,0,318,121,91,-30
"779f9ddd1fd14d1e9e69f72219a1fdbd","62bff51286ef4f348717a3cf6fe2318f",22901966,1,-3,0,320,121,120,-1
"62bff51286ef4f348717a3cf6fe2318f","b1cd0e7dc3ad4a8eb91a4bfdbeb025b0",22901966,1,-2,0,321,120,118,-2
"b1cd0e7dc3ad4a8eb91a4bfdbeb025b0","b1cd0e7dc3ad4a8eb91a4bfdbeb025b0",22901966,1,0,1,322,118,118,0
"b1cd0e7dc3ad4a8eb91a4bfdbeb025b0","779f9ddd1fd14d1e9e69f72219a1fdbd",22901966,1,5,0,323,118,121,3
"e20db35ced8544ddac5bc3839145e463","ae26e6cda8ad4a3f81bd347560d9579f",22901966,1,40,0,325,91,125,34
"ae26e6cda8ad4a3f81bd347560d9579f","ae26e6cda8ad4a3f81bd347560d9579f",22901966,1,0,1,326,125,125,0
"ae26e6cda8ad4a3f81bd347560d9579f","ee48df95832b4374aa273ceb27ec1315",22901966,1,1,0,327,125,126,1
"ee48df95832b4374aa273ceb27ec1315","ee48df95832b4374aa273ceb27ec1315",22901966,1,0,1,328,126,126,0
"ee48df95832b4374aa273ceb27ec1315","7a439da90b394756ad1777fc4c6dead5",22901966,1,1,0,329,126,127,1
"7a439da90b394756ad1777fc4c6dead5","7a439da90b394756ad1777fc4c6dead5",22901966,1,0,1,330,127,127,0
"7a439da90b394756ad1777fc4c6dead5","779f9ddd1fd14d1e9e69f72219a1fdbd",22901966,1,-6,0,331,127,121,-6
"779f9ddd1fd14d1e9e69f72219a1fdbd","a8dd5213034441ac92724b4e83eb0bb2",22901966,1,9,0,332,121,129,8
"a8dd5213034441ac92724b4e83eb0bb2","a8dd5213034441ac92724b4e83eb0bb2",22901966,1,0,1,333,129,129,0
"a8dd5213034441ac92724b4e83eb0bb2","8115eab6556b45f5b415c3b8c26a12e5",22901966,1,2,0,334,129,131,2
"8115eab6556b45f5b415c3b8c26a12e5","8115eab6556b45f5b415c3b8c26a12e5",22901966,2,0,1,335,131,131,0
"8115eab6556b45f5b415c3b8c26a12e5","ec34b06efd844b46a4c4818ecdb9b8f4",22901966,1,1,0,337,131,132,1
"ec34b06efd844b46a4c4818ecdb9b8f4","ec34b06efd844b46a4c4818ecdb9b8f4",22901966,2,0,1,338,132,132,0
"ec34b06efd844b46a4c4818ecdb9b8f4","c2e1c2b9eac64109b343a088584b576b",22901966,1,1,0,340,132,133,1
"c2e1c2b9eac64109b343a088584b576b","c2e1c2b9eac64109b343a088584b576b",22901966,2,0,1,341,133,133,0
"c2e1c2b9eac64109b343a088584b576b","579338175e0b4bbb8ef3b712b5d8b54e",22901966,1,-5,0,343,133,128,-5
"579338175e0b4bbb8ef3b712b5d8b54e","8bc5795d6a984a3eace4e2811e52dd4f",22901966,1,8,0,344,128,135,7
"8bc5795d6a984a3eace4e2811e52dd4f","8bc5795d6a984a3eace4e2811e52dd4f",22901966,1,0,1,345,135,135,0
"8bc5795d6a984a3eace4e2811e52dd4f","b416d47c56a742199b5d7c7f19d6503a",22901966,1,-1,0,346,135,134,-1
"b416d47c56a742199b5d7c7f19d6503a","cd4532ad48034873ba8bce2aac0c9808",22901966,1,4,0,347,134,137,3
"cd4532ad48034873ba8bce2aac0c9808","cd4532ad48034873ba8bce2aac0c9808",22901966,1,0,1,348,137,137,0
"cd4532ad48034873ba8bce2aac0c9808","779f9ddd1fd14d1e9e69f72219a1fdbd",22901966,1,-19,0,349,137,121,-16
"779f9ddd1fd14d1e9e69f72219a1fdbd","df1de691dafe4549a18a4398ee9dfaf9",22901966,1,23,0,350,121,139,18
"df1de691dafe4549a18a4398ee9dfaf9","6c5ad271a44743479bfaea29b1db8d02",22901966,1,4,0,351,139,143,4
"6c5ad271a44743479bfaea29b1db8d02","6c5ad271a44743479bfaea29b1db8d02",22901966,1,0,1,352,143,143,0
"6c5ad271a44743479bfaea29b1db8d02","83d311bed5374fee83d8d67a7d9d82dc",22901966,1,1,0,353,143,144,1
"83d311bed5374fee83d8d67a7d9d82dc","83d311bed5374fee83d8d67a7d9d82dc",22901966,1,0,1,354,144,144,0
"83d311bed5374fee83d8d67a7d9d82dc","402bba41861d43acb52a5abb89e8831e",22901966,1,1,0,355,144,145,1
"402bba41861d43acb52a5abb89e8831e","402bba41861d43acb52a5abb89e8831e",22901966,2,0,1,356,145,145,0
"402bba41861d43acb52a5abb89e8831e","df1de691dafe4549a18a4398ee9dfaf9",22901966,1,-6,0,358,145,139,-6
"df1de691dafe4549a18a4398ee9dfaf9","8aae34f5ddbb4052a709b12e6b0d40fa",22901966,1,9,0,359,139,147,8
"8aae34f5ddbb4052a709b12e6b0d40fa","8aae34f5ddbb4052a709b12e6b0d40fa",22901966,1,0,1,360,147,147,0
"8aae34f5ddbb4052a709b12e6b0d40fa","645b3f0249f64f76af2e19eb4d0e55b7",22901966,1,2,0,361,147,149,2
"645b3f0249f64f76af2e19eb4d0e55b7","645b3f0249f64f76af2e19eb4d0e55b7",22901966,2,0,1,362,149,149,0
"645b3f0249f64f76af2e19eb4d0e55b7","7e7b8db5064d4369805ab370aac5ddfb",22901966,1,1,0,364,149,150,1
"7e7b8db5064d4369805ab370aac5ddfb","7e7b8db5064d4369805ab370aac5ddfb",22901966,2,0,1,365,150,150,0
"7e7b8db5064d4369805ab370aac5ddfb","8956d210ae7f41968fada86d4c979d6a",22901966,1,1,0,367,150,151,1
"8956d210ae7f41968fada86d4c979d6a","8956d210ae7f41968fada86d4c979d6a",22901966,2,0,1,368,151,151,0
"8956d210ae7f41968fada86d4c979d6a","f902b0f41b544d4dbf79664fd233648d",22901966,1,-5,0,370,151,146,-5
"f902b0f41b544d4dbf79664fd233648d","ae781e8b775e4ccd93bc800dad5c8376",22901966,1,8,0,371,146,153,7
"ae781e8b775e4ccd93bc800dad5c8376","ae781e8b775e4ccd93bc800dad5c8376",22901966,2,0,1,372,153,153,0
"ae781e8b775e4ccd93bc800dad5c8376","06882a8492d9499aa31555567f575ecb",22901966,1,1,0,374,153,154,1
"06882a8492d9499aa31555567f575ecb","06882a8492d9499aa31555567f575ecb",22901966,1,0,1,375,154,154,0
"06882a8492d9499aa31555567f575ecb","f293c508f409466a8f27ddd7d1e40b20",22901966,1,1,0,376,154,155,1
"f293c508f409466a8f27ddd7d1e40b20","f293c508f409466a8f27ddd7d1e40b20",22901966,2,0,1,377,155,155,0
"f293c508f409466a8f27ddd7d1e40b20","cc4ddef5bbbe48ebb605141b347c4ed1",22901966,1,1,0,379,155,156,1
"cc4ddef5bbbe48ebb605141b347c4ed1","cc4ddef5bbbe48ebb605141b347c4ed1",22901966,1,0,1,380,156,156,0
"cc4ddef5bbbe48ebb605141b347c4ed1","d313cec988a84645bee413e8d4724a4b",22901966,1,3,0,381,156,158,2
"d313cec988a84645bee413e8d4724a4b","f03480cf4eba413194d7af52fc0e7f28",22901966,1,-7,0,382,158,152,-6
"f03480cf4eba413194d7af52fc0e7f28","d313cec988a84645bee413e8d4724a4b",22901966,1,7,0,383,152,158,6
"d313cec988a84645bee413e8d4724a4b","d313cec988a84645bee413e8d4724a4b",22901966,3,0,1,384,158,158,0
"d313cec988a84645bee413e8d4724a4b","dc60696c76a74368a60f72246e47700d",22901966,1,1,0,387,158,159,1
"dc60696c76a74368a60f72246e47700d","dc60696c76a74368a60f72246e47700d",22901966,1,0,1,388,159,159,0
"dc60696c76a74368a60f72246e47700d","df1de691dafe4549a18a4398ee9dfaf9",22901966,1,-23,0,389,159,139,-20
"df1de691dafe4549a18a4398ee9dfaf9","78adeee1fa2c4fe0bc73f7bca9fcee86",22901966,1,26,0,390,139,160,21
"78adeee1fa2c4fe0bc73f7bca9fcee86","78adeee1fa2c4fe0bc73f7bca9fcee86",22901966,1,0,1,391,160,160,0
"78adeee1fa2c4fe0bc73f7bca9fcee86","65202579580f4ad38d734b4ee39d22a8",22901966,1,5,0,392,160,164,4
"65202579580f4ad38d734b4ee39d22a8","65202579580f4ad38d734b4ee39d22a8",22901966,66,0,1,393,164,164,0
"65202579580f4ad38d734b4ee39d22a8","78adeee1fa2c4fe0bc73f7bca9fcee86",22901966,2,-5,0,445,164,160,-4
"78adeee1fa2c4fe0bc73f7bca9fcee86","3cbcea2be0984e7dbd5a48195af10ce7",22901966,1,8,0,446,160,165,5
"3cbcea2be0984e7dbd5a48195af10ce7","82e6285962b8400d9d6fc32436022a94",22901966,1,2,0,447,165,167,2
"82e6285962b8400d9d6fc32436022a94","3cbcea2be0984e7dbd5a48195af10ce7",22901966,1,-2,0,448,167,165,-2
"3cbcea2be0984e7dbd5a48195af10ce7","a9ac840f098c4bd0a2ee896214ce29cd",22901966,1,5,0,449,165,168,3
"a9ac840f098c4bd0a2ee896214ce29cd","a9ac840f098c4bd0a2ee896214ce29cd",22901966,2,0,1,450,168,168,0
"a9ac840f098c4bd0a2ee896214ce29cd","0c7262dff33c4087bc660ccf40f92f9c",22901966,1,4,0,451,168,169,1
"0c7262dff33c4087bc660ccf40f92f9c","b2275c3fad834f8d90737a2d9a6927d6",22901966,2,3,0,452,169,172,3
"b2275c3fad834f8d90737a2d9a6927d6","a9ac840f098c4bd0a2ee896214ce29cd",22901966,1,-7,0,453,172,168,-4
"a9ac840f098c4bd0a2ee896214ce29cd","78adeee1fa2c4fe0bc73f7bca9fcee86",22901966,1,-13,0,455,168,160,-8
"78adeee1fa2c4fe0bc73f7bca9fcee86","8959e6304a0348309a771e4d08d1b64a",22901966,2,4,0,456,160,163,3
"8959e6304a0348309a771e4d08d1b64a","65202579580f4ad38d734b4ee39d22a8",22901966,2,1,0,457,163,164,1
"65202579580f4ad38d734b4ee39d22a8","0c7262dff33c4087bc660ccf40f92f9c",22901966,1,12,0,475,164,169,5
"0c7262dff33c4087bc660ccf40f92f9c","0c7262dff33c4087bc660ccf40f92f9c",22901966,1,0,1,476,169,169,0
"b2275c3fad834f8d90737a2d9a6927d6","b2275c3fad834f8d90737a2d9a6927d6",22901966,28,0,1,478,172,172,0
"b2275c3fad834f8d90737a2d9a6927d6","eb515a26030b41f8a82a1e6114420bad",22901966,1,1,0,506,172,173,1
"eb515a26030b41f8a82a1e6114420bad","eb515a26030b41f8a82a1e6114420bad",22901966,2,0,1,507,173,173,0
"eb515a26030b41f8a82a1e6114420bad","b42cc17b7de840f181a704558d0bc845",22901966,1,3,0,509,173,175,2
"b42cc17b7de840f181a704558d0bc845","0c7262dff33c4087bc660ccf40f92f9c",22901966,1,-7,0,510,175,169,-6
"0c7262dff33c4087bc660ccf40f92f9c","b42cc17b7de840f181a704558d0bc845",22901966,1,7,0,511,169,175,6
"b42cc17b7de840f181a704558d0bc845","801f9e9135034f49bf5f8b4bdefedb41",22901966,1,2,0,512,175,177,2
"801f9e9135034f49bf5f8b4bdefedb41","801f9e9135034f49bf5f8b4bdefedb41",22901966,4,0,1,513,177,177,0
"801f9e9135034f49bf5f8b4bdefedb41","ea38cc0e6e6e41edbabf210220808bf9",22901966,1,3,0,517,177,179,2
"ea38cc0e6e6e41edbabf210220808bf9","362fcb0699a14845ab29b2340093e528",22901966,1,-6,0,518,179,174,-5
"362fcb0699a14845ab29b2340093e528","b87c552dd247427abe6ab5795b9c9d43",22901966,1,8,0,519,174,181,7
"b87c552dd247427abe6ab5795b9c9d43","ea38cc0e6e6e41edbabf210220808bf9",22901966,1,-2,0,520,181,179,-2
"ea38cc0e6e6e41edbabf210220808bf9","b87c552dd247427abe6ab5795b9c9d43",22901966,1,2,0,521,179,181,2
"b87c552dd247427abe6ab5795b9c9d43","b87c552dd247427abe6ab5795b9c9d43",22901966,7,0,1,522,181,181,0
"b87c552dd247427abe6ab5795b9c9d43","139b097acfca451689d80c9c6eebdf7b",22901966,1,-3,0,529,181,178,-3
"139b097acfca451689d80c9c6eebdf7b","30f660a1feb34582a739722532524f79",22901966,1,6,0,530,178,183,5
"30f660a1feb34582a739722532524f79","30f660a1feb34582a739722532524f79",22901966,5,0,1,531,183,183,0
"30f660a1feb34582a739722532524f79","2024b4885bd14338a39b7b509acbbd02",22901966,1,-1,0,536,183,182,-1
"2024b4885bd14338a39b7b509acbbd02","c3f63fe50d8e487c86bf8ef76c9cadd3",22901966,1,4,0,537,182,185,3
"c3f63fe50d8e487c86bf8ef76c9cadd3","c3f63fe50d8e487c86bf8ef76c9cadd3",22901966,1,0,1,538,185,185,0
"c3f63fe50d8e487c86bf8ef76c9cadd3","0c7262dff33c4087bc660ccf40f92f9c",22901966,1,-20,0,539,185,169,-16
"0c7262dff33c4087bc660ccf40f92f9c","c8e371568a0c4391b25796ae4e91952e",22901966,1,23,0,540,169,186,17
"c8e371568a0c4391b25796ae4e91952e","7d932b23e1c84326ae5aa4d3c0d813d1",22901966,1,2,0,541,186,188,2
"7d932b23e1c84326ae5aa4d3c0d813d1","7d932b23e1c84326ae5aa4d3c0d813d1",22901966,1,0,1,542,188,188,0
"7d932b23e1c84326ae5aa4d3c0d813d1","ab11d94c6c8948ea90b88f19d2cd502b",22901966,1,3,0,543,188,190,2
"ab11d94c6c8948ea90b88f19d2cd502b","c8e371568a0c4391b25796ae4e91952e",22901966,1,-5,0,544,190,186,-4
"c8e371568a0c4391b25796ae4e91952e","ab11d94c6c8948ea90b88f19d2cd502b",22901966,1,5,0,545,186,190,4
"ab11d94c6c8948ea90b88f19d2cd502b","f992451ed6ad4e68bb9e68ad6be7c4be",22901966,1,2,0,546,190,192,2
"f992451ed6ad4e68bb9e68ad6be7c4be","f992451ed6ad4e68bb9e68ad6be7c4be",22901966,1,0,1,547,192,192,0
"f992451ed6ad4e68bb9e68ad6be7c4be","07b44a7a51e94c78b411c753fc39dab0",22901966,1,-3,0,548,192,189,-3
"07b44a7a51e94c78b411c753fc39dab0","6cd2dcaac46847d4a0bc53f296d90375",22901966,1,6,0,549,189,194,5
"6cd2dcaac46847d4a0bc53f296d90375","6cd2dcaac46847d4a0bc53f296d90375",22901966,1,0,1,550,194,194,0
"6cd2dcaac46847d4a0bc53f296d90375","2d2580c9411c4972909db508d6956a58",22901966,1,2,0,551,194,196,2
"2d2580c9411c4972909db508d6956a58","2d2580c9411c4972909db508d6956a58",22901966,2,0,1,552,196,196,0
"2d2580c9411c4972909db508d6956a58","5bddb3d9ed264f3984702f048c7e5340",22901966,1,1,0,554,196,197,1
"5bddb3d9ed264f3984702f048c7e5340","5bddb3d9ed264f3984702f048c7e5340",22901966,2,0,1,555,197,197,0
"5bddb3d9ed264f3984702f048c7e5340","d5e8e2bd12a2466b9d6d90855f0eb079",22901966,1,1,0,557,197,198,1
"d5e8e2bd12a2466b9d6d90855f0eb079","d5e8e2bd12a2466b9d6d90855f0eb079",22901966,2,0,1,558,198,198,0
"d5e8e2bd12a2466b9d6d90855f0eb079","017d7ca8e0394b91aaadc9574df2202c",22901966,1,-5,0,560,198,193,-5
"017d7ca8e0394b91aaadc9574df2202c","54e8e9f0ea3e45c4bf3b8ac799ee31b1",22901966,1,8,0,561,193,200,7
"54e8e9f0ea3e45c4bf3b8ac799ee31b1","54e8e9f0ea3e45c4bf3b8ac799ee31b1",22901966,1,0,1,562,200,200,0
"54e8e9f0ea3e45c4bf3b8ac799ee31b1","c614a00911be4877a075f19315530fb0",22901966,1,1,0,563,200,201,1
"c614a00911be4877a075f19315530fb0","c614a00911be4877a075f19315530fb0",22901966,6,0,1,564,201,201,0
"c614a00911be4877a075f19315530fb0","a6c21bd8b95249c7972820a7a7d76aff",22901966,1,1,0,570,201,202,1
"a6c21bd8b95249c7972820a7a7d76aff","a6c21bd8b95249c7972820a7a7d76aff",22901966,1,0,1,571,202,202,0
"a6c21bd8b95249c7972820a7a7d76aff","bb329d880ab54120adaf203a693bb203",22901966,1,1,0,572,202,203,1
"bb329d880ab54120adaf203a693bb203","bb329d880ab54120adaf203a693bb203",22901966,1,0,1,573,203,203,0
"bb329d880ab54120adaf203a693bb203","f9170dd6bc6442b4acd832747609b09a",22901966,1,-4,0,574,203,199,-4
"f9170dd6bc6442b4acd832747609b09a","334c2344009840079b1d0e1b7ce3d5a7",22901966,1,7,0,575,199,205,6
"334c2344009840079b1d0e1b7ce3d5a7","334c2344009840079b1d0e1b7ce3d5a7",22901966,1,0,1,576,205,205,0
"334c2344009840079b1d0e1b7ce3d5a7","c8e371568a0c4391b25796ae4e91952e",22901966,1,-23,0,577,205,186,-19
"c8e371568a0c4391b25796ae4e91952e","d7f13c8d63ec4e2aa673fbb9cf9c6933",22901966,1,26,0,578,186,206,20
"d7f13c8d63ec4e2aa673fbb9cf9c6933","7108f0e4c2584f1f9c471689ae4c885c",22901966,1,2,0,579,206,208,2
"7108f0e4c2584f1f9c471689ae4c885c","b9e80f77c3a44349863b19875725c384",22901966,1,-1,0,580,208,207,-1
"b9e80f77c3a44349863b19875725c384","b9e80f77c3a44349863b19875725c384",22901966,12,0,1,581,207,207,0
"b9e80f77c3a44349863b19875725c384","7108f0e4c2584f1f9c471689ae4c885c",22901966,1,1,0,593,207,208,1
"7108f0e4c2584f1f9c471689ae4c885c","7108f0e4c2584f1f9c471689ae4c885c",22901966,10,0,1,594,208,208,0
"7108f0e4c2584f1f9c471689ae4c885c","d7f13c8d63ec4e2aa673fbb9cf9c6933",22901966,1,-2,0,604,208,206,-2
"d7f13c8d63ec4e2aa673fbb9cf9c6933","09400e101c5d4b439cf9a26b03aae558",22901966,1,5,0,605,206,210,4
"09400e101c5d4b439cf9a26b03aae558","09400e101c5d4b439cf9a26b03aae558",22901966,1,0,1,606,210,210,0
"09400e101c5d4b439cf9a26b03aae558","a88efa7e50ce47159810ab553afa6d3a",22901966,1,2,0,607,210,212,2
"a88efa7e50ce47159810ab553afa6d3a","a88efa7e50ce47159810ab553afa6d3a",22901966,5,0,1,608,212,212,0
"a88efa7e50ce47159810ab553afa6d3a","be502a7a43c44bf7b682698de79d9369",22901966,1,3,0,613,212,214,2
"be502a7a43c44bf7b682698de79d9369","a875096404ef4a9984b62d74cda916f9",22901966,1,-6,0,614,214,209,-5
"a875096404ef4a9984b62d74cda916f9","f7fb1952f56b4189b86a9f8b7862d2b8",22901966,1,7,0,615,209,215,6
"f7fb1952f56b4189b86a9f8b7862d2b8","be502a7a43c44bf7b682698de79d9369",22901966,1,-1,0,616,215,214,-1
"be502a7a43c44bf7b682698de79d9369","be502a7a43c44bf7b682698de79d9369",22901966,1,0,1,617,214,214,0
"be502a7a43c44bf7b682698de79d9369","f7fb1952f56b4189b86a9f8b7862d2b8",22901966,1,1,0,618,214,215,1
"f7fb1952f56b4189b86a9f8b7862d2b8","f7fb1952f56b4189b86a9f8b7862d2b8",22901966,13,0,1,619,215,215,0
"f7fb1952f56b4189b86a9f8b7862d2b8","b860ee85d8bc4a2f97958cfb71be3533",22901966,1,1,0,632,215,216,1
"b860ee85d8bc4a2f97958cfb71be3533","b860ee85d8bc4a2f97958cfb71be3533",22901966,2,0,1,633,216,216,0
"b860ee85d8bc4a2f97958cfb71be3533","ec341f459285443b8361f7f15638ff08",22901966,1,-3,0,635,216,213,-3
"ec341f459285443b8361f7f15638ff08","363837c182e04711840d896ae1e0339c",22901966,1,6,0,636,213,218,5
"363837c182e04711840d896ae1e0339c","363837c182e04711840d896ae1e0339c",22901966,12,0,1,637,218,218,0
"363837c182e04711840d896ae1e0339c","01b2051f8941460d89945e3b02d1ce78",22901966,1,-1,0,649,218,217,-1
"01b2051f8941460d89945e3b02d1ce78","91125ca626c5470eb145501f8c37f8db",22901966,1,4,0,650,217,220,3
"91125ca626c5470eb145501f8c37f8db","91125ca626c5470eb145501f8c37f8db",22901966,1,0,1,651,220,220,0
"91125ca626c5470eb145501f8c37f8db","d7f13c8d63ec4e2aa673fbb9cf9c6933",22901966,1,-18,0,652,220,206,-14
"d7f13c8d63ec4e2aa673fbb9cf9c6933","1c6721b1f63f4d30ba7746ea8af02a52",22901966,1,21,0,653,206,221,15
"1c6721b1f63f4d30ba7746ea8af02a52","77ecef8eff6b4a2caea7707669bf7475",22901966,3,1,0,654,221,222,1
"77ecef8eff6b4a2caea7707669bf7475","0c7262dff33c4087bc660ccf40f92f9c",22901966,1,-71,0,655,222,169,-53
"0c7262dff33c4087bc660ccf40f92f9c","1c6721b1f63f4d30ba7746ea8af02a52",22901966,1,70,0,656,169,221,52
"1c6721b1f63f4d30ba7746ea8af02a52","1c6721b1f63f4d30ba7746ea8af02a52",22901966,1,0,1,657,221,221,0
"77ecef8eff6b4a2caea7707669bf7475","77ecef8eff6b4a2caea7707669bf7475",22901966,12,0,1,659,222,222,0
"77ecef8eff6b4a2caea7707669bf7475","8b9ae98743bd4d4a8a87dff1c1244211",22901966,1,6,0,671,222,227,5
"8b9ae98743bd4d4a8a87dff1c1244211","1c6721b1f63f4d30ba7746ea8af02a52",22901966,1,-7,0,672,227,221,-6
"1c6721b1f63f4d30ba7746ea8af02a52","d03cb855c70044cf8c35d9ec0de696e3",22901966,1,4,0,673,221,224,3
"d03cb855c70044cf8c35d9ec0de696e3","d03cb855c70044cf8c35d9ec0de696e3",22901966,1,0,1,674,224,224,0
"d03cb855c70044cf8c35d9ec0de696e3","a49a937d6896486d9a5396654abcf2e1",22901966,1,2,0,675,224,226,2
"a49a937d6896486d9a5396654abcf2e1","a49a937d6896486d9a5396654abcf2e1",22901966,3,0,1,676,226,226,0
"a49a937d6896486d9a5396654abcf2e1","8b9ae98743bd4d4a8a87dff1c1244211",22901966,1,1,0,679,226,227,1
"8b9ae98743bd4d4a8a87dff1c1244211","8b9ae98743bd4d4a8a87dff1c1244211",22901966,17,0,1,680,227,227,0
"8b9ae98743bd4d4a8a87dff1c1244211","f7906d6f59b9489a91d2ef40db5a474d",22901966,1,-4,0,697,227,223,-4
"f7906d6f59b9489a91d2ef40db5a474d","2ab1535aac1346ba8801535bf729ef37",22901966,1,7,0,698,223,229,6
"2ab1535aac1346ba8801535bf729ef37","2ab1535aac1346ba8801535bf729ef37",22901966,6,0,1,699,229,229,0
"2ab1535aac1346ba8801535bf729ef37","1c6721b1f63f4d30ba7746ea8af02a52",22901966,1,-10,0,701,229,221,-8
"77ecef8eff6b4a2caea7707669bf7475","1c6721b1f63f4d30ba7746ea8af02a52",22901966,1,-1,0,703,222,221,-1
"1c6721b1f63f4d30ba7746ea8af02a52","2ab1535aac1346ba8801535bf729ef37",22901966,1,10,0,704,221,229,8
"2ab1535aac1346ba8801535bf729ef37","a4f40fb48a8542c8949bae1f002cd9bc",22901966,1,2,0,709,229,231,2
"a4f40fb48a8542c8949bae1f002cd9bc","a4f40fb48a8542c8949bae1f002cd9bc",22901966,5,0,1,710,231,231,0
"a4f40fb48a8542c8949bae1f002cd9bc","8972c23e32044edb8a78fa1eed4e5947",22901966,1,1,0,715,231,232,1
"8972c23e32044edb8a78fa1eed4e5947","8972c23e32044edb8a78fa1eed4e5947",22901966,1,0,1,716,232,232,0
"8972c23e32044edb8a78fa1eed4e5947","92feb4a40f8344d38b6f722e42a53295",22901966,1,1,0,717,232,233,1
"92feb4a40f8344d38b6f722e42a53295","92feb4a40f8344d38b6f722e42a53295",22901966,2,0,1,718,233,233,0
"92feb4a40f8344d38b6f722e42a53295","5152833676bf4c6cb317060be10f68db",22901966,1,-5,0,720,233,228,-5
"5152833676bf4c6cb317060be10f68db","ca3e28f290354c08aefe5b0f769604e6",22901966,1,8,0,721,228,235,7
"ca3e28f290354c08aefe5b0f769604e6","ca3e28f290354c08aefe5b0f769604e6",22901966,4,0,1,722,235,235,0
"ca3e28f290354c08aefe5b0f769604e6","79a35eea833e4c2c9d22fc53c3c6445c",22901966,1,1,0,726,235,236,1
"79a35eea833e4c2c9d22fc53c3c6445c","79a35eea833e4c2c9d22fc53c3c6445c",22901966,9,0,1,727,236,236,0
"79a35eea833e4c2c9d22fc53c3c6445c","8f68228b1518449e9615cdafee41a2bd",22901966,1,1,0,736,236,237,1
"8f68228b1518449e9615cdafee41a2bd","8f68228b1518449e9615cdafee41a2bd",22901966,1,0,1,737,237,237,0
"8f68228b1518449e9615cdafee41a2bd","cab89fa5c3ed45a5aa550fc0352d6a42",22901966,1,1,0,738,237,238,1
"cab89fa5c3ed45a5aa550fc0352d6a42","cab89fa5c3ed45a5aa550fc0352d6a42",22901966,6,0,1,739,238,238,0
"cab89fa5c3ed45a5aa550fc0352d6a42","66d4fad4f1cf4b46be0750a99ad7a35a",22901966,1,1,0,745,238,239,1
"66d4fad4f1cf4b46be0750a99ad7a35a","66d4fad4f1cf4b46be0750a99ad7a35a",22901966,1,0,1,746,239,239,0
"66d4fad4f1cf4b46be0750a99ad7a35a","0b04c8e2f86d48c7aeb7e225819cd32b",22901966,1,-5,0,747,239,234,-5
"0b04c8e2f86d48c7aeb7e225819cd32b","f53da5fd9bfe412da4b80d4742563b6c",22901966,1,8,0,748,234,241,7
"f53da5fd9bfe412da4b80d4742563b6c","f53da5fd9bfe412da4b80d4742563b6c",22901966,1,0,1,749,241,241,0
"f53da5fd9bfe412da4b80d4742563b6c","2ae94c0cea4d480a9d5dca8fb1d7b542",22901966,1,3,0,750,241,242,1
"2ae94c0cea4d480a9d5dca8fb1d7b542","1c6721b1f63f4d30ba7746ea8af02a52",22901966,1,-27,0,751,242,221,-21
"1c6721b1f63f4d30ba7746ea8af02a52","1ebf23f9d994469a85206e4c7b1bf5f5",22901966,1,30,0,752,221,245,24
"1ebf23f9d994469a85206e4c7b1bf5f5","1ebf23f9d994469a85206e4c7b1bf5f5",22901966,10,0,1,753,245,245,0
"1ebf23f9d994469a85206e4c7b1bf5f5","85ae675b83e8422da842cfd25596af99",22901966,1,1,0,763,245,246,1
"85ae675b83e8422da842cfd25596af99","85ae675b83e8422da842cfd25596af99",22901966,1,0,1,764,246,246,0
"85ae675b83e8422da842cfd25596af99","fa235f0f364d47e4ae1c87f47bf8e6ba",22901966,1,8,0,765,246,252,6
"fa235f0f364d47e4ae1c87f47bf8e6ba","2ae94c0cea4d480a9d5dca8fb1d7b542",22901966,1,-12,0,766,252,242,-10
"2ae94c0cea4d480a9d5dca8fb1d7b542","fa235f0f364d47e4ae1c87f47bf8e6ba",22901966,1,12,0,767,242,252,10
"fa235f0f364d47e4ae1c87f47bf8e6ba","79f7845465cc4ed19d8e4f1429541be0",22901966,1,2,0,768,252,254,2
"79f7845465cc4ed19d8e4f1429541be0","79f7845465cc4ed19d8e4f1429541be0",22901966,2,0,1,769,254,254,0
"79f7845465cc4ed19d8e4f1429541be0","00f61990949545828dd12f1303d47504",22901966,1,3,0,771,254,256,2
"00f61990949545828dd12f1303d47504","6e83e23f56544a19b94067c1c558d9c0",22901966,1,-11,0,772,256,247,-9
"6e83e23f56544a19b94067c1c558d9c0","00f61990949545828dd12f1303d47504",22901966,1,11,0,773,247,256,9
"00f61990949545828dd12f1303d47504","ead7bb4b64e247d2ae632ab8a296b091",22901966,1,2,0,774,256,258,2
"ead7bb4b64e247d2ae632ab8a296b091","ead7bb4b64e247d2ae632ab8a296b091",22901966,2,0,1,775,258,258,0
"ead7bb4b64e247d2ae632ab8a296b091","41b0048dde734bb280bac6116baa8e27",22901966,1,1,0,777,258,259,1
"41b0048dde734bb280bac6116baa8e27","41b0048dde734bb280bac6116baa8e27",22901966,2,0,1,778,259,259,0
"41b0048dde734bb280bac6116baa8e27","b41c5a094a604ee0915327da5cc0beb7",22901966,1,1,0,780,259,260,1
"b41c5a094a604ee0915327da5cc0beb7","b41c5a094a604ee0915327da5cc0beb7",22901966,5,0,1,781,260,260,0
"b41c5a094a604ee0915327da5cc0beb7","d546341988904f069cfa86b21457d9d9",22901966,1,-10,0,786,260,251,-9
"d546341988904f069cfa86b21457d9d9","28c171777c52431ab6b925073bd63d46",22901966,1,15,0,787,251,264,13
"28c171777c52431ab6b925073bd63d46","28c171777c52431ab6b925073bd63d46",22901966,7,0,1,788,264,264,0
"28c171777c52431ab6b925073bd63d46","ac160db940cb49ae8579162b1d52bb5d",22901966,1,2,0,795,264,266,2
"ac160db940cb49ae8579162b1d52bb5d","ac160db940cb49ae8579162b1d52bb5d",22901966,3,0,1,796,266,266,0
"ac160db940cb49ae8579162b1d52bb5d","d989ebcfc12a4b669f0100dc1aa14f1e",22901966,1,-12,0,799,266,255,-11
"d989ebcfc12a4b669f0100dc1aa14f1e","c6fd49b485cc4874b0bbdd9c6171e09c",22901966,1,15,0,800,255,268,13
"c6fd49b485cc4874b0bbdd9c6171e09c","c6fd49b485cc4874b0bbdd9c6171e09c",22901966,3,0,1,801,268,268,0
"c6fd49b485cc4874b0bbdd9c6171e09c","44240778a97c4af0937817499b75707b",22901966,1,1,0,804,268,269,1
"44240778a97c4af0937817499b75707b","44240778a97c4af0937817499b75707b",22901966,2,0,1,805,269,269,0
"44240778a97c4af0937817499b75707b","7aa76d3e993840d8805f097cbdbcd44b",22901966,1,-9,0,807,269,261,-8
"7aa76d3e993840d8805f097cbdbcd44b","865a4d3b43374da7944dc7d397f566d9",22901966,1,12,0,808,261,271,10
"865a4d3b43374da7944dc7d397f566d9","865a4d3b43374da7944dc7d397f566d9",22901966,1,0,1,809,271,271,0
"865a4d3b43374da7944dc7d397f566d9","0d987bed3ffa4ed0b9a2e62e97b7b30f",22901966,1,3,0,810,271,272,1
"0d987bed3ffa4ed0b9a2e62e97b7b30f","2ae94c0cea4d480a9d5dca8fb1d7b542",22901966,1,-38,0,811,272,242,-30
"2ae94c0cea4d480a9d5dca8fb1d7b542","0d987bed3ffa4ed0b9a2e62e97b7b30f",22901966,1,38,0,812,242,272,30
"0d987bed3ffa4ed0b9a2e62e97b7b30f","82ae07bc0c9b4570a41799290d1ef399",22901966,1,4,0,813,272,275,3
"82ae07bc0c9b4570a41799290d1ef399","bb5a47f5ea01454a8b79455422d3b9da",22901966,3,6,0,814,275,280,5
"bb5a47f5ea01454a8b79455422d3b9da","bb5a47f5ea01454a8b79455422d3b9da",22901966,83,0,1,815,280,280,0
"bb5a47f5ea01454a8b79455422d3b9da","0d987bed3ffa4ed0b9a2e62e97b7b30f",22901966,3,-10,0,822,280,272,-8
"0d987bed3ffa4ed0b9a2e62e97b7b30f","bb5a47f5ea01454a8b79455422d3b9da",22901966,3,10,0,823,272,280,8
"bb5a47f5ea01454a8b79455422d3b9da","82ae07bc0c9b4570a41799290d1ef399",22901966,2,-6,0,828,280,275,-5
"bb5a47f5ea01454a8b79455422d3b9da","bc5524e78a8544e2ae2fdc2f3462bbec",22901966,1,-1,0,841,280,279,-1
"bc5524e78a8544e2ae2fdc2f3462bbec","bb5a47f5ea01454a8b79455422d3b9da",22901966,1,1,0,842,279,280,1
"0d987bed3ffa4ed0b9a2e62e97b7b30f","94cecc3f1e7d484b8e068e79241dfd73",22901966,1,13,0,902,272,281,9
"94cecc3f1e7d484b8e068e79241dfd73","a37477c4e4c14169ad44b06b493007f6",22901966,1,2,0,903,281,283,2
"a37477c4e4c14169ad44b06b493007f6","94cecc3f1e7d484b8e068e79241dfd73",22901966,1,-2,0,904,283,281,-2
"94cecc3f1e7d484b8e068e79241dfd73","fab84b4fab5940efb4ea868ef8d09396",22901966,1,5,0,905,281,284,3
"fab84b4fab5940efb4ea868ef8d09396","4a29443515bb404cb8924e1c60a63b73",22901966,1,4,0,906,284,285,1
"4a29443515bb404cb8924e1c60a63b73","fab84b4fab5940efb4ea868ef8d09396",22901966,1,-4,0,907,285,284,-1
"fab84b4fab5940efb4ea868ef8d09396","208c9b2796c944db8dacaa96082520ea",22901966,1,7,0,908,284,288,4
"208c9b2796c944db8dacaa96082520ea","0d987bed3ffa4ed0b9a2e62e97b7b30f",22901966,1,-25,0,909,288,272,-16
"b613861cecf84ffcab01afb23f660475","b613861cecf84ffcab01afb23f660475",22900813,4,0,1,1,1,1,0
"b613861cecf84ffcab01afb23f660475","e2911e79efc2420eac45d9f671463d4b",22900813,1,3,0,5,1,2,1
"519d1b8c59404d67b54e96c5c8a830b2","531db53f81f646edb0cdcfe0085b03b7",22900813,2,1,0,10,3,4,1
"531db53f81f646edb0cdcfe0085b03b7","531db53f81f646edb0cdcfe0085b03b7",22900813,1,0,1,11,4,4,0
"531db53f81f646edb0cdcfe0085b03b7","4f5f94b2f95141e0a9d53a61da2276da",22900813,1,1,0,12,4,5,1
"4f5f94b2f95141e0a9d53a61da2276da","4f5f94b2f95141e0a9d53a61da2276da",22900813,1,0,1,13,5,5,0
"4f5f94b2f95141e0a9d53a61da2276da","6d541c89590949f99af293c4f2333f67",22900813,1,1,0,14,5,6,1
"6d541c89590949f99af293c4f2333f67","6d541c89590949f99af293c4f2333f67",22900813,1,0,1,15,6,6,0
"6d541c89590949f99af293c4f2333f67","dd5cf0b9fe4c4f1d8f5ff8e4c04879cb",22900813,1,1,0,16,6,7,1
"dd5cf0b9fe4c4f1d8f5ff8e4c04879cb","dd5cf0b9fe4c4f1d8f5ff8e4c04879cb",22900813,1,0,1,17,7,7,0
"dd5cf0b9fe4c4f1d8f5ff8e4c04879cb","f96261861edc426abe2248be4f0a709a",22900813,2,1,0,18,7,8,1
"f96261861edc426abe2248be4f0a709a","f96261861edc426abe2248be4f0a709a",22900813,1,0,1,19,8,8,0
"f96261861edc426abe2248be4f0a709a","66b5e16f4f75454fb5b8172079f0fa83",22900813,2,1,0,20,8,9,1
"66b5e16f4f75454fb5b8172079f0fa83","66b5e16f4f75454fb5b8172079f0fa83",22900813,1,0,1,21,9,9,0
"66b5e16f4f75454fb5b8172079f0fa83","0680571d4698477995e41842c36a54b2",22900813,2,1,0,22,9,10,1
"0680571d4698477995e41842c36a54b2","0680571d4698477995e41842c36a54b2",22900813,1,0,1,23,10,10,0
"0680571d4698477995e41842c36a54b2","e2911e79efc2420eac45d9f671463d4b",22900813,1,-8,0,24,10,2,-8
"e2911e79efc2420eac45d9f671463d4b","56586aa865414f538729c7f7735d2bc6",22900813,2,12,0,25,2,12,10
"56586aa865414f538729c7f7735d2bc6","e2911e79efc2420eac45d9f671463d4b",22900813,2,-12,0,26,12,2,-10
"e2911e79efc2420eac45d9f671463d4b","9112f2bffece48e08c6d2287be204085",22900813,1,9,0,27,2,11,9
"9112f2bffece48e08c6d2287be204085","e2911e79efc2420eac45d9f671463d4b",22900813,1,-9,0,28,11,2,-9
"e2911e79efc2420eac45d9f671463d4b","e2911e79efc2420eac45d9f671463d4b",22900813,3,0,1,29,2,2,0
"e2911e79efc2420eac45d9f671463d4b","519d1b8c59404d67b54e96c5c8a830b2",22900813,2,1,0,30,2,3,1
"519d1b8c59404d67b54e96c5c8a830b2","519d1b8c59404d67b54e96c5c8a830b2",22900813,3,0,1,31,3,3,0
"531db53f81f646edb0cdcfe0085b03b7","dd5cf0b9fe4c4f1d8f5ff8e4c04879cb",22900813,1,3,0,34,4,7,3
"0680571d4698477995e41842c36a54b2","9112f2bffece48e08c6d2287be204085",22900813,1,1,0,38,10,11,1
"9112f2bffece48e08c6d2287be204085","56586aa865414f538729c7f7735d2bc6",22900813,1,3,0,39,11,12,1
"56586aa865414f538729c7f7735d2bc6","56586aa865414f538729c7f7735d2bc6",22900813,1,0,1,42,12,12,0
"56586aa865414f538729c7f7735d2bc6","b7f2b31585d94eb3bf86376714aa7070",22900813,2,2,0,43,12,13,1
"b7f2b31585d94eb3bf86376714aa7070","56586aa865414f538729c7f7735d2bc6",22900813,1,-2,0,44,13,12,-1
"b7f2b31585d94eb3bf86376714aa7070","b7f2b31585d94eb3bf86376714aa7070",22900813,1,0,1,46,13,13,0
"b7f2b31585d94eb3bf86376714aa7070","3f1c815879794b929260d224becaff7e",22900813,1,2,0,47,13,14,1
"3f1c815879794b929260d224becaff7e","81c864a886d54a6b8ff85f7d736f4f95",22900813,1,2,0,48,14,15,1
"81c864a886d54a6b8ff85f7d736f4f95","5c5ceeee4562457ba6d41515aeebfbb1",22900813,1,4,0,49,15,17,2
"5c5ceeee4562457ba6d41515aeebfbb1","5c5ceeee4562457ba6d41515aeebfbb1",22900813,3,0,1,50,17,17,0
"5c5ceeee4562457ba6d41515aeebfbb1","56586aa865414f538729c7f7735d2bc6",22900813,1,-10,0,52,17,12,-5
"56586aa865414f538729c7f7735d2bc6","9afd71a5298d4333b6849dfce1b9422c",22900813,1,13,0,53,12,18,6
"9afd71a5298d4333b6849dfce1b9422c","9afd71a5298d4333b6849dfce1b9422c",22900813,1,0,1,54,18,18,0
"9afd71a5298d4333b6849dfce1b9422c","56586aa865414f538729c7f7735d2bc6",22900813,1,-13,0,55,18,12,-6
"56586aa865414f538729c7f7735d2bc6","5c5ceeee4562457ba6d41515aeebfbb1",22900813,1,10,0,56,12,17,5
"5c5ceeee4562457ba6d41515aeebfbb1","eb2a0eb537344a9e891c761662e400b6",22900813,1,-2,0,58,17,16,-1
"eb2a0eb537344a9e891c761662e400b6","81c864a886d54a6b8ff85f7d736f4f95",22900813,1,-2,0,59,16,15,-1
"81c864a886d54a6b8ff85f7d736f4f95","3f1c815879794b929260d224becaff7e",22900813,1,-2,0,60,15,14,-1
"3f1c815879794b929260d224becaff7e","b7f2b31585d94eb3bf86376714aa7070",22900813,1,-2,0,61,14,13,-1
"b7f2b31585d94eb3bf86376714aa7070","67a089198fcb4e1c8f2385786c2b296f",22900813,1,55,0,62,13,39,26
"67a089198fcb4e1c8f2385786c2b296f","64d48c6c9c7940639a932219a6c87198",22900813,1,1,0,63,39,40,1
"64d48c6c9c7940639a932219a6c87198","64d48c6c9c7940639a932219a6c87198",22900813,1,0,1,64,40,40,0
"64d48c6c9c7940639a932219a6c87198","67a089198fcb4e1c8f2385786c2b296f",22900813,1,-1,0,65,40,39,-1
"67a089198fcb4e1c8f2385786c2b296f","b534b89233134e30a9b5645138bfa9ee",22900813,1,4,0,66,39,41,2
"b534b89233134e30a9b5645138bfa9ee","0e37b720d23b4e7f8b313e79313fd107",22900813,1,3,0,67,41,44,3
"0e37b720d23b4e7f8b313e79313fd107","0e37b720d23b4e7f8b313e79313fd107",22900813,1,0,1,68,44,44,0
"0e37b720d23b4e7f8b313e79313fd107","6875d67fdd5f48168b62719df449bebd",22900813,1,1,0,69,44,45,1
"6875d67fdd5f48168b62719df449bebd","6875d67fdd5f48168b62719df449bebd",22900813,1,0,1,70,45,45,0
"6875d67fdd5f48168b62719df449bebd","6e13d61a7bdb44bca949c9f86fab3be5",22900813,1,3,0,71,45,47,2
"6e13d61a7bdb44bca949c9f86fab3be5","b534b89233134e30a9b5645138bfa9ee",22900813,1,-7,0,72,47,41,-6
"b534b89233134e30a9b5645138bfa9ee","6e13d61a7bdb44bca949c9f86fab3be5",22900813,1,7,0,73,41,47,6
"6e13d61a7bdb44bca949c9f86fab3be5","6e13d61a7bdb44bca949c9f86fab3be5",22900813,1,0,1,74,47,47,0
"6e13d61a7bdb44bca949c9f86fab3be5","195f78799f984cc2b06c48dfe36be751",22900813,1,2,0,75,47,49,2
"195f78799f984cc2b06c48dfe36be751","195f78799f984cc2b06c48dfe36be751",22900813,2,0,1,76,49,49,0
"195f78799f984cc2b06c48dfe36be751","d9c8d8c444a64dadbbb508652c721e17",22900813,1,-3,0,78,49,46,-3
"d9c8d8c444a64dadbbb508652c721e17","d0c74f735e024943943e40333d6d337f",22900813,1,6,0,79,46,51,5
"d0c74f735e024943943e40333d6d337f","d0c74f735e024943943e40333d6d337f",22900813,2,0,1,80,51,51,0
"d0c74f735e024943943e40333d6d337f","983f8ff320594b279a7f4a6fe132f9c5",22900813,1,2,0,82,51,53,2
"983f8ff320594b279a7f4a6fe132f9c5","983f8ff320594b279a7f4a6fe132f9c5",22900813,2,0,1,83,53,53,0
"983f8ff320594b279a7f4a6fe132f9c5","35adfa5d923046aebabfefd98f35ff05",22900813,1,1,0,85,53,54,1
"35adfa5d923046aebabfefd98f35ff05","35adfa5d923046aebabfefd98f35ff05",22900813,2,0,1,86,54,54,0
"35adfa5d923046aebabfefd98f35ff05","b6f8a98476224da1b40e555ececc7ed8",22900813,1,1,0,88,54,55,1
"b6f8a98476224da1b40e555ececc7ed8","b6f8a98476224da1b40e555ececc7ed8",22900813,2,0,1,89,55,55,0
"b6f8a98476224da1b40e555ececc7ed8","86e22cb5fe0e4b47a9489ecddf7ed78f",22900813,1,1,0,91,55,56,1
"86e22cb5fe0e4b47a9489ecddf7ed78f","86e22cb5fe0e4b47a9489ecddf7ed78f",22900813,2,0,1,92,56,56,0
"86e22cb5fe0e4b47a9489ecddf7ed78f","f924752d8a1149668870b1e7698486f7",22900813,1,-6,0,94,56,50,-6
"f924752d8a1149668870b1e7698486f7","78f30e4dcac84e3cbea8b2cc6e0d62b3",22900813,1,10,0,95,50,59,9
"78f30e4dcac84e3cbea8b2cc6e0d62b3","a1f2f12debe5432fb7a70bcd12bacfb9",22900813,1,-1,0,96,59,58,-1
"a1f2f12debe5432fb7a70bcd12bacfb9","a1f2f12debe5432fb7a70bcd12bacfb9",22900813,19,0,1,100,58,58,0
"a1f2f12debe5432fb7a70bcd12bacfb9","bc42d26810654ea9a1df1efe1e58c7d5",22900813,1,6,0,116,58,63,5
"bc42d26810654ea9a1df1efe1e58c7d5","a0a418b8540d479fa6e0f653b701da8b",22900813,1,1,0,117,63,64,1
"a0a418b8540d479fa6e0f653b701da8b","12aa6e1672ac4e7aa6449a7a8609cd72",22900813,1,-8,0,118,64,57,-7
"12aa6e1672ac4e7aa6449a7a8609cd72","309ccf3cc4fe429d9bfbaef53d3fa479",22900813,1,4,0,119,57,60,3
"309ccf3cc4fe429d9bfbaef53d3fa479","d646286c8051419bbc2e31dd1db55ca8",22900813,1,10,0,120,60,67,7
"d646286c8051419bbc2e31dd1db55ca8","b534b89233134e30a9b5645138bfa9ee",22900813,1,-33,0,121,67,41,-26
"b534b89233134e30a9b5645138bfa9ee","d646286c8051419bbc2e31dd1db55ca8",22900813,1,33,0,122,41,67,26
"d646286c8051419bbc2e31dd1db55ca8","a2becd407db34b189200a32546d9d569",22900813,1,9,0,123,67,75,8
"a2becd407db34b189200a32546d9d569","a2becd407db34b189200a32546d9d569",22900813,2,0,1,124,75,75,0
"a2becd407db34b189200a32546d9d569","58c22b011d0f4c2ea6d13615edbb9eeb",22900813,1,2,0,126,75,77,2
"58c22b011d0f4c2ea6d13615edbb9eeb","58c22b011d0f4c2ea6d13615edbb9eeb",22900813,11,0,1,127,77,77,0
"58c22b011d0f4c2ea6d13615edbb9eeb","dd76e1861dc9461c830888729d091ee0",22900813,1,1,0,138,77,78,1
"dd76e1861dc9461c830888729d091ee0","dd76e1861dc9461c830888729d091ee0",22900813,5,0,1,139,78,78,0
"dd76e1861dc9461c830888729d091ee0","cd1d828f1a694b87913a7ea66c23803e",22900813,1,1,0,144,78,79,1
"cd1d828f1a694b87913a7ea66c23803e","cd1d828f1a694b87913a7ea66c23803e",22900813,2,0,1,145,79,79,0
"cd1d828f1a694b87913a7ea66c23803e","140d5b27b8574befad82c0a013b59dfa",22900813,1,-5,0,147,79,74,-5
"140d5b27b8574befad82c0a013b59dfa","d18a9ea32855445f8736581f5cb119ce",22900813,1,9,0,148,74,82,8
"d18a9ea32855445f8736581f5cb119ce","6a9f0ef185fb47f0937e29daa1c71ed5",22900813,1,10,0,149,82,90,8
"6a9f0ef185fb47f0937e29daa1c71ed5","ae5ac430ea254e708a6f5deaaf7464ae",22900813,1,-7,0,150,90,84,-6
"ae5ac430ea254e708a6f5deaaf7464ae","d646286c8051419bbc2e31dd1db55ca8",22900813,1,-20,0,151,84,67,-17
"d646286c8051419bbc2e31dd1db55ca8","e20db35ced8544ddac5bc3839145e463",22900813,1,30,0,152,67,91,24
"e20db35ced8544ddac5bc3839145e463","d391c8b6e56a43a7b654e9dee02d904b",22900813,1,13,0,153,91,103,12
"d391c8b6e56a43a7b654e9dee02d904b","00ae5f0c51874a73a41ebea838d95682",22900813,1,-2,0,154,103,101,-2
"00ae5f0c51874a73a41ebea838d95682","e20db35ced8544ddac5bc3839145e463",22900813,1,-11,0,155,101,91,-10
"e20db35ced8544ddac5bc3839145e463","00ae5f0c51874a73a41ebea838d95682",22900813,1,11,0,156,91,101,10
"00ae5f0c51874a73a41ebea838d95682","00ae5f0c51874a73a41ebea838d95682",22900813,1,0,1,157,101,101,0
"00ae5f0c51874a73a41ebea838d95682","d391c8b6e56a43a7b654e9dee02d904b",22900813,1,2,0,158,101,103,2
"d391c8b6e56a43a7b654e9dee02d904b","d391c8b6e56a43a7b654e9dee02d904b",22900813,15,0,1,159,103,103,0
"d391c8b6e56a43a7b654e9dee02d904b","6111116566fc4fd9abba409322bea245",22900813,1,1,0,174,103,104,1
"6111116566fc4fd9abba409322bea245","6111116566fc4fd9abba409322bea245",22900813,2,0,1,175,104,104,0
"6111116566fc4fd9abba409322bea245","a81b2235cb9c499eb9ea8ee0a8dd9725",22900813,1,1,0,177,104,105,1
"a81b2235cb9c499eb9ea8ee0a8dd9725","a81b2235cb9c499eb9ea8ee0a8dd9725",22900813,2,0,1,178,105,105,0
"a81b2235cb9c499eb9ea8ee0a8dd9725","2d4e0ab0ef3b4d73b82c72d4621a7579",22900813,1,1,0,180,105,106,1
"2d4e0ab0ef3b4d73b82c72d4621a7579","2d4e0ab0ef3b4d73b82c72d4621a7579",22900813,2,0,1,181,106,106,0
"2d4e0ab0ef3b4d73b82c72d4621a7579","8bdebf492ebd4e62b0d522e8ab5e5197",22900813,1,1,0,183,106,107,1
"8bdebf492ebd4e62b0d522e8ab5e5197","8bdebf492ebd4e62b0d522e8ab5e5197",22900813,2,0,1,184,107,107,0
"8bdebf492ebd4e62b0d522e8ab5e5197","73039f8c1eb9409cb4caee2cf968001e",22900813,1,-7,0,186,107,100,-7
"73039f8c1eb9409cb4caee2cf968001e","4280927ec4d643238aa49c32f9e06c6c",22900813,1,10,0,187,100,109,9
"4280927ec4d643238aa49c32f9e06c6c","4280927ec4d643238aa49c32f9e06c6c",22900813,2,0,1,188,109,109,0
"4280927ec4d643238aa49c32f9e06c6c","fc44e6a5f7654430af1227838224dceb",22900813,1,2,0,190,109,111,2
"fc44e6a5f7654430af1227838224dceb","fc44e6a5f7654430af1227838224dceb",22900813,2,0,1,191,111,111,0
"fc44e6a5f7654430af1227838224dceb","08111f75e22d409998cf8b85bd431f0a",22900813,1,-3,0,193,111,108,-3
"08111f75e22d409998cf8b85bd431f0a","a9ae0a3c070d455bb4369a8996313336",22900813,1,7,0,194,108,114,6
"a9ae0a3c070d455bb4369a8996313336","a9ae0a3c070d455bb4369a8996313336",22900813,1,0,1,195,114,114,0
"a9ae0a3c070d455bb4369a8996313336","37319e88176d4aefa91d7a9980dbae91",22900813,1,-2,0,196,114,112,-2
"37319e88176d4aefa91d7a9980dbae91","62bff51286ef4f348717a3cf6fe2318f",22900813,1,9,0,197,112,120,8
"62bff51286ef4f348717a3cf6fe2318f","e20db35ced8544ddac5bc3839145e463",22900813,1,-33,0,198,120,91,-29
"e20db35ced8544ddac5bc3839145e463","779f9ddd1fd14d1e9e69f72219a1fdbd",22900813,1,36,0,199,91,121,30
"779f9ddd1fd14d1e9e69f72219a1fdbd","a8dd5213034441ac92724b4e83eb0bb2",22900813,2,9,0,200,121,129,8
"a8dd5213034441ac92724b4e83eb0bb2","779f9ddd1fd14d1e9e69f72219a1fdbd",22900813,1,-9,0,201,129,121,-8
"a8dd5213034441ac92724b4e83eb0bb2","a8dd5213034441ac92724b4e83eb0bb2",22900813,1,0,1,203,129,129,0
"a8dd5213034441ac92724b4e83eb0bb2","579338175e0b4bbb8ef3b712b5d8b54e",22900813,1,-1,0,204,129,128,-1
"579338175e0b4bbb8ef3b712b5d8b54e","b416d47c56a742199b5d7c7f19d6503a",22900813,1,7,0,205,128,134,6
"b416d47c56a742199b5d7c7f19d6503a","779f9ddd1fd14d1e9e69f72219a1fdbd",22900813,1,-15,0,206,134,121,-13
"779f9ddd1fd14d1e9e69f72219a1fdbd","df1de691dafe4549a18a4398ee9dfaf9",22900813,1,23,0,207,121,139,18
"df1de691dafe4549a18a4398ee9dfaf9","6c5ad271a44743479bfaea29b1db8d02",22900813,1,4,0,208,139,143,4
"6c5ad271a44743479bfaea29b1db8d02","6c5ad271a44743479bfaea29b1db8d02",22900813,1,0,1,209,143,143,0
"6c5ad271a44743479bfaea29b1db8d02","83d311bed5374fee83d8d67a7d9d82dc",22900813,1,1,0,210,143,144,1
"83d311bed5374fee83d8d67a7d9d82dc","83d311bed5374fee83d8d67a7d9d82dc",22900813,1,0,1,211,144,144,0
"83d311bed5374fee83d8d67a7d9d82dc","402bba41861d43acb52a5abb89e8831e",22900813,1,1,0,212,144,145,1
"402bba41861d43acb52a5abb89e8831e","402bba41861d43acb52a5abb89e8831e",22900813,2,0,1,213,145,145,0
"402bba41861d43acb52a5abb89e8831e","df1de691dafe4549a18a4398ee9dfaf9",22900813,1,-6,0,215,145,139,-6
"df1de691dafe4549a18a4398ee9dfaf9","8aae34f5ddbb4052a709b12e6b0d40fa",22900813,1,9,0,216,139,147,8
"8aae34f5ddbb4052a709b12e6b0d40fa","8aae34f5ddbb4052a709b12e6b0d40fa",22900813,2,0,1,217,147,147,0
"8aae34f5ddbb4052a709b12e6b0d40fa","645b3f0249f64f76af2e19eb4d0e55b7",22900813,1,2,0,219,147,149,2
"645b3f0249f64f76af2e19eb4d0e55b7","645b3f0249f64f76af2e19eb4d0e55b7",22900813,5,0,1,220,149,149,0
"645b3f0249f64f76af2e19eb4d0e55b7","7e7b8db5064d4369805ab370aac5ddfb",22900813,1,1,0,225,149,150,1
"7e7b8db5064d4369805ab370aac5ddfb","7e7b8db5064d4369805ab370aac5ddfb",22900813,2,0,1,226,150,150,0
"7e7b8db5064d4369805ab370aac5ddfb","8956d210ae7f41968fada86d4c979d6a",22900813,1,1,0,228,150,151,1
"8956d210ae7f41968fada86d4c979d6a","8956d210ae7f41968fada86d4c979d6a",22900813,2,0,1,229,151,151,0
"8956d210ae7f41968fada86d4c979d6a","f902b0f41b544d4dbf79664fd233648d",22900813,1,-5,0,231,151,146,-5
"f902b0f41b544d4dbf79664fd233648d","8aae34f5ddbb4052a709b12e6b0d40fa",22900813,1,1,0,232,146,147,1
"8aae34f5ddbb4052a709b12e6b0d40fa","f03480cf4eba413194d7af52fc0e7f28",22900813,1,6,0,233,147,152,5
"f03480cf4eba413194d7af52fc0e7f28","f902b0f41b544d4dbf79664fd233648d",22900813,1,-7,0,234,152,146,-6
"f902b0f41b544d4dbf79664fd233648d","ae781e8b775e4ccd93bc800dad5c8376",22900813,1,8,0,235,146,153,7
"ae781e8b775e4ccd93bc800dad5c8376","ae781e8b775e4ccd93bc800dad5c8376",22900813,2,0,1,236,153,153,0
"ae781e8b775e4ccd93bc800dad5c8376","06882a8492d9499aa31555567f575ecb",22900813,1,1,0,238,153,154,1
"06882a8492d9499aa31555567f575ecb","06882a8492d9499aa31555567f575ecb",22900813,1,0,1,239,154,154,0
"06882a8492d9499aa31555567f575ecb","f293c508f409466a8f27ddd7d1e40b20",22900813,1,1,0,240,154,155,1
"f293c508f409466a8f27ddd7d1e40b20","f293c508f409466a8f27ddd7d1e40b20",22900813,2,0,1,241,155,155,0
"f293c508f409466a8f27ddd7d1e40b20","cc4ddef5bbbe48ebb605141b347c4ed1",22900813,1,1,0,243,155,156,1
"cc4ddef5bbbe48ebb605141b347c4ed1","cc4ddef5bbbe48ebb605141b347c4ed1",22900813,1,0,1,244,156,156,0
"cc4ddef5bbbe48ebb605141b347c4ed1","f03480cf4eba413194d7af52fc0e7f28",22900813,1,-4,0,245,156,152,-4
"f03480cf4eba413194d7af52fc0e7f28","d313cec988a84645bee413e8d4724a4b",22900813,1,7,0,246,152,158,6
"d313cec988a84645bee413e8d4724a4b","78adeee1fa2c4fe0bc73f7bca9fcee86",22900813,1,4,0,247,158,160,2
"78adeee1fa2c4fe0bc73f7bca9fcee86","df1de691dafe4549a18a4398ee9dfaf9",22900813,1,-26,0,248,160,139,-21
"df1de691dafe4549a18a4398ee9dfaf9","78adeee1fa2c4fe0bc73f7bca9fcee86",22900813,1,26,0,249,139,160,21
"78adeee1fa2c4fe0bc73f7bca9fcee86","65202579580f4ad38d734b4ee39d22a8",22900813,1,5,0,250,160,164,4
"65202579580f4ad38d734b4ee39d22a8","65202579580f4ad38d734b4ee39d22a8",22900813,7,0,1,251,164,164,0
"65202579580f4ad38d734b4ee39d22a8","78adeee1fa2c4fe0bc73f7bca9fcee86",22900813,1,-5,0,258,164,160,-4
"78adeee1fa2c4fe0bc73f7bca9fcee86","3cbcea2be0984e7dbd5a48195af10ce7",22900813,1,8,0,259,160,165,5
"3cbcea2be0984e7dbd5a48195af10ce7","82e6285962b8400d9d6fc32436022a94",22900813,1,2,0,260,165,167,2
"82e6285962b8400d9d6fc32436022a94","a9ac840f098c4bd0a2ee896214ce29cd",22900813,1,3,0,261,167,168,1
"a9ac840f098c4bd0a2ee896214ce29cd","3cbcea2be0984e7dbd5a48195af10ce7",22900813,1,-5,0,262,168,165,-3
"3cbcea2be0984e7dbd5a48195af10ce7","0c7262dff33c4087bc660ccf40f92f9c",22900813,1,9,0,263,165,169,4
"0c7262dff33c4087bc660ccf40f92f9c","a9ac840f098c4bd0a2ee896214ce29cd",22900813,1,-4,0,264,169,168,-1
"a9ac840f098c4bd0a2ee896214ce29cd","b2275c3fad834f8d90737a2d9a6927d6",22900813,1,7,0,265,168,172,4
"b2275c3fad834f8d90737a2d9a6927d6","b42cc17b7de840f181a704558d0bc845",22900813,1,4,0,266,172,175,3
"b42cc17b7de840f181a704558d0bc845","0c7262dff33c4087bc660ccf40f92f9c",22900813,2,-7,0,267,175,169,-6
"0c7262dff33c4087bc660ccf40f92f9c","0c7262dff33c4087bc660ccf40f92f9c",22900813,1,0,1,268,169,169,0
"0c7262dff33c4087bc660ccf40f92f9c","b42cc17b7de840f181a704558d0bc845",22900813,2,7,0,269,169,175,6
"b42cc17b7de840f181a704558d0bc845","b42cc17b7de840f181a704558d0bc845",22900813,1,0,1,270,175,175,0
"b42cc17b7de840f181a704558d0bc845","362fcb0699a14845ab29b2340093e528",22900813,1,-1,0,273,175,174,-1
"362fcb0699a14845ab29b2340093e528","b87c552dd247427abe6ab5795b9c9d43",22900813,1,8,0,274,174,181,7
"b87c552dd247427abe6ab5795b9c9d43","ea38cc0e6e6e41edbabf210220808bf9",22900813,1,-2,0,275,181,179,-2
"ea38cc0e6e6e41edbabf210220808bf9","ea38cc0e6e6e41edbabf210220808bf9",22900813,1,0,1,276,179,179,0
"ea38cc0e6e6e41edbabf210220808bf9","139b097acfca451689d80c9c6eebdf7b",22900813,1,-1,0,277,179,178,-1
"139b097acfca451689d80c9c6eebdf7b","2024b4885bd14338a39b7b509acbbd02",22900813,1,5,0,278,178,182,4
"2024b4885bd14338a39b7b509acbbd02","c8e371568a0c4391b25796ae4e91952e",22900813,1,7,0,279,182,186,4
"c8e371568a0c4391b25796ae4e91952e","0c7262dff33c4087bc660ccf40f92f9c",22900813,1,-23,0,280,186,169,-17
"0c7262dff33c4087bc660ccf40f92f9c","c8e371568a0c4391b25796ae4e91952e",22900813,1,23,0,281,169,186,17
"c8e371568a0c4391b25796ae4e91952e","ab11d94c6c8948ea90b88f19d2cd502b",22900813,1,5,0,282,186,190,4
"ab11d94c6c8948ea90b88f19d2cd502b","ab11d94c6c8948ea90b88f19d2cd502b",22900813,1,0,1,283,190,190,0
"ab11d94c6c8948ea90b88f19d2cd502b","07b44a7a51e94c78b411c753fc39dab0",22900813,1,-1,0,284,190,189,-1
"07b44a7a51e94c78b411c753fc39dab0","6cd2dcaac46847d4a0bc53f296d90375",22900813,1,6,0,285,189,194,5
"6cd2dcaac46847d4a0bc53f296d90375","6cd2dcaac46847d4a0bc53f296d90375",22900813,1,0,1,286,194,194,0
"6cd2dcaac46847d4a0bc53f296d90375","017d7ca8e0394b91aaadc9574df2202c",22900813,1,-1,0,287,194,193,-1
"017d7ca8e0394b91aaadc9574df2202c","f9170dd6bc6442b4acd832747609b09a",22900813,1,7,0,288,193,199,6
"f9170dd6bc6442b4acd832747609b09a","c8e371568a0c4391b25796ae4e91952e",22900813,1,-16,0,289,199,186,-13
"c8e371568a0c4391b25796ae4e91952e","d7f13c8d63ec4e2aa673fbb9cf9c6933",22900813,1,26,0,290,186,206,20
"d7f13c8d63ec4e2aa673fbb9cf9c6933","b9e80f77c3a44349863b19875725c384",22900813,1,1,0,291,206,207,1
"b9e80f77c3a44349863b19875725c384","7108f0e4c2584f1f9c471689ae4c885c",22900813,1,1,0,292,207,208,1
"7108f0e4c2584f1f9c471689ae4c885c","d7f13c8d63ec4e2aa673fbb9cf9c6933",22900813,1,-2,0,293,208,206,-2
"d7f13c8d63ec4e2aa673fbb9cf9c6933","09400e101c5d4b439cf9a26b03aae558",22900813,2,5,0,294,206,210,4
"09400e101c5d4b439cf9a26b03aae558","d7f13c8d63ec4e2aa673fbb9cf9c6933",22900813,1,-5,0,295,210,206,-4
"09400e101c5d4b439cf9a26b03aae558","a875096404ef4a9984b62d74cda916f9",22900813,1,-1,0,297,210,209,-1
"a875096404ef4a9984b62d74cda916f9","f7fb1952f56b4189b86a9f8b7862d2b8",22900813,1,7,0,298,209,215,6
"f7fb1952f56b4189b86a9f8b7862d2b8","be502a7a43c44bf7b682698de79d9369",22900813,1,-1,0,299,215,214,-1
"be502a7a43c44bf7b682698de79d9369","be502a7a43c44bf7b682698de79d9369",22900813,1,0,1,300,214,214,0
"be502a7a43c44bf7b682698de79d9369","ec341f459285443b8361f7f15638ff08",22900813,2,-1,0,301,214,213,-1
"ec341f459285443b8361f7f15638ff08","be502a7a43c44bf7b682698de79d9369",22900813,1,1,0,302,213,214,1
"ec341f459285443b8361f7f15638ff08","363837c182e04711840d896ae1e0339c",22900813,1,6,0,304,213,218,5
"363837c182e04711840d896ae1e0339c","01b2051f8941460d89945e3b02d1ce78",22900813,1,-1,0,305,218,217,-1
"01b2051f8941460d89945e3b02d1ce78","d7f13c8d63ec4e2aa673fbb9cf9c6933",22900813,1,-14,0,306,217,206,-11
"d7f13c8d63ec4e2aa673fbb9cf9c6933","1c6721b1f63f4d30ba7746ea8af02a52",22900813,2,21,0,307,206,221,15
"1c6721b1f63f4d30ba7746ea8af02a52","d7f13c8d63ec4e2aa673fbb9cf9c6933",22900813,1,-21,0,308,221,206,-15
"1c6721b1f63f4d30ba7746ea8af02a52","77ecef8eff6b4a2caea7707669bf7475",22900813,1,1,0,310,221,222,1
"77ecef8eff6b4a2caea7707669bf7475","d03cb855c70044cf8c35d9ec0de696e3",22900813,1,3,0,311,222,224,2
"d03cb855c70044cf8c35d9ec0de696e3","1c6721b1f63f4d30ba7746ea8af02a52",22900813,1,-4,0,312,224,221,-3
"1c6721b1f63f4d30ba7746ea8af02a52","8b9ae98743bd4d4a8a87dff1c1244211",22900813,1,7,0,313,221,227,6
"8b9ae98743bd4d4a8a87dff1c1244211","d03cb855c70044cf8c35d9ec0de696e3",22900813,1,-3,0,314,227,224,-3
"d03cb855c70044cf8c35d9ec0de696e3","2ab1535aac1346ba8801535bf729ef37",22900813,1,6,0,315,224,229,5
"2ab1535aac1346ba8801535bf729ef37","f7906d6f59b9489a91d2ef40db5a474d",22900813,1,-7,0,316,229,223,-6
"f7906d6f59b9489a91d2ef40db5a474d","2ab1535aac1346ba8801535bf729ef37",22900813,1,7,0,317,223,229,6
"2ab1535aac1346ba8801535bf729ef37","2ab1535aac1346ba8801535bf729ef37",22900813,1,0,1,318,229,229,0
"2ab1535aac1346ba8801535bf729ef37","5152833676bf4c6cb317060be10f68db",22900813,1,-1,0,319,229,228,-1
"5152833676bf4c6cb317060be10f68db","0b04c8e2f86d48c7aeb7e225819cd32b",22900813,1,7,0,320,228,234,6
"0b04c8e2f86d48c7aeb7e225819cd32b","1c6721b1f63f4d30ba7746ea8af02a52",22900813,1,-16,0,321,234,221,-13
"1c6721b1f63f4d30ba7746ea8af02a52","2ae94c0cea4d480a9d5dca8fb1d7b542",22900813,1,27,0,322,221,242,21
"2ae94c0cea4d480a9d5dca8fb1d7b542","1ebf23f9d994469a85206e4c7b1bf5f5",22900813,1,3,0,323,242,245,3
"1ebf23f9d994469a85206e4c7b1bf5f5","2ae94c0cea4d480a9d5dca8fb1d7b542",22900813,3,-3,0,324,245,242,-3
"2ae94c0cea4d480a9d5dca8fb1d7b542","6e83e23f56544a19b94067c1c558d9c0",22900813,3,6,0,325,242,247,5
"6e83e23f56544a19b94067c1c558d9c0","00f61990949545828dd12f1303d47504",22900813,3,11,0,326,247,256,9
"00f61990949545828dd12f1303d47504","00f61990949545828dd12f1303d47504",22900813,2,0,1,327,256,256,0
"00f61990949545828dd12f1303d47504","d546341988904f069cfa86b21457d9d9",22900813,3,-6,0,328,256,251,-5
"d546341988904f069cfa86b21457d9d9","d989ebcfc12a4b669f0100dc1aa14f1e",22900813,3,5,0,329,251,255,4
"d989ebcfc12a4b669f0100dc1aa14f1e","7aa76d3e993840d8805f097cbdbcd44b",22900813,3,7,0,330,255,261,6
"7aa76d3e993840d8805f097cbdbcd44b","0d987bed3ffa4ed0b9a2e62e97b7b30f",22900813,2,15,0,331,261,272,11
"0d987bed3ffa4ed0b9a2e62e97b7b30f","2ae94c0cea4d480a9d5dca8fb1d7b542",22900813,3,-38,0,332,272,242,-30
"2ae94c0cea4d480a9d5dca8fb1d7b542","0d987bed3ffa4ed0b9a2e62e97b7b30f",22900813,4,38,0,333,242,272,30
"0d987bed3ffa4ed0b9a2e62e97b7b30f","82ae07bc0c9b4570a41799290d1ef399",22900813,3,4,0,334,272,275,3
"82ae07bc0c9b4570a41799290d1ef399","bb5a47f5ea01454a8b79455422d3b9da",22900813,2,6,0,335,275,280,5
"bb5a47f5ea01454a8b79455422d3b9da","bb5a47f5ea01454a8b79455422d3b9da",22900813,21,0,1,336,280,280,0
"bb5a47f5ea01454a8b79455422d3b9da","94cecc3f1e7d484b8e068e79241dfd73",22900813,2,3,0,343,280,281,1
"94cecc3f1e7d484b8e068e79241dfd73","0d987bed3ffa4ed0b9a2e62e97b7b30f",22900813,2,-13,0,344,281,272,-9
"0d987bed3ffa4ed0b9a2e62e97b7b30f","a37477c4e4c14169ad44b06b493007f6",22900813,2,15,0,345,272,283,11
"a37477c4e4c14169ad44b06b493007f6","0d987bed3ffa4ed0b9a2e62e97b7b30f",22900813,1,-15,0,346,283,272,-11
"0d987bed3ffa4ed0b9a2e62e97b7b30f","1ebf23f9d994469a85206e4c7b1bf5f5",22900813,1,-35,0,349,272,245,-27
"7aa76d3e993840d8805f097cbdbcd44b","2ae94c0cea4d480a9d5dca8fb1d7b542",22900813,1,-23,0,357,261,242,-19
"0d987bed3ffa4ed0b9a2e62e97b7b30f","0d987bed3ffa4ed0b9a2e62e97b7b30f",22900813,1,0,1,359,272,272,0
"0d987bed3ffa4ed0b9a2e62e97b7b30f","bb5a47f5ea01454a8b79455422d3b9da",22900813,1,10,0,360,272,280,8
"bb5a47f5ea01454a8b79455422d3b9da","0d987bed3ffa4ed0b9a2e62e97b7b30f",22900813,1,-10,0,368,280,272,-8
"82ae07bc0c9b4570a41799290d1ef399","94cecc3f1e7d484b8e068e79241dfd73",22900813,1,9,0,370,275,281,6
"94cecc3f1e7d484b8e068e79241dfd73","a37477c4e4c14169ad44b06b493007f6",22900813,1,2,0,371,281,283,2
"a37477c4e4c14169ad44b06b493007f6","94cecc3f1e7d484b8e068e79241dfd73",22900813,2,-2,0,372,283,281,-2
"94cecc3f1e7d484b8e068e79241dfd73","fab84b4fab5940efb4ea868ef8d09396",22900813,2,5,0,373,281,284,3
"fab84b4fab5940efb4ea868ef8d09396","fab84b4fab5940efb4ea868ef8d09396",22900813,2,0,1,374,284,284,0
"fab84b4fab5940efb4ea868ef8d09396","4a29443515bb404cb8924e1c60a63b73",22900813,2,4,0,375,284,285,1
"4a29443515bb404cb8924e1c60a63b73","208c9b2796c944db8dacaa96082520ea",22900813,2,3,0,376,285,288,3
"208c9b2796c944db8dacaa96082520ea","4a29443515bb404cb8924e1c60a63b73",22900813,1,-3,0,377,288,285,-3
"4a29443515bb404cb8924e1c60a63b73","4a29443515bb404cb8924e1c60a63b73",22900813,1,0,1,378,285,285,0
"4a29443515bb404cb8924e1c60a63b73","6a9a3b5bde4a48daa896fe8c06eca56f",22900813,1,5,0,379,285,289,4
"6a9a3b5bde4a48daa896fe8c06eca56f","869e967078f04da18dd0b0b9389a7424",22900813,1,5,0,380,289,293,4
"869e967078f04da18dd0b0b9389a7424","869e967078f04da18dd0b0b9389a7424",22900813,3,0,1,381,293,293,0
"869e967078f04da18dd0b0b9389a7424","34a6e49023fc4465bd5ca604330bbd1c",22900813,2,-1,0,382,293,292,-1
"34a6e49023fc4465bd5ca604330bbd1c","869e967078f04da18dd0b0b9389a7424",22900813,1,1,0,383,292,293,1
"34a6e49023fc4465bd5ca604330bbd1c","ba0e59461bfb4a44b7b1c28a01f8d3b3",22900813,1,9,0,387,292,299,7
"ba0e59461bfb4a44b7b1c28a01f8d3b3","21592f2a9e9c4b2f8c66ec5dbcbf6a2b",22900813,1,-4,0,388,299,296,-3
"21592f2a9e9c4b2f8c66ec5dbcbf6a2b","ba0e59461bfb4a44b7b1c28a01f8d3b3",22900813,1,4,0,389,296,299,3
"ba0e59461bfb4a44b7b1c28a01f8d3b3","7646a919d7e64fa990bca9b024ff089d",22900813,1,-1,0,390,299,298,-1
"7646a919d7e64fa990bca9b024ff089d","4a29443515bb404cb8924e1c60a63b73",22900813,1,-17,0,391,298,285,-13
"4a29443515bb404cb8924e1c60a63b73","3434c10e561d488a914e0f7d71907abd",22900813,1,27,0,392,285,305,20
"3434c10e561d488a914e0f7d71907abd","53e7e900392747ccad52e711ab0f80d8",22900813,2,2,0,393,305,307,2
"53e7e900392747ccad52e711ab0f80d8","3434c10e561d488a914e0f7d71907abd",22900813,2,-2,0,394,307,305,-2
"3434c10e561d488a914e0f7d71907abd","130acc2aeb0448fdbb2de63bc5cebe5b",22900813,1,5,0,397,305,309,4
"130acc2aeb0448fdbb2de63bc5cebe5b","130acc2aeb0448fdbb2de63bc5cebe5b",22900813,1,0,1,398,309,309,0
"130acc2aeb0448fdbb2de63bc5cebe5b","141c0df6cd1946539aadd1c9b7068cd4",22900813,1,-1,0,399,309,308,-1
"141c0df6cd1946539aadd1c9b7068cd4","0c787d16c9504873b1a4d903cec09948",22900813,1,7,0,400,308,314,6
"0c787d16c9504873b1a4d903cec09948","86c27d40179e419c8e9d150fb6afa5d0",22900813,1,6,0,401,314,319,5
"86c27d40179e419c8e9d150fb6afa5d0","8d7e0b55cf9849cda222a0f2440cec55",22900813,1,-1,0,402,319,318,-1
"8d7e0b55cf9849cda222a0f2440cec55","47edbb64109243e6b0f8f64cdef90c6c",22900813,1,9,0,403,318,326,8
"47edbb64109243e6b0f8f64cdef90c6c","24f1363179ad4aaa965484a78471912b",22900813,1,-3,0,404,326,323,-3
"24f1363179ad4aaa965484a78471912b","3628bdce1dd2429ba924d2d4d09448d2",22900813,1,-1,0,405,323,322,-1
"3628bdce1dd2429ba924d2d4d09448d2","3434c10e561d488a914e0f7d71907abd",22900813,1,-21,0,406,322,305,-17
"3434c10e561d488a914e0f7d71907abd","0c4079457ede49e3aeb5e86ed84bdf35",22900813,2,31,0,407,305,329,24
"0c4079457ede49e3aeb5e86ed84bdf35","3434c10e561d488a914e0f7d71907abd",22900813,1,-31,0,408,329,305,-24
"0c4079457ede49e3aeb5e86ed84bdf35","38aea304b4fa46e1b29bb72f5cea4c93",22900813,2,2,0,410,329,331,2
"38aea304b4fa46e1b29bb72f5cea4c93","0c4079457ede49e3aeb5e86ed84bdf35",22900813,2,-2,0,411,331,329,-2
"0c4079457ede49e3aeb5e86ed84bdf35","0c4079457ede49e3aeb5e86ed84bdf35",22900813,1,0,1,412,329,329,0
"0c4079457ede49e3aeb5e86ed84bdf35","bbc5139ca9024389a94db3a6f47dcff6",22900813,1,14,0,415,329,341,12
"bbc5139ca9024389a94db3a6f47dcff6","bbc5139ca9024389a94db3a6f47dcff6",22900813,1,0,1,416,341,341,0
"bbc5139ca9024389a94db3a6f47dcff6","c2490bc612d146edbe786556fab3651b",22900813,1,-1,0,417,341,340,-1
"c2490bc612d146edbe786556fab3651b","30ead9794d4847abaf222ca966cc8630",22900813,1,11,0,418,340,348,8
"30ead9794d4847abaf222ca966cc8630","0c4079457ede49e3aeb5e86ed84bdf35",22900813,1,-24,0,419,348,329,-19
"0c4079457ede49e3aeb5e86ed84bdf35","897b7f51242c44aab2205c72fdcbf4cd",22900813,1,28,0,420,329,352,23
"897b7f51242c44aab2205c72fdcbf4cd","09b9678ddc3d452ea4a3d46e15826065",22900813,1,1,0,421,352,353,1
"09b9678ddc3d452ea4a3d46e15826065","c20993c944444fe085345591a8bd837e",22900813,1,-2,0,422,353,351,-2
"c20993c944444fe085345591a8bd837e","eff0de7f2dbb42dfa1a2e686efab5b6d",22900813,1,3,0,423,351,354,3
"eff0de7f2dbb42dfa1a2e686efab5b6d","2fe14166dc9642c3bc666b86a57f943d",22900813,1,4,0,424,354,357,3
"2fe14166dc9642c3bc666b86a57f943d","30ead9794d4847abaf222ca966cc8630",22900813,1,-10,0,425,357,348,-9
"30ead9794d4847abaf222ca966cc8630","2fe14166dc9642c3bc666b86a57f943d",22900813,1,10,0,426,348,357,9
"2fe14166dc9642c3bc666b86a57f943d","52580888dadb4fe3baa795683ea227bd",22900813,1,8,0,427,357,364,7
"52580888dadb4fe3baa795683ea227bd","1ba8fef685d74a8194b9db252eb704fb",22900813,1,-10,0,428,364,355,-9
"1ba8fef685d74a8194b9db252eb704fb","52580888dadb4fe3baa795683ea227bd",22900813,1,10,0,429,355,364,9
"52580888dadb4fe3baa795683ea227bd","f00179e251a045b39c3f7a54f9aa4acc",22900813,1,-1,0,430,364,363,-1
"f00179e251a045b39c3f7a54f9aa4acc","492a3bc6a1254f23a7998587961b22a4",22900813,1,4,0,431,363,366,3
"492a3bc6a1254f23a7998587961b22a4","492a3bc6a1254f23a7998587961b22a4",22900813,1,0,1,432,366,366,0
"492a3bc6a1254f23a7998587961b22a4","072a190fd302456290895f9f04d6940a",22900813,1,-1,0,433,366,365,-1
"072a190fd302456290895f9f04d6940a","b71bac264efb4abd97015447bd490db6",22900813,1,8,0,434,365,370,5
"b71bac264efb4abd97015447bd490db6","30ead9794d4847abaf222ca966cc8630",22900813,1,-28,0,435,370,348,-22
"30ead9794d4847abaf222ca966cc8630","8d448d625b024c82a5eb240bbd7431d6",22900813,1,33,0,436,348,374,26
"8d448d625b024c82a5eb240bbd7431d6","8d448d625b024c82a5eb240bbd7431d6",22900813,6,0,1,437,374,374,0
"8d448d625b024c82a5eb240bbd7431d6","b71bac264efb4abd97015447bd490db6",22900813,2,-5,0,441,374,370,-4
"b71bac264efb4abd97015447bd490db6","8d448d625b024c82a5eb240bbd7431d6",22900813,1,5,0,442,370,374,4
"b71bac264efb4abd97015447bd490db6","d6d02b6ef04e4f17805504500b8ce441",22900813,1,8,0,446,370,375,5
"d6d02b6ef04e4f17805504500b8ce441","d6d02b6ef04e4f17805504500b8ce441",22900813,2,0,1,447,375,375,0
"d6d02b6ef04e4f17805504500b8ce441","66baf19b6b904b70922329068c63746d",22900813,1,4,0,449,375,376,1
"66baf19b6b904b70922329068c63746d","7f544639412e40a9ba27f43b415362ab",22900813,3,2,0,450,376,378,2
"7f544639412e40a9ba27f43b415362ab","66baf19b6b904b70922329068c63746d",22900813,2,-2,0,451,378,376,-2
"66baf19b6b904b70922329068c63746d","c2fca3669923477ab966ded303dea31c",22900813,1,8,0,454,376,383,7
"c2fca3669923477ab966ded303dea31c","4890121ce5d74576b4632b77cfc23398",22900813,1,6,0,455,383,388,5
"4890121ce5d74576b4632b77cfc23398","18d3b836dd804224883cc9180b60a8e1",22900813,1,-1,0,456,388,387,-1
"18d3b836dd804224883cc9180b60a8e1","6f8881a745ac4c358a68b92c3b4abe81",22900813,1,9,0,457,387,394,7
"6f8881a745ac4c358a68b92c3b4abe81","6f8881a745ac4c358a68b92c3b4abe81",22900813,1,0,1,458,394,394,0
"6f8881a745ac4c358a68b92c3b4abe81","f7002c8484354eceac57bc7bd62c76c1",22900813,1,-1,0,459,394,393,-1
"f7002c8484354eceac57bc7bd62c76c1","0c12af0a4e7f4002852cf84b2537c161",22900813,1,3,0,460,393,395,2
"0c12af0a4e7f4002852cf84b2537c161","66baf19b6b904b70922329068c63746d",22900813,1,-24,0,461,395,376,-19
"66baf19b6b904b70922329068c63746d","2b09a08242b54983aec7063990fb3f66",22900813,1,32,0,462,376,400,24
"2b09a08242b54983aec7063990fb3f66","2b09a08242b54983aec7063990fb3f66",22900813,4,0,1,463,400,400,0
"2b09a08242b54983aec7063990fb3f66","1157bd665ec4472fb58b751dc5099355",22900813,2,4,0,467,400,403,3
"1157bd665ec4472fb58b751dc5099355","2b09a08242b54983aec7063990fb3f66",22900813,1,-4,0,468,403,400,-3
"1157bd665ec4472fb58b751dc5099355","3c8a22d2f9c146ea956609e3ed4f2559",22900813,1,3,0,470,403,405,2
"3c8a22d2f9c146ea956609e3ed4f2559","58fc9094275e4c49be3f4ba6d4acc0a4",22900813,1,2,0,471,405,406,1
"58fc9094275e4c49be3f4ba6d4acc0a4","58fc9094275e4c49be3f4ba6d4acc0a4",22900813,1,0,1,472,406,406,0
"58fc9094275e4c49be3f4ba6d4acc0a4","02b3a1bead9244c1ba2f857c7da8f82a",22900813,1,3,0,473,406,408,2
"02b3a1bead9244c1ba2f857c7da8f82a","02b3a1bead9244c1ba2f857c7da8f82a",22900813,1,0,1,474,408,408,0
"02b3a1bead9244c1ba2f857c7da8f82a","6a5f020451db426dacba9e2ea3fcc62a",22900813,1,3,0,475,408,410,2
"6a5f020451db426dacba9e2ea3fcc62a","6a5f020451db426dacba9e2ea3fcc62a",22900813,1,0,1,476,410,410,0
"6a5f020451db426dacba9e2ea3fcc62a","33a9d248b2e44588a5b07fc1342b9bc2",22900813,1,2,0,477,410,411,1
"33a9d248b2e44588a5b07fc1342b9bc2","33a9d248b2e44588a5b07fc1342b9bc2",22900813,1,0,1,478,411,411,0
"33a9d248b2e44588a5b07fc1342b9bc2","687055dad9fc40c3982478fe33ec01bf",22900813,1,4,0,479,411,414,3
"687055dad9fc40c3982478fe33ec01bf","2b09a08242b54983aec7063990fb3f66",22900813,1,-21,0,480,414,400,-14
"2b09a08242b54983aec7063990fb3f66","a2b4bd40cee2481ebd3fc179d6a5cd62",22900813,1,27,0,481,400,417,17
"a2b4bd40cee2481ebd3fc179d6a5cd62","a2b4bd40cee2481ebd3fc179d6a5cd62",22900813,1,0,1,482,417,417,0
"a2b4bd40cee2481ebd3fc179d6a5cd62","bec48fc2e1294c7eb3d0aca780d731b8",22900813,1,4,0,483,417,420,3
"bec48fc2e1294c7eb3d0aca780d731b8","bec48fc2e1294c7eb3d0aca780d731b8",22900813,3,0,1,484,420,420,0
"bec48fc2e1294c7eb3d0aca780d731b8","a24600b0e49245f6bdba8c893cfeddb0",22900813,1,7,0,487,420,425,5
"a24600b0e49245f6bdba8c893cfeddb0","dbde19fcce2a4c1abdc7f685c293a23f",22900813,2,-4,0,488,425,422,-3
"dbde19fcce2a4c1abdc7f685c293a23f","a24600b0e49245f6bdba8c893cfeddb0",22900813,2,4,0,489,422,425,3
"a24600b0e49245f6bdba8c893cfeddb0","a24600b0e49245f6bdba8c893cfeddb0",22900813,3,0,1,490,425,425,0
"a24600b0e49245f6bdba8c893cfeddb0","a2b4bd40cee2481ebd3fc179d6a5cd62",22900813,1,-11,0,495,425,417,-8
"a2b4bd40cee2481ebd3fc179d6a5cd62","24cf8786024543f19b89bc20034e60d7",22900813,1,18,0,496,417,428,11
"24cf8786024543f19b89bc20034e60d7","f2a73be2f46840b182d7bd095378004e",22900813,1,1,0,497,428,429,1
"f2a73be2f46840b182d7bd095378004e","f2a73be2f46840b182d7bd095378004e",22900813,2,0,1,498,429,429,0
"f2a73be2f46840b182d7bd095378004e","24cf8786024543f19b89bc20034e60d7",22900813,1,-1,0,500,429,428,-1
"24cf8786024543f19b89bc20034e60d7","dce46f8904594a62a6377a3587aaa663",22900813,1,4,0,501,428,431,3
"dce46f8904594a62a6377a3587aaa663","dce46f8904594a62a6377a3587aaa663",22900813,2,0,1,502,431,431,0
"dce46f8904594a62a6377a3587aaa663","a2b4bd40cee2481ebd3fc179d6a5cd62",22900813,1,-22,0,504,431,417,-14
"a2b4bd40cee2481ebd3fc179d6a5cd62","5d290f75e44b4bdb8256c600debbb44d",22900813,1,13,0,505,417,426,9
"5d290f75e44b4bdb8256c600debbb44d","66baf19b6b904b70922329068c63746d",22900813,1,-72,0,506,426,376,-50
"66baf19b6b904b70922329068c63746d","66baf19b6b904b70922329068c63746d",22900813,1,0,1,507,376,376,0
"7f544639412e40a9ba27f43b415362ab","7f544639412e40a9ba27f43b415362ab",22900813,1,0,1,509,378,378,0
"7f544639412e40a9ba27f43b415362ab","2ae94c0cea4d480a9d5dca8fb1d7b542",22900813,1,-184,0,510,378,242,-136
"6e83e23f56544a19b94067c1c558d9c0","6e83e23f56544a19b94067c1c558d9c0",22900813,1,0,1,512,247,247,0
"6e83e23f56544a19b94067c1c558d9c0","1ebf23f9d994469a85206e4c7b1bf5f5",22900813,1,-3,0,513,247,245,-2
"2ae94c0cea4d480a9d5dca8fb1d7b542","00f61990949545828dd12f1303d47504",22900813,1,17,0,515,242,256,14
"00f61990949545828dd12f1303d47504","6e83e23f56544a19b94067c1c558d9c0",22900813,1,-11,0,516,256,247,-9
"208c9b2796c944db8dacaa96082520ea","208c9b2796c944db8dacaa96082520ea",22900813,1,0,1,541,288,288,0
"b613861cecf84ffcab01afb23f660475","b613861cecf84ffcab01afb23f660475",22903543,3,0,1,1,1,1,0
"b613861cecf84ffcab01afb23f660475","e2911e79efc2420eac45d9f671463d4b",22903543,2,3,0,4,1,2,1
"e2911e79efc2420eac45d9f671463d4b","b613861cecf84ffcab01afb23f660475",22903543,1,-3,0,5,2,1,-1
"e2911e79efc2420eac45d9f671463d4b","e2911e79efc2420eac45d9f671463d4b",22903543,1,0,1,7,2,2,0
"e2911e79efc2420eac45d9f671463d4b","519d1b8c59404d67b54e96c5c8a830b2",22903543,1,1,0,8,2,3,1
"519d1b8c59404d67b54e96c5c8a830b2","519d1b8c59404d67b54e96c5c8a830b2",22903543,1,0,1,9,3,3,0
"519d1b8c59404d67b54e96c5c8a830b2","531db53f81f646edb0cdcfe0085b03b7",22903543,1,1,0,10,3,4,1
"531db53f81f646edb0cdcfe0085b03b7","531db53f81f646edb0cdcfe0085b03b7",22903543,1,0,1,11,4,4,0
"531db53f81f646edb0cdcfe0085b03b7","4f5f94b2f95141e0a9d53a61da2276da",22903543,1,1,0,12,4,5,1
"4f5f94b2f95141e0a9d53a61da2276da","4f5f94b2f95141e0a9d53a61da2276da",22903543,1,0,1,13,5,5,0
"4f5f94b2f95141e0a9d53a61da2276da","6d541c89590949f99af293c4f2333f67",22903543,1,1,0,14,5,6,1
"6d541c89590949f99af293c4f2333f67","6d541c89590949f99af293c4f2333f67",22903543,1,0,1,15,6,6,0
"6d541c89590949f99af293c4f2333f67","dd5cf0b9fe4c4f1d8f5ff8e4c04879cb",22903543,1,1,0,16,6,7,1
"dd5cf0b9fe4c4f1d8f5ff8e4c04879cb","dd5cf0b9fe4c4f1d8f5ff8e4c04879cb",22903543,1,0,1,17,7,7,0
"dd5cf0b9fe4c4f1d8f5ff8e4c04879cb","f96261861edc426abe2248be4f0a709a",22903543,1,1,0,18,7,8,1
"f96261861edc426abe2248be4f0a709a","f96261861edc426abe2248be4f0a709a",22903543,1,0,1,19,8,8,0
"f96261861edc426abe2248be4f0a709a","66b5e16f4f75454fb5b8172079f0fa83",22903543,1,1,0,20,8,9,1
"66b5e16f4f75454fb5b8172079f0fa83","66b5e16f4f75454fb5b8172079f0fa83",22903543,1,0,1,21,9,9,0
"66b5e16f4f75454fb5b8172079f0fa83","0680571d4698477995e41842c36a54b2",22903543,1,1,0,22,9,10,1
"0680571d4698477995e41842c36a54b2","0680571d4698477995e41842c36a54b2",22903543,1,0,1,23,10,10,0
"0680571d4698477995e41842c36a54b2","9112f2bffece48e08c6d2287be204085",22903543,1,1,0,24,10,11,1
"9112f2bffece48e08c6d2287be204085","9112f2bffece48e08c6d2287be204085",22903543,1,0,1,25,11,11,0
"9112f2bffece48e08c6d2287be204085","56586aa865414f538729c7f7735d2bc6",22903543,1,3,0,26,11,12,1
"56586aa865414f538729c7f7735d2bc6","e2911e79efc2420eac45d9f671463d4b",22903543,1,-12,0,27,12,2,-10
"e2911e79efc2420eac45d9f671463d4b","56586aa865414f538729c7f7735d2bc6",22903543,1,12,0,28,2,12,10
"56586aa865414f538729c7f7735d2bc6","56586aa865414f538729c7f7735d2bc6",22903543,5,0,1,29,12,12,0
"56586aa865414f538729c7f7735d2bc6","b7f2b31585d94eb3bf86376714aa7070",22903543,5,2,0,30,12,13,1
"b7f2b31585d94eb3bf86376714aa7070","56586aa865414f538729c7f7735d2bc6",22903543,2,-2,0,31,13,12,-1
"b7f2b31585d94eb3bf86376714aa7070","b7f2b31585d94eb3bf86376714aa7070",22903543,2,0,1,33,13,13,0
"b7f2b31585d94eb3bf86376714aa7070","3f1c815879794b929260d224becaff7e",22903543,3,2,0,34,13,14,1
"3f1c815879794b929260d224becaff7e","81c864a886d54a6b8ff85f7d736f4f95",22903543,2,2,0,35,14,15,1
"81c864a886d54a6b8ff85f7d736f4f95","5c5ceeee4562457ba6d41515aeebfbb1",22903543,2,4,0,36,15,17,2
"5c5ceeee4562457ba6d41515aeebfbb1","5c5ceeee4562457ba6d41515aeebfbb1",22903543,1,0,1,37,17,17,0
"5c5ceeee4562457ba6d41515aeebfbb1","56586aa865414f538729c7f7735d2bc6",22903543,1,-10,0,38,17,12,-5
"56586aa865414f538729c7f7735d2bc6","9afd71a5298d4333b6849dfce1b9422c",22903543,2,13,0,39,12,18,6
"9afd71a5298d4333b6849dfce1b9422c","56586aa865414f538729c7f7735d2bc6",22903543,3,-13,0,40,18,12,-6
"5c5ceeee4562457ba6d41515aeebfbb1","9afd71a5298d4333b6849dfce1b9422c",22903543,1,3,0,48,17,18,1
"3f1c815879794b929260d224becaff7e","5c5ceeee4562457ba6d41515aeebfbb1",22903543,1,6,0,56,14,17,3
"5c5ceeee4562457ba6d41515aeebfbb1","81c864a886d54a6b8ff85f7d736f4f95",22903543,1,-4,0,57,17,15,-2
"81c864a886d54a6b8ff85f7d736f4f95","9afd71a5298d4333b6849dfce1b9422c",22903543,1,7,0,58,15,18,3
"9afd71a5298d4333b6849dfce1b9422c","9afd71a5298d4333b6849dfce1b9422c",22903543,5,0,1,61,18,18,0
"9afd71a5298d4333b6849dfce1b9422c","b7719e26494940efa49512aedd0aac79",22903543,2,4,0,65,18,20,2
"b7719e26494940efa49512aedd0aac79","d4f45188d3c84a02ba08454e6403a818",22903543,2,5,0,66,20,24,4
"d4f45188d3c84a02ba08454e6403a818","d4c3b003e8274e429d2fa688d73fde6d",22903543,2,-2,0,67,24,22,-2
"d4c3b003e8274e429d2fa688d73fde6d","9afd71a5298d4333b6849dfce1b9422c",22903543,1,-7,0,68,22,18,-4
"d4c3b003e8274e429d2fa688d73fde6d","b7719e26494940efa49512aedd0aac79",22903543,1,-3,0,73,22,20,-2
"b7719e26494940efa49512aedd0aac79","a49d1bb4328949299686242fd0be5584",22903543,1,2,0,74,20,21,1
"a49d1bb4328949299686242fd0be5584","b7719e26494940efa49512aedd0aac79",22903543,1,-2,0,75,21,20,-1
"b7719e26494940efa49512aedd0aac79","afbf7250b99d47bea07172749483ca97",22903543,2,12,0,76,20,28,8
"afbf7250b99d47bea07172749483ca97","b7719e26494940efa49512aedd0aac79",22903543,1,-12,0,77,28,20,-8
"afbf7250b99d47bea07172749483ca97","4e51676dc72045d99c19b9fa7b22f8bc",22903543,1,3,0,79,28,29,1
"4e51676dc72045d99c19b9fa7b22f8bc","4e51676dc72045d99c19b9fa7b22f8bc",22903543,1,0,1,80,29,29,0
"4e51676dc72045d99c19b9fa7b22f8bc","51970cfa30e643e894e66ae85c8024cc",22903543,1,3,0,81,29,31,2
"51970cfa30e643e894e66ae85c8024cc","4e51676dc72045d99c19b9fa7b22f8bc",22903543,1,-3,0,82,31,29,-2
"4e51676dc72045d99c19b9fa7b22f8bc","c33c17be71ae4d588da7369472e5bb1b",22903543,1,9,0,83,29,34,5
"c33c17be71ae4d588da7369472e5bb1b","93679be414554a11b1893002f2229a93",22903543,1,3,0,84,34,35,1
"93679be414554a11b1893002f2229a93","c33c17be71ae4d588da7369472e5bb1b",22903543,1,-3,0,85,35,34,-1
"c33c17be71ae4d588da7369472e5bb1b","7040a13096d746ac84b8fac8d9752058",22903543,1,6,0,86,34,36,2
"7040a13096d746ac84b8fac8d9752058","93679be414554a11b1893002f2229a93",22903543,1,-3,0,87,36,35,-1
"93679be414554a11b1893002f2229a93","9a0dc646f934470daf08c4b56ccf73db",22903543,1,6,0,88,35,37,2
"9a0dc646f934470daf08c4b56ccf73db","7040a13096d746ac84b8fac8d9752058",22903543,1,-3,0,89,37,36,-1
"7040a13096d746ac84b8fac8d9752058","9a0dc646f934470daf08c4b56ccf73db",22903543,1,3,0,90,36,37,1
"9a0dc646f934470daf08c4b56ccf73db","fc0e049d56024bc9a02c9a9c435c3df7",22903543,1,3,0,91,37,38,1
"fc0e049d56024bc9a02c9a9c435c3df7","fc0e049d56024bc9a02c9a9c435c3df7",22903543,1,0,1,92,38,38,0
"fc0e049d56024bc9a02c9a9c435c3df7","67a089198fcb4e1c8f2385786c2b296f",22903543,1,4,0,93,38,39,1
"67a089198fcb4e1c8f2385786c2b296f","64d48c6c9c7940639a932219a6c87198",22903543,1,1,0,94,39,40,1
"64d48c6c9c7940639a932219a6c87198","64d48c6c9c7940639a932219a6c87198",22903543,1,0,1,95,40,40,0
"64d48c6c9c7940639a932219a6c87198","67a089198fcb4e1c8f2385786c2b296f",22903543,1,-1,0,96,40,39,-1
"67a089198fcb4e1c8f2385786c2b296f","b534b89233134e30a9b5645138bfa9ee",22903543,1,4,0,97,39,41,2
"b534b89233134e30a9b5645138bfa9ee","b534b89233134e30a9b5645138bfa9ee",22903543,3,0,1,100,41,41,0
"b534b89233134e30a9b5645138bfa9ee","0e37b720d23b4e7f8b313e79313fd107",22903543,1,3,0,101,41,44,3
"0e37b720d23b4e7f8b313e79313fd107","0e37b720d23b4e7f8b313e79313fd107",22903543,1,0,1,102,44,44,0
"0e37b720d23b4e7f8b313e79313fd107","6875d67fdd5f48168b62719df449bebd",22903543,1,1,0,103,44,45,1
"6875d67fdd5f48168b62719df449bebd","6875d67fdd5f48168b62719df449bebd",22903543,1,0,1,104,45,45,0
"6875d67fdd5f48168b62719df449bebd","b534b89233134e30a9b5645138bfa9ee",22903543,1,-4,0,105,45,41,-4
"b534b89233134e30a9b5645138bfa9ee","6e13d61a7bdb44bca949c9f86fab3be5",22903543,1,7,0,106,41,47,6
"6e13d61a7bdb44bca949c9f86fab3be5","195f78799f984cc2b06c48dfe36be751",22903543,1,2,0,107,47,49,2
"195f78799f984cc2b06c48dfe36be751","195f78799f984cc2b06c48dfe36be751",22903543,2,0,1,108,49,49,0
"195f78799f984cc2b06c48dfe36be751","d9c8d8c444a64dadbbb508652c721e17",22903543,1,-3,0,110,49,46,-3
"d9c8d8c444a64dadbbb508652c721e17","d0c74f735e024943943e40333d6d337f",22903543,1,6,0,111,46,51,5
"d0c74f735e024943943e40333d6d337f","983f8ff320594b279a7f4a6fe132f9c5",22903543,1,2,0,112,51,53,2
"983f8ff320594b279a7f4a6fe132f9c5","983f8ff320594b279a7f4a6fe132f9c5",22903543,2,0,1,113,53,53,0
"983f8ff320594b279a7f4a6fe132f9c5","35adfa5d923046aebabfefd98f35ff05",22903543,1,1,0,115,53,54,1
"35adfa5d923046aebabfefd98f35ff05","35adfa5d923046aebabfefd98f35ff05",22903543,2,0,1,116,54,54,0
"35adfa5d923046aebabfefd98f35ff05","b6f8a98476224da1b40e555ececc7ed8",22903543,1,1,0,118,54,55,1
"b6f8a98476224da1b40e555ececc7ed8","b6f8a98476224da1b40e555ececc7ed8",22903543,2,0,1,119,55,55,0
"b6f8a98476224da1b40e555ececc7ed8","86e22cb5fe0e4b47a9489ecddf7ed78f",22903543,1,1,0,121,55,56,1
"86e22cb5fe0e4b47a9489ecddf7ed78f","86e22cb5fe0e4b47a9489ecddf7ed78f",22903543,2,0,1,122,56,56,0
"86e22cb5fe0e4b47a9489ecddf7ed78f","f924752d8a1149668870b1e7698486f7",22903543,1,-6,0,124,56,50,-6
"f924752d8a1149668870b1e7698486f7","a1f2f12debe5432fb7a70bcd12bacfb9",22903543,1,9,0,125,50,58,8
"a1f2f12debe5432fb7a70bcd12bacfb9","78f30e4dcac84e3cbea8b2cc6e0d62b3",22903543,2,1,0,126,58,59,1
"78f30e4dcac84e3cbea8b2cc6e0d62b3","a1f2f12debe5432fb7a70bcd12bacfb9",22903543,1,-1,0,127,59,58,-1
"a1f2f12debe5432fb7a70bcd12bacfb9","a1f2f12debe5432fb7a70bcd12bacfb9",22903543,28,0,1,128,58,58,0
"78f30e4dcac84e3cbea8b2cc6e0d62b3","78f30e4dcac84e3cbea8b2cc6e0d62b3",22903543,7,0,1,157,59,59,0
"78f30e4dcac84e3cbea8b2cc6e0d62b3","a0a418b8540d479fa6e0f653b701da8b",22903543,1,6,0,164,59,64,5
"a0a418b8540d479fa6e0f653b701da8b","12aa6e1672ac4e7aa6449a7a8609cd72",22903543,1,-8,0,165,64,57,-7
"12aa6e1672ac4e7aa6449a7a8609cd72","bc42d26810654ea9a1df1efe1e58c7d5",22903543,1,7,0,166,57,63,6
"bc42d26810654ea9a1df1efe1e58c7d5","4c943503763e4e349906eea3ed3c8e86",22903543,1,-2,0,167,63,61,-2
"4c943503763e4e349906eea3ed3c8e86","4c943503763e4e349906eea3ed3c8e86",22903543,1,0,1,168,61,61,0
"4c943503763e4e349906eea3ed3c8e86","309ccf3cc4fe429d9bfbaef53d3fa479",22903543,1,-1,0,169,61,60,-1
"309ccf3cc4fe429d9bfbaef53d3fa479","b534b89233134e30a9b5645138bfa9ee",22903543,1,-23,0,170,60,41,-19
"b534b89233134e30a9b5645138bfa9ee","d646286c8051419bbc2e31dd1db55ca8",22903543,1,33,0,171,41,67,26
"d646286c8051419bbc2e31dd1db55ca8","267f883678b24aed855fde42524975d9",22903543,1,4,0,172,67,71,4
"267f883678b24aed855fde42524975d9","267f883678b24aed855fde42524975d9",22903543,1,0,1,173,71,71,0
"267f883678b24aed855fde42524975d9","88fff56d0342490dbef9040750a20f6c",22903543,1,1,0,174,71,72,1
"88fff56d0342490dbef9040750a20f6c","88fff56d0342490dbef9040750a20f6c",22903543,2,0,1,175,72,72,0
"88fff56d0342490dbef9040750a20f6c","adb17b12b66c4a49a85fd34322f7df70",22903543,1,1,0,177,72,73,1
"adb17b12b66c4a49a85fd34322f7df70","adb17b12b66c4a49a85fd34322f7df70",22903543,1,0,1,178,73,73,0
"adb17b12b66c4a49a85fd34322f7df70","a2becd407db34b189200a32546d9d569",22903543,1,3,0,179,73,75,2
"a2becd407db34b189200a32546d9d569","d646286c8051419bbc2e31dd1db55ca8",22903543,1,-9,0,180,75,67,-8
"d646286c8051419bbc2e31dd1db55ca8","58c22b011d0f4c2ea6d13615edbb9eeb",22903543,1,11,0,181,67,77,10
"58c22b011d0f4c2ea6d13615edbb9eeb","58c22b011d0f4c2ea6d13615edbb9eeb",22903543,2,0,1,182,77,77,0
"58c22b011d0f4c2ea6d13615edbb9eeb","dd76e1861dc9461c830888729d091ee0",22903543,1,1,0,184,77,78,1
"dd76e1861dc9461c830888729d091ee0","dd76e1861dc9461c830888729d091ee0",22903543,12,0,1,185,78,78,0
"dd76e1861dc9461c830888729d091ee0","cd1d828f1a694b87913a7ea66c23803e",22903543,1,1,0,197,78,79,1
"cd1d828f1a694b87913a7ea66c23803e","cd1d828f1a694b87913a7ea66c23803e",22903543,5,0,1,198,79,79,0
"cd1d828f1a694b87913a7ea66c23803e","9176a3c2b4d2465fa8b0c67096c2a97e",22903543,1,1,0,203,79,80,1
"9176a3c2b4d2465fa8b0c67096c2a97e","9176a3c2b4d2465fa8b0c67096c2a97e",22903543,11,0,1,204,80,80,0
"9176a3c2b4d2465fa8b0c67096c2a97e","f8ec6445f7194e25b9101d4fbcb07a18",22903543,1,1,0,215,80,81,1
"f8ec6445f7194e25b9101d4fbcb07a18","f8ec6445f7194e25b9101d4fbcb07a18",22903543,2,0,1,216,81,81,0
"f8ec6445f7194e25b9101d4fbcb07a18","140d5b27b8574befad82c0a013b59dfa",22903543,1,-7,0,218,81,74,-7
"140d5b27b8574befad82c0a013b59dfa","d18a9ea32855445f8736581f5cb119ce",22903543,1,9,0,219,74,82,8
"d18a9ea32855445f8736581f5cb119ce","f564483cbd7a407681aa2fcca518cf5f",22903543,1,4,0,220,82,85,3
"f564483cbd7a407681aa2fcca518cf5f","f564483cbd7a407681aa2fcca518cf5f",22903543,1,0,1,221,85,85,0
"f564483cbd7a407681aa2fcca518cf5f","18fd01350bd5434ca636d59a599d768a",22903543,1,1,0,222,85,86,1
"18fd01350bd5434ca636d59a599d768a","18fd01350bd5434ca636d59a599d768a",22903543,9,0,1,223,86,86,0
"18fd01350bd5434ca636d59a599d768a","6a9f0ef185fb47f0937e29daa1c71ed5",22903543,1,5,0,232,86,90,4
"6a9f0ef185fb47f0937e29daa1c71ed5","ae5ac430ea254e708a6f5deaaf7464ae",22903543,1,-7,0,233,90,84,-6
"ae5ac430ea254e708a6f5deaaf7464ae","c681290961c94c4caf23b529d1ae6b9a",22903543,1,5,0,234,84,88,4
"c681290961c94c4caf23b529d1ae6b9a","c681290961c94c4caf23b529d1ae6b9a",22903543,1,0,1,235,88,88,0
"c681290961c94c4caf23b529d1ae6b9a","6a9f0ef185fb47f0937e29daa1c71ed5",22903543,1,2,0,236,88,90,2
"6a9f0ef185fb47f0937e29daa1c71ed5","6a9f0ef185fb47f0937e29daa1c71ed5",22903543,3,0,1,237,90,90,0
"6a9f0ef185fb47f0937e29daa1c71ed5","d646286c8051419bbc2e31dd1db55ca8",22903543,1,-27,0,240,90,67,-23
"d646286c8051419bbc2e31dd1db55ca8","e20db35ced8544ddac5bc3839145e463",22903543,1,30,0,241,67,91,24
"e20db35ced8544ddac5bc3839145e463","00ae5f0c51874a73a41ebea838d95682",22903543,1,11,0,242,91,101,10
"00ae5f0c51874a73a41ebea838d95682","e20db35ced8544ddac5bc3839145e463",22903543,2,-11,0,243,101,91,-10
"e20db35ced8544ddac5bc3839145e463","d391c8b6e56a43a7b654e9dee02d904b",22903543,2,13,0,244,91,103,12
"d391c8b6e56a43a7b654e9dee02d904b","4280927ec4d643238aa49c32f9e06c6c",22903543,1,7,0,245,103,109,6
"4280927ec4d643238aa49c32f9e06c6c","73039f8c1eb9409cb4caee2cf968001e",22903543,2,-10,0,246,109,100,-9
"73039f8c1eb9409cb4caee2cf968001e","37319e88176d4aefa91d7a9980dbae91",22903543,1,14,0,247,100,112,12
"37319e88176d4aefa91d7a9980dbae91","08111f75e22d409998cf8b85bd431f0a",22903543,1,-5,0,248,112,108,-4
"08111f75e22d409998cf8b85bd431f0a","62bff51286ef4f348717a3cf6fe2318f",22903543,1,14,0,249,108,120,12
"62bff51286ef4f348717a3cf6fe2318f","e20db35ced8544ddac5bc3839145e463",22903543,2,-33,0,250,120,91,-29
"e20db35ced8544ddac5bc3839145e463","779f9ddd1fd14d1e9e69f72219a1fdbd",22903543,2,36,0,251,91,121,30
"779f9ddd1fd14d1e9e69f72219a1fdbd","a9ae0a3c070d455bb4369a8996313336",22903543,1,-10,0,252,121,114,-7
"a9ae0a3c070d455bb4369a8996313336","779f9ddd1fd14d1e9e69f72219a1fdbd",22903543,1,10,0,253,114,121,7
"779f9ddd1fd14d1e9e69f72219a1fdbd","e20db35ced8544ddac5bc3839145e463",22903543,1,-36,0,254,121,91,-30
"e20db35ced8544ddac5bc3839145e463","62bff51286ef4f348717a3cf6fe2318f",22903543,2,33,0,255,91,120,29
"62bff51286ef4f348717a3cf6fe2318f","3ec3a3563847406fa73338f9e9999cf3",22903543,2,-3,0,256,120,117,-3
"3ec3a3563847406fa73338f9e9999cf3","3ec3a3563847406fa73338f9e9999cf3",22903543,1,0,1,257,117,117,0
"3ec3a3563847406fa73338f9e9999cf3","e20db35ced8544ddac5bc3839145e463",22903543,1,-30,0,258,117,91,-26
"3ec3a3563847406fa73338f9e9999cf3","1febb706d7a34005ae8711ed49c76e64",22903543,1,-27,0,261,117,94,-23
"1febb706d7a34005ae8711ed49c76e64","1febb706d7a34005ae8711ed49c76e64",22903543,2,0,1,262,94,94,0
"1febb706d7a34005ae8711ed49c76e64","8f73ba6f5a0042f2850356ac38ac6f24",22903543,1,1,0,264,94,95,1
"8f73ba6f5a0042f2850356ac38ac6f24","8f73ba6f5a0042f2850356ac38ac6f24",22903543,6,0,1,265,95,95,0
"8f73ba6f5a0042f2850356ac38ac6f24","e2260b86653c46d7b14a41fb419dbf8c",22903543,1,1,0,271,95,96,1
"e2260b86653c46d7b14a41fb419dbf8c","e2260b86653c46d7b14a41fb419dbf8c",22903543,2,0,1,272,96,96,0
"e2260b86653c46d7b14a41fb419dbf8c","35eb641ad1d845bbba54915bce75a962",22903543,1,1,0,274,96,97,1
"35eb641ad1d845bbba54915bce75a962","35eb641ad1d845bbba54915bce75a962",22903543,5,0,1,275,97,97,0
"35eb641ad1d845bbba54915bce75a962","08be90ffbeea4795a138cd42ed8db56f",22903543,1,1,0,280,97,98,1
"08be90ffbeea4795a138cd42ed8db56f","08be90ffbeea4795a138cd42ed8db56f",22903543,5,0,1,281,98,98,0
"08be90ffbeea4795a138cd42ed8db56f","3007433c8f584dcbb5ac159c1c5f2be3",22903543,1,1,0,286,98,99,1
"3007433c8f584dcbb5ac159c1c5f2be3","3007433c8f584dcbb5ac159c1c5f2be3",22903543,5,0,1,287,99,99,0
"3007433c8f584dcbb5ac159c1c5f2be3","00ae5f0c51874a73a41ebea838d95682",22903543,1,3,0,292,99,101,2
"d391c8b6e56a43a7b654e9dee02d904b","d391c8b6e56a43a7b654e9dee02d904b",22903543,17,0,1,295,103,103,0
"d391c8b6e56a43a7b654e9dee02d904b","6111116566fc4fd9abba409322bea245",22903543,1,1,0,312,103,104,1
"6111116566fc4fd9abba409322bea245","6111116566fc4fd9abba409322bea245",22903543,2,0,1,313,104,104,0
"6111116566fc4fd9abba409322bea245","a81b2235cb9c499eb9ea8ee0a8dd9725",22903543,1,1,0,315,104,105,1
"a81b2235cb9c499eb9ea8ee0a8dd9725","a81b2235cb9c499eb9ea8ee0a8dd9725",22903543,5,0,1,316,105,105,0
"a81b2235cb9c499eb9ea8ee0a8dd9725","2d4e0ab0ef3b4d73b82c72d4621a7579",22903543,1,1,0,321,105,106,1
"2d4e0ab0ef3b4d73b82c72d4621a7579","2d4e0ab0ef3b4d73b82c72d4621a7579",22903543,2,0,1,322,106,106,0
"2d4e0ab0ef3b4d73b82c72d4621a7579","8bdebf492ebd4e62b0d522e8ab5e5197",22903543,1,1,0,324,106,107,1
"8bdebf492ebd4e62b0d522e8ab5e5197","8bdebf492ebd4e62b0d522e8ab5e5197",22903543,5,0,1,325,107,107,0
"8bdebf492ebd4e62b0d522e8ab5e5197","4280927ec4d643238aa49c32f9e06c6c",22903543,1,3,0,330,107,109,2
"73039f8c1eb9409cb4caee2cf968001e","fc44e6a5f7654430af1227838224dceb",22903543,1,12,0,332,100,111,11
"fc44e6a5f7654430af1227838224dceb","fc44e6a5f7654430af1227838224dceb",22903543,5,0,1,333,111,111,0
"fc44e6a5f7654430af1227838224dceb","08111f75e22d409998cf8b85bd431f0a",22903543,1,-3,0,338,111,108,-3
"08111f75e22d409998cf8b85bd431f0a","a9ae0a3c070d455bb4369a8996313336",22903543,1,7,0,339,108,114,6
"a9ae0a3c070d455bb4369a8996313336","a9ae0a3c070d455bb4369a8996313336",22903543,1,0,1,340,114,114,0
"a9ae0a3c070d455bb4369a8996313336","71cec822bcff4f30a20e75dc63ef7b65",22903543,1,2,0,341,114,116,2
"71cec822bcff4f30a20e75dc63ef7b65","71cec822bcff4f30a20e75dc63ef7b65",22903543,1,0,1,342,116,116,0
"71cec822bcff4f30a20e75dc63ef7b65","37319e88176d4aefa91d7a9980dbae91",22903543,1,-4,0,343,116,112,-4
"37319e88176d4aefa91d7a9980dbae91","62bff51286ef4f348717a3cf6fe2318f",22903543,1,9,0,344,112,120,8
"62bff51286ef4f348717a3cf6fe2318f","b1cd0e7dc3ad4a8eb91a4bfdbeb025b0",22903543,1,-2,0,345,120,118,-2
"b1cd0e7dc3ad4a8eb91a4bfdbeb025b0","b1cd0e7dc3ad4a8eb91a4bfdbeb025b0",22903543,3,0,1,346,118,118,0
"b1cd0e7dc3ad4a8eb91a4bfdbeb025b0","62bff51286ef4f348717a3cf6fe2318f",22903543,1,2,0,349,118,120,2
"62bff51286ef4f348717a3cf6fe2318f","62bff51286ef4f348717a3cf6fe2318f",22903543,3,0,1,350,120,120,0
"779f9ddd1fd14d1e9e69f72219a1fdbd","ae26e6cda8ad4a3f81bd347560d9579f",22903543,1,4,0,355,121,125,4
"ae26e6cda8ad4a3f81bd347560d9579f","ae26e6cda8ad4a3f81bd347560d9579f",22903543,1,0,1,356,125,125,0
"ae26e6cda8ad4a3f81bd347560d9579f","ee48df95832b4374aa273ceb27ec1315",22903543,1,1,0,357,125,126,1
"ee48df95832b4374aa273ceb27ec1315","ee48df95832b4374aa273ceb27ec1315",22903543,1,0,1,358,126,126,0
"ee48df95832b4374aa273ceb27ec1315","7a439da90b394756ad1777fc4c6dead5",22903543,1,1,0,359,126,127,1
"7a439da90b394756ad1777fc4c6dead5","7a439da90b394756ad1777fc4c6dead5",22903543,1,0,1,360,127,127,0
"7a439da90b394756ad1777fc4c6dead5","a8dd5213034441ac92724b4e83eb0bb2",22903543,1,3,0,361,127,129,2
"a8dd5213034441ac92724b4e83eb0bb2","779f9ddd1fd14d1e9e69f72219a1fdbd",22903543,1,-9,0,362,129,121,-8
"779f9ddd1fd14d1e9e69f72219a1fdbd","8115eab6556b45f5b415c3b8c26a12e5",22903543,1,11,0,363,121,131,10
"8115eab6556b45f5b415c3b8c26a12e5","8115eab6556b45f5b415c3b8c26a12e5",22903543,11,0,1,364,131,131,0
"8115eab6556b45f5b415c3b8c26a12e5","ec34b06efd844b46a4c4818ecdb9b8f4",22903543,1,1,0,375,131,132,1
"ec34b06efd844b46a4c4818ecdb9b8f4","ec34b06efd844b46a4c4818ecdb9b8f4",22903543,5,0,1,376,132,132,0
"ec34b06efd844b46a4c4818ecdb9b8f4","c2e1c2b9eac64109b343a088584b576b",22903543,1,1,0,381,132,133,1
"c2e1c2b9eac64109b343a088584b576b","c2e1c2b9eac64109b343a088584b576b",22903543,2,0,1,382,133,133,0
"c2e1c2b9eac64109b343a088584b576b","579338175e0b4bbb8ef3b712b5d8b54e",22903543,1,-5,0,384,133,128,-5
"579338175e0b4bbb8ef3b712b5d8b54e","8bc5795d6a984a3eace4e2811e52dd4f",22903543,1,8,0,385,128,135,7
"8bc5795d6a984a3eace4e2811e52dd4f","8bc5795d6a984a3eace4e2811e52dd4f",22903543,1,0,1,386,135,135,0
"8bc5795d6a984a3eace4e2811e52dd4f","b416d47c56a742199b5d7c7f19d6503a",22903543,1,-1,0,387,135,134,-1
"b416d47c56a742199b5d7c7f19d6503a","cd4532ad48034873ba8bce2aac0c9808",22903543,1,4,0,388,134,137,3
"cd4532ad48034873ba8bce2aac0c9808","cd4532ad48034873ba8bce2aac0c9808",22903543,1,0,1,389,137,137,0
"cd4532ad48034873ba8bce2aac0c9808","779f9ddd1fd14d1e9e69f72219a1fdbd",22903543,1,-19,0,390,137,121,-16
"779f9ddd1fd14d1e9e69f72219a1fdbd","df1de691dafe4549a18a4398ee9dfaf9",22903543,1,23,0,391,121,139,18
"df1de691dafe4549a18a4398ee9dfaf9","6c5ad271a44743479bfaea29b1db8d02",22903543,2,4,0,392,139,143,4
"6c5ad271a44743479bfaea29b1db8d02","df1de691dafe4549a18a4398ee9dfaf9",22903543,1,-4,0,393,143,139,-4
"6c5ad271a44743479bfaea29b1db8d02","6c5ad271a44743479bfaea29b1db8d02",22903543,1,0,1,395,143,143,0
"6c5ad271a44743479bfaea29b1db8d02","83d311bed5374fee83d8d67a7d9d82dc",22903543,1,1,0,396,143,144,1
"83d311bed5374fee83d8d67a7d9d82dc","83d311bed5374fee83d8d67a7d9d82dc",22903543,1,0,1,397,144,144,0
"83d311bed5374fee83d8d67a7d9d82dc","402bba41861d43acb52a5abb89e8831e",22903543,1,1,0,398,144,145,1
"402bba41861d43acb52a5abb89e8831e","402bba41861d43acb52a5abb89e8831e",22903543,2,0,1,399,145,145,0
"402bba41861d43acb52a5abb89e8831e","df1de691dafe4549a18a4398ee9dfaf9",22903543,1,-6,0,401,145,139,-6
"df1de691dafe4549a18a4398ee9dfaf9","8aae34f5ddbb4052a709b12e6b0d40fa",22903543,1,9,0,402,139,147,8
"8aae34f5ddbb4052a709b12e6b0d40fa","645b3f0249f64f76af2e19eb4d0e55b7",22903543,1,2,0,403,147,149,2
"645b3f0249f64f76af2e19eb4d0e55b7","645b3f0249f64f76af2e19eb4d0e55b7",22903543,2,0,1,404,149,149,0
"645b3f0249f64f76af2e19eb4d0e55b7","7e7b8db5064d4369805ab370aac5ddfb",22903543,1,1,0,406,149,150,1
"7e7b8db5064d4369805ab370aac5ddfb","7e7b8db5064d4369805ab370aac5ddfb",22903543,2,0,1,407,150,150,0
"7e7b8db5064d4369805ab370aac5ddfb","8956d210ae7f41968fada86d4c979d6a",22903543,1,1,0,409,150,151,1
"8956d210ae7f41968fada86d4c979d6a","8956d210ae7f41968fada86d4c979d6a",22903543,2,0,1,410,151,151,0
"8956d210ae7f41968fada86d4c979d6a","f902b0f41b544d4dbf79664fd233648d",22903543,1,-5,0,412,151,146,-5
"f902b0f41b544d4dbf79664fd233648d","ae781e8b775e4ccd93bc800dad5c8376",22903543,1,8,0,413,146,153,7
"ae781e8b775e4ccd93bc800dad5c8376","ae781e8b775e4ccd93bc800dad5c8376",22903543,2,0,1,414,153,153,0
"ae781e8b775e4ccd93bc800dad5c8376","06882a8492d9499aa31555567f575ecb",22903543,1,1,0,416,153,154,1
"06882a8492d9499aa31555567f575ecb","06882a8492d9499aa31555567f575ecb",22903543,1,0,1,417,154,154,0
"06882a8492d9499aa31555567f575ecb","f293c508f409466a8f27ddd7d1e40b20",22903543,1,1,0,418,154,155,1
"f293c508f409466a8f27ddd7d1e40b20","f293c508f409466a8f27ddd7d1e40b20",22903543,2,0,1,419,155,155,0
"f293c508f409466a8f27ddd7d1e40b20","cc4ddef5bbbe48ebb605141b347c4ed1",22903543,1,1,0,421,155,156,1
"cc4ddef5bbbe48ebb605141b347c4ed1","cc4ddef5bbbe48ebb605141b347c4ed1",22903543,6,0,1,422,156,156,0
"cc4ddef5bbbe48ebb605141b347c4ed1","f03480cf4eba413194d7af52fc0e7f28",22903543,1,-4,0,428,156,152,-4
"f03480cf4eba413194d7af52fc0e7f28","d313cec988a84645bee413e8d4724a4b",22903543,1,7,0,429,152,158,6
"d313cec988a84645bee413e8d4724a4b","d313cec988a84645bee413e8d4724a4b",22903543,4,0,1,430,158,158,0
"d313cec988a84645bee413e8d4724a4b","dc60696c76a74368a60f72246e47700d",22903543,1,1,0,434,158,159,1
"dc60696c76a74368a60f72246e47700d","dc60696c76a74368a60f72246e47700d",22903543,1,0,1,435,159,159,0
"dc60696c76a74368a60f72246e47700d","78adeee1fa2c4fe0bc73f7bca9fcee86",22903543,1,3,0,436,159,160,1
"78adeee1fa2c4fe0bc73f7bca9fcee86","df1de691dafe4549a18a4398ee9dfaf9",22903543,1,-26,0,437,160,139,-21
"df1de691dafe4549a18a4398ee9dfaf9","78adeee1fa2c4fe0bc73f7bca9fcee86",22903543,1,26,0,438,139,160,21
"78adeee1fa2c4fe0bc73f7bca9fcee86","65202579580f4ad38d734b4ee39d22a8",22903543,3,5,0,439,160,164,4
"65202579580f4ad38d734b4ee39d22a8","65202579580f4ad38d734b4ee39d22a8",22903543,68,0,1,440,164,164,0
"65202579580f4ad38d734b4ee39d22a8","78adeee1fa2c4fe0bc73f7bca9fcee86",22903543,2,-5,0,447,164,160,-4
"78adeee1fa2c4fe0bc73f7bca9fcee86","3cbcea2be0984e7dbd5a48195af10ce7",22903543,2,8,0,448,160,165,5
"3cbcea2be0984e7dbd5a48195af10ce7","82e6285962b8400d9d6fc32436022a94",22903543,2,2,0,449,165,167,2
"82e6285962b8400d9d6fc32436022a94","a9ac840f098c4bd0a2ee896214ce29cd",22903543,1,3,0,450,167,168,1
"a9ac840f098c4bd0a2ee896214ce29cd","3cbcea2be0984e7dbd5a48195af10ce7",22903543,1,-5,0,451,168,165,-3
"3cbcea2be0984e7dbd5a48195af10ce7","a9ac840f098c4bd0a2ee896214ce29cd",22903543,3,5,0,452,165,168,3
"a9ac840f098c4bd0a2ee896214ce29cd","67a089198fcb4e1c8f2385786c2b296f",22903543,1,-165,0,453,168,39,-129
"67a089198fcb4e1c8f2385786c2b296f","78adeee1fa2c4fe0bc73f7bca9fcee86",22903543,1,152,0,454,39,160,121
"82e6285962b8400d9d6fc32436022a94","3cbcea2be0984e7dbd5a48195af10ce7",22903543,2,-2,0,513,167,165,-2
"a9ac840f098c4bd0a2ee896214ce29cd","78adeee1fa2c4fe0bc73f7bca9fcee86",22903543,1,-13,0,515,168,160,-8
"65202579580f4ad38d734b4ee39d22a8","3cbcea2be0984e7dbd5a48195af10ce7",22903543,1,3,0,524,164,165,1
"3cbcea2be0984e7dbd5a48195af10ce7","78adeee1fa2c4fe0bc73f7bca9fcee86",22903543,1,-8,0,525,165,160,-5
"78adeee1fa2c4fe0bc73f7bca9fcee86","82e6285962b8400d9d6fc32436022a94",22903543,1,10,0,526,160,167,7
"a9ac840f098c4bd0a2ee896214ce29cd","a9ac840f098c4bd0a2ee896214ce29cd",22903543,1,0,1,529,168,168,0
"a9ac840f098c4bd0a2ee896214ce29cd","0c7262dff33c4087bc660ccf40f92f9c",22903543,1,4,0,530,168,169,1
"0c7262dff33c4087bc660ccf40f92f9c","b2275c3fad834f8d90737a2d9a6927d6",22903543,2,3,0,531,169,172,3
"b2275c3fad834f8d90737a2d9a6927d6","0c7262dff33c4087bc660ccf40f92f9c",22903543,1,-3,0,532,172,169,-3
"b2275c3fad834f8d90737a2d9a6927d6","b2275c3fad834f8d90737a2d9a6927d6",22903543,32,0,1,534,172,172,0
"b2275c3fad834f8d90737a2d9a6927d6","eb515a26030b41f8a82a1e6114420bad",22903543,1,1,0,566,172,173,1
"eb515a26030b41f8a82a1e6114420bad","eb515a26030b41f8a82a1e6114420bad",22903543,2,0,1,567,173,173,0
"eb515a26030b41f8a82a1e6114420bad","b42cc17b7de840f181a704558d0bc845",22903543,1,3,0,569,173,175,2
"b42cc17b7de840f181a704558d0bc845","0c7262dff33c4087bc660ccf40f92f9c",22903543,1,-7,0,570,175,169,-6
"0c7262dff33c4087bc660ccf40f92f9c","b42cc17b7de840f181a704558d0bc845",22903543,1,7,0,571,169,175,6
"b42cc17b7de840f181a704558d0bc845","801f9e9135034f49bf5f8b4bdefedb41",22903543,1,2,0,572,175,177,2
"801f9e9135034f49bf5f8b4bdefedb41","801f9e9135034f49bf5f8b4bdefedb41",22903543,4,0,1,573,177,177,0
"801f9e9135034f49bf5f8b4bdefedb41","ea38cc0e6e6e41edbabf210220808bf9",22903543,1,3,0,577,177,179,2
"ea38cc0e6e6e41edbabf210220808bf9","362fcb0699a14845ab29b2340093e528",22903543,1,-6,0,578,179,174,-5
"362fcb0699a14845ab29b2340093e528","b87c552dd247427abe6ab5795b9c9d43",22903543,1,8,0,579,174,181,7
"b87c552dd247427abe6ab5795b9c9d43","ea38cc0e6e6e41edbabf210220808bf9",22903543,1,-2,0,580,181,179,-2
"ea38cc0e6e6e41edbabf210220808bf9","ea38cc0e6e6e41edbabf210220808bf9",22903543,1,0,1,581,179,179,0
"ea38cc0e6e6e41edbabf210220808bf9","b87c552dd247427abe6ab5795b9c9d43",22903543,1,2,0,582,179,181,2
"b87c552dd247427abe6ab5795b9c9d43","b87c552dd247427abe6ab5795b9c9d43",22903543,7,0,1,583,181,181,0
"b87c552dd247427abe6ab5795b9c9d43","139b097acfca451689d80c9c6eebdf7b",22903543,1,-3,0,590,181,178,-3
"139b097acfca451689d80c9c6eebdf7b","30f660a1feb34582a739722532524f79",22903543,1,6,0,591,178,183,5
"30f660a1feb34582a739722532524f79","30f660a1feb34582a739722532524f79",22903543,3,0,1,592,183,183,0
"30f660a1feb34582a739722532524f79","2024b4885bd14338a39b7b509acbbd02",22903543,1,-1,0,595,183,182,-1
"2024b4885bd14338a39b7b509acbbd02","c3f63fe50d8e487c86bf8ef76c9cadd3",22903543,1,4,0,596,182,185,3
"c3f63fe50d8e487c86bf8ef76c9cadd3","c3f63fe50d8e487c86bf8ef76c9cadd3",22903543,1,0,1,597,185,185,0
"c3f63fe50d8e487c86bf8ef76c9cadd3","c8e371568a0c4391b25796ae4e91952e",22903543,1,3,0,598,185,186,1
"c8e371568a0c4391b25796ae4e91952e","0c7262dff33c4087bc660ccf40f92f9c",22903543,1,-23,0,599,186,169,-17
"0c7262dff33c4087bc660ccf40f92f9c","7d932b23e1c84326ae5aa4d3c0d813d1",22903543,1,25,0,600,169,188,19
"7d932b23e1c84326ae5aa4d3c0d813d1","7d932b23e1c84326ae5aa4d3c0d813d1",22903543,3,0,1,601,188,188,0
"7d932b23e1c84326ae5aa4d3c0d813d1","c8e371568a0c4391b25796ae4e91952e",22903543,1,-2,0,604,188,186,-2
"c8e371568a0c4391b25796ae4e91952e","ab11d94c6c8948ea90b88f19d2cd502b",22903543,2,5,0,605,186,190,4
"ab11d94c6c8948ea90b88f19d2cd502b","c8e371568a0c4391b25796ae4e91952e",22903543,1,-5,0,606,190,186,-4
"ab11d94c6c8948ea90b88f19d2cd502b","ab11d94c6c8948ea90b88f19d2cd502b",22903543,1,0,1,608,190,190,0
"ab11d94c6c8948ea90b88f19d2cd502b","f992451ed6ad4e68bb9e68ad6be7c4be",22903543,1,2,0,609,190,192,2
"f992451ed6ad4e68bb9e68ad6be7c4be","f992451ed6ad4e68bb9e68ad6be7c4be",22903543,3,0,1,610,192,192,0
"f992451ed6ad4e68bb9e68ad6be7c4be","6cd2dcaac46847d4a0bc53f296d90375",22903543,1,3,0,613,192,194,2
"6cd2dcaac46847d4a0bc53f296d90375","07b44a7a51e94c78b411c753fc39dab0",22903543,1,-6,0,614,194,189,-5
"07b44a7a51e94c78b411c753fc39dab0","6cd2dcaac46847d4a0bc53f296d90375",22903543,1,6,0,615,189,194,5
"6cd2dcaac46847d4a0bc53f296d90375","2d2580c9411c4972909db508d6956a58",22903543,1,2,0,616,194,196,2
"2d2580c9411c4972909db508d6956a58","2d2580c9411c4972909db508d6956a58",22903543,2,0,1,617,196,196,0
"2d2580c9411c4972909db508d6956a58","5bddb3d9ed264f3984702f048c7e5340",22903543,1,1,0,619,196,197,1
"5bddb3d9ed264f3984702f048c7e5340","5bddb3d9ed264f3984702f048c7e5340",22903543,2,0,1,620,197,197,0
"5bddb3d9ed264f3984702f048c7e5340","d5e8e2bd12a2466b9d6d90855f0eb079",22903543,1,1,0,622,197,198,1
"d5e8e2bd12a2466b9d6d90855f0eb079","d5e8e2bd12a2466b9d6d90855f0eb079",22903543,2,0,1,623,198,198,0
"d5e8e2bd12a2466b9d6d90855f0eb079","017d7ca8e0394b91aaadc9574df2202c",22903543,1,-5,0,625,198,193,-5
"017d7ca8e0394b91aaadc9574df2202c","54e8e9f0ea3e45c4bf3b8ac799ee31b1",22903543,1,8,0,626,193,200,7
"54e8e9f0ea3e45c4bf3b8ac799ee31b1","54e8e9f0ea3e45c4bf3b8ac799ee31b1",22903543,1,0,1,627,200,200,0
"54e8e9f0ea3e45c4bf3b8ac799ee31b1","c614a00911be4877a075f19315530fb0",22903543,1,1,0,628,200,201,1
"c614a00911be4877a075f19315530fb0","c614a00911be4877a075f19315530fb0",22903543,6,0,1,629,201,201,0
"c614a00911be4877a075f19315530fb0","a6c21bd8b95249c7972820a7a7d76aff",22903543,1,1,0,635,201,202,1
"a6c21bd8b95249c7972820a7a7d76aff","a6c21bd8b95249c7972820a7a7d76aff",22903543,1,0,1,636,202,202,0
"a6c21bd8b95249c7972820a7a7d76aff","bb329d880ab54120adaf203a693bb203",22903543,1,1,0,637,202,203,1
"bb329d880ab54120adaf203a693bb203","bb329d880ab54120adaf203a693bb203",22903543,1,0,1,638,203,203,0
"bb329d880ab54120adaf203a693bb203","f9170dd6bc6442b4acd832747609b09a",22903543,1,-4,0,639,203,199,-4
"f9170dd6bc6442b4acd832747609b09a","334c2344009840079b1d0e1b7ce3d5a7",22903543,1,7,0,640,199,205,6
"334c2344009840079b1d0e1b7ce3d5a7","334c2344009840079b1d0e1b7ce3d5a7",22903543,1,0,1,641,205,205,0
"334c2344009840079b1d0e1b7ce3d5a7","c8e371568a0c4391b25796ae4e91952e",22903543,1,-23,0,642,205,186,-19
"c8e371568a0c4391b25796ae4e91952e","d7f13c8d63ec4e2aa673fbb9cf9c6933",22903543,1,26,0,643,186,206,20
"d7f13c8d63ec4e2aa673fbb9cf9c6933","7108f0e4c2584f1f9c471689ae4c885c",22903543,1,2,0,644,206,208,2
"7108f0e4c2584f1f9c471689ae4c885c","b9e80f77c3a44349863b19875725c384",22903543,2,-1,0,645,208,207,-1
"b9e80f77c3a44349863b19875725c384","d7f13c8d63ec4e2aa673fbb9cf9c6933",22903543,1,-1,0,646,207,206,-1
"d7f13c8d63ec4e2aa673fbb9cf9c6933","b9e80f77c3a44349863b19875725c384",22903543,1,1,0,647,206,207,1
"b9e80f77c3a44349863b19875725c384","7108f0e4c2584f1f9c471689ae4c885c",22903543,2,1,0,648,207,208,1
"b9e80f77c3a44349863b19875725c384","b9e80f77c3a44349863b19875725c384",22903543,21,0,1,650,207,207,0
"7108f0e4c2584f1f9c471689ae4c885c","7108f0e4c2584f1f9c471689ae4c885c",22903543,11,0,1,672,208,208,0
"7108f0e4c2584f1f9c471689ae4c885c","09400e101c5d4b439cf9a26b03aae558",22903543,1,3,0,683,208,210,2
"09400e101c5d4b439cf9a26b03aae558","d7f13c8d63ec4e2aa673fbb9cf9c6933",22903543,1,-5,0,684,210,206,-4
"d7f13c8d63ec4e2aa673fbb9cf9c6933","09400e101c5d4b439cf9a26b03aae558",22903543,1,5,0,685,206,210,4
"09400e101c5d4b439cf9a26b03aae558","a88efa7e50ce47159810ab553afa6d3a",22903543,1,2,0,686,210,212,2
"a88efa7e50ce47159810ab553afa6d3a","a88efa7e50ce47159810ab553afa6d3a",22903543,2,0,1,687,212,212,0
"a88efa7e50ce47159810ab553afa6d3a","be502a7a43c44bf7b682698de79d9369",22903543,1,3,0,689,212,214,2
"be502a7a43c44bf7b682698de79d9369","a875096404ef4a9984b62d74cda916f9",22903543,1,-6,0,690,214,209,-5
"a875096404ef4a9984b62d74cda916f9","f7fb1952f56b4189b86a9f8b7862d2b8",22903543,1,7,0,691,209,215,6
"f7fb1952f56b4189b86a9f8b7862d2b8","be502a7a43c44bf7b682698de79d9369",22903543,1,-1,0,692,215,214,-1
"b613861cecf84ffcab01afb23f660475","b613861cecf84ffcab01afb23f660475",22906796,6,0,1,1,1,1,0
"b613861cecf84ffcab01afb23f660475","e2911e79efc2420eac45d9f671463d4b",22906796,1,3,0,7,1,2,1
"e2911e79efc2420eac45d9f671463d4b","e2911e79efc2420eac45d9f671463d4b",22906796,2,0,1,8,2,2,0
"e2911e79efc2420eac45d9f671463d4b","519d1b8c59404d67b54e96c5c8a830b2",22906796,1,1,0,10,2,3,1
"519d1b8c59404d67b54e96c5c8a830b2","519d1b8c59404d67b54e96c5c8a830b2",22906796,1,0,1,11,3,3,0
"519d1b8c59404d67b54e96c5c8a830b2","531db53f81f646edb0cdcfe0085b03b7",22906796,1,1,0,12,3,4,1
"531db53f81f646edb0cdcfe0085b03b7","531db53f81f646edb0cdcfe0085b03b7",22906796,1,0,1,13,4,4,0
"531db53f81f646edb0cdcfe0085b03b7","4f5f94b2f95141e0a9d53a61da2276da",22906796,1,1,0,14,4,5,1
"4f5f94b2f95141e0a9d53a61da2276da","4f5f94b2f95141e0a9d53a61da2276da",22906796,2,0,1,15,5,5,0
"4f5f94b2f95141e0a9d53a61da2276da","6d541c89590949f99af293c4f2333f67",22906796,1,1,0,17,5,6,1
"6d541c89590949f99af293c4f2333f67","6d541c89590949f99af293c4f2333f67",22906796,1,0,1,18,6,6,0
"6d541c89590949f99af293c4f2333f67","dd5cf0b9fe4c4f1d8f5ff8e4c04879cb",22906796,1,1,0,19,6,7,1
"dd5cf0b9fe4c4f1d8f5ff8e4c04879cb","dd5cf0b9fe4c4f1d8f5ff8e4c04879cb",22906796,1,0,1,20,7,7,0
"dd5cf0b9fe4c4f1d8f5ff8e4c04879cb","e2911e79efc2420eac45d9f671463d4b",22906796,1,-5,0,21,7,2,-5
"e2911e79efc2420eac45d9f671463d4b","f96261861edc426abe2248be4f0a709a",22906796,1,6,0,22,2,8,6
"f96261861edc426abe2248be4f0a709a","f96261861edc426abe2248be4f0a709a",22906796,1,0,1,23,8,8,0
"f96261861edc426abe2248be4f0a709a","66b5e16f4f75454fb5b8172079f0fa83",22906796,1,1,0,24,8,9,1
"66b5e16f4f75454fb5b8172079f0fa83","66b5e16f4f75454fb5b8172079f0fa83",22906796,1,0,1,25,9,9,0
"66b5e16f4f75454fb5b8172079f0fa83","0680571d4698477995e41842c36a54b2",22906796,1,1,0,26,9,10,1
"0680571d4698477995e41842c36a54b2","0680571d4698477995e41842c36a54b2",22906796,1,0,1,27,10,10,0
"0680571d4698477995e41842c36a54b2","9112f2bffece48e08c6d2287be204085",22906796,1,1,0,28,10,11,1
"9112f2bffece48e08c6d2287be204085","9112f2bffece48e08c6d2287be204085",22906796,1,0,1,29,11,11,0
"9112f2bffece48e08c6d2287be204085","56586aa865414f538729c7f7735d2bc6",22906796,1,3,0,30,11,12,1
"56586aa865414f538729c7f7735d2bc6","e2911e79efc2420eac45d9f671463d4b",22906796,1,-12,0,31,12,2,-10
"e2911e79efc2420eac45d9f671463d4b","56586aa865414f538729c7f7735d2bc6",22906796,1,12,0,32,2,12,10
"56586aa865414f538729c7f7735d2bc6","56586aa865414f538729c7f7735d2bc6",22906796,1,0,1,33,12,12,0
"56586aa865414f538729c7f7735d2bc6","b7f2b31585d94eb3bf86376714aa7070",22906796,2,2,0,34,12,13,1
"b7f2b31585d94eb3bf86376714aa7070","56586aa865414f538729c7f7735d2bc6",22906796,1,-2,0,35,13,12,-1
"b7f2b31585d94eb3bf86376714aa7070","b7f2b31585d94eb3bf86376714aa7070",22906796,2,0,1,37,13,13,0
"b7f2b31585d94eb3bf86376714aa7070","3f1c815879794b929260d224becaff7e",22906796,1,2,0,39,13,14,1
"3f1c815879794b929260d224becaff7e","56586aa865414f538729c7f7735d2bc6",22906796,1,-4,0,40,14,12,-2
"56586aa865414f538729c7f7735d2bc6","5c5ceeee4562457ba6d41515aeebfbb1",22906796,1,10,0,41,12,17,5
"5c5ceeee4562457ba6d41515aeebfbb1","81c864a886d54a6b8ff85f7d736f4f95",22906796,1,-4,0,42,17,15,-2
"81c864a886d54a6b8ff85f7d736f4f95","5c5ceeee4562457ba6d41515aeebfbb1",22906796,1,4,0,43,15,17,2
"5c5ceeee4562457ba6d41515aeebfbb1","56586aa865414f538729c7f7735d2bc6",22906796,1,-10,0,44,17,12,-5
"56586aa865414f538729c7f7735d2bc6","9afd71a5298d4333b6849dfce1b9422c",22906796,1,13,0,45,12,18,6
"9afd71a5298d4333b6849dfce1b9422c","b7719e26494940efa49512aedd0aac79",22906796,1,4,0,46,18,20,2
"b7719e26494940efa49512aedd0aac79","9afd71a5298d4333b6849dfce1b9422c",22906796,1,-4,0,47,20,18,-2
"9afd71a5298d4333b6849dfce1b9422c","d4f45188d3c84a02ba08454e6403a818",22906796,1,9,0,48,18,24,6
"d4f45188d3c84a02ba08454e6403a818","d4c3b003e8274e429d2fa688d73fde6d",22906796,2,-2,0,49,24,22,-2
"d4c3b003e8274e429d2fa688d73fde6d","d4c3b003e8274e429d2fa688d73fde6d",22906796,3,0,1,50,22,22,0
"d4c3b003e8274e429d2fa688d73fde6d","b7719e26494940efa49512aedd0aac79",22906796,1,-3,0,53,22,20,-2
"b7719e26494940efa49512aedd0aac79","d4f45188d3c84a02ba08454e6403a818",22906796,1,5,0,54,20,24,4
"d4c3b003e8274e429d2fa688d73fde6d","5bc03c8f16354d04bd51f5bb93559ad3",22906796,1,4,0,56,22,26,4
"5bc03c8f16354d04bd51f5bb93559ad3","b7719e26494940efa49512aedd0aac79",22906796,1,-7,0,57,26,20,-6
"b7719e26494940efa49512aedd0aac79","b7719e26494940efa49512aedd0aac79",22906796,1,0,1,58,20,20,0
"b7719e26494940efa49512aedd0aac79","afbf7250b99d47bea07172749483ca97",22906796,1,12,0,59,20,28,8
"afbf7250b99d47bea07172749483ca97","afbf7250b99d47bea07172749483ca97",22906796,1,0,1,60,28,28,0
"afbf7250b99d47bea07172749483ca97","4e51676dc72045d99c19b9fa7b22f8bc",22906796,1,3,0,61,28,29,1
"4e51676dc72045d99c19b9fa7b22f8bc","4e51676dc72045d99c19b9fa7b22f8bc",22906796,1,0,1,62,29,29,0
"4e51676dc72045d99c19b9fa7b22f8bc","51970cfa30e643e894e66ae85c8024cc",22906796,1,3,0,63,29,31,2
"51970cfa30e643e894e66ae85c8024cc","c33c17be71ae4d588da7369472e5bb1b",22906796,1,6,0,64,31,34,3
"c33c17be71ae4d588da7369472e5bb1b","4e51676dc72045d99c19b9fa7b22f8bc",22906796,1,-9,0,65,34,29,-5
"4e51676dc72045d99c19b9fa7b22f8bc","c33c17be71ae4d588da7369472e5bb1b",22906796,1,9,0,66,29,34,5
"c33c17be71ae4d588da7369472e5bb1b","93679be414554a11b1893002f2229a93",22906796,1,3,0,67,34,35,1
"93679be414554a11b1893002f2229a93","7040a13096d746ac84b8fac8d9752058",22906796,2,3,0,68,35,36,1
"7040a13096d746ac84b8fac8d9752058","93679be414554a11b1893002f2229a93",22906796,1,-3,0,69,36,35,-1
"7040a13096d746ac84b8fac8d9752058","9a0dc646f934470daf08c4b56ccf73db",22906796,1,3,0,71,36,37,1
"9a0dc646f934470daf08c4b56ccf73db","9a0dc646f934470daf08c4b56ccf73db",22906796,1,0,1,72,37,37,0
"9a0dc646f934470daf08c4b56ccf73db","fc0e049d56024bc9a02c9a9c435c3df7",22906796,1,3,0,73,37,38,1
"fc0e049d56024bc9a02c9a9c435c3df7","fc0e049d56024bc9a02c9a9c435c3df7",22906796,1,0,1,74,38,38,0
"fc0e049d56024bc9a02c9a9c435c3df7","67a089198fcb4e1c8f2385786c2b296f",22906796,1,4,0,75,38,39,1
"67a089198fcb4e1c8f2385786c2b296f","64d48c6c9c7940639a932219a6c87198",22906796,1,1,0,76,39,40,1
"64d48c6c9c7940639a932219a6c87198","64d48c6c9c7940639a932219a6c87198",22906796,4,0,1,77,40,40,0
"64d48c6c9c7940639a932219a6c87198","b534b89233134e30a9b5645138bfa9ee",22906796,1,3,0,81,40,41,1
"b534b89233134e30a9b5645138bfa9ee","67a089198fcb4e1c8f2385786c2b296f",22906796,1,-4,0,82,41,39,-2
"67a089198fcb4e1c8f2385786c2b296f","0e37b720d23b4e7f8b313e79313fd107",22906796,1,7,0,83,39,44,5
"0e37b720d23b4e7f8b313e79313fd107","0e37b720d23b4e7f8b313e79313fd107",22906796,1,0,1,84,44,44,0
"0e37b720d23b4e7f8b313e79313fd107","6875d67fdd5f48168b62719df449bebd",22906796,1,1,0,85,44,45,1
"6875d67fdd5f48168b62719df449bebd","6875d67fdd5f48168b62719df449bebd",22906796,1,0,1,86,45,45,0
"6875d67fdd5f48168b62719df449bebd","b534b89233134e30a9b5645138bfa9ee",22906796,1,-4,0,87,45,41,-4
"b534b89233134e30a9b5645138bfa9ee","6e13d61a7bdb44bca949c9f86fab3be5",22906796,1,7,0,88,41,47,6
"6e13d61a7bdb44bca949c9f86fab3be5","6e13d61a7bdb44bca949c9f86fab3be5",22906796,3,0,1,89,47,47,0
"6e13d61a7bdb44bca949c9f86fab3be5","195f78799f984cc2b06c48dfe36be751",22906796,1,2,0,92,47,49,2
"195f78799f984cc2b06c48dfe36be751","195f78799f984cc2b06c48dfe36be751",22906796,2,0,1,93,49,49,0
"195f78799f984cc2b06c48dfe36be751","d9c8d8c444a64dadbbb508652c721e17",22906796,1,-3,0,95,49,46,-3
"d9c8d8c444a64dadbbb508652c721e17","d0c74f735e024943943e40333d6d337f",22906796,1,6,0,96,46,51,5
"d0c74f735e024943943e40333d6d337f","d0c74f735e024943943e40333d6d337f",22906796,2,0,1,97,51,51,0
"d0c74f735e024943943e40333d6d337f","983f8ff320594b279a7f4a6fe132f9c5",22906796,1,2,0,99,51,53,2
"983f8ff320594b279a7f4a6fe132f9c5","983f8ff320594b279a7f4a6fe132f9c5",22906796,2,0,1,100,53,53,0
"983f8ff320594b279a7f4a6fe132f9c5","35adfa5d923046aebabfefd98f35ff05",22906796,1,1,0,102,53,54,1
"35adfa5d923046aebabfefd98f35ff05","35adfa5d923046aebabfefd98f35ff05",22906796,2,0,1,103,54,54,0
"35adfa5d923046aebabfefd98f35ff05","b6f8a98476224da1b40e555ececc7ed8",22906796,1,1,0,105,54,55,1
"b6f8a98476224da1b40e555ececc7ed8","b6f8a98476224da1b40e555ececc7ed8",22906796,2,0,1,106,55,55,0
"b6f8a98476224da1b40e555ececc7ed8","86e22cb5fe0e4b47a9489ecddf7ed78f",22906796,1,1,0,108,55,56,1
"86e22cb5fe0e4b47a9489ecddf7ed78f","86e22cb5fe0e4b47a9489ecddf7ed78f",22906796,2,0,1,109,56,56,0
"86e22cb5fe0e4b47a9489ecddf7ed78f","f924752d8a1149668870b1e7698486f7",22906796,1,-6,0,111,56,50,-6
"f924752d8a1149668870b1e7698486f7","a1f2f12debe5432fb7a70bcd12bacfb9",22906796,1,9,0,112,50,58,8
"a1f2f12debe5432fb7a70bcd12bacfb9","78f30e4dcac84e3cbea8b2cc6e0d62b3",22906796,2,1,0,113,58,59,1
"78f30e4dcac84e3cbea8b2cc6e0d62b3","a1f2f12debe5432fb7a70bcd12bacfb9",22906796,1,-1,0,114,59,58,-1
"a1f2f12debe5432fb7a70bcd12bacfb9","a1f2f12debe5432fb7a70bcd12bacfb9",22906796,26,0,1,115,58,58,0
"78f30e4dcac84e3cbea8b2cc6e0d62b3","78f30e4dcac84e3cbea8b2cc6e0d62b3",22906796,13,0,1,142,59,59,0
"78f30e4dcac84e3cbea8b2cc6e0d62b3","bc42d26810654ea9a1df1efe1e58c7d5",22906796,1,5,0,155,59,63,4
"bc42d26810654ea9a1df1efe1e58c7d5","12aa6e1672ac4e7aa6449a7a8609cd72",22906796,1,-7,0,156,63,57,-6
"12aa6e1672ac4e7aa6449a7a8609cd72","a0a418b8540d479fa6e0f653b701da8b",22906796,1,8,0,157,57,64,7
"a0a418b8540d479fa6e0f653b701da8b","4c943503763e4e349906eea3ed3c8e86",22906796,1,-3,0,158,64,61,-3
"4c943503763e4e349906eea3ed3c8e86","4c943503763e4e349906eea3ed3c8e86",22906796,1,0,1,159,61,61,0
"4c943503763e4e349906eea3ed3c8e86","bc42d26810654ea9a1df1efe1e58c7d5",22906796,1,2,0,160,61,63,2
"bc42d26810654ea9a1df1efe1e58c7d5","bc42d26810654ea9a1df1efe1e58c7d5",22906796,3,0,1,161,63,63,0
"bc42d26810654ea9a1df1efe1e58c7d5","a0a418b8540d479fa6e0f653b701da8b",22906796,1,1,0,164,63,64,1
"a0a418b8540d479fa6e0f653b701da8b","a0a418b8540d479fa6e0f653b701da8b",22906796,3,0,1,165,64,64,0
"a0a418b8540d479fa6e0f653b701da8b","309ccf3cc4fe429d9bfbaef53d3fa479",22906796,1,-4,0,168,64,60,-4
"309ccf3cc4fe429d9bfbaef53d3fa479","d646286c8051419bbc2e31dd1db55ca8",22906796,1,10,0,169,60,67,7
"d646286c8051419bbc2e31dd1db55ca8","b534b89233134e30a9b5645138bfa9ee",22906796,1,-33,0,170,67,41,-26
"b534b89233134e30a9b5645138bfa9ee","267f883678b24aed855fde42524975d9",22906796,1,37,0,171,41,71,30
"267f883678b24aed855fde42524975d9","267f883678b24aed855fde42524975d9",22906796,1,0,1,172,71,71,0
"267f883678b24aed855fde42524975d9","88fff56d0342490dbef9040750a20f6c",22906796,1,1,0,173,71,72,1
"88fff56d0342490dbef9040750a20f6c","88fff56d0342490dbef9040750a20f6c",22906796,1,0,1,174,72,72,0
"88fff56d0342490dbef9040750a20f6c","adb17b12b66c4a49a85fd34322f7df70",22906796,1,1,0,175,72,73,1
"adb17b12b66c4a49a85fd34322f7df70","adb17b12b66c4a49a85fd34322f7df70",22906796,1,0,1,176,73,73,0
"adb17b12b66c4a49a85fd34322f7df70","a2becd407db34b189200a32546d9d569",22906796,1,3,0,177,73,75,2
"a2becd407db34b189200a32546d9d569","d646286c8051419bbc2e31dd1db55ca8",22906796,1,-9,0,178,75,67,-8
"d646286c8051419bbc2e31dd1db55ca8","a2becd407db34b189200a32546d9d569",22906796,1,9,0,179,67,75,8
"a2becd407db34b189200a32546d9d569","a2becd407db34b189200a32546d9d569",22906796,5,0,1,180,75,75,0
"a2becd407db34b189200a32546d9d569","58c22b011d0f4c2ea6d13615edbb9eeb",22906796,1,2,0,185,75,77,2
"58c22b011d0f4c2ea6d13615edbb9eeb","58c22b011d0f4c2ea6d13615edbb9eeb",22906796,2,0,1,186,77,77,0
"58c22b011d0f4c2ea6d13615edbb9eeb","dd76e1861dc9461c830888729d091ee0",22906796,1,1,0,188,77,78,1
"dd76e1861dc9461c830888729d091ee0","dd76e1861dc9461c830888729d091ee0",22906796,8,0,1,189,78,78,0
"dd76e1861dc9461c830888729d091ee0","cd1d828f1a694b87913a7ea66c23803e",22906796,1,1,0,197,78,79,1
"cd1d828f1a694b87913a7ea66c23803e","cd1d828f1a694b87913a7ea66c23803e",22906796,2,0,1,198,79,79,0
"cd1d828f1a694b87913a7ea66c23803e","9176a3c2b4d2465fa8b0c67096c2a97e",22906796,1,1,0,200,79,80,1
"9176a3c2b4d2465fa8b0c67096c2a97e","9176a3c2b4d2465fa8b0c67096c2a97e",22906796,5,0,1,201,80,80,0
"9176a3c2b4d2465fa8b0c67096c2a97e","f8ec6445f7194e25b9101d4fbcb07a18",22906796,1,1,0,206,80,81,1
"f8ec6445f7194e25b9101d4fbcb07a18","f8ec6445f7194e25b9101d4fbcb07a18",22906796,2,0,1,207,81,81,0
"f8ec6445f7194e25b9101d4fbcb07a18","140d5b27b8574befad82c0a013b59dfa",22906796,1,-7,0,209,81,74,-7
"140d5b27b8574befad82c0a013b59dfa","d18a9ea32855445f8736581f5cb119ce",22906796,1,9,0,210,74,82,8
"d18a9ea32855445f8736581f5cb119ce","f564483cbd7a407681aa2fcca518cf5f",22906796,1,4,0,211,82,85,3
"f564483cbd7a407681aa2fcca518cf5f","f564483cbd7a407681aa2fcca518cf5f",22906796,1,0,1,212,85,85,0
"f564483cbd7a407681aa2fcca518cf5f","18fd01350bd5434ca636d59a599d768a",22906796,1,1,0,213,85,86,1
"18fd01350bd5434ca636d59a599d768a","18fd01350bd5434ca636d59a599d768a",22906796,8,0,1,214,86,86,0
"18fd01350bd5434ca636d59a599d768a","ae5ac430ea254e708a6f5deaaf7464ae",22906796,1,-2,0,222,86,84,-2
"ae5ac430ea254e708a6f5deaaf7464ae","6a9f0ef185fb47f0937e29daa1c71ed5",22906796,1,7,0,223,84,90,6
"6a9f0ef185fb47f0937e29daa1c71ed5","c681290961c94c4caf23b529d1ae6b9a",22906796,1,-2,0,224,90,88,-2
"c681290961c94c4caf23b529d1ae6b9a","c681290961c94c4caf23b529d1ae6b9a",22906796,1,0,1,225,88,88,0
"c681290961c94c4caf23b529d1ae6b9a","6a9f0ef185fb47f0937e29daa1c71ed5",22906796,1,2,0,226,88,90,2
"6a9f0ef185fb47f0937e29daa1c71ed5","6a9f0ef185fb47f0937e29daa1c71ed5",22906796,3,0,1,227,90,90,0
"6a9f0ef185fb47f0937e29daa1c71ed5","d646286c8051419bbc2e31dd1db55ca8",22906796,1,-27,0,230,90,67,-23
"d646286c8051419bbc2e31dd1db55ca8","e20db35ced8544ddac5bc3839145e463",22906796,1,30,0,231,67,91,24
"e20db35ced8544ddac5bc3839145e463","1febb706d7a34005ae8711ed49c76e64",22906796,1,3,0,232,91,94,3
"1febb706d7a34005ae8711ed49c76e64","1febb706d7a34005ae8711ed49c76e64",22906796,2,0,1,233,94,94,0
"1febb706d7a34005ae8711ed49c76e64","8f73ba6f5a0042f2850356ac38ac6f24",22906796,1,1,0,235,94,95,1
"8f73ba6f5a0042f2850356ac38ac6f24","8f73ba6f5a0042f2850356ac38ac6f24",22906796,5,0,1,236,95,95,0
"8f73ba6f5a0042f2850356ac38ac6f24","e2260b86653c46d7b14a41fb419dbf8c",22906796,1,1,0,241,95,96,1
"e2260b86653c46d7b14a41fb419dbf8c","e2260b86653c46d7b14a41fb419dbf8c",22906796,2,0,1,242,96,96,0
"e2260b86653c46d7b14a41fb419dbf8c","35eb641ad1d845bbba54915bce75a962",22906796,1,1,0,244,96,97,1
"35eb641ad1d845bbba54915bce75a962","35eb641ad1d845bbba54915bce75a962",22906796,2,0,1,245,97,97,0
"35eb641ad1d845bbba54915bce75a962","08be90ffbeea4795a138cd42ed8db56f",22906796,1,1,0,247,97,98,1
"08be90ffbeea4795a138cd42ed8db56f","08be90ffbeea4795a138cd42ed8db56f",22906796,5,0,1,248,98,98,0
"08be90ffbeea4795a138cd42ed8db56f","3007433c8f584dcbb5ac159c1c5f2be3",22906796,1,1,0,253,98,99,1
"3007433c8f584dcbb5ac159c1c5f2be3","3007433c8f584dcbb5ac159c1c5f2be3",22906796,5,0,1,254,99,99,0
"3007433c8f584dcbb5ac159c1c5f2be3","e20db35ced8544ddac5bc3839145e463",22906796,1,-8,0,259,99,91,-8
"e20db35ced8544ddac5bc3839145e463","d391c8b6e56a43a7b654e9dee02d904b",22906796,1,13,0,260,91,103,12
"d391c8b6e56a43a7b654e9dee02d904b","00ae5f0c51874a73a41ebea838d95682",22906796,1,-2,0,261,103,101,-2
"00ae5f0c51874a73a41ebea838d95682","00ae5f0c51874a73a41ebea838d95682",22906796,1,0,1,262,101,101,0
"00ae5f0c51874a73a41ebea838d95682","d391c8b6e56a43a7b654e9dee02d904b",22906796,1,2,0,263,101,103,2
"d391c8b6e56a43a7b654e9dee02d904b","d391c8b6e56a43a7b654e9dee02d904b",22906796,18,0,1,264,103,103,0
"d391c8b6e56a43a7b654e9dee02d904b","6111116566fc4fd9abba409322bea245",22906796,1,1,0,282,103,104,1
"6111116566fc4fd9abba409322bea245","6111116566fc4fd9abba409322bea245",22906796,5,0,1,283,104,104,0
"6111116566fc4fd9abba409322bea245","a81b2235cb9c499eb9ea8ee0a8dd9725",22906796,1,1,0,288,104,105,1
"a81b2235cb9c499eb9ea8ee0a8dd9725","a81b2235cb9c499eb9ea8ee0a8dd9725",22906796,5,0,1,289,105,105,0
"a81b2235cb9c499eb9ea8ee0a8dd9725","2d4e0ab0ef3b4d73b82c72d4621a7579",22906796,1,1,0,294,105,106,1
"2d4e0ab0ef3b4d73b82c72d4621a7579","2d4e0ab0ef3b4d73b82c72d4621a7579",22906796,2,0,1,295,106,106,0
"2d4e0ab0ef3b4d73b82c72d4621a7579","8bdebf492ebd4e62b0d522e8ab5e5197",22906796,1,1,0,297,106,107,1
"8bdebf492ebd4e62b0d522e8ab5e5197","8bdebf492ebd4e62b0d522e8ab5e5197",22906796,2,0,1,298,107,107,0
"8bdebf492ebd4e62b0d522e8ab5e5197","73039f8c1eb9409cb4caee2cf968001e",22906796,1,-7,0,300,107,100,-7
"73039f8c1eb9409cb4caee2cf968001e","4280927ec4d643238aa49c32f9e06c6c",22906796,1,10,0,301,100,109,9
"4280927ec4d643238aa49c32f9e06c6c","4280927ec4d643238aa49c32f9e06c6c",22906796,1,0,1,302,109,109,0
"4280927ec4d643238aa49c32f9e06c6c","fc44e6a5f7654430af1227838224dceb",22906796,1,2,0,303,109,111,2
"fc44e6a5f7654430af1227838224dceb","fc44e6a5f7654430af1227838224dceb",22906796,2,0,1,304,111,111,0
"fc44e6a5f7654430af1227838224dceb","08111f75e22d409998cf8b85bd431f0a",22906796,1,-3,0,306,111,108,-3
"08111f75e22d409998cf8b85bd431f0a","a9ae0a3c070d455bb4369a8996313336",22906796,1,7,0,307,108,114,6
"a9ae0a3c070d455bb4369a8996313336","a9ae0a3c070d455bb4369a8996313336",22906796,1,0,1,308,114,114,0
"a9ae0a3c070d455bb4369a8996313336","e20db35ced8544ddac5bc3839145e463",22906796,1,-26,0,309,114,91,-23
"e20db35ced8544ddac5bc3839145e463","e20db35ced8544ddac5bc3839145e463",22906796,1,0,1,310,91,91,0
"e20db35ced8544ddac5bc3839145e463","a9ae0a3c070d455bb4369a8996313336",22906796,1,26,0,311,91,114,23
"a9ae0a3c070d455bb4369a8996313336","71cec822bcff4f30a20e75dc63ef7b65",22906796,1,2,0,312,114,116,2
"71cec822bcff4f30a20e75dc63ef7b65","71cec822bcff4f30a20e75dc63ef7b65",22906796,1,0,1,313,116,116,0
"71cec822bcff4f30a20e75dc63ef7b65","62bff51286ef4f348717a3cf6fe2318f",22906796,1,5,0,314,116,120,4
"62bff51286ef4f348717a3cf6fe2318f","37319e88176d4aefa91d7a9980dbae91",22906796,1,-9,0,315,120,112,-8
"37319e88176d4aefa91d7a9980dbae91","b1cd0e7dc3ad4a8eb91a4bfdbeb025b0",22906796,1,7,0,316,112,118,6
"b1cd0e7dc3ad4a8eb91a4bfdbeb025b0","b1cd0e7dc3ad4a8eb91a4bfdbeb025b0",22906796,1,0,1,317,118,118,0
"b1cd0e7dc3ad4a8eb91a4bfdbeb025b0","62bff51286ef4f348717a3cf6fe2318f",22906796,1,2,0,318,118,120,2
"62bff51286ef4f348717a3cf6fe2318f","62bff51286ef4f348717a3cf6fe2318f",22906796,3,0,1,319,120,120,0
"62bff51286ef4f348717a3cf6fe2318f","779f9ddd1fd14d1e9e69f72219a1fdbd",22906796,1,3,0,322,120,121,1
"779f9ddd1fd14d1e9e69f72219a1fdbd","e20db35ced8544ddac5bc3839145e463",22906796,1,-36,0,323,121,91,-30
"e20db35ced8544ddac5bc3839145e463","ae26e6cda8ad4a3f81bd347560d9579f",22906796,1,40,0,324,91,125,34
"ae26e6cda8ad4a3f81bd347560d9579f","ae26e6cda8ad4a3f81bd347560d9579f",22906796,3,0,1,325,125,125,0
"ae26e6cda8ad4a3f81bd347560d9579f","ee48df95832b4374aa273ceb27ec1315",22906796,1,1,0,328,125,126,1
"ee48df95832b4374aa273ceb27ec1315","ee48df95832b4374aa273ceb27ec1315",22906796,1,0,1,329,126,126,0
"ee48df95832b4374aa273ceb27ec1315","7a439da90b394756ad1777fc4c6dead5",22906796,1,1,0,330,126,127,1
"7a439da90b394756ad1777fc4c6dead5","7a439da90b394756ad1777fc4c6dead5",22906796,1,0,1,331,127,127,0
"7a439da90b394756ad1777fc4c6dead5","a8dd5213034441ac92724b4e83eb0bb2",22906796,1,3,0,332,127,129,2
"a8dd5213034441ac92724b4e83eb0bb2","779f9ddd1fd14d1e9e69f72219a1fdbd",22906796,1,-9,0,333,129,121,-8
"b613861cecf84ffcab01afb23f660475","b613861cecf84ffcab01afb23f660475",22909863,4,0,1,1,1,1,0
"b613861cecf84ffcab01afb23f660475","e2911e79efc2420eac45d9f671463d4b",22909863,1,3,0,5,1,2,1
"e2911e79efc2420eac45d9f671463d4b","e2911e79efc2420eac45d9f671463d4b",22909863,2,0,1,6,2,2,0
"e2911e79efc2420eac45d9f671463d4b","519d1b8c59404d67b54e96c5c8a830b2",22909863,1,1,0,8,2,3,1
"519d1b8c59404d67b54e96c5c8a830b2","519d1b8c59404d67b54e96c5c8a830b2",22909863,1,0,1,9,3,3,0
"519d1b8c59404d67b54e96c5c8a830b2","531db53f81f646edb0cdcfe0085b03b7",22909863,1,1,0,10,3,4,1
"531db53f81f646edb0cdcfe0085b03b7","531db53f81f646edb0cdcfe0085b03b7",22909863,1,0,1,11,4,4,0
"531db53f81f646edb0cdcfe0085b03b7","4f5f94b2f95141e0a9d53a61da2276da",22909863,1,1,0,12,4,5,1
"4f5f94b2f95141e0a9d53a61da2276da","4f5f94b2f95141e0a9d53a61da2276da",22909863,1,0,1,13,5,5,0
"4f5f94b2f95141e0a9d53a61da2276da","6d541c89590949f99af293c4f2333f67",22909863,1,1,0,14,5,6,1
"6d541c89590949f99af293c4f2333f67","6d541c89590949f99af293c4f2333f67",22909863,1,0,1,15,6,6,0
"6d541c89590949f99af293c4f2333f67","dd5cf0b9fe4c4f1d8f5ff8e4c04879cb",22909863,1,1,0,16,6,7,1
"dd5cf0b9fe4c4f1d8f5ff8e4c04879cb","dd5cf0b9fe4c4f1d8f5ff8e4c04879cb",22909863,1,0,1,17,7,7,0
"dd5cf0b9fe4c4f1d8f5ff8e4c04879cb","f96261861edc426abe2248be4f0a709a",22909863,1,1,0,18,7,8,1
"f96261861edc426abe2248be4f0a709a","f96261861edc426abe2248be4f0a709a",22909863,1,0,1,19,8,8,0
"f96261861edc426abe2248be4f0a709a","66b5e16f4f75454fb5b8172079f0fa83",22909863,1,1,0,20,8,9,1
"66b5e16f4f75454fb5b8172079f0fa83","66b5e16f4f75454fb5b8172079f0fa83",22909863,1,0,1,21,9,9,0
"66b5e16f4f75454fb5b8172079f0fa83","0680571d4698477995e41842c36a54b2",22909863,1,1,0,22,9,10,1
"0680571d4698477995e41842c36a54b2","0680571d4698477995e41842c36a54b2",22909863,1,0,1,23,10,10,0
"0680571d4698477995e41842c36a54b2","9112f2bffece48e08c6d2287be204085",22909863,1,1,0,24,10,11,1
"9112f2bffece48e08c6d2287be204085","9112f2bffece48e08c6d2287be204085",22909863,1,0,1,25,11,11,0
"9112f2bffece48e08c6d2287be204085","e2911e79efc2420eac45d9f671463d4b",22909863,2,-9,0,26,11,2,-9
"e2911e79efc2420eac45d9f671463d4b","56586aa865414f538729c7f7735d2bc6",22909863,2,12,0,27,2,12,10
"56586aa865414f538729c7f7735d2bc6","56586aa865414f538729c7f7735d2bc6",22909863,3,0,1,28,12,12,0
"56586aa865414f538729c7f7735d2bc6","e2911e79efc2420eac45d9f671463d4b",22909863,1,-12,0,29,12,2,-10
"e2911e79efc2420eac45d9f671463d4b","9112f2bffece48e08c6d2287be204085",22909863,1,9,0,30,2,11,9
"56586aa865414f538729c7f7735d2bc6","b7f2b31585d94eb3bf86376714aa7070",22909863,2,2,0,35,12,13,1
"b7f2b31585d94eb3bf86376714aa7070","56586aa865414f538729c7f7735d2bc6",22909863,1,-2,0,36,13,12,-1
"b7f2b31585d94eb3bf86376714aa7070","b7f2b31585d94eb3bf86376714aa7070",22909863,1,0,1,38,13,13,0
"b7f2b31585d94eb3bf86376714aa7070","3f1c815879794b929260d224becaff7e",22909863,1,2,0,39,13,14,1
"3f1c815879794b929260d224becaff7e","81c864a886d54a6b8ff85f7d736f4f95",22909863,1,2,0,40,14,15,1
"81c864a886d54a6b8ff85f7d736f4f95","5c5ceeee4562457ba6d41515aeebfbb1",22909863,1,4,0,41,15,17,2
"5c5ceeee4562457ba6d41515aeebfbb1","5c5ceeee4562457ba6d41515aeebfbb1",22909863,1,0,1,42,17,17,0
"5c5ceeee4562457ba6d41515aeebfbb1","9afd71a5298d4333b6849dfce1b9422c",22909863,1,3,0,43,17,18,1
"9afd71a5298d4333b6849dfce1b9422c","56586aa865414f538729c7f7735d2bc6",22909863,1,-13,0,44,18,12,-6
"56586aa865414f538729c7f7735d2bc6","9afd71a5298d4333b6849dfce1b9422c",22909863,1,13,0,45,12,18,6
"9afd71a5298d4333b6849dfce1b9422c","9afd71a5298d4333b6849dfce1b9422c",22909863,1,0,1,46,18,18,0
"9afd71a5298d4333b6849dfce1b9422c","b7719e26494940efa49512aedd0aac79",22909863,1,4,0,47,18,20,2
"b7719e26494940efa49512aedd0aac79","9afd71a5298d4333b6849dfce1b9422c",22909863,1,-4,0,48,20,18,-2
"9afd71a5298d4333b6849dfce1b9422c","d4f45188d3c84a02ba08454e6403a818",22909863,1,9,0,49,18,24,6
"d4f45188d3c84a02ba08454e6403a818","d4c3b003e8274e429d2fa688d73fde6d",22909863,1,-2,0,50,24,22,-2
"d4c3b003e8274e429d2fa688d73fde6d","d4c3b003e8274e429d2fa688d73fde6d",22909863,2,0,1,51,22,22,0
"d4c3b003e8274e429d2fa688d73fde6d","b7719e26494940efa49512aedd0aac79",22909863,2,-3,0,52,22,20,-2
"b7719e26494940efa49512aedd0aac79","d4f45188d3c84a02ba08454e6403a818",22909863,1,5,0,53,20,24,4
"d4f45188d3c84a02ba08454e6403a818","a49d1bb4328949299686242fd0be5584",22909863,1,-3,0,54,24,21,-3
"a49d1bb4328949299686242fd0be5584","d4c3b003e8274e429d2fa688d73fde6d",22909863,1,1,0,55,21,22,1
"b7719e26494940efa49512aedd0aac79","b7719e26494940efa49512aedd0aac79",22909863,2,0,1,58,20,20,0
"b7719e26494940efa49512aedd0aac79","afbf7250b99d47bea07172749483ca97",22909863,2,12,0,59,20,28,8
"afbf7250b99d47bea07172749483ca97","afbf7250b99d47bea07172749483ca97",22909863,2,0,1,60,28,28,0
"afbf7250b99d47bea07172749483ca97","4e51676dc72045d99c19b9fa7b22f8bc",22909863,2,3,0,61,28,29,1
"4e51676dc72045d99c19b9fa7b22f8bc","4e51676dc72045d99c19b9fa7b22f8bc",22909863,1,0,1,62,29,29,0
"4e51676dc72045d99c19b9fa7b22f8bc","51970cfa30e643e894e66ae85c8024cc",22909863,1,3,0,63,29,31,2
"51970cfa30e643e894e66ae85c8024cc","4e51676dc72045d99c19b9fa7b22f8bc",22909863,1,-3,0,64,31,29,-2
"4e51676dc72045d99c19b9fa7b22f8bc","c33c17be71ae4d588da7369472e5bb1b",22909863,1,9,0,65,29,34,5
"c33c17be71ae4d588da7369472e5bb1b","c33c17be71ae4d588da7369472e5bb1b",22909863,1,0,1,66,34,34,0
"c33c17be71ae4d588da7369472e5bb1b","93679be414554a11b1893002f2229a93",22909863,1,3,0,67,34,35,1
"93679be414554a11b1893002f2229a93","7040a13096d746ac84b8fac8d9752058",22909863,2,3,0,68,35,36,1
"7040a13096d746ac84b8fac8d9752058","93679be414554a11b1893002f2229a93",22909863,1,-3,0,69,36,35,-1
"7040a13096d746ac84b8fac8d9752058","9a0dc646f934470daf08c4b56ccf73db",22909863,1,3,0,71,36,37,1
"9a0dc646f934470daf08c4b56ccf73db","9a0dc646f934470daf08c4b56ccf73db",22909863,1,0,1,72,37,37,0
"9a0dc646f934470daf08c4b56ccf73db","fc0e049d56024bc9a02c9a9c435c3df7",22909863,1,3,0,73,37,38,1
"fc0e049d56024bc9a02c9a9c435c3df7","67a089198fcb4e1c8f2385786c2b296f",22909863,1,4,0,74,38,39,1
"67a089198fcb4e1c8f2385786c2b296f","fc0e049d56024bc9a02c9a9c435c3df7",22909863,1,-4,0,75,39,38,-1
"fc0e049d56024bc9a02c9a9c435c3df7","64d48c6c9c7940639a932219a6c87198",22909863,1,5,0,76,38,40,2
"64d48c6c9c7940639a932219a6c87198","64d48c6c9c7940639a932219a6c87198",22909863,1,0,1,77,40,40,0
"64d48c6c9c7940639a932219a6c87198","b534b89233134e30a9b5645138bfa9ee",22909863,1,3,0,78,40,41,1
"b534b89233134e30a9b5645138bfa9ee","67a089198fcb4e1c8f2385786c2b296f",22909863,1,-4,0,79,41,39,-2
"67a089198fcb4e1c8f2385786c2b296f","b534b89233134e30a9b5645138bfa9ee",22909863,1,4,0,80,39,41,2
"b534b89233134e30a9b5645138bfa9ee","b7719e26494940efa49512aedd0aac79",22909863,1,-44,0,81,41,20,-21
"4e51676dc72045d99c19b9fa7b22f8bc","b534b89233134e30a9b5645138bfa9ee",22909863,1,29,0,86,29,41,12
"b534b89233134e30a9b5645138bfa9ee","fc5d3a81023c41d8ab70b19d4c5c50eb",22909863,1,1,0,87,41,42,1
"fc5d3a81023c41d8ab70b19d4c5c50eb","0e37b720d23b4e7f8b313e79313fd107",22909863,1,2,0,88,42,44,2
"0e37b720d23b4e7f8b313e79313fd107","0e37b720d23b4e7f8b313e79313fd107",22909863,1,0,1,89,44,44,0
"0e37b720d23b4e7f8b313e79313fd107","6875d67fdd5f48168b62719df449bebd",22909863,1,1,0,90,44,45,1
"6875d67fdd5f48168b62719df449bebd","6875d67fdd5f48168b62719df449bebd",22909863,1,0,1,91,45,45,0
"6875d67fdd5f48168b62719df449bebd","b534b89233134e30a9b5645138bfa9ee",22909863,1,-4,0,92,45,41,-4
"b534b89233134e30a9b5645138bfa9ee","6e13d61a7bdb44bca949c9f86fab3be5",22909863,1,7,0,93,41,47,6
"6e13d61a7bdb44bca949c9f86fab3be5","6e13d61a7bdb44bca949c9f86fab3be5",22909863,1,0,1,94,47,47,0
"6e13d61a7bdb44bca949c9f86fab3be5","195f78799f984cc2b06c48dfe36be751",22909863,1,2,0,95,47,49,2
"195f78799f984cc2b06c48dfe36be751","195f78799f984cc2b06c48dfe36be751",22909863,2,0,1,96,49,49,0
"195f78799f984cc2b06c48dfe36be751","d0c74f735e024943943e40333d6d337f",22909863,1,3,0,98,49,51,2
"d0c74f735e024943943e40333d6d337f","d9c8d8c444a64dadbbb508652c721e17",22909863,1,-6,0,99,51,46,-5
"d9c8d8c444a64dadbbb508652c721e17","d0c74f735e024943943e40333d6d337f",22909863,1,6,0,100,46,51,5
"d0c74f735e024943943e40333d6d337f","983f8ff320594b279a7f4a6fe132f9c5",22909863,1,2,0,101,51,53,2
"983f8ff320594b279a7f4a6fe132f9c5","983f8ff320594b279a7f4a6fe132f9c5",22909863,2,0,1,102,53,53,0
"983f8ff320594b279a7f4a6fe132f9c5","35adfa5d923046aebabfefd98f35ff05",22909863,1,1,0,104,53,54,1
"35adfa5d923046aebabfefd98f35ff05","35adfa5d923046aebabfefd98f35ff05",22909863,2,0,1,105,54,54,0
"35adfa5d923046aebabfefd98f35ff05","b6f8a98476224da1b40e555ececc7ed8",22909863,1,1,0,107,54,55,1
"b6f8a98476224da1b40e555ececc7ed8","b6f8a98476224da1b40e555ececc7ed8",22909863,2,0,1,108,55,55,0
"b6f8a98476224da1b40e555ececc7ed8","86e22cb5fe0e4b47a9489ecddf7ed78f",22909863,1,1,0,110,55,56,1
"86e22cb5fe0e4b47a9489ecddf7ed78f","86e22cb5fe0e4b47a9489ecddf7ed78f",22909863,2,0,1,111,56,56,0
"86e22cb5fe0e4b47a9489ecddf7ed78f","f924752d8a1149668870b1e7698486f7",22909863,1,-6,0,113,56,50,-6
"f924752d8a1149668870b1e7698486f7","a1f2f12debe5432fb7a70bcd12bacfb9",22909863,1,9,0,114,50,58,8
"a1f2f12debe5432fb7a70bcd12bacfb9","78f30e4dcac84e3cbea8b2cc6e0d62b3",22909863,2,1,0,115,58,59,1
"78f30e4dcac84e3cbea8b2cc6e0d62b3","a1f2f12debe5432fb7a70bcd12bacfb9",22909863,1,-1,0,116,59,58,-1
"a1f2f12debe5432fb7a70bcd12bacfb9","a1f2f12debe5432fb7a70bcd12bacfb9",22909863,13,0,1,117,58,58,0
"78f30e4dcac84e3cbea8b2cc6e0d62b3","78f30e4dcac84e3cbea8b2cc6e0d62b3",22909863,11,0,1,131,59,59,0
"78f30e4dcac84e3cbea8b2cc6e0d62b3","bc42d26810654ea9a1df1efe1e58c7d5",22909863,1,5,0,142,59,63,4
"bc42d26810654ea9a1df1efe1e58c7d5","12aa6e1672ac4e7aa6449a7a8609cd72",22909863,1,-7,0,143,63,57,-6
"12aa6e1672ac4e7aa6449a7a8609cd72","a0a418b8540d479fa6e0f653b701da8b",22909863,1,8,0,144,57,64,7
"a0a418b8540d479fa6e0f653b701da8b","4c943503763e4e349906eea3ed3c8e86",22909863,1,-3,0,145,64,61,-3
"4c943503763e4e349906eea3ed3c8e86","4c943503763e4e349906eea3ed3c8e86",22909863,1,0,1,146,61,61,0
"4c943503763e4e349906eea3ed3c8e86","309ccf3cc4fe429d9bfbaef53d3fa479",22909863,1,-1,0,147,61,60,-1
"309ccf3cc4fe429d9bfbaef53d3fa479","d646286c8051419bbc2e31dd1db55ca8",22909863,1,10,0,148,60,67,7
"d646286c8051419bbc2e31dd1db55ca8","b534b89233134e30a9b5645138bfa9ee",22909863,1,-33,0,149,67,41,-26
"b534b89233134e30a9b5645138bfa9ee","267f883678b24aed855fde42524975d9",22909863,1,37,0,150,41,71,30
"267f883678b24aed855fde42524975d9","267f883678b24aed855fde42524975d9",22909863,1,0,1,151,71,71,0
"267f883678b24aed855fde42524975d9","88fff56d0342490dbef9040750a20f6c",22909863,1,1,0,152,71,72,1
"88fff56d0342490dbef9040750a20f6c","88fff56d0342490dbef9040750a20f6c",22909863,1,0,1,153,72,72,0
"88fff56d0342490dbef9040750a20f6c","adb17b12b66c4a49a85fd34322f7df70",22909863,1,1,0,154,72,73,1
"adb17b12b66c4a49a85fd34322f7df70","adb17b12b66c4a49a85fd34322f7df70",22909863,1,0,1,155,73,73,0
"adb17b12b66c4a49a85fd34322f7df70","a2becd407db34b189200a32546d9d569",22909863,1,3,0,156,73,75,2
"a2becd407db34b189200a32546d9d569","d646286c8051419bbc2e31dd1db55ca8",22909863,1,-9,0,157,75,67,-8
"d646286c8051419bbc2e31dd1db55ca8","a2becd407db34b189200a32546d9d569",22909863,1,9,0,158,67,75,8
"a2becd407db34b189200a32546d9d569","a2becd407db34b189200a32546d9d569",22909863,2,0,1,159,75,75,0
"a2becd407db34b189200a32546d9d569","58c22b011d0f4c2ea6d13615edbb9eeb",22909863,1,2,0,161,75,77,2
"58c22b011d0f4c2ea6d13615edbb9eeb","58c22b011d0f4c2ea6d13615edbb9eeb",22909863,2,0,1,162,77,77,0
"58c22b011d0f4c2ea6d13615edbb9eeb","dd76e1861dc9461c830888729d091ee0",22909863,1,1,0,164,77,78,1
"dd76e1861dc9461c830888729d091ee0","dd76e1861dc9461c830888729d091ee0",22909863,5,0,1,165,78,78,0
"dd76e1861dc9461c830888729d091ee0","cd1d828f1a694b87913a7ea66c23803e",22909863,1,1,0,170,78,79,1
"cd1d828f1a694b87913a7ea66c23803e","cd1d828f1a694b87913a7ea66c23803e",22909863,2,0,1,171,79,79,0
"cd1d828f1a694b87913a7ea66c23803e","9176a3c2b4d2465fa8b0c67096c2a97e",22909863,1,1,0,173,79,80,1
"9176a3c2b4d2465fa8b0c67096c2a97e","9176a3c2b4d2465fa8b0c67096c2a97e",22909863,5,0,1,174,80,80,0
"9176a3c2b4d2465fa8b0c67096c2a97e","f8ec6445f7194e25b9101d4fbcb07a18",22909863,1,1,0,179,80,81,1
"f8ec6445f7194e25b9101d4fbcb07a18","f8ec6445f7194e25b9101d4fbcb07a18",22909863,2,0,1,180,81,81,0
"f8ec6445f7194e25b9101d4fbcb07a18","140d5b27b8574befad82c0a013b59dfa",22909863,1,-7,0,182,81,74,-7
"140d5b27b8574befad82c0a013b59dfa","d18a9ea32855445f8736581f5cb119ce",22909863,2,9,0,183,74,82,8
"d18a9ea32855445f8736581f5cb119ce","a2becd407db34b189200a32546d9d569",22909863,1,-8,0,184,82,75,-7
"a2becd407db34b189200a32546d9d569","140d5b27b8574befad82c0a013b59dfa",22909863,1,-1,0,185,75,74,-1
"d18a9ea32855445f8736581f5cb119ce","f564483cbd7a407681aa2fcca518cf5f",22909863,1,4,0,187,82,85,3
"f564483cbd7a407681aa2fcca518cf5f","f564483cbd7a407681aa2fcca518cf5f",22909863,1,0,1,188,85,85,0
"f564483cbd7a407681aa2fcca518cf5f","18fd01350bd5434ca636d59a599d768a",22909863,1,1,0,189,85,86,1
"18fd01350bd5434ca636d59a599d768a","18fd01350bd5434ca636d59a599d768a",22909863,8,0,1,190,86,86,0
"18fd01350bd5434ca636d59a599d768a","ae5ac430ea254e708a6f5deaaf7464ae",22909863,1,-2,0,198,86,84,-2
"ae5ac430ea254e708a6f5deaaf7464ae","6a9f0ef185fb47f0937e29daa1c71ed5",22909863,1,7,0,199,84,90,6
"6a9f0ef185fb47f0937e29daa1c71ed5","c681290961c94c4caf23b529d1ae6b9a",22909863,1,-2,0,200,90,88,-2
"c681290961c94c4caf23b529d1ae6b9a","c681290961c94c4caf23b529d1ae6b9a",22909863,1,0,1,201,88,88,0
"c681290961c94c4caf23b529d1ae6b9a","6a9f0ef185fb47f0937e29daa1c71ed5",22909863,1,2,0,202,88,90,2
"6a9f0ef185fb47f0937e29daa1c71ed5","6a9f0ef185fb47f0937e29daa1c71ed5",22909863,3,0,1,203,90,90,0
"6a9f0ef185fb47f0937e29daa1c71ed5","d646286c8051419bbc2e31dd1db55ca8",22909863,1,-27,0,206,90,67,-23
"d646286c8051419bbc2e31dd1db55ca8","e20db35ced8544ddac5bc3839145e463",22909863,1,30,0,207,67,91,24
"e20db35ced8544ddac5bc3839145e463","1febb706d7a34005ae8711ed49c76e64",22909863,1,3,0,208,91,94,3
"1febb706d7a34005ae8711ed49c76e64","1febb706d7a34005ae8711ed49c76e64",22909863,2,0,1,209,94,94,0
"1febb706d7a34005ae8711ed49c76e64","8f73ba6f5a0042f2850356ac38ac6f24",22909863,1,1,0,211,94,95,1
"8f73ba6f5a0042f2850356ac38ac6f24","8f73ba6f5a0042f2850356ac38ac6f24",22909863,5,0,1,212,95,95,0
"8f73ba6f5a0042f2850356ac38ac6f24","e2260b86653c46d7b14a41fb419dbf8c",22909863,1,1,0,217,95,96,1
"e2260b86653c46d7b14a41fb419dbf8c","e2260b86653c46d7b14a41fb419dbf8c",22909863,2,0,1,218,96,96,0
"e2260b86653c46d7b14a41fb419dbf8c","35eb641ad1d845bbba54915bce75a962",22909863,1,1,0,220,96,97,1
"35eb641ad1d845bbba54915bce75a962","35eb641ad1d845bbba54915bce75a962",22909863,5,0,1,221,97,97,0
"35eb641ad1d845bbba54915bce75a962","08be90ffbeea4795a138cd42ed8db56f",22909863,1,1,0,226,97,98,1
"08be90ffbeea4795a138cd42ed8db56f","08be90ffbeea4795a138cd42ed8db56f",22909863,2,0,1,227,98,98,0
"08be90ffbeea4795a138cd42ed8db56f","3007433c8f584dcbb5ac159c1c5f2be3",22909863,1,1,0,229,98,99,1
"3007433c8f584dcbb5ac159c1c5f2be3","3007433c8f584dcbb5ac159c1c5f2be3",22909863,5,0,1,230,99,99,0
"3007433c8f584dcbb5ac159c1c5f2be3","e20db35ced8544ddac5bc3839145e463",22909863,1,-8,0,235,99,91,-8
"e20db35ced8544ddac5bc3839145e463","00ae5f0c51874a73a41ebea838d95682",22909863,1,11,0,236,91,101,10
"00ae5f0c51874a73a41ebea838d95682","d391c8b6e56a43a7b654e9dee02d904b",22909863,2,2,0,237,101,103,2
"d391c8b6e56a43a7b654e9dee02d904b","00ae5f0c51874a73a41ebea838d95682",22909863,1,-2,0,238,103,101,-2
"d391c8b6e56a43a7b654e9dee02d904b","d391c8b6e56a43a7b654e9dee02d904b",22909863,15,0,1,240,103,103,0
"d391c8b6e56a43a7b654e9dee02d904b","6111116566fc4fd9abba409322bea245",22909863,1,1,0,255,103,104,1
"6111116566fc4fd9abba409322bea245","6111116566fc4fd9abba409322bea245",22909863,2,0,1,256,104,104,0
"6111116566fc4fd9abba409322bea245","a81b2235cb9c499eb9ea8ee0a8dd9725",22909863,1,1,0,258,104,105,1
"a81b2235cb9c499eb9ea8ee0a8dd9725","a81b2235cb9c499eb9ea8ee0a8dd9725",22909863,5,0,1,259,105,105,0
"a81b2235cb9c499eb9ea8ee0a8dd9725","2d4e0ab0ef3b4d73b82c72d4621a7579",22909863,1,1,0,264,105,106,1
"2d4e0ab0ef3b4d73b82c72d4621a7579","2d4e0ab0ef3b4d73b82c72d4621a7579",22909863,2,0,1,265,106,106,0
"2d4e0ab0ef3b4d73b82c72d4621a7579","8bdebf492ebd4e62b0d522e8ab5e5197",22909863,1,1,0,267,106,107,1
"8bdebf492ebd4e62b0d522e8ab5e5197","8bdebf492ebd4e62b0d522e8ab5e5197",22909863,2,0,1,268,107,107,0
"8bdebf492ebd4e62b0d522e8ab5e5197","73039f8c1eb9409cb4caee2cf968001e",22909863,1,-7,0,270,107,100,-7
"73039f8c1eb9409cb4caee2cf968001e","4280927ec4d643238aa49c32f9e06c6c",22909863,1,10,0,271,100,109,9
"4280927ec4d643238aa49c32f9e06c6c","4280927ec4d643238aa49c32f9e06c6c",22909863,1,0,1,272,109,109,0
"4280927ec4d643238aa49c32f9e06c6c","fc44e6a5f7654430af1227838224dceb",22909863,1,2,0,273,109,111,2
"fc44e6a5f7654430af1227838224dceb","fc44e6a5f7654430af1227838224dceb",22909863,2,0,1,274,111,111,0
"fc44e6a5f7654430af1227838224dceb","08111f75e22d409998cf8b85bd431f0a",22909863,1,-3,0,276,111,108,-3
"08111f75e22d409998cf8b85bd431f0a","a9ae0a3c070d455bb4369a8996313336",22909863,1,7,0,277,108,114,6
"a9ae0a3c070d455bb4369a8996313336","a9ae0a3c070d455bb4369a8996313336",22909863,1,0,1,278,114,114,0
"a9ae0a3c070d455bb4369a8996313336","71cec822bcff4f30a20e75dc63ef7b65",22909863,1,2,0,279,114,116,2
"71cec822bcff4f30a20e75dc63ef7b65","71cec822bcff4f30a20e75dc63ef7b65",22909863,3,0,1,280,116,116,0
"71cec822bcff4f30a20e75dc63ef7b65","37319e88176d4aefa91d7a9980dbae91",22909863,1,-4,0,283,116,112,-4
"37319e88176d4aefa91d7a9980dbae91","62bff51286ef4f348717a3cf6fe2318f",22909863,1,9,0,284,112,120,8
"62bff51286ef4f348717a3cf6fe2318f","b1cd0e7dc3ad4a8eb91a4bfdbeb025b0",22909863,1,-2,0,285,120,118,-2
"b1cd0e7dc3ad4a8eb91a4bfdbeb025b0","b1cd0e7dc3ad4a8eb91a4bfdbeb025b0",22909863,1,0,1,286,118,118,0
"b1cd0e7dc3ad4a8eb91a4bfdbeb025b0","62bff51286ef4f348717a3cf6fe2318f",22909863,1,2,0,287,118,120,2
"62bff51286ef4f348717a3cf6fe2318f","62bff51286ef4f348717a3cf6fe2318f",22909863,3,0,1,288,120,120,0
"62bff51286ef4f348717a3cf6fe2318f","779f9ddd1fd14d1e9e69f72219a1fdbd",22909863,1,3,0,291,120,121,1
"779f9ddd1fd14d1e9e69f72219a1fdbd","e20db35ced8544ddac5bc3839145e463",22909863,1,-36,0,292,121,91,-30
"e20db35ced8544ddac5bc3839145e463","779f9ddd1fd14d1e9e69f72219a1fdbd",22909863,1,36,0,293,91,121,30
"779f9ddd1fd14d1e9e69f72219a1fdbd","ae26e6cda8ad4a3f81bd347560d9579f",22909863,1,4,0,294,121,125,4
"ae26e6cda8ad4a3f81bd347560d9579f","ae26e6cda8ad4a3f81bd347560d9579f",22909863,1,0,1,295,125,125,0
"ae26e6cda8ad4a3f81bd347560d9579f","ee48df95832b4374aa273ceb27ec1315",22909863,1,1,0,296,125,126,1
"ee48df95832b4374aa273ceb27ec1315","ee48df95832b4374aa273ceb27ec1315",22909863,1,0,1,297,126,126,0
"ee48df95832b4374aa273ceb27ec1315","7a439da90b394756ad1777fc4c6dead5",22909863,1,1,0,298,126,127,1
"7a439da90b394756ad1777fc4c6dead5","7a439da90b394756ad1777fc4c6dead5",22909863,1,0,1,299,127,127,0
"7a439da90b394756ad1777fc4c6dead5","a8dd5213034441ac92724b4e83eb0bb2",22909863,1,3,0,300,127,129,2
"a8dd5213034441ac92724b4e83eb0bb2","779f9ddd1fd14d1e9e69f72219a1fdbd",22909863,1,-9,0,301,129,121,-8
"779f9ddd1fd14d1e9e69f72219a1fdbd","a8dd5213034441ac92724b4e83eb0bb2",22909863,1,9,0,302,121,129,8
"a8dd5213034441ac92724b4e83eb0bb2","8115eab6556b45f5b415c3b8c26a12e5",22909863,1,2,0,303,129,131,2
"8115eab6556b45f5b415c3b8c26a12e5","8115eab6556b45f5b415c3b8c26a12e5",22909863,2,0,1,304,131,131,0
"8115eab6556b45f5b415c3b8c26a12e5","ec34b06efd844b46a4c4818ecdb9b8f4",22909863,1,1,0,306,131,132,1
"ec34b06efd844b46a4c4818ecdb9b8f4","ec34b06efd844b46a4c4818ecdb9b8f4",22909863,2,0,1,307,132,132,0
"ec34b06efd844b46a4c4818ecdb9b8f4","c2e1c2b9eac64109b343a088584b576b",22909863,1,1,0,309,132,133,1
"c2e1c2b9eac64109b343a088584b576b","c2e1c2b9eac64109b343a088584b576b",22909863,2,0,1,310,133,133,0
"c2e1c2b9eac64109b343a088584b576b","579338175e0b4bbb8ef3b712b5d8b54e",22909863,1,-5,0,312,133,128,-5
"579338175e0b4bbb8ef3b712b5d8b54e","8bc5795d6a984a3eace4e2811e52dd4f",22909863,1,8,0,313,128,135,7
"8bc5795d6a984a3eace4e2811e52dd4f","8bc5795d6a984a3eace4e2811e52dd4f",22909863,3,0,1,314,135,135,0
"8bc5795d6a984a3eace4e2811e52dd4f","b416d47c56a742199b5d7c7f19d6503a",22909863,1,-1,0,317,135,134,-1
"b416d47c56a742199b5d7c7f19d6503a","cd4532ad48034873ba8bce2aac0c9808",22909863,1,4,0,318,134,137,3
"cd4532ad48034873ba8bce2aac0c9808","cd4532ad48034873ba8bce2aac0c9808",22909863,1,0,1,319,137,137,0
"cd4532ad48034873ba8bce2aac0c9808","779f9ddd1fd14d1e9e69f72219a1fdbd",22909863,1,-19,0,320,137,121,-16
"779f9ddd1fd14d1e9e69f72219a1fdbd","df1de691dafe4549a18a4398ee9dfaf9",22909863,1,23,0,321,121,139,18
"df1de691dafe4549a18a4398ee9dfaf9","6c5ad271a44743479bfaea29b1db8d02",22909863,2,4,0,322,139,143,4
"6c5ad271a44743479bfaea29b1db8d02","df1de691dafe4549a18a4398ee9dfaf9",22909863,1,-4,0,323,143,139,-4
"6c5ad271a44743479bfaea29b1db8d02","6c5ad271a44743479bfaea29b1db8d02",22909863,1,0,1,325,143,143,0
"6c5ad271a44743479bfaea29b1db8d02","83d311bed5374fee83d8d67a7d9d82dc",22909863,1,1,0,326,143,144,1
"83d311bed5374fee83d8d67a7d9d82dc","83d311bed5374fee83d8d67a7d9d82dc",22909863,1,0,1,327,144,144,0
"83d311bed5374fee83d8d67a7d9d82dc","402bba41861d43acb52a5abb89e8831e",22909863,1,1,0,328,144,145,1
"402bba41861d43acb52a5abb89e8831e","402bba41861d43acb52a5abb89e8831e",22909863,2,0,1,329,145,145,0
"402bba41861d43acb52a5abb89e8831e","8aae34f5ddbb4052a709b12e6b0d40fa",22909863,1,3,0,331,145,147,2
"8aae34f5ddbb4052a709b12e6b0d40fa","df1de691dafe4549a18a4398ee9dfaf9",22909863,1,-9,0,332,147,139,-8
"df1de691dafe4549a18a4398ee9dfaf9","8aae34f5ddbb4052a709b12e6b0d40fa",22909863,1,9,0,333,139,147,8
"8aae34f5ddbb4052a709b12e6b0d40fa","645b3f0249f64f76af2e19eb4d0e55b7",22909863,1,2,0,334,147,149,2
"645b3f0249f64f76af2e19eb4d0e55b7","645b3f0249f64f76af2e19eb4d0e55b7",22909863,2,0,1,335,149,149,0
"645b3f0249f64f76af2e19eb4d0e55b7","7e7b8db5064d4369805ab370aac5ddfb",22909863,1,1,0,337,149,150,1
"7e7b8db5064d4369805ab370aac5ddfb","7e7b8db5064d4369805ab370aac5ddfb",22909863,5,0,1,338,150,150,0
"7e7b8db5064d4369805ab370aac5ddfb","8956d210ae7f41968fada86d4c979d6a",22909863,1,1,0,343,150,151,1
"8956d210ae7f41968fada86d4c979d6a","8956d210ae7f41968fada86d4c979d6a",22909863,2,0,1,344,151,151,0
"8956d210ae7f41968fada86d4c979d6a","f902b0f41b544d4dbf79664fd233648d",22909863,1,-5,0,346,151,146,-5
"f902b0f41b544d4dbf79664fd233648d","ae781e8b775e4ccd93bc800dad5c8376",22909863,1,8,0,347,146,153,7
"ae781e8b775e4ccd93bc800dad5c8376","ae781e8b775e4ccd93bc800dad5c8376",22909863,2,0,1,348,153,153,0
"ae781e8b775e4ccd93bc800dad5c8376","06882a8492d9499aa31555567f575ecb",22909863,1,1,0,350,153,154,1
"06882a8492d9499aa31555567f575ecb","06882a8492d9499aa31555567f575ecb",22909863,1,0,1,351,154,154,0
"06882a8492d9499aa31555567f575ecb","f293c508f409466a8f27ddd7d1e40b20",22909863,1,1,0,352,154,155,1
"f293c508f409466a8f27ddd7d1e40b20","f293c508f409466a8f27ddd7d1e40b20",22909863,2,0,1,353,155,155,0
"f293c508f409466a8f27ddd7d1e40b20","cc4ddef5bbbe48ebb605141b347c4ed1",22909863,1,1,0,355,155,156,1
"cc4ddef5bbbe48ebb605141b347c4ed1","cc4ddef5bbbe48ebb605141b347c4ed1",22909863,3,0,1,356,156,156,0
"cc4ddef5bbbe48ebb605141b347c4ed1","d313cec988a84645bee413e8d4724a4b",22909863,1,3,0,359,156,158,2
"d313cec988a84645bee413e8d4724a4b","f03480cf4eba413194d7af52fc0e7f28",22909863,1,-7,0,360,158,152,-6
"f03480cf4eba413194d7af52fc0e7f28","d313cec988a84645bee413e8d4724a4b",22909863,1,7,0,361,152,158,6
"d313cec988a84645bee413e8d4724a4b","d313cec988a84645bee413e8d4724a4b",22909863,5,0,1,362,158,158,0
"d313cec988a84645bee413e8d4724a4b","779f9ddd1fd14d1e9e69f72219a1fdbd",22909863,1,-45,0,365,158,121,-37
"779f9ddd1fd14d1e9e69f72219a1fdbd","d313cec988a84645bee413e8d4724a4b",22909863,1,45,0,366,121,158,37
"d313cec988a84645bee413e8d4724a4b","df1de691dafe4549a18a4398ee9dfaf9",22909863,1,-22,0,367,158,139,-19
"df1de691dafe4549a18a4398ee9dfaf9","d313cec988a84645bee413e8d4724a4b",22909863,1,22,0,368,139,158,19
"d313cec988a84645bee413e8d4724a4b","dc60696c76a74368a60f72246e47700d",22909863,1,1,0,371,158,159,1
"dc60696c76a74368a60f72246e47700d","dc60696c76a74368a60f72246e47700d",22909863,1,0,1,372,159,159,0
"dc60696c76a74368a60f72246e47700d","78adeee1fa2c4fe0bc73f7bca9fcee86",22909863,1,3,0,373,159,160,1
"78adeee1fa2c4fe0bc73f7bca9fcee86","df1de691dafe4549a18a4398ee9dfaf9",22909863,1,-26,0,374,160,139,-21
"df1de691dafe4549a18a4398ee9dfaf9","78adeee1fa2c4fe0bc73f7bca9fcee86",22909863,1,26,0,375,139,160,21
"78adeee1fa2c4fe0bc73f7bca9fcee86","65202579580f4ad38d734b4ee39d22a8",22909863,3,5,0,376,160,164,4
"65202579580f4ad38d734b4ee39d22a8","65202579580f4ad38d734b4ee39d22a8",22909863,60,0,1,377,164,164,0
"65202579580f4ad38d734b4ee39d22a8","78adeee1fa2c4fe0bc73f7bca9fcee86",22909863,1,-5,0,379,164,160,-4
"65202579580f4ad38d734b4ee39d22a8","3cbcea2be0984e7dbd5a48195af10ce7",22909863,2,3,0,430,164,165,1
"3cbcea2be0984e7dbd5a48195af10ce7","78adeee1fa2c4fe0bc73f7bca9fcee86",22909863,2,-8,0,431,165,160,-5
"78adeee1fa2c4fe0bc73f7bca9fcee86","82e6285962b8400d9d6fc32436022a94",22909863,2,10,0,432,160,167,7
"82e6285962b8400d9d6fc32436022a94","78adeee1fa2c4fe0bc73f7bca9fcee86",22909863,1,-10,0,433,167,160,-7
"82e6285962b8400d9d6fc32436022a94","3cbcea2be0984e7dbd5a48195af10ce7",22909863,1,-2,0,447,167,165,-2
"3cbcea2be0984e7dbd5a48195af10ce7","a9ac840f098c4bd0a2ee896214ce29cd",22909863,1,5,0,448,165,168,3
"a9ac840f098c4bd0a2ee896214ce29cd","a9ac840f098c4bd0a2ee896214ce29cd",22909863,1,0,1,449,168,168,0
"a9ac840f098c4bd0a2ee896214ce29cd","0c7262dff33c4087bc660ccf40f92f9c",22909863,1,4,0,450,168,169,1
"0c7262dff33c4087bc660ccf40f92f9c","b2275c3fad834f8d90737a2d9a6927d6",22909863,1,3,0,451,169,172,3
"b2275c3fad834f8d90737a2d9a6927d6","b2275c3fad834f8d90737a2d9a6927d6",22909863,26,0,1,452,172,172,0
"b2275c3fad834f8d90737a2d9a6927d6","eb515a26030b41f8a82a1e6114420bad",22909863,1,1,0,478,172,173,1
"eb515a26030b41f8a82a1e6114420bad","eb515a26030b41f8a82a1e6114420bad",22909863,2,0,1,479,173,173,0
"eb515a26030b41f8a82a1e6114420bad","0c7262dff33c4087bc660ccf40f92f9c",22909863,1,-4,0,481,173,169,-4
"0c7262dff33c4087bc660ccf40f92f9c","b42cc17b7de840f181a704558d0bc845",22909863,2,7,0,482,169,175,6
"b42cc17b7de840f181a704558d0bc845","0c7262dff33c4087bc660ccf40f92f9c",22909863,1,-7,0,483,175,169,-6
"b42cc17b7de840f181a704558d0bc845","b42cc17b7de840f181a704558d0bc845",22909863,2,0,1,485,175,175,0
"b42cc17b7de840f181a704558d0bc845","801f9e9135034f49bf5f8b4bdefedb41",22909863,1,2,0,487,175,177,2
"801f9e9135034f49bf5f8b4bdefedb41","801f9e9135034f49bf5f8b4bdefedb41",22909863,11,0,1,488,177,177,0
"801f9e9135034f49bf5f8b4bdefedb41","ea38cc0e6e6e41edbabf210220808bf9",22909863,1,3,0,499,177,179,2
"ea38cc0e6e6e41edbabf210220808bf9","362fcb0699a14845ab29b2340093e528",22909863,1,-6,0,500,179,174,-5
"362fcb0699a14845ab29b2340093e528","b87c552dd247427abe6ab5795b9c9d43",22909863,1,8,0,501,174,181,7
"b87c552dd247427abe6ab5795b9c9d43","ea38cc0e6e6e41edbabf210220808bf9",22909863,1,-2,0,502,181,179,-2
"ea38cc0e6e6e41edbabf210220808bf9","b87c552dd247427abe6ab5795b9c9d43",22909863,1,2,0,503,179,181,2
"b87c552dd247427abe6ab5795b9c9d43","b87c552dd247427abe6ab5795b9c9d43",22909863,7,0,1,504,181,181,0
"b87c552dd247427abe6ab5795b9c9d43","139b097acfca451689d80c9c6eebdf7b",22909863,1,-3,0,511,181,178,-3
"139b097acfca451689d80c9c6eebdf7b","30f660a1feb34582a739722532524f79",22909863,1,6,0,512,178,183,5
"30f660a1feb34582a739722532524f79","30f660a1feb34582a739722532524f79",22909863,5,0,1,513,183,183,0
"30f660a1feb34582a739722532524f79","2024b4885bd14338a39b7b509acbbd02",22909863,1,-1,0,518,183,182,-1
"2024b4885bd14338a39b7b509acbbd02","c3f63fe50d8e487c86bf8ef76c9cadd3",22909863,1,4,0,519,182,185,3
"c3f63fe50d8e487c86bf8ef76c9cadd3","c3f63fe50d8e487c86bf8ef76c9cadd3",22909863,3,0,1,520,185,185,0
"c3f63fe50d8e487c86bf8ef76c9cadd3","0c7262dff33c4087bc660ccf40f92f9c",22909863,1,-20,0,523,185,169,-16
"0c7262dff33c4087bc660ccf40f92f9c","c8e371568a0c4391b25796ae4e91952e",22909863,1,23,0,524,169,186,17
"c8e371568a0c4391b25796ae4e91952e","7d932b23e1c84326ae5aa4d3c0d813d1",22909863,1,2,0,525,186,188,2
"7d932b23e1c84326ae5aa4d3c0d813d1","7d932b23e1c84326ae5aa4d3c0d813d1",22909863,3,0,1,526,188,188,0
"7d932b23e1c84326ae5aa4d3c0d813d1","c8e371568a0c4391b25796ae4e91952e",22909863,1,-2,0,529,188,186,-2
"c8e371568a0c4391b25796ae4e91952e","ab11d94c6c8948ea90b88f19d2cd502b",22909863,1,5,0,530,186,190,4
"ab11d94c6c8948ea90b88f19d2cd502b","ab11d94c6c8948ea90b88f19d2cd502b",22909863,1,0,1,531,190,190,0
"ab11d94c6c8948ea90b88f19d2cd502b","f992451ed6ad4e68bb9e68ad6be7c4be",22909863,1,2,0,532,190,192,2
"f992451ed6ad4e68bb9e68ad6be7c4be","f992451ed6ad4e68bb9e68ad6be7c4be",22909863,1,0,1,533,192,192,0
"f992451ed6ad4e68bb9e68ad6be7c4be","07b44a7a51e94c78b411c753fc39dab0",22909863,1,-3,0,534,192,189,-3
"07b44a7a51e94c78b411c753fc39dab0","6cd2dcaac46847d4a0bc53f296d90375",22909863,1,6,0,535,189,194,5
"6cd2dcaac46847d4a0bc53f296d90375","6cd2dcaac46847d4a0bc53f296d90375",22909863,1,0,1,536,194,194,0
"6cd2dcaac46847d4a0bc53f296d90375","2d2580c9411c4972909db508d6956a58",22909863,1,2,0,537,194,196,2
"2d2580c9411c4972909db508d6956a58","2d2580c9411c4972909db508d6956a58",22909863,8,0,1,538,196,196,0
"2d2580c9411c4972909db508d6956a58","5bddb3d9ed264f3984702f048c7e5340",22909863,1,1,0,546,196,197,1
"5bddb3d9ed264f3984702f048c7e5340","5bddb3d9ed264f3984702f048c7e5340",22909863,2,0,1,547,197,197,0
"5bddb3d9ed264f3984702f048c7e5340","d5e8e2bd12a2466b9d6d90855f0eb079",22909863,1,1,0,549,197,198,1
"d5e8e2bd12a2466b9d6d90855f0eb079","d5e8e2bd12a2466b9d6d90855f0eb079",22909863,2,0,1,550,198,198,0
"d5e8e2bd12a2466b9d6d90855f0eb079","017d7ca8e0394b91aaadc9574df2202c",22909863,1,-5,0,552,198,193,-5
"017d7ca8e0394b91aaadc9574df2202c","54e8e9f0ea3e45c4bf3b8ac799ee31b1",22909863,1,8,0,553,193,200,7
"54e8e9f0ea3e45c4bf3b8ac799ee31b1","54e8e9f0ea3e45c4bf3b8ac799ee31b1",22909863,1,0,1,554,200,200,0
"54e8e9f0ea3e45c4bf3b8ac799ee31b1","c614a00911be4877a075f19315530fb0",22909863,1,1,0,555,200,201,1
"c614a00911be4877a075f19315530fb0","c614a00911be4877a075f19315530fb0",22909863,6,0,1,556,201,201,0
"c614a00911be4877a075f19315530fb0","a6c21bd8b95249c7972820a7a7d76aff",22909863,1,1,0,562,201,202,1
"a6c21bd8b95249c7972820a7a7d76aff","a6c21bd8b95249c7972820a7a7d76aff",22909863,1,0,1,563,202,202,0
"a6c21bd8b95249c7972820a7a7d76aff","bb329d880ab54120adaf203a693bb203",22909863,1,1,0,564,202,203,1
"bb329d880ab54120adaf203a693bb203","bb329d880ab54120adaf203a693bb203",22909863,1,0,1,565,203,203,0
"bb329d880ab54120adaf203a693bb203","f9170dd6bc6442b4acd832747609b09a",22909863,1,-4,0,566,203,199,-4
"f9170dd6bc6442b4acd832747609b09a","334c2344009840079b1d0e1b7ce3d5a7",22909863,1,7,0,567,199,205,6
"334c2344009840079b1d0e1b7ce3d5a7","334c2344009840079b1d0e1b7ce3d5a7",22909863,2,0,1,568,205,205,0
"334c2344009840079b1d0e1b7ce3d5a7","c8e371568a0c4391b25796ae4e91952e",22909863,2,-23,0,569,205,186,-19
"c8e371568a0c4391b25796ae4e91952e","d7f13c8d63ec4e2aa673fbb9cf9c6933",22909863,2,26,0,570,186,206,20
"d7f13c8d63ec4e2aa673fbb9cf9c6933","b9e80f77c3a44349863b19875725c384",22909863,1,1,0,571,206,207,1
"b9e80f77c3a44349863b19875725c384","7108f0e4c2584f1f9c471689ae4c885c",22909863,3,1,0,572,207,208,1
"7108f0e4c2584f1f9c471689ae4c885c","334c2344009840079b1d0e1b7ce3d5a7",22909863,1,-5,0,573,208,205,-3
"d7f13c8d63ec4e2aa673fbb9cf9c6933","c8e371568a0c4391b25796ae4e91952e",22909863,1,-26,0,577,206,186,-20
"c8e371568a0c4391b25796ae4e91952e","b9e80f77c3a44349863b19875725c384",22909863,1,27,0,578,186,207,21
"7108f0e4c2584f1f9c471689ae4c885c","b9e80f77c3a44349863b19875725c384",22909863,1,-1,0,580,208,207,-1
"b9e80f77c3a44349863b19875725c384","b9e80f77c3a44349863b19875725c384",22909863,27,0,1,581,207,207,0
"7108f0e4c2584f1f9c471689ae4c885c","7108f0e4c2584f1f9c471689ae4c885c",22909863,13,0,1,609,208,208,0
"7108f0e4c2584f1f9c471689ae4c885c","d7f13c8d63ec4e2aa673fbb9cf9c6933",22909863,1,-2,0,622,208,206,-2
"d7f13c8d63ec4e2aa673fbb9cf9c6933","09400e101c5d4b439cf9a26b03aae558",22909863,1,5,0,623,206,210,4
"09400e101c5d4b439cf9a26b03aae558","09400e101c5d4b439cf9a26b03aae558",22909863,1,0,1,624,210,210,0
"09400e101c5d4b439cf9a26b03aae558","a88efa7e50ce47159810ab553afa6d3a",22909863,1,2,0,625,210,212,2
"a88efa7e50ce47159810ab553afa6d3a","a88efa7e50ce47159810ab553afa6d3a",22909863,5,0,1,626,212,212,0
"a88efa7e50ce47159810ab553afa6d3a","a875096404ef4a9984b62d74cda916f9",22909863,1,-3,0,631,212,209,-3
"a875096404ef4a9984b62d74cda916f9","be502a7a43c44bf7b682698de79d9369",22909863,1,6,0,632,209,214,5
"be502a7a43c44bf7b682698de79d9369","f7fb1952f56b4189b86a9f8b7862d2b8",22909863,2,1,0,633,214,215,1
"f7fb1952f56b4189b86a9f8b7862d2b8","be502a7a43c44bf7b682698de79d9369",22909863,1,-1,0,634,215,214,-1
"f7fb1952f56b4189b86a9f8b7862d2b8","f7fb1952f56b4189b86a9f8b7862d2b8",22909863,13,0,1,636,215,215,0
"f7fb1952f56b4189b86a9f8b7862d2b8","b860ee85d8bc4a2f97958cfb71be3533",22909863,1,1,0,649,215,216,1
"b860ee85d8bc4a2f97958cfb71be3533","b860ee85d8bc4a2f97958cfb71be3533",22909863,2,0,1,650,216,216,0
"b860ee85d8bc4a2f97958cfb71be3533","ec341f459285443b8361f7f15638ff08",22909863,1,-3,0,652,216,213,-3
"ec341f459285443b8361f7f15638ff08","363837c182e04711840d896ae1e0339c",22909863,1,6,0,653,213,218,5
"363837c182e04711840d896ae1e0339c","363837c182e04711840d896ae1e0339c",22909863,15,0,1,654,218,218,0
"363837c182e04711840d896ae1e0339c","01b2051f8941460d89945e3b02d1ce78",22909863,1,-1,0,669,218,217,-1
"01b2051f8941460d89945e3b02d1ce78","91125ca626c5470eb145501f8c37f8db",22909863,1,4,0,670,217,220,3
"91125ca626c5470eb145501f8c37f8db","91125ca626c5470eb145501f8c37f8db",22909863,1,0,1,671,220,220,0
"91125ca626c5470eb145501f8c37f8db","1c6721b1f63f4d30ba7746ea8af02a52",22909863,1,3,0,672,220,221,1
"1c6721b1f63f4d30ba7746ea8af02a52","d7f13c8d63ec4e2aa673fbb9cf9c6933",22909863,1,-21,0,673,221,206,-15
"d7f13c8d63ec4e2aa673fbb9cf9c6933","77ecef8eff6b4a2caea7707669bf7475",22909863,1,22,0,674,206,222,16
"77ecef8eff6b4a2caea7707669bf7475","77ecef8eff6b4a2caea7707669bf7475",22909863,13,0,1,675,222,222,0
"77ecef8eff6b4a2caea7707669bf7475","1c6721b1f63f4d30ba7746ea8af02a52",22909863,1,-1,0,688,222,221,-1
"1c6721b1f63f4d30ba7746ea8af02a52","d03cb855c70044cf8c35d9ec0de696e3",22909863,1,4,0,689,221,224,3
"d03cb855c70044cf8c35d9ec0de696e3","8b9ae98743bd4d4a8a87dff1c1244211",22909863,1,3,0,690,224,227,3
"8b9ae98743bd4d4a8a87dff1c1244211","d03cb855c70044cf8c35d9ec0de696e3",22909863,1,-3,0,691,227,224,-3
"d03cb855c70044cf8c35d9ec0de696e3","a49a937d6896486d9a5396654abcf2e1",22909863,1,2,0,692,224,226,2
"a49a937d6896486d9a5396654abcf2e1","a49a937d6896486d9a5396654abcf2e1",22909863,5,0,1,693,226,226,0
"a49a937d6896486d9a5396654abcf2e1","8b9ae98743bd4d4a8a87dff1c1244211",22909863,1,1,0,698,226,227,1
"8b9ae98743bd4d4a8a87dff1c1244211","8b9ae98743bd4d4a8a87dff1c1244211",22909863,21,0,1,699,227,227,0
"8b9ae98743bd4d4a8a87dff1c1244211","f7906d6f59b9489a91d2ef40db5a474d",22909863,1,-4,0,720,227,223,-4
"f7906d6f59b9489a91d2ef40db5a474d","2ab1535aac1346ba8801535bf729ef37",22909863,1,7,0,721,223,229,6
"2ab1535aac1346ba8801535bf729ef37","2ab1535aac1346ba8801535bf729ef37",22909863,2,0,1,722,229,229,0
"2ab1535aac1346ba8801535bf729ef37","a4f40fb48a8542c8949bae1f002cd9bc",22909863,1,2,0,724,229,231,2
"a4f40fb48a8542c8949bae1f002cd9bc","a4f40fb48a8542c8949bae1f002cd9bc",22909863,2,0,1,725,231,231,0
"a4f40fb48a8542c8949bae1f002cd9bc","8972c23e32044edb8a78fa1eed4e5947",22909863,1,1,0,727,231,232,1
"8972c23e32044edb8a78fa1eed4e5947","8972c23e32044edb8a78fa1eed4e5947",22909863,3,0,1,728,232,232,0
"8972c23e32044edb8a78fa1eed4e5947","92feb4a40f8344d38b6f722e42a53295",22909863,1,1,0,731,232,233,1
"92feb4a40f8344d38b6f722e42a53295","92feb4a40f8344d38b6f722e42a53295",22909863,2,0,1,732,233,233,0
"92feb4a40f8344d38b6f722e42a53295","5152833676bf4c6cb317060be10f68db",22909863,1,-5,0,734,233,228,-5
"5152833676bf4c6cb317060be10f68db","ca3e28f290354c08aefe5b0f769604e6",22909863,1,8,0,735,228,235,7
"ca3e28f290354c08aefe5b0f769604e6","ca3e28f290354c08aefe5b0f769604e6",22909863,14,0,1,736,235,235,0
"ca3e28f290354c08aefe5b0f769604e6","79a35eea833e4c2c9d22fc53c3c6445c",22909863,1,1,0,750,235,236,1
"79a35eea833e4c2c9d22fc53c3c6445c","79a35eea833e4c2c9d22fc53c3c6445c",22909863,4,0,1,751,236,236,0
"79a35eea833e4c2c9d22fc53c3c6445c","8f68228b1518449e9615cdafee41a2bd",22909863,1,1,0,755,236,237,1
"8f68228b1518449e9615cdafee41a2bd","8f68228b1518449e9615cdafee41a2bd",22909863,1,0,1,756,237,237,0
"8f68228b1518449e9615cdafee41a2bd","cab89fa5c3ed45a5aa550fc0352d6a42",22909863,1,1,0,757,237,238,1
"cab89fa5c3ed45a5aa550fc0352d6a42","cab89fa5c3ed45a5aa550fc0352d6a42",22909863,5,0,1,758,238,238,0
"cab89fa5c3ed45a5aa550fc0352d6a42","66d4fad4f1cf4b46be0750a99ad7a35a",22909863,1,1,0,763,238,239,1
"66d4fad4f1cf4b46be0750a99ad7a35a","66d4fad4f1cf4b46be0750a99ad7a35a",22909863,1,0,1,764,239,239,0
"66d4fad4f1cf4b46be0750a99ad7a35a","0b04c8e2f86d48c7aeb7e225819cd32b",22909863,1,-5,0,765,239,234,-5
"0b04c8e2f86d48c7aeb7e225819cd32b","f53da5fd9bfe412da4b80d4742563b6c",22909863,1,8,0,766,234,241,7
"f53da5fd9bfe412da4b80d4742563b6c","f53da5fd9bfe412da4b80d4742563b6c",22909863,2,0,1,767,241,241,0
"f53da5fd9bfe412da4b80d4742563b6c","1c6721b1f63f4d30ba7746ea8af02a52",22909863,2,-24,0,768,241,221,-20
"1c6721b1f63f4d30ba7746ea8af02a52","2ae94c0cea4d480a9d5dca8fb1d7b542",22909863,2,27,0,769,221,242,21
"2ae94c0cea4d480a9d5dca8fb1d7b542","1ebf23f9d994469a85206e4c7b1bf5f5",22909863,1,3,0,770,242,245,3
"1ebf23f9d994469a85206e4c7b1bf5f5","f53da5fd9bfe412da4b80d4742563b6c",22909863,1,-6,0,771,245,241,-4
"2ae94c0cea4d480a9d5dca8fb1d7b542","1c6721b1f63f4d30ba7746ea8af02a52",22909863,1,-27,0,775,242,221,-21
"1c6721b1f63f4d30ba7746ea8af02a52","1ebf23f9d994469a85206e4c7b1bf5f5",22909863,1,30,0,776,221,245,24
"1ebf23f9d994469a85206e4c7b1bf5f5","1ebf23f9d994469a85206e4c7b1bf5f5",22909863,15,0,1,777,245,245,0
"1ebf23f9d994469a85206e4c7b1bf5f5","85ae675b83e8422da842cfd25596af99",22909863,1,1,0,792,245,246,1
"85ae675b83e8422da842cfd25596af99","85ae675b83e8422da842cfd25596af99",22909863,3,0,1,793,246,246,0
"85ae675b83e8422da842cfd25596af99","fa235f0f364d47e4ae1c87f47bf8e6ba",22909863,1,8,0,796,246,252,6
"fa235f0f364d47e4ae1c87f47bf8e6ba","2ae94c0cea4d480a9d5dca8fb1d7b542",22909863,1,-12,0,797,252,242,-10
"2ae94c0cea4d480a9d5dca8fb1d7b542","fa235f0f364d47e4ae1c87f47bf8e6ba",22909863,1,12,0,798,242,252,10
"fa235f0f364d47e4ae1c87f47bf8e6ba","79f7845465cc4ed19d8e4f1429541be0",22909863,1,2,0,799,252,254,2
"79f7845465cc4ed19d8e4f1429541be0","79f7845465cc4ed19d8e4f1429541be0",22909863,2,0,1,800,254,254,0
"79f7845465cc4ed19d8e4f1429541be0","6e83e23f56544a19b94067c1c558d9c0",22909863,1,-8,0,802,254,247,-7
"6e83e23f56544a19b94067c1c558d9c0","00f61990949545828dd12f1303d47504",22909863,1,11,0,803,247,256,9
"00f61990949545828dd12f1303d47504","00f61990949545828dd12f1303d47504",22909863,1,0,1,804,256,256,0
"00f61990949545828dd12f1303d47504","ead7bb4b64e247d2ae632ab8a296b091",22909863,1,2,0,805,256,258,2
"ead7bb4b64e247d2ae632ab8a296b091","ead7bb4b64e247d2ae632ab8a296b091",22909863,2,0,1,806,258,258,0
"ead7bb4b64e247d2ae632ab8a296b091","41b0048dde734bb280bac6116baa8e27",22909863,1,1,0,808,258,259,1
"41b0048dde734bb280bac6116baa8e27","41b0048dde734bb280bac6116baa8e27",22909863,2,0,1,809,259,259,0
"41b0048dde734bb280bac6116baa8e27","b41c5a094a604ee0915327da5cc0beb7",22909863,1,1,0,811,259,260,1
"b41c5a094a604ee0915327da5cc0beb7","b41c5a094a604ee0915327da5cc0beb7",22909863,2,0,1,812,260,260,0
"b41c5a094a604ee0915327da5cc0beb7","d546341988904f069cfa86b21457d9d9",22909863,1,-10,0,814,260,251,-9
"d546341988904f069cfa86b21457d9d9","28c171777c52431ab6b925073bd63d46",22909863,1,15,0,815,251,264,13
"28c171777c52431ab6b925073bd63d46","28c171777c52431ab6b925073bd63d46",22909863,3,0,1,816,264,264,0
"28c171777c52431ab6b925073bd63d46","ac160db940cb49ae8579162b1d52bb5d",22909863,1,2,0,819,264,266,2
"ac160db940cb49ae8579162b1d52bb5d","ac160db940cb49ae8579162b1d52bb5d",22909863,7,0,1,820,266,266,0
"ac160db940cb49ae8579162b1d52bb5d","d989ebcfc12a4b669f0100dc1aa14f1e",22909863,1,-12,0,827,266,255,-11
"d989ebcfc12a4b669f0100dc1aa14f1e","c6fd49b485cc4874b0bbdd9c6171e09c",22909863,1,15,0,828,255,268,13
"c6fd49b485cc4874b0bbdd9c6171e09c","c6fd49b485cc4874b0bbdd9c6171e09c",22909863,3,0,1,829,268,268,0
"c6fd49b485cc4874b0bbdd9c6171e09c","44240778a97c4af0937817499b75707b",22909863,1,1,0,832,268,269,1
"44240778a97c4af0937817499b75707b","44240778a97c4af0937817499b75707b",22909863,2,0,1,833,269,269,0
"44240778a97c4af0937817499b75707b","7aa76d3e993840d8805f097cbdbcd44b",22909863,1,-9,0,835,269,261,-8
"7aa76d3e993840d8805f097cbdbcd44b","865a4d3b43374da7944dc7d397f566d9",22909863,1,12,0,836,261,271,10
"865a4d3b43374da7944dc7d397f566d9","865a4d3b43374da7944dc7d397f566d9",22909863,1,0,1,837,271,271,0
"865a4d3b43374da7944dc7d397f566d9","2ae94c0cea4d480a9d5dca8fb1d7b542",22909863,1,-35,0,838,271,242,-29
"2ae94c0cea4d480a9d5dca8fb1d7b542","0d987bed3ffa4ed0b9a2e62e97b7b30f",22909863,1,38,0,839,242,272,30
"0d987bed3ffa4ed0b9a2e62e97b7b30f","0d987bed3ffa4ed0b9a2e62e97b7b30f",22909863,3,0,1,840,272,272,0
"0d987bed3ffa4ed0b9a2e62e97b7b30f","82ae07bc0c9b4570a41799290d1ef399",22909863,1,4,0,843,272,275,3
"82ae07bc0c9b4570a41799290d1ef399","bb5a47f5ea01454a8b79455422d3b9da",22909863,1,6,0,844,275,280,5
"bb5a47f5ea01454a8b79455422d3b9da","bb5a47f5ea01454a8b79455422d3b9da",22909863,32,0,1,845,280,280,0
"bb5a47f5ea01454a8b79455422d3b9da","0d987bed3ffa4ed0b9a2e62e97b7b30f",22909863,2,-10,0,861,280,272,-8
"0d987bed3ffa4ed0b9a2e62e97b7b30f","bb5a47f5ea01454a8b79455422d3b9da",22909863,2,10,0,862,272,280,8
"b613861cecf84ffcab01afb23f660475","b613861cecf84ffcab01afb23f660475",22913375,3,0,1,1,1,1,0
"b613861cecf84ffcab01afb23f660475","e2911e79efc2420eac45d9f671463d4b",22913375,1,3,0,4,1,2,1
"e2911e79efc2420eac45d9f671463d4b","e2911e79efc2420eac45d9f671463d4b",22913375,2,0,1,5,2,2,0
"e2911e79efc2420eac45d9f671463d4b","519d1b8c59404d67b54e96c5c8a830b2",22913375,1,1,0,7,2,3,1
"519d1b8c59404d67b54e96c5c8a830b2","519d1b8c59404d67b54e96c5c8a830b2",22913375,1,0,1,8,3,3,0
"519d1b8c59404d67b54e96c5c8a830b2","531db53f81f646edb0cdcfe0085b03b7",22913375,1,1,0,9,3,4,1
"531db53f81f646edb0cdcfe0085b03b7","531db53f81f646edb0cdcfe0085b03b7",22913375,1,0,1,10,4,4,0
"531db53f81f646edb0cdcfe0085b03b7","4f5f94b2f95141e0a9d53a61da2276da",22913375,1,1,0,11,4,5,1
"4f5f94b2f95141e0a9d53a61da2276da","4f5f94b2f95141e0a9d53a61da2276da",22913375,1,0,1,12,5,5,0
"4f5f94b2f95141e0a9d53a61da2276da","6d541c89590949f99af293c4f2333f67",22913375,1,1,0,13,5,6,1
"6d541c89590949f99af293c4f2333f67","6d541c89590949f99af293c4f2333f67",22913375,2,0,1,14,6,6,0
"6d541c89590949f99af293c4f2333f67","dd5cf0b9fe4c4f1d8f5ff8e4c04879cb",22913375,1,1,0,16,6,7,1
"dd5cf0b9fe4c4f1d8f5ff8e4c04879cb","dd5cf0b9fe4c4f1d8f5ff8e4c04879cb",22913375,1,0,1,17,7,7,0
"dd5cf0b9fe4c4f1d8f5ff8e4c04879cb","f96261861edc426abe2248be4f0a709a",22913375,1,1,0,18,7,8,1
"f96261861edc426abe2248be4f0a709a","f96261861edc426abe2248be4f0a709a",22913375,1,0,1,19,8,8,0
"f96261861edc426abe2248be4f0a709a","66b5e16f4f75454fb5b8172079f0fa83",22913375,1,1,0,20,8,9,1
"66b5e16f4f75454fb5b8172079f0fa83","66b5e16f4f75454fb5b8172079f0fa83",22913375,1,0,1,21,9,9,0
"66b5e16f4f75454fb5b8172079f0fa83","0680571d4698477995e41842c36a54b2",22913375,1,1,0,22,9,10,1
"0680571d4698477995e41842c36a54b2","0680571d4698477995e41842c36a54b2",22913375,1,0,1,23,10,10,0
"0680571d4698477995e41842c36a54b2","9112f2bffece48e08c6d2287be204085",22913375,1,1,0,24,10,11,1
"9112f2bffece48e08c6d2287be204085","9112f2bffece48e08c6d2287be204085",22913375,1,0,1,25,11,11,0
"9112f2bffece48e08c6d2287be204085","e2911e79efc2420eac45d9f671463d4b",22913375,1,-9,0,26,11,2,-9
"e2911e79efc2420eac45d9f671463d4b","56586aa865414f538729c7f7735d2bc6",22913375,1,12,0,27,2,12,10
"56586aa865414f538729c7f7735d2bc6","56586aa865414f538729c7f7735d2bc6",22913375,2,0,1,28,12,12,0
"56586aa865414f538729c7f7735d2bc6","b7f2b31585d94eb3bf86376714aa7070",22913375,1,2,0,30,12,13,1
"b7f2b31585d94eb3bf86376714aa7070","b7f2b31585d94eb3bf86376714aa7070",22913375,2,0,1,31,13,13,0
"b7f2b31585d94eb3bf86376714aa7070","3f1c815879794b929260d224becaff7e",22913375,1,2,0,33,13,14,1
"3f1c815879794b929260d224becaff7e","56586aa865414f538729c7f7735d2bc6",22913375,1,-4,0,34,14,12,-2
"56586aa865414f538729c7f7735d2bc6","3f1c815879794b929260d224becaff7e",22913375,1,4,0,35,12,14,2
"3f1c815879794b929260d224becaff7e","81c864a886d54a6b8ff85f7d736f4f95",22913375,1,2,0,36,14,15,1
"81c864a886d54a6b8ff85f7d736f4f95","5c5ceeee4562457ba6d41515aeebfbb1",22913375,1,4,0,37,15,17,2
"5c5ceeee4562457ba6d41515aeebfbb1","5c5ceeee4562457ba6d41515aeebfbb1",22913375,3,0,1,38,17,17,0
"5c5ceeee4562457ba6d41515aeebfbb1","56586aa865414f538729c7f7735d2bc6",22913375,1,-10,0,41,17,12,-5
"56586aa865414f538729c7f7735d2bc6","9afd71a5298d4333b6849dfce1b9422c",22913375,1,13,0,42,12,18,6
"9afd71a5298d4333b6849dfce1b9422c","9afd71a5298d4333b6849dfce1b9422c",22913375,1,0,1,43,18,18,0
"9afd71a5298d4333b6849dfce1b9422c","b7719e26494940efa49512aedd0aac79",22913375,1,4,0,44,18,20,2
"b7719e26494940efa49512aedd0aac79","d4f45188d3c84a02ba08454e6403a818",22913375,2,5,0,45,20,24,4
"d4f45188d3c84a02ba08454e6403a818","d4c3b003e8274e429d2fa688d73fde6d",22913375,2,-2,0,46,24,22,-2
"d4c3b003e8274e429d2fa688d73fde6d","d4c3b003e8274e429d2fa688d73fde6d",22913375,1,0,1,47,22,22,0
"d4c3b003e8274e429d2fa688d73fde6d","b7719e26494940efa49512aedd0aac79",22913375,2,-3,0,48,22,20,-2
"afbf7250b99d47bea07172749483ca97","afbf7250b99d47bea07172749483ca97",22913375,1,0,1,54,28,28,0
"afbf7250b99d47bea07172749483ca97","4e51676dc72045d99c19b9fa7b22f8bc",22913375,3,3,0,55,28,29,1
"4e51676dc72045d99c19b9fa7b22f8bc","4e51676dc72045d99c19b9fa7b22f8bc",22913375,1,0,1,56,29,29,0
"4e51676dc72045d99c19b9fa7b22f8bc","afbf7250b99d47bea07172749483ca97",22913375,2,-3,0,57,29,28,-1
"4e51676dc72045d99c19b9fa7b22f8bc","51970cfa30e643e894e66ae85c8024cc",22913375,1,3,0,61,29,31,2
"51970cfa30e643e894e66ae85c8024cc","4e51676dc72045d99c19b9fa7b22f8bc",22913375,1,-3,0,62,31,29,-2
"4e51676dc72045d99c19b9fa7b22f8bc","c33c17be71ae4d588da7369472e5bb1b",22913375,1,9,0,63,29,34,5
"c33c17be71ae4d588da7369472e5bb1b","c33c17be71ae4d588da7369472e5bb1b",22913375,1,0,1,64,34,34,0
"c33c17be71ae4d588da7369472e5bb1b","93679be414554a11b1893002f2229a93",22913375,1,3,0,65,34,35,1
"93679be414554a11b1893002f2229a93","93679be414554a11b1893002f2229a93",22913375,1,0,1,66,35,35,0
"93679be414554a11b1893002f2229a93","7040a13096d746ac84b8fac8d9752058",22913375,1,3,0,67,35,36,1
"7040a13096d746ac84b8fac8d9752058","9a0dc646f934470daf08c4b56ccf73db",22913375,2,3,0,68,36,37,1
"9a0dc646f934470daf08c4b56ccf73db","7040a13096d746ac84b8fac8d9752058",22913375,1,-3,0,69,37,36,-1
"9a0dc646f934470daf08c4b56ccf73db","fc0e049d56024bc9a02c9a9c435c3df7",22913375,1,3,0,71,37,38,1
"fc0e049d56024bc9a02c9a9c435c3df7","67a089198fcb4e1c8f2385786c2b296f",22913375,1,4,0,72,38,39,1
"67a089198fcb4e1c8f2385786c2b296f","fc0e049d56024bc9a02c9a9c435c3df7",22913375,1,-4,0,73,39,38,-1
"fc0e049d56024bc9a02c9a9c435c3df7","64d48c6c9c7940639a932219a6c87198",22913375,1,5,0,74,38,40,2
"64d48c6c9c7940639a932219a6c87198","64d48c6c9c7940639a932219a6c87198",22913375,1,0,1,75,40,40,0
"64d48c6c9c7940639a932219a6c87198","67a089198fcb4e1c8f2385786c2b296f",22913375,1,-1,0,76,40,39,-1
"67a089198fcb4e1c8f2385786c2b296f","b534b89233134e30a9b5645138bfa9ee",22913375,1,4,0,77,39,41,2
"b534b89233134e30a9b5645138bfa9ee","0e37b720d23b4e7f8b313e79313fd107",22913375,1,3,0,78,41,44,3
"0e37b720d23b4e7f8b313e79313fd107","0e37b720d23b4e7f8b313e79313fd107",22913375,1,0,1,79,44,44,0
"0e37b720d23b4e7f8b313e79313fd107","6875d67fdd5f48168b62719df449bebd",22913375,1,1,0,80,44,45,1
"6875d67fdd5f48168b62719df449bebd","6875d67fdd5f48168b62719df449bebd",22913375,1,0,1,81,45,45,0
"6875d67fdd5f48168b62719df449bebd","6e13d61a7bdb44bca949c9f86fab3be5",22913375,1,3,0,82,45,47,2
"6e13d61a7bdb44bca949c9f86fab3be5","b534b89233134e30a9b5645138bfa9ee",22913375,1,-7,0,83,47,41,-6
"b534b89233134e30a9b5645138bfa9ee","6e13d61a7bdb44bca949c9f86fab3be5",22913375,1,7,0,84,41,47,6
"6e13d61a7bdb44bca949c9f86fab3be5","195f78799f984cc2b06c48dfe36be751",22913375,1,2,0,85,47,49,2
"195f78799f984cc2b06c48dfe36be751","195f78799f984cc2b06c48dfe36be751",22913375,2,0,1,86,49,49,0
"195f78799f984cc2b06c48dfe36be751","d9c8d8c444a64dadbbb508652c721e17",22913375,1,-3,0,88,49,46,-3
"d9c8d8c444a64dadbbb508652c721e17","d0c74f735e024943943e40333d6d337f",22913375,1,6,0,89,46,51,5
"d0c74f735e024943943e40333d6d337f","d0c74f735e024943943e40333d6d337f",22913375,1,0,1,90,51,51,0
"d0c74f735e024943943e40333d6d337f","983f8ff320594b279a7f4a6fe132f9c5",22913375,1,2,0,91,51,53,2
"983f8ff320594b279a7f4a6fe132f9c5","983f8ff320594b279a7f4a6fe132f9c5",22913375,2,0,1,92,53,53,0
"983f8ff320594b279a7f4a6fe132f9c5","35adfa5d923046aebabfefd98f35ff05",22913375,1,1,0,94,53,54,1
"35adfa5d923046aebabfefd98f35ff05","35adfa5d923046aebabfefd98f35ff05",22913375,2,0,1,95,54,54,0
"35adfa5d923046aebabfefd98f35ff05","b6f8a98476224da1b40e555ececc7ed8",22913375,1,1,0,97,54,55,1
"b6f8a98476224da1b40e555ececc7ed8","b6f8a98476224da1b40e555ececc7ed8",22913375,2,0,1,98,55,55,0
"b6f8a98476224da1b40e555ececc7ed8","86e22cb5fe0e4b47a9489ecddf7ed78f",22913375,1,1,0,100,55,56,1
"86e22cb5fe0e4b47a9489ecddf7ed78f","86e22cb5fe0e4b47a9489ecddf7ed78f",22913375,2,0,1,101,56,56,0
"86e22cb5fe0e4b47a9489ecddf7ed78f","f924752d8a1149668870b1e7698486f7",22913375,1,-6,0,103,56,50,-6
"f924752d8a1149668870b1e7698486f7","78f30e4dcac84e3cbea8b2cc6e0d62b3",22913375,1,10,0,104,50,59,9
"78f30e4dcac84e3cbea8b2cc6e0d62b3","a1f2f12debe5432fb7a70bcd12bacfb9",22913375,1,-1,0,105,59,58,-1
"a1f2f12debe5432fb7a70bcd12bacfb9","a1f2f12debe5432fb7a70bcd12bacfb9",22913375,25,0,1,106,58,58,0
"a1f2f12debe5432fb7a70bcd12bacfb9","78f30e4dcac84e3cbea8b2cc6e0d62b3",22913375,1,1,0,131,58,59,1
"78f30e4dcac84e3cbea8b2cc6e0d62b3","78f30e4dcac84e3cbea8b2cc6e0d62b3",22913375,9,0,1,132,59,59,0
"78f30e4dcac84e3cbea8b2cc6e0d62b3","12aa6e1672ac4e7aa6449a7a8609cd72",22913375,1,-2,0,141,59,57,-2
"12aa6e1672ac4e7aa6449a7a8609cd72","bc42d26810654ea9a1df1efe1e58c7d5",22913375,1,7,0,142,57,63,6
"bc42d26810654ea9a1df1efe1e58c7d5","a0a418b8540d479fa6e0f653b701da8b",22913375,1,1,0,143,63,64,1
"a0a418b8540d479fa6e0f653b701da8b","4c943503763e4e349906eea3ed3c8e86",22913375,1,-3,0,144,64,61,-3
"4c943503763e4e349906eea3ed3c8e86","4c943503763e4e349906eea3ed3c8e86",22913375,1,0,1,145,61,61,0
"4c943503763e4e349906eea3ed3c8e86","a0a418b8540d479fa6e0f653b701da8b",22913375,1,3,0,146,61,64,3
"a0a418b8540d479fa6e0f653b701da8b","a0a418b8540d479fa6e0f653b701da8b",22913375,3,0,1,147,64,64,0
"a0a418b8540d479fa6e0f653b701da8b","309ccf3cc4fe429d9bfbaef53d3fa479",22913375,1,-4,0,150,64,60,-4
"309ccf3cc4fe429d9bfbaef53d3fa479","b534b89233134e30a9b5645138bfa9ee",22913375,1,-23,0,151,60,41,-19
"b534b89233134e30a9b5645138bfa9ee","d646286c8051419bbc2e31dd1db55ca8",22913375,1,33,0,152,41,67,26
"d646286c8051419bbc2e31dd1db55ca8","267f883678b24aed855fde42524975d9",22913375,1,4,0,153,67,71,4
"267f883678b24aed855fde42524975d9","267f883678b24aed855fde42524975d9",22913375,1,0,1,154,71,71,0
"267f883678b24aed855fde42524975d9","88fff56d0342490dbef9040750a20f6c",22913375,1,1,0,155,71,72,1
"88fff56d0342490dbef9040750a20f6c","88fff56d0342490dbef9040750a20f6c",22913375,1,0,1,156,72,72,0
"88fff56d0342490dbef9040750a20f6c","adb17b12b66c4a49a85fd34322f7df70",22913375,1,1,0,157,72,73,1
"adb17b12b66c4a49a85fd34322f7df70","adb17b12b66c4a49a85fd34322f7df70",22913375,1,0,1,158,73,73,0
"adb17b12b66c4a49a85fd34322f7df70","d646286c8051419bbc2e31dd1db55ca8",22913375,1,-6,0,159,73,67,-6
"d646286c8051419bbc2e31dd1db55ca8","a2becd407db34b189200a32546d9d569",22913375,1,9,0,160,67,75,8
"a2becd407db34b189200a32546d9d569","a2becd407db34b189200a32546d9d569",22913375,3,0,1,161,75,75,0
"a2becd407db34b189200a32546d9d569","58c22b011d0f4c2ea6d13615edbb9eeb",22913375,1,2,0,164,75,77,2
"58c22b011d0f4c2ea6d13615edbb9eeb","58c22b011d0f4c2ea6d13615edbb9eeb",22913375,2,0,1,165,77,77,0
"58c22b011d0f4c2ea6d13615edbb9eeb","dd76e1861dc9461c830888729d091ee0",22913375,1,1,0,167,77,78,1
"dd76e1861dc9461c830888729d091ee0","dd76e1861dc9461c830888729d091ee0",22913375,5,0,1,168,78,78,0
"dd76e1861dc9461c830888729d091ee0","cd1d828f1a694b87913a7ea66c23803e",22913375,1,1,0,173,78,79,1
"cd1d828f1a694b87913a7ea66c23803e","cd1d828f1a694b87913a7ea66c23803e",22913375,2,0,1,174,79,79,0
"cd1d828f1a694b87913a7ea66c23803e","9176a3c2b4d2465fa8b0c67096c2a97e",22913375,1,1,0,176,79,80,1
"9176a3c2b4d2465fa8b0c67096c2a97e","9176a3c2b4d2465fa8b0c67096c2a97e",22913375,11,0,1,177,80,80,0
"9176a3c2b4d2465fa8b0c67096c2a97e","f8ec6445f7194e25b9101d4fbcb07a18",22913375,1,1,0,188,80,81,1
"f8ec6445f7194e25b9101d4fbcb07a18","f8ec6445f7194e25b9101d4fbcb07a18",22913375,5,0,1,189,81,81,0
"f8ec6445f7194e25b9101d4fbcb07a18","140d5b27b8574befad82c0a013b59dfa",22913375,1,-7,0,194,81,74,-7
"140d5b27b8574befad82c0a013b59dfa","d18a9ea32855445f8736581f5cb119ce",22913375,1,9,0,195,74,82,8
"d18a9ea32855445f8736581f5cb119ce","f564483cbd7a407681aa2fcca518cf5f",22913375,1,4,0,196,82,85,3
"f564483cbd7a407681aa2fcca518cf5f","f564483cbd7a407681aa2fcca518cf5f",22913375,1,0,1,197,85,85,0
"f564483cbd7a407681aa2fcca518cf5f","18fd01350bd5434ca636d59a599d768a",22913375,1,1,0,198,85,86,1
"18fd01350bd5434ca636d59a599d768a","18fd01350bd5434ca636d59a599d768a",22913375,5,0,1,199,86,86,0
"18fd01350bd5434ca636d59a599d768a","ae5ac430ea254e708a6f5deaaf7464ae",22913375,1,-2,0,204,86,84,-2
"ae5ac430ea254e708a6f5deaaf7464ae","6a9f0ef185fb47f0937e29daa1c71ed5",22913375,1,7,0,205,84,90,6
"6a9f0ef185fb47f0937e29daa1c71ed5","c681290961c94c4caf23b529d1ae6b9a",22913375,1,-2,0,206,90,88,-2
"c681290961c94c4caf23b529d1ae6b9a","c681290961c94c4caf23b529d1ae6b9a",22913375,1,0,1,207,88,88,0
"c681290961c94c4caf23b529d1ae6b9a","6a9f0ef185fb47f0937e29daa1c71ed5",22913375,1,2,0,208,88,90,2
"6a9f0ef185fb47f0937e29daa1c71ed5","6a9f0ef185fb47f0937e29daa1c71ed5",22913375,3,0,1,209,90,90,0
"6a9f0ef185fb47f0937e29daa1c71ed5","e20db35ced8544ddac5bc3839145e463",22913375,1,3,0,212,90,91,1
"e20db35ced8544ddac5bc3839145e463","d646286c8051419bbc2e31dd1db55ca8",22913375,1,-30,0,213,91,67,-24
"d646286c8051419bbc2e31dd1db55ca8","1febb706d7a34005ae8711ed49c76e64",22913375,1,33,0,214,67,94,27
"1febb706d7a34005ae8711ed49c76e64","1febb706d7a34005ae8711ed49c76e64",22913375,2,0,1,215,94,94,0
"1febb706d7a34005ae8711ed49c76e64","8f73ba6f5a0042f2850356ac38ac6f24",22913375,1,1,0,217,94,95,1
"8f73ba6f5a0042f2850356ac38ac6f24","8f73ba6f5a0042f2850356ac38ac6f24",22913375,5,0,1,218,95,95,0
"8f73ba6f5a0042f2850356ac38ac6f24","e2260b86653c46d7b14a41fb419dbf8c",22913375,1,1,0,223,95,96,1
"e2260b86653c46d7b14a41fb419dbf8c","e2260b86653c46d7b14a41fb419dbf8c",22913375,2,0,1,224,96,96,0
"e2260b86653c46d7b14a41fb419dbf8c","35eb641ad1d845bbba54915bce75a962",22913375,1,1,0,226,96,97,1
"35eb641ad1d845bbba54915bce75a962","35eb641ad1d845bbba54915bce75a962",22913375,5,0,1,227,97,97,0
"35eb641ad1d845bbba54915bce75a962","08be90ffbeea4795a138cd42ed8db56f",22913375,1,1,0,232,97,98,1
"08be90ffbeea4795a138cd42ed8db56f","08be90ffbeea4795a138cd42ed8db56f",22913375,2,0,1,233,98,98,0
"08be90ffbeea4795a138cd42ed8db56f","3007433c8f584dcbb5ac159c1c5f2be3",22913375,1,1,0,235,98,99,1
"3007433c8f584dcbb5ac159c1c5f2be3","3007433c8f584dcbb5ac159c1c5f2be3",22913375,5,0,1,236,99,99,0
"3007433c8f584dcbb5ac159c1c5f2be3","e20db35ced8544ddac5bc3839145e463",22913375,1,-8,0,241,99,91,-8
"e20db35ced8544ddac5bc3839145e463","00ae5f0c51874a73a41ebea838d95682",22913375,1,11,0,242,91,101,10
"00ae5f0c51874a73a41ebea838d95682","d391c8b6e56a43a7b654e9dee02d904b",22913375,2,2,0,243,101,103,2
"d391c8b6e56a43a7b654e9dee02d904b","00ae5f0c51874a73a41ebea838d95682",22913375,1,-2,0,244,103,101,-2
"d391c8b6e56a43a7b654e9dee02d904b","d391c8b6e56a43a7b654e9dee02d904b",22913375,15,0,1,246,103,103,0
"d391c8b6e56a43a7b654e9dee02d904b","6111116566fc4fd9abba409322bea245",22913375,1,1,0,261,103,104,1
"6111116566fc4fd9abba409322bea245","6111116566fc4fd9abba409322bea245",22913375,2,0,1,262,104,104,0
"6111116566fc4fd9abba409322bea245","a81b2235cb9c499eb9ea8ee0a8dd9725",22913375,1,1,0,264,104,105,1
"a81b2235cb9c499eb9ea8ee0a8dd9725","a81b2235cb9c499eb9ea8ee0a8dd9725",22913375,2,0,1,265,105,105,0
"a81b2235cb9c499eb9ea8ee0a8dd9725","2d4e0ab0ef3b4d73b82c72d4621a7579",22913375,1,1,0,267,105,106,1
"2d4e0ab0ef3b4d73b82c72d4621a7579","2d4e0ab0ef3b4d73b82c72d4621a7579",22913375,2,0,1,268,106,106,0
"2d4e0ab0ef3b4d73b82c72d4621a7579","8bdebf492ebd4e62b0d522e8ab5e5197",22913375,1,1,0,270,106,107,1
"8bdebf492ebd4e62b0d522e8ab5e5197","8bdebf492ebd4e62b0d522e8ab5e5197",22913375,2,0,1,271,107,107,0
"8bdebf492ebd4e62b0d522e8ab5e5197","73039f8c1eb9409cb4caee2cf968001e",22913375,1,-7,0,273,107,100,-7
"73039f8c1eb9409cb4caee2cf968001e","4280927ec4d643238aa49c32f9e06c6c",22913375,1,10,0,274,100,109,9
"4280927ec4d643238aa49c32f9e06c6c","4280927ec4d643238aa49c32f9e06c6c",22913375,3,0,1,275,109,109,0
"4280927ec4d643238aa49c32f9e06c6c","fc44e6a5f7654430af1227838224dceb",22913375,1,2,0,278,109,111,2
"fc44e6a5f7654430af1227838224dceb","fc44e6a5f7654430af1227838224dceb",22913375,2,0,1,279,111,111,0
"fc44e6a5f7654430af1227838224dceb","08111f75e22d409998cf8b85bd431f0a",22913375,1,-3,0,281,111,108,-3
"08111f75e22d409998cf8b85bd431f0a","a9ae0a3c070d455bb4369a8996313336",22913375,1,7,0,282,108,114,6
"a9ae0a3c070d455bb4369a8996313336","a9ae0a3c070d455bb4369a8996313336",22913375,2,0,1,283,114,114,0
"a9ae0a3c070d455bb4369a8996313336","71cec822bcff4f30a20e75dc63ef7b65",22913375,1,2,0,285,114,116,2
"71cec822bcff4f30a20e75dc63ef7b65","71cec822bcff4f30a20e75dc63ef7b65",22913375,1,0,1,286,116,116,0
"71cec822bcff4f30a20e75dc63ef7b65","37319e88176d4aefa91d7a9980dbae91",22913375,1,-4,0,287,116,112,-4
"37319e88176d4aefa91d7a9980dbae91","62bff51286ef4f348717a3cf6fe2318f",22913375,1,9,0,288,112,120,8
"62bff51286ef4f348717a3cf6fe2318f","b1cd0e7dc3ad4a8eb91a4bfdbeb025b0",22913375,1,-2,0,289,120,118,-2
"b1cd0e7dc3ad4a8eb91a4bfdbeb025b0","b1cd0e7dc3ad4a8eb91a4bfdbeb025b0",22913375,1,0,1,290,118,118,0
"b1cd0e7dc3ad4a8eb91a4bfdbeb025b0","62bff51286ef4f348717a3cf6fe2318f",22913375,1,2,0,291,118,120,2
"62bff51286ef4f348717a3cf6fe2318f","62bff51286ef4f348717a3cf6fe2318f",22913375,3,0,1,292,120,120,0
"62bff51286ef4f348717a3cf6fe2318f","e20db35ced8544ddac5bc3839145e463",22913375,1,-33,0,295,120,91,-29
"e20db35ced8544ddac5bc3839145e463","779f9ddd1fd14d1e9e69f72219a1fdbd",22913375,1,36,0,296,91,121,30
"779f9ddd1fd14d1e9e69f72219a1fdbd","ae26e6cda8ad4a3f81bd347560d9579f",22913375,1,4,0,297,121,125,4
"ae26e6cda8ad4a3f81bd347560d9579f","ae26e6cda8ad4a3f81bd347560d9579f",22913375,1,0,1,298,125,125,0
"ae26e6cda8ad4a3f81bd347560d9579f","ee48df95832b4374aa273ceb27ec1315",22913375,1,1,0,299,125,126,1
"ee48df95832b4374aa273ceb27ec1315","ee48df95832b4374aa273ceb27ec1315",22913375,1,0,1,300,126,126,0
"ee48df95832b4374aa273ceb27ec1315","7a439da90b394756ad1777fc4c6dead5",22913375,1,1,0,301,126,127,1
"7a439da90b394756ad1777fc4c6dead5","7a439da90b394756ad1777fc4c6dead5",22913375,1,0,1,302,127,127,0
"7a439da90b394756ad1777fc4c6dead5","779f9ddd1fd14d1e9e69f72219a1fdbd",22913375,1,-6,0,303,127,121,-6
"779f9ddd1fd14d1e9e69f72219a1fdbd","a8dd5213034441ac92724b4e83eb0bb2",22913375,2,9,0,304,121,129,8
"a8dd5213034441ac92724b4e83eb0bb2","a8dd5213034441ac92724b4e83eb0bb2",22913375,2,0,1,305,129,129,0
"a8dd5213034441ac92724b4e83eb0bb2","8115eab6556b45f5b415c3b8c26a12e5",22913375,1,2,0,307,129,131,2
"8115eab6556b45f5b415c3b8c26a12e5","8115eab6556b45f5b415c3b8c26a12e5",22913375,2,0,1,308,131,131,0
"8115eab6556b45f5b415c3b8c26a12e5","ec34b06efd844b46a4c4818ecdb9b8f4",22913375,1,1,0,310,131,132,1
"ec34b06efd844b46a4c4818ecdb9b8f4","ec34b06efd844b46a4c4818ecdb9b8f4",22913375,2,0,1,311,132,132,0
"ec34b06efd844b46a4c4818ecdb9b8f4","c2e1c2b9eac64109b343a088584b576b",22913375,1,1,0,313,132,133,1
"c2e1c2b9eac64109b343a088584b576b","c2e1c2b9eac64109b343a088584b576b",22913375,2,0,1,314,133,133,0
"c2e1c2b9eac64109b343a088584b576b","579338175e0b4bbb8ef3b712b5d8b54e",22913375,1,-5,0,316,133,128,-5
"579338175e0b4bbb8ef3b712b5d8b54e","8bc5795d6a984a3eace4e2811e52dd4f",22913375,1,8,0,317,128,135,7
"8bc5795d6a984a3eace4e2811e52dd4f","8bc5795d6a984a3eace4e2811e52dd4f",22913375,1,0,1,318,135,135,0
"8bc5795d6a984a3eace4e2811e52dd4f","b416d47c56a742199b5d7c7f19d6503a",22913375,1,-1,0,319,135,134,-1
"b416d47c56a742199b5d7c7f19d6503a","cd4532ad48034873ba8bce2aac0c9808",22913375,1,4,0,320,134,137,3
"cd4532ad48034873ba8bce2aac0c9808","cd4532ad48034873ba8bce2aac0c9808",22913375,2,0,1,321,137,137,0
"cd4532ad48034873ba8bce2aac0c9808","779f9ddd1fd14d1e9e69f72219a1fdbd",22913375,1,-19,0,323,137,121,-16
"779f9ddd1fd14d1e9e69f72219a1fdbd","df1de691dafe4549a18a4398ee9dfaf9",22913375,2,23,0,324,121,139,18
"df1de691dafe4549a18a4398ee9dfaf9","6c5ad271a44743479bfaea29b1db8d02",22913375,3,4,0,325,139,143,4
"6c5ad271a44743479bfaea29b1db8d02","6c5ad271a44743479bfaea29b1db8d02",22913375,1,0,1,326,143,143,0
"6c5ad271a44743479bfaea29b1db8d02","83d311bed5374fee83d8d67a7d9d82dc",22913375,1,1,0,327,143,144,1
"83d311bed5374fee83d8d67a7d9d82dc","83d311bed5374fee83d8d67a7d9d82dc",22913375,1,0,1,328,144,144,0
"83d311bed5374fee83d8d67a7d9d82dc","402bba41861d43acb52a5abb89e8831e",22913375,1,1,0,329,144,145,1
"402bba41861d43acb52a5abb89e8831e","402bba41861d43acb52a5abb89e8831e",22913375,2,0,1,330,145,145,0
"402bba41861d43acb52a5abb89e8831e","df1de691dafe4549a18a4398ee9dfaf9",22913375,1,-6,0,332,145,139,-6
"df1de691dafe4549a18a4398ee9dfaf9","8aae34f5ddbb4052a709b12e6b0d40fa",22913375,3,9,0,333,139,147,8
"8aae34f5ddbb4052a709b12e6b0d40fa","8aae34f5ddbb4052a709b12e6b0d40fa",22913375,5,0,1,334,147,147,0
"8aae34f5ddbb4052a709b12e6b0d40fa","645b3f0249f64f76af2e19eb4d0e55b7",22913375,1,2,0,339,147,149,2
"645b3f0249f64f76af2e19eb4d0e55b7","645b3f0249f64f76af2e19eb4d0e55b7",22913375,2,0,1,340,149,149,0
"645b3f0249f64f76af2e19eb4d0e55b7","7e7b8db5064d4369805ab370aac5ddfb",22913375,1,1,0,342,149,150,1
"7e7b8db5064d4369805ab370aac5ddfb","7e7b8db5064d4369805ab370aac5ddfb",22913375,2,0,1,343,150,150,0
"7e7b8db5064d4369805ab370aac5ddfb","8956d210ae7f41968fada86d4c979d6a",22913375,1,1,0,345,150,151,1
"8956d210ae7f41968fada86d4c979d6a","8956d210ae7f41968fada86d4c979d6a",22913375,5,0,1,346,151,151,0
"8956d210ae7f41968fada86d4c979d6a","f902b0f41b544d4dbf79664fd233648d",22913375,1,-5,0,351,151,146,-5
"f902b0f41b544d4dbf79664fd233648d","ae781e8b775e4ccd93bc800dad5c8376",22913375,1,8,0,352,146,153,7
"ae781e8b775e4ccd93bc800dad5c8376","ae781e8b775e4ccd93bc800dad5c8376",22913375,2,0,1,353,153,153,0
"ae781e8b775e4ccd93bc800dad5c8376","06882a8492d9499aa31555567f575ecb",22913375,1,1,0,355,153,154,1
"06882a8492d9499aa31555567f575ecb","06882a8492d9499aa31555567f575ecb",22913375,2,0,1,356,154,154,0
"06882a8492d9499aa31555567f575ecb","f293c508f409466a8f27ddd7d1e40b20",22913375,1,1,0,358,154,155,1
"f293c508f409466a8f27ddd7d1e40b20","f293c508f409466a8f27ddd7d1e40b20",22913375,2,0,1,359,155,155,0
"f293c508f409466a8f27ddd7d1e40b20","cc4ddef5bbbe48ebb605141b347c4ed1",22913375,1,1,0,361,155,156,1
"cc4ddef5bbbe48ebb605141b347c4ed1","cc4ddef5bbbe48ebb605141b347c4ed1",22913375,1,0,1,362,156,156,0
"cc4ddef5bbbe48ebb605141b347c4ed1","f03480cf4eba413194d7af52fc0e7f28",22913375,1,-4,0,363,156,152,-4
"f03480cf4eba413194d7af52fc0e7f28","d313cec988a84645bee413e8d4724a4b",22913375,2,7,0,364,152,158,6
"d313cec988a84645bee413e8d4724a4b","d313cec988a84645bee413e8d4724a4b",22913375,8,0,1,365,158,158,0
"d313cec988a84645bee413e8d4724a4b","dc60696c76a74368a60f72246e47700d",22913375,2,1,0,369,158,159,1
"dc60696c76a74368a60f72246e47700d","dc60696c76a74368a60f72246e47700d",22913375,2,0,1,370,159,159,0
"dc60696c76a74368a60f72246e47700d","df1de691dafe4549a18a4398ee9dfaf9",22913375,1,-23,0,371,159,139,-20
"6c5ad271a44743479bfaea29b1db8d02","df1de691dafe4549a18a4398ee9dfaf9",22913375,2,-4,0,373,143,139,-4
"8aae34f5ddbb4052a709b12e6b0d40fa","f902b0f41b544d4dbf79664fd233648d",22913375,2,-1,0,375,147,146,-1
"f902b0f41b544d4dbf79664fd233648d","f03480cf4eba413194d7af52fc0e7f28",22913375,1,7,0,376,146,152,6
"dc60696c76a74368a60f72246e47700d","779f9ddd1fd14d1e9e69f72219a1fdbd",22913375,1,-46,0,382,159,121,-38
"779f9ddd1fd14d1e9e69f72219a1fdbd","779f9ddd1fd14d1e9e69f72219a1fdbd",22913375,1,0,1,383,121,121,0
"a8dd5213034441ac92724b4e83eb0bb2","579338175e0b4bbb8ef3b712b5d8b54e",22913375,1,-1,0,385,129,128,-1
"579338175e0b4bbb8ef3b712b5d8b54e","b416d47c56a742199b5d7c7f19d6503a",22913375,1,7,0,386,128,134,6
"b416d47c56a742199b5d7c7f19d6503a","779f9ddd1fd14d1e9e69f72219a1fdbd",22913375,1,-15,0,387,134,121,-13
"f902b0f41b544d4dbf79664fd233648d","d313cec988a84645bee413e8d4724a4b",22913375,1,14,0,393,146,158,12
"d313cec988a84645bee413e8d4724a4b","f03480cf4eba413194d7af52fc0e7f28",22913375,1,-7,0,396,158,152,-6
"f03480cf4eba413194d7af52fc0e7f28","df1de691dafe4549a18a4398ee9dfaf9",22913375,1,-15,0,397,152,139,-13
"df1de691dafe4549a18a4398ee9dfaf9","df1de691dafe4549a18a4398ee9dfaf9",22913375,1,0,1,398,139,139,0
"df1de691dafe4549a18a4398ee9dfaf9","78adeee1fa2c4fe0bc73f7bca9fcee86",22913375,1,26,0,399,139,160,21
"78adeee1fa2c4fe0bc73f7bca9fcee86","78adeee1fa2c4fe0bc73f7bca9fcee86",22913375,1,0,1,400,160,160,0
"78adeee1fa2c4fe0bc73f7bca9fcee86","65202579580f4ad38d734b4ee39d22a8",22913375,5,5,0,401,160,164,4
"65202579580f4ad38d734b4ee39d22a8","65202579580f4ad38d734b4ee39d22a8",22913375,65,0,1,402,164,164,0
"65202579580f4ad38d734b4ee39d22a8","78adeee1fa2c4fe0bc73f7bca9fcee86",22913375,5,-5,0,404,164,160,-4
"65202579580f4ad38d734b4ee39d22a8","8959e6304a0348309a771e4d08d1b64a",22913375,1,-1,0,419,164,163,-1
"8959e6304a0348309a771e4d08d1b64a","65202579580f4ad38d734b4ee39d22a8",22913375,1,1,0,420,163,164,1
"78adeee1fa2c4fe0bc73f7bca9fcee86","3cbcea2be0984e7dbd5a48195af10ce7",22913375,1,8,0,478,160,165,5
"3cbcea2be0984e7dbd5a48195af10ce7","82e6285962b8400d9d6fc32436022a94",22913375,6,2,0,479,165,167,2
"82e6285962b8400d9d6fc32436022a94","a9ac840f098c4bd0a2ee896214ce29cd",22913375,2,3,0,480,167,168,1
"a9ac840f098c4bd0a2ee896214ce29cd","3cbcea2be0984e7dbd5a48195af10ce7",22913375,3,-5,0,481,168,165,-3
"3cbcea2be0984e7dbd5a48195af10ce7","a9ac840f098c4bd0a2ee896214ce29cd",22913375,2,5,0,482,165,168,3
"82e6285962b8400d9d6fc32436022a94","3cbcea2be0984e7dbd5a48195af10ce7",22913375,4,-2,0,485,167,165,-2
"a9ac840f098c4bd0a2ee896214ce29cd","a9ac840f098c4bd0a2ee896214ce29cd",22913375,2,0,1,487,168,168,0
"a9ac840f098c4bd0a2ee896214ce29cd","0c7262dff33c4087bc660ccf40f92f9c",22913375,1,4,0,498,168,169,1
"0c7262dff33c4087bc660ccf40f92f9c","b2275c3fad834f8d90737a2d9a6927d6",22913375,1,3,0,499,169,172,3
"b2275c3fad834f8d90737a2d9a6927d6","b7719e26494940efa49512aedd0aac79",22913375,1,-212,0,500,172,20,-152
"b7719e26494940efa49512aedd0aac79","b7719e26494940efa49512aedd0aac79",22913375,2,0,1,501,20,20,0
"b7719e26494940efa49512aedd0aac79","afbf7250b99d47bea07172749483ca97",22913375,2,12,0,502,20,28,8
"afbf7250b99d47bea07172749483ca97","b7719e26494940efa49512aedd0aac79",22913375,1,-12,0,503,28,20,-8
"b613861cecf84ffcab01afb23f660475","b613861cecf84ffcab01afb23f660475",23023961,4,0,1,1,1,1,0
"b613861cecf84ffcab01afb23f660475","e2911e79efc2420eac45d9f671463d4b",23023961,1,3,0,5,1,2,1
"e2911e79efc2420eac45d9f671463d4b","e2911e79efc2420eac45d9f671463d4b",23023961,2,0,1,6,2,2,0
"e2911e79efc2420eac45d9f671463d4b","519d1b8c59404d67b54e96c5c8a830b2",23023961,1,1,0,8,2,3,1
"519d1b8c59404d67b54e96c5c8a830b2","519d1b8c59404d67b54e96c5c8a830b2",23023961,1,0,1,9,3,3,0
"519d1b8c59404d67b54e96c5c8a830b2","531db53f81f646edb0cdcfe0085b03b7",23023961,1,1,0,10,3,4,1
"531db53f81f646edb0cdcfe0085b03b7","531db53f81f646edb0cdcfe0085b03b7",23023961,1,0,1,11,4,4,0
"531db53f81f646edb0cdcfe0085b03b7","4f5f94b2f95141e0a9d53a61da2276da",23023961,1,1,0,12,4,5,1
"4f5f94b2f95141e0a9d53a61da2276da","4f5f94b2f95141e0a9d53a61da2276da",23023961,1,0,1,13,5,5,0
"4f5f94b2f95141e0a9d53a61da2276da","6d541c89590949f99af293c4f2333f67",23023961,1,1,0,14,5,6,1
"6d541c89590949f99af293c4f2333f67","6d541c89590949f99af293c4f2333f67",23023961,1,0,1,15,6,6,0
"6d541c89590949f99af293c4f2333f67","dd5cf0b9fe4c4f1d8f5ff8e4c04879cb",23023961,1,1,0,16,6,7,1
"dd5cf0b9fe4c4f1d8f5ff8e4c04879cb","dd5cf0b9fe4c4f1d8f5ff8e4c04879cb",23023961,2,0,1,17,7,7,0
"dd5cf0b9fe4c4f1d8f5ff8e4c04879cb","f96261861edc426abe2248be4f0a709a",23023961,2,1,0,18,7,8,1
"f96261861edc426abe2248be4f0a709a","f96261861edc426abe2248be4f0a709a",23023961,2,0,1,19,8,8,0
"f96261861edc426abe2248be4f0a709a","66b5e16f4f75454fb5b8172079f0fa83",23023961,2,1,0,20,8,9,1
"66b5e16f4f75454fb5b8172079f0fa83","66b5e16f4f75454fb5b8172079f0fa83",23023961,2,0,1,21,9,9,0
"66b5e16f4f75454fb5b8172079f0fa83","0680571d4698477995e41842c36a54b2",23023961,2,1,0,22,9,10,1
"0680571d4698477995e41842c36a54b2","0680571d4698477995e41842c36a54b2",23023961,2,0,1,23,10,10,0
"0680571d4698477995e41842c36a54b2","e2911e79efc2420eac45d9f671463d4b",23023961,1,-8,0,24,10,2,-8
"e2911e79efc2420eac45d9f671463d4b","56586aa865414f538729c7f7735d2bc6",23023961,2,12,0,25,2,12,10
"56586aa865414f538729c7f7735d2bc6","9afd71a5298d4333b6849dfce1b9422c",23023961,2,13,0,26,12,18,6
"9afd71a5298d4333b6849dfce1b9422c","56586aa865414f538729c7f7735d2bc6",23023961,3,-13,0,27,18,12,-6
"56586aa865414f538729c7f7735d2bc6","e2911e79efc2420eac45d9f671463d4b",23023961,1,-12,0,30,12,2,-10
"e2911e79efc2420eac45d9f671463d4b","9112f2bffece48e08c6d2287be204085",23023961,1,9,0,31,2,11,9
"9112f2bffece48e08c6d2287be204085","dd5cf0b9fe4c4f1d8f5ff8e4c04879cb",23023961,1,-4,0,32,11,7,-4
"0680571d4698477995e41842c36a54b2","9112f2bffece48e08c6d2287be204085",23023961,1,1,0,40,10,11,1
"9112f2bffece48e08c6d2287be204085","9112f2bffece48e08c6d2287be204085",23023961,1,0,1,41,11,11,0
"9112f2bffece48e08c6d2287be204085","e2911e79efc2420eac45d9f671463d4b",23023961,1,-9,0,42,11,2,-9
"56586aa865414f538729c7f7735d2bc6","56586aa865414f538729c7f7735d2bc6",23023961,8,0,1,44,12,12,0
"56586aa865414f538729c7f7735d2bc6","b7f2b31585d94eb3bf86376714aa7070",23023961,1,2,0,52,12,13,1
"b7f2b31585d94eb3bf86376714aa7070","b7f2b31585d94eb3bf86376714aa7070",23023961,3,0,1,53,13,13,0
"b7f2b31585d94eb3bf86376714aa7070","3f1c815879794b929260d224becaff7e",23023961,1,2,0,56,13,14,1
"3f1c815879794b929260d224becaff7e","81c864a886d54a6b8ff85f7d736f4f95",23023961,1,2,0,57,14,15,1
"81c864a886d54a6b8ff85f7d736f4f95","5c5ceeee4562457ba6d41515aeebfbb1",23023961,1,4,0,58,15,17,2
"5c5ceeee4562457ba6d41515aeebfbb1","5c5ceeee4562457ba6d41515aeebfbb1",23023961,1,0,1,59,17,17,0
"5c5ceeee4562457ba6d41515aeebfbb1","9afd71a5298d4333b6849dfce1b9422c",23023961,1,3,0,60,17,18,1
"56586aa865414f538729c7f7735d2bc6","b7719e26494940efa49512aedd0aac79",23023961,1,17,0,62,12,20,8
"b7719e26494940efa49512aedd0aac79","9afd71a5298d4333b6849dfce1b9422c",23023961,1,-4,0,63,20,18,-2
"9afd71a5298d4333b6849dfce1b9422c","d4f45188d3c84a02ba08454e6403a818",23023961,1,9,0,64,18,24,6
"d4f45188d3c84a02ba08454e6403a818","d4c3b003e8274e429d2fa688d73fde6d",23023961,1,-2,0,65,24,22,-2
"d4c3b003e8274e429d2fa688d73fde6d","d4c3b003e8274e429d2fa688d73fde6d",23023961,7,0,1,66,22,22,0
"d4c3b003e8274e429d2fa688d73fde6d","b7719e26494940efa49512aedd0aac79",23023961,1,-3,0,73,22,20,-2
"b7719e26494940efa49512aedd0aac79","b7719e26494940efa49512aedd0aac79",23023961,1,0,1,74,20,20,0
"b7719e26494940efa49512aedd0aac79","afbf7250b99d47bea07172749483ca97",23023961,1,12,0,75,20,28,8
"afbf7250b99d47bea07172749483ca97","afbf7250b99d47bea07172749483ca97",23023961,1,0,1,76,28,28,0
"afbf7250b99d47bea07172749483ca97","4e51676dc72045d99c19b9fa7b22f8bc",23023961,1,3,0,77,28,29,1
"4e51676dc72045d99c19b9fa7b22f8bc","4e51676dc72045d99c19b9fa7b22f8bc",23023961,1,0,1,78,29,29,0
"4e51676dc72045d99c19b9fa7b22f8bc","51970cfa30e643e894e66ae85c8024cc",23023961,1,3,0,79,29,31,2
"51970cfa30e643e894e66ae85c8024cc","c33c17be71ae4d588da7369472e5bb1b",23023961,1,6,0,80,31,34,3
"c33c17be71ae4d588da7369472e5bb1b","4e51676dc72045d99c19b9fa7b22f8bc",23023961,1,-9,0,81,34,29,-5
"4e51676dc72045d99c19b9fa7b22f8bc","93679be414554a11b1893002f2229a93",23023961,1,12,0,82,29,35,6
"93679be414554a11b1893002f2229a93","c33c17be71ae4d588da7369472e5bb1b",23023961,1,-3,0,83,35,34,-1
"c33c17be71ae4d588da7369472e5bb1b","93679be414554a11b1893002f2229a93",23023961,1,3,0,84,34,35,1
"93679be414554a11b1893002f2229a93","7040a13096d746ac84b8fac8d9752058",23023961,1,3,0,85,35,36,1
"7040a13096d746ac84b8fac8d9752058","7040a13096d746ac84b8fac8d9752058",23023961,1,0,1,86,36,36,0
"7040a13096d746ac84b8fac8d9752058","9a0dc646f934470daf08c4b56ccf73db",23023961,1,3,0,87,36,37,1
"9a0dc646f934470daf08c4b56ccf73db","fc0e049d56024bc9a02c9a9c435c3df7",23023961,1,3,0,88,37,38,1
"fc0e049d56024bc9a02c9a9c435c3df7","9a0dc646f934470daf08c4b56ccf73db",23023961,1,-3,0,89,38,37,-1
"9a0dc646f934470daf08c4b56ccf73db","67a089198fcb4e1c8f2385786c2b296f",23023961,1,7,0,90,37,39,2
"67a089198fcb4e1c8f2385786c2b296f","fc0e049d56024bc9a02c9a9c435c3df7",23023961,1,-4,0,91,39,38,-1
"fc0e049d56024bc9a02c9a9c435c3df7","64d48c6c9c7940639a932219a6c87198",23023961,1,5,0,92,38,40,2
"64d48c6c9c7940639a932219a6c87198","64d48c6c9c7940639a932219a6c87198",23023961,2,0,1,93,40,40,0
"64d48c6c9c7940639a932219a6c87198","67a089198fcb4e1c8f2385786c2b296f",23023961,1,-1,0,95,40,39,-1
"67a089198fcb4e1c8f2385786c2b296f","b534b89233134e30a9b5645138bfa9ee",23023961,1,4,0,96,39,41,2
"b534b89233134e30a9b5645138bfa9ee","0e37b720d23b4e7f8b313e79313fd107",23023961,1,3,0,97,41,44,3
"0e37b720d23b4e7f8b313e79313fd107","0e37b720d23b4e7f8b313e79313fd107",23023961,1,0,1,98,44,44,0
"0e37b720d23b4e7f8b313e79313fd107","6875d67fdd5f48168b62719df449bebd",23023961,1,1,0,99,44,45,1
"6875d67fdd5f48168b62719df449bebd","6875d67fdd5f48168b62719df449bebd",23023961,1,0,1,100,45,45,0
"6875d67fdd5f48168b62719df449bebd","6e13d61a7bdb44bca949c9f86fab3be5",23023961,1,3,0,101,45,47,2
"6e13d61a7bdb44bca949c9f86fab3be5","b534b89233134e30a9b5645138bfa9ee",23023961,1,-7,0,102,47,41,-6
"b534b89233134e30a9b5645138bfa9ee","6e13d61a7bdb44bca949c9f86fab3be5",23023961,1,7,0,103,41,47,6
"6e13d61a7bdb44bca949c9f86fab3be5","6e13d61a7bdb44bca949c9f86fab3be5",23023961,2,0,1,104,47,47,0
"6e13d61a7bdb44bca949c9f86fab3be5","195f78799f984cc2b06c48dfe36be751",23023961,1,2,0,106,47,49,2
"195f78799f984cc2b06c48dfe36be751","195f78799f984cc2b06c48dfe36be751",23023961,5,0,1,107,49,49,0
"195f78799f984cc2b06c48dfe36be751","d9c8d8c444a64dadbbb508652c721e17",23023961,1,-3,0,112,49,46,-3
"d9c8d8c444a64dadbbb508652c721e17","d0c74f735e024943943e40333d6d337f",23023961,1,6,0,113,46,51,5
"d0c74f735e024943943e40333d6d337f","d0c74f735e024943943e40333d6d337f",23023961,1,0,1,114,51,51,0
"d0c74f735e024943943e40333d6d337f","983f8ff320594b279a7f4a6fe132f9c5",23023961,1,2,0,115,51,53,2
"983f8ff320594b279a7f4a6fe132f9c5","983f8ff320594b279a7f4a6fe132f9c5",23023961,2,0,1,116,53,53,0
"983f8ff320594b279a7f4a6fe132f9c5","35adfa5d923046aebabfefd98f35ff05",23023961,1,1,0,118,53,54,1
"35adfa5d923046aebabfefd98f35ff05","35adfa5d923046aebabfefd98f35ff05",23023961,5,0,1,119,54,54,0
"35adfa5d923046aebabfefd98f35ff05","b6f8a98476224da1b40e555ececc7ed8",23023961,1,1,0,124,54,55,1
"b6f8a98476224da1b40e555ececc7ed8","b6f8a98476224da1b40e555ececc7ed8",23023961,2,0,1,125,55,55,0
"b6f8a98476224da1b40e555ececc7ed8","86e22cb5fe0e4b47a9489ecddf7ed78f",23023961,1,1,0,127,55,56,1
"86e22cb5fe0e4b47a9489ecddf7ed78f","86e22cb5fe0e4b47a9489ecddf7ed78f",23023961,2,0,1,128,56,56,0
"86e22cb5fe0e4b47a9489ecddf7ed78f","f924752d8a1149668870b1e7698486f7",23023961,1,-6,0,130,56,50,-6
"f924752d8a1149668870b1e7698486f7","a1f2f12debe5432fb7a70bcd12bacfb9",23023961,1,9,0,131,50,58,8
"a1f2f12debe5432fb7a70bcd12bacfb9","78f30e4dcac84e3cbea8b2cc6e0d62b3",23023961,2,1,0,132,58,59,1
"78f30e4dcac84e3cbea8b2cc6e0d62b3","a1f2f12debe5432fb7a70bcd12bacfb9",23023961,1,-1,0,133,59,58,-1
"a1f2f12debe5432fb7a70bcd12bacfb9","a1f2f12debe5432fb7a70bcd12bacfb9",23023961,18,0,1,134,58,58,0
"78f30e4dcac84e3cbea8b2cc6e0d62b3","78f30e4dcac84e3cbea8b2cc6e0d62b3",23023961,8,0,1,153,59,59,0
"78f30e4dcac84e3cbea8b2cc6e0d62b3","a0a418b8540d479fa6e0f653b701da8b",23023961,1,6,0,161,59,64,5
"a0a418b8540d479fa6e0f653b701da8b","12aa6e1672ac4e7aa6449a7a8609cd72",23023961,1,-8,0,162,64,57,-7
"12aa6e1672ac4e7aa6449a7a8609cd72","bc42d26810654ea9a1df1efe1e58c7d5",23023961,1,7,0,163,57,63,6
"bc42d26810654ea9a1df1efe1e58c7d5","4c943503763e4e349906eea3ed3c8e86",23023961,1,-2,0,164,63,61,-2
"4c943503763e4e349906eea3ed3c8e86","4c943503763e4e349906eea3ed3c8e86",23023961,1,0,1,165,61,61,0
"4c943503763e4e349906eea3ed3c8e86","bc42d26810654ea9a1df1efe1e58c7d5",23023961,1,2,0,166,61,63,2
"bc42d26810654ea9a1df1efe1e58c7d5","bc42d26810654ea9a1df1efe1e58c7d5",23023961,4,0,1,167,63,63,0
"bc42d26810654ea9a1df1efe1e58c7d5","a0a418b8540d479fa6e0f653b701da8b",23023961,2,1,0,170,63,64,1
"a0a418b8540d479fa6e0f653b701da8b","a0a418b8540d479fa6e0f653b701da8b",23023961,5,0,1,171,64,64,0
"a0a418b8540d479fa6e0f653b701da8b","309ccf3cc4fe429d9bfbaef53d3fa479",23023961,2,-4,0,174,64,60,-4
"309ccf3cc4fe429d9bfbaef53d3fa479","bc42d26810654ea9a1df1efe1e58c7d5",23023961,1,3,0,175,60,63,3
"bc42d26810654ea9a1df1efe1e58c7d5","7af822066add4e7f8e007e4eee31a8bf",23023961,1,3,0,177,63,65,2
"7af822066add4e7f8e007e4eee31a8bf","bc42d26810654ea9a1df1efe1e58c7d5",23023961,1,-3,0,178,65,63,-2
"309ccf3cc4fe429d9bfbaef53d3fa479","d646286c8051419bbc2e31dd1db55ca8",23023961,1,10,0,183,60,67,7
"d646286c8051419bbc2e31dd1db55ca8","b534b89233134e30a9b5645138bfa9ee",23023961,1,-33,0,184,67,41,-26
"b534b89233134e30a9b5645138bfa9ee","267f883678b24aed855fde42524975d9",23023961,1,37,0,185,41,71,30
"267f883678b24aed855fde42524975d9","267f883678b24aed855fde42524975d9",23023961,1,0,1,186,71,71,0
"267f883678b24aed855fde42524975d9","88fff56d0342490dbef9040750a20f6c",23023961,1,1,0,187,71,72,1
"88fff56d0342490dbef9040750a20f6c","88fff56d0342490dbef9040750a20f6c",23023961,1,0,1,188,72,72,0
"88fff56d0342490dbef9040750a20f6c","adb17b12b66c4a49a85fd34322f7df70",23023961,1,1,0,189,72,73,1
"adb17b12b66c4a49a85fd34322f7df70","adb17b12b66c4a49a85fd34322f7df70",23023961,1,0,1,190,73,73,0
"adb17b12b66c4a49a85fd34322f7df70","a2becd407db34b189200a32546d9d569",23023961,1,3,0,191,73,75,2
"a2becd407db34b189200a32546d9d569","d646286c8051419bbc2e31dd1db55ca8",23023961,1,-9,0,192,75,67,-8
"d646286c8051419bbc2e31dd1db55ca8","a2becd407db34b189200a32546d9d569",23023961,1,9,0,193,67,75,8
"a2becd407db34b189200a32546d9d569","a2becd407db34b189200a32546d9d569",23023961,11,0,1,194,75,75,0
"a2becd407db34b189200a32546d9d569","58c22b011d0f4c2ea6d13615edbb9eeb",23023961,1,2,0,205,75,77,2
"58c22b011d0f4c2ea6d13615edbb9eeb","58c22b011d0f4c2ea6d13615edbb9eeb",23023961,5,0,1,206,77,77,0
"58c22b011d0f4c2ea6d13615edbb9eeb","dd76e1861dc9461c830888729d091ee0",23023961,1,1,0,211,77,78,1
"dd76e1861dc9461c830888729d091ee0","dd76e1861dc9461c830888729d091ee0",23023961,8,0,1,212,78,78,0
"dd76e1861dc9461c830888729d091ee0","cd1d828f1a694b87913a7ea66c23803e",23023961,1,1,0,220,78,79,1
"cd1d828f1a694b87913a7ea66c23803e","cd1d828f1a694b87913a7ea66c23803e",23023961,2,0,1,221,79,79,0
"cd1d828f1a694b87913a7ea66c23803e","9176a3c2b4d2465fa8b0c67096c2a97e",23023961,1,1,0,223,79,80,1
"9176a3c2b4d2465fa8b0c67096c2a97e","9176a3c2b4d2465fa8b0c67096c2a97e",23023961,11,0,1,224,80,80,0
"9176a3c2b4d2465fa8b0c67096c2a97e","f8ec6445f7194e25b9101d4fbcb07a18",23023961,1,1,0,235,80,81,1
"f8ec6445f7194e25b9101d4fbcb07a18","f8ec6445f7194e25b9101d4fbcb07a18",23023961,2,0,1,236,81,81,0
"f8ec6445f7194e25b9101d4fbcb07a18","140d5b27b8574befad82c0a013b59dfa",23023961,1,-7,0,238,81,74,-7
"140d5b27b8574befad82c0a013b59dfa","d18a9ea32855445f8736581f5cb119ce",23023961,1,9,0,239,74,82,8
"d18a9ea32855445f8736581f5cb119ce","f564483cbd7a407681aa2fcca518cf5f",23023961,1,4,0,240,82,85,3
"f564483cbd7a407681aa2fcca518cf5f","f564483cbd7a407681aa2fcca518cf5f",23023961,1,0,1,241,85,85,0
"f564483cbd7a407681aa2fcca518cf5f","18fd01350bd5434ca636d59a599d768a",23023961,1,1,0,242,85,86,1
"18fd01350bd5434ca636d59a599d768a","18fd01350bd5434ca636d59a599d768a",23023961,5,0,1,243,86,86,0
"18fd01350bd5434ca636d59a599d768a","6a9f0ef185fb47f0937e29daa1c71ed5",23023961,1,5,0,248,86,90,4
"6a9f0ef185fb47f0937e29daa1c71ed5","ae5ac430ea254e708a6f5deaaf7464ae",23023961,1,-7,0,249,90,84,-6
"ae5ac430ea254e708a6f5deaaf7464ae","c681290961c94c4caf23b529d1ae6b9a",23023961,1,5,0,250,84,88,4
"c681290961c94c4caf23b529d1ae6b9a","c681290961c94c4caf23b529d1ae6b9a",23023961,1,0,1,251,88,88,0
"c681290961c94c4caf23b529d1ae6b9a","6a9f0ef185fb47f0937e29daa1c71ed5",23023961,1,2,0,252,88,90,2
"6a9f0ef185fb47f0937e29daa1c71ed5","6a9f0ef185fb47f0937e29daa1c71ed5",23023961,3,0,1,253,90,90,0
"6a9f0ef185fb47f0937e29daa1c71ed5","e20db35ced8544ddac5bc3839145e463",23023961,1,3,0,256,90,91,1
"e20db35ced8544ddac5bc3839145e463","d646286c8051419bbc2e31dd1db55ca8",23023961,1,-30,0,257,91,67,-24
"d646286c8051419bbc2e31dd1db55ca8","67a089198fcb4e1c8f2385786c2b296f",23023961,1,-37,0,258,67,39,-28
"67a089198fcb4e1c8f2385786c2b296f","e20db35ced8544ddac5bc3839145e463",23023961,1,67,0,259,39,91,52
"e20db35ced8544ddac5bc3839145e463","e20db35ced8544ddac5bc3839145e463",23023961,1,0,1,260,91,91,0
"e20db35ced8544ddac5bc3839145e463","1febb706d7a34005ae8711ed49c76e64",23023961,1,3,0,261,91,94,3
"1febb706d7a34005ae8711ed49c76e64","1febb706d7a34005ae8711ed49c76e64",23023961,2,0,1,262,94,94,0
"1febb706d7a34005ae8711ed49c76e64","8f73ba6f5a0042f2850356ac38ac6f24",23023961,1,1,0,264,94,95,1
"8f73ba6f5a0042f2850356ac38ac6f24","8f73ba6f5a0042f2850356ac38ac6f24",23023961,5,0,1,265,95,95,0
"8f73ba6f5a0042f2850356ac38ac6f24","e2260b86653c46d7b14a41fb419dbf8c",23023961,1,1,0,270,95,96,1
"e2260b86653c46d7b14a41fb419dbf8c","e2260b86653c46d7b14a41fb419dbf8c",23023961,2,0,1,271,96,96,0
"e2260b86653c46d7b14a41fb419dbf8c","35eb641ad1d845bbba54915bce75a962",23023961,1,1,0,273,96,97,1
"35eb641ad1d845bbba54915bce75a962","35eb641ad1d845bbba54915bce75a962",23023961,5,0,1,274,97,97,0
"35eb641ad1d845bbba54915bce75a962","08be90ffbeea4795a138cd42ed8db56f",23023961,1,1,0,279,97,98,1
"08be90ffbeea4795a138cd42ed8db56f","08be90ffbeea4795a138cd42ed8db56f",23023961,5,0,1,280,98,98,0
"08be90ffbeea4795a138cd42ed8db56f","3007433c8f584dcbb5ac159c1c5f2be3",23023961,1,1,0,285,98,99,1
"3007433c8f584dcbb5ac159c1c5f2be3","3007433c8f584dcbb5ac159c1c5f2be3",23023961,5,0,1,286,99,99,0
"3007433c8f584dcbb5ac159c1c5f2be3","e20db35ced8544ddac5bc3839145e463",23023961,1,-8,0,291,99,91,-8
"e20db35ced8544ddac5bc3839145e463","00ae5f0c51874a73a41ebea838d95682",23023961,1,11,0,292,91,101,10
"00ae5f0c51874a73a41ebea838d95682","d391c8b6e56a43a7b654e9dee02d904b",23023961,2,2,0,293,101,103,2
"d391c8b6e56a43a7b654e9dee02d904b","00ae5f0c51874a73a41ebea838d95682",23023961,1,-2,0,294,103,101,-2
"00ae5f0c51874a73a41ebea838d95682","00ae5f0c51874a73a41ebea838d95682",23023961,1,0,1,295,101,101,0
"d391c8b6e56a43a7b654e9dee02d904b","d391c8b6e56a43a7b654e9dee02d904b",23023961,15,0,1,297,103,103,0
"d391c8b6e56a43a7b654e9dee02d904b","6111116566fc4fd9abba409322bea245",23023961,1,1,0,312,103,104,1
"6111116566fc4fd9abba409322bea245","6111116566fc4fd9abba409322bea245",23023961,2,0,1,313,104,104,0
"6111116566fc4fd9abba409322bea245","a81b2235cb9c499eb9ea8ee0a8dd9725",23023961,1,1,0,315,104,105,1
"a81b2235cb9c499eb9ea8ee0a8dd9725","a81b2235cb9c499eb9ea8ee0a8dd9725",23023961,5,0,1,316,105,105,0
"a81b2235cb9c499eb9ea8ee0a8dd9725","2d4e0ab0ef3b4d73b82c72d4621a7579",23023961,1,1,0,321,105,106,1
"2d4e0ab0ef3b4d73b82c72d4621a7579","2d4e0ab0ef3b4d73b82c72d4621a7579",23023961,2,0,1,322,106,106,0
"2d4e0ab0ef3b4d73b82c72d4621a7579","8bdebf492ebd4e62b0d522e8ab5e5197",23023961,1,1,0,324,106,107,1
"8bdebf492ebd4e62b0d522e8ab5e5197","8bdebf492ebd4e62b0d522e8ab5e5197",23023961,2,0,1,325,107,107,0
"8bdebf492ebd4e62b0d522e8ab5e5197","73039f8c1eb9409cb4caee2cf968001e",23023961,1,-7,0,327,107,100,-7
"73039f8c1eb9409cb4caee2cf968001e","4280927ec4d643238aa49c32f9e06c6c",23023961,1,10,0,328,100,109,9
"4280927ec4d643238aa49c32f9e06c6c","4280927ec4d643238aa49c32f9e06c6c",23023961,3,0,1,329,109,109,0
"4280927ec4d643238aa49c32f9e06c6c","fc44e6a5f7654430af1227838224dceb",23023961,1,2,0,332,109,111,2
"fc44e6a5f7654430af1227838224dceb","fc44e6a5f7654430af1227838224dceb",23023961,2,0,1,333,111,111,0
"fc44e6a5f7654430af1227838224dceb","08111f75e22d409998cf8b85bd431f0a",23023961,1,-3,0,335,111,108,-3
"08111f75e22d409998cf8b85bd431f0a","a9ae0a3c070d455bb4369a8996313336",23023961,1,7,0,336,108,114,6
"a9ae0a3c070d455bb4369a8996313336","a9ae0a3c070d455bb4369a8996313336",23023961,1,0,1,337,114,114,0
"a9ae0a3c070d455bb4369a8996313336","71cec822bcff4f30a20e75dc63ef7b65",23023961,1,2,0,338,114,116,2
"71cec822bcff4f30a20e75dc63ef7b65","71cec822bcff4f30a20e75dc63ef7b65",23023961,1,0,1,339,116,116,0
"71cec822bcff4f30a20e75dc63ef7b65","37319e88176d4aefa91d7a9980dbae91",23023961,1,-4,0,340,116,112,-4
"37319e88176d4aefa91d7a9980dbae91","62bff51286ef4f348717a3cf6fe2318f",23023961,1,9,0,341,112,120,8
"62bff51286ef4f348717a3cf6fe2318f","b1cd0e7dc3ad4a8eb91a4bfdbeb025b0",23023961,1,-2,0,342,120,118,-2
"b1cd0e7dc3ad4a8eb91a4bfdbeb025b0","b1cd0e7dc3ad4a8eb91a4bfdbeb025b0",23023961,1,0,1,343,118,118,0
"b1cd0e7dc3ad4a8eb91a4bfdbeb025b0","62bff51286ef4f348717a3cf6fe2318f",23023961,1,2,0,344,118,120,2
"62bff51286ef4f348717a3cf6fe2318f","62bff51286ef4f348717a3cf6fe2318f",23023961,3,0,1,345,120,120,0
"62bff51286ef4f348717a3cf6fe2318f","e20db35ced8544ddac5bc3839145e463",23023961,1,-33,0,348,120,91,-29
"e20db35ced8544ddac5bc3839145e463","779f9ddd1fd14d1e9e69f72219a1fdbd",23023961,1,36,0,349,91,121,30
"779f9ddd1fd14d1e9e69f72219a1fdbd","ae26e6cda8ad4a3f81bd347560d9579f",23023961,1,4,0,350,121,125,4
"ae26e6cda8ad4a3f81bd347560d9579f","ae26e6cda8ad4a3f81bd347560d9579f",23023961,3,0,1,351,125,125,0
"ae26e6cda8ad4a3f81bd347560d9579f","ee48df95832b4374aa273ceb27ec1315",23023961,1,1,0,354,125,126,1
"ee48df95832b4374aa273ceb27ec1315","ee48df95832b4374aa273ceb27ec1315",23023961,1,0,1,355,126,126,0
"ee48df95832b4374aa273ceb27ec1315","7a439da90b394756ad1777fc4c6dead5",23023961,1,1,0,356,126,127,1
"7a439da90b394756ad1777fc4c6dead5","7a439da90b394756ad1777fc4c6dead5",23023961,1,0,1,357,127,127,0
"7a439da90b394756ad1777fc4c6dead5","a8dd5213034441ac92724b4e83eb0bb2",23023961,1,3,0,358,127,129,2
"a8dd5213034441ac92724b4e83eb0bb2","779f9ddd1fd14d1e9e69f72219a1fdbd",23023961,1,-9,0,359,129,121,-8
"779f9ddd1fd14d1e9e69f72219a1fdbd","a8dd5213034441ac92724b4e83eb0bb2",23023961,1,9,0,360,121,129,8
"a8dd5213034441ac92724b4e83eb0bb2","a8dd5213034441ac92724b4e83eb0bb2",23023961,1,0,1,361,129,129,0
"a8dd5213034441ac92724b4e83eb0bb2","8115eab6556b45f5b415c3b8c26a12e5",23023961,1,2,0,362,129,131,2
"8115eab6556b45f5b415c3b8c26a12e5","8115eab6556b45f5b415c3b8c26a12e5",23023961,5,0,1,363,131,131,0
"8115eab6556b45f5b415c3b8c26a12e5","ec34b06efd844b46a4c4818ecdb9b8f4",23023961,1,1,0,368,131,132,1
"ec34b06efd844b46a4c4818ecdb9b8f4","ec34b06efd844b46a4c4818ecdb9b8f4",23023961,5,0,1,369,132,132,0
"ec34b06efd844b46a4c4818ecdb9b8f4","c2e1c2b9eac64109b343a088584b576b",23023961,1,1,0,374,132,133,1
"c2e1c2b9eac64109b343a088584b576b","c2e1c2b9eac64109b343a088584b576b",23023961,2,0,1,375,133,133,0
"c2e1c2b9eac64109b343a088584b576b","579338175e0b4bbb8ef3b712b5d8b54e",23023961,1,-5,0,377,133,128,-5
"579338175e0b4bbb8ef3b712b5d8b54e","8bc5795d6a984a3eace4e2811e52dd4f",23023961,1,8,0,378,128,135,7
"8bc5795d6a984a3eace4e2811e52dd4f","8bc5795d6a984a3eace4e2811e52dd4f",23023961,1,0,1,379,135,135,0
"8bc5795d6a984a3eace4e2811e52dd4f","b416d47c56a742199b5d7c7f19d6503a",23023961,1,-1,0,380,135,134,-1
"b416d47c56a742199b5d7c7f19d6503a","cd4532ad48034873ba8bce2aac0c9808",23023961,1,4,0,381,134,137,3
"cd4532ad48034873ba8bce2aac0c9808","cd4532ad48034873ba8bce2aac0c9808",23023961,2,0,1,382,137,137,0
"cd4532ad48034873ba8bce2aac0c9808","779f9ddd1fd14d1e9e69f72219a1fdbd",23023961,1,-19,0,384,137,121,-16
"779f9ddd1fd14d1e9e69f72219a1fdbd","df1de691dafe4549a18a4398ee9dfaf9",23023961,1,23,0,385,121,139,18
"df1de691dafe4549a18a4398ee9dfaf9","6c5ad271a44743479bfaea29b1db8d02",23023961,1,4,0,386,139,143,4
"6c5ad271a44743479bfaea29b1db8d02","6c5ad271a44743479bfaea29b1db8d02",23023961,2,0,1,387,143,143,0
"6c5ad271a44743479bfaea29b1db8d02","83d311bed5374fee83d8d67a7d9d82dc",23023961,1,1,0,389,143,144,1
"83d311bed5374fee83d8d67a7d9d82dc","83d311bed5374fee83d8d67a7d9d82dc",23023961,1,0,1,390,144,144,0
"83d311bed5374fee83d8d67a7d9d82dc","402bba41861d43acb52a5abb89e8831e",23023961,1,1,0,391,144,145,1
"402bba41861d43acb52a5abb89e8831e","402bba41861d43acb52a5abb89e8831e",23023961,2,0,1,392,145,145,0
"402bba41861d43acb52a5abb89e8831e","8aae34f5ddbb4052a709b12e6b0d40fa",23023961,1,3,0,394,145,147,2
"8aae34f5ddbb4052a709b12e6b0d40fa","df1de691dafe4549a18a4398ee9dfaf9",23023961,1,-9,0,395,147,139,-8
"df1de691dafe4549a18a4398ee9dfaf9","8aae34f5ddbb4052a709b12e6b0d40fa",23023961,1,9,0,396,139,147,8
"8aae34f5ddbb4052a709b12e6b0d40fa","8aae34f5ddbb4052a709b12e6b0d40fa",23023961,3,0,1,397,147,147,0
"8aae34f5ddbb4052a709b12e6b0d40fa","645b3f0249f64f76af2e19eb4d0e55b7",23023961,1,2,0,400,147,149,2
"645b3f0249f64f76af2e19eb4d0e55b7","645b3f0249f64f76af2e19eb4d0e55b7",23023961,8,0,1,401,149,149,0
"645b3f0249f64f76af2e19eb4d0e55b7","7e7b8db5064d4369805ab370aac5ddfb",23023961,1,1,0,409,149,150,1
"7e7b8db5064d4369805ab370aac5ddfb","7e7b8db5064d4369805ab370aac5ddfb",23023961,8,0,1,410,150,150,0
"7e7b8db5064d4369805ab370aac5ddfb","8956d210ae7f41968fada86d4c979d6a",23023961,1,1,0,418,150,151,1
"8956d210ae7f41968fada86d4c979d6a","8956d210ae7f41968fada86d4c979d6a",23023961,2,0,1,419,151,151,0
"8956d210ae7f41968fada86d4c979d6a","f902b0f41b544d4dbf79664fd233648d",23023961,1,-5,0,421,151,146,-5
"f902b0f41b544d4dbf79664fd233648d","ae781e8b775e4ccd93bc800dad5c8376",23023961,1,8,0,422,146,153,7
"ae781e8b775e4ccd93bc800dad5c8376","ae781e8b775e4ccd93bc800dad5c8376",23023961,2,0,1,423,153,153,0
"ae781e8b775e4ccd93bc800dad5c8376","06882a8492d9499aa31555567f575ecb",23023961,1,1,0,425,153,154,1
"06882a8492d9499aa31555567f575ecb","06882a8492d9499aa31555567f575ecb",23023961,1,0,1,426,154,154,0
"06882a8492d9499aa31555567f575ecb","f293c508f409466a8f27ddd7d1e40b20",23023961,1,1,0,427,154,155,1
"f293c508f409466a8f27ddd7d1e40b20","f293c508f409466a8f27ddd7d1e40b20",23023961,5,0,1,428,155,155,0
"f293c508f409466a8f27ddd7d1e40b20","cc4ddef5bbbe48ebb605141b347c4ed1",23023961,1,1,0,433,155,156,1
"cc4ddef5bbbe48ebb605141b347c4ed1","cc4ddef5bbbe48ebb605141b347c4ed1",23023961,5,0,1,434,156,156,0
"cc4ddef5bbbe48ebb605141b347c4ed1","d313cec988a84645bee413e8d4724a4b",23023961,1,3,0,439,156,158,2
"d313cec988a84645bee413e8d4724a4b","f03480cf4eba413194d7af52fc0e7f28",23023961,1,-7,0,440,158,152,-6
"f03480cf4eba413194d7af52fc0e7f28","d313cec988a84645bee413e8d4724a4b",23023961,1,7,0,441,152,158,6
"d313cec988a84645bee413e8d4724a4b","d313cec988a84645bee413e8d4724a4b",23023961,3,0,1,442,158,158,0
"d313cec988a84645bee413e8d4724a4b","dc60696c76a74368a60f72246e47700d",23023961,1,1,0,445,158,159,1
"dc60696c76a74368a60f72246e47700d","dc60696c76a74368a60f72246e47700d",23023961,1,0,1,446,159,159,0
"dc60696c76a74368a60f72246e47700d","df1de691dafe4549a18a4398ee9dfaf9",23023961,1,-23,0,447,159,139,-20
"df1de691dafe4549a18a4398ee9dfaf9","78adeee1fa2c4fe0bc73f7bca9fcee86",23023961,1,26,0,448,139,160,21
