"from","to","user_id","weight","dis","sl","seq_min","ordF","ordT","disRevised"
"b613861cecf84ffcab01afb23f660475","b613861cecf84ffcab01afb23f660475",15916291,3,0,1,1,1,1,0
"b613861cecf84ffcab01afb23f660475","e2911e79efc2420eac45d9f671463d4b",15916291,1,3,0,4,1,2,1
"e2911e79efc2420eac45d9f671463d4b","e2911e79efc2420eac45d9f671463d4b",15916291,2,0,1,5,2,2,0
"e2911e79efc2420eac45d9f671463d4b","519d1b8c59404d67b54e96c5c8a830b2",15916291,1,1,0,7,2,3,1
"519d1b8c59404d67b54e96c5c8a830b2","519d1b8c59404d67b54e96c5c8a830b2",15916291,1,0,1,8,3,3,0
"519d1b8c59404d67b54e96c5c8a830b2","531db53f81f646edb0cdcfe0085b03b7",15916291,1,1,0,9,3,4,1
"531db53f81f646edb0cdcfe0085b03b7","531db53f81f646edb0cdcfe0085b03b7",15916291,1,0,1,10,4,4,0
"531db53f81f646edb0cdcfe0085b03b7","4f5f94b2f95141e0a9d53a61da2276da",15916291,1,1,0,11,4,5,1
"4f5f94b2f95141e0a9d53a61da2276da","4f5f94b2f95141e0a9d53a61da2276da",15916291,1,0,1,12,5,5,0
"4f5f94b2f95141e0a9d53a61da2276da","6d541c89590949f99af293c4f2333f67",15916291,1,1,0,13,5,6,1
"6d541c89590949f99af293c4f2333f67","6d541c89590949f99af293c4f2333f67",15916291,1,0,1,14,6,6,0
"6d541c89590949f99af293c4f2333f67","dd5cf0b9fe4c4f1d8f5ff8e4c04879cb",15916291,1,1,0,15,6,7,1
"dd5cf0b9fe4c4f1d8f5ff8e4c04879cb","dd5cf0b9fe4c4f1d8f5ff8e4c04879cb",15916291,1,0,1,16,7,7,0
"dd5cf0b9fe4c4f1d8f5ff8e4c04879cb","f96261861edc426abe2248be4f0a709a",15916291,1,1,0,17,7,8,1
"f96261861edc426abe2248be4f0a709a","f96261861edc426abe2248be4f0a709a",15916291,1,0,1,18,8,8,0
"f96261861edc426abe2248be4f0a709a","66b5e16f4f75454fb5b8172079f0fa83",15916291,1,1,0,19,8,9,1
"66b5e16f4f75454fb5b8172079f0fa83","66b5e16f4f75454fb5b8172079f0fa83",15916291,1,0,1,20,9,9,0
"66b5e16f4f75454fb5b8172079f0fa83","9112f2bffece48e08c6d2287be204085",15916291,1,2,0,21,9,11,2
"9112f2bffece48e08c6d2287be204085","9112f2bffece48e08c6d2287be204085",15916291,1,0,1,22,11,11,0
"9112f2bffece48e08c6d2287be204085","0680571d4698477995e41842c36a54b2",15916291,1,-1,0,23,11,10,-1
"0680571d4698477995e41842c36a54b2","0680571d4698477995e41842c36a54b2",15916291,1,0,1,24,10,10,0
"0680571d4698477995e41842c36a54b2","e2911e79efc2420eac45d9f671463d4b",15916291,1,-8,0,25,10,2,-8
"e2911e79efc2420eac45d9f671463d4b","56586aa865414f538729c7f7735d2bc6",15916291,1,12,0,26,2,12,10
"56586aa865414f538729c7f7735d2bc6","56586aa865414f538729c7f7735d2bc6",15916291,11,0,1,27,12,12,0
"56586aa865414f538729c7f7735d2bc6","b7f2b31585d94eb3bf86376714aa7070",15916291,3,2,0,33,12,13,1
"b7f2b31585d94eb3bf86376714aa7070","b7f2b31585d94eb3bf86376714aa7070",15916291,4,0,1,34,13,13,0
"b7f2b31585d94eb3bf86376714aa7070","3f1c815879794b929260d224becaff7e",15916291,2,2,0,36,13,14,1
"3f1c815879794b929260d224becaff7e","56586aa865414f538729c7f7735d2bc6",15916291,1,-4,0,37,14,12,-2
"3f1c815879794b929260d224becaff7e","5c5ceeee4562457ba6d41515aeebfbb1",15916291,2,6,0,43,14,17,3
"5c5ceeee4562457ba6d41515aeebfbb1","56586aa865414f538729c7f7735d2bc6",15916291,1,-10,0,44,17,12,-5
"b7f2b31585d94eb3bf86376714aa7070","5c5ceeee4562457ba6d41515aeebfbb1",15916291,1,8,0,50,13,17,4
"5c5ceeee4562457ba6d41515aeebfbb1","3f1c815879794b929260d224becaff7e",15916291,1,-6,0,51,17,14,-3
"5c5ceeee4562457ba6d41515aeebfbb1","9afd71a5298d4333b6849dfce1b9422c",15916291,1,3,0,53,17,18,1
"9afd71a5298d4333b6849dfce1b9422c","56586aa865414f538729c7f7735d2bc6",15916291,1,-13,0,54,18,12,-6
"56586aa865414f538729c7f7735d2bc6","b7719e26494940efa49512aedd0aac79",15916291,1,17,0,55,12,20,8
"b7719e26494940efa49512aedd0aac79","9afd71a5298d4333b6849dfce1b9422c",15916291,1,-4,0,56,20,18,-2
"9afd71a5298d4333b6849dfce1b9422c","d4f45188d3c84a02ba08454e6403a818",15916291,1,9,0,57,18,24,6
"d4f45188d3c84a02ba08454e6403a818","d4c3b003e8274e429d2fa688d73fde6d",15916291,1,-2,0,58,24,22,-2
"d4c3b003e8274e429d2fa688d73fde6d","b7719e26494940efa49512aedd0aac79",15916291,1,-3,0,59,22,20,-2
"b7719e26494940efa49512aedd0aac79","afbf7250b99d47bea07172749483ca97",15916291,3,12,0,60,20,28,8
"afbf7250b99d47bea07172749483ca97","b7719e26494940efa49512aedd0aac79",15916291,2,-12,0,61,28,20,-8
"afbf7250b99d47bea07172749483ca97","4e51676dc72045d99c19b9fa7b22f8bc",15916291,2,3,0,63,28,29,1
"4e51676dc72045d99c19b9fa7b22f8bc","4e51676dc72045d99c19b9fa7b22f8bc",15916291,1,0,1,64,29,29,0
"4e51676dc72045d99c19b9fa7b22f8bc","51970cfa30e643e894e66ae85c8024cc",15916291,2,3,0,65,29,31,2
"51970cfa30e643e894e66ae85c8024cc","c33c17be71ae4d588da7369472e5bb1b",15916291,1,6,0,66,31,34,3
"c33c17be71ae4d588da7369472e5bb1b","4e51676dc72045d99c19b9fa7b22f8bc",15916291,2,-9,0,67,34,29,-5
"4e51676dc72045d99c19b9fa7b22f8bc","c33c17be71ae4d588da7369472e5bb1b",15916291,4,9,0,68,29,34,5
"c33c17be71ae4d588da7369472e5bb1b","93679be414554a11b1893002f2229a93",15916291,5,3,0,69,34,35,1
"93679be414554a11b1893002f2229a93","c33c17be71ae4d588da7369472e5bb1b",15916291,3,-3,0,70,35,34,-1
"93679be414554a11b1893002f2229a93","93679be414554a11b1893002f2229a93",15916291,1,0,1,72,35,35,0
"93679be414554a11b1893002f2229a93","7040a13096d746ac84b8fac8d9752058",15916291,1,3,0,75,35,36,1
"7040a13096d746ac84b8fac8d9752058","7040a13096d746ac84b8fac8d9752058",15916291,1,0,1,76,36,36,0
"7040a13096d746ac84b8fac8d9752058","9a0dc646f934470daf08c4b56ccf73db",15916291,1,3,0,77,36,37,1
"9a0dc646f934470daf08c4b56ccf73db","fc0e049d56024bc9a02c9a9c435c3df7",15916291,1,3,0,78,37,38,1
"fc0e049d56024bc9a02c9a9c435c3df7","9a0dc646f934470daf08c4b56ccf73db",15916291,1,-3,0,79,38,37,-1
"9a0dc646f934470daf08c4b56ccf73db","c9c52446b6294aa5a9c2abaed536c37e",15916291,1,-13,0,80,37,32,-5
"c9c52446b6294aa5a9c2abaed536c37e","4e51676dc72045d99c19b9fa7b22f8bc",15916291,2,-5,0,81,32,29,-3
"93679be414554a11b1893002f2229a93","a49d1bb4328949299686242fd0be5584",15916291,1,-25,0,86,35,21,-14
"a49d1bb4328949299686242fd0be5584","b7719e26494940efa49512aedd0aac79",15916291,1,-2,0,87,21,20,-1
"b7719e26494940efa49512aedd0aac79","4e51676dc72045d99c19b9fa7b22f8bc",15916291,1,15,0,90,20,29,9
"4e51676dc72045d99c19b9fa7b22f8bc","afbf7250b99d47bea07172749483ca97",15916291,1,-3,0,91,29,28,-1
"51970cfa30e643e894e66ae85c8024cc","c9c52446b6294aa5a9c2abaed536c37e",15916291,1,2,0,94,31,32,1
"c33c17be71ae4d588da7369472e5bb1b","c33c17be71ae4d588da7369472e5bb1b",15916291,1,0,1,97,34,34,0
"c33c17be71ae4d588da7369472e5bb1b","67a089198fcb4e1c8f2385786c2b296f",15916291,1,16,0,100,34,39,5
"67a089198fcb4e1c8f2385786c2b296f","67a089198fcb4e1c8f2385786c2b296f",15916291,2,0,1,101,39,39,0
"67a089198fcb4e1c8f2385786c2b296f","64d48c6c9c7940639a932219a6c87198",15916291,2,1,0,102,39,40,1
"64d48c6c9c7940639a932219a6c87198","a9ac840f098c4bd0a2ee896214ce29cd",15916291,1,164,0,103,40,168,128
"a9ac840f098c4bd0a2ee896214ce29cd","a9ac840f098c4bd0a2ee896214ce29cd",15916291,3,0,1,104,168,168,0
"a9ac840f098c4bd0a2ee896214ce29cd","78adeee1fa2c4fe0bc73f7bca9fcee86",15916291,1,-13,0,105,168,160,-8
"78adeee1fa2c4fe0bc73f7bca9fcee86","78adeee1fa2c4fe0bc73f7bca9fcee86",15916291,7,0,1,106,160,160,0
"78adeee1fa2c4fe0bc73f7bca9fcee86","65202579580f4ad38d734b4ee39d22a8",15916291,11,5,0,110,160,164,4
"65202579580f4ad38d734b4ee39d22a8","65202579580f4ad38d734b4ee39d22a8",15916291,99,0,1,111,164,164,0
"65202579580f4ad38d734b4ee39d22a8","78adeee1fa2c4fe0bc73f7bca9fcee86",15916291,8,-5,0,113,164,160,-4
"65202579580f4ad38d734b4ee39d22a8","8959e6304a0348309a771e4d08d1b64a",15916291,2,-1,0,119,164,163,-1
"8959e6304a0348309a771e4d08d1b64a","67a089198fcb4e1c8f2385786c2b296f",15916291,1,-156,0,120,163,39,-124
"64d48c6c9c7940639a932219a6c87198","64d48c6c9c7940639a932219a6c87198",15916291,1,0,1,123,40,40,0
"64d48c6c9c7940639a932219a6c87198","b534b89233134e30a9b5645138bfa9ee",15916291,1,3,0,124,40,41,1
"b534b89233134e30a9b5645138bfa9ee","67a089198fcb4e1c8f2385786c2b296f",15916291,1,-4,0,125,41,39,-2
"67a089198fcb4e1c8f2385786c2b296f","0e37b720d23b4e7f8b313e79313fd107",15916291,1,7,0,126,39,44,5
"0e37b720d23b4e7f8b313e79313fd107","0e37b720d23b4e7f8b313e79313fd107",15916291,1,0,1,127,44,44,0
"0e37b720d23b4e7f8b313e79313fd107","6875d67fdd5f48168b62719df449bebd",15916291,1,1,0,128,44,45,1
"6875d67fdd5f48168b62719df449bebd","6e13d61a7bdb44bca949c9f86fab3be5",15916291,2,3,0,129,45,47,2
"6e13d61a7bdb44bca949c9f86fab3be5","b534b89233134e30a9b5645138bfa9ee",15916291,1,-7,0,130,47,41,-6
"b534b89233134e30a9b5645138bfa9ee","6875d67fdd5f48168b62719df449bebd",15916291,1,4,0,131,41,45,4
"6e13d61a7bdb44bca949c9f86fab3be5","6e13d61a7bdb44bca949c9f86fab3be5",15916291,12,0,1,133,47,47,0
"6e13d61a7bdb44bca949c9f86fab3be5","195f78799f984cc2b06c48dfe36be751",15916291,1,2,0,139,47,49,2
"195f78799f984cc2b06c48dfe36be751","195f78799f984cc2b06c48dfe36be751",15916291,2,0,1,140,49,49,0
"195f78799f984cc2b06c48dfe36be751","d9c8d8c444a64dadbbb508652c721e17",15916291,1,-3,0,142,49,46,-3
"d9c8d8c444a64dadbbb508652c721e17","d0c74f735e024943943e40333d6d337f",15916291,1,6,0,143,46,51,5
"d0c74f735e024943943e40333d6d337f","35adfa5d923046aebabfefd98f35ff05",15916291,1,3,0,144,51,54,3
"35adfa5d923046aebabfefd98f35ff05","35adfa5d923046aebabfefd98f35ff05",15916291,2,0,1,145,54,54,0
"35adfa5d923046aebabfefd98f35ff05","b6f8a98476224da1b40e555ececc7ed8",15916291,1,1,0,147,54,55,1
"b6f8a98476224da1b40e555ececc7ed8","b6f8a98476224da1b40e555ececc7ed8",15916291,2,0,1,148,55,55,0
"b6f8a98476224da1b40e555ececc7ed8","86e22cb5fe0e4b47a9489ecddf7ed78f",15916291,1,1,0,150,55,56,1
"86e22cb5fe0e4b47a9489ecddf7ed78f","86e22cb5fe0e4b47a9489ecddf7ed78f",15916291,2,0,1,151,56,56,0
"86e22cb5fe0e4b47a9489ecddf7ed78f","983f8ff320594b279a7f4a6fe132f9c5",15916291,1,-3,0,153,56,53,-3
"983f8ff320594b279a7f4a6fe132f9c5","983f8ff320594b279a7f4a6fe132f9c5",15916291,2,0,1,154,53,53,0
"983f8ff320594b279a7f4a6fe132f9c5","d0c74f735e024943943e40333d6d337f",15916291,1,-2,0,156,53,51,-2
"d0c74f735e024943943e40333d6d337f","a1f2f12debe5432fb7a70bcd12bacfb9",15916291,1,8,0,157,51,58,7
"a1f2f12debe5432fb7a70bcd12bacfb9","f924752d8a1149668870b1e7698486f7",15916291,1,-9,0,158,58,50,-8
"f924752d8a1149668870b1e7698486f7","78f30e4dcac84e3cbea8b2cc6e0d62b3",15916291,2,10,0,159,50,59,9
"78f30e4dcac84e3cbea8b2cc6e0d62b3","a1f2f12debe5432fb7a70bcd12bacfb9",15916291,2,-1,0,160,59,58,-1
"a1f2f12debe5432fb7a70bcd12bacfb9","a1f2f12debe5432fb7a70bcd12bacfb9",15916291,19,0,1,161,58,58,0
"a1f2f12debe5432fb7a70bcd12bacfb9","12aa6e1672ac4e7aa6449a7a8609cd72",15916291,1,-1,0,164,58,57,-1
"12aa6e1672ac4e7aa6449a7a8609cd72","d0c74f735e024943943e40333d6d337f",15916291,1,-7,0,165,57,51,-6
"d0c74f735e024943943e40333d6d337f","d0c74f735e024943943e40333d6d337f",15916291,7,0,1,166,51,51,0
"d0c74f735e024943943e40333d6d337f","6e13d61a7bdb44bca949c9f86fab3be5",15916291,1,-5,0,173,51,47,-4
"6e13d61a7bdb44bca949c9f86fab3be5","f924752d8a1149668870b1e7698486f7",15916291,1,4,0,174,47,50,3
"f924752d8a1149668870b1e7698486f7","6e13d61a7bdb44bca949c9f86fab3be5",15916291,1,-4,0,175,50,47,-3
"6e13d61a7bdb44bca949c9f86fab3be5","d0c74f735e024943943e40333d6d337f",15916291,1,5,0,182,47,51,4
"d0c74f735e024943943e40333d6d337f","d9c8d8c444a64dadbbb508652c721e17",15916291,1,-6,0,183,51,46,-5
"d9c8d8c444a64dadbbb508652c721e17","f924752d8a1149668870b1e7698486f7",15916291,1,5,0,184,46,50,4
"a1f2f12debe5432fb7a70bcd12bacfb9","78f30e4dcac84e3cbea8b2cc6e0d62b3",15916291,1,1,0,203,58,59,1
"78f30e4dcac84e3cbea8b2cc6e0d62b3","78f30e4dcac84e3cbea8b2cc6e0d62b3",15916291,11,0,1,204,59,59,0
"78f30e4dcac84e3cbea8b2cc6e0d62b3","12aa6e1672ac4e7aa6449a7a8609cd72",15916291,1,-2,0,215,59,57,-2
"12aa6e1672ac4e7aa6449a7a8609cd72","bc42d26810654ea9a1df1efe1e58c7d5",15916291,1,7,0,216,57,63,6
"bc42d26810654ea9a1df1efe1e58c7d5","a0a418b8540d479fa6e0f653b701da8b",15916291,2,1,0,217,63,64,1
"a0a418b8540d479fa6e0f653b701da8b","4c943503763e4e349906eea3ed3c8e86",15916291,1,-3,0,218,64,61,-3
"4c943503763e4e349906eea3ed3c8e86","4c943503763e4e349906eea3ed3c8e86",15916291,1,0,1,219,61,61,0
"4c943503763e4e349906eea3ed3c8e86","bc42d26810654ea9a1df1efe1e58c7d5",15916291,1,2,0,220,61,63,2
"bc42d26810654ea9a1df1efe1e58c7d5","bc42d26810654ea9a1df1efe1e58c7d5",15916291,3,0,1,221,63,63,0
"a0a418b8540d479fa6e0f653b701da8b","a0a418b8540d479fa6e0f653b701da8b",15916291,3,0,1,225,64,64,0
"a0a418b8540d479fa6e0f653b701da8b","309ccf3cc4fe429d9bfbaef53d3fa479",15916291,1,-4,0,228,64,60,-4
"309ccf3cc4fe429d9bfbaef53d3fa479","d646286c8051419bbc2e31dd1db55ca8",15916291,1,10,0,229,60,67,7
"d646286c8051419bbc2e31dd1db55ca8","b534b89233134e30a9b5645138bfa9ee",15916291,1,-33,0,230,67,41,-26
"b534b89233134e30a9b5645138bfa9ee","267f883678b24aed855fde42524975d9",15916291,1,37,0,231,41,71,30
"267f883678b24aed855fde42524975d9","267f883678b24aed855fde42524975d9",15916291,1,0,1,232,71,71,0
"267f883678b24aed855fde42524975d9","88fff56d0342490dbef9040750a20f6c",15916291,1,1,0,233,71,72,1
"88fff56d0342490dbef9040750a20f6c","88fff56d0342490dbef9040750a20f6c",15916291,1,0,1,234,72,72,0
"88fff56d0342490dbef9040750a20f6c","adb17b12b66c4a49a85fd34322f7df70",15916291,1,1,0,235,72,73,1
"adb17b12b66c4a49a85fd34322f7df70","adb17b12b66c4a49a85fd34322f7df70",15916291,1,0,1,236,73,73,0
"adb17b12b66c4a49a85fd34322f7df70","d646286c8051419bbc2e31dd1db55ca8",15916291,1,-6,0,237,73,67,-6
"d646286c8051419bbc2e31dd1db55ca8","a2becd407db34b189200a32546d9d569",15916291,2,9,0,238,67,75,8
"a2becd407db34b189200a32546d9d569","d646286c8051419bbc2e31dd1db55ca8",15916291,2,-9,0,239,75,67,-8
"d646286c8051419bbc2e31dd1db55ca8","d646286c8051419bbc2e31dd1db55ca8",15916291,1,0,1,240,67,67,0
"d646286c8051419bbc2e31dd1db55ca8","58c22b011d0f4c2ea6d13615edbb9eeb",15916291,1,11,0,243,67,77,10
"58c22b011d0f4c2ea6d13615edbb9eeb","58c22b011d0f4c2ea6d13615edbb9eeb",15916291,2,0,1,244,77,77,0
"58c22b011d0f4c2ea6d13615edbb9eeb","dd76e1861dc9461c830888729d091ee0",15916291,1,1,0,246,77,78,1
"dd76e1861dc9461c830888729d091ee0","dd76e1861dc9461c830888729d091ee0",15916291,2,0,1,247,78,78,0
"dd76e1861dc9461c830888729d091ee0","cd1d828f1a694b87913a7ea66c23803e",15916291,1,1,0,249,78,79,1
"cd1d828f1a694b87913a7ea66c23803e","cd1d828f1a694b87913a7ea66c23803e",15916291,2,0,1,250,79,79,0
"cd1d828f1a694b87913a7ea66c23803e","f8ec6445f7194e25b9101d4fbcb07a18",15916291,1,2,0,252,79,81,2
"f8ec6445f7194e25b9101d4fbcb07a18","f8ec6445f7194e25b9101d4fbcb07a18",15916291,2,0,1,253,81,81,0
"f8ec6445f7194e25b9101d4fbcb07a18","a2becd407db34b189200a32546d9d569",15916291,1,-6,0,255,81,75,-6
"a2becd407db34b189200a32546d9d569","a2becd407db34b189200a32546d9d569",15916291,14,0,1,256,75,75,0
"a2becd407db34b189200a32546d9d569","140d5b27b8574befad82c0a013b59dfa",15916291,1,-1,0,270,75,74,-1
"140d5b27b8574befad82c0a013b59dfa","d18a9ea32855445f8736581f5cb119ce",15916291,1,9,0,271,74,82,8
"d18a9ea32855445f8736581f5cb119ce","f564483cbd7a407681aa2fcca518cf5f",15916291,1,4,0,272,82,85,3
"f564483cbd7a407681aa2fcca518cf5f","f564483cbd7a407681aa2fcca518cf5f",15916291,8,0,1,273,85,85,0
"f564483cbd7a407681aa2fcca518cf5f","18fd01350bd5434ca636d59a599d768a",15916291,1,1,0,281,85,86,1
"18fd01350bd5434ca636d59a599d768a","18fd01350bd5434ca636d59a599d768a",15916291,8,0,1,282,86,86,0
"18fd01350bd5434ca636d59a599d768a","6a9f0ef185fb47f0937e29daa1c71ed5",15916291,1,5,0,290,86,90,4
"6a9f0ef185fb47f0937e29daa1c71ed5","ae5ac430ea254e708a6f5deaaf7464ae",15916291,1,-7,0,291,90,84,-6
"ae5ac430ea254e708a6f5deaaf7464ae","c681290961c94c4caf23b529d1ae6b9a",15916291,1,5,0,292,84,88,4
"c681290961c94c4caf23b529d1ae6b9a","c681290961c94c4caf23b529d1ae6b9a",15916291,1,0,1,293,88,88,0
"c681290961c94c4caf23b529d1ae6b9a","6a9f0ef185fb47f0937e29daa1c71ed5",15916291,1,2,0,294,88,90,2
"6a9f0ef185fb47f0937e29daa1c71ed5","6a9f0ef185fb47f0937e29daa1c71ed5",15916291,3,0,1,295,90,90,0
"6a9f0ef185fb47f0937e29daa1c71ed5","e20db35ced8544ddac5bc3839145e463",15916291,1,3,0,298,90,91,1
"e20db35ced8544ddac5bc3839145e463","d646286c8051419bbc2e31dd1db55ca8",15916291,1,-30,0,299,91,67,-24
"d646286c8051419bbc2e31dd1db55ca8","3007433c8f584dcbb5ac159c1c5f2be3",15916291,1,38,0,300,67,99,32
"3007433c8f584dcbb5ac159c1c5f2be3","3007433c8f584dcbb5ac159c1c5f2be3",15916291,2,0,1,301,99,99,0
"3007433c8f584dcbb5ac159c1c5f2be3","08be90ffbeea4795a138cd42ed8db56f",15916291,1,-1,0,303,99,98,-1
"08be90ffbeea4795a138cd42ed8db56f","08be90ffbeea4795a138cd42ed8db56f",15916291,2,0,1,304,98,98,0
"08be90ffbeea4795a138cd42ed8db56f","35eb641ad1d845bbba54915bce75a962",15916291,1,-1,0,306,98,97,-1
"35eb641ad1d845bbba54915bce75a962","35eb641ad1d845bbba54915bce75a962",15916291,2,0,1,307,97,97,0
"35eb641ad1d845bbba54915bce75a962","e2260b86653c46d7b14a41fb419dbf8c",15916291,1,-1,0,309,97,96,-1
"e2260b86653c46d7b14a41fb419dbf8c","e2260b86653c46d7b14a41fb419dbf8c",15916291,2,0,1,310,96,96,0
"e2260b86653c46d7b14a41fb419dbf8c","8f73ba6f5a0042f2850356ac38ac6f24",15916291,1,-1,0,312,96,95,-1
"8f73ba6f5a0042f2850356ac38ac6f24","8f73ba6f5a0042f2850356ac38ac6f24",15916291,2,0,1,313,95,95,0
"8f73ba6f5a0042f2850356ac38ac6f24","1febb706d7a34005ae8711ed49c76e64",15916291,1,-1,0,315,95,94,-1
"1febb706d7a34005ae8711ed49c76e64","1febb706d7a34005ae8711ed49c76e64",15916291,2,0,1,316,94,94,0
"1febb706d7a34005ae8711ed49c76e64","e20db35ced8544ddac5bc3839145e463",15916291,1,-3,0,318,94,91,-3
"e20db35ced8544ddac5bc3839145e463","00ae5f0c51874a73a41ebea838d95682",15916291,1,11,0,319,91,101,10
"00ae5f0c51874a73a41ebea838d95682","d391c8b6e56a43a7b654e9dee02d904b",15916291,2,2,0,320,101,103,2
"d391c8b6e56a43a7b654e9dee02d904b","e20db35ced8544ddac5bc3839145e463",15916291,1,-13,0,321,103,91,-12
"e20db35ced8544ddac5bc3839145e463","e20db35ced8544ddac5bc3839145e463",15916291,2,0,1,322,91,91,0
"e20db35ced8544ddac5bc3839145e463","d391c8b6e56a43a7b654e9dee02d904b",15916291,1,13,0,324,91,103,12
"d391c8b6e56a43a7b654e9dee02d904b","00ae5f0c51874a73a41ebea838d95682",15916291,1,-2,0,325,103,101,-2
"00ae5f0c51874a73a41ebea838d95682","00ae5f0c51874a73a41ebea838d95682",15916291,2,0,1,326,101,101,0
"d391c8b6e56a43a7b654e9dee02d904b","d391c8b6e56a43a7b654e9dee02d904b",15916291,16,0,1,329,103,103,0
"d391c8b6e56a43a7b654e9dee02d904b","6111116566fc4fd9abba409322bea245",15916291,1,1,0,345,103,104,1
"6111116566fc4fd9abba409322bea245","6111116566fc4fd9abba409322bea245",15916291,2,0,1,346,104,104,0
"6111116566fc4fd9abba409322bea245","a81b2235cb9c499eb9ea8ee0a8dd9725",15916291,1,1,0,348,104,105,1
"a81b2235cb9c499eb9ea8ee0a8dd9725","a81b2235cb9c499eb9ea8ee0a8dd9725",15916291,2,0,1,349,105,105,0
"a81b2235cb9c499eb9ea8ee0a8dd9725","2d4e0ab0ef3b4d73b82c72d4621a7579",15916291,1,1,0,351,105,106,1
"2d4e0ab0ef3b4d73b82c72d4621a7579","2d4e0ab0ef3b4d73b82c72d4621a7579",15916291,2,0,1,352,106,106,0
"2d4e0ab0ef3b4d73b82c72d4621a7579","8bdebf492ebd4e62b0d522e8ab5e5197",15916291,1,1,0,354,106,107,1
"8bdebf492ebd4e62b0d522e8ab5e5197","8bdebf492ebd4e62b0d522e8ab5e5197",15916291,2,0,1,355,107,107,0
"8bdebf492ebd4e62b0d522e8ab5e5197","73039f8c1eb9409cb4caee2cf968001e",15916291,1,-7,0,357,107,100,-7
"73039f8c1eb9409cb4caee2cf968001e","4280927ec4d643238aa49c32f9e06c6c",15916291,1,10,0,358,100,109,9
"4280927ec4d643238aa49c32f9e06c6c","4280927ec4d643238aa49c32f9e06c6c",15916291,2,0,1,359,109,109,0
"4280927ec4d643238aa49c32f9e06c6c","fc44e6a5f7654430af1227838224dceb",15916291,1,2,0,361,109,111,2
"fc44e6a5f7654430af1227838224dceb","fc44e6a5f7654430af1227838224dceb",15916291,8,0,1,362,111,111,0
"fc44e6a5f7654430af1227838224dceb","a9ae0a3c070d455bb4369a8996313336",15916291,1,4,0,370,111,114,3
"a9ae0a3c070d455bb4369a8996313336","08111f75e22d409998cf8b85bd431f0a",15916291,1,-7,0,371,114,108,-6
"08111f75e22d409998cf8b85bd431f0a","a9ae0a3c070d455bb4369a8996313336",15916291,2,7,0,372,108,114,6
"a9ae0a3c070d455bb4369a8996313336","a9ae0a3c070d455bb4369a8996313336",15916291,3,0,1,373,114,114,0
"a9ae0a3c070d455bb4369a8996313336","4280927ec4d643238aa49c32f9e06c6c",15916291,1,-6,0,376,114,109,-5
"4280927ec4d643238aa49c32f9e06c6c","37319e88176d4aefa91d7a9980dbae91",15916291,1,4,0,377,109,112,3
"37319e88176d4aefa91d7a9980dbae91","08111f75e22d409998cf8b85bd431f0a",15916291,1,-5,0,378,112,108,-4
"a9ae0a3c070d455bb4369a8996313336","71cec822bcff4f30a20e75dc63ef7b65",15916291,1,2,0,380,114,116,2
"71cec822bcff4f30a20e75dc63ef7b65","71cec822bcff4f30a20e75dc63ef7b65",15916291,5,0,1,381,116,116,0
"71cec822bcff4f30a20e75dc63ef7b65","37319e88176d4aefa91d7a9980dbae91",15916291,1,-4,0,386,116,112,-4
"37319e88176d4aefa91d7a9980dbae91","62bff51286ef4f348717a3cf6fe2318f",15916291,1,9,0,387,112,120,8
"62bff51286ef4f348717a3cf6fe2318f","b1cd0e7dc3ad4a8eb91a4bfdbeb025b0",15916291,1,-2,0,388,120,118,-2
"b1cd0e7dc3ad4a8eb91a4bfdbeb025b0","b1cd0e7dc3ad4a8eb91a4bfdbeb025b0",15916291,1,0,1,389,118,118,0
"b1cd0e7dc3ad4a8eb91a4bfdbeb025b0","62bff51286ef4f348717a3cf6fe2318f",15916291,1,2,0,390,118,120,2
"62bff51286ef4f348717a3cf6fe2318f","62bff51286ef4f348717a3cf6fe2318f",15916291,3,0,1,391,120,120,0
"62bff51286ef4f348717a3cf6fe2318f","779f9ddd1fd14d1e9e69f72219a1fdbd",15916291,1,3,0,394,120,121,1
"779f9ddd1fd14d1e9e69f72219a1fdbd","e20db35ced8544ddac5bc3839145e463",15916291,1,-36,0,395,121,91,-30
"e20db35ced8544ddac5bc3839145e463","ae26e6cda8ad4a3f81bd347560d9579f",15916291,1,40,0,396,91,125,34
"ae26e6cda8ad4a3f81bd347560d9579f","ae26e6cda8ad4a3f81bd347560d9579f",15916291,1,0,1,397,125,125,0
"ae26e6cda8ad4a3f81bd347560d9579f","ee48df95832b4374aa273ceb27ec1315",15916291,1,1,0,398,125,126,1
"ee48df95832b4374aa273ceb27ec1315","ee48df95832b4374aa273ceb27ec1315",15916291,1,0,1,399,126,126,0
"ee48df95832b4374aa273ceb27ec1315","7a439da90b394756ad1777fc4c6dead5",15916291,1,1,0,400,126,127,1
"7a439da90b394756ad1777fc4c6dead5","7a439da90b394756ad1777fc4c6dead5",15916291,1,0,1,401,127,127,0
"7a439da90b394756ad1777fc4c6dead5","a8dd5213034441ac92724b4e83eb0bb2",15916291,1,3,0,402,127,129,2
"a8dd5213034441ac92724b4e83eb0bb2","779f9ddd1fd14d1e9e69f72219a1fdbd",15916291,1,-9,0,403,129,121,-8
"779f9ddd1fd14d1e9e69f72219a1fdbd","a8dd5213034441ac92724b4e83eb0bb2",15916291,1,9,0,404,121,129,8
"a8dd5213034441ac92724b4e83eb0bb2","8115eab6556b45f5b415c3b8c26a12e5",15916291,1,2,0,405,129,131,2
"8115eab6556b45f5b415c3b8c26a12e5","8115eab6556b45f5b415c3b8c26a12e5",15916291,2,0,1,406,131,131,0
"8115eab6556b45f5b415c3b8c26a12e5","ec34b06efd844b46a4c4818ecdb9b8f4",15916291,1,1,0,408,131,132,1
"ec34b06efd844b46a4c4818ecdb9b8f4","ec34b06efd844b46a4c4818ecdb9b8f4",15916291,2,0,1,409,132,132,0
"ec34b06efd844b46a4c4818ecdb9b8f4","c2e1c2b9eac64109b343a088584b576b",15916291,1,1,0,411,132,133,1
"c2e1c2b9eac64109b343a088584b576b","c2e1c2b9eac64109b343a088584b576b",15916291,8,0,1,412,133,133,0
"c2e1c2b9eac64109b343a088584b576b","579338175e0b4bbb8ef3b712b5d8b54e",15916291,1,-5,0,420,133,128,-5
"579338175e0b4bbb8ef3b712b5d8b54e","8bc5795d6a984a3eace4e2811e52dd4f",15916291,1,8,0,421,128,135,7
"8bc5795d6a984a3eace4e2811e52dd4f","8bc5795d6a984a3eace4e2811e52dd4f",15916291,1,0,1,422,135,135,0
"8bc5795d6a984a3eace4e2811e52dd4f","b416d47c56a742199b5d7c7f19d6503a",15916291,1,-1,0,423,135,134,-1
"b416d47c56a742199b5d7c7f19d6503a","cd4532ad48034873ba8bce2aac0c9808",15916291,1,4,0,424,134,137,3
"cd4532ad48034873ba8bce2aac0c9808","cd4532ad48034873ba8bce2aac0c9808",15916291,1,0,1,425,137,137,0
"cd4532ad48034873ba8bce2aac0c9808","779f9ddd1fd14d1e9e69f72219a1fdbd",15916291,1,-19,0,426,137,121,-16
"779f9ddd1fd14d1e9e69f72219a1fdbd","df1de691dafe4549a18a4398ee9dfaf9",15916291,1,23,0,427,121,139,18
"df1de691dafe4549a18a4398ee9dfaf9","6c5ad271a44743479bfaea29b1db8d02",15916291,2,4,0,428,139,143,4
"6c5ad271a44743479bfaea29b1db8d02","78adeee1fa2c4fe0bc73f7bca9fcee86",15916291,1,22,0,429,143,160,17
"8959e6304a0348309a771e4d08d1b64a","78adeee1fa2c4fe0bc73f7bca9fcee86",15916291,1,-4,0,440,163,160,-3
"78adeee1fa2c4fe0bc73f7bca9fcee86","df1de691dafe4549a18a4398ee9dfaf9",15916291,1,-26,0,441,160,139,-21
"df1de691dafe4549a18a4398ee9dfaf9","d313cec988a84645bee413e8d4724a4b",15916291,1,22,0,442,139,158,19
"d313cec988a84645bee413e8d4724a4b","df1de691dafe4549a18a4398ee9dfaf9",15916291,1,-22,0,443,158,139,-19
"df1de691dafe4549a18a4398ee9dfaf9","df1de691dafe4549a18a4398ee9dfaf9",15916291,1,0,1,444,139,139,0
"6c5ad271a44743479bfaea29b1db8d02","402bba41861d43acb52a5abb89e8831e",15916291,1,2,0,446,143,145,2
"402bba41861d43acb52a5abb89e8831e","402bba41861d43acb52a5abb89e8831e",15916291,5,0,1,447,145,145,0
"402bba41861d43acb52a5abb89e8831e","83d311bed5374fee83d8d67a7d9d82dc",15916291,1,-1,0,452,145,144,-1
"83d311bed5374fee83d8d67a7d9d82dc","83d311bed5374fee83d8d67a7d9d82dc",15916291,1,0,1,453,144,144,0
"83d311bed5374fee83d8d67a7d9d82dc","6c5ad271a44743479bfaea29b1db8d02",15916291,1,-1,0,454,144,143,-1
"6c5ad271a44743479bfaea29b1db8d02","df1de691dafe4549a18a4398ee9dfaf9",15916291,1,-4,0,455,143,139,-4
"df1de691dafe4549a18a4398ee9dfaf9","8aae34f5ddbb4052a709b12e6b0d40fa",15916291,1,9,0,456,139,147,8
"8aae34f5ddbb4052a709b12e6b0d40fa","7e7b8db5064d4369805ab370aac5ddfb",15916291,1,3,0,457,147,150,3
"7e7b8db5064d4369805ab370aac5ddfb","645b3f0249f64f76af2e19eb4d0e55b7",15916291,1,-1,0,458,150,149,-1
"645b3f0249f64f76af2e19eb4d0e55b7","645b3f0249f64f76af2e19eb4d0e55b7",15916291,2,0,1,459,149,149,0
"645b3f0249f64f76af2e19eb4d0e55b7","7e7b8db5064d4369805ab370aac5ddfb",15916291,1,1,0,461,149,150,1
"7e7b8db5064d4369805ab370aac5ddfb","7e7b8db5064d4369805ab370aac5ddfb",15916291,1,0,1,462,150,150,0
"7e7b8db5064d4369805ab370aac5ddfb","8956d210ae7f41968fada86d4c979d6a",15916291,1,1,0,463,150,151,1
"8956d210ae7f41968fada86d4c979d6a","8956d210ae7f41968fada86d4c979d6a",15916291,2,0,1,464,151,151,0
"8956d210ae7f41968fada86d4c979d6a","8aae34f5ddbb4052a709b12e6b0d40fa",15916291,1,-4,0,466,151,147,-4
"8aae34f5ddbb4052a709b12e6b0d40fa","8aae34f5ddbb4052a709b12e6b0d40fa",15916291,22,0,1,467,147,147,0
"8aae34f5ddbb4052a709b12e6b0d40fa","f902b0f41b544d4dbf79664fd233648d",15916291,1,-1,0,489,147,146,-1
"f902b0f41b544d4dbf79664fd233648d","ae781e8b775e4ccd93bc800dad5c8376",15916291,1,8,0,490,146,153,7
"ae781e8b775e4ccd93bc800dad5c8376","ae781e8b775e4ccd93bc800dad5c8376",15916291,5,0,1,491,153,153,0
"ae781e8b775e4ccd93bc800dad5c8376","06882a8492d9499aa31555567f575ecb",15916291,1,1,0,496,153,154,1
"06882a8492d9499aa31555567f575ecb","06882a8492d9499aa31555567f575ecb",15916291,1,0,1,497,154,154,0
"06882a8492d9499aa31555567f575ecb","f293c508f409466a8f27ddd7d1e40b20",15916291,1,1,0,498,154,155,1
"f293c508f409466a8f27ddd7d1e40b20","f293c508f409466a8f27ddd7d1e40b20",15916291,9,0,1,499,155,155,0
"f293c508f409466a8f27ddd7d1e40b20","cc4ddef5bbbe48ebb605141b347c4ed1",15916291,1,1,0,508,155,156,1
"cc4ddef5bbbe48ebb605141b347c4ed1","cc4ddef5bbbe48ebb605141b347c4ed1",15916291,3,0,1,509,156,156,0
"cc4ddef5bbbe48ebb605141b347c4ed1","d313cec988a84645bee413e8d4724a4b",15916291,1,3,0,512,156,158,2
"d313cec988a84645bee413e8d4724a4b","f03480cf4eba413194d7af52fc0e7f28",15916291,1,-7,0,513,158,152,-6
"f03480cf4eba413194d7af52fc0e7f28","d313cec988a84645bee413e8d4724a4b",15916291,1,7,0,514,152,158,6
"d313cec988a84645bee413e8d4724a4b","d313cec988a84645bee413e8d4724a4b",15916291,3,0,1,515,158,158,0
"d313cec988a84645bee413e8d4724a4b","dc60696c76a74368a60f72246e47700d",15916291,1,1,0,518,158,159,1
"dc60696c76a74368a60f72246e47700d","dc60696c76a74368a60f72246e47700d",15916291,1,0,1,519,159,159,0
"dc60696c76a74368a60f72246e47700d","df1de691dafe4549a18a4398ee9dfaf9",15916291,1,-23,0,520,159,139,-20
"df1de691dafe4549a18a4398ee9dfaf9","78adeee1fa2c4fe0bc73f7bca9fcee86",15916291,1,26,0,521,139,160,21
"78adeee1fa2c4fe0bc73f7bca9fcee86","3cbcea2be0984e7dbd5a48195af10ce7",15916291,2,8,0,532,160,165,5
"3cbcea2be0984e7dbd5a48195af10ce7","82e6285962b8400d9d6fc32436022a94",15916291,3,2,0,533,165,167,2
"82e6285962b8400d9d6fc32436022a94","82e6285962b8400d9d6fc32436022a94",15916291,1,0,1,534,167,167,0
"82e6285962b8400d9d6fc32436022a94","3cbcea2be0984e7dbd5a48195af10ce7",15916291,4,-2,0,535,167,165,-2
"3cbcea2be0984e7dbd5a48195af10ce7","3cbcea2be0984e7dbd5a48195af10ce7",15916291,1,0,1,536,165,165,0
"3cbcea2be0984e7dbd5a48195af10ce7","a9ac840f098c4bd0a2ee896214ce29cd",15916291,4,5,0,539,165,168,3
"a9ac840f098c4bd0a2ee896214ce29cd","0c7262dff33c4087bc660ccf40f92f9c",15916291,5,4,0,541,168,169,1
"0c7262dff33c4087bc660ccf40f92f9c","b2275c3fad834f8d90737a2d9a6927d6",15916291,4,3,0,542,169,172,3
"b2275c3fad834f8d90737a2d9a6927d6","0c7262dff33c4087bc660ccf40f92f9c",15916291,2,-3,0,543,172,169,-3
"0c7262dff33c4087bc660ccf40f92f9c","a9ac840f098c4bd0a2ee896214ce29cd",15916291,3,-4,0,544,169,168,-1
"a9ac840f098c4bd0a2ee896214ce29cd","3cbcea2be0984e7dbd5a48195af10ce7",15916291,1,-5,0,545,168,165,-3
"a9ac840f098c4bd0a2ee896214ce29cd","82e6285962b8400d9d6fc32436022a94",15916291,1,-3,0,547,168,167,-1
"a9ac840f098c4bd0a2ee896214ce29cd","b2275c3fad834f8d90737a2d9a6927d6",15916291,1,7,0,552,168,172,4
"b2275c3fad834f8d90737a2d9a6927d6","78adeee1fa2c4fe0bc73f7bca9fcee86",15916291,1,-20,0,553,172,160,-12
"78adeee1fa2c4fe0bc73f7bca9fcee86","8959e6304a0348309a771e4d08d1b64a",15916291,1,4,0,573,160,163,3
"8959e6304a0348309a771e4d08d1b64a","65202579580f4ad38d734b4ee39d22a8",15916291,1,1,0,574,163,164,1
"65202579580f4ad38d734b4ee39d22a8","3cbcea2be0984e7dbd5a48195af10ce7",15916291,2,3,0,628,164,165,1
"3cbcea2be0984e7dbd5a48195af10ce7","78adeee1fa2c4fe0bc73f7bca9fcee86",15916291,2,-8,0,629,165,160,-5
"78adeee1fa2c4fe0bc73f7bca9fcee86","82e6285962b8400d9d6fc32436022a94",15916291,2,10,0,630,160,167,7
"82e6285962b8400d9d6fc32436022a94","78adeee1fa2c4fe0bc73f7bca9fcee86",15916291,1,-10,0,631,167,160,-7
"0c7262dff33c4087bc660ccf40f92f9c","0c7262dff33c4087bc660ccf40f92f9c",15916291,1,0,1,651,169,169,0
"b2275c3fad834f8d90737a2d9a6927d6","a9ac840f098c4bd0a2ee896214ce29cd",15916291,1,-7,0,653,172,168,-4
"b2275c3fad834f8d90737a2d9a6927d6","b2275c3fad834f8d90737a2d9a6927d6",15916291,22,0,1,658,172,172,0
"b2275c3fad834f8d90737a2d9a6927d6","eb515a26030b41f8a82a1e6114420bad",15916291,1,1,0,680,172,173,1
"eb515a26030b41f8a82a1e6114420bad","eb515a26030b41f8a82a1e6114420bad",15916291,2,0,1,681,173,173,0
"eb515a26030b41f8a82a1e6114420bad","0c7262dff33c4087bc660ccf40f92f9c",15916291,1,-4,0,683,173,169,-4
"0c7262dff33c4087bc660ccf40f92f9c","b42cc17b7de840f181a704558d0bc845",15916291,1,7,0,684,169,175,6
"b42cc17b7de840f181a704558d0bc845","b42cc17b7de840f181a704558d0bc845",15916291,28,0,1,685,175,175,0
"b42cc17b7de840f181a704558d0bc845","801f9e9135034f49bf5f8b4bdefedb41",15916291,1,2,0,713,175,177,2
"801f9e9135034f49bf5f8b4bdefedb41","801f9e9135034f49bf5f8b4bdefedb41",15916291,4,0,1,714,177,177,0
"801f9e9135034f49bf5f8b4bdefedb41","ea38cc0e6e6e41edbabf210220808bf9",15916291,1,3,0,718,177,179,2
"ea38cc0e6e6e41edbabf210220808bf9","b87c552dd247427abe6ab5795b9c9d43",15916291,2,2,0,719,179,181,2
"b87c552dd247427abe6ab5795b9c9d43","362fcb0699a14845ab29b2340093e528",15916291,1,-8,0,720,181,174,-7
"362fcb0699a14845ab29b2340093e528","ea38cc0e6e6e41edbabf210220808bf9",15916291,1,6,0,721,174,179,5
"b87c552dd247427abe6ab5795b9c9d43","b87c552dd247427abe6ab5795b9c9d43",15916291,8,0,1,723,181,181,0
"b87c552dd247427abe6ab5795b9c9d43","139b097acfca451689d80c9c6eebdf7b",15916291,1,-3,0,731,181,178,-3
"139b097acfca451689d80c9c6eebdf7b","30f660a1feb34582a739722532524f79",15916291,1,6,0,732,178,183,5
"30f660a1feb34582a739722532524f79","30f660a1feb34582a739722532524f79",15916291,10,0,1,733,183,183,0
"30f660a1feb34582a739722532524f79","2024b4885bd14338a39b7b509acbbd02",15916291,1,-1,0,743,183,182,-1
"2024b4885bd14338a39b7b509acbbd02","c3f63fe50d8e487c86bf8ef76c9cadd3",15916291,1,4,0,744,182,185,3
"c3f63fe50d8e487c86bf8ef76c9cadd3","c3f63fe50d8e487c86bf8ef76c9cadd3",15916291,1,0,1,745,185,185,0
"c3f63fe50d8e487c86bf8ef76c9cadd3","c8e371568a0c4391b25796ae4e91952e",15916291,1,3,0,746,185,186,1
"c8e371568a0c4391b25796ae4e91952e","0c7262dff33c4087bc660ccf40f92f9c",15916291,1,-23,0,747,186,169,-17
"0c7262dff33c4087bc660ccf40f92f9c","7d932b23e1c84326ae5aa4d3c0d813d1",15916291,1,25,0,748,169,188,19
"7d932b23e1c84326ae5aa4d3c0d813d1","7d932b23e1c84326ae5aa4d3c0d813d1",15916291,1,0,1,749,188,188,0
"7d932b23e1c84326ae5aa4d3c0d813d1","c8e371568a0c4391b25796ae4e91952e",15916291,1,-2,0,750,188,186,-2
"c8e371568a0c4391b25796ae4e91952e","ab11d94c6c8948ea90b88f19d2cd502b",15916291,1,5,0,751,186,190,4
"ab11d94c6c8948ea90b88f19d2cd502b","ab11d94c6c8948ea90b88f19d2cd502b",15916291,6,0,1,752,190,190,0
"ab11d94c6c8948ea90b88f19d2cd502b","f992451ed6ad4e68bb9e68ad6be7c4be",15916291,1,2,0,758,190,192,2
"f992451ed6ad4e68bb9e68ad6be7c4be","f992451ed6ad4e68bb9e68ad6be7c4be",15916291,1,0,1,759,192,192,0
"f992451ed6ad4e68bb9e68ad6be7c4be","6cd2dcaac46847d4a0bc53f296d90375",15916291,1,3,0,760,192,194,2
"6cd2dcaac46847d4a0bc53f296d90375","07b44a7a51e94c78b411c753fc39dab0",15916291,1,-6,0,761,194,189,-5
"07b44a7a51e94c78b411c753fc39dab0","d5e8e2bd12a2466b9d6d90855f0eb079",15916291,1,10,0,762,189,198,9
"d5e8e2bd12a2466b9d6d90855f0eb079","d5e8e2bd12a2466b9d6d90855f0eb079",15916291,2,0,1,763,198,198,0
"d5e8e2bd12a2466b9d6d90855f0eb079","5bddb3d9ed264f3984702f048c7e5340",15916291,1,-1,0,765,198,197,-1
"5bddb3d9ed264f3984702f048c7e5340","5bddb3d9ed264f3984702f048c7e5340",15916291,2,0,1,766,197,197,0
"5bddb3d9ed264f3984702f048c7e5340","2d2580c9411c4972909db508d6956a58",15916291,1,-1,0,768,197,196,-1
"2d2580c9411c4972909db508d6956a58","2d2580c9411c4972909db508d6956a58",15916291,2,0,1,769,196,196,0
"2d2580c9411c4972909db508d6956a58","6cd2dcaac46847d4a0bc53f296d90375",15916291,1,-2,0,771,196,194,-2
"6cd2dcaac46847d4a0bc53f296d90375","6cd2dcaac46847d4a0bc53f296d90375",15916291,4,0,1,772,194,194,0
"6cd2dcaac46847d4a0bc53f296d90375","017d7ca8e0394b91aaadc9574df2202c",15916291,1,-1,0,776,194,193,-1
"017d7ca8e0394b91aaadc9574df2202c","54e8e9f0ea3e45c4bf3b8ac799ee31b1",15916291,1,8,0,777,193,200,7
"54e8e9f0ea3e45c4bf3b8ac799ee31b1","54e8e9f0ea3e45c4bf3b8ac799ee31b1",15916291,3,0,1,778,200,200,0
"54e8e9f0ea3e45c4bf3b8ac799ee31b1","c614a00911be4877a075f19315530fb0",15916291,1,1,0,781,200,201,1
"c614a00911be4877a075f19315530fb0","c614a00911be4877a075f19315530fb0",15916291,6,0,1,782,201,201,0
"c614a00911be4877a075f19315530fb0","a6c21bd8b95249c7972820a7a7d76aff",15916291,1,1,0,788,201,202,1
"a6c21bd8b95249c7972820a7a7d76aff","a6c21bd8b95249c7972820a7a7d76aff",15916291,1,0,1,789,202,202,0
"a6c21bd8b95249c7972820a7a7d76aff","bb329d880ab54120adaf203a693bb203",15916291,1,1,0,790,202,203,1
"bb329d880ab54120adaf203a693bb203","bb329d880ab54120adaf203a693bb203",15916291,1,0,1,791,203,203,0
"bb329d880ab54120adaf203a693bb203","f9170dd6bc6442b4acd832747609b09a",15916291,1,-4,0,792,203,199,-4
"f9170dd6bc6442b4acd832747609b09a","334c2344009840079b1d0e1b7ce3d5a7",15916291,1,7,0,793,199,205,6
"334c2344009840079b1d0e1b7ce3d5a7","334c2344009840079b1d0e1b7ce3d5a7",15916291,1,0,1,794,205,205,0
"334c2344009840079b1d0e1b7ce3d5a7","d7f13c8d63ec4e2aa673fbb9cf9c6933",15916291,1,3,0,795,205,206,1
"d7f13c8d63ec4e2aa673fbb9cf9c6933","c8e371568a0c4391b25796ae4e91952e",15916291,1,-26,0,796,206,186,-20
"c8e371568a0c4391b25796ae4e91952e","b9e80f77c3a44349863b19875725c384",15916291,1,27,0,797,186,207,21
"b9e80f77c3a44349863b19875725c384","7108f0e4c2584f1f9c471689ae4c885c",15916291,2,1,0,798,207,208,1
"7108f0e4c2584f1f9c471689ae4c885c","78adeee1fa2c4fe0bc73f7bca9fcee86",15916291,1,-68,0,799,208,160,-48
"82e6285962b8400d9d6fc32436022a94","d7f13c8d63ec4e2aa673fbb9cf9c6933",15916291,1,56,0,813,167,206,39
"d7f13c8d63ec4e2aa673fbb9cf9c6933","d7f13c8d63ec4e2aa673fbb9cf9c6933",15916291,1,0,1,814,206,206,0
"d7f13c8d63ec4e2aa673fbb9cf9c6933","7108f0e4c2584f1f9c471689ae4c885c",15916291,1,2,0,815,206,208,2
"7108f0e4c2584f1f9c471689ae4c885c","b9e80f77c3a44349863b19875725c384",15916291,1,-1,0,816,208,207,-1
"b9e80f77c3a44349863b19875725c384","b9e80f77c3a44349863b19875725c384",15916291,16,0,1,817,207,207,0
"7108f0e4c2584f1f9c471689ae4c885c","7108f0e4c2584f1f9c471689ae4c885c",15916291,10,0,1,834,208,208,0
"7108f0e4c2584f1f9c471689ae4c885c","09400e101c5d4b439cf9a26b03aae558",15916291,1,3,0,844,208,210,2
"09400e101c5d4b439cf9a26b03aae558","d7f13c8d63ec4e2aa673fbb9cf9c6933",15916291,1,-5,0,845,210,206,-4
"d7f13c8d63ec4e2aa673fbb9cf9c6933","a875096404ef4a9984b62d74cda916f9",15916291,1,4,0,846,206,209,3
"a875096404ef4a9984b62d74cda916f9","d7f13c8d63ec4e2aa673fbb9cf9c6933",15916291,1,-4,0,847,209,206,-3
"d7f13c8d63ec4e2aa673fbb9cf9c6933","09400e101c5d4b439cf9a26b03aae558",15916291,1,5,0,848,206,210,4
"09400e101c5d4b439cf9a26b03aae558","09400e101c5d4b439cf9a26b03aae558",15916291,16,0,1,849,210,210,0
"09400e101c5d4b439cf9a26b03aae558","a88efa7e50ce47159810ab553afa6d3a",15916291,1,2,0,865,210,212,2
"a88efa7e50ce47159810ab553afa6d3a","a88efa7e50ce47159810ab553afa6d3a",15916291,2,0,1,866,212,212,0
"a88efa7e50ce47159810ab553afa6d3a","a875096404ef4a9984b62d74cda916f9",15916291,1,-3,0,868,212,209,-3
"a875096404ef4a9984b62d74cda916f9","be502a7a43c44bf7b682698de79d9369",15916291,1,6,0,869,209,214,5
"be502a7a43c44bf7b682698de79d9369","f7fb1952f56b4189b86a9f8b7862d2b8",15916291,1,1,0,870,214,215,1
"f7fb1952f56b4189b86a9f8b7862d2b8","f7fb1952f56b4189b86a9f8b7862d2b8",15916291,12,0,1,871,215,215,0
"f7fb1952f56b4189b86a9f8b7862d2b8","be502a7a43c44bf7b682698de79d9369",15916291,1,-1,0,883,215,214,-1
"be502a7a43c44bf7b682698de79d9369","be502a7a43c44bf7b682698de79d9369",15916291,12,0,1,884,214,214,0
"be502a7a43c44bf7b682698de79d9369","ec341f459285443b8361f7f15638ff08",15916291,1,-1,0,896,214,213,-1
"ec341f459285443b8361f7f15638ff08","363837c182e04711840d896ae1e0339c",15916291,1,6,0,897,213,218,5
"363837c182e04711840d896ae1e0339c","363837c182e04711840d896ae1e0339c",15916291,12,0,1,898,218,218,0
"363837c182e04711840d896ae1e0339c","01b2051f8941460d89945e3b02d1ce78",15916291,1,-1,0,910,218,217,-1
"01b2051f8941460d89945e3b02d1ce78","91125ca626c5470eb145501f8c37f8db",15916291,1,4,0,911,217,220,3
"91125ca626c5470eb145501f8c37f8db","91125ca626c5470eb145501f8c37f8db",15916291,1,0,1,912,220,220,0
"91125ca626c5470eb145501f8c37f8db","d7f13c8d63ec4e2aa673fbb9cf9c6933",15916291,1,-18,0,913,220,206,-14
"d7f13c8d63ec4e2aa673fbb9cf9c6933","1c6721b1f63f4d30ba7746ea8af02a52",15916291,1,21,0,914,206,221,15
"1c6721b1f63f4d30ba7746ea8af02a52","77ecef8eff6b4a2caea7707669bf7475",15916291,1,1,0,915,221,222,1
"77ecef8eff6b4a2caea7707669bf7475","77ecef8eff6b4a2caea7707669bf7475",15916291,12,0,1,916,222,222,0
"77ecef8eff6b4a2caea7707669bf7475","d03cb855c70044cf8c35d9ec0de696e3",15916291,1,3,0,928,222,224,2
"d03cb855c70044cf8c35d9ec0de696e3","1c6721b1f63f4d30ba7746ea8af02a52",15916291,1,-4,0,929,224,221,-3
"1c6721b1f63f4d30ba7746ea8af02a52","8b9ae98743bd4d4a8a87dff1c1244211",15916291,1,7,0,930,221,227,6
"8b9ae98743bd4d4a8a87dff1c1244211","f7906d6f59b9489a91d2ef40db5a474d",15916291,2,-4,0,931,227,223,-4
"f7906d6f59b9489a91d2ef40db5a474d","1c6721b1f63f4d30ba7746ea8af02a52",15916291,1,-3,0,932,223,221,-2
"1c6721b1f63f4d30ba7746ea8af02a52","d03cb855c70044cf8c35d9ec0de696e3",15916291,1,4,0,933,221,224,3
"d03cb855c70044cf8c35d9ec0de696e3","8b9ae98743bd4d4a8a87dff1c1244211",15916291,2,3,0,934,224,227,3
"8b9ae98743bd4d4a8a87dff1c1244211","d03cb855c70044cf8c35d9ec0de696e3",15916291,1,-3,0,935,227,224,-3
"d03cb855c70044cf8c35d9ec0de696e3","d03cb855c70044cf8c35d9ec0de696e3",15916291,5,0,1,936,224,224,0
"8b9ae98743bd4d4a8a87dff1c1244211","8b9ae98743bd4d4a8a87dff1c1244211",15916291,9,0,1,942,227,227,0
"f7906d6f59b9489a91d2ef40db5a474d","2ab1535aac1346ba8801535bf729ef37",15916291,1,7,0,952,223,229,6
"2ab1535aac1346ba8801535bf729ef37","2ab1535aac1346ba8801535bf729ef37",15916291,10,0,1,953,229,229,0
"2ab1535aac1346ba8801535bf729ef37","a4f40fb48a8542c8949bae1f002cd9bc",15916291,1,2,0,963,229,231,2
"a4f40fb48a8542c8949bae1f002cd9bc","a4f40fb48a8542c8949bae1f002cd9bc",15916291,2,0,1,964,231,231,0
"a4f40fb48a8542c8949bae1f002cd9bc","5152833676bf4c6cb317060be10f68db",15916291,1,-3,0,966,231,228,-3
"5152833676bf4c6cb317060be10f68db","ca3e28f290354c08aefe5b0f769604e6",15916291,1,8,0,967,228,235,7
"ca3e28f290354c08aefe5b0f769604e6","ca3e28f290354c08aefe5b0f769604e6",15916291,9,0,1,968,235,235,0
"ca3e28f290354c08aefe5b0f769604e6","79a35eea833e4c2c9d22fc53c3c6445c",15916291,1,1,0,977,235,236,1
"79a35eea833e4c2c9d22fc53c3c6445c","79a35eea833e4c2c9d22fc53c3c6445c",15916291,9,0,1,978,236,236,0
"79a35eea833e4c2c9d22fc53c3c6445c","8f68228b1518449e9615cdafee41a2bd",15916291,1,1,0,987,236,237,1
"8f68228b1518449e9615cdafee41a2bd","8f68228b1518449e9615cdafee41a2bd",15916291,1,0,1,988,237,237,0
"8f68228b1518449e9615cdafee41a2bd","cab89fa5c3ed45a5aa550fc0352d6a42",15916291,1,1,0,989,237,238,1
"cab89fa5c3ed45a5aa550fc0352d6a42","cab89fa5c3ed45a5aa550fc0352d6a42",15916291,5,0,1,990,238,238,0
"cab89fa5c3ed45a5aa550fc0352d6a42","66d4fad4f1cf4b46be0750a99ad7a35a",15916291,1,1,0,995,238,239,1
"66d4fad4f1cf4b46be0750a99ad7a35a","66d4fad4f1cf4b46be0750a99ad7a35a",15916291,1,0,1,996,239,239,0
"66d4fad4f1cf4b46be0750a99ad7a35a","0b04c8e2f86d48c7aeb7e225819cd32b",15916291,1,-5,0,997,239,234,-5
"0b04c8e2f86d48c7aeb7e225819cd32b","f53da5fd9bfe412da4b80d4742563b6c",15916291,1,8,0,998,234,241,7
"f53da5fd9bfe412da4b80d4742563b6c","f53da5fd9bfe412da4b80d4742563b6c",15916291,3,0,1,1000,241,241,0
"f53da5fd9bfe412da4b80d4742563b6c","2ae94c0cea4d480a9d5dca8fb1d7b542",15916291,1,3,0,1002,241,242,1
"2ae94c0cea4d480a9d5dca8fb1d7b542","1c6721b1f63f4d30ba7746ea8af02a52",15916291,1,-27,0,1003,242,221,-21
"1c6721b1f63f4d30ba7746ea8af02a52","1ebf23f9d994469a85206e4c7b1bf5f5",15916291,1,30,0,1004,221,245,24
"1ebf23f9d994469a85206e4c7b1bf5f5","2ae94c0cea4d480a9d5dca8fb1d7b542",15916291,2,-3,0,1005,245,242,-3
"2ae94c0cea4d480a9d5dca8fb1d7b542","2ae94c0cea4d480a9d5dca8fb1d7b542",15916291,2,0,1,1006,242,242,0
"2ae94c0cea4d480a9d5dca8fb1d7b542","1ebf23f9d994469a85206e4c7b1bf5f5",15916291,1,3,0,1008,242,245,3
"2ae94c0cea4d480a9d5dca8fb1d7b542","30c9ba177afc49a695625d2bdec40207",15916291,1,9,0,1010,242,250,8
"30c9ba177afc49a695625d2bdec40207","30c9ba177afc49a695625d2bdec40207",15916291,2,0,1,1011,250,250,0
"30c9ba177afc49a695625d2bdec40207","6e83e23f56544a19b94067c1c558d9c0",15916291,1,-3,0,1013,250,247,-3
"6e83e23f56544a19b94067c1c558d9c0","00f61990949545828dd12f1303d47504",15916291,1,11,0,1014,247,256,9
"00f61990949545828dd12f1303d47504","00f61990949545828dd12f1303d47504",15916291,2,0,1,1015,256,256,0
"00f61990949545828dd12f1303d47504","ead7bb4b64e247d2ae632ab8a296b091",15916291,1,2,0,1017,256,258,2
"ead7bb4b64e247d2ae632ab8a296b091","ead7bb4b64e247d2ae632ab8a296b091",15916291,2,0,1,1018,258,258,0
"ead7bb4b64e247d2ae632ab8a296b091","41b0048dde734bb280bac6116baa8e27",15916291,1,1,0,1020,258,259,1
"41b0048dde734bb280bac6116baa8e27","41b0048dde734bb280bac6116baa8e27",15916291,2,0,1,1021,259,259,0
"41b0048dde734bb280bac6116baa8e27","b41c5a094a604ee0915327da5cc0beb7",15916291,1,1,0,1023,259,260,1
"b41c5a094a604ee0915327da5cc0beb7","b41c5a094a604ee0915327da5cc0beb7",15916291,2,0,1,1024,260,260,0
"b41c5a094a604ee0915327da5cc0beb7","d546341988904f069cfa86b21457d9d9",15916291,1,-10,0,1026,260,251,-9
"d546341988904f069cfa86b21457d9d9","28c171777c52431ab6b925073bd63d46",15916291,1,15,0,1027,251,264,13
"28c171777c52431ab6b925073bd63d46","28c171777c52431ab6b925073bd63d46",15916291,7,0,1,1028,264,264,0
"28c171777c52431ab6b925073bd63d46","ac160db940cb49ae8579162b1d52bb5d",15916291,1,2,0,1035,264,266,2
"ac160db940cb49ae8579162b1d52bb5d","ac160db940cb49ae8579162b1d52bb5d",15916291,3,0,1,1036,266,266,0
"ac160db940cb49ae8579162b1d52bb5d","d989ebcfc12a4b669f0100dc1aa14f1e",15916291,1,-12,0,1039,266,255,-11
"d989ebcfc12a4b669f0100dc1aa14f1e","c6fd49b485cc4874b0bbdd9c6171e09c",15916291,1,15,0,1040,255,268,13
"c6fd49b485cc4874b0bbdd9c6171e09c","c6fd49b485cc4874b0bbdd9c6171e09c",15916291,3,0,1,1041,268,268,0
"c6fd49b485cc4874b0bbdd9c6171e09c","44240778a97c4af0937817499b75707b",15916291,1,1,0,1044,268,269,1
"44240778a97c4af0937817499b75707b","44240778a97c4af0937817499b75707b",15916291,2,0,1,1045,269,269,0
"44240778a97c4af0937817499b75707b","7aa76d3e993840d8805f097cbdbcd44b",15916291,1,-9,0,1047,269,261,-8
"7aa76d3e993840d8805f097cbdbcd44b","865a4d3b43374da7944dc7d397f566d9",15916291,1,12,0,1048,261,271,10
"865a4d3b43374da7944dc7d397f566d9","865a4d3b43374da7944dc7d397f566d9",15916291,1,0,1,1049,271,271,0
"865a4d3b43374da7944dc7d397f566d9","0d987bed3ffa4ed0b9a2e62e97b7b30f",15916291,1,3,0,1050,271,272,1
"0d987bed3ffa4ed0b9a2e62e97b7b30f","2ae94c0cea4d480a9d5dca8fb1d7b542",15916291,1,-38,0,1051,272,242,-30
"2ae94c0cea4d480a9d5dca8fb1d7b542","0d987bed3ffa4ed0b9a2e62e97b7b30f",15916291,1,38,0,1052,242,272,30
"0d987bed3ffa4ed0b9a2e62e97b7b30f","82ae07bc0c9b4570a41799290d1ef399",15916291,1,4,0,1053,272,275,3
"82ae07bc0c9b4570a41799290d1ef399","bb5a47f5ea01454a8b79455422d3b9da",15916291,4,6,0,1054,275,280,5
"bb5a47f5ea01454a8b79455422d3b9da","bb5a47f5ea01454a8b79455422d3b9da",15916291,77,0,1,1055,280,280,0
"bb5a47f5ea01454a8b79455422d3b9da","bc5524e78a8544e2ae2fdc2f3462bbec",15916291,2,-1,0,1062,280,279,-1
"bc5524e78a8544e2ae2fdc2f3462bbec","bb5a47f5ea01454a8b79455422d3b9da",15916291,2,1,0,1063,279,280,1
"bb5a47f5ea01454a8b79455422d3b9da","82ae07bc0c9b4570a41799290d1ef399",15916291,3,-6,0,1070,280,275,-5
"bb5a47f5ea01454a8b79455422d3b9da","0d987bed3ffa4ed0b9a2e62e97b7b30f",15916291,1,-10,0,1134,280,272,-8
"0d987bed3ffa4ed0b9a2e62e97b7b30f","94cecc3f1e7d484b8e068e79241dfd73",15916291,1,13,0,1135,272,281,9
"94cecc3f1e7d484b8e068e79241dfd73","a37477c4e4c14169ad44b06b493007f6",15916291,1,2,0,1136,281,283,2
"a37477c4e4c14169ad44b06b493007f6","0d987bed3ffa4ed0b9a2e62e97b7b30f",15916291,1,-15,0,1137,283,272,-11
"0d987bed3ffa4ed0b9a2e62e97b7b30f","0d987bed3ffa4ed0b9a2e62e97b7b30f",15916291,1,0,1,1138,272,272,0
"0d987bed3ffa4ed0b9a2e62e97b7b30f","bb5a47f5ea01454a8b79455422d3b9da",15916291,1,10,0,1139,272,280,8
"bb5a47f5ea01454a8b79455422d3b9da","94cecc3f1e7d484b8e068e79241dfd73",15916291,1,3,0,1148,280,281,1
"94cecc3f1e7d484b8e068e79241dfd73","0d987bed3ffa4ed0b9a2e62e97b7b30f",15916291,1,-13,0,1149,281,272,-9
"0d987bed3ffa4ed0b9a2e62e97b7b30f","a37477c4e4c14169ad44b06b493007f6",15916291,1,15,0,1150,272,283,11
"a37477c4e4c14169ad44b06b493007f6","94cecc3f1e7d484b8e068e79241dfd73",15916291,1,-2,0,1151,283,281,-2
"94cecc3f1e7d484b8e068e79241dfd73","fab84b4fab5940efb4ea868ef8d09396",15916291,1,5,0,1152,281,284,3
"fab84b4fab5940efb4ea868ef8d09396","4a29443515bb404cb8924e1c60a63b73",15916291,1,4,0,1153,284,285,1
"4a29443515bb404cb8924e1c60a63b73","fab84b4fab5940efb4ea868ef8d09396",15916291,1,-4,0,1154,285,284,-1
"fab84b4fab5940efb4ea868ef8d09396","208c9b2796c944db8dacaa96082520ea",15916291,1,7,0,1155,284,288,4
"208c9b2796c944db8dacaa96082520ea","4a29443515bb404cb8924e1c60a63b73",15916291,2,-3,0,1156,288,285,-3
"4a29443515bb404cb8924e1c60a63b73","4a29443515bb404cb8924e1c60a63b73",15916291,1,0,1,1157,285,285,0
"4a29443515bb404cb8924e1c60a63b73","208c9b2796c944db8dacaa96082520ea",15916291,1,3,0,1158,285,288,3
"208c9b2796c944db8dacaa96082520ea","208c9b2796c944db8dacaa96082520ea",15916291,1,0,1,1159,288,288,0
"4a29443515bb404cb8924e1c60a63b73","7669a956527947d0add87455277e80b4",15916291,1,7,0,1161,285,291,6
"7669a956527947d0add87455277e80b4","7669a956527947d0add87455277e80b4",15916291,1,0,1,1162,291,291,0
"7669a956527947d0add87455277e80b4","6a9a3b5bde4a48daa896fe8c06eca56f",15916291,1,-2,0,1163,291,289,-2
"6a9a3b5bde4a48daa896fe8c06eca56f","869e967078f04da18dd0b0b9389a7424",15916291,1,5,0,1164,289,293,4
"869e967078f04da18dd0b0b9389a7424","869e967078f04da18dd0b0b9389a7424",15916291,1,0,1,1165,293,293,0
"869e967078f04da18dd0b0b9389a7424","34a6e49023fc4465bd5ca604330bbd1c",15916291,1,-1,0,1166,293,292,-1
"34a6e49023fc4465bd5ca604330bbd1c","21592f2a9e9c4b2f8c66ec5dbcbf6a2b",15916291,1,5,0,1167,292,296,4
"21592f2a9e9c4b2f8c66ec5dbcbf6a2b","ba0e59461bfb4a44b7b1c28a01f8d3b3",15916291,1,4,0,1168,296,299,3
"ba0e59461bfb4a44b7b1c28a01f8d3b3","0e0b36e731a645e7b1b8a88f5031ca38",15916291,1,2,0,1169,299,301,2
"0e0b36e731a645e7b1b8a88f5031ca38","0e0b36e731a645e7b1b8a88f5031ca38",15916291,2,0,1,1170,301,301,0
"0e0b36e731a645e7b1b8a88f5031ca38","a66a144637284c21afc6de17fea4bfb8",15916291,1,1,0,1172,301,302,1
"a66a144637284c21afc6de17fea4bfb8","a66a144637284c21afc6de17fea4bfb8",15916291,2,0,1,1173,302,302,0
"a66a144637284c21afc6de17fea4bfb8","ba0e59461bfb4a44b7b1c28a01f8d3b3",15916291,1,-3,0,1175,302,299,-3
"ba0e59461bfb4a44b7b1c28a01f8d3b3","7646a919d7e64fa990bca9b024ff089d",15916291,1,-1,0,1176,299,298,-1
"7646a919d7e64fa990bca9b024ff089d","e390b575229748ea8aac9364efe2bf00",15916291,1,7,0,1177,298,304,6
"e390b575229748ea8aac9364efe2bf00","e390b575229748ea8aac9364efe2bf00",15916291,1,0,1,1178,304,304,0
"e390b575229748ea8aac9364efe2bf00","4a29443515bb404cb8924e1c60a63b73",15916291,1,-24,0,1179,304,285,-19
"4a29443515bb404cb8924e1c60a63b73","3434c10e561d488a914e0f7d71907abd",15916291,1,27,0,1180,285,305,20
"3434c10e561d488a914e0f7d71907abd","53e7e900392747ccad52e711ab0f80d8",15916291,1,2,0,1181,305,307,2
"53e7e900392747ccad52e711ab0f80d8","53e7e900392747ccad52e711ab0f80d8",15916291,1,0,1,1182,307,307,0
"53e7e900392747ccad52e711ab0f80d8","3434c10e561d488a914e0f7d71907abd",15916291,1,-2,0,1183,307,305,-2
"3434c10e561d488a914e0f7d71907abd","130acc2aeb0448fdbb2de63bc5cebe5b",15916291,1,5,0,1184,305,309,4
"130acc2aeb0448fdbb2de63bc5cebe5b","130acc2aeb0448fdbb2de63bc5cebe5b",15916291,5,0,1,1185,309,309,0
"130acc2aeb0448fdbb2de63bc5cebe5b","56d94971a7a94257aa330183a8ebd0ea",15916291,1,4,0,1186,309,313,4
"56d94971a7a94257aa330183a8ebd0ea","56d94971a7a94257aa330183a8ebd0ea",15916291,2,0,1,1187,313,313,0
"56d94971a7a94257aa330183a8ebd0ea","ea859f8207e44537889daeaba13ac2e8",15916291,1,-1,0,1189,313,312,-1
"ea859f8207e44537889daeaba13ac2e8","ea859f8207e44537889daeaba13ac2e8",15916291,2,0,1,1190,312,312,0
"ea859f8207e44537889daeaba13ac2e8","9c062b3251034ebe90f5054e2a3b5120",15916291,1,-1,0,1192,312,311,-1
"9c062b3251034ebe90f5054e2a3b5120","9c062b3251034ebe90f5054e2a3b5120",15916291,2,0,1,1193,311,311,0
"9c062b3251034ebe90f5054e2a3b5120","130acc2aeb0448fdbb2de63bc5cebe5b",15916291,1,-2,0,1195,311,309,-2
"130acc2aeb0448fdbb2de63bc5cebe5b","141c0df6cd1946539aadd1c9b7068cd4",15916291,1,-1,0,1200,309,308,-1
"141c0df6cd1946539aadd1c9b7068cd4","3434c10e561d488a914e0f7d71907abd",15916291,1,-4,0,1201,308,305,-3
"3434c10e561d488a914e0f7d71907abd","0c787d16c9504873b1a4d903cec09948",15916291,1,11,0,1202,305,314,9
"0c787d16c9504873b1a4d903cec09948","0c787d16c9504873b1a4d903cec09948",15916291,1,0,1,1203,314,314,0
"0c787d16c9504873b1a4d903cec09948","13255e63e0aa4abf85e5211bf613d43e",15916291,1,3,0,1204,314,317,3
"13255e63e0aa4abf85e5211bf613d43e","13255e63e0aa4abf85e5211bf613d43e",15916291,1,0,1,1205,317,317,0
"13255e63e0aa4abf85e5211bf613d43e","86c27d40179e419c8e9d150fb6afa5d0",15916291,1,3,0,1206,317,319,2
"86c27d40179e419c8e9d150fb6afa5d0","0c787d16c9504873b1a4d903cec09948",15916291,1,-6,0,1207,319,314,-5
"0c787d16c9504873b1a4d903cec09948","8d7e0b55cf9849cda222a0f2440cec55",15916291,1,5,0,1208,314,318,4
"8d7e0b55cf9849cda222a0f2440cec55","8d7e0b55cf9849cda222a0f2440cec55",15916291,2,0,1,1209,318,318,0
"8d7e0b55cf9849cda222a0f2440cec55","3434c10e561d488a914e0f7d71907abd",15916291,2,-16,0,1210,318,305,-13
"3434c10e561d488a914e0f7d71907abd","86c27d40179e419c8e9d150fb6afa5d0",15916291,2,17,0,1211,305,319,14
"86c27d40179e419c8e9d150fb6afa5d0","8d7e0b55cf9849cda222a0f2440cec55",15916291,2,-1,0,1212,319,318,-1
"86c27d40179e419c8e9d150fb6afa5d0","3434c10e561d488a914e0f7d71907abd",15916291,1,-17,0,1216,319,305,-14
"3434c10e561d488a914e0f7d71907abd","8d7e0b55cf9849cda222a0f2440cec55",15916291,1,16,0,1217,305,318,13
"8d7e0b55cf9849cda222a0f2440cec55","86c27d40179e419c8e9d150fb6afa5d0",15916291,1,1,0,1218,318,319,1
"86c27d40179e419c8e9d150fb6afa5d0","86c27d40179e419c8e9d150fb6afa5d0",15916291,1,0,1,1219,319,319,0
"8d7e0b55cf9849cda222a0f2440cec55","24f1363179ad4aaa965484a78471912b",15916291,1,6,0,1221,318,323,5
"24f1363179ad4aaa965484a78471912b","47edbb64109243e6b0f8f64cdef90c6c",15916291,1,3,0,1222,323,326,3
"47edbb64109243e6b0f8f64cdef90c6c","24f1363179ad4aaa965484a78471912b",15916291,1,-3,0,1223,326,323,-3
"24f1363179ad4aaa965484a78471912b","3628bdce1dd2429ba924d2d4d09448d2",15916291,1,-1,0,1224,323,322,-1
"3628bdce1dd2429ba924d2d4d09448d2","56b3fd1a212a4764be39d979fde3326e",15916291,1,7,0,1225,322,328,6
"56b3fd1a212a4764be39d979fde3326e","56b3fd1a212a4764be39d979fde3326e",15916291,1,0,1,1226,328,328,0
"56b3fd1a212a4764be39d979fde3326e","0c4079457ede49e3aeb5e86ed84bdf35",15916291,1,3,0,1227,328,329,1
"0c4079457ede49e3aeb5e86ed84bdf35","3434c10e561d488a914e0f7d71907abd",15916291,1,-31,0,1228,329,305,-24
"3434c10e561d488a914e0f7d71907abd","38aea304b4fa46e1b29bb72f5cea4c93",15916291,1,33,0,1229,305,331,26
"38aea304b4fa46e1b29bb72f5cea4c93","e36d261332f14e79bb4b467aceaeb9b5",15916291,1,2,0,1230,331,333,2
"e36d261332f14e79bb4b467aceaeb9b5","e36d261332f14e79bb4b467aceaeb9b5",15916291,2,0,1,1231,333,333,0
"e36d261332f14e79bb4b467aceaeb9b5","c7e89b9d04744d2eab742fc24e3ef1ae",15916291,1,1,0,1233,333,334,1
"c7e89b9d04744d2eab742fc24e3ef1ae","c7e89b9d04744d2eab742fc24e3ef1ae",15916291,2,0,1,1234,334,334,0
"c7e89b9d04744d2eab742fc24e3ef1ae","fe49f8054b374a0ea4bb266ed135ff62",15916291,1,1,0,1236,334,335,1
"fe49f8054b374a0ea4bb266ed135ff62","fe49f8054b374a0ea4bb266ed135ff62",15916291,2,0,1,1237,335,335,0
"fe49f8054b374a0ea4bb266ed135ff62","d0a8f74af98642fe8360d22c42e45117",15916291,1,1,0,1239,335,336,1
"d0a8f74af98642fe8360d22c42e45117","d0a8f74af98642fe8360d22c42e45117",15916291,2,0,1,1240,336,336,0
"d0a8f74af98642fe8360d22c42e45117","38aea304b4fa46e1b29bb72f5cea4c93",15916291,1,-5,0,1242,336,331,-5
"38aea304b4fa46e1b29bb72f5cea4c93","38aea304b4fa46e1b29bb72f5cea4c93",15916291,4,0,1,1243,331,331,0
"38aea304b4fa46e1b29bb72f5cea4c93","0c4079457ede49e3aeb5e86ed84bdf35",15916291,1,-2,0,1247,331,329,-2
"0c4079457ede49e3aeb5e86ed84bdf35","a7c6339ca1da4368a18d471f0519f877",15916291,1,11,0,1248,329,339,10
"a7c6339ca1da4368a18d471f0519f877","a7c6339ca1da4368a18d471f0519f877",15916291,1,0,1,1249,339,339,0
"a7c6339ca1da4368a18d471f0519f877","b8b9418ab322418d9db9b40d96af873a",15916291,1,-2,0,1250,339,337,-2
"b8b9418ab322418d9db9b40d96af873a","bbc5139ca9024389a94db3a6f47dcff6",15916291,1,5,0,1251,337,341,4
"bbc5139ca9024389a94db3a6f47dcff6","fcea5b10d5a14a3b9324ffece8f6e1e5",15916291,1,4,0,1252,341,345,4
"fcea5b10d5a14a3b9324ffece8f6e1e5","fcea5b10d5a14a3b9324ffece8f6e1e5",15916291,2,0,1,1253,345,345,0
"fcea5b10d5a14a3b9324ffece8f6e1e5","b37947176785476f8b29d49a851366dc",15916291,1,-1,0,1255,345,344,-1
"b37947176785476f8b29d49a851366dc","b37947176785476f8b29d49a851366dc",15916291,2,0,1,1256,344,344,0
"b37947176785476f8b29d49a851366dc","4ee6ca9019ab4a1ab323f98094a9bd77",15916291,1,-1,0,1258,344,343,-1
"4ee6ca9019ab4a1ab323f98094a9bd77","4ee6ca9019ab4a1ab323f98094a9bd77",15916291,2,0,1,1259,343,343,0
"4ee6ca9019ab4a1ab323f98094a9bd77","bbc5139ca9024389a94db3a6f47dcff6",15916291,1,-2,0,1261,343,341,-2
"bbc5139ca9024389a94db3a6f47dcff6","bbc5139ca9024389a94db3a6f47dcff6",15916291,3,0,1,1262,341,341,0
"bbc5139ca9024389a94db3a6f47dcff6","c2490bc612d146edbe786556fab3651b",15916291,1,-1,0,1265,341,340,-1
"c2490bc612d146edbe786556fab3651b","6ac8bb048b854999a47edb35fe627f11",15916291,1,8,0,1266,340,347,7
"6ac8bb048b854999a47edb35fe627f11","6ac8bb048b854999a47edb35fe627f11",15916291,1,0,1,1267,347,347,0
"6ac8bb048b854999a47edb35fe627f11","0c4079457ede49e3aeb5e86ed84bdf35",15916291,1,-21,0,1268,347,329,-18
"0c4079457ede49e3aeb5e86ed84bdf35","30ead9794d4847abaf222ca966cc8630",15916291,1,24,0,1269,329,348,19
"30ead9794d4847abaf222ca966cc8630","897b7f51242c44aab2205c72fdcbf4cd",15916291,1,4,0,1270,348,352,4
"897b7f51242c44aab2205c72fdcbf4cd","c20993c944444fe085345591a8bd837e",15916291,1,-1,0,1271,352,351,-1
"c20993c944444fe085345591a8bd837e","09b9678ddc3d452ea4a3d46e15826065",15916291,1,2,0,1272,351,353,2
"09b9678ddc3d452ea4a3d46e15826065","eff0de7f2dbb42dfa1a2e686efab5b6d",15916291,2,1,0,1273,353,354,1
"eff0de7f2dbb42dfa1a2e686efab5b6d","c20993c944444fe085345591a8bd837e",15916291,1,-3,0,1274,354,351,-3
"c20993c944444fe085345591a8bd837e","c20993c944444fe085345591a8bd837e",15916291,3,0,1,1275,351,351,0
"c20993c944444fe085345591a8bd837e","897b7f51242c44aab2205c72fdcbf4cd",15916291,1,1,0,1278,351,352,1
"897b7f51242c44aab2205c72fdcbf4cd","897b7f51242c44aab2205c72fdcbf4cd",15916291,3,0,1,1279,352,352,0
"897b7f51242c44aab2205c72fdcbf4cd","09b9678ddc3d452ea4a3d46e15826065",15916291,1,1,0,1282,352,353,1
"09b9678ddc3d452ea4a3d46e15826065","09b9678ddc3d452ea4a3d46e15826065",15916291,3,0,1,1283,353,353,0
"eff0de7f2dbb42dfa1a2e686efab5b6d","eff0de7f2dbb42dfa1a2e686efab5b6d",15916291,3,0,1,1287,354,354,0
"eff0de7f2dbb42dfa1a2e686efab5b6d","30ead9794d4847abaf222ca966cc8630",15916291,1,-6,0,1290,354,348,-6
"30ead9794d4847abaf222ca966cc8630","2fe14166dc9642c3bc666b86a57f943d",15916291,1,10,0,1291,348,357,9
"2fe14166dc9642c3bc666b86a57f943d","ab8fdad974ae471f9f24c3f9dd04462e",15916291,1,5,0,1292,357,362,5
"ab8fdad974ae471f9f24c3f9dd04462e","ab8fdad974ae471f9f24c3f9dd04462e",15916291,2,0,1,1293,362,362,0
"ab8fdad974ae471f9f24c3f9dd04462e","0a8f150a4cf747acbde62f4721823da3",15916291,1,-1,0,1295,362,361,-1
"0a8f150a4cf747acbde62f4721823da3","0a8f150a4cf747acbde62f4721823da3",15916291,2,0,1,1296,361,361,0
"0a8f150a4cf747acbde62f4721823da3","cb5fc7ef85d547c4be1a7439d0bf6052",15916291,1,-1,0,1298,361,360,-1
"cb5fc7ef85d547c4be1a7439d0bf6052","cb5fc7ef85d547c4be1a7439d0bf6052",15916291,2,0,1,1299,360,360,0
"cb5fc7ef85d547c4be1a7439d0bf6052","44421dd1e13a47a388c4a19834b744c7",15916291,1,-1,0,1301,360,359,-1
"44421dd1e13a47a388c4a19834b744c7","44421dd1e13a47a388c4a19834b744c7",15916291,2,0,1,1302,359,359,0
"44421dd1e13a47a388c4a19834b744c7","2fe14166dc9642c3bc666b86a57f943d",15916291,1,-2,0,1304,359,357,-2
"2fe14166dc9642c3bc666b86a57f943d","2fe14166dc9642c3bc666b86a57f943d",15916291,3,0,1,1305,357,357,0
"2fe14166dc9642c3bc666b86a57f943d","52580888dadb4fe3baa795683ea227bd",15916291,1,8,0,1308,357,364,7
"52580888dadb4fe3baa795683ea227bd","1ba8fef685d74a8194b9db252eb704fb",15916291,1,-10,0,1309,364,355,-9
"1ba8fef685d74a8194b9db252eb704fb","30ead9794d4847abaf222ca966cc8630",15916291,1,-8,0,1310,355,348,-7
"30ead9794d4847abaf222ca966cc8630","f00179e251a045b39c3f7a54f9aa4acc",15916291,1,17,0,1311,348,363,15
"f00179e251a045b39c3f7a54f9aa4acc","f00179e251a045b39c3f7a54f9aa4acc",15916291,1,0,1,1312,363,363,0
"f00179e251a045b39c3f7a54f9aa4acc","52580888dadb4fe3baa795683ea227bd",15916291,1,1,0,1313,363,364,1
"52580888dadb4fe3baa795683ea227bd","f00179e251a045b39c3f7a54f9aa4acc",15916291,3,-1,0,1314,364,363,-1
"f00179e251a045b39c3f7a54f9aa4acc","492a3bc6a1254f23a7998587961b22a4",15916291,3,4,0,1315,363,366,3
"492a3bc6a1254f23a7998587961b22a4","c76574d21bc14aeea7ecd0b027f39858",15916291,1,2,0,1316,366,367,1
"c76574d21bc14aeea7ecd0b027f39858","072a190fd302456290895f9f04d6940a",15916291,1,-3,0,1317,367,365,-2
"072a190fd302456290895f9f04d6940a","52580888dadb4fe3baa795683ea227bd",15916291,1,-2,0,1318,365,364,-1
"492a3bc6a1254f23a7998587961b22a4","072a190fd302456290895f9f04d6940a",15916291,2,-1,0,1321,366,365,-1
"072a190fd302456290895f9f04d6940a","30ead9794d4847abaf222ca966cc8630",15916291,1,-20,0,1322,365,348,-17
"30ead9794d4847abaf222ca966cc8630","b71bac264efb4abd97015447bd490db6",15916291,3,28,0,1323,348,370,22
"b71bac264efb4abd97015447bd490db6","8d448d625b024c82a5eb240bbd7431d6",15916291,7,5,0,1324,370,374,4
"8d448d625b024c82a5eb240bbd7431d6","8d448d625b024c82a5eb240bbd7431d6",15916291,78,0,1,1325,374,374,0
"8d448d625b024c82a5eb240bbd7431d6","b71bac264efb4abd97015447bd490db6",15916291,5,-5,0,1332,374,370,-4
"b71bac264efb4abd97015447bd490db6","1b4550d0dab04078b3bf08a655345bdc",15916291,1,4,0,1333,370,373,3
"1b4550d0dab04078b3bf08a655345bdc","1b4550d0dab04078b3bf08a655345bdc",15916291,1,0,1,1334,373,373,0
"1b4550d0dab04078b3bf08a655345bdc","b71bac264efb4abd97015447bd490db6",15916291,1,-4,0,1335,373,370,-3
"8d448d625b024c82a5eb240bbd7431d6","1b4550d0dab04078b3bf08a655345bdc",15916291,1,-1,0,1344,374,373,-1
"1b4550d0dab04078b3bf08a655345bdc","30ead9794d4847abaf222ca966cc8630",15916291,1,-32,0,1345,373,348,-25
"b71bac264efb4abd97015447bd490db6","52580888dadb4fe3baa795683ea227bd",15916291,1,-10,0,1347,370,364,-6
"52580888dadb4fe3baa795683ea227bd","c76574d21bc14aeea7ecd0b027f39858",15916291,1,5,0,1348,364,367,3
"c76574d21bc14aeea7ecd0b027f39858","52580888dadb4fe3baa795683ea227bd",15916291,1,-5,0,1349,367,364,-3
"492a3bc6a1254f23a7998587961b22a4","492a3bc6a1254f23a7998587961b22a4",15916291,1,0,1,1352,366,366,0
"072a190fd302456290895f9f04d6940a","cfa457d1743848e4bb5e4beced6448ed",15916291,1,5,0,1354,365,369,4
"cfa457d1743848e4bb5e4beced6448ed","cfa457d1743848e4bb5e4beced6448ed",15916291,1,0,1,1355,369,369,0
"cfa457d1743848e4bb5e4beced6448ed","30ead9794d4847abaf222ca966cc8630",15916291,1,-25,0,1356,369,348,-21
"b71bac264efb4abd97015447bd490db6","b71bac264efb4abd97015447bd490db6",15916291,1,0,1,1368,370,370,0
"b71bac264efb4abd97015447bd490db6","d6d02b6ef04e4f17805504500b8ce441",15916291,2,8,0,1422,370,375,5
"d6d02b6ef04e4f17805504500b8ce441","d6d02b6ef04e4f17805504500b8ce441",15916291,3,0,1,1423,375,375,0
"d6d02b6ef04e4f17805504500b8ce441","66baf19b6b904b70922329068c63746d",15916291,2,4,0,1425,375,376,1
"66baf19b6b904b70922329068c63746d","7f544639412e40a9ba27f43b415362ab",15916291,2,2,0,1426,376,378,2
"7f544639412e40a9ba27f43b415362ab","a355d80f03d64640b19cd1f1c5ea01fc",15916291,1,-1,0,1427,378,377,-1
"a355d80f03d64640b19cd1f1c5ea01fc","66baf19b6b904b70922329068c63746d",15916291,1,-1,0,1428,377,376,-1
"66baf19b6b904b70922329068c63746d","a355d80f03d64640b19cd1f1c5ea01fc",15916291,1,1,0,1429,376,377,1
"a355d80f03d64640b19cd1f1c5ea01fc","7f544639412e40a9ba27f43b415362ab",15916291,1,1,0,1430,377,378,1
"7f544639412e40a9ba27f43b415362ab","a0d10309a2dd456289147f84be9d37f9",15916291,1,3,0,1431,378,381,3
"a0d10309a2dd456289147f84be9d37f9","a0d10309a2dd456289147f84be9d37f9",15916291,2,0,1,1432,381,381,0
"a0d10309a2dd456289147f84be9d37f9","0fcbc3ca07b144138b8d85da581f09a8",15916291,1,1,0,1434,381,382,1
"0fcbc3ca07b144138b8d85da581f09a8","0fcbc3ca07b144138b8d85da581f09a8",15916291,2,0,1,1435,382,382,0
"0fcbc3ca07b144138b8d85da581f09a8","7f544639412e40a9ba27f43b415362ab",15916291,1,-4,0,1437,382,378,-4
"7f544639412e40a9ba27f43b415362ab","66baf19b6b904b70922329068c63746d",15916291,1,-2,0,1438,378,376,-2
"66baf19b6b904b70922329068c63746d","c2fca3669923477ab966ded303dea31c",15916291,1,8,0,1439,376,383,7
"c2fca3669923477ab966ded303dea31c","4890121ce5d74576b4632b77cfc23398",15916291,1,6,0,1440,383,388,5
"4890121ce5d74576b4632b77cfc23398","4890121ce5d74576b4632b77cfc23398",15916291,1,0,1,1441,388,388,0
"4890121ce5d74576b4632b77cfc23398","96bb2b3e85a34d8b9544514e89f6fe97",15916291,1,3,0,1442,388,390,2
"96bb2b3e85a34d8b9544514e89f6fe97","18d3b836dd804224883cc9180b60a8e1",15916291,1,-4,0,1443,390,387,-3
"18d3b836dd804224883cc9180b60a8e1","96bb2b3e85a34d8b9544514e89f6fe97",15916291,1,4,0,1444,387,390,3
"96bb2b3e85a34d8b9544514e89f6fe97","17f95d18bab743888e1736033dc3384d",15916291,1,-1,0,1445,390,389,-1
"17f95d18bab743888e1736033dc3384d","6f8881a745ac4c358a68b92c3b4abe81",15916291,2,6,0,1446,389,394,5
"6f8881a745ac4c358a68b92c3b4abe81","6f8881a745ac4c358a68b92c3b4abe81",15916291,3,0,1,1447,394,394,0
"6f8881a745ac4c358a68b92c3b4abe81","f7002c8484354eceac57bc7bd62c76c1",15916291,2,-1,0,1450,394,393,-1
"f7002c8484354eceac57bc7bd62c76c1","44a277ea44dc4ae689fab4b82f0b4098",15916291,1,5,0,1451,393,397,4
"44a277ea44dc4ae689fab4b82f0b4098","44a277ea44dc4ae689fab4b82f0b4098",15916291,1,0,1,1452,397,397,0
"44a277ea44dc4ae689fab4b82f0b4098","0c12af0a4e7f4002852cf84b2537c161",15916291,1,-2,0,1453,397,395,-2
"0c12af0a4e7f4002852cf84b2537c161","859e0b8d71694b12befb69ee698138f9",15916291,1,5,0,1454,395,399,4
"859e0b8d71694b12befb69ee698138f9","859e0b8d71694b12befb69ee698138f9",15916291,1,0,1,1455,399,399,0
"859e0b8d71694b12befb69ee698138f9","2b09a08242b54983aec7063990fb3f66",15916291,1,3,0,1456,399,400,1
"2b09a08242b54983aec7063990fb3f66","66baf19b6b904b70922329068c63746d",15916291,3,-32,0,1457,400,376,-24
"66baf19b6b904b70922329068c63746d","2b09a08242b54983aec7063990fb3f66",15916291,3,32,0,1458,376,400,24
"2b09a08242b54983aec7063990fb3f66","1f471b7a883a4df48211e8c6a81b59a7",15916291,1,1,0,1459,400,401,1
"1f471b7a883a4df48211e8c6a81b59a7","1f471b7a883a4df48211e8c6a81b59a7",15916291,3,0,1,1460,401,401,0
"1f471b7a883a4df48211e8c6a81b59a7","2b09a08242b54983aec7063990fb3f66",15916291,1,-1,0,1463,401,400,-1
"2b09a08242b54983aec7063990fb3f66","2b09a08242b54983aec7063990fb3f66",15916291,4,0,1,1464,400,400,0
"2b09a08242b54983aec7063990fb3f66","9de0d567bfa84fe5b77cb76f4a76a5d1",15916291,1,5,0,1467,400,404,4
"9de0d567bfa84fe5b77cb76f4a76a5d1","9de0d567bfa84fe5b77cb76f4a76a5d1",15916291,1,0,1,1468,404,404,0
"9de0d567bfa84fe5b77cb76f4a76a5d1","1157bd665ec4472fb58b751dc5099355",15916291,1,-1,0,1469,404,403,-1
"1157bd665ec4472fb58b751dc5099355","58fc9094275e4c49be3f4ba6d4acc0a4",15916291,1,5,0,1470,403,406,3
"58fc9094275e4c49be3f4ba6d4acc0a4","3c8a22d2f9c146ea956609e3ed4f2559",15916291,1,-2,0,1471,406,405,-1
"3c8a22d2f9c146ea956609e3ed4f2559","c1c1be90b2b14c1ab4a5e1ee3c241902",15916291,1,3,0,1472,405,407,2
"c1c1be90b2b14c1ab4a5e1ee3c241902","c1c1be90b2b14c1ab4a5e1ee3c241902",15916291,5,0,1,1473,407,407,0
"c1c1be90b2b14c1ab4a5e1ee3c241902","58fc9094275e4c49be3f4ba6d4acc0a4",15916291,1,-1,0,1478,407,406,-1
"58fc9094275e4c49be3f4ba6d4acc0a4","58fc9094275e4c49be3f4ba6d4acc0a4",15916291,2,0,1,1479,406,406,0
"58fc9094275e4c49be3f4ba6d4acc0a4","02b3a1bead9244c1ba2f857c7da8f82a",15916291,1,3,0,1481,406,408,2
"02b3a1bead9244c1ba2f857c7da8f82a","58fc9094275e4c49be3f4ba6d4acc0a4",15916291,1,-3,0,1482,408,406,-2
"58fc9094275e4c49be3f4ba6d4acc0a4","6206fc6479014bb193084c32409dc1b9",15916291,1,4,0,1483,406,409,3
"6206fc6479014bb193084c32409dc1b9","6206fc6479014bb193084c32409dc1b9",15916291,2,0,1,1484,409,409,0
"6206fc6479014bb193084c32409dc1b9","02b3a1bead9244c1ba2f857c7da8f82a",15916291,1,-1,0,1486,409,408,-1
"02b3a1bead9244c1ba2f857c7da8f82a","6a5f020451db426dacba9e2ea3fcc62a",15916291,2,3,0,1487,408,410,2
"6a5f020451db426dacba9e2ea3fcc62a","02b3a1bead9244c1ba2f857c7da8f82a",15916291,1,-3,0,1488,410,408,-2
"6a5f020451db426dacba9e2ea3fcc62a","33a9d248b2e44588a5b07fc1342b9bc2",15916291,1,2,0,1490,410,411,1
"33a9d248b2e44588a5b07fc1342b9bc2","6a5f020451db426dacba9e2ea3fcc62a",15916291,1,-2,0,1491,411,410,-1
"6a5f020451db426dacba9e2ea3fcc62a","2a65ee6e2ac64f6a8a55fbe5373ec763",15916291,1,4,0,1492,410,413,3
"2a65ee6e2ac64f6a8a55fbe5373ec763","2a65ee6e2ac64f6a8a55fbe5373ec763",15916291,2,0,1,1493,413,413,0
"2a65ee6e2ac64f6a8a55fbe5373ec763","33a9d248b2e44588a5b07fc1342b9bc2",15916291,1,-2,0,1495,413,411,-2
"33a9d248b2e44588a5b07fc1342b9bc2","33a9d248b2e44588a5b07fc1342b9bc2",15916291,6,0,1,1496,411,411,0
"33a9d248b2e44588a5b07fc1342b9bc2","1fd0f6dadbc14ebc965faf6122190b96",15916291,1,5,0,1502,411,415,4
"1fd0f6dadbc14ebc965faf6122190b96","1fd0f6dadbc14ebc965faf6122190b96",15916291,1,0,1,1503,415,415,0
"1fd0f6dadbc14ebc965faf6122190b96","687055dad9fc40c3982478fe33ec01bf",15916291,1,-1,0,1504,415,414,-1
"687055dad9fc40c3982478fe33ec01bf","2add1669f08d4101913db15f8c23b3b7",15916291,1,3,0,1505,414,416,2
"2add1669f08d4101913db15f8c23b3b7","2add1669f08d4101913db15f8c23b3b7",15916291,1,0,1,1506,416,416,0
"2add1669f08d4101913db15f8c23b3b7","a2b4bd40cee2481ebd3fc179d6a5cd62",15916291,1,3,0,1507,416,417,1
"a2b4bd40cee2481ebd3fc179d6a5cd62","2b09a08242b54983aec7063990fb3f66",15916291,1,-27,0,1508,417,400,-17
"2b09a08242b54983aec7063990fb3f66","a2b4bd40cee2481ebd3fc179d6a5cd62",15916291,1,27,0,1509,400,417,17
"a2b4bd40cee2481ebd3fc179d6a5cd62","a2b4bd40cee2481ebd3fc179d6a5cd62",15916291,4,0,1,1510,417,417,0
"a2b4bd40cee2481ebd3fc179d6a5cd62","e34e59dce2204f228f3a84b6725df60f",15916291,1,2,0,1512,417,419,2
"e34e59dce2204f228f3a84b6725df60f","e34e59dce2204f228f3a84b6725df60f",15916291,2,0,1,1513,419,419,0
"e34e59dce2204f228f3a84b6725df60f","a2b4bd40cee2481ebd3fc179d6a5cd62",15916291,1,-2,0,1514,419,417,-2
"a2b4bd40cee2481ebd3fc179d6a5cd62","bec48fc2e1294c7eb3d0aca780d731b8",15916291,3,4,0,1515,417,420,3
"bec48fc2e1294c7eb3d0aca780d731b8","24cf8786024543f19b89bc20034e60d7",15916291,1,14,0,1516,420,428,8
"24cf8786024543f19b89bc20034e60d7","f2a73be2f46840b182d7bd095378004e",15916291,2,1,0,1517,428,429,1
"f2a73be2f46840b182d7bd095378004e","dce46f8904594a62a6377a3587aaa663",15916291,1,3,0,1518,429,431,2
"dce46f8904594a62a6377a3587aaa663","24cf8786024543f19b89bc20034e60d7",15916291,1,-4,0,1519,431,428,-3
"24cf8786024543f19b89bc20034e60d7","dce46f8904594a62a6377a3587aaa663",15916291,2,4,0,1520,428,431,3
"dce46f8904594a62a6377a3587aaa663","66ada10dde9f43018588f1ced9d477fc",15916291,1,4,0,1521,431,434,3
"66ada10dde9f43018588f1ced9d477fc","070600601c4c439288445d2f0724807d",15916291,1,6,0,1522,434,437,3
"070600601c4c439288445d2f0724807d","24cf8786024543f19b89bc20034e60d7",15916291,1,-14,0,1523,437,428,-9
"24cf8786024543f19b89bc20034e60d7","1823b6de7d334a7aaabc4570719af4d9",15916291,1,16,0,1524,428,439,11
"1823b6de7d334a7aaabc4570719af4d9","1823b6de7d334a7aaabc4570719af4d9",15916291,10,0,1,1525,439,439,0
"1823b6de7d334a7aaabc4570719af4d9","070600601c4c439288445d2f0724807d",15916291,2,-2,0,1535,439,437,-2
"070600601c4c439288445d2f0724807d","0380cd76a7d44bc3a4da1f15e4d68f89",15916291,2,4,0,1536,437,440,3
"0380cd76a7d44bc3a4da1f15e4d68f89","b71bac264efb4abd97015447bd490db6",15916291,1,-107,0,1537,440,370,-70
"8d448d625b024c82a5eb240bbd7431d6","d6d02b6ef04e4f17805504500b8ce441",15916291,1,3,0,1548,374,375,1
"d6d02b6ef04e4f17805504500b8ce441","b71bac264efb4abd97015447bd490db6",15916291,1,-8,0,1549,375,370,-5
"7f544639412e40a9ba27f43b415362ab","96bb2b3e85a34d8b9544514e89f6fe97",15916291,1,15,0,1554,378,390,12
"96bb2b3e85a34d8b9544514e89f6fe97","66baf19b6b904b70922329068c63746d",15916291,1,-17,0,1555,390,376,-14
"66baf19b6b904b70922329068c63746d","17f95d18bab743888e1736033dc3384d",15916291,1,16,0,1556,376,389,13
"f7002c8484354eceac57bc7bd62c76c1","0c12af0a4e7f4002852cf84b2537c161",15916291,1,3,0,1559,393,395,2
"0c12af0a4e7f4002852cf84b2537c161","66baf19b6b904b70922329068c63746d",15916291,1,-24,0,1560,395,376,-19
"66baf19b6b904b70922329068c63746d","a2b4bd40cee2481ebd3fc179d6a5cd62",15916291,1,59,0,1566,376,417,41
"bec48fc2e1294c7eb3d0aca780d731b8","bec48fc2e1294c7eb3d0aca780d731b8",15916291,9,0,1,1570,420,420,0
"bec48fc2e1294c7eb3d0aca780d731b8","dbde19fcce2a4c1abdc7f685c293a23f",15916291,1,3,0,1571,420,422,2
"dbde19fcce2a4c1abdc7f685c293a23f","bec48fc2e1294c7eb3d0aca780d731b8",15916291,1,-3,0,1572,422,420,-2
"bec48fc2e1294c7eb3d0aca780d731b8","e34e59dce2204f228f3a84b6725df60f",15916291,1,-2,0,1574,420,419,-1
"e34e59dce2204f228f3a84b6725df60f","bec48fc2e1294c7eb3d0aca780d731b8",15916291,1,2,0,1576,419,420,1
"bec48fc2e1294c7eb3d0aca780d731b8","a2b4bd40cee2481ebd3fc179d6a5cd62",15916291,1,-4,0,1577,420,417,-3
"bec48fc2e1294c7eb3d0aca780d731b8","a24600b0e49245f6bdba8c893cfeddb0",15916291,1,7,0,1586,420,425,5
"a24600b0e49245f6bdba8c893cfeddb0","dbde19fcce2a4c1abdc7f685c293a23f",15916291,1,-4,0,1587,425,422,-3
"dbde19fcce2a4c1abdc7f685c293a23f","a24600b0e49245f6bdba8c893cfeddb0",15916291,1,4,0,1588,422,425,3
"a24600b0e49245f6bdba8c893cfeddb0","a24600b0e49245f6bdba8c893cfeddb0",15916291,5,0,1,1589,425,425,0
"a24600b0e49245f6bdba8c893cfeddb0","a2b4bd40cee2481ebd3fc179d6a5cd62",15916291,1,-11,0,1594,425,417,-8
"a2b4bd40cee2481ebd3fc179d6a5cd62","24cf8786024543f19b89bc20034e60d7",15916291,1,18,0,1595,417,428,11
"f2a73be2f46840b182d7bd095378004e","f2a73be2f46840b182d7bd095378004e",15916291,14,0,1,1597,429,429,0
"f2a73be2f46840b182d7bd095378004e","604551fd4266430cb860fef58fa7dd61",15916291,1,1,0,1598,429,430,1
"604551fd4266430cb860fef58fa7dd61","604551fd4266430cb860fef58fa7dd61",15916291,2,0,1,1599,430,430,0
"604551fd4266430cb860fef58fa7dd61","f2a73be2f46840b182d7bd095378004e",15916291,1,-1,0,1601,430,429,-1
"f2a73be2f46840b182d7bd095378004e","24cf8786024543f19b89bc20034e60d7",15916291,1,-1,0,1615,429,428,-1
"dce46f8904594a62a6377a3587aaa663","dce46f8904594a62a6377a3587aaa663",15916291,1,0,1,1617,431,431,0
"dce46f8904594a62a6377a3587aaa663","061c175cc90f45fbad883025394e78dd",15916291,1,2,0,1618,431,433,2
"061c175cc90f45fbad883025394e78dd","061c175cc90f45fbad883025394e78dd",15916291,2,0,1,1619,433,433,0
"061c175cc90f45fbad883025394e78dd","9b9d0a249052413c869753b99682b0ac",15916291,1,-1,0,1621,433,432,-1
"9b9d0a249052413c869753b99682b0ac","9b9d0a249052413c869753b99682b0ac",15916291,1,0,1,1622,432,432,0
"9b9d0a249052413c869753b99682b0ac","dce46f8904594a62a6377a3587aaa663",15916291,1,-1,0,1623,432,431,-1
"dce46f8904594a62a6377a3587aaa663","74a7f8712e5449c2bc0b43c6f90dafed",15916291,1,5,0,1624,431,435,4
"74a7f8712e5449c2bc0b43c6f90dafed","74a7f8712e5449c2bc0b43c6f90dafed",15916291,1,0,1,1625,435,435,0
"74a7f8712e5449c2bc0b43c6f90dafed","66ada10dde9f43018588f1ced9d477fc",15916291,1,-1,0,1626,435,434,-1
"66ada10dde9f43018588f1ced9d477fc","bf12c96466d840a69bed7020b3f18bb8",15916291,1,3,0,1627,434,436,2
"bf12c96466d840a69bed7020b3f18bb8","bf12c96466d840a69bed7020b3f18bb8",15916291,1,0,1,1628,436,436,0
"bf12c96466d840a69bed7020b3f18bb8","24cf8786024543f19b89bc20034e60d7",15916291,1,-11,0,1629,436,428,-8
"24cf8786024543f19b89bc20034e60d7","070600601c4c439288445d2f0724807d",15916291,1,14,0,1630,428,437,9
"070600601c4c439288445d2f0724807d","1823b6de7d334a7aaabc4570719af4d9",15916291,1,2,0,1631,437,439,2
"0380cd76a7d44bc3a4da1f15e4d68f89","0380cd76a7d44bc3a4da1f15e4d68f89",15916291,1,0,1,1634,440,440,0
"0380cd76a7d44bc3a4da1f15e4d68f89","23b7673c8b5443108c2ef09382834a86",15916291,1,2,0,1635,440,441,1
"23b7673c8b5443108c2ef09382834a86","23b7673c8b5443108c2ef09382834a86",15916291,2,0,1,1636,441,441,0
"23b7673c8b5443108c2ef09382834a86","901e92500aea43c79f19f1b279050668",15916291,1,2,0,1638,441,442,1
"901e92500aea43c79f19f1b279050668","901e92500aea43c79f19f1b279050668",15916291,4,0,1,1639,442,442,0
"901e92500aea43c79f19f1b279050668","4660ff2089114e8db82ceb26a4f329e3",15916291,1,4,0,1643,442,445,3
"4660ff2089114e8db82ceb26a4f329e3","4660ff2089114e8db82ceb26a4f329e3",15916291,2,0,1,1644,445,445,0
"4660ff2089114e8db82ceb26a4f329e3","7bd5586eb9d8484eb74a433ee7bfe499",15916291,1,2,0,1646,445,446,1
"7bd5586eb9d8484eb74a433ee7bfe499","7bd5586eb9d8484eb74a433ee7bfe499",15916291,19,0,1,1647,446,446,0
"7bd5586eb9d8484eb74a433ee7bfe499","8a7f26e690f34dda97be16904518ca99",15916291,1,2,0,1666,446,447,1
"8a7f26e690f34dda97be16904518ca99","8a7f26e690f34dda97be16904518ca99",15916291,1,0,1,1667,447,447,0
"8a7f26e690f34dda97be16904518ca99","b2f0d654738f48158edff28e8d3a546e",15916291,1,5,0,1668,447,449,2
"b2f0d654738f48158edff28e8d3a546e","070600601c4c439288445d2f0724807d",15916291,1,-21,0,1669,449,437,-12
"070600601c4c439288445d2f0724807d","b2f0d654738f48158edff28e8d3a546e",15916291,1,21,0,1670,437,449,12
"b2f0d654738f48158edff28e8d3a546e","f60ee41ec635499abd48168342d32c2f",15916291,1,5,0,1671,449,453,4
"f60ee41ec635499abd48168342d32c2f","f60ee41ec635499abd48168342d32c2f",15916291,7,0,1,1672,453,453,0
"f60ee41ec635499abd48168342d32c2f","f67fbf45a5f146ed866965bc57c7c001",15916291,1,3,0,1679,453,454,1
"f67fbf45a5f146ed866965bc57c7c001","b2f0d654738f48158edff28e8d3a546e",15916291,1,-8,0,1680,454,449,-5
"b2f0d654738f48158edff28e8d3a546e","f67fbf45a5f146ed866965bc57c7c001",15916291,1,8,0,1681,449,454,5
"f67fbf45a5f146ed866965bc57c7c001","f67fbf45a5f146ed866965bc57c7c001",15916291,1,0,1,1682,454,454,0
"f67fbf45a5f146ed866965bc57c7c001","d937afe49bd24a07a550dda1c1155122",15916291,1,1,0,1683,454,455,1
"d937afe49bd24a07a550dda1c1155122","d937afe49bd24a07a550dda1c1155122",15916291,1,0,1,1684,455,455,0
"d937afe49bd24a07a550dda1c1155122","3628b3f7823443d0912a339096b69943",15916291,1,1,0,1685,455,456,1
"3628b3f7823443d0912a339096b69943","3628b3f7823443d0912a339096b69943",15916291,1,0,1,1686,456,456,0
"3628b3f7823443d0912a339096b69943","9e049ee647cf43ecbcb5ed792a8e7588",15916291,1,1,0,1687,456,457,1
"9e049ee647cf43ecbcb5ed792a8e7588","9e049ee647cf43ecbcb5ed792a8e7588",15916291,1,0,1,1688,457,457,0
"9e049ee647cf43ecbcb5ed792a8e7588","5256a214faaf410b93f76cea06428334",15916291,1,1,0,1689,457,458,1
"5256a214faaf410b93f76cea06428334","5256a214faaf410b93f76cea06428334",15916291,1,0,1,1690,458,458,0
"5256a214faaf410b93f76cea06428334","42de338840a34d15adb66e7b14fb9d2c",15916291,1,3,0,1691,458,461,3
"42de338840a34d15adb66e7b14fb9d2c","42de338840a34d15adb66e7b14fb9d2c",15916291,1,0,1,1692,461,461,0
"42de338840a34d15adb66e7b14fb9d2c","25c32b120fce40fa9b6c85133aeb4716",15916291,1,-2,0,1693,461,459,-2
"25c32b120fce40fa9b6c85133aeb4716","25c32b120fce40fa9b6c85133aeb4716",15916291,5,0,1,1694,459,459,0
"25c32b120fce40fa9b6c85133aeb4716","11bc14f2204949008b7d511b933363c1",15916291,1,1,0,1699,459,460,1
"11bc14f2204949008b7d511b933363c1","11bc14f2204949008b7d511b933363c1",15916291,5,0,1,1700,460,460,0
"11bc14f2204949008b7d511b933363c1","9da37c6210b1416b8079c274f70bf600",15916291,1,2,0,1705,460,462,2
"9da37c6210b1416b8079c274f70bf600","9da37c6210b1416b8079c274f70bf600",15916291,9,0,1,1706,462,462,0
"9da37c6210b1416b8079c274f70bf600","519119f1deac45ff9ab4f13529be5c6e",15916291,1,1,0,1715,462,463,1
"519119f1deac45ff9ab4f13529be5c6e","519119f1deac45ff9ab4f13529be5c6e",15916291,5,0,1,1716,463,463,0
"519119f1deac45ff9ab4f13529be5c6e","f67fbf45a5f146ed866965bc57c7c001",15916291,1,-9,0,1721,463,454,-9
"f67fbf45a5f146ed866965bc57c7c001","c5df9f40ec14463b9dcfdc73df3e9285",15916291,1,12,0,1722,454,464,10
"c5df9f40ec14463b9dcfdc73df3e9285","c5df9f40ec14463b9dcfdc73df3e9285",15916291,2,0,1,1723,464,464,0
"c5df9f40ec14463b9dcfdc73df3e9285","83d42d95cd844fc093fc09cee250edb8",15916291,1,3,0,1725,464,465,1
"83d42d95cd844fc093fc09cee250edb8","83d42d95cd844fc093fc09cee250edb8",15916291,10,0,1,1726,465,465,0
"67a089198fcb4e1c8f2385786c2b296f","b613861cecf84ffcab01afb23f660475",22368716,1,-72,0,1,39,1,-38
"b613861cecf84ffcab01afb23f660475","b613861cecf84ffcab01afb23f660475",22368716,4,0,1,2,1,1,0
"b613861cecf84ffcab01afb23f660475","e2911e79efc2420eac45d9f671463d4b",22368716,1,3,0,6,1,2,1
"e2911e79efc2420eac45d9f671463d4b","e2911e79efc2420eac45d9f671463d4b",22368716,2,0,1,7,2,2,0
"e2911e79efc2420eac45d9f671463d4b","519d1b8c59404d67b54e96c5c8a830b2",22368716,1,1,0,9,2,3,1
"519d1b8c59404d67b54e96c5c8a830b2","519d1b8c59404d67b54e96c5c8a830b2",22368716,1,0,1,10,3,3,0
"519d1b8c59404d67b54e96c5c8a830b2","531db53f81f646edb0cdcfe0085b03b7",22368716,1,1,0,11,3,4,1
"531db53f81f646edb0cdcfe0085b03b7","531db53f81f646edb0cdcfe0085b03b7",22368716,1,0,1,12,4,4,0
"531db53f81f646edb0cdcfe0085b03b7","4f5f94b2f95141e0a9d53a61da2276da",22368716,1,1,0,13,4,5,1
"4f5f94b2f95141e0a9d53a61da2276da","4f5f94b2f95141e0a9d53a61da2276da",22368716,1,0,1,14,5,5,0
"4f5f94b2f95141e0a9d53a61da2276da","6d541c89590949f99af293c4f2333f67",22368716,1,1,0,15,5,6,1
"6d541c89590949f99af293c4f2333f67","6d541c89590949f99af293c4f2333f67",22368716,1,0,1,16,6,6,0
"6d541c89590949f99af293c4f2333f67","dd5cf0b9fe4c4f1d8f5ff8e4c04879cb",22368716,1,1,0,17,6,7,1
"dd5cf0b9fe4c4f1d8f5ff8e4c04879cb","dd5cf0b9fe4c4f1d8f5ff8e4c04879cb",22368716,1,0,1,18,7,7,0
"dd5cf0b9fe4c4f1d8f5ff8e4c04879cb","f96261861edc426abe2248be4f0a709a",22368716,1,1,0,19,7,8,1
"f96261861edc426abe2248be4f0a709a","f96261861edc426abe2248be4f0a709a",22368716,1,0,1,20,8,8,0
"f96261861edc426abe2248be4f0a709a","66b5e16f4f75454fb5b8172079f0fa83",22368716,1,1,0,21,8,9,1
"66b5e16f4f75454fb5b8172079f0fa83","66b5e16f4f75454fb5b8172079f0fa83",22368716,1,0,1,22,9,9,0
"66b5e16f4f75454fb5b8172079f0fa83","0680571d4698477995e41842c36a54b2",22368716,1,1,0,23,9,10,1
"0680571d4698477995e41842c36a54b2","0680571d4698477995e41842c36a54b2",22368716,2,0,1,24,10,10,0
"0680571d4698477995e41842c36a54b2","9112f2bffece48e08c6d2287be204085",22368716,2,1,0,25,10,11,1
"9112f2bffece48e08c6d2287be204085","9112f2bffece48e08c6d2287be204085",22368716,3,0,1,26,11,11,0
"9112f2bffece48e08c6d2287be204085","56586aa865414f538729c7f7735d2bc6",22368716,1,3,0,27,11,12,1
"56586aa865414f538729c7f7735d2bc6","e2911e79efc2420eac45d9f671463d4b",22368716,1,-12,0,28,12,2,-10
"e2911e79efc2420eac45d9f671463d4b","56586aa865414f538729c7f7735d2bc6",22368716,2,12,0,29,2,12,10
"56586aa865414f538729c7f7735d2bc6","9112f2bffece48e08c6d2287be204085",22368716,1,-3,0,30,12,11,-1
"9112f2bffece48e08c6d2287be204085","e2911e79efc2420eac45d9f671463d4b",22368716,2,-9,0,32,11,2,-9
"e2911e79efc2420eac45d9f671463d4b","0680571d4698477995e41842c36a54b2",22368716,1,8,0,33,2,10,8
"56586aa865414f538729c7f7735d2bc6","56586aa865414f538729c7f7735d2bc6",22368716,3,0,1,39,12,12,0
"56586aa865414f538729c7f7735d2bc6","b7f2b31585d94eb3bf86376714aa7070",22368716,1,2,0,42,12,13,1
"b7f2b31585d94eb3bf86376714aa7070","b7f2b31585d94eb3bf86376714aa7070",22368716,2,0,1,43,13,13,0
"b7f2b31585d94eb3bf86376714aa7070","3f1c815879794b929260d224becaff7e",22368716,1,2,0,45,13,14,1
"3f1c815879794b929260d224becaff7e","5c5ceeee4562457ba6d41515aeebfbb1",22368716,1,6,0,46,14,17,3
"5c5ceeee4562457ba6d41515aeebfbb1","81c864a886d54a6b8ff85f7d736f4f95",22368716,1,-4,0,47,17,15,-2
"81c864a886d54a6b8ff85f7d736f4f95","5c5ceeee4562457ba6d41515aeebfbb1",22368716,1,4,0,48,15,17,2
"5c5ceeee4562457ba6d41515aeebfbb1","56586aa865414f538729c7f7735d2bc6",22368716,1,-10,0,49,17,12,-5
"56586aa865414f538729c7f7735d2bc6","9afd71a5298d4333b6849dfce1b9422c",22368716,1,13,0,50,12,18,6
"9afd71a5298d4333b6849dfce1b9422c","b7719e26494940efa49512aedd0aac79",22368716,1,4,0,51,18,20,2
"b7719e26494940efa49512aedd0aac79","9afd71a5298d4333b6849dfce1b9422c",22368716,1,-4,0,52,20,18,-2
"9afd71a5298d4333b6849dfce1b9422c","d4f45188d3c84a02ba08454e6403a818",22368716,1,9,0,53,18,24,6
"d4f45188d3c84a02ba08454e6403a818","d4c3b003e8274e429d2fa688d73fde6d",22368716,2,-2,0,54,24,22,-2
"d4c3b003e8274e429d2fa688d73fde6d","d4c3b003e8274e429d2fa688d73fde6d",22368716,1,0,1,55,22,22,0
"d4c3b003e8274e429d2fa688d73fde6d","b7719e26494940efa49512aedd0aac79",22368716,2,-3,0,56,22,20,-2
"b7719e26494940efa49512aedd0aac79","d4f45188d3c84a02ba08454e6403a818",22368716,1,5,0,57,20,24,4
"b7719e26494940efa49512aedd0aac79","b7719e26494940efa49512aedd0aac79",22368716,1,0,1,60,20,20,0
"b7719e26494940efa49512aedd0aac79","afbf7250b99d47bea07172749483ca97",22368716,1,12,0,61,20,28,8
"afbf7250b99d47bea07172749483ca97","afbf7250b99d47bea07172749483ca97",22368716,1,0,1,62,28,28,0
"afbf7250b99d47bea07172749483ca97","4e51676dc72045d99c19b9fa7b22f8bc",22368716,1,3,0,63,28,29,1
"4e51676dc72045d99c19b9fa7b22f8bc","4e51676dc72045d99c19b9fa7b22f8bc",22368716,1,0,1,64,29,29,0
"4e51676dc72045d99c19b9fa7b22f8bc","51970cfa30e643e894e66ae85c8024cc",22368716,1,3,0,65,29,31,2
"51970cfa30e643e894e66ae85c8024cc","4e51676dc72045d99c19b9fa7b22f8bc",22368716,1,-3,0,66,31,29,-2
"4e51676dc72045d99c19b9fa7b22f8bc","c33c17be71ae4d588da7369472e5bb1b",22368716,1,9,0,67,29,34,5
"c33c17be71ae4d588da7369472e5bb1b","c33c17be71ae4d588da7369472e5bb1b",22368716,1,0,1,68,34,34,0
"c33c17be71ae4d588da7369472e5bb1b","93679be414554a11b1893002f2229a93",22368716,1,3,0,69,34,35,1
"93679be414554a11b1893002f2229a93","93679be414554a11b1893002f2229a93",22368716,2,0,1,70,35,35,0
"93679be414554a11b1893002f2229a93","7040a13096d746ac84b8fac8d9752058",22368716,3,3,0,71,35,36,1
"7040a13096d746ac84b8fac8d9752058","9a0dc646f934470daf08c4b56ccf73db",22368716,2,3,0,72,36,37,1
"9a0dc646f934470daf08c4b56ccf73db","7040a13096d746ac84b8fac8d9752058",22368716,1,-3,0,73,37,36,-1
"9a0dc646f934470daf08c4b56ccf73db","fc0e049d56024bc9a02c9a9c435c3df7",22368716,1,3,0,75,37,38,1
"fc0e049d56024bc9a02c9a9c435c3df7","67a089198fcb4e1c8f2385786c2b296f",22368716,1,4,0,76,38,39,1
"67a089198fcb4e1c8f2385786c2b296f","fc0e049d56024bc9a02c9a9c435c3df7",22368716,1,-4,0,77,39,38,-1
"fc0e049d56024bc9a02c9a9c435c3df7","64d48c6c9c7940639a932219a6c87198",22368716,1,5,0,78,38,40,2
"64d48c6c9c7940639a932219a6c87198","67a089198fcb4e1c8f2385786c2b296f",22368716,1,-1,0,79,40,39,-1
"67a089198fcb4e1c8f2385786c2b296f","67a089198fcb4e1c8f2385786c2b296f",22368716,2,0,1,80,39,39,0
"67a089198fcb4e1c8f2385786c2b296f","64d48c6c9c7940639a932219a6c87198",22368716,1,1,0,82,39,40,1
"64d48c6c9c7940639a932219a6c87198","64d48c6c9c7940639a932219a6c87198",22368716,2,0,1,83,40,40,0
"64d48c6c9c7940639a932219a6c87198","b534b89233134e30a9b5645138bfa9ee",22368716,1,3,0,85,40,41,1
"b534b89233134e30a9b5645138bfa9ee","67a089198fcb4e1c8f2385786c2b296f",22368716,1,-4,0,86,41,39,-2
"67a089198fcb4e1c8f2385786c2b296f","6875d67fdd5f48168b62719df449bebd",22368716,1,8,0,87,39,45,6
"6875d67fdd5f48168b62719df449bebd","6875d67fdd5f48168b62719df449bebd",22368716,1,0,1,88,45,45,0
"6875d67fdd5f48168b62719df449bebd","6e13d61a7bdb44bca949c9f86fab3be5",22368716,1,3,0,89,45,47,2
"6e13d61a7bdb44bca949c9f86fab3be5","b534b89233134e30a9b5645138bfa9ee",22368716,1,-7,0,90,47,41,-6
"b534b89233134e30a9b5645138bfa9ee","6e13d61a7bdb44bca949c9f86fab3be5",22368716,1,7,0,91,41,47,6
"6e13d61a7bdb44bca949c9f86fab3be5","195f78799f984cc2b06c48dfe36be751",22368716,1,2,0,92,47,49,2
"195f78799f984cc2b06c48dfe36be751","195f78799f984cc2b06c48dfe36be751",22368716,2,0,1,93,49,49,0
"195f78799f984cc2b06c48dfe36be751","d9c8d8c444a64dadbbb508652c721e17",22368716,1,-3,0,95,49,46,-3
"d9c8d8c444a64dadbbb508652c721e17","d0c74f735e024943943e40333d6d337f",22368716,1,6,0,96,46,51,5
"d0c74f735e024943943e40333d6d337f","d0c74f735e024943943e40333d6d337f",22368716,1,0,1,97,51,51,0
"d0c74f735e024943943e40333d6d337f","983f8ff320594b279a7f4a6fe132f9c5",22368716,1,2,0,98,51,53,2
"983f8ff320594b279a7f4a6fe132f9c5","983f8ff320594b279a7f4a6fe132f9c5",22368716,2,0,1,100,53,53,0
"983f8ff320594b279a7f4a6fe132f9c5","35adfa5d923046aebabfefd98f35ff05",22368716,1,1,0,101,53,54,1
"35adfa5d923046aebabfefd98f35ff05","35adfa5d923046aebabfefd98f35ff05",22368716,2,0,1,102,54,54,0
"35adfa5d923046aebabfefd98f35ff05","b6f8a98476224da1b40e555ececc7ed8",22368716,1,1,0,104,54,55,1
"b6f8a98476224da1b40e555ececc7ed8","b6f8a98476224da1b40e555ececc7ed8",22368716,2,0,1,105,55,55,0
"b6f8a98476224da1b40e555ececc7ed8","86e22cb5fe0e4b47a9489ecddf7ed78f",22368716,1,1,0,107,55,56,1
"86e22cb5fe0e4b47a9489ecddf7ed78f","86e22cb5fe0e4b47a9489ecddf7ed78f",22368716,2,0,1,108,56,56,0
"86e22cb5fe0e4b47a9489ecddf7ed78f","f924752d8a1149668870b1e7698486f7",22368716,1,-6,0,110,56,50,-6
"f924752d8a1149668870b1e7698486f7","78f30e4dcac84e3cbea8b2cc6e0d62b3",22368716,1,10,0,111,50,59,9
"78f30e4dcac84e3cbea8b2cc6e0d62b3","a1f2f12debe5432fb7a70bcd12bacfb9",22368716,1,-1,0,112,59,58,-1
"a1f2f12debe5432fb7a70bcd12bacfb9","a1f2f12debe5432fb7a70bcd12bacfb9",22368716,12,0,1,113,58,58,0
"a1f2f12debe5432fb7a70bcd12bacfb9","78f30e4dcac84e3cbea8b2cc6e0d62b3",22368716,1,1,0,125,58,59,1
"78f30e4dcac84e3cbea8b2cc6e0d62b3","78f30e4dcac84e3cbea8b2cc6e0d62b3",22368716,17,0,1,126,59,59,0
"78f30e4dcac84e3cbea8b2cc6e0d62b3","12aa6e1672ac4e7aa6449a7a8609cd72",22368716,1,-2,0,143,59,57,-2
"12aa6e1672ac4e7aa6449a7a8609cd72","bc42d26810654ea9a1df1efe1e58c7d5",22368716,1,7,0,144,57,63,6
"bc42d26810654ea9a1df1efe1e58c7d5","a0a418b8540d479fa6e0f653b701da8b",22368716,2,1,0,145,63,64,1
"a0a418b8540d479fa6e0f653b701da8b","bc42d26810654ea9a1df1efe1e58c7d5",22368716,1,-1,0,146,64,63,-1
"bc42d26810654ea9a1df1efe1e58c7d5","bc42d26810654ea9a1df1efe1e58c7d5",22368716,3,0,1,147,63,63,0
"a0a418b8540d479fa6e0f653b701da8b","a0a418b8540d479fa6e0f653b701da8b",22368716,3,0,1,151,64,64,0
"a0a418b8540d479fa6e0f653b701da8b","4c943503763e4e349906eea3ed3c8e86",22368716,1,-3,0,154,64,61,-3
"4c943503763e4e349906eea3ed3c8e86","4c943503763e4e349906eea3ed3c8e86",22368716,1,0,1,155,61,61,0
"4c943503763e4e349906eea3ed3c8e86","309ccf3cc4fe429d9bfbaef53d3fa479",22368716,1,-1,0,156,61,60,-1
"309ccf3cc4fe429d9bfbaef53d3fa479","b534b89233134e30a9b5645138bfa9ee",22368716,1,-23,0,157,60,41,-19
"b534b89233134e30a9b5645138bfa9ee","d646286c8051419bbc2e31dd1db55ca8",22368716,1,33,0,158,41,67,26
"d646286c8051419bbc2e31dd1db55ca8","267f883678b24aed855fde42524975d9",22368716,1,4,0,159,67,71,4
"267f883678b24aed855fde42524975d9","267f883678b24aed855fde42524975d9",22368716,1,0,1,160,71,71,0
"267f883678b24aed855fde42524975d9","88fff56d0342490dbef9040750a20f6c",22368716,1,1,0,161,71,72,1
"88fff56d0342490dbef9040750a20f6c","88fff56d0342490dbef9040750a20f6c",22368716,1,0,1,162,72,72,0
"88fff56d0342490dbef9040750a20f6c","adb17b12b66c4a49a85fd34322f7df70",22368716,1,1,0,163,72,73,1
"adb17b12b66c4a49a85fd34322f7df70","adb17b12b66c4a49a85fd34322f7df70",22368716,1,0,1,164,73,73,0
"adb17b12b66c4a49a85fd34322f7df70","d646286c8051419bbc2e31dd1db55ca8",22368716,1,-6,0,165,73,67,-6
"d646286c8051419bbc2e31dd1db55ca8","a2becd407db34b189200a32546d9d569",22368716,1,9,0,166,67,75,8
"a2becd407db34b189200a32546d9d569","a2becd407db34b189200a32546d9d569",22368716,1,0,1,167,75,75,0
"a2becd407db34b189200a32546d9d569","58c22b011d0f4c2ea6d13615edbb9eeb",22368716,1,2,0,168,75,77,2
"58c22b011d0f4c2ea6d13615edbb9eeb","58c22b011d0f4c2ea6d13615edbb9eeb",22368716,2,0,1,169,77,77,0
"58c22b011d0f4c2ea6d13615edbb9eeb","dd76e1861dc9461c830888729d091ee0",22368716,1,1,0,171,77,78,1
"dd76e1861dc9461c830888729d091ee0","dd76e1861dc9461c830888729d091ee0",22368716,5,0,1,172,78,78,0
"dd76e1861dc9461c830888729d091ee0","cd1d828f1a694b87913a7ea66c23803e",22368716,1,1,0,177,78,79,1
"cd1d828f1a694b87913a7ea66c23803e","cd1d828f1a694b87913a7ea66c23803e",22368716,5,0,1,178,79,79,0
"cd1d828f1a694b87913a7ea66c23803e","9176a3c2b4d2465fa8b0c67096c2a97e",22368716,1,1,0,183,79,80,1
"9176a3c2b4d2465fa8b0c67096c2a97e","9176a3c2b4d2465fa8b0c67096c2a97e",22368716,5,0,1,184,80,80,0
"9176a3c2b4d2465fa8b0c67096c2a97e","f8ec6445f7194e25b9101d4fbcb07a18",22368716,1,1,0,189,80,81,1
"f8ec6445f7194e25b9101d4fbcb07a18","f8ec6445f7194e25b9101d4fbcb07a18",22368716,5,0,1,190,81,81,0
"f8ec6445f7194e25b9101d4fbcb07a18","140d5b27b8574befad82c0a013b59dfa",22368716,1,-7,0,195,81,74,-7
"140d5b27b8574befad82c0a013b59dfa","d18a9ea32855445f8736581f5cb119ce",22368716,1,9,0,196,74,82,8
"d18a9ea32855445f8736581f5cb119ce","f564483cbd7a407681aa2fcca518cf5f",22368716,1,4,0,197,82,85,3
"f564483cbd7a407681aa2fcca518cf5f","f564483cbd7a407681aa2fcca518cf5f",22368716,1,0,1,198,85,85,0
"f564483cbd7a407681aa2fcca518cf5f","18fd01350bd5434ca636d59a599d768a",22368716,1,1,0,199,85,86,1
"18fd01350bd5434ca636d59a599d768a","18fd01350bd5434ca636d59a599d768a",22368716,9,0,1,200,86,86,0
"18fd01350bd5434ca636d59a599d768a","ae5ac430ea254e708a6f5deaaf7464ae",22368716,1,-2,0,209,86,84,-2
"ae5ac430ea254e708a6f5deaaf7464ae","6a9f0ef185fb47f0937e29daa1c71ed5",22368716,2,7,0,210,84,90,6
"6a9f0ef185fb47f0937e29daa1c71ed5","42fb58708eaf4e5daa82bfca61b6f5fd",22368716,2,-3,0,211,90,87,-3
"42fb58708eaf4e5daa82bfca61b6f5fd","6a9f0ef185fb47f0937e29daa1c71ed5",22368716,1,3,0,212,87,90,3
"6a9f0ef185fb47f0937e29daa1c71ed5","ae5ac430ea254e708a6f5deaaf7464ae",22368716,1,-7,0,213,90,84,-6
"ae5ac430ea254e708a6f5deaaf7464ae","c681290961c94c4caf23b529d1ae6b9a",22368716,1,5,0,214,84,88,4
"c681290961c94c4caf23b529d1ae6b9a","c681290961c94c4caf23b529d1ae6b9a",22368716,1,0,1,215,88,88,0
"c681290961c94c4caf23b529d1ae6b9a","6a9f0ef185fb47f0937e29daa1c71ed5",22368716,1,2,0,216,88,90,2
"6a9f0ef185fb47f0937e29daa1c71ed5","6a9f0ef185fb47f0937e29daa1c71ed5",22368716,7,0,1,217,90,90,0
"6a9f0ef185fb47f0937e29daa1c71ed5","d646286c8051419bbc2e31dd1db55ca8",22368716,2,-27,0,220,90,67,-23
"d646286c8051419bbc2e31dd1db55ca8","e20db35ced8544ddac5bc3839145e463",22368716,2,30,0,221,67,91,24
"e20db35ced8544ddac5bc3839145e463","1febb706d7a34005ae8711ed49c76e64",22368716,1,3,0,222,91,94,3
"1febb706d7a34005ae8711ed49c76e64","1febb706d7a34005ae8711ed49c76e64",22368716,2,0,1,223,94,94,0
"1febb706d7a34005ae8711ed49c76e64","8f73ba6f5a0042f2850356ac38ac6f24",22368716,1,1,0,225,94,95,1
"8f73ba6f5a0042f2850356ac38ac6f24","8f73ba6f5a0042f2850356ac38ac6f24",22368716,5,0,1,226,95,95,0
"8f73ba6f5a0042f2850356ac38ac6f24","e2260b86653c46d7b14a41fb419dbf8c",22368716,1,1,0,231,95,96,1
"e2260b86653c46d7b14a41fb419dbf8c","e2260b86653c46d7b14a41fb419dbf8c",22368716,2,0,1,232,96,96,0
"e2260b86653c46d7b14a41fb419dbf8c","35eb641ad1d845bbba54915bce75a962",22368716,1,1,0,234,96,97,1
"35eb641ad1d845bbba54915bce75a962","35eb641ad1d845bbba54915bce75a962",22368716,2,0,1,235,97,97,0
"35eb641ad1d845bbba54915bce75a962","08be90ffbeea4795a138cd42ed8db56f",22368716,1,1,0,237,97,98,1
"08be90ffbeea4795a138cd42ed8db56f","08be90ffbeea4795a138cd42ed8db56f",22368716,5,0,1,238,98,98,0
"08be90ffbeea4795a138cd42ed8db56f","3007433c8f584dcbb5ac159c1c5f2be3",22368716,1,1,0,243,98,99,1
"3007433c8f584dcbb5ac159c1c5f2be3","3007433c8f584dcbb5ac159c1c5f2be3",22368716,5,0,1,244,99,99,0
"3007433c8f584dcbb5ac159c1c5f2be3","e20db35ced8544ddac5bc3839145e463",22368716,1,-8,0,249,99,91,-8
"e20db35ced8544ddac5bc3839145e463","00ae5f0c51874a73a41ebea838d95682",22368716,3,11,0,250,91,101,10
"00ae5f0c51874a73a41ebea838d95682","d391c8b6e56a43a7b654e9dee02d904b",22368716,4,2,0,251,101,103,2
"d391c8b6e56a43a7b654e9dee02d904b","00ae5f0c51874a73a41ebea838d95682",22368716,1,-2,0,252,103,101,-2
"d391c8b6e56a43a7b654e9dee02d904b","d391c8b6e56a43a7b654e9dee02d904b",22368716,15,0,1,254,103,103,0
"d391c8b6e56a43a7b654e9dee02d904b","6111116566fc4fd9abba409322bea245",22368716,1,1,0,269,103,104,1
"6111116566fc4fd9abba409322bea245","6111116566fc4fd9abba409322bea245",22368716,2,0,1,270,104,104,0
"6111116566fc4fd9abba409322bea245","a81b2235cb9c499eb9ea8ee0a8dd9725",22368716,1,1,0,272,104,105,1
"a81b2235cb9c499eb9ea8ee0a8dd9725","a81b2235cb9c499eb9ea8ee0a8dd9725",22368716,5,0,1,273,105,105,0
"a81b2235cb9c499eb9ea8ee0a8dd9725","2d4e0ab0ef3b4d73b82c72d4621a7579",22368716,1,1,0,278,105,106,1
"2d4e0ab0ef3b4d73b82c72d4621a7579","2d4e0ab0ef3b4d73b82c72d4621a7579",22368716,2,0,1,279,106,106,0
"2d4e0ab0ef3b4d73b82c72d4621a7579","8bdebf492ebd4e62b0d522e8ab5e5197",22368716,1,1,0,281,106,107,1
"8bdebf492ebd4e62b0d522e8ab5e5197","8bdebf492ebd4e62b0d522e8ab5e5197",22368716,5,0,1,282,107,107,0
"8bdebf492ebd4e62b0d522e8ab5e5197","73039f8c1eb9409cb4caee2cf968001e",22368716,1,-7,0,287,107,100,-7
"73039f8c1eb9409cb4caee2cf968001e","4280927ec4d643238aa49c32f9e06c6c",22368716,2,10,0,288,100,109,9
"4280927ec4d643238aa49c32f9e06c6c","4280927ec4d643238aa49c32f9e06c6c",22368716,1,0,1,289,109,109,0
"4280927ec4d643238aa49c32f9e06c6c","fc44e6a5f7654430af1227838224dceb",22368716,1,2,0,290,109,111,2
"fc44e6a5f7654430af1227838224dceb","fc44e6a5f7654430af1227838224dceb",22368716,2,0,1,291,111,111,0
"fc44e6a5f7654430af1227838224dceb","08111f75e22d409998cf8b85bd431f0a",22368716,1,-3,0,293,111,108,-3
"08111f75e22d409998cf8b85bd431f0a","a9ae0a3c070d455bb4369a8996313336",22368716,2,7,0,294,108,114,6
"a9ae0a3c070d455bb4369a8996313336","a9ae0a3c070d455bb4369a8996313336",22368716,1,0,1,295,114,114,0
"a9ae0a3c070d455bb4369a8996313336","71cec822bcff4f30a20e75dc63ef7b65",22368716,1,2,0,296,114,116,2
"71cec822bcff4f30a20e75dc63ef7b65","71cec822bcff4f30a20e75dc63ef7b65",22368716,1,0,1,297,116,116,0
"71cec822bcff4f30a20e75dc63ef7b65","37319e88176d4aefa91d7a9980dbae91",22368716,1,-4,0,298,116,112,-4
"37319e88176d4aefa91d7a9980dbae91","62bff51286ef4f348717a3cf6fe2318f",22368716,2,9,0,299,112,120,8
"62bff51286ef4f348717a3cf6fe2318f","3ec3a3563847406fa73338f9e9999cf3",22368716,1,-3,0,300,120,117,-3
"3ec3a3563847406fa73338f9e9999cf3","a9ae0a3c070d455bb4369a8996313336",22368716,1,-4,0,301,117,114,-3
"a9ae0a3c070d455bb4369a8996313336","4280927ec4d643238aa49c32f9e06c6c",22368716,1,-6,0,302,114,109,-5
"4280927ec4d643238aa49c32f9e06c6c","37319e88176d4aefa91d7a9980dbae91",22368716,1,4,0,303,109,112,3
"37319e88176d4aefa91d7a9980dbae91","00ae5f0c51874a73a41ebea838d95682",22368716,1,-13,0,304,112,101,-11
"d391c8b6e56a43a7b654e9dee02d904b","08111f75e22d409998cf8b85bd431f0a",22368716,1,6,0,306,103,108,5
"08111f75e22d409998cf8b85bd431f0a","73039f8c1eb9409cb4caee2cf968001e",22368716,1,-9,0,307,108,100,-8
"73039f8c1eb9409cb4caee2cf968001e","e20db35ced8544ddac5bc3839145e463",22368716,2,-10,0,308,100,91,-9
"d391c8b6e56a43a7b654e9dee02d904b","73039f8c1eb9409cb4caee2cf968001e",22368716,2,-3,0,311,103,100,-3
"e20db35ced8544ddac5bc3839145e463","d646286c8051419bbc2e31dd1db55ca8",22368716,1,-30,0,313,91,67,-24
"d646286c8051419bbc2e31dd1db55ca8","6a9f0ef185fb47f0937e29daa1c71ed5",22368716,1,27,0,314,67,90,23
"42fb58708eaf4e5daa82bfca61b6f5fd","ae5ac430ea254e708a6f5deaaf7464ae",22368716,1,-4,0,318,87,84,-3
"00ae5f0c51874a73a41ebea838d95682","e20db35ced8544ddac5bc3839145e463",22368716,1,-11,0,325,101,91,-10
"e20db35ced8544ddac5bc3839145e463","d391c8b6e56a43a7b654e9dee02d904b",22368716,1,13,0,326,91,103,12
"4280927ec4d643238aa49c32f9e06c6c","08111f75e22d409998cf8b85bd431f0a",22368716,1,-1,0,329,109,108,-1
"a9ae0a3c070d455bb4369a8996313336","37319e88176d4aefa91d7a9980dbae91",22368716,1,-2,0,331,114,112,-2
"62bff51286ef4f348717a3cf6fe2318f","b1cd0e7dc3ad4a8eb91a4bfdbeb025b0",22368716,1,-2,0,333,120,118,-2
"b1cd0e7dc3ad4a8eb91a4bfdbeb025b0","b1cd0e7dc3ad4a8eb91a4bfdbeb025b0",22368716,1,0,1,334,118,118,0
"b1cd0e7dc3ad4a8eb91a4bfdbeb025b0","62bff51286ef4f348717a3cf6fe2318f",22368716,1,2,0,335,118,120,2
"62bff51286ef4f348717a3cf6fe2318f","62bff51286ef4f348717a3cf6fe2318f",22368716,3,0,1,336,120,120,0
"62bff51286ef4f348717a3cf6fe2318f","e20db35ced8544ddac5bc3839145e463",22368716,1,-33,0,339,120,91,-29
"e20db35ced8544ddac5bc3839145e463","779f9ddd1fd14d1e9e69f72219a1fdbd",22368716,1,36,0,340,91,121,30
"779f9ddd1fd14d1e9e69f72219a1fdbd","ae26e6cda8ad4a3f81bd347560d9579f",22368716,1,4,0,341,121,125,4
"ae26e6cda8ad4a3f81bd347560d9579f","ae26e6cda8ad4a3f81bd347560d9579f",22368716,3,0,1,342,125,125,0
"ae26e6cda8ad4a3f81bd347560d9579f","ee48df95832b4374aa273ceb27ec1315",22368716,1,1,0,345,125,126,1
"ee48df95832b4374aa273ceb27ec1315","ee48df95832b4374aa273ceb27ec1315",22368716,1,0,1,346,126,126,0
"ee48df95832b4374aa273ceb27ec1315","7a439da90b394756ad1777fc4c6dead5",22368716,1,1,0,347,126,127,1
"7a439da90b394756ad1777fc4c6dead5","7a439da90b394756ad1777fc4c6dead5",22368716,1,0,1,348,127,127,0
"7a439da90b394756ad1777fc4c6dead5","779f9ddd1fd14d1e9e69f72219a1fdbd",22368716,1,-6,0,349,127,121,-6
"779f9ddd1fd14d1e9e69f72219a1fdbd","a8dd5213034441ac92724b4e83eb0bb2",22368716,1,9,0,350,121,129,8
"a8dd5213034441ac92724b4e83eb0bb2","a8dd5213034441ac92724b4e83eb0bb2",22368716,1,0,1,351,129,129,0
"a8dd5213034441ac92724b4e83eb0bb2","8115eab6556b45f5b415c3b8c26a12e5",22368716,1,2,0,352,129,131,2
"8115eab6556b45f5b415c3b8c26a12e5","8115eab6556b45f5b415c3b8c26a12e5",22368716,2,0,1,353,131,131,0
"8115eab6556b45f5b415c3b8c26a12e5","ec34b06efd844b46a4c4818ecdb9b8f4",22368716,1,1,0,355,131,132,1
"ec34b06efd844b46a4c4818ecdb9b8f4","ec34b06efd844b46a4c4818ecdb9b8f4",22368716,5,0,1,356,132,132,0
"ec34b06efd844b46a4c4818ecdb9b8f4","c2e1c2b9eac64109b343a088584b576b",22368716,1,1,0,361,132,133,1
"c2e1c2b9eac64109b343a088584b576b","c2e1c2b9eac64109b343a088584b576b",22368716,2,0,1,362,133,133,0
"c2e1c2b9eac64109b343a088584b576b","579338175e0b4bbb8ef3b712b5d8b54e",22368716,1,-5,0,364,133,128,-5
"579338175e0b4bbb8ef3b712b5d8b54e","8bc5795d6a984a3eace4e2811e52dd4f",22368716,1,8,0,365,128,135,7
"8bc5795d6a984a3eace4e2811e52dd4f","8bc5795d6a984a3eace4e2811e52dd4f",22368716,1,0,1,366,135,135,0
"8bc5795d6a984a3eace4e2811e52dd4f","b416d47c56a742199b5d7c7f19d6503a",22368716,1,-1,0,367,135,134,-1
"b416d47c56a742199b5d7c7f19d6503a","cd4532ad48034873ba8bce2aac0c9808",22368716,1,4,0,368,134,137,3
"cd4532ad48034873ba8bce2aac0c9808","cd4532ad48034873ba8bce2aac0c9808",22368716,1,0,1,369,137,137,0
"cd4532ad48034873ba8bce2aac0c9808","779f9ddd1fd14d1e9e69f72219a1fdbd",22368716,1,-19,0,370,137,121,-16
"779f9ddd1fd14d1e9e69f72219a1fdbd","df1de691dafe4549a18a4398ee9dfaf9",22368716,1,23,0,371,121,139,18
"df1de691dafe4549a18a4398ee9dfaf9","6c5ad271a44743479bfaea29b1db8d02",22368716,1,4,0,372,139,143,4
"6c5ad271a44743479bfaea29b1db8d02","6c5ad271a44743479bfaea29b1db8d02",22368716,5,0,1,373,143,143,0
"6c5ad271a44743479bfaea29b1db8d02","83d311bed5374fee83d8d67a7d9d82dc",22368716,1,1,0,378,143,144,1
"83d311bed5374fee83d8d67a7d9d82dc","83d311bed5374fee83d8d67a7d9d82dc",22368716,1,0,1,379,144,144,0
"83d311bed5374fee83d8d67a7d9d82dc","402bba41861d43acb52a5abb89e8831e",22368716,1,1,0,380,144,145,1
"402bba41861d43acb52a5abb89e8831e","402bba41861d43acb52a5abb89e8831e",22368716,2,0,1,381,145,145,0
"402bba41861d43acb52a5abb89e8831e","8aae34f5ddbb4052a709b12e6b0d40fa",22368716,1,3,0,383,145,147,2
"8aae34f5ddbb4052a709b12e6b0d40fa","df1de691dafe4549a18a4398ee9dfaf9",22368716,1,-9,0,384,147,139,-8
"df1de691dafe4549a18a4398ee9dfaf9","8aae34f5ddbb4052a709b12e6b0d40fa",22368716,1,9,0,385,139,147,8
"8aae34f5ddbb4052a709b12e6b0d40fa","645b3f0249f64f76af2e19eb4d0e55b7",22368716,1,2,0,386,147,149,2
"645b3f0249f64f76af2e19eb4d0e55b7","645b3f0249f64f76af2e19eb4d0e55b7",22368716,5,0,1,387,149,149,0
"645b3f0249f64f76af2e19eb4d0e55b7","7e7b8db5064d4369805ab370aac5ddfb",22368716,1,1,0,392,149,150,1
"7e7b8db5064d4369805ab370aac5ddfb","7e7b8db5064d4369805ab370aac5ddfb",22368716,2,0,1,393,150,150,0
"7e7b8db5064d4369805ab370aac5ddfb","8956d210ae7f41968fada86d4c979d6a",22368716,1,1,0,395,150,151,1
"8956d210ae7f41968fada86d4c979d6a","8956d210ae7f41968fada86d4c979d6a",22368716,2,0,1,396,151,151,0
"8956d210ae7f41968fada86d4c979d6a","f902b0f41b544d4dbf79664fd233648d",22368716,1,-5,0,398,151,146,-5
"f902b0f41b544d4dbf79664fd233648d","ae781e8b775e4ccd93bc800dad5c8376",22368716,1,8,0,399,146,153,7
"ae781e8b775e4ccd93bc800dad5c8376","ae781e8b775e4ccd93bc800dad5c8376",22368716,2,0,1,400,153,153,0
"ae781e8b775e4ccd93bc800dad5c8376","06882a8492d9499aa31555567f575ecb",22368716,1,1,0,402,153,154,1
"06882a8492d9499aa31555567f575ecb","06882a8492d9499aa31555567f575ecb",22368716,1,0,1,403,154,154,0
"06882a8492d9499aa31555567f575ecb","f293c508f409466a8f27ddd7d1e40b20",22368716,1,1,0,404,154,155,1
"f293c508f409466a8f27ddd7d1e40b20","f293c508f409466a8f27ddd7d1e40b20",22368716,2,0,1,405,155,155,0
"f293c508f409466a8f27ddd7d1e40b20","cc4ddef5bbbe48ebb605141b347c4ed1",22368716,1,1,0,407,155,156,1
"cc4ddef5bbbe48ebb605141b347c4ed1","cc4ddef5bbbe48ebb605141b347c4ed1",22368716,5,0,1,408,156,156,0
"cc4ddef5bbbe48ebb605141b347c4ed1","f03480cf4eba413194d7af52fc0e7f28",22368716,1,-4,0,413,156,152,-4
"f03480cf4eba413194d7af52fc0e7f28","d313cec988a84645bee413e8d4724a4b",22368716,1,7,0,414,152,158,6
"d313cec988a84645bee413e8d4724a4b","d313cec988a84645bee413e8d4724a4b",22368716,4,0,1,415,158,158,0
"d313cec988a84645bee413e8d4724a4b","dc60696c76a74368a60f72246e47700d",22368716,1,1,0,419,158,159,1
"dc60696c76a74368a60f72246e47700d","dc60696c76a74368a60f72246e47700d",22368716,1,0,1,420,159,159,0
"dc60696c76a74368a60f72246e47700d","78adeee1fa2c4fe0bc73f7bca9fcee86",22368716,1,3,0,421,159,160,1
"78adeee1fa2c4fe0bc73f7bca9fcee86","df1de691dafe4549a18a4398ee9dfaf9",22368716,1,-26,0,422,160,139,-21
"df1de691dafe4549a18a4398ee9dfaf9","65202579580f4ad38d734b4ee39d22a8",22368716,1,31,0,423,139,164,25
"65202579580f4ad38d734b4ee39d22a8","65202579580f4ad38d734b4ee39d22a8",22368716,51,0,1,424,164,164,0
"65202579580f4ad38d734b4ee39d22a8","78adeee1fa2c4fe0bc73f7bca9fcee86",22368716,2,-5,0,429,164,160,-4
"78adeee1fa2c4fe0bc73f7bca9fcee86","65202579580f4ad38d734b4ee39d22a8",22368716,1,5,0,430,160,164,4
"78adeee1fa2c4fe0bc73f7bca9fcee86","3cbcea2be0984e7dbd5a48195af10ce7",22368716,1,8,0,478,160,165,5
"3cbcea2be0984e7dbd5a48195af10ce7","82e6285962b8400d9d6fc32436022a94",22368716,1,2,0,479,165,167,2
"82e6285962b8400d9d6fc32436022a94","3cbcea2be0984e7dbd5a48195af10ce7",22368716,1,-2,0,480,167,165,-2
"3cbcea2be0984e7dbd5a48195af10ce7","a9ac840f098c4bd0a2ee896214ce29cd",22368716,1,5,0,481,165,168,3
"a9ac840f098c4bd0a2ee896214ce29cd","0c7262dff33c4087bc660ccf40f92f9c",22368716,1,4,0,482,168,169,1
"0c7262dff33c4087bc660ccf40f92f9c","a9ac840f098c4bd0a2ee896214ce29cd",22368716,1,-4,0,483,169,168,-1
"a9ac840f098c4bd0a2ee896214ce29cd","b2275c3fad834f8d90737a2d9a6927d6",22368716,1,7,0,484,168,172,4
"b2275c3fad834f8d90737a2d9a6927d6","0c7262dff33c4087bc660ccf40f92f9c",22368716,1,-3,0,485,172,169,-3
"0c7262dff33c4087bc660ccf40f92f9c","b2275c3fad834f8d90737a2d9a6927d6",22368716,1,3,0,486,169,172,3
"b2275c3fad834f8d90737a2d9a6927d6","b2275c3fad834f8d90737a2d9a6927d6",22368716,26,0,1,487,172,172,0
"b2275c3fad834f8d90737a2d9a6927d6","eb515a26030b41f8a82a1e6114420bad",22368716,1,1,0,513,172,173,1
"eb515a26030b41f8a82a1e6114420bad","eb515a26030b41f8a82a1e6114420bad",22368716,2,0,1,514,173,173,0
"eb515a26030b41f8a82a1e6114420bad","b42cc17b7de840f181a704558d0bc845",22368716,1,3,0,516,173,175,2
"b42cc17b7de840f181a704558d0bc845","0c7262dff33c4087bc660ccf40f92f9c",22368716,1,-7,0,517,175,169,-6
"0c7262dff33c4087bc660ccf40f92f9c","b42cc17b7de840f181a704558d0bc845",22368716,1,7,0,518,169,175,6
"b42cc17b7de840f181a704558d0bc845","801f9e9135034f49bf5f8b4bdefedb41",22368716,1,2,0,519,175,177,2
"801f9e9135034f49bf5f8b4bdefedb41","801f9e9135034f49bf5f8b4bdefedb41",22368716,8,0,1,520,177,177,0
"801f9e9135034f49bf5f8b4bdefedb41","ea38cc0e6e6e41edbabf210220808bf9",22368716,1,3,0,528,177,179,2
"ea38cc0e6e6e41edbabf210220808bf9","362fcb0699a14845ab29b2340093e528",22368716,2,-6,0,529,179,174,-5
"362fcb0699a14845ab29b2340093e528","b87c552dd247427abe6ab5795b9c9d43",22368716,1,8,0,530,174,181,7
"b87c552dd247427abe6ab5795b9c9d43","ea38cc0e6e6e41edbabf210220808bf9",22368716,3,-2,0,531,181,179,-2
"ea38cc0e6e6e41edbabf210220808bf9","b87c552dd247427abe6ab5795b9c9d43",22368716,1,2,0,532,179,181,2
"b87c552dd247427abe6ab5795b9c9d43","b87c552dd247427abe6ab5795b9c9d43",22368716,10,0,1,533,181,181,0
"b87c552dd247427abe6ab5795b9c9d43","139b097acfca451689d80c9c6eebdf7b",22368716,1,-3,0,543,181,178,-3
"139b097acfca451689d80c9c6eebdf7b","2024b4885bd14338a39b7b509acbbd02",22368716,1,5,0,544,178,182,4
"2024b4885bd14338a39b7b509acbbd02","b87c552dd247427abe6ab5795b9c9d43",22368716,1,-2,0,545,182,181,-1
"ea38cc0e6e6e41edbabf210220808bf9","b42cc17b7de840f181a704558d0bc845",22368716,1,-5,0,547,179,175,-4
"b42cc17b7de840f181a704558d0bc845","139b097acfca451689d80c9c6eebdf7b",22368716,1,4,0,548,175,178,3
"139b097acfca451689d80c9c6eebdf7b","b42cc17b7de840f181a704558d0bc845",22368716,1,-4,0,549,178,175,-3
"b42cc17b7de840f181a704558d0bc845","b87c552dd247427abe6ab5795b9c9d43",22368716,1,7,0,550,175,181,6
"362fcb0699a14845ab29b2340093e528","139b097acfca451689d80c9c6eebdf7b",22368716,1,5,0,553,174,178,4
"139b097acfca451689d80c9c6eebdf7b","30f660a1feb34582a739722532524f79",22368716,1,6,0,554,178,183,5
"30f660a1feb34582a739722532524f79","30f660a1feb34582a739722532524f79",22368716,10,0,1,555,183,183,0
"30f660a1feb34582a739722532524f79","2024b4885bd14338a39b7b509acbbd02",22368716,2,-1,0,565,183,182,-1
"2024b4885bd14338a39b7b509acbbd02","cf4c280bad6a43e6b131d8385ef9ef3f",22368716,1,3,0,566,182,184,2
"cf4c280bad6a43e6b131d8385ef9ef3f","30f660a1feb34582a739722532524f79",22368716,1,-2,0,567,184,183,-1
"2024b4885bd14338a39b7b509acbbd02","c3f63fe50d8e487c86bf8ef76c9cadd3",22368716,1,4,0,569,182,185,3
"c3f63fe50d8e487c86bf8ef76c9cadd3","c3f63fe50d8e487c86bf8ef76c9cadd3",22368716,1,0,1,570,185,185,0
"c3f63fe50d8e487c86bf8ef76c9cadd3","0c7262dff33c4087bc660ccf40f92f9c",22368716,1,-20,0,571,185,169,-16
"0c7262dff33c4087bc660ccf40f92f9c","c8e371568a0c4391b25796ae4e91952e",22368716,1,23,0,572,169,186,17
"c8e371568a0c4391b25796ae4e91952e","7d932b23e1c84326ae5aa4d3c0d813d1",22368716,1,2,0,573,186,188,2
"7d932b23e1c84326ae5aa4d3c0d813d1","7d932b23e1c84326ae5aa4d3c0d813d1",22368716,1,0,1,574,188,188,0
"7d932b23e1c84326ae5aa4d3c0d813d1","c8e371568a0c4391b25796ae4e91952e",22368716,1,-2,0,575,188,186,-2
"c8e371568a0c4391b25796ae4e91952e","ab11d94c6c8948ea90b88f19d2cd502b",22368716,2,5,0,576,186,190,4
"ab11d94c6c8948ea90b88f19d2cd502b","ab11d94c6c8948ea90b88f19d2cd502b",22368716,1,0,1,577,190,190,0
"ab11d94c6c8948ea90b88f19d2cd502b","f992451ed6ad4e68bb9e68ad6be7c4be",22368716,1,2,0,578,190,192,2
"f992451ed6ad4e68bb9e68ad6be7c4be","f992451ed6ad4e68bb9e68ad6be7c4be",22368716,1,0,1,579,192,192,0
"f992451ed6ad4e68bb9e68ad6be7c4be","07b44a7a51e94c78b411c753fc39dab0",22368716,1,-3,0,580,192,189,-3
"07b44a7a51e94c78b411c753fc39dab0","6cd2dcaac46847d4a0bc53f296d90375",22368716,2,6,0,581,189,194,5
"6cd2dcaac46847d4a0bc53f296d90375","6cd2dcaac46847d4a0bc53f296d90375",22368716,1,0,1,582,194,194,0
"6cd2dcaac46847d4a0bc53f296d90375","2d2580c9411c4972909db508d6956a58",22368716,1,2,0,583,194,196,2
"2d2580c9411c4972909db508d6956a58","2d2580c9411c4972909db508d6956a58",22368716,9,0,1,584,196,196,0
"2d2580c9411c4972909db508d6956a58","5bddb3d9ed264f3984702f048c7e5340",22368716,1,1,0,593,196,197,1
"5bddb3d9ed264f3984702f048c7e5340","5bddb3d9ed264f3984702f048c7e5340",22368716,2,0,1,594,197,197,0
"5bddb3d9ed264f3984702f048c7e5340","d5e8e2bd12a2466b9d6d90855f0eb079",22368716,1,1,0,596,197,198,1
"d5e8e2bd12a2466b9d6d90855f0eb079","d5e8e2bd12a2466b9d6d90855f0eb079",22368716,2,0,1,597,198,198,0
"d5e8e2bd12a2466b9d6d90855f0eb079","017d7ca8e0394b91aaadc9574df2202c",22368716,1,-5,0,599,198,193,-5
"017d7ca8e0394b91aaadc9574df2202c","54e8e9f0ea3e45c4bf3b8ac799ee31b1",22368716,1,8,0,600,193,200,7
"54e8e9f0ea3e45c4bf3b8ac799ee31b1","54e8e9f0ea3e45c4bf3b8ac799ee31b1",22368716,3,0,1,601,200,200,0
"54e8e9f0ea3e45c4bf3b8ac799ee31b1","c614a00911be4877a075f19315530fb0",22368716,1,1,0,604,200,201,1
"c614a00911be4877a075f19315530fb0","c614a00911be4877a075f19315530fb0",22368716,6,0,1,605,201,201,0
"c614a00911be4877a075f19315530fb0","a6c21bd8b95249c7972820a7a7d76aff",22368716,1,1,0,611,201,202,1
"a6c21bd8b95249c7972820a7a7d76aff","a6c21bd8b95249c7972820a7a7d76aff",22368716,1,0,1,612,202,202,0
"a6c21bd8b95249c7972820a7a7d76aff","bb329d880ab54120adaf203a693bb203",22368716,1,1,0,613,202,203,1
"bb329d880ab54120adaf203a693bb203","bb329d880ab54120adaf203a693bb203",22368716,1,0,1,614,203,203,0
"bb329d880ab54120adaf203a693bb203","f9170dd6bc6442b4acd832747609b09a",22368716,1,-4,0,615,203,199,-4
"f9170dd6bc6442b4acd832747609b09a","b54257a550b94ebc9538f3a90eee9d7e",22368716,1,6,0,616,199,204,5
"b54257a550b94ebc9538f3a90eee9d7e","f9170dd6bc6442b4acd832747609b09a",22368716,1,-6,0,617,204,199,-5
"f9170dd6bc6442b4acd832747609b09a","c8e371568a0c4391b25796ae4e91952e",22368716,1,-16,0,618,199,186,-13
"ab11d94c6c8948ea90b88f19d2cd502b","c8e371568a0c4391b25796ae4e91952e",22368716,1,-5,0,620,190,186,-4
"c8e371568a0c4391b25796ae4e91952e","07b44a7a51e94c78b411c753fc39dab0",22368716,1,4,0,621,186,189,3
"6cd2dcaac46847d4a0bc53f296d90375","017d7ca8e0394b91aaadc9574df2202c",22368716,1,-1,0,623,194,193,-1
"017d7ca8e0394b91aaadc9574df2202c","334c2344009840079b1d0e1b7ce3d5a7",22368716,1,14,0,624,193,205,12
"334c2344009840079b1d0e1b7ce3d5a7","334c2344009840079b1d0e1b7ce3d5a7",22368716,1,0,1,625,205,205,0
"334c2344009840079b1d0e1b7ce3d5a7","c8e371568a0c4391b25796ae4e91952e",22368716,1,-23,0,626,205,186,-19
"c8e371568a0c4391b25796ae4e91952e","d7f13c8d63ec4e2aa673fbb9cf9c6933",22368716,1,26,0,627,186,206,20
"d7f13c8d63ec4e2aa673fbb9cf9c6933","b9e80f77c3a44349863b19875725c384",22368716,1,1,0,628,206,207,1
"b9e80f77c3a44349863b19875725c384","7108f0e4c2584f1f9c471689ae4c885c",22368716,2,1,0,629,207,208,1
"7108f0e4c2584f1f9c471689ae4c885c","b9e80f77c3a44349863b19875725c384",22368716,1,-1,0,630,208,207,-1
"b9e80f77c3a44349863b19875725c384","b9e80f77c3a44349863b19875725c384",22368716,15,0,1,631,207,207,0
"7108f0e4c2584f1f9c471689ae4c885c","7108f0e4c2584f1f9c471689ae4c885c",22368716,15,0,1,647,208,208,0
"7108f0e4c2584f1f9c471689ae4c885c","d7f13c8d63ec4e2aa673fbb9cf9c6933",22368716,1,-2,0,662,208,206,-2
"d7f13c8d63ec4e2aa673fbb9cf9c6933","09400e101c5d4b439cf9a26b03aae558",22368716,1,5,0,663,206,210,4
"09400e101c5d4b439cf9a26b03aae558","09400e101c5d4b439cf9a26b03aae558",22368716,1,0,1,664,210,210,0
"09400e101c5d4b439cf9a26b03aae558","a88efa7e50ce47159810ab553afa6d3a",22368716,1,2,0,665,210,212,2
"a88efa7e50ce47159810ab553afa6d3a","a88efa7e50ce47159810ab553afa6d3a",22368716,5,0,1,666,212,212,0
"a88efa7e50ce47159810ab553afa6d3a","be502a7a43c44bf7b682698de79d9369",22368716,1,3,0,671,212,214,2
"be502a7a43c44bf7b682698de79d9369","a875096404ef4a9984b62d74cda916f9",22368716,1,-6,0,672,214,209,-5
"a875096404ef4a9984b62d74cda916f9","f7fb1952f56b4189b86a9f8b7862d2b8",22368716,1,7,0,673,209,215,6
"f7fb1952f56b4189b86a9f8b7862d2b8","be502a7a43c44bf7b682698de79d9369",22368716,1,-1,0,674,215,214,-1
"be502a7a43c44bf7b682698de79d9369","be502a7a43c44bf7b682698de79d9369",22368716,2,0,1,675,214,214,0
"be502a7a43c44bf7b682698de79d9369","f7fb1952f56b4189b86a9f8b7862d2b8",22368716,1,1,0,677,214,215,1
"f7fb1952f56b4189b86a9f8b7862d2b8","f7fb1952f56b4189b86a9f8b7862d2b8",22368716,13,0,1,678,215,215,0
"f7fb1952f56b4189b86a9f8b7862d2b8","b860ee85d8bc4a2f97958cfb71be3533",22368716,1,1,0,691,215,216,1
"b860ee85d8bc4a2f97958cfb71be3533","b860ee85d8bc4a2f97958cfb71be3533",22368716,5,0,1,692,216,216,0
"b860ee85d8bc4a2f97958cfb71be3533","ec341f459285443b8361f7f15638ff08",22368716,1,-3,0,697,216,213,-3
"ec341f459285443b8361f7f15638ff08","363837c182e04711840d896ae1e0339c",22368716,1,6,0,698,213,218,5
"363837c182e04711840d896ae1e0339c","363837c182e04711840d896ae1e0339c",22368716,21,0,1,699,218,218,0
"363837c182e04711840d896ae1e0339c","01b2051f8941460d89945e3b02d1ce78",22368716,1,-1,0,720,218,217,-1
"01b2051f8941460d89945e3b02d1ce78","91125ca626c5470eb145501f8c37f8db",22368716,1,4,0,721,217,220,3
"91125ca626c5470eb145501f8c37f8db","91125ca626c5470eb145501f8c37f8db",22368716,1,0,1,722,220,220,0
"91125ca626c5470eb145501f8c37f8db","d7f13c8d63ec4e2aa673fbb9cf9c6933",22368716,1,-18,0,723,220,206,-14
"d7f13c8d63ec4e2aa673fbb9cf9c6933","1c6721b1f63f4d30ba7746ea8af02a52",22368716,1,21,0,724,206,221,15
"1c6721b1f63f4d30ba7746ea8af02a52","77ecef8eff6b4a2caea7707669bf7475",22368716,2,1,0,725,221,222,1
"77ecef8eff6b4a2caea7707669bf7475","77ecef8eff6b4a2caea7707669bf7475",22368716,12,0,1,726,222,222,0
"77ecef8eff6b4a2caea7707669bf7475","1c6721b1f63f4d30ba7746ea8af02a52",22368716,2,-1,0,738,222,221,-1
"1c6721b1f63f4d30ba7746ea8af02a52","d03cb855c70044cf8c35d9ec0de696e3",22368716,1,4,0,739,221,224,3
"d03cb855c70044cf8c35d9ec0de696e3","8b9ae98743bd4d4a8a87dff1c1244211",22368716,1,3,0,740,224,227,3
"8b9ae98743bd4d4a8a87dff1c1244211","d03cb855c70044cf8c35d9ec0de696e3",22368716,1,-3,0,741,227,224,-3
"d03cb855c70044cf8c35d9ec0de696e3","a49a937d6896486d9a5396654abcf2e1",22368716,2,2,0,742,224,226,2
"a49a937d6896486d9a5396654abcf2e1","a49a937d6896486d9a5396654abcf2e1",22368716,5,0,1,743,226,226,0
"a49a937d6896486d9a5396654abcf2e1","d03cb855c70044cf8c35d9ec0de696e3",22368716,1,-2,0,744,226,224,-2
"a49a937d6896486d9a5396654abcf2e1","8b9ae98743bd4d4a8a87dff1c1244211",22368716,1,1,0,750,226,227,1
"8b9ae98743bd4d4a8a87dff1c1244211","8b9ae98743bd4d4a8a87dff1c1244211",22368716,34,0,1,751,227,227,0
"8b9ae98743bd4d4a8a87dff1c1244211","2ab1535aac1346ba8801535bf729ef37",22368716,1,3,0,785,227,229,2
"2ab1535aac1346ba8801535bf729ef37","f7906d6f59b9489a91d2ef40db5a474d",22368716,1,-7,0,786,229,223,-6
"f7906d6f59b9489a91d2ef40db5a474d","2ab1535aac1346ba8801535bf729ef37",22368716,1,7,0,787,223,229,6
"2ab1535aac1346ba8801535bf729ef37","a4f40fb48a8542c8949bae1f002cd9bc",22368716,1,2,0,788,229,231,2
"a4f40fb48a8542c8949bae1f002cd9bc","a4f40fb48a8542c8949bae1f002cd9bc",22368716,5,0,1,789,231,231,0
"a4f40fb48a8542c8949bae1f002cd9bc","8972c23e32044edb8a78fa1eed4e5947",22368716,1,1,0,794,231,232,1
"8972c23e32044edb8a78fa1eed4e5947","8972c23e32044edb8a78fa1eed4e5947",22368716,6,0,1,795,232,232,0
"8972c23e32044edb8a78fa1eed4e5947","92feb4a40f8344d38b6f722e42a53295",22368716,1,1,0,801,232,233,1
"92feb4a40f8344d38b6f722e42a53295","92feb4a40f8344d38b6f722e42a53295",22368716,2,0,1,802,233,233,0
"92feb4a40f8344d38b6f722e42a53295","5152833676bf4c6cb317060be10f68db",22368716,1,-5,0,804,233,228,-5
"5152833676bf4c6cb317060be10f68db","ca3e28f290354c08aefe5b0f769604e6",22368716,1,8,0,805,228,235,7
"ca3e28f290354c08aefe5b0f769604e6","ca3e28f290354c08aefe5b0f769604e6",22368716,9,0,1,806,235,235,0
"ca3e28f290354c08aefe5b0f769604e6","79a35eea833e4c2c9d22fc53c3c6445c",22368716,1,1,0,815,235,236,1
"79a35eea833e4c2c9d22fc53c3c6445c","79a35eea833e4c2c9d22fc53c3c6445c",22368716,9,0,1,816,236,236,0
"79a35eea833e4c2c9d22fc53c3c6445c","8f68228b1518449e9615cdafee41a2bd",22368716,1,1,0,825,236,237,1
"8f68228b1518449e9615cdafee41a2bd","8f68228b1518449e9615cdafee41a2bd",22368716,1,0,1,826,237,237,0
"8f68228b1518449e9615cdafee41a2bd","cab89fa5c3ed45a5aa550fc0352d6a42",22368716,1,1,0,827,237,238,1
"cab89fa5c3ed45a5aa550fc0352d6a42","cab89fa5c3ed45a5aa550fc0352d6a42",22368716,6,0,1,828,238,238,0
"cab89fa5c3ed45a5aa550fc0352d6a42","0b04c8e2f86d48c7aeb7e225819cd32b",22368716,1,-4,0,834,238,234,-4
"0b04c8e2f86d48c7aeb7e225819cd32b","64dbedb3ce544f6aae8e10e0cf10f16d",22368716,1,7,0,835,234,240,6
"64dbedb3ce544f6aae8e10e0cf10f16d","0b04c8e2f86d48c7aeb7e225819cd32b",22368716,1,-7,0,836,240,234,-6
"0b04c8e2f86d48c7aeb7e225819cd32b","2ab1535aac1346ba8801535bf729ef37",22368716,1,-6,0,837,234,229,-5
"2ab1535aac1346ba8801535bf729ef37","5152833676bf4c6cb317060be10f68db",22368716,1,-1,0,838,229,228,-1
"5152833676bf4c6cb317060be10f68db","1c6721b1f63f4d30ba7746ea8af02a52",22368716,1,-9,0,839,228,221,-7
"1c6721b1f63f4d30ba7746ea8af02a52","66d4fad4f1cf4b46be0750a99ad7a35a",22368716,1,21,0,842,221,239,18
"66d4fad4f1cf4b46be0750a99ad7a35a","66d4fad4f1cf4b46be0750a99ad7a35a",22368716,1,0,1,843,239,239,0
"66d4fad4f1cf4b46be0750a99ad7a35a","0b04c8e2f86d48c7aeb7e225819cd32b",22368716,1,-5,0,844,239,234,-5
"0b04c8e2f86d48c7aeb7e225819cd32b","f53da5fd9bfe412da4b80d4742563b6c",22368716,1,8,0,845,234,241,7
"f53da5fd9bfe412da4b80d4742563b6c","f53da5fd9bfe412da4b80d4742563b6c",22368716,2,0,1,846,241,241,0
"f53da5fd9bfe412da4b80d4742563b6c","2ae94c0cea4d480a9d5dca8fb1d7b542",22368716,1,3,0,847,241,242,1
"2ae94c0cea4d480a9d5dca8fb1d7b542","1c6721b1f63f4d30ba7746ea8af02a52",22368716,4,-27,0,848,242,221,-21
"1c6721b1f63f4d30ba7746ea8af02a52","1ebf23f9d994469a85206e4c7b1bf5f5",22368716,2,30,0,849,221,245,24
"1ebf23f9d994469a85206e4c7b1bf5f5","b48100e167b24c7782f6f5ba968c9fdb",22368716,1,-2,0,850,245,243,-2
"b48100e167b24c7782f6f5ba968c9fdb","b48100e167b24c7782f6f5ba968c9fdb",22368716,1,0,1,851,243,243,0
"b48100e167b24c7782f6f5ba968c9fdb","2ae94c0cea4d480a9d5dca8fb1d7b542",22368716,1,-1,0,852,243,242,-1
"2ae94c0cea4d480a9d5dca8fb1d7b542","1ebf23f9d994469a85206e4c7b1bf5f5",22368716,3,3,0,853,242,245,3
"1ebf23f9d994469a85206e4c7b1bf5f5","1ebf23f9d994469a85206e4c7b1bf5f5",22368716,10,0,1,854,245,245,0
"1ebf23f9d994469a85206e4c7b1bf5f5","85ae675b83e8422da842cfd25596af99",22368716,3,1,0,864,245,246,1
"85ae675b83e8422da842cfd25596af99","85ae675b83e8422da842cfd25596af99",22368716,3,0,1,865,246,246,0
"85ae675b83e8422da842cfd25596af99","2ae94c0cea4d480a9d5dca8fb1d7b542",22368716,3,-4,0,866,246,242,-4
"2ae94c0cea4d480a9d5dca8fb1d7b542","fa235f0f364d47e4ae1c87f47bf8e6ba",22368716,2,12,0,867,242,252,10
"fa235f0f364d47e4ae1c87f47bf8e6ba","2ae94c0cea4d480a9d5dca8fb1d7b542",22368716,1,-12,0,868,252,242,-10
"1ebf23f9d994469a85206e4c7b1bf5f5","2ae94c0cea4d480a9d5dca8fb1d7b542",22368716,1,-3,0,870,245,242,-3
"1c6721b1f63f4d30ba7746ea8af02a52","2ae94c0cea4d480a9d5dca8fb1d7b542",22368716,2,27,0,872,221,242,21
"1c6721b1f63f4d30ba7746ea8af02a52","f53da5fd9bfe412da4b80d4742563b6c",22368716,1,24,0,879,221,241,20
"f53da5fd9bfe412da4b80d4742563b6c","1c6721b1f63f4d30ba7746ea8af02a52",22368716,1,-24,0,881,241,221,-20
"fa235f0f364d47e4ae1c87f47bf8e6ba","fa235f0f364d47e4ae1c87f47bf8e6ba",22368716,1,0,1,888,252,252,0
"fa235f0f364d47e4ae1c87f47bf8e6ba","79f7845465cc4ed19d8e4f1429541be0",22368716,1,2,0,889,252,254,2
"79f7845465cc4ed19d8e4f1429541be0","79f7845465cc4ed19d8e4f1429541be0",22368716,2,0,1,890,254,254,0
"79f7845465cc4ed19d8e4f1429541be0","6e83e23f56544a19b94067c1c558d9c0",22368716,1,-8,0,892,254,247,-7
"6e83e23f56544a19b94067c1c558d9c0","00f61990949545828dd12f1303d47504",22368716,2,11,0,893,247,256,9
"00f61990949545828dd12f1303d47504","00f61990949545828dd12f1303d47504",22368716,1,0,1,894,256,256,0
"00f61990949545828dd12f1303d47504","ead7bb4b64e247d2ae632ab8a296b091",22368716,1,2,0,895,256,258,2
"ead7bb4b64e247d2ae632ab8a296b091","ead7bb4b64e247d2ae632ab8a296b091",22368716,2,0,1,896,258,258,0
"ead7bb4b64e247d2ae632ab8a296b091","41b0048dde734bb280bac6116baa8e27",22368716,1,1,0,898,258,259,1
"41b0048dde734bb280bac6116baa8e27","41b0048dde734bb280bac6116baa8e27",22368716,2,0,1,899,259,259,0
"41b0048dde734bb280bac6116baa8e27","b41c5a094a604ee0915327da5cc0beb7",22368716,1,1,0,901,259,260,1
"b41c5a094a604ee0915327da5cc0beb7","b41c5a094a604ee0915327da5cc0beb7",22368716,5,0,1,902,260,260,0
"b41c5a094a604ee0915327da5cc0beb7","d546341988904f069cfa86b21457d9d9",22368716,1,-10,0,907,260,251,-9
"d546341988904f069cfa86b21457d9d9","28c171777c52431ab6b925073bd63d46",22368716,1,15,0,908,251,264,13
"28c171777c52431ab6b925073bd63d46","28c171777c52431ab6b925073bd63d46",22368716,7,0,1,909,264,264,0
"28c171777c52431ab6b925073bd63d46","ac160db940cb49ae8579162b1d52bb5d",22368716,1,2,0,916,264,266,2
"ac160db940cb49ae8579162b1d52bb5d","ac160db940cb49ae8579162b1d52bb5d",22368716,3,0,1,917,266,266,0
"ac160db940cb49ae8579162b1d52bb5d","d989ebcfc12a4b669f0100dc1aa14f1e",22368716,1,-12,0,920,266,255,-11
"d989ebcfc12a4b669f0100dc1aa14f1e","c6fd49b485cc4874b0bbdd9c6171e09c",22368716,1,15,0,921,255,268,13
"c6fd49b485cc4874b0bbdd9c6171e09c","c6fd49b485cc4874b0bbdd9c6171e09c",22368716,3,0,1,922,268,268,0
"c6fd49b485cc4874b0bbdd9c6171e09c","44240778a97c4af0937817499b75707b",22368716,1,1,0,925,268,269,1
"44240778a97c4af0937817499b75707b","44240778a97c4af0937817499b75707b",22368716,2,0,1,926,269,269,0
"44240778a97c4af0937817499b75707b","7aa76d3e993840d8805f097cbdbcd44b",22368716,1,-9,0,928,269,261,-8
"7aa76d3e993840d8805f097cbdbcd44b","865a4d3b43374da7944dc7d397f566d9",22368716,1,12,0,929,261,271,10
"865a4d3b43374da7944dc7d397f566d9","865a4d3b43374da7944dc7d397f566d9",22368716,1,0,1,930,271,271,0
"865a4d3b43374da7944dc7d397f566d9","0d987bed3ffa4ed0b9a2e62e97b7b30f",22368716,1,3,0,931,271,272,1
"0d987bed3ffa4ed0b9a2e62e97b7b30f","2ae94c0cea4d480a9d5dca8fb1d7b542",22368716,2,-38,0,932,272,242,-30
"2ae94c0cea4d480a9d5dca8fb1d7b542","6e83e23f56544a19b94067c1c558d9c0",22368716,1,6,0,933,242,247,5
"6e83e23f56544a19b94067c1c558d9c0","2ae94c0cea4d480a9d5dca8fb1d7b542",22368716,1,-6,0,934,247,242,-5
"2ae94c0cea4d480a9d5dca8fb1d7b542","30c9ba177afc49a695625d2bdec40207",22368716,1,9,0,935,242,250,8
"30c9ba177afc49a695625d2bdec40207","30c9ba177afc49a695625d2bdec40207",22368716,3,0,1,936,250,250,0
"30c9ba177afc49a695625d2bdec40207","6e83e23f56544a19b94067c1c558d9c0",22368716,1,-3,0,938,250,247,-3
"00f61990949545828dd12f1303d47504","d546341988904f069cfa86b21457d9d9",22368716,1,-6,0,940,256,251,-5
"d546341988904f069cfa86b21457d9d9","d989ebcfc12a4b669f0100dc1aa14f1e",22368716,2,5,0,941,251,255,4
"d989ebcfc12a4b669f0100dc1aa14f1e","7aa76d3e993840d8805f097cbdbcd44b",22368716,2,7,0,942,255,261,6
"7aa76d3e993840d8805f097cbdbcd44b","0c7262dff33c4087bc660ccf40f92f9c",22368716,1,-120,0,943,261,169,-92
"0c7262dff33c4087bc660ccf40f92f9c","93679be414554a11b1893002f2229a93",22368716,1,-182,0,944,169,35,-134
"7040a13096d746ac84b8fac8d9752058","93679be414554a11b1893002f2229a93",22368716,1,-3,0,946,36,35,-1
"7040a13096d746ac84b8fac8d9752058","30c9ba177afc49a695625d2bdec40207",22368716,1,285,0,949,36,250,214
"30c9ba177afc49a695625d2bdec40207","2ae94c0cea4d480a9d5dca8fb1d7b542",22368716,1,-9,0,951,250,242,-8
"2ae94c0cea4d480a9d5dca8fb1d7b542","00f61990949545828dd12f1303d47504",22368716,1,17,0,952,242,256,14
"00f61990949545828dd12f1303d47504","6e83e23f56544a19b94067c1c558d9c0",22368716,1,-11,0,953,256,247,-9
"6e83e23f56544a19b94067c1c558d9c0","d546341988904f069cfa86b21457d9d9",22368716,1,5,0,954,247,251,4
"7aa76d3e993840d8805f097cbdbcd44b","0d987bed3ffa4ed0b9a2e62e97b7b30f",22368716,1,15,0,957,261,272,11
"2ae94c0cea4d480a9d5dca8fb1d7b542","ecf5f1a3754c487589496d10a397f977",22368716,1,40,0,959,242,274,32
"ecf5f1a3754c487589496d10a397f977","0d987bed3ffa4ed0b9a2e62e97b7b30f",22368716,2,-2,0,960,274,272,-2
"0d987bed3ffa4ed0b9a2e62e97b7b30f","ecf5f1a3754c487589496d10a397f977",22368716,1,2,0,961,272,274,2
"0d987bed3ffa4ed0b9a2e62e97b7b30f","bb5a47f5ea01454a8b79455422d3b9da",22368716,1,10,0,963,272,280,8
"bb5a47f5ea01454a8b79455422d3b9da","bb5a47f5ea01454a8b79455422d3b9da",22368716,6,0,1,964,280,280,0
"bb5a47f5ea01454a8b79455422d3b9da","82ae07bc0c9b4570a41799290d1ef399",22368716,1,-6,0,967,280,275,-5
"82ae07bc0c9b4570a41799290d1ef399","bb5a47f5ea01454a8b79455422d3b9da",22368716,1,6,0,968,275,280,5
"bb5a47f5ea01454a8b79455422d3b9da","0d987bed3ffa4ed0b9a2e62e97b7b30f",22368716,1,-10,0,972,280,272,-8
"0d987bed3ffa4ed0b9a2e62e97b7b30f","94cecc3f1e7d484b8e068e79241dfd73",22368716,1,13,0,973,272,281,9
"94cecc3f1e7d484b8e068e79241dfd73","a37477c4e4c14169ad44b06b493007f6",22368716,1,2,0,974,281,283,2
"a37477c4e4c14169ad44b06b493007f6","fab84b4fab5940efb4ea868ef8d09396",22368716,1,3,0,975,283,284,1
"fab84b4fab5940efb4ea868ef8d09396","94cecc3f1e7d484b8e068e79241dfd73",22368716,1,-5,0,976,284,281,-3
"94cecc3f1e7d484b8e068e79241dfd73","4a29443515bb404cb8924e1c60a63b73",22368716,1,9,0,977,281,285,4
"4a29443515bb404cb8924e1c60a63b73","fab84b4fab5940efb4ea868ef8d09396",22368716,1,-4,0,978,285,284,-1
"fab84b4fab5940efb4ea868ef8d09396","208c9b2796c944db8dacaa96082520ea",22368716,1,7,0,979,284,288,4
"208c9b2796c944db8dacaa96082520ea","208c9b2796c944db8dacaa96082520ea",22368716,1,0,1,980,288,288,0
"208c9b2796c944db8dacaa96082520ea","4a29443515bb404cb8924e1c60a63b73",22368716,1,-3,0,981,288,285,-3
"4a29443515bb404cb8924e1c60a63b73","7669a956527947d0add87455277e80b4",22368716,1,7,0,982,285,291,6
"7669a956527947d0add87455277e80b4","7669a956527947d0add87455277e80b4",22368716,1,0,1,983,291,291,0
"7669a956527947d0add87455277e80b4","6a9a3b5bde4a48daa896fe8c06eca56f",22368716,1,-2,0,984,291,289,-2
"6a9a3b5bde4a48daa896fe8c06eca56f","869e967078f04da18dd0b0b9389a7424",22368716,1,5,0,985,289,293,4
"869e967078f04da18dd0b0b9389a7424","869e967078f04da18dd0b0b9389a7424",22368716,1,0,1,986,293,293,0
"869e967078f04da18dd0b0b9389a7424","51ab6291537748fab90d519aa09889d6",22368716,1,2,0,987,293,295,2
"51ab6291537748fab90d519aa09889d6","51ab6291537748fab90d519aa09889d6",22368716,5,0,1,988,295,295,0
"51ab6291537748fab90d519aa09889d6","34a6e49023fc4465bd5ca604330bbd1c",22368716,1,-3,0,993,295,292,-3
"34a6e49023fc4465bd5ca604330bbd1c","ba0e59461bfb4a44b7b1c28a01f8d3b3",22368716,1,9,0,994,292,299,7
"ba0e59461bfb4a44b7b1c28a01f8d3b3","21592f2a9e9c4b2f8c66ec5dbcbf6a2b",22368716,1,-4,0,995,299,296,-3
"21592f2a9e9c4b2f8c66ec5dbcbf6a2b","ba0e59461bfb4a44b7b1c28a01f8d3b3",22368716,1,4,0,996,296,299,3
"ba0e59461bfb4a44b7b1c28a01f8d3b3","0e0b36e731a645e7b1b8a88f5031ca38",22368716,1,2,0,997,299,301,2
"0e0b36e731a645e7b1b8a88f5031ca38","0e0b36e731a645e7b1b8a88f5031ca38",22368716,2,0,1,998,301,301,0
"0e0b36e731a645e7b1b8a88f5031ca38","a66a144637284c21afc6de17fea4bfb8",22368716,1,1,0,1000,301,302,1
"a66a144637284c21afc6de17fea4bfb8","a66a144637284c21afc6de17fea4bfb8",22368716,2,0,1,1001,302,302,0
"a66a144637284c21afc6de17fea4bfb8","7646a919d7e64fa990bca9b024ff089d",22368716,1,-4,0,1003,302,298,-4
"7646a919d7e64fa990bca9b024ff089d","ba0e59461bfb4a44b7b1c28a01f8d3b3",22368716,1,1,0,1004,298,299,1
"ba0e59461bfb4a44b7b1c28a01f8d3b3","2c5bb2cbd0014420ad8c95d40e38efd1",22368716,1,5,0,1005,299,303,4
"2c5bb2cbd0014420ad8c95d40e38efd1","7646a919d7e64fa990bca9b024ff089d",22368716,1,-6,0,1006,303,298,-5
"7646a919d7e64fa990bca9b024ff089d","4a29443515bb404cb8924e1c60a63b73",22368716,1,-17,0,1007,298,285,-13
"4a29443515bb404cb8924e1c60a63b73","3434c10e561d488a914e0f7d71907abd",22368716,1,27,0,1008,285,305,20
"3434c10e561d488a914e0f7d71907abd","53e7e900392747ccad52e711ab0f80d8",22368716,2,2,0,1009,305,307,2
"53e7e900392747ccad52e711ab0f80d8","3434c10e561d488a914e0f7d71907abd",22368716,2,-2,0,1010,307,305,-2
"3434c10e561d488a914e0f7d71907abd","4a29443515bb404cb8924e1c60a63b73",22368716,2,-27,0,1011,305,285,-20
"4a29443515bb404cb8924e1c60a63b73","e390b575229748ea8aac9364efe2bf00",22368716,1,24,0,1012,285,304,19
"e390b575229748ea8aac9364efe2bf00","e390b575229748ea8aac9364efe2bf00",22368716,1,0,1,1013,304,304,0
"e390b575229748ea8aac9364efe2bf00","3434c10e561d488a914e0f7d71907abd",22368716,1,3,0,1014,304,305,1
"4a29443515bb404cb8924e1c60a63b73","53e7e900392747ccad52e711ab0f80d8",22368716,1,29,0,1016,285,307,22
"53e7e900392747ccad52e711ab0f80d8","53e7e900392747ccad52e711ab0f80d8",22368716,1,0,1,1017,307,307,0
"3434c10e561d488a914e0f7d71907abd","130acc2aeb0448fdbb2de63bc5cebe5b",22368716,2,5,0,1019,305,309,4
"130acc2aeb0448fdbb2de63bc5cebe5b","141c0df6cd1946539aadd1c9b7068cd4",22368716,1,-1,0,1020,309,308,-1
"141c0df6cd1946539aadd1c9b7068cd4","53e7e900392747ccad52e711ab0f80d8",22368716,1,-2,0,1021,308,307,-1
"53e7e900392747ccad52e711ab0f80d8","130acc2aeb0448fdbb2de63bc5cebe5b",22368716,2,3,0,1022,307,309,2
"130acc2aeb0448fdbb2de63bc5cebe5b","3434c10e561d488a914e0f7d71907abd",22368716,2,-5,0,1023,309,305,-4
"130acc2aeb0448fdbb2de63bc5cebe5b","9c062b3251034ebe90f5054e2a3b5120",22368716,1,2,0,1025,309,311,2
"9c062b3251034ebe90f5054e2a3b5120","9c062b3251034ebe90f5054e2a3b5120",22368716,2,0,1,1026,311,311,0
"9c062b3251034ebe90f5054e2a3b5120","ea859f8207e44537889daeaba13ac2e8",22368716,1,1,0,1028,311,312,1
"ea859f8207e44537889daeaba13ac2e8","ea859f8207e44537889daeaba13ac2e8",22368716,1,0,1,1029,312,312,0
"ea859f8207e44537889daeaba13ac2e8","56d94971a7a94257aa330183a8ebd0ea",22368716,1,1,0,1030,312,313,1
"56d94971a7a94257aa330183a8ebd0ea","56d94971a7a94257aa330183a8ebd0ea",22368716,4,0,1,1031,313,313,0
"56d94971a7a94257aa330183a8ebd0ea","141c0df6cd1946539aadd1c9b7068cd4",22368716,1,-5,0,1035,313,308,-5
"141c0df6cd1946539aadd1c9b7068cd4","13255e63e0aa4abf85e5211bf613d43e",22368716,1,10,0,1036,308,317,9
"13255e63e0aa4abf85e5211bf613d43e","13255e63e0aa4abf85e5211bf613d43e",22368716,1,0,1,1037,317,317,0
"13255e63e0aa4abf85e5211bf613d43e","0c787d16c9504873b1a4d903cec09948",22368716,1,-3,0,1038,317,314,-3
"0c787d16c9504873b1a4d903cec09948","86c27d40179e419c8e9d150fb6afa5d0",22368716,2,6,0,1039,314,319,5
"86c27d40179e419c8e9d150fb6afa5d0","86c27d40179e419c8e9d150fb6afa5d0",22368716,1,0,1,1040,319,319,0
"86c27d40179e419c8e9d150fb6afa5d0","47edbb64109243e6b0f8f64cdef90c6c",22368716,2,8,0,1041,319,326,7
"47edbb64109243e6b0f8f64cdef90c6c","24f1363179ad4aaa965484a78471912b",22368716,2,-3,0,1042,326,323,-3
"24f1363179ad4aaa965484a78471912b","8d7e0b55cf9849cda222a0f2440cec55",22368716,2,-6,0,1043,323,318,-5
"8d7e0b55cf9849cda222a0f2440cec55","24f1363179ad4aaa965484a78471912b",22368716,1,6,0,1044,318,323,5
"24f1363179ad4aaa965484a78471912b","24f1363179ad4aaa965484a78471912b",22368716,1,0,1,1045,323,323,0
"24f1363179ad4aaa965484a78471912b","3628bdce1dd2429ba924d2d4d09448d2",22368716,1,-1,0,1046,323,322,-1
"3628bdce1dd2429ba924d2d4d09448d2","3434c10e561d488a914e0f7d71907abd",22368716,1,-21,0,1047,322,305,-17
"3434c10e561d488a914e0f7d71907abd","141c0df6cd1946539aadd1c9b7068cd4",22368716,1,4,0,1051,305,308,3
"141c0df6cd1946539aadd1c9b7068cd4","0c787d16c9504873b1a4d903cec09948",22368716,1,7,0,1052,308,314,6
"8d7e0b55cf9849cda222a0f2440cec55","3628bdce1dd2429ba924d2d4d09448d2",22368716,1,5,0,1057,318,322,4
"3628bdce1dd2429ba924d2d4d09448d2","56b3fd1a212a4764be39d979fde3326e",22368716,1,7,0,1058,322,328,6
"56b3fd1a212a4764be39d979fde3326e","56b3fd1a212a4764be39d979fde3326e",22368716,1,0,1,1059,328,328,0
"56b3fd1a212a4764be39d979fde3326e","3434c10e561d488a914e0f7d71907abd",22368716,1,-28,0,1060,328,305,-23
"3434c10e561d488a914e0f7d71907abd","0c4079457ede49e3aeb5e86ed84bdf35",22368716,1,31,0,1061,305,329,24
"0c4079457ede49e3aeb5e86ed84bdf35","38aea304b4fa46e1b29bb72f5cea4c93",22368716,1,2,0,1062,329,331,2
"38aea304b4fa46e1b29bb72f5cea4c93","38aea304b4fa46e1b29bb72f5cea4c93",22368716,2,0,1,1063,331,331,0
"38aea304b4fa46e1b29bb72f5cea4c93","e36d261332f14e79bb4b467aceaeb9b5",22368716,1,2,0,1065,331,333,2
"e36d261332f14e79bb4b467aceaeb9b5","e36d261332f14e79bb4b467aceaeb9b5",22368716,1,0,1,1066,333,333,0
"e36d261332f14e79bb4b467aceaeb9b5","c7e89b9d04744d2eab742fc24e3ef1ae",22368716,1,1,0,1067,333,334,1
"c7e89b9d04744d2eab742fc24e3ef1ae","c7e89b9d04744d2eab742fc24e3ef1ae",22368716,5,0,1,1068,334,334,0
"c7e89b9d04744d2eab742fc24e3ef1ae","fe49f8054b374a0ea4bb266ed135ff62",22368716,1,1,0,1073,334,335,1
"fe49f8054b374a0ea4bb266ed135ff62","fe49f8054b374a0ea4bb266ed135ff62",22368716,2,0,1,1074,335,335,0
"fe49f8054b374a0ea4bb266ed135ff62","d0a8f74af98642fe8360d22c42e45117",22368716,1,1,0,1076,335,336,1
"d0a8f74af98642fe8360d22c42e45117","d0a8f74af98642fe8360d22c42e45117",22368716,2,0,1,1077,336,336,0
"d0a8f74af98642fe8360d22c42e45117","0c4079457ede49e3aeb5e86ed84bdf35",22368716,1,-7,0,1079,336,329,-7
"0c4079457ede49e3aeb5e86ed84bdf35","a7c6339ca1da4368a18d471f0519f877",22368716,1,11,0,1080,329,339,10
"a7c6339ca1da4368a18d471f0519f877","a7c6339ca1da4368a18d471f0519f877",22368716,1,0,1,1081,339,339,0
"a7c6339ca1da4368a18d471f0519f877","bbc5139ca9024389a94db3a6f47dcff6",22368716,1,3,0,1082,339,341,2
"bbc5139ca9024389a94db3a6f47dcff6","b8b9418ab322418d9db9b40d96af873a",22368716,1,-5,0,1083,341,337,-4
"b8b9418ab322418d9db9b40d96af873a","bbc5139ca9024389a94db3a6f47dcff6",22368716,1,5,0,1084,337,341,4
"bbc5139ca9024389a94db3a6f47dcff6","4ee6ca9019ab4a1ab323f98094a9bd77",22368716,1,2,0,1085,341,343,2
"4ee6ca9019ab4a1ab323f98094a9bd77","4ee6ca9019ab4a1ab323f98094a9bd77",22368716,2,0,1,1086,343,343,0
"4ee6ca9019ab4a1ab323f98094a9bd77","b37947176785476f8b29d49a851366dc",22368716,1,1,0,1088,343,344,1
"b37947176785476f8b29d49a851366dc","b37947176785476f8b29d49a851366dc",22368716,2,0,1,1089,344,344,0
"b37947176785476f8b29d49a851366dc","fcea5b10d5a14a3b9324ffece8f6e1e5",22368716,1,1,0,1091,344,345,1
"fcea5b10d5a14a3b9324ffece8f6e1e5","fcea5b10d5a14a3b9324ffece8f6e1e5",22368716,2,0,1,1092,345,345,0
"fcea5b10d5a14a3b9324ffece8f6e1e5","c2490bc612d146edbe786556fab3651b",22368716,1,-5,0,1094,345,340,-5
"c2490bc612d146edbe786556fab3651b","6ac8bb048b854999a47edb35fe627f11",22368716,1,8,0,1095,340,347,7
"6ac8bb048b854999a47edb35fe627f11","6ac8bb048b854999a47edb35fe627f11",22368716,1,0,1,1096,347,347,0
"6ac8bb048b854999a47edb35fe627f11","0c4079457ede49e3aeb5e86ed84bdf35",22368716,1,-21,0,1097,347,329,-18
"0c4079457ede49e3aeb5e86ed84bdf35","30ead9794d4847abaf222ca966cc8630",22368716,1,24,0,1098,329,348,19
"30ead9794d4847abaf222ca966cc8630","897b7f51242c44aab2205c72fdcbf4cd",22368716,1,4,0,1099,348,352,4
"897b7f51242c44aab2205c72fdcbf4cd","09b9678ddc3d452ea4a3d46e15826065",22368716,2,1,0,1100,352,353,1
"09b9678ddc3d452ea4a3d46e15826065","eff0de7f2dbb42dfa1a2e686efab5b6d",22368716,2,1,0,1101,353,354,1
"eff0de7f2dbb42dfa1a2e686efab5b6d","c20993c944444fe085345591a8bd837e",22368716,1,-3,0,1102,354,351,-3
"c20993c944444fe085345591a8bd837e","c20993c944444fe085345591a8bd837e",22368716,4,0,1,1103,351,351,0
"c20993c944444fe085345591a8bd837e","897b7f51242c44aab2205c72fdcbf4cd",22368716,1,1,0,1107,351,352,1
"897b7f51242c44aab2205c72fdcbf4cd","897b7f51242c44aab2205c72fdcbf4cd",22368716,3,0,1,1108,352,352,0
"09b9678ddc3d452ea4a3d46e15826065","09b9678ddc3d452ea4a3d46e15826065",22368716,3,0,1,1112,353,353,0
"eff0de7f2dbb42dfa1a2e686efab5b6d","eff0de7f2dbb42dfa1a2e686efab5b6d",22368716,3,0,1,1116,354,354,0
"eff0de7f2dbb42dfa1a2e686efab5b6d","30ead9794d4847abaf222ca966cc8630",22368716,1,-6,0,1119,354,348,-6
"30ead9794d4847abaf222ca966cc8630","2fe14166dc9642c3bc666b86a57f943d",22368716,1,10,0,1120,348,357,9
"2fe14166dc9642c3bc666b86a57f943d","2fe14166dc9642c3bc666b86a57f943d",22368716,1,0,1,1121,357,357,0
"2fe14166dc9642c3bc666b86a57f943d","44421dd1e13a47a388c4a19834b744c7",22368716,1,2,0,1122,357,359,2
"44421dd1e13a47a388c4a19834b744c7","44421dd1e13a47a388c4a19834b744c7",22368716,5,0,1,1123,359,359,0
"44421dd1e13a47a388c4a19834b744c7","cb5fc7ef85d547c4be1a7439d0bf6052",22368716,1,1,0,1128,359,360,1
"cb5fc7ef85d547c4be1a7439d0bf6052","cb5fc7ef85d547c4be1a7439d0bf6052",22368716,2,0,1,1129,360,360,0
"cb5fc7ef85d547c4be1a7439d0bf6052","0a8f150a4cf747acbde62f4721823da3",22368716,1,1,0,1131,360,361,1
"0a8f150a4cf747acbde62f4721823da3","0a8f150a4cf747acbde62f4721823da3",22368716,2,0,1,1132,361,361,0
"0a8f150a4cf747acbde62f4721823da3","ab8fdad974ae471f9f24c3f9dd04462e",22368716,1,1,0,1134,361,362,1
"ab8fdad974ae471f9f24c3f9dd04462e","ab8fdad974ae471f9f24c3f9dd04462e",22368716,2,0,1,1135,362,362,0
"ab8fdad974ae471f9f24c3f9dd04462e","52580888dadb4fe3baa795683ea227bd",22368716,1,3,0,1137,362,364,2
"52580888dadb4fe3baa795683ea227bd","1ba8fef685d74a8194b9db252eb704fb",22368716,1,-10,0,1138,364,355,-9
"1ba8fef685d74a8194b9db252eb704fb","52580888dadb4fe3baa795683ea227bd",22368716,1,10,0,1139,355,364,9
"52580888dadb4fe3baa795683ea227bd","492a3bc6a1254f23a7998587961b22a4",22368716,1,3,0,1140,364,366,2
"492a3bc6a1254f23a7998587961b22a4","f00179e251a045b39c3f7a54f9aa4acc",22368716,1,-4,0,1141,366,363,-3
"f00179e251a045b39c3f7a54f9aa4acc","492a3bc6a1254f23a7998587961b22a4",22368716,1,4,0,1142,363,366,3
"492a3bc6a1254f23a7998587961b22a4","072a190fd302456290895f9f04d6940a",22368716,1,-1,0,1143,366,365,-1
"072a190fd302456290895f9f04d6940a","cfa457d1743848e4bb5e4beced6448ed",22368716,1,5,0,1144,365,369,4
"cfa457d1743848e4bb5e4beced6448ed","cfa457d1743848e4bb5e4beced6448ed",22368716,1,0,1,1145,369,369,0
"cfa457d1743848e4bb5e4beced6448ed","b71bac264efb4abd97015447bd490db6",22368716,1,3,0,1146,369,370,1
"b71bac264efb4abd97015447bd490db6","30ead9794d4847abaf222ca966cc8630",22368716,1,-28,0,1147,370,348,-22
"30ead9794d4847abaf222ca966cc8630","8d448d625b024c82a5eb240bbd7431d6",22368716,1,33,0,1148,348,374,26
"8d448d625b024c82a5eb240bbd7431d6","8d448d625b024c82a5eb240bbd7431d6",22368716,49,0,1,1149,374,374,0
"8d448d625b024c82a5eb240bbd7431d6","b71bac264efb4abd97015447bd490db6",22368716,1,-5,0,1153,374,370,-4
"b71bac264efb4abd97015447bd490db6","8d448d625b024c82a5eb240bbd7431d6",22368716,1,5,0,1154,370,374,4
"8d448d625b024c82a5eb240bbd7431d6","d6d02b6ef04e4f17805504500b8ce441",22368716,1,3,0,1200,374,375,1
"d6d02b6ef04e4f17805504500b8ce441","b71bac264efb4abd97015447bd490db6",22368716,1,-8,0,1201,375,370,-5
"b71bac264efb4abd97015447bd490db6","d6d02b6ef04e4f17805504500b8ce441",22368716,1,8,0,1202,370,375,5
"d6d02b6ef04e4f17805504500b8ce441","d6d02b6ef04e4f17805504500b8ce441",22368716,1,0,1,1203,375,375,0
"d6d02b6ef04e4f17805504500b8ce441","66baf19b6b904b70922329068c63746d",22368716,1,4,0,1204,375,376,1
"66baf19b6b904b70922329068c63746d","7f544639412e40a9ba27f43b415362ab",22368716,2,2,0,1205,376,378,2
"7f544639412e40a9ba27f43b415362ab","66baf19b6b904b70922329068c63746d",22368716,2,-2,0,1206,378,376,-2
"7f544639412e40a9ba27f43b415362ab","7f544639412e40a9ba27f43b415362ab",22368716,4,0,1,1208,378,378,0
"7f544639412e40a9ba27f43b415362ab","d5ae8642e15b46b8bd298b02274d4e9c",22368716,1,2,0,1209,378,380,2
"d5ae8642e15b46b8bd298b02274d4e9c","d5ae8642e15b46b8bd298b02274d4e9c",22368716,1,0,1,1210,380,380,0
"d5ae8642e15b46b8bd298b02274d4e9c","a0d10309a2dd456289147f84be9d37f9",22368716,1,1,0,1211,380,381,1
"a0d10309a2dd456289147f84be9d37f9","a0d10309a2dd456289147f84be9d37f9",22368716,2,0,1,1212,381,381,0
"a0d10309a2dd456289147f84be9d37f9","0fcbc3ca07b144138b8d85da581f09a8",22368716,1,1,0,1214,381,382,1
"0fcbc3ca07b144138b8d85da581f09a8","0fcbc3ca07b144138b8d85da581f09a8",22368716,2,0,1,1215,382,382,0
"0fcbc3ca07b144138b8d85da581f09a8","66baf19b6b904b70922329068c63746d",22368716,1,-6,0,1217,382,376,-6
"66baf19b6b904b70922329068c63746d","c2fca3669923477ab966ded303dea31c",22368716,1,8,0,1218,376,383,7
"c2fca3669923477ab966ded303dea31c","4890121ce5d74576b4632b77cfc23398",22368716,1,6,0,1219,383,388,5
"4890121ce5d74576b4632b77cfc23398","4890121ce5d74576b4632b77cfc23398",22368716,1,0,1,1220,388,388,0
"4890121ce5d74576b4632b77cfc23398","18d3b836dd804224883cc9180b60a8e1",22368716,3,-1,0,1221,388,387,-1
"18d3b836dd804224883cc9180b60a8e1","96bb2b3e85a34d8b9544514e89f6fe97",22368716,1,4,0,1222,387,390,3
"96bb2b3e85a34d8b9544514e89f6fe97","96bb2b3e85a34d8b9544514e89f6fe97",22368716,1,0,1,1223,390,390,0
"96bb2b3e85a34d8b9544514e89f6fe97","ac4e9b54acfe4670b4634859c7263cb5",22368716,1,2,0,1224,390,392,2
"ac4e9b54acfe4670b4634859c7263cb5","ac4e9b54acfe4670b4634859c7263cb5",22368716,1,0,1,1225,392,392,0
"ac4e9b54acfe4670b4634859c7263cb5","17f95d18bab743888e1736033dc3384d",22368716,1,-3,0,1226,392,389,-3
"17f95d18bab743888e1736033dc3384d","6f8881a745ac4c358a68b92c3b4abe81",22368716,2,6,0,1227,389,394,5
"6f8881a745ac4c358a68b92c3b4abe81","6f8881a745ac4c358a68b92c3b4abe81",22368716,1,0,1,1228,394,394,0
"6f8881a745ac4c358a68b92c3b4abe81","f7002c8484354eceac57bc7bd62c76c1",22368716,1,-1,0,1229,394,393,-1
"f7002c8484354eceac57bc7bd62c76c1","44a277ea44dc4ae689fab4b82f0b4098",22368716,1,5,0,1230,393,397,4
"44a277ea44dc4ae689fab4b82f0b4098","44a277ea44dc4ae689fab4b82f0b4098",22368716,1,0,1,1231,397,397,0
"44a277ea44dc4ae689fab4b82f0b4098","0c12af0a4e7f4002852cf84b2537c161",22368716,1,-2,0,1232,397,395,-2
"0c12af0a4e7f4002852cf84b2537c161","859e0b8d71694b12befb69ee698138f9",22368716,1,5,0,1233,395,399,4
"859e0b8d71694b12befb69ee698138f9","859e0b8d71694b12befb69ee698138f9",22368716,1,0,1,1234,399,399,0
"859e0b8d71694b12befb69ee698138f9","2b09a08242b54983aec7063990fb3f66",22368716,1,3,0,1235,399,400,1
"2b09a08242b54983aec7063990fb3f66","66baf19b6b904b70922329068c63746d",22368716,3,-32,0,1236,400,376,-24
"66baf19b6b904b70922329068c63746d","2b09a08242b54983aec7063990fb3f66",22368716,4,32,0,1237,376,400,24
"2b09a08242b54983aec7063990fb3f66","2b09a08242b54983aec7063990fb3f66",22368716,8,0,1,1238,400,400,0
"2b09a08242b54983aec7063990fb3f66","1f471b7a883a4df48211e8c6a81b59a7",22368716,1,1,0,1242,400,401,1
"1f471b7a883a4df48211e8c6a81b59a7","1f471b7a883a4df48211e8c6a81b59a7",22368716,1,0,1,1243,401,401,0
"1f471b7a883a4df48211e8c6a81b59a7","2b09a08242b54983aec7063990fb3f66",22368716,1,-1,0,1244,401,400,-1
"2b09a08242b54983aec7063990fb3f66","1157bd665ec4472fb58b751dc5099355",22368716,1,4,0,1245,400,403,3
"1157bd665ec4472fb58b751dc5099355","2b09a08242b54983aec7063990fb3f66",22368716,1,-4,0,1246,403,400,-3
"66baf19b6b904b70922329068c63746d","66baf19b6b904b70922329068c63746d",22368716,1,0,1,1249,376,376,0
"2b09a08242b54983aec7063990fb3f66","df8191ec5e584c838a899c378941a566",22368716,1,-4,0,1251,400,398,-2
"df8191ec5e584c838a899c378941a566","0c12af0a4e7f4002852cf84b2537c161",22368716,1,-4,0,1252,398,395,-3
"0c12af0a4e7f4002852cf84b2537c161","6f8881a745ac4c358a68b92c3b4abe81",22368716,1,-2,0,1253,395,394,-1
"6f8881a745ac4c358a68b92c3b4abe81","96bb2b3e85a34d8b9544514e89f6fe97",22368716,1,-5,0,1254,394,390,-4
"96bb2b3e85a34d8b9544514e89f6fe97","f7002c8484354eceac57bc7bd62c76c1",22368716,2,4,0,1255,390,393,3
"f7002c8484354eceac57bc7bd62c76c1","17f95d18bab743888e1736033dc3384d",22368716,2,-5,0,1256,393,389,-4
"17f95d18bab743888e1736033dc3384d","4890121ce5d74576b4632b77cfc23398",22368716,1,-2,0,1257,389,388,-1
"18d3b836dd804224883cc9180b60a8e1","4890121ce5d74576b4632b77cfc23398",22368716,1,1,0,1259,387,388,1
"4890121ce5d74576b4632b77cfc23398","c2fca3669923477ab966ded303dea31c",22368716,1,-6,0,1260,388,383,-5
"c2fca3669923477ab966ded303dea31c","18d3b836dd804224883cc9180b60a8e1",22368716,1,5,0,1261,383,387,4
"18d3b836dd804224883cc9180b60a8e1","2b09a08242b54983aec7063990fb3f66",22368716,1,19,0,1262,387,400,13
"2b09a08242b54983aec7063990fb3f66","9de0d567bfa84fe5b77cb76f4a76a5d1",22368716,1,5,0,1266,400,404,4
"9de0d567bfa84fe5b77cb76f4a76a5d1","9de0d567bfa84fe5b77cb76f4a76a5d1",22368716,1,0,1,1267,404,404,0
"9de0d567bfa84fe5b77cb76f4a76a5d1","1157bd665ec4472fb58b751dc5099355",22368716,1,-1,0,1268,404,403,-1
"1157bd665ec4472fb58b751dc5099355","3c8a22d2f9c146ea956609e3ed4f2559",22368716,1,3,0,1269,403,405,2
"3c8a22d2f9c146ea956609e3ed4f2559","58fc9094275e4c49be3f4ba6d4acc0a4",22368716,1,2,0,1270,405,406,1
"58fc9094275e4c49be3f4ba6d4acc0a4","58fc9094275e4c49be3f4ba6d4acc0a4",22368716,1,0,1,1271,406,406,0
"58fc9094275e4c49be3f4ba6d4acc0a4","c1c1be90b2b14c1ab4a5e1ee3c241902",22368716,1,1,0,1272,406,407,1
"c1c1be90b2b14c1ab4a5e1ee3c241902","c1c1be90b2b14c1ab4a5e1ee3c241902",22368716,5,0,1,1273,407,407,0
"c1c1be90b2b14c1ab4a5e1ee3c241902","58fc9094275e4c49be3f4ba6d4acc0a4",22368716,1,-1,0,1278,407,406,-1
"58fc9094275e4c49be3f4ba6d4acc0a4","02b3a1bead9244c1ba2f857c7da8f82a",22368716,1,3,0,1279,406,408,2
"02b3a1bead9244c1ba2f857c7da8f82a","02b3a1bead9244c1ba2f857c7da8f82a",22368716,1,0,1,1280,408,408,0
"02b3a1bead9244c1ba2f857c7da8f82a","6206fc6479014bb193084c32409dc1b9",22368716,1,1,0,1281,408,409,1
"6206fc6479014bb193084c32409dc1b9","6206fc6479014bb193084c32409dc1b9",22368716,1,0,1,1282,409,409,0
"6206fc6479014bb193084c32409dc1b9","6a5f020451db426dacba9e2ea3fcc62a",22368716,1,2,0,1283,409,410,1
"6a5f020451db426dacba9e2ea3fcc62a","02b3a1bead9244c1ba2f857c7da8f82a",22368716,1,-3,0,1284,410,408,-2
"02b3a1bead9244c1ba2f857c7da8f82a","6a5f020451db426dacba9e2ea3fcc62a",22368716,1,3,0,1285,408,410,2
"6a5f020451db426dacba9e2ea3fcc62a","6a5f020451db426dacba9e2ea3fcc62a",22368716,3,0,1,1286,410,410,0
"6a5f020451db426dacba9e2ea3fcc62a","33a9d248b2e44588a5b07fc1342b9bc2",22368716,1,2,0,1287,410,411,1
"33a9d248b2e44588a5b07fc1342b9bc2","33a9d248b2e44588a5b07fc1342b9bc2",22368716,2,0,1,1288,411,411,0
"33a9d248b2e44588a5b07fc1342b9bc2","c6f26bd420634f1cb7989e76fe6b16c0",22368716,1,1,0,1289,411,412,1
"c6f26bd420634f1cb7989e76fe6b16c0","c6f26bd420634f1cb7989e76fe6b16c0",22368716,5,0,1,1290,412,412,0
"c6f26bd420634f1cb7989e76fe6b16c0","2a65ee6e2ac64f6a8a55fbe5373ec763",22368716,1,1,0,1295,412,413,1
"2a65ee6e2ac64f6a8a55fbe5373ec763","2a65ee6e2ac64f6a8a55fbe5373ec763",22368716,2,0,1,1296,413,413,0
"2a65ee6e2ac64f6a8a55fbe5373ec763","33a9d248b2e44588a5b07fc1342b9bc2",22368716,1,-2,0,1298,413,411,-2
"33a9d248b2e44588a5b07fc1342b9bc2","1fd0f6dadbc14ebc965faf6122190b96",22368716,1,5,0,1299,411,415,4
"1fd0f6dadbc14ebc965faf6122190b96","1fd0f6dadbc14ebc965faf6122190b96",22368716,1,0,1,1300,415,415,0
"1fd0f6dadbc14ebc965faf6122190b96","687055dad9fc40c3982478fe33ec01bf",22368716,1,-1,0,1301,415,414,-1
"687055dad9fc40c3982478fe33ec01bf","2add1669f08d4101913db15f8c23b3b7",22368716,1,3,0,1302,414,416,2
"2add1669f08d4101913db15f8c23b3b7","2add1669f08d4101913db15f8c23b3b7",22368716,1,0,1,1303,416,416,0
"2add1669f08d4101913db15f8c23b3b7","a2b4bd40cee2481ebd3fc179d6a5cd62",22368716,1,3,0,1304,416,417,1
"a2b4bd40cee2481ebd3fc179d6a5cd62","2b09a08242b54983aec7063990fb3f66",22368716,1,-27,0,1305,417,400,-17
"2b09a08242b54983aec7063990fb3f66","a2b4bd40cee2481ebd3fc179d6a5cd62",22368716,3,27,0,1306,400,417,17
"a2b4bd40cee2481ebd3fc179d6a5cd62","a2b4bd40cee2481ebd3fc179d6a5cd62",22368716,3,0,1,1307,417,417,0
"a2b4bd40cee2481ebd3fc179d6a5cd62","e34e59dce2204f228f3a84b6725df60f",22368716,1,2,0,1308,417,419,2
"e34e59dce2204f228f3a84b6725df60f","e34e59dce2204f228f3a84b6725df60f",22368716,1,0,1,1309,419,419,0
"e34e59dce2204f228f3a84b6725df60f","bec48fc2e1294c7eb3d0aca780d731b8",22368716,1,2,0,1310,419,420,1
"bec48fc2e1294c7eb3d0aca780d731b8","a2b4bd40cee2481ebd3fc179d6a5cd62",22368716,1,-4,0,1311,420,417,-3
"a2b4bd40cee2481ebd3fc179d6a5cd62","bec48fc2e1294c7eb3d0aca780d731b8",22368716,2,4,0,1312,417,420,3
"bec48fc2e1294c7eb3d0aca780d731b8","bec48fc2e1294c7eb3d0aca780d731b8",22368716,4,0,1,1313,420,420,0
"bec48fc2e1294c7eb3d0aca780d731b8","a24600b0e49245f6bdba8c893cfeddb0",22368716,2,7,0,1314,420,425,5
"a24600b0e49245f6bdba8c893cfeddb0","dbde19fcce2a4c1abdc7f685c293a23f",22368716,1,-4,0,1315,425,422,-3
"dbde19fcce2a4c1abdc7f685c293a23f","a24600b0e49245f6bdba8c893cfeddb0",22368716,1,4,0,1316,422,425,3
"a24600b0e49245f6bdba8c893cfeddb0","a24600b0e49245f6bdba8c893cfeddb0",22368716,3,0,1,1317,425,425,0
"a24600b0e49245f6bdba8c893cfeddb0","a2b4bd40cee2481ebd3fc179d6a5cd62",22368716,1,-11,0,1318,425,417,-8
"a2b4bd40cee2481ebd3fc179d6a5cd62","24cf8786024543f19b89bc20034e60d7",22368716,3,18,0,1319,417,428,11
"24cf8786024543f19b89bc20034e60d7","f2a73be2f46840b182d7bd095378004e",22368716,3,1,0,1320,428,429,1
"f2a73be2f46840b182d7bd095378004e","24cf8786024543f19b89bc20034e60d7",22368716,1,-1,0,1321,429,428,-1
"f2a73be2f46840b182d7bd095378004e","f2a73be2f46840b182d7bd095378004e",22368716,1,0,1,1323,429,429,0
"f2a73be2f46840b182d7bd095378004e","604551fd4266430cb860fef58fa7dd61",22368716,1,1,0,1324,429,430,1
"604551fd4266430cb860fef58fa7dd61","604551fd4266430cb860fef58fa7dd61",22368716,7,0,1,1325,430,430,0
"604551fd4266430cb860fef58fa7dd61","24cf8786024543f19b89bc20034e60d7",22368716,1,-2,0,1332,430,428,-2
"24cf8786024543f19b89bc20034e60d7","dce46f8904594a62a6377a3587aaa663",22368716,2,4,0,1333,428,431,3
"dce46f8904594a62a6377a3587aaa663","dce46f8904594a62a6377a3587aaa663",22368716,4,0,1,1334,431,431,0
"dce46f8904594a62a6377a3587aaa663","9b9d0a249052413c869753b99682b0ac",22368716,1,1,0,1336,431,432,1
"9b9d0a249052413c869753b99682b0ac","9b9d0a249052413c869753b99682b0ac",22368716,3,0,1,1337,432,432,0
"9b9d0a249052413c869753b99682b0ac","061c175cc90f45fbad883025394e78dd",22368716,1,1,0,1340,432,433,1
"061c175cc90f45fbad883025394e78dd","061c175cc90f45fbad883025394e78dd",22368716,5,0,1,1341,433,433,0
"061c175cc90f45fbad883025394e78dd","dce46f8904594a62a6377a3587aaa663",22368716,1,-2,0,1346,433,431,-2
"dce46f8904594a62a6377a3587aaa663","66ada10dde9f43018588f1ced9d477fc",22368716,2,4,0,1348,431,434,3
"66ada10dde9f43018588f1ced9d477fc","dce46f8904594a62a6377a3587aaa663",22368716,1,-4,0,1349,434,431,-3
"dce46f8904594a62a6377a3587aaa663","74a7f8712e5449c2bc0b43c6f90dafed",22368716,1,5,0,1351,431,435,4
"74a7f8712e5449c2bc0b43c6f90dafed","74a7f8712e5449c2bc0b43c6f90dafed",22368716,1,0,1,1352,435,435,0
"74a7f8712e5449c2bc0b43c6f90dafed","66ada10dde9f43018588f1ced9d477fc",22368716,1,-1,0,1353,435,434,-1
"66ada10dde9f43018588f1ced9d477fc","bf12c96466d840a69bed7020b3f18bb8",22368716,1,3,0,1354,434,436,2
"bf12c96466d840a69bed7020b3f18bb8","bf12c96466d840a69bed7020b3f18bb8",22368716,1,0,1,1355,436,436,0
"bf12c96466d840a69bed7020b3f18bb8","070600601c4c439288445d2f0724807d",22368716,1,3,0,1356,436,437,1
"070600601c4c439288445d2f0724807d","24cf8786024543f19b89bc20034e60d7",22368716,2,-14,0,1357,437,428,-9
"24cf8786024543f19b89bc20034e60d7","1823b6de7d334a7aaabc4570719af4d9",22368716,2,16,0,1358,428,439,11
"1823b6de7d334a7aaabc4570719af4d9","1823b6de7d334a7aaabc4570719af4d9",22368716,14,0,1,1359,439,439,0
"1823b6de7d334a7aaabc4570719af4d9","0380cd76a7d44bc3a4da1f15e4d68f89",22368716,2,2,0,1373,439,440,1
"0380cd76a7d44bc3a4da1f15e4d68f89","070600601c4c439288445d2f0724807d",22368716,2,-4,0,1374,440,437,-3
"070600601c4c439288445d2f0724807d","0380cd76a7d44bc3a4da1f15e4d68f89",22368716,1,4,0,1375,437,440,3
"0380cd76a7d44bc3a4da1f15e4d68f89","0380cd76a7d44bc3a4da1f15e4d68f89",22368716,1,0,1,1376,440,440,0
"0380cd76a7d44bc3a4da1f15e4d68f89","23b7673c8b5443108c2ef09382834a86",22368716,1,2,0,1377,440,441,1
"23b7673c8b5443108c2ef09382834a86","23b7673c8b5443108c2ef09382834a86",22368716,3,0,1,1378,441,441,0
"23b7673c8b5443108c2ef09382834a86","901e92500aea43c79f19f1b279050668",22368716,1,2,0,1380,441,442,1
"901e92500aea43c79f19f1b279050668","901e92500aea43c79f19f1b279050668",22368716,1,0,1,1381,442,442,0
"901e92500aea43c79f19f1b279050668","001339db8ced4cf78829ebe8b145449d",22368716,1,1,0,1382,442,443,1
"001339db8ced4cf78829ebe8b145449d","001339db8ced4cf78829ebe8b145449d",22368716,5,0,1,1383,443,443,0
"001339db8ced4cf78829ebe8b145449d","452745e0366e42ae81561bfddebcc6c3",22368716,1,1,0,1388,443,444,1
"452745e0366e42ae81561bfddebcc6c3","452745e0366e42ae81561bfddebcc6c3",22368716,2,0,1,1389,444,444,0
"452745e0366e42ae81561bfddebcc6c3","901e92500aea43c79f19f1b279050668",22368716,1,-2,0,1391,444,442,-2
"901e92500aea43c79f19f1b279050668","4660ff2089114e8db82ceb26a4f329e3",22368716,2,4,0,1392,442,445,3
"4660ff2089114e8db82ceb26a4f329e3","4660ff2089114e8db82ceb26a4f329e3",22368716,3,0,1,1393,445,445,0
"4660ff2089114e8db82ceb26a4f329e3","7bd5586eb9d8484eb74a433ee7bfe499",22368716,1,2,0,1395,445,446,1
"7bd5586eb9d8484eb74a433ee7bfe499","7bd5586eb9d8484eb74a433ee7bfe499",22368716,15,0,1,1396,446,446,0
"7bd5586eb9d8484eb74a433ee7bfe499","8a7f26e690f34dda97be16904518ca99",22368716,1,2,0,1411,446,447,1
"8a7f26e690f34dda97be16904518ca99","8a7f26e690f34dda97be16904518ca99",22368716,1,0,1,1412,447,447,0
"8a7f26e690f34dda97be16904518ca99","b2f0d654738f48158edff28e8d3a546e",22368716,1,5,0,1413,447,449,2
"b2f0d654738f48158edff28e8d3a546e","070600601c4c439288445d2f0724807d",22368716,3,-21,0,1414,449,437,-12
"070600601c4c439288445d2f0724807d","f60ee41ec635499abd48168342d32c2f",22368716,2,26,0,1415,437,453,16
"f60ee41ec635499abd48168342d32c2f","f60ee41ec635499abd48168342d32c2f",22368716,64,0,1,1416,453,453,0
"f60ee41ec635499abd48168342d32c2f","b2f0d654738f48158edff28e8d3a546e",22368716,4,-5,0,1419,453,449,-4
"b2f0d654738f48158edff28e8d3a546e","f60ee41ec635499abd48168342d32c2f",22368716,3,5,0,1420,449,453,4
"b2f0d654738f48158edff28e8d3a546e","f67fbf45a5f146ed866965bc57c7c001",22368716,2,8,0,1425,449,454,5
"f67fbf45a5f146ed866965bc57c7c001","f67fbf45a5f146ed866965bc57c7c001",22368716,5,0,1,1426,454,454,0
"f67fbf45a5f146ed866965bc57c7c001","b2f0d654738f48158edff28e8d3a546e",22368716,1,-8,0,1427,454,449,-5
"f60ee41ec635499abd48168342d32c2f","66baf19b6b904b70922329068c63746d",22368716,1,-117,0,1436,453,376,-77
"66baf19b6b904b70922329068c63746d","df8191ec5e584c838a899c378941a566",22368716,1,28,0,1437,376,398,22
"df8191ec5e584c838a899c378941a566","c2fca3669923477ab966ded303dea31c",22368716,1,-20,0,1438,398,383,-15
"c2fca3669923477ab966ded303dea31c","6f8881a745ac4c358a68b92c3b4abe81",22368716,1,14,0,1439,383,394,11
"6f8881a745ac4c358a68b92c3b4abe81","4890121ce5d74576b4632b77cfc23398",22368716,1,-8,0,1440,394,388,-6
"4890121ce5d74576b4632b77cfc23398","f7002c8484354eceac57bc7bd62c76c1",22368716,1,7,0,1441,388,393,5
"f7002c8484354eceac57bc7bd62c76c1","7f544639412e40a9ba27f43b415362ab",22368716,1,-19,0,1442,393,378,-15
"7f544639412e40a9ba27f43b415362ab","18d3b836dd804224883cc9180b60a8e1",22368716,1,11,0,1443,378,387,9
"18d3b836dd804224883cc9180b60a8e1","7f544639412e40a9ba27f43b415362ab",22368716,1,-11,0,1444,387,378,-9
"66baf19b6b904b70922329068c63746d","4890121ce5d74576b4632b77cfc23398",22368716,1,14,0,1449,376,388,12
"18d3b836dd804224883cc9180b60a8e1","c2fca3669923477ab966ded303dea31c",22368716,1,-5,0,1451,387,383,-4
"c2fca3669923477ab966ded303dea31c","96bb2b3e85a34d8b9544514e89f6fe97",22368716,1,9,0,1452,383,390,7
"6f8881a745ac4c358a68b92c3b4abe81","66baf19b6b904b70922329068c63746d",22368716,1,-22,0,1456,394,376,-18
"2b09a08242b54983aec7063990fb3f66","0c12af0a4e7f4002852cf84b2537c161",22368716,1,-8,0,1458,400,395,-5
"0c12af0a4e7f4002852cf84b2537c161","2b09a08242b54983aec7063990fb3f66",22368716,1,8,0,1459,395,400,5
"2b09a08242b54983aec7063990fb3f66","6a5f020451db426dacba9e2ea3fcc62a",22368716,1,15,0,1462,400,410,10
"6a5f020451db426dacba9e2ea3fcc62a","687055dad9fc40c3982478fe33ec01bf",22368716,1,6,0,1465,410,414,4
"687055dad9fc40c3982478fe33ec01bf","2b09a08242b54983aec7063990fb3f66",22368716,1,-21,0,1466,414,400,-14
"a2b4bd40cee2481ebd3fc179d6a5cd62","33a9d248b2e44588a5b07fc1342b9bc2",22368716,1,-10,0,1468,417,411,-6
"33a9d248b2e44588a5b07fc1342b9bc2","2b09a08242b54983aec7063990fb3f66",22368716,1,-17,0,1470,411,400,-11
"a24600b0e49245f6bdba8c893cfeddb0","24cf8786024543f19b89bc20034e60d7",22368716,1,7,0,1480,425,428,3
"24cf8786024543f19b89bc20034e60d7","a2b4bd40cee2481ebd3fc179d6a5cd62",22368716,2,-18,0,1481,428,417,-11
"f2a73be2f46840b182d7bd095378004e","a2b4bd40cee2481ebd3fc179d6a5cd62",22368716,1,-19,0,1485,429,417,-12
"24cf8786024543f19b89bc20034e60d7","24cf8786024543f19b89bc20034e60d7",22368716,1,0,1,1487,428,428,0
"a2b4bd40cee2481ebd3fc179d6a5cd62","f2a73be2f46840b182d7bd095378004e",22368716,1,19,0,1489,417,429,12
"f2a73be2f46840b182d7bd095378004e","dce46f8904594a62a6377a3587aaa663",22368716,1,3,0,1490,429,431,2
"dce46f8904594a62a6377a3587aaa663","24cf8786024543f19b89bc20034e60d7",22368716,1,-4,0,1491,431,428,-3
"66ada10dde9f43018588f1ced9d477fc","070600601c4c439288445d2f0724807d",22368716,1,6,0,1494,434,437,3
"070600601c4c439288445d2f0724807d","901e92500aea43c79f19f1b279050668",22368716,1,8,0,1499,437,442,5
"4660ff2089114e8db82ceb26a4f329e3","0380cd76a7d44bc3a4da1f15e4d68f89",22368716,1,-8,0,1502,445,440,-5
"0380cd76a7d44bc3a4da1f15e4d68f89","901e92500aea43c79f19f1b279050668",22368716,1,4,0,1503,440,442,2
"901e92500aea43c79f19f1b279050668","7bd5586eb9d8484eb74a433ee7bfe499",22368716,1,6,0,1504,442,446,4
"7bd5586eb9d8484eb74a433ee7bfe499","23b7673c8b5443108c2ef09382834a86",22368716,1,-8,0,1505,446,441,-5
"23b7673c8b5443108c2ef09382834a86","b2f0d654738f48158edff28e8d3a546e",22368716,1,15,0,1507,441,449,8
"070600601c4c439288445d2f0724807d","7bd5586eb9d8484eb74a433ee7bfe499",22368716,1,14,0,1509,437,446,9
"7bd5586eb9d8484eb74a433ee7bfe499","b2f0d654738f48158edff28e8d3a546e",22368716,1,7,0,1510,446,449,3
"f67fbf45a5f146ed866965bc57c7c001","d937afe49bd24a07a550dda1c1155122",22368716,1,1,0,1572,454,455,1
"d937afe49bd24a07a550dda1c1155122","d937afe49bd24a07a550dda1c1155122",22368716,1,0,1,1573,455,455,0
"d937afe49bd24a07a550dda1c1155122","3628b3f7823443d0912a339096b69943",22368716,1,1,0,1574,455,456,1
"3628b3f7823443d0912a339096b69943","3628b3f7823443d0912a339096b69943",22368716,1,0,1,1575,456,456,0
"3628b3f7823443d0912a339096b69943","9e049ee647cf43ecbcb5ed792a8e7588",22368716,1,1,0,1576,456,457,1
"9e049ee647cf43ecbcb5ed792a8e7588","9e049ee647cf43ecbcb5ed792a8e7588",22368716,1,0,1,1577,457,457,0
"9e049ee647cf43ecbcb5ed792a8e7588","5256a214faaf410b93f76cea06428334",22368716,1,1,0,1578,457,458,1
"5256a214faaf410b93f76cea06428334","5256a214faaf410b93f76cea06428334",22368716,1,0,1,1579,458,458,0
"5256a214faaf410b93f76cea06428334","25c32b120fce40fa9b6c85133aeb4716",22368716,1,1,0,1580,458,459,1
"25c32b120fce40fa9b6c85133aeb4716","25c32b120fce40fa9b6c85133aeb4716",22368716,1,0,1,1581,459,459,0
"25c32b120fce40fa9b6c85133aeb4716","11bc14f2204949008b7d511b933363c1",22368716,1,1,0,1582,459,460,1
"11bc14f2204949008b7d511b933363c1","11bc14f2204949008b7d511b933363c1",22368716,1,0,1,1583,460,460,0
"11bc14f2204949008b7d511b933363c1","42de338840a34d15adb66e7b14fb9d2c",22368716,1,1,0,1584,460,461,1
"42de338840a34d15adb66e7b14fb9d2c","42de338840a34d15adb66e7b14fb9d2c",22368716,1,0,1,1585,461,461,0
"42de338840a34d15adb66e7b14fb9d2c","9da37c6210b1416b8079c274f70bf600",22368716,1,1,0,1586,461,462,1
"9da37c6210b1416b8079c274f70bf600","9da37c6210b1416b8079c274f70bf600",22368716,1,0,1,1587,462,462,0
"9da37c6210b1416b8079c274f70bf600","519119f1deac45ff9ab4f13529be5c6e",22368716,1,1,0,1588,462,463,1
"519119f1deac45ff9ab4f13529be5c6e","519119f1deac45ff9ab4f13529be5c6e",22368716,1,0,1,1589,463,463,0
"519119f1deac45ff9ab4f13529be5c6e","f67fbf45a5f146ed866965bc57c7c001",22368716,1,-9,0,1590,463,454,-9
"f67fbf45a5f146ed866965bc57c7c001","c5df9f40ec14463b9dcfdc73df3e9285",22368716,1,12,0,1591,454,464,10
"c5df9f40ec14463b9dcfdc73df3e9285","c5df9f40ec14463b9dcfdc73df3e9285",22368716,1,0,1,1592,464,464,0
"c5df9f40ec14463b9dcfdc73df3e9285","83d42d95cd844fc093fc09cee250edb8",22368716,2,3,0,1593,464,465,1
"83d42d95cd844fc093fc09cee250edb8","c5df9f40ec14463b9dcfdc73df3e9285",22368716,1,-3,0,1594,465,464,-1
"83d42d95cd844fc093fc09cee250edb8","83d42d95cd844fc093fc09cee250edb8",22368716,3,0,1,1596,465,465,0
"b613861cecf84ffcab01afb23f660475","b613861cecf84ffcab01afb23f660475",11899953,4,0,1,1,1,1,0
"b613861cecf84ffcab01afb23f660475","e2911e79efc2420eac45d9f671463d4b",11899953,1,3,0,5,1,2,1
"e2911e79efc2420eac45d9f671463d4b","e2911e79efc2420eac45d9f671463d4b",11899953,3,0,1,6,2,2,0
"e2911e79efc2420eac45d9f671463d4b","519d1b8c59404d67b54e96c5c8a830b2",11899953,1,1,0,9,2,3,1
"519d1b8c59404d67b54e96c5c8a830b2","519d1b8c59404d67b54e96c5c8a830b2",11899953,2,0,1,10,3,3,0
"519d1b8c59404d67b54e96c5c8a830b2","531db53f81f646edb0cdcfe0085b03b7",11899953,1,1,0,12,3,4,1
"531db53f81f646edb0cdcfe0085b03b7","531db53f81f646edb0cdcfe0085b03b7",11899953,1,0,1,13,4,4,0
"531db53f81f646edb0cdcfe0085b03b7","4f5f94b2f95141e0a9d53a61da2276da",11899953,1,1,0,14,4,5,1
"4f5f94b2f95141e0a9d53a61da2276da","4f5f94b2f95141e0a9d53a61da2276da",11899953,1,0,1,15,5,5,0
"4f5f94b2f95141e0a9d53a61da2276da","6d541c89590949f99af293c4f2333f67",11899953,1,1,0,16,5,6,1
"6d541c89590949f99af293c4f2333f67","6d541c89590949f99af293c4f2333f67",11899953,1,0,1,17,6,6,0
"6d541c89590949f99af293c4f2333f67","dd5cf0b9fe4c4f1d8f5ff8e4c04879cb",11899953,1,1,0,18,6,7,1
"dd5cf0b9fe4c4f1d8f5ff8e4c04879cb","dd5cf0b9fe4c4f1d8f5ff8e4c04879cb",11899953,1,0,1,19,7,7,0
"dd5cf0b9fe4c4f1d8f5ff8e4c04879cb","f96261861edc426abe2248be4f0a709a",11899953,1,1,0,20,7,8,1
"f96261861edc426abe2248be4f0a709a","f96261861edc426abe2248be4f0a709a",11899953,1,0,1,21,8,8,0
"f96261861edc426abe2248be4f0a709a","66b5e16f4f75454fb5b8172079f0fa83",11899953,1,1,0,22,8,9,1
"66b5e16f4f75454fb5b8172079f0fa83","66b5e16f4f75454fb5b8172079f0fa83",11899953,1,0,1,23,9,9,0
"66b5e16f4f75454fb5b8172079f0fa83","0680571d4698477995e41842c36a54b2",11899953,1,1,0,24,9,10,1
"0680571d4698477995e41842c36a54b2","0680571d4698477995e41842c36a54b2",11899953,1,0,1,25,10,10,0
"0680571d4698477995e41842c36a54b2","9112f2bffece48e08c6d2287be204085",11899953,1,1,0,26,10,11,1
"9112f2bffece48e08c6d2287be204085","9112f2bffece48e08c6d2287be204085",11899953,1,0,1,27,11,11,0
"9112f2bffece48e08c6d2287be204085","e2911e79efc2420eac45d9f671463d4b",11899953,1,-9,0,28,11,2,-9
"e2911e79efc2420eac45d9f671463d4b","56586aa865414f538729c7f7735d2bc6",11899953,3,12,0,29,2,12,10
"56586aa865414f538729c7f7735d2bc6","56586aa865414f538729c7f7735d2bc6",11899953,8,0,1,30,12,12,0
"56586aa865414f538729c7f7735d2bc6","b7f2b31585d94eb3bf86376714aa7070",11899953,1,2,0,33,12,13,1
"b7f2b31585d94eb3bf86376714aa7070","b7f2b31585d94eb3bf86376714aa7070",11899953,2,0,1,34,13,13,0
"b7f2b31585d94eb3bf86376714aa7070","3f1c815879794b929260d224becaff7e",11899953,1,2,0,36,13,14,1
"3f1c815879794b929260d224becaff7e","81c864a886d54a6b8ff85f7d736f4f95",11899953,1,2,0,37,14,15,1
"81c864a886d54a6b8ff85f7d736f4f95","3f1c815879794b929260d224becaff7e",11899953,1,-2,0,38,15,14,-1
"3f1c815879794b929260d224becaff7e","e2911e79efc2420eac45d9f671463d4b",11899953,1,-16,0,39,14,2,-12
"56586aa865414f538729c7f7735d2bc6","e2911e79efc2420eac45d9f671463d4b",11899953,1,-12,0,42,12,2,-10
"56586aa865414f538729c7f7735d2bc6","81c864a886d54a6b8ff85f7d736f4f95",11899953,1,6,0,48,12,15,3
"81c864a886d54a6b8ff85f7d736f4f95","5c5ceeee4562457ba6d41515aeebfbb1",11899953,1,4,0,49,15,17,2
"5c5ceeee4562457ba6d41515aeebfbb1","5c5ceeee4562457ba6d41515aeebfbb1",11899953,1,0,1,50,17,17,0
"5c5ceeee4562457ba6d41515aeebfbb1","9afd71a5298d4333b6849dfce1b9422c",11899953,1,3,0,51,17,18,1
"9afd71a5298d4333b6849dfce1b9422c","56586aa865414f538729c7f7735d2bc6",11899953,1,-13,0,52,18,12,-6
"56586aa865414f538729c7f7735d2bc6","9afd71a5298d4333b6849dfce1b9422c",11899953,1,13,0,53,12,18,6
"9afd71a5298d4333b6849dfce1b9422c","9afd71a5298d4333b6849dfce1b9422c",11899953,1,0,1,54,18,18,0
"9afd71a5298d4333b6849dfce1b9422c","b7719e26494940efa49512aedd0aac79",11899953,1,4,0,55,18,20,2
"b7719e26494940efa49512aedd0aac79","9afd71a5298d4333b6849dfce1b9422c",11899953,1,-4,0,56,20,18,-2
"9afd71a5298d4333b6849dfce1b9422c","d4f45188d3c84a02ba08454e6403a818",11899953,1,9,0,57,18,24,6
"d4f45188d3c84a02ba08454e6403a818","d4c3b003e8274e429d2fa688d73fde6d",11899953,1,-2,0,58,24,22,-2
"d4c3b003e8274e429d2fa688d73fde6d","d4c3b003e8274e429d2fa688d73fde6d",11899953,1,0,1,59,22,22,0
"d4c3b003e8274e429d2fa688d73fde6d","b7719e26494940efa49512aedd0aac79",11899953,1,-3,0,60,22,20,-2
"b7719e26494940efa49512aedd0aac79","afbf7250b99d47bea07172749483ca97",11899953,2,12,0,61,20,28,8
"afbf7250b99d47bea07172749483ca97","b7719e26494940efa49512aedd0aac79",11899953,1,-12,0,62,28,20,-8
"afbf7250b99d47bea07172749483ca97","4e51676dc72045d99c19b9fa7b22f8bc",11899953,1,3,0,64,28,29,1
"4e51676dc72045d99c19b9fa7b22f8bc","4e51676dc72045d99c19b9fa7b22f8bc",11899953,1,0,1,65,29,29,0
"4e51676dc72045d99c19b9fa7b22f8bc","51970cfa30e643e894e66ae85c8024cc",11899953,1,3,0,66,29,31,2
"51970cfa30e643e894e66ae85c8024cc","c33c17be71ae4d588da7369472e5bb1b",11899953,1,6,0,67,31,34,3
"c33c17be71ae4d588da7369472e5bb1b","4e51676dc72045d99c19b9fa7b22f8bc",11899953,1,-9,0,68,34,29,-5
"4e51676dc72045d99c19b9fa7b22f8bc","c33c17be71ae4d588da7369472e5bb1b",11899953,1,9,0,69,29,34,5
"c33c17be71ae4d588da7369472e5bb1b","93679be414554a11b1893002f2229a93",11899953,1,3,0,70,34,35,1
"93679be414554a11b1893002f2229a93","93679be414554a11b1893002f2229a93",11899953,1,0,1,71,35,35,0
"93679be414554a11b1893002f2229a93","7040a13096d746ac84b8fac8d9752058",11899953,1,3,0,72,35,36,1
"7040a13096d746ac84b8fac8d9752058","7040a13096d746ac84b8fac8d9752058",11899953,2,0,1,73,36,36,0
"7040a13096d746ac84b8fac8d9752058","9a0dc646f934470daf08c4b56ccf73db",11899953,2,3,0,74,36,37,1
"9a0dc646f934470daf08c4b56ccf73db","9a0dc646f934470daf08c4b56ccf73db",11899953,2,0,1,75,37,37,0
"9a0dc646f934470daf08c4b56ccf73db","7040a13096d746ac84b8fac8d9752058",11899953,1,-3,0,76,37,36,-1
"9a0dc646f934470daf08c4b56ccf73db","fc0e049d56024bc9a02c9a9c435c3df7",11899953,1,3,0,80,37,38,1
"fc0e049d56024bc9a02c9a9c435c3df7","fc0e049d56024bc9a02c9a9c435c3df7",11899953,6,0,1,81,38,38,0
"fc0e049d56024bc9a02c9a9c435c3df7","67a089198fcb4e1c8f2385786c2b296f",11899953,1,4,0,87,38,39,1
"64d48c6c9c7940639a932219a6c87198","64d48c6c9c7940639a932219a6c87198",11899953,1,0,1,89,40,40,0
"64d48c6c9c7940639a932219a6c87198","b534b89233134e30a9b5645138bfa9ee",11899953,1,3,0,90,40,41,1
"b534b89233134e30a9b5645138bfa9ee","67a089198fcb4e1c8f2385786c2b296f",11899953,1,-4,0,91,41,39,-2
"67a089198fcb4e1c8f2385786c2b296f","0e37b720d23b4e7f8b313e79313fd107",11899953,1,7,0,92,39,44,5
"0e37b720d23b4e7f8b313e79313fd107","0e37b720d23b4e7f8b313e79313fd107",11899953,2,0,1,93,44,44,0
"0e37b720d23b4e7f8b313e79313fd107","6875d67fdd5f48168b62719df449bebd",11899953,1,1,0,95,44,45,1
"6875d67fdd5f48168b62719df449bebd","6875d67fdd5f48168b62719df449bebd",11899953,1,0,1,96,45,45,0
"6875d67fdd5f48168b62719df449bebd","b534b89233134e30a9b5645138bfa9ee",11899953,1,-4,0,97,45,41,-4
"6e13d61a7bdb44bca949c9f86fab3be5","6e13d61a7bdb44bca949c9f86fab3be5",11899953,1,0,1,99,47,47,0
"6e13d61a7bdb44bca949c9f86fab3be5","195f78799f984cc2b06c48dfe36be751",11899953,1,2,0,100,47,49,2
"195f78799f984cc2b06c48dfe36be751","195f78799f984cc2b06c48dfe36be751",11899953,2,0,1,101,49,49,0
"195f78799f984cc2b06c48dfe36be751","d9c8d8c444a64dadbbb508652c721e17",11899953,1,-3,0,103,49,46,-3
"d9c8d8c444a64dadbbb508652c721e17","d0c74f735e024943943e40333d6d337f",11899953,2,6,0,104,46,51,5
"d0c74f735e024943943e40333d6d337f","d0c74f735e024943943e40333d6d337f",11899953,3,0,1,105,51,51,0
"d0c74f735e024943943e40333d6d337f","983f8ff320594b279a7f4a6fe132f9c5",11899953,1,2,0,106,51,53,2
"983f8ff320594b279a7f4a6fe132f9c5","983f8ff320594b279a7f4a6fe132f9c5",11899953,2,0,1,107,53,53,0
"983f8ff320594b279a7f4a6fe132f9c5","35adfa5d923046aebabfefd98f35ff05",11899953,1,1,0,109,53,54,1
"35adfa5d923046aebabfefd98f35ff05","35adfa5d923046aebabfefd98f35ff05",11899953,5,0,1,110,54,54,0
"35adfa5d923046aebabfefd98f35ff05","b6f8a98476224da1b40e555ececc7ed8",11899953,1,1,0,115,54,55,1
"b6f8a98476224da1b40e555ececc7ed8","b6f8a98476224da1b40e555ececc7ed8",11899953,2,0,1,116,55,55,0
"b6f8a98476224da1b40e555ececc7ed8","86e22cb5fe0e4b47a9489ecddf7ed78f",11899953,1,1,0,118,55,56,1
"86e22cb5fe0e4b47a9489ecddf7ed78f","86e22cb5fe0e4b47a9489ecddf7ed78f",11899953,2,0,1,119,56,56,0
"86e22cb5fe0e4b47a9489ecddf7ed78f","f924752d8a1149668870b1e7698486f7",11899953,1,-6,0,121,56,50,-6
"f924752d8a1149668870b1e7698486f7","a1f2f12debe5432fb7a70bcd12bacfb9",11899953,1,9,0,122,50,58,8
"a1f2f12debe5432fb7a70bcd12bacfb9","78f30e4dcac84e3cbea8b2cc6e0d62b3",11899953,3,1,0,123,58,59,1
"78f30e4dcac84e3cbea8b2cc6e0d62b3","a1f2f12debe5432fb7a70bcd12bacfb9",11899953,2,-1,0,124,59,58,-1
"a1f2f12debe5432fb7a70bcd12bacfb9","a1f2f12debe5432fb7a70bcd12bacfb9",11899953,16,0,1,125,58,58,0
"78f30e4dcac84e3cbea8b2cc6e0d62b3","78f30e4dcac84e3cbea8b2cc6e0d62b3",11899953,16,0,1,142,59,59,0
"78f30e4dcac84e3cbea8b2cc6e0d62b3","12aa6e1672ac4e7aa6449a7a8609cd72",11899953,1,-2,0,158,59,57,-2
"12aa6e1672ac4e7aa6449a7a8609cd72","bc42d26810654ea9a1df1efe1e58c7d5",11899953,1,7,0,159,57,63,6
"bc42d26810654ea9a1df1efe1e58c7d5","a0a418b8540d479fa6e0f653b701da8b",11899953,3,1,0,160,63,64,1
"a0a418b8540d479fa6e0f653b701da8b","4c943503763e4e349906eea3ed3c8e86",11899953,1,-3,0,161,64,61,-3
"4c943503763e4e349906eea3ed3c8e86","4c943503763e4e349906eea3ed3c8e86",11899953,1,0,1,162,61,61,0
"4c943503763e4e349906eea3ed3c8e86","bc42d26810654ea9a1df1efe1e58c7d5",11899953,1,2,0,163,61,63,2
"bc42d26810654ea9a1df1efe1e58c7d5","bc42d26810654ea9a1df1efe1e58c7d5",11899953,4,0,1,164,63,63,0
"a0a418b8540d479fa6e0f653b701da8b","a0a418b8540d479fa6e0f653b701da8b",11899953,3,0,1,168,64,64,0
"a0a418b8540d479fa6e0f653b701da8b","309ccf3cc4fe429d9bfbaef53d3fa479",11899953,1,-4,0,171,64,60,-4
"309ccf3cc4fe429d9bfbaef53d3fa479","78f30e4dcac84e3cbea8b2cc6e0d62b3",11899953,1,-2,0,172,60,59,-1
"a1f2f12debe5432fb7a70bcd12bacfb9","12aa6e1672ac4e7aa6449a7a8609cd72",11899953,1,-1,0,174,58,57,-1
"12aa6e1672ac4e7aa6449a7a8609cd72","d646286c8051419bbc2e31dd1db55ca8",11899953,1,14,0,175,57,67,10
"d646286c8051419bbc2e31dd1db55ca8","b534b89233134e30a9b5645138bfa9ee",11899953,1,-33,0,176,67,41,-26
"b534b89233134e30a9b5645138bfa9ee","267f883678b24aed855fde42524975d9",11899953,1,37,0,177,41,71,30
"267f883678b24aed855fde42524975d9","267f883678b24aed855fde42524975d9",11899953,1,0,1,178,71,71,0
"267f883678b24aed855fde42524975d9","88fff56d0342490dbef9040750a20f6c",11899953,1,1,0,179,71,72,1
"88fff56d0342490dbef9040750a20f6c","88fff56d0342490dbef9040750a20f6c",11899953,1,0,1,180,72,72,0
"88fff56d0342490dbef9040750a20f6c","adb17b12b66c4a49a85fd34322f7df70",11899953,1,1,0,181,72,73,1
"adb17b12b66c4a49a85fd34322f7df70","adb17b12b66c4a49a85fd34322f7df70",11899953,1,0,1,182,73,73,0
"adb17b12b66c4a49a85fd34322f7df70","a2becd407db34b189200a32546d9d569",11899953,1,3,0,183,73,75,2
"a2becd407db34b189200a32546d9d569","d646286c8051419bbc2e31dd1db55ca8",11899953,1,-9,0,184,75,67,-8
"d646286c8051419bbc2e31dd1db55ca8","a2becd407db34b189200a32546d9d569",11899953,3,9,0,185,67,75,8
"a2becd407db34b189200a32546d9d569","58c22b011d0f4c2ea6d13615edbb9eeb",11899953,1,2,0,186,75,77,2
"58c22b011d0f4c2ea6d13615edbb9eeb","58c22b011d0f4c2ea6d13615edbb9eeb",11899953,2,0,1,187,77,77,0
"58c22b011d0f4c2ea6d13615edbb9eeb","dd76e1861dc9461c830888729d091ee0",11899953,1,1,0,189,77,78,1
"dd76e1861dc9461c830888729d091ee0","dd76e1861dc9461c830888729d091ee0",11899953,11,0,1,190,78,78,0
"dd76e1861dc9461c830888729d091ee0","cd1d828f1a694b87913a7ea66c23803e",11899953,1,1,0,201,78,79,1
"cd1d828f1a694b87913a7ea66c23803e","cd1d828f1a694b87913a7ea66c23803e",11899953,2,0,1,202,79,79,0
"cd1d828f1a694b87913a7ea66c23803e","9176a3c2b4d2465fa8b0c67096c2a97e",11899953,1,1,0,204,79,80,1
"9176a3c2b4d2465fa8b0c67096c2a97e","9176a3c2b4d2465fa8b0c67096c2a97e",11899953,5,0,1,205,80,80,0
"9176a3c2b4d2465fa8b0c67096c2a97e","f8ec6445f7194e25b9101d4fbcb07a18",11899953,1,1,0,210,80,81,1
"f8ec6445f7194e25b9101d4fbcb07a18","f8ec6445f7194e25b9101d4fbcb07a18",11899953,2,0,1,211,81,81,0
"f8ec6445f7194e25b9101d4fbcb07a18","140d5b27b8574befad82c0a013b59dfa",11899953,1,-7,0,213,81,74,-7
"140d5b27b8574befad82c0a013b59dfa","d18a9ea32855445f8736581f5cb119ce",11899953,2,9,0,214,74,82,8
"d18a9ea32855445f8736581f5cb119ce","f564483cbd7a407681aa2fcca518cf5f",11899953,1,4,0,215,82,85,3
"f564483cbd7a407681aa2fcca518cf5f","f564483cbd7a407681aa2fcca518cf5f",11899953,3,0,1,216,85,85,0
"f564483cbd7a407681aa2fcca518cf5f","18fd01350bd5434ca636d59a599d768a",11899953,1,1,0,219,85,86,1
"18fd01350bd5434ca636d59a599d768a","18fd01350bd5434ca636d59a599d768a",11899953,8,0,1,220,86,86,0
"18fd01350bd5434ca636d59a599d768a","ae5ac430ea254e708a6f5deaaf7464ae",11899953,1,-2,0,228,86,84,-2
"ae5ac430ea254e708a6f5deaaf7464ae","6a9f0ef185fb47f0937e29daa1c71ed5",11899953,1,7,0,229,84,90,6
"6a9f0ef185fb47f0937e29daa1c71ed5","c681290961c94c4caf23b529d1ae6b9a",11899953,1,-2,0,230,90,88,-2
"c681290961c94c4caf23b529d1ae6b9a","c681290961c94c4caf23b529d1ae6b9a",11899953,1,0,1,231,88,88,0
"c681290961c94c4caf23b529d1ae6b9a","6a9f0ef185fb47f0937e29daa1c71ed5",11899953,1,2,0,232,88,90,2
"6a9f0ef185fb47f0937e29daa1c71ed5","6a9f0ef185fb47f0937e29daa1c71ed5",11899953,3,0,1,233,90,90,0
"6a9f0ef185fb47f0937e29daa1c71ed5","d646286c8051419bbc2e31dd1db55ca8",11899953,1,-27,0,236,90,67,-23
"d646286c8051419bbc2e31dd1db55ca8","e20db35ced8544ddac5bc3839145e463",11899953,2,30,0,237,67,91,24
"e20db35ced8544ddac5bc3839145e463","d646286c8051419bbc2e31dd1db55ca8",11899953,1,-30,0,238,91,67,-24
"e20db35ced8544ddac5bc3839145e463","1febb706d7a34005ae8711ed49c76e64",11899953,1,3,0,241,91,94,3
"1febb706d7a34005ae8711ed49c76e64","1febb706d7a34005ae8711ed49c76e64",11899953,5,0,1,242,94,94,0
"1febb706d7a34005ae8711ed49c76e64","8f73ba6f5a0042f2850356ac38ac6f24",11899953,1,1,0,247,94,95,1
"8f73ba6f5a0042f2850356ac38ac6f24","8f73ba6f5a0042f2850356ac38ac6f24",11899953,5,0,1,248,95,95,0
"8f73ba6f5a0042f2850356ac38ac6f24","e2260b86653c46d7b14a41fb419dbf8c",11899953,1,1,0,253,95,96,1
"e2260b86653c46d7b14a41fb419dbf8c","e2260b86653c46d7b14a41fb419dbf8c",11899953,2,0,1,254,96,96,0
"e2260b86653c46d7b14a41fb419dbf8c","35eb641ad1d845bbba54915bce75a962",11899953,1,1,0,256,96,97,1
"35eb641ad1d845bbba54915bce75a962","35eb641ad1d845bbba54915bce75a962",11899953,5,0,1,257,97,97,0
"35eb641ad1d845bbba54915bce75a962","08be90ffbeea4795a138cd42ed8db56f",11899953,2,1,0,262,97,98,1
"08be90ffbeea4795a138cd42ed8db56f","08be90ffbeea4795a138cd42ed8db56f",11899953,6,0,1,263,98,98,0
"08be90ffbeea4795a138cd42ed8db56f","3007433c8f584dcbb5ac159c1c5f2be3",11899953,1,1,0,268,98,99,1
"3007433c8f584dcbb5ac159c1c5f2be3","3007433c8f584dcbb5ac159c1c5f2be3",11899953,5,0,1,269,99,99,0
"3007433c8f584dcbb5ac159c1c5f2be3","00ae5f0c51874a73a41ebea838d95682",11899953,1,3,0,274,99,101,2
"e20db35ced8544ddac5bc3839145e463","d391c8b6e56a43a7b654e9dee02d904b",11899953,1,13,0,276,91,103,12
"d391c8b6e56a43a7b654e9dee02d904b","d391c8b6e56a43a7b654e9dee02d904b",11899953,15,0,1,279,103,103,0
"d391c8b6e56a43a7b654e9dee02d904b","6111116566fc4fd9abba409322bea245",11899953,1,1,0,294,103,104,1
"6111116566fc4fd9abba409322bea245","6111116566fc4fd9abba409322bea245",11899953,2,0,1,295,104,104,0
"6111116566fc4fd9abba409322bea245","a81b2235cb9c499eb9ea8ee0a8dd9725",11899953,1,1,0,297,104,105,1
"a81b2235cb9c499eb9ea8ee0a8dd9725","a81b2235cb9c499eb9ea8ee0a8dd9725",11899953,2,0,1,298,105,105,0
"a81b2235cb9c499eb9ea8ee0a8dd9725","2d4e0ab0ef3b4d73b82c72d4621a7579",11899953,1,1,0,300,105,106,1
"2d4e0ab0ef3b4d73b82c72d4621a7579","2d4e0ab0ef3b4d73b82c72d4621a7579",11899953,2,0,1,301,106,106,0
"2d4e0ab0ef3b4d73b82c72d4621a7579","8bdebf492ebd4e62b0d522e8ab5e5197",11899953,1,1,0,303,106,107,1
"8bdebf492ebd4e62b0d522e8ab5e5197","8bdebf492ebd4e62b0d522e8ab5e5197",11899953,2,0,1,304,107,107,0
"8bdebf492ebd4e62b0d522e8ab5e5197","4280927ec4d643238aa49c32f9e06c6c",11899953,1,3,0,306,107,109,2
"4280927ec4d643238aa49c32f9e06c6c","73039f8c1eb9409cb4caee2cf968001e",11899953,1,-10,0,307,109,100,-9
"73039f8c1eb9409cb4caee2cf968001e","4280927ec4d643238aa49c32f9e06c6c",11899953,1,10,0,308,100,109,9
"4280927ec4d643238aa49c32f9e06c6c","fc44e6a5f7654430af1227838224dceb",11899953,1,2,0,309,109,111,2
"fc44e6a5f7654430af1227838224dceb","fc44e6a5f7654430af1227838224dceb",11899953,2,0,1,310,111,111,0
"fc44e6a5f7654430af1227838224dceb","08111f75e22d409998cf8b85bd431f0a",11899953,1,-3,0,312,111,108,-3
"08111f75e22d409998cf8b85bd431f0a","a9ae0a3c070d455bb4369a8996313336",11899953,1,7,0,313,108,114,6
"a9ae0a3c070d455bb4369a8996313336","a9ae0a3c070d455bb4369a8996313336",11899953,1,0,1,314,114,114,0
"a9ae0a3c070d455bb4369a8996313336","71cec822bcff4f30a20e75dc63ef7b65",11899953,1,2,0,315,114,116,2
"71cec822bcff4f30a20e75dc63ef7b65","71cec822bcff4f30a20e75dc63ef7b65",11899953,1,0,1,316,116,116,0
"71cec822bcff4f30a20e75dc63ef7b65","37319e88176d4aefa91d7a9980dbae91",11899953,1,-4,0,317,116,112,-4
"37319e88176d4aefa91d7a9980dbae91","62bff51286ef4f348717a3cf6fe2318f",11899953,1,9,0,318,112,120,8
"62bff51286ef4f348717a3cf6fe2318f","e20db35ced8544ddac5bc3839145e463",11899953,1,-33,0,319,120,91,-29
"e20db35ced8544ddac5bc3839145e463","62bff51286ef4f348717a3cf6fe2318f",11899953,2,33,0,323,91,120,29
"62bff51286ef4f348717a3cf6fe2318f","3ec3a3563847406fa73338f9e9999cf3",11899953,1,-3,0,324,120,117,-3
"3ec3a3563847406fa73338f9e9999cf3","35eb641ad1d845bbba54915bce75a962",11899953,1,-24,0,325,117,97,-20
"08be90ffbeea4795a138cd42ed8db56f","e20db35ced8544ddac5bc3839145e463",11899953,1,-7,0,328,98,91,-7
"62bff51286ef4f348717a3cf6fe2318f","b1cd0e7dc3ad4a8eb91a4bfdbeb025b0",11899953,1,-2,0,330,120,118,-2
"b1cd0e7dc3ad4a8eb91a4bfdbeb025b0","b1cd0e7dc3ad4a8eb91a4bfdbeb025b0",11899953,1,0,1,331,118,118,0
"b1cd0e7dc3ad4a8eb91a4bfdbeb025b0","62bff51286ef4f348717a3cf6fe2318f",11899953,1,2,0,332,118,120,2
"62bff51286ef4f348717a3cf6fe2318f","62bff51286ef4f348717a3cf6fe2318f",11899953,3,0,1,333,120,120,0
"62bff51286ef4f348717a3cf6fe2318f","779f9ddd1fd14d1e9e69f72219a1fdbd",11899953,1,3,0,336,120,121,1
"779f9ddd1fd14d1e9e69f72219a1fdbd","e20db35ced8544ddac5bc3839145e463",11899953,1,-36,0,337,121,91,-30
"e20db35ced8544ddac5bc3839145e463","ae26e6cda8ad4a3f81bd347560d9579f",11899953,1,40,0,338,91,125,34
"ae26e6cda8ad4a3f81bd347560d9579f","ae26e6cda8ad4a3f81bd347560d9579f",11899953,1,0,1,339,125,125,0
"ae26e6cda8ad4a3f81bd347560d9579f","ee48df95832b4374aa273ceb27ec1315",11899953,1,1,0,340,125,126,1
"ee48df95832b4374aa273ceb27ec1315","ee48df95832b4374aa273ceb27ec1315",11899953,1,0,1,341,126,126,0
"ee48df95832b4374aa273ceb27ec1315","7a439da90b394756ad1777fc4c6dead5",11899953,1,1,0,342,126,127,1
"7a439da90b394756ad1777fc4c6dead5","7a439da90b394756ad1777fc4c6dead5",11899953,1,0,1,343,127,127,0
"7a439da90b394756ad1777fc4c6dead5","a8dd5213034441ac92724b4e83eb0bb2",11899953,1,3,0,344,127,129,2
"a8dd5213034441ac92724b4e83eb0bb2","779f9ddd1fd14d1e9e69f72219a1fdbd",11899953,1,-9,0,345,129,121,-8
"779f9ddd1fd14d1e9e69f72219a1fdbd","a8dd5213034441ac92724b4e83eb0bb2",11899953,1,9,0,346,121,129,8
"a8dd5213034441ac92724b4e83eb0bb2","8115eab6556b45f5b415c3b8c26a12e5",11899953,1,2,0,347,129,131,2
"8115eab6556b45f5b415c3b8c26a12e5","8115eab6556b45f5b415c3b8c26a12e5",11899953,5,0,1,348,131,131,0
"8115eab6556b45f5b415c3b8c26a12e5","ec34b06efd844b46a4c4818ecdb9b8f4",11899953,1,1,0,353,131,132,1
"ec34b06efd844b46a4c4818ecdb9b8f4","ec34b06efd844b46a4c4818ecdb9b8f4",11899953,2,0,1,354,132,132,0
"ec34b06efd844b46a4c4818ecdb9b8f4","c2e1c2b9eac64109b343a088584b576b",11899953,1,1,0,356,132,133,1
"c2e1c2b9eac64109b343a088584b576b","c2e1c2b9eac64109b343a088584b576b",11899953,2,0,1,357,133,133,0
"c2e1c2b9eac64109b343a088584b576b","579338175e0b4bbb8ef3b712b5d8b54e",11899953,1,-5,0,359,133,128,-5
"579338175e0b4bbb8ef3b712b5d8b54e","8bc5795d6a984a3eace4e2811e52dd4f",11899953,1,8,0,360,128,135,7
"8bc5795d6a984a3eace4e2811e52dd4f","8bc5795d6a984a3eace4e2811e52dd4f",11899953,1,0,1,361,135,135,0
"8bc5795d6a984a3eace4e2811e52dd4f","b416d47c56a742199b5d7c7f19d6503a",11899953,1,-1,0,362,135,134,-1
"b416d47c56a742199b5d7c7f19d6503a","cd4532ad48034873ba8bce2aac0c9808",11899953,1,4,0,363,134,137,3
"cd4532ad48034873ba8bce2aac0c9808","cd4532ad48034873ba8bce2aac0c9808",11899953,1,0,1,364,137,137,0
"cd4532ad48034873ba8bce2aac0c9808","df1de691dafe4549a18a4398ee9dfaf9",11899953,1,4,0,365,137,139,2
"df1de691dafe4549a18a4398ee9dfaf9","779f9ddd1fd14d1e9e69f72219a1fdbd",11899953,1,-23,0,366,139,121,-18
"779f9ddd1fd14d1e9e69f72219a1fdbd","6c5ad271a44743479bfaea29b1db8d02",11899953,1,27,0,367,121,143,22
"6c5ad271a44743479bfaea29b1db8d02","6c5ad271a44743479bfaea29b1db8d02",11899953,1,0,1,368,143,143,0
"6c5ad271a44743479bfaea29b1db8d02","83d311bed5374fee83d8d67a7d9d82dc",11899953,1,1,0,369,143,144,1
"83d311bed5374fee83d8d67a7d9d82dc","83d311bed5374fee83d8d67a7d9d82dc",11899953,1,0,1,370,144,144,0
"83d311bed5374fee83d8d67a7d9d82dc","402bba41861d43acb52a5abb89e8831e",11899953,1,1,0,371,144,145,1
"402bba41861d43acb52a5abb89e8831e","402bba41861d43acb52a5abb89e8831e",11899953,2,0,1,372,145,145,0
"402bba41861d43acb52a5abb89e8831e","8aae34f5ddbb4052a709b12e6b0d40fa",11899953,1,3,0,374,145,147,2
"8aae34f5ddbb4052a709b12e6b0d40fa","df1de691dafe4549a18a4398ee9dfaf9",11899953,1,-9,0,375,147,139,-8
"8aae34f5ddbb4052a709b12e6b0d40fa","645b3f0249f64f76af2e19eb4d0e55b7",11899953,1,2,0,377,147,149,2
"645b3f0249f64f76af2e19eb4d0e55b7","645b3f0249f64f76af2e19eb4d0e55b7",11899953,2,0,1,378,149,149,0
"645b3f0249f64f76af2e19eb4d0e55b7","7e7b8db5064d4369805ab370aac5ddfb",11899953,1,1,0,380,149,150,1
"7e7b8db5064d4369805ab370aac5ddfb","7e7b8db5064d4369805ab370aac5ddfb",11899953,5,0,1,381,150,150,0
"7e7b8db5064d4369805ab370aac5ddfb","8956d210ae7f41968fada86d4c979d6a",11899953,1,1,0,386,150,151,1
"8956d210ae7f41968fada86d4c979d6a","8956d210ae7f41968fada86d4c979d6a",11899953,2,0,1,387,151,151,0
"8956d210ae7f41968fada86d4c979d6a","f902b0f41b544d4dbf79664fd233648d",11899953,1,-5,0,389,151,146,-5
"f902b0f41b544d4dbf79664fd233648d","ae781e8b775e4ccd93bc800dad5c8376",11899953,1,8,0,390,146,153,7
"ae781e8b775e4ccd93bc800dad5c8376","ae781e8b775e4ccd93bc800dad5c8376",11899953,2,0,1,391,153,153,0
"ae781e8b775e4ccd93bc800dad5c8376","06882a8492d9499aa31555567f575ecb",11899953,1,1,0,393,153,154,1
"06882a8492d9499aa31555567f575ecb","06882a8492d9499aa31555567f575ecb",11899953,1,0,1,394,154,154,0
"06882a8492d9499aa31555567f575ecb","f293c508f409466a8f27ddd7d1e40b20",11899953,1,1,0,395,154,155,1
"f293c508f409466a8f27ddd7d1e40b20","f293c508f409466a8f27ddd7d1e40b20",11899953,2,0,1,396,155,155,0
"f293c508f409466a8f27ddd7d1e40b20","cc4ddef5bbbe48ebb605141b347c4ed1",11899953,1,1,0,398,155,156,1
"cc4ddef5bbbe48ebb605141b347c4ed1","cc4ddef5bbbe48ebb605141b347c4ed1",11899953,1,0,1,399,156,156,0
"cc4ddef5bbbe48ebb605141b347c4ed1","f03480cf4eba413194d7af52fc0e7f28",11899953,1,-4,0,400,156,152,-4
"f03480cf4eba413194d7af52fc0e7f28","d313cec988a84645bee413e8d4724a4b",11899953,1,7,0,401,152,158,6
"d313cec988a84645bee413e8d4724a4b","dc60696c76a74368a60f72246e47700d",11899953,1,1,0,406,158,159,1
"dc60696c76a74368a60f72246e47700d","dc60696c76a74368a60f72246e47700d",11899953,1,0,1,407,159,159,0
"dc60696c76a74368a60f72246e47700d","df1de691dafe4549a18a4398ee9dfaf9",11899953,1,-23,0,408,159,139,-20
"df1de691dafe4549a18a4398ee9dfaf9","78adeee1fa2c4fe0bc73f7bca9fcee86",11899953,1,26,0,409,139,160,21
"78adeee1fa2c4fe0bc73f7bca9fcee86","78adeee1fa2c4fe0bc73f7bca9fcee86",11899953,5,0,1,410,160,160,0
"78adeee1fa2c4fe0bc73f7bca9fcee86","67a089198fcb4e1c8f2385786c2b296f",11899953,2,-152,0,412,160,39,-121
"67a089198fcb4e1c8f2385786c2b296f","64d48c6c9c7940639a932219a6c87198",11899953,2,1,0,413,39,40,1
"64d48c6c9c7940639a932219a6c87198","78adeee1fa2c4fe0bc73f7bca9fcee86",11899953,1,151,0,414,40,160,120
"67a089198fcb4e1c8f2385786c2b296f","d9c8d8c444a64dadbbb508652c721e17",11899953,1,10,0,416,39,46,7
"d9c8d8c444a64dadbbb508652c721e17","b534b89233134e30a9b5645138bfa9ee",11899953,1,-6,0,417,46,41,-5
"b534b89233134e30a9b5645138bfa9ee","6e13d61a7bdb44bca949c9f86fab3be5",11899953,2,7,0,418,41,47,6
"6e13d61a7bdb44bca949c9f86fab3be5","d9c8d8c444a64dadbbb508652c721e17",11899953,1,-1,0,419,47,46,-1
"d0c74f735e024943943e40333d6d337f","67a089198fcb4e1c8f2385786c2b296f",11899953,1,-16,0,421,51,39,-12
"67a089198fcb4e1c8f2385786c2b296f","78adeee1fa2c4fe0bc73f7bca9fcee86",11899953,1,152,0,422,39,160,121
"65202579580f4ad38d734b4ee39d22a8","78adeee1fa2c4fe0bc73f7bca9fcee86",11899953,2,-5,0,480,164,160,-4
"78adeee1fa2c4fe0bc73f7bca9fcee86","3cbcea2be0984e7dbd5a48195af10ce7",11899953,1,8,0,481,160,165,5
"3cbcea2be0984e7dbd5a48195af10ce7","82e6285962b8400d9d6fc32436022a94",11899953,1,2,0,482,165,167,2
"82e6285962b8400d9d6fc32436022a94","a9ac840f098c4bd0a2ee896214ce29cd",11899953,1,3,0,483,167,168,1
"a9ac840f098c4bd0a2ee896214ce29cd","3cbcea2be0984e7dbd5a48195af10ce7",11899953,1,-5,0,484,168,165,-3
"3cbcea2be0984e7dbd5a48195af10ce7","a9ac840f098c4bd0a2ee896214ce29cd",11899953,1,5,0,485,165,168,3
"a9ac840f098c4bd0a2ee896214ce29cd","67a089198fcb4e1c8f2385786c2b296f",11899953,1,-165,0,486,168,39,-129
"67a089198fcb4e1c8f2385786c2b296f","12aa6e1672ac4e7aa6449a7a8609cd72",11899953,1,23,0,487,39,57,18
"12aa6e1672ac4e7aa6449a7a8609cd72","b534b89233134e30a9b5645138bfa9ee",11899953,1,-19,0,488,57,41,-16
"b534b89233134e30a9b5645138bfa9ee","a1f2f12debe5432fb7a70bcd12bacfb9",11899953,1,20,0,489,41,58,17
"78f30e4dcac84e3cbea8b2cc6e0d62b3","140d5b27b8574befad82c0a013b59dfa",11899953,1,20,0,491,59,74,15
"a2becd407db34b189200a32546d9d569","140d5b27b8574befad82c0a013b59dfa",11899953,1,-1,0,494,75,74,-1
"d18a9ea32855445f8736581f5cb119ce","67a089198fcb4e1c8f2385786c2b296f",11899953,1,-54,0,496,82,39,-43
"67a089198fcb4e1c8f2385786c2b296f","a9ac840f098c4bd0a2ee896214ce29cd",11899953,1,165,0,497,39,168,129
"a9ac840f098c4bd0a2ee896214ce29cd","a9ac840f098c4bd0a2ee896214ce29cd",11899953,2,0,1,498,168,168,0
"a9ac840f098c4bd0a2ee896214ce29cd","0c7262dff33c4087bc660ccf40f92f9c",11899953,1,4,0,500,168,169,1
"0c7262dff33c4087bc660ccf40f92f9c","b2275c3fad834f8d90737a2d9a6927d6",11899953,1,3,0,501,169,172,3
"b2275c3fad834f8d90737a2d9a6927d6","b2275c3fad834f8d90737a2d9a6927d6",11899953,20,0,1,502,172,172,0
"b2275c3fad834f8d90737a2d9a6927d6","eb515a26030b41f8a82a1e6114420bad",11899953,1,1,0,522,172,173,1
"eb515a26030b41f8a82a1e6114420bad","eb515a26030b41f8a82a1e6114420bad",11899953,5,0,1,523,173,173,0
"eb515a26030b41f8a82a1e6114420bad","b42cc17b7de840f181a704558d0bc845",11899953,1,3,0,528,173,175,2
"b42cc17b7de840f181a704558d0bc845","0c7262dff33c4087bc660ccf40f92f9c",11899953,1,-7,0,529,175,169,-6
"0c7262dff33c4087bc660ccf40f92f9c","b42cc17b7de840f181a704558d0bc845",11899953,1,7,0,530,169,175,6
"b42cc17b7de840f181a704558d0bc845","801f9e9135034f49bf5f8b4bdefedb41",11899953,1,2,0,531,175,177,2
"801f9e9135034f49bf5f8b4bdefedb41","801f9e9135034f49bf5f8b4bdefedb41",11899953,4,0,1,532,177,177,0
"801f9e9135034f49bf5f8b4bdefedb41","362fcb0699a14845ab29b2340093e528",11899953,1,-3,0,536,177,174,-3
"362fcb0699a14845ab29b2340093e528","ea38cc0e6e6e41edbabf210220808bf9",11899953,1,6,0,537,174,179,5
"ea38cc0e6e6e41edbabf210220808bf9","b87c552dd247427abe6ab5795b9c9d43",11899953,2,2,0,538,179,181,2
"b87c552dd247427abe6ab5795b9c9d43","ea38cc0e6e6e41edbabf210220808bf9",11899953,1,-2,0,539,181,179,-2
"b87c552dd247427abe6ab5795b9c9d43","b87c552dd247427abe6ab5795b9c9d43",11899953,8,0,1,541,181,181,0
"b87c552dd247427abe6ab5795b9c9d43","139b097acfca451689d80c9c6eebdf7b",11899953,1,-3,0,549,181,178,-3
"139b097acfca451689d80c9c6eebdf7b","30f660a1feb34582a739722532524f79",11899953,1,6,0,550,178,183,5
"30f660a1feb34582a739722532524f79","30f660a1feb34582a739722532524f79",11899953,1,0,1,551,183,183,0
"30f660a1feb34582a739722532524f79","2024b4885bd14338a39b7b509acbbd02",11899953,1,-1,0,552,183,182,-1
"2024b4885bd14338a39b7b509acbbd02","c3f63fe50d8e487c86bf8ef76c9cadd3",11899953,1,4,0,553,182,185,3
"c3f63fe50d8e487c86bf8ef76c9cadd3","c3f63fe50d8e487c86bf8ef76c9cadd3",11899953,1,0,1,554,185,185,0
"c3f63fe50d8e487c86bf8ef76c9cadd3","c8e371568a0c4391b25796ae4e91952e",11899953,1,3,0,555,185,186,1
"c8e371568a0c4391b25796ae4e91952e","0c7262dff33c4087bc660ccf40f92f9c",11899953,2,-23,0,556,186,169,-17
"0c7262dff33c4087bc660ccf40f92f9c","7d932b23e1c84326ae5aa4d3c0d813d1",11899953,1,25,0,557,169,188,19
"7d932b23e1c84326ae5aa4d3c0d813d1","7d932b23e1c84326ae5aa4d3c0d813d1",11899953,1,0,1,558,188,188,0
"7d932b23e1c84326ae5aa4d3c0d813d1","ab11d94c6c8948ea90b88f19d2cd502b",11899953,1,3,0,559,188,190,2
"ab11d94c6c8948ea90b88f19d2cd502b","c8e371568a0c4391b25796ae4e91952e",11899953,1,-5,0,560,190,186,-4
"f992451ed6ad4e68bb9e68ad6be7c4be","f992451ed6ad4e68bb9e68ad6be7c4be",11899953,1,0,1,563,192,192,0
"6cd2dcaac46847d4a0bc53f296d90375","2d2580c9411c4972909db508d6956a58",11899953,1,2,0,567,194,196,2
"2d2580c9411c4972909db508d6956a58","2d2580c9411c4972909db508d6956a58",11899953,2,0,1,568,196,196,0
"2d2580c9411c4972909db508d6956a58","5bddb3d9ed264f3984702f048c7e5340",11899953,1,1,0,570,196,197,1
"5bddb3d9ed264f3984702f048c7e5340","5bddb3d9ed264f3984702f048c7e5340",11899953,2,0,1,571,197,197,0
"5bddb3d9ed264f3984702f048c7e5340","d5e8e2bd12a2466b9d6d90855f0eb079",11899953,1,1,0,573,197,198,1
"d5e8e2bd12a2466b9d6d90855f0eb079","d5e8e2bd12a2466b9d6d90855f0eb079",11899953,2,0,1,574,198,198,0
"d5e8e2bd12a2466b9d6d90855f0eb079","017d7ca8e0394b91aaadc9574df2202c",11899953,1,-5,0,576,198,193,-5
"017d7ca8e0394b91aaadc9574df2202c","54e8e9f0ea3e45c4bf3b8ac799ee31b1",11899953,1,8,0,577,193,200,7
"54e8e9f0ea3e45c4bf3b8ac799ee31b1","54e8e9f0ea3e45c4bf3b8ac799ee31b1",11899953,1,0,1,578,200,200,0
"54e8e9f0ea3e45c4bf3b8ac799ee31b1","c614a00911be4877a075f19315530fb0",11899953,1,1,0,579,200,201,1
"c614a00911be4877a075f19315530fb0","c614a00911be4877a075f19315530fb0",11899953,6,0,1,580,201,201,0
"c614a00911be4877a075f19315530fb0","a6c21bd8b95249c7972820a7a7d76aff",11899953,1,1,0,586,201,202,1
"a6c21bd8b95249c7972820a7a7d76aff","a6c21bd8b95249c7972820a7a7d76aff",11899953,1,0,1,587,202,202,0
"a6c21bd8b95249c7972820a7a7d76aff","bb329d880ab54120adaf203a693bb203",11899953,1,1,0,588,202,203,1
"bb329d880ab54120adaf203a693bb203","c8e371568a0c4391b25796ae4e91952e",11899953,1,-20,0,589,203,186,-17
"c8e371568a0c4391b25796ae4e91952e","c8e371568a0c4391b25796ae4e91952e",11899953,4,0,1,590,186,186,0
"017d7ca8e0394b91aaadc9574df2202c","bb329d880ab54120adaf203a693bb203",11899953,1,11,0,595,193,203,10
"bb329d880ab54120adaf203a693bb203","bb329d880ab54120adaf203a693bb203",11899953,1,0,1,596,203,203,0
"bb329d880ab54120adaf203a693bb203","f9170dd6bc6442b4acd832747609b09a",11899953,1,-4,0,597,203,199,-4
"f9170dd6bc6442b4acd832747609b09a","b54257a550b94ebc9538f3a90eee9d7e",11899953,1,6,0,598,199,204,5
"b54257a550b94ebc9538f3a90eee9d7e","b54257a550b94ebc9538f3a90eee9d7e",11899953,1,0,1,599,204,204,0
"b54257a550b94ebc9538f3a90eee9d7e","f9170dd6bc6442b4acd832747609b09a",11899953,1,-6,0,600,204,199,-5
"f9170dd6bc6442b4acd832747609b09a","c8e371568a0c4391b25796ae4e91952e",11899953,1,-16,0,601,199,186,-13
"c8e371568a0c4391b25796ae4e91952e","334c2344009840079b1d0e1b7ce3d5a7",11899953,1,23,0,604,186,205,19
"334c2344009840079b1d0e1b7ce3d5a7","334c2344009840079b1d0e1b7ce3d5a7",11899953,1,0,1,605,205,205,0
"334c2344009840079b1d0e1b7ce3d5a7","c8e371568a0c4391b25796ae4e91952e",11899953,1,-23,0,606,205,186,-19
"c8e371568a0c4391b25796ae4e91952e","d7f13c8d63ec4e2aa673fbb9cf9c6933",11899953,1,26,0,607,186,206,20
"7108f0e4c2584f1f9c471689ae4c885c","b9e80f77c3a44349863b19875725c384",11899953,1,-1,0,610,208,207,-1
"b9e80f77c3a44349863b19875725c384","b9e80f77c3a44349863b19875725c384",11899953,16,0,1,611,207,207,0
"7108f0e4c2584f1f9c471689ae4c885c","7108f0e4c2584f1f9c471689ae4c885c",11899953,11,0,1,628,208,208,0
"09400e101c5d4b439cf9a26b03aae558","a88efa7e50ce47159810ab553afa6d3a",11899953,1,2,0,642,210,212,2
"a88efa7e50ce47159810ab553afa6d3a","a88efa7e50ce47159810ab553afa6d3a",11899953,5,0,1,643,212,212,0
"a88efa7e50ce47159810ab553afa6d3a","be502a7a43c44bf7b682698de79d9369",11899953,1,3,0,648,212,214,2
"be502a7a43c44bf7b682698de79d9369","f7fb1952f56b4189b86a9f8b7862d2b8",11899953,1,1,0,652,214,215,1
"f7fb1952f56b4189b86a9f8b7862d2b8","f7fb1952f56b4189b86a9f8b7862d2b8",11899953,13,0,1,653,215,215,0
"f7fb1952f56b4189b86a9f8b7862d2b8","b860ee85d8bc4a2f97958cfb71be3533",11899953,1,1,0,666,215,216,1
"b860ee85d8bc4a2f97958cfb71be3533","b860ee85d8bc4a2f97958cfb71be3533",11899953,2,0,1,667,216,216,0
"b860ee85d8bc4a2f97958cfb71be3533","ec341f459285443b8361f7f15638ff08",11899953,1,-3,0,669,216,213,-3
"ec341f459285443b8361f7f15638ff08","363837c182e04711840d896ae1e0339c",11899953,1,6,0,670,213,218,5
"363837c182e04711840d896ae1e0339c","363837c182e04711840d896ae1e0339c",11899953,13,0,1,671,218,218,0
"363837c182e04711840d896ae1e0339c","01b2051f8941460d89945e3b02d1ce78",11899953,1,-1,0,684,218,217,-1
"01b2051f8941460d89945e3b02d1ce78","91125ca626c5470eb145501f8c37f8db",11899953,1,4,0,685,217,220,3
"91125ca626c5470eb145501f8c37f8db","91125ca626c5470eb145501f8c37f8db",11899953,1,0,1,686,220,220,0
"91125ca626c5470eb145501f8c37f8db","1c6721b1f63f4d30ba7746ea8af02a52",11899953,1,3,0,687,220,221,1
"1c6721b1f63f4d30ba7746ea8af02a52","d7f13c8d63ec4e2aa673fbb9cf9c6933",11899953,1,-21,0,688,221,206,-15
"d7f13c8d63ec4e2aa673fbb9cf9c6933","77ecef8eff6b4a2caea7707669bf7475",11899953,1,22,0,689,206,222,16
"77ecef8eff6b4a2caea7707669bf7475","0c7262dff33c4087bc660ccf40f92f9c",11899953,1,-71,0,690,222,169,-53
"0c7262dff33c4087bc660ccf40f92f9c","78adeee1fa2c4fe0bc73f7bca9fcee86",11899953,1,-17,0,691,169,160,-9
"65202579580f4ad38d734b4ee39d22a8","67a089198fcb4e1c8f2385786c2b296f",11899953,1,-157,0,704,164,39,-125
"67a089198fcb4e1c8f2385786c2b296f","1c6721b1f63f4d30ba7746ea8af02a52",11899953,1,239,0,705,39,221,182
"1c6721b1f63f4d30ba7746ea8af02a52","1c6721b1f63f4d30ba7746ea8af02a52",11899953,1,0,1,706,221,221,0
"77ecef8eff6b4a2caea7707669bf7475","77ecef8eff6b4a2caea7707669bf7475",11899953,12,0,1,708,222,222,0
"8b9ae98743bd4d4a8a87dff1c1244211","1c6721b1f63f4d30ba7746ea8af02a52",11899953,1,-7,0,721,227,221,-6
"d03cb855c70044cf8c35d9ec0de696e3","d03cb855c70044cf8c35d9ec0de696e3",11899953,1,0,1,723,224,224,0
"d03cb855c70044cf8c35d9ec0de696e3","a49a937d6896486d9a5396654abcf2e1",11899953,1,2,0,724,224,226,2
"a49a937d6896486d9a5396654abcf2e1","a49a937d6896486d9a5396654abcf2e1",11899953,1,0,1,725,226,226,0
"a49a937d6896486d9a5396654abcf2e1","8b9ae98743bd4d4a8a87dff1c1244211",11899953,1,1,0,726,226,227,1
"8b9ae98743bd4d4a8a87dff1c1244211","8b9ae98743bd4d4a8a87dff1c1244211",11899953,18,0,1,727,227,227,0
"8b9ae98743bd4d4a8a87dff1c1244211","2ab1535aac1346ba8801535bf729ef37",11899953,1,3,0,745,227,229,2
"2ab1535aac1346ba8801535bf729ef37","f7906d6f59b9489a91d2ef40db5a474d",11899953,1,-7,0,746,229,223,-6
"2ab1535aac1346ba8801535bf729ef37","a4f40fb48a8542c8949bae1f002cd9bc",11899953,1,2,0,748,229,231,2
"a4f40fb48a8542c8949bae1f002cd9bc","a4f40fb48a8542c8949bae1f002cd9bc",11899953,2,0,1,749,231,231,0
"a4f40fb48a8542c8949bae1f002cd9bc","8972c23e32044edb8a78fa1eed4e5947",11899953,1,1,0,751,231,232,1
"8972c23e32044edb8a78fa1eed4e5947","8972c23e32044edb8a78fa1eed4e5947",11899953,1,0,1,752,232,232,0
"8972c23e32044edb8a78fa1eed4e5947","92feb4a40f8344d38b6f722e42a53295",11899953,1,1,0,753,232,233,1
"92feb4a40f8344d38b6f722e42a53295","92feb4a40f8344d38b6f722e42a53295",11899953,2,0,1,754,233,233,0
"92feb4a40f8344d38b6f722e42a53295","5152833676bf4c6cb317060be10f68db",11899953,1,-5,0,756,233,228,-5
"5152833676bf4c6cb317060be10f68db","ca3e28f290354c08aefe5b0f769604e6",11899953,1,8,0,757,228,235,7
"ca3e28f290354c08aefe5b0f769604e6","ca3e28f290354c08aefe5b0f769604e6",11899953,9,0,1,758,235,235,0
"ca3e28f290354c08aefe5b0f769604e6","79a35eea833e4c2c9d22fc53c3c6445c",11899953,1,1,0,767,235,236,1
"79a35eea833e4c2c9d22fc53c3c6445c","79a35eea833e4c2c9d22fc53c3c6445c",11899953,9,0,1,768,236,236,0
"79a35eea833e4c2c9d22fc53c3c6445c","8f68228b1518449e9615cdafee41a2bd",11899953,1,1,0,777,236,237,1
"8f68228b1518449e9615cdafee41a2bd","8f68228b1518449e9615cdafee41a2bd",11899953,1,0,1,778,237,237,0
"8f68228b1518449e9615cdafee41a2bd","cab89fa5c3ed45a5aa550fc0352d6a42",11899953,1,1,0,779,237,238,1
"cab89fa5c3ed45a5aa550fc0352d6a42","cab89fa5c3ed45a5aa550fc0352d6a42",11899953,3,0,1,780,238,238,0
"cab89fa5c3ed45a5aa550fc0352d6a42","1c6721b1f63f4d30ba7746ea8af02a52",11899953,1,-20,0,783,238,221,-17
"1c6721b1f63f4d30ba7746ea8af02a52","64dbedb3ce544f6aae8e10e0cf10f16d",11899953,1,23,0,786,221,240,19
"64dbedb3ce544f6aae8e10e0cf10f16d","66d4fad4f1cf4b46be0750a99ad7a35a",11899953,1,-2,0,787,240,239,-1
"66d4fad4f1cf4b46be0750a99ad7a35a","66d4fad4f1cf4b46be0750a99ad7a35a",11899953,1,0,1,788,239,239,0
"66d4fad4f1cf4b46be0750a99ad7a35a","0b04c8e2f86d48c7aeb7e225819cd32b",11899953,1,-5,0,789,239,234,-5
"0b04c8e2f86d48c7aeb7e225819cd32b","1c6721b1f63f4d30ba7746ea8af02a52",11899953,1,-16,0,790,234,221,-13
"1c6721b1f63f4d30ba7746ea8af02a52","f53da5fd9bfe412da4b80d4742563b6c",11899953,1,24,0,793,221,241,20
"f53da5fd9bfe412da4b80d4742563b6c","f53da5fd9bfe412da4b80d4742563b6c",11899953,1,0,1,794,241,241,0
"f53da5fd9bfe412da4b80d4742563b6c","1c6721b1f63f4d30ba7746ea8af02a52",11899953,1,-24,0,795,241,221,-20
"1c6721b1f63f4d30ba7746ea8af02a52","2ae94c0cea4d480a9d5dca8fb1d7b542",11899953,1,27,0,796,221,242,21
"1ebf23f9d994469a85206e4c7b1bf5f5","1ebf23f9d994469a85206e4c7b1bf5f5",11899953,10,0,1,798,245,245,0
"1ebf23f9d994469a85206e4c7b1bf5f5","85ae675b83e8422da842cfd25596af99",11899953,1,1,0,808,245,246,1
"85ae675b83e8422da842cfd25596af99","85ae675b83e8422da842cfd25596af99",11899953,1,0,1,809,246,246,0
"85ae675b83e8422da842cfd25596af99","2ae94c0cea4d480a9d5dca8fb1d7b542",11899953,1,-4,0,810,246,242,-4
"2ae94c0cea4d480a9d5dca8fb1d7b542","fa235f0f364d47e4ae1c87f47bf8e6ba",11899953,1,12,0,811,242,252,10
"fa235f0f364d47e4ae1c87f47bf8e6ba","fa235f0f364d47e4ae1c87f47bf8e6ba",11899953,1,0,1,812,252,252,0
"fa235f0f364d47e4ae1c87f47bf8e6ba","79f7845465cc4ed19d8e4f1429541be0",11899953,1,2,0,813,252,254,2
"79f7845465cc4ed19d8e4f1429541be0","79f7845465cc4ed19d8e4f1429541be0",11899953,2,0,1,814,254,254,0
"79f7845465cc4ed19d8e4f1429541be0","00f61990949545828dd12f1303d47504",11899953,1,3,0,816,254,256,2
"00f61990949545828dd12f1303d47504","ead7bb4b64e247d2ae632ab8a296b091",11899953,1,2,0,819,256,258,2
"ead7bb4b64e247d2ae632ab8a296b091","ead7bb4b64e247d2ae632ab8a296b091",11899953,2,0,1,820,258,258,0
"ead7bb4b64e247d2ae632ab8a296b091","41b0048dde734bb280bac6116baa8e27",11899953,1,1,0,822,258,259,1
"41b0048dde734bb280bac6116baa8e27","41b0048dde734bb280bac6116baa8e27",11899953,2,0,1,823,259,259,0
"41b0048dde734bb280bac6116baa8e27","b41c5a094a604ee0915327da5cc0beb7",11899953,1,1,0,825,259,260,1
"b41c5a094a604ee0915327da5cc0beb7","b41c5a094a604ee0915327da5cc0beb7",11899953,2,0,1,826,260,260,0
"b41c5a094a604ee0915327da5cc0beb7","d546341988904f069cfa86b21457d9d9",11899953,1,-10,0,828,260,251,-9
"d546341988904f069cfa86b21457d9d9","28c171777c52431ab6b925073bd63d46",11899953,1,15,0,829,251,264,13
"28c171777c52431ab6b925073bd63d46","28c171777c52431ab6b925073bd63d46",11899953,3,0,1,830,264,264,0
"28c171777c52431ab6b925073bd63d46","ac160db940cb49ae8579162b1d52bb5d",11899953,1,2,0,833,264,266,2
"ac160db940cb49ae8579162b1d52bb5d","ac160db940cb49ae8579162b1d52bb5d",11899953,7,0,1,834,266,266,0
"ac160db940cb49ae8579162b1d52bb5d","d989ebcfc12a4b669f0100dc1aa14f1e",11899953,1,-12,0,841,266,255,-11
"d989ebcfc12a4b669f0100dc1aa14f1e","c6fd49b485cc4874b0bbdd9c6171e09c",11899953,1,15,0,842,255,268,13
"c6fd49b485cc4874b0bbdd9c6171e09c","c6fd49b485cc4874b0bbdd9c6171e09c",11899953,3,0,1,843,268,268,0
"c6fd49b485cc4874b0bbdd9c6171e09c","44240778a97c4af0937817499b75707b",11899953,1,1,0,846,268,269,1
"44240778a97c4af0937817499b75707b","44240778a97c4af0937817499b75707b",11899953,2,0,1,847,269,269,0
"44240778a97c4af0937817499b75707b","7aa76d3e993840d8805f097cbdbcd44b",11899953,1,-9,0,849,269,261,-8
"7aa76d3e993840d8805f097cbdbcd44b","865a4d3b43374da7944dc7d397f566d9",11899953,1,12,0,850,261,271,10
"865a4d3b43374da7944dc7d397f566d9","865a4d3b43374da7944dc7d397f566d9",11899953,1,0,1,851,271,271,0
"865a4d3b43374da7944dc7d397f566d9","2ae94c0cea4d480a9d5dca8fb1d7b542",11899953,1,-35,0,852,271,242,-29
"2ae94c0cea4d480a9d5dca8fb1d7b542","0d987bed3ffa4ed0b9a2e62e97b7b30f",11899953,1,38,0,853,242,272,30
"0d987bed3ffa4ed0b9a2e62e97b7b30f","0d987bed3ffa4ed0b9a2e62e97b7b30f",11899953,2,0,1,854,272,272,0
"0d987bed3ffa4ed0b9a2e62e97b7b30f","82ae07bc0c9b4570a41799290d1ef399",11899953,1,4,0,856,272,275,3
"82ae07bc0c9b4570a41799290d1ef399","0d987bed3ffa4ed0b9a2e62e97b7b30f",11899953,1,-4,0,857,275,272,-3
"bb5a47f5ea01454a8b79455422d3b9da","82ae07bc0c9b4570a41799290d1ef399",11899953,1,-6,0,864,280,275,-5
"82ae07bc0c9b4570a41799290d1ef399","bb5a47f5ea01454a8b79455422d3b9da",11899953,2,6,0,865,275,280,5
"bb5a47f5ea01454a8b79455422d3b9da","bc5524e78a8544e2ae2fdc2f3462bbec",11899953,2,-1,0,867,280,279,-1
"bc5524e78a8544e2ae2fdc2f3462bbec","82ae07bc0c9b4570a41799290d1ef399",11899953,1,-5,0,868,279,275,-4
"bb5a47f5ea01454a8b79455422d3b9da","94cecc3f1e7d484b8e068e79241dfd73",11899953,1,3,0,940,280,281,1
"94cecc3f1e7d484b8e068e79241dfd73","0d987bed3ffa4ed0b9a2e62e97b7b30f",11899953,1,-13,0,941,281,272,-9
"0d987bed3ffa4ed0b9a2e62e97b7b30f","a37477c4e4c14169ad44b06b493007f6",11899953,1,15,0,942,272,283,11
"a37477c4e4c14169ad44b06b493007f6","fab84b4fab5940efb4ea868ef8d09396",11899953,1,3,0,943,283,284,1
"fab84b4fab5940efb4ea868ef8d09396","94cecc3f1e7d484b8e068e79241dfd73",11899953,1,-5,0,944,284,281,-3
"94cecc3f1e7d484b8e068e79241dfd73","fab84b4fab5940efb4ea868ef8d09396",11899953,1,5,0,945,281,284,3
"fab84b4fab5940efb4ea868ef8d09396","fab84b4fab5940efb4ea868ef8d09396",11899953,1,0,1,946,284,284,0
"fab84b4fab5940efb4ea868ef8d09396","0c7262dff33c4087bc660ccf40f92f9c",11899953,1,-153,0,947,284,169,-115
"0c7262dff33c4087bc660ccf40f92f9c","c8e371568a0c4391b25796ae4e91952e",11899953,1,23,0,948,169,186,17
"208c9b2796c944db8dacaa96082520ea","208c9b2796c944db8dacaa96082520ea",11899953,1,0,1,954,288,288,0
"4a29443515bb404cb8924e1c60a63b73","7669a956527947d0add87455277e80b4",11899953,1,7,0,956,285,291,6
"7669a956527947d0add87455277e80b4","7669a956527947d0add87455277e80b4",11899953,1,0,1,957,291,291,0
"7669a956527947d0add87455277e80b4","869e967078f04da18dd0b0b9389a7424",11899953,1,3,0,958,291,293,2
"869e967078f04da18dd0b0b9389a7424","6a9a3b5bde4a48daa896fe8c06eca56f",11899953,1,-5,0,959,293,289,-4
"869e967078f04da18dd0b0b9389a7424","51ab6291537748fab90d519aa09889d6",11899953,1,2,0,961,293,295,2
"51ab6291537748fab90d519aa09889d6","51ab6291537748fab90d519aa09889d6",11899953,5,0,1,962,295,295,0
"51ab6291537748fab90d519aa09889d6","34a6e49023fc4465bd5ca604330bbd1c",11899953,1,-3,0,967,295,292,-3
"ba0e59461bfb4a44b7b1c28a01f8d3b3","21592f2a9e9c4b2f8c66ec5dbcbf6a2b",11899953,1,-4,0,969,299,296,-3
"ba0e59461bfb4a44b7b1c28a01f8d3b3","0e0b36e731a645e7b1b8a88f5031ca38",11899953,1,2,0,971,299,301,2
"0e0b36e731a645e7b1b8a88f5031ca38","0e0b36e731a645e7b1b8a88f5031ca38",11899953,2,0,1,972,301,301,0
"0e0b36e731a645e7b1b8a88f5031ca38","a66a144637284c21afc6de17fea4bfb8",11899953,1,1,0,974,301,302,1
"a66a144637284c21afc6de17fea4bfb8","a66a144637284c21afc6de17fea4bfb8",11899953,2,0,1,975,302,302,0
"a66a144637284c21afc6de17fea4bfb8","7646a919d7e64fa990bca9b024ff089d",11899953,1,-4,0,977,302,298,-4
"7646a919d7e64fa990bca9b024ff089d","4a29443515bb404cb8924e1c60a63b73",11899953,1,-17,0,978,298,285,-13
"208c9b2796c944db8dacaa96082520ea","ba0e59461bfb4a44b7b1c28a01f8d3b3",11899953,1,15,0,980,288,299,11
"ba0e59461bfb4a44b7b1c28a01f8d3b3","4a29443515bb404cb8924e1c60a63b73",11899953,1,-18,0,981,299,285,-14
"4a29443515bb404cb8924e1c60a63b73","7646a919d7e64fa990bca9b024ff089d",11899953,1,17,0,982,285,298,13
"7646a919d7e64fa990bca9b024ff089d","e390b575229748ea8aac9364efe2bf00",11899953,1,7,0,983,298,304,6
"e390b575229748ea8aac9364efe2bf00","e390b575229748ea8aac9364efe2bf00",11899953,1,0,1,984,304,304,0
"e390b575229748ea8aac9364efe2bf00","4a29443515bb404cb8924e1c60a63b73",11899953,1,-24,0,985,304,285,-19
"4a29443515bb404cb8924e1c60a63b73","3434c10e561d488a914e0f7d71907abd",11899953,1,27,0,986,285,305,20
"53e7e900392747ccad52e711ab0f80d8","53e7e900392747ccad52e711ab0f80d8",11899953,1,0,1,994,307,307,0
"53e7e900392747ccad52e711ab0f80d8","130acc2aeb0448fdbb2de63bc5cebe5b",11899953,1,3,0,995,307,309,2
"130acc2aeb0448fdbb2de63bc5cebe5b","3434c10e561d488a914e0f7d71907abd",11899953,1,-5,0,996,309,305,-4
"3434c10e561d488a914e0f7d71907abd","130acc2aeb0448fdbb2de63bc5cebe5b",11899953,1,5,0,997,305,309,4
"130acc2aeb0448fdbb2de63bc5cebe5b","9c062b3251034ebe90f5054e2a3b5120",11899953,1,2,0,998,309,311,2
"9c062b3251034ebe90f5054e2a3b5120","9c062b3251034ebe90f5054e2a3b5120",11899953,2,0,1,1000,311,311,0
"9c062b3251034ebe90f5054e2a3b5120","ea859f8207e44537889daeaba13ac2e8",11899953,1,1,0,1001,311,312,1
"ea859f8207e44537889daeaba13ac2e8","ea859f8207e44537889daeaba13ac2e8",11899953,1,0,1,1002,312,312,0
"ea859f8207e44537889daeaba13ac2e8","56d94971a7a94257aa330183a8ebd0ea",11899953,1,1,0,1003,312,313,1
"56d94971a7a94257aa330183a8ebd0ea","56d94971a7a94257aa330183a8ebd0ea",11899953,1,0,1,1004,313,313,0
"56d94971a7a94257aa330183a8ebd0ea","141c0df6cd1946539aadd1c9b7068cd4",11899953,1,-5,0,1005,313,308,-5
"141c0df6cd1946539aadd1c9b7068cd4","13255e63e0aa4abf85e5211bf613d43e",11899953,1,10,0,1006,308,317,9
"13255e63e0aa4abf85e5211bf613d43e","13255e63e0aa4abf85e5211bf613d43e",11899953,1,0,1,1007,317,317,0
"13255e63e0aa4abf85e5211bf613d43e","0c787d16c9504873b1a4d903cec09948",11899953,1,-3,0,1008,317,314,-3
"0c787d16c9504873b1a4d903cec09948","86c27d40179e419c8e9d150fb6afa5d0",11899953,1,6,0,1009,314,319,5
"86c27d40179e419c8e9d150fb6afa5d0","86c27d40179e419c8e9d150fb6afa5d0",11899953,1,0,1,1010,319,319,0
"86c27d40179e419c8e9d150fb6afa5d0","47edbb64109243e6b0f8f64cdef90c6c",11899953,1,8,0,1011,319,326,7
"47edbb64109243e6b0f8f64cdef90c6c","8d7e0b55cf9849cda222a0f2440cec55",11899953,1,-9,0,1012,326,318,-8
"8d7e0b55cf9849cda222a0f2440cec55","24f1363179ad4aaa965484a78471912b",11899953,2,6,0,1013,318,323,5
"24f1363179ad4aaa965484a78471912b","3628bdce1dd2429ba924d2d4d09448d2",11899953,2,-1,0,1014,323,322,-1
"3628bdce1dd2429ba924d2d4d09448d2","24f1363179ad4aaa965484a78471912b",11899953,1,1,0,1015,322,323,1
"24f1363179ad4aaa965484a78471912b","86c27d40179e419c8e9d150fb6afa5d0",11899953,1,-5,0,1016,323,319,-4
"86c27d40179e419c8e9d150fb6afa5d0","3434c10e561d488a914e0f7d71907abd",11899953,1,-17,0,1017,319,305,-14
"3434c10e561d488a914e0f7d71907abd","53e7e900392747ccad52e711ab0f80d8",11899953,6,2,0,1018,305,307,2
"53e7e900392747ccad52e711ab0f80d8","3434c10e561d488a914e0f7d71907abd",11899953,5,-2,0,1019,307,305,-2
"3434c10e561d488a914e0f7d71907abd","86c27d40179e419c8e9d150fb6afa5d0",11899953,1,17,0,1020,305,319,14
"86c27d40179e419c8e9d150fb6afa5d0","8d7e0b55cf9849cda222a0f2440cec55",11899953,1,-1,0,1021,319,318,-1
"24f1363179ad4aaa965484a78471912b","47edbb64109243e6b0f8f64cdef90c6c",11899953,1,3,0,1023,323,326,3
"47edbb64109243e6b0f8f64cdef90c6c","24f1363179ad4aaa965484a78471912b",11899953,1,-3,0,1024,326,323,-3
"24f1363179ad4aaa965484a78471912b","24f1363179ad4aaa965484a78471912b",11899953,1,0,1,1025,323,323,0
"3628bdce1dd2429ba924d2d4d09448d2","3434c10e561d488a914e0f7d71907abd",11899953,1,-21,0,1027,322,305,-17
"3434c10e561d488a914e0f7d71907abd","56b3fd1a212a4764be39d979fde3326e",11899953,1,28,0,1030,305,328,23
"56b3fd1a212a4764be39d979fde3326e","56b3fd1a212a4764be39d979fde3326e",11899953,1,0,1,1031,328,328,0
"56b3fd1a212a4764be39d979fde3326e","3434c10e561d488a914e0f7d71907abd",11899953,1,-28,0,1032,328,305,-23
"3434c10e561d488a914e0f7d71907abd","0c4079457ede49e3aeb5e86ed84bdf35",11899953,1,31,0,1033,305,329,24
"0c4079457ede49e3aeb5e86ed84bdf35","38aea304b4fa46e1b29bb72f5cea4c93",11899953,3,2,0,1034,329,331,2
"38aea304b4fa46e1b29bb72f5cea4c93","38aea304b4fa46e1b29bb72f5cea4c93",11899953,2,0,1,1035,331,331,0
"38aea304b4fa46e1b29bb72f5cea4c93","e36d261332f14e79bb4b467aceaeb9b5",11899953,1,2,0,1036,331,333,2
"e36d261332f14e79bb4b467aceaeb9b5","e36d261332f14e79bb4b467aceaeb9b5",11899953,1,0,1,1037,333,333,0
"e36d261332f14e79bb4b467aceaeb9b5","c7e89b9d04744d2eab742fc24e3ef1ae",11899953,1,1,0,1038,333,334,1
"c7e89b9d04744d2eab742fc24e3ef1ae","c7e89b9d04744d2eab742fc24e3ef1ae",11899953,2,0,1,1039,334,334,0
"c7e89b9d04744d2eab742fc24e3ef1ae","fe49f8054b374a0ea4bb266ed135ff62",11899953,1,1,0,1041,334,335,1
"fe49f8054b374a0ea4bb266ed135ff62","fe49f8054b374a0ea4bb266ed135ff62",11899953,2,0,1,1042,335,335,0
"fe49f8054b374a0ea4bb266ed135ff62","d0a8f74af98642fe8360d22c42e45117",11899953,1,1,0,1044,335,336,1
"d0a8f74af98642fe8360d22c42e45117","d0a8f74af98642fe8360d22c42e45117",11899953,2,0,1,1045,336,336,0
"d0a8f74af98642fe8360d22c42e45117","0c4079457ede49e3aeb5e86ed84bdf35",11899953,1,-7,0,1047,336,329,-7
"0c4079457ede49e3aeb5e86ed84bdf35","a7c6339ca1da4368a18d471f0519f877",11899953,1,11,0,1048,329,339,10
"a7c6339ca1da4368a18d471f0519f877","a7c6339ca1da4368a18d471f0519f877",11899953,1,0,1,1049,339,339,0
"a7c6339ca1da4368a18d471f0519f877","b8b9418ab322418d9db9b40d96af873a",11899953,1,-2,0,1050,339,337,-2
"b8b9418ab322418d9db9b40d96af873a","bbc5139ca9024389a94db3a6f47dcff6",11899953,1,5,0,1051,337,341,4
"bbc5139ca9024389a94db3a6f47dcff6","bbc5139ca9024389a94db3a6f47dcff6",11899953,2,0,1,1052,341,341,0
"bbc5139ca9024389a94db3a6f47dcff6","4ee6ca9019ab4a1ab323f98094a9bd77",11899953,1,2,0,1054,341,343,2
"4ee6ca9019ab4a1ab323f98094a9bd77","4ee6ca9019ab4a1ab323f98094a9bd77",11899953,2,0,1,1055,343,343,0
"4ee6ca9019ab4a1ab323f98094a9bd77","b37947176785476f8b29d49a851366dc",11899953,1,1,0,1057,343,344,1
"b37947176785476f8b29d49a851366dc","b37947176785476f8b29d49a851366dc",11899953,2,0,1,1058,344,344,0
"b37947176785476f8b29d49a851366dc","fcea5b10d5a14a3b9324ffece8f6e1e5",11899953,1,1,0,1060,344,345,1
"fcea5b10d5a14a3b9324ffece8f6e1e5","fcea5b10d5a14a3b9324ffece8f6e1e5",11899953,2,0,1,1061,345,345,0
"fcea5b10d5a14a3b9324ffece8f6e1e5","c2490bc612d146edbe786556fab3651b",11899953,1,-5,0,1063,345,340,-5
"c2490bc612d146edbe786556fab3651b","0c4079457ede49e3aeb5e86ed84bdf35",11899953,1,-13,0,1064,340,329,-11
"38aea304b4fa46e1b29bb72f5cea4c93","0c4079457ede49e3aeb5e86ed84bdf35",11899953,1,-2,0,1066,331,329,-2
"0c4079457ede49e3aeb5e86ed84bdf35","6ac8bb048b854999a47edb35fe627f11",11899953,1,21,0,1067,329,347,18
"6ac8bb048b854999a47edb35fe627f11","6ac8bb048b854999a47edb35fe627f11",11899953,1,0,1,1068,347,347,0
"6ac8bb048b854999a47edb35fe627f11","0c4079457ede49e3aeb5e86ed84bdf35",11899953,1,-21,0,1069,347,329,-18
"0c4079457ede49e3aeb5e86ed84bdf35","30ead9794d4847abaf222ca966cc8630",11899953,1,24,0,1070,329,348,19
"30ead9794d4847abaf222ca966cc8630","c20993c944444fe085345591a8bd837e",11899953,1,3,0,1071,348,351,3
"c20993c944444fe085345591a8bd837e","eff0de7f2dbb42dfa1a2e686efab5b6d",11899953,1,3,0,1072,351,354,3
"eff0de7f2dbb42dfa1a2e686efab5b6d","09b9678ddc3d452ea4a3d46e15826065",11899953,3,-1,0,1073,354,353,-1
"09b9678ddc3d452ea4a3d46e15826065","897b7f51242c44aab2205c72fdcbf4cd",11899953,4,-1,0,1074,353,352,-1
"897b7f51242c44aab2205c72fdcbf4cd","30ead9794d4847abaf222ca966cc8630",11899953,1,-4,0,1075,352,348,-4
"30ead9794d4847abaf222ca966cc8630","09b9678ddc3d452ea4a3d46e15826065",11899953,3,5,0,1076,348,353,5
"897b7f51242c44aab2205c72fdcbf4cd","eff0de7f2dbb42dfa1a2e686efab5b6d",11899953,4,2,0,1078,352,354,2
"eff0de7f2dbb42dfa1a2e686efab5b6d","c20993c944444fe085345591a8bd837e",11899953,3,-3,0,1079,354,351,-3
"c20993c944444fe085345591a8bd837e","bc5524e78a8544e2ae2fdc2f3462bbec",11899953,1,-98,0,1080,351,279,-72
"bc5524e78a8544e2ae2fdc2f3462bbec","0d987bed3ffa4ed0b9a2e62e97b7b30f",11899953,3,-9,0,1081,279,272,-7
"0d987bed3ffa4ed0b9a2e62e97b7b30f","bb5a47f5ea01454a8b79455422d3b9da",11899953,3,10,0,1082,272,280,8
"bb5a47f5ea01454a8b79455422d3b9da","bb5a47f5ea01454a8b79455422d3b9da",11899953,87,0,1,1083,280,280,0
"bb5a47f5ea01454a8b79455422d3b9da","0c7262dff33c4087bc660ccf40f92f9c",11899953,1,-145,0,1092,280,169,-111
"0c7262dff33c4087bc660ccf40f92f9c","30ead9794d4847abaf222ca966cc8630",11899953,1,239,0,1093,169,348,179
"30ead9794d4847abaf222ca966cc8630","30ead9794d4847abaf222ca966cc8630",11899953,2,0,1,1094,348,348,0
"09b9678ddc3d452ea4a3d46e15826065","eff0de7f2dbb42dfa1a2e686efab5b6d",11899953,3,1,0,1096,353,354,1
"c20993c944444fe085345591a8bd837e","897b7f51242c44aab2205c72fdcbf4cd",11899953,1,1,0,1098,351,352,1
"897b7f51242c44aab2205c72fdcbf4cd","897b7f51242c44aab2205c72fdcbf4cd",11899953,8,0,1,1099,352,352,0
"897b7f51242c44aab2205c72fdcbf4cd","09b9678ddc3d452ea4a3d46e15826065",11899953,1,1,0,1103,352,353,1
"09b9678ddc3d452ea4a3d46e15826065","09b9678ddc3d452ea4a3d46e15826065",11899953,6,0,1,1104,353,353,0
"eff0de7f2dbb42dfa1a2e686efab5b6d","eff0de7f2dbb42dfa1a2e686efab5b6d",11899953,7,0,1,1108,354,354,0
"eff0de7f2dbb42dfa1a2e686efab5b6d","30ead9794d4847abaf222ca966cc8630",11899953,2,-6,0,1111,354,348,-6
"30ead9794d4847abaf222ca966cc8630","2fe14166dc9642c3bc666b86a57f943d",11899953,2,10,0,1112,348,357,9
"2fe14166dc9642c3bc666b86a57f943d","2fe14166dc9642c3bc666b86a57f943d",11899953,1,0,1,1113,357,357,0
"2fe14166dc9642c3bc666b86a57f943d","44421dd1e13a47a388c4a19834b744c7",11899953,1,2,0,1114,357,359,2
"44421dd1e13a47a388c4a19834b744c7","44421dd1e13a47a388c4a19834b744c7",11899953,2,0,1,1115,359,359,0
"44421dd1e13a47a388c4a19834b744c7","cb5fc7ef85d547c4be1a7439d0bf6052",11899953,1,1,0,1117,359,360,1
"cb5fc7ef85d547c4be1a7439d0bf6052","cb5fc7ef85d547c4be1a7439d0bf6052",11899953,2,0,1,1118,360,360,0
"cb5fc7ef85d547c4be1a7439d0bf6052","0a8f150a4cf747acbde62f4721823da3",11899953,1,1,0,1120,360,361,1
"0a8f150a4cf747acbde62f4721823da3","0a8f150a4cf747acbde62f4721823da3",11899953,2,0,1,1121,361,361,0
"0a8f150a4cf747acbde62f4721823da3","ab8fdad974ae471f9f24c3f9dd04462e",11899953,1,1,0,1123,361,362,1
"ab8fdad974ae471f9f24c3f9dd04462e","ab8fdad974ae471f9f24c3f9dd04462e",11899953,2,0,1,1124,362,362,0
"ab8fdad974ae471f9f24c3f9dd04462e","1ba8fef685d74a8194b9db252eb704fb",11899953,1,-7,0,1126,362,355,-7
"1ba8fef685d74a8194b9db252eb704fb","52580888dadb4fe3baa795683ea227bd",11899953,1,10,0,1127,355,364,9
"52580888dadb4fe3baa795683ea227bd","52580888dadb4fe3baa795683ea227bd",11899953,1,0,1,1128,364,364,0
"52580888dadb4fe3baa795683ea227bd","f00179e251a045b39c3f7a54f9aa4acc",11899953,1,-1,0,1129,364,363,-1
"f00179e251a045b39c3f7a54f9aa4acc","492a3bc6a1254f23a7998587961b22a4",11899953,1,4,0,1130,363,366,3
"492a3bc6a1254f23a7998587961b22a4","492a3bc6a1254f23a7998587961b22a4",11899953,1,0,1,1131,366,366,0
"492a3bc6a1254f23a7998587961b22a4","072a190fd302456290895f9f04d6940a",11899953,1,-1,0,1132,366,365,-1
"072a190fd302456290895f9f04d6940a","cfa457d1743848e4bb5e4beced6448ed",11899953,2,5,0,1133,365,369,4
"cfa457d1743848e4bb5e4beced6448ed","897b7f51242c44aab2205c72fdcbf4cd",11899953,2,-21,0,1134,369,352,-17
"897b7f51242c44aab2205c72fdcbf4cd","c76574d21bc14aeea7ecd0b027f39858",11899953,2,19,0,1137,352,367,15
"c76574d21bc14aeea7ecd0b027f39858","09b9678ddc3d452ea4a3d46e15826065",11899953,1,-18,0,1138,367,353,-14
"09b9678ddc3d452ea4a3d46e15826065","c20993c944444fe085345591a8bd837e",11899953,2,-2,0,1140,353,351,-2
"c20993c944444fe085345591a8bd837e","09b9678ddc3d452ea4a3d46e15826065",11899953,2,2,0,1141,351,353,2
"2fe14166dc9642c3bc666b86a57f943d","1ba8fef685d74a8194b9db252eb704fb",11899953,1,-2,0,1147,357,355,-2
"1ba8fef685d74a8194b9db252eb704fb","2fe14166dc9642c3bc666b86a57f943d",11899953,1,2,0,1148,355,357,2
"2fe14166dc9642c3bc666b86a57f943d","c76574d21bc14aeea7ecd0b027f39858",11899953,1,13,0,1149,357,367,10
"c76574d21bc14aeea7ecd0b027f39858","1ba8fef685d74a8194b9db252eb704fb",11899953,1,-15,0,1150,367,355,-12
"1ba8fef685d74a8194b9db252eb704fb","492a3bc6a1254f23a7998587961b22a4",11899953,1,13,0,1151,355,366,11
"492a3bc6a1254f23a7998587961b22a4","c76574d21bc14aeea7ecd0b027f39858",11899953,1,2,0,1152,366,367,1
"c76574d21bc14aeea7ecd0b027f39858","072a190fd302456290895f9f04d6940a",11899953,1,-3,0,1153,367,365,-2
"c76574d21bc14aeea7ecd0b027f39858","eff0de7f2dbb42dfa1a2e686efab5b6d",11899953,1,-17,0,1158,367,354,-13
"09b9678ddc3d452ea4a3d46e15826065","30ead9794d4847abaf222ca966cc8630",11899953,1,-5,0,1166,353,348,-5
"eff0de7f2dbb42dfa1a2e686efab5b6d","897b7f51242c44aab2205c72fdcbf4cd",11899953,1,-2,0,1173,354,352,-2
"c20993c944444fe085345591a8bd837e","30ead9794d4847abaf222ca966cc8630",11899953,1,-3,0,1178,351,348,-3
"30ead9794d4847abaf222ca966cc8630","cfa457d1743848e4bb5e4beced6448ed",11899953,1,25,0,1179,348,369,21
"cfa457d1743848e4bb5e4beced6448ed","cfa457d1743848e4bb5e4beced6448ed",11899953,1,0,1,1180,369,369,0
"cfa457d1743848e4bb5e4beced6448ed","30ead9794d4847abaf222ca966cc8630",11899953,1,-25,0,1181,369,348,-21
"30ead9794d4847abaf222ca966cc8630","b71bac264efb4abd97015447bd490db6",11899953,1,28,0,1182,348,370,22
"b71bac264efb4abd97015447bd490db6","8d448d625b024c82a5eb240bbd7431d6",11899953,4,5,0,1183,370,374,4
"8d448d625b024c82a5eb240bbd7431d6","8d448d625b024c82a5eb240bbd7431d6",11899953,76,0,1,1184,374,374,0
"8d448d625b024c82a5eb240bbd7431d6","b71bac264efb4abd97015447bd490db6",11899953,3,-5,0,1188,374,370,-4
"8d448d625b024c82a5eb240bbd7431d6","1b4550d0dab04078b3bf08a655345bdc",11899953,1,-1,0,1192,374,373,-1
"1b4550d0dab04078b3bf08a655345bdc","8d448d625b024c82a5eb240bbd7431d6",11899953,1,1,0,1193,373,374,1
"b71bac264efb4abd97015447bd490db6","d6d02b6ef04e4f17805504500b8ce441",11899953,4,8,0,1246,370,375,5
"d6d02b6ef04e4f17805504500b8ce441","d6d02b6ef04e4f17805504500b8ce441",11899953,26,0,1,1247,375,375,0
"d6d02b6ef04e4f17805504500b8ce441","07b44a7a51e94c78b411c753fc39dab0",11899953,1,-248,0,1249,375,189,-186
"07b44a7a51e94c78b411c753fc39dab0","c8e371568a0c4391b25796ae4e91952e",11899953,2,-4,0,1250,189,186,-3
"c8e371568a0c4391b25796ae4e91952e","ab11d94c6c8948ea90b88f19d2cd502b",11899953,5,5,0,1251,186,190,4
"ab11d94c6c8948ea90b88f19d2cd502b","07b44a7a51e94c78b411c753fc39dab0",11899953,3,-1,0,1252,190,189,-1
"07b44a7a51e94c78b411c753fc39dab0","6cd2dcaac46847d4a0bc53f296d90375",11899953,3,6,0,1253,189,194,5
"6cd2dcaac46847d4a0bc53f296d90375","017d7ca8e0394b91aaadc9574df2202c",11899953,2,-1,0,1254,194,193,-1
"017d7ca8e0394b91aaadc9574df2202c","ab11d94c6c8948ea90b88f19d2cd502b",11899953,1,-4,0,1255,193,190,-3
"ab11d94c6c8948ea90b88f19d2cd502b","f992451ed6ad4e68bb9e68ad6be7c4be",11899953,2,2,0,1256,190,192,2
"f992451ed6ad4e68bb9e68ad6be7c4be","6cd2dcaac46847d4a0bc53f296d90375",11899953,2,3,0,1257,192,194,2
"6cd2dcaac46847d4a0bc53f296d90375","07b44a7a51e94c78b411c753fc39dab0",11899953,2,-6,0,1258,194,189,-5
"07b44a7a51e94c78b411c753fc39dab0","ab11d94c6c8948ea90b88f19d2cd502b",11899953,1,1,0,1259,189,190,1
"ab11d94c6c8948ea90b88f19d2cd502b","017d7ca8e0394b91aaadc9574df2202c",11899953,1,4,0,1260,190,193,3
"017d7ca8e0394b91aaadc9574df2202c","c8e371568a0c4391b25796ae4e91952e",11899953,1,-9,0,1261,193,186,-7
"07b44a7a51e94c78b411c753fc39dab0","07b44a7a51e94c78b411c753fc39dab0",11899953,4,0,1,1264,189,189,0
"ab11d94c6c8948ea90b88f19d2cd502b","0c7262dff33c4087bc660ccf40f92f9c",11899953,1,-28,0,1270,190,169,-21
"0c7262dff33c4087bc660ccf40f92f9c","a875096404ef4a9984b62d74cda916f9",11899953,1,53,0,1271,169,209,40
"a875096404ef4a9984b62d74cda916f9","d7f13c8d63ec4e2aa673fbb9cf9c6933",11899953,1,-4,0,1272,209,206,-3
"d7f13c8d63ec4e2aa673fbb9cf9c6933","09400e101c5d4b439cf9a26b03aae558",11899953,3,5,0,1273,206,210,4
"09400e101c5d4b439cf9a26b03aae558","a875096404ef4a9984b62d74cda916f9",11899953,2,-1,0,1274,210,209,-1
"a875096404ef4a9984b62d74cda916f9","a875096404ef4a9984b62d74cda916f9",11899953,1,0,1,1275,209,209,0
"a875096404ef4a9984b62d74cda916f9","a88efa7e50ce47159810ab553afa6d3a",11899953,1,3,0,1276,209,212,3
"a88efa7e50ce47159810ab553afa6d3a","a875096404ef4a9984b62d74cda916f9",11899953,1,-3,0,1277,212,209,-3
"a875096404ef4a9984b62d74cda916f9","f7fb1952f56b4189b86a9f8b7862d2b8",11899953,3,7,0,1278,209,215,6
"f7fb1952f56b4189b86a9f8b7862d2b8","be502a7a43c44bf7b682698de79d9369",11899953,2,-1,0,1279,215,214,-1
"be502a7a43c44bf7b682698de79d9369","ec341f459285443b8361f7f15638ff08",11899953,1,-1,0,1280,214,213,-1
"ec341f459285443b8361f7f15638ff08","d7f13c8d63ec4e2aa673fbb9cf9c6933",11899953,1,-9,0,1281,213,206,-7
"d7f13c8d63ec4e2aa673fbb9cf9c6933","b9e80f77c3a44349863b19875725c384",11899953,2,1,0,1282,206,207,1
"b9e80f77c3a44349863b19875725c384","7108f0e4c2584f1f9c471689ae4c885c",11899953,5,1,0,1283,207,208,1
"7108f0e4c2584f1f9c471689ae4c885c","09400e101c5d4b439cf9a26b03aae558",11899953,1,3,0,1284,208,210,2
"09400e101c5d4b439cf9a26b03aae558","09400e101c5d4b439cf9a26b03aae558",11899953,3,0,1,1285,210,210,0
"09400e101c5d4b439cf9a26b03aae558","be502a7a43c44bf7b682698de79d9369",11899953,1,5,0,1286,210,214,4
"be502a7a43c44bf7b682698de79d9369","a875096404ef4a9984b62d74cda916f9",11899953,2,-6,0,1287,214,209,-5
"f7fb1952f56b4189b86a9f8b7862d2b8","ec341f459285443b8361f7f15638ff08",11899953,1,-2,0,1289,215,213,-2
"ec341f459285443b8361f7f15638ff08","a875096404ef4a9984b62d74cda916f9",11899953,1,-5,0,1290,213,209,-4
"a875096404ef4a9984b62d74cda916f9","b9e80f77c3a44349863b19875725c384",11899953,1,-3,0,1291,209,207,-2
"7108f0e4c2584f1f9c471689ae4c885c","d7f13c8d63ec4e2aa673fbb9cf9c6933",11899953,3,-2,0,1293,208,206,-2
"a875096404ef4a9984b62d74cda916f9","be502a7a43c44bf7b682698de79d9369",11899953,1,6,0,1297,209,214,5
"be502a7a43c44bf7b682698de79d9369","b9e80f77c3a44349863b19875725c384",11899953,1,-9,0,1298,214,207,-7
"d7f13c8d63ec4e2aa673fbb9cf9c6933","f7fb1952f56b4189b86a9f8b7862d2b8",11899953,1,11,0,1301,206,215,9
"f7fb1952f56b4189b86a9f8b7862d2b8","0c7262dff33c4087bc660ccf40f92f9c",11899953,1,-60,0,1302,215,169,-46
"0c7262dff33c4087bc660ccf40f92f9c","1c6721b1f63f4d30ba7746ea8af02a52",11899953,1,70,0,1303,169,221,52
"1c6721b1f63f4d30ba7746ea8af02a52","f7906d6f59b9489a91d2ef40db5a474d",11899953,1,3,0,1304,221,223,2
"f7906d6f59b9489a91d2ef40db5a474d","d03cb855c70044cf8c35d9ec0de696e3",11899953,1,1,0,1305,223,224,1
"d03cb855c70044cf8c35d9ec0de696e3","8b9ae98743bd4d4a8a87dff1c1244211",11899953,2,3,0,1306,224,227,3
"8b9ae98743bd4d4a8a87dff1c1244211","f7906d6f59b9489a91d2ef40db5a474d",11899953,3,-4,0,1307,227,223,-4
"f7906d6f59b9489a91d2ef40db5a474d","f7906d6f59b9489a91d2ef40db5a474d",11899953,1,0,1,1308,223,223,0
"f7906d6f59b9489a91d2ef40db5a474d","2ab1535aac1346ba8801535bf729ef37",11899953,3,7,0,1309,223,229,6
"2ab1535aac1346ba8801535bf729ef37","77ecef8eff6b4a2caea7707669bf7475",11899953,1,-9,0,1310,229,222,-7
"77ecef8eff6b4a2caea7707669bf7475","1c6721b1f63f4d30ba7746ea8af02a52",11899953,4,-1,0,1311,222,221,-1
"1c6721b1f63f4d30ba7746ea8af02a52","8b9ae98743bd4d4a8a87dff1c1244211",11899953,1,7,0,1312,221,227,6
"f7906d6f59b9489a91d2ef40db5a474d","5152833676bf4c6cb317060be10f68db",11899953,1,6,0,1314,223,228,5
"5152833676bf4c6cb317060be10f68db","d03cb855c70044cf8c35d9ec0de696e3",11899953,1,-5,0,1315,228,224,-4
"d03cb855c70044cf8c35d9ec0de696e3","f7906d6f59b9489a91d2ef40db5a474d",11899953,1,-1,0,1316,224,223,-1
"f7906d6f59b9489a91d2ef40db5a474d","1c6721b1f63f4d30ba7746ea8af02a52",11899953,1,-3,0,1317,223,221,-2
"1c6721b1f63f4d30ba7746ea8af02a52","77ecef8eff6b4a2caea7707669bf7475",11899953,4,1,0,1318,221,222,1
"77ecef8eff6b4a2caea7707669bf7475","8b9ae98743bd4d4a8a87dff1c1244211",11899953,2,6,0,1319,222,227,5
"8b9ae98743bd4d4a8a87dff1c1244211","5152833676bf4c6cb317060be10f68db",11899953,1,2,0,1320,227,228,1
"5152833676bf4c6cb317060be10f68db","2ab1535aac1346ba8801535bf729ef37",11899953,1,1,0,1321,228,229,1
"2ab1535aac1346ba8801535bf729ef37","d03cb855c70044cf8c35d9ec0de696e3",11899953,1,-6,0,1322,229,224,-5
"d03cb855c70044cf8c35d9ec0de696e3","77ecef8eff6b4a2caea7707669bf7475",11899953,1,-3,0,1323,224,222,-2
"1c6721b1f63f4d30ba7746ea8af02a52","d03cb855c70044cf8c35d9ec0de696e3",11899953,2,4,0,1325,221,224,3
"2ab1535aac1346ba8801535bf729ef37","0c7262dff33c4087bc660ccf40f92f9c",11899953,1,-80,0,1329,229,169,-60
"0c7262dff33c4087bc660ccf40f92f9c","2ae94c0cea4d480a9d5dca8fb1d7b542",11899953,1,97,0,1330,169,242,73
"2ae94c0cea4d480a9d5dca8fb1d7b542","6e83e23f56544a19b94067c1c558d9c0",11899953,1,6,0,1331,242,247,5
"6e83e23f56544a19b94067c1c558d9c0","6e83e23f56544a19b94067c1c558d9c0",11899953,2,0,1,1332,247,247,0
"6e83e23f56544a19b94067c1c558d9c0","d546341988904f069cfa86b21457d9d9",11899953,3,5,0,1334,247,251,4
"d546341988904f069cfa86b21457d9d9","00f61990949545828dd12f1303d47504",11899953,1,6,0,1335,251,256,5
"00f61990949545828dd12f1303d47504","00f61990949545828dd12f1303d47504",11899953,1,0,1,1336,256,256,0
"00f61990949545828dd12f1303d47504","2ae94c0cea4d480a9d5dca8fb1d7b542",11899953,1,-17,0,1337,256,242,-14
"2ae94c0cea4d480a9d5dca8fb1d7b542","1ebf23f9d994469a85206e4c7b1bf5f5",11899953,3,3,0,1338,242,245,3
"1ebf23f9d994469a85206e4c7b1bf5f5","d546341988904f069cfa86b21457d9d9",11899953,1,8,0,1339,245,251,6
"d546341988904f069cfa86b21457d9d9","6e83e23f56544a19b94067c1c558d9c0",11899953,4,-5,0,1340,251,247,-4
"6e83e23f56544a19b94067c1c558d9c0","d989ebcfc12a4b669f0100dc1aa14f1e",11899953,1,10,0,1341,247,255,8
"d989ebcfc12a4b669f0100dc1aa14f1e","d989ebcfc12a4b669f0100dc1aa14f1e",11899953,1,0,1,1342,255,255,0
"d989ebcfc12a4b669f0100dc1aa14f1e","7aa76d3e993840d8805f097cbdbcd44b",11899953,1,7,0,1343,255,261,6
"7aa76d3e993840d8805f097cbdbcd44b","7028800abe7d4e27b613d1d6cbe26bf7",11899953,1,7,0,1344,261,267,6
"7028800abe7d4e27b613d1d6cbe26bf7","2ae94c0cea4d480a9d5dca8fb1d7b542",11899953,1,-30,0,1345,267,242,-25
"1ebf23f9d994469a85206e4c7b1bf5f5","6e83e23f56544a19b94067c1c558d9c0",11899953,2,3,0,1347,245,247,2
"6e83e23f56544a19b94067c1c558d9c0","00f61990949545828dd12f1303d47504",11899953,4,11,0,1348,247,256,9
"00f61990949545828dd12f1303d47504","6e83e23f56544a19b94067c1c558d9c0",11899953,3,-11,0,1349,256,247,-9
"00f61990949545828dd12f1303d47504","1ebf23f9d994469a85206e4c7b1bf5f5",11899953,1,-14,0,1353,256,245,-11
"1ebf23f9d994469a85206e4c7b1bf5f5","2ae94c0cea4d480a9d5dca8fb1d7b542",11899953,1,-3,0,1354,245,242,-3
"2ae94c0cea4d480a9d5dca8fb1d7b542","d546341988904f069cfa86b21457d9d9",11899953,1,11,0,1355,242,251,9
"00f61990949545828dd12f1303d47504","d546341988904f069cfa86b21457d9d9",11899953,1,-6,0,1358,256,251,-5
"d546341988904f069cfa86b21457d9d9","1ebf23f9d994469a85206e4c7b1bf5f5",11899953,1,-8,0,1359,251,245,-6
"6e83e23f56544a19b94067c1c558d9c0","2ae94c0cea4d480a9d5dca8fb1d7b542",11899953,1,-6,0,1361,247,242,-5
"2ae94c0cea4d480a9d5dca8fb1d7b542","00f61990949545828dd12f1303d47504",11899953,1,17,0,1362,242,256,14
"00f61990949545828dd12f1303d47504","d989ebcfc12a4b669f0100dc1aa14f1e",11899953,1,-1,0,1363,256,255,-1
"d989ebcfc12a4b669f0100dc1aa14f1e","d546341988904f069cfa86b21457d9d9",11899953,1,-5,0,1364,255,251,-4
"6e83e23f56544a19b94067c1c558d9c0","7028800abe7d4e27b613d1d6cbe26bf7",11899953,1,24,0,1366,247,267,20
"7028800abe7d4e27b613d1d6cbe26bf7","7aa76d3e993840d8805f097cbdbcd44b",11899953,1,-7,0,1367,267,261,-6
"7aa76d3e993840d8805f097cbdbcd44b","30c9ba177afc49a695625d2bdec40207",11899953,1,-14,0,1368,261,250,-11
"30c9ba177afc49a695625d2bdec40207","30c9ba177afc49a695625d2bdec40207",11899953,2,0,1,1369,250,250,0
"30c9ba177afc49a695625d2bdec40207","00f61990949545828dd12f1303d47504",11899953,1,8,0,1371,250,256,6
"d546341988904f069cfa86b21457d9d9","0c7262dff33c4087bc660ccf40f92f9c",11899953,1,-108,0,1374,251,169,-82
"0c7262dff33c4087bc660ccf40f92f9c","4a29443515bb404cb8924e1c60a63b73",11899953,2,157,0,1375,169,285,116
"4a29443515bb404cb8924e1c60a63b73","4a29443515bb404cb8924e1c60a63b73",11899953,4,0,1,1376,285,285,0
"4a29443515bb404cb8924e1c60a63b73","208c9b2796c944db8dacaa96082520ea",11899953,4,3,0,1377,285,288,3
"208c9b2796c944db8dacaa96082520ea","fab84b4fab5940efb4ea868ef8d09396",11899953,1,-7,0,1378,288,284,-4
"fab84b4fab5940efb4ea868ef8d09396","4a29443515bb404cb8924e1c60a63b73",11899953,2,4,0,1379,284,285,1
"4a29443515bb404cb8924e1c60a63b73","fab84b4fab5940efb4ea868ef8d09396",11899953,1,-4,0,1380,285,284,-1
"208c9b2796c944db8dacaa96082520ea","4a29443515bb404cb8924e1c60a63b73",11899953,3,-3,0,1383,288,285,-3
"4a29443515bb404cb8924e1c60a63b73","6a9a3b5bde4a48daa896fe8c06eca56f",11899953,2,5,0,1384,285,289,4
"6a9a3b5bde4a48daa896fe8c06eca56f","208c9b2796c944db8dacaa96082520ea",11899953,1,-2,0,1385,289,288,-1
"208c9b2796c944db8dacaa96082520ea","34a6e49023fc4465bd5ca604330bbd1c",11899953,1,6,0,1386,288,292,4
"34a6e49023fc4465bd5ca604330bbd1c","4a29443515bb404cb8924e1c60a63b73",11899953,2,-9,0,1387,292,285,-7
"4a29443515bb404cb8924e1c60a63b73","869e967078f04da18dd0b0b9389a7424",11899953,1,10,0,1388,285,293,8
"869e967078f04da18dd0b0b9389a7424","208c9b2796c944db8dacaa96082520ea",11899953,1,-7,0,1389,293,288,-5
"6a9a3b5bde4a48daa896fe8c06eca56f","869e967078f04da18dd0b0b9389a7424",11899953,2,5,0,1393,289,293,4
"869e967078f04da18dd0b0b9389a7424","34a6e49023fc4465bd5ca604330bbd1c",11899953,2,-1,0,1394,293,292,-1
"34a6e49023fc4465bd5ca604330bbd1c","21592f2a9e9c4b2f8c66ec5dbcbf6a2b",11899953,1,5,0,1395,292,296,4
"21592f2a9e9c4b2f8c66ec5dbcbf6a2b","ba0e59461bfb4a44b7b1c28a01f8d3b3",11899953,2,4,0,1396,296,299,3
"ba0e59461bfb4a44b7b1c28a01f8d3b3","869e967078f04da18dd0b0b9389a7424",11899953,1,-8,0,1397,299,293,-6
"869e967078f04da18dd0b0b9389a7424","7646a919d7e64fa990bca9b024ff089d",11899953,1,7,0,1398,293,298,5
"7646a919d7e64fa990bca9b024ff089d","34a6e49023fc4465bd5ca604330bbd1c",11899953,1,-8,0,1399,298,292,-6
"34a6e49023fc4465bd5ca604330bbd1c","6a9a3b5bde4a48daa896fe8c06eca56f",11899953,1,-4,0,1400,292,289,-3
"6a9a3b5bde4a48daa896fe8c06eca56f","21592f2a9e9c4b2f8c66ec5dbcbf6a2b",11899953,1,9,0,1401,289,296,7
"21592f2a9e9c4b2f8c66ec5dbcbf6a2b","869e967078f04da18dd0b0b9389a7424",11899953,1,-4,0,1402,296,293,-3
"869e967078f04da18dd0b0b9389a7424","21592f2a9e9c4b2f8c66ec5dbcbf6a2b",11899953,1,4,0,1403,293,296,3
"21592f2a9e9c4b2f8c66ec5dbcbf6a2b","34a6e49023fc4465bd5ca604330bbd1c",11899953,1,-5,0,1404,296,292,-4
"34a6e49023fc4465bd5ca604330bbd1c","ba0e59461bfb4a44b7b1c28a01f8d3b3",11899953,2,9,0,1405,292,299,7
"ba0e59461bfb4a44b7b1c28a01f8d3b3","7646a919d7e64fa990bca9b024ff089d",11899953,1,-1,0,1406,299,298,-1
"7646a919d7e64fa990bca9b024ff089d","2c5bb2cbd0014420ad8c95d40e38efd1",11899953,1,6,0,1407,298,303,5
"2c5bb2cbd0014420ad8c95d40e38efd1","869e967078f04da18dd0b0b9389a7424",11899953,1,-13,0,1408,303,293,-10
"4a29443515bb404cb8924e1c60a63b73","d6d02b6ef04e4f17805504500b8ce441",11899953,4,118,0,1411,285,375,90
"d6d02b6ef04e4f17805504500b8ce441","b71bac264efb4abd97015447bd490db6",11899953,3,-8,0,1416,375,370,-5
"d6d02b6ef04e4f17805504500b8ce441","8d448d625b024c82a5eb240bbd7431d6",11899953,2,-3,0,1418,375,374,-1
"8d448d625b024c82a5eb240bbd7431d6","4a29443515bb404cb8924e1c60a63b73",11899953,1,-115,0,1426,374,285,-89
"d6d02b6ef04e4f17805504500b8ce441","4a29443515bb404cb8924e1c60a63b73",11899953,4,-118,0,1431,375,285,-90
"8d448d625b024c82a5eb240bbd7431d6","d6d02b6ef04e4f17805504500b8ce441",11899953,1,3,0,1454,374,375,1
"4a29443515bb404cb8924e1c60a63b73","66baf19b6b904b70922329068c63746d",11899953,1,122,0,1459,285,376,91
"66baf19b6b904b70922329068c63746d","66baf19b6b904b70922329068c63746d",11899953,3,0,1,1460,376,376,0
"66baf19b6b904b70922329068c63746d","7f544639412e40a9ba27f43b415362ab",11899953,6,2,0,1461,376,378,2
"7f544639412e40a9ba27f43b415362ab","7f544639412e40a9ba27f43b415362ab",11899953,1,0,1,1462,378,378,0
"7f544639412e40a9ba27f43b415362ab","d5ae8642e15b46b8bd298b02274d4e9c",11899953,1,2,0,1463,378,380,2
"d5ae8642e15b46b8bd298b02274d4e9c","d5ae8642e15b46b8bd298b02274d4e9c",11899953,1,0,1,1464,380,380,0
"d5ae8642e15b46b8bd298b02274d4e9c","a0d10309a2dd456289147f84be9d37f9",11899953,1,1,0,1465,380,381,1
"a0d10309a2dd456289147f84be9d37f9","a0d10309a2dd456289147f84be9d37f9",11899953,2,0,1,1466,381,381,0
"a0d10309a2dd456289147f84be9d37f9","0fcbc3ca07b144138b8d85da581f09a8",11899953,1,1,0,1468,381,382,1
"0fcbc3ca07b144138b8d85da581f09a8","0fcbc3ca07b144138b8d85da581f09a8",11899953,2,0,1,1469,382,382,0
"0fcbc3ca07b144138b8d85da581f09a8","66baf19b6b904b70922329068c63746d",11899953,1,-6,0,1471,382,376,-6
"66baf19b6b904b70922329068c63746d","c2fca3669923477ab966ded303dea31c",11899953,1,8,0,1472,376,383,7
"c2fca3669923477ab966ded303dea31c","4890121ce5d74576b4632b77cfc23398",11899953,1,6,0,1473,383,388,5
"4890121ce5d74576b4632b77cfc23398","4890121ce5d74576b4632b77cfc23398",11899953,1,0,1,1474,388,388,0
"4890121ce5d74576b4632b77cfc23398","18d3b836dd804224883cc9180b60a8e1",11899953,1,-1,0,1475,388,387,-1
"18d3b836dd804224883cc9180b60a8e1","96bb2b3e85a34d8b9544514e89f6fe97",11899953,1,4,0,1476,387,390,3
"96bb2b3e85a34d8b9544514e89f6fe97","96bb2b3e85a34d8b9544514e89f6fe97",11899953,1,0,1,1477,390,390,0
"96bb2b3e85a34d8b9544514e89f6fe97","17f95d18bab743888e1736033dc3384d",11899953,2,-1,0,1478,390,389,-1
"17f95d18bab743888e1736033dc3384d","7f544639412e40a9ba27f43b415362ab",11899953,3,-14,0,1479,389,378,-11
"7f544639412e40a9ba27f43b415362ab","66baf19b6b904b70922329068c63746d",11899953,6,-2,0,1480,378,376,-2
"66baf19b6b904b70922329068c63746d","96bb2b3e85a34d8b9544514e89f6fe97",11899953,3,17,0,1481,376,390,14
"7f544639412e40a9ba27f43b415362ab","96bb2b3e85a34d8b9544514e89f6fe97",11899953,2,15,0,1484,378,390,12
"96bb2b3e85a34d8b9544514e89f6fe97","66baf19b6b904b70922329068c63746d",11899953,3,-17,0,1485,390,376,-14
"66baf19b6b904b70922329068c63746d","17f95d18bab743888e1736033dc3384d",11899953,1,16,0,1490,376,389,13
"96bb2b3e85a34d8b9544514e89f6fe97","ac4e9b54acfe4670b4634859c7263cb5",11899953,1,2,0,1498,390,392,2
"ac4e9b54acfe4670b4634859c7263cb5","ac4e9b54acfe4670b4634859c7263cb5",11899953,1,0,1,1499,392,392,0
"ac4e9b54acfe4670b4634859c7263cb5","17f95d18bab743888e1736033dc3384d",11899953,1,-3,0,1500,392,389,-3
"17f95d18bab743888e1736033dc3384d","6f8881a745ac4c358a68b92c3b4abe81",11899953,1,6,0,1501,389,394,5
"6f8881a745ac4c358a68b92c3b4abe81","6f8881a745ac4c358a68b92c3b4abe81",11899953,1,0,1,1502,394,394,0
"6f8881a745ac4c358a68b92c3b4abe81","f7002c8484354eceac57bc7bd62c76c1",11899953,1,-1,0,1503,394,393,-1
"f7002c8484354eceac57bc7bd62c76c1","66baf19b6b904b70922329068c63746d",11899953,1,-21,0,1504,393,376,-17
"66baf19b6b904b70922329068c63746d","44a277ea44dc4ae689fab4b82f0b4098",11899953,1,26,0,1508,376,397,21
"44a277ea44dc4ae689fab4b82f0b4098","44a277ea44dc4ae689fab4b82f0b4098",11899953,1,0,1,1509,397,397,0
"44a277ea44dc4ae689fab4b82f0b4098","0c12af0a4e7f4002852cf84b2537c161",11899953,1,-2,0,1510,397,395,-2
"0c12af0a4e7f4002852cf84b2537c161","66baf19b6b904b70922329068c63746d",11899953,1,-24,0,1511,395,376,-19
"66baf19b6b904b70922329068c63746d","859e0b8d71694b12befb69ee698138f9",11899953,1,29,0,1514,376,399,23
"859e0b8d71694b12befb69ee698138f9","859e0b8d71694b12befb69ee698138f9",11899953,1,0,1,1515,399,399,0
"859e0b8d71694b12befb69ee698138f9","2b09a08242b54983aec7063990fb3f66",11899953,1,3,0,1516,399,400,1
"2b09a08242b54983aec7063990fb3f66","66baf19b6b904b70922329068c63746d",11899953,1,-32,0,1517,400,376,-24
"66baf19b6b904b70922329068c63746d","2b09a08242b54983aec7063990fb3f66",11899953,1,32,0,1518,376,400,24
"2b09a08242b54983aec7063990fb3f66","4a29443515bb404cb8924e1c60a63b73",11899953,1,-154,0,1519,400,285,-115
"4a29443515bb404cb8924e1c60a63b73","2b09a08242b54983aec7063990fb3f66",11899953,1,154,0,1521,285,400,115
"2b09a08242b54983aec7063990fb3f66","2b09a08242b54983aec7063990fb3f66",11899953,9,0,1,1522,400,400,0
"2b09a08242b54983aec7063990fb3f66","1f471b7a883a4df48211e8c6a81b59a7",11899953,1,1,0,1524,400,401,1
"1f471b7a883a4df48211e8c6a81b59a7","1f471b7a883a4df48211e8c6a81b59a7",11899953,1,0,1,1525,401,401,0
"1f471b7a883a4df48211e8c6a81b59a7","2b09a08242b54983aec7063990fb3f66",11899953,1,-1,0,1526,401,400,-1
"2b09a08242b54983aec7063990fb3f66","1157bd665ec4472fb58b751dc5099355",11899953,5,4,0,1528,400,403,3
"1157bd665ec4472fb58b751dc5099355","2b09a08242b54983aec7063990fb3f66",11899953,3,-4,0,1529,403,400,-3
"2b09a08242b54983aec7063990fb3f66","9de0d567bfa84fe5b77cb76f4a76a5d1",11899953,1,5,0,1531,400,404,4
"9de0d567bfa84fe5b77cb76f4a76a5d1","9de0d567bfa84fe5b77cb76f4a76a5d1",11899953,1,0,1,1532,404,404,0
"9de0d567bfa84fe5b77cb76f4a76a5d1","1157bd665ec4472fb58b751dc5099355",11899953,1,-1,0,1533,404,403,-1
"1157bd665ec4472fb58b751dc5099355","3c8a22d2f9c146ea956609e3ed4f2559",11899953,1,3,0,1534,403,405,2
"3c8a22d2f9c146ea956609e3ed4f2559","58fc9094275e4c49be3f4ba6d4acc0a4",11899953,2,2,0,1535,405,406,1
"58fc9094275e4c49be3f4ba6d4acc0a4","58fc9094275e4c49be3f4ba6d4acc0a4",11899953,2,0,1,1536,406,406,0
"58fc9094275e4c49be3f4ba6d4acc0a4","c1c1be90b2b14c1ab4a5e1ee3c241902",11899953,1,1,0,1538,406,407,1
"c1c1be90b2b14c1ab4a5e1ee3c241902","c1c1be90b2b14c1ab4a5e1ee3c241902",11899953,5,0,1,1539,407,407,0
"c1c1be90b2b14c1ab4a5e1ee3c241902","02b3a1bead9244c1ba2f857c7da8f82a",11899953,1,2,0,1544,407,408,1
"02b3a1bead9244c1ba2f857c7da8f82a","58fc9094275e4c49be3f4ba6d4acc0a4",11899953,2,-3,0,1545,408,406,-2
"58fc9094275e4c49be3f4ba6d4acc0a4","2b09a08242b54983aec7063990fb3f66",11899953,1,-9,0,1546,406,400,-6
"2b09a08242b54983aec7063990fb3f66","02b3a1bead9244c1ba2f857c7da8f82a",11899953,2,12,0,1547,400,408,8
"02b3a1bead9244c1ba2f857c7da8f82a","2b09a08242b54983aec7063990fb3f66",11899953,2,-12,0,1548,408,400,-8
"1157bd665ec4472fb58b751dc5099355","02b3a1bead9244c1ba2f857c7da8f82a",11899953,1,8,0,1559,403,408,5
"02b3a1bead9244c1ba2f857c7da8f82a","3c8a22d2f9c146ea956609e3ed4f2559",11899953,1,-5,0,1560,408,405,-3
"3c8a22d2f9c146ea956609e3ed4f2559","2b09a08242b54983aec7063990fb3f66",11899953,1,-7,0,1561,405,400,-5
"1157bd665ec4472fb58b751dc5099355","58fc9094275e4c49be3f4ba6d4acc0a4",11899953,1,5,0,1565,403,406,3
"58fc9094275e4c49be3f4ba6d4acc0a4","3c8a22d2f9c146ea956609e3ed4f2559",11899953,1,-2,0,1566,406,405,-1
"58fc9094275e4c49be3f4ba6d4acc0a4","02b3a1bead9244c1ba2f857c7da8f82a",11899953,2,3,0,1568,406,408,2
"02b3a1bead9244c1ba2f857c7da8f82a","02b3a1bead9244c1ba2f857c7da8f82a",11899953,1,0,1,1571,408,408,0
"02b3a1bead9244c1ba2f857c7da8f82a","6206fc6479014bb193084c32409dc1b9",11899953,1,1,0,1572,408,409,1
"6206fc6479014bb193084c32409dc1b9","6206fc6479014bb193084c32409dc1b9",11899953,1,0,1,1573,409,409,0
"6206fc6479014bb193084c32409dc1b9","02b3a1bead9244c1ba2f857c7da8f82a",11899953,1,-1,0,1574,409,408,-1
"02b3a1bead9244c1ba2f857c7da8f82a","6a5f020451db426dacba9e2ea3fcc62a",11899953,1,3,0,1575,408,410,2
"6a5f020451db426dacba9e2ea3fcc62a","6a5f020451db426dacba9e2ea3fcc62a",11899953,4,0,1,1576,410,410,0
"6a5f020451db426dacba9e2ea3fcc62a","33a9d248b2e44588a5b07fc1342b9bc2",11899953,1,2,0,1580,410,411,1
"33a9d248b2e44588a5b07fc1342b9bc2","33a9d248b2e44588a5b07fc1342b9bc2",11899953,3,0,1,1581,411,411,0
"33a9d248b2e44588a5b07fc1342b9bc2","c6f26bd420634f1cb7989e76fe6b16c0",11899953,1,1,0,1584,411,412,1
"c6f26bd420634f1cb7989e76fe6b16c0","c6f26bd420634f1cb7989e76fe6b16c0",11899953,5,0,1,1585,412,412,0
"c6f26bd420634f1cb7989e76fe6b16c0","2a65ee6e2ac64f6a8a55fbe5373ec763",11899953,1,1,0,1590,412,413,1
"2a65ee6e2ac64f6a8a55fbe5373ec763","2a65ee6e2ac64f6a8a55fbe5373ec763",11899953,2,0,1,1591,413,413,0
"2a65ee6e2ac64f6a8a55fbe5373ec763","33a9d248b2e44588a5b07fc1342b9bc2",11899953,1,-2,0,1593,413,411,-2
"33a9d248b2e44588a5b07fc1342b9bc2","1fd0f6dadbc14ebc965faf6122190b96",11899953,1,5,0,1594,411,415,4
"1fd0f6dadbc14ebc965faf6122190b96","1fd0f6dadbc14ebc965faf6122190b96",11899953,1,0,1,1595,415,415,0
"1fd0f6dadbc14ebc965faf6122190b96","687055dad9fc40c3982478fe33ec01bf",11899953,1,-1,0,1596,415,414,-1
"687055dad9fc40c3982478fe33ec01bf","2add1669f08d4101913db15f8c23b3b7",11899953,1,3,0,1597,414,416,2
"2add1669f08d4101913db15f8c23b3b7","2add1669f08d4101913db15f8c23b3b7",11899953,1,0,1,1598,416,416,0
"2add1669f08d4101913db15f8c23b3b7","a2b4bd40cee2481ebd3fc179d6a5cd62",11899953,1,3,0,1599,416,417,1
"a2b4bd40cee2481ebd3fc179d6a5cd62","2b09a08242b54983aec7063990fb3f66",11899953,1,-27,0,1600,417,400,-17
"2b09a08242b54983aec7063990fb3f66","a2b4bd40cee2481ebd3fc179d6a5cd62",11899953,1,27,0,1601,400,417,17
"a2b4bd40cee2481ebd3fc179d6a5cd62","e34e59dce2204f228f3a84b6725df60f",11899953,1,2,0,1602,417,419,2
"e34e59dce2204f228f3a84b6725df60f","e34e59dce2204f228f3a84b6725df60f",11899953,1,0,1,1603,419,419,0
"e34e59dce2204f228f3a84b6725df60f","a2b4bd40cee2481ebd3fc179d6a5cd62",11899953,1,-2,0,1604,419,417,-2
"a2b4bd40cee2481ebd3fc179d6a5cd62","bec48fc2e1294c7eb3d0aca780d731b8",11899953,1,4,0,1605,417,420,3
"bec48fc2e1294c7eb3d0aca780d731b8","bec48fc2e1294c7eb3d0aca780d731b8",11899953,3,0,1,1606,420,420,0
"bec48fc2e1294c7eb3d0aca780d731b8","a24600b0e49245f6bdba8c893cfeddb0",11899953,1,7,0,1609,420,425,5
"a24600b0e49245f6bdba8c893cfeddb0","dbde19fcce2a4c1abdc7f685c293a23f",11899953,2,-4,0,1610,425,422,-3
"dbde19fcce2a4c1abdc7f685c293a23f","a24600b0e49245f6bdba8c893cfeddb0",11899953,2,4,0,1611,422,425,3
"a24600b0e49245f6bdba8c893cfeddb0","a24600b0e49245f6bdba8c893cfeddb0",11899953,3,0,1,1612,425,425,0
"a24600b0e49245f6bdba8c893cfeddb0","a2b4bd40cee2481ebd3fc179d6a5cd62",11899953,1,-11,0,1617,425,417,-8
"a2b4bd40cee2481ebd3fc179d6a5cd62","24cf8786024543f19b89bc20034e60d7",11899953,1,18,0,1618,417,428,11
"24cf8786024543f19b89bc20034e60d7","f2a73be2f46840b182d7bd095378004e",11899953,2,1,0,1619,428,429,1
"f2a73be2f46840b182d7bd095378004e","f2a73be2f46840b182d7bd095378004e",11899953,1,0,1,1620,429,429,0
"f2a73be2f46840b182d7bd095378004e","604551fd4266430cb860fef58fa7dd61",11899953,1,1,0,1621,429,430,1
"604551fd4266430cb860fef58fa7dd61","604551fd4266430cb860fef58fa7dd61",11899953,1,0,1,1622,430,430,0
"604551fd4266430cb860fef58fa7dd61","dce46f8904594a62a6377a3587aaa663",11899953,1,2,0,1623,430,431,1
"dce46f8904594a62a6377a3587aaa663","24cf8786024543f19b89bc20034e60d7",11899953,1,-4,0,1624,431,428,-3
"24cf8786024543f19b89bc20034e60d7","dce46f8904594a62a6377a3587aaa663",11899953,1,4,0,1625,428,431,3
"dce46f8904594a62a6377a3587aaa663","9b9d0a249052413c869753b99682b0ac",11899953,1,1,0,1626,431,432,1
"9b9d0a249052413c869753b99682b0ac","9b9d0a249052413c869753b99682b0ac",11899953,1,0,1,1627,432,432,0
"9b9d0a249052413c869753b99682b0ac","061c175cc90f45fbad883025394e78dd",11899953,1,1,0,1628,432,433,1
"061c175cc90f45fbad883025394e78dd","061c175cc90f45fbad883025394e78dd",11899953,4,0,1,1629,433,433,0
"061c175cc90f45fbad883025394e78dd","dce46f8904594a62a6377a3587aaa663",11899953,1,-2,0,1633,433,431,-2
"dce46f8904594a62a6377a3587aaa663","74a7f8712e5449c2bc0b43c6f90dafed",11899953,1,5,0,1634,431,435,4
"74a7f8712e5449c2bc0b43c6f90dafed","74a7f8712e5449c2bc0b43c6f90dafed",11899953,1,0,1,1635,435,435,0
"74a7f8712e5449c2bc0b43c6f90dafed","66ada10dde9f43018588f1ced9d477fc",11899953,1,-1,0,1636,435,434,-1
"66ada10dde9f43018588f1ced9d477fc","dce46f8904594a62a6377a3587aaa663",11899953,1,-4,0,1637,434,431,-3
"dce46f8904594a62a6377a3587aaa663","bf12c96466d840a69bed7020b3f18bb8",11899953,1,7,0,1638,431,436,5
"bf12c96466d840a69bed7020b3f18bb8","dce46f8904594a62a6377a3587aaa663",11899953,1,-7,0,1639,436,431,-5
"dce46f8904594a62a6377a3587aaa663","dce46f8904594a62a6377a3587aaa663",11899953,1,0,1,1640,431,431,0
"dce46f8904594a62a6377a3587aaa663","f2a73be2f46840b182d7bd095378004e",11899953,1,-3,0,1641,431,429,-2
"f2a73be2f46840b182d7bd095378004e","bf12c96466d840a69bed7020b3f18bb8",11899953,1,10,0,1642,429,436,7
"bf12c96466d840a69bed7020b3f18bb8","24cf8786024543f19b89bc20034e60d7",11899953,1,-11,0,1643,436,428,-8
"24cf8786024543f19b89bc20034e60d7","24cf8786024543f19b89bc20034e60d7",11899953,1,0,1,1644,428,428,0
"f2a73be2f46840b182d7bd095378004e","24cf8786024543f19b89bc20034e60d7",11899953,1,-1,0,1646,429,428,-1
"24cf8786024543f19b89bc20034e60d7","bf12c96466d840a69bed7020b3f18bb8",11899953,1,11,0,1647,428,436,8
"bf12c96466d840a69bed7020b3f18bb8","bf12c96466d840a69bed7020b3f18bb8",11899953,1,0,1,1648,436,436,0
"bf12c96466d840a69bed7020b3f18bb8","070600601c4c439288445d2f0724807d",11899953,1,3,0,1649,436,437,1
"070600601c4c439288445d2f0724807d","24cf8786024543f19b89bc20034e60d7",11899953,1,-14,0,1650,437,428,-9
"24cf8786024543f19b89bc20034e60d7","1823b6de7d334a7aaabc4570719af4d9",11899953,1,16,0,1651,428,439,11
"1823b6de7d334a7aaabc4570719af4d9","070600601c4c439288445d2f0724807d",11899953,2,-2,0,1652,439,437,-2
"070600601c4c439288445d2f0724807d","1823b6de7d334a7aaabc4570719af4d9",11899953,1,2,0,1653,437,439,2
"1823b6de7d334a7aaabc4570719af4d9","1823b6de7d334a7aaabc4570719af4d9",11899953,23,0,1,1654,439,439,0
"070600601c4c439288445d2f0724807d","0380cd76a7d44bc3a4da1f15e4d68f89",11899953,1,4,0,1678,437,440,3
"0380cd76a7d44bc3a4da1f15e4d68f89","0380cd76a7d44bc3a4da1f15e4d68f89",11899953,2,0,1,1679,440,440,0
"0380cd76a7d44bc3a4da1f15e4d68f89","23b7673c8b5443108c2ef09382834a86",11899953,2,2,0,1681,440,441,1
"23b7673c8b5443108c2ef09382834a86","0380cd76a7d44bc3a4da1f15e4d68f89",11899953,1,-2,0,1682,441,440,-1
"23b7673c8b5443108c2ef09382834a86","23b7673c8b5443108c2ef09382834a86",11899953,1,0,1,1684,441,441,0
"23b7673c8b5443108c2ef09382834a86","901e92500aea43c79f19f1b279050668",11899953,1,2,0,1685,441,442,1
"901e92500aea43c79f19f1b279050668","901e92500aea43c79f19f1b279050668",11899953,1,0,1,1686,442,442,0
"901e92500aea43c79f19f1b279050668","001339db8ced4cf78829ebe8b145449d",11899953,1,1,0,1687,442,443,1
"001339db8ced4cf78829ebe8b145449d","001339db8ced4cf78829ebe8b145449d",11899953,8,0,1,1688,443,443,0
"001339db8ced4cf78829ebe8b145449d","452745e0366e42ae81561bfddebcc6c3",11899953,1,1,0,1696,443,444,1
"452745e0366e42ae81561bfddebcc6c3","452745e0366e42ae81561bfddebcc6c3",11899953,2,0,1,1697,444,444,0
"452745e0366e42ae81561bfddebcc6c3","901e92500aea43c79f19f1b279050668",11899953,1,-2,0,1699,444,442,-2
"901e92500aea43c79f19f1b279050668","4660ff2089114e8db82ceb26a4f329e3",11899953,1,4,0,1700,442,445,3
"4660ff2089114e8db82ceb26a4f329e3","4660ff2089114e8db82ceb26a4f329e3",11899953,2,0,1,1701,445,445,0
"4660ff2089114e8db82ceb26a4f329e3","7bd5586eb9d8484eb74a433ee7bfe499",11899953,3,2,0,1703,445,446,1
"7bd5586eb9d8484eb74a433ee7bfe499","7bd5586eb9d8484eb74a433ee7bfe499",11899953,13,0,1,1704,446,446,0
"7bd5586eb9d8484eb74a433ee7bfe499","8a7f26e690f34dda97be16904518ca99",11899953,1,2,0,1716,446,447,1
"8a7f26e690f34dda97be16904518ca99","8a7f26e690f34dda97be16904518ca99",11899953,1,0,1,1717,447,447,0
"8a7f26e690f34dda97be16904518ca99","070600601c4c439288445d2f0724807d",11899953,1,-16,0,1718,447,437,-10
"070600601c4c439288445d2f0724807d","b2f0d654738f48158edff28e8d3a546e",11899953,1,21,0,1719,437,449,12
"b2f0d654738f48158edff28e8d3a546e","f60ee41ec635499abd48168342d32c2f",11899953,3,5,0,1720,449,453,4
"f60ee41ec635499abd48168342d32c2f","f60ee41ec635499abd48168342d32c2f",11899953,74,0,1,1721,453,453,0
"f60ee41ec635499abd48168342d32c2f","b2f0d654738f48158edff28e8d3a546e",11899953,1,-5,0,1722,453,449,-4
"f60ee41ec635499abd48168342d32c2f","f67fbf45a5f146ed866965bc57c7c001",11899953,2,3,0,1774,453,454,1
"f67fbf45a5f146ed866965bc57c7c001","b2f0d654738f48158edff28e8d3a546e",11899953,2,-8,0,1775,454,449,-5
"b2f0d654738f48158edff28e8d3a546e","f67fbf45a5f146ed866965bc57c7c001",11899953,1,8,0,1776,449,454,5
"f67fbf45a5f146ed866965bc57c7c001","f67fbf45a5f146ed866965bc57c7c001",11899953,1,0,1,1777,454,454,0
"f67fbf45a5f146ed866965bc57c7c001","d937afe49bd24a07a550dda1c1155122",11899953,1,1,0,1778,454,455,1
"d937afe49bd24a07a550dda1c1155122","d937afe49bd24a07a550dda1c1155122",11899953,1,0,1,1779,455,455,0
"d937afe49bd24a07a550dda1c1155122","3628b3f7823443d0912a339096b69943",11899953,1,1,0,1780,455,456,1
"3628b3f7823443d0912a339096b69943","3628b3f7823443d0912a339096b69943",11899953,1,0,1,1781,456,456,0
"3628b3f7823443d0912a339096b69943","9e049ee647cf43ecbcb5ed792a8e7588",11899953,1,1,0,1782,456,457,1
"9e049ee647cf43ecbcb5ed792a8e7588","9e049ee647cf43ecbcb5ed792a8e7588",11899953,1,0,1,1783,457,457,0
"9e049ee647cf43ecbcb5ed792a8e7588","5256a214faaf410b93f76cea06428334",11899953,1,1,0,1784,457,458,1
"5256a214faaf410b93f76cea06428334","5256a214faaf410b93f76cea06428334",11899953,1,0,1,1785,458,458,0
"5256a214faaf410b93f76cea06428334","25c32b120fce40fa9b6c85133aeb4716",11899953,1,1,0,1786,458,459,1
"25c32b120fce40fa9b6c85133aeb4716","25c32b120fce40fa9b6c85133aeb4716",11899953,1,0,1,1787,459,459,0
"25c32b120fce40fa9b6c85133aeb4716","11bc14f2204949008b7d511b933363c1",11899953,1,1,0,1788,459,460,1
"11bc14f2204949008b7d511b933363c1","11bc14f2204949008b7d511b933363c1",11899953,1,0,1,1789,460,460,0
"11bc14f2204949008b7d511b933363c1","42de338840a34d15adb66e7b14fb9d2c",11899953,1,1,0,1790,460,461,1
"42de338840a34d15adb66e7b14fb9d2c","42de338840a34d15adb66e7b14fb9d2c",11899953,3,0,1,1791,461,461,0
"42de338840a34d15adb66e7b14fb9d2c","9da37c6210b1416b8079c274f70bf600",11899953,1,1,0,1794,461,462,1
"9da37c6210b1416b8079c274f70bf600","9da37c6210b1416b8079c274f70bf600",11899953,1,0,1,1795,462,462,0
"9da37c6210b1416b8079c274f70bf600","519119f1deac45ff9ab4f13529be5c6e",11899953,1,1,0,1796,462,463,1
"519119f1deac45ff9ab4f13529be5c6e","519119f1deac45ff9ab4f13529be5c6e",11899953,1,0,1,1797,463,463,0
"519119f1deac45ff9ab4f13529be5c6e","f67fbf45a5f146ed866965bc57c7c001",11899953,1,-9,0,1798,463,454,-9
"f67fbf45a5f146ed866965bc57c7c001","c5df9f40ec14463b9dcfdc73df3e9285",11899953,3,12,0,1799,454,464,10
"c5df9f40ec14463b9dcfdc73df3e9285","c5df9f40ec14463b9dcfdc73df3e9285",11899953,19,0,1,1800,464,464,0
"c5df9f40ec14463b9dcfdc73df3e9285","83d42d95cd844fc093fc09cee250edb8",11899953,4,3,0,1801,464,465,1
"83d42d95cd844fc093fc09cee250edb8","c5df9f40ec14463b9dcfdc73df3e9285",11899953,1,-3,0,1802,465,464,-1
"83d42d95cd844fc093fc09cee250edb8","83d42d95cd844fc093fc09cee250edb8",11899953,13,0,1,1804,465,465,0
"83d42d95cd844fc093fc09cee250edb8","66baf19b6b904b70922329068c63746d",11899953,2,-135,0,1807,465,376,-89
"66baf19b6b904b70922329068c63746d","7bd5586eb9d8484eb74a433ee7bfe499",11899953,1,105,0,1808,376,446,70
"7bd5586eb9d8484eb74a433ee7bfe499","070600601c4c439288445d2f0724807d",11899953,1,-14,0,1809,446,437,-9
"070600601c4c439288445d2f0724807d","7bd5586eb9d8484eb74a433ee7bfe499",11899953,1,14,0,1810,437,446,9
"7bd5586eb9d8484eb74a433ee7bfe499","4660ff2089114e8db82ceb26a4f329e3",11899953,2,-2,0,1811,446,445,-1
"7bd5586eb9d8484eb74a433ee7bfe499","66baf19b6b904b70922329068c63746d",11899953,1,-105,0,1816,446,376,-70
"66baf19b6b904b70922329068c63746d","b2f0d654738f48158edff28e8d3a546e",11899953,2,112,0,1817,376,449,73
"b2f0d654738f48158edff28e8d3a546e","9428d8bd9c5a47b2a235b254e5e27ded",11899953,2,4,0,1818,449,452,3
"9428d8bd9c5a47b2a235b254e5e27ded","f60ee41ec635499abd48168342d32c2f",11899953,2,1,0,1819,452,453,1
"b2f0d654738f48158edff28e8d3a546e","66baf19b6b904b70922329068c63746d",11899953,1,-112,0,1831,449,376,-73
"f60ee41ec635499abd48168342d32c2f","9428d8bd9c5a47b2a235b254e5e27ded",11899953,1,-1,0,1842,453,452,-1
"9428d8bd9c5a47b2a235b254e5e27ded","66baf19b6b904b70922329068c63746d",11899953,1,-116,0,1843,452,376,-76
"66baf19b6b904b70922329068c63746d","c5df9f40ec14463b9dcfdc73df3e9285",11899953,2,132,0,1844,376,464,88
"c5df9f40ec14463b9dcfdc73df3e9285","f67fbf45a5f146ed866965bc57c7c001",11899953,2,-12,0,1851,464,454,-10
"66baf19b6b904b70922329068c63746d","d6d02b6ef04e4f17805504500b8ce441",11899953,1,-4,0,1859,376,375,-1
"4a29443515bb404cb8924e1c60a63b73","c5df9f40ec14463b9dcfdc73df3e9285",11899953,1,254,0,1863,285,464,179
"c5df9f40ec14463b9dcfdc73df3e9285","d6d02b6ef04e4f17805504500b8ce441",11899953,1,-136,0,1866,464,375,-89
"d6d02b6ef04e4f17805504500b8ce441","66baf19b6b904b70922329068c63746d",11899953,1,4,0,1872,375,376,1
"83d42d95cd844fc093fc09cee250edb8","9428d8bd9c5a47b2a235b254e5e27ded",11899953,1,-19,0,1888,465,452,-13
"9428d8bd9c5a47b2a235b254e5e27ded","b2f0d654738f48158edff28e8d3a546e",11899953,1,-4,0,1889,452,449,-3
"f60ee41ec635499abd48168342d32c2f","1b4550d0dab04078b3bf08a655345bdc",11899953,1,-125,0,1898,453,373,-80
"1b4550d0dab04078b3bf08a655345bdc","b71bac264efb4abd97015447bd490db6",11899953,1,-4,0,1899,373,370,-3
"8d448d625b024c82a5eb240bbd7431d6","0d987bed3ffa4ed0b9a2e62e97b7b30f",11899953,1,-137,0,1908,374,272,-102
"0d987bed3ffa4ed0b9a2e62e97b7b30f","bc5524e78a8544e2ae2fdc2f3462bbec",11899953,2,9,0,1909,272,279,7
"bc5524e78a8544e2ae2fdc2f3462bbec","bb5a47f5ea01454a8b79455422d3b9da",11899953,1,1,0,1910,279,280,1
"bb5a47f5ea01454a8b79455422d3b9da","8959e6304a0348309a771e4d08d1b64a",11899953,1,-158,0,1918,280,163,-117
"8959e6304a0348309a771e4d08d1b64a","78adeee1fa2c4fe0bc73f7bca9fcee86",11899953,1,-4,0,1919,163,160,-3
"78adeee1fa2c4fe0bc73f7bca9fcee86","65202579580f4ad38d734b4ee39d22a8",11899953,4,5,0,1920,160,164,4
"65202579580f4ad38d734b4ee39d22a8","65202579580f4ad38d734b4ee39d22a8",11899953,69,0,1,1921,164,164,0
"65202579580f4ad38d734b4ee39d22a8","f902b0f41b544d4dbf79664fd233648d",11899953,1,-23,0,1928,164,146,-18
"f902b0f41b544d4dbf79664fd233648d","df1de691dafe4549a18a4398ee9dfaf9",11899953,1,-8,0,1929,146,139,-7
"df1de691dafe4549a18a4398ee9dfaf9","8aae34f5ddbb4052a709b12e6b0d40fa",11899953,2,9,0,1930,139,147,8
"8aae34f5ddbb4052a709b12e6b0d40fa","8aae34f5ddbb4052a709b12e6b0d40fa",11899953,3,0,1,1931,147,147,0
"8aae34f5ddbb4052a709b12e6b0d40fa","67a089198fcb4e1c8f2385786c2b296f",11899953,1,-135,0,1933,147,39,-108
"67a089198fcb4e1c8f2385786c2b296f","140d5b27b8574befad82c0a013b59dfa",11899953,1,45,0,1934,39,74,35
"140d5b27b8574befad82c0a013b59dfa","d646286c8051419bbc2e31dd1db55ca8",11899953,2,-8,0,1935,74,67,-7
"a2becd407db34b189200a32546d9d569","a2becd407db34b189200a32546d9d569",11899953,1,0,1,1937,75,75,0
"a2becd407db34b189200a32546d9d569","67a089198fcb4e1c8f2385786c2b296f",11899953,2,-46,0,1938,75,39,-36
"67a089198fcb4e1c8f2385786c2b296f","0c4079457ede49e3aeb5e86ed84bdf35",11899953,1,384,0,1939,39,329,290
"0c4079457ede49e3aeb5e86ed84bdf35","0c4079457ede49e3aeb5e86ed84bdf35",11899953,1,0,1,1940,329,329,0
"38aea304b4fa46e1b29bb72f5cea4c93","4a29443515bb404cb8924e1c60a63b73",11899953,1,-60,0,1943,331,285,-46
"4a29443515bb404cb8924e1c60a63b73","d646286c8051419bbc2e31dd1db55ca8",11899953,1,-289,0,1944,285,67,-218
"d646286c8051419bbc2e31dd1db55ca8","140d5b27b8574befad82c0a013b59dfa",11899953,1,8,0,1945,67,74,7
"140d5b27b8574befad82c0a013b59dfa","a2becd407db34b189200a32546d9d569",11899953,1,1,0,1946,74,75,1
"67a089198fcb4e1c8f2385786c2b296f","83d42d95cd844fc093fc09cee250edb8",11899953,1,583,0,1948,39,465,426
"83d42d95cd844fc093fc09cee250edb8","b534b89233134e30a9b5645138bfa9ee",11899953,1,-579,0,1956,465,41,-424
"b534b89233134e30a9b5645138bfa9ee","f924752d8a1149668870b1e7698486f7",11899953,2,11,0,1957,41,50,9
"f924752d8a1149668870b1e7698486f7","d0c74f735e024943943e40333d6d337f",11899953,2,1,0,1958,50,51,1
"d0c74f735e024943943e40333d6d337f","b534b89233134e30a9b5645138bfa9ee",11899953,1,-12,0,1960,51,41,-10
"d0c74f735e024943943e40333d6d337f","6e13d61a7bdb44bca949c9f86fab3be5",11899953,1,-5,0,1964,51,47,-4
"6e13d61a7bdb44bca949c9f86fab3be5","f924752d8a1149668870b1e7698486f7",11899953,1,4,0,1965,47,50,3
"f924752d8a1149668870b1e7698486f7","6e13d61a7bdb44bca949c9f86fab3be5",11899953,1,-4,0,1966,50,47,-3
"6e13d61a7bdb44bca949c9f86fab3be5","a0a418b8540d479fa6e0f653b701da8b",11899953,1,20,0,1967,47,64,17
"a0a418b8540d479fa6e0f653b701da8b","d9c8d8c444a64dadbbb508652c721e17",11899953,1,-21,0,1968,64,46,-18
"d9c8d8c444a64dadbbb508652c721e17","a0a418b8540d479fa6e0f653b701da8b",11899953,1,21,0,1969,46,64,18
"a0a418b8540d479fa6e0f653b701da8b","bc42d26810654ea9a1df1efe1e58c7d5",11899953,2,-1,0,1970,64,63,-1
"bc42d26810654ea9a1df1efe1e58c7d5","309ccf3cc4fe429d9bfbaef53d3fa479",11899953,1,-3,0,1974,63,60,-3
"309ccf3cc4fe429d9bfbaef53d3fa479","67a089198fcb4e1c8f2385786c2b296f",11899953,1,-27,0,1975,60,39,-21
"67a089198fcb4e1c8f2385786c2b296f","df1de691dafe4549a18a4398ee9dfaf9",11899953,1,126,0,1976,39,139,100
"df1de691dafe4549a18a4398ee9dfaf9","f902b0f41b544d4dbf79664fd233648d",11899953,1,8,0,1977,139,146,7
"f902b0f41b544d4dbf79664fd233648d","8aae34f5ddbb4052a709b12e6b0d40fa",11899953,1,1,0,1978,146,147,1
"8aae34f5ddbb4052a709b12e6b0d40fa","f902b0f41b544d4dbf79664fd233648d",11899953,1,-1,0,1980,147,146,-1
"f902b0f41b544d4dbf79664fd233648d","d313cec988a84645bee413e8d4724a4b",11899953,1,14,0,1981,146,158,12
"d313cec988a84645bee413e8d4724a4b","d313cec988a84645bee413e8d4724a4b",11899953,6,0,1,1982,158,158,0
"d313cec988a84645bee413e8d4724a4b","f03480cf4eba413194d7af52fc0e7f28",11899953,1,-7,0,1984,158,152,-6
"f03480cf4eba413194d7af52fc0e7f28","f4ce60b4a944484082ccb701b48b3da1",11899953,1,6,0,1985,152,157,5
"f4ce60b4a944484082ccb701b48b3da1","6c5ad271a44743479bfaea29b1db8d02",11899953,1,-17,0,1986,157,143,-14
"6c5ad271a44743479bfaea29b1db8d02","67a089198fcb4e1c8f2385786c2b296f",11899953,1,-130,0,1987,143,39,-104
"67a089198fcb4e1c8f2385786c2b296f","67a089198fcb4e1c8f2385786c2b296f",11899953,1,0,1,1988,39,39,0
"67a089198fcb4e1c8f2385786c2b296f","e20db35ced8544ddac5bc3839145e463",11899953,1,67,0,1989,39,91,52
"e20db35ced8544ddac5bc3839145e463","e20db35ced8544ddac5bc3839145e463",11899953,6,0,1,1990,91,91,0
"e20db35ced8544ddac5bc3839145e463","00ae5f0c51874a73a41ebea838d95682",11899953,1,11,0,1992,91,101,10
"00ae5f0c51874a73a41ebea838d95682","d391c8b6e56a43a7b654e9dee02d904b",11899953,2,2,0,1993,101,103,2
"d391c8b6e56a43a7b654e9dee02d904b","00ae5f0c51874a73a41ebea838d95682",11899953,2,-2,0,1994,103,101,-2
"00ae5f0c51874a73a41ebea838d95682","00ae5f0c51874a73a41ebea838d95682",11899953,2,0,1,1995,101,101,0
"00ae5f0c51874a73a41ebea838d95682","e20db35ced8544ddac5bc3839145e463",11899953,2,-11,0,1997,101,91,-10
"b613861cecf84ffcab01afb23f660475","b613861cecf84ffcab01afb23f660475",18524205,2,0,1,1,1,1,0
"b613861cecf84ffcab01afb23f660475","e2911e79efc2420eac45d9f671463d4b",18524205,2,3,0,3,1,2,1
"e2911e79efc2420eac45d9f671463d4b","b613861cecf84ffcab01afb23f660475",18524205,1,-3,0,4,2,1,-1
"e2911e79efc2420eac45d9f671463d4b","e2911e79efc2420eac45d9f671463d4b",18524205,1,0,1,6,2,2,0
"e2911e79efc2420eac45d9f671463d4b","519d1b8c59404d67b54e96c5c8a830b2",18524205,1,1,0,7,2,3,1
"519d1b8c59404d67b54e96c5c8a830b2","519d1b8c59404d67b54e96c5c8a830b2",18524205,1,0,1,8,3,3,0
"519d1b8c59404d67b54e96c5c8a830b2","531db53f81f646edb0cdcfe0085b03b7",18524205,1,1,0,9,3,4,1
"531db53f81f646edb0cdcfe0085b03b7","531db53f81f646edb0cdcfe0085b03b7",18524205,1,0,1,10,4,4,0
"531db53f81f646edb0cdcfe0085b03b7","4f5f94b2f95141e0a9d53a61da2276da",18524205,1,1,0,11,4,5,1
"4f5f94b2f95141e0a9d53a61da2276da","4f5f94b2f95141e0a9d53a61da2276da",18524205,1,0,1,12,5,5,0
"4f5f94b2f95141e0a9d53a61da2276da","6d541c89590949f99af293c4f2333f67",18524205,1,1,0,13,5,6,1
"6d541c89590949f99af293c4f2333f67","6d541c89590949f99af293c4f2333f67",18524205,1,0,1,14,6,6,0
"6d541c89590949f99af293c4f2333f67","dd5cf0b9fe4c4f1d8f5ff8e4c04879cb",18524205,1,1,0,15,6,7,1
"dd5cf0b9fe4c4f1d8f5ff8e4c04879cb","dd5cf0b9fe4c4f1d8f5ff8e4c04879cb",18524205,1,0,1,16,7,7,0
"dd5cf0b9fe4c4f1d8f5ff8e4c04879cb","f96261861edc426abe2248be4f0a709a",18524205,1,1,0,17,7,8,1
"f96261861edc426abe2248be4f0a709a","f96261861edc426abe2248be4f0a709a",18524205,1,0,1,18,8,8,0
"f96261861edc426abe2248be4f0a709a","66b5e16f4f75454fb5b8172079f0fa83",18524205,1,1,0,19,8,9,1
"66b5e16f4f75454fb5b8172079f0fa83","66b5e16f4f75454fb5b8172079f0fa83",18524205,1,0,1,20,9,9,0
"66b5e16f4f75454fb5b8172079f0fa83","9112f2bffece48e08c6d2287be204085",18524205,1,2,0,21,9,11,2
"9112f2bffece48e08c6d2287be204085","9112f2bffece48e08c6d2287be204085",18524205,1,0,1,22,11,11,0
"9112f2bffece48e08c6d2287be204085","0680571d4698477995e41842c36a54b2",18524205,1,-1,0,23,11,10,-1
"0680571d4698477995e41842c36a54b2","0680571d4698477995e41842c36a54b2",18524205,1,0,1,24,10,10,0
"0680571d4698477995e41842c36a54b2","e2911e79efc2420eac45d9f671463d4b",18524205,1,-8,0,25,10,2,-8
"e2911e79efc2420eac45d9f671463d4b","56586aa865414f538729c7f7735d2bc6",18524205,1,12,0,26,2,12,10
"56586aa865414f538729c7f7735d2bc6","56586aa865414f538729c7f7735d2bc6",18524205,3,0,1,27,12,12,0
"56586aa865414f538729c7f7735d2bc6","b7f2b31585d94eb3bf86376714aa7070",18524205,2,2,0,29,12,13,1
"b7f2b31585d94eb3bf86376714aa7070","56586aa865414f538729c7f7735d2bc6",18524205,1,-2,0,30,13,12,-1
"b7f2b31585d94eb3bf86376714aa7070","b7f2b31585d94eb3bf86376714aa7070",18524205,1,0,1,32,13,13,0
"b7f2b31585d94eb3bf86376714aa7070","3f1c815879794b929260d224becaff7e",18524205,1,2,0,33,13,14,1
"3f1c815879794b929260d224becaff7e","81c864a886d54a6b8ff85f7d736f4f95",18524205,1,2,0,34,14,15,1
"81c864a886d54a6b8ff85f7d736f4f95","5c5ceeee4562457ba6d41515aeebfbb1",18524205,1,4,0,35,15,17,2
"5c5ceeee4562457ba6d41515aeebfbb1","9afd71a5298d4333b6849dfce1b9422c",18524205,1,3,0,36,17,18,1
"9afd71a5298d4333b6849dfce1b9422c","56586aa865414f538729c7f7735d2bc6",18524205,1,-13,0,37,18,12,-6
"56586aa865414f538729c7f7735d2bc6","9afd71a5298d4333b6849dfce1b9422c",18524205,2,13,0,39,12,18,6
"9afd71a5298d4333b6849dfce1b9422c","5c5ceeee4562457ba6d41515aeebfbb1",18524205,1,-3,0,40,18,17,-1
"5c5ceeee4562457ba6d41515aeebfbb1","5c5ceeee4562457ba6d41515aeebfbb1",18524205,1,0,1,41,17,17,0
"5c5ceeee4562457ba6d41515aeebfbb1","56586aa865414f538729c7f7735d2bc6",18524205,1,-10,0,42,17,12,-5
"9afd71a5298d4333b6849dfce1b9422c","9afd71a5298d4333b6849dfce1b9422c",18524205,1,0,1,44,18,18,0
"9afd71a5298d4333b6849dfce1b9422c","b7719e26494940efa49512aedd0aac79",18524205,1,4,0,45,18,20,2
"b7719e26494940efa49512aedd0aac79","d4f45188d3c84a02ba08454e6403a818",18524205,1,5,0,46,20,24,4
"d4f45188d3c84a02ba08454e6403a818","d4c3b003e8274e429d2fa688d73fde6d",18524205,3,-2,0,47,24,22,-2
"d4c3b003e8274e429d2fa688d73fde6d","b7719e26494940efa49512aedd0aac79",18524205,3,-3,0,48,22,20,-2
"b7719e26494940efa49512aedd0aac79","b7719e26494940efa49512aedd0aac79",18524205,1,0,1,49,20,20,0
"b7719e26494940efa49512aedd0aac79","afbf7250b99d47bea07172749483ca97",18524205,1,12,0,50,20,28,8
"afbf7250b99d47bea07172749483ca97","afbf7250b99d47bea07172749483ca97",18524205,1,0,1,51,28,28,0
"afbf7250b99d47bea07172749483ca97","4e51676dc72045d99c19b9fa7b22f8bc",18524205,1,3,0,52,28,29,1
"4e51676dc72045d99c19b9fa7b22f8bc","4e51676dc72045d99c19b9fa7b22f8bc",18524205,1,0,1,53,29,29,0
"4e51676dc72045d99c19b9fa7b22f8bc","51970cfa30e643e894e66ae85c8024cc",18524205,1,3,0,54,29,31,2
"51970cfa30e643e894e66ae85c8024cc","4e51676dc72045d99c19b9fa7b22f8bc",18524205,1,-3,0,55,31,29,-2
"4e51676dc72045d99c19b9fa7b22f8bc","c33c17be71ae4d588da7369472e5bb1b",18524205,1,9,0,56,29,34,5
"c33c17be71ae4d588da7369472e5bb1b","c33c17be71ae4d588da7369472e5bb1b",18524205,1,0,1,57,34,34,0
"c33c17be71ae4d588da7369472e5bb1b","93679be414554a11b1893002f2229a93",18524205,1,3,0,58,34,35,1
"93679be414554a11b1893002f2229a93","7040a13096d746ac84b8fac8d9752058",18524205,1,3,0,59,35,36,1
"7040a13096d746ac84b8fac8d9752058","93679be414554a11b1893002f2229a93",18524205,1,-3,0,60,36,35,-1
"93679be414554a11b1893002f2229a93","9a0dc646f934470daf08c4b56ccf73db",18524205,1,6,0,61,35,37,2
"9a0dc646f934470daf08c4b56ccf73db","7040a13096d746ac84b8fac8d9752058",18524205,2,-3,0,62,37,36,-1
"7040a13096d746ac84b8fac8d9752058","9a0dc646f934470daf08c4b56ccf73db",18524205,2,3,0,63,36,37,1
"9a0dc646f934470daf08c4b56ccf73db","fc0e049d56024bc9a02c9a9c435c3df7",18524205,1,3,0,64,37,38,1
"fc0e049d56024bc9a02c9a9c435c3df7","fc0e049d56024bc9a02c9a9c435c3df7",18524205,6,0,1,65,38,38,0
"fc0e049d56024bc9a02c9a9c435c3df7","78adeee1fa2c4fe0bc73f7bca9fcee86",18524205,1,156,0,71,38,160,122
"78adeee1fa2c4fe0bc73f7bca9fcee86","f8c6e9dd315640039488619b16128971",18524205,1,2,0,74,160,162,2
"f8c6e9dd315640039488619b16128971","f8c6e9dd315640039488619b16128971",18524205,1,0,1,75,162,162,0
"f8c6e9dd315640039488619b16128971","67a089198fcb4e1c8f2385786c2b296f",18524205,1,-154,0,76,162,39,-123
"67a089198fcb4e1c8f2385786c2b296f","67a089198fcb4e1c8f2385786c2b296f",18524205,2,0,1,77,39,39,0
"64d48c6c9c7940639a932219a6c87198","b534b89233134e30a9b5645138bfa9ee",18524205,1,3,0,83,40,41,1
"b534b89233134e30a9b5645138bfa9ee","67a089198fcb4e1c8f2385786c2b296f",18524205,1,-4,0,84,41,39,-2
"67a089198fcb4e1c8f2385786c2b296f","0e37b720d23b4e7f8b313e79313fd107",18524205,1,7,0,85,39,44,5
"0e37b720d23b4e7f8b313e79313fd107","0e37b720d23b4e7f8b313e79313fd107",18524205,1,0,1,86,44,44,0
"0e37b720d23b4e7f8b313e79313fd107","6875d67fdd5f48168b62719df449bebd",18524205,1,1,0,87,44,45,1
"6875d67fdd5f48168b62719df449bebd","6875d67fdd5f48168b62719df449bebd",18524205,1,0,1,88,45,45,0
"6875d67fdd5f48168b62719df449bebd","b534b89233134e30a9b5645138bfa9ee",18524205,1,-4,0,89,45,41,-4
"6e13d61a7bdb44bca949c9f86fab3be5","195f78799f984cc2b06c48dfe36be751",18524205,1,2,0,92,47,49,2
"195f78799f984cc2b06c48dfe36be751","195f78799f984cc2b06c48dfe36be751",18524205,2,0,1,93,49,49,0
"195f78799f984cc2b06c48dfe36be751","d9c8d8c444a64dadbbb508652c721e17",18524205,1,-3,0,95,49,46,-3
"d0c74f735e024943943e40333d6d337f","d0c74f735e024943943e40333d6d337f",18524205,1,0,1,97,51,51,0
"d0c74f735e024943943e40333d6d337f","983f8ff320594b279a7f4a6fe132f9c5",18524205,1,2,0,98,51,53,2
"983f8ff320594b279a7f4a6fe132f9c5","983f8ff320594b279a7f4a6fe132f9c5",18524205,2,0,1,100,53,53,0
"983f8ff320594b279a7f4a6fe132f9c5","35adfa5d923046aebabfefd98f35ff05",18524205,1,1,0,101,53,54,1
"35adfa5d923046aebabfefd98f35ff05","35adfa5d923046aebabfefd98f35ff05",18524205,5,0,1,102,54,54,0
"35adfa5d923046aebabfefd98f35ff05","b6f8a98476224da1b40e555ececc7ed8",18524205,1,1,0,107,54,55,1
"b6f8a98476224da1b40e555ececc7ed8","b6f8a98476224da1b40e555ececc7ed8",18524205,2,0,1,108,55,55,0
"b6f8a98476224da1b40e555ececc7ed8","86e22cb5fe0e4b47a9489ecddf7ed78f",18524205,1,1,0,110,55,56,1
"86e22cb5fe0e4b47a9489ecddf7ed78f","86e22cb5fe0e4b47a9489ecddf7ed78f",18524205,2,0,1,111,56,56,0
"86e22cb5fe0e4b47a9489ecddf7ed78f","f924752d8a1149668870b1e7698486f7",18524205,1,-6,0,113,56,50,-6
"f924752d8a1149668870b1e7698486f7","a1f2f12debe5432fb7a70bcd12bacfb9",18524205,2,9,0,114,50,58,8
"a1f2f12debe5432fb7a70bcd12bacfb9","78f30e4dcac84e3cbea8b2cc6e0d62b3",18524205,2,1,0,115,58,59,1
"78f30e4dcac84e3cbea8b2cc6e0d62b3","67a089198fcb4e1c8f2385786c2b296f",18524205,1,-25,0,116,59,39,-20
"67a089198fcb4e1c8f2385786c2b296f","64d48c6c9c7940639a932219a6c87198",18524205,3,1,0,117,39,40,1
"64d48c6c9c7940639a932219a6c87198","64d48c6c9c7940639a932219a6c87198",18524205,2,0,1,118,40,40,0
"64d48c6c9c7940639a932219a6c87198","67a089198fcb4e1c8f2385786c2b296f",18524205,2,-1,0,119,40,39,-1
"67a089198fcb4e1c8f2385786c2b296f","b534b89233134e30a9b5645138bfa9ee",18524205,1,4,0,120,39,41,2
"b534b89233134e30a9b5645138bfa9ee","b534b89233134e30a9b5645138bfa9ee",18524205,1,0,1,121,41,41,0
"b534b89233134e30a9b5645138bfa9ee","6e13d61a7bdb44bca949c9f86fab3be5",18524205,3,7,0,122,41,47,6
"6e13d61a7bdb44bca949c9f86fab3be5","d9c8d8c444a64dadbbb508652c721e17",18524205,2,-1,0,123,47,46,-1
"d9c8d8c444a64dadbbb508652c721e17","d9c8d8c444a64dadbbb508652c721e17",18524205,1,0,1,124,46,46,0
"d9c8d8c444a64dadbbb508652c721e17","b534b89233134e30a9b5645138bfa9ee",18524205,1,-6,0,125,46,41,-5
"d9c8d8c444a64dadbbb508652c721e17","d0c74f735e024943943e40333d6d337f",18524205,3,6,0,128,46,51,5
"d0c74f735e024943943e40333d6d337f","f924752d8a1149668870b1e7698486f7",18524205,1,-1,0,129,51,50,-1
"78f30e4dcac84e3cbea8b2cc6e0d62b3","6e13d61a7bdb44bca949c9f86fab3be5",18524205,1,-14,0,132,59,47,-12
"6e13d61a7bdb44bca949c9f86fab3be5","6e13d61a7bdb44bca949c9f86fab3be5",18524205,2,0,1,133,47,47,0
"6e13d61a7bdb44bca949c9f86fab3be5","a1f2f12debe5432fb7a70bcd12bacfb9",18524205,3,13,0,134,47,58,11
"a1f2f12debe5432fb7a70bcd12bacfb9","a1f2f12debe5432fb7a70bcd12bacfb9",18524205,7,0,1,135,58,58,0
"a1f2f12debe5432fb7a70bcd12bacfb9","6e13d61a7bdb44bca949c9f86fab3be5",18524205,3,-13,0,136,58,47,-11
"6e13d61a7bdb44bca949c9f86fab3be5","78f30e4dcac84e3cbea8b2cc6e0d62b3",18524205,1,14,0,147,47,59,12
"78f30e4dcac84e3cbea8b2cc6e0d62b3","78f30e4dcac84e3cbea8b2cc6e0d62b3",18524205,7,0,1,148,59,59,0
"78f30e4dcac84e3cbea8b2cc6e0d62b3","12aa6e1672ac4e7aa6449a7a8609cd72",18524205,1,-2,0,155,59,57,-2
"12aa6e1672ac4e7aa6449a7a8609cd72","bc42d26810654ea9a1df1efe1e58c7d5",18524205,2,7,0,156,57,63,6
"bc42d26810654ea9a1df1efe1e58c7d5","a0a418b8540d479fa6e0f653b701da8b",18524205,4,1,0,157,63,64,1
"a0a418b8540d479fa6e0f653b701da8b","4c943503763e4e349906eea3ed3c8e86",18524205,1,-3,0,158,64,61,-3
"4c943503763e4e349906eea3ed3c8e86","4c943503763e4e349906eea3ed3c8e86",18524205,1,0,1,159,61,61,0
"4c943503763e4e349906eea3ed3c8e86","bc42d26810654ea9a1df1efe1e58c7d5",18524205,1,2,0,160,61,63,2
"bc42d26810654ea9a1df1efe1e58c7d5","bc42d26810654ea9a1df1efe1e58c7d5",18524205,3,0,1,161,63,63,0
"a0a418b8540d479fa6e0f653b701da8b","a0a418b8540d479fa6e0f653b701da8b",18524205,4,0,1,165,64,64,0
"a0a418b8540d479fa6e0f653b701da8b","309ccf3cc4fe429d9bfbaef53d3fa479",18524205,2,-4,0,168,64,60,-4
"309ccf3cc4fe429d9bfbaef53d3fa479","b534b89233134e30a9b5645138bfa9ee",18524205,1,-23,0,169,60,41,-19
"b534b89233134e30a9b5645138bfa9ee","d646286c8051419bbc2e31dd1db55ca8",18524205,1,33,0,170,41,67,26
"d646286c8051419bbc2e31dd1db55ca8","d9c8d8c444a64dadbbb508652c721e17",18524205,1,-27,0,171,67,46,-21
"d0c74f735e024943943e40333d6d337f","78f30e4dcac84e3cbea8b2cc6e0d62b3",18524205,1,9,0,173,51,59,8
"78f30e4dcac84e3cbea8b2cc6e0d62b3","a1f2f12debe5432fb7a70bcd12bacfb9",18524205,1,-1,0,174,59,58,-1
"a1f2f12debe5432fb7a70bcd12bacfb9","f924752d8a1149668870b1e7698486f7",18524205,1,-9,0,175,58,50,-8
"f924752d8a1149668870b1e7698486f7","bc42d26810654ea9a1df1efe1e58c7d5",18524205,1,15,0,176,50,63,13
"bc42d26810654ea9a1df1efe1e58c7d5","12aa6e1672ac4e7aa6449a7a8609cd72",18524205,1,-7,0,177,63,57,-6
"a0a418b8540d479fa6e0f653b701da8b","bc42d26810654ea9a1df1efe1e58c7d5",18524205,1,-1,0,181,64,63,-1
"309ccf3cc4fe429d9bfbaef53d3fa479","d646286c8051419bbc2e31dd1db55ca8",18524205,1,10,0,184,60,67,7
"d646286c8051419bbc2e31dd1db55ca8","b534b89233134e30a9b5645138bfa9ee",18524205,1,-33,0,185,67,41,-26
"b534b89233134e30a9b5645138bfa9ee","267f883678b24aed855fde42524975d9",18524205,1,37,0,186,41,71,30
"267f883678b24aed855fde42524975d9","267f883678b24aed855fde42524975d9",18524205,1,0,1,187,71,71,0
"267f883678b24aed855fde42524975d9","88fff56d0342490dbef9040750a20f6c",18524205,1,1,0,188,71,72,1
"88fff56d0342490dbef9040750a20f6c","88fff56d0342490dbef9040750a20f6c",18524205,1,0,1,189,72,72,0
"88fff56d0342490dbef9040750a20f6c","adb17b12b66c4a49a85fd34322f7df70",18524205,1,1,0,190,72,73,1
"adb17b12b66c4a49a85fd34322f7df70","d646286c8051419bbc2e31dd1db55ca8",18524205,1,-6,0,191,73,67,-6
"d646286c8051419bbc2e31dd1db55ca8","adb17b12b66c4a49a85fd34322f7df70",18524205,1,6,0,192,67,73,6
"adb17b12b66c4a49a85fd34322f7df70","a2becd407db34b189200a32546d9d569",18524205,1,3,0,193,73,75,2
"a2becd407db34b189200a32546d9d569","a2becd407db34b189200a32546d9d569",18524205,1,0,1,194,75,75,0
"a2becd407db34b189200a32546d9d569","58c22b011d0f4c2ea6d13615edbb9eeb",18524205,1,2,0,195,75,77,2
"58c22b011d0f4c2ea6d13615edbb9eeb","58c22b011d0f4c2ea6d13615edbb9eeb",18524205,5,0,1,196,77,77,0
"58c22b011d0f4c2ea6d13615edbb9eeb","dd76e1861dc9461c830888729d091ee0",18524205,1,1,0,201,77,78,1
"dd76e1861dc9461c830888729d091ee0","dd76e1861dc9461c830888729d091ee0",18524205,8,0,1,202,78,78,0
"dd76e1861dc9461c830888729d091ee0","cd1d828f1a694b87913a7ea66c23803e",18524205,1,1,0,210,78,79,1
"cd1d828f1a694b87913a7ea66c23803e","cd1d828f1a694b87913a7ea66c23803e",18524205,2,0,1,211,79,79,0
"cd1d828f1a694b87913a7ea66c23803e","9176a3c2b4d2465fa8b0c67096c2a97e",18524205,1,1,0,213,79,80,1
"9176a3c2b4d2465fa8b0c67096c2a97e","9176a3c2b4d2465fa8b0c67096c2a97e",18524205,5,0,1,214,80,80,0
"9176a3c2b4d2465fa8b0c67096c2a97e","f8ec6445f7194e25b9101d4fbcb07a18",18524205,1,1,0,219,80,81,1
"f8ec6445f7194e25b9101d4fbcb07a18","f8ec6445f7194e25b9101d4fbcb07a18",18524205,2,0,1,220,81,81,0
"f8ec6445f7194e25b9101d4fbcb07a18","140d5b27b8574befad82c0a013b59dfa",18524205,1,-7,0,222,81,74,-7
"140d5b27b8574befad82c0a013b59dfa","d18a9ea32855445f8736581f5cb119ce",18524205,1,9,0,223,74,82,8
"d18a9ea32855445f8736581f5cb119ce","f564483cbd7a407681aa2fcca518cf5f",18524205,1,4,0,224,82,85,3
"f564483cbd7a407681aa2fcca518cf5f","f564483cbd7a407681aa2fcca518cf5f",18524205,4,0,1,225,85,85,0
"f564483cbd7a407681aa2fcca518cf5f","18fd01350bd5434ca636d59a599d768a",18524205,1,1,0,229,85,86,1
"18fd01350bd5434ca636d59a599d768a","18fd01350bd5434ca636d59a599d768a",18524205,9,0,1,230,86,86,0
"18fd01350bd5434ca636d59a599d768a","ae5ac430ea254e708a6f5deaaf7464ae",18524205,1,-2,0,239,86,84,-2
"ae5ac430ea254e708a6f5deaaf7464ae","6a9f0ef185fb47f0937e29daa1c71ed5",18524205,1,7,0,240,84,90,6
"6a9f0ef185fb47f0937e29daa1c71ed5","c681290961c94c4caf23b529d1ae6b9a",18524205,1,-2,0,241,90,88,-2
"c681290961c94c4caf23b529d1ae6b9a","c681290961c94c4caf23b529d1ae6b9a",18524205,1,0,1,242,88,88,0
"c681290961c94c4caf23b529d1ae6b9a","6a9f0ef185fb47f0937e29daa1c71ed5",18524205,1,2,0,243,88,90,2
"6a9f0ef185fb47f0937e29daa1c71ed5","6a9f0ef185fb47f0937e29daa1c71ed5",18524205,3,0,1,244,90,90,0
"6a9f0ef185fb47f0937e29daa1c71ed5","e20db35ced8544ddac5bc3839145e463",18524205,1,3,0,247,90,91,1
"e20db35ced8544ddac5bc3839145e463","d646286c8051419bbc2e31dd1db55ca8",18524205,1,-30,0,248,91,67,-24
"d646286c8051419bbc2e31dd1db55ca8","1febb706d7a34005ae8711ed49c76e64",18524205,1,33,0,249,67,94,27
"1febb706d7a34005ae8711ed49c76e64","1febb706d7a34005ae8711ed49c76e64",18524205,2,0,1,250,94,94,0
"1febb706d7a34005ae8711ed49c76e64","8f73ba6f5a0042f2850356ac38ac6f24",18524205,1,1,0,252,94,95,1
"8f73ba6f5a0042f2850356ac38ac6f24","8f73ba6f5a0042f2850356ac38ac6f24",18524205,5,0,1,253,95,95,0
"8f73ba6f5a0042f2850356ac38ac6f24","e2260b86653c46d7b14a41fb419dbf8c",18524205,1,1,0,258,95,96,1
"e2260b86653c46d7b14a41fb419dbf8c","e2260b86653c46d7b14a41fb419dbf8c",18524205,2,0,1,259,96,96,0
"e2260b86653c46d7b14a41fb419dbf8c","35eb641ad1d845bbba54915bce75a962",18524205,1,1,0,261,96,97,1
"35eb641ad1d845bbba54915bce75a962","35eb641ad1d845bbba54915bce75a962",18524205,2,0,1,262,97,97,0
"35eb641ad1d845bbba54915bce75a962","08be90ffbeea4795a138cd42ed8db56f",18524205,1,1,0,264,97,98,1
"08be90ffbeea4795a138cd42ed8db56f","08be90ffbeea4795a138cd42ed8db56f",18524205,5,0,1,265,98,98,0
"08be90ffbeea4795a138cd42ed8db56f","3007433c8f584dcbb5ac159c1c5f2be3",18524205,1,1,0,270,98,99,1
"3007433c8f584dcbb5ac159c1c5f2be3","3007433c8f584dcbb5ac159c1c5f2be3",18524205,2,0,1,271,99,99,0
"3007433c8f584dcbb5ac159c1c5f2be3","00ae5f0c51874a73a41ebea838d95682",18524205,1,3,0,273,99,101,2
"00ae5f0c51874a73a41ebea838d95682","e20db35ced8544ddac5bc3839145e463",18524205,1,-11,0,274,101,91,-10
"e20db35ced8544ddac5bc3839145e463","d391c8b6e56a43a7b654e9dee02d904b",18524205,1,13,0,275,91,103,12
"d391c8b6e56a43a7b654e9dee02d904b","00ae5f0c51874a73a41ebea838d95682",18524205,1,-2,0,276,103,101,-2
"00ae5f0c51874a73a41ebea838d95682","d391c8b6e56a43a7b654e9dee02d904b",18524205,1,2,0,277,101,103,2
"d391c8b6e56a43a7b654e9dee02d904b","d391c8b6e56a43a7b654e9dee02d904b",18524205,16,0,1,278,103,103,0
"d391c8b6e56a43a7b654e9dee02d904b","6111116566fc4fd9abba409322bea245",18524205,1,1,0,294,103,104,1
"6111116566fc4fd9abba409322bea245","6111116566fc4fd9abba409322bea245",18524205,2,0,1,295,104,104,0
"6111116566fc4fd9abba409322bea245","a81b2235cb9c499eb9ea8ee0a8dd9725",18524205,1,1,0,297,104,105,1
"a81b2235cb9c499eb9ea8ee0a8dd9725","a81b2235cb9c499eb9ea8ee0a8dd9725",18524205,5,0,1,298,105,105,0
"a81b2235cb9c499eb9ea8ee0a8dd9725","2d4e0ab0ef3b4d73b82c72d4621a7579",18524205,1,1,0,303,105,106,1
"2d4e0ab0ef3b4d73b82c72d4621a7579","2d4e0ab0ef3b4d73b82c72d4621a7579",18524205,2,0,1,304,106,106,0
"2d4e0ab0ef3b4d73b82c72d4621a7579","8bdebf492ebd4e62b0d522e8ab5e5197",18524205,1,1,0,306,106,107,1
"8bdebf492ebd4e62b0d522e8ab5e5197","8bdebf492ebd4e62b0d522e8ab5e5197",18524205,2,0,1,307,107,107,0
"8bdebf492ebd4e62b0d522e8ab5e5197","4280927ec4d643238aa49c32f9e06c6c",18524205,1,3,0,309,107,109,2
"4280927ec4d643238aa49c32f9e06c6c","73039f8c1eb9409cb4caee2cf968001e",18524205,1,-10,0,310,109,100,-9
"73039f8c1eb9409cb4caee2cf968001e","4280927ec4d643238aa49c32f9e06c6c",18524205,1,10,0,311,100,109,9
"4280927ec4d643238aa49c32f9e06c6c","fc44e6a5f7654430af1227838224dceb",18524205,1,2,0,312,109,111,2
"fc44e6a5f7654430af1227838224dceb","fc44e6a5f7654430af1227838224dceb",18524205,5,0,1,313,111,111,0
"fc44e6a5f7654430af1227838224dceb","a9ae0a3c070d455bb4369a8996313336",18524205,1,4,0,318,111,114,3
"a9ae0a3c070d455bb4369a8996313336","08111f75e22d409998cf8b85bd431f0a",18524205,1,-7,0,319,114,108,-6
"08111f75e22d409998cf8b85bd431f0a","a9ae0a3c070d455bb4369a8996313336",18524205,1,7,0,320,108,114,6
"a9ae0a3c070d455bb4369a8996313336","a9ae0a3c070d455bb4369a8996313336",18524205,2,0,1,321,114,114,0
"a9ae0a3c070d455bb4369a8996313336","e20db35ced8544ddac5bc3839145e463",18524205,1,-26,0,323,114,91,-23
"e20db35ced8544ddac5bc3839145e463","a9ae0a3c070d455bb4369a8996313336",18524205,1,26,0,324,91,114,23
"a9ae0a3c070d455bb4369a8996313336","71cec822bcff4f30a20e75dc63ef7b65",18524205,1,2,0,325,114,116,2
"71cec822bcff4f30a20e75dc63ef7b65","71cec822bcff4f30a20e75dc63ef7b65",18524205,3,0,1,326,116,116,0
"71cec822bcff4f30a20e75dc63ef7b65","62bff51286ef4f348717a3cf6fe2318f",18524205,1,5,0,329,116,120,4
"62bff51286ef4f348717a3cf6fe2318f","37319e88176d4aefa91d7a9980dbae91",18524205,1,-9,0,330,120,112,-8
"37319e88176d4aefa91d7a9980dbae91","e20db35ced8544ddac5bc3839145e463",18524205,1,-24,0,331,112,91,-21
"e20db35ced8544ddac5bc3839145e463","e20db35ced8544ddac5bc3839145e463",18524205,1,0,1,332,91,91,0
"e20db35ced8544ddac5bc3839145e463","3ec3a3563847406fa73338f9e9999cf3",18524205,1,30,0,333,91,117,26
"3ec3a3563847406fa73338f9e9999cf3","62bff51286ef4f348717a3cf6fe2318f",18524205,1,3,0,334,117,120,3
"62bff51286ef4f348717a3cf6fe2318f","b1cd0e7dc3ad4a8eb91a4bfdbeb025b0",18524205,1,-2,0,335,120,118,-2
"b1cd0e7dc3ad4a8eb91a4bfdbeb025b0","b1cd0e7dc3ad4a8eb91a4bfdbeb025b0",18524205,3,0,1,336,118,118,0
"b1cd0e7dc3ad4a8eb91a4bfdbeb025b0","62bff51286ef4f348717a3cf6fe2318f",18524205,1,2,0,339,118,120,2
"62bff51286ef4f348717a3cf6fe2318f","62bff51286ef4f348717a3cf6fe2318f",18524205,3,0,1,340,120,120,0
"62bff51286ef4f348717a3cf6fe2318f","e20db35ced8544ddac5bc3839145e463",18524205,1,-33,0,343,120,91,-29
"e20db35ced8544ddac5bc3839145e463","779f9ddd1fd14d1e9e69f72219a1fdbd",18524205,1,36,0,344,91,121,30
"779f9ddd1fd14d1e9e69f72219a1fdbd","ae26e6cda8ad4a3f81bd347560d9579f",18524205,1,4,0,345,121,125,4
"ae26e6cda8ad4a3f81bd347560d9579f","ae26e6cda8ad4a3f81bd347560d9579f",18524205,3,0,1,346,125,125,0
"ae26e6cda8ad4a3f81bd347560d9579f","ee48df95832b4374aa273ceb27ec1315",18524205,1,1,0,349,125,126,1
"ee48df95832b4374aa273ceb27ec1315","ee48df95832b4374aa273ceb27ec1315",18524205,1,0,1,350,126,126,0
"ee48df95832b4374aa273ceb27ec1315","7a439da90b394756ad1777fc4c6dead5",18524205,1,1,0,351,126,127,1
"7a439da90b394756ad1777fc4c6dead5","7a439da90b394756ad1777fc4c6dead5",18524205,1,0,1,352,127,127,0
"7a439da90b394756ad1777fc4c6dead5","779f9ddd1fd14d1e9e69f72219a1fdbd",18524205,1,-6,0,353,127,121,-6
"779f9ddd1fd14d1e9e69f72219a1fdbd","a8dd5213034441ac92724b4e83eb0bb2",18524205,1,9,0,354,121,129,8
"a8dd5213034441ac92724b4e83eb0bb2","a8dd5213034441ac92724b4e83eb0bb2",18524205,1,0,1,355,129,129,0
"a8dd5213034441ac92724b4e83eb0bb2","8115eab6556b45f5b415c3b8c26a12e5",18524205,1,2,0,356,129,131,2
"8115eab6556b45f5b415c3b8c26a12e5","8115eab6556b45f5b415c3b8c26a12e5",18524205,2,0,1,357,131,131,0
"8115eab6556b45f5b415c3b8c26a12e5","ec34b06efd844b46a4c4818ecdb9b8f4",18524205,1,1,0,359,131,132,1
"ec34b06efd844b46a4c4818ecdb9b8f4","ec34b06efd844b46a4c4818ecdb9b8f4",18524205,2,0,1,360,132,132,0
"ec34b06efd844b46a4c4818ecdb9b8f4","c2e1c2b9eac64109b343a088584b576b",18524205,1,1,0,362,132,133,1
"c2e1c2b9eac64109b343a088584b576b","c2e1c2b9eac64109b343a088584b576b",18524205,2,0,1,363,133,133,0
"c2e1c2b9eac64109b343a088584b576b","579338175e0b4bbb8ef3b712b5d8b54e",18524205,1,-5,0,365,133,128,-5
"579338175e0b4bbb8ef3b712b5d8b54e","8bc5795d6a984a3eace4e2811e52dd4f",18524205,1,8,0,366,128,135,7
"8bc5795d6a984a3eace4e2811e52dd4f","8bc5795d6a984a3eace4e2811e52dd4f",18524205,3,0,1,367,135,135,0
"8bc5795d6a984a3eace4e2811e52dd4f","b416d47c56a742199b5d7c7f19d6503a",18524205,1,-1,0,370,135,134,-1
"b416d47c56a742199b5d7c7f19d6503a","cd4532ad48034873ba8bce2aac0c9808",18524205,1,4,0,371,134,137,3
"cd4532ad48034873ba8bce2aac0c9808","cd4532ad48034873ba8bce2aac0c9808",18524205,3,0,1,372,137,137,0
"cd4532ad48034873ba8bce2aac0c9808","779f9ddd1fd14d1e9e69f72219a1fdbd",18524205,1,-19,0,375,137,121,-16
"779f9ddd1fd14d1e9e69f72219a1fdbd","df1de691dafe4549a18a4398ee9dfaf9",18524205,1,23,0,376,121,139,18
"df1de691dafe4549a18a4398ee9dfaf9","6c5ad271a44743479bfaea29b1db8d02",18524205,1,4,0,377,139,143,4
"6c5ad271a44743479bfaea29b1db8d02","e20db35ced8544ddac5bc3839145e463",18524205,1,-63,0,378,143,91,-52
"e20db35ced8544ddac5bc3839145e463","6c5ad271a44743479bfaea29b1db8d02",18524205,1,63,0,379,91,143,52
"6c5ad271a44743479bfaea29b1db8d02","83d311bed5374fee83d8d67a7d9d82dc",18524205,1,1,0,380,143,144,1
"83d311bed5374fee83d8d67a7d9d82dc","83d311bed5374fee83d8d67a7d9d82dc",18524205,1,0,1,381,144,144,0
"83d311bed5374fee83d8d67a7d9d82dc","402bba41861d43acb52a5abb89e8831e",18524205,1,1,0,382,144,145,1
"402bba41861d43acb52a5abb89e8831e","402bba41861d43acb52a5abb89e8831e",18524205,2,0,1,383,145,145,0
"402bba41861d43acb52a5abb89e8831e","8aae34f5ddbb4052a709b12e6b0d40fa",18524205,1,3,0,385,145,147,2
"8aae34f5ddbb4052a709b12e6b0d40fa","df1de691dafe4549a18a4398ee9dfaf9",18524205,1,-9,0,386,147,139,-8
"df1de691dafe4549a18a4398ee9dfaf9","8aae34f5ddbb4052a709b12e6b0d40fa",18524205,1,9,0,387,139,147,8
"8aae34f5ddbb4052a709b12e6b0d40fa","645b3f0249f64f76af2e19eb4d0e55b7",18524205,1,2,0,388,147,149,2
"645b3f0249f64f76af2e19eb4d0e55b7","645b3f0249f64f76af2e19eb4d0e55b7",18524205,5,0,1,389,149,149,0
"645b3f0249f64f76af2e19eb4d0e55b7","7e7b8db5064d4369805ab370aac5ddfb",18524205,1,1,0,394,149,150,1
"7e7b8db5064d4369805ab370aac5ddfb","7e7b8db5064d4369805ab370aac5ddfb",18524205,2,0,1,395,150,150,0
"7e7b8db5064d4369805ab370aac5ddfb","8956d210ae7f41968fada86d4c979d6a",18524205,1,1,0,397,150,151,1
"8956d210ae7f41968fada86d4c979d6a","8956d210ae7f41968fada86d4c979d6a",18524205,2,0,1,398,151,151,0
"8956d210ae7f41968fada86d4c979d6a","f902b0f41b544d4dbf79664fd233648d",18524205,1,-5,0,400,151,146,-5
"f902b0f41b544d4dbf79664fd233648d","ae781e8b775e4ccd93bc800dad5c8376",18524205,1,8,0,401,146,153,7
"ae781e8b775e4ccd93bc800dad5c8376","ae781e8b775e4ccd93bc800dad5c8376",18524205,2,0,1,402,153,153,0
"ae781e8b775e4ccd93bc800dad5c8376","06882a8492d9499aa31555567f575ecb",18524205,1,1,0,404,153,154,1
"06882a8492d9499aa31555567f575ecb","06882a8492d9499aa31555567f575ecb",18524205,1,0,1,405,154,154,0
"06882a8492d9499aa31555567f575ecb","f293c508f409466a8f27ddd7d1e40b20",18524205,1,1,0,406,154,155,1
"f293c508f409466a8f27ddd7d1e40b20","f293c508f409466a8f27ddd7d1e40b20",18524205,9,0,1,407,155,155,0
"f293c508f409466a8f27ddd7d1e40b20","cc4ddef5bbbe48ebb605141b347c4ed1",18524205,1,1,0,416,155,156,1
"cc4ddef5bbbe48ebb605141b347c4ed1","f03480cf4eba413194d7af52fc0e7f28",18524205,1,-4,0,417,156,152,-4
"f03480cf4eba413194d7af52fc0e7f28","cc4ddef5bbbe48ebb605141b347c4ed1",18524205,1,4,0,418,152,156,4
"cc4ddef5bbbe48ebb605141b347c4ed1","d313cec988a84645bee413e8d4724a4b",18524205,1,3,0,419,156,158,2
"d313cec988a84645bee413e8d4724a4b","d313cec988a84645bee413e8d4724a4b",18524205,4,0,1,420,158,158,0
"d313cec988a84645bee413e8d4724a4b","dc60696c76a74368a60f72246e47700d",18524205,1,1,0,424,158,159,1
"dc60696c76a74368a60f72246e47700d","dc60696c76a74368a60f72246e47700d",18524205,1,0,1,425,159,159,0
"dc60696c76a74368a60f72246e47700d","df1de691dafe4549a18a4398ee9dfaf9",18524205,1,-23,0,426,159,139,-20
"df1de691dafe4549a18a4398ee9dfaf9","78adeee1fa2c4fe0bc73f7bca9fcee86",18524205,1,26,0,427,139,160,21
"78adeee1fa2c4fe0bc73f7bca9fcee86","78adeee1fa2c4fe0bc73f7bca9fcee86",18524205,3,0,1,428,160,160,0
"78adeee1fa2c4fe0bc73f7bca9fcee86","65202579580f4ad38d734b4ee39d22a8",18524205,2,5,0,429,160,164,4
"65202579580f4ad38d734b4ee39d22a8","65202579580f4ad38d734b4ee39d22a8",18524205,53,0,1,430,164,164,0
"65202579580f4ad38d734b4ee39d22a8","78adeee1fa2c4fe0bc73f7bca9fcee86",18524205,1,-5,0,437,164,160,-4
"65202579580f4ad38d734b4ee39d22a8","3cbcea2be0984e7dbd5a48195af10ce7",18524205,1,3,0,485,164,165,1
"3cbcea2be0984e7dbd5a48195af10ce7","78adeee1fa2c4fe0bc73f7bca9fcee86",18524205,1,-8,0,486,165,160,-5
"78adeee1fa2c4fe0bc73f7bca9fcee86","82e6285962b8400d9d6fc32436022a94",18524205,1,10,0,487,160,167,7
"82e6285962b8400d9d6fc32436022a94","a9ac840f098c4bd0a2ee896214ce29cd",18524205,1,3,0,488,167,168,1
"a9ac840f098c4bd0a2ee896214ce29cd","3cbcea2be0984e7dbd5a48195af10ce7",18524205,1,-5,0,489,168,165,-3
"3cbcea2be0984e7dbd5a48195af10ce7","a9ac840f098c4bd0a2ee896214ce29cd",18524205,1,5,0,490,165,168,3
"a9ac840f098c4bd0a2ee896214ce29cd","0c7262dff33c4087bc660ccf40f92f9c",18524205,1,4,0,491,168,169,1
"0c7262dff33c4087bc660ccf40f92f9c","b2275c3fad834f8d90737a2d9a6927d6",18524205,2,3,0,492,169,172,3
"b2275c3fad834f8d90737a2d9a6927d6","b2275c3fad834f8d90737a2d9a6927d6",18524205,26,0,1,493,172,172,0
"b2275c3fad834f8d90737a2d9a6927d6","eb515a26030b41f8a82a1e6114420bad",18524205,1,1,0,519,172,173,1
"eb515a26030b41f8a82a1e6114420bad","eb515a26030b41f8a82a1e6114420bad",18524205,2,0,1,520,173,173,0
"eb515a26030b41f8a82a1e6114420bad","b42cc17b7de840f181a704558d0bc845",18524205,1,3,0,522,173,175,2
"b42cc17b7de840f181a704558d0bc845","0c7262dff33c4087bc660ccf40f92f9c",18524205,1,-7,0,523,175,169,-6
"0c7262dff33c4087bc660ccf40f92f9c","0c7262dff33c4087bc660ccf40f92f9c",18524205,2,0,1,524,169,169,0
"b2275c3fad834f8d90737a2d9a6927d6","0c7262dff33c4087bc660ccf40f92f9c",18524205,1,-3,0,527,172,169,-3
"0c7262dff33c4087bc660ccf40f92f9c","b42cc17b7de840f181a704558d0bc845",18524205,2,7,0,528,169,175,6
"b42cc17b7de840f181a704558d0bc845","b42cc17b7de840f181a704558d0bc845",18524205,2,0,1,529,175,175,0
"b42cc17b7de840f181a704558d0bc845","801f9e9135034f49bf5f8b4bdefedb41",18524205,1,2,0,530,175,177,2
"801f9e9135034f49bf5f8b4bdefedb41","801f9e9135034f49bf5f8b4bdefedb41",18524205,8,0,1,531,177,177,0
"801f9e9135034f49bf5f8b4bdefedb41","362fcb0699a14845ab29b2340093e528",18524205,1,-3,0,539,177,174,-3
"362fcb0699a14845ab29b2340093e528","b87c552dd247427abe6ab5795b9c9d43",18524205,1,8,0,540,174,181,7
"b87c552dd247427abe6ab5795b9c9d43","ea38cc0e6e6e41edbabf210220808bf9",18524205,2,-2,0,541,181,179,-2
"ea38cc0e6e6e41edbabf210220808bf9","ea38cc0e6e6e41edbabf210220808bf9",18524205,1,0,1,542,179,179,0
"ea38cc0e6e6e41edbabf210220808bf9","b87c552dd247427abe6ab5795b9c9d43",18524205,3,2,0,543,179,181,2
"b87c552dd247427abe6ab5795b9c9d43","b87c552dd247427abe6ab5795b9c9d43",18524205,7,0,1,544,181,181,0
"b87c552dd247427abe6ab5795b9c9d43","139b097acfca451689d80c9c6eebdf7b",18524205,2,-3,0,551,181,178,-3
"139b097acfca451689d80c9c6eebdf7b","30f660a1feb34582a739722532524f79",18524205,1,6,0,552,178,183,5
"30f660a1feb34582a739722532524f79","30f660a1feb34582a739722532524f79",18524205,3,0,1,553,183,183,0
"30f660a1feb34582a739722532524f79","2024b4885bd14338a39b7b509acbbd02",18524205,1,-1,0,556,183,182,-1
"2024b4885bd14338a39b7b509acbbd02","c3f63fe50d8e487c86bf8ef76c9cadd3",18524205,1,4,0,557,182,185,3
"c3f63fe50d8e487c86bf8ef76c9cadd3","c3f63fe50d8e487c86bf8ef76c9cadd3",18524205,1,0,1,558,185,185,0
"c3f63fe50d8e487c86bf8ef76c9cadd3","c8e371568a0c4391b25796ae4e91952e",18524205,1,3,0,559,185,186,1
"c8e371568a0c4391b25796ae4e91952e","0c7262dff33c4087bc660ccf40f92f9c",18524205,1,-23,0,560,186,169,-17
"0c7262dff33c4087bc660ccf40f92f9c","7d932b23e1c84326ae5aa4d3c0d813d1",18524205,1,25,0,561,169,188,19
"7d932b23e1c84326ae5aa4d3c0d813d1","7d932b23e1c84326ae5aa4d3c0d813d1",18524205,3,0,1,562,188,188,0
"7d932b23e1c84326ae5aa4d3c0d813d1","c8e371568a0c4391b25796ae4e91952e",18524205,1,-2,0,565,188,186,-2
"c8e371568a0c4391b25796ae4e91952e","ab11d94c6c8948ea90b88f19d2cd502b",18524205,1,5,0,566,186,190,4
"ab11d94c6c8948ea90b88f19d2cd502b","ab11d94c6c8948ea90b88f19d2cd502b",18524205,1,0,1,567,190,190,0
"ab11d94c6c8948ea90b88f19d2cd502b","f992451ed6ad4e68bb9e68ad6be7c4be",18524205,1,2,0,568,190,192,2
"f992451ed6ad4e68bb9e68ad6be7c4be","6cd2dcaac46847d4a0bc53f296d90375",18524205,2,3,0,569,192,194,2
"6cd2dcaac46847d4a0bc53f296d90375","07b44a7a51e94c78b411c753fc39dab0",18524205,1,-6,0,570,194,189,-5
"07b44a7a51e94c78b411c753fc39dab0","f992451ed6ad4e68bb9e68ad6be7c4be",18524205,1,3,0,571,189,192,3
"6cd2dcaac46847d4a0bc53f296d90375","2d2580c9411c4972909db508d6956a58",18524205,1,2,0,573,194,196,2
"2d2580c9411c4972909db508d6956a58","2d2580c9411c4972909db508d6956a58",18524205,2,0,1,574,196,196,0
"2d2580c9411c4972909db508d6956a58","5bddb3d9ed264f3984702f048c7e5340",18524205,1,1,0,576,196,197,1
"5bddb3d9ed264f3984702f048c7e5340","5bddb3d9ed264f3984702f048c7e5340",18524205,2,0,1,577,197,197,0
"5bddb3d9ed264f3984702f048c7e5340","d5e8e2bd12a2466b9d6d90855f0eb079",18524205,1,1,0,579,197,198,1
"d5e8e2bd12a2466b9d6d90855f0eb079","d5e8e2bd12a2466b9d6d90855f0eb079",18524205,2,0,1,580,198,198,0
"d5e8e2bd12a2466b9d6d90855f0eb079","017d7ca8e0394b91aaadc9574df2202c",18524205,1,-5,0,582,198,193,-5
"017d7ca8e0394b91aaadc9574df2202c","54e8e9f0ea3e45c4bf3b8ac799ee31b1",18524205,1,8,0,583,193,200,7
"54e8e9f0ea3e45c4bf3b8ac799ee31b1","54e8e9f0ea3e45c4bf3b8ac799ee31b1",18524205,1,0,1,584,200,200,0
"54e8e9f0ea3e45c4bf3b8ac799ee31b1","c614a00911be4877a075f19315530fb0",18524205,1,1,0,585,200,201,1
"c614a00911be4877a075f19315530fb0","c614a00911be4877a075f19315530fb0",18524205,6,0,1,586,201,201,0
"c614a00911be4877a075f19315530fb0","a6c21bd8b95249c7972820a7a7d76aff",18524205,1,1,0,592,201,202,1
"a6c21bd8b95249c7972820a7a7d76aff","a6c21bd8b95249c7972820a7a7d76aff",18524205,1,0,1,593,202,202,0
"a6c21bd8b95249c7972820a7a7d76aff","bb329d880ab54120adaf203a693bb203",18524205,1,1,0,594,202,203,1
"bb329d880ab54120adaf203a693bb203","bb329d880ab54120adaf203a693bb203",18524205,1,0,1,595,203,203,0
"bb329d880ab54120adaf203a693bb203","f9170dd6bc6442b4acd832747609b09a",18524205,1,-4,0,596,203,199,-4
"f9170dd6bc6442b4acd832747609b09a","334c2344009840079b1d0e1b7ce3d5a7",18524205,2,7,0,597,199,205,6
"334c2344009840079b1d0e1b7ce3d5a7","334c2344009840079b1d0e1b7ce3d5a7",18524205,2,0,1,598,205,205,0
"334c2344009840079b1d0e1b7ce3d5a7","d7f13c8d63ec4e2aa673fbb9cf9c6933",18524205,1,3,0,599,205,206,1
"d7f13c8d63ec4e2aa673fbb9cf9c6933","c8e371568a0c4391b25796ae4e91952e",18524205,2,-26,0,600,206,186,-20
"c8e371568a0c4391b25796ae4e91952e","7108f0e4c2584f1f9c471689ae4c885c",18524205,1,28,0,601,186,208,22
"7108f0e4c2584f1f9c471689ae4c885c","b9e80f77c3a44349863b19875725c384",18524205,2,-1,0,602,208,207,-1
"b9e80f77c3a44349863b19875725c384","0d987bed3ffa4ed0b9a2e62e97b7b30f",18524205,1,85,0,603,207,272,65
"0d987bed3ffa4ed0b9a2e62e97b7b30f","0d987bed3ffa4ed0b9a2e62e97b7b30f",18524205,3,0,1,604,272,272,0
"0d987bed3ffa4ed0b9a2e62e97b7b30f","82ae07bc0c9b4570a41799290d1ef399",18524205,4,4,0,605,272,275,3
"82ae07bc0c9b4570a41799290d1ef399","bb5a47f5ea01454a8b79455422d3b9da",18524205,2,6,0,606,275,280,5
"bb5a47f5ea01454a8b79455422d3b9da","0d987bed3ffa4ed0b9a2e62e97b7b30f",18524205,1,-10,0,614,280,272,-8
"0d987bed3ffa4ed0b9a2e62e97b7b30f","d7f13c8d63ec4e2aa673fbb9cf9c6933",18524205,1,-86,0,615,272,206,-66
"d7f13c8d63ec4e2aa673fbb9cf9c6933","bb5a47f5ea01454a8b79455422d3b9da",18524205,1,96,0,616,206,280,74
"bb5a47f5ea01454a8b79455422d3b9da","b9e80f77c3a44349863b19875725c384",18524205,1,-95,0,624,280,207,-73
"b9e80f77c3a44349863b19875725c384","7108f0e4c2584f1f9c471689ae4c885c",18524205,4,1,0,625,207,208,1
"b9e80f77c3a44349863b19875725c384","b9e80f77c3a44349863b19875725c384",18524205,17,0,1,627,207,207,0
"7108f0e4c2584f1f9c471689ae4c885c","7108f0e4c2584f1f9c471689ae4c885c",18524205,12,0,1,645,208,208,0
"7108f0e4c2584f1f9c471689ae4c885c","09400e101c5d4b439cf9a26b03aae558",18524205,1,3,0,657,208,210,2
"09400e101c5d4b439cf9a26b03aae558","d7f13c8d63ec4e2aa673fbb9cf9c6933",18524205,1,-5,0,658,210,206,-4
"d7f13c8d63ec4e2aa673fbb9cf9c6933","09400e101c5d4b439cf9a26b03aae558",18524205,1,5,0,659,206,210,4
"09400e101c5d4b439cf9a26b03aae558","a88efa7e50ce47159810ab553afa6d3a",18524205,1,2,0,660,210,212,2
"a88efa7e50ce47159810ab553afa6d3a","a88efa7e50ce47159810ab553afa6d3a",18524205,5,0,1,661,212,212,0
"a88efa7e50ce47159810ab553afa6d3a","be502a7a43c44bf7b682698de79d9369",18524205,1,3,0,666,212,214,2
"be502a7a43c44bf7b682698de79d9369","a875096404ef4a9984b62d74cda916f9",18524205,1,-6,0,667,214,209,-5
"a875096404ef4a9984b62d74cda916f9","f7fb1952f56b4189b86a9f8b7862d2b8",18524205,1,7,0,668,209,215,6
"f7fb1952f56b4189b86a9f8b7862d2b8","be502a7a43c44bf7b682698de79d9369",18524205,1,-1,0,669,215,214,-1
"be502a7a43c44bf7b682698de79d9369","f7fb1952f56b4189b86a9f8b7862d2b8",18524205,1,1,0,670,214,215,1
"f7fb1952f56b4189b86a9f8b7862d2b8","f7fb1952f56b4189b86a9f8b7862d2b8",18524205,11,0,1,671,215,215,0
"f7fb1952f56b4189b86a9f8b7862d2b8","b860ee85d8bc4a2f97958cfb71be3533",18524205,1,1,0,682,215,216,1
"b860ee85d8bc4a2f97958cfb71be3533","b860ee85d8bc4a2f97958cfb71be3533",18524205,2,0,1,683,216,216,0
"b860ee85d8bc4a2f97958cfb71be3533","363837c182e04711840d896ae1e0339c",18524205,1,3,0,685,216,218,2
"363837c182e04711840d896ae1e0339c","ec341f459285443b8361f7f15638ff08",18524205,1,-6,0,686,218,213,-5
"ec341f459285443b8361f7f15638ff08","363837c182e04711840d896ae1e0339c",18524205,1,6,0,687,213,218,5
"363837c182e04711840d896ae1e0339c","363837c182e04711840d896ae1e0339c",18524205,11,0,1,688,218,218,0
"363837c182e04711840d896ae1e0339c","01b2051f8941460d89945e3b02d1ce78",18524205,1,-1,0,699,218,217,-1
"01b2051f8941460d89945e3b02d1ce78","91125ca626c5470eb145501f8c37f8db",18524205,1,4,0,700,217,220,3
"91125ca626c5470eb145501f8c37f8db","91125ca626c5470eb145501f8c37f8db",18524205,1,0,1,701,220,220,0
"91125ca626c5470eb145501f8c37f8db","1c6721b1f63f4d30ba7746ea8af02a52",18524205,1,3,0,702,220,221,1
"1c6721b1f63f4d30ba7746ea8af02a52","d7f13c8d63ec4e2aa673fbb9cf9c6933",18524205,1,-21,0,703,221,206,-15
"d7f13c8d63ec4e2aa673fbb9cf9c6933","77ecef8eff6b4a2caea7707669bf7475",18524205,1,22,0,704,206,222,16
"77ecef8eff6b4a2caea7707669bf7475","77ecef8eff6b4a2caea7707669bf7475",18524205,12,0,1,705,222,222,0
"77ecef8eff6b4a2caea7707669bf7475","1c6721b1f63f4d30ba7746ea8af02a52",18524205,1,-1,0,717,222,221,-1
"1c6721b1f63f4d30ba7746ea8af02a52","8b9ae98743bd4d4a8a87dff1c1244211",18524205,2,7,0,718,221,227,6
"8b9ae98743bd4d4a8a87dff1c1244211","d03cb855c70044cf8c35d9ec0de696e3",18524205,2,-3,0,719,227,224,-3
"d03cb855c70044cf8c35d9ec0de696e3","0d987bed3ffa4ed0b9a2e62e97b7b30f",18524205,1,61,0,720,224,272,48
"bb5a47f5ea01454a8b79455422d3b9da","c8e371568a0c4391b25796ae4e91952e",18524205,1,-122,0,729,280,186,-94
"c8e371568a0c4391b25796ae4e91952e","017d7ca8e0394b91aaadc9574df2202c",18524205,1,9,0,730,186,193,7
"017d7ca8e0394b91aaadc9574df2202c","6cd2dcaac46847d4a0bc53f296d90375",18524205,1,1,0,731,193,194,1
"6cd2dcaac46847d4a0bc53f296d90375","017d7ca8e0394b91aaadc9574df2202c",18524205,2,-1,0,732,194,193,-1
"017d7ca8e0394b91aaadc9574df2202c","f9170dd6bc6442b4acd832747609b09a",18524205,2,7,0,733,193,199,6
"f9170dd6bc6442b4acd832747609b09a","d7f13c8d63ec4e2aa673fbb9cf9c6933",18524205,1,10,0,734,199,206,7
"c8e371568a0c4391b25796ae4e91952e","b9e80f77c3a44349863b19875725c384",18524205,1,27,0,736,186,207,21
"7108f0e4c2584f1f9c471689ae4c885c","d7f13c8d63ec4e2aa673fbb9cf9c6933",18524205,2,-2,0,738,208,206,-2
"d7f13c8d63ec4e2aa673fbb9cf9c6933","0c7262dff33c4087bc660ccf40f92f9c",18524205,1,-49,0,739,206,169,-37
"0c7262dff33c4087bc660ccf40f92f9c","ea38cc0e6e6e41edbabf210220808bf9",18524205,1,12,0,740,169,179,10
"139b097acfca451689d80c9c6eebdf7b","2024b4885bd14338a39b7b509acbbd02",18524205,1,5,0,743,178,182,4
"2024b4885bd14338a39b7b509acbbd02","0c7262dff33c4087bc660ccf40f92f9c",18524205,1,-16,0,744,182,169,-13
"0c7262dff33c4087bc660ccf40f92f9c","c8e371568a0c4391b25796ae4e91952e",18524205,1,23,0,745,169,186,17
"c8e371568a0c4391b25796ae4e91952e","c8e371568a0c4391b25796ae4e91952e",18524205,1,0,1,746,186,186,0
"c8e371568a0c4391b25796ae4e91952e","6cd2dcaac46847d4a0bc53f296d90375",18524205,1,10,0,747,186,194,8
"6cd2dcaac46847d4a0bc53f296d90375","6cd2dcaac46847d4a0bc53f296d90375",18524205,1,0,1,748,194,194,0
"334c2344009840079b1d0e1b7ce3d5a7","c8e371568a0c4391b25796ae4e91952e",18524205,1,-23,0,753,205,186,-19
"c8e371568a0c4391b25796ae4e91952e","d7f13c8d63ec4e2aa673fbb9cf9c6933",18524205,1,26,0,754,186,206,20
"d7f13c8d63ec4e2aa673fbb9cf9c6933","b9e80f77c3a44349863b19875725c384",18524205,1,1,0,755,206,207,1
"d7f13c8d63ec4e2aa673fbb9cf9c6933","362fcb0699a14845ab29b2340093e528",18524205,1,-43,0,758,206,174,-32
"362fcb0699a14845ab29b2340093e528","0c7262dff33c4087bc660ccf40f92f9c",18524205,1,-6,0,759,174,169,-5
"b42cc17b7de840f181a704558d0bc845","362fcb0699a14845ab29b2340093e528",18524205,1,-1,0,762,175,174,-1
"362fcb0699a14845ab29b2340093e528","ea38cc0e6e6e41edbabf210220808bf9",18524205,1,6,0,763,174,179,5
"ea38cc0e6e6e41edbabf210220808bf9","139b097acfca451689d80c9c6eebdf7b",18524205,1,-1,0,766,179,178,-1
"139b097acfca451689d80c9c6eebdf7b","0c7262dff33c4087bc660ccf40f92f9c",18524205,1,-11,0,767,178,169,-9
"0c7262dff33c4087bc660ccf40f92f9c","7040a13096d746ac84b8fac8d9752058",18524205,1,-179,0,768,169,36,-133
"7040a13096d746ac84b8fac8d9752058","7040a13096d746ac84b8fac8d9752058",18524205,2,0,1,769,36,36,0
"9a0dc646f934470daf08c4b56ccf73db","9a0dc646f934470daf08c4b56ccf73db",18524205,1,0,1,772,37,37,0
"7040a13096d746ac84b8fac8d9752058","b613861cecf84ffcab01afb23f660475",18524205,1,-62,0,774,36,1,-35
"b613861cecf84ffcab01afb23f660475","b7719e26494940efa49512aedd0aac79",18524205,1,32,0,775,1,20,19
"b7719e26494940efa49512aedd0aac79","3cbcea2be0984e7dbd5a48195af10ce7",18524205,1,200,0,776,20,165,145
"3cbcea2be0984e7dbd5a48195af10ce7","82e6285962b8400d9d6fc32436022a94",18524205,1,2,0,777,165,167,2
"82e6285962b8400d9d6fc32436022a94","a49d1bb4328949299686242fd0be5584",18524205,1,-200,0,778,167,21,-146
"a49d1bb4328949299686242fd0be5584","d4f45188d3c84a02ba08454e6403a818",18524205,1,3,0,779,21,24,3
"d4c3b003e8274e429d2fa688d73fde6d","d4c3b003e8274e429d2fa688d73fde6d",18524205,4,0,1,781,22,22,0
"b7719e26494940efa49512aedd0aac79","a49d1bb4328949299686242fd0be5584",18524205,2,2,0,784,20,21,1
"a49d1bb4328949299686242fd0be5584","d4c3b003e8274e429d2fa688d73fde6d",18524205,2,1,0,785,21,22,1
"d4c3b003e8274e429d2fa688d73fde6d","d4f45188d3c84a02ba08454e6403a818",18524205,2,2,0,786,22,24,2
"d4f45188d3c84a02ba08454e6403a818","b7719e26494940efa49512aedd0aac79",18524205,1,-5,0,794,24,20,-4
"b7719e26494940efa49512aedd0aac79","1c6721b1f63f4d30ba7746ea8af02a52",18524205,1,279,0,795,20,221,201
"1c6721b1f63f4d30ba7746ea8af02a52","1c6721b1f63f4d30ba7746ea8af02a52",18524205,1,0,1,796,221,221,0
"77ecef8eff6b4a2caea7707669bf7475","d03cb855c70044cf8c35d9ec0de696e3",18524205,1,3,0,798,222,224,2
"d03cb855c70044cf8c35d9ec0de696e3","1c6721b1f63f4d30ba7746ea8af02a52",18524205,1,-4,0,799,224,221,-3
"d03cb855c70044cf8c35d9ec0de696e3","a49a937d6896486d9a5396654abcf2e1",18524205,1,2,0,802,224,226,2
"a49a937d6896486d9a5396654abcf2e1","a49a937d6896486d9a5396654abcf2e1",18524205,3,0,1,803,226,226,0
"a49a937d6896486d9a5396654abcf2e1","8b9ae98743bd4d4a8a87dff1c1244211",18524205,1,1,0,806,226,227,1
"8b9ae98743bd4d4a8a87dff1c1244211","8b9ae98743bd4d4a8a87dff1c1244211",18524205,17,0,1,807,227,227,0
"8b9ae98743bd4d4a8a87dff1c1244211","2ab1535aac1346ba8801535bf729ef37",18524205,1,3,0,824,227,229,2
"2ab1535aac1346ba8801535bf729ef37","f7906d6f59b9489a91d2ef40db5a474d",18524205,1,-7,0,825,229,223,-6
"f7906d6f59b9489a91d2ef40db5a474d","2ab1535aac1346ba8801535bf729ef37",18524205,1,7,0,826,223,229,6
"2ab1535aac1346ba8801535bf729ef37","a4f40fb48a8542c8949bae1f002cd9bc",18524205,1,2,0,827,229,231,2
"a4f40fb48a8542c8949bae1f002cd9bc","a4f40fb48a8542c8949bae1f002cd9bc",18524205,2,0,1,828,231,231,0
"a4f40fb48a8542c8949bae1f002cd9bc","8972c23e32044edb8a78fa1eed4e5947",18524205,1,1,0,830,231,232,1
"8972c23e32044edb8a78fa1eed4e5947","8972c23e32044edb8a78fa1eed4e5947",18524205,1,0,1,831,232,232,0
"8972c23e32044edb8a78fa1eed4e5947","92feb4a40f8344d38b6f722e42a53295",18524205,1,1,0,832,232,233,1
"92feb4a40f8344d38b6f722e42a53295","92feb4a40f8344d38b6f722e42a53295",18524205,2,0,1,833,233,233,0
"92feb4a40f8344d38b6f722e42a53295","5152833676bf4c6cb317060be10f68db",18524205,1,-5,0,835,233,228,-5
"5152833676bf4c6cb317060be10f68db","2ab1535aac1346ba8801535bf729ef37",18524205,2,1,0,836,228,229,1
"2ab1535aac1346ba8801535bf729ef37","0b04c8e2f86d48c7aeb7e225819cd32b",18524205,2,6,0,837,229,234,5
"0b04c8e2f86d48c7aeb7e225819cd32b","5152833676bf4c6cb317060be10f68db",18524205,1,-7,0,838,234,228,-6
"0b04c8e2f86d48c7aeb7e225819cd32b","2ab1535aac1346ba8801535bf729ef37",18524205,2,-6,0,841,234,229,-5
"5152833676bf4c6cb317060be10f68db","0b04c8e2f86d48c7aeb7e225819cd32b",18524205,1,7,0,843,228,234,6
"5152833676bf4c6cb317060be10f68db","ca3e28f290354c08aefe5b0f769604e6",18524205,1,8,0,846,228,235,7
"ca3e28f290354c08aefe5b0f769604e6","ca3e28f290354c08aefe5b0f769604e6",18524205,9,0,1,847,235,235,0
"ca3e28f290354c08aefe5b0f769604e6","79a35eea833e4c2c9d22fc53c3c6445c",18524205,1,1,0,856,235,236,1
"79a35eea833e4c2c9d22fc53c3c6445c","79a35eea833e4c2c9d22fc53c3c6445c",18524205,4,0,1,857,236,236,0
"79a35eea833e4c2c9d22fc53c3c6445c","8f68228b1518449e9615cdafee41a2bd",18524205,1,1,0,861,236,237,1
"8f68228b1518449e9615cdafee41a2bd","8f68228b1518449e9615cdafee41a2bd",18524205,1,0,1,862,237,237,0
"8f68228b1518449e9615cdafee41a2bd","cab89fa5c3ed45a5aa550fc0352d6a42",18524205,1,1,0,863,237,238,1
"cab89fa5c3ed45a5aa550fc0352d6a42","cab89fa5c3ed45a5aa550fc0352d6a42",18524205,3,0,1,864,238,238,0
"cab89fa5c3ed45a5aa550fc0352d6a42","66d4fad4f1cf4b46be0750a99ad7a35a",18524205,1,1,0,867,238,239,1
"66d4fad4f1cf4b46be0750a99ad7a35a","66d4fad4f1cf4b46be0750a99ad7a35a",18524205,1,0,1,868,239,239,0
"66d4fad4f1cf4b46be0750a99ad7a35a","0b04c8e2f86d48c7aeb7e225819cd32b",18524205,1,-5,0,869,239,234,-5
"0b04c8e2f86d48c7aeb7e225819cd32b","f53da5fd9bfe412da4b80d4742563b6c",18524205,1,8,0,870,234,241,7
"f53da5fd9bfe412da4b80d4742563b6c","f53da5fd9bfe412da4b80d4742563b6c",18524205,1,0,1,871,241,241,0
"f53da5fd9bfe412da4b80d4742563b6c","1c6721b1f63f4d30ba7746ea8af02a52",18524205,1,-24,0,872,241,221,-20
"1c6721b1f63f4d30ba7746ea8af02a52","2ae94c0cea4d480a9d5dca8fb1d7b542",18524205,1,27,0,873,221,242,21
"2ae94c0cea4d480a9d5dca8fb1d7b542","1ebf23f9d994469a85206e4c7b1bf5f5",18524205,1,3,0,874,242,245,3
"1ebf23f9d994469a85206e4c7b1bf5f5","1ebf23f9d994469a85206e4c7b1bf5f5",18524205,10,0,1,875,245,245,0
"1ebf23f9d994469a85206e4c7b1bf5f5","85ae675b83e8422da842cfd25596af99",18524205,1,1,0,885,245,246,1
"85ae675b83e8422da842cfd25596af99","85ae675b83e8422da842cfd25596af99",18524205,1,0,1,886,246,246,0
"85ae675b83e8422da842cfd25596af99","2ae94c0cea4d480a9d5dca8fb1d7b542",18524205,1,-4,0,887,246,242,-4
"2ae94c0cea4d480a9d5dca8fb1d7b542","fa235f0f364d47e4ae1c87f47bf8e6ba",18524205,1,12,0,888,242,252,10
"fa235f0f364d47e4ae1c87f47bf8e6ba","fa235f0f364d47e4ae1c87f47bf8e6ba",18524205,1,0,1,889,252,252,0
"fa235f0f364d47e4ae1c87f47bf8e6ba","79f7845465cc4ed19d8e4f1429541be0",18524205,1,2,0,890,252,254,2
"79f7845465cc4ed19d8e4f1429541be0","79f7845465cc4ed19d8e4f1429541be0",18524205,2,0,1,891,254,254,0
"79f7845465cc4ed19d8e4f1429541be0","6e83e23f56544a19b94067c1c558d9c0",18524205,1,-8,0,893,254,247,-7
"00f61990949545828dd12f1303d47504","00f61990949545828dd12f1303d47504",18524205,1,0,1,895,256,256,0
"00f61990949545828dd12f1303d47504","ead7bb4b64e247d2ae632ab8a296b091",18524205,1,2,0,896,256,258,2
"ead7bb4b64e247d2ae632ab8a296b091","ead7bb4b64e247d2ae632ab8a296b091",18524205,2,0,1,897,258,258,0
"ead7bb4b64e247d2ae632ab8a296b091","41b0048dde734bb280bac6116baa8e27",18524205,1,1,0,899,258,259,1
"41b0048dde734bb280bac6116baa8e27","41b0048dde734bb280bac6116baa8e27",18524205,2,0,1,900,259,259,0
"41b0048dde734bb280bac6116baa8e27","b41c5a094a604ee0915327da5cc0beb7",18524205,1,1,0,902,259,260,1
"b41c5a094a604ee0915327da5cc0beb7","b41c5a094a604ee0915327da5cc0beb7",18524205,2,0,1,903,260,260,0
"b41c5a094a604ee0915327da5cc0beb7","d546341988904f069cfa86b21457d9d9",18524205,1,-10,0,905,260,251,-9
"d546341988904f069cfa86b21457d9d9","28c171777c52431ab6b925073bd63d46",18524205,1,15,0,906,251,264,13
"28c171777c52431ab6b925073bd63d46","28c171777c52431ab6b925073bd63d46",18524205,7,0,1,907,264,264,0
"28c171777c52431ab6b925073bd63d46","ac160db940cb49ae8579162b1d52bb5d",18524205,1,2,0,914,264,266,2
"ac160db940cb49ae8579162b1d52bb5d","ac160db940cb49ae8579162b1d52bb5d",18524205,3,0,1,915,266,266,0
"ac160db940cb49ae8579162b1d52bb5d","d989ebcfc12a4b669f0100dc1aa14f1e",18524205,1,-12,0,918,266,255,-11
"d989ebcfc12a4b669f0100dc1aa14f1e","c6fd49b485cc4874b0bbdd9c6171e09c",18524205,1,15,0,919,255,268,13
"c6fd49b485cc4874b0bbdd9c6171e09c","c6fd49b485cc4874b0bbdd9c6171e09c",18524205,3,0,1,920,268,268,0
"c6fd49b485cc4874b0bbdd9c6171e09c","44240778a97c4af0937817499b75707b",18524205,1,1,0,923,268,269,1
"44240778a97c4af0937817499b75707b","44240778a97c4af0937817499b75707b",18524205,2,0,1,924,269,269,0
"44240778a97c4af0937817499b75707b","7aa76d3e993840d8805f097cbdbcd44b",18524205,1,-9,0,926,269,261,-8
"7aa76d3e993840d8805f097cbdbcd44b","865a4d3b43374da7944dc7d397f566d9",18524205,1,12,0,927,261,271,10
"865a4d3b43374da7944dc7d397f566d9","865a4d3b43374da7944dc7d397f566d9",18524205,1,0,1,928,271,271,0
"865a4d3b43374da7944dc7d397f566d9","2ae94c0cea4d480a9d5dca8fb1d7b542",18524205,1,-35,0,929,271,242,-29
"2ae94c0cea4d480a9d5dca8fb1d7b542","0d987bed3ffa4ed0b9a2e62e97b7b30f",18524205,1,38,0,930,242,272,30
"82ae07bc0c9b4570a41799290d1ef399","0d987bed3ffa4ed0b9a2e62e97b7b30f",18524205,3,-4,0,933,275,272,-3
"82ae07bc0c9b4570a41799290d1ef399","82ae07bc0c9b4570a41799290d1ef399",18524205,1,0,1,938,275,275,0
"bb5a47f5ea01454a8b79455422d3b9da","82ae07bc0c9b4570a41799290d1ef399",18524205,1,-6,0,948,280,275,-5
"bb5a47f5ea01454a8b79455422d3b9da","bb5a47f5ea01454a8b79455422d3b9da",18524205,96,0,1,1000,280,280,0
"bb5a47f5ea01454a8b79455422d3b9da","94cecc3f1e7d484b8e068e79241dfd73",18524205,1,3,0,1011,280,281,1
"94cecc3f1e7d484b8e068e79241dfd73","0d987bed3ffa4ed0b9a2e62e97b7b30f",18524205,1,-13,0,1012,281,272,-9
"0d987bed3ffa4ed0b9a2e62e97b7b30f","a37477c4e4c14169ad44b06b493007f6",18524205,1,15,0,1013,272,283,11
"a37477c4e4c14169ad44b06b493007f6","94cecc3f1e7d484b8e068e79241dfd73",18524205,1,-2,0,1014,283,281,-2
"94cecc3f1e7d484b8e068e79241dfd73","fab84b4fab5940efb4ea868ef8d09396",18524205,2,5,0,1015,281,284,3
"fab84b4fab5940efb4ea868ef8d09396","fab84b4fab5940efb4ea868ef8d09396",18524205,1,0,1,1016,284,284,0
"fab84b4fab5940efb4ea868ef8d09396","4a29443515bb404cb8924e1c60a63b73",18524205,1,4,0,1017,284,285,1
"4a29443515bb404cb8924e1c60a63b73","208c9b2796c944db8dacaa96082520ea",18524205,2,3,0,1018,285,288,3
"208c9b2796c944db8dacaa96082520ea","5152833676bf4c6cb317060be10f68db",18524205,1,-81,0,1019,288,228,-60
"5152833676bf4c6cb317060be10f68db","1c6721b1f63f4d30ba7746ea8af02a52",18524205,1,-9,0,1020,228,221,-7
"1c6721b1f63f4d30ba7746ea8af02a52","2ab1535aac1346ba8801535bf729ef37",18524205,1,10,0,1021,221,229,8
"2ab1535aac1346ba8801535bf729ef37","2ab1535aac1346ba8801535bf729ef37",18524205,2,0,1,1022,229,229,0
"2ab1535aac1346ba8801535bf729ef37","5152833676bf4c6cb317060be10f68db",18524205,3,-1,0,1024,229,228,-1
"5152833676bf4c6cb317060be10f68db","0c7262dff33c4087bc660ccf40f92f9c",18524205,1,-79,0,1025,228,169,-59
"0c7262dff33c4087bc660ccf40f92f9c","94cecc3f1e7d484b8e068e79241dfd73",18524205,1,148,0,1026,169,281,112
"94cecc3f1e7d484b8e068e79241dfd73","a37477c4e4c14169ad44b06b493007f6",18524205,2,2,0,1027,281,283,2
"a37477c4e4c14169ad44b06b493007f6","fab84b4fab5940efb4ea868ef8d09396",18524205,1,3,0,1028,283,284,1
"fab84b4fab5940efb4ea868ef8d09396","94cecc3f1e7d484b8e068e79241dfd73",18524205,2,-5,0,1029,284,281,-3
"a37477c4e4c14169ad44b06b493007f6","1c6721b1f63f4d30ba7746ea8af02a52",18524205,1,-80,0,1033,283,221,-62
"1c6721b1f63f4d30ba7746ea8af02a52","77ecef8eff6b4a2caea7707669bf7475",18524205,2,1,0,1034,221,222,1
"77ecef8eff6b4a2caea7707669bf7475","0d987bed3ffa4ed0b9a2e62e97b7b30f",18524205,1,64,0,1035,222,272,50
"0d987bed3ffa4ed0b9a2e62e97b7b30f","bb5a47f5ea01454a8b79455422d3b9da",18524205,3,10,0,1036,272,280,8
"bb5a47f5ea01454a8b79455422d3b9da","4a29443515bb404cb8924e1c60a63b73",18524205,1,12,0,1044,280,285,5
"4a29443515bb404cb8924e1c60a63b73","4a29443515bb404cb8924e1c60a63b73",18524205,1,0,1,1045,285,285,0
"208c9b2796c944db8dacaa96082520ea","208c9b2796c944db8dacaa96082520ea",18524205,1,0,1,1047,288,288,0
"208c9b2796c944db8dacaa96082520ea","4a29443515bb404cb8924e1c60a63b73",18524205,1,-3,0,1048,288,285,-3
"4a29443515bb404cb8924e1c60a63b73","7669a956527947d0add87455277e80b4",18524205,1,7,0,1049,285,291,6
"7669a956527947d0add87455277e80b4","7669a956527947d0add87455277e80b4",18524205,3,0,1,1050,291,291,0
"7669a956527947d0add87455277e80b4","869e967078f04da18dd0b0b9389a7424",18524205,1,3,0,1053,291,293,2
"869e967078f04da18dd0b0b9389a7424","6a9a3b5bde4a48daa896fe8c06eca56f",18524205,1,-5,0,1054,293,289,-4
"6a9a3b5bde4a48daa896fe8c06eca56f","869e967078f04da18dd0b0b9389a7424",18524205,1,5,0,1055,289,293,4
"869e967078f04da18dd0b0b9389a7424","51ab6291537748fab90d519aa09889d6",18524205,1,2,0,1056,293,295,2
"51ab6291537748fab90d519aa09889d6","51ab6291537748fab90d519aa09889d6",18524205,11,0,1,1057,295,295,0
"51ab6291537748fab90d519aa09889d6","34a6e49023fc4465bd5ca604330bbd1c",18524205,1,-3,0,1068,295,292,-3
"34a6e49023fc4465bd5ca604330bbd1c","ba0e59461bfb4a44b7b1c28a01f8d3b3",18524205,1,9,0,1069,292,299,7
"ba0e59461bfb4a44b7b1c28a01f8d3b3","21592f2a9e9c4b2f8c66ec5dbcbf6a2b",18524205,1,-4,0,1070,299,296,-3
"21592f2a9e9c4b2f8c66ec5dbcbf6a2b","ba0e59461bfb4a44b7b1c28a01f8d3b3",18524205,1,4,0,1071,296,299,3
"ba0e59461bfb4a44b7b1c28a01f8d3b3","0e0b36e731a645e7b1b8a88f5031ca38",18524205,1,2,0,1072,299,301,2
"0e0b36e731a645e7b1b8a88f5031ca38","0e0b36e731a645e7b1b8a88f5031ca38",18524205,9,0,1,1073,301,301,0
"0e0b36e731a645e7b1b8a88f5031ca38","a66a144637284c21afc6de17fea4bfb8",18524205,1,1,0,1082,301,302,1
"a66a144637284c21afc6de17fea4bfb8","a66a144637284c21afc6de17fea4bfb8",18524205,2,0,1,1083,302,302,0
"a66a144637284c21afc6de17fea4bfb8","7646a919d7e64fa990bca9b024ff089d",18524205,1,-4,0,1085,302,298,-4
"7646a919d7e64fa990bca9b024ff089d","e390b575229748ea8aac9364efe2bf00",18524205,1,7,0,1086,298,304,6
"e390b575229748ea8aac9364efe2bf00","e390b575229748ea8aac9364efe2bf00",18524205,1,0,1,1087,304,304,0
"e390b575229748ea8aac9364efe2bf00","4a29443515bb404cb8924e1c60a63b73",18524205,1,-24,0,1088,304,285,-19
"4a29443515bb404cb8924e1c60a63b73","3434c10e561d488a914e0f7d71907abd",18524205,1,27,0,1089,285,305,20
"3434c10e561d488a914e0f7d71907abd","53e7e900392747ccad52e711ab0f80d8",18524205,2,2,0,1090,305,307,2
"53e7e900392747ccad52e711ab0f80d8","3434c10e561d488a914e0f7d71907abd",18524205,2,-2,0,1091,307,305,-2
"53e7e900392747ccad52e711ab0f80d8","53e7e900392747ccad52e711ab0f80d8",18524205,1,0,1,1093,307,307,0
"3434c10e561d488a914e0f7d71907abd","130acc2aeb0448fdbb2de63bc5cebe5b",18524205,1,5,0,1095,305,309,4
"130acc2aeb0448fdbb2de63bc5cebe5b","130acc2aeb0448fdbb2de63bc5cebe5b",18524205,1,0,1,1096,309,309,0
"130acc2aeb0448fdbb2de63bc5cebe5b","9c062b3251034ebe90f5054e2a3b5120",18524205,1,2,0,1097,309,311,2
"9c062b3251034ebe90f5054e2a3b5120","9c062b3251034ebe90f5054e2a3b5120",18524205,5,0,1,1098,311,311,0
"9c062b3251034ebe90f5054e2a3b5120","ea859f8207e44537889daeaba13ac2e8",18524205,1,1,0,1103,311,312,1
"ea859f8207e44537889daeaba13ac2e8","ea859f8207e44537889daeaba13ac2e8",18524205,9,0,1,1104,312,312,0
"ea859f8207e44537889daeaba13ac2e8","56d94971a7a94257aa330183a8ebd0ea",18524205,1,1,0,1113,312,313,1
"56d94971a7a94257aa330183a8ebd0ea","56d94971a7a94257aa330183a8ebd0ea",18524205,1,0,1,1114,313,313,0
"56d94971a7a94257aa330183a8ebd0ea","141c0df6cd1946539aadd1c9b7068cd4",18524205,1,-5,0,1115,313,308,-5
"141c0df6cd1946539aadd1c9b7068cd4","13255e63e0aa4abf85e5211bf613d43e",18524205,1,10,0,1116,308,317,9
"13255e63e0aa4abf85e5211bf613d43e","13255e63e0aa4abf85e5211bf613d43e",18524205,1,0,1,1117,317,317,0
"13255e63e0aa4abf85e5211bf613d43e","0c787d16c9504873b1a4d903cec09948",18524205,1,-3,0,1118,317,314,-3
"0c787d16c9504873b1a4d903cec09948","86c27d40179e419c8e9d150fb6afa5d0",18524205,1,6,0,1119,314,319,5
"86c27d40179e419c8e9d150fb6afa5d0","86c27d40179e419c8e9d150fb6afa5d0",18524205,1,0,1,1120,319,319,0
"86c27d40179e419c8e9d150fb6afa5d0","8d7e0b55cf9849cda222a0f2440cec55",18524205,1,-1,0,1121,319,318,-1
"8d7e0b55cf9849cda222a0f2440cec55","24f1363179ad4aaa965484a78471912b",18524205,1,6,0,1122,318,323,5
"24f1363179ad4aaa965484a78471912b","47edbb64109243e6b0f8f64cdef90c6c",18524205,1,3,0,1123,323,326,3
"47edbb64109243e6b0f8f64cdef90c6c","24f1363179ad4aaa965484a78471912b",18524205,1,-3,0,1124,326,323,-3
"24f1363179ad4aaa965484a78471912b","3628bdce1dd2429ba924d2d4d09448d2",18524205,1,-1,0,1125,323,322,-1
"3628bdce1dd2429ba924d2d4d09448d2","56b3fd1a212a4764be39d979fde3326e",18524205,1,7,0,1126,322,328,6
"56b3fd1a212a4764be39d979fde3326e","56b3fd1a212a4764be39d979fde3326e",18524205,1,0,1,1127,328,328,0
"56b3fd1a212a4764be39d979fde3326e","3434c10e561d488a914e0f7d71907abd",18524205,1,-28,0,1128,328,305,-23
"3434c10e561d488a914e0f7d71907abd","0c4079457ede49e3aeb5e86ed84bdf35",18524205,1,31,0,1129,305,329,24
"0c4079457ede49e3aeb5e86ed84bdf35","38aea304b4fa46e1b29bb72f5cea4c93",18524205,4,2,0,1130,329,331,2
"38aea304b4fa46e1b29bb72f5cea4c93","38aea304b4fa46e1b29bb72f5cea4c93",18524205,1,0,1,1131,331,331,0
"38aea304b4fa46e1b29bb72f5cea4c93","e36d261332f14e79bb4b467aceaeb9b5",18524205,1,2,0,1132,331,333,2
"e36d261332f14e79bb4b467aceaeb9b5","e36d261332f14e79bb4b467aceaeb9b5",18524205,1,0,1,1133,333,333,0
"e36d261332f14e79bb4b467aceaeb9b5","c7e89b9d04744d2eab742fc24e3ef1ae",18524205,1,1,0,1134,333,334,1
"c7e89b9d04744d2eab742fc24e3ef1ae","c7e89b9d04744d2eab742fc24e3ef1ae",18524205,5,0,1,1135,334,334,0
"c7e89b9d04744d2eab742fc24e3ef1ae","fe49f8054b374a0ea4bb266ed135ff62",18524205,1,1,0,1140,334,335,1
"fe49f8054b374a0ea4bb266ed135ff62","fe49f8054b374a0ea4bb266ed135ff62",18524205,5,0,1,1141,335,335,0
"fe49f8054b374a0ea4bb266ed135ff62","d0a8f74af98642fe8360d22c42e45117",18524205,1,1,0,1146,335,336,1
"d0a8f74af98642fe8360d22c42e45117","d0a8f74af98642fe8360d22c42e45117",18524205,2,0,1,1147,336,336,0
"d0a8f74af98642fe8360d22c42e45117","0c4079457ede49e3aeb5e86ed84bdf35",18524205,1,-7,0,1149,336,329,-7
"0c4079457ede49e3aeb5e86ed84bdf35","0c4079457ede49e3aeb5e86ed84bdf35",18524205,2,0,1,1150,329,329,0
"38aea304b4fa46e1b29bb72f5cea4c93","0c4079457ede49e3aeb5e86ed84bdf35",18524205,1,-2,0,1152,331,329,-2
"0c4079457ede49e3aeb5e86ed84bdf35","a7c6339ca1da4368a18d471f0519f877",18524205,1,11,0,1153,329,339,10
"a7c6339ca1da4368a18d471f0519f877","a7c6339ca1da4368a18d471f0519f877",18524205,1,0,1,1154,339,339,0
"a7c6339ca1da4368a18d471f0519f877","b8b9418ab322418d9db9b40d96af873a",18524205,1,-2,0,1155,339,337,-2
"b8b9418ab322418d9db9b40d96af873a","bbc5139ca9024389a94db3a6f47dcff6",18524205,1,5,0,1156,337,341,4
"bbc5139ca9024389a94db3a6f47dcff6","bbc5139ca9024389a94db3a6f47dcff6",18524205,1,0,1,1157,341,341,0
"bbc5139ca9024389a94db3a6f47dcff6","4ee6ca9019ab4a1ab323f98094a9bd77",18524205,1,2,0,1158,341,343,2
"4ee6ca9019ab4a1ab323f98094a9bd77","4ee6ca9019ab4a1ab323f98094a9bd77",18524205,2,0,1,1159,343,343,0
"4ee6ca9019ab4a1ab323f98094a9bd77","b37947176785476f8b29d49a851366dc",18524205,1,1,0,1161,343,344,1
"b37947176785476f8b29d49a851366dc","b37947176785476f8b29d49a851366dc",18524205,2,0,1,1162,344,344,0
"b37947176785476f8b29d49a851366dc","fcea5b10d5a14a3b9324ffece8f6e1e5",18524205,1,1,0,1164,344,345,1
"fcea5b10d5a14a3b9324ffece8f6e1e5","fcea5b10d5a14a3b9324ffece8f6e1e5",18524205,2,0,1,1165,345,345,0
"fcea5b10d5a14a3b9324ffece8f6e1e5","c2490bc612d146edbe786556fab3651b",18524205,1,-5,0,1167,345,340,-5
"c2490bc612d146edbe786556fab3651b","0c4079457ede49e3aeb5e86ed84bdf35",18524205,1,-13,0,1168,340,329,-11
"38aea304b4fa46e1b29bb72f5cea4c93","6ac8bb048b854999a47edb35fe627f11",18524205,1,19,0,1170,331,347,16
"6ac8bb048b854999a47edb35fe627f11","6ac8bb048b854999a47edb35fe627f11",18524205,1,0,1,1171,347,347,0
"6ac8bb048b854999a47edb35fe627f11","30ead9794d4847abaf222ca966cc8630",18524205,1,3,0,1172,347,348,1
"30ead9794d4847abaf222ca966cc8630","0c4079457ede49e3aeb5e86ed84bdf35",18524205,1,-24,0,1173,348,329,-19
"0c4079457ede49e3aeb5e86ed84bdf35","09b9678ddc3d452ea4a3d46e15826065",18524205,1,29,0,1174,329,353,24
"09b9678ddc3d452ea4a3d46e15826065","c20993c944444fe085345591a8bd837e",18524205,1,-2,0,1175,353,351,-2
"c20993c944444fe085345591a8bd837e","897b7f51242c44aab2205c72fdcbf4cd",18524205,2,1,0,1176,351,352,1
"897b7f51242c44aab2205c72fdcbf4cd","eff0de7f2dbb42dfa1a2e686efab5b6d",18524205,1,2,0,1177,352,354,2
"eff0de7f2dbb42dfa1a2e686efab5b6d","568fab6c935d4be6925c261344494c53",18524205,1,-5,0,1178,354,349,-5
"568fab6c935d4be6925c261344494c53","568fab6c935d4be6925c261344494c53",18524205,1,0,1,1179,349,349,0
"568fab6c935d4be6925c261344494c53","30ead9794d4847abaf222ca966cc8630",18524205,1,-1,0,1180,349,348,-1
"30ead9794d4847abaf222ca966cc8630","c20993c944444fe085345591a8bd837e",18524205,1,3,0,1181,348,351,3
"c20993c944444fe085345591a8bd837e","09b9678ddc3d452ea4a3d46e15826065",18524205,1,2,0,1182,351,353,2
"09b9678ddc3d452ea4a3d46e15826065","eff0de7f2dbb42dfa1a2e686efab5b6d",18524205,2,1,0,1183,353,354,1
"eff0de7f2dbb42dfa1a2e686efab5b6d","897b7f51242c44aab2205c72fdcbf4cd",18524205,1,-2,0,1184,354,352,-2
"897b7f51242c44aab2205c72fdcbf4cd","4a92daef4d504e1792575a26502bb7b7",18524205,1,-8,0,1185,352,346,-6
"4a92daef4d504e1792575a26502bb7b7","0c4079457ede49e3aeb5e86ed84bdf35",18524205,1,-20,0,1186,346,329,-17
"0c4079457ede49e3aeb5e86ed84bdf35","c20993c944444fe085345591a8bd837e",18524205,1,27,0,1187,329,351,22
"c20993c944444fe085345591a8bd837e","c20993c944444fe085345591a8bd837e",18524205,3,0,1,1188,351,351,0
"897b7f51242c44aab2205c72fdcbf4cd","897b7f51242c44aab2205c72fdcbf4cd",18524205,3,0,1,1192,352,352,0
"897b7f51242c44aab2205c72fdcbf4cd","09b9678ddc3d452ea4a3d46e15826065",18524205,1,1,0,1195,352,353,1
"09b9678ddc3d452ea4a3d46e15826065","09b9678ddc3d452ea4a3d46e15826065",18524205,3,0,1,1196,353,353,0
"eff0de7f2dbb42dfa1a2e686efab5b6d","eff0de7f2dbb42dfa1a2e686efab5b6d",18524205,3,0,1,1200,354,354,0
"eff0de7f2dbb42dfa1a2e686efab5b6d","30ead9794d4847abaf222ca966cc8630",18524205,1,-6,0,1203,354,348,-6
"30ead9794d4847abaf222ca966cc8630","2fe14166dc9642c3bc666b86a57f943d",18524205,1,10,0,1204,348,357,9
"2fe14166dc9642c3bc666b86a57f943d","2fe14166dc9642c3bc666b86a57f943d",18524205,1,0,1,1205,357,357,0
"2fe14166dc9642c3bc666b86a57f943d","44421dd1e13a47a388c4a19834b744c7",18524205,1,2,0,1206,357,359,2
"44421dd1e13a47a388c4a19834b744c7","44421dd1e13a47a388c4a19834b744c7",18524205,2,0,1,1207,359,359,0
"44421dd1e13a47a388c4a19834b744c7","cb5fc7ef85d547c4be1a7439d0bf6052",18524205,1,1,0,1209,359,360,1
"cb5fc7ef85d547c4be1a7439d0bf6052","cb5fc7ef85d547c4be1a7439d0bf6052",18524205,5,0,1,1210,360,360,0
"cb5fc7ef85d547c4be1a7439d0bf6052","0a8f150a4cf747acbde62f4721823da3",18524205,1,1,0,1215,360,361,1
"0a8f150a4cf747acbde62f4721823da3","0a8f150a4cf747acbde62f4721823da3",18524205,5,0,1,1216,361,361,0
"0a8f150a4cf747acbde62f4721823da3","ab8fdad974ae471f9f24c3f9dd04462e",18524205,1,1,0,1221,361,362,1
"ab8fdad974ae471f9f24c3f9dd04462e","ab8fdad974ae471f9f24c3f9dd04462e",18524205,2,0,1,1222,362,362,0
"ab8fdad974ae471f9f24c3f9dd04462e","1ba8fef685d74a8194b9db252eb704fb",18524205,1,-7,0,1224,362,355,-7
"1ba8fef685d74a8194b9db252eb704fb","52580888dadb4fe3baa795683ea227bd",18524205,1,10,0,1225,355,364,9
"52580888dadb4fe3baa795683ea227bd","52580888dadb4fe3baa795683ea227bd",18524205,1,0,1,1226,364,364,0
"52580888dadb4fe3baa795683ea227bd","492a3bc6a1254f23a7998587961b22a4",18524205,1,3,0,1227,364,366,2
"492a3bc6a1254f23a7998587961b22a4","f00179e251a045b39c3f7a54f9aa4acc",18524205,1,-4,0,1228,366,363,-3
"f00179e251a045b39c3f7a54f9aa4acc","492a3bc6a1254f23a7998587961b22a4",18524205,1,4,0,1229,363,366,3
"492a3bc6a1254f23a7998587961b22a4","072a190fd302456290895f9f04d6940a",18524205,1,-1,0,1230,366,365,-1
"072a190fd302456290895f9f04d6940a","cfa457d1743848e4bb5e4beced6448ed",18524205,1,5,0,1231,365,369,4
"cfa457d1743848e4bb5e4beced6448ed","cfa457d1743848e4bb5e4beced6448ed",18524205,1,0,1,1232,369,369,0
"cfa457d1743848e4bb5e4beced6448ed","30ead9794d4847abaf222ca966cc8630",18524205,1,-25,0,1233,369,348,-21
"30ead9794d4847abaf222ca966cc8630","b71bac264efb4abd97015447bd490db6",18524205,1,28,0,1234,348,370,22
"b71bac264efb4abd97015447bd490db6","0c4079457ede49e3aeb5e86ed84bdf35",18524205,1,-52,0,1235,370,329,-41
"38aea304b4fa46e1b29bb72f5cea4c93","8d448d625b024c82a5eb240bbd7431d6",18524205,1,55,0,1238,331,374,43
"8d448d625b024c82a5eb240bbd7431d6","8d448d625b024c82a5eb240bbd7431d6",18524205,57,0,1,1239,374,374,0
"8d448d625b024c82a5eb240bbd7431d6","b71bac264efb4abd97015447bd490db6",18524205,3,-5,0,1241,374,370,-4
"b71bac264efb4abd97015447bd490db6","8d448d625b024c82a5eb240bbd7431d6",18524205,3,5,0,1242,370,374,4
"8d448d625b024c82a5eb240bbd7431d6","fc0771786a1e405986933843fdfd7eda",18524205,1,-3,0,1247,374,372,-2
"fc0771786a1e405986933843fdfd7eda","fc0771786a1e405986933843fdfd7eda",18524205,1,0,1,1248,372,372,0
"fc0771786a1e405986933843fdfd7eda","b71bac264efb4abd97015447bd490db6",18524205,1,-2,0,1249,372,370,-2
"b71bac264efb4abd97015447bd490db6","b71bac264efb4abd97015447bd490db6",18524205,2,0,1,1250,370,370,0
"b71bac264efb4abd97015447bd490db6","d6d02b6ef04e4f17805504500b8ce441",18524205,1,8,0,1307,370,375,5
"d6d02b6ef04e4f17805504500b8ce441","d6d02b6ef04e4f17805504500b8ce441",18524205,2,0,1,1308,375,375,0
"d6d02b6ef04e4f17805504500b8ce441","66baf19b6b904b70922329068c63746d",18524205,1,4,0,1310,375,376,1
"66baf19b6b904b70922329068c63746d","7f544639412e40a9ba27f43b415362ab",18524205,4,2,0,1311,376,378,2
"7f544639412e40a9ba27f43b415362ab","b71bac264efb4abd97015447bd490db6",18524205,1,-14,0,1312,378,370,-8
"b71bac264efb4abd97015447bd490db6","2ae94c0cea4d480a9d5dca8fb1d7b542",18524205,1,-170,0,1313,370,242,-128
"2ae94c0cea4d480a9d5dca8fb1d7b542","30c9ba177afc49a695625d2bdec40207",18524205,1,9,0,1314,242,250,8
"30c9ba177afc49a695625d2bdec40207","30c9ba177afc49a695625d2bdec40207",18524205,2,0,1,1315,250,250,0
"30c9ba177afc49a695625d2bdec40207","6e83e23f56544a19b94067c1c558d9c0",18524205,1,-3,0,1317,250,247,-3
"6e83e23f56544a19b94067c1c558d9c0","00f61990949545828dd12f1303d47504",18524205,2,11,0,1318,247,256,9
"00f61990949545828dd12f1303d47504","4a29443515bb404cb8924e1c60a63b73",18524205,1,43,0,1319,256,285,29
"4a29443515bb404cb8924e1c60a63b73","869e967078f04da18dd0b0b9389a7424",18524205,1,10,0,1320,285,293,8
"869e967078f04da18dd0b0b9389a7424","34a6e49023fc4465bd5ca604330bbd1c",18524205,1,-1,0,1321,293,292,-1
"34a6e49023fc4465bd5ca604330bbd1c","66baf19b6b904b70922329068c63746d",18524205,1,113,0,1322,292,376,84
"66baf19b6b904b70922329068c63746d","66baf19b6b904b70922329068c63746d",18524205,3,0,1,1323,376,376,0
"7f544639412e40a9ba27f43b415362ab","7f544639412e40a9ba27f43b415362ab",18524205,2,0,1,1326,378,378,0
"7f544639412e40a9ba27f43b415362ab","66baf19b6b904b70922329068c63746d",18524205,1,-2,0,1327,378,376,-2
"7f544639412e40a9ba27f43b415362ab","d5ae8642e15b46b8bd298b02274d4e9c",18524205,1,2,0,1330,378,380,2
"d5ae8642e15b46b8bd298b02274d4e9c","d5ae8642e15b46b8bd298b02274d4e9c",18524205,3,0,1,1331,380,380,0
"d5ae8642e15b46b8bd298b02274d4e9c","a0d10309a2dd456289147f84be9d37f9",18524205,1,1,0,1334,380,381,1
"a0d10309a2dd456289147f84be9d37f9","a0d10309a2dd456289147f84be9d37f9",18524205,2,0,1,1335,381,381,0
"a0d10309a2dd456289147f84be9d37f9","0fcbc3ca07b144138b8d85da581f09a8",18524205,1,1,0,1337,381,382,1
"0fcbc3ca07b144138b8d85da581f09a8","0fcbc3ca07b144138b8d85da581f09a8",18524205,5,0,1,1338,382,382,0
"0fcbc3ca07b144138b8d85da581f09a8","66baf19b6b904b70922329068c63746d",18524205,1,-6,0,1343,382,376,-6
"66baf19b6b904b70922329068c63746d","4890121ce5d74576b4632b77cfc23398",18524205,1,14,0,1344,376,388,12
"4890121ce5d74576b4632b77cfc23398","c2fca3669923477ab966ded303dea31c",18524205,1,-6,0,1345,388,383,-5
"c2fca3669923477ab966ded303dea31c","4890121ce5d74576b4632b77cfc23398",18524205,1,6,0,1346,383,388,5
"4890121ce5d74576b4632b77cfc23398","96bb2b3e85a34d8b9544514e89f6fe97",18524205,1,3,0,1347,388,390,2
"96bb2b3e85a34d8b9544514e89f6fe97","18d3b836dd804224883cc9180b60a8e1",18524205,1,-4,0,1348,390,387,-3
"18d3b836dd804224883cc9180b60a8e1","96bb2b3e85a34d8b9544514e89f6fe97",18524205,1,4,0,1349,387,390,3
"96bb2b3e85a34d8b9544514e89f6fe97","66baf19b6b904b70922329068c63746d",18524205,1,-17,0,1350,390,376,-14
"7f544639412e40a9ba27f43b415362ab","ac4e9b54acfe4670b4634859c7263cb5",18524205,1,17,0,1353,378,392,14
"ac4e9b54acfe4670b4634859c7263cb5","ac4e9b54acfe4670b4634859c7263cb5",18524205,3,0,1,1354,392,392,0
"ac4e9b54acfe4670b4634859c7263cb5","6f8881a745ac4c358a68b92c3b4abe81",18524205,1,3,0,1357,392,394,2
"6f8881a745ac4c358a68b92c3b4abe81","17f95d18bab743888e1736033dc3384d",18524205,1,-6,0,1358,394,389,-5
"17f95d18bab743888e1736033dc3384d","6f8881a745ac4c358a68b92c3b4abe81",18524205,1,6,0,1359,389,394,5
"6f8881a745ac4c358a68b92c3b4abe81","f7002c8484354eceac57bc7bd62c76c1",18524205,1,-1,0,1360,394,393,-1
"f7002c8484354eceac57bc7bd62c76c1","44a277ea44dc4ae689fab4b82f0b4098",18524205,1,5,0,1361,393,397,4
"44a277ea44dc4ae689fab4b82f0b4098","44a277ea44dc4ae689fab4b82f0b4098",18524205,1,0,1,1362,397,397,0
"44a277ea44dc4ae689fab4b82f0b4098","0c12af0a4e7f4002852cf84b2537c161",18524205,1,-2,0,1363,397,395,-2
"0c12af0a4e7f4002852cf84b2537c161","859e0b8d71694b12befb69ee698138f9",18524205,1,5,0,1364,395,399,4
"859e0b8d71694b12befb69ee698138f9","859e0b8d71694b12befb69ee698138f9",18524205,1,0,1,1365,399,399,0
"859e0b8d71694b12befb69ee698138f9","2b09a08242b54983aec7063990fb3f66",18524205,1,3,0,1366,399,400,1
"2b09a08242b54983aec7063990fb3f66","66baf19b6b904b70922329068c63746d",18524205,1,-32,0,1367,400,376,-24
"66baf19b6b904b70922329068c63746d","2b09a08242b54983aec7063990fb3f66",18524205,1,32,0,1368,376,400,24
"2b09a08242b54983aec7063990fb3f66","2b09a08242b54983aec7063990fb3f66",18524205,1,0,1,1369,400,400,0
"2b09a08242b54983aec7063990fb3f66","1f471b7a883a4df48211e8c6a81b59a7",18524205,1,1,0,1370,400,401,1
"1f471b7a883a4df48211e8c6a81b59a7","1f471b7a883a4df48211e8c6a81b59a7",18524205,1,0,1,1371,401,401,0
"1f471b7a883a4df48211e8c6a81b59a7","2b09a08242b54983aec7063990fb3f66",18524205,1,-1,0,1372,401,400,-1
"2b09a08242b54983aec7063990fb3f66","9de0d567bfa84fe5b77cb76f4a76a5d1",18524205,1,5,0,1373,400,404,4
"9de0d567bfa84fe5b77cb76f4a76a5d1","9de0d567bfa84fe5b77cb76f4a76a5d1",18524205,1,0,1,1374,404,404,0
"9de0d567bfa84fe5b77cb76f4a76a5d1","1157bd665ec4472fb58b751dc5099355",18524205,1,-1,0,1375,404,403,-1
"1157bd665ec4472fb58b751dc5099355","3c8a22d2f9c146ea956609e3ed4f2559",18524205,1,3,0,1376,403,405,2
"3c8a22d2f9c146ea956609e3ed4f2559","58fc9094275e4c49be3f4ba6d4acc0a4",18524205,1,2,0,1377,405,406,1
"58fc9094275e4c49be3f4ba6d4acc0a4","58fc9094275e4c49be3f4ba6d4acc0a4",18524205,1,0,1,1378,406,406,0
"58fc9094275e4c49be3f4ba6d4acc0a4","c1c1be90b2b14c1ab4a5e1ee3c241902",18524205,1,1,0,1379,406,407,1
"c1c1be90b2b14c1ab4a5e1ee3c241902","c1c1be90b2b14c1ab4a5e1ee3c241902",18524205,5,0,1,1380,407,407,0
"c1c1be90b2b14c1ab4a5e1ee3c241902","58fc9094275e4c49be3f4ba6d4acc0a4",18524205,1,-1,0,1385,407,406,-1
"58fc9094275e4c49be3f4ba6d4acc0a4","02b3a1bead9244c1ba2f857c7da8f82a",18524205,1,3,0,1386,406,408,2
"02b3a1bead9244c1ba2f857c7da8f82a","02b3a1bead9244c1ba2f857c7da8f82a",18524205,1,0,1,1387,408,408,0
"02b3a1bead9244c1ba2f857c7da8f82a","6206fc6479014bb193084c32409dc1b9",18524205,1,1,0,1388,408,409,1
"6206fc6479014bb193084c32409dc1b9","6206fc6479014bb193084c32409dc1b9",18524205,1,0,1,1389,409,409,0
"6206fc6479014bb193084c32409dc1b9","02b3a1bead9244c1ba2f857c7da8f82a",18524205,1,-1,0,1390,409,408,-1
"02b3a1bead9244c1ba2f857c7da8f82a","6a5f020451db426dacba9e2ea3fcc62a",18524205,1,3,0,1391,408,410,2
"6a5f020451db426dacba9e2ea3fcc62a","6a5f020451db426dacba9e2ea3fcc62a",18524205,2,0,1,1392,410,410,0
"6a5f020451db426dacba9e2ea3fcc62a","33a9d248b2e44588a5b07fc1342b9bc2",18524205,1,2,0,1394,410,411,1
"33a9d248b2e44588a5b07fc1342b9bc2","33a9d248b2e44588a5b07fc1342b9bc2",18524205,2,0,1,1395,411,411,0
"33a9d248b2e44588a5b07fc1342b9bc2","687055dad9fc40c3982478fe33ec01bf",18524205,2,4,0,1396,411,414,3
"687055dad9fc40c3982478fe33ec01bf","2add1669f08d4101913db15f8c23b3b7",18524205,1,3,0,1397,414,416,2
"2add1669f08d4101913db15f8c23b3b7","2add1669f08d4101913db15f8c23b3b7",18524205,4,0,1,1398,416,416,0
"2add1669f08d4101913db15f8c23b3b7","1fd0f6dadbc14ebc965faf6122190b96",18524205,1,-2,0,1402,416,415,-1
"1fd0f6dadbc14ebc965faf6122190b96","1fd0f6dadbc14ebc965faf6122190b96",18524205,2,0,1,1403,415,415,0
"1fd0f6dadbc14ebc965faf6122190b96","687055dad9fc40c3982478fe33ec01bf",18524205,1,-1,0,1405,415,414,-1
"687055dad9fc40c3982478fe33ec01bf","33a9d248b2e44588a5b07fc1342b9bc2",18524205,1,-4,0,1406,414,411,-3
"33a9d248b2e44588a5b07fc1342b9bc2","2add1669f08d4101913db15f8c23b3b7",18524205,1,7,0,1407,411,416,5
"2add1669f08d4101913db15f8c23b3b7","33a9d248b2e44588a5b07fc1342b9bc2",18524205,1,-7,0,1408,416,411,-5
"33a9d248b2e44588a5b07fc1342b9bc2","c6f26bd420634f1cb7989e76fe6b16c0",18524205,1,1,0,1410,411,412,1
"c6f26bd420634f1cb7989e76fe6b16c0","c6f26bd420634f1cb7989e76fe6b16c0",18524205,5,0,1,1411,412,412,0
"c6f26bd420634f1cb7989e76fe6b16c0","2a65ee6e2ac64f6a8a55fbe5373ec763",18524205,1,1,0,1416,412,413,1
"2a65ee6e2ac64f6a8a55fbe5373ec763","2a65ee6e2ac64f6a8a55fbe5373ec763",18524205,2,0,1,1417,413,413,0
"2a65ee6e2ac64f6a8a55fbe5373ec763","33a9d248b2e44588a5b07fc1342b9bc2",18524205,1,-2,0,1419,413,411,-2
"687055dad9fc40c3982478fe33ec01bf","a2b4bd40cee2481ebd3fc179d6a5cd62",18524205,1,6,0,1421,414,417,3
"a2b4bd40cee2481ebd3fc179d6a5cd62","2b09a08242b54983aec7063990fb3f66",18524205,1,-27,0,1422,417,400,-17
"2b09a08242b54983aec7063990fb3f66","e34e59dce2204f228f3a84b6725df60f",18524205,1,29,0,1423,400,419,19
"e34e59dce2204f228f3a84b6725df60f","e34e59dce2204f228f3a84b6725df60f",18524205,1,0,1,1424,419,419,0
"e34e59dce2204f228f3a84b6725df60f","bec48fc2e1294c7eb3d0aca780d731b8",18524205,1,2,0,1425,419,420,1
"bec48fc2e1294c7eb3d0aca780d731b8","a2b4bd40cee2481ebd3fc179d6a5cd62",18524205,1,-4,0,1426,420,417,-3
"a2b4bd40cee2481ebd3fc179d6a5cd62","bec48fc2e1294c7eb3d0aca780d731b8",18524205,1,4,0,1427,417,420,3
"bec48fc2e1294c7eb3d0aca780d731b8","bec48fc2e1294c7eb3d0aca780d731b8",18524205,1,0,1,1428,420,420,0
"bec48fc2e1294c7eb3d0aca780d731b8","a24600b0e49245f6bdba8c893cfeddb0",18524205,1,7,0,1429,420,425,5
"a24600b0e49245f6bdba8c893cfeddb0","dbde19fcce2a4c1abdc7f685c293a23f",18524205,2,-4,0,1430,425,422,-3
"dbde19fcce2a4c1abdc7f685c293a23f","a24600b0e49245f6bdba8c893cfeddb0",18524205,2,4,0,1431,422,425,3
"a24600b0e49245f6bdba8c893cfeddb0","a24600b0e49245f6bdba8c893cfeddb0",18524205,2,0,1,1432,425,425,0
"a24600b0e49245f6bdba8c893cfeddb0","5d290f75e44b4bdb8256c600debbb44d",18524205,1,2,0,1434,425,426,1
"5d290f75e44b4bdb8256c600debbb44d","a24600b0e49245f6bdba8c893cfeddb0",18524205,1,-2,0,1435,426,425,-1
"a24600b0e49245f6bdba8c893cfeddb0","a2b4bd40cee2481ebd3fc179d6a5cd62",18524205,1,-11,0,1438,425,417,-8
"a2b4bd40cee2481ebd3fc179d6a5cd62","24cf8786024543f19b89bc20034e60d7",18524205,1,18,0,1439,417,428,11
"24cf8786024543f19b89bc20034e60d7","f2a73be2f46840b182d7bd095378004e",18524205,2,1,0,1440,428,429,1
"f2a73be2f46840b182d7bd095378004e","f67fbf45a5f146ed866965bc57c7c001",18524205,1,42,0,1441,429,454,25
"f67fbf45a5f146ed866965bc57c7c001","f67fbf45a5f146ed866965bc57c7c001",18524205,2,0,1,1442,454,454,0
"f67fbf45a5f146ed866965bc57c7c001","d937afe49bd24a07a550dda1c1155122",18524205,1,1,0,1444,454,455,1
"d937afe49bd24a07a550dda1c1155122","d937afe49bd24a07a550dda1c1155122",18524205,3,0,1,1445,455,455,0
"d937afe49bd24a07a550dda1c1155122","3628b3f7823443d0912a339096b69943",18524205,1,1,0,1448,455,456,1
"3628b3f7823443d0912a339096b69943","3628b3f7823443d0912a339096b69943",18524205,1,0,1,1449,456,456,0
"3628b3f7823443d0912a339096b69943","9e049ee647cf43ecbcb5ed792a8e7588",18524205,1,1,0,1450,456,457,1
"9e049ee647cf43ecbcb5ed792a8e7588","9e049ee647cf43ecbcb5ed792a8e7588",18524205,1,0,1,1451,457,457,0
"9e049ee647cf43ecbcb5ed792a8e7588","5256a214faaf410b93f76cea06428334",18524205,1,1,0,1452,457,458,1
"5256a214faaf410b93f76cea06428334","5256a214faaf410b93f76cea06428334",18524205,1,0,1,1453,458,458,0
"5256a214faaf410b93f76cea06428334","25c32b120fce40fa9b6c85133aeb4716",18524205,1,1,0,1454,458,459,1
"25c32b120fce40fa9b6c85133aeb4716","25c32b120fce40fa9b6c85133aeb4716",18524205,3,0,1,1455,459,459,0
"25c32b120fce40fa9b6c85133aeb4716","11bc14f2204949008b7d511b933363c1",18524205,1,1,0,1458,459,460,1
"11bc14f2204949008b7d511b933363c1","11bc14f2204949008b7d511b933363c1",18524205,6,0,1,1459,460,460,0
"11bc14f2204949008b7d511b933363c1","42de338840a34d15adb66e7b14fb9d2c",18524205,1,1,0,1465,460,461,1
"42de338840a34d15adb66e7b14fb9d2c","42de338840a34d15adb66e7b14fb9d2c",18524205,1,0,1,1466,461,461,0
"42de338840a34d15adb66e7b14fb9d2c","9da37c6210b1416b8079c274f70bf600",18524205,1,1,0,1467,461,462,1
"9da37c6210b1416b8079c274f70bf600","9da37c6210b1416b8079c274f70bf600",18524205,3,0,1,1468,462,462,0
"9da37c6210b1416b8079c274f70bf600","519119f1deac45ff9ab4f13529be5c6e",18524205,1,1,0,1471,462,463,1
"519119f1deac45ff9ab4f13529be5c6e","f67fbf45a5f146ed866965bc57c7c001",18524205,1,-9,0,1472,463,454,-9
"f67fbf45a5f146ed866965bc57c7c001","519119f1deac45ff9ab4f13529be5c6e",18524205,1,9,0,1473,454,463,9
"519119f1deac45ff9ab4f13529be5c6e","c5df9f40ec14463b9dcfdc73df3e9285",18524205,1,3,0,1474,463,464,1
"c5df9f40ec14463b9dcfdc73df3e9285","c5df9f40ec14463b9dcfdc73df3e9285",18524205,1,0,1,1475,464,464,0
"c5df9f40ec14463b9dcfdc73df3e9285","f2a73be2f46840b182d7bd095378004e",18524205,1,-54,0,1476,464,429,-35
"f2a73be2f46840b182d7bd095378004e","604551fd4266430cb860fef58fa7dd61",18524205,1,1,0,1477,429,430,1
"604551fd4266430cb860fef58fa7dd61","604551fd4266430cb860fef58fa7dd61",18524205,7,0,1,1478,430,430,0
"604551fd4266430cb860fef58fa7dd61","dce46f8904594a62a6377a3587aaa663",18524205,1,2,0,1485,430,431,1
"dce46f8904594a62a6377a3587aaa663","24cf8786024543f19b89bc20034e60d7",18524205,3,-4,0,1486,431,428,-3
"24cf8786024543f19b89bc20034e60d7","dce46f8904594a62a6377a3587aaa663",18524205,4,4,0,1487,428,431,3
"dce46f8904594a62a6377a3587aaa663","9b9d0a249052413c869753b99682b0ac",18524205,1,1,0,1488,431,432,1
"9b9d0a249052413c869753b99682b0ac","9b9d0a249052413c869753b99682b0ac",18524205,5,0,1,1489,432,432,0
"9b9d0a249052413c869753b99682b0ac","061c175cc90f45fbad883025394e78dd",18524205,1,1,0,1494,432,433,1
"061c175cc90f45fbad883025394e78dd","061c175cc90f45fbad883025394e78dd",18524205,6,0,1,1495,433,433,0
"061c175cc90f45fbad883025394e78dd","dce46f8904594a62a6377a3587aaa663",18524205,1,-2,0,1501,433,431,-2
"dce46f8904594a62a6377a3587aaa663","66ada10dde9f43018588f1ced9d477fc",18524205,3,4,0,1502,431,434,3
"66ada10dde9f43018588f1ced9d477fc","24cf8786024543f19b89bc20034e60d7",18524205,2,-8,0,1503,434,428,-6
"24cf8786024543f19b89bc20034e60d7","74a7f8712e5449c2bc0b43c6f90dafed",18524205,1,9,0,1509,428,435,7
"74a7f8712e5449c2bc0b43c6f90dafed","74a7f8712e5449c2bc0b43c6f90dafed",18524205,2,0,1,1510,435,435,0
"74a7f8712e5449c2bc0b43c6f90dafed","66ada10dde9f43018588f1ced9d477fc",18524205,1,-1,0,1512,435,434,-1
"66ada10dde9f43018588f1ced9d477fc","bf12c96466d840a69bed7020b3f18bb8",18524205,1,3,0,1513,434,436,2
"bf12c96466d840a69bed7020b3f18bb8","bf12c96466d840a69bed7020b3f18bb8",18524205,1,0,1,1514,436,436,0
"bf12c96466d840a69bed7020b3f18bb8","070600601c4c439288445d2f0724807d",18524205,1,3,0,1515,436,437,1
"070600601c4c439288445d2f0724807d","24cf8786024543f19b89bc20034e60d7",18524205,2,-14,0,1516,437,428,-9
"24cf8786024543f19b89bc20034e60d7","1823b6de7d334a7aaabc4570719af4d9",18524205,2,16,0,1517,428,439,11
"1823b6de7d334a7aaabc4570719af4d9","24cf8786024543f19b89bc20034e60d7",18524205,1,-16,0,1518,439,428,-11
"f2a73be2f46840b182d7bd095378004e","dce46f8904594a62a6377a3587aaa663",18524205,1,3,0,1520,429,431,2
"66ada10dde9f43018588f1ced9d477fc","070600601c4c439288445d2f0724807d",18524205,1,6,0,1524,434,437,3
"1823b6de7d334a7aaabc4570719af4d9","1823b6de7d334a7aaabc4570719af4d9",18524205,14,0,1,1527,439,439,0
"1823b6de7d334a7aaabc4570719af4d9","0380cd76a7d44bc3a4da1f15e4d68f89",18524205,1,2,0,1541,439,440,1
"0380cd76a7d44bc3a4da1f15e4d68f89","070600601c4c439288445d2f0724807d",18524205,1,-4,0,1542,440,437,-3
"070600601c4c439288445d2f0724807d","0380cd76a7d44bc3a4da1f15e4d68f89",18524205,1,4,0,1543,437,440,3
"0380cd76a7d44bc3a4da1f15e4d68f89","23b7673c8b5443108c2ef09382834a86",18524205,2,2,0,1544,440,441,1
"23b7673c8b5443108c2ef09382834a86","0380cd76a7d44bc3a4da1f15e4d68f89",18524205,1,-2,0,1545,441,440,-1
"23b7673c8b5443108c2ef09382834a86","901e92500aea43c79f19f1b279050668",18524205,2,2,0,1547,441,442,1
"901e92500aea43c79f19f1b279050668","23b7673c8b5443108c2ef09382834a86",18524205,1,-2,0,1548,442,441,-1
"901e92500aea43c79f19f1b279050668","001339db8ced4cf78829ebe8b145449d",18524205,1,1,0,1550,442,443,1
"001339db8ced4cf78829ebe8b145449d","001339db8ced4cf78829ebe8b145449d",18524205,12,0,1,1551,443,443,0
"001339db8ced4cf78829ebe8b145449d","452745e0366e42ae81561bfddebcc6c3",18524205,1,1,0,1563,443,444,1
"452745e0366e42ae81561bfddebcc6c3","452745e0366e42ae81561bfddebcc6c3",18524205,2,0,1,1564,444,444,0
"452745e0366e42ae81561bfddebcc6c3","4660ff2089114e8db82ceb26a4f329e3",18524205,1,2,0,1566,444,445,1
"4660ff2089114e8db82ceb26a4f329e3","901e92500aea43c79f19f1b279050668",18524205,3,-4,0,1567,445,442,-3
"901e92500aea43c79f19f1b279050668","4660ff2089114e8db82ceb26a4f329e3",18524205,2,4,0,1568,442,445,3
"4660ff2089114e8db82ceb26a4f329e3","7bd5586eb9d8484eb74a433ee7bfe499",18524205,1,2,0,1569,445,446,1
"7bd5586eb9d8484eb74a433ee7bfe499","7bd5586eb9d8484eb74a433ee7bfe499",18524205,10,0,1,1570,446,446,0
"7bd5586eb9d8484eb74a433ee7bfe499","b2f0d654738f48158edff28e8d3a546e",18524205,1,7,0,1579,446,449,3
"b2f0d654738f48158edff28e8d3a546e","070600601c4c439288445d2f0724807d",18524205,1,-21,0,1580,449,437,-12
"070600601c4c439288445d2f0724807d","8a7f26e690f34dda97be16904518ca99",18524205,1,16,0,1581,437,447,10
"8a7f26e690f34dda97be16904518ca99","7bd5586eb9d8484eb74a433ee7bfe499",18524205,1,-2,0,1582,447,446,-1
"7bd5586eb9d8484eb74a433ee7bfe499","4660ff2089114e8db82ceb26a4f329e3",18524205,1,-2,0,1584,446,445,-1
"4660ff2089114e8db82ceb26a4f329e3","4660ff2089114e8db82ceb26a4f329e3",18524205,1,0,1,1587,445,445,0
"901e92500aea43c79f19f1b279050668","070600601c4c439288445d2f0724807d",18524205,2,-8,0,1589,442,437,-5
"070600601c4c439288445d2f0724807d","901e92500aea43c79f19f1b279050668",18524205,1,8,0,1590,437,442,5
"b613861cecf84ffcab01afb23f660475","b613861cecf84ffcab01afb23f660475",22850074,2,0,1,1,1,1,0
"b613861cecf84ffcab01afb23f660475","e2911e79efc2420eac45d9f671463d4b",22850074,2,3,0,3,1,2,1
"e2911e79efc2420eac45d9f671463d4b","b613861cecf84ffcab01afb23f660475",22850074,1,-3,0,4,2,1,-1
"e2911e79efc2420eac45d9f671463d4b","e2911e79efc2420eac45d9f671463d4b",22850074,1,0,1,6,2,2,0
"e2911e79efc2420eac45d9f671463d4b","519d1b8c59404d67b54e96c5c8a830b2",22850074,1,1,0,7,2,3,1
"519d1b8c59404d67b54e96c5c8a830b2","519d1b8c59404d67b54e96c5c8a830b2",22850074,1,0,1,8,3,3,0
"519d1b8c59404d67b54e96c5c8a830b2","531db53f81f646edb0cdcfe0085b03b7",22850074,1,1,0,9,3,4,1
"531db53f81f646edb0cdcfe0085b03b7","531db53f81f646edb0cdcfe0085b03b7",22850074,1,0,1,10,4,4,0
"531db53f81f646edb0cdcfe0085b03b7","4f5f94b2f95141e0a9d53a61da2276da",22850074,1,1,0,11,4,5,1
"4f5f94b2f95141e0a9d53a61da2276da","4f5f94b2f95141e0a9d53a61da2276da",22850074,1,0,1,12,5,5,0
"4f5f94b2f95141e0a9d53a61da2276da","6d541c89590949f99af293c4f2333f67",22850074,1,1,0,13,5,6,1
"6d541c89590949f99af293c4f2333f67","6d541c89590949f99af293c4f2333f67",22850074,1,0,1,14,6,6,0
"6d541c89590949f99af293c4f2333f67","dd5cf0b9fe4c4f1d8f5ff8e4c04879cb",22850074,1,1,0,15,6,7,1
"dd5cf0b9fe4c4f1d8f5ff8e4c04879cb","dd5cf0b9fe4c4f1d8f5ff8e4c04879cb",22850074,1,0,1,16,7,7,0
"dd5cf0b9fe4c4f1d8f5ff8e4c04879cb","f96261861edc426abe2248be4f0a709a",22850074,1,1,0,17,7,8,1
"f96261861edc426abe2248be4f0a709a","f96261861edc426abe2248be4f0a709a",22850074,1,0,1,18,8,8,0
"f96261861edc426abe2248be4f0a709a","66b5e16f4f75454fb5b8172079f0fa83",22850074,1,1,0,19,8,9,1
"66b5e16f4f75454fb5b8172079f0fa83","66b5e16f4f75454fb5b8172079f0fa83",22850074,1,0,1,20,9,9,0
"66b5e16f4f75454fb5b8172079f0fa83","0680571d4698477995e41842c36a54b2",22850074,1,1,0,21,9,10,1
"0680571d4698477995e41842c36a54b2","0680571d4698477995e41842c36a54b2",22850074,1,0,1,22,10,10,0
"0680571d4698477995e41842c36a54b2","9112f2bffece48e08c6d2287be204085",22850074,1,1,0,23,10,11,1
"9112f2bffece48e08c6d2287be204085","9112f2bffece48e08c6d2287be204085",22850074,1,0,1,24,11,11,0
"9112f2bffece48e08c6d2287be204085","56586aa865414f538729c7f7735d2bc6",22850074,1,3,0,25,11,12,1
"56586aa865414f538729c7f7735d2bc6","e2911e79efc2420eac45d9f671463d4b",22850074,1,-12,0,26,12,2,-10
"e2911e79efc2420eac45d9f671463d4b","56586aa865414f538729c7f7735d2bc6",22850074,1,12,0,27,2,12,10
"56586aa865414f538729c7f7735d2bc6","56586aa865414f538729c7f7735d2bc6",22850074,3,0,1,28,12,12,0
"56586aa865414f538729c7f7735d2bc6","b7f2b31585d94eb3bf86376714aa7070",22850074,4,2,0,29,12,13,1
"b7f2b31585d94eb3bf86376714aa7070","56586aa865414f538729c7f7735d2bc6",22850074,2,-2,0,30,13,12,-1
"b7f2b31585d94eb3bf86376714aa7070","b7f2b31585d94eb3bf86376714aa7070",22850074,1,0,1,32,13,13,0
"b7f2b31585d94eb3bf86376714aa7070","3f1c815879794b929260d224becaff7e",22850074,1,2,0,33,13,14,1
"3f1c815879794b929260d224becaff7e","56586aa865414f538729c7f7735d2bc6",22850074,1,-4,0,34,14,12,-2
"b7f2b31585d94eb3bf86376714aa7070","5c5ceeee4562457ba6d41515aeebfbb1",22850074,1,8,0,40,13,17,4
"5c5ceeee4562457ba6d41515aeebfbb1","81c864a886d54a6b8ff85f7d736f4f95",22850074,2,-4,0,41,17,15,-2
"81c864a886d54a6b8ff85f7d736f4f95","eb2a0eb537344a9e891c761662e400b6",22850074,1,2,0,42,15,16,1
"eb2a0eb537344a9e891c761662e400b6","5c5ceeee4562457ba6d41515aeebfbb1",22850074,1,2,0,43,16,17,1
"81c864a886d54a6b8ff85f7d736f4f95","5c5ceeee4562457ba6d41515aeebfbb1",22850074,1,4,0,45,15,17,2
"5c5ceeee4562457ba6d41515aeebfbb1","9afd71a5298d4333b6849dfce1b9422c",22850074,1,3,0,46,17,18,1
"9afd71a5298d4333b6849dfce1b9422c","56586aa865414f538729c7f7735d2bc6",22850074,1,-13,0,47,18,12,-6
"56586aa865414f538729c7f7735d2bc6","b7719e26494940efa49512aedd0aac79",22850074,1,17,0,48,12,20,8
"b7719e26494940efa49512aedd0aac79","9afd71a5298d4333b6849dfce1b9422c",22850074,1,-4,0,49,20,18,-2
"9afd71a5298d4333b6849dfce1b9422c","d4c3b003e8274e429d2fa688d73fde6d",22850074,1,7,0,50,18,22,4
"d4c3b003e8274e429d2fa688d73fde6d","d4f45188d3c84a02ba08454e6403a818",22850074,1,2,0,51,22,24,2
"d4f45188d3c84a02ba08454e6403a818","d4c3b003e8274e429d2fa688d73fde6d",22850074,1,-2,0,52,24,22,-2
"d4c3b003e8274e429d2fa688d73fde6d","b7719e26494940efa49512aedd0aac79",22850074,1,-3,0,53,22,20,-2
"b7719e26494940efa49512aedd0aac79","b7719e26494940efa49512aedd0aac79",22850074,1,0,1,54,20,20,0
"b7719e26494940efa49512aedd0aac79","afbf7250b99d47bea07172749483ca97",22850074,1,12,0,55,20,28,8
"afbf7250b99d47bea07172749483ca97","afbf7250b99d47bea07172749483ca97",22850074,1,0,1,56,28,28,0
"afbf7250b99d47bea07172749483ca97","4e51676dc72045d99c19b9fa7b22f8bc",22850074,1,3,0,57,28,29,1
"4e51676dc72045d99c19b9fa7b22f8bc","4e51676dc72045d99c19b9fa7b22f8bc",22850074,1,0,1,58,29,29,0
"4e51676dc72045d99c19b9fa7b22f8bc","51970cfa30e643e894e66ae85c8024cc",22850074,1,3,0,59,29,31,2
"51970cfa30e643e894e66ae85c8024cc","c9c52446b6294aa5a9c2abaed536c37e",22850074,1,2,0,60,31,32,1
"c9c52446b6294aa5a9c2abaed536c37e","51970cfa30e643e894e66ae85c8024cc",22850074,1,-2,0,61,32,31,-1
"51970cfa30e643e894e66ae85c8024cc","4e51676dc72045d99c19b9fa7b22f8bc",22850074,1,-3,0,62,31,29,-2
"4e51676dc72045d99c19b9fa7b22f8bc","c33c17be71ae4d588da7369472e5bb1b",22850074,1,9,0,63,29,34,5
"c33c17be71ae4d588da7369472e5bb1b","c33c17be71ae4d588da7369472e5bb1b",22850074,1,0,1,64,34,34,0
"c33c17be71ae4d588da7369472e5bb1b","93679be414554a11b1893002f2229a93",22850074,1,3,0,65,34,35,1
"93679be414554a11b1893002f2229a93","93679be414554a11b1893002f2229a93",22850074,1,0,1,66,35,35,0
"93679be414554a11b1893002f2229a93","7040a13096d746ac84b8fac8d9752058",22850074,1,3,0,67,35,36,1
"7040a13096d746ac84b8fac8d9752058","7040a13096d746ac84b8fac8d9752058",22850074,1,0,1,68,36,36,0
"7040a13096d746ac84b8fac8d9752058","9a0dc646f934470daf08c4b56ccf73db",22850074,1,3,0,69,36,37,1
"9a0dc646f934470daf08c4b56ccf73db","9a0dc646f934470daf08c4b56ccf73db",22850074,1,0,1,70,37,37,0
"9a0dc646f934470daf08c4b56ccf73db","fc0e049d56024bc9a02c9a9c435c3df7",22850074,1,3,0,71,37,38,1
"fc0e049d56024bc9a02c9a9c435c3df7","fc0e049d56024bc9a02c9a9c435c3df7",22850074,1,0,1,72,38,38,0
"fc0e049d56024bc9a02c9a9c435c3df7","67a089198fcb4e1c8f2385786c2b296f",22850074,1,4,0,73,38,39,1
"67a089198fcb4e1c8f2385786c2b296f","fc0e049d56024bc9a02c9a9c435c3df7",22850074,1,-4,0,74,39,38,-1
"fc0e049d56024bc9a02c9a9c435c3df7","64d48c6c9c7940639a932219a6c87198",22850074,1,5,0,75,38,40,2
"64d48c6c9c7940639a932219a6c87198","64d48c6c9c7940639a932219a6c87198",22850074,1,0,1,76,40,40,0
"64d48c6c9c7940639a932219a6c87198","b534b89233134e30a9b5645138bfa9ee",22850074,1,3,0,77,40,41,1
"b534b89233134e30a9b5645138bfa9ee","67a089198fcb4e1c8f2385786c2b296f",22850074,1,-4,0,78,41,39,-2
"b534b89233134e30a9b5645138bfa9ee","fc5d3a81023c41d8ab70b19d4c5c50eb",22850074,1,1,0,80,41,42,1
"fc5d3a81023c41d8ab70b19d4c5c50eb","0e37b720d23b4e7f8b313e79313fd107",22850074,1,2,0,81,42,44,2
"0e37b720d23b4e7f8b313e79313fd107","0e37b720d23b4e7f8b313e79313fd107",22850074,1,0,1,82,44,44,0
"0e37b720d23b4e7f8b313e79313fd107","6875d67fdd5f48168b62719df449bebd",22850074,1,1,0,83,44,45,1
"6875d67fdd5f48168b62719df449bebd","6875d67fdd5f48168b62719df449bebd",22850074,1,0,1,84,45,45,0
"6875d67fdd5f48168b62719df449bebd","6e13d61a7bdb44bca949c9f86fab3be5",22850074,1,3,0,85,45,47,2
"6e13d61a7bdb44bca949c9f86fab3be5","b534b89233134e30a9b5645138bfa9ee",22850074,1,-7,0,86,47,41,-6
"b534b89233134e30a9b5645138bfa9ee","6e13d61a7bdb44bca949c9f86fab3be5",22850074,1,7,0,87,41,47,6
"6e13d61a7bdb44bca949c9f86fab3be5","6e13d61a7bdb44bca949c9f86fab3be5",22850074,1,0,1,88,47,47,0
"6e13d61a7bdb44bca949c9f86fab3be5","195f78799f984cc2b06c48dfe36be751",22850074,1,2,0,89,47,49,2
"195f78799f984cc2b06c48dfe36be751","195f78799f984cc2b06c48dfe36be751",22850074,2,0,1,90,49,49,0
"195f78799f984cc2b06c48dfe36be751","d9c8d8c444a64dadbbb508652c721e17",22850074,1,-3,0,92,49,46,-3
"d9c8d8c444a64dadbbb508652c721e17","d0c74f735e024943943e40333d6d337f",22850074,1,6,0,93,46,51,5
"d0c74f735e024943943e40333d6d337f","d0c74f735e024943943e40333d6d337f",22850074,1,0,1,94,51,51,0
"d0c74f735e024943943e40333d6d337f","983f8ff320594b279a7f4a6fe132f9c5",22850074,1,2,0,95,51,53,2
"983f8ff320594b279a7f4a6fe132f9c5","983f8ff320594b279a7f4a6fe132f9c5",22850074,2,0,1,96,53,53,0
"983f8ff320594b279a7f4a6fe132f9c5","35adfa5d923046aebabfefd98f35ff05",22850074,1,1,0,98,53,54,1
"35adfa5d923046aebabfefd98f35ff05","35adfa5d923046aebabfefd98f35ff05",22850074,8,0,1,100,54,54,0
"35adfa5d923046aebabfefd98f35ff05","b6f8a98476224da1b40e555ececc7ed8",22850074,1,1,0,107,54,55,1
"b6f8a98476224da1b40e555ececc7ed8","b6f8a98476224da1b40e555ececc7ed8",22850074,2,0,1,108,55,55,0
"b6f8a98476224da1b40e555ececc7ed8","86e22cb5fe0e4b47a9489ecddf7ed78f",22850074,1,1,0,110,55,56,1
"86e22cb5fe0e4b47a9489ecddf7ed78f","86e22cb5fe0e4b47a9489ecddf7ed78f",22850074,2,0,1,111,56,56,0
"86e22cb5fe0e4b47a9489ecddf7ed78f","78f30e4dcac84e3cbea8b2cc6e0d62b3",22850074,1,4,0,113,56,59,3
"78f30e4dcac84e3cbea8b2cc6e0d62b3","a1f2f12debe5432fb7a70bcd12bacfb9",22850074,1,-1,0,114,59,58,-1
"a1f2f12debe5432fb7a70bcd12bacfb9","f924752d8a1149668870b1e7698486f7",22850074,1,-9,0,115,58,50,-8
"f924752d8a1149668870b1e7698486f7","a1f2f12debe5432fb7a70bcd12bacfb9",22850074,1,9,0,116,50,58,8
"a1f2f12debe5432fb7a70bcd12bacfb9","a1f2f12debe5432fb7a70bcd12bacfb9",22850074,20,0,1,117,58,58,0
"a1f2f12debe5432fb7a70bcd12bacfb9","78f30e4dcac84e3cbea8b2cc6e0d62b3",22850074,1,1,0,137,58,59,1
"78f30e4dcac84e3cbea8b2cc6e0d62b3","78f30e4dcac84e3cbea8b2cc6e0d62b3",22850074,25,0,1,138,59,59,0
"78f30e4dcac84e3cbea8b2cc6e0d62b3","12aa6e1672ac4e7aa6449a7a8609cd72",22850074,1,-2,0,163,59,57,-2
"12aa6e1672ac4e7aa6449a7a8609cd72","a0a418b8540d479fa6e0f653b701da8b",22850074,1,8,0,164,57,64,7
"a0a418b8540d479fa6e0f653b701da8b","bc42d26810654ea9a1df1efe1e58c7d5",22850074,3,-1,0,165,64,63,-1
"bc42d26810654ea9a1df1efe1e58c7d5","4c943503763e4e349906eea3ed3c8e86",22850074,1,-2,0,166,63,61,-2
"4c943503763e4e349906eea3ed3c8e86","4c943503763e4e349906eea3ed3c8e86",22850074,1,0,1,167,61,61,0
"4c943503763e4e349906eea3ed3c8e86","bc42d26810654ea9a1df1efe1e58c7d5",22850074,1,2,0,168,61,63,2
"bc42d26810654ea9a1df1efe1e58c7d5","bc42d26810654ea9a1df1efe1e58c7d5",22850074,3,0,1,169,63,63,0
"bc42d26810654ea9a1df1efe1e58c7d5","a0a418b8540d479fa6e0f653b701da8b",22850074,4,1,0,172,63,64,1
"a0a418b8540d479fa6e0f653b701da8b","a0a418b8540d479fa6e0f653b701da8b",22850074,3,0,1,173,64,64,0
"a0a418b8540d479fa6e0f653b701da8b","309ccf3cc4fe429d9bfbaef53d3fa479",22850074,1,-4,0,176,64,60,-4
"309ccf3cc4fe429d9bfbaef53d3fa479","d646286c8051419bbc2e31dd1db55ca8",22850074,1,10,0,177,60,67,7
"d646286c8051419bbc2e31dd1db55ca8","b534b89233134e30a9b5645138bfa9ee",22850074,1,-33,0,178,67,41,-26
"b534b89233134e30a9b5645138bfa9ee","267f883678b24aed855fde42524975d9",22850074,1,37,0,179,41,71,30
"267f883678b24aed855fde42524975d9","267f883678b24aed855fde42524975d9",22850074,1,0,1,180,71,71,0
"267f883678b24aed855fde42524975d9","88fff56d0342490dbef9040750a20f6c",22850074,1,1,0,181,71,72,1
"88fff56d0342490dbef9040750a20f6c","88fff56d0342490dbef9040750a20f6c",22850074,1,0,1,182,72,72,0
"88fff56d0342490dbef9040750a20f6c","adb17b12b66c4a49a85fd34322f7df70",22850074,1,1,0,183,72,73,1
"adb17b12b66c4a49a85fd34322f7df70","adb17b12b66c4a49a85fd34322f7df70",22850074,1,0,1,184,73,73,0
"adb17b12b66c4a49a85fd34322f7df70","d646286c8051419bbc2e31dd1db55ca8",22850074,1,-6,0,185,73,67,-6
"d646286c8051419bbc2e31dd1db55ca8","a2becd407db34b189200a32546d9d569",22850074,1,9,0,186,67,75,8
"a2becd407db34b189200a32546d9d569","a2becd407db34b189200a32546d9d569",22850074,3,0,1,187,75,75,0
"a2becd407db34b189200a32546d9d569","58c22b011d0f4c2ea6d13615edbb9eeb",22850074,1,2,0,190,75,77,2
"58c22b011d0f4c2ea6d13615edbb9eeb","58c22b011d0f4c2ea6d13615edbb9eeb",22850074,2,0,1,191,77,77,0
"58c22b011d0f4c2ea6d13615edbb9eeb","dd76e1861dc9461c830888729d091ee0",22850074,1,1,0,193,77,78,1
"dd76e1861dc9461c830888729d091ee0","dd76e1861dc9461c830888729d091ee0",22850074,5,0,1,194,78,78,0
"dd76e1861dc9461c830888729d091ee0","cd1d828f1a694b87913a7ea66c23803e",22850074,1,1,0,199,78,79,1
"cd1d828f1a694b87913a7ea66c23803e","cd1d828f1a694b87913a7ea66c23803e",22850074,2,0,1,200,79,79,0
"cd1d828f1a694b87913a7ea66c23803e","9176a3c2b4d2465fa8b0c67096c2a97e",22850074,1,1,0,202,79,80,1
"9176a3c2b4d2465fa8b0c67096c2a97e","9176a3c2b4d2465fa8b0c67096c2a97e",22850074,5,0,1,203,80,80,0
"9176a3c2b4d2465fa8b0c67096c2a97e","f8ec6445f7194e25b9101d4fbcb07a18",22850074,1,1,0,208,80,81,1
"f8ec6445f7194e25b9101d4fbcb07a18","f8ec6445f7194e25b9101d4fbcb07a18",22850074,2,0,1,209,81,81,0
"f8ec6445f7194e25b9101d4fbcb07a18","140d5b27b8574befad82c0a013b59dfa",22850074,1,-7,0,211,81,74,-7
"140d5b27b8574befad82c0a013b59dfa","d18a9ea32855445f8736581f5cb119ce",22850074,1,9,0,212,74,82,8
"d18a9ea32855445f8736581f5cb119ce","f564483cbd7a407681aa2fcca518cf5f",22850074,1,4,0,213,82,85,3
"f564483cbd7a407681aa2fcca518cf5f","f564483cbd7a407681aa2fcca518cf5f",22850074,1,0,1,214,85,85,0
"f564483cbd7a407681aa2fcca518cf5f","18fd01350bd5434ca636d59a599d768a",22850074,1,1,0,215,85,86,1
"18fd01350bd5434ca636d59a599d768a","18fd01350bd5434ca636d59a599d768a",22850074,9,0,1,216,86,86,0
"18fd01350bd5434ca636d59a599d768a","ae5ac430ea254e708a6f5deaaf7464ae",22850074,1,-2,0,225,86,84,-2
"ae5ac430ea254e708a6f5deaaf7464ae","6a9f0ef185fb47f0937e29daa1c71ed5",22850074,3,7,0,226,84,90,6
"6a9f0ef185fb47f0937e29daa1c71ed5","42fb58708eaf4e5daa82bfca61b6f5fd",22850074,1,-3,0,227,90,87,-3
"42fb58708eaf4e5daa82bfca61b6f5fd","ae5ac430ea254e708a6f5deaaf7464ae",22850074,2,-4,0,228,87,84,-3
"6a9f0ef185fb47f0937e29daa1c71ed5","d18a9ea32855445f8736581f5cb119ce",22850074,4,-10,0,230,90,82,-8
"d18a9ea32855445f8736581f5cb119ce","42fb58708eaf4e5daa82bfca61b6f5fd",22850074,3,7,0,231,82,87,5
"42fb58708eaf4e5daa82bfca61b6f5fd","6a9f0ef185fb47f0937e29daa1c71ed5",22850074,2,3,0,236,87,90,3
"d18a9ea32855445f8736581f5cb119ce","c681290961c94c4caf23b529d1ae6b9a",22850074,1,8,0,241,82,88,6
"c681290961c94c4caf23b529d1ae6b9a","c681290961c94c4caf23b529d1ae6b9a",22850074,1,0,1,242,88,88,0
"c681290961c94c4caf23b529d1ae6b9a","6a9f0ef185fb47f0937e29daa1c71ed5",22850074,1,2,0,243,88,90,2
"6a9f0ef185fb47f0937e29daa1c71ed5","6a9f0ef185fb47f0937e29daa1c71ed5",22850074,3,0,1,244,90,90,0
"6a9f0ef185fb47f0937e29daa1c71ed5","e20db35ced8544ddac5bc3839145e463",22850074,1,3,0,247,90,91,1
"e20db35ced8544ddac5bc3839145e463","d646286c8051419bbc2e31dd1db55ca8",22850074,1,-30,0,248,91,67,-24
"d646286c8051419bbc2e31dd1db55ca8","1febb706d7a34005ae8711ed49c76e64",22850074,1,33,0,249,67,94,27
"1febb706d7a34005ae8711ed49c76e64","1febb706d7a34005ae8711ed49c76e64",22850074,2,0,1,250,94,94,0
"1febb706d7a34005ae8711ed49c76e64","8f73ba6f5a0042f2850356ac38ac6f24",22850074,1,1,0,252,94,95,1
"8f73ba6f5a0042f2850356ac38ac6f24","8f73ba6f5a0042f2850356ac38ac6f24",22850074,5,0,1,253,95,95,0
"8f73ba6f5a0042f2850356ac38ac6f24","e2260b86653c46d7b14a41fb419dbf8c",22850074,1,1,0,258,95,96,1
"e2260b86653c46d7b14a41fb419dbf8c","e2260b86653c46d7b14a41fb419dbf8c",22850074,2,0,1,259,96,96,0
"e2260b86653c46d7b14a41fb419dbf8c","35eb641ad1d845bbba54915bce75a962",22850074,1,1,0,261,96,97,1
"35eb641ad1d845bbba54915bce75a962","35eb641ad1d845bbba54915bce75a962",22850074,5,0,1,262,97,97,0
"35eb641ad1d845bbba54915bce75a962","08be90ffbeea4795a138cd42ed8db56f",22850074,1,1,0,267,97,98,1
"08be90ffbeea4795a138cd42ed8db56f","08be90ffbeea4795a138cd42ed8db56f",22850074,5,0,1,268,98,98,0
"08be90ffbeea4795a138cd42ed8db56f","3007433c8f584dcbb5ac159c1c5f2be3",22850074,1,1,0,273,98,99,1
"3007433c8f584dcbb5ac159c1c5f2be3","3007433c8f584dcbb5ac159c1c5f2be3",22850074,2,0,1,274,99,99,0
"3007433c8f584dcbb5ac159c1c5f2be3","00ae5f0c51874a73a41ebea838d95682",22850074,1,3,0,276,99,101,2
"00ae5f0c51874a73a41ebea838d95682","e20db35ced8544ddac5bc3839145e463",22850074,2,-11,0,277,101,91,-10
"e20db35ced8544ddac5bc3839145e463","d391c8b6e56a43a7b654e9dee02d904b",22850074,1,13,0,278,91,103,12
"d391c8b6e56a43a7b654e9dee02d904b","73039f8c1eb9409cb4caee2cf968001e",22850074,1,-3,0,279,103,100,-3
"73039f8c1eb9409cb4caee2cf968001e","e20db35ced8544ddac5bc3839145e463",22850074,1,-10,0,280,100,91,-9
"e20db35ced8544ddac5bc3839145e463","00ae5f0c51874a73a41ebea838d95682",22850074,1,11,0,281,91,101,10
"00ae5f0c51874a73a41ebea838d95682","d391c8b6e56a43a7b654e9dee02d904b",22850074,2,2,0,282,101,103,2
"d391c8b6e56a43a7b654e9dee02d904b","00ae5f0c51874a73a41ebea838d95682",22850074,2,-2,0,283,103,101,-2
"d391c8b6e56a43a7b654e9dee02d904b","d391c8b6e56a43a7b654e9dee02d904b",22850074,16,0,1,285,103,103,0
"d391c8b6e56a43a7b654e9dee02d904b","6111116566fc4fd9abba409322bea245",22850074,1,1,0,301,103,104,1
"6111116566fc4fd9abba409322bea245","6111116566fc4fd9abba409322bea245",22850074,2,0,1,302,104,104,0
"6111116566fc4fd9abba409322bea245","a81b2235cb9c499eb9ea8ee0a8dd9725",22850074,1,1,0,304,104,105,1
"a81b2235cb9c499eb9ea8ee0a8dd9725","a81b2235cb9c499eb9ea8ee0a8dd9725",22850074,5,0,1,305,105,105,0
"a81b2235cb9c499eb9ea8ee0a8dd9725","2d4e0ab0ef3b4d73b82c72d4621a7579",22850074,1,1,0,310,105,106,1
"2d4e0ab0ef3b4d73b82c72d4621a7579","2d4e0ab0ef3b4d73b82c72d4621a7579",22850074,2,0,1,311,106,106,0
"2d4e0ab0ef3b4d73b82c72d4621a7579","8bdebf492ebd4e62b0d522e8ab5e5197",22850074,1,1,0,313,106,107,1
"8bdebf492ebd4e62b0d522e8ab5e5197","8bdebf492ebd4e62b0d522e8ab5e5197",22850074,2,0,1,314,107,107,0
"8bdebf492ebd4e62b0d522e8ab5e5197","4280927ec4d643238aa49c32f9e06c6c",22850074,1,3,0,316,107,109,2
"4280927ec4d643238aa49c32f9e06c6c","73039f8c1eb9409cb4caee2cf968001e",22850074,2,-10,0,317,109,100,-9
"73039f8c1eb9409cb4caee2cf968001e","4280927ec4d643238aa49c32f9e06c6c",22850074,1,10,0,318,100,109,9
"4280927ec4d643238aa49c32f9e06c6c","fc44e6a5f7654430af1227838224dceb",22850074,1,2,0,319,109,111,2
"fc44e6a5f7654430af1227838224dceb","fc44e6a5f7654430af1227838224dceb",22850074,2,0,1,320,111,111,0
"fc44e6a5f7654430af1227838224dceb","a9ae0a3c070d455bb4369a8996313336",22850074,1,4,0,322,111,114,3
"a9ae0a3c070d455bb4369a8996313336","08111f75e22d409998cf8b85bd431f0a",22850074,1,-7,0,323,114,108,-6
"08111f75e22d409998cf8b85bd431f0a","a9ae0a3c070d455bb4369a8996313336",22850074,2,7,0,324,108,114,6
"a9ae0a3c070d455bb4369a8996313336","37319e88176d4aefa91d7a9980dbae91",22850074,1,-2,0,325,114,112,-2
"37319e88176d4aefa91d7a9980dbae91","4280927ec4d643238aa49c32f9e06c6c",22850074,1,-4,0,326,112,109,-3
"4280927ec4d643238aa49c32f9e06c6c","08111f75e22d409998cf8b85bd431f0a",22850074,1,-1,0,327,109,108,-1
"a9ae0a3c070d455bb4369a8996313336","71cec822bcff4f30a20e75dc63ef7b65",22850074,1,2,0,329,114,116,2
"71cec822bcff4f30a20e75dc63ef7b65","71cec822bcff4f30a20e75dc63ef7b65",22850074,1,0,1,330,116,116,0
"71cec822bcff4f30a20e75dc63ef7b65","37319e88176d4aefa91d7a9980dbae91",22850074,1,-4,0,331,116,112,-4
"37319e88176d4aefa91d7a9980dbae91","62bff51286ef4f348717a3cf6fe2318f",22850074,1,9,0,332,112,120,8
"62bff51286ef4f348717a3cf6fe2318f","3ec3a3563847406fa73338f9e9999cf3",22850074,1,-3,0,333,120,117,-3
"3ec3a3563847406fa73338f9e9999cf3","d391c8b6e56a43a7b654e9dee02d904b",22850074,1,-17,0,334,117,103,-14
"e20db35ced8544ddac5bc3839145e463","4280927ec4d643238aa49c32f9e06c6c",22850074,1,20,0,337,91,109,18
"73039f8c1eb9409cb4caee2cf968001e","62bff51286ef4f348717a3cf6fe2318f",22850074,1,23,0,339,100,120,20
"62bff51286ef4f348717a3cf6fe2318f","08111f75e22d409998cf8b85bd431f0a",22850074,1,-14,0,340,120,108,-12
"08111f75e22d409998cf8b85bd431f0a","b1cd0e7dc3ad4a8eb91a4bfdbeb025b0",22850074,1,12,0,341,108,118,10
"b1cd0e7dc3ad4a8eb91a4bfdbeb025b0","b1cd0e7dc3ad4a8eb91a4bfdbeb025b0",22850074,1,0,1,342,118,118,0
"b1cd0e7dc3ad4a8eb91a4bfdbeb025b0","62bff51286ef4f348717a3cf6fe2318f",22850074,1,2,0,343,118,120,2
"62bff51286ef4f348717a3cf6fe2318f","62bff51286ef4f348717a3cf6fe2318f",22850074,3,0,1,344,120,120,0
"62bff51286ef4f348717a3cf6fe2318f","779f9ddd1fd14d1e9e69f72219a1fdbd",22850074,1,3,0,347,120,121,1
"779f9ddd1fd14d1e9e69f72219a1fdbd","e20db35ced8544ddac5bc3839145e463",22850074,1,-36,0,348,121,91,-30
"e20db35ced8544ddac5bc3839145e463","ae26e6cda8ad4a3f81bd347560d9579f",22850074,1,40,0,349,91,125,34
"ae26e6cda8ad4a3f81bd347560d9579f","ae26e6cda8ad4a3f81bd347560d9579f",22850074,3,0,1,350,125,125,0
"ae26e6cda8ad4a3f81bd347560d9579f","ee48df95832b4374aa273ceb27ec1315",22850074,1,1,0,353,125,126,1
"ee48df95832b4374aa273ceb27ec1315","ee48df95832b4374aa273ceb27ec1315",22850074,1,0,1,354,126,126,0
"ee48df95832b4374aa273ceb27ec1315","7a439da90b394756ad1777fc4c6dead5",22850074,1,1,0,355,126,127,1
"7a439da90b394756ad1777fc4c6dead5","7a439da90b394756ad1777fc4c6dead5",22850074,1,0,1,356,127,127,0
"7a439da90b394756ad1777fc4c6dead5","a8dd5213034441ac92724b4e83eb0bb2",22850074,1,3,0,357,127,129,2
"a8dd5213034441ac92724b4e83eb0bb2","779f9ddd1fd14d1e9e69f72219a1fdbd",22850074,1,-9,0,358,129,121,-8
"779f9ddd1fd14d1e9e69f72219a1fdbd","a8dd5213034441ac92724b4e83eb0bb2",22850074,1,9,0,359,121,129,8
"a8dd5213034441ac92724b4e83eb0bb2","8115eab6556b45f5b415c3b8c26a12e5",22850074,1,2,0,360,129,131,2
"8115eab6556b45f5b415c3b8c26a12e5","8115eab6556b45f5b415c3b8c26a12e5",22850074,2,0,1,361,131,131,0
"8115eab6556b45f5b415c3b8c26a12e5","ec34b06efd844b46a4c4818ecdb9b8f4",22850074,1,1,0,363,131,132,1
"ec34b06efd844b46a4c4818ecdb9b8f4","ec34b06efd844b46a4c4818ecdb9b8f4",22850074,2,0,1,364,132,132,0
"ec34b06efd844b46a4c4818ecdb9b8f4","c2e1c2b9eac64109b343a088584b576b",22850074,1,1,0,366,132,133,1
"c2e1c2b9eac64109b343a088584b576b","c2e1c2b9eac64109b343a088584b576b",22850074,2,0,1,367,133,133,0
"c2e1c2b9eac64109b343a088584b576b","579338175e0b4bbb8ef3b712b5d8b54e",22850074,1,-5,0,369,133,128,-5
"579338175e0b4bbb8ef3b712b5d8b54e","8bc5795d6a984a3eace4e2811e52dd4f",22850074,1,8,0,370,128,135,7
"8bc5795d6a984a3eace4e2811e52dd4f","8bc5795d6a984a3eace4e2811e52dd4f",22850074,1,0,1,371,135,135,0
"8bc5795d6a984a3eace4e2811e52dd4f","b416d47c56a742199b5d7c7f19d6503a",22850074,1,-1,0,372,135,134,-1
"b416d47c56a742199b5d7c7f19d6503a","cd4532ad48034873ba8bce2aac0c9808",22850074,1,4,0,373,134,137,3
"cd4532ad48034873ba8bce2aac0c9808","cd4532ad48034873ba8bce2aac0c9808",22850074,1,0,1,374,137,137,0
"cd4532ad48034873ba8bce2aac0c9808","df1de691dafe4549a18a4398ee9dfaf9",22850074,1,4,0,375,137,139,2
"df1de691dafe4549a18a4398ee9dfaf9","779f9ddd1fd14d1e9e69f72219a1fdbd",22850074,1,-23,0,376,139,121,-18
"779f9ddd1fd14d1e9e69f72219a1fdbd","6c5ad271a44743479bfaea29b1db8d02",22850074,1,27,0,377,121,143,22
"6c5ad271a44743479bfaea29b1db8d02","df1de691dafe4549a18a4398ee9dfaf9",22850074,1,-4,0,378,143,139,-4
"df1de691dafe4549a18a4398ee9dfaf9","df1de691dafe4549a18a4398ee9dfaf9",22850074,1,0,1,379,139,139,0
"df1de691dafe4549a18a4398ee9dfaf9","6c5ad271a44743479bfaea29b1db8d02",22850074,1,4,0,380,139,143,4
"6c5ad271a44743479bfaea29b1db8d02","6c5ad271a44743479bfaea29b1db8d02",22850074,1,0,1,381,143,143,0
"6c5ad271a44743479bfaea29b1db8d02","83d311bed5374fee83d8d67a7d9d82dc",22850074,1,1,0,382,143,144,1
"83d311bed5374fee83d8d67a7d9d82dc","83d311bed5374fee83d8d67a7d9d82dc",22850074,1,0,1,383,144,144,0
"83d311bed5374fee83d8d67a7d9d82dc","402bba41861d43acb52a5abb89e8831e",22850074,1,1,0,384,144,145,1
"402bba41861d43acb52a5abb89e8831e","402bba41861d43acb52a5abb89e8831e",22850074,2,0,1,385,145,145,0
"402bba41861d43acb52a5abb89e8831e","8aae34f5ddbb4052a709b12e6b0d40fa",22850074,1,3,0,387,145,147,2
"8aae34f5ddbb4052a709b12e6b0d40fa","df1de691dafe4549a18a4398ee9dfaf9",22850074,1,-9,0,388,147,139,-8
"df1de691dafe4549a18a4398ee9dfaf9","8aae34f5ddbb4052a709b12e6b0d40fa",22850074,1,9,0,389,139,147,8
"8aae34f5ddbb4052a709b12e6b0d40fa","645b3f0249f64f76af2e19eb4d0e55b7",22850074,1,2,0,390,147,149,2
"645b3f0249f64f76af2e19eb4d0e55b7","645b3f0249f64f76af2e19eb4d0e55b7",22850074,8,0,1,391,149,149,0
"645b3f0249f64f76af2e19eb4d0e55b7","7e7b8db5064d4369805ab370aac5ddfb",22850074,1,1,0,399,149,150,1
"7e7b8db5064d4369805ab370aac5ddfb","7e7b8db5064d4369805ab370aac5ddfb",22850074,5,0,1,400,150,150,0
"7e7b8db5064d4369805ab370aac5ddfb","8956d210ae7f41968fada86d4c979d6a",22850074,1,1,0,405,150,151,1
"8956d210ae7f41968fada86d4c979d6a","8956d210ae7f41968fada86d4c979d6a",22850074,2,0,1,406,151,151,0
"8956d210ae7f41968fada86d4c979d6a","f902b0f41b544d4dbf79664fd233648d",22850074,1,-5,0,408,151,146,-5
"f902b0f41b544d4dbf79664fd233648d","ae781e8b775e4ccd93bc800dad5c8376",22850074,1,8,0,409,146,153,7
"ae781e8b775e4ccd93bc800dad5c8376","ae781e8b775e4ccd93bc800dad5c8376",22850074,2,0,1,410,153,153,0
"ae781e8b775e4ccd93bc800dad5c8376","06882a8492d9499aa31555567f575ecb",22850074,1,1,0,412,153,154,1
"06882a8492d9499aa31555567f575ecb","06882a8492d9499aa31555567f575ecb",22850074,1,0,1,413,154,154,0
"06882a8492d9499aa31555567f575ecb","f293c508f409466a8f27ddd7d1e40b20",22850074,1,1,0,414,154,155,1
"f293c508f409466a8f27ddd7d1e40b20","f293c508f409466a8f27ddd7d1e40b20",22850074,2,0,1,415,155,155,0
"f293c508f409466a8f27ddd7d1e40b20","cc4ddef5bbbe48ebb605141b347c4ed1",22850074,1,1,0,417,155,156,1
"cc4ddef5bbbe48ebb605141b347c4ed1","cc4ddef5bbbe48ebb605141b347c4ed1",22850074,5,0,1,418,156,156,0
"cc4ddef5bbbe48ebb605141b347c4ed1","f03480cf4eba413194d7af52fc0e7f28",22850074,1,-4,0,423,156,152,-4
"f03480cf4eba413194d7af52fc0e7f28","d313cec988a84645bee413e8d4724a4b",22850074,1,7,0,424,152,158,6
"d313cec988a84645bee413e8d4724a4b","d313cec988a84645bee413e8d4724a4b",22850074,6,0,1,425,158,158,0
"d313cec988a84645bee413e8d4724a4b","dc60696c76a74368a60f72246e47700d",22850074,1,1,0,429,158,159,1
"dc60696c76a74368a60f72246e47700d","dc60696c76a74368a60f72246e47700d",22850074,1,0,1,430,159,159,0
"dc60696c76a74368a60f72246e47700d","df1de691dafe4549a18a4398ee9dfaf9",22850074,1,-23,0,431,159,139,-20
"df1de691dafe4549a18a4398ee9dfaf9","78adeee1fa2c4fe0bc73f7bca9fcee86",22850074,2,26,0,432,139,160,21
"78adeee1fa2c4fe0bc73f7bca9fcee86","78adeee1fa2c4fe0bc73f7bca9fcee86",22850074,3,0,1,433,160,160,0
"78adeee1fa2c4fe0bc73f7bca9fcee86","65202579580f4ad38d734b4ee39d22a8",22850074,5,5,0,434,160,164,4
"65202579580f4ad38d734b4ee39d22a8","65202579580f4ad38d734b4ee39d22a8",22850074,82,0,1,435,164,164,0
"65202579580f4ad38d734b4ee39d22a8","8959e6304a0348309a771e4d08d1b64a",22850074,2,-1,0,442,164,163,-1
"8959e6304a0348309a771e4d08d1b64a","65202579580f4ad38d734b4ee39d22a8",22850074,1,1,0,443,163,164,1
"65202579580f4ad38d734b4ee39d22a8","78adeee1fa2c4fe0bc73f7bca9fcee86",22850074,4,-5,0,446,164,160,-4
"8959e6304a0348309a771e4d08d1b64a","df1de691dafe4549a18a4398ee9dfaf9",22850074,1,-30,0,464,163,139,-24
"78adeee1fa2c4fe0bc73f7bca9fcee86","d313cec988a84645bee413e8d4724a4b",22850074,1,-4,0,466,160,158,-2
"d313cec988a84645bee413e8d4724a4b","67a089198fcb4e1c8f2385786c2b296f",22850074,1,-148,0,469,158,39,-119
"67a089198fcb4e1c8f2385786c2b296f","b534b89233134e30a9b5645138bfa9ee",22850074,2,4,0,470,39,41,2
"b534b89233134e30a9b5645138bfa9ee","309ccf3cc4fe429d9bfbaef53d3fa479",22850074,1,23,0,471,41,60,19
"309ccf3cc4fe429d9bfbaef53d3fa479","bc42d26810654ea9a1df1efe1e58c7d5",22850074,1,3,0,472,60,63,3
"a0a418b8540d479fa6e0f653b701da8b","a1f2f12debe5432fb7a70bcd12bacfb9",22850074,1,-7,0,478,64,58,-6
"a1f2f12debe5432fb7a70bcd12bacfb9","309ccf3cc4fe429d9bfbaef53d3fa479",22850074,1,3,0,479,58,60,2
"309ccf3cc4fe429d9bfbaef53d3fa479","78f30e4dcac84e3cbea8b2cc6e0d62b3",22850074,1,-2,0,480,60,59,-1
"78f30e4dcac84e3cbea8b2cc6e0d62b3","78adeee1fa2c4fe0bc73f7bca9fcee86",22850074,1,127,0,481,59,160,101
"78adeee1fa2c4fe0bc73f7bca9fcee86","8959e6304a0348309a771e4d08d1b64a",22850074,1,4,0,482,160,163,3
"8959e6304a0348309a771e4d08d1b64a","78adeee1fa2c4fe0bc73f7bca9fcee86",22850074,1,-4,0,483,163,160,-3
"78adeee1fa2c4fe0bc73f7bca9fcee86","3cbcea2be0984e7dbd5a48195af10ce7",22850074,1,8,0,550,160,165,5
"3cbcea2be0984e7dbd5a48195af10ce7","82e6285962b8400d9d6fc32436022a94",22850074,1,2,0,551,165,167,2
"82e6285962b8400d9d6fc32436022a94","3cbcea2be0984e7dbd5a48195af10ce7",22850074,1,-2,0,552,167,165,-2
"3cbcea2be0984e7dbd5a48195af10ce7","a9ac840f098c4bd0a2ee896214ce29cd",22850074,1,5,0,553,165,168,3
"a9ac840f098c4bd0a2ee896214ce29cd","0c7262dff33c4087bc660ccf40f92f9c",22850074,1,4,0,554,168,169,1
"0c7262dff33c4087bc660ccf40f92f9c","0c7262dff33c4087bc660ccf40f92f9c",22850074,1,0,1,555,169,169,0
"0c7262dff33c4087bc660ccf40f92f9c","b2275c3fad834f8d90737a2d9a6927d6",22850074,1,3,0,556,169,172,3
"b2275c3fad834f8d90737a2d9a6927d6","b2275c3fad834f8d90737a2d9a6927d6",22850074,23,0,1,557,172,172,0
"b2275c3fad834f8d90737a2d9a6927d6","eb515a26030b41f8a82a1e6114420bad",22850074,1,1,0,580,172,173,1
"eb515a26030b41f8a82a1e6114420bad","eb515a26030b41f8a82a1e6114420bad",22850074,2,0,1,581,173,173,0
"eb515a26030b41f8a82a1e6114420bad","0c7262dff33c4087bc660ccf40f92f9c",22850074,1,-4,0,583,173,169,-4
"0c7262dff33c4087bc660ccf40f92f9c","b42cc17b7de840f181a704558d0bc845",22850074,1,7,0,584,169,175,6
"b42cc17b7de840f181a704558d0bc845","b42cc17b7de840f181a704558d0bc845",22850074,1,0,1,585,175,175,0
"b42cc17b7de840f181a704558d0bc845","801f9e9135034f49bf5f8b4bdefedb41",22850074,1,2,0,586,175,177,2
"801f9e9135034f49bf5f8b4bdefedb41","801f9e9135034f49bf5f8b4bdefedb41",22850074,4,0,1,587,177,177,0
"801f9e9135034f49bf5f8b4bdefedb41","362fcb0699a14845ab29b2340093e528",22850074,1,-3,0,591,177,174,-3
"362fcb0699a14845ab29b2340093e528","ea38cc0e6e6e41edbabf210220808bf9",22850074,1,6,0,592,174,179,5
"ea38cc0e6e6e41edbabf210220808bf9","b87c552dd247427abe6ab5795b9c9d43",22850074,2,2,0,593,179,181,2
"b87c552dd247427abe6ab5795b9c9d43","ea38cc0e6e6e41edbabf210220808bf9",22850074,1,-2,0,594,181,179,-2
"b87c552dd247427abe6ab5795b9c9d43","b87c552dd247427abe6ab5795b9c9d43",22850074,7,0,1,596,181,181,0
"b87c552dd247427abe6ab5795b9c9d43","139b097acfca451689d80c9c6eebdf7b",22850074,1,-3,0,603,181,178,-3
"139b097acfca451689d80c9c6eebdf7b","30f660a1feb34582a739722532524f79",22850074,1,6,0,604,178,183,5
"30f660a1feb34582a739722532524f79","30f660a1feb34582a739722532524f79",22850074,3,0,1,605,183,183,0
"30f660a1feb34582a739722532524f79","2024b4885bd14338a39b7b509acbbd02",22850074,1,-1,0,608,183,182,-1
"2024b4885bd14338a39b7b509acbbd02","c3f63fe50d8e487c86bf8ef76c9cadd3",22850074,1,4,0,609,182,185,3
"c3f63fe50d8e487c86bf8ef76c9cadd3","c3f63fe50d8e487c86bf8ef76c9cadd3",22850074,1,0,1,610,185,185,0
"c3f63fe50d8e487c86bf8ef76c9cadd3","0c7262dff33c4087bc660ccf40f92f9c",22850074,1,-20,0,611,185,169,-16
"0c7262dff33c4087bc660ccf40f92f9c","c8e371568a0c4391b25796ae4e91952e",22850074,1,23,0,612,169,186,17
"c8e371568a0c4391b25796ae4e91952e","7d932b23e1c84326ae5aa4d3c0d813d1",22850074,1,2,0,613,186,188,2
"7d932b23e1c84326ae5aa4d3c0d813d1","7d932b23e1c84326ae5aa4d3c0d813d1",22850074,3,0,1,614,188,188,0
"7d932b23e1c84326ae5aa4d3c0d813d1","c8e371568a0c4391b25796ae4e91952e",22850074,1,-2,0,617,188,186,-2
"c8e371568a0c4391b25796ae4e91952e","ab11d94c6c8948ea90b88f19d2cd502b",22850074,2,5,0,618,186,190,4
"ab11d94c6c8948ea90b88f19d2cd502b","ab11d94c6c8948ea90b88f19d2cd502b",22850074,1,0,1,619,190,190,0
"ab11d94c6c8948ea90b88f19d2cd502b","f992451ed6ad4e68bb9e68ad6be7c4be",22850074,1,2,0,620,190,192,2
"f992451ed6ad4e68bb9e68ad6be7c4be","f992451ed6ad4e68bb9e68ad6be7c4be",22850074,1,0,1,621,192,192,0
"f992451ed6ad4e68bb9e68ad6be7c4be","6cd2dcaac46847d4a0bc53f296d90375",22850074,1,3,0,622,192,194,2
"6cd2dcaac46847d4a0bc53f296d90375","07b44a7a51e94c78b411c753fc39dab0",22850074,2,-6,0,623,194,189,-5
"07b44a7a51e94c78b411c753fc39dab0","6cd2dcaac46847d4a0bc53f296d90375",22850074,1,6,0,624,189,194,5
"6cd2dcaac46847d4a0bc53f296d90375","2d2580c9411c4972909db508d6956a58",22850074,1,2,0,625,194,196,2
"2d2580c9411c4972909db508d6956a58","2d2580c9411c4972909db508d6956a58",22850074,2,0,1,626,196,196,0
"2d2580c9411c4972909db508d6956a58","5bddb3d9ed264f3984702f048c7e5340",22850074,1,1,0,628,196,197,1
"5bddb3d9ed264f3984702f048c7e5340","5bddb3d9ed264f3984702f048c7e5340",22850074,2,0,1,629,197,197,0
"5bddb3d9ed264f3984702f048c7e5340","d5e8e2bd12a2466b9d6d90855f0eb079",22850074,1,1,0,631,197,198,1
"d5e8e2bd12a2466b9d6d90855f0eb079","d5e8e2bd12a2466b9d6d90855f0eb079",22850074,2,0,1,632,198,198,0
"d5e8e2bd12a2466b9d6d90855f0eb079","017d7ca8e0394b91aaadc9574df2202c",22850074,1,-5,0,634,198,193,-5
"017d7ca8e0394b91aaadc9574df2202c","54e8e9f0ea3e45c4bf3b8ac799ee31b1",22850074,1,8,0,635,193,200,7
"54e8e9f0ea3e45c4bf3b8ac799ee31b1","54e8e9f0ea3e45c4bf3b8ac799ee31b1",22850074,1,0,1,636,200,200,0
"54e8e9f0ea3e45c4bf3b8ac799ee31b1","c614a00911be4877a075f19315530fb0",22850074,1,1,0,637,200,201,1
"c614a00911be4877a075f19315530fb0","c614a00911be4877a075f19315530fb0",22850074,6,0,1,638,201,201,0
"c614a00911be4877a075f19315530fb0","a6c21bd8b95249c7972820a7a7d76aff",22850074,1,1,0,644,201,202,1
"a6c21bd8b95249c7972820a7a7d76aff","c8e371568a0c4391b25796ae4e91952e",22850074,1,-19,0,645,202,186,-16
"ab11d94c6c8948ea90b88f19d2cd502b","c8e371568a0c4391b25796ae4e91952e",22850074,1,-5,0,647,190,186,-4
"c8e371568a0c4391b25796ae4e91952e","6cd2dcaac46847d4a0bc53f296d90375",22850074,1,10,0,648,186,194,8
"07b44a7a51e94c78b411c753fc39dab0","017d7ca8e0394b91aaadc9574df2202c",22850074,1,5,0,650,189,193,4
"017d7ca8e0394b91aaadc9574df2202c","a6c21bd8b95249c7972820a7a7d76aff",22850074,1,10,0,651,193,202,9
"a6c21bd8b95249c7972820a7a7d76aff","a6c21bd8b95249c7972820a7a7d76aff",22850074,1,0,1,652,202,202,0
"a6c21bd8b95249c7972820a7a7d76aff","bb329d880ab54120adaf203a693bb203",22850074,1,1,0,653,202,203,1
"bb329d880ab54120adaf203a693bb203","bb329d880ab54120adaf203a693bb203",22850074,1,0,1,654,203,203,0
"bb329d880ab54120adaf203a693bb203","f9170dd6bc6442b4acd832747609b09a",22850074,1,-4,0,655,203,199,-4
"f9170dd6bc6442b4acd832747609b09a","334c2344009840079b1d0e1b7ce3d5a7",22850074,1,7,0,656,199,205,6
"334c2344009840079b1d0e1b7ce3d5a7","334c2344009840079b1d0e1b7ce3d5a7",22850074,1,0,1,657,205,205,0
"334c2344009840079b1d0e1b7ce3d5a7","d7f13c8d63ec4e2aa673fbb9cf9c6933",22850074,1,3,0,658,205,206,1
"d7f13c8d63ec4e2aa673fbb9cf9c6933","c8e371568a0c4391b25796ae4e91952e",22850074,1,-26,0,659,206,186,-20
"c8e371568a0c4391b25796ae4e91952e","b9e80f77c3a44349863b19875725c384",22850074,1,27,0,660,186,207,21
"b9e80f77c3a44349863b19875725c384","7108f0e4c2584f1f9c471689ae4c885c",22850074,2,1,0,661,207,208,1
"7108f0e4c2584f1f9c471689ae4c885c","b9e80f77c3a44349863b19875725c384",22850074,1,-1,0,662,208,207,-1
"b9e80f77c3a44349863b19875725c384","b9e80f77c3a44349863b19875725c384",22850074,19,0,1,663,207,207,0
"7108f0e4c2584f1f9c471689ae4c885c","7108f0e4c2584f1f9c471689ae4c885c",22850074,10,0,1,683,208,208,0
"7108f0e4c2584f1f9c471689ae4c885c","09400e101c5d4b439cf9a26b03aae558",22850074,1,3,0,693,208,210,2
"09400e101c5d4b439cf9a26b03aae558","d7f13c8d63ec4e2aa673fbb9cf9c6933",22850074,1,-5,0,694,210,206,-4
"d7f13c8d63ec4e2aa673fbb9cf9c6933","09400e101c5d4b439cf9a26b03aae558",22850074,1,5,0,695,206,210,4
"09400e101c5d4b439cf9a26b03aae558","a88efa7e50ce47159810ab553afa6d3a",22850074,1,2,0,696,210,212,2
"a88efa7e50ce47159810ab553afa6d3a","a88efa7e50ce47159810ab553afa6d3a",22850074,11,0,1,697,212,212,0
"a88efa7e50ce47159810ab553afa6d3a","a875096404ef4a9984b62d74cda916f9",22850074,1,-3,0,708,212,209,-3
"a875096404ef4a9984b62d74cda916f9","be502a7a43c44bf7b682698de79d9369",22850074,1,6,0,709,209,214,5
"be502a7a43c44bf7b682698de79d9369","f7fb1952f56b4189b86a9f8b7862d2b8",22850074,2,1,0,710,214,215,1
"f7fb1952f56b4189b86a9f8b7862d2b8","be502a7a43c44bf7b682698de79d9369",22850074,1,-1,0,711,215,214,-1
"f7fb1952f56b4189b86a9f8b7862d2b8","f7fb1952f56b4189b86a9f8b7862d2b8",22850074,11,0,1,713,215,215,0
"f7fb1952f56b4189b86a9f8b7862d2b8","b860ee85d8bc4a2f97958cfb71be3533",22850074,1,1,0,724,215,216,1
"b860ee85d8bc4a2f97958cfb71be3533","b860ee85d8bc4a2f97958cfb71be3533",22850074,2,0,1,725,216,216,0
"b860ee85d8bc4a2f97958cfb71be3533","ec341f459285443b8361f7f15638ff08",22850074,1,-3,0,727,216,213,-3
"ec341f459285443b8361f7f15638ff08","363837c182e04711840d896ae1e0339c",22850074,1,6,0,728,213,218,5
"363837c182e04711840d896ae1e0339c","363837c182e04711840d896ae1e0339c",22850074,13,0,1,729,218,218,0
"363837c182e04711840d896ae1e0339c","01b2051f8941460d89945e3b02d1ce78",22850074,1,-1,0,742,218,217,-1
"01b2051f8941460d89945e3b02d1ce78","363837c182e04711840d896ae1e0339c",22850074,1,1,0,743,217,218,1
"363837c182e04711840d896ae1e0339c","be95c065e45447c1bd8215ea6f130c7a",22850074,1,2,0,744,218,219,1
"be95c065e45447c1bd8215ea6f130c7a","be502a7a43c44bf7b682698de79d9369",22850074,1,-7,0,745,219,214,-5
"be502a7a43c44bf7b682698de79d9369","01b2051f8941460d89945e3b02d1ce78",22850074,1,4,0,746,214,217,3
"01b2051f8941460d89945e3b02d1ce78","f7fb1952f56b4189b86a9f8b7862d2b8",22850074,1,-3,0,747,217,215,-2
"f7fb1952f56b4189b86a9f8b7862d2b8","ec341f459285443b8361f7f15638ff08",22850074,1,-2,0,748,215,213,-2
"ec341f459285443b8361f7f15638ff08","91125ca626c5470eb145501f8c37f8db",22850074,1,9,0,749,213,220,7
"91125ca626c5470eb145501f8c37f8db","91125ca626c5470eb145501f8c37f8db",22850074,1,0,1,750,220,220,0
"91125ca626c5470eb145501f8c37f8db","d7f13c8d63ec4e2aa673fbb9cf9c6933",22850074,1,-18,0,751,220,206,-14
"d7f13c8d63ec4e2aa673fbb9cf9c6933","1c6721b1f63f4d30ba7746ea8af02a52",22850074,1,21,0,752,206,221,15
"1c6721b1f63f4d30ba7746ea8af02a52","77ecef8eff6b4a2caea7707669bf7475",22850074,2,1,0,753,221,222,1
"77ecef8eff6b4a2caea7707669bf7475","1c6721b1f63f4d30ba7746ea8af02a52",22850074,1,-1,0,754,222,221,-1
"1c6721b1f63f4d30ba7746ea8af02a52","1c6721b1f63f4d30ba7746ea8af02a52",22850074,1,0,1,755,221,221,0
"77ecef8eff6b4a2caea7707669bf7475","77ecef8eff6b4a2caea7707669bf7475",22850074,12,0,1,757,222,222,0
"77ecef8eff6b4a2caea7707669bf7475","d03cb855c70044cf8c35d9ec0de696e3",22850074,1,3,0,769,222,224,2
"d03cb855c70044cf8c35d9ec0de696e3","1c6721b1f63f4d30ba7746ea8af02a52",22850074,1,-4,0,770,224,221,-3
"1c6721b1f63f4d30ba7746ea8af02a52","8b9ae98743bd4d4a8a87dff1c1244211",22850074,1,7,0,771,221,227,6
"8b9ae98743bd4d4a8a87dff1c1244211","d03cb855c70044cf8c35d9ec0de696e3",22850074,2,-3,0,772,227,224,-3
"d03cb855c70044cf8c35d9ec0de696e3","a49a937d6896486d9a5396654abcf2e1",22850074,1,2,0,773,224,226,2
"a49a937d6896486d9a5396654abcf2e1","a49a937d6896486d9a5396654abcf2e1",22850074,1,0,1,774,226,226,0
"a49a937d6896486d9a5396654abcf2e1","8b9ae98743bd4d4a8a87dff1c1244211",22850074,1,1,0,775,226,227,1
"8b9ae98743bd4d4a8a87dff1c1244211","8b9ae98743bd4d4a8a87dff1c1244211",22850074,13,0,1,776,227,227,0
"8b9ae98743bd4d4a8a87dff1c1244211","2ab1535aac1346ba8801535bf729ef37",22850074,1,3,0,789,227,229,2
"2ab1535aac1346ba8801535bf729ef37","f7906d6f59b9489a91d2ef40db5a474d",22850074,1,-7,0,790,229,223,-6
"f7906d6f59b9489a91d2ef40db5a474d","2ab1535aac1346ba8801535bf729ef37",22850074,1,7,0,791,223,229,6
"2ab1535aac1346ba8801535bf729ef37","a4f40fb48a8542c8949bae1f002cd9bc",22850074,1,2,0,792,229,231,2
"a4f40fb48a8542c8949bae1f002cd9bc","a4f40fb48a8542c8949bae1f002cd9bc",22850074,2,0,1,793,231,231,0
"a4f40fb48a8542c8949bae1f002cd9bc","8972c23e32044edb8a78fa1eed4e5947",22850074,1,1,0,795,231,232,1
"8972c23e32044edb8a78fa1eed4e5947","8972c23e32044edb8a78fa1eed4e5947",22850074,5,0,1,796,232,232,0
"8972c23e32044edb8a78fa1eed4e5947","92feb4a40f8344d38b6f722e42a53295",22850074,1,1,0,801,232,233,1
"92feb4a40f8344d38b6f722e42a53295","92feb4a40f8344d38b6f722e42a53295",22850074,2,0,1,802,233,233,0
"92feb4a40f8344d38b6f722e42a53295","5152833676bf4c6cb317060be10f68db",22850074,1,-5,0,804,233,228,-5
"5152833676bf4c6cb317060be10f68db","ca3e28f290354c08aefe5b0f769604e6",22850074,1,8,0,805,228,235,7
"ca3e28f290354c08aefe5b0f769604e6","ca3e28f290354c08aefe5b0f769604e6",22850074,4,0,1,806,235,235,0
"ca3e28f290354c08aefe5b0f769604e6","79a35eea833e4c2c9d22fc53c3c6445c",22850074,1,1,0,810,235,236,1
"79a35eea833e4c2c9d22fc53c3c6445c","79a35eea833e4c2c9d22fc53c3c6445c",22850074,4,0,1,811,236,236,0
"79a35eea833e4c2c9d22fc53c3c6445c","8f68228b1518449e9615cdafee41a2bd",22850074,1,1,0,815,236,237,1
"8f68228b1518449e9615cdafee41a2bd","8f68228b1518449e9615cdafee41a2bd",22850074,1,0,1,816,237,237,0
"8f68228b1518449e9615cdafee41a2bd","cab89fa5c3ed45a5aa550fc0352d6a42",22850074,1,1,0,817,237,238,1
"cab89fa5c3ed45a5aa550fc0352d6a42","cab89fa5c3ed45a5aa550fc0352d6a42",22850074,6,0,1,818,238,238,0
"cab89fa5c3ed45a5aa550fc0352d6a42","0b04c8e2f86d48c7aeb7e225819cd32b",22850074,1,-4,0,824,238,234,-4
"0b04c8e2f86d48c7aeb7e225819cd32b","1c6721b1f63f4d30ba7746ea8af02a52",22850074,1,-16,0,825,234,221,-13
"1c6721b1f63f4d30ba7746ea8af02a52","0b04c8e2f86d48c7aeb7e225819cd32b",22850074,2,16,0,826,221,234,13
"0b04c8e2f86d48c7aeb7e225819cd32b","2ab1535aac1346ba8801535bf729ef37",22850074,2,-6,0,827,234,229,-5
"2ab1535aac1346ba8801535bf729ef37","5152833676bf4c6cb317060be10f68db",22850074,1,-1,0,828,229,228,-1
"5152833676bf4c6cb317060be10f68db","d03cb855c70044cf8c35d9ec0de696e3",22850074,1,-5,0,829,228,224,-4
"d03cb855c70044cf8c35d9ec0de696e3","8b9ae98743bd4d4a8a87dff1c1244211",22850074,1,3,0,830,224,227,3
"8b9ae98743bd4d4a8a87dff1c1244211","77ecef8eff6b4a2caea7707669bf7475",22850074,1,-6,0,831,227,222,-5
"77ecef8eff6b4a2caea7707669bf7475","f7906d6f59b9489a91d2ef40db5a474d",22850074,1,2,0,832,222,223,1
"f7906d6f59b9489a91d2ef40db5a474d","1c6721b1f63f4d30ba7746ea8af02a52",22850074,1,-3,0,833,223,221,-2
"2ab1535aac1346ba8801535bf729ef37","8b9ae98743bd4d4a8a87dff1c1244211",22850074,1,-3,0,836,229,227,-2
"d03cb855c70044cf8c35d9ec0de696e3","5152833676bf4c6cb317060be10f68db",22850074,1,5,0,838,224,228,4
"5152833676bf4c6cb317060be10f68db","f7906d6f59b9489a91d2ef40db5a474d",22850074,1,-6,0,839,228,223,-5
"f7906d6f59b9489a91d2ef40db5a474d","66d4fad4f1cf4b46be0750a99ad7a35a",22850074,1,18,0,840,223,239,16
"66d4fad4f1cf4b46be0750a99ad7a35a","66d4fad4f1cf4b46be0750a99ad7a35a",22850074,1,0,1,841,239,239,0
"66d4fad4f1cf4b46be0750a99ad7a35a","0b04c8e2f86d48c7aeb7e225819cd32b",22850074,1,-5,0,842,239,234,-5
"0b04c8e2f86d48c7aeb7e225819cd32b","f53da5fd9bfe412da4b80d4742563b6c",22850074,1,8,0,843,234,241,7
"f53da5fd9bfe412da4b80d4742563b6c","f53da5fd9bfe412da4b80d4742563b6c",22850074,1,0,1,844,241,241,0
"f53da5fd9bfe412da4b80d4742563b6c","2ae94c0cea4d480a9d5dca8fb1d7b542",22850074,1,3,0,845,241,242,1
"2ae94c0cea4d480a9d5dca8fb1d7b542","1c6721b1f63f4d30ba7746ea8af02a52",22850074,1,-27,0,846,242,221,-21
"1c6721b1f63f4d30ba7746ea8af02a52","1ebf23f9d994469a85206e4c7b1bf5f5",22850074,1,30,0,847,221,245,24
"1ebf23f9d994469a85206e4c7b1bf5f5","1ebf23f9d994469a85206e4c7b1bf5f5",22850074,10,0,1,848,245,245,0
"1ebf23f9d994469a85206e4c7b1bf5f5","85ae675b83e8422da842cfd25596af99",22850074,1,1,0,858,245,246,1
"85ae675b83e8422da842cfd25596af99","85ae675b83e8422da842cfd25596af99",22850074,1,0,1,859,246,246,0
"85ae675b83e8422da842cfd25596af99","2ae94c0cea4d480a9d5dca8fb1d7b542",22850074,1,-4,0,860,246,242,-4
"2ae94c0cea4d480a9d5dca8fb1d7b542","30c9ba177afc49a695625d2bdec40207",22850074,1,9,0,861,242,250,8
"30c9ba177afc49a695625d2bdec40207","30c9ba177afc49a695625d2bdec40207",22850074,2,0,1,862,250,250,0
"30c9ba177afc49a695625d2bdec40207","00f61990949545828dd12f1303d47504",22850074,1,8,0,864,250,256,6
"00f61990949545828dd12f1303d47504","6e83e23f56544a19b94067c1c558d9c0",22850074,1,-11,0,865,256,247,-9
"6e83e23f56544a19b94067c1c558d9c0","00f61990949545828dd12f1303d47504",22850074,1,11,0,866,247,256,9
"00f61990949545828dd12f1303d47504","ead7bb4b64e247d2ae632ab8a296b091",22850074,1,2,0,867,256,258,2
"ead7bb4b64e247d2ae632ab8a296b091","ead7bb4b64e247d2ae632ab8a296b091",22850074,2,0,1,868,258,258,0
"ead7bb4b64e247d2ae632ab8a296b091","41b0048dde734bb280bac6116baa8e27",22850074,1,1,0,870,258,259,1
"41b0048dde734bb280bac6116baa8e27","41b0048dde734bb280bac6116baa8e27",22850074,2,0,1,871,259,259,0
"41b0048dde734bb280bac6116baa8e27","b41c5a094a604ee0915327da5cc0beb7",22850074,1,1,0,873,259,260,1
"b41c5a094a604ee0915327da5cc0beb7","b41c5a094a604ee0915327da5cc0beb7",22850074,2,0,1,874,260,260,0
"b41c5a094a604ee0915327da5cc0beb7","d546341988904f069cfa86b21457d9d9",22850074,1,-10,0,876,260,251,-9
"d546341988904f069cfa86b21457d9d9","28c171777c52431ab6b925073bd63d46",22850074,1,15,0,877,251,264,13
"28c171777c52431ab6b925073bd63d46","28c171777c52431ab6b925073bd63d46",22850074,3,0,1,878,264,264,0
"28c171777c52431ab6b925073bd63d46","ac160db940cb49ae8579162b1d52bb5d",22850074,1,2,0,881,264,266,2
"ac160db940cb49ae8579162b1d52bb5d","ac160db940cb49ae8579162b1d52bb5d",22850074,7,0,1,882,266,266,0
"ac160db940cb49ae8579162b1d52bb5d","d989ebcfc12a4b669f0100dc1aa14f1e",22850074,1,-12,0,889,266,255,-11
"d989ebcfc12a4b669f0100dc1aa14f1e","c6fd49b485cc4874b0bbdd9c6171e09c",22850074,1,15,0,890,255,268,13
"c6fd49b485cc4874b0bbdd9c6171e09c","c6fd49b485cc4874b0bbdd9c6171e09c",22850074,3,0,1,891,268,268,0
"c6fd49b485cc4874b0bbdd9c6171e09c","44240778a97c4af0937817499b75707b",22850074,1,1,0,894,268,269,1
"44240778a97c4af0937817499b75707b","44240778a97c4af0937817499b75707b",22850074,2,0,1,895,269,269,0
"44240778a97c4af0937817499b75707b","7aa76d3e993840d8805f097cbdbcd44b",22850074,1,-9,0,897,269,261,-8
"7aa76d3e993840d8805f097cbdbcd44b","2ae94c0cea4d480a9d5dca8fb1d7b542",22850074,2,-23,0,898,261,242,-19
"2ae94c0cea4d480a9d5dca8fb1d7b542","7028800abe7d4e27b613d1d6cbe26bf7",22850074,1,30,0,899,242,267,25
"7028800abe7d4e27b613d1d6cbe26bf7","7aa76d3e993840d8805f097cbdbcd44b",22850074,1,-7,0,900,267,261,-6
"2ae94c0cea4d480a9d5dca8fb1d7b542","d989ebcfc12a4b669f0100dc1aa14f1e",22850074,1,16,0,902,242,255,13
"d989ebcfc12a4b669f0100dc1aa14f1e","7aa76d3e993840d8805f097cbdbcd44b",22850074,1,7,0,903,255,261,6
"7aa76d3e993840d8805f097cbdbcd44b","865a4d3b43374da7944dc7d397f566d9",22850074,1,12,0,904,261,271,10
"865a4d3b43374da7944dc7d397f566d9","865a4d3b43374da7944dc7d397f566d9",22850074,1,0,1,905,271,271,0
"865a4d3b43374da7944dc7d397f566d9","0d987bed3ffa4ed0b9a2e62e97b7b30f",22850074,1,3,0,906,271,272,1
"0d987bed3ffa4ed0b9a2e62e97b7b30f","2ae94c0cea4d480a9d5dca8fb1d7b542",22850074,1,-38,0,907,272,242,-30
"2ae94c0cea4d480a9d5dca8fb1d7b542","0d987bed3ffa4ed0b9a2e62e97b7b30f",22850074,1,38,0,908,242,272,30
"bb5a47f5ea01454a8b79455422d3b9da","82ae07bc0c9b4570a41799290d1ef399",22850074,1,-6,0,917,280,275,-5
"82ae07bc0c9b4570a41799290d1ef399","4a29443515bb404cb8924e1c60a63b73",22850074,1,18,0,918,275,285,10
"4a29443515bb404cb8924e1c60a63b73","4a29443515bb404cb8924e1c60a63b73",22850074,2,0,1,919,285,285,0
"4a29443515bb404cb8924e1c60a63b73","208c9b2796c944db8dacaa96082520ea",22850074,4,3,0,920,285,288,3
"208c9b2796c944db8dacaa96082520ea","208c9b2796c944db8dacaa96082520ea",22850074,1,0,1,921,288,288,0
"208c9b2796c944db8dacaa96082520ea","4a29443515bb404cb8924e1c60a63b73",22850074,2,-3,0,922,288,285,-3
"208c9b2796c944db8dacaa96082520ea","6a9a3b5bde4a48daa896fe8c06eca56f",22850074,1,2,0,924,288,289,1
"6a9a3b5bde4a48daa896fe8c06eca56f","fab84b4fab5940efb4ea868ef8d09396",22850074,1,-9,0,925,289,284,-5
"4a29443515bb404cb8924e1c60a63b73","7669a956527947d0add87455277e80b4",22850074,1,7,0,931,285,291,6
"7669a956527947d0add87455277e80b4","7669a956527947d0add87455277e80b4",22850074,1,0,1,932,291,291,0
"7669a956527947d0add87455277e80b4","6a9a3b5bde4a48daa896fe8c06eca56f",22850074,1,-2,0,933,291,289,-2
"6a9a3b5bde4a48daa896fe8c06eca56f","869e967078f04da18dd0b0b9389a7424",22850074,1,5,0,934,289,293,4
"869e967078f04da18dd0b0b9389a7424","869e967078f04da18dd0b0b9389a7424",22850074,1,0,1,935,293,293,0
"869e967078f04da18dd0b0b9389a7424","51ab6291537748fab90d519aa09889d6",22850074,1,2,0,936,293,295,2
"51ab6291537748fab90d519aa09889d6","51ab6291537748fab90d519aa09889d6",22850074,5,0,1,937,295,295,0
"51ab6291537748fab90d519aa09889d6","34a6e49023fc4465bd5ca604330bbd1c",22850074,1,-3,0,942,295,292,-3
"34a6e49023fc4465bd5ca604330bbd1c","ba0e59461bfb4a44b7b1c28a01f8d3b3",22850074,1,9,0,943,292,299,7
"ba0e59461bfb4a44b7b1c28a01f8d3b3","21592f2a9e9c4b2f8c66ec5dbcbf6a2b",22850074,1,-4,0,944,299,296,-3
"21592f2a9e9c4b2f8c66ec5dbcbf6a2b","ba0e59461bfb4a44b7b1c28a01f8d3b3",22850074,1,4,0,945,296,299,3
"ba0e59461bfb4a44b7b1c28a01f8d3b3","0e0b36e731a645e7b1b8a88f5031ca38",22850074,1,2,0,946,299,301,2
"0e0b36e731a645e7b1b8a88f5031ca38","0e0b36e731a645e7b1b8a88f5031ca38",22850074,2,0,1,947,301,301,0
"0e0b36e731a645e7b1b8a88f5031ca38","a66a144637284c21afc6de17fea4bfb8",22850074,1,1,0,949,301,302,1
"a66a144637284c21afc6de17fea4bfb8","a66a144637284c21afc6de17fea4bfb8",22850074,2,0,1,950,302,302,0
"a66a144637284c21afc6de17fea4bfb8","7646a919d7e64fa990bca9b024ff089d",22850074,1,-4,0,952,302,298,-4
"7646a919d7e64fa990bca9b024ff089d","e390b575229748ea8aac9364efe2bf00",22850074,1,7,0,953,298,304,6
"e390b575229748ea8aac9364efe2bf00","e390b575229748ea8aac9364efe2bf00",22850074,1,0,1,954,304,304,0
"e390b575229748ea8aac9364efe2bf00","3434c10e561d488a914e0f7d71907abd",22850074,1,3,0,955,304,305,1
"3434c10e561d488a914e0f7d71907abd","4a29443515bb404cb8924e1c60a63b73",22850074,2,-27,0,956,305,285,-20
"4a29443515bb404cb8924e1c60a63b73","53e7e900392747ccad52e711ab0f80d8",22850074,1,29,0,957,285,307,22
"53e7e900392747ccad52e711ab0f80d8","53e7e900392747ccad52e711ab0f80d8",22850074,1,0,1,958,307,307,0
"53e7e900392747ccad52e711ab0f80d8","130acc2aeb0448fdbb2de63bc5cebe5b",22850074,1,3,0,959,307,309,2
"130acc2aeb0448fdbb2de63bc5cebe5b","3434c10e561d488a914e0f7d71907abd",22850074,1,-5,0,960,309,305,-4
"3434c10e561d488a914e0f7d71907abd","130acc2aeb0448fdbb2de63bc5cebe5b",22850074,1,5,0,961,305,309,4
"130acc2aeb0448fdbb2de63bc5cebe5b","9c062b3251034ebe90f5054e2a3b5120",22850074,1,2,0,962,309,311,2
"9c062b3251034ebe90f5054e2a3b5120","9c062b3251034ebe90f5054e2a3b5120",22850074,2,0,1,963,311,311,0
"9c062b3251034ebe90f5054e2a3b5120","ea859f8207e44537889daeaba13ac2e8",22850074,1,1,0,965,311,312,1
"ea859f8207e44537889daeaba13ac2e8","ea859f8207e44537889daeaba13ac2e8",22850074,1,0,1,966,312,312,0
"ea859f8207e44537889daeaba13ac2e8","56d94971a7a94257aa330183a8ebd0ea",22850074,1,1,0,967,312,313,1
"56d94971a7a94257aa330183a8ebd0ea","56d94971a7a94257aa330183a8ebd0ea",22850074,1,0,1,968,313,313,0
"56d94971a7a94257aa330183a8ebd0ea","141c0df6cd1946539aadd1c9b7068cd4",22850074,1,-5,0,969,313,308,-5
"141c0df6cd1946539aadd1c9b7068cd4","3434c10e561d488a914e0f7d71907abd",22850074,2,-4,0,970,308,305,-3
"3434c10e561d488a914e0f7d71907abd","3434c10e561d488a914e0f7d71907abd",22850074,1,0,1,971,305,305,0
"3434c10e561d488a914e0f7d71907abd","53e7e900392747ccad52e711ab0f80d8",22850074,2,2,0,972,305,307,2
"53e7e900392747ccad52e711ab0f80d8","4a29443515bb404cb8924e1c60a63b73",22850074,1,-29,0,973,307,285,-22
"208c9b2796c944db8dacaa96082520ea","fab84b4fab5940efb4ea868ef8d09396",22850074,1,-7,0,975,288,284,-4
"208c9b2796c944db8dacaa96082520ea","0d987bed3ffa4ed0b9a2e62e97b7b30f",22850074,1,-25,0,978,288,272,-16
"0d987bed3ffa4ed0b9a2e62e97b7b30f","0c787d16c9504873b1a4d903cec09948",22850074,1,60,0,982,272,314,42
"0c787d16c9504873b1a4d903cec09948","3434c10e561d488a914e0f7d71907abd",22850074,1,-11,0,983,314,305,-9
"3434c10e561d488a914e0f7d71907abd","0c787d16c9504873b1a4d903cec09948",22850074,1,11,0,984,305,314,9
"0c787d16c9504873b1a4d903cec09948","130acc2aeb0448fdbb2de63bc5cebe5b",22850074,1,-6,0,985,314,309,-5
"130acc2aeb0448fdbb2de63bc5cebe5b","53e7e900392747ccad52e711ab0f80d8",22850074,1,-3,0,986,309,307,-2
"53e7e900392747ccad52e711ab0f80d8","141c0df6cd1946539aadd1c9b7068cd4",22850074,1,2,0,987,307,308,1
"4a29443515bb404cb8924e1c60a63b73","2c5bb2cbd0014420ad8c95d40e38efd1",22850074,1,23,0,990,285,303,18
"2c5bb2cbd0014420ad8c95d40e38efd1","ba0e59461bfb4a44b7b1c28a01f8d3b3",22850074,1,-5,0,991,303,299,-4
"ba0e59461bfb4a44b7b1c28a01f8d3b3","7646a919d7e64fa990bca9b024ff089d",22850074,1,-1,0,992,299,298,-1
"7646a919d7e64fa990bca9b024ff089d","4a29443515bb404cb8924e1c60a63b73",22850074,1,-17,0,993,298,285,-13
"4a29443515bb404cb8924e1c60a63b73","3434c10e561d488a914e0f7d71907abd",22850074,1,27,0,994,285,305,20
"53e7e900392747ccad52e711ab0f80d8","3434c10e561d488a914e0f7d71907abd",22850074,1,-2,0,996,307,305,-2
"3434c10e561d488a914e0f7d71907abd","13255e63e0aa4abf85e5211bf613d43e",22850074,1,14,0,997,305,317,12
"13255e63e0aa4abf85e5211bf613d43e","13255e63e0aa4abf85e5211bf613d43e",22850074,1,0,1,998,317,317,0
"13255e63e0aa4abf85e5211bf613d43e","86c27d40179e419c8e9d150fb6afa5d0",22850074,1,3,0,999,317,319,2
"86c27d40179e419c8e9d150fb6afa5d0","0c787d16c9504873b1a4d903cec09948",22850074,1,-6,0,1000,319,314,-5
"0c787d16c9504873b1a4d903cec09948","86c27d40179e419c8e9d150fb6afa5d0",22850074,1,6,0,1001,314,319,5
"86c27d40179e419c8e9d150fb6afa5d0","24f1363179ad4aaa965484a78471912b",22850074,1,5,0,1002,319,323,4
"24f1363179ad4aaa965484a78471912b","47edbb64109243e6b0f8f64cdef90c6c",22850074,2,3,0,1003,323,326,3
"47edbb64109243e6b0f8f64cdef90c6c","8d7e0b55cf9849cda222a0f2440cec55",22850074,1,-9,0,1004,326,318,-8
"8d7e0b55cf9849cda222a0f2440cec55","24f1363179ad4aaa965484a78471912b",22850074,1,6,0,1005,318,323,5
"24f1363179ad4aaa965484a78471912b","3628bdce1dd2429ba924d2d4d09448d2",22850074,1,-1,0,1006,323,322,-1
"3628bdce1dd2429ba924d2d4d09448d2","24f1363179ad4aaa965484a78471912b",22850074,1,1,0,1007,322,323,1
"47edbb64109243e6b0f8f64cdef90c6c","43ea1b823a4b4e51b7c694c10725db82",22850074,1,2,0,1009,326,327,1
"43ea1b823a4b4e51b7c694c10725db82","3628bdce1dd2429ba924d2d4d09448d2",22850074,1,-6,0,1010,327,322,-5
"3628bdce1dd2429ba924d2d4d09448d2","56b3fd1a212a4764be39d979fde3326e",22850074,1,7,0,1011,322,328,6
"56b3fd1a212a4764be39d979fde3326e","56b3fd1a212a4764be39d979fde3326e",22850074,1,0,1,1012,328,328,0
"56b3fd1a212a4764be39d979fde3326e","0c4079457ede49e3aeb5e86ed84bdf35",22850074,1,3,0,1013,328,329,1
"0c4079457ede49e3aeb5e86ed84bdf35","3434c10e561d488a914e0f7d71907abd",22850074,1,-31,0,1014,329,305,-24
"3434c10e561d488a914e0f7d71907abd","38aea304b4fa46e1b29bb72f5cea4c93",22850074,1,33,0,1015,305,331,26
"38aea304b4fa46e1b29bb72f5cea4c93","38aea304b4fa46e1b29bb72f5cea4c93",22850074,1,0,1,1016,331,331,0
"38aea304b4fa46e1b29bb72f5cea4c93","e36d261332f14e79bb4b467aceaeb9b5",22850074,1,2,0,1017,331,333,2
"e36d261332f14e79bb4b467aceaeb9b5","e36d261332f14e79bb4b467aceaeb9b5",22850074,1,0,1,1018,333,333,0
"e36d261332f14e79bb4b467aceaeb9b5","c7e89b9d04744d2eab742fc24e3ef1ae",22850074,1,1,0,1019,333,334,1
"c7e89b9d04744d2eab742fc24e3ef1ae","c7e89b9d04744d2eab742fc24e3ef1ae",22850074,5,0,1,1020,334,334,0
"c7e89b9d04744d2eab742fc24e3ef1ae","fe49f8054b374a0ea4bb266ed135ff62",22850074,1,1,0,1025,334,335,1
"fe49f8054b374a0ea4bb266ed135ff62","fe49f8054b374a0ea4bb266ed135ff62",22850074,2,0,1,1026,335,335,0
"fe49f8054b374a0ea4bb266ed135ff62","d0a8f74af98642fe8360d22c42e45117",22850074,1,1,0,1028,335,336,1
"d0a8f74af98642fe8360d22c42e45117","d0a8f74af98642fe8360d22c42e45117",22850074,5,0,1,1029,336,336,0
"d0a8f74af98642fe8360d22c42e45117","0c4079457ede49e3aeb5e86ed84bdf35",22850074,1,-7,0,1034,336,329,-7
"0c4079457ede49e3aeb5e86ed84bdf35","a7c6339ca1da4368a18d471f0519f877",22850074,1,11,0,1035,329,339,10
"a7c6339ca1da4368a18d471f0519f877","a7c6339ca1da4368a18d471f0519f877",22850074,1,0,1,1036,339,339,0
"a7c6339ca1da4368a18d471f0519f877","bbc5139ca9024389a94db3a6f47dcff6",22850074,1,3,0,1037,339,341,2
"bbc5139ca9024389a94db3a6f47dcff6","b8b9418ab322418d9db9b40d96af873a",22850074,2,-5,0,1038,341,337,-4
"b8b9418ab322418d9db9b40d96af873a","bbc5139ca9024389a94db3a6f47dcff6",22850074,1,5,0,1039,337,341,4
"bbc5139ca9024389a94db3a6f47dcff6","4ee6ca9019ab4a1ab323f98094a9bd77",22850074,1,2,0,1040,341,343,2
"4ee6ca9019ab4a1ab323f98094a9bd77","4ee6ca9019ab4a1ab323f98094a9bd77",22850074,2,0,1,1041,343,343,0
"4ee6ca9019ab4a1ab323f98094a9bd77","b37947176785476f8b29d49a851366dc",22850074,1,1,0,1043,343,344,1
"b37947176785476f8b29d49a851366dc","b37947176785476f8b29d49a851366dc",22850074,2,0,1,1044,344,344,0
"b37947176785476f8b29d49a851366dc","fcea5b10d5a14a3b9324ffece8f6e1e5",22850074,1,1,0,1046,344,345,1
"fcea5b10d5a14a3b9324ffece8f6e1e5","fcea5b10d5a14a3b9324ffece8f6e1e5",22850074,2,0,1,1047,345,345,0
"fcea5b10d5a14a3b9324ffece8f6e1e5","c2490bc612d146edbe786556fab3651b",22850074,1,-5,0,1049,345,340,-5
"c2490bc612d146edbe786556fab3651b","bbc5139ca9024389a94db3a6f47dcff6",22850074,2,1,0,1050,340,341,1
"bbc5139ca9024389a94db3a6f47dcff6","4a92daef4d504e1792575a26502bb7b7",22850074,2,6,0,1051,341,346,5
"4a92daef4d504e1792575a26502bb7b7","c2490bc612d146edbe786556fab3651b",22850074,2,-7,0,1052,346,340,-6
"c2490bc612d146edbe786556fab3651b","6ac8bb048b854999a47edb35fe627f11",22850074,1,8,0,1053,340,347,7
"6ac8bb048b854999a47edb35fe627f11","6ac8bb048b854999a47edb35fe627f11",22850074,1,0,1,1054,347,347,0
"6ac8bb048b854999a47edb35fe627f11","0c4079457ede49e3aeb5e86ed84bdf35",22850074,1,-21,0,1055,347,329,-18
"0c4079457ede49e3aeb5e86ed84bdf35","30ead9794d4847abaf222ca966cc8630",22850074,2,24,0,1056,329,348,19
"30ead9794d4847abaf222ca966cc8630","eff0de7f2dbb42dfa1a2e686efab5b6d",22850074,1,6,0,1057,348,354,6
"eff0de7f2dbb42dfa1a2e686efab5b6d","09b9678ddc3d452ea4a3d46e15826065",22850074,6,-1,0,1058,354,353,-1
"09b9678ddc3d452ea4a3d46e15826065","897b7f51242c44aab2205c72fdcbf4cd",22850074,4,-1,0,1059,353,352,-1
"897b7f51242c44aab2205c72fdcbf4cd","c20993c944444fe085345591a8bd837e",22850074,5,-1,0,1060,352,351,-1
"c20993c944444fe085345591a8bd837e","94cecc3f1e7d484b8e068e79241dfd73",22850074,1,-94,0,1061,351,281,-70
"94cecc3f1e7d484b8e068e79241dfd73","94cecc3f1e7d484b8e068e79241dfd73",22850074,1,0,1,1062,281,281,0
"94cecc3f1e7d484b8e068e79241dfd73","a37477c4e4c14169ad44b06b493007f6",22850074,1,2,0,1063,281,283,2
"a37477c4e4c14169ad44b06b493007f6","30ead9794d4847abaf222ca966cc8630",22850074,1,89,0,1064,283,348,65
"30ead9794d4847abaf222ca966cc8630","30ead9794d4847abaf222ca966cc8630",22850074,1,0,1,1065,348,348,0
"30ead9794d4847abaf222ca966cc8630","897b7f51242c44aab2205c72fdcbf4cd",22850074,1,4,0,1066,348,352,4
"897b7f51242c44aab2205c72fdcbf4cd","eff0de7f2dbb42dfa1a2e686efab5b6d",22850074,2,2,0,1067,352,354,2
"09b9678ddc3d452ea4a3d46e15826065","c20993c944444fe085345591a8bd837e",22850074,3,-2,0,1069,353,351,-2
"c20993c944444fe085345591a8bd837e","c20993c944444fe085345591a8bd837e",22850074,4,0,1,1070,351,351,0
"c20993c944444fe085345591a8bd837e","897b7f51242c44aab2205c72fdcbf4cd",22850074,2,1,0,1074,351,352,1
"897b7f51242c44aab2205c72fdcbf4cd","897b7f51242c44aab2205c72fdcbf4cd",22850074,4,0,1,1075,352,352,0
"897b7f51242c44aab2205c72fdcbf4cd","09b9678ddc3d452ea4a3d46e15826065",22850074,1,1,0,1078,352,353,1
"09b9678ddc3d452ea4a3d46e15826065","09b9678ddc3d452ea4a3d46e15826065",22850074,3,0,1,1079,353,353,0
"09b9678ddc3d452ea4a3d46e15826065","eff0de7f2dbb42dfa1a2e686efab5b6d",22850074,2,1,0,1082,353,354,1
"eff0de7f2dbb42dfa1a2e686efab5b6d","eff0de7f2dbb42dfa1a2e686efab5b6d",22850074,4,0,1,1083,354,354,0
"eff0de7f2dbb42dfa1a2e686efab5b6d","30ead9794d4847abaf222ca966cc8630",22850074,1,-6,0,1086,354,348,-6
"30ead9794d4847abaf222ca966cc8630","2fe14166dc9642c3bc666b86a57f943d",22850074,2,10,0,1087,348,357,9
"2fe14166dc9642c3bc666b86a57f943d","2fe14166dc9642c3bc666b86a57f943d",22850074,3,0,1,1088,357,357,0
"2fe14166dc9642c3bc666b86a57f943d","44421dd1e13a47a388c4a19834b744c7",22850074,1,2,0,1091,357,359,2
"44421dd1e13a47a388c4a19834b744c7","44421dd1e13a47a388c4a19834b744c7",22850074,2,0,1,1092,359,359,0
"44421dd1e13a47a388c4a19834b744c7","cb5fc7ef85d547c4be1a7439d0bf6052",22850074,1,1,0,1094,359,360,1
"cb5fc7ef85d547c4be1a7439d0bf6052","cb5fc7ef85d547c4be1a7439d0bf6052",22850074,5,0,1,1095,360,360,0
"cb5fc7ef85d547c4be1a7439d0bf6052","0a8f150a4cf747acbde62f4721823da3",22850074,1,1,0,1100,360,361,1
"0a8f150a4cf747acbde62f4721823da3","0a8f150a4cf747acbde62f4721823da3",22850074,2,0,1,1101,361,361,0
"0a8f150a4cf747acbde62f4721823da3","ab8fdad974ae471f9f24c3f9dd04462e",22850074,1,1,0,1103,361,362,1
"ab8fdad974ae471f9f24c3f9dd04462e","ab8fdad974ae471f9f24c3f9dd04462e",22850074,2,0,1,1104,362,362,0
"ab8fdad974ae471f9f24c3f9dd04462e","1ba8fef685d74a8194b9db252eb704fb",22850074,1,-7,0,1106,362,355,-7
"1ba8fef685d74a8194b9db252eb704fb","52580888dadb4fe3baa795683ea227bd",22850074,1,10,0,1107,355,364,9
"52580888dadb4fe3baa795683ea227bd","52580888dadb4fe3baa795683ea227bd",22850074,1,0,1,1108,364,364,0
"52580888dadb4fe3baa795683ea227bd","f00179e251a045b39c3f7a54f9aa4acc",22850074,1,-1,0,1109,364,363,-1
"f00179e251a045b39c3f7a54f9aa4acc","492a3bc6a1254f23a7998587961b22a4",22850074,1,4,0,1110,363,366,3
"492a3bc6a1254f23a7998587961b22a4","492a3bc6a1254f23a7998587961b22a4",22850074,1,0,1,1111,366,366,0
"492a3bc6a1254f23a7998587961b22a4","072a190fd302456290895f9f04d6940a",22850074,1,-1,0,1112,366,365,-1
"072a190fd302456290895f9f04d6940a","cfa457d1743848e4bb5e4beced6448ed",22850074,1,5,0,1113,365,369,4
"cfa457d1743848e4bb5e4beced6448ed","cfa457d1743848e4bb5e4beced6448ed",22850074,1,0,1,1114,369,369,0
"cfa457d1743848e4bb5e4beced6448ed","b71bac264efb4abd97015447bd490db6",22850074,1,3,0,1115,369,370,1
"b71bac264efb4abd97015447bd490db6","30ead9794d4847abaf222ca966cc8630",22850074,2,-28,0,1116,370,348,-22
"30ead9794d4847abaf222ca966cc8630","b71bac264efb4abd97015447bd490db6",22850074,3,28,0,1117,348,370,22
"b71bac264efb4abd97015447bd490db6","8d448d625b024c82a5eb240bbd7431d6",22850074,4,5,0,1118,370,374,4
"8d448d625b024c82a5eb240bbd7431d6","8d448d625b024c82a5eb240bbd7431d6",22850074,84,0,1,1119,374,374,0
"8d448d625b024c82a5eb240bbd7431d6","d6d02b6ef04e4f17805504500b8ce441",22850074,1,3,0,1126,374,375,1
"d6d02b6ef04e4f17805504500b8ce441","b71bac264efb4abd97015447bd490db6",22850074,3,-8,0,1127,375,370,-5
"b71bac264efb4abd97015447bd490db6","d6d02b6ef04e4f17805504500b8ce441",22850074,5,8,0,1128,370,375,5
"d6d02b6ef04e4f17805504500b8ce441","d6d02b6ef04e4f17805504500b8ce441",22850074,6,0,1,1129,375,375,0
"d6d02b6ef04e4f17805504500b8ce441","66baf19b6b904b70922329068c63746d",22850074,2,4,0,1132,375,376,1
"66baf19b6b904b70922329068c63746d","7f544639412e40a9ba27f43b415362ab",22850074,3,2,0,1133,376,378,2
"7f544639412e40a9ba27f43b415362ab","2ae94c0cea4d480a9d5dca8fb1d7b542",22850074,1,-184,0,1134,378,242,-136
"2ae94c0cea4d480a9d5dca8fb1d7b542","66baf19b6b904b70922329068c63746d",22850074,1,182,0,1135,242,376,134
"66baf19b6b904b70922329068c63746d","66baf19b6b904b70922329068c63746d",22850074,1,0,1,1136,376,376,0
"7f544639412e40a9ba27f43b415362ab","7f544639412e40a9ba27f43b415362ab",22850074,1,0,1,1138,378,378,0
"7f544639412e40a9ba27f43b415362ab","d5ae8642e15b46b8bd298b02274d4e9c",22850074,1,2,0,1139,378,380,2
"d5ae8642e15b46b8bd298b02274d4e9c","d5ae8642e15b46b8bd298b02274d4e9c",22850074,1,0,1,1140,380,380,0
"d5ae8642e15b46b8bd298b02274d4e9c","a0d10309a2dd456289147f84be9d37f9",22850074,1,1,0,1141,380,381,1
"a0d10309a2dd456289147f84be9d37f9","a0d10309a2dd456289147f84be9d37f9",22850074,2,0,1,1142,381,381,0
"a0d10309a2dd456289147f84be9d37f9","0fcbc3ca07b144138b8d85da581f09a8",22850074,1,1,0,1144,381,382,1
"0fcbc3ca07b144138b8d85da581f09a8","0fcbc3ca07b144138b8d85da581f09a8",22850074,2,0,1,1145,382,382,0
"0fcbc3ca07b144138b8d85da581f09a8","66baf19b6b904b70922329068c63746d",22850074,1,-6,0,1147,382,376,-6
"66baf19b6b904b70922329068c63746d","4890121ce5d74576b4632b77cfc23398",22850074,2,14,0,1148,376,388,12
"4890121ce5d74576b4632b77cfc23398","c2fca3669923477ab966ded303dea31c",22850074,2,-6,0,1149,388,383,-5
"c2fca3669923477ab966ded303dea31c","4890121ce5d74576b4632b77cfc23398",22850074,1,6,0,1150,383,388,5
"4890121ce5d74576b4632b77cfc23398","96bb2b3e85a34d8b9544514e89f6fe97",22850074,2,3,0,1151,388,390,2
"96bb2b3e85a34d8b9544514e89f6fe97","18d3b836dd804224883cc9180b60a8e1",22850074,3,-4,0,1152,390,387,-3
"18d3b836dd804224883cc9180b60a8e1","96bb2b3e85a34d8b9544514e89f6fe97",22850074,2,4,0,1153,387,390,3
"96bb2b3e85a34d8b9544514e89f6fe97","66baf19b6b904b70922329068c63746d",22850074,1,-17,0,1154,390,376,-14
"96bb2b3e85a34d8b9544514e89f6fe97","1ba8fef685d74a8194b9db252eb704fb",22850074,1,-49,0,1159,390,355,-35
"1ba8fef685d74a8194b9db252eb704fb","30ead9794d4847abaf222ca966cc8630",22850074,1,-8,0,1160,355,348,-7
"2fe14166dc9642c3bc666b86a57f943d","ac4e9b54acfe4670b4634859c7263cb5",22850074,1,49,0,1162,357,392,35
"ac4e9b54acfe4670b4634859c7263cb5","ac4e9b54acfe4670b4634859c7263cb5",22850074,1,0,1,1163,392,392,0
"ac4e9b54acfe4670b4634859c7263cb5","6f8881a745ac4c358a68b92c3b4abe81",22850074,1,3,0,1164,392,394,2
"6f8881a745ac4c358a68b92c3b4abe81","17f95d18bab743888e1736033dc3384d",22850074,2,-6,0,1165,394,389,-5
"17f95d18bab743888e1736033dc3384d","6f8881a745ac4c358a68b92c3b4abe81",22850074,1,6,0,1166,389,394,5
"6f8881a745ac4c358a68b92c3b4abe81","6f8881a745ac4c358a68b92c3b4abe81",22850074,3,0,1,1167,394,394,0
"6f8881a745ac4c358a68b92c3b4abe81","f7002c8484354eceac57bc7bd62c76c1",22850074,1,-1,0,1170,394,393,-1
"f7002c8484354eceac57bc7bd62c76c1","44a277ea44dc4ae689fab4b82f0b4098",22850074,1,5,0,1171,393,397,4
"44a277ea44dc4ae689fab4b82f0b4098","44a277ea44dc4ae689fab4b82f0b4098",22850074,1,0,1,1172,397,397,0
"44a277ea44dc4ae689fab4b82f0b4098","0c12af0a4e7f4002852cf84b2537c161",22850074,1,-2,0,1173,397,395,-2
"0c12af0a4e7f4002852cf84b2537c161","859e0b8d71694b12befb69ee698138f9",22850074,1,5,0,1174,395,399,4
"859e0b8d71694b12befb69ee698138f9","859e0b8d71694b12befb69ee698138f9",22850074,1,0,1,1175,399,399,0
"859e0b8d71694b12befb69ee698138f9","66baf19b6b904b70922329068c63746d",22850074,1,-29,0,1176,399,376,-23
"66baf19b6b904b70922329068c63746d","2b09a08242b54983aec7063990fb3f66",22850074,2,32,0,1177,376,400,24
"2b09a08242b54983aec7063990fb3f66","2b09a08242b54983aec7063990fb3f66",22850074,7,0,1,1178,400,400,0
"2b09a08242b54983aec7063990fb3f66","1f471b7a883a4df48211e8c6a81b59a7",22850074,1,1,0,1185,400,401,1
"1f471b7a883a4df48211e8c6a81b59a7","1f471b7a883a4df48211e8c6a81b59a7",22850074,1,0,1,1186,401,401,0
"1f471b7a883a4df48211e8c6a81b59a7","2b09a08242b54983aec7063990fb3f66",22850074,1,-1,0,1187,401,400,-1
"2b09a08242b54983aec7063990fb3f66","1157bd665ec4472fb58b751dc5099355",22850074,3,4,0,1188,400,403,3
"1157bd665ec4472fb58b751dc5099355","3c8a22d2f9c146ea956609e3ed4f2559",22850074,2,3,0,1189,403,405,2
"3c8a22d2f9c146ea956609e3ed4f2559","1157bd665ec4472fb58b751dc5099355",22850074,1,-3,0,1190,405,403,-2
"1157bd665ec4472fb58b751dc5099355","2b09a08242b54983aec7063990fb3f66",22850074,3,-4,0,1191,403,400,-3
"2b09a08242b54983aec7063990fb3f66","66baf19b6b904b70922329068c63746d",22850074,2,-32,0,1192,400,376,-24
"2b09a08242b54983aec7063990fb3f66","df8191ec5e584c838a899c378941a566",22850074,1,-4,0,1194,400,398,-2
"df8191ec5e584c838a899c378941a566","6f8881a745ac4c358a68b92c3b4abe81",22850074,1,-6,0,1195,398,394,-4
"6f8881a745ac4c358a68b92c3b4abe81","0c12af0a4e7f4002852cf84b2537c161",22850074,1,2,0,1196,394,395,1
"0c12af0a4e7f4002852cf84b2537c161","4890121ce5d74576b4632b77cfc23398",22850074,1,-10,0,1197,395,388,-7
"4890121ce5d74576b4632b77cfc23398","17f95d18bab743888e1736033dc3384d",22850074,1,2,0,1198,388,389,1
"17f95d18bab743888e1736033dc3384d","96bb2b3e85a34d8b9544514e89f6fe97",22850074,2,1,0,1199,389,390,1
"96bb2b3e85a34d8b9544514e89f6fe97","f7002c8484354eceac57bc7bd62c76c1",22850074,1,4,0,1200,390,393,3
"f7002c8484354eceac57bc7bd62c76c1","7f544639412e40a9ba27f43b415362ab",22850074,1,-19,0,1201,393,378,-15
"7f544639412e40a9ba27f43b415362ab","c2fca3669923477ab966ded303dea31c",22850074,1,6,0,1202,378,383,5
"c2fca3669923477ab966ded303dea31c","18d3b836dd804224883cc9180b60a8e1",22850074,1,5,0,1203,383,387,4
"18d3b836dd804224883cc9180b60a8e1","66baf19b6b904b70922329068c63746d",22850074,1,-13,0,1204,387,376,-11
"66baf19b6b904b70922329068c63746d","d6d02b6ef04e4f17805504500b8ce441",22850074,1,-4,0,1205,376,375,-1
"d6d02b6ef04e4f17805504500b8ce441","8d448d625b024c82a5eb240bbd7431d6",22850074,1,-3,0,1209,375,374,-1
"8d448d625b024c82a5eb240bbd7431d6","1b4550d0dab04078b3bf08a655345bdc",22850074,1,-1,0,1217,374,373,-1
"1b4550d0dab04078b3bf08a655345bdc","30ead9794d4847abaf222ca966cc8630",22850074,1,-32,0,1218,373,348,-25
"b71bac264efb4abd97015447bd490db6","c76574d21bc14aeea7ecd0b027f39858",22850074,1,-5,0,1220,370,367,-3
"c76574d21bc14aeea7ecd0b027f39858","492a3bc6a1254f23a7998587961b22a4",22850074,1,-2,0,1221,367,366,-1
"492a3bc6a1254f23a7998587961b22a4","52580888dadb4fe3baa795683ea227bd",22850074,1,-3,0,1222,366,364,-2
"52580888dadb4fe3baa795683ea227bd","072a190fd302456290895f9f04d6940a",22850074,1,2,0,1223,364,365,1
"072a190fd302456290895f9f04d6940a","2fe14166dc9642c3bc666b86a57f943d",22850074,1,-10,0,1224,365,357,-8
"2fe14166dc9642c3bc666b86a57f943d","f00179e251a045b39c3f7a54f9aa4acc",22850074,1,7,0,1225,357,363,6
"f00179e251a045b39c3f7a54f9aa4acc","eff0de7f2dbb42dfa1a2e686efab5b6d",22850074,1,-11,0,1226,363,354,-9
"c20993c944444fe085345591a8bd837e","eff0de7f2dbb42dfa1a2e686efab5b6d",22850074,2,3,0,1234,351,354,3
"c20993c944444fe085345591a8bd837e","1ba8fef685d74a8194b9db252eb704fb",22850074,1,5,0,1238,351,355,4
"1ba8fef685d74a8194b9db252eb704fb","0c4079457ede49e3aeb5e86ed84bdf35",22850074,1,-32,0,1239,355,329,-26
"30ead9794d4847abaf222ca966cc8630","bbc5139ca9024389a94db3a6f47dcff6",22850074,1,-10,0,1241,348,341,-7
"b8b9418ab322418d9db9b40d96af873a","30ead9794d4847abaf222ca966cc8630",22850074,1,15,0,1246,337,348,11
"30ead9794d4847abaf222ca966cc8630","0c4079457ede49e3aeb5e86ed84bdf35",22850074,1,-24,0,1247,348,329,-19
"0c4079457ede49e3aeb5e86ed84bdf35","c2490bc612d146edbe786556fab3651b",22850074,1,13,0,1248,329,340,11
"c2490bc612d146edbe786556fab3651b","897b7f51242c44aab2205c72fdcbf4cd",22850074,1,15,0,1249,340,352,12
"eff0de7f2dbb42dfa1a2e686efab5b6d","52580888dadb4fe3baa795683ea227bd",22850074,1,12,0,1257,354,364,10
"52580888dadb4fe3baa795683ea227bd","1ba8fef685d74a8194b9db252eb704fb",22850074,1,-10,0,1258,364,355,-9
"1ba8fef685d74a8194b9db252eb704fb","09b9678ddc3d452ea4a3d46e15826065",22850074,1,-3,0,1259,355,353,-2
"c20993c944444fe085345591a8bd837e","09b9678ddc3d452ea4a3d46e15826065",22850074,1,2,0,1261,351,353,2
"c20993c944444fe085345591a8bd837e","2fe14166dc9642c3bc666b86a57f943d",22850074,1,7,0,1263,351,357,6
"2fe14166dc9642c3bc666b86a57f943d","30ead9794d4847abaf222ca966cc8630",22850074,1,-10,0,1264,357,348,-9
"30ead9794d4847abaf222ca966cc8630","072a190fd302456290895f9f04d6940a",22850074,1,20,0,1267,348,365,17
"072a190fd302456290895f9f04d6940a","492a3bc6a1254f23a7998587961b22a4",22850074,1,1,0,1268,365,366,1
"492a3bc6a1254f23a7998587961b22a4","f00179e251a045b39c3f7a54f9aa4acc",22850074,1,-4,0,1269,366,363,-3
"f00179e251a045b39c3f7a54f9aa4acc","8d448d625b024c82a5eb240bbd7431d6",22850074,1,16,0,1270,363,374,11
"8d448d625b024c82a5eb240bbd7431d6","b71bac264efb4abd97015447bd490db6",22850074,4,-5,0,1278,374,370,-4
"7f544639412e40a9ba27f43b415362ab","4890121ce5d74576b4632b77cfc23398",22850074,1,12,0,1285,378,388,10
"c2fca3669923477ab966ded303dea31c","66baf19b6b904b70922329068c63746d",22850074,1,-8,0,1287,383,376,-7
"66baf19b6b904b70922329068c63746d","f7002c8484354eceac57bc7bd62c76c1",22850074,1,21,0,1288,376,393,17
"f7002c8484354eceac57bc7bd62c76c1","6f8881a745ac4c358a68b92c3b4abe81",22850074,1,1,0,1289,393,394,1
"18d3b836dd804224883cc9180b60a8e1","2b09a08242b54983aec7063990fb3f66",22850074,1,19,0,1293,387,400,13
"66baf19b6b904b70922329068c63746d","0c12af0a4e7f4002852cf84b2537c161",22850074,1,24,0,1295,376,395,19
"0c12af0a4e7f4002852cf84b2537c161","2b09a08242b54983aec7063990fb3f66",22850074,1,8,0,1296,395,400,5
"2b09a08242b54983aec7063990fb3f66","58fc9094275e4c49be3f4ba6d4acc0a4",22850074,1,9,0,1299,400,406,6
"58fc9094275e4c49be3f4ba6d4acc0a4","3c8a22d2f9c146ea956609e3ed4f2559",22850074,2,-2,0,1300,406,405,-1
"3c8a22d2f9c146ea956609e3ed4f2559","58fc9094275e4c49be3f4ba6d4acc0a4",22850074,2,2,0,1301,405,406,1
"3c8a22d2f9c146ea956609e3ed4f2559","2b09a08242b54983aec7063990fb3f66",22850074,1,-7,0,1303,405,400,-5
"2b09a08242b54983aec7063990fb3f66","9de0d567bfa84fe5b77cb76f4a76a5d1",22850074,1,5,0,1306,400,404,4
"9de0d567bfa84fe5b77cb76f4a76a5d1","9de0d567bfa84fe5b77cb76f4a76a5d1",22850074,1,0,1,1307,404,404,0
"9de0d567bfa84fe5b77cb76f4a76a5d1","1157bd665ec4472fb58b751dc5099355",22850074,1,-1,0,1308,404,403,-1
"58fc9094275e4c49be3f4ba6d4acc0a4","58fc9094275e4c49be3f4ba6d4acc0a4",22850074,1,0,1,1311,406,406,0
"58fc9094275e4c49be3f4ba6d4acc0a4","c1c1be90b2b14c1ab4a5e1ee3c241902",22850074,1,1,0,1312,406,407,1
"c1c1be90b2b14c1ab4a5e1ee3c241902","c1c1be90b2b14c1ab4a5e1ee3c241902",22850074,5,0,1,1313,407,407,0
"c1c1be90b2b14c1ab4a5e1ee3c241902","02b3a1bead9244c1ba2f857c7da8f82a",22850074,1,2,0,1318,407,408,1
"02b3a1bead9244c1ba2f857c7da8f82a","58fc9094275e4c49be3f4ba6d4acc0a4",22850074,1,-3,0,1319,408,406,-2
"58fc9094275e4c49be3f4ba6d4acc0a4","02b3a1bead9244c1ba2f857c7da8f82a",22850074,1,3,0,1320,406,408,2
"02b3a1bead9244c1ba2f857c7da8f82a","6206fc6479014bb193084c32409dc1b9",22850074,1,1,0,1321,408,409,1
"6206fc6479014bb193084c32409dc1b9","6206fc6479014bb193084c32409dc1b9",22850074,1,0,1,1322,409,409,0
"6206fc6479014bb193084c32409dc1b9","6a5f020451db426dacba9e2ea3fcc62a",22850074,1,2,0,1323,409,410,1
"6a5f020451db426dacba9e2ea3fcc62a","02b3a1bead9244c1ba2f857c7da8f82a",22850074,1,-3,0,1324,410,408,-2
"02b3a1bead9244c1ba2f857c7da8f82a","6a5f020451db426dacba9e2ea3fcc62a",22850074,1,3,0,1325,408,410,2
"6a5f020451db426dacba9e2ea3fcc62a","33a9d248b2e44588a5b07fc1342b9bc2",22850074,2,2,0,1326,410,411,1
"33a9d248b2e44588a5b07fc1342b9bc2","6a5f020451db426dacba9e2ea3fcc62a",22850074,1,-2,0,1327,411,410,-1
"33a9d248b2e44588a5b07fc1342b9bc2","c6f26bd420634f1cb7989e76fe6b16c0",22850074,1,1,0,1329,411,412,1
"c6f26bd420634f1cb7989e76fe6b16c0","c6f26bd420634f1cb7989e76fe6b16c0",22850074,5,0,1,1330,412,412,0
"c6f26bd420634f1cb7989e76fe6b16c0","2a65ee6e2ac64f6a8a55fbe5373ec763",22850074,1,1,0,1335,412,413,1
"2a65ee6e2ac64f6a8a55fbe5373ec763","2a65ee6e2ac64f6a8a55fbe5373ec763",22850074,2,0,1,1336,413,413,0
"2a65ee6e2ac64f6a8a55fbe5373ec763","33a9d248b2e44588a5b07fc1342b9bc2",22850074,1,-2,0,1338,413,411,-2
"33a9d248b2e44588a5b07fc1342b9bc2","1fd0f6dadbc14ebc965faf6122190b96",22850074,1,5,0,1339,411,415,4
"1fd0f6dadbc14ebc965faf6122190b96","1fd0f6dadbc14ebc965faf6122190b96",22850074,1,0,1,1340,415,415,0
"1fd0f6dadbc14ebc965faf6122190b96","687055dad9fc40c3982478fe33ec01bf",22850074,1,-1,0,1341,415,414,-1
"687055dad9fc40c3982478fe33ec01bf","2add1669f08d4101913db15f8c23b3b7",22850074,1,3,0,1342,414,416,2
"2add1669f08d4101913db15f8c23b3b7","2add1669f08d4101913db15f8c23b3b7",22850074,1,0,1,1343,416,416,0
"2add1669f08d4101913db15f8c23b3b7","a2b4bd40cee2481ebd3fc179d6a5cd62",22850074,1,3,0,1344,416,417,1
"a2b4bd40cee2481ebd3fc179d6a5cd62","2b09a08242b54983aec7063990fb3f66",22850074,1,-27,0,1345,417,400,-17
"2b09a08242b54983aec7063990fb3f66","e34e59dce2204f228f3a84b6725df60f",22850074,1,29,0,1346,400,419,19
"e34e59dce2204f228f3a84b6725df60f","e34e59dce2204f228f3a84b6725df60f",22850074,1,0,1,1347,419,419,0
"e34e59dce2204f228f3a84b6725df60f","bec48fc2e1294c7eb3d0aca780d731b8",22850074,1,2,0,1348,419,420,1
"bec48fc2e1294c7eb3d0aca780d731b8","a2b4bd40cee2481ebd3fc179d6a5cd62",22850074,1,-4,0,1349,420,417,-3
"a2b4bd40cee2481ebd3fc179d6a5cd62","bec48fc2e1294c7eb3d0aca780d731b8",22850074,1,4,0,1350,417,420,3
"bec48fc2e1294c7eb3d0aca780d731b8","bec48fc2e1294c7eb3d0aca780d731b8",22850074,1,0,1,1351,420,420,0
"bec48fc2e1294c7eb3d0aca780d731b8","a24600b0e49245f6bdba8c893cfeddb0",22850074,1,7,0,1352,420,425,5
"a24600b0e49245f6bdba8c893cfeddb0","dbde19fcce2a4c1abdc7f685c293a23f",22850074,1,-4,0,1353,425,422,-3
"dbde19fcce2a4c1abdc7f685c293a23f","a24600b0e49245f6bdba8c893cfeddb0",22850074,1,4,0,1354,422,425,3
"a24600b0e49245f6bdba8c893cfeddb0","a24600b0e49245f6bdba8c893cfeddb0",22850074,1,0,1,1355,425,425,0
"a24600b0e49245f6bdba8c893cfeddb0","a2b4bd40cee2481ebd3fc179d6a5cd62",22850074,1,-11,0,1356,425,417,-8
"a2b4bd40cee2481ebd3fc179d6a5cd62","24cf8786024543f19b89bc20034e60d7",22850074,1,18,0,1357,417,428,11
"24cf8786024543f19b89bc20034e60d7","f2a73be2f46840b182d7bd095378004e",22850074,1,1,0,1358,428,429,1
"f2a73be2f46840b182d7bd095378004e","f2a73be2f46840b182d7bd095378004e",22850074,1,0,1,1359,429,429,0
"f2a73be2f46840b182d7bd095378004e","604551fd4266430cb860fef58fa7dd61",22850074,1,1,0,1360,429,430,1
"604551fd4266430cb860fef58fa7dd61","604551fd4266430cb860fef58fa7dd61",22850074,4,0,1,1361,430,430,0
"604551fd4266430cb860fef58fa7dd61","24cf8786024543f19b89bc20034e60d7",22850074,1,-2,0,1365,430,428,-2
"24cf8786024543f19b89bc20034e60d7","dce46f8904594a62a6377a3587aaa663",22850074,1,4,0,1366,428,431,3
"dce46f8904594a62a6377a3587aaa663","dce46f8904594a62a6377a3587aaa663",22850074,3,0,1,1367,431,431,0
"dce46f8904594a62a6377a3587aaa663","9b9d0a249052413c869753b99682b0ac",22850074,1,1,0,1369,431,432,1
"9b9d0a249052413c869753b99682b0ac","9b9d0a249052413c869753b99682b0ac",22850074,1,0,1,1370,432,432,0
"9b9d0a249052413c869753b99682b0ac","061c175cc90f45fbad883025394e78dd",22850074,1,1,0,1371,432,433,1
"061c175cc90f45fbad883025394e78dd","061c175cc90f45fbad883025394e78dd",22850074,6,0,1,1372,433,433,0
"061c175cc90f45fbad883025394e78dd","dce46f8904594a62a6377a3587aaa663",22850074,1,-2,0,1378,433,431,-2
"dce46f8904594a62a6377a3587aaa663","66ada10dde9f43018588f1ced9d477fc",22850074,1,4,0,1380,431,434,3
"66ada10dde9f43018588f1ced9d477fc","dce46f8904594a62a6377a3587aaa663",22850074,1,-4,0,1381,434,431,-3
"dce46f8904594a62a6377a3587aaa663","66baf19b6b904b70922329068c63746d",22850074,1,-81,0,1382,431,376,-55
"66baf19b6b904b70922329068c63746d","6f8881a745ac4c358a68b92c3b4abe81",22850074,1,22,0,1383,376,394,18
"6f8881a745ac4c358a68b92c3b4abe81","74a7f8712e5449c2bc0b43c6f90dafed",22850074,1,64,0,1384,394,435,41
"74a7f8712e5449c2bc0b43c6f90dafed","74a7f8712e5449c2bc0b43c6f90dafed",22850074,1,0,1,1385,435,435,0
"74a7f8712e5449c2bc0b43c6f90dafed","66ada10dde9f43018588f1ced9d477fc",22850074,1,-1,0,1386,435,434,-1
"66ada10dde9f43018588f1ced9d477fc","bf12c96466d840a69bed7020b3f18bb8",22850074,1,3,0,1387,434,436,2
"bf12c96466d840a69bed7020b3f18bb8","bf12c96466d840a69bed7020b3f18bb8",22850074,1,0,1,1388,436,436,0
"bf12c96466d840a69bed7020b3f18bb8","24cf8786024543f19b89bc20034e60d7",22850074,1,-11,0,1389,436,428,-8
"24cf8786024543f19b89bc20034e60d7","070600601c4c439288445d2f0724807d",22850074,1,14,0,1390,428,437,9
"070600601c4c439288445d2f0724807d","1823b6de7d334a7aaabc4570719af4d9",22850074,1,2,0,1391,437,439,2
"1823b6de7d334a7aaabc4570719af4d9","1823b6de7d334a7aaabc4570719af4d9",22850074,12,0,1,1392,439,439,0
"1823b6de7d334a7aaabc4570719af4d9","070600601c4c439288445d2f0724807d",22850074,1,-2,0,1404,439,437,-2
"070600601c4c439288445d2f0724807d","0380cd76a7d44bc3a4da1f15e4d68f89",22850074,1,4,0,1405,437,440,3
"0380cd76a7d44bc3a4da1f15e4d68f89","0380cd76a7d44bc3a4da1f15e4d68f89",22850074,2,0,1,1406,440,440,0
"0380cd76a7d44bc3a4da1f15e4d68f89","23b7673c8b5443108c2ef09382834a86",22850074,1,2,0,1408,440,441,1
"23b7673c8b5443108c2ef09382834a86","23b7673c8b5443108c2ef09382834a86",22850074,2,0,1,1409,441,441,0
"23b7673c8b5443108c2ef09382834a86","901e92500aea43c79f19f1b279050668",22850074,1,2,0,1411,441,442,1
"901e92500aea43c79f19f1b279050668","901e92500aea43c79f19f1b279050668",22850074,1,0,1,1412,442,442,0
"901e92500aea43c79f19f1b279050668","001339db8ced4cf78829ebe8b145449d",22850074,1,1,0,1413,442,443,1
"001339db8ced4cf78829ebe8b145449d","001339db8ced4cf78829ebe8b145449d",22850074,2,0,1,1414,443,443,0
"001339db8ced4cf78829ebe8b145449d","452745e0366e42ae81561bfddebcc6c3",22850074,1,1,0,1416,443,444,1
"452745e0366e42ae81561bfddebcc6c3","452745e0366e42ae81561bfddebcc6c3",22850074,2,0,1,1417,444,444,0
"452745e0366e42ae81561bfddebcc6c3","901e92500aea43c79f19f1b279050668",22850074,1,-2,0,1419,444,442,-2
"901e92500aea43c79f19f1b279050668","4660ff2089114e8db82ceb26a4f329e3",22850074,1,4,0,1420,442,445,3
"4660ff2089114e8db82ceb26a4f329e3","4660ff2089114e8db82ceb26a4f329e3",22850074,1,0,1,1421,445,445,0
"4660ff2089114e8db82ceb26a4f329e3","7bd5586eb9d8484eb74a433ee7bfe499",22850074,2,2,0,1422,445,446,1
"7bd5586eb9d8484eb74a433ee7bfe499","4660ff2089114e8db82ceb26a4f329e3",22850074,1,-2,0,1423,446,445,-1
"7bd5586eb9d8484eb74a433ee7bfe499","7bd5586eb9d8484eb74a433ee7bfe499",22850074,8,0,1,1425,446,446,0
"7bd5586eb9d8484eb74a433ee7bfe499","8a7f26e690f34dda97be16904518ca99",22850074,1,2,0,1433,446,447,1
"8a7f26e690f34dda97be16904518ca99","8a7f26e690f34dda97be16904518ca99",22850074,1,0,1,1434,447,447,0
"8a7f26e690f34dda97be16904518ca99","b2f0d654738f48158edff28e8d3a546e",22850074,1,5,0,1435,447,449,2
"b2f0d654738f48158edff28e8d3a546e","070600601c4c439288445d2f0724807d",22850074,1,-21,0,1436,449,437,-12
"070600601c4c439288445d2f0724807d","f60ee41ec635499abd48168342d32c2f",22850074,1,26,0,1437,437,453,16
"f60ee41ec635499abd48168342d32c2f","f60ee41ec635499abd48168342d32c2f",22850074,63,0,1,1438,453,453,0
"f60ee41ec635499abd48168342d32c2f","b2f0d654738f48158edff28e8d3a546e",22850074,2,-5,0,1445,453,449,-4
"b2f0d654738f48158edff28e8d3a546e","f67fbf45a5f146ed866965bc57c7c001",22850074,2,8,0,1446,449,454,5
"f67fbf45a5f146ed866965bc57c7c001","b2f0d654738f48158edff28e8d3a546e",22850074,2,-8,0,1447,454,449,-5
"f67fbf45a5f146ed866965bc57c7c001","f67fbf45a5f146ed866965bc57c7c001",22850074,1,0,1,1449,454,454,0
"f67fbf45a5f146ed866965bc57c7c001","d937afe49bd24a07a550dda1c1155122",22850074,1,1,0,1450,454,455,1
"d937afe49bd24a07a550dda1c1155122","d937afe49bd24a07a550dda1c1155122",22850074,1,0,1,1451,455,455,0
"d937afe49bd24a07a550dda1c1155122","3628b3f7823443d0912a339096b69943",22850074,1,1,0,1452,455,456,1
"3628b3f7823443d0912a339096b69943","3628b3f7823443d0912a339096b69943",22850074,1,0,1,1453,456,456,0
"3628b3f7823443d0912a339096b69943","9e049ee647cf43ecbcb5ed792a8e7588",22850074,1,1,0,1454,456,457,1
"9e049ee647cf43ecbcb5ed792a8e7588","9e049ee647cf43ecbcb5ed792a8e7588",22850074,1,0,1,1455,457,457,0
"9e049ee647cf43ecbcb5ed792a8e7588","5256a214faaf410b93f76cea06428334",22850074,1,1,0,1456,457,458,1
"5256a214faaf410b93f76cea06428334","5256a214faaf410b93f76cea06428334",22850074,1,0,1,1457,458,458,0
"5256a214faaf410b93f76cea06428334","25c32b120fce40fa9b6c85133aeb4716",22850074,1,1,0,1458,458,459,1
"25c32b120fce40fa9b6c85133aeb4716","25c32b120fce40fa9b6c85133aeb4716",22850074,1,0,1,1459,459,459,0
"25c32b120fce40fa9b6c85133aeb4716","11bc14f2204949008b7d511b933363c1",22850074,1,1,0,1460,459,460,1
"11bc14f2204949008b7d511b933363c1","11bc14f2204949008b7d511b933363c1",22850074,1,0,1,1461,460,460,0
"11bc14f2204949008b7d511b933363c1","42de338840a34d15adb66e7b14fb9d2c",22850074,1,1,0,1462,460,461,1
"42de338840a34d15adb66e7b14fb9d2c","42de338840a34d15adb66e7b14fb9d2c",22850074,3,0,1,1463,461,461,0
"42de338840a34d15adb66e7b14fb9d2c","9da37c6210b1416b8079c274f70bf600",22850074,1,1,0,1466,461,462,1
"9da37c6210b1416b8079c274f70bf600","9da37c6210b1416b8079c274f70bf600",22850074,1,0,1,1467,462,462,0
"9da37c6210b1416b8079c274f70bf600","519119f1deac45ff9ab4f13529be5c6e",22850074,1,1,0,1468,462,463,1
"519119f1deac45ff9ab4f13529be5c6e","519119f1deac45ff9ab4f13529be5c6e",22850074,1,0,1,1469,463,463,0
"519119f1deac45ff9ab4f13529be5c6e","f67fbf45a5f146ed866965bc57c7c001",22850074,1,-9,0,1470,463,454,-9
"f67fbf45a5f146ed866965bc57c7c001","c5df9f40ec14463b9dcfdc73df3e9285",22850074,1,12,0,1471,454,464,10
"c5df9f40ec14463b9dcfdc73df3e9285","c5df9f40ec14463b9dcfdc73df3e9285",22850074,2,0,1,1472,464,464,0
"c5df9f40ec14463b9dcfdc73df3e9285","83d42d95cd844fc093fc09cee250edb8",22850074,1,3,0,1474,464,465,1
"83d42d95cd844fc093fc09cee250edb8","83d42d95cd844fc093fc09cee250edb8",22850074,1,0,1,1475,465,465,0
"83d42d95cd844fc093fc09cee250edb8","0d987bed3ffa4ed0b9a2e62e97b7b30f",22850074,1,-279,0,1476,465,272,-193
"0d987bed3ffa4ed0b9a2e62e97b7b30f","0d987bed3ffa4ed0b9a2e62e97b7b30f",22850074,4,0,1,1477,272,272,0
"0d987bed3ffa4ed0b9a2e62e97b7b30f","82ae07bc0c9b4570a41799290d1ef399",22850074,1,4,0,1478,272,275,3
"82ae07bc0c9b4570a41799290d1ef399","bb5a47f5ea01454a8b79455422d3b9da",22850074,1,6,0,1479,275,280,5
"bb5a47f5ea01454a8b79455422d3b9da","bb5a47f5ea01454a8b79455422d3b9da",22850074,68,0,1,1480,280,280,0
"bb5a47f5ea01454a8b79455422d3b9da","0d987bed3ffa4ed0b9a2e62e97b7b30f",22850074,1,-10,0,1487,280,272,-8
"0d987bed3ffa4ed0b9a2e62e97b7b30f","bb5a47f5ea01454a8b79455422d3b9da",22850074,2,10,0,1488,272,280,8
"bb5a47f5ea01454a8b79455422d3b9da","94cecc3f1e7d484b8e068e79241dfd73",22850074,1,3,0,1543,280,281,1
"94cecc3f1e7d484b8e068e79241dfd73","0d987bed3ffa4ed0b9a2e62e97b7b30f",22850074,1,-13,0,1544,281,272,-9
"0d987bed3ffa4ed0b9a2e62e97b7b30f","a37477c4e4c14169ad44b06b493007f6",22850074,1,15,0,1545,272,283,11
"a37477c4e4c14169ad44b06b493007f6","b71bac264efb4abd97015447bd490db6",22850074,1,117,0,1546,283,370,87
"d6d02b6ef04e4f17805504500b8ce441","b2f0d654738f48158edff28e8d3a546e",22850074,1,116,0,1611,375,449,74
"b2f0d654738f48158edff28e8d3a546e","f60ee41ec635499abd48168342d32c2f",22850074,2,5,0,1612,449,453,4
"f60ee41ec635499abd48168342d32c2f","9428d8bd9c5a47b2a235b254e5e27ded",22850074,1,-1,0,1620,453,452,-1
"9428d8bd9c5a47b2a235b254e5e27ded","f60ee41ec635499abd48168342d32c2f",22850074,1,1,0,1621,452,453,1
"f60ee41ec635499abd48168342d32c2f","f67fbf45a5f146ed866965bc57c7c001",22850074,1,3,0,1673,453,454,1
"b2f0d654738f48158edff28e8d3a546e","a9ac840f098c4bd0a2ee896214ce29cd",22850074,1,-395,0,1675,449,168,-281
"a9ac840f098c4bd0a2ee896214ce29cd","fab84b4fab5940efb4ea868ef8d09396",22850074,1,157,0,1676,168,284,116
"fab84b4fab5940efb4ea868ef8d09396","4a29443515bb404cb8924e1c60a63b73",22850074,3,4,0,1677,284,285,1
"4a29443515bb404cb8924e1c60a63b73","fab84b4fab5940efb4ea868ef8d09396",22850074,2,-4,0,1678,285,284,-1
"fab84b4fab5940efb4ea868ef8d09396","208c9b2796c944db8dacaa96082520ea",22850074,2,7,0,1679,284,288,4
"208c9b2796c944db8dacaa96082520ea","b71bac264efb4abd97015447bd490db6",22850074,1,107,0,1680,288,370,82
"b71bac264efb4abd97015447bd490db6","0d987bed3ffa4ed0b9a2e62e97b7b30f",22850074,1,-132,0,1681,370,272,-98
"0d987bed3ffa4ed0b9a2e62e97b7b30f","8d448d625b024c82a5eb240bbd7431d6",22850074,1,137,0,1682,272,374,102
"b613861cecf84ffcab01afb23f660475","b613861cecf84ffcab01afb23f660475",22850121,4,0,1,1,1,1,0
"b613861cecf84ffcab01afb23f660475","e2911e79efc2420eac45d9f671463d4b",22850121,1,3,0,5,1,2,1
"519d1b8c59404d67b54e96c5c8a830b2","531db53f81f646edb0cdcfe0085b03b7",22850121,2,1,0,10,3,4,1
"531db53f81f646edb0cdcfe0085b03b7","531db53f81f646edb0cdcfe0085b03b7",22850121,2,0,1,11,4,4,0
"531db53f81f646edb0cdcfe0085b03b7","4f5f94b2f95141e0a9d53a61da2276da",22850121,2,1,0,12,4,5,1
"4f5f94b2f95141e0a9d53a61da2276da","4f5f94b2f95141e0a9d53a61da2276da",22850121,2,0,1,13,5,5,0
"4f5f94b2f95141e0a9d53a61da2276da","6d541c89590949f99af293c4f2333f67",22850121,2,1,0,14,5,6,1
"6d541c89590949f99af293c4f2333f67","6d541c89590949f99af293c4f2333f67",22850121,1,0,1,15,6,6,0
"6d541c89590949f99af293c4f2333f67","dd5cf0b9fe4c4f1d8f5ff8e4c04879cb",22850121,3,1,0,16,6,7,1
"dd5cf0b9fe4c4f1d8f5ff8e4c04879cb","dd5cf0b9fe4c4f1d8f5ff8e4c04879cb",22850121,2,0,1,17,7,7,0
"dd5cf0b9fe4c4f1d8f5ff8e4c04879cb","6d541c89590949f99af293c4f2333f67",22850121,2,-1,0,19,7,6,-1
"6d541c89590949f99af293c4f2333f67","4f5f94b2f95141e0a9d53a61da2276da",22850121,1,-1,0,20,6,5,-1
"4f5f94b2f95141e0a9d53a61da2276da","531db53f81f646edb0cdcfe0085b03b7",22850121,1,-1,0,21,5,4,-1
"531db53f81f646edb0cdcfe0085b03b7","519d1b8c59404d67b54e96c5c8a830b2",22850121,1,-1,0,22,4,3,-1
"519d1b8c59404d67b54e96c5c8a830b2","f96261861edc426abe2248be4f0a709a",22850121,1,5,0,23,3,8,5
"f96261861edc426abe2248be4f0a709a","f96261861edc426abe2248be4f0a709a",22850121,2,0,1,24,8,8,0
"f96261861edc426abe2248be4f0a709a","66b5e16f4f75454fb5b8172079f0fa83",22850121,2,1,0,25,8,9,1
"66b5e16f4f75454fb5b8172079f0fa83","66b5e16f4f75454fb5b8172079f0fa83",22850121,2,0,1,26,9,9,0
"66b5e16f4f75454fb5b8172079f0fa83","0680571d4698477995e41842c36a54b2",22850121,2,1,0,27,9,10,1
"0680571d4698477995e41842c36a54b2","0680571d4698477995e41842c36a54b2",22850121,2,0,1,28,10,10,0
"0680571d4698477995e41842c36a54b2","e2911e79efc2420eac45d9f671463d4b",22850121,1,-8,0,29,10,2,-8
"e2911e79efc2420eac45d9f671463d4b","56586aa865414f538729c7f7735d2bc6",22850121,2,12,0,30,2,12,10
"56586aa865414f538729c7f7735d2bc6","b613861cecf84ffcab01afb23f660475",22850121,1,-15,0,31,12,1,-11
"b613861cecf84ffcab01afb23f660475","9112f2bffece48e08c6d2287be204085",22850121,1,12,0,32,1,11,10
"9112f2bffece48e08c6d2287be204085","e2911e79efc2420eac45d9f671463d4b",22850121,1,-9,0,33,11,2,-9
"e2911e79efc2420eac45d9f671463d4b","e2911e79efc2420eac45d9f671463d4b",22850121,5,0,1,34,2,2,0
"e2911e79efc2420eac45d9f671463d4b","519d1b8c59404d67b54e96c5c8a830b2",22850121,2,1,0,37,2,3,1
"519d1b8c59404d67b54e96c5c8a830b2","519d1b8c59404d67b54e96c5c8a830b2",22850121,2,0,1,38,3,3,0
"dd5cf0b9fe4c4f1d8f5ff8e4c04879cb","f96261861edc426abe2248be4f0a709a",22850121,1,1,0,47,7,8,1
"0680571d4698477995e41842c36a54b2","9112f2bffece48e08c6d2287be204085",22850121,1,1,0,53,10,11,1
"9112f2bffece48e08c6d2287be204085","9112f2bffece48e08c6d2287be204085",22850121,1,0,1,54,11,11,0
"9112f2bffece48e08c6d2287be204085","56586aa865414f538729c7f7735d2bc6",22850121,1,3,0,55,11,12,1
"56586aa865414f538729c7f7735d2bc6","e2911e79efc2420eac45d9f671463d4b",22850121,1,-12,0,56,12,2,-10
"56586aa865414f538729c7f7735d2bc6","56586aa865414f538729c7f7735d2bc6",22850121,2,0,1,58,12,12,0
"56586aa865414f538729c7f7735d2bc6","b7f2b31585d94eb3bf86376714aa7070",22850121,1,2,0,60,12,13,1
"b7f2b31585d94eb3bf86376714aa7070","b7f2b31585d94eb3bf86376714aa7070",22850121,2,0,1,61,13,13,0
"b7f2b31585d94eb3bf86376714aa7070","3f1c815879794b929260d224becaff7e",22850121,1,2,0,63,13,14,1
"3f1c815879794b929260d224becaff7e","81c864a886d54a6b8ff85f7d736f4f95",22850121,1,2,0,64,14,15,1
"81c864a886d54a6b8ff85f7d736f4f95","5c5ceeee4562457ba6d41515aeebfbb1",22850121,1,4,0,65,15,17,2
"5c5ceeee4562457ba6d41515aeebfbb1","5c5ceeee4562457ba6d41515aeebfbb1",22850121,1,0,1,66,17,17,0
"5c5ceeee4562457ba6d41515aeebfbb1","9afd71a5298d4333b6849dfce1b9422c",22850121,1,3,0,67,17,18,1
"9afd71a5298d4333b6849dfce1b9422c","56586aa865414f538729c7f7735d2bc6",22850121,1,-13,0,68,18,12,-6
"56586aa865414f538729c7f7735d2bc6","9afd71a5298d4333b6849dfce1b9422c",22850121,1,13,0,69,12,18,6
"9afd71a5298d4333b6849dfce1b9422c","b7719e26494940efa49512aedd0aac79",22850121,1,4,0,70,18,20,2
"b7719e26494940efa49512aedd0aac79","d4f45188d3c84a02ba08454e6403a818",22850121,1,5,0,71,20,24,4
"d4f45188d3c84a02ba08454e6403a818","d4c3b003e8274e429d2fa688d73fde6d",22850121,1,-2,0,72,24,22,-2
"b7719e26494940efa49512aedd0aac79","afbf7250b99d47bea07172749483ca97",22850121,2,12,0,75,20,28,8
"afbf7250b99d47bea07172749483ca97","4e51676dc72045d99c19b9fa7b22f8bc",22850121,1,3,0,78,28,29,1
"4e51676dc72045d99c19b9fa7b22f8bc","4e51676dc72045d99c19b9fa7b22f8bc",22850121,1,0,1,79,29,29,0
"4e51676dc72045d99c19b9fa7b22f8bc","51970cfa30e643e894e66ae85c8024cc",22850121,1,3,0,80,29,31,2
"51970cfa30e643e894e66ae85c8024cc","4e51676dc72045d99c19b9fa7b22f8bc",22850121,1,-3,0,81,31,29,-2
"4e51676dc72045d99c19b9fa7b22f8bc","c33c17be71ae4d588da7369472e5bb1b",22850121,1,9,0,82,29,34,5
"c33c17be71ae4d588da7369472e5bb1b","c33c17be71ae4d588da7369472e5bb1b",22850121,1,0,1,83,34,34,0
"c33c17be71ae4d588da7369472e5bb1b","93679be414554a11b1893002f2229a93",22850121,1,3,0,84,34,35,1
"93679be414554a11b1893002f2229a93","93679be414554a11b1893002f2229a93",22850121,1,0,1,85,35,35,0
"93679be414554a11b1893002f2229a93","7040a13096d746ac84b8fac8d9752058",22850121,1,3,0,86,35,36,1
"7040a13096d746ac84b8fac8d9752058","9a0dc646f934470daf08c4b56ccf73db",22850121,1,3,0,87,36,37,1
"9a0dc646f934470daf08c4b56ccf73db","7040a13096d746ac84b8fac8d9752058",22850121,1,-3,0,88,37,36,-1
"7040a13096d746ac84b8fac8d9752058","fc0e049d56024bc9a02c9a9c435c3df7",22850121,1,6,0,89,36,38,2
"fc0e049d56024bc9a02c9a9c435c3df7","9a0dc646f934470daf08c4b56ccf73db",22850121,1,-3,0,90,38,37,-1
"9a0dc646f934470daf08c4b56ccf73db","fc0e049d56024bc9a02c9a9c435c3df7",22850121,1,3,0,91,37,38,1
"fc0e049d56024bc9a02c9a9c435c3df7","67a089198fcb4e1c8f2385786c2b296f",22850121,1,4,0,92,38,39,1
"64d48c6c9c7940639a932219a6c87198","64d48c6c9c7940639a932219a6c87198",22850121,1,0,1,100,40,40,0
"64d48c6c9c7940639a932219a6c87198","67a089198fcb4e1c8f2385786c2b296f",22850121,8,-1,0,101,40,39,-1
"67a089198fcb4e1c8f2385786c2b296f","b534b89233134e30a9b5645138bfa9ee",22850121,3,4,0,102,39,41,2
"b534b89233134e30a9b5645138bfa9ee","0e37b720d23b4e7f8b313e79313fd107",22850121,1,3,0,103,41,44,3
"0e37b720d23b4e7f8b313e79313fd107","0e37b720d23b4e7f8b313e79313fd107",22850121,2,0,1,104,44,44,0
"0e37b720d23b4e7f8b313e79313fd107","6875d67fdd5f48168b62719df449bebd",22850121,1,1,0,106,44,45,1
"6875d67fdd5f48168b62719df449bebd","6875d67fdd5f48168b62719df449bebd",22850121,1,0,1,107,45,45,0
"6875d67fdd5f48168b62719df449bebd","b534b89233134e30a9b5645138bfa9ee",22850121,1,-4,0,108,45,41,-4
"b534b89233134e30a9b5645138bfa9ee","6e13d61a7bdb44bca949c9f86fab3be5",22850121,2,7,0,109,41,47,6
"6e13d61a7bdb44bca949c9f86fab3be5","6e13d61a7bdb44bca949c9f86fab3be5",22850121,2,0,1,110,47,47,0
"6e13d61a7bdb44bca949c9f86fab3be5","195f78799f984cc2b06c48dfe36be751",22850121,1,2,0,111,47,49,2
"195f78799f984cc2b06c48dfe36be751","195f78799f984cc2b06c48dfe36be751",22850121,2,0,1,112,49,49,0
"195f78799f984cc2b06c48dfe36be751","d0c74f735e024943943e40333d6d337f",22850121,1,3,0,114,49,51,2
"d0c74f735e024943943e40333d6d337f","d9c8d8c444a64dadbbb508652c721e17",22850121,1,-6,0,115,51,46,-5
"d9c8d8c444a64dadbbb508652c721e17","67a089198fcb4e1c8f2385786c2b296f",22850121,1,-10,0,116,46,39,-7
"67a089198fcb4e1c8f2385786c2b296f","64d48c6c9c7940639a932219a6c87198",22850121,8,1,0,117,39,40,1
"b534b89233134e30a9b5645138bfa9ee","f924752d8a1149668870b1e7698486f7",22850121,1,11,0,120,41,50,9
"f924752d8a1149668870b1e7698486f7","d0c74f735e024943943e40333d6d337f",22850121,1,1,0,121,50,51,1
"d0c74f735e024943943e40333d6d337f","d0c74f735e024943943e40333d6d337f",22850121,2,0,1,122,51,51,0
"d0c74f735e024943943e40333d6d337f","35adfa5d923046aebabfefd98f35ff05",22850121,1,3,0,124,51,54,3
"35adfa5d923046aebabfefd98f35ff05","35adfa5d923046aebabfefd98f35ff05",22850121,5,0,1,125,54,54,0
"35adfa5d923046aebabfefd98f35ff05","b6f8a98476224da1b40e555ececc7ed8",22850121,1,1,0,130,54,55,1
"b6f8a98476224da1b40e555ececc7ed8","b6f8a98476224da1b40e555ececc7ed8",22850121,2,0,1,131,55,55,0
"b6f8a98476224da1b40e555ececc7ed8","86e22cb5fe0e4b47a9489ecddf7ed78f",22850121,1,1,0,133,55,56,1
"86e22cb5fe0e4b47a9489ecddf7ed78f","86e22cb5fe0e4b47a9489ecddf7ed78f",22850121,2,0,1,134,56,56,0
"86e22cb5fe0e4b47a9489ecddf7ed78f","983f8ff320594b279a7f4a6fe132f9c5",22850121,1,-3,0,136,56,53,-3
"983f8ff320594b279a7f4a6fe132f9c5","983f8ff320594b279a7f4a6fe132f9c5",22850121,2,0,1,137,53,53,0
"983f8ff320594b279a7f4a6fe132f9c5","f924752d8a1149668870b1e7698486f7",22850121,1,-3,0,139,53,50,-3
"f924752d8a1149668870b1e7698486f7","78f30e4dcac84e3cbea8b2cc6e0d62b3",22850121,1,10,0,140,50,59,9
"78f30e4dcac84e3cbea8b2cc6e0d62b3","a1f2f12debe5432fb7a70bcd12bacfb9",22850121,2,-1,0,141,59,58,-1
"a1f2f12debe5432fb7a70bcd12bacfb9","b534b89233134e30a9b5645138bfa9ee",22850121,1,-20,0,142,58,41,-17
"b534b89233134e30a9b5645138bfa9ee","12aa6e1672ac4e7aa6449a7a8609cd72",22850121,1,19,0,143,41,57,16
"12aa6e1672ac4e7aa6449a7a8609cd72","a0a418b8540d479fa6e0f653b701da8b",22850121,1,8,0,144,57,64,7
"a0a418b8540d479fa6e0f653b701da8b","bc42d26810654ea9a1df1efe1e58c7d5",22850121,1,-1,0,145,64,63,-1
"bc42d26810654ea9a1df1efe1e58c7d5","d0c74f735e024943943e40333d6d337f",22850121,1,-14,0,146,63,51,-12
"d0c74f735e024943943e40333d6d337f","f924752d8a1149668870b1e7698486f7",22850121,1,-1,0,147,51,50,-1
"f924752d8a1149668870b1e7698486f7","a1f2f12debe5432fb7a70bcd12bacfb9",22850121,1,9,0,148,50,58,8
"a1f2f12debe5432fb7a70bcd12bacfb9","78f30e4dcac84e3cbea8b2cc6e0d62b3",22850121,2,1,0,149,58,59,1
"a1f2f12debe5432fb7a70bcd12bacfb9","a1f2f12debe5432fb7a70bcd12bacfb9",22850121,17,0,1,151,58,58,0
"78f30e4dcac84e3cbea8b2cc6e0d62b3","78f30e4dcac84e3cbea8b2cc6e0d62b3",22850121,7,0,1,169,59,59,0
"78f30e4dcac84e3cbea8b2cc6e0d62b3","12aa6e1672ac4e7aa6449a7a8609cd72",22850121,1,-2,0,176,59,57,-2
"12aa6e1672ac4e7aa6449a7a8609cd72","bc42d26810654ea9a1df1efe1e58c7d5",22850121,1,7,0,177,57,63,6
"bc42d26810654ea9a1df1efe1e58c7d5","a0a418b8540d479fa6e0f653b701da8b",22850121,2,1,0,178,63,64,1
"a0a418b8540d479fa6e0f653b701da8b","4c943503763e4e349906eea3ed3c8e86",22850121,1,-3,0,179,64,61,-3
"4c943503763e4e349906eea3ed3c8e86","4c943503763e4e349906eea3ed3c8e86",22850121,1,0,1,180,61,61,0
"4c943503763e4e349906eea3ed3c8e86","bc42d26810654ea9a1df1efe1e58c7d5",22850121,1,2,0,181,61,63,2
"bc42d26810654ea9a1df1efe1e58c7d5","bc42d26810654ea9a1df1efe1e58c7d5",22850121,3,0,1,182,63,63,0
"a0a418b8540d479fa6e0f653b701da8b","a0a418b8540d479fa6e0f653b701da8b",22850121,3,0,1,186,64,64,0
"a0a418b8540d479fa6e0f653b701da8b","309ccf3cc4fe429d9bfbaef53d3fa479",22850121,1,-4,0,189,64,60,-4
"309ccf3cc4fe429d9bfbaef53d3fa479","d646286c8051419bbc2e31dd1db55ca8",22850121,1,10,0,190,60,67,7
"d646286c8051419bbc2e31dd1db55ca8","b534b89233134e30a9b5645138bfa9ee",22850121,1,-33,0,191,67,41,-26
"b534b89233134e30a9b5645138bfa9ee","67a089198fcb4e1c8f2385786c2b296f",22850121,1,-4,0,192,41,39,-2
"67a089198fcb4e1c8f2385786c2b296f","d646286c8051419bbc2e31dd1db55ca8",22850121,1,37,0,193,39,67,28
"d646286c8051419bbc2e31dd1db55ca8","267f883678b24aed855fde42524975d9",22850121,1,4,0,194,67,71,4
"88fff56d0342490dbef9040750a20f6c","adb17b12b66c4a49a85fd34322f7df70",22850121,1,1,0,198,72,73,1
"adb17b12b66c4a49a85fd34322f7df70","a2becd407db34b189200a32546d9d569",22850121,1,3,0,200,73,75,2
"a2becd407db34b189200a32546d9d569","a2becd407db34b189200a32546d9d569",22850121,3,0,1,203,75,75,0
"dd76e1861dc9461c830888729d091ee0","f8ec6445f7194e25b9101d4fbcb07a18",22850121,1,3,0,210,78,81,3
"f8ec6445f7194e25b9101d4fbcb07a18","a2becd407db34b189200a32546d9d569",22850121,1,-6,0,213,81,75,-6
"a2becd407db34b189200a32546d9d569","9176a3c2b4d2465fa8b0c67096c2a97e",22850121,1,5,0,216,75,80,5
"9176a3c2b4d2465fa8b0c67096c2a97e","cd1d828f1a694b87913a7ea66c23803e",22850121,1,-1,0,228,80,79,-1
"cd1d828f1a694b87913a7ea66c23803e","140d5b27b8574befad82c0a013b59dfa",22850121,1,-5,0,231,79,74,-5
"d18a9ea32855445f8736581f5cb119ce","f564483cbd7a407681aa2fcca518cf5f",22850121,1,4,0,233,82,85,3
"f564483cbd7a407681aa2fcca518cf5f","f564483cbd7a407681aa2fcca518cf5f",22850121,1,0,1,234,85,85,0
"f564483cbd7a407681aa2fcca518cf5f","18fd01350bd5434ca636d59a599d768a",22850121,1,1,0,235,85,86,1
"18fd01350bd5434ca636d59a599d768a","18fd01350bd5434ca636d59a599d768a",22850121,9,0,1,236,86,86,0
"18fd01350bd5434ca636d59a599d768a","6a9f0ef185fb47f0937e29daa1c71ed5",22850121,1,5,0,245,86,90,4
"6a9f0ef185fb47f0937e29daa1c71ed5","ae5ac430ea254e708a6f5deaaf7464ae",22850121,1,-7,0,246,90,84,-6
"ae5ac430ea254e708a6f5deaaf7464ae","6a9f0ef185fb47f0937e29daa1c71ed5",22850121,1,7,0,247,84,90,6
"6a9f0ef185fb47f0937e29daa1c71ed5","c681290961c94c4caf23b529d1ae6b9a",22850121,1,-2,0,251,90,88,-2
"c681290961c94c4caf23b529d1ae6b9a","c681290961c94c4caf23b529d1ae6b9a",22850121,1,0,1,252,88,88,0
"c681290961c94c4caf23b529d1ae6b9a","e20db35ced8544ddac5bc3839145e463",22850121,1,5,0,253,88,91,3
"e20db35ced8544ddac5bc3839145e463","d646286c8051419bbc2e31dd1db55ca8",22850121,2,-30,0,254,91,67,-24
"d646286c8051419bbc2e31dd1db55ca8","67a089198fcb4e1c8f2385786c2b296f",22850121,1,-37,0,255,67,39,-28
"67a089198fcb4e1c8f2385786c2b296f","67a089198fcb4e1c8f2385786c2b296f",22850121,4,0,1,256,39,39,0
"67a089198fcb4e1c8f2385786c2b296f","e20db35ced8544ddac5bc3839145e463",22850121,2,67,0,259,39,91,52
"e20db35ced8544ddac5bc3839145e463","e20db35ced8544ddac5bc3839145e463",22850121,1,0,1,260,91,91,0
"e20db35ced8544ddac5bc3839145e463","1febb706d7a34005ae8711ed49c76e64",22850121,1,3,0,261,91,94,3
"1febb706d7a34005ae8711ed49c76e64","1febb706d7a34005ae8711ed49c76e64",22850121,4,0,1,262,94,94,0
"1febb706d7a34005ae8711ed49c76e64","8f73ba6f5a0042f2850356ac38ac6f24",22850121,1,1,0,264,94,95,1
"8f73ba6f5a0042f2850356ac38ac6f24","8f73ba6f5a0042f2850356ac38ac6f24",22850121,5,0,1,265,95,95,0
"8f73ba6f5a0042f2850356ac38ac6f24","e2260b86653c46d7b14a41fb419dbf8c",22850121,1,1,0,270,95,96,1
"e2260b86653c46d7b14a41fb419dbf8c","e2260b86653c46d7b14a41fb419dbf8c",22850121,4,0,1,271,96,96,0
"e2260b86653c46d7b14a41fb419dbf8c","35eb641ad1d845bbba54915bce75a962",22850121,1,1,0,273,96,97,1
"35eb641ad1d845bbba54915bce75a962","35eb641ad1d845bbba54915bce75a962",22850121,5,0,1,274,97,97,0
"35eb641ad1d845bbba54915bce75a962","08be90ffbeea4795a138cd42ed8db56f",22850121,1,1,0,279,97,98,1
"08be90ffbeea4795a138cd42ed8db56f","08be90ffbeea4795a138cd42ed8db56f",22850121,5,0,1,280,98,98,0
"08be90ffbeea4795a138cd42ed8db56f","3007433c8f584dcbb5ac159c1c5f2be3",22850121,1,1,0,285,98,99,1
"3007433c8f584dcbb5ac159c1c5f2be3","3007433c8f584dcbb5ac159c1c5f2be3",22850121,5,0,1,286,99,99,0
"3007433c8f584dcbb5ac159c1c5f2be3","e20db35ced8544ddac5bc3839145e463",22850121,1,-8,0,291,99,91,-8
"e20db35ced8544ddac5bc3839145e463","d391c8b6e56a43a7b654e9dee02d904b",22850121,2,13,0,292,91,103,12
"d391c8b6e56a43a7b654e9dee02d904b","00ae5f0c51874a73a41ebea838d95682",22850121,3,-2,0,293,103,101,-2
"00ae5f0c51874a73a41ebea838d95682","00ae5f0c51874a73a41ebea838d95682",22850121,1,0,1,294,101,101,0
"00ae5f0c51874a73a41ebea838d95682","d391c8b6e56a43a7b654e9dee02d904b",22850121,3,2,0,295,101,103,2
"d391c8b6e56a43a7b654e9dee02d904b","d391c8b6e56a43a7b654e9dee02d904b",22850121,23,0,1,296,103,103,0
"d391c8b6e56a43a7b654e9dee02d904b","e20db35ced8544ddac5bc3839145e463",22850121,1,-13,0,305,103,91,-12
"00ae5f0c51874a73a41ebea838d95682","e20db35ced8544ddac5bc3839145e463",22850121,2,-11,0,308,101,91,-10
"e20db35ced8544ddac5bc3839145e463","6111116566fc4fd9abba409322bea245",22850121,1,14,0,309,91,104,13
"6111116566fc4fd9abba409322bea245","6111116566fc4fd9abba409322bea245",22850121,5,0,1,310,104,104,0
"6111116566fc4fd9abba409322bea245","a81b2235cb9c499eb9ea8ee0a8dd9725",22850121,1,1,0,315,104,105,1
"a81b2235cb9c499eb9ea8ee0a8dd9725","a81b2235cb9c499eb9ea8ee0a8dd9725",22850121,5,0,1,316,105,105,0
"a81b2235cb9c499eb9ea8ee0a8dd9725","2d4e0ab0ef3b4d73b82c72d4621a7579",22850121,1,1,0,321,105,106,1
"2d4e0ab0ef3b4d73b82c72d4621a7579","2d4e0ab0ef3b4d73b82c72d4621a7579",22850121,2,0,1,322,106,106,0
"2d4e0ab0ef3b4d73b82c72d4621a7579","8bdebf492ebd4e62b0d522e8ab5e5197",22850121,1,1,0,324,106,107,1
"8bdebf492ebd4e62b0d522e8ab5e5197","8bdebf492ebd4e62b0d522e8ab5e5197",22850121,2,0,1,325,107,107,0
"8bdebf492ebd4e62b0d522e8ab5e5197","00ae5f0c51874a73a41ebea838d95682",22850121,1,-6,0,327,107,101,-6
"d391c8b6e56a43a7b654e9dee02d904b","4280927ec4d643238aa49c32f9e06c6c",22850121,1,7,0,345,103,109,6
"4280927ec4d643238aa49c32f9e06c6c","73039f8c1eb9409cb4caee2cf968001e",22850121,1,-10,0,346,109,100,-9
"73039f8c1eb9409cb4caee2cf968001e","4280927ec4d643238aa49c32f9e06c6c",22850121,1,10,0,347,100,109,9
"4280927ec4d643238aa49c32f9e06c6c","fc44e6a5f7654430af1227838224dceb",22850121,1,2,0,348,109,111,2
"fc44e6a5f7654430af1227838224dceb","fc44e6a5f7654430af1227838224dceb",22850121,8,0,1,349,111,111,0
"fc44e6a5f7654430af1227838224dceb","4280927ec4d643238aa49c32f9e06c6c",22850121,1,-2,0,357,111,109,-2
"4280927ec4d643238aa49c32f9e06c6c","08111f75e22d409998cf8b85bd431f0a",22850121,1,-1,0,358,109,108,-1
"08111f75e22d409998cf8b85bd431f0a","a9ae0a3c070d455bb4369a8996313336",22850121,1,7,0,359,108,114,6
"a9ae0a3c070d455bb4369a8996313336","37319e88176d4aefa91d7a9980dbae91",22850121,1,-2,0,360,114,112,-2
"37319e88176d4aefa91d7a9980dbae91","1febb706d7a34005ae8711ed49c76e64",22850121,1,-21,0,361,112,94,-18
"1febb706d7a34005ae8711ed49c76e64","e2260b86653c46d7b14a41fb419dbf8c",22850121,1,2,0,364,94,96,2
"e2260b86653c46d7b14a41fb419dbf8c","e20db35ced8544ddac5bc3839145e463",22850121,1,-5,0,367,96,91,-5
"e20db35ced8544ddac5bc3839145e463","00ae5f0c51874a73a41ebea838d95682",22850121,1,11,0,368,91,101,10
"d646286c8051419bbc2e31dd1db55ca8","d391c8b6e56a43a7b654e9dee02d904b",22850121,1,43,0,371,67,103,36
"d391c8b6e56a43a7b654e9dee02d904b","6a9f0ef185fb47f0937e29daa1c71ed5",22850121,1,-16,0,372,103,90,-13
"6a9f0ef185fb47f0937e29daa1c71ed5","67a089198fcb4e1c8f2385786c2b296f",22850121,1,-64,0,375,90,39,-51
"e20db35ced8544ddac5bc3839145e463","37319e88176d4aefa91d7a9980dbae91",22850121,1,24,0,377,91,112,21
"37319e88176d4aefa91d7a9980dbae91","a9ae0a3c070d455bb4369a8996313336",22850121,1,2,0,378,112,114,2
"a9ae0a3c070d455bb4369a8996313336","a9ae0a3c070d455bb4369a8996313336",22850121,1,0,1,379,114,114,0
"a9ae0a3c070d455bb4369a8996313336","71cec822bcff4f30a20e75dc63ef7b65",22850121,1,2,0,380,114,116,2
"71cec822bcff4f30a20e75dc63ef7b65","71cec822bcff4f30a20e75dc63ef7b65",22850121,1,0,1,381,116,116,0
"71cec822bcff4f30a20e75dc63ef7b65","62bff51286ef4f348717a3cf6fe2318f",22850121,1,5,0,382,116,120,4
"62bff51286ef4f348717a3cf6fe2318f","37319e88176d4aefa91d7a9980dbae91",22850121,1,-9,0,383,120,112,-8
"37319e88176d4aefa91d7a9980dbae91","62bff51286ef4f348717a3cf6fe2318f",22850121,1,9,0,384,112,120,8
"62bff51286ef4f348717a3cf6fe2318f","62bff51286ef4f348717a3cf6fe2318f",22850121,3,0,1,385,120,120,0
"62bff51286ef4f348717a3cf6fe2318f","b1cd0e7dc3ad4a8eb91a4bfdbeb025b0",22850121,1,-2,0,388,120,118,-2
"b1cd0e7dc3ad4a8eb91a4bfdbeb025b0","b1cd0e7dc3ad4a8eb91a4bfdbeb025b0",22850121,1,0,1,389,118,118,0
"b1cd0e7dc3ad4a8eb91a4bfdbeb025b0","e20db35ced8544ddac5bc3839145e463",22850121,1,-31,0,390,118,91,-27
"e20db35ced8544ddac5bc3839145e463","779f9ddd1fd14d1e9e69f72219a1fdbd",22850121,1,36,0,391,91,121,30
"779f9ddd1fd14d1e9e69f72219a1fdbd","67a089198fcb4e1c8f2385786c2b296f",22850121,1,-103,0,392,121,39,-82
"67a089198fcb4e1c8f2385786c2b296f","779f9ddd1fd14d1e9e69f72219a1fdbd",22850121,2,103,0,396,39,121,82
"779f9ddd1fd14d1e9e69f72219a1fdbd","779f9ddd1fd14d1e9e69f72219a1fdbd",22850121,2,0,1,397,121,121,0
"779f9ddd1fd14d1e9e69f72219a1fdbd","ae26e6cda8ad4a3f81bd347560d9579f",22850121,2,4,0,398,121,125,4
"ae26e6cda8ad4a3f81bd347560d9579f","ae26e6cda8ad4a3f81bd347560d9579f",22850121,3,0,1,399,125,125,0
"ae26e6cda8ad4a3f81bd347560d9579f","ee48df95832b4374aa273ceb27ec1315",22850121,4,1,0,402,125,126,1
"ee48df95832b4374aa273ceb27ec1315","ee48df95832b4374aa273ceb27ec1315",22850121,2,0,1,403,126,126,0
"ee48df95832b4374aa273ceb27ec1315","7a439da90b394756ad1777fc4c6dead5",22850121,4,1,0,404,126,127,1
"7a439da90b394756ad1777fc4c6dead5","7a439da90b394756ad1777fc4c6dead5",22850121,3,0,1,405,127,127,0
"7a439da90b394756ad1777fc4c6dead5","a8dd5213034441ac92724b4e83eb0bb2",22850121,2,3,0,406,127,129,2
"a8dd5213034441ac92724b4e83eb0bb2","779f9ddd1fd14d1e9e69f72219a1fdbd",22850121,2,-9,0,407,129,121,-8
"779f9ddd1fd14d1e9e69f72219a1fdbd","a8dd5213034441ac92724b4e83eb0bb2",22850121,3,9,0,408,121,129,8
"a8dd5213034441ac92724b4e83eb0bb2","8115eab6556b45f5b415c3b8c26a12e5",22850121,1,2,0,409,129,131,2
"8115eab6556b45f5b415c3b8c26a12e5","8115eab6556b45f5b415c3b8c26a12e5",22850121,4,0,1,410,131,131,0
"8115eab6556b45f5b415c3b8c26a12e5","ec34b06efd844b46a4c4818ecdb9b8f4",22850121,2,1,0,412,131,132,1
"ec34b06efd844b46a4c4818ecdb9b8f4","ec34b06efd844b46a4c4818ecdb9b8f4",22850121,4,0,1,413,132,132,0
"ec34b06efd844b46a4c4818ecdb9b8f4","c2e1c2b9eac64109b343a088584b576b",22850121,2,1,0,415,132,133,1
"c2e1c2b9eac64109b343a088584b576b","c2e1c2b9eac64109b343a088584b576b",22850121,4,0,1,416,133,133,0
"c2e1c2b9eac64109b343a088584b576b","579338175e0b4bbb8ef3b712b5d8b54e",22850121,2,-5,0,418,133,128,-5
"579338175e0b4bbb8ef3b712b5d8b54e","b416d47c56a742199b5d7c7f19d6503a",22850121,1,7,0,419,128,134,6
"b416d47c56a742199b5d7c7f19d6503a","ae26e6cda8ad4a3f81bd347560d9579f",22850121,1,-11,0,420,134,125,-9
"ee48df95832b4374aa273ceb27ec1315","ae26e6cda8ad4a3f81bd347560d9579f",22850121,1,-1,0,422,126,125,-1
"779f9ddd1fd14d1e9e69f72219a1fdbd","8115eab6556b45f5b415c3b8c26a12e5",22850121,1,11,0,428,121,131,10
"579338175e0b4bbb8ef3b712b5d8b54e","8bc5795d6a984a3eace4e2811e52dd4f",22850121,1,8,0,438,128,135,7
"8bc5795d6a984a3eace4e2811e52dd4f","8bc5795d6a984a3eace4e2811e52dd4f",22850121,1,0,1,439,135,135,0
"8bc5795d6a984a3eace4e2811e52dd4f","b416d47c56a742199b5d7c7f19d6503a",22850121,1,-1,0,440,135,134,-1
"b416d47c56a742199b5d7c7f19d6503a","f661500307d74c908e9207d949ceb4aa",22850121,1,3,0,441,134,136,2
"f661500307d74c908e9207d949ceb4aa","ee48df95832b4374aa273ceb27ec1315",22850121,1,-13,0,442,136,126,-10
"7a439da90b394756ad1777fc4c6dead5","779f9ddd1fd14d1e9e69f72219a1fdbd",22850121,2,-6,0,446,127,121,-6
"a8dd5213034441ac92724b4e83eb0bb2","579338175e0b4bbb8ef3b712b5d8b54e",22850121,1,-1,0,448,129,128,-1
"579338175e0b4bbb8ef3b712b5d8b54e","cd4532ad48034873ba8bce2aac0c9808",22850121,1,11,0,449,128,137,9
"cd4532ad48034873ba8bce2aac0c9808","cd4532ad48034873ba8bce2aac0c9808",22850121,1,0,1,450,137,137,0
"cd4532ad48034873ba8bce2aac0c9808","df1de691dafe4549a18a4398ee9dfaf9",22850121,1,4,0,451,137,139,2
"df1de691dafe4549a18a4398ee9dfaf9","779f9ddd1fd14d1e9e69f72219a1fdbd",22850121,1,-23,0,452,139,121,-18
"779f9ddd1fd14d1e9e69f72219a1fdbd","6c5ad271a44743479bfaea29b1db8d02",22850121,1,27,0,453,121,143,22
"6c5ad271a44743479bfaea29b1db8d02","67a089198fcb4e1c8f2385786c2b296f",22850121,1,-130,0,454,143,39,-104
"a8dd5213034441ac92724b4e83eb0bb2","67a089198fcb4e1c8f2385786c2b296f",22850121,1,-112,0,462,129,39,-90
"67a089198fcb4e1c8f2385786c2b296f","df1de691dafe4549a18a4398ee9dfaf9",22850121,2,126,0,463,39,139,100
"df1de691dafe4549a18a4398ee9dfaf9","df1de691dafe4549a18a4398ee9dfaf9",22850121,1,0,1,464,139,139,0
"df1de691dafe4549a18a4398ee9dfaf9","6c5ad271a44743479bfaea29b1db8d02",22850121,1,4,0,465,139,143,4
"6c5ad271a44743479bfaea29b1db8d02","6c5ad271a44743479bfaea29b1db8d02",22850121,1,0,1,466,143,143,0
"6c5ad271a44743479bfaea29b1db8d02","83d311bed5374fee83d8d67a7d9d82dc",22850121,1,1,0,467,143,144,1
"83d311bed5374fee83d8d67a7d9d82dc","83d311bed5374fee83d8d67a7d9d82dc",22850121,1,0,1,468,144,144,0
"83d311bed5374fee83d8d67a7d9d82dc","402bba41861d43acb52a5abb89e8831e",22850121,1,1,0,469,144,145,1
"402bba41861d43acb52a5abb89e8831e","402bba41861d43acb52a5abb89e8831e",22850121,2,0,1,470,145,145,0
"402bba41861d43acb52a5abb89e8831e","8aae34f5ddbb4052a709b12e6b0d40fa",22850121,1,3,0,472,145,147,2
"8aae34f5ddbb4052a709b12e6b0d40fa","df1de691dafe4549a18a4398ee9dfaf9",22850121,1,-9,0,473,147,139,-8
"df1de691dafe4549a18a4398ee9dfaf9","8aae34f5ddbb4052a709b12e6b0d40fa",22850121,2,9,0,474,139,147,8
"8aae34f5ddbb4052a709b12e6b0d40fa","8aae34f5ddbb4052a709b12e6b0d40fa",22850121,3,0,1,475,147,147,0
"8aae34f5ddbb4052a709b12e6b0d40fa","645b3f0249f64f76af2e19eb4d0e55b7",22850121,2,2,0,477,147,149,2
"645b3f0249f64f76af2e19eb4d0e55b7","645b3f0249f64f76af2e19eb4d0e55b7",22850121,7,0,1,478,149,149,0
"645b3f0249f64f76af2e19eb4d0e55b7","8aae34f5ddbb4052a709b12e6b0d40fa",22850121,1,-2,0,481,149,147,-2
"8aae34f5ddbb4052a709b12e6b0d40fa","7e7b8db5064d4369805ab370aac5ddfb",22850121,1,3,0,482,147,150,3
"7e7b8db5064d4369805ab370aac5ddfb","7e7b8db5064d4369805ab370aac5ddfb",22850121,7,0,1,483,150,150,0
"7e7b8db5064d4369805ab370aac5ddfb","8956d210ae7f41968fada86d4c979d6a",22850121,2,1,0,485,150,151,1
"8956d210ae7f41968fada86d4c979d6a","8956d210ae7f41968fada86d4c979d6a",22850121,4,0,1,486,151,151,0
"8956d210ae7f41968fada86d4c979d6a","645b3f0249f64f76af2e19eb4d0e55b7",22850121,1,-2,0,488,151,149,-2
"645b3f0249f64f76af2e19eb4d0e55b7","f902b0f41b544d4dbf79664fd233648d",22850121,1,-3,0,491,149,146,-3
"f902b0f41b544d4dbf79664fd233648d","ae781e8b775e4ccd93bc800dad5c8376",22850121,1,8,0,492,146,153,7
"ae781e8b775e4ccd93bc800dad5c8376","ae781e8b775e4ccd93bc800dad5c8376",22850121,2,0,1,493,153,153,0
"ae781e8b775e4ccd93bc800dad5c8376","06882a8492d9499aa31555567f575ecb",22850121,1,1,0,495,153,154,1
"06882a8492d9499aa31555567f575ecb","06882a8492d9499aa31555567f575ecb",22850121,2,0,1,496,154,154,0
"06882a8492d9499aa31555567f575ecb","f293c508f409466a8f27ddd7d1e40b20",22850121,1,1,0,498,154,155,1
"f293c508f409466a8f27ddd7d1e40b20","f293c508f409466a8f27ddd7d1e40b20",22850121,2,0,1,499,155,155,0
"f293c508f409466a8f27ddd7d1e40b20","cc4ddef5bbbe48ebb605141b347c4ed1",22850121,1,1,0,501,155,156,1
"cc4ddef5bbbe48ebb605141b347c4ed1","cc4ddef5bbbe48ebb605141b347c4ed1",22850121,1,0,1,502,156,156,0
"cc4ddef5bbbe48ebb605141b347c4ed1","f03480cf4eba413194d7af52fc0e7f28",22850121,1,-4,0,503,156,152,-4
"f03480cf4eba413194d7af52fc0e7f28","d313cec988a84645bee413e8d4724a4b",22850121,1,7,0,504,152,158,6
"d313cec988a84645bee413e8d4724a4b","d313cec988a84645bee413e8d4724a4b",22850121,4,0,1,505,158,158,0
"d313cec988a84645bee413e8d4724a4b","dc60696c76a74368a60f72246e47700d",22850121,1,1,0,509,158,159,1
"dc60696c76a74368a60f72246e47700d","dc60696c76a74368a60f72246e47700d",22850121,1,0,1,510,159,159,0
"dc60696c76a74368a60f72246e47700d","df1de691dafe4549a18a4398ee9dfaf9",22850121,1,-23,0,511,159,139,-20
"df1de691dafe4549a18a4398ee9dfaf9","78adeee1fa2c4fe0bc73f7bca9fcee86",22850121,1,26,0,512,139,160,21
"78adeee1fa2c4fe0bc73f7bca9fcee86","67a089198fcb4e1c8f2385786c2b296f",22850121,2,-152,0,513,160,39,-121
"67a089198fcb4e1c8f2385786c2b296f","f902b0f41b544d4dbf79664fd233648d",22850121,1,134,0,514,39,146,107
"f902b0f41b544d4dbf79664fd233648d","df1de691dafe4549a18a4398ee9dfaf9",22850121,1,-8,0,515,146,139,-7
"645b3f0249f64f76af2e19eb4d0e55b7","7e7b8db5064d4369805ab370aac5ddfb",22850121,1,1,0,521,149,150,1
"8956d210ae7f41968fada86d4c979d6a","f902b0f41b544d4dbf79664fd233648d",22850121,2,-5,0,530,151,146,-5
"f902b0f41b544d4dbf79664fd233648d","f03480cf4eba413194d7af52fc0e7f28",22850121,1,7,0,531,146,152,6
"f03480cf4eba413194d7af52fc0e7f28","8aae34f5ddbb4052a709b12e6b0d40fa",22850121,1,-6,0,532,152,147,-5
"8aae34f5ddbb4052a709b12e6b0d40fa","8956d210ae7f41968fada86d4c979d6a",22850121,1,4,0,533,147,151,4
"f902b0f41b544d4dbf79664fd233648d","8aae34f5ddbb4052a709b12e6b0d40fa",22850121,1,1,0,535,146,147,1
"8aae34f5ddbb4052a709b12e6b0d40fa","f03480cf4eba413194d7af52fc0e7f28",22850121,1,6,0,536,147,152,5
"f03480cf4eba413194d7af52fc0e7f28","f902b0f41b544d4dbf79664fd233648d",22850121,1,-7,0,537,152,146,-6
"f902b0f41b544d4dbf79664fd233648d","67a089198fcb4e1c8f2385786c2b296f",22850121,1,-134,0,538,146,39,-107
"df1de691dafe4549a18a4398ee9dfaf9","67a089198fcb4e1c8f2385786c2b296f",22850121,1,-126,0,540,139,39,-100
"67a089198fcb4e1c8f2385786c2b296f","78adeee1fa2c4fe0bc73f7bca9fcee86",22850121,2,152,0,541,39,160,121
"78adeee1fa2c4fe0bc73f7bca9fcee86","78adeee1fa2c4fe0bc73f7bca9fcee86",22850121,2,0,1,542,160,160,0
"b534b89233134e30a9b5645138bfa9ee","d9c8d8c444a64dadbbb508652c721e17",22850121,1,6,0,547,41,46,5
"d9c8d8c444a64dadbbb508652c721e17","6e13d61a7bdb44bca949c9f86fab3be5",22850121,1,1,0,548,46,47,1
"6e13d61a7bdb44bca949c9f86fab3be5","d9c8d8c444a64dadbbb508652c721e17",22850121,1,-1,0,549,47,46,-1
"d9c8d8c444a64dadbbb508652c721e17","b534b89233134e30a9b5645138bfa9ee",22850121,1,-6,0,550,46,41,-5
"6e13d61a7bdb44bca949c9f86fab3be5","67a089198fcb4e1c8f2385786c2b296f",22850121,1,-11,0,553,47,39,-8
"78adeee1fa2c4fe0bc73f7bca9fcee86","65202579580f4ad38d734b4ee39d22a8",22850121,2,5,0,558,160,164,4
"65202579580f4ad38d734b4ee39d22a8","65202579580f4ad38d734b4ee39d22a8",22850121,51,0,1,559,164,164,0
"65202579580f4ad38d734b4ee39d22a8","78adeee1fa2c4fe0bc73f7bca9fcee86",22850121,1,-5,0,561,164,160,-4
"65202579580f4ad38d734b4ee39d22a8","3cbcea2be0984e7dbd5a48195af10ce7",22850121,1,3,0,612,164,165,1
"3cbcea2be0984e7dbd5a48195af10ce7","78adeee1fa2c4fe0bc73f7bca9fcee86",22850121,1,-8,0,613,165,160,-5
"78adeee1fa2c4fe0bc73f7bca9fcee86","82e6285962b8400d9d6fc32436022a94",22850121,1,10,0,614,160,167,7
"82e6285962b8400d9d6fc32436022a94","a9ac840f098c4bd0a2ee896214ce29cd",22850121,1,3,0,615,167,168,1
"a9ac840f098c4bd0a2ee896214ce29cd","3cbcea2be0984e7dbd5a48195af10ce7",22850121,1,-5,0,616,168,165,-3
"3cbcea2be0984e7dbd5a48195af10ce7","67a089198fcb4e1c8f2385786c2b296f",22850121,1,-160,0,617,165,39,-126
"67a089198fcb4e1c8f2385786c2b296f","b7719e26494940efa49512aedd0aac79",22850121,1,-40,0,618,39,20,-19
"b7719e26494940efa49512aedd0aac79","a49d1bb4328949299686242fd0be5584",22850121,2,2,0,619,20,21,1
"a49d1bb4328949299686242fd0be5584","afbf7250b99d47bea07172749483ca97",22850121,1,10,0,620,21,28,7
"afbf7250b99d47bea07172749483ca97","b7719e26494940efa49512aedd0aac79",22850121,2,-12,0,621,28,20,-8
"b7719e26494940efa49512aedd0aac79","b613861cecf84ffcab01afb23f660475",22850121,2,-32,0,622,20,1,-19
"b613861cecf84ffcab01afb23f660475","b7719e26494940efa49512aedd0aac79",22850121,1,32,0,623,1,20,19
"a49d1bb4328949299686242fd0be5584","d4f45188d3c84a02ba08454e6403a818",22850121,1,3,0,625,21,24,3
"d4f45188d3c84a02ba08454e6403a818","a49d1bb4328949299686242fd0be5584",22850121,1,-3,0,626,24,21,-3
"a49d1bb4328949299686242fd0be5584","d4c3b003e8274e429d2fa688d73fde6d",22850121,1,1,0,627,21,22,1
"d4c3b003e8274e429d2fa688d73fde6d","d4c3b003e8274e429d2fa688d73fde6d",22850121,2,0,1,628,22,22,0
"d4c3b003e8274e429d2fa688d73fde6d","b7719e26494940efa49512aedd0aac79",22850121,2,-3,0,629,22,20,-2
"b613861cecf84ffcab01afb23f660475","0c7262dff33c4087bc660ccf40f92f9c",22850121,1,241,0,631,1,169,168
"0c7262dff33c4087bc660ccf40f92f9c","b2275c3fad834f8d90737a2d9a6927d6",22850121,5,3,0,632,169,172,3
"b2275c3fad834f8d90737a2d9a6927d6","0c7262dff33c4087bc660ccf40f92f9c",22850121,3,-3,0,633,172,169,-3
"0c7262dff33c4087bc660ccf40f92f9c","0c7262dff33c4087bc660ccf40f92f9c",22850121,4,0,1,647,169,169,0
"b2275c3fad834f8d90737a2d9a6927d6","b2275c3fad834f8d90737a2d9a6927d6",22850121,20,0,1,650,172,172,0
"b2275c3fad834f8d90737a2d9a6927d6","eb515a26030b41f8a82a1e6114420bad",22850121,1,1,0,670,172,173,1
"eb515a26030b41f8a82a1e6114420bad","eb515a26030b41f8a82a1e6114420bad",22850121,2,0,1,671,173,173,0
"eb515a26030b41f8a82a1e6114420bad","0c7262dff33c4087bc660ccf40f92f9c",22850121,1,-4,0,673,173,169,-4
"0c7262dff33c4087bc660ccf40f92f9c","b42cc17b7de840f181a704558d0bc845",22850121,5,7,0,676,169,175,6
"b42cc17b7de840f181a704558d0bc845","b42cc17b7de840f181a704558d0bc845",22850121,5,0,1,677,175,175,0
"b42cc17b7de840f181a704558d0bc845","801f9e9135034f49bf5f8b4bdefedb41",22850121,2,2,0,678,175,177,2
"801f9e9135034f49bf5f8b4bdefedb41","801f9e9135034f49bf5f8b4bdefedb41",22850121,13,0,1,679,177,177,0
"801f9e9135034f49bf5f8b4bdefedb41","362fcb0699a14845ab29b2340093e528",22850121,2,-3,0,687,177,174,-3
"362fcb0699a14845ab29b2340093e528","ea38cc0e6e6e41edbabf210220808bf9",22850121,5,6,0,688,174,179,5
"b87c552dd247427abe6ab5795b9c9d43","b42cc17b7de840f181a704558d0bc845",22850121,2,-7,0,690,181,175,-6
"b42cc17b7de840f181a704558d0bc845","139b097acfca451689d80c9c6eebdf7b",22850121,4,4,0,691,175,178,3
"139b097acfca451689d80c9c6eebdf7b","801f9e9135034f49bf5f8b4bdefedb41",22850121,2,-2,0,692,178,177,-1
"801f9e9135034f49bf5f8b4bdefedb41","b87c552dd247427abe6ab5795b9c9d43",22850121,1,5,0,697,177,181,4
"b87c552dd247427abe6ab5795b9c9d43","362fcb0699a14845ab29b2340093e528",22850121,1,-8,0,698,181,174,-7
"ea38cc0e6e6e41edbabf210220808bf9","b42cc17b7de840f181a704558d0bc845",22850121,1,-5,0,700,179,175,-4
"139b097acfca451689d80c9c6eebdf7b","b42cc17b7de840f181a704558d0bc845",22850121,3,-4,0,702,178,175,-3
"b42cc17b7de840f181a704558d0bc845","ea38cc0e6e6e41edbabf210220808bf9",22850121,3,5,0,703,175,179,4
"ea38cc0e6e6e41edbabf210220808bf9","362fcb0699a14845ab29b2340093e528",22850121,3,-6,0,704,179,174,-5
"362fcb0699a14845ab29b2340093e528","b87c552dd247427abe6ab5795b9c9d43",22850121,4,8,0,705,174,181,7
"801f9e9135034f49bf5f8b4bdefedb41","0c7262dff33c4087bc660ccf40f92f9c",22850121,1,-9,0,717,177,169,-8
"139b097acfca451689d80c9c6eebdf7b","ea38cc0e6e6e41edbabf210220808bf9",22850121,1,1,0,723,178,179,1
"ea38cc0e6e6e41edbabf210220808bf9","139b097acfca451689d80c9c6eebdf7b",22850121,1,-1,0,724,179,178,-1
"139b097acfca451689d80c9c6eebdf7b","30f660a1feb34582a739722532524f79",22850121,1,6,0,725,178,183,5
"30f660a1feb34582a739722532524f79","30f660a1feb34582a739722532524f79",22850121,3,0,1,726,183,183,0
"30f660a1feb34582a739722532524f79","2024b4885bd14338a39b7b509acbbd02",22850121,1,-1,0,729,183,182,-1
"2024b4885bd14338a39b7b509acbbd02","362fcb0699a14845ab29b2340093e528",22850121,1,-10,0,730,182,174,-8
"b87c552dd247427abe6ab5795b9c9d43","139b097acfca451689d80c9c6eebdf7b",22850121,3,-3,0,733,181,178,-3
"b87c552dd247427abe6ab5795b9c9d43","ea38cc0e6e6e41edbabf210220808bf9",22850121,1,-2,0,738,181,179,-2
"ea38cc0e6e6e41edbabf210220808bf9","0c7262dff33c4087bc660ccf40f92f9c",22850121,1,-12,0,739,179,169,-10
"b2275c3fad834f8d90737a2d9a6927d6","b42cc17b7de840f181a704558d0bc845",22850121,1,4,0,741,172,175,3
"b42cc17b7de840f181a704558d0bc845","0c7262dff33c4087bc660ccf40f92f9c",22850121,1,-7,0,742,175,169,-6
"b42cc17b7de840f181a704558d0bc845","c3f63fe50d8e487c86bf8ef76c9cadd3",22850121,1,13,0,744,175,185,10
"c3f63fe50d8e487c86bf8ef76c9cadd3","c3f63fe50d8e487c86bf8ef76c9cadd3",22850121,1,0,1,745,185,185,0
"c3f63fe50d8e487c86bf8ef76c9cadd3","0c7262dff33c4087bc660ccf40f92f9c",22850121,1,-20,0,746,185,169,-16
"0c7262dff33c4087bc660ccf40f92f9c","c8e371568a0c4391b25796ae4e91952e",22850121,2,23,0,747,169,186,17
"c8e371568a0c4391b25796ae4e91952e","0c7262dff33c4087bc660ccf40f92f9c",22850121,1,-23,0,748,186,169,-17
"0c7262dff33c4087bc660ccf40f92f9c","362fcb0699a14845ab29b2340093e528",22850121,2,6,0,749,169,174,5
"139b097acfca451689d80c9c6eebdf7b","0c7262dff33c4087bc660ccf40f92f9c",22850121,1,-11,0,753,178,169,-9
"362fcb0699a14845ab29b2340093e528","b42cc17b7de840f181a704558d0bc845",22850121,1,1,0,756,174,175,1
"b42cc17b7de840f181a704558d0bc845","362fcb0699a14845ab29b2340093e528",22850121,1,-1,0,757,175,174,-1
"b87c552dd247427abe6ab5795b9c9d43","b87c552dd247427abe6ab5795b9c9d43",22850121,8,0,1,760,181,181,0
"b42cc17b7de840f181a704558d0bc845","2024b4885bd14338a39b7b509acbbd02",22850121,1,9,0,770,175,182,7
"2024b4885bd14338a39b7b509acbbd02","0c7262dff33c4087bc660ccf40f92f9c",22850121,1,-16,0,771,182,169,-13
"c8e371568a0c4391b25796ae4e91952e","7d932b23e1c84326ae5aa4d3c0d813d1",22850121,1,2,0,779,186,188,2
"7d932b23e1c84326ae5aa4d3c0d813d1","7d932b23e1c84326ae5aa4d3c0d813d1",22850121,1,0,1,780,188,188,0
"7d932b23e1c84326ae5aa4d3c0d813d1","c8e371568a0c4391b25796ae4e91952e",22850121,1,-2,0,781,188,186,-2
"c8e371568a0c4391b25796ae4e91952e","ab11d94c6c8948ea90b88f19d2cd502b",22850121,2,5,0,782,186,190,4
"ab11d94c6c8948ea90b88f19d2cd502b","ab11d94c6c8948ea90b88f19d2cd502b",22850121,3,0,1,783,190,190,0
"ab11d94c6c8948ea90b88f19d2cd502b","f992451ed6ad4e68bb9e68ad6be7c4be",22850121,2,2,0,784,190,192,2
"f992451ed6ad4e68bb9e68ad6be7c4be","f992451ed6ad4e68bb9e68ad6be7c4be",22850121,4,0,1,785,192,192,0
"f992451ed6ad4e68bb9e68ad6be7c4be","07b44a7a51e94c78b411c753fc39dab0",22850121,1,-3,0,786,192,189,-3
"07b44a7a51e94c78b411c753fc39dab0","6cd2dcaac46847d4a0bc53f296d90375",22850121,2,6,0,787,189,194,5
"6cd2dcaac46847d4a0bc53f296d90375","017d7ca8e0394b91aaadc9574df2202c",22850121,1,-1,0,788,194,193,-1
"017d7ca8e0394b91aaadc9574df2202c","ab11d94c6c8948ea90b88f19d2cd502b",22850121,3,-4,0,789,193,190,-3
"f992451ed6ad4e68bb9e68ad6be7c4be","6cd2dcaac46847d4a0bc53f296d90375",22850121,1,3,0,794,192,194,2
"6cd2dcaac46847d4a0bc53f296d90375","07b44a7a51e94c78b411c753fc39dab0",22850121,3,-6,0,795,194,189,-5
"07b44a7a51e94c78b411c753fc39dab0","017d7ca8e0394b91aaadc9574df2202c",22850121,2,5,0,796,189,193,4
"ab11d94c6c8948ea90b88f19d2cd502b","6cd2dcaac46847d4a0bc53f296d90375",22850121,2,5,0,799,190,194,4
"07b44a7a51e94c78b411c753fc39dab0","0c7262dff33c4087bc660ccf40f92f9c",22850121,1,-27,0,801,189,169,-20
"0c7262dff33c4087bc660ccf40f92f9c","07b44a7a51e94c78b411c753fc39dab0",22850121,1,27,0,809,169,189,20
"07b44a7a51e94c78b411c753fc39dab0","c8e371568a0c4391b25796ae4e91952e",22850121,1,-4,0,810,189,186,-3
"ab11d94c6c8948ea90b88f19d2cd502b","07b44a7a51e94c78b411c753fc39dab0",22850121,1,-1,0,813,190,189,-1
"6cd2dcaac46847d4a0bc53f296d90375","6cd2dcaac46847d4a0bc53f296d90375",22850121,1,0,1,815,194,194,0
"6cd2dcaac46847d4a0bc53f296d90375","2d2580c9411c4972909db508d6956a58",22850121,1,2,0,816,194,196,2
"2d2580c9411c4972909db508d6956a58","2d2580c9411c4972909db508d6956a58",22850121,8,0,1,817,196,196,0
"2d2580c9411c4972909db508d6956a58","5bddb3d9ed264f3984702f048c7e5340",22850121,1,1,0,825,196,197,1
"5bddb3d9ed264f3984702f048c7e5340","5bddb3d9ed264f3984702f048c7e5340",22850121,8,0,1,826,197,197,0
"5bddb3d9ed264f3984702f048c7e5340","d5e8e2bd12a2466b9d6d90855f0eb079",22850121,1,1,0,834,197,198,1
"d5e8e2bd12a2466b9d6d90855f0eb079","d5e8e2bd12a2466b9d6d90855f0eb079",22850121,11,0,1,835,198,198,0
"d5e8e2bd12a2466b9d6d90855f0eb079","017d7ca8e0394b91aaadc9574df2202c",22850121,1,-5,0,846,198,193,-5
"ab11d94c6c8948ea90b88f19d2cd502b","f9170dd6bc6442b4acd832747609b09a",22850121,1,11,0,848,190,199,9
"f9170dd6bc6442b4acd832747609b09a","ab11d94c6c8948ea90b88f19d2cd502b",22850121,1,-11,0,849,199,190,-9
"017d7ca8e0394b91aaadc9574df2202c","54e8e9f0ea3e45c4bf3b8ac799ee31b1",22850121,1,8,0,853,193,200,7
"54e8e9f0ea3e45c4bf3b8ac799ee31b1","54e8e9f0ea3e45c4bf3b8ac799ee31b1",22850121,5,0,1,854,200,200,0
"54e8e9f0ea3e45c4bf3b8ac799ee31b1","c614a00911be4877a075f19315530fb0",22850121,1,1,0,859,200,201,1
"c614a00911be4877a075f19315530fb0","c614a00911be4877a075f19315530fb0",22850121,58,0,1,860,201,201,0
"c614a00911be4877a075f19315530fb0","a6c21bd8b95249c7972820a7a7d76aff",22850121,1,1,0,918,201,202,1
"a6c21bd8b95249c7972820a7a7d76aff","a6c21bd8b95249c7972820a7a7d76aff",22850121,1,0,1,919,202,202,0
"a6c21bd8b95249c7972820a7a7d76aff","bb329d880ab54120adaf203a693bb203",22850121,1,1,0,920,202,203,1
"bb329d880ab54120adaf203a693bb203","bb329d880ab54120adaf203a693bb203",22850121,1,0,1,921,203,203,0
"bb329d880ab54120adaf203a693bb203","f9170dd6bc6442b4acd832747609b09a",22850121,1,-4,0,922,203,199,-4
"f9170dd6bc6442b4acd832747609b09a","334c2344009840079b1d0e1b7ce3d5a7",22850121,1,7,0,923,199,205,6
"334c2344009840079b1d0e1b7ce3d5a7","334c2344009840079b1d0e1b7ce3d5a7",22850121,1,0,1,924,205,205,0
"334c2344009840079b1d0e1b7ce3d5a7","c8e371568a0c4391b25796ae4e91952e",22850121,1,-23,0,925,205,186,-19
"c8e371568a0c4391b25796ae4e91952e","d7f13c8d63ec4e2aa673fbb9cf9c6933",22850121,1,26,0,926,186,206,20
"0c7262dff33c4087bc660ccf40f92f9c","b9e80f77c3a44349863b19875725c384",22850121,1,50,0,928,169,207,38
"b9e80f77c3a44349863b19875725c384","7108f0e4c2584f1f9c471689ae4c885c",22850121,2,1,0,929,207,208,1
"7108f0e4c2584f1f9c471689ae4c885c","d7f13c8d63ec4e2aa673fbb9cf9c6933",22850121,1,-2,0,930,208,206,-2
"d7f13c8d63ec4e2aa673fbb9cf9c6933","d7f13c8d63ec4e2aa673fbb9cf9c6933",22850121,2,0,1,931,206,206,0
"d7f13c8d63ec4e2aa673fbb9cf9c6933","7108f0e4c2584f1f9c471689ae4c885c",22850121,2,2,0,932,206,208,2
"7108f0e4c2584f1f9c471689ae4c885c","b9e80f77c3a44349863b19875725c384",22850121,2,-1,0,933,208,207,-1
"b9e80f77c3a44349863b19875725c384","09400e101c5d4b439cf9a26b03aae558",22850121,1,4,0,934,207,210,3
"09400e101c5d4b439cf9a26b03aae558","d7f13c8d63ec4e2aa673fbb9cf9c6933",22850121,2,-5,0,935,210,206,-4
"d7f13c8d63ec4e2aa673fbb9cf9c6933","09400e101c5d4b439cf9a26b03aae558",22850121,1,5,0,936,206,210,4
"09400e101c5d4b439cf9a26b03aae558","a88efa7e50ce47159810ab553afa6d3a",22850121,1,2,0,937,210,212,2
"a88efa7e50ce47159810ab553afa6d3a","a88efa7e50ce47159810ab553afa6d3a",22850121,20,0,1,938,212,212,0
"a88efa7e50ce47159810ab553afa6d3a","a875096404ef4a9984b62d74cda916f9",22850121,1,-3,0,941,212,209,-3
"be502a7a43c44bf7b682698de79d9369","0c7262dff33c4087bc660ccf40f92f9c",22850121,1,-59,0,944,214,169,-45
"b87c552dd247427abe6ab5795b9c9d43","d7f13c8d63ec4e2aa673fbb9cf9c6933",22850121,1,35,0,947,181,206,25
"b9e80f77c3a44349863b19875725c384","b9e80f77c3a44349863b19875725c384",22850121,14,0,1,951,207,207,0
"7108f0e4c2584f1f9c471689ae4c885c","7108f0e4c2584f1f9c471689ae4c885c",22850121,12,0,1,966,208,208,0
"7108f0e4c2584f1f9c471689ae4c885c","09400e101c5d4b439cf9a26b03aae558",22850121,1,3,0,978,208,210,2
"d7f13c8d63ec4e2aa673fbb9cf9c6933","a88efa7e50ce47159810ab553afa6d3a",22850121,1,7,0,980,206,212,6
"a88efa7e50ce47159810ab553afa6d3a","be502a7a43c44bf7b682698de79d9369",22850121,1,3,0,998,212,214,2
"a875096404ef4a9984b62d74cda916f9","f7fb1952f56b4189b86a9f8b7862d2b8",22850121,3,7,0,1000,209,215,6
"f7fb1952f56b4189b86a9f8b7862d2b8","09400e101c5d4b439cf9a26b03aae558",22850121,1,-6,0,1001,215,210,-5
"09400e101c5d4b439cf9a26b03aae558","ec341f459285443b8361f7f15638ff08",22850121,1,4,0,1002,210,213,3
"ec341f459285443b8361f7f15638ff08","09400e101c5d4b439cf9a26b03aae558",22850121,1,-4,0,1003,213,210,-3
"09400e101c5d4b439cf9a26b03aae558","be502a7a43c44bf7b682698de79d9369",22850121,1,5,0,1004,210,214,4
"be502a7a43c44bf7b682698de79d9369","a875096404ef4a9984b62d74cda916f9",22850121,2,-6,0,1005,214,209,-5
"f7fb1952f56b4189b86a9f8b7862d2b8","be502a7a43c44bf7b682698de79d9369",22850121,2,-1,0,1007,215,214,-1
"be502a7a43c44bf7b682698de79d9369","f7fb1952f56b4189b86a9f8b7862d2b8",22850121,1,1,0,1008,214,215,1
"f7fb1952f56b4189b86a9f8b7862d2b8","f7fb1952f56b4189b86a9f8b7862d2b8",22850121,15,0,1,1009,215,215,0
"f7fb1952f56b4189b86a9f8b7862d2b8","b860ee85d8bc4a2f97958cfb71be3533",22850121,1,1,0,1024,215,216,1
"b860ee85d8bc4a2f97958cfb71be3533","b860ee85d8bc4a2f97958cfb71be3533",22850121,2,0,1,1025,216,216,0
"b860ee85d8bc4a2f97958cfb71be3533","ec341f459285443b8361f7f15638ff08",22850121,1,-3,0,1027,216,213,-3
"ec341f459285443b8361f7f15638ff08","363837c182e04711840d896ae1e0339c",22850121,1,6,0,1028,213,218,5
"363837c182e04711840d896ae1e0339c","363837c182e04711840d896ae1e0339c",22850121,14,0,1,1029,218,218,0
"363837c182e04711840d896ae1e0339c","01b2051f8941460d89945e3b02d1ce78",22850121,1,-1,0,1043,218,217,-1
"01b2051f8941460d89945e3b02d1ce78","91125ca626c5470eb145501f8c37f8db",22850121,1,4,0,1044,217,220,3
"91125ca626c5470eb145501f8c37f8db","91125ca626c5470eb145501f8c37f8db",22850121,5,0,1,1045,220,220,0
"91125ca626c5470eb145501f8c37f8db","d7f13c8d63ec4e2aa673fbb9cf9c6933",22850121,1,-18,0,1046,220,206,-14
"d7f13c8d63ec4e2aa673fbb9cf9c6933","1c6721b1f63f4d30ba7746ea8af02a52",22850121,2,21,0,1047,206,221,15
"1c6721b1f63f4d30ba7746ea8af02a52","77ecef8eff6b4a2caea7707669bf7475",22850121,5,1,0,1048,221,222,1
"77ecef8eff6b4a2caea7707669bf7475","0c7262dff33c4087bc660ccf40f92f9c",22850121,1,-71,0,1049,222,169,-53
"0c7262dff33c4087bc660ccf40f92f9c","be95c065e45447c1bd8215ea6f130c7a",22850121,1,66,0,1050,169,219,50
"be95c065e45447c1bd8215ea6f130c7a","d7f13c8d63ec4e2aa673fbb9cf9c6933",22850121,1,-17,0,1051,219,206,-13
"d7f13c8d63ec4e2aa673fbb9cf9c6933","91125ca626c5470eb145501f8c37f8db",22850121,1,18,0,1052,206,220,14
"91125ca626c5470eb145501f8c37f8db","1c6721b1f63f4d30ba7746ea8af02a52",22850121,1,3,0,1057,220,221,1
"1c6721b1f63f4d30ba7746ea8af02a52","d7f13c8d63ec4e2aa673fbb9cf9c6933",22850121,2,-21,0,1058,221,206,-15
"d7f13c8d63ec4e2aa673fbb9cf9c6933","77ecef8eff6b4a2caea7707669bf7475",22850121,2,22,0,1059,206,222,16
"77ecef8eff6b4a2caea7707669bf7475","d7f13c8d63ec4e2aa673fbb9cf9c6933",22850121,2,-22,0,1060,222,206,-16
"1c6721b1f63f4d30ba7746ea8af02a52","1c6721b1f63f4d30ba7746ea8af02a52",22850121,2,0,1,1062,221,221,0
"77ecef8eff6b4a2caea7707669bf7475","1c6721b1f63f4d30ba7746ea8af02a52",22850121,6,-1,0,1064,222,221,-1
"1c6721b1f63f4d30ba7746ea8af02a52","d03cb855c70044cf8c35d9ec0de696e3",22850121,5,4,0,1068,221,224,3
"d03cb855c70044cf8c35d9ec0de696e3","8b9ae98743bd4d4a8a87dff1c1244211",22850121,4,3,0,1069,224,227,3
"8b9ae98743bd4d4a8a87dff1c1244211","1c6721b1f63f4d30ba7746ea8af02a52",22850121,2,-7,0,1070,227,221,-6
"1c6721b1f63f4d30ba7746ea8af02a52","f7906d6f59b9489a91d2ef40db5a474d",22850121,1,3,0,1071,221,223,2
"f7906d6f59b9489a91d2ef40db5a474d","77ecef8eff6b4a2caea7707669bf7475",22850121,3,-2,0,1072,223,222,-1
"d7f13c8d63ec4e2aa673fbb9cf9c6933","0c7262dff33c4087bc660ccf40f92f9c",22850121,2,-49,0,1074,206,169,-37
"0c7262dff33c4087bc660ccf40f92f9c","1c6721b1f63f4d30ba7746ea8af02a52",22850121,2,70,0,1075,169,221,52
"77ecef8eff6b4a2caea7707669bf7475","77ecef8eff6b4a2caea7707669bf7475",22850121,12,0,1,1077,222,222,0
"8b9ae98743bd4d4a8a87dff1c1244211","f7906d6f59b9489a91d2ef40db5a474d",22850121,3,-4,0,1092,227,223,-4
"8b9ae98743bd4d4a8a87dff1c1244211","d03cb855c70044cf8c35d9ec0de696e3",22850121,1,-3,0,1097,227,224,-3
"d03cb855c70044cf8c35d9ec0de696e3","d03cb855c70044cf8c35d9ec0de696e3",22850121,1,0,1,1098,224,224,0
"d03cb855c70044cf8c35d9ec0de696e3","a49a937d6896486d9a5396654abcf2e1",22850121,1,2,0,1099,224,226,2
"a49a937d6896486d9a5396654abcf2e1","a49a937d6896486d9a5396654abcf2e1",22850121,3,0,1,1100,226,226,0
"a49a937d6896486d9a5396654abcf2e1","8b9ae98743bd4d4a8a87dff1c1244211",22850121,1,1,0,1103,226,227,1
"8b9ae98743bd4d4a8a87dff1c1244211","8b9ae98743bd4d4a8a87dff1c1244211",22850121,29,0,1,1104,227,227,0
"f7906d6f59b9489a91d2ef40db5a474d","2ab1535aac1346ba8801535bf729ef37",22850121,2,7,0,1134,223,229,6
"2ab1535aac1346ba8801535bf729ef37","5152833676bf4c6cb317060be10f68db",22850121,1,-1,0,1135,229,228,-1
"5152833676bf4c6cb317060be10f68db","77ecef8eff6b4a2caea7707669bf7475",22850121,1,-8,0,1136,228,222,-6
"2ab1535aac1346ba8801535bf729ef37","0c7262dff33c4087bc660ccf40f92f9c",22850121,1,-80,0,1142,229,169,-60
"0c7262dff33c4087bc660ccf40f92f9c","ea38cc0e6e6e41edbabf210220808bf9",22850121,6,12,0,1143,169,179,10
"ea38cc0e6e6e41edbabf210220808bf9","b87c552dd247427abe6ab5795b9c9d43",22850121,10,2,0,1144,179,181,2
"b87c552dd247427abe6ab5795b9c9d43","0c7262dff33c4087bc660ccf40f92f9c",22850121,5,-14,0,1145,181,169,-12
"d03cb855c70044cf8c35d9ec0de696e3","f7906d6f59b9489a91d2ef40db5a474d",22850121,1,-1,0,1151,224,223,-1
"77ecef8eff6b4a2caea7707669bf7475","8b9ae98743bd4d4a8a87dff1c1244211",22850121,1,6,0,1153,222,227,5
"77ecef8eff6b4a2caea7707669bf7475","d03cb855c70044cf8c35d9ec0de696e3",22850121,1,3,0,1156,222,224,2
"d03cb855c70044cf8c35d9ec0de696e3","1c6721b1f63f4d30ba7746ea8af02a52",22850121,1,-4,0,1157,224,221,-3
"1c6721b1f63f4d30ba7746ea8af02a52","8b9ae98743bd4d4a8a87dff1c1244211",22850121,1,7,0,1158,221,227,6
"8b9ae98743bd4d4a8a87dff1c1244211","2ab1535aac1346ba8801535bf729ef37",22850121,1,3,0,1159,227,229,2
"2ab1535aac1346ba8801535bf729ef37","f7906d6f59b9489a91d2ef40db5a474d",22850121,1,-7,0,1160,229,223,-6
"f7906d6f59b9489a91d2ef40db5a474d","a4f40fb48a8542c8949bae1f002cd9bc",22850121,1,9,0,1161,223,231,8
"a4f40fb48a8542c8949bae1f002cd9bc","a4f40fb48a8542c8949bae1f002cd9bc",22850121,7,0,1,1162,231,231,0
"a4f40fb48a8542c8949bae1f002cd9bc","8972c23e32044edb8a78fa1eed4e5947",22850121,2,1,0,1164,231,232,1
"8972c23e32044edb8a78fa1eed4e5947","8972c23e32044edb8a78fa1eed4e5947",22850121,4,0,1,1165,232,232,0
"8972c23e32044edb8a78fa1eed4e5947","92feb4a40f8344d38b6f722e42a53295",22850121,2,1,0,1166,232,233,1
"92feb4a40f8344d38b6f722e42a53295","92feb4a40f8344d38b6f722e42a53295",22850121,7,0,1,1167,233,233,0
"92feb4a40f8344d38b6f722e42a53295","5152833676bf4c6cb317060be10f68db",22850121,2,-5,0,1169,233,228,-5
"5152833676bf4c6cb317060be10f68db","2ab1535aac1346ba8801535bf729ef37",22850121,1,1,0,1170,228,229,1
"2ab1535aac1346ba8801535bf729ef37","0b04c8e2f86d48c7aeb7e225819cd32b",22850121,1,6,0,1171,229,234,5
"0b04c8e2f86d48c7aeb7e225819cd32b","2ab1535aac1346ba8801535bf729ef37",22850121,1,-6,0,1172,234,229,-5
"2ab1535aac1346ba8801535bf729ef37","a4f40fb48a8542c8949bae1f002cd9bc",22850121,1,2,0,1173,229,231,2
"5152833676bf4c6cb317060be10f68db","ca3e28f290354c08aefe5b0f769604e6",22850121,1,8,0,1190,228,235,7
"ca3e28f290354c08aefe5b0f769604e6","ca3e28f290354c08aefe5b0f769604e6",22850121,14,0,1,1191,235,235,0
"ca3e28f290354c08aefe5b0f769604e6","79a35eea833e4c2c9d22fc53c3c6445c",22850121,1,1,0,1205,235,236,1
"79a35eea833e4c2c9d22fc53c3c6445c","79a35eea833e4c2c9d22fc53c3c6445c",22850121,14,0,1,1206,236,236,0
"79a35eea833e4c2c9d22fc53c3c6445c","8f68228b1518449e9615cdafee41a2bd",22850121,1,1,0,1220,236,237,1
"8f68228b1518449e9615cdafee41a2bd","8f68228b1518449e9615cdafee41a2bd",22850121,3,0,1,1221,237,237,0
"8f68228b1518449e9615cdafee41a2bd","cab89fa5c3ed45a5aa550fc0352d6a42",22850121,1,1,0,1224,237,238,1
"cab89fa5c3ed45a5aa550fc0352d6a42","cab89fa5c3ed45a5aa550fc0352d6a42",22850121,5,0,1,1225,238,238,0
"cab89fa5c3ed45a5aa550fc0352d6a42","66d4fad4f1cf4b46be0750a99ad7a35a",22850121,1,1,0,1230,238,239,1
"66d4fad4f1cf4b46be0750a99ad7a35a","66d4fad4f1cf4b46be0750a99ad7a35a",22850121,3,0,1,1231,239,239,0
"66d4fad4f1cf4b46be0750a99ad7a35a","0b04c8e2f86d48c7aeb7e225819cd32b",22850121,1,-5,0,1234,239,234,-5
"0b04c8e2f86d48c7aeb7e225819cd32b","f53da5fd9bfe412da4b80d4742563b6c",22850121,1,8,0,1235,234,241,7
"f53da5fd9bfe412da4b80d4742563b6c","f53da5fd9bfe412da4b80d4742563b6c",22850121,1,0,1,1236,241,241,0
"f53da5fd9bfe412da4b80d4742563b6c","2ae94c0cea4d480a9d5dca8fb1d7b542",22850121,1,3,0,1237,241,242,1
"2ae94c0cea4d480a9d5dca8fb1d7b542","1c6721b1f63f4d30ba7746ea8af02a52",22850121,1,-27,0,1238,242,221,-21
"1c6721b1f63f4d30ba7746ea8af02a52","1ebf23f9d994469a85206e4c7b1bf5f5",22850121,1,30,0,1239,221,245,24
"1ebf23f9d994469a85206e4c7b1bf5f5","0c7262dff33c4087bc660ccf40f92f9c",22850121,1,-100,0,1240,245,169,-76
"0c7262dff33c4087bc660ccf40f92f9c","0d987bed3ffa4ed0b9a2e62e97b7b30f",22850121,5,135,0,1241,169,272,103
"0d987bed3ffa4ed0b9a2e62e97b7b30f","0d987bed3ffa4ed0b9a2e62e97b7b30f",22850121,11,0,1,1242,272,272,0
"0d987bed3ffa4ed0b9a2e62e97b7b30f","82ae07bc0c9b4570a41799290d1ef399",22850121,3,4,0,1244,272,275,3
"82ae07bc0c9b4570a41799290d1ef399","bb5a47f5ea01454a8b79455422d3b9da",22850121,6,6,0,1245,275,280,5
"bb5a47f5ea01454a8b79455422d3b9da","bb5a47f5ea01454a8b79455422d3b9da",22850121,82,0,1,1246,280,280,0
"bb5a47f5ea01454a8b79455422d3b9da","0c7262dff33c4087bc660ccf40f92f9c",22850121,2,-145,0,1253,280,169,-111
"0c7262dff33c4087bc660ccf40f92f9c","2ae94c0cea4d480a9d5dca8fb1d7b542",22850121,2,97,0,1254,169,242,73
"2ae94c0cea4d480a9d5dca8fb1d7b542","2ae94c0cea4d480a9d5dca8fb1d7b542",22850121,2,0,1,1255,242,242,0
"2ae94c0cea4d480a9d5dca8fb1d7b542","1ebf23f9d994469a85206e4c7b1bf5f5",22850121,2,3,0,1256,242,245,3
"1ebf23f9d994469a85206e4c7b1bf5f5","1ebf23f9d994469a85206e4c7b1bf5f5",22850121,10,0,1,1257,245,245,0
"1ebf23f9d994469a85206e4c7b1bf5f5","85ae675b83e8422da842cfd25596af99",22850121,1,1,0,1267,245,246,1
"85ae675b83e8422da842cfd25596af99","85ae675b83e8422da842cfd25596af99",22850121,5,0,1,1268,246,246,0
"85ae675b83e8422da842cfd25596af99","fa235f0f364d47e4ae1c87f47bf8e6ba",22850121,1,8,0,1273,246,252,6
"fa235f0f364d47e4ae1c87f47bf8e6ba","2ae94c0cea4d480a9d5dca8fb1d7b542",22850121,2,-12,0,1274,252,242,-10
"2ae94c0cea4d480a9d5dca8fb1d7b542","fa235f0f364d47e4ae1c87f47bf8e6ba",22850121,2,12,0,1275,242,252,10
"fa235f0f364d47e4ae1c87f47bf8e6ba","79f7845465cc4ed19d8e4f1429541be0",22850121,1,2,0,1276,252,254,2
"79f7845465cc4ed19d8e4f1429541be0","79f7845465cc4ed19d8e4f1429541be0",22850121,8,0,1,1277,254,254,0
"79f7845465cc4ed19d8e4f1429541be0","fa235f0f364d47e4ae1c87f47bf8e6ba",22850121,1,-2,0,1285,254,252,-2
"fa235f0f364d47e4ae1c87f47bf8e6ba","00f61990949545828dd12f1303d47504",22850121,1,5,0,1286,252,256,4
"00f61990949545828dd12f1303d47504","6e83e23f56544a19b94067c1c558d9c0",22850121,1,-11,0,1287,256,247,-9
"6e83e23f56544a19b94067c1c558d9c0","d546341988904f069cfa86b21457d9d9",22850121,1,5,0,1288,247,251,4
"d546341988904f069cfa86b21457d9d9","1ebf23f9d994469a85206e4c7b1bf5f5",22850121,1,-8,0,1289,251,245,-6
"1ebf23f9d994469a85206e4c7b1bf5f5","2ae94c0cea4d480a9d5dca8fb1d7b542",22850121,2,-3,0,1290,245,242,-3
"fa235f0f364d47e4ae1c87f47bf8e6ba","6e83e23f56544a19b94067c1c558d9c0",22850121,1,-6,0,1294,252,247,-5
"6e83e23f56544a19b94067c1c558d9c0","00f61990949545828dd12f1303d47504",22850121,2,11,0,1295,247,256,9
"00f61990949545828dd12f1303d47504","0c7262dff33c4087bc660ccf40f92f9c",22850121,2,-114,0,1296,256,169,-87
"2ae94c0cea4d480a9d5dca8fb1d7b542","d989ebcfc12a4b669f0100dc1aa14f1e",22850121,1,16,0,1298,242,255,13
"d989ebcfc12a4b669f0100dc1aa14f1e","2ae94c0cea4d480a9d5dca8fb1d7b542",22850121,1,-16,0,1299,255,242,-13
"2ae94c0cea4d480a9d5dca8fb1d7b542","00f61990949545828dd12f1303d47504",22850121,1,17,0,1300,242,256,14
"00f61990949545828dd12f1303d47504","d989ebcfc12a4b669f0100dc1aa14f1e",22850121,1,-1,0,1301,256,255,-1
"d989ebcfc12a4b669f0100dc1aa14f1e","1ebf23f9d994469a85206e4c7b1bf5f5",22850121,1,-13,0,1302,255,245,-10
"1ebf23f9d994469a85206e4c7b1bf5f5","00f61990949545828dd12f1303d47504",22850121,1,14,0,1303,245,256,11
"00f61990949545828dd12f1303d47504","ead7bb4b64e247d2ae632ab8a296b091",22850121,1,2,0,1304,256,258,2
"ead7bb4b64e247d2ae632ab8a296b091","ead7bb4b64e247d2ae632ab8a296b091",22850121,10,0,1,1305,258,258,0
"ead7bb4b64e247d2ae632ab8a296b091","41b0048dde734bb280bac6116baa8e27",22850121,1,1,0,1307,258,259,1
"41b0048dde734bb280bac6116baa8e27","41b0048dde734bb280bac6116baa8e27",22850121,8,0,1,1308,259,259,0
"41b0048dde734bb280bac6116baa8e27","ead7bb4b64e247d2ae632ab8a296b091",22850121,1,-1,0,1316,259,258,-1
"ead7bb4b64e247d2ae632ab8a296b091","b41c5a094a604ee0915327da5cc0beb7",22850121,1,2,0,1325,258,260,2
"b41c5a094a604ee0915327da5cc0beb7","b41c5a094a604ee0915327da5cc0beb7",22850121,8,0,1,1326,260,260,0
"b41c5a094a604ee0915327da5cc0beb7","d546341988904f069cfa86b21457d9d9",22850121,1,-10,0,1334,260,251,-9
"d546341988904f069cfa86b21457d9d9","fa235f0f364d47e4ae1c87f47bf8e6ba",22850121,1,1,0,1335,251,252,1
"2ae94c0cea4d480a9d5dca8fb1d7b542","28c171777c52431ab6b925073bd63d46",22850121,1,26,0,1338,242,264,22
"28c171777c52431ab6b925073bd63d46","28c171777c52431ab6b925073bd63d46",22850121,11,0,1,1339,264,264,0
"28c171777c52431ab6b925073bd63d46","ac160db940cb49ae8579162b1d52bb5d",22850121,1,2,0,1350,264,266,2
"ac160db940cb49ae8579162b1d52bb5d","ac160db940cb49ae8579162b1d52bb5d",22850121,15,0,1,1351,266,266,0
"ac160db940cb49ae8579162b1d52bb5d","d989ebcfc12a4b669f0100dc1aa14f1e",22850121,1,-12,0,1366,266,255,-11
"d989ebcfc12a4b669f0100dc1aa14f1e","c6fd49b485cc4874b0bbdd9c6171e09c",22850121,1,15,0,1367,255,268,13
"c6fd49b485cc4874b0bbdd9c6171e09c","c6fd49b485cc4874b0bbdd9c6171e09c",22850121,11,0,1,1368,268,268,0
"c6fd49b485cc4874b0bbdd9c6171e09c","44240778a97c4af0937817499b75707b",22850121,1,1,0,1379,268,269,1
"44240778a97c4af0937817499b75707b","44240778a97c4af0937817499b75707b",22850121,8,0,1,1380,269,269,0
"44240778a97c4af0937817499b75707b","7aa76d3e993840d8805f097cbdbcd44b",22850121,1,-9,0,1388,269,261,-8
"7aa76d3e993840d8805f097cbdbcd44b","865a4d3b43374da7944dc7d397f566d9",22850121,1,12,0,1389,261,271,10
"865a4d3b43374da7944dc7d397f566d9","865a4d3b43374da7944dc7d397f566d9",22850121,1,0,1,1390,271,271,0
"865a4d3b43374da7944dc7d397f566d9","2ae94c0cea4d480a9d5dca8fb1d7b542",22850121,1,-35,0,1391,271,242,-29
"2ae94c0cea4d480a9d5dca8fb1d7b542","0d987bed3ffa4ed0b9a2e62e97b7b30f",22850121,1,38,0,1392,242,272,30
"0d987bed3ffa4ed0b9a2e62e97b7b30f","0c7262dff33c4087bc660ccf40f92f9c",22850121,1,-135,0,1393,272,169,-103
"0c7262dff33c4087bc660ccf40f92f9c","94cecc3f1e7d484b8e068e79241dfd73",22850121,1,148,0,1394,169,281,112
"94cecc3f1e7d484b8e068e79241dfd73","94cecc3f1e7d484b8e068e79241dfd73",22850121,1,0,1,1395,281,281,0
"94cecc3f1e7d484b8e068e79241dfd73","a37477c4e4c14169ad44b06b493007f6",22850121,2,2,0,1396,281,283,2
"a37477c4e4c14169ad44b06b493007f6","0c7262dff33c4087bc660ccf40f92f9c",22850121,3,-150,0,1397,283,169,-114
"0d987bed3ffa4ed0b9a2e62e97b7b30f","bb5a47f5ea01454a8b79455422d3b9da",22850121,2,10,0,1401,272,280,8
"bb5a47f5ea01454a8b79455422d3b9da","82ae07bc0c9b4570a41799290d1ef399",22850121,3,-6,0,1407,280,275,-5
"bb5a47f5ea01454a8b79455422d3b9da","bc5524e78a8544e2ae2fdc2f3462bbec",22850121,1,-1,0,1460,280,279,-1
"bc5524e78a8544e2ae2fdc2f3462bbec","0c7262dff33c4087bc660ccf40f92f9c",22850121,1,-144,0,1461,279,169,-110
"bb5a47f5ea01454a8b79455422d3b9da","94cecc3f1e7d484b8e068e79241dfd73",22850121,1,3,0,1473,280,281,1
"94cecc3f1e7d484b8e068e79241dfd73","0d987bed3ffa4ed0b9a2e62e97b7b30f",22850121,1,-13,0,1474,281,272,-9
"0d987bed3ffa4ed0b9a2e62e97b7b30f","a37477c4e4c14169ad44b06b493007f6",22850121,1,15,0,1475,272,283,11
"bb5a47f5ea01454a8b79455422d3b9da","0d987bed3ffa4ed0b9a2e62e97b7b30f",22850121,1,-10,0,1492,280,272,-8
"0d987bed3ffa4ed0b9a2e62e97b7b30f","94cecc3f1e7d484b8e068e79241dfd73",22850121,1,13,0,1493,272,281,9
"0c7262dff33c4087bc660ccf40f92f9c","fab84b4fab5940efb4ea868ef8d09396",22850121,1,153,0,1496,169,284,115
"fab84b4fab5940efb4ea868ef8d09396","4a29443515bb404cb8924e1c60a63b73",22850121,1,4,0,1497,284,285,1
"4a29443515bb404cb8924e1c60a63b73","4a29443515bb404cb8924e1c60a63b73",22850121,1,0,1,1498,285,285,0
"4a29443515bb404cb8924e1c60a63b73","208c9b2796c944db8dacaa96082520ea",22850121,1,3,0,1499,285,288,3
"208c9b2796c944db8dacaa96082520ea","208c9b2796c944db8dacaa96082520ea",22850121,1,0,1,1500,288,288,0
"208c9b2796c944db8dacaa96082520ea","4a29443515bb404cb8924e1c60a63b73",22850121,1,-3,0,1501,288,285,-3
"4a29443515bb404cb8924e1c60a63b73","7669a956527947d0add87455277e80b4",22850121,1,7,0,1502,285,291,6
"7669a956527947d0add87455277e80b4","7669a956527947d0add87455277e80b4",22850121,2,0,1,1503,291,291,0
"7669a956527947d0add87455277e80b4","6a9a3b5bde4a48daa896fe8c06eca56f",22850121,1,-2,0,1504,291,289,-2
"6a9a3b5bde4a48daa896fe8c06eca56f","869e967078f04da18dd0b0b9389a7424",22850121,1,5,0,1505,289,293,4
"869e967078f04da18dd0b0b9389a7424","869e967078f04da18dd0b0b9389a7424",22850121,1,0,1,1506,293,293,0
"869e967078f04da18dd0b0b9389a7424","51ab6291537748fab90d519aa09889d6",22850121,1,2,0,1507,293,295,2
"51ab6291537748fab90d519aa09889d6","51ab6291537748fab90d519aa09889d6",22850121,17,0,1,1508,295,295,0
"51ab6291537748fab90d519aa09889d6","34a6e49023fc4465bd5ca604330bbd1c",22850121,1,-3,0,1525,295,292,-3
"34a6e49023fc4465bd5ca604330bbd1c","21592f2a9e9c4b2f8c66ec5dbcbf6a2b",22850121,1,5,0,1526,292,296,4
"21592f2a9e9c4b2f8c66ec5dbcbf6a2b","7669a956527947d0add87455277e80b4",22850121,1,-7,0,1527,296,291,-5
"7669a956527947d0add87455277e80b4","869e967078f04da18dd0b0b9389a7424",22850121,1,3,0,1529,291,293,2
"869e967078f04da18dd0b0b9389a7424","6a9a3b5bde4a48daa896fe8c06eca56f",22850121,3,-5,0,1530,293,289,-4
"6a9a3b5bde4a48daa896fe8c06eca56f","34a6e49023fc4465bd5ca604330bbd1c",22850121,2,4,0,1531,289,292,3
"34a6e49023fc4465bd5ca604330bbd1c","ba0e59461bfb4a44b7b1c28a01f8d3b3",22850121,1,9,0,1532,292,299,7
"ba0e59461bfb4a44b7b1c28a01f8d3b3","21592f2a9e9c4b2f8c66ec5dbcbf6a2b",22850121,1,-4,0,1533,299,296,-3
"21592f2a9e9c4b2f8c66ec5dbcbf6a2b","ba0e59461bfb4a44b7b1c28a01f8d3b3",22850121,1,4,0,1534,296,299,3
"ba0e59461bfb4a44b7b1c28a01f8d3b3","0e0b36e731a645e7b1b8a88f5031ca38",22850121,1,2,0,1535,299,301,2
"0e0b36e731a645e7b1b8a88f5031ca38","0e0b36e731a645e7b1b8a88f5031ca38",22850121,8,0,1,1536,301,301,0
"0e0b36e731a645e7b1b8a88f5031ca38","a66a144637284c21afc6de17fea4bfb8",22850121,1,1,0,1544,301,302,1
"a66a144637284c21afc6de17fea4bfb8","a66a144637284c21afc6de17fea4bfb8",22850121,8,0,1,1545,302,302,0
"a66a144637284c21afc6de17fea4bfb8","7646a919d7e64fa990bca9b024ff089d",22850121,1,-4,0,1553,302,298,-4
"7646a919d7e64fa990bca9b024ff089d","2c5bb2cbd0014420ad8c95d40e38efd1",22850121,1,6,0,1554,298,303,5
"2c5bb2cbd0014420ad8c95d40e38efd1","869e967078f04da18dd0b0b9389a7424",22850121,1,-13,0,1555,303,293,-10
"34a6e49023fc4465bd5ca604330bbd1c","e390b575229748ea8aac9364efe2bf00",22850121,1,15,0,1558,292,304,12
"e390b575229748ea8aac9364efe2bf00","e390b575229748ea8aac9364efe2bf00",22850121,3,0,1,1559,304,304,0
"e390b575229748ea8aac9364efe2bf00","3434c10e561d488a914e0f7d71907abd",22850121,1,3,0,1562,304,305,1
"3434c10e561d488a914e0f7d71907abd","4a29443515bb404cb8924e1c60a63b73",22850121,1,-27,0,1563,305,285,-20
"4a29443515bb404cb8924e1c60a63b73","53e7e900392747ccad52e711ab0f80d8",22850121,1,29,0,1564,285,307,22
"53e7e900392747ccad52e711ab0f80d8","53e7e900392747ccad52e711ab0f80d8",22850121,2,0,1,1565,307,307,0
"53e7e900392747ccad52e711ab0f80d8","6a9a3b5bde4a48daa896fe8c06eca56f",22850121,1,-24,0,1566,307,289,-18
"6a9a3b5bde4a48daa896fe8c06eca56f","4a29443515bb404cb8924e1c60a63b73",22850121,1,-5,0,1567,289,285,-4
"4a29443515bb404cb8924e1c60a63b73","869e967078f04da18dd0b0b9389a7424",22850121,1,10,0,1568,285,293,8
"6a9a3b5bde4a48daa896fe8c06eca56f","3434c10e561d488a914e0f7d71907abd",22850121,1,22,0,1570,289,305,16
"3434c10e561d488a914e0f7d71907abd","130acc2aeb0448fdbb2de63bc5cebe5b",22850121,1,5,0,1571,305,309,4
"130acc2aeb0448fdbb2de63bc5cebe5b","130acc2aeb0448fdbb2de63bc5cebe5b",22850121,1,0,1,1572,309,309,0
"130acc2aeb0448fdbb2de63bc5cebe5b","34a6e49023fc4465bd5ca604330bbd1c",22850121,1,-23,0,1573,309,292,-17
"34a6e49023fc4465bd5ca604330bbd1c","4a29443515bb404cb8924e1c60a63b73",22850121,1,-9,0,1574,292,285,-7
"4a29443515bb404cb8924e1c60a63b73","3434c10e561d488a914e0f7d71907abd",22850121,1,27,0,1575,285,305,20
"3434c10e561d488a914e0f7d71907abd","53e7e900392747ccad52e711ab0f80d8",22850121,1,2,0,1576,305,307,2
"53e7e900392747ccad52e711ab0f80d8","9c062b3251034ebe90f5054e2a3b5120",22850121,1,5,0,1578,307,311,4
"9c062b3251034ebe90f5054e2a3b5120","9c062b3251034ebe90f5054e2a3b5120",22850121,8,0,1,1579,311,311,0
"9c062b3251034ebe90f5054e2a3b5120","ea859f8207e44537889daeaba13ac2e8",22850121,1,1,0,1587,311,312,1
"ea859f8207e44537889daeaba13ac2e8","ea859f8207e44537889daeaba13ac2e8",22850121,5,0,1,1588,312,312,0
"ea859f8207e44537889daeaba13ac2e8","56d94971a7a94257aa330183a8ebd0ea",22850121,1,1,0,1593,312,313,1
"56d94971a7a94257aa330183a8ebd0ea","56d94971a7a94257aa330183a8ebd0ea",22850121,5,0,1,1594,313,313,0
"56d94971a7a94257aa330183a8ebd0ea","141c0df6cd1946539aadd1c9b7068cd4",22850121,1,-5,0,1599,313,308,-5
"141c0df6cd1946539aadd1c9b7068cd4","13255e63e0aa4abf85e5211bf613d43e",22850121,1,10,0,1600,308,317,9
"13255e63e0aa4abf85e5211bf613d43e","13255e63e0aa4abf85e5211bf613d43e",22850121,3,0,1,1601,317,317,0
"13255e63e0aa4abf85e5211bf613d43e","0c787d16c9504873b1a4d903cec09948",22850121,1,-3,0,1604,317,314,-3
"0c787d16c9504873b1a4d903cec09948","86c27d40179e419c8e9d150fb6afa5d0",22850121,1,6,0,1605,314,319,5
"86c27d40179e419c8e9d150fb6afa5d0","86c27d40179e419c8e9d150fb6afa5d0",22850121,1,0,1,1606,319,319,0
"86c27d40179e419c8e9d150fb6afa5d0","130acc2aeb0448fdbb2de63bc5cebe5b",22850121,2,-12,0,1607,319,309,-10
"130acc2aeb0448fdbb2de63bc5cebe5b","3434c10e561d488a914e0f7d71907abd",22850121,1,-5,0,1608,309,305,-4
"3434c10e561d488a914e0f7d71907abd","24f1363179ad4aaa965484a78471912b",22850121,1,22,0,1609,305,323,18
"24f1363179ad4aaa965484a78471912b","8d7e0b55cf9849cda222a0f2440cec55",22850121,1,-6,0,1610,323,318,-5
"8d7e0b55cf9849cda222a0f2440cec55","47edbb64109243e6b0f8f64cdef90c6c",22850121,1,9,0,1611,318,326,8
"47edbb64109243e6b0f8f64cdef90c6c","53e7e900392747ccad52e711ab0f80d8",22850121,1,-23,0,1612,326,307,-19
"53e7e900392747ccad52e711ab0f80d8","3628bdce1dd2429ba924d2d4d09448d2",22850121,1,19,0,1613,307,322,15
"3628bdce1dd2429ba924d2d4d09448d2","3434c10e561d488a914e0f7d71907abd",22850121,1,-21,0,1614,322,305,-17
"3434c10e561d488a914e0f7d71907abd","86c27d40179e419c8e9d150fb6afa5d0",22850121,1,17,0,1615,305,319,14
"130acc2aeb0448fdbb2de63bc5cebe5b","141c0df6cd1946539aadd1c9b7068cd4",22850121,1,-1,0,1617,309,308,-1
"141c0df6cd1946539aadd1c9b7068cd4","47edbb64109243e6b0f8f64cdef90c6c",22850121,1,21,0,1618,308,326,18
"47edbb64109243e6b0f8f64cdef90c6c","8d7e0b55cf9849cda222a0f2440cec55",22850121,1,-9,0,1619,326,318,-8
"8d7e0b55cf9849cda222a0f2440cec55","24f1363179ad4aaa965484a78471912b",22850121,1,6,0,1620,318,323,5
"24f1363179ad4aaa965484a78471912b","24f1363179ad4aaa965484a78471912b",22850121,2,0,1,1621,323,323,0
"24f1363179ad4aaa965484a78471912b","3628bdce1dd2429ba924d2d4d09448d2",22850121,1,-1,0,1623,323,322,-1
"3628bdce1dd2429ba924d2d4d09448d2","56b3fd1a212a4764be39d979fde3326e",22850121,1,7,0,1624,322,328,6
"56b3fd1a212a4764be39d979fde3326e","56b3fd1a212a4764be39d979fde3326e",22850121,3,0,1,1625,328,328,0
"56b3fd1a212a4764be39d979fde3326e","3434c10e561d488a914e0f7d71907abd",22850121,1,-28,0,1628,328,305,-23
"3434c10e561d488a914e0f7d71907abd","0c4079457ede49e3aeb5e86ed84bdf35",22850121,1,31,0,1629,305,329,24
"0c4079457ede49e3aeb5e86ed84bdf35","38aea304b4fa46e1b29bb72f5cea4c93",22850121,2,2,0,1630,329,331,2
"38aea304b4fa46e1b29bb72f5cea4c93","4a29443515bb404cb8924e1c60a63b73",22850121,1,-60,0,1631,331,285,-46
"4a29443515bb404cb8924e1c60a63b73","fab84b4fab5940efb4ea868ef8d09396",22850121,1,-4,0,1632,285,284,-1
"fab84b4fab5940efb4ea868ef8d09396","fab84b4fab5940efb4ea868ef8d09396",22850121,1,0,1,1633,284,284,0
"fab84b4fab5940efb4ea868ef8d09396","0c4079457ede49e3aeb5e86ed84bdf35",22850121,1,62,0,1634,284,329,45
"0c4079457ede49e3aeb5e86ed84bdf35","0c4079457ede49e3aeb5e86ed84bdf35",22850121,1,0,1,1635,329,329,0
"38aea304b4fa46e1b29bb72f5cea4c93","38aea304b4fa46e1b29bb72f5cea4c93",22850121,1,0,1,1637,331,331,0
"38aea304b4fa46e1b29bb72f5cea4c93","e36d261332f14e79bb4b467aceaeb9b5",22850121,1,2,0,1638,331,333,2
"e36d261332f14e79bb4b467aceaeb9b5","e36d261332f14e79bb4b467aceaeb9b5",22850121,5,0,1,1639,333,333,0
"e36d261332f14e79bb4b467aceaeb9b5","c7e89b9d04744d2eab742fc24e3ef1ae",22850121,1,1,0,1644,333,334,1
"c7e89b9d04744d2eab742fc24e3ef1ae","c7e89b9d04744d2eab742fc24e3ef1ae",22850121,8,0,1,1645,334,334,0
"c7e89b9d04744d2eab742fc24e3ef1ae","fe49f8054b374a0ea4bb266ed135ff62",22850121,1,1,0,1653,334,335,1
"fe49f8054b374a0ea4bb266ed135ff62","fe49f8054b374a0ea4bb266ed135ff62",22850121,8,0,1,1654,335,335,0
"fe49f8054b374a0ea4bb266ed135ff62","d0a8f74af98642fe8360d22c42e45117",22850121,1,1,0,1662,335,336,1
"d0a8f74af98642fe8360d22c42e45117","d0a8f74af98642fe8360d22c42e45117",22850121,5,0,1,1663,336,336,0
"d0a8f74af98642fe8360d22c42e45117","0c4079457ede49e3aeb5e86ed84bdf35",22850121,1,-7,0,1668,336,329,-7
"0c4079457ede49e3aeb5e86ed84bdf35","a7c6339ca1da4368a18d471f0519f877",22850121,2,11,0,1669,329,339,10
"a7c6339ca1da4368a18d471f0519f877","a7c6339ca1da4368a18d471f0519f877",22850121,2,0,1,1670,339,339,0
"a7c6339ca1da4368a18d471f0519f877","b8b9418ab322418d9db9b40d96af873a",22850121,2,-2,0,1671,339,337,-2
"b8b9418ab322418d9db9b40d96af873a","bbc5139ca9024389a94db3a6f47dcff6",22850121,2,5,0,1672,337,341,4
"bbc5139ca9024389a94db3a6f47dcff6","c2490bc612d146edbe786556fab3651b",22850121,1,-1,0,1673,341,340,-1
"c2490bc612d146edbe786556fab3651b","a7c6339ca1da4368a18d471f0519f877",22850121,1,-2,0,1674,340,339,-1
"bbc5139ca9024389a94db3a6f47dcff6","4a29443515bb404cb8924e1c60a63b73",22850121,1,-72,0,1678,341,285,-56
"4a29443515bb404cb8924e1c60a63b73","0c4079457ede49e3aeb5e86ed84bdf35",22850121,1,58,0,1679,285,329,44
"0c4079457ede49e3aeb5e86ed84bdf35","b8b9418ab322418d9db9b40d96af873a",22850121,1,9,0,1680,329,337,8
"b8b9418ab322418d9db9b40d96af873a","0c4079457ede49e3aeb5e86ed84bdf35",22850121,1,-9,0,1681,337,329,-8
"a7c6339ca1da4368a18d471f0519f877","bbc5139ca9024389a94db3a6f47dcff6",22850121,1,3,0,1683,339,341,2
"bbc5139ca9024389a94db3a6f47dcff6","b8b9418ab322418d9db9b40d96af873a",22850121,1,-5,0,1684,341,337,-4
"b8b9418ab322418d9db9b40d96af873a","c2490bc612d146edbe786556fab3651b",22850121,1,4,0,1685,337,340,3
"c2490bc612d146edbe786556fab3651b","6ac8bb048b854999a47edb35fe627f11",22850121,1,8,0,1686,340,347,7
"6ac8bb048b854999a47edb35fe627f11","6ac8bb048b854999a47edb35fe627f11",22850121,3,0,1,1687,347,347,0
"6ac8bb048b854999a47edb35fe627f11","0c4079457ede49e3aeb5e86ed84bdf35",22850121,1,-21,0,1690,347,329,-18
"0c4079457ede49e3aeb5e86ed84bdf35","30ead9794d4847abaf222ca966cc8630",22850121,1,24,0,1691,329,348,19
"30ead9794d4847abaf222ca966cc8630","09b9678ddc3d452ea4a3d46e15826065",22850121,1,5,0,1692,348,353,5
"09b9678ddc3d452ea4a3d46e15826065","c20993c944444fe085345591a8bd837e",22850121,4,-2,0,1693,353,351,-2
"c20993c944444fe085345591a8bd837e","897b7f51242c44aab2205c72fdcbf4cd",22850121,5,1,0,1694,351,352,1
"897b7f51242c44aab2205c72fdcbf4cd","eff0de7f2dbb42dfa1a2e686efab5b6d",22850121,2,2,0,1695,352,354,2
"eff0de7f2dbb42dfa1a2e686efab5b6d","4a29443515bb404cb8924e1c60a63b73",22850121,1,-88,0,1696,354,285,-69
"4a29443515bb404cb8924e1c60a63b73","c2490bc612d146edbe786556fab3651b",22850121,1,71,0,1697,285,340,55
"c2490bc612d146edbe786556fab3651b","0c4079457ede49e3aeb5e86ed84bdf35",22850121,1,-13,0,1698,340,329,-11
"0c4079457ede49e3aeb5e86ed84bdf35","bbc5139ca9024389a94db3a6f47dcff6",22850121,1,14,0,1699,329,341,12
"bbc5139ca9024389a94db3a6f47dcff6","0c7262dff33c4087bc660ccf40f92f9c",22850121,1,-229,0,1700,341,169,-172
"b87c552dd247427abe6ab5795b9c9d43","0c4079457ede49e3aeb5e86ed84bdf35",22850121,1,201,0,1703,181,329,148
"0c4079457ede49e3aeb5e86ed84bdf35","c2490bc612d146edbe786556fab3651b",22850121,1,13,0,1704,329,340,11
"c2490bc612d146edbe786556fab3651b","bbc5139ca9024389a94db3a6f47dcff6",22850121,1,1,0,1705,340,341,1
"bbc5139ca9024389a94db3a6f47dcff6","bbc5139ca9024389a94db3a6f47dcff6",22850121,1,0,1,1706,341,341,0
"bbc5139ca9024389a94db3a6f47dcff6","4ee6ca9019ab4a1ab323f98094a9bd77",22850121,1,2,0,1707,341,343,2
"4ee6ca9019ab4a1ab323f98094a9bd77","4ee6ca9019ab4a1ab323f98094a9bd77",22850121,8,0,1,1708,343,343,0
"4ee6ca9019ab4a1ab323f98094a9bd77","b37947176785476f8b29d49a851366dc",22850121,1,1,0,1716,343,344,1
"b37947176785476f8b29d49a851366dc","b37947176785476f8b29d49a851366dc",22850121,8,0,1,1717,344,344,0
"b37947176785476f8b29d49a851366dc","fcea5b10d5a14a3b9324ffece8f6e1e5",22850121,1,1,0,1725,344,345,1
"fcea5b10d5a14a3b9324ffece8f6e1e5","fcea5b10d5a14a3b9324ffece8f6e1e5",22850121,8,0,1,1726,345,345,0
"fcea5b10d5a14a3b9324ffece8f6e1e5","c2490bc612d146edbe786556fab3651b",22850121,1,-5,0,1734,345,340,-5
"c2490bc612d146edbe786556fab3651b","4a29443515bb404cb8924e1c60a63b73",22850121,1,-71,0,1735,340,285,-55
"4a29443515bb404cb8924e1c60a63b73","30ead9794d4847abaf222ca966cc8630",22850121,2,82,0,1736,285,348,63
"30ead9794d4847abaf222ca966cc8630","30ead9794d4847abaf222ca966cc8630",22850121,1,0,1,1737,348,348,0
"30ead9794d4847abaf222ca966cc8630","897b7f51242c44aab2205c72fdcbf4cd",22850121,1,4,0,1738,348,352,4
"897b7f51242c44aab2205c72fdcbf4cd","c20993c944444fe085345591a8bd837e",22850121,3,-1,0,1739,352,351,-1
"c20993c944444fe085345591a8bd837e","eff0de7f2dbb42dfa1a2e686efab5b6d",22850121,2,3,0,1740,351,354,3
"eff0de7f2dbb42dfa1a2e686efab5b6d","09b9678ddc3d452ea4a3d46e15826065",22850121,3,-1,0,1741,354,353,-1
"c20993c944444fe085345591a8bd837e","c20993c944444fe085345591a8bd837e",22850121,6,0,1,1743,351,351,0
"897b7f51242c44aab2205c72fdcbf4cd","897b7f51242c44aab2205c72fdcbf4cd",22850121,7,0,1,1747,352,352,0
"897b7f51242c44aab2205c72fdcbf4cd","09b9678ddc3d452ea4a3d46e15826065",22850121,2,1,0,1750,352,353,1
"09b9678ddc3d452ea4a3d46e15826065","09b9678ddc3d452ea4a3d46e15826065",22850121,6,0,1,1751,353,353,0
"09b9678ddc3d452ea4a3d46e15826065","eff0de7f2dbb42dfa1a2e686efab5b6d",22850121,3,1,0,1754,353,354,1
"eff0de7f2dbb42dfa1a2e686efab5b6d","eff0de7f2dbb42dfa1a2e686efab5b6d",22850121,7,0,1,1755,354,354,0
"eff0de7f2dbb42dfa1a2e686efab5b6d","30ead9794d4847abaf222ca966cc8630",22850121,1,-6,0,1758,354,348,-6
"30ead9794d4847abaf222ca966cc8630","2fe14166dc9642c3bc666b86a57f943d",22850121,2,10,0,1759,348,357,9
"2fe14166dc9642c3bc666b86a57f943d","2fe14166dc9642c3bc666b86a57f943d",22850121,1,0,1,1760,357,357,0
"2fe14166dc9642c3bc666b86a57f943d","44421dd1e13a47a388c4a19834b744c7",22850121,1,2,0,1761,357,359,2
"44421dd1e13a47a388c4a19834b744c7","44421dd1e13a47a388c4a19834b744c7",22850121,8,0,1,1762,359,359,0
"44421dd1e13a47a388c4a19834b744c7","cb5fc7ef85d547c4be1a7439d0bf6052",22850121,1,1,0,1770,359,360,1
"cb5fc7ef85d547c4be1a7439d0bf6052","cb5fc7ef85d547c4be1a7439d0bf6052",22850121,5,0,1,1771,360,360,0
"cb5fc7ef85d547c4be1a7439d0bf6052","0a8f150a4cf747acbde62f4721823da3",22850121,1,1,0,1776,360,361,1
"0a8f150a4cf747acbde62f4721823da3","0a8f150a4cf747acbde62f4721823da3",22850121,5,0,1,1777,361,361,0
"0a8f150a4cf747acbde62f4721823da3","ab8fdad974ae471f9f24c3f9dd04462e",22850121,1,1,0,1782,361,362,1
"ab8fdad974ae471f9f24c3f9dd04462e","ab8fdad974ae471f9f24c3f9dd04462e",22850121,5,0,1,1783,362,362,0
"ab8fdad974ae471f9f24c3f9dd04462e","1ba8fef685d74a8194b9db252eb704fb",22850121,1,-7,0,1788,362,355,-7
"1ba8fef685d74a8194b9db252eb704fb","52580888dadb4fe3baa795683ea227bd",22850121,2,10,0,1789,355,364,9
"52580888dadb4fe3baa795683ea227bd","f00179e251a045b39c3f7a54f9aa4acc",22850121,2,-1,0,1790,364,363,-1
"f00179e251a045b39c3f7a54f9aa4acc","c20993c944444fe085345591a8bd837e",22850121,1,-14,0,1791,363,351,-12
"c20993c944444fe085345591a8bd837e","09b9678ddc3d452ea4a3d46e15826065",22850121,2,2,0,1798,351,353,2
"eff0de7f2dbb42dfa1a2e686efab5b6d","2fe14166dc9642c3bc666b86a57f943d",22850121,2,4,0,1803,354,357,3
"2fe14166dc9642c3bc666b86a57f943d","30ead9794d4847abaf222ca966cc8630",22850121,2,-10,0,1804,357,348,-9
"30ead9794d4847abaf222ca966cc8630","1ba8fef685d74a8194b9db252eb704fb",22850121,2,8,0,1805,348,355,7
"1ba8fef685d74a8194b9db252eb704fb","09b9678ddc3d452ea4a3d46e15826065",22850121,1,-3,0,1806,355,353,-2
"52580888dadb4fe3baa795683ea227bd","52580888dadb4fe3baa795683ea227bd",22850121,1,0,1,1822,364,364,0
"f00179e251a045b39c3f7a54f9aa4acc","492a3bc6a1254f23a7998587961b22a4",22850121,1,4,0,1824,363,366,3
"492a3bc6a1254f23a7998587961b22a4","492a3bc6a1254f23a7998587961b22a4",22850121,2,0,1,1825,366,366,0
"492a3bc6a1254f23a7998587961b22a4","072a190fd302456290895f9f04d6940a",22850121,3,-1,0,1826,366,365,-1
"072a190fd302456290895f9f04d6940a","eff0de7f2dbb42dfa1a2e686efab5b6d",22850121,1,-14,0,1827,365,354,-11
"eff0de7f2dbb42dfa1a2e686efab5b6d","c76574d21bc14aeea7ecd0b027f39858",22850121,1,17,0,1829,354,367,13
"c76574d21bc14aeea7ecd0b027f39858","c20993c944444fe085345591a8bd837e",22850121,1,-20,0,1830,367,351,-16
"09b9678ddc3d452ea4a3d46e15826065","897b7f51242c44aab2205c72fdcbf4cd",22850121,2,-1,0,1833,353,352,-1
"897b7f51242c44aab2205c72fdcbf4cd","30ead9794d4847abaf222ca966cc8630",22850121,1,-4,0,1840,352,348,-4
"2fe14166dc9642c3bc666b86a57f943d","1ba8fef685d74a8194b9db252eb704fb",22850121,1,-2,0,1842,357,355,-2
"1ba8fef685d74a8194b9db252eb704fb","492a3bc6a1254f23a7998587961b22a4",22850121,1,13,0,1843,355,366,11
"072a190fd302456290895f9f04d6940a","c76574d21bc14aeea7ecd0b027f39858",22850121,1,3,0,1845,365,367,2
"c76574d21bc14aeea7ecd0b027f39858","492a3bc6a1254f23a7998587961b22a4",22850121,1,-2,0,1846,367,366,-1
"072a190fd302456290895f9f04d6940a","cfa457d1743848e4bb5e4beced6448ed",22850121,1,5,0,1849,365,369,4
"cfa457d1743848e4bb5e4beced6448ed","cfa457d1743848e4bb5e4beced6448ed",22850121,3,0,1,1850,369,369,0
"cfa457d1743848e4bb5e4beced6448ed","30ead9794d4847abaf222ca966cc8630",22850121,1,-25,0,1853,369,348,-21
"30ead9794d4847abaf222ca966cc8630","b71bac264efb4abd97015447bd490db6",22850121,1,28,0,1854,348,370,22
"b71bac264efb4abd97015447bd490db6","4a29443515bb404cb8924e1c60a63b73",22850121,1,-110,0,1855,370,285,-85
"30ead9794d4847abaf222ca966cc8630","492a3bc6a1254f23a7998587961b22a4",22850121,1,21,0,1857,348,366,18
"492a3bc6a1254f23a7998587961b22a4","b71bac264efb4abd97015447bd490db6",22850121,1,7,0,1858,366,370,4
"b71bac264efb4abd97015447bd490db6","b71bac264efb4abd97015447bd490db6",22850121,2,0,1,1859,370,370,0
"b71bac264efb4abd97015447bd490db6","492a3bc6a1254f23a7998587961b22a4",22850121,1,-7,0,1860,370,366,-4
"492a3bc6a1254f23a7998587961b22a4","8d448d625b024c82a5eb240bbd7431d6",22850121,1,12,0,1861,366,374,8
"8d448d625b024c82a5eb240bbd7431d6","b71bac264efb4abd97015447bd490db6",22850121,4,-5,0,1862,374,370,-4
"b71bac264efb4abd97015447bd490db6","8d448d625b024c82a5eb240bbd7431d6",22850121,5,5,0,1863,370,374,4
"8d448d625b024c82a5eb240bbd7431d6","8d448d625b024c82a5eb240bbd7431d6",22850121,73,0,1,1864,374,374,0
"8d448d625b024c82a5eb240bbd7431d6","4a29443515bb404cb8924e1c60a63b73",22850121,1,-115,0,1870,374,285,-89
"4a29443515bb404cb8924e1c60a63b73","d6d02b6ef04e4f17805504500b8ce441",22850121,1,118,0,1871,285,375,90
"d6d02b6ef04e4f17805504500b8ce441","d6d02b6ef04e4f17805504500b8ce441",22850121,15,0,1,1872,375,375,0
"d6d02b6ef04e4f17805504500b8ce441","d646286c8051419bbc2e31dd1db55ca8",22850121,1,-407,0,1874,375,67,-308
"d646286c8051419bbc2e31dd1db55ca8","6a9f0ef185fb47f0937e29daa1c71ed5",22850121,1,27,0,1875,67,90,23
"6a9f0ef185fb47f0937e29daa1c71ed5","6a9f0ef185fb47f0937e29daa1c71ed5",22850121,7,0,1,1876,90,90,0
"6a9f0ef185fb47f0937e29daa1c71ed5","42fb58708eaf4e5daa82bfca61b6f5fd",22850121,1,-3,0,1878,90,87,-3
"42fb58708eaf4e5daa82bfca61b6f5fd","adb17b12b66c4a49a85fd34322f7df70",22850121,1,-18,0,1879,87,73,-14
"adb17b12b66c4a49a85fd34322f7df70","adb17b12b66c4a49a85fd34322f7df70",22850121,2,0,1,1880,73,73,0
"adb17b12b66c4a49a85fd34322f7df70","88fff56d0342490dbef9040750a20f6c",22850121,1,-1,0,1881,73,72,-1
"88fff56d0342490dbef9040750a20f6c","88fff56d0342490dbef9040750a20f6c",22850121,3,0,1,1882,72,72,0
"88fff56d0342490dbef9040750a20f6c","267f883678b24aed855fde42524975d9",22850121,1,-1,0,1883,72,71,-1
"267f883678b24aed855fde42524975d9","267f883678b24aed855fde42524975d9",22850121,4,0,1,1884,71,71,0
"267f883678b24aed855fde42524975d9","88fff56d0342490dbef9040750a20f6c",22850121,2,1,0,1887,71,72,1
"88fff56d0342490dbef9040750a20f6c","d646286c8051419bbc2e31dd1db55ca8",22850121,1,-5,0,1889,72,67,-5
"d646286c8051419bbc2e31dd1db55ca8","a2becd407db34b189200a32546d9d569",22850121,3,9,0,1890,67,75,8
"a2becd407db34b189200a32546d9d569","58c22b011d0f4c2ea6d13615edbb9eeb",22850121,2,2,0,1891,75,77,2
"58c22b011d0f4c2ea6d13615edbb9eeb","58c22b011d0f4c2ea6d13615edbb9eeb",22850121,10,0,1,1892,77,77,0
"58c22b011d0f4c2ea6d13615edbb9eeb","dd76e1861dc9461c830888729d091ee0",22850121,2,1,0,1900,77,78,1
"dd76e1861dc9461c830888729d091ee0","dd76e1861dc9461c830888729d091ee0",22850121,10,0,1,1901,78,78,0
"dd76e1861dc9461c830888729d091ee0","cd1d828f1a694b87913a7ea66c23803e",22850121,1,1,0,1909,78,79,1
"cd1d828f1a694b87913a7ea66c23803e","cd1d828f1a694b87913a7ea66c23803e",22850121,7,0,1,1910,79,79,0
"cd1d828f1a694b87913a7ea66c23803e","9176a3c2b4d2465fa8b0c67096c2a97e",22850121,1,1,0,1915,79,80,1
"9176a3c2b4d2465fa8b0c67096c2a97e","9176a3c2b4d2465fa8b0c67096c2a97e",22850121,22,0,1,1916,80,80,0
"9176a3c2b4d2465fa8b0c67096c2a97e","f8ec6445f7194e25b9101d4fbcb07a18",22850121,1,1,0,1927,80,81,1
"f8ec6445f7194e25b9101d4fbcb07a18","f8ec6445f7194e25b9101d4fbcb07a18",22850121,7,0,1,1928,81,81,0
"f8ec6445f7194e25b9101d4fbcb07a18","140d5b27b8574befad82c0a013b59dfa",22850121,1,-7,0,1933,81,74,-7
"140d5b27b8574befad82c0a013b59dfa","072a190fd302456290895f9f04d6940a",22850121,1,383,0,1934,74,365,291
"072a190fd302456290895f9f04d6940a","d646286c8051419bbc2e31dd1db55ca8",22850121,1,-391,0,1935,365,67,-298
"d646286c8051419bbc2e31dd1db55ca8","d646286c8051419bbc2e31dd1db55ca8",22850121,1,0,1,1936,67,67,0
"a2becd407db34b189200a32546d9d569","d646286c8051419bbc2e31dd1db55ca8",22850121,2,-9,0,1938,75,67,-8
"d646286c8051419bbc2e31dd1db55ca8","140d5b27b8574befad82c0a013b59dfa",22850121,1,8,0,1939,67,74,7
"140d5b27b8574befad82c0a013b59dfa","d18a9ea32855445f8736581f5cb119ce",22850121,2,9,0,1940,74,82,8
"d18a9ea32855445f8736581f5cb119ce","18fd01350bd5434ca636d59a599d768a",22850121,1,5,0,1941,82,86,4
"18fd01350bd5434ca636d59a599d768a","2ae94c0cea4d480a9d5dca8fb1d7b542",22850121,1,207,0,1942,86,242,156
"2ae94c0cea4d480a9d5dca8fb1d7b542","6e83e23f56544a19b94067c1c558d9c0",22850121,1,6,0,1943,242,247,5
"6e83e23f56544a19b94067c1c558d9c0","30c9ba177afc49a695625d2bdec40207",22850121,1,3,0,1944,247,250,3
"30c9ba177afc49a695625d2bdec40207","30c9ba177afc49a695625d2bdec40207",22850121,8,0,1,1945,250,250,0
"30c9ba177afc49a695625d2bdec40207","6e83e23f56544a19b94067c1c558d9c0",22850121,1,-3,0,1953,250,247,-3
"b87c552dd247427abe6ab5795b9c9d43","b71bac264efb4abd97015447bd490db6",22850121,1,253,0,1958,181,370,189
"8d448d625b024c82a5eb240bbd7431d6","1b4550d0dab04078b3bf08a655345bdc",22850121,1,-1,0,1969,374,373,-1
"1b4550d0dab04078b3bf08a655345bdc","b71bac264efb4abd97015447bd490db6",22850121,2,-4,0,1970,373,370,-3
"b71bac264efb4abd97015447bd490db6","d6d02b6ef04e4f17805504500b8ce441",22850121,2,8,0,2025,370,375,5
"d6d02b6ef04e4f17805504500b8ce441","4a29443515bb404cb8924e1c60a63b73",22850121,1,-118,0,2027,375,285,-90
"4a29443515bb404cb8924e1c60a63b73","1b4550d0dab04078b3bf08a655345bdc",22850121,1,114,0,2028,285,373,88
"d6d02b6ef04e4f17805504500b8ce441","66baf19b6b904b70922329068c63746d",22850121,2,4,0,2045,375,376,1
"66baf19b6b904b70922329068c63746d","66baf19b6b904b70922329068c63746d",22850121,2,0,1,2046,376,376,0
"66baf19b6b904b70922329068c63746d","7f544639412e40a9ba27f43b415362ab",22850121,2,2,0,2047,376,378,2
"7f544639412e40a9ba27f43b415362ab","d6d02b6ef04e4f17805504500b8ce441",22850121,1,-6,0,2048,378,375,-3
"7f544639412e40a9ba27f43b415362ab","7f544639412e40a9ba27f43b415362ab",22850121,1,0,1,2055,378,378,0
"7f544639412e40a9ba27f43b415362ab","d5ae8642e15b46b8bd298b02274d4e9c",22850121,1,2,0,2056,378,380,2
"d5ae8642e15b46b8bd298b02274d4e9c","d5ae8642e15b46b8bd298b02274d4e9c",22850121,9,0,1,2057,380,380,0
"d5ae8642e15b46b8bd298b02274d4e9c","a0d10309a2dd456289147f84be9d37f9",22850121,1,1,0,2066,380,381,1
"a0d10309a2dd456289147f84be9d37f9","a0d10309a2dd456289147f84be9d37f9",22850121,8,0,1,2067,381,381,0
"a0d10309a2dd456289147f84be9d37f9","0fcbc3ca07b144138b8d85da581f09a8",22850121,1,1,0,2075,381,382,1
"0fcbc3ca07b144138b8d85da581f09a8","0fcbc3ca07b144138b8d85da581f09a8",22850121,8,0,1,2076,382,382,0
"0fcbc3ca07b144138b8d85da581f09a8","66baf19b6b904b70922329068c63746d",22850121,1,-6,0,2084,382,376,-6
"66baf19b6b904b70922329068c63746d","4890121ce5d74576b4632b77cfc23398",22850121,1,14,0,2085,376,388,12
"4890121ce5d74576b4632b77cfc23398","c2fca3669923477ab966ded303dea31c",22850121,1,-6,0,2086,388,383,-5
"c2fca3669923477ab966ded303dea31c","4890121ce5d74576b4632b77cfc23398",22850121,1,6,0,2087,383,388,5
"4890121ce5d74576b4632b77cfc23398","18d3b836dd804224883cc9180b60a8e1",22850121,1,-1,0,2088,388,387,-1
"18d3b836dd804224883cc9180b60a8e1","96bb2b3e85a34d8b9544514e89f6fe97",22850121,1,4,0,2089,387,390,3
"96bb2b3e85a34d8b9544514e89f6fe97","96bb2b3e85a34d8b9544514e89f6fe97",22850121,1,0,1,2090,390,390,0
"96bb2b3e85a34d8b9544514e89f6fe97","ac4e9b54acfe4670b4634859c7263cb5",22850121,1,2,0,2091,390,392,2
"ac4e9b54acfe4670b4634859c7263cb5","ac4e9b54acfe4670b4634859c7263cb5",22850121,3,0,1,2092,392,392,0
"ac4e9b54acfe4670b4634859c7263cb5","17f95d18bab743888e1736033dc3384d",22850121,1,-3,0,2095,392,389,-3
"17f95d18bab743888e1736033dc3384d","6f8881a745ac4c358a68b92c3b4abe81",22850121,1,6,0,2096,389,394,5
"6f8881a745ac4c358a68b92c3b4abe81","6f8881a745ac4c358a68b92c3b4abe81",22850121,1,0,1,2097,394,394,0
"6f8881a745ac4c358a68b92c3b4abe81","f7002c8484354eceac57bc7bd62c76c1",22850121,1,-1,0,2098,394,393,-1
"f7002c8484354eceac57bc7bd62c76c1","44a277ea44dc4ae689fab4b82f0b4098",22850121,1,5,0,2099,393,397,4
"44a277ea44dc4ae689fab4b82f0b4098","44a277ea44dc4ae689fab4b82f0b4098",22850121,3,0,1,2100,397,397,0
"44a277ea44dc4ae689fab4b82f0b4098","0c12af0a4e7f4002852cf84b2537c161",22850121,1,-2,0,2103,397,395,-2
"0c12af0a4e7f4002852cf84b2537c161","859e0b8d71694b12befb69ee698138f9",22850121,1,5,0,2104,395,399,4
"859e0b8d71694b12befb69ee698138f9","859e0b8d71694b12befb69ee698138f9",22850121,3,0,1,2105,399,399,0
"859e0b8d71694b12befb69ee698138f9","66baf19b6b904b70922329068c63746d",22850121,1,-29,0,2108,399,376,-23
"66baf19b6b904b70922329068c63746d","2b09a08242b54983aec7063990fb3f66",22850121,1,32,0,2109,376,400,24
"2b09a08242b54983aec7063990fb3f66","2b09a08242b54983aec7063990fb3f66",22850121,5,0,1,2110,400,400,0
"2b09a08242b54983aec7063990fb3f66","1f471b7a883a4df48211e8c6a81b59a7",22850121,1,1,0,2115,400,401,1
"1f471b7a883a4df48211e8c6a81b59a7","1f471b7a883a4df48211e8c6a81b59a7",22850121,3,0,1,2116,401,401,0
"1f471b7a883a4df48211e8c6a81b59a7","2b09a08242b54983aec7063990fb3f66",22850121,1,-1,0,2119,401,400,-1
"2b09a08242b54983aec7063990fb3f66","9de0d567bfa84fe5b77cb76f4a76a5d1",22850121,1,5,0,2120,400,404,4
"9de0d567bfa84fe5b77cb76f4a76a5d1","9de0d567bfa84fe5b77cb76f4a76a5d1",22850121,3,0,1,2121,404,404,0
"9de0d567bfa84fe5b77cb76f4a76a5d1","1157bd665ec4472fb58b751dc5099355",22850121,1,-1,0,2124,404,403,-1
"1157bd665ec4472fb58b751dc5099355","3c8a22d2f9c146ea956609e3ed4f2559",22850121,1,3,0,2125,403,405,2
"3c8a22d2f9c146ea956609e3ed4f2559","58fc9094275e4c49be3f4ba6d4acc0a4",22850121,1,2,0,2126,405,406,1
"58fc9094275e4c49be3f4ba6d4acc0a4","58fc9094275e4c49be3f4ba6d4acc0a4",22850121,2,0,1,2127,406,406,0
"58fc9094275e4c49be3f4ba6d4acc0a4","c1c1be90b2b14c1ab4a5e1ee3c241902",22850121,1,1,0,2129,406,407,1
"c1c1be90b2b14c1ab4a5e1ee3c241902","c1c1be90b2b14c1ab4a5e1ee3c241902",22850121,17,0,1,2130,407,407,0
"c1c1be90b2b14c1ab4a5e1ee3c241902","02b3a1bead9244c1ba2f857c7da8f82a",22850121,1,2,0,2147,407,408,1
"02b3a1bead9244c1ba2f857c7da8f82a","58fc9094275e4c49be3f4ba6d4acc0a4",22850121,1,-3,0,2148,408,406,-2
"58fc9094275e4c49be3f4ba6d4acc0a4","02b3a1bead9244c1ba2f857c7da8f82a",22850121,1,3,0,2149,406,408,2
"02b3a1bead9244c1ba2f857c7da8f82a","6206fc6479014bb193084c32409dc1b9",22850121,1,1,0,2150,408,409,1
"6206fc6479014bb193084c32409dc1b9","6206fc6479014bb193084c32409dc1b9",22850121,5,0,1,2151,409,409,0
"6206fc6479014bb193084c32409dc1b9","2b09a08242b54983aec7063990fb3f66",22850121,1,-13,0,2156,409,400,-9
"2b09a08242b54983aec7063990fb3f66","02b3a1bead9244c1ba2f857c7da8f82a",22850121,1,12,0,2157,400,408,8
"02b3a1bead9244c1ba2f857c7da8f82a","02b3a1bead9244c1ba2f857c7da8f82a",22850121,1,0,1,2158,408,408,0
"02b3a1bead9244c1ba2f857c7da8f82a","687055dad9fc40c3982478fe33ec01bf",22850121,1,9,0,2159,408,414,6
"687055dad9fc40c3982478fe33ec01bf","2b09a08242b54983aec7063990fb3f66",22850121,1,-21,0,2160,414,400,-14
"2b09a08242b54983aec7063990fb3f66","1fd0f6dadbc14ebc965faf6122190b96",22850121,1,22,0,2161,400,415,15
"1fd0f6dadbc14ebc965faf6122190b96","1fd0f6dadbc14ebc965faf6122190b96",22850121,3,0,1,2162,415,415,0
"1fd0f6dadbc14ebc965faf6122190b96","687055dad9fc40c3982478fe33ec01bf",22850121,1,-1,0,2165,415,414,-1
"687055dad9fc40c3982478fe33ec01bf","6a5f020451db426dacba9e2ea3fcc62a",22850121,1,-6,0,2166,414,410,-4
"6a5f020451db426dacba9e2ea3fcc62a","02b3a1bead9244c1ba2f857c7da8f82a",22850121,1,-3,0,2167,410,408,-2
"02b3a1bead9244c1ba2f857c7da8f82a","6a5f020451db426dacba9e2ea3fcc62a",22850121,1,3,0,2168,408,410,2
"6a5f020451db426dacba9e2ea3fcc62a","2add1669f08d4101913db15f8c23b3b7",22850121,1,9,0,2169,410,416,6
"2add1669f08d4101913db15f8c23b3b7","2add1669f08d4101913db15f8c23b3b7",22850121,3,0,1,2170,416,416,0
"2add1669f08d4101913db15f8c23b3b7","2b09a08242b54983aec7063990fb3f66",22850121,1,-24,0,2173,416,400,-16
"2b09a08242b54983aec7063990fb3f66","a2b4bd40cee2481ebd3fc179d6a5cd62",22850121,1,27,0,2174,400,417,17
"a2b4bd40cee2481ebd3fc179d6a5cd62","6a5f020451db426dacba9e2ea3fcc62a",22850121,1,-12,0,2175,417,410,-7
"6a5f020451db426dacba9e2ea3fcc62a","33a9d248b2e44588a5b07fc1342b9bc2",22850121,1,2,0,2176,410,411,1
"33a9d248b2e44588a5b07fc1342b9bc2","33a9d248b2e44588a5b07fc1342b9bc2",22850121,1,0,1,2177,411,411,0
"33a9d248b2e44588a5b07fc1342b9bc2","c6f26bd420634f1cb7989e76fe6b16c0",22850121,1,1,0,2178,411,412,1
"c6f26bd420634f1cb7989e76fe6b16c0","c6f26bd420634f1cb7989e76fe6b16c0",22850121,17,0,1,2179,412,412,0
"c6f26bd420634f1cb7989e76fe6b16c0","e34e59dce2204f228f3a84b6725df60f",22850121,1,11,0,2196,412,419,7
"e34e59dce2204f228f3a84b6725df60f","e34e59dce2204f228f3a84b6725df60f",22850121,3,0,1,2197,419,419,0
"e34e59dce2204f228f3a84b6725df60f","a2b4bd40cee2481ebd3fc179d6a5cd62",22850121,1,-2,0,2200,419,417,-2
"a2b4bd40cee2481ebd3fc179d6a5cd62","bec48fc2e1294c7eb3d0aca780d731b8",22850121,1,4,0,2201,417,420,3
"bec48fc2e1294c7eb3d0aca780d731b8","2a65ee6e2ac64f6a8a55fbe5373ec763",22850121,1,-12,0,2202,420,413,-7
"2a65ee6e2ac64f6a8a55fbe5373ec763","2a65ee6e2ac64f6a8a55fbe5373ec763",22850121,8,0,1,2203,413,413,0
"2a65ee6e2ac64f6a8a55fbe5373ec763","33a9d248b2e44588a5b07fc1342b9bc2",22850121,1,-2,0,2211,413,411,-2
"33a9d248b2e44588a5b07fc1342b9bc2","bec48fc2e1294c7eb3d0aca780d731b8",22850121,1,14,0,2212,411,420,9
"bec48fc2e1294c7eb3d0aca780d731b8","24cf8786024543f19b89bc20034e60d7",22850121,1,14,0,2213,420,428,8
"24cf8786024543f19b89bc20034e60d7","f2a73be2f46840b182d7bd095378004e",22850121,2,1,0,2214,428,429,1
"f2a73be2f46840b182d7bd095378004e","bec48fc2e1294c7eb3d0aca780d731b8",22850121,1,-15,0,2215,429,420,-9
"bec48fc2e1294c7eb3d0aca780d731b8","dbde19fcce2a4c1abdc7f685c293a23f",22850121,1,3,0,2216,420,422,2
"dbde19fcce2a4c1abdc7f685c293a23f","a24600b0e49245f6bdba8c893cfeddb0",22850121,3,4,0,2217,422,425,3
"a24600b0e49245f6bdba8c893cfeddb0","a24600b0e49245f6bdba8c893cfeddb0",22850121,2,0,1,2218,425,425,0
"a24600b0e49245f6bdba8c893cfeddb0","5d290f75e44b4bdb8256c600debbb44d",22850121,1,2,0,2219,425,426,1
"5d290f75e44b4bdb8256c600debbb44d","a2b4bd40cee2481ebd3fc179d6a5cd62",22850121,2,-13,0,2220,426,417,-9
"a2b4bd40cee2481ebd3fc179d6a5cd62","a24600b0e49245f6bdba8c893cfeddb0",22850121,1,11,0,2221,417,425,8
"a24600b0e49245f6bdba8c893cfeddb0","a2b4bd40cee2481ebd3fc179d6a5cd62",22850121,1,-11,0,2222,425,417,-8
"a2b4bd40cee2481ebd3fc179d6a5cd62","24cf8786024543f19b89bc20034e60d7",22850121,1,18,0,2223,417,428,11
"f2a73be2f46840b182d7bd095378004e","5d290f75e44b4bdb8256c600debbb44d",22850121,1,-6,0,2225,429,426,-3
"a2b4bd40cee2481ebd3fc179d6a5cd62","5d290f75e44b4bdb8256c600debbb44d",22850121,1,13,0,2227,417,426,9
"5d290f75e44b4bdb8256c600debbb44d","f2a73be2f46840b182d7bd095378004e",22850121,1,6,0,2228,426,429,3
"f2a73be2f46840b182d7bd095378004e","604551fd4266430cb860fef58fa7dd61",22850121,1,1,0,2229,429,430,1
"604551fd4266430cb860fef58fa7dd61","604551fd4266430cb860fef58fa7dd61",22850121,5,0,1,2230,430,430,0
"604551fd4266430cb860fef58fa7dd61","dbde19fcce2a4c1abdc7f685c293a23f",22850121,1,-13,0,2235,430,422,-8
"a24600b0e49245f6bdba8c893cfeddb0","24cf8786024543f19b89bc20034e60d7",22850121,1,7,0,2238,425,428,3
"24cf8786024543f19b89bc20034e60d7","dce46f8904594a62a6377a3587aaa663",22850121,3,4,0,2239,428,431,3
"dce46f8904594a62a6377a3587aaa663","dce46f8904594a62a6377a3587aaa663",22850121,4,0,1,2240,431,431,0
"dce46f8904594a62a6377a3587aaa663","9b9d0a249052413c869753b99682b0ac",22850121,1,1,0,2241,431,432,1
"9b9d0a249052413c869753b99682b0ac","9b9d0a249052413c869753b99682b0ac",22850121,5,0,1,2242,432,432,0
"9b9d0a249052413c869753b99682b0ac","061c175cc90f45fbad883025394e78dd",22850121,1,1,0,2247,432,433,1
"061c175cc90f45fbad883025394e78dd","061c175cc90f45fbad883025394e78dd",22850121,3,0,1,2248,433,433,0
"061c175cc90f45fbad883025394e78dd","dce46f8904594a62a6377a3587aaa663",22850121,1,-2,0,2251,433,431,-2
"dce46f8904594a62a6377a3587aaa663","dbde19fcce2a4c1abdc7f685c293a23f",22850121,1,-15,0,2252,431,422,-9
"a24600b0e49245f6bdba8c893cfeddb0","66baf19b6b904b70922329068c63746d",22850121,1,-70,0,2254,425,376,-49
"66baf19b6b904b70922329068c63746d","b2f0d654738f48158edff28e8d3a546e",22850121,1,112,0,2255,376,449,73
"b2f0d654738f48158edff28e8d3a546e","b2f0d654738f48158edff28e8d3a546e",22850121,1,0,1,2256,449,449,0
"b2f0d654738f48158edff28e8d3a546e","24cf8786024543f19b89bc20034e60d7",22850121,1,-35,0,2257,449,428,-21
"dce46f8904594a62a6377a3587aaa663","66baf19b6b904b70922329068c63746d",22850121,2,-81,0,2262,431,376,-55
"66baf19b6b904b70922329068c63746d","9428d8bd9c5a47b2a235b254e5e27ded",22850121,1,116,0,2263,376,452,76
"9428d8bd9c5a47b2a235b254e5e27ded","b2f0d654738f48158edff28e8d3a546e",22850121,1,-4,0,2264,452,449,-3
"b2f0d654738f48158edff28e8d3a546e","f60ee41ec635499abd48168342d32c2f",22850121,1,5,0,2265,449,453,4
"f60ee41ec635499abd48168342d32c2f","f60ee41ec635499abd48168342d32c2f",22850121,52,0,1,2266,453,453,0
"f60ee41ec635499abd48168342d32c2f","b2f0d654738f48158edff28e8d3a546e",22850121,1,-5,0,2318,453,449,-4
"b2f0d654738f48158edff28e8d3a546e","f67fbf45a5f146ed866965bc57c7c001",22850121,1,8,0,2319,449,454,5
"f67fbf45a5f146ed866965bc57c7c001","f67fbf45a5f146ed866965bc57c7c001",22850121,10,0,1,2320,454,454,0
"f67fbf45a5f146ed866965bc57c7c001","d937afe49bd24a07a550dda1c1155122",22850121,1,1,0,2330,454,455,1
"d937afe49bd24a07a550dda1c1155122","d937afe49bd24a07a550dda1c1155122",22850121,5,0,1,2331,455,455,0
"d937afe49bd24a07a550dda1c1155122","3628b3f7823443d0912a339096b69943",22850121,1,1,0,2336,455,456,1
"3628b3f7823443d0912a339096b69943","3628b3f7823443d0912a339096b69943",22850121,3,0,1,2337,456,456,0
"3628b3f7823443d0912a339096b69943","9e049ee647cf43ecbcb5ed792a8e7588",22850121,1,1,0,2340,456,457,1
"9e049ee647cf43ecbcb5ed792a8e7588","9e049ee647cf43ecbcb5ed792a8e7588",22850121,5,0,1,2341,457,457,0
"9e049ee647cf43ecbcb5ed792a8e7588","5256a214faaf410b93f76cea06428334",22850121,1,1,0,2346,457,458,1
"5256a214faaf410b93f76cea06428334","5256a214faaf410b93f76cea06428334",22850121,5,0,1,2347,458,458,0
"5256a214faaf410b93f76cea06428334","25c32b120fce40fa9b6c85133aeb4716",22850121,1,1,0,2352,458,459,1
"25c32b120fce40fa9b6c85133aeb4716","25c32b120fce40fa9b6c85133aeb4716",22850121,5,0,1,2353,459,459,0
"25c32b120fce40fa9b6c85133aeb4716","11bc14f2204949008b7d511b933363c1",22850121,1,1,0,2358,459,460,1
"11bc14f2204949008b7d511b933363c1","11bc14f2204949008b7d511b933363c1",22850121,5,0,1,2359,460,460,0
"11bc14f2204949008b7d511b933363c1","42de338840a34d15adb66e7b14fb9d2c",22850121,1,1,0,2364,460,461,1
"42de338840a34d15adb66e7b14fb9d2c","42de338840a34d15adb66e7b14fb9d2c",22850121,11,0,1,2365,461,461,0
"42de338840a34d15adb66e7b14fb9d2c","9da37c6210b1416b8079c274f70bf600",22850121,1,1,0,2376,461,462,1
"9da37c6210b1416b8079c274f70bf600","9da37c6210b1416b8079c274f70bf600",22850121,9,0,1,2377,462,462,0
"9da37c6210b1416b8079c274f70bf600","519119f1deac45ff9ab4f13529be5c6e",22850121,1,1,0,2386,462,463,1
"519119f1deac45ff9ab4f13529be5c6e","519119f1deac45ff9ab4f13529be5c6e",22850121,5,0,1,2387,463,463,0
"519119f1deac45ff9ab4f13529be5c6e","f67fbf45a5f146ed866965bc57c7c001",22850121,1,-9,0,2392,463,454,-9
"f67fbf45a5f146ed866965bc57c7c001","c5df9f40ec14463b9dcfdc73df3e9285",22850121,1,12,0,2393,454,464,10
"c5df9f40ec14463b9dcfdc73df3e9285","c5df9f40ec14463b9dcfdc73df3e9285",22850121,5,0,1,2394,464,464,0
"c5df9f40ec14463b9dcfdc73df3e9285","83d42d95cd844fc093fc09cee250edb8",22850121,1,3,0,2397,464,465,1
"83d42d95cd844fc093fc09cee250edb8","83d42d95cd844fc093fc09cee250edb8",22850121,3,0,1,2398,465,465,0
"83d42d95cd844fc093fc09cee250edb8","66baf19b6b904b70922329068c63746d",22850121,1,-135,0,2401,465,376,-89
"66baf19b6b904b70922329068c63746d","d6d02b6ef04e4f17805504500b8ce441",22850121,1,-4,0,2402,376,375,-1
"d6d02b6ef04e4f17805504500b8ce441","24cf8786024543f19b89bc20034e60d7",22850121,1,81,0,2405,375,428,53
"dce46f8904594a62a6377a3587aaa663","66ada10dde9f43018588f1ced9d477fc",22850121,1,4,0,2407,431,434,3
"66ada10dde9f43018588f1ced9d477fc","83d42d95cd844fc093fc09cee250edb8",22850121,1,50,0,2408,434,465,31
"83d42d95cd844fc093fc09cee250edb8","dce46f8904594a62a6377a3587aaa663",22850121,1,-54,0,2409,465,431,-34
"66baf19b6b904b70922329068c63746d","24cf8786024543f19b89bc20034e60d7",22850121,1,77,0,2411,376,428,52
"24cf8786024543f19b89bc20034e60d7","66ada10dde9f43018588f1ced9d477fc",22850121,1,8,0,2412,428,434,6
"66ada10dde9f43018588f1ced9d477fc","74a7f8712e5449c2bc0b43c6f90dafed",22850121,1,1,0,2413,434,435,1
"74a7f8712e5449c2bc0b43c6f90dafed","74a7f8712e5449c2bc0b43c6f90dafed",22850121,3,0,1,2414,435,435,0
"74a7f8712e5449c2bc0b43c6f90dafed","66ada10dde9f43018588f1ced9d477fc",22850121,1,-1,0,2417,435,434,-1
"66ada10dde9f43018588f1ced9d477fc","bf12c96466d840a69bed7020b3f18bb8",22850121,1,3,0,2418,434,436,2
"bf12c96466d840a69bed7020b3f18bb8","bf12c96466d840a69bed7020b3f18bb8",22850121,3,0,1,2419,436,436,0
"bf12c96466d840a69bed7020b3f18bb8","070600601c4c439288445d2f0724807d",22850121,1,3,0,2422,436,437,1
"070600601c4c439288445d2f0724807d","24cf8786024543f19b89bc20034e60d7",22850121,1,-14,0,2423,437,428,-9
"24cf8786024543f19b89bc20034e60d7","1823b6de7d334a7aaabc4570719af4d9",22850121,1,16,0,2424,428,439,11
"1823b6de7d334a7aaabc4570719af4d9","66baf19b6b904b70922329068c63746d",22850121,1,-93,0,2425,439,376,-63
"66baf19b6b904b70922329068c63746d","070600601c4c439288445d2f0724807d",22850121,1,91,0,2426,376,437,61
"070600601c4c439288445d2f0724807d","070600601c4c439288445d2f0724807d",22850121,2,0,1,2427,437,437,0
"070600601c4c439288445d2f0724807d","1823b6de7d334a7aaabc4570719af4d9",22850121,2,2,0,2428,437,439,2
"1823b6de7d334a7aaabc4570719af4d9","1823b6de7d334a7aaabc4570719af4d9",22850121,12,0,1,2429,439,439,0
"1823b6de7d334a7aaabc4570719af4d9","070600601c4c439288445d2f0724807d",22850121,2,-2,0,2441,439,437,-2
"070600601c4c439288445d2f0724807d","0380cd76a7d44bc3a4da1f15e4d68f89",22850121,2,4,0,2442,437,440,3
"0380cd76a7d44bc3a4da1f15e4d68f89","0380cd76a7d44bc3a4da1f15e4d68f89",22850121,2,0,1,2443,440,440,0
"0380cd76a7d44bc3a4da1f15e4d68f89","23b7673c8b5443108c2ef09382834a86",22850121,2,2,0,2444,440,441,1
"23b7673c8b5443108c2ef09382834a86","23b7673c8b5443108c2ef09382834a86",22850121,1,0,1,2445,441,441,0
"23b7673c8b5443108c2ef09382834a86","901e92500aea43c79f19f1b279050668",22850121,1,2,0,2446,441,442,1
"901e92500aea43c79f19f1b279050668","901e92500aea43c79f19f1b279050668",22850121,1,0,1,2447,442,442,0
"901e92500aea43c79f19f1b279050668","001339db8ced4cf78829ebe8b145449d",22850121,1,1,0,2448,442,443,1
"001339db8ced4cf78829ebe8b145449d","001339db8ced4cf78829ebe8b145449d",22850121,11,0,1,2449,443,443,0
"001339db8ced4cf78829ebe8b145449d","452745e0366e42ae81561bfddebcc6c3",22850121,1,1,0,2460,443,444,1
"452745e0366e42ae81561bfddebcc6c3","452745e0366e42ae81561bfddebcc6c3",22850121,8,0,1,2461,444,444,0
"452745e0366e42ae81561bfddebcc6c3","4660ff2089114e8db82ceb26a4f329e3",22850121,1,2,0,2469,444,445,1
"4660ff2089114e8db82ceb26a4f329e3","901e92500aea43c79f19f1b279050668",22850121,1,-4,0,2470,445,442,-3
"901e92500aea43c79f19f1b279050668","4660ff2089114e8db82ceb26a4f329e3",22850121,1,4,0,2471,442,445,3
"4660ff2089114e8db82ceb26a4f329e3","7bd5586eb9d8484eb74a433ee7bfe499",22850121,1,2,0,2472,445,446,1
"7bd5586eb9d8484eb74a433ee7bfe499","7bd5586eb9d8484eb74a433ee7bfe499",22850121,17,0,1,2473,446,446,0
"7bd5586eb9d8484eb74a433ee7bfe499","8a7f26e690f34dda97be16904518ca99",22850121,1,2,0,2490,446,447,1
"8a7f26e690f34dda97be16904518ca99","8a7f26e690f34dda97be16904518ca99",22850121,3,0,1,2491,447,447,0
"8a7f26e690f34dda97be16904518ca99","b2f0d654738f48158edff28e8d3a546e",22850121,1,5,0,2494,447,449,2
"b2f0d654738f48158edff28e8d3a546e","070600601c4c439288445d2f0724807d",22850121,1,-21,0,2495,449,437,-12
"070600601c4c439288445d2f0724807d","d6d02b6ef04e4f17805504500b8ce441",22850121,1,-95,0,2496,437,375,-62
"d6d02b6ef04e4f17805504500b8ce441","070600601c4c439288445d2f0724807d",22850121,1,95,0,2501,375,437,62
"23b7673c8b5443108c2ef09382834a86","c5df9f40ec14463b9dcfdc73df3e9285",22850121,1,35,0,2508,441,464,23
"b613861cecf84ffcab01afb23f660475","b613861cecf84ffcab01afb23f660475",22850355,3,0,1,1,1,1,0
"b613861cecf84ffcab01afb23f660475","e2911e79efc2420eac45d9f671463d4b",22850355,1,3,0,4,1,2,1
"e2911e79efc2420eac45d9f671463d4b","e2911e79efc2420eac45d9f671463d4b",22850355,2,0,1,5,2,2,0
"e2911e79efc2420eac45d9f671463d4b","519d1b8c59404d67b54e96c5c8a830b2",22850355,1,1,0,7,2,3,1
"519d1b8c59404d67b54e96c5c8a830b2","519d1b8c59404d67b54e96c5c8a830b2",22850355,2,0,1,8,3,3,0
"519d1b8c59404d67b54e96c5c8a830b2","531db53f81f646edb0cdcfe0085b03b7",22850355,1,1,0,10,3,4,1
"531db53f81f646edb0cdcfe0085b03b7","531db53f81f646edb0cdcfe0085b03b7",22850355,2,0,1,11,4,4,0
"531db53f81f646edb0cdcfe0085b03b7","4f5f94b2f95141e0a9d53a61da2276da",22850355,1,1,0,13,4,5,1
"4f5f94b2f95141e0a9d53a61da2276da","4f5f94b2f95141e0a9d53a61da2276da",22850355,2,0,1,14,5,5,0
"4f5f94b2f95141e0a9d53a61da2276da","6d541c89590949f99af293c4f2333f67",22850355,1,1,0,16,5,6,1
"6d541c89590949f99af293c4f2333f67","6d541c89590949f99af293c4f2333f67",22850355,1,0,1,17,6,6,0
"6d541c89590949f99af293c4f2333f67","dd5cf0b9fe4c4f1d8f5ff8e4c04879cb",22850355,1,1,0,18,6,7,1
"dd5cf0b9fe4c4f1d8f5ff8e4c04879cb","dd5cf0b9fe4c4f1d8f5ff8e4c04879cb",22850355,2,0,1,19,7,7,0
"dd5cf0b9fe4c4f1d8f5ff8e4c04879cb","f96261861edc426abe2248be4f0a709a",22850355,1,1,0,21,7,8,1
"f96261861edc426abe2248be4f0a709a","f96261861edc426abe2248be4f0a709a",22850355,2,0,1,22,8,8,0
"f96261861edc426abe2248be4f0a709a","66b5e16f4f75454fb5b8172079f0fa83",22850355,1,1,0,24,8,9,1
"66b5e16f4f75454fb5b8172079f0fa83","66b5e16f4f75454fb5b8172079f0fa83",22850355,1,0,1,25,9,9,0
"66b5e16f4f75454fb5b8172079f0fa83","0680571d4698477995e41842c36a54b2",22850355,1,1,0,26,9,10,1
"0680571d4698477995e41842c36a54b2","0680571d4698477995e41842c36a54b2",22850355,1,0,1,27,10,10,0
"0680571d4698477995e41842c36a54b2","9112f2bffece48e08c6d2287be204085",22850355,1,1,0,28,10,11,1
"9112f2bffece48e08c6d2287be204085","9112f2bffece48e08c6d2287be204085",22850355,1,0,1,29,11,11,0
"9112f2bffece48e08c6d2287be204085","56586aa865414f538729c7f7735d2bc6",22850355,1,3,0,30,11,12,1
"56586aa865414f538729c7f7735d2bc6","e2911e79efc2420eac45d9f671463d4b",22850355,3,-12,0,31,12,2,-10
"e2911e79efc2420eac45d9f671463d4b","56586aa865414f538729c7f7735d2bc6",22850355,3,12,0,32,2,12,10
"56586aa865414f538729c7f7735d2bc6","56586aa865414f538729c7f7735d2bc6",22850355,3,0,1,33,12,12,0
"56586aa865414f538729c7f7735d2bc6","b7f2b31585d94eb3bf86376714aa7070",22850355,1,2,0,40,12,13,1
"b7f2b31585d94eb3bf86376714aa7070","b7f2b31585d94eb3bf86376714aa7070",22850355,3,0,1,41,13,13,0
"b7f2b31585d94eb3bf86376714aa7070","3f1c815879794b929260d224becaff7e",22850355,1,2,0,44,13,14,1
"3f1c815879794b929260d224becaff7e","5c5ceeee4562457ba6d41515aeebfbb1",22850355,1,6,0,45,14,17,3
"5c5ceeee4562457ba6d41515aeebfbb1","81c864a886d54a6b8ff85f7d736f4f95",22850355,1,-4,0,46,17,15,-2
"81c864a886d54a6b8ff85f7d736f4f95","5c5ceeee4562457ba6d41515aeebfbb1",22850355,1,4,0,47,15,17,2
"5c5ceeee4562457ba6d41515aeebfbb1","9afd71a5298d4333b6849dfce1b9422c",22850355,1,3,0,48,17,18,1
"9afd71a5298d4333b6849dfce1b9422c","56586aa865414f538729c7f7735d2bc6",22850355,1,-13,0,49,18,12,-6
"56586aa865414f538729c7f7735d2bc6","9afd71a5298d4333b6849dfce1b9422c",22850355,1,13,0,50,12,18,6
"9afd71a5298d4333b6849dfce1b9422c","b7719e26494940efa49512aedd0aac79",22850355,1,4,0,51,18,20,2
"b7719e26494940efa49512aedd0aac79","d4f45188d3c84a02ba08454e6403a818",22850355,1,5,0,52,20,24,4
"d4f45188d3c84a02ba08454e6403a818","d4c3b003e8274e429d2fa688d73fde6d",22850355,1,-2,0,53,24,22,-2
"d4c3b003e8274e429d2fa688d73fde6d","b7719e26494940efa49512aedd0aac79",22850355,1,-3,0,54,22,20,-2
"b7719e26494940efa49512aedd0aac79","afbf7250b99d47bea07172749483ca97",22850355,1,12,0,55,20,28,8
"afbf7250b99d47bea07172749483ca97","b7719e26494940efa49512aedd0aac79",22850355,1,-12,0,56,28,20,-8
"b7719e26494940efa49512aedd0aac79","4e51676dc72045d99c19b9fa7b22f8bc",22850355,1,15,0,57,20,29,9
"4e51676dc72045d99c19b9fa7b22f8bc","afbf7250b99d47bea07172749483ca97",22850355,1,-3,0,58,29,28,-1
"afbf7250b99d47bea07172749483ca97","4e51676dc72045d99c19b9fa7b22f8bc",22850355,1,3,0,59,28,29,1
"4e51676dc72045d99c19b9fa7b22f8bc","51970cfa30e643e894e66ae85c8024cc",22850355,1,3,0,60,29,31,2
"51970cfa30e643e894e66ae85c8024cc","c33c17be71ae4d588da7369472e5bb1b",22850355,1,6,0,61,31,34,3
"c33c17be71ae4d588da7369472e5bb1b","4e51676dc72045d99c19b9fa7b22f8bc",22850355,1,-9,0,62,34,29,-5
"4e51676dc72045d99c19b9fa7b22f8bc","c33c17be71ae4d588da7369472e5bb1b",22850355,1,9,0,63,29,34,5
"c33c17be71ae4d588da7369472e5bb1b","93679be414554a11b1893002f2229a93",22850355,1,3,0,64,34,35,1
"93679be414554a11b1893002f2229a93","7040a13096d746ac84b8fac8d9752058",22850355,1,3,0,65,35,36,1
"7040a13096d746ac84b8fac8d9752058","93679be414554a11b1893002f2229a93",22850355,1,-3,0,66,36,35,-1
"93679be414554a11b1893002f2229a93","9a0dc646f934470daf08c4b56ccf73db",22850355,1,6,0,67,35,37,2
"9a0dc646f934470daf08c4b56ccf73db","7040a13096d746ac84b8fac8d9752058",22850355,1,-3,0,68,37,36,-1
"7040a13096d746ac84b8fac8d9752058","fc0e049d56024bc9a02c9a9c435c3df7",22850355,1,6,0,69,36,38,2
"fc0e049d56024bc9a02c9a9c435c3df7","9a0dc646f934470daf08c4b56ccf73db",22850355,1,-3,0,70,38,37,-1
"9a0dc646f934470daf08c4b56ccf73db","67a089198fcb4e1c8f2385786c2b296f",22850355,1,7,0,71,37,39,2
"64d48c6c9c7940639a932219a6c87198","64d48c6c9c7940639a932219a6c87198",22850355,1,0,1,73,40,40,0
"67a089198fcb4e1c8f2385786c2b296f","b534b89233134e30a9b5645138bfa9ee",22850355,1,4,0,75,39,41,2
"b534b89233134e30a9b5645138bfa9ee","0e37b720d23b4e7f8b313e79313fd107",22850355,1,3,0,76,41,44,3
"0e37b720d23b4e7f8b313e79313fd107","0e37b720d23b4e7f8b313e79313fd107",22850355,2,0,1,77,44,44,0
"0e37b720d23b4e7f8b313e79313fd107","6875d67fdd5f48168b62719df449bebd",22850355,1,1,0,79,44,45,1
"6875d67fdd5f48168b62719df449bebd","6875d67fdd5f48168b62719df449bebd",22850355,1,0,1,80,45,45,0
"6875d67fdd5f48168b62719df449bebd","b534b89233134e30a9b5645138bfa9ee",22850355,1,-4,0,81,45,41,-4
"b534b89233134e30a9b5645138bfa9ee","6e13d61a7bdb44bca949c9f86fab3be5",22850355,3,7,0,82,41,47,6
"6e13d61a7bdb44bca949c9f86fab3be5","6e13d61a7bdb44bca949c9f86fab3be5",22850355,1,0,1,83,47,47,0
"6e13d61a7bdb44bca949c9f86fab3be5","b534b89233134e30a9b5645138bfa9ee",22850355,2,-7,0,84,47,41,-6
"6e13d61a7bdb44bca949c9f86fab3be5","195f78799f984cc2b06c48dfe36be751",22850355,1,2,0,88,47,49,2
"195f78799f984cc2b06c48dfe36be751","195f78799f984cc2b06c48dfe36be751",22850355,2,0,1,89,49,49,0
"195f78799f984cc2b06c48dfe36be751","d9c8d8c444a64dadbbb508652c721e17",22850355,1,-3,0,91,49,46,-3
"d9c8d8c444a64dadbbb508652c721e17","d0c74f735e024943943e40333d6d337f",22850355,1,6,0,92,46,51,5
"d0c74f735e024943943e40333d6d337f","d0c74f735e024943943e40333d6d337f",22850355,1,0,1,93,51,51,0
"d0c74f735e024943943e40333d6d337f","983f8ff320594b279a7f4a6fe132f9c5",22850355,1,2,0,94,51,53,2
"983f8ff320594b279a7f4a6fe132f9c5","983f8ff320594b279a7f4a6fe132f9c5",22850355,2,0,1,95,53,53,0
"983f8ff320594b279a7f4a6fe132f9c5","35adfa5d923046aebabfefd98f35ff05",22850355,1,1,0,97,53,54,1
"35adfa5d923046aebabfefd98f35ff05","35adfa5d923046aebabfefd98f35ff05",22850355,2,0,1,98,54,54,0
"35adfa5d923046aebabfefd98f35ff05","b6f8a98476224da1b40e555ececc7ed8",22850355,1,1,0,100,54,55,1
"b6f8a98476224da1b40e555ececc7ed8","b6f8a98476224da1b40e555ececc7ed8",22850355,2,0,1,101,55,55,0
"b6f8a98476224da1b40e555ececc7ed8","86e22cb5fe0e4b47a9489ecddf7ed78f",22850355,1,1,0,103,55,56,1
"86e22cb5fe0e4b47a9489ecddf7ed78f","86e22cb5fe0e4b47a9489ecddf7ed78f",22850355,2,0,1,104,56,56,0
"86e22cb5fe0e4b47a9489ecddf7ed78f","f924752d8a1149668870b1e7698486f7",22850355,1,-6,0,106,56,50,-6
"f924752d8a1149668870b1e7698486f7","78f30e4dcac84e3cbea8b2cc6e0d62b3",22850355,1,10,0,107,50,59,9
"78f30e4dcac84e3cbea8b2cc6e0d62b3","a1f2f12debe5432fb7a70bcd12bacfb9",22850355,1,-1,0,108,59,58,-1
"a1f2f12debe5432fb7a70bcd12bacfb9","a1f2f12debe5432fb7a70bcd12bacfb9",22850355,19,0,1,109,58,58,0
"a1f2f12debe5432fb7a70bcd12bacfb9","78f30e4dcac84e3cbea8b2cc6e0d62b3",22850355,1,1,0,128,58,59,1
"78f30e4dcac84e3cbea8b2cc6e0d62b3","78f30e4dcac84e3cbea8b2cc6e0d62b3",22850355,9,0,1,129,59,59,0
"78f30e4dcac84e3cbea8b2cc6e0d62b3","a0a418b8540d479fa6e0f653b701da8b",22850355,1,6,0,138,59,64,5
"a0a418b8540d479fa6e0f653b701da8b","bc42d26810654ea9a1df1efe1e58c7d5",22850355,1,-1,0,139,64,63,-1
"bc42d26810654ea9a1df1efe1e58c7d5","12aa6e1672ac4e7aa6449a7a8609cd72",22850355,1,-7,0,140,63,57,-6
"12aa6e1672ac4e7aa6449a7a8609cd72","4c943503763e4e349906eea3ed3c8e86",22850355,1,5,0,141,57,61,4
"4c943503763e4e349906eea3ed3c8e86","4c943503763e4e349906eea3ed3c8e86",22850355,1,0,1,142,61,61,0
"4c943503763e4e349906eea3ed3c8e86","309ccf3cc4fe429d9bfbaef53d3fa479",22850355,1,-1,0,143,61,60,-1
"309ccf3cc4fe429d9bfbaef53d3fa479","b534b89233134e30a9b5645138bfa9ee",22850355,1,-23,0,144,60,41,-19
"b534b89233134e30a9b5645138bfa9ee","d646286c8051419bbc2e31dd1db55ca8",22850355,1,33,0,145,41,67,26
"d646286c8051419bbc2e31dd1db55ca8","267f883678b24aed855fde42524975d9",22850355,1,4,0,146,67,71,4
"267f883678b24aed855fde42524975d9","267f883678b24aed855fde42524975d9",22850355,1,0,1,147,71,71,0
"267f883678b24aed855fde42524975d9","88fff56d0342490dbef9040750a20f6c",22850355,1,1,0,148,71,72,1
"88fff56d0342490dbef9040750a20f6c","88fff56d0342490dbef9040750a20f6c",22850355,3,0,1,149,72,72,0
"88fff56d0342490dbef9040750a20f6c","adb17b12b66c4a49a85fd34322f7df70",22850355,1,1,0,152,72,73,1
"adb17b12b66c4a49a85fd34322f7df70","adb17b12b66c4a49a85fd34322f7df70",22850355,1,0,1,153,73,73,0
"adb17b12b66c4a49a85fd34322f7df70","a2becd407db34b189200a32546d9d569",22850355,1,3,0,154,73,75,2
"a2becd407db34b189200a32546d9d569","d646286c8051419bbc2e31dd1db55ca8",22850355,1,-9,0,155,75,67,-8
"d646286c8051419bbc2e31dd1db55ca8","a2becd407db34b189200a32546d9d569",22850355,1,9,0,156,67,75,8
"a2becd407db34b189200a32546d9d569","58c22b011d0f4c2ea6d13615edbb9eeb",22850355,1,2,0,157,75,77,2
"58c22b011d0f4c2ea6d13615edbb9eeb","58c22b011d0f4c2ea6d13615edbb9eeb",22850355,2,0,1,158,77,77,0
"58c22b011d0f4c2ea6d13615edbb9eeb","dd76e1861dc9461c830888729d091ee0",22850355,1,1,0,160,77,78,1
"dd76e1861dc9461c830888729d091ee0","dd76e1861dc9461c830888729d091ee0",22850355,8,0,1,161,78,78,0
"dd76e1861dc9461c830888729d091ee0","cd1d828f1a694b87913a7ea66c23803e",22850355,1,1,0,169,78,79,1
"cd1d828f1a694b87913a7ea66c23803e","cd1d828f1a694b87913a7ea66c23803e",22850355,2,0,1,170,79,79,0
"cd1d828f1a694b87913a7ea66c23803e","9176a3c2b4d2465fa8b0c67096c2a97e",22850355,1,1,0,172,79,80,1
"9176a3c2b4d2465fa8b0c67096c2a97e","9176a3c2b4d2465fa8b0c67096c2a97e",22850355,5,0,1,173,80,80,0
"9176a3c2b4d2465fa8b0c67096c2a97e","f8ec6445f7194e25b9101d4fbcb07a18",22850355,1,1,0,178,80,81,1
"f8ec6445f7194e25b9101d4fbcb07a18","f8ec6445f7194e25b9101d4fbcb07a18",22850355,2,0,1,179,81,81,0
"f8ec6445f7194e25b9101d4fbcb07a18","140d5b27b8574befad82c0a013b59dfa",22850355,1,-7,0,181,81,74,-7
"140d5b27b8574befad82c0a013b59dfa","d18a9ea32855445f8736581f5cb119ce",22850355,1,9,0,182,74,82,8
"d18a9ea32855445f8736581f5cb119ce","f564483cbd7a407681aa2fcca518cf5f",22850355,1,4,0,183,82,85,3
"f564483cbd7a407681aa2fcca518cf5f","f564483cbd7a407681aa2fcca518cf5f",22850355,4,0,1,184,85,85,0
"f564483cbd7a407681aa2fcca518cf5f","18fd01350bd5434ca636d59a599d768a",22850355,1,1,0,188,85,86,1
"18fd01350bd5434ca636d59a599d768a","18fd01350bd5434ca636d59a599d768a",22850355,6,0,1,189,86,86,0
"18fd01350bd5434ca636d59a599d768a","6a9f0ef185fb47f0937e29daa1c71ed5",22850355,2,5,0,194,86,90,4
"6a9f0ef185fb47f0937e29daa1c71ed5","ae5ac430ea254e708a6f5deaaf7464ae",22850355,1,-7,0,195,90,84,-6
"ae5ac430ea254e708a6f5deaaf7464ae","18fd01350bd5434ca636d59a599d768a",22850355,1,2,0,196,84,86,2
"18fd01350bd5434ca636d59a599d768a","c681290961c94c4caf23b529d1ae6b9a",22850355,1,3,0,198,86,88,2
"c681290961c94c4caf23b529d1ae6b9a","c681290961c94c4caf23b529d1ae6b9a",22850355,5,0,1,199,88,88,0
"c681290961c94c4caf23b529d1ae6b9a","18fd01350bd5434ca636d59a599d768a",22850355,1,-3,0,201,88,86,-2
"6a9f0ef185fb47f0937e29daa1c71ed5","6a9f0ef185fb47f0937e29daa1c71ed5",22850355,4,0,1,203,90,90,0
"6a9f0ef185fb47f0937e29daa1c71ed5","c681290961c94c4caf23b529d1ae6b9a",22850355,2,-2,0,204,90,88,-2
"c681290961c94c4caf23b529d1ae6b9a","6a9f0ef185fb47f0937e29daa1c71ed5",22850355,1,2,0,206,88,90,2
"c681290961c94c4caf23b529d1ae6b9a","d646286c8051419bbc2e31dd1db55ca8",22850355,1,-25,0,211,88,67,-21
"d646286c8051419bbc2e31dd1db55ca8","e20db35ced8544ddac5bc3839145e463",22850355,1,30,0,212,67,91,24
"e20db35ced8544ddac5bc3839145e463","e20db35ced8544ddac5bc3839145e463",22850355,1,0,1,213,91,91,0
"e20db35ced8544ddac5bc3839145e463","67a089198fcb4e1c8f2385786c2b296f",22850355,1,-67,0,214,91,39,-52
"67a089198fcb4e1c8f2385786c2b296f","64d48c6c9c7940639a932219a6c87198",22850355,4,1,0,215,39,40,1
"64d48c6c9c7940639a932219a6c87198","67a089198fcb4e1c8f2385786c2b296f",22850355,2,-1,0,216,40,39,-1
"64d48c6c9c7940639a932219a6c87198","e20db35ced8544ddac5bc3839145e463",22850355,1,66,0,218,40,91,51
"e20db35ced8544ddac5bc3839145e463","1febb706d7a34005ae8711ed49c76e64",22850355,1,3,0,219,91,94,3
"1febb706d7a34005ae8711ed49c76e64","1febb706d7a34005ae8711ed49c76e64",22850355,2,0,1,220,94,94,0
"1febb706d7a34005ae8711ed49c76e64","8f73ba6f5a0042f2850356ac38ac6f24",22850355,1,1,0,222,94,95,1
"8f73ba6f5a0042f2850356ac38ac6f24","8f73ba6f5a0042f2850356ac38ac6f24",22850355,4,0,1,223,95,95,0
"8f73ba6f5a0042f2850356ac38ac6f24","e2260b86653c46d7b14a41fb419dbf8c",22850355,1,1,0,225,95,96,1
"e2260b86653c46d7b14a41fb419dbf8c","e2260b86653c46d7b14a41fb419dbf8c",22850355,2,0,1,226,96,96,0
"e2260b86653c46d7b14a41fb419dbf8c","35eb641ad1d845bbba54915bce75a962",22850355,1,1,0,228,96,97,1
"35eb641ad1d845bbba54915bce75a962","35eb641ad1d845bbba54915bce75a962",22850355,5,0,1,229,97,97,0
"35eb641ad1d845bbba54915bce75a962","08be90ffbeea4795a138cd42ed8db56f",22850355,1,1,0,234,97,98,1
"08be90ffbeea4795a138cd42ed8db56f","08be90ffbeea4795a138cd42ed8db56f",22850355,5,0,1,235,98,98,0
"08be90ffbeea4795a138cd42ed8db56f","3007433c8f584dcbb5ac159c1c5f2be3",22850355,1,1,0,240,98,99,1
"3007433c8f584dcbb5ac159c1c5f2be3","3007433c8f584dcbb5ac159c1c5f2be3",22850355,2,0,1,241,99,99,0
"3007433c8f584dcbb5ac159c1c5f2be3","00ae5f0c51874a73a41ebea838d95682",22850355,1,3,0,243,99,101,2
"00ae5f0c51874a73a41ebea838d95682","e20db35ced8544ddac5bc3839145e463",22850355,1,-11,0,244,101,91,-10
"e20db35ced8544ddac5bc3839145e463","d391c8b6e56a43a7b654e9dee02d904b",22850355,1,13,0,245,91,103,12
"d391c8b6e56a43a7b654e9dee02d904b","00ae5f0c51874a73a41ebea838d95682",22850355,1,-2,0,246,103,101,-2
"00ae5f0c51874a73a41ebea838d95682","d391c8b6e56a43a7b654e9dee02d904b",22850355,2,2,0,247,101,103,2
"d391c8b6e56a43a7b654e9dee02d904b","d391c8b6e56a43a7b654e9dee02d904b",22850355,15,0,1,248,103,103,0
"d391c8b6e56a43a7b654e9dee02d904b","6111116566fc4fd9abba409322bea245",22850355,1,1,0,263,103,104,1
"6111116566fc4fd9abba409322bea245","6111116566fc4fd9abba409322bea245",22850355,2,0,1,264,104,104,0
"6111116566fc4fd9abba409322bea245","a81b2235cb9c499eb9ea8ee0a8dd9725",22850355,1,1,0,266,104,105,1
"a81b2235cb9c499eb9ea8ee0a8dd9725","a81b2235cb9c499eb9ea8ee0a8dd9725",22850355,5,0,1,267,105,105,0
"a81b2235cb9c499eb9ea8ee0a8dd9725","2d4e0ab0ef3b4d73b82c72d4621a7579",22850355,1,1,0,272,105,106,1
"2d4e0ab0ef3b4d73b82c72d4621a7579","2d4e0ab0ef3b4d73b82c72d4621a7579",22850355,2,0,1,273,106,106,0
"2d4e0ab0ef3b4d73b82c72d4621a7579","8bdebf492ebd4e62b0d522e8ab5e5197",22850355,1,1,0,275,106,107,1
"8bdebf492ebd4e62b0d522e8ab5e5197","8bdebf492ebd4e62b0d522e8ab5e5197",22850355,4,0,1,276,107,107,0
"8bdebf492ebd4e62b0d522e8ab5e5197","73039f8c1eb9409cb4caee2cf968001e",22850355,1,-7,0,278,107,100,-7
"73039f8c1eb9409cb4caee2cf968001e","4280927ec4d643238aa49c32f9e06c6c",22850355,2,10,0,279,100,109,9
"4280927ec4d643238aa49c32f9e06c6c","4280927ec4d643238aa49c32f9e06c6c",22850355,1,0,1,280,109,109,0
"4280927ec4d643238aa49c32f9e06c6c","fc44e6a5f7654430af1227838224dceb",22850355,1,2,0,281,109,111,2
"fc44e6a5f7654430af1227838224dceb","fc44e6a5f7654430af1227838224dceb",22850355,5,0,1,282,111,111,0
"fc44e6a5f7654430af1227838224dceb","08111f75e22d409998cf8b85bd431f0a",22850355,1,-3,0,287,111,108,-3
"08111f75e22d409998cf8b85bd431f0a","a9ae0a3c070d455bb4369a8996313336",22850355,2,7,0,288,108,114,6
"a9ae0a3c070d455bb4369a8996313336","a9ae0a3c070d455bb4369a8996313336",22850355,2,0,1,289,114,114,0
"a9ae0a3c070d455bb4369a8996313336","71cec822bcff4f30a20e75dc63ef7b65",22850355,2,2,0,291,114,116,2
"71cec822bcff4f30a20e75dc63ef7b65","e20db35ced8544ddac5bc3839145e463",22850355,1,-28,0,292,116,91,-25
"e20db35ced8544ddac5bc3839145e463","8f73ba6f5a0042f2850356ac38ac6f24",22850355,1,4,0,293,91,95,4
"8f73ba6f5a0042f2850356ac38ac6f24","d391c8b6e56a43a7b654e9dee02d904b",22850355,1,9,0,296,95,103,8
"d391c8b6e56a43a7b654e9dee02d904b","e20db35ced8544ddac5bc3839145e463",22850355,1,-13,0,297,103,91,-12
"e20db35ced8544ddac5bc3839145e463","00ae5f0c51874a73a41ebea838d95682",22850355,2,11,0,298,91,101,10
"00ae5f0c51874a73a41ebea838d95682","73039f8c1eb9409cb4caee2cf968001e",22850355,1,-1,0,299,101,100,-1
"4280927ec4d643238aa49c32f9e06c6c","08111f75e22d409998cf8b85bd431f0a",22850355,1,-1,0,301,109,108,-1
"71cec822bcff4f30a20e75dc63ef7b65","71cec822bcff4f30a20e75dc63ef7b65",22850355,3,0,1,304,116,116,0
"71cec822bcff4f30a20e75dc63ef7b65","37319e88176d4aefa91d7a9980dbae91",22850355,1,-4,0,307,116,112,-4
"37319e88176d4aefa91d7a9980dbae91","62bff51286ef4f348717a3cf6fe2318f",22850355,1,9,0,308,112,120,8
"62bff51286ef4f348717a3cf6fe2318f","62bff51286ef4f348717a3cf6fe2318f",22850355,4,0,1,309,120,120,0
"62bff51286ef4f348717a3cf6fe2318f","e20db35ced8544ddac5bc3839145e463",22850355,1,-33,0,313,120,91,-29
"e20db35ced8544ddac5bc3839145e463","779f9ddd1fd14d1e9e69f72219a1fdbd",22850355,1,36,0,314,91,121,30
"779f9ddd1fd14d1e9e69f72219a1fdbd","779f9ddd1fd14d1e9e69f72219a1fdbd",22850355,2,0,1,315,121,121,0
"779f9ddd1fd14d1e9e69f72219a1fdbd","ae26e6cda8ad4a3f81bd347560d9579f",22850355,1,4,0,317,121,125,4
"ae26e6cda8ad4a3f81bd347560d9579f","ae26e6cda8ad4a3f81bd347560d9579f",22850355,3,0,1,318,125,125,0
"ae26e6cda8ad4a3f81bd347560d9579f","ee48df95832b4374aa273ceb27ec1315",22850355,1,1,0,321,125,126,1
"ee48df95832b4374aa273ceb27ec1315","ee48df95832b4374aa273ceb27ec1315",22850355,1,0,1,322,126,126,0
"ee48df95832b4374aa273ceb27ec1315","7a439da90b394756ad1777fc4c6dead5",22850355,1,1,0,323,126,127,1
"7a439da90b394756ad1777fc4c6dead5","779f9ddd1fd14d1e9e69f72219a1fdbd",22850355,1,-6,0,324,127,121,-6
"779f9ddd1fd14d1e9e69f72219a1fdbd","7a439da90b394756ad1777fc4c6dead5",22850355,1,6,0,325,121,127,6
"7a439da90b394756ad1777fc4c6dead5","a8dd5213034441ac92724b4e83eb0bb2",22850355,1,3,0,326,127,129,2
"a8dd5213034441ac92724b4e83eb0bb2","a8dd5213034441ac92724b4e83eb0bb2",22850355,3,0,1,327,129,129,0
"a8dd5213034441ac92724b4e83eb0bb2","8115eab6556b45f5b415c3b8c26a12e5",22850355,1,2,0,330,129,131,2
"8115eab6556b45f5b415c3b8c26a12e5","8115eab6556b45f5b415c3b8c26a12e5",22850355,2,0,1,331,131,131,0
"8115eab6556b45f5b415c3b8c26a12e5","ec34b06efd844b46a4c4818ecdb9b8f4",22850355,1,1,0,333,131,132,1
"ec34b06efd844b46a4c4818ecdb9b8f4","ec34b06efd844b46a4c4818ecdb9b8f4",22850355,2,0,1,334,132,132,0
"ec34b06efd844b46a4c4818ecdb9b8f4","c2e1c2b9eac64109b343a088584b576b",22850355,1,1,0,336,132,133,1
"c2e1c2b9eac64109b343a088584b576b","c2e1c2b9eac64109b343a088584b576b",22850355,2,0,1,337,133,133,0
"c2e1c2b9eac64109b343a088584b576b","579338175e0b4bbb8ef3b712b5d8b54e",22850355,1,-5,0,339,133,128,-5
"579338175e0b4bbb8ef3b712b5d8b54e","8bc5795d6a984a3eace4e2811e52dd4f",22850355,1,8,0,340,128,135,7
"8bc5795d6a984a3eace4e2811e52dd4f","8bc5795d6a984a3eace4e2811e52dd4f",22850355,1,0,1,341,135,135,0
"8bc5795d6a984a3eace4e2811e52dd4f","b416d47c56a742199b5d7c7f19d6503a",22850355,1,-1,0,342,135,134,-1
"b416d47c56a742199b5d7c7f19d6503a","cd4532ad48034873ba8bce2aac0c9808",22850355,1,4,0,343,134,137,3
"cd4532ad48034873ba8bce2aac0c9808","cd4532ad48034873ba8bce2aac0c9808",22850355,1,0,1,344,137,137,0
"cd4532ad48034873ba8bce2aac0c9808","779f9ddd1fd14d1e9e69f72219a1fdbd",22850355,1,-19,0,345,137,121,-16
"779f9ddd1fd14d1e9e69f72219a1fdbd","df1de691dafe4549a18a4398ee9dfaf9",22850355,1,23,0,346,121,139,18
"df1de691dafe4549a18a4398ee9dfaf9","6c5ad271a44743479bfaea29b1db8d02",22850355,2,4,0,347,139,143,4
"6c5ad271a44743479bfaea29b1db8d02","df1de691dafe4549a18a4398ee9dfaf9",22850355,1,-4,0,348,143,139,-4
"df1de691dafe4549a18a4398ee9dfaf9","df1de691dafe4549a18a4398ee9dfaf9",22850355,1,0,1,349,139,139,0
"6c5ad271a44743479bfaea29b1db8d02","6c5ad271a44743479bfaea29b1db8d02",22850355,1,0,1,351,143,143,0
"6c5ad271a44743479bfaea29b1db8d02","402bba41861d43acb52a5abb89e8831e",22850355,1,2,0,352,143,145,2
"402bba41861d43acb52a5abb89e8831e","402bba41861d43acb52a5abb89e8831e",22850355,2,0,1,353,145,145,0
"402bba41861d43acb52a5abb89e8831e","df1de691dafe4549a18a4398ee9dfaf9",22850355,1,-6,0,355,145,139,-6
"df1de691dafe4549a18a4398ee9dfaf9","8aae34f5ddbb4052a709b12e6b0d40fa",22850355,1,9,0,356,139,147,8
"8aae34f5ddbb4052a709b12e6b0d40fa","8aae34f5ddbb4052a709b12e6b0d40fa",22850355,2,0,1,357,147,147,0
"8aae34f5ddbb4052a709b12e6b0d40fa","645b3f0249f64f76af2e19eb4d0e55b7",22850355,1,2,0,359,147,149,2
"645b3f0249f64f76af2e19eb4d0e55b7","645b3f0249f64f76af2e19eb4d0e55b7",22850355,2,0,1,360,149,149,0
"645b3f0249f64f76af2e19eb4d0e55b7","7e7b8db5064d4369805ab370aac5ddfb",22850355,1,1,0,362,149,150,1
"7e7b8db5064d4369805ab370aac5ddfb","7e7b8db5064d4369805ab370aac5ddfb",22850355,2,0,1,363,150,150,0
"7e7b8db5064d4369805ab370aac5ddfb","8956d210ae7f41968fada86d4c979d6a",22850355,1,1,0,365,150,151,1
"8956d210ae7f41968fada86d4c979d6a","8956d210ae7f41968fada86d4c979d6a",22850355,2,0,1,366,151,151,0
"8956d210ae7f41968fada86d4c979d6a","f902b0f41b544d4dbf79664fd233648d",22850355,1,-5,0,368,151,146,-5
"f902b0f41b544d4dbf79664fd233648d","ae781e8b775e4ccd93bc800dad5c8376",22850355,1,8,0,369,146,153,7
"ae781e8b775e4ccd93bc800dad5c8376","ae781e8b775e4ccd93bc800dad5c8376",22850355,5,0,1,370,153,153,0
"ae781e8b775e4ccd93bc800dad5c8376","06882a8492d9499aa31555567f575ecb",22850355,1,1,0,375,153,154,1
"06882a8492d9499aa31555567f575ecb","06882a8492d9499aa31555567f575ecb",22850355,1,0,1,376,154,154,0
"06882a8492d9499aa31555567f575ecb","f293c508f409466a8f27ddd7d1e40b20",22850355,1,1,0,377,154,155,1
"f293c508f409466a8f27ddd7d1e40b20","f293c508f409466a8f27ddd7d1e40b20",22850355,2,0,1,378,155,155,0
"f293c508f409466a8f27ddd7d1e40b20","cc4ddef5bbbe48ebb605141b347c4ed1",22850355,1,1,0,380,155,156,1
"cc4ddef5bbbe48ebb605141b347c4ed1","f03480cf4eba413194d7af52fc0e7f28",22850355,1,-4,0,381,156,152,-4
"f03480cf4eba413194d7af52fc0e7f28","d313cec988a84645bee413e8d4724a4b",22850355,1,7,0,382,152,158,6
"d313cec988a84645bee413e8d4724a4b","cc4ddef5bbbe48ebb605141b347c4ed1",22850355,1,-3,0,383,158,156,-2
"cc4ddef5bbbe48ebb605141b347c4ed1","d313cec988a84645bee413e8d4724a4b",22850355,1,3,0,384,156,158,2
"d313cec988a84645bee413e8d4724a4b","d313cec988a84645bee413e8d4724a4b",22850355,3,0,1,385,158,158,0
"d313cec988a84645bee413e8d4724a4b","dc60696c76a74368a60f72246e47700d",22850355,1,1,0,388,158,159,1
"dc60696c76a74368a60f72246e47700d","dc60696c76a74368a60f72246e47700d",22850355,1,0,1,389,159,159,0
"dc60696c76a74368a60f72246e47700d","78adeee1fa2c4fe0bc73f7bca9fcee86",22850355,1,3,0,390,159,160,1
"78adeee1fa2c4fe0bc73f7bca9fcee86","df1de691dafe4549a18a4398ee9dfaf9",22850355,1,-26,0,391,160,139,-21
"df1de691dafe4549a18a4398ee9dfaf9","65202579580f4ad38d734b4ee39d22a8",22850355,1,31,0,392,139,164,25
"65202579580f4ad38d734b4ee39d22a8","65202579580f4ad38d734b4ee39d22a8",22850355,64,0,1,393,164,164,0
"65202579580f4ad38d734b4ee39d22a8","78adeee1fa2c4fe0bc73f7bca9fcee86",22850355,2,-5,0,396,164,160,-4
"78adeee1fa2c4fe0bc73f7bca9fcee86","65202579580f4ad38d734b4ee39d22a8",22850355,2,5,0,397,160,164,4
"78adeee1fa2c4fe0bc73f7bca9fcee86","3cbcea2be0984e7dbd5a48195af10ce7",22850355,1,8,0,451,160,165,5
"3cbcea2be0984e7dbd5a48195af10ce7","82e6285962b8400d9d6fc32436022a94",22850355,1,2,0,452,165,167,2
"82e6285962b8400d9d6fc32436022a94","3cbcea2be0984e7dbd5a48195af10ce7",22850355,1,-2,0,453,167,165,-2
"3cbcea2be0984e7dbd5a48195af10ce7","73039f8c1eb9409cb4caee2cf968001e",22850355,1,-83,0,454,165,100,-65
"73039f8c1eb9409cb4caee2cf968001e","e20db35ced8544ddac5bc3839145e463",22850355,1,-10,0,455,100,91,-9
"d391c8b6e56a43a7b654e9dee02d904b","8bdebf492ebd4e62b0d522e8ab5e5197",22850355,1,4,0,458,103,107,4
"8bdebf492ebd4e62b0d522e8ab5e5197","d18a9ea32855445f8736581f5cb119ce",22850355,1,-30,0,461,107,82,-25
"d18a9ea32855445f8736581f5cb119ce","d646286c8051419bbc2e31dd1db55ca8",22850355,1,-17,0,462,82,67,-15
"d646286c8051419bbc2e31dd1db55ca8","d18a9ea32855445f8736581f5cb119ce",22850355,1,17,0,463,67,82,15
"d18a9ea32855445f8736581f5cb119ce","ae5ac430ea254e708a6f5deaaf7464ae",22850355,1,3,0,464,82,84,2
"ae5ac430ea254e708a6f5deaaf7464ae","6a9f0ef185fb47f0937e29daa1c71ed5",22850355,1,7,0,465,84,90,6
"6a9f0ef185fb47f0937e29daa1c71ed5","67a089198fcb4e1c8f2385786c2b296f",22850355,1,-64,0,468,90,39,-51
"64d48c6c9c7940639a932219a6c87198","0c7262dff33c4087bc660ccf40f92f9c",22850355,1,168,0,470,40,169,129
"0c7262dff33c4087bc660ccf40f92f9c","b2275c3fad834f8d90737a2d9a6927d6",22850355,4,3,0,471,169,172,3
"b2275c3fad834f8d90737a2d9a6927d6","0c7262dff33c4087bc660ccf40f92f9c",22850355,3,-3,0,472,172,169,-3
"0c7262dff33c4087bc660ccf40f92f9c","a9ac840f098c4bd0a2ee896214ce29cd",22850355,2,-4,0,477,169,168,-1
"a9ac840f098c4bd0a2ee896214ce29cd","0c7262dff33c4087bc660ccf40f92f9c",22850355,1,4,0,478,168,169,1
"a9ac840f098c4bd0a2ee896214ce29cd","b2275c3fad834f8d90737a2d9a6927d6",22850355,1,7,0,480,168,172,4
"b2275c3fad834f8d90737a2d9a6927d6","78adeee1fa2c4fe0bc73f7bca9fcee86",22850355,1,-20,0,481,172,160,-12
"65202579580f4ad38d734b4ee39d22a8","3cbcea2be0984e7dbd5a48195af10ce7",22850355,1,3,0,492,164,165,1
"3cbcea2be0984e7dbd5a48195af10ce7","78adeee1fa2c4fe0bc73f7bca9fcee86",22850355,1,-8,0,493,165,160,-5
"78adeee1fa2c4fe0bc73f7bca9fcee86","82e6285962b8400d9d6fc32436022a94",22850355,1,10,0,494,160,167,7
"82e6285962b8400d9d6fc32436022a94","0c7262dff33c4087bc660ccf40f92f9c",22850355,1,7,0,495,167,169,2
"0c7262dff33c4087bc660ccf40f92f9c","0c7262dff33c4087bc660ccf40f92f9c",22850355,1,0,1,496,169,169,0
"b2275c3fad834f8d90737a2d9a6927d6","b2275c3fad834f8d90737a2d9a6927d6",22850355,22,0,1,498,172,172,0
"b2275c3fad834f8d90737a2d9a6927d6","eb515a26030b41f8a82a1e6114420bad",22850355,1,1,0,520,172,173,1
"eb515a26030b41f8a82a1e6114420bad","eb515a26030b41f8a82a1e6114420bad",22850355,2,0,1,521,173,173,0
"eb515a26030b41f8a82a1e6114420bad","0c7262dff33c4087bc660ccf40f92f9c",22850355,1,-4,0,523,173,169,-4
"0c7262dff33c4087bc660ccf40f92f9c","b42cc17b7de840f181a704558d0bc845",22850355,3,7,0,524,169,175,6
"b42cc17b7de840f181a704558d0bc845","b42cc17b7de840f181a704558d0bc845",22850355,2,0,1,525,175,175,0
"b42cc17b7de840f181a704558d0bc845","801f9e9135034f49bf5f8b4bdefedb41",22850355,2,2,0,526,175,177,2
"801f9e9135034f49bf5f8b4bdefedb41","801f9e9135034f49bf5f8b4bdefedb41",22850355,11,0,1,527,177,177,0
"801f9e9135034f49bf5f8b4bdefedb41","b87c552dd247427abe6ab5795b9c9d43",22850355,1,5,0,534,177,181,4
"b87c552dd247427abe6ab5795b9c9d43","ea38cc0e6e6e41edbabf210220808bf9",22850355,1,-2,0,535,181,179,-2
"ea38cc0e6e6e41edbabf210220808bf9","362fcb0699a14845ab29b2340093e528",22850355,1,-6,0,536,179,174,-5
"362fcb0699a14845ab29b2340093e528","ea38cc0e6e6e41edbabf210220808bf9",22850355,1,6,0,537,174,179,5
"ea38cc0e6e6e41edbabf210220808bf9","b87c552dd247427abe6ab5795b9c9d43",22850355,1,2,0,538,179,181,2
"b87c552dd247427abe6ab5795b9c9d43","b87c552dd247427abe6ab5795b9c9d43",22850355,8,0,1,539,181,181,0
"b87c552dd247427abe6ab5795b9c9d43","139b097acfca451689d80c9c6eebdf7b",22850355,1,-3,0,547,181,178,-3
"139b097acfca451689d80c9c6eebdf7b","30f660a1feb34582a739722532524f79",22850355,1,6,0,548,178,183,5
"30f660a1feb34582a739722532524f79","30f660a1feb34582a739722532524f79",22850355,5,0,1,549,183,183,0
"30f660a1feb34582a739722532524f79","2024b4885bd14338a39b7b509acbbd02",22850355,1,-1,0,554,183,182,-1
"2024b4885bd14338a39b7b509acbbd02","c3f63fe50d8e487c86bf8ef76c9cadd3",22850355,1,4,0,555,182,185,3
"c3f63fe50d8e487c86bf8ef76c9cadd3","c3f63fe50d8e487c86bf8ef76c9cadd3",22850355,1,0,1,556,185,185,0
"c3f63fe50d8e487c86bf8ef76c9cadd3","c8e371568a0c4391b25796ae4e91952e",22850355,1,3,0,557,185,186,1
"c8e371568a0c4391b25796ae4e91952e","0c7262dff33c4087bc660ccf40f92f9c",22850355,1,-23,0,558,186,169,-17
"0c7262dff33c4087bc660ccf40f92f9c","c8e371568a0c4391b25796ae4e91952e",22850355,1,23,0,559,169,186,17
"c8e371568a0c4391b25796ae4e91952e","ab11d94c6c8948ea90b88f19d2cd502b",22850355,4,5,0,560,186,190,4
"ab11d94c6c8948ea90b88f19d2cd502b","ab11d94c6c8948ea90b88f19d2cd502b",22850355,1,0,1,561,190,190,0
"ab11d94c6c8948ea90b88f19d2cd502b","f992451ed6ad4e68bb9e68ad6be7c4be",22850355,1,2,0,562,190,192,2
"f992451ed6ad4e68bb9e68ad6be7c4be","f992451ed6ad4e68bb9e68ad6be7c4be",22850355,1,0,1,563,192,192,0
"f992451ed6ad4e68bb9e68ad6be7c4be","07b44a7a51e94c78b411c753fc39dab0",22850355,1,-3,0,564,192,189,-3
"07b44a7a51e94c78b411c753fc39dab0","6cd2dcaac46847d4a0bc53f296d90375",22850355,1,6,0,565,189,194,5
"6cd2dcaac46847d4a0bc53f296d90375","6cd2dcaac46847d4a0bc53f296d90375",22850355,4,0,1,566,194,194,0
"6cd2dcaac46847d4a0bc53f296d90375","2d2580c9411c4972909db508d6956a58",22850355,2,2,0,568,194,196,2
"2d2580c9411c4972909db508d6956a58","2d2580c9411c4972909db508d6956a58",22850355,4,0,1,569,196,196,0
"2d2580c9411c4972909db508d6956a58","5bddb3d9ed264f3984702f048c7e5340",22850355,2,1,0,571,196,197,1
"5bddb3d9ed264f3984702f048c7e5340","5bddb3d9ed264f3984702f048c7e5340",22850355,4,0,1,572,197,197,0
"5bddb3d9ed264f3984702f048c7e5340","d5e8e2bd12a2466b9d6d90855f0eb079",22850355,2,1,0,574,197,198,1
"d5e8e2bd12a2466b9d6d90855f0eb079","d5e8e2bd12a2466b9d6d90855f0eb079",22850355,4,0,1,575,198,198,0
"d5e8e2bd12a2466b9d6d90855f0eb079","017d7ca8e0394b91aaadc9574df2202c",22850355,2,-5,0,577,198,193,-5
"017d7ca8e0394b91aaadc9574df2202c","54e8e9f0ea3e45c4bf3b8ac799ee31b1",22850355,1,8,0,578,193,200,7
"54e8e9f0ea3e45c4bf3b8ac799ee31b1","54e8e9f0ea3e45c4bf3b8ac799ee31b1",22850355,1,0,1,579,200,200,0
"54e8e9f0ea3e45c4bf3b8ac799ee31b1","c614a00911be4877a075f19315530fb0",22850355,1,1,0,580,200,201,1
"c614a00911be4877a075f19315530fb0","c614a00911be4877a075f19315530fb0",22850355,6,0,1,581,201,201,0
"c614a00911be4877a075f19315530fb0","a6c21bd8b95249c7972820a7a7d76aff",22850355,1,1,0,587,201,202,1
"a6c21bd8b95249c7972820a7a7d76aff","a6c21bd8b95249c7972820a7a7d76aff",22850355,1,0,1,588,202,202,0
"a6c21bd8b95249c7972820a7a7d76aff","bb329d880ab54120adaf203a693bb203",22850355,1,1,0,589,202,203,1
"bb329d880ab54120adaf203a693bb203","bb329d880ab54120adaf203a693bb203",22850355,1,0,1,590,203,203,0
"bb329d880ab54120adaf203a693bb203","f9170dd6bc6442b4acd832747609b09a",22850355,1,-4,0,591,203,199,-4
"f9170dd6bc6442b4acd832747609b09a","d7f13c8d63ec4e2aa673fbb9cf9c6933",22850355,1,10,0,592,199,206,7
"d7f13c8d63ec4e2aa673fbb9cf9c6933","c8e371568a0c4391b25796ae4e91952e",22850355,1,-26,0,593,206,186,-20
"c8e371568a0c4391b25796ae4e91952e","b9e80f77c3a44349863b19875725c384",22850355,1,27,0,594,186,207,21
"b9e80f77c3a44349863b19875725c384","7108f0e4c2584f1f9c471689ae4c885c",22850355,2,1,0,595,207,208,1
"7108f0e4c2584f1f9c471689ae4c885c","c8e371568a0c4391b25796ae4e91952e",22850355,1,-28,0,596,208,186,-22
"c8e371568a0c4391b25796ae4e91952e","c8e371568a0c4391b25796ae4e91952e",22850355,3,0,1,597,186,186,0
"c8e371568a0c4391b25796ae4e91952e","362fcb0699a14845ab29b2340093e528",22850355,1,-17,0,598,186,174,-12
"362fcb0699a14845ab29b2340093e528","0c7262dff33c4087bc660ccf40f92f9c",22850355,2,-6,0,599,174,169,-5
"801f9e9135034f49bf5f8b4bdefedb41","362fcb0699a14845ab29b2340093e528",22850355,1,-3,0,606,177,174,-3
"b42cc17b7de840f181a704558d0bc845","c8e371568a0c4391b25796ae4e91952e",22850355,1,16,0,610,175,186,11
"ab11d94c6c8948ea90b88f19d2cd502b","c8e371568a0c4391b25796ae4e91952e",22850355,3,-5,0,613,190,186,-4
"c8e371568a0c4391b25796ae4e91952e","b54257a550b94ebc9538f3a90eee9d7e",22850355,1,22,0,616,186,204,18
"b54257a550b94ebc9538f3a90eee9d7e","c8e371568a0c4391b25796ae4e91952e",22850355,1,-22,0,617,204,186,-18
"c8e371568a0c4391b25796ae4e91952e","334c2344009840079b1d0e1b7ce3d5a7",22850355,1,23,0,618,186,205,19
"334c2344009840079b1d0e1b7ce3d5a7","334c2344009840079b1d0e1b7ce3d5a7",22850355,1,0,1,619,205,205,0
"334c2344009840079b1d0e1b7ce3d5a7","017d7ca8e0394b91aaadc9574df2202c",22850355,1,-14,0,620,205,193,-12
"017d7ca8e0394b91aaadc9574df2202c","c8e371568a0c4391b25796ae4e91952e",22850355,3,-9,0,621,193,186,-7
"c8e371568a0c4391b25796ae4e91952e","6cd2dcaac46847d4a0bc53f296d90375",22850355,2,10,0,622,186,194,8
"6cd2dcaac46847d4a0bc53f296d90375","017d7ca8e0394b91aaadc9574df2202c",22850355,2,-1,0,624,194,193,-1
"c8e371568a0c4391b25796ae4e91952e","7d932b23e1c84326ae5aa4d3c0d813d1",22850355,1,2,0,627,186,188,2
"7d932b23e1c84326ae5aa4d3c0d813d1","7d932b23e1c84326ae5aa4d3c0d813d1",22850355,3,0,1,628,188,188,0
"7d932b23e1c84326ae5aa4d3c0d813d1","c8e371568a0c4391b25796ae4e91952e",22850355,1,-2,0,631,188,186,-2
"c8e371568a0c4391b25796ae4e91952e","017d7ca8e0394b91aaadc9574df2202c",22850355,1,9,0,634,186,193,7
"017d7ca8e0394b91aaadc9574df2202c","6cd2dcaac46847d4a0bc53f296d90375",22850355,1,1,0,635,193,194,1
"017d7ca8e0394b91aaadc9574df2202c","d7f13c8d63ec4e2aa673fbb9cf9c6933",22850355,1,17,0,646,193,206,13
"d7f13c8d63ec4e2aa673fbb9cf9c6933","d7f13c8d63ec4e2aa673fbb9cf9c6933",22850355,1,0,1,647,206,206,0
"d7f13c8d63ec4e2aa673fbb9cf9c6933","7108f0e4c2584f1f9c471689ae4c885c",22850355,1,2,0,648,206,208,2
"7108f0e4c2584f1f9c471689ae4c885c","b9e80f77c3a44349863b19875725c384",22850355,1,-1,0,649,208,207,-1
"b9e80f77c3a44349863b19875725c384","b9e80f77c3a44349863b19875725c384",22850355,16,0,1,650,207,207,0
"7108f0e4c2584f1f9c471689ae4c885c","7108f0e4c2584f1f9c471689ae4c885c",22850355,11,0,1,667,208,208,0
"7108f0e4c2584f1f9c471689ae4c885c","d7f13c8d63ec4e2aa673fbb9cf9c6933",22850355,1,-2,0,678,208,206,-2
"d7f13c8d63ec4e2aa673fbb9cf9c6933","09400e101c5d4b439cf9a26b03aae558",22850355,3,5,0,679,206,210,4
"09400e101c5d4b439cf9a26b03aae558","09400e101c5d4b439cf9a26b03aae558",22850355,2,0,1,680,210,210,0
"09400e101c5d4b439cf9a26b03aae558","a88efa7e50ce47159810ab553afa6d3a",22850355,1,2,0,681,210,212,2
"a88efa7e50ce47159810ab553afa6d3a","a88efa7e50ce47159810ab553afa6d3a",22850355,5,0,1,682,212,212,0
"a88efa7e50ce47159810ab553afa6d3a","be502a7a43c44bf7b682698de79d9369",22850355,1,3,0,687,212,214,2
"be502a7a43c44bf7b682698de79d9369","f7fb1952f56b4189b86a9f8b7862d2b8",22850355,2,1,0,688,214,215,1
"f7fb1952f56b4189b86a9f8b7862d2b8","a875096404ef4a9984b62d74cda916f9",22850355,1,-7,0,689,215,209,-6
"a875096404ef4a9984b62d74cda916f9","be502a7a43c44bf7b682698de79d9369",22850355,1,6,0,690,209,214,5
"f7fb1952f56b4189b86a9f8b7862d2b8","f7fb1952f56b4189b86a9f8b7862d2b8",22850355,34,0,1,692,215,215,0
"f7fb1952f56b4189b86a9f8b7862d2b8","b860ee85d8bc4a2f97958cfb71be3533",22850355,1,1,0,726,215,216,1
"b860ee85d8bc4a2f97958cfb71be3533","b860ee85d8bc4a2f97958cfb71be3533",22850355,2,0,1,727,216,216,0
"b860ee85d8bc4a2f97958cfb71be3533","ec341f459285443b8361f7f15638ff08",22850355,1,-3,0,729,216,213,-3
"ec341f459285443b8361f7f15638ff08","363837c182e04711840d896ae1e0339c",22850355,1,6,0,730,213,218,5
"363837c182e04711840d896ae1e0339c","363837c182e04711840d896ae1e0339c",22850355,13,0,1,731,218,218,0
"363837c182e04711840d896ae1e0339c","01b2051f8941460d89945e3b02d1ce78",22850355,1,-1,0,744,218,217,-1
"01b2051f8941460d89945e3b02d1ce78","91125ca626c5470eb145501f8c37f8db",22850355,1,4,0,745,217,220,3
"91125ca626c5470eb145501f8c37f8db","91125ca626c5470eb145501f8c37f8db",22850355,1,0,1,746,220,220,0
"91125ca626c5470eb145501f8c37f8db","1c6721b1f63f4d30ba7746ea8af02a52",22850355,1,3,0,747,220,221,1
"1c6721b1f63f4d30ba7746ea8af02a52","d7f13c8d63ec4e2aa673fbb9cf9c6933",22850355,1,-21,0,748,221,206,-15
"d7f13c8d63ec4e2aa673fbb9cf9c6933","77ecef8eff6b4a2caea7707669bf7475",22850355,1,22,0,749,206,222,16
"77ecef8eff6b4a2caea7707669bf7475","a875096404ef4a9984b62d74cda916f9",22850355,1,-18,0,750,222,209,-13
"a875096404ef4a9984b62d74cda916f9","d7f13c8d63ec4e2aa673fbb9cf9c6933",22850355,2,-4,0,751,209,206,-3
"09400e101c5d4b439cf9a26b03aae558","1c6721b1f63f4d30ba7746ea8af02a52",22850355,1,16,0,753,210,221,11
"1c6721b1f63f4d30ba7746ea8af02a52","1c6721b1f63f4d30ba7746ea8af02a52",22850355,2,0,1,754,221,221,0
"1c6721b1f63f4d30ba7746ea8af02a52","77ecef8eff6b4a2caea7707669bf7475",22850355,2,1,0,755,221,222,1
"77ecef8eff6b4a2caea7707669bf7475","77ecef8eff6b4a2caea7707669bf7475",22850355,14,0,1,756,222,222,0
"77ecef8eff6b4a2caea7707669bf7475","d03cb855c70044cf8c35d9ec0de696e3",22850355,1,3,0,770,222,224,2
"d03cb855c70044cf8c35d9ec0de696e3","8b9ae98743bd4d4a8a87dff1c1244211",22850355,6,3,0,771,224,227,3
"8b9ae98743bd4d4a8a87dff1c1244211","1c6721b1f63f4d30ba7746ea8af02a52",22850355,1,-7,0,772,227,221,-6
"1c6721b1f63f4d30ba7746ea8af02a52","d03cb855c70044cf8c35d9ec0de696e3",22850355,3,4,0,773,221,224,3
"d03cb855c70044cf8c35d9ec0de696e3","a49a937d6896486d9a5396654abcf2e1",22850355,2,2,0,774,224,226,2
"a49a937d6896486d9a5396654abcf2e1","a49a937d6896486d9a5396654abcf2e1",22850355,2,0,1,775,226,226,0
"a49a937d6896486d9a5396654abcf2e1","d03cb855c70044cf8c35d9ec0de696e3",22850355,1,-2,0,776,226,224,-2
"8b9ae98743bd4d4a8a87dff1c1244211","8b9ae98743bd4d4a8a87dff1c1244211",22850355,19,0,1,778,227,227,0
"8b9ae98743bd4d4a8a87dff1c1244211","f7906d6f59b9489a91d2ef40db5a474d",22850355,1,-4,0,797,227,223,-4
"f7906d6f59b9489a91d2ef40db5a474d","2ab1535aac1346ba8801535bf729ef37",22850355,3,7,0,798,223,229,6
"2ab1535aac1346ba8801535bf729ef37","2ab1535aac1346ba8801535bf729ef37",22850355,2,0,1,799,229,229,0
"2ab1535aac1346ba8801535bf729ef37","a4f40fb48a8542c8949bae1f002cd9bc",22850355,1,2,0,800,229,231,2
"a4f40fb48a8542c8949bae1f002cd9bc","a4f40fb48a8542c8949bae1f002cd9bc",22850355,2,0,1,801,231,231,0
"a4f40fb48a8542c8949bae1f002cd9bc","8972c23e32044edb8a78fa1eed4e5947",22850355,1,1,0,803,231,232,1
"8972c23e32044edb8a78fa1eed4e5947","8972c23e32044edb8a78fa1eed4e5947",22850355,1,0,1,804,232,232,0
"8972c23e32044edb8a78fa1eed4e5947","92feb4a40f8344d38b6f722e42a53295",22850355,1,1,0,805,232,233,1
"92feb4a40f8344d38b6f722e42a53295","92feb4a40f8344d38b6f722e42a53295",22850355,2,0,1,806,233,233,0
"92feb4a40f8344d38b6f722e42a53295","5152833676bf4c6cb317060be10f68db",22850355,1,-5,0,808,233,228,-5
"5152833676bf4c6cb317060be10f68db","ca3e28f290354c08aefe5b0f769604e6",22850355,1,8,0,809,228,235,7
"ca3e28f290354c08aefe5b0f769604e6","ca3e28f290354c08aefe5b0f769604e6",22850355,9,0,1,810,235,235,0
"ca3e28f290354c08aefe5b0f769604e6","79a35eea833e4c2c9d22fc53c3c6445c",22850355,1,1,0,819,235,236,1
"79a35eea833e4c2c9d22fc53c3c6445c","79a35eea833e4c2c9d22fc53c3c6445c",22850355,14,0,1,820,236,236,0
"79a35eea833e4c2c9d22fc53c3c6445c","8f68228b1518449e9615cdafee41a2bd",22850355,1,1,0,834,236,237,1
"8f68228b1518449e9615cdafee41a2bd","8f68228b1518449e9615cdafee41a2bd",22850355,1,0,1,835,237,237,0
"8f68228b1518449e9615cdafee41a2bd","cab89fa5c3ed45a5aa550fc0352d6a42",22850355,1,1,0,836,237,238,1
"cab89fa5c3ed45a5aa550fc0352d6a42","cab89fa5c3ed45a5aa550fc0352d6a42",22850355,5,0,1,837,238,238,0
"cab89fa5c3ed45a5aa550fc0352d6a42","66d4fad4f1cf4b46be0750a99ad7a35a",22850355,1,1,0,842,238,239,1
"66d4fad4f1cf4b46be0750a99ad7a35a","66d4fad4f1cf4b46be0750a99ad7a35a",22850355,1,0,1,843,239,239,0
"66d4fad4f1cf4b46be0750a99ad7a35a","0b04c8e2f86d48c7aeb7e225819cd32b",22850355,1,-5,0,844,239,234,-5
"0b04c8e2f86d48c7aeb7e225819cd32b","f53da5fd9bfe412da4b80d4742563b6c",22850355,1,8,0,845,234,241,7
"f53da5fd9bfe412da4b80d4742563b6c","f53da5fd9bfe412da4b80d4742563b6c",22850355,1,0,1,846,241,241,0
"f53da5fd9bfe412da4b80d4742563b6c","2ae94c0cea4d480a9d5dca8fb1d7b542",22850355,1,3,0,847,241,242,1
"2ae94c0cea4d480a9d5dca8fb1d7b542","1c6721b1f63f4d30ba7746ea8af02a52",22850355,1,-27,0,848,242,221,-21
"1c6721b1f63f4d30ba7746ea8af02a52","1ebf23f9d994469a85206e4c7b1bf5f5",22850355,1,30,0,849,221,245,24
"1ebf23f9d994469a85206e4c7b1bf5f5","1c6721b1f63f4d30ba7746ea8af02a52",22850355,1,-30,0,850,245,221,-24
"1c6721b1f63f4d30ba7746ea8af02a52","f7906d6f59b9489a91d2ef40db5a474d",22850355,2,3,0,851,221,223,2
"f7906d6f59b9489a91d2ef40db5a474d","d03cb855c70044cf8c35d9ec0de696e3",22850355,3,1,0,852,223,224,1
"8b9ae98743bd4d4a8a87dff1c1244211","d03cb855c70044cf8c35d9ec0de696e3",22850355,4,-3,0,854,227,224,-3
"d03cb855c70044cf8c35d9ec0de696e3","5152833676bf4c6cb317060be10f68db",22850355,1,5,0,855,224,228,4
"5152833676bf4c6cb317060be10f68db","1c6721b1f63f4d30ba7746ea8af02a52",22850355,1,-9,0,856,228,221,-7
"1c6721b1f63f4d30ba7746ea8af02a52","2ab1535aac1346ba8801535bf729ef37",22850355,1,10,0,857,221,229,8
"2ab1535aac1346ba8801535bf729ef37","2ae94c0cea4d480a9d5dca8fb1d7b542",22850355,1,17,0,859,229,242,13
"2ae94c0cea4d480a9d5dca8fb1d7b542","1ebf23f9d994469a85206e4c7b1bf5f5",22850355,1,3,0,861,242,245,3
"1ebf23f9d994469a85206e4c7b1bf5f5","1ebf23f9d994469a85206e4c7b1bf5f5",22850355,14,0,1,862,245,245,0
"1ebf23f9d994469a85206e4c7b1bf5f5","85ae675b83e8422da842cfd25596af99",22850355,1,1,0,876,245,246,1
"85ae675b83e8422da842cfd25596af99","85ae675b83e8422da842cfd25596af99",22850355,3,0,1,877,246,246,0
"85ae675b83e8422da842cfd25596af99","fa235f0f364d47e4ae1c87f47bf8e6ba",22850355,1,8,0,880,246,252,6
"fa235f0f364d47e4ae1c87f47bf8e6ba","2ae94c0cea4d480a9d5dca8fb1d7b542",22850355,1,-12,0,881,252,242,-10
"2ae94c0cea4d480a9d5dca8fb1d7b542","fa235f0f364d47e4ae1c87f47bf8e6ba",22850355,1,12,0,882,242,252,10
"fa235f0f364d47e4ae1c87f47bf8e6ba","79f7845465cc4ed19d8e4f1429541be0",22850355,1,2,0,883,252,254,2
"79f7845465cc4ed19d8e4f1429541be0","79f7845465cc4ed19d8e4f1429541be0",22850355,8,0,1,884,254,254,0
"79f7845465cc4ed19d8e4f1429541be0","6e83e23f56544a19b94067c1c558d9c0",22850355,1,-8,0,892,254,247,-7
"6e83e23f56544a19b94067c1c558d9c0","00f61990949545828dd12f1303d47504",22850355,1,11,0,893,247,256,9
"00f61990949545828dd12f1303d47504","ead7bb4b64e247d2ae632ab8a296b091",22850355,1,2,0,895,256,258,2
"ead7bb4b64e247d2ae632ab8a296b091","ead7bb4b64e247d2ae632ab8a296b091",22850355,2,0,1,896,258,258,0
"ead7bb4b64e247d2ae632ab8a296b091","41b0048dde734bb280bac6116baa8e27",22850355,1,1,0,898,258,259,1
"41b0048dde734bb280bac6116baa8e27","41b0048dde734bb280bac6116baa8e27",22850355,2,0,1,899,259,259,0
"41b0048dde734bb280bac6116baa8e27","b41c5a094a604ee0915327da5cc0beb7",22850355,1,1,0,901,259,260,1
"b41c5a094a604ee0915327da5cc0beb7","b41c5a094a604ee0915327da5cc0beb7",22850355,4,0,1,902,260,260,0
"b41c5a094a604ee0915327da5cc0beb7","d546341988904f069cfa86b21457d9d9",22850355,2,-10,0,904,260,251,-9
"d546341988904f069cfa86b21457d9d9","28c171777c52431ab6b925073bd63d46",22850355,1,15,0,905,251,264,13
"28c171777c52431ab6b925073bd63d46","28c171777c52431ab6b925073bd63d46",22850355,7,0,1,906,264,264,0
"28c171777c52431ab6b925073bd63d46","ac160db940cb49ae8579162b1d52bb5d",22850355,1,2,0,913,264,266,2
"ac160db940cb49ae8579162b1d52bb5d","ac160db940cb49ae8579162b1d52bb5d",22850355,11,0,1,914,266,266,0
"ac160db940cb49ae8579162b1d52bb5d","d989ebcfc12a4b669f0100dc1aa14f1e",22850355,1,-12,0,925,266,255,-11
"d989ebcfc12a4b669f0100dc1aa14f1e","c6fd49b485cc4874b0bbdd9c6171e09c",22850355,1,15,0,926,255,268,13
"c6fd49b485cc4874b0bbdd9c6171e09c","c6fd49b485cc4874b0bbdd9c6171e09c",22850355,7,0,1,927,268,268,0
"c6fd49b485cc4874b0bbdd9c6171e09c","44240778a97c4af0937817499b75707b",22850355,1,1,0,934,268,269,1
"44240778a97c4af0937817499b75707b","44240778a97c4af0937817499b75707b",22850355,2,0,1,935,269,269,0
"44240778a97c4af0937817499b75707b","7aa76d3e993840d8805f097cbdbcd44b",22850355,1,-9,0,937,269,261,-8
"7aa76d3e993840d8805f097cbdbcd44b","865a4d3b43374da7944dc7d397f566d9",22850355,1,12,0,938,261,271,10
"865a4d3b43374da7944dc7d397f566d9","865a4d3b43374da7944dc7d397f566d9",22850355,1,0,1,939,271,271,0
"865a4d3b43374da7944dc7d397f566d9","2ae94c0cea4d480a9d5dca8fb1d7b542",22850355,1,-35,0,940,271,242,-29
"2ae94c0cea4d480a9d5dca8fb1d7b542","0d987bed3ffa4ed0b9a2e62e97b7b30f",22850355,1,38,0,941,242,272,30
"0d987bed3ffa4ed0b9a2e62e97b7b30f","a875096404ef4a9984b62d74cda916f9",22850355,1,-82,0,942,272,209,-63
"09400e101c5d4b439cf9a26b03aae558","f7906d6f59b9489a91d2ef40db5a474d",22850355,1,19,0,946,210,223,13
"f7906d6f59b9489a91d2ef40db5a474d","1c6721b1f63f4d30ba7746ea8af02a52",22850355,1,-3,0,947,223,221,-2
"d03cb855c70044cf8c35d9ec0de696e3","1c6721b1f63f4d30ba7746ea8af02a52",22850355,2,-4,0,951,224,221,-3
"77ecef8eff6b4a2caea7707669bf7475","f7906d6f59b9489a91d2ef40db5a474d",22850355,1,2,0,954,222,223,1
"a49a937d6896486d9a5396654abcf2e1","2ab1535aac1346ba8801535bf729ef37",22850355,1,4,0,962,226,229,3
"2ab1535aac1346ba8801535bf729ef37","f7906d6f59b9489a91d2ef40db5a474d",22850355,2,-7,0,963,229,223,-6
"2ab1535aac1346ba8801535bf729ef37","5152833676bf4c6cb317060be10f68db",22850355,2,-1,0,965,229,228,-1
"00f61990949545828dd12f1303d47504","b41c5a094a604ee0915327da5cc0beb7",22850355,1,4,0,970,256,260,4
"bb5a47f5ea01454a8b79455422d3b9da","017d7ca8e0394b91aaadc9574df2202c",22850355,1,-113,0,986,280,193,-87
"017d7ca8e0394b91aaadc9574df2202c","1c6721b1f63f4d30ba7746ea8af02a52",22850355,1,38,0,991,193,221,28
"d03cb855c70044cf8c35d9ec0de696e3","2ab1535aac1346ba8801535bf729ef37",22850355,1,6,0,996,224,229,5
"5152833676bf4c6cb317060be10f68db","d546341988904f069cfa86b21457d9d9",22850355,2,29,0,1000,228,251,23
"d546341988904f069cfa86b21457d9d9","2ae94c0cea4d480a9d5dca8fb1d7b542",22850355,3,-11,0,1001,251,242,-9
"2ae94c0cea4d480a9d5dca8fb1d7b542","2ae94c0cea4d480a9d5dca8fb1d7b542",22850355,3,0,1,1002,242,242,0
"2ae94c0cea4d480a9d5dca8fb1d7b542","00f61990949545828dd12f1303d47504",22850355,3,17,0,1004,242,256,14
"00f61990949545828dd12f1303d47504","00f61990949545828dd12f1303d47504",22850355,4,0,1,1005,256,256,0
"00f61990949545828dd12f1303d47504","d546341988904f069cfa86b21457d9d9",22850355,3,-6,0,1006,256,251,-5
"d546341988904f069cfa86b21457d9d9","00f61990949545828dd12f1303d47504",22850355,1,6,0,1010,251,256,5
"d546341988904f069cfa86b21457d9d9","0d987bed3ffa4ed0b9a2e62e97b7b30f",22850355,2,27,0,1013,251,272,21
"0d987bed3ffa4ed0b9a2e62e97b7b30f","0d987bed3ffa4ed0b9a2e62e97b7b30f",22850355,4,0,1,1014,272,272,0
"0d987bed3ffa4ed0b9a2e62e97b7b30f","bb5a47f5ea01454a8b79455422d3b9da",22850355,3,10,0,1016,272,280,8
"bb5a47f5ea01454a8b79455422d3b9da","bb5a47f5ea01454a8b79455422d3b9da",22850355,77,0,1,1017,280,280,0
"bb5a47f5ea01454a8b79455422d3b9da","82ae07bc0c9b4570a41799290d1ef399",22850355,3,-6,0,1019,280,275,-5
"82ae07bc0c9b4570a41799290d1ef399","bb5a47f5ea01454a8b79455422d3b9da",22850355,4,6,0,1020,275,280,5
"bb5a47f5ea01454a8b79455422d3b9da","0d987bed3ffa4ed0b9a2e62e97b7b30f",22850355,2,-10,0,1025,280,272,-8
"0d987bed3ffa4ed0b9a2e62e97b7b30f","82ae07bc0c9b4570a41799290d1ef399",22850355,1,4,0,1026,272,275,3
"0d987bed3ffa4ed0b9a2e62e97b7b30f","94cecc3f1e7d484b8e068e79241dfd73",22850355,1,13,0,1087,272,281,9
"94cecc3f1e7d484b8e068e79241dfd73","a37477c4e4c14169ad44b06b493007f6",22850355,1,2,0,1088,281,283,2
"a37477c4e4c14169ad44b06b493007f6","bc5524e78a8544e2ae2fdc2f3462bbec",22850355,1,-6,0,1089,283,279,-4
"bc5524e78a8544e2ae2fdc2f3462bbec","0d987bed3ffa4ed0b9a2e62e97b7b30f",22850355,1,-9,0,1090,279,272,-7
"bb5a47f5ea01454a8b79455422d3b9da","4a29443515bb404cb8924e1c60a63b73",22850355,1,12,0,1101,280,285,5
"4a29443515bb404cb8924e1c60a63b73","208c9b2796c944db8dacaa96082520ea",22850355,2,3,0,1102,285,288,3
"208c9b2796c944db8dacaa96082520ea","208c9b2796c944db8dacaa96082520ea",22850355,1,0,1,1103,288,288,0
"208c9b2796c944db8dacaa96082520ea","4a29443515bb404cb8924e1c60a63b73",22850355,1,-3,0,1104,288,285,-3
"4a29443515bb404cb8924e1c60a63b73","7669a956527947d0add87455277e80b4",22850355,1,7,0,1105,285,291,6
"7669a956527947d0add87455277e80b4","7669a956527947d0add87455277e80b4",22850355,1,0,1,1106,291,291,0
"7669a956527947d0add87455277e80b4","869e967078f04da18dd0b0b9389a7424",22850355,1,3,0,1107,291,293,2
"869e967078f04da18dd0b0b9389a7424","6a9a3b5bde4a48daa896fe8c06eca56f",22850355,1,-5,0,1108,293,289,-4
"6a9a3b5bde4a48daa896fe8c06eca56f","869e967078f04da18dd0b0b9389a7424",22850355,1,5,0,1109,289,293,4
"869e967078f04da18dd0b0b9389a7424","51ab6291537748fab90d519aa09889d6",22850355,1,2,0,1110,293,295,2
"51ab6291537748fab90d519aa09889d6","51ab6291537748fab90d519aa09889d6",22850355,11,0,1,1111,295,295,0
"51ab6291537748fab90d519aa09889d6","34a6e49023fc4465bd5ca604330bbd1c",22850355,1,-3,0,1122,295,292,-3
"34a6e49023fc4465bd5ca604330bbd1c","21592f2a9e9c4b2f8c66ec5dbcbf6a2b",22850355,1,5,0,1123,292,296,4
"21592f2a9e9c4b2f8c66ec5dbcbf6a2b","ba0e59461bfb4a44b7b1c28a01f8d3b3",22850355,1,4,0,1124,296,299,3
"ba0e59461bfb4a44b7b1c28a01f8d3b3","ba0e59461bfb4a44b7b1c28a01f8d3b3",22850355,1,0,1,1125,299,299,0
"ba0e59461bfb4a44b7b1c28a01f8d3b3","0e0b36e731a645e7b1b8a88f5031ca38",22850355,1,2,0,1126,299,301,2
"0e0b36e731a645e7b1b8a88f5031ca38","0e0b36e731a645e7b1b8a88f5031ca38",22850355,5,0,1,1127,301,301,0
"0e0b36e731a645e7b1b8a88f5031ca38","a66a144637284c21afc6de17fea4bfb8",22850355,1,1,0,1132,301,302,1
"a66a144637284c21afc6de17fea4bfb8","a66a144637284c21afc6de17fea4bfb8",22850355,2,0,1,1133,302,302,0
"a66a144637284c21afc6de17fea4bfb8","7646a919d7e64fa990bca9b024ff089d",22850355,1,-4,0,1135,302,298,-4
"7646a919d7e64fa990bca9b024ff089d","e390b575229748ea8aac9364efe2bf00",22850355,1,7,0,1136,298,304,6
"e390b575229748ea8aac9364efe2bf00","e390b575229748ea8aac9364efe2bf00",22850355,1,0,1,1137,304,304,0
"e390b575229748ea8aac9364efe2bf00","3434c10e561d488a914e0f7d71907abd",22850355,1,3,0,1138,304,305,1
"3434c10e561d488a914e0f7d71907abd","4a29443515bb404cb8924e1c60a63b73",22850355,1,-27,0,1139,305,285,-20
"4a29443515bb404cb8924e1c60a63b73","53e7e900392747ccad52e711ab0f80d8",22850355,1,29,0,1140,285,307,22
"53e7e900392747ccad52e711ab0f80d8","3434c10e561d488a914e0f7d71907abd",22850355,1,-2,0,1141,307,305,-2
"3434c10e561d488a914e0f7d71907abd","53e7e900392747ccad52e711ab0f80d8",22850355,1,2,0,1142,305,307,2
"53e7e900392747ccad52e711ab0f80d8","53e7e900392747ccad52e711ab0f80d8",22850355,1,0,1,1143,307,307,0
"53e7e900392747ccad52e711ab0f80d8","130acc2aeb0448fdbb2de63bc5cebe5b",22850355,1,3,0,1144,307,309,2
"130acc2aeb0448fdbb2de63bc5cebe5b","3434c10e561d488a914e0f7d71907abd",22850355,1,-5,0,1145,309,305,-4
"3434c10e561d488a914e0f7d71907abd","130acc2aeb0448fdbb2de63bc5cebe5b",22850355,2,5,0,1146,305,309,4
"130acc2aeb0448fdbb2de63bc5cebe5b","9c062b3251034ebe90f5054e2a3b5120",22850355,1,2,0,1147,309,311,2
"9c062b3251034ebe90f5054e2a3b5120","9c062b3251034ebe90f5054e2a3b5120",22850355,2,0,1,1148,311,311,0
"9c062b3251034ebe90f5054e2a3b5120","ea859f8207e44537889daeaba13ac2e8",22850355,1,1,0,1150,311,312,1
"ea859f8207e44537889daeaba13ac2e8","ea859f8207e44537889daeaba13ac2e8",22850355,4,0,1,1151,312,312,0
"ea859f8207e44537889daeaba13ac2e8","56d94971a7a94257aa330183a8ebd0ea",22850355,1,1,0,1155,312,313,1
"56d94971a7a94257aa330183a8ebd0ea","56d94971a7a94257aa330183a8ebd0ea",22850355,1,0,1,1156,313,313,0
"56d94971a7a94257aa330183a8ebd0ea","141c0df6cd1946539aadd1c9b7068cd4",22850355,1,-5,0,1157,313,308,-5
"141c0df6cd1946539aadd1c9b7068cd4","13255e63e0aa4abf85e5211bf613d43e",22850355,1,10,0,1158,308,317,9
"13255e63e0aa4abf85e5211bf613d43e","13255e63e0aa4abf85e5211bf613d43e",22850355,1,0,1,1159,317,317,0
"13255e63e0aa4abf85e5211bf613d43e","86c27d40179e419c8e9d150fb6afa5d0",22850355,1,3,0,1160,317,319,2
"86c27d40179e419c8e9d150fb6afa5d0","0c787d16c9504873b1a4d903cec09948",22850355,1,-6,0,1161,319,314,-5
"0c787d16c9504873b1a4d903cec09948","86c27d40179e419c8e9d150fb6afa5d0",22850355,1,6,0,1162,314,319,5
"86c27d40179e419c8e9d150fb6afa5d0","8d7e0b55cf9849cda222a0f2440cec55",22850355,1,-1,0,1163,319,318,-1
"8d7e0b55cf9849cda222a0f2440cec55","24f1363179ad4aaa965484a78471912b",22850355,1,6,0,1164,318,323,5
"24f1363179ad4aaa965484a78471912b","47edbb64109243e6b0f8f64cdef90c6c",22850355,1,3,0,1165,323,326,3
"47edbb64109243e6b0f8f64cdef90c6c","24f1363179ad4aaa965484a78471912b",22850355,1,-3,0,1166,326,323,-3
"24f1363179ad4aaa965484a78471912b","3628bdce1dd2429ba924d2d4d09448d2",22850355,1,-1,0,1167,323,322,-1
"3628bdce1dd2429ba924d2d4d09448d2","56b3fd1a212a4764be39d979fde3326e",22850355,1,7,0,1168,322,328,6
"56b3fd1a212a4764be39d979fde3326e","56b3fd1a212a4764be39d979fde3326e",22850355,1,0,1,1169,328,328,0
"56b3fd1a212a4764be39d979fde3326e","0c4079457ede49e3aeb5e86ed84bdf35",22850355,1,3,0,1170,328,329,1
"0c4079457ede49e3aeb5e86ed84bdf35","3434c10e561d488a914e0f7d71907abd",22850355,1,-31,0,1171,329,305,-24
"3434c10e561d488a914e0f7d71907abd","38aea304b4fa46e1b29bb72f5cea4c93",22850355,1,33,0,1172,305,331,26
"38aea304b4fa46e1b29bb72f5cea4c93","141c0df6cd1946539aadd1c9b7068cd4",22850355,1,-29,0,1173,331,308,-23
"141c0df6cd1946539aadd1c9b7068cd4","3434c10e561d488a914e0f7d71907abd",22850355,1,-4,0,1174,308,305,-3
"130acc2aeb0448fdbb2de63bc5cebe5b","141c0df6cd1946539aadd1c9b7068cd4",22850355,2,-1,0,1176,309,308,-1
"141c0df6cd1946539aadd1c9b7068cd4","130acc2aeb0448fdbb2de63bc5cebe5b",22850355,1,1,0,1177,308,309,1
"130acc2aeb0448fdbb2de63bc5cebe5b","0c787d16c9504873b1a4d903cec09948",22850355,1,6,0,1178,309,314,5
"0c787d16c9504873b1a4d903cec09948","130acc2aeb0448fdbb2de63bc5cebe5b",22850355,1,-6,0,1179,314,309,-5
"141c0df6cd1946539aadd1c9b7068cd4","34a6e49023fc4465bd5ca604330bbd1c",22850355,1,-22,0,1181,308,292,-16
"34a6e49023fc4465bd5ca604330bbd1c","4a29443515bb404cb8924e1c60a63b73",22850355,1,-9,0,1182,292,285,-7
"4a29443515bb404cb8924e1c60a63b73","869e967078f04da18dd0b0b9389a7424",22850355,1,10,0,1183,285,293,8
"869e967078f04da18dd0b0b9389a7424","869e967078f04da18dd0b0b9389a7424",22850355,3,0,1,1184,293,293,0
"869e967078f04da18dd0b0b9389a7424","34a6e49023fc4465bd5ca604330bbd1c",22850355,1,-1,0,1187,293,292,-1
"34a6e49023fc4465bd5ca604330bbd1c","0c4079457ede49e3aeb5e86ed84bdf35",22850355,1,49,0,1188,292,329,37
"0c4079457ede49e3aeb5e86ed84bdf35","38aea304b4fa46e1b29bb72f5cea4c93",22850355,2,2,0,1189,329,331,2
"38aea304b4fa46e1b29bb72f5cea4c93","38aea304b4fa46e1b29bb72f5cea4c93",22850355,4,0,1,1190,331,331,0
"38aea304b4fa46e1b29bb72f5cea4c93","e36d261332f14e79bb4b467aceaeb9b5",22850355,1,2,0,1192,331,333,2
"e36d261332f14e79bb4b467aceaeb9b5","e36d261332f14e79bb4b467aceaeb9b5",22850355,1,0,1,1193,333,333,0
"e36d261332f14e79bb4b467aceaeb9b5","c7e89b9d04744d2eab742fc24e3ef1ae",22850355,1,1,0,1194,333,334,1
"c7e89b9d04744d2eab742fc24e3ef1ae","c7e89b9d04744d2eab742fc24e3ef1ae",22850355,2,0,1,1195,334,334,0
"c7e89b9d04744d2eab742fc24e3ef1ae","fe49f8054b374a0ea4bb266ed135ff62",22850355,1,1,0,1197,334,335,1
"fe49f8054b374a0ea4bb266ed135ff62","fe49f8054b374a0ea4bb266ed135ff62",22850355,2,0,1,1198,335,335,0
"fe49f8054b374a0ea4bb266ed135ff62","d0a8f74af98642fe8360d22c42e45117",22850355,1,1,0,1200,335,336,1
"d0a8f74af98642fe8360d22c42e45117","d0a8f74af98642fe8360d22c42e45117",22850355,2,0,1,1201,336,336,0
"d0a8f74af98642fe8360d22c42e45117","0c4079457ede49e3aeb5e86ed84bdf35",22850355,1,-7,0,1203,336,329,-7
"0c4079457ede49e3aeb5e86ed84bdf35","a7c6339ca1da4368a18d471f0519f877",22850355,1,11,0,1204,329,339,10
"a7c6339ca1da4368a18d471f0519f877","a7c6339ca1da4368a18d471f0519f877",22850355,1,0,1,1205,339,339,0
"a7c6339ca1da4368a18d471f0519f877","bbc5139ca9024389a94db3a6f47dcff6",22850355,1,3,0,1206,339,341,2
"bbc5139ca9024389a94db3a6f47dcff6","b8b9418ab322418d9db9b40d96af873a",22850355,2,-5,0,1207,341,337,-4
"b8b9418ab322418d9db9b40d96af873a","38aea304b4fa46e1b29bb72f5cea4c93",22850355,3,-7,0,1208,337,331,-6
"38aea304b4fa46e1b29bb72f5cea4c93","c2490bc612d146edbe786556fab3651b",22850355,2,11,0,1209,331,340,9
"c2490bc612d146edbe786556fab3651b","38aea304b4fa46e1b29bb72f5cea4c93",22850355,2,-11,0,1210,340,331,-9
"38aea304b4fa46e1b29bb72f5cea4c93","0c4079457ede49e3aeb5e86ed84bdf35",22850355,4,-2,0,1211,331,329,-2
"0c4079457ede49e3aeb5e86ed84bdf35","b8b9418ab322418d9db9b40d96af873a",22850355,2,9,0,1212,329,337,8
"0c4079457ede49e3aeb5e86ed84bdf35","bbc5139ca9024389a94db3a6f47dcff6",22850355,1,14,0,1216,329,341,12
"b8b9418ab322418d9db9b40d96af873a","bbc5139ca9024389a94db3a6f47dcff6",22850355,1,5,0,1223,337,341,4
"bbc5139ca9024389a94db3a6f47dcff6","bbc5139ca9024389a94db3a6f47dcff6",22850355,1,0,1,1224,341,341,0
"bbc5139ca9024389a94db3a6f47dcff6","4ee6ca9019ab4a1ab323f98094a9bd77",22850355,1,2,0,1225,341,343,2
"4ee6ca9019ab4a1ab323f98094a9bd77","4ee6ca9019ab4a1ab323f98094a9bd77",22850355,2,0,1,1226,343,343,0
"4ee6ca9019ab4a1ab323f98094a9bd77","b37947176785476f8b29d49a851366dc",22850355,1,1,0,1228,343,344,1
"b37947176785476f8b29d49a851366dc","b37947176785476f8b29d49a851366dc",22850355,2,0,1,1229,344,344,0
"b37947176785476f8b29d49a851366dc","fcea5b10d5a14a3b9324ffece8f6e1e5",22850355,1,1,0,1231,344,345,1
"fcea5b10d5a14a3b9324ffece8f6e1e5","fcea5b10d5a14a3b9324ffece8f6e1e5",22850355,5,0,1,1232,345,345,0
"fcea5b10d5a14a3b9324ffece8f6e1e5","c2490bc612d146edbe786556fab3651b",22850355,1,-5,0,1237,345,340,-5
"c2490bc612d146edbe786556fab3651b","6ac8bb048b854999a47edb35fe627f11",22850355,1,8,0,1238,340,347,7
"6ac8bb048b854999a47edb35fe627f11","6ac8bb048b854999a47edb35fe627f11",22850355,1,0,1,1239,347,347,0
"6ac8bb048b854999a47edb35fe627f11","0c4079457ede49e3aeb5e86ed84bdf35",22850355,1,-21,0,1240,347,329,-18
"0c4079457ede49e3aeb5e86ed84bdf35","30ead9794d4847abaf222ca966cc8630",22850355,2,24,0,1241,329,348,19
"30ead9794d4847abaf222ca966cc8630","09b9678ddc3d452ea4a3d46e15826065",22850355,1,5,0,1242,348,353,5
"09b9678ddc3d452ea4a3d46e15826065","897b7f51242c44aab2205c72fdcbf4cd",22850355,3,-1,0,1243,353,352,-1
"897b7f51242c44aab2205c72fdcbf4cd","eff0de7f2dbb42dfa1a2e686efab5b6d",22850355,3,2,0,1244,352,354,2
"eff0de7f2dbb42dfa1a2e686efab5b6d","c20993c944444fe085345591a8bd837e",22850355,3,-3,0,1245,354,351,-3
"c20993c944444fe085345591a8bd837e","0c4079457ede49e3aeb5e86ed84bdf35",22850355,1,-27,0,1246,351,329,-22
"0c4079457ede49e3aeb5e86ed84bdf35","0c4079457ede49e3aeb5e86ed84bdf35",22850355,1,0,1,1247,329,329,0
"30ead9794d4847abaf222ca966cc8630","30ead9794d4847abaf222ca966cc8630",22850355,2,0,1,1252,348,348,0
"30ead9794d4847abaf222ca966cc8630","897b7f51242c44aab2205c72fdcbf4cd",22850355,2,4,0,1253,348,352,4
"eff0de7f2dbb42dfa1a2e686efab5b6d","09b9678ddc3d452ea4a3d46e15826065",22850355,2,-1,0,1255,354,353,-1
"09b9678ddc3d452ea4a3d46e15826065","c20993c944444fe085345591a8bd837e",22850355,2,-2,0,1256,353,351,-2
"c20993c944444fe085345591a8bd837e","c20993c944444fe085345591a8bd837e",22850355,6,0,1,1257,351,351,0
"c20993c944444fe085345591a8bd837e","897b7f51242c44aab2205c72fdcbf4cd",22850355,2,1,0,1261,351,352,1
"897b7f51242c44aab2205c72fdcbf4cd","897b7f51242c44aab2205c72fdcbf4cd",22850355,5,0,1,1262,352,352,0
"897b7f51242c44aab2205c72fdcbf4cd","09b9678ddc3d452ea4a3d46e15826065",22850355,1,1,0,1265,352,353,1
"09b9678ddc3d452ea4a3d46e15826065","09b9678ddc3d452ea4a3d46e15826065",22850355,5,0,1,1266,353,353,0
"09b9678ddc3d452ea4a3d46e15826065","eff0de7f2dbb42dfa1a2e686efab5b6d",22850355,2,1,0,1269,353,354,1
"eff0de7f2dbb42dfa1a2e686efab5b6d","eff0de7f2dbb42dfa1a2e686efab5b6d",22850355,5,0,1,1270,354,354,0
"eff0de7f2dbb42dfa1a2e686efab5b6d","30ead9794d4847abaf222ca966cc8630",22850355,1,-6,0,1273,354,348,-6
"30ead9794d4847abaf222ca966cc8630","2fe14166dc9642c3bc666b86a57f943d",22850355,2,10,0,1274,348,357,9
"2fe14166dc9642c3bc666b86a57f943d","09b9678ddc3d452ea4a3d46e15826065",22850355,1,-5,0,1275,357,353,-4
"897b7f51242c44aab2205c72fdcbf4cd","1ba8fef685d74a8194b9db252eb704fb",22850355,1,4,0,1278,352,355,3
"1ba8fef685d74a8194b9db252eb704fb","eff0de7f2dbb42dfa1a2e686efab5b6d",22850355,1,-2,0,1279,355,354,-1
"c20993c944444fe085345591a8bd837e","09b9678ddc3d452ea4a3d46e15826065",22850355,2,2,0,1281,351,353,2
"897b7f51242c44aab2205c72fdcbf4cd","30ead9794d4847abaf222ca966cc8630",22850355,1,-4,0,1288,352,348,-4
"2fe14166dc9642c3bc666b86a57f943d","2fe14166dc9642c3bc666b86a57f943d",22850355,1,0,1,1290,357,357,0
"2fe14166dc9642c3bc666b86a57f943d","44421dd1e13a47a388c4a19834b744c7",22850355,1,2,0,1291,357,359,2
"44421dd1e13a47a388c4a19834b744c7","44421dd1e13a47a388c4a19834b744c7",22850355,2,0,1,1292,359,359,0
"44421dd1e13a47a388c4a19834b744c7","cb5fc7ef85d547c4be1a7439d0bf6052",22850355,1,1,0,1294,359,360,1
"cb5fc7ef85d547c4be1a7439d0bf6052","cb5fc7ef85d547c4be1a7439d0bf6052",22850355,5,0,1,1295,360,360,0
"cb5fc7ef85d547c4be1a7439d0bf6052","0a8f150a4cf747acbde62f4721823da3",22850355,1,1,0,1300,360,361,1
"0a8f150a4cf747acbde62f4721823da3","0a8f150a4cf747acbde62f4721823da3",22850355,5,0,1,1301,361,361,0
"0a8f150a4cf747acbde62f4721823da3","ab8fdad974ae471f9f24c3f9dd04462e",22850355,1,1,0,1306,361,362,1
"ab8fdad974ae471f9f24c3f9dd04462e","ab8fdad974ae471f9f24c3f9dd04462e",22850355,2,0,1,1307,362,362,0
"ab8fdad974ae471f9f24c3f9dd04462e","1ba8fef685d74a8194b9db252eb704fb",22850355,1,-7,0,1309,362,355,-7
"1ba8fef685d74a8194b9db252eb704fb","52580888dadb4fe3baa795683ea227bd",22850355,1,10,0,1310,355,364,9
"52580888dadb4fe3baa795683ea227bd","52580888dadb4fe3baa795683ea227bd",22850355,2,0,1,1311,364,364,0
"52580888dadb4fe3baa795683ea227bd","f00179e251a045b39c3f7a54f9aa4acc",22850355,1,-1,0,1313,364,363,-1
"f00179e251a045b39c3f7a54f9aa4acc","492a3bc6a1254f23a7998587961b22a4",22850355,1,4,0,1314,363,366,3
"492a3bc6a1254f23a7998587961b22a4","492a3bc6a1254f23a7998587961b22a4",22850355,1,0,1,1315,366,366,0
"492a3bc6a1254f23a7998587961b22a4","072a190fd302456290895f9f04d6940a",22850355,1,-1,0,1316,366,365,-1
"072a190fd302456290895f9f04d6940a","cfa457d1743848e4bb5e4beced6448ed",22850355,1,5,0,1317,365,369,4
"cfa457d1743848e4bb5e4beced6448ed","cfa457d1743848e4bb5e4beced6448ed",22850355,1,0,1,1318,369,369,0
"cfa457d1743848e4bb5e4beced6448ed","b71bac264efb4abd97015447bd490db6",22850355,1,3,0,1319,369,370,1
"b71bac264efb4abd97015447bd490db6","30ead9794d4847abaf222ca966cc8630",22850355,2,-28,0,1320,370,348,-22
"30ead9794d4847abaf222ca966cc8630","8d448d625b024c82a5eb240bbd7431d6",22850355,1,33,0,1321,348,374,26
"8d448d625b024c82a5eb240bbd7431d6","b71bac264efb4abd97015447bd490db6",22850355,4,-5,0,1322,374,370,-4
"b71bac264efb4abd97015447bd490db6","8d448d625b024c82a5eb240bbd7431d6",22850355,6,5,0,1323,370,374,4
"8d448d625b024c82a5eb240bbd7431d6","8d448d625b024c82a5eb240bbd7431d6",22850355,88,0,1,1324,374,374,0
"8d448d625b024c82a5eb240bbd7431d6","30ead9794d4847abaf222ca966cc8630",22850355,1,-33,0,1330,374,348,-26
"897b7f51242c44aab2205c72fdcbf4cd","c20993c944444fe085345591a8bd837e",22850355,1,-1,0,1334,352,351,-1
"c20993c944444fe085345591a8bd837e","eff0de7f2dbb42dfa1a2e686efab5b6d",22850355,1,3,0,1336,351,354,3
"eff0de7f2dbb42dfa1a2e686efab5b6d","2fe14166dc9642c3bc666b86a57f943d",22850355,1,4,0,1344,354,357,3
"2fe14166dc9642c3bc666b86a57f943d","30ead9794d4847abaf222ca966cc8630",22850355,1,-10,0,1345,357,348,-9
"30ead9794d4847abaf222ca966cc8630","c76574d21bc14aeea7ecd0b027f39858",22850355,1,23,0,1346,348,367,19
"c76574d21bc14aeea7ecd0b027f39858","30ead9794d4847abaf222ca966cc8630",22850355,1,-23,0,1347,367,348,-19
"30ead9794d4847abaf222ca966cc8630","b71bac264efb4abd97015447bd490db6",22850355,1,28,0,1348,348,370,22
"30ead9794d4847abaf222ca966cc8630","d6d02b6ef04e4f17805504500b8ce441",22850355,1,36,0,1350,348,375,27
"d6d02b6ef04e4f17805504500b8ce441","d6d02b6ef04e4f17805504500b8ce441",22850355,9,0,1,1351,375,375,0
"d6d02b6ef04e4f17805504500b8ce441","fab84b4fab5940efb4ea868ef8d09396",22850355,1,-122,0,1356,375,284,-91
"fab84b4fab5940efb4ea868ef8d09396","fab84b4fab5940efb4ea868ef8d09396",22850355,2,0,1,1357,284,284,0
"fab84b4fab5940efb4ea868ef8d09396","4a29443515bb404cb8924e1c60a63b73",22850355,1,4,0,1359,284,285,1
"208c9b2796c944db8dacaa96082520ea","1b4550d0dab04078b3bf08a655345bdc",22850355,1,111,0,1361,288,373,85
"1b4550d0dab04078b3bf08a655345bdc","b71bac264efb4abd97015447bd490db6",22850355,2,-4,0,1362,373,370,-3
"8d448d625b024c82a5eb240bbd7431d6","1b4550d0dab04078b3bf08a655345bdc",22850355,1,-1,0,1371,374,373,-1
"1b4550d0dab04078b3bf08a655345bdc","8d448d625b024c82a5eb240bbd7431d6",22850355,1,1,0,1372,373,374,1
"b71bac264efb4abd97015447bd490db6","d6d02b6ef04e4f17805504500b8ce441",22850355,2,8,0,1395,370,375,5
"d6d02b6ef04e4f17805504500b8ce441","1b4550d0dab04078b3bf08a655345bdc",22850355,1,-4,0,1397,375,373,-2
"8d448d625b024c82a5eb240bbd7431d6","d6d02b6ef04e4f17805504500b8ce441",22850355,1,3,0,1442,374,375,1
"d6d02b6ef04e4f17805504500b8ce441","b71bac264efb4abd97015447bd490db6",22850355,2,-8,0,1443,375,370,-5
"8d448d625b024c82a5eb240bbd7431d6","66baf19b6b904b70922329068c63746d",22850355,1,7,0,1466,374,376,2
"66baf19b6b904b70922329068c63746d","7f544639412e40a9ba27f43b415362ab",22850355,1,2,0,1467,376,378,2
"7f544639412e40a9ba27f43b415362ab","7f544639412e40a9ba27f43b415362ab",22850355,1,0,1,1468,378,378,0
"7f544639412e40a9ba27f43b415362ab","d5ae8642e15b46b8bd298b02274d4e9c",22850355,1,2,0,1469,378,380,2
"d5ae8642e15b46b8bd298b02274d4e9c","d5ae8642e15b46b8bd298b02274d4e9c",22850355,1,0,1,1470,380,380,0
"d5ae8642e15b46b8bd298b02274d4e9c","a0d10309a2dd456289147f84be9d37f9",22850355,1,1,0,1471,380,381,1
"a0d10309a2dd456289147f84be9d37f9","a0d10309a2dd456289147f84be9d37f9",22850355,2,0,1,1472,381,381,0
"a0d10309a2dd456289147f84be9d37f9","0fcbc3ca07b144138b8d85da581f09a8",22850355,1,1,0,1474,381,382,1
"0fcbc3ca07b144138b8d85da581f09a8","0fcbc3ca07b144138b8d85da581f09a8",22850355,2,0,1,1475,382,382,0
"0fcbc3ca07b144138b8d85da581f09a8","66baf19b6b904b70922329068c63746d",22850355,1,-6,0,1477,382,376,-6
"66baf19b6b904b70922329068c63746d","c2fca3669923477ab966ded303dea31c",22850355,1,8,0,1478,376,383,7
"c2fca3669923477ab966ded303dea31c","4890121ce5d74576b4632b77cfc23398",22850355,1,6,0,1479,383,388,5
"4890121ce5d74576b4632b77cfc23398","4890121ce5d74576b4632b77cfc23398",22850355,1,0,1,1480,388,388,0
"4890121ce5d74576b4632b77cfc23398","18d3b836dd804224883cc9180b60a8e1",22850355,1,-1,0,1481,388,387,-1
"18d3b836dd804224883cc9180b60a8e1","96bb2b3e85a34d8b9544514e89f6fe97",22850355,1,4,0,1482,387,390,3
"96bb2b3e85a34d8b9544514e89f6fe97","96bb2b3e85a34d8b9544514e89f6fe97",22850355,2,0,1,1483,390,390,0
"96bb2b3e85a34d8b9544514e89f6fe97","ac4e9b54acfe4670b4634859c7263cb5",22850355,1,2,0,1484,390,392,2
"ac4e9b54acfe4670b4634859c7263cb5","ac4e9b54acfe4670b4634859c7263cb5",22850355,1,0,1,1485,392,392,0
"ac4e9b54acfe4670b4634859c7263cb5","6f8881a745ac4c358a68b92c3b4abe81",22850355,1,3,0,1486,392,394,2
"6f8881a745ac4c358a68b92c3b4abe81","17f95d18bab743888e1736033dc3384d",22850355,2,-6,0,1487,394,389,-5
"17f95d18bab743888e1736033dc3384d","6f8881a745ac4c358a68b92c3b4abe81",22850355,1,6,0,1488,389,394,5
"6f8881a745ac4c358a68b92c3b4abe81","f7002c8484354eceac57bc7bd62c76c1",22850355,1,-1,0,1489,394,393,-1
"f7002c8484354eceac57bc7bd62c76c1","44a277ea44dc4ae689fab4b82f0b4098",22850355,1,5,0,1490,393,397,4
"44a277ea44dc4ae689fab4b82f0b4098","44a277ea44dc4ae689fab4b82f0b4098",22850355,1,0,1,1491,397,397,0
"44a277ea44dc4ae689fab4b82f0b4098","0c12af0a4e7f4002852cf84b2537c161",22850355,1,-2,0,1492,397,395,-2
"0c12af0a4e7f4002852cf84b2537c161","859e0b8d71694b12befb69ee698138f9",22850355,1,5,0,1493,395,399,4
"859e0b8d71694b12befb69ee698138f9","859e0b8d71694b12befb69ee698138f9",22850355,2,0,1,1494,399,399,0
"859e0b8d71694b12befb69ee698138f9","66baf19b6b904b70922329068c63746d",22850355,1,-29,0,1496,399,376,-23
"66baf19b6b904b70922329068c63746d","2b09a08242b54983aec7063990fb3f66",22850355,2,32,0,1497,376,400,24
"2b09a08242b54983aec7063990fb3f66","2b09a08242b54983aec7063990fb3f66",22850355,10,0,1,1498,400,400,0
"2b09a08242b54983aec7063990fb3f66","17f95d18bab743888e1736033dc3384d",22850355,1,-16,0,1499,400,389,-11
"17f95d18bab743888e1736033dc3384d","66baf19b6b904b70922329068c63746d",22850355,1,-16,0,1500,389,376,-13
"66baf19b6b904b70922329068c63746d","96bb2b3e85a34d8b9544514e89f6fe97",22850355,1,17,0,1501,376,390,14
"96bb2b3e85a34d8b9544514e89f6fe97","6f8881a745ac4c358a68b92c3b4abe81",22850355,1,5,0,1503,390,394,4
"17f95d18bab743888e1736033dc3384d","2b09a08242b54983aec7063990fb3f66",22850355,1,16,0,1505,389,400,11
"2b09a08242b54983aec7063990fb3f66","66baf19b6b904b70922329068c63746d",22850355,1,-32,0,1510,400,376,-24
"2b09a08242b54983aec7063990fb3f66","1f471b7a883a4df48211e8c6a81b59a7",22850355,1,1,0,1514,400,401,1
"1f471b7a883a4df48211e8c6a81b59a7","1f471b7a883a4df48211e8c6a81b59a7",22850355,3,0,1,1515,401,401,0
"1f471b7a883a4df48211e8c6a81b59a7","2b09a08242b54983aec7063990fb3f66",22850355,1,-1,0,1518,401,400,-1
"2b09a08242b54983aec7063990fb3f66","1157bd665ec4472fb58b751dc5099355",22850355,2,4,0,1519,400,403,3
"1157bd665ec4472fb58b751dc5099355","2b09a08242b54983aec7063990fb3f66",22850355,1,-4,0,1520,403,400,-3
"1157bd665ec4472fb58b751dc5099355","58fc9094275e4c49be3f4ba6d4acc0a4",22850355,2,5,0,1525,403,406,3
"58fc9094275e4c49be3f4ba6d4acc0a4","3c8a22d2f9c146ea956609e3ed4f2559",22850355,2,-2,0,1526,406,405,-1
"3c8a22d2f9c146ea956609e3ed4f2559","58fc9094275e4c49be3f4ba6d4acc0a4",22850355,2,2,0,1527,405,406,1
"58fc9094275e4c49be3f4ba6d4acc0a4","9de0d567bfa84fe5b77cb76f4a76a5d1",22850355,1,-4,0,1528,406,404,-2
"9de0d567bfa84fe5b77cb76f4a76a5d1","9de0d567bfa84fe5b77cb76f4a76a5d1",22850355,1,0,1,1529,404,404,0
"9de0d567bfa84fe5b77cb76f4a76a5d1","1157bd665ec4472fb58b751dc5099355",22850355,1,-1,0,1530,404,403,-1
"58fc9094275e4c49be3f4ba6d4acc0a4","c1c1be90b2b14c1ab4a5e1ee3c241902",22850355,1,1,0,1534,406,407,1
"c1c1be90b2b14c1ab4a5e1ee3c241902","c1c1be90b2b14c1ab4a5e1ee3c241902",22850355,5,0,1,1535,407,407,0
"c1c1be90b2b14c1ab4a5e1ee3c241902","58fc9094275e4c49be3f4ba6d4acc0a4",22850355,1,-1,0,1540,407,406,-1
"58fc9094275e4c49be3f4ba6d4acc0a4","02b3a1bead9244c1ba2f857c7da8f82a",22850355,1,3,0,1541,406,408,2
"02b3a1bead9244c1ba2f857c7da8f82a","02b3a1bead9244c1ba2f857c7da8f82a",22850355,1,0,1,1542,408,408,0
"02b3a1bead9244c1ba2f857c7da8f82a","6206fc6479014bb193084c32409dc1b9",22850355,1,1,0,1543,408,409,1
"6206fc6479014bb193084c32409dc1b9","6206fc6479014bb193084c32409dc1b9",22850355,4,0,1,1544,409,409,0
"6206fc6479014bb193084c32409dc1b9","6a5f020451db426dacba9e2ea3fcc62a",22850355,1,2,0,1548,409,410,1
"6a5f020451db426dacba9e2ea3fcc62a","02b3a1bead9244c1ba2f857c7da8f82a",22850355,1,-3,0,1549,410,408,-2
"02b3a1bead9244c1ba2f857c7da8f82a","6a5f020451db426dacba9e2ea3fcc62a",22850355,1,3,0,1550,408,410,2
"6a5f020451db426dacba9e2ea3fcc62a","6a5f020451db426dacba9e2ea3fcc62a",22850355,3,0,1,1551,410,410,0
"6a5f020451db426dacba9e2ea3fcc62a","33a9d248b2e44588a5b07fc1342b9bc2",22850355,2,2,0,1554,410,411,1
"33a9d248b2e44588a5b07fc1342b9bc2","6a5f020451db426dacba9e2ea3fcc62a",22850355,1,-2,0,1555,411,410,-1
"33a9d248b2e44588a5b07fc1342b9bc2","c6f26bd420634f1cb7989e76fe6b16c0",22850355,1,1,0,1557,411,412,1
"c6f26bd420634f1cb7989e76fe6b16c0","c6f26bd420634f1cb7989e76fe6b16c0",22850355,5,0,1,1558,412,412,0
"c6f26bd420634f1cb7989e76fe6b16c0","2a65ee6e2ac64f6a8a55fbe5373ec763",22850355,1,1,0,1563,412,413,1
"2a65ee6e2ac64f6a8a55fbe5373ec763","2a65ee6e2ac64f6a8a55fbe5373ec763",22850355,2,0,1,1564,413,413,0
"2a65ee6e2ac64f6a8a55fbe5373ec763","33a9d248b2e44588a5b07fc1342b9bc2",22850355,1,-2,0,1566,413,411,-2
"33a9d248b2e44588a5b07fc1342b9bc2","1fd0f6dadbc14ebc965faf6122190b96",22850355,1,5,0,1567,411,415,4
"1fd0f6dadbc14ebc965faf6122190b96","1fd0f6dadbc14ebc965faf6122190b96",22850355,1,0,1,1568,415,415,0
"1fd0f6dadbc14ebc965faf6122190b96","687055dad9fc40c3982478fe33ec01bf",22850355,1,-1,0,1569,415,414,-1
"687055dad9fc40c3982478fe33ec01bf","2add1669f08d4101913db15f8c23b3b7",22850355,1,3,0,1570,414,416,2
"2add1669f08d4101913db15f8c23b3b7","2add1669f08d4101913db15f8c23b3b7",22850355,1,0,1,1571,416,416,0
"2add1669f08d4101913db15f8c23b3b7","a2b4bd40cee2481ebd3fc179d6a5cd62",22850355,1,3,0,1572,416,417,1
"a2b4bd40cee2481ebd3fc179d6a5cd62","2b09a08242b54983aec7063990fb3f66",22850355,1,-27,0,1573,417,400,-17
"2b09a08242b54983aec7063990fb3f66","a2b4bd40cee2481ebd3fc179d6a5cd62",22850355,1,27,0,1574,400,417,17
"a2b4bd40cee2481ebd3fc179d6a5cd62","a2b4bd40cee2481ebd3fc179d6a5cd62",22850355,1,0,1,1575,417,417,0
"a2b4bd40cee2481ebd3fc179d6a5cd62","e34e59dce2204f228f3a84b6725df60f",22850355,1,2,0,1576,417,419,2
"e34e59dce2204f228f3a84b6725df60f","e34e59dce2204f228f3a84b6725df60f",22850355,1,0,1,1577,419,419,0
"e34e59dce2204f228f3a84b6725df60f","a2b4bd40cee2481ebd3fc179d6a5cd62",22850355,1,-2,0,1578,419,417,-2
"a2b4bd40cee2481ebd3fc179d6a5cd62","bec48fc2e1294c7eb3d0aca780d731b8",22850355,2,4,0,1579,417,420,3
"bec48fc2e1294c7eb3d0aca780d731b8","bec48fc2e1294c7eb3d0aca780d731b8",22850355,4,0,1,1580,420,420,0
"bec48fc2e1294c7eb3d0aca780d731b8","a24600b0e49245f6bdba8c893cfeddb0",22850355,1,7,0,1582,420,425,5
"a24600b0e49245f6bdba8c893cfeddb0","dbde19fcce2a4c1abdc7f685c293a23f",22850355,1,-4,0,1583,425,422,-3
"dbde19fcce2a4c1abdc7f685c293a23f","a24600b0e49245f6bdba8c893cfeddb0",22850355,1,4,0,1584,422,425,3
"a24600b0e49245f6bdba8c893cfeddb0","a24600b0e49245f6bdba8c893cfeddb0",22850355,1,0,1,1585,425,425,0
"a24600b0e49245f6bdba8c893cfeddb0","a2b4bd40cee2481ebd3fc179d6a5cd62",22850355,1,-11,0,1586,425,417,-8
"a2b4bd40cee2481ebd3fc179d6a5cd62","24cf8786024543f19b89bc20034e60d7",22850355,1,18,0,1587,417,428,11
"24cf8786024543f19b89bc20034e60d7","f2a73be2f46840b182d7bd095378004e",22850355,2,1,0,1588,428,429,1
"f2a73be2f46840b182d7bd095378004e","bec48fc2e1294c7eb3d0aca780d731b8",22850355,1,-15,0,1589,429,420,-9
"bec48fc2e1294c7eb3d0aca780d731b8","a2b4bd40cee2481ebd3fc179d6a5cd62",22850355,1,-4,0,1590,420,417,-3
"bec48fc2e1294c7eb3d0aca780d731b8","24cf8786024543f19b89bc20034e60d7",22850355,1,14,0,1594,420,428,8
"24cf8786024543f19b89bc20034e60d7","24cf8786024543f19b89bc20034e60d7",22850355,1,0,1,1595,428,428,0
"f2a73be2f46840b182d7bd095378004e","f2a73be2f46840b182d7bd095378004e",22850355,1,0,1,1597,429,429,0
"f2a73be2f46840b182d7bd095378004e","604551fd4266430cb860fef58fa7dd61",22850355,1,1,0,1598,429,430,1
"604551fd4266430cb860fef58fa7dd61","604551fd4266430cb860fef58fa7dd61",22850355,7,0,1,1599,430,430,0
"604551fd4266430cb860fef58fa7dd61","24cf8786024543f19b89bc20034e60d7",22850355,1,-2,0,1606,430,428,-2
"24cf8786024543f19b89bc20034e60d7","dce46f8904594a62a6377a3587aaa663",22850355,1,4,0,1607,428,431,3
"dce46f8904594a62a6377a3587aaa663","dce46f8904594a62a6377a3587aaa663",22850355,1,0,1,1608,431,431,0
"dce46f8904594a62a6377a3587aaa663","9b9d0a249052413c869753b99682b0ac",22850355,1,1,0,1609,431,432,1
"9b9d0a249052413c869753b99682b0ac","9b9d0a249052413c869753b99682b0ac",22850355,1,0,1,1610,432,432,0
"9b9d0a249052413c869753b99682b0ac","061c175cc90f45fbad883025394e78dd",22850355,1,1,0,1611,432,433,1
"061c175cc90f45fbad883025394e78dd","061c175cc90f45fbad883025394e78dd",22850355,5,0,1,1612,433,433,0
"061c175cc90f45fbad883025394e78dd","dce46f8904594a62a6377a3587aaa663",22850355,1,-2,0,1617,433,431,-2
"dce46f8904594a62a6377a3587aaa663","74a7f8712e5449c2bc0b43c6f90dafed",22850355,1,5,0,1618,431,435,4
"74a7f8712e5449c2bc0b43c6f90dafed","74a7f8712e5449c2bc0b43c6f90dafed",22850355,3,0,1,1619,435,435,0
"74a7f8712e5449c2bc0b43c6f90dafed","66ada10dde9f43018588f1ced9d477fc",22850355,1,-1,0,1622,435,434,-1
"66ada10dde9f43018588f1ced9d477fc","bf12c96466d840a69bed7020b3f18bb8",22850355,1,3,0,1623,434,436,2
"bf12c96466d840a69bed7020b3f18bb8","bf12c96466d840a69bed7020b3f18bb8",22850355,1,0,1,1624,436,436,0
"bf12c96466d840a69bed7020b3f18bb8","070600601c4c439288445d2f0724807d",22850355,1,3,0,1625,436,437,1
"070600601c4c439288445d2f0724807d","24cf8786024543f19b89bc20034e60d7",22850355,1,-14,0,1626,437,428,-9
"24cf8786024543f19b89bc20034e60d7","1823b6de7d334a7aaabc4570719af4d9",22850355,1,16,0,1627,428,439,11
"1823b6de7d334a7aaabc4570719af4d9","070600601c4c439288445d2f0724807d",22850355,2,-2,0,1628,439,437,-2
"070600601c4c439288445d2f0724807d","070600601c4c439288445d2f0724807d",22850355,1,0,1,1629,437,437,0
"070600601c4c439288445d2f0724807d","1823b6de7d334a7aaabc4570719af4d9",22850355,1,2,0,1630,437,439,2
"1823b6de7d334a7aaabc4570719af4d9","1823b6de7d334a7aaabc4570719af4d9",22850355,14,0,1,1631,439,439,0
"070600601c4c439288445d2f0724807d","0380cd76a7d44bc3a4da1f15e4d68f89",22850355,1,4,0,1646,437,440,3
"0380cd76a7d44bc3a4da1f15e4d68f89","0380cd76a7d44bc3a4da1f15e4d68f89",22850355,1,0,1,1647,440,440,0
"0380cd76a7d44bc3a4da1f15e4d68f89","23b7673c8b5443108c2ef09382834a86",22850355,2,2,0,1648,440,441,1
"23b7673c8b5443108c2ef09382834a86","0380cd76a7d44bc3a4da1f15e4d68f89",22850355,1,-2,0,1649,441,440,-1
"23b7673c8b5443108c2ef09382834a86","23b7673c8b5443108c2ef09382834a86",22850355,1,0,1,1651,441,441,0
"23b7673c8b5443108c2ef09382834a86","901e92500aea43c79f19f1b279050668",22850355,1,2,0,1652,441,442,1
"901e92500aea43c79f19f1b279050668","901e92500aea43c79f19f1b279050668",22850355,2,0,1,1653,442,442,0
"901e92500aea43c79f19f1b279050668","001339db8ced4cf78829ebe8b145449d",22850355,1,1,0,1655,442,443,1
"001339db8ced4cf78829ebe8b145449d","001339db8ced4cf78829ebe8b145449d",22850355,5,0,1,1656,443,443,0
"001339db8ced4cf78829ebe8b145449d","452745e0366e42ae81561bfddebcc6c3",22850355,1,1,0,1661,443,444,1
"452745e0366e42ae81561bfddebcc6c3","452745e0366e42ae81561bfddebcc6c3",22850355,2,0,1,1662,444,444,0
"452745e0366e42ae81561bfddebcc6c3","901e92500aea43c79f19f1b279050668",22850355,1,-2,0,1664,444,442,-2
"901e92500aea43c79f19f1b279050668","4660ff2089114e8db82ceb26a4f329e3",22850355,1,4,0,1665,442,445,3
"4660ff2089114e8db82ceb26a4f329e3","4660ff2089114e8db82ceb26a4f329e3",22850355,2,0,1,1666,445,445,0
"4660ff2089114e8db82ceb26a4f329e3","7bd5586eb9d8484eb74a433ee7bfe499",22850355,1,2,0,1668,445,446,1
"7bd5586eb9d8484eb74a433ee7bfe499","7bd5586eb9d8484eb74a433ee7bfe499",22850355,10,0,1,1669,446,446,0
"7bd5586eb9d8484eb74a433ee7bfe499","8a7f26e690f34dda97be16904518ca99",22850355,1,2,0,1679,446,447,1
"8a7f26e690f34dda97be16904518ca99","8a7f26e690f34dda97be16904518ca99",22850355,1,0,1,1680,447,447,0
"8a7f26e690f34dda97be16904518ca99","070600601c4c439288445d2f0724807d",22850355,1,-16,0,1681,447,437,-10
"070600601c4c439288445d2f0724807d","b2f0d654738f48158edff28e8d3a546e",22850355,1,21,0,1682,437,449,12
"b2f0d654738f48158edff28e8d3a546e","f60ee41ec635499abd48168342d32c2f",22850355,3,5,0,1683,449,453,4
"f60ee41ec635499abd48168342d32c2f","b2f0d654738f48158edff28e8d3a546e",22850355,2,-5,0,1684,453,449,-4
"f60ee41ec635499abd48168342d32c2f","f60ee41ec635499abd48168342d32c2f",22850355,58,0,1,1686,453,453,0
"b2f0d654738f48158edff28e8d3a546e","f67fbf45a5f146ed866965bc57c7c001",22850355,1,8,0,1738,449,454,5
"f67fbf45a5f146ed866965bc57c7c001","f67fbf45a5f146ed866965bc57c7c001",22850355,2,0,1,1739,454,454,0
"f67fbf45a5f146ed866965bc57c7c001","d937afe49bd24a07a550dda1c1155122",22850355,1,1,0,1741,454,455,1
"d937afe49bd24a07a550dda1c1155122","d937afe49bd24a07a550dda1c1155122",22850355,5,0,1,1742,455,455,0
"d937afe49bd24a07a550dda1c1155122","3628b3f7823443d0912a339096b69943",22850355,1,1,0,1747,455,456,1
"3628b3f7823443d0912a339096b69943","3628b3f7823443d0912a339096b69943",22850355,1,0,1,1748,456,456,0
"3628b3f7823443d0912a339096b69943","9e049ee647cf43ecbcb5ed792a8e7588",22850355,1,1,0,1749,456,457,1
"9e049ee647cf43ecbcb5ed792a8e7588","9e049ee647cf43ecbcb5ed792a8e7588",22850355,1,0,1,1750,457,457,0
"9e049ee647cf43ecbcb5ed792a8e7588","5256a214faaf410b93f76cea06428334",22850355,1,1,0,1751,457,458,1
"5256a214faaf410b93f76cea06428334","5256a214faaf410b93f76cea06428334",22850355,1,0,1,1752,458,458,0
"5256a214faaf410b93f76cea06428334","25c32b120fce40fa9b6c85133aeb4716",22850355,1,1,0,1753,458,459,1
"25c32b120fce40fa9b6c85133aeb4716","25c32b120fce40fa9b6c85133aeb4716",22850355,6,0,1,1754,459,459,0
"25c32b120fce40fa9b6c85133aeb4716","11bc14f2204949008b7d511b933363c1",22850355,1,1,0,1760,459,460,1
"11bc14f2204949008b7d511b933363c1","11bc14f2204949008b7d511b933363c1",22850355,6,0,1,1761,460,460,0
"11bc14f2204949008b7d511b933363c1","42de338840a34d15adb66e7b14fb9d2c",22850355,1,1,0,1767,460,461,1
"42de338840a34d15adb66e7b14fb9d2c","42de338840a34d15adb66e7b14fb9d2c",22850355,3,0,1,1768,461,461,0
"42de338840a34d15adb66e7b14fb9d2c","9da37c6210b1416b8079c274f70bf600",22850355,1,1,0,1771,461,462,1
"9da37c6210b1416b8079c274f70bf600","9da37c6210b1416b8079c274f70bf600",22850355,3,0,1,1772,462,462,0
"9da37c6210b1416b8079c274f70bf600","519119f1deac45ff9ab4f13529be5c6e",22850355,1,1,0,1775,462,463,1
"519119f1deac45ff9ab4f13529be5c6e","519119f1deac45ff9ab4f13529be5c6e",22850355,3,0,1,1776,463,463,0
"519119f1deac45ff9ab4f13529be5c6e","f67fbf45a5f146ed866965bc57c7c001",22850355,1,-9,0,1779,463,454,-9
"f67fbf45a5f146ed866965bc57c7c001","c5df9f40ec14463b9dcfdc73df3e9285",22850355,1,12,0,1780,454,464,10
"c5df9f40ec14463b9dcfdc73df3e9285","c5df9f40ec14463b9dcfdc73df3e9285",22850355,5,0,1,1781,464,464,0
"c5df9f40ec14463b9dcfdc73df3e9285","83d42d95cd844fc093fc09cee250edb8",22850355,1,3,0,1782,464,465,1
"83d42d95cd844fc093fc09cee250edb8","83d42d95cd844fc093fc09cee250edb8",22850355,3,0,1,1783,465,465,0
"83d42d95cd844fc093fc09cee250edb8","c5df9f40ec14463b9dcfdc73df3e9285",22850355,1,-3,0,1786,465,464,-1
"c5df9f40ec14463b9dcfdc73df3e9285","9428d8bd9c5a47b2a235b254e5e27ded",22850355,1,-16,0,1789,464,452,-12
"9428d8bd9c5a47b2a235b254e5e27ded","b2f0d654738f48158edff28e8d3a546e",22850355,1,-4,0,1790,452,449,-3
"f60ee41ec635499abd48168342d32c2f","c5df9f40ec14463b9dcfdc73df3e9285",22850355,1,15,0,1799,453,464,11
"b613861cecf84ffcab01afb23f660475","b613861cecf84ffcab01afb23f660475",22851902,4,0,1,1,1,1,0
"b613861cecf84ffcab01afb23f660475","e2911e79efc2420eac45d9f671463d4b",22851902,1,3,0,5,1,2,1
"e2911e79efc2420eac45d9f671463d4b","e2911e79efc2420eac45d9f671463d4b",22851902,2,0,1,6,2,2,0
"e2911e79efc2420eac45d9f671463d4b","519d1b8c59404d67b54e96c5c8a830b2",22851902,1,1,0,8,2,3,1
"519d1b8c59404d67b54e96c5c8a830b2","519d1b8c59404d67b54e96c5c8a830b2",22851902,1,0,1,9,3,3,0
"519d1b8c59404d67b54e96c5c8a830b2","531db53f81f646edb0cdcfe0085b03b7",22851902,1,1,0,10,3,4,1
"531db53f81f646edb0cdcfe0085b03b7","531db53f81f646edb0cdcfe0085b03b7",22851902,1,0,1,11,4,4,0
"531db53f81f646edb0cdcfe0085b03b7","4f5f94b2f95141e0a9d53a61da2276da",22851902,1,1,0,12,4,5,1
"4f5f94b2f95141e0a9d53a61da2276da","4f5f94b2f95141e0a9d53a61da2276da",22851902,1,0,1,13,5,5,0
"4f5f94b2f95141e0a9d53a61da2276da","6d541c89590949f99af293c4f2333f67",22851902,1,1,0,14,5,6,1
"6d541c89590949f99af293c4f2333f67","6d541c89590949f99af293c4f2333f67",22851902,1,0,1,15,6,6,0
"6d541c89590949f99af293c4f2333f67","dd5cf0b9fe4c4f1d8f5ff8e4c04879cb",22851902,1,1,0,16,6,7,1
"dd5cf0b9fe4c4f1d8f5ff8e4c04879cb","dd5cf0b9fe4c4f1d8f5ff8e4c04879cb",22851902,2,0,1,17,7,7,0
"dd5cf0b9fe4c4f1d8f5ff8e4c04879cb","f96261861edc426abe2248be4f0a709a",22851902,1,1,0,19,7,8,1
"f96261861edc426abe2248be4f0a709a","f96261861edc426abe2248be4f0a709a",22851902,1,0,1,20,8,8,0
"f96261861edc426abe2248be4f0a709a","66b5e16f4f75454fb5b8172079f0fa83",22851902,1,1,0,21,8,9,1
"66b5e16f4f75454fb5b8172079f0fa83","66b5e16f4f75454fb5b8172079f0fa83",22851902,1,0,1,22,9,9,0
"66b5e16f4f75454fb5b8172079f0fa83","0680571d4698477995e41842c36a54b2",22851902,1,1,0,23,9,10,1
"0680571d4698477995e41842c36a54b2","0680571d4698477995e41842c36a54b2",22851902,2,0,1,24,10,10,0
"0680571d4698477995e41842c36a54b2","9112f2bffece48e08c6d2287be204085",22851902,1,1,0,26,10,11,1
"9112f2bffece48e08c6d2287be204085","9112f2bffece48e08c6d2287be204085",22851902,1,0,1,27,11,11,0
"9112f2bffece48e08c6d2287be204085","56586aa865414f538729c7f7735d2bc6",22851902,1,3,0,28,11,12,1
"56586aa865414f538729c7f7735d2bc6","e2911e79efc2420eac45d9f671463d4b",22851902,1,-12,0,29,12,2,-10
"e2911e79efc2420eac45d9f671463d4b","56586aa865414f538729c7f7735d2bc6",22851902,1,12,0,30,2,12,10
"56586aa865414f538729c7f7735d2bc6","56586aa865414f538729c7f7735d2bc6",22851902,2,0,1,31,12,12,0
"56586aa865414f538729c7f7735d2bc6","b7f2b31585d94eb3bf86376714aa7070",22851902,2,2,0,33,12,13,1
"b7f2b31585d94eb3bf86376714aa7070","56586aa865414f538729c7f7735d2bc6",22851902,1,-2,0,34,13,12,-1
"b7f2b31585d94eb3bf86376714aa7070","b7f2b31585d94eb3bf86376714aa7070",22851902,1,0,1,36,13,13,0
"b7f2b31585d94eb3bf86376714aa7070","3f1c815879794b929260d224becaff7e",22851902,1,2,0,37,13,14,1
"3f1c815879794b929260d224becaff7e","81c864a886d54a6b8ff85f7d736f4f95",22851902,1,2,0,38,14,15,1
"81c864a886d54a6b8ff85f7d736f4f95","3f1c815879794b929260d224becaff7e",22851902,1,-2,0,39,15,14,-1
"3f1c815879794b929260d224becaff7e","5c5ceeee4562457ba6d41515aeebfbb1",22851902,1,6,0,40,14,17,3
"5c5ceeee4562457ba6d41515aeebfbb1","81c864a886d54a6b8ff85f7d736f4f95",22851902,1,-4,0,41,17,15,-2
"81c864a886d54a6b8ff85f7d736f4f95","5c5ceeee4562457ba6d41515aeebfbb1",22851902,1,4,0,42,15,17,2
"5c5ceeee4562457ba6d41515aeebfbb1","56586aa865414f538729c7f7735d2bc6",22851902,1,-10,0,43,17,12,-5
"56586aa865414f538729c7f7735d2bc6","5c5ceeee4562457ba6d41515aeebfbb1",22851902,1,10,0,44,12,17,5
"5c5ceeee4562457ba6d41515aeebfbb1","5c5ceeee4562457ba6d41515aeebfbb1",22851902,1,0,1,45,17,17,0
"5c5ceeee4562457ba6d41515aeebfbb1","9afd71a5298d4333b6849dfce1b9422c",22851902,1,3,0,46,17,18,1
"9afd71a5298d4333b6849dfce1b9422c","56586aa865414f538729c7f7735d2bc6",22851902,1,-13,0,47,18,12,-6
"56586aa865414f538729c7f7735d2bc6","9afd71a5298d4333b6849dfce1b9422c",22851902,1,13,0,48,12,18,6
"9afd71a5298d4333b6849dfce1b9422c","9afd71a5298d4333b6849dfce1b9422c",22851902,2,0,1,49,18,18,0
"9afd71a5298d4333b6849dfce1b9422c","b7719e26494940efa49512aedd0aac79",22851902,1,4,0,51,18,20,2
"b7719e26494940efa49512aedd0aac79","d4f45188d3c84a02ba08454e6403a818",22851902,1,5,0,52,20,24,4
"d4f45188d3c84a02ba08454e6403a818","d4c3b003e8274e429d2fa688d73fde6d",22851902,1,-2,0,53,24,22,-2
"d4c3b003e8274e429d2fa688d73fde6d","b7719e26494940efa49512aedd0aac79",22851902,1,-3,0,54,22,20,-2
"b7719e26494940efa49512aedd0aac79","b7719e26494940efa49512aedd0aac79",22851902,1,0,1,55,20,20,0
"b7719e26494940efa49512aedd0aac79","afbf7250b99d47bea07172749483ca97",22851902,1,12,0,56,20,28,8
"afbf7250b99d47bea07172749483ca97","afbf7250b99d47bea07172749483ca97",22851902,1,0,1,57,28,28,0
"afbf7250b99d47bea07172749483ca97","4e51676dc72045d99c19b9fa7b22f8bc",22851902,1,3,0,58,28,29,1
"4e51676dc72045d99c19b9fa7b22f8bc","4e51676dc72045d99c19b9fa7b22f8bc",22851902,1,0,1,59,29,29,0
"4e51676dc72045d99c19b9fa7b22f8bc","51970cfa30e643e894e66ae85c8024cc",22851902,1,3,0,60,29,31,2
"51970cfa30e643e894e66ae85c8024cc","c33c17be71ae4d588da7369472e5bb1b",22851902,1,6,0,61,31,34,3
"c33c17be71ae4d588da7369472e5bb1b","4e51676dc72045d99c19b9fa7b22f8bc",22851902,1,-9,0,62,34,29,-5
"4e51676dc72045d99c19b9fa7b22f8bc","c33c17be71ae4d588da7369472e5bb1b",22851902,1,9,0,63,29,34,5
"c33c17be71ae4d588da7369472e5bb1b","93679be414554a11b1893002f2229a93",22851902,1,3,0,64,34,35,1
"93679be414554a11b1893002f2229a93","7040a13096d746ac84b8fac8d9752058",22851902,1,3,0,65,35,36,1
"7040a13096d746ac84b8fac8d9752058","93679be414554a11b1893002f2229a93",22851902,1,-3,0,66,36,35,-1
"93679be414554a11b1893002f2229a93","9a0dc646f934470daf08c4b56ccf73db",22851902,1,6,0,67,35,37,2
"9a0dc646f934470daf08c4b56ccf73db","7040a13096d746ac84b8fac8d9752058",22851902,1,-3,0,68,37,36,-1
"7040a13096d746ac84b8fac8d9752058","9a0dc646f934470daf08c4b56ccf73db",22851902,1,3,0,69,36,37,1
"9a0dc646f934470daf08c4b56ccf73db","fc0e049d56024bc9a02c9a9c435c3df7",22851902,1,3,0,70,37,38,1
"fc0e049d56024bc9a02c9a9c435c3df7","fc0e049d56024bc9a02c9a9c435c3df7",22851902,1,0,1,71,38,38,0
"fc0e049d56024bc9a02c9a9c435c3df7","67a089198fcb4e1c8f2385786c2b296f",22851902,1,4,0,72,38,39,1
"67a089198fcb4e1c8f2385786c2b296f","64d48c6c9c7940639a932219a6c87198",22851902,2,1,0,73,39,40,1
"64d48c6c9c7940639a932219a6c87198","67a089198fcb4e1c8f2385786c2b296f",22851902,1,-1,0,74,40,39,-1
"64d48c6c9c7940639a932219a6c87198","64d48c6c9c7940639a932219a6c87198",22851902,2,0,1,77,40,40,0
"67a089198fcb4e1c8f2385786c2b296f","0e37b720d23b4e7f8b313e79313fd107",22851902,1,7,0,81,39,44,5
"0e37b720d23b4e7f8b313e79313fd107","0e37b720d23b4e7f8b313e79313fd107",22851902,1,0,1,82,44,44,0
"0e37b720d23b4e7f8b313e79313fd107","6875d67fdd5f48168b62719df449bebd",22851902,1,1,0,83,44,45,1
"6875d67fdd5f48168b62719df449bebd","6875d67fdd5f48168b62719df449bebd",22851902,1,0,1,84,45,45,0
"6875d67fdd5f48168b62719df449bebd","b534b89233134e30a9b5645138bfa9ee",22851902,1,-4,0,85,45,41,-4
"6e13d61a7bdb44bca949c9f86fab3be5","6e13d61a7bdb44bca949c9f86fab3be5",22851902,4,0,1,87,47,47,0
"6e13d61a7bdb44bca949c9f86fab3be5","195f78799f984cc2b06c48dfe36be751",22851902,1,2,0,90,47,49,2
"195f78799f984cc2b06c48dfe36be751","195f78799f984cc2b06c48dfe36be751",22851902,2,0,1,91,49,49,0
"195f78799f984cc2b06c48dfe36be751","6e13d61a7bdb44bca949c9f86fab3be5",22851902,1,-2,0,93,49,47,-2
"6e13d61a7bdb44bca949c9f86fab3be5","d9c8d8c444a64dadbbb508652c721e17",22851902,1,-1,0,95,47,46,-1
"d0c74f735e024943943e40333d6d337f","f924752d8a1149668870b1e7698486f7",22851902,1,-1,0,97,51,50,-1
"f924752d8a1149668870b1e7698486f7","67a089198fcb4e1c8f2385786c2b296f",22851902,1,-15,0,98,50,39,-11
"b534b89233134e30a9b5645138bfa9ee","64d48c6c9c7940639a932219a6c87198",22851902,1,-3,0,100,41,40,-1
"64d48c6c9c7940639a932219a6c87198","b534b89233134e30a9b5645138bfa9ee",22851902,2,3,0,101,40,41,1
"b534b89233134e30a9b5645138bfa9ee","67a089198fcb4e1c8f2385786c2b296f",22851902,4,-4,0,102,41,39,-2
"67a089198fcb4e1c8f2385786c2b296f","b534b89233134e30a9b5645138bfa9ee",22851902,3,4,0,103,39,41,2
"67a089198fcb4e1c8f2385786c2b296f","67a089198fcb4e1c8f2385786c2b296f",22851902,2,0,1,105,39,39,0
"b534b89233134e30a9b5645138bfa9ee","6e13d61a7bdb44bca949c9f86fab3be5",22851902,2,7,0,107,41,47,6
"6e13d61a7bdb44bca949c9f86fab3be5","d0c74f735e024943943e40333d6d337f",22851902,1,5,0,108,47,51,4
"d0c74f735e024943943e40333d6d337f","d9c8d8c444a64dadbbb508652c721e17",22851902,1,-6,0,109,51,46,-5
"d9c8d8c444a64dadbbb508652c721e17","d0c74f735e024943943e40333d6d337f",22851902,2,6,0,110,46,51,5
"d0c74f735e024943943e40333d6d337f","983f8ff320594b279a7f4a6fe132f9c5",22851902,1,2,0,111,51,53,2
"983f8ff320594b279a7f4a6fe132f9c5","983f8ff320594b279a7f4a6fe132f9c5",22851902,2,0,1,112,53,53,0
"983f8ff320594b279a7f4a6fe132f9c5","35adfa5d923046aebabfefd98f35ff05",22851902,1,1,0,114,53,54,1
"35adfa5d923046aebabfefd98f35ff05","35adfa5d923046aebabfefd98f35ff05",22851902,2,0,1,115,54,54,0
"35adfa5d923046aebabfefd98f35ff05","b6f8a98476224da1b40e555ececc7ed8",22851902,1,1,0,117,54,55,1
"b6f8a98476224da1b40e555ececc7ed8","b6f8a98476224da1b40e555ececc7ed8",22851902,2,0,1,118,55,55,0
"b6f8a98476224da1b40e555ececc7ed8","86e22cb5fe0e4b47a9489ecddf7ed78f",22851902,1,1,0,120,55,56,1
"86e22cb5fe0e4b47a9489ecddf7ed78f","86e22cb5fe0e4b47a9489ecddf7ed78f",22851902,2,0,1,121,56,56,0
"86e22cb5fe0e4b47a9489ecddf7ed78f","f924752d8a1149668870b1e7698486f7",22851902,1,-6,0,123,56,50,-6
"f924752d8a1149668870b1e7698486f7","78f30e4dcac84e3cbea8b2cc6e0d62b3",22851902,1,10,0,124,50,59,9
"78f30e4dcac84e3cbea8b2cc6e0d62b3","a1f2f12debe5432fb7a70bcd12bacfb9",22851902,1,-1,0,125,59,58,-1
"a1f2f12debe5432fb7a70bcd12bacfb9","a1f2f12debe5432fb7a70bcd12bacfb9",22851902,35,0,1,126,58,58,0
"a1f2f12debe5432fb7a70bcd12bacfb9","78f30e4dcac84e3cbea8b2cc6e0d62b3",22851902,1,1,0,161,58,59,1
"78f30e4dcac84e3cbea8b2cc6e0d62b3","78f30e4dcac84e3cbea8b2cc6e0d62b3",22851902,8,0,1,162,59,59,0
"78f30e4dcac84e3cbea8b2cc6e0d62b3","12aa6e1672ac4e7aa6449a7a8609cd72",22851902,1,-2,0,170,59,57,-2
"12aa6e1672ac4e7aa6449a7a8609cd72","a0a418b8540d479fa6e0f653b701da8b",22851902,1,8,0,171,57,64,7
"a0a418b8540d479fa6e0f653b701da8b","bc42d26810654ea9a1df1efe1e58c7d5",22851902,1,-1,0,172,64,63,-1
"bc42d26810654ea9a1df1efe1e58c7d5","bc42d26810654ea9a1df1efe1e58c7d5",22851902,4,0,1,173,63,63,0
"bc42d26810654ea9a1df1efe1e58c7d5","a0a418b8540d479fa6e0f653b701da8b",22851902,1,1,0,177,63,64,1
"a0a418b8540d479fa6e0f653b701da8b","a0a418b8540d479fa6e0f653b701da8b",22851902,3,0,1,178,64,64,0
"a0a418b8540d479fa6e0f653b701da8b","4c943503763e4e349906eea3ed3c8e86",22851902,1,-3,0,181,64,61,-3
"4c943503763e4e349906eea3ed3c8e86","4c943503763e4e349906eea3ed3c8e86",22851902,1,0,1,182,61,61,0
"4c943503763e4e349906eea3ed3c8e86","309ccf3cc4fe429d9bfbaef53d3fa479",22851902,1,-1,0,183,61,60,-1
"309ccf3cc4fe429d9bfbaef53d3fa479","d646286c8051419bbc2e31dd1db55ca8",22851902,1,10,0,184,60,67,7
"d646286c8051419bbc2e31dd1db55ca8","b534b89233134e30a9b5645138bfa9ee",22851902,1,-33,0,185,67,41,-26
"67a089198fcb4e1c8f2385786c2b296f","d646286c8051419bbc2e31dd1db55ca8",22851902,1,37,0,187,39,67,28
"d646286c8051419bbc2e31dd1db55ca8","d646286c8051419bbc2e31dd1db55ca8",22851902,1,0,1,188,67,67,0
"d646286c8051419bbc2e31dd1db55ca8","267f883678b24aed855fde42524975d9",22851902,1,4,0,189,67,71,4
"267f883678b24aed855fde42524975d9","267f883678b24aed855fde42524975d9",22851902,1,0,1,190,71,71,0
"267f883678b24aed855fde42524975d9","88fff56d0342490dbef9040750a20f6c",22851902,1,1,0,191,71,72,1
"88fff56d0342490dbef9040750a20f6c","88fff56d0342490dbef9040750a20f6c",22851902,1,0,1,192,72,72,0
"88fff56d0342490dbef9040750a20f6c","adb17b12b66c4a49a85fd34322f7df70",22851902,1,1,0,193,72,73,1
"adb17b12b66c4a49a85fd34322f7df70","adb17b12b66c4a49a85fd34322f7df70",22851902,1,0,1,194,73,73,0
"adb17b12b66c4a49a85fd34322f7df70","d646286c8051419bbc2e31dd1db55ca8",22851902,1,-6,0,195,73,67,-6
"d646286c8051419bbc2e31dd1db55ca8","a2becd407db34b189200a32546d9d569",22851902,1,9,0,196,67,75,8
"a2becd407db34b189200a32546d9d569","a2becd407db34b189200a32546d9d569",22851902,2,0,1,197,75,75,0
"a2becd407db34b189200a32546d9d569","58c22b011d0f4c2ea6d13615edbb9eeb",22851902,1,2,0,199,75,77,2
"58c22b011d0f4c2ea6d13615edbb9eeb","58c22b011d0f4c2ea6d13615edbb9eeb",22851902,2,0,1,200,77,77,0
"58c22b011d0f4c2ea6d13615edbb9eeb","dd76e1861dc9461c830888729d091ee0",22851902,1,1,0,202,77,78,1
"dd76e1861dc9461c830888729d091ee0","dd76e1861dc9461c830888729d091ee0",22851902,5,0,1,203,78,78,0
"dd76e1861dc9461c830888729d091ee0","cd1d828f1a694b87913a7ea66c23803e",22851902,1,1,0,208,78,79,1
"cd1d828f1a694b87913a7ea66c23803e","cd1d828f1a694b87913a7ea66c23803e",22851902,2,0,1,209,79,79,0
"cd1d828f1a694b87913a7ea66c23803e","9176a3c2b4d2465fa8b0c67096c2a97e",22851902,1,1,0,211,79,80,1
"9176a3c2b4d2465fa8b0c67096c2a97e","9176a3c2b4d2465fa8b0c67096c2a97e",22851902,5,0,1,212,80,80,0
"9176a3c2b4d2465fa8b0c67096c2a97e","f8ec6445f7194e25b9101d4fbcb07a18",22851902,1,1,0,217,80,81,1
"f8ec6445f7194e25b9101d4fbcb07a18","f8ec6445f7194e25b9101d4fbcb07a18",22851902,2,0,1,218,81,81,0
"f8ec6445f7194e25b9101d4fbcb07a18","140d5b27b8574befad82c0a013b59dfa",22851902,1,-7,0,220,81,74,-7
"140d5b27b8574befad82c0a013b59dfa","d18a9ea32855445f8736581f5cb119ce",22851902,1,9,0,221,74,82,8
"d18a9ea32855445f8736581f5cb119ce","f564483cbd7a407681aa2fcca518cf5f",22851902,1,4,0,222,82,85,3
"f564483cbd7a407681aa2fcca518cf5f","f564483cbd7a407681aa2fcca518cf5f",22851902,1,0,1,223,85,85,0
"f564483cbd7a407681aa2fcca518cf5f","18fd01350bd5434ca636d59a599d768a",22851902,1,1,0,224,85,86,1
"18fd01350bd5434ca636d59a599d768a","18fd01350bd5434ca636d59a599d768a",22851902,9,0,1,225,86,86,0
"18fd01350bd5434ca636d59a599d768a","ae5ac430ea254e708a6f5deaaf7464ae",22851902,1,-2,0,234,86,84,-2
"ae5ac430ea254e708a6f5deaaf7464ae","6a9f0ef185fb47f0937e29daa1c71ed5",22851902,1,7,0,235,84,90,6
"6a9f0ef185fb47f0937e29daa1c71ed5","c681290961c94c4caf23b529d1ae6b9a",22851902,1,-2,0,236,90,88,-2
"c681290961c94c4caf23b529d1ae6b9a","c681290961c94c4caf23b529d1ae6b9a",22851902,1,0,1,237,88,88,0
"c681290961c94c4caf23b529d1ae6b9a","6a9f0ef185fb47f0937e29daa1c71ed5",22851902,1,2,0,238,88,90,2
"6a9f0ef185fb47f0937e29daa1c71ed5","6a9f0ef185fb47f0937e29daa1c71ed5",22851902,3,0,1,239,90,90,0
"6a9f0ef185fb47f0937e29daa1c71ed5","d646286c8051419bbc2e31dd1db55ca8",22851902,1,-27,0,242,90,67,-23
"d646286c8051419bbc2e31dd1db55ca8","e20db35ced8544ddac5bc3839145e463",22851902,1,30,0,243,67,91,24
"e20db35ced8544ddac5bc3839145e463","1febb706d7a34005ae8711ed49c76e64",22851902,1,3,0,244,91,94,3
"1febb706d7a34005ae8711ed49c76e64","1febb706d7a34005ae8711ed49c76e64",22851902,2,0,1,245,94,94,0
"1febb706d7a34005ae8711ed49c76e64","8f73ba6f5a0042f2850356ac38ac6f24",22851902,1,1,0,247,94,95,1
"8f73ba6f5a0042f2850356ac38ac6f24","8f73ba6f5a0042f2850356ac38ac6f24",22851902,5,0,1,248,95,95,0
"8f73ba6f5a0042f2850356ac38ac6f24","e2260b86653c46d7b14a41fb419dbf8c",22851902,1,1,0,253,95,96,1
"e2260b86653c46d7b14a41fb419dbf8c","e2260b86653c46d7b14a41fb419dbf8c",22851902,2,0,1,254,96,96,0
"e2260b86653c46d7b14a41fb419dbf8c","35eb641ad1d845bbba54915bce75a962",22851902,1,1,0,256,96,97,1
"35eb641ad1d845bbba54915bce75a962","35eb641ad1d845bbba54915bce75a962",22851902,5,0,1,257,97,97,0
"35eb641ad1d845bbba54915bce75a962","08be90ffbeea4795a138cd42ed8db56f",22851902,1,1,0,262,97,98,1
"08be90ffbeea4795a138cd42ed8db56f","08be90ffbeea4795a138cd42ed8db56f",22851902,5,0,1,263,98,98,0
"08be90ffbeea4795a138cd42ed8db56f","3007433c8f584dcbb5ac159c1c5f2be3",22851902,1,1,0,268,98,99,1
"3007433c8f584dcbb5ac159c1c5f2be3","3007433c8f584dcbb5ac159c1c5f2be3",22851902,5,0,1,269,99,99,0
"3007433c8f584dcbb5ac159c1c5f2be3","00ae5f0c51874a73a41ebea838d95682",22851902,1,3,0,274,99,101,2
"00ae5f0c51874a73a41ebea838d95682","e20db35ced8544ddac5bc3839145e463",22851902,1,-11,0,275,101,91,-10
"e20db35ced8544ddac5bc3839145e463","d391c8b6e56a43a7b654e9dee02d904b",22851902,1,13,0,276,91,103,12
"d391c8b6e56a43a7b654e9dee02d904b","67a089198fcb4e1c8f2385786c2b296f",22851902,1,-80,0,277,103,39,-64
"67a089198fcb4e1c8f2385786c2b296f","e20db35ced8544ddac5bc3839145e463",22851902,1,67,0,278,39,91,52
"e20db35ced8544ddac5bc3839145e463","73039f8c1eb9409cb4caee2cf968001e",22851902,1,10,0,279,91,100,9
"73039f8c1eb9409cb4caee2cf968001e","d391c8b6e56a43a7b654e9dee02d904b",22851902,1,3,0,280,100,103,3
"d391c8b6e56a43a7b654e9dee02d904b","00ae5f0c51874a73a41ebea838d95682",22851902,3,-2,0,281,103,101,-2
"00ae5f0c51874a73a41ebea838d95682","00ae5f0c51874a73a41ebea838d95682",22851902,1,0,1,282,101,101,0
"00ae5f0c51874a73a41ebea838d95682","d391c8b6e56a43a7b654e9dee02d904b",22851902,2,2,0,283,101,103,2
"d391c8b6e56a43a7b654e9dee02d904b","d391c8b6e56a43a7b654e9dee02d904b",22851902,15,0,1,284,103,103,0
"00ae5f0c51874a73a41ebea838d95682","6111116566fc4fd9abba409322bea245",22851902,1,3,0,300,101,104,3
"6111116566fc4fd9abba409322bea245","6111116566fc4fd9abba409322bea245",22851902,2,0,1,301,104,104,0
"6111116566fc4fd9abba409322bea245","a81b2235cb9c499eb9ea8ee0a8dd9725",22851902,1,1,0,303,104,105,1
"a81b2235cb9c499eb9ea8ee0a8dd9725","a81b2235cb9c499eb9ea8ee0a8dd9725",22851902,5,0,1,304,105,105,0
"a81b2235cb9c499eb9ea8ee0a8dd9725","2d4e0ab0ef3b4d73b82c72d4621a7579",22851902,1,1,0,309,105,106,1
"2d4e0ab0ef3b4d73b82c72d4621a7579","2d4e0ab0ef3b4d73b82c72d4621a7579",22851902,5,0,1,310,106,106,0
"2d4e0ab0ef3b4d73b82c72d4621a7579","8bdebf492ebd4e62b0d522e8ab5e5197",22851902,1,1,0,315,106,107,1
"8bdebf492ebd4e62b0d522e8ab5e5197","8bdebf492ebd4e62b0d522e8ab5e5197",22851902,2,0,1,316,107,107,0
"8bdebf492ebd4e62b0d522e8ab5e5197","4280927ec4d643238aa49c32f9e06c6c",22851902,1,3,0,318,107,109,2
"4280927ec4d643238aa49c32f9e06c6c","73039f8c1eb9409cb4caee2cf968001e",22851902,2,-10,0,319,109,100,-9
"73039f8c1eb9409cb4caee2cf968001e","08111f75e22d409998cf8b85bd431f0a",22851902,1,9,0,320,100,108,8
"08111f75e22d409998cf8b85bd431f0a","d391c8b6e56a43a7b654e9dee02d904b",22851902,1,-6,0,321,108,103,-5
"00ae5f0c51874a73a41ebea838d95682","73039f8c1eb9409cb4caee2cf968001e",22851902,1,-1,0,323,101,100,-1
"73039f8c1eb9409cb4caee2cf968001e","4280927ec4d643238aa49c32f9e06c6c",22851902,1,10,0,324,100,109,9
"4280927ec4d643238aa49c32f9e06c6c","4280927ec4d643238aa49c32f9e06c6c",22851902,2,0,1,325,109,109,0
"4280927ec4d643238aa49c32f9e06c6c","fc44e6a5f7654430af1227838224dceb",22851902,1,2,0,327,109,111,2
"fc44e6a5f7654430af1227838224dceb","fc44e6a5f7654430af1227838224dceb",22851902,2,0,1,328,111,111,0
"fc44e6a5f7654430af1227838224dceb","a9ae0a3c070d455bb4369a8996313336",22851902,1,4,0,330,111,114,3
"a9ae0a3c070d455bb4369a8996313336","08111f75e22d409998cf8b85bd431f0a",22851902,2,-7,0,331,114,108,-6
"08111f75e22d409998cf8b85bd431f0a","a9ae0a3c070d455bb4369a8996313336",22851902,1,7,0,332,108,114,6
"a9ae0a3c070d455bb4369a8996313336","e20db35ced8544ddac5bc3839145e463",22851902,1,-26,0,333,114,91,-23
"e20db35ced8544ddac5bc3839145e463","00ae5f0c51874a73a41ebea838d95682",22851902,1,11,0,334,91,101,10
"d391c8b6e56a43a7b654e9dee02d904b","4280927ec4d643238aa49c32f9e06c6c",22851902,1,7,0,336,103,109,6
"73039f8c1eb9409cb4caee2cf968001e","a9ae0a3c070d455bb4369a8996313336",22851902,1,16,0,338,100,114,14
"08111f75e22d409998cf8b85bd431f0a","71cec822bcff4f30a20e75dc63ef7b65",22851902,1,9,0,340,108,116,8
"71cec822bcff4f30a20e75dc63ef7b65","71cec822bcff4f30a20e75dc63ef7b65",22851902,1,0,1,341,116,116,0
"71cec822bcff4f30a20e75dc63ef7b65","37319e88176d4aefa91d7a9980dbae91",22851902,1,-4,0,342,116,112,-4
"37319e88176d4aefa91d7a9980dbae91","62bff51286ef4f348717a3cf6fe2318f",22851902,1,9,0,343,112,120,8
"62bff51286ef4f348717a3cf6fe2318f","3ec3a3563847406fa73338f9e9999cf3",22851902,1,-3,0,344,120,117,-3
"3ec3a3563847406fa73338f9e9999cf3","e20db35ced8544ddac5bc3839145e463",22851902,1,-30,0,345,117,91,-26
"e20db35ced8544ddac5bc3839145e463","a9ae0a3c070d455bb4369a8996313336",22851902,1,26,0,346,91,114,23
"a9ae0a3c070d455bb4369a8996313336","62bff51286ef4f348717a3cf6fe2318f",22851902,1,7,0,347,114,120,6
"62bff51286ef4f348717a3cf6fe2318f","37319e88176d4aefa91d7a9980dbae91",22851902,1,-9,0,348,120,112,-8
"37319e88176d4aefa91d7a9980dbae91","b1cd0e7dc3ad4a8eb91a4bfdbeb025b0",22851902,1,7,0,349,112,118,6
"b1cd0e7dc3ad4a8eb91a4bfdbeb025b0","b1cd0e7dc3ad4a8eb91a4bfdbeb025b0",22851902,1,0,1,350,118,118,0
"b1cd0e7dc3ad4a8eb91a4bfdbeb025b0","62bff51286ef4f348717a3cf6fe2318f",22851902,1,2,0,351,118,120,2
"62bff51286ef4f348717a3cf6fe2318f","62bff51286ef4f348717a3cf6fe2318f",22851902,3,0,1,352,120,120,0
"62bff51286ef4f348717a3cf6fe2318f","779f9ddd1fd14d1e9e69f72219a1fdbd",22851902,1,3,0,355,120,121,1
"779f9ddd1fd14d1e9e69f72219a1fdbd","e20db35ced8544ddac5bc3839145e463",22851902,1,-36,0,356,121,91,-30
"e20db35ced8544ddac5bc3839145e463","ae26e6cda8ad4a3f81bd347560d9579f",22851902,1,40,0,357,91,125,34
"ae26e6cda8ad4a3f81bd347560d9579f","ae26e6cda8ad4a3f81bd347560d9579f",22851902,3,0,1,358,125,125,0
"ae26e6cda8ad4a3f81bd347560d9579f","ee48df95832b4374aa273ceb27ec1315",22851902,1,1,0,361,125,126,1
"ee48df95832b4374aa273ceb27ec1315","ee48df95832b4374aa273ceb27ec1315",22851902,1,0,1,362,126,126,0
"ee48df95832b4374aa273ceb27ec1315","7a439da90b394756ad1777fc4c6dead5",22851902,1,1,0,363,126,127,1
"7a439da90b394756ad1777fc4c6dead5","7a439da90b394756ad1777fc4c6dead5",22851902,1,0,1,364,127,127,0
"7a439da90b394756ad1777fc4c6dead5","a8dd5213034441ac92724b4e83eb0bb2",22851902,1,3,0,365,127,129,2
"a8dd5213034441ac92724b4e83eb0bb2","779f9ddd1fd14d1e9e69f72219a1fdbd",22851902,1,-9,0,366,129,121,-8
"779f9ddd1fd14d1e9e69f72219a1fdbd","a8dd5213034441ac92724b4e83eb0bb2",22851902,1,9,0,367,121,129,8
"a8dd5213034441ac92724b4e83eb0bb2","a8dd5213034441ac92724b4e83eb0bb2",22851902,1,0,1,368,129,129,0
"a8dd5213034441ac92724b4e83eb0bb2","8115eab6556b45f5b415c3b8c26a12e5",22851902,1,2,0,369,129,131,2
"8115eab6556b45f5b415c3b8c26a12e5","8115eab6556b45f5b415c3b8c26a12e5",22851902,2,0,1,370,131,131,0
"8115eab6556b45f5b415c3b8c26a12e5","ec34b06efd844b46a4c4818ecdb9b8f4",22851902,1,1,0,372,131,132,1
"ec34b06efd844b46a4c4818ecdb9b8f4","ec34b06efd844b46a4c4818ecdb9b8f4",22851902,2,0,1,373,132,132,0
"ec34b06efd844b46a4c4818ecdb9b8f4","c2e1c2b9eac64109b343a088584b576b",22851902,1,1,0,375,132,133,1
"c2e1c2b9eac64109b343a088584b576b","c2e1c2b9eac64109b343a088584b576b",22851902,2,0,1,376,133,133,0
"c2e1c2b9eac64109b343a088584b576b","a8dd5213034441ac92724b4e83eb0bb2",22851902,1,-4,0,378,133,129,-4
"a8dd5213034441ac92724b4e83eb0bb2","579338175e0b4bbb8ef3b712b5d8b54e",22851902,1,-1,0,379,129,128,-1
"579338175e0b4bbb8ef3b712b5d8b54e","8bc5795d6a984a3eace4e2811e52dd4f",22851902,1,8,0,380,128,135,7
"8bc5795d6a984a3eace4e2811e52dd4f","8bc5795d6a984a3eace4e2811e52dd4f",22851902,1,0,1,381,135,135,0
"8bc5795d6a984a3eace4e2811e52dd4f","b416d47c56a742199b5d7c7f19d6503a",22851902,1,-1,0,382,135,134,-1
"b416d47c56a742199b5d7c7f19d6503a","cd4532ad48034873ba8bce2aac0c9808",22851902,1,4,0,383,134,137,3
"cd4532ad48034873ba8bce2aac0c9808","cd4532ad48034873ba8bce2aac0c9808",22851902,3,0,1,384,137,137,0
"cd4532ad48034873ba8bce2aac0c9808","df1de691dafe4549a18a4398ee9dfaf9",22851902,1,4,0,387,137,139,2
"df1de691dafe4549a18a4398ee9dfaf9","779f9ddd1fd14d1e9e69f72219a1fdbd",22851902,1,-23,0,388,139,121,-18
"779f9ddd1fd14d1e9e69f72219a1fdbd","6c5ad271a44743479bfaea29b1db8d02",22851902,1,27,0,389,121,143,22
"6c5ad271a44743479bfaea29b1db8d02","67a089198fcb4e1c8f2385786c2b296f",22851902,1,-130,0,390,143,39,-104
"67a089198fcb4e1c8f2385786c2b296f","df1de691dafe4549a18a4398ee9dfaf9",22851902,1,126,0,391,39,139,100
"df1de691dafe4549a18a4398ee9dfaf9","df1de691dafe4549a18a4398ee9dfaf9",22851902,1,0,1,392,139,139,0
"df1de691dafe4549a18a4398ee9dfaf9","6c5ad271a44743479bfaea29b1db8d02",22851902,1,4,0,393,139,143,4
"6c5ad271a44743479bfaea29b1db8d02","6c5ad271a44743479bfaea29b1db8d02",22851902,1,0,1,394,143,143,0
"6c5ad271a44743479bfaea29b1db8d02","83d311bed5374fee83d8d67a7d9d82dc",22851902,1,1,0,395,143,144,1
"83d311bed5374fee83d8d67a7d9d82dc","83d311bed5374fee83d8d67a7d9d82dc",22851902,5,0,1,396,144,144,0
"83d311bed5374fee83d8d67a7d9d82dc","402bba41861d43acb52a5abb89e8831e",22851902,1,1,0,401,144,145,1
"402bba41861d43acb52a5abb89e8831e","402bba41861d43acb52a5abb89e8831e",22851902,2,0,1,402,145,145,0
"402bba41861d43acb52a5abb89e8831e","df1de691dafe4549a18a4398ee9dfaf9",22851902,1,-6,0,404,145,139,-6
"df1de691dafe4549a18a4398ee9dfaf9","8aae34f5ddbb4052a709b12e6b0d40fa",22851902,1,9,0,405,139,147,8
"8aae34f5ddbb4052a709b12e6b0d40fa","8aae34f5ddbb4052a709b12e6b0d40fa",22851902,3,0,1,406,147,147,0
"8aae34f5ddbb4052a709b12e6b0d40fa","645b3f0249f64f76af2e19eb4d0e55b7",22851902,1,2,0,409,147,149,2
"645b3f0249f64f76af2e19eb4d0e55b7","645b3f0249f64f76af2e19eb4d0e55b7",22851902,2,0,1,410,149,149,0
"645b3f0249f64f76af2e19eb4d0e55b7","8aae34f5ddbb4052a709b12e6b0d40fa",22851902,1,-2,0,412,149,147,-2
"8aae34f5ddbb4052a709b12e6b0d40fa","7e7b8db5064d4369805ab370aac5ddfb",22851902,1,3,0,413,147,150,3
"7e7b8db5064d4369805ab370aac5ddfb","7e7b8db5064d4369805ab370aac5ddfb",22851902,2,0,1,414,150,150,0
"7e7b8db5064d4369805ab370aac5ddfb","8956d210ae7f41968fada86d4c979d6a",22851902,1,1,0,416,150,151,1
"8956d210ae7f41968fada86d4c979d6a","8956d210ae7f41968fada86d4c979d6a",22851902,2,0,1,417,151,151,0
"8956d210ae7f41968fada86d4c979d6a","f902b0f41b544d4dbf79664fd233648d",22851902,1,-5,0,419,151,146,-5
"f902b0f41b544d4dbf79664fd233648d","ae781e8b775e4ccd93bc800dad5c8376",22851902,1,8,0,420,146,153,7
"ae781e8b775e4ccd93bc800dad5c8376","ae781e8b775e4ccd93bc800dad5c8376",22851902,2,0,1,421,153,153,0
"ae781e8b775e4ccd93bc800dad5c8376","06882a8492d9499aa31555567f575ecb",22851902,1,1,0,423,153,154,1
"06882a8492d9499aa31555567f575ecb","06882a8492d9499aa31555567f575ecb",22851902,1,0,1,424,154,154,0
"06882a8492d9499aa31555567f575ecb","f293c508f409466a8f27ddd7d1e40b20",22851902,1,1,0,425,154,155,1
"f293c508f409466a8f27ddd7d1e40b20","f293c508f409466a8f27ddd7d1e40b20",22851902,2,0,1,426,155,155,0
"f293c508f409466a8f27ddd7d1e40b20","cc4ddef5bbbe48ebb605141b347c4ed1",22851902,1,1,0,428,155,156,1
"cc4ddef5bbbe48ebb605141b347c4ed1","cc4ddef5bbbe48ebb605141b347c4ed1",22851902,3,0,1,429,156,156,0
"cc4ddef5bbbe48ebb605141b347c4ed1","d313cec988a84645bee413e8d4724a4b",22851902,1,3,0,432,156,158,2
"d313cec988a84645bee413e8d4724a4b","f03480cf4eba413194d7af52fc0e7f28",22851902,1,-7,0,433,158,152,-6
"f03480cf4eba413194d7af52fc0e7f28","d313cec988a84645bee413e8d4724a4b",22851902,1,7,0,434,152,158,6
"d313cec988a84645bee413e8d4724a4b","d313cec988a84645bee413e8d4724a4b",22851902,3,0,1,435,158,158,0
"d313cec988a84645bee413e8d4724a4b","dc60696c76a74368a60f72246e47700d",22851902,1,1,0,438,158,159,1
"dc60696c76a74368a60f72246e47700d","dc60696c76a74368a60f72246e47700d",22851902,1,0,1,439,159,159,0
"dc60696c76a74368a60f72246e47700d","df1de691dafe4549a18a4398ee9dfaf9",22851902,1,-23,0,440,159,139,-20
"df1de691dafe4549a18a4398ee9dfaf9","78adeee1fa2c4fe0bc73f7bca9fcee86",22851902,1,26,0,441,139,160,21
"78adeee1fa2c4fe0bc73f7bca9fcee86","65202579580f4ad38d734b4ee39d22a8",22851902,4,5,0,442,160,164,4
"65202579580f4ad38d734b4ee39d22a8","78adeee1fa2c4fe0bc73f7bca9fcee86",22851902,2,-5,0,449,164,160,-4
"65202579580f4ad38d734b4ee39d22a8","8959e6304a0348309a771e4d08d1b64a",22851902,1,-1,0,451,164,163,-1
"8959e6304a0348309a771e4d08d1b64a","78adeee1fa2c4fe0bc73f7bca9fcee86",22851902,2,-4,0,452,163,160,-3
"78adeee1fa2c4fe0bc73f7bca9fcee86","3cbcea2be0984e7dbd5a48195af10ce7",22851902,1,8,0,507,160,165,5
"3cbcea2be0984e7dbd5a48195af10ce7","82e6285962b8400d9d6fc32436022a94",22851902,1,2,0,508,165,167,2
"82e6285962b8400d9d6fc32436022a94","a9ac840f098c4bd0a2ee896214ce29cd",22851902,1,3,0,509,167,168,1
"a9ac840f098c4bd0a2ee896214ce29cd","3cbcea2be0984e7dbd5a48195af10ce7",22851902,1,-5,0,510,168,165,-3
"3cbcea2be0984e7dbd5a48195af10ce7","a9ac840f098c4bd0a2ee896214ce29cd",22851902,1,5,0,511,165,168,3
"a9ac840f098c4bd0a2ee896214ce29cd","0c7262dff33c4087bc660ccf40f92f9c",22851902,1,4,0,512,168,169,1
"0c7262dff33c4087bc660ccf40f92f9c","b2275c3fad834f8d90737a2d9a6927d6",22851902,2,3,0,513,169,172,3
"b2275c3fad834f8d90737a2d9a6927d6","fab84b4fab5940efb4ea868ef8d09396",22851902,1,150,0,514,172,284,112
"fab84b4fab5940efb4ea868ef8d09396","a9ac840f098c4bd0a2ee896214ce29cd",22851902,1,-157,0,515,284,168,-116
"a9ac840f098c4bd0a2ee896214ce29cd","a9ac840f098c4bd0a2ee896214ce29cd",22851902,1,0,1,516,168,168,0
"a9ac840f098c4bd0a2ee896214ce29cd","67a089198fcb4e1c8f2385786c2b296f",22851902,1,-165,0,517,168,39,-129
"67a089198fcb4e1c8f2385786c2b296f","8959e6304a0348309a771e4d08d1b64a",22851902,1,156,0,518,39,163,124
"65202579580f4ad38d734b4ee39d22a8","0c7262dff33c4087bc660ccf40f92f9c",22851902,1,12,0,528,164,169,5
"0c7262dff33c4087bc660ccf40f92f9c","0c7262dff33c4087bc660ccf40f92f9c",22851902,1,0,1,529,169,169,0
"b2275c3fad834f8d90737a2d9a6927d6","b2275c3fad834f8d90737a2d9a6927d6",22851902,22,0,1,531,172,172,0
"b2275c3fad834f8d90737a2d9a6927d6","eb515a26030b41f8a82a1e6114420bad",22851902,1,1,0,553,172,173,1
"eb515a26030b41f8a82a1e6114420bad","eb515a26030b41f8a82a1e6114420bad",22851902,2,0,1,554,173,173,0
"eb515a26030b41f8a82a1e6114420bad","0c7262dff33c4087bc660ccf40f92f9c",22851902,1,-4,0,556,173,169,-4
"0c7262dff33c4087bc660ccf40f92f9c","b42cc17b7de840f181a704558d0bc845",22851902,2,7,0,557,169,175,6
"b42cc17b7de840f181a704558d0bc845","b42cc17b7de840f181a704558d0bc845",22851902,7,0,1,558,175,175,0
"b42cc17b7de840f181a704558d0bc845","362fcb0699a14845ab29b2340093e528",22851902,1,-1,0,559,175,174,-1
"362fcb0699a14845ab29b2340093e528","0c7262dff33c4087bc660ccf40f92f9c",22851902,1,-6,0,560,174,169,-5
"b42cc17b7de840f181a704558d0bc845","801f9e9135034f49bf5f8b4bdefedb41",22851902,1,2,0,568,175,177,2
"801f9e9135034f49bf5f8b4bdefedb41","801f9e9135034f49bf5f8b4bdefedb41",22851902,8,0,1,569,177,177,0
"801f9e9135034f49bf5f8b4bdefedb41","ea38cc0e6e6e41edbabf210220808bf9",22851902,1,3,0,577,177,179,2
"ea38cc0e6e6e41edbabf210220808bf9","362fcb0699a14845ab29b2340093e528",22851902,1,-6,0,578,179,174,-5
"362fcb0699a14845ab29b2340093e528","b87c552dd247427abe6ab5795b9c9d43",22851902,1,8,0,579,174,181,7
"b87c552dd247427abe6ab5795b9c9d43","ea38cc0e6e6e41edbabf210220808bf9",22851902,1,-2,0,580,181,179,-2
"ea38cc0e6e6e41edbabf210220808bf9","ea38cc0e6e6e41edbabf210220808bf9",22851902,1,0,1,581,179,179,0
"ea38cc0e6e6e41edbabf210220808bf9","b87c552dd247427abe6ab5795b9c9d43",22851902,1,2,0,582,179,181,2
"b87c552dd247427abe6ab5795b9c9d43","b87c552dd247427abe6ab5795b9c9d43",22851902,7,0,1,583,181,181,0
"b87c552dd247427abe6ab5795b9c9d43","139b097acfca451689d80c9c6eebdf7b",22851902,1,-3,0,590,181,178,-3
"139b097acfca451689d80c9c6eebdf7b","30f660a1feb34582a739722532524f79",22851902,1,6,0,591,178,183,5
"30f660a1feb34582a739722532524f79","30f660a1feb34582a739722532524f79",22851902,8,0,1,592,183,183,0
"30f660a1feb34582a739722532524f79","2024b4885bd14338a39b7b509acbbd02",22851902,1,-1,0,600,183,182,-1
"2024b4885bd14338a39b7b509acbbd02","c3f63fe50d8e487c86bf8ef76c9cadd3",22851902,1,4,0,601,182,185,3
"c3f63fe50d8e487c86bf8ef76c9cadd3","c3f63fe50d8e487c86bf8ef76c9cadd3",22851902,1,0,1,602,185,185,0
"c3f63fe50d8e487c86bf8ef76c9cadd3","0c7262dff33c4087bc660ccf40f92f9c",22851902,1,-20,0,603,185,169,-16
"0c7262dff33c4087bc660ccf40f92f9c","c8e371568a0c4391b25796ae4e91952e",22851902,2,23,0,604,169,186,17
"c8e371568a0c4391b25796ae4e91952e","0c7262dff33c4087bc660ccf40f92f9c",22851902,1,-23,0,605,186,169,-17
"c8e371568a0c4391b25796ae4e91952e","c8e371568a0c4391b25796ae4e91952e",22851902,1,0,1,607,186,186,0
"c8e371568a0c4391b25796ae4e91952e","7d932b23e1c84326ae5aa4d3c0d813d1",22851902,1,2,0,608,186,188,2
"7d932b23e1c84326ae5aa4d3c0d813d1","7d932b23e1c84326ae5aa4d3c0d813d1",22851902,1,0,1,609,188,188,0
"7d932b23e1c84326ae5aa4d3c0d813d1","c8e371568a0c4391b25796ae4e91952e",22851902,1,-2,0,610,188,186,-2
"c8e371568a0c4391b25796ae4e91952e","ab11d94c6c8948ea90b88f19d2cd502b",22851902,2,5,0,611,186,190,4
"ab11d94c6c8948ea90b88f19d2cd502b","ab11d94c6c8948ea90b88f19d2cd502b",22851902,2,0,1,612,190,190,0
"ab11d94c6c8948ea90b88f19d2cd502b","07b44a7a51e94c78b411c753fc39dab0",22851902,1,-1,0,613,190,189,-1
"07b44a7a51e94c78b411c753fc39dab0","c8e371568a0c4391b25796ae4e91952e",22851902,1,-4,0,614,189,186,-3
"ab11d94c6c8948ea90b88f19d2cd502b","f992451ed6ad4e68bb9e68ad6be7c4be",22851902,1,2,0,617,190,192,2
"f992451ed6ad4e68bb9e68ad6be7c4be","f992451ed6ad4e68bb9e68ad6be7c4be",22851902,3,0,1,618,192,192,0
"f992451ed6ad4e68bb9e68ad6be7c4be","07b44a7a51e94c78b411c753fc39dab0",22851902,1,-3,0,621,192,189,-3
"07b44a7a51e94c78b411c753fc39dab0","6cd2dcaac46847d4a0bc53f296d90375",22851902,1,6,0,622,189,194,5
"6cd2dcaac46847d4a0bc53f296d90375","6cd2dcaac46847d4a0bc53f296d90375",22851902,3,0,1,623,194,194,0
"6cd2dcaac46847d4a0bc53f296d90375","017d7ca8e0394b91aaadc9574df2202c",22851902,1,-1,0,624,194,193,-1
"017d7ca8e0394b91aaadc9574df2202c","c8e371568a0c4391b25796ae4e91952e",22851902,1,-9,0,625,193,186,-7
"c8e371568a0c4391b25796ae4e91952e","6cd2dcaac46847d4a0bc53f296d90375",22851902,1,10,0,626,186,194,8
"6cd2dcaac46847d4a0bc53f296d90375","2d2580c9411c4972909db508d6956a58",22851902,1,2,0,629,194,196,2
"2d2580c9411c4972909db508d6956a58","2d2580c9411c4972909db508d6956a58",22851902,5,0,1,630,196,196,0
"2d2580c9411c4972909db508d6956a58","5bddb3d9ed264f3984702f048c7e5340",22851902,1,1,0,635,196,197,1
"5bddb3d9ed264f3984702f048c7e5340","5bddb3d9ed264f3984702f048c7e5340",22851902,2,0,1,636,197,197,0
"5bddb3d9ed264f3984702f048c7e5340","d5e8e2bd12a2466b9d6d90855f0eb079",22851902,1,1,0,638,197,198,1
"d5e8e2bd12a2466b9d6d90855f0eb079","d5e8e2bd12a2466b9d6d90855f0eb079",22851902,2,0,1,639,198,198,0
"d5e8e2bd12a2466b9d6d90855f0eb079","017d7ca8e0394b91aaadc9574df2202c",22851902,1,-5,0,641,198,193,-5
"017d7ca8e0394b91aaadc9574df2202c","54e8e9f0ea3e45c4bf3b8ac799ee31b1",22851902,1,8,0,642,193,200,7
"54e8e9f0ea3e45c4bf3b8ac799ee31b1","54e8e9f0ea3e45c4bf3b8ac799ee31b1",22851902,1,0,1,643,200,200,0
"54e8e9f0ea3e45c4bf3b8ac799ee31b1","c614a00911be4877a075f19315530fb0",22851902,1,1,0,644,200,201,1
"c614a00911be4877a075f19315530fb0","c614a00911be4877a075f19315530fb0",22851902,6,0,1,645,201,201,0
"c614a00911be4877a075f19315530fb0","a6c21bd8b95249c7972820a7a7d76aff",22851902,1,1,0,651,201,202,1
"a6c21bd8b95249c7972820a7a7d76aff","a6c21bd8b95249c7972820a7a7d76aff",22851902,1,0,1,652,202,202,0
"a6c21bd8b95249c7972820a7a7d76aff","bb329d880ab54120adaf203a693bb203",22851902,1,1,0,653,202,203,1
"bb329d880ab54120adaf203a693bb203","bb329d880ab54120adaf203a693bb203",22851902,1,0,1,654,203,203,0
"bb329d880ab54120adaf203a693bb203","f9170dd6bc6442b4acd832747609b09a",22851902,1,-4,0,655,203,199,-4
"f9170dd6bc6442b4acd832747609b09a","334c2344009840079b1d0e1b7ce3d5a7",22851902,1,7,0,656,199,205,6
"334c2344009840079b1d0e1b7ce3d5a7","334c2344009840079b1d0e1b7ce3d5a7",22851902,1,0,1,657,205,205,0
"334c2344009840079b1d0e1b7ce3d5a7","c8e371568a0c4391b25796ae4e91952e",22851902,1,-23,0,658,205,186,-19
"c8e371568a0c4391b25796ae4e91952e","d7f13c8d63ec4e2aa673fbb9cf9c6933",22851902,1,26,0,659,186,206,20
"d7f13c8d63ec4e2aa673fbb9cf9c6933","b9e80f77c3a44349863b19875725c384",22851902,2,1,0,660,206,207,1
"b9e80f77c3a44349863b19875725c384","7108f0e4c2584f1f9c471689ae4c885c",22851902,3,1,0,661,207,208,1
"7108f0e4c2584f1f9c471689ae4c885c","0c7262dff33c4087bc660ccf40f92f9c",22851902,1,-51,0,662,208,169,-39
"0c7262dff33c4087bc660ccf40f92f9c","d7f13c8d63ec4e2aa673fbb9cf9c6933",22851902,1,49,0,663,169,206,37
"d7f13c8d63ec4e2aa673fbb9cf9c6933","d7f13c8d63ec4e2aa673fbb9cf9c6933",22851902,1,0,1,664,206,206,0
"7108f0e4c2584f1f9c471689ae4c885c","b9e80f77c3a44349863b19875725c384",22851902,1,-1,0,667,208,207,-1
"b9e80f77c3a44349863b19875725c384","b9e80f77c3a44349863b19875725c384",22851902,11,0,1,668,207,207,0
"7108f0e4c2584f1f9c471689ae4c885c","7108f0e4c2584f1f9c471689ae4c885c",22851902,11,0,1,680,208,208,0
"7108f0e4c2584f1f9c471689ae4c885c","09400e101c5d4b439cf9a26b03aae558",22851902,1,3,0,691,208,210,2
"09400e101c5d4b439cf9a26b03aae558","d7f13c8d63ec4e2aa673fbb9cf9c6933",22851902,1,-5,0,692,210,206,-4
"09400e101c5d4b439cf9a26b03aae558","09400e101c5d4b439cf9a26b03aae558",22851902,1,0,1,694,210,210,0
"a88efa7e50ce47159810ab553afa6d3a","a875096404ef4a9984b62d74cda916f9",22851902,1,-3,0,698,212,209,-3
"f7fb1952f56b4189b86a9f8b7862d2b8","be502a7a43c44bf7b682698de79d9369",22851902,1,-1,0,700,215,214,-1
"be502a7a43c44bf7b682698de79d9369","be502a7a43c44bf7b682698de79d9369",22851902,1,0,1,701,214,214,0
"be502a7a43c44bf7b682698de79d9369","f7fb1952f56b4189b86a9f8b7862d2b8",22851902,1,1,0,702,214,215,1
"f7fb1952f56b4189b86a9f8b7862d2b8","f7fb1952f56b4189b86a9f8b7862d2b8",22851902,14,0,1,703,215,215,0
"f7fb1952f56b4189b86a9f8b7862d2b8","b860ee85d8bc4a2f97958cfb71be3533",22851902,1,1,0,717,215,216,1
"b860ee85d8bc4a2f97958cfb71be3533","b860ee85d8bc4a2f97958cfb71be3533",22851902,5,0,1,718,216,216,0
"b860ee85d8bc4a2f97958cfb71be3533","ec341f459285443b8361f7f15638ff08",22851902,1,-3,0,723,216,213,-3
"ec341f459285443b8361f7f15638ff08","363837c182e04711840d896ae1e0339c",22851902,1,6,0,724,213,218,5
"363837c182e04711840d896ae1e0339c","363837c182e04711840d896ae1e0339c",22851902,12,0,1,725,218,218,0
"363837c182e04711840d896ae1e0339c","01b2051f8941460d89945e3b02d1ce78",22851902,1,-1,0,737,218,217,-1
"01b2051f8941460d89945e3b02d1ce78","91125ca626c5470eb145501f8c37f8db",22851902,1,4,0,738,217,220,3
"91125ca626c5470eb145501f8c37f8db","91125ca626c5470eb145501f8c37f8db",22851902,1,0,1,739,220,220,0
"91125ca626c5470eb145501f8c37f8db","d7f13c8d63ec4e2aa673fbb9cf9c6933",22851902,1,-18,0,740,220,206,-14
"d7f13c8d63ec4e2aa673fbb9cf9c6933","1c6721b1f63f4d30ba7746ea8af02a52",22851902,1,21,0,741,206,221,15
"1c6721b1f63f4d30ba7746ea8af02a52","77ecef8eff6b4a2caea7707669bf7475",22851902,1,1,0,742,221,222,1
"77ecef8eff6b4a2caea7707669bf7475","77ecef8eff6b4a2caea7707669bf7475",22851902,12,0,1,743,222,222,0
"77ecef8eff6b4a2caea7707669bf7475","1c6721b1f63f4d30ba7746ea8af02a52",22851902,1,-1,0,755,222,221,-1
"1c6721b1f63f4d30ba7746ea8af02a52","d03cb855c70044cf8c35d9ec0de696e3",22851902,1,4,0,756,221,224,3
"d03cb855c70044cf8c35d9ec0de696e3","8b9ae98743bd4d4a8a87dff1c1244211",22851902,1,3,0,757,224,227,3
"8b9ae98743bd4d4a8a87dff1c1244211","d03cb855c70044cf8c35d9ec0de696e3",22851902,1,-3,0,758,227,224,-3
"d03cb855c70044cf8c35d9ec0de696e3","a49a937d6896486d9a5396654abcf2e1",22851902,1,2,0,759,224,226,2
"a49a937d6896486d9a5396654abcf2e1","a49a937d6896486d9a5396654abcf2e1",22851902,1,0,1,760,226,226,0
"a49a937d6896486d9a5396654abcf2e1","8b9ae98743bd4d4a8a87dff1c1244211",22851902,1,1,0,761,226,227,1
"8b9ae98743bd4d4a8a87dff1c1244211","8b9ae98743bd4d4a8a87dff1c1244211",22851902,22,0,1,762,227,227,0
"8b9ae98743bd4d4a8a87dff1c1244211","2ab1535aac1346ba8801535bf729ef37",22851902,1,3,0,784,227,229,2
"2ab1535aac1346ba8801535bf729ef37","f7906d6f59b9489a91d2ef40db5a474d",22851902,1,-7,0,785,229,223,-6
"f7906d6f59b9489a91d2ef40db5a474d","2ab1535aac1346ba8801535bf729ef37",22851902,1,7,0,786,223,229,6
"2ab1535aac1346ba8801535bf729ef37","2ab1535aac1346ba8801535bf729ef37",22851902,2,0,1,787,229,229,0
"2ab1535aac1346ba8801535bf729ef37","a4f40fb48a8542c8949bae1f002cd9bc",22851902,1,2,0,789,229,231,2
"a4f40fb48a8542c8949bae1f002cd9bc","a4f40fb48a8542c8949bae1f002cd9bc",22851902,5,0,1,790,231,231,0
"a4f40fb48a8542c8949bae1f002cd9bc","8972c23e32044edb8a78fa1eed4e5947",22851902,1,1,0,795,231,232,1
"8972c23e32044edb8a78fa1eed4e5947","8972c23e32044edb8a78fa1eed4e5947",22851902,1,0,1,796,232,232,0
"8972c23e32044edb8a78fa1eed4e5947","92feb4a40f8344d38b6f722e42a53295",22851902,1,1,0,797,232,233,1
"92feb4a40f8344d38b6f722e42a53295","92feb4a40f8344d38b6f722e42a53295",22851902,1,0,1,798,233,233,0
"92feb4a40f8344d38b6f722e42a53295","5152833676bf4c6cb317060be10f68db",22851902,1,-5,0,799,233,228,-5
"5152833676bf4c6cb317060be10f68db","92feb4a40f8344d38b6f722e42a53295",22851902,1,5,0,800,228,233,5
"92feb4a40f8344d38b6f722e42a53295","ca3e28f290354c08aefe5b0f769604e6",22851902,1,3,0,801,233,235,2
"ca3e28f290354c08aefe5b0f769604e6","ca3e28f290354c08aefe5b0f769604e6",22851902,14,0,1,802,235,235,0
"ca3e28f290354c08aefe5b0f769604e6","79a35eea833e4c2c9d22fc53c3c6445c",22851902,1,1,0,816,235,236,1
"79a35eea833e4c2c9d22fc53c3c6445c","79a35eea833e4c2c9d22fc53c3c6445c",22851902,4,0,1,817,236,236,0
"79a35eea833e4c2c9d22fc53c3c6445c","8f68228b1518449e9615cdafee41a2bd",22851902,1,1,0,821,236,237,1
"8f68228b1518449e9615cdafee41a2bd","8f68228b1518449e9615cdafee41a2bd",22851902,1,0,1,822,237,237,0
"8f68228b1518449e9615cdafee41a2bd","cab89fa5c3ed45a5aa550fc0352d6a42",22851902,1,1,0,823,237,238,1
"cab89fa5c3ed45a5aa550fc0352d6a42","cab89fa5c3ed45a5aa550fc0352d6a42",22851902,3,0,1,824,238,238,0
"cab89fa5c3ed45a5aa550fc0352d6a42","66d4fad4f1cf4b46be0750a99ad7a35a",22851902,1,1,0,827,238,239,1
"66d4fad4f1cf4b46be0750a99ad7a35a","66d4fad4f1cf4b46be0750a99ad7a35a",22851902,1,0,1,828,239,239,0
"66d4fad4f1cf4b46be0750a99ad7a35a","0b04c8e2f86d48c7aeb7e225819cd32b",22851902,1,-5,0,829,239,234,-5
"0b04c8e2f86d48c7aeb7e225819cd32b","f53da5fd9bfe412da4b80d4742563b6c",22851902,1,8,0,830,234,241,7
"f53da5fd9bfe412da4b80d4742563b6c","f53da5fd9bfe412da4b80d4742563b6c",22851902,1,0,1,831,241,241,0
"f53da5fd9bfe412da4b80d4742563b6c","2ae94c0cea4d480a9d5dca8fb1d7b542",22851902,1,3,0,832,241,242,1
"2ae94c0cea4d480a9d5dca8fb1d7b542","1c6721b1f63f4d30ba7746ea8af02a52",22851902,1,-27,0,833,242,221,-21
"1c6721b1f63f4d30ba7746ea8af02a52","1ebf23f9d994469a85206e4c7b1bf5f5",22851902,1,30,0,834,221,245,24
"1ebf23f9d994469a85206e4c7b1bf5f5","1ebf23f9d994469a85206e4c7b1bf5f5",22851902,14,0,1,835,245,245,0
"1ebf23f9d994469a85206e4c7b1bf5f5","85ae675b83e8422da842cfd25596af99",22851902,1,1,0,849,245,246,1
"85ae675b83e8422da842cfd25596af99","85ae675b83e8422da842cfd25596af99",22851902,1,0,1,850,246,246,0
"85ae675b83e8422da842cfd25596af99","2ae94c0cea4d480a9d5dca8fb1d7b542",22851902,1,-4,0,851,246,242,-4
"2ae94c0cea4d480a9d5dca8fb1d7b542","30c9ba177afc49a695625d2bdec40207",22851902,1,9,0,852,242,250,8
"30c9ba177afc49a695625d2bdec40207","30c9ba177afc49a695625d2bdec40207",22851902,8,0,1,853,250,250,0
"30c9ba177afc49a695625d2bdec40207","6e83e23f56544a19b94067c1c558d9c0",22851902,1,-3,0,861,250,247,-3
"6e83e23f56544a19b94067c1c558d9c0","00f61990949545828dd12f1303d47504",22851902,1,11,0,862,247,256,9
"00f61990949545828dd12f1303d47504","ead7bb4b64e247d2ae632ab8a296b091",22851902,1,2,0,863,256,258,2
"ead7bb4b64e247d2ae632ab8a296b091","ead7bb4b64e247d2ae632ab8a296b091",22851902,2,0,1,864,258,258,0
"ead7bb4b64e247d2ae632ab8a296b091","41b0048dde734bb280bac6116baa8e27",22851902,1,1,0,866,258,259,1
"41b0048dde734bb280bac6116baa8e27","41b0048dde734bb280bac6116baa8e27",22851902,2,0,1,867,259,259,0
"41b0048dde734bb280bac6116baa8e27","b41c5a094a604ee0915327da5cc0beb7",22851902,1,1,0,869,259,260,1
"b41c5a094a604ee0915327da5cc0beb7","b41c5a094a604ee0915327da5cc0beb7",22851902,5,0,1,870,260,260,0
"b41c5a094a604ee0915327da5cc0beb7","d546341988904f069cfa86b21457d9d9",22851902,1,-10,0,875,260,251,-9
"d546341988904f069cfa86b21457d9d9","28c171777c52431ab6b925073bd63d46",22851902,1,15,0,876,251,264,13
"28c171777c52431ab6b925073bd63d46","28c171777c52431ab6b925073bd63d46",22851902,7,0,1,877,264,264,0
"28c171777c52431ab6b925073bd63d46","ac160db940cb49ae8579162b1d52bb5d",22851902,1,2,0,884,264,266,2
"ac160db940cb49ae8579162b1d52bb5d","ac160db940cb49ae8579162b1d52bb5d",22851902,7,0,1,885,266,266,0
"ac160db940cb49ae8579162b1d52bb5d","d989ebcfc12a4b669f0100dc1aa14f1e",22851902,1,-12,0,892,266,255,-11
"d989ebcfc12a4b669f0100dc1aa14f1e","c6fd49b485cc4874b0bbdd9c6171e09c",22851902,1,15,0,893,255,268,13
"c6fd49b485cc4874b0bbdd9c6171e09c","c6fd49b485cc4874b0bbdd9c6171e09c",22851902,3,0,1,894,268,268,0
"c6fd49b485cc4874b0bbdd9c6171e09c","44240778a97c4af0937817499b75707b",22851902,1,1,0,897,268,269,1
"44240778a97c4af0937817499b75707b","44240778a97c4af0937817499b75707b",22851902,2,0,1,898,269,269,0
"44240778a97c4af0937817499b75707b","7aa76d3e993840d8805f097cbdbcd44b",22851902,1,-9,0,900,269,261,-8
"7aa76d3e993840d8805f097cbdbcd44b","865a4d3b43374da7944dc7d397f566d9",22851902,1,12,0,901,261,271,10
"865a4d3b43374da7944dc7d397f566d9","865a4d3b43374da7944dc7d397f566d9",22851902,1,0,1,902,271,271,0
"865a4d3b43374da7944dc7d397f566d9","2ae94c0cea4d480a9d5dca8fb1d7b542",22851902,1,-35,0,903,271,242,-29
"2ae94c0cea4d480a9d5dca8fb1d7b542","0d987bed3ffa4ed0b9a2e62e97b7b30f",22851902,1,38,0,904,242,272,30
"0d987bed3ffa4ed0b9a2e62e97b7b30f","82ae07bc0c9b4570a41799290d1ef399",22851902,1,4,0,906,272,275,3
"bb5a47f5ea01454a8b79455422d3b9da","0d987bed3ffa4ed0b9a2e62e97b7b30f",22851902,1,-10,0,925,280,272,-8
"0d987bed3ffa4ed0b9a2e62e97b7b30f","94cecc3f1e7d484b8e068e79241dfd73",22851902,1,13,0,926,272,281,9
"94cecc3f1e7d484b8e068e79241dfd73","a37477c4e4c14169ad44b06b493007f6",22851902,1,2,0,927,281,283,2
"a37477c4e4c14169ad44b06b493007f6","4a29443515bb404cb8924e1c60a63b73",22851902,1,7,0,928,283,285,2
"4a29443515bb404cb8924e1c60a63b73","4a29443515bb404cb8924e1c60a63b73",22851902,1,0,1,929,285,285,0
"4a29443515bb404cb8924e1c60a63b73","208c9b2796c944db8dacaa96082520ea",22851902,1,3,0,930,285,288,3
"208c9b2796c944db8dacaa96082520ea","208c9b2796c944db8dacaa96082520ea",22851902,1,0,1,931,288,288,0
"208c9b2796c944db8dacaa96082520ea","4a29443515bb404cb8924e1c60a63b73",22851902,1,-3,0,932,288,285,-3
"4a29443515bb404cb8924e1c60a63b73","7669a956527947d0add87455277e80b4",22851902,1,7,0,933,285,291,6
"7669a956527947d0add87455277e80b4","7669a956527947d0add87455277e80b4",22851902,1,0,1,934,291,291,0
"7669a956527947d0add87455277e80b4","869e967078f04da18dd0b0b9389a7424",22851902,1,3,0,935,291,293,2
"869e967078f04da18dd0b0b9389a7424","6a9a3b5bde4a48daa896fe8c06eca56f",22851902,1,-5,0,936,293,289,-4
"6a9a3b5bde4a48daa896fe8c06eca56f","869e967078f04da18dd0b0b9389a7424",22851902,1,5,0,937,289,293,4
"869e967078f04da18dd0b0b9389a7424","51ab6291537748fab90d519aa09889d6",22851902,1,2,0,938,293,295,2
"51ab6291537748fab90d519aa09889d6","51ab6291537748fab90d519aa09889d6",22851902,5,0,1,939,295,295,0
"51ab6291537748fab90d519aa09889d6","34a6e49023fc4465bd5ca604330bbd1c",22851902,1,-3,0,944,295,292,-3
"34a6e49023fc4465bd5ca604330bbd1c","21592f2a9e9c4b2f8c66ec5dbcbf6a2b",22851902,1,5,0,945,292,296,4
"21592f2a9e9c4b2f8c66ec5dbcbf6a2b","ba0e59461bfb4a44b7b1c28a01f8d3b3",22851902,1,4,0,946,296,299,3
"ba0e59461bfb4a44b7b1c28a01f8d3b3","ba0e59461bfb4a44b7b1c28a01f8d3b3",22851902,1,0,1,947,299,299,0
"ba0e59461bfb4a44b7b1c28a01f8d3b3","0e0b36e731a645e7b1b8a88f5031ca38",22851902,1,2,0,948,299,301,2
"0e0b36e731a645e7b1b8a88f5031ca38","0e0b36e731a645e7b1b8a88f5031ca38",22851902,9,0,1,949,301,301,0
"0e0b36e731a645e7b1b8a88f5031ca38","a66a144637284c21afc6de17fea4bfb8",22851902,1,1,0,958,301,302,1
"a66a144637284c21afc6de17fea4bfb8","a66a144637284c21afc6de17fea4bfb8",22851902,2,0,1,959,302,302,0
"a66a144637284c21afc6de17fea4bfb8","7646a919d7e64fa990bca9b024ff089d",22851902,1,-4,0,961,302,298,-4
"7646a919d7e64fa990bca9b024ff089d","e390b575229748ea8aac9364efe2bf00",22851902,1,7,0,962,298,304,6
"e390b575229748ea8aac9364efe2bf00","e390b575229748ea8aac9364efe2bf00",22851902,1,0,1,963,304,304,0
"e390b575229748ea8aac9364efe2bf00","4a29443515bb404cb8924e1c60a63b73",22851902,1,-24,0,964,304,285,-19
"4a29443515bb404cb8924e1c60a63b73","3434c10e561d488a914e0f7d71907abd",22851902,1,27,0,965,285,305,20
"3434c10e561d488a914e0f7d71907abd","53e7e900392747ccad52e711ab0f80d8",22851902,1,2,0,966,305,307,2
"53e7e900392747ccad52e711ab0f80d8","53e7e900392747ccad52e711ab0f80d8",22851902,1,0,1,967,307,307,0
"53e7e900392747ccad52e711ab0f80d8","3434c10e561d488a914e0f7d71907abd",22851902,1,-2,0,968,307,305,-2
"3434c10e561d488a914e0f7d71907abd","130acc2aeb0448fdbb2de63bc5cebe5b",22851902,1,5,0,969,305,309,4
"130acc2aeb0448fdbb2de63bc5cebe5b","130acc2aeb0448fdbb2de63bc5cebe5b",22851902,1,0,1,970,309,309,0
"130acc2aeb0448fdbb2de63bc5cebe5b","9c062b3251034ebe90f5054e2a3b5120",22851902,1,2,0,971,309,311,2
"9c062b3251034ebe90f5054e2a3b5120","9c062b3251034ebe90f5054e2a3b5120",22851902,2,0,1,972,311,311,0
"9c062b3251034ebe90f5054e2a3b5120","ea859f8207e44537889daeaba13ac2e8",22851902,1,1,0,974,311,312,1
"ea859f8207e44537889daeaba13ac2e8","ea859f8207e44537889daeaba13ac2e8",22851902,1,0,1,975,312,312,0
"ea859f8207e44537889daeaba13ac2e8","56d94971a7a94257aa330183a8ebd0ea",22851902,1,1,0,976,312,313,1
"56d94971a7a94257aa330183a8ebd0ea","56d94971a7a94257aa330183a8ebd0ea",22851902,1,0,1,977,313,313,0
"56d94971a7a94257aa330183a8ebd0ea","141c0df6cd1946539aadd1c9b7068cd4",22851902,1,-5,0,978,313,308,-5
"141c0df6cd1946539aadd1c9b7068cd4","13255e63e0aa4abf85e5211bf613d43e",22851902,1,10,0,979,308,317,9
"13255e63e0aa4abf85e5211bf613d43e","13255e63e0aa4abf85e5211bf613d43e",22851902,1,0,1,980,317,317,0
"13255e63e0aa4abf85e5211bf613d43e","86c27d40179e419c8e9d150fb6afa5d0",22851902,1,3,0,981,317,319,2
"86c27d40179e419c8e9d150fb6afa5d0","0c787d16c9504873b1a4d903cec09948",22851902,1,-6,0,982,319,314,-5
"0c787d16c9504873b1a4d903cec09948","47edbb64109243e6b0f8f64cdef90c6c",22851902,1,14,0,983,314,326,12
"47edbb64109243e6b0f8f64cdef90c6c","8d7e0b55cf9849cda222a0f2440cec55",22851902,1,-9,0,984,326,318,-8
"8d7e0b55cf9849cda222a0f2440cec55","24f1363179ad4aaa965484a78471912b",22851902,1,6,0,985,318,323,5
"24f1363179ad4aaa965484a78471912b","3628bdce1dd2429ba924d2d4d09448d2",22851902,1,-1,0,986,323,322,-1
"3628bdce1dd2429ba924d2d4d09448d2","56b3fd1a212a4764be39d979fde3326e",22851902,1,7,0,987,322,328,6
"56b3fd1a212a4764be39d979fde3326e","56b3fd1a212a4764be39d979fde3326e",22851902,1,0,1,988,328,328,0
"56b3fd1a212a4764be39d979fde3326e","3434c10e561d488a914e0f7d71907abd",22851902,1,-28,0,989,328,305,-23
"3434c10e561d488a914e0f7d71907abd","0c4079457ede49e3aeb5e86ed84bdf35",22851902,1,31,0,990,305,329,24
"0c4079457ede49e3aeb5e86ed84bdf35","38aea304b4fa46e1b29bb72f5cea4c93",22851902,1,2,0,991,329,331,2
"38aea304b4fa46e1b29bb72f5cea4c93","38aea304b4fa46e1b29bb72f5cea4c93",22851902,1,0,1,992,331,331,0
"38aea304b4fa46e1b29bb72f5cea4c93","e36d261332f14e79bb4b467aceaeb9b5",22851902,1,2,0,993,331,333,2
"e36d261332f14e79bb4b467aceaeb9b5","e36d261332f14e79bb4b467aceaeb9b5",22851902,1,0,1,994,333,333,0
"e36d261332f14e79bb4b467aceaeb9b5","c7e89b9d04744d2eab742fc24e3ef1ae",22851902,1,1,0,995,333,334,1
"c7e89b9d04744d2eab742fc24e3ef1ae","c7e89b9d04744d2eab742fc24e3ef1ae",22851902,2,0,1,996,334,334,0
"c7e89b9d04744d2eab742fc24e3ef1ae","fe49f8054b374a0ea4bb266ed135ff62",22851902,1,1,0,998,334,335,1
"fe49f8054b374a0ea4bb266ed135ff62","fe49f8054b374a0ea4bb266ed135ff62",22851902,5,0,1,1000,335,335,0
"fe49f8054b374a0ea4bb266ed135ff62","d0a8f74af98642fe8360d22c42e45117",22851902,1,1,0,1004,335,336,1
"d0a8f74af98642fe8360d22c42e45117","d0a8f74af98642fe8360d22c42e45117",22851902,2,0,1,1005,336,336,0
"d0a8f74af98642fe8360d22c42e45117","0c4079457ede49e3aeb5e86ed84bdf35",22851902,1,-7,0,1007,336,329,-7
"0c4079457ede49e3aeb5e86ed84bdf35","a7c6339ca1da4368a18d471f0519f877",22851902,1,11,0,1008,329,339,10
"a7c6339ca1da4368a18d471f0519f877","a7c6339ca1da4368a18d471f0519f877",22851902,1,0,1,1009,339,339,0
"a7c6339ca1da4368a18d471f0519f877","b8b9418ab322418d9db9b40d96af873a",22851902,1,-2,0,1010,339,337,-2
"b8b9418ab322418d9db9b40d96af873a","bbc5139ca9024389a94db3a6f47dcff6",22851902,1,5,0,1011,337,341,4
"bbc5139ca9024389a94db3a6f47dcff6","bbc5139ca9024389a94db3a6f47dcff6",22851902,1,0,1,1012,341,341,0
"bbc5139ca9024389a94db3a6f47dcff6","4ee6ca9019ab4a1ab323f98094a9bd77",22851902,1,2,0,1013,341,343,2
"4ee6ca9019ab4a1ab323f98094a9bd77","4ee6ca9019ab4a1ab323f98094a9bd77",22851902,2,0,1,1014,343,343,0
"4ee6ca9019ab4a1ab323f98094a9bd77","b37947176785476f8b29d49a851366dc",22851902,1,1,0,1016,343,344,1
"b37947176785476f8b29d49a851366dc","b37947176785476f8b29d49a851366dc",22851902,2,0,1,1017,344,344,0
"b37947176785476f8b29d49a851366dc","fcea5b10d5a14a3b9324ffece8f6e1e5",22851902,1,1,0,1019,344,345,1
"fcea5b10d5a14a3b9324ffece8f6e1e5","fcea5b10d5a14a3b9324ffece8f6e1e5",22851902,2,0,1,1020,345,345,0
"fcea5b10d5a14a3b9324ffece8f6e1e5","c2490bc612d146edbe786556fab3651b",22851902,1,-5,0,1022,345,340,-5
"c2490bc612d146edbe786556fab3651b","6ac8bb048b854999a47edb35fe627f11",22851902,1,8,0,1023,340,347,7
"6ac8bb048b854999a47edb35fe627f11","6ac8bb048b854999a47edb35fe627f11",22851902,3,0,1,1024,347,347,0
"6ac8bb048b854999a47edb35fe627f11","0c4079457ede49e3aeb5e86ed84bdf35",22851902,1,-21,0,1027,347,329,-18
"0c4079457ede49e3aeb5e86ed84bdf35","30ead9794d4847abaf222ca966cc8630",22851902,1,24,0,1028,329,348,19
"30ead9794d4847abaf222ca966cc8630","09b9678ddc3d452ea4a3d46e15826065",22851902,1,5,0,1029,348,353,5
"09b9678ddc3d452ea4a3d46e15826065","897b7f51242c44aab2205c72fdcbf4cd",22851902,1,-1,0,1030,353,352,-1
"897b7f51242c44aab2205c72fdcbf4cd","c20993c944444fe085345591a8bd837e",22851902,1,-1,0,1031,352,351,-1
"c20993c944444fe085345591a8bd837e","eff0de7f2dbb42dfa1a2e686efab5b6d",22851902,1,3,0,1032,351,354,3
"eff0de7f2dbb42dfa1a2e686efab5b6d","44421dd1e13a47a388c4a19834b744c7",22851902,1,6,0,1033,354,359,5
"44421dd1e13a47a388c4a19834b744c7","44421dd1e13a47a388c4a19834b744c7",22851902,2,0,1,1034,359,359,0
"44421dd1e13a47a388c4a19834b744c7","cb5fc7ef85d547c4be1a7439d0bf6052",22851902,1,1,0,1036,359,360,1
"cb5fc7ef85d547c4be1a7439d0bf6052","cb5fc7ef85d547c4be1a7439d0bf6052",22851902,5,0,1,1037,360,360,0
"cb5fc7ef85d547c4be1a7439d0bf6052","0a8f150a4cf747acbde62f4721823da3",22851902,1,1,0,1042,360,361,1
"0a8f150a4cf747acbde62f4721823da3","0a8f150a4cf747acbde62f4721823da3",22851902,5,0,1,1043,361,361,0
"0a8f150a4cf747acbde62f4721823da3","ab8fdad974ae471f9f24c3f9dd04462e",22851902,1,1,0,1048,361,362,1
"ab8fdad974ae471f9f24c3f9dd04462e","ab8fdad974ae471f9f24c3f9dd04462e",22851902,5,0,1,1049,362,362,0
"ab8fdad974ae471f9f24c3f9dd04462e","1ba8fef685d74a8194b9db252eb704fb",22851902,1,-7,0,1054,362,355,-7
"1ba8fef685d74a8194b9db252eb704fb","52580888dadb4fe3baa795683ea227bd",22851902,1,10,0,1055,355,364,9
"52580888dadb4fe3baa795683ea227bd","52580888dadb4fe3baa795683ea227bd",22851902,3,0,1,1056,364,364,0
"52580888dadb4fe3baa795683ea227bd","f00179e251a045b39c3f7a54f9aa4acc",22851902,1,-1,0,1059,364,363,-1
"f00179e251a045b39c3f7a54f9aa4acc","492a3bc6a1254f23a7998587961b22a4",22851902,1,4,0,1060,363,366,3
"492a3bc6a1254f23a7998587961b22a4","492a3bc6a1254f23a7998587961b22a4",22851902,1,0,1,1061,366,366,0
"492a3bc6a1254f23a7998587961b22a4","072a190fd302456290895f9f04d6940a",22851902,2,-1,0,1062,366,365,-1
"072a190fd302456290895f9f04d6940a","cfa457d1743848e4bb5e4beced6448ed",22851902,1,5,0,1063,365,369,4
"cfa457d1743848e4bb5e4beced6448ed","cfa457d1743848e4bb5e4beced6448ed",22851902,1,0,1,1064,369,369,0
"cfa457d1743848e4bb5e4beced6448ed","30ead9794d4847abaf222ca966cc8630",22851902,1,-25,0,1065,369,348,-21
"30ead9794d4847abaf222ca966cc8630","b71bac264efb4abd97015447bd490db6",22851902,1,28,0,1066,348,370,22
"b71bac264efb4abd97015447bd490db6","b71bac264efb4abd97015447bd490db6",22851902,1,0,1,1067,370,370,0
"b71bac264efb4abd97015447bd490db6","8d448d625b024c82a5eb240bbd7431d6",22851902,2,5,0,1068,370,374,4
"8d448d625b024c82a5eb240bbd7431d6","8d448d625b024c82a5eb240bbd7431d6",22851902,14,0,1,1069,374,374,0
"8d448d625b024c82a5eb240bbd7431d6","9428d8bd9c5a47b2a235b254e5e27ded",22851902,1,123,0,1076,374,452,78
"9428d8bd9c5a47b2a235b254e5e27ded","b2f0d654738f48158edff28e8d3a546e",22851902,3,-4,0,1077,452,449,-3
"b2f0d654738f48158edff28e8d3a546e","f60ee41ec635499abd48168342d32c2f",22851902,4,5,0,1078,449,453,4
"f60ee41ec635499abd48168342d32c2f","f60ee41ec635499abd48168342d32c2f",22851902,26,0,1,1079,453,453,0
"f60ee41ec635499abd48168342d32c2f","9428d8bd9c5a47b2a235b254e5e27ded",22851902,1,-1,0,1086,453,452,-1
"9428d8bd9c5a47b2a235b254e5e27ded","66baf19b6b904b70922329068c63746d",22851902,1,-116,0,1087,452,376,-76
"66baf19b6b904b70922329068c63746d","a875096404ef4a9984b62d74cda916f9",22851902,1,-226,0,1088,376,209,-167
"a875096404ef4a9984b62d74cda916f9","d7f13c8d63ec4e2aa673fbb9cf9c6933",22851902,1,-4,0,1089,209,206,-3
"d7f13c8d63ec4e2aa673fbb9cf9c6933","09400e101c5d4b439cf9a26b03aae558",22851902,2,5,0,1090,206,210,4
"09400e101c5d4b439cf9a26b03aae558","a88efa7e50ce47159810ab553afa6d3a",22851902,2,2,0,1091,210,212,2
"a88efa7e50ce47159810ab553afa6d3a","a88efa7e50ce47159810ab553afa6d3a",22851902,4,0,1,1092,212,212,0
"a88efa7e50ce47159810ab553afa6d3a","be502a7a43c44bf7b682698de79d9369",22851902,1,3,0,1094,212,214,2
"be502a7a43c44bf7b682698de79d9369","a875096404ef4a9984b62d74cda916f9",22851902,1,-6,0,1095,214,209,-5
"a875096404ef4a9984b62d74cda916f9","f7fb1952f56b4189b86a9f8b7862d2b8",22851902,2,7,0,1096,209,215,6
"f7fb1952f56b4189b86a9f8b7862d2b8","0c7262dff33c4087bc660ccf40f92f9c",22851902,1,-60,0,1097,215,169,-46
"0c7262dff33c4087bc660ccf40f92f9c","3628bdce1dd2429ba924d2d4d09448d2",22851902,1,205,0,1098,169,322,153
"3628bdce1dd2429ba924d2d4d09448d2","3434c10e561d488a914e0f7d71907abd",22851902,1,-21,0,1099,322,305,-17
"3434c10e561d488a914e0f7d71907abd","24f1363179ad4aaa965484a78471912b",22851902,1,22,0,1100,305,323,18
"24f1363179ad4aaa965484a78471912b","47edbb64109243e6b0f8f64cdef90c6c",22851902,1,3,0,1101,323,326,3
"47edbb64109243e6b0f8f64cdef90c6c","66baf19b6b904b70922329068c63746d",22851902,1,70,0,1102,326,376,50
"66baf19b6b904b70922329068c63746d","66baf19b6b904b70922329068c63746d",22851902,1,0,1,1103,376,376,0
"66baf19b6b904b70922329068c63746d","7f544639412e40a9ba27f43b415362ab",22851902,1,2,0,1104,376,378,2
"7f544639412e40a9ba27f43b415362ab","7f544639412e40a9ba27f43b415362ab",22851902,1,0,1,1105,378,378,0
"7f544639412e40a9ba27f43b415362ab","d5ae8642e15b46b8bd298b02274d4e9c",22851902,1,2,0,1106,378,380,2
"d5ae8642e15b46b8bd298b02274d4e9c","d5ae8642e15b46b8bd298b02274d4e9c",22851902,1,0,1,1107,380,380,0
"d5ae8642e15b46b8bd298b02274d4e9c","a0d10309a2dd456289147f84be9d37f9",22851902,1,1,0,1108,380,381,1
"a0d10309a2dd456289147f84be9d37f9","a0d10309a2dd456289147f84be9d37f9",22851902,2,0,1,1109,381,381,0
"a0d10309a2dd456289147f84be9d37f9","0fcbc3ca07b144138b8d85da581f09a8",22851902,1,1,0,1111,381,382,1
"0fcbc3ca07b144138b8d85da581f09a8","0fcbc3ca07b144138b8d85da581f09a8",22851902,8,0,1,1112,382,382,0
"0fcbc3ca07b144138b8d85da581f09a8","66baf19b6b904b70922329068c63746d",22851902,1,-6,0,1120,382,376,-6
"66baf19b6b904b70922329068c63746d","c2fca3669923477ab966ded303dea31c",22851902,1,8,0,1121,376,383,7
"c2fca3669923477ab966ded303dea31c","4890121ce5d74576b4632b77cfc23398",22851902,1,6,0,1122,383,388,5
"4890121ce5d74576b4632b77cfc23398","4890121ce5d74576b4632b77cfc23398",22851902,1,0,1,1123,388,388,0
"4890121ce5d74576b4632b77cfc23398","18d3b836dd804224883cc9180b60a8e1",22851902,1,-1,0,1124,388,387,-1
"18d3b836dd804224883cc9180b60a8e1","96bb2b3e85a34d8b9544514e89f6fe97",22851902,1,4,0,1125,387,390,3
"96bb2b3e85a34d8b9544514e89f6fe97","96bb2b3e85a34d8b9544514e89f6fe97",22851902,1,0,1,1126,390,390,0
"96bb2b3e85a34d8b9544514e89f6fe97","ac4e9b54acfe4670b4634859c7263cb5",22851902,2,2,0,1127,390,392,2
"ac4e9b54acfe4670b4634859c7263cb5","ac4e9b54acfe4670b4634859c7263cb5",22851902,2,0,1,1128,392,392,0
"ac4e9b54acfe4670b4634859c7263cb5","17f95d18bab743888e1736033dc3384d",22851902,1,-3,0,1130,392,389,-3
"17f95d18bab743888e1736033dc3384d","6f8881a745ac4c358a68b92c3b4abe81",22851902,2,6,0,1131,389,394,5
"6f8881a745ac4c358a68b92c3b4abe81","f7002c8484354eceac57bc7bd62c76c1",22851902,2,-1,0,1132,394,393,-1
"f7002c8484354eceac57bc7bd62c76c1","96bb2b3e85a34d8b9544514e89f6fe97",22851902,1,-4,0,1133,393,390,-3
"ac4e9b54acfe4670b4634859c7263cb5","6f8881a745ac4c358a68b92c3b4abe81",22851902,1,3,0,1135,392,394,2
"6f8881a745ac4c358a68b92c3b4abe81","17f95d18bab743888e1736033dc3384d",22851902,1,-6,0,1136,394,389,-5
"f7002c8484354eceac57bc7bd62c76c1","44a277ea44dc4ae689fab4b82f0b4098",22851902,1,5,0,1139,393,397,4
"44a277ea44dc4ae689fab4b82f0b4098","44a277ea44dc4ae689fab4b82f0b4098",22851902,1,0,1,1140,397,397,0
"44a277ea44dc4ae689fab4b82f0b4098","0c12af0a4e7f4002852cf84b2537c161",22851902,1,-2,0,1141,397,395,-2
"0c12af0a4e7f4002852cf84b2537c161","859e0b8d71694b12befb69ee698138f9",22851902,1,5,0,1142,395,399,4
"859e0b8d71694b12befb69ee698138f9","859e0b8d71694b12befb69ee698138f9",22851902,3,0,1,1143,399,399,0
"859e0b8d71694b12befb69ee698138f9","66baf19b6b904b70922329068c63746d",22851902,1,-29,0,1146,399,376,-23
"66baf19b6b904b70922329068c63746d","2b09a08242b54983aec7063990fb3f66",22851902,2,32,0,1147,376,400,24
"2b09a08242b54983aec7063990fb3f66","2b09a08242b54983aec7063990fb3f66",22851902,2,0,1,1148,400,400,0
"2b09a08242b54983aec7063990fb3f66","1f471b7a883a4df48211e8c6a81b59a7",22851902,1,1,0,1150,400,401,1
"1f471b7a883a4df48211e8c6a81b59a7","1f471b7a883a4df48211e8c6a81b59a7",22851902,1,0,1,1151,401,401,0
"1f471b7a883a4df48211e8c6a81b59a7","2b09a08242b54983aec7063990fb3f66",22851902,1,-1,0,1152,401,400,-1
"2b09a08242b54983aec7063990fb3f66","1157bd665ec4472fb58b751dc5099355",22851902,1,4,0,1153,400,403,3
"1157bd665ec4472fb58b751dc5099355","2b09a08242b54983aec7063990fb3f66",22851902,2,-4,0,1154,403,400,-3
"2b09a08242b54983aec7063990fb3f66","66baf19b6b904b70922329068c63746d",22851902,1,-32,0,1155,400,376,-24
"2b09a08242b54983aec7063990fb3f66","072a190fd302456290895f9f04d6940a",22851902,1,-52,0,1157,400,365,-35
"072a190fd302456290895f9f04d6940a","30ead9794d4847abaf222ca966cc8630",22851902,1,-20,0,1158,365,348,-17
"30ead9794d4847abaf222ca966cc8630","492a3bc6a1254f23a7998587961b22a4",22851902,1,21,0,1159,348,366,18
"072a190fd302456290895f9f04d6940a","4a29443515bb404cb8924e1c60a63b73",22851902,1,-102,0,1161,365,285,-80
"4a29443515bb404cb8924e1c60a63b73","b8b9418ab322418d9db9b40d96af873a",22851902,1,67,0,1162,285,337,52
"b8b9418ab322418d9db9b40d96af873a","0c4079457ede49e3aeb5e86ed84bdf35",22851902,1,-9,0,1163,337,329,-8
"0c4079457ede49e3aeb5e86ed84bdf35","1157bd665ec4472fb58b751dc5099355",22851902,1,100,0,1164,329,403,74
"2b09a08242b54983aec7063990fb3f66","9de0d567bfa84fe5b77cb76f4a76a5d1",22851902,1,5,0,1166,400,404,4
"9de0d567bfa84fe5b77cb76f4a76a5d1","9de0d567bfa84fe5b77cb76f4a76a5d1",22851902,1,0,1,1167,404,404,0
"9de0d567bfa84fe5b77cb76f4a76a5d1","1157bd665ec4472fb58b751dc5099355",22851902,1,-1,0,1168,404,403,-1
"1157bd665ec4472fb58b751dc5099355","3c8a22d2f9c146ea956609e3ed4f2559",22851902,1,3,0,1169,403,405,2
"3c8a22d2f9c146ea956609e3ed4f2559","58fc9094275e4c49be3f4ba6d4acc0a4",22851902,1,2,0,1170,405,406,1
"58fc9094275e4c49be3f4ba6d4acc0a4","58fc9094275e4c49be3f4ba6d4acc0a4",22851902,4,0,1,1171,406,406,0
"58fc9094275e4c49be3f4ba6d4acc0a4","c1c1be90b2b14c1ab4a5e1ee3c241902",22851902,1,1,0,1173,406,407,1
"c1c1be90b2b14c1ab4a5e1ee3c241902","c1c1be90b2b14c1ab4a5e1ee3c241902",22851902,5,0,1,1174,407,407,0
"c1c1be90b2b14c1ab4a5e1ee3c241902","58fc9094275e4c49be3f4ba6d4acc0a4",22851902,1,-1,0,1179,407,406,-1
"58fc9094275e4c49be3f4ba6d4acc0a4","02b3a1bead9244c1ba2f857c7da8f82a",22851902,1,3,0,1182,406,408,2
"02b3a1bead9244c1ba2f857c7da8f82a","02b3a1bead9244c1ba2f857c7da8f82a",22851902,1,0,1,1183,408,408,0
"02b3a1bead9244c1ba2f857c7da8f82a","6206fc6479014bb193084c32409dc1b9",22851902,1,1,0,1184,408,409,1
"6206fc6479014bb193084c32409dc1b9","6206fc6479014bb193084c32409dc1b9",22851902,4,0,1,1185,409,409,0
"6206fc6479014bb193084c32409dc1b9","02b3a1bead9244c1ba2f857c7da8f82a",22851902,1,-1,0,1189,409,408,-1
"02b3a1bead9244c1ba2f857c7da8f82a","6a5f020451db426dacba9e2ea3fcc62a",22851902,1,3,0,1190,408,410,2
"6a5f020451db426dacba9e2ea3fcc62a","6a5f020451db426dacba9e2ea3fcc62a",22851902,5,0,1,1191,410,410,0
"6a5f020451db426dacba9e2ea3fcc62a","33a9d248b2e44588a5b07fc1342b9bc2",22851902,3,2,0,1192,410,411,1
"33a9d248b2e44588a5b07fc1342b9bc2","6a5f020451db426dacba9e2ea3fcc62a",22851902,1,-2,0,1193,411,410,-1
"33a9d248b2e44588a5b07fc1342b9bc2","33a9d248b2e44588a5b07fc1342b9bc2",22851902,3,0,1,1195,411,411,0
"33a9d248b2e44588a5b07fc1342b9bc2","2b09a08242b54983aec7063990fb3f66",22851902,1,-17,0,1198,411,400,-11
"2b09a08242b54983aec7063990fb3f66","6a5f020451db426dacba9e2ea3fcc62a",22851902,1,15,0,1199,400,410,10
"33a9d248b2e44588a5b07fc1342b9bc2","c6f26bd420634f1cb7989e76fe6b16c0",22851902,1,1,0,1205,411,412,1
"c6f26bd420634f1cb7989e76fe6b16c0","c6f26bd420634f1cb7989e76fe6b16c0",22851902,5,0,1,1206,412,412,0
"c6f26bd420634f1cb7989e76fe6b16c0","2a65ee6e2ac64f6a8a55fbe5373ec763",22851902,1,1,0,1211,412,413,1
"2a65ee6e2ac64f6a8a55fbe5373ec763","2a65ee6e2ac64f6a8a55fbe5373ec763",22851902,2,0,1,1212,413,413,0
"2a65ee6e2ac64f6a8a55fbe5373ec763","33a9d248b2e44588a5b07fc1342b9bc2",22851902,1,-2,0,1214,413,411,-2
"33a9d248b2e44588a5b07fc1342b9bc2","1fd0f6dadbc14ebc965faf6122190b96",22851902,1,5,0,1215,411,415,4
"1fd0f6dadbc14ebc965faf6122190b96","1fd0f6dadbc14ebc965faf6122190b96",22851902,1,0,1,1216,415,415,0
"1fd0f6dadbc14ebc965faf6122190b96","687055dad9fc40c3982478fe33ec01bf",22851902,1,-1,0,1217,415,414,-1
"687055dad9fc40c3982478fe33ec01bf","2add1669f08d4101913db15f8c23b3b7",22851902,1,3,0,1218,414,416,2
"2add1669f08d4101913db15f8c23b3b7","2add1669f08d4101913db15f8c23b3b7",22851902,1,0,1,1219,416,416,0
"2add1669f08d4101913db15f8c23b3b7","2b09a08242b54983aec7063990fb3f66",22851902,1,-24,0,1220,416,400,-16
"2b09a08242b54983aec7063990fb3f66","a2b4bd40cee2481ebd3fc179d6a5cd62",22851902,1,27,0,1221,400,417,17
"a2b4bd40cee2481ebd3fc179d6a5cd62","9428d8bd9c5a47b2a235b254e5e27ded",22851902,1,57,0,1222,417,452,35
"f60ee41ec635499abd48168342d32c2f","b2f0d654738f48158edff28e8d3a546e",22851902,3,-5,0,1232,453,449,-4
"b2f0d654738f48158edff28e8d3a546e","f67fbf45a5f146ed866965bc57c7c001",22851902,2,8,0,1233,449,454,5
"f67fbf45a5f146ed866965bc57c7c001","a2b4bd40cee2481ebd3fc179d6a5cd62",22851902,1,-61,0,1234,454,417,-37
"a2b4bd40cee2481ebd3fc179d6a5cd62","a2b4bd40cee2481ebd3fc179d6a5cd62",22851902,2,0,1,1235,417,417,0
"a2b4bd40cee2481ebd3fc179d6a5cd62","e34e59dce2204f228f3a84b6725df60f",22851902,1,2,0,1237,417,419,2
"e34e59dce2204f228f3a84b6725df60f","e34e59dce2204f228f3a84b6725df60f",22851902,1,0,1,1238,419,419,0
"e34e59dce2204f228f3a84b6725df60f","bec48fc2e1294c7eb3d0aca780d731b8",22851902,1,2,0,1239,419,420,1
"bec48fc2e1294c7eb3d0aca780d731b8","a2b4bd40cee2481ebd3fc179d6a5cd62",22851902,1,-4,0,1240,420,417,-3
"a2b4bd40cee2481ebd3fc179d6a5cd62","bec48fc2e1294c7eb3d0aca780d731b8",22851902,1,4,0,1241,417,420,3
"bec48fc2e1294c7eb3d0aca780d731b8","bec48fc2e1294c7eb3d0aca780d731b8",22851902,4,0,1,1242,420,420,0
"bec48fc2e1294c7eb3d0aca780d731b8","dbde19fcce2a4c1abdc7f685c293a23f",22851902,1,3,0,1246,420,422,2
"dbde19fcce2a4c1abdc7f685c293a23f","a24600b0e49245f6bdba8c893cfeddb0",22851902,2,4,0,1247,422,425,3
"a24600b0e49245f6bdba8c893cfeddb0","a24600b0e49245f6bdba8c893cfeddb0",22851902,4,0,1,1248,425,425,0
"a24600b0e49245f6bdba8c893cfeddb0","dbde19fcce2a4c1abdc7f685c293a23f",22851902,1,-4,0,1251,425,422,-3
"a24600b0e49245f6bdba8c893cfeddb0","a2b4bd40cee2481ebd3fc179d6a5cd62",22851902,1,-11,0,1254,425,417,-8
"a2b4bd40cee2481ebd3fc179d6a5cd62","24cf8786024543f19b89bc20034e60d7",22851902,1,18,0,1255,417,428,11
"24cf8786024543f19b89bc20034e60d7","f2a73be2f46840b182d7bd095378004e",22851902,1,1,0,1256,428,429,1
"f2a73be2f46840b182d7bd095378004e","f2a73be2f46840b182d7bd095378004e",22851902,1,0,1,1257,429,429,0
"f2a73be2f46840b182d7bd095378004e","604551fd4266430cb860fef58fa7dd61",22851902,1,1,0,1258,429,430,1
"604551fd4266430cb860fef58fa7dd61","604551fd4266430cb860fef58fa7dd61",22851902,4,0,1,1259,430,430,0
"604551fd4266430cb860fef58fa7dd61","dce46f8904594a62a6377a3587aaa663",22851902,1,2,0,1263,430,431,1
"dce46f8904594a62a6377a3587aaa663","24cf8786024543f19b89bc20034e60d7",22851902,2,-4,0,1264,431,428,-3
"24cf8786024543f19b89bc20034e60d7","dce46f8904594a62a6377a3587aaa663",22851902,1,4,0,1265,428,431,3
"dce46f8904594a62a6377a3587aaa663","dce46f8904594a62a6377a3587aaa663",22851902,1,0,1,1266,431,431,0
"dce46f8904594a62a6377a3587aaa663","9b9d0a249052413c869753b99682b0ac",22851902,1,1,0,1267,431,432,1
"9b9d0a249052413c869753b99682b0ac","9b9d0a249052413c869753b99682b0ac",22851902,1,0,1,1268,432,432,0
"9b9d0a249052413c869753b99682b0ac","061c175cc90f45fbad883025394e78dd",22851902,1,1,0,1269,432,433,1
"061c175cc90f45fbad883025394e78dd","061c175cc90f45fbad883025394e78dd",22851902,4,0,1,1270,433,433,0
"061c175cc90f45fbad883025394e78dd","dce46f8904594a62a6377a3587aaa663",22851902,1,-2,0,1274,433,431,-2
"24cf8786024543f19b89bc20034e60d7","66ada10dde9f43018588f1ced9d477fc",22851902,1,8,0,1276,428,434,6
"66ada10dde9f43018588f1ced9d477fc","74a7f8712e5449c2bc0b43c6f90dafed",22851902,1,1,0,1277,434,435,1
"74a7f8712e5449c2bc0b43c6f90dafed","74a7f8712e5449c2bc0b43c6f90dafed",22851902,1,0,1,1278,435,435,0
"74a7f8712e5449c2bc0b43c6f90dafed","66ada10dde9f43018588f1ced9d477fc",22851902,1,-1,0,1279,435,434,-1
"66ada10dde9f43018588f1ced9d477fc","bf12c96466d840a69bed7020b3f18bb8",22851902,1,3,0,1280,434,436,2
"bf12c96466d840a69bed7020b3f18bb8","bf12c96466d840a69bed7020b3f18bb8",22851902,1,0,1,1281,436,436,0
"bf12c96466d840a69bed7020b3f18bb8","070600601c4c439288445d2f0724807d",22851902,1,3,0,1282,436,437,1
"070600601c4c439288445d2f0724807d","24cf8786024543f19b89bc20034e60d7",22851902,1,-14,0,1283,437,428,-9
"24cf8786024543f19b89bc20034e60d7","1823b6de7d334a7aaabc4570719af4d9",22851902,1,16,0,1284,428,439,11
"1823b6de7d334a7aaabc4570719af4d9","1b4550d0dab04078b3bf08a655345bdc",22851902,1,-101,0,1285,439,373,-66
"1b4550d0dab04078b3bf08a655345bdc","b71bac264efb4abd97015447bd490db6",22851902,1,-4,0,1286,373,370,-3
"8d448d625b024c82a5eb240bbd7431d6","070600601c4c439288445d2f0724807d",22851902,1,98,0,1295,374,437,63
"070600601c4c439288445d2f0724807d","070600601c4c439288445d2f0724807d",22851902,1,0,1,1296,437,437,0
"070600601c4c439288445d2f0724807d","1823b6de7d334a7aaabc4570719af4d9",22851902,1,2,0,1297,437,439,2
"1823b6de7d334a7aaabc4570719af4d9","1823b6de7d334a7aaabc4570719af4d9",22851902,10,0,1,1298,439,439,0
"1823b6de7d334a7aaabc4570719af4d9","070600601c4c439288445d2f0724807d",22851902,1,-2,0,1308,439,437,-2
"070600601c4c439288445d2f0724807d","0380cd76a7d44bc3a4da1f15e4d68f89",22851902,1,4,0,1309,437,440,3
"0380cd76a7d44bc3a4da1f15e4d68f89","0380cd76a7d44bc3a4da1f15e4d68f89",22851902,7,0,1,1310,440,440,0
"0380cd76a7d44bc3a4da1f15e4d68f89","23b7673c8b5443108c2ef09382834a86",22851902,2,2,0,1317,440,441,1
"23b7673c8b5443108c2ef09382834a86","0380cd76a7d44bc3a4da1f15e4d68f89",22851902,1,-2,0,1318,441,440,-1
"23b7673c8b5443108c2ef09382834a86","901e92500aea43c79f19f1b279050668",22851902,2,2,0,1320,441,442,1
"901e92500aea43c79f19f1b279050668","23b7673c8b5443108c2ef09382834a86",22851902,1,-2,0,1321,442,441,-1
"901e92500aea43c79f19f1b279050668","001339db8ced4cf78829ebe8b145449d",22851902,1,1,0,1323,442,443,1
"001339db8ced4cf78829ebe8b145449d","001339db8ced4cf78829ebe8b145449d",22851902,5,0,1,1324,443,443,0
"001339db8ced4cf78829ebe8b145449d","452745e0366e42ae81561bfddebcc6c3",22851902,1,1,0,1329,443,444,1
"452745e0366e42ae81561bfddebcc6c3","452745e0366e42ae81561bfddebcc6c3",22851902,2,0,1,1330,444,444,0
"452745e0366e42ae81561bfddebcc6c3","4660ff2089114e8db82ceb26a4f329e3",22851902,1,2,0,1332,444,445,1
"4660ff2089114e8db82ceb26a4f329e3","901e92500aea43c79f19f1b279050668",22851902,1,-4,0,1333,445,442,-3
"901e92500aea43c79f19f1b279050668","4660ff2089114e8db82ceb26a4f329e3",22851902,1,4,0,1334,442,445,3
"4660ff2089114e8db82ceb26a4f329e3","4660ff2089114e8db82ceb26a4f329e3",22851902,6,0,1,1335,445,445,0
"4660ff2089114e8db82ceb26a4f329e3","8a7f26e690f34dda97be16904518ca99",22851902,1,4,0,1341,445,447,2
"8a7f26e690f34dda97be16904518ca99","8a7f26e690f34dda97be16904518ca99",22851902,1,0,1,1342,447,447,0
"8a7f26e690f34dda97be16904518ca99","b2f0d654738f48158edff28e8d3a546e",22851902,1,5,0,1343,447,449,2
"b2f0d654738f48158edff28e8d3a546e","070600601c4c439288445d2f0724807d",22851902,1,-21,0,1344,449,437,-12
"070600601c4c439288445d2f0724807d","f60ee41ec635499abd48168342d32c2f",22851902,1,26,0,1345,437,453,16
"f67fbf45a5f146ed866965bc57c7c001","f67fbf45a5f146ed866965bc57c7c001",22851902,2,0,1,1355,454,454,0
"f67fbf45a5f146ed866965bc57c7c001","d937afe49bd24a07a550dda1c1155122",22851902,1,1,0,1357,454,455,1
"d937afe49bd24a07a550dda1c1155122","d937afe49bd24a07a550dda1c1155122",22851902,1,0,1,1358,455,455,0
"d937afe49bd24a07a550dda1c1155122","3628b3f7823443d0912a339096b69943",22851902,1,1,0,1359,455,456,1
"3628b3f7823443d0912a339096b69943","3628b3f7823443d0912a339096b69943",22851902,1,0,1,1360,456,456,0
"3628b3f7823443d0912a339096b69943","9e049ee647cf43ecbcb5ed792a8e7588",22851902,1,1,0,1361,456,457,1
"9e049ee647cf43ecbcb5ed792a8e7588","5256a214faaf410b93f76cea06428334",22851902,1,1,0,1362,457,458,1
"5256a214faaf410b93f76cea06428334","5256a214faaf410b93f76cea06428334",22851902,1,0,1,1363,458,458,0
"5256a214faaf410b93f76cea06428334","25c32b120fce40fa9b6c85133aeb4716",22851902,1,1,0,1364,458,459,1
"25c32b120fce40fa9b6c85133aeb4716","25c32b120fce40fa9b6c85133aeb4716",22851902,3,0,1,1365,459,459,0
"25c32b120fce40fa9b6c85133aeb4716","11bc14f2204949008b7d511b933363c1",22851902,1,1,0,1368,459,460,1
"11bc14f2204949008b7d511b933363c1","42de338840a34d15adb66e7b14fb9d2c",22851902,1,1,0,1369,460,461,1
"42de338840a34d15adb66e7b14fb9d2c","42de338840a34d15adb66e7b14fb9d2c",22851902,1,0,1,1370,461,461,0
"42de338840a34d15adb66e7b14fb9d2c","9da37c6210b1416b8079c274f70bf600",22851902,1,1,0,1371,461,462,1
"9da37c6210b1416b8079c274f70bf600","9da37c6210b1416b8079c274f70bf600",22851902,1,0,1,1372,462,462,0
"9da37c6210b1416b8079c274f70bf600","519119f1deac45ff9ab4f13529be5c6e",22851902,1,1,0,1373,462,463,1
"519119f1deac45ff9ab4f13529be5c6e","519119f1deac45ff9ab4f13529be5c6e",22851902,1,0,1,1374,463,463,0
"519119f1deac45ff9ab4f13529be5c6e","c5df9f40ec14463b9dcfdc73df3e9285",22851902,1,3,0,1375,463,464,1
"c5df9f40ec14463b9dcfdc73df3e9285","c5df9f40ec14463b9dcfdc73df3e9285",22851902,1,0,1,1376,464,464,0
"c5df9f40ec14463b9dcfdc73df3e9285","bc5524e78a8544e2ae2fdc2f3462bbec",22851902,1,-267,0,1377,464,279,-185
"bc5524e78a8544e2ae2fdc2f3462bbec","bc5524e78a8544e2ae2fdc2f3462bbec",22851902,1,0,1,1378,279,279,0
"bc5524e78a8544e2ae2fdc2f3462bbec","0d987bed3ffa4ed0b9a2e62e97b7b30f",22851902,5,-9,0,1379,279,272,-7
"0d987bed3ffa4ed0b9a2e62e97b7b30f","0d987bed3ffa4ed0b9a2e62e97b7b30f",22851902,2,0,1,1380,272,272,0
"0d987bed3ffa4ed0b9a2e62e97b7b30f","bb5a47f5ea01454a8b79455422d3b9da",22851902,5,10,0,1381,272,280,8
"bb5a47f5ea01454a8b79455422d3b9da","bb5a47f5ea01454a8b79455422d3b9da",22851902,51,0,1,1382,280,280,0
"bb5a47f5ea01454a8b79455422d3b9da","82ae07bc0c9b4570a41799290d1ef399",22851902,3,-6,0,1389,280,275,-5
"82ae07bc0c9b4570a41799290d1ef399","bb5a47f5ea01454a8b79455422d3b9da",22851902,4,6,0,1390,275,280,5
"bb5a47f5ea01454a8b79455422d3b9da","bc5524e78a8544e2ae2fdc2f3462bbec",22851902,3,-1,0,1401,280,279,-1
"bb5a47f5ea01454a8b79455422d3b9da","94cecc3f1e7d484b8e068e79241dfd73",22851902,2,3,0,1424,280,281,1
"94cecc3f1e7d484b8e068e79241dfd73","0d987bed3ffa4ed0b9a2e62e97b7b30f",22851902,2,-13,0,1425,281,272,-9
"0d987bed3ffa4ed0b9a2e62e97b7b30f","a37477c4e4c14169ad44b06b493007f6",22851902,2,15,0,1426,272,283,11
"a37477c4e4c14169ad44b06b493007f6","78adeee1fa2c4fe0bc73f7bca9fcee86",22851902,1,-167,0,1427,283,160,-123
"78adeee1fa2c4fe0bc73f7bca9fcee86","8959e6304a0348309a771e4d08d1b64a",22851902,1,4,0,1428,160,163,3
"8959e6304a0348309a771e4d08d1b64a","65202579580f4ad38d734b4ee39d22a8",22851902,1,1,0,1429,163,164,1
"65202579580f4ad38d734b4ee39d22a8","65202579580f4ad38d734b4ee39d22a8",22851902,72,0,1,1430,164,164,0
"65202579580f4ad38d734b4ee39d22a8","bc5524e78a8544e2ae2fdc2f3462bbec",22851902,1,156,0,1437,164,279,115
"a37477c4e4c14169ad44b06b493007f6","fab84b4fab5940efb4ea868ef8d09396",22851902,1,3,0,1450,283,284,1
"fab84b4fab5940efb4ea868ef8d09396","fab84b4fab5940efb4ea868ef8d09396",22851902,1,0,1,1451,284,284,0
"fab84b4fab5940efb4ea868ef8d09396","9428d8bd9c5a47b2a235b254e5e27ded",22851902,1,242,0,1452,284,452,168
"e2911e79efc2420eac45d9f671463d4b","e2911e79efc2420eac45d9f671463d4b",22851949,13,0,1,1,2,2,0
"e2911e79efc2420eac45d9f671463d4b","b613861cecf84ffcab01afb23f660475",22851949,2,-3,0,2,2,1,-1
"b613861cecf84ffcab01afb23f660475","9112f2bffece48e08c6d2287be204085",22851949,1,12,0,8,1,11,10
"9112f2bffece48e08c6d2287be204085","9112f2bffece48e08c6d2287be204085",22851949,4,0,1,10,11,11,0
"9112f2bffece48e08c6d2287be204085","0680571d4698477995e41842c36a54b2",22851949,1,-1,0,12,11,10,-1
"0680571d4698477995e41842c36a54b2","0680571d4698477995e41842c36a54b2",22851949,2,0,1,13,10,10,0
"0680571d4698477995e41842c36a54b2","66b5e16f4f75454fb5b8172079f0fa83",22851949,1,-1,0,14,10,9,-1
"66b5e16f4f75454fb5b8172079f0fa83","66b5e16f4f75454fb5b8172079f0fa83",22851949,2,0,1,15,9,9,0
"66b5e16f4f75454fb5b8172079f0fa83","e2911e79efc2420eac45d9f671463d4b",22851949,1,-7,0,16,9,2,-7
"e2911e79efc2420eac45d9f671463d4b","519d1b8c59404d67b54e96c5c8a830b2",22851949,3,1,0,18,2,3,1
"519d1b8c59404d67b54e96c5c8a830b2","519d1b8c59404d67b54e96c5c8a830b2",22851949,5,0,1,19,3,3,0
"519d1b8c59404d67b54e96c5c8a830b2","531db53f81f646edb0cdcfe0085b03b7",22851949,3,1,0,23,3,4,1
"531db53f81f646edb0cdcfe0085b03b7","519d1b8c59404d67b54e96c5c8a830b2",22851949,1,-1,0,24,4,3,-1
"531db53f81f646edb0cdcfe0085b03b7","4f5f94b2f95141e0a9d53a61da2276da",22851949,2,1,0,26,4,5,1
"4f5f94b2f95141e0a9d53a61da2276da","4f5f94b2f95141e0a9d53a61da2276da",22851949,3,0,1,27,5,5,0
"4f5f94b2f95141e0a9d53a61da2276da","531db53f81f646edb0cdcfe0085b03b7",22851949,1,-1,0,28,5,4,-1
"531db53f81f646edb0cdcfe0085b03b7","531db53f81f646edb0cdcfe0085b03b7",22851949,2,0,1,29,4,4,0
"531db53f81f646edb0cdcfe0085b03b7","6d541c89590949f99af293c4f2333f67",22851949,1,2,0,30,4,6,2
"6d541c89590949f99af293c4f2333f67","6d541c89590949f99af293c4f2333f67",22851949,3,0,1,31,6,6,0
"6d541c89590949f99af293c4f2333f67","4f5f94b2f95141e0a9d53a61da2276da",22851949,1,-1,0,32,6,5,-1
"4f5f94b2f95141e0a9d53a61da2276da","6d541c89590949f99af293c4f2333f67",22851949,2,1,0,34,5,6,1
"6d541c89590949f99af293c4f2333f67","e2911e79efc2420eac45d9f671463d4b",22851949,1,-4,0,36,6,2,-4
"519d1b8c59404d67b54e96c5c8a830b2","e2911e79efc2420eac45d9f671463d4b",22851949,1,-1,0,38,3,2,-1
"6d541c89590949f99af293c4f2333f67","dd5cf0b9fe4c4f1d8f5ff8e4c04879cb",22851949,1,1,0,59,6,7,1
"dd5cf0b9fe4c4f1d8f5ff8e4c04879cb","dd5cf0b9fe4c4f1d8f5ff8e4c04879cb",22851949,1,0,1,60,7,7,0
"dd5cf0b9fe4c4f1d8f5ff8e4c04879cb","f96261861edc426abe2248be4f0a709a",22851949,1,1,0,61,7,8,1
"f96261861edc426abe2248be4f0a709a","f96261861edc426abe2248be4f0a709a",22851949,1,0,1,62,8,8,0
"f96261861edc426abe2248be4f0a709a","66b5e16f4f75454fb5b8172079f0fa83",22851949,1,1,0,63,8,9,1
"66b5e16f4f75454fb5b8172079f0fa83","0680571d4698477995e41842c36a54b2",22851949,1,1,0,65,9,10,1
"0680571d4698477995e41842c36a54b2","9112f2bffece48e08c6d2287be204085",22851949,1,1,0,67,10,11,1
"9112f2bffece48e08c6d2287be204085","e2911e79efc2420eac45d9f671463d4b",22851949,1,-9,0,69,11,2,-9
"3f1c815879794b929260d224becaff7e","5c5ceeee4562457ba6d41515aeebfbb1",22851949,1,6,0,81,14,17,3
"5c5ceeee4562457ba6d41515aeebfbb1","81c864a886d54a6b8ff85f7d736f4f95",22851949,1,-4,0,82,17,15,-2
"81c864a886d54a6b8ff85f7d736f4f95","5c5ceeee4562457ba6d41515aeebfbb1",22851949,1,4,0,83,15,17,2
"5c5ceeee4562457ba6d41515aeebfbb1","5c5ceeee4562457ba6d41515aeebfbb1",22851949,2,0,1,84,17,17,0
"5c5ceeee4562457ba6d41515aeebfbb1","9afd71a5298d4333b6849dfce1b9422c",22851949,1,3,0,86,17,18,1
"9afd71a5298d4333b6849dfce1b9422c","56586aa865414f538729c7f7735d2bc6",22851949,1,-13,0,87,18,12,-6
"56586aa865414f538729c7f7735d2bc6","9afd71a5298d4333b6849dfce1b9422c",22851949,1,13,0,88,12,18,6
"9afd71a5298d4333b6849dfce1b9422c","b7719e26494940efa49512aedd0aac79",22851949,1,4,0,89,18,20,2
"b7719e26494940efa49512aedd0aac79","d4f45188d3c84a02ba08454e6403a818",22851949,1,5,0,90,20,24,4
"d4f45188d3c84a02ba08454e6403a818","d4c3b003e8274e429d2fa688d73fde6d",22851949,1,-2,0,91,24,22,-2
"d4c3b003e8274e429d2fa688d73fde6d","d4c3b003e8274e429d2fa688d73fde6d",22851949,2,0,1,92,22,22,0
"d4c3b003e8274e429d2fa688d73fde6d","b7719e26494940efa49512aedd0aac79",22851949,1,-3,0,94,22,20,-2
"b7719e26494940efa49512aedd0aac79","b7719e26494940efa49512aedd0aac79",22851949,1,0,1,95,20,20,0
"b7719e26494940efa49512aedd0aac79","afbf7250b99d47bea07172749483ca97",22851949,1,12,0,96,20,28,8
"afbf7250b99d47bea07172749483ca97","afbf7250b99d47bea07172749483ca97",22851949,1,0,1,97,28,28,0
"afbf7250b99d47bea07172749483ca97","4e51676dc72045d99c19b9fa7b22f8bc",22851949,1,3,0,98,28,29,1
"4e51676dc72045d99c19b9fa7b22f8bc","4e51676dc72045d99c19b9fa7b22f8bc",22851949,1,0,1,99,29,29,0
"4e51676dc72045d99c19b9fa7b22f8bc","51970cfa30e643e894e66ae85c8024cc",22851949,1,3,0,100,29,31,2
"51970cfa30e643e894e66ae85c8024cc","4e51676dc72045d99c19b9fa7b22f8bc",22851949,1,-3,0,101,31,29,-2
"4e51676dc72045d99c19b9fa7b22f8bc","c33c17be71ae4d588da7369472e5bb1b",22851949,1,9,0,102,29,34,5
"c33c17be71ae4d588da7369472e5bb1b","93679be414554a11b1893002f2229a93",22851949,1,3,0,103,34,35,1
"93679be414554a11b1893002f2229a93","c33c17be71ae4d588da7369472e5bb1b",22851949,1,-3,0,104,35,34,-1
"c33c17be71ae4d588da7369472e5bb1b","7040a13096d746ac84b8fac8d9752058",22851949,1,6,0,105,34,36,2
"7040a13096d746ac84b8fac8d9752058","93679be414554a11b1893002f2229a93",22851949,1,-3,0,106,36,35,-1
"93679be414554a11b1893002f2229a93","9a0dc646f934470daf08c4b56ccf73db",22851949,1,6,0,107,35,37,2
"9a0dc646f934470daf08c4b56ccf73db","7040a13096d746ac84b8fac8d9752058",22851949,1,-3,0,108,37,36,-1
"7040a13096d746ac84b8fac8d9752058","fc0e049d56024bc9a02c9a9c435c3df7",22851949,1,6,0,109,36,38,2
"fc0e049d56024bc9a02c9a9c435c3df7","9a0dc646f934470daf08c4b56ccf73db",22851949,1,-3,0,110,38,37,-1
"9a0dc646f934470daf08c4b56ccf73db","67a089198fcb4e1c8f2385786c2b296f",22851949,1,7,0,111,37,39,2
"67a089198fcb4e1c8f2385786c2b296f","67a089198fcb4e1c8f2385786c2b296f",22851949,1,0,1,112,39,39,0
"67a089198fcb4e1c8f2385786c2b296f","64d48c6c9c7940639a932219a6c87198",22851949,1,1,0,113,39,40,1
"64d48c6c9c7940639a932219a6c87198","64d48c6c9c7940639a932219a6c87198",22851949,3,0,1,114,40,40,0
"64d48c6c9c7940639a932219a6c87198","b534b89233134e30a9b5645138bfa9ee",22851949,1,3,0,117,40,41,1
"b534b89233134e30a9b5645138bfa9ee","67a089198fcb4e1c8f2385786c2b296f",22851949,1,-4,0,118,41,39,-2
"67a089198fcb4e1c8f2385786c2b296f","0e37b720d23b4e7f8b313e79313fd107",22851949,1,7,0,119,39,44,5
"0e37b720d23b4e7f8b313e79313fd107","0e37b720d23b4e7f8b313e79313fd107",22851949,1,0,1,120,44,44,0
"0e37b720d23b4e7f8b313e79313fd107","6875d67fdd5f48168b62719df449bebd",22851949,1,1,0,121,44,45,1
"6875d67fdd5f48168b62719df449bebd","6875d67fdd5f48168b62719df449bebd",22851949,1,0,1,122,45,45,0
"6875d67fdd5f48168b62719df449bebd","b534b89233134e30a9b5645138bfa9ee",22851949,1,-4,0,123,45,41,-4
"b534b89233134e30a9b5645138bfa9ee","6e13d61a7bdb44bca949c9f86fab3be5",22851949,1,7,0,124,41,47,6
"6e13d61a7bdb44bca949c9f86fab3be5","6e13d61a7bdb44bca949c9f86fab3be5",22851949,7,0,1,125,47,47,0
"6e13d61a7bdb44bca949c9f86fab3be5","195f78799f984cc2b06c48dfe36be751",22851949,1,2,0,132,47,49,2
"195f78799f984cc2b06c48dfe36be751","195f78799f984cc2b06c48dfe36be751",22851949,2,0,1,133,49,49,0
"195f78799f984cc2b06c48dfe36be751","d9c8d8c444a64dadbbb508652c721e17",22851949,1,-3,0,135,49,46,-3
"d9c8d8c444a64dadbbb508652c721e17","d0c74f735e024943943e40333d6d337f",22851949,1,6,0,136,46,51,5
"d0c74f735e024943943e40333d6d337f","d0c74f735e024943943e40333d6d337f",22851949,2,0,1,137,51,51,0
"d0c74f735e024943943e40333d6d337f","983f8ff320594b279a7f4a6fe132f9c5",22851949,1,2,0,139,51,53,2
"983f8ff320594b279a7f4a6fe132f9c5","983f8ff320594b279a7f4a6fe132f9c5",22851949,2,0,1,140,53,53,0
"983f8ff320594b279a7f4a6fe132f9c5","35adfa5d923046aebabfefd98f35ff05",22851949,1,1,0,142,53,54,1
"35adfa5d923046aebabfefd98f35ff05","35adfa5d923046aebabfefd98f35ff05",22851949,5,0,1,143,54,54,0
"35adfa5d923046aebabfefd98f35ff05","b6f8a98476224da1b40e555ececc7ed8",22851949,1,1,0,148,54,55,1
"b6f8a98476224da1b40e555ececc7ed8","b6f8a98476224da1b40e555ececc7ed8",22851949,2,0,1,149,55,55,0
"b6f8a98476224da1b40e555ececc7ed8","86e22cb5fe0e4b47a9489ecddf7ed78f",22851949,1,1,0,151,55,56,1
"86e22cb5fe0e4b47a9489ecddf7ed78f","86e22cb5fe0e4b47a9489ecddf7ed78f",22851949,2,0,1,152,56,56,0
"86e22cb5fe0e4b47a9489ecddf7ed78f","f924752d8a1149668870b1e7698486f7",22851949,1,-6,0,154,56,50,-6
"f924752d8a1149668870b1e7698486f7","a1f2f12debe5432fb7a70bcd12bacfb9",22851949,1,9,0,155,50,58,8
"a1f2f12debe5432fb7a70bcd12bacfb9","78f30e4dcac84e3cbea8b2cc6e0d62b3",22851949,2,1,0,156,58,59,1
"78f30e4dcac84e3cbea8b2cc6e0d62b3","a1f2f12debe5432fb7a70bcd12bacfb9",22851949,1,-1,0,157,59,58,-1
"a1f2f12debe5432fb7a70bcd12bacfb9","a1f2f12debe5432fb7a70bcd12bacfb9",22851949,13,0,1,158,58,58,0
"78f30e4dcac84e3cbea8b2cc6e0d62b3","78f30e4dcac84e3cbea8b2cc6e0d62b3",22851949,7,0,1,172,59,59,0
"78f30e4dcac84e3cbea8b2cc6e0d62b3","12aa6e1672ac4e7aa6449a7a8609cd72",22851949,1,-2,0,179,59,57,-2
"12aa6e1672ac4e7aa6449a7a8609cd72","a0a418b8540d479fa6e0f653b701da8b",22851949,1,8,0,180,57,64,7
"a0a418b8540d479fa6e0f653b701da8b","bc42d26810654ea9a1df1efe1e58c7d5",22851949,1,-1,0,181,64,63,-1
"bc42d26810654ea9a1df1efe1e58c7d5","bc42d26810654ea9a1df1efe1e58c7d5",22851949,4,0,1,182,63,63,0
"bc42d26810654ea9a1df1efe1e58c7d5","4c943503763e4e349906eea3ed3c8e86",22851949,1,-2,0,186,63,61,-2
"4c943503763e4e349906eea3ed3c8e86","4c943503763e4e349906eea3ed3c8e86",22851949,1,0,1,187,61,61,0
"4c943503763e4e349906eea3ed3c8e86","309ccf3cc4fe429d9bfbaef53d3fa479",22851949,1,-1,0,188,61,60,-1
"309ccf3cc4fe429d9bfbaef53d3fa479","d646286c8051419bbc2e31dd1db55ca8",22851949,1,10,0,189,60,67,7
"d646286c8051419bbc2e31dd1db55ca8","b534b89233134e30a9b5645138bfa9ee",22851949,1,-33,0,190,67,41,-26
"b534b89233134e30a9b5645138bfa9ee","267f883678b24aed855fde42524975d9",22851949,1,37,0,191,41,71,30
"267f883678b24aed855fde42524975d9","267f883678b24aed855fde42524975d9",22851949,1,0,1,192,71,71,0
"267f883678b24aed855fde42524975d9","88fff56d0342490dbef9040750a20f6c",22851949,1,1,0,193,71,72,1
"88fff56d0342490dbef9040750a20f6c","88fff56d0342490dbef9040750a20f6c",22851949,1,0,1,194,72,72,0
"88fff56d0342490dbef9040750a20f6c","adb17b12b66c4a49a85fd34322f7df70",22851949,1,1,0,195,72,73,1
"adb17b12b66c4a49a85fd34322f7df70","adb17b12b66c4a49a85fd34322f7df70",22851949,1,0,1,196,73,73,0
"adb17b12b66c4a49a85fd34322f7df70","d646286c8051419bbc2e31dd1db55ca8",22851949,1,-6,0,197,73,67,-6
"d646286c8051419bbc2e31dd1db55ca8","a2becd407db34b189200a32546d9d569",22851949,1,9,0,198,67,75,8
"a2becd407db34b189200a32546d9d569","a2becd407db34b189200a32546d9d569",22851949,4,0,1,199,75,75,0
"a2becd407db34b189200a32546d9d569","58c22b011d0f4c2ea6d13615edbb9eeb",22851949,1,2,0,203,75,77,2
"58c22b011d0f4c2ea6d13615edbb9eeb","58c22b011d0f4c2ea6d13615edbb9eeb",22851949,8,0,1,204,77,77,0
"58c22b011d0f4c2ea6d13615edbb9eeb","dd76e1861dc9461c830888729d091ee0",22851949,1,1,0,212,77,78,1
"dd76e1861dc9461c830888729d091ee0","dd76e1861dc9461c830888729d091ee0",22851949,5,0,1,213,78,78,0
"dd76e1861dc9461c830888729d091ee0","cd1d828f1a694b87913a7ea66c23803e",22851949,1,1,0,218,78,79,1
"cd1d828f1a694b87913a7ea66c23803e","cd1d828f1a694b87913a7ea66c23803e",22851949,2,0,1,219,79,79,0
"cd1d828f1a694b87913a7ea66c23803e","9176a3c2b4d2465fa8b0c67096c2a97e",22851949,1,1,0,221,79,80,1
"9176a3c2b4d2465fa8b0c67096c2a97e","9176a3c2b4d2465fa8b0c67096c2a97e",22851949,5,0,1,222,80,80,0
"9176a3c2b4d2465fa8b0c67096c2a97e","f8ec6445f7194e25b9101d4fbcb07a18",22851949,1,1,0,227,80,81,1
"f8ec6445f7194e25b9101d4fbcb07a18","f8ec6445f7194e25b9101d4fbcb07a18",22851949,2,0,1,228,81,81,0
"f8ec6445f7194e25b9101d4fbcb07a18","140d5b27b8574befad82c0a013b59dfa",22851949,1,-7,0,230,81,74,-7
"140d5b27b8574befad82c0a013b59dfa","d18a9ea32855445f8736581f5cb119ce",22851949,1,9,0,231,74,82,8
"d18a9ea32855445f8736581f5cb119ce","f564483cbd7a407681aa2fcca518cf5f",22851949,1,4,0,232,82,85,3
"f564483cbd7a407681aa2fcca518cf5f","f564483cbd7a407681aa2fcca518cf5f",22851949,6,0,1,233,85,85,0
"f564483cbd7a407681aa2fcca518cf5f","18fd01350bd5434ca636d59a599d768a",22851949,2,1,0,238,85,86,1
"18fd01350bd5434ca636d59a599d768a","18fd01350bd5434ca636d59a599d768a",22851949,4,0,1,239,86,86,0
"18fd01350bd5434ca636d59a599d768a","f564483cbd7a407681aa2fcca518cf5f",22851949,1,-1,0,241,86,85,-1
"18fd01350bd5434ca636d59a599d768a","6a9f0ef185fb47f0937e29daa1c71ed5",22851949,1,5,0,246,86,90,4
"6a9f0ef185fb47f0937e29daa1c71ed5","ae5ac430ea254e708a6f5deaaf7464ae",22851949,1,-7,0,247,90,84,-6
"ae5ac430ea254e708a6f5deaaf7464ae","6a9f0ef185fb47f0937e29daa1c71ed5",22851949,1,7,0,248,84,90,6
"6a9f0ef185fb47f0937e29daa1c71ed5","6a9f0ef185fb47f0937e29daa1c71ed5",22851949,3,0,1,249,90,90,0
"6a9f0ef185fb47f0937e29daa1c71ed5","c681290961c94c4caf23b529d1ae6b9a",22851949,1,-2,0,252,90,88,-2
"c681290961c94c4caf23b529d1ae6b9a","c681290961c94c4caf23b529d1ae6b9a",22851949,1,0,1,253,88,88,0
"c681290961c94c4caf23b529d1ae6b9a","d646286c8051419bbc2e31dd1db55ca8",22851949,1,-25,0,254,88,67,-21
"d646286c8051419bbc2e31dd1db55ca8","e20db35ced8544ddac5bc3839145e463",22851949,1,30,0,255,67,91,24
"e20db35ced8544ddac5bc3839145e463","1febb706d7a34005ae8711ed49c76e64",22851949,1,3,0,256,91,94,3
"1febb706d7a34005ae8711ed49c76e64","1febb706d7a34005ae8711ed49c76e64",22851949,2,0,1,257,94,94,0
"1febb706d7a34005ae8711ed49c76e64","8f73ba6f5a0042f2850356ac38ac6f24",22851949,1,1,0,259,94,95,1
"8f73ba6f5a0042f2850356ac38ac6f24","8f73ba6f5a0042f2850356ac38ac6f24",22851949,5,0,1,260,95,95,0
"8f73ba6f5a0042f2850356ac38ac6f24","e2260b86653c46d7b14a41fb419dbf8c",22851949,1,1,0,265,95,96,1
"e2260b86653c46d7b14a41fb419dbf8c","e2260b86653c46d7b14a41fb419dbf8c",22851949,2,0,1,266,96,96,0
"e2260b86653c46d7b14a41fb419dbf8c","35eb641ad1d845bbba54915bce75a962",22851949,1,1,0,268,96,97,1
"35eb641ad1d845bbba54915bce75a962","35eb641ad1d845bbba54915bce75a962",22851949,5,0,1,269,97,97,0
"35eb641ad1d845bbba54915bce75a962","08be90ffbeea4795a138cd42ed8db56f",22851949,1,1,0,274,97,98,1
"08be90ffbeea4795a138cd42ed8db56f","08be90ffbeea4795a138cd42ed8db56f",22851949,5,0,1,275,98,98,0
"08be90ffbeea4795a138cd42ed8db56f","3007433c8f584dcbb5ac159c1c5f2be3",22851949,1,1,0,280,98,99,1
"3007433c8f584dcbb5ac159c1c5f2be3","3007433c8f584dcbb5ac159c1c5f2be3",22851949,5,0,1,281,99,99,0
"3007433c8f584dcbb5ac159c1c5f2be3","e20db35ced8544ddac5bc3839145e463",22851949,1,-8,0,286,99,91,-8
"e20db35ced8544ddac5bc3839145e463","00ae5f0c51874a73a41ebea838d95682",22851949,1,11,0,287,91,101,10
"00ae5f0c51874a73a41ebea838d95682","d391c8b6e56a43a7b654e9dee02d904b",22851949,2,2,0,288,101,103,2
"d391c8b6e56a43a7b654e9dee02d904b","00ae5f0c51874a73a41ebea838d95682",22851949,1,-2,0,289,103,101,-2
"00ae5f0c51874a73a41ebea838d95682","00ae5f0c51874a73a41ebea838d95682",22851949,1,0,1,290,101,101,0
"d391c8b6e56a43a7b654e9dee02d904b","d391c8b6e56a43a7b654e9dee02d904b",22851949,20,0,1,292,103,103,0
"d391c8b6e56a43a7b654e9dee02d904b","a81b2235cb9c499eb9ea8ee0a8dd9725",22851949,1,2,0,312,103,105,2
"a81b2235cb9c499eb9ea8ee0a8dd9725","a81b2235cb9c499eb9ea8ee0a8dd9725",22851949,5,0,1,313,105,105,0
"a81b2235cb9c499eb9ea8ee0a8dd9725","2d4e0ab0ef3b4d73b82c72d4621a7579",22851949,1,1,0,318,105,106,1
"2d4e0ab0ef3b4d73b82c72d4621a7579","2d4e0ab0ef3b4d73b82c72d4621a7579",22851949,2,0,1,319,106,106,0
"2d4e0ab0ef3b4d73b82c72d4621a7579","6111116566fc4fd9abba409322bea245",22851949,1,-2,0,321,106,104,-2
"6111116566fc4fd9abba409322bea245","6111116566fc4fd9abba409322bea245",22851949,2,0,1,322,104,104,0
"6111116566fc4fd9abba409322bea245","8bdebf492ebd4e62b0d522e8ab5e5197",22851949,1,3,0,324,104,107,3
"8bdebf492ebd4e62b0d522e8ab5e5197","8bdebf492ebd4e62b0d522e8ab5e5197",22851949,2,0,1,325,107,107,0
"8bdebf492ebd4e62b0d522e8ab5e5197","73039f8c1eb9409cb4caee2cf968001e",22851949,1,-7,0,327,107,100,-7
"73039f8c1eb9409cb4caee2cf968001e","4280927ec4d643238aa49c32f9e06c6c",22851949,1,10,0,328,100,109,9
"4280927ec4d643238aa49c32f9e06c6c","4280927ec4d643238aa49c32f9e06c6c",22851949,2,0,1,329,109,109,0
"4280927ec4d643238aa49c32f9e06c6c","fc44e6a5f7654430af1227838224dceb",22851949,1,2,0,331,109,111,2
"fc44e6a5f7654430af1227838224dceb","fc44e6a5f7654430af1227838224dceb",22851949,5,0,1,332,111,111,0
"fc44e6a5f7654430af1227838224dceb","08111f75e22d409998cf8b85bd431f0a",22851949,1,-3,0,337,111,108,-3
"08111f75e22d409998cf8b85bd431f0a","a9ae0a3c070d455bb4369a8996313336",22851949,1,7,0,338,108,114,6
"a9ae0a3c070d455bb4369a8996313336","a9ae0a3c070d455bb4369a8996313336",22851949,1,0,1,339,114,114,0
"a9ae0a3c070d455bb4369a8996313336","71cec822bcff4f30a20e75dc63ef7b65",22851949,1,2,0,340,114,116,2
"71cec822bcff4f30a20e75dc63ef7b65","71cec822bcff4f30a20e75dc63ef7b65",22851949,3,0,1,341,116,116,0
"71cec822bcff4f30a20e75dc63ef7b65","37319e88176d4aefa91d7a9980dbae91",22851949,1,-4,0,344,116,112,-4
"37319e88176d4aefa91d7a9980dbae91","62bff51286ef4f348717a3cf6fe2318f",22851949,1,9,0,345,112,120,8
"62bff51286ef4f348717a3cf6fe2318f","62bff51286ef4f348717a3cf6fe2318f",22851949,4,0,1,346,120,120,0
"62bff51286ef4f348717a3cf6fe2318f","b1cd0e7dc3ad4a8eb91a4bfdbeb025b0",22851949,1,-2,0,350,120,118,-2
"b1cd0e7dc3ad4a8eb91a4bfdbeb025b0","b1cd0e7dc3ad4a8eb91a4bfdbeb025b0",22851949,1,0,1,351,118,118,0
"b1cd0e7dc3ad4a8eb91a4bfdbeb025b0","e20db35ced8544ddac5bc3839145e463",22851949,1,-31,0,352,118,91,-27
"e20db35ced8544ddac5bc3839145e463","779f9ddd1fd14d1e9e69f72219a1fdbd",22851949,1,36,0,353,91,121,30
"779f9ddd1fd14d1e9e69f72219a1fdbd","ae26e6cda8ad4a3f81bd347560d9579f",22851949,1,4,0,354,121,125,4
"ae26e6cda8ad4a3f81bd347560d9579f","ae26e6cda8ad4a3f81bd347560d9579f",22851949,1,0,1,355,125,125,0
"ae26e6cda8ad4a3f81bd347560d9579f","ee48df95832b4374aa273ceb27ec1315",22851949,1,1,0,356,125,126,1
"ee48df95832b4374aa273ceb27ec1315","ee48df95832b4374aa273ceb27ec1315",22851949,1,0,1,357,126,126,0
"ee48df95832b4374aa273ceb27ec1315","7a439da90b394756ad1777fc4c6dead5",22851949,1,1,0,358,126,127,1
"7a439da90b394756ad1777fc4c6dead5","7a439da90b394756ad1777fc4c6dead5",22851949,3,0,1,359,127,127,0
"7a439da90b394756ad1777fc4c6dead5","779f9ddd1fd14d1e9e69f72219a1fdbd",22851949,1,-6,0,362,127,121,-6
"779f9ddd1fd14d1e9e69f72219a1fdbd","a8dd5213034441ac92724b4e83eb0bb2",22851949,1,9,0,363,121,129,8
"a8dd5213034441ac92724b4e83eb0bb2","a8dd5213034441ac92724b4e83eb0bb2",22851949,2,0,1,364,129,129,0
"a8dd5213034441ac92724b4e83eb0bb2","8115eab6556b45f5b415c3b8c26a12e5",22851949,1,2,0,366,129,131,2
"8115eab6556b45f5b415c3b8c26a12e5","8115eab6556b45f5b415c3b8c26a12e5",22851949,2,0,1,367,131,131,0
"8115eab6556b45f5b415c3b8c26a12e5","ec34b06efd844b46a4c4818ecdb9b8f4",22851949,1,1,0,369,131,132,1
"ec34b06efd844b46a4c4818ecdb9b8f4","ec34b06efd844b46a4c4818ecdb9b8f4",22851949,2,0,1,370,132,132,0
"ec34b06efd844b46a4c4818ecdb9b8f4","c2e1c2b9eac64109b343a088584b576b",22851949,1,1,0,372,132,133,1
"c2e1c2b9eac64109b343a088584b576b","c2e1c2b9eac64109b343a088584b576b",22851949,2,0,1,373,133,133,0
"c2e1c2b9eac64109b343a088584b576b","579338175e0b4bbb8ef3b712b5d8b54e",22851949,1,-5,0,375,133,128,-5
"579338175e0b4bbb8ef3b712b5d8b54e","8bc5795d6a984a3eace4e2811e52dd4f",22851949,1,8,0,376,128,135,7
"8bc5795d6a984a3eace4e2811e52dd4f","8bc5795d6a984a3eace4e2811e52dd4f",22851949,1,0,1,377,135,135,0
"8bc5795d6a984a3eace4e2811e52dd4f","b416d47c56a742199b5d7c7f19d6503a",22851949,1,-1,0,378,135,134,-1
"b416d47c56a742199b5d7c7f19d6503a","cd4532ad48034873ba8bce2aac0c9808",22851949,1,4,0,379,134,137,3
"cd4532ad48034873ba8bce2aac0c9808","cd4532ad48034873ba8bce2aac0c9808",22851949,1,0,1,380,137,137,0
"cd4532ad48034873ba8bce2aac0c9808","779f9ddd1fd14d1e9e69f72219a1fdbd",22851949,1,-19,0,381,137,121,-16
"779f9ddd1fd14d1e9e69f72219a1fdbd","df1de691dafe4549a18a4398ee9dfaf9",22851949,1,23,0,382,121,139,18
"df1de691dafe4549a18a4398ee9dfaf9","6c5ad271a44743479bfaea29b1db8d02",22851949,1,4,0,383,139,143,4
"6c5ad271a44743479bfaea29b1db8d02","6c5ad271a44743479bfaea29b1db8d02",22851949,2,0,1,384,143,143,0
"6c5ad271a44743479bfaea29b1db8d02","83d311bed5374fee83d8d67a7d9d82dc",22851949,1,1,0,386,143,144,1
"83d311bed5374fee83d8d67a7d9d82dc","83d311bed5374fee83d8d67a7d9d82dc",22851949,1,0,1,387,144,144,0
"83d311bed5374fee83d8d67a7d9d82dc","402bba41861d43acb52a5abb89e8831e",22851949,1,1,0,388,144,145,1
"402bba41861d43acb52a5abb89e8831e","402bba41861d43acb52a5abb89e8831e",22851949,2,0,1,389,145,145,0
"402bba41861d43acb52a5abb89e8831e","8aae34f5ddbb4052a709b12e6b0d40fa",22851949,1,3,0,391,145,147,2
"8aae34f5ddbb4052a709b12e6b0d40fa","df1de691dafe4549a18a4398ee9dfaf9",22851949,1,-9,0,392,147,139,-8
"df1de691dafe4549a18a4398ee9dfaf9","8aae34f5ddbb4052a709b12e6b0d40fa",22851949,1,9,0,393,139,147,8
"8aae34f5ddbb4052a709b12e6b0d40fa","8aae34f5ddbb4052a709b12e6b0d40fa",22851949,1,0,1,394,147,147,0
"8aae34f5ddbb4052a709b12e6b0d40fa","645b3f0249f64f76af2e19eb4d0e55b7",22851949,1,2,0,395,147,149,2
"645b3f0249f64f76af2e19eb4d0e55b7","645b3f0249f64f76af2e19eb4d0e55b7",22851949,5,0,1,396,149,149,0
"645b3f0249f64f76af2e19eb4d0e55b7","7e7b8db5064d4369805ab370aac5ddfb",22851949,1,1,0,401,149,150,1
"7e7b8db5064d4369805ab370aac5ddfb","7e7b8db5064d4369805ab370aac5ddfb",22851949,2,0,1,402,150,150,0
"7e7b8db5064d4369805ab370aac5ddfb","8956d210ae7f41968fada86d4c979d6a",22851949,1,1,0,404,150,151,1
"8956d210ae7f41968fada86d4c979d6a","8956d210ae7f41968fada86d4c979d6a",22851949,2,0,1,405,151,151,0
"8956d210ae7f41968fada86d4c979d6a","f902b0f41b544d4dbf79664fd233648d",22851949,1,-5,0,407,151,146,-5
"f902b0f41b544d4dbf79664fd233648d","ae781e8b775e4ccd93bc800dad5c8376",22851949,1,8,0,408,146,153,7
"ae781e8b775e4ccd93bc800dad5c8376","ae781e8b775e4ccd93bc800dad5c8376",22851949,2,0,1,409,153,153,0
"ae781e8b775e4ccd93bc800dad5c8376","06882a8492d9499aa31555567f575ecb",22851949,1,1,0,411,153,154,1
"06882a8492d9499aa31555567f575ecb","06882a8492d9499aa31555567f575ecb",22851949,1,0,1,412,154,154,0
"06882a8492d9499aa31555567f575ecb","f293c508f409466a8f27ddd7d1e40b20",22851949,1,1,0,413,154,155,1
"f293c508f409466a8f27ddd7d1e40b20","f293c508f409466a8f27ddd7d1e40b20",22851949,5,0,1,414,155,155,0
"f293c508f409466a8f27ddd7d1e40b20","cc4ddef5bbbe48ebb605141b347c4ed1",22851949,1,1,0,419,155,156,1
"cc4ddef5bbbe48ebb605141b347c4ed1","cc4ddef5bbbe48ebb605141b347c4ed1",22851949,1,0,1,420,156,156,0
"cc4ddef5bbbe48ebb605141b347c4ed1","d313cec988a84645bee413e8d4724a4b",22851949,1,3,0,421,156,158,2
"d313cec988a84645bee413e8d4724a4b","f03480cf4eba413194d7af52fc0e7f28",22851949,1,-7,0,422,158,152,-6
"f03480cf4eba413194d7af52fc0e7f28","d313cec988a84645bee413e8d4724a4b",22851949,1,7,0,423,152,158,6
"d313cec988a84645bee413e8d4724a4b","d313cec988a84645bee413e8d4724a4b",22851949,3,0,1,424,158,158,0
"d313cec988a84645bee413e8d4724a4b","dc60696c76a74368a60f72246e47700d",22851949,1,1,0,427,158,159,1
"dc60696c76a74368a60f72246e47700d","dc60696c76a74368a60f72246e47700d",22851949,1,0,1,428,159,159,0
"dc60696c76a74368a60f72246e47700d","78adeee1fa2c4fe0bc73f7bca9fcee86",22851949,1,3,0,429,159,160,1
"78adeee1fa2c4fe0bc73f7bca9fcee86","df1de691dafe4549a18a4398ee9dfaf9",22851949,1,-26,0,430,160,139,-21
"df1de691dafe4549a18a4398ee9dfaf9","65202579580f4ad38d734b4ee39d22a8",22851949,1,31,0,431,139,164,25
"65202579580f4ad38d734b4ee39d22a8","65202579580f4ad38d734b4ee39d22a8",22851949,52,0,1,432,164,164,0
"65202579580f4ad38d734b4ee39d22a8","78adeee1fa2c4fe0bc73f7bca9fcee86",22851949,3,-5,0,438,164,160,-4
"78adeee1fa2c4fe0bc73f7bca9fcee86","65202579580f4ad38d734b4ee39d22a8",22851949,2,5,0,439,160,164,4
"78adeee1fa2c4fe0bc73f7bca9fcee86","3cbcea2be0984e7dbd5a48195af10ce7",22851949,1,8,0,489,160,165,5
"3cbcea2be0984e7dbd5a48195af10ce7","82e6285962b8400d9d6fc32436022a94",22851949,1,2,0,490,165,167,2
"82e6285962b8400d9d6fc32436022a94","3cbcea2be0984e7dbd5a48195af10ce7",22851949,1,-2,0,491,167,165,-2
"3cbcea2be0984e7dbd5a48195af10ce7","a9ac840f098c4bd0a2ee896214ce29cd",22851949,1,5,0,492,165,168,3
"a9ac840f098c4bd0a2ee896214ce29cd","a9ac840f098c4bd0a2ee896214ce29cd",22851949,1,0,1,493,168,168,0
"a9ac840f098c4bd0a2ee896214ce29cd","0c7262dff33c4087bc660ccf40f92f9c",22851949,1,4,0,494,168,169,1
"0c7262dff33c4087bc660ccf40f92f9c","b2275c3fad834f8d90737a2d9a6927d6",22851949,1,3,0,495,169,172,3
"b2275c3fad834f8d90737a2d9a6927d6","b2275c3fad834f8d90737a2d9a6927d6",22851949,31,0,1,496,172,172,0
"b2275c3fad834f8d90737a2d9a6927d6","eb515a26030b41f8a82a1e6114420bad",22851949,1,1,0,527,172,173,1
"eb515a26030b41f8a82a1e6114420bad","eb515a26030b41f8a82a1e6114420bad",22851949,2,0,1,528,173,173,0
"eb515a26030b41f8a82a1e6114420bad","b42cc17b7de840f181a704558d0bc845",22851949,1,3,0,530,173,175,2
"b42cc17b7de840f181a704558d0bc845","0c7262dff33c4087bc660ccf40f92f9c",22851949,1,-7,0,531,175,169,-6
"0c7262dff33c4087bc660ccf40f92f9c","b42cc17b7de840f181a704558d0bc845",22851949,1,7,0,532,169,175,6
"b42cc17b7de840f181a704558d0bc845","b42cc17b7de840f181a704558d0bc845",22851949,4,0,1,533,175,175,0
"b42cc17b7de840f181a704558d0bc845","801f9e9135034f49bf5f8b4bdefedb41",22851949,1,2,0,537,175,177,2
"801f9e9135034f49bf5f8b4bdefedb41","801f9e9135034f49bf5f8b4bdefedb41",22851949,4,0,1,538,177,177,0
"801f9e9135034f49bf5f8b4bdefedb41","ea38cc0e6e6e41edbabf210220808bf9",22851949,1,3,0,542,177,179,2
"ea38cc0e6e6e41edbabf210220808bf9","362fcb0699a14845ab29b2340093e528",22851949,1,-6,0,543,179,174,-5
"362fcb0699a14845ab29b2340093e528","b87c552dd247427abe6ab5795b9c9d43",22851949,1,8,0,544,174,181,7
"b87c552dd247427abe6ab5795b9c9d43","ea38cc0e6e6e41edbabf210220808bf9",22851949,1,-2,0,545,181,179,-2
"ea38cc0e6e6e41edbabf210220808bf9","ea38cc0e6e6e41edbabf210220808bf9",22851949,1,0,1,546,179,179,0
"ea38cc0e6e6e41edbabf210220808bf9","b87c552dd247427abe6ab5795b9c9d43",22851949,1,2,0,547,179,181,2
"b87c552dd247427abe6ab5795b9c9d43","b87c552dd247427abe6ab5795b9c9d43",22851949,7,0,1,548,181,181,0
"b87c552dd247427abe6ab5795b9c9d43","139b097acfca451689d80c9c6eebdf7b",22851949,1,-3,0,555,181,178,-3
"139b097acfca451689d80c9c6eebdf7b","30f660a1feb34582a739722532524f79",22851949,1,6,0,556,178,183,5
"30f660a1feb34582a739722532524f79","30f660a1feb34582a739722532524f79",22851949,9,0,1,557,183,183,0
"30f660a1feb34582a739722532524f79","2024b4885bd14338a39b7b509acbbd02",22851949,1,-1,0,566,183,182,-1
"2024b4885bd14338a39b7b509acbbd02","c3f63fe50d8e487c86bf8ef76c9cadd3",22851949,1,4,0,567,182,185,3
"c3f63fe50d8e487c86bf8ef76c9cadd3","c3f63fe50d8e487c86bf8ef76c9cadd3",22851949,4,0,1,568,185,185,0
"c3f63fe50d8e487c86bf8ef76c9cadd3","0c7262dff33c4087bc660ccf40f92f9c",22851949,1,-20,0,569,185,169,-16
"0c7262dff33c4087bc660ccf40f92f9c","c8e371568a0c4391b25796ae4e91952e",22851949,6,23,0,570,169,186,17
"c8e371568a0c4391b25796ae4e91952e","7d932b23e1c84326ae5aa4d3c0d813d1",22851949,1,2,0,571,186,188,2
"7d932b23e1c84326ae5aa4d3c0d813d1","7d932b23e1c84326ae5aa4d3c0d813d1",22851949,1,0,1,572,188,188,0
"7d932b23e1c84326ae5aa4d3c0d813d1","ab11d94c6c8948ea90b88f19d2cd502b",22851949,1,3,0,573,188,190,2
"ab11d94c6c8948ea90b88f19d2cd502b","c8e371568a0c4391b25796ae4e91952e",22851949,1,-5,0,574,190,186,-4
"c8e371568a0c4391b25796ae4e91952e","ab11d94c6c8948ea90b88f19d2cd502b",22851949,5,5,0,575,186,190,4
"ab11d94c6c8948ea90b88f19d2cd502b","ab11d94c6c8948ea90b88f19d2cd502b",22851949,5,0,1,576,190,190,0
"ab11d94c6c8948ea90b88f19d2cd502b","f992451ed6ad4e68bb9e68ad6be7c4be",22851949,1,2,0,580,190,192,2
"f992451ed6ad4e68bb9e68ad6be7c4be","f992451ed6ad4e68bb9e68ad6be7c4be",22851949,1,0,1,581,192,192,0
"f992451ed6ad4e68bb9e68ad6be7c4be","07b44a7a51e94c78b411c753fc39dab0",22851949,1,-3,0,582,192,189,-3
"07b44a7a51e94c78b411c753fc39dab0","6cd2dcaac46847d4a0bc53f296d90375",22851949,5,6,0,583,189,194,5
"6cd2dcaac46847d4a0bc53f296d90375","6cd2dcaac46847d4a0bc53f296d90375",22851949,3,0,1,584,194,194,0
"6cd2dcaac46847d4a0bc53f296d90375","2d2580c9411c4972909db508d6956a58",22851949,1,2,0,587,194,196,2
"2d2580c9411c4972909db508d6956a58","2d2580c9411c4972909db508d6956a58",22851949,8,0,1,588,196,196,0
"2d2580c9411c4972909db508d6956a58","5bddb3d9ed264f3984702f048c7e5340",22851949,1,1,0,596,196,197,1
"5bddb3d9ed264f3984702f048c7e5340","5bddb3d9ed264f3984702f048c7e5340",22851949,2,0,1,597,197,197,0
"5bddb3d9ed264f3984702f048c7e5340","d5e8e2bd12a2466b9d6d90855f0eb079",22851949,1,1,0,599,197,198,1
"d5e8e2bd12a2466b9d6d90855f0eb079","d5e8e2bd12a2466b9d6d90855f0eb079",22851949,2,0,1,600,198,198,0
"d5e8e2bd12a2466b9d6d90855f0eb079","017d7ca8e0394b91aaadc9574df2202c",22851949,1,-5,0,602,198,193,-5
"017d7ca8e0394b91aaadc9574df2202c","54e8e9f0ea3e45c4bf3b8ac799ee31b1",22851949,1,8,0,603,193,200,7
"54e8e9f0ea3e45c4bf3b8ac799ee31b1","54e8e9f0ea3e45c4bf3b8ac799ee31b1",22851949,1,0,1,604,200,200,0
"54e8e9f0ea3e45c4bf3b8ac799ee31b1","c614a00911be4877a075f19315530fb0",22851949,1,1,0,605,200,201,1
"c614a00911be4877a075f19315530fb0","c614a00911be4877a075f19315530fb0",22851949,6,0,1,606,201,201,0
"c614a00911be4877a075f19315530fb0","a6c21bd8b95249c7972820a7a7d76aff",22851949,1,1,0,612,201,202,1
"a6c21bd8b95249c7972820a7a7d76aff","a6c21bd8b95249c7972820a7a7d76aff",22851949,1,0,1,613,202,202,0
"a6c21bd8b95249c7972820a7a7d76aff","bb329d880ab54120adaf203a693bb203",22851949,1,1,0,614,202,203,1
"bb329d880ab54120adaf203a693bb203","bb329d880ab54120adaf203a693bb203",22851949,2,0,1,615,203,203,0
"bb329d880ab54120adaf203a693bb203","c8e371568a0c4391b25796ae4e91952e",22851949,1,-20,0,616,203,186,-17
"c8e371568a0c4391b25796ae4e91952e","c8e371568a0c4391b25796ae4e91952e",22851949,2,0,1,617,186,186,0
"ab11d94c6c8948ea90b88f19d2cd502b","07b44a7a51e94c78b411c753fc39dab0",22851949,4,-1,0,619,190,189,-1
"6cd2dcaac46847d4a0bc53f296d90375","017d7ca8e0394b91aaadc9574df2202c",22851949,4,-1,0,621,194,193,-1
"017d7ca8e0394b91aaadc9574df2202c","bb329d880ab54120adaf203a693bb203",22851949,1,11,0,622,193,203,10
"bb329d880ab54120adaf203a693bb203","f9170dd6bc6442b4acd832747609b09a",22851949,1,-4,0,624,203,199,-4
"f9170dd6bc6442b4acd832747609b09a","c8e371568a0c4391b25796ae4e91952e",22851949,2,-16,0,625,199,186,-13
"017d7ca8e0394b91aaadc9574df2202c","f9170dd6bc6442b4acd832747609b09a",22851949,3,7,0,631,193,199,6
"f9170dd6bc6442b4acd832747609b09a","d7f13c8d63ec4e2aa673fbb9cf9c6933",22851949,2,10,0,632,199,206,7
"d7f13c8d63ec4e2aa673fbb9cf9c6933","c8e371568a0c4391b25796ae4e91952e",22851949,3,-26,0,633,206,186,-20
"c8e371568a0c4391b25796ae4e91952e","334c2344009840079b1d0e1b7ce3d5a7",22851949,1,23,0,634,186,205,19
"334c2344009840079b1d0e1b7ce3d5a7","334c2344009840079b1d0e1b7ce3d5a7",22851949,1,0,1,635,205,205,0
"334c2344009840079b1d0e1b7ce3d5a7","b9e80f77c3a44349863b19875725c384",22851949,1,4,0,636,205,207,2
"b9e80f77c3a44349863b19875725c384","7108f0e4c2584f1f9c471689ae4c885c",22851949,3,1,0,637,207,208,1
"7108f0e4c2584f1f9c471689ae4c885c","c8e371568a0c4391b25796ae4e91952e",22851949,1,-28,0,638,208,186,-22
"c8e371568a0c4391b25796ae4e91952e","d7f13c8d63ec4e2aa673fbb9cf9c6933",22851949,3,26,0,639,186,206,20
"d7f13c8d63ec4e2aa673fbb9cf9c6933","7108f0e4c2584f1f9c471689ae4c885c",22851949,1,2,0,642,206,208,2
"7108f0e4c2584f1f9c471689ae4c885c","b9e80f77c3a44349863b19875725c384",22851949,2,-1,0,643,208,207,-1
"b9e80f77c3a44349863b19875725c384","b9e80f77c3a44349863b19875725c384",22851949,14,0,1,644,207,207,0
"7108f0e4c2584f1f9c471689ae4c885c","7108f0e4c2584f1f9c471689ae4c885c",22851949,29,0,1,659,208,208,0
"7108f0e4c2584f1f9c471689ae4c885c","09400e101c5d4b439cf9a26b03aae558",22851949,1,3,0,688,208,210,2
"09400e101c5d4b439cf9a26b03aae558","d7f13c8d63ec4e2aa673fbb9cf9c6933",22851949,1,-5,0,689,210,206,-4
"d7f13c8d63ec4e2aa673fbb9cf9c6933","0c7262dff33c4087bc660ccf40f92f9c",22851949,1,-49,0,690,206,169,-37
"0c7262dff33c4087bc660ccf40f92f9c","c3f63fe50d8e487c86bf8ef76c9cadd3",22851949,1,20,0,691,169,185,16
"c3f63fe50d8e487c86bf8ef76c9cadd3","c8e371568a0c4391b25796ae4e91952e",22851949,1,3,0,695,185,186,1
"c8e371568a0c4391b25796ae4e91952e","0c7262dff33c4087bc660ccf40f92f9c",22851949,4,-23,0,696,186,169,-17
"d7f13c8d63ec4e2aa673fbb9cf9c6933","b9e80f77c3a44349863b19875725c384",22851949,1,1,0,706,206,207,1
"7108f0e4c2584f1f9c471689ae4c885c","d7f13c8d63ec4e2aa673fbb9cf9c6933",22851949,1,-2,0,708,208,206,-2
"d7f13c8d63ec4e2aa673fbb9cf9c6933","09400e101c5d4b439cf9a26b03aae558",22851949,2,5,0,709,206,210,4
"09400e101c5d4b439cf9a26b03aae558","09400e101c5d4b439cf9a26b03aae558",22851949,5,0,1,710,210,210,0
"09400e101c5d4b439cf9a26b03aae558","a88efa7e50ce47159810ab553afa6d3a",22851949,1,2,0,715,210,212,2
"a88efa7e50ce47159810ab553afa6d3a","a88efa7e50ce47159810ab553afa6d3a",22851949,5,0,1,716,212,212,0
"a88efa7e50ce47159810ab553afa6d3a","be502a7a43c44bf7b682698de79d9369",22851949,1,3,0,721,212,214,2
"be502a7a43c44bf7b682698de79d9369","a875096404ef4a9984b62d74cda916f9",22851949,1,-6,0,722,214,209,-5
"a875096404ef4a9984b62d74cda916f9","f7fb1952f56b4189b86a9f8b7862d2b8",22851949,1,7,0,723,209,215,6
"f7fb1952f56b4189b86a9f8b7862d2b8","be502a7a43c44bf7b682698de79d9369",22851949,1,-1,0,724,215,214,-1
"be502a7a43c44bf7b682698de79d9369","be502a7a43c44bf7b682698de79d9369",22851949,5,0,1,725,214,214,0
"be502a7a43c44bf7b682698de79d9369","f7fb1952f56b4189b86a9f8b7862d2b8",22851949,2,1,0,730,214,215,1
"f7fb1952f56b4189b86a9f8b7862d2b8","f7fb1952f56b4189b86a9f8b7862d2b8",22851949,17,0,1,731,215,215,0
"f7fb1952f56b4189b86a9f8b7862d2b8","b860ee85d8bc4a2f97958cfb71be3533",22851949,1,1,0,748,215,216,1
"b860ee85d8bc4a2f97958cfb71be3533","b860ee85d8bc4a2f97958cfb71be3533",22851949,2,0,1,749,216,216,0
"b860ee85d8bc4a2f97958cfb71be3533","ec341f459285443b8361f7f15638ff08",22851949,1,-3,0,751,216,213,-3
"ec341f459285443b8361f7f15638ff08","363837c182e04711840d896ae1e0339c",22851949,1,6,0,752,213,218,5
"363837c182e04711840d896ae1e0339c","363837c182e04711840d896ae1e0339c",22851949,14,0,1,753,218,218,0
"363837c182e04711840d896ae1e0339c","01b2051f8941460d89945e3b02d1ce78",22851949,1,-1,0,767,218,217,-1
"01b2051f8941460d89945e3b02d1ce78","91125ca626c5470eb145501f8c37f8db",22851949,1,4,0,768,217,220,3
"91125ca626c5470eb145501f8c37f8db","91125ca626c5470eb145501f8c37f8db",22851949,1,0,1,769,220,220,0
"91125ca626c5470eb145501f8c37f8db","1c6721b1f63f4d30ba7746ea8af02a52",22851949,1,3,0,770,220,221,1
"1c6721b1f63f4d30ba7746ea8af02a52","d7f13c8d63ec4e2aa673fbb9cf9c6933",22851949,1,-21,0,771,221,206,-15
"d7f13c8d63ec4e2aa673fbb9cf9c6933","77ecef8eff6b4a2caea7707669bf7475",22851949,1,22,0,772,206,222,16
"77ecef8eff6b4a2caea7707669bf7475","77ecef8eff6b4a2caea7707669bf7475",22851949,12,0,1,773,222,222,0
"77ecef8eff6b4a2caea7707669bf7475","1c6721b1f63f4d30ba7746ea8af02a52",22851949,2,-1,0,785,222,221,-1
"1c6721b1f63f4d30ba7746ea8af02a52","d03cb855c70044cf8c35d9ec0de696e3",22851949,2,4,0,786,221,224,3
"d03cb855c70044cf8c35d9ec0de696e3","8b9ae98743bd4d4a8a87dff1c1244211",22851949,2,3,0,787,224,227,3
"8b9ae98743bd4d4a8a87dff1c1244211","0c7262dff33c4087bc660ccf40f92f9c",22851949,1,-77,0,788,227,169,-58
"c8e371568a0c4391b25796ae4e91952e","7108f0e4c2584f1f9c471689ae4c885c",22851949,1,28,0,803,186,208,22
"b9e80f77c3a44349863b19875725c384","d7f13c8d63ec4e2aa673fbb9cf9c6933",22851949,1,-1,0,805,207,206,-1
"09400e101c5d4b439cf9a26b03aae558","a875096404ef4a9984b62d74cda916f9",22851949,1,-1,0,807,210,209,-1
"a875096404ef4a9984b62d74cda916f9","be502a7a43c44bf7b682698de79d9369",22851949,1,6,0,808,209,214,5
"f7fb1952f56b4189b86a9f8b7862d2b8","363837c182e04711840d896ae1e0339c",22851949,1,4,0,810,215,218,3
"363837c182e04711840d896ae1e0339c","ec341f459285443b8361f7f15638ff08",22851949,1,-6,0,811,218,213,-5
"ec341f459285443b8361f7f15638ff08","01b2051f8941460d89945e3b02d1ce78",22851949,1,5,0,812,213,217,4
"01b2051f8941460d89945e3b02d1ce78","d7f13c8d63ec4e2aa673fbb9cf9c6933",22851949,1,-14,0,813,217,206,-11
"d7f13c8d63ec4e2aa673fbb9cf9c6933","1c6721b1f63f4d30ba7746ea8af02a52",22851949,1,21,0,814,206,221,15
"1c6721b1f63f4d30ba7746ea8af02a52","77ecef8eff6b4a2caea7707669bf7475",22851949,3,1,0,815,221,222,1
"77ecef8eff6b4a2caea7707669bf7475","d03cb855c70044cf8c35d9ec0de696e3",22851949,2,3,0,816,222,224,2
"d03cb855c70044cf8c35d9ec0de696e3","1c6721b1f63f4d30ba7746ea8af02a52",22851949,2,-4,0,817,224,221,-3
"1c6721b1f63f4d30ba7746ea8af02a52","8b9ae98743bd4d4a8a87dff1c1244211",22851949,2,7,0,818,221,227,6
"8b9ae98743bd4d4a8a87dff1c1244211","d03cb855c70044cf8c35d9ec0de696e3",22851949,1,-3,0,819,227,224,-3
"d03cb855c70044cf8c35d9ec0de696e3","d03cb855c70044cf8c35d9ec0de696e3",22851949,2,0,1,820,224,224,0
"d03cb855c70044cf8c35d9ec0de696e3","a49a937d6896486d9a5396654abcf2e1",22851949,1,2,0,822,224,226,2
"a49a937d6896486d9a5396654abcf2e1","a49a937d6896486d9a5396654abcf2e1",22851949,3,0,1,823,226,226,0
"a49a937d6896486d9a5396654abcf2e1","8b9ae98743bd4d4a8a87dff1c1244211",22851949,1,1,0,826,226,227,1
"8b9ae98743bd4d4a8a87dff1c1244211","8b9ae98743bd4d4a8a87dff1c1244211",22851949,23,0,1,827,227,227,0
"8b9ae98743bd4d4a8a87dff1c1244211","f7906d6f59b9489a91d2ef40db5a474d",22851949,1,-4,0,850,227,223,-4
"f7906d6f59b9489a91d2ef40db5a474d","2ab1535aac1346ba8801535bf729ef37",22851949,1,7,0,851,223,229,6
"2ab1535aac1346ba8801535bf729ef37","2ab1535aac1346ba8801535bf729ef37",22851949,5,0,1,852,229,229,0
"2ab1535aac1346ba8801535bf729ef37","a4f40fb48a8542c8949bae1f002cd9bc",22851949,1,2,0,857,229,231,2
"a4f40fb48a8542c8949bae1f002cd9bc","a4f40fb48a8542c8949bae1f002cd9bc",22851949,2,0,1,858,231,231,0
"a4f40fb48a8542c8949bae1f002cd9bc","8972c23e32044edb8a78fa1eed4e5947",22851949,1,1,0,860,231,232,1
"8972c23e32044edb8a78fa1eed4e5947","8972c23e32044edb8a78fa1eed4e5947",22851949,3,0,1,861,232,232,0
"8972c23e32044edb8a78fa1eed4e5947","92feb4a40f8344d38b6f722e42a53295",22851949,1,1,0,864,232,233,1
"92feb4a40f8344d38b6f722e42a53295","92feb4a40f8344d38b6f722e42a53295",22851949,2,0,1,865,233,233,0
"92feb4a40f8344d38b6f722e42a53295","5152833676bf4c6cb317060be10f68db",22851949,1,-5,0,867,233,228,-5
"5152833676bf4c6cb317060be10f68db","ca3e28f290354c08aefe5b0f769604e6",22851949,1,8,0,868,228,235,7
"ca3e28f290354c08aefe5b0f769604e6","ca3e28f290354c08aefe5b0f769604e6",22851949,4,0,1,869,235,235,0
"ca3e28f290354c08aefe5b0f769604e6","79a35eea833e4c2c9d22fc53c3c6445c",22851949,1,1,0,873,235,236,1
"79a35eea833e4c2c9d22fc53c3c6445c","79a35eea833e4c2c9d22fc53c3c6445c",22851949,4,0,1,874,236,236,0
"79a35eea833e4c2c9d22fc53c3c6445c","8f68228b1518449e9615cdafee41a2bd",22851949,1,1,0,878,236,237,1
"8f68228b1518449e9615cdafee41a2bd","8f68228b1518449e9615cdafee41a2bd",22851949,1,0,1,879,237,237,0
"8f68228b1518449e9615cdafee41a2bd","cab89fa5c3ed45a5aa550fc0352d6a42",22851949,1,1,0,880,237,238,1
"cab89fa5c3ed45a5aa550fc0352d6a42","cab89fa5c3ed45a5aa550fc0352d6a42",22851949,3,0,1,881,238,238,0
"cab89fa5c3ed45a5aa550fc0352d6a42","2ab1535aac1346ba8801535bf729ef37",22851949,1,-10,0,884,238,229,-9
"2ab1535aac1346ba8801535bf729ef37","0b04c8e2f86d48c7aeb7e225819cd32b",22851949,1,6,0,885,229,234,5
"0b04c8e2f86d48c7aeb7e225819cd32b","5152833676bf4c6cb317060be10f68db",22851949,1,-7,0,886,234,228,-6
"5152833676bf4c6cb317060be10f68db","1c6721b1f63f4d30ba7746ea8af02a52",22851949,1,-9,0,887,228,221,-7
"8b9ae98743bd4d4a8a87dff1c1244211","2ab1535aac1346ba8801535bf729ef37",22851949,2,3,0,892,227,229,2
"2ab1535aac1346ba8801535bf729ef37","f7906d6f59b9489a91d2ef40db5a474d",22851949,2,-7,0,893,229,223,-6
"f7906d6f59b9489a91d2ef40db5a474d","5152833676bf4c6cb317060be10f68db",22851949,2,6,0,894,223,228,5
"5152833676bf4c6cb317060be10f68db","66d4fad4f1cf4b46be0750a99ad7a35a",22851949,1,12,0,895,228,239,11
"66d4fad4f1cf4b46be0750a99ad7a35a","66d4fad4f1cf4b46be0750a99ad7a35a",22851949,1,0,1,896,239,239,0
"66d4fad4f1cf4b46be0750a99ad7a35a","0b04c8e2f86d48c7aeb7e225819cd32b",22851949,1,-5,0,897,239,234,-5
"0b04c8e2f86d48c7aeb7e225819cd32b","1c6721b1f63f4d30ba7746ea8af02a52",22851949,1,-16,0,898,234,221,-13
"5152833676bf4c6cb317060be10f68db","0b04c8e2f86d48c7aeb7e225819cd32b",22851949,1,7,0,906,228,234,6
"0b04c8e2f86d48c7aeb7e225819cd32b","f53da5fd9bfe412da4b80d4742563b6c",22851949,1,8,0,907,234,241,7
"f53da5fd9bfe412da4b80d4742563b6c","f53da5fd9bfe412da4b80d4742563b6c",22851949,1,0,1,908,241,241,0
"f53da5fd9bfe412da4b80d4742563b6c","1c6721b1f63f4d30ba7746ea8af02a52",22851949,1,-24,0,909,241,221,-20
"1c6721b1f63f4d30ba7746ea8af02a52","2ae94c0cea4d480a9d5dca8fb1d7b542",22851949,1,27,0,910,221,242,21
"2ae94c0cea4d480a9d5dca8fb1d7b542","1ebf23f9d994469a85206e4c7b1bf5f5",22851949,2,3,0,911,242,245,3
"1ebf23f9d994469a85206e4c7b1bf5f5","2ae94c0cea4d480a9d5dca8fb1d7b542",22851949,1,-3,0,912,245,242,-3
"2ae94c0cea4d480a9d5dca8fb1d7b542","2ae94c0cea4d480a9d5dca8fb1d7b542",22851949,1,0,1,913,242,242,0
"1ebf23f9d994469a85206e4c7b1bf5f5","1ebf23f9d994469a85206e4c7b1bf5f5",22851949,10,0,1,915,245,245,0
"1ebf23f9d994469a85206e4c7b1bf5f5","85ae675b83e8422da842cfd25596af99",22851949,1,1,0,925,245,246,1
"85ae675b83e8422da842cfd25596af99","85ae675b83e8422da842cfd25596af99",22851949,1,0,1,926,246,246,0
"85ae675b83e8422da842cfd25596af99","2ae94c0cea4d480a9d5dca8fb1d7b542",22851949,1,-4,0,927,246,242,-4
"2ae94c0cea4d480a9d5dca8fb1d7b542","fa235f0f364d47e4ae1c87f47bf8e6ba",22851949,1,12,0,928,242,252,10
"fa235f0f364d47e4ae1c87f47bf8e6ba","fa235f0f364d47e4ae1c87f47bf8e6ba",22851949,4,0,1,929,252,252,0
"fa235f0f364d47e4ae1c87f47bf8e6ba","79f7845465cc4ed19d8e4f1429541be0",22851949,1,2,0,933,252,254,2
"79f7845465cc4ed19d8e4f1429541be0","79f7845465cc4ed19d8e4f1429541be0",22851949,2,0,1,934,254,254,0
"79f7845465cc4ed19d8e4f1429541be0","6e83e23f56544a19b94067c1c558d9c0",22851949,1,-8,0,936,254,247,-7
"6e83e23f56544a19b94067c1c558d9c0","00f61990949545828dd12f1303d47504",22851949,1,11,0,937,247,256,9
"00f61990949545828dd12f1303d47504","00f61990949545828dd12f1303d47504",22851949,2,0,1,938,256,256,0
"00f61990949545828dd12f1303d47504","ead7bb4b64e247d2ae632ab8a296b091",22851949,1,2,0,940,256,258,2
"ead7bb4b64e247d2ae632ab8a296b091","ead7bb4b64e247d2ae632ab8a296b091",22851949,2,0,1,941,258,258,0
"ead7bb4b64e247d2ae632ab8a296b091","41b0048dde734bb280bac6116baa8e27",22851949,1,1,0,943,258,259,1
"41b0048dde734bb280bac6116baa8e27","41b0048dde734bb280bac6116baa8e27",22851949,2,0,1,944,259,259,0
"41b0048dde734bb280bac6116baa8e27","b41c5a094a604ee0915327da5cc0beb7",22851949,1,1,0,946,259,260,1
"b41c5a094a604ee0915327da5cc0beb7","b41c5a094a604ee0915327da5cc0beb7",22851949,2,0,1,947,260,260,0
"b41c5a094a604ee0915327da5cc0beb7","d546341988904f069cfa86b21457d9d9",22851949,1,-10,0,949,260,251,-9
"d546341988904f069cfa86b21457d9d9","28c171777c52431ab6b925073bd63d46",22851949,1,15,0,950,251,264,13
"28c171777c52431ab6b925073bd63d46","28c171777c52431ab6b925073bd63d46",22851949,11,0,1,951,264,264,0
"28c171777c52431ab6b925073bd63d46","ac160db940cb49ae8579162b1d52bb5d",22851949,1,2,0,962,264,266,2
"ac160db940cb49ae8579162b1d52bb5d","ac160db940cb49ae8579162b1d52bb5d",22851949,3,0,1,963,266,266,0
"ac160db940cb49ae8579162b1d52bb5d","d989ebcfc12a4b669f0100dc1aa14f1e",22851949,1,-12,0,966,266,255,-11
"d989ebcfc12a4b669f0100dc1aa14f1e","c6fd49b485cc4874b0bbdd9c6171e09c",22851949,1,15,0,967,255,268,13
"c6fd49b485cc4874b0bbdd9c6171e09c","c6fd49b485cc4874b0bbdd9c6171e09c",22851949,3,0,1,968,268,268,0
"c6fd49b485cc4874b0bbdd9c6171e09c","44240778a97c4af0937817499b75707b",22851949,1,1,0,971,268,269,1
"44240778a97c4af0937817499b75707b","44240778a97c4af0937817499b75707b",22851949,2,0,1,972,269,269,0
"44240778a97c4af0937817499b75707b","7aa76d3e993840d8805f097cbdbcd44b",22851949,1,-9,0,974,269,261,-8
"7aa76d3e993840d8805f097cbdbcd44b","0d987bed3ffa4ed0b9a2e62e97b7b30f",22851949,1,15,0,975,261,272,11
"0d987bed3ffa4ed0b9a2e62e97b7b30f","2ae94c0cea4d480a9d5dca8fb1d7b542",22851949,3,-38,0,976,272,242,-30
"2ae94c0cea4d480a9d5dca8fb1d7b542","0d987bed3ffa4ed0b9a2e62e97b7b30f",22851949,2,38,0,977,242,272,30
"2ae94c0cea4d480a9d5dca8fb1d7b542","865a4d3b43374da7944dc7d397f566d9",22851949,1,35,0,979,242,271,29
"865a4d3b43374da7944dc7d397f566d9","865a4d3b43374da7944dc7d397f566d9",22851949,1,0,1,980,271,271,0
"865a4d3b43374da7944dc7d397f566d9","0d987bed3ffa4ed0b9a2e62e97b7b30f",22851949,1,3,0,981,271,272,1
"0d987bed3ffa4ed0b9a2e62e97b7b30f","82ae07bc0c9b4570a41799290d1ef399",22851949,1,4,0,984,272,275,3
"82ae07bc0c9b4570a41799290d1ef399","0d987bed3ffa4ed0b9a2e62e97b7b30f",22851949,1,-4,0,985,275,272,-3
"bb5a47f5ea01454a8b79455422d3b9da","bb5a47f5ea01454a8b79455422d3b9da",22851949,74,0,1,1000,280,280,0
"bb5a47f5ea01454a8b79455422d3b9da","0d987bed3ffa4ed0b9a2e62e97b7b30f",22851949,3,-10,0,1023,280,272,-8
"0d987bed3ffa4ed0b9a2e62e97b7b30f","0d987bed3ffa4ed0b9a2e62e97b7b30f",22851949,3,0,1,1024,272,272,0
"0d987bed3ffa4ed0b9a2e62e97b7b30f","bb5a47f5ea01454a8b79455422d3b9da",22851949,3,10,0,1025,272,280,8
"0d987bed3ffa4ed0b9a2e62e97b7b30f","94cecc3f1e7d484b8e068e79241dfd73",22851949,1,13,0,1069,272,281,9
"94cecc3f1e7d484b8e068e79241dfd73","a37477c4e4c14169ad44b06b493007f6",22851949,1,2,0,1070,281,283,2
"a37477c4e4c14169ad44b06b493007f6","94cecc3f1e7d484b8e068e79241dfd73",22851949,1,-2,0,1071,283,281,-2
"94cecc3f1e7d484b8e068e79241dfd73","fab84b4fab5940efb4ea868ef8d09396",22851949,1,5,0,1072,281,284,3
"fab84b4fab5940efb4ea868ef8d09396","fab84b4fab5940efb4ea868ef8d09396",22851949,3,0,1,1073,284,284,0
"fab84b4fab5940efb4ea868ef8d09396","4a29443515bb404cb8924e1c60a63b73",22851949,3,4,0,1074,284,285,1
"4a29443515bb404cb8924e1c60a63b73","208c9b2796c944db8dacaa96082520ea",22851949,4,3,0,1075,285,288,3
"208c9b2796c944db8dacaa96082520ea","fab84b4fab5940efb4ea868ef8d09396",22851949,1,-7,0,1076,288,284,-4
"208c9b2796c944db8dacaa96082520ea","208c9b2796c944db8dacaa96082520ea",22851949,2,0,1,1080,288,288,0
"208c9b2796c944db8dacaa96082520ea","4a29443515bb404cb8924e1c60a63b73",22851949,2,-3,0,1082,288,285,-3
"4a29443515bb404cb8924e1c60a63b73","7669a956527947d0add87455277e80b4",22851949,1,7,0,1083,285,291,6
"7669a956527947d0add87455277e80b4","7669a956527947d0add87455277e80b4",22851949,1,0,1,1084,291,291,0
"7669a956527947d0add87455277e80b4","6a9a3b5bde4a48daa896fe8c06eca56f",22851949,1,-2,0,1085,291,289,-2
"6a9a3b5bde4a48daa896fe8c06eca56f","869e967078f04da18dd0b0b9389a7424",22851949,2,5,0,1086,289,293,4
"869e967078f04da18dd0b0b9389a7424","869e967078f04da18dd0b0b9389a7424",22851949,3,0,1,1087,293,293,0
"869e967078f04da18dd0b0b9389a7424","51ab6291537748fab90d519aa09889d6",22851949,1,2,0,1090,293,295,2
"51ab6291537748fab90d519aa09889d6","51ab6291537748fab90d519aa09889d6",22851949,5,0,1,1091,295,295,0
"51ab6291537748fab90d519aa09889d6","34a6e49023fc4465bd5ca604330bbd1c",22851949,1,-3,0,1096,295,292,-3
"34a6e49023fc4465bd5ca604330bbd1c","ba0e59461bfb4a44b7b1c28a01f8d3b3",22851949,3,9,0,1097,292,299,7
"ba0e59461bfb4a44b7b1c28a01f8d3b3","21592f2a9e9c4b2f8c66ec5dbcbf6a2b",22851949,2,-4,0,1098,299,296,-3
"21592f2a9e9c4b2f8c66ec5dbcbf6a2b","ba0e59461bfb4a44b7b1c28a01f8d3b3",22851949,1,4,0,1099,296,299,3
"ba0e59461bfb4a44b7b1c28a01f8d3b3","ba0e59461bfb4a44b7b1c28a01f8d3b3",22851949,1,0,1,1100,299,299,0
"ba0e59461bfb4a44b7b1c28a01f8d3b3","0e0b36e731a645e7b1b8a88f5031ca38",22851949,1,2,0,1101,299,301,2
"0e0b36e731a645e7b1b8a88f5031ca38","0e0b36e731a645e7b1b8a88f5031ca38",22851949,2,0,1,1102,301,301,0
"0e0b36e731a645e7b1b8a88f5031ca38","a66a144637284c21afc6de17fea4bfb8",22851949,1,1,0,1104,301,302,1
"a66a144637284c21afc6de17fea4bfb8","a66a144637284c21afc6de17fea4bfb8",22851949,2,0,1,1105,302,302,0
"a66a144637284c21afc6de17fea4bfb8","7646a919d7e64fa990bca9b024ff089d",22851949,1,-4,0,1107,302,298,-4
"7646a919d7e64fa990bca9b024ff089d","4a29443515bb404cb8924e1c60a63b73",22851949,2,-17,0,1108,298,285,-13
"208c9b2796c944db8dacaa96082520ea","869e967078f04da18dd0b0b9389a7424",22851949,1,7,0,1110,288,293,5
"869e967078f04da18dd0b0b9389a7424","4a29443515bb404cb8924e1c60a63b73",22851949,1,-10,0,1111,293,285,-8
"4a29443515bb404cb8924e1c60a63b73","34a6e49023fc4465bd5ca604330bbd1c",22851949,1,9,0,1112,285,292,7
"ba0e59461bfb4a44b7b1c28a01f8d3b3","7646a919d7e64fa990bca9b024ff089d",22851949,1,-1,0,1114,299,298,-1
"7646a919d7e64fa990bca9b024ff089d","e390b575229748ea8aac9364efe2bf00",22851949,1,7,0,1115,298,304,6
"e390b575229748ea8aac9364efe2bf00","e390b575229748ea8aac9364efe2bf00",22851949,1,0,1,1116,304,304,0
"e390b575229748ea8aac9364efe2bf00","4a29443515bb404cb8924e1c60a63b73",22851949,1,-24,0,1117,304,285,-19
"4a29443515bb404cb8924e1c60a63b73","3434c10e561d488a914e0f7d71907abd",22851949,2,27,0,1118,285,305,20
"3434c10e561d488a914e0f7d71907abd","53e7e900392747ccad52e711ab0f80d8",22851949,3,2,0,1119,305,307,2
"53e7e900392747ccad52e711ab0f80d8","53e7e900392747ccad52e711ab0f80d8",22851949,7,0,1,1120,307,307,0
"53e7e900392747ccad52e711ab0f80d8","130acc2aeb0448fdbb2de63bc5cebe5b",22851949,2,3,0,1127,307,309,2
"130acc2aeb0448fdbb2de63bc5cebe5b","3434c10e561d488a914e0f7d71907abd",22851949,2,-5,0,1128,309,305,-4
"3434c10e561d488a914e0f7d71907abd","130acc2aeb0448fdbb2de63bc5cebe5b",22851949,2,5,0,1129,305,309,4
"130acc2aeb0448fdbb2de63bc5cebe5b","130acc2aeb0448fdbb2de63bc5cebe5b",22851949,3,0,1,1130,309,309,0
"130acc2aeb0448fdbb2de63bc5cebe5b","9c062b3251034ebe90f5054e2a3b5120",22851949,1,2,0,1133,309,311,2
"9c062b3251034ebe90f5054e2a3b5120","9c062b3251034ebe90f5054e2a3b5120",22851949,2,0,1,1134,311,311,0
"9c062b3251034ebe90f5054e2a3b5120","ea859f8207e44537889daeaba13ac2e8",22851949,1,1,0,1136,311,312,1
"ea859f8207e44537889daeaba13ac2e8","ea859f8207e44537889daeaba13ac2e8",22851949,1,0,1,1137,312,312,0
"ea859f8207e44537889daeaba13ac2e8","56d94971a7a94257aa330183a8ebd0ea",22851949,1,1,0,1138,312,313,1
"56d94971a7a94257aa330183a8ebd0ea","56d94971a7a94257aa330183a8ebd0ea",22851949,1,0,1,1139,313,313,0
"56d94971a7a94257aa330183a8ebd0ea","141c0df6cd1946539aadd1c9b7068cd4",22851949,1,-5,0,1140,313,308,-5
"141c0df6cd1946539aadd1c9b7068cd4","13255e63e0aa4abf85e5211bf613d43e",22851949,1,10,0,1141,308,317,9
"13255e63e0aa4abf85e5211bf613d43e","13255e63e0aa4abf85e5211bf613d43e",22851949,1,0,1,1142,317,317,0
"13255e63e0aa4abf85e5211bf613d43e","0c787d16c9504873b1a4d903cec09948",22851949,1,-3,0,1143,317,314,-3
"0c787d16c9504873b1a4d903cec09948","86c27d40179e419c8e9d150fb6afa5d0",22851949,2,6,0,1144,314,319,5
"86c27d40179e419c8e9d150fb6afa5d0","86c27d40179e419c8e9d150fb6afa5d0",22851949,2,0,1,1145,319,319,0
"86c27d40179e419c8e9d150fb6afa5d0","8d7e0b55cf9849cda222a0f2440cec55",22851949,2,-1,0,1147,319,318,-1
"8d7e0b55cf9849cda222a0f2440cec55","47edbb64109243e6b0f8f64cdef90c6c",22851949,1,9,0,1148,318,326,8
"47edbb64109243e6b0f8f64cdef90c6c","24f1363179ad4aaa965484a78471912b",22851949,1,-3,0,1149,326,323,-3
"24f1363179ad4aaa965484a78471912b","24f1363179ad4aaa965484a78471912b",22851949,2,0,1,1150,323,323,0
"24f1363179ad4aaa965484a78471912b","3628bdce1dd2429ba924d2d4d09448d2",22851949,2,-1,0,1152,323,322,-1
"3628bdce1dd2429ba924d2d4d09448d2","3434c10e561d488a914e0f7d71907abd",22851949,1,-21,0,1153,322,305,-17
"53e7e900392747ccad52e711ab0f80d8","3434c10e561d488a914e0f7d71907abd",22851949,1,-2,0,1155,307,305,-2
"130acc2aeb0448fdbb2de63bc5cebe5b","141c0df6cd1946539aadd1c9b7068cd4",22851949,1,-1,0,1157,309,308,-1
"141c0df6cd1946539aadd1c9b7068cd4","86c27d40179e419c8e9d150fb6afa5d0",22851949,1,13,0,1158,308,319,11
"86c27d40179e419c8e9d150fb6afa5d0","0c787d16c9504873b1a4d903cec09948",22851949,1,-6,0,1159,319,314,-5
"0c787d16c9504873b1a4d903cec09948","47edbb64109243e6b0f8f64cdef90c6c",22851949,1,14,0,1160,314,326,12
"47edbb64109243e6b0f8f64cdef90c6c","8d7e0b55cf9849cda222a0f2440cec55",22851949,1,-9,0,1161,326,318,-8
"8d7e0b55cf9849cda222a0f2440cec55","24f1363179ad4aaa965484a78471912b",22851949,1,6,0,1162,318,323,5
"3628bdce1dd2429ba924d2d4d09448d2","56b3fd1a212a4764be39d979fde3326e",22851949,1,7,0,1164,322,328,6
"56b3fd1a212a4764be39d979fde3326e","56b3fd1a212a4764be39d979fde3326e",22851949,1,0,1,1165,328,328,0
"56b3fd1a212a4764be39d979fde3326e","3434c10e561d488a914e0f7d71907abd",22851949,1,-28,0,1166,328,305,-23
"3434c10e561d488a914e0f7d71907abd","0c4079457ede49e3aeb5e86ed84bdf35",22851949,2,31,0,1167,305,329,24
"0c4079457ede49e3aeb5e86ed84bdf35","38aea304b4fa46e1b29bb72f5cea4c93",22851949,3,2,0,1168,329,331,2
"38aea304b4fa46e1b29bb72f5cea4c93","fab84b4fab5940efb4ea868ef8d09396",22851949,1,-64,0,1169,331,284,-47
"4a29443515bb404cb8924e1c60a63b73","6a9a3b5bde4a48daa896fe8c06eca56f",22851949,1,5,0,1174,285,289,4
"869e967078f04da18dd0b0b9389a7424","34a6e49023fc4465bd5ca604330bbd1c",22851949,1,-1,0,1176,293,292,-1
"21592f2a9e9c4b2f8c66ec5dbcbf6a2b","7646a919d7e64fa990bca9b024ff089d",22851949,1,3,0,1179,296,298,2
"3434c10e561d488a914e0f7d71907abd","141c0df6cd1946539aadd1c9b7068cd4",22851949,1,4,0,1185,305,308,3
"141c0df6cd1946539aadd1c9b7068cd4","0c787d16c9504873b1a4d903cec09948",22851949,1,7,0,1186,308,314,6
"8d7e0b55cf9849cda222a0f2440cec55","3628bdce1dd2429ba924d2d4d09448d2",22851949,1,5,0,1189,318,322,4
"3628bdce1dd2429ba924d2d4d09448d2","24f1363179ad4aaa965484a78471912b",22851949,1,1,0,1190,322,323,1
"24f1363179ad4aaa965484a78471912b","47edbb64109243e6b0f8f64cdef90c6c",22851949,1,3,0,1191,323,326,3
"47edbb64109243e6b0f8f64cdef90c6c","3434c10e561d488a914e0f7d71907abd",22851949,1,-25,0,1192,326,305,-21
"38aea304b4fa46e1b29bb72f5cea4c93","38aea304b4fa46e1b29bb72f5cea4c93",22851949,4,0,1,1195,331,331,0
"38aea304b4fa46e1b29bb72f5cea4c93","e36d261332f14e79bb4b467aceaeb9b5",22851949,1,2,0,1199,331,333,2
"e36d261332f14e79bb4b467aceaeb9b5","e36d261332f14e79bb4b467aceaeb9b5",22851949,1,0,1,1200,333,333,0
"e36d261332f14e79bb4b467aceaeb9b5","c7e89b9d04744d2eab742fc24e3ef1ae",22851949,1,1,0,1201,333,334,1
"c7e89b9d04744d2eab742fc24e3ef1ae","c7e89b9d04744d2eab742fc24e3ef1ae",22851949,8,0,1,1202,334,334,0
"c7e89b9d04744d2eab742fc24e3ef1ae","fe49f8054b374a0ea4bb266ed135ff62",22851949,1,1,0,1210,334,335,1
"fe49f8054b374a0ea4bb266ed135ff62","fe49f8054b374a0ea4bb266ed135ff62",22851949,5,0,1,1211,335,335,0
"fe49f8054b374a0ea4bb266ed135ff62","d0a8f74af98642fe8360d22c42e45117",22851949,1,1,0,1216,335,336,1
"d0a8f74af98642fe8360d22c42e45117","d0a8f74af98642fe8360d22c42e45117",22851949,2,0,1,1217,336,336,0
"d0a8f74af98642fe8360d22c42e45117","0c4079457ede49e3aeb5e86ed84bdf35",22851949,1,-7,0,1219,336,329,-7
"0c4079457ede49e3aeb5e86ed84bdf35","a7c6339ca1da4368a18d471f0519f877",22851949,1,11,0,1220,329,339,10
"a7c6339ca1da4368a18d471f0519f877","a7c6339ca1da4368a18d471f0519f877",22851949,1,0,1,1221,339,339,0
"a7c6339ca1da4368a18d471f0519f877","b8b9418ab322418d9db9b40d96af873a",22851949,1,-2,0,1222,339,337,-2
"b8b9418ab322418d9db9b40d96af873a","bbc5139ca9024389a94db3a6f47dcff6",22851949,2,5,0,1223,337,341,4
"bbc5139ca9024389a94db3a6f47dcff6","bbc5139ca9024389a94db3a6f47dcff6",22851949,4,0,1,1224,341,341,0
"bbc5139ca9024389a94db3a6f47dcff6","4ee6ca9019ab4a1ab323f98094a9bd77",22851949,1,2,0,1228,341,343,2
"4ee6ca9019ab4a1ab323f98094a9bd77","4ee6ca9019ab4a1ab323f98094a9bd77",22851949,2,0,1,1229,343,343,0
"4ee6ca9019ab4a1ab323f98094a9bd77","b37947176785476f8b29d49a851366dc",22851949,1,1,0,1231,343,344,1
"b37947176785476f8b29d49a851366dc","b37947176785476f8b29d49a851366dc",22851949,2,0,1,1232,344,344,0
"b37947176785476f8b29d49a851366dc","fcea5b10d5a14a3b9324ffece8f6e1e5",22851949,1,1,0,1234,344,345,1
"fcea5b10d5a14a3b9324ffece8f6e1e5","fcea5b10d5a14a3b9324ffece8f6e1e5",22851949,5,0,1,1235,345,345,0
"fcea5b10d5a14a3b9324ffece8f6e1e5","c2490bc612d146edbe786556fab3651b",22851949,1,-5,0,1240,345,340,-5
"c2490bc612d146edbe786556fab3651b","0c4079457ede49e3aeb5e86ed84bdf35",22851949,1,-13,0,1241,340,329,-11
"38aea304b4fa46e1b29bb72f5cea4c93","0c4079457ede49e3aeb5e86ed84bdf35",22851949,1,-2,0,1243,331,329,-2
"0c4079457ede49e3aeb5e86ed84bdf35","b8b9418ab322418d9db9b40d96af873a",22851949,1,9,0,1244,329,337,8
"bbc5139ca9024389a94db3a6f47dcff6","c2490bc612d146edbe786556fab3651b",22851949,1,-1,0,1246,341,340,-1
"c2490bc612d146edbe786556fab3651b","6ac8bb048b854999a47edb35fe627f11",22851949,1,8,0,1247,340,347,7
"6ac8bb048b854999a47edb35fe627f11","6ac8bb048b854999a47edb35fe627f11",22851949,1,0,1,1248,347,347,0
"6ac8bb048b854999a47edb35fe627f11","30ead9794d4847abaf222ca966cc8630",22851949,1,3,0,1249,347,348,1
"30ead9794d4847abaf222ca966cc8630","0c4079457ede49e3aeb5e86ed84bdf35",22851949,1,-24,0,1250,348,329,-19
"0c4079457ede49e3aeb5e86ed84bdf35","897b7f51242c44aab2205c72fdcbf4cd",22851949,1,28,0,1251,329,352,23
"897b7f51242c44aab2205c72fdcbf4cd","c20993c944444fe085345591a8bd837e",22851949,1,-1,0,1252,352,351,-1
"c20993c944444fe085345591a8bd837e","09b9678ddc3d452ea4a3d46e15826065",22851949,1,2,0,1253,351,353,2
"09b9678ddc3d452ea4a3d46e15826065","eff0de7f2dbb42dfa1a2e686efab5b6d",22851949,2,1,0,1254,353,354,1
"eff0de7f2dbb42dfa1a2e686efab5b6d","c20993c944444fe085345591a8bd837e",22851949,1,-3,0,1255,354,351,-3
"c20993c944444fe085345591a8bd837e","c20993c944444fe085345591a8bd837e",22851949,3,0,1,1256,351,351,0
"c20993c944444fe085345591a8bd837e","897b7f51242c44aab2205c72fdcbf4cd",22851949,1,1,0,1259,351,352,1
"897b7f51242c44aab2205c72fdcbf4cd","897b7f51242c44aab2205c72fdcbf4cd",22851949,3,0,1,1260,352,352,0
"897b7f51242c44aab2205c72fdcbf4cd","09b9678ddc3d452ea4a3d46e15826065",22851949,1,1,0,1263,352,353,1
"09b9678ddc3d452ea4a3d46e15826065","09b9678ddc3d452ea4a3d46e15826065",22851949,3,0,1,1264,353,353,0
"eff0de7f2dbb42dfa1a2e686efab5b6d","eff0de7f2dbb42dfa1a2e686efab5b6d",22851949,3,0,1,1268,354,354,0
"eff0de7f2dbb42dfa1a2e686efab5b6d","30ead9794d4847abaf222ca966cc8630",22851949,1,-6,0,1271,354,348,-6
"30ead9794d4847abaf222ca966cc8630","2fe14166dc9642c3bc666b86a57f943d",22851949,1,10,0,1272,348,357,9
"2fe14166dc9642c3bc666b86a57f943d","2fe14166dc9642c3bc666b86a57f943d",22851949,5,0,1,1273,357,357,0
"2fe14166dc9642c3bc666b86a57f943d","44421dd1e13a47a388c4a19834b744c7",22851949,1,2,0,1278,357,359,2
"44421dd1e13a47a388c4a19834b744c7","44421dd1e13a47a388c4a19834b744c7",22851949,2,0,1,1279,359,359,0
"44421dd1e13a47a388c4a19834b744c7","cb5fc7ef85d547c4be1a7439d0bf6052",22851949,1,1,0,1281,359,360,1
"cb5fc7ef85d547c4be1a7439d0bf6052","cb5fc7ef85d547c4be1a7439d0bf6052",22851949,2,0,1,1282,360,360,0
"cb5fc7ef85d547c4be1a7439d0bf6052","0a8f150a4cf747acbde62f4721823da3",22851949,1,1,0,1284,360,361,1
"0a8f150a4cf747acbde62f4721823da3","0a8f150a4cf747acbde62f4721823da3",22851949,5,0,1,1285,361,361,0
"0a8f150a4cf747acbde62f4721823da3","ab8fdad974ae471f9f24c3f9dd04462e",22851949,1,1,0,1290,361,362,1
"ab8fdad974ae471f9f24c3f9dd04462e","ab8fdad974ae471f9f24c3f9dd04462e",22851949,2,0,1,1291,362,362,0
"ab8fdad974ae471f9f24c3f9dd04462e","52580888dadb4fe3baa795683ea227bd",22851949,1,3,0,1293,362,364,2
"52580888dadb4fe3baa795683ea227bd","1ba8fef685d74a8194b9db252eb704fb",22851949,1,-10,0,1294,364,355,-9
"1ba8fef685d74a8194b9db252eb704fb","52580888dadb4fe3baa795683ea227bd",22851949,1,10,0,1295,355,364,9
"52580888dadb4fe3baa795683ea227bd","52580888dadb4fe3baa795683ea227bd",22851949,1,0,1,1296,364,364,0
"52580888dadb4fe3baa795683ea227bd","f00179e251a045b39c3f7a54f9aa4acc",22851949,1,-1,0,1297,364,363,-1
"f00179e251a045b39c3f7a54f9aa4acc","492a3bc6a1254f23a7998587961b22a4",22851949,1,4,0,1298,363,366,3
"492a3bc6a1254f23a7998587961b22a4","492a3bc6a1254f23a7998587961b22a4",22851949,2,0,1,1299,366,366,0
"492a3bc6a1254f23a7998587961b22a4","072a190fd302456290895f9f04d6940a",22851949,1,-1,0,1301,366,365,-1
"072a190fd302456290895f9f04d6940a","cfa457d1743848e4bb5e4beced6448ed",22851949,1,5,0,1302,365,369,4
"cfa457d1743848e4bb5e4beced6448ed","cfa457d1743848e4bb5e4beced6448ed",22851949,1,0,1,1303,369,369,0
"cfa457d1743848e4bb5e4beced6448ed","30ead9794d4847abaf222ca966cc8630",22851949,1,-25,0,1304,369,348,-21
"30ead9794d4847abaf222ca966cc8630","b71bac264efb4abd97015447bd490db6",22851949,1,28,0,1305,348,370,22
"b71bac264efb4abd97015447bd490db6","8d448d625b024c82a5eb240bbd7431d6",22851949,3,5,0,1306,370,374,4
"8d448d625b024c82a5eb240bbd7431d6","8d448d625b024c82a5eb240bbd7431d6",22851949,58,0,1,1307,374,374,0
"8d448d625b024c82a5eb240bbd7431d6","b71bac264efb4abd97015447bd490db6",22851949,2,-5,0,1311,374,370,-4
"8d448d625b024c82a5eb240bbd7431d6","4a29443515bb404cb8924e1c60a63b73",22851949,1,-115,0,1360,374,285,-89
"4a29443515bb404cb8924e1c60a63b73","d6d02b6ef04e4f17805504500b8ce441",22851949,1,118,0,1361,285,375,90
"d6d02b6ef04e4f17805504500b8ce441","d6d02b6ef04e4f17805504500b8ce441",22851949,7,0,1,1362,375,375,0
"d6d02b6ef04e4f17805504500b8ce441","b71bac264efb4abd97015447bd490db6",22851949,1,-8,0,1364,375,370,-5
"b71bac264efb4abd97015447bd490db6","d6d02b6ef04e4f17805504500b8ce441",22851949,1,8,0,1374,370,375,5
"d6d02b6ef04e4f17805504500b8ce441","66baf19b6b904b70922329068c63746d",22851949,1,4,0,1380,375,376,1
"66baf19b6b904b70922329068c63746d","66baf19b6b904b70922329068c63746d",22851949,2,0,1,1381,376,376,0
"66baf19b6b904b70922329068c63746d","7f544639412e40a9ba27f43b415362ab",22851949,5,2,0,1382,376,378,2
"7f544639412e40a9ba27f43b415362ab","7f544639412e40a9ba27f43b415362ab",22851949,6,0,1,1383,378,378,0
"7f544639412e40a9ba27f43b415362ab","d5ae8642e15b46b8bd298b02274d4e9c",22851949,1,2,0,1388,378,380,2
"d5ae8642e15b46b8bd298b02274d4e9c","d5ae8642e15b46b8bd298b02274d4e9c",22851949,1,0,1,1389,380,380,0
"d5ae8642e15b46b8bd298b02274d4e9c","a0d10309a2dd456289147f84be9d37f9",22851949,1,1,0,1390,380,381,1
"a0d10309a2dd456289147f84be9d37f9","a0d10309a2dd456289147f84be9d37f9",22851949,2,0,1,1391,381,381,0
"a0d10309a2dd456289147f84be9d37f9","0fcbc3ca07b144138b8d85da581f09a8",22851949,1,1,0,1393,381,382,1
"0fcbc3ca07b144138b8d85da581f09a8","0fcbc3ca07b144138b8d85da581f09a8",22851949,2,0,1,1394,382,382,0
"0fcbc3ca07b144138b8d85da581f09a8","66baf19b6b904b70922329068c63746d",22851949,1,-6,0,1396,382,376,-6
"66baf19b6b904b70922329068c63746d","c2fca3669923477ab966ded303dea31c",22851949,4,8,0,1397,376,383,7
"c2fca3669923477ab966ded303dea31c","4890121ce5d74576b4632b77cfc23398",22851949,5,6,0,1398,383,388,5
"4890121ce5d74576b4632b77cfc23398","4890121ce5d74576b4632b77cfc23398",22851949,5,0,1,1399,388,388,0
"4890121ce5d74576b4632b77cfc23398","66baf19b6b904b70922329068c63746d",22851949,1,-14,0,1400,388,376,-12
"7f544639412e40a9ba27f43b415362ab","66baf19b6b904b70922329068c63746d",22851949,5,-2,0,1402,378,376,-2
"66baf19b6b904b70922329068c63746d","4890121ce5d74576b4632b77cfc23398",22851949,2,14,0,1403,376,388,12
"4890121ce5d74576b4632b77cfc23398","c2fca3669923477ab966ded303dea31c",22851949,2,-6,0,1404,388,383,-5
"4890121ce5d74576b4632b77cfc23398","18d3b836dd804224883cc9180b60a8e1",22851949,4,-1,0,1409,388,387,-1
"18d3b836dd804224883cc9180b60a8e1","96bb2b3e85a34d8b9544514e89f6fe97",22851949,4,4,0,1410,387,390,3
"96bb2b3e85a34d8b9544514e89f6fe97","96bb2b3e85a34d8b9544514e89f6fe97",22851949,3,0,1,1411,390,390,0
"96bb2b3e85a34d8b9544514e89f6fe97","ac4e9b54acfe4670b4634859c7263cb5",22851949,2,2,0,1412,390,392,2
"ac4e9b54acfe4670b4634859c7263cb5","ac4e9b54acfe4670b4634859c7263cb5",22851949,2,0,1,1413,392,392,0
"ac4e9b54acfe4670b4634859c7263cb5","66baf19b6b904b70922329068c63746d",22851949,1,-19,0,1414,392,376,-16
"96bb2b3e85a34d8b9544514e89f6fe97","66baf19b6b904b70922329068c63746d",22851949,1,-17,0,1422,390,376,-14
"ac4e9b54acfe4670b4634859c7263cb5","6f8881a745ac4c358a68b92c3b4abe81",22851949,1,3,0,1431,392,394,2
"6f8881a745ac4c358a68b92c3b4abe81","17f95d18bab743888e1736033dc3384d",22851949,1,-6,0,1432,394,389,-5
"17f95d18bab743888e1736033dc3384d","6f8881a745ac4c358a68b92c3b4abe81",22851949,3,6,0,1433,389,394,5
"6f8881a745ac4c358a68b92c3b4abe81","6f8881a745ac4c358a68b92c3b4abe81",22851949,3,0,1,1434,394,394,0
"6f8881a745ac4c358a68b92c3b4abe81","f7002c8484354eceac57bc7bd62c76c1",22851949,4,-1,0,1436,394,393,-1
"f7002c8484354eceac57bc7bd62c76c1","96bb2b3e85a34d8b9544514e89f6fe97",22851949,1,-4,0,1437,393,390,-3
"96bb2b3e85a34d8b9544514e89f6fe97","17f95d18bab743888e1736033dc3384d",22851949,2,-1,0,1439,390,389,-1
"f7002c8484354eceac57bc7bd62c76c1","66baf19b6b904b70922329068c63746d",22851949,1,-21,0,1442,393,376,-17
"c2fca3669923477ab966ded303dea31c","18d3b836dd804224883cc9180b60a8e1",22851949,1,5,0,1447,383,387,4
"18d3b836dd804224883cc9180b60a8e1","17f95d18bab743888e1736033dc3384d",22851949,1,3,0,1448,387,389,2
"17f95d18bab743888e1736033dc3384d","96bb2b3e85a34d8b9544514e89f6fe97",22851949,1,1,0,1449,389,390,1
"96bb2b3e85a34d8b9544514e89f6fe97","6f8881a745ac4c358a68b92c3b4abe81",22851949,1,5,0,1450,390,394,4
"f7002c8484354eceac57bc7bd62c76c1","0c12af0a4e7f4002852cf84b2537c161",22851949,1,3,0,1452,393,395,2
"0c12af0a4e7f4002852cf84b2537c161","2b09a08242b54983aec7063990fb3f66",22851949,1,8,0,1453,395,400,5
"2b09a08242b54983aec7063990fb3f66","66baf19b6b904b70922329068c63746d",22851949,3,-32,0,1454,400,376,-24
"66baf19b6b904b70922329068c63746d","2b09a08242b54983aec7063990fb3f66",22851949,4,32,0,1455,376,400,24
"2b09a08242b54983aec7063990fb3f66","2b09a08242b54983aec7063990fb3f66",22851949,8,0,1,1456,400,400,0
"66baf19b6b904b70922329068c63746d","859e0b8d71694b12befb69ee698138f9",22851949,1,29,0,1458,376,399,23
"859e0b8d71694b12befb69ee698138f9","859e0b8d71694b12befb69ee698138f9",22851949,1,0,1,1459,399,399,0
"859e0b8d71694b12befb69ee698138f9","66baf19b6b904b70922329068c63746d",22851949,1,-29,0,1460,399,376,-23
"2b09a08242b54983aec7063990fb3f66","1f471b7a883a4df48211e8c6a81b59a7",22851949,1,1,0,1464,400,401,1
"1f471b7a883a4df48211e8c6a81b59a7","1f471b7a883a4df48211e8c6a81b59a7",22851949,1,0,1,1465,401,401,0
"1f471b7a883a4df48211e8c6a81b59a7","2b09a08242b54983aec7063990fb3f66",22851949,1,-1,0,1466,401,400,-1
"2b09a08242b54983aec7063990fb3f66","9de0d567bfa84fe5b77cb76f4a76a5d1",22851949,1,5,0,1467,400,404,4
"9de0d567bfa84fe5b77cb76f4a76a5d1","9de0d567bfa84fe5b77cb76f4a76a5d1",22851949,1,0,1,1468,404,404,0
"9de0d567bfa84fe5b77cb76f4a76a5d1","1157bd665ec4472fb58b751dc5099355",22851949,1,-1,0,1469,404,403,-1
"1157bd665ec4472fb58b751dc5099355","83d42d95cd844fc093fc09cee250edb8",22851949,1,99,0,1470,403,465,62
"83d42d95cd844fc093fc09cee250edb8","83d42d95cd844fc093fc09cee250edb8",22851949,6,0,1,1471,465,465,0
"83d42d95cd844fc093fc09cee250edb8","c5df9f40ec14463b9dcfdc73df3e9285",22851949,1,-3,0,1473,465,464,-1
"c5df9f40ec14463b9dcfdc73df3e9285","c5df9f40ec14463b9dcfdc73df3e9285",22851949,3,0,1,1474,464,464,0
"c5df9f40ec14463b9dcfdc73df3e9285","f67fbf45a5f146ed866965bc57c7c001",22851949,2,-12,0,1476,464,454,-10
"f67fbf45a5f146ed866965bc57c7c001","58fc9094275e4c49be3f4ba6d4acc0a4",22851949,1,-79,0,1477,454,406,-48
"58fc9094275e4c49be3f4ba6d4acc0a4","2b09a08242b54983aec7063990fb3f66",22851949,3,-9,0,1478,406,400,-6
"2b09a08242b54983aec7063990fb3f66","58fc9094275e4c49be3f4ba6d4acc0a4",22851949,2,9,0,1479,400,406,6
"58fc9094275e4c49be3f4ba6d4acc0a4","58fc9094275e4c49be3f4ba6d4acc0a4",22851949,4,0,1,1480,406,406,0
"58fc9094275e4c49be3f4ba6d4acc0a4","c1c1be90b2b14c1ab4a5e1ee3c241902",22851949,1,1,0,1483,406,407,1
"c1c1be90b2b14c1ab4a5e1ee3c241902","c1c1be90b2b14c1ab4a5e1ee3c241902",22851949,5,0,1,1484,407,407,0
"c1c1be90b2b14c1ab4a5e1ee3c241902","58fc9094275e4c49be3f4ba6d4acc0a4",22851949,1,-1,0,1489,407,406,-1
"58fc9094275e4c49be3f4ba6d4acc0a4","02b3a1bead9244c1ba2f857c7da8f82a",22851949,2,3,0,1490,406,408,2
"02b3a1bead9244c1ba2f857c7da8f82a","02b3a1bead9244c1ba2f857c7da8f82a",22851949,3,0,1,1491,408,408,0
"02b3a1bead9244c1ba2f857c7da8f82a","58fc9094275e4c49be3f4ba6d4acc0a4",22851949,1,-3,0,1492,408,406,-2
"58fc9094275e4c49be3f4ba6d4acc0a4","1157bd665ec4472fb58b751dc5099355",22851949,1,-5,0,1493,406,403,-3
"1157bd665ec4472fb58b751dc5099355","58fc9094275e4c49be3f4ba6d4acc0a4",22851949,2,5,0,1494,403,406,3
"2b09a08242b54983aec7063990fb3f66","df8191ec5e584c838a899c378941a566",22851949,1,-4,0,1500,400,398,-2
"df8191ec5e584c838a899c378941a566","7f544639412e40a9ba27f43b415362ab",22851949,1,-26,0,1501,398,378,-20
"f7002c8484354eceac57bc7bd62c76c1","44a277ea44dc4ae689fab4b82f0b4098",22851949,1,5,0,1514,393,397,4
"44a277ea44dc4ae689fab4b82f0b4098","44a277ea44dc4ae689fab4b82f0b4098",22851949,1,0,1,1515,397,397,0
"44a277ea44dc4ae689fab4b82f0b4098","0c12af0a4e7f4002852cf84b2537c161",22851949,1,-2,0,1516,397,395,-2
"0c12af0a4e7f4002852cf84b2537c161","66baf19b6b904b70922329068c63746d",22851949,1,-24,0,1517,395,376,-19
"2b09a08242b54983aec7063990fb3f66","1157bd665ec4472fb58b751dc5099355",22851949,1,4,0,1522,400,403,3
"58fc9094275e4c49be3f4ba6d4acc0a4","3c8a22d2f9c146ea956609e3ed4f2559",22851949,1,-2,0,1524,406,405,-1
"3c8a22d2f9c146ea956609e3ed4f2559","58fc9094275e4c49be3f4ba6d4acc0a4",22851949,1,2,0,1525,405,406,1
"02b3a1bead9244c1ba2f857c7da8f82a","6206fc6479014bb193084c32409dc1b9",22851949,1,1,0,1530,408,409,1
"6206fc6479014bb193084c32409dc1b9","6206fc6479014bb193084c32409dc1b9",22851949,1,0,1,1531,409,409,0
"6206fc6479014bb193084c32409dc1b9","6a5f020451db426dacba9e2ea3fcc62a",22851949,1,2,0,1532,409,410,1
"6a5f020451db426dacba9e2ea3fcc62a","02b3a1bead9244c1ba2f857c7da8f82a",22851949,1,-3,0,1533,410,408,-2
"02b3a1bead9244c1ba2f857c7da8f82a","6a5f020451db426dacba9e2ea3fcc62a",22851949,1,3,0,1534,408,410,2
"6a5f020451db426dacba9e2ea3fcc62a","6a5f020451db426dacba9e2ea3fcc62a",22851949,1,0,1,1535,410,410,0
"6a5f020451db426dacba9e2ea3fcc62a","33a9d248b2e44588a5b07fc1342b9bc2",22851949,2,2,0,1536,410,411,1
"33a9d248b2e44588a5b07fc1342b9bc2","6a5f020451db426dacba9e2ea3fcc62a",22851949,1,-2,0,1537,411,410,-1
"33a9d248b2e44588a5b07fc1342b9bc2","c6f26bd420634f1cb7989e76fe6b16c0",22851949,1,1,0,1539,411,412,1
"c6f26bd420634f1cb7989e76fe6b16c0","c6f26bd420634f1cb7989e76fe6b16c0",22851949,5,0,1,1540,412,412,0
"c6f26bd420634f1cb7989e76fe6b16c0","2a65ee6e2ac64f6a8a55fbe5373ec763",22851949,1,1,0,1545,412,413,1
"2a65ee6e2ac64f6a8a55fbe5373ec763","2a65ee6e2ac64f6a8a55fbe5373ec763",22851949,5,0,1,1546,413,413,0
"2a65ee6e2ac64f6a8a55fbe5373ec763","33a9d248b2e44588a5b07fc1342b9bc2",22851949,1,-2,0,1551,413,411,-2
"33a9d248b2e44588a5b07fc1342b9bc2","1fd0f6dadbc14ebc965faf6122190b96",22851949,1,5,0,1552,411,415,4
"1fd0f6dadbc14ebc965faf6122190b96","1fd0f6dadbc14ebc965faf6122190b96",22851949,2,0,1,1553,415,415,0
"1fd0f6dadbc14ebc965faf6122190b96","687055dad9fc40c3982478fe33ec01bf",22851949,2,-1,0,1554,415,414,-1
"687055dad9fc40c3982478fe33ec01bf","2add1669f08d4101913db15f8c23b3b7",22851949,2,3,0,1555,414,416,2
"2add1669f08d4101913db15f8c23b3b7","687055dad9fc40c3982478fe33ec01bf",22851949,1,-3,0,1556,416,414,-2
"687055dad9fc40c3982478fe33ec01bf","2b09a08242b54983aec7063990fb3f66",22851949,1,-21,0,1557,414,400,-14
"2b09a08242b54983aec7063990fb3f66","1fd0f6dadbc14ebc965faf6122190b96",22851949,1,22,0,1560,400,415,15
"2add1669f08d4101913db15f8c23b3b7","2add1669f08d4101913db15f8c23b3b7",22851949,1,0,1,1564,416,416,0
"2add1669f08d4101913db15f8c23b3b7","2b09a08242b54983aec7063990fb3f66",22851949,1,-24,0,1565,416,400,-16
"2b09a08242b54983aec7063990fb3f66","a2b4bd40cee2481ebd3fc179d6a5cd62",22851949,1,27,0,1566,400,417,17
"a2b4bd40cee2481ebd3fc179d6a5cd62","e34e59dce2204f228f3a84b6725df60f",22851949,1,2,0,1567,417,419,2
"e34e59dce2204f228f3a84b6725df60f","e34e59dce2204f228f3a84b6725df60f",22851949,1,0,1,1568,419,419,0
"e34e59dce2204f228f3a84b6725df60f","bec48fc2e1294c7eb3d0aca780d731b8",22851949,1,2,0,1569,419,420,1
"bec48fc2e1294c7eb3d0aca780d731b8","a2b4bd40cee2481ebd3fc179d6a5cd62",22851949,1,-4,0,1570,420,417,-3
"a2b4bd40cee2481ebd3fc179d6a5cd62","bec48fc2e1294c7eb3d0aca780d731b8",22851949,1,4,0,1571,417,420,3
"bec48fc2e1294c7eb3d0aca780d731b8","bec48fc2e1294c7eb3d0aca780d731b8",22851949,4,0,1,1572,420,420,0
"bec48fc2e1294c7eb3d0aca780d731b8","dbde19fcce2a4c1abdc7f685c293a23f",22851949,1,3,0,1576,420,422,2
"dbde19fcce2a4c1abdc7f685c293a23f","a24600b0e49245f6bdba8c893cfeddb0",22851949,1,4,0,1577,422,425,3
"a24600b0e49245f6bdba8c893cfeddb0","a24600b0e49245f6bdba8c893cfeddb0",22851949,5,0,1,1578,425,425,0
"a24600b0e49245f6bdba8c893cfeddb0","24cf8786024543f19b89bc20034e60d7",22851949,1,7,0,1583,425,428,3
"24cf8786024543f19b89bc20034e60d7","24cf8786024543f19b89bc20034e60d7",22851949,1,0,1,1584,428,428,0
"24cf8786024543f19b89bc20034e60d7","f2a73be2f46840b182d7bd095378004e",22851949,2,1,0,1585,428,429,1
"f2a73be2f46840b182d7bd095378004e","24cf8786024543f19b89bc20034e60d7",22851949,2,-1,0,1586,429,428,-1
"24cf8786024543f19b89bc20034e60d7","a2b4bd40cee2481ebd3fc179d6a5cd62",22851949,2,-18,0,1587,428,417,-11
"a2b4bd40cee2481ebd3fc179d6a5cd62","24cf8786024543f19b89bc20034e60d7",22851949,1,18,0,1588,417,428,11
"a2b4bd40cee2481ebd3fc179d6a5cd62","f2a73be2f46840b182d7bd095378004e",22851949,1,19,0,1590,417,429,12
"f2a73be2f46840b182d7bd095378004e","f2a73be2f46840b182d7bd095378004e",22851949,2,0,1,1591,429,429,0
"f2a73be2f46840b182d7bd095378004e","604551fd4266430cb860fef58fa7dd61",22851949,1,1,0,1593,429,430,1
"604551fd4266430cb860fef58fa7dd61","604551fd4266430cb860fef58fa7dd61",22851949,9,0,1,1594,430,430,0
"604551fd4266430cb860fef58fa7dd61","24cf8786024543f19b89bc20034e60d7",22851949,1,-2,0,1603,430,428,-2
"24cf8786024543f19b89bc20034e60d7","dce46f8904594a62a6377a3587aaa663",22851949,2,4,0,1604,428,431,3
"dce46f8904594a62a6377a3587aaa663","dce46f8904594a62a6377a3587aaa663",22851949,3,0,1,1605,431,431,0
"dce46f8904594a62a6377a3587aaa663","9b9d0a249052413c869753b99682b0ac",22851949,1,1,0,1607,431,432,1
"9b9d0a249052413c869753b99682b0ac","9b9d0a249052413c869753b99682b0ac",22851949,1,0,1,1608,432,432,0
"9b9d0a249052413c869753b99682b0ac","061c175cc90f45fbad883025394e78dd",22851949,1,1,0,1609,432,433,1
"061c175cc90f45fbad883025394e78dd","061c175cc90f45fbad883025394e78dd",22851949,6,0,1,1610,433,433,0
"061c175cc90f45fbad883025394e78dd","dce46f8904594a62a6377a3587aaa663",22851949,1,-2,0,1616,433,431,-2
"dce46f8904594a62a6377a3587aaa663","74a7f8712e5449c2bc0b43c6f90dafed",22851949,1,5,0,1617,431,435,4
"74a7f8712e5449c2bc0b43c6f90dafed","74a7f8712e5449c2bc0b43c6f90dafed",22851949,1,0,1,1618,435,435,0
"74a7f8712e5449c2bc0b43c6f90dafed","66ada10dde9f43018588f1ced9d477fc",22851949,1,-1,0,1619,435,434,-1
"66ada10dde9f43018588f1ced9d477fc","24cf8786024543f19b89bc20034e60d7",22851949,2,-8,0,1620,434,428,-6
"dce46f8904594a62a6377a3587aaa663","66ada10dde9f43018588f1ced9d477fc",22851949,1,4,0,1625,431,434,3
"24cf8786024543f19b89bc20034e60d7","070600601c4c439288445d2f0724807d",22851949,3,14,0,1627,428,437,9
"070600601c4c439288445d2f0724807d","24cf8786024543f19b89bc20034e60d7",22851949,2,-14,0,1628,437,428,-9
"070600601c4c439288445d2f0724807d","0380cd76a7d44bc3a4da1f15e4d68f89",22851949,2,4,0,1630,437,440,3
"0380cd76a7d44bc3a4da1f15e4d68f89","1823b6de7d334a7aaabc4570719af4d9",22851949,2,-2,0,1631,440,439,-1
"1823b6de7d334a7aaabc4570719af4d9","0380cd76a7d44bc3a4da1f15e4d68f89",22851949,2,2,0,1632,439,440,1
"1823b6de7d334a7aaabc4570719af4d9","070600601c4c439288445d2f0724807d",22851949,1,-2,0,1634,439,437,-2
"24cf8786024543f19b89bc20034e60d7","bf12c96466d840a69bed7020b3f18bb8",22851949,1,11,0,1636,428,436,8
"bf12c96466d840a69bed7020b3f18bb8","66ada10dde9f43018588f1ced9d477fc",22851949,1,-3,0,1637,436,434,-2
"66ada10dde9f43018588f1ced9d477fc","bf12c96466d840a69bed7020b3f18bb8",22851949,1,3,0,1638,434,436,2
"bf12c96466d840a69bed7020b3f18bb8","bf12c96466d840a69bed7020b3f18bb8",22851949,1,0,1,1639,436,436,0
"bf12c96466d840a69bed7020b3f18bb8","24cf8786024543f19b89bc20034e60d7",22851949,1,-11,0,1640,436,428,-8
"070600601c4c439288445d2f0724807d","1823b6de7d334a7aaabc4570719af4d9",22851949,1,2,0,1642,437,439,2
"1823b6de7d334a7aaabc4570719af4d9","1823b6de7d334a7aaabc4570719af4d9",22851949,11,0,1,1643,439,439,0
"0380cd76a7d44bc3a4da1f15e4d68f89","070600601c4c439288445d2f0724807d",22851949,1,-4,0,1655,440,437,-3
"0380cd76a7d44bc3a4da1f15e4d68f89","0380cd76a7d44bc3a4da1f15e4d68f89",22851949,2,0,1,1657,440,440,0
"0380cd76a7d44bc3a4da1f15e4d68f89","23b7673c8b5443108c2ef09382834a86",22851949,1,2,0,1659,440,441,1
"23b7673c8b5443108c2ef09382834a86","23b7673c8b5443108c2ef09382834a86",22851949,4,0,1,1660,441,441,0
"23b7673c8b5443108c2ef09382834a86","901e92500aea43c79f19f1b279050668",22851949,1,2,0,1664,441,442,1
"901e92500aea43c79f19f1b279050668","901e92500aea43c79f19f1b279050668",22851949,2,0,1,1665,442,442,0
"901e92500aea43c79f19f1b279050668","001339db8ced4cf78829ebe8b145449d",22851949,1,1,0,1667,442,443,1
"001339db8ced4cf78829ebe8b145449d","001339db8ced4cf78829ebe8b145449d",22851949,8,0,1,1668,443,443,0
"001339db8ced4cf78829ebe8b145449d","452745e0366e42ae81561bfddebcc6c3",22851949,1,1,0,1676,443,444,1
"452745e0366e42ae81561bfddebcc6c3","452745e0366e42ae81561bfddebcc6c3",22851949,8,0,1,1677,444,444,0
"452745e0366e42ae81561bfddebcc6c3","901e92500aea43c79f19f1b279050668",22851949,1,-2,0,1685,444,442,-2
"901e92500aea43c79f19f1b279050668","4660ff2089114e8db82ceb26a4f329e3",22851949,1,4,0,1686,442,445,3
"4660ff2089114e8db82ceb26a4f329e3","4660ff2089114e8db82ceb26a4f329e3",22851949,3,0,1,1687,445,445,0
"4660ff2089114e8db82ceb26a4f329e3","7bd5586eb9d8484eb74a433ee7bfe499",22851949,1,2,0,1690,445,446,1
"7bd5586eb9d8484eb74a433ee7bfe499","7bd5586eb9d8484eb74a433ee7bfe499",22851949,21,0,1,1691,446,446,0
"7bd5586eb9d8484eb74a433ee7bfe499","8a7f26e690f34dda97be16904518ca99",22851949,1,2,0,1712,446,447,1
"8a7f26e690f34dda97be16904518ca99","8a7f26e690f34dda97be16904518ca99",22851949,1,0,1,1713,447,447,0
"8a7f26e690f34dda97be16904518ca99","b2f0d654738f48158edff28e8d3a546e",22851949,1,5,0,1714,447,449,2
"b2f0d654738f48158edff28e8d3a546e","070600601c4c439288445d2f0724807d",22851949,1,-21,0,1715,449,437,-12
"070600601c4c439288445d2f0724807d","f60ee41ec635499abd48168342d32c2f",22851949,1,26,0,1716,437,453,16
"f60ee41ec635499abd48168342d32c2f","f60ee41ec635499abd48168342d32c2f",22851949,58,0,1,1717,453,453,0
"f60ee41ec635499abd48168342d32c2f","b2f0d654738f48158edff28e8d3a546e",22851949,2,-5,0,1723,453,449,-4
"b2f0d654738f48158edff28e8d3a546e","f60ee41ec635499abd48168342d32c2f",22851949,2,5,0,1724,449,453,4
"b2f0d654738f48158edff28e8d3a546e","f67fbf45a5f146ed866965bc57c7c001",22851949,1,8,0,1771,449,454,5
"f67fbf45a5f146ed866965bc57c7c001","f67fbf45a5f146ed866965bc57c7c001",22851949,2,0,1,1772,454,454,0
"f67fbf45a5f146ed866965bc57c7c001","d937afe49bd24a07a550dda1c1155122",22851949,1,1,0,1774,454,455,1
"d937afe49bd24a07a550dda1c1155122","d937afe49bd24a07a550dda1c1155122",22851949,1,0,1,1775,455,455,0
"d937afe49bd24a07a550dda1c1155122","3628b3f7823443d0912a339096b69943",22851949,1,1,0,1776,455,456,1
"3628b3f7823443d0912a339096b69943","3628b3f7823443d0912a339096b69943",22851949,1,0,1,1777,456,456,0
"3628b3f7823443d0912a339096b69943","9e049ee647cf43ecbcb5ed792a8e7588",22851949,1,1,0,1778,456,457,1
"9e049ee647cf43ecbcb5ed792a8e7588","9e049ee647cf43ecbcb5ed792a8e7588",22851949,1,0,1,1779,457,457,0
"9e049ee647cf43ecbcb5ed792a8e7588","5256a214faaf410b93f76cea06428334",22851949,1,1,0,1780,457,458,1
"5256a214faaf410b93f76cea06428334","5256a214faaf410b93f76cea06428334",22851949,1,0,1,1781,458,458,0
"5256a214faaf410b93f76cea06428334","25c32b120fce40fa9b6c85133aeb4716",22851949,1,1,0,1782,458,459,1
"25c32b120fce40fa9b6c85133aeb4716","25c32b120fce40fa9b6c85133aeb4716",22851949,1,0,1,1783,459,459,0
"25c32b120fce40fa9b6c85133aeb4716","11bc14f2204949008b7d511b933363c1",22851949,1,1,0,1784,459,460,1
"11bc14f2204949008b7d511b933363c1","11bc14f2204949008b7d511b933363c1",22851949,1,0,1,1785,460,460,0
"11bc14f2204949008b7d511b933363c1","42de338840a34d15adb66e7b14fb9d2c",22851949,1,1,0,1786,460,461,1
"42de338840a34d15adb66e7b14fb9d2c","42de338840a34d15adb66e7b14fb9d2c",22851949,1,0,1,1787,461,461,0
"42de338840a34d15adb66e7b14fb9d2c","9da37c6210b1416b8079c274f70bf600",22851949,1,1,0,1788,461,462,1
"9da37c6210b1416b8079c274f70bf600","9da37c6210b1416b8079c274f70bf600",22851949,3,0,1,1789,462,462,0
"9da37c6210b1416b8079c274f70bf600","519119f1deac45ff9ab4f13529be5c6e",22851949,1,1,0,1792,462,463,1
"519119f1deac45ff9ab4f13529be5c6e","519119f1deac45ff9ab4f13529be5c6e",22851949,1,0,1,1793,463,463,0
"519119f1deac45ff9ab4f13529be5c6e","c5df9f40ec14463b9dcfdc73df3e9285",22851949,1,3,0,1794,463,464,1
"f67fbf45a5f146ed866965bc57c7c001","c5df9f40ec14463b9dcfdc73df3e9285",22851949,1,12,0,1796,454,464,10
"c5df9f40ec14463b9dcfdc73df3e9285","83d42d95cd844fc093fc09cee250edb8",22851949,1,3,0,1798,464,465,1
"83d42d95cd844fc093fc09cee250edb8","9428d8bd9c5a47b2a235b254e5e27ded",22851949,1,-19,0,1803,465,452,-13
"9428d8bd9c5a47b2a235b254e5e27ded","b2f0d654738f48158edff28e8d3a546e",22851949,1,-4,0,1804,452,449,-3
"f60ee41ec635499abd48168342d32c2f","56586aa865414f538729c7f7735d2bc6",22851949,1,-622,0,1813,453,12,-441
"56586aa865414f538729c7f7735d2bc6","5c5ceeee4562457ba6d41515aeebfbb1",22851949,1,10,0,1814,12,17,5
"5c5ceeee4562457ba6d41515aeebfbb1","56586aa865414f538729c7f7735d2bc6",22851949,1,-10,0,1815,17,12,-5
"56586aa865414f538729c7f7735d2bc6","56586aa865414f538729c7f7735d2bc6",22851949,8,0,1,1816,12,12,0
"56586aa865414f538729c7f7735d2bc6","e2911e79efc2420eac45d9f671463d4b",22851949,2,-12,0,1818,12,2,-10
"e2911e79efc2420eac45d9f671463d4b","56586aa865414f538729c7f7735d2bc6",22851949,4,12,0,1819,2,12,10
"56586aa865414f538729c7f7735d2bc6","b613861cecf84ffcab01afb23f660475",22851949,1,-15,0,1820,12,1,-11
"b613861cecf84ffcab01afb23f660475","b613861cecf84ffcab01afb23f660475",22851949,5,0,1,1821,1,1,0
"b613861cecf84ffcab01afb23f660475","e2911e79efc2420eac45d9f671463d4b",22851949,2,3,0,1823,1,2,1
"56586aa865414f538729c7f7735d2bc6","b7f2b31585d94eb3bf86376714aa7070",22851949,2,2,0,1828,12,13,1
"b7f2b31585d94eb3bf86376714aa7070","b7f2b31585d94eb3bf86376714aa7070",22851949,6,0,1,1829,13,13,0
"b7f2b31585d94eb3bf86376714aa7070","3f1c815879794b929260d224becaff7e",22851949,2,2,0,1831,13,14,1
"b613861cecf84ffcab01afb23f660475","b613861cecf84ffcab01afb23f660475",22852860,5,0,1,1,1,1,0
"b613861cecf84ffcab01afb23f660475","e2911e79efc2420eac45d9f671463d4b",22852860,2,3,0,6,1,2,1
"e2911e79efc2420eac45d9f671463d4b","b613861cecf84ffcab01afb23f660475",22852860,1,-3,0,7,2,1,-1
"e2911e79efc2420eac45d9f671463d4b","e2911e79efc2420eac45d9f671463d4b",22852860,1,0,1,9,2,2,0
"e2911e79efc2420eac45d9f671463d4b","519d1b8c59404d67b54e96c5c8a830b2",22852860,1,1,0,10,2,3,1
"519d1b8c59404d67b54e96c5c8a830b2","519d1b8c59404d67b54e96c5c8a830b2",22852860,1,0,1,11,3,3,0
"519d1b8c59404d67b54e96c5c8a830b2","531db53f81f646edb0cdcfe0085b03b7",22852860,1,1,0,12,3,4,1
"531db53f81f646edb0cdcfe0085b03b7","531db53f81f646edb0cdcfe0085b03b7",22852860,1,0,1,13,4,4,0
"531db53f81f646edb0cdcfe0085b03b7","4f5f94b2f95141e0a9d53a61da2276da",22852860,1,1,0,14,4,5,1
"4f5f94b2f95141e0a9d53a61da2276da","4f5f94b2f95141e0a9d53a61da2276da",22852860,1,0,1,15,5,5,0
"4f5f94b2f95141e0a9d53a61da2276da","6d541c89590949f99af293c4f2333f67",22852860,1,1,0,16,5,6,1
"6d541c89590949f99af293c4f2333f67","6d541c89590949f99af293c4f2333f67",22852860,1,0,1,17,6,6,0
"6d541c89590949f99af293c4f2333f67","dd5cf0b9fe4c4f1d8f5ff8e4c04879cb",22852860,1,1,0,18,6,7,1
"dd5cf0b9fe4c4f1d8f5ff8e4c04879cb","dd5cf0b9fe4c4f1d8f5ff8e4c04879cb",22852860,1,0,1,19,7,7,0
"dd5cf0b9fe4c4f1d8f5ff8e4c04879cb","f96261861edc426abe2248be4f0a709a",22852860,1,1,0,20,7,8,1
"f96261861edc426abe2248be4f0a709a","f96261861edc426abe2248be4f0a709a",22852860,1,0,1,21,8,8,0
"f96261861edc426abe2248be4f0a709a","66b5e16f4f75454fb5b8172079f0fa83",22852860,1,1,0,22,8,9,1
"66b5e16f4f75454fb5b8172079f0fa83","66b5e16f4f75454fb5b8172079f0fa83",22852860,1,0,1,23,9,9,0
"66b5e16f4f75454fb5b8172079f0fa83","0680571d4698477995e41842c36a54b2",22852860,1,1,0,24,9,10,1
"0680571d4698477995e41842c36a54b2","0680571d4698477995e41842c36a54b2",22852860,1,0,1,25,10,10,0
"0680571d4698477995e41842c36a54b2","9112f2bffece48e08c6d2287be204085",22852860,1,1,0,26,10,11,1
"9112f2bffece48e08c6d2287be204085","9112f2bffece48e08c6d2287be204085",22852860,1,0,1,27,11,11,0
"9112f2bffece48e08c6d2287be204085","56586aa865414f538729c7f7735d2bc6",22852860,1,3,0,28,11,12,1
"56586aa865414f538729c7f7735d2bc6","e2911e79efc2420eac45d9f671463d4b",22852860,1,-12,0,29,12,2,-10
"e2911e79efc2420eac45d9f671463d4b","56586aa865414f538729c7f7735d2bc6",22852860,1,12,0,30,2,12,10
"56586aa865414f538729c7f7735d2bc6","56586aa865414f538729c7f7735d2bc6",22852860,2,0,1,31,12,12,0
"56586aa865414f538729c7f7735d2bc6","b7f2b31585d94eb3bf86376714aa7070",22852860,1,2,0,33,12,13,1
"b7f2b31585d94eb3bf86376714aa7070","b7f2b31585d94eb3bf86376714aa7070",22852860,3,0,1,34,13,13,0
"b7f2b31585d94eb3bf86376714aa7070","3f1c815879794b929260d224becaff7e",22852860,1,2,0,37,13,14,1
"3f1c815879794b929260d224becaff7e","5c5ceeee4562457ba6d41515aeebfbb1",22852860,1,6,0,38,14,17,3
"5c5ceeee4562457ba6d41515aeebfbb1","81c864a886d54a6b8ff85f7d736f4f95",22852860,1,-4,0,39,17,15,-2
"81c864a886d54a6b8ff85f7d736f4f95","5c5ceeee4562457ba6d41515aeebfbb1",22852860,1,4,0,40,15,17,2
"5c5ceeee4562457ba6d41515aeebfbb1","56586aa865414f538729c7f7735d2bc6",22852860,1,-10,0,41,17,12,-5
"56586aa865414f538729c7f7735d2bc6","9afd71a5298d4333b6849dfce1b9422c",22852860,1,13,0,42,12,18,6
"9afd71a5298d4333b6849dfce1b9422c","9afd71a5298d4333b6849dfce1b9422c",22852860,5,0,1,43,18,18,0
"9afd71a5298d4333b6849dfce1b9422c","b7719e26494940efa49512aedd0aac79",22852860,1,4,0,48,18,20,2
"b7719e26494940efa49512aedd0aac79","d4f45188d3c84a02ba08454e6403a818",22852860,1,5,0,49,20,24,4
"d4f45188d3c84a02ba08454e6403a818","d4c3b003e8274e429d2fa688d73fde6d",22852860,1,-2,0,50,24,22,-2
"d4c3b003e8274e429d2fa688d73fde6d","d4c3b003e8274e429d2fa688d73fde6d",22852860,1,0,1,51,22,22,0
"d4c3b003e8274e429d2fa688d73fde6d","b7719e26494940efa49512aedd0aac79",22852860,1,-3,0,52,22,20,-2
"afbf7250b99d47bea07172749483ca97","b7719e26494940efa49512aedd0aac79",22852860,1,-12,0,54,28,20,-8
"afbf7250b99d47bea07172749483ca97","4e51676dc72045d99c19b9fa7b22f8bc",22852860,1,3,0,56,28,29,1
"4e51676dc72045d99c19b9fa7b22f8bc","4e51676dc72045d99c19b9fa7b22f8bc",22852860,1,0,1,57,29,29,0
"4e51676dc72045d99c19b9fa7b22f8bc","51970cfa30e643e894e66ae85c8024cc",22852860,1,3,0,58,29,31,2
"51970cfa30e643e894e66ae85c8024cc","c33c17be71ae4d588da7369472e5bb1b",22852860,1,6,0,59,31,34,3
"c33c17be71ae4d588da7369472e5bb1b","4e51676dc72045d99c19b9fa7b22f8bc",22852860,1,-9,0,60,34,29,-5
"4e51676dc72045d99c19b9fa7b22f8bc","c33c17be71ae4d588da7369472e5bb1b",22852860,1,9,0,61,29,34,5
"c33c17be71ae4d588da7369472e5bb1b","93679be414554a11b1893002f2229a93",22852860,1,3,0,62,34,35,1
"93679be414554a11b1893002f2229a93","7040a13096d746ac84b8fac8d9752058",22852860,2,3,0,63,35,36,1
"7040a13096d746ac84b8fac8d9752058","93679be414554a11b1893002f2229a93",22852860,1,-3,0,64,36,35,-1
"7040a13096d746ac84b8fac8d9752058","9a0dc646f934470daf08c4b56ccf73db",22852860,1,3,0,66,36,37,1
"9a0dc646f934470daf08c4b56ccf73db","fc0e049d56024bc9a02c9a9c435c3df7",22852860,6,3,0,67,37,38,1
"fc0e049d56024bc9a02c9a9c435c3df7","9a0dc646f934470daf08c4b56ccf73db",22852860,6,-3,0,68,38,37,-1
"fc0e049d56024bc9a02c9a9c435c3df7","fc0e049d56024bc9a02c9a9c435c3df7",22852860,5,0,1,70,38,38,0
"9a0dc646f934470daf08c4b56ccf73db","9a0dc646f934470daf08c4b56ccf73db",22852860,5,0,1,76,37,37,0
"9a0dc646f934470daf08c4b56ccf73db","67a089198fcb4e1c8f2385786c2b296f",22852860,1,7,0,89,37,39,2
"b534b89233134e30a9b5645138bfa9ee","0e37b720d23b4e7f8b313e79313fd107",22852860,1,3,0,98,41,44,3
"0e37b720d23b4e7f8b313e79313fd107","0e37b720d23b4e7f8b313e79313fd107",22852860,1,0,1,99,44,44,0
"0e37b720d23b4e7f8b313e79313fd107","6875d67fdd5f48168b62719df449bebd",22852860,1,1,0,100,44,45,1
"6875d67fdd5f48168b62719df449bebd","6875d67fdd5f48168b62719df449bebd",22852860,1,0,1,101,45,45,0
"6875d67fdd5f48168b62719df449bebd","b534b89233134e30a9b5645138bfa9ee",22852860,1,-4,0,102,45,41,-4
"6e13d61a7bdb44bca949c9f86fab3be5","6e13d61a7bdb44bca949c9f86fab3be5",22852860,4,0,1,104,47,47,0
"6e13d61a7bdb44bca949c9f86fab3be5","195f78799f984cc2b06c48dfe36be751",22852860,1,2,0,106,47,49,2
"195f78799f984cc2b06c48dfe36be751","195f78799f984cc2b06c48dfe36be751",22852860,2,0,1,107,49,49,0
"195f78799f984cc2b06c48dfe36be751","d9c8d8c444a64dadbbb508652c721e17",22852860,1,-3,0,109,49,46,-3
"d0c74f735e024943943e40333d6d337f","d0c74f735e024943943e40333d6d337f",22852860,1,0,1,111,51,51,0
"d0c74f735e024943943e40333d6d337f","983f8ff320594b279a7f4a6fe132f9c5",22852860,1,2,0,112,51,53,2
"983f8ff320594b279a7f4a6fe132f9c5","983f8ff320594b279a7f4a6fe132f9c5",22852860,2,0,1,113,53,53,0
"983f8ff320594b279a7f4a6fe132f9c5","35adfa5d923046aebabfefd98f35ff05",22852860,1,1,0,115,53,54,1
"35adfa5d923046aebabfefd98f35ff05","35adfa5d923046aebabfefd98f35ff05",22852860,2,0,1,116,54,54,0
"35adfa5d923046aebabfefd98f35ff05","b6f8a98476224da1b40e555ececc7ed8",22852860,1,1,0,118,54,55,1
"b6f8a98476224da1b40e555ececc7ed8","b6f8a98476224da1b40e555ececc7ed8",22852860,2,0,1,119,55,55,0
"b6f8a98476224da1b40e555ececc7ed8","86e22cb5fe0e4b47a9489ecddf7ed78f",22852860,1,1,0,121,55,56,1
"86e22cb5fe0e4b47a9489ecddf7ed78f","86e22cb5fe0e4b47a9489ecddf7ed78f",22852860,2,0,1,122,56,56,0
"86e22cb5fe0e4b47a9489ecddf7ed78f","f924752d8a1149668870b1e7698486f7",22852860,1,-6,0,124,56,50,-6
"a1f2f12debe5432fb7a70bcd12bacfb9","78f30e4dcac84e3cbea8b2cc6e0d62b3",22852860,2,1,0,126,58,59,1
"a1f2f12debe5432fb7a70bcd12bacfb9","a1f2f12debe5432fb7a70bcd12bacfb9",22852860,13,0,1,128,58,58,0
"78f30e4dcac84e3cbea8b2cc6e0d62b3","78f30e4dcac84e3cbea8b2cc6e0d62b3",22852860,7,0,1,142,59,59,0
"78f30e4dcac84e3cbea8b2cc6e0d62b3","a0a418b8540d479fa6e0f653b701da8b",22852860,1,6,0,149,59,64,5
"a0a418b8540d479fa6e0f653b701da8b","12aa6e1672ac4e7aa6449a7a8609cd72",22852860,1,-8,0,150,64,57,-7
"bc42d26810654ea9a1df1efe1e58c7d5","4c943503763e4e349906eea3ed3c8e86",22852860,1,-2,0,152,63,61,-2
"4c943503763e4e349906eea3ed3c8e86","4c943503763e4e349906eea3ed3c8e86",22852860,1,0,1,153,61,61,0
"4c943503763e4e349906eea3ed3c8e86","bc42d26810654ea9a1df1efe1e58c7d5",22852860,1,2,0,154,61,63,2
"309ccf3cc4fe429d9bfbaef53d3fa479","b534b89233134e30a9b5645138bfa9ee",22852860,1,-23,0,163,60,41,-19
"d646286c8051419bbc2e31dd1db55ca8","267f883678b24aed855fde42524975d9",22852860,1,4,0,165,67,71,4
"267f883678b24aed855fde42524975d9","267f883678b24aed855fde42524975d9",22852860,1,0,1,166,71,71,0
"267f883678b24aed855fde42524975d9","88fff56d0342490dbef9040750a20f6c",22852860,1,1,0,167,71,72,1
"88fff56d0342490dbef9040750a20f6c","88fff56d0342490dbef9040750a20f6c",22852860,1,0,1,168,72,72,0
"88fff56d0342490dbef9040750a20f6c","adb17b12b66c4a49a85fd34322f7df70",22852860,1,1,0,169,72,73,1
"adb17b12b66c4a49a85fd34322f7df70","adb17b12b66c4a49a85fd34322f7df70",22852860,1,0,1,170,73,73,0
"adb17b12b66c4a49a85fd34322f7df70","d646286c8051419bbc2e31dd1db55ca8",22852860,1,-6,0,171,73,67,-6
"a2becd407db34b189200a32546d9d569","58c22b011d0f4c2ea6d13615edbb9eeb",22852860,1,2,0,178,75,77,2
"58c22b011d0f4c2ea6d13615edbb9eeb","58c22b011d0f4c2ea6d13615edbb9eeb",22852860,2,0,1,179,77,77,0
"58c22b011d0f4c2ea6d13615edbb9eeb","dd76e1861dc9461c830888729d091ee0",22852860,1,1,0,181,77,78,1
"dd76e1861dc9461c830888729d091ee0","dd76e1861dc9461c830888729d091ee0",22852860,8,0,1,182,78,78,0
"dd76e1861dc9461c830888729d091ee0","cd1d828f1a694b87913a7ea66c23803e",22852860,1,1,0,190,78,79,1
"cd1d828f1a694b87913a7ea66c23803e","cd1d828f1a694b87913a7ea66c23803e",22852860,2,0,1,191,79,79,0
"cd1d828f1a694b87913a7ea66c23803e","9176a3c2b4d2465fa8b0c67096c2a97e",22852860,1,1,0,193,79,80,1
"9176a3c2b4d2465fa8b0c67096c2a97e","9176a3c2b4d2465fa8b0c67096c2a97e",22852860,5,0,1,194,80,80,0
"9176a3c2b4d2465fa8b0c67096c2a97e","f8ec6445f7194e25b9101d4fbcb07a18",22852860,1,1,0,199,80,81,1
"f8ec6445f7194e25b9101d4fbcb07a18","f8ec6445f7194e25b9101d4fbcb07a18",22852860,2,0,1,200,81,81,0
"f8ec6445f7194e25b9101d4fbcb07a18","140d5b27b8574befad82c0a013b59dfa",22852860,1,-7,0,202,81,74,-7
"d18a9ea32855445f8736581f5cb119ce","f564483cbd7a407681aa2fcca518cf5f",22852860,1,4,0,204,82,85,3
"f564483cbd7a407681aa2fcca518cf5f","f564483cbd7a407681aa2fcca518cf5f",22852860,4,0,1,205,85,85,0
"f564483cbd7a407681aa2fcca518cf5f","18fd01350bd5434ca636d59a599d768a",22852860,1,1,0,209,85,86,1
"18fd01350bd5434ca636d59a599d768a","18fd01350bd5434ca636d59a599d768a",22852860,8,0,1,210,86,86,0
"18fd01350bd5434ca636d59a599d768a","ae5ac430ea254e708a6f5deaaf7464ae",22852860,2,-2,0,218,86,84,-2
"6a9f0ef185fb47f0937e29daa1c71ed5","42fb58708eaf4e5daa82bfca61b6f5fd",22852860,1,-3,0,220,90,87,-3
"42fb58708eaf4e5daa82bfca61b6f5fd","18fd01350bd5434ca636d59a599d768a",22852860,1,-2,0,221,87,86,-1
"6a9f0ef185fb47f0937e29daa1c71ed5","c681290961c94c4caf23b529d1ae6b9a",22852860,1,-2,0,224,90,88,-2
"c681290961c94c4caf23b529d1ae6b9a","c681290961c94c4caf23b529d1ae6b9a",22852860,1,0,1,225,88,88,0
"c681290961c94c4caf23b529d1ae6b9a","6a9f0ef185fb47f0937e29daa1c71ed5",22852860,1,2,0,226,88,90,2
"e20db35ced8544ddac5bc3839145e463","1febb706d7a34005ae8711ed49c76e64",22852860,1,3,0,232,91,94,3
"1febb706d7a34005ae8711ed49c76e64","1febb706d7a34005ae8711ed49c76e64",22852860,2,0,1,233,94,94,0
"1febb706d7a34005ae8711ed49c76e64","8f73ba6f5a0042f2850356ac38ac6f24",22852860,1,1,0,235,94,95,1
"8f73ba6f5a0042f2850356ac38ac6f24","8f73ba6f5a0042f2850356ac38ac6f24",22852860,5,0,1,236,95,95,0
"8f73ba6f5a0042f2850356ac38ac6f24","e2260b86653c46d7b14a41fb419dbf8c",22852860,1,1,0,241,95,96,1
"e2260b86653c46d7b14a41fb419dbf8c","e2260b86653c46d7b14a41fb419dbf8c",22852860,2,0,1,242,96,96,0
"e2260b86653c46d7b14a41fb419dbf8c","35eb641ad1d845bbba54915bce75a962",22852860,1,1,0,244,96,97,1
"35eb641ad1d845bbba54915bce75a962","35eb641ad1d845bbba54915bce75a962",22852860,5,0,1,245,97,97,0
"35eb641ad1d845bbba54915bce75a962","08be90ffbeea4795a138cd42ed8db56f",22852860,1,1,0,250,97,98,1
"08be90ffbeea4795a138cd42ed8db56f","08be90ffbeea4795a138cd42ed8db56f",22852860,2,0,1,251,98,98,0
"08be90ffbeea4795a138cd42ed8db56f","3007433c8f584dcbb5ac159c1c5f2be3",22852860,1,1,0,253,98,99,1
"3007433c8f584dcbb5ac159c1c5f2be3","3007433c8f584dcbb5ac159c1c5f2be3",22852860,5,0,1,254,99,99,0
"3007433c8f584dcbb5ac159c1c5f2be3","e20db35ced8544ddac5bc3839145e463",22852860,1,-8,0,259,99,91,-8
"00ae5f0c51874a73a41ebea838d95682","d391c8b6e56a43a7b654e9dee02d904b",22852860,3,2,0,261,101,103,2
"d391c8b6e56a43a7b654e9dee02d904b","d391c8b6e56a43a7b654e9dee02d904b",22852860,19,0,1,264,103,103,0
"d391c8b6e56a43a7b654e9dee02d904b","6111116566fc4fd9abba409322bea245",22852860,1,1,0,283,103,104,1
"6111116566fc4fd9abba409322bea245","6111116566fc4fd9abba409322bea245",22852860,2,0,1,284,104,104,0
"6111116566fc4fd9abba409322bea245","a81b2235cb9c499eb9ea8ee0a8dd9725",22852860,1,1,0,286,104,105,1
"a81b2235cb9c499eb9ea8ee0a8dd9725","a81b2235cb9c499eb9ea8ee0a8dd9725",22852860,2,0,1,287,105,105,0
"a81b2235cb9c499eb9ea8ee0a8dd9725","2d4e0ab0ef3b4d73b82c72d4621a7579",22852860,1,1,0,289,105,106,1
"2d4e0ab0ef3b4d73b82c72d4621a7579","2d4e0ab0ef3b4d73b82c72d4621a7579",22852860,2,0,1,290,106,106,0
"2d4e0ab0ef3b4d73b82c72d4621a7579","8bdebf492ebd4e62b0d522e8ab5e5197",22852860,1,1,0,292,106,107,1
"8bdebf492ebd4e62b0d522e8ab5e5197","8bdebf492ebd4e62b0d522e8ab5e5197",22852860,2,0,1,293,107,107,0
"8bdebf492ebd4e62b0d522e8ab5e5197","73039f8c1eb9409cb4caee2cf968001e",22852860,1,-7,0,295,107,100,-7
"4280927ec4d643238aa49c32f9e06c6c","4280927ec4d643238aa49c32f9e06c6c",22852860,1,0,1,297,109,109,0
"4280927ec4d643238aa49c32f9e06c6c","fc44e6a5f7654430af1227838224dceb",22852860,1,2,0,298,109,111,2
"fc44e6a5f7654430af1227838224dceb","fc44e6a5f7654430af1227838224dceb",22852860,2,0,1,299,111,111,0
"fc44e6a5f7654430af1227838224dceb","a9ae0a3c070d455bb4369a8996313336",22852860,1,4,0,301,111,114,3
"a9ae0a3c070d455bb4369a8996313336","08111f75e22d409998cf8b85bd431f0a",22852860,1,-7,0,302,114,108,-6
"a9ae0a3c070d455bb4369a8996313336","a9ae0a3c070d455bb4369a8996313336",22852860,1,0,1,304,114,114,0
"a9ae0a3c070d455bb4369a8996313336","e20db35ced8544ddac5bc3839145e463",22852860,1,-26,0,305,114,91,-23
"e20db35ced8544ddac5bc3839145e463","e20db35ced8544ddac5bc3839145e463",22852860,1,0,1,306,91,91,0
"d391c8b6e56a43a7b654e9dee02d904b","4280927ec4d643238aa49c32f9e06c6c",22852860,1,7,0,309,103,109,6
"a9ae0a3c070d455bb4369a8996313336","71cec822bcff4f30a20e75dc63ef7b65",22852860,1,2,0,313,114,116,2
"71cec822bcff4f30a20e75dc63ef7b65","71cec822bcff4f30a20e75dc63ef7b65",22852860,1,0,1,314,116,116,0
"71cec822bcff4f30a20e75dc63ef7b65","62bff51286ef4f348717a3cf6fe2318f",22852860,1,5,0,315,116,120,4
"37319e88176d4aefa91d7a9980dbae91","b1cd0e7dc3ad4a8eb91a4bfdbeb025b0",22852860,1,7,0,317,112,118,6
"b1cd0e7dc3ad4a8eb91a4bfdbeb025b0","b1cd0e7dc3ad4a8eb91a4bfdbeb025b0",22852860,1,0,1,318,118,118,0
"b1cd0e7dc3ad4a8eb91a4bfdbeb025b0","e20db35ced8544ddac5bc3839145e463",22852860,1,-31,0,319,118,91,-27
"779f9ddd1fd14d1e9e69f72219a1fdbd","ae26e6cda8ad4a3f81bd347560d9579f",22852860,1,4,0,321,121,125,4
"ae26e6cda8ad4a3f81bd347560d9579f","ae26e6cda8ad4a3f81bd347560d9579f",22852860,3,0,1,322,125,125,0
"ae26e6cda8ad4a3f81bd347560d9579f","ee48df95832b4374aa273ceb27ec1315",22852860,1,1,0,325,125,126,1
"ee48df95832b4374aa273ceb27ec1315","ee48df95832b4374aa273ceb27ec1315",22852860,1,0,1,326,126,126,0
"ee48df95832b4374aa273ceb27ec1315","7a439da90b394756ad1777fc4c6dead5",22852860,1,1,0,327,126,127,1
"7a439da90b394756ad1777fc4c6dead5","7a439da90b394756ad1777fc4c6dead5",22852860,1,0,1,328,127,127,0
"7a439da90b394756ad1777fc4c6dead5","779f9ddd1fd14d1e9e69f72219a1fdbd",22852860,1,-6,0,329,127,121,-6
"a8dd5213034441ac92724b4e83eb0bb2","8115eab6556b45f5b415c3b8c26a12e5",22852860,1,2,0,332,129,131,2
"8115eab6556b45f5b415c3b8c26a12e5","8115eab6556b45f5b415c3b8c26a12e5",22852860,2,0,1,333,131,131,0
"8115eab6556b45f5b415c3b8c26a12e5","ec34b06efd844b46a4c4818ecdb9b8f4",22852860,1,1,0,335,131,132,1
"ec34b06efd844b46a4c4818ecdb9b8f4","ec34b06efd844b46a4c4818ecdb9b8f4",22852860,5,0,1,336,132,132,0
"ec34b06efd844b46a4c4818ecdb9b8f4","c2e1c2b9eac64109b343a088584b576b",22852860,1,1,0,341,132,133,1
"c2e1c2b9eac64109b343a088584b576b","c2e1c2b9eac64109b343a088584b576b",22852860,2,0,1,342,133,133,0
"c2e1c2b9eac64109b343a088584b576b","579338175e0b4bbb8ef3b712b5d8b54e",22852860,1,-5,0,344,133,128,-5
"579338175e0b4bbb8ef3b712b5d8b54e","8bc5795d6a984a3eace4e2811e52dd4f",22852860,1,8,0,345,128,135,7
"8bc5795d6a984a3eace4e2811e52dd4f","8bc5795d6a984a3eace4e2811e52dd4f",22852860,1,0,1,346,135,135,0
"8bc5795d6a984a3eace4e2811e52dd4f","b416d47c56a742199b5d7c7f19d6503a",22852860,1,-1,0,347,135,134,-1
"b416d47c56a742199b5d7c7f19d6503a","cd4532ad48034873ba8bce2aac0c9808",22852860,1,4,0,348,134,137,3
"cd4532ad48034873ba8bce2aac0c9808","cd4532ad48034873ba8bce2aac0c9808",22852860,1,0,1,349,137,137,0
"cd4532ad48034873ba8bce2aac0c9808","779f9ddd1fd14d1e9e69f72219a1fdbd",22852860,1,-19,0,350,137,121,-16
"6c5ad271a44743479bfaea29b1db8d02","83d311bed5374fee83d8d67a7d9d82dc",22852860,1,1,0,354,143,144,1
"83d311bed5374fee83d8d67a7d9d82dc","83d311bed5374fee83d8d67a7d9d82dc",22852860,1,0,1,355,144,144,0
"83d311bed5374fee83d8d67a7d9d82dc","402bba41861d43acb52a5abb89e8831e",22852860,1,1,0,356,144,145,1
"402bba41861d43acb52a5abb89e8831e","402bba41861d43acb52a5abb89e8831e",22852860,2,0,1,357,145,145,0
"402bba41861d43acb52a5abb89e8831e","df1de691dafe4549a18a4398ee9dfaf9",22852860,1,-6,0,359,145,139,-6
"8aae34f5ddbb4052a709b12e6b0d40fa","645b3f0249f64f76af2e19eb4d0e55b7",22852860,1,2,0,362,147,149,2
"645b3f0249f64f76af2e19eb4d0e55b7","645b3f0249f64f76af2e19eb4d0e55b7",22852860,2,0,1,363,149,149,0
"645b3f0249f64f76af2e19eb4d0e55b7","7e7b8db5064d4369805ab370aac5ddfb",22852860,1,1,0,365,149,150,1
"7e7b8db5064d4369805ab370aac5ddfb","7e7b8db5064d4369805ab370aac5ddfb",22852860,2,0,1,366,150,150,0
"7e7b8db5064d4369805ab370aac5ddfb","8956d210ae7f41968fada86d4c979d6a",22852860,1,1,0,368,150,151,1
"8956d210ae7f41968fada86d4c979d6a","8956d210ae7f41968fada86d4c979d6a",22852860,2,0,1,369,151,151,0
"8956d210ae7f41968fada86d4c979d6a","f902b0f41b544d4dbf79664fd233648d",22852860,1,-5,0,371,151,146,-5
"f902b0f41b544d4dbf79664fd233648d","ae781e8b775e4ccd93bc800dad5c8376",22852860,1,8,0,372,146,153,7
"ae781e8b775e4ccd93bc800dad5c8376","ae781e8b775e4ccd93bc800dad5c8376",22852860,5,0,1,373,153,153,0
"ae781e8b775e4ccd93bc800dad5c8376","06882a8492d9499aa31555567f575ecb",22852860,1,1,0,378,153,154,1
"06882a8492d9499aa31555567f575ecb","06882a8492d9499aa31555567f575ecb",22852860,1,0,1,379,154,154,0
"06882a8492d9499aa31555567f575ecb","f293c508f409466a8f27ddd7d1e40b20",22852860,1,1,0,380,154,155,1
"f293c508f409466a8f27ddd7d1e40b20","f293c508f409466a8f27ddd7d1e40b20",22852860,2,0,1,381,155,155,0
"f293c508f409466a8f27ddd7d1e40b20","cc4ddef5bbbe48ebb605141b347c4ed1",22852860,1,1,0,383,155,156,1
"cc4ddef5bbbe48ebb605141b347c4ed1","cc4ddef5bbbe48ebb605141b347c4ed1",22852860,3,0,1,384,156,156,0
"cc4ddef5bbbe48ebb605141b347c4ed1","f03480cf4eba413194d7af52fc0e7f28",22852860,1,-4,0,387,156,152,-4
"d313cec988a84645bee413e8d4724a4b","dc60696c76a74368a60f72246e47700d",22852860,1,1,0,393,158,159,1
"dc60696c76a74368a60f72246e47700d","dc60696c76a74368a60f72246e47700d",22852860,1,0,1,394,159,159,0
"dc60696c76a74368a60f72246e47700d","df1de691dafe4549a18a4398ee9dfaf9",22852860,1,-23,0,395,159,139,-20
"78adeee1fa2c4fe0bc73f7bca9fcee86","78adeee1fa2c4fe0bc73f7bca9fcee86",22852860,2,0,1,407,160,160,0
"78adeee1fa2c4fe0bc73f7bca9fcee86","3cbcea2be0984e7dbd5a48195af10ce7",22852860,1,8,0,442,160,165,5
"3cbcea2be0984e7dbd5a48195af10ce7","82e6285962b8400d9d6fc32436022a94",22852860,3,2,0,443,165,167,2
"82e6285962b8400d9d6fc32436022a94","3cbcea2be0984e7dbd5a48195af10ce7",22852860,2,-2,0,444,167,165,-2
"3cbcea2be0984e7dbd5a48195af10ce7","3cbcea2be0984e7dbd5a48195af10ce7",22852860,1,0,1,445,165,165,0
"82e6285962b8400d9d6fc32436022a94","a9ac840f098c4bd0a2ee896214ce29cd",22852860,1,3,0,449,167,168,1
"a9ac840f098c4bd0a2ee896214ce29cd","a9ac840f098c4bd0a2ee896214ce29cd",22852860,2,0,1,450,168,168,0
"a9ac840f098c4bd0a2ee896214ce29cd","0c7262dff33c4087bc660ccf40f92f9c",22852860,1,4,0,452,168,169,1
"0c7262dff33c4087bc660ccf40f92f9c","b2275c3fad834f8d90737a2d9a6927d6",22852860,1,3,0,453,169,172,3
"b2275c3fad834f8d90737a2d9a6927d6","b2275c3fad834f8d90737a2d9a6927d6",22852860,22,0,1,454,172,172,0
"b2275c3fad834f8d90737a2d9a6927d6","eb515a26030b41f8a82a1e6114420bad",22852860,1,1,0,476,172,173,1
"eb515a26030b41f8a82a1e6114420bad","eb515a26030b41f8a82a1e6114420bad",22852860,5,0,1,477,173,173,0
"eb515a26030b41f8a82a1e6114420bad","0c7262dff33c4087bc660ccf40f92f9c",22852860,1,-4,0,482,173,169,-4
"0c7262dff33c4087bc660ccf40f92f9c","b42cc17b7de840f181a704558d0bc845",22852860,1,7,0,483,169,175,6
"b42cc17b7de840f181a704558d0bc845","b42cc17b7de840f181a704558d0bc845",22852860,1,0,1,484,175,175,0
"b42cc17b7de840f181a704558d0bc845","801f9e9135034f49bf5f8b4bdefedb41",22852860,1,2,0,485,175,177,2
"801f9e9135034f49bf5f8b4bdefedb41","801f9e9135034f49bf5f8b4bdefedb41",22852860,4,0,1,486,177,177,0
"801f9e9135034f49bf5f8b4bdefedb41","362fcb0699a14845ab29b2340093e528",22852860,1,-3,0,490,177,174,-3
"362fcb0699a14845ab29b2340093e528","ea38cc0e6e6e41edbabf210220808bf9",22852860,1,6,0,491,174,179,5
"ea38cc0e6e6e41edbabf210220808bf9","b87c552dd247427abe6ab5795b9c9d43",22852860,2,2,0,492,179,181,2
"b87c552dd247427abe6ab5795b9c9d43","ea38cc0e6e6e41edbabf210220808bf9",22852860,2,-2,0,493,181,179,-2
"b87c552dd247427abe6ab5795b9c9d43","b87c552dd247427abe6ab5795b9c9d43",22852860,8,0,1,495,181,181,0
"b87c552dd247427abe6ab5795b9c9d43","139b097acfca451689d80c9c6eebdf7b",22852860,1,-3,0,503,181,178,-3
"139b097acfca451689d80c9c6eebdf7b","30f660a1feb34582a739722532524f79",22852860,1,6,0,504,178,183,5
"30f660a1feb34582a739722532524f79","30f660a1feb34582a739722532524f79",22852860,5,0,1,505,183,183,0
"30f660a1feb34582a739722532524f79","2024b4885bd14338a39b7b509acbbd02",22852860,1,-1,0,510,183,182,-1
"2024b4885bd14338a39b7b509acbbd02","c3f63fe50d8e487c86bf8ef76c9cadd3",22852860,1,4,0,511,182,185,3
"c3f63fe50d8e487c86bf8ef76c9cadd3","c3f63fe50d8e487c86bf8ef76c9cadd3",22852860,1,0,1,512,185,185,0
"c3f63fe50d8e487c86bf8ef76c9cadd3","0c7262dff33c4087bc660ccf40f92f9c",22852860,1,-20,0,513,185,169,-16
"0c7262dff33c4087bc660ccf40f92f9c","c8e371568a0c4391b25796ae4e91952e",22852860,1,23,0,514,169,186,17
"c8e371568a0c4391b25796ae4e91952e","7d932b23e1c84326ae5aa4d3c0d813d1",22852860,1,2,0,515,186,188,2
"7d932b23e1c84326ae5aa4d3c0d813d1","7d932b23e1c84326ae5aa4d3c0d813d1",22852860,1,0,1,516,188,188,0
"7d932b23e1c84326ae5aa4d3c0d813d1","c8e371568a0c4391b25796ae4e91952e",22852860,1,-2,0,517,188,186,-2
"c8e371568a0c4391b25796ae4e91952e","ab11d94c6c8948ea90b88f19d2cd502b",22852860,1,5,0,518,186,190,4
"ab11d94c6c8948ea90b88f19d2cd502b","ab11d94c6c8948ea90b88f19d2cd502b",22852860,2,0,1,519,190,190,0
"ab11d94c6c8948ea90b88f19d2cd502b","f992451ed6ad4e68bb9e68ad6be7c4be",22852860,1,2,0,521,190,192,2
"f992451ed6ad4e68bb9e68ad6be7c4be","f992451ed6ad4e68bb9e68ad6be7c4be",22852860,1,0,1,522,192,192,0
"f992451ed6ad4e68bb9e68ad6be7c4be","07b44a7a51e94c78b411c753fc39dab0",22852860,1,-3,0,523,192,189,-3
"07b44a7a51e94c78b411c753fc39dab0","6cd2dcaac46847d4a0bc53f296d90375",22852860,1,6,0,524,189,194,5
"6cd2dcaac46847d4a0bc53f296d90375","6cd2dcaac46847d4a0bc53f296d90375",22852860,1,0,1,525,194,194,0
"6cd2dcaac46847d4a0bc53f296d90375","2d2580c9411c4972909db508d6956a58",22852860,1,2,0,526,194,196,2
"2d2580c9411c4972909db508d6956a58","2d2580c9411c4972909db508d6956a58",22852860,2,0,1,527,196,196,0
"2d2580c9411c4972909db508d6956a58","5bddb3d9ed264f3984702f048c7e5340",22852860,1,1,0,529,196,197,1
"5bddb3d9ed264f3984702f048c7e5340","5bddb3d9ed264f3984702f048c7e5340",22852860,2,0,1,530,197,197,0
"5bddb3d9ed264f3984702f048c7e5340","d5e8e2bd12a2466b9d6d90855f0eb079",22852860,1,1,0,532,197,198,1
"d5e8e2bd12a2466b9d6d90855f0eb079","d5e8e2bd12a2466b9d6d90855f0eb079",22852860,2,0,1,533,198,198,0
"d5e8e2bd12a2466b9d6d90855f0eb079","017d7ca8e0394b91aaadc9574df2202c",22852860,1,-5,0,535,198,193,-5
"017d7ca8e0394b91aaadc9574df2202c","54e8e9f0ea3e45c4bf3b8ac799ee31b1",22852860,1,8,0,536,193,200,7
"54e8e9f0ea3e45c4bf3b8ac799ee31b1","54e8e9f0ea3e45c4bf3b8ac799ee31b1",22852860,1,0,1,537,200,200,0
"54e8e9f0ea3e45c4bf3b8ac799ee31b1","c614a00911be4877a075f19315530fb0",22852860,1,1,0,538,200,201,1
"c614a00911be4877a075f19315530fb0","c614a00911be4877a075f19315530fb0",22852860,6,0,1,539,201,201,0
"c614a00911be4877a075f19315530fb0","a6c21bd8b95249c7972820a7a7d76aff",22852860,1,1,0,545,201,202,1
"a6c21bd8b95249c7972820a7a7d76aff","a6c21bd8b95249c7972820a7a7d76aff",22852860,1,0,1,546,202,202,0
"a6c21bd8b95249c7972820a7a7d76aff","bb329d880ab54120adaf203a693bb203",22852860,1,1,0,547,202,203,1
"bb329d880ab54120adaf203a693bb203","bb329d880ab54120adaf203a693bb203",22852860,1,0,1,548,203,203,0
"bb329d880ab54120adaf203a693bb203","f9170dd6bc6442b4acd832747609b09a",22852860,1,-4,0,549,203,199,-4
"f9170dd6bc6442b4acd832747609b09a","334c2344009840079b1d0e1b7ce3d5a7",22852860,1,7,0,550,199,205,6
"334c2344009840079b1d0e1b7ce3d5a7","334c2344009840079b1d0e1b7ce3d5a7",22852860,1,0,1,551,205,205,0
"334c2344009840079b1d0e1b7ce3d5a7","c8e371568a0c4391b25796ae4e91952e",22852860,1,-23,0,552,205,186,-19
"c8e371568a0c4391b25796ae4e91952e","d7f13c8d63ec4e2aa673fbb9cf9c6933",22852860,1,26,0,553,186,206,20
"d7f13c8d63ec4e2aa673fbb9cf9c6933","b9e80f77c3a44349863b19875725c384",22852860,1,1,0,554,206,207,1
"b9e80f77c3a44349863b19875725c384","7108f0e4c2584f1f9c471689ae4c885c",22852860,2,1,0,555,207,208,1
"7108f0e4c2584f1f9c471689ae4c885c","b9e80f77c3a44349863b19875725c384",22852860,1,-1,0,556,208,207,-1
"b9e80f77c3a44349863b19875725c384","b9e80f77c3a44349863b19875725c384",22852860,15,0,1,557,207,207,0
"7108f0e4c2584f1f9c471689ae4c885c","7108f0e4c2584f1f9c471689ae4c885c",22852860,10,0,1,573,208,208,0
"7108f0e4c2584f1f9c471689ae4c885c","d7f13c8d63ec4e2aa673fbb9cf9c6933",22852860,1,-2,0,583,208,206,-2
"d7f13c8d63ec4e2aa673fbb9cf9c6933","09400e101c5d4b439cf9a26b03aae558",22852860,1,5,0,584,206,210,4
"09400e101c5d4b439cf9a26b03aae558","09400e101c5d4b439cf9a26b03aae558",22852860,2,0,1,585,210,210,0
"09400e101c5d4b439cf9a26b03aae558","a88efa7e50ce47159810ab553afa6d3a",22852860,1,2,0,587,210,212,2
"a88efa7e50ce47159810ab553afa6d3a","a88efa7e50ce47159810ab553afa6d3a",22852860,2,0,1,588,212,212,0
"a88efa7e50ce47159810ab553afa6d3a","be502a7a43c44bf7b682698de79d9369",22852860,1,3,0,590,212,214,2
"be502a7a43c44bf7b682698de79d9369","a875096404ef4a9984b62d74cda916f9",22852860,1,-6,0,591,214,209,-5
"a875096404ef4a9984b62d74cda916f9","f7fb1952f56b4189b86a9f8b7862d2b8",22852860,1,7,0,592,209,215,6
"f7fb1952f56b4189b86a9f8b7862d2b8","be502a7a43c44bf7b682698de79d9369",22852860,1,-1,0,593,215,214,-1
"be502a7a43c44bf7b682698de79d9369","be502a7a43c44bf7b682698de79d9369",22852860,3,0,1,594,214,214,0
"be502a7a43c44bf7b682698de79d9369","f7fb1952f56b4189b86a9f8b7862d2b8",22852860,1,1,0,597,214,215,1
"f7fb1952f56b4189b86a9f8b7862d2b8","f7fb1952f56b4189b86a9f8b7862d2b8",22852860,16,0,1,598,215,215,0
"f7fb1952f56b4189b86a9f8b7862d2b8","b860ee85d8bc4a2f97958cfb71be3533",22852860,1,1,0,614,215,216,1
"b860ee85d8bc4a2f97958cfb71be3533","b860ee85d8bc4a2f97958cfb71be3533",22852860,2,0,1,615,216,216,0
"b860ee85d8bc4a2f97958cfb71be3533","ec341f459285443b8361f7f15638ff08",22852860,1,-3,0,617,216,213,-3
"ec341f459285443b8361f7f15638ff08","363837c182e04711840d896ae1e0339c",22852860,1,6,0,618,213,218,5
"363837c182e04711840d896ae1e0339c","363837c182e04711840d896ae1e0339c",22852860,12,0,1,619,218,218,0
"363837c182e04711840d896ae1e0339c","01b2051f8941460d89945e3b02d1ce78",22852860,1,-1,0,631,218,217,-1
"01b2051f8941460d89945e3b02d1ce78","91125ca626c5470eb145501f8c37f8db",22852860,1,4,0,632,217,220,3
"91125ca626c5470eb145501f8c37f8db","91125ca626c5470eb145501f8c37f8db",22852860,1,0,1,633,220,220,0
"91125ca626c5470eb145501f8c37f8db","1c6721b1f63f4d30ba7746ea8af02a52",22852860,1,3,0,634,220,221,1
"1c6721b1f63f4d30ba7746ea8af02a52","d7f13c8d63ec4e2aa673fbb9cf9c6933",22852860,1,-21,0,635,221,206,-15
"d7f13c8d63ec4e2aa673fbb9cf9c6933","77ecef8eff6b4a2caea7707669bf7475",22852860,1,22,0,636,206,222,16
"77ecef8eff6b4a2caea7707669bf7475","77ecef8eff6b4a2caea7707669bf7475",22852860,12,0,1,637,222,222,0
"77ecef8eff6b4a2caea7707669bf7475","d03cb855c70044cf8c35d9ec0de696e3",22852860,1,3,0,649,222,224,2
"d03cb855c70044cf8c35d9ec0de696e3","8b9ae98743bd4d4a8a87dff1c1244211",22852860,2,3,0,650,224,227,3
"8b9ae98743bd4d4a8a87dff1c1244211","1c6721b1f63f4d30ba7746ea8af02a52",22852860,1,-7,0,651,227,221,-6
"1c6721b1f63f4d30ba7746ea8af02a52","d03cb855c70044cf8c35d9ec0de696e3",22852860,2,4,0,652,221,224,3
"d03cb855c70044cf8c35d9ec0de696e3","a49a937d6896486d9a5396654abcf2e1",22852860,2,2,0,653,224,226,2
"a49a937d6896486d9a5396654abcf2e1","a49a937d6896486d9a5396654abcf2e1",22852860,4,0,1,654,226,226,0
"a49a937d6896486d9a5396654abcf2e1","8b9ae98743bd4d4a8a87dff1c1244211",22852860,1,1,0,655,226,227,1
"8b9ae98743bd4d4a8a87dff1c1244211","8b9ae98743bd4d4a8a87dff1c1244211",22852860,17,0,1,656,227,227,0
"8b9ae98743bd4d4a8a87dff1c1244211","f7906d6f59b9489a91d2ef40db5a474d",22852860,1,-4,0,673,227,223,-4
"f7906d6f59b9489a91d2ef40db5a474d","2ab1535aac1346ba8801535bf729ef37",22852860,3,7,0,674,223,229,6
"2ab1535aac1346ba8801535bf729ef37","2ab1535aac1346ba8801535bf729ef37",22852860,3,0,1,675,229,229,0
"2ab1535aac1346ba8801535bf729ef37","a4f40fb48a8542c8949bae1f002cd9bc",22852860,1,2,0,678,229,231,2
"a4f40fb48a8542c8949bae1f002cd9bc","a4f40fb48a8542c8949bae1f002cd9bc",22852860,2,0,1,679,231,231,0
"a4f40fb48a8542c8949bae1f002cd9bc","8972c23e32044edb8a78fa1eed4e5947",22852860,1,1,0,681,231,232,1
"8972c23e32044edb8a78fa1eed4e5947","8972c23e32044edb8a78fa1eed4e5947",22852860,1,0,1,682,232,232,0
"8972c23e32044edb8a78fa1eed4e5947","92feb4a40f8344d38b6f722e42a53295",22852860,1,1,0,683,232,233,1
"92feb4a40f8344d38b6f722e42a53295","92feb4a40f8344d38b6f722e42a53295",22852860,2,0,1,684,233,233,0
"92feb4a40f8344d38b6f722e42a53295","5152833676bf4c6cb317060be10f68db",22852860,1,-5,0,686,233,228,-5
"5152833676bf4c6cb317060be10f68db","ca3e28f290354c08aefe5b0f769604e6",22852860,1,8,0,687,228,235,7
"ca3e28f290354c08aefe5b0f769604e6","ca3e28f290354c08aefe5b0f769604e6",22852860,4,0,1,688,235,235,0
"ca3e28f290354c08aefe5b0f769604e6","79a35eea833e4c2c9d22fc53c3c6445c",22852860,1,1,0,692,235,236,1
"79a35eea833e4c2c9d22fc53c3c6445c","79a35eea833e4c2c9d22fc53c3c6445c",22852860,4,0,1,693,236,236,0
"79a35eea833e4c2c9d22fc53c3c6445c","8f68228b1518449e9615cdafee41a2bd",22852860,1,1,0,697,236,237,1
"8f68228b1518449e9615cdafee41a2bd","8f68228b1518449e9615cdafee41a2bd",22852860,1,0,1,698,237,237,0
"8f68228b1518449e9615cdafee41a2bd","cab89fa5c3ed45a5aa550fc0352d6a42",22852860,1,1,0,699,237,238,1
"cab89fa5c3ed45a5aa550fc0352d6a42","cab89fa5c3ed45a5aa550fc0352d6a42",22852860,5,0,1,700,238,238,0
"cab89fa5c3ed45a5aa550fc0352d6a42","66d4fad4f1cf4b46be0750a99ad7a35a",22852860,1,1,0,705,238,239,1
"66d4fad4f1cf4b46be0750a99ad7a35a","66d4fad4f1cf4b46be0750a99ad7a35a",22852860,1,0,1,706,239,239,0
"66d4fad4f1cf4b46be0750a99ad7a35a","0b04c8e2f86d48c7aeb7e225819cd32b",22852860,1,-5,0,707,239,234,-5
"0b04c8e2f86d48c7aeb7e225819cd32b","f53da5fd9bfe412da4b80d4742563b6c",22852860,1,8,0,708,234,241,7
"f53da5fd9bfe412da4b80d4742563b6c","f53da5fd9bfe412da4b80d4742563b6c",22852860,1,0,1,709,241,241,0
"f53da5fd9bfe412da4b80d4742563b6c","1c6721b1f63f4d30ba7746ea8af02a52",22852860,1,-24,0,710,241,221,-20
"1c6721b1f63f4d30ba7746ea8af02a52","2ae94c0cea4d480a9d5dca8fb1d7b542",22852860,1,27,0,711,221,242,21
"2ae94c0cea4d480a9d5dca8fb1d7b542","1ebf23f9d994469a85206e4c7b1bf5f5",22852860,2,3,0,712,242,245,3
"1ebf23f9d994469a85206e4c7b1bf5f5","0c7262dff33c4087bc660ccf40f92f9c",22852860,1,-100,0,713,245,169,-76
"0c7262dff33c4087bc660ccf40f92f9c","f7906d6f59b9489a91d2ef40db5a474d",22852860,1,73,0,714,169,223,54
"f7906d6f59b9489a91d2ef40db5a474d","1c6721b1f63f4d30ba7746ea8af02a52",22852860,1,-3,0,715,223,221,-2
"8b9ae98743bd4d4a8a87dff1c1244211","a49a937d6896486d9a5396654abcf2e1",22852860,1,-1,0,718,227,226,-1
"a49a937d6896486d9a5396654abcf2e1","d03cb855c70044cf8c35d9ec0de696e3",22852860,1,-2,0,721,226,224,-2
"d03cb855c70044cf8c35d9ec0de696e3","d03cb855c70044cf8c35d9ec0de696e3",22852860,4,0,1,722,224,224,0
"d03cb855c70044cf8c35d9ec0de696e3","2ab1535aac1346ba8801535bf729ef37",22852860,1,6,0,724,224,229,5
"2ab1535aac1346ba8801535bf729ef37","f7906d6f59b9489a91d2ef40db5a474d",22852860,1,-7,0,725,229,223,-6
"f7906d6f59b9489a91d2ef40db5a474d","0c7262dff33c4087bc660ccf40f92f9c",22852860,1,-73,0,726,223,169,-54
"0c7262dff33c4087bc660ccf40f92f9c","2ae94c0cea4d480a9d5dca8fb1d7b542",22852860,1,97,0,727,169,242,73
"2ae94c0cea4d480a9d5dca8fb1d7b542","2ae94c0cea4d480a9d5dca8fb1d7b542",22852860,1,0,1,728,242,242,0
"1ebf23f9d994469a85206e4c7b1bf5f5","1ebf23f9d994469a85206e4c7b1bf5f5",22852860,10,0,1,730,245,245,0
"1ebf23f9d994469a85206e4c7b1bf5f5","2ae94c0cea4d480a9d5dca8fb1d7b542",22852860,1,-3,0,740,245,242,-3
"2ae94c0cea4d480a9d5dca8fb1d7b542","fa235f0f364d47e4ae1c87f47bf8e6ba",22852860,2,12,0,741,242,252,10
"fa235f0f364d47e4ae1c87f47bf8e6ba","6e83e23f56544a19b94067c1c558d9c0",22852860,1,-6,0,742,252,247,-5
"6e83e23f56544a19b94067c1c558d9c0","1ebf23f9d994469a85206e4c7b1bf5f5",22852860,1,-3,0,743,247,245,-2
"1ebf23f9d994469a85206e4c7b1bf5f5","85ae675b83e8422da842cfd25596af99",22852860,1,1,0,744,245,246,1
"85ae675b83e8422da842cfd25596af99","85ae675b83e8422da842cfd25596af99",22852860,1,0,1,745,246,246,0
"85ae675b83e8422da842cfd25596af99","2ae94c0cea4d480a9d5dca8fb1d7b542",22852860,1,-4,0,746,246,242,-4
"fa235f0f364d47e4ae1c87f47bf8e6ba","fa235f0f364d47e4ae1c87f47bf8e6ba",22852860,7,0,1,748,252,252,0
"fa235f0f364d47e4ae1c87f47bf8e6ba","79f7845465cc4ed19d8e4f1429541be0",22852860,1,2,0,755,252,254,2
"79f7845465cc4ed19d8e4f1429541be0","79f7845465cc4ed19d8e4f1429541be0",22852860,2,0,1,756,254,254,0
"79f7845465cc4ed19d8e4f1429541be0","00f61990949545828dd12f1303d47504",22852860,1,3,0,758,254,256,2
"00f61990949545828dd12f1303d47504","6e83e23f56544a19b94067c1c558d9c0",22852860,1,-11,0,759,256,247,-9
"00f61990949545828dd12f1303d47504","ead7bb4b64e247d2ae632ab8a296b091",22852860,1,2,0,761,256,258,2
"ead7bb4b64e247d2ae632ab8a296b091","ead7bb4b64e247d2ae632ab8a296b091",22852860,2,0,1,762,258,258,0
"ead7bb4b64e247d2ae632ab8a296b091","41b0048dde734bb280bac6116baa8e27",22852860,1,1,0,764,258,259,1
"41b0048dde734bb280bac6116baa8e27","41b0048dde734bb280bac6116baa8e27",22852860,2,0,1,765,259,259,0
"41b0048dde734bb280bac6116baa8e27","b41c5a094a604ee0915327da5cc0beb7",22852860,1,1,0,767,259,260,1
"b41c5a094a604ee0915327da5cc0beb7","b41c5a094a604ee0915327da5cc0beb7",22852860,2,0,1,768,260,260,0
"b41c5a094a604ee0915327da5cc0beb7","d546341988904f069cfa86b21457d9d9",22852860,1,-10,0,770,260,251,-9
"d546341988904f069cfa86b21457d9d9","28c171777c52431ab6b925073bd63d46",22852860,1,15,0,771,251,264,13
"28c171777c52431ab6b925073bd63d46","28c171777c52431ab6b925073bd63d46",22852860,3,0,1,772,264,264,0
"28c171777c52431ab6b925073bd63d46","ac160db940cb49ae8579162b1d52bb5d",22852860,1,2,0,775,264,266,2
"ac160db940cb49ae8579162b1d52bb5d","ac160db940cb49ae8579162b1d52bb5d",22852860,3,0,1,776,266,266,0
"ac160db940cb49ae8579162b1d52bb5d","d989ebcfc12a4b669f0100dc1aa14f1e",22852860,1,-12,0,779,266,255,-11
"d989ebcfc12a4b669f0100dc1aa14f1e","c6fd49b485cc4874b0bbdd9c6171e09c",22852860,1,15,0,780,255,268,13
"c6fd49b485cc4874b0bbdd9c6171e09c","c6fd49b485cc4874b0bbdd9c6171e09c",22852860,3,0,1,781,268,268,0
"c6fd49b485cc4874b0bbdd9c6171e09c","44240778a97c4af0937817499b75707b",22852860,1,1,0,784,268,269,1
"44240778a97c4af0937817499b75707b","44240778a97c4af0937817499b75707b",22852860,1,0,1,785,269,269,0
"44240778a97c4af0937817499b75707b","7aa76d3e993840d8805f097cbdbcd44b",22852860,1,-9,0,786,269,261,-8
"7aa76d3e993840d8805f097cbdbcd44b","44240778a97c4af0937817499b75707b",22852860,1,9,0,787,261,269,8
"44240778a97c4af0937817499b75707b","865a4d3b43374da7944dc7d397f566d9",22852860,1,3,0,788,269,271,2
"865a4d3b43374da7944dc7d397f566d9","865a4d3b43374da7944dc7d397f566d9",22852860,1,0,1,789,271,271,0
"865a4d3b43374da7944dc7d397f566d9","2ae94c0cea4d480a9d5dca8fb1d7b542",22852860,1,-35,0,790,271,242,-29
"2ae94c0cea4d480a9d5dca8fb1d7b542","0d987bed3ffa4ed0b9a2e62e97b7b30f",22852860,1,38,0,791,242,272,30
"0d987bed3ffa4ed0b9a2e62e97b7b30f","0c7262dff33c4087bc660ccf40f92f9c",22852860,1,-135,0,792,272,169,-103
"0c7262dff33c4087bc660ccf40f92f9c","362fcb0699a14845ab29b2340093e528",22852860,1,6,0,793,169,174,5
"362fcb0699a14845ab29b2340093e528","b42cc17b7de840f181a704558d0bc845",22852860,1,1,0,794,174,175,1
"b42cc17b7de840f181a704558d0bc845","362fcb0699a14845ab29b2340093e528",22852860,1,-1,0,795,175,174,-1
"362fcb0699a14845ab29b2340093e528","b87c552dd247427abe6ab5795b9c9d43",22852860,1,8,0,796,174,181,7
"ea38cc0e6e6e41edbabf210220808bf9","139b097acfca451689d80c9c6eebdf7b",22852860,1,-1,0,798,179,178,-1
"139b097acfca451689d80c9c6eebdf7b","1c6721b1f63f4d30ba7746ea8af02a52",22852860,1,59,0,799,178,221,43
"1c6721b1f63f4d30ba7746ea8af02a52","f7906d6f59b9489a91d2ef40db5a474d",22852860,1,3,0,800,221,223,2
"f7906d6f59b9489a91d2ef40db5a474d","8b9ae98743bd4d4a8a87dff1c1244211",22852860,1,4,0,801,223,227,4
"8b9ae98743bd4d4a8a87dff1c1244211","d03cb855c70044cf8c35d9ec0de696e3",22852860,2,-3,0,802,227,224,-3
"a49a937d6896486d9a5396654abcf2e1","f7906d6f59b9489a91d2ef40db5a474d",22852860,1,-3,0,805,226,223,-3
"2ab1535aac1346ba8801535bf729ef37","8b9ae98743bd4d4a8a87dff1c1244211",22852860,1,-3,0,807,229,227,-2
"d03cb855c70044cf8c35d9ec0de696e3","5152833676bf4c6cb317060be10f68db",22852860,1,5,0,809,224,228,4
"5152833676bf4c6cb317060be10f68db","d03cb855c70044cf8c35d9ec0de696e3",22852860,1,-5,0,810,228,224,-4
"d03cb855c70044cf8c35d9ec0de696e3","f7906d6f59b9489a91d2ef40db5a474d",22852860,1,-1,0,813,224,223,-1
"2ab1535aac1346ba8801535bf729ef37","0d987bed3ffa4ed0b9a2e62e97b7b30f",22852860,1,55,0,815,229,272,43
"0d987bed3ffa4ed0b9a2e62e97b7b30f","0d987bed3ffa4ed0b9a2e62e97b7b30f",22852860,2,0,1,816,272,272,0
"0d987bed3ffa4ed0b9a2e62e97b7b30f","bb5a47f5ea01454a8b79455422d3b9da",22852860,8,10,0,818,272,280,8
"bb5a47f5ea01454a8b79455422d3b9da","bb5a47f5ea01454a8b79455422d3b9da",22852860,139,0,1,819,280,280,0
"bb5a47f5ea01454a8b79455422d3b9da","82ae07bc0c9b4570a41799290d1ef399",22852860,4,-6,0,821,280,275,-5
"82ae07bc0c9b4570a41799290d1ef399","bb5a47f5ea01454a8b79455422d3b9da",22852860,6,6,0,822,275,280,5
"bb5a47f5ea01454a8b79455422d3b9da","0d987bed3ffa4ed0b9a2e62e97b7b30f",22852860,3,-10,0,827,280,272,-8
"0d987bed3ffa4ed0b9a2e62e97b7b30f","82ae07bc0c9b4570a41799290d1ef399",22852860,2,4,0,828,272,275,3
"82ae07bc0c9b4570a41799290d1ef399","0d987bed3ffa4ed0b9a2e62e97b7b30f",22852860,1,-4,0,829,275,272,-3
"bb5a47f5ea01454a8b79455422d3b9da","bc5524e78a8544e2ae2fdc2f3462bbec",22852860,8,-1,0,841,280,279,-1
"bc5524e78a8544e2ae2fdc2f3462bbec","82ae07bc0c9b4570a41799290d1ef399",22852860,1,-5,0,842,279,275,-4
"bc5524e78a8544e2ae2fdc2f3462bbec","0d987bed3ffa4ed0b9a2e62e97b7b30f",22852860,5,-9,0,857,279,272,-7
"bc5524e78a8544e2ae2fdc2f3462bbec","bb5a47f5ea01454a8b79455422d3b9da",22852860,2,1,0,889,279,280,1
"bb5a47f5ea01454a8b79455422d3b9da","94cecc3f1e7d484b8e068e79241dfd73",22852860,1,3,0,997,280,281,1
"94cecc3f1e7d484b8e068e79241dfd73","0d987bed3ffa4ed0b9a2e62e97b7b30f",22852860,1,-13,0,998,281,272,-9
"0d987bed3ffa4ed0b9a2e62e97b7b30f","a37477c4e4c14169ad44b06b493007f6",22852860,1,15,0,999,272,283,11
"a37477c4e4c14169ad44b06b493007f6","94cecc3f1e7d484b8e068e79241dfd73",22852860,2,-2,0,1000,283,281,-2
"94cecc3f1e7d484b8e068e79241dfd73","94cecc3f1e7d484b8e068e79241dfd73",22852860,2,0,1,1001,281,281,0
"94cecc3f1e7d484b8e068e79241dfd73","a37477c4e4c14169ad44b06b493007f6",22852860,3,2,0,1002,281,283,2
"a37477c4e4c14169ad44b06b493007f6","d9c8d8c444a64dadbbb508652c721e17",22852860,1,-309,0,1005,283,46,-237
"d9c8d8c444a64dadbbb508652c721e17","b534b89233134e30a9b5645138bfa9ee",22852860,2,-6,0,1006,46,41,-5
"b534b89233134e30a9b5645138bfa9ee","6e13d61a7bdb44bca949c9f86fab3be5",22852860,4,7,0,1007,41,47,6
"6e13d61a7bdb44bca949c9f86fab3be5","d9c8d8c444a64dadbbb508652c721e17",22852860,2,-1,0,1008,47,46,-1
"d9c8d8c444a64dadbbb508652c721e17","bc42d26810654ea9a1df1efe1e58c7d5",22852860,1,20,0,1009,46,63,17
"bc42d26810654ea9a1df1efe1e58c7d5","a0a418b8540d479fa6e0f653b701da8b",22852860,4,1,0,1010,63,64,1
"a0a418b8540d479fa6e0f653b701da8b","bc42d26810654ea9a1df1efe1e58c7d5",22852860,3,-1,0,1011,64,63,-1
"bc42d26810654ea9a1df1efe1e58c7d5","bc42d26810654ea9a1df1efe1e58c7d5",22852860,6,0,1,1012,63,63,0
"a0a418b8540d479fa6e0f653b701da8b","b534b89233134e30a9b5645138bfa9ee",22852860,1,-27,0,1014,64,41,-23
"b534b89233134e30a9b5645138bfa9ee","a0a418b8540d479fa6e0f653b701da8b",22852860,1,27,0,1015,41,64,23
"a0a418b8540d479fa6e0f653b701da8b","309ccf3cc4fe429d9bfbaef53d3fa479",22852860,3,-4,0,1016,64,60,-4
"309ccf3cc4fe429d9bfbaef53d3fa479","78f30e4dcac84e3cbea8b2cc6e0d62b3",22852860,1,-2,0,1017,60,59,-1
"78f30e4dcac84e3cbea8b2cc6e0d62b3","a1f2f12debe5432fb7a70bcd12bacfb9",22852860,3,-1,0,1018,59,58,-1
"a1f2f12debe5432fb7a70bcd12bacfb9","f924752d8a1149668870b1e7698486f7",22852860,1,-9,0,1019,58,50,-8
"f924752d8a1149668870b1e7698486f7","b534b89233134e30a9b5645138bfa9ee",22852860,1,-11,0,1020,50,41,-9
"b534b89233134e30a9b5645138bfa9ee","d0c74f735e024943943e40333d6d337f",22852860,1,12,0,1021,41,51,10
"d0c74f735e024943943e40333d6d337f","f924752d8a1149668870b1e7698486f7",22852860,2,-1,0,1022,51,50,-1
"f924752d8a1149668870b1e7698486f7","6e13d61a7bdb44bca949c9f86fab3be5",22852860,1,-4,0,1023,50,47,-3
"6e13d61a7bdb44bca949c9f86fab3be5","94cecc3f1e7d484b8e068e79241dfd73",22852860,1,306,0,1024,47,281,234
"a37477c4e4c14169ad44b06b493007f6","a49d1bb4328949299686242fd0be5584",22852860,1,-357,0,1027,283,21,-262
"a49d1bb4328949299686242fd0be5584","b7719e26494940efa49512aedd0aac79",22852860,1,-2,0,1028,21,20,-1
"b7719e26494940efa49512aedd0aac79","b7719e26494940efa49512aedd0aac79",22852860,1,0,1,1029,20,20,0
"b7719e26494940efa49512aedd0aac79","afbf7250b99d47bea07172749483ca97",22852860,3,12,0,1030,20,28,8
"afbf7250b99d47bea07172749483ca97","67a089198fcb4e1c8f2385786c2b296f",22852860,1,28,0,1031,28,39,11
"67a089198fcb4e1c8f2385786c2b296f","67a089198fcb4e1c8f2385786c2b296f",22852860,2,0,1,1032,39,39,0
"67a089198fcb4e1c8f2385786c2b296f","64d48c6c9c7940639a932219a6c87198",22852860,3,1,0,1033,39,40,1
"64d48c6c9c7940639a932219a6c87198","64d48c6c9c7940639a932219a6c87198",22852860,5,0,1,1034,40,40,0
"64d48c6c9c7940639a932219a6c87198","67a089198fcb4e1c8f2385786c2b296f",22852860,3,-1,0,1035,40,39,-1
"67a089198fcb4e1c8f2385786c2b296f","b534b89233134e30a9b5645138bfa9ee",22852860,3,4,0,1036,39,41,2
"b534b89233134e30a9b5645138bfa9ee","b534b89233134e30a9b5645138bfa9ee",22852860,2,0,1,1037,41,41,0
"b534b89233134e30a9b5645138bfa9ee","67a089198fcb4e1c8f2385786c2b296f",22852860,1,-4,0,1038,41,39,-2
"6e13d61a7bdb44bca949c9f86fab3be5","d0c74f735e024943943e40333d6d337f",22852860,1,5,0,1046,47,51,4
"d0c74f735e024943943e40333d6d337f","d9c8d8c444a64dadbbb508652c721e17",22852860,1,-6,0,1047,51,46,-5
"d9c8d8c444a64dadbbb508652c721e17","d0c74f735e024943943e40333d6d337f",22852860,3,6,0,1048,46,51,5
"d0c74f735e024943943e40333d6d337f","78f30e4dcac84e3cbea8b2cc6e0d62b3",22852860,1,9,0,1049,51,59,8
"78f30e4dcac84e3cbea8b2cc6e0d62b3","f924752d8a1149668870b1e7698486f7",22852860,1,-10,0,1050,59,50,-9
"f924752d8a1149668870b1e7698486f7","a1f2f12debe5432fb7a70bcd12bacfb9",22852860,2,9,0,1051,50,58,8
"a1f2f12debe5432fb7a70bcd12bacfb9","a0a418b8540d479fa6e0f653b701da8b",22852860,1,7,0,1052,58,64,6
"bc42d26810654ea9a1df1efe1e58c7d5","12aa6e1672ac4e7aa6449a7a8609cd72",22852860,2,-7,0,1054,63,57,-6
"12aa6e1672ac4e7aa6449a7a8609cd72","bc42d26810654ea9a1df1efe1e58c7d5",22852860,2,7,0,1055,57,63,6
"a0a418b8540d479fa6e0f653b701da8b","a0a418b8540d479fa6e0f653b701da8b",22852860,6,0,1,1058,64,64,0
"309ccf3cc4fe429d9bfbaef53d3fa479","d646286c8051419bbc2e31dd1db55ca8",22852860,2,10,0,1060,60,67,7
"d646286c8051419bbc2e31dd1db55ca8","b534b89233134e30a9b5645138bfa9ee",22852860,2,-33,0,1061,67,41,-26
"b534b89233134e30a9b5645138bfa9ee","d646286c8051419bbc2e31dd1db55ca8",22852860,2,33,0,1062,41,67,26
"d646286c8051419bbc2e31dd1db55ca8","a2becd407db34b189200a32546d9d569",22852860,2,9,0,1063,67,75,8
"a2becd407db34b189200a32546d9d569","a2becd407db34b189200a32546d9d569",22852860,6,0,1,1064,75,75,0
"a2becd407db34b189200a32546d9d569","140d5b27b8574befad82c0a013b59dfa",22852860,1,-1,0,1065,75,74,-1
"140d5b27b8574befad82c0a013b59dfa","d18a9ea32855445f8736581f5cb119ce",22852860,3,9,0,1066,74,82,8
"d18a9ea32855445f8736581f5cb119ce","ae5ac430ea254e708a6f5deaaf7464ae",22852860,2,3,0,1067,82,84,2
"ae5ac430ea254e708a6f5deaaf7464ae","6a9f0ef185fb47f0937e29daa1c71ed5",22852860,4,7,0,1068,84,90,6
"6a9f0ef185fb47f0937e29daa1c71ed5","6a9f0ef185fb47f0937e29daa1c71ed5",22852860,7,0,1,1069,90,90,0
"6a9f0ef185fb47f0937e29daa1c71ed5","d646286c8051419bbc2e31dd1db55ca8",22852860,3,-27,0,1071,90,67,-23
"d646286c8051419bbc2e31dd1db55ca8","e20db35ced8544ddac5bc3839145e463",22852860,3,30,0,1072,67,91,24
"e20db35ced8544ddac5bc3839145e463","d391c8b6e56a43a7b654e9dee02d904b",22852860,2,13,0,1073,91,103,12
"d391c8b6e56a43a7b654e9dee02d904b","e20db35ced8544ddac5bc3839145e463",22852860,1,-13,0,1074,103,91,-12
"e20db35ced8544ddac5bc3839145e463","00ae5f0c51874a73a41ebea838d95682",22852860,3,11,0,1075,91,101,10
"00ae5f0c51874a73a41ebea838d95682","00ae5f0c51874a73a41ebea838d95682",22852860,1,0,1,1076,101,101,0
"00ae5f0c51874a73a41ebea838d95682","4280927ec4d643238aa49c32f9e06c6c",22852860,1,9,0,1077,101,109,8
"4280927ec4d643238aa49c32f9e06c6c","73039f8c1eb9409cb4caee2cf968001e",22852860,3,-10,0,1078,109,100,-9
"73039f8c1eb9409cb4caee2cf968001e","4280927ec4d643238aa49c32f9e06c6c",22852860,2,10,0,1079,100,109,9
"4280927ec4d643238aa49c32f9e06c6c","08111f75e22d409998cf8b85bd431f0a",22852860,1,-1,0,1080,109,108,-1
"08111f75e22d409998cf8b85bd431f0a","a9ae0a3c070d455bb4369a8996313336",22852860,4,7,0,1081,108,114,6
"a9ae0a3c070d455bb4369a8996313336","37319e88176d4aefa91d7a9980dbae91",22852860,1,-2,0,1082,114,112,-2
"37319e88176d4aefa91d7a9980dbae91","62bff51286ef4f348717a3cf6fe2318f",22852860,1,9,0,1083,112,120,8
"62bff51286ef4f348717a3cf6fe2318f","e20db35ced8544ddac5bc3839145e463",22852860,1,-33,0,1084,120,91,-29
"e20db35ced8544ddac5bc3839145e463","779f9ddd1fd14d1e9e69f72219a1fdbd",22852860,3,36,0,1085,91,121,30
"779f9ddd1fd14d1e9e69f72219a1fdbd","779f9ddd1fd14d1e9e69f72219a1fdbd",22852860,2,0,1,1086,121,121,0
"779f9ddd1fd14d1e9e69f72219a1fdbd","a8dd5213034441ac92724b4e83eb0bb2",22852860,3,9,0,1087,121,129,8
"a8dd5213034441ac92724b4e83eb0bb2","a8dd5213034441ac92724b4e83eb0bb2",22852860,2,0,1,1088,129,129,0
"a8dd5213034441ac92724b4e83eb0bb2","579338175e0b4bbb8ef3b712b5d8b54e",22852860,2,-1,0,1089,129,128,-1
"579338175e0b4bbb8ef3b712b5d8b54e","b416d47c56a742199b5d7c7f19d6503a",22852860,2,7,0,1090,128,134,6
"b416d47c56a742199b5d7c7f19d6503a","779f9ddd1fd14d1e9e69f72219a1fdbd",22852860,2,-15,0,1091,134,121,-13
"779f9ddd1fd14d1e9e69f72219a1fdbd","df1de691dafe4549a18a4398ee9dfaf9",22852860,3,23,0,1092,121,139,18
"df1de691dafe4549a18a4398ee9dfaf9","6c5ad271a44743479bfaea29b1db8d02",22852860,3,4,0,1093,139,143,4
"6c5ad271a44743479bfaea29b1db8d02","6c5ad271a44743479bfaea29b1db8d02",22852860,3,0,1,1094,143,143,0
"6c5ad271a44743479bfaea29b1db8d02","df1de691dafe4549a18a4398ee9dfaf9",22852860,1,-4,0,1096,143,139,-4
"df1de691dafe4549a18a4398ee9dfaf9","8aae34f5ddbb4052a709b12e6b0d40fa",22852860,2,9,0,1097,139,147,8
"8aae34f5ddbb4052a709b12e6b0d40fa","8aae34f5ddbb4052a709b12e6b0d40fa",22852860,2,0,1,1098,147,147,0
"8aae34f5ddbb4052a709b12e6b0d40fa","f902b0f41b544d4dbf79664fd233648d",22852860,1,-1,0,1099,147,146,-1
"f902b0f41b544d4dbf79664fd233648d","d313cec988a84645bee413e8d4724a4b",22852860,2,14,0,1100,146,158,12
"d313cec988a84645bee413e8d4724a4b","f03480cf4eba413194d7af52fc0e7f28",22852860,2,-7,0,1101,158,152,-6
"f03480cf4eba413194d7af52fc0e7f28","d313cec988a84645bee413e8d4724a4b",22852860,3,7,0,1102,152,158,6
"d313cec988a84645bee413e8d4724a4b","d313cec988a84645bee413e8d4724a4b",22852860,6,0,1,1103,158,158,0
"d313cec988a84645bee413e8d4724a4b","df1de691dafe4549a18a4398ee9dfaf9",22852860,2,-22,0,1104,158,139,-19
"df1de691dafe4549a18a4398ee9dfaf9","78adeee1fa2c4fe0bc73f7bca9fcee86",22852860,3,26,0,1105,139,160,21
"78adeee1fa2c4fe0bc73f7bca9fcee86","65202579580f4ad38d734b4ee39d22a8",22852860,6,5,0,1106,160,164,4
"65202579580f4ad38d734b4ee39d22a8","65202579580f4ad38d734b4ee39d22a8",22852860,72,0,1,1107,164,164,0
"65202579580f4ad38d734b4ee39d22a8","78adeee1fa2c4fe0bc73f7bca9fcee86",22852860,4,-5,0,1108,164,160,-4
"65202579580f4ad38d734b4ee39d22a8","3cbcea2be0984e7dbd5a48195af10ce7",22852860,1,3,0,1137,164,165,1
"3cbcea2be0984e7dbd5a48195af10ce7","78adeee1fa2c4fe0bc73f7bca9fcee86",22852860,1,-8,0,1138,165,160,-5
"78adeee1fa2c4fe0bc73f7bca9fcee86","82e6285962b8400d9d6fc32436022a94",22852860,1,10,0,1139,160,167,7
"82e6285962b8400d9d6fc32436022a94","78adeee1fa2c4fe0bc73f7bca9fcee86",22852860,1,-10,0,1140,167,160,-7
"65202579580f4ad38d734b4ee39d22a8","fab84b4fab5940efb4ea868ef8d09396",22852860,1,165,0,1149,164,284,120
"fab84b4fab5940efb4ea868ef8d09396","fab84b4fab5940efb4ea868ef8d09396",22852860,2,0,1,1150,284,284,0
"fab84b4fab5940efb4ea868ef8d09396","4a29443515bb404cb8924e1c60a63b73",22852860,1,4,0,1151,284,285,1
"4a29443515bb404cb8924e1c60a63b73","fab84b4fab5940efb4ea868ef8d09396",22852860,1,-4,0,1152,285,284,-1
"fab84b4fab5940efb4ea868ef8d09396","208c9b2796c944db8dacaa96082520ea",22852860,1,7,0,1153,284,288,4
"208c9b2796c944db8dacaa96082520ea","208c9b2796c944db8dacaa96082520ea",22852860,1,0,1,1154,288,288,0
"208c9b2796c944db8dacaa96082520ea","4a29443515bb404cb8924e1c60a63b73",22852860,1,-3,0,1155,288,285,-3
"4a29443515bb404cb8924e1c60a63b73","7669a956527947d0add87455277e80b4",22852860,1,7,0,1156,285,291,6
"7669a956527947d0add87455277e80b4","7669a956527947d0add87455277e80b4",22852860,1,0,1,1157,291,291,0
"7669a956527947d0add87455277e80b4","6a9a3b5bde4a48daa896fe8c06eca56f",22852860,1,-2,0,1158,291,289,-2
"6a9a3b5bde4a48daa896fe8c06eca56f","869e967078f04da18dd0b0b9389a7424",22852860,2,5,0,1159,289,293,4
"869e967078f04da18dd0b0b9389a7424","869e967078f04da18dd0b0b9389a7424",22852860,1,0,1,1160,293,293,0
"869e967078f04da18dd0b0b9389a7424","51ab6291537748fab90d519aa09889d6",22852860,1,2,0,1161,293,295,2
"51ab6291537748fab90d519aa09889d6","51ab6291537748fab90d519aa09889d6",22852860,5,0,1,1162,295,295,0
"51ab6291537748fab90d519aa09889d6","34a6e49023fc4465bd5ca604330bbd1c",22852860,1,-3,0,1167,295,292,-3
"34a6e49023fc4465bd5ca604330bbd1c","21592f2a9e9c4b2f8c66ec5dbcbf6a2b",22852860,1,5,0,1168,292,296,4
"21592f2a9e9c4b2f8c66ec5dbcbf6a2b","ba0e59461bfb4a44b7b1c28a01f8d3b3",22852860,1,4,0,1169,296,299,3
"ba0e59461bfb4a44b7b1c28a01f8d3b3","ba0e59461bfb4a44b7b1c28a01f8d3b3",22852860,1,0,1,1170,299,299,0
"ba0e59461bfb4a44b7b1c28a01f8d3b3","0e0b36e731a645e7b1b8a88f5031ca38",22852860,1,2,0,1171,299,301,2
"0e0b36e731a645e7b1b8a88f5031ca38","0e0b36e731a645e7b1b8a88f5031ca38",22852860,2,0,1,1172,301,301,0
"0e0b36e731a645e7b1b8a88f5031ca38","a66a144637284c21afc6de17fea4bfb8",22852860,1,1,0,1174,301,302,1
"a66a144637284c21afc6de17fea4bfb8","a66a144637284c21afc6de17fea4bfb8",22852860,2,0,1,1175,302,302,0
"a66a144637284c21afc6de17fea4bfb8","7646a919d7e64fa990bca9b024ff089d",22852860,1,-4,0,1177,302,298,-4
"7646a919d7e64fa990bca9b024ff089d","e390b575229748ea8aac9364efe2bf00",22852860,1,7,0,1178,298,304,6
"e390b575229748ea8aac9364efe2bf00","e390b575229748ea8aac9364efe2bf00",22852860,1,0,1,1179,304,304,0
"e390b575229748ea8aac9364efe2bf00","3434c10e561d488a914e0f7d71907abd",22852860,1,3,0,1180,304,305,1
"3434c10e561d488a914e0f7d71907abd","4a29443515bb404cb8924e1c60a63b73",22852860,2,-27,0,1181,305,285,-20
"4a29443515bb404cb8924e1c60a63b73","53e7e900392747ccad52e711ab0f80d8",22852860,2,29,0,1182,285,307,22
"53e7e900392747ccad52e711ab0f80d8","53e7e900392747ccad52e711ab0f80d8",22852860,3,0,1,1183,307,307,0
"53e7e900392747ccad52e711ab0f80d8","3434c10e561d488a914e0f7d71907abd",22852860,2,-2,0,1184,307,305,-2
"3434c10e561d488a914e0f7d71907abd","53e7e900392747ccad52e711ab0f80d8",22852860,3,2,0,1185,305,307,2
"53e7e900392747ccad52e711ab0f80d8","130acc2aeb0448fdbb2de63bc5cebe5b",22852860,3,3,0,1186,307,309,2
"130acc2aeb0448fdbb2de63bc5cebe5b","3434c10e561d488a914e0f7d71907abd",22852860,3,-5,0,1187,309,305,-4
"3434c10e561d488a914e0f7d71907abd","130acc2aeb0448fdbb2de63bc5cebe5b",22852860,2,5,0,1188,305,309,4
"130acc2aeb0448fdbb2de63bc5cebe5b","9c062b3251034ebe90f5054e2a3b5120",22852860,1,2,0,1189,309,311,2
"9c062b3251034ebe90f5054e2a3b5120","9c062b3251034ebe90f5054e2a3b5120",22852860,2,0,1,1190,311,311,0
"9c062b3251034ebe90f5054e2a3b5120","ea859f8207e44537889daeaba13ac2e8",22852860,1,1,0,1192,311,312,1
"ea859f8207e44537889daeaba13ac2e8","ea859f8207e44537889daeaba13ac2e8",22852860,1,0,1,1193,312,312,0
"ea859f8207e44537889daeaba13ac2e8","56d94971a7a94257aa330183a8ebd0ea",22852860,1,1,0,1194,312,313,1
"56d94971a7a94257aa330183a8ebd0ea","56d94971a7a94257aa330183a8ebd0ea",22852860,4,0,1,1195,313,313,0
"56d94971a7a94257aa330183a8ebd0ea","141c0df6cd1946539aadd1c9b7068cd4",22852860,1,-5,0,1199,313,308,-5
"141c0df6cd1946539aadd1c9b7068cd4","13255e63e0aa4abf85e5211bf613d43e",22852860,1,10,0,1200,308,317,9
"13255e63e0aa4abf85e5211bf613d43e","13255e63e0aa4abf85e5211bf613d43e",22852860,1,0,1,1201,317,317,0
"13255e63e0aa4abf85e5211bf613d43e","0c787d16c9504873b1a4d903cec09948",22852860,1,-3,0,1202,317,314,-3
"0c787d16c9504873b1a4d903cec09948","86c27d40179e419c8e9d150fb6afa5d0",22852860,1,6,0,1203,314,319,5
"86c27d40179e419c8e9d150fb6afa5d0","86c27d40179e419c8e9d150fb6afa5d0",22852860,1,0,1,1204,319,319,0
"86c27d40179e419c8e9d150fb6afa5d0","24f1363179ad4aaa965484a78471912b",22852860,1,5,0,1205,319,323,4
"24f1363179ad4aaa965484a78471912b","47edbb64109243e6b0f8f64cdef90c6c",22852860,1,3,0,1206,323,326,3
"47edbb64109243e6b0f8f64cdef90c6c","8d7e0b55cf9849cda222a0f2440cec55",22852860,1,-9,0,1207,326,318,-8
"8d7e0b55cf9849cda222a0f2440cec55","24f1363179ad4aaa965484a78471912b",22852860,1,6,0,1208,318,323,5
"24f1363179ad4aaa965484a78471912b","3628bdce1dd2429ba924d2d4d09448d2",22852860,2,-1,0,1209,323,322,-1
"3628bdce1dd2429ba924d2d4d09448d2","56b3fd1a212a4764be39d979fde3326e",22852860,1,7,0,1210,322,328,6
"56b3fd1a212a4764be39d979fde3326e","56b3fd1a212a4764be39d979fde3326e",22852860,1,0,1,1211,328,328,0
"56b3fd1a212a4764be39d979fde3326e","3434c10e561d488a914e0f7d71907abd",22852860,1,-28,0,1212,328,305,-23
"3434c10e561d488a914e0f7d71907abd","0c4079457ede49e3aeb5e86ed84bdf35",22852860,3,31,0,1213,305,329,24
"0c4079457ede49e3aeb5e86ed84bdf35","38aea304b4fa46e1b29bb72f5cea4c93",22852860,1,2,0,1214,329,331,2
"38aea304b4fa46e1b29bb72f5cea4c93","38aea304b4fa46e1b29bb72f5cea4c93",22852860,1,0,1,1215,331,331,0
"38aea304b4fa46e1b29bb72f5cea4c93","e36d261332f14e79bb4b467aceaeb9b5",22852860,1,2,0,1216,331,333,2
"e36d261332f14e79bb4b467aceaeb9b5","e36d261332f14e79bb4b467aceaeb9b5",22852860,1,0,1,1217,333,333,0
"e36d261332f14e79bb4b467aceaeb9b5","c7e89b9d04744d2eab742fc24e3ef1ae",22852860,1,1,0,1218,333,334,1
"c7e89b9d04744d2eab742fc24e3ef1ae","c7e89b9d04744d2eab742fc24e3ef1ae",22852860,2,0,1,1219,334,334,0
"c7e89b9d04744d2eab742fc24e3ef1ae","fe49f8054b374a0ea4bb266ed135ff62",22852860,1,1,0,1221,334,335,1
"fe49f8054b374a0ea4bb266ed135ff62","fe49f8054b374a0ea4bb266ed135ff62",22852860,2,0,1,1222,335,335,0
"fe49f8054b374a0ea4bb266ed135ff62","d0a8f74af98642fe8360d22c42e45117",22852860,1,1,0,1224,335,336,1
"d0a8f74af98642fe8360d22c42e45117","d0a8f74af98642fe8360d22c42e45117",22852860,2,0,1,1225,336,336,0
"d0a8f74af98642fe8360d22c42e45117","0c4079457ede49e3aeb5e86ed84bdf35",22852860,1,-7,0,1227,336,329,-7
"0c4079457ede49e3aeb5e86ed84bdf35","a7c6339ca1da4368a18d471f0519f877",22852860,1,11,0,1228,329,339,10
"a7c6339ca1da4368a18d471f0519f877","a7c6339ca1da4368a18d471f0519f877",22852860,1,0,1,1229,339,339,0
"a7c6339ca1da4368a18d471f0519f877","bbc5139ca9024389a94db3a6f47dcff6",22852860,1,3,0,1230,339,341,2
"bbc5139ca9024389a94db3a6f47dcff6","b8b9418ab322418d9db9b40d96af873a",22852860,1,-5,0,1231,341,337,-4
"b8b9418ab322418d9db9b40d96af873a","bbc5139ca9024389a94db3a6f47dcff6",22852860,1,5,0,1232,337,341,4
"bbc5139ca9024389a94db3a6f47dcff6","4ee6ca9019ab4a1ab323f98094a9bd77",22852860,1,2,0,1233,341,343,2
"4ee6ca9019ab4a1ab323f98094a9bd77","4ee6ca9019ab4a1ab323f98094a9bd77",22852860,2,0,1,1234,343,343,0
"4ee6ca9019ab4a1ab323f98094a9bd77","b37947176785476f8b29d49a851366dc",22852860,1,1,0,1236,343,344,1
"b37947176785476f8b29d49a851366dc","b37947176785476f8b29d49a851366dc",22852860,2,0,1,1237,344,344,0
"b37947176785476f8b29d49a851366dc","fcea5b10d5a14a3b9324ffece8f6e1e5",22852860,1,1,0,1239,344,345,1
"fcea5b10d5a14a3b9324ffece8f6e1e5","fcea5b10d5a14a3b9324ffece8f6e1e5",22852860,2,0,1,1240,345,345,0
"fcea5b10d5a14a3b9324ffece8f6e1e5","c2490bc612d146edbe786556fab3651b",22852860,1,-5,0,1242,345,340,-5
"c2490bc612d146edbe786556fab3651b","6ac8bb048b854999a47edb35fe627f11",22852860,1,8,0,1243,340,347,7
"6ac8bb048b854999a47edb35fe627f11","6ac8bb048b854999a47edb35fe627f11",22852860,1,0,1,1244,347,347,0
"6ac8bb048b854999a47edb35fe627f11","0c4079457ede49e3aeb5e86ed84bdf35",22852860,1,-21,0,1245,347,329,-18
"0c4079457ede49e3aeb5e86ed84bdf35","30ead9794d4847abaf222ca966cc8630",22852860,5,24,0,1246,329,348,19
"30ead9794d4847abaf222ca966cc8630","c20993c944444fe085345591a8bd837e",22852860,2,3,0,1247,348,351,3
"c20993c944444fe085345591a8bd837e","897b7f51242c44aab2205c72fdcbf4cd",22852860,2,1,0,1248,351,352,1
"897b7f51242c44aab2205c72fdcbf4cd","09b9678ddc3d452ea4a3d46e15826065",22852860,2,1,0,1249,352,353,1
"09b9678ddc3d452ea4a3d46e15826065","eff0de7f2dbb42dfa1a2e686efab5b6d",22852860,2,1,0,1250,353,354,1
"eff0de7f2dbb42dfa1a2e686efab5b6d","4a29443515bb404cb8924e1c60a63b73",22852860,1,-88,0,1251,354,285,-69
"4a29443515bb404cb8924e1c60a63b73","4a29443515bb404cb8924e1c60a63b73",22852860,1,0,1,1252,285,285,0
"4a29443515bb404cb8924e1c60a63b73","208c9b2796c944db8dacaa96082520ea",22852860,1,3,0,1253,285,288,3
"208c9b2796c944db8dacaa96082520ea","6a9a3b5bde4a48daa896fe8c06eca56f",22852860,1,2,0,1254,288,289,1
"869e967078f04da18dd0b0b9389a7424","4a29443515bb404cb8924e1c60a63b73",22852860,1,-10,0,1256,293,285,-8
"4a29443515bb404cb8924e1c60a63b73","21592f2a9e9c4b2f8c66ec5dbcbf6a2b",22852860,1,14,0,1257,285,296,11
"21592f2a9e9c4b2f8c66ec5dbcbf6a2b","34a6e49023fc4465bd5ca604330bbd1c",22852860,1,-5,0,1258,296,292,-4
"34a6e49023fc4465bd5ca604330bbd1c","ba0e59461bfb4a44b7b1c28a01f8d3b3",22852860,1,9,0,1259,292,299,7
"ba0e59461bfb4a44b7b1c28a01f8d3b3","7646a919d7e64fa990bca9b024ff089d",22852860,1,-1,0,1260,299,298,-1
"7646a919d7e64fa990bca9b024ff089d","4a29443515bb404cb8924e1c60a63b73",22852860,1,-17,0,1261,298,285,-13
"4a29443515bb404cb8924e1c60a63b73","3434c10e561d488a914e0f7d71907abd",22852860,2,27,0,1262,285,305,20
"3434c10e561d488a914e0f7d71907abd","3434c10e561d488a914e0f7d71907abd",22852860,3,0,1,1263,305,305,0
"130acc2aeb0448fdbb2de63bc5cebe5b","130acc2aeb0448fdbb2de63bc5cebe5b",22852860,2,0,1,1268,309,309,0
"130acc2aeb0448fdbb2de63bc5cebe5b","141c0df6cd1946539aadd1c9b7068cd4",22852860,1,-1,0,1270,309,308,-1
"141c0df6cd1946539aadd1c9b7068cd4","3434c10e561d488a914e0f7d71907abd",22852860,1,-4,0,1271,308,305,-3
"3434c10e561d488a914e0f7d71907abd","141c0df6cd1946539aadd1c9b7068cd4",22852860,1,4,0,1276,305,308,3
"141c0df6cd1946539aadd1c9b7068cd4","86c27d40179e419c8e9d150fb6afa5d0",22852860,1,13,0,1277,308,319,11
"86c27d40179e419c8e9d150fb6afa5d0","0c787d16c9504873b1a4d903cec09948",22852860,1,-6,0,1278,319,314,-5
"0c787d16c9504873b1a4d903cec09948","8d7e0b55cf9849cda222a0f2440cec55",22852860,1,5,0,1279,314,318,4
"8d7e0b55cf9849cda222a0f2440cec55","47edbb64109243e6b0f8f64cdef90c6c",22852860,1,9,0,1280,318,326,8
"47edbb64109243e6b0f8f64cdef90c6c","24f1363179ad4aaa965484a78471912b",22852860,1,-3,0,1281,326,323,-3
"3628bdce1dd2429ba924d2d4d09448d2","0c4079457ede49e3aeb5e86ed84bdf35",22852860,1,10,0,1283,322,329,7
"0c4079457ede49e3aeb5e86ed84bdf35","3434c10e561d488a914e0f7d71907abd",22852860,3,-31,0,1284,329,305,-24
"3434c10e561d488a914e0f7d71907abd","38aea304b4fa46e1b29bb72f5cea4c93",22852860,2,33,0,1287,305,331,26
"38aea304b4fa46e1b29bb72f5cea4c93","30ead9794d4847abaf222ca966cc8630",22852860,1,22,0,1288,331,348,17
"30ead9794d4847abaf222ca966cc8630","30ead9794d4847abaf222ca966cc8630",22852860,3,0,1,1289,348,348,0
"30ead9794d4847abaf222ca966cc8630","eff0de7f2dbb42dfa1a2e686efab5b6d",22852860,1,6,0,1290,348,354,6
"eff0de7f2dbb42dfa1a2e686efab5b6d","897b7f51242c44aab2205c72fdcbf4cd",22852860,1,-2,0,1291,354,352,-2
"897b7f51242c44aab2205c72fdcbf4cd","c20993c944444fe085345591a8bd837e",22852860,1,-1,0,1292,352,351,-1
"c20993c944444fe085345591a8bd837e","09b9678ddc3d452ea4a3d46e15826065",22852860,3,2,0,1293,351,353,2
"09b9678ddc3d452ea4a3d46e15826065","c20993c944444fe085345591a8bd837e",22852860,1,-2,0,1294,353,351,-2
"c20993c944444fe085345591a8bd837e","c20993c944444fe085345591a8bd837e",22852860,4,0,1,1295,351,351,0
"897b7f51242c44aab2205c72fdcbf4cd","897b7f51242c44aab2205c72fdcbf4cd",22852860,5,0,1,1299,352,352,0
"09b9678ddc3d452ea4a3d46e15826065","09b9678ddc3d452ea4a3d46e15826065",22852860,4,0,1,1303,353,353,0
"eff0de7f2dbb42dfa1a2e686efab5b6d","eff0de7f2dbb42dfa1a2e686efab5b6d",22852860,4,0,1,1307,354,354,0
"eff0de7f2dbb42dfa1a2e686efab5b6d","30ead9794d4847abaf222ca966cc8630",22852860,1,-6,0,1310,354,348,-6
"30ead9794d4847abaf222ca966cc8630","2fe14166dc9642c3bc666b86a57f943d",22852860,1,10,0,1311,348,357,9
"2fe14166dc9642c3bc666b86a57f943d","2fe14166dc9642c3bc666b86a57f943d",22852860,1,0,1,1312,357,357,0
"2fe14166dc9642c3bc666b86a57f943d","44421dd1e13a47a388c4a19834b744c7",22852860,1,2,0,1313,357,359,2
"44421dd1e13a47a388c4a19834b744c7","44421dd1e13a47a388c4a19834b744c7",22852860,2,0,1,1314,359,359,0
"44421dd1e13a47a388c4a19834b744c7","cb5fc7ef85d547c4be1a7439d0bf6052",22852860,1,1,0,1316,359,360,1
"cb5fc7ef85d547c4be1a7439d0bf6052","cb5fc7ef85d547c4be1a7439d0bf6052",22852860,5,0,1,1317,360,360,0
"cb5fc7ef85d547c4be1a7439d0bf6052","0a8f150a4cf747acbde62f4721823da3",22852860,1,1,0,1322,360,361,1
"0a8f150a4cf747acbde62f4721823da3","0a8f150a4cf747acbde62f4721823da3",22852860,2,0,1,1323,361,361,0
"0a8f150a4cf747acbde62f4721823da3","ab8fdad974ae471f9f24c3f9dd04462e",22852860,1,1,0,1325,361,362,1
"ab8fdad974ae471f9f24c3f9dd04462e","ab8fdad974ae471f9f24c3f9dd04462e",22852860,2,0,1,1326,362,362,0
"ab8fdad974ae471f9f24c3f9dd04462e","1ba8fef685d74a8194b9db252eb704fb",22852860,1,-7,0,1328,362,355,-7
"1ba8fef685d74a8194b9db252eb704fb","52580888dadb4fe3baa795683ea227bd",22852860,1,10,0,1329,355,364,9
"52580888dadb4fe3baa795683ea227bd","52580888dadb4fe3baa795683ea227bd",22852860,2,0,1,1330,364,364,0
"52580888dadb4fe3baa795683ea227bd","f00179e251a045b39c3f7a54f9aa4acc",22852860,1,-1,0,1332,364,363,-1
"f00179e251a045b39c3f7a54f9aa4acc","492a3bc6a1254f23a7998587961b22a4",22852860,1,4,0,1333,363,366,3
"492a3bc6a1254f23a7998587961b22a4","492a3bc6a1254f23a7998587961b22a4",22852860,1,0,1,1334,366,366,0
"492a3bc6a1254f23a7998587961b22a4","072a190fd302456290895f9f04d6940a",22852860,1,-1,0,1335,366,365,-1
"072a190fd302456290895f9f04d6940a","cfa457d1743848e4bb5e4beced6448ed",22852860,1,5,0,1336,365,369,4
"cfa457d1743848e4bb5e4beced6448ed","cfa457d1743848e4bb5e4beced6448ed",22852860,1,0,1,1337,369,369,0
"cfa457d1743848e4bb5e4beced6448ed","30ead9794d4847abaf222ca966cc8630",22852860,1,-25,0,1338,369,348,-21
"30ead9794d4847abaf222ca966cc8630","b71bac264efb4abd97015447bd490db6",22852860,1,28,0,1339,348,370,22
"b71bac264efb4abd97015447bd490db6","b71bac264efb4abd97015447bd490db6",22852860,2,0,1,1340,370,370,0
"b71bac264efb4abd97015447bd490db6","30ead9794d4847abaf222ca966cc8630",22852860,1,-28,0,1341,370,348,-22
"09b9678ddc3d452ea4a3d46e15826065","897b7f51242c44aab2205c72fdcbf4cd",22852860,1,-1,0,1345,353,352,-1
"897b7f51242c44aab2205c72fdcbf4cd","eff0de7f2dbb42dfa1a2e686efab5b6d",22852860,1,2,0,1348,352,354,2
"eff0de7f2dbb42dfa1a2e686efab5b6d","c20993c944444fe085345591a8bd837e",22852860,1,-3,0,1349,354,351,-3
"09b9678ddc3d452ea4a3d46e15826065","c76574d21bc14aeea7ecd0b027f39858",22852860,1,18,0,1352,353,367,14
"c76574d21bc14aeea7ecd0b027f39858","eff0de7f2dbb42dfa1a2e686efab5b6d",22852860,1,-17,0,1353,367,354,-13
"eff0de7f2dbb42dfa1a2e686efab5b6d","0c4079457ede49e3aeb5e86ed84bdf35",22852860,1,-30,0,1355,354,329,-25
"30ead9794d4847abaf222ca966cc8630","c2490bc612d146edbe786556fab3651b",22852860,1,-11,0,1357,348,340,-8
"c2490bc612d146edbe786556fab3651b","4a92daef4d504e1792575a26502bb7b7",22852860,1,7,0,1358,340,346,6
"4a92daef4d504e1792575a26502bb7b7","bbc5139ca9024389a94db3a6f47dcff6",22852860,1,-6,0,1359,346,341,-5
"bbc5139ca9024389a94db3a6f47dcff6","38aea304b4fa46e1b29bb72f5cea4c93",22852860,1,-12,0,1360,341,331,-10
"38aea304b4fa46e1b29bb72f5cea4c93","b8b9418ab322418d9db9b40d96af873a",22852860,1,7,0,1361,331,337,6
"b8b9418ab322418d9db9b40d96af873a","3434c10e561d488a914e0f7d71907abd",22852860,1,-40,0,1362,337,305,-32
"0c4079457ede49e3aeb5e86ed84bdf35","0c4079457ede49e3aeb5e86ed84bdf35",22852860,4,0,1,1364,329,329,0
"38aea304b4fa46e1b29bb72f5cea4c93","0c4079457ede49e3aeb5e86ed84bdf35",22852860,1,-2,0,1367,331,329,-2
"0c4079457ede49e3aeb5e86ed84bdf35","b8b9418ab322418d9db9b40d96af873a",22852860,1,9,0,1368,329,337,8
"b8b9418ab322418d9db9b40d96af873a","0c4079457ede49e3aeb5e86ed84bdf35",22852860,1,-9,0,1369,337,329,-8
"30ead9794d4847abaf222ca966cc8630","0c4079457ede49e3aeb5e86ed84bdf35",22852860,3,-24,0,1371,348,329,-19
"0c4079457ede49e3aeb5e86ed84bdf35","b71bac264efb4abd97015447bd490db6",22852860,1,52,0,1381,329,370,41
"b71bac264efb4abd97015447bd490db6","8d448d625b024c82a5eb240bbd7431d6",22852860,4,5,0,1383,370,374,4
"8d448d625b024c82a5eb240bbd7431d6","8d448d625b024c82a5eb240bbd7431d6",22852860,69,0,1,1384,374,374,0
"8d448d625b024c82a5eb240bbd7431d6","b71bac264efb4abd97015447bd490db6",22852860,2,-5,0,1391,374,370,-4
"8d448d625b024c82a5eb240bbd7431d6","d6d02b6ef04e4f17805504500b8ce441",22852860,2,3,0,1439,374,375,1
"d6d02b6ef04e4f17805504500b8ce441","b71bac264efb4abd97015447bd490db6",22852860,2,-8,0,1440,375,370,-5
"b71bac264efb4abd97015447bd490db6","d6d02b6ef04e4f17805504500b8ce441",22852860,2,8,0,1441,370,375,5
"d6d02b6ef04e4f17805504500b8ce441","4a29443515bb404cb8924e1c60a63b73",22852860,2,-118,0,1442,375,285,-90
"3434c10e561d488a914e0f7d71907abd","fab84b4fab5940efb4ea868ef8d09396",22852860,1,-31,0,1450,305,284,-21
"fab84b4fab5940efb4ea868ef8d09396","b71bac264efb4abd97015447bd490db6",22852860,1,114,0,1452,284,370,86
"d6d02b6ef04e4f17805504500b8ce441","d6d02b6ef04e4f17805504500b8ce441",22852860,16,0,1,1465,375,375,0
"d6d02b6ef04e4f17805504500b8ce441","6e83e23f56544a19b94067c1c558d9c0",22852860,1,-172,0,1466,375,247,-128
"6e83e23f56544a19b94067c1c558d9c0","2ae94c0cea4d480a9d5dca8fb1d7b542",22852860,1,-6,0,1467,247,242,-5
"2ae94c0cea4d480a9d5dca8fb1d7b542","d6d02b6ef04e4f17805504500b8ce441",22852860,1,178,0,1468,242,375,133
"d6d02b6ef04e4f17805504500b8ce441","66baf19b6b904b70922329068c63746d",22852860,2,4,0,1472,375,376,1
"66baf19b6b904b70922329068c63746d","7f544639412e40a9ba27f43b415362ab",22852860,3,2,0,1473,376,378,2
"7f544639412e40a9ba27f43b415362ab","66baf19b6b904b70922329068c63746d",22852860,1,-2,0,1474,378,376,-2
"66baf19b6b904b70922329068c63746d","66baf19b6b904b70922329068c63746d",22852860,1,0,1,1475,376,376,0
"7f544639412e40a9ba27f43b415362ab","7f544639412e40a9ba27f43b415362ab",22852860,4,0,1,1477,378,378,0
"7f544639412e40a9ba27f43b415362ab","d5ae8642e15b46b8bd298b02274d4e9c",22852860,1,2,0,1481,378,380,2
"d5ae8642e15b46b8bd298b02274d4e9c","d5ae8642e15b46b8bd298b02274d4e9c",22852860,1,0,1,1482,380,380,0
"d5ae8642e15b46b8bd298b02274d4e9c","a0d10309a2dd456289147f84be9d37f9",22852860,1,1,0,1483,380,381,1
"a0d10309a2dd456289147f84be9d37f9","a0d10309a2dd456289147f84be9d37f9",22852860,2,0,1,1484,381,381,0
"a0d10309a2dd456289147f84be9d37f9","0fcbc3ca07b144138b8d85da581f09a8",22852860,1,1,0,1486,381,382,1
"0fcbc3ca07b144138b8d85da581f09a8","0fcbc3ca07b144138b8d85da581f09a8",22852860,8,0,1,1487,382,382,0
"0fcbc3ca07b144138b8d85da581f09a8","66baf19b6b904b70922329068c63746d",22852860,1,-6,0,1495,382,376,-6
"66baf19b6b904b70922329068c63746d","4890121ce5d74576b4632b77cfc23398",22852860,1,14,0,1496,376,388,12
"4890121ce5d74576b4632b77cfc23398","c2fca3669923477ab966ded303dea31c",22852860,1,-6,0,1497,388,383,-5
"c2fca3669923477ab966ded303dea31c","4890121ce5d74576b4632b77cfc23398",22852860,1,6,0,1498,383,388,5
"4890121ce5d74576b4632b77cfc23398","4890121ce5d74576b4632b77cfc23398",22852860,1,0,1,1499,388,388,0
"4890121ce5d74576b4632b77cfc23398","96bb2b3e85a34d8b9544514e89f6fe97",22852860,1,3,0,1500,388,390,2
"96bb2b3e85a34d8b9544514e89f6fe97","18d3b836dd804224883cc9180b60a8e1",22852860,1,-4,0,1501,390,387,-3
"18d3b836dd804224883cc9180b60a8e1","96bb2b3e85a34d8b9544514e89f6fe97",22852860,1,4,0,1502,387,390,3
"96bb2b3e85a34d8b9544514e89f6fe97","96bb2b3e85a34d8b9544514e89f6fe97",22852860,1,0,1,1503,390,390,0
"96bb2b3e85a34d8b9544514e89f6fe97","ac4e9b54acfe4670b4634859c7263cb5",22852860,2,2,0,1504,390,392,2
"ac4e9b54acfe4670b4634859c7263cb5","17f95d18bab743888e1736033dc3384d",22852860,1,-3,0,1505,392,389,-3
"17f95d18bab743888e1736033dc3384d","6f8881a745ac4c358a68b92c3b4abe81",22852860,2,6,0,1506,389,394,5
"6f8881a745ac4c358a68b92c3b4abe81","ac4e9b54acfe4670b4634859c7263cb5",22852860,1,-3,0,1507,394,392,-2
"ac4e9b54acfe4670b4634859c7263cb5","f7002c8484354eceac57bc7bd62c76c1",22852860,1,2,0,1508,392,393,1
"f7002c8484354eceac57bc7bd62c76c1","96bb2b3e85a34d8b9544514e89f6fe97",22852860,1,-4,0,1509,393,390,-3
"ac4e9b54acfe4670b4634859c7263cb5","ac4e9b54acfe4670b4634859c7263cb5",22852860,1,0,1,1511,392,392,0
"ac4e9b54acfe4670b4634859c7263cb5","6f8881a745ac4c358a68b92c3b4abe81",22852860,1,3,0,1512,392,394,2
"6f8881a745ac4c358a68b92c3b4abe81","17f95d18bab743888e1736033dc3384d",22852860,1,-6,0,1513,394,389,-5
"6f8881a745ac4c358a68b92c3b4abe81","6f8881a745ac4c358a68b92c3b4abe81",22852860,3,0,1,1515,394,394,0
"6f8881a745ac4c358a68b92c3b4abe81","f7002c8484354eceac57bc7bd62c76c1",22852860,1,-1,0,1518,394,393,-1
"f7002c8484354eceac57bc7bd62c76c1","44a277ea44dc4ae689fab4b82f0b4098",22852860,1,5,0,1519,393,397,4
"44a277ea44dc4ae689fab4b82f0b4098","44a277ea44dc4ae689fab4b82f0b4098",22852860,1,0,1,1520,397,397,0
"44a277ea44dc4ae689fab4b82f0b4098","0c12af0a4e7f4002852cf84b2537c161",22852860,1,-2,0,1521,397,395,-2
"0c12af0a4e7f4002852cf84b2537c161","859e0b8d71694b12befb69ee698138f9",22852860,1,5,0,1522,395,399,4
"859e0b8d71694b12befb69ee698138f9","859e0b8d71694b12befb69ee698138f9",22852860,1,0,1,1523,399,399,0
"859e0b8d71694b12befb69ee698138f9","66baf19b6b904b70922329068c63746d",22852860,1,-29,0,1524,399,376,-23
"66baf19b6b904b70922329068c63746d","2b09a08242b54983aec7063990fb3f66",22852860,1,32,0,1525,376,400,24
"2b09a08242b54983aec7063990fb3f66","2b09a08242b54983aec7063990fb3f66",22852860,12,0,1,1526,400,400,0
"2b09a08242b54983aec7063990fb3f66","1f471b7a883a4df48211e8c6a81b59a7",22852860,2,1,0,1530,400,401,1
"1f471b7a883a4df48211e8c6a81b59a7","1f471b7a883a4df48211e8c6a81b59a7",22852860,2,0,1,1531,401,401,0
"1f471b7a883a4df48211e8c6a81b59a7","2b09a08242b54983aec7063990fb3f66",22852860,2,-1,0,1532,401,400,-1
"2b09a08242b54983aec7063990fb3f66","9de0d567bfa84fe5b77cb76f4a76a5d1",22852860,1,5,0,1533,400,404,4
"9de0d567bfa84fe5b77cb76f4a76a5d1","9de0d567bfa84fe5b77cb76f4a76a5d1",22852860,1,0,1,1534,404,404,0
"9de0d567bfa84fe5b77cb76f4a76a5d1","1157bd665ec4472fb58b751dc5099355",22852860,1,-1,0,1535,404,403,-1
"1157bd665ec4472fb58b751dc5099355","3c8a22d2f9c146ea956609e3ed4f2559",22852860,1,3,0,1536,403,405,2
"3c8a22d2f9c146ea956609e3ed4f2559","58fc9094275e4c49be3f4ba6d4acc0a4",22852860,1,2,0,1537,405,406,1
"58fc9094275e4c49be3f4ba6d4acc0a4","58fc9094275e4c49be3f4ba6d4acc0a4",22852860,2,0,1,1538,406,406,0
"58fc9094275e4c49be3f4ba6d4acc0a4","c1c1be90b2b14c1ab4a5e1ee3c241902",22852860,1,1,0,1540,406,407,1
"c1c1be90b2b14c1ab4a5e1ee3c241902","c1c1be90b2b14c1ab4a5e1ee3c241902",22852860,5,0,1,1541,407,407,0
"c1c1be90b2b14c1ab4a5e1ee3c241902","02b3a1bead9244c1ba2f857c7da8f82a",22852860,1,2,0,1546,407,408,1
"02b3a1bead9244c1ba2f857c7da8f82a","58fc9094275e4c49be3f4ba6d4acc0a4",22852860,1,-3,0,1547,408,406,-2
"58fc9094275e4c49be3f4ba6d4acc0a4","02b3a1bead9244c1ba2f857c7da8f82a",22852860,1,3,0,1548,406,408,2
"02b3a1bead9244c1ba2f857c7da8f82a","02b3a1bead9244c1ba2f857c7da8f82a",22852860,1,0,1,1549,408,408,0
"02b3a1bead9244c1ba2f857c7da8f82a","6206fc6479014bb193084c32409dc1b9",22852860,1,1,0,1550,408,409,1
"6206fc6479014bb193084c32409dc1b9","6206fc6479014bb193084c32409dc1b9",22852860,1,0,1,1551,409,409,0
"6206fc6479014bb193084c32409dc1b9","6a5f020451db426dacba9e2ea3fcc62a",22852860,1,2,0,1552,409,410,1
"6a5f020451db426dacba9e2ea3fcc62a","02b3a1bead9244c1ba2f857c7da8f82a",22852860,1,-3,0,1553,410,408,-2
"02b3a1bead9244c1ba2f857c7da8f82a","6a5f020451db426dacba9e2ea3fcc62a",22852860,1,3,0,1554,408,410,2
"6a5f020451db426dacba9e2ea3fcc62a","6a5f020451db426dacba9e2ea3fcc62a",22852860,3,0,1,1555,410,410,0
"6a5f020451db426dacba9e2ea3fcc62a","33a9d248b2e44588a5b07fc1342b9bc2",22852860,1,2,0,1558,410,411,1
"33a9d248b2e44588a5b07fc1342b9bc2","33a9d248b2e44588a5b07fc1342b9bc2",22852860,2,0,1,1559,411,411,0
"33a9d248b2e44588a5b07fc1342b9bc2","c6f26bd420634f1cb7989e76fe6b16c0",22852860,1,1,0,1561,411,412,1
"c6f26bd420634f1cb7989e76fe6b16c0","c6f26bd420634f1cb7989e76fe6b16c0",22852860,5,0,1,1562,412,412,0
"c6f26bd420634f1cb7989e76fe6b16c0","2a65ee6e2ac64f6a8a55fbe5373ec763",22852860,1,1,0,1567,412,413,1
"2a65ee6e2ac64f6a8a55fbe5373ec763","2a65ee6e2ac64f6a8a55fbe5373ec763",22852860,2,0,1,1568,413,413,0
"2a65ee6e2ac64f6a8a55fbe5373ec763","33a9d248b2e44588a5b07fc1342b9bc2",22852860,1,-2,0,1570,413,411,-2
"33a9d248b2e44588a5b07fc1342b9bc2","687055dad9fc40c3982478fe33ec01bf",22852860,1,4,0,1571,411,414,3
"687055dad9fc40c3982478fe33ec01bf","2b09a08242b54983aec7063990fb3f66",22852860,1,-21,0,1572,414,400,-14
"2b09a08242b54983aec7063990fb3f66","1fd0f6dadbc14ebc965faf6122190b96",22852860,1,22,0,1573,400,415,15
"1fd0f6dadbc14ebc965faf6122190b96","1fd0f6dadbc14ebc965faf6122190b96",22852860,1,0,1,1574,415,415,0
"1fd0f6dadbc14ebc965faf6122190b96","687055dad9fc40c3982478fe33ec01bf",22852860,1,-1,0,1575,415,414,-1
"687055dad9fc40c3982478fe33ec01bf","2add1669f08d4101913db15f8c23b3b7",22852860,1,3,0,1576,414,416,2
"2add1669f08d4101913db15f8c23b3b7","2b09a08242b54983aec7063990fb3f66",22852860,1,-24,0,1577,416,400,-16
"2b09a08242b54983aec7063990fb3f66","2add1669f08d4101913db15f8c23b3b7",22852860,1,24,0,1578,400,416,16
"2add1669f08d4101913db15f8c23b3b7","a2b4bd40cee2481ebd3fc179d6a5cd62",22852860,1,3,0,1579,416,417,1
"a2b4bd40cee2481ebd3fc179d6a5cd62","a2b4bd40cee2481ebd3fc179d6a5cd62",22852860,5,0,1,1580,417,417,0
"a2b4bd40cee2481ebd3fc179d6a5cd62","2b09a08242b54983aec7063990fb3f66",22852860,1,-27,0,1581,417,400,-17
"2b09a08242b54983aec7063990fb3f66","a2b4bd40cee2481ebd3fc179d6a5cd62",22852860,1,27,0,1583,400,417,17
"a2b4bd40cee2481ebd3fc179d6a5cd62","e34e59dce2204f228f3a84b6725df60f",22852860,1,2,0,1584,417,419,2
"e34e59dce2204f228f3a84b6725df60f","e34e59dce2204f228f3a84b6725df60f",22852860,1,0,1,1585,419,419,0
"e34e59dce2204f228f3a84b6725df60f","bec48fc2e1294c7eb3d0aca780d731b8",22852860,1,2,0,1586,419,420,1
"bec48fc2e1294c7eb3d0aca780d731b8","a2b4bd40cee2481ebd3fc179d6a5cd62",22852860,1,-4,0,1587,420,417,-3
"a2b4bd40cee2481ebd3fc179d6a5cd62","bec48fc2e1294c7eb3d0aca780d731b8",22852860,1,4,0,1588,417,420,3
"bec48fc2e1294c7eb3d0aca780d731b8","bec48fc2e1294c7eb3d0aca780d731b8",22852860,2,0,1,1589,420,420,0
"bec48fc2e1294c7eb3d0aca780d731b8","a24600b0e49245f6bdba8c893cfeddb0",22852860,1,7,0,1591,420,425,5
"a24600b0e49245f6bdba8c893cfeddb0","dbde19fcce2a4c1abdc7f685c293a23f",22852860,1,-4,0,1592,425,422,-3
"dbde19fcce2a4c1abdc7f685c293a23f","a24600b0e49245f6bdba8c893cfeddb0",22852860,1,4,0,1593,422,425,3
"a24600b0e49245f6bdba8c893cfeddb0","a24600b0e49245f6bdba8c893cfeddb0",22852860,2,0,1,1594,425,425,0
"a24600b0e49245f6bdba8c893cfeddb0","24cf8786024543f19b89bc20034e60d7",22852860,1,7,0,1596,425,428,3
"24cf8786024543f19b89bc20034e60d7","a2b4bd40cee2481ebd3fc179d6a5cd62",22852860,1,-18,0,1597,428,417,-11
"a2b4bd40cee2481ebd3fc179d6a5cd62","f2a73be2f46840b182d7bd095378004e",22852860,1,19,0,1598,417,429,12
"f2a73be2f46840b182d7bd095378004e","f2a73be2f46840b182d7bd095378004e",22852860,5,0,1,1599,429,429,0
"f2a73be2f46840b182d7bd095378004e","604551fd4266430cb860fef58fa7dd61",22852860,1,1,0,1602,429,430,1
"604551fd4266430cb860fef58fa7dd61","604551fd4266430cb860fef58fa7dd61",22852860,1,0,1,1603,430,430,0
"604551fd4266430cb860fef58fa7dd61","dce46f8904594a62a6377a3587aaa663",22852860,1,2,0,1604,430,431,1
"dce46f8904594a62a6377a3587aaa663","24cf8786024543f19b89bc20034e60d7",22852860,1,-4,0,1605,431,428,-3
"24cf8786024543f19b89bc20034e60d7","dce46f8904594a62a6377a3587aaa663",22852860,3,4,0,1606,428,431,3
"dce46f8904594a62a6377a3587aaa663","dce46f8904594a62a6377a3587aaa663",22852860,5,0,1,1607,431,431,0
"dce46f8904594a62a6377a3587aaa663","9b9d0a249052413c869753b99682b0ac",22852860,1,1,0,1608,431,432,1
"9b9d0a249052413c869753b99682b0ac","9b9d0a249052413c869753b99682b0ac",22852860,3,0,1,1609,432,432,0
"9b9d0a249052413c869753b99682b0ac","061c175cc90f45fbad883025394e78dd",22852860,1,1,0,1612,432,433,1
"061c175cc90f45fbad883025394e78dd","061c175cc90f45fbad883025394e78dd",22852860,5,0,1,1613,433,433,0
"061c175cc90f45fbad883025394e78dd","dce46f8904594a62a6377a3587aaa663",22852860,1,-2,0,1618,433,431,-2
"dce46f8904594a62a6377a3587aaa663","5d290f75e44b4bdb8256c600debbb44d",22852860,1,-9,0,1619,431,426,-5
"5d290f75e44b4bdb8256c600debbb44d","a2b4bd40cee2481ebd3fc179d6a5cd62",22852860,2,-13,0,1620,426,417,-9
"a2b4bd40cee2481ebd3fc179d6a5cd62","24cf8786024543f19b89bc20034e60d7",22852860,3,18,0,1622,417,428,11
"24cf8786024543f19b89bc20034e60d7","f2a73be2f46840b182d7bd095378004e",22852860,3,1,0,1623,428,429,1
"f2a73be2f46840b182d7bd095378004e","24cf8786024543f19b89bc20034e60d7",22852860,2,-1,0,1626,429,428,-1
"dce46f8904594a62a6377a3587aaa663","2b09a08242b54983aec7063990fb3f66",22852860,1,-49,0,1629,431,400,-31
"2b09a08242b54983aec7063990fb3f66","1157bd665ec4472fb58b751dc5099355",22852860,1,4,0,1635,400,403,3
"1157bd665ec4472fb58b751dc5099355","2b09a08242b54983aec7063990fb3f66",22852860,1,-4,0,1636,403,400,-3
"2b09a08242b54983aec7063990fb3f66","5d290f75e44b4bdb8256c600debbb44d",22852860,1,40,0,1642,400,426,26
"f2a73be2f46840b182d7bd095378004e","d9c8d8c444a64dadbbb508652c721e17",22852860,1,-516,0,1647,429,46,-383
"f924752d8a1149668870b1e7698486f7","78f30e4dcac84e3cbea8b2cc6e0d62b3",22852860,1,10,0,1653,50,59,9
"a1f2f12debe5432fb7a70bcd12bacfb9","bc42d26810654ea9a1df1efe1e58c7d5",22852860,1,6,0,1655,58,63,5
"12aa6e1672ac4e7aa6449a7a8609cd72","a0a418b8540d479fa6e0f653b701da8b",22852860,1,8,0,1657,57,64,7
"bc42d26810654ea9a1df1efe1e58c7d5","309ccf3cc4fe429d9bfbaef53d3fa479",22852860,1,-3,0,1662,63,60,-3
"b534b89233134e30a9b5645138bfa9ee","a2becd407db34b189200a32546d9d569",22852860,1,42,0,1665,41,75,34
"a2becd407db34b189200a32546d9d569","d646286c8051419bbc2e31dd1db55ca8",22852860,1,-9,0,1666,75,67,-8
"d646286c8051419bbc2e31dd1db55ca8","140d5b27b8574befad82c0a013b59dfa",22852860,1,8,0,1667,67,74,7
"d391c8b6e56a43a7b654e9dee02d904b","00ae5f0c51874a73a41ebea838d95682",22852860,2,-2,0,1676,103,101,-2
"00ae5f0c51874a73a41ebea838d95682","e20db35ced8544ddac5bc3839145e463",22852860,1,-11,0,1677,101,91,-10
"e20db35ced8544ddac5bc3839145e463","4280927ec4d643238aa49c32f9e06c6c",22852860,1,20,0,1678,91,109,18
"73039f8c1eb9409cb4caee2cf968001e","08111f75e22d409998cf8b85bd431f0a",22852860,2,9,0,1680,100,108,8
"a9ae0a3c070d455bb4369a8996313336","62bff51286ef4f348717a3cf6fe2318f",22852860,1,7,0,1682,114,120,6
"62bff51286ef4f348717a3cf6fe2318f","37319e88176d4aefa91d7a9980dbae91",22852860,2,-9,0,1683,120,112,-8
"37319e88176d4aefa91d7a9980dbae91","e20db35ced8544ddac5bc3839145e463",22852860,1,-24,0,1684,112,91,-21
"6c5ad271a44743479bfaea29b1db8d02","8aae34f5ddbb4052a709b12e6b0d40fa",22852860,1,5,0,1693,143,147,4
"8aae34f5ddbb4052a709b12e6b0d40fa","df1de691dafe4549a18a4398ee9dfaf9",22852860,1,-9,0,1694,147,139,-8
"df1de691dafe4549a18a4398ee9dfaf9","f902b0f41b544d4dbf79664fd233648d",22852860,1,8,0,1695,139,146,7
"78adeee1fa2c4fe0bc73f7bca9fcee86","a2b4bd40cee2481ebd3fc179d6a5cd62",22852860,1,355,0,1702,160,417,257
"24cf8786024543f19b89bc20034e60d7","66ada10dde9f43018588f1ced9d477fc",22852860,1,8,0,1708,428,434,6
"66ada10dde9f43018588f1ced9d477fc","24cf8786024543f19b89bc20034e60d7",22852860,1,-8,0,1709,434,428,-6
"24cf8786024543f19b89bc20034e60d7","2ae94c0cea4d480a9d5dca8fb1d7b542",22852860,1,-259,0,1710,428,242,-186
"2ae94c0cea4d480a9d5dca8fb1d7b542","6e83e23f56544a19b94067c1c558d9c0",22852860,1,6,0,1711,242,247,5
"6e83e23f56544a19b94067c1c558d9c0","30c9ba177afc49a695625d2bdec40207",22852860,1,3,0,1712,247,250,3
"30c9ba177afc49a695625d2bdec40207","30c9ba177afc49a695625d2bdec40207",22852860,2,0,1,1713,250,250,0
"30c9ba177afc49a695625d2bdec40207","6e83e23f56544a19b94067c1c558d9c0",22852860,1,-3,0,1715,250,247,-3
"6e83e23f56544a19b94067c1c558d9c0","00f61990949545828dd12f1303d47504",22852860,2,11,0,1716,247,256,9
"00f61990949545828dd12f1303d47504","0c7262dff33c4087bc660ccf40f92f9c",22852860,1,-114,0,1717,256,169,-87
"0c7262dff33c4087bc660ccf40f92f9c","d6d02b6ef04e4f17805504500b8ce441",22852860,1,275,0,1718,169,375,206
"4a29443515bb404cb8924e1c60a63b73","24cf8786024543f19b89bc20034e60d7",22852860,1,199,0,1723,285,428,143
"dce46f8904594a62a6377a3587aaa663","74a7f8712e5449c2bc0b43c6f90dafed",22852860,1,5,0,1728,431,435,4
"74a7f8712e5449c2bc0b43c6f90dafed","74a7f8712e5449c2bc0b43c6f90dafed",22852860,1,0,1,1729,435,435,0
"74a7f8712e5449c2bc0b43c6f90dafed","66ada10dde9f43018588f1ced9d477fc",22852860,1,-1,0,1730,435,434,-1
"66ada10dde9f43018588f1ced9d477fc","bf12c96466d840a69bed7020b3f18bb8",22852860,1,3,0,1731,434,436,2
"bf12c96466d840a69bed7020b3f18bb8","bf12c96466d840a69bed7020b3f18bb8",22852860,1,0,1,1732,436,436,0
"bf12c96466d840a69bed7020b3f18bb8","070600601c4c439288445d2f0724807d",22852860,1,3,0,1733,436,437,1
"070600601c4c439288445d2f0724807d","24cf8786024543f19b89bc20034e60d7",22852860,1,-14,0,1734,437,428,-9
"24cf8786024543f19b89bc20034e60d7","1823b6de7d334a7aaabc4570719af4d9",22852860,1,16,0,1735,428,439,11
"1823b6de7d334a7aaabc4570719af4d9","1823b6de7d334a7aaabc4570719af4d9",22852860,14,0,1,1736,439,439,0
"1823b6de7d334a7aaabc4570719af4d9","070600601c4c439288445d2f0724807d",22852860,1,-2,0,1750,439,437,-2
"070600601c4c439288445d2f0724807d","0380cd76a7d44bc3a4da1f15e4d68f89",22852860,1,4,0,1751,437,440,3
"0380cd76a7d44bc3a4da1f15e4d68f89","0380cd76a7d44bc3a4da1f15e4d68f89",22852860,3,0,1,1752,440,440,0
"0380cd76a7d44bc3a4da1f15e4d68f89","23b7673c8b5443108c2ef09382834a86",22852860,2,2,0,1755,440,441,1
"23b7673c8b5443108c2ef09382834a86","0380cd76a7d44bc3a4da1f15e4d68f89",22852860,1,-2,0,1756,441,440,-1
"23b7673c8b5443108c2ef09382834a86","23b7673c8b5443108c2ef09382834a86",22852860,2,0,1,1758,441,441,0
"23b7673c8b5443108c2ef09382834a86","901e92500aea43c79f19f1b279050668",22852860,1,2,0,1760,441,442,1
"901e92500aea43c79f19f1b279050668","901e92500aea43c79f19f1b279050668",22852860,2,0,1,1761,442,442,0
"901e92500aea43c79f19f1b279050668","001339db8ced4cf78829ebe8b145449d",22852860,1,1,0,1763,442,443,1
"001339db8ced4cf78829ebe8b145449d","001339db8ced4cf78829ebe8b145449d",22852860,11,0,1,1764,443,443,0
"001339db8ced4cf78829ebe8b145449d","452745e0366e42ae81561bfddebcc6c3",22852860,1,1,0,1775,443,444,1
"452745e0366e42ae81561bfddebcc6c3","452745e0366e42ae81561bfddebcc6c3",22852860,5,0,1,1776,444,444,0
"452745e0366e42ae81561bfddebcc6c3","901e92500aea43c79f19f1b279050668",22852860,1,-2,0,1781,444,442,-2
"901e92500aea43c79f19f1b279050668","4660ff2089114e8db82ceb26a4f329e3",22852860,1,4,0,1782,442,445,3
"4660ff2089114e8db82ceb26a4f329e3","4660ff2089114e8db82ceb26a4f329e3",22852860,3,0,1,1783,445,445,0
"4660ff2089114e8db82ceb26a4f329e3","7bd5586eb9d8484eb74a433ee7bfe499",22852860,1,2,0,1786,445,446,1
"7bd5586eb9d8484eb74a433ee7bfe499","7bd5586eb9d8484eb74a433ee7bfe499",22852860,16,0,1,1787,446,446,0
"7bd5586eb9d8484eb74a433ee7bfe499","8a7f26e690f34dda97be16904518ca99",22852860,1,2,0,1803,446,447,1
"8a7f26e690f34dda97be16904518ca99","8a7f26e690f34dda97be16904518ca99",22852860,1,0,1,1804,447,447,0
"8a7f26e690f34dda97be16904518ca99","070600601c4c439288445d2f0724807d",22852860,1,-16,0,1805,447,437,-10
"070600601c4c439288445d2f0724807d","b2f0d654738f48158edff28e8d3a546e",22852860,1,21,0,1806,437,449,12
"b2f0d654738f48158edff28e8d3a546e","b2f0d654738f48158edff28e8d3a546e",22852860,1,0,1,1807,449,449,0
"b2f0d654738f48158edff28e8d3a546e","f60ee41ec635499abd48168342d32c2f",22852860,5,5,0,1808,449,453,4
"f60ee41ec635499abd48168342d32c2f","f60ee41ec635499abd48168342d32c2f",22852860,72,0,1,1809,453,453,0
"f60ee41ec635499abd48168342d32c2f","b2f0d654738f48158edff28e8d3a546e",22852860,3,-5,0,1811,453,449,-4
"b2f0d654738f48158edff28e8d3a546e","f67fbf45a5f146ed866965bc57c7c001",22852860,1,8,0,1863,449,454,5
"f67fbf45a5f146ed866965bc57c7c001","f67fbf45a5f146ed866965bc57c7c001",22852860,2,0,1,1864,454,454,0
"f67fbf45a5f146ed866965bc57c7c001","d937afe49bd24a07a550dda1c1155122",22852860,1,1,0,1866,454,455,1
"d937afe49bd24a07a550dda1c1155122","d937afe49bd24a07a550dda1c1155122",22852860,1,0,1,1867,455,455,0
"d937afe49bd24a07a550dda1c1155122","3628b3f7823443d0912a339096b69943",22852860,1,1,0,1868,455,456,1
"3628b3f7823443d0912a339096b69943","3628b3f7823443d0912a339096b69943",22852860,1,0,1,1869,456,456,0
"3628b3f7823443d0912a339096b69943","9e049ee647cf43ecbcb5ed792a8e7588",22852860,1,1,0,1870,456,457,1
"9e049ee647cf43ecbcb5ed792a8e7588","9e049ee647cf43ecbcb5ed792a8e7588",22852860,1,0,1,1871,457,457,0
"9e049ee647cf43ecbcb5ed792a8e7588","5256a214faaf410b93f76cea06428334",22852860,1,1,0,1872,457,458,1
"5256a214faaf410b93f76cea06428334","5256a214faaf410b93f76cea06428334",22852860,3,0,1,1873,458,458,0
"5256a214faaf410b93f76cea06428334","25c32b120fce40fa9b6c85133aeb4716",22852860,1,1,0,1876,458,459,1
"25c32b120fce40fa9b6c85133aeb4716","25c32b120fce40fa9b6c85133aeb4716",22852860,5,0,1,1877,459,459,0
"25c32b120fce40fa9b6c85133aeb4716","11bc14f2204949008b7d511b933363c1",22852860,1,1,0,1882,459,460,1
"11bc14f2204949008b7d511b933363c1","11bc14f2204949008b7d511b933363c1",22852860,6,0,1,1883,460,460,0
"11bc14f2204949008b7d511b933363c1","42de338840a34d15adb66e7b14fb9d2c",22852860,1,1,0,1889,460,461,1
"42de338840a34d15adb66e7b14fb9d2c","42de338840a34d15adb66e7b14fb9d2c",22852860,1,0,1,1890,461,461,0
"42de338840a34d15adb66e7b14fb9d2c","9da37c6210b1416b8079c274f70bf600",22852860,1,1,0,1891,461,462,1
"9da37c6210b1416b8079c274f70bf600","9da37c6210b1416b8079c274f70bf600",22852860,1,0,1,1892,462,462,0
"9da37c6210b1416b8079c274f70bf600","519119f1deac45ff9ab4f13529be5c6e",22852860,1,1,0,1893,462,463,1
"519119f1deac45ff9ab4f13529be5c6e","519119f1deac45ff9ab4f13529be5c6e",22852860,1,0,1,1894,463,463,0
"519119f1deac45ff9ab4f13529be5c6e","f67fbf45a5f146ed866965bc57c7c001",22852860,1,-9,0,1895,463,454,-9
"f67fbf45a5f146ed866965bc57c7c001","c5df9f40ec14463b9dcfdc73df3e9285",22852860,1,12,0,1896,454,464,10
"c5df9f40ec14463b9dcfdc73df3e9285","c5df9f40ec14463b9dcfdc73df3e9285",22852860,4,0,1,1897,464,464,0
"c5df9f40ec14463b9dcfdc73df3e9285","83d42d95cd844fc093fc09cee250edb8",22852860,1,3,0,1899,464,465,1
"83d42d95cd844fc093fc09cee250edb8","83d42d95cd844fc093fc09cee250edb8",22852860,5,0,1,1900,465,465,0
"83d42d95cd844fc093fc09cee250edb8","9428d8bd9c5a47b2a235b254e5e27ded",22852860,1,-19,0,1905,465,452,-13
"9428d8bd9c5a47b2a235b254e5e27ded","b2f0d654738f48158edff28e8d3a546e",22852860,1,-4,0,1906,452,449,-3
"f60ee41ec635499abd48168342d32c2f","d6d02b6ef04e4f17805504500b8ce441",22852860,1,-121,0,1915,453,375,-78
"7f544639412e40a9ba27f43b415362ab","c5df9f40ec14463b9dcfdc73df3e9285",22852860,1,130,0,1937,378,464,86
"c5df9f40ec14463b9dcfdc73df3e9285","b2f0d654738f48158edff28e8d3a546e",22852860,1,-20,0,1940,464,449,-15
"67a089198fcb4e1c8f2385786c2b296f","67a089198fcb4e1c8f2385786c2b296f",22853626,2,0,1,1,39,39,0
"67a089198fcb4e1c8f2385786c2b296f","b613861cecf84ffcab01afb23f660475",22853626,1,-72,0,2,39,1,-38
"e2911e79efc2420eac45d9f671463d4b","e2911e79efc2420eac45d9f671463d4b",22853626,9,0,1,10,2,2,0
"e2911e79efc2420eac45d9f671463d4b","519d1b8c59404d67b54e96c5c8a830b2",22853626,1,1,0,11,2,3,1
"519d1b8c59404d67b54e96c5c8a830b2","519d1b8c59404d67b54e96c5c8a830b2",22853626,1,0,1,12,3,3,0
"519d1b8c59404d67b54e96c5c8a830b2","531db53f81f646edb0cdcfe0085b03b7",22853626,1,1,0,13,3,4,1
"531db53f81f646edb0cdcfe0085b03b7","531db53f81f646edb0cdcfe0085b03b7",22853626,1,0,1,14,4,4,0
"531db53f81f646edb0cdcfe0085b03b7","4f5f94b2f95141e0a9d53a61da2276da",22853626,1,1,0,15,4,5,1
"4f5f94b2f95141e0a9d53a61da2276da","4f5f94b2f95141e0a9d53a61da2276da",22853626,1,0,1,16,5,5,0
"4f5f94b2f95141e0a9d53a61da2276da","6d541c89590949f99af293c4f2333f67",22853626,1,1,0,17,5,6,1
"6d541c89590949f99af293c4f2333f67","6d541c89590949f99af293c4f2333f67",22853626,1,0,1,18,6,6,0
"6d541c89590949f99af293c4f2333f67","dd5cf0b9fe4c4f1d8f5ff8e4c04879cb",22853626,1,1,0,19,6,7,1
"dd5cf0b9fe4c4f1d8f5ff8e4c04879cb","dd5cf0b9fe4c4f1d8f5ff8e4c04879cb",22853626,2,0,1,20,7,7,0
"dd5cf0b9fe4c4f1d8f5ff8e4c04879cb","6d541c89590949f99af293c4f2333f67",22853626,1,-1,0,22,7,6,-1
"6d541c89590949f99af293c4f2333f67","4f5f94b2f95141e0a9d53a61da2276da",22853626,1,-1,0,23,6,5,-1
"4f5f94b2f95141e0a9d53a61da2276da","f96261861edc426abe2248be4f0a709a",22853626,1,3,0,24,5,8,3
"f96261861edc426abe2248be4f0a709a","f96261861edc426abe2248be4f0a709a",22853626,2,0,1,25,8,8,0
"f96261861edc426abe2248be4f0a709a","66b5e16f4f75454fb5b8172079f0fa83",22853626,1,1,0,27,8,9,1
"66b5e16f4f75454fb5b8172079f0fa83","66b5e16f4f75454fb5b8172079f0fa83",22853626,2,0,1,28,9,9,0
"66b5e16f4f75454fb5b8172079f0fa83","0680571d4698477995e41842c36a54b2",22853626,1,1,0,30,9,10,1
"0680571d4698477995e41842c36a54b2","0680571d4698477995e41842c36a54b2",22853626,2,0,1,31,10,10,0
"0680571d4698477995e41842c36a54b2","56586aa865414f538729c7f7735d2bc6",22853626,1,4,0,33,10,12,2
"56586aa865414f538729c7f7735d2bc6","9112f2bffece48e08c6d2287be204085",22853626,1,-3,0,37,12,11,-1
"9112f2bffece48e08c6d2287be204085","9112f2bffece48e08c6d2287be204085",22853626,2,0,1,38,11,11,0
"9112f2bffece48e08c6d2287be204085","e2911e79efc2420eac45d9f671463d4b",22853626,1,-9,0,40,11,2,-9
"3f1c815879794b929260d224becaff7e","56586aa865414f538729c7f7735d2bc6",22853626,1,-4,0,53,14,12,-2
"3f1c815879794b929260d224becaff7e","81c864a886d54a6b8ff85f7d736f4f95",22853626,1,2,0,64,14,15,1
"81c864a886d54a6b8ff85f7d736f4f95","5c5ceeee4562457ba6d41515aeebfbb1",22853626,2,4,0,65,15,17,2
"5c5ceeee4562457ba6d41515aeebfbb1","e2911e79efc2420eac45d9f671463d4b",22853626,1,-22,0,66,17,2,-15
"5c5ceeee4562457ba6d41515aeebfbb1","5c5ceeee4562457ba6d41515aeebfbb1",22853626,3,0,1,77,17,17,0
"5c5ceeee4562457ba6d41515aeebfbb1","9afd71a5298d4333b6849dfce1b9422c",22853626,1,3,0,80,17,18,1
"9afd71a5298d4333b6849dfce1b9422c","56586aa865414f538729c7f7735d2bc6",22853626,1,-13,0,81,18,12,-6
"d4c3b003e8274e429d2fa688d73fde6d","d4c3b003e8274e429d2fa688d73fde6d",22853626,6,0,1,87,22,22,0
"d4c3b003e8274e429d2fa688d73fde6d","5bc03c8f16354d04bd51f5bb93559ad3",22853626,1,4,0,93,22,26,4
"5bc03c8f16354d04bd51f5bb93559ad3","b7719e26494940efa49512aedd0aac79",22853626,1,-7,0,94,26,20,-6
"afbf7250b99d47bea07172749483ca97","b7719e26494940efa49512aedd0aac79",22853626,1,-12,0,96,28,20,-8
"afbf7250b99d47bea07172749483ca97","4e51676dc72045d99c19b9fa7b22f8bc",22853626,4,3,0,100,28,29,1
"4e51676dc72045d99c19b9fa7b22f8bc","4e51676dc72045d99c19b9fa7b22f8bc",22853626,2,0,1,101,29,29,0
"4e51676dc72045d99c19b9fa7b22f8bc","afbf7250b99d47bea07172749483ca97",22853626,2,-3,0,102,29,28,-1
"4e51676dc72045d99c19b9fa7b22f8bc","51970cfa30e643e894e66ae85c8024cc",22853626,2,3,0,104,29,31,2
"51970cfa30e643e894e66ae85c8024cc","4e51676dc72045d99c19b9fa7b22f8bc",22853626,2,-3,0,105,31,29,-2
"4e51676dc72045d99c19b9fa7b22f8bc","c33c17be71ae4d588da7369472e5bb1b",22853626,2,9,0,106,29,34,5
"c33c17be71ae4d588da7369472e5bb1b","c33c17be71ae4d588da7369472e5bb1b",22853626,1,0,1,107,34,34,0
"c33c17be71ae4d588da7369472e5bb1b","93679be414554a11b1893002f2229a93",22853626,2,3,0,108,34,35,1
"93679be414554a11b1893002f2229a93","7040a13096d746ac84b8fac8d9752058",22853626,2,3,0,109,35,36,1
"7040a13096d746ac84b8fac8d9752058","93679be414554a11b1893002f2229a93",22853626,2,-3,0,110,36,35,-1
"7040a13096d746ac84b8fac8d9752058","9a0dc646f934470daf08c4b56ccf73db",22853626,1,3,0,112,36,37,1
"9a0dc646f934470daf08c4b56ccf73db","fc0e049d56024bc9a02c9a9c435c3df7",22853626,2,3,0,113,37,38,1
"fc0e049d56024bc9a02c9a9c435c3df7","9a0dc646f934470daf08c4b56ccf73db",22853626,2,-3,0,114,38,37,-1
"fc0e049d56024bc9a02c9a9c435c3df7","67a089198fcb4e1c8f2385786c2b296f",22853626,1,4,0,116,38,39,1
"67a089198fcb4e1c8f2385786c2b296f","64d48c6c9c7940639a932219a6c87198",22853626,3,1,0,117,39,40,1
"64d48c6c9c7940639a932219a6c87198","64d48c6c9c7940639a932219a6c87198",22853626,3,0,1,118,40,40,0
"64d48c6c9c7940639a932219a6c87198","67a089198fcb4e1c8f2385786c2b296f",22853626,2,-1,0,121,40,39,-1
"67a089198fcb4e1c8f2385786c2b296f","b534b89233134e30a9b5645138bfa9ee",22853626,2,4,0,122,39,41,2
"b534b89233134e30a9b5645138bfa9ee","0e37b720d23b4e7f8b313e79313fd107",22853626,1,3,0,123,41,44,3
"0e37b720d23b4e7f8b313e79313fd107","0e37b720d23b4e7f8b313e79313fd107",22853626,5,0,1,124,44,44,0
"0e37b720d23b4e7f8b313e79313fd107","6875d67fdd5f48168b62719df449bebd",22853626,1,1,0,129,44,45,1
"6875d67fdd5f48168b62719df449bebd","6875d67fdd5f48168b62719df449bebd",22853626,3,0,1,130,45,45,0
"6875d67fdd5f48168b62719df449bebd","b534b89233134e30a9b5645138bfa9ee",22853626,1,-4,0,133,45,41,-4
"b534b89233134e30a9b5645138bfa9ee","6e13d61a7bdb44bca949c9f86fab3be5",22853626,2,7,0,134,41,47,6
"6e13d61a7bdb44bca949c9f86fab3be5","6e13d61a7bdb44bca949c9f86fab3be5",22853626,3,0,1,135,47,47,0
"6e13d61a7bdb44bca949c9f86fab3be5","195f78799f984cc2b06c48dfe36be751",22853626,1,2,0,138,47,49,2
"195f78799f984cc2b06c48dfe36be751","195f78799f984cc2b06c48dfe36be751",22853626,2,0,1,139,49,49,0
"195f78799f984cc2b06c48dfe36be751","6e13d61a7bdb44bca949c9f86fab3be5",22853626,1,-2,0,141,49,47,-2
"6e13d61a7bdb44bca949c9f86fab3be5","d9c8d8c444a64dadbbb508652c721e17",22853626,2,-1,0,142,47,46,-1
"d9c8d8c444a64dadbbb508652c721e17","d0c74f735e024943943e40333d6d337f",22853626,2,6,0,143,46,51,5
"d0c74f735e024943943e40333d6d337f","d0c74f735e024943943e40333d6d337f",22853626,2,0,1,144,51,51,0
"d0c74f735e024943943e40333d6d337f","35adfa5d923046aebabfefd98f35ff05",22853626,1,3,0,145,51,54,3
"35adfa5d923046aebabfefd98f35ff05","35adfa5d923046aebabfefd98f35ff05",22853626,8,0,1,146,54,54,0
"35adfa5d923046aebabfefd98f35ff05","d0c74f735e024943943e40333d6d337f",22853626,2,-3,0,151,54,51,-3
"d0c74f735e024943943e40333d6d337f","e2911e79efc2420eac45d9f671463d4b",22853626,1,-85,0,153,51,2,-49
"e2911e79efc2420eac45d9f671463d4b","983f8ff320594b279a7f4a6fe132f9c5",22853626,1,87,0,156,2,53,51
"983f8ff320594b279a7f4a6fe132f9c5","983f8ff320594b279a7f4a6fe132f9c5",22853626,2,0,1,157,53,53,0
"983f8ff320594b279a7f4a6fe132f9c5","35adfa5d923046aebabfefd98f35ff05",22853626,1,1,0,159,53,54,1
"d0c74f735e024943943e40333d6d337f","b6f8a98476224da1b40e555ececc7ed8",22853626,1,4,0,164,51,55,4
"b6f8a98476224da1b40e555ececc7ed8","b6f8a98476224da1b40e555ececc7ed8",22853626,2,0,1,165,55,55,0
"b6f8a98476224da1b40e555ececc7ed8","35adfa5d923046aebabfefd98f35ff05",22853626,1,-1,0,167,55,54,-1
"35adfa5d923046aebabfefd98f35ff05","86e22cb5fe0e4b47a9489ecddf7ed78f",22853626,1,2,0,168,54,56,2
"86e22cb5fe0e4b47a9489ecddf7ed78f","86e22cb5fe0e4b47a9489ecddf7ed78f",22853626,2,0,1,169,56,56,0
"86e22cb5fe0e4b47a9489ecddf7ed78f","f924752d8a1149668870b1e7698486f7",22853626,1,-6,0,171,56,50,-6
"f924752d8a1149668870b1e7698486f7","78f30e4dcac84e3cbea8b2cc6e0d62b3",22853626,1,10,0,172,50,59,9
"78f30e4dcac84e3cbea8b2cc6e0d62b3","a1f2f12debe5432fb7a70bcd12bacfb9",22853626,1,-1,0,173,59,58,-1
"a1f2f12debe5432fb7a70bcd12bacfb9","a1f2f12debe5432fb7a70bcd12bacfb9",22853626,24,0,1,174,58,58,0
"78f30e4dcac84e3cbea8b2cc6e0d62b3","78f30e4dcac84e3cbea8b2cc6e0d62b3",22853626,7,0,1,199,59,59,0
"78f30e4dcac84e3cbea8b2cc6e0d62b3","12aa6e1672ac4e7aa6449a7a8609cd72",22853626,1,-2,0,206,59,57,-2
"12aa6e1672ac4e7aa6449a7a8609cd72","bc42d26810654ea9a1df1efe1e58c7d5",22853626,1,7,0,207,57,63,6
"a0a418b8540d479fa6e0f653b701da8b","4c943503763e4e349906eea3ed3c8e86",22853626,1,-3,0,217,64,61,-3
"4c943503763e4e349906eea3ed3c8e86","4c943503763e4e349906eea3ed3c8e86",22853626,1,0,1,218,61,61,0
"4c943503763e4e349906eea3ed3c8e86","309ccf3cc4fe429d9bfbaef53d3fa479",22853626,1,-1,0,219,61,60,-1
"d646286c8051419bbc2e31dd1db55ca8","267f883678b24aed855fde42524975d9",22853626,1,4,0,222,67,71,4
"267f883678b24aed855fde42524975d9","267f883678b24aed855fde42524975d9",22853626,1,0,1,223,71,71,0
"267f883678b24aed855fde42524975d9","88fff56d0342490dbef9040750a20f6c",22853626,1,1,0,224,71,72,1
"88fff56d0342490dbef9040750a20f6c","88fff56d0342490dbef9040750a20f6c",22853626,1,0,1,225,72,72,0
"88fff56d0342490dbef9040750a20f6c","adb17b12b66c4a49a85fd34322f7df70",22853626,1,1,0,226,72,73,1
"adb17b12b66c4a49a85fd34322f7df70","adb17b12b66c4a49a85fd34322f7df70",22853626,1,0,1,227,73,73,0
"adb17b12b66c4a49a85fd34322f7df70","d646286c8051419bbc2e31dd1db55ca8",22853626,1,-6,0,228,73,67,-6
"a2becd407db34b189200a32546d9d569","a2becd407db34b189200a32546d9d569",22853626,3,0,1,230,75,75,0
"a2becd407db34b189200a32546d9d569","58c22b011d0f4c2ea6d13615edbb9eeb",22853626,1,2,0,233,75,77,2
"58c22b011d0f4c2ea6d13615edbb9eeb","58c22b011d0f4c2ea6d13615edbb9eeb",22853626,8,0,1,234,77,77,0
"58c22b011d0f4c2ea6d13615edbb9eeb","dd76e1861dc9461c830888729d091ee0",22853626,2,1,0,236,77,78,1
"dd76e1861dc9461c830888729d091ee0","dd76e1861dc9461c830888729d091ee0",22853626,8,0,1,237,78,78,0
"dd76e1861dc9461c830888729d091ee0","58c22b011d0f4c2ea6d13615edbb9eeb",22853626,1,-1,0,243,78,77,-1
"dd76e1861dc9461c830888729d091ee0","cd1d828f1a694b87913a7ea66c23803e",22853626,1,1,0,253,78,79,1
"cd1d828f1a694b87913a7ea66c23803e","cd1d828f1a694b87913a7ea66c23803e",22853626,2,0,1,254,79,79,0
"cd1d828f1a694b87913a7ea66c23803e","9176a3c2b4d2465fa8b0c67096c2a97e",22853626,1,1,0,256,79,80,1
"9176a3c2b4d2465fa8b0c67096c2a97e","9176a3c2b4d2465fa8b0c67096c2a97e",22853626,11,0,1,257,80,80,0
"9176a3c2b4d2465fa8b0c67096c2a97e","f8ec6445f7194e25b9101d4fbcb07a18",22853626,1,1,0,268,80,81,1
"f8ec6445f7194e25b9101d4fbcb07a18","f8ec6445f7194e25b9101d4fbcb07a18",22853626,2,0,1,269,81,81,0
"f8ec6445f7194e25b9101d4fbcb07a18","140d5b27b8574befad82c0a013b59dfa",22853626,1,-7,0,271,81,74,-7
"ae5ac430ea254e708a6f5deaaf7464ae","d646286c8051419bbc2e31dd1db55ca8",22853626,1,-20,0,274,84,67,-17
"d18a9ea32855445f8736581f5cb119ce","f564483cbd7a407681aa2fcca518cf5f",22853626,1,4,0,279,82,85,3
"f564483cbd7a407681aa2fcca518cf5f","f564483cbd7a407681aa2fcca518cf5f",22853626,4,0,1,280,85,85,0
"f564483cbd7a407681aa2fcca518cf5f","18fd01350bd5434ca636d59a599d768a",22853626,1,1,0,284,85,86,1
"18fd01350bd5434ca636d59a599d768a","18fd01350bd5434ca636d59a599d768a",22853626,8,0,1,285,86,86,0
"18fd01350bd5434ca636d59a599d768a","6a9f0ef185fb47f0937e29daa1c71ed5",22853626,1,5,0,293,86,90,4
"6a9f0ef185fb47f0937e29daa1c71ed5","ae5ac430ea254e708a6f5deaaf7464ae",22853626,1,-7,0,294,90,84,-6
"6a9f0ef185fb47f0937e29daa1c71ed5","c681290961c94c4caf23b529d1ae6b9a",22853626,1,-2,0,299,90,88,-2
"c681290961c94c4caf23b529d1ae6b9a","c681290961c94c4caf23b529d1ae6b9a",22853626,1,0,1,300,88,88,0
"c681290961c94c4caf23b529d1ae6b9a","e20db35ced8544ddac5bc3839145e463",22853626,1,5,0,301,88,91,3
"e20db35ced8544ddac5bc3839145e463","d646286c8051419bbc2e31dd1db55ca8",22853626,1,-30,0,302,91,67,-24
"d646286c8051419bbc2e31dd1db55ca8","1febb706d7a34005ae8711ed49c76e64",22853626,1,33,0,303,67,94,27
"1febb706d7a34005ae8711ed49c76e64","1febb706d7a34005ae8711ed49c76e64",22853626,5,0,1,304,94,94,0
"1febb706d7a34005ae8711ed49c76e64","8f73ba6f5a0042f2850356ac38ac6f24",22853626,1,1,0,309,94,95,1
"8f73ba6f5a0042f2850356ac38ac6f24","8f73ba6f5a0042f2850356ac38ac6f24",22853626,5,0,1,310,95,95,0
"8f73ba6f5a0042f2850356ac38ac6f24","e2260b86653c46d7b14a41fb419dbf8c",22853626,1,1,0,315,95,96,1
"e2260b86653c46d7b14a41fb419dbf8c","e2260b86653c46d7b14a41fb419dbf8c",22853626,5,0,1,316,96,96,0
"e2260b86653c46d7b14a41fb419dbf8c","35eb641ad1d845bbba54915bce75a962",22853626,1,1,0,321,96,97,1
"35eb641ad1d845bbba54915bce75a962","35eb641ad1d845bbba54915bce75a962",22853626,2,0,1,322,97,97,0
"35eb641ad1d845bbba54915bce75a962","08be90ffbeea4795a138cd42ed8db56f",22853626,1,1,0,324,97,98,1
"08be90ffbeea4795a138cd42ed8db56f","08be90ffbeea4795a138cd42ed8db56f",22853626,5,0,1,325,98,98,0
"08be90ffbeea4795a138cd42ed8db56f","3007433c8f584dcbb5ac159c1c5f2be3",22853626,1,1,0,330,98,99,1
"3007433c8f584dcbb5ac159c1c5f2be3","3007433c8f584dcbb5ac159c1c5f2be3",22853626,5,0,1,331,99,99,0
"3007433c8f584dcbb5ac159c1c5f2be3","e20db35ced8544ddac5bc3839145e463",22853626,1,-8,0,336,99,91,-8
"00ae5f0c51874a73a41ebea838d95682","d391c8b6e56a43a7b654e9dee02d904b",22853626,5,2,0,338,101,103,2
"d391c8b6e56a43a7b654e9dee02d904b","00ae5f0c51874a73a41ebea838d95682",22853626,3,-2,0,339,103,101,-2
"00ae5f0c51874a73a41ebea838d95682","00ae5f0c51874a73a41ebea838d95682",22853626,3,0,1,340,101,101,0
"d391c8b6e56a43a7b654e9dee02d904b","d391c8b6e56a43a7b654e9dee02d904b",22853626,13,0,1,344,103,103,0
"d391c8b6e56a43a7b654e9dee02d904b","6111116566fc4fd9abba409322bea245",22853626,1,1,0,361,103,104,1
"6111116566fc4fd9abba409322bea245","6111116566fc4fd9abba409322bea245",22853626,2,0,1,362,104,104,0
"6111116566fc4fd9abba409322bea245","a81b2235cb9c499eb9ea8ee0a8dd9725",22853626,1,1,0,364,104,105,1
"a81b2235cb9c499eb9ea8ee0a8dd9725","a81b2235cb9c499eb9ea8ee0a8dd9725",22853626,2,0,1,365,105,105,0
"a81b2235cb9c499eb9ea8ee0a8dd9725","2d4e0ab0ef3b4d73b82c72d4621a7579",22853626,1,1,0,367,105,106,1
"2d4e0ab0ef3b4d73b82c72d4621a7579","2d4e0ab0ef3b4d73b82c72d4621a7579",22853626,2,0,1,368,106,106,0
"2d4e0ab0ef3b4d73b82c72d4621a7579","8bdebf492ebd4e62b0d522e8ab5e5197",22853626,1,1,0,370,106,107,1
"8bdebf492ebd4e62b0d522e8ab5e5197","8bdebf492ebd4e62b0d522e8ab5e5197",22853626,2,0,1,371,107,107,0
"8bdebf492ebd4e62b0d522e8ab5e5197","73039f8c1eb9409cb4caee2cf968001e",22853626,1,-7,0,373,107,100,-7
"73039f8c1eb9409cb4caee2cf968001e","4280927ec4d643238aa49c32f9e06c6c",22853626,1,10,0,374,100,109,9
"4280927ec4d643238aa49c32f9e06c6c","4280927ec4d643238aa49c32f9e06c6c",22853626,4,0,1,375,109,109,0
"4280927ec4d643238aa49c32f9e06c6c","fc44e6a5f7654430af1227838224dceb",22853626,3,2,0,378,109,111,2
"fc44e6a5f7654430af1227838224dceb","fc44e6a5f7654430af1227838224dceb",22853626,7,0,1,379,111,111,0
"fc44e6a5f7654430af1227838224dceb","08111f75e22d409998cf8b85bd431f0a",22853626,2,-3,0,384,111,108,-3
"a9ae0a3c070d455bb4369a8996313336","a9ae0a3c070d455bb4369a8996313336",22853626,1,0,1,386,114,114,0
"a9ae0a3c070d455bb4369a8996313336","71cec822bcff4f30a20e75dc63ef7b65",22853626,3,2,0,387,114,116,2
"71cec822bcff4f30a20e75dc63ef7b65","71cec822bcff4f30a20e75dc63ef7b65",22853626,7,0,1,388,116,116,0
"71cec822bcff4f30a20e75dc63ef7b65","62bff51286ef4f348717a3cf6fe2318f",22853626,3,5,0,389,116,120,4
"37319e88176d4aefa91d7a9980dbae91","b1cd0e7dc3ad4a8eb91a4bfdbeb025b0",22853626,1,7,0,391,112,118,6
"b1cd0e7dc3ad4a8eb91a4bfdbeb025b0","b1cd0e7dc3ad4a8eb91a4bfdbeb025b0",22853626,2,0,1,392,118,118,0
"b1cd0e7dc3ad4a8eb91a4bfdbeb025b0","62bff51286ef4f348717a3cf6fe2318f",22853626,1,2,0,393,118,120,2
"62bff51286ef4f348717a3cf6fe2318f","779f9ddd1fd14d1e9e69f72219a1fdbd",22853626,5,3,0,397,120,121,1
"779f9ddd1fd14d1e9e69f72219a1fdbd","e20db35ced8544ddac5bc3839145e463",22853626,6,-36,0,398,121,91,-30
"e20db35ced8544ddac5bc3839145e463","ae26e6cda8ad4a3f81bd347560d9579f",22853626,2,40,0,399,91,125,34
"ae26e6cda8ad4a3f81bd347560d9579f","ae26e6cda8ad4a3f81bd347560d9579f",22853626,4,0,1,400,125,125,0
"ae26e6cda8ad4a3f81bd347560d9579f","ee48df95832b4374aa273ceb27ec1315",22853626,2,1,0,403,125,126,1
"ee48df95832b4374aa273ceb27ec1315","ee48df95832b4374aa273ceb27ec1315",22853626,5,0,1,404,126,126,0
"ee48df95832b4374aa273ceb27ec1315","7a439da90b394756ad1777fc4c6dead5",22853626,1,1,0,409,126,127,1
"7a439da90b394756ad1777fc4c6dead5","7a439da90b394756ad1777fc4c6dead5",22853626,1,0,1,410,127,127,0
"7a439da90b394756ad1777fc4c6dead5","a8dd5213034441ac92724b4e83eb0bb2",22853626,1,3,0,411,127,129,2
"a8dd5213034441ac92724b4e83eb0bb2","a8dd5213034441ac92724b4e83eb0bb2",22853626,2,0,1,414,129,129,0
"a8dd5213034441ac92724b4e83eb0bb2","8115eab6556b45f5b415c3b8c26a12e5",22853626,1,2,0,416,129,131,2
"8115eab6556b45f5b415c3b8c26a12e5","8115eab6556b45f5b415c3b8c26a12e5",22853626,1,0,1,417,131,131,0
"8115eab6556b45f5b415c3b8c26a12e5","779f9ddd1fd14d1e9e69f72219a1fdbd",22853626,1,-11,0,418,131,121,-10
"779f9ddd1fd14d1e9e69f72219a1fdbd","779f9ddd1fd14d1e9e69f72219a1fdbd",22853626,1,0,1,419,121,121,0
"a8dd5213034441ac92724b4e83eb0bb2","ec34b06efd844b46a4c4818ecdb9b8f4",22853626,1,3,0,421,129,132,3
"ec34b06efd844b46a4c4818ecdb9b8f4","ec34b06efd844b46a4c4818ecdb9b8f4",22853626,5,0,1,422,132,132,0
"ec34b06efd844b46a4c4818ecdb9b8f4","c2e1c2b9eac64109b343a088584b576b",22853626,1,1,0,427,132,133,1
"c2e1c2b9eac64109b343a088584b576b","c2e1c2b9eac64109b343a088584b576b",22853626,2,0,1,428,133,133,0
"c2e1c2b9eac64109b343a088584b576b","579338175e0b4bbb8ef3b712b5d8b54e",22853626,1,-5,0,430,133,128,-5
"579338175e0b4bbb8ef3b712b5d8b54e","8bc5795d6a984a3eace4e2811e52dd4f",22853626,2,8,0,431,128,135,7
"8bc5795d6a984a3eace4e2811e52dd4f","8bc5795d6a984a3eace4e2811e52dd4f",22853626,3,0,1,432,135,135,0
"8bc5795d6a984a3eace4e2811e52dd4f","b416d47c56a742199b5d7c7f19d6503a",22853626,2,-1,0,433,135,134,-1
"b416d47c56a742199b5d7c7f19d6503a","cd4532ad48034873ba8bce2aac0c9808",22853626,2,4,0,434,134,137,3
"cd4532ad48034873ba8bce2aac0c9808","cd4532ad48034873ba8bce2aac0c9808",22853626,2,0,1,435,137,137,0
"cd4532ad48034873ba8bce2aac0c9808","df1de691dafe4549a18a4398ee9dfaf9",22853626,1,4,0,436,137,139,2
"df1de691dafe4549a18a4398ee9dfaf9","779f9ddd1fd14d1e9e69f72219a1fdbd",22853626,1,-23,0,437,139,121,-18
"779f9ddd1fd14d1e9e69f72219a1fdbd","6c5ad271a44743479bfaea29b1db8d02",22853626,1,27,0,438,121,143,22
"6c5ad271a44743479bfaea29b1db8d02","6c5ad271a44743479bfaea29b1db8d02",22853626,1,0,1,439,143,143,0
"6c5ad271a44743479bfaea29b1db8d02","83d311bed5374fee83d8d67a7d9d82dc",22853626,2,1,0,440,143,144,1
"83d311bed5374fee83d8d67a7d9d82dc","83d311bed5374fee83d8d67a7d9d82dc",22853626,1,0,1,441,144,144,0
"83d311bed5374fee83d8d67a7d9d82dc","402bba41861d43acb52a5abb89e8831e",22853626,2,1,0,442,144,145,1
"402bba41861d43acb52a5abb89e8831e","402bba41861d43acb52a5abb89e8831e",22853626,2,0,1,443,145,145,0
"402bba41861d43acb52a5abb89e8831e","8aae34f5ddbb4052a709b12e6b0d40fa",22853626,1,3,0,445,145,147,2
"8aae34f5ddbb4052a709b12e6b0d40fa","df1de691dafe4549a18a4398ee9dfaf9",22853626,1,-9,0,446,147,139,-8
"8aae34f5ddbb4052a709b12e6b0d40fa","8aae34f5ddbb4052a709b12e6b0d40fa",22853626,5,0,1,448,147,147,0
"8aae34f5ddbb4052a709b12e6b0d40fa","645b3f0249f64f76af2e19eb4d0e55b7",22853626,1,2,0,453,147,149,2
"645b3f0249f64f76af2e19eb4d0e55b7","645b3f0249f64f76af2e19eb4d0e55b7",22853626,2,0,1,454,149,149,0
"645b3f0249f64f76af2e19eb4d0e55b7","8aae34f5ddbb4052a709b12e6b0d40fa",22853626,1,-2,0,456,149,147,-2
"8aae34f5ddbb4052a709b12e6b0d40fa","7e7b8db5064d4369805ab370aac5ddfb",22853626,1,3,0,457,147,150,3
"7e7b8db5064d4369805ab370aac5ddfb","7e7b8db5064d4369805ab370aac5ddfb",22853626,5,0,1,458,150,150,0
"7e7b8db5064d4369805ab370aac5ddfb","8956d210ae7f41968fada86d4c979d6a",22853626,1,1,0,463,150,151,1
"8956d210ae7f41968fada86d4c979d6a","8956d210ae7f41968fada86d4c979d6a",22853626,5,0,1,464,151,151,0
"8956d210ae7f41968fada86d4c979d6a","f902b0f41b544d4dbf79664fd233648d",22853626,1,-5,0,469,151,146,-5
"f902b0f41b544d4dbf79664fd233648d","ae781e8b775e4ccd93bc800dad5c8376",22853626,1,8,0,470,146,153,7
"ae781e8b775e4ccd93bc800dad5c8376","ae781e8b775e4ccd93bc800dad5c8376",22853626,2,0,1,471,153,153,0
"ae781e8b775e4ccd93bc800dad5c8376","06882a8492d9499aa31555567f575ecb",22853626,1,1,0,473,153,154,1
"06882a8492d9499aa31555567f575ecb","06882a8492d9499aa31555567f575ecb",22853626,1,0,1,474,154,154,0
"06882a8492d9499aa31555567f575ecb","f293c508f409466a8f27ddd7d1e40b20",22853626,1,1,0,475,154,155,1
"f293c508f409466a8f27ddd7d1e40b20","f293c508f409466a8f27ddd7d1e40b20",22853626,9,0,1,476,155,155,0
"f293c508f409466a8f27ddd7d1e40b20","cc4ddef5bbbe48ebb605141b347c4ed1",22853626,1,1,0,485,155,156,1
"cc4ddef5bbbe48ebb605141b347c4ed1","cc4ddef5bbbe48ebb605141b347c4ed1",22853626,1,0,1,486,156,156,0
"cc4ddef5bbbe48ebb605141b347c4ed1","f03480cf4eba413194d7af52fc0e7f28",22853626,1,-4,0,487,156,152,-4
"d313cec988a84645bee413e8d4724a4b","dc60696c76a74368a60f72246e47700d",22853626,1,1,0,493,158,159,1
"dc60696c76a74368a60f72246e47700d","dc60696c76a74368a60f72246e47700d",22853626,1,0,1,494,159,159,0
"dc60696c76a74368a60f72246e47700d","78adeee1fa2c4fe0bc73f7bca9fcee86",22853626,1,3,0,495,159,160,1
"78adeee1fa2c4fe0bc73f7bca9fcee86","8959e6304a0348309a771e4d08d1b64a",22853626,1,4,0,508,160,163,3
"8959e6304a0348309a771e4d08d1b64a","65202579580f4ad38d734b4ee39d22a8",22853626,2,1,0,509,163,164,1
"3cbcea2be0984e7dbd5a48195af10ce7","3cbcea2be0984e7dbd5a48195af10ce7",22853626,1,0,1,528,165,165,0
"b2275c3fad834f8d90737a2d9a6927d6","e20db35ced8544ddac5bc3839145e463",22853626,1,-105,0,535,172,91,-81
"e20db35ced8544ddac5bc3839145e463","e20db35ced8544ddac5bc3839145e463",22853626,1,0,1,536,91,91,0
"d391c8b6e56a43a7b654e9dee02d904b","e20db35ced8544ddac5bc3839145e463",22853626,1,-13,0,539,103,91,-12
"e20db35ced8544ddac5bc3839145e463","4280927ec4d643238aa49c32f9e06c6c",22853626,4,20,0,540,91,109,18
"73039f8c1eb9409cb4caee2cf968001e","a9ae0a3c070d455bb4369a8996313336",22853626,1,16,0,542,100,114,14
"a9ae0a3c070d455bb4369a8996313336","08111f75e22d409998cf8b85bd431f0a",22853626,2,-7,0,543,114,108,-6
"08111f75e22d409998cf8b85bd431f0a","71cec822bcff4f30a20e75dc63ef7b65",22853626,1,9,0,544,108,116,8
"71cec822bcff4f30a20e75dc63ef7b65","37319e88176d4aefa91d7a9980dbae91",22853626,2,-4,0,546,116,112,-4
"37319e88176d4aefa91d7a9980dbae91","62bff51286ef4f348717a3cf6fe2318f",22853626,8,9,0,547,112,120,8
"ee48df95832b4374aa273ceb27ec1315","ae26e6cda8ad4a3f81bd347560d9579f",22853626,1,-1,0,555,126,125,-1
"ae26e6cda8ad4a3f81bd347560d9579f","7a439da90b394756ad1777fc4c6dead5",22853626,1,2,0,556,125,127,2
"7a439da90b394756ad1777fc4c6dead5","779f9ddd1fd14d1e9e69f72219a1fdbd",22853626,1,-6,0,557,127,121,-6
"a8dd5213034441ac92724b4e83eb0bb2","579338175e0b4bbb8ef3b712b5d8b54e",22853626,1,-1,0,559,129,128,-1
"579338175e0b4bbb8ef3b712b5d8b54e","08111f75e22d409998cf8b85bd431f0a",22853626,1,-25,0,560,128,108,-20
"08111f75e22d409998cf8b85bd431f0a","e20db35ced8544ddac5bc3839145e463",22853626,3,-19,0,561,108,91,-17
"4280927ec4d643238aa49c32f9e06c6c","08111f75e22d409998cf8b85bd431f0a",22853626,1,-1,0,563,109,108,-1
"e20db35ced8544ddac5bc3839145e463","37319e88176d4aefa91d7a9980dbae91",22853626,3,24,0,574,91,112,21
"e20db35ced8544ddac5bc3839145e463","a9ae0a3c070d455bb4369a8996313336",22853626,2,26,0,576,91,114,23
"a9ae0a3c070d455bb4369a8996313336","37319e88176d4aefa91d7a9980dbae91",22853626,2,-2,0,577,114,112,-2
"e20db35ced8544ddac5bc3839145e463","a8dd5213034441ac92724b4e83eb0bb2",22853626,1,45,0,583,91,129,38
"cd4532ad48034873ba8bce2aac0c9808","779f9ddd1fd14d1e9e69f72219a1fdbd",22853626,1,-19,0,592,137,121,-16
"402bba41861d43acb52a5abb89e8831e","df1de691dafe4549a18a4398ee9dfaf9",22853626,1,-6,0,597,145,139,-6
"8aae34f5ddbb4052a709b12e6b0d40fa","67a089198fcb4e1c8f2385786c2b296f",22853626,1,-135,0,599,147,39,-108
"67a089198fcb4e1c8f2385786c2b296f","0c7262dff33c4087bc660ccf40f92f9c",22853626,1,169,0,601,39,169,130
"0c7262dff33c4087bc660ccf40f92f9c","0c7262dff33c4087bc660ccf40f92f9c",22853626,3,0,1,602,169,169,0
"0c7262dff33c4087bc660ccf40f92f9c","b2275c3fad834f8d90737a2d9a6927d6",22853626,2,3,0,603,169,172,3
"b2275c3fad834f8d90737a2d9a6927d6","0c7262dff33c4087bc660ccf40f92f9c",22853626,2,-3,0,604,172,169,-3
"0c7262dff33c4087bc660ccf40f92f9c","b42cc17b7de840f181a704558d0bc845",22853626,2,7,0,608,169,175,6
"b42cc17b7de840f181a704558d0bc845","b42cc17b7de840f181a704558d0bc845",22853626,2,0,1,609,175,175,0
"b42cc17b7de840f181a704558d0bc845","801f9e9135034f49bf5f8b4bdefedb41",22853626,2,2,0,611,175,177,2
"801f9e9135034f49bf5f8b4bdefedb41","801f9e9135034f49bf5f8b4bdefedb41",22853626,12,0,1,612,177,177,0
"801f9e9135034f49bf5f8b4bdefedb41","362fcb0699a14845ab29b2340093e528",22853626,2,-3,0,619,177,174,-3
"362fcb0699a14845ab29b2340093e528","b2275c3fad834f8d90737a2d9a6927d6",22853626,1,-3,0,620,174,172,-2
"b2275c3fad834f8d90737a2d9a6927d6","b2275c3fad834f8d90737a2d9a6927d6",22853626,29,0,1,621,172,172,0
"b2275c3fad834f8d90737a2d9a6927d6","eb515a26030b41f8a82a1e6114420bad",22853626,1,1,0,650,172,173,1
"eb515a26030b41f8a82a1e6114420bad","eb515a26030b41f8a82a1e6114420bad",22853626,5,0,1,651,173,173,0
"eb515a26030b41f8a82a1e6114420bad","b42cc17b7de840f181a704558d0bc845",22853626,1,3,0,656,173,175,2
"b42cc17b7de840f181a704558d0bc845","0c7262dff33c4087bc660ccf40f92f9c",22853626,1,-7,0,657,175,169,-6
"0c7262dff33c4087bc660ccf40f92f9c","ea38cc0e6e6e41edbabf210220808bf9",22853626,2,12,0,658,169,179,10
"ea38cc0e6e6e41edbabf210220808bf9","362fcb0699a14845ab29b2340093e528",22853626,1,-6,0,659,179,174,-5
"362fcb0699a14845ab29b2340093e528","b87c552dd247427abe6ab5795b9c9d43",22853626,2,8,0,660,174,181,7
"b87c552dd247427abe6ab5795b9c9d43","ea38cc0e6e6e41edbabf210220808bf9",22853626,2,-2,0,661,181,179,-2
"ea38cc0e6e6e41edbabf210220808bf9","ea38cc0e6e6e41edbabf210220808bf9",22853626,1,0,1,662,179,179,0
"ea38cc0e6e6e41edbabf210220808bf9","b87c552dd247427abe6ab5795b9c9d43",22853626,3,2,0,663,179,181,2
"b87c552dd247427abe6ab5795b9c9d43","b87c552dd247427abe6ab5795b9c9d43",22853626,7,0,1,664,181,181,0
"b87c552dd247427abe6ab5795b9c9d43","139b097acfca451689d80c9c6eebdf7b",22853626,1,-3,0,671,181,178,-3
"139b097acfca451689d80c9c6eebdf7b","30f660a1feb34582a739722532524f79",22853626,1,6,0,672,178,183,5
"30f660a1feb34582a739722532524f79","30f660a1feb34582a739722532524f79",22853626,10,0,1,673,183,183,0
"30f660a1feb34582a739722532524f79","2024b4885bd14338a39b7b509acbbd02",22853626,1,-1,0,683,183,182,-1
"2024b4885bd14338a39b7b509acbbd02","c3f63fe50d8e487c86bf8ef76c9cadd3",22853626,1,4,0,684,182,185,3
"c3f63fe50d8e487c86bf8ef76c9cadd3","c3f63fe50d8e487c86bf8ef76c9cadd3",22853626,1,0,1,685,185,185,0
"c3f63fe50d8e487c86bf8ef76c9cadd3","0c7262dff33c4087bc660ccf40f92f9c",22853626,1,-20,0,686,185,169,-16
"0c7262dff33c4087bc660ccf40f92f9c","c8e371568a0c4391b25796ae4e91952e",22853626,1,23,0,687,169,186,17
"c8e371568a0c4391b25796ae4e91952e","7d932b23e1c84326ae5aa4d3c0d813d1",22853626,1,2,0,688,186,188,2
"7d932b23e1c84326ae5aa4d3c0d813d1","7d932b23e1c84326ae5aa4d3c0d813d1",22853626,4,0,1,689,188,188,0
"7d932b23e1c84326ae5aa4d3c0d813d1","c8e371568a0c4391b25796ae4e91952e",22853626,2,-2,0,690,188,186,-2
"c8e371568a0c4391b25796ae4e91952e","ab11d94c6c8948ea90b88f19d2cd502b",22853626,3,5,0,691,186,190,4
"ab11d94c6c8948ea90b88f19d2cd502b","ab11d94c6c8948ea90b88f19d2cd502b",22853626,1,0,1,692,190,190,0
"ab11d94c6c8948ea90b88f19d2cd502b","f992451ed6ad4e68bb9e68ad6be7c4be",22853626,1,2,0,693,190,192,2
"f992451ed6ad4e68bb9e68ad6be7c4be","f992451ed6ad4e68bb9e68ad6be7c4be",22853626,2,0,1,694,192,192,0
"f992451ed6ad4e68bb9e68ad6be7c4be","ab11d94c6c8948ea90b88f19d2cd502b",22853626,1,-2,0,695,192,190,-2
"ab11d94c6c8948ea90b88f19d2cd502b","e20db35ced8544ddac5bc3839145e463",22853626,1,-130,0,696,190,91,-99
"37319e88176d4aefa91d7a9980dbae91","a9ae0a3c070d455bb4369a8996313336",22853626,1,2,0,698,112,114,2
"62bff51286ef4f348717a3cf6fe2318f","e20db35ced8544ddac5bc3839145e463",22853626,1,-33,0,707,120,91,-29
"779f9ddd1fd14d1e9e69f72219a1fdbd","ee48df95832b4374aa273ceb27ec1315",22853626,1,5,0,709,121,126,5
"ee48df95832b4374aa273ceb27ec1315","08111f75e22d409998cf8b85bd431f0a",22853626,1,-22,0,710,126,108,-18
"fc44e6a5f7654430af1227838224dceb","a9ae0a3c070d455bb4369a8996313336",22853626,1,4,0,716,111,114,3
"08111f75e22d409998cf8b85bd431f0a","62bff51286ef4f348717a3cf6fe2318f",22853626,1,14,0,718,108,120,12
"e20db35ced8544ddac5bc3839145e463","0c7262dff33c4087bc660ccf40f92f9c",22853626,1,102,0,724,91,169,78
"0c7262dff33c4087bc660ccf40f92f9c","362fcb0699a14845ab29b2340093e528",22853626,1,6,0,725,169,174,5
"362fcb0699a14845ab29b2340093e528","b42cc17b7de840f181a704558d0bc845",22853626,1,1,0,726,174,175,1
"ea38cc0e6e6e41edbabf210220808bf9","07b44a7a51e94c78b411c753fc39dab0",22853626,1,15,0,736,179,189,10
"07b44a7a51e94c78b411c753fc39dab0","6cd2dcaac46847d4a0bc53f296d90375",22853626,1,6,0,737,189,194,5
"6cd2dcaac46847d4a0bc53f296d90375","6cd2dcaac46847d4a0bc53f296d90375",22853626,2,0,1,738,194,194,0
"6cd2dcaac46847d4a0bc53f296d90375","2d2580c9411c4972909db508d6956a58",22853626,1,2,0,740,194,196,2
"2d2580c9411c4972909db508d6956a58","2d2580c9411c4972909db508d6956a58",22853626,5,0,1,741,196,196,0
"2d2580c9411c4972909db508d6956a58","5bddb3d9ed264f3984702f048c7e5340",22853626,1,1,0,746,196,197,1
"5bddb3d9ed264f3984702f048c7e5340","5bddb3d9ed264f3984702f048c7e5340",22853626,2,0,1,747,197,197,0
"5bddb3d9ed264f3984702f048c7e5340","d5e8e2bd12a2466b9d6d90855f0eb079",22853626,1,1,0,749,197,198,1
"d5e8e2bd12a2466b9d6d90855f0eb079","d5e8e2bd12a2466b9d6d90855f0eb079",22853626,2,0,1,750,198,198,0
"d5e8e2bd12a2466b9d6d90855f0eb079","017d7ca8e0394b91aaadc9574df2202c",22853626,1,-5,0,752,198,193,-5
"017d7ca8e0394b91aaadc9574df2202c","54e8e9f0ea3e45c4bf3b8ac799ee31b1",22853626,1,8,0,753,193,200,7
"54e8e9f0ea3e45c4bf3b8ac799ee31b1","54e8e9f0ea3e45c4bf3b8ac799ee31b1",22853626,1,0,1,754,200,200,0
"54e8e9f0ea3e45c4bf3b8ac799ee31b1","c614a00911be4877a075f19315530fb0",22853626,1,1,0,755,200,201,1
"c614a00911be4877a075f19315530fb0","c614a00911be4877a075f19315530fb0",22853626,6,0,1,756,201,201,0
"c614a00911be4877a075f19315530fb0","a6c21bd8b95249c7972820a7a7d76aff",22853626,1,1,0,762,201,202,1
"a6c21bd8b95249c7972820a7a7d76aff","a6c21bd8b95249c7972820a7a7d76aff",22853626,1,0,1,763,202,202,0
"a6c21bd8b95249c7972820a7a7d76aff","f9170dd6bc6442b4acd832747609b09a",22853626,1,-3,0,764,202,199,-3
"f9170dd6bc6442b4acd832747609b09a","b54257a550b94ebc9538f3a90eee9d7e",22853626,1,6,0,765,199,204,5
"b54257a550b94ebc9538f3a90eee9d7e","67a089198fcb4e1c8f2385786c2b296f",22853626,1,-214,0,766,204,39,-165
"64d48c6c9c7940639a932219a6c87198","08111f75e22d409998cf8b85bd431f0a",22853626,1,85,0,768,40,108,68
"62bff51286ef4f348717a3cf6fe2318f","b1cd0e7dc3ad4a8eb91a4bfdbeb025b0",22853626,1,-2,0,779,120,118,-2
"b1cd0e7dc3ad4a8eb91a4bfdbeb025b0","779f9ddd1fd14d1e9e69f72219a1fdbd",22853626,1,5,0,781,118,121,3
"62bff51286ef4f348717a3cf6fe2318f","a9ae0a3c070d455bb4369a8996313336",22853626,1,-7,0,790,120,114,-6
"a9ae0a3c070d455bb4369a8996313336","3ec3a3563847406fa73338f9e9999cf3",22853626,1,4,0,791,114,117,3
"3ec3a3563847406fa73338f9e9999cf3","71cec822bcff4f30a20e75dc63ef7b65",22853626,1,-2,0,792,117,116,-1
"62bff51286ef4f348717a3cf6fe2318f","362fcb0699a14845ab29b2340093e528",22853626,1,75,0,797,120,174,54
"362fcb0699a14845ab29b2340093e528","0c7262dff33c4087bc660ccf40f92f9c",22853626,1,-6,0,798,174,169,-5
"b42cc17b7de840f181a704558d0bc845","362fcb0699a14845ab29b2340093e528",22853626,1,-1,0,800,175,174,-1
"362fcb0699a14845ab29b2340093e528","ea38cc0e6e6e41edbabf210220808bf9",22853626,2,6,0,801,174,179,5
"ea38cc0e6e6e41edbabf210220808bf9","139b097acfca451689d80c9c6eebdf7b",22853626,1,-1,0,802,179,178,-1
"139b097acfca451689d80c9c6eebdf7b","b42cc17b7de840f181a704558d0bc845",22853626,1,-4,0,803,178,175,-3
"b42cc17b7de840f181a704558d0bc845","b87c552dd247427abe6ab5795b9c9d43",22853626,1,7,0,804,175,181,6
"b87c552dd247427abe6ab5795b9c9d43","b42cc17b7de840f181a704558d0bc845",22853626,1,-7,0,805,181,175,-6
"b42cc17b7de840f181a704558d0bc845","b7719e26494940efa49512aedd0aac79",22853626,1,-216,0,806,175,20,-155
"b7719e26494940efa49512aedd0aac79","a49d1bb4328949299686242fd0be5584",22853626,1,2,0,807,20,21,1
"a49d1bb4328949299686242fd0be5584","d4c3b003e8274e429d2fa688d73fde6d",22853626,1,1,0,808,21,22,1
"d4c3b003e8274e429d2fa688d73fde6d","a49d1bb4328949299686242fd0be5584",22853626,1,-1,0,809,22,21,-1
"a49d1bb4328949299686242fd0be5584","d4f45188d3c84a02ba08454e6403a818",22853626,1,3,0,810,21,24,3
"d4f45188d3c84a02ba08454e6403a818","5bc03c8f16354d04bd51f5bb93559ad3",22853626,1,2,0,811,24,26,2
"5bc03c8f16354d04bd51f5bb93559ad3","362fcb0699a14845ab29b2340093e528",22853626,1,208,0,812,26,174,148
"b87c552dd247427abe6ab5795b9c9d43","c8e371568a0c4391b25796ae4e91952e",22853626,1,9,0,815,181,186,5
"c8e371568a0c4391b25796ae4e91952e","c8e371568a0c4391b25796ae4e91952e",22853626,1,0,1,816,186,186,0
"ab11d94c6c8948ea90b88f19d2cd502b","6cd2dcaac46847d4a0bc53f296d90375",22853626,1,5,0,818,190,194,4
"6cd2dcaac46847d4a0bc53f296d90375","07b44a7a51e94c78b411c753fc39dab0",22853626,2,-6,0,819,194,189,-5
"07b44a7a51e94c78b411c753fc39dab0","017d7ca8e0394b91aaadc9574df2202c",22853626,2,5,0,820,189,193,4
"017d7ca8e0394b91aaadc9574df2202c","7d932b23e1c84326ae5aa4d3c0d813d1",22853626,1,-7,0,821,193,188,-5
"7d932b23e1c84326ae5aa4d3c0d813d1","ab11d94c6c8948ea90b88f19d2cd502b",22853626,1,3,0,823,188,190,2
"ab11d94c6c8948ea90b88f19d2cd502b","c8e371568a0c4391b25796ae4e91952e",22853626,2,-5,0,824,190,186,-4
"c8e371568a0c4391b25796ae4e91952e","f992451ed6ad4e68bb9e68ad6be7c4be",22853626,1,7,0,825,186,192,6
"f992451ed6ad4e68bb9e68ad6be7c4be","6cd2dcaac46847d4a0bc53f296d90375",22853626,1,3,0,827,192,194,2
"017d7ca8e0394b91aaadc9574df2202c","ab11d94c6c8948ea90b88f19d2cd502b",22853626,1,-4,0,830,193,190,-3
"c8e371568a0c4391b25796ae4e91952e","07b44a7a51e94c78b411c753fc39dab0",22853626,1,4,0,832,186,189,3
"07b44a7a51e94c78b411c753fc39dab0","7d932b23e1c84326ae5aa4d3c0d813d1",22853626,1,-2,0,833,189,188,-1
"ab11d94c6c8948ea90b88f19d2cd502b","07b44a7a51e94c78b411c753fc39dab0",22853626,1,-1,0,838,190,189,-1
"07b44a7a51e94c78b411c753fc39dab0","bb329d880ab54120adaf203a693bb203",22853626,1,16,0,839,189,203,14
"bb329d880ab54120adaf203a693bb203","bb329d880ab54120adaf203a693bb203",22853626,1,0,1,840,203,203,0
"bb329d880ab54120adaf203a693bb203","f9170dd6bc6442b4acd832747609b09a",22853626,1,-4,0,841,203,199,-4
"f9170dd6bc6442b4acd832747609b09a","334c2344009840079b1d0e1b7ce3d5a7",22853626,1,7,0,842,199,205,6
"334c2344009840079b1d0e1b7ce3d5a7","334c2344009840079b1d0e1b7ce3d5a7",22853626,1,0,1,843,205,205,0
"334c2344009840079b1d0e1b7ce3d5a7","c8e371568a0c4391b25796ae4e91952e",22853626,1,-23,0,844,205,186,-19
"c8e371568a0c4391b25796ae4e91952e","d7f13c8d63ec4e2aa673fbb9cf9c6933",22853626,1,26,0,845,186,206,20
"d7f13c8d63ec4e2aa673fbb9cf9c6933","b9e80f77c3a44349863b19875725c384",22853626,1,1,0,846,206,207,1
"b9e80f77c3a44349863b19875725c384","7108f0e4c2584f1f9c471689ae4c885c",22853626,2,1,0,847,207,208,1
"7108f0e4c2584f1f9c471689ae4c885c","b9e80f77c3a44349863b19875725c384",22853626,1,-1,0,848,208,207,-1
"b9e80f77c3a44349863b19875725c384","b9e80f77c3a44349863b19875725c384",22853626,16,0,1,849,207,207,0
"7108f0e4c2584f1f9c471689ae4c885c","7108f0e4c2584f1f9c471689ae4c885c",22853626,12,0,1,866,208,208,0
"7108f0e4c2584f1f9c471689ae4c885c","d7f13c8d63ec4e2aa673fbb9cf9c6933",22853626,1,-2,0,878,208,206,-2
"d7f13c8d63ec4e2aa673fbb9cf9c6933","09400e101c5d4b439cf9a26b03aae558",22853626,3,5,0,879,206,210,4
"09400e101c5d4b439cf9a26b03aae558","0c7262dff33c4087bc660ccf40f92f9c",22853626,1,-54,0,880,210,169,-41
"b87c552dd247427abe6ab5795b9c9d43","a875096404ef4a9984b62d74cda916f9",22853626,1,39,0,884,181,209,28
"a875096404ef4a9984b62d74cda916f9","d7f13c8d63ec4e2aa673fbb9cf9c6933",22853626,1,-4,0,885,209,206,-3
"09400e101c5d4b439cf9a26b03aae558","09400e101c5d4b439cf9a26b03aae558",22853626,4,0,1,887,210,210,0
"09400e101c5d4b439cf9a26b03aae558","a88efa7e50ce47159810ab553afa6d3a",22853626,2,2,0,891,210,212,2
"a88efa7e50ce47159810ab553afa6d3a","a88efa7e50ce47159810ab553afa6d3a",22853626,7,0,1,892,212,212,0
"a88efa7e50ce47159810ab553afa6d3a","a875096404ef4a9984b62d74cda916f9",22853626,1,-3,0,897,212,209,-3
"a875096404ef4a9984b62d74cda916f9","f7fb1952f56b4189b86a9f8b7862d2b8",22853626,2,7,0,898,209,215,6
"f7fb1952f56b4189b86a9f8b7862d2b8","be502a7a43c44bf7b682698de79d9369",22853626,3,-1,0,899,215,214,-1
"be502a7a43c44bf7b682698de79d9369","be502a7a43c44bf7b682698de79d9369",22853626,1,0,1,900,214,214,0
"be502a7a43c44bf7b682698de79d9369","f7fb1952f56b4189b86a9f8b7862d2b8",22853626,1,1,0,901,214,215,1
"f7fb1952f56b4189b86a9f8b7862d2b8","f7fb1952f56b4189b86a9f8b7862d2b8",22853626,17,0,1,902,215,215,0
"be502a7a43c44bf7b682698de79d9369","b860ee85d8bc4a2f97958cfb71be3533",22853626,1,2,0,920,214,216,2
"b860ee85d8bc4a2f97958cfb71be3533","b860ee85d8bc4a2f97958cfb71be3533",22853626,2,0,1,921,216,216,0
"b860ee85d8bc4a2f97958cfb71be3533","ec341f459285443b8361f7f15638ff08",22853626,1,-3,0,923,216,213,-3
"ec341f459285443b8361f7f15638ff08","363837c182e04711840d896ae1e0339c",22853626,1,6,0,924,213,218,5
"363837c182e04711840d896ae1e0339c","363837c182e04711840d896ae1e0339c",22853626,20,0,1,925,218,218,0
"363837c182e04711840d896ae1e0339c","01b2051f8941460d89945e3b02d1ce78",22853626,1,-1,0,945,218,217,-1
"01b2051f8941460d89945e3b02d1ce78","09400e101c5d4b439cf9a26b03aae558",22853626,1,-9,0,946,217,210,-7
"09400e101c5d4b439cf9a26b03aae558","be95c065e45447c1bd8215ea6f130c7a",22853626,2,12,0,947,210,219,9
"be95c065e45447c1bd8215ea6f130c7a","a88efa7e50ce47159810ab553afa6d3a",22853626,1,-10,0,948,219,212,-7
"a88efa7e50ce47159810ab553afa6d3a","f7fb1952f56b4189b86a9f8b7862d2b8",22853626,1,4,0,951,212,215,3
"be502a7a43c44bf7b682698de79d9369","a875096404ef4a9984b62d74cda916f9",22853626,2,-6,0,953,214,209,-5
"a875096404ef4a9984b62d74cda916f9","ec341f459285443b8361f7f15638ff08",22853626,1,5,0,954,209,213,4
"ec341f459285443b8361f7f15638ff08","91125ca626c5470eb145501f8c37f8db",22853626,1,9,0,955,213,220,7
"91125ca626c5470eb145501f8c37f8db","91125ca626c5470eb145501f8c37f8db",22853626,1,0,1,956,220,220,0
"91125ca626c5470eb145501f8c37f8db","1c6721b1f63f4d30ba7746ea8af02a52",22853626,1,3,0,957,220,221,1
"1c6721b1f63f4d30ba7746ea8af02a52","d7f13c8d63ec4e2aa673fbb9cf9c6933",22853626,2,-21,0,958,221,206,-15
"d7f13c8d63ec4e2aa673fbb9cf9c6933","77ecef8eff6b4a2caea7707669bf7475",22853626,1,22,0,959,206,222,16
"77ecef8eff6b4a2caea7707669bf7475","1c6721b1f63f4d30ba7746ea8af02a52",22853626,2,-1,0,960,222,221,-1
"be95c065e45447c1bd8215ea6f130c7a","09400e101c5d4b439cf9a26b03aae558",22853626,1,-12,0,964,219,210,-9
"a88efa7e50ce47159810ab553afa6d3a","be502a7a43c44bf7b682698de79d9369",22853626,1,3,0,966,212,214,2
"f7fb1952f56b4189b86a9f8b7862d2b8","09400e101c5d4b439cf9a26b03aae558",22853626,1,-6,0,969,215,210,-5
"09400e101c5d4b439cf9a26b03aae558","ec341f459285443b8361f7f15638ff08",22853626,1,4,0,970,210,213,3
"ec341f459285443b8361f7f15638ff08","1c6721b1f63f4d30ba7746ea8af02a52",22853626,1,12,0,971,213,221,8
"1c6721b1f63f4d30ba7746ea8af02a52","77ecef8eff6b4a2caea7707669bf7475",22853626,1,1,0,973,221,222,1
"77ecef8eff6b4a2caea7707669bf7475","77ecef8eff6b4a2caea7707669bf7475",22853626,12,0,1,974,222,222,0
"1c6721b1f63f4d30ba7746ea8af02a52","d03cb855c70044cf8c35d9ec0de696e3",22853626,1,4,0,987,221,224,3
"d03cb855c70044cf8c35d9ec0de696e3","8b9ae98743bd4d4a8a87dff1c1244211",22853626,1,3,0,988,224,227,3
"d03cb855c70044cf8c35d9ec0de696e3","a49a937d6896486d9a5396654abcf2e1",22853626,1,2,0,990,224,226,2
"a49a937d6896486d9a5396654abcf2e1","a49a937d6896486d9a5396654abcf2e1",22853626,1,0,1,991,226,226,0
"a49a937d6896486d9a5396654abcf2e1","8b9ae98743bd4d4a8a87dff1c1244211",22853626,1,1,0,992,226,227,1
"8b9ae98743bd4d4a8a87dff1c1244211","8b9ae98743bd4d4a8a87dff1c1244211",22853626,35,0,1,1000,227,227,0
"8b9ae98743bd4d4a8a87dff1c1244211","d03cb855c70044cf8c35d9ec0de696e3",22853626,3,-3,0,1028,227,224,-3
"d03cb855c70044cf8c35d9ec0de696e3","2ab1535aac1346ba8801535bf729ef37",22853626,1,6,0,1029,224,229,5
"2ab1535aac1346ba8801535bf729ef37","f7906d6f59b9489a91d2ef40db5a474d",22853626,1,-7,0,1030,229,223,-6
"f7906d6f59b9489a91d2ef40db5a474d","a4f40fb48a8542c8949bae1f002cd9bc",22853626,1,9,0,1031,223,231,8
"a4f40fb48a8542c8949bae1f002cd9bc","a4f40fb48a8542c8949bae1f002cd9bc",22853626,5,0,1,1032,231,231,0
"a4f40fb48a8542c8949bae1f002cd9bc","8972c23e32044edb8a78fa1eed4e5947",22853626,1,1,0,1037,231,232,1
"8972c23e32044edb8a78fa1eed4e5947","8972c23e32044edb8a78fa1eed4e5947",22853626,3,0,1,1038,232,232,0
"8972c23e32044edb8a78fa1eed4e5947","92feb4a40f8344d38b6f722e42a53295",22853626,1,1,0,1041,232,233,1
"92feb4a40f8344d38b6f722e42a53295","92feb4a40f8344d38b6f722e42a53295",22853626,2,0,1,1042,233,233,0
"92feb4a40f8344d38b6f722e42a53295","2ab1535aac1346ba8801535bf729ef37",22853626,1,-4,0,1044,233,229,-4
"2ab1535aac1346ba8801535bf729ef37","5152833676bf4c6cb317060be10f68db",22853626,2,-1,0,1045,229,228,-1
"5152833676bf4c6cb317060be10f68db","ca3e28f290354c08aefe5b0f769604e6",22853626,1,8,0,1046,228,235,7
"ca3e28f290354c08aefe5b0f769604e6","ca3e28f290354c08aefe5b0f769604e6",22853626,4,0,1,1047,235,235,0
"ca3e28f290354c08aefe5b0f769604e6","79a35eea833e4c2c9d22fc53c3c6445c",22853626,1,1,0,1051,235,236,1
"79a35eea833e4c2c9d22fc53c3c6445c","79a35eea833e4c2c9d22fc53c3c6445c",22853626,4,0,1,1052,236,236,0
"79a35eea833e4c2c9d22fc53c3c6445c","8f68228b1518449e9615cdafee41a2bd",22853626,1,1,0,1056,236,237,1
"8f68228b1518449e9615cdafee41a2bd","8f68228b1518449e9615cdafee41a2bd",22853626,1,0,1,1057,237,237,0
"8f68228b1518449e9615cdafee41a2bd","cab89fa5c3ed45a5aa550fc0352d6a42",22853626,1,1,0,1058,237,238,1
"cab89fa5c3ed45a5aa550fc0352d6a42","cab89fa5c3ed45a5aa550fc0352d6a42",22853626,3,0,1,1059,238,238,0
"cab89fa5c3ed45a5aa550fc0352d6a42","66d4fad4f1cf4b46be0750a99ad7a35a",22853626,1,1,0,1062,238,239,1
"66d4fad4f1cf4b46be0750a99ad7a35a","66d4fad4f1cf4b46be0750a99ad7a35a",22853626,1,0,1,1063,239,239,0
"66d4fad4f1cf4b46be0750a99ad7a35a","0b04c8e2f86d48c7aeb7e225819cd32b",22853626,1,-5,0,1064,239,234,-5
"0b04c8e2f86d48c7aeb7e225819cd32b","0d987bed3ffa4ed0b9a2e62e97b7b30f",22853626,1,49,0,1065,234,272,38
"0d987bed3ffa4ed0b9a2e62e97b7b30f","0d987bed3ffa4ed0b9a2e62e97b7b30f",22853626,8,0,1,1066,272,272,0
"0d987bed3ffa4ed0b9a2e62e97b7b30f","bb5a47f5ea01454a8b79455422d3b9da",22853626,8,10,0,1068,272,280,8
"bb5a47f5ea01454a8b79455422d3b9da","bb5a47f5ea01454a8b79455422d3b9da",22853626,110,0,1,1069,280,280,0
"bb5a47f5ea01454a8b79455422d3b9da","82ae07bc0c9b4570a41799290d1ef399",22853626,5,-6,0,1073,280,275,-5
"82ae07bc0c9b4570a41799290d1ef399","bb5a47f5ea01454a8b79455422d3b9da",22853626,6,6,0,1074,275,280,5
"bb5a47f5ea01454a8b79455422d3b9da","0d987bed3ffa4ed0b9a2e62e97b7b30f",22853626,2,-10,0,1077,280,272,-8
"0d987bed3ffa4ed0b9a2e62e97b7b30f","94cecc3f1e7d484b8e068e79241dfd73",22853626,2,13,0,1078,272,281,9
"94cecc3f1e7d484b8e068e79241dfd73","a37477c4e4c14169ad44b06b493007f6",22853626,2,2,0,1079,281,283,2
"a37477c4e4c14169ad44b06b493007f6","2ae94c0cea4d480a9d5dca8fb1d7b542",22853626,1,-53,0,1080,283,242,-41
"2ae94c0cea4d480a9d5dca8fb1d7b542","2ae94c0cea4d480a9d5dca8fb1d7b542",22853626,2,0,1,1081,242,242,0
"2ae94c0cea4d480a9d5dca8fb1d7b542","1ebf23f9d994469a85206e4c7b1bf5f5",22853626,1,3,0,1082,242,245,3
"1ebf23f9d994469a85206e4c7b1bf5f5","1ebf23f9d994469a85206e4c7b1bf5f5",22853626,11,0,1,1083,245,245,0
"1ebf23f9d994469a85206e4c7b1bf5f5","85ae675b83e8422da842cfd25596af99",22853626,2,1,0,1094,245,246,1
"85ae675b83e8422da842cfd25596af99","85ae675b83e8422da842cfd25596af99",22853626,2,0,1,1095,246,246,0
"85ae675b83e8422da842cfd25596af99","2ae94c0cea4d480a9d5dca8fb1d7b542",22853626,2,-4,0,1096,246,242,-4
"2ae94c0cea4d480a9d5dca8fb1d7b542","fa235f0f364d47e4ae1c87f47bf8e6ba",22853626,4,12,0,1097,242,252,10
"fa235f0f364d47e4ae1c87f47bf8e6ba","fa235f0f364d47e4ae1c87f47bf8e6ba",22853626,1,0,1,1098,252,252,0
"fa235f0f364d47e4ae1c87f47bf8e6ba","79f7845465cc4ed19d8e4f1429541be0",22853626,1,2,0,1099,252,254,2
"79f7845465cc4ed19d8e4f1429541be0","79f7845465cc4ed19d8e4f1429541be0",22853626,2,0,1,1100,254,254,0
"79f7845465cc4ed19d8e4f1429541be0","6e83e23f56544a19b94067c1c558d9c0",22853626,1,-8,0,1102,254,247,-7
"6e83e23f56544a19b94067c1c558d9c0","00f61990949545828dd12f1303d47504",22853626,2,11,0,1103,247,256,9
"00f61990949545828dd12f1303d47504","1ebf23f9d994469a85206e4c7b1bf5f5",22853626,1,-14,0,1104,256,245,-11
"1ebf23f9d994469a85206e4c7b1bf5f5","d546341988904f069cfa86b21457d9d9",22853626,1,8,0,1105,245,251,6
"d546341988904f069cfa86b21457d9d9","2ae94c0cea4d480a9d5dca8fb1d7b542",22853626,1,-11,0,1106,251,242,-9
"fa235f0f364d47e4ae1c87f47bf8e6ba","6e83e23f56544a19b94067c1c558d9c0",22853626,2,-6,0,1108,252,247,-5
"6e83e23f56544a19b94067c1c558d9c0","1ebf23f9d994469a85206e4c7b1bf5f5",22853626,1,-3,0,1109,247,245,-2
"00f61990949545828dd12f1303d47504","d546341988904f069cfa86b21457d9d9",22853626,1,-6,0,1116,256,251,-5
"d546341988904f069cfa86b21457d9d9","1ebf23f9d994469a85206e4c7b1bf5f5",22853626,2,-8,0,1117,251,245,-6
"1ebf23f9d994469a85206e4c7b1bf5f5","2ae94c0cea4d480a9d5dca8fb1d7b542",22853626,3,-3,0,1118,245,242,-3
"fa235f0f364d47e4ae1c87f47bf8e6ba","00f61990949545828dd12f1303d47504",22853626,1,5,0,1120,252,256,4
"00f61990949545828dd12f1303d47504","6e83e23f56544a19b94067c1c558d9c0",22853626,2,-11,0,1121,256,247,-9
"6e83e23f56544a19b94067c1c558d9c0","fa235f0f364d47e4ae1c87f47bf8e6ba",22853626,1,6,0,1122,247,252,5
"fa235f0f364d47e4ae1c87f47bf8e6ba","d546341988904f069cfa86b21457d9d9",22853626,1,-1,0,1123,252,251,-1
"1ebf23f9d994469a85206e4c7b1bf5f5","6e83e23f56544a19b94067c1c558d9c0",22853626,1,3,0,1125,245,247,2
"6e83e23f56544a19b94067c1c558d9c0","1c6721b1f63f4d30ba7746ea8af02a52",22853626,1,-33,0,1126,247,221,-26
"1c6721b1f63f4d30ba7746ea8af02a52","2ae94c0cea4d480a9d5dca8fb1d7b542",22853626,1,27,0,1127,221,242,21
"2ae94c0cea4d480a9d5dca8fb1d7b542","1c6721b1f63f4d30ba7746ea8af02a52",22853626,2,-27,0,1129,242,221,-21
"1c6721b1f63f4d30ba7746ea8af02a52","1ebf23f9d994469a85206e4c7b1bf5f5",22853626,2,30,0,1130,221,245,24
"2ae94c0cea4d480a9d5dca8fb1d7b542","00f61990949545828dd12f1303d47504",22853626,1,17,0,1132,242,256,14
"00f61990949545828dd12f1303d47504","ead7bb4b64e247d2ae632ab8a296b091",22853626,1,2,0,1133,256,258,2
"ead7bb4b64e247d2ae632ab8a296b091","ead7bb4b64e247d2ae632ab8a296b091",22853626,2,0,1,1134,258,258,0
"ead7bb4b64e247d2ae632ab8a296b091","00f61990949545828dd12f1303d47504",22853626,1,-2,0,1136,258,256,-2
"00f61990949545828dd12f1303d47504","41b0048dde734bb280bac6116baa8e27",22853626,1,3,0,1137,256,259,3
"41b0048dde734bb280bac6116baa8e27","41b0048dde734bb280bac6116baa8e27",22853626,9,0,1,1138,259,259,0
"41b0048dde734bb280bac6116baa8e27","b41c5a094a604ee0915327da5cc0beb7",22853626,1,1,0,1147,259,260,1
"b41c5a094a604ee0915327da5cc0beb7","b41c5a094a604ee0915327da5cc0beb7",22853626,5,0,1,1148,260,260,0
"b41c5a094a604ee0915327da5cc0beb7","d546341988904f069cfa86b21457d9d9",22853626,1,-10,0,1153,260,251,-9
"d546341988904f069cfa86b21457d9d9","28c171777c52431ab6b925073bd63d46",22853626,1,15,0,1154,251,264,13
"28c171777c52431ab6b925073bd63d46","28c171777c52431ab6b925073bd63d46",22853626,11,0,1,1155,264,264,0
"28c171777c52431ab6b925073bd63d46","ac160db940cb49ae8579162b1d52bb5d",22853626,1,2,0,1166,264,266,2
"ac160db940cb49ae8579162b1d52bb5d","ac160db940cb49ae8579162b1d52bb5d",22853626,3,0,1,1167,266,266,0
"ac160db940cb49ae8579162b1d52bb5d","d989ebcfc12a4b669f0100dc1aa14f1e",22853626,1,-12,0,1170,266,255,-11
"d989ebcfc12a4b669f0100dc1aa14f1e","c6fd49b485cc4874b0bbdd9c6171e09c",22853626,1,15,0,1171,255,268,13
"c6fd49b485cc4874b0bbdd9c6171e09c","c6fd49b485cc4874b0bbdd9c6171e09c",22853626,10,0,1,1172,268,268,0
"c6fd49b485cc4874b0bbdd9c6171e09c","44240778a97c4af0937817499b75707b",22853626,2,1,0,1179,268,269,1
"44240778a97c4af0937817499b75707b","44240778a97c4af0937817499b75707b",22853626,6,0,1,1180,269,269,0
"44240778a97c4af0937817499b75707b","7aa76d3e993840d8805f097cbdbcd44b",22853626,3,-9,0,1182,269,261,-8
"7aa76d3e993840d8805f097cbdbcd44b","7028800abe7d4e27b613d1d6cbe26bf7",22853626,2,7,0,1183,261,267,6
"7028800abe7d4e27b613d1d6cbe26bf7","7aa76d3e993840d8805f097cbdbcd44b",22853626,1,-7,0,1184,267,261,-6
"7aa76d3e993840d8805f097cbdbcd44b","2ae94c0cea4d480a9d5dca8fb1d7b542",22853626,3,-23,0,1185,261,242,-19
"2ae94c0cea4d480a9d5dca8fb1d7b542","0d987bed3ffa4ed0b9a2e62e97b7b30f",22853626,4,38,0,1186,242,272,30
"0d987bed3ffa4ed0b9a2e62e97b7b30f","2ae94c0cea4d480a9d5dca8fb1d7b542",22853626,5,-38,0,1188,272,242,-30
"2ae94c0cea4d480a9d5dca8fb1d7b542","7028800abe7d4e27b613d1d6cbe26bf7",22853626,3,30,0,1189,242,267,25
"7028800abe7d4e27b613d1d6cbe26bf7","c6fd49b485cc4874b0bbdd9c6171e09c",22853626,1,1,0,1190,267,268,1
"7028800abe7d4e27b613d1d6cbe26bf7","82ae07bc0c9b4570a41799290d1ef399",22853626,1,12,0,1200,267,275,8
"82ae07bc0c9b4570a41799290d1ef399","0d987bed3ffa4ed0b9a2e62e97b7b30f",22853626,4,-4,0,1201,275,272,-3
"0d987bed3ffa4ed0b9a2e62e97b7b30f","82ae07bc0c9b4570a41799290d1ef399",22853626,2,4,0,1202,272,275,3
"bb5a47f5ea01454a8b79455422d3b9da","df1de691dafe4549a18a4398ee9dfaf9",22853626,1,-188,0,1211,280,139,-141
"df1de691dafe4549a18a4398ee9dfaf9","f03480cf4eba413194d7af52fc0e7f28",22853626,1,15,0,1212,139,152,13
"f03480cf4eba413194d7af52fc0e7f28","d313cec988a84645bee413e8d4724a4b",22853626,3,7,0,1213,152,158,6
"d313cec988a84645bee413e8d4724a4b","d313cec988a84645bee413e8d4724a4b",22853626,7,0,1,1214,158,158,0
"d313cec988a84645bee413e8d4724a4b","78adeee1fa2c4fe0bc73f7bca9fcee86",22853626,1,4,0,1216,158,160,2
"78adeee1fa2c4fe0bc73f7bca9fcee86","df1de691dafe4549a18a4398ee9dfaf9",22853626,2,-26,0,1217,160,139,-21
"df1de691dafe4549a18a4398ee9dfaf9","65202579580f4ad38d734b4ee39d22a8",22853626,2,31,0,1218,139,164,25
"65202579580f4ad38d734b4ee39d22a8","78adeee1fa2c4fe0bc73f7bca9fcee86",22853626,10,-5,0,1219,164,160,-4
"78adeee1fa2c4fe0bc73f7bca9fcee86","65202579580f4ad38d734b4ee39d22a8",22853626,15,5,0,1220,160,164,4
"65202579580f4ad38d734b4ee39d22a8","65202579580f4ad38d734b4ee39d22a8",22853626,124,0,1,1221,164,164,0
"65202579580f4ad38d734b4ee39d22a8","67a089198fcb4e1c8f2385786c2b296f",22853626,1,-157,0,1227,164,39,-125
"64d48c6c9c7940639a932219a6c87198","64dbedb3ce544f6aae8e10e0cf10f16d",22853626,1,261,0,1229,40,240,200
"64dbedb3ce544f6aae8e10e0cf10f16d","1c6721b1f63f4d30ba7746ea8af02a52",22853626,1,-23,0,1230,240,221,-19
"1c6721b1f63f4d30ba7746ea8af02a52","1c6721b1f63f4d30ba7746ea8af02a52",22853626,4,0,1,1231,221,221,0
"1c6721b1f63f4d30ba7746ea8af02a52","64dbedb3ce544f6aae8e10e0cf10f16d",22853626,1,23,0,1234,221,240,19
"64dbedb3ce544f6aae8e10e0cf10f16d","0b04c8e2f86d48c7aeb7e225819cd32b",22853626,1,-7,0,1235,240,234,-6
"0b04c8e2f86d48c7aeb7e225819cd32b","2ab1535aac1346ba8801535bf729ef37",22853626,1,-6,0,1236,234,229,-5
"5152833676bf4c6cb317060be10f68db","8b9ae98743bd4d4a8a87dff1c1244211",22853626,1,-2,0,1238,228,227,-1
"d03cb855c70044cf8c35d9ec0de696e3","f7906d6f59b9489a91d2ef40db5a474d",22853626,1,-1,0,1240,224,223,-1
"f7906d6f59b9489a91d2ef40db5a474d","f53da5fd9bfe412da4b80d4742563b6c",22853626,1,21,0,1241,223,241,18
"f53da5fd9bfe412da4b80d4742563b6c","f53da5fd9bfe412da4b80d4742563b6c",22853626,1,0,1,1242,241,241,0
"f53da5fd9bfe412da4b80d4742563b6c","2ae94c0cea4d480a9d5dca8fb1d7b542",22853626,1,3,0,1243,241,242,1
"2ae94c0cea4d480a9d5dca8fb1d7b542","30c9ba177afc49a695625d2bdec40207",22853626,1,9,0,1247,242,250,8
"30c9ba177afc49a695625d2bdec40207","30c9ba177afc49a695625d2bdec40207",22853626,2,0,1,1248,250,250,0
"30c9ba177afc49a695625d2bdec40207","00f61990949545828dd12f1303d47504",22853626,1,8,0,1250,250,256,6
"6e83e23f56544a19b94067c1c558d9c0","d546341988904f069cfa86b21457d9d9",22853626,1,5,0,1252,247,251,4
"d546341988904f069cfa86b21457d9d9","7aa76d3e993840d8805f097cbdbcd44b",22853626,1,12,0,1253,251,261,10
"7028800abe7d4e27b613d1d6cbe26bf7","44240778a97c4af0937817499b75707b",22853626,2,2,0,1255,267,269,2
"7aa76d3e993840d8805f097cbdbcd44b","865a4d3b43374da7944dc7d397f566d9",22853626,1,12,0,1259,261,271,10
"865a4d3b43374da7944dc7d397f566d9","865a4d3b43374da7944dc7d397f566d9",22853626,3,0,1,1260,271,271,0
"865a4d3b43374da7944dc7d397f566d9","0d987bed3ffa4ed0b9a2e62e97b7b30f",22853626,1,3,0,1263,271,272,1
"44240778a97c4af0937817499b75707b","c6fd49b485cc4874b0bbdd9c6171e09c",22853626,1,-1,0,1269,269,268,-1
"c6fd49b485cc4874b0bbdd9c6171e09c","7aa76d3e993840d8805f097cbdbcd44b",22853626,1,-8,0,1270,268,261,-7
"94cecc3f1e7d484b8e068e79241dfd73","94cecc3f1e7d484b8e068e79241dfd73",22853626,1,0,1,1285,281,281,0
"94cecc3f1e7d484b8e068e79241dfd73","fab84b4fab5940efb4ea868ef8d09396",22853626,2,5,0,1286,281,284,3
"fab84b4fab5940efb4ea868ef8d09396","a37477c4e4c14169ad44b06b493007f6",22853626,1,-3,0,1287,284,283,-1
"a37477c4e4c14169ad44b06b493007f6","82ae07bc0c9b4570a41799290d1ef399",22853626,1,-11,0,1288,283,275,-8
"bb5a47f5ea01454a8b79455422d3b9da","4a29443515bb404cb8924e1c60a63b73",22853626,1,12,0,1299,280,285,5
"4a29443515bb404cb8924e1c60a63b73","4a29443515bb404cb8924e1c60a63b73",22853626,2,0,1,1300,285,285,0
"4a29443515bb404cb8924e1c60a63b73","208c9b2796c944db8dacaa96082520ea",22853626,2,3,0,1301,285,288,3
"208c9b2796c944db8dacaa96082520ea","208c9b2796c944db8dacaa96082520ea",22853626,3,0,1,1302,288,288,0
"208c9b2796c944db8dacaa96082520ea","4a29443515bb404cb8924e1c60a63b73",22853626,4,-3,0,1303,288,285,-3
"4a29443515bb404cb8924e1c60a63b73","7669a956527947d0add87455277e80b4",22853626,1,7,0,1304,285,291,6
"7669a956527947d0add87455277e80b4","7669a956527947d0add87455277e80b4",22853626,1,0,1,1305,291,291,0
"7669a956527947d0add87455277e80b4","6a9a3b5bde4a48daa896fe8c06eca56f",22853626,1,-2,0,1306,291,289,-2
"6a9a3b5bde4a48daa896fe8c06eca56f","869e967078f04da18dd0b0b9389a7424",22853626,1,5,0,1307,289,293,4
"869e967078f04da18dd0b0b9389a7424","869e967078f04da18dd0b0b9389a7424",22853626,1,0,1,1308,293,293,0
"869e967078f04da18dd0b0b9389a7424","51ab6291537748fab90d519aa09889d6",22853626,1,2,0,1309,293,295,2
"51ab6291537748fab90d519aa09889d6","51ab6291537748fab90d519aa09889d6",22853626,5,0,1,1310,295,295,0
"51ab6291537748fab90d519aa09889d6","34a6e49023fc4465bd5ca604330bbd1c",22853626,1,-3,0,1315,295,292,-3
"34a6e49023fc4465bd5ca604330bbd1c","21592f2a9e9c4b2f8c66ec5dbcbf6a2b",22853626,1,5,0,1316,292,296,4
"21592f2a9e9c4b2f8c66ec5dbcbf6a2b","208c9b2796c944db8dacaa96082520ea",22853626,1,-11,0,1317,296,288,-8
"4a29443515bb404cb8924e1c60a63b73","6a9a3b5bde4a48daa896fe8c06eca56f",22853626,2,5,0,1319,285,289,4
"6a9a3b5bde4a48daa896fe8c06eca56f","21592f2a9e9c4b2f8c66ec5dbcbf6a2b",22853626,1,9,0,1320,289,296,7
"21592f2a9e9c4b2f8c66ec5dbcbf6a2b","ba0e59461bfb4a44b7b1c28a01f8d3b3",22853626,1,4,0,1321,296,299,3
"ba0e59461bfb4a44b7b1c28a01f8d3b3","ba0e59461bfb4a44b7b1c28a01f8d3b3",22853626,3,0,1,1322,299,299,0
"ba0e59461bfb4a44b7b1c28a01f8d3b3","0e0b36e731a645e7b1b8a88f5031ca38",22853626,1,2,0,1325,299,301,2
"0e0b36e731a645e7b1b8a88f5031ca38","0e0b36e731a645e7b1b8a88f5031ca38",22853626,5,0,1,1326,301,301,0
"0e0b36e731a645e7b1b8a88f5031ca38","a66a144637284c21afc6de17fea4bfb8",22853626,1,1,0,1331,301,302,1
"a66a144637284c21afc6de17fea4bfb8","a66a144637284c21afc6de17fea4bfb8",22853626,2,0,1,1332,302,302,0
"a66a144637284c21afc6de17fea4bfb8","7646a919d7e64fa990bca9b024ff089d",22853626,1,-4,0,1334,302,298,-4
"7646a919d7e64fa990bca9b024ff089d","e390b575229748ea8aac9364efe2bf00",22853626,1,7,0,1335,298,304,6
"e390b575229748ea8aac9364efe2bf00","e390b575229748ea8aac9364efe2bf00",22853626,1,0,1,1336,304,304,0
"e390b575229748ea8aac9364efe2bf00","4a29443515bb404cb8924e1c60a63b73",22853626,1,-24,0,1337,304,285,-19
"4a29443515bb404cb8924e1c60a63b73","3434c10e561d488a914e0f7d71907abd",22853626,1,27,0,1338,285,305,20
"3434c10e561d488a914e0f7d71907abd","53e7e900392747ccad52e711ab0f80d8",22853626,2,2,0,1339,305,307,2
"53e7e900392747ccad52e711ab0f80d8","53e7e900392747ccad52e711ab0f80d8",22853626,3,0,1,1340,307,307,0
"53e7e900392747ccad52e711ab0f80d8","130acc2aeb0448fdbb2de63bc5cebe5b",22853626,1,3,0,1343,307,309,2
"130acc2aeb0448fdbb2de63bc5cebe5b","3434c10e561d488a914e0f7d71907abd",22853626,1,-5,0,1344,309,305,-4
"3434c10e561d488a914e0f7d71907abd","130acc2aeb0448fdbb2de63bc5cebe5b",22853626,2,5,0,1345,305,309,4
"130acc2aeb0448fdbb2de63bc5cebe5b","9c062b3251034ebe90f5054e2a3b5120",22853626,2,2,0,1346,309,311,2
"9c062b3251034ebe90f5054e2a3b5120","9c062b3251034ebe90f5054e2a3b5120",22853626,4,0,1,1347,311,311,0
"9c062b3251034ebe90f5054e2a3b5120","ea859f8207e44537889daeaba13ac2e8",22853626,2,1,0,1349,311,312,1
"ea859f8207e44537889daeaba13ac2e8","ea859f8207e44537889daeaba13ac2e8",22853626,2,0,1,1350,312,312,0
"ea859f8207e44537889daeaba13ac2e8","56d94971a7a94257aa330183a8ebd0ea",22853626,1,1,0,1351,312,313,1
"56d94971a7a94257aa330183a8ebd0ea","56d94971a7a94257aa330183a8ebd0ea",22853626,6,0,1,1352,313,313,0
"56d94971a7a94257aa330183a8ebd0ea","141c0df6cd1946539aadd1c9b7068cd4",22853626,1,-5,0,1358,313,308,-5
"141c0df6cd1946539aadd1c9b7068cd4","13255e63e0aa4abf85e5211bf613d43e",22853626,1,10,0,1359,308,317,9
"13255e63e0aa4abf85e5211bf613d43e","13255e63e0aa4abf85e5211bf613d43e",22853626,1,0,1,1360,317,317,0
"13255e63e0aa4abf85e5211bf613d43e","0c787d16c9504873b1a4d903cec09948",22853626,1,-3,0,1361,317,314,-3
"0c787d16c9504873b1a4d903cec09948","86c27d40179e419c8e9d150fb6afa5d0",22853626,1,6,0,1362,314,319,5
"86c27d40179e419c8e9d150fb6afa5d0","86c27d40179e419c8e9d150fb6afa5d0",22853626,1,0,1,1363,319,319,0
"86c27d40179e419c8e9d150fb6afa5d0","8d7e0b55cf9849cda222a0f2440cec55",22853626,1,-1,0,1364,319,318,-1
"8d7e0b55cf9849cda222a0f2440cec55","47edbb64109243e6b0f8f64cdef90c6c",22853626,2,9,0,1365,318,326,8
"47edbb64109243e6b0f8f64cdef90c6c","24f1363179ad4aaa965484a78471912b",22853626,2,-3,0,1366,326,323,-3
"24f1363179ad4aaa965484a78471912b","24f1363179ad4aaa965484a78471912b",22853626,2,0,1,1367,323,323,0
"24f1363179ad4aaa965484a78471912b","3434c10e561d488a914e0f7d71907abd",22853626,1,-22,0,1369,323,305,-18
"53e7e900392747ccad52e711ab0f80d8","3434c10e561d488a914e0f7d71907abd",22853626,1,-2,0,1371,307,305,-2
"130acc2aeb0448fdbb2de63bc5cebe5b","130acc2aeb0448fdbb2de63bc5cebe5b",22853626,1,0,1,1373,309,309,0
"ea859f8207e44537889daeaba13ac2e8","141c0df6cd1946539aadd1c9b7068cd4",22853626,1,-4,0,1379,312,308,-4
"141c0df6cd1946539aadd1c9b7068cd4","86c27d40179e419c8e9d150fb6afa5d0",22853626,1,13,0,1380,308,319,11
"86c27d40179e419c8e9d150fb6afa5d0","0c787d16c9504873b1a4d903cec09948",22853626,1,-6,0,1381,319,314,-5
"0c787d16c9504873b1a4d903cec09948","24f1363179ad4aaa965484a78471912b",22853626,1,11,0,1382,314,323,9
"24f1363179ad4aaa965484a78471912b","8d7e0b55cf9849cda222a0f2440cec55",22853626,1,-6,0,1383,323,318,-5
"24f1363179ad4aaa965484a78471912b","3628bdce1dd2429ba924d2d4d09448d2",22853626,1,-1,0,1386,323,322,-1
"3628bdce1dd2429ba924d2d4d09448d2","56b3fd1a212a4764be39d979fde3326e",22853626,1,7,0,1387,322,328,6
"56b3fd1a212a4764be39d979fde3326e","56b3fd1a212a4764be39d979fde3326e",22853626,1,0,1,1388,328,328,0
"56b3fd1a212a4764be39d979fde3326e","0c4079457ede49e3aeb5e86ed84bdf35",22853626,1,3,0,1389,328,329,1
"0c4079457ede49e3aeb5e86ed84bdf35","3434c10e561d488a914e0f7d71907abd",22853626,1,-31,0,1390,329,305,-24
"3434c10e561d488a914e0f7d71907abd","38aea304b4fa46e1b29bb72f5cea4c93",22853626,1,33,0,1391,305,331,26
"38aea304b4fa46e1b29bb72f5cea4c93","38aea304b4fa46e1b29bb72f5cea4c93",22853626,1,0,1,1392,331,331,0
"38aea304b4fa46e1b29bb72f5cea4c93","e36d261332f14e79bb4b467aceaeb9b5",22853626,1,2,0,1393,331,333,2
"e36d261332f14e79bb4b467aceaeb9b5","e36d261332f14e79bb4b467aceaeb9b5",22853626,1,0,1,1394,333,333,0
"e36d261332f14e79bb4b467aceaeb9b5","c7e89b9d04744d2eab742fc24e3ef1ae",22853626,1,1,0,1395,333,334,1
"c7e89b9d04744d2eab742fc24e3ef1ae","c7e89b9d04744d2eab742fc24e3ef1ae",22853626,5,0,1,1396,334,334,0
"c7e89b9d04744d2eab742fc24e3ef1ae","fe49f8054b374a0ea4bb266ed135ff62",22853626,1,1,0,1401,334,335,1
"fe49f8054b374a0ea4bb266ed135ff62","fe49f8054b374a0ea4bb266ed135ff62",22853626,2,0,1,1402,335,335,0
"fe49f8054b374a0ea4bb266ed135ff62","d0a8f74af98642fe8360d22c42e45117",22853626,1,1,0,1404,335,336,1
"d0a8f74af98642fe8360d22c42e45117","d0a8f74af98642fe8360d22c42e45117",22853626,2,0,1,1405,336,336,0
"d0a8f74af98642fe8360d22c42e45117","0c4079457ede49e3aeb5e86ed84bdf35",22853626,1,-7,0,1407,336,329,-7
"0c4079457ede49e3aeb5e86ed84bdf35","b8b9418ab322418d9db9b40d96af873a",22853626,1,9,0,1408,329,337,8
"b8b9418ab322418d9db9b40d96af873a","0c4079457ede49e3aeb5e86ed84bdf35",22853626,1,-9,0,1409,337,329,-8
"0c4079457ede49e3aeb5e86ed84bdf35","a7c6339ca1da4368a18d471f0519f877",22853626,1,11,0,1410,329,339,10
"a7c6339ca1da4368a18d471f0519f877","a7c6339ca1da4368a18d471f0519f877",22853626,1,0,1,1411,339,339,0
"a7c6339ca1da4368a18d471f0519f877","bbc5139ca9024389a94db3a6f47dcff6",22853626,1,3,0,1412,339,341,2
"bbc5139ca9024389a94db3a6f47dcff6","b8b9418ab322418d9db9b40d96af873a",22853626,1,-5,0,1413,341,337,-4
"b8b9418ab322418d9db9b40d96af873a","bbc5139ca9024389a94db3a6f47dcff6",22853626,2,5,0,1414,337,341,4
"bbc5139ca9024389a94db3a6f47dcff6","bbc5139ca9024389a94db3a6f47dcff6",22853626,8,0,1,1415,341,341,0
"bbc5139ca9024389a94db3a6f47dcff6","4ee6ca9019ab4a1ab323f98094a9bd77",22853626,4,2,0,1419,341,343,2
"4ee6ca9019ab4a1ab323f98094a9bd77","4ee6ca9019ab4a1ab323f98094a9bd77",22853626,6,0,1,1420,343,343,0
"4ee6ca9019ab4a1ab323f98094a9bd77","b37947176785476f8b29d49a851366dc",22853626,3,1,0,1422,343,344,1
"b37947176785476f8b29d49a851366dc","b37947176785476f8b29d49a851366dc",22853626,6,0,1,1423,344,344,0
"b37947176785476f8b29d49a851366dc","bbc5139ca9024389a94db3a6f47dcff6",22853626,1,-3,0,1425,344,341,-3
"bbc5139ca9024389a94db3a6f47dcff6","fcea5b10d5a14a3b9324ffece8f6e1e5",22853626,1,4,0,1429,341,345,4
"fcea5b10d5a14a3b9324ffece8f6e1e5","fcea5b10d5a14a3b9324ffece8f6e1e5",22853626,7,0,1,1430,345,345,0
"fcea5b10d5a14a3b9324ffece8f6e1e5","c2490bc612d146edbe786556fab3651b",22853626,2,-5,0,1435,345,340,-5
"c2490bc612d146edbe786556fab3651b","6ac8bb048b854999a47edb35fe627f11",22853626,2,8,0,1436,340,347,7
"6ac8bb048b854999a47edb35fe627f11","6ac8bb048b854999a47edb35fe627f11",22853626,2,0,1,1437,347,347,0
"6ac8bb048b854999a47edb35fe627f11","30ead9794d4847abaf222ca966cc8630",22853626,2,3,0,1438,347,348,1
"30ead9794d4847abaf222ca966cc8630","0c4079457ede49e3aeb5e86ed84bdf35",22853626,2,-24,0,1439,348,329,-19
"0c4079457ede49e3aeb5e86ed84bdf35","897b7f51242c44aab2205c72fdcbf4cd",22853626,2,28,0,1440,329,352,23
"897b7f51242c44aab2205c72fdcbf4cd","09b9678ddc3d452ea4a3d46e15826065",22853626,3,1,0,1441,352,353,1
"09b9678ddc3d452ea4a3d46e15826065","c20993c944444fe085345591a8bd837e",22853626,1,-2,0,1442,353,351,-2
"c20993c944444fe085345591a8bd837e","eff0de7f2dbb42dfa1a2e686efab5b6d",22853626,2,3,0,1443,351,354,3
"eff0de7f2dbb42dfa1a2e686efab5b6d","c20993c944444fe085345591a8bd837e",22853626,2,-3,0,1444,354,351,-3
"c20993c944444fe085345591a8bd837e","c20993c944444fe085345591a8bd837e",22853626,4,0,1,1445,351,351,0
"c20993c944444fe085345591a8bd837e","897b7f51242c44aab2205c72fdcbf4cd",22853626,1,1,0,1448,351,352,1
"897b7f51242c44aab2205c72fdcbf4cd","897b7f51242c44aab2205c72fdcbf4cd",22853626,4,0,1,1449,352,352,0
"09b9678ddc3d452ea4a3d46e15826065","09b9678ddc3d452ea4a3d46e15826065",22853626,4,0,1,1453,353,353,0
"09b9678ddc3d452ea4a3d46e15826065","eff0de7f2dbb42dfa1a2e686efab5b6d",22853626,2,1,0,1456,353,354,1
"eff0de7f2dbb42dfa1a2e686efab5b6d","eff0de7f2dbb42dfa1a2e686efab5b6d",22853626,4,0,1,1457,354,354,0
"eff0de7f2dbb42dfa1a2e686efab5b6d","30ead9794d4847abaf222ca966cc8630",22853626,1,-6,0,1460,354,348,-6
"30ead9794d4847abaf222ca966cc8630","2fe14166dc9642c3bc666b86a57f943d",22853626,2,10,0,1461,348,357,9
"2fe14166dc9642c3bc666b86a57f943d","2fe14166dc9642c3bc666b86a57f943d",22853626,3,0,1,1462,357,357,0
"2fe14166dc9642c3bc666b86a57f943d","44421dd1e13a47a388c4a19834b744c7",22853626,1,2,0,1464,357,359,2
"44421dd1e13a47a388c4a19834b744c7","44421dd1e13a47a388c4a19834b744c7",22853626,2,0,1,1465,359,359,0
"44421dd1e13a47a388c4a19834b744c7","cb5fc7ef85d547c4be1a7439d0bf6052",22853626,1,1,0,1467,359,360,1
"cb5fc7ef85d547c4be1a7439d0bf6052","cb5fc7ef85d547c4be1a7439d0bf6052",22853626,5,0,1,1468,360,360,0
"cb5fc7ef85d547c4be1a7439d0bf6052","0a8f150a4cf747acbde62f4721823da3",22853626,1,1,0,1473,360,361,1
"0a8f150a4cf747acbde62f4721823da3","0a8f150a4cf747acbde62f4721823da3",22853626,2,0,1,1474,361,361,0
"0a8f150a4cf747acbde62f4721823da3","ab8fdad974ae471f9f24c3f9dd04462e",22853626,1,1,0,1476,361,362,1
"ab8fdad974ae471f9f24c3f9dd04462e","ab8fdad974ae471f9f24c3f9dd04462e",22853626,2,0,1,1477,362,362,0
"ab8fdad974ae471f9f24c3f9dd04462e","1ba8fef685d74a8194b9db252eb704fb",22853626,1,-7,0,1479,362,355,-7
"1ba8fef685d74a8194b9db252eb704fb","52580888dadb4fe3baa795683ea227bd",22853626,1,10,0,1480,355,364,9
"52580888dadb4fe3baa795683ea227bd","52580888dadb4fe3baa795683ea227bd",22853626,1,0,1,1481,364,364,0
"52580888dadb4fe3baa795683ea227bd","f00179e251a045b39c3f7a54f9aa4acc",22853626,1,-1,0,1482,364,363,-1
"f00179e251a045b39c3f7a54f9aa4acc","492a3bc6a1254f23a7998587961b22a4",22853626,1,4,0,1483,363,366,3
"492a3bc6a1254f23a7998587961b22a4","492a3bc6a1254f23a7998587961b22a4",22853626,1,0,1,1484,366,366,0
"492a3bc6a1254f23a7998587961b22a4","072a190fd302456290895f9f04d6940a",22853626,1,-1,0,1485,366,365,-1
"072a190fd302456290895f9f04d6940a","cfa457d1743848e4bb5e4beced6448ed",22853626,1,5,0,1486,365,369,4
"cfa457d1743848e4bb5e4beced6448ed","cfa457d1743848e4bb5e4beced6448ed",22853626,1,0,1,1487,369,369,0
"cfa457d1743848e4bb5e4beced6448ed","30ead9794d4847abaf222ca966cc8630",22853626,1,-25,0,1488,369,348,-21
"30ead9794d4847abaf222ca966cc8630","b71bac264efb4abd97015447bd490db6",22853626,1,28,0,1489,348,370,22
"b71bac264efb4abd97015447bd490db6","8d448d625b024c82a5eb240bbd7431d6",22853626,10,5,0,1490,370,374,4
"8d448d625b024c82a5eb240bbd7431d6","8d448d625b024c82a5eb240bbd7431d6",22853626,85,0,1,1491,374,374,0
"8d448d625b024c82a5eb240bbd7431d6","b71bac264efb4abd97015447bd490db6",22853626,8,-5,0,1492,374,370,-4
"b71bac264efb4abd97015447bd490db6","d6d02b6ef04e4f17805504500b8ce441",22853626,4,8,0,1500,370,375,5
"d6d02b6ef04e4f17805504500b8ce441","d6d02b6ef04e4f17805504500b8ce441",22853626,38,0,1,1501,375,375,0
"d6d02b6ef04e4f17805504500b8ce441","66baf19b6b904b70922329068c63746d",22853626,2,4,0,1503,375,376,1
"66baf19b6b904b70922329068c63746d","7f544639412e40a9ba27f43b415362ab",22853626,7,2,0,1504,376,378,2
"7f544639412e40a9ba27f43b415362ab","66baf19b6b904b70922329068c63746d",22853626,3,-2,0,1505,378,376,-2
"66baf19b6b904b70922329068c63746d","66baf19b6b904b70922329068c63746d",22853626,3,0,1,1506,376,376,0
"7f544639412e40a9ba27f43b415362ab","78adeee1fa2c4fe0bc73f7bca9fcee86",22853626,2,-298,0,1508,378,160,-218
"65202579580f4ad38d734b4ee39d22a8","8959e6304a0348309a771e4d08d1b64a",22853626,3,-1,0,1518,164,163,-1
"8959e6304a0348309a771e4d08d1b64a","e2911e79efc2420eac45d9f671463d4b",22853626,1,-225,0,1519,163,2,-161
"e2911e79efc2420eac45d9f671463d4b","56586aa865414f538729c7f7735d2bc6",22853626,8,12,0,1522,2,12,10
"56586aa865414f538729c7f7735d2bc6","e2911e79efc2420eac45d9f671463d4b",22853626,4,-12,0,1523,12,2,-10
"56586aa865414f538729c7f7735d2bc6","b7f2b31585d94eb3bf86376714aa7070",22853626,8,2,0,1525,12,13,1
"b7f2b31585d94eb3bf86376714aa7070","56586aa865414f538729c7f7735d2bc6",22853626,3,-2,0,1526,13,12,-1
"b7f2b31585d94eb3bf86376714aa7070","3f1c815879794b929260d224becaff7e",22853626,5,2,0,1528,13,14,1
"3f1c815879794b929260d224becaff7e","66baf19b6b904b70922329068c63746d",22853626,1,501,0,1529,14,376,362
"7f544639412e40a9ba27f43b415362ab","7f544639412e40a9ba27f43b415362ab",22853626,3,0,1,1534,378,378,0
"7f544639412e40a9ba27f43b415362ab","d5ae8642e15b46b8bd298b02274d4e9c",22853626,1,2,0,1536,378,380,2
"d5ae8642e15b46b8bd298b02274d4e9c","d5ae8642e15b46b8bd298b02274d4e9c",22853626,1,0,1,1537,380,380,0
"d5ae8642e15b46b8bd298b02274d4e9c","a0d10309a2dd456289147f84be9d37f9",22853626,1,1,0,1538,380,381,1
"a0d10309a2dd456289147f84be9d37f9","a0d10309a2dd456289147f84be9d37f9",22853626,2,0,1,1539,381,381,0
"a0d10309a2dd456289147f84be9d37f9","0fcbc3ca07b144138b8d85da581f09a8",22853626,1,1,0,1541,381,382,1
"0fcbc3ca07b144138b8d85da581f09a8","0fcbc3ca07b144138b8d85da581f09a8",22853626,5,0,1,1542,382,382,0
"0fcbc3ca07b144138b8d85da581f09a8","66baf19b6b904b70922329068c63746d",22853626,1,-6,0,1547,382,376,-6
"66baf19b6b904b70922329068c63746d","c2fca3669923477ab966ded303dea31c",22853626,2,8,0,1548,376,383,7
"c2fca3669923477ab966ded303dea31c","4890121ce5d74576b4632b77cfc23398",22853626,1,6,0,1549,383,388,5
"4890121ce5d74576b4632b77cfc23398","4890121ce5d74576b4632b77cfc23398",22853626,1,0,1,1550,388,388,0
"4890121ce5d74576b4632b77cfc23398","18d3b836dd804224883cc9180b60a8e1",22853626,1,-1,0,1551,388,387,-1
"18d3b836dd804224883cc9180b60a8e1","96bb2b3e85a34d8b9544514e89f6fe97",22853626,1,4,0,1552,387,390,3
"96bb2b3e85a34d8b9544514e89f6fe97","1ba8fef685d74a8194b9db252eb704fb",22853626,1,-49,0,1553,390,355,-35
"1ba8fef685d74a8194b9db252eb704fb","30ead9794d4847abaf222ca966cc8630",22853626,1,-8,0,1554,355,348,-7
"2fe14166dc9642c3bc666b86a57f943d","56586aa865414f538729c7f7735d2bc6",22853626,1,-475,0,1557,357,12,-345
"56586aa865414f538729c7f7735d2bc6","56586aa865414f538729c7f7735d2bc6",22853626,13,0,1,1558,12,12,0
"56586aa865414f538729c7f7735d2bc6","66baf19b6b904b70922329068c63746d",22853626,1,505,0,1561,12,376,364
"78adeee1fa2c4fe0bc73f7bca9fcee86","78adeee1fa2c4fe0bc73f7bca9fcee86",22853626,5,0,1,1564,160,160,0
"65202579580f4ad38d734b4ee39d22a8","3cbcea2be0984e7dbd5a48195af10ce7",22853626,4,3,0,1630,164,165,1
"3cbcea2be0984e7dbd5a48195af10ce7","78adeee1fa2c4fe0bc73f7bca9fcee86",22853626,4,-8,0,1631,165,160,-5
"78adeee1fa2c4fe0bc73f7bca9fcee86","82e6285962b8400d9d6fc32436022a94",22853626,3,10,0,1632,160,167,7
"82e6285962b8400d9d6fc32436022a94","3cbcea2be0984e7dbd5a48195af10ce7",22853626,2,-2,0,1633,167,165,-2
"3cbcea2be0984e7dbd5a48195af10ce7","a9ac840f098c4bd0a2ee896214ce29cd",22853626,2,5,0,1634,165,168,3
"a9ac840f098c4bd0a2ee896214ce29cd","0c7262dff33c4087bc660ccf40f92f9c",22853626,2,4,0,1635,168,169,1
"0c7262dff33c4087bc660ccf40f92f9c","a9ac840f098c4bd0a2ee896214ce29cd",22853626,2,-4,0,1636,169,168,-1
"a9ac840f098c4bd0a2ee896214ce29cd","b2275c3fad834f8d90737a2d9a6927d6",22853626,2,7,0,1637,168,172,4
"b2275c3fad834f8d90737a2d9a6927d6","0d987bed3ffa4ed0b9a2e62e97b7b30f",22853626,1,132,0,1638,172,272,100
"bb5a47f5ea01454a8b79455422d3b9da","bc5524e78a8544e2ae2fdc2f3462bbec",22853626,1,-1,0,1650,280,279,-1
"bc5524e78a8544e2ae2fdc2f3462bbec","82ae07bc0c9b4570a41799290d1ef399",22853626,1,-5,0,1651,279,275,-4
"2ae94c0cea4d480a9d5dca8fb1d7b542","78adeee1fa2c4fe0bc73f7bca9fcee86",22853626,1,-114,0,1656,242,160,-82
"78adeee1fa2c4fe0bc73f7bca9fcee86","b613861cecf84ffcab01afb23f660475",22853626,1,-224,0,1657,160,1,-159
"b613861cecf84ffcab01afb23f660475","b613861cecf84ffcab01afb23f660475",22853626,5,0,1,1658,1,1,0
"b613861cecf84ffcab01afb23f660475","e2911e79efc2420eac45d9f671463d4b",22853626,3,3,0,1659,1,2,1
"e2911e79efc2420eac45d9f671463d4b","b613861cecf84ffcab01afb23f660475",22853626,1,-3,0,1660,2,1,-1
"b7f2b31585d94eb3bf86376714aa7070","b7f2b31585d94eb3bf86376714aa7070",22853626,5,0,1,1666,13,13,0
"3f1c815879794b929260d224becaff7e","5c5ceeee4562457ba6d41515aeebfbb1",22853626,2,6,0,1668,14,17,3
"5c5ceeee4562457ba6d41515aeebfbb1","81c864a886d54a6b8ff85f7d736f4f95",22853626,2,-4,0,1669,17,15,-2
"81c864a886d54a6b8ff85f7d736f4f95","56586aa865414f538729c7f7735d2bc6",22853626,1,-6,0,1670,15,12,-3
"56586aa865414f538729c7f7735d2bc6","9afd71a5298d4333b6849dfce1b9422c",22853626,2,13,0,1671,12,18,6
"9afd71a5298d4333b6849dfce1b9422c","9afd71a5298d4333b6849dfce1b9422c",22853626,2,0,1,1672,18,18,0
"9afd71a5298d4333b6849dfce1b9422c","b7719e26494940efa49512aedd0aac79",22853626,2,4,0,1673,18,20,2
"b7719e26494940efa49512aedd0aac79","d4f45188d3c84a02ba08454e6403a818",22853626,2,5,0,1674,20,24,4
"d4f45188d3c84a02ba08454e6403a818","d4c3b003e8274e429d2fa688d73fde6d",22853626,2,-2,0,1675,24,22,-2
"d4c3b003e8274e429d2fa688d73fde6d","b7719e26494940efa49512aedd0aac79",22853626,1,-3,0,1676,22,20,-2
"b7719e26494940efa49512aedd0aac79","b7719e26494940efa49512aedd0aac79",22853626,1,0,1,1677,20,20,0
"b7719e26494940efa49512aedd0aac79","afbf7250b99d47bea07172749483ca97",22853626,3,12,0,1678,20,28,8
"afbf7250b99d47bea07172749483ca97","afbf7250b99d47bea07172749483ca97",22853626,1,0,1,1679,28,28,0
"93679be414554a11b1893002f2229a93","c33c17be71ae4d588da7369472e5bb1b",22853626,1,-3,0,1686,35,34,-1
"c33c17be71ae4d588da7369472e5bb1b","7040a13096d746ac84b8fac8d9752058",22853626,1,6,0,1687,34,36,2
"93679be414554a11b1893002f2229a93","9a0dc646f934470daf08c4b56ccf73db",22853626,1,6,0,1689,35,37,2
"9a0dc646f934470daf08c4b56ccf73db","7040a13096d746ac84b8fac8d9752058",22853626,1,-3,0,1690,37,36,-1
"7040a13096d746ac84b8fac8d9752058","fc0e049d56024bc9a02c9a9c435c3df7",22853626,1,6,0,1691,36,38,2
"9a0dc646f934470daf08c4b56ccf73db","67a089198fcb4e1c8f2385786c2b296f",22853626,1,7,0,1693,37,39,2
"67a089198fcb4e1c8f2385786c2b296f","fc0e049d56024bc9a02c9a9c435c3df7",22853626,1,-4,0,1694,39,38,-1
"fc0e049d56024bc9a02c9a9c435c3df7","64d48c6c9c7940639a932219a6c87198",22853626,1,5,0,1695,38,40,2
"b534b89233134e30a9b5645138bfa9ee","b534b89233134e30a9b5645138bfa9ee",22853626,1,0,1,1698,41,41,0
"d0c74f735e024943943e40333d6d337f","f924752d8a1149668870b1e7698486f7",22853626,1,-1,0,1702,51,50,-1
"f924752d8a1149668870b1e7698486f7","a1f2f12debe5432fb7a70bcd12bacfb9",22853626,1,9,0,1703,50,58,8
"a1f2f12debe5432fb7a70bcd12bacfb9","78f30e4dcac84e3cbea8b2cc6e0d62b3",22853626,2,1,0,1704,58,59,1
"78f30e4dcac84e3cbea8b2cc6e0d62b3","bc42d26810654ea9a1df1efe1e58c7d5",22853626,1,5,0,1705,59,63,4
"bc42d26810654ea9a1df1efe1e58c7d5","a0a418b8540d479fa6e0f653b701da8b",22853626,3,1,0,1706,63,64,1
"a0a418b8540d479fa6e0f653b701da8b","12aa6e1672ac4e7aa6449a7a8609cd72",22853626,1,-8,0,1707,64,57,-7
"12aa6e1672ac4e7aa6449a7a8609cd72","a0a418b8540d479fa6e0f653b701da8b",22853626,1,8,0,1708,57,64,7
"a0a418b8540d479fa6e0f653b701da8b","a0a418b8540d479fa6e0f653b701da8b",22853626,4,0,1,1709,64,64,0
"a0a418b8540d479fa6e0f653b701da8b","bc42d26810654ea9a1df1efe1e58c7d5",22853626,2,-1,0,1710,64,63,-1
"bc42d26810654ea9a1df1efe1e58c7d5","bc42d26810654ea9a1df1efe1e58c7d5",22853626,4,0,1,1711,63,63,0
"bc42d26810654ea9a1df1efe1e58c7d5","309ccf3cc4fe429d9bfbaef53d3fa479",22853626,1,-3,0,1712,63,60,-3
"309ccf3cc4fe429d9bfbaef53d3fa479","b534b89233134e30a9b5645138bfa9ee",22853626,2,-23,0,1713,60,41,-19
"b534b89233134e30a9b5645138bfa9ee","d646286c8051419bbc2e31dd1db55ca8",22853626,2,33,0,1714,41,67,26
"d646286c8051419bbc2e31dd1db55ca8","a2becd407db34b189200a32546d9d569",22853626,3,9,0,1715,67,75,8
"a2becd407db34b189200a32546d9d569","d646286c8051419bbc2e31dd1db55ca8",22853626,2,-9,0,1716,75,67,-8
"d646286c8051419bbc2e31dd1db55ca8","140d5b27b8574befad82c0a013b59dfa",22853626,2,8,0,1717,67,74,7
"140d5b27b8574befad82c0a013b59dfa","d18a9ea32855445f8736581f5cb119ce",22853626,3,9,0,1718,74,82,8
"d18a9ea32855445f8736581f5cb119ce","ae5ac430ea254e708a6f5deaaf7464ae",22853626,2,3,0,1719,82,84,2
"ae5ac430ea254e708a6f5deaaf7464ae","6a9f0ef185fb47f0937e29daa1c71ed5",22853626,2,7,0,1720,84,90,6
"6a9f0ef185fb47f0937e29daa1c71ed5","6a9f0ef185fb47f0937e29daa1c71ed5",22853626,5,0,1,1721,90,90,0
"6a9f0ef185fb47f0937e29daa1c71ed5","d646286c8051419bbc2e31dd1db55ca8",22853626,1,-27,0,1723,90,67,-23
"d646286c8051419bbc2e31dd1db55ca8","e20db35ced8544ddac5bc3839145e463",22853626,1,30,0,1724,67,91,24
"e20db35ced8544ddac5bc3839145e463","00ae5f0c51874a73a41ebea838d95682",22853626,3,11,0,1725,91,101,10
"00ae5f0c51874a73a41ebea838d95682","e20db35ced8544ddac5bc3839145e463",22853626,1,-11,0,1726,101,91,-10
"e20db35ced8544ddac5bc3839145e463","d391c8b6e56a43a7b654e9dee02d904b",22853626,1,13,0,1727,91,103,12
"d391c8b6e56a43a7b654e9dee02d904b","4280927ec4d643238aa49c32f9e06c6c",22853626,1,7,0,1728,103,109,6
"4280927ec4d643238aa49c32f9e06c6c","73039f8c1eb9409cb4caee2cf968001e",22853626,2,-10,0,1729,109,100,-9
"73039f8c1eb9409cb4caee2cf968001e","08111f75e22d409998cf8b85bd431f0a",22853626,1,9,0,1730,100,108,8
"08111f75e22d409998cf8b85bd431f0a","a9ae0a3c070d455bb4369a8996313336",22853626,4,7,0,1731,108,114,6
"a9ae0a3c070d455bb4369a8996313336","62bff51286ef4f348717a3cf6fe2318f",22853626,2,7,0,1732,114,120,6
"62bff51286ef4f348717a3cf6fe2318f","62bff51286ef4f348717a3cf6fe2318f",22853626,17,0,1,1733,120,120,0
"62bff51286ef4f348717a3cf6fe2318f","37319e88176d4aefa91d7a9980dbae91",22853626,6,-9,0,1735,120,112,-8
"37319e88176d4aefa91d7a9980dbae91","e20db35ced8544ddac5bc3839145e463",22853626,3,-24,0,1736,112,91,-21
"e20db35ced8544ddac5bc3839145e463","779f9ddd1fd14d1e9e69f72219a1fdbd",22853626,2,36,0,1737,91,121,30
"779f9ddd1fd14d1e9e69f72219a1fdbd","a8dd5213034441ac92724b4e83eb0bb2",22853626,4,9,0,1738,121,129,8
"a8dd5213034441ac92724b4e83eb0bb2","779f9ddd1fd14d1e9e69f72219a1fdbd",22853626,3,-9,0,1739,129,121,-8
"779f9ddd1fd14d1e9e69f72219a1fdbd","579338175e0b4bbb8ef3b712b5d8b54e",22853626,2,8,0,1740,121,128,7
"579338175e0b4bbb8ef3b712b5d8b54e","b416d47c56a742199b5d7c7f19d6503a",22853626,1,7,0,1741,128,134,6
"b416d47c56a742199b5d7c7f19d6503a","779f9ddd1fd14d1e9e69f72219a1fdbd",22853626,1,-15,0,1742,134,121,-13
"779f9ddd1fd14d1e9e69f72219a1fdbd","df1de691dafe4549a18a4398ee9dfaf9",22853626,2,23,0,1743,121,139,18
"df1de691dafe4549a18a4398ee9dfaf9","6c5ad271a44743479bfaea29b1db8d02",22853626,2,4,0,1744,139,143,4
"6c5ad271a44743479bfaea29b1db8d02","df1de691dafe4549a18a4398ee9dfaf9",22853626,1,-4,0,1745,143,139,-4
"df1de691dafe4549a18a4398ee9dfaf9","8aae34f5ddbb4052a709b12e6b0d40fa",22853626,3,9,0,1746,139,147,8
"8aae34f5ddbb4052a709b12e6b0d40fa","f902b0f41b544d4dbf79664fd233648d",22853626,2,-1,0,1747,147,146,-1
"f902b0f41b544d4dbf79664fd233648d","f03480cf4eba413194d7af52fc0e7f28",22853626,1,7,0,1748,146,152,6
"f03480cf4eba413194d7af52fc0e7f28","8aae34f5ddbb4052a709b12e6b0d40fa",22853626,1,-6,0,1749,152,147,-5
"f902b0f41b544d4dbf79664fd233648d","d313cec988a84645bee413e8d4724a4b",22853626,1,14,0,1751,146,158,12
"d313cec988a84645bee413e8d4724a4b","f03480cf4eba413194d7af52fc0e7f28",22853626,1,-7,0,1752,158,152,-6
"d313cec988a84645bee413e8d4724a4b","df1de691dafe4549a18a4398ee9dfaf9",22853626,1,-22,0,1755,158,139,-19
"df1de691dafe4549a18a4398ee9dfaf9","78adeee1fa2c4fe0bc73f7bca9fcee86",22853626,1,26,0,1756,139,160,21
"78adeee1fa2c4fe0bc73f7bca9fcee86","3cbcea2be0984e7dbd5a48195af10ce7",22853626,2,8,0,1767,160,165,5
"3cbcea2be0984e7dbd5a48195af10ce7","82e6285962b8400d9d6fc32436022a94",22853626,2,2,0,1768,165,167,2
"82e6285962b8400d9d6fc32436022a94","a9ac840f098c4bd0a2ee896214ce29cd",22853626,1,3,0,1769,167,168,1
"a9ac840f098c4bd0a2ee896214ce29cd","3cbcea2be0984e7dbd5a48195af10ce7",22853626,1,-5,0,1770,168,165,-3
"82e6285962b8400d9d6fc32436022a94","78adeee1fa2c4fe0bc73f7bca9fcee86",22853626,1,-10,0,1787,167,160,-7
"3cbcea2be0984e7dbd5a48195af10ce7","65202579580f4ad38d734b4ee39d22a8",22853626,1,-3,0,1789,165,164,-1
"65202579580f4ad38d734b4ee39d22a8","b71bac264efb4abd97015447bd490db6",22853626,1,279,0,1797,164,370,206
"b71bac264efb4abd97015447bd490db6","b71bac264efb4abd97015447bd490db6",22853626,3,0,1,1798,370,370,0
"7f544639412e40a9ba27f43b415362ab","0c4079457ede49e3aeb5e86ed84bdf35",22853626,1,-66,0,1859,378,329,-49
"0c4079457ede49e3aeb5e86ed84bdf35","c2490bc612d146edbe786556fab3651b",22853626,1,13,0,1860,329,340,11
"c2490bc612d146edbe786556fab3651b","bbc5139ca9024389a94db3a6f47dcff6",22853626,1,1,0,1861,340,341,1
"b37947176785476f8b29d49a851366dc","fcea5b10d5a14a3b9324ffece8f6e1e5",22853626,1,1,0,1868,344,345,1
"09b9678ddc3d452ea4a3d46e15826065","897b7f51242c44aab2205c72fdcbf4cd",22853626,1,-1,0,1879,353,352,-1
"897b7f51242c44aab2205c72fdcbf4cd","c20993c944444fe085345591a8bd837e",22853626,1,-1,0,1881,352,351,-1
"c20993c944444fe085345591a8bd837e","09b9678ddc3d452ea4a3d46e15826065",22853626,1,2,0,1885,351,353,2
"eff0de7f2dbb42dfa1a2e686efab5b6d","c2490bc612d146edbe786556fab3651b",22853626,1,-17,0,1888,354,340,-14
"c2490bc612d146edbe786556fab3651b","0c4079457ede49e3aeb5e86ed84bdf35",22853626,1,-13,0,1889,340,329,-11
"0c4079457ede49e3aeb5e86ed84bdf35","bbc5139ca9024389a94db3a6f47dcff6",22853626,2,14,0,1890,329,341,12
"bbc5139ca9024389a94db3a6f47dcff6","c2490bc612d146edbe786556fab3651b",22853626,2,-1,0,1891,341,340,-1
"c2490bc612d146edbe786556fab3651b","4a92daef4d504e1792575a26502bb7b7",22853626,1,7,0,1892,340,346,6
"4a92daef4d504e1792575a26502bb7b7","bbc5139ca9024389a94db3a6f47dcff6",22853626,1,-6,0,1893,346,341,-5
"b37947176785476f8b29d49a851366dc","0c4079457ede49e3aeb5e86ed84bdf35",22853626,1,-17,0,1900,344,329,-15
"4ee6ca9019ab4a1ab323f98094a9bd77","c2490bc612d146edbe786556fab3651b",22853626,1,-3,0,1903,343,340,-3
"c2490bc612d146edbe786556fab3651b","b8b9418ab322418d9db9b40d96af873a",22853626,1,-4,0,1904,340,337,-3
"c2490bc612d146edbe786556fab3651b","78adeee1fa2c4fe0bc73f7bca9fcee86",22853626,1,-245,0,1908,340,160,-180
"82e6285962b8400d9d6fc32436022a94","4a29443515bb404cb8924e1c60a63b73",22853626,1,164,0,1922,167,285,118
"6a9a3b5bde4a48daa896fe8c06eca56f","208c9b2796c944db8dacaa96082520ea",22853626,1,-2,0,1928,289,288,-1
"4a29443515bb404cb8924e1c60a63b73","b71bac264efb4abd97015447bd490db6",22853626,1,110,0,1931,285,370,85
"d6d02b6ef04e4f17805504500b8ce441","b71bac264efb4abd97015447bd490db6",22853626,2,-8,0,1953,375,370,-5
"8d448d625b024c82a5eb240bbd7431d6","b2f0d654738f48158edff28e8d3a546e",22853626,1,119,0,1962,374,449,75
"b2f0d654738f48158edff28e8d3a546e","b2f0d654738f48158edff28e8d3a546e",22853626,2,0,1,1963,449,449,0
"b2f0d654738f48158edff28e8d3a546e","66baf19b6b904b70922329068c63746d",22853626,1,-112,0,1964,449,376,-73
"c2fca3669923477ab966ded303dea31c","96bb2b3e85a34d8b9544514e89f6fe97",22853626,1,9,0,1970,383,390,7
"96bb2b3e85a34d8b9544514e89f6fe97","96bb2b3e85a34d8b9544514e89f6fe97",22853626,2,0,1,1971,390,390,0
"96bb2b3e85a34d8b9544514e89f6fe97","ac4e9b54acfe4670b4634859c7263cb5",22853626,1,2,0,1973,390,392,2
"ac4e9b54acfe4670b4634859c7263cb5","ac4e9b54acfe4670b4634859c7263cb5",22853626,1,0,1,1974,392,392,0
"ac4e9b54acfe4670b4634859c7263cb5","17f95d18bab743888e1736033dc3384d",22853626,1,-3,0,1975,392,389,-3
"17f95d18bab743888e1736033dc3384d","6f8881a745ac4c358a68b92c3b4abe81",22853626,1,6,0,1976,389,394,5
"6f8881a745ac4c358a68b92c3b4abe81","6f8881a745ac4c358a68b92c3b4abe81",22853626,1,0,1,1977,394,394,0
"6f8881a745ac4c358a68b92c3b4abe81","f7002c8484354eceac57bc7bd62c76c1",22853626,1,-1,0,1978,394,393,-1
"f7002c8484354eceac57bc7bd62c76c1","44a277ea44dc4ae689fab4b82f0b4098",22853626,1,5,0,1979,393,397,4
"44a277ea44dc4ae689fab4b82f0b4098","44a277ea44dc4ae689fab4b82f0b4098",22853626,1,0,1,1980,397,397,0
"44a277ea44dc4ae689fab4b82f0b4098","0c12af0a4e7f4002852cf84b2537c161",22853626,1,-2,0,1981,397,395,-2
"0c12af0a4e7f4002852cf84b2537c161","859e0b8d71694b12befb69ee698138f9",22853626,1,5,0,1982,395,399,4
"859e0b8d71694b12befb69ee698138f9","859e0b8d71694b12befb69ee698138f9",22853626,1,0,1,1983,399,399,0
"859e0b8d71694b12befb69ee698138f9","66baf19b6b904b70922329068c63746d",22853626,1,-29,0,1984,399,376,-23
"66baf19b6b904b70922329068c63746d","2b09a08242b54983aec7063990fb3f66",22853626,1,32,0,1985,376,400,24
"2b09a08242b54983aec7063990fb3f66","2b09a08242b54983aec7063990fb3f66",22853626,6,0,1,1986,400,400,0
"2b09a08242b54983aec7063990fb3f66","1f471b7a883a4df48211e8c6a81b59a7",22853626,1,1,0,1987,400,401,1
"1f471b7a883a4df48211e8c6a81b59a7","1f471b7a883a4df48211e8c6a81b59a7",22853626,3,0,1,1988,401,401,0
"1f471b7a883a4df48211e8c6a81b59a7","2b09a08242b54983aec7063990fb3f66",22853626,1,-1,0,1991,401,400,-1
"2b09a08242b54983aec7063990fb3f66","9de0d567bfa84fe5b77cb76f4a76a5d1",22853626,1,5,0,1993,400,404,4
"9de0d567bfa84fe5b77cb76f4a76a5d1","9de0d567bfa84fe5b77cb76f4a76a5d1",22853626,1,0,1,1994,404,404,0
"9de0d567bfa84fe5b77cb76f4a76a5d1","1157bd665ec4472fb58b751dc5099355",22853626,1,-1,0,1995,404,403,-1
"1157bd665ec4472fb58b751dc5099355","3c8a22d2f9c146ea956609e3ed4f2559",22853626,1,3,0,1996,403,405,2
"3c8a22d2f9c146ea956609e3ed4f2559","2b09a08242b54983aec7063990fb3f66",22853626,2,-7,0,1997,405,400,-5
"2b09a08242b54983aec7063990fb3f66","d6d02b6ef04e4f17805504500b8ce441",22853626,1,-36,0,2002,400,375,-25
"d6d02b6ef04e4f17805504500b8ce441","3c8a22d2f9c146ea956609e3ed4f2559",22853626,1,43,0,2009,375,405,30
"2b09a08242b54983aec7063990fb3f66","3c8a22d2f9c146ea956609e3ed4f2559",22853626,1,7,0,2011,400,405,5
"3c8a22d2f9c146ea956609e3ed4f2559","58fc9094275e4c49be3f4ba6d4acc0a4",22853626,1,2,0,2012,405,406,1
"58fc9094275e4c49be3f4ba6d4acc0a4","58fc9094275e4c49be3f4ba6d4acc0a4",22853626,1,0,1,2013,406,406,0
"58fc9094275e4c49be3f4ba6d4acc0a4","c1c1be90b2b14c1ab4a5e1ee3c241902",22853626,1,1,0,2014,406,407,1
"c1c1be90b2b14c1ab4a5e1ee3c241902","c1c1be90b2b14c1ab4a5e1ee3c241902",22853626,5,0,1,2015,407,407,0
"c1c1be90b2b14c1ab4a5e1ee3c241902","58fc9094275e4c49be3f4ba6d4acc0a4",22853626,1,-1,0,2020,407,406,-1
"58fc9094275e4c49be3f4ba6d4acc0a4","02b3a1bead9244c1ba2f857c7da8f82a",22853626,1,3,0,2021,406,408,2
"02b3a1bead9244c1ba2f857c7da8f82a","02b3a1bead9244c1ba2f857c7da8f82a",22853626,1,0,1,2022,408,408,0
"02b3a1bead9244c1ba2f857c7da8f82a","6206fc6479014bb193084c32409dc1b9",22853626,1,1,0,2023,408,409,1
"6206fc6479014bb193084c32409dc1b9","6206fc6479014bb193084c32409dc1b9",22853626,4,0,1,2024,409,409,0
"6206fc6479014bb193084c32409dc1b9","6a5f020451db426dacba9e2ea3fcc62a",22853626,1,2,0,2028,409,410,1
"6a5f020451db426dacba9e2ea3fcc62a","02b3a1bead9244c1ba2f857c7da8f82a",22853626,1,-3,0,2029,410,408,-2
"02b3a1bead9244c1ba2f857c7da8f82a","6a5f020451db426dacba9e2ea3fcc62a",22853626,1,3,0,2030,408,410,2
"6a5f020451db426dacba9e2ea3fcc62a","33a9d248b2e44588a5b07fc1342b9bc2",22853626,1,2,0,2031,410,411,1
"33a9d248b2e44588a5b07fc1342b9bc2","6a5f020451db426dacba9e2ea3fcc62a",22853626,1,-2,0,2032,411,410,-1
"6a5f020451db426dacba9e2ea3fcc62a","c6f26bd420634f1cb7989e76fe6b16c0",22853626,1,3,0,2033,410,412,2
"c6f26bd420634f1cb7989e76fe6b16c0","c6f26bd420634f1cb7989e76fe6b16c0",22853626,5,0,1,2034,412,412,0
"c6f26bd420634f1cb7989e76fe6b16c0","33a9d248b2e44588a5b07fc1342b9bc2",22853626,1,-1,0,2039,412,411,-1
"33a9d248b2e44588a5b07fc1342b9bc2","33a9d248b2e44588a5b07fc1342b9bc2",22853626,1,0,1,2040,411,411,0
"33a9d248b2e44588a5b07fc1342b9bc2","2a65ee6e2ac64f6a8a55fbe5373ec763",22853626,1,2,0,2041,411,413,2
"2a65ee6e2ac64f6a8a55fbe5373ec763","2a65ee6e2ac64f6a8a55fbe5373ec763",22853626,2,0,1,2042,413,413,0
"2a65ee6e2ac64f6a8a55fbe5373ec763","33a9d248b2e44588a5b07fc1342b9bc2",22853626,1,-2,0,2044,413,411,-2
"33a9d248b2e44588a5b07fc1342b9bc2","687055dad9fc40c3982478fe33ec01bf",22853626,1,4,0,2045,411,414,3
"687055dad9fc40c3982478fe33ec01bf","a2b4bd40cee2481ebd3fc179d6a5cd62",22853626,1,6,0,2046,414,417,3
"a2b4bd40cee2481ebd3fc179d6a5cd62","a2b4bd40cee2481ebd3fc179d6a5cd62",22853626,1,0,1,2047,417,417,0
"a2b4bd40cee2481ebd3fc179d6a5cd62","bec48fc2e1294c7eb3d0aca780d731b8",22853626,2,4,0,2048,417,420,3
"bec48fc2e1294c7eb3d0aca780d731b8","a2b4bd40cee2481ebd3fc179d6a5cd62",22853626,1,-4,0,2049,420,417,-3
"bec48fc2e1294c7eb3d0aca780d731b8","bec48fc2e1294c7eb3d0aca780d731b8",22853626,3,0,1,2051,420,420,0
"bec48fc2e1294c7eb3d0aca780d731b8","dbde19fcce2a4c1abdc7f685c293a23f",22853626,2,3,0,2052,420,422,2
"dbde19fcce2a4c1abdc7f685c293a23f","bec48fc2e1294c7eb3d0aca780d731b8",22853626,1,-3,0,2053,422,420,-2
"dbde19fcce2a4c1abdc7f685c293a23f","a24600b0e49245f6bdba8c893cfeddb0",22853626,1,4,0,2056,422,425,3
"a24600b0e49245f6bdba8c893cfeddb0","a24600b0e49245f6bdba8c893cfeddb0",22853626,2,0,1,2057,425,425,0
"a24600b0e49245f6bdba8c893cfeddb0","a2b4bd40cee2481ebd3fc179d6a5cd62",22853626,1,-11,0,2059,425,417,-8
"a2b4bd40cee2481ebd3fc179d6a5cd62","24cf8786024543f19b89bc20034e60d7",22853626,2,18,0,2060,417,428,11
"24cf8786024543f19b89bc20034e60d7","f2a73be2f46840b182d7bd095378004e",22853626,3,1,0,2061,428,429,1
"f2a73be2f46840b182d7bd095378004e","f2a73be2f46840b182d7bd095378004e",22853626,2,0,1,2062,429,429,0
"f2a73be2f46840b182d7bd095378004e","604551fd4266430cb860fef58fa7dd61",22853626,1,1,0,2063,429,430,1
"604551fd4266430cb860fef58fa7dd61","604551fd4266430cb860fef58fa7dd61",22853626,4,0,1,2064,430,430,0
"604551fd4266430cb860fef58fa7dd61","dce46f8904594a62a6377a3587aaa663",22853626,1,2,0,2068,430,431,1
"dce46f8904594a62a6377a3587aaa663","24cf8786024543f19b89bc20034e60d7",22853626,3,-4,0,2069,431,428,-3
"24cf8786024543f19b89bc20034e60d7","24cf8786024543f19b89bc20034e60d7",22853626,1,0,1,2070,428,428,0
"f2a73be2f46840b182d7bd095378004e","24cf8786024543f19b89bc20034e60d7",22853626,3,-1,0,2072,429,428,-1
"24cf8786024543f19b89bc20034e60d7","a2b4bd40cee2481ebd3fc179d6a5cd62",22853626,3,-18,0,2073,428,417,-11
"a2b4bd40cee2481ebd3fc179d6a5cd62","f2a73be2f46840b182d7bd095378004e",22853626,2,19,0,2076,417,429,12
"24cf8786024543f19b89bc20034e60d7","dce46f8904594a62a6377a3587aaa663",22853626,2,4,0,2079,428,431,3
"dce46f8904594a62a6377a3587aaa663","dce46f8904594a62a6377a3587aaa663",22853626,1,0,1,2080,431,431,0
"dce46f8904594a62a6377a3587aaa663","9b9d0a249052413c869753b99682b0ac",22853626,1,1,0,2081,431,432,1
"9b9d0a249052413c869753b99682b0ac","9b9d0a249052413c869753b99682b0ac",22853626,3,0,1,2082,432,432,0
"9b9d0a249052413c869753b99682b0ac","061c175cc90f45fbad883025394e78dd",22853626,1,1,0,2085,432,433,1
"061c175cc90f45fbad883025394e78dd","061c175cc90f45fbad883025394e78dd",22853626,4,0,1,2086,433,433,0
"061c175cc90f45fbad883025394e78dd","dce46f8904594a62a6377a3587aaa663",22853626,1,-2,0,2090,433,431,-2
"dce46f8904594a62a6377a3587aaa663","66ada10dde9f43018588f1ced9d477fc",22853626,1,4,0,2091,431,434,3
"66ada10dde9f43018588f1ced9d477fc","070600601c4c439288445d2f0724807d",22853626,1,6,0,2092,434,437,3
"070600601c4c439288445d2f0724807d","24cf8786024543f19b89bc20034e60d7",22853626,1,-14,0,2093,437,428,-9
"24cf8786024543f19b89bc20034e60d7","1823b6de7d334a7aaabc4570719af4d9",22853626,1,16,0,2094,428,439,11
"1823b6de7d334a7aaabc4570719af4d9","d6d02b6ef04e4f17805504500b8ce441",22853626,1,-97,0,2095,439,375,-64
"d6d02b6ef04e4f17805504500b8ce441","2b09a08242b54983aec7063990fb3f66",22853626,1,36,0,2117,375,400,25
"2b09a08242b54983aec7063990fb3f66","687055dad9fc40c3982478fe33ec01bf",22853626,1,21,0,2118,400,414,14
"687055dad9fc40c3982478fe33ec01bf","1fd0f6dadbc14ebc965faf6122190b96",22853626,1,1,0,2119,414,415,1
"1fd0f6dadbc14ebc965faf6122190b96","1fd0f6dadbc14ebc965faf6122190b96",22853626,1,0,1,2120,415,415,0
"1fd0f6dadbc14ebc965faf6122190b96","687055dad9fc40c3982478fe33ec01bf",22853626,1,-1,0,2121,415,414,-1
"687055dad9fc40c3982478fe33ec01bf","2add1669f08d4101913db15f8c23b3b7",22853626,1,3,0,2122,414,416,2
"2add1669f08d4101913db15f8c23b3b7","2add1669f08d4101913db15f8c23b3b7",22853626,1,0,1,2123,416,416,0
"2add1669f08d4101913db15f8c23b3b7","2b09a08242b54983aec7063990fb3f66",22853626,1,-24,0,2124,416,400,-16
"2b09a08242b54983aec7063990fb3f66","a2b4bd40cee2481ebd3fc179d6a5cd62",22853626,1,27,0,2125,400,417,17
"a2b4bd40cee2481ebd3fc179d6a5cd62","e34e59dce2204f228f3a84b6725df60f",22853626,2,2,0,2126,417,419,2
"e34e59dce2204f228f3a84b6725df60f","e34e59dce2204f228f3a84b6725df60f",22853626,2,0,1,2127,419,419,0
"e34e59dce2204f228f3a84b6725df60f","a2b4bd40cee2481ebd3fc179d6a5cd62",22853626,1,-2,0,2129,419,417,-2
"e34e59dce2204f228f3a84b6725df60f","bec48fc2e1294c7eb3d0aca780d731b8",22853626,1,2,0,2131,419,420,1
"bec48fc2e1294c7eb3d0aca780d731b8","24cf8786024543f19b89bc20034e60d7",22853626,1,14,0,2133,420,428,8
"24cf8786024543f19b89bc20034e60d7","74a7f8712e5449c2bc0b43c6f90dafed",22853626,1,9,0,2137,428,435,7
"74a7f8712e5449c2bc0b43c6f90dafed","74a7f8712e5449c2bc0b43c6f90dafed",22853626,1,0,1,2138,435,435,0
"74a7f8712e5449c2bc0b43c6f90dafed","66ada10dde9f43018588f1ced9d477fc",22853626,1,-1,0,2139,435,434,-1
"66ada10dde9f43018588f1ced9d477fc","bf12c96466d840a69bed7020b3f18bb8",22853626,1,3,0,2140,434,436,2
"bf12c96466d840a69bed7020b3f18bb8","bf12c96466d840a69bed7020b3f18bb8",22853626,3,0,1,2141,436,436,0
"bf12c96466d840a69bed7020b3f18bb8","24cf8786024543f19b89bc20034e60d7",22853626,1,-11,0,2144,436,428,-8
"24cf8786024543f19b89bc20034e60d7","070600601c4c439288445d2f0724807d",22853626,2,14,0,2145,428,437,9
"070600601c4c439288445d2f0724807d","1823b6de7d334a7aaabc4570719af4d9",22853626,1,2,0,2146,437,439,2
"1823b6de7d334a7aaabc4570719af4d9","1823b6de7d334a7aaabc4570719af4d9",22853626,13,0,1,2147,439,439,0
"1823b6de7d334a7aaabc4570719af4d9","0380cd76a7d44bc3a4da1f15e4d68f89",22853626,1,2,0,2160,439,440,1
"0380cd76a7d44bc3a4da1f15e4d68f89","070600601c4c439288445d2f0724807d",22853626,1,-4,0,2161,440,437,-3
"070600601c4c439288445d2f0724807d","0380cd76a7d44bc3a4da1f15e4d68f89",22853626,1,4,0,2162,437,440,3
"0380cd76a7d44bc3a4da1f15e4d68f89","0380cd76a7d44bc3a4da1f15e4d68f89",22853626,1,0,1,2163,440,440,0
"0380cd76a7d44bc3a4da1f15e4d68f89","23b7673c8b5443108c2ef09382834a86",22853626,1,2,0,2164,440,441,1
"23b7673c8b5443108c2ef09382834a86","23b7673c8b5443108c2ef09382834a86",22853626,3,0,1,2165,441,441,0
"23b7673c8b5443108c2ef09382834a86","901e92500aea43c79f19f1b279050668",22853626,2,2,0,2167,441,442,1
"901e92500aea43c79f19f1b279050668","901e92500aea43c79f19f1b279050668",22853626,3,0,1,2168,442,442,0
"901e92500aea43c79f19f1b279050668","24cf8786024543f19b89bc20034e60d7",22853626,1,-22,0,2170,442,428,-14
"f2a73be2f46840b182d7bd095378004e","dce46f8904594a62a6377a3587aaa663",22853626,1,3,0,2172,429,431,2
"070600601c4c439288445d2f0724807d","66ada10dde9f43018588f1ced9d477fc",22853626,1,-6,0,2177,437,434,-3
"66ada10dde9f43018588f1ced9d477fc","1823b6de7d334a7aaabc4570719af4d9",22853626,1,8,0,2178,434,439,5
"1823b6de7d334a7aaabc4570719af4d9","070600601c4c439288445d2f0724807d",22853626,1,-2,0,2179,439,437,-2
"070600601c4c439288445d2f0724807d","23b7673c8b5443108c2ef09382834a86",22853626,1,6,0,2180,437,441,4
"901e92500aea43c79f19f1b279050668","001339db8ced4cf78829ebe8b145449d",22853626,1,1,0,2184,442,443,1
"001339db8ced4cf78829ebe8b145449d","001339db8ced4cf78829ebe8b145449d",22853626,5,0,1,2185,443,443,0
"001339db8ced4cf78829ebe8b145449d","452745e0366e42ae81561bfddebcc6c3",22853626,1,1,0,2190,443,444,1
"452745e0366e42ae81561bfddebcc6c3","452745e0366e42ae81561bfddebcc6c3",22853626,5,0,1,2191,444,444,0
"452745e0366e42ae81561bfddebcc6c3","901e92500aea43c79f19f1b279050668",22853626,1,-2,0,2196,444,442,-2
"901e92500aea43c79f19f1b279050668","4660ff2089114e8db82ceb26a4f329e3",22853626,1,4,0,2197,442,445,3
"4660ff2089114e8db82ceb26a4f329e3","4660ff2089114e8db82ceb26a4f329e3",22853626,2,0,1,2198,445,445,0
"4660ff2089114e8db82ceb26a4f329e3","7bd5586eb9d8484eb74a433ee7bfe499",22853626,1,2,0,2200,445,446,1
"7bd5586eb9d8484eb74a433ee7bfe499","7bd5586eb9d8484eb74a433ee7bfe499",22853626,13,0,1,2201,446,446,0
"7bd5586eb9d8484eb74a433ee7bfe499","8a7f26e690f34dda97be16904518ca99",22853626,1,2,0,2214,446,447,1
"8a7f26e690f34dda97be16904518ca99","8a7f26e690f34dda97be16904518ca99",22853626,1,0,1,2215,447,447,0
"8a7f26e690f34dda97be16904518ca99","b2f0d654738f48158edff28e8d3a546e",22853626,1,5,0,2216,447,449,2
"b2f0d654738f48158edff28e8d3a546e","070600601c4c439288445d2f0724807d",22853626,1,-21,0,2217,449,437,-12
"070600601c4c439288445d2f0724807d","f60ee41ec635499abd48168342d32c2f",22853626,1,26,0,2218,437,453,16
"f60ee41ec635499abd48168342d32c2f","f60ee41ec635499abd48168342d32c2f",22853626,80,0,1,2219,453,453,0
"f60ee41ec635499abd48168342d32c2f","b2f0d654738f48158edff28e8d3a546e",22853626,6,-5,0,2224,453,449,-4
"b2f0d654738f48158edff28e8d3a546e","f60ee41ec635499abd48168342d32c2f",22853626,5,5,0,2225,449,453,4
"f60ee41ec635499abd48168342d32c2f","f67fbf45a5f146ed866965bc57c7c001",22853626,1,3,0,2272,453,454,1
"f67fbf45a5f146ed866965bc57c7c001","b2f0d654738f48158edff28e8d3a546e",22853626,2,-8,0,2273,454,449,-5
"b2f0d654738f48158edff28e8d3a546e","f67fbf45a5f146ed866965bc57c7c001",22853626,6,8,0,2274,449,454,5
"f67fbf45a5f146ed866965bc57c7c001","f67fbf45a5f146ed866965bc57c7c001",22853626,2,0,1,2275,454,454,0
"f67fbf45a5f146ed866965bc57c7c001","d937afe49bd24a07a550dda1c1155122",22853626,1,1,0,2276,454,455,1
"d937afe49bd24a07a550dda1c1155122","d937afe49bd24a07a550dda1c1155122",22853626,1,0,1,2277,455,455,0
"d937afe49bd24a07a550dda1c1155122","3628b3f7823443d0912a339096b69943",22853626,1,1,0,2278,455,456,1
"3628b3f7823443d0912a339096b69943","3628b3f7823443d0912a339096b69943",22853626,3,0,1,2279,456,456,0
"3628b3f7823443d0912a339096b69943","9e049ee647cf43ecbcb5ed792a8e7588",22853626,1,1,0,2282,456,457,1
"9e049ee647cf43ecbcb5ed792a8e7588","9e049ee647cf43ecbcb5ed792a8e7588",22853626,1,0,1,2283,457,457,0
"9e049ee647cf43ecbcb5ed792a8e7588","5256a214faaf410b93f76cea06428334",22853626,1,1,0,2284,457,458,1
"5256a214faaf410b93f76cea06428334","5256a214faaf410b93f76cea06428334",22853626,1,0,1,2285,458,458,0
"5256a214faaf410b93f76cea06428334","25c32b120fce40fa9b6c85133aeb4716",22853626,1,1,0,2286,458,459,1
"25c32b120fce40fa9b6c85133aeb4716","25c32b120fce40fa9b6c85133aeb4716",22853626,3,0,1,2287,459,459,0
"25c32b120fce40fa9b6c85133aeb4716","11bc14f2204949008b7d511b933363c1",22853626,1,1,0,2290,459,460,1
"11bc14f2204949008b7d511b933363c1","11bc14f2204949008b7d511b933363c1",22853626,1,0,1,2291,460,460,0
"11bc14f2204949008b7d511b933363c1","42de338840a34d15adb66e7b14fb9d2c",22853626,1,1,0,2292,460,461,1
"42de338840a34d15adb66e7b14fb9d2c","42de338840a34d15adb66e7b14fb9d2c",22853626,3,0,1,2293,461,461,0
"42de338840a34d15adb66e7b14fb9d2c","9da37c6210b1416b8079c274f70bf600",22853626,1,1,0,2296,461,462,1
"9da37c6210b1416b8079c274f70bf600","9da37c6210b1416b8079c274f70bf600",22853626,1,0,1,2297,462,462,0
"9da37c6210b1416b8079c274f70bf600","519119f1deac45ff9ab4f13529be5c6e",22853626,1,1,0,2298,462,463,1
"519119f1deac45ff9ab4f13529be5c6e","519119f1deac45ff9ab4f13529be5c6e",22853626,1,0,1,2299,463,463,0
"519119f1deac45ff9ab4f13529be5c6e","c5df9f40ec14463b9dcfdc73df3e9285",22853626,1,3,0,2300,463,464,1
"c5df9f40ec14463b9dcfdc73df3e9285","f67fbf45a5f146ed866965bc57c7c001",22853626,3,-12,0,2301,464,454,-10
"f67fbf45a5f146ed866965bc57c7c001","c5df9f40ec14463b9dcfdc73df3e9285",22853626,5,12,0,2302,454,464,10
"c5df9f40ec14463b9dcfdc73df3e9285","83d42d95cd844fc093fc09cee250edb8",22853626,3,3,0,2303,464,465,1
"83d42d95cd844fc093fc09cee250edb8","c5df9f40ec14463b9dcfdc73df3e9285",22853626,2,-3,0,2304,465,464,-1
"83d42d95cd844fc093fc09cee250edb8","83d42d95cd844fc093fc09cee250edb8",22853626,3,0,1,2306,465,465,0
"83d42d95cd844fc093fc09cee250edb8","b2f0d654738f48158edff28e8d3a546e",22853626,1,-23,0,2308,465,449,-16
"c5df9f40ec14463b9dcfdc73df3e9285","c5df9f40ec14463b9dcfdc73df3e9285",22853626,5,0,1,2324,464,464,0
"c5df9f40ec14463b9dcfdc73df3e9285","d6d02b6ef04e4f17805504500b8ce441",22853626,1,-136,0,2330,464,375,-89
"d6d02b6ef04e4f17805504500b8ce441","78adeee1fa2c4fe0bc73f7bca9fcee86",22853626,1,-292,0,2337,375,160,-215
"78adeee1fa2c4fe0bc73f7bca9fcee86","0d987bed3ffa4ed0b9a2e62e97b7b30f",22853626,1,152,0,2339,160,272,112
"bb5a47f5ea01454a8b79455422d3b9da","94cecc3f1e7d484b8e068e79241dfd73",22853626,2,3,0,2403,280,281,1
"94cecc3f1e7d484b8e068e79241dfd73","0d987bed3ffa4ed0b9a2e62e97b7b30f",22853626,2,-13,0,2404,281,272,-9
"0d987bed3ffa4ed0b9a2e62e97b7b30f","a37477c4e4c14169ad44b06b493007f6",22853626,2,15,0,2405,272,283,11
"a37477c4e4c14169ad44b06b493007f6","94cecc3f1e7d484b8e068e79241dfd73",22853626,1,-2,0,2406,283,281,-2
"fab84b4fab5940efb4ea868ef8d09396","94cecc3f1e7d484b8e068e79241dfd73",22853626,1,-5,0,2408,284,281,-3
"a37477c4e4c14169ad44b06b493007f6","d6d02b6ef04e4f17805504500b8ce441",22853626,2,125,0,2410,283,375,92
"d6d02b6ef04e4f17805504500b8ce441","9428d8bd9c5a47b2a235b254e5e27ded",22853626,1,120,0,2413,375,452,77
"9428d8bd9c5a47b2a235b254e5e27ded","b2f0d654738f48158edff28e8d3a546e",22853626,2,-4,0,2414,452,449,-3
"f67fbf45a5f146ed866965bc57c7c001","bc5524e78a8544e2ae2fdc2f3462bbec",22853626,1,-255,0,2427,454,279,-175
"bc5524e78a8544e2ae2fdc2f3462bbec","0d987bed3ffa4ed0b9a2e62e97b7b30f",22853626,2,-9,0,2428,279,272,-7
"bb5a47f5ea01454a8b79455422d3b9da","f67fbf45a5f146ed866965bc57c7c001",22853626,1,254,0,2437,280,454,174
"f67fbf45a5f146ed866965bc57c7c001","f60ee41ec635499abd48168342d32c2f",22853626,1,-3,0,2441,454,453,-1
"c5df9f40ec14463b9dcfdc73df3e9285","0d987bed3ffa4ed0b9a2e62e97b7b30f",22853626,1,-276,0,2454,464,272,-192
"d6d02b6ef04e4f17805504500b8ce441","c5df9f40ec14463b9dcfdc73df3e9285",22853626,1,136,0,2474,375,464,89
"c5df9f40ec14463b9dcfdc73df3e9285","8959e6304a0348309a771e4d08d1b64a",22853626,1,-424,0,2477,464,163,-301
"8959e6304a0348309a771e4d08d1b64a","78adeee1fa2c4fe0bc73f7bca9fcee86",22853626,2,-4,0,2478,163,160,-3
"65202579580f4ad38d734b4ee39d22a8","bc5524e78a8544e2ae2fdc2f3462bbec",22853626,1,156,0,2487,164,279,115
"bb5a47f5ea01454a8b79455422d3b9da","1b4550d0dab04078b3bf08a655345bdc",22853626,1,126,0,2497,280,373,93
"1b4550d0dab04078b3bf08a655345bdc","b71bac264efb4abd97015447bd490db6",22853626,1,-4,0,2498,373,370,-3
"8d448d625b024c82a5eb240bbd7431d6","9428d8bd9c5a47b2a235b254e5e27ded",22853626,1,123,0,2507,374,452,78
"b613861cecf84ffcab01afb23f660475","b613861cecf84ffcab01afb23f660475",22853789,7,0,1,1,1,1,0
"e2911e79efc2420eac45d9f671463d4b","e2911e79efc2420eac45d9f671463d4b",22853789,3,0,1,10,2,2,0
"e2911e79efc2420eac45d9f671463d4b","519d1b8c59404d67b54e96c5c8a830b2",22853789,1,1,0,11,2,3,1
"519d1b8c59404d67b54e96c5c8a830b2","519d1b8c59404d67b54e96c5c8a830b2",22853789,1,0,1,12,3,3,0
"519d1b8c59404d67b54e96c5c8a830b2","531db53f81f646edb0cdcfe0085b03b7",22853789,1,1,0,13,3,4,1
"531db53f81f646edb0cdcfe0085b03b7","531db53f81f646edb0cdcfe0085b03b7",22853789,1,0,1,14,4,4,0
"531db53f81f646edb0cdcfe0085b03b7","4f5f94b2f95141e0a9d53a61da2276da",22853789,1,1,0,15,4,5,1
"4f5f94b2f95141e0a9d53a61da2276da","4f5f94b2f95141e0a9d53a61da2276da",22853789,1,0,1,16,5,5,0
"4f5f94b2f95141e0a9d53a61da2276da","6d541c89590949f99af293c4f2333f67",22853789,1,1,0,17,5,6,1
"6d541c89590949f99af293c4f2333f67","6d541c89590949f99af293c4f2333f67",22853789,1,0,1,18,6,6,0
"6d541c89590949f99af293c4f2333f67","dd5cf0b9fe4c4f1d8f5ff8e4c04879cb",22853789,1,1,0,19,6,7,1
"dd5cf0b9fe4c4f1d8f5ff8e4c04879cb","dd5cf0b9fe4c4f1d8f5ff8e4c04879cb",22853789,1,0,1,20,7,7,0
"dd5cf0b9fe4c4f1d8f5ff8e4c04879cb","f96261861edc426abe2248be4f0a709a",22853789,1,1,0,21,7,8,1
"f96261861edc426abe2248be4f0a709a","f96261861edc426abe2248be4f0a709a",22853789,1,0,1,22,8,8,0
"f96261861edc426abe2248be4f0a709a","66b5e16f4f75454fb5b8172079f0fa83",22853789,1,1,0,23,8,9,1
"66b5e16f4f75454fb5b8172079f0fa83","66b5e16f4f75454fb5b8172079f0fa83",22853789,1,0,1,24,9,9,0
"66b5e16f4f75454fb5b8172079f0fa83","0680571d4698477995e41842c36a54b2",22853789,1,1,0,25,9,10,1
"0680571d4698477995e41842c36a54b2","0680571d4698477995e41842c36a54b2",22853789,1,0,1,26,10,10,0
"0680571d4698477995e41842c36a54b2","9112f2bffece48e08c6d2287be204085",22853789,1,1,0,27,10,11,1
"9112f2bffece48e08c6d2287be204085","9112f2bffece48e08c6d2287be204085",22853789,1,0,1,28,11,11,0
"9112f2bffece48e08c6d2287be204085","e2911e79efc2420eac45d9f671463d4b",22853789,1,-9,0,29,11,2,-9
"56586aa865414f538729c7f7735d2bc6","b613861cecf84ffcab01afb23f660475",22853789,1,-15,0,32,12,1,-11
"56586aa865414f538729c7f7735d2bc6","67a089198fcb4e1c8f2385786c2b296f",22853789,1,57,0,40,12,39,27
"64d48c6c9c7940639a932219a6c87198","b7f2b31585d94eb3bf86376714aa7070",22853789,1,-56,0,42,40,13,-27
"b7f2b31585d94eb3bf86376714aa7070","67a089198fcb4e1c8f2385786c2b296f",22853789,1,55,0,46,13,39,26
"67a089198fcb4e1c8f2385786c2b296f","56586aa865414f538729c7f7735d2bc6",22853789,1,-57,0,47,39,12,-27
"3f1c815879794b929260d224becaff7e","81c864a886d54a6b8ff85f7d736f4f95",22853789,1,2,0,50,14,15,1
"81c864a886d54a6b8ff85f7d736f4f95","56586aa865414f538729c7f7735d2bc6",22853789,1,-6,0,51,15,12,-3
"9afd71a5298d4333b6849dfce1b9422c","9afd71a5298d4333b6849dfce1b9422c",22853789,1,0,1,56,18,18,0
"d4f45188d3c84a02ba08454e6403a818","b7719e26494940efa49512aedd0aac79",22853789,1,-5,0,59,24,20,-4
"4e51676dc72045d99c19b9fa7b22f8bc","afbf7250b99d47bea07172749483ca97",22853789,1,-3,0,64,29,28,-1
"51970cfa30e643e894e66ae85c8024cc","4e51676dc72045d99c19b9fa7b22f8bc",22853789,1,-3,0,67,31,29,-2
"93679be414554a11b1893002f2229a93","c33c17be71ae4d588da7369472e5bb1b",22853789,1,-3,0,70,35,34,-1
"64d48c6c9c7940639a932219a6c87198","a49d1bb4328949299686242fd0be5584",22853789,1,-39,0,80,40,21,-19
"d4c3b003e8274e429d2fa688d73fde6d","fc0e049d56024bc9a02c9a9c435c3df7",22853789,1,33,0,85,22,38,16
"fc0e049d56024bc9a02c9a9c435c3df7","b613861cecf84ffcab01afb23f660475",22853789,1,-68,0,86,38,1,-37
"b7719e26494940efa49512aedd0aac79","d4c3b003e8274e429d2fa688d73fde6d",22853789,1,3,0,93,20,22,2
"d4f45188d3c84a02ba08454e6403a818","a49d1bb4328949299686242fd0be5584",22853789,1,-3,0,95,24,21,-3
"a49d1bb4328949299686242fd0be5584","b7f2b31585d94eb3bf86376714aa7070",22853789,1,-17,0,96,21,13,-8
"b7f2b31585d94eb3bf86376714aa7070","b7f2b31585d94eb3bf86376714aa7070",22853789,4,0,1,100,13,13,0
"b7f2b31585d94eb3bf86376714aa7070","5c5ceeee4562457ba6d41515aeebfbb1",22853789,1,8,0,101,13,17,4
"5c5ceeee4562457ba6d41515aeebfbb1","3f1c815879794b929260d224becaff7e",22853789,1,-6,0,102,17,14,-3
"3f1c815879794b929260d224becaff7e","5c5ceeee4562457ba6d41515aeebfbb1",22853789,2,6,0,103,14,17,3
"5c5ceeee4562457ba6d41515aeebfbb1","56586aa865414f538729c7f7735d2bc6",22853789,1,-10,0,104,17,12,-5
"56586aa865414f538729c7f7735d2bc6","9afd71a5298d4333b6849dfce1b9422c",22853789,4,13,0,105,12,18,6
"9afd71a5298d4333b6849dfce1b9422c","b613861cecf84ffcab01afb23f660475",22853789,1,-28,0,106,18,1,-17
"b613861cecf84ffcab01afb23f660475","a49d1bb4328949299686242fd0be5584",22853789,2,34,0,107,1,21,20
"a49d1bb4328949299686242fd0be5584","b7719e26494940efa49512aedd0aac79",22853789,5,-2,0,108,21,20,-1
"b7719e26494940efa49512aedd0aac79","a49d1bb4328949299686242fd0be5584",22853789,7,2,0,109,20,21,1
"a49d1bb4328949299686242fd0be5584","d4f45188d3c84a02ba08454e6403a818",22853789,6,3,0,110,21,24,3
"d4f45188d3c84a02ba08454e6403a818","d4c3b003e8274e429d2fa688d73fde6d",22853789,9,-2,0,111,24,22,-2
"d4c3b003e8274e429d2fa688d73fde6d","d4c3b003e8274e429d2fa688d73fde6d",22853789,1,0,1,112,22,22,0
"d4c3b003e8274e429d2fa688d73fde6d","b7719e26494940efa49512aedd0aac79",22853789,5,-3,0,113,22,20,-2
"b7719e26494940efa49512aedd0aac79","b613861cecf84ffcab01afb23f660475",22853789,1,-32,0,114,20,1,-19
"b613861cecf84ffcab01afb23f660475","67a089198fcb4e1c8f2385786c2b296f",22853789,1,72,0,115,1,39,38
"67a089198fcb4e1c8f2385786c2b296f","64d48c6c9c7940639a932219a6c87198",22853789,7,1,0,116,39,40,1
"64d48c6c9c7940639a932219a6c87198","64d48c6c9c7940639a932219a6c87198",22853789,1,0,1,117,40,40,0
"b534b89233134e30a9b5645138bfa9ee","0e37b720d23b4e7f8b313e79313fd107",22853789,1,3,0,120,41,44,3
"0e37b720d23b4e7f8b313e79313fd107","0e37b720d23b4e7f8b313e79313fd107",22853789,1,0,1,121,44,44,0
"0e37b720d23b4e7f8b313e79313fd107","6875d67fdd5f48168b62719df449bebd",22853789,1,1,0,122,44,45,1
"6875d67fdd5f48168b62719df449bebd","6875d67fdd5f48168b62719df449bebd",22853789,1,0,1,123,45,45,0
"6875d67fdd5f48168b62719df449bebd","b534b89233134e30a9b5645138bfa9ee",22853789,1,-4,0,124,45,41,-4
"b534b89233134e30a9b5645138bfa9ee","6e13d61a7bdb44bca949c9f86fab3be5",22853789,3,7,0,125,41,47,6
"6e13d61a7bdb44bca949c9f86fab3be5","a49d1bb4328949299686242fd0be5584",22853789,1,-49,0,126,47,21,-26
"a49d1bb4328949299686242fd0be5584","d4c3b003e8274e429d2fa688d73fde6d",22853789,1,1,0,129,21,22,1
"d4c3b003e8274e429d2fa688d73fde6d","d4f45188d3c84a02ba08454e6403a818",22853789,2,2,0,130,22,24,2
"d4f45188d3c84a02ba08454e6403a818","67a089198fcb4e1c8f2385786c2b296f",22853789,1,35,0,131,24,39,15
"67a089198fcb4e1c8f2385786c2b296f","67a089198fcb4e1c8f2385786c2b296f",22853789,3,0,1,132,39,39,0
"64d48c6c9c7940639a932219a6c87198","b534b89233134e30a9b5645138bfa9ee",22853789,1,3,0,134,40,41,1
"67a089198fcb4e1c8f2385786c2b296f","b7719e26494940efa49512aedd0aac79",22853789,1,-40,0,136,39,20,-19
"d4c3b003e8274e429d2fa688d73fde6d","6e13d61a7bdb44bca949c9f86fab3be5",22853789,1,48,0,140,22,47,25
"6e13d61a7bdb44bca949c9f86fab3be5","b534b89233134e30a9b5645138bfa9ee",22853789,1,-7,0,141,47,41,-6
"6e13d61a7bdb44bca949c9f86fab3be5","6e13d61a7bdb44bca949c9f86fab3be5",22853789,1,0,1,143,47,47,0
"6e13d61a7bdb44bca949c9f86fab3be5","195f78799f984cc2b06c48dfe36be751",22853789,1,2,0,144,47,49,2
"195f78799f984cc2b06c48dfe36be751","195f78799f984cc2b06c48dfe36be751",22853789,2,0,1,145,49,49,0
"195f78799f984cc2b06c48dfe36be751","d9c8d8c444a64dadbbb508652c721e17",22853789,1,-3,0,147,49,46,-3
"d9c8d8c444a64dadbbb508652c721e17","d0c74f735e024943943e40333d6d337f",22853789,1,6,0,148,46,51,5
"d0c74f735e024943943e40333d6d337f","d0c74f735e024943943e40333d6d337f",22853789,1,0,1,149,51,51,0
"d0c74f735e024943943e40333d6d337f","983f8ff320594b279a7f4a6fe132f9c5",22853789,1,2,0,150,51,53,2
"983f8ff320594b279a7f4a6fe132f9c5","983f8ff320594b279a7f4a6fe132f9c5",22853789,5,0,1,151,53,53,0
"983f8ff320594b279a7f4a6fe132f9c5","35adfa5d923046aebabfefd98f35ff05",22853789,1,1,0,156,53,54,1
"35adfa5d923046aebabfefd98f35ff05","35adfa5d923046aebabfefd98f35ff05",22853789,5,0,1,157,54,54,0
"35adfa5d923046aebabfefd98f35ff05","b6f8a98476224da1b40e555ececc7ed8",22853789,1,1,0,162,54,55,1
"b6f8a98476224da1b40e555ececc7ed8","b6f8a98476224da1b40e555ececc7ed8",22853789,2,0,1,163,55,55,0
"b6f8a98476224da1b40e555ececc7ed8","86e22cb5fe0e4b47a9489ecddf7ed78f",22853789,1,1,0,165,55,56,1
"86e22cb5fe0e4b47a9489ecddf7ed78f","86e22cb5fe0e4b47a9489ecddf7ed78f",22853789,5,0,1,166,56,56,0
"86e22cb5fe0e4b47a9489ecddf7ed78f","f924752d8a1149668870b1e7698486f7",22853789,2,-6,0,168,56,50,-6
"f924752d8a1149668870b1e7698486f7","78f30e4dcac84e3cbea8b2cc6e0d62b3",22853789,1,10,0,169,50,59,9
"78f30e4dcac84e3cbea8b2cc6e0d62b3","a1f2f12debe5432fb7a70bcd12bacfb9",22853789,2,-1,0,170,59,58,-1
"a1f2f12debe5432fb7a70bcd12bacfb9","d0c74f735e024943943e40333d6d337f",22853789,1,-8,0,171,58,51,-7
"d0c74f735e024943943e40333d6d337f","12aa6e1672ac4e7aa6449a7a8609cd72",22853789,1,7,0,172,51,57,6
"12aa6e1672ac4e7aa6449a7a8609cd72","f924752d8a1149668870b1e7698486f7",22853789,1,-8,0,173,57,50,-7
"f924752d8a1149668870b1e7698486f7","a1f2f12debe5432fb7a70bcd12bacfb9",22853789,1,9,0,174,50,58,8
"a1f2f12debe5432fb7a70bcd12bacfb9","78f30e4dcac84e3cbea8b2cc6e0d62b3",22853789,2,1,0,175,58,59,1
"a1f2f12debe5432fb7a70bcd12bacfb9","a1f2f12debe5432fb7a70bcd12bacfb9",22853789,15,0,1,177,58,58,0
"78f30e4dcac84e3cbea8b2cc6e0d62b3","78f30e4dcac84e3cbea8b2cc6e0d62b3",22853789,7,0,1,193,59,59,0
"78f30e4dcac84e3cbea8b2cc6e0d62b3","12aa6e1672ac4e7aa6449a7a8609cd72",22853789,1,-2,0,200,59,57,-2
"12aa6e1672ac4e7aa6449a7a8609cd72","a0a418b8540d479fa6e0f653b701da8b",22853789,1,8,0,201,57,64,7
"a0a418b8540d479fa6e0f653b701da8b","bc42d26810654ea9a1df1efe1e58c7d5",22853789,2,-1,0,202,64,63,-1
"bc42d26810654ea9a1df1efe1e58c7d5","bc42d26810654ea9a1df1efe1e58c7d5",22853789,7,0,1,203,63,63,0
"bc42d26810654ea9a1df1efe1e58c7d5","d0c74f735e024943943e40333d6d337f",22853789,1,-14,0,207,63,51,-12
"d0c74f735e024943943e40333d6d337f","309ccf3cc4fe429d9bfbaef53d3fa479",22853789,1,11,0,208,51,60,9
"309ccf3cc4fe429d9bfbaef53d3fa479","86e22cb5fe0e4b47a9489ecddf7ed78f",22853789,1,-6,0,209,60,56,-4
"f924752d8a1149668870b1e7698486f7","bc42d26810654ea9a1df1efe1e58c7d5",22853789,1,15,0,214,50,63,13
"bc42d26810654ea9a1df1efe1e58c7d5","a0a418b8540d479fa6e0f653b701da8b",22853789,2,1,0,216,63,64,1
"bc42d26810654ea9a1df1efe1e58c7d5","3cbcea2be0984e7dbd5a48195af10ce7",22853789,1,130,0,218,63,165,102
"3cbcea2be0984e7dbd5a48195af10ce7","3cbcea2be0984e7dbd5a48195af10ce7",22853789,1,0,1,219,165,165,0
"82e6285962b8400d9d6fc32436022a94","67a089198fcb4e1c8f2385786c2b296f",22853789,2,-162,0,221,167,39,-128
"67a089198fcb4e1c8f2385786c2b296f","3cbcea2be0984e7dbd5a48195af10ce7",22853789,1,160,0,222,39,165,126
"b534b89233134e30a9b5645138bfa9ee","309ccf3cc4fe429d9bfbaef53d3fa479",22853789,1,23,0,226,41,60,19
"309ccf3cc4fe429d9bfbaef53d3fa479","bc42d26810654ea9a1df1efe1e58c7d5",22853789,1,3,0,227,60,63,3
"a0a418b8540d479fa6e0f653b701da8b","4c943503763e4e349906eea3ed3c8e86",22853789,1,-3,0,231,64,61,-3
"4c943503763e4e349906eea3ed3c8e86","4c943503763e4e349906eea3ed3c8e86",22853789,1,0,1,232,61,61,0
"4c943503763e4e349906eea3ed3c8e86","a0a418b8540d479fa6e0f653b701da8b",22853789,1,3,0,233,61,64,3
"a0a418b8540d479fa6e0f653b701da8b","a0a418b8540d479fa6e0f653b701da8b",22853789,3,0,1,234,64,64,0
"a0a418b8540d479fa6e0f653b701da8b","309ccf3cc4fe429d9bfbaef53d3fa479",22853789,1,-4,0,237,64,60,-4
"309ccf3cc4fe429d9bfbaef53d3fa479","d646286c8051419bbc2e31dd1db55ca8",22853789,1,10,0,238,60,67,7
"d646286c8051419bbc2e31dd1db55ca8","b534b89233134e30a9b5645138bfa9ee",22853789,1,-33,0,239,67,41,-26
"b534b89233134e30a9b5645138bfa9ee","267f883678b24aed855fde42524975d9",22853789,1,37,0,240,41,71,30
"267f883678b24aed855fde42524975d9","267f883678b24aed855fde42524975d9",22853789,1,0,1,241,71,71,0
"267f883678b24aed855fde42524975d9","88fff56d0342490dbef9040750a20f6c",22853789,1,1,0,242,71,72,1
"88fff56d0342490dbef9040750a20f6c","88fff56d0342490dbef9040750a20f6c",22853789,1,0,1,243,72,72,0
"88fff56d0342490dbef9040750a20f6c","adb17b12b66c4a49a85fd34322f7df70",22853789,1,1,0,244,72,73,1
"adb17b12b66c4a49a85fd34322f7df70","adb17b12b66c4a49a85fd34322f7df70",22853789,1,0,1,245,73,73,0
"adb17b12b66c4a49a85fd34322f7df70","d646286c8051419bbc2e31dd1db55ca8",22853789,1,-6,0,246,73,67,-6
"d646286c8051419bbc2e31dd1db55ca8","a2becd407db34b189200a32546d9d569",22853789,1,9,0,247,67,75,8
"a2becd407db34b189200a32546d9d569","a2becd407db34b189200a32546d9d569",22853789,2,0,1,248,75,75,0
"a2becd407db34b189200a32546d9d569","58c22b011d0f4c2ea6d13615edbb9eeb",22853789,1,2,0,250,75,77,2
"58c22b011d0f4c2ea6d13615edbb9eeb","58c22b011d0f4c2ea6d13615edbb9eeb",22853789,2,0,1,251,77,77,0
"58c22b011d0f4c2ea6d13615edbb9eeb","dd76e1861dc9461c830888729d091ee0",22853789,1,1,0,253,77,78,1
"dd76e1861dc9461c830888729d091ee0","dd76e1861dc9461c830888729d091ee0",22853789,8,0,1,254,78,78,0
"dd76e1861dc9461c830888729d091ee0","cd1d828f1a694b87913a7ea66c23803e",22853789,1,1,0,262,78,79,1
"cd1d828f1a694b87913a7ea66c23803e","cd1d828f1a694b87913a7ea66c23803e",22853789,2,0,1,263,79,79,0
"cd1d828f1a694b87913a7ea66c23803e","9176a3c2b4d2465fa8b0c67096c2a97e",22853789,1,1,0,265,79,80,1
"9176a3c2b4d2465fa8b0c67096c2a97e","9176a3c2b4d2465fa8b0c67096c2a97e",22853789,5,0,1,266,80,80,0
"9176a3c2b4d2465fa8b0c67096c2a97e","f8ec6445f7194e25b9101d4fbcb07a18",22853789,1,1,0,271,80,81,1
"f8ec6445f7194e25b9101d4fbcb07a18","f8ec6445f7194e25b9101d4fbcb07a18",22853789,2,0,1,272,81,81,0
"f8ec6445f7194e25b9101d4fbcb07a18","140d5b27b8574befad82c0a013b59dfa",22853789,1,-7,0,274,81,74,-7
"140d5b27b8574befad82c0a013b59dfa","d18a9ea32855445f8736581f5cb119ce",22853789,1,9,0,275,74,82,8
"d18a9ea32855445f8736581f5cb119ce","ae5ac430ea254e708a6f5deaaf7464ae",22853789,2,3,0,276,82,84,2
"ae5ac430ea254e708a6f5deaaf7464ae","d18a9ea32855445f8736581f5cb119ce",22853789,1,-3,0,277,84,82,-2
"d18a9ea32855445f8736581f5cb119ce","f564483cbd7a407681aa2fcca518cf5f",22853789,1,4,0,278,82,85,3
"f564483cbd7a407681aa2fcca518cf5f","f564483cbd7a407681aa2fcca518cf5f",22853789,4,0,1,279,85,85,0
"f564483cbd7a407681aa2fcca518cf5f","18fd01350bd5434ca636d59a599d768a",22853789,1,1,0,283,85,86,1
"18fd01350bd5434ca636d59a599d768a","18fd01350bd5434ca636d59a599d768a",22853789,9,0,1,284,86,86,0
"18fd01350bd5434ca636d59a599d768a","ae5ac430ea254e708a6f5deaaf7464ae",22853789,1,-2,0,293,86,84,-2
"ae5ac430ea254e708a6f5deaaf7464ae","6a9f0ef185fb47f0937e29daa1c71ed5",22853789,1,7,0,294,84,90,6
"6a9f0ef185fb47f0937e29daa1c71ed5","c681290961c94c4caf23b529d1ae6b9a",22853789,1,-2,0,295,90,88,-2
"c681290961c94c4caf23b529d1ae6b9a","c681290961c94c4caf23b529d1ae6b9a",22853789,1,0,1,296,88,88,0
"c681290961c94c4caf23b529d1ae6b9a","6a9f0ef185fb47f0937e29daa1c71ed5",22853789,1,2,0,297,88,90,2
"6a9f0ef185fb47f0937e29daa1c71ed5","6a9f0ef185fb47f0937e29daa1c71ed5",22853789,3,0,1,298,90,90,0
"6a9f0ef185fb47f0937e29daa1c71ed5","e20db35ced8544ddac5bc3839145e463",22853789,1,3,0,301,90,91,1
"e20db35ced8544ddac5bc3839145e463","d646286c8051419bbc2e31dd1db55ca8",22853789,1,-30,0,302,91,67,-24
"d646286c8051419bbc2e31dd1db55ca8","1febb706d7a34005ae8711ed49c76e64",22853789,1,33,0,303,67,94,27
"1febb706d7a34005ae8711ed49c76e64","1febb706d7a34005ae8711ed49c76e64",22853789,6,0,1,304,94,94,0
"1febb706d7a34005ae8711ed49c76e64","8f73ba6f5a0042f2850356ac38ac6f24",22853789,1,1,0,310,94,95,1
"8f73ba6f5a0042f2850356ac38ac6f24","8f73ba6f5a0042f2850356ac38ac6f24",22853789,5,0,1,311,95,95,0
"8f73ba6f5a0042f2850356ac38ac6f24","e2260b86653c46d7b14a41fb419dbf8c",22853789,1,1,0,316,95,96,1
"e2260b86653c46d7b14a41fb419dbf8c","e2260b86653c46d7b14a41fb419dbf8c",22853789,2,0,1,317,96,96,0
"e2260b86653c46d7b14a41fb419dbf8c","35eb641ad1d845bbba54915bce75a962",22853789,1,1,0,319,96,97,1
"35eb641ad1d845bbba54915bce75a962","35eb641ad1d845bbba54915bce75a962",22853789,5,0,1,320,97,97,0
"35eb641ad1d845bbba54915bce75a962","08be90ffbeea4795a138cd42ed8db56f",22853789,1,1,0,325,97,98,1
"08be90ffbeea4795a138cd42ed8db56f","08be90ffbeea4795a138cd42ed8db56f",22853789,5,0,1,326,98,98,0
"08be90ffbeea4795a138cd42ed8db56f","3007433c8f584dcbb5ac159c1c5f2be3",22853789,1,1,0,331,98,99,1
"3007433c8f584dcbb5ac159c1c5f2be3","3007433c8f584dcbb5ac159c1c5f2be3",22853789,5,0,1,332,99,99,0
"3007433c8f584dcbb5ac159c1c5f2be3","00ae5f0c51874a73a41ebea838d95682",22853789,1,3,0,337,99,101,2
"00ae5f0c51874a73a41ebea838d95682","e20db35ced8544ddac5bc3839145e463",22853789,1,-11,0,338,101,91,-10
"e20db35ced8544ddac5bc3839145e463","d391c8b6e56a43a7b654e9dee02d904b",22853789,1,13,0,339,91,103,12
"d391c8b6e56a43a7b654e9dee02d904b","00ae5f0c51874a73a41ebea838d95682",22853789,1,-2,0,340,103,101,-2
"00ae5f0c51874a73a41ebea838d95682","d391c8b6e56a43a7b654e9dee02d904b",22853789,3,2,0,341,101,103,2
"d391c8b6e56a43a7b654e9dee02d904b","d391c8b6e56a43a7b654e9dee02d904b",22853789,15,0,1,342,103,103,0
"d391c8b6e56a43a7b654e9dee02d904b","6111116566fc4fd9abba409322bea245",22853789,1,1,0,357,103,104,1
"6111116566fc4fd9abba409322bea245","6111116566fc4fd9abba409322bea245",22853789,2,0,1,358,104,104,0
"6111116566fc4fd9abba409322bea245","a81b2235cb9c499eb9ea8ee0a8dd9725",22853789,1,1,0,360,104,105,1
"a81b2235cb9c499eb9ea8ee0a8dd9725","a81b2235cb9c499eb9ea8ee0a8dd9725",22853789,5,0,1,361,105,105,0
"a81b2235cb9c499eb9ea8ee0a8dd9725","2d4e0ab0ef3b4d73b82c72d4621a7579",22853789,1,1,0,366,105,106,1
"2d4e0ab0ef3b4d73b82c72d4621a7579","2d4e0ab0ef3b4d73b82c72d4621a7579",22853789,2,0,1,367,106,106,0
"2d4e0ab0ef3b4d73b82c72d4621a7579","8bdebf492ebd4e62b0d522e8ab5e5197",22853789,1,1,0,369,106,107,1
"8bdebf492ebd4e62b0d522e8ab5e5197","8bdebf492ebd4e62b0d522e8ab5e5197",22853789,2,0,1,370,107,107,0
"8bdebf492ebd4e62b0d522e8ab5e5197","73039f8c1eb9409cb4caee2cf968001e",22853789,1,-7,0,372,107,100,-7
"73039f8c1eb9409cb4caee2cf968001e","4280927ec4d643238aa49c32f9e06c6c",22853789,1,10,0,373,100,109,9
"4280927ec4d643238aa49c32f9e06c6c","4280927ec4d643238aa49c32f9e06c6c",22853789,2,0,1,374,109,109,0
"4280927ec4d643238aa49c32f9e06c6c","fc44e6a5f7654430af1227838224dceb",22853789,2,2,0,375,109,111,2
"fc44e6a5f7654430af1227838224dceb","fc44e6a5f7654430af1227838224dceb",22853789,4,0,1,376,111,111,0
"fc44e6a5f7654430af1227838224dceb","08111f75e22d409998cf8b85bd431f0a",22853789,1,-3,0,378,111,108,-3
"08111f75e22d409998cf8b85bd431f0a","a9ae0a3c070d455bb4369a8996313336",22853789,3,7,0,379,108,114,6
"a9ae0a3c070d455bb4369a8996313336","a9ae0a3c070d455bb4369a8996313336",22853789,1,0,1,380,114,114,0
"a9ae0a3c070d455bb4369a8996313336","b7719e26494940efa49512aedd0aac79",22853789,1,-133,0,381,114,20,-94
"d4c3b003e8274e429d2fa688d73fde6d","62bff51286ef4f348717a3cf6fe2318f",22853789,1,137,0,385,22,120,98
"62bff51286ef4f348717a3cf6fe2318f","37319e88176d4aefa91d7a9980dbae91",22853789,2,-9,0,386,120,112,-8
"37319e88176d4aefa91d7a9980dbae91","e20db35ced8544ddac5bc3839145e463",22853789,1,-24,0,387,112,91,-21
"e20db35ced8544ddac5bc3839145e463","00ae5f0c51874a73a41ebea838d95682",22853789,2,11,0,391,91,101,10
"d391c8b6e56a43a7b654e9dee02d904b","4280927ec4d643238aa49c32f9e06c6c",22853789,2,7,0,393,103,109,6
"4280927ec4d643238aa49c32f9e06c6c","73039f8c1eb9409cb4caee2cf968001e",22853789,2,-10,0,394,109,100,-9
"73039f8c1eb9409cb4caee2cf968001e","08111f75e22d409998cf8b85bd431f0a",22853789,2,9,0,395,100,108,8
"a9ae0a3c070d455bb4369a8996313336","37319e88176d4aefa91d7a9980dbae91",22853789,2,-2,0,397,114,112,-2
"37319e88176d4aefa91d7a9980dbae91","4280927ec4d643238aa49c32f9e06c6c",22853789,2,-4,0,398,112,109,-3
"fc44e6a5f7654430af1227838224dceb","a9ae0a3c070d455bb4369a8996313336",22853789,1,4,0,402,111,114,3
"a9ae0a3c070d455bb4369a8996313336","08111f75e22d409998cf8b85bd431f0a",22853789,1,-7,0,403,114,108,-6
"08111f75e22d409998cf8b85bd431f0a","71cec822bcff4f30a20e75dc63ef7b65",22853789,1,9,0,404,108,116,8
"71cec822bcff4f30a20e75dc63ef7b65","71cec822bcff4f30a20e75dc63ef7b65",22853789,1,0,1,405,116,116,0
"71cec822bcff4f30a20e75dc63ef7b65","62bff51286ef4f348717a3cf6fe2318f",22853789,1,5,0,406,116,120,4
"37319e88176d4aefa91d7a9980dbae91","62bff51286ef4f348717a3cf6fe2318f",22853789,1,9,0,408,112,120,8
"62bff51286ef4f348717a3cf6fe2318f","62bff51286ef4f348717a3cf6fe2318f",22853789,5,0,1,409,120,120,0
"62bff51286ef4f348717a3cf6fe2318f","e20db35ced8544ddac5bc3839145e463",22853789,1,-33,0,412,120,91,-29
"e20db35ced8544ddac5bc3839145e463","779f9ddd1fd14d1e9e69f72219a1fdbd",22853789,2,36,0,413,91,121,30
"779f9ddd1fd14d1e9e69f72219a1fdbd","ae26e6cda8ad4a3f81bd347560d9579f",22853789,1,4,0,414,121,125,4
"ae26e6cda8ad4a3f81bd347560d9579f","ae26e6cda8ad4a3f81bd347560d9579f",22853789,1,0,1,415,125,125,0
"ae26e6cda8ad4a3f81bd347560d9579f","ee48df95832b4374aa273ceb27ec1315",22853789,1,1,0,416,125,126,1
"ee48df95832b4374aa273ceb27ec1315","ee48df95832b4374aa273ceb27ec1315",22853789,1,0,1,417,126,126,0
"ee48df95832b4374aa273ceb27ec1315","7a439da90b394756ad1777fc4c6dead5",22853789,1,1,0,418,126,127,1
"7a439da90b394756ad1777fc4c6dead5","7a439da90b394756ad1777fc4c6dead5",22853789,1,0,1,419,127,127,0
"7a439da90b394756ad1777fc4c6dead5","779f9ddd1fd14d1e9e69f72219a1fdbd",22853789,1,-6,0,420,127,121,-6
"779f9ddd1fd14d1e9e69f72219a1fdbd","a8dd5213034441ac92724b4e83eb0bb2",22853789,2,9,0,421,121,129,8
"a8dd5213034441ac92724b4e83eb0bb2","a8dd5213034441ac92724b4e83eb0bb2",22853789,1,0,1,422,129,129,0
"a8dd5213034441ac92724b4e83eb0bb2","8115eab6556b45f5b415c3b8c26a12e5",22853789,1,2,0,423,129,131,2
"8115eab6556b45f5b415c3b8c26a12e5","8115eab6556b45f5b415c3b8c26a12e5",22853789,2,0,1,424,131,131,0
"8115eab6556b45f5b415c3b8c26a12e5","ec34b06efd844b46a4c4818ecdb9b8f4",22853789,1,1,0,426,131,132,1
"ec34b06efd844b46a4c4818ecdb9b8f4","ec34b06efd844b46a4c4818ecdb9b8f4",22853789,5,0,1,427,132,132,0
"ec34b06efd844b46a4c4818ecdb9b8f4","c2e1c2b9eac64109b343a088584b576b",22853789,1,1,0,432,132,133,1
"c2e1c2b9eac64109b343a088584b576b","c2e1c2b9eac64109b343a088584b576b",22853789,2,0,1,433,133,133,0
"c2e1c2b9eac64109b343a088584b576b","579338175e0b4bbb8ef3b712b5d8b54e",22853789,1,-5,0,435,133,128,-5
"579338175e0b4bbb8ef3b712b5d8b54e","8bc5795d6a984a3eace4e2811e52dd4f",22853789,1,8,0,436,128,135,7
"8bc5795d6a984a3eace4e2811e52dd4f","8bc5795d6a984a3eace4e2811e52dd4f",22853789,1,0,1,437,135,135,0
"8bc5795d6a984a3eace4e2811e52dd4f","b416d47c56a742199b5d7c7f19d6503a",22853789,1,-1,0,438,135,134,-1
"b416d47c56a742199b5d7c7f19d6503a","cd4532ad48034873ba8bce2aac0c9808",22853789,1,4,0,439,134,137,3
"cd4532ad48034873ba8bce2aac0c9808","cd4532ad48034873ba8bce2aac0c9808",22853789,1,0,1,440,137,137,0
"cd4532ad48034873ba8bce2aac0c9808","779f9ddd1fd14d1e9e69f72219a1fdbd",22853789,1,-19,0,441,137,121,-16
"779f9ddd1fd14d1e9e69f72219a1fdbd","df1de691dafe4549a18a4398ee9dfaf9",22853789,1,23,0,442,121,139,18
"df1de691dafe4549a18a4398ee9dfaf9","6c5ad271a44743479bfaea29b1db8d02",22853789,1,4,0,443,139,143,4
"6c5ad271a44743479bfaea29b1db8d02","6c5ad271a44743479bfaea29b1db8d02",22853789,1,0,1,444,143,143,0
"6c5ad271a44743479bfaea29b1db8d02","83d311bed5374fee83d8d67a7d9d82dc",22853789,1,1,0,445,143,144,1
"83d311bed5374fee83d8d67a7d9d82dc","83d311bed5374fee83d8d67a7d9d82dc",22853789,1,0,1,446,144,144,0
"83d311bed5374fee83d8d67a7d9d82dc","402bba41861d43acb52a5abb89e8831e",22853789,1,1,0,447,144,145,1
"402bba41861d43acb52a5abb89e8831e","402bba41861d43acb52a5abb89e8831e",22853789,2,0,1,448,145,145,0
"402bba41861d43acb52a5abb89e8831e","df1de691dafe4549a18a4398ee9dfaf9",22853789,1,-6,0,450,145,139,-6
"df1de691dafe4549a18a4398ee9dfaf9","8aae34f5ddbb4052a709b12e6b0d40fa",22853789,1,9,0,451,139,147,8
"8aae34f5ddbb4052a709b12e6b0d40fa","8aae34f5ddbb4052a709b12e6b0d40fa",22853789,1,0,1,452,147,147,0
"8aae34f5ddbb4052a709b12e6b0d40fa","645b3f0249f64f76af2e19eb4d0e55b7",22853789,1,2,0,453,147,149,2
"645b3f0249f64f76af2e19eb4d0e55b7","645b3f0249f64f76af2e19eb4d0e55b7",22853789,5,0,1,454,149,149,0
"645b3f0249f64f76af2e19eb4d0e55b7","7e7b8db5064d4369805ab370aac5ddfb",22853789,1,1,0,459,149,150,1
"7e7b8db5064d4369805ab370aac5ddfb","7e7b8db5064d4369805ab370aac5ddfb",22853789,2,0,1,460,150,150,0
"7e7b8db5064d4369805ab370aac5ddfb","8956d210ae7f41968fada86d4c979d6a",22853789,1,1,0,462,150,151,1
"8956d210ae7f41968fada86d4c979d6a","8956d210ae7f41968fada86d4c979d6a",22853789,2,0,1,463,151,151,0
"8956d210ae7f41968fada86d4c979d6a","f902b0f41b544d4dbf79664fd233648d",22853789,1,-5,0,465,151,146,-5
"f902b0f41b544d4dbf79664fd233648d","ae781e8b775e4ccd93bc800dad5c8376",22853789,1,8,0,466,146,153,7
"ae781e8b775e4ccd93bc800dad5c8376","ae781e8b775e4ccd93bc800dad5c8376",22853789,2,0,1,467,153,153,0
"ae781e8b775e4ccd93bc800dad5c8376","06882a8492d9499aa31555567f575ecb",22853789,1,1,0,469,153,154,1
"06882a8492d9499aa31555567f575ecb","06882a8492d9499aa31555567f575ecb",22853789,1,0,1,470,154,154,0
"06882a8492d9499aa31555567f575ecb","f293c508f409466a8f27ddd7d1e40b20",22853789,1,1,0,471,154,155,1
"f293c508f409466a8f27ddd7d1e40b20","f293c508f409466a8f27ddd7d1e40b20",22853789,2,0,1,472,155,155,0
"f293c508f409466a8f27ddd7d1e40b20","cc4ddef5bbbe48ebb605141b347c4ed1",22853789,1,1,0,474,155,156,1
"cc4ddef5bbbe48ebb605141b347c4ed1","cc4ddef5bbbe48ebb605141b347c4ed1",22853789,1,0,1,475,156,156,0
"cc4ddef5bbbe48ebb605141b347c4ed1","f03480cf4eba413194d7af52fc0e7f28",22853789,1,-4,0,476,156,152,-4
"f03480cf4eba413194d7af52fc0e7f28","d313cec988a84645bee413e8d4724a4b",22853789,1,7,0,477,152,158,6
"d313cec988a84645bee413e8d4724a4b","d313cec988a84645bee413e8d4724a4b",22853789,6,0,1,478,158,158,0
"d313cec988a84645bee413e8d4724a4b","dc60696c76a74368a60f72246e47700d",22853789,1,1,0,482,158,159,1
"dc60696c76a74368a60f72246e47700d","dc60696c76a74368a60f72246e47700d",22853789,1,0,1,483,159,159,0
"dc60696c76a74368a60f72246e47700d","df1de691dafe4549a18a4398ee9dfaf9",22853789,1,-23,0,484,159,139,-20
"df1de691dafe4549a18a4398ee9dfaf9","78adeee1fa2c4fe0bc73f7bca9fcee86",22853789,1,26,0,485,139,160,21
"78adeee1fa2c4fe0bc73f7bca9fcee86","d646286c8051419bbc2e31dd1db55ca8",22853789,1,-115,0,486,160,67,-93
"d646286c8051419bbc2e31dd1db55ca8","d18a9ea32855445f8736581f5cb119ce",22853789,1,17,0,487,67,82,15
"d18a9ea32855445f8736581f5cb119ce","d18a9ea32855445f8736581f5cb119ce",22853789,1,0,1,488,82,82,0
"ae5ac430ea254e708a6f5deaaf7464ae","67a089198fcb4e1c8f2385786c2b296f",22853789,1,-57,0,490,84,39,-45
"67a089198fcb4e1c8f2385786c2b296f","e20db35ced8544ddac5bc3839145e463",22853789,1,67,0,491,39,91,52
"e20db35ced8544ddac5bc3839145e463","3ec3a3563847406fa73338f9e9999cf3",22853789,1,30,0,492,91,117,26
"3ec3a3563847406fa73338f9e9999cf3","62bff51286ef4f348717a3cf6fe2318f",22853789,1,3,0,493,117,120,3
"62bff51286ef4f348717a3cf6fe2318f","b1cd0e7dc3ad4a8eb91a4bfdbeb025b0",22853789,1,-2,0,496,120,118,-2
"b1cd0e7dc3ad4a8eb91a4bfdbeb025b0","b1cd0e7dc3ad4a8eb91a4bfdbeb025b0",22853789,2,0,1,497,118,118,0
"b1cd0e7dc3ad4a8eb91a4bfdbeb025b0","e20db35ced8544ddac5bc3839145e463",22853789,1,-31,0,499,118,91,-27
"779f9ddd1fd14d1e9e69f72219a1fdbd","67a089198fcb4e1c8f2385786c2b296f",22853789,2,-103,0,501,121,39,-82
"67a089198fcb4e1c8f2385786c2b296f","73039f8c1eb9409cb4caee2cf968001e",22853789,1,77,0,502,39,100,61
"73039f8c1eb9409cb4caee2cf968001e","e20db35ced8544ddac5bc3839145e463",22853789,1,-10,0,503,100,91,-9
"4280927ec4d643238aa49c32f9e06c6c","67a089198fcb4e1c8f2385786c2b296f",22853789,1,-87,0,513,109,39,-70
"67a089198fcb4e1c8f2385786c2b296f","f03480cf4eba413194d7af52fc0e7f28",22853789,1,141,0,514,39,152,113
"f03480cf4eba413194d7af52fc0e7f28","df1de691dafe4549a18a4398ee9dfaf9",22853789,1,-15,0,515,152,139,-13
"df1de691dafe4549a18a4398ee9dfaf9","d313cec988a84645bee413e8d4724a4b",22853789,1,22,0,516,139,158,19
"d313cec988a84645bee413e8d4724a4b","f03480cf4eba413194d7af52fc0e7f28",22853789,1,-7,0,519,158,152,-6
"f03480cf4eba413194d7af52fc0e7f28","f4ce60b4a944484082ccb701b48b3da1",22853789,1,6,0,520,152,157,5
"f4ce60b4a944484082ccb701b48b3da1","67a089198fcb4e1c8f2385786c2b296f",22853789,1,-147,0,521,157,39,-118
"67a089198fcb4e1c8f2385786c2b296f","779f9ddd1fd14d1e9e69f72219a1fdbd",22853789,1,103,0,522,39,121,82
"779f9ddd1fd14d1e9e69f72219a1fdbd","779f9ddd1fd14d1e9e69f72219a1fdbd",22853789,1,0,1,523,121,121,0
"a8dd5213034441ac92724b4e83eb0bb2","779f9ddd1fd14d1e9e69f72219a1fdbd",22853789,1,-9,0,525,129,121,-8
"67a089198fcb4e1c8f2385786c2b296f","78adeee1fa2c4fe0bc73f7bca9fcee86",22853789,3,152,0,527,39,160,121
"78adeee1fa2c4fe0bc73f7bca9fcee86","8959e6304a0348309a771e4d08d1b64a",22853789,2,4,0,528,160,163,3
"8959e6304a0348309a771e4d08d1b64a","65202579580f4ad38d734b4ee39d22a8",22853789,2,1,0,529,163,164,1
"65202579580f4ad38d734b4ee39d22a8","65202579580f4ad38d734b4ee39d22a8",22853789,78,0,1,530,164,164,0
"65202579580f4ad38d734b4ee39d22a8","8959e6304a0348309a771e4d08d1b64a",22853789,2,-1,0,537,164,163,-1
"8959e6304a0348309a771e4d08d1b64a","67a089198fcb4e1c8f2385786c2b296f",22853789,1,-156,0,538,163,39,-124
"67a089198fcb4e1c8f2385786c2b296f","d9c8d8c444a64dadbbb508652c721e17",22853789,1,10,0,539,39,46,7
"d9c8d8c444a64dadbbb508652c721e17","b534b89233134e30a9b5645138bfa9ee",22853789,1,-6,0,540,46,41,-5
"6e13d61a7bdb44bca949c9f86fab3be5","d0c74f735e024943943e40333d6d337f",22853789,1,5,0,542,47,51,4
"d0c74f735e024943943e40333d6d337f","d9c8d8c444a64dadbbb508652c721e17",22853789,1,-6,0,543,51,46,-5
"d9c8d8c444a64dadbbb508652c721e17","67a089198fcb4e1c8f2385786c2b296f",22853789,1,-10,0,544,46,39,-7
"67a089198fcb4e1c8f2385786c2b296f","d646286c8051419bbc2e31dd1db55ca8",22853789,1,37,0,549,39,67,28
"d646286c8051419bbc2e31dd1db55ca8","d646286c8051419bbc2e31dd1db55ca8",22853789,1,0,1,550,67,67,0
"d646286c8051419bbc2e31dd1db55ca8","67a089198fcb4e1c8f2385786c2b296f",22853789,1,-37,0,551,67,39,-28
"78adeee1fa2c4fe0bc73f7bca9fcee86","78adeee1fa2c4fe0bc73f7bca9fcee86",22853789,1,0,1,553,160,160,0
"78adeee1fa2c4fe0bc73f7bca9fcee86","c33c17be71ae4d588da7369472e5bb1b",22853789,1,-168,0,554,160,34,-126
"64d48c6c9c7940639a932219a6c87198","a23ae40d7a9e4ee4828cc06415a3218c",22853789,1,-32,0,567,40,27,-13
"a23ae40d7a9e4ee4828cc06415a3218c","b7719e26494940efa49512aedd0aac79",22853789,1,-9,0,568,27,20,-7
"b7719e26494940efa49512aedd0aac79","65202579580f4ad38d734b4ee39d22a8",22853789,1,197,0,572,20,164,144
"65202579580f4ad38d734b4ee39d22a8","78adeee1fa2c4fe0bc73f7bca9fcee86",22853789,3,-5,0,578,164,160,-4
"78adeee1fa2c4fe0bc73f7bca9fcee86","65202579580f4ad38d734b4ee39d22a8",22853789,3,5,0,579,160,164,4
"65202579580f4ad38d734b4ee39d22a8","a49d1bb4328949299686242fd0be5584",22853789,1,-195,0,583,164,21,-143
"d4c3b003e8274e429d2fa688d73fde6d","65202579580f4ad38d734b4ee39d22a8",22853789,1,194,0,586,22,164,142
"78adeee1fa2c4fe0bc73f7bca9fcee86","3cbcea2be0984e7dbd5a48195af10ce7",22853789,1,8,0,630,160,165,5
"82e6285962b8400d9d6fc32436022a94","a9ac840f098c4bd0a2ee896214ce29cd",22853789,1,3,0,632,167,168,1
"a9ac840f098c4bd0a2ee896214ce29cd","a9ac840f098c4bd0a2ee896214ce29cd",22853789,1,0,1,633,168,168,0
"a9ac840f098c4bd0a2ee896214ce29cd","67a089198fcb4e1c8f2385786c2b296f",22853789,1,-165,0,634,168,39,-129
"67a089198fcb4e1c8f2385786c2b296f","a9ac840f098c4bd0a2ee896214ce29cd",22853789,1,165,0,635,39,168,129
"a9ac840f098c4bd0a2ee896214ce29cd","0c7262dff33c4087bc660ccf40f92f9c",22853789,1,4,0,636,168,169,1
"0c7262dff33c4087bc660ccf40f92f9c","b2275c3fad834f8d90737a2d9a6927d6",22853789,2,3,0,637,169,172,3
"b2275c3fad834f8d90737a2d9a6927d6","67a089198fcb4e1c8f2385786c2b296f",22853789,1,-172,0,638,172,39,-133
"8959e6304a0348309a771e4d08d1b64a","0d987bed3ffa4ed0b9a2e62e97b7b30f",22853789,1,148,0,649,163,272,109
"0d987bed3ffa4ed0b9a2e62e97b7b30f","0c7262dff33c4087bc660ccf40f92f9c",22853789,1,-135,0,650,272,169,-103
"0c7262dff33c4087bc660ccf40f92f9c","0c7262dff33c4087bc660ccf40f92f9c",22853789,3,0,1,651,169,169,0
"b2275c3fad834f8d90737a2d9a6927d6","b2275c3fad834f8d90737a2d9a6927d6",22853789,22,0,1,654,172,172,0
"b2275c3fad834f8d90737a2d9a6927d6","eb515a26030b41f8a82a1e6114420bad",22853789,1,1,0,676,172,173,1
"eb515a26030b41f8a82a1e6114420bad","eb515a26030b41f8a82a1e6114420bad",22853789,2,0,1,677,173,173,0
"eb515a26030b41f8a82a1e6114420bad","b42cc17b7de840f181a704558d0bc845",22853789,1,3,0,679,173,175,2
"b42cc17b7de840f181a704558d0bc845","0c7262dff33c4087bc660ccf40f92f9c",22853789,1,-7,0,680,175,169,-6
"0c7262dff33c4087bc660ccf40f92f9c","b42cc17b7de840f181a704558d0bc845",22853789,1,7,0,681,169,175,6
"b42cc17b7de840f181a704558d0bc845","801f9e9135034f49bf5f8b4bdefedb41",22853789,1,2,0,682,175,177,2
"801f9e9135034f49bf5f8b4bdefedb41","801f9e9135034f49bf5f8b4bdefedb41",22853789,4,0,1,683,177,177,0
"801f9e9135034f49bf5f8b4bdefedb41","ea38cc0e6e6e41edbabf210220808bf9",22853789,1,3,0,687,177,179,2
"ea38cc0e6e6e41edbabf210220808bf9","362fcb0699a14845ab29b2340093e528",22853789,1,-6,0,688,179,174,-5
"362fcb0699a14845ab29b2340093e528","b87c552dd247427abe6ab5795b9c9d43",22853789,1,8,0,689,174,181,7
"b87c552dd247427abe6ab5795b9c9d43","ea38cc0e6e6e41edbabf210220808bf9",22853789,1,-2,0,690,181,179,-2
"ea38cc0e6e6e41edbabf210220808bf9","b87c552dd247427abe6ab5795b9c9d43",22853789,1,2,0,691,179,181,2
"b87c552dd247427abe6ab5795b9c9d43","b87c552dd247427abe6ab5795b9c9d43",22853789,7,0,1,692,181,181,0
"b87c552dd247427abe6ab5795b9c9d43","139b097acfca451689d80c9c6eebdf7b",22853789,1,-3,0,699,181,178,-3
"139b097acfca451689d80c9c6eebdf7b","30f660a1feb34582a739722532524f79",22853789,1,6,0,700,178,183,5
"30f660a1feb34582a739722532524f79","30f660a1feb34582a739722532524f79",22853789,5,0,1,701,183,183,0
"30f660a1feb34582a739722532524f79","2024b4885bd14338a39b7b509acbbd02",22853789,1,-1,0,706,183,182,-1
"2024b4885bd14338a39b7b509acbbd02","c3f63fe50d8e487c86bf8ef76c9cadd3",22853789,1,4,0,707,182,185,3
"c3f63fe50d8e487c86bf8ef76c9cadd3","c3f63fe50d8e487c86bf8ef76c9cadd3",22853789,1,0,1,708,185,185,0
"c3f63fe50d8e487c86bf8ef76c9cadd3","0c7262dff33c4087bc660ccf40f92f9c",22853789,1,-20,0,709,185,169,-16
"0c7262dff33c4087bc660ccf40f92f9c","c8e371568a0c4391b25796ae4e91952e",22853789,1,23,0,710,169,186,17
"c8e371568a0c4391b25796ae4e91952e","7d932b23e1c84326ae5aa4d3c0d813d1",22853789,1,2,0,711,186,188,2
"7d932b23e1c84326ae5aa4d3c0d813d1","7d932b23e1c84326ae5aa4d3c0d813d1",22853789,1,0,1,712,188,188,0
"7d932b23e1c84326ae5aa4d3c0d813d1","ab11d94c6c8948ea90b88f19d2cd502b",22853789,1,3,0,713,188,190,2
"ab11d94c6c8948ea90b88f19d2cd502b","c8e371568a0c4391b25796ae4e91952e",22853789,1,-5,0,714,190,186,-4
"c8e371568a0c4391b25796ae4e91952e","ab11d94c6c8948ea90b88f19d2cd502b",22853789,1,5,0,715,186,190,4
"ab11d94c6c8948ea90b88f19d2cd502b","f992451ed6ad4e68bb9e68ad6be7c4be",22853789,1,2,0,716,190,192,2
"f992451ed6ad4e68bb9e68ad6be7c4be","f992451ed6ad4e68bb9e68ad6be7c4be",22853789,1,0,1,717,192,192,0
"f992451ed6ad4e68bb9e68ad6be7c4be","6cd2dcaac46847d4a0bc53f296d90375",22853789,1,3,0,718,192,194,2
"6cd2dcaac46847d4a0bc53f296d90375","07b44a7a51e94c78b411c753fc39dab0",22853789,1,-6,0,719,194,189,-5
"07b44a7a51e94c78b411c753fc39dab0","6cd2dcaac46847d4a0bc53f296d90375",22853789,1,6,0,720,189,194,5
"6cd2dcaac46847d4a0bc53f296d90375","2d2580c9411c4972909db508d6956a58",22853789,1,2,0,721,194,196,2
"2d2580c9411c4972909db508d6956a58","2d2580c9411c4972909db508d6956a58",22853789,2,0,1,722,196,196,0
"2d2580c9411c4972909db508d6956a58","5bddb3d9ed264f3984702f048c7e5340",22853789,1,1,0,724,196,197,1
"5bddb3d9ed264f3984702f048c7e5340","5bddb3d9ed264f3984702f048c7e5340",22853789,2,0,1,725,197,197,0
"5bddb3d9ed264f3984702f048c7e5340","d5e8e2bd12a2466b9d6d90855f0eb079",22853789,1,1,0,727,197,198,1
"d5e8e2bd12a2466b9d6d90855f0eb079","d5e8e2bd12a2466b9d6d90855f0eb079",22853789,2,0,1,728,198,198,0
"d5e8e2bd12a2466b9d6d90855f0eb079","017d7ca8e0394b91aaadc9574df2202c",22853789,1,-5,0,730,198,193,-5
"017d7ca8e0394b91aaadc9574df2202c","54e8e9f0ea3e45c4bf3b8ac799ee31b1",22853789,1,8,0,731,193,200,7
"54e8e9f0ea3e45c4bf3b8ac799ee31b1","54e8e9f0ea3e45c4bf3b8ac799ee31b1",22853789,1,0,1,732,200,200,0
"54e8e9f0ea3e45c4bf3b8ac799ee31b1","c614a00911be4877a075f19315530fb0",22853789,1,1,0,733,200,201,1
"c614a00911be4877a075f19315530fb0","c614a00911be4877a075f19315530fb0",22853789,6,0,1,734,201,201,0
"c614a00911be4877a075f19315530fb0","a6c21bd8b95249c7972820a7a7d76aff",22853789,1,1,0,740,201,202,1
"a6c21bd8b95249c7972820a7a7d76aff","a6c21bd8b95249c7972820a7a7d76aff",22853789,1,0,1,741,202,202,0
"a6c21bd8b95249c7972820a7a7d76aff","bb329d880ab54120adaf203a693bb203",22853789,1,1,0,742,202,203,1
"bb329d880ab54120adaf203a693bb203","bb329d880ab54120adaf203a693bb203",22853789,1,0,1,743,203,203,0
"bb329d880ab54120adaf203a693bb203","f9170dd6bc6442b4acd832747609b09a",22853789,1,-4,0,744,203,199,-4
"f9170dd6bc6442b4acd832747609b09a","334c2344009840079b1d0e1b7ce3d5a7",22853789,1,7,0,745,199,205,6
"334c2344009840079b1d0e1b7ce3d5a7","334c2344009840079b1d0e1b7ce3d5a7",22853789,1,0,1,746,205,205,0
"334c2344009840079b1d0e1b7ce3d5a7","d7f13c8d63ec4e2aa673fbb9cf9c6933",22853789,1,3,0,747,205,206,1
"d7f13c8d63ec4e2aa673fbb9cf9c6933","c8e371568a0c4391b25796ae4e91952e",22853789,1,-26,0,748,206,186,-20
"c8e371568a0c4391b25796ae4e91952e","7108f0e4c2584f1f9c471689ae4c885c",22853789,1,28,0,749,186,208,22
"7108f0e4c2584f1f9c471689ae4c885c","b9e80f77c3a44349863b19875725c384",22853789,2,-1,0,750,208,207,-1
"b9e80f77c3a44349863b19875725c384","0c7262dff33c4087bc660ccf40f92f9c",22853789,1,-50,0,751,207,169,-38
"0c7262dff33c4087bc660ccf40f92f9c","017d7ca8e0394b91aaadc9574df2202c",22853789,1,32,0,752,169,193,24
"017d7ca8e0394b91aaadc9574df2202c","c8e371568a0c4391b25796ae4e91952e",22853789,1,-9,0,753,193,186,-7
"c8e371568a0c4391b25796ae4e91952e","6cd2dcaac46847d4a0bc53f296d90375",22853789,1,10,0,754,186,194,8
"6cd2dcaac46847d4a0bc53f296d90375","017d7ca8e0394b91aaadc9574df2202c",22853789,2,-1,0,755,194,193,-1
"017d7ca8e0394b91aaadc9574df2202c","6cd2dcaac46847d4a0bc53f296d90375",22853789,1,1,0,756,193,194,1
"6cd2dcaac46847d4a0bc53f296d90375","f9170dd6bc6442b4acd832747609b09a",22853789,1,6,0,757,194,199,5
"f9170dd6bc6442b4acd832747609b09a","6cd2dcaac46847d4a0bc53f296d90375",22853789,1,-6,0,758,199,194,-5
"017d7ca8e0394b91aaadc9574df2202c","0c7262dff33c4087bc660ccf40f92f9c",22853789,1,-32,0,760,193,169,-24
"0c7262dff33c4087bc660ccf40f92f9c","d7f13c8d63ec4e2aa673fbb9cf9c6933",22853789,1,49,0,761,169,206,37
"d7f13c8d63ec4e2aa673fbb9cf9c6933","d7f13c8d63ec4e2aa673fbb9cf9c6933",22853789,1,0,1,762,206,206,0
"d7f13c8d63ec4e2aa673fbb9cf9c6933","7108f0e4c2584f1f9c471689ae4c885c",22853789,1,2,0,763,206,208,2
"b9e80f77c3a44349863b19875725c384","b9e80f77c3a44349863b19875725c384",22853789,16,0,1,765,207,207,0
"b9e80f77c3a44349863b19875725c384","7108f0e4c2584f1f9c471689ae4c885c",22853789,1,1,0,781,207,208,1
"7108f0e4c2584f1f9c471689ae4c885c","7108f0e4c2584f1f9c471689ae4c885c",22853789,12,0,1,782,208,208,0
"7108f0e4c2584f1f9c471689ae4c885c","d7f13c8d63ec4e2aa673fbb9cf9c6933",22853789,1,-2,0,794,208,206,-2
"d7f13c8d63ec4e2aa673fbb9cf9c6933","09400e101c5d4b439cf9a26b03aae558",22853789,1,5,0,795,206,210,4
"09400e101c5d4b439cf9a26b03aae558","09400e101c5d4b439cf9a26b03aae558",22853789,1,0,1,796,210,210,0
"09400e101c5d4b439cf9a26b03aae558","a88efa7e50ce47159810ab553afa6d3a",22853789,1,2,0,797,210,212,2
"a88efa7e50ce47159810ab553afa6d3a","a88efa7e50ce47159810ab553afa6d3a",22853789,2,0,1,798,212,212,0
"a88efa7e50ce47159810ab553afa6d3a","be502a7a43c44bf7b682698de79d9369",22853789,1,3,0,800,212,214,2
"be502a7a43c44bf7b682698de79d9369","f7fb1952f56b4189b86a9f8b7862d2b8",22853789,2,1,0,801,214,215,1
"f7fb1952f56b4189b86a9f8b7862d2b8","a875096404ef4a9984b62d74cda916f9",22853789,1,-7,0,802,215,209,-6
"a875096404ef4a9984b62d74cda916f9","be502a7a43c44bf7b682698de79d9369",22853789,1,6,0,803,209,214,5
"f7fb1952f56b4189b86a9f8b7862d2b8","f7fb1952f56b4189b86a9f8b7862d2b8",22853789,15,0,1,805,215,215,0
"f7fb1952f56b4189b86a9f8b7862d2b8","b860ee85d8bc4a2f97958cfb71be3533",22853789,1,1,0,820,215,216,1
"b860ee85d8bc4a2f97958cfb71be3533","b860ee85d8bc4a2f97958cfb71be3533",22853789,2,0,1,821,216,216,0
"b860ee85d8bc4a2f97958cfb71be3533","ec341f459285443b8361f7f15638ff08",22853789,1,-3,0,823,216,213,-3
"ec341f459285443b8361f7f15638ff08","363837c182e04711840d896ae1e0339c",22853789,1,6,0,824,213,218,5
"363837c182e04711840d896ae1e0339c","363837c182e04711840d896ae1e0339c",22853789,12,0,1,825,218,218,0
"363837c182e04711840d896ae1e0339c","01b2051f8941460d89945e3b02d1ce78",22853789,1,-1,0,837,218,217,-1
"01b2051f8941460d89945e3b02d1ce78","d7f13c8d63ec4e2aa673fbb9cf9c6933",22853789,1,-14,0,838,217,206,-11
"d7f13c8d63ec4e2aa673fbb9cf9c6933","a875096404ef4a9984b62d74cda916f9",22853789,1,4,0,839,206,209,3
"a875096404ef4a9984b62d74cda916f9","09400e101c5d4b439cf9a26b03aae558",22853789,1,1,0,840,209,210,1
"09400e101c5d4b439cf9a26b03aae558","91125ca626c5470eb145501f8c37f8db",22853789,1,13,0,841,210,220,10
"91125ca626c5470eb145501f8c37f8db","91125ca626c5470eb145501f8c37f8db",22853789,1,0,1,842,220,220,0
"91125ca626c5470eb145501f8c37f8db","1c6721b1f63f4d30ba7746ea8af02a52",22853789,1,3,0,843,220,221,1
"1c6721b1f63f4d30ba7746ea8af02a52","d7f13c8d63ec4e2aa673fbb9cf9c6933",22853789,1,-21,0,844,221,206,-15
"d7f13c8d63ec4e2aa673fbb9cf9c6933","77ecef8eff6b4a2caea7707669bf7475",22853789,1,22,0,845,206,222,16
"77ecef8eff6b4a2caea7707669bf7475","0c7262dff33c4087bc660ccf40f92f9c",22853789,1,-71,0,846,222,169,-53
"0c7262dff33c4087bc660ccf40f92f9c","78adeee1fa2c4fe0bc73f7bca9fcee86",22853789,1,-17,0,848,169,160,-9
"65202579580f4ad38d734b4ee39d22a8","0c7262dff33c4087bc660ccf40f92f9c",22853789,1,12,0,867,164,169,5
"0c7262dff33c4087bc660ccf40f92f9c","1c6721b1f63f4d30ba7746ea8af02a52",22853789,1,70,0,868,169,221,52
"1c6721b1f63f4d30ba7746ea8af02a52","1c6721b1f63f4d30ba7746ea8af02a52",22853789,1,0,1,869,221,221,0
"1c6721b1f63f4d30ba7746ea8af02a52","77ecef8eff6b4a2caea7707669bf7475",22853789,1,1,0,870,221,222,1
"77ecef8eff6b4a2caea7707669bf7475","77ecef8eff6b4a2caea7707669bf7475",22853789,13,0,1,871,222,222,0
"77ecef8eff6b4a2caea7707669bf7475","1c6721b1f63f4d30ba7746ea8af02a52",22853789,1,-1,0,884,222,221,-1
"1c6721b1f63f4d30ba7746ea8af02a52","d03cb855c70044cf8c35d9ec0de696e3",22853789,1,4,0,885,221,224,3
"d03cb855c70044cf8c35d9ec0de696e3","8b9ae98743bd4d4a8a87dff1c1244211",22853789,2,3,0,886,224,227,3
"8b9ae98743bd4d4a8a87dff1c1244211","d03cb855c70044cf8c35d9ec0de696e3",22853789,2,-3,0,887,227,224,-3
"d03cb855c70044cf8c35d9ec0de696e3","a49a937d6896486d9a5396654abcf2e1",22853789,1,2,0,888,224,226,2
"a49a937d6896486d9a5396654abcf2e1","a49a937d6896486d9a5396654abcf2e1",22853789,3,0,1,889,226,226,0
"a49a937d6896486d9a5396654abcf2e1","8b9ae98743bd4d4a8a87dff1c1244211",22853789,1,1,0,892,226,227,1
"8b9ae98743bd4d4a8a87dff1c1244211","8b9ae98743bd4d4a8a87dff1c1244211",22853789,25,0,1,893,227,227,0
"8b9ae98743bd4d4a8a87dff1c1244211","2ab1535aac1346ba8801535bf729ef37",22853789,1,3,0,918,227,229,2
"2ab1535aac1346ba8801535bf729ef37","f7906d6f59b9489a91d2ef40db5a474d",22853789,2,-7,0,919,229,223,-6
"f7906d6f59b9489a91d2ef40db5a474d","2ab1535aac1346ba8801535bf729ef37",22853789,2,7,0,920,223,229,6
"2ab1535aac1346ba8801535bf729ef37","a4f40fb48a8542c8949bae1f002cd9bc",22853789,1,2,0,921,229,231,2
"a4f40fb48a8542c8949bae1f002cd9bc","a4f40fb48a8542c8949bae1f002cd9bc",22853789,2,0,1,922,231,231,0
"a4f40fb48a8542c8949bae1f002cd9bc","8972c23e32044edb8a78fa1eed4e5947",22853789,1,1,0,924,231,232,1
"8972c23e32044edb8a78fa1eed4e5947","8972c23e32044edb8a78fa1eed4e5947",22853789,1,0,1,925,232,232,0
"8972c23e32044edb8a78fa1eed4e5947","92feb4a40f8344d38b6f722e42a53295",22853789,1,1,0,926,232,233,1
"92feb4a40f8344d38b6f722e42a53295","92feb4a40f8344d38b6f722e42a53295",22853789,2,0,1,927,233,233,0
"92feb4a40f8344d38b6f722e42a53295","5152833676bf4c6cb317060be10f68db",22853789,1,-5,0,929,233,228,-5
"5152833676bf4c6cb317060be10f68db","0b04c8e2f86d48c7aeb7e225819cd32b",22853789,1,7,0,930,228,234,6
"0b04c8e2f86d48c7aeb7e225819cd32b","8b9ae98743bd4d4a8a87dff1c1244211",22853789,1,-9,0,931,234,227,-7
"d03cb855c70044cf8c35d9ec0de696e3","2ab1535aac1346ba8801535bf729ef37",22853789,1,6,0,933,224,229,5
"f7906d6f59b9489a91d2ef40db5a474d","5152833676bf4c6cb317060be10f68db",22853789,1,6,0,935,223,228,5
"5152833676bf4c6cb317060be10f68db","ca3e28f290354c08aefe5b0f769604e6",22853789,1,8,0,936,228,235,7
"ca3e28f290354c08aefe5b0f769604e6","ca3e28f290354c08aefe5b0f769604e6",22853789,9,0,1,937,235,235,0
"ca3e28f290354c08aefe5b0f769604e6","79a35eea833e4c2c9d22fc53c3c6445c",22853789,1,1,0,946,235,236,1
"79a35eea833e4c2c9d22fc53c3c6445c","79a35eea833e4c2c9d22fc53c3c6445c",22853789,9,0,1,947,236,236,0
"79a35eea833e4c2c9d22fc53c3c6445c","8f68228b1518449e9615cdafee41a2bd",22853789,1,1,0,956,236,237,1
"8f68228b1518449e9615cdafee41a2bd","8f68228b1518449e9615cdafee41a2bd",22853789,1,0,1,957,237,237,0
"8f68228b1518449e9615cdafee41a2bd","cab89fa5c3ed45a5aa550fc0352d6a42",22853789,1,1,0,958,237,238,1
"cab89fa5c3ed45a5aa550fc0352d6a42","cab89fa5c3ed45a5aa550fc0352d6a42",22853789,1,0,1,959,238,238,0
"cab89fa5c3ed45a5aa550fc0352d6a42","1c6721b1f63f4d30ba7746ea8af02a52",22853789,1,-20,0,960,238,221,-17
"1c6721b1f63f4d30ba7746ea8af02a52","f7906d6f59b9489a91d2ef40db5a474d",22853789,1,3,0,961,221,223,2
"f7906d6f59b9489a91d2ef40db5a474d","d03cb855c70044cf8c35d9ec0de696e3",22853789,1,1,0,962,223,224,1
"8b9ae98743bd4d4a8a87dff1c1244211","f7906d6f59b9489a91d2ef40db5a474d",22853789,1,-4,0,964,227,223,-4
"2ab1535aac1346ba8801535bf729ef37","5152833676bf4c6cb317060be10f68db",22853789,1,-1,0,966,229,228,-1
"5152833676bf4c6cb317060be10f68db","77ecef8eff6b4a2caea7707669bf7475",22853789,1,-8,0,967,228,222,-6
"77ecef8eff6b4a2caea7707669bf7475","66d4fad4f1cf4b46be0750a99ad7a35a",22853789,1,20,0,968,222,239,17
"66d4fad4f1cf4b46be0750a99ad7a35a","66d4fad4f1cf4b46be0750a99ad7a35a",22853789,1,0,1,969,239,239,0
"66d4fad4f1cf4b46be0750a99ad7a35a","0b04c8e2f86d48c7aeb7e225819cd32b",22853789,1,-5,0,970,239,234,-5
"0b04c8e2f86d48c7aeb7e225819cd32b","f53da5fd9bfe412da4b80d4742563b6c",22853789,1,8,0,971,234,241,7
"f53da5fd9bfe412da4b80d4742563b6c","f53da5fd9bfe412da4b80d4742563b6c",22853789,1,0,1,972,241,241,0
"f53da5fd9bfe412da4b80d4742563b6c","1c6721b1f63f4d30ba7746ea8af02a52",22853789,1,-24,0,973,241,221,-20
"1c6721b1f63f4d30ba7746ea8af02a52","2ae94c0cea4d480a9d5dca8fb1d7b542",22853789,1,27,0,974,221,242,21
"2ae94c0cea4d480a9d5dca8fb1d7b542","1ebf23f9d994469a85206e4c7b1bf5f5",22853789,2,3,0,975,242,245,3
"1ebf23f9d994469a85206e4c7b1bf5f5","0c7262dff33c4087bc660ccf40f92f9c",22853789,1,-100,0,976,245,169,-76
"0c7262dff33c4087bc660ccf40f92f9c","2ae94c0cea4d480a9d5dca8fb1d7b542",22853789,1,97,0,977,169,242,73
"2ae94c0cea4d480a9d5dca8fb1d7b542","2ae94c0cea4d480a9d5dca8fb1d7b542",22853789,1,0,1,978,242,242,0
"1ebf23f9d994469a85206e4c7b1bf5f5","1ebf23f9d994469a85206e4c7b1bf5f5",22853789,10,0,1,980,245,245,0
"1ebf23f9d994469a85206e4c7b1bf5f5","85ae675b83e8422da842cfd25596af99",22853789,1,1,0,990,245,246,1
"85ae675b83e8422da842cfd25596af99","85ae675b83e8422da842cfd25596af99",22853789,1,0,1,991,246,246,0
"85ae675b83e8422da842cfd25596af99","2ae94c0cea4d480a9d5dca8fb1d7b542",22853789,1,-4,0,992,246,242,-4
"2ae94c0cea4d480a9d5dca8fb1d7b542","fa235f0f364d47e4ae1c87f47bf8e6ba",22853789,1,12,0,993,242,252,10
"fa235f0f364d47e4ae1c87f47bf8e6ba","fa235f0f364d47e4ae1c87f47bf8e6ba",22853789,3,0,1,994,252,252,0
"fa235f0f364d47e4ae1c87f47bf8e6ba","79f7845465cc4ed19d8e4f1429541be0",22853789,1,2,0,997,252,254,2
"79f7845465cc4ed19d8e4f1429541be0","79f7845465cc4ed19d8e4f1429541be0",22853789,2,0,1,998,254,254,0
"79f7845465cc4ed19d8e4f1429541be0","00f61990949545828dd12f1303d47504",22853789,1,3,0,1000,254,256,2
"00f61990949545828dd12f1303d47504","6e83e23f56544a19b94067c1c558d9c0",22853789,2,-11,0,1001,256,247,-9
"6e83e23f56544a19b94067c1c558d9c0","00f61990949545828dd12f1303d47504",22853789,1,11,0,1002,247,256,9
"00f61990949545828dd12f1303d47504","ead7bb4b64e247d2ae632ab8a296b091",22853789,1,2,0,1003,256,258,2
"ead7bb4b64e247d2ae632ab8a296b091","ead7bb4b64e247d2ae632ab8a296b091",22853789,2,0,1,1004,258,258,0
"ead7bb4b64e247d2ae632ab8a296b091","41b0048dde734bb280bac6116baa8e27",22853789,1,1,0,1006,258,259,1
"41b0048dde734bb280bac6116baa8e27","41b0048dde734bb280bac6116baa8e27",22853789,2,0,1,1007,259,259,0
"41b0048dde734bb280bac6116baa8e27","b41c5a094a604ee0915327da5cc0beb7",22853789,1,1,0,1009,259,260,1
"b41c5a094a604ee0915327da5cc0beb7","b41c5a094a604ee0915327da5cc0beb7",22853789,2,0,1,1010,260,260,0
"b41c5a094a604ee0915327da5cc0beb7","d546341988904f069cfa86b21457d9d9",22853789,1,-10,0,1012,260,251,-9
"d546341988904f069cfa86b21457d9d9","d989ebcfc12a4b669f0100dc1aa14f1e",22853789,1,5,0,1013,251,255,4
"d989ebcfc12a4b669f0100dc1aa14f1e","00f61990949545828dd12f1303d47504",22853789,1,1,0,1014,255,256,1
"00f61990949545828dd12f1303d47504","d546341988904f069cfa86b21457d9d9",22853789,1,-6,0,1015,256,251,-5
"d546341988904f069cfa86b21457d9d9","28c171777c52431ab6b925073bd63d46",22853789,1,15,0,1016,251,264,13
"28c171777c52431ab6b925073bd63d46","28c171777c52431ab6b925073bd63d46",22853789,11,0,1,1017,264,264,0
"28c171777c52431ab6b925073bd63d46","ac160db940cb49ae8579162b1d52bb5d",22853789,1,2,0,1028,264,266,2
"ac160db940cb49ae8579162b1d52bb5d","ac160db940cb49ae8579162b1d52bb5d",22853789,3,0,1,1029,266,266,0
"ac160db940cb49ae8579162b1d52bb5d","d989ebcfc12a4b669f0100dc1aa14f1e",22853789,1,-12,0,1032,266,255,-11
"d989ebcfc12a4b669f0100dc1aa14f1e","c6fd49b485cc4874b0bbdd9c6171e09c",22853789,1,15,0,1033,255,268,13
"c6fd49b485cc4874b0bbdd9c6171e09c","c6fd49b485cc4874b0bbdd9c6171e09c",22853789,3,0,1,1034,268,268,0
"c6fd49b485cc4874b0bbdd9c6171e09c","44240778a97c4af0937817499b75707b",22853789,1,1,0,1037,268,269,1
"44240778a97c4af0937817499b75707b","44240778a97c4af0937817499b75707b",22853789,2,0,1,1038,269,269,0
"44240778a97c4af0937817499b75707b","7aa76d3e993840d8805f097cbdbcd44b",22853789,1,-9,0,1040,269,261,-8
"7aa76d3e993840d8805f097cbdbcd44b","865a4d3b43374da7944dc7d397f566d9",22853789,1,12,0,1041,261,271,10
"865a4d3b43374da7944dc7d397f566d9","865a4d3b43374da7944dc7d397f566d9",22853789,1,0,1,1042,271,271,0
"865a4d3b43374da7944dc7d397f566d9","2ae94c0cea4d480a9d5dca8fb1d7b542",22853789,1,-35,0,1043,271,242,-29
"2ae94c0cea4d480a9d5dca8fb1d7b542","0d987bed3ffa4ed0b9a2e62e97b7b30f",22853789,1,38,0,1044,242,272,30
"0d987bed3ffa4ed0b9a2e62e97b7b30f","0d987bed3ffa4ed0b9a2e62e97b7b30f",22853789,1,0,1,1045,272,272,0
"0d987bed3ffa4ed0b9a2e62e97b7b30f","82ae07bc0c9b4570a41799290d1ef399",22853789,2,4,0,1046,272,275,3
"82ae07bc0c9b4570a41799290d1ef399","bb5a47f5ea01454a8b79455422d3b9da",22853789,3,6,0,1047,275,280,5
"bb5a47f5ea01454a8b79455422d3b9da","bb5a47f5ea01454a8b79455422d3b9da",22853789,79,0,1,1048,280,280,0
"bb5a47f5ea01454a8b79455422d3b9da","0d987bed3ffa4ed0b9a2e62e97b7b30f",22853789,1,-10,0,1055,280,272,-8
"0d987bed3ffa4ed0b9a2e62e97b7b30f","bc5524e78a8544e2ae2fdc2f3462bbec",22853789,1,9,0,1056,272,279,7
"bc5524e78a8544e2ae2fdc2f3462bbec","bb5a47f5ea01454a8b79455422d3b9da",22853789,1,1,0,1057,279,280,1
"bb5a47f5ea01454a8b79455422d3b9da","0c7262dff33c4087bc660ccf40f92f9c",22853789,1,-145,0,1067,280,169,-111
"0c7262dff33c4087bc660ccf40f92f9c","0d987bed3ffa4ed0b9a2e62e97b7b30f",22853789,1,135,0,1068,169,272,103
"bb5a47f5ea01454a8b79455422d3b9da","94cecc3f1e7d484b8e068e79241dfd73",22853789,1,3,0,1128,280,281,1
"94cecc3f1e7d484b8e068e79241dfd73","0d987bed3ffa4ed0b9a2e62e97b7b30f",22853789,1,-13,0,1129,281,272,-9
"0d987bed3ffa4ed0b9a2e62e97b7b30f","a37477c4e4c14169ad44b06b493007f6",22853789,1,15,0,1130,272,283,11
"a37477c4e4c14169ad44b06b493007f6","94cecc3f1e7d484b8e068e79241dfd73",22853789,1,-2,0,1131,283,281,-2
"94cecc3f1e7d484b8e068e79241dfd73","fab84b4fab5940efb4ea868ef8d09396",22853789,1,5,0,1132,281,284,3
"fab84b4fab5940efb4ea868ef8d09396","4a29443515bb404cb8924e1c60a63b73",22853789,2,4,0,1133,284,285,1
"4a29443515bb404cb8924e1c60a63b73","fab84b4fab5940efb4ea868ef8d09396",22853789,2,-4,0,1134,285,284,-1
"fab84b4fab5940efb4ea868ef8d09396","208c9b2796c944db8dacaa96082520ea",22853789,2,7,0,1135,284,288,4
"208c9b2796c944db8dacaa96082520ea","eb2a0eb537344a9e891c761662e400b6",22853789,1,-378,0,1136,288,16,-272
"eb2a0eb537344a9e891c761662e400b6","56586aa865414f538729c7f7735d2bc6",22853789,1,-8,0,1137,16,12,-4
"56586aa865414f538729c7f7735d2bc6","5c5ceeee4562457ba6d41515aeebfbb1",22853789,1,10,0,1138,12,17,5
"5c5ceeee4562457ba6d41515aeebfbb1","9afd71a5298d4333b6849dfce1b9422c",22853789,1,3,0,1139,17,18,1
"9afd71a5298d4333b6849dfce1b9422c","56586aa865414f538729c7f7735d2bc6",22853789,3,-13,0,1140,18,12,-6
"9afd71a5298d4333b6849dfce1b9422c","b7719e26494940efa49512aedd0aac79",22853789,2,4,0,1142,18,20,2
"b7719e26494940efa49512aedd0aac79","d4f45188d3c84a02ba08454e6403a818",22853789,3,5,0,1143,20,24,4
"b7719e26494940efa49512aedd0aac79","afbf7250b99d47bea07172749483ca97",22853789,3,12,0,1146,20,28,8
"afbf7250b99d47bea07172749483ca97","b7719e26494940efa49512aedd0aac79",22853789,1,-12,0,1147,28,20,-8
"afbf7250b99d47bea07172749483ca97","4e51676dc72045d99c19b9fa7b22f8bc",22853789,3,3,0,1149,28,29,1
"4e51676dc72045d99c19b9fa7b22f8bc","4e51676dc72045d99c19b9fa7b22f8bc",22853789,1,0,1,1150,29,29,0
"4e51676dc72045d99c19b9fa7b22f8bc","51970cfa30e643e894e66ae85c8024cc",22853789,2,3,0,1151,29,31,2
"51970cfa30e643e894e66ae85c8024cc","c33c17be71ae4d588da7369472e5bb1b",22853789,1,6,0,1152,31,34,3
"c33c17be71ae4d588da7369472e5bb1b","4e51676dc72045d99c19b9fa7b22f8bc",22853789,1,-9,0,1153,34,29,-5
"4e51676dc72045d99c19b9fa7b22f8bc","c33c17be71ae4d588da7369472e5bb1b",22853789,2,9,0,1154,29,34,5
"c33c17be71ae4d588da7369472e5bb1b","93679be414554a11b1893002f2229a93",22853789,4,3,0,1155,34,35,1
"93679be414554a11b1893002f2229a93","93679be414554a11b1893002f2229a93",22853789,2,0,1,1156,35,35,0
"93679be414554a11b1893002f2229a93","7040a13096d746ac84b8fac8d9752058",22853789,3,3,0,1157,35,36,1
"7040a13096d746ac84b8fac8d9752058","7040a13096d746ac84b8fac8d9752058",22853789,3,0,1,1158,36,36,0
"7040a13096d746ac84b8fac8d9752058","9a0dc646f934470daf08c4b56ccf73db",22853789,3,3,0,1159,36,37,1
"9a0dc646f934470daf08c4b56ccf73db","fc0e049d56024bc9a02c9a9c435c3df7",22853789,6,3,0,1160,37,38,1
"fc0e049d56024bc9a02c9a9c435c3df7","9a0dc646f934470daf08c4b56ccf73db",22853789,3,-3,0,1161,38,37,-1
"fc0e049d56024bc9a02c9a9c435c3df7","67a089198fcb4e1c8f2385786c2b296f",22853789,3,4,0,1163,38,39,1
"64d48c6c9c7940639a932219a6c87198","67a089198fcb4e1c8f2385786c2b296f",22853789,3,-1,0,1165,40,39,-1
"67a089198fcb4e1c8f2385786c2b296f","b534b89233134e30a9b5645138bfa9ee",22853789,4,4,0,1166,39,41,2
"b534b89233134e30a9b5645138bfa9ee","67a089198fcb4e1c8f2385786c2b296f",22853789,2,-4,0,1167,41,39,-2
"b534b89233134e30a9b5645138bfa9ee","b613861cecf84ffcab01afb23f660475",22853789,1,-76,0,1169,41,1,-40
"b613861cecf84ffcab01afb23f660475","e2911e79efc2420eac45d9f671463d4b",22853789,5,3,0,1171,1,2,1
"e2911e79efc2420eac45d9f671463d4b","b613861cecf84ffcab01afb23f660475",22853789,2,-3,0,1172,2,1,-1
"b613861cecf84ffcab01afb23f660475","56586aa865414f538729c7f7735d2bc6",22853789,1,15,0,1173,1,12,11
"56586aa865414f538729c7f7735d2bc6","e2911e79efc2420eac45d9f671463d4b",22853789,3,-12,0,1174,12,2,-10
"e2911e79efc2420eac45d9f671463d4b","56586aa865414f538729c7f7735d2bc6",22853789,6,12,0,1175,2,12,10
"56586aa865414f538729c7f7735d2bc6","b7f2b31585d94eb3bf86376714aa7070",22853789,7,2,0,1176,12,13,1
"b7f2b31585d94eb3bf86376714aa7070","56586aa865414f538729c7f7735d2bc6",22853789,4,-2,0,1177,13,12,-1
"b7f2b31585d94eb3bf86376714aa7070","3f1c815879794b929260d224becaff7e",22853789,3,2,0,1179,13,14,1
"3f1c815879794b929260d224becaff7e","fab84b4fab5940efb4ea868ef8d09396",22853789,1,375,0,1180,14,284,270
"208c9b2796c944db8dacaa96082520ea","208c9b2796c944db8dacaa96082520ea",22853789,1,0,1,1184,288,288,0
"208c9b2796c944db8dacaa96082520ea","4a29443515bb404cb8924e1c60a63b73",22853789,1,-3,0,1185,288,285,-3
"4a29443515bb404cb8924e1c60a63b73","7669a956527947d0add87455277e80b4",22853789,1,7,0,1186,285,291,6
"7669a956527947d0add87455277e80b4","7669a956527947d0add87455277e80b4",22853789,1,0,1,1187,291,291,0
"7669a956527947d0add87455277e80b4","6a9a3b5bde4a48daa896fe8c06eca56f",22853789,1,-2,0,1188,291,289,-2
"6a9a3b5bde4a48daa896fe8c06eca56f","869e967078f04da18dd0b0b9389a7424",22853789,1,5,0,1189,289,293,4
"869e967078f04da18dd0b0b9389a7424","869e967078f04da18dd0b0b9389a7424",22853789,2,0,1,1190,293,293,0
"869e967078f04da18dd0b0b9389a7424","51ab6291537748fab90d519aa09889d6",22853789,1,2,0,1191,293,295,2
"51ab6291537748fab90d519aa09889d6","51ab6291537748fab90d519aa09889d6",22853789,5,0,1,1192,295,295,0
"51ab6291537748fab90d519aa09889d6","34a6e49023fc4465bd5ca604330bbd1c",22853789,1,-3,0,1197,295,292,-3
"34a6e49023fc4465bd5ca604330bbd1c","21592f2a9e9c4b2f8c66ec5dbcbf6a2b",22853789,1,5,0,1198,292,296,4
"21592f2a9e9c4b2f8c66ec5dbcbf6a2b","ba0e59461bfb4a44b7b1c28a01f8d3b3",22853789,1,4,0,1199,296,299,3
"ba0e59461bfb4a44b7b1c28a01f8d3b3","ba0e59461bfb4a44b7b1c28a01f8d3b3",22853789,1,0,1,1200,299,299,0
"ba0e59461bfb4a44b7b1c28a01f8d3b3","0e0b36e731a645e7b1b8a88f5031ca38",22853789,1,2,0,1201,299,301,2
"0e0b36e731a645e7b1b8a88f5031ca38","0e0b36e731a645e7b1b8a88f5031ca38",22853789,2,0,1,1202,301,301,0
"0e0b36e731a645e7b1b8a88f5031ca38","a66a144637284c21afc6de17fea4bfb8",22853789,1,1,0,1204,301,302,1
"a66a144637284c21afc6de17fea4bfb8","a66a144637284c21afc6de17fea4bfb8",22853789,5,0,1,1205,302,302,0
"a66a144637284c21afc6de17fea4bfb8","7646a919d7e64fa990bca9b024ff089d",22853789,1,-4,0,1210,302,298,-4
"7646a919d7e64fa990bca9b024ff089d","e390b575229748ea8aac9364efe2bf00",22853789,1,7,0,1211,298,304,6
"e390b575229748ea8aac9364efe2bf00","e390b575229748ea8aac9364efe2bf00",22853789,1,0,1,1212,304,304,0
"e390b575229748ea8aac9364efe2bf00","4a29443515bb404cb8924e1c60a63b73",22853789,1,-24,0,1213,304,285,-19
"4a29443515bb404cb8924e1c60a63b73","3434c10e561d488a914e0f7d71907abd",22853789,2,27,0,1214,285,305,20
"3434c10e561d488a914e0f7d71907abd","53e7e900392747ccad52e711ab0f80d8",22853789,3,2,0,1215,305,307,2
"53e7e900392747ccad52e711ab0f80d8","53e7e900392747ccad52e711ab0f80d8",22853789,3,0,1,1216,307,307,0
"53e7e900392747ccad52e711ab0f80d8","130acc2aeb0448fdbb2de63bc5cebe5b",22853789,1,3,0,1217,307,309,2
"130acc2aeb0448fdbb2de63bc5cebe5b","3434c10e561d488a914e0f7d71907abd",22853789,2,-5,0,1218,309,305,-4
"53e7e900392747ccad52e711ab0f80d8","141c0df6cd1946539aadd1c9b7068cd4",22853789,2,2,0,1220,307,308,1
"141c0df6cd1946539aadd1c9b7068cd4","130acc2aeb0448fdbb2de63bc5cebe5b",22853789,1,1,0,1221,308,309,1
"141c0df6cd1946539aadd1c9b7068cd4","53e7e900392747ccad52e711ab0f80d8",22853789,1,-2,0,1225,308,307,-1
"53e7e900392747ccad52e711ab0f80d8","3434c10e561d488a914e0f7d71907abd",22853789,2,-2,0,1228,307,305,-2
"3434c10e561d488a914e0f7d71907abd","130acc2aeb0448fdbb2de63bc5cebe5b",22853789,2,5,0,1229,305,309,4
"130acc2aeb0448fdbb2de63bc5cebe5b","130acc2aeb0448fdbb2de63bc5cebe5b",22853789,1,0,1,1230,309,309,0
"130acc2aeb0448fdbb2de63bc5cebe5b","9c062b3251034ebe90f5054e2a3b5120",22853789,1,2,0,1231,309,311,2
"9c062b3251034ebe90f5054e2a3b5120","9c062b3251034ebe90f5054e2a3b5120",22853789,2,0,1,1232,311,311,0
"9c062b3251034ebe90f5054e2a3b5120","ea859f8207e44537889daeaba13ac2e8",22853789,1,1,0,1234,311,312,1
"ea859f8207e44537889daeaba13ac2e8","ea859f8207e44537889daeaba13ac2e8",22853789,1,0,1,1235,312,312,0
"ea859f8207e44537889daeaba13ac2e8","56d94971a7a94257aa330183a8ebd0ea",22853789,1,1,0,1236,312,313,1
"56d94971a7a94257aa330183a8ebd0ea","56d94971a7a94257aa330183a8ebd0ea",22853789,1,0,1,1237,313,313,0
"56d94971a7a94257aa330183a8ebd0ea","141c0df6cd1946539aadd1c9b7068cd4",22853789,1,-5,0,1238,313,308,-5
"141c0df6cd1946539aadd1c9b7068cd4","13255e63e0aa4abf85e5211bf613d43e",22853789,1,10,0,1239,308,317,9
"13255e63e0aa4abf85e5211bf613d43e","13255e63e0aa4abf85e5211bf613d43e",22853789,1,0,1,1240,317,317,0
"13255e63e0aa4abf85e5211bf613d43e","86c27d40179e419c8e9d150fb6afa5d0",22853789,1,3,0,1241,317,319,2
"86c27d40179e419c8e9d150fb6afa5d0","0c787d16c9504873b1a4d903cec09948",22853789,1,-6,0,1242,319,314,-5
"0c787d16c9504873b1a4d903cec09948","86c27d40179e419c8e9d150fb6afa5d0",22853789,2,6,0,1243,314,319,5
"86c27d40179e419c8e9d150fb6afa5d0","8d7e0b55cf9849cda222a0f2440cec55",22853789,1,-1,0,1244,319,318,-1
"8d7e0b55cf9849cda222a0f2440cec55","47edbb64109243e6b0f8f64cdef90c6c",22853789,1,9,0,1245,318,326,8
"47edbb64109243e6b0f8f64cdef90c6c","24f1363179ad4aaa965484a78471912b",22853789,2,-3,0,1246,326,323,-3
"24f1363179ad4aaa965484a78471912b","24f1363179ad4aaa965484a78471912b",22853789,1,0,1,1247,323,323,0
"24f1363179ad4aaa965484a78471912b","3628bdce1dd2429ba924d2d4d09448d2",22853789,1,-1,0,1248,323,322,-1
"3628bdce1dd2429ba924d2d4d09448d2","56b3fd1a212a4764be39d979fde3326e",22853789,1,7,0,1249,322,328,6
"56b3fd1a212a4764be39d979fde3326e","56b3fd1a212a4764be39d979fde3326e",22853789,1,0,1,1250,328,328,0
"56b3fd1a212a4764be39d979fde3326e","3434c10e561d488a914e0f7d71907abd",22853789,1,-28,0,1251,328,305,-23
"3434c10e561d488a914e0f7d71907abd","0c4079457ede49e3aeb5e86ed84bdf35",22853789,3,31,0,1252,305,329,24
"0c4079457ede49e3aeb5e86ed84bdf35","38aea304b4fa46e1b29bb72f5cea4c93",22853789,3,2,0,1253,329,331,2
"38aea304b4fa46e1b29bb72f5cea4c93","38aea304b4fa46e1b29bb72f5cea4c93",22853789,6,0,1,1254,331,331,0
"38aea304b4fa46e1b29bb72f5cea4c93","0c4079457ede49e3aeb5e86ed84bdf35",22853789,3,-2,0,1255,331,329,-2
"0c4079457ede49e3aeb5e86ed84bdf35","0c4079457ede49e3aeb5e86ed84bdf35",22853789,1,0,1,1256,329,329,0
"0c4079457ede49e3aeb5e86ed84bdf35","3434c10e561d488a914e0f7d71907abd",22853789,2,-31,0,1257,329,305,-24
"3434c10e561d488a914e0f7d71907abd","38aea304b4fa46e1b29bb72f5cea4c93",22853789,1,33,0,1260,305,331,26
"38aea304b4fa46e1b29bb72f5cea4c93","e36d261332f14e79bb4b467aceaeb9b5",22853789,1,2,0,1265,331,333,2
"e36d261332f14e79bb4b467aceaeb9b5","e36d261332f14e79bb4b467aceaeb9b5",22853789,1,0,1,1266,333,333,0
"e36d261332f14e79bb4b467aceaeb9b5","c7e89b9d04744d2eab742fc24e3ef1ae",22853789,1,1,0,1267,333,334,1
"c7e89b9d04744d2eab742fc24e3ef1ae","c7e89b9d04744d2eab742fc24e3ef1ae",22853789,2,0,1,1268,334,334,0
"c7e89b9d04744d2eab742fc24e3ef1ae","fe49f8054b374a0ea4bb266ed135ff62",22853789,1,1,0,1270,334,335,1
"fe49f8054b374a0ea4bb266ed135ff62","fe49f8054b374a0ea4bb266ed135ff62",22853789,2,0,1,1271,335,335,0
"fe49f8054b374a0ea4bb266ed135ff62","d0a8f74af98642fe8360d22c42e45117",22853789,1,1,0,1273,335,336,1
"d0a8f74af98642fe8360d22c42e45117","d0a8f74af98642fe8360d22c42e45117",22853789,2,0,1,1274,336,336,0
"d0a8f74af98642fe8360d22c42e45117","0c4079457ede49e3aeb5e86ed84bdf35",22853789,1,-7,0,1276,336,329,-7
"0c4079457ede49e3aeb5e86ed84bdf35","a7c6339ca1da4368a18d471f0519f877",22853789,1,11,0,1277,329,339,10
"a7c6339ca1da4368a18d471f0519f877","a7c6339ca1da4368a18d471f0519f877",22853789,1,0,1,1278,339,339,0
"a7c6339ca1da4368a18d471f0519f877","bbc5139ca9024389a94db3a6f47dcff6",22853789,1,3,0,1279,339,341,2
"bbc5139ca9024389a94db3a6f47dcff6","b8b9418ab322418d9db9b40d96af873a",22853789,1,-5,0,1280,341,337,-4
"b8b9418ab322418d9db9b40d96af873a","bbc5139ca9024389a94db3a6f47dcff6",22853789,2,5,0,1281,337,341,4
"bbc5139ca9024389a94db3a6f47dcff6","4ee6ca9019ab4a1ab323f98094a9bd77",22853789,1,2,0,1282,341,343,2
"4ee6ca9019ab4a1ab323f98094a9bd77","4ee6ca9019ab4a1ab323f98094a9bd77",22853789,2,0,1,1283,343,343,0
"4ee6ca9019ab4a1ab323f98094a9bd77","b37947176785476f8b29d49a851366dc",22853789,1,1,0,1285,343,344,1
"b37947176785476f8b29d49a851366dc","b37947176785476f8b29d49a851366dc",22853789,2,0,1,1286,344,344,0
"b37947176785476f8b29d49a851366dc","fcea5b10d5a14a3b9324ffece8f6e1e5",22853789,1,1,0,1288,344,345,1
"fcea5b10d5a14a3b9324ffece8f6e1e5","fcea5b10d5a14a3b9324ffece8f6e1e5",22853789,2,0,1,1289,345,345,0
"fcea5b10d5a14a3b9324ffece8f6e1e5","c2490bc612d146edbe786556fab3651b",22853789,1,-5,0,1291,345,340,-5
"c2490bc612d146edbe786556fab3651b","6ac8bb048b854999a47edb35fe627f11",22853789,1,8,0,1292,340,347,7
"6ac8bb048b854999a47edb35fe627f11","6ac8bb048b854999a47edb35fe627f11",22853789,1,0,1,1293,347,347,0
"6ac8bb048b854999a47edb35fe627f11","0c4079457ede49e3aeb5e86ed84bdf35",22853789,1,-21,0,1294,347,329,-18
"0c4079457ede49e3aeb5e86ed84bdf35","30ead9794d4847abaf222ca966cc8630",22853789,1,24,0,1295,329,348,19
"30ead9794d4847abaf222ca966cc8630","09b9678ddc3d452ea4a3d46e15826065",22853789,1,5,0,1296,348,353,5
"09b9678ddc3d452ea4a3d46e15826065","c20993c944444fe085345591a8bd837e",22853789,2,-2,0,1297,353,351,-2
"c20993c944444fe085345591a8bd837e","897b7f51242c44aab2205c72fdcbf4cd",22853789,1,1,0,1298,351,352,1
"897b7f51242c44aab2205c72fdcbf4cd","eff0de7f2dbb42dfa1a2e686efab5b6d",22853789,2,2,0,1299,352,354,2
"eff0de7f2dbb42dfa1a2e686efab5b6d","897b7f51242c44aab2205c72fdcbf4cd",22853789,2,-2,0,1300,354,352,-2
"897b7f51242c44aab2205c72fdcbf4cd","897b7f51242c44aab2205c72fdcbf4cd",22853789,2,0,1,1301,352,352,0
"897b7f51242c44aab2205c72fdcbf4cd","44421dd1e13a47a388c4a19834b744c7",22853789,1,8,0,1302,352,359,7
"44421dd1e13a47a388c4a19834b744c7","2fe14166dc9642c3bc666b86a57f943d",22853789,1,-2,0,1303,359,357,-2
"2fe14166dc9642c3bc666b86a57f943d","44421dd1e13a47a388c4a19834b744c7",22853789,1,2,0,1304,357,359,2
"44421dd1e13a47a388c4a19834b744c7","44421dd1e13a47a388c4a19834b744c7",22853789,1,0,1,1305,359,359,0
"44421dd1e13a47a388c4a19834b744c7","cb5fc7ef85d547c4be1a7439d0bf6052",22853789,1,1,0,1306,359,360,1
"cb5fc7ef85d547c4be1a7439d0bf6052","cb5fc7ef85d547c4be1a7439d0bf6052",22853789,2,0,1,1307,360,360,0
"cb5fc7ef85d547c4be1a7439d0bf6052","ab8fdad974ae471f9f24c3f9dd04462e",22853789,1,2,0,1309,360,362,2
"ab8fdad974ae471f9f24c3f9dd04462e","0a8f150a4cf747acbde62f4721823da3",22853789,2,-1,0,1310,362,361,-1
"0a8f150a4cf747acbde62f4721823da3","ab8fdad974ae471f9f24c3f9dd04462e",22853789,2,1,0,1311,361,362,1
"ab8fdad974ae471f9f24c3f9dd04462e","1ba8fef685d74a8194b9db252eb704fb",22853789,1,-7,0,1314,362,355,-7
"1ba8fef685d74a8194b9db252eb704fb","52580888dadb4fe3baa795683ea227bd",22853789,2,10,0,1315,355,364,9
"52580888dadb4fe3baa795683ea227bd","52580888dadb4fe3baa795683ea227bd",22853789,3,0,1,1316,364,364,0
"52580888dadb4fe3baa795683ea227bd","2fe14166dc9642c3bc666b86a57f943d",22853789,1,-8,0,1318,364,357,-7
"2fe14166dc9642c3bc666b86a57f943d","f00179e251a045b39c3f7a54f9aa4acc",22853789,1,7,0,1319,357,363,6
"f00179e251a045b39c3f7a54f9aa4acc","1ba8fef685d74a8194b9db252eb704fb",22853789,1,-9,0,1320,363,355,-8
"52580888dadb4fe3baa795683ea227bd","f00179e251a045b39c3f7a54f9aa4acc",22853789,1,-1,0,1323,364,363,-1
"f00179e251a045b39c3f7a54f9aa4acc","492a3bc6a1254f23a7998587961b22a4",22853789,1,4,0,1324,363,366,3
"492a3bc6a1254f23a7998587961b22a4","492a3bc6a1254f23a7998587961b22a4",22853789,1,0,1,1325,366,366,0
"492a3bc6a1254f23a7998587961b22a4","072a190fd302456290895f9f04d6940a",22853789,1,-1,0,1326,366,365,-1
"072a190fd302456290895f9f04d6940a","30ead9794d4847abaf222ca966cc8630",22853789,1,-20,0,1327,365,348,-17
"30ead9794d4847abaf222ca966cc8630","2fe14166dc9642c3bc666b86a57f943d",22853789,1,10,0,1328,348,357,9
"2fe14166dc9642c3bc666b86a57f943d","c76574d21bc14aeea7ecd0b027f39858",22853789,1,13,0,1329,357,367,10
"c76574d21bc14aeea7ecd0b027f39858","cfa457d1743848e4bb5e4beced6448ed",22853789,1,2,0,1330,367,369,2
"cfa457d1743848e4bb5e4beced6448ed","cfa457d1743848e4bb5e4beced6448ed",22853789,1,0,1,1331,369,369,0
"cfa457d1743848e4bb5e4beced6448ed","b71bac264efb4abd97015447bd490db6",22853789,1,3,0,1332,369,370,1
"b71bac264efb4abd97015447bd490db6","30ead9794d4847abaf222ca966cc8630",22853789,1,-28,0,1333,370,348,-22
"30ead9794d4847abaf222ca966cc8630","b71bac264efb4abd97015447bd490db6",22853789,1,28,0,1334,348,370,22
"b71bac264efb4abd97015447bd490db6","8d448d625b024c82a5eb240bbd7431d6",22853789,6,5,0,1335,370,374,4
"8d448d625b024c82a5eb240bbd7431d6","8d448d625b024c82a5eb240bbd7431d6",22853789,88,0,1,1336,374,374,0
"8d448d625b024c82a5eb240bbd7431d6","0d987bed3ffa4ed0b9a2e62e97b7b30f",22853789,1,-137,0,1345,374,272,-102
"0d987bed3ffa4ed0b9a2e62e97b7b30f","bb5a47f5ea01454a8b79455422d3b9da",22853789,1,10,0,1346,272,280,8
"bb5a47f5ea01454a8b79455422d3b9da","82ae07bc0c9b4570a41799290d1ef399",22853789,1,-6,0,1347,280,275,-5
"bb5a47f5ea01454a8b79455422d3b9da","8d448d625b024c82a5eb240bbd7431d6",22853789,1,127,0,1355,280,374,94
"8d448d625b024c82a5eb240bbd7431d6","b71bac264efb4abd97015447bd490db6",22853789,2,-5,0,1398,374,370,-4
"b71bac264efb4abd97015447bd490db6","d6d02b6ef04e4f17805504500b8ce441",22853789,5,8,0,1399,370,375,5
"d6d02b6ef04e4f17805504500b8ce441","d6d02b6ef04e4f17805504500b8ce441",22853789,37,0,1,1400,375,375,0
"d6d02b6ef04e4f17805504500b8ce441","66baf19b6b904b70922329068c63746d",22853789,4,4,0,1402,375,376,1
"66baf19b6b904b70922329068c63746d","7f544639412e40a9ba27f43b415362ab",22853789,3,2,0,1403,376,378,2
"7f544639412e40a9ba27f43b415362ab","7f544639412e40a9ba27f43b415362ab",22853789,2,0,1,1404,378,378,0
"7f544639412e40a9ba27f43b415362ab","d5ae8642e15b46b8bd298b02274d4e9c",22853789,1,2,0,1405,378,380,2
"d5ae8642e15b46b8bd298b02274d4e9c","d5ae8642e15b46b8bd298b02274d4e9c",22853789,1,0,1,1406,380,380,0
"d5ae8642e15b46b8bd298b02274d4e9c","a0d10309a2dd456289147f84be9d37f9",22853789,1,1,0,1407,380,381,1
"a0d10309a2dd456289147f84be9d37f9","a0d10309a2dd456289147f84be9d37f9",22853789,2,0,1,1408,381,381,0
"a0d10309a2dd456289147f84be9d37f9","0fcbc3ca07b144138b8d85da581f09a8",22853789,1,1,0,1410,381,382,1
"0fcbc3ca07b144138b8d85da581f09a8","0fcbc3ca07b144138b8d85da581f09a8",22853789,2,0,1,1411,382,382,0
"0fcbc3ca07b144138b8d85da581f09a8","66baf19b6b904b70922329068c63746d",22853789,1,-6,0,1413,382,376,-6
"66baf19b6b904b70922329068c63746d","4890121ce5d74576b4632b77cfc23398",22853789,1,14,0,1414,376,388,12
"4890121ce5d74576b4632b77cfc23398","c2fca3669923477ab966ded303dea31c",22853789,1,-6,0,1415,388,383,-5
"c2fca3669923477ab966ded303dea31c","4890121ce5d74576b4632b77cfc23398",22853789,1,6,0,1416,383,388,5
"4890121ce5d74576b4632b77cfc23398","96bb2b3e85a34d8b9544514e89f6fe97",22853789,1,3,0,1417,388,390,2
"96bb2b3e85a34d8b9544514e89f6fe97","18d3b836dd804224883cc9180b60a8e1",22853789,1,-4,0,1418,390,387,-3
"18d3b836dd804224883cc9180b60a8e1","96bb2b3e85a34d8b9544514e89f6fe97",22853789,1,4,0,1419,387,390,3
"96bb2b3e85a34d8b9544514e89f6fe97","0c7262dff33c4087bc660ccf40f92f9c",22853789,1,-296,0,1420,390,169,-221
"0c7262dff33c4087bc660ccf40f92f9c","1ba8fef685d74a8194b9db252eb704fb",22853789,1,247,0,1421,169,355,186
"1ba8fef685d74a8194b9db252eb704fb","30ead9794d4847abaf222ca966cc8630",22853789,1,-8,0,1422,355,348,-7
"30ead9794d4847abaf222ca966cc8630","ac4e9b54acfe4670b4634859c7263cb5",22853789,1,59,0,1423,348,392,44
"ac4e9b54acfe4670b4634859c7263cb5","ac4e9b54acfe4670b4634859c7263cb5",22853789,1,0,1,1424,392,392,0
"ac4e9b54acfe4670b4634859c7263cb5","17f95d18bab743888e1736033dc3384d",22853789,1,-3,0,1425,392,389,-3
"17f95d18bab743888e1736033dc3384d","6f8881a745ac4c358a68b92c3b4abe81",22853789,1,6,0,1426,389,394,5
"6f8881a745ac4c358a68b92c3b4abe81","6f8881a745ac4c358a68b92c3b4abe81",22853789,2,0,1,1427,394,394,0
"6f8881a745ac4c358a68b92c3b4abe81","f7002c8484354eceac57bc7bd62c76c1",22853789,1,-1,0,1429,394,393,-1
"f7002c8484354eceac57bc7bd62c76c1","44a277ea44dc4ae689fab4b82f0b4098",22853789,1,5,0,1430,393,397,4
"44a277ea44dc4ae689fab4b82f0b4098","44a277ea44dc4ae689fab4b82f0b4098",22853789,1,0,1,1431,397,397,0
"44a277ea44dc4ae689fab4b82f0b4098","0c12af0a4e7f4002852cf84b2537c161",22853789,1,-2,0,1432,397,395,-2
"0c12af0a4e7f4002852cf84b2537c161","859e0b8d71694b12befb69ee698138f9",22853789,1,5,0,1433,395,399,4
"859e0b8d71694b12befb69ee698138f9","66baf19b6b904b70922329068c63746d",22853789,1,-29,0,1434,399,376,-23
"66baf19b6b904b70922329068c63746d","2b09a08242b54983aec7063990fb3f66",22853789,3,32,0,1435,376,400,24
"2b09a08242b54983aec7063990fb3f66","2b09a08242b54983aec7063990fb3f66",22853789,16,0,1,1436,400,400,0
"2b09a08242b54983aec7063990fb3f66","1f471b7a883a4df48211e8c6a81b59a7",22853789,1,1,0,1440,400,401,1
"1f471b7a883a4df48211e8c6a81b59a7","1f471b7a883a4df48211e8c6a81b59a7",22853789,1,0,1,1441,401,401,0
"1f471b7a883a4df48211e8c6a81b59a7","2b09a08242b54983aec7063990fb3f66",22853789,1,-1,0,1442,401,400,-1
"2b09a08242b54983aec7063990fb3f66","66baf19b6b904b70922329068c63746d",22853789,1,-32,0,1444,400,376,-24
"2b09a08242b54983aec7063990fb3f66","1157bd665ec4472fb58b751dc5099355",22853789,2,4,0,1446,400,403,3
"1157bd665ec4472fb58b751dc5099355","3c8a22d2f9c146ea956609e3ed4f2559",22853789,1,3,0,1447,403,405,2
"3c8a22d2f9c146ea956609e3ed4f2559","1157bd665ec4472fb58b751dc5099355",22853789,1,-3,0,1448,405,403,-2
"1157bd665ec4472fb58b751dc5099355","2b09a08242b54983aec7063990fb3f66",22853789,1,-4,0,1449,403,400,-3
"1157bd665ec4472fb58b751dc5099355","58fc9094275e4c49be3f4ba6d4acc0a4",22853789,1,5,0,1452,403,406,3
"58fc9094275e4c49be3f4ba6d4acc0a4","3c8a22d2f9c146ea956609e3ed4f2559",22853789,1,-2,0,1453,406,405,-1
"3c8a22d2f9c146ea956609e3ed4f2559","58fc9094275e4c49be3f4ba6d4acc0a4",22853789,1,2,0,1454,405,406,1
"58fc9094275e4c49be3f4ba6d4acc0a4","c1c1be90b2b14c1ab4a5e1ee3c241902",22853789,1,1,0,1455,406,407,1
"c1c1be90b2b14c1ab4a5e1ee3c241902","c1c1be90b2b14c1ab4a5e1ee3c241902",22853789,5,0,1,1456,407,407,0
"c1c1be90b2b14c1ab4a5e1ee3c241902","58fc9094275e4c49be3f4ba6d4acc0a4",22853789,1,-1,0,1461,407,406,-1
"58fc9094275e4c49be3f4ba6d4acc0a4","02b3a1bead9244c1ba2f857c7da8f82a",22853789,1,3,0,1462,406,408,2
"02b3a1bead9244c1ba2f857c7da8f82a","02b3a1bead9244c1ba2f857c7da8f82a",22853789,2,0,1,1463,408,408,0
"02b3a1bead9244c1ba2f857c7da8f82a","6206fc6479014bb193084c32409dc1b9",22853789,1,1,0,1464,408,409,1
"6206fc6479014bb193084c32409dc1b9","6206fc6479014bb193084c32409dc1b9",22853789,1,0,1,1465,409,409,0
"6206fc6479014bb193084c32409dc1b9","02b3a1bead9244c1ba2f857c7da8f82a",22853789,1,-1,0,1466,409,408,-1
"02b3a1bead9244c1ba2f857c7da8f82a","6a5f020451db426dacba9e2ea3fcc62a",22853789,2,3,0,1467,408,410,2
"6a5f020451db426dacba9e2ea3fcc62a","6a5f020451db426dacba9e2ea3fcc62a",22853789,2,0,1,1468,410,410,0
"6a5f020451db426dacba9e2ea3fcc62a","33a9d248b2e44588a5b07fc1342b9bc2",22853789,3,2,0,1470,410,411,1
"33a9d248b2e44588a5b07fc1342b9bc2","33a9d248b2e44588a5b07fc1342b9bc2",22853789,1,0,1,1471,411,411,0
"33a9d248b2e44588a5b07fc1342b9bc2","c6f26bd420634f1cb7989e76fe6b16c0",22853789,1,1,0,1472,411,412,1
"c6f26bd420634f1cb7989e76fe6b16c0","c6f26bd420634f1cb7989e76fe6b16c0",22853789,5,0,1,1473,412,412,0
"c6f26bd420634f1cb7989e76fe6b16c0","2a65ee6e2ac64f6a8a55fbe5373ec763",22853789,1,1,0,1478,412,413,1
"2a65ee6e2ac64f6a8a55fbe5373ec763","2a65ee6e2ac64f6a8a55fbe5373ec763",22853789,2,0,1,1479,413,413,0
"2a65ee6e2ac64f6a8a55fbe5373ec763","33a9d248b2e44588a5b07fc1342b9bc2",22853789,1,-2,0,1481,413,411,-2
"33a9d248b2e44588a5b07fc1342b9bc2","1fd0f6dadbc14ebc965faf6122190b96",22853789,1,5,0,1482,411,415,4
"1fd0f6dadbc14ebc965faf6122190b96","1fd0f6dadbc14ebc965faf6122190b96",22853789,1,0,1,1483,415,415,0
"1fd0f6dadbc14ebc965faf6122190b96","687055dad9fc40c3982478fe33ec01bf",22853789,1,-1,0,1484,415,414,-1
"687055dad9fc40c3982478fe33ec01bf","2add1669f08d4101913db15f8c23b3b7",22853789,1,3,0,1485,414,416,2
"2add1669f08d4101913db15f8c23b3b7","2add1669f08d4101913db15f8c23b3b7",22853789,1,0,1,1486,416,416,0
"2add1669f08d4101913db15f8c23b3b7","a2b4bd40cee2481ebd3fc179d6a5cd62",22853789,1,3,0,1487,416,417,1
"a2b4bd40cee2481ebd3fc179d6a5cd62","2b09a08242b54983aec7063990fb3f66",22853789,1,-27,0,1488,417,400,-17
"2b09a08242b54983aec7063990fb3f66","a2b4bd40cee2481ebd3fc179d6a5cd62",22853789,2,27,0,1489,400,417,17
"a2b4bd40cee2481ebd3fc179d6a5cd62","e34e59dce2204f228f3a84b6725df60f",22853789,1,2,0,1490,417,419,2
"e34e59dce2204f228f3a84b6725df60f","e34e59dce2204f228f3a84b6725df60f",22853789,1,0,1,1491,419,419,0
"e34e59dce2204f228f3a84b6725df60f","a2b4bd40cee2481ebd3fc179d6a5cd62",22853789,1,-2,0,1492,419,417,-2
"a2b4bd40cee2481ebd3fc179d6a5cd62","bec48fc2e1294c7eb3d0aca780d731b8",22853789,2,4,0,1493,417,420,3
"bec48fc2e1294c7eb3d0aca780d731b8","bec48fc2e1294c7eb3d0aca780d731b8",22853789,3,0,1,1494,420,420,0
"bec48fc2e1294c7eb3d0aca780d731b8","a24600b0e49245f6bdba8c893cfeddb0",22853789,1,7,0,1496,420,425,5
"a24600b0e49245f6bdba8c893cfeddb0","dbde19fcce2a4c1abdc7f685c293a23f",22853789,1,-4,0,1497,425,422,-3
"dbde19fcce2a4c1abdc7f685c293a23f","a24600b0e49245f6bdba8c893cfeddb0",22853789,2,4,0,1498,422,425,3
"a24600b0e49245f6bdba8c893cfeddb0","a24600b0e49245f6bdba8c893cfeddb0",22853789,3,0,1,1499,425,425,0
"a24600b0e49245f6bdba8c893cfeddb0","a2b4bd40cee2481ebd3fc179d6a5cd62",22853789,2,-11,0,1500,425,417,-8
"a2b4bd40cee2481ebd3fc179d6a5cd62","24cf8786024543f19b89bc20034e60d7",22853789,2,18,0,1501,417,428,11
"24cf8786024543f19b89bc20034e60d7","f2a73be2f46840b182d7bd095378004e",22853789,3,1,0,1502,428,429,1
"f2a73be2f46840b182d7bd095378004e","f2a73be2f46840b182d7bd095378004e",22853789,2,0,1,1503,429,429,0
"f2a73be2f46840b182d7bd095378004e","604551fd4266430cb860fef58fa7dd61",22853789,1,1,0,1504,429,430,1
"604551fd4266430cb860fef58fa7dd61","604551fd4266430cb860fef58fa7dd61",22853789,1,0,1,1505,430,430,0
"604551fd4266430cb860fef58fa7dd61","dce46f8904594a62a6377a3587aaa663",22853789,1,2,0,1506,430,431,1
"dce46f8904594a62a6377a3587aaa663","24cf8786024543f19b89bc20034e60d7",22853789,2,-4,0,1507,431,428,-3
"24cf8786024543f19b89bc20034e60d7","dce46f8904594a62a6377a3587aaa663",22853789,4,4,0,1508,428,431,3
"dce46f8904594a62a6377a3587aaa663","9b9d0a249052413c869753b99682b0ac",22853789,1,1,0,1509,431,432,1
"9b9d0a249052413c869753b99682b0ac","9b9d0a249052413c869753b99682b0ac",22853789,1,0,1,1510,432,432,0
"9b9d0a249052413c869753b99682b0ac","061c175cc90f45fbad883025394e78dd",22853789,1,1,0,1511,432,433,1
"061c175cc90f45fbad883025394e78dd","061c175cc90f45fbad883025394e78dd",22853789,1,0,1,1512,433,433,0
"061c175cc90f45fbad883025394e78dd","dce46f8904594a62a6377a3587aaa663",22853789,1,-2,0,1513,433,431,-2
"dce46f8904594a62a6377a3587aaa663","74a7f8712e5449c2bc0b43c6f90dafed",22853789,1,5,0,1514,431,435,4
"74a7f8712e5449c2bc0b43c6f90dafed","74a7f8712e5449c2bc0b43c6f90dafed",22853789,1,0,1,1515,435,435,0
"74a7f8712e5449c2bc0b43c6f90dafed","66ada10dde9f43018588f1ced9d477fc",22853789,1,-1,0,1516,435,434,-1
"66ada10dde9f43018588f1ced9d477fc","6e83e23f56544a19b94067c1c558d9c0",22853789,1,-261,0,1517,434,247,-187
"6e83e23f56544a19b94067c1c558d9c0","2ae94c0cea4d480a9d5dca8fb1d7b542",22853789,1,-6,0,1518,247,242,-5
"2ae94c0cea4d480a9d5dca8fb1d7b542","30c9ba177afc49a695625d2bdec40207",22853789,1,9,0,1519,242,250,8
"30c9ba177afc49a695625d2bdec40207","30c9ba177afc49a695625d2bdec40207",22853789,2,0,1,1520,250,250,0
"30c9ba177afc49a695625d2bdec40207","00f61990949545828dd12f1303d47504",22853789,1,8,0,1522,250,256,6
"6e83e23f56544a19b94067c1c558d9c0","0c7262dff33c4087bc660ccf40f92f9c",22853789,1,-103,0,1524,247,169,-78
"0c7262dff33c4087bc660ccf40f92f9c","4a29443515bb404cb8924e1c60a63b73",22853789,1,157,0,1525,169,285,116
"4a29443515bb404cb8924e1c60a63b73","34a6e49023fc4465bd5ca604330bbd1c",22853789,1,9,0,1526,285,292,7
"34a6e49023fc4465bd5ca604330bbd1c","869e967078f04da18dd0b0b9389a7424",22853789,1,1,0,1527,292,293,1
"869e967078f04da18dd0b0b9389a7424","34a6e49023fc4465bd5ca604330bbd1c",22853789,1,-1,0,1529,293,292,-1
"34a6e49023fc4465bd5ca604330bbd1c","4a29443515bb404cb8924e1c60a63b73",22853789,1,-9,0,1530,292,285,-7
"4a29443515bb404cb8924e1c60a63b73","0c4079457ede49e3aeb5e86ed84bdf35",22853789,1,58,0,1531,285,329,44
"0c4079457ede49e3aeb5e86ed84bdf35","b8b9418ab322418d9db9b40d96af873a",22853789,1,9,0,1535,329,337,8
"bbc5139ca9024389a94db3a6f47dcff6","bbc5139ca9024389a94db3a6f47dcff6",22853789,1,0,1,1537,341,341,0
"bbc5139ca9024389a94db3a6f47dcff6","c2490bc612d146edbe786556fab3651b",22853789,1,-1,0,1538,341,340,-1
"c2490bc612d146edbe786556fab3651b","30ead9794d4847abaf222ca966cc8630",22853789,1,11,0,1539,340,348,8
"30ead9794d4847abaf222ca966cc8630","0c4079457ede49e3aeb5e86ed84bdf35",22853789,1,-24,0,1540,348,329,-19
"0c4079457ede49e3aeb5e86ed84bdf35","897b7f51242c44aab2205c72fdcbf4cd",22853789,1,28,0,1541,329,352,23
"897b7f51242c44aab2205c72fdcbf4cd","09b9678ddc3d452ea4a3d46e15826065",22853789,1,1,0,1545,352,353,1
"c20993c944444fe085345591a8bd837e","09b9678ddc3d452ea4a3d46e15826065",22853789,1,2,0,1547,351,353,2
"09b9678ddc3d452ea4a3d46e15826065","09b9678ddc3d452ea4a3d46e15826065",22853789,3,0,1,1548,353,353,0
"09b9678ddc3d452ea4a3d46e15826065","eff0de7f2dbb42dfa1a2e686efab5b6d",22853789,1,1,0,1551,353,354,1
"eff0de7f2dbb42dfa1a2e686efab5b6d","eff0de7f2dbb42dfa1a2e686efab5b6d",22853789,3,0,1,1552,354,354,0
"eff0de7f2dbb42dfa1a2e686efab5b6d","2fe14166dc9642c3bc666b86a57f943d",22853789,1,4,0,1555,354,357,3
"2fe14166dc9642c3bc666b86a57f943d","30ead9794d4847abaf222ca966cc8630",22853789,1,-10,0,1556,357,348,-9
"30ead9794d4847abaf222ca966cc8630","4a29443515bb404cb8924e1c60a63b73",22853789,1,-82,0,1557,348,285,-63
"4a29443515bb404cb8924e1c60a63b73","1b4550d0dab04078b3bf08a655345bdc",22853789,2,114,0,1558,285,373,88
"1b4550d0dab04078b3bf08a655345bdc","b71bac264efb4abd97015447bd490db6",22853789,3,-4,0,1559,373,370,-3
"8d448d625b024c82a5eb240bbd7431d6","d6d02b6ef04e4f17805504500b8ce441",22853789,3,3,0,1568,374,375,1
"d6d02b6ef04e4f17805504500b8ce441","b71bac264efb4abd97015447bd490db6",22853789,4,-8,0,1569,375,370,-5
"d6d02b6ef04e4f17805504500b8ce441","4a29443515bb404cb8924e1c60a63b73",22853789,3,-118,0,1571,375,285,-90
"7f544639412e40a9ba27f43b415362ab","1b4550d0dab04078b3bf08a655345bdc",22853789,1,-10,0,1590,378,373,-5
"8d448d625b024c82a5eb240bbd7431d6","c33c17be71ae4d588da7369472e5bb1b",22853789,1,-457,0,1600,374,34,-340
"c33c17be71ae4d588da7369472e5bb1b","c33c17be71ae4d588da7369472e5bb1b",22853789,3,0,1,1601,34,34,0
"c33c17be71ae4d588da7369472e5bb1b","b613861cecf84ffcab01afb23f660475",22853789,1,-56,0,1602,34,1,-33
"56586aa865414f538729c7f7735d2bc6","56586aa865414f538729c7f7735d2bc6",22853789,4,0,1,1609,12,12,0
"5c5ceeee4562457ba6d41515aeebfbb1","81c864a886d54a6b8ff85f7d736f4f95",22853789,1,-4,0,1614,17,15,-2
"81c864a886d54a6b8ff85f7d736f4f95","9afd71a5298d4333b6849dfce1b9422c",22853789,1,7,0,1615,15,18,3
"56586aa865414f538729c7f7735d2bc6","b7719e26494940efa49512aedd0aac79",22853789,1,17,0,1617,12,20,8
"b7719e26494940efa49512aedd0aac79","9afd71a5298d4333b6849dfce1b9422c",22853789,1,-4,0,1618,20,18,-2
"9afd71a5298d4333b6849dfce1b9422c","d4f45188d3c84a02ba08454e6403a818",22853789,1,9,0,1619,18,24,6
"b7719e26494940efa49512aedd0aac79","d6d02b6ef04e4f17805504500b8ce441",22853789,1,484,0,1622,20,375,355
"66baf19b6b904b70922329068c63746d","b71bac264efb4abd97015447bd490db6",22853789,1,-12,0,1626,376,370,-6
"7f544639412e40a9ba27f43b415362ab","66baf19b6b904b70922329068c63746d",22853789,1,-2,0,1645,378,376,-2
"66baf19b6b904b70922329068c63746d","66baf19b6b904b70922329068c63746d",22853789,1,0,1,1646,376,376,0
"2b09a08242b54983aec7063990fb3f66","d6d02b6ef04e4f17805504500b8ce441",22853789,1,-36,0,1658,400,375,-25
"4a29443515bb404cb8924e1c60a63b73","d6d02b6ef04e4f17805504500b8ce441",22853789,1,118,0,1675,285,375,90
"4a29443515bb404cb8924e1c60a63b73","2c5bb2cbd0014420ad8c95d40e38efd1",22853789,1,23,0,1680,285,303,18
"2c5bb2cbd0014420ad8c95d40e38efd1","4a29443515bb404cb8924e1c60a63b73",22853789,1,-23,0,1681,303,285,-18
"3434c10e561d488a914e0f7d71907abd","4a29443515bb404cb8924e1c60a63b73",22853789,1,-27,0,1683,305,285,-20
"4a29443515bb404cb8924e1c60a63b73","53e7e900392747ccad52e711ab0f80d8",22853789,1,29,0,1684,285,307,22
"130acc2aeb0448fdbb2de63bc5cebe5b","141c0df6cd1946539aadd1c9b7068cd4",22853789,1,-1,0,1687,309,308,-1
"141c0df6cd1946539aadd1c9b7068cd4","0c787d16c9504873b1a4d903cec09948",22853789,1,7,0,1688,308,314,6
"86c27d40179e419c8e9d150fb6afa5d0","47edbb64109243e6b0f8f64cdef90c6c",22853789,1,8,0,1690,319,326,7
"24f1363179ad4aaa965484a78471912b","8d7e0b55cf9849cda222a0f2440cec55",22853789,1,-6,0,1692,323,318,-5
"8d7e0b55cf9849cda222a0f2440cec55","3628bdce1dd2429ba924d2d4d09448d2",22853789,1,5,0,1693,318,322,4
"3628bdce1dd2429ba924d2d4d09448d2","3434c10e561d488a914e0f7d71907abd",22853789,1,-21,0,1694,322,305,-17
"0c4079457ede49e3aeb5e86ed84bdf35","9de0d567bfa84fe5b77cb76f4a76a5d1",22853789,1,101,0,1698,329,404,75
"9de0d567bfa84fe5b77cb76f4a76a5d1","9de0d567bfa84fe5b77cb76f4a76a5d1",22853789,1,0,1,1699,404,404,0
"9de0d567bfa84fe5b77cb76f4a76a5d1","1157bd665ec4472fb58b751dc5099355",22853789,1,-1,0,1700,404,403,-1
"1157bd665ec4472fb58b751dc5099355","02b3a1bead9244c1ba2f857c7da8f82a",22853789,1,8,0,1701,403,408,5
"02b3a1bead9244c1ba2f857c7da8f82a","3c8a22d2f9c146ea956609e3ed4f2559",22853789,1,-5,0,1702,408,405,-3
"3c8a22d2f9c146ea956609e3ed4f2559","02b3a1bead9244c1ba2f857c7da8f82a",22853789,1,5,0,1703,405,408,3
"33a9d248b2e44588a5b07fc1342b9bc2","6a5f020451db426dacba9e2ea3fcc62a",22853789,1,-2,0,1707,411,410,-1
"33a9d248b2e44588a5b07fc1342b9bc2","687055dad9fc40c3982478fe33ec01bf",22853789,1,4,0,1709,411,414,3
"687055dad9fc40c3982478fe33ec01bf","2b09a08242b54983aec7063990fb3f66",22853789,1,-21,0,1710,414,400,-14
"a2b4bd40cee2481ebd3fc179d6a5cd62","a2b4bd40cee2481ebd3fc179d6a5cd62",22853789,1,0,1,1712,417,417,0
"bec48fc2e1294c7eb3d0aca780d731b8","dbde19fcce2a4c1abdc7f685c293a23f",22853789,1,3,0,1715,420,422,2
"f2a73be2f46840b182d7bd095378004e","dce46f8904594a62a6377a3587aaa663",22853789,2,3,0,1723,429,431,2
"dce46f8904594a62a6377a3587aaa663","f2a73be2f46840b182d7bd095378004e",22853789,2,-3,0,1727,431,429,-2
"f2a73be2f46840b182d7bd095378004e","24cf8786024543f19b89bc20034e60d7",22853789,2,-1,0,1728,429,428,-1
"dce46f8904594a62a6377a3587aaa663","dce46f8904594a62a6377a3587aaa663",22853789,3,0,1,1730,431,431,0
"dce46f8904594a62a6377a3587aaa663","bf12c96466d840a69bed7020b3f18bb8",22853789,1,7,0,1731,431,436,5
"bf12c96466d840a69bed7020b3f18bb8","f2a73be2f46840b182d7bd095378004e",22853789,1,-10,0,1732,436,429,-7
"f2a73be2f46840b182d7bd095378004e","66ada10dde9f43018588f1ced9d477fc",22853789,1,7,0,1733,429,434,5
"66ada10dde9f43018588f1ced9d477fc","24cf8786024543f19b89bc20034e60d7",22853789,1,-8,0,1734,434,428,-6
"dce46f8904594a62a6377a3587aaa663","66ada10dde9f43018588f1ced9d477fc",22853789,1,4,0,1741,431,434,3
"66ada10dde9f43018588f1ced9d477fc","bf12c96466d840a69bed7020b3f18bb8",22853789,2,3,0,1742,434,436,2
"bf12c96466d840a69bed7020b3f18bb8","66ada10dde9f43018588f1ced9d477fc",22853789,1,-3,0,1743,436,434,-2
"bf12c96466d840a69bed7020b3f18bb8","bf12c96466d840a69bed7020b3f18bb8",22853789,1,0,1,1745,436,436,0
"bf12c96466d840a69bed7020b3f18bb8","24cf8786024543f19b89bc20034e60d7",22853789,1,-11,0,1746,436,428,-8
"24cf8786024543f19b89bc20034e60d7","070600601c4c439288445d2f0724807d",22853789,1,14,0,1747,428,437,9
"070600601c4c439288445d2f0724807d","1823b6de7d334a7aaabc4570719af4d9",22853789,2,2,0,1748,437,439,2
"1823b6de7d334a7aaabc4570719af4d9","1823b6de7d334a7aaabc4570719af4d9",22853789,12,0,1,1749,439,439,0
"1823b6de7d334a7aaabc4570719af4d9","0380cd76a7d44bc3a4da1f15e4d68f89",22853789,3,2,0,1761,439,440,1
"0380cd76a7d44bc3a4da1f15e4d68f89","070600601c4c439288445d2f0724807d",22853789,3,-4,0,1762,440,437,-3
"070600601c4c439288445d2f0724807d","0380cd76a7d44bc3a4da1f15e4d68f89",22853789,2,4,0,1763,437,440,3
"0380cd76a7d44bc3a4da1f15e4d68f89","1823b6de7d334a7aaabc4570719af4d9",22853789,1,-2,0,1764,440,439,-1
"0380cd76a7d44bc3a4da1f15e4d68f89","0380cd76a7d44bc3a4da1f15e4d68f89",22853789,2,0,1,1771,440,440,0
"0380cd76a7d44bc3a4da1f15e4d68f89","23b7673c8b5443108c2ef09382834a86",22853789,1,2,0,1773,440,441,1
"23b7673c8b5443108c2ef09382834a86","23b7673c8b5443108c2ef09382834a86",22853789,1,0,1,1774,441,441,0
"23b7673c8b5443108c2ef09382834a86","901e92500aea43c79f19f1b279050668",22853789,4,2,0,1775,441,442,1
"901e92500aea43c79f19f1b279050668","23b7673c8b5443108c2ef09382834a86",22853789,3,-2,0,1776,442,441,-1
"901e92500aea43c79f19f1b279050668","001339db8ced4cf78829ebe8b145449d",22853789,1,1,0,1782,442,443,1
"001339db8ced4cf78829ebe8b145449d","001339db8ced4cf78829ebe8b145449d",22853789,2,0,1,1783,443,443,0
"001339db8ced4cf78829ebe8b145449d","452745e0366e42ae81561bfddebcc6c3",22853789,1,1,0,1785,443,444,1
"452745e0366e42ae81561bfddebcc6c3","452745e0366e42ae81561bfddebcc6c3",22853789,2,0,1,1786,444,444,0
"452745e0366e42ae81561bfddebcc6c3","901e92500aea43c79f19f1b279050668",22853789,1,-2,0,1788,444,442,-2
"901e92500aea43c79f19f1b279050668","4660ff2089114e8db82ceb26a4f329e3",22853789,1,4,0,1789,442,445,3
"4660ff2089114e8db82ceb26a4f329e3","4660ff2089114e8db82ceb26a4f329e3",22853789,2,0,1,1790,445,445,0
"4660ff2089114e8db82ceb26a4f329e3","7bd5586eb9d8484eb74a433ee7bfe499",22853789,1,2,0,1792,445,446,1
"7bd5586eb9d8484eb74a433ee7bfe499","7bd5586eb9d8484eb74a433ee7bfe499",22853789,9,0,1,1793,446,446,0
"7bd5586eb9d8484eb74a433ee7bfe499","8a7f26e690f34dda97be16904518ca99",22853789,1,2,0,1802,446,447,1
"8a7f26e690f34dda97be16904518ca99","8a7f26e690f34dda97be16904518ca99",22853789,1,0,1,1803,447,447,0
"8a7f26e690f34dda97be16904518ca99","b2f0d654738f48158edff28e8d3a546e",22853789,1,5,0,1804,447,449,2
"b2f0d654738f48158edff28e8d3a546e","070600601c4c439288445d2f0724807d",22853789,1,-21,0,1805,449,437,-12
"070600601c4c439288445d2f0724807d","f60ee41ec635499abd48168342d32c2f",22853789,1,26,0,1806,437,453,16
"f60ee41ec635499abd48168342d32c2f","f60ee41ec635499abd48168342d32c2f",22853789,67,0,1,1807,453,453,0
"f60ee41ec635499abd48168342d32c2f","b2f0d654738f48158edff28e8d3a546e",22853789,2,-5,0,1808,453,449,-4
"b2f0d654738f48158edff28e8d3a546e","f60ee41ec635499abd48168342d32c2f",22853789,3,5,0,1809,449,453,4
"f60ee41ec635499abd48168342d32c2f","f67fbf45a5f146ed866965bc57c7c001",22853789,1,3,0,1860,453,454,1
"f67fbf45a5f146ed866965bc57c7c001","f67fbf45a5f146ed866965bc57c7c001",22853789,3,0,1,1861,454,454,0
"f67fbf45a5f146ed866965bc57c7c001","e20db35ced8544ddac5bc3839145e463",22853789,1,-501,0,1864,454,91,-363
"e20db35ced8544ddac5bc3839145e463","e20db35ced8544ddac5bc3839145e463",22853789,4,0,1,1865,91,91,0
"e20db35ced8544ddac5bc3839145e463","d937afe49bd24a07a550dda1c1155122",22853789,1,502,0,1866,91,455,364
"d937afe49bd24a07a550dda1c1155122","d937afe49bd24a07a550dda1c1155122",22853789,1,0,1,1867,455,455,0
"d937afe49bd24a07a550dda1c1155122","3628b3f7823443d0912a339096b69943",22853789,1,1,0,1868,455,456,1
"3628b3f7823443d0912a339096b69943","3628b3f7823443d0912a339096b69943",22853789,1,0,1,1869,456,456,0
"3628b3f7823443d0912a339096b69943","9e049ee647cf43ecbcb5ed792a8e7588",22853789,1,1,0,1870,456,457,1
"9e049ee647cf43ecbcb5ed792a8e7588","9e049ee647cf43ecbcb5ed792a8e7588",22853789,1,0,1,1871,457,457,0
"9e049ee647cf43ecbcb5ed792a8e7588","5256a214faaf410b93f76cea06428334",22853789,1,1,0,1872,457,458,1
"5256a214faaf410b93f76cea06428334","5256a214faaf410b93f76cea06428334",22853789,1,0,1,1873,458,458,0
"5256a214faaf410b93f76cea06428334","25c32b120fce40fa9b6c85133aeb4716",22853789,1,1,0,1874,458,459,1
"25c32b120fce40fa9b6c85133aeb4716","25c32b120fce40fa9b6c85133aeb4716",22853789,1,0,1,1875,459,459,0
"25c32b120fce40fa9b6c85133aeb4716","11bc14f2204949008b7d511b933363c1",22853789,1,1,0,1876,459,460,1
"11bc14f2204949008b7d511b933363c1","11bc14f2204949008b7d511b933363c1",22853789,1,0,1,1877,460,460,0
"11bc14f2204949008b7d511b933363c1","42de338840a34d15adb66e7b14fb9d2c",22853789,1,1,0,1878,460,461,1
"42de338840a34d15adb66e7b14fb9d2c","42de338840a34d15adb66e7b14fb9d2c",22853789,1,0,1,1879,461,461,0
"42de338840a34d15adb66e7b14fb9d2c","9da37c6210b1416b8079c274f70bf600",22853789,1,1,0,1880,461,462,1
"9da37c6210b1416b8079c274f70bf600","9da37c6210b1416b8079c274f70bf600",22853789,1,0,1,1881,462,462,0
"9da37c6210b1416b8079c274f70bf600","519119f1deac45ff9ab4f13529be5c6e",22853789,1,1,0,1882,462,463,1
"519119f1deac45ff9ab4f13529be5c6e","519119f1deac45ff9ab4f13529be5c6e",22853789,1,0,1,1883,463,463,0
"519119f1deac45ff9ab4f13529be5c6e","c5df9f40ec14463b9dcfdc73df3e9285",22853789,1,3,0,1884,463,464,1
"c5df9f40ec14463b9dcfdc73df3e9285","f67fbf45a5f146ed866965bc57c7c001",22853789,2,-12,0,1885,464,454,-10
"f67fbf45a5f146ed866965bc57c7c001","c5df9f40ec14463b9dcfdc73df3e9285",22853789,3,12,0,1886,454,464,10
"c5df9f40ec14463b9dcfdc73df3e9285","83d42d95cd844fc093fc09cee250edb8",22853789,6,3,0,1887,464,465,1
"83d42d95cd844fc093fc09cee250edb8","c5df9f40ec14463b9dcfdc73df3e9285",22853789,4,-3,0,1888,465,464,-1
"83d42d95cd844fc093fc09cee250edb8","83d42d95cd844fc093fc09cee250edb8",22853789,5,0,1,1890,465,465,0
"c5df9f40ec14463b9dcfdc73df3e9285","c5df9f40ec14463b9dcfdc73df3e9285",22853789,2,0,1,1896,464,464,0
"83d42d95cd844fc093fc09cee250edb8","d6d02b6ef04e4f17805504500b8ce441",22853789,2,-139,0,1901,465,375,-90
"d6d02b6ef04e4f17805504500b8ce441","b2f0d654738f48158edff28e8d3a546e",22853789,2,116,0,1909,375,449,74
"b2f0d654738f48158edff28e8d3a546e","f67fbf45a5f146ed866965bc57c7c001",22853789,1,8,0,1921,449,454,5
"d6d02b6ef04e4f17805504500b8ce441","3cbcea2be0984e7dbd5a48195af10ce7",22853789,1,-284,0,1934,375,165,-210
"3cbcea2be0984e7dbd5a48195af10ce7","82e6285962b8400d9d6fc32436022a94",22853789,4,2,0,1935,165,167,2
"82e6285962b8400d9d6fc32436022a94","d6d02b6ef04e4f17805504500b8ce441",22853789,1,282,0,1936,167,375,208
"f60ee41ec635499abd48168342d32c2f","d6d02b6ef04e4f17805504500b8ce441",22853789,1,-121,0,1951,453,375,-78
"b7719e26494940efa49512aedd0aac79","b613861cecf84ffcab01afb23f660475",22854375,1,-32,0,1,20,1,-19
"e2911e79efc2420eac45d9f671463d4b","b613861cecf84ffcab01afb23f660475",22854375,3,-3,0,10,2,1,-1
"b613861cecf84ffcab01afb23f660475","e2911e79efc2420eac45d9f671463d4b",22854375,4,3,0,11,1,2,1
"e2911e79efc2420eac45d9f671463d4b","e2911e79efc2420eac45d9f671463d4b",22854375,3,0,1,12,2,2,0
"56586aa865414f538729c7f7735d2bc6","b613861cecf84ffcab01afb23f660475",22854375,1,-15,0,16,12,1,-11
"b613861cecf84ffcab01afb23f660475","b613861cecf84ffcab01afb23f660475",22854375,8,0,1,17,1,1,0
"e2911e79efc2420eac45d9f671463d4b","531db53f81f646edb0cdcfe0085b03b7",22854375,1,2,0,22,2,4,2
"531db53f81f646edb0cdcfe0085b03b7","531db53f81f646edb0cdcfe0085b03b7",22854375,1,0,1,23,4,4,0
"531db53f81f646edb0cdcfe0085b03b7","6d541c89590949f99af293c4f2333f67",22854375,1,2,0,24,4,6,2
"6d541c89590949f99af293c4f2333f67","6d541c89590949f99af293c4f2333f67",22854375,2,0,1,25,6,6,0
"6d541c89590949f99af293c4f2333f67","e2911e79efc2420eac45d9f671463d4b",22854375,2,-4,0,26,6,2,-4
"e2911e79efc2420eac45d9f671463d4b","6d541c89590949f99af293c4f2333f67",22854375,1,4,0,27,2,6,4
"e2911e79efc2420eac45d9f671463d4b","519d1b8c59404d67b54e96c5c8a830b2",22854375,1,1,0,31,2,3,1
"519d1b8c59404d67b54e96c5c8a830b2","519d1b8c59404d67b54e96c5c8a830b2",22854375,2,0,1,32,3,3,0
"519d1b8c59404d67b54e96c5c8a830b2","e2911e79efc2420eac45d9f671463d4b",22854375,1,-1,0,34,3,2,-1
"e2911e79efc2420eac45d9f671463d4b","9112f2bffece48e08c6d2287be204085",22854375,1,9,0,35,2,11,9
"9112f2bffece48e08c6d2287be204085","9112f2bffece48e08c6d2287be204085",22854375,1,0,1,36,11,11,0
"9112f2bffece48e08c6d2287be204085","0680571d4698477995e41842c36a54b2",22854375,1,-1,0,37,11,10,-1
"0680571d4698477995e41842c36a54b2","0680571d4698477995e41842c36a54b2",22854375,2,0,1,38,10,10,0
"0680571d4698477995e41842c36a54b2","531db53f81f646edb0cdcfe0085b03b7",22854375,1,-6,0,40,10,4,-6
"531db53f81f646edb0cdcfe0085b03b7","4f5f94b2f95141e0a9d53a61da2276da",22854375,1,1,0,41,4,5,1
"4f5f94b2f95141e0a9d53a61da2276da","4f5f94b2f95141e0a9d53a61da2276da",22854375,2,0,1,42,5,5,0
"4f5f94b2f95141e0a9d53a61da2276da","6d541c89590949f99af293c4f2333f67",22854375,1,1,0,44,5,6,1
"6d541c89590949f99af293c4f2333f67","dd5cf0b9fe4c4f1d8f5ff8e4c04879cb",22854375,1,1,0,45,6,7,1
"dd5cf0b9fe4c4f1d8f5ff8e4c04879cb","dd5cf0b9fe4c4f1d8f5ff8e4c04879cb",22854375,2,0,1,46,7,7,0
"dd5cf0b9fe4c4f1d8f5ff8e4c04879cb","f96261861edc426abe2248be4f0a709a",22854375,1,1,0,48,7,8,1
"f96261861edc426abe2248be4f0a709a","f96261861edc426abe2248be4f0a709a",22854375,2,0,1,49,8,8,0
"f96261861edc426abe2248be4f0a709a","66b5e16f4f75454fb5b8172079f0fa83",22854375,1,1,0,51,8,9,1
"66b5e16f4f75454fb5b8172079f0fa83","66b5e16f4f75454fb5b8172079f0fa83",22854375,3,0,1,52,9,9,0
"66b5e16f4f75454fb5b8172079f0fa83","56586aa865414f538729c7f7735d2bc6",22854375,1,5,0,54,9,12,3
"56586aa865414f538729c7f7735d2bc6","e2911e79efc2420eac45d9f671463d4b",22854375,4,-12,0,55,12,2,-10
"e2911e79efc2420eac45d9f671463d4b","56586aa865414f538729c7f7735d2bc6",22854375,5,12,0,56,2,12,10
"56586aa865414f538729c7f7735d2bc6","66b5e16f4f75454fb5b8172079f0fa83",22854375,1,-5,0,65,12,9,-3
"66b5e16f4f75454fb5b8172079f0fa83","e2911e79efc2420eac45d9f671463d4b",22854375,1,-7,0,67,9,2,-7
"56586aa865414f538729c7f7735d2bc6","b7f2b31585d94eb3bf86376714aa7070",22854375,3,2,0,88,12,13,1
"b7f2b31585d94eb3bf86376714aa7070","b613861cecf84ffcab01afb23f660475",22854375,1,-17,0,89,13,1,-12
"b7f2b31585d94eb3bf86376714aa7070","56586aa865414f538729c7f7735d2bc6",22854375,1,-2,0,93,13,12,-1
"b7f2b31585d94eb3bf86376714aa7070","b7f2b31585d94eb3bf86376714aa7070",22854375,14,0,1,100,13,13,0
"b7f2b31585d94eb3bf86376714aa7070","3f1c815879794b929260d224becaff7e",22854375,1,2,0,113,13,14,1
"3f1c815879794b929260d224becaff7e","56586aa865414f538729c7f7735d2bc6",22854375,1,-4,0,114,14,12,-2
"56586aa865414f538729c7f7735d2bc6","56586aa865414f538729c7f7735d2bc6",22854375,31,0,1,115,12,12,0
"56586aa865414f538729c7f7735d2bc6","81c864a886d54a6b8ff85f7d736f4f95",22854375,1,6,0,117,12,15,3
"81c864a886d54a6b8ff85f7d736f4f95","5c5ceeee4562457ba6d41515aeebfbb1",22854375,1,4,0,118,15,17,2
"5c5ceeee4562457ba6d41515aeebfbb1","5c5ceeee4562457ba6d41515aeebfbb1",22854375,19,0,1,119,17,17,0
"5c5ceeee4562457ba6d41515aeebfbb1","b613861cecf84ffcab01afb23f660475",22854375,1,-25,0,120,17,1,-16
"b613861cecf84ffcab01afb23f660475","56586aa865414f538729c7f7735d2bc6",22854375,3,15,0,121,1,12,11
"56586aa865414f538729c7f7735d2bc6","5c5ceeee4562457ba6d41515aeebfbb1",22854375,1,10,0,124,12,17,5
"5c5ceeee4562457ba6d41515aeebfbb1","56586aa865414f538729c7f7735d2bc6",22854375,1,-10,0,143,17,12,-5
"56586aa865414f538729c7f7735d2bc6","9afd71a5298d4333b6849dfce1b9422c",22854375,1,13,0,144,12,18,6
"9afd71a5298d4333b6849dfce1b9422c","9afd71a5298d4333b6849dfce1b9422c",22854375,1,0,1,145,18,18,0
"9afd71a5298d4333b6849dfce1b9422c","b7719e26494940efa49512aedd0aac79",22854375,1,4,0,146,18,20,2
"b7719e26494940efa49512aedd0aac79","9afd71a5298d4333b6849dfce1b9422c",22854375,1,-4,0,147,20,18,-2
"9afd71a5298d4333b6849dfce1b9422c","d4f45188d3c84a02ba08454e6403a818",22854375,1,9,0,148,18,24,6
"d4f45188d3c84a02ba08454e6403a818","d4c3b003e8274e429d2fa688d73fde6d",22854375,2,-2,0,149,24,22,-2
"d4c3b003e8274e429d2fa688d73fde6d","d4c3b003e8274e429d2fa688d73fde6d",22854375,16,0,1,150,22,22,0
"d4c3b003e8274e429d2fa688d73fde6d","b7719e26494940efa49512aedd0aac79",22854375,1,-3,0,164,22,20,-2
"b7719e26494940efa49512aedd0aac79","b7719e26494940efa49512aedd0aac79",22854375,1,0,1,165,20,20,0
"b7719e26494940efa49512aedd0aac79","afbf7250b99d47bea07172749483ca97",22854375,1,12,0,166,20,28,8
"afbf7250b99d47bea07172749483ca97","afbf7250b99d47bea07172749483ca97",22854375,1,0,1,167,28,28,0
"afbf7250b99d47bea07172749483ca97","4e51676dc72045d99c19b9fa7b22f8bc",22854375,1,3,0,168,28,29,1
"4e51676dc72045d99c19b9fa7b22f8bc","4e51676dc72045d99c19b9fa7b22f8bc",22854375,1,0,1,169,29,29,0
"4e51676dc72045d99c19b9fa7b22f8bc","51970cfa30e643e894e66ae85c8024cc",22854375,1,3,0,170,29,31,2
"51970cfa30e643e894e66ae85c8024cc","c33c17be71ae4d588da7369472e5bb1b",22854375,1,6,0,171,31,34,3
"c33c17be71ae4d588da7369472e5bb1b","4e51676dc72045d99c19b9fa7b22f8bc",22854375,1,-9,0,172,34,29,-5
"4e51676dc72045d99c19b9fa7b22f8bc","c33c17be71ae4d588da7369472e5bb1b",22854375,1,9,0,173,29,34,5
"c33c17be71ae4d588da7369472e5bb1b","93679be414554a11b1893002f2229a93",22854375,1,3,0,174,34,35,1
"93679be414554a11b1893002f2229a93","93679be414554a11b1893002f2229a93",22854375,2,0,1,175,35,35,0
"93679be414554a11b1893002f2229a93","7040a13096d746ac84b8fac8d9752058",22854375,1,3,0,176,35,36,1
"7040a13096d746ac84b8fac8d9752058","7040a13096d746ac84b8fac8d9752058",22854375,1,0,1,177,36,36,0
"7040a13096d746ac84b8fac8d9752058","9a0dc646f934470daf08c4b56ccf73db",22854375,1,3,0,178,36,37,1
"9a0dc646f934470daf08c4b56ccf73db","9a0dc646f934470daf08c4b56ccf73db",22854375,1,0,1,179,37,37,0
"9a0dc646f934470daf08c4b56ccf73db","fc0e049d56024bc9a02c9a9c435c3df7",22854375,1,3,0,180,37,38,1
"fc0e049d56024bc9a02c9a9c435c3df7","fc0e049d56024bc9a02c9a9c435c3df7",22854375,7,0,1,181,38,38,0
"fc0e049d56024bc9a02c9a9c435c3df7","67a089198fcb4e1c8f2385786c2b296f",22854375,4,4,0,182,38,39,1
"67a089198fcb4e1c8f2385786c2b296f","64d48c6c9c7940639a932219a6c87198",22854375,4,1,0,183,39,40,1
"64d48c6c9c7940639a932219a6c87198","64d48c6c9c7940639a932219a6c87198",22854375,32,0,1,184,40,40,0
"64d48c6c9c7940639a932219a6c87198","b534b89233134e30a9b5645138bfa9ee",22854375,1,3,0,215,40,41,1
"b534b89233134e30a9b5645138bfa9ee","67a089198fcb4e1c8f2385786c2b296f",22854375,1,-4,0,216,41,39,-2
"67a089198fcb4e1c8f2385786c2b296f","0e37b720d23b4e7f8b313e79313fd107",22854375,1,7,0,217,39,44,5
"0e37b720d23b4e7f8b313e79313fd107","0e37b720d23b4e7f8b313e79313fd107",22854375,1,0,1,218,44,44,0
"0e37b720d23b4e7f8b313e79313fd107","6875d67fdd5f48168b62719df449bebd",22854375,1,1,0,219,44,45,1
"6875d67fdd5f48168b62719df449bebd","6875d67fdd5f48168b62719df449bebd",22854375,4,0,1,220,45,45,0
"6875d67fdd5f48168b62719df449bebd","6e13d61a7bdb44bca949c9f86fab3be5",22854375,1,3,0,222,45,47,2
"6e13d61a7bdb44bca949c9f86fab3be5","b534b89233134e30a9b5645138bfa9ee",22854375,5,-7,0,223,47,41,-6
"b534b89233134e30a9b5645138bfa9ee","6e13d61a7bdb44bca949c9f86fab3be5",22854375,4,7,0,224,41,47,6
"6e13d61a7bdb44bca949c9f86fab3be5","6e13d61a7bdb44bca949c9f86fab3be5",22854375,21,0,1,225,47,47,0
"b534b89233134e30a9b5645138bfa9ee","195f78799f984cc2b06c48dfe36be751",22854375,2,9,0,229,41,49,8
"195f78799f984cc2b06c48dfe36be751","195f78799f984cc2b06c48dfe36be751",22854375,5,0,1,230,49,49,0
"195f78799f984cc2b06c48dfe36be751","d9c8d8c444a64dadbbb508652c721e17",22854375,1,-3,0,233,49,46,-3
"d9c8d8c444a64dadbbb508652c721e17","d0c74f735e024943943e40333d6d337f",22854375,3,6,0,234,46,51,5
"d0c74f735e024943943e40333d6d337f","f924752d8a1149668870b1e7698486f7",22854375,3,-1,0,235,51,50,-1
"f924752d8a1149668870b1e7698486f7","b534b89233134e30a9b5645138bfa9ee",22854375,1,-11,0,236,50,41,-9
"b534b89233134e30a9b5645138bfa9ee","78f30e4dcac84e3cbea8b2cc6e0d62b3",22854375,1,21,0,237,41,59,18
"78f30e4dcac84e3cbea8b2cc6e0d62b3","12aa6e1672ac4e7aa6449a7a8609cd72",22854375,1,-2,0,238,59,57,-2
"12aa6e1672ac4e7aa6449a7a8609cd72","a0a418b8540d479fa6e0f653b701da8b",22854375,3,8,0,239,57,64,7
"a0a418b8540d479fa6e0f653b701da8b","d646286c8051419bbc2e31dd1db55ca8",22854375,1,6,0,240,64,67,3
"d646286c8051419bbc2e31dd1db55ca8","309ccf3cc4fe429d9bfbaef53d3fa479",22854375,1,-10,0,241,67,60,-7
"309ccf3cc4fe429d9bfbaef53d3fa479","a1f2f12debe5432fb7a70bcd12bacfb9",22854375,1,-3,0,242,60,58,-2
"a1f2f12debe5432fb7a70bcd12bacfb9","bc42d26810654ea9a1df1efe1e58c7d5",22854375,1,6,0,243,58,63,5
"bc42d26810654ea9a1df1efe1e58c7d5","b534b89233134e30a9b5645138bfa9ee",22854375,1,-26,0,244,63,41,-22
"b534b89233134e30a9b5645138bfa9ee","d646286c8051419bbc2e31dd1db55ca8",22854375,11,33,0,245,41,67,26
"d646286c8051419bbc2e31dd1db55ca8","b534b89233134e30a9b5645138bfa9ee",22854375,5,-33,0,246,67,41,-26
"d646286c8051419bbc2e31dd1db55ca8","a2becd407db34b189200a32546d9d569",22854375,6,9,0,250,67,75,8
"a2becd407db34b189200a32546d9d569","140d5b27b8574befad82c0a013b59dfa",22854375,5,-1,0,251,75,74,-1
"140d5b27b8574befad82c0a013b59dfa","d646286c8051419bbc2e31dd1db55ca8",22854375,2,-8,0,252,74,67,-7
"d646286c8051419bbc2e31dd1db55ca8","ae5ac430ea254e708a6f5deaaf7464ae",22854375,1,20,0,253,67,84,17
"ae5ac430ea254e708a6f5deaaf7464ae","d18a9ea32855445f8736581f5cb119ce",22854375,2,-3,0,254,84,82,-2
"d18a9ea32855445f8736581f5cb119ce","e20db35ced8544ddac5bc3839145e463",22854375,1,13,0,255,82,91,9
"e20db35ced8544ddac5bc3839145e463","d646286c8051419bbc2e31dd1db55ca8",22854375,6,-30,0,256,91,67,-24
"d646286c8051419bbc2e31dd1db55ca8","6a9f0ef185fb47f0937e29daa1c71ed5",22854375,1,27,0,257,67,90,23
"6a9f0ef185fb47f0937e29daa1c71ed5","e20db35ced8544ddac5bc3839145e463",22854375,2,3,0,258,90,91,1
"d646286c8051419bbc2e31dd1db55ca8","d646286c8051419bbc2e31dd1db55ca8",22854375,8,0,1,260,67,67,0
"d646286c8051419bbc2e31dd1db55ca8","e20db35ced8544ddac5bc3839145e463",22854375,3,30,0,261,67,91,24
"e20db35ced8544ddac5bc3839145e463","e20db35ced8544ddac5bc3839145e463",22854375,4,0,1,262,91,91,0
"e20db35ced8544ddac5bc3839145e463","42fb58708eaf4e5daa82bfca61b6f5fd",22854375,1,-6,0,271,91,87,-4
"42fb58708eaf4e5daa82bfca61b6f5fd","6a9f0ef185fb47f0937e29daa1c71ed5",22854375,1,3,0,272,87,90,3
"6a9f0ef185fb47f0937e29daa1c71ed5","ae5ac430ea254e708a6f5deaaf7464ae",22854375,2,-7,0,273,90,84,-6
"d18a9ea32855445f8736581f5cb119ce","a2becd407db34b189200a32546d9d569",22854375,2,-8,0,275,82,75,-7
"b534b89233134e30a9b5645138bfa9ee","bc42d26810654ea9a1df1efe1e58c7d5",22854375,2,26,0,279,41,63,22
"bc42d26810654ea9a1df1efe1e58c7d5","7af822066add4e7f8e007e4eee31a8bf",22854375,1,3,0,280,63,65,2
"7af822066add4e7f8e007e4eee31a8bf","a0a418b8540d479fa6e0f653b701da8b",22854375,3,-2,0,281,65,64,-1
"a0a418b8540d479fa6e0f653b701da8b","309ccf3cc4fe429d9bfbaef53d3fa479",22854375,3,-4,0,282,64,60,-4
"309ccf3cc4fe429d9bfbaef53d3fa479","78f30e4dcac84e3cbea8b2cc6e0d62b3",22854375,3,-2,0,283,60,59,-1
"78f30e4dcac84e3cbea8b2cc6e0d62b3","a1f2f12debe5432fb7a70bcd12bacfb9",22854375,4,-1,0,284,59,58,-1
"a1f2f12debe5432fb7a70bcd12bacfb9","d0c74f735e024943943e40333d6d337f",22854375,2,-8,0,285,58,51,-7
"d0c74f735e024943943e40333d6d337f","12aa6e1672ac4e7aa6449a7a8609cd72",22854375,4,7,0,286,51,57,6
"12aa6e1672ac4e7aa6449a7a8609cd72","f924752d8a1149668870b1e7698486f7",22854375,2,-8,0,287,57,50,-7
"f924752d8a1149668870b1e7698486f7","6e13d61a7bdb44bca949c9f86fab3be5",22854375,2,-4,0,288,50,47,-3
"6e13d61a7bdb44bca949c9f86fab3be5","d9c8d8c444a64dadbbb508652c721e17",22854375,2,-1,0,289,47,46,-1
"d9c8d8c444a64dadbbb508652c721e17","6875d67fdd5f48168b62719df449bebd",22854375,1,-2,0,290,46,45,-1
"6875d67fdd5f48168b62719df449bebd","b534b89233134e30a9b5645138bfa9ee",22854375,1,-4,0,293,45,41,-4
"b534b89233134e30a9b5645138bfa9ee","7af822066add4e7f8e007e4eee31a8bf",22854375,1,29,0,294,41,65,24
"7af822066add4e7f8e007e4eee31a8bf","6e13d61a7bdb44bca949c9f86fab3be5",22854375,1,-22,0,295,65,47,-18
"6e13d61a7bdb44bca949c9f86fab3be5","7af822066add4e7f8e007e4eee31a8bf",22854375,1,22,0,296,47,65,18
"7af822066add4e7f8e007e4eee31a8bf","7af822066add4e7f8e007e4eee31a8bf",22854375,4,0,1,297,65,65,0
"7af822066add4e7f8e007e4eee31a8bf","b534b89233134e30a9b5645138bfa9ee",22854375,2,-29,0,298,65,41,-24
"bc42d26810654ea9a1df1efe1e58c7d5","a0a418b8540d479fa6e0f653b701da8b",22854375,4,1,0,300,63,64,1
"a0a418b8540d479fa6e0f653b701da8b","7af822066add4e7f8e007e4eee31a8bf",22854375,1,2,0,301,64,65,1
"7af822066add4e7f8e007e4eee31a8bf","309ccf3cc4fe429d9bfbaef53d3fa479",22854375,1,-6,0,302,65,60,-5
"12aa6e1672ac4e7aa6449a7a8609cd72","6e13d61a7bdb44bca949c9f86fab3be5",22854375,2,-12,0,307,57,47,-10
"6e13d61a7bdb44bca949c9f86fab3be5","f924752d8a1149668870b1e7698486f7",22854375,2,4,0,308,47,50,3
"f924752d8a1149668870b1e7698486f7","d9c8d8c444a64dadbbb508652c721e17",22854375,2,-5,0,309,50,46,-4
"d9c8d8c444a64dadbbb508652c721e17","6e13d61a7bdb44bca949c9f86fab3be5",22854375,1,1,0,310,46,47,1
"195f78799f984cc2b06c48dfe36be751","d0c74f735e024943943e40333d6d337f",22854375,1,3,0,315,49,51,2
"d0c74f735e024943943e40333d6d337f","d9c8d8c444a64dadbbb508652c721e17",22854375,2,-6,0,316,51,46,-5
"d9c8d8c444a64dadbbb508652c721e17","f924752d8a1149668870b1e7698486f7",22854375,2,5,0,317,46,50,4
"d0c74f735e024943943e40333d6d337f","983f8ff320594b279a7f4a6fe132f9c5",22854375,1,2,0,341,51,53,2
"983f8ff320594b279a7f4a6fe132f9c5","983f8ff320594b279a7f4a6fe132f9c5",22854375,2,0,1,342,53,53,0
"983f8ff320594b279a7f4a6fe132f9c5","35adfa5d923046aebabfefd98f35ff05",22854375,1,1,0,344,53,54,1
"35adfa5d923046aebabfefd98f35ff05","35adfa5d923046aebabfefd98f35ff05",22854375,2,0,1,345,54,54,0
"35adfa5d923046aebabfefd98f35ff05","86e22cb5fe0e4b47a9489ecddf7ed78f",22854375,1,2,0,347,54,56,2
"86e22cb5fe0e4b47a9489ecddf7ed78f","86e22cb5fe0e4b47a9489ecddf7ed78f",22854375,2,0,1,348,56,56,0
"86e22cb5fe0e4b47a9489ecddf7ed78f","b6f8a98476224da1b40e555ececc7ed8",22854375,1,-1,0,350,56,55,-1
"b6f8a98476224da1b40e555ececc7ed8","b6f8a98476224da1b40e555ececc7ed8",22854375,4,0,1,351,55,55,0
"b6f8a98476224da1b40e555ececc7ed8","d0c74f735e024943943e40333d6d337f",22854375,2,-4,0,353,55,51,-4
"d0c74f735e024943943e40333d6d337f","d0c74f735e024943943e40333d6d337f",22854375,4,0,1,354,51,51,0
"d0c74f735e024943943e40333d6d337f","b6f8a98476224da1b40e555ececc7ed8",22854375,1,4,0,355,51,55,4
"f924752d8a1149668870b1e7698486f7","a1f2f12debe5432fb7a70bcd12bacfb9",22854375,3,9,0,363,50,58,8
"a1f2f12debe5432fb7a70bcd12bacfb9","78f30e4dcac84e3cbea8b2cc6e0d62b3",22854375,6,1,0,364,58,59,1
"a1f2f12debe5432fb7a70bcd12bacfb9","a1f2f12debe5432fb7a70bcd12bacfb9",22854375,10,0,1,366,58,58,0
"78f30e4dcac84e3cbea8b2cc6e0d62b3","78f30e4dcac84e3cbea8b2cc6e0d62b3",22854375,7,0,1,377,59,59,0
"78f30e4dcac84e3cbea8b2cc6e0d62b3","a0a418b8540d479fa6e0f653b701da8b",22854375,2,6,0,384,59,64,5
"a0a418b8540d479fa6e0f653b701da8b","12aa6e1672ac4e7aa6449a7a8609cd72",22854375,2,-8,0,385,64,57,-7
"12aa6e1672ac4e7aa6449a7a8609cd72","bc42d26810654ea9a1df1efe1e58c7d5",22854375,2,7,0,386,57,63,6
"bc42d26810654ea9a1df1efe1e58c7d5","4c943503763e4e349906eea3ed3c8e86",22854375,1,-2,0,387,63,61,-2
"4c943503763e4e349906eea3ed3c8e86","4c943503763e4e349906eea3ed3c8e86",22854375,2,0,1,388,61,61,0
"4c943503763e4e349906eea3ed3c8e86","a1f2f12debe5432fb7a70bcd12bacfb9",22854375,1,-4,0,390,61,58,-3
"78f30e4dcac84e3cbea8b2cc6e0d62b3","309ccf3cc4fe429d9bfbaef53d3fa479",22854375,1,2,0,392,59,60,1
"309ccf3cc4fe429d9bfbaef53d3fa479","12aa6e1672ac4e7aa6449a7a8609cd72",22854375,1,-4,0,393,60,57,-3
"a0a418b8540d479fa6e0f653b701da8b","bc42d26810654ea9a1df1efe1e58c7d5",22854375,5,-1,0,395,64,63,-1
"bc42d26810654ea9a1df1efe1e58c7d5","78f30e4dcac84e3cbea8b2cc6e0d62b3",22854375,1,-5,0,396,63,59,-4
"a1f2f12debe5432fb7a70bcd12bacfb9","309ccf3cc4fe429d9bfbaef53d3fa479",22854375,2,3,0,398,58,60,2
"309ccf3cc4fe429d9bfbaef53d3fa479","bc42d26810654ea9a1df1efe1e58c7d5",22854375,1,3,0,399,60,63,3
"bc42d26810654ea9a1df1efe1e58c7d5","12aa6e1672ac4e7aa6449a7a8609cd72",22854375,2,-7,0,400,63,57,-6
"309ccf3cc4fe429d9bfbaef53d3fa479","7af822066add4e7f8e007e4eee31a8bf",22854375,2,6,0,403,60,65,5
"bc42d26810654ea9a1df1efe1e58c7d5","bc42d26810654ea9a1df1efe1e58c7d5",22854375,8,0,1,406,63,63,0
"a0a418b8540d479fa6e0f653b701da8b","a0a418b8540d479fa6e0f653b701da8b",22854375,8,0,1,411,64,64,0
"309ccf3cc4fe429d9bfbaef53d3fa479","b534b89233134e30a9b5645138bfa9ee",22854375,2,-23,0,415,60,41,-19
"b534b89233134e30a9b5645138bfa9ee","b534b89233134e30a9b5645138bfa9ee",22854375,2,0,1,419,41,41,0
"d646286c8051419bbc2e31dd1db55ca8","267f883678b24aed855fde42524975d9",22854375,1,4,0,421,67,71,4
"267f883678b24aed855fde42524975d9","267f883678b24aed855fde42524975d9",22854375,3,0,1,422,71,71,0
"267f883678b24aed855fde42524975d9","88fff56d0342490dbef9040750a20f6c",22854375,1,1,0,425,71,72,1
"88fff56d0342490dbef9040750a20f6c","88fff56d0342490dbef9040750a20f6c",22854375,1,0,1,426,72,72,0
"88fff56d0342490dbef9040750a20f6c","adb17b12b66c4a49a85fd34322f7df70",22854375,1,1,0,427,72,73,1
"adb17b12b66c4a49a85fd34322f7df70","adb17b12b66c4a49a85fd34322f7df70",22854375,1,0,1,428,73,73,0
"adb17b12b66c4a49a85fd34322f7df70","a2becd407db34b189200a32546d9d569",22854375,1,3,0,429,73,75,2
"a2becd407db34b189200a32546d9d569","d646286c8051419bbc2e31dd1db55ca8",22854375,2,-9,0,430,75,67,-8
"a2becd407db34b189200a32546d9d569","58c22b011d0f4c2ea6d13615edbb9eeb",22854375,1,2,0,460,75,77,2
"58c22b011d0f4c2ea6d13615edbb9eeb","58c22b011d0f4c2ea6d13615edbb9eeb",22854375,5,0,1,461,77,77,0
"58c22b011d0f4c2ea6d13615edbb9eeb","dd76e1861dc9461c830888729d091ee0",22854375,1,1,0,466,77,78,1
"dd76e1861dc9461c830888729d091ee0","dd76e1861dc9461c830888729d091ee0",22854375,8,0,1,467,78,78,0
"dd76e1861dc9461c830888729d091ee0","cd1d828f1a694b87913a7ea66c23803e",22854375,1,1,0,475,78,79,1
"cd1d828f1a694b87913a7ea66c23803e","cd1d828f1a694b87913a7ea66c23803e",22854375,2,0,1,476,79,79,0
"cd1d828f1a694b87913a7ea66c23803e","9176a3c2b4d2465fa8b0c67096c2a97e",22854375,1,1,0,478,79,80,1
"9176a3c2b4d2465fa8b0c67096c2a97e","9176a3c2b4d2465fa8b0c67096c2a97e",22854375,11,0,1,479,80,80,0
"9176a3c2b4d2465fa8b0c67096c2a97e","f8ec6445f7194e25b9101d4fbcb07a18",22854375,1,1,0,490,80,81,1
"f8ec6445f7194e25b9101d4fbcb07a18","f8ec6445f7194e25b9101d4fbcb07a18",22854375,3,0,1,491,81,81,0
"f8ec6445f7194e25b9101d4fbcb07a18","140d5b27b8574befad82c0a013b59dfa",22854375,1,-7,0,494,81,74,-7
"d646286c8051419bbc2e31dd1db55ca8","140d5b27b8574befad82c0a013b59dfa",22854375,1,8,0,500,67,74,7
"d646286c8051419bbc2e31dd1db55ca8","7af822066add4e7f8e007e4eee31a8bf",22854375,1,-4,0,503,67,65,-2
"bc42d26810654ea9a1df1efe1e58c7d5","a1f2f12debe5432fb7a70bcd12bacfb9",22854375,1,-6,0,510,63,58,-5
"78f30e4dcac84e3cbea8b2cc6e0d62b3","d0c74f735e024943943e40333d6d337f",22854375,2,-9,0,513,59,51,-8
"d9c8d8c444a64dadbbb508652c721e17","b534b89233134e30a9b5645138bfa9ee",22854375,1,-6,0,518,46,41,-5
"6e13d61a7bdb44bca949c9f86fab3be5","d0c74f735e024943943e40333d6d337f",22854375,1,5,0,520,47,51,4
"78f30e4dcac84e3cbea8b2cc6e0d62b3","bc42d26810654ea9a1df1efe1e58c7d5",22854375,1,5,0,525,59,63,4
"12aa6e1672ac4e7aa6449a7a8609cd72","309ccf3cc4fe429d9bfbaef53d3fa479",22854375,1,4,0,532,57,60,3
"a2becd407db34b189200a32546d9d569","d18a9ea32855445f8736581f5cb119ce",22854375,1,8,0,537,75,82,7
"d18a9ea32855445f8736581f5cb119ce","140d5b27b8574befad82c0a013b59dfa",22854375,1,-9,0,538,82,74,-8
"d18a9ea32855445f8736581f5cb119ce","f564483cbd7a407681aa2fcca518cf5f",22854375,1,4,0,543,82,85,3
"f564483cbd7a407681aa2fcca518cf5f","f564483cbd7a407681aa2fcca518cf5f",22854375,1,0,1,544,85,85,0
"f564483cbd7a407681aa2fcca518cf5f","18fd01350bd5434ca636d59a599d768a",22854375,1,1,0,545,85,86,1
"18fd01350bd5434ca636d59a599d768a","18fd01350bd5434ca636d59a599d768a",22854375,8,0,1,546,86,86,0
"18fd01350bd5434ca636d59a599d768a","6a9f0ef185fb47f0937e29daa1c71ed5",22854375,1,5,0,554,86,90,4
"6a9f0ef185fb47f0937e29daa1c71ed5","c681290961c94c4caf23b529d1ae6b9a",22854375,1,-2,0,560,90,88,-2
"c681290961c94c4caf23b529d1ae6b9a","c681290961c94c4caf23b529d1ae6b9a",22854375,3,0,1,561,88,88,0
"c681290961c94c4caf23b529d1ae6b9a","e20db35ced8544ddac5bc3839145e463",22854375,1,5,0,564,88,91,3
"d646286c8051419bbc2e31dd1db55ca8","1febb706d7a34005ae8711ed49c76e64",22854375,1,33,0,566,67,94,27
"1febb706d7a34005ae8711ed49c76e64","1febb706d7a34005ae8711ed49c76e64",22854375,2,0,1,567,94,94,0
"1febb706d7a34005ae8711ed49c76e64","8f73ba6f5a0042f2850356ac38ac6f24",22854375,1,1,0,569,94,95,1
"8f73ba6f5a0042f2850356ac38ac6f24","8f73ba6f5a0042f2850356ac38ac6f24",22854375,5,0,1,570,95,95,0
"8f73ba6f5a0042f2850356ac38ac6f24","e2260b86653c46d7b14a41fb419dbf8c",22854375,1,1,0,575,95,96,1
"e2260b86653c46d7b14a41fb419dbf8c","e2260b86653c46d7b14a41fb419dbf8c",22854375,2,0,1,576,96,96,0
"e2260b86653c46d7b14a41fb419dbf8c","35eb641ad1d845bbba54915bce75a962",22854375,1,1,0,578,96,97,1
"35eb641ad1d845bbba54915bce75a962","35eb641ad1d845bbba54915bce75a962",22854375,5,0,1,579,97,97,0
"35eb641ad1d845bbba54915bce75a962","08be90ffbeea4795a138cd42ed8db56f",22854375,1,1,0,584,97,98,1
"08be90ffbeea4795a138cd42ed8db56f","08be90ffbeea4795a138cd42ed8db56f",22854375,2,0,1,585,98,98,0
"08be90ffbeea4795a138cd42ed8db56f","3007433c8f584dcbb5ac159c1c5f2be3",22854375,1,1,0,587,98,99,1
"3007433c8f584dcbb5ac159c1c5f2be3","3007433c8f584dcbb5ac159c1c5f2be3",22854375,3,0,1,588,99,99,0
"3007433c8f584dcbb5ac159c1c5f2be3","00ae5f0c51874a73a41ebea838d95682",22854375,1,3,0,591,99,101,2
"00ae5f0c51874a73a41ebea838d95682","00ae5f0c51874a73a41ebea838d95682",22854375,19,0,1,595,101,101,0
"00ae5f0c51874a73a41ebea838d95682","d391c8b6e56a43a7b654e9dee02d904b",22854375,1,2,0,614,101,103,2
"d391c8b6e56a43a7b654e9dee02d904b","d391c8b6e56a43a7b654e9dee02d904b",22854375,15,0,1,615,103,103,0
"d391c8b6e56a43a7b654e9dee02d904b","6111116566fc4fd9abba409322bea245",22854375,1,1,0,630,103,104,1
"6111116566fc4fd9abba409322bea245","6111116566fc4fd9abba409322bea245",22854375,2,0,1,631,104,104,0
"6111116566fc4fd9abba409322bea245","a81b2235cb9c499eb9ea8ee0a8dd9725",22854375,1,1,0,633,104,105,1
"a81b2235cb9c499eb9ea8ee0a8dd9725","a81b2235cb9c499eb9ea8ee0a8dd9725",22854375,2,0,1,634,105,105,0
"a81b2235cb9c499eb9ea8ee0a8dd9725","2d4e0ab0ef3b4d73b82c72d4621a7579",22854375,1,1,0,636,105,106,1
"2d4e0ab0ef3b4d73b82c72d4621a7579","2d4e0ab0ef3b4d73b82c72d4621a7579",22854375,2,0,1,637,106,106,0
"2d4e0ab0ef3b4d73b82c72d4621a7579","8bdebf492ebd4e62b0d522e8ab5e5197",22854375,1,1,0,639,106,107,1
"8bdebf492ebd4e62b0d522e8ab5e5197","8bdebf492ebd4e62b0d522e8ab5e5197",22854375,3,0,1,640,107,107,0
"8bdebf492ebd4e62b0d522e8ab5e5197","4280927ec4d643238aa49c32f9e06c6c",22854375,1,3,0,643,107,109,2
"4280927ec4d643238aa49c32f9e06c6c","4280927ec4d643238aa49c32f9e06c6c",22854375,7,0,1,646,109,109,0
"4280927ec4d643238aa49c32f9e06c6c","fc44e6a5f7654430af1227838224dceb",22854375,1,2,0,653,109,111,2
"fc44e6a5f7654430af1227838224dceb","fc44e6a5f7654430af1227838224dceb",22854375,2,0,1,654,111,111,0
"fc44e6a5f7654430af1227838224dceb","08111f75e22d409998cf8b85bd431f0a",22854375,1,-3,0,656,111,108,-3
"08111f75e22d409998cf8b85bd431f0a","a9ae0a3c070d455bb4369a8996313336",22854375,2,7,0,657,108,114,6
"a9ae0a3c070d455bb4369a8996313336","a9ae0a3c070d455bb4369a8996313336",22854375,2,0,1,658,114,114,0
"a9ae0a3c070d455bb4369a8996313336","e20db35ced8544ddac5bc3839145e463",22854375,1,-26,0,660,114,91,-23
"e20db35ced8544ddac5bc3839145e463","4280927ec4d643238aa49c32f9e06c6c",22854375,1,20,0,661,91,109,18
"4280927ec4d643238aa49c32f9e06c6c","e20db35ced8544ddac5bc3839145e463",22854375,1,-20,0,662,109,91,-18
"e20db35ced8544ddac5bc3839145e463","08111f75e22d409998cf8b85bd431f0a",22854375,1,19,0,663,91,108,17
"a9ae0a3c070d455bb4369a8996313336","71cec822bcff4f30a20e75dc63ef7b65",22854375,1,2,0,665,114,116,2
"71cec822bcff4f30a20e75dc63ef7b65","71cec822bcff4f30a20e75dc63ef7b65",22854375,3,0,1,666,116,116,0
"71cec822bcff4f30a20e75dc63ef7b65","37319e88176d4aefa91d7a9980dbae91",22854375,1,-4,0,669,116,112,-4
"62bff51286ef4f348717a3cf6fe2318f","e20db35ced8544ddac5bc3839145e463",22854375,2,-33,0,671,120,91,-29
"e20db35ced8544ddac5bc3839145e463","b534b89233134e30a9b5645138bfa9ee",22854375,1,-63,0,673,91,41,-50
"b534b89233134e30a9b5645138bfa9ee","12aa6e1672ac4e7aa6449a7a8609cd72",22854375,1,19,0,674,41,57,16
"12aa6e1672ac4e7aa6449a7a8609cd72","a1f2f12debe5432fb7a70bcd12bacfb9",22854375,1,1,0,675,57,58,1
"f924752d8a1149668870b1e7698486f7","67a089198fcb4e1c8f2385786c2b296f",22854375,1,-15,0,680,50,39,-11
"67a089198fcb4e1c8f2385786c2b296f","b534b89233134e30a9b5645138bfa9ee",22854375,2,4,0,681,39,41,2
"b534b89233134e30a9b5645138bfa9ee","64d48c6c9c7940639a932219a6c87198",22854375,1,-3,0,682,41,40,-1
"64d48c6c9c7940639a932219a6c87198","67a089198fcb4e1c8f2385786c2b296f",22854375,2,-1,0,683,40,39,-1
"67a089198fcb4e1c8f2385786c2b296f","fc0e049d56024bc9a02c9a9c435c3df7",22854375,1,-4,0,684,39,38,-1
"b534b89233134e30a9b5645138bfa9ee","d9c8d8c444a64dadbbb508652c721e17",22854375,1,6,0,693,41,46,5
"bc42d26810654ea9a1df1efe1e58c7d5","309ccf3cc4fe429d9bfbaef53d3fa479",22854375,1,-3,0,705,63,60,-3
"d646286c8051419bbc2e31dd1db55ca8","b1cd0e7dc3ad4a8eb91a4bfdbeb025b0",22854375,1,61,0,712,67,118,51
"b1cd0e7dc3ad4a8eb91a4bfdbeb025b0","b1cd0e7dc3ad4a8eb91a4bfdbeb025b0",22854375,3,0,1,713,118,118,0
"b1cd0e7dc3ad4a8eb91a4bfdbeb025b0","62bff51286ef4f348717a3cf6fe2318f",22854375,1,2,0,716,118,120,2
"779f9ddd1fd14d1e9e69f72219a1fdbd","62bff51286ef4f348717a3cf6fe2318f",22854375,1,-3,0,724,121,120,-1
"e20db35ced8544ddac5bc3839145e463","ae26e6cda8ad4a3f81bd347560d9579f",22854375,1,40,0,729,91,125,34
"ae26e6cda8ad4a3f81bd347560d9579f","ae26e6cda8ad4a3f81bd347560d9579f",22854375,1,0,1,730,125,125,0
"ae26e6cda8ad4a3f81bd347560d9579f","ee48df95832b4374aa273ceb27ec1315",22854375,1,1,0,731,125,126,1
"ee48df95832b4374aa273ceb27ec1315","ee48df95832b4374aa273ceb27ec1315",22854375,1,0,1,732,126,126,0
"ee48df95832b4374aa273ceb27ec1315","7a439da90b394756ad1777fc4c6dead5",22854375,1,1,0,733,126,127,1
"7a439da90b394756ad1777fc4c6dead5","7a439da90b394756ad1777fc4c6dead5",22854375,1,0,1,734,127,127,0
"7a439da90b394756ad1777fc4c6dead5","779f9ddd1fd14d1e9e69f72219a1fdbd",22854375,1,-6,0,735,127,121,-6
"a8dd5213034441ac92724b4e83eb0bb2","8115eab6556b45f5b415c3b8c26a12e5",22854375,1,2,0,754,129,131,2
"8115eab6556b45f5b415c3b8c26a12e5","8115eab6556b45f5b415c3b8c26a12e5",22854375,2,0,1,755,131,131,0
"8115eab6556b45f5b415c3b8c26a12e5","ec34b06efd844b46a4c4818ecdb9b8f4",22854375,1,1,0,757,131,132,1
"ec34b06efd844b46a4c4818ecdb9b8f4","ec34b06efd844b46a4c4818ecdb9b8f4",22854375,2,0,1,758,132,132,0
"ec34b06efd844b46a4c4818ecdb9b8f4","c2e1c2b9eac64109b343a088584b576b",22854375,1,1,0,760,132,133,1
"c2e1c2b9eac64109b343a088584b576b","c2e1c2b9eac64109b343a088584b576b",22854375,2,0,1,761,133,133,0
"c2e1c2b9eac64109b343a088584b576b","579338175e0b4bbb8ef3b712b5d8b54e",22854375,1,-5,0,763,133,128,-5
"579338175e0b4bbb8ef3b712b5d8b54e","8bc5795d6a984a3eace4e2811e52dd4f",22854375,1,8,0,764,128,135,7
"8bc5795d6a984a3eace4e2811e52dd4f","8bc5795d6a984a3eace4e2811e52dd4f",22854375,3,0,1,765,135,135,0
"8bc5795d6a984a3eace4e2811e52dd4f","b416d47c56a742199b5d7c7f19d6503a",22854375,1,-1,0,768,135,134,-1
"b416d47c56a742199b5d7c7f19d6503a","cd4532ad48034873ba8bce2aac0c9808",22854375,1,4,0,769,134,137,3
"cd4532ad48034873ba8bce2aac0c9808","cd4532ad48034873ba8bce2aac0c9808",22854375,1,0,1,770,137,137,0
"cd4532ad48034873ba8bce2aac0c9808","779f9ddd1fd14d1e9e69f72219a1fdbd",22854375,1,-19,0,771,137,121,-16
"6c5ad271a44743479bfaea29b1db8d02","d646286c8051419bbc2e31dd1db55ca8",22854375,1,-93,0,774,143,67,-76
"d646286c8051419bbc2e31dd1db55ca8","df1de691dafe4549a18a4398ee9dfaf9",22854375,1,89,0,775,67,139,72
"6c5ad271a44743479bfaea29b1db8d02","83d311bed5374fee83d8d67a7d9d82dc",22854375,1,1,0,779,143,144,1
"83d311bed5374fee83d8d67a7d9d82dc","83d311bed5374fee83d8d67a7d9d82dc",22854375,1,0,1,780,144,144,0
"83d311bed5374fee83d8d67a7d9d82dc","402bba41861d43acb52a5abb89e8831e",22854375,1,1,0,781,144,145,1
"402bba41861d43acb52a5abb89e8831e","402bba41861d43acb52a5abb89e8831e",22854375,2,0,1,782,145,145,0
"402bba41861d43acb52a5abb89e8831e","8aae34f5ddbb4052a709b12e6b0d40fa",22854375,1,3,0,784,145,147,2
"8aae34f5ddbb4052a709b12e6b0d40fa","8aae34f5ddbb4052a709b12e6b0d40fa",22854375,30,0,1,787,147,147,0
"8aae34f5ddbb4052a709b12e6b0d40fa","645b3f0249f64f76af2e19eb4d0e55b7",22854375,1,2,0,817,147,149,2
"645b3f0249f64f76af2e19eb4d0e55b7","645b3f0249f64f76af2e19eb4d0e55b7",22854375,5,0,1,818,149,149,0
"645b3f0249f64f76af2e19eb4d0e55b7","7e7b8db5064d4369805ab370aac5ddfb",22854375,1,1,0,823,149,150,1
"7e7b8db5064d4369805ab370aac5ddfb","7e7b8db5064d4369805ab370aac5ddfb",22854375,2,0,1,824,150,150,0
"7e7b8db5064d4369805ab370aac5ddfb","8956d210ae7f41968fada86d4c979d6a",22854375,1,1,0,826,150,151,1
"8956d210ae7f41968fada86d4c979d6a","8956d210ae7f41968fada86d4c979d6a",22854375,2,0,1,827,151,151,0
"8956d210ae7f41968fada86d4c979d6a","f902b0f41b544d4dbf79664fd233648d",22854375,1,-5,0,829,151,146,-5
"f902b0f41b544d4dbf79664fd233648d","ae781e8b775e4ccd93bc800dad5c8376",22854375,1,8,0,830,146,153,7
"ae781e8b775e4ccd93bc800dad5c8376","ae781e8b775e4ccd93bc800dad5c8376",22854375,2,0,1,831,153,153,0
"ae781e8b775e4ccd93bc800dad5c8376","06882a8492d9499aa31555567f575ecb",22854375,1,1,0,833,153,154,1
"06882a8492d9499aa31555567f575ecb","06882a8492d9499aa31555567f575ecb",22854375,2,0,1,834,154,154,0
"06882a8492d9499aa31555567f575ecb","f293c508f409466a8f27ddd7d1e40b20",22854375,1,1,0,836,154,155,1
"f293c508f409466a8f27ddd7d1e40b20","f293c508f409466a8f27ddd7d1e40b20",22854375,2,0,1,837,155,155,0
"f293c508f409466a8f27ddd7d1e40b20","cc4ddef5bbbe48ebb605141b347c4ed1",22854375,1,1,0,839,155,156,1
"cc4ddef5bbbe48ebb605141b347c4ed1","cc4ddef5bbbe48ebb605141b347c4ed1",22854375,3,0,1,840,156,156,0
"cc4ddef5bbbe48ebb605141b347c4ed1","d313cec988a84645bee413e8d4724a4b",22854375,1,3,0,843,156,158,2
"d313cec988a84645bee413e8d4724a4b","f03480cf4eba413194d7af52fc0e7f28",22854375,1,-7,0,844,158,152,-6
"d313cec988a84645bee413e8d4724a4b","dc60696c76a74368a60f72246e47700d",22854375,1,1,0,849,158,159,1
"dc60696c76a74368a60f72246e47700d","dc60696c76a74368a60f72246e47700d",22854375,2,0,1,850,159,159,0
"dc60696c76a74368a60f72246e47700d","df1de691dafe4549a18a4398ee9dfaf9",22854375,1,-23,0,852,159,139,-20
"78adeee1fa2c4fe0bc73f7bca9fcee86","78adeee1fa2c4fe0bc73f7bca9fcee86",22854375,1,0,1,864,160,160,0
"65202579580f4ad38d734b4ee39d22a8","8959e6304a0348309a771e4d08d1b64a",22854375,1,-1,0,901,164,163,-1
"8959e6304a0348309a771e4d08d1b64a","65202579580f4ad38d734b4ee39d22a8",22854375,1,1,0,902,163,164,1
"3cbcea2be0984e7dbd5a48195af10ce7","0c7262dff33c4087bc660ccf40f92f9c",22854375,1,9,0,940,165,169,4
"0c7262dff33c4087bc660ccf40f92f9c","a9ac840f098c4bd0a2ee896214ce29cd",22854375,3,-4,0,941,169,168,-1
"a9ac840f098c4bd0a2ee896214ce29cd","b2275c3fad834f8d90737a2d9a6927d6",22854375,2,7,0,942,168,172,4
"a9ac840f098c4bd0a2ee896214ce29cd","a9ac840f098c4bd0a2ee896214ce29cd",22854375,1,0,1,948,168,168,0
"3cbcea2be0984e7dbd5a48195af10ce7","82e6285962b8400d9d6fc32436022a94",22854375,1,2,0,950,165,167,2
"82e6285962b8400d9d6fc32436022a94","3cbcea2be0984e7dbd5a48195af10ce7",22854375,2,-2,0,951,167,165,-2
"b2275c3fad834f8d90737a2d9a6927d6","eb515a26030b41f8a82a1e6114420bad",22854375,1,1,0,979,172,173,1
"eb515a26030b41f8a82a1e6114420bad","eb515a26030b41f8a82a1e6114420bad",22854375,2,0,1,980,173,173,0
"eb515a26030b41f8a82a1e6114420bad","b2275c3fad834f8d90737a2d9a6927d6",22854375,1,-1,0,982,173,172,-1
"b2275c3fad834f8d90737a2d9a6927d6","b2275c3fad834f8d90737a2d9a6927d6",22854375,72,0,1,1000,172,172,0
"b2275c3fad834f8d90737a2d9a6927d6","0c7262dff33c4087bc660ccf40f92f9c",22854375,6,-3,0,1045,172,169,-3
"0c7262dff33c4087bc660ccf40f92f9c","b42cc17b7de840f181a704558d0bc845",22854375,6,7,0,1046,169,175,6
"b42cc17b7de840f181a704558d0bc845","b42cc17b7de840f181a704558d0bc845",22854375,25,0,1,1047,175,175,0
"b42cc17b7de840f181a704558d0bc845","0c7262dff33c4087bc660ccf40f92f9c",22854375,4,-7,0,1048,175,169,-6
"0c7262dff33c4087bc660ccf40f92f9c","b2275c3fad834f8d90737a2d9a6927d6",22854375,5,3,0,1049,169,172,3
"b2275c3fad834f8d90737a2d9a6927d6","b42cc17b7de840f181a704558d0bc845",22854375,2,4,0,1050,172,175,3
"0c7262dff33c4087bc660ccf40f92f9c","0c7262dff33c4087bc660ccf40f92f9c",22854375,2,0,1,1052,169,169,0
"b42cc17b7de840f181a704558d0bc845","d646286c8051419bbc2e31dd1db55ca8",22854375,1,-139,0,1056,175,67,-108
"d646286c8051419bbc2e31dd1db55ca8","362fcb0699a14845ab29b2340093e528",22854375,1,138,0,1057,67,174,107
"362fcb0699a14845ab29b2340093e528","0c7262dff33c4087bc660ccf40f92f9c",22854375,1,-6,0,1058,174,169,-5
"b42cc17b7de840f181a704558d0bc845","801f9e9135034f49bf5f8b4bdefedb41",22854375,1,2,0,1087,175,177,2
"801f9e9135034f49bf5f8b4bdefedb41","801f9e9135034f49bf5f8b4bdefedb41",22854375,4,0,1,1088,177,177,0
"801f9e9135034f49bf5f8b4bdefedb41","362fcb0699a14845ab29b2340093e528",22854375,1,-3,0,1092,177,174,-3
"362fcb0699a14845ab29b2340093e528","ea38cc0e6e6e41edbabf210220808bf9",22854375,2,6,0,1093,174,179,5
"ea38cc0e6e6e41edbabf210220808bf9","b87c552dd247427abe6ab5795b9c9d43",22854375,2,2,0,1094,179,181,2
"b87c552dd247427abe6ab5795b9c9d43","ea38cc0e6e6e41edbabf210220808bf9",22854375,3,-2,0,1095,181,179,-2
"ea38cc0e6e6e41edbabf210220808bf9","ea38cc0e6e6e41edbabf210220808bf9",22854375,6,0,1,1096,179,179,0
"ea38cc0e6e6e41edbabf210220808bf9","139b097acfca451689d80c9c6eebdf7b",22854375,2,-1,0,1102,179,178,-1
"139b097acfca451689d80c9c6eebdf7b","b2275c3fad834f8d90737a2d9a6927d6",22854375,1,-8,0,1103,178,172,-6
"b42cc17b7de840f181a704558d0bc845","362fcb0699a14845ab29b2340093e528",22854375,1,-1,0,1107,175,174,-1
"362fcb0699a14845ab29b2340093e528","b87c552dd247427abe6ab5795b9c9d43",22854375,1,8,0,1108,174,181,7
"b87c552dd247427abe6ab5795b9c9d43","b87c552dd247427abe6ab5795b9c9d43",22854375,11,0,1,1111,181,181,0
"b87c552dd247427abe6ab5795b9c9d43","139b097acfca451689d80c9c6eebdf7b",22854375,1,-3,0,1122,181,178,-3
"139b097acfca451689d80c9c6eebdf7b","30f660a1feb34582a739722532524f79",22854375,1,6,0,1123,178,183,5
"30f660a1feb34582a739722532524f79","30f660a1feb34582a739722532524f79",22854375,3,0,1,1124,183,183,0
"30f660a1feb34582a739722532524f79","2024b4885bd14338a39b7b509acbbd02",22854375,1,-1,0,1127,183,182,-1
"2024b4885bd14338a39b7b509acbbd02","c3f63fe50d8e487c86bf8ef76c9cadd3",22854375,2,4,0,1128,182,185,3
"c3f63fe50d8e487c86bf8ef76c9cadd3","cf4c280bad6a43e6b131d8385ef9ef3f",22854375,1,-1,0,1129,185,184,-1
"cf4c280bad6a43e6b131d8385ef9ef3f","2024b4885bd14338a39b7b509acbbd02",22854375,1,-3,0,1130,184,182,-2
"c3f63fe50d8e487c86bf8ef76c9cadd3","c3f63fe50d8e487c86bf8ef76c9cadd3",22854375,1,0,1,1132,185,185,0
"c3f63fe50d8e487c86bf8ef76c9cadd3","0c7262dff33c4087bc660ccf40f92f9c",22854375,1,-20,0,1133,185,169,-16
"0c7262dff33c4087bc660ccf40f92f9c","c8e371568a0c4391b25796ae4e91952e",22854375,3,23,0,1134,169,186,17
"c8e371568a0c4391b25796ae4e91952e","0c7262dff33c4087bc660ccf40f92f9c",22854375,2,-23,0,1135,186,169,-17
"c8e371568a0c4391b25796ae4e91952e","c8e371568a0c4391b25796ae4e91952e",22854375,2,0,1,1137,186,186,0
"0c7262dff33c4087bc660ccf40f92f9c","7d932b23e1c84326ae5aa4d3c0d813d1",22854375,1,25,0,1139,169,188,19
"7d932b23e1c84326ae5aa4d3c0d813d1","7d932b23e1c84326ae5aa4d3c0d813d1",22854375,1,0,1,1140,188,188,0
"7d932b23e1c84326ae5aa4d3c0d813d1","ab11d94c6c8948ea90b88f19d2cd502b",22854375,1,3,0,1141,188,190,2
"ab11d94c6c8948ea90b88f19d2cd502b","c8e371568a0c4391b25796ae4e91952e",22854375,3,-5,0,1142,190,186,-4
"c8e371568a0c4391b25796ae4e91952e","ab11d94c6c8948ea90b88f19d2cd502b",22854375,4,5,0,1143,186,190,4
"ab11d94c6c8948ea90b88f19d2cd502b","ab11d94c6c8948ea90b88f19d2cd502b",22854375,18,0,1,1144,190,190,0
"ab11d94c6c8948ea90b88f19d2cd502b","f992451ed6ad4e68bb9e68ad6be7c4be",22854375,1,2,0,1161,190,192,2
"f992451ed6ad4e68bb9e68ad6be7c4be","f992451ed6ad4e68bb9e68ad6be7c4be",22854375,1,0,1,1162,192,192,0
"f992451ed6ad4e68bb9e68ad6be7c4be","07b44a7a51e94c78b411c753fc39dab0",22854375,1,-3,0,1163,192,189,-3
"07b44a7a51e94c78b411c753fc39dab0","6cd2dcaac46847d4a0bc53f296d90375",22854375,2,6,0,1164,189,194,5
"6cd2dcaac46847d4a0bc53f296d90375","6cd2dcaac46847d4a0bc53f296d90375",22854375,17,0,1,1165,194,194,0
"6cd2dcaac46847d4a0bc53f296d90375","c8e371568a0c4391b25796ae4e91952e",22854375,1,-10,0,1167,194,186,-8
"c8e371568a0c4391b25796ae4e91952e","017d7ca8e0394b91aaadc9574df2202c",22854375,1,9,0,1168,186,193,7
"017d7ca8e0394b91aaadc9574df2202c","6cd2dcaac46847d4a0bc53f296d90375",22854375,1,1,0,1169,193,194,1
"6cd2dcaac46847d4a0bc53f296d90375","2d2580c9411c4972909db508d6956a58",22854375,1,2,0,1185,194,196,2
"2d2580c9411c4972909db508d6956a58","2d2580c9411c4972909db508d6956a58",22854375,8,0,1,1186,196,196,0
"2d2580c9411c4972909db508d6956a58","5bddb3d9ed264f3984702f048c7e5340",22854375,1,1,0,1194,196,197,1
"5bddb3d9ed264f3984702f048c7e5340","5bddb3d9ed264f3984702f048c7e5340",22854375,2,0,1,1195,197,197,0
"5bddb3d9ed264f3984702f048c7e5340","d5e8e2bd12a2466b9d6d90855f0eb079",22854375,1,1,0,1197,197,198,1
"d5e8e2bd12a2466b9d6d90855f0eb079","d5e8e2bd12a2466b9d6d90855f0eb079",22854375,2,0,1,1198,198,198,0
"d5e8e2bd12a2466b9d6d90855f0eb079","017d7ca8e0394b91aaadc9574df2202c",22854375,1,-5,0,1200,198,193,-5
"017d7ca8e0394b91aaadc9574df2202c","54e8e9f0ea3e45c4bf3b8ac799ee31b1",22854375,1,8,0,1201,193,200,7
"54e8e9f0ea3e45c4bf3b8ac799ee31b1","54e8e9f0ea3e45c4bf3b8ac799ee31b1",22854375,1,0,1,1202,200,200,0
"54e8e9f0ea3e45c4bf3b8ac799ee31b1","c614a00911be4877a075f19315530fb0",22854375,1,1,0,1203,200,201,1
"c614a00911be4877a075f19315530fb0","c614a00911be4877a075f19315530fb0",22854375,6,0,1,1204,201,201,0
"c614a00911be4877a075f19315530fb0","a6c21bd8b95249c7972820a7a7d76aff",22854375,1,1,0,1210,201,202,1
"a6c21bd8b95249c7972820a7a7d76aff","bb329d880ab54120adaf203a693bb203",22854375,1,1,0,1211,202,203,1
"bb329d880ab54120adaf203a693bb203","bb329d880ab54120adaf203a693bb203",22854375,2,0,1,1212,203,203,0
"bb329d880ab54120adaf203a693bb203","a6c21bd8b95249c7972820a7a7d76aff",22854375,1,-1,0,1214,203,202,-1
"a6c21bd8b95249c7972820a7a7d76aff","a6c21bd8b95249c7972820a7a7d76aff",22854375,1,0,1,1215,202,202,0
"a6c21bd8b95249c7972820a7a7d76aff","f9170dd6bc6442b4acd832747609b09a",22854375,1,-3,0,1216,202,199,-3
"f9170dd6bc6442b4acd832747609b09a","b54257a550b94ebc9538f3a90eee9d7e",22854375,1,6,0,1217,199,204,5
"b54257a550b94ebc9538f3a90eee9d7e","ab11d94c6c8948ea90b88f19d2cd502b",22854375,1,-17,0,1218,204,190,-14
"ab11d94c6c8948ea90b88f19d2cd502b","07b44a7a51e94c78b411c753fc39dab0",22854375,1,-1,0,1221,190,189,-1
"07b44a7a51e94c78b411c753fc39dab0","c8e371568a0c4391b25796ae4e91952e",22854375,1,-4,0,1222,189,186,-3
"c8e371568a0c4391b25796ae4e91952e","6cd2dcaac46847d4a0bc53f296d90375",22854375,2,10,0,1223,186,194,8
"6cd2dcaac46847d4a0bc53f296d90375","017d7ca8e0394b91aaadc9574df2202c",22854375,2,-1,0,1224,194,193,-1
"017d7ca8e0394b91aaadc9574df2202c","334c2344009840079b1d0e1b7ce3d5a7",22854375,1,14,0,1225,193,205,12
"334c2344009840079b1d0e1b7ce3d5a7","334c2344009840079b1d0e1b7ce3d5a7",22854375,4,0,1,1226,205,205,0
"334c2344009840079b1d0e1b7ce3d5a7","c8e371568a0c4391b25796ae4e91952e",22854375,1,-23,0,1230,205,186,-19
"c8e371568a0c4391b25796ae4e91952e","d7f13c8d63ec4e2aa673fbb9cf9c6933",22854375,3,26,0,1231,186,206,20
"d7f13c8d63ec4e2aa673fbb9cf9c6933","b9e80f77c3a44349863b19875725c384",22854375,3,1,0,1232,206,207,1
"b9e80f77c3a44349863b19875725c384","7108f0e4c2584f1f9c471689ae4c885c",22854375,4,1,0,1233,207,208,1
"7108f0e4c2584f1f9c471689ae4c885c","d7f13c8d63ec4e2aa673fbb9cf9c6933",22854375,1,-2,0,1234,208,206,-2
"d7f13c8d63ec4e2aa673fbb9cf9c6933","d7f13c8d63ec4e2aa673fbb9cf9c6933",22854375,2,0,1,1235,206,206,0
"7108f0e4c2584f1f9c471689ae4c885c","b9e80f77c3a44349863b19875725c384",22854375,2,-1,0,1239,208,207,-1
"b9e80f77c3a44349863b19875725c384","b9e80f77c3a44349863b19875725c384",22854375,15,0,1,1240,207,207,0
"7108f0e4c2584f1f9c471689ae4c885c","7108f0e4c2584f1f9c471689ae4c885c",22854375,12,0,1,1256,208,208,0
"7108f0e4c2584f1f9c471689ae4c885c","09400e101c5d4b439cf9a26b03aae558",22854375,1,3,0,1268,208,210,2
"09400e101c5d4b439cf9a26b03aae558","d7f13c8d63ec4e2aa673fbb9cf9c6933",22854375,2,-5,0,1269,210,206,-4
"d7f13c8d63ec4e2aa673fbb9cf9c6933","09400e101c5d4b439cf9a26b03aae558",22854375,2,5,0,1270,206,210,4
"09400e101c5d4b439cf9a26b03aae558","09400e101c5d4b439cf9a26b03aae558",22854375,18,0,1,1271,210,210,0
"09400e101c5d4b439cf9a26b03aae558","a88efa7e50ce47159810ab553afa6d3a",22854375,1,2,0,1289,210,212,2
"a88efa7e50ce47159810ab553afa6d3a","a88efa7e50ce47159810ab553afa6d3a",22854375,2,0,1,1290,212,212,0
"a88efa7e50ce47159810ab553afa6d3a","f7fb1952f56b4189b86a9f8b7862d2b8",22854375,1,4,0,1292,212,215,3
"f7fb1952f56b4189b86a9f8b7862d2b8","a875096404ef4a9984b62d74cda916f9",22854375,1,-7,0,1293,215,209,-6
"a875096404ef4a9984b62d74cda916f9","be502a7a43c44bf7b682698de79d9369",22854375,1,6,0,1294,209,214,5
"be502a7a43c44bf7b682698de79d9369","f7fb1952f56b4189b86a9f8b7862d2b8",22854375,1,1,0,1295,214,215,1
"f7fb1952f56b4189b86a9f8b7862d2b8","f7fb1952f56b4189b86a9f8b7862d2b8",22854375,17,0,1,1296,215,215,0
"f7fb1952f56b4189b86a9f8b7862d2b8","be502a7a43c44bf7b682698de79d9369",22854375,2,-1,0,1313,215,214,-1
"be502a7a43c44bf7b682698de79d9369","be502a7a43c44bf7b682698de79d9369",22854375,25,0,1,1314,214,214,0
"be502a7a43c44bf7b682698de79d9369","b860ee85d8bc4a2f97958cfb71be3533",22854375,1,2,0,1326,214,216,2
"b860ee85d8bc4a2f97958cfb71be3533","b860ee85d8bc4a2f97958cfb71be3533",22854375,2,0,1,1327,216,216,0
"b860ee85d8bc4a2f97958cfb71be3533","be502a7a43c44bf7b682698de79d9369",22854375,1,-2,0,1329,216,214,-2
"be502a7a43c44bf7b682698de79d9369","ec341f459285443b8361f7f15638ff08",22854375,2,-1,0,1343,214,213,-1
"ec341f459285443b8361f7f15638ff08","363837c182e04711840d896ae1e0339c",22854375,2,6,0,1344,213,218,5
"363837c182e04711840d896ae1e0339c","363837c182e04711840d896ae1e0339c",22854375,13,0,1,1345,218,218,0
"363837c182e04711840d896ae1e0339c","01b2051f8941460d89945e3b02d1ce78",22854375,2,-1,0,1358,218,217,-1
"01b2051f8941460d89945e3b02d1ce78","91125ca626c5470eb145501f8c37f8db",22854375,1,4,0,1359,217,220,3
"91125ca626c5470eb145501f8c37f8db","91125ca626c5470eb145501f8c37f8db",22854375,2,0,1,1360,220,220,0
"91125ca626c5470eb145501f8c37f8db","1c6721b1f63f4d30ba7746ea8af02a52",22854375,1,3,0,1362,220,221,1
"1c6721b1f63f4d30ba7746ea8af02a52","d7f13c8d63ec4e2aa673fbb9cf9c6933",22854375,1,-21,0,1363,221,206,-15
"d7f13c8d63ec4e2aa673fbb9cf9c6933","77ecef8eff6b4a2caea7707669bf7475",22854375,1,22,0,1364,206,222,16
"77ecef8eff6b4a2caea7707669bf7475","c8e371568a0c4391b25796ae4e91952e",22854375,1,-48,0,1365,222,186,-36
"6cd2dcaac46847d4a0bc53f296d90375","07b44a7a51e94c78b411c753fc39dab0",22854375,2,-6,0,1369,194,189,-5
"07b44a7a51e94c78b411c753fc39dab0","017d7ca8e0394b91aaadc9574df2202c",22854375,1,5,0,1370,189,193,4
"017d7ca8e0394b91aaadc9574df2202c","f9170dd6bc6442b4acd832747609b09a",22854375,2,7,0,1371,193,199,6
"f9170dd6bc6442b4acd832747609b09a","c8e371568a0c4391b25796ae4e91952e",22854375,2,-16,0,1372,199,186,-13
"7108f0e4c2584f1f9c471689ae4c885c","1c6721b1f63f4d30ba7746ea8af02a52",22854375,1,19,0,1376,208,221,13
"1c6721b1f63f4d30ba7746ea8af02a52","1c6721b1f63f4d30ba7746ea8af02a52",22854375,4,0,1,1377,221,221,0
"1c6721b1f63f4d30ba7746ea8af02a52","77ecef8eff6b4a2caea7707669bf7475",22854375,6,1,0,1378,221,222,1
"77ecef8eff6b4a2caea7707669bf7475","1c6721b1f63f4d30ba7746ea8af02a52",22854375,4,-1,0,1379,222,221,-1
"77ecef8eff6b4a2caea7707669bf7475","77ecef8eff6b4a2caea7707669bf7475",22854375,13,0,1,1383,222,222,0
"1c6721b1f63f4d30ba7746ea8af02a52","8b9ae98743bd4d4a8a87dff1c1244211",22854375,1,7,0,1397,221,227,6
"8b9ae98743bd4d4a8a87dff1c1244211","d03cb855c70044cf8c35d9ec0de696e3",22854375,1,-3,0,1398,227,224,-3
"d03cb855c70044cf8c35d9ec0de696e3","d03cb855c70044cf8c35d9ec0de696e3",22854375,15,0,1,1399,224,224,0
"d03cb855c70044cf8c35d9ec0de696e3","a49a937d6896486d9a5396654abcf2e1",22854375,1,2,0,1413,224,226,2
"a49a937d6896486d9a5396654abcf2e1","a49a937d6896486d9a5396654abcf2e1",22854375,1,0,1,1414,226,226,0
"a49a937d6896486d9a5396654abcf2e1","8b9ae98743bd4d4a8a87dff1c1244211",22854375,1,1,0,1415,226,227,1
"8b9ae98743bd4d4a8a87dff1c1244211","8b9ae98743bd4d4a8a87dff1c1244211",22854375,23,0,1,1416,227,227,0
"8b9ae98743bd4d4a8a87dff1c1244211","f7906d6f59b9489a91d2ef40db5a474d",22854375,1,-4,0,1439,227,223,-4
"f7906d6f59b9489a91d2ef40db5a474d","2ab1535aac1346ba8801535bf729ef37",22854375,2,7,0,1440,223,229,6
"2ab1535aac1346ba8801535bf729ef37","2ab1535aac1346ba8801535bf729ef37",22854375,26,0,1,1441,229,229,0
"2ab1535aac1346ba8801535bf729ef37","a4f40fb48a8542c8949bae1f002cd9bc",22854375,1,2,0,1467,229,231,2
"a4f40fb48a8542c8949bae1f002cd9bc","a4f40fb48a8542c8949bae1f002cd9bc",22854375,2,0,1,1468,231,231,0
"a4f40fb48a8542c8949bae1f002cd9bc","8972c23e32044edb8a78fa1eed4e5947",22854375,1,1,0,1470,231,232,1
"8972c23e32044edb8a78fa1eed4e5947","8972c23e32044edb8a78fa1eed4e5947",22854375,1,0,1,1471,232,232,0
"8972c23e32044edb8a78fa1eed4e5947","92feb4a40f8344d38b6f722e42a53295",22854375,1,1,0,1472,232,233,1
"92feb4a40f8344d38b6f722e42a53295","92feb4a40f8344d38b6f722e42a53295",22854375,5,0,1,1473,233,233,0
"92feb4a40f8344d38b6f722e42a53295","5152833676bf4c6cb317060be10f68db",22854375,1,-5,0,1478,233,228,-5
"5152833676bf4c6cb317060be10f68db","ca3e28f290354c08aefe5b0f769604e6",22854375,1,8,0,1479,228,235,7
"ca3e28f290354c08aefe5b0f769604e6","ca3e28f290354c08aefe5b0f769604e6",22854375,9,0,1,1480,235,235,0
"ca3e28f290354c08aefe5b0f769604e6","79a35eea833e4c2c9d22fc53c3c6445c",22854375,1,1,0,1489,235,236,1
"79a35eea833e4c2c9d22fc53c3c6445c","79a35eea833e4c2c9d22fc53c3c6445c",22854375,4,0,1,1490,236,236,0
"79a35eea833e4c2c9d22fc53c3c6445c","8f68228b1518449e9615cdafee41a2bd",22854375,1,1,0,1494,236,237,1
"8f68228b1518449e9615cdafee41a2bd","8f68228b1518449e9615cdafee41a2bd",22854375,1,0,1,1495,237,237,0
"8f68228b1518449e9615cdafee41a2bd","cab89fa5c3ed45a5aa550fc0352d6a42",22854375,1,1,0,1496,237,238,1
"cab89fa5c3ed45a5aa550fc0352d6a42","cab89fa5c3ed45a5aa550fc0352d6a42",22854375,3,0,1,1497,238,238,0
"cab89fa5c3ed45a5aa550fc0352d6a42","0b04c8e2f86d48c7aeb7e225819cd32b",22854375,1,-4,0,1500,238,234,-4
"0b04c8e2f86d48c7aeb7e225819cd32b","2ab1535aac1346ba8801535bf729ef37",22854375,1,-6,0,1501,234,229,-5
"2ab1535aac1346ba8801535bf729ef37","5152833676bf4c6cb317060be10f68db",22854375,2,-1,0,1502,229,228,-1
"5152833676bf4c6cb317060be10f68db","1c6721b1f63f4d30ba7746ea8af02a52",22854375,1,-9,0,1503,228,221,-7
"77ecef8eff6b4a2caea7707669bf7475","2ab1535aac1346ba8801535bf729ef37",22854375,1,9,0,1505,222,229,7
"2ab1535aac1346ba8801535bf729ef37","1c6721b1f63f4d30ba7746ea8af02a52",22854375,1,-10,0,1506,229,221,-8
"1c6721b1f63f4d30ba7746ea8af02a52","5152833676bf4c6cb317060be10f68db",22854375,1,9,0,1507,221,228,7
"5152833676bf4c6cb317060be10f68db","66d4fad4f1cf4b46be0750a99ad7a35a",22854375,1,12,0,1508,228,239,11
"66d4fad4f1cf4b46be0750a99ad7a35a","66d4fad4f1cf4b46be0750a99ad7a35a",22854375,1,0,1,1509,239,239,0
"66d4fad4f1cf4b46be0750a99ad7a35a","0b04c8e2f86d48c7aeb7e225819cd32b",22854375,1,-5,0,1510,239,234,-5
"0b04c8e2f86d48c7aeb7e225819cd32b","1c6721b1f63f4d30ba7746ea8af02a52",22854375,2,-16,0,1511,234,221,-13
"1c6721b1f63f4d30ba7746ea8af02a52","f53da5fd9bfe412da4b80d4742563b6c",22854375,1,24,0,1514,221,241,20
"f53da5fd9bfe412da4b80d4742563b6c","f53da5fd9bfe412da4b80d4742563b6c",22854375,1,0,1,1515,241,241,0
"f53da5fd9bfe412da4b80d4742563b6c","2ae94c0cea4d480a9d5dca8fb1d7b542",22854375,1,3,0,1516,241,242,1
"2ae94c0cea4d480a9d5dca8fb1d7b542","1c6721b1f63f4d30ba7746ea8af02a52",22854375,2,-27,0,1517,242,221,-21
"1c6721b1f63f4d30ba7746ea8af02a52","1ebf23f9d994469a85206e4c7b1bf5f5",22854375,1,30,0,1518,221,245,24
"1ebf23f9d994469a85206e4c7b1bf5f5","b48100e167b24c7782f6f5ba968c9fdb",22854375,1,-2,0,1519,245,243,-2
"b48100e167b24c7782f6f5ba968c9fdb","2ae94c0cea4d480a9d5dca8fb1d7b542",22854375,1,-1,0,1520,243,242,-1
"2ae94c0cea4d480a9d5dca8fb1d7b542","b48100e167b24c7782f6f5ba968c9fdb",22854375,1,1,0,1521,242,243,1
"b48100e167b24c7782f6f5ba968c9fdb","1ebf23f9d994469a85206e4c7b1bf5f5",22854375,1,2,0,1522,243,245,2
"1ebf23f9d994469a85206e4c7b1bf5f5","2ae94c0cea4d480a9d5dca8fb1d7b542",22854375,3,-3,0,1523,245,242,-3
"2ae94c0cea4d480a9d5dca8fb1d7b542","7aa76d3e993840d8805f097cbdbcd44b",22854375,1,23,0,1524,242,261,19
"7aa76d3e993840d8805f097cbdbcd44b","d989ebcfc12a4b669f0100dc1aa14f1e",22854375,1,-7,0,1525,261,255,-6
"d989ebcfc12a4b669f0100dc1aa14f1e","7028800abe7d4e27b613d1d6cbe26bf7",22854375,1,14,0,1526,255,267,12
"7028800abe7d4e27b613d1d6cbe26bf7","00f61990949545828dd12f1303d47504",22854375,1,-13,0,1527,267,256,-11
"00f61990949545828dd12f1303d47504","d546341988904f069cfa86b21457d9d9",22854375,3,-6,0,1528,256,251,-5
"d546341988904f069cfa86b21457d9d9","fa235f0f364d47e4ae1c87f47bf8e6ba",22854375,1,1,0,1529,251,252,1
"fa235f0f364d47e4ae1c87f47bf8e6ba","6e83e23f56544a19b94067c1c558d9c0",22854375,1,-6,0,1530,252,247,-5
"6e83e23f56544a19b94067c1c558d9c0","1ebf23f9d994469a85206e4c7b1bf5f5",22854375,1,-3,0,1531,247,245,-2
"1ebf23f9d994469a85206e4c7b1bf5f5","1ebf23f9d994469a85206e4c7b1bf5f5",22854375,12,0,1,1532,245,245,0
"1ebf23f9d994469a85206e4c7b1bf5f5","85ae675b83e8422da842cfd25596af99",22854375,1,1,0,1544,245,246,1
"85ae675b83e8422da842cfd25596af99","85ae675b83e8422da842cfd25596af99",22854375,1,0,1,1545,246,246,0
"85ae675b83e8422da842cfd25596af99","2ae94c0cea4d480a9d5dca8fb1d7b542",22854375,1,-4,0,1546,246,242,-4
"2ae94c0cea4d480a9d5dca8fb1d7b542","fa235f0f364d47e4ae1c87f47bf8e6ba",22854375,1,12,0,1547,242,252,10
"fa235f0f364d47e4ae1c87f47bf8e6ba","79f7845465cc4ed19d8e4f1429541be0",22854375,1,2,0,1548,252,254,2
"79f7845465cc4ed19d8e4f1429541be0","79f7845465cc4ed19d8e4f1429541be0",22854375,2,0,1,1549,254,254,0
"79f7845465cc4ed19d8e4f1429541be0","fa235f0f364d47e4ae1c87f47bf8e6ba",22854375,1,-2,0,1551,254,252,-2
"fa235f0f364d47e4ae1c87f47bf8e6ba","fa235f0f364d47e4ae1c87f47bf8e6ba",22854375,38,0,1,1552,252,252,0
"fa235f0f364d47e4ae1c87f47bf8e6ba","00f61990949545828dd12f1303d47504",22854375,1,5,0,1590,252,256,4
"00f61990949545828dd12f1303d47504","6e83e23f56544a19b94067c1c558d9c0",22854375,2,-11,0,1591,256,247,-9
"6e83e23f56544a19b94067c1c558d9c0","ead7bb4b64e247d2ae632ab8a296b091",22854375,1,13,0,1592,247,258,11
"ead7bb4b64e247d2ae632ab8a296b091","ead7bb4b64e247d2ae632ab8a296b091",22854375,2,0,1,1593,258,258,0
"ead7bb4b64e247d2ae632ab8a296b091","41b0048dde734bb280bac6116baa8e27",22854375,1,1,0,1595,258,259,1
"41b0048dde734bb280bac6116baa8e27","41b0048dde734bb280bac6116baa8e27",22854375,2,0,1,1596,259,259,0
"41b0048dde734bb280bac6116baa8e27","b41c5a094a604ee0915327da5cc0beb7",22854375,1,1,0,1598,259,260,1
"b41c5a094a604ee0915327da5cc0beb7","b41c5a094a604ee0915327da5cc0beb7",22854375,8,0,1,1599,260,260,0
"b41c5a094a604ee0915327da5cc0beb7","d546341988904f069cfa86b21457d9d9",22854375,1,-10,0,1607,260,251,-9
"d546341988904f069cfa86b21457d9d9","00f61990949545828dd12f1303d47504",22854375,1,6,0,1608,251,256,5
"00f61990949545828dd12f1303d47504","d989ebcfc12a4b669f0100dc1aa14f1e",22854375,1,-1,0,1609,256,255,-1
"d989ebcfc12a4b669f0100dc1aa14f1e","00f61990949545828dd12f1303d47504",22854375,1,1,0,1610,255,256,1
"00f61990949545828dd12f1303d47504","00f61990949545828dd12f1303d47504",22854375,5,0,1,1611,256,256,0
"d546341988904f069cfa86b21457d9d9","28c171777c52431ab6b925073bd63d46",22854375,1,15,0,1616,251,264,13
"28c171777c52431ab6b925073bd63d46","28c171777c52431ab6b925073bd63d46",22854375,3,0,1,1617,264,264,0
"28c171777c52431ab6b925073bd63d46","ac160db940cb49ae8579162b1d52bb5d",22854375,1,2,0,1620,264,266,2
"ac160db940cb49ae8579162b1d52bb5d","ac160db940cb49ae8579162b1d52bb5d",22854375,7,0,1,1621,266,266,0
"ac160db940cb49ae8579162b1d52bb5d","d989ebcfc12a4b669f0100dc1aa14f1e",22854375,1,-12,0,1628,266,255,-11
"d989ebcfc12a4b669f0100dc1aa14f1e","44240778a97c4af0937817499b75707b",22854375,1,16,0,1629,255,269,14
"44240778a97c4af0937817499b75707b","44240778a97c4af0937817499b75707b",22854375,2,0,1,1630,269,269,0
"44240778a97c4af0937817499b75707b","c6fd49b485cc4874b0bbdd9c6171e09c",22854375,1,-1,0,1632,269,268,-1
"c6fd49b485cc4874b0bbdd9c6171e09c","c6fd49b485cc4874b0bbdd9c6171e09c",22854375,7,0,1,1633,268,268,0
"c6fd49b485cc4874b0bbdd9c6171e09c","7aa76d3e993840d8805f097cbdbcd44b",22854375,1,-8,0,1640,268,261,-7
"7aa76d3e993840d8805f097cbdbcd44b","865a4d3b43374da7944dc7d397f566d9",22854375,1,12,0,1641,261,271,10
"865a4d3b43374da7944dc7d397f566d9","865a4d3b43374da7944dc7d397f566d9",22854375,1,0,1,1642,271,271,0
"865a4d3b43374da7944dc7d397f566d9","0d987bed3ffa4ed0b9a2e62e97b7b30f",22854375,1,3,0,1643,271,272,1
"0d987bed3ffa4ed0b9a2e62e97b7b30f","2ae94c0cea4d480a9d5dca8fb1d7b542",22854375,2,-38,0,1644,272,242,-30
"2ae94c0cea4d480a9d5dca8fb1d7b542","0d987bed3ffa4ed0b9a2e62e97b7b30f",22854375,3,38,0,1645,242,272,30
"0d987bed3ffa4ed0b9a2e62e97b7b30f","bb5a47f5ea01454a8b79455422d3b9da",22854375,17,10,0,1646,272,280,8
"bb5a47f5ea01454a8b79455422d3b9da","bb5a47f5ea01454a8b79455422d3b9da",22854375,158,0,1,1647,280,280,0
"bb5a47f5ea01454a8b79455422d3b9da","82ae07bc0c9b4570a41799290d1ef399",22854375,7,-6,0,1654,280,275,-5
"82ae07bc0c9b4570a41799290d1ef399","bc5524e78a8544e2ae2fdc2f3462bbec",22854375,1,5,0,1655,275,279,4
"bc5524e78a8544e2ae2fdc2f3462bbec","0d987bed3ffa4ed0b9a2e62e97b7b30f",22854375,1,-9,0,1656,279,272,-7
"82ae07bc0c9b4570a41799290d1ef399","bb5a47f5ea01454a8b79455422d3b9da",22854375,6,6,0,1661,275,280,5
"bb5a47f5ea01454a8b79455422d3b9da","bc5524e78a8544e2ae2fdc2f3462bbec",22854375,3,-1,0,1666,280,279,-1
"bc5524e78a8544e2ae2fdc2f3462bbec","82ae07bc0c9b4570a41799290d1ef399",22854375,3,-5,0,1667,279,275,-4
"82ae07bc0c9b4570a41799290d1ef399","1c6721b1f63f4d30ba7746ea8af02a52",22854375,1,-69,0,1668,275,221,-54
"1c6721b1f63f4d30ba7746ea8af02a52","2ae94c0cea4d480a9d5dca8fb1d7b542",22854375,3,27,0,1671,221,242,21
"2ae94c0cea4d480a9d5dca8fb1d7b542","2ae94c0cea4d480a9d5dca8fb1d7b542",22854375,1,0,1,1675,242,242,0
"2ae94c0cea4d480a9d5dca8fb1d7b542","1ebf23f9d994469a85206e4c7b1bf5f5",22854375,2,3,0,1676,242,245,3
"0d987bed3ffa4ed0b9a2e62e97b7b30f","0d987bed3ffa4ed0b9a2e62e97b7b30f",22854375,4,0,1,1679,272,272,0
"0d987bed3ffa4ed0b9a2e62e97b7b30f","82ae07bc0c9b4570a41799290d1ef399",22854375,1,4,0,1680,272,275,3
"82ae07bc0c9b4570a41799290d1ef399","0d987bed3ffa4ed0b9a2e62e97b7b30f",22854375,3,-4,0,1681,275,272,-3
"bb5a47f5ea01454a8b79455422d3b9da","0d987bed3ffa4ed0b9a2e62e97b7b30f",22854375,10,-10,0,1769,280,272,-8
"bb5a47f5ea01454a8b79455422d3b9da","94cecc3f1e7d484b8e068e79241dfd73",22854375,4,3,0,1789,280,281,1
"94cecc3f1e7d484b8e068e79241dfd73","0d987bed3ffa4ed0b9a2e62e97b7b30f",22854375,4,-13,0,1790,281,272,-9
"0d987bed3ffa4ed0b9a2e62e97b7b30f","a37477c4e4c14169ad44b06b493007f6",22854375,4,15,0,1791,272,283,11
"a37477c4e4c14169ad44b06b493007f6","0d987bed3ffa4ed0b9a2e62e97b7b30f",22854375,1,-15,0,1792,283,272,-11
"0d987bed3ffa4ed0b9a2e62e97b7b30f","94cecc3f1e7d484b8e068e79241dfd73",22854375,1,13,0,1793,272,281,9
"94cecc3f1e7d484b8e068e79241dfd73","bb5a47f5ea01454a8b79455422d3b9da",22854375,1,-3,0,1794,281,280,-1
"a37477c4e4c14169ad44b06b493007f6","fab84b4fab5940efb4ea868ef8d09396",22854375,2,3,0,1861,283,284,1
"fab84b4fab5940efb4ea868ef8d09396","94cecc3f1e7d484b8e068e79241dfd73",22854375,2,-5,0,1862,284,281,-3
"94cecc3f1e7d484b8e068e79241dfd73","4a29443515bb404cb8924e1c60a63b73",22854375,2,9,0,1863,281,285,4
"4a29443515bb404cb8924e1c60a63b73","fab84b4fab5940efb4ea868ef8d09396",22854375,3,-4,0,1864,285,284,-1
"fab84b4fab5940efb4ea868ef8d09396","208c9b2796c944db8dacaa96082520ea",22854375,2,7,0,1865,284,288,4
"208c9b2796c944db8dacaa96082520ea","4a29443515bb404cb8924e1c60a63b73",22854375,3,-3,0,1866,288,285,-3
"fab84b4fab5940efb4ea868ef8d09396","fab84b4fab5940efb4ea868ef8d09396",22854375,2,0,1,1868,284,284,0
"fab84b4fab5940efb4ea868ef8d09396","4a29443515bb404cb8924e1c60a63b73",22854375,2,4,0,1869,284,285,1
"4a29443515bb404cb8924e1c60a63b73","208c9b2796c944db8dacaa96082520ea",22854375,2,3,0,1870,285,288,3
"208c9b2796c944db8dacaa96082520ea","0d987bed3ffa4ed0b9a2e62e97b7b30f",22854375,1,-25,0,1871,288,272,-16
"208c9b2796c944db8dacaa96082520ea","208c9b2796c944db8dacaa96082520ea",22854375,13,0,1,1890,288,288,0
"4a29443515bb404cb8924e1c60a63b73","7669a956527947d0add87455277e80b4",22854375,1,7,0,1903,285,291,6
"7669a956527947d0add87455277e80b4","7669a956527947d0add87455277e80b4",22854375,1,0,1,1904,291,291,0
"7669a956527947d0add87455277e80b4","869e967078f04da18dd0b0b9389a7424",22854375,1,3,0,1905,291,293,2
"869e967078f04da18dd0b0b9389a7424","6a9a3b5bde4a48daa896fe8c06eca56f",22854375,2,-5,0,1906,293,289,-4
"6a9a3b5bde4a48daa896fe8c06eca56f","869e967078f04da18dd0b0b9389a7424",22854375,2,5,0,1907,289,293,4
"869e967078f04da18dd0b0b9389a7424","869e967078f04da18dd0b0b9389a7424",22854375,31,0,1,1908,293,293,0
"869e967078f04da18dd0b0b9389a7424","51ab6291537748fab90d519aa09889d6",22854375,1,2,0,1939,293,295,2
"51ab6291537748fab90d519aa09889d6","51ab6291537748fab90d519aa09889d6",22854375,5,0,1,1940,295,295,0
"51ab6291537748fab90d519aa09889d6","34a6e49023fc4465bd5ca604330bbd1c",22854375,1,-3,0,1945,295,292,-3
"34a6e49023fc4465bd5ca604330bbd1c","21592f2a9e9c4b2f8c66ec5dbcbf6a2b",22854375,2,5,0,1946,292,296,4
"21592f2a9e9c4b2f8c66ec5dbcbf6a2b","ba0e59461bfb4a44b7b1c28a01f8d3b3",22854375,2,4,0,1947,296,299,3
"ba0e59461bfb4a44b7b1c28a01f8d3b3","ba0e59461bfb4a44b7b1c28a01f8d3b3",22854375,15,0,1,1948,299,299,0
"ba0e59461bfb4a44b7b1c28a01f8d3b3","0e0b36e731a645e7b1b8a88f5031ca38",22854375,1,2,0,1962,299,301,2
"0e0b36e731a645e7b1b8a88f5031ca38","0e0b36e731a645e7b1b8a88f5031ca38",22854375,5,0,1,1963,301,301,0
"0e0b36e731a645e7b1b8a88f5031ca38","a66a144637284c21afc6de17fea4bfb8",22854375,1,1,0,1968,301,302,1
"a66a144637284c21afc6de17fea4bfb8","a66a144637284c21afc6de17fea4bfb8",22854375,2,0,1,1969,302,302,0
"a66a144637284c21afc6de17fea4bfb8","7646a919d7e64fa990bca9b024ff089d",22854375,1,-4,0,1971,302,298,-4
"7646a919d7e64fa990bca9b024ff089d","e390b575229748ea8aac9364efe2bf00",22854375,1,7,0,1972,298,304,6
"e390b575229748ea8aac9364efe2bf00","e390b575229748ea8aac9364efe2bf00",22854375,1,0,1,1973,304,304,0
"e390b575229748ea8aac9364efe2bf00","4a29443515bb404cb8924e1c60a63b73",22854375,1,-24,0,1974,304,285,-19
"4a29443515bb404cb8924e1c60a63b73","3434c10e561d488a914e0f7d71907abd",22854375,2,27,0,1975,285,305,20
"3434c10e561d488a914e0f7d71907abd","3434c10e561d488a914e0f7d71907abd",22854375,4,0,1,1976,305,305,0
"3434c10e561d488a914e0f7d71907abd","4a29443515bb404cb8924e1c60a63b73",22854375,3,-27,0,1977,305,285,-20
"4a29443515bb404cb8924e1c60a63b73","53e7e900392747ccad52e711ab0f80d8",22854375,3,29,0,1978,285,307,22
"53e7e900392747ccad52e711ab0f80d8","4a29443515bb404cb8924e1c60a63b73",22854375,1,-29,0,1979,307,285,-22
"53e7e900392747ccad52e711ab0f80d8","3434c10e561d488a914e0f7d71907abd",22854375,2,-2,0,1984,307,305,-2
"3434c10e561d488a914e0f7d71907abd","53e7e900392747ccad52e711ab0f80d8",22854375,2,2,0,1987,305,307,2
"53e7e900392747ccad52e711ab0f80d8","53e7e900392747ccad52e711ab0f80d8",22854375,29,0,1,1988,307,307,0
"3434c10e561d488a914e0f7d71907abd","130acc2aeb0448fdbb2de63bc5cebe5b",22854375,2,5,0,2016,305,309,4
"130acc2aeb0448fdbb2de63bc5cebe5b","130acc2aeb0448fdbb2de63bc5cebe5b",22854375,16,0,1,2017,309,309,0
"130acc2aeb0448fdbb2de63bc5cebe5b","9c062b3251034ebe90f5054e2a3b5120",22854375,1,2,0,2033,309,311,2
"9c062b3251034ebe90f5054e2a3b5120","9c062b3251034ebe90f5054e2a3b5120",22854375,2,0,1,2034,311,311,0
"9c062b3251034ebe90f5054e2a3b5120","ea859f8207e44537889daeaba13ac2e8",22854375,1,1,0,2036,311,312,1
"ea859f8207e44537889daeaba13ac2e8","ea859f8207e44537889daeaba13ac2e8",22854375,9,0,1,2037,312,312,0
"ea859f8207e44537889daeaba13ac2e8","56d94971a7a94257aa330183a8ebd0ea",22854375,1,1,0,2042,312,313,1
"56d94971a7a94257aa330183a8ebd0ea","56d94971a7a94257aa330183a8ebd0ea",22854375,1,0,1,2043,313,313,0
"56d94971a7a94257aa330183a8ebd0ea","ea859f8207e44537889daeaba13ac2e8",22854375,1,-1,0,2044,313,312,-1
"ea859f8207e44537889daeaba13ac2e8","141c0df6cd1946539aadd1c9b7068cd4",22854375,1,-4,0,2049,312,308,-4
"141c0df6cd1946539aadd1c9b7068cd4","13255e63e0aa4abf85e5211bf613d43e",22854375,1,10,0,2050,308,317,9
"13255e63e0aa4abf85e5211bf613d43e","13255e63e0aa4abf85e5211bf613d43e",22854375,1,0,1,2051,317,317,0
"13255e63e0aa4abf85e5211bf613d43e","0c787d16c9504873b1a4d903cec09948",22854375,1,-3,0,2052,317,314,-3
"0c787d16c9504873b1a4d903cec09948","86c27d40179e419c8e9d150fb6afa5d0",22854375,2,6,0,2053,314,319,5
"86c27d40179e419c8e9d150fb6afa5d0","86c27d40179e419c8e9d150fb6afa5d0",22854375,23,0,1,2054,319,319,0
"86c27d40179e419c8e9d150fb6afa5d0","47edbb64109243e6b0f8f64cdef90c6c",22854375,1,8,0,2076,319,326,7
"47edbb64109243e6b0f8f64cdef90c6c","24f1363179ad4aaa965484a78471912b",22854375,4,-3,0,2077,326,323,-3
"24f1363179ad4aaa965484a78471912b","8d7e0b55cf9849cda222a0f2440cec55",22854375,3,-6,0,2078,323,318,-5
"8d7e0b55cf9849cda222a0f2440cec55","3628bdce1dd2429ba924d2d4d09448d2",22854375,1,5,0,2079,318,322,4
"3628bdce1dd2429ba924d2d4d09448d2","86c27d40179e419c8e9d150fb6afa5d0",22854375,4,-4,0,2080,322,319,-3
"86c27d40179e419c8e9d150fb6afa5d0","0c787d16c9504873b1a4d903cec09948",22854375,2,-6,0,2081,319,314,-5
"0c787d16c9504873b1a4d903cec09948","24f1363179ad4aaa965484a78471912b",22854375,1,11,0,2082,314,323,9
"24f1363179ad4aaa965484a78471912b","47edbb64109243e6b0f8f64cdef90c6c",22854375,2,3,0,2083,323,326,3
"47edbb64109243e6b0f8f64cdef90c6c","8d7e0b55cf9849cda222a0f2440cec55",22854375,1,-9,0,2084,326,318,-8
"8d7e0b55cf9849cda222a0f2440cec55","86c27d40179e419c8e9d150fb6afa5d0",22854375,1,1,0,2085,318,319,1
"86c27d40179e419c8e9d150fb6afa5d0","3628bdce1dd2429ba924d2d4d09448d2",22854375,2,4,0,2086,319,322,3
"86c27d40179e419c8e9d150fb6afa5d0","8d7e0b55cf9849cda222a0f2440cec55",22854375,2,-1,0,2089,319,318,-1
"8d7e0b55cf9849cda222a0f2440cec55","47edbb64109243e6b0f8f64cdef90c6c",22854375,3,9,0,2090,318,326,8
"24f1363179ad4aaa965484a78471912b","24f1363179ad4aaa965484a78471912b",22854375,14,0,1,2092,323,323,0
"24f1363179ad4aaa965484a78471912b","86c27d40179e419c8e9d150fb6afa5d0",22854375,1,-5,0,2093,323,319,-4
"3628bdce1dd2429ba924d2d4d09448d2","24f1363179ad4aaa965484a78471912b",22854375,1,1,0,2095,322,323,1
"47edbb64109243e6b0f8f64cdef90c6c","3628bdce1dd2429ba924d2d4d09448d2",22854375,1,-4,0,2098,326,322,-4
"86c27d40179e419c8e9d150fb6afa5d0","3434c10e561d488a914e0f7d71907abd",22854375,1,-17,0,2100,319,305,-14
"53e7e900392747ccad52e711ab0f80d8","47edbb64109243e6b0f8f64cdef90c6c",22854375,1,23,0,2102,307,326,19
"47edbb64109243e6b0f8f64cdef90c6c","3434c10e561d488a914e0f7d71907abd",22854375,1,-25,0,2103,326,305,-21
"3434c10e561d488a914e0f7d71907abd","24f1363179ad4aaa965484a78471912b",22854375,1,22,0,2104,305,323,18
"24f1363179ad4aaa965484a78471912b","3628bdce1dd2429ba924d2d4d09448d2",22854375,3,-1,0,2105,323,322,-1
"86c27d40179e419c8e9d150fb6afa5d0","24f1363179ad4aaa965484a78471912b",22854375,1,5,0,2107,319,323,4
"3628bdce1dd2429ba924d2d4d09448d2","56b3fd1a212a4764be39d979fde3326e",22854375,1,7,0,2125,322,328,6
"56b3fd1a212a4764be39d979fde3326e","56b3fd1a212a4764be39d979fde3326e",22854375,1,0,1,2126,328,328,0
"56b3fd1a212a4764be39d979fde3326e","3434c10e561d488a914e0f7d71907abd",22854375,1,-28,0,2127,328,305,-23
"3434c10e561d488a914e0f7d71907abd","0c4079457ede49e3aeb5e86ed84bdf35",22854375,1,31,0,2128,305,329,24
"0c4079457ede49e3aeb5e86ed84bdf35","38aea304b4fa46e1b29bb72f5cea4c93",22854375,4,2,0,2129,329,331,2
"38aea304b4fa46e1b29bb72f5cea4c93","0c4079457ede49e3aeb5e86ed84bdf35",22854375,4,-2,0,2130,331,329,-2
"0c4079457ede49e3aeb5e86ed84bdf35","0c4079457ede49e3aeb5e86ed84bdf35",22854375,3,0,1,2131,329,329,0
"38aea304b4fa46e1b29bb72f5cea4c93","38aea304b4fa46e1b29bb72f5cea4c93",22854375,24,0,1,2133,331,331,0
"38aea304b4fa46e1b29bb72f5cea4c93","e36d261332f14e79bb4b467aceaeb9b5",22854375,1,2,0,2155,331,333,2
"e36d261332f14e79bb4b467aceaeb9b5","e36d261332f14e79bb4b467aceaeb9b5",22854375,1,0,1,2156,333,333,0
"e36d261332f14e79bb4b467aceaeb9b5","c7e89b9d04744d2eab742fc24e3ef1ae",22854375,1,1,0,2157,333,334,1
"c7e89b9d04744d2eab742fc24e3ef1ae","c7e89b9d04744d2eab742fc24e3ef1ae",22854375,2,0,1,2158,334,334,0
"c7e89b9d04744d2eab742fc24e3ef1ae","fe49f8054b374a0ea4bb266ed135ff62",22854375,1,1,0,2160,334,335,1
"fe49f8054b374a0ea4bb266ed135ff62","fe49f8054b374a0ea4bb266ed135ff62",22854375,2,0,1,2161,335,335,0
"fe49f8054b374a0ea4bb266ed135ff62","d0a8f74af98642fe8360d22c42e45117",22854375,1,1,0,2163,335,336,1
"d0a8f74af98642fe8360d22c42e45117","d0a8f74af98642fe8360d22c42e45117",22854375,2,0,1,2164,336,336,0
"d0a8f74af98642fe8360d22c42e45117","0c4079457ede49e3aeb5e86ed84bdf35",22854375,1,-7,0,2166,336,329,-7
"0c4079457ede49e3aeb5e86ed84bdf35","a7c6339ca1da4368a18d471f0519f877",22854375,1,11,0,2167,329,339,10
"a7c6339ca1da4368a18d471f0519f877","a7c6339ca1da4368a18d471f0519f877",22854375,1,0,1,2168,339,339,0
"a7c6339ca1da4368a18d471f0519f877","b8b9418ab322418d9db9b40d96af873a",22854375,1,-2,0,2169,339,337,-2
"b8b9418ab322418d9db9b40d96af873a","bbc5139ca9024389a94db3a6f47dcff6",22854375,3,5,0,2170,337,341,4
"bbc5139ca9024389a94db3a6f47dcff6","bbc5139ca9024389a94db3a6f47dcff6",22854375,16,0,1,2171,341,341,0
"bbc5139ca9024389a94db3a6f47dcff6","4ee6ca9019ab4a1ab323f98094a9bd77",22854375,1,2,0,2186,341,343,2
"4ee6ca9019ab4a1ab323f98094a9bd77","4ee6ca9019ab4a1ab323f98094a9bd77",22854375,2,0,1,2187,343,343,0
"4ee6ca9019ab4a1ab323f98094a9bd77","b37947176785476f8b29d49a851366dc",22854375,1,1,0,2189,343,344,1
"b37947176785476f8b29d49a851366dc","b37947176785476f8b29d49a851366dc",22854375,2,0,1,2190,344,344,0
"b37947176785476f8b29d49a851366dc","fcea5b10d5a14a3b9324ffece8f6e1e5",22854375,1,1,0,2192,344,345,1
"fcea5b10d5a14a3b9324ffece8f6e1e5","fcea5b10d5a14a3b9324ffece8f6e1e5",22854375,2,0,1,2193,345,345,0
"fcea5b10d5a14a3b9324ffece8f6e1e5","c2490bc612d146edbe786556fab3651b",22854375,2,-5,0,2195,345,340,-5
"c2490bc612d146edbe786556fab3651b","4a92daef4d504e1792575a26502bb7b7",22854375,1,7,0,2196,340,346,6
"4a92daef4d504e1792575a26502bb7b7","bbc5139ca9024389a94db3a6f47dcff6",22854375,1,-6,0,2197,346,341,-5
"bbc5139ca9024389a94db3a6f47dcff6","0c4079457ede49e3aeb5e86ed84bdf35",22854375,1,-14,0,2198,341,329,-12
"0c4079457ede49e3aeb5e86ed84bdf35","bbc5139ca9024389a94db3a6f47dcff6",22854375,1,14,0,2201,329,341,12
"bbc5139ca9024389a94db3a6f47dcff6","b8b9418ab322418d9db9b40d96af873a",22854375,1,-5,0,2202,341,337,-4
"bbc5139ca9024389a94db3a6f47dcff6","fcea5b10d5a14a3b9324ffece8f6e1e5",22854375,1,4,0,2204,341,345,4
"c2490bc612d146edbe786556fab3651b","6ac8bb048b854999a47edb35fe627f11",22854375,1,8,0,2206,340,347,7
"6ac8bb048b854999a47edb35fe627f11","6ac8bb048b854999a47edb35fe627f11",22854375,1,0,1,2207,347,347,0
"6ac8bb048b854999a47edb35fe627f11","30ead9794d4847abaf222ca966cc8630",22854375,1,3,0,2208,347,348,1
"30ead9794d4847abaf222ca966cc8630","0c4079457ede49e3aeb5e86ed84bdf35",22854375,3,-24,0,2209,348,329,-19
"0c4079457ede49e3aeb5e86ed84bdf35","09b9678ddc3d452ea4a3d46e15826065",22854375,1,29,0,2210,329,353,24
"09b9678ddc3d452ea4a3d46e15826065","eff0de7f2dbb42dfa1a2e686efab5b6d",22854375,4,1,0,2211,353,354,1
"eff0de7f2dbb42dfa1a2e686efab5b6d","897b7f51242c44aab2205c72fdcbf4cd",22854375,1,-2,0,2212,354,352,-2
"897b7f51242c44aab2205c72fdcbf4cd","c20993c944444fe085345591a8bd837e",22854375,3,-1,0,2213,352,351,-1
"c20993c944444fe085345591a8bd837e","30ead9794d4847abaf222ca966cc8630",22854375,1,-3,0,2214,351,348,-3
"0c4079457ede49e3aeb5e86ed84bdf35","30ead9794d4847abaf222ca966cc8630",22854375,2,24,0,2217,329,348,19
"30ead9794d4847abaf222ca966cc8630","eff0de7f2dbb42dfa1a2e686efab5b6d",22854375,1,6,0,2218,348,354,6
"eff0de7f2dbb42dfa1a2e686efab5b6d","09b9678ddc3d452ea4a3d46e15826065",22854375,3,-1,0,2219,354,353,-1
"09b9678ddc3d452ea4a3d46e15826065","c20993c944444fe085345591a8bd837e",22854375,2,-2,0,2220,353,351,-2
"c20993c944444fe085345591a8bd837e","897b7f51242c44aab2205c72fdcbf4cd",22854375,4,1,0,2221,351,352,1
"897b7f51242c44aab2205c72fdcbf4cd","30ead9794d4847abaf222ca966cc8630",22854375,1,-4,0,2222,352,348,-4
"30ead9794d4847abaf222ca966cc8630","30ead9794d4847abaf222ca966cc8630",22854375,1,0,1,2223,348,348,0
"30ead9794d4847abaf222ca966cc8630","897b7f51242c44aab2205c72fdcbf4cd",22854375,1,4,0,2224,348,352,4
"c20993c944444fe085345591a8bd837e","09b9678ddc3d452ea4a3d46e15826065",22854375,2,2,0,2226,351,353,2
"eff0de7f2dbb42dfa1a2e686efab5b6d","c20993c944444fe085345591a8bd837e",22854375,2,-3,0,2228,354,351,-3
"c20993c944444fe085345591a8bd837e","c20993c944444fe085345591a8bd837e",22854375,5,0,1,2229,351,351,0
"897b7f51242c44aab2205c72fdcbf4cd","897b7f51242c44aab2205c72fdcbf4cd",22854375,6,0,1,2233,352,352,0
"897b7f51242c44aab2205c72fdcbf4cd","09b9678ddc3d452ea4a3d46e15826065",22854375,2,1,0,2236,352,353,1
"09b9678ddc3d452ea4a3d46e15826065","09b9678ddc3d452ea4a3d46e15826065",22854375,5,0,1,2237,353,353,0
"eff0de7f2dbb42dfa1a2e686efab5b6d","eff0de7f2dbb42dfa1a2e686efab5b6d",22854375,6,0,1,2241,354,354,0
"eff0de7f2dbb42dfa1a2e686efab5b6d","30ead9794d4847abaf222ca966cc8630",22854375,1,-6,0,2244,354,348,-6
"30ead9794d4847abaf222ca966cc8630","2fe14166dc9642c3bc666b86a57f943d",22854375,2,10,0,2245,348,357,9
"2fe14166dc9642c3bc666b86a57f943d","2fe14166dc9642c3bc666b86a57f943d",22854375,29,0,1,2246,357,357,0
"2fe14166dc9642c3bc666b86a57f943d","44421dd1e13a47a388c4a19834b744c7",22854375,1,2,0,2258,357,359,2
"44421dd1e13a47a388c4a19834b744c7","44421dd1e13a47a388c4a19834b744c7",22854375,2,0,1,2259,359,359,0
"44421dd1e13a47a388c4a19834b744c7","2fe14166dc9642c3bc666b86a57f943d",22854375,1,-2,0,2261,359,357,-2
"2fe14166dc9642c3bc666b86a57f943d","cb5fc7ef85d547c4be1a7439d0bf6052",22854375,1,3,0,2279,357,360,3
"cb5fc7ef85d547c4be1a7439d0bf6052","cb5fc7ef85d547c4be1a7439d0bf6052",22854375,5,0,1,2280,360,360,0
"cb5fc7ef85d547c4be1a7439d0bf6052","0a8f150a4cf747acbde62f4721823da3",22854375,1,1,0,2285,360,361,1
"0a8f150a4cf747acbde62f4721823da3","0a8f150a4cf747acbde62f4721823da3",22854375,2,0,1,2286,361,361,0
"0a8f150a4cf747acbde62f4721823da3","ab8fdad974ae471f9f24c3f9dd04462e",22854375,1,1,0,2288,361,362,1
"ab8fdad974ae471f9f24c3f9dd04462e","ab8fdad974ae471f9f24c3f9dd04462e",22854375,2,0,1,2289,362,362,0
"ab8fdad974ae471f9f24c3f9dd04462e","52580888dadb4fe3baa795683ea227bd",22854375,1,3,0,2291,362,364,2
"52580888dadb4fe3baa795683ea227bd","1ba8fef685d74a8194b9db252eb704fb",22854375,2,-10,0,2292,364,355,-9
"1ba8fef685d74a8194b9db252eb704fb","52580888dadb4fe3baa795683ea227bd",22854375,2,10,0,2293,355,364,9
"52580888dadb4fe3baa795683ea227bd","52580888dadb4fe3baa795683ea227bd",22854375,5,0,1,2294,364,364,0
"52580888dadb4fe3baa795683ea227bd","f00179e251a045b39c3f7a54f9aa4acc",22854375,1,-1,0,2299,364,363,-1
"f00179e251a045b39c3f7a54f9aa4acc","492a3bc6a1254f23a7998587961b22a4",22854375,2,4,0,2300,363,366,3
"492a3bc6a1254f23a7998587961b22a4","492a3bc6a1254f23a7998587961b22a4",22854375,6,0,1,2301,366,366,0
"492a3bc6a1254f23a7998587961b22a4","072a190fd302456290895f9f04d6940a",22854375,2,-1,0,2307,366,365,-1
"072a190fd302456290895f9f04d6940a","cfa457d1743848e4bb5e4beced6448ed",22854375,1,5,0,2308,365,369,4
"cfa457d1743848e4bb5e4beced6448ed","cfa457d1743848e4bb5e4beced6448ed",22854375,2,0,1,2309,369,369,0
"cfa457d1743848e4bb5e4beced6448ed","30ead9794d4847abaf222ca966cc8630",22854375,1,-25,0,2311,369,348,-21
"30ead9794d4847abaf222ca966cc8630","b71bac264efb4abd97015447bd490db6",22854375,4,28,0,2312,348,370,22
"b71bac264efb4abd97015447bd490db6","30ead9794d4847abaf222ca966cc8630",22854375,2,-28,0,2313,370,348,-22
"b71bac264efb4abd97015447bd490db6","0c4079457ede49e3aeb5e86ed84bdf35",22854375,1,-52,0,2315,370,329,-41
"30ead9794d4847abaf222ca966cc8630","c20993c944444fe085345591a8bd837e",22854375,1,3,0,2320,348,351,3
"09b9678ddc3d452ea4a3d46e15826065","897b7f51242c44aab2205c72fdcbf4cd",22854375,1,-1,0,2322,353,352,-1
"897b7f51242c44aab2205c72fdcbf4cd","eff0de7f2dbb42dfa1a2e686efab5b6d",22854375,1,2,0,2327,352,354,2
"09b9678ddc3d452ea4a3d46e15826065","30ead9794d4847abaf222ca966cc8630",22854375,1,-5,0,2332,353,348,-5
"30ead9794d4847abaf222ca966cc8630","8d448d625b024c82a5eb240bbd7431d6",22854375,1,33,0,2335,348,374,26
"8d448d625b024c82a5eb240bbd7431d6","8d448d625b024c82a5eb240bbd7431d6",22854375,103,0,1,2336,374,374,0
"8d448d625b024c82a5eb240bbd7431d6","b71bac264efb4abd97015447bd490db6",22854375,14,-5,0,2340,374,370,-4
"b71bac264efb4abd97015447bd490db6","8d448d625b024c82a5eb240bbd7431d6",22854375,14,5,0,2341,370,374,4
"b71bac264efb4abd97015447bd490db6","b71bac264efb4abd97015447bd490db6",22854375,1,0,1,2420,370,370,0
"8d448d625b024c82a5eb240bbd7431d6","1b4550d0dab04078b3bf08a655345bdc",22854375,1,-1,0,2429,374,373,-1
"1b4550d0dab04078b3bf08a655345bdc","b71bac264efb4abd97015447bd490db6",22854375,1,-4,0,2430,373,370,-3
"b71bac264efb4abd97015447bd490db6","d6d02b6ef04e4f17805504500b8ce441",22854375,3,8,0,2453,370,375,5
"d6d02b6ef04e4f17805504500b8ce441","d6d02b6ef04e4f17805504500b8ce441",22854375,29,0,1,2454,375,375,0
"d6d02b6ef04e4f17805504500b8ce441","66baf19b6b904b70922329068c63746d",22854375,2,4,0,2456,375,376,1
"66baf19b6b904b70922329068c63746d","7f544639412e40a9ba27f43b415362ab",22854375,3,2,0,2457,376,378,2
"7f544639412e40a9ba27f43b415362ab","66baf19b6b904b70922329068c63746d",22854375,2,-2,0,2458,378,376,-2
"66baf19b6b904b70922329068c63746d","d6d02b6ef04e4f17805504500b8ce441",22854375,1,-4,0,2459,376,375,-1
"d6d02b6ef04e4f17805504500b8ce441","b71bac264efb4abd97015447bd490db6",22854375,1,-8,0,2461,375,370,-5
"d6d02b6ef04e4f17805504500b8ce441","8d448d625b024c82a5eb240bbd7431d6",22854375,1,-3,0,2463,375,374,-1
"8d448d625b024c82a5eb240bbd7431d6","66baf19b6b904b70922329068c63746d",22854375,1,7,0,2471,374,376,2
"7f544639412e40a9ba27f43b415362ab","7f544639412e40a9ba27f43b415362ab",22854375,14,0,1,2473,378,378,0
"7f544639412e40a9ba27f43b415362ab","d5ae8642e15b46b8bd298b02274d4e9c",22854375,1,2,0,2486,378,380,2
"d5ae8642e15b46b8bd298b02274d4e9c","d5ae8642e15b46b8bd298b02274d4e9c",22854375,4,0,1,2487,380,380,0
"d5ae8642e15b46b8bd298b02274d4e9c","a0d10309a2dd456289147f84be9d37f9",22854375,1,1,0,2491,380,381,1
"a0d10309a2dd456289147f84be9d37f9","a0d10309a2dd456289147f84be9d37f9",22854375,2,0,1,2492,381,381,0
"a0d10309a2dd456289147f84be9d37f9","0fcbc3ca07b144138b8d85da581f09a8",22854375,1,1,0,2494,381,382,1
"0fcbc3ca07b144138b8d85da581f09a8","0fcbc3ca07b144138b8d85da581f09a8",22854375,2,0,1,2495,382,382,0
"0fcbc3ca07b144138b8d85da581f09a8","66baf19b6b904b70922329068c63746d",22854375,1,-6,0,2497,382,376,-6
"66baf19b6b904b70922329068c63746d","4890121ce5d74576b4632b77cfc23398",22854375,2,14,0,2498,376,388,12
"4890121ce5d74576b4632b77cfc23398","c2fca3669923477ab966ded303dea31c",22854375,2,-6,0,2499,388,383,-5
"c2fca3669923477ab966ded303dea31c","4890121ce5d74576b4632b77cfc23398",22854375,2,6,0,2500,383,388,5
"4890121ce5d74576b4632b77cfc23398","4890121ce5d74576b4632b77cfc23398",22854375,5,0,1,2501,388,388,0
"4890121ce5d74576b4632b77cfc23398","18d3b836dd804224883cc9180b60a8e1",22854375,2,-1,0,2506,388,387,-1
"18d3b836dd804224883cc9180b60a8e1","96bb2b3e85a34d8b9544514e89f6fe97",22854375,2,4,0,2507,387,390,3
"96bb2b3e85a34d8b9544514e89f6fe97","96bb2b3e85a34d8b9544514e89f6fe97",22854375,7,0,1,2508,390,390,0
"96bb2b3e85a34d8b9544514e89f6fe97","ac4e9b54acfe4670b4634859c7263cb5",22854375,1,2,0,2514,390,392,2
"ac4e9b54acfe4670b4634859c7263cb5","ac4e9b54acfe4670b4634859c7263cb5",22854375,3,0,1,2515,392,392,0
"ac4e9b54acfe4670b4634859c7263cb5","17f95d18bab743888e1736033dc3384d",22854375,1,-3,0,2518,392,389,-3
"17f95d18bab743888e1736033dc3384d","6f8881a745ac4c358a68b92c3b4abe81",22854375,2,6,0,2519,389,394,5
"6f8881a745ac4c358a68b92c3b4abe81","6f8881a745ac4c358a68b92c3b4abe81",22854375,15,0,1,2520,394,394,0
"6f8881a745ac4c358a68b92c3b4abe81","f7002c8484354eceac57bc7bd62c76c1",22854375,2,-1,0,2535,394,393,-1
"f7002c8484354eceac57bc7bd62c76c1","0c12af0a4e7f4002852cf84b2537c161",22854375,2,3,0,2536,393,395,2
"0c12af0a4e7f4002852cf84b2537c161","df8191ec5e584c838a899c378941a566",22854375,1,4,0,2537,395,398,3
"df8191ec5e584c838a899c378941a566","44a277ea44dc4ae689fab4b82f0b4098",22854375,1,-2,0,2538,398,397,-1
"44a277ea44dc4ae689fab4b82f0b4098","44a277ea44dc4ae689fab4b82f0b4098",22854375,3,0,1,2539,397,397,0
"44a277ea44dc4ae689fab4b82f0b4098","0c12af0a4e7f4002852cf84b2537c161",22854375,1,-2,0,2542,397,395,-2
"0c12af0a4e7f4002852cf84b2537c161","859e0b8d71694b12befb69ee698138f9",22854375,1,5,0,2543,395,399,4
"859e0b8d71694b12befb69ee698138f9","859e0b8d71694b12befb69ee698138f9",22854375,2,0,1,2544,399,399,0
"859e0b8d71694b12befb69ee698138f9","66baf19b6b904b70922329068c63746d",22854375,1,-29,0,2546,399,376,-23
"66baf19b6b904b70922329068c63746d","2b09a08242b54983aec7063990fb3f66",22854375,2,32,0,2547,376,400,24
"2b09a08242b54983aec7063990fb3f66","2b09a08242b54983aec7063990fb3f66",22854375,14,0,1,2548,400,400,0
"2b09a08242b54983aec7063990fb3f66","2add1669f08d4101913db15f8c23b3b7",22854375,1,24,0,2550,400,416,16
"2add1669f08d4101913db15f8c23b3b7","687055dad9fc40c3982478fe33ec01bf",22854375,1,-3,0,2551,416,414,-2
"687055dad9fc40c3982478fe33ec01bf","33a9d248b2e44588a5b07fc1342b9bc2",22854375,1,-4,0,2552,414,411,-3
"33a9d248b2e44588a5b07fc1342b9bc2","6a5f020451db426dacba9e2ea3fcc62a",22854375,5,-2,0,2553,411,410,-1
"6a5f020451db426dacba9e2ea3fcc62a","33a9d248b2e44588a5b07fc1342b9bc2",22854375,7,2,0,2554,410,411,1
"33a9d248b2e44588a5b07fc1342b9bc2","02b3a1bead9244c1ba2f857c7da8f82a",22854375,1,-5,0,2555,411,408,-3
"02b3a1bead9244c1ba2f857c7da8f82a","6a5f020451db426dacba9e2ea3fcc62a",22854375,3,3,0,2556,408,410,2
"6a5f020451db426dacba9e2ea3fcc62a","58fc9094275e4c49be3f4ba6d4acc0a4",22854375,1,-6,0,2557,410,406,-4
"58fc9094275e4c49be3f4ba6d4acc0a4","02b3a1bead9244c1ba2f857c7da8f82a",22854375,5,3,0,2558,406,408,2
"02b3a1bead9244c1ba2f857c7da8f82a","58fc9094275e4c49be3f4ba6d4acc0a4",22854375,4,-3,0,2559,408,406,-2
"58fc9094275e4c49be3f4ba6d4acc0a4","3c8a22d2f9c146ea956609e3ed4f2559",22854375,2,-2,0,2560,406,405,-1
"3c8a22d2f9c146ea956609e3ed4f2559","2b09a08242b54983aec7063990fb3f66",22854375,1,-7,0,2561,405,400,-5
"2b09a08242b54983aec7063990fb3f66","1157bd665ec4472fb58b751dc5099355",22854375,2,4,0,2562,400,403,3
"1157bd665ec4472fb58b751dc5099355","2b09a08242b54983aec7063990fb3f66",22854375,1,-4,0,2563,403,400,-3
"2b09a08242b54983aec7063990fb3f66","1f471b7a883a4df48211e8c6a81b59a7",22854375,1,1,0,2574,400,401,1
"1f471b7a883a4df48211e8c6a81b59a7","1f471b7a883a4df48211e8c6a81b59a7",22854375,1,0,1,2575,401,401,0
"1f471b7a883a4df48211e8c6a81b59a7","2b09a08242b54983aec7063990fb3f66",22854375,1,-1,0,2576,401,400,-1
"2b09a08242b54983aec7063990fb3f66","9de0d567bfa84fe5b77cb76f4a76a5d1",22854375,1,5,0,2577,400,404,4
"9de0d567bfa84fe5b77cb76f4a76a5d1","9de0d567bfa84fe5b77cb76f4a76a5d1",22854375,1,0,1,2578,404,404,0
"9de0d567bfa84fe5b77cb76f4a76a5d1","1157bd665ec4472fb58b751dc5099355",22854375,1,-1,0,2579,404,403,-1
"1157bd665ec4472fb58b751dc5099355","58fc9094275e4c49be3f4ba6d4acc0a4",22854375,1,5,0,2580,403,406,3
"3c8a22d2f9c146ea956609e3ed4f2559","58fc9094275e4c49be3f4ba6d4acc0a4",22854375,2,2,0,2582,405,406,1
"58fc9094275e4c49be3f4ba6d4acc0a4","58fc9094275e4c49be3f4ba6d4acc0a4",22854375,16,0,1,2583,406,406,0
"58fc9094275e4c49be3f4ba6d4acc0a4","c1c1be90b2b14c1ab4a5e1ee3c241902",22854375,1,1,0,2596,406,407,1
"c1c1be90b2b14c1ab4a5e1ee3c241902","c1c1be90b2b14c1ab4a5e1ee3c241902",22854375,5,0,1,2597,407,407,0
"c1c1be90b2b14c1ab4a5e1ee3c241902","02b3a1bead9244c1ba2f857c7da8f82a",22854375,1,2,0,2602,407,408,1
"02b3a1bead9244c1ba2f857c7da8f82a","02b3a1bead9244c1ba2f857c7da8f82a",22854375,12,0,1,2605,408,408,0
"02b3a1bead9244c1ba2f857c7da8f82a","6206fc6479014bb193084c32409dc1b9",22854375,1,1,0,2619,408,409,1
"6206fc6479014bb193084c32409dc1b9","6206fc6479014bb193084c32409dc1b9",22854375,1,0,1,2620,409,409,0
"6206fc6479014bb193084c32409dc1b9","02b3a1bead9244c1ba2f857c7da8f82a",22854375,1,-1,0,2621,409,408,-1
"6a5f020451db426dacba9e2ea3fcc62a","687055dad9fc40c3982478fe33ec01bf",22854375,1,6,0,2627,410,414,4
"687055dad9fc40c3982478fe33ec01bf","6a5f020451db426dacba9e2ea3fcc62a",22854375,1,-6,0,2628,414,410,-4
"6a5f020451db426dacba9e2ea3fcc62a","6a5f020451db426dacba9e2ea3fcc62a",22854375,5,0,1,2629,410,410,0
"33a9d248b2e44588a5b07fc1342b9bc2","33a9d248b2e44588a5b07fc1342b9bc2",22854375,16,0,1,2636,411,411,0
"33a9d248b2e44588a5b07fc1342b9bc2","c6f26bd420634f1cb7989e76fe6b16c0",22854375,1,1,0,2651,411,412,1
"c6f26bd420634f1cb7989e76fe6b16c0","c6f26bd420634f1cb7989e76fe6b16c0",22854375,5,0,1,2652,412,412,0
"c6f26bd420634f1cb7989e76fe6b16c0","2a65ee6e2ac64f6a8a55fbe5373ec763",22854375,1,1,0,2657,412,413,1
"2a65ee6e2ac64f6a8a55fbe5373ec763","2a65ee6e2ac64f6a8a55fbe5373ec763",22854375,2,0,1,2658,413,413,0
"2a65ee6e2ac64f6a8a55fbe5373ec763","33a9d248b2e44588a5b07fc1342b9bc2",22854375,1,-2,0,2660,413,411,-2
"33a9d248b2e44588a5b07fc1342b9bc2","58fc9094275e4c49be3f4ba6d4acc0a4",22854375,1,-8,0,2661,411,406,-5
"58fc9094275e4c49be3f4ba6d4acc0a4","687055dad9fc40c3982478fe33ec01bf",22854375,1,12,0,2662,406,414,8
"687055dad9fc40c3982478fe33ec01bf","58fc9094275e4c49be3f4ba6d4acc0a4",22854375,1,-12,0,2663,414,406,-8
"58fc9094275e4c49be3f4ba6d4acc0a4","1fd0f6dadbc14ebc965faf6122190b96",22854375,1,13,0,2665,406,415,9
"1fd0f6dadbc14ebc965faf6122190b96","687055dad9fc40c3982478fe33ec01bf",22854375,2,-1,0,2666,415,414,-1
"687055dad9fc40c3982478fe33ec01bf","2add1669f08d4101913db15f8c23b3b7",22854375,2,3,0,2667,414,416,2
"2add1669f08d4101913db15f8c23b3b7","1fd0f6dadbc14ebc965faf6122190b96",22854375,1,-2,0,2668,416,415,-1
"1fd0f6dadbc14ebc965faf6122190b96","1fd0f6dadbc14ebc965faf6122190b96",22854375,2,0,1,2669,415,415,0
"2add1669f08d4101913db15f8c23b3b7","2add1669f08d4101913db15f8c23b3b7",22854375,2,0,1,2673,416,416,0
"2add1669f08d4101913db15f8c23b3b7","2b09a08242b54983aec7063990fb3f66",22854375,1,-24,0,2675,416,400,-16
"2b09a08242b54983aec7063990fb3f66","a2b4bd40cee2481ebd3fc179d6a5cd62",22854375,2,27,0,2676,400,417,17
"a2b4bd40cee2481ebd3fc179d6a5cd62","a2b4bd40cee2481ebd3fc179d6a5cd62",22854375,1,0,1,2677,417,417,0
"a2b4bd40cee2481ebd3fc179d6a5cd62","bec48fc2e1294c7eb3d0aca780d731b8",22854375,4,4,0,2678,417,420,3
"bec48fc2e1294c7eb3d0aca780d731b8","bec48fc2e1294c7eb3d0aca780d731b8",22854375,9,0,1,2679,420,420,0
"bec48fc2e1294c7eb3d0aca780d731b8","dbde19fcce2a4c1abdc7f685c293a23f",22854375,1,3,0,2680,420,422,2
"dbde19fcce2a4c1abdc7f685c293a23f","a24600b0e49245f6bdba8c893cfeddb0",22854375,3,4,0,2681,422,425,3
"a24600b0e49245f6bdba8c893cfeddb0","a24600b0e49245f6bdba8c893cfeddb0",22854375,8,0,1,2682,425,425,0
"a24600b0e49245f6bdba8c893cfeddb0","24cf8786024543f19b89bc20034e60d7",22854375,3,7,0,2683,425,428,3
"24cf8786024543f19b89bc20034e60d7","a2b4bd40cee2481ebd3fc179d6a5cd62",22854375,4,-18,0,2684,428,417,-11
"a2b4bd40cee2481ebd3fc179d6a5cd62","f2a73be2f46840b182d7bd095378004e",22854375,3,19,0,2685,417,429,12
"f2a73be2f46840b182d7bd095378004e","a2b4bd40cee2481ebd3fc179d6a5cd62",22854375,2,-19,0,2686,429,417,-12
"a2b4bd40cee2481ebd3fc179d6a5cd62","e34e59dce2204f228f3a84b6725df60f",22854375,1,2,0,2687,417,419,2
"e34e59dce2204f228f3a84b6725df60f","e34e59dce2204f228f3a84b6725df60f",22854375,2,0,1,2688,419,419,0
"e34e59dce2204f228f3a84b6725df60f","a2b4bd40cee2481ebd3fc179d6a5cd62",22854375,1,-2,0,2690,419,417,-2
"bec48fc2e1294c7eb3d0aca780d731b8","a24600b0e49245f6bdba8c893cfeddb0",22854375,2,7,0,2699,420,425,5
"a24600b0e49245f6bdba8c893cfeddb0","dbde19fcce2a4c1abdc7f685c293a23f",22854375,2,-4,0,2700,425,422,-3
"a24600b0e49245f6bdba8c893cfeddb0","5d290f75e44b4bdb8256c600debbb44d",22854375,2,2,0,2702,425,426,1
"5d290f75e44b4bdb8256c600debbb44d","a24600b0e49245f6bdba8c893cfeddb0",22854375,2,-2,0,2703,426,425,-1
"f2a73be2f46840b182d7bd095378004e","24cf8786024543f19b89bc20034e60d7",22854375,4,-1,0,2713,429,428,-1
"24cf8786024543f19b89bc20034e60d7","24cf8786024543f19b89bc20034e60d7",22854375,3,0,1,2714,428,428,0
"24cf8786024543f19b89bc20034e60d7","f2a73be2f46840b182d7bd095378004e",22854375,5,1,0,2715,428,429,1
"a2b4bd40cee2481ebd3fc179d6a5cd62","24cf8786024543f19b89bc20034e60d7",22854375,2,18,0,2717,417,428,11
"24cf8786024543f19b89bc20034e60d7","a24600b0e49245f6bdba8c893cfeddb0",22854375,1,-7,0,2718,428,425,-3
"f2a73be2f46840b182d7bd095378004e","f2a73be2f46840b182d7bd095378004e",22854375,5,0,1,2724,429,429,0
"f2a73be2f46840b182d7bd095378004e","604551fd4266430cb860fef58fa7dd61",22854375,1,1,0,2727,429,430,1
"604551fd4266430cb860fef58fa7dd61","604551fd4266430cb860fef58fa7dd61",22854375,1,0,1,2728,430,430,0
"604551fd4266430cb860fef58fa7dd61","24cf8786024543f19b89bc20034e60d7",22854375,1,-2,0,2729,430,428,-2
"24cf8786024543f19b89bc20034e60d7","dce46f8904594a62a6377a3587aaa663",22854375,4,4,0,2730,428,431,3
"dce46f8904594a62a6377a3587aaa663","dce46f8904594a62a6377a3587aaa663",22854375,30,0,1,2731,431,431,0
"dce46f8904594a62a6377a3587aaa663","24cf8786024543f19b89bc20034e60d7",22854375,3,-4,0,2733,431,428,-3
"dce46f8904594a62a6377a3587aaa663","f2a73be2f46840b182d7bd095378004e",22854375,1,-3,0,2735,431,429,-2
"f2a73be2f46840b182d7bd095378004e","dce46f8904594a62a6377a3587aaa663",22854375,2,3,0,2739,429,431,2
"dce46f8904594a62a6377a3587aaa663","9b9d0a249052413c869753b99682b0ac",22854375,1,1,0,2772,431,432,1
"9b9d0a249052413c869753b99682b0ac","9b9d0a249052413c869753b99682b0ac",22854375,1,0,1,2773,432,432,0
"9b9d0a249052413c869753b99682b0ac","061c175cc90f45fbad883025394e78dd",22854375,1,1,0,2774,432,433,1
"061c175cc90f45fbad883025394e78dd","061c175cc90f45fbad883025394e78dd",22854375,6,0,1,2775,433,433,0
"061c175cc90f45fbad883025394e78dd","dce46f8904594a62a6377a3587aaa663",22854375,1,-2,0,2781,433,431,-2
"dce46f8904594a62a6377a3587aaa663","66ada10dde9f43018588f1ced9d477fc",22854375,2,4,0,2782,431,434,3
"66ada10dde9f43018588f1ced9d477fc","bf12c96466d840a69bed7020b3f18bb8",22854375,3,3,0,2783,434,436,2
"bf12c96466d840a69bed7020b3f18bb8","74a7f8712e5449c2bc0b43c6f90dafed",22854375,1,-2,0,2784,436,435,-1
"74a7f8712e5449c2bc0b43c6f90dafed","74a7f8712e5449c2bc0b43c6f90dafed",22854375,3,0,1,2785,435,435,0
"74a7f8712e5449c2bc0b43c6f90dafed","66ada10dde9f43018588f1ced9d477fc",22854375,2,-1,0,2786,435,434,-1
"bf12c96466d840a69bed7020b3f18bb8","24cf8786024543f19b89bc20034e60d7",22854375,2,-11,0,2788,436,428,-8
"a2b4bd40cee2481ebd3fc179d6a5cd62","66ada10dde9f43018588f1ced9d477fc",22854375,1,26,0,2790,417,434,17
"66ada10dde9f43018588f1ced9d477fc","24cf8786024543f19b89bc20034e60d7",22854375,2,-8,0,2791,434,428,-6
"24cf8786024543f19b89bc20034e60d7","74a7f8712e5449c2bc0b43c6f90dafed",22854375,1,9,0,2792,428,435,7
"24cf8786024543f19b89bc20034e60d7","66ada10dde9f43018588f1ced9d477fc",22854375,1,8,0,2797,428,434,6
"bf12c96466d840a69bed7020b3f18bb8","bf12c96466d840a69bed7020b3f18bb8",22854375,1,0,1,2799,436,436,0
"24cf8786024543f19b89bc20034e60d7","070600601c4c439288445d2f0724807d",22854375,2,14,0,2801,428,437,9
"070600601c4c439288445d2f0724807d","1823b6de7d334a7aaabc4570719af4d9",22854375,6,2,0,2802,437,439,2
"1823b6de7d334a7aaabc4570719af4d9","070600601c4c439288445d2f0724807d",22854375,8,-2,0,2803,439,437,-2
"070600601c4c439288445d2f0724807d","070600601c4c439288445d2f0724807d",22854375,2,0,1,2804,437,437,0
"1823b6de7d334a7aaabc4570719af4d9","1823b6de7d334a7aaabc4570719af4d9",22854375,13,0,1,2806,439,439,0
"070600601c4c439288445d2f0724807d","0380cd76a7d44bc3a4da1f15e4d68f89",22854375,3,4,0,2820,437,440,3
"0380cd76a7d44bc3a4da1f15e4d68f89","0380cd76a7d44bc3a4da1f15e4d68f89",22854375,13,0,1,2821,440,440,0
"0380cd76a7d44bc3a4da1f15e4d68f89","1823b6de7d334a7aaabc4570719af4d9",22854375,1,-2,0,2822,440,439,-1
"0380cd76a7d44bc3a4da1f15e4d68f89","23b7673c8b5443108c2ef09382834a86",22854375,4,2,0,2828,440,441,1
"23b7673c8b5443108c2ef09382834a86","0380cd76a7d44bc3a4da1f15e4d68f89",22854375,2,-2,0,2829,441,440,-1
"23b7673c8b5443108c2ef09382834a86","23b7673c8b5443108c2ef09382834a86",22854375,19,0,1,2842,441,441,0
"23b7673c8b5443108c2ef09382834a86","070600601c4c439288445d2f0724807d",22854375,2,-6,0,2843,441,437,-4
"070600601c4c439288445d2f0724807d","23b7673c8b5443108c2ef09382834a86",22854375,2,6,0,2847,437,441,4
"23b7673c8b5443108c2ef09382834a86","901e92500aea43c79f19f1b279050668",22854375,2,2,0,2868,441,442,1
"901e92500aea43c79f19f1b279050668","901e92500aea43c79f19f1b279050668",22854375,8,0,1,2869,442,442,0
"901e92500aea43c79f19f1b279050668","001339db8ced4cf78829ebe8b145449d",22854375,1,1,0,2876,442,443,1
"001339db8ced4cf78829ebe8b145449d","001339db8ced4cf78829ebe8b145449d",22854375,8,0,1,2877,443,443,0
"001339db8ced4cf78829ebe8b145449d","452745e0366e42ae81561bfddebcc6c3",22854375,1,1,0,2885,443,444,1
"452745e0366e42ae81561bfddebcc6c3","452745e0366e42ae81561bfddebcc6c3",22854375,2,0,1,2886,444,444,0
"452745e0366e42ae81561bfddebcc6c3","4660ff2089114e8db82ceb26a4f329e3",22854375,1,2,0,2888,444,445,1
"4660ff2089114e8db82ceb26a4f329e3","901e92500aea43c79f19f1b279050668",22854375,2,-4,0,2889,445,442,-3
"901e92500aea43c79f19f1b279050668","4660ff2089114e8db82ceb26a4f329e3",22854375,3,4,0,2890,442,445,3
"4660ff2089114e8db82ceb26a4f329e3","7bd5586eb9d8484eb74a433ee7bfe499",22854375,4,2,0,2891,445,446,1
"7bd5586eb9d8484eb74a433ee7bfe499","7bd5586eb9d8484eb74a433ee7bfe499",22854375,23,0,1,2892,446,446,0
"7bd5586eb9d8484eb74a433ee7bfe499","8a7f26e690f34dda97be16904518ca99",22854375,2,2,0,2893,446,447,1
"8a7f26e690f34dda97be16904518ca99","4660ff2089114e8db82ceb26a4f329e3",22854375,1,-4,0,2894,447,445,-2
"4660ff2089114e8db82ceb26a4f329e3","4660ff2089114e8db82ceb26a4f329e3",22854375,9,0,1,2895,445,445,0
"8a7f26e690f34dda97be16904518ca99","8a7f26e690f34dda97be16904518ca99",22854375,1,0,1,2928,447,447,0
"8a7f26e690f34dda97be16904518ca99","b2f0d654738f48158edff28e8d3a546e",22854375,1,5,0,2929,447,449,2
"b2f0d654738f48158edff28e8d3a546e","070600601c4c439288445d2f0724807d",22854375,3,-21,0,2930,449,437,-12
"070600601c4c439288445d2f0724807d","b2f0d654738f48158edff28e8d3a546e",22854375,2,21,0,2931,437,449,12
"b2f0d654738f48158edff28e8d3a546e","b2f0d654738f48158edff28e8d3a546e",22854375,3,0,1,2932,449,449,0
"b2f0d654738f48158edff28e8d3a546e","f60ee41ec635499abd48168342d32c2f",22854375,11,5,0,2933,449,453,4
"f60ee41ec635499abd48168342d32c2f","f60ee41ec635499abd48168342d32c2f",22854375,90,0,1,2934,453,453,0
"f60ee41ec635499abd48168342d32c2f","b2f0d654738f48158edff28e8d3a546e",22854375,10,-5,0,2939,453,449,-4
"f60ee41ec635499abd48168342d32c2f","9428d8bd9c5a47b2a235b254e5e27ded",22854375,1,-1,0,2942,453,452,-1
"9428d8bd9c5a47b2a235b254e5e27ded","24cf8786024543f19b89bc20034e60d7",22854375,1,-39,0,2943,452,428,-24
"070600601c4c439288445d2f0724807d","f60ee41ec635499abd48168342d32c2f",22854375,2,26,0,2952,437,453,16
"b2f0d654738f48158edff28e8d3a546e","f67fbf45a5f146ed866965bc57c7c001",22854375,1,8,0,3039,449,454,5
"f67fbf45a5f146ed866965bc57c7c001","f67fbf45a5f146ed866965bc57c7c001",22854375,2,0,1,3040,454,454,0
"f67fbf45a5f146ed866965bc57c7c001","d937afe49bd24a07a550dda1c1155122",22854375,1,1,0,3042,454,455,1
"d937afe49bd24a07a550dda1c1155122","d937afe49bd24a07a550dda1c1155122",22854375,1,0,1,3043,455,455,0
"d937afe49bd24a07a550dda1c1155122","3628b3f7823443d0912a339096b69943",22854375,1,1,0,3044,455,456,1
"3628b3f7823443d0912a339096b69943","3628b3f7823443d0912a339096b69943",22854375,1,0,1,3045,456,456,0
"3628b3f7823443d0912a339096b69943","9e049ee647cf43ecbcb5ed792a8e7588",22854375,1,1,0,3046,456,457,1
"9e049ee647cf43ecbcb5ed792a8e7588","9e049ee647cf43ecbcb5ed792a8e7588",22854375,1,0,1,3047,457,457,0
"9e049ee647cf43ecbcb5ed792a8e7588","5256a214faaf410b93f76cea06428334",22854375,1,1,0,3048,457,458,1
"5256a214faaf410b93f76cea06428334","5256a214faaf410b93f76cea06428334",22854375,1,0,1,3049,458,458,0
"5256a214faaf410b93f76cea06428334","25c32b120fce40fa9b6c85133aeb4716",22854375,1,1,0,3050,458,459,1
"25c32b120fce40fa9b6c85133aeb4716","25c32b120fce40fa9b6c85133aeb4716",22854375,3,0,1,3051,459,459,0
"25c32b120fce40fa9b6c85133aeb4716","11bc14f2204949008b7d511b933363c1",22854375,1,1,0,3054,459,460,1
"11bc14f2204949008b7d511b933363c1","11bc14f2204949008b7d511b933363c1",22854375,1,0,1,3055,460,460,0
"11bc14f2204949008b7d511b933363c1","42de338840a34d15adb66e7b14fb9d2c",22854375,1,1,0,3056,460,461,1
"42de338840a34d15adb66e7b14fb9d2c","42de338840a34d15adb66e7b14fb9d2c",22854375,3,0,1,3057,461,461,0
"42de338840a34d15adb66e7b14fb9d2c","9da37c6210b1416b8079c274f70bf600",22854375,1,1,0,3060,461,462,1
"9da37c6210b1416b8079c274f70bf600","9da37c6210b1416b8079c274f70bf600",22854375,1,0,1,3061,462,462,0
"9da37c6210b1416b8079c274f70bf600","519119f1deac45ff9ab4f13529be5c6e",22854375,1,1,0,3062,462,463,1
"519119f1deac45ff9ab4f13529be5c6e","519119f1deac45ff9ab4f13529be5c6e",22854375,1,0,1,3063,463,463,0
"519119f1deac45ff9ab4f13529be5c6e","c5df9f40ec14463b9dcfdc73df3e9285",22854375,1,3,0,3064,463,464,1
"c5df9f40ec14463b9dcfdc73df3e9285","f67fbf45a5f146ed866965bc57c7c001",22854375,4,-12,0,3065,464,454,-10
"f67fbf45a5f146ed866965bc57c7c001","c5df9f40ec14463b9dcfdc73df3e9285",22854375,4,12,0,3066,454,464,10
"c5df9f40ec14463b9dcfdc73df3e9285","c5df9f40ec14463b9dcfdc73df3e9285",22854375,14,0,1,3067,464,464,0
"c5df9f40ec14463b9dcfdc73df3e9285","83d42d95cd844fc093fc09cee250edb8",22854375,8,3,0,3068,464,465,1
"83d42d95cd844fc093fc09cee250edb8","83d42d95cd844fc093fc09cee250edb8",22854375,12,0,1,3069,465,465,0
"83d42d95cd844fc093fc09cee250edb8","a23ae40d7a9e4ee4828cc06415a3218c",22854375,1,-614,0,3070,465,27,-438
"a23ae40d7a9e4ee4828cc06415a3218c","b7719e26494940efa49512aedd0aac79",22854375,1,-9,0,3071,27,20,-7
"b7719e26494940efa49512aedd0aac79","d4f45188d3c84a02ba08454e6403a818",22854375,1,5,0,3072,20,24,4
"d4c3b003e8274e429d2fa688d73fde6d","5bc03c8f16354d04bd51f5bb93559ad3",22854375,1,4,0,3076,22,26,4
"5bc03c8f16354d04bd51f5bb93559ad3","b7719e26494940efa49512aedd0aac79",22854375,1,-7,0,3077,26,20,-6
"b7719e26494940efa49512aedd0aac79","fc0e049d56024bc9a02c9a9c435c3df7",22854375,1,36,0,3078,20,38,18
"64d48c6c9c7940639a932219a6c87198","fc0e049d56024bc9a02c9a9c435c3df7",22854375,1,-5,0,3083,40,38,-2
"64d48c6c9c7940639a932219a6c87198","6e83e23f56544a19b94067c1c558d9c0",22854375,1,271,0,3089,40,247,207
"6e83e23f56544a19b94067c1c558d9c0","2ae94c0cea4d480a9d5dca8fb1d7b542",22854375,1,-6,0,3090,247,242,-5
"2ae94c0cea4d480a9d5dca8fb1d7b542","30c9ba177afc49a695625d2bdec40207",22854375,1,9,0,3091,242,250,8
"30c9ba177afc49a695625d2bdec40207","30c9ba177afc49a695625d2bdec40207",22854375,2,0,1,3092,250,250,0
"30c9ba177afc49a695625d2bdec40207","00f61990949545828dd12f1303d47504",22854375,1,8,0,3094,250,256,6
"6e83e23f56544a19b94067c1c558d9c0","d6d02b6ef04e4f17805504500b8ce441",22854375,1,172,0,3096,247,375,128
"d6d02b6ef04e4f17805504500b8ce441","83d42d95cd844fc093fc09cee250edb8",22854375,1,139,0,3106,375,465,90
"83d42d95cd844fc093fc09cee250edb8","d6d02b6ef04e4f17805504500b8ce441",22854375,2,-139,0,3113,465,375,-90
"d6d02b6ef04e4f17805504500b8ce441","c5df9f40ec14463b9dcfdc73df3e9285",22854375,3,136,0,3116,375,464,89
"83d42d95cd844fc093fc09cee250edb8","c5df9f40ec14463b9dcfdc73df3e9285",22854375,4,-3,0,3122,465,464,-1
"c5df9f40ec14463b9dcfdc73df3e9285","d6d02b6ef04e4f17805504500b8ce441",22854375,1,-136,0,3125,464,375,-89
"83d42d95cd844fc093fc09cee250edb8","b2f0d654738f48158edff28e8d3a546e",22854375,1,-23,0,3154,465,449,-16
"f60ee41ec635499abd48168342d32c2f","d6d02b6ef04e4f17805504500b8ce441",22854375,1,-121,0,3165,453,375,-78
"d6d02b6ef04e4f17805504500b8ce441","4a29443515bb404cb8924e1c60a63b73",22854375,1,-118,0,3173,375,285,-90
"4a29443515bb404cb8924e1c60a63b73","93679be414554a11b1893002f2229a93",22854375,1,-339,0,3174,285,35,-250
"93679be414554a11b1893002f2229a93","d646286c8051419bbc2e31dd1db55ca8",22854375,1,50,0,3176,35,67,32
"a2becd407db34b189200a32546d9d569","a2becd407db34b189200a32546d9d569",22854375,29,0,1,3180,75,75,0
"140d5b27b8574befad82c0a013b59dfa","b534b89233134e30a9b5645138bfa9ee",22854375,3,-41,0,3182,74,41,-33
"140d5b27b8574befad82c0a013b59dfa","d18a9ea32855445f8736581f5cb119ce",22854375,3,9,0,3189,74,82,8
"d18a9ea32855445f8736581f5cb119ce","ae5ac430ea254e708a6f5deaaf7464ae",22854375,1,3,0,3190,82,84,2
"ae5ac430ea254e708a6f5deaaf7464ae","6a9f0ef185fb47f0937e29daa1c71ed5",22854375,2,7,0,3191,84,90,6
"6a9f0ef185fb47f0937e29daa1c71ed5","6a9f0ef185fb47f0937e29daa1c71ed5",22854375,5,0,1,3192,90,90,0
"d646286c8051419bbc2e31dd1db55ca8","00ae5f0c51874a73a41ebea838d95682",22854375,1,41,0,3196,67,101,34
"00ae5f0c51874a73a41ebea838d95682","e20db35ced8544ddac5bc3839145e463",22854375,2,-11,0,3197,101,91,-10
"e20db35ced8544ddac5bc3839145e463","d391c8b6e56a43a7b654e9dee02d904b",22854375,2,13,0,3198,91,103,12
"d391c8b6e56a43a7b654e9dee02d904b","00ae5f0c51874a73a41ebea838d95682",22854375,2,-2,0,3199,103,101,-2
"00ae5f0c51874a73a41ebea838d95682","4280927ec4d643238aa49c32f9e06c6c",22854375,1,9,0,3200,101,109,8
"4280927ec4d643238aa49c32f9e06c6c","73039f8c1eb9409cb4caee2cf968001e",22854375,2,-10,0,3201,109,100,-9
"73039f8c1eb9409cb4caee2cf968001e","4280927ec4d643238aa49c32f9e06c6c",22854375,2,10,0,3202,100,109,9
"4280927ec4d643238aa49c32f9e06c6c","a9ae0a3c070d455bb4369a8996313336",22854375,1,6,0,3203,109,114,5
"a9ae0a3c070d455bb4369a8996313336","08111f75e22d409998cf8b85bd431f0a",22854375,1,-7,0,3204,114,108,-6
"08111f75e22d409998cf8b85bd431f0a","62bff51286ef4f348717a3cf6fe2318f",22854375,1,14,0,3205,108,120,12
"62bff51286ef4f348717a3cf6fe2318f","37319e88176d4aefa91d7a9980dbae91",22854375,1,-9,0,3206,120,112,-8
"37319e88176d4aefa91d7a9980dbae91","62bff51286ef4f348717a3cf6fe2318f",22854375,2,9,0,3207,112,120,8
"62bff51286ef4f348717a3cf6fe2318f","62bff51286ef4f348717a3cf6fe2318f",22854375,6,0,1,3208,120,120,0
"62bff51286ef4f348717a3cf6fe2318f","779f9ddd1fd14d1e9e69f72219a1fdbd",22854375,2,3,0,3209,120,121,1
"779f9ddd1fd14d1e9e69f72219a1fdbd","e20db35ced8544ddac5bc3839145e463",22854375,3,-36,0,3210,121,91,-30
"e20db35ced8544ddac5bc3839145e463","779f9ddd1fd14d1e9e69f72219a1fdbd",22854375,3,36,0,3211,91,121,30
"779f9ddd1fd14d1e9e69f72219a1fdbd","a8dd5213034441ac92724b4e83eb0bb2",22854375,2,9,0,3212,121,129,8
"a8dd5213034441ac92724b4e83eb0bb2","a8dd5213034441ac92724b4e83eb0bb2",22854375,18,0,1,3213,129,129,0
"a8dd5213034441ac92724b4e83eb0bb2","579338175e0b4bbb8ef3b712b5d8b54e",22854375,1,-1,0,3214,129,128,-1
"579338175e0b4bbb8ef3b712b5d8b54e","b416d47c56a742199b5d7c7f19d6503a",22854375,1,7,0,3215,128,134,6
"b416d47c56a742199b5d7c7f19d6503a","779f9ddd1fd14d1e9e69f72219a1fdbd",22854375,1,-15,0,3216,134,121,-13
"779f9ddd1fd14d1e9e69f72219a1fdbd","df1de691dafe4549a18a4398ee9dfaf9",22854375,2,23,0,3217,121,139,18
"df1de691dafe4549a18a4398ee9dfaf9","6c5ad271a44743479bfaea29b1db8d02",22854375,3,4,0,3218,139,143,4
"6c5ad271a44743479bfaea29b1db8d02","6c5ad271a44743479bfaea29b1db8d02",22854375,3,0,1,3219,143,143,0
"6c5ad271a44743479bfaea29b1db8d02","8aae34f5ddbb4052a709b12e6b0d40fa",22854375,1,5,0,3220,143,147,4
"8aae34f5ddbb4052a709b12e6b0d40fa","df1de691dafe4549a18a4398ee9dfaf9",22854375,2,-9,0,3221,147,139,-8
"df1de691dafe4549a18a4398ee9dfaf9","8aae34f5ddbb4052a709b12e6b0d40fa",22854375,2,9,0,3222,139,147,8
"8aae34f5ddbb4052a709b12e6b0d40fa","f902b0f41b544d4dbf79664fd233648d",22854375,1,-1,0,3223,147,146,-1
"f902b0f41b544d4dbf79664fd233648d","f03480cf4eba413194d7af52fc0e7f28",22854375,1,7,0,3224,146,152,6
"f03480cf4eba413194d7af52fc0e7f28","d313cec988a84645bee413e8d4724a4b",22854375,2,7,0,3225,152,158,6
"d313cec988a84645bee413e8d4724a4b","d313cec988a84645bee413e8d4724a4b",22854375,5,0,1,3226,158,158,0
"d313cec988a84645bee413e8d4724a4b","df1de691dafe4549a18a4398ee9dfaf9",22854375,1,-22,0,3228,158,139,-19
"df1de691dafe4549a18a4398ee9dfaf9","78adeee1fa2c4fe0bc73f7bca9fcee86",22854375,2,26,0,3229,139,160,21
"78adeee1fa2c4fe0bc73f7bca9fcee86","65202579580f4ad38d734b4ee39d22a8",22854375,7,5,0,3230,160,164,4
"65202579580f4ad38d734b4ee39d22a8","65202579580f4ad38d734b4ee39d22a8",22854375,84,0,1,3231,164,164,0
"65202579580f4ad38d734b4ee39d22a8","78adeee1fa2c4fe0bc73f7bca9fcee86",22854375,4,-5,0,3235,164,160,-4
"65202579580f4ad38d734b4ee39d22a8","3cbcea2be0984e7dbd5a48195af10ce7",22854375,3,3,0,3239,164,165,1
"3cbcea2be0984e7dbd5a48195af10ce7","78adeee1fa2c4fe0bc73f7bca9fcee86",22854375,4,-8,0,3240,165,160,-5
"78adeee1fa2c4fe0bc73f7bca9fcee86","82e6285962b8400d9d6fc32436022a94",22854375,3,10,0,3241,160,167,7
"82e6285962b8400d9d6fc32436022a94","a9ac840f098c4bd0a2ee896214ce29cd",22854375,2,3,0,3242,167,168,1
"a9ac840f098c4bd0a2ee896214ce29cd","3cbcea2be0984e7dbd5a48195af10ce7",22854375,3,-5,0,3243,168,165,-3
"3cbcea2be0984e7dbd5a48195af10ce7","a9ac840f098c4bd0a2ee896214ce29cd",22854375,2,5,0,3244,165,168,3
"a9ac840f098c4bd0a2ee896214ce29cd","0c7262dff33c4087bc660ccf40f92f9c",22854375,2,4,0,3245,168,169,1
"b42cc17b7de840f181a704558d0bc845","b87c552dd247427abe6ab5795b9c9d43",22854375,1,7,0,3250,175,181,6
"ea38cc0e6e6e41edbabf210220808bf9","362fcb0699a14845ab29b2340093e528",22854375,1,-6,0,3252,179,174,-5
"139b097acfca451689d80c9c6eebdf7b","2024b4885bd14338a39b7b509acbbd02",22854375,1,5,0,3255,178,182,4
"2024b4885bd14338a39b7b509acbbd02","0c7262dff33c4087bc660ccf40f92f9c",22854375,1,-16,0,3256,182,169,-13
"ab11d94c6c8948ea90b88f19d2cd502b","6cd2dcaac46847d4a0bc53f296d90375",22854375,1,5,0,3261,190,194,4
"d7f13c8d63ec4e2aa673fbb9cf9c6933","7108f0e4c2584f1f9c471689ae4c885c",22854375,1,2,0,3268,206,208,2
"b9e80f77c3a44349863b19875725c384","09400e101c5d4b439cf9a26b03aae558",22854375,1,4,0,3270,207,210,3
"09400e101c5d4b439cf9a26b03aae558","be502a7a43c44bf7b682698de79d9369",22854375,1,5,0,3273,210,214,4
"be502a7a43c44bf7b682698de79d9369","a875096404ef4a9984b62d74cda916f9",22854375,1,-6,0,3274,214,209,-5
"a875096404ef4a9984b62d74cda916f9","f7fb1952f56b4189b86a9f8b7862d2b8",22854375,1,7,0,3275,209,215,6
"01b2051f8941460d89945e3b02d1ce78","d7f13c8d63ec4e2aa673fbb9cf9c6933",22854375,1,-14,0,3280,217,206,-11
"d7f13c8d63ec4e2aa673fbb9cf9c6933","1c6721b1f63f4d30ba7746ea8af02a52",22854375,1,21,0,3281,206,221,15
"77ecef8eff6b4a2caea7707669bf7475","8b9ae98743bd4d4a8a87dff1c1244211",22854375,1,6,0,3283,222,227,5
"8b9ae98743bd4d4a8a87dff1c1244211","1c6721b1f63f4d30ba7746ea8af02a52",22854375,1,-7,0,3284,227,221,-6
"1c6721b1f63f4d30ba7746ea8af02a52","d03cb855c70044cf8c35d9ec0de696e3",22854375,1,4,0,3285,221,224,3
"d03cb855c70044cf8c35d9ec0de696e3","2ab1535aac1346ba8801535bf729ef37",22854375,1,6,0,3287,224,229,5
"2ab1535aac1346ba8801535bf729ef37","f7906d6f59b9489a91d2ef40db5a474d",22854375,1,-7,0,3288,229,223,-6
"5152833676bf4c6cb317060be10f68db","0b04c8e2f86d48c7aeb7e225819cd32b",22854375,1,7,0,3291,228,234,6
"2ae94c0cea4d480a9d5dca8fb1d7b542","6e83e23f56544a19b94067c1c558d9c0",22854375,1,6,0,3296,242,247,5
"6e83e23f56544a19b94067c1c558d9c0","00f61990949545828dd12f1303d47504",22854375,1,11,0,3297,247,256,9
"d546341988904f069cfa86b21457d9d9","d989ebcfc12a4b669f0100dc1aa14f1e",22854375,1,5,0,3300,251,255,4
"d989ebcfc12a4b669f0100dc1aa14f1e","7aa76d3e993840d8805f097cbdbcd44b",22854375,1,7,0,3301,255,261,6
"7aa76d3e993840d8805f097cbdbcd44b","0d987bed3ffa4ed0b9a2e62e97b7b30f",22854375,1,15,0,3302,261,272,11
"a37477c4e4c14169ad44b06b493007f6","94cecc3f1e7d484b8e068e79241dfd73",22854375,1,-2,0,3317,283,281,-2
"94cecc3f1e7d484b8e068e79241dfd73","fab84b4fab5940efb4ea868ef8d09396",22854375,1,5,0,3318,281,284,3
"4a29443515bb404cb8924e1c60a63b73","869e967078f04da18dd0b0b9389a7424",22854375,1,10,0,3324,285,293,8
"869e967078f04da18dd0b0b9389a7424","34a6e49023fc4465bd5ca604330bbd1c",22854375,1,-1,0,3327,293,292,-1
"ba0e59461bfb4a44b7b1c28a01f8d3b3","7646a919d7e64fa990bca9b024ff089d",22854375,1,-1,0,3331,299,298,-1
"7646a919d7e64fa990bca9b024ff089d","3434c10e561d488a914e0f7d71907abd",22854375,1,10,0,3332,298,305,7
"53e7e900392747ccad52e711ab0f80d8","130acc2aeb0448fdbb2de63bc5cebe5b",22854375,1,3,0,3337,307,309,2
"130acc2aeb0448fdbb2de63bc5cebe5b","3434c10e561d488a914e0f7d71907abd",22854375,1,-5,0,3338,309,305,-4
"130acc2aeb0448fdbb2de63bc5cebe5b","141c0df6cd1946539aadd1c9b7068cd4",22854375,1,-1,0,3340,309,308,-1
"141c0df6cd1946539aadd1c9b7068cd4","86c27d40179e419c8e9d150fb6afa5d0",22854375,1,13,0,3341,308,319,11
"8d7e0b55cf9849cda222a0f2440cec55","24f1363179ad4aaa965484a78471912b",22854375,1,6,0,3345,318,323,5
"3628bdce1dd2429ba924d2d4d09448d2","0c4079457ede49e3aeb5e86ed84bdf35",22854375,1,10,0,3349,322,329,7
"0c4079457ede49e3aeb5e86ed84bdf35","3434c10e561d488a914e0f7d71907abd",22854375,1,-31,0,3350,329,305,-24
"3434c10e561d488a914e0f7d71907abd","38aea304b4fa46e1b29bb72f5cea4c93",22854375,1,33,0,3351,305,331,26
"0c4079457ede49e3aeb5e86ed84bdf35","b8b9418ab322418d9db9b40d96af873a",22854375,1,9,0,3355,329,337,8
"bbc5139ca9024389a94db3a6f47dcff6","c2490bc612d146edbe786556fab3651b",22854375,1,-1,0,3358,341,340,-1
"c2490bc612d146edbe786556fab3651b","30ead9794d4847abaf222ca966cc8630",22854375,1,11,0,3359,340,348,8
"0c4079457ede49e3aeb5e86ed84bdf35","eff0de7f2dbb42dfa1a2e686efab5b6d",22854375,1,30,0,3361,329,354,25
"c20993c944444fe085345591a8bd837e","2fe14166dc9642c3bc666b86a57f943d",22854375,1,7,0,3373,351,357,6
"2fe14166dc9642c3bc666b86a57f943d","30ead9794d4847abaf222ca966cc8630",22854375,1,-10,0,3374,357,348,-9
"2fe14166dc9642c3bc666b86a57f943d","52580888dadb4fe3baa795683ea227bd",22854375,1,8,0,3376,357,364,7
"52580888dadb4fe3baa795683ea227bd","492a3bc6a1254f23a7998587961b22a4",22854375,1,3,0,3379,364,366,2
"492a3bc6a1254f23a7998587961b22a4","f00179e251a045b39c3f7a54f9aa4acc",22854375,1,-4,0,3380,366,363,-3
"072a190fd302456290895f9f04d6940a","30ead9794d4847abaf222ca966cc8630",22854375,1,-20,0,3383,365,348,-17
"96bb2b3e85a34d8b9544514e89f6fe97","6f8881a745ac4c358a68b92c3b4abe81",22854375,1,5,0,3408,390,394,4
"6f8881a745ac4c358a68b92c3b4abe81","17f95d18bab743888e1736033dc3384d",22854375,1,-6,0,3409,394,389,-5
"0c12af0a4e7f4002852cf84b2537c161","2b09a08242b54983aec7063990fb3f66",22854375,1,8,0,3413,395,400,5
"2b09a08242b54983aec7063990fb3f66","66baf19b6b904b70922329068c63746d",22854375,1,-32,0,3414,400,376,-24
"1157bd665ec4472fb58b751dc5099355","3c8a22d2f9c146ea956609e3ed4f2559",22854375,1,3,0,3419,403,405,2
"33a9d248b2e44588a5b07fc1342b9bc2","687055dad9fc40c3982478fe33ec01bf",22854375,1,4,0,3432,411,414,3
"687055dad9fc40c3982478fe33ec01bf","2b09a08242b54983aec7063990fb3f66",22854375,1,-21,0,3433,414,400,-14
"bec48fc2e1294c7eb3d0aca780d731b8","a2b4bd40cee2481ebd3fc179d6a5cd62",22854375,1,-4,0,3436,420,417,-3
"a24600b0e49245f6bdba8c893cfeddb0","a2b4bd40cee2481ebd3fc179d6a5cd62",22854375,1,-11,0,3443,425,417,-8
"66ada10dde9f43018588f1ced9d477fc","070600601c4c439288445d2f0724807d",22854375,1,6,0,3452,434,437,3
"070600601c4c439288445d2f0724807d","24cf8786024543f19b89bc20034e60d7",22854375,1,-14,0,3453,437,428,-9
"24cf8786024543f19b89bc20034e60d7","1823b6de7d334a7aaabc4570719af4d9",22854375,1,16,0,3454,428,439,11
"7bd5586eb9d8484eb74a433ee7bfe499","4660ff2089114e8db82ceb26a4f329e3",22854375,1,-2,0,3468,446,445,-1
"7bd5586eb9d8484eb74a433ee7bfe499","b2f0d654738f48158edff28e8d3a546e",22854375,1,7,0,3470,446,449,3
"f60ee41ec635499abd48168342d32c2f","f67fbf45a5f146ed866965bc57c7c001",22854375,1,3,0,3481,453,454,1
"f67fbf45a5f146ed866965bc57c7c001","b2f0d654738f48158edff28e8d3a546e",22854375,1,-8,0,3482,454,449,-5
"b2f0d654738f48158edff28e8d3a546e","c5df9f40ec14463b9dcfdc73df3e9285",22854375,1,20,0,3483,449,464,15
"b613861cecf84ffcab01afb23f660475","e2911e79efc2420eac45d9f671463d4b",22854502,1,3,0,1,1,2,1
"e2911e79efc2420eac45d9f671463d4b","e2911e79efc2420eac45d9f671463d4b",22854502,3,0,1,2,2,2,0
"e2911e79efc2420eac45d9f671463d4b","519d1b8c59404d67b54e96c5c8a830b2",22854502,1,1,0,5,2,3,1
"519d1b8c59404d67b54e96c5c8a830b2","519d1b8c59404d67b54e96c5c8a830b2",22854502,1,0,1,6,3,3,0
"519d1b8c59404d67b54e96c5c8a830b2","531db53f81f646edb0cdcfe0085b03b7",22854502,1,1,0,7,3,4,1
"531db53f81f646edb0cdcfe0085b03b7","531db53f81f646edb0cdcfe0085b03b7",22854502,1,0,1,8,4,4,0
"531db53f81f646edb0cdcfe0085b03b7","4f5f94b2f95141e0a9d53a61da2276da",22854502,1,1,0,9,4,5,1
"4f5f94b2f95141e0a9d53a61da2276da","4f5f94b2f95141e0a9d53a61da2276da",22854502,1,0,1,10,5,5,0
"4f5f94b2f95141e0a9d53a61da2276da","6d541c89590949f99af293c4f2333f67",22854502,1,1,0,11,5,6,1
"6d541c89590949f99af293c4f2333f67","6d541c89590949f99af293c4f2333f67",22854502,1,0,1,12,6,6,0
"6d541c89590949f99af293c4f2333f67","dd5cf0b9fe4c4f1d8f5ff8e4c04879cb",22854502,1,1,0,13,6,7,1
"dd5cf0b9fe4c4f1d8f5ff8e4c04879cb","dd5cf0b9fe4c4f1d8f5ff8e4c04879cb",22854502,1,0,1,14,7,7,0
"dd5cf0b9fe4c4f1d8f5ff8e4c04879cb","f96261861edc426abe2248be4f0a709a",22854502,1,1,0,15,7,8,1
"f96261861edc426abe2248be4f0a709a","f96261861edc426abe2248be4f0a709a",22854502,1,0,1,16,8,8,0
"f96261861edc426abe2248be4f0a709a","66b5e16f4f75454fb5b8172079f0fa83",22854502,1,1,0,17,8,9,1
"66b5e16f4f75454fb5b8172079f0fa83","66b5e16f4f75454fb5b8172079f0fa83",22854502,1,0,1,18,9,9,0
"66b5e16f4f75454fb5b8172079f0fa83","9112f2bffece48e08c6d2287be204085",22854502,1,2,0,19,9,11,2
"9112f2bffece48e08c6d2287be204085","9112f2bffece48e08c6d2287be204085",22854502,1,0,1,20,11,11,0
"9112f2bffece48e08c6d2287be204085","0680571d4698477995e41842c36a54b2",22854502,1,-1,0,21,11,10,-1
"0680571d4698477995e41842c36a54b2","0680571d4698477995e41842c36a54b2",22854502,1,0,1,22,10,10,0
"0680571d4698477995e41842c36a54b2","56586aa865414f538729c7f7735d2bc6",22854502,1,4,0,23,10,12,2
"56586aa865414f538729c7f7735d2bc6","e2911e79efc2420eac45d9f671463d4b",22854502,1,-12,0,24,12,2,-10
"e2911e79efc2420eac45d9f671463d4b","56586aa865414f538729c7f7735d2bc6",22854502,1,12,0,25,2,12,10
"56586aa865414f538729c7f7735d2bc6","56586aa865414f538729c7f7735d2bc6",22854502,5,0,1,26,12,12,0
"56586aa865414f538729c7f7735d2bc6","b7f2b31585d94eb3bf86376714aa7070",22854502,1,2,0,31,12,13,1
"b7f2b31585d94eb3bf86376714aa7070","b7f2b31585d94eb3bf86376714aa7070",22854502,7,0,1,32,13,13,0
"b7f2b31585d94eb3bf86376714aa7070","3f1c815879794b929260d224becaff7e",22854502,1,2,0,39,13,14,1
"3f1c815879794b929260d224becaff7e","5c5ceeee4562457ba6d41515aeebfbb1",22854502,1,6,0,40,14,17,3
"5c5ceeee4562457ba6d41515aeebfbb1","81c864a886d54a6b8ff85f7d736f4f95",22854502,1,-4,0,41,17,15,-2
"81c864a886d54a6b8ff85f7d736f4f95","5c5ceeee4562457ba6d41515aeebfbb1",22854502,1,4,0,42,15,17,2
"5c5ceeee4562457ba6d41515aeebfbb1","5c5ceeee4562457ba6d41515aeebfbb1",22854502,5,0,1,43,17,17,0
"5c5ceeee4562457ba6d41515aeebfbb1","56586aa865414f538729c7f7735d2bc6",22854502,1,-10,0,48,17,12,-5
"56586aa865414f538729c7f7735d2bc6","9afd71a5298d4333b6849dfce1b9422c",22854502,1,13,0,49,12,18,6
"9afd71a5298d4333b6849dfce1b9422c","9afd71a5298d4333b6849dfce1b9422c",22854502,1,0,1,50,18,18,0
"9afd71a5298d4333b6849dfce1b9422c","b7719e26494940efa49512aedd0aac79",22854502,1,4,0,51,18,20,2
"b7719e26494940efa49512aedd0aac79","9afd71a5298d4333b6849dfce1b9422c",22854502,1,-4,0,52,20,18,-2
"9afd71a5298d4333b6849dfce1b9422c","d4f45188d3c84a02ba08454e6403a818",22854502,1,9,0,53,18,24,6
"d4f45188d3c84a02ba08454e6403a818","d4c3b003e8274e429d2fa688d73fde6d",22854502,1,-2,0,54,24,22,-2
"d4c3b003e8274e429d2fa688d73fde6d","d4c3b003e8274e429d2fa688d73fde6d",22854502,2,0,1,55,22,22,0
"d4c3b003e8274e429d2fa688d73fde6d","b7719e26494940efa49512aedd0aac79",22854502,1,-3,0,57,22,20,-2
"b7719e26494940efa49512aedd0aac79","afbf7250b99d47bea07172749483ca97",22854502,2,12,0,58,20,28,8
"afbf7250b99d47bea07172749483ca97","b7719e26494940efa49512aedd0aac79",22854502,1,-12,0,59,28,20,-8
"afbf7250b99d47bea07172749483ca97","4e51676dc72045d99c19b9fa7b22f8bc",22854502,3,3,0,61,28,29,1
"4e51676dc72045d99c19b9fa7b22f8bc","4e51676dc72045d99c19b9fa7b22f8bc",22854502,8,0,1,62,29,29,0
"4e51676dc72045d99c19b9fa7b22f8bc","51970cfa30e643e894e66ae85c8024cc",22854502,2,3,0,63,29,31,2
"51970cfa30e643e894e66ae85c8024cc","4e51676dc72045d99c19b9fa7b22f8bc",22854502,2,-3,0,64,31,29,-2
"4e51676dc72045d99c19b9fa7b22f8bc","c33c17be71ae4d588da7369472e5bb1b",22854502,4,9,0,65,29,34,5
"c33c17be71ae4d588da7369472e5bb1b","93679be414554a11b1893002f2229a93",22854502,3,3,0,66,34,35,1
"93679be414554a11b1893002f2229a93","c33c17be71ae4d588da7369472e5bb1b",22854502,1,-3,0,67,35,34,-1
"93679be414554a11b1893002f2229a93","7040a13096d746ac84b8fac8d9752058",22854502,2,3,0,69,35,36,1
"fc0e049d56024bc9a02c9a9c435c3df7","afbf7250b99d47bea07172749483ca97",22854502,1,-24,0,74,38,28,-10
"afbf7250b99d47bea07172749483ca97","afbf7250b99d47bea07172749483ca97",22854502,3,0,1,75,28,28,0
"4e51676dc72045d99c19b9fa7b22f8bc","afbf7250b99d47bea07172749483ca97",22854502,1,-3,0,79,29,28,-1
"c33c17be71ae4d588da7369472e5bb1b","c9c52446b6294aa5a9c2abaed536c37e",22854502,1,-4,0,85,34,32,-2
"c9c52446b6294aa5a9c2abaed536c37e","4e51676dc72045d99c19b9fa7b22f8bc",22854502,1,-5,0,86,32,29,-3
"c33c17be71ae4d588da7369472e5bb1b","4e51676dc72045d99c19b9fa7b22f8bc",22854502,1,-9,0,88,34,29,-5
"c33c17be71ae4d588da7369472e5bb1b","c33c17be71ae4d588da7369472e5bb1b",22854502,1,0,1,96,34,34,0
"93679be414554a11b1893002f2229a93","93679be414554a11b1893002f2229a93",22854502,1,0,1,98,35,35,0
"7040a13096d746ac84b8fac8d9752058","7040a13096d746ac84b8fac8d9752058",22854502,2,0,1,100,36,36,0
"7040a13096d746ac84b8fac8d9752058","9a0dc646f934470daf08c4b56ccf73db",22854502,2,3,0,101,36,37,1
"9a0dc646f934470daf08c4b56ccf73db","9a0dc646f934470daf08c4b56ccf73db",22854502,2,0,1,102,37,37,0
"9a0dc646f934470daf08c4b56ccf73db","fc0e049d56024bc9a02c9a9c435c3df7",22854502,2,3,0,103,37,38,1
"fc0e049d56024bc9a02c9a9c435c3df7","67a089198fcb4e1c8f2385786c2b296f",22854502,1,4,0,104,38,39,1
"67a089198fcb4e1c8f2385786c2b296f","67a089198fcb4e1c8f2385786c2b296f",22854502,2,0,1,105,39,39,0
"67a089198fcb4e1c8f2385786c2b296f","64d48c6c9c7940639a932219a6c87198",22854502,2,1,0,106,39,40,1
"64d48c6c9c7940639a932219a6c87198","64d48c6c9c7940639a932219a6c87198",22854502,13,0,1,107,40,40,0
"64d48c6c9c7940639a932219a6c87198","67a089198fcb4e1c8f2385786c2b296f",22854502,2,-1,0,120,40,39,-1
"67a089198fcb4e1c8f2385786c2b296f","b534b89233134e30a9b5645138bfa9ee",22854502,2,4,0,121,39,41,2
"b534b89233134e30a9b5645138bfa9ee","b534b89233134e30a9b5645138bfa9ee",22854502,1,0,1,122,41,41,0
"b534b89233134e30a9b5645138bfa9ee","67a089198fcb4e1c8f2385786c2b296f",22854502,1,-4,0,123,41,39,-2
"67a089198fcb4e1c8f2385786c2b296f","0e37b720d23b4e7f8b313e79313fd107",22854502,1,7,0,124,39,44,5
"0e37b720d23b4e7f8b313e79313fd107","0e37b720d23b4e7f8b313e79313fd107",22854502,1,0,1,125,44,44,0
"0e37b720d23b4e7f8b313e79313fd107","6875d67fdd5f48168b62719df449bebd",22854502,1,1,0,126,44,45,1
"6875d67fdd5f48168b62719df449bebd","6875d67fdd5f48168b62719df449bebd",22854502,1,0,1,127,45,45,0
"6875d67fdd5f48168b62719df449bebd","b534b89233134e30a9b5645138bfa9ee",22854502,1,-4,0,128,45,41,-4
"b534b89233134e30a9b5645138bfa9ee","6e13d61a7bdb44bca949c9f86fab3be5",22854502,1,7,0,129,41,47,6
"6e13d61a7bdb44bca949c9f86fab3be5","6e13d61a7bdb44bca949c9f86fab3be5",22854502,7,0,1,130,47,47,0
"6e13d61a7bdb44bca949c9f86fab3be5","195f78799f984cc2b06c48dfe36be751",22854502,1,2,0,137,47,49,2
"195f78799f984cc2b06c48dfe36be751","195f78799f984cc2b06c48dfe36be751",22854502,2,0,1,138,49,49,0
"195f78799f984cc2b06c48dfe36be751","d0c74f735e024943943e40333d6d337f",22854502,1,3,0,140,49,51,2
"d0c74f735e024943943e40333d6d337f","d9c8d8c444a64dadbbb508652c721e17",22854502,1,-6,0,141,51,46,-5
"d9c8d8c444a64dadbbb508652c721e17","d0c74f735e024943943e40333d6d337f",22854502,1,6,0,142,46,51,5
"d0c74f735e024943943e40333d6d337f","d0c74f735e024943943e40333d6d337f",22854502,2,0,1,143,51,51,0
"d0c74f735e024943943e40333d6d337f","983f8ff320594b279a7f4a6fe132f9c5",22854502,1,2,0,145,51,53,2
"983f8ff320594b279a7f4a6fe132f9c5","983f8ff320594b279a7f4a6fe132f9c5",22854502,2,0,1,146,53,53,0
"983f8ff320594b279a7f4a6fe132f9c5","35adfa5d923046aebabfefd98f35ff05",22854502,1,1,0,148,53,54,1
"35adfa5d923046aebabfefd98f35ff05","35adfa5d923046aebabfefd98f35ff05",22854502,2,0,1,149,54,54,0
"35adfa5d923046aebabfefd98f35ff05","b6f8a98476224da1b40e555ececc7ed8",22854502,1,1,0,151,54,55,1
"b6f8a98476224da1b40e555ececc7ed8","b6f8a98476224da1b40e555ececc7ed8",22854502,2,0,1,152,55,55,0
"b6f8a98476224da1b40e555ececc7ed8","86e22cb5fe0e4b47a9489ecddf7ed78f",22854502,1,1,0,154,55,56,1
"86e22cb5fe0e4b47a9489ecddf7ed78f","86e22cb5fe0e4b47a9489ecddf7ed78f",22854502,2,0,1,155,56,56,0
"86e22cb5fe0e4b47a9489ecddf7ed78f","f924752d8a1149668870b1e7698486f7",22854502,1,-6,0,157,56,50,-6
"f924752d8a1149668870b1e7698486f7","78f30e4dcac84e3cbea8b2cc6e0d62b3",22854502,1,10,0,158,50,59,9
"78f30e4dcac84e3cbea8b2cc6e0d62b3","a1f2f12debe5432fb7a70bcd12bacfb9",22854502,1,-1,0,159,59,58,-1
"a1f2f12debe5432fb7a70bcd12bacfb9","a1f2f12debe5432fb7a70bcd12bacfb9",22854502,28,0,1,160,58,58,0
"a1f2f12debe5432fb7a70bcd12bacfb9","78f30e4dcac84e3cbea8b2cc6e0d62b3",22854502,1,1,0,188,58,59,1
"78f30e4dcac84e3cbea8b2cc6e0d62b3","78f30e4dcac84e3cbea8b2cc6e0d62b3",22854502,11,0,1,189,59,59,0
"78f30e4dcac84e3cbea8b2cc6e0d62b3","bc42d26810654ea9a1df1efe1e58c7d5",22854502,1,5,0,200,59,63,4
"bc42d26810654ea9a1df1efe1e58c7d5","a0a418b8540d479fa6e0f653b701da8b",22854502,2,1,0,201,63,64,1
"a0a418b8540d479fa6e0f653b701da8b","12aa6e1672ac4e7aa6449a7a8609cd72",22854502,1,-8,0,202,64,57,-7
"12aa6e1672ac4e7aa6449a7a8609cd72","4c943503763e4e349906eea3ed3c8e86",22854502,1,5,0,203,57,61,4
"4c943503763e4e349906eea3ed3c8e86","4c943503763e4e349906eea3ed3c8e86",22854502,1,0,1,204,61,61,0
"4c943503763e4e349906eea3ed3c8e86","bc42d26810654ea9a1df1efe1e58c7d5",22854502,1,2,0,205,61,63,2
"bc42d26810654ea9a1df1efe1e58c7d5","bc42d26810654ea9a1df1efe1e58c7d5",22854502,3,0,1,206,63,63,0
"a0a418b8540d479fa6e0f653b701da8b","a0a418b8540d479fa6e0f653b701da8b",22854502,3,0,1,210,64,64,0
"a0a418b8540d479fa6e0f653b701da8b","309ccf3cc4fe429d9bfbaef53d3fa479",22854502,1,-4,0,213,64,60,-4
"309ccf3cc4fe429d9bfbaef53d3fa479","b534b89233134e30a9b5645138bfa9ee",22854502,1,-23,0,214,60,41,-19
"b534b89233134e30a9b5645138bfa9ee","d646286c8051419bbc2e31dd1db55ca8",22854502,2,33,0,215,41,67,26
"d646286c8051419bbc2e31dd1db55ca8","67a089198fcb4e1c8f2385786c2b296f",22854502,2,-37,0,216,67,39,-28
"67a089198fcb4e1c8f2385786c2b296f","d646286c8051419bbc2e31dd1db55ca8",22854502,2,37,0,217,39,67,28
"d646286c8051419bbc2e31dd1db55ca8","d646286c8051419bbc2e31dd1db55ca8",22854502,2,0,1,218,67,67,0
"d646286c8051419bbc2e31dd1db55ca8","267f883678b24aed855fde42524975d9",22854502,2,4,0,219,67,71,4
"267f883678b24aed855fde42524975d9","267f883678b24aed855fde42524975d9",22854502,3,0,1,220,71,71,0
"267f883678b24aed855fde42524975d9","88fff56d0342490dbef9040750a20f6c",22854502,1,1,0,221,71,72,1
"88fff56d0342490dbef9040750a20f6c","88fff56d0342490dbef9040750a20f6c",22854502,1,0,1,222,72,72,0
"88fff56d0342490dbef9040750a20f6c","adb17b12b66c4a49a85fd34322f7df70",22854502,1,1,0,223,72,73,1
"adb17b12b66c4a49a85fd34322f7df70","adb17b12b66c4a49a85fd34322f7df70",22854502,1,0,1,224,73,73,0
"adb17b12b66c4a49a85fd34322f7df70","a2becd407db34b189200a32546d9d569",22854502,1,3,0,225,73,75,2
"a2becd407db34b189200a32546d9d569","d646286c8051419bbc2e31dd1db55ca8",22854502,1,-9,0,226,75,67,-8
"d646286c8051419bbc2e31dd1db55ca8","140d5b27b8574befad82c0a013b59dfa",22854502,1,8,0,231,67,74,7
"140d5b27b8574befad82c0a013b59dfa","a2becd407db34b189200a32546d9d569",22854502,1,1,0,232,74,75,1
"a2becd407db34b189200a32546d9d569","a2becd407db34b189200a32546d9d569",22854502,12,0,1,233,75,75,0
"a2becd407db34b189200a32546d9d569","58c22b011d0f4c2ea6d13615edbb9eeb",22854502,1,2,0,245,75,77,2
"58c22b011d0f4c2ea6d13615edbb9eeb","58c22b011d0f4c2ea6d13615edbb9eeb",22854502,11,0,1,246,77,77,0
"58c22b011d0f4c2ea6d13615edbb9eeb","dd76e1861dc9461c830888729d091ee0",22854502,1,1,0,257,77,78,1
"dd76e1861dc9461c830888729d091ee0","dd76e1861dc9461c830888729d091ee0",22854502,5,0,1,258,78,78,0
"dd76e1861dc9461c830888729d091ee0","cd1d828f1a694b87913a7ea66c23803e",22854502,1,1,0,263,78,79,1
"cd1d828f1a694b87913a7ea66c23803e","cd1d828f1a694b87913a7ea66c23803e",22854502,2,0,1,264,79,79,0
"cd1d828f1a694b87913a7ea66c23803e","9176a3c2b4d2465fa8b0c67096c2a97e",22854502,1,1,0,266,79,80,1
"9176a3c2b4d2465fa8b0c67096c2a97e","9176a3c2b4d2465fa8b0c67096c2a97e",22854502,5,0,1,267,80,80,0
"9176a3c2b4d2465fa8b0c67096c2a97e","f8ec6445f7194e25b9101d4fbcb07a18",22854502,1,1,0,272,80,81,1
"f8ec6445f7194e25b9101d4fbcb07a18","f8ec6445f7194e25b9101d4fbcb07a18",22854502,2,0,1,273,81,81,0
"f8ec6445f7194e25b9101d4fbcb07a18","140d5b27b8574befad82c0a013b59dfa",22854502,1,-7,0,275,81,74,-7
"140d5b27b8574befad82c0a013b59dfa","d18a9ea32855445f8736581f5cb119ce",22854502,1,9,0,276,74,82,8
"d18a9ea32855445f8736581f5cb119ce","f564483cbd7a407681aa2fcca518cf5f",22854502,1,4,0,277,82,85,3
"f564483cbd7a407681aa2fcca518cf5f","f564483cbd7a407681aa2fcca518cf5f",22854502,1,0,1,278,85,85,0
"f564483cbd7a407681aa2fcca518cf5f","18fd01350bd5434ca636d59a599d768a",22854502,1,1,0,279,85,86,1
"18fd01350bd5434ca636d59a599d768a","18fd01350bd5434ca636d59a599d768a",22854502,9,0,1,280,86,86,0
"18fd01350bd5434ca636d59a599d768a","6a9f0ef185fb47f0937e29daa1c71ed5",22854502,1,5,0,289,86,90,4
"6a9f0ef185fb47f0937e29daa1c71ed5","ae5ac430ea254e708a6f5deaaf7464ae",22854502,2,-7,0,290,90,84,-6
"ae5ac430ea254e708a6f5deaaf7464ae","c681290961c94c4caf23b529d1ae6b9a",22854502,1,5,0,291,84,88,4
"c681290961c94c4caf23b529d1ae6b9a","c681290961c94c4caf23b529d1ae6b9a",22854502,2,0,1,292,88,88,0
"c681290961c94c4caf23b529d1ae6b9a","6a9f0ef185fb47f0937e29daa1c71ed5",22854502,1,2,0,294,88,90,2
"6a9f0ef185fb47f0937e29daa1c71ed5","6a9f0ef185fb47f0937e29daa1c71ed5",22854502,4,0,1,295,90,90,0
"6a9f0ef185fb47f0937e29daa1c71ed5","e20db35ced8544ddac5bc3839145e463",22854502,1,3,0,298,90,91,1
"e20db35ced8544ddac5bc3839145e463","d646286c8051419bbc2e31dd1db55ca8",22854502,2,-30,0,299,91,67,-24
"d646286c8051419bbc2e31dd1db55ca8","1febb706d7a34005ae8711ed49c76e64",22854502,1,33,0,300,67,94,27
"1febb706d7a34005ae8711ed49c76e64","1febb706d7a34005ae8711ed49c76e64",22854502,2,0,1,301,94,94,0
"1febb706d7a34005ae8711ed49c76e64","8f73ba6f5a0042f2850356ac38ac6f24",22854502,1,1,0,303,94,95,1
"8f73ba6f5a0042f2850356ac38ac6f24","8f73ba6f5a0042f2850356ac38ac6f24",22854502,2,0,1,304,95,95,0
"8f73ba6f5a0042f2850356ac38ac6f24","e2260b86653c46d7b14a41fb419dbf8c",22854502,1,1,0,306,95,96,1
"e2260b86653c46d7b14a41fb419dbf8c","e2260b86653c46d7b14a41fb419dbf8c",22854502,2,0,1,307,96,96,0
"e2260b86653c46d7b14a41fb419dbf8c","35eb641ad1d845bbba54915bce75a962",22854502,1,1,0,309,96,97,1
"35eb641ad1d845bbba54915bce75a962","35eb641ad1d845bbba54915bce75a962",22854502,5,0,1,310,97,97,0
"35eb641ad1d845bbba54915bce75a962","08be90ffbeea4795a138cd42ed8db56f",22854502,1,1,0,315,97,98,1
"08be90ffbeea4795a138cd42ed8db56f","08be90ffbeea4795a138cd42ed8db56f",22854502,5,0,1,316,98,98,0
"08be90ffbeea4795a138cd42ed8db56f","3007433c8f584dcbb5ac159c1c5f2be3",22854502,1,1,0,321,98,99,1
"3007433c8f584dcbb5ac159c1c5f2be3","3007433c8f584dcbb5ac159c1c5f2be3",22854502,5,0,1,322,99,99,0
"3007433c8f584dcbb5ac159c1c5f2be3","d391c8b6e56a43a7b654e9dee02d904b",22854502,1,5,0,327,99,103,4
"d391c8b6e56a43a7b654e9dee02d904b","e20db35ced8544ddac5bc3839145e463",22854502,1,-13,0,328,103,91,-12
"e20db35ced8544ddac5bc3839145e463","00ae5f0c51874a73a41ebea838d95682",22854502,1,11,0,329,91,101,10
"00ae5f0c51874a73a41ebea838d95682","ae5ac430ea254e708a6f5deaaf7464ae",22854502,1,-21,0,330,101,84,-17
"ae5ac430ea254e708a6f5deaaf7464ae","d646286c8051419bbc2e31dd1db55ca8",22854502,2,-20,0,331,84,67,-17
"d646286c8051419bbc2e31dd1db55ca8","6a9f0ef185fb47f0937e29daa1c71ed5",22854502,1,27,0,332,67,90,23
"ae5ac430ea254e708a6f5deaaf7464ae","6a9f0ef185fb47f0937e29daa1c71ed5",22854502,1,7,0,335,84,90,6
"6a9f0ef185fb47f0937e29daa1c71ed5","67a089198fcb4e1c8f2385786c2b296f",22854502,1,-64,0,336,90,39,-51
"67a089198fcb4e1c8f2385786c2b296f","00ae5f0c51874a73a41ebea838d95682",22854502,1,78,0,337,39,101,62
"00ae5f0c51874a73a41ebea838d95682","00ae5f0c51874a73a41ebea838d95682",22854502,3,0,1,338,101,101,0
"00ae5f0c51874a73a41ebea838d95682","d391c8b6e56a43a7b654e9dee02d904b",22854502,2,2,0,341,101,103,2
"d391c8b6e56a43a7b654e9dee02d904b","d391c8b6e56a43a7b654e9dee02d904b",22854502,17,0,1,342,103,103,0
"d391c8b6e56a43a7b654e9dee02d904b","6111116566fc4fd9abba409322bea245",22854502,1,1,0,359,103,104,1
"6111116566fc4fd9abba409322bea245","6111116566fc4fd9abba409322bea245",22854502,2,0,1,360,104,104,0
"6111116566fc4fd9abba409322bea245","a81b2235cb9c499eb9ea8ee0a8dd9725",22854502,1,1,0,362,104,105,1
"a81b2235cb9c499eb9ea8ee0a8dd9725","a81b2235cb9c499eb9ea8ee0a8dd9725",22854502,2,0,1,363,105,105,0
"a81b2235cb9c499eb9ea8ee0a8dd9725","2d4e0ab0ef3b4d73b82c72d4621a7579",22854502,1,1,0,365,105,106,1
"2d4e0ab0ef3b4d73b82c72d4621a7579","2d4e0ab0ef3b4d73b82c72d4621a7579",22854502,2,0,1,366,106,106,0
"2d4e0ab0ef3b4d73b82c72d4621a7579","8bdebf492ebd4e62b0d522e8ab5e5197",22854502,1,1,0,368,106,107,1
"8bdebf492ebd4e62b0d522e8ab5e5197","8bdebf492ebd4e62b0d522e8ab5e5197",22854502,2,0,1,369,107,107,0
"8bdebf492ebd4e62b0d522e8ab5e5197","4280927ec4d643238aa49c32f9e06c6c",22854502,1,3,0,371,107,109,2
"4280927ec4d643238aa49c32f9e06c6c","73039f8c1eb9409cb4caee2cf968001e",22854502,1,-10,0,372,109,100,-9
"73039f8c1eb9409cb4caee2cf968001e","08111f75e22d409998cf8b85bd431f0a",22854502,1,9,0,373,100,108,8
"08111f75e22d409998cf8b85bd431f0a","00ae5f0c51874a73a41ebea838d95682",22854502,1,-8,0,374,108,101,-7
"d391c8b6e56a43a7b654e9dee02d904b","00ae5f0c51874a73a41ebea838d95682",22854502,1,-2,0,376,103,101,-2
"00ae5f0c51874a73a41ebea838d95682","73039f8c1eb9409cb4caee2cf968001e",22854502,1,-1,0,377,101,100,-1
"73039f8c1eb9409cb4caee2cf968001e","4280927ec4d643238aa49c32f9e06c6c",22854502,1,10,0,378,100,109,9
"4280927ec4d643238aa49c32f9e06c6c","4280927ec4d643238aa49c32f9e06c6c",22854502,3,0,1,379,109,109,0
"4280927ec4d643238aa49c32f9e06c6c","fc44e6a5f7654430af1227838224dceb",22854502,1,2,0,382,109,111,2
"fc44e6a5f7654430af1227838224dceb","fc44e6a5f7654430af1227838224dceb",22854502,5,0,1,383,111,111,0
"fc44e6a5f7654430af1227838224dceb","08111f75e22d409998cf8b85bd431f0a",22854502,1,-3,0,388,111,108,-3
"08111f75e22d409998cf8b85bd431f0a","a9ae0a3c070d455bb4369a8996313336",22854502,1,7,0,389,108,114,6
"a9ae0a3c070d455bb4369a8996313336","a9ae0a3c070d455bb4369a8996313336",22854502,1,0,1,390,114,114,0
"a9ae0a3c070d455bb4369a8996313336","71cec822bcff4f30a20e75dc63ef7b65",22854502,1,2,0,391,114,116,2
"71cec822bcff4f30a20e75dc63ef7b65","71cec822bcff4f30a20e75dc63ef7b65",22854502,3,0,1,392,116,116,0
"71cec822bcff4f30a20e75dc63ef7b65","37319e88176d4aefa91d7a9980dbae91",22854502,1,-4,0,395,116,112,-4
"37319e88176d4aefa91d7a9980dbae91","62bff51286ef4f348717a3cf6fe2318f",22854502,1,9,0,396,112,120,8
"62bff51286ef4f348717a3cf6fe2318f","b1cd0e7dc3ad4a8eb91a4bfdbeb025b0",22854502,1,-2,0,397,120,118,-2
"b1cd0e7dc3ad4a8eb91a4bfdbeb025b0","b1cd0e7dc3ad4a8eb91a4bfdbeb025b0",22854502,1,0,1,398,118,118,0
"b1cd0e7dc3ad4a8eb91a4bfdbeb025b0","62bff51286ef4f348717a3cf6fe2318f",22854502,1,2,0,399,118,120,2
"62bff51286ef4f348717a3cf6fe2318f","62bff51286ef4f348717a3cf6fe2318f",22854502,3,0,1,400,120,120,0
"62bff51286ef4f348717a3cf6fe2318f","779f9ddd1fd14d1e9e69f72219a1fdbd",22854502,1,3,0,403,120,121,1
"779f9ddd1fd14d1e9e69f72219a1fdbd","e20db35ced8544ddac5bc3839145e463",22854502,1,-36,0,404,121,91,-30
"267f883678b24aed855fde42524975d9","67a089198fcb4e1c8f2385786c2b296f",22854502,1,-41,0,410,71,39,-32
"d646286c8051419bbc2e31dd1db55ca8","64d48c6c9c7940639a932219a6c87198",22854502,1,-36,0,414,67,40,-27
"64d48c6c9c7940639a932219a6c87198","ae26e6cda8ad4a3f81bd347560d9579f",22854502,1,106,0,415,40,125,85
"ae26e6cda8ad4a3f81bd347560d9579f","ae26e6cda8ad4a3f81bd347560d9579f",22854502,1,0,1,416,125,125,0
"ae26e6cda8ad4a3f81bd347560d9579f","ee48df95832b4374aa273ceb27ec1315",22854502,1,1,0,417,125,126,1
"ee48df95832b4374aa273ceb27ec1315","ee48df95832b4374aa273ceb27ec1315",22854502,1,0,1,418,126,126,0
"ee48df95832b4374aa273ceb27ec1315","7a439da90b394756ad1777fc4c6dead5",22854502,1,1,0,419,126,127,1
"7a439da90b394756ad1777fc4c6dead5","7a439da90b394756ad1777fc4c6dead5",22854502,1,0,1,420,127,127,0
"7a439da90b394756ad1777fc4c6dead5","779f9ddd1fd14d1e9e69f72219a1fdbd",22854502,1,-6,0,421,127,121,-6
"779f9ddd1fd14d1e9e69f72219a1fdbd","a8dd5213034441ac92724b4e83eb0bb2",22854502,1,9,0,422,121,129,8
"a8dd5213034441ac92724b4e83eb0bb2","a8dd5213034441ac92724b4e83eb0bb2",22854502,2,0,1,423,129,129,0
"a8dd5213034441ac92724b4e83eb0bb2","8115eab6556b45f5b415c3b8c26a12e5",22854502,1,2,0,425,129,131,2
"8115eab6556b45f5b415c3b8c26a12e5","8115eab6556b45f5b415c3b8c26a12e5",22854502,2,0,1,426,131,131,0
"8115eab6556b45f5b415c3b8c26a12e5","ec34b06efd844b46a4c4818ecdb9b8f4",22854502,1,1,0,428,131,132,1
"ec34b06efd844b46a4c4818ecdb9b8f4","ec34b06efd844b46a4c4818ecdb9b8f4",22854502,8,0,1,429,132,132,0
"ec34b06efd844b46a4c4818ecdb9b8f4","c2e1c2b9eac64109b343a088584b576b",22854502,1,1,0,437,132,133,1
"c2e1c2b9eac64109b343a088584b576b","c2e1c2b9eac64109b343a088584b576b",22854502,2,0,1,438,133,133,0
"c2e1c2b9eac64109b343a088584b576b","579338175e0b4bbb8ef3b712b5d8b54e",22854502,1,-5,0,440,133,128,-5
"579338175e0b4bbb8ef3b712b5d8b54e","8bc5795d6a984a3eace4e2811e52dd4f",22854502,1,8,0,441,128,135,7
"8bc5795d6a984a3eace4e2811e52dd4f","8bc5795d6a984a3eace4e2811e52dd4f",22854502,1,0,1,442,135,135,0
"8bc5795d6a984a3eace4e2811e52dd4f","b416d47c56a742199b5d7c7f19d6503a",22854502,1,-1,0,443,135,134,-1
"b416d47c56a742199b5d7c7f19d6503a","cd4532ad48034873ba8bce2aac0c9808",22854502,1,4,0,444,134,137,3
"cd4532ad48034873ba8bce2aac0c9808","cd4532ad48034873ba8bce2aac0c9808",22854502,1,0,1,445,137,137,0
"cd4532ad48034873ba8bce2aac0c9808","df1de691dafe4549a18a4398ee9dfaf9",22854502,1,4,0,446,137,139,2
"df1de691dafe4549a18a4398ee9dfaf9","779f9ddd1fd14d1e9e69f72219a1fdbd",22854502,1,-23,0,447,139,121,-18
"779f9ddd1fd14d1e9e69f72219a1fdbd","779f9ddd1fd14d1e9e69f72219a1fdbd",22854502,1,0,1,448,121,121,0
"779f9ddd1fd14d1e9e69f72219a1fdbd","df1de691dafe4549a18a4398ee9dfaf9",22854502,1,23,0,449,121,139,18
"df1de691dafe4549a18a4398ee9dfaf9","6c5ad271a44743479bfaea29b1db8d02",22854502,1,4,0,450,139,143,4
"6c5ad271a44743479bfaea29b1db8d02","6c5ad271a44743479bfaea29b1db8d02",22854502,1,0,1,451,143,143,0
"6c5ad271a44743479bfaea29b1db8d02","83d311bed5374fee83d8d67a7d9d82dc",22854502,1,1,0,452,143,144,1
"83d311bed5374fee83d8d67a7d9d82dc","83d311bed5374fee83d8d67a7d9d82dc",22854502,1,0,1,453,144,144,0
"83d311bed5374fee83d8d67a7d9d82dc","402bba41861d43acb52a5abb89e8831e",22854502,1,1,0,454,144,145,1
"402bba41861d43acb52a5abb89e8831e","402bba41861d43acb52a5abb89e8831e",22854502,2,0,1,455,145,145,0
"402bba41861d43acb52a5abb89e8831e","8aae34f5ddbb4052a709b12e6b0d40fa",22854502,1,3,0,457,145,147,2
"8aae34f5ddbb4052a709b12e6b0d40fa","df1de691dafe4549a18a4398ee9dfaf9",22854502,1,-9,0,458,147,139,-8
"df1de691dafe4549a18a4398ee9dfaf9","8aae34f5ddbb4052a709b12e6b0d40fa",22854502,1,9,0,459,139,147,8
"8aae34f5ddbb4052a709b12e6b0d40fa","67a089198fcb4e1c8f2385786c2b296f",22854502,1,-135,0,460,147,39,-108
"67a089198fcb4e1c8f2385786c2b296f","8aae34f5ddbb4052a709b12e6b0d40fa",22854502,1,135,0,461,39,147,108
"8aae34f5ddbb4052a709b12e6b0d40fa","645b3f0249f64f76af2e19eb4d0e55b7",22854502,1,2,0,462,147,149,2
"645b3f0249f64f76af2e19eb4d0e55b7","645b3f0249f64f76af2e19eb4d0e55b7",22854502,2,0,1,463,149,149,0
"645b3f0249f64f76af2e19eb4d0e55b7","7e7b8db5064d4369805ab370aac5ddfb",22854502,1,1,0,465,149,150,1
"7e7b8db5064d4369805ab370aac5ddfb","7e7b8db5064d4369805ab370aac5ddfb",22854502,2,0,1,466,150,150,0
"7e7b8db5064d4369805ab370aac5ddfb","8956d210ae7f41968fada86d4c979d6a",22854502,1,1,0,468,150,151,1
"8956d210ae7f41968fada86d4c979d6a","8956d210ae7f41968fada86d4c979d6a",22854502,2,0,1,469,151,151,0
"8956d210ae7f41968fada86d4c979d6a","8aae34f5ddbb4052a709b12e6b0d40fa",22854502,1,-4,0,471,151,147,-4
"8aae34f5ddbb4052a709b12e6b0d40fa","f902b0f41b544d4dbf79664fd233648d",22854502,1,-1,0,472,147,146,-1
"f902b0f41b544d4dbf79664fd233648d","ae781e8b775e4ccd93bc800dad5c8376",22854502,1,8,0,473,146,153,7
"ae781e8b775e4ccd93bc800dad5c8376","ae781e8b775e4ccd93bc800dad5c8376",22854502,2,0,1,474,153,153,0
"ae781e8b775e4ccd93bc800dad5c8376","06882a8492d9499aa31555567f575ecb",22854502,1,1,0,476,153,154,1
"06882a8492d9499aa31555567f575ecb","06882a8492d9499aa31555567f575ecb",22854502,1,0,1,477,154,154,0
"06882a8492d9499aa31555567f575ecb","f293c508f409466a8f27ddd7d1e40b20",22854502,1,1,0,478,154,155,1
"f293c508f409466a8f27ddd7d1e40b20","f293c508f409466a8f27ddd7d1e40b20",22854502,2,0,1,479,155,155,0
"f293c508f409466a8f27ddd7d1e40b20","cc4ddef5bbbe48ebb605141b347c4ed1",22854502,1,1,0,481,155,156,1
"cc4ddef5bbbe48ebb605141b347c4ed1","cc4ddef5bbbe48ebb605141b347c4ed1",22854502,3,0,1,482,156,156,0
"cc4ddef5bbbe48ebb605141b347c4ed1","f03480cf4eba413194d7af52fc0e7f28",22854502,1,-4,0,485,156,152,-4
"f03480cf4eba413194d7af52fc0e7f28","d313cec988a84645bee413e8d4724a4b",22854502,1,7,0,486,152,158,6
"d313cec988a84645bee413e8d4724a4b","d313cec988a84645bee413e8d4724a4b",22854502,4,0,1,487,158,158,0
"d313cec988a84645bee413e8d4724a4b","dc60696c76a74368a60f72246e47700d",22854502,1,1,0,491,158,159,1
"dc60696c76a74368a60f72246e47700d","dc60696c76a74368a60f72246e47700d",22854502,1,0,1,492,159,159,0
"dc60696c76a74368a60f72246e47700d","78adeee1fa2c4fe0bc73f7bca9fcee86",22854502,1,3,0,493,159,160,1
"78adeee1fa2c4fe0bc73f7bca9fcee86","df1de691dafe4549a18a4398ee9dfaf9",22854502,1,-26,0,494,160,139,-21
"df1de691dafe4549a18a4398ee9dfaf9","67a089198fcb4e1c8f2385786c2b296f",22854502,1,-126,0,495,139,39,-100
"67a089198fcb4e1c8f2385786c2b296f","3cbcea2be0984e7dbd5a48195af10ce7",22854502,1,160,0,496,39,165,126
"3cbcea2be0984e7dbd5a48195af10ce7","3cbcea2be0984e7dbd5a48195af10ce7",22854502,1,0,1,497,165,165,0
"82e6285962b8400d9d6fc32436022a94","3cbcea2be0984e7dbd5a48195af10ce7",22854502,1,-2,0,499,167,165,-2
"3cbcea2be0984e7dbd5a48195af10ce7","78adeee1fa2c4fe0bc73f7bca9fcee86",22854502,2,-8,0,500,165,160,-5
"78adeee1fa2c4fe0bc73f7bca9fcee86","78adeee1fa2c4fe0bc73f7bca9fcee86",22854502,1,0,1,501,160,160,0
"78adeee1fa2c4fe0bc73f7bca9fcee86","65202579580f4ad38d734b4ee39d22a8",22854502,4,5,0,502,160,164,4
"65202579580f4ad38d734b4ee39d22a8","78adeee1fa2c4fe0bc73f7bca9fcee86",22854502,2,-5,0,505,164,160,-4
"65202579580f4ad38d734b4ee39d22a8","8959e6304a0348309a771e4d08d1b64a",22854502,1,-1,0,511,164,163,-1
"8959e6304a0348309a771e4d08d1b64a","65202579580f4ad38d734b4ee39d22a8",22854502,1,1,0,512,163,164,1
"65202579580f4ad38d734b4ee39d22a8","3cbcea2be0984e7dbd5a48195af10ce7",22854502,1,3,0,566,164,165,1
"78adeee1fa2c4fe0bc73f7bca9fcee86","82e6285962b8400d9d6fc32436022a94",22854502,1,10,0,568,160,167,7
"82e6285962b8400d9d6fc32436022a94","a9ac840f098c4bd0a2ee896214ce29cd",22854502,1,3,0,569,167,168,1
"a9ac840f098c4bd0a2ee896214ce29cd","3cbcea2be0984e7dbd5a48195af10ce7",22854502,1,-5,0,570,168,165,-3
"3cbcea2be0984e7dbd5a48195af10ce7","67a089198fcb4e1c8f2385786c2b296f",22854502,1,-160,0,571,165,39,-126
"67a089198fcb4e1c8f2385786c2b296f","ae5ac430ea254e708a6f5deaaf7464ae",22854502,1,57,0,572,39,84,45
"d646286c8051419bbc2e31dd1db55ca8","78adeee1fa2c4fe0bc73f7bca9fcee86",22854502,1,115,0,574,67,160,93
"65202579580f4ad38d734b4ee39d22a8","0c7262dff33c4087bc660ccf40f92f9c",22854502,1,12,0,583,164,169,5
"0c7262dff33c4087bc660ccf40f92f9c","b2275c3fad834f8d90737a2d9a6927d6",22854502,2,3,0,584,169,172,3
"b2275c3fad834f8d90737a2d9a6927d6","0c7262dff33c4087bc660ccf40f92f9c",22854502,1,-3,0,585,172,169,-3
"0c7262dff33c4087bc660ccf40f92f9c","0c7262dff33c4087bc660ccf40f92f9c",22854502,2,0,1,586,169,169,0
"b2275c3fad834f8d90737a2d9a6927d6","b2275c3fad834f8d90737a2d9a6927d6",22854502,30,0,1,589,172,172,0
"b2275c3fad834f8d90737a2d9a6927d6","eb515a26030b41f8a82a1e6114420bad",22854502,1,1,0,619,172,173,1
"eb515a26030b41f8a82a1e6114420bad","eb515a26030b41f8a82a1e6114420bad",22854502,2,0,1,620,173,173,0
"eb515a26030b41f8a82a1e6114420bad","0c7262dff33c4087bc660ccf40f92f9c",22854502,1,-4,0,622,173,169,-4
"0c7262dff33c4087bc660ccf40f92f9c","b42cc17b7de840f181a704558d0bc845",22854502,2,7,0,623,169,175,6
"b42cc17b7de840f181a704558d0bc845","b42cc17b7de840f181a704558d0bc845",22854502,2,0,1,624,175,175,0
"b42cc17b7de840f181a704558d0bc845","801f9e9135034f49bf5f8b4bdefedb41",22854502,1,2,0,625,175,177,2
"801f9e9135034f49bf5f8b4bdefedb41","801f9e9135034f49bf5f8b4bdefedb41",22854502,7,0,1,626,177,177,0
"801f9e9135034f49bf5f8b4bdefedb41","362fcb0699a14845ab29b2340093e528",22854502,1,-3,0,633,177,174,-3
"362fcb0699a14845ab29b2340093e528","ea38cc0e6e6e41edbabf210220808bf9",22854502,2,6,0,634,174,179,5
"ea38cc0e6e6e41edbabf210220808bf9","b87c552dd247427abe6ab5795b9c9d43",22854502,3,2,0,635,179,181,2
"b87c552dd247427abe6ab5795b9c9d43","ea38cc0e6e6e41edbabf210220808bf9",22854502,2,-2,0,636,181,179,-2
"b87c552dd247427abe6ab5795b9c9d43","b87c552dd247427abe6ab5795b9c9d43",22854502,7,0,1,638,181,181,0
"b87c552dd247427abe6ab5795b9c9d43","139b097acfca451689d80c9c6eebdf7b",22854502,1,-3,0,645,181,178,-3
"139b097acfca451689d80c9c6eebdf7b","30f660a1feb34582a739722532524f79",22854502,1,6,0,646,178,183,5
"30f660a1feb34582a739722532524f79","30f660a1feb34582a739722532524f79",22854502,5,0,1,647,183,183,0
"30f660a1feb34582a739722532524f79","2024b4885bd14338a39b7b509acbbd02",22854502,1,-1,0,652,183,182,-1
"2024b4885bd14338a39b7b509acbbd02","c3f63fe50d8e487c86bf8ef76c9cadd3",22854502,1,4,0,653,182,185,3
"c3f63fe50d8e487c86bf8ef76c9cadd3","c3f63fe50d8e487c86bf8ef76c9cadd3",22854502,1,0,1,654,185,185,0
"c3f63fe50d8e487c86bf8ef76c9cadd3","0c7262dff33c4087bc660ccf40f92f9c",22854502,1,-20,0,655,185,169,-16
"0c7262dff33c4087bc660ccf40f92f9c","c8e371568a0c4391b25796ae4e91952e",22854502,3,23,0,656,169,186,17
"c8e371568a0c4391b25796ae4e91952e","0c7262dff33c4087bc660ccf40f92f9c",22854502,1,-23,0,657,186,169,-17
"c8e371568a0c4391b25796ae4e91952e","c8e371568a0c4391b25796ae4e91952e",22854502,4,0,1,659,186,186,0
"c8e371568a0c4391b25796ae4e91952e","7d932b23e1c84326ae5aa4d3c0d813d1",22854502,1,2,0,662,186,188,2
"7d932b23e1c84326ae5aa4d3c0d813d1","7d932b23e1c84326ae5aa4d3c0d813d1",22854502,2,0,1,663,188,188,0
"7d932b23e1c84326ae5aa4d3c0d813d1","c8e371568a0c4391b25796ae4e91952e",22854502,2,-2,0,664,188,186,-2
"c8e371568a0c4391b25796ae4e91952e","ab11d94c6c8948ea90b88f19d2cd502b",22854502,3,5,0,665,186,190,4
"ab11d94c6c8948ea90b88f19d2cd502b","ab11d94c6c8948ea90b88f19d2cd502b",22854502,2,0,1,666,190,190,0
"ab11d94c6c8948ea90b88f19d2cd502b","f992451ed6ad4e68bb9e68ad6be7c4be",22854502,1,2,0,667,190,192,2
"f992451ed6ad4e68bb9e68ad6be7c4be","f992451ed6ad4e68bb9e68ad6be7c4be",22854502,1,0,1,668,192,192,0
"f992451ed6ad4e68bb9e68ad6be7c4be","07b44a7a51e94c78b411c753fc39dab0",22854502,1,-3,0,669,192,189,-3
"07b44a7a51e94c78b411c753fc39dab0","6cd2dcaac46847d4a0bc53f296d90375",22854502,2,6,0,670,189,194,5
"6cd2dcaac46847d4a0bc53f296d90375","6cd2dcaac46847d4a0bc53f296d90375",22854502,2,0,1,671,194,194,0
"6cd2dcaac46847d4a0bc53f296d90375","2d2580c9411c4972909db508d6956a58",22854502,2,2,0,672,194,196,2
"2d2580c9411c4972909db508d6956a58","2d2580c9411c4972909db508d6956a58",22854502,6,0,1,673,196,196,0
"2d2580c9411c4972909db508d6956a58","5bddb3d9ed264f3984702f048c7e5340",22854502,1,1,0,677,196,197,1
"5bddb3d9ed264f3984702f048c7e5340","5bddb3d9ed264f3984702f048c7e5340",22854502,2,0,1,678,197,197,0
"5bddb3d9ed264f3984702f048c7e5340","d5e8e2bd12a2466b9d6d90855f0eb079",22854502,1,1,0,680,197,198,1
"d5e8e2bd12a2466b9d6d90855f0eb079","d5e8e2bd12a2466b9d6d90855f0eb079",22854502,2,0,1,681,198,198,0
"d5e8e2bd12a2466b9d6d90855f0eb079","2d2580c9411c4972909db508d6956a58",22854502,1,-2,0,683,198,196,-2
"2d2580c9411c4972909db508d6956a58","017d7ca8e0394b91aaadc9574df2202c",22854502,2,-3,0,684,196,193,-3
"017d7ca8e0394b91aaadc9574df2202c","54e8e9f0ea3e45c4bf3b8ac799ee31b1",22854502,1,8,0,685,193,200,7
"54e8e9f0ea3e45c4bf3b8ac799ee31b1","54e8e9f0ea3e45c4bf3b8ac799ee31b1",22854502,1,0,1,686,200,200,0
"54e8e9f0ea3e45c4bf3b8ac799ee31b1","c614a00911be4877a075f19315530fb0",22854502,1,1,0,687,200,201,1
"c614a00911be4877a075f19315530fb0","c614a00911be4877a075f19315530fb0",22854502,6,0,1,688,201,201,0
"c614a00911be4877a075f19315530fb0","a6c21bd8b95249c7972820a7a7d76aff",22854502,1,1,0,694,201,202,1
"a6c21bd8b95249c7972820a7a7d76aff","a6c21bd8b95249c7972820a7a7d76aff",22854502,1,0,1,695,202,202,0
"a6c21bd8b95249c7972820a7a7d76aff","c8e371568a0c4391b25796ae4e91952e",22854502,1,-19,0,696,202,186,-16
"c8e371568a0c4391b25796ae4e91952e","017d7ca8e0394b91aaadc9574df2202c",22854502,1,9,0,697,186,193,7
"017d7ca8e0394b91aaadc9574df2202c","f9170dd6bc6442b4acd832747609b09a",22854502,2,7,0,698,193,199,6
"f9170dd6bc6442b4acd832747609b09a","6cd2dcaac46847d4a0bc53f296d90375",22854502,1,-6,0,699,199,194,-5
"017d7ca8e0394b91aaadc9574df2202c","bb329d880ab54120adaf203a693bb203",22854502,1,11,0,704,193,203,10
"bb329d880ab54120adaf203a693bb203","bb329d880ab54120adaf203a693bb203",22854502,5,0,1,705,203,203,0
"bb329d880ab54120adaf203a693bb203","f9170dd6bc6442b4acd832747609b09a",22854502,1,-4,0,710,203,199,-4
"f9170dd6bc6442b4acd832747609b09a","b54257a550b94ebc9538f3a90eee9d7e",22854502,1,6,0,711,199,204,5
"b54257a550b94ebc9538f3a90eee9d7e","f9170dd6bc6442b4acd832747609b09a",22854502,1,-6,0,712,204,199,-5
"f9170dd6bc6442b4acd832747609b09a","c8e371568a0c4391b25796ae4e91952e",22854502,1,-16,0,713,199,186,-13
"c8e371568a0c4391b25796ae4e91952e","6cd2dcaac46847d4a0bc53f296d90375",22854502,1,10,0,714,186,194,8
"6cd2dcaac46847d4a0bc53f296d90375","017d7ca8e0394b91aaadc9574df2202c",22854502,2,-1,0,715,194,193,-1
"017d7ca8e0394b91aaadc9574df2202c","334c2344009840079b1d0e1b7ce3d5a7",22854502,1,14,0,716,193,205,12
"334c2344009840079b1d0e1b7ce3d5a7","334c2344009840079b1d0e1b7ce3d5a7",22854502,5,0,1,717,205,205,0
"334c2344009840079b1d0e1b7ce3d5a7","6cd2dcaac46847d4a0bc53f296d90375",22854502,1,-13,0,722,205,194,-11
"6cd2dcaac46847d4a0bc53f296d90375","b54257a550b94ebc9538f3a90eee9d7e",22854502,1,12,0,723,194,204,10
"b54257a550b94ebc9538f3a90eee9d7e","017d7ca8e0394b91aaadc9574df2202c",22854502,1,-13,0,724,204,193,-11
"017d7ca8e0394b91aaadc9574df2202c","017d7ca8e0394b91aaadc9574df2202c",22854502,1,0,1,725,193,193,0
"017d7ca8e0394b91aaadc9574df2202c","ab11d94c6c8948ea90b88f19d2cd502b",22854502,1,-4,0,726,193,190,-3
"ab11d94c6c8948ea90b88f19d2cd502b","c8e371568a0c4391b25796ae4e91952e",22854502,1,-5,0,727,190,186,-4
"c8e371568a0c4391b25796ae4e91952e","07b44a7a51e94c78b411c753fc39dab0",22854502,1,4,0,728,186,189,3
"07b44a7a51e94c78b411c753fc39dab0","0c7262dff33c4087bc660ccf40f92f9c",22854502,1,-27,0,729,189,169,-20
"0c7262dff33c4087bc660ccf40f92f9c","362fcb0699a14845ab29b2340093e528",22854502,1,6,0,730,169,174,5
"362fcb0699a14845ab29b2340093e528","0c7262dff33c4087bc660ccf40f92f9c",22854502,1,-6,0,731,174,169,-5
"b42cc17b7de840f181a704558d0bc845","362fcb0699a14845ab29b2340093e528",22854502,1,-1,0,734,175,174,-1
"ea38cc0e6e6e41edbabf210220808bf9","139b097acfca451689d80c9c6eebdf7b",22854502,1,-1,0,738,179,178,-1
"139b097acfca451689d80c9c6eebdf7b","2024b4885bd14338a39b7b509acbbd02",22854502,1,5,0,739,178,182,4
"2024b4885bd14338a39b7b509acbbd02","0c7262dff33c4087bc660ccf40f92f9c",22854502,1,-16,0,740,182,169,-13
"ab11d94c6c8948ea90b88f19d2cd502b","07b44a7a51e94c78b411c753fc39dab0",22854502,2,-1,0,745,190,189,-1
"f9170dd6bc6442b4acd832747609b09a","7d932b23e1c84326ae5aa4d3c0d813d1",22854502,1,-14,0,750,199,188,-11
"07b44a7a51e94c78b411c753fc39dab0","c8e371568a0c4391b25796ae4e91952e",22854502,1,-4,0,755,189,186,-3
"c8e371568a0c4391b25796ae4e91952e","d7f13c8d63ec4e2aa673fbb9cf9c6933",22854502,1,26,0,756,186,206,20
"d7f13c8d63ec4e2aa673fbb9cf9c6933","c8e371568a0c4391b25796ae4e91952e",22854502,1,-26,0,757,206,186,-20
"c8e371568a0c4391b25796ae4e91952e","b9e80f77c3a44349863b19875725c384",22854502,1,27,0,758,186,207,21
"b9e80f77c3a44349863b19875725c384","7108f0e4c2584f1f9c471689ae4c885c",22854502,2,1,0,759,207,208,1
"7108f0e4c2584f1f9c471689ae4c885c","b9e80f77c3a44349863b19875725c384",22854502,2,-1,0,760,208,207,-1
"b9e80f77c3a44349863b19875725c384","b9e80f77c3a44349863b19875725c384",22854502,20,0,1,761,207,207,0
"7108f0e4c2584f1f9c471689ae4c885c","7108f0e4c2584f1f9c471689ae4c885c",22854502,11,0,1,782,208,208,0
"7108f0e4c2584f1f9c471689ae4c885c","09400e101c5d4b439cf9a26b03aae558",22854502,1,3,0,793,208,210,2
"09400e101c5d4b439cf9a26b03aae558","d7f13c8d63ec4e2aa673fbb9cf9c6933",22854502,1,-5,0,794,210,206,-4
"d7f13c8d63ec4e2aa673fbb9cf9c6933","09400e101c5d4b439cf9a26b03aae558",22854502,1,5,0,795,206,210,4
"09400e101c5d4b439cf9a26b03aae558","a88efa7e50ce47159810ab553afa6d3a",22854502,1,2,0,796,210,212,2
"a88efa7e50ce47159810ab553afa6d3a","a88efa7e50ce47159810ab553afa6d3a",22854502,5,0,1,797,212,212,0
"a88efa7e50ce47159810ab553afa6d3a","a875096404ef4a9984b62d74cda916f9",22854502,1,-3,0,802,212,209,-3
"a875096404ef4a9984b62d74cda916f9","f7fb1952f56b4189b86a9f8b7862d2b8",22854502,1,7,0,803,209,215,6
"f7fb1952f56b4189b86a9f8b7862d2b8","be502a7a43c44bf7b682698de79d9369",22854502,2,-1,0,804,215,214,-1
"be502a7a43c44bf7b682698de79d9369","ec341f459285443b8361f7f15638ff08",22854502,2,-1,0,805,214,213,-1
"ec341f459285443b8361f7f15638ff08","09400e101c5d4b439cf9a26b03aae558",22854502,1,-4,0,806,213,210,-3
"09400e101c5d4b439cf9a26b03aae558","09400e101c5d4b439cf9a26b03aae558",22854502,1,0,1,807,210,210,0
"09400e101c5d4b439cf9a26b03aae558","a875096404ef4a9984b62d74cda916f9",22854502,1,-1,0,808,210,209,-1
"a875096404ef4a9984b62d74cda916f9","be502a7a43c44bf7b682698de79d9369",22854502,1,6,0,809,209,214,5
"be502a7a43c44bf7b682698de79d9369","f7fb1952f56b4189b86a9f8b7862d2b8",22854502,3,1,0,810,214,215,1
"f7fb1952f56b4189b86a9f8b7862d2b8","f7fb1952f56b4189b86a9f8b7862d2b8",22854502,19,0,1,813,215,215,0
"f7fb1952f56b4189b86a9f8b7862d2b8","b860ee85d8bc4a2f97958cfb71be3533",22854502,1,1,0,832,215,216,1
"b860ee85d8bc4a2f97958cfb71be3533","b860ee85d8bc4a2f97958cfb71be3533",22854502,2,0,1,833,216,216,0
"b860ee85d8bc4a2f97958cfb71be3533","be502a7a43c44bf7b682698de79d9369",22854502,1,-2,0,835,216,214,-2
"be502a7a43c44bf7b682698de79d9369","be502a7a43c44bf7b682698de79d9369",22854502,1,0,1,836,214,214,0
"ec341f459285443b8361f7f15638ff08","363837c182e04711840d896ae1e0339c",22854502,1,6,0,838,213,218,5
"363837c182e04711840d896ae1e0339c","363837c182e04711840d896ae1e0339c",22854502,16,0,1,839,218,218,0
"363837c182e04711840d896ae1e0339c","01b2051f8941460d89945e3b02d1ce78",22854502,2,-1,0,855,218,217,-1
"01b2051f8941460d89945e3b02d1ce78","91125ca626c5470eb145501f8c37f8db",22854502,1,4,0,856,217,220,3
"91125ca626c5470eb145501f8c37f8db","91125ca626c5470eb145501f8c37f8db",22854502,1,0,1,857,220,220,0
"91125ca626c5470eb145501f8c37f8db","d7f13c8d63ec4e2aa673fbb9cf9c6933",22854502,1,-18,0,858,220,206,-14
"d7f13c8d63ec4e2aa673fbb9cf9c6933","1c6721b1f63f4d30ba7746ea8af02a52",22854502,1,21,0,859,206,221,15
"1c6721b1f63f4d30ba7746ea8af02a52","77ecef8eff6b4a2caea7707669bf7475",22854502,1,1,0,860,221,222,1
"77ecef8eff6b4a2caea7707669bf7475","77ecef8eff6b4a2caea7707669bf7475",22854502,12,0,1,861,222,222,0
"77ecef8eff6b4a2caea7707669bf7475","1c6721b1f63f4d30ba7746ea8af02a52",22854502,1,-1,0,873,222,221,-1
"1c6721b1f63f4d30ba7746ea8af02a52","d03cb855c70044cf8c35d9ec0de696e3",22854502,3,4,0,874,221,224,3
"d03cb855c70044cf8c35d9ec0de696e3","8b9ae98743bd4d4a8a87dff1c1244211",22854502,3,3,0,875,224,227,3
"8b9ae98743bd4d4a8a87dff1c1244211","f7906d6f59b9489a91d2ef40db5a474d",22854502,2,-4,0,876,227,223,-4
"f7906d6f59b9489a91d2ef40db5a474d","1c6721b1f63f4d30ba7746ea8af02a52",22854502,1,-3,0,877,223,221,-2
"1c6721b1f63f4d30ba7746ea8af02a52","d7f13c8d63ec4e2aa673fbb9cf9c6933",22854502,1,-21,0,878,221,206,-15
"d7f13c8d63ec4e2aa673fbb9cf9c6933","be95c065e45447c1bd8215ea6f130c7a",22854502,1,17,0,879,206,219,13
"be95c065e45447c1bd8215ea6f130c7a","363837c182e04711840d896ae1e0339c",22854502,1,-2,0,880,219,218,-1
"01b2051f8941460d89945e3b02d1ce78","be502a7a43c44bf7b682698de79d9369",22854502,1,-4,0,882,217,214,-3
"f7fb1952f56b4189b86a9f8b7862d2b8","ec341f459285443b8361f7f15638ff08",22854502,1,-2,0,884,215,213,-2
"ec341f459285443b8361f7f15638ff08","7108f0e4c2584f1f9c471689ae4c885c",22854502,1,-7,0,885,213,208,-5
"b9e80f77c3a44349863b19875725c384","01b2051f8941460d89945e3b02d1ce78",22854502,1,13,0,887,207,217,10
"01b2051f8941460d89945e3b02d1ce78","d7f13c8d63ec4e2aa673fbb9cf9c6933",22854502,1,-14,0,888,217,206,-11
"d7f13c8d63ec4e2aa673fbb9cf9c6933","363837c182e04711840d896ae1e0339c",22854502,1,15,0,889,206,218,12
"363837c182e04711840d896ae1e0339c","1c6721b1f63f4d30ba7746ea8af02a52",22854502,1,6,0,890,218,221,3
"8b9ae98743bd4d4a8a87dff1c1244211","d03cb855c70044cf8c35d9ec0de696e3",22854502,2,-3,0,893,227,224,-3
"d03cb855c70044cf8c35d9ec0de696e3","a49a937d6896486d9a5396654abcf2e1",22854502,1,2,0,894,224,226,2
"a49a937d6896486d9a5396654abcf2e1","a49a937d6896486d9a5396654abcf2e1",22854502,3,0,1,895,226,226,0
"a49a937d6896486d9a5396654abcf2e1","8b9ae98743bd4d4a8a87dff1c1244211",22854502,1,1,0,898,226,227,1
"8b9ae98743bd4d4a8a87dff1c1244211","8b9ae98743bd4d4a8a87dff1c1244211",22854502,15,0,1,899,227,227,0
"8b9ae98743bd4d4a8a87dff1c1244211","2ab1535aac1346ba8801535bf729ef37",22854502,1,3,0,914,227,229,2
"2ab1535aac1346ba8801535bf729ef37","f7906d6f59b9489a91d2ef40db5a474d",22854502,1,-7,0,915,229,223,-6
"f7906d6f59b9489a91d2ef40db5a474d","2ab1535aac1346ba8801535bf729ef37",22854502,1,7,0,916,223,229,6
"2ab1535aac1346ba8801535bf729ef37","a4f40fb48a8542c8949bae1f002cd9bc",22854502,1,2,0,917,229,231,2
"a4f40fb48a8542c8949bae1f002cd9bc","a4f40fb48a8542c8949bae1f002cd9bc",22854502,5,0,1,918,231,231,0
"a4f40fb48a8542c8949bae1f002cd9bc","8972c23e32044edb8a78fa1eed4e5947",22854502,1,1,0,923,231,232,1
"8972c23e32044edb8a78fa1eed4e5947","8972c23e32044edb8a78fa1eed4e5947",22854502,4,0,1,924,232,232,0
"8972c23e32044edb8a78fa1eed4e5947","92feb4a40f8344d38b6f722e42a53295",22854502,1,1,0,928,232,233,1
"92feb4a40f8344d38b6f722e42a53295","92feb4a40f8344d38b6f722e42a53295",22854502,2,0,1,929,233,233,0
"92feb4a40f8344d38b6f722e42a53295","2ab1535aac1346ba8801535bf729ef37",22854502,1,-4,0,931,233,229,-4
"2ab1535aac1346ba8801535bf729ef37","2ab1535aac1346ba8801535bf729ef37",22854502,2,0,1,932,229,229,0
"2ab1535aac1346ba8801535bf729ef37","d03cb855c70044cf8c35d9ec0de696e3",22854502,1,-6,0,934,229,224,-5
"d03cb855c70044cf8c35d9ec0de696e3","5152833676bf4c6cb317060be10f68db",22854502,1,5,0,935,224,228,4
"5152833676bf4c6cb317060be10f68db","8b9ae98743bd4d4a8a87dff1c1244211",22854502,1,-2,0,936,228,227,-1
"d03cb855c70044cf8c35d9ec0de696e3","f7906d6f59b9489a91d2ef40db5a474d",22854502,1,-1,0,938,224,223,-1
"f7906d6f59b9489a91d2ef40db5a474d","ca3e28f290354c08aefe5b0f769604e6",22854502,1,14,0,939,223,235,12
"ca3e28f290354c08aefe5b0f769604e6","ca3e28f290354c08aefe5b0f769604e6",22854502,4,0,1,940,235,235,0
"ca3e28f290354c08aefe5b0f769604e6","79a35eea833e4c2c9d22fc53c3c6445c",22854502,1,1,0,944,235,236,1
"79a35eea833e4c2c9d22fc53c3c6445c","79a35eea833e4c2c9d22fc53c3c6445c",22854502,9,0,1,945,236,236,0
"79a35eea833e4c2c9d22fc53c3c6445c","8f68228b1518449e9615cdafee41a2bd",22854502,1,1,0,954,236,237,1
"8f68228b1518449e9615cdafee41a2bd","8f68228b1518449e9615cdafee41a2bd",22854502,1,0,1,955,237,237,0
"8f68228b1518449e9615cdafee41a2bd","cab89fa5c3ed45a5aa550fc0352d6a42",22854502,1,1,0,956,237,238,1
"cab89fa5c3ed45a5aa550fc0352d6a42","cab89fa5c3ed45a5aa550fc0352d6a42",22854502,5,0,1,957,238,238,0
"cab89fa5c3ed45a5aa550fc0352d6a42","66d4fad4f1cf4b46be0750a99ad7a35a",22854502,1,1,0,962,238,239,1
"66d4fad4f1cf4b46be0750a99ad7a35a","66d4fad4f1cf4b46be0750a99ad7a35a",22854502,1,0,1,963,239,239,0
"66d4fad4f1cf4b46be0750a99ad7a35a","0b04c8e2f86d48c7aeb7e225819cd32b",22854502,1,-5,0,964,239,234,-5
"0b04c8e2f86d48c7aeb7e225819cd32b","f53da5fd9bfe412da4b80d4742563b6c",22854502,1,8,0,965,234,241,7
"f53da5fd9bfe412da4b80d4742563b6c","f53da5fd9bfe412da4b80d4742563b6c",22854502,1,0,1,966,241,241,0
"f53da5fd9bfe412da4b80d4742563b6c","1c6721b1f63f4d30ba7746ea8af02a52",22854502,1,-24,0,967,241,221,-20
"1c6721b1f63f4d30ba7746ea8af02a52","2ae94c0cea4d480a9d5dca8fb1d7b542",22854502,1,27,0,968,221,242,21
"2ae94c0cea4d480a9d5dca8fb1d7b542","1ebf23f9d994469a85206e4c7b1bf5f5",22854502,1,3,0,969,242,245,3
"1ebf23f9d994469a85206e4c7b1bf5f5","1ebf23f9d994469a85206e4c7b1bf5f5",22854502,10,0,1,970,245,245,0
"1ebf23f9d994469a85206e4c7b1bf5f5","85ae675b83e8422da842cfd25596af99",22854502,1,1,0,980,245,246,1
"85ae675b83e8422da842cfd25596af99","85ae675b83e8422da842cfd25596af99",22854502,1,0,1,981,246,246,0
"85ae675b83e8422da842cfd25596af99","fa235f0f364d47e4ae1c87f47bf8e6ba",22854502,1,8,0,982,246,252,6
"fa235f0f364d47e4ae1c87f47bf8e6ba","2ae94c0cea4d480a9d5dca8fb1d7b542",22854502,2,-12,0,983,252,242,-10
"2ae94c0cea4d480a9d5dca8fb1d7b542","fa235f0f364d47e4ae1c87f47bf8e6ba",22854502,2,12,0,984,242,252,10
"fa235f0f364d47e4ae1c87f47bf8e6ba","1c6721b1f63f4d30ba7746ea8af02a52",22854502,1,-39,0,985,252,221,-31
"f7906d6f59b9489a91d2ef40db5a474d","5152833676bf4c6cb317060be10f68db",22854502,1,6,0,989,223,228,5
"5152833676bf4c6cb317060be10f68db","2ab1535aac1346ba8801535bf729ef37",22854502,1,1,0,990,228,229,1
"2ab1535aac1346ba8801535bf729ef37","2ae94c0cea4d480a9d5dca8fb1d7b542",22854502,1,17,0,991,229,242,13
"2ae94c0cea4d480a9d5dca8fb1d7b542","1c6721b1f63f4d30ba7746ea8af02a52",22854502,1,-27,0,992,242,221,-21
"1c6721b1f63f4d30ba7746ea8af02a52","1ebf23f9d994469a85206e4c7b1bf5f5",22854502,1,30,0,993,221,245,24
"1ebf23f9d994469a85206e4c7b1bf5f5","fa235f0f364d47e4ae1c87f47bf8e6ba",22854502,1,9,0,994,245,252,7
"fa235f0f364d47e4ae1c87f47bf8e6ba","79f7845465cc4ed19d8e4f1429541be0",22854502,1,2,0,998,252,254,2
"79f7845465cc4ed19d8e4f1429541be0","79f7845465cc4ed19d8e4f1429541be0",22854502,2,0,1,1000,254,254,0
"79f7845465cc4ed19d8e4f1429541be0","fa235f0f364d47e4ae1c87f47bf8e6ba",22854502,1,-2,0,1001,254,252,-2
"fa235f0f364d47e4ae1c87f47bf8e6ba","fa235f0f364d47e4ae1c87f47bf8e6ba",22854502,13,0,1,1002,252,252,0
"fa235f0f364d47e4ae1c87f47bf8e6ba","6e83e23f56544a19b94067c1c558d9c0",22854502,1,-6,0,1014,252,247,-5
"6e83e23f56544a19b94067c1c558d9c0","00f61990949545828dd12f1303d47504",22854502,2,11,0,1015,247,256,9
"00f61990949545828dd12f1303d47504","00f61990949545828dd12f1303d47504",22854502,1,0,1,1016,256,256,0
"00f61990949545828dd12f1303d47504","ead7bb4b64e247d2ae632ab8a296b091",22854502,1,2,0,1017,256,258,2
"ead7bb4b64e247d2ae632ab8a296b091","ead7bb4b64e247d2ae632ab8a296b091",22854502,2,0,1,1018,258,258,0
"ead7bb4b64e247d2ae632ab8a296b091","41b0048dde734bb280bac6116baa8e27",22854502,1,1,0,1020,258,259,1
"41b0048dde734bb280bac6116baa8e27","41b0048dde734bb280bac6116baa8e27",22854502,2,0,1,1021,259,259,0
"41b0048dde734bb280bac6116baa8e27","b41c5a094a604ee0915327da5cc0beb7",22854502,1,1,0,1023,259,260,1
"b41c5a094a604ee0915327da5cc0beb7","b41c5a094a604ee0915327da5cc0beb7",22854502,2,0,1,1024,260,260,0
"b41c5a094a604ee0915327da5cc0beb7","00f61990949545828dd12f1303d47504",22854502,1,-4,0,1026,260,256,-4
"00f61990949545828dd12f1303d47504","d546341988904f069cfa86b21457d9d9",22854502,1,-6,0,1027,256,251,-5
"d546341988904f069cfa86b21457d9d9","28c171777c52431ab6b925073bd63d46",22854502,1,15,0,1028,251,264,13
"28c171777c52431ab6b925073bd63d46","28c171777c52431ab6b925073bd63d46",22854502,11,0,1,1029,264,264,0
"28c171777c52431ab6b925073bd63d46","ac160db940cb49ae8579162b1d52bb5d",22854502,1,2,0,1040,264,266,2
"ac160db940cb49ae8579162b1d52bb5d","ac160db940cb49ae8579162b1d52bb5d",22854502,7,0,1,1041,266,266,0
"ac160db940cb49ae8579162b1d52bb5d","d989ebcfc12a4b669f0100dc1aa14f1e",22854502,1,-12,0,1048,266,255,-11
"d989ebcfc12a4b669f0100dc1aa14f1e","c6fd49b485cc4874b0bbdd9c6171e09c",22854502,1,15,0,1049,255,268,13
"c6fd49b485cc4874b0bbdd9c6171e09c","c6fd49b485cc4874b0bbdd9c6171e09c",22854502,7,0,1,1050,268,268,0
"c6fd49b485cc4874b0bbdd9c6171e09c","44240778a97c4af0937817499b75707b",22854502,1,1,0,1057,268,269,1
"44240778a97c4af0937817499b75707b","44240778a97c4af0937817499b75707b",22854502,2,0,1,1058,269,269,0
"44240778a97c4af0937817499b75707b","7aa76d3e993840d8805f097cbdbcd44b",22854502,1,-9,0,1060,269,261,-8
"7aa76d3e993840d8805f097cbdbcd44b","865a4d3b43374da7944dc7d397f566d9",22854502,1,12,0,1061,261,271,10
"865a4d3b43374da7944dc7d397f566d9","865a4d3b43374da7944dc7d397f566d9",22854502,1,0,1,1062,271,271,0
"865a4d3b43374da7944dc7d397f566d9","2ae94c0cea4d480a9d5dca8fb1d7b542",22854502,1,-35,0,1063,271,242,-29
"2ae94c0cea4d480a9d5dca8fb1d7b542","0d987bed3ffa4ed0b9a2e62e97b7b30f",22854502,1,38,0,1064,242,272,30
"0d987bed3ffa4ed0b9a2e62e97b7b30f","0d987bed3ffa4ed0b9a2e62e97b7b30f",22854502,1,0,1,1065,272,272,0
"0d987bed3ffa4ed0b9a2e62e97b7b30f","bb5a47f5ea01454a8b79455422d3b9da",22854502,1,10,0,1066,272,280,8
"bb5a47f5ea01454a8b79455422d3b9da","bb5a47f5ea01454a8b79455422d3b9da",22854502,66,0,1,1067,280,280,0
"bb5a47f5ea01454a8b79455422d3b9da","82ae07bc0c9b4570a41799290d1ef399",22854502,1,-6,0,1074,280,275,-5
"82ae07bc0c9b4570a41799290d1ef399","bb5a47f5ea01454a8b79455422d3b9da",22854502,1,6,0,1075,275,280,5
"bb5a47f5ea01454a8b79455422d3b9da","94cecc3f1e7d484b8e068e79241dfd73",22854502,1,3,0,1093,280,281,1
"94cecc3f1e7d484b8e068e79241dfd73","a37477c4e4c14169ad44b06b493007f6",22854502,5,2,0,1094,281,283,2
"a37477c4e4c14169ad44b06b493007f6","94cecc3f1e7d484b8e068e79241dfd73",22854502,2,-2,0,1095,283,281,-2
"a37477c4e4c14169ad44b06b493007f6","0d987bed3ffa4ed0b9a2e62e97b7b30f",22854502,1,-15,0,1097,283,272,-11
"0d987bed3ffa4ed0b9a2e62e97b7b30f","bc5524e78a8544e2ae2fdc2f3462bbec",22854502,1,9,0,1098,272,279,7
"bc5524e78a8544e2ae2fdc2f3462bbec","bb5a47f5ea01454a8b79455422d3b9da",22854502,1,1,0,1099,279,280,1
"bb5a47f5ea01454a8b79455422d3b9da","0d987bed3ffa4ed0b9a2e62e97b7b30f",22854502,1,-10,0,1142,280,272,-8
"0d987bed3ffa4ed0b9a2e62e97b7b30f","94cecc3f1e7d484b8e068e79241dfd73",22854502,1,13,0,1143,272,281,9
"a37477c4e4c14169ad44b06b493007f6","0c7262dff33c4087bc660ccf40f92f9c",22854502,1,-150,0,1145,283,169,-114
"0c7262dff33c4087bc660ccf40f92f9c","a49d1bb4328949299686242fd0be5584",22854502,1,-207,0,1146,169,21,-148
"a49d1bb4328949299686242fd0be5584","b7719e26494940efa49512aedd0aac79",22854502,1,-2,0,1147,21,20,-1
"b7719e26494940efa49512aedd0aac79","d4c3b003e8274e429d2fa688d73fde6d",22854502,1,3,0,1148,20,22,2
"d4c3b003e8274e429d2fa688d73fde6d","d4f45188d3c84a02ba08454e6403a818",22854502,1,2,0,1149,22,24,2
"d4f45188d3c84a02ba08454e6403a818","a49d1bb4328949299686242fd0be5584",22854502,1,-3,0,1150,24,21,-3
"a49d1bb4328949299686242fd0be5584","d4c3b003e8274e429d2fa688d73fde6d",22854502,1,1,0,1151,21,22,1
"d4c3b003e8274e429d2fa688d73fde6d","3cbcea2be0984e7dbd5a48195af10ce7",22854502,1,197,0,1152,22,165,143
"3cbcea2be0984e7dbd5a48195af10ce7","82e6285962b8400d9d6fc32436022a94",22854502,2,2,0,1153,165,167,2
"82e6285962b8400d9d6fc32436022a94","78adeee1fa2c4fe0bc73f7bca9fcee86",22854502,1,-10,0,1154,167,160,-7
"78adeee1fa2c4fe0bc73f7bca9fcee86","3cbcea2be0984e7dbd5a48195af10ce7",22854502,1,8,0,1155,160,165,5
"3cbcea2be0984e7dbd5a48195af10ce7","65202579580f4ad38d734b4ee39d22a8",22854502,1,-3,0,1156,165,164,-1
"65202579580f4ad38d734b4ee39d22a8","65202579580f4ad38d734b4ee39d22a8",22854502,73,0,1,1157,164,164,0
"65202579580f4ad38d734b4ee39d22a8","b7719e26494940efa49512aedd0aac79",22854502,1,-197,0,1166,164,20,-144
"b7719e26494940efa49512aedd0aac79","b613861cecf84ffcab01afb23f660475",22854502,1,-32,0,1167,20,1,-19
"b613861cecf84ffcab01afb23f660475","94cecc3f1e7d484b8e068e79241dfd73",22854502,1,389,0,1168,1,281,280
"94cecc3f1e7d484b8e068e79241dfd73","94cecc3f1e7d484b8e068e79241dfd73",22854502,1,0,1,1169,281,281,0
"a37477c4e4c14169ad44b06b493007f6","4a29443515bb404cb8924e1c60a63b73",22854502,1,7,0,1173,283,285,2
"4a29443515bb404cb8924e1c60a63b73","94cecc3f1e7d484b8e068e79241dfd73",22854502,1,-9,0,1174,285,281,-4
"94cecc3f1e7d484b8e068e79241dfd73","208c9b2796c944db8dacaa96082520ea",22854502,1,12,0,1175,281,288,7
"208c9b2796c944db8dacaa96082520ea","208c9b2796c944db8dacaa96082520ea",22854502,2,0,1,1176,288,288,0
"208c9b2796c944db8dacaa96082520ea","4a29443515bb404cb8924e1c60a63b73",22854502,1,-3,0,1178,288,285,-3
"4a29443515bb404cb8924e1c60a63b73","7669a956527947d0add87455277e80b4",22854502,1,7,0,1179,285,291,6
"7669a956527947d0add87455277e80b4","7669a956527947d0add87455277e80b4",22854502,1,0,1,1180,291,291,0
"7669a956527947d0add87455277e80b4","6a9a3b5bde4a48daa896fe8c06eca56f",22854502,1,-2,0,1181,291,289,-2
"6a9a3b5bde4a48daa896fe8c06eca56f","869e967078f04da18dd0b0b9389a7424",22854502,1,5,0,1182,289,293,4
"869e967078f04da18dd0b0b9389a7424","869e967078f04da18dd0b0b9389a7424",22854502,2,0,1,1183,293,293,0
"869e967078f04da18dd0b0b9389a7424","51ab6291537748fab90d519aa09889d6",22854502,1,2,0,1184,293,295,2
"51ab6291537748fab90d519aa09889d6","51ab6291537748fab90d519aa09889d6",22854502,5,0,1,1185,295,295,0
"51ab6291537748fab90d519aa09889d6","869e967078f04da18dd0b0b9389a7424",22854502,1,-2,0,1190,295,293,-2
"869e967078f04da18dd0b0b9389a7424","34a6e49023fc4465bd5ca604330bbd1c",22854502,1,-1,0,1192,293,292,-1
"34a6e49023fc4465bd5ca604330bbd1c","21592f2a9e9c4b2f8c66ec5dbcbf6a2b",22854502,1,5,0,1193,292,296,4
"21592f2a9e9c4b2f8c66ec5dbcbf6a2b","ba0e59461bfb4a44b7b1c28a01f8d3b3",22854502,1,4,0,1194,296,299,3
"ba0e59461bfb4a44b7b1c28a01f8d3b3","ba0e59461bfb4a44b7b1c28a01f8d3b3",22854502,1,0,1,1195,299,299,0
"ba0e59461bfb4a44b7b1c28a01f8d3b3","0e0b36e731a645e7b1b8a88f5031ca38",22854502,1,2,0,1196,299,301,2
"0e0b36e731a645e7b1b8a88f5031ca38","0e0b36e731a645e7b1b8a88f5031ca38",22854502,4,0,1,1197,301,301,0
"0e0b36e731a645e7b1b8a88f5031ca38","a66a144637284c21afc6de17fea4bfb8",22854502,1,1,0,1199,301,302,1
"a66a144637284c21afc6de17fea4bfb8","a66a144637284c21afc6de17fea4bfb8",22854502,2,0,1,1200,302,302,0
"a66a144637284c21afc6de17fea4bfb8","0e0b36e731a645e7b1b8a88f5031ca38",22854502,1,-1,0,1202,302,301,-1
"0e0b36e731a645e7b1b8a88f5031ca38","ba0e59461bfb4a44b7b1c28a01f8d3b3",22854502,1,-2,0,1205,301,299,-2
"ba0e59461bfb4a44b7b1c28a01f8d3b3","7646a919d7e64fa990bca9b024ff089d",22854502,1,-1,0,1206,299,298,-1
"7646a919d7e64fa990bca9b024ff089d","4a29443515bb404cb8924e1c60a63b73",22854502,1,-17,0,1207,298,285,-13
"4a29443515bb404cb8924e1c60a63b73","208c9b2796c944db8dacaa96082520ea",22854502,2,3,0,1208,285,288,3
"208c9b2796c944db8dacaa96082520ea","ba0e59461bfb4a44b7b1c28a01f8d3b3",22854502,1,15,0,1209,288,299,11
"ba0e59461bfb4a44b7b1c28a01f8d3b3","4a29443515bb404cb8924e1c60a63b73",22854502,2,-18,0,1210,299,285,-14
"4a29443515bb404cb8924e1c60a63b73","ba0e59461bfb4a44b7b1c28a01f8d3b3",22854502,1,18,0,1211,285,299,14
"4a29443515bb404cb8924e1c60a63b73","7646a919d7e64fa990bca9b024ff089d",22854502,1,17,0,1213,285,298,13
"7646a919d7e64fa990bca9b024ff089d","e390b575229748ea8aac9364efe2bf00",22854502,1,7,0,1214,298,304,6
"e390b575229748ea8aac9364efe2bf00","e390b575229748ea8aac9364efe2bf00",22854502,1,0,1,1215,304,304,0
"e390b575229748ea8aac9364efe2bf00","3434c10e561d488a914e0f7d71907abd",22854502,1,3,0,1216,304,305,1
"3434c10e561d488a914e0f7d71907abd","4a29443515bb404cb8924e1c60a63b73",22854502,2,-27,0,1217,305,285,-20
"4a29443515bb404cb8924e1c60a63b73","53e7e900392747ccad52e711ab0f80d8",22854502,1,29,0,1218,285,307,22
"53e7e900392747ccad52e711ab0f80d8","53e7e900392747ccad52e711ab0f80d8",22854502,5,0,1,1219,307,307,0
"53e7e900392747ccad52e711ab0f80d8","130acc2aeb0448fdbb2de63bc5cebe5b",22854502,1,3,0,1224,307,309,2
"130acc2aeb0448fdbb2de63bc5cebe5b","3434c10e561d488a914e0f7d71907abd",22854502,1,-5,0,1225,309,305,-4
"3434c10e561d488a914e0f7d71907abd","130acc2aeb0448fdbb2de63bc5cebe5b",22854502,1,5,0,1226,305,309,4
"130acc2aeb0448fdbb2de63bc5cebe5b","130acc2aeb0448fdbb2de63bc5cebe5b",22854502,2,0,1,1227,309,309,0
"130acc2aeb0448fdbb2de63bc5cebe5b","9c062b3251034ebe90f5054e2a3b5120",22854502,1,2,0,1229,309,311,2
"9c062b3251034ebe90f5054e2a3b5120","9c062b3251034ebe90f5054e2a3b5120",22854502,2,0,1,1230,311,311,0
"9c062b3251034ebe90f5054e2a3b5120","ea859f8207e44537889daeaba13ac2e8",22854502,1,1,0,1232,311,312,1
"ea859f8207e44537889daeaba13ac2e8","ea859f8207e44537889daeaba13ac2e8",22854502,1,0,1,1233,312,312,0
"ea859f8207e44537889daeaba13ac2e8","56d94971a7a94257aa330183a8ebd0ea",22854502,1,1,0,1234,312,313,1
"56d94971a7a94257aa330183a8ebd0ea","56d94971a7a94257aa330183a8ebd0ea",22854502,1,0,1,1235,313,313,0
"56d94971a7a94257aa330183a8ebd0ea","141c0df6cd1946539aadd1c9b7068cd4",22854502,1,-5,0,1236,313,308,-5
"141c0df6cd1946539aadd1c9b7068cd4","13255e63e0aa4abf85e5211bf613d43e",22854502,1,10,0,1237,308,317,9
"13255e63e0aa4abf85e5211bf613d43e","3434c10e561d488a914e0f7d71907abd",22854502,1,-14,0,1238,317,305,-12
"4a29443515bb404cb8924e1c60a63b73","3434c10e561d488a914e0f7d71907abd",22854502,1,27,0,1240,285,305,20
"3434c10e561d488a914e0f7d71907abd","0c787d16c9504873b1a4d903cec09948",22854502,1,11,0,1241,305,314,9
"0c787d16c9504873b1a4d903cec09948","3434c10e561d488a914e0f7d71907abd",22854502,1,-11,0,1242,314,305,-9
"3434c10e561d488a914e0f7d71907abd","13255e63e0aa4abf85e5211bf613d43e",22854502,1,14,0,1243,305,317,12
"13255e63e0aa4abf85e5211bf613d43e","13255e63e0aa4abf85e5211bf613d43e",22854502,1,0,1,1244,317,317,0
"13255e63e0aa4abf85e5211bf613d43e","0c787d16c9504873b1a4d903cec09948",22854502,1,-3,0,1245,317,314,-3
"0c787d16c9504873b1a4d903cec09948","86c27d40179e419c8e9d150fb6afa5d0",22854502,1,6,0,1246,314,319,5
"86c27d40179e419c8e9d150fb6afa5d0","8d7e0b55cf9849cda222a0f2440cec55",22854502,1,-1,0,1247,319,318,-1
"8d7e0b55cf9849cda222a0f2440cec55","3434c10e561d488a914e0f7d71907abd",22854502,1,-16,0,1248,318,305,-13
"3434c10e561d488a914e0f7d71907abd","86c27d40179e419c8e9d150fb6afa5d0",22854502,1,17,0,1249,305,319,14
"86c27d40179e419c8e9d150fb6afa5d0","86c27d40179e419c8e9d150fb6afa5d0",22854502,4,0,1,1250,319,319,0
"86c27d40179e419c8e9d150fb6afa5d0","47edbb64109243e6b0f8f64cdef90c6c",22854502,1,8,0,1254,319,326,7
"47edbb64109243e6b0f8f64cdef90c6c","24f1363179ad4aaa965484a78471912b",22854502,1,-3,0,1255,326,323,-3
"24f1363179ad4aaa965484a78471912b","8d7e0b55cf9849cda222a0f2440cec55",22854502,1,-6,0,1256,323,318,-5
"8d7e0b55cf9849cda222a0f2440cec55","24f1363179ad4aaa965484a78471912b",22854502,1,6,0,1257,318,323,5
"24f1363179ad4aaa965484a78471912b","24f1363179ad4aaa965484a78471912b",22854502,1,0,1,1258,323,323,0
"24f1363179ad4aaa965484a78471912b","3628bdce1dd2429ba924d2d4d09448d2",22854502,1,-1,0,1259,323,322,-1
"3628bdce1dd2429ba924d2d4d09448d2","56b3fd1a212a4764be39d979fde3326e",22854502,1,7,0,1260,322,328,6
"56b3fd1a212a4764be39d979fde3326e","56b3fd1a212a4764be39d979fde3326e",22854502,1,0,1,1261,328,328,0
"56b3fd1a212a4764be39d979fde3326e","43ea1b823a4b4e51b7c694c10725db82",22854502,1,-1,0,1262,328,327,-1
"43ea1b823a4b4e51b7c694c10725db82","24f1363179ad4aaa965484a78471912b",22854502,1,-5,0,1263,327,323,-4
"24f1363179ad4aaa965484a78471912b","47edbb64109243e6b0f8f64cdef90c6c",22854502,1,3,0,1264,323,326,3
"47edbb64109243e6b0f8f64cdef90c6c","3628bdce1dd2429ba924d2d4d09448d2",22854502,1,-4,0,1265,326,322,-4
"3628bdce1dd2429ba924d2d4d09448d2","3434c10e561d488a914e0f7d71907abd",22854502,1,-21,0,1266,322,305,-17
"3434c10e561d488a914e0f7d71907abd","0c4079457ede49e3aeb5e86ed84bdf35",22854502,1,31,0,1267,305,329,24
"0c4079457ede49e3aeb5e86ed84bdf35","38aea304b4fa46e1b29bb72f5cea4c93",22854502,1,2,0,1268,329,331,2
"38aea304b4fa46e1b29bb72f5cea4c93","38aea304b4fa46e1b29bb72f5cea4c93",22854502,2,0,1,1269,331,331,0
"38aea304b4fa46e1b29bb72f5cea4c93","e36d261332f14e79bb4b467aceaeb9b5",22854502,1,2,0,1271,331,333,2
"e36d261332f14e79bb4b467aceaeb9b5","e36d261332f14e79bb4b467aceaeb9b5",22854502,1,0,1,1272,333,333,0
"e36d261332f14e79bb4b467aceaeb9b5","c7e89b9d04744d2eab742fc24e3ef1ae",22854502,1,1,0,1273,333,334,1
"c7e89b9d04744d2eab742fc24e3ef1ae","c7e89b9d04744d2eab742fc24e3ef1ae",22854502,2,0,1,1274,334,334,0
"c7e89b9d04744d2eab742fc24e3ef1ae","fe49f8054b374a0ea4bb266ed135ff62",22854502,1,1,0,1276,334,335,1
"fe49f8054b374a0ea4bb266ed135ff62","fe49f8054b374a0ea4bb266ed135ff62",22854502,2,0,1,1277,335,335,0
"fe49f8054b374a0ea4bb266ed135ff62","d0a8f74af98642fe8360d22c42e45117",22854502,1,1,0,1279,335,336,1
"d0a8f74af98642fe8360d22c42e45117","d0a8f74af98642fe8360d22c42e45117",22854502,2,0,1,1280,336,336,0
"d0a8f74af98642fe8360d22c42e45117","0c4079457ede49e3aeb5e86ed84bdf35",22854502,1,-7,0,1282,336,329,-7
"0c4079457ede49e3aeb5e86ed84bdf35","a7c6339ca1da4368a18d471f0519f877",22854502,1,11,0,1283,329,339,10
"a7c6339ca1da4368a18d471f0519f877","a7c6339ca1da4368a18d471f0519f877",22854502,1,0,1,1284,339,339,0
"a7c6339ca1da4368a18d471f0519f877","bbc5139ca9024389a94db3a6f47dcff6",22854502,1,3,0,1285,339,341,2
"bbc5139ca9024389a94db3a6f47dcff6","b8b9418ab322418d9db9b40d96af873a",22854502,1,-5,0,1286,341,337,-4
"b8b9418ab322418d9db9b40d96af873a","bbc5139ca9024389a94db3a6f47dcff6",22854502,1,5,0,1287,337,341,4
"bbc5139ca9024389a94db3a6f47dcff6","bbc5139ca9024389a94db3a6f47dcff6",22854502,3,0,1,1288,341,341,0
"bbc5139ca9024389a94db3a6f47dcff6","4ee6ca9019ab4a1ab323f98094a9bd77",22854502,1,2,0,1290,341,343,2
"4ee6ca9019ab4a1ab323f98094a9bd77","4ee6ca9019ab4a1ab323f98094a9bd77",22854502,2,0,1,1291,343,343,0
"4ee6ca9019ab4a1ab323f98094a9bd77","b37947176785476f8b29d49a851366dc",22854502,1,1,0,1293,343,344,1
"b37947176785476f8b29d49a851366dc","b37947176785476f8b29d49a851366dc",22854502,2,0,1,1294,344,344,0
"b37947176785476f8b29d49a851366dc","fcea5b10d5a14a3b9324ffece8f6e1e5",22854502,1,1,0,1296,344,345,1
"fcea5b10d5a14a3b9324ffece8f6e1e5","fcea5b10d5a14a3b9324ffece8f6e1e5",22854502,2,0,1,1297,345,345,0
"fcea5b10d5a14a3b9324ffece8f6e1e5","c2490bc612d146edbe786556fab3651b",22854502,1,-5,0,1299,345,340,-5
"c2490bc612d146edbe786556fab3651b","6ac8bb048b854999a47edb35fe627f11",22854502,1,8,0,1300,340,347,7
"6ac8bb048b854999a47edb35fe627f11","6ac8bb048b854999a47edb35fe627f11",22854502,1,0,1,1301,347,347,0
"6ac8bb048b854999a47edb35fe627f11","0c4079457ede49e3aeb5e86ed84bdf35",22854502,1,-21,0,1302,347,329,-18
"0c4079457ede49e3aeb5e86ed84bdf35","30ead9794d4847abaf222ca966cc8630",22854502,1,24,0,1303,329,348,19
"30ead9794d4847abaf222ca966cc8630","c20993c944444fe085345591a8bd837e",22854502,1,3,0,1304,348,351,3
"c20993c944444fe085345591a8bd837e","09b9678ddc3d452ea4a3d46e15826065",22854502,1,2,0,1305,351,353,2
"09b9678ddc3d452ea4a3d46e15826065","897b7f51242c44aab2205c72fdcbf4cd",22854502,1,-1,0,1306,353,352,-1
"897b7f51242c44aab2205c72fdcbf4cd","eff0de7f2dbb42dfa1a2e686efab5b6d",22854502,1,2,0,1307,352,354,2
"eff0de7f2dbb42dfa1a2e686efab5b6d","c20993c944444fe085345591a8bd837e",22854502,1,-3,0,1308,354,351,-3
"c20993c944444fe085345591a8bd837e","c20993c944444fe085345591a8bd837e",22854502,3,0,1,1309,351,351,0
"c20993c944444fe085345591a8bd837e","897b7f51242c44aab2205c72fdcbf4cd",22854502,1,1,0,1312,351,352,1
"897b7f51242c44aab2205c72fdcbf4cd","897b7f51242c44aab2205c72fdcbf4cd",22854502,3,0,1,1313,352,352,0
"897b7f51242c44aab2205c72fdcbf4cd","09b9678ddc3d452ea4a3d46e15826065",22854502,1,1,0,1316,352,353,1
"09b9678ddc3d452ea4a3d46e15826065","09b9678ddc3d452ea4a3d46e15826065",22854502,3,0,1,1317,353,353,0
"09b9678ddc3d452ea4a3d46e15826065","eff0de7f2dbb42dfa1a2e686efab5b6d",22854502,1,1,0,1320,353,354,1
"eff0de7f2dbb42dfa1a2e686efab5b6d","eff0de7f2dbb42dfa1a2e686efab5b6d",22854502,3,0,1,1321,354,354,0
"eff0de7f2dbb42dfa1a2e686efab5b6d","2fe14166dc9642c3bc666b86a57f943d",22854502,1,4,0,1324,354,357,3
"2fe14166dc9642c3bc666b86a57f943d","30ead9794d4847abaf222ca966cc8630",22854502,1,-10,0,1325,357,348,-9
"30ead9794d4847abaf222ca966cc8630","2fe14166dc9642c3bc666b86a57f943d",22854502,1,10,0,1326,348,357,9
"2fe14166dc9642c3bc666b86a57f943d","2fe14166dc9642c3bc666b86a57f943d",22854502,1,0,1,1327,357,357,0
"2fe14166dc9642c3bc666b86a57f943d","44421dd1e13a47a388c4a19834b744c7",22854502,1,2,0,1328,357,359,2
"44421dd1e13a47a388c4a19834b744c7","44421dd1e13a47a388c4a19834b744c7",22854502,2,0,1,1329,359,359,0
"44421dd1e13a47a388c4a19834b744c7","cb5fc7ef85d547c4be1a7439d0bf6052",22854502,1,1,0,1331,359,360,1
"cb5fc7ef85d547c4be1a7439d0bf6052","cb5fc7ef85d547c4be1a7439d0bf6052",22854502,5,0,1,1332,360,360,0
"cb5fc7ef85d547c4be1a7439d0bf6052","0a8f150a4cf747acbde62f4721823da3",22854502,1,1,0,1337,360,361,1
"0a8f150a4cf747acbde62f4721823da3","0a8f150a4cf747acbde62f4721823da3",22854502,2,0,1,1338,361,361,0
"0a8f150a4cf747acbde62f4721823da3","ab8fdad974ae471f9f24c3f9dd04462e",22854502,1,1,0,1340,361,362,1
"ab8fdad974ae471f9f24c3f9dd04462e","ab8fdad974ae471f9f24c3f9dd04462e",22854502,2,0,1,1341,362,362,0
"ab8fdad974ae471f9f24c3f9dd04462e","52580888dadb4fe3baa795683ea227bd",22854502,1,3,0,1343,362,364,2
"52580888dadb4fe3baa795683ea227bd","1ba8fef685d74a8194b9db252eb704fb",22854502,1,-10,0,1344,364,355,-9
"1ba8fef685d74a8194b9db252eb704fb","52580888dadb4fe3baa795683ea227bd",22854502,1,10,0,1345,355,364,9
"52580888dadb4fe3baa795683ea227bd","52580888dadb4fe3baa795683ea227bd",22854502,2,0,1,1346,364,364,0
"52580888dadb4fe3baa795683ea227bd","f00179e251a045b39c3f7a54f9aa4acc",22854502,2,-1,0,1347,364,363,-1
"f00179e251a045b39c3f7a54f9aa4acc","492a3bc6a1254f23a7998587961b22a4",22854502,2,4,0,1348,363,366,3
"492a3bc6a1254f23a7998587961b22a4","492a3bc6a1254f23a7998587961b22a4",22854502,1,0,1,1349,366,366,0
"492a3bc6a1254f23a7998587961b22a4","072a190fd302456290895f9f04d6940a",22854502,2,-1,0,1350,366,365,-1
"072a190fd302456290895f9f04d6940a","52580888dadb4fe3baa795683ea227bd",22854502,1,-2,0,1351,365,364,-1
"52580888dadb4fe3baa795683ea227bd","c76574d21bc14aeea7ecd0b027f39858",22854502,1,5,0,1352,364,367,3
"c76574d21bc14aeea7ecd0b027f39858","52580888dadb4fe3baa795683ea227bd",22854502,1,-5,0,1353,367,364,-3
"072a190fd302456290895f9f04d6940a","cfa457d1743848e4bb5e4beced6448ed",22854502,1,5,0,1358,365,369,4
"cfa457d1743848e4bb5e4beced6448ed","cfa457d1743848e4bb5e4beced6448ed",22854502,1,0,1,1359,369,369,0
"cfa457d1743848e4bb5e4beced6448ed","b71bac264efb4abd97015447bd490db6",22854502,1,3,0,1360,369,370,1
"b71bac264efb4abd97015447bd490db6","30ead9794d4847abaf222ca966cc8630",22854502,1,-28,0,1361,370,348,-22
"30ead9794d4847abaf222ca966cc8630","2ae94c0cea4d480a9d5dca8fb1d7b542",22854502,1,-142,0,1362,348,242,-106
"2ae94c0cea4d480a9d5dca8fb1d7b542","30c9ba177afc49a695625d2bdec40207",22854502,1,9,0,1363,242,250,8
"30c9ba177afc49a695625d2bdec40207","30c9ba177afc49a695625d2bdec40207",22854502,2,0,1,1364,250,250,0
"30c9ba177afc49a695625d2bdec40207","6e83e23f56544a19b94067c1c558d9c0",22854502,1,-3,0,1366,250,247,-3
"00f61990949545828dd12f1303d47504","fab84b4fab5940efb4ea868ef8d09396",22854502,1,39,0,1368,256,284,28
"fab84b4fab5940efb4ea868ef8d09396","fab84b4fab5940efb4ea868ef8d09396",22854502,2,0,1,1369,284,284,0
"fab84b4fab5940efb4ea868ef8d09396","4a29443515bb404cb8924e1c60a63b73",22854502,1,4,0,1371,284,285,1
"208c9b2796c944db8dacaa96082520ea","c2490bc612d146edbe786556fab3651b",22854502,1,68,0,1373,288,340,52
"c2490bc612d146edbe786556fab3651b","0c4079457ede49e3aeb5e86ed84bdf35",22854502,2,-13,0,1374,340,329,-11
"0c4079457ede49e3aeb5e86ed84bdf35","bbc5139ca9024389a94db3a6f47dcff6",22854502,2,14,0,1375,329,341,12
"bbc5139ca9024389a94db3a6f47dcff6","c2490bc612d146edbe786556fab3651b",22854502,3,-1,0,1376,341,340,-1
"c2490bc612d146edbe786556fab3651b","4a92daef4d504e1792575a26502bb7b7",22854502,1,7,0,1377,340,346,6
"4a92daef4d504e1792575a26502bb7b7","bbc5139ca9024389a94db3a6f47dcff6",22854502,1,-6,0,1378,346,341,-5
"c2490bc612d146edbe786556fab3651b","b71bac264efb4abd97015447bd490db6",22854502,1,39,0,1381,340,370,30
"b71bac264efb4abd97015447bd490db6","b71bac264efb4abd97015447bd490db6",22854502,2,0,1,1382,370,370,0
"b71bac264efb4abd97015447bd490db6","8d448d625b024c82a5eb240bbd7431d6",22854502,4,5,0,1384,370,374,4
"8d448d625b024c82a5eb240bbd7431d6","8d448d625b024c82a5eb240bbd7431d6",22854502,59,0,1,1385,374,374,0
"8d448d625b024c82a5eb240bbd7431d6","b71bac264efb4abd97015447bd490db6",22854502,3,-5,0,1391,374,370,-4
"b71bac264efb4abd97015447bd490db6","d6d02b6ef04e4f17805504500b8ce441",22854502,2,8,0,1440,370,375,5
"d6d02b6ef04e4f17805504500b8ce441","d6d02b6ef04e4f17805504500b8ce441",22854502,9,0,1,1441,375,375,0
"d6d02b6ef04e4f17805504500b8ce441","4a29443515bb404cb8924e1c60a63b73",22854502,1,-118,0,1442,375,285,-90
"4a29443515bb404cb8924e1c60a63b73","c2490bc612d146edbe786556fab3651b",22854502,1,71,0,1443,285,340,55
"c2490bc612d146edbe786556fab3651b","1b4550d0dab04078b3bf08a655345bdc",22854502,1,43,0,1447,340,373,33
"1b4550d0dab04078b3bf08a655345bdc","b71bac264efb4abd97015447bd490db6",22854502,1,-4,0,1448,373,370,-3
"8d448d625b024c82a5eb240bbd7431d6","d6d02b6ef04e4f17805504500b8ce441",22854502,1,3,0,1459,374,375,1
"d6d02b6ef04e4f17805504500b8ce441","b71bac264efb4abd97015447bd490db6",22854502,1,-8,0,1460,375,370,-5
"d6d02b6ef04e4f17805504500b8ce441","66baf19b6b904b70922329068c63746d",22854502,2,4,0,1468,375,376,1
"66baf19b6b904b70922329068c63746d","66baf19b6b904b70922329068c63746d",22854502,4,0,1,1469,376,376,0
"66baf19b6b904b70922329068c63746d","7f544639412e40a9ba27f43b415362ab",22854502,2,2,0,1471,376,378,2
"7f544639412e40a9ba27f43b415362ab","7f544639412e40a9ba27f43b415362ab",22854502,6,0,1,1472,378,378,0
"7f544639412e40a9ba27f43b415362ab","66baf19b6b904b70922329068c63746d",22854502,2,-2,0,1473,378,376,-2
"66baf19b6b904b70922329068c63746d","d6d02b6ef04e4f17805504500b8ce441",22854502,1,-4,0,1475,376,375,-1
"7f544639412e40a9ba27f43b415362ab","d5ae8642e15b46b8bd298b02274d4e9c",22854502,1,2,0,1485,378,380,2
"d5ae8642e15b46b8bd298b02274d4e9c","d5ae8642e15b46b8bd298b02274d4e9c",22854502,1,0,1,1486,380,380,0
"d5ae8642e15b46b8bd298b02274d4e9c","a0d10309a2dd456289147f84be9d37f9",22854502,1,1,0,1487,380,381,1
"a0d10309a2dd456289147f84be9d37f9","a0d10309a2dd456289147f84be9d37f9",22854502,2,0,1,1488,381,381,0
"a0d10309a2dd456289147f84be9d37f9","0fcbc3ca07b144138b8d85da581f09a8",22854502,1,1,0,1490,381,382,1
"0fcbc3ca07b144138b8d85da581f09a8","0fcbc3ca07b144138b8d85da581f09a8",22854502,5,0,1,1491,382,382,0
"0fcbc3ca07b144138b8d85da581f09a8","66baf19b6b904b70922329068c63746d",22854502,1,-6,0,1496,382,376,-6
"66baf19b6b904b70922329068c63746d","c2fca3669923477ab966ded303dea31c",22854502,1,8,0,1497,376,383,7
"c2fca3669923477ab966ded303dea31c","7f544639412e40a9ba27f43b415362ab",22854502,1,-6,0,1498,383,378,-5
"66baf19b6b904b70922329068c63746d","4890121ce5d74576b4632b77cfc23398",22854502,1,14,0,1501,376,388,12
"4890121ce5d74576b4632b77cfc23398","c2fca3669923477ab966ded303dea31c",22854502,1,-6,0,1502,388,383,-5
"c2fca3669923477ab966ded303dea31c","4890121ce5d74576b4632b77cfc23398",22854502,1,6,0,1503,383,388,5
"4890121ce5d74576b4632b77cfc23398","4890121ce5d74576b4632b77cfc23398",22854502,1,0,1,1504,388,388,0
"4890121ce5d74576b4632b77cfc23398","18d3b836dd804224883cc9180b60a8e1",22854502,1,-1,0,1505,388,387,-1
"18d3b836dd804224883cc9180b60a8e1","96bb2b3e85a34d8b9544514e89f6fe97",22854502,1,4,0,1506,387,390,3
"96bb2b3e85a34d8b9544514e89f6fe97","96bb2b3e85a34d8b9544514e89f6fe97",22854502,3,0,1,1507,390,390,0
"96bb2b3e85a34d8b9544514e89f6fe97","ac4e9b54acfe4670b4634859c7263cb5",22854502,1,2,0,1510,390,392,2
"ac4e9b54acfe4670b4634859c7263cb5","ac4e9b54acfe4670b4634859c7263cb5",22854502,3,0,1,1511,392,392,0
"ac4e9b54acfe4670b4634859c7263cb5","17f95d18bab743888e1736033dc3384d",22854502,1,-3,0,1514,392,389,-3
"17f95d18bab743888e1736033dc3384d","6f8881a745ac4c358a68b92c3b4abe81",22854502,1,6,0,1515,389,394,5
"6f8881a745ac4c358a68b92c3b4abe81","6f8881a745ac4c358a68b92c3b4abe81",22854502,2,0,1,1516,394,394,0
"6f8881a745ac4c358a68b92c3b4abe81","f7002c8484354eceac57bc7bd62c76c1",22854502,1,-1,0,1518,394,393,-1
"f7002c8484354eceac57bc7bd62c76c1","44a277ea44dc4ae689fab4b82f0b4098",22854502,1,5,0,1519,393,397,4
"44a277ea44dc4ae689fab4b82f0b4098","44a277ea44dc4ae689fab4b82f0b4098",22854502,1,0,1,1520,397,397,0
"44a277ea44dc4ae689fab4b82f0b4098","0c12af0a4e7f4002852cf84b2537c161",22854502,1,-2,0,1521,397,395,-2
"0c12af0a4e7f4002852cf84b2537c161","859e0b8d71694b12befb69ee698138f9",22854502,1,5,0,1522,395,399,4
"859e0b8d71694b12befb69ee698138f9","859e0b8d71694b12befb69ee698138f9",22854502,1,0,1,1523,399,399,0
"859e0b8d71694b12befb69ee698138f9","66baf19b6b904b70922329068c63746d",22854502,1,-29,0,1524,399,376,-23
"66baf19b6b904b70922329068c63746d","2b09a08242b54983aec7063990fb3f66",22854502,1,32,0,1525,376,400,24
"2b09a08242b54983aec7063990fb3f66","2b09a08242b54983aec7063990fb3f66",22854502,4,0,1,1526,400,400,0
"2b09a08242b54983aec7063990fb3f66","1f471b7a883a4df48211e8c6a81b59a7",22854502,1,1,0,1530,400,401,1
"1f471b7a883a4df48211e8c6a81b59a7","1f471b7a883a4df48211e8c6a81b59a7",22854502,1,0,1,1531,401,401,0
"1f471b7a883a4df48211e8c6a81b59a7","2b09a08242b54983aec7063990fb3f66",22854502,1,-1,0,1532,401,400,-1
"2b09a08242b54983aec7063990fb3f66","9de0d567bfa84fe5b77cb76f4a76a5d1",22854502,1,5,0,1533,400,404,4
"9de0d567bfa84fe5b77cb76f4a76a5d1","9de0d567bfa84fe5b77cb76f4a76a5d1",22854502,1,0,1,1534,404,404,0
"9de0d567bfa84fe5b77cb76f4a76a5d1","1157bd665ec4472fb58b751dc5099355",22854502,1,-1,0,1535,404,403,-1
"1157bd665ec4472fb58b751dc5099355","3c8a22d2f9c146ea956609e3ed4f2559",22854502,1,3,0,1536,403,405,2
"3c8a22d2f9c146ea956609e3ed4f2559","58fc9094275e4c49be3f4ba6d4acc0a4",22854502,1,2,0,1537,405,406,1
"58fc9094275e4c49be3f4ba6d4acc0a4","c1c1be90b2b14c1ab4a5e1ee3c241902",22854502,1,1,0,1538,406,407,1
"c1c1be90b2b14c1ab4a5e1ee3c241902","c1c1be90b2b14c1ab4a5e1ee3c241902",22854502,5,0,1,1539,407,407,0
"c1c1be90b2b14c1ab4a5e1ee3c241902","58fc9094275e4c49be3f4ba6d4acc0a4",22854502,1,-1,0,1544,407,406,-1
"58fc9094275e4c49be3f4ba6d4acc0a4","58fc9094275e4c49be3f4ba6d4acc0a4",22854502,2,0,1,1545,406,406,0
"58fc9094275e4c49be3f4ba6d4acc0a4","02b3a1bead9244c1ba2f857c7da8f82a",22854502,1,3,0,1547,406,408,2
"02b3a1bead9244c1ba2f857c7da8f82a","02b3a1bead9244c1ba2f857c7da8f82a",22854502,2,0,1,1548,408,408,0
"02b3a1bead9244c1ba2f857c7da8f82a","6206fc6479014bb193084c32409dc1b9",22854502,1,1,0,1549,408,409,1
"6206fc6479014bb193084c32409dc1b9","6206fc6479014bb193084c32409dc1b9",22854502,1,0,1,1550,409,409,0
"6206fc6479014bb193084c32409dc1b9","02b3a1bead9244c1ba2f857c7da8f82a",22854502,1,-1,0,1551,409,408,-1
"02b3a1bead9244c1ba2f857c7da8f82a","6a5f020451db426dacba9e2ea3fcc62a",22854502,1,3,0,1553,408,410,2
"6a5f020451db426dacba9e2ea3fcc62a","6a5f020451db426dacba9e2ea3fcc62a",22854502,4,0,1,1554,410,410,0
"6a5f020451db426dacba9e2ea3fcc62a","33a9d248b2e44588a5b07fc1342b9bc2",22854502,1,2,0,1558,410,411,1
"33a9d248b2e44588a5b07fc1342b9bc2","33a9d248b2e44588a5b07fc1342b9bc2",22854502,11,0,1,1559,411,411,0
"33a9d248b2e44588a5b07fc1342b9bc2","c6f26bd420634f1cb7989e76fe6b16c0",22854502,1,1,0,1561,411,412,1
"c6f26bd420634f1cb7989e76fe6b16c0","c6f26bd420634f1cb7989e76fe6b16c0",22854502,5,0,1,1562,412,412,0
"c6f26bd420634f1cb7989e76fe6b16c0","2a65ee6e2ac64f6a8a55fbe5373ec763",22854502,1,1,0,1567,412,413,1
"2a65ee6e2ac64f6a8a55fbe5373ec763","2a65ee6e2ac64f6a8a55fbe5373ec763",22854502,2,0,1,1568,413,413,0
"2a65ee6e2ac64f6a8a55fbe5373ec763","33a9d248b2e44588a5b07fc1342b9bc2",22854502,1,-2,0,1570,413,411,-2
"33a9d248b2e44588a5b07fc1342b9bc2","687055dad9fc40c3982478fe33ec01bf",22854502,1,4,0,1571,411,414,3
"687055dad9fc40c3982478fe33ec01bf","33a9d248b2e44588a5b07fc1342b9bc2",22854502,1,-4,0,1572,414,411,-3
"33a9d248b2e44588a5b07fc1342b9bc2","1fd0f6dadbc14ebc965faf6122190b96",22854502,1,5,0,1582,411,415,4
"1fd0f6dadbc14ebc965faf6122190b96","1fd0f6dadbc14ebc965faf6122190b96",22854502,1,0,1,1583,415,415,0
"1fd0f6dadbc14ebc965faf6122190b96","687055dad9fc40c3982478fe33ec01bf",22854502,1,-1,0,1584,415,414,-1
"687055dad9fc40c3982478fe33ec01bf","2add1669f08d4101913db15f8c23b3b7",22854502,1,3,0,1585,414,416,2
"2add1669f08d4101913db15f8c23b3b7","2add1669f08d4101913db15f8c23b3b7",22854502,1,0,1,1586,416,416,0
"2add1669f08d4101913db15f8c23b3b7","2b09a08242b54983aec7063990fb3f66",22854502,1,-24,0,1587,416,400,-16
"2b09a08242b54983aec7063990fb3f66","a2b4bd40cee2481ebd3fc179d6a5cd62",22854502,1,27,0,1588,400,417,17
"a2b4bd40cee2481ebd3fc179d6a5cd62","e34e59dce2204f228f3a84b6725df60f",22854502,1,2,0,1589,417,419,2
"e34e59dce2204f228f3a84b6725df60f","e34e59dce2204f228f3a84b6725df60f",22854502,1,0,1,1590,419,419,0
"e34e59dce2204f228f3a84b6725df60f","a2b4bd40cee2481ebd3fc179d6a5cd62",22854502,1,-2,0,1591,419,417,-2
"a2b4bd40cee2481ebd3fc179d6a5cd62","bec48fc2e1294c7eb3d0aca780d731b8",22854502,1,4,0,1592,417,420,3
"bec48fc2e1294c7eb3d0aca780d731b8","bec48fc2e1294c7eb3d0aca780d731b8",22854502,3,0,1,1593,420,420,0
"bec48fc2e1294c7eb3d0aca780d731b8","dbde19fcce2a4c1abdc7f685c293a23f",22854502,1,3,0,1596,420,422,2
"dbde19fcce2a4c1abdc7f685c293a23f","a24600b0e49245f6bdba8c893cfeddb0",22854502,1,4,0,1597,422,425,3
"a24600b0e49245f6bdba8c893cfeddb0","a24600b0e49245f6bdba8c893cfeddb0",22854502,3,0,1,1598,425,425,0
"a24600b0e49245f6bdba8c893cfeddb0","a2b4bd40cee2481ebd3fc179d6a5cd62",22854502,1,-11,0,1601,425,417,-8
"a2b4bd40cee2481ebd3fc179d6a5cd62","24cf8786024543f19b89bc20034e60d7",22854502,1,18,0,1602,417,428,11
"24cf8786024543f19b89bc20034e60d7","a2b4bd40cee2481ebd3fc179d6a5cd62",22854502,1,-18,0,1603,428,417,-11
"a2b4bd40cee2481ebd3fc179d6a5cd62","f2a73be2f46840b182d7bd095378004e",22854502,1,19,0,1604,417,429,12
"f2a73be2f46840b182d7bd095378004e","f2a73be2f46840b182d7bd095378004e",22854502,3,0,1,1605,429,429,0
"f2a73be2f46840b182d7bd095378004e","604551fd4266430cb860fef58fa7dd61",22854502,1,1,0,1608,429,430,1
"604551fd4266430cb860fef58fa7dd61","604551fd4266430cb860fef58fa7dd61",22854502,1,0,1,1609,430,430,0
"604551fd4266430cb860fef58fa7dd61","dce46f8904594a62a6377a3587aaa663",22854502,1,2,0,1610,430,431,1
"dce46f8904594a62a6377a3587aaa663","24cf8786024543f19b89bc20034e60d7",22854502,1,-4,0,1611,431,428,-3
"24cf8786024543f19b89bc20034e60d7","dce46f8904594a62a6377a3587aaa663",22854502,1,4,0,1612,428,431,3
"dce46f8904594a62a6377a3587aaa663","dce46f8904594a62a6377a3587aaa663",22854502,1,0,1,1613,431,431,0
"dce46f8904594a62a6377a3587aaa663","9b9d0a249052413c869753b99682b0ac",22854502,1,1,0,1614,431,432,1
"9b9d0a249052413c869753b99682b0ac","9b9d0a249052413c869753b99682b0ac",22854502,1,0,1,1615,432,432,0
"9b9d0a249052413c869753b99682b0ac","061c175cc90f45fbad883025394e78dd",22854502,1,1,0,1616,432,433,1
"061c175cc90f45fbad883025394e78dd","061c175cc90f45fbad883025394e78dd",22854502,4,0,1,1617,433,433,0
"061c175cc90f45fbad883025394e78dd","dce46f8904594a62a6377a3587aaa663",22854502,1,-2,0,1621,433,431,-2
"dce46f8904594a62a6377a3587aaa663","74a7f8712e5449c2bc0b43c6f90dafed",22854502,1,5,0,1622,431,435,4
"74a7f8712e5449c2bc0b43c6f90dafed","74a7f8712e5449c2bc0b43c6f90dafed",22854502,1,0,1,1623,435,435,0
"74a7f8712e5449c2bc0b43c6f90dafed","66ada10dde9f43018588f1ced9d477fc",22854502,1,-1,0,1624,435,434,-1
"66ada10dde9f43018588f1ced9d477fc","bf12c96466d840a69bed7020b3f18bb8",22854502,1,3,0,1625,434,436,2
"bf12c96466d840a69bed7020b3f18bb8","bf12c96466d840a69bed7020b3f18bb8",22854502,2,0,1,1626,436,436,0
"bf12c96466d840a69bed7020b3f18bb8","070600601c4c439288445d2f0724807d",22854502,1,3,0,1628,436,437,1
"070600601c4c439288445d2f0724807d","24cf8786024543f19b89bc20034e60d7",22854502,1,-14,0,1629,437,428,-9
"24cf8786024543f19b89bc20034e60d7","1823b6de7d334a7aaabc4570719af4d9",22854502,1,16,0,1630,428,439,11
"1823b6de7d334a7aaabc4570719af4d9","1823b6de7d334a7aaabc4570719af4d9",22854502,11,0,1,1631,439,439,0
"1823b6de7d334a7aaabc4570719af4d9","0380cd76a7d44bc3a4da1f15e4d68f89",22854502,1,2,0,1642,439,440,1
"0380cd76a7d44bc3a4da1f15e4d68f89","070600601c4c439288445d2f0724807d",22854502,1,-4,0,1643,440,437,-3
"070600601c4c439288445d2f0724807d","0380cd76a7d44bc3a4da1f15e4d68f89",22854502,1,4,0,1644,437,440,3
"0380cd76a7d44bc3a4da1f15e4d68f89","0380cd76a7d44bc3a4da1f15e4d68f89",22854502,2,0,1,1645,440,440,0
"0380cd76a7d44bc3a4da1f15e4d68f89","23b7673c8b5443108c2ef09382834a86",22854502,1,2,0,1647,440,441,1
"23b7673c8b5443108c2ef09382834a86","23b7673c8b5443108c2ef09382834a86",22854502,1,0,1,1648,441,441,0
"23b7673c8b5443108c2ef09382834a86","901e92500aea43c79f19f1b279050668",22854502,2,2,0,1649,441,442,1
"901e92500aea43c79f19f1b279050668","23b7673c8b5443108c2ef09382834a86",22854502,1,-2,0,1650,442,441,-1
"901e92500aea43c79f19f1b279050668","001339db8ced4cf78829ebe8b145449d",22854502,1,1,0,1652,442,443,1
"001339db8ced4cf78829ebe8b145449d","001339db8ced4cf78829ebe8b145449d",22854502,5,0,1,1653,443,443,0
"001339db8ced4cf78829ebe8b145449d","452745e0366e42ae81561bfddebcc6c3",22854502,1,1,0,1658,443,444,1
"452745e0366e42ae81561bfddebcc6c3","452745e0366e42ae81561bfddebcc6c3",22854502,2,0,1,1659,444,444,0
"452745e0366e42ae81561bfddebcc6c3","901e92500aea43c79f19f1b279050668",22854502,1,-2,0,1661,444,442,-2
"901e92500aea43c79f19f1b279050668","4660ff2089114e8db82ceb26a4f329e3",22854502,1,4,0,1662,442,445,3
"4660ff2089114e8db82ceb26a4f329e3","4660ff2089114e8db82ceb26a4f329e3",22854502,2,0,1,1663,445,445,0
"4660ff2089114e8db82ceb26a4f329e3","7bd5586eb9d8484eb74a433ee7bfe499",22854502,1,2,0,1665,445,446,1
"7bd5586eb9d8484eb74a433ee7bfe499","7bd5586eb9d8484eb74a433ee7bfe499",22854502,53,0,1,1666,446,446,0
"7bd5586eb9d8484eb74a433ee7bfe499","070600601c4c439288445d2f0724807d",22854502,3,-14,0,1703,446,437,-9
"070600601c4c439288445d2f0724807d","1823b6de7d334a7aaabc4570719af4d9",22854502,2,2,0,1704,437,439,2
"1823b6de7d334a7aaabc4570719af4d9","070600601c4c439288445d2f0724807d",22854502,1,-2,0,1705,439,437,-2
"070600601c4c439288445d2f0724807d","7bd5586eb9d8484eb74a433ee7bfe499",22854502,2,14,0,1706,437,446,9
"1823b6de7d334a7aaabc4570719af4d9","7bd5586eb9d8484eb74a433ee7bfe499",22854502,1,12,0,1719,439,446,7
"7bd5586eb9d8484eb74a433ee7bfe499","8a7f26e690f34dda97be16904518ca99",22854502,1,2,0,1728,446,447,1
"8a7f26e690f34dda97be16904518ca99","8a7f26e690f34dda97be16904518ca99",22854502,1,0,1,1729,447,447,0
"8a7f26e690f34dda97be16904518ca99","b2f0d654738f48158edff28e8d3a546e",22854502,1,5,0,1730,447,449,2
"b2f0d654738f48158edff28e8d3a546e","070600601c4c439288445d2f0724807d",22854502,1,-21,0,1731,449,437,-12
"070600601c4c439288445d2f0724807d","f60ee41ec635499abd48168342d32c2f",22854502,1,26,0,1732,437,453,16
"f60ee41ec635499abd48168342d32c2f","b2f0d654738f48158edff28e8d3a546e",22854502,2,-5,0,1733,453,449,-4
"b2f0d654738f48158edff28e8d3a546e","f60ee41ec635499abd48168342d32c2f",22854502,2,5,0,1734,449,453,4
"f60ee41ec635499abd48168342d32c2f","f60ee41ec635499abd48168342d32c2f",22854502,5,0,1,1735,453,453,0
"f60ee41ec635499abd48168342d32c2f","f67fbf45a5f146ed866965bc57c7c001",22854502,1,3,0,1742,453,454,1
"f67fbf45a5f146ed866965bc57c7c001","f67fbf45a5f146ed866965bc57c7c001",22854502,2,0,1,1743,454,454,0
"f67fbf45a5f146ed866965bc57c7c001","d937afe49bd24a07a550dda1c1155122",22854502,1,1,0,1745,454,455,1
"d937afe49bd24a07a550dda1c1155122","d937afe49bd24a07a550dda1c1155122",22854502,3,0,1,1746,455,455,0
"d937afe49bd24a07a550dda1c1155122","3628b3f7823443d0912a339096b69943",22854502,1,1,0,1749,455,456,1
"3628b3f7823443d0912a339096b69943","3628b3f7823443d0912a339096b69943",22854502,1,0,1,1750,456,456,0
"3628b3f7823443d0912a339096b69943","9e049ee647cf43ecbcb5ed792a8e7588",22854502,1,1,0,1751,456,457,1
"9e049ee647cf43ecbcb5ed792a8e7588","9e049ee647cf43ecbcb5ed792a8e7588",22854502,1,0,1,1752,457,457,0
"9e049ee647cf43ecbcb5ed792a8e7588","5256a214faaf410b93f76cea06428334",22854502,1,1,0,1753,457,458,1
"5256a214faaf410b93f76cea06428334","5256a214faaf410b93f76cea06428334",22854502,1,0,1,1754,458,458,0
"5256a214faaf410b93f76cea06428334","25c32b120fce40fa9b6c85133aeb4716",22854502,1,1,0,1755,458,459,1
"25c32b120fce40fa9b6c85133aeb4716","25c32b120fce40fa9b6c85133aeb4716",22854502,6,0,1,1756,459,459,0
"25c32b120fce40fa9b6c85133aeb4716","11bc14f2204949008b7d511b933363c1",22854502,1,1,0,1762,459,460,1
"11bc14f2204949008b7d511b933363c1","11bc14f2204949008b7d511b933363c1",22854502,6,0,1,1763,460,460,0
"11bc14f2204949008b7d511b933363c1","42de338840a34d15adb66e7b14fb9d2c",22854502,1,1,0,1769,460,461,1
"42de338840a34d15adb66e7b14fb9d2c","42de338840a34d15adb66e7b14fb9d2c",22854502,3,0,1,1770,461,461,0
"42de338840a34d15adb66e7b14fb9d2c","9da37c6210b1416b8079c274f70bf600",22854502,1,1,0,1773,461,462,1
"9da37c6210b1416b8079c274f70bf600","9da37c6210b1416b8079c274f70bf600",22854502,1,0,1,1774,462,462,0
"9da37c6210b1416b8079c274f70bf600","519119f1deac45ff9ab4f13529be5c6e",22854502,1,1,0,1775,462,463,1
"519119f1deac45ff9ab4f13529be5c6e","519119f1deac45ff9ab4f13529be5c6e",22854502,3,0,1,1776,463,463,0
"519119f1deac45ff9ab4f13529be5c6e","f67fbf45a5f146ed866965bc57c7c001",22854502,1,-9,0,1779,463,454,-9
"f67fbf45a5f146ed866965bc57c7c001","c5df9f40ec14463b9dcfdc73df3e9285",22854502,2,12,0,1780,454,464,10
"c5df9f40ec14463b9dcfdc73df3e9285","c5df9f40ec14463b9dcfdc73df3e9285",22854502,5,0,1,1781,464,464,0
"c5df9f40ec14463b9dcfdc73df3e9285","f67fbf45a5f146ed866965bc57c7c001",22854502,1,-12,0,1782,464,454,-10
"c5df9f40ec14463b9dcfdc73df3e9285","11bc14f2204949008b7d511b933363c1",22854502,1,-6,0,1786,464,460,-4
"11bc14f2204949008b7d511b933363c1","c5df9f40ec14463b9dcfdc73df3e9285",22854502,1,6,0,1787,460,464,4
"c5df9f40ec14463b9dcfdc73df3e9285","83d42d95cd844fc093fc09cee250edb8",22854502,1,3,0,1790,464,465,1
"83d42d95cd844fc093fc09cee250edb8","83d42d95cd844fc093fc09cee250edb8",22854502,4,0,1,1791,465,465,0
"83d42d95cd844fc093fc09cee250edb8","c5df9f40ec14463b9dcfdc73df3e9285",22854502,1,-3,0,1795,465,464,-1
"c5df9f40ec14463b9dcfdc73df3e9285","25c32b120fce40fa9b6c85133aeb4716",22854502,1,-7,0,1796,464,459,-5
"25c32b120fce40fa9b6c85133aeb4716","4e51676dc72045d99c19b9fa7b22f8bc",22854502,1,-598,0,1797,459,29,-430
"4e51676dc72045d99c19b9fa7b22f8bc","f67fbf45a5f146ed866965bc57c7c001",22854502,1,593,0,1798,29,454,425
"f67fbf45a5f146ed866965bc57c7c001","11bc14f2204949008b7d511b933363c1",22854502,1,6,0,1799,454,460,6
"b613861cecf84ffcab01afb23f660475","b613861cecf84ffcab01afb23f660475",22855176,10,0,1,1,1,1,0
"b613861cecf84ffcab01afb23f660475","e2911e79efc2420eac45d9f671463d4b",22855176,5,3,0,12,1,2,1
"e2911e79efc2420eac45d9f671463d4b","b613861cecf84ffcab01afb23f660475",22855176,4,-3,0,13,2,1,-1
"e2911e79efc2420eac45d9f671463d4b","e2911e79efc2420eac45d9f671463d4b",22855176,2,0,1,15,2,2,0
"e2911e79efc2420eac45d9f671463d4b","519d1b8c59404d67b54e96c5c8a830b2",22855176,1,1,0,16,2,3,1
"519d1b8c59404d67b54e96c5c8a830b2","519d1b8c59404d67b54e96c5c8a830b2",22855176,1,0,1,17,3,3,0
"519d1b8c59404d67b54e96c5c8a830b2","531db53f81f646edb0cdcfe0085b03b7",22855176,1,1,0,18,3,4,1
"531db53f81f646edb0cdcfe0085b03b7","531db53f81f646edb0cdcfe0085b03b7",22855176,1,0,1,19,4,4,0
"531db53f81f646edb0cdcfe0085b03b7","4f5f94b2f95141e0a9d53a61da2276da",22855176,1,1,0,20,4,5,1
"4f5f94b2f95141e0a9d53a61da2276da","4f5f94b2f95141e0a9d53a61da2276da",22855176,1,0,1,21,5,5,0
"4f5f94b2f95141e0a9d53a61da2276da","6d541c89590949f99af293c4f2333f67",22855176,1,1,0,22,5,6,1
"6d541c89590949f99af293c4f2333f67","6d541c89590949f99af293c4f2333f67",22855176,1,0,1,23,6,6,0
"6d541c89590949f99af293c4f2333f67","dd5cf0b9fe4c4f1d8f5ff8e4c04879cb",22855176,1,1,0,24,6,7,1
"dd5cf0b9fe4c4f1d8f5ff8e4c04879cb","dd5cf0b9fe4c4f1d8f5ff8e4c04879cb",22855176,1,0,1,25,7,7,0
"dd5cf0b9fe4c4f1d8f5ff8e4c04879cb","f96261861edc426abe2248be4f0a709a",22855176,1,1,0,26,7,8,1
"f96261861edc426abe2248be4f0a709a","f96261861edc426abe2248be4f0a709a",22855176,1,0,1,27,8,8,0
"f96261861edc426abe2248be4f0a709a","66b5e16f4f75454fb5b8172079f0fa83",22855176,1,1,0,28,8,9,1
"66b5e16f4f75454fb5b8172079f0fa83","66b5e16f4f75454fb5b8172079f0fa83",22855176,2,0,1,29,9,9,0
"66b5e16f4f75454fb5b8172079f0fa83","0680571d4698477995e41842c36a54b2",22855176,1,1,0,31,9,10,1
"0680571d4698477995e41842c36a54b2","0680571d4698477995e41842c36a54b2",22855176,1,0,1,32,10,10,0
"0680571d4698477995e41842c36a54b2","9112f2bffece48e08c6d2287be204085",22855176,1,1,0,33,10,11,1
"9112f2bffece48e08c6d2287be204085","9112f2bffece48e08c6d2287be204085",22855176,1,0,1,34,11,11,0
"9112f2bffece48e08c6d2287be204085","56586aa865414f538729c7f7735d2bc6",22855176,1,3,0,35,11,12,1
"56586aa865414f538729c7f7735d2bc6","e2911e79efc2420eac45d9f671463d4b",22855176,1,-12,0,36,12,2,-10
"e2911e79efc2420eac45d9f671463d4b","56586aa865414f538729c7f7735d2bc6",22855176,1,12,0,37,2,12,10
"56586aa865414f538729c7f7735d2bc6","56586aa865414f538729c7f7735d2bc6",22855176,12,0,1,38,12,12,0
"56586aa865414f538729c7f7735d2bc6","b7f2b31585d94eb3bf86376714aa7070",22855176,2,2,0,41,12,13,1
"b7f2b31585d94eb3bf86376714aa7070","b7f2b31585d94eb3bf86376714aa7070",22855176,9,0,1,42,13,13,0
"b7f2b31585d94eb3bf86376714aa7070","3f1c815879794b929260d224becaff7e",22855176,2,2,0,50,13,14,1
"3f1c815879794b929260d224becaff7e","81c864a886d54a6b8ff85f7d736f4f95",22855176,1,2,0,51,14,15,1
"81c864a886d54a6b8ff85f7d736f4f95","3f1c815879794b929260d224becaff7e",22855176,1,-2,0,52,15,14,-1
"3f1c815879794b929260d224becaff7e","56586aa865414f538729c7f7735d2bc6",22855176,2,-4,0,53,14,12,-2
"5c5ceeee4562457ba6d41515aeebfbb1","81c864a886d54a6b8ff85f7d736f4f95",22855176,1,-4,0,57,17,15,-2
"81c864a886d54a6b8ff85f7d736f4f95","eb2a0eb537344a9e891c761662e400b6",22855176,1,2,0,58,15,16,1
"5c5ceeee4562457ba6d41515aeebfbb1","5c5ceeee4562457ba6d41515aeebfbb1",22855176,2,0,1,61,17,17,0
"5c5ceeee4562457ba6d41515aeebfbb1","56586aa865414f538729c7f7735d2bc6",22855176,1,-10,0,63,17,12,-5
"56586aa865414f538729c7f7735d2bc6","9afd71a5298d4333b6849dfce1b9422c",22855176,1,13,0,64,12,18,6
"9afd71a5298d4333b6849dfce1b9422c","9afd71a5298d4333b6849dfce1b9422c",22855176,6,0,1,65,18,18,0
"9afd71a5298d4333b6849dfce1b9422c","b7719e26494940efa49512aedd0aac79",22855176,2,4,0,70,18,20,2
"a49d1bb4328949299686242fd0be5584","afbf7250b99d47bea07172749483ca97",22855176,1,10,0,72,21,28,7
"afbf7250b99d47bea07172749483ca97","b7719e26494940efa49512aedd0aac79",22855176,1,-12,0,73,28,20,-8
"afbf7250b99d47bea07172749483ca97","4e51676dc72045d99c19b9fa7b22f8bc",22855176,1,3,0,75,28,29,1
"4e51676dc72045d99c19b9fa7b22f8bc","4e51676dc72045d99c19b9fa7b22f8bc",22855176,3,0,1,76,29,29,0
"4e51676dc72045d99c19b9fa7b22f8bc","51970cfa30e643e894e66ae85c8024cc",22855176,2,3,0,77,29,31,2
"51970cfa30e643e894e66ae85c8024cc","c33c17be71ae4d588da7369472e5bb1b",22855176,1,6,0,78,31,34,3
"9a0dc646f934470daf08c4b56ccf73db","9a0dc646f934470daf08c4b56ccf73db",22855176,1,0,1,86,37,37,0
"64d48c6c9c7940639a932219a6c87198","64d48c6c9c7940639a932219a6c87198",22855176,1,0,1,91,40,40,0
"b534b89233134e30a9b5645138bfa9ee","67a089198fcb4e1c8f2385786c2b296f",22855176,1,-4,0,94,41,39,-2
"b534b89233134e30a9b5645138bfa9ee","6875d67fdd5f48168b62719df449bebd",22855176,1,4,0,98,41,45,4
"6875d67fdd5f48168b62719df449bebd","6875d67fdd5f48168b62719df449bebd",22855176,5,0,1,100,45,45,0
"6875d67fdd5f48168b62719df449bebd","b534b89233134e30a9b5645138bfa9ee",22855176,2,-4,0,103,45,41,-4
"b534b89233134e30a9b5645138bfa9ee","6e13d61a7bdb44bca949c9f86fab3be5",22855176,5,7,0,104,41,47,6
"6e13d61a7bdb44bca949c9f86fab3be5","6e13d61a7bdb44bca949c9f86fab3be5",22855176,2,0,1,105,47,47,0
"6e13d61a7bdb44bca949c9f86fab3be5","195f78799f984cc2b06c48dfe36be751",22855176,2,2,0,107,47,49,2
"195f78799f984cc2b06c48dfe36be751","195f78799f984cc2b06c48dfe36be751",22855176,5,0,1,108,49,49,0
"195f78799f984cc2b06c48dfe36be751","d0c74f735e024943943e40333d6d337f",22855176,1,3,0,111,49,51,2
"d0c74f735e024943943e40333d6d337f","d9c8d8c444a64dadbbb508652c721e17",22855176,1,-6,0,112,51,46,-5
"d9c8d8c444a64dadbbb508652c721e17","f924752d8a1149668870b1e7698486f7",22855176,1,5,0,113,46,50,4
"f924752d8a1149668870b1e7698486f7","0e37b720d23b4e7f8b313e79313fd107",22855176,2,-8,0,114,50,44,-6
"0e37b720d23b4e7f8b313e79313fd107","0e37b720d23b4e7f8b313e79313fd107",22855176,4,0,1,115,44,44,0
"0e37b720d23b4e7f8b313e79313fd107","b534b89233134e30a9b5645138bfa9ee",22855176,1,-3,0,118,44,41,-3
"b534b89233134e30a9b5645138bfa9ee","d0c74f735e024943943e40333d6d337f",22855176,1,12,0,119,41,51,10
"d0c74f735e024943943e40333d6d337f","d0c74f735e024943943e40333d6d337f",22855176,1,0,1,120,51,51,0
"d0c74f735e024943943e40333d6d337f","983f8ff320594b279a7f4a6fe132f9c5",22855176,1,2,0,121,51,53,2
"983f8ff320594b279a7f4a6fe132f9c5","983f8ff320594b279a7f4a6fe132f9c5",22855176,6,0,1,122,53,53,0
"983f8ff320594b279a7f4a6fe132f9c5","f924752d8a1149668870b1e7698486f7",22855176,1,-3,0,128,53,50,-3
"0e37b720d23b4e7f8b313e79313fd107","6875d67fdd5f48168b62719df449bebd",22855176,1,1,0,131,44,45,1
"195f78799f984cc2b06c48dfe36be751","d9c8d8c444a64dadbbb508652c721e17",22855176,1,-3,0,138,49,46,-3
"d9c8d8c444a64dadbbb508652c721e17","d0c74f735e024943943e40333d6d337f",22855176,2,6,0,139,46,51,5
"d0c74f735e024943943e40333d6d337f","b534b89233134e30a9b5645138bfa9ee",22855176,1,-12,0,140,51,41,-10
"b534b89233134e30a9b5645138bfa9ee","35adfa5d923046aebabfefd98f35ff05",22855176,1,15,0,141,41,54,13
"35adfa5d923046aebabfefd98f35ff05","35adfa5d923046aebabfefd98f35ff05",22855176,8,0,1,142,54,54,0
"35adfa5d923046aebabfefd98f35ff05","b6f8a98476224da1b40e555ececc7ed8",22855176,1,1,0,150,54,55,1
"b6f8a98476224da1b40e555ececc7ed8","b6f8a98476224da1b40e555ececc7ed8",22855176,2,0,1,151,55,55,0
"b6f8a98476224da1b40e555ececc7ed8","86e22cb5fe0e4b47a9489ecddf7ed78f",22855176,1,1,0,153,55,56,1
"86e22cb5fe0e4b47a9489ecddf7ed78f","86e22cb5fe0e4b47a9489ecddf7ed78f",22855176,2,0,1,154,56,56,0
"86e22cb5fe0e4b47a9489ecddf7ed78f","f924752d8a1149668870b1e7698486f7",22855176,1,-6,0,156,56,50,-6
"f924752d8a1149668870b1e7698486f7","78f30e4dcac84e3cbea8b2cc6e0d62b3",22855176,2,10,0,157,50,59,9
"78f30e4dcac84e3cbea8b2cc6e0d62b3","a1f2f12debe5432fb7a70bcd12bacfb9",22855176,3,-1,0,158,59,58,-1
"a1f2f12debe5432fb7a70bcd12bacfb9","a1f2f12debe5432fb7a70bcd12bacfb9",22855176,23,0,1,159,58,58,0
"a1f2f12debe5432fb7a70bcd12bacfb9","d0c74f735e024943943e40333d6d337f",22855176,1,-8,0,170,58,51,-7
"d0c74f735e024943943e40333d6d337f","12aa6e1672ac4e7aa6449a7a8609cd72",22855176,1,7,0,171,51,57,6
"12aa6e1672ac4e7aa6449a7a8609cd72","f924752d8a1149668870b1e7698486f7",22855176,1,-8,0,172,57,50,-7
"f924752d8a1149668870b1e7698486f7","6e13d61a7bdb44bca949c9f86fab3be5",22855176,1,-4,0,173,50,47,-3
"6e13d61a7bdb44bca949c9f86fab3be5","d9c8d8c444a64dadbbb508652c721e17",22855176,2,-1,0,174,47,46,-1
"d9c8d8c444a64dadbbb508652c721e17","a1f2f12debe5432fb7a70bcd12bacfb9",22855176,1,14,0,175,46,58,12
"a1f2f12debe5432fb7a70bcd12bacfb9","78f30e4dcac84e3cbea8b2cc6e0d62b3",22855176,2,1,0,176,58,59,1
"78f30e4dcac84e3cbea8b2cc6e0d62b3","78f30e4dcac84e3cbea8b2cc6e0d62b3",22855176,12,0,1,191,59,59,0
"78f30e4dcac84e3cbea8b2cc6e0d62b3","12aa6e1672ac4e7aa6449a7a8609cd72",22855176,1,-2,0,203,59,57,-2
"12aa6e1672ac4e7aa6449a7a8609cd72","bc42d26810654ea9a1df1efe1e58c7d5",22855176,1,7,0,204,57,63,6
"bc42d26810654ea9a1df1efe1e58c7d5","a0a418b8540d479fa6e0f653b701da8b",22855176,2,1,0,205,63,64,1
"a0a418b8540d479fa6e0f653b701da8b","4c943503763e4e349906eea3ed3c8e86",22855176,1,-3,0,206,64,61,-3
"4c943503763e4e349906eea3ed3c8e86","4c943503763e4e349906eea3ed3c8e86",22855176,4,0,1,207,61,61,0
"4c943503763e4e349906eea3ed3c8e86","bc42d26810654ea9a1df1efe1e58c7d5",22855176,1,2,0,211,61,63,2
"bc42d26810654ea9a1df1efe1e58c7d5","bc42d26810654ea9a1df1efe1e58c7d5",22855176,6,0,1,212,63,63,0
"a0a418b8540d479fa6e0f653b701da8b","a0a418b8540d479fa6e0f653b701da8b",22855176,6,0,1,216,64,64,0
"a0a418b8540d479fa6e0f653b701da8b","309ccf3cc4fe429d9bfbaef53d3fa479",22855176,1,-4,0,219,64,60,-4
"309ccf3cc4fe429d9bfbaef53d3fa479","b534b89233134e30a9b5645138bfa9ee",22855176,2,-23,0,220,60,41,-19
"b534b89233134e30a9b5645138bfa9ee","d646286c8051419bbc2e31dd1db55ca8",22855176,1,33,0,221,41,67,26
"d646286c8051419bbc2e31dd1db55ca8","267f883678b24aed855fde42524975d9",22855176,1,4,0,222,67,71,4
"267f883678b24aed855fde42524975d9","267f883678b24aed855fde42524975d9",22855176,4,0,1,223,71,71,0
"267f883678b24aed855fde42524975d9","88fff56d0342490dbef9040750a20f6c",22855176,1,1,0,227,71,72,1
"88fff56d0342490dbef9040750a20f6c","88fff56d0342490dbef9040750a20f6c",22855176,5,0,1,228,72,72,0
"88fff56d0342490dbef9040750a20f6c","adb17b12b66c4a49a85fd34322f7df70",22855176,2,1,0,229,72,73,1
"adb17b12b66c4a49a85fd34322f7df70","adb17b12b66c4a49a85fd34322f7df70",22855176,3,0,1,230,73,73,0
"adb17b12b66c4a49a85fd34322f7df70","88fff56d0342490dbef9040750a20f6c",22855176,1,-1,0,231,73,72,-1
"adb17b12b66c4a49a85fd34322f7df70","a2becd407db34b189200a32546d9d569",22855176,1,3,0,239,73,75,2
"a2becd407db34b189200a32546d9d569","d646286c8051419bbc2e31dd1db55ca8",22855176,1,-9,0,240,75,67,-8
"a2becd407db34b189200a32546d9d569","a2becd407db34b189200a32546d9d569",22855176,1,0,1,242,75,75,0
"a2becd407db34b189200a32546d9d569","58c22b011d0f4c2ea6d13615edbb9eeb",22855176,1,2,0,243,75,77,2
"58c22b011d0f4c2ea6d13615edbb9eeb","58c22b011d0f4c2ea6d13615edbb9eeb",22855176,3,0,1,244,77,77,0
"58c22b011d0f4c2ea6d13615edbb9eeb","dd76e1861dc9461c830888729d091ee0",22855176,1,1,0,247,77,78,1
"dd76e1861dc9461c830888729d091ee0","dd76e1861dc9461c830888729d091ee0",22855176,7,0,1,248,78,78,0
"dd76e1861dc9461c830888729d091ee0","cd1d828f1a694b87913a7ea66c23803e",22855176,1,1,0,255,78,79,1
"cd1d828f1a694b87913a7ea66c23803e","cd1d828f1a694b87913a7ea66c23803e",22855176,3,0,1,256,79,79,0
"cd1d828f1a694b87913a7ea66c23803e","9176a3c2b4d2465fa8b0c67096c2a97e",22855176,1,1,0,259,79,80,1
"9176a3c2b4d2465fa8b0c67096c2a97e","9176a3c2b4d2465fa8b0c67096c2a97e",22855176,6,0,1,260,80,80,0
"9176a3c2b4d2465fa8b0c67096c2a97e","f8ec6445f7194e25b9101d4fbcb07a18",22855176,1,1,0,266,80,81,1
"f8ec6445f7194e25b9101d4fbcb07a18","f8ec6445f7194e25b9101d4fbcb07a18",22855176,3,0,1,267,81,81,0
"f8ec6445f7194e25b9101d4fbcb07a18","140d5b27b8574befad82c0a013b59dfa",22855176,1,-7,0,270,81,74,-7
"d18a9ea32855445f8736581f5cb119ce","f564483cbd7a407681aa2fcca518cf5f",22855176,1,4,0,272,82,85,3
"f564483cbd7a407681aa2fcca518cf5f","f564483cbd7a407681aa2fcca518cf5f",22855176,2,0,1,273,85,85,0
"f564483cbd7a407681aa2fcca518cf5f","18fd01350bd5434ca636d59a599d768a",22855176,1,1,0,275,85,86,1
"18fd01350bd5434ca636d59a599d768a","18fd01350bd5434ca636d59a599d768a",22855176,12,0,1,276,86,86,0
"18fd01350bd5434ca636d59a599d768a","6a9f0ef185fb47f0937e29daa1c71ed5",22855176,1,5,0,288,86,90,4
"ae5ac430ea254e708a6f5deaaf7464ae","c681290961c94c4caf23b529d1ae6b9a",22855176,1,5,0,290,84,88,4
"c681290961c94c4caf23b529d1ae6b9a","c681290961c94c4caf23b529d1ae6b9a",22855176,2,0,1,291,88,88,0
"c681290961c94c4caf23b529d1ae6b9a","6a9f0ef185fb47f0937e29daa1c71ed5",22855176,1,2,0,293,88,90,2
"6a9f0ef185fb47f0937e29daa1c71ed5","d646286c8051419bbc2e31dd1db55ca8",22855176,1,-27,0,297,90,67,-23
"d646286c8051419bbc2e31dd1db55ca8","e20db35ced8544ddac5bc3839145e463",22855176,2,30,0,298,67,91,24
"e20db35ced8544ddac5bc3839145e463","1febb706d7a34005ae8711ed49c76e64",22855176,1,3,0,301,91,94,3
"1febb706d7a34005ae8711ed49c76e64","1febb706d7a34005ae8711ed49c76e64",22855176,3,0,1,302,94,94,0
"1febb706d7a34005ae8711ed49c76e64","8f73ba6f5a0042f2850356ac38ac6f24",22855176,1,1,0,305,94,95,1
"8f73ba6f5a0042f2850356ac38ac6f24","8f73ba6f5a0042f2850356ac38ac6f24",22855176,7,0,1,306,95,95,0
"8f73ba6f5a0042f2850356ac38ac6f24","e2260b86653c46d7b14a41fb419dbf8c",22855176,1,1,0,313,95,96,1
"e2260b86653c46d7b14a41fb419dbf8c","e2260b86653c46d7b14a41fb419dbf8c",22855176,3,0,1,314,96,96,0
"e2260b86653c46d7b14a41fb419dbf8c","35eb641ad1d845bbba54915bce75a962",22855176,1,1,0,317,96,97,1
"35eb641ad1d845bbba54915bce75a962","35eb641ad1d845bbba54915bce75a962",22855176,8,0,1,318,97,97,0
"35eb641ad1d845bbba54915bce75a962","08be90ffbeea4795a138cd42ed8db56f",22855176,1,1,0,326,97,98,1
"08be90ffbeea4795a138cd42ed8db56f","08be90ffbeea4795a138cd42ed8db56f",22855176,7,0,1,327,98,98,0
"08be90ffbeea4795a138cd42ed8db56f","3007433c8f584dcbb5ac159c1c5f2be3",22855176,1,1,0,334,98,99,1
"3007433c8f584dcbb5ac159c1c5f2be3","3007433c8f584dcbb5ac159c1c5f2be3",22855176,7,0,1,335,99,99,0
"3007433c8f584dcbb5ac159c1c5f2be3","e20db35ced8544ddac5bc3839145e463",22855176,1,-8,0,342,99,91,-8
"e20db35ced8544ddac5bc3839145e463","d391c8b6e56a43a7b654e9dee02d904b",22855176,1,13,0,343,91,103,12
"d391c8b6e56a43a7b654e9dee02d904b","00ae5f0c51874a73a41ebea838d95682",22855176,1,-2,0,344,103,101,-2
"d391c8b6e56a43a7b654e9dee02d904b","d391c8b6e56a43a7b654e9dee02d904b",22855176,16,0,1,347,103,103,0
"d391c8b6e56a43a7b654e9dee02d904b","6111116566fc4fd9abba409322bea245",22855176,1,1,0,363,103,104,1
"6111116566fc4fd9abba409322bea245","6111116566fc4fd9abba409322bea245",22855176,11,0,1,364,104,104,0
"6111116566fc4fd9abba409322bea245","a81b2235cb9c499eb9ea8ee0a8dd9725",22855176,1,1,0,375,104,105,1
"a81b2235cb9c499eb9ea8ee0a8dd9725","a81b2235cb9c499eb9ea8ee0a8dd9725",22855176,3,0,1,376,105,105,0
"a81b2235cb9c499eb9ea8ee0a8dd9725","2d4e0ab0ef3b4d73b82c72d4621a7579",22855176,1,1,0,379,105,106,1
"2d4e0ab0ef3b4d73b82c72d4621a7579","2d4e0ab0ef3b4d73b82c72d4621a7579",22855176,3,0,1,380,106,106,0
"2d4e0ab0ef3b4d73b82c72d4621a7579","8bdebf492ebd4e62b0d522e8ab5e5197",22855176,1,1,0,383,106,107,1
"8bdebf492ebd4e62b0d522e8ab5e5197","8bdebf492ebd4e62b0d522e8ab5e5197",22855176,7,0,1,384,107,107,0
"8bdebf492ebd4e62b0d522e8ab5e5197","73039f8c1eb9409cb4caee2cf968001e",22855176,1,-7,0,391,107,100,-7
"4280927ec4d643238aa49c32f9e06c6c","4280927ec4d643238aa49c32f9e06c6c",22855176,1,0,1,393,109,109,0
"4280927ec4d643238aa49c32f9e06c6c","fc44e6a5f7654430af1227838224dceb",22855176,1,2,0,394,109,111,2
"fc44e6a5f7654430af1227838224dceb","fc44e6a5f7654430af1227838224dceb",22855176,3,0,1,395,111,111,0
"fc44e6a5f7654430af1227838224dceb","08111f75e22d409998cf8b85bd431f0a",22855176,1,-3,0,398,111,108,-3
"08111f75e22d409998cf8b85bd431f0a","71cec822bcff4f30a20e75dc63ef7b65",22855176,1,9,0,399,108,116,8
"71cec822bcff4f30a20e75dc63ef7b65","71cec822bcff4f30a20e75dc63ef7b65",22855176,2,0,1,400,116,116,0
"62bff51286ef4f348717a3cf6fe2318f","3ec3a3563847406fa73338f9e9999cf3",22855176,1,-3,0,404,120,117,-3
"3ec3a3563847406fa73338f9e9999cf3","4280927ec4d643238aa49c32f9e06c6c",22855176,1,-10,0,405,117,109,-8
"4280927ec4d643238aa49c32f9e06c6c","37319e88176d4aefa91d7a9980dbae91",22855176,1,4,0,406,109,112,3
"37319e88176d4aefa91d7a9980dbae91","73039f8c1eb9409cb4caee2cf968001e",22855176,1,-14,0,407,112,100,-12
"00ae5f0c51874a73a41ebea838d95682","08111f75e22d409998cf8b85bd431f0a",22855176,1,8,0,409,101,108,7
"08111f75e22d409998cf8b85bd431f0a","e20db35ced8544ddac5bc3839145e463",22855176,1,-19,0,410,108,91,-17
"e20db35ced8544ddac5bc3839145e463","d646286c8051419bbc2e31dd1db55ca8",22855176,2,-30,0,412,91,67,-24
"d646286c8051419bbc2e31dd1db55ca8","d391c8b6e56a43a7b654e9dee02d904b",22855176,1,43,0,414,67,103,36
"d391c8b6e56a43a7b654e9dee02d904b","d646286c8051419bbc2e31dd1db55ca8",22855176,1,-43,0,415,103,67,-36
"d646286c8051419bbc2e31dd1db55ca8","67a089198fcb4e1c8f2385786c2b296f",22855176,1,-37,0,419,67,39,-28
"67a089198fcb4e1c8f2385786c2b296f","c33c17be71ae4d588da7369472e5bb1b",22855176,1,-16,0,420,39,34,-5
"c33c17be71ae4d588da7369472e5bb1b","c33c17be71ae4d588da7369472e5bb1b",22855176,4,0,1,421,34,34,0
"c33c17be71ae4d588da7369472e5bb1b","7040a13096d746ac84b8fac8d9752058",22855176,1,6,0,422,34,36,2
"7040a13096d746ac84b8fac8d9752058","7040a13096d746ac84b8fac8d9752058",22855176,1,0,1,423,36,36,0
"7040a13096d746ac84b8fac8d9752058","93679be414554a11b1893002f2229a93",22855176,4,-3,0,424,36,35,-1
"93679be414554a11b1893002f2229a93","7040a13096d746ac84b8fac8d9752058",22855176,6,3,0,425,35,36,1
"7040a13096d746ac84b8fac8d9752058","3ec3a3563847406fa73338f9e9999cf3",22855176,1,107,0,426,36,117,81
"3ec3a3563847406fa73338f9e9999cf3","e20db35ced8544ddac5bc3839145e463",22855176,3,-30,0,427,117,91,-26
"e20db35ced8544ddac5bc3839145e463","62bff51286ef4f348717a3cf6fe2318f",22855176,4,33,0,428,91,120,29
"62bff51286ef4f348717a3cf6fe2318f","e20db35ced8544ddac5bc3839145e463",22855176,2,-33,0,429,120,91,-29
"d391c8b6e56a43a7b654e9dee02d904b","e20db35ced8544ddac5bc3839145e463",22855176,1,-13,0,440,103,91,-12
"37319e88176d4aefa91d7a9980dbae91","3ec3a3563847406fa73338f9e9999cf3",22855176,1,6,0,442,112,117,5
"62bff51286ef4f348717a3cf6fe2318f","b1cd0e7dc3ad4a8eb91a4bfdbeb025b0",22855176,1,-2,0,445,120,118,-2
"b1cd0e7dc3ad4a8eb91a4bfdbeb025b0","b1cd0e7dc3ad4a8eb91a4bfdbeb025b0",22855176,2,0,1,446,118,118,0
"b1cd0e7dc3ad4a8eb91a4bfdbeb025b0","62bff51286ef4f348717a3cf6fe2318f",22855176,1,2,0,448,118,120,2
"62bff51286ef4f348717a3cf6fe2318f","779f9ddd1fd14d1e9e69f72219a1fdbd",22855176,1,3,0,452,120,121,1
"779f9ddd1fd14d1e9e69f72219a1fdbd","e20db35ced8544ddac5bc3839145e463",22855176,1,-36,0,453,121,91,-30
"e20db35ced8544ddac5bc3839145e463","ae26e6cda8ad4a3f81bd347560d9579f",22855176,1,40,0,454,91,125,34
"ae26e6cda8ad4a3f81bd347560d9579f","ae26e6cda8ad4a3f81bd347560d9579f",22855176,2,0,1,455,125,125,0
"ae26e6cda8ad4a3f81bd347560d9579f","ee48df95832b4374aa273ceb27ec1315",22855176,1,1,0,457,125,126,1
"ee48df95832b4374aa273ceb27ec1315","ee48df95832b4374aa273ceb27ec1315",22855176,2,0,1,458,126,126,0
"ee48df95832b4374aa273ceb27ec1315","7a439da90b394756ad1777fc4c6dead5",22855176,1,1,0,460,126,127,1
"7a439da90b394756ad1777fc4c6dead5","7a439da90b394756ad1777fc4c6dead5",22855176,2,0,1,461,127,127,0
"7a439da90b394756ad1777fc4c6dead5","a8dd5213034441ac92724b4e83eb0bb2",22855176,1,3,0,463,127,129,2
"a8dd5213034441ac92724b4e83eb0bb2","779f9ddd1fd14d1e9e69f72219a1fdbd",22855176,1,-9,0,464,129,121,-8
"779f9ddd1fd14d1e9e69f72219a1fdbd","a8dd5213034441ac92724b4e83eb0bb2",22855176,1,9,0,465,121,129,8
"a8dd5213034441ac92724b4e83eb0bb2","8115eab6556b45f5b415c3b8c26a12e5",22855176,1,2,0,466,129,131,2
"8115eab6556b45f5b415c3b8c26a12e5","8115eab6556b45f5b415c3b8c26a12e5",22855176,3,0,1,467,131,131,0
"8115eab6556b45f5b415c3b8c26a12e5","ec34b06efd844b46a4c4818ecdb9b8f4",22855176,1,1,0,470,131,132,1
"ec34b06efd844b46a4c4818ecdb9b8f4","ec34b06efd844b46a4c4818ecdb9b8f4",22855176,3,0,1,471,132,132,0
"ec34b06efd844b46a4c4818ecdb9b8f4","c2e1c2b9eac64109b343a088584b576b",22855176,1,1,0,474,132,133,1
"c2e1c2b9eac64109b343a088584b576b","c2e1c2b9eac64109b343a088584b576b",22855176,3,0,1,475,133,133,0
"c2e1c2b9eac64109b343a088584b576b","579338175e0b4bbb8ef3b712b5d8b54e",22855176,1,-5,0,478,133,128,-5
"579338175e0b4bbb8ef3b712b5d8b54e","8bc5795d6a984a3eace4e2811e52dd4f",22855176,1,8,0,479,128,135,7
"8bc5795d6a984a3eace4e2811e52dd4f","8bc5795d6a984a3eace4e2811e52dd4f",22855176,2,0,1,480,135,135,0
"8bc5795d6a984a3eace4e2811e52dd4f","b416d47c56a742199b5d7c7f19d6503a",22855176,1,-1,0,482,135,134,-1
"b416d47c56a742199b5d7c7f19d6503a","cd4532ad48034873ba8bce2aac0c9808",22855176,1,4,0,483,134,137,3
"cd4532ad48034873ba8bce2aac0c9808","cd4532ad48034873ba8bce2aac0c9808",22855176,1,0,1,484,137,137,0
"cd4532ad48034873ba8bce2aac0c9808","df1de691dafe4549a18a4398ee9dfaf9",22855176,1,4,0,485,137,139,2
"df1de691dafe4549a18a4398ee9dfaf9","779f9ddd1fd14d1e9e69f72219a1fdbd",22855176,1,-23,0,486,139,121,-18
"6c5ad271a44743479bfaea29b1db8d02","6c5ad271a44743479bfaea29b1db8d02",22855176,1,0,1,490,143,143,0
"8aae34f5ddbb4052a709b12e6b0d40fa","f902b0f41b544d4dbf79664fd233648d",22855176,2,-1,0,493,147,146,-1
"f902b0f41b544d4dbf79664fd233648d","83d311bed5374fee83d8d67a7d9d82dc",22855176,1,-3,0,494,146,144,-2
"83d311bed5374fee83d8d67a7d9d82dc","83d311bed5374fee83d8d67a7d9d82dc",22855176,2,0,1,495,144,144,0
"83d311bed5374fee83d8d67a7d9d82dc","402bba41861d43acb52a5abb89e8831e",22855176,1,1,0,497,144,145,1
"402bba41861d43acb52a5abb89e8831e","402bba41861d43acb52a5abb89e8831e",22855176,3,0,1,498,145,145,0
"402bba41861d43acb52a5abb89e8831e","df1de691dafe4549a18a4398ee9dfaf9",22855176,1,-6,0,501,145,139,-6
"8aae34f5ddbb4052a709b12e6b0d40fa","645b3f0249f64f76af2e19eb4d0e55b7",22855176,1,2,0,503,147,149,2
"645b3f0249f64f76af2e19eb4d0e55b7","645b3f0249f64f76af2e19eb4d0e55b7",22855176,3,0,1,504,149,149,0
"645b3f0249f64f76af2e19eb4d0e55b7","7e7b8db5064d4369805ab370aac5ddfb",22855176,1,1,0,507,149,150,1
"7e7b8db5064d4369805ab370aac5ddfb","7e7b8db5064d4369805ab370aac5ddfb",22855176,3,0,1,508,150,150,0
"7e7b8db5064d4369805ab370aac5ddfb","8956d210ae7f41968fada86d4c979d6a",22855176,1,1,0,511,150,151,1
"8956d210ae7f41968fada86d4c979d6a","8956d210ae7f41968fada86d4c979d6a",22855176,3,0,1,512,151,151,0
"8956d210ae7f41968fada86d4c979d6a","8aae34f5ddbb4052a709b12e6b0d40fa",22855176,1,-4,0,515,151,147,-4
"f902b0f41b544d4dbf79664fd233648d","ae781e8b775e4ccd93bc800dad5c8376",22855176,1,8,0,517,146,153,7
"ae781e8b775e4ccd93bc800dad5c8376","ae781e8b775e4ccd93bc800dad5c8376",22855176,3,0,1,518,153,153,0
"ae781e8b775e4ccd93bc800dad5c8376","06882a8492d9499aa31555567f575ecb",22855176,1,1,0,521,153,154,1
"06882a8492d9499aa31555567f575ecb","06882a8492d9499aa31555567f575ecb",22855176,2,0,1,522,154,154,0
"06882a8492d9499aa31555567f575ecb","f293c508f409466a8f27ddd7d1e40b20",22855176,1,1,0,524,154,155,1
"f293c508f409466a8f27ddd7d1e40b20","f293c508f409466a8f27ddd7d1e40b20",22855176,3,0,1,525,155,155,0
"f293c508f409466a8f27ddd7d1e40b20","cc4ddef5bbbe48ebb605141b347c4ed1",22855176,1,1,0,528,155,156,1
"cc4ddef5bbbe48ebb605141b347c4ed1","cc4ddef5bbbe48ebb605141b347c4ed1",22855176,2,0,1,529,156,156,0
"cc4ddef5bbbe48ebb605141b347c4ed1","f03480cf4eba413194d7af52fc0e7f28",22855176,1,-4,0,531,156,152,-4
"f03480cf4eba413194d7af52fc0e7f28","d313cec988a84645bee413e8d4724a4b",22855176,1,7,0,532,152,158,6
"d313cec988a84645bee413e8d4724a4b","dc60696c76a74368a60f72246e47700d",22855176,1,1,0,533,158,159,1
"dc60696c76a74368a60f72246e47700d","dc60696c76a74368a60f72246e47700d",22855176,2,0,1,534,159,159,0
"dc60696c76a74368a60f72246e47700d","df1de691dafe4549a18a4398ee9dfaf9",22855176,1,-23,0,536,159,139,-20
"df1de691dafe4549a18a4398ee9dfaf9","78adeee1fa2c4fe0bc73f7bca9fcee86",22855176,1,26,0,537,139,160,21
"65202579580f4ad38d734b4ee39d22a8","78adeee1fa2c4fe0bc73f7bca9fcee86",22855176,5,-5,0,543,164,160,-4
"78adeee1fa2c4fe0bc73f7bca9fcee86","3cbcea2be0984e7dbd5a48195af10ce7",22855176,1,8,0,548,160,165,5
"3cbcea2be0984e7dbd5a48195af10ce7","a9ac840f098c4bd0a2ee896214ce29cd",22855176,2,5,0,551,165,168,3
"a9ac840f098c4bd0a2ee896214ce29cd","e20db35ced8544ddac5bc3839145e463",22855176,1,-98,0,552,168,91,-77
"62bff51286ef4f348717a3cf6fe2318f","0d987bed3ffa4ed0b9a2e62e97b7b30f",22855176,1,204,0,556,120,272,152
"0d987bed3ffa4ed0b9a2e62e97b7b30f","0c7262dff33c4087bc660ccf40f92f9c",22855176,2,-135,0,557,272,169,-103
"0c7262dff33c4087bc660ccf40f92f9c","b2275c3fad834f8d90737a2d9a6927d6",22855176,6,3,0,558,169,172,3
"b2275c3fad834f8d90737a2d9a6927d6","0c7262dff33c4087bc660ccf40f92f9c",22855176,4,-3,0,559,172,169,-3
"b2275c3fad834f8d90737a2d9a6927d6","b2275c3fad834f8d90737a2d9a6927d6",22855176,21,0,1,565,172,172,0
"b2275c3fad834f8d90737a2d9a6927d6","eb515a26030b41f8a82a1e6114420bad",22855176,1,1,0,586,172,173,1
"eb515a26030b41f8a82a1e6114420bad","eb515a26030b41f8a82a1e6114420bad",22855176,3,0,1,587,173,173,0
"eb515a26030b41f8a82a1e6114420bad","b42cc17b7de840f181a704558d0bc845",22855176,1,3,0,590,173,175,2
"b42cc17b7de840f181a704558d0bc845","0c7262dff33c4087bc660ccf40f92f9c",22855176,3,-7,0,591,175,169,-6
"0c7262dff33c4087bc660ccf40f92f9c","eb2a0eb537344a9e891c761662e400b6",22855176,1,-218,0,592,169,16,-153
"5c5ceeee4562457ba6d41515aeebfbb1","b613861cecf84ffcab01afb23f660475",22855176,1,-25,0,595,17,1,-16
"b613861cecf84ffcab01afb23f660475","c33c17be71ae4d588da7369472e5bb1b",22855176,1,56,0,602,1,34,33
"c33c17be71ae4d588da7369472e5bb1b","93679be414554a11b1893002f2229a93",22855176,3,3,0,605,34,35,1
"7040a13096d746ac84b8fac8d9752058","9a0dc646f934470daf08c4b56ccf73db",22855176,2,3,0,609,36,37,1
"9a0dc646f934470daf08c4b56ccf73db","fc0e049d56024bc9a02c9a9c435c3df7",22855176,3,3,0,610,37,38,1
"fc0e049d56024bc9a02c9a9c435c3df7","9a0dc646f934470daf08c4b56ccf73db",22855176,1,-3,0,611,38,37,-1
"67a089198fcb4e1c8f2385786c2b296f","b534b89233134e30a9b5645138bfa9ee",22855176,4,4,0,616,39,41,2
"b534b89233134e30a9b5645138bfa9ee","b534b89233134e30a9b5645138bfa9ee",22855176,3,0,1,617,41,41,0
"6e13d61a7bdb44bca949c9f86fab3be5","67a089198fcb4e1c8f2385786c2b296f",22855176,1,-11,0,619,47,39,-8
"67a089198fcb4e1c8f2385786c2b296f","67a089198fcb4e1c8f2385786c2b296f",22855176,2,0,1,620,39,39,0
"67a089198fcb4e1c8f2385786c2b296f","56586aa865414f538729c7f7735d2bc6",22855176,1,-57,0,621,39,12,-27
"56586aa865414f538729c7f7735d2bc6","0c7262dff33c4087bc660ccf40f92f9c",22855176,1,226,0,633,12,169,157
"b2275c3fad834f8d90737a2d9a6927d6","b42cc17b7de840f181a704558d0bc845",22855176,2,4,0,636,172,175,3
"0c7262dff33c4087bc660ccf40f92f9c","78adeee1fa2c4fe0bc73f7bca9fcee86",22855176,1,-17,0,638,169,160,-9
"78adeee1fa2c4fe0bc73f7bca9fcee86","78adeee1fa2c4fe0bc73f7bca9fcee86",22855176,3,0,1,639,160,160,0
"65202579580f4ad38d734b4ee39d22a8","8959e6304a0348309a771e4d08d1b64a",22855176,1,-1,0,649,164,163,-1
"8959e6304a0348309a771e4d08d1b64a","67a089198fcb4e1c8f2385786c2b296f",22855176,1,-156,0,650,163,39,-124
"67a089198fcb4e1c8f2385786c2b296f","d9c8d8c444a64dadbbb508652c721e17",22855176,1,10,0,651,39,46,7
"d9c8d8c444a64dadbbb508652c721e17","b534b89233134e30a9b5645138bfa9ee",22855176,1,-6,0,652,46,41,-5
"6e13d61a7bdb44bca949c9f86fab3be5","b534b89233134e30a9b5645138bfa9ee",22855176,1,-7,0,654,47,41,-6
"b534b89233134e30a9b5645138bfa9ee","78adeee1fa2c4fe0bc73f7bca9fcee86",22855176,1,148,0,655,41,160,119
"65202579580f4ad38d734b4ee39d22a8","3cbcea2be0984e7dbd5a48195af10ce7",22855176,1,3,0,713,164,165,1
"3cbcea2be0984e7dbd5a48195af10ce7","78adeee1fa2c4fe0bc73f7bca9fcee86",22855176,1,-8,0,714,165,160,-5
"78adeee1fa2c4fe0bc73f7bca9fcee86","82e6285962b8400d9d6fc32436022a94",22855176,1,10,0,715,160,167,7
"a9ac840f098c4bd0a2ee896214ce29cd","0c7262dff33c4087bc660ccf40f92f9c",22855176,1,4,0,718,168,169,1
"0c7262dff33c4087bc660ccf40f92f9c","a9ac840f098c4bd0a2ee896214ce29cd",22855176,1,-4,0,719,169,168,-1
"a9ac840f098c4bd0a2ee896214ce29cd","b2275c3fad834f8d90737a2d9a6927d6",22855176,1,7,0,720,168,172,4
"0c7262dff33c4087bc660ccf40f92f9c","b42cc17b7de840f181a704558d0bc845",22855176,1,7,0,727,169,175,6
"b42cc17b7de840f181a704558d0bc845","b42cc17b7de840f181a704558d0bc845",22855176,2,0,1,728,175,175,0
"b42cc17b7de840f181a704558d0bc845","801f9e9135034f49bf5f8b4bdefedb41",22855176,1,2,0,729,175,177,2
"801f9e9135034f49bf5f8b4bdefedb41","801f9e9135034f49bf5f8b4bdefedb41",22855176,5,0,1,730,177,177,0
"801f9e9135034f49bf5f8b4bdefedb41","b42cc17b7de840f181a704558d0bc845",22855176,1,-2,0,735,177,175,-2
"b42cc17b7de840f181a704558d0bc845","ea38cc0e6e6e41edbabf210220808bf9",22855176,1,5,0,737,175,179,4
"ea38cc0e6e6e41edbabf210220808bf9","362fcb0699a14845ab29b2340093e528",22855176,1,-6,0,738,179,174,-5
"362fcb0699a14845ab29b2340093e528","b87c552dd247427abe6ab5795b9c9d43",22855176,1,8,0,739,174,181,7
"b87c552dd247427abe6ab5795b9c9d43","b87c552dd247427abe6ab5795b9c9d43",22855176,8,0,1,740,181,181,0
"b87c552dd247427abe6ab5795b9c9d43","ea38cc0e6e6e41edbabf210220808bf9",22855176,2,-2,0,748,181,179,-2
"ea38cc0e6e6e41edbabf210220808bf9","139b097acfca451689d80c9c6eebdf7b",22855176,2,-1,0,749,179,178,-1
"139b097acfca451689d80c9c6eebdf7b","2024b4885bd14338a39b7b509acbbd02",22855176,1,5,0,750,178,182,4
"2024b4885bd14338a39b7b509acbbd02","ea38cc0e6e6e41edbabf210220808bf9",22855176,1,-4,0,751,182,179,-3
"ea38cc0e6e6e41edbabf210220808bf9","b87c552dd247427abe6ab5795b9c9d43",22855176,1,2,0,752,179,181,2
"ea38cc0e6e6e41edbabf210220808bf9","ea38cc0e6e6e41edbabf210220808bf9",22855176,1,0,1,754,179,179,0
"139b097acfca451689d80c9c6eebdf7b","30f660a1feb34582a739722532524f79",22855176,1,6,0,756,178,183,5
"30f660a1feb34582a739722532524f79","30f660a1feb34582a739722532524f79",22855176,8,0,1,757,183,183,0
"30f660a1feb34582a739722532524f79","2024b4885bd14338a39b7b509acbbd02",22855176,1,-1,0,765,183,182,-1
"2024b4885bd14338a39b7b509acbbd02","cf4c280bad6a43e6b131d8385ef9ef3f",22855176,3,3,0,766,182,184,2
"cf4c280bad6a43e6b131d8385ef9ef3f","2024b4885bd14338a39b7b509acbbd02",22855176,3,-3,0,767,184,182,-2
"2024b4885bd14338a39b7b509acbbd02","c3f63fe50d8e487c86bf8ef76c9cadd3",22855176,1,4,0,772,182,185,3
"c3f63fe50d8e487c86bf8ef76c9cadd3","c3f63fe50d8e487c86bf8ef76c9cadd3",22855176,2,0,1,773,185,185,0
"c3f63fe50d8e487c86bf8ef76c9cadd3","0c7262dff33c4087bc660ccf40f92f9c",22855176,1,-20,0,775,185,169,-16
"c8e371568a0c4391b25796ae4e91952e","7d932b23e1c84326ae5aa4d3c0d813d1",22855176,1,2,0,777,186,188,2
"7d932b23e1c84326ae5aa4d3c0d813d1","7d932b23e1c84326ae5aa4d3c0d813d1",22855176,2,0,1,778,188,188,0
"7d932b23e1c84326ae5aa4d3c0d813d1","c8e371568a0c4391b25796ae4e91952e",22855176,1,-2,0,780,188,186,-2
"c8e371568a0c4391b25796ae4e91952e","ab11d94c6c8948ea90b88f19d2cd502b",22855176,2,5,0,781,186,190,4
"ab11d94c6c8948ea90b88f19d2cd502b","8959e6304a0348309a771e4d08d1b64a",22855176,1,-41,0,782,190,163,-27
"65202579580f4ad38d734b4ee39d22a8","0d987bed3ffa4ed0b9a2e62e97b7b30f",22855176,1,147,0,792,164,272,108
"0c7262dff33c4087bc660ccf40f92f9c","07b44a7a51e94c78b411c753fc39dab0",22855176,1,27,0,795,169,189,20
"07b44a7a51e94c78b411c753fc39dab0","c8e371568a0c4391b25796ae4e91952e",22855176,1,-4,0,796,189,186,-3
"ab11d94c6c8948ea90b88f19d2cd502b","f992451ed6ad4e68bb9e68ad6be7c4be",22855176,1,2,0,798,190,192,2
"f992451ed6ad4e68bb9e68ad6be7c4be","f992451ed6ad4e68bb9e68ad6be7c4be",22855176,2,0,1,799,192,192,0
"f992451ed6ad4e68bb9e68ad6be7c4be","ab11d94c6c8948ea90b88f19d2cd502b",22855176,1,-2,0,801,192,190,-2
"ab11d94c6c8948ea90b88f19d2cd502b","07b44a7a51e94c78b411c753fc39dab0",22855176,1,-1,0,802,190,189,-1
"07b44a7a51e94c78b411c753fc39dab0","6cd2dcaac46847d4a0bc53f296d90375",22855176,1,6,0,803,189,194,5
"6cd2dcaac46847d4a0bc53f296d90375","2d2580c9411c4972909db508d6956a58",22855176,1,2,0,804,194,196,2
"2d2580c9411c4972909db508d6956a58","2d2580c9411c4972909db508d6956a58",22855176,3,0,1,805,196,196,0
"2d2580c9411c4972909db508d6956a58","5bddb3d9ed264f3984702f048c7e5340",22855176,1,1,0,808,196,197,1
"5bddb3d9ed264f3984702f048c7e5340","5bddb3d9ed264f3984702f048c7e5340",22855176,3,0,1,809,197,197,0
"5bddb3d9ed264f3984702f048c7e5340","d5e8e2bd12a2466b9d6d90855f0eb079",22855176,1,1,0,812,197,198,1
"d5e8e2bd12a2466b9d6d90855f0eb079","d5e8e2bd12a2466b9d6d90855f0eb079",22855176,3,0,1,813,198,198,0
"d5e8e2bd12a2466b9d6d90855f0eb079","6cd2dcaac46847d4a0bc53f296d90375",22855176,1,-4,0,816,198,194,-4
"6cd2dcaac46847d4a0bc53f296d90375","017d7ca8e0394b91aaadc9574df2202c",22855176,1,-1,0,817,194,193,-1
"017d7ca8e0394b91aaadc9574df2202c","54e8e9f0ea3e45c4bf3b8ac799ee31b1",22855176,1,8,0,818,193,200,7
"54e8e9f0ea3e45c4bf3b8ac799ee31b1","54e8e9f0ea3e45c4bf3b8ac799ee31b1",22855176,2,0,1,819,200,200,0
"54e8e9f0ea3e45c4bf3b8ac799ee31b1","c614a00911be4877a075f19315530fb0",22855176,1,1,0,821,200,201,1
"c614a00911be4877a075f19315530fb0","c614a00911be4877a075f19315530fb0",22855176,6,0,1,822,201,201,0
"c614a00911be4877a075f19315530fb0","a6c21bd8b95249c7972820a7a7d76aff",22855176,1,1,0,828,201,202,1
"a6c21bd8b95249c7972820a7a7d76aff","a6c21bd8b95249c7972820a7a7d76aff",22855176,2,0,1,829,202,202,0
"a6c21bd8b95249c7972820a7a7d76aff","bb329d880ab54120adaf203a693bb203",22855176,1,1,0,831,202,203,1
"bb329d880ab54120adaf203a693bb203","bb329d880ab54120adaf203a693bb203",22855176,2,0,1,832,203,203,0
"bb329d880ab54120adaf203a693bb203","f9170dd6bc6442b4acd832747609b09a",22855176,1,-4,0,834,203,199,-4
"f9170dd6bc6442b4acd832747609b09a","334c2344009840079b1d0e1b7ce3d5a7",22855176,1,7,0,835,199,205,6
"334c2344009840079b1d0e1b7ce3d5a7","334c2344009840079b1d0e1b7ce3d5a7",22855176,2,0,1,836,205,205,0
"334c2344009840079b1d0e1b7ce3d5a7","d7f13c8d63ec4e2aa673fbb9cf9c6933",22855176,1,3,0,838,205,206,1
"d7f13c8d63ec4e2aa673fbb9cf9c6933","c8e371568a0c4391b25796ae4e91952e",22855176,1,-26,0,839,206,186,-20
"c8e371568a0c4391b25796ae4e91952e","b9e80f77c3a44349863b19875725c384",22855176,1,27,0,840,186,207,21
"b9e80f77c3a44349863b19875725c384","7108f0e4c2584f1f9c471689ae4c885c",22855176,2,1,0,841,207,208,1
"7108f0e4c2584f1f9c471689ae4c885c","b9e80f77c3a44349863b19875725c384",22855176,1,-1,0,842,208,207,-1
"b9e80f77c3a44349863b19875725c384","b9e80f77c3a44349863b19875725c384",22855176,15,0,1,843,207,207,0
"7108f0e4c2584f1f9c471689ae4c885c","7108f0e4c2584f1f9c471689ae4c885c",22855176,10,0,1,859,208,208,0
"7108f0e4c2584f1f9c471689ae4c885c","d7f13c8d63ec4e2aa673fbb9cf9c6933",22855176,1,-2,0,869,208,206,-2
"d7f13c8d63ec4e2aa673fbb9cf9c6933","09400e101c5d4b439cf9a26b03aae558",22855176,3,5,0,870,206,210,4
"09400e101c5d4b439cf9a26b03aae558","0c7262dff33c4087bc660ccf40f92f9c",22855176,1,-54,0,871,210,169,-41
"0c7262dff33c4087bc660ccf40f92f9c","a875096404ef4a9984b62d74cda916f9",22855176,2,53,0,872,169,209,40
"a875096404ef4a9984b62d74cda916f9","d7f13c8d63ec4e2aa673fbb9cf9c6933",22855176,2,-4,0,873,209,206,-3
"09400e101c5d4b439cf9a26b03aae558","a88efa7e50ce47159810ab553afa6d3a",22855176,1,2,0,875,210,212,2
"a88efa7e50ce47159810ab553afa6d3a","a88efa7e50ce47159810ab553afa6d3a",22855176,7,0,1,876,212,212,0
"a88efa7e50ce47159810ab553afa6d3a","a875096404ef4a9984b62d74cda916f9",22855176,1,-3,0,883,212,209,-3
"a875096404ef4a9984b62d74cda916f9","be502a7a43c44bf7b682698de79d9369",22855176,2,6,0,884,209,214,5
"be502a7a43c44bf7b682698de79d9369","f7fb1952f56b4189b86a9f8b7862d2b8",22855176,2,1,0,885,214,215,1
"f7fb1952f56b4189b86a9f8b7862d2b8","ec341f459285443b8361f7f15638ff08",22855176,1,-2,0,886,215,213,-2
"ec341f459285443b8361f7f15638ff08","09400e101c5d4b439cf9a26b03aae558",22855176,1,-4,0,887,213,210,-3
"09400e101c5d4b439cf9a26b03aae558","09400e101c5d4b439cf9a26b03aae558",22855176,1,0,1,888,210,210,0
"09400e101c5d4b439cf9a26b03aae558","a875096404ef4a9984b62d74cda916f9",22855176,2,-1,0,889,210,209,-1
"a875096404ef4a9984b62d74cda916f9","f7fb1952f56b4189b86a9f8b7862d2b8",22855176,1,7,0,890,209,215,6
"f7fb1952f56b4189b86a9f8b7862d2b8","be502a7a43c44bf7b682698de79d9369",22855176,1,-1,0,891,215,214,-1
"be502a7a43c44bf7b682698de79d9369","0c7262dff33c4087bc660ccf40f92f9c",22855176,1,-59,0,892,214,169,-45
"f7fb1952f56b4189b86a9f8b7862d2b8","f7fb1952f56b4189b86a9f8b7862d2b8",22855176,13,0,1,901,215,215,0
"f7fb1952f56b4189b86a9f8b7862d2b8","b860ee85d8bc4a2f97958cfb71be3533",22855176,1,1,0,914,215,216,1
"b860ee85d8bc4a2f97958cfb71be3533","b860ee85d8bc4a2f97958cfb71be3533",22855176,3,0,1,915,216,216,0
"b860ee85d8bc4a2f97958cfb71be3533","be502a7a43c44bf7b682698de79d9369",22855176,1,-2,0,918,216,214,-2
"be502a7a43c44bf7b682698de79d9369","be502a7a43c44bf7b682698de79d9369",22855176,1,0,1,919,214,214,0
"be502a7a43c44bf7b682698de79d9369","ec341f459285443b8361f7f15638ff08",22855176,1,-1,0,920,214,213,-1
"ec341f459285443b8361f7f15638ff08","363837c182e04711840d896ae1e0339c",22855176,1,6,0,921,213,218,5
"363837c182e04711840d896ae1e0339c","363837c182e04711840d896ae1e0339c",22855176,24,0,1,922,218,218,0
"363837c182e04711840d896ae1e0339c","01b2051f8941460d89945e3b02d1ce78",22855176,1,-1,0,946,218,217,-1
"01b2051f8941460d89945e3b02d1ce78","309ccf3cc4fe429d9bfbaef53d3fa479",22855176,1,-205,0,947,217,60,-157
"b534b89233134e30a9b5645138bfa9ee","a0a418b8540d479fa6e0f653b701da8b",22855176,1,27,0,949,41,64,23
"a0a418b8540d479fa6e0f653b701da8b","bc42d26810654ea9a1df1efe1e58c7d5",22855176,3,-1,0,952,64,63,-1
"bc42d26810654ea9a1df1efe1e58c7d5","67a089198fcb4e1c8f2385786c2b296f",22855176,1,-30,0,955,63,39,-24
"67a089198fcb4e1c8f2385786c2b296f","b7719e26494940efa49512aedd0aac79",22855176,1,-40,0,956,39,20,-19
"b613861cecf84ffcab01afb23f660475","9afd71a5298d4333b6849dfce1b9422c",22855176,1,28,0,961,1,18,17
"b7719e26494940efa49512aedd0aac79","9afd71a5298d4333b6849dfce1b9422c",22855176,1,-4,0,964,20,18,-2
"9afd71a5298d4333b6849dfce1b9422c","d4f45188d3c84a02ba08454e6403a818",22855176,1,9,0,965,18,24,6
"d4c3b003e8274e429d2fa688d73fde6d","4e51676dc72045d99c19b9fa7b22f8bc",22855176,1,12,0,967,22,29,7
"51970cfa30e643e894e66ae85c8024cc","4e51676dc72045d99c19b9fa7b22f8bc",22855176,1,-3,0,971,31,29,-2
"93679be414554a11b1893002f2229a93","b613861cecf84ffcab01afb23f660475",22855176,1,-59,0,977,35,1,-34
"b613861cecf84ffcab01afb23f660475","67a089198fcb4e1c8f2385786c2b296f",22855176,1,72,0,978,1,39,38
"d0c74f735e024943943e40333d6d337f","f924752d8a1149668870b1e7698486f7",22855176,1,-1,0,988,51,50,-1
"a1f2f12debe5432fb7a70bcd12bacfb9","a0a418b8540d479fa6e0f653b701da8b",22855176,1,7,0,991,58,64,6
"bc42d26810654ea9a1df1efe1e58c7d5","12aa6e1672ac4e7aa6449a7a8609cd72",22855176,1,-7,0,993,63,57,-6
"12aa6e1672ac4e7aa6449a7a8609cd72","a0a418b8540d479fa6e0f653b701da8b",22855176,1,8,0,994,57,64,7
"bc42d26810654ea9a1df1efe1e58c7d5","309ccf3cc4fe429d9bfbaef53d3fa479",22855176,1,-3,0,998,63,60,-3
"309ccf3cc4fe429d9bfbaef53d3fa479","67a089198fcb4e1c8f2385786c2b296f",22855176,1,-27,0,999,60,39,-21
"67a089198fcb4e1c8f2385786c2b296f","d646286c8051419bbc2e31dd1db55ca8",22855176,1,37,0,1000,39,67,28
"d646286c8051419bbc2e31dd1db55ca8","d646286c8051419bbc2e31dd1db55ca8",22855176,3,0,1,1001,67,67,0
"d646286c8051419bbc2e31dd1db55ca8","a2becd407db34b189200a32546d9d569",22855176,2,9,0,1003,67,75,8
"a2becd407db34b189200a32546d9d569","140d5b27b8574befad82c0a013b59dfa",22855176,1,-1,0,1004,75,74,-1
"140d5b27b8574befad82c0a013b59dfa","d18a9ea32855445f8736581f5cb119ce",22855176,2,9,0,1005,74,82,8
"d18a9ea32855445f8736581f5cb119ce","ae5ac430ea254e708a6f5deaaf7464ae",22855176,1,3,0,1006,82,84,2
"ae5ac430ea254e708a6f5deaaf7464ae","6a9f0ef185fb47f0937e29daa1c71ed5",22855176,2,7,0,1007,84,90,6
"6a9f0ef185fb47f0937e29daa1c71ed5","6a9f0ef185fb47f0937e29daa1c71ed5",22855176,6,0,1,1008,90,90,0
"6a9f0ef185fb47f0937e29daa1c71ed5","ae5ac430ea254e708a6f5deaaf7464ae",22855176,2,-7,0,1009,90,84,-6
"6a9f0ef185fb47f0937e29daa1c71ed5","67a089198fcb4e1c8f2385786c2b296f",22855176,1,-64,0,1011,90,39,-51
"67a089198fcb4e1c8f2385786c2b296f","42fb58708eaf4e5daa82bfca61b6f5fd",22855176,1,61,0,1012,39,87,48
"42fb58708eaf4e5daa82bfca61b6f5fd","d646286c8051419bbc2e31dd1db55ca8",22855176,1,-24,0,1013,87,67,-20
"d646286c8051419bbc2e31dd1db55ca8","6a9f0ef185fb47f0937e29daa1c71ed5",22855176,1,27,0,1014,67,90,23
"6a9f0ef185fb47f0937e29daa1c71ed5","e20db35ced8544ddac5bc3839145e463",22855176,1,3,0,1017,90,91,1
"e20db35ced8544ddac5bc3839145e463","3ec3a3563847406fa73338f9e9999cf3",22855176,2,30,0,1018,91,117,26
"3ec3a3563847406fa73338f9e9999cf3","62bff51286ef4f348717a3cf6fe2318f",22855176,1,3,0,1019,117,120,3
"62bff51286ef4f348717a3cf6fe2318f","62bff51286ef4f348717a3cf6fe2318f",22855176,11,0,1,1020,120,120,0
"62bff51286ef4f348717a3cf6fe2318f","f661500307d74c908e9207d949ceb4aa",22855176,1,21,0,1022,120,136,16
"f661500307d74c908e9207d949ceb4aa","779f9ddd1fd14d1e9e69f72219a1fdbd",22855176,1,-18,0,1023,136,121,-15
"779f9ddd1fd14d1e9e69f72219a1fdbd","df1de691dafe4549a18a4398ee9dfaf9",22855176,2,23,0,1024,121,139,18
"df1de691dafe4549a18a4398ee9dfaf9","f4ce60b4a944484082ccb701b48b3da1",22855176,1,21,0,1025,139,157,18
"f4ce60b4a944484082ccb701b48b3da1","d313cec988a84645bee413e8d4724a4b",22855176,1,1,0,1026,157,158,1
"d313cec988a84645bee413e8d4724a4b","cf4c280bad6a43e6b131d8385ef9ef3f",22855176,1,40,0,1027,158,184,26
"cf4c280bad6a43e6b131d8385ef9ef3f","0c7262dff33c4087bc660ccf40f92f9c",22855176,1,-19,0,1028,184,169,-15
"0c7262dff33c4087bc660ccf40f92f9c","c8e371568a0c4391b25796ae4e91952e",22855176,2,23,0,1029,169,186,17
"c8e371568a0c4391b25796ae4e91952e","b54257a550b94ebc9538f3a90eee9d7e",22855176,1,22,0,1030,186,204,18
"b54257a550b94ebc9538f3a90eee9d7e","be95c065e45447c1bd8215ea6f130c7a",22855176,1,21,0,1031,204,219,15
"be95c065e45447c1bd8215ea6f130c7a","d7f13c8d63ec4e2aa673fbb9cf9c6933",22855176,1,-17,0,1032,219,206,-13
"d7f13c8d63ec4e2aa673fbb9cf9c6933","91125ca626c5470eb145501f8c37f8db",22855176,1,18,0,1033,206,220,14
"91125ca626c5470eb145501f8c37f8db","91125ca626c5470eb145501f8c37f8db",22855176,2,0,1,1034,220,220,0
"91125ca626c5470eb145501f8c37f8db","1c6721b1f63f4d30ba7746ea8af02a52",22855176,1,3,0,1036,220,221,1
"1c6721b1f63f4d30ba7746ea8af02a52","d7f13c8d63ec4e2aa673fbb9cf9c6933",22855176,1,-21,0,1037,221,206,-15
"d7f13c8d63ec4e2aa673fbb9cf9c6933","77ecef8eff6b4a2caea7707669bf7475",22855176,1,22,0,1038,206,222,16
"77ecef8eff6b4a2caea7707669bf7475","1c6721b1f63f4d30ba7746ea8af02a52",22855176,2,-1,0,1039,222,221,-1
"1c6721b1f63f4d30ba7746ea8af02a52","1c6721b1f63f4d30ba7746ea8af02a52",22855176,1,0,1,1040,221,221,0
"1c6721b1f63f4d30ba7746ea8af02a52","77ecef8eff6b4a2caea7707669bf7475",22855176,1,1,0,1041,221,222,1
"77ecef8eff6b4a2caea7707669bf7475","77ecef8eff6b4a2caea7707669bf7475",22855176,12,0,1,1042,222,222,0
"1c6721b1f63f4d30ba7746ea8af02a52","8b9ae98743bd4d4a8a87dff1c1244211",22855176,1,7,0,1055,221,227,6
"8b9ae98743bd4d4a8a87dff1c1244211","d03cb855c70044cf8c35d9ec0de696e3",22855176,2,-3,0,1056,227,224,-3
"d03cb855c70044cf8c35d9ec0de696e3","a49a937d6896486d9a5396654abcf2e1",22855176,1,2,0,1057,224,226,2
"a49a937d6896486d9a5396654abcf2e1","a49a937d6896486d9a5396654abcf2e1",22855176,2,0,1,1058,226,226,0
"a49a937d6896486d9a5396654abcf2e1","8b9ae98743bd4d4a8a87dff1c1244211",22855176,1,1,0,1060,226,227,1
"8b9ae98743bd4d4a8a87dff1c1244211","8b9ae98743bd4d4a8a87dff1c1244211",22855176,13,0,1,1061,227,227,0
"d03cb855c70044cf8c35d9ec0de696e3","2ab1535aac1346ba8801535bf729ef37",22855176,1,6,0,1075,224,229,5
"2ab1535aac1346ba8801535bf729ef37","f7906d6f59b9489a91d2ef40db5a474d",22855176,1,-7,0,1076,229,223,-6
"f7906d6f59b9489a91d2ef40db5a474d","a4f40fb48a8542c8949bae1f002cd9bc",22855176,1,9,0,1077,223,231,8
"a4f40fb48a8542c8949bae1f002cd9bc","a4f40fb48a8542c8949bae1f002cd9bc",22855176,3,0,1,1078,231,231,0
"a4f40fb48a8542c8949bae1f002cd9bc","8972c23e32044edb8a78fa1eed4e5947",22855176,1,1,0,1081,231,232,1
"8972c23e32044edb8a78fa1eed4e5947","8972c23e32044edb8a78fa1eed4e5947",22855176,2,0,1,1082,232,232,0
"8972c23e32044edb8a78fa1eed4e5947","92feb4a40f8344d38b6f722e42a53295",22855176,1,1,0,1084,232,233,1
"92feb4a40f8344d38b6f722e42a53295","92feb4a40f8344d38b6f722e42a53295",22855176,3,0,1,1085,233,233,0
"92feb4a40f8344d38b6f722e42a53295","2ab1535aac1346ba8801535bf729ef37",22855176,1,-4,0,1088,233,229,-4
"2ab1535aac1346ba8801535bf729ef37","2ab1535aac1346ba8801535bf729ef37",22855176,1,0,1,1089,229,229,0
"2ab1535aac1346ba8801535bf729ef37","5152833676bf4c6cb317060be10f68db",22855176,1,-1,0,1090,229,228,-1
"5152833676bf4c6cb317060be10f68db","ca3e28f290354c08aefe5b0f769604e6",22855176,1,8,0,1091,228,235,7
"ca3e28f290354c08aefe5b0f769604e6","ca3e28f290354c08aefe5b0f769604e6",22855176,5,0,1,1092,235,235,0
"ca3e28f290354c08aefe5b0f769604e6","79a35eea833e4c2c9d22fc53c3c6445c",22855176,1,1,0,1097,235,236,1
"79a35eea833e4c2c9d22fc53c3c6445c","79a35eea833e4c2c9d22fc53c3c6445c",22855176,11,0,1,1098,236,236,0
"79a35eea833e4c2c9d22fc53c3c6445c","8f68228b1518449e9615cdafee41a2bd",22855176,1,1,0,1109,236,237,1
"8f68228b1518449e9615cdafee41a2bd","8f68228b1518449e9615cdafee41a2bd",22855176,3,0,1,1110,237,237,0
"8f68228b1518449e9615cdafee41a2bd","cab89fa5c3ed45a5aa550fc0352d6a42",22855176,1,1,0,1113,237,238,1
"cab89fa5c3ed45a5aa550fc0352d6a42","cab89fa5c3ed45a5aa550fc0352d6a42",22855176,2,0,1,1114,238,238,0
"cab89fa5c3ed45a5aa550fc0352d6a42","66d4fad4f1cf4b46be0750a99ad7a35a",22855176,1,1,0,1116,238,239,1
"66d4fad4f1cf4b46be0750a99ad7a35a","66d4fad4f1cf4b46be0750a99ad7a35a",22855176,2,0,1,1117,239,239,0
"66d4fad4f1cf4b46be0750a99ad7a35a","0b04c8e2f86d48c7aeb7e225819cd32b",22855176,1,-5,0,1119,239,234,-5
"0b04c8e2f86d48c7aeb7e225819cd32b","64dbedb3ce544f6aae8e10e0cf10f16d",22855176,1,7,0,1120,234,240,6
"64dbedb3ce544f6aae8e10e0cf10f16d","0b04c8e2f86d48c7aeb7e225819cd32b",22855176,1,-7,0,1121,240,234,-6
"0b04c8e2f86d48c7aeb7e225819cd32b","f53da5fd9bfe412da4b80d4742563b6c",22855176,1,8,0,1122,234,241,7
"f53da5fd9bfe412da4b80d4742563b6c","f53da5fd9bfe412da4b80d4742563b6c",22855176,3,0,1,1123,241,241,0
"f53da5fd9bfe412da4b80d4742563b6c","2ae94c0cea4d480a9d5dca8fb1d7b542",22855176,1,3,0,1126,241,242,1
"2ae94c0cea4d480a9d5dca8fb1d7b542","1c6721b1f63f4d30ba7746ea8af02a52",22855176,1,-27,0,1127,242,221,-21
"1c6721b1f63f4d30ba7746ea8af02a52","1ebf23f9d994469a85206e4c7b1bf5f5",22855176,1,30,0,1128,221,245,24
"1ebf23f9d994469a85206e4c7b1bf5f5","1ebf23f9d994469a85206e4c7b1bf5f5",22855176,10,0,1,1129,245,245,0
"1ebf23f9d994469a85206e4c7b1bf5f5","85ae675b83e8422da842cfd25596af99",22855176,1,1,0,1139,245,246,1
"85ae675b83e8422da842cfd25596af99","85ae675b83e8422da842cfd25596af99",22855176,2,0,1,1140,246,246,0
"85ae675b83e8422da842cfd25596af99","2ae94c0cea4d480a9d5dca8fb1d7b542",22855176,1,-4,0,1142,246,242,-4
"2ae94c0cea4d480a9d5dca8fb1d7b542","fa235f0f364d47e4ae1c87f47bf8e6ba",22855176,1,12,0,1143,242,252,10
"fa235f0f364d47e4ae1c87f47bf8e6ba","79f7845465cc4ed19d8e4f1429541be0",22855176,1,2,0,1144,252,254,2
"79f7845465cc4ed19d8e4f1429541be0","79f7845465cc4ed19d8e4f1429541be0",22855176,3,0,1,1145,254,254,0
"79f7845465cc4ed19d8e4f1429541be0","fa235f0f364d47e4ae1c87f47bf8e6ba",22855176,1,-2,0,1148,254,252,-2
"fa235f0f364d47e4ae1c87f47bf8e6ba","6e83e23f56544a19b94067c1c558d9c0",22855176,1,-6,0,1149,252,247,-5
"6e83e23f56544a19b94067c1c558d9c0","00f61990949545828dd12f1303d47504",22855176,2,11,0,1150,247,256,9
"00f61990949545828dd12f1303d47504","ead7bb4b64e247d2ae632ab8a296b091",22855176,1,2,0,1151,256,258,2
"ead7bb4b64e247d2ae632ab8a296b091","ead7bb4b64e247d2ae632ab8a296b091",22855176,3,0,1,1152,258,258,0
"ead7bb4b64e247d2ae632ab8a296b091","41b0048dde734bb280bac6116baa8e27",22855176,1,1,0,1155,258,259,1
"41b0048dde734bb280bac6116baa8e27","41b0048dde734bb280bac6116baa8e27",22855176,3,0,1,1156,259,259,0
"41b0048dde734bb280bac6116baa8e27","b41c5a094a604ee0915327da5cc0beb7",22855176,1,1,0,1159,259,260,1
"b41c5a094a604ee0915327da5cc0beb7","b41c5a094a604ee0915327da5cc0beb7",22855176,3,0,1,1160,260,260,0
"b41c5a094a604ee0915327da5cc0beb7","00f61990949545828dd12f1303d47504",22855176,1,-4,0,1163,260,256,-4
"00f61990949545828dd12f1303d47504","d546341988904f069cfa86b21457d9d9",22855176,1,-6,0,1164,256,251,-5
"d546341988904f069cfa86b21457d9d9","28c171777c52431ab6b925073bd63d46",22855176,1,15,0,1165,251,264,13
"28c171777c52431ab6b925073bd63d46","28c171777c52431ab6b925073bd63d46",22855176,4,0,1,1166,264,264,0
"28c171777c52431ab6b925073bd63d46","ac160db940cb49ae8579162b1d52bb5d",22855176,1,2,0,1170,264,266,2
"ac160db940cb49ae8579162b1d52bb5d","ac160db940cb49ae8579162b1d52bb5d",22855176,4,0,1,1171,266,266,0
"ac160db940cb49ae8579162b1d52bb5d","d989ebcfc12a4b669f0100dc1aa14f1e",22855176,1,-12,0,1175,266,255,-11
"d989ebcfc12a4b669f0100dc1aa14f1e","c6fd49b485cc4874b0bbdd9c6171e09c",22855176,1,15,0,1176,255,268,13
"c6fd49b485cc4874b0bbdd9c6171e09c","c6fd49b485cc4874b0bbdd9c6171e09c",22855176,4,0,1,1177,268,268,0
"c6fd49b485cc4874b0bbdd9c6171e09c","44240778a97c4af0937817499b75707b",22855176,1,1,0,1181,268,269,1
"44240778a97c4af0937817499b75707b","44240778a97c4af0937817499b75707b",22855176,3,0,1,1182,269,269,0
"44240778a97c4af0937817499b75707b","7aa76d3e993840d8805f097cbdbcd44b",22855176,1,-9,0,1185,269,261,-8
"7aa76d3e993840d8805f097cbdbcd44b","7028800abe7d4e27b613d1d6cbe26bf7",22855176,1,7,0,1186,261,267,6
"7028800abe7d4e27b613d1d6cbe26bf7","7aa76d3e993840d8805f097cbdbcd44b",22855176,1,-7,0,1187,267,261,-6
"7aa76d3e993840d8805f097cbdbcd44b","d989ebcfc12a4b669f0100dc1aa14f1e",22855176,1,-7,0,1188,261,255,-6
"d989ebcfc12a4b669f0100dc1aa14f1e","865a4d3b43374da7944dc7d397f566d9",22855176,1,19,0,1189,255,271,16
"865a4d3b43374da7944dc7d397f566d9","865a4d3b43374da7944dc7d397f566d9",22855176,2,0,1,1190,271,271,0
"865a4d3b43374da7944dc7d397f566d9","0d987bed3ffa4ed0b9a2e62e97b7b30f",22855176,1,3,0,1192,271,272,1
"0d987bed3ffa4ed0b9a2e62e97b7b30f","2ae94c0cea4d480a9d5dca8fb1d7b542",22855176,1,-38,0,1193,272,242,-30
"2ae94c0cea4d480a9d5dca8fb1d7b542","0d987bed3ffa4ed0b9a2e62e97b7b30f",22855176,1,38,0,1194,242,272,30
"0d987bed3ffa4ed0b9a2e62e97b7b30f","eb2a0eb537344a9e891c761662e400b6",22855176,1,-353,0,1195,272,16,-256
"eb2a0eb537344a9e891c761662e400b6","56586aa865414f538729c7f7735d2bc6",22855176,3,-8,0,1196,16,12,-4
"56586aa865414f538729c7f7735d2bc6","5c5ceeee4562457ba6d41515aeebfbb1",22855176,4,10,0,1197,12,17,5
"5c5ceeee4562457ba6d41515aeebfbb1","eb2a0eb537344a9e891c761662e400b6",22855176,1,-2,0,1198,17,16,-1
"eb2a0eb537344a9e891c761662e400b6","82ae07bc0c9b4570a41799290d1ef399",22855176,1,357,0,1199,16,275,259
"82ae07bc0c9b4570a41799290d1ef399","0d987bed3ffa4ed0b9a2e62e97b7b30f",22855176,3,-4,0,1200,275,272,-3
"0d987bed3ffa4ed0b9a2e62e97b7b30f","82ae07bc0c9b4570a41799290d1ef399",22855176,3,4,0,1201,272,275,3
"0d987bed3ffa4ed0b9a2e62e97b7b30f","8959e6304a0348309a771e4d08d1b64a",22855176,1,-148,0,1203,272,163,-109
"8959e6304a0348309a771e4d08d1b64a","78adeee1fa2c4fe0bc73f7bca9fcee86",22855176,2,-4,0,1204,163,160,-3
"78adeee1fa2c4fe0bc73f7bca9fcee86","65202579580f4ad38d734b4ee39d22a8",22855176,9,5,0,1205,160,164,4
"65202579580f4ad38d734b4ee39d22a8","65202579580f4ad38d734b4ee39d22a8",22855176,78,0,1,1206,164,164,0
"65202579580f4ad38d734b4ee39d22a8","67a089198fcb4e1c8f2385786c2b296f",22855176,1,-157,0,1215,164,39,-125
"67a089198fcb4e1c8f2385786c2b296f","0d987bed3ffa4ed0b9a2e62e97b7b30f",22855176,1,304,0,1216,39,272,233
"82ae07bc0c9b4570a41799290d1ef399","82ae07bc0c9b4570a41799290d1ef399",22855176,2,0,1,1218,275,275,0
"0d987bed3ffa4ed0b9a2e62e97b7b30f","0d987bed3ffa4ed0b9a2e62e97b7b30f",22855176,3,0,1,1220,272,272,0
"82ae07bc0c9b4570a41799290d1ef399","bb5a47f5ea01454a8b79455422d3b9da",22855176,4,6,0,1223,275,280,5
"bb5a47f5ea01454a8b79455422d3b9da","bb5a47f5ea01454a8b79455422d3b9da",22855176,89,0,1,1224,280,280,0
"bb5a47f5ea01454a8b79455422d3b9da","bc5524e78a8544e2ae2fdc2f3462bbec",22855176,3,-1,0,1231,280,279,-1
"bc5524e78a8544e2ae2fdc2f3462bbec","0d987bed3ffa4ed0b9a2e62e97b7b30f",22855176,3,-9,0,1232,279,272,-7
"0d987bed3ffa4ed0b9a2e62e97b7b30f","bb5a47f5ea01454a8b79455422d3b9da",22855176,3,10,0,1233,272,280,8
"bb5a47f5ea01454a8b79455422d3b9da","82ae07bc0c9b4570a41799290d1ef399",22855176,2,-6,0,1265,280,275,-5
"bc5524e78a8544e2ae2fdc2f3462bbec","82ae07bc0c9b4570a41799290d1ef399",22855176,1,-5,0,1297,279,275,-4
"bb5a47f5ea01454a8b79455422d3b9da","94cecc3f1e7d484b8e068e79241dfd73",22855176,1,3,0,1318,280,281,1
"94cecc3f1e7d484b8e068e79241dfd73","0d987bed3ffa4ed0b9a2e62e97b7b30f",22855176,1,-13,0,1319,281,272,-9
"0d987bed3ffa4ed0b9a2e62e97b7b30f","a37477c4e4c14169ad44b06b493007f6",22855176,1,15,0,1320,272,283,11
"a37477c4e4c14169ad44b06b493007f6","bc5524e78a8544e2ae2fdc2f3462bbec",22855176,1,-6,0,1321,283,279,-4
"bb5a47f5ea01454a8b79455422d3b9da","0d987bed3ffa4ed0b9a2e62e97b7b30f",22855176,1,-10,0,1333,280,272,-8
"0d987bed3ffa4ed0b9a2e62e97b7b30f","94cecc3f1e7d484b8e068e79241dfd73",22855176,1,13,0,1334,272,281,9
"94cecc3f1e7d484b8e068e79241dfd73","a37477c4e4c14169ad44b06b493007f6",22855176,1,2,0,1335,281,283,2
"a37477c4e4c14169ad44b06b493007f6","4a29443515bb404cb8924e1c60a63b73",22855176,1,7,0,1336,283,285,2
"4a29443515bb404cb8924e1c60a63b73","94cecc3f1e7d484b8e068e79241dfd73",22855176,1,-9,0,1337,285,281,-4
"94cecc3f1e7d484b8e068e79241dfd73","208c9b2796c944db8dacaa96082520ea",22855176,1,12,0,1338,281,288,7
"208c9b2796c944db8dacaa96082520ea","4a29443515bb404cb8924e1c60a63b73",22855176,4,-3,0,1339,288,285,-3
"4a29443515bb404cb8924e1c60a63b73","4a29443515bb404cb8924e1c60a63b73",22855176,4,0,1,1340,285,285,0
"4a29443515bb404cb8924e1c60a63b73","208c9b2796c944db8dacaa96082520ea",22855176,6,3,0,1341,285,288,3
"4a29443515bb404cb8924e1c60a63b73","b71bac264efb4abd97015447bd490db6",22855176,2,110,0,1343,285,370,85
"b71bac264efb4abd97015447bd490db6","b71bac264efb4abd97015447bd490db6",22855176,3,0,1,1344,370,370,0
"b71bac264efb4abd97015447bd490db6","4a29443515bb404cb8924e1c60a63b73",22855176,4,-110,0,1345,370,285,-85
"208c9b2796c944db8dacaa96082520ea","208c9b2796c944db8dacaa96082520ea",22855176,2,0,1,1349,288,288,0
"208c9b2796c944db8dacaa96082520ea","6a9a3b5bde4a48daa896fe8c06eca56f",22855176,1,2,0,1352,288,289,1
"6a9a3b5bde4a48daa896fe8c06eca56f","4a29443515bb404cb8924e1c60a63b73",22855176,1,-5,0,1353,289,285,-4
"4a29443515bb404cb8924e1c60a63b73","7669a956527947d0add87455277e80b4",22855176,2,7,0,1354,285,291,6
"7669a956527947d0add87455277e80b4","7669a956527947d0add87455277e80b4",22855176,7,0,1,1355,291,291,0
"7669a956527947d0add87455277e80b4","fab84b4fab5940efb4ea868ef8d09396",22855176,1,-11,0,1358,291,284,-7
"fab84b4fab5940efb4ea868ef8d09396","fab84b4fab5940efb4ea868ef8d09396",22855176,5,0,1,1359,284,284,0
"fab84b4fab5940efb4ea868ef8d09396","0c7262dff33c4087bc660ccf40f92f9c",22855176,1,-153,0,1360,284,169,-115
"0c7262dff33c4087bc660ccf40f92f9c","73039f8c1eb9409cb4caee2cf968001e",22855176,1,-92,0,1361,169,100,-69
"73039f8c1eb9409cb4caee2cf968001e","e20db35ced8544ddac5bc3839145e463",22855176,1,-10,0,1362,100,91,-9
"e20db35ced8544ddac5bc3839145e463","e20db35ced8544ddac5bc3839145e463",22855176,8,0,1,1363,91,91,0
"e20db35ced8544ddac5bc3839145e463","73039f8c1eb9409cb4caee2cf968001e",22855176,2,10,0,1364,91,100,9
"73039f8c1eb9409cb4caee2cf968001e","00ae5f0c51874a73a41ebea838d95682",22855176,3,1,0,1365,100,101,1
"00ae5f0c51874a73a41ebea838d95682","d391c8b6e56a43a7b654e9dee02d904b",22855176,4,2,0,1366,101,103,2
"d391c8b6e56a43a7b654e9dee02d904b","73039f8c1eb9409cb4caee2cf968001e",22855176,2,-3,0,1367,103,100,-3
"73039f8c1eb9409cb4caee2cf968001e","4280927ec4d643238aa49c32f9e06c6c",22855176,3,10,0,1368,100,109,9
"4280927ec4d643238aa49c32f9e06c6c","d391c8b6e56a43a7b654e9dee02d904b",22855176,1,-7,0,1369,109,103,-6
"d391c8b6e56a43a7b654e9dee02d904b","08111f75e22d409998cf8b85bd431f0a",22855176,1,6,0,1370,103,108,5
"08111f75e22d409998cf8b85bd431f0a","00ae5f0c51874a73a41ebea838d95682",22855176,1,-8,0,1371,108,101,-7
"00ae5f0c51874a73a41ebea838d95682","00ae5f0c51874a73a41ebea838d95682",22855176,4,0,1,1372,101,101,0
"00ae5f0c51874a73a41ebea838d95682","73039f8c1eb9409cb4caee2cf968001e",22855176,1,-1,0,1374,101,100,-1
"4280927ec4d643238aa49c32f9e06c6c","67a089198fcb4e1c8f2385786c2b296f",22855176,1,-87,0,1376,109,39,-70
"67a089198fcb4e1c8f2385786c2b296f","e20db35ced8544ddac5bc3839145e463",22855176,2,67,0,1377,39,91,52
"e20db35ced8544ddac5bc3839145e463","37319e88176d4aefa91d7a9980dbae91",22855176,3,24,0,1378,91,112,21
"37319e88176d4aefa91d7a9980dbae91","62bff51286ef4f348717a3cf6fe2318f",22855176,6,9,0,1379,112,120,8
"62bff51286ef4f348717a3cf6fe2318f","37319e88176d4aefa91d7a9980dbae91",22855176,2,-9,0,1380,120,112,-8
"62bff51286ef4f348717a3cf6fe2318f","67a089198fcb4e1c8f2385786c2b296f",22855176,3,-100,0,1383,120,39,-81
"67a089198fcb4e1c8f2385786c2b296f","df1de691dafe4549a18a4398ee9dfaf9",22855176,1,126,0,1384,39,139,100
"df1de691dafe4549a18a4398ee9dfaf9","df1de691dafe4549a18a4398ee9dfaf9",22855176,2,0,1,1385,139,139,0
"df1de691dafe4549a18a4398ee9dfaf9","6c5ad271a44743479bfaea29b1db8d02",22855176,2,4,0,1386,139,143,4
"6c5ad271a44743479bfaea29b1db8d02","df1de691dafe4549a18a4398ee9dfaf9",22855176,2,-4,0,1387,143,139,-4
"df1de691dafe4549a18a4398ee9dfaf9","8aae34f5ddbb4052a709b12e6b0d40fa",22855176,3,9,0,1388,139,147,8
"8aae34f5ddbb4052a709b12e6b0d40fa","b7719e26494940efa49512aedd0aac79",22855176,1,-175,0,1389,147,20,-127
"b7719e26494940efa49512aedd0aac79","a49d1bb4328949299686242fd0be5584",22855176,3,2,0,1390,20,21,1
"a49d1bb4328949299686242fd0be5584","b7719e26494940efa49512aedd0aac79",22855176,3,-2,0,1391,21,20,-1
"b7719e26494940efa49512aedd0aac79","afbf7250b99d47bea07172749483ca97",22855176,4,12,0,1392,20,28,8
"afbf7250b99d47bea07172749483ca97","b613861cecf84ffcab01afb23f660475",22855176,2,-44,0,1393,28,1,-27
"b613861cecf84ffcab01afb23f660475","00ae5f0c51874a73a41ebea838d95682",22855176,1,150,0,1394,1,101,100
"00ae5f0c51874a73a41ebea838d95682","e20db35ced8544ddac5bc3839145e463",22855176,1,-11,0,1395,101,91,-10
"e20db35ced8544ddac5bc3839145e463","00ae5f0c51874a73a41ebea838d95682",22855176,1,11,0,1396,91,101,10
"73039f8c1eb9409cb4caee2cf968001e","71cec822bcff4f30a20e75dc63ef7b65",22855176,1,18,0,1400,100,116,16
"71cec822bcff4f30a20e75dc63ef7b65","37319e88176d4aefa91d7a9980dbae91",22855176,2,-4,0,1401,116,112,-4
"67a089198fcb4e1c8f2385786c2b296f","0c7262dff33c4087bc660ccf40f92f9c",22855176,1,169,0,1406,39,169,130
"0c7262dff33c4087bc660ccf40f92f9c","0c7262dff33c4087bc660ccf40f92f9c",22855176,8,0,1,1407,169,169,0
"0c7262dff33c4087bc660ccf40f92f9c","4a29443515bb404cb8924e1c60a63b73",22855176,1,157,0,1409,169,285,116
"7669a956527947d0add87455277e80b4","6a9a3b5bde4a48daa896fe8c06eca56f",22855176,1,-2,0,1419,291,289,-2
"6a9a3b5bde4a48daa896fe8c06eca56f","869e967078f04da18dd0b0b9389a7424",22855176,2,5,0,1420,289,293,4
"869e967078f04da18dd0b0b9389a7424","51ab6291537748fab90d519aa09889d6",22855176,1,2,0,1421,293,295,2
"51ab6291537748fab90d519aa09889d6","51ab6291537748fab90d519aa09889d6",22855176,6,0,1,1422,295,295,0
"51ab6291537748fab90d519aa09889d6","869e967078f04da18dd0b0b9389a7424",22855176,1,-2,0,1428,295,293,-2
"869e967078f04da18dd0b0b9389a7424","34a6e49023fc4465bd5ca604330bbd1c",22855176,1,-1,0,1429,293,292,-1
"34a6e49023fc4465bd5ca604330bbd1c","21592f2a9e9c4b2f8c66ec5dbcbf6a2b",22855176,1,5,0,1430,292,296,4
"21592f2a9e9c4b2f8c66ec5dbcbf6a2b","ba0e59461bfb4a44b7b1c28a01f8d3b3",22855176,2,4,0,1431,296,299,3
"ba0e59461bfb4a44b7b1c28a01f8d3b3","0e0b36e731a645e7b1b8a88f5031ca38",22855176,1,2,0,1432,299,301,2
"0e0b36e731a645e7b1b8a88f5031ca38","0e0b36e731a645e7b1b8a88f5031ca38",22855176,3,0,1,1433,301,301,0
"0e0b36e731a645e7b1b8a88f5031ca38","a66a144637284c21afc6de17fea4bfb8",22855176,1,1,0,1436,301,302,1
"a66a144637284c21afc6de17fea4bfb8","a66a144637284c21afc6de17fea4bfb8",22855176,3,0,1,1437,302,302,0
"a66a144637284c21afc6de17fea4bfb8","ba0e59461bfb4a44b7b1c28a01f8d3b3",22855176,1,-3,0,1440,302,299,-3
"ba0e59461bfb4a44b7b1c28a01f8d3b3","7646a919d7e64fa990bca9b024ff089d",22855176,2,-1,0,1441,299,298,-1
"7646a919d7e64fa990bca9b024ff089d","e390b575229748ea8aac9364efe2bf00",22855176,1,7,0,1442,298,304,6
"e390b575229748ea8aac9364efe2bf00","e390b575229748ea8aac9364efe2bf00",22855176,2,0,1,1443,304,304,0
"e390b575229748ea8aac9364efe2bf00","3434c10e561d488a914e0f7d71907abd",22855176,1,3,0,1445,304,305,1
"3434c10e561d488a914e0f7d71907abd","4a29443515bb404cb8924e1c60a63b73",22855176,1,-27,0,1446,305,285,-20
"4a29443515bb404cb8924e1c60a63b73","53e7e900392747ccad52e711ab0f80d8",22855176,1,29,0,1447,285,307,22
"53e7e900392747ccad52e711ab0f80d8","4a29443515bb404cb8924e1c60a63b73",22855176,1,-29,0,1448,307,285,-22
"4a29443515bb404cb8924e1c60a63b73","3434c10e561d488a914e0f7d71907abd",22855176,1,27,0,1452,285,305,20
"3434c10e561d488a914e0f7d71907abd","3434c10e561d488a914e0f7d71907abd",22855176,1,0,1,1453,305,305,0
"3434c10e561d488a914e0f7d71907abd","53e7e900392747ccad52e711ab0f80d8",22855176,1,2,0,1454,305,307,2
"53e7e900392747ccad52e711ab0f80d8","53e7e900392747ccad52e711ab0f80d8",22855176,1,0,1,1455,307,307,0
"53e7e900392747ccad52e711ab0f80d8","130acc2aeb0448fdbb2de63bc5cebe5b",22855176,1,3,0,1456,307,309,2
"130acc2aeb0448fdbb2de63bc5cebe5b","3434c10e561d488a914e0f7d71907abd",22855176,1,-5,0,1457,309,305,-4
"3434c10e561d488a914e0f7d71907abd","9c062b3251034ebe90f5054e2a3b5120",22855176,1,7,0,1458,305,311,6
"9c062b3251034ebe90f5054e2a3b5120","9c062b3251034ebe90f5054e2a3b5120",22855176,3,0,1,1459,311,311,0
"9c062b3251034ebe90f5054e2a3b5120","ea859f8207e44537889daeaba13ac2e8",22855176,1,1,0,1462,311,312,1
"ea859f8207e44537889daeaba13ac2e8","ea859f8207e44537889daeaba13ac2e8",22855176,2,0,1,1463,312,312,0
"ea859f8207e44537889daeaba13ac2e8","56d94971a7a94257aa330183a8ebd0ea",22855176,1,1,0,1465,312,313,1
"56d94971a7a94257aa330183a8ebd0ea","56d94971a7a94257aa330183a8ebd0ea",22855176,2,0,1,1466,313,313,0
"56d94971a7a94257aa330183a8ebd0ea","130acc2aeb0448fdbb2de63bc5cebe5b",22855176,1,-4,0,1468,313,309,-4
"130acc2aeb0448fdbb2de63bc5cebe5b","141c0df6cd1946539aadd1c9b7068cd4",22855176,1,-1,0,1469,309,308,-1
"141c0df6cd1946539aadd1c9b7068cd4","13255e63e0aa4abf85e5211bf613d43e",22855176,1,10,0,1470,308,317,9
"13255e63e0aa4abf85e5211bf613d43e","13255e63e0aa4abf85e5211bf613d43e",22855176,2,0,1,1471,317,317,0
"13255e63e0aa4abf85e5211bf613d43e","0c787d16c9504873b1a4d903cec09948",22855176,1,-3,0,1473,317,314,-3
"0c787d16c9504873b1a4d903cec09948","86c27d40179e419c8e9d150fb6afa5d0",22855176,1,6,0,1474,314,319,5
"86c27d40179e419c8e9d150fb6afa5d0","86c27d40179e419c8e9d150fb6afa5d0",22855176,2,0,1,1475,319,319,0
"86c27d40179e419c8e9d150fb6afa5d0","47edbb64109243e6b0f8f64cdef90c6c",22855176,1,8,0,1477,319,326,7
"47edbb64109243e6b0f8f64cdef90c6c","8d7e0b55cf9849cda222a0f2440cec55",22855176,1,-9,0,1478,326,318,-8
"8d7e0b55cf9849cda222a0f2440cec55","24f1363179ad4aaa965484a78471912b",22855176,1,6,0,1479,318,323,5
"24f1363179ad4aaa965484a78471912b","24f1363179ad4aaa965484a78471912b",22855176,1,0,1,1480,323,323,0
"24f1363179ad4aaa965484a78471912b","3628bdce1dd2429ba924d2d4d09448d2",22855176,2,-1,0,1481,323,322,-1
"3628bdce1dd2429ba924d2d4d09448d2","3434c10e561d488a914e0f7d71907abd",22855176,2,-21,0,1482,322,305,-17
"3434c10e561d488a914e0f7d71907abd","0c4079457ede49e3aeb5e86ed84bdf35",22855176,1,31,0,1483,305,329,24
"0c4079457ede49e3aeb5e86ed84bdf35","38aea304b4fa46e1b29bb72f5cea4c93",22855176,4,2,0,1484,329,331,2
"38aea304b4fa46e1b29bb72f5cea4c93","0c4079457ede49e3aeb5e86ed84bdf35",22855176,2,-2,0,1485,331,329,-2
"0c4079457ede49e3aeb5e86ed84bdf35","4a92daef4d504e1792575a26502bb7b7",22855176,1,20,0,1486,329,346,17
"4a92daef4d504e1792575a26502bb7b7","bbc5139ca9024389a94db3a6f47dcff6",22855176,1,-6,0,1487,346,341,-5
"bbc5139ca9024389a94db3a6f47dcff6","4a29443515bb404cb8924e1c60a63b73",22855176,1,-72,0,1488,341,285,-56
"4a29443515bb404cb8924e1c60a63b73","0c4079457ede49e3aeb5e86ed84bdf35",22855176,2,58,0,1489,285,329,44
"0c4079457ede49e3aeb5e86ed84bdf35","0c4079457ede49e3aeb5e86ed84bdf35",22855176,4,0,1,1490,329,329,0
"38aea304b4fa46e1b29bb72f5cea4c93","3434c10e561d488a914e0f7d71907abd",22855176,1,-33,0,1492,331,305,-26
"3434c10e561d488a914e0f7d71907abd","43ea1b823a4b4e51b7c694c10725db82",22855176,2,27,0,1493,305,327,22
"43ea1b823a4b4e51b7c694c10725db82","56b3fd1a212a4764be39d979fde3326e",22855176,1,1,0,1494,327,328,1
"56b3fd1a212a4764be39d979fde3326e","56b3fd1a212a4764be39d979fde3326e",22855176,2,0,1,1495,328,328,0
"56b3fd1a212a4764be39d979fde3326e","0c4079457ede49e3aeb5e86ed84bdf35",22855176,1,3,0,1497,328,329,1
"0c4079457ede49e3aeb5e86ed84bdf35","3434c10e561d488a914e0f7d71907abd",22855176,1,-31,0,1498,329,305,-24
"3434c10e561d488a914e0f7d71907abd","38aea304b4fa46e1b29bb72f5cea4c93",22855176,1,33,0,1499,305,331,26
"38aea304b4fa46e1b29bb72f5cea4c93","4a29443515bb404cb8924e1c60a63b73",22855176,1,-60,0,1500,331,285,-46
"38aea304b4fa46e1b29bb72f5cea4c93","0c7262dff33c4087bc660ccf40f92f9c",22855176,1,-217,0,1504,331,169,-162
"0c7262dff33c4087bc660ccf40f92f9c","43ea1b823a4b4e51b7c694c10725db82",22855176,1,211,0,1506,169,327,158
"43ea1b823a4b4e51b7c694c10725db82","3434c10e561d488a914e0f7d71907abd",22855176,1,-27,0,1507,327,305,-22
"43ea1b823a4b4e51b7c694c10725db82","47edbb64109243e6b0f8f64cdef90c6c",22855176,2,-2,0,1509,327,326,-1
"47edbb64109243e6b0f8f64cdef90c6c","24f1363179ad4aaa965484a78471912b",22855176,3,-3,0,1510,326,323,-3
"24f1363179ad4aaa965484a78471912b","3434c10e561d488a914e0f7d71907abd",22855176,1,-22,0,1511,323,305,-18
"3434c10e561d488a914e0f7d71907abd","3628bdce1dd2429ba924d2d4d09448d2",22855176,1,21,0,1512,305,322,17
"3628bdce1dd2429ba924d2d4d09448d2","47edbb64109243e6b0f8f64cdef90c6c",22855176,1,4,0,1513,322,326,4
"3628bdce1dd2429ba924d2d4d09448d2","24f1363179ad4aaa965484a78471912b",22855176,1,1,0,1516,322,323,1
"24f1363179ad4aaa965484a78471912b","43ea1b823a4b4e51b7c694c10725db82",22855176,1,5,0,1517,323,327,4
"47edbb64109243e6b0f8f64cdef90c6c","0c4079457ede49e3aeb5e86ed84bdf35",22855176,1,6,0,1519,326,329,3
"38aea304b4fa46e1b29bb72f5cea4c93","e36d261332f14e79bb4b467aceaeb9b5",22855176,1,2,0,1522,331,333,2
"e36d261332f14e79bb4b467aceaeb9b5","e36d261332f14e79bb4b467aceaeb9b5",22855176,2,0,1,1523,333,333,0
"e36d261332f14e79bb4b467aceaeb9b5","c7e89b9d04744d2eab742fc24e3ef1ae",22855176,1,1,0,1525,333,334,1
"c7e89b9d04744d2eab742fc24e3ef1ae","c7e89b9d04744d2eab742fc24e3ef1ae",22855176,3,0,1,1526,334,334,0
"c7e89b9d04744d2eab742fc24e3ef1ae","fe49f8054b374a0ea4bb266ed135ff62",22855176,1,1,0,1529,334,335,1
"fe49f8054b374a0ea4bb266ed135ff62","fe49f8054b374a0ea4bb266ed135ff62",22855176,3,0,1,1530,335,335,0
"fe49f8054b374a0ea4bb266ed135ff62","d0a8f74af98642fe8360d22c42e45117",22855176,1,1,0,1533,335,336,1
"d0a8f74af98642fe8360d22c42e45117","d0a8f74af98642fe8360d22c42e45117",22855176,3,0,1,1534,336,336,0
"d0a8f74af98642fe8360d22c42e45117","38aea304b4fa46e1b29bb72f5cea4c93",22855176,1,-5,0,1537,336,331,-5
"0c4079457ede49e3aeb5e86ed84bdf35","b8b9418ab322418d9db9b40d96af873a",22855176,1,9,0,1540,329,337,8
"b8b9418ab322418d9db9b40d96af873a","a7c6339ca1da4368a18d471f0519f877",22855176,1,2,0,1541,337,339,2
"a7c6339ca1da4368a18d471f0519f877","a7c6339ca1da4368a18d471f0519f877",22855176,2,0,1,1542,339,339,0
"a7c6339ca1da4368a18d471f0519f877","bbc5139ca9024389a94db3a6f47dcff6",22855176,1,3,0,1544,339,341,2
"bbc5139ca9024389a94db3a6f47dcff6","b8b9418ab322418d9db9b40d96af873a",22855176,1,-5,0,1545,341,337,-4
"b8b9418ab322418d9db9b40d96af873a","4ee6ca9019ab4a1ab323f98094a9bd77",22855176,1,7,0,1546,337,343,6
"4ee6ca9019ab4a1ab323f98094a9bd77","4ee6ca9019ab4a1ab323f98094a9bd77",22855176,3,0,1,1547,343,343,0
"4ee6ca9019ab4a1ab323f98094a9bd77","b37947176785476f8b29d49a851366dc",22855176,1,1,0,1550,343,344,1
"b37947176785476f8b29d49a851366dc","b37947176785476f8b29d49a851366dc",22855176,3,0,1,1551,344,344,0
"b37947176785476f8b29d49a851366dc","fcea5b10d5a14a3b9324ffece8f6e1e5",22855176,1,1,0,1554,344,345,1
"fcea5b10d5a14a3b9324ffece8f6e1e5","fcea5b10d5a14a3b9324ffece8f6e1e5",22855176,7,0,1,1555,345,345,0
"fcea5b10d5a14a3b9324ffece8f6e1e5","bbc5139ca9024389a94db3a6f47dcff6",22855176,1,-4,0,1562,345,341,-4
"bbc5139ca9024389a94db3a6f47dcff6","bbc5139ca9024389a94db3a6f47dcff6",22855176,3,0,1,1563,341,341,0
"bbc5139ca9024389a94db3a6f47dcff6","c2490bc612d146edbe786556fab3651b",22855176,1,-1,0,1566,341,340,-1
"c2490bc612d146edbe786556fab3651b","6ac8bb048b854999a47edb35fe627f11",22855176,1,8,0,1567,340,347,7
"6ac8bb048b854999a47edb35fe627f11","6ac8bb048b854999a47edb35fe627f11",22855176,2,0,1,1568,347,347,0
"6ac8bb048b854999a47edb35fe627f11","0c4079457ede49e3aeb5e86ed84bdf35",22855176,1,-21,0,1570,347,329,-18
"0c4079457ede49e3aeb5e86ed84bdf35","30ead9794d4847abaf222ca966cc8630",22855176,1,24,0,1571,329,348,19
"30ead9794d4847abaf222ca966cc8630","09b9678ddc3d452ea4a3d46e15826065",22855176,1,5,0,1572,348,353,5
"09b9678ddc3d452ea4a3d46e15826065","897b7f51242c44aab2205c72fdcbf4cd",22855176,1,-1,0,1573,353,352,-1
"897b7f51242c44aab2205c72fdcbf4cd","c20993c944444fe085345591a8bd837e",22855176,1,-1,0,1574,352,351,-1
"c20993c944444fe085345591a8bd837e","eff0de7f2dbb42dfa1a2e686efab5b6d",22855176,1,3,0,1575,351,354,3
"eff0de7f2dbb42dfa1a2e686efab5b6d","c20993c944444fe085345591a8bd837e",22855176,1,-3,0,1576,354,351,-3
"c20993c944444fe085345591a8bd837e","c20993c944444fe085345591a8bd837e",22855176,3,0,1,1577,351,351,0
"c20993c944444fe085345591a8bd837e","897b7f51242c44aab2205c72fdcbf4cd",22855176,1,1,0,1580,351,352,1
"897b7f51242c44aab2205c72fdcbf4cd","897b7f51242c44aab2205c72fdcbf4cd",22855176,3,0,1,1581,352,352,0
"897b7f51242c44aab2205c72fdcbf4cd","09b9678ddc3d452ea4a3d46e15826065",22855176,1,1,0,1584,352,353,1
"09b9678ddc3d452ea4a3d46e15826065","09b9678ddc3d452ea4a3d46e15826065",22855176,3,0,1,1585,353,353,0
"09b9678ddc3d452ea4a3d46e15826065","eff0de7f2dbb42dfa1a2e686efab5b6d",22855176,1,1,0,1588,353,354,1
"eff0de7f2dbb42dfa1a2e686efab5b6d","eff0de7f2dbb42dfa1a2e686efab5b6d",22855176,3,0,1,1589,354,354,0
"eff0de7f2dbb42dfa1a2e686efab5b6d","2fe14166dc9642c3bc666b86a57f943d",22855176,1,4,0,1592,354,357,3
"2fe14166dc9642c3bc666b86a57f943d","30ead9794d4847abaf222ca966cc8630",22855176,1,-10,0,1593,357,348,-9
"30ead9794d4847abaf222ca966cc8630","44421dd1e13a47a388c4a19834b744c7",22855176,1,12,0,1594,348,359,11
"44421dd1e13a47a388c4a19834b744c7","44421dd1e13a47a388c4a19834b744c7",22855176,3,0,1,1595,359,359,0
"44421dd1e13a47a388c4a19834b744c7","cb5fc7ef85d547c4be1a7439d0bf6052",22855176,1,1,0,1598,359,360,1
"cb5fc7ef85d547c4be1a7439d0bf6052","cb5fc7ef85d547c4be1a7439d0bf6052",22855176,3,0,1,1599,360,360,0
"cb5fc7ef85d547c4be1a7439d0bf6052","0a8f150a4cf747acbde62f4721823da3",22855176,1,1,0,1602,360,361,1
"0a8f150a4cf747acbde62f4721823da3","0a8f150a4cf747acbde62f4721823da3",22855176,3,0,1,1603,361,361,0
"0a8f150a4cf747acbde62f4721823da3","ab8fdad974ae471f9f24c3f9dd04462e",22855176,1,1,0,1606,361,362,1
"ab8fdad974ae471f9f24c3f9dd04462e","ab8fdad974ae471f9f24c3f9dd04462e",22855176,3,0,1,1607,362,362,0
"ab8fdad974ae471f9f24c3f9dd04462e","2fe14166dc9642c3bc666b86a57f943d",22855176,1,-5,0,1610,362,357,-5
"2fe14166dc9642c3bc666b86a57f943d","52580888dadb4fe3baa795683ea227bd",22855176,1,8,0,1611,357,364,7
"52580888dadb4fe3baa795683ea227bd","1ba8fef685d74a8194b9db252eb704fb",22855176,1,-10,0,1612,364,355,-9
"1ba8fef685d74a8194b9db252eb704fb","52580888dadb4fe3baa795683ea227bd",22855176,1,10,0,1613,355,364,9
"52580888dadb4fe3baa795683ea227bd","f00179e251a045b39c3f7a54f9aa4acc",22855176,1,-1,0,1614,364,363,-1
"f00179e251a045b39c3f7a54f9aa4acc","492a3bc6a1254f23a7998587961b22a4",22855176,1,4,0,1615,363,366,3
"492a3bc6a1254f23a7998587961b22a4","492a3bc6a1254f23a7998587961b22a4",22855176,1,0,1,1616,366,366,0
"492a3bc6a1254f23a7998587961b22a4","072a190fd302456290895f9f04d6940a",22855176,1,-1,0,1617,366,365,-1
"072a190fd302456290895f9f04d6940a","cfa457d1743848e4bb5e4beced6448ed",22855176,1,5,0,1618,365,369,4
"cfa457d1743848e4bb5e4beced6448ed","cfa457d1743848e4bb5e4beced6448ed",22855176,2,0,1,1619,369,369,0
"cfa457d1743848e4bb5e4beced6448ed","30ead9794d4847abaf222ca966cc8630",22855176,1,-25,0,1621,369,348,-21
"30ead9794d4847abaf222ca966cc8630","b71bac264efb4abd97015447bd490db6",22855176,2,28,0,1622,348,370,22
"4a29443515bb404cb8924e1c60a63b73","c76574d21bc14aeea7ecd0b027f39858",22855176,1,105,0,1624,285,367,82
"c76574d21bc14aeea7ecd0b027f39858","30ead9794d4847abaf222ca966cc8630",22855176,1,-23,0,1625,367,348,-19
"30ead9794d4847abaf222ca966cc8630","30ead9794d4847abaf222ca966cc8630",22855176,1,0,1,1626,348,348,0
"4a29443515bb404cb8924e1c60a63b73","d6d02b6ef04e4f17805504500b8ce441",22855176,3,118,0,1629,285,375,90
"d6d02b6ef04e4f17805504500b8ce441","d6d02b6ef04e4f17805504500b8ce441",22855176,55,0,1,1630,375,375,0
"d6d02b6ef04e4f17805504500b8ce441","4a29443515bb404cb8924e1c60a63b73",22855176,3,-118,0,1632,375,285,-90
"4a29443515bb404cb8924e1c60a63b73","3628bdce1dd2429ba924d2d4d09448d2",22855176,1,48,0,1633,285,322,37
"3434c10e561d488a914e0f7d71907abd","47edbb64109243e6b0f8f64cdef90c6c",22855176,1,25,0,1635,305,326,21
"24f1363179ad4aaa965484a78471912b","b71bac264efb4abd97015447bd490db6",22855176,1,61,0,1637,323,370,47
"b71bac264efb4abd97015447bd490db6","8d448d625b024c82a5eb240bbd7431d6",22855176,5,5,0,1639,370,374,4
"8d448d625b024c82a5eb240bbd7431d6","b71bac264efb4abd97015447bd490db6",22855176,3,-5,0,1640,374,370,-4
"8d448d625b024c82a5eb240bbd7431d6","8d448d625b024c82a5eb240bbd7431d6",22855176,74,0,1,1642,374,374,0
"8d448d625b024c82a5eb240bbd7431d6","d6d02b6ef04e4f17805504500b8ce441",22855176,2,3,0,1693,374,375,1
"d6d02b6ef04e4f17805504500b8ce441","b71bac264efb4abd97015447bd490db6",22855176,3,-8,0,1694,375,370,-5
"b71bac264efb4abd97015447bd490db6","d6d02b6ef04e4f17805504500b8ce441",22855176,4,8,0,1695,370,375,5
"d6d02b6ef04e4f17805504500b8ce441","1b4550d0dab04078b3bf08a655345bdc",22855176,1,-4,0,1696,375,373,-2
"1b4550d0dab04078b3bf08a655345bdc","b71bac264efb4abd97015447bd490db6",22855176,1,-4,0,1697,373,370,-3
"d6d02b6ef04e4f17805504500b8ce441","0c7262dff33c4087bc660ccf40f92f9c",22855176,1,-275,0,1715,375,169,-206
"0c7262dff33c4087bc660ccf40f92f9c","b71bac264efb4abd97015447bd490db6",22855176,1,267,0,1716,169,370,201
"d6d02b6ef04e4f17805504500b8ce441","37319e88176d4aefa91d7a9980dbae91",22855176,1,-353,0,1751,375,112,-263
"37319e88176d4aefa91d7a9980dbae91","e20db35ced8544ddac5bc3839145e463",22855176,2,-24,0,1752,112,91,-21
"e20db35ced8544ddac5bc3839145e463","c9c52446b6294aa5a9c2abaed536c37e",22855176,1,-87,0,1753,91,32,-59
"c9c52446b6294aa5a9c2abaed536c37e","4e51676dc72045d99c19b9fa7b22f8bc",22855176,1,-5,0,1754,32,29,-3
"4e51676dc72045d99c19b9fa7b22f8bc","c33c17be71ae4d588da7369472e5bb1b",22855176,3,9,0,1755,29,34,5
"c33c17be71ae4d588da7369472e5bb1b","4e51676dc72045d99c19b9fa7b22f8bc",22855176,2,-9,0,1756,34,29,-5
"4e51676dc72045d99c19b9fa7b22f8bc","b613861cecf84ffcab01afb23f660475",22855176,1,-47,0,1757,29,1,-28
"b613861cecf84ffcab01afb23f660475","fc0e049d56024bc9a02c9a9c435c3df7",22855176,1,68,0,1758,1,38,37
"fc0e049d56024bc9a02c9a9c435c3df7","fc0e049d56024bc9a02c9a9c435c3df7",22855176,3,0,1,1759,38,38,0
"fc0e049d56024bc9a02c9a9c435c3df7","67a089198fcb4e1c8f2385786c2b296f",22855176,3,4,0,1761,38,39,1
"67a089198fcb4e1c8f2385786c2b296f","64d48c6c9c7940639a932219a6c87198",22855176,5,1,0,1762,39,40,1
"64d48c6c9c7940639a932219a6c87198","67a089198fcb4e1c8f2385786c2b296f",22855176,5,-1,0,1763,40,39,-1
"67a089198fcb4e1c8f2385786c2b296f","2ae94c0cea4d480a9d5dca8fb1d7b542",22855176,1,266,0,1771,39,242,203
"2ae94c0cea4d480a9d5dca8fb1d7b542","6e83e23f56544a19b94067c1c558d9c0",22855176,1,6,0,1772,242,247,5
"6e83e23f56544a19b94067c1c558d9c0","30c9ba177afc49a695625d2bdec40207",22855176,1,3,0,1773,247,250,3
"30c9ba177afc49a695625d2bdec40207","30c9ba177afc49a695625d2bdec40207",22855176,3,0,1,1774,250,250,0
"30c9ba177afc49a695625d2bdec40207","6e83e23f56544a19b94067c1c558d9c0",22855176,1,-3,0,1777,250,247,-3
"00f61990949545828dd12f1303d47504","d6d02b6ef04e4f17805504500b8ce441",22855176,1,161,0,1779,256,375,119
"d6d02b6ef04e4f17805504500b8ce441","a49d1bb4328949299686242fd0be5584",22855176,1,-482,0,1782,375,21,-354
"b7719e26494940efa49512aedd0aac79","b7719e26494940efa49512aedd0aac79",22855176,1,0,1,1784,20,20,0
"afbf7250b99d47bea07172749483ca97","d6d02b6ef04e4f17805504500b8ce441",22855176,1,472,0,1786,28,375,347
"d6d02b6ef04e4f17805504500b8ce441","fab84b4fab5940efb4ea868ef8d09396",22855176,1,-122,0,1795,375,284,-91
"fab84b4fab5940efb4ea868ef8d09396","4a29443515bb404cb8924e1c60a63b73",22855176,2,4,0,1798,284,285,1
"208c9b2796c944db8dacaa96082520ea","fab84b4fab5940efb4ea868ef8d09396",22855176,1,-7,0,1800,288,284,-4
"208c9b2796c944db8dacaa96082520ea","d6d02b6ef04e4f17805504500b8ce441",22855176,1,115,0,1805,288,375,87
"d6d02b6ef04e4f17805504500b8ce441","b2f0d654738f48158edff28e8d3a546e",22855176,2,116,0,1819,375,449,74
"b2f0d654738f48158edff28e8d3a546e","b2f0d654738f48158edff28e8d3a546e",22855176,4,0,1,1820,449,449,0
"b2f0d654738f48158edff28e8d3a546e","d6d02b6ef04e4f17805504500b8ce441",22855176,1,-116,0,1821,449,375,-74
"d6d02b6ef04e4f17805504500b8ce441","66baf19b6b904b70922329068c63746d",22855176,2,4,0,1825,375,376,1
"66baf19b6b904b70922329068c63746d","7f544639412e40a9ba27f43b415362ab",22855176,3,2,0,1826,376,378,2
"7f544639412e40a9ba27f43b415362ab","d6d02b6ef04e4f17805504500b8ce441",22855176,1,-6,0,1827,378,375,-3
"7f544639412e40a9ba27f43b415362ab","7f544639412e40a9ba27f43b415362ab",22855176,1,0,1,1832,378,378,0
"7f544639412e40a9ba27f43b415362ab","d5ae8642e15b46b8bd298b02274d4e9c",22855176,1,2,0,1833,378,380,2
"d5ae8642e15b46b8bd298b02274d4e9c","d5ae8642e15b46b8bd298b02274d4e9c",22855176,2,0,1,1834,380,380,0
"d5ae8642e15b46b8bd298b02274d4e9c","a0d10309a2dd456289147f84be9d37f9",22855176,1,1,0,1836,380,381,1
"a0d10309a2dd456289147f84be9d37f9","a0d10309a2dd456289147f84be9d37f9",22855176,3,0,1,1837,381,381,0
"a0d10309a2dd456289147f84be9d37f9","0fcbc3ca07b144138b8d85da581f09a8",22855176,1,1,0,1840,381,382,1
"0fcbc3ca07b144138b8d85da581f09a8","0fcbc3ca07b144138b8d85da581f09a8",22855176,3,0,1,1841,382,382,0
"0fcbc3ca07b144138b8d85da581f09a8","7f544639412e40a9ba27f43b415362ab",22855176,1,-4,0,1844,382,378,-4
"7f544639412e40a9ba27f43b415362ab","66baf19b6b904b70922329068c63746d",22855176,2,-2,0,1845,378,376,-2
"66baf19b6b904b70922329068c63746d","4890121ce5d74576b4632b77cfc23398",22855176,1,14,0,1846,376,388,12
"4890121ce5d74576b4632b77cfc23398","c2fca3669923477ab966ded303dea31c",22855176,1,-6,0,1847,388,383,-5
"c2fca3669923477ab966ded303dea31c","4890121ce5d74576b4632b77cfc23398",22855176,2,6,0,1848,383,388,5
"4890121ce5d74576b4632b77cfc23398","18d3b836dd804224883cc9180b60a8e1",22855176,1,-1,0,1849,388,387,-1
"18d3b836dd804224883cc9180b60a8e1","96bb2b3e85a34d8b9544514e89f6fe97",22855176,1,4,0,1850,387,390,3
"96bb2b3e85a34d8b9544514e89f6fe97","ac4e9b54acfe4670b4634859c7263cb5",22855176,1,2,0,1851,390,392,2
"ac4e9b54acfe4670b4634859c7263cb5","ac4e9b54acfe4670b4634859c7263cb5",22855176,2,0,1,1852,392,392,0
"ac4e9b54acfe4670b4634859c7263cb5","6f8881a745ac4c358a68b92c3b4abe81",22855176,1,3,0,1854,392,394,2
"6f8881a745ac4c358a68b92c3b4abe81","17f95d18bab743888e1736033dc3384d",22855176,3,-6,0,1855,394,389,-5
"17f95d18bab743888e1736033dc3384d","96bb2b3e85a34d8b9544514e89f6fe97",22855176,1,1,0,1856,389,390,1
"96bb2b3e85a34d8b9544514e89f6fe97","f7002c8484354eceac57bc7bd62c76c1",22855176,1,4,0,1857,390,393,3
"f7002c8484354eceac57bc7bd62c76c1","96bb2b3e85a34d8b9544514e89f6fe97",22855176,1,-4,0,1858,393,390,-3
"96bb2b3e85a34d8b9544514e89f6fe97","6f8881a745ac4c358a68b92c3b4abe81",22855176,1,5,0,1859,390,394,4
"17f95d18bab743888e1736033dc3384d","6f8881a745ac4c358a68b92c3b4abe81",22855176,1,6,0,1861,389,394,5
"6f8881a745ac4c358a68b92c3b4abe81","f7002c8484354eceac57bc7bd62c76c1",22855176,1,-1,0,1862,394,393,-1
"f7002c8484354eceac57bc7bd62c76c1","44a277ea44dc4ae689fab4b82f0b4098",22855176,1,5,0,1863,393,397,4
"44a277ea44dc4ae689fab4b82f0b4098","44a277ea44dc4ae689fab4b82f0b4098",22855176,2,0,1,1864,397,397,0
"44a277ea44dc4ae689fab4b82f0b4098","0c12af0a4e7f4002852cf84b2537c161",22855176,1,-2,0,1866,397,395,-2
"0c12af0a4e7f4002852cf84b2537c161","7f544639412e40a9ba27f43b415362ab",22855176,1,-22,0,1867,395,378,-17
"7f544639412e40a9ba27f43b415362ab","df8191ec5e584c838a899c378941a566",22855176,1,26,0,1868,378,398,20
"df8191ec5e584c838a899c378941a566","66baf19b6b904b70922329068c63746d",22855176,2,-28,0,1869,398,376,-22
"66baf19b6b904b70922329068c63746d","c2fca3669923477ab966ded303dea31c",22855176,1,8,0,1870,376,383,7
"4890121ce5d74576b4632b77cfc23398","96bb2b3e85a34d8b9544514e89f6fe97",22855176,1,3,0,1872,388,390,2
"96bb2b3e85a34d8b9544514e89f6fe97","18d3b836dd804224883cc9180b60a8e1",22855176,1,-4,0,1873,390,387,-3
"18d3b836dd804224883cc9180b60a8e1","6f8881a745ac4c358a68b92c3b4abe81",22855176,1,9,0,1874,387,394,7
"17f95d18bab743888e1736033dc3384d","f7002c8484354eceac57bc7bd62c76c1",22855176,1,5,0,1876,389,393,4
"f7002c8484354eceac57bc7bd62c76c1","0c12af0a4e7f4002852cf84b2537c161",22855176,1,3,0,1877,393,395,2
"0c12af0a4e7f4002852cf84b2537c161","df8191ec5e584c838a899c378941a566",22855176,1,4,0,1878,395,398,3
"66baf19b6b904b70922329068c63746d","859e0b8d71694b12befb69ee698138f9",22855176,1,29,0,1880,376,399,23
"859e0b8d71694b12befb69ee698138f9","859e0b8d71694b12befb69ee698138f9",22855176,2,0,1,1881,399,399,0
"859e0b8d71694b12befb69ee698138f9","66baf19b6b904b70922329068c63746d",22855176,1,-29,0,1883,399,376,-23
"66baf19b6b904b70922329068c63746d","2b09a08242b54983aec7063990fb3f66",22855176,3,32,0,1884,376,400,24
"2b09a08242b54983aec7063990fb3f66","2b09a08242b54983aec7063990fb3f66",22855176,6,0,1,1885,400,400,0
"2b09a08242b54983aec7063990fb3f66","66baf19b6b904b70922329068c63746d",22855176,3,-32,0,1886,400,376,-24
"66baf19b6b904b70922329068c63746d","d6d02b6ef04e4f17805504500b8ce441",22855176,1,-4,0,1887,376,375,-1
"d6d02b6ef04e4f17805504500b8ce441","2add1669f08d4101913db15f8c23b3b7",22855176,1,60,0,1892,375,416,41
"2add1669f08d4101913db15f8c23b3b7","2b09a08242b54983aec7063990fb3f66",22855176,3,-24,0,1893,416,400,-16
"66baf19b6b904b70922329068c63746d","66baf19b6b904b70922329068c63746d",22855176,2,0,1,1899,376,376,0
"2b09a08242b54983aec7063990fb3f66","1f471b7a883a4df48211e8c6a81b59a7",22855176,1,1,0,1906,400,401,1
"1f471b7a883a4df48211e8c6a81b59a7","1f471b7a883a4df48211e8c6a81b59a7",22855176,2,0,1,1907,401,401,0
"1f471b7a883a4df48211e8c6a81b59a7","2b09a08242b54983aec7063990fb3f66",22855176,1,-1,0,1909,401,400,-1
"2b09a08242b54983aec7063990fb3f66","9de0d567bfa84fe5b77cb76f4a76a5d1",22855176,1,5,0,1911,400,404,4
"9de0d567bfa84fe5b77cb76f4a76a5d1","9de0d567bfa84fe5b77cb76f4a76a5d1",22855176,2,0,1,1912,404,404,0
"9de0d567bfa84fe5b77cb76f4a76a5d1","1157bd665ec4472fb58b751dc5099355",22855176,1,-1,0,1914,404,403,-1
"1157bd665ec4472fb58b751dc5099355","3c8a22d2f9c146ea956609e3ed4f2559",22855176,1,3,0,1915,403,405,2
"3c8a22d2f9c146ea956609e3ed4f2559","2b09a08242b54983aec7063990fb3f66",22855176,1,-7,0,1916,405,400,-5
"2b09a08242b54983aec7063990fb3f66","3c8a22d2f9c146ea956609e3ed4f2559",22855176,1,7,0,1917,400,405,5
"3c8a22d2f9c146ea956609e3ed4f2559","58fc9094275e4c49be3f4ba6d4acc0a4",22855176,1,2,0,1918,405,406,1
"58fc9094275e4c49be3f4ba6d4acc0a4","c1c1be90b2b14c1ab4a5e1ee3c241902",22855176,1,1,0,1919,406,407,1
"c1c1be90b2b14c1ab4a5e1ee3c241902","c1c1be90b2b14c1ab4a5e1ee3c241902",22855176,6,0,1,1920,407,407,0
"c1c1be90b2b14c1ab4a5e1ee3c241902","58fc9094275e4c49be3f4ba6d4acc0a4",22855176,1,-1,0,1926,407,406,-1
"58fc9094275e4c49be3f4ba6d4acc0a4","02b3a1bead9244c1ba2f857c7da8f82a",22855176,1,3,0,1927,406,408,2
"02b3a1bead9244c1ba2f857c7da8f82a","58fc9094275e4c49be3f4ba6d4acc0a4",22855176,1,-3,0,1928,408,406,-2
"58fc9094275e4c49be3f4ba6d4acc0a4","6206fc6479014bb193084c32409dc1b9",22855176,1,4,0,1929,406,409,3
"6206fc6479014bb193084c32409dc1b9","6206fc6479014bb193084c32409dc1b9",22855176,2,0,1,1930,409,409,0
"6206fc6479014bb193084c32409dc1b9","02b3a1bead9244c1ba2f857c7da8f82a",22855176,1,-1,0,1932,409,408,-1
"02b3a1bead9244c1ba2f857c7da8f82a","6a5f020451db426dacba9e2ea3fcc62a",22855176,2,3,0,1933,408,410,2
"6a5f020451db426dacba9e2ea3fcc62a","02b3a1bead9244c1ba2f857c7da8f82a",22855176,1,-3,0,1934,410,408,-2
"6a5f020451db426dacba9e2ea3fcc62a","6a5f020451db426dacba9e2ea3fcc62a",22855176,1,0,1,1936,410,410,0
"6a5f020451db426dacba9e2ea3fcc62a","33a9d248b2e44588a5b07fc1342b9bc2",22855176,1,2,0,1937,410,411,1
"33a9d248b2e44588a5b07fc1342b9bc2","c6f26bd420634f1cb7989e76fe6b16c0",22855176,1,1,0,1938,411,412,1
"c6f26bd420634f1cb7989e76fe6b16c0","c6f26bd420634f1cb7989e76fe6b16c0",22855176,6,0,1,1939,412,412,0
"c6f26bd420634f1cb7989e76fe6b16c0","2a65ee6e2ac64f6a8a55fbe5373ec763",22855176,1,1,0,1945,412,413,1
"2a65ee6e2ac64f6a8a55fbe5373ec763","2a65ee6e2ac64f6a8a55fbe5373ec763",22855176,3,0,1,1946,413,413,0
"2a65ee6e2ac64f6a8a55fbe5373ec763","33a9d248b2e44588a5b07fc1342b9bc2",22855176,1,-2,0,1949,413,411,-2
"33a9d248b2e44588a5b07fc1342b9bc2","33a9d248b2e44588a5b07fc1342b9bc2",22855176,2,0,1,1950,411,411,0
"33a9d248b2e44588a5b07fc1342b9bc2","1fd0f6dadbc14ebc965faf6122190b96",22855176,1,5,0,1952,411,415,4
"1fd0f6dadbc14ebc965faf6122190b96","1fd0f6dadbc14ebc965faf6122190b96",22855176,2,0,1,1953,415,415,0
"1fd0f6dadbc14ebc965faf6122190b96","687055dad9fc40c3982478fe33ec01bf",22855176,1,-1,0,1955,415,414,-1
"687055dad9fc40c3982478fe33ec01bf","66baf19b6b904b70922329068c63746d",22855176,1,-53,0,1956,414,376,-38
"66baf19b6b904b70922329068c63746d","b2f0d654738f48158edff28e8d3a546e",22855176,1,112,0,1957,376,449,73
"b2f0d654738f48158edff28e8d3a546e","66baf19b6b904b70922329068c63746d",22855176,1,-112,0,1959,449,376,-73
"66baf19b6b904b70922329068c63746d","2add1669f08d4101913db15f8c23b3b7",22855176,1,56,0,1960,376,416,40
"2b09a08242b54983aec7063990fb3f66","2add1669f08d4101913db15f8c23b3b7",22855176,2,24,0,1962,400,416,16
"2add1669f08d4101913db15f8c23b3b7","2add1669f08d4101913db15f8c23b3b7",22855176,1,0,1,1965,416,416,0
"2add1669f08d4101913db15f8c23b3b7","a2b4bd40cee2481ebd3fc179d6a5cd62",22855176,1,3,0,1966,416,417,1
"a2b4bd40cee2481ebd3fc179d6a5cd62","2b09a08242b54983aec7063990fb3f66",22855176,1,-27,0,1967,417,400,-17
"2b09a08242b54983aec7063990fb3f66","e34e59dce2204f228f3a84b6725df60f",22855176,1,29,0,1968,400,419,19
"e34e59dce2204f228f3a84b6725df60f","e34e59dce2204f228f3a84b6725df60f",22855176,2,0,1,1969,419,419,0
"e34e59dce2204f228f3a84b6725df60f","bec48fc2e1294c7eb3d0aca780d731b8",22855176,1,2,0,1971,419,420,1
"bec48fc2e1294c7eb3d0aca780d731b8","a2b4bd40cee2481ebd3fc179d6a5cd62",22855176,2,-4,0,1972,420,417,-3
"a2b4bd40cee2481ebd3fc179d6a5cd62","bec48fc2e1294c7eb3d0aca780d731b8",22855176,2,4,0,1973,417,420,3
"bec48fc2e1294c7eb3d0aca780d731b8","bec48fc2e1294c7eb3d0aca780d731b8",22855176,2,0,1,1974,420,420,0
"bec48fc2e1294c7eb3d0aca780d731b8","a24600b0e49245f6bdba8c893cfeddb0",22855176,1,7,0,1975,420,425,5
"a24600b0e49245f6bdba8c893cfeddb0","dbde19fcce2a4c1abdc7f685c293a23f",22855176,2,-4,0,1976,425,422,-3
"dbde19fcce2a4c1abdc7f685c293a23f","a24600b0e49245f6bdba8c893cfeddb0",22855176,3,4,0,1977,422,425,3
"a24600b0e49245f6bdba8c893cfeddb0","a24600b0e49245f6bdba8c893cfeddb0",22855176,5,0,1,1980,425,425,0
"a24600b0e49245f6bdba8c893cfeddb0","a2b4bd40cee2481ebd3fc179d6a5cd62",22855176,2,-11,0,1984,425,417,-8
"a2b4bd40cee2481ebd3fc179d6a5cd62","24cf8786024543f19b89bc20034e60d7",22855176,3,18,0,1985,417,428,11
"24cf8786024543f19b89bc20034e60d7","f2a73be2f46840b182d7bd095378004e",22855176,3,1,0,1986,428,429,1
"f2a73be2f46840b182d7bd095378004e","604551fd4266430cb860fef58fa7dd61",22855176,1,1,0,1987,429,430,1
"604551fd4266430cb860fef58fa7dd61","604551fd4266430cb860fef58fa7dd61",22855176,6,0,1,1988,430,430,0
"604551fd4266430cb860fef58fa7dd61","f2a73be2f46840b182d7bd095378004e",22855176,1,-1,0,1994,430,429,-1
"f2a73be2f46840b182d7bd095378004e","24cf8786024543f19b89bc20034e60d7",22855176,2,-1,0,1995,429,428,-1
"24cf8786024543f19b89bc20034e60d7","dce46f8904594a62a6377a3587aaa663",22855176,3,4,0,1996,428,431,3
"dce46f8904594a62a6377a3587aaa663","dce46f8904594a62a6377a3587aaa663",22855176,3,0,1,1997,431,431,0
"dce46f8904594a62a6377a3587aaa663","f2a73be2f46840b182d7bd095378004e",22855176,2,-3,0,1998,431,429,-2
"f2a73be2f46840b182d7bd095378004e","dce46f8904594a62a6377a3587aaa663",22855176,2,3,0,1999,429,431,2
"dce46f8904594a62a6377a3587aaa663","24cf8786024543f19b89bc20034e60d7",22855176,2,-4,0,2000,431,428,-3
"24cf8786024543f19b89bc20034e60d7","9b9d0a249052413c869753b99682b0ac",22855176,1,5,0,2001,428,432,4
"9b9d0a249052413c869753b99682b0ac","9b9d0a249052413c869753b99682b0ac",22855176,5,0,1,2002,432,432,0
"9b9d0a249052413c869753b99682b0ac","061c175cc90f45fbad883025394e78dd",22855176,1,1,0,2007,432,433,1
"061c175cc90f45fbad883025394e78dd","061c175cc90f45fbad883025394e78dd",22855176,6,0,1,2008,433,433,0
"061c175cc90f45fbad883025394e78dd","dce46f8904594a62a6377a3587aaa663",22855176,1,-2,0,2014,433,431,-2
"f2a73be2f46840b182d7bd095378004e","66ada10dde9f43018588f1ced9d477fc",22855176,1,7,0,2018,429,434,5
"66ada10dde9f43018588f1ced9d477fc","24cf8786024543f19b89bc20034e60d7",22855176,2,-8,0,2019,434,428,-6
"24cf8786024543f19b89bc20034e60d7","a2b4bd40cee2481ebd3fc179d6a5cd62",22855176,1,-18,0,2020,428,417,-11
"a2b4bd40cee2481ebd3fc179d6a5cd62","a2b4bd40cee2481ebd3fc179d6a5cd62",22855176,1,0,1,2021,417,417,0
"dce46f8904594a62a6377a3587aaa663","66ada10dde9f43018588f1ced9d477fc",22855176,2,4,0,2026,431,434,3
"66ada10dde9f43018588f1ced9d477fc","dce46f8904594a62a6377a3587aaa663",22855176,1,-4,0,2027,434,431,-3
"dce46f8904594a62a6377a3587aaa663","74a7f8712e5449c2bc0b43c6f90dafed",22855176,1,5,0,2028,431,435,4
"74a7f8712e5449c2bc0b43c6f90dafed","74a7f8712e5449c2bc0b43c6f90dafed",22855176,2,0,1,2029,435,435,0
"74a7f8712e5449c2bc0b43c6f90dafed","66ada10dde9f43018588f1ced9d477fc",22855176,1,-1,0,2031,435,434,-1
"66ada10dde9f43018588f1ced9d477fc","66baf19b6b904b70922329068c63746d",22855176,1,-85,0,2032,434,376,-58
"66baf19b6b904b70922329068c63746d","24cf8786024543f19b89bc20034e60d7",22855176,1,77,0,2033,376,428,52
"24cf8786024543f19b89bc20034e60d7","bf12c96466d840a69bed7020b3f18bb8",22855176,2,11,0,2034,428,436,8
"bf12c96466d840a69bed7020b3f18bb8","bf12c96466d840a69bed7020b3f18bb8",22855176,3,0,1,2035,436,436,0
"bf12c96466d840a69bed7020b3f18bb8","24cf8786024543f19b89bc20034e60d7",22855176,2,-11,0,2036,436,428,-8
"24cf8786024543f19b89bc20034e60d7","070600601c4c439288445d2f0724807d",22855176,2,14,0,2041,428,437,9
"070600601c4c439288445d2f0724807d","1823b6de7d334a7aaabc4570719af4d9",22855176,4,2,0,2042,437,439,2
"1823b6de7d334a7aaabc4570719af4d9","1823b6de7d334a7aaabc4570719af4d9",22855176,22,0,1,2043,439,439,0
"1823b6de7d334a7aaabc4570719af4d9","070600601c4c439288445d2f0724807d",22855176,1,-2,0,2045,439,437,-2
"070600601c4c439288445d2f0724807d","070600601c4c439288445d2f0724807d",22855176,2,0,1,2046,437,437,0
"1823b6de7d334a7aaabc4570719af4d9","0380cd76a7d44bc3a4da1f15e4d68f89",22855176,4,2,0,2057,439,440,1
"0380cd76a7d44bc3a4da1f15e4d68f89","070600601c4c439288445d2f0724807d",22855176,5,-4,0,2058,440,437,-3
"070600601c4c439288445d2f0724807d","0380cd76a7d44bc3a4da1f15e4d68f89",22855176,4,4,0,2059,437,440,3
"0380cd76a7d44bc3a4da1f15e4d68f89","1823b6de7d334a7aaabc4570719af4d9",22855176,1,-2,0,2060,440,439,-1
"070600601c4c439288445d2f0724807d","66baf19b6b904b70922329068c63746d",22855176,1,-91,0,2063,437,376,-61
"66baf19b6b904b70922329068c63746d","070600601c4c439288445d2f0724807d",22855176,1,91,0,2064,376,437,61
"070600601c4c439288445d2f0724807d","d6d02b6ef04e4f17805504500b8ce441",22855176,1,-95,0,2080,437,375,-62
"d6d02b6ef04e4f17805504500b8ce441","3cbcea2be0984e7dbd5a48195af10ce7",22855176,2,-284,0,2083,375,165,-210
"3cbcea2be0984e7dbd5a48195af10ce7","3cbcea2be0984e7dbd5a48195af10ce7",22855176,5,0,1,2084,165,165,0
"3cbcea2be0984e7dbd5a48195af10ce7","82e6285962b8400d9d6fc32436022a94",22855176,7,2,0,2085,165,167,2
"82e6285962b8400d9d6fc32436022a94","070600601c4c439288445d2f0724807d",22855176,3,377,0,2086,167,437,270
"0380cd76a7d44bc3a4da1f15e4d68f89","0380cd76a7d44bc3a4da1f15e4d68f89",22855176,4,0,1,2088,440,440,0
"0380cd76a7d44bc3a4da1f15e4d68f89","23b7673c8b5443108c2ef09382834a86",22855176,4,2,0,2091,440,441,1
"23b7673c8b5443108c2ef09382834a86","3cbcea2be0984e7dbd5a48195af10ce7",22855176,1,-385,0,2092,441,165,-276
"23b7673c8b5443108c2ef09382834a86","0380cd76a7d44bc3a4da1f15e4d68f89",22855176,1,-2,0,2099,441,440,-1
"23b7673c8b5443108c2ef09382834a86","23b7673c8b5443108c2ef09382834a86",22855176,3,0,1,2101,441,441,0
"23b7673c8b5443108c2ef09382834a86","901e92500aea43c79f19f1b279050668",22855176,3,2,0,2103,441,442,1
"901e92500aea43c79f19f1b279050668","001339db8ced4cf78829ebe8b145449d",22855176,1,1,0,2104,442,443,1
"001339db8ced4cf78829ebe8b145449d","001339db8ced4cf78829ebe8b145449d",22855176,3,0,1,2105,443,443,0
"001339db8ced4cf78829ebe8b145449d","452745e0366e42ae81561bfddebcc6c3",22855176,1,1,0,2108,443,444,1
"452745e0366e42ae81561bfddebcc6c3","452745e0366e42ae81561bfddebcc6c3",22855176,3,0,1,2109,444,444,0
"452745e0366e42ae81561bfddebcc6c3","901e92500aea43c79f19f1b279050668",22855176,1,-2,0,2112,444,442,-2
"901e92500aea43c79f19f1b279050668","901e92500aea43c79f19f1b279050668",22855176,1,0,1,2113,442,442,0
"901e92500aea43c79f19f1b279050668","4660ff2089114e8db82ceb26a4f329e3",22855176,2,4,0,2114,442,445,3
"4660ff2089114e8db82ceb26a4f329e3","4660ff2089114e8db82ceb26a4f329e3",22855176,2,0,1,2115,445,445,0
"4660ff2089114e8db82ceb26a4f329e3","7bd5586eb9d8484eb74a433ee7bfe499",22855176,2,2,0,2117,445,446,1
"7bd5586eb9d8484eb74a433ee7bfe499","7bd5586eb9d8484eb74a433ee7bfe499",22855176,19,0,1,2118,446,446,0
"7bd5586eb9d8484eb74a433ee7bfe499","66baf19b6b904b70922329068c63746d",22855176,1,-105,0,2136,446,376,-70
"66baf19b6b904b70922329068c63746d","3cbcea2be0984e7dbd5a48195af10ce7",22855176,1,-288,0,2137,376,165,-211
"070600601c4c439288445d2f0724807d","8a7f26e690f34dda97be16904518ca99",22855176,1,16,0,2141,437,447,10
"8a7f26e690f34dda97be16904518ca99","8a7f26e690f34dda97be16904518ca99",22855176,5,0,1,2142,447,447,0
"8a7f26e690f34dda97be16904518ca99","23b7673c8b5443108c2ef09382834a86",22855176,1,-10,0,2147,447,441,-6
"901e92500aea43c79f19f1b279050668","1823b6de7d334a7aaabc4570719af4d9",22855176,1,-6,0,2150,442,439,-3
"1823b6de7d334a7aaabc4570719af4d9","901e92500aea43c79f19f1b279050668",22855176,1,6,0,2151,439,442,3
"901e92500aea43c79f19f1b279050668","0380cd76a7d44bc3a4da1f15e4d68f89",22855176,1,-4,0,2152,442,440,-2
"070600601c4c439288445d2f0724807d","bec48fc2e1294c7eb3d0aca780d731b8",22855176,1,-28,0,2154,437,420,-17
"bec48fc2e1294c7eb3d0aca780d731b8","dbde19fcce2a4c1abdc7f685c293a23f",22855176,1,3,0,2158,420,422,2
"901e92500aea43c79f19f1b279050668","23b7673c8b5443108c2ef09382834a86",22855176,1,-2,0,2176,442,441,-1
"23b7673c8b5443108c2ef09382834a86","4660ff2089114e8db82ceb26a4f329e3",22855176,1,6,0,2177,441,445,4
"4660ff2089114e8db82ceb26a4f329e3","901e92500aea43c79f19f1b279050668",22855176,1,-4,0,2178,445,442,-3
"7bd5586eb9d8484eb74a433ee7bfe499","b2f0d654738f48158edff28e8d3a546e",22855176,1,7,0,2182,446,449,3
"b2f0d654738f48158edff28e8d3a546e","070600601c4c439288445d2f0724807d",22855176,1,-21,0,2183,449,437,-12
"070600601c4c439288445d2f0724807d","f60ee41ec635499abd48168342d32c2f",22855176,1,26,0,2184,437,453,16
"f60ee41ec635499abd48168342d32c2f","f60ee41ec635499abd48168342d32c2f",22855176,81,0,1,2185,453,453,0
"f60ee41ec635499abd48168342d32c2f","b2f0d654738f48158edff28e8d3a546e",22855176,3,-5,0,2187,453,449,-4
"b2f0d654738f48158edff28e8d3a546e","f60ee41ec635499abd48168342d32c2f",22855176,4,5,0,2188,449,453,4
"f60ee41ec635499abd48168342d32c2f","f67fbf45a5f146ed866965bc57c7c001",22855176,1,3,0,2193,453,454,1
"f67fbf45a5f146ed866965bc57c7c001","f67fbf45a5f146ed866965bc57c7c001",22855176,5,0,1,2194,454,454,0
"f67fbf45a5f146ed866965bc57c7c001","d6d02b6ef04e4f17805504500b8ce441",22855176,1,-124,0,2195,454,375,-79
"82e6285962b8400d9d6fc32436022a94","d6d02b6ef04e4f17805504500b8ce441",22855176,1,282,0,2201,167,375,208
"b2f0d654738f48158edff28e8d3a546e","f67fbf45a5f146ed866965bc57c7c001",22855176,2,8,0,2261,449,454,5
"f67fbf45a5f146ed866965bc57c7c001","d937afe49bd24a07a550dda1c1155122",22855176,1,1,0,2265,454,455,1
"d937afe49bd24a07a550dda1c1155122","d937afe49bd24a07a550dda1c1155122",22855176,2,0,1,2266,455,455,0
"d937afe49bd24a07a550dda1c1155122","3628b3f7823443d0912a339096b69943",22855176,1,1,0,2268,455,456,1
"3628b3f7823443d0912a339096b69943","3628b3f7823443d0912a339096b69943",22855176,2,0,1,2269,456,456,0
"3628b3f7823443d0912a339096b69943","9e049ee647cf43ecbcb5ed792a8e7588",22855176,1,1,0,2271,456,457,1
"9e049ee647cf43ecbcb5ed792a8e7588","9e049ee647cf43ecbcb5ed792a8e7588",22855176,2,0,1,2272,457,457,0
"9e049ee647cf43ecbcb5ed792a8e7588","5256a214faaf410b93f76cea06428334",22855176,1,1,0,2274,457,458,1
"5256a214faaf410b93f76cea06428334","5256a214faaf410b93f76cea06428334",22855176,2,0,1,2275,458,458,0
"5256a214faaf410b93f76cea06428334","25c32b120fce40fa9b6c85133aeb4716",22855176,1,1,0,2277,458,459,1
"25c32b120fce40fa9b6c85133aeb4716","25c32b120fce40fa9b6c85133aeb4716",22855176,5,0,1,2278,459,459,0
"25c32b120fce40fa9b6c85133aeb4716","11bc14f2204949008b7d511b933363c1",22855176,1,1,0,2283,459,460,1
"11bc14f2204949008b7d511b933363c1","11bc14f2204949008b7d511b933363c1",22855176,2,0,1,2284,460,460,0
"11bc14f2204949008b7d511b933363c1","4a29443515bb404cb8924e1c60a63b73",22855176,1,-248,0,2286,460,285,-175
"4a29443515bb404cb8924e1c60a63b73","6a9a3b5bde4a48daa896fe8c06eca56f",22855176,2,5,0,2287,285,289,4
"6a9a3b5bde4a48daa896fe8c06eca56f","6a9a3b5bde4a48daa896fe8c06eca56f",22855176,1,0,1,2288,289,289,0
"6a9a3b5bde4a48daa896fe8c06eca56f","21592f2a9e9c4b2f8c66ec5dbcbf6a2b",22855176,1,9,0,2289,289,296,7
"7646a919d7e64fa990bca9b024ff089d","21592f2a9e9c4b2f8c66ec5dbcbf6a2b",22855176,1,-3,0,2292,298,296,-2
"21592f2a9e9c4b2f8c66ec5dbcbf6a2b","208c9b2796c944db8dacaa96082520ea",22855176,1,-11,0,2293,296,288,-8
"208c9b2796c944db8dacaa96082520ea","2c5bb2cbd0014420ad8c95d40e38efd1",22855176,1,20,0,2294,288,303,15
"2c5bb2cbd0014420ad8c95d40e38efd1","4a29443515bb404cb8924e1c60a63b73",22855176,1,-23,0,2295,303,285,-18
"869e967078f04da18dd0b0b9389a7424","4a29443515bb404cb8924e1c60a63b73",22855176,1,-10,0,2298,293,285,-8
"4a29443515bb404cb8924e1c60a63b73","f67fbf45a5f146ed866965bc57c7c001",22855176,1,242,0,2299,285,454,169
"f67fbf45a5f146ed866965bc57c7c001","42de338840a34d15adb66e7b14fb9d2c",22855176,1,7,0,2301,454,461,7
"42de338840a34d15adb66e7b14fb9d2c","42de338840a34d15adb66e7b14fb9d2c",22855176,1,0,1,2302,461,461,0
"42de338840a34d15adb66e7b14fb9d2c","9da37c6210b1416b8079c274f70bf600",22855176,1,1,0,2303,461,462,1
"9da37c6210b1416b8079c274f70bf600","9da37c6210b1416b8079c274f70bf600",22855176,2,0,1,2304,462,462,0
"9da37c6210b1416b8079c274f70bf600","519119f1deac45ff9ab4f13529be5c6e",22855176,1,1,0,2306,462,463,1
"519119f1deac45ff9ab4f13529be5c6e","519119f1deac45ff9ab4f13529be5c6e",22855176,2,0,1,2307,463,463,0
"519119f1deac45ff9ab4f13529be5c6e","f67fbf45a5f146ed866965bc57c7c001",22855176,1,-9,0,2309,463,454,-9
"f67fbf45a5f146ed866965bc57c7c001","c5df9f40ec14463b9dcfdc73df3e9285",22855176,3,12,0,2310,454,464,10
"c5df9f40ec14463b9dcfdc73df3e9285","c5df9f40ec14463b9dcfdc73df3e9285",22855176,12,0,1,2311,464,464,0
"c5df9f40ec14463b9dcfdc73df3e9285","83d42d95cd844fc093fc09cee250edb8",22855176,5,3,0,2315,464,465,1
"83d42d95cd844fc093fc09cee250edb8","c5df9f40ec14463b9dcfdc73df3e9285",22855176,5,-3,0,2316,465,464,-1
"83d42d95cd844fc093fc09cee250edb8","83d42d95cd844fc093fc09cee250edb8",22855176,6,0,1,2318,465,465,0
"83d42d95cd844fc093fc09cee250edb8","9428d8bd9c5a47b2a235b254e5e27ded",22855176,1,-19,0,2325,465,452,-13
"9428d8bd9c5a47b2a235b254e5e27ded","b2f0d654738f48158edff28e8d3a546e",22855176,2,-4,0,2326,452,449,-3
"f60ee41ec635499abd48168342d32c2f","9428d8bd9c5a47b2a235b254e5e27ded",22855176,1,-1,0,2335,453,452,-1
"f60ee41ec635499abd48168342d32c2f","c5df9f40ec14463b9dcfdc73df3e9285",22855176,1,15,0,2345,453,464,11
"c5df9f40ec14463b9dcfdc73df3e9285","b2f0d654738f48158edff28e8d3a546e",22855176,1,-20,0,2348,464,449,-15
"b2f0d654738f48158edff28e8d3a546e","9428d8bd9c5a47b2a235b254e5e27ded",22855176,1,4,0,2349,449,452,3
"9428d8bd9c5a47b2a235b254e5e27ded","f60ee41ec635499abd48168342d32c2f",22855176,1,1,0,2350,452,453,1
"c5df9f40ec14463b9dcfdc73df3e9285","f67fbf45a5f146ed866965bc57c7c001",22855176,1,-12,0,2363,464,454,-10
"c5df9f40ec14463b9dcfdc73df3e9285","d6d02b6ef04e4f17805504500b8ce441",22855176,1,-136,0,2371,464,375,-89
"d6d02b6ef04e4f17805504500b8ce441","83d42d95cd844fc093fc09cee250edb8",22855176,1,139,0,2374,375,465,90
"c5df9f40ec14463b9dcfdc73df3e9285","37319e88176d4aefa91d7a9980dbae91",22855176,1,-489,0,2381,464,112,-352
"e20db35ced8544ddac5bc3839145e463","3cbcea2be0984e7dbd5a48195af10ce7",22855176,1,93,0,2383,91,165,74
"82e6285962b8400d9d6fc32436022a94","3cbcea2be0984e7dbd5a48195af10ce7",22855176,3,-2,0,2386,167,165,-2
"82e6285962b8400d9d6fc32436022a94","a23ae40d7a9e4ee4828cc06415a3218c",22855176,1,-193,0,2388,167,27,-140
"a23ae40d7a9e4ee4828cc06415a3218c","b7719e26494940efa49512aedd0aac79",22855176,1,-9,0,2389,27,20,-7
"b7719e26494940efa49512aedd0aac79","d4f45188d3c84a02ba08454e6403a818",22855176,1,5,0,2390,20,24,4
"d4f45188d3c84a02ba08454e6403a818","d4c3b003e8274e429d2fa688d73fde6d",22855176,2,-2,0,2391,24,22,-2
"b613861cecf84ffcab01afb23f660475","b613861cecf84ffcab01afb23f660475",22855232,3,0,1,1,1,1,0
"b613861cecf84ffcab01afb23f660475","e2911e79efc2420eac45d9f671463d4b",22855232,2,3,0,4,1,2,1
"e2911e79efc2420eac45d9f671463d4b","b613861cecf84ffcab01afb23f660475",22855232,1,-3,0,5,2,1,-1
"e2911e79efc2420eac45d9f671463d4b","e2911e79efc2420eac45d9f671463d4b",22855232,1,0,1,7,2,2,0
"e2911e79efc2420eac45d9f671463d4b","519d1b8c59404d67b54e96c5c8a830b2",22855232,1,1,0,8,2,3,1
"519d1b8c59404d67b54e96c5c8a830b2","519d1b8c59404d67b54e96c5c8a830b2",22855232,1,0,1,9,3,3,0
"519d1b8c59404d67b54e96c5c8a830b2","531db53f81f646edb0cdcfe0085b03b7",22855232,1,1,0,10,3,4,1
"531db53f81f646edb0cdcfe0085b03b7","531db53f81f646edb0cdcfe0085b03b7",22855232,1,0,1,11,4,4,0
"531db53f81f646edb0cdcfe0085b03b7","4f5f94b2f95141e0a9d53a61da2276da",22855232,1,1,0,12,4,5,1
"4f5f94b2f95141e0a9d53a61da2276da","4f5f94b2f95141e0a9d53a61da2276da",22855232,1,0,1,13,5,5,0
"4f5f94b2f95141e0a9d53a61da2276da","6d541c89590949f99af293c4f2333f67",22855232,1,1,0,14,5,6,1
"6d541c89590949f99af293c4f2333f67","6d541c89590949f99af293c4f2333f67",22855232,1,0,1,15,6,6,0
"6d541c89590949f99af293c4f2333f67","dd5cf0b9fe4c4f1d8f5ff8e4c04879cb",22855232,1,1,0,16,6,7,1
"dd5cf0b9fe4c4f1d8f5ff8e4c04879cb","dd5cf0b9fe4c4f1d8f5ff8e4c04879cb",22855232,1,0,1,17,7,7,0
"dd5cf0b9fe4c4f1d8f5ff8e4c04879cb","f96261861edc426abe2248be4f0a709a",22855232,1,1,0,18,7,8,1
"f96261861edc426abe2248be4f0a709a","f96261861edc426abe2248be4f0a709a",22855232,4,0,1,19,8,8,0
"f96261861edc426abe2248be4f0a709a","66b5e16f4f75454fb5b8172079f0fa83",22855232,1,1,0,23,8,9,1
"66b5e16f4f75454fb5b8172079f0fa83","66b5e16f4f75454fb5b8172079f0fa83",22855232,1,0,1,24,9,9,0
"66b5e16f4f75454fb5b8172079f0fa83","0680571d4698477995e41842c36a54b2",22855232,1,1,0,25,9,10,1
"0680571d4698477995e41842c36a54b2","0680571d4698477995e41842c36a54b2",22855232,1,0,1,26,10,10,0
"0680571d4698477995e41842c36a54b2","9112f2bffece48e08c6d2287be204085",22855232,1,1,0,27,10,11,1
"9112f2bffece48e08c6d2287be204085","9112f2bffece48e08c6d2287be204085",22855232,6,0,1,28,11,11,0
"9112f2bffece48e08c6d2287be204085","56586aa865414f538729c7f7735d2bc6",22855232,1,3,0,34,11,12,1
"56586aa865414f538729c7f7735d2bc6","e2911e79efc2420eac45d9f671463d4b",22855232,1,-12,0,35,12,2,-10
"e2911e79efc2420eac45d9f671463d4b","56586aa865414f538729c7f7735d2bc6",22855232,1,12,0,36,2,12,10
"56586aa865414f538729c7f7735d2bc6","56586aa865414f538729c7f7735d2bc6",22855232,1,0,1,37,12,12,0
"56586aa865414f538729c7f7735d2bc6","b7f2b31585d94eb3bf86376714aa7070",22855232,2,2,0,38,12,13,1
"b7f2b31585d94eb3bf86376714aa7070","56586aa865414f538729c7f7735d2bc6",22855232,1,-2,0,39,13,12,-1
"b7f2b31585d94eb3bf86376714aa7070","b7f2b31585d94eb3bf86376714aa7070",22855232,2,0,1,41,13,13,0
"b7f2b31585d94eb3bf86376714aa7070","3f1c815879794b929260d224becaff7e",22855232,1,2,0,43,13,14,1
"3f1c815879794b929260d224becaff7e","81c864a886d54a6b8ff85f7d736f4f95",22855232,1,2,0,44,14,15,1
"81c864a886d54a6b8ff85f7d736f4f95","5c5ceeee4562457ba6d41515aeebfbb1",22855232,1,4,0,45,15,17,2
"5c5ceeee4562457ba6d41515aeebfbb1","5c5ceeee4562457ba6d41515aeebfbb1",22855232,1,0,1,46,17,17,0
"5c5ceeee4562457ba6d41515aeebfbb1","56586aa865414f538729c7f7735d2bc6",22855232,1,-10,0,47,17,12,-5
"56586aa865414f538729c7f7735d2bc6","9afd71a5298d4333b6849dfce1b9422c",22855232,1,13,0,48,12,18,6
"9afd71a5298d4333b6849dfce1b9422c","9afd71a5298d4333b6849dfce1b9422c",22855232,4,0,1,49,18,18,0
"9afd71a5298d4333b6849dfce1b9422c","b7719e26494940efa49512aedd0aac79",22855232,1,4,0,53,18,20,2
"b7719e26494940efa49512aedd0aac79","d4f45188d3c84a02ba08454e6403a818",22855232,1,5,0,54,20,24,4
"d4f45188d3c84a02ba08454e6403a818","d4c3b003e8274e429d2fa688d73fde6d",22855232,1,-2,0,55,24,22,-2
"d4c3b003e8274e429d2fa688d73fde6d","d4c3b003e8274e429d2fa688d73fde6d",22855232,5,0,1,56,22,22,0
"d4c3b003e8274e429d2fa688d73fde6d","b7719e26494940efa49512aedd0aac79",22855232,1,-3,0,61,22,20,-2
"b7719e26494940efa49512aedd0aac79","afbf7250b99d47bea07172749483ca97",22855232,2,12,0,62,20,28,8
"afbf7250b99d47bea07172749483ca97","b7719e26494940efa49512aedd0aac79",22855232,1,-12,0,63,28,20,-8
"afbf7250b99d47bea07172749483ca97","4e51676dc72045d99c19b9fa7b22f8bc",22855232,1,3,0,65,28,29,1
"4e51676dc72045d99c19b9fa7b22f8bc","4e51676dc72045d99c19b9fa7b22f8bc",22855232,1,0,1,66,29,29,0
"4e51676dc72045d99c19b9fa7b22f8bc","51970cfa30e643e894e66ae85c8024cc",22855232,1,3,0,67,29,31,2
"51970cfa30e643e894e66ae85c8024cc","4e51676dc72045d99c19b9fa7b22f8bc",22855232,1,-3,0,68,31,29,-2
"4e51676dc72045d99c19b9fa7b22f8bc","c33c17be71ae4d588da7369472e5bb1b",22855232,1,9,0,69,29,34,5
"c33c17be71ae4d588da7369472e5bb1b","c33c17be71ae4d588da7369472e5bb1b",22855232,1,0,1,70,34,34,0
"c33c17be71ae4d588da7369472e5bb1b","93679be414554a11b1893002f2229a93",22855232,1,3,0,71,34,35,1
"93679be414554a11b1893002f2229a93","93679be414554a11b1893002f2229a93",22855232,1,0,1,72,35,35,0
"93679be414554a11b1893002f2229a93","7040a13096d746ac84b8fac8d9752058",22855232,1,3,0,73,35,36,1
"7040a13096d746ac84b8fac8d9752058","7040a13096d746ac84b8fac8d9752058",22855232,1,0,1,74,36,36,0
"7040a13096d746ac84b8fac8d9752058","9a0dc646f934470daf08c4b56ccf73db",22855232,1,3,0,75,36,37,1
"9a0dc646f934470daf08c4b56ccf73db","9a0dc646f934470daf08c4b56ccf73db",22855232,1,0,1,76,37,37,0
"9a0dc646f934470daf08c4b56ccf73db","fc0e049d56024bc9a02c9a9c435c3df7",22855232,1,3,0,77,37,38,1
"fc0e049d56024bc9a02c9a9c435c3df7","fc0e049d56024bc9a02c9a9c435c3df7",22855232,3,0,1,78,38,38,0
"fc0e049d56024bc9a02c9a9c435c3df7","67a089198fcb4e1c8f2385786c2b296f",22855232,1,4,0,81,38,39,1
"67a089198fcb4e1c8f2385786c2b296f","67a089198fcb4e1c8f2385786c2b296f",22855232,1,0,1,82,39,39,0
"67a089198fcb4e1c8f2385786c2b296f","64d48c6c9c7940639a932219a6c87198",22855232,1,1,0,83,39,40,1
"64d48c6c9c7940639a932219a6c87198","64d48c6c9c7940639a932219a6c87198",22855232,1,0,1,84,40,40,0
"64d48c6c9c7940639a932219a6c87198","67a089198fcb4e1c8f2385786c2b296f",22855232,1,-1,0,85,40,39,-1
"67a089198fcb4e1c8f2385786c2b296f","b534b89233134e30a9b5645138bfa9ee",22855232,1,4,0,86,39,41,2
"b534b89233134e30a9b5645138bfa9ee","0e37b720d23b4e7f8b313e79313fd107",22855232,1,3,0,87,41,44,3
"0e37b720d23b4e7f8b313e79313fd107","0e37b720d23b4e7f8b313e79313fd107",22855232,1,0,1,88,44,44,0
"0e37b720d23b4e7f8b313e79313fd107","6875d67fdd5f48168b62719df449bebd",22855232,1,1,0,89,44,45,1
"6875d67fdd5f48168b62719df449bebd","6875d67fdd5f48168b62719df449bebd",22855232,1,0,1,90,45,45,0
"6875d67fdd5f48168b62719df449bebd","6e13d61a7bdb44bca949c9f86fab3be5",22855232,1,3,0,91,45,47,2
"6e13d61a7bdb44bca949c9f86fab3be5","b534b89233134e30a9b5645138bfa9ee",22855232,1,-7,0,92,47,41,-6
"b534b89233134e30a9b5645138bfa9ee","6e13d61a7bdb44bca949c9f86fab3be5",22855232,1,7,0,93,41,47,6
"195f78799f984cc2b06c48dfe36be751","6e13d61a7bdb44bca949c9f86fab3be5",22855232,1,-2,0,100,49,47,-2
"6e13d61a7bdb44bca949c9f86fab3be5","6e13d61a7bdb44bca949c9f86fab3be5",22855232,2,0,1,101,47,47,0
"6e13d61a7bdb44bca949c9f86fab3be5","195f78799f984cc2b06c48dfe36be751",22855232,2,2,0,103,47,49,2
"195f78799f984cc2b06c48dfe36be751","195f78799f984cc2b06c48dfe36be751",22855232,7,0,1,104,49,49,0
"195f78799f984cc2b06c48dfe36be751","d0c74f735e024943943e40333d6d337f",22855232,1,3,0,106,49,51,2
"d0c74f735e024943943e40333d6d337f","d9c8d8c444a64dadbbb508652c721e17",22855232,1,-6,0,107,51,46,-5
"d9c8d8c444a64dadbbb508652c721e17","d0c74f735e024943943e40333d6d337f",22855232,1,6,0,108,46,51,5
"d0c74f735e024943943e40333d6d337f","983f8ff320594b279a7f4a6fe132f9c5",22855232,1,2,0,109,51,53,2
"983f8ff320594b279a7f4a6fe132f9c5","983f8ff320594b279a7f4a6fe132f9c5",22855232,2,0,1,110,53,53,0
"983f8ff320594b279a7f4a6fe132f9c5","35adfa5d923046aebabfefd98f35ff05",22855232,1,1,0,112,53,54,1
"35adfa5d923046aebabfefd98f35ff05","35adfa5d923046aebabfefd98f35ff05",22855232,5,0,1,113,54,54,0
"35adfa5d923046aebabfefd98f35ff05","b6f8a98476224da1b40e555ececc7ed8",22855232,1,1,0,118,54,55,1
"b6f8a98476224da1b40e555ececc7ed8","b6f8a98476224da1b40e555ececc7ed8",22855232,2,0,1,119,55,55,0
"b6f8a98476224da1b40e555ececc7ed8","d0c74f735e024943943e40333d6d337f",22855232,1,-4,0,121,55,51,-4
"d0c74f735e024943943e40333d6d337f","86e22cb5fe0e4b47a9489ecddf7ed78f",22855232,1,5,0,122,51,56,5
"86e22cb5fe0e4b47a9489ecddf7ed78f","86e22cb5fe0e4b47a9489ecddf7ed78f",22855232,5,0,1,123,56,56,0
"86e22cb5fe0e4b47a9489ecddf7ed78f","f924752d8a1149668870b1e7698486f7",22855232,1,-6,0,128,56,50,-6
"f924752d8a1149668870b1e7698486f7","78f30e4dcac84e3cbea8b2cc6e0d62b3",22855232,1,10,0,129,50,59,9
"78f30e4dcac84e3cbea8b2cc6e0d62b3","a1f2f12debe5432fb7a70bcd12bacfb9",22855232,1,-1,0,130,59,58,-1
"a1f2f12debe5432fb7a70bcd12bacfb9","a1f2f12debe5432fb7a70bcd12bacfb9",22855232,33,0,1,131,58,58,0
"a1f2f12debe5432fb7a70bcd12bacfb9","78f30e4dcac84e3cbea8b2cc6e0d62b3",22855232,1,1,0,164,58,59,1
"78f30e4dcac84e3cbea8b2cc6e0d62b3","78f30e4dcac84e3cbea8b2cc6e0d62b3",22855232,9,0,1,165,59,59,0
"78f30e4dcac84e3cbea8b2cc6e0d62b3","bc42d26810654ea9a1df1efe1e58c7d5",22855232,1,5,0,174,59,63,4
"bc42d26810654ea9a1df1efe1e58c7d5","a0a418b8540d479fa6e0f653b701da8b",22855232,2,1,0,175,63,64,1
"a0a418b8540d479fa6e0f653b701da8b","12aa6e1672ac4e7aa6449a7a8609cd72",22855232,1,-8,0,176,64,57,-7
"12aa6e1672ac4e7aa6449a7a8609cd72","4c943503763e4e349906eea3ed3c8e86",22855232,1,5,0,177,57,61,4
"4c943503763e4e349906eea3ed3c8e86","4c943503763e4e349906eea3ed3c8e86",22855232,1,0,1,178,61,61,0
"4c943503763e4e349906eea3ed3c8e86","bc42d26810654ea9a1df1efe1e58c7d5",22855232,1,2,0,179,61,63,2
"bc42d26810654ea9a1df1efe1e58c7d5","bc42d26810654ea9a1df1efe1e58c7d5",22855232,3,0,1,180,63,63,0
"a0a418b8540d479fa6e0f653b701da8b","a0a418b8540d479fa6e0f653b701da8b",22855232,3,0,1,184,64,64,0
"a0a418b8540d479fa6e0f653b701da8b","309ccf3cc4fe429d9bfbaef53d3fa479",22855232,1,-4,0,187,64,60,-4
"309ccf3cc4fe429d9bfbaef53d3fa479","d646286c8051419bbc2e31dd1db55ca8",22855232,1,10,0,188,60,67,7
"d646286c8051419bbc2e31dd1db55ca8","b534b89233134e30a9b5645138bfa9ee",22855232,1,-33,0,189,67,41,-26
"b534b89233134e30a9b5645138bfa9ee","267f883678b24aed855fde42524975d9",22855232,1,37,0,190,41,71,30
"267f883678b24aed855fde42524975d9","267f883678b24aed855fde42524975d9",22855232,1,0,1,191,71,71,0
"267f883678b24aed855fde42524975d9","88fff56d0342490dbef9040750a20f6c",22855232,1,1,0,192,71,72,1
"88fff56d0342490dbef9040750a20f6c","88fff56d0342490dbef9040750a20f6c",22855232,1,0,1,193,72,72,0
"88fff56d0342490dbef9040750a20f6c","adb17b12b66c4a49a85fd34322f7df70",22855232,1,1,0,194,72,73,1
"adb17b12b66c4a49a85fd34322f7df70","adb17b12b66c4a49a85fd34322f7df70",22855232,1,0,1,195,73,73,0
"adb17b12b66c4a49a85fd34322f7df70","a2becd407db34b189200a32546d9d569",22855232,1,3,0,196,73,75,2
"a2becd407db34b189200a32546d9d569","d646286c8051419bbc2e31dd1db55ca8",22855232,1,-9,0,197,75,67,-8
"d646286c8051419bbc2e31dd1db55ca8","a2becd407db34b189200a32546d9d569",22855232,1,9,0,198,67,75,8
"a2becd407db34b189200a32546d9d569","58c22b011d0f4c2ea6d13615edbb9eeb",22855232,3,2,0,199,75,77,2
"58c22b011d0f4c2ea6d13615edbb9eeb","58c22b011d0f4c2ea6d13615edbb9eeb",22855232,6,0,1,200,77,77,0
"58c22b011d0f4c2ea6d13615edbb9eeb","a2becd407db34b189200a32546d9d569",22855232,2,-2,0,202,77,75,-2
"a2becd407db34b189200a32546d9d569","a2becd407db34b189200a32546d9d569",22855232,8,0,1,203,75,75,0
"58c22b011d0f4c2ea6d13615edbb9eeb","dd76e1861dc9461c830888729d091ee0",22855232,1,1,0,218,77,78,1
"dd76e1861dc9461c830888729d091ee0","dd76e1861dc9461c830888729d091ee0",22855232,8,0,1,219,78,78,0
"dd76e1861dc9461c830888729d091ee0","a2becd407db34b189200a32546d9d569",22855232,1,-3,0,227,78,75,-3
"a2becd407db34b189200a32546d9d569","cd1d828f1a694b87913a7ea66c23803e",22855232,1,4,0,228,75,79,4
"cd1d828f1a694b87913a7ea66c23803e","cd1d828f1a694b87913a7ea66c23803e",22855232,2,0,1,229,79,79,0
"cd1d828f1a694b87913a7ea66c23803e","9176a3c2b4d2465fa8b0c67096c2a97e",22855232,1,1,0,231,79,80,1
"9176a3c2b4d2465fa8b0c67096c2a97e","9176a3c2b4d2465fa8b0c67096c2a97e",22855232,11,0,1,232,80,80,0
"9176a3c2b4d2465fa8b0c67096c2a97e","f8ec6445f7194e25b9101d4fbcb07a18",22855232,1,1,0,243,80,81,1
"f8ec6445f7194e25b9101d4fbcb07a18","f8ec6445f7194e25b9101d4fbcb07a18",22855232,5,0,1,244,81,81,0
"f8ec6445f7194e25b9101d4fbcb07a18","140d5b27b8574befad82c0a013b59dfa",22855232,1,-7,0,249,81,74,-7
"140d5b27b8574befad82c0a013b59dfa","d18a9ea32855445f8736581f5cb119ce",22855232,1,9,0,250,74,82,8
"d18a9ea32855445f8736581f5cb119ce","f564483cbd7a407681aa2fcca518cf5f",22855232,1,4,0,251,82,85,3
"f564483cbd7a407681aa2fcca518cf5f","f564483cbd7a407681aa2fcca518cf5f",22855232,1,0,1,252,85,85,0
"f564483cbd7a407681aa2fcca518cf5f","18fd01350bd5434ca636d59a599d768a",22855232,1,1,0,253,85,86,1
"18fd01350bd5434ca636d59a599d768a","18fd01350bd5434ca636d59a599d768a",22855232,9,0,1,254,86,86,0
"18fd01350bd5434ca636d59a599d768a","ae5ac430ea254e708a6f5deaaf7464ae",22855232,1,-2,0,263,86,84,-2
"ae5ac430ea254e708a6f5deaaf7464ae","6a9f0ef185fb47f0937e29daa1c71ed5",22855232,1,7,0,264,84,90,6
"6a9f0ef185fb47f0937e29daa1c71ed5","c681290961c94c4caf23b529d1ae6b9a",22855232,1,-2,0,265,90,88,-2
"c681290961c94c4caf23b529d1ae6b9a","c681290961c94c4caf23b529d1ae6b9a",22855232,1,0,1,266,88,88,0
"c681290961c94c4caf23b529d1ae6b9a","6a9f0ef185fb47f0937e29daa1c71ed5",22855232,1,2,0,267,88,90,2
"6a9f0ef185fb47f0937e29daa1c71ed5","6a9f0ef185fb47f0937e29daa1c71ed5",22855232,3,0,1,268,90,90,0
"6a9f0ef185fb47f0937e29daa1c71ed5","d646286c8051419bbc2e31dd1db55ca8",22855232,1,-27,0,271,90,67,-23
"d646286c8051419bbc2e31dd1db55ca8","e20db35ced8544ddac5bc3839145e463",22855232,1,30,0,272,67,91,24
"e20db35ced8544ddac5bc3839145e463","1febb706d7a34005ae8711ed49c76e64",22855232,1,3,0,273,91,94,3
"1febb706d7a34005ae8711ed49c76e64","1febb706d7a34005ae8711ed49c76e64",22855232,2,0,1,274,94,94,0
"1febb706d7a34005ae8711ed49c76e64","8f73ba6f5a0042f2850356ac38ac6f24",22855232,1,1,0,276,94,95,1
"8f73ba6f5a0042f2850356ac38ac6f24","8f73ba6f5a0042f2850356ac38ac6f24",22855232,5,0,1,277,95,95,0
"8f73ba6f5a0042f2850356ac38ac6f24","e2260b86653c46d7b14a41fb419dbf8c",22855232,1,1,0,282,95,96,1
"e2260b86653c46d7b14a41fb419dbf8c","e2260b86653c46d7b14a41fb419dbf8c",22855232,2,0,1,283,96,96,0
"e2260b86653c46d7b14a41fb419dbf8c","35eb641ad1d845bbba54915bce75a962",22855232,1,1,0,285,96,97,1
"35eb641ad1d845bbba54915bce75a962","35eb641ad1d845bbba54915bce75a962",22855232,2,0,1,286,97,97,0
"35eb641ad1d845bbba54915bce75a962","08be90ffbeea4795a138cd42ed8db56f",22855232,1,1,0,288,97,98,1
"08be90ffbeea4795a138cd42ed8db56f","08be90ffbeea4795a138cd42ed8db56f",22855232,5,0,1,289,98,98,0
"08be90ffbeea4795a138cd42ed8db56f","3007433c8f584dcbb5ac159c1c5f2be3",22855232,1,1,0,294,98,99,1
"3007433c8f584dcbb5ac159c1c5f2be3","3007433c8f584dcbb5ac159c1c5f2be3",22855232,2,0,1,295,99,99,0
"3007433c8f584dcbb5ac159c1c5f2be3","00ae5f0c51874a73a41ebea838d95682",22855232,1,3,0,297,99,101,2
"00ae5f0c51874a73a41ebea838d95682","e20db35ced8544ddac5bc3839145e463",22855232,2,-11,0,298,101,91,-10
"e20db35ced8544ddac5bc3839145e463","d391c8b6e56a43a7b654e9dee02d904b",22855232,2,13,0,299,91,103,12
"d391c8b6e56a43a7b654e9dee02d904b","00ae5f0c51874a73a41ebea838d95682",22855232,2,-2,0,300,103,101,-2
"00ae5f0c51874a73a41ebea838d95682","d391c8b6e56a43a7b654e9dee02d904b",22855232,1,2,0,301,101,103,2
"d391c8b6e56a43a7b654e9dee02d904b","d391c8b6e56a43a7b654e9dee02d904b",22855232,16,0,1,302,103,103,0
"00ae5f0c51874a73a41ebea838d95682","00ae5f0c51874a73a41ebea838d95682",22855232,2,0,1,319,101,101,0
"00ae5f0c51874a73a41ebea838d95682","6111116566fc4fd9abba409322bea245",22855232,1,3,0,321,101,104,3
"6111116566fc4fd9abba409322bea245","6111116566fc4fd9abba409322bea245",22855232,2,0,1,322,104,104,0
"6111116566fc4fd9abba409322bea245","00ae5f0c51874a73a41ebea838d95682",22855232,1,-3,0,324,104,101,-3
"00ae5f0c51874a73a41ebea838d95682","a81b2235cb9c499eb9ea8ee0a8dd9725",22855232,1,4,0,325,101,105,4
"a81b2235cb9c499eb9ea8ee0a8dd9725","a81b2235cb9c499eb9ea8ee0a8dd9725",22855232,2,0,1,326,105,105,0
"a81b2235cb9c499eb9ea8ee0a8dd9725","00ae5f0c51874a73a41ebea838d95682",22855232,1,-4,0,328,105,101,-4
"00ae5f0c51874a73a41ebea838d95682","2d4e0ab0ef3b4d73b82c72d4621a7579",22855232,1,5,0,329,101,106,5
"2d4e0ab0ef3b4d73b82c72d4621a7579","2d4e0ab0ef3b4d73b82c72d4621a7579",22855232,2,0,1,330,106,106,0
"2d4e0ab0ef3b4d73b82c72d4621a7579","8bdebf492ebd4e62b0d522e8ab5e5197",22855232,1,1,0,332,106,107,1
"8bdebf492ebd4e62b0d522e8ab5e5197","8bdebf492ebd4e62b0d522e8ab5e5197",22855232,5,0,1,333,107,107,0
"8bdebf492ebd4e62b0d522e8ab5e5197","73039f8c1eb9409cb4caee2cf968001e",22855232,1,-7,0,338,107,100,-7
"73039f8c1eb9409cb4caee2cf968001e","4280927ec4d643238aa49c32f9e06c6c",22855232,1,10,0,339,100,109,9
"4280927ec4d643238aa49c32f9e06c6c","4280927ec4d643238aa49c32f9e06c6c",22855232,3,0,1,340,109,109,0
"4280927ec4d643238aa49c32f9e06c6c","fc44e6a5f7654430af1227838224dceb",22855232,1,2,0,341,109,111,2
"fc44e6a5f7654430af1227838224dceb","fc44e6a5f7654430af1227838224dceb",22855232,2,0,1,342,111,111,0
"fc44e6a5f7654430af1227838224dceb","a9ae0a3c070d455bb4369a8996313336",22855232,1,4,0,344,111,114,3
"a9ae0a3c070d455bb4369a8996313336","08111f75e22d409998cf8b85bd431f0a",22855232,1,-7,0,345,114,108,-6
"08111f75e22d409998cf8b85bd431f0a","a9ae0a3c070d455bb4369a8996313336",22855232,4,7,0,346,108,114,6
"a9ae0a3c070d455bb4369a8996313336","e20db35ced8544ddac5bc3839145e463",22855232,1,-26,0,347,114,91,-23
"e20db35ced8544ddac5bc3839145e463","00ae5f0c51874a73a41ebea838d95682",22855232,1,11,0,348,91,101,10
"d391c8b6e56a43a7b654e9dee02d904b","4280927ec4d643238aa49c32f9e06c6c",22855232,1,7,0,351,103,109,6
"4280927ec4d643238aa49c32f9e06c6c","73039f8c1eb9409cb4caee2cf968001e",22855232,1,-10,0,352,109,100,-9
"73039f8c1eb9409cb4caee2cf968001e","08111f75e22d409998cf8b85bd431f0a",22855232,1,9,0,353,100,108,8
"a9ae0a3c070d455bb4369a8996313336","71cec822bcff4f30a20e75dc63ef7b65",22855232,1,2,0,355,114,116,2
"71cec822bcff4f30a20e75dc63ef7b65","71cec822bcff4f30a20e75dc63ef7b65",22855232,3,0,1,356,116,116,0
"71cec822bcff4f30a20e75dc63ef7b65","62bff51286ef4f348717a3cf6fe2318f",22855232,1,5,0,359,116,120,4
"62bff51286ef4f348717a3cf6fe2318f","37319e88176d4aefa91d7a9980dbae91",22855232,1,-9,0,360,120,112,-8
"37319e88176d4aefa91d7a9980dbae91","b1cd0e7dc3ad4a8eb91a4bfdbeb025b0",22855232,1,7,0,361,112,118,6
"b1cd0e7dc3ad4a8eb91a4bfdbeb025b0","b1cd0e7dc3ad4a8eb91a4bfdbeb025b0",22855232,2,0,1,362,118,118,0
"b1cd0e7dc3ad4a8eb91a4bfdbeb025b0","62bff51286ef4f348717a3cf6fe2318f",22855232,1,2,0,363,118,120,2
"62bff51286ef4f348717a3cf6fe2318f","62bff51286ef4f348717a3cf6fe2318f",22855232,3,0,1,364,120,120,0
"62bff51286ef4f348717a3cf6fe2318f","b1cd0e7dc3ad4a8eb91a4bfdbeb025b0",22855232,1,-2,0,367,120,118,-2
"b1cd0e7dc3ad4a8eb91a4bfdbeb025b0","779f9ddd1fd14d1e9e69f72219a1fdbd",22855232,1,5,0,369,118,121,3
"779f9ddd1fd14d1e9e69f72219a1fdbd","e20db35ced8544ddac5bc3839145e463",22855232,1,-36,0,370,121,91,-30
"e20db35ced8544ddac5bc3839145e463","ae26e6cda8ad4a3f81bd347560d9579f",22855232,1,40,0,371,91,125,34
"ae26e6cda8ad4a3f81bd347560d9579f","ae26e6cda8ad4a3f81bd347560d9579f",22855232,1,0,1,372,125,125,0
"ae26e6cda8ad4a3f81bd347560d9579f","ee48df95832b4374aa273ceb27ec1315",22855232,1,1,0,373,125,126,1
"ee48df95832b4374aa273ceb27ec1315","ee48df95832b4374aa273ceb27ec1315",22855232,1,0,1,374,126,126,0
"ee48df95832b4374aa273ceb27ec1315","7a439da90b394756ad1777fc4c6dead5",22855232,1,1,0,375,126,127,1
"7a439da90b394756ad1777fc4c6dead5","7a439da90b394756ad1777fc4c6dead5",22855232,1,0,1,376,127,127,0
"7a439da90b394756ad1777fc4c6dead5","a8dd5213034441ac92724b4e83eb0bb2",22855232,1,3,0,377,127,129,2
"a8dd5213034441ac92724b4e83eb0bb2","779f9ddd1fd14d1e9e69f72219a1fdbd",22855232,1,-9,0,378,129,121,-8
"779f9ddd1fd14d1e9e69f72219a1fdbd","a8dd5213034441ac92724b4e83eb0bb2",22855232,1,9,0,379,121,129,8
"a8dd5213034441ac92724b4e83eb0bb2","8115eab6556b45f5b415c3b8c26a12e5",22855232,1,2,0,380,129,131,2
"8115eab6556b45f5b415c3b8c26a12e5","8115eab6556b45f5b415c3b8c26a12e5",22855232,5,0,1,381,131,131,0
"8115eab6556b45f5b415c3b8c26a12e5","a8dd5213034441ac92724b4e83eb0bb2",22855232,1,-2,0,386,131,129,-2
"a8dd5213034441ac92724b4e83eb0bb2","ec34b06efd844b46a4c4818ecdb9b8f4",22855232,1,3,0,387,129,132,3
"ec34b06efd844b46a4c4818ecdb9b8f4","ec34b06efd844b46a4c4818ecdb9b8f4",22855232,2,0,1,388,132,132,0
"ec34b06efd844b46a4c4818ecdb9b8f4","c2e1c2b9eac64109b343a088584b576b",22855232,1,1,0,390,132,133,1
"c2e1c2b9eac64109b343a088584b576b","c2e1c2b9eac64109b343a088584b576b",22855232,2,0,1,391,133,133,0
"c2e1c2b9eac64109b343a088584b576b","579338175e0b4bbb8ef3b712b5d8b54e",22855232,1,-5,0,393,133,128,-5
"579338175e0b4bbb8ef3b712b5d8b54e","8bc5795d6a984a3eace4e2811e52dd4f",22855232,1,8,0,394,128,135,7
"8bc5795d6a984a3eace4e2811e52dd4f","8bc5795d6a984a3eace4e2811e52dd4f",22855232,1,0,1,395,135,135,0
"8bc5795d6a984a3eace4e2811e52dd4f","b416d47c56a742199b5d7c7f19d6503a",22855232,1,-1,0,396,135,134,-1
"b416d47c56a742199b5d7c7f19d6503a","cd4532ad48034873ba8bce2aac0c9808",22855232,1,4,0,397,134,137,3
"cd4532ad48034873ba8bce2aac0c9808","cd4532ad48034873ba8bce2aac0c9808",22855232,1,0,1,398,137,137,0
"cd4532ad48034873ba8bce2aac0c9808","df1de691dafe4549a18a4398ee9dfaf9",22855232,1,4,0,399,137,139,2
"df1de691dafe4549a18a4398ee9dfaf9","779f9ddd1fd14d1e9e69f72219a1fdbd",22855232,1,-23,0,400,139,121,-18
"779f9ddd1fd14d1e9e69f72219a1fdbd","6c5ad271a44743479bfaea29b1db8d02",22855232,1,27,0,401,121,143,22
"6c5ad271a44743479bfaea29b1db8d02","6c5ad271a44743479bfaea29b1db8d02",22855232,1,0,1,402,143,143,0
"6c5ad271a44743479bfaea29b1db8d02","83d311bed5374fee83d8d67a7d9d82dc",22855232,1,1,0,403,143,144,1
"83d311bed5374fee83d8d67a7d9d82dc","83d311bed5374fee83d8d67a7d9d82dc",22855232,1,0,1,404,144,144,0
"83d311bed5374fee83d8d67a7d9d82dc","402bba41861d43acb52a5abb89e8831e",22855232,1,1,0,405,144,145,1
"402bba41861d43acb52a5abb89e8831e","402bba41861d43acb52a5abb89e8831e",22855232,2,0,1,406,145,145,0
"402bba41861d43acb52a5abb89e8831e","df1de691dafe4549a18a4398ee9dfaf9",22855232,1,-6,0,408,145,139,-6
"df1de691dafe4549a18a4398ee9dfaf9","8aae34f5ddbb4052a709b12e6b0d40fa",22855232,1,9,0,409,139,147,8
"8aae34f5ddbb4052a709b12e6b0d40fa","8aae34f5ddbb4052a709b12e6b0d40fa",22855232,2,0,1,410,147,147,0
"8aae34f5ddbb4052a709b12e6b0d40fa","645b3f0249f64f76af2e19eb4d0e55b7",22855232,1,2,0,412,147,149,2
"645b3f0249f64f76af2e19eb4d0e55b7","645b3f0249f64f76af2e19eb4d0e55b7",22855232,2,0,1,413,149,149,0
"645b3f0249f64f76af2e19eb4d0e55b7","7e7b8db5064d4369805ab370aac5ddfb",22855232,1,1,0,415,149,150,1
"7e7b8db5064d4369805ab370aac5ddfb","7e7b8db5064d4369805ab370aac5ddfb",22855232,5,0,1,416,150,150,0
"7e7b8db5064d4369805ab370aac5ddfb","8aae34f5ddbb4052a709b12e6b0d40fa",22855232,1,-3,0,421,150,147,-3
"8aae34f5ddbb4052a709b12e6b0d40fa","8956d210ae7f41968fada86d4c979d6a",22855232,1,4,0,422,147,151,4
"8956d210ae7f41968fada86d4c979d6a","8956d210ae7f41968fada86d4c979d6a",22855232,2,0,1,423,151,151,0
"8956d210ae7f41968fada86d4c979d6a","f902b0f41b544d4dbf79664fd233648d",22855232,1,-5,0,425,151,146,-5
"f902b0f41b544d4dbf79664fd233648d","ae781e8b775e4ccd93bc800dad5c8376",22855232,1,8,0,426,146,153,7
"ae781e8b775e4ccd93bc800dad5c8376","ae781e8b775e4ccd93bc800dad5c8376",22855232,2,0,1,427,153,153,0
"ae781e8b775e4ccd93bc800dad5c8376","06882a8492d9499aa31555567f575ecb",22855232,1,1,0,429,153,154,1
"06882a8492d9499aa31555567f575ecb","06882a8492d9499aa31555567f575ecb",22855232,1,0,1,430,154,154,0
"06882a8492d9499aa31555567f575ecb","f293c508f409466a8f27ddd7d1e40b20",22855232,1,1,0,431,154,155,1
"f293c508f409466a8f27ddd7d1e40b20","f293c508f409466a8f27ddd7d1e40b20",22855232,2,0,1,432,155,155,0
"f293c508f409466a8f27ddd7d1e40b20","cc4ddef5bbbe48ebb605141b347c4ed1",22855232,1,1,0,434,155,156,1
"cc4ddef5bbbe48ebb605141b347c4ed1","cc4ddef5bbbe48ebb605141b347c4ed1",22855232,5,0,1,435,156,156,0
"cc4ddef5bbbe48ebb605141b347c4ed1","d313cec988a84645bee413e8d4724a4b",22855232,1,3,0,440,156,158,2
"d313cec988a84645bee413e8d4724a4b","f03480cf4eba413194d7af52fc0e7f28",22855232,2,-7,0,441,158,152,-6
"f03480cf4eba413194d7af52fc0e7f28","d313cec988a84645bee413e8d4724a4b",22855232,2,7,0,442,152,158,6
"d313cec988a84645bee413e8d4724a4b","d313cec988a84645bee413e8d4724a4b",22855232,4,0,1,443,158,158,0
"d313cec988a84645bee413e8d4724a4b","dc60696c76a74368a60f72246e47700d",22855232,1,1,0,446,158,159,1
"dc60696c76a74368a60f72246e47700d","dc60696c76a74368a60f72246e47700d",22855232,1,0,1,447,159,159,0
"dc60696c76a74368a60f72246e47700d","df1de691dafe4549a18a4398ee9dfaf9",22855232,1,-23,0,448,159,139,-20
"df1de691dafe4549a18a4398ee9dfaf9","78adeee1fa2c4fe0bc73f7bca9fcee86",22855232,1,26,0,449,139,160,21
"78adeee1fa2c4fe0bc73f7bca9fcee86","65202579580f4ad38d734b4ee39d22a8",22855232,5,5,0,450,160,164,4
"65202579580f4ad38d734b4ee39d22a8","65202579580f4ad38d734b4ee39d22a8",22855232,64,0,1,451,164,164,0
"65202579580f4ad38d734b4ee39d22a8","78adeee1fa2c4fe0bc73f7bca9fcee86",22855232,2,-5,0,456,164,160,-4
"65202579580f4ad38d734b4ee39d22a8","f924752d8a1149668870b1e7698486f7",22855232,1,-142,0,459,164,50,-114
"f924752d8a1149668870b1e7698486f7","b534b89233134e30a9b5645138bfa9ee",22855232,1,-11,0,460,50,41,-9
"b534b89233134e30a9b5645138bfa9ee","d0c74f735e024943943e40333d6d337f",22855232,1,12,0,461,41,51,10
"d0c74f735e024943943e40333d6d337f","f924752d8a1149668870b1e7698486f7",22855232,1,-1,0,462,51,50,-1
"f924752d8a1149668870b1e7698486f7","6e13d61a7bdb44bca949c9f86fab3be5",22855232,1,-4,0,463,50,47,-3
"6e13d61a7bdb44bca949c9f86fab3be5","78adeee1fa2c4fe0bc73f7bca9fcee86",22855232,1,141,0,464,47,160,113
"78adeee1fa2c4fe0bc73f7bca9fcee86","78adeee1fa2c4fe0bc73f7bca9fcee86",22855232,1,0,1,465,160,160,0
"65202579580f4ad38d734b4ee39d22a8","3cbcea2be0984e7dbd5a48195af10ce7",22855232,1,3,0,520,164,165,1
"3cbcea2be0984e7dbd5a48195af10ce7","78adeee1fa2c4fe0bc73f7bca9fcee86",22855232,1,-8,0,521,165,160,-5
"78adeee1fa2c4fe0bc73f7bca9fcee86","82e6285962b8400d9d6fc32436022a94",22855232,1,10,0,522,160,167,7
"82e6285962b8400d9d6fc32436022a94","78adeee1fa2c4fe0bc73f7bca9fcee86",22855232,1,-10,0,523,167,160,-7
"65202579580f4ad38d734b4ee39d22a8","37319e88176d4aefa91d7a9980dbae91",22855232,1,-66,0,532,164,112,-52
"37319e88176d4aefa91d7a9980dbae91","e20db35ced8544ddac5bc3839145e463",22855232,1,-24,0,533,112,91,-21
"e20db35ced8544ddac5bc3839145e463","08111f75e22d409998cf8b85bd431f0a",22855232,1,19,0,534,91,108,17
"08111f75e22d409998cf8b85bd431f0a","e20db35ced8544ddac5bc3839145e463",22855232,1,-19,0,535,108,91,-17
"e20db35ced8544ddac5bc3839145e463","4280927ec4d643238aa49c32f9e06c6c",22855232,1,20,0,536,91,109,18
"4280927ec4d643238aa49c32f9e06c6c","08111f75e22d409998cf8b85bd431f0a",22855232,2,-1,0,537,109,108,-1
"a9ae0a3c070d455bb4369a8996313336","37319e88176d4aefa91d7a9980dbae91",22855232,1,-2,0,539,114,112,-2
"37319e88176d4aefa91d7a9980dbae91","4280927ec4d643238aa49c32f9e06c6c",22855232,1,-4,0,540,112,109,-3
"a9ae0a3c070d455bb4369a8996313336","67a089198fcb4e1c8f2385786c2b296f",22855232,1,-93,0,545,114,39,-75
"67a089198fcb4e1c8f2385786c2b296f","779f9ddd1fd14d1e9e69f72219a1fdbd",22855232,1,103,0,546,39,121,82
"779f9ddd1fd14d1e9e69f72219a1fdbd","579338175e0b4bbb8ef3b712b5d8b54e",22855232,1,8,0,547,121,128,7
"579338175e0b4bbb8ef3b712b5d8b54e","a8dd5213034441ac92724b4e83eb0bb2",22855232,1,1,0,548,128,129,1
"a8dd5213034441ac92724b4e83eb0bb2","a8dd5213034441ac92724b4e83eb0bb2",22855232,2,0,1,549,129,129,0
"a8dd5213034441ac92724b4e83eb0bb2","579338175e0b4bbb8ef3b712b5d8b54e",22855232,1,-1,0,551,129,128,-1
"579338175e0b4bbb8ef3b712b5d8b54e","67a089198fcb4e1c8f2385786c2b296f",22855232,1,-111,0,552,128,39,-89
"67a089198fcb4e1c8f2385786c2b296f","f03480cf4eba413194d7af52fc0e7f28",22855232,1,141,0,553,39,152,113
"f03480cf4eba413194d7af52fc0e7f28","df1de691dafe4549a18a4398ee9dfaf9",22855232,3,-15,0,554,152,139,-13
"df1de691dafe4549a18a4398ee9dfaf9","f03480cf4eba413194d7af52fc0e7f28",22855232,2,15,0,555,139,152,13
"df1de691dafe4549a18a4398ee9dfaf9","d313cec988a84645bee413e8d4724a4b",22855232,1,22,0,559,139,158,19
"d313cec988a84645bee413e8d4724a4b","f4ce60b4a944484082ccb701b48b3da1",22855232,1,-1,0,563,158,157,-1
"f4ce60b4a944484082ccb701b48b3da1","67a089198fcb4e1c8f2385786c2b296f",22855232,1,-147,0,564,157,39,-118
"67a089198fcb4e1c8f2385786c2b296f","0c7262dff33c4087bc660ccf40f92f9c",22855232,1,169,0,565,39,169,130
"0c7262dff33c4087bc660ccf40f92f9c","0c7262dff33c4087bc660ccf40f92f9c",22855232,1,0,1,566,169,169,0
"0c7262dff33c4087bc660ccf40f92f9c","b2275c3fad834f8d90737a2d9a6927d6",22855232,1,3,0,567,169,172,3
"b2275c3fad834f8d90737a2d9a6927d6","b2275c3fad834f8d90737a2d9a6927d6",22855232,30,0,1,568,172,172,0
"b2275c3fad834f8d90737a2d9a6927d6","eb515a26030b41f8a82a1e6114420bad",22855232,1,1,0,598,172,173,1
"eb515a26030b41f8a82a1e6114420bad","eb515a26030b41f8a82a1e6114420bad",22855232,2,0,1,599,173,173,0
"eb515a26030b41f8a82a1e6114420bad","0c7262dff33c4087bc660ccf40f92f9c",22855232,1,-4,0,601,173,169,-4
"0c7262dff33c4087bc660ccf40f92f9c","b42cc17b7de840f181a704558d0bc845",22855232,2,7,0,602,169,175,6
"b42cc17b7de840f181a704558d0bc845","801f9e9135034f49bf5f8b4bdefedb41",22855232,1,2,0,603,175,177,2
"801f9e9135034f49bf5f8b4bdefedb41","801f9e9135034f49bf5f8b4bdefedb41",22855232,11,0,1,604,177,177,0
"801f9e9135034f49bf5f8b4bdefedb41","362fcb0699a14845ab29b2340093e528",22855232,1,-3,0,615,177,174,-3
"362fcb0699a14845ab29b2340093e528","ea38cc0e6e6e41edbabf210220808bf9",22855232,2,6,0,616,174,179,5
"ea38cc0e6e6e41edbabf210220808bf9","b87c552dd247427abe6ab5795b9c9d43",22855232,2,2,0,617,179,181,2
"b87c552dd247427abe6ab5795b9c9d43","ea38cc0e6e6e41edbabf210220808bf9",22855232,2,-2,0,618,181,179,-2
"ea38cc0e6e6e41edbabf210220808bf9","ea38cc0e6e6e41edbabf210220808bf9",22855232,3,0,1,619,179,179,0
"b87c552dd247427abe6ab5795b9c9d43","b87c552dd247427abe6ab5795b9c9d43",22855232,7,0,1,621,181,181,0
"b87c552dd247427abe6ab5795b9c9d43","139b097acfca451689d80c9c6eebdf7b",22855232,1,-3,0,628,181,178,-3
"139b097acfca451689d80c9c6eebdf7b","2024b4885bd14338a39b7b509acbbd02",22855232,1,5,0,629,178,182,4
"2024b4885bd14338a39b7b509acbbd02","b2275c3fad834f8d90737a2d9a6927d6",22855232,1,-13,0,630,182,172,-10
"b2275c3fad834f8d90737a2d9a6927d6","0c7262dff33c4087bc660ccf40f92f9c",22855232,1,-3,0,631,172,169,-3
"b42cc17b7de840f181a704558d0bc845","362fcb0699a14845ab29b2340093e528",22855232,1,-1,0,633,175,174,-1
"ea38cc0e6e6e41edbabf210220808bf9","2024b4885bd14338a39b7b509acbbd02",22855232,1,4,0,635,179,182,3
"2024b4885bd14338a39b7b509acbbd02","b87c552dd247427abe6ab5795b9c9d43",22855232,1,-2,0,636,182,181,-1
"ea38cc0e6e6e41edbabf210220808bf9","139b097acfca451689d80c9c6eebdf7b",22855232,1,-1,0,640,179,178,-1
"139b097acfca451689d80c9c6eebdf7b","30f660a1feb34582a739722532524f79",22855232,1,6,0,641,178,183,5
"30f660a1feb34582a739722532524f79","30f660a1feb34582a739722532524f79",22855232,3,0,1,642,183,183,0
"30f660a1feb34582a739722532524f79","2024b4885bd14338a39b7b509acbbd02",22855232,1,-1,0,645,183,182,-1
"2024b4885bd14338a39b7b509acbbd02","c3f63fe50d8e487c86bf8ef76c9cadd3",22855232,1,4,0,646,182,185,3
"c3f63fe50d8e487c86bf8ef76c9cadd3","c3f63fe50d8e487c86bf8ef76c9cadd3",22855232,1,0,1,647,185,185,0
"c3f63fe50d8e487c86bf8ef76c9cadd3","0c7262dff33c4087bc660ccf40f92f9c",22855232,1,-20,0,648,185,169,-16
"0c7262dff33c4087bc660ccf40f92f9c","c8e371568a0c4391b25796ae4e91952e",22855232,1,23,0,649,169,186,17
"c8e371568a0c4391b25796ae4e91952e","7d932b23e1c84326ae5aa4d3c0d813d1",22855232,1,2,0,650,186,188,2
"7d932b23e1c84326ae5aa4d3c0d813d1","7d932b23e1c84326ae5aa4d3c0d813d1",22855232,3,0,1,651,188,188,0
"7d932b23e1c84326ae5aa4d3c0d813d1","c8e371568a0c4391b25796ae4e91952e",22855232,1,-2,0,654,188,186,-2
"c8e371568a0c4391b25796ae4e91952e","ab11d94c6c8948ea90b88f19d2cd502b",22855232,1,5,0,655,186,190,4
"ab11d94c6c8948ea90b88f19d2cd502b","f992451ed6ad4e68bb9e68ad6be7c4be",22855232,1,2,0,656,190,192,2
"f992451ed6ad4e68bb9e68ad6be7c4be","f992451ed6ad4e68bb9e68ad6be7c4be",22855232,1,0,1,657,192,192,0
"f992451ed6ad4e68bb9e68ad6be7c4be","07b44a7a51e94c78b411c753fc39dab0",22855232,1,-3,0,658,192,189,-3
"07b44a7a51e94c78b411c753fc39dab0","6cd2dcaac46847d4a0bc53f296d90375",22855232,1,6,0,659,189,194,5
"6cd2dcaac46847d4a0bc53f296d90375","6cd2dcaac46847d4a0bc53f296d90375",22855232,1,0,1,660,194,194,0
"6cd2dcaac46847d4a0bc53f296d90375","2d2580c9411c4972909db508d6956a58",22855232,1,2,0,661,194,196,2
"2d2580c9411c4972909db508d6956a58","2d2580c9411c4972909db508d6956a58",22855232,9,0,1,662,196,196,0
"2d2580c9411c4972909db508d6956a58","5bddb3d9ed264f3984702f048c7e5340",22855232,1,1,0,671,196,197,1
"5bddb3d9ed264f3984702f048c7e5340","5bddb3d9ed264f3984702f048c7e5340",22855232,6,0,1,672,197,197,0
"5bddb3d9ed264f3984702f048c7e5340","d5e8e2bd12a2466b9d6d90855f0eb079",22855232,1,1,0,678,197,198,1
"d5e8e2bd12a2466b9d6d90855f0eb079","d5e8e2bd12a2466b9d6d90855f0eb079",22855232,2,0,1,679,198,198,0
"d5e8e2bd12a2466b9d6d90855f0eb079","017d7ca8e0394b91aaadc9574df2202c",22855232,1,-5,0,681,198,193,-5
"017d7ca8e0394b91aaadc9574df2202c","54e8e9f0ea3e45c4bf3b8ac799ee31b1",22855232,1,8,0,682,193,200,7
"54e8e9f0ea3e45c4bf3b8ac799ee31b1","54e8e9f0ea3e45c4bf3b8ac799ee31b1",22855232,1,0,1,683,200,200,0
"54e8e9f0ea3e45c4bf3b8ac799ee31b1","c614a00911be4877a075f19315530fb0",22855232,1,1,0,684,200,201,1
"c614a00911be4877a075f19315530fb0","c614a00911be4877a075f19315530fb0",22855232,6,0,1,685,201,201,0
"c614a00911be4877a075f19315530fb0","a6c21bd8b95249c7972820a7a7d76aff",22855232,1,1,0,691,201,202,1
"a6c21bd8b95249c7972820a7a7d76aff","a6c21bd8b95249c7972820a7a7d76aff",22855232,1,0,1,692,202,202,0
"a6c21bd8b95249c7972820a7a7d76aff","bb329d880ab54120adaf203a693bb203",22855232,1,1,0,693,202,203,1
"bb329d880ab54120adaf203a693bb203","bb329d880ab54120adaf203a693bb203",22855232,1,0,1,694,203,203,0
"bb329d880ab54120adaf203a693bb203","f9170dd6bc6442b4acd832747609b09a",22855232,1,-4,0,695,203,199,-4
"f9170dd6bc6442b4acd832747609b09a","334c2344009840079b1d0e1b7ce3d5a7",22855232,1,7,0,696,199,205,6
"334c2344009840079b1d0e1b7ce3d5a7","334c2344009840079b1d0e1b7ce3d5a7",22855232,1,0,1,697,205,205,0
"334c2344009840079b1d0e1b7ce3d5a7","c8e371568a0c4391b25796ae4e91952e",22855232,1,-23,0,698,205,186,-19
"c8e371568a0c4391b25796ae4e91952e","d7f13c8d63ec4e2aa673fbb9cf9c6933",22855232,1,26,0,699,186,206,20
"d7f13c8d63ec4e2aa673fbb9cf9c6933","7108f0e4c2584f1f9c471689ae4c885c",22855232,1,2,0,700,206,208,2
"7108f0e4c2584f1f9c471689ae4c885c","b9e80f77c3a44349863b19875725c384",22855232,1,-1,0,701,208,207,-1
"b9e80f77c3a44349863b19875725c384","b9e80f77c3a44349863b19875725c384",22855232,18,0,1,702,207,207,0
"b9e80f77c3a44349863b19875725c384","7108f0e4c2584f1f9c471689ae4c885c",22855232,1,1,0,720,207,208,1
"7108f0e4c2584f1f9c471689ae4c885c","7108f0e4c2584f1f9c471689ae4c885c",22855232,10,0,1,721,208,208,0
"7108f0e4c2584f1f9c471689ae4c885c","d7f13c8d63ec4e2aa673fbb9cf9c6933",22855232,1,-2,0,731,208,206,-2
"d7f13c8d63ec4e2aa673fbb9cf9c6933","09400e101c5d4b439cf9a26b03aae558",22855232,1,5,0,732,206,210,4
"09400e101c5d4b439cf9a26b03aae558","09400e101c5d4b439cf9a26b03aae558",22855232,8,0,1,733,210,210,0
"09400e101c5d4b439cf9a26b03aae558","a88efa7e50ce47159810ab553afa6d3a",22855232,2,2,0,735,210,212,2
"a88efa7e50ce47159810ab553afa6d3a","a88efa7e50ce47159810ab553afa6d3a",22855232,7,0,1,736,212,212,0
"a88efa7e50ce47159810ab553afa6d3a","09400e101c5d4b439cf9a26b03aae558",22855232,1,-2,0,738,212,210,-2
"a88efa7e50ce47159810ab553afa6d3a","a875096404ef4a9984b62d74cda916f9",22855232,1,-3,0,751,212,209,-3
"a875096404ef4a9984b62d74cda916f9","f7fb1952f56b4189b86a9f8b7862d2b8",22855232,1,7,0,752,209,215,6
"f7fb1952f56b4189b86a9f8b7862d2b8","be502a7a43c44bf7b682698de79d9369",22855232,2,-1,0,753,215,214,-1
"be502a7a43c44bf7b682698de79d9369","be502a7a43c44bf7b682698de79d9369",22855232,6,0,1,754,214,214,0
"be502a7a43c44bf7b682698de79d9369","f7fb1952f56b4189b86a9f8b7862d2b8",22855232,2,1,0,755,214,215,1
"f7fb1952f56b4189b86a9f8b7862d2b8","f7fb1952f56b4189b86a9f8b7862d2b8",22855232,10,0,1,756,215,215,0
"f7fb1952f56b4189b86a9f8b7862d2b8","b860ee85d8bc4a2f97958cfb71be3533",22855232,1,1,0,773,215,216,1
"b860ee85d8bc4a2f97958cfb71be3533","b860ee85d8bc4a2f97958cfb71be3533",22855232,2,0,1,774,216,216,0
"b860ee85d8bc4a2f97958cfb71be3533","363837c182e04711840d896ae1e0339c",22855232,1,3,0,776,216,218,2
"363837c182e04711840d896ae1e0339c","ec341f459285443b8361f7f15638ff08",22855232,1,-6,0,777,218,213,-5
"ec341f459285443b8361f7f15638ff08","363837c182e04711840d896ae1e0339c",22855232,1,6,0,778,213,218,5
"363837c182e04711840d896ae1e0339c","363837c182e04711840d896ae1e0339c",22855232,11,0,1,779,218,218,0
"363837c182e04711840d896ae1e0339c","01b2051f8941460d89945e3b02d1ce78",22855232,1,-1,0,790,218,217,-1
"01b2051f8941460d89945e3b02d1ce78","91125ca626c5470eb145501f8c37f8db",22855232,1,4,0,791,217,220,3
"91125ca626c5470eb145501f8c37f8db","91125ca626c5470eb145501f8c37f8db",22855232,1,0,1,792,220,220,0
"91125ca626c5470eb145501f8c37f8db","d7f13c8d63ec4e2aa673fbb9cf9c6933",22855232,1,-18,0,793,220,206,-14
"d7f13c8d63ec4e2aa673fbb9cf9c6933","1c6721b1f63f4d30ba7746ea8af02a52",22855232,1,21,0,794,206,221,15
"1c6721b1f63f4d30ba7746ea8af02a52","77ecef8eff6b4a2caea7707669bf7475",22855232,1,1,0,795,221,222,1
"77ecef8eff6b4a2caea7707669bf7475","77ecef8eff6b4a2caea7707669bf7475",22855232,12,0,1,796,222,222,0
"77ecef8eff6b4a2caea7707669bf7475","d03cb855c70044cf8c35d9ec0de696e3",22855232,1,3,0,808,222,224,2
"d03cb855c70044cf8c35d9ec0de696e3","1c6721b1f63f4d30ba7746ea8af02a52",22855232,1,-4,0,809,224,221,-3
"1c6721b1f63f4d30ba7746ea8af02a52","8b9ae98743bd4d4a8a87dff1c1244211",22855232,1,7,0,810,221,227,6
"8b9ae98743bd4d4a8a87dff1c1244211","d03cb855c70044cf8c35d9ec0de696e3",22855232,1,-3,0,811,227,224,-3
"d03cb855c70044cf8c35d9ec0de696e3","d03cb855c70044cf8c35d9ec0de696e3",22855232,2,0,1,812,224,224,0
"d03cb855c70044cf8c35d9ec0de696e3","a49a937d6896486d9a5396654abcf2e1",22855232,1,2,0,814,224,226,2
"a49a937d6896486d9a5396654abcf2e1","a49a937d6896486d9a5396654abcf2e1",22855232,1,0,1,815,226,226,0
"a49a937d6896486d9a5396654abcf2e1","8b9ae98743bd4d4a8a87dff1c1244211",22855232,1,1,0,816,226,227,1
"8b9ae98743bd4d4a8a87dff1c1244211","8b9ae98743bd4d4a8a87dff1c1244211",22855232,18,0,1,817,227,227,0
"8b9ae98743bd4d4a8a87dff1c1244211","f7906d6f59b9489a91d2ef40db5a474d",22855232,1,-4,0,835,227,223,-4
"f7906d6f59b9489a91d2ef40db5a474d","2ab1535aac1346ba8801535bf729ef37",22855232,1,7,0,836,223,229,6
"2ab1535aac1346ba8801535bf729ef37","2ab1535aac1346ba8801535bf729ef37",22855232,4,0,1,837,229,229,0
"2ab1535aac1346ba8801535bf729ef37","a4f40fb48a8542c8949bae1f002cd9bc",22855232,1,2,0,839,229,231,2
"a4f40fb48a8542c8949bae1f002cd9bc","a4f40fb48a8542c8949bae1f002cd9bc",22855232,2,0,1,840,231,231,0
"a4f40fb48a8542c8949bae1f002cd9bc","2ab1535aac1346ba8801535bf729ef37",22855232,1,-2,0,842,231,229,-2
"2ab1535aac1346ba8801535bf729ef37","8972c23e32044edb8a78fa1eed4e5947",22855232,1,3,0,845,229,232,3
"8972c23e32044edb8a78fa1eed4e5947","8972c23e32044edb8a78fa1eed4e5947",22855232,1,0,1,846,232,232,0
"8972c23e32044edb8a78fa1eed4e5947","92feb4a40f8344d38b6f722e42a53295",22855232,1,1,0,847,232,233,1
"92feb4a40f8344d38b6f722e42a53295","92feb4a40f8344d38b6f722e42a53295",22855232,2,0,1,848,233,233,0
"92feb4a40f8344d38b6f722e42a53295","5152833676bf4c6cb317060be10f68db",22855232,1,-5,0,850,233,228,-5
"5152833676bf4c6cb317060be10f68db","ca3e28f290354c08aefe5b0f769604e6",22855232,1,8,0,851,228,235,7
"ca3e28f290354c08aefe5b0f769604e6","ca3e28f290354c08aefe5b0f769604e6",22855232,9,0,1,852,235,235,0
"ca3e28f290354c08aefe5b0f769604e6","79a35eea833e4c2c9d22fc53c3c6445c",22855232,1,1,0,861,235,236,1
"79a35eea833e4c2c9d22fc53c3c6445c","79a35eea833e4c2c9d22fc53c3c6445c",22855232,9,0,1,862,236,236,0
"79a35eea833e4c2c9d22fc53c3c6445c","8f68228b1518449e9615cdafee41a2bd",22855232,1,1,0,871,236,237,1
"8f68228b1518449e9615cdafee41a2bd","8f68228b1518449e9615cdafee41a2bd",22855232,1,0,1,872,237,237,0
"8f68228b1518449e9615cdafee41a2bd","cab89fa5c3ed45a5aa550fc0352d6a42",22855232,1,1,0,873,237,238,1
"cab89fa5c3ed45a5aa550fc0352d6a42","cab89fa5c3ed45a5aa550fc0352d6a42",22855232,5,0,1,874,238,238,0
"cab89fa5c3ed45a5aa550fc0352d6a42","66d4fad4f1cf4b46be0750a99ad7a35a",22855232,1,1,0,879,238,239,1
"66d4fad4f1cf4b46be0750a99ad7a35a","66d4fad4f1cf4b46be0750a99ad7a35a",22855232,1,0,1,880,239,239,0
"66d4fad4f1cf4b46be0750a99ad7a35a","0b04c8e2f86d48c7aeb7e225819cd32b",22855232,1,-5,0,881,239,234,-5
"0b04c8e2f86d48c7aeb7e225819cd32b","f53da5fd9bfe412da4b80d4742563b6c",22855232,1,8,0,882,234,241,7
"f53da5fd9bfe412da4b80d4742563b6c","f53da5fd9bfe412da4b80d4742563b6c",22855232,1,0,1,883,241,241,0
"f53da5fd9bfe412da4b80d4742563b6c","1c6721b1f63f4d30ba7746ea8af02a52",22855232,1,-24,0,884,241,221,-20
"1c6721b1f63f4d30ba7746ea8af02a52","2ae94c0cea4d480a9d5dca8fb1d7b542",22855232,1,27,0,885,221,242,21
"2ae94c0cea4d480a9d5dca8fb1d7b542","1ebf23f9d994469a85206e4c7b1bf5f5",22855232,1,3,0,886,242,245,3
"1ebf23f9d994469a85206e4c7b1bf5f5","1ebf23f9d994469a85206e4c7b1bf5f5",22855232,10,0,1,887,245,245,0
"1ebf23f9d994469a85206e4c7b1bf5f5","85ae675b83e8422da842cfd25596af99",22855232,1,1,0,897,245,246,1
"85ae675b83e8422da842cfd25596af99","85ae675b83e8422da842cfd25596af99",22855232,1,0,1,898,246,246,0
"85ae675b83e8422da842cfd25596af99","2ae94c0cea4d480a9d5dca8fb1d7b542",22855232,1,-4,0,899,246,242,-4
"2ae94c0cea4d480a9d5dca8fb1d7b542","fa235f0f364d47e4ae1c87f47bf8e6ba",22855232,1,12,0,900,242,252,10
"fa235f0f364d47e4ae1c87f47bf8e6ba","79f7845465cc4ed19d8e4f1429541be0",22855232,1,2,0,901,252,254,2
"79f7845465cc4ed19d8e4f1429541be0","79f7845465cc4ed19d8e4f1429541be0",22855232,2,0,1,902,254,254,0
"79f7845465cc4ed19d8e4f1429541be0","6e83e23f56544a19b94067c1c558d9c0",22855232,1,-8,0,904,254,247,-7
"6e83e23f56544a19b94067c1c558d9c0","00f61990949545828dd12f1303d47504",22855232,1,11,0,905,247,256,9
"00f61990949545828dd12f1303d47504","ead7bb4b64e247d2ae632ab8a296b091",22855232,1,2,0,906,256,258,2
"ead7bb4b64e247d2ae632ab8a296b091","ead7bb4b64e247d2ae632ab8a296b091",22855232,2,0,1,907,258,258,0
"ead7bb4b64e247d2ae632ab8a296b091","00f61990949545828dd12f1303d47504",22855232,1,-2,0,909,258,256,-2
"00f61990949545828dd12f1303d47504","41b0048dde734bb280bac6116baa8e27",22855232,1,3,0,910,256,259,3
"41b0048dde734bb280bac6116baa8e27","41b0048dde734bb280bac6116baa8e27",22855232,2,0,1,911,259,259,0
"41b0048dde734bb280bac6116baa8e27","b41c5a094a604ee0915327da5cc0beb7",22855232,1,1,0,913,259,260,1
"b41c5a094a604ee0915327da5cc0beb7","b41c5a094a604ee0915327da5cc0beb7",22855232,2,0,1,914,260,260,0
"b41c5a094a604ee0915327da5cc0beb7","d546341988904f069cfa86b21457d9d9",22855232,1,-10,0,916,260,251,-9
"d546341988904f069cfa86b21457d9d9","28c171777c52431ab6b925073bd63d46",22855232,1,15,0,917,251,264,13
"28c171777c52431ab6b925073bd63d46","28c171777c52431ab6b925073bd63d46",22855232,3,0,1,918,264,264,0
"28c171777c52431ab6b925073bd63d46","ac160db940cb49ae8579162b1d52bb5d",22855232,1,2,0,921,264,266,2
"ac160db940cb49ae8579162b1d52bb5d","ac160db940cb49ae8579162b1d52bb5d",22855232,3,0,1,922,266,266,0
"ac160db940cb49ae8579162b1d52bb5d","d989ebcfc12a4b669f0100dc1aa14f1e",22855232,1,-12,0,925,266,255,-11
"d989ebcfc12a4b669f0100dc1aa14f1e","c6fd49b485cc4874b0bbdd9c6171e09c",22855232,1,15,0,926,255,268,13
"c6fd49b485cc4874b0bbdd9c6171e09c","c6fd49b485cc4874b0bbdd9c6171e09c",22855232,8,0,1,927,268,268,0
"c6fd49b485cc4874b0bbdd9c6171e09c","44240778a97c4af0937817499b75707b",22855232,1,1,0,935,268,269,1
"44240778a97c4af0937817499b75707b","44240778a97c4af0937817499b75707b",22855232,2,0,1,936,269,269,0
"44240778a97c4af0937817499b75707b","7aa76d3e993840d8805f097cbdbcd44b",22855232,1,-9,0,938,269,261,-8
"7aa76d3e993840d8805f097cbdbcd44b","865a4d3b43374da7944dc7d397f566d9",22855232,1,12,0,939,261,271,10
"865a4d3b43374da7944dc7d397f566d9","865a4d3b43374da7944dc7d397f566d9",22855232,1,0,1,940,271,271,0
"865a4d3b43374da7944dc7d397f566d9","0d987bed3ffa4ed0b9a2e62e97b7b30f",22855232,1,3,0,941,271,272,1
"0d987bed3ffa4ed0b9a2e62e97b7b30f","2ae94c0cea4d480a9d5dca8fb1d7b542",22855232,1,-38,0,942,272,242,-30
"2ae94c0cea4d480a9d5dca8fb1d7b542","0d987bed3ffa4ed0b9a2e62e97b7b30f",22855232,1,38,0,943,242,272,30
"0d987bed3ffa4ed0b9a2e62e97b7b30f","82ae07bc0c9b4570a41799290d1ef399",22855232,3,4,0,944,272,275,3
"82ae07bc0c9b4570a41799290d1ef399","0d987bed3ffa4ed0b9a2e62e97b7b30f",22855232,2,-4,0,945,275,272,-3
"82ae07bc0c9b4570a41799290d1ef399","bb5a47f5ea01454a8b79455422d3b9da",22855232,1,6,0,949,275,280,5
"bb5a47f5ea01454a8b79455422d3b9da","bb5a47f5ea01454a8b79455422d3b9da",22855232,85,0,1,1000,280,280,0
"bb5a47f5ea01454a8b79455422d3b9da","94cecc3f1e7d484b8e068e79241dfd73",22855232,1,3,0,1014,280,281,1
"94cecc3f1e7d484b8e068e79241dfd73","0d987bed3ffa4ed0b9a2e62e97b7b30f",22855232,1,-13,0,1015,281,272,-9
"0d987bed3ffa4ed0b9a2e62e97b7b30f","a37477c4e4c14169ad44b06b493007f6",22855232,1,15,0,1016,272,283,11
"a37477c4e4c14169ad44b06b493007f6","4a29443515bb404cb8924e1c60a63b73",22855232,1,7,0,1017,283,285,2
"4a29443515bb404cb8924e1c60a63b73","4a29443515bb404cb8924e1c60a63b73",22855232,1,0,1,1018,285,285,0
"4a29443515bb404cb8924e1c60a63b73","208c9b2796c944db8dacaa96082520ea",22855232,1,3,0,1019,285,288,3
"208c9b2796c944db8dacaa96082520ea","208c9b2796c944db8dacaa96082520ea",22855232,1,0,1,1020,288,288,0
"208c9b2796c944db8dacaa96082520ea","4a29443515bb404cb8924e1c60a63b73",22855232,1,-3,0,1021,288,285,-3
"4a29443515bb404cb8924e1c60a63b73","7669a956527947d0add87455277e80b4",22855232,1,7,0,1022,285,291,6
"7669a956527947d0add87455277e80b4","7669a956527947d0add87455277e80b4",22855232,1,0,1,1023,291,291,0
"7669a956527947d0add87455277e80b4","6a9a3b5bde4a48daa896fe8c06eca56f",22855232,1,-2,0,1024,291,289,-2
"6a9a3b5bde4a48daa896fe8c06eca56f","869e967078f04da18dd0b0b9389a7424",22855232,1,5,0,1025,289,293,4
"869e967078f04da18dd0b0b9389a7424","869e967078f04da18dd0b0b9389a7424",22855232,1,0,1,1026,293,293,0
"869e967078f04da18dd0b0b9389a7424","51ab6291537748fab90d519aa09889d6",22855232,1,2,0,1027,293,295,2
"51ab6291537748fab90d519aa09889d6","51ab6291537748fab90d519aa09889d6",22855232,11,0,1,1028,295,295,0
"51ab6291537748fab90d519aa09889d6","34a6e49023fc4465bd5ca604330bbd1c",22855232,1,-3,0,1039,295,292,-3
"34a6e49023fc4465bd5ca604330bbd1c","21592f2a9e9c4b2f8c66ec5dbcbf6a2b",22855232,1,5,0,1040,292,296,4
"21592f2a9e9c4b2f8c66ec5dbcbf6a2b","ba0e59461bfb4a44b7b1c28a01f8d3b3",22855232,1,4,0,1041,296,299,3
"ba0e59461bfb4a44b7b1c28a01f8d3b3","ba0e59461bfb4a44b7b1c28a01f8d3b3",22855232,1,0,1,1042,299,299,0
"ba0e59461bfb4a44b7b1c28a01f8d3b3","0e0b36e731a645e7b1b8a88f5031ca38",22855232,1,2,0,1043,299,301,2
"0e0b36e731a645e7b1b8a88f5031ca38","0e0b36e731a645e7b1b8a88f5031ca38",22855232,5,0,1,1044,301,301,0
"0e0b36e731a645e7b1b8a88f5031ca38","a66a144637284c21afc6de17fea4bfb8",22855232,1,1,0,1049,301,302,1
"a66a144637284c21afc6de17fea4bfb8","a66a144637284c21afc6de17fea4bfb8",22855232,2,0,1,1050,302,302,0
"a66a144637284c21afc6de17fea4bfb8","7646a919d7e64fa990bca9b024ff089d",22855232,1,-4,0,1052,302,298,-4
"7646a919d7e64fa990bca9b024ff089d","e390b575229748ea8aac9364efe2bf00",22855232,1,7,0,1053,298,304,6
"e390b575229748ea8aac9364efe2bf00","e390b575229748ea8aac9364efe2bf00",22855232,1,0,1,1054,304,304,0
"e390b575229748ea8aac9364efe2bf00","3434c10e561d488a914e0f7d71907abd",22855232,1,3,0,1055,304,305,1
"3434c10e561d488a914e0f7d71907abd","4a29443515bb404cb8924e1c60a63b73",22855232,1,-27,0,1056,305,285,-20
"4a29443515bb404cb8924e1c60a63b73","53e7e900392747ccad52e711ab0f80d8",22855232,1,29,0,1057,285,307,22
"53e7e900392747ccad52e711ab0f80d8","53e7e900392747ccad52e711ab0f80d8",22855232,2,0,1,1058,307,307,0
"53e7e900392747ccad52e711ab0f80d8","3434c10e561d488a914e0f7d71907abd",22855232,1,-2,0,1060,307,305,-2
"3434c10e561d488a914e0f7d71907abd","130acc2aeb0448fdbb2de63bc5cebe5b",22855232,1,5,0,1061,305,309,4
"130acc2aeb0448fdbb2de63bc5cebe5b","130acc2aeb0448fdbb2de63bc5cebe5b",22855232,1,0,1,1062,309,309,0
"130acc2aeb0448fdbb2de63bc5cebe5b","9c062b3251034ebe90f5054e2a3b5120",22855232,1,2,0,1063,309,311,2
"9c062b3251034ebe90f5054e2a3b5120","9c062b3251034ebe90f5054e2a3b5120",22855232,5,0,1,1064,311,311,0
"9c062b3251034ebe90f5054e2a3b5120","130acc2aeb0448fdbb2de63bc5cebe5b",22855232,1,-2,0,1069,311,309,-2
"130acc2aeb0448fdbb2de63bc5cebe5b","ea859f8207e44537889daeaba13ac2e8",22855232,1,3,0,1070,309,312,3
"ea859f8207e44537889daeaba13ac2e8","ea859f8207e44537889daeaba13ac2e8",22855232,1,0,1,1071,312,312,0
"ea859f8207e44537889daeaba13ac2e8","56d94971a7a94257aa330183a8ebd0ea",22855232,1,1,0,1072,312,313,1
"56d94971a7a94257aa330183a8ebd0ea","56d94971a7a94257aa330183a8ebd0ea",22855232,1,0,1,1073,313,313,0
"56d94971a7a94257aa330183a8ebd0ea","141c0df6cd1946539aadd1c9b7068cd4",22855232,1,-5,0,1074,313,308,-5
"141c0df6cd1946539aadd1c9b7068cd4","13255e63e0aa4abf85e5211bf613d43e",22855232,1,10,0,1075,308,317,9
"13255e63e0aa4abf85e5211bf613d43e","13255e63e0aa4abf85e5211bf613d43e",22855232,3,0,1,1076,317,317,0
"13255e63e0aa4abf85e5211bf613d43e","0c787d16c9504873b1a4d903cec09948",22855232,1,-3,0,1079,317,314,-3
"0c787d16c9504873b1a4d903cec09948","86c27d40179e419c8e9d150fb6afa5d0",22855232,1,6,0,1080,314,319,5
"86c27d40179e419c8e9d150fb6afa5d0","86c27d40179e419c8e9d150fb6afa5d0",22855232,1,0,1,1081,319,319,0
"86c27d40179e419c8e9d150fb6afa5d0","24f1363179ad4aaa965484a78471912b",22855232,1,5,0,1082,319,323,4
"24f1363179ad4aaa965484a78471912b","47edbb64109243e6b0f8f64cdef90c6c",22855232,1,3,0,1083,323,326,3
"47edbb64109243e6b0f8f64cdef90c6c","8d7e0b55cf9849cda222a0f2440cec55",22855232,1,-9,0,1084,326,318,-8
"8d7e0b55cf9849cda222a0f2440cec55","24f1363179ad4aaa965484a78471912b",22855232,1,6,0,1085,318,323,5
"24f1363179ad4aaa965484a78471912b","3628bdce1dd2429ba924d2d4d09448d2",22855232,1,-1,0,1086,323,322,-1
"3628bdce1dd2429ba924d2d4d09448d2","56b3fd1a212a4764be39d979fde3326e",22855232,1,7,0,1087,322,328,6
"56b3fd1a212a4764be39d979fde3326e","56b3fd1a212a4764be39d979fde3326e",22855232,1,0,1,1088,328,328,0
"56b3fd1a212a4764be39d979fde3326e","0c4079457ede49e3aeb5e86ed84bdf35",22855232,1,3,0,1089,328,329,1
"0c4079457ede49e3aeb5e86ed84bdf35","3434c10e561d488a914e0f7d71907abd",22855232,1,-31,0,1090,329,305,-24
"3434c10e561d488a914e0f7d71907abd","38aea304b4fa46e1b29bb72f5cea4c93",22855232,1,33,0,1091,305,331,26
"38aea304b4fa46e1b29bb72f5cea4c93","38aea304b4fa46e1b29bb72f5cea4c93",22855232,2,0,1,1092,331,331,0
"38aea304b4fa46e1b29bb72f5cea4c93","e36d261332f14e79bb4b467aceaeb9b5",22855232,1,2,0,1094,331,333,2
"e36d261332f14e79bb4b467aceaeb9b5","e36d261332f14e79bb4b467aceaeb9b5",22855232,1,0,1,1095,333,333,0
"e36d261332f14e79bb4b467aceaeb9b5","c7e89b9d04744d2eab742fc24e3ef1ae",22855232,1,1,0,1096,333,334,1
"c7e89b9d04744d2eab742fc24e3ef1ae","c7e89b9d04744d2eab742fc24e3ef1ae",22855232,2,0,1,1097,334,334,0
"c7e89b9d04744d2eab742fc24e3ef1ae","fe49f8054b374a0ea4bb266ed135ff62",22855232,1,1,0,1099,334,335,1
"fe49f8054b374a0ea4bb266ed135ff62","fe49f8054b374a0ea4bb266ed135ff62",22855232,2,0,1,1100,335,335,0
"fe49f8054b374a0ea4bb266ed135ff62","d0a8f74af98642fe8360d22c42e45117",22855232,1,1,0,1102,335,336,1
"d0a8f74af98642fe8360d22c42e45117","d0a8f74af98642fe8360d22c42e45117",22855232,2,0,1,1103,336,336,0
"d0a8f74af98642fe8360d22c42e45117","0c4079457ede49e3aeb5e86ed84bdf35",22855232,1,-7,0,1105,336,329,-7
"0c4079457ede49e3aeb5e86ed84bdf35","a7c6339ca1da4368a18d471f0519f877",22855232,1,11,0,1106,329,339,10
"a7c6339ca1da4368a18d471f0519f877","a7c6339ca1da4368a18d471f0519f877",22855232,1,0,1,1107,339,339,0
"a7c6339ca1da4368a18d471f0519f877","b8b9418ab322418d9db9b40d96af873a",22855232,1,-2,0,1108,339,337,-2
"b8b9418ab322418d9db9b40d96af873a","bbc5139ca9024389a94db3a6f47dcff6",22855232,1,5,0,1109,337,341,4
"bbc5139ca9024389a94db3a6f47dcff6","4a29443515bb404cb8924e1c60a63b73",22855232,1,-72,0,1110,341,285,-56
"4a29443515bb404cb8924e1c60a63b73","c2490bc612d146edbe786556fab3651b",22855232,1,71,0,1111,285,340,55
"c2490bc612d146edbe786556fab3651b","0c4079457ede49e3aeb5e86ed84bdf35",22855232,1,-13,0,1112,340,329,-11
"0c4079457ede49e3aeb5e86ed84bdf35","bbc5139ca9024389a94db3a6f47dcff6",22855232,1,14,0,1113,329,341,12
"bbc5139ca9024389a94db3a6f47dcff6","bbc5139ca9024389a94db3a6f47dcff6",22855232,1,0,1,1114,341,341,0
"bbc5139ca9024389a94db3a6f47dcff6","4ee6ca9019ab4a1ab323f98094a9bd77",22855232,1,2,0,1115,341,343,2
"4ee6ca9019ab4a1ab323f98094a9bd77","4ee6ca9019ab4a1ab323f98094a9bd77",22855232,5,0,1,1116,343,343,0
"4ee6ca9019ab4a1ab323f98094a9bd77","b37947176785476f8b29d49a851366dc",22855232,1,1,0,1121,343,344,1
"b37947176785476f8b29d49a851366dc","b37947176785476f8b29d49a851366dc",22855232,2,0,1,1122,344,344,0
"b37947176785476f8b29d49a851366dc","fcea5b10d5a14a3b9324ffece8f6e1e5",22855232,1,1,0,1124,344,345,1
"fcea5b10d5a14a3b9324ffece8f6e1e5","fcea5b10d5a14a3b9324ffece8f6e1e5",22855232,5,0,1,1125,345,345,0
"fcea5b10d5a14a3b9324ffece8f6e1e5","c2490bc612d146edbe786556fab3651b",22855232,1,-5,0,1130,345,340,-5
"c2490bc612d146edbe786556fab3651b","6ac8bb048b854999a47edb35fe627f11",22855232,1,8,0,1131,340,347,7
"6ac8bb048b854999a47edb35fe627f11","6ac8bb048b854999a47edb35fe627f11",22855232,1,0,1,1132,347,347,0
"6ac8bb048b854999a47edb35fe627f11","0c4079457ede49e3aeb5e86ed84bdf35",22855232,1,-21,0,1133,347,329,-18
"0c4079457ede49e3aeb5e86ed84bdf35","30ead9794d4847abaf222ca966cc8630",22855232,1,24,0,1134,329,348,19
"30ead9794d4847abaf222ca966cc8630","eff0de7f2dbb42dfa1a2e686efab5b6d",22855232,1,6,0,1135,348,354,6
"eff0de7f2dbb42dfa1a2e686efab5b6d","c20993c944444fe085345591a8bd837e",22855232,2,-3,0,1136,354,351,-3
"c20993c944444fe085345591a8bd837e","897b7f51242c44aab2205c72fdcbf4cd",22855232,3,1,0,1137,351,352,1
"897b7f51242c44aab2205c72fdcbf4cd","09b9678ddc3d452ea4a3d46e15826065",22855232,2,1,0,1138,352,353,1
"09b9678ddc3d452ea4a3d46e15826065","c20993c944444fe085345591a8bd837e",22855232,1,-2,0,1139,353,351,-2
"c20993c944444fe085345591a8bd837e","c20993c944444fe085345591a8bd837e",22855232,5,0,1,1140,351,351,0
"897b7f51242c44aab2205c72fdcbf4cd","897b7f51242c44aab2205c72fdcbf4cd",22855232,4,0,1,1144,352,352,0
"09b9678ddc3d452ea4a3d46e15826065","09b9678ddc3d452ea4a3d46e15826065",22855232,4,0,1,1148,353,353,0
"09b9678ddc3d452ea4a3d46e15826065","eff0de7f2dbb42dfa1a2e686efab5b6d",22855232,2,1,0,1151,353,354,1
"eff0de7f2dbb42dfa1a2e686efab5b6d","eff0de7f2dbb42dfa1a2e686efab5b6d",22855232,4,0,1,1152,354,354,0
"eff0de7f2dbb42dfa1a2e686efab5b6d","2fe14166dc9642c3bc666b86a57f943d",22855232,1,4,0,1155,354,357,3
"2fe14166dc9642c3bc666b86a57f943d","30ead9794d4847abaf222ca966cc8630",22855232,2,-10,0,1156,357,348,-9
"30ead9794d4847abaf222ca966cc8630","44421dd1e13a47a388c4a19834b744c7",22855232,1,12,0,1157,348,359,11
"44421dd1e13a47a388c4a19834b744c7","44421dd1e13a47a388c4a19834b744c7",22855232,2,0,1,1158,359,359,0
"44421dd1e13a47a388c4a19834b744c7","cb5fc7ef85d547c4be1a7439d0bf6052",22855232,1,1,0,1160,359,360,1
"cb5fc7ef85d547c4be1a7439d0bf6052","cb5fc7ef85d547c4be1a7439d0bf6052",22855232,5,0,1,1161,360,360,0
"cb5fc7ef85d547c4be1a7439d0bf6052","0a8f150a4cf747acbde62f4721823da3",22855232,1,1,0,1166,360,361,1
"0a8f150a4cf747acbde62f4721823da3","0a8f150a4cf747acbde62f4721823da3",22855232,5,0,1,1167,361,361,0
"0a8f150a4cf747acbde62f4721823da3","ab8fdad974ae471f9f24c3f9dd04462e",22855232,1,1,0,1172,361,362,1
"ab8fdad974ae471f9f24c3f9dd04462e","ab8fdad974ae471f9f24c3f9dd04462e",22855232,2,0,1,1173,362,362,0
"ab8fdad974ae471f9f24c3f9dd04462e","52580888dadb4fe3baa795683ea227bd",22855232,1,3,0,1175,362,364,2
"52580888dadb4fe3baa795683ea227bd","1ba8fef685d74a8194b9db252eb704fb",22855232,1,-10,0,1176,364,355,-9
"1ba8fef685d74a8194b9db252eb704fb","52580888dadb4fe3baa795683ea227bd",22855232,1,10,0,1177,355,364,9
"52580888dadb4fe3baa795683ea227bd","52580888dadb4fe3baa795683ea227bd",22855232,1,0,1,1178,364,364,0
"52580888dadb4fe3baa795683ea227bd","f00179e251a045b39c3f7a54f9aa4acc",22855232,1,-1,0,1179,364,363,-1
"f00179e251a045b39c3f7a54f9aa4acc","492a3bc6a1254f23a7998587961b22a4",22855232,1,4,0,1180,363,366,3
"492a3bc6a1254f23a7998587961b22a4","492a3bc6a1254f23a7998587961b22a4",22855232,1,0,1,1181,366,366,0
"492a3bc6a1254f23a7998587961b22a4","072a190fd302456290895f9f04d6940a",22855232,1,-1,0,1182,366,365,-1
"072a190fd302456290895f9f04d6940a","30ead9794d4847abaf222ca966cc8630",22855232,1,-20,0,1183,365,348,-17
"30ead9794d4847abaf222ca966cc8630","30ead9794d4847abaf222ca966cc8630",22855232,1,0,1,1184,348,348,0
"30ead9794d4847abaf222ca966cc8630","09b9678ddc3d452ea4a3d46e15826065",22855232,1,5,0,1185,348,353,5
"09b9678ddc3d452ea4a3d46e15826065","897b7f51242c44aab2205c72fdcbf4cd",22855232,1,-1,0,1186,353,352,-1
"897b7f51242c44aab2205c72fdcbf4cd","eff0de7f2dbb42dfa1a2e686efab5b6d",22855232,1,2,0,1187,352,354,2
"eff0de7f2dbb42dfa1a2e686efab5b6d","09b9678ddc3d452ea4a3d46e15826065",22855232,1,-1,0,1189,354,353,-1
"897b7f51242c44aab2205c72fdcbf4cd","2fe14166dc9642c3bc666b86a57f943d",22855232,1,6,0,1197,352,357,5
"30ead9794d4847abaf222ca966cc8630","cfa457d1743848e4bb5e4beced6448ed",22855232,1,25,0,1199,348,369,21
"cfa457d1743848e4bb5e4beced6448ed","cfa457d1743848e4bb5e4beced6448ed",22855232,1,0,1,1200,369,369,0
"cfa457d1743848e4bb5e4beced6448ed","30ead9794d4847abaf222ca966cc8630",22855232,1,-25,0,1201,369,348,-21
"30ead9794d4847abaf222ca966cc8630","b71bac264efb4abd97015447bd490db6",22855232,1,28,0,1202,348,370,22
"b71bac264efb4abd97015447bd490db6","8d448d625b024c82a5eb240bbd7431d6",22855232,4,5,0,1203,370,374,4
"8d448d625b024c82a5eb240bbd7431d6","8d448d625b024c82a5eb240bbd7431d6",22855232,67,0,1,1204,374,374,0
"8d448d625b024c82a5eb240bbd7431d6","b71bac264efb4abd97015447bd490db6",22855232,2,-5,0,1208,374,370,-4
"b71bac264efb4abd97015447bd490db6","d6d02b6ef04e4f17805504500b8ce441",22855232,1,8,0,1258,370,375,5
"d6d02b6ef04e4f17805504500b8ce441","d6d02b6ef04e4f17805504500b8ce441",22855232,1,0,1,1259,375,375,0
"d6d02b6ef04e4f17805504500b8ce441","b71bac264efb4abd97015447bd490db6",22855232,1,-8,0,1260,375,370,-5
"8d448d625b024c82a5eb240bbd7431d6","0d987bed3ffa4ed0b9a2e62e97b7b30f",22855232,1,-137,0,1269,374,272,-102
"0d987bed3ffa4ed0b9a2e62e97b7b30f","bb5a47f5ea01454a8b79455422d3b9da",22855232,2,10,0,1270,272,280,8
"bb5a47f5ea01454a8b79455422d3b9da","bc5524e78a8544e2ae2fdc2f3462bbec",22855232,1,-1,0,1278,280,279,-1
"bc5524e78a8544e2ae2fdc2f3462bbec","0d987bed3ffa4ed0b9a2e62e97b7b30f",22855232,2,-9,0,1279,279,272,-7
"0d987bed3ffa4ed0b9a2e62e97b7b30f","bc5524e78a8544e2ae2fdc2f3462bbec",22855232,1,9,0,1280,272,279,7
"bc5524e78a8544e2ae2fdc2f3462bbec","bb5a47f5ea01454a8b79455422d3b9da",22855232,1,1,0,1281,279,280,1
"bb5a47f5ea01454a8b79455422d3b9da","b71bac264efb4abd97015447bd490db6",22855232,1,122,0,1289,280,370,90
"8d448d625b024c82a5eb240bbd7431d6","bc5524e78a8544e2ae2fdc2f3462bbec",22855232,1,-128,0,1300,374,279,-95
"bc5524e78a8544e2ae2fdc2f3462bbec","bc5524e78a8544e2ae2fdc2f3462bbec",22855232,1,0,1,1301,279,279,0
"bb5a47f5ea01454a8b79455422d3b9da","66baf19b6b904b70922329068c63746d",22855232,1,134,0,1311,280,376,96
"66baf19b6b904b70922329068c63746d","66baf19b6b904b70922329068c63746d",22855232,3,0,1,1312,376,376,0
"66baf19b6b904b70922329068c63746d","7f544639412e40a9ba27f43b415362ab",22855232,3,2,0,1313,376,378,2
"7f544639412e40a9ba27f43b415362ab","d5ae8642e15b46b8bd298b02274d4e9c",22855232,1,2,0,1314,378,380,2
"d5ae8642e15b46b8bd298b02274d4e9c","d5ae8642e15b46b8bd298b02274d4e9c",22855232,4,0,1,1315,380,380,0
"d5ae8642e15b46b8bd298b02274d4e9c","a0d10309a2dd456289147f84be9d37f9",22855232,1,1,0,1319,380,381,1
"a0d10309a2dd456289147f84be9d37f9","a0d10309a2dd456289147f84be9d37f9",22855232,2,0,1,1320,381,381,0
"a0d10309a2dd456289147f84be9d37f9","0fcbc3ca07b144138b8d85da581f09a8",22855232,1,1,0,1322,381,382,1
"0fcbc3ca07b144138b8d85da581f09a8","0fcbc3ca07b144138b8d85da581f09a8",22855232,8,0,1,1323,382,382,0
"0fcbc3ca07b144138b8d85da581f09a8","66baf19b6b904b70922329068c63746d",22855232,1,-6,0,1331,382,376,-6
"66baf19b6b904b70922329068c63746d","c2fca3669923477ab966ded303dea31c",22855232,1,8,0,1332,376,383,7
"c2fca3669923477ab966ded303dea31c","4890121ce5d74576b4632b77cfc23398",22855232,1,6,0,1333,383,388,5
"4890121ce5d74576b4632b77cfc23398","4890121ce5d74576b4632b77cfc23398",22855232,1,0,1,1334,388,388,0
"4890121ce5d74576b4632b77cfc23398","18d3b836dd804224883cc9180b60a8e1",22855232,1,-1,0,1335,388,387,-1
"18d3b836dd804224883cc9180b60a8e1","96bb2b3e85a34d8b9544514e89f6fe97",22855232,1,4,0,1336,387,390,3
"96bb2b3e85a34d8b9544514e89f6fe97","96bb2b3e85a34d8b9544514e89f6fe97",22855232,1,0,1,1337,390,390,0
"96bb2b3e85a34d8b9544514e89f6fe97","ac4e9b54acfe4670b4634859c7263cb5",22855232,1,2,0,1338,390,392,2
"ac4e9b54acfe4670b4634859c7263cb5","ac4e9b54acfe4670b4634859c7263cb5",22855232,2,0,1,1339,392,392,0
"ac4e9b54acfe4670b4634859c7263cb5","66baf19b6b904b70922329068c63746d",22855232,1,-19,0,1340,392,376,-16
"7f544639412e40a9ba27f43b415362ab","ac4e9b54acfe4670b4634859c7263cb5",22855232,1,17,0,1343,378,392,14
"ac4e9b54acfe4670b4634859c7263cb5","17f95d18bab743888e1736033dc3384d",22855232,1,-3,0,1345,392,389,-3
"17f95d18bab743888e1736033dc3384d","6f8881a745ac4c358a68b92c3b4abe81",22855232,1,6,0,1346,389,394,5
"6f8881a745ac4c358a68b92c3b4abe81","6f8881a745ac4c358a68b92c3b4abe81",22855232,2,0,1,1347,394,394,0
"6f8881a745ac4c358a68b92c3b4abe81","f7002c8484354eceac57bc7bd62c76c1",22855232,2,-1,0,1348,394,393,-1
"f7002c8484354eceac57bc7bd62c76c1","66baf19b6b904b70922329068c63746d",22855232,1,-21,0,1349,393,376,-17
"66baf19b6b904b70922329068c63746d","6f8881a745ac4c358a68b92c3b4abe81",22855232,1,22,0,1350,376,394,18
"f7002c8484354eceac57bc7bd62c76c1","44a277ea44dc4ae689fab4b82f0b4098",22855232,1,5,0,1353,393,397,4
"44a277ea44dc4ae689fab4b82f0b4098","44a277ea44dc4ae689fab4b82f0b4098",22855232,1,0,1,1354,397,397,0
"44a277ea44dc4ae689fab4b82f0b4098","0c12af0a4e7f4002852cf84b2537c161",22855232,1,-2,0,1355,397,395,-2
"0c12af0a4e7f4002852cf84b2537c161","859e0b8d71694b12befb69ee698138f9",22855232,1,5,0,1356,395,399,4
"859e0b8d71694b12befb69ee698138f9","859e0b8d71694b12befb69ee698138f9",22855232,1,0,1,1357,399,399,0
"859e0b8d71694b12befb69ee698138f9","2b09a08242b54983aec7063990fb3f66",22855232,1,3,0,1358,399,400,1
"2b09a08242b54983aec7063990fb3f66","66baf19b6b904b70922329068c63746d",22855232,1,-32,0,1359,400,376,-24
"66baf19b6b904b70922329068c63746d","2b09a08242b54983aec7063990fb3f66",22855232,1,32,0,1360,376,400,24
"2b09a08242b54983aec7063990fb3f66","2b09a08242b54983aec7063990fb3f66",22855232,1,0,1,1361,400,400,0
"2b09a08242b54983aec7063990fb3f66","1f471b7a883a4df48211e8c6a81b59a7",22855232,1,1,0,1362,400,401,1
"1f471b7a883a4df48211e8c6a81b59a7","1f471b7a883a4df48211e8c6a81b59a7",22855232,3,0,1,1363,401,401,0
"1f471b7a883a4df48211e8c6a81b59a7","2b09a08242b54983aec7063990fb3f66",22855232,1,-1,0,1366,401,400,-1
"2b09a08242b54983aec7063990fb3f66","9de0d567bfa84fe5b77cb76f4a76a5d1",22855232,1,5,0,1367,400,404,4
"9de0d567bfa84fe5b77cb76f4a76a5d1","9de0d567bfa84fe5b77cb76f4a76a5d1",22855232,1,0,1,1368,404,404,0
"9de0d567bfa84fe5b77cb76f4a76a5d1","1157bd665ec4472fb58b751dc5099355",22855232,1,-1,0,1369,404,403,-1
"1157bd665ec4472fb58b751dc5099355","c1c1be90b2b14c1ab4a5e1ee3c241902",22855232,1,6,0,1370,403,407,4
"c1c1be90b2b14c1ab4a5e1ee3c241902","c1c1be90b2b14c1ab4a5e1ee3c241902",22855232,5,0,1,1371,407,407,0
"c1c1be90b2b14c1ab4a5e1ee3c241902","58fc9094275e4c49be3f4ba6d4acc0a4",22855232,1,-1,0,1376,407,406,-1
"58fc9094275e4c49be3f4ba6d4acc0a4","6206fc6479014bb193084c32409dc1b9",22855232,1,4,0,1377,406,409,3
"6206fc6479014bb193084c32409dc1b9","6206fc6479014bb193084c32409dc1b9",22855232,3,0,1,1378,409,409,0
"6206fc6479014bb193084c32409dc1b9","02b3a1bead9244c1ba2f857c7da8f82a",22855232,1,-1,0,1380,409,408,-1
"02b3a1bead9244c1ba2f857c7da8f82a","6206fc6479014bb193084c32409dc1b9",22855232,1,1,0,1381,408,409,1
"6206fc6479014bb193084c32409dc1b9","6a5f020451db426dacba9e2ea3fcc62a",22855232,1,2,0,1383,409,410,1
"6a5f020451db426dacba9e2ea3fcc62a","02b3a1bead9244c1ba2f857c7da8f82a",22855232,1,-3,0,1384,410,408,-2
"02b3a1bead9244c1ba2f857c7da8f82a","6a5f020451db426dacba9e2ea3fcc62a",22855232,1,3,0,1385,408,410,2
"6a5f020451db426dacba9e2ea3fcc62a","6a5f020451db426dacba9e2ea3fcc62a",22855232,2,0,1,1386,410,410,0
"6a5f020451db426dacba9e2ea3fcc62a","33a9d248b2e44588a5b07fc1342b9bc2",22855232,1,2,0,1388,410,411,1
"33a9d248b2e44588a5b07fc1342b9bc2","33a9d248b2e44588a5b07fc1342b9bc2",22855232,1,0,1,1389,411,411,0
"33a9d248b2e44588a5b07fc1342b9bc2","c6f26bd420634f1cb7989e76fe6b16c0",22855232,1,1,0,1390,411,412,1
"c6f26bd420634f1cb7989e76fe6b16c0","c6f26bd420634f1cb7989e76fe6b16c0",22855232,5,0,1,1391,412,412,0
"c6f26bd420634f1cb7989e76fe6b16c0","2a65ee6e2ac64f6a8a55fbe5373ec763",22855232,1,1,0,1396,412,413,1
"2a65ee6e2ac64f6a8a55fbe5373ec763","2a65ee6e2ac64f6a8a55fbe5373ec763",22855232,2,0,1,1397,413,413,0
"2a65ee6e2ac64f6a8a55fbe5373ec763","33a9d248b2e44588a5b07fc1342b9bc2",22855232,1,-2,0,1399,413,411,-2
"33a9d248b2e44588a5b07fc1342b9bc2","1fd0f6dadbc14ebc965faf6122190b96",22855232,1,5,0,1400,411,415,4
"1fd0f6dadbc14ebc965faf6122190b96","1fd0f6dadbc14ebc965faf6122190b96",22855232,1,0,1,1401,415,415,0
"1fd0f6dadbc14ebc965faf6122190b96","687055dad9fc40c3982478fe33ec01bf",22855232,1,-1,0,1402,415,414,-1
"687055dad9fc40c3982478fe33ec01bf","2add1669f08d4101913db15f8c23b3b7",22855232,1,3,0,1403,414,416,2
"2add1669f08d4101913db15f8c23b3b7","2add1669f08d4101913db15f8c23b3b7",22855232,1,0,1,1404,416,416,0
"2add1669f08d4101913db15f8c23b3b7","2b09a08242b54983aec7063990fb3f66",22855232,1,-24,0,1405,416,400,-16
"2b09a08242b54983aec7063990fb3f66","a2b4bd40cee2481ebd3fc179d6a5cd62",22855232,1,27,0,1406,400,417,17
"a2b4bd40cee2481ebd3fc179d6a5cd62","e34e59dce2204f228f3a84b6725df60f",22855232,1,2,0,1407,417,419,2
"e34e59dce2204f228f3a84b6725df60f","e34e59dce2204f228f3a84b6725df60f",22855232,1,0,1,1408,419,419,0
"e34e59dce2204f228f3a84b6725df60f","a2b4bd40cee2481ebd3fc179d6a5cd62",22855232,1,-2,0,1409,419,417,-2
"a2b4bd40cee2481ebd3fc179d6a5cd62","bec48fc2e1294c7eb3d0aca780d731b8",22855232,1,4,0,1410,417,420,3
"bec48fc2e1294c7eb3d0aca780d731b8","bec48fc2e1294c7eb3d0aca780d731b8",22855232,3,0,1,1411,420,420,0
"bec48fc2e1294c7eb3d0aca780d731b8","dbde19fcce2a4c1abdc7f685c293a23f",22855232,1,3,0,1414,420,422,2
"dbde19fcce2a4c1abdc7f685c293a23f","a24600b0e49245f6bdba8c893cfeddb0",22855232,1,4,0,1415,422,425,3
"a24600b0e49245f6bdba8c893cfeddb0","a24600b0e49245f6bdba8c893cfeddb0",22855232,2,0,1,1416,425,425,0
"a24600b0e49245f6bdba8c893cfeddb0","a2b4bd40cee2481ebd3fc179d6a5cd62",22855232,1,-11,0,1418,425,417,-8
"a2b4bd40cee2481ebd3fc179d6a5cd62","24cf8786024543f19b89bc20034e60d7",22855232,1,18,0,1419,417,428,11
"24cf8786024543f19b89bc20034e60d7","f2a73be2f46840b182d7bd095378004e",22855232,1,1,0,1420,428,429,1
"f2a73be2f46840b182d7bd095378004e","f2a73be2f46840b182d7bd095378004e",22855232,1,0,1,1421,429,429,0
"f2a73be2f46840b182d7bd095378004e","604551fd4266430cb860fef58fa7dd61",22855232,1,1,0,1422,429,430,1
"604551fd4266430cb860fef58fa7dd61","604551fd4266430cb860fef58fa7dd61",22855232,8,0,1,1423,430,430,0
"604551fd4266430cb860fef58fa7dd61","24cf8786024543f19b89bc20034e60d7",22855232,1,-2,0,1431,430,428,-2
"24cf8786024543f19b89bc20034e60d7","dce46f8904594a62a6377a3587aaa663",22855232,1,4,0,1432,428,431,3
"dce46f8904594a62a6377a3587aaa663","dce46f8904594a62a6377a3587aaa663",22855232,1,0,1,1433,431,431,0
"dce46f8904594a62a6377a3587aaa663","9b9d0a249052413c869753b99682b0ac",22855232,1,1,0,1434,431,432,1
"9b9d0a249052413c869753b99682b0ac","9b9d0a249052413c869753b99682b0ac",22855232,5,0,1,1435,432,432,0
"9b9d0a249052413c869753b99682b0ac","061c175cc90f45fbad883025394e78dd",22855232,1,1,0,1440,432,433,1
"061c175cc90f45fbad883025394e78dd","061c175cc90f45fbad883025394e78dd",22855232,5,0,1,1441,433,433,0
"061c175cc90f45fbad883025394e78dd","dce46f8904594a62a6377a3587aaa663",22855232,1,-2,0,1446,433,431,-2
"dce46f8904594a62a6377a3587aaa663","74a7f8712e5449c2bc0b43c6f90dafed",22855232,1,5,0,1447,431,435,4
"74a7f8712e5449c2bc0b43c6f90dafed","74a7f8712e5449c2bc0b43c6f90dafed",22855232,2,0,1,1448,435,435,0
"74a7f8712e5449c2bc0b43c6f90dafed","66ada10dde9f43018588f1ced9d477fc",22855232,1,-1,0,1450,435,434,-1
"66ada10dde9f43018588f1ced9d477fc","bf12c96466d840a69bed7020b3f18bb8",22855232,1,3,0,1451,434,436,2
"bf12c96466d840a69bed7020b3f18bb8","bf12c96466d840a69bed7020b3f18bb8",22855232,1,0,1,1452,436,436,0
"bf12c96466d840a69bed7020b3f18bb8","070600601c4c439288445d2f0724807d",22855232,1,3,0,1453,436,437,1
"070600601c4c439288445d2f0724807d","24cf8786024543f19b89bc20034e60d7",22855232,1,-14,0,1454,437,428,-9
"24cf8786024543f19b89bc20034e60d7","1823b6de7d334a7aaabc4570719af4d9",22855232,1,16,0,1455,428,439,11
"1823b6de7d334a7aaabc4570719af4d9","1823b6de7d334a7aaabc4570719af4d9",22855232,16,0,1,1456,439,439,0
"1823b6de7d334a7aaabc4570719af4d9","070600601c4c439288445d2f0724807d",22855232,1,-2,0,1472,439,437,-2
"070600601c4c439288445d2f0724807d","0380cd76a7d44bc3a4da1f15e4d68f89",22855232,1,4,0,1473,437,440,3
"0380cd76a7d44bc3a4da1f15e4d68f89","0380cd76a7d44bc3a4da1f15e4d68f89",22855232,1,0,1,1474,440,440,0
"0380cd76a7d44bc3a4da1f15e4d68f89","23b7673c8b5443108c2ef09382834a86",22855232,1,2,0,1475,440,441,1
"23b7673c8b5443108c2ef09382834a86","23b7673c8b5443108c2ef09382834a86",22855232,1,0,1,1476,441,441,0
"23b7673c8b5443108c2ef09382834a86","901e92500aea43c79f19f1b279050668",22855232,1,2,0,1477,441,442,1
"901e92500aea43c79f19f1b279050668","001339db8ced4cf78829ebe8b145449d",22855232,1,1,0,1478,442,443,1
"001339db8ced4cf78829ebe8b145449d","001339db8ced4cf78829ebe8b145449d",22855232,11,0,1,1479,443,443,0
"001339db8ced4cf78829ebe8b145449d","452745e0366e42ae81561bfddebcc6c3",22855232,1,1,0,1490,443,444,1
"452745e0366e42ae81561bfddebcc6c3","452745e0366e42ae81561bfddebcc6c3",22855232,2,0,1,1491,444,444,0
"452745e0366e42ae81561bfddebcc6c3","901e92500aea43c79f19f1b279050668",22855232,1,-2,0,1493,444,442,-2
"901e92500aea43c79f19f1b279050668","4660ff2089114e8db82ceb26a4f329e3",22855232,1,4,0,1494,442,445,3
"4660ff2089114e8db82ceb26a4f329e3","7bd5586eb9d8484eb74a433ee7bfe499",22855232,2,2,0,1495,445,446,1
"7bd5586eb9d8484eb74a433ee7bfe499","4660ff2089114e8db82ceb26a4f329e3",22855232,1,-2,0,1496,446,445,-1
"7bd5586eb9d8484eb74a433ee7bfe499","7bd5586eb9d8484eb74a433ee7bfe499",22855232,21,0,1,1498,446,446,0
"7bd5586eb9d8484eb74a433ee7bfe499","8a7f26e690f34dda97be16904518ca99",22855232,1,2,0,1519,446,447,1
"8a7f26e690f34dda97be16904518ca99","8a7f26e690f34dda97be16904518ca99",22855232,1,0,1,1520,447,447,0
"8a7f26e690f34dda97be16904518ca99","070600601c4c439288445d2f0724807d",22855232,1,-16,0,1521,447,437,-10
"070600601c4c439288445d2f0724807d","b2f0d654738f48158edff28e8d3a546e",22855232,1,21,0,1522,437,449,12
"b2f0d654738f48158edff28e8d3a546e","f60ee41ec635499abd48168342d32c2f",22855232,4,5,0,1523,449,453,4
"f60ee41ec635499abd48168342d32c2f","f60ee41ec635499abd48168342d32c2f",22855232,65,0,1,1524,453,453,0
"f60ee41ec635499abd48168342d32c2f","b2f0d654738f48158edff28e8d3a546e",22855232,1,-5,0,1531,453,449,-4
"f60ee41ec635499abd48168342d32c2f","f67fbf45a5f146ed866965bc57c7c001",22855232,1,3,0,1575,453,454,1
"f67fbf45a5f146ed866965bc57c7c001","b2f0d654738f48158edff28e8d3a546e",22855232,1,-8,0,1576,454,449,-5
"b2f0d654738f48158edff28e8d3a546e","f67fbf45a5f146ed866965bc57c7c001",22855232,1,8,0,1577,449,454,5
"f67fbf45a5f146ed866965bc57c7c001","f67fbf45a5f146ed866965bc57c7c001",22855232,1,0,1,1578,454,454,0
"f67fbf45a5f146ed866965bc57c7c001","d937afe49bd24a07a550dda1c1155122",22855232,1,1,0,1579,454,455,1
"d937afe49bd24a07a550dda1c1155122","d937afe49bd24a07a550dda1c1155122",22855232,3,0,1,1580,455,455,0
"d937afe49bd24a07a550dda1c1155122","3628b3f7823443d0912a339096b69943",22855232,1,1,0,1583,455,456,1
"3628b3f7823443d0912a339096b69943","3628b3f7823443d0912a339096b69943",22855232,1,0,1,1584,456,456,0
"3628b3f7823443d0912a339096b69943","9e049ee647cf43ecbcb5ed792a8e7588",22855232,1,1,0,1585,456,457,1
"9e049ee647cf43ecbcb5ed792a8e7588","9e049ee647cf43ecbcb5ed792a8e7588",22855232,1,0,1,1586,457,457,0
"9e049ee647cf43ecbcb5ed792a8e7588","5256a214faaf410b93f76cea06428334",22855232,1,1,0,1587,457,458,1
"5256a214faaf410b93f76cea06428334","5256a214faaf410b93f76cea06428334",22855232,1,0,1,1588,458,458,0
"5256a214faaf410b93f76cea06428334","25c32b120fce40fa9b6c85133aeb4716",22855232,1,1,0,1589,458,459,1
"25c32b120fce40fa9b6c85133aeb4716","25c32b120fce40fa9b6c85133aeb4716",22855232,1,0,1,1590,459,459,0
"25c32b120fce40fa9b6c85133aeb4716","11bc14f2204949008b7d511b933363c1",22855232,1,1,0,1591,459,460,1
"11bc14f2204949008b7d511b933363c1","11bc14f2204949008b7d511b933363c1",22855232,1,0,1,1592,460,460,0
"11bc14f2204949008b7d511b933363c1","42de338840a34d15adb66e7b14fb9d2c",22855232,1,1,0,1593,460,461,1
"42de338840a34d15adb66e7b14fb9d2c","42de338840a34d15adb66e7b14fb9d2c",22855232,1,0,1,1594,461,461,0
"42de338840a34d15adb66e7b14fb9d2c","66baf19b6b904b70922329068c63746d",22855232,1,-127,0,1595,461,376,-85
"7f544639412e40a9ba27f43b415362ab","9da37c6210b1416b8079c274f70bf600",22855232,1,126,0,1598,378,462,84
"9da37c6210b1416b8079c274f70bf600","9da37c6210b1416b8079c274f70bf600",22855232,1,0,1,1599,462,462,0
"9da37c6210b1416b8079c274f70bf600","519119f1deac45ff9ab4f13529be5c6e",22855232,1,1,0,1600,462,463,1
"519119f1deac45ff9ab4f13529be5c6e","519119f1deac45ff9ab4f13529be5c6e",22855232,1,0,1,1601,463,463,0
"519119f1deac45ff9ab4f13529be5c6e","f67fbf45a5f146ed866965bc57c7c001",22855232,1,-9,0,1602,463,454,-9
"f67fbf45a5f146ed866965bc57c7c001","c5df9f40ec14463b9dcfdc73df3e9285",22855232,1,12,0,1603,454,464,10
"c5df9f40ec14463b9dcfdc73df3e9285","c5df9f40ec14463b9dcfdc73df3e9285",22855232,2,0,1,1604,464,464,0
"c5df9f40ec14463b9dcfdc73df3e9285","83d42d95cd844fc093fc09cee250edb8",22855232,1,3,0,1606,464,465,1
"83d42d95cd844fc093fc09cee250edb8","83d42d95cd844fc093fc09cee250edb8",22855232,2,0,1,1607,465,465,0
"83d42d95cd844fc093fc09cee250edb8","b2f0d654738f48158edff28e8d3a546e",22855232,1,-23,0,1609,465,449,-16
"f60ee41ec635499abd48168342d32c2f","9428d8bd9c5a47b2a235b254e5e27ded",22855232,1,-1,0,1620,453,452,-1
"9428d8bd9c5a47b2a235b254e5e27ded","9428d8bd9c5a47b2a235b254e5e27ded",22855232,1,0,1,1621,452,452,0
"9428d8bd9c5a47b2a235b254e5e27ded","b2f0d654738f48158edff28e8d3a546e",22855232,1,-4,0,1622,452,449,-3
"67a089198fcb4e1c8f2385786c2b296f","b613861cecf84ffcab01afb23f660475",22855361,1,-72,0,1,39,1,-38
"b613861cecf84ffcab01afb23f660475","b613861cecf84ffcab01afb23f660475",22855361,2,0,1,2,1,1,0
"b613861cecf84ffcab01afb23f660475","e2911e79efc2420eac45d9f671463d4b",22855361,2,3,0,4,1,2,1
"e2911e79efc2420eac45d9f671463d4b","b613861cecf84ffcab01afb23f660475",22855361,1,-3,0,5,2,1,-1
"e2911e79efc2420eac45d9f671463d4b","e2911e79efc2420eac45d9f671463d4b",22855361,1,0,1,7,2,2,0
"e2911e79efc2420eac45d9f671463d4b","519d1b8c59404d67b54e96c5c8a830b2",22855361,1,1,0,8,2,3,1
"519d1b8c59404d67b54e96c5c8a830b2","519d1b8c59404d67b54e96c5c8a830b2",22855361,1,0,1,9,3,3,0
"519d1b8c59404d67b54e96c5c8a830b2","531db53f81f646edb0cdcfe0085b03b7",22855361,1,1,0,10,3,4,1
"531db53f81f646edb0cdcfe0085b03b7","531db53f81f646edb0cdcfe0085b03b7",22855361,1,0,1,11,4,4,0
"531db53f81f646edb0cdcfe0085b03b7","4f5f94b2f95141e0a9d53a61da2276da",22855361,1,1,0,12,4,5,1
"4f5f94b2f95141e0a9d53a61da2276da","4f5f94b2f95141e0a9d53a61da2276da",22855361,1,0,1,13,5,5,0
"4f5f94b2f95141e0a9d53a61da2276da","6d541c89590949f99af293c4f2333f67",22855361,1,1,0,14,5,6,1
"6d541c89590949f99af293c4f2333f67","6d541c89590949f99af293c4f2333f67",22855361,1,0,1,15,6,6,0
"6d541c89590949f99af293c4f2333f67","dd5cf0b9fe4c4f1d8f5ff8e4c04879cb",22855361,1,1,0,16,6,7,1
"dd5cf0b9fe4c4f1d8f5ff8e4c04879cb","dd5cf0b9fe4c4f1d8f5ff8e4c04879cb",22855361,1,0,1,17,7,7,0
"dd5cf0b9fe4c4f1d8f5ff8e4c04879cb","f96261861edc426abe2248be4f0a709a",22855361,1,1,0,18,7,8,1
"f96261861edc426abe2248be4f0a709a","f96261861edc426abe2248be4f0a709a",22855361,1,0,1,19,8,8,0
"f96261861edc426abe2248be4f0a709a","66b5e16f4f75454fb5b8172079f0fa83",22855361,1,1,0,20,8,9,1
"66b5e16f4f75454fb5b8172079f0fa83","66b5e16f4f75454fb5b8172079f0fa83",22855361,1,0,1,21,9,9,0
"66b5e16f4f75454fb5b8172079f0fa83","0680571d4698477995e41842c36a54b2",22855361,1,1,0,22,9,10,1
"0680571d4698477995e41842c36a54b2","0680571d4698477995e41842c36a54b2",22855361,1,0,1,23,10,10,0
"0680571d4698477995e41842c36a54b2","9112f2bffece48e08c6d2287be204085",22855361,1,1,0,24,10,11,1
"9112f2bffece48e08c6d2287be204085","9112f2bffece48e08c6d2287be204085",22855361,1,0,1,25,11,11,0
"9112f2bffece48e08c6d2287be204085","e2911e79efc2420eac45d9f671463d4b",22855361,1,-9,0,26,11,2,-9
"e2911e79efc2420eac45d9f671463d4b","56586aa865414f538729c7f7735d2bc6",22855361,1,12,0,27,2,12,10
"56586aa865414f538729c7f7735d2bc6","56586aa865414f538729c7f7735d2bc6",22855361,3,0,1,28,12,12,0
"56586aa865414f538729c7f7735d2bc6","b7f2b31585d94eb3bf86376714aa7070",22855361,1,2,0,31,12,13,1
"b7f2b31585d94eb3bf86376714aa7070","b7f2b31585d94eb3bf86376714aa7070",22855361,2,0,1,32,13,13,0
"b7f2b31585d94eb3bf86376714aa7070","3f1c815879794b929260d224becaff7e",22855361,1,2,0,34,13,14,1
"3f1c815879794b929260d224becaff7e","81c864a886d54a6b8ff85f7d736f4f95",22855361,1,2,0,35,14,15,1
"81c864a886d54a6b8ff85f7d736f4f95","5c5ceeee4562457ba6d41515aeebfbb1",22855361,1,4,0,36,15,17,2
"5c5ceeee4562457ba6d41515aeebfbb1","5c5ceeee4562457ba6d41515aeebfbb1",22855361,2,0,1,37,17,17,0
"5c5ceeee4562457ba6d41515aeebfbb1","9afd71a5298d4333b6849dfce1b9422c",22855361,1,3,0,39,17,18,1
"9afd71a5298d4333b6849dfce1b9422c","56586aa865414f538729c7f7735d2bc6",22855361,1,-13,0,40,18,12,-6
"56586aa865414f538729c7f7735d2bc6","9afd71a5298d4333b6849dfce1b9422c",22855361,1,13,0,41,12,18,6
"9afd71a5298d4333b6849dfce1b9422c","9afd71a5298d4333b6849dfce1b9422c",22855361,1,0,1,42,18,18,0
"9afd71a5298d4333b6849dfce1b9422c","b7719e26494940efa49512aedd0aac79",22855361,1,4,0,43,18,20,2
"b7719e26494940efa49512aedd0aac79","d4f45188d3c84a02ba08454e6403a818",22855361,2,5,0,44,20,24,4
"d4f45188d3c84a02ba08454e6403a818","d4c3b003e8274e429d2fa688d73fde6d",22855361,3,-2,0,45,24,22,-2
"d4c3b003e8274e429d2fa688d73fde6d","d4c3b003e8274e429d2fa688d73fde6d",22855361,1,0,1,46,22,22,0
"d4c3b003e8274e429d2fa688d73fde6d","b7719e26494940efa49512aedd0aac79",22855361,2,-3,0,47,22,20,-2
"b7719e26494940efa49512aedd0aac79","afbf7250b99d47bea07172749483ca97",22855361,3,12,0,48,20,28,8
"afbf7250b99d47bea07172749483ca97","b7719e26494940efa49512aedd0aac79",22855361,1,-12,0,49,28,20,-8
"afbf7250b99d47bea07172749483ca97","4e51676dc72045d99c19b9fa7b22f8bc",22855361,2,3,0,51,28,29,1
"4e51676dc72045d99c19b9fa7b22f8bc","4e51676dc72045d99c19b9fa7b22f8bc",22855361,3,0,1,52,29,29,0
"4e51676dc72045d99c19b9fa7b22f8bc","51970cfa30e643e894e66ae85c8024cc",22855361,2,3,0,53,29,31,2
"51970cfa30e643e894e66ae85c8024cc","c33c17be71ae4d588da7369472e5bb1b",22855361,1,6,0,54,31,34,3
"c9c52446b6294aa5a9c2abaed536c37e","51970cfa30e643e894e66ae85c8024cc",22855361,1,-2,0,63,32,31,-1
"51970cfa30e643e894e66ae85c8024cc","4e51676dc72045d99c19b9fa7b22f8bc",22855361,2,-3,0,64,31,29,-2
"4e51676dc72045d99c19b9fa7b22f8bc","afbf7250b99d47bea07172749483ca97",22855361,1,-3,0,65,29,28,-1
"afbf7250b99d47bea07172749483ca97","afbf7250b99d47bea07172749483ca97",22855361,1,0,1,66,28,28,0
"c33c17be71ae4d588da7369472e5bb1b","93679be414554a11b1893002f2229a93",22855361,1,3,0,73,34,35,1
"93679be414554a11b1893002f2229a93","7040a13096d746ac84b8fac8d9752058",22855361,1,3,0,74,35,36,1
"7040a13096d746ac84b8fac8d9752058","93679be414554a11b1893002f2229a93",22855361,1,-3,0,75,36,35,-1
"93679be414554a11b1893002f2229a93","9a0dc646f934470daf08c4b56ccf73db",22855361,1,6,0,76,35,37,2
"9a0dc646f934470daf08c4b56ccf73db","7040a13096d746ac84b8fac8d9752058",22855361,1,-3,0,77,37,36,-1
"7040a13096d746ac84b8fac8d9752058","9a0dc646f934470daf08c4b56ccf73db",22855361,1,3,0,78,36,37,1
"9a0dc646f934470daf08c4b56ccf73db","fc0e049d56024bc9a02c9a9c435c3df7",22855361,1,3,0,79,37,38,1
"64d48c6c9c7940639a932219a6c87198","67a089198fcb4e1c8f2385786c2b296f",22855361,3,-1,0,83,40,39,-1
"64d48c6c9c7940639a932219a6c87198","64d48c6c9c7940639a932219a6c87198",22855361,1,0,1,85,40,40,0
"b534b89233134e30a9b5645138bfa9ee","0e37b720d23b4e7f8b313e79313fd107",22855361,1,3,0,88,41,44,3
"0e37b720d23b4e7f8b313e79313fd107","0e37b720d23b4e7f8b313e79313fd107",22855361,1,0,1,89,44,44,0
"0e37b720d23b4e7f8b313e79313fd107","6875d67fdd5f48168b62719df449bebd",22855361,1,1,0,90,44,45,1
"6875d67fdd5f48168b62719df449bebd","6875d67fdd5f48168b62719df449bebd",22855361,4,0,1,91,45,45,0
"6875d67fdd5f48168b62719df449bebd","6e13d61a7bdb44bca949c9f86fab3be5",22855361,1,3,0,95,45,47,2
"6e13d61a7bdb44bca949c9f86fab3be5","b534b89233134e30a9b5645138bfa9ee",22855361,1,-7,0,96,47,41,-6
"6e13d61a7bdb44bca949c9f86fab3be5","195f78799f984cc2b06c48dfe36be751",22855361,1,2,0,98,47,49,2
"195f78799f984cc2b06c48dfe36be751","195f78799f984cc2b06c48dfe36be751",22855361,2,0,1,100,49,49,0
"195f78799f984cc2b06c48dfe36be751","d9c8d8c444a64dadbbb508652c721e17",22855361,1,-3,0,101,49,46,-3
"d9c8d8c444a64dadbbb508652c721e17","d0c74f735e024943943e40333d6d337f",22855361,2,6,0,102,46,51,5
"d0c74f735e024943943e40333d6d337f","d0c74f735e024943943e40333d6d337f",22855361,1,0,1,103,51,51,0
"d0c74f735e024943943e40333d6d337f","983f8ff320594b279a7f4a6fe132f9c5",22855361,1,2,0,104,51,53,2
"983f8ff320594b279a7f4a6fe132f9c5","983f8ff320594b279a7f4a6fe132f9c5",22855361,2,0,1,105,53,53,0
"983f8ff320594b279a7f4a6fe132f9c5","35adfa5d923046aebabfefd98f35ff05",22855361,1,1,0,107,53,54,1
"35adfa5d923046aebabfefd98f35ff05","35adfa5d923046aebabfefd98f35ff05",22855361,2,0,1,108,54,54,0
"35adfa5d923046aebabfefd98f35ff05","b6f8a98476224da1b40e555ececc7ed8",22855361,1,1,0,110,54,55,1
"b6f8a98476224da1b40e555ececc7ed8","b6f8a98476224da1b40e555ececc7ed8",22855361,2,0,1,111,55,55,0
"b6f8a98476224da1b40e555ececc7ed8","86e22cb5fe0e4b47a9489ecddf7ed78f",22855361,1,1,0,113,55,56,1
"86e22cb5fe0e4b47a9489ecddf7ed78f","86e22cb5fe0e4b47a9489ecddf7ed78f",22855361,2,0,1,114,56,56,0
"86e22cb5fe0e4b47a9489ecddf7ed78f","f924752d8a1149668870b1e7698486f7",22855361,1,-6,0,116,56,50,-6
"f924752d8a1149668870b1e7698486f7","a1f2f12debe5432fb7a70bcd12bacfb9",22855361,1,9,0,117,50,58,8
"a1f2f12debe5432fb7a70bcd12bacfb9","78f30e4dcac84e3cbea8b2cc6e0d62b3",22855361,2,1,0,118,58,59,1
"78f30e4dcac84e3cbea8b2cc6e0d62b3","a1f2f12debe5432fb7a70bcd12bacfb9",22855361,2,-1,0,119,59,58,-1
"a1f2f12debe5432fb7a70bcd12bacfb9","a1f2f12debe5432fb7a70bcd12bacfb9",22855361,14,0,1,120,58,58,0
"78f30e4dcac84e3cbea8b2cc6e0d62b3","78f30e4dcac84e3cbea8b2cc6e0d62b3",22855361,13,0,1,135,59,59,0
"78f30e4dcac84e3cbea8b2cc6e0d62b3","a0a418b8540d479fa6e0f653b701da8b",22855361,1,6,0,148,59,64,5
"a0a418b8540d479fa6e0f653b701da8b","bc42d26810654ea9a1df1efe1e58c7d5",22855361,1,-1,0,149,64,63,-1
"bc42d26810654ea9a1df1efe1e58c7d5","12aa6e1672ac4e7aa6449a7a8609cd72",22855361,1,-7,0,150,63,57,-6
"12aa6e1672ac4e7aa6449a7a8609cd72","4c943503763e4e349906eea3ed3c8e86",22855361,1,5,0,151,57,61,4
"4c943503763e4e349906eea3ed3c8e86","4c943503763e4e349906eea3ed3c8e86",22855361,1,0,1,152,61,61,0
"4c943503763e4e349906eea3ed3c8e86","309ccf3cc4fe429d9bfbaef53d3fa479",22855361,1,-1,0,153,61,60,-1
"309ccf3cc4fe429d9bfbaef53d3fa479","d646286c8051419bbc2e31dd1db55ca8",22855361,1,10,0,154,60,67,7
"d646286c8051419bbc2e31dd1db55ca8","b534b89233134e30a9b5645138bfa9ee",22855361,1,-33,0,155,67,41,-26
"b534b89233134e30a9b5645138bfa9ee","267f883678b24aed855fde42524975d9",22855361,1,37,0,156,41,71,30
"267f883678b24aed855fde42524975d9","267f883678b24aed855fde42524975d9",22855361,1,0,1,157,71,71,0
"267f883678b24aed855fde42524975d9","88fff56d0342490dbef9040750a20f6c",22855361,1,1,0,158,71,72,1
"88fff56d0342490dbef9040750a20f6c","88fff56d0342490dbef9040750a20f6c",22855361,1,0,1,159,72,72,0
"88fff56d0342490dbef9040750a20f6c","adb17b12b66c4a49a85fd34322f7df70",22855361,1,1,0,160,72,73,1
"adb17b12b66c4a49a85fd34322f7df70","adb17b12b66c4a49a85fd34322f7df70",22855361,1,0,1,161,73,73,0
"adb17b12b66c4a49a85fd34322f7df70","d646286c8051419bbc2e31dd1db55ca8",22855361,1,-6,0,162,73,67,-6
"d646286c8051419bbc2e31dd1db55ca8","a2becd407db34b189200a32546d9d569",22855361,1,9,0,163,67,75,8
"a2becd407db34b189200a32546d9d569","a2becd407db34b189200a32546d9d569",22855361,1,0,1,164,75,75,0
"a2becd407db34b189200a32546d9d569","58c22b011d0f4c2ea6d13615edbb9eeb",22855361,1,2,0,165,75,77,2
"58c22b011d0f4c2ea6d13615edbb9eeb","58c22b011d0f4c2ea6d13615edbb9eeb",22855361,5,0,1,166,77,77,0
"58c22b011d0f4c2ea6d13615edbb9eeb","dd76e1861dc9461c830888729d091ee0",22855361,1,1,0,171,77,78,1
"dd76e1861dc9461c830888729d091ee0","dd76e1861dc9461c830888729d091ee0",22855361,8,0,1,172,78,78,0
"dd76e1861dc9461c830888729d091ee0","cd1d828f1a694b87913a7ea66c23803e",22855361,1,1,0,180,78,79,1
"cd1d828f1a694b87913a7ea66c23803e","cd1d828f1a694b87913a7ea66c23803e",22855361,2,0,1,181,79,79,0
"cd1d828f1a694b87913a7ea66c23803e","9176a3c2b4d2465fa8b0c67096c2a97e",22855361,1,1,0,183,79,80,1
"9176a3c2b4d2465fa8b0c67096c2a97e","9176a3c2b4d2465fa8b0c67096c2a97e",22855361,5,0,1,184,80,80,0
"9176a3c2b4d2465fa8b0c67096c2a97e","f8ec6445f7194e25b9101d4fbcb07a18",22855361,1,1,0,189,80,81,1
"f8ec6445f7194e25b9101d4fbcb07a18","f8ec6445f7194e25b9101d4fbcb07a18",22855361,2,0,1,190,81,81,0
"f8ec6445f7194e25b9101d4fbcb07a18","140d5b27b8574befad82c0a013b59dfa",22855361,1,-7,0,192,81,74,-7
"140d5b27b8574befad82c0a013b59dfa","d18a9ea32855445f8736581f5cb119ce",22855361,1,9,0,193,74,82,8
"d18a9ea32855445f8736581f5cb119ce","f564483cbd7a407681aa2fcca518cf5f",22855361,1,4,0,194,82,85,3
"f564483cbd7a407681aa2fcca518cf5f","f564483cbd7a407681aa2fcca518cf5f",22855361,1,0,1,195,85,85,0
"f564483cbd7a407681aa2fcca518cf5f","18fd01350bd5434ca636d59a599d768a",22855361,1,1,0,196,85,86,1
"18fd01350bd5434ca636d59a599d768a","18fd01350bd5434ca636d59a599d768a",22855361,9,0,1,197,86,86,0
"18fd01350bd5434ca636d59a599d768a","ae5ac430ea254e708a6f5deaaf7464ae",22855361,2,-2,0,206,86,84,-2
"ae5ac430ea254e708a6f5deaaf7464ae","6a9f0ef185fb47f0937e29daa1c71ed5",22855361,3,7,0,207,84,90,6
"6a9f0ef185fb47f0937e29daa1c71ed5","c681290961c94c4caf23b529d1ae6b9a",22855361,2,-2,0,208,90,88,-2
"c681290961c94c4caf23b529d1ae6b9a","c681290961c94c4caf23b529d1ae6b9a",22855361,1,0,1,209,88,88,0
"c681290961c94c4caf23b529d1ae6b9a","6a9f0ef185fb47f0937e29daa1c71ed5",22855361,1,2,0,210,88,90,2
"6a9f0ef185fb47f0937e29daa1c71ed5","6a9f0ef185fb47f0937e29daa1c71ed5",22855361,11,0,1,211,90,90,0
"6a9f0ef185fb47f0937e29daa1c71ed5","e20db35ced8544ddac5bc3839145e463",22855361,2,3,0,214,90,91,1
"e20db35ced8544ddac5bc3839145e463","d646286c8051419bbc2e31dd1db55ca8",22855361,3,-30,0,215,91,67,-24
"d646286c8051419bbc2e31dd1db55ca8","1febb706d7a34005ae8711ed49c76e64",22855361,1,33,0,216,67,94,27
"1febb706d7a34005ae8711ed49c76e64","1febb706d7a34005ae8711ed49c76e64",22855361,6,0,1,217,94,94,0
"1febb706d7a34005ae8711ed49c76e64","8f73ba6f5a0042f2850356ac38ac6f24",22855361,1,1,0,223,94,95,1
"8f73ba6f5a0042f2850356ac38ac6f24","8f73ba6f5a0042f2850356ac38ac6f24",22855361,5,0,1,224,95,95,0
"8f73ba6f5a0042f2850356ac38ac6f24","e2260b86653c46d7b14a41fb419dbf8c",22855361,1,1,0,229,95,96,1
"e2260b86653c46d7b14a41fb419dbf8c","e2260b86653c46d7b14a41fb419dbf8c",22855361,2,0,1,230,96,96,0
"e2260b86653c46d7b14a41fb419dbf8c","35eb641ad1d845bbba54915bce75a962",22855361,1,1,0,232,96,97,1
"35eb641ad1d845bbba54915bce75a962","35eb641ad1d845bbba54915bce75a962",22855361,5,0,1,233,97,97,0
"35eb641ad1d845bbba54915bce75a962","08be90ffbeea4795a138cd42ed8db56f",22855361,1,1,0,238,97,98,1
"08be90ffbeea4795a138cd42ed8db56f","08be90ffbeea4795a138cd42ed8db56f",22855361,6,0,1,239,98,98,0
"08be90ffbeea4795a138cd42ed8db56f","3007433c8f584dcbb5ac159c1c5f2be3",22855361,1,1,0,245,98,99,1
"3007433c8f584dcbb5ac159c1c5f2be3","3007433c8f584dcbb5ac159c1c5f2be3",22855361,5,0,1,246,99,99,0
"3007433c8f584dcbb5ac159c1c5f2be3","00ae5f0c51874a73a41ebea838d95682",22855361,1,3,0,251,99,101,2
"00ae5f0c51874a73a41ebea838d95682","d391c8b6e56a43a7b654e9dee02d904b",22855361,3,2,0,252,101,103,2
"d391c8b6e56a43a7b654e9dee02d904b","e20db35ced8544ddac5bc3839145e463",22855361,2,-13,0,253,103,91,-12
"e20db35ced8544ddac5bc3839145e463","00ae5f0c51874a73a41ebea838d95682",22855361,1,11,0,254,91,101,10
"d391c8b6e56a43a7b654e9dee02d904b","d391c8b6e56a43a7b654e9dee02d904b",22855361,15,0,1,256,103,103,0
"d391c8b6e56a43a7b654e9dee02d904b","6111116566fc4fd9abba409322bea245",22855361,1,1,0,271,103,104,1
"6111116566fc4fd9abba409322bea245","6111116566fc4fd9abba409322bea245",22855361,2,0,1,272,104,104,0
"6111116566fc4fd9abba409322bea245","a81b2235cb9c499eb9ea8ee0a8dd9725",22855361,1,1,0,274,104,105,1
"a81b2235cb9c499eb9ea8ee0a8dd9725","a81b2235cb9c499eb9ea8ee0a8dd9725",22855361,5,0,1,275,105,105,0
"a81b2235cb9c499eb9ea8ee0a8dd9725","2d4e0ab0ef3b4d73b82c72d4621a7579",22855361,1,1,0,280,105,106,1
"2d4e0ab0ef3b4d73b82c72d4621a7579","2d4e0ab0ef3b4d73b82c72d4621a7579",22855361,2,0,1,281,106,106,0
"2d4e0ab0ef3b4d73b82c72d4621a7579","8bdebf492ebd4e62b0d522e8ab5e5197",22855361,1,1,0,283,106,107,1
"8bdebf492ebd4e62b0d522e8ab5e5197","8bdebf492ebd4e62b0d522e8ab5e5197",22855361,8,0,1,284,107,107,0
"8bdebf492ebd4e62b0d522e8ab5e5197","4280927ec4d643238aa49c32f9e06c6c",22855361,1,3,0,292,107,109,2
"4280927ec4d643238aa49c32f9e06c6c","73039f8c1eb9409cb4caee2cf968001e",22855361,2,-10,0,293,109,100,-9
"73039f8c1eb9409cb4caee2cf968001e","4280927ec4d643238aa49c32f9e06c6c",22855361,2,10,0,294,100,109,9
"4280927ec4d643238aa49c32f9e06c6c","fc44e6a5f7654430af1227838224dceb",22855361,1,2,0,295,109,111,2
"fc44e6a5f7654430af1227838224dceb","fc44e6a5f7654430af1227838224dceb",22855361,2,0,1,296,111,111,0
"fc44e6a5f7654430af1227838224dceb","08111f75e22d409998cf8b85bd431f0a",22855361,1,-3,0,298,111,108,-3
"08111f75e22d409998cf8b85bd431f0a","a9ae0a3c070d455bb4369a8996313336",22855361,2,7,0,299,108,114,6
"a9ae0a3c070d455bb4369a8996313336","a9ae0a3c070d455bb4369a8996313336",22855361,1,0,1,300,114,114,0
"a9ae0a3c070d455bb4369a8996313336","71cec822bcff4f30a20e75dc63ef7b65",22855361,1,2,0,301,114,116,2
"71cec822bcff4f30a20e75dc63ef7b65","71cec822bcff4f30a20e75dc63ef7b65",22855361,1,0,1,302,116,116,0
"71cec822bcff4f30a20e75dc63ef7b65","37319e88176d4aefa91d7a9980dbae91",22855361,1,-4,0,303,116,112,-4
"37319e88176d4aefa91d7a9980dbae91","62bff51286ef4f348717a3cf6fe2318f",22855361,1,9,0,304,112,120,8
"62bff51286ef4f348717a3cf6fe2318f","b1cd0e7dc3ad4a8eb91a4bfdbeb025b0",22855361,1,-2,0,305,120,118,-2
"b1cd0e7dc3ad4a8eb91a4bfdbeb025b0","b1cd0e7dc3ad4a8eb91a4bfdbeb025b0",22855361,1,0,1,306,118,118,0
"b1cd0e7dc3ad4a8eb91a4bfdbeb025b0","62bff51286ef4f348717a3cf6fe2318f",22855361,1,2,0,307,118,120,2
"62bff51286ef4f348717a3cf6fe2318f","62bff51286ef4f348717a3cf6fe2318f",22855361,5,0,1,308,120,120,0
"62bff51286ef4f348717a3cf6fe2318f","e20db35ced8544ddac5bc3839145e463",22855361,1,-33,0,311,120,91,-29
"e20db35ced8544ddac5bc3839145e463","779f9ddd1fd14d1e9e69f72219a1fdbd",22855361,2,36,0,312,91,121,30
"779f9ddd1fd14d1e9e69f72219a1fdbd","ae26e6cda8ad4a3f81bd347560d9579f",22855361,1,4,0,313,121,125,4
"ae26e6cda8ad4a3f81bd347560d9579f","ae26e6cda8ad4a3f81bd347560d9579f",22855361,3,0,1,314,125,125,0
"ae26e6cda8ad4a3f81bd347560d9579f","ee48df95832b4374aa273ceb27ec1315",22855361,1,1,0,317,125,126,1
"ee48df95832b4374aa273ceb27ec1315","ee48df95832b4374aa273ceb27ec1315",22855361,1,0,1,318,126,126,0
"ee48df95832b4374aa273ceb27ec1315","7a439da90b394756ad1777fc4c6dead5",22855361,1,1,0,319,126,127,1
"7a439da90b394756ad1777fc4c6dead5","7a439da90b394756ad1777fc4c6dead5",22855361,1,0,1,320,127,127,0
"7a439da90b394756ad1777fc4c6dead5","a8dd5213034441ac92724b4e83eb0bb2",22855361,1,3,0,321,127,129,2
"a8dd5213034441ac92724b4e83eb0bb2","779f9ddd1fd14d1e9e69f72219a1fdbd",22855361,1,-9,0,322,129,121,-8
"779f9ddd1fd14d1e9e69f72219a1fdbd","a8dd5213034441ac92724b4e83eb0bb2",22855361,1,9,0,323,121,129,8
"a8dd5213034441ac92724b4e83eb0bb2","8115eab6556b45f5b415c3b8c26a12e5",22855361,1,2,0,324,129,131,2
"8115eab6556b45f5b415c3b8c26a12e5","8115eab6556b45f5b415c3b8c26a12e5",22855361,2,0,1,325,131,131,0
"8115eab6556b45f5b415c3b8c26a12e5","ec34b06efd844b46a4c4818ecdb9b8f4",22855361,1,1,0,327,131,132,1
"ec34b06efd844b46a4c4818ecdb9b8f4","ec34b06efd844b46a4c4818ecdb9b8f4",22855361,2,0,1,328,132,132,0
"ec34b06efd844b46a4c4818ecdb9b8f4","c2e1c2b9eac64109b343a088584b576b",22855361,1,1,0,330,132,133,1
"c2e1c2b9eac64109b343a088584b576b","c2e1c2b9eac64109b343a088584b576b",22855361,2,0,1,331,133,133,0
"c2e1c2b9eac64109b343a088584b576b","579338175e0b4bbb8ef3b712b5d8b54e",22855361,1,-5,0,333,133,128,-5
"579338175e0b4bbb8ef3b712b5d8b54e","8bc5795d6a984a3eace4e2811e52dd4f",22855361,1,8,0,334,128,135,7
"8bc5795d6a984a3eace4e2811e52dd4f","8bc5795d6a984a3eace4e2811e52dd4f",22855361,1,0,1,335,135,135,0
"8bc5795d6a984a3eace4e2811e52dd4f","b416d47c56a742199b5d7c7f19d6503a",22855361,1,-1,0,336,135,134,-1
"b416d47c56a742199b5d7c7f19d6503a","cd4532ad48034873ba8bce2aac0c9808",22855361,1,4,0,337,134,137,3
"cd4532ad48034873ba8bce2aac0c9808","cd4532ad48034873ba8bce2aac0c9808",22855361,1,0,1,338,137,137,0
"cd4532ad48034873ba8bce2aac0c9808","df1de691dafe4549a18a4398ee9dfaf9",22855361,1,4,0,339,137,139,2
"df1de691dafe4549a18a4398ee9dfaf9","779f9ddd1fd14d1e9e69f72219a1fdbd",22855361,1,-23,0,340,139,121,-18
"779f9ddd1fd14d1e9e69f72219a1fdbd","6c5ad271a44743479bfaea29b1db8d02",22855361,1,27,0,341,121,143,22
"6c5ad271a44743479bfaea29b1db8d02","67a089198fcb4e1c8f2385786c2b296f",22855361,1,-130,0,342,143,39,-104
"67a089198fcb4e1c8f2385786c2b296f","64d48c6c9c7940639a932219a6c87198",22855361,6,1,0,343,39,40,1
"64d48c6c9c7940639a932219a6c87198","b534b89233134e30a9b5645138bfa9ee",22855361,1,3,0,344,40,41,1
"b534b89233134e30a9b5645138bfa9ee","67a089198fcb4e1c8f2385786c2b296f",22855361,1,-4,0,345,41,39,-2
"67a089198fcb4e1c8f2385786c2b296f","b534b89233134e30a9b5645138bfa9ee",22855361,2,4,0,346,39,41,2
"b534b89233134e30a9b5645138bfa9ee","6e13d61a7bdb44bca949c9f86fab3be5",22855361,2,7,0,347,41,47,6
"6e13d61a7bdb44bca949c9f86fab3be5","d9c8d8c444a64dadbbb508652c721e17",22855361,1,-1,0,348,47,46,-1
"d0c74f735e024943943e40333d6d337f","78f30e4dcac84e3cbea8b2cc6e0d62b3",22855361,1,9,0,350,51,59,8
"a1f2f12debe5432fb7a70bcd12bacfb9","f924752d8a1149668870b1e7698486f7",22855361,1,-9,0,352,58,50,-8
"f924752d8a1149668870b1e7698486f7","309ccf3cc4fe429d9bfbaef53d3fa479",22855361,1,12,0,353,50,60,10
"309ccf3cc4fe429d9bfbaef53d3fa479","12aa6e1672ac4e7aa6449a7a8609cd72",22855361,1,-4,0,354,60,57,-3
"12aa6e1672ac4e7aa6449a7a8609cd72","bc42d26810654ea9a1df1efe1e58c7d5",22855361,1,7,0,355,57,63,6
"bc42d26810654ea9a1df1efe1e58c7d5","a0a418b8540d479fa6e0f653b701da8b",22855361,1,1,0,356,63,64,1
"a0a418b8540d479fa6e0f653b701da8b","b534b89233134e30a9b5645138bfa9ee",22855361,1,-27,0,357,64,41,-23
"b534b89233134e30a9b5645138bfa9ee","d646286c8051419bbc2e31dd1db55ca8",22855361,1,33,0,358,41,67,26
"d646286c8051419bbc2e31dd1db55ca8","d646286c8051419bbc2e31dd1db55ca8",22855361,1,0,1,359,67,67,0
"d646286c8051419bbc2e31dd1db55ca8","ae5ac430ea254e708a6f5deaaf7464ae",22855361,1,20,0,360,67,84,17
"d646286c8051419bbc2e31dd1db55ca8","00ae5f0c51874a73a41ebea838d95682",22855361,1,41,0,366,67,101,34
"e20db35ced8544ddac5bc3839145e463","4280927ec4d643238aa49c32f9e06c6c",22855361,1,20,0,369,91,109,18
"73039f8c1eb9409cb4caee2cf968001e","08111f75e22d409998cf8b85bd431f0a",22855361,1,9,0,371,100,108,8
"08111f75e22d409998cf8b85bd431f0a","62bff51286ef4f348717a3cf6fe2318f",22855361,1,14,0,372,108,120,12
"62bff51286ef4f348717a3cf6fe2318f","779f9ddd1fd14d1e9e69f72219a1fdbd",22855361,1,3,0,375,120,121,1
"779f9ddd1fd14d1e9e69f72219a1fdbd","e20db35ced8544ddac5bc3839145e463",22855361,1,-36,0,376,121,91,-30
"779f9ddd1fd14d1e9e69f72219a1fdbd","779f9ddd1fd14d1e9e69f72219a1fdbd",22855361,1,0,1,378,121,121,0
"779f9ddd1fd14d1e9e69f72219a1fdbd","df1de691dafe4549a18a4398ee9dfaf9",22855361,1,23,0,379,121,139,18
"df1de691dafe4549a18a4398ee9dfaf9","6c5ad271a44743479bfaea29b1db8d02",22855361,1,4,0,380,139,143,4
"6c5ad271a44743479bfaea29b1db8d02","6c5ad271a44743479bfaea29b1db8d02",22855361,1,0,1,381,143,143,0
"6c5ad271a44743479bfaea29b1db8d02","83d311bed5374fee83d8d67a7d9d82dc",22855361,1,1,0,382,143,144,1
"83d311bed5374fee83d8d67a7d9d82dc","83d311bed5374fee83d8d67a7d9d82dc",22855361,1,0,1,383,144,144,0
"83d311bed5374fee83d8d67a7d9d82dc","402bba41861d43acb52a5abb89e8831e",22855361,1,1,0,384,144,145,1
"402bba41861d43acb52a5abb89e8831e","402bba41861d43acb52a5abb89e8831e",22855361,2,0,1,385,145,145,0
"402bba41861d43acb52a5abb89e8831e","df1de691dafe4549a18a4398ee9dfaf9",22855361,1,-6,0,387,145,139,-6
"df1de691dafe4549a18a4398ee9dfaf9","8aae34f5ddbb4052a709b12e6b0d40fa",22855361,1,9,0,388,139,147,8
"8aae34f5ddbb4052a709b12e6b0d40fa","8aae34f5ddbb4052a709b12e6b0d40fa",22855361,2,0,1,389,147,147,0
"8aae34f5ddbb4052a709b12e6b0d40fa","645b3f0249f64f76af2e19eb4d0e55b7",22855361,1,2,0,390,147,149,2
"645b3f0249f64f76af2e19eb4d0e55b7","645b3f0249f64f76af2e19eb4d0e55b7",22855361,2,0,1,391,149,149,0
"645b3f0249f64f76af2e19eb4d0e55b7","7e7b8db5064d4369805ab370aac5ddfb",22855361,1,1,0,393,149,150,1
"7e7b8db5064d4369805ab370aac5ddfb","7e7b8db5064d4369805ab370aac5ddfb",22855361,2,0,1,394,150,150,0
"7e7b8db5064d4369805ab370aac5ddfb","8956d210ae7f41968fada86d4c979d6a",22855361,1,1,0,396,150,151,1
"8956d210ae7f41968fada86d4c979d6a","8956d210ae7f41968fada86d4c979d6a",22855361,2,0,1,397,151,151,0
"8956d210ae7f41968fada86d4c979d6a","f902b0f41b544d4dbf79664fd233648d",22855361,1,-5,0,399,151,146,-5
"f902b0f41b544d4dbf79664fd233648d","ae781e8b775e4ccd93bc800dad5c8376",22855361,1,8,0,400,146,153,7
"ae781e8b775e4ccd93bc800dad5c8376","ae781e8b775e4ccd93bc800dad5c8376",22855361,4,0,1,401,153,153,0
"ae781e8b775e4ccd93bc800dad5c8376","06882a8492d9499aa31555567f575ecb",22855361,2,1,0,403,153,154,1
"06882a8492d9499aa31555567f575ecb","06882a8492d9499aa31555567f575ecb",22855361,1,0,1,404,154,154,0
"06882a8492d9499aa31555567f575ecb","f293c508f409466a8f27ddd7d1e40b20",22855361,2,1,0,405,154,155,1
"f293c508f409466a8f27ddd7d1e40b20","f293c508f409466a8f27ddd7d1e40b20",22855361,2,0,1,406,155,155,0
"f293c508f409466a8f27ddd7d1e40b20","cc4ddef5bbbe48ebb605141b347c4ed1",22855361,2,1,0,408,155,156,1
"cc4ddef5bbbe48ebb605141b347c4ed1","cc4ddef5bbbe48ebb605141b347c4ed1",22855361,2,0,1,409,156,156,0
"cc4ddef5bbbe48ebb605141b347c4ed1","d313cec988a84645bee413e8d4724a4b",22855361,3,3,0,410,156,158,2
"d313cec988a84645bee413e8d4724a4b","f03480cf4eba413194d7af52fc0e7f28",22855361,3,-7,0,411,158,152,-6
"f03480cf4eba413194d7af52fc0e7f28","d313cec988a84645bee413e8d4724a4b",22855361,5,7,0,412,152,158,6
"d313cec988a84645bee413e8d4724a4b","d313cec988a84645bee413e8d4724a4b",22855361,12,0,1,413,158,158,0
"d313cec988a84645bee413e8d4724a4b","dc60696c76a74368a60f72246e47700d",22855361,1,1,0,416,158,159,1
"dc60696c76a74368a60f72246e47700d","dc60696c76a74368a60f72246e47700d",22855361,1,0,1,417,159,159,0
"dc60696c76a74368a60f72246e47700d","78adeee1fa2c4fe0bc73f7bca9fcee86",22855361,1,3,0,418,159,160,1
"78adeee1fa2c4fe0bc73f7bca9fcee86","df1de691dafe4549a18a4398ee9dfaf9",22855361,1,-26,0,419,160,139,-21
"df1de691dafe4549a18a4398ee9dfaf9","65202579580f4ad38d734b4ee39d22a8",22855361,1,31,0,420,139,164,25
"65202579580f4ad38d734b4ee39d22a8","65202579580f4ad38d734b4ee39d22a8",22855361,53,0,1,421,164,164,0
"65202579580f4ad38d734b4ee39d22a8","78adeee1fa2c4fe0bc73f7bca9fcee86",22855361,2,-5,0,428,164,160,-4
"78adeee1fa2c4fe0bc73f7bca9fcee86","65202579580f4ad38d734b4ee39d22a8",22855361,1,5,0,429,160,164,4
"78adeee1fa2c4fe0bc73f7bca9fcee86","3cbcea2be0984e7dbd5a48195af10ce7",22855361,1,8,0,477,160,165,5
"3cbcea2be0984e7dbd5a48195af10ce7","82e6285962b8400d9d6fc32436022a94",22855361,1,2,0,478,165,167,2
"82e6285962b8400d9d6fc32436022a94","67a089198fcb4e1c8f2385786c2b296f",22855361,1,-162,0,479,167,39,-128
"64d48c6c9c7940639a932219a6c87198","a49d1bb4328949299686242fd0be5584",22855361,1,-39,0,481,40,21,-19
"a49d1bb4328949299686242fd0be5584","b7719e26494940efa49512aedd0aac79",22855361,2,-2,0,482,21,20,-1
"b7719e26494940efa49512aedd0aac79","b7719e26494940efa49512aedd0aac79",22855361,1,0,1,483,20,20,0
"afbf7250b99d47bea07172749483ca97","a23ae40d7a9e4ee4828cc06415a3218c",22855361,1,-3,0,485,28,27,-1
"a23ae40d7a9e4ee4828cc06415a3218c","b7719e26494940efa49512aedd0aac79",22855361,1,-9,0,486,27,20,-7
"d4c3b003e8274e429d2fa688d73fde6d","a49d1bb4328949299686242fd0be5584",22855361,1,-1,0,489,22,21,-1
"b7719e26494940efa49512aedd0aac79","a49d1bb4328949299686242fd0be5584",22855361,1,2,0,491,20,21,1
"a49d1bb4328949299686242fd0be5584","d4c3b003e8274e429d2fa688d73fde6d",22855361,1,1,0,492,21,22,1
"d4c3b003e8274e429d2fa688d73fde6d","d4f45188d3c84a02ba08454e6403a818",22855361,1,2,0,493,22,24,2
"b7719e26494940efa49512aedd0aac79","4e51676dc72045d99c19b9fa7b22f8bc",22855361,1,15,0,496,20,29,9
"4e51676dc72045d99c19b9fa7b22f8bc","c9c52446b6294aa5a9c2abaed536c37e",22855361,2,5,0,497,29,32,3
"c9c52446b6294aa5a9c2abaed536c37e","4e51676dc72045d99c19b9fa7b22f8bc",22855361,1,-5,0,498,32,29,-3
"4e51676dc72045d99c19b9fa7b22f8bc","c33c17be71ae4d588da7369472e5bb1b",22855361,4,9,0,499,29,34,5
"c33c17be71ae4d588da7369472e5bb1b","c33c17be71ae4d588da7369472e5bb1b",22855361,3,0,1,500,34,34,0
"c33c17be71ae4d588da7369472e5bb1b","4e51676dc72045d99c19b9fa7b22f8bc",22855361,4,-9,0,501,34,29,-5
"4e51676dc72045d99c19b9fa7b22f8bc","fc0e049d56024bc9a02c9a9c435c3df7",22855361,1,21,0,502,29,38,9
"fc0e049d56024bc9a02c9a9c435c3df7","fc0e049d56024bc9a02c9a9c435c3df7",22855361,3,0,1,503,38,38,0
"fc0e049d56024bc9a02c9a9c435c3df7","67a089198fcb4e1c8f2385786c2b296f",22855361,3,4,0,505,38,39,1
"64d48c6c9c7940639a932219a6c87198","fc0e049d56024bc9a02c9a9c435c3df7",22855361,1,-5,0,507,40,38,-2
"67a089198fcb4e1c8f2385786c2b296f","ae5ac430ea254e708a6f5deaaf7464ae",22855361,1,57,0,509,39,84,45
"ae5ac430ea254e708a6f5deaaf7464ae","d646286c8051419bbc2e31dd1db55ca8",22855361,1,-20,0,510,84,67,-17
"d646286c8051419bbc2e31dd1db55ca8","18fd01350bd5434ca636d59a599d768a",22855361,1,22,0,511,67,86,19
"6a9f0ef185fb47f0937e29daa1c71ed5","d646286c8051419bbc2e31dd1db55ca8",22855361,1,-27,0,516,90,67,-23
"d646286c8051419bbc2e31dd1db55ca8","e20db35ced8544ddac5bc3839145e463",22855361,3,30,0,517,67,91,24
"e20db35ced8544ddac5bc3839145e463","08be90ffbeea4795a138cd42ed8db56f",22855361,1,7,0,518,91,98,7
"08be90ffbeea4795a138cd42ed8db56f","1febb706d7a34005ae8711ed49c76e64",22855361,1,-4,0,519,98,94,-4
"1febb706d7a34005ae8711ed49c76e64","00ae5f0c51874a73a41ebea838d95682",22855361,1,8,0,520,94,101,7
"00ae5f0c51874a73a41ebea838d95682","e20db35ced8544ddac5bc3839145e463",22855361,1,-11,0,521,101,91,-10
"e20db35ced8544ddac5bc3839145e463","d391c8b6e56a43a7b654e9dee02d904b",22855361,1,13,0,522,91,103,12
"d391c8b6e56a43a7b654e9dee02d904b","00ae5f0c51874a73a41ebea838d95682",22855361,1,-2,0,523,103,101,-2
"00ae5f0c51874a73a41ebea838d95682","73039f8c1eb9409cb4caee2cf968001e",22855361,1,-1,0,524,101,100,-1
"4280927ec4d643238aa49c32f9e06c6c","4280927ec4d643238aa49c32f9e06c6c",22855361,1,0,1,526,109,109,0
"4280927ec4d643238aa49c32f9e06c6c","08111f75e22d409998cf8b85bd431f0a",22855361,1,-1,0,527,109,108,-1
"a9ae0a3c070d455bb4369a8996313336","42fb58708eaf4e5daa82bfca61b6f5fd",22855361,1,-32,0,529,114,87,-27
"42fb58708eaf4e5daa82bfca61b6f5fd","d646286c8051419bbc2e31dd1db55ca8",22855361,1,-24,0,530,87,67,-20
"d646286c8051419bbc2e31dd1db55ca8","6a9f0ef185fb47f0937e29daa1c71ed5",22855361,1,27,0,531,67,90,23
"c681290961c94c4caf23b529d1ae6b9a","d646286c8051419bbc2e31dd1db55ca8",22855361,1,-25,0,535,88,67,-21
"e20db35ced8544ddac5bc3839145e463","6a9f0ef185fb47f0937e29daa1c71ed5",22855361,1,-3,0,539,91,90,-1
"6a9f0ef185fb47f0937e29daa1c71ed5","df1de691dafe4549a18a4398ee9dfaf9",22855361,1,62,0,542,90,139,49
"df1de691dafe4549a18a4398ee9dfaf9","f902b0f41b544d4dbf79664fd233648d",22855361,1,8,0,543,139,146,7
"f902b0f41b544d4dbf79664fd233648d","8aae34f5ddbb4052a709b12e6b0d40fa",22855361,1,1,0,544,146,147,1
"8aae34f5ddbb4052a709b12e6b0d40fa","f902b0f41b544d4dbf79664fd233648d",22855361,1,-1,0,546,147,146,-1
"f902b0f41b544d4dbf79664fd233648d","f03480cf4eba413194d7af52fc0e7f28",22855361,1,7,0,547,146,152,6
"d313cec988a84645bee413e8d4724a4b","f4ce60b4a944484082ccb701b48b3da1",22855361,4,-1,0,551,158,157,-1
"f4ce60b4a944484082ccb701b48b3da1","f03480cf4eba413194d7af52fc0e7f28",22855361,1,-6,0,552,157,152,-5
"f4ce60b4a944484082ccb701b48b3da1","ae781e8b775e4ccd93bc800dad5c8376",22855361,3,-5,0,557,157,153,-4
"ae781e8b775e4ccd93bc800dad5c8376","f293c508f409466a8f27ddd7d1e40b20",22855361,1,2,0,558,153,155,2
"f293c508f409466a8f27ddd7d1e40b20","f03480cf4eba413194d7af52fc0e7f28",22855361,1,-3,0,559,155,152,-3
"f03480cf4eba413194d7af52fc0e7f28","f4ce60b4a944484082ccb701b48b3da1",22855361,1,6,0,572,152,157,5
"ae781e8b775e4ccd93bc800dad5c8376","cc4ddef5bbbe48ebb605141b347c4ed1",22855361,1,3,0,576,153,156,3
"f4ce60b4a944484082ccb701b48b3da1","a9ac840f098c4bd0a2ee896214ce29cd",22855361,1,18,0,583,157,168,11
"a9ac840f098c4bd0a2ee896214ce29cd","b2275c3fad834f8d90737a2d9a6927d6",22855361,1,7,0,587,168,172,4
"b2275c3fad834f8d90737a2d9a6927d6","b2275c3fad834f8d90737a2d9a6927d6",22855361,24,0,1,591,172,172,0
"eb515a26030b41f8a82a1e6114420bad","eb515a26030b41f8a82a1e6114420bad",22855361,4,0,1,616,173,173,0
"eb515a26030b41f8a82a1e6114420bad","0c7262dff33c4087bc660ccf40f92f9c",22855361,5,-4,0,623,173,169,-4
"b42cc17b7de840f181a704558d0bc845","b42cc17b7de840f181a704558d0bc845",22855361,1,0,1,625,175,175,0
"b42cc17b7de840f181a704558d0bc845","801f9e9135034f49bf5f8b4bdefedb41",22855361,1,2,0,626,175,177,2
"801f9e9135034f49bf5f8b4bdefedb41","801f9e9135034f49bf5f8b4bdefedb41",22855361,4,0,1,627,177,177,0
"801f9e9135034f49bf5f8b4bdefedb41","ea38cc0e6e6e41edbabf210220808bf9",22855361,1,3,0,631,177,179,2
"ea38cc0e6e6e41edbabf210220808bf9","362fcb0699a14845ab29b2340093e528",22855361,1,-6,0,632,179,174,-5
"362fcb0699a14845ab29b2340093e528","b87c552dd247427abe6ab5795b9c9d43",22855361,1,8,0,633,174,181,7
"b87c552dd247427abe6ab5795b9c9d43","139b097acfca451689d80c9c6eebdf7b",22855361,4,-3,0,634,181,178,-3
"139b097acfca451689d80c9c6eebdf7b","b2275c3fad834f8d90737a2d9a6927d6",22855361,2,-8,0,635,178,172,-6
"b42cc17b7de840f181a704558d0bc845","b87c552dd247427abe6ab5795b9c9d43",22855361,1,7,0,640,175,181,6
"b87c552dd247427abe6ab5795b9c9d43","362fcb0699a14845ab29b2340093e528",22855361,1,-8,0,641,181,174,-7
"362fcb0699a14845ab29b2340093e528","ea38cc0e6e6e41edbabf210220808bf9",22855361,2,6,0,642,174,179,5
"ea38cc0e6e6e41edbabf210220808bf9","ea38cc0e6e6e41edbabf210220808bf9",22855361,1,0,1,643,179,179,0
"ea38cc0e6e6e41edbabf210220808bf9","b87c552dd247427abe6ab5795b9c9d43",22855361,3,2,0,644,179,181,2
"b87c552dd247427abe6ab5795b9c9d43","b87c552dd247427abe6ab5795b9c9d43",22855361,7,0,1,645,181,181,0
"139b097acfca451689d80c9c6eebdf7b","b42cc17b7de840f181a704558d0bc845",22855361,2,-4,0,653,178,175,-3
"b42cc17b7de840f181a704558d0bc845","2024b4885bd14338a39b7b509acbbd02",22855361,1,9,0,654,175,182,7
"2024b4885bd14338a39b7b509acbbd02","362fcb0699a14845ab29b2340093e528",22855361,1,-10,0,655,182,174,-8
"b42cc17b7de840f181a704558d0bc845","b2275c3fad834f8d90737a2d9a6927d6",22855361,3,-4,0,662,175,172,-3
"0c7262dff33c4087bc660ccf40f92f9c","2024b4885bd14338a39b7b509acbbd02",22855361,1,16,0,665,169,182,13
"2024b4885bd14338a39b7b509acbbd02","b2275c3fad834f8d90737a2d9a6927d6",22855361,1,-13,0,666,182,172,-10
"362fcb0699a14845ab29b2340093e528","30f660a1feb34582a739722532524f79",22855361,1,11,0,670,174,183,9
"30f660a1feb34582a739722532524f79","30f660a1feb34582a739722532524f79",22855361,3,0,1,671,183,183,0
"30f660a1feb34582a739722532524f79","2024b4885bd14338a39b7b509acbbd02",22855361,1,-1,0,674,183,182,-1
"2024b4885bd14338a39b7b509acbbd02","c3f63fe50d8e487c86bf8ef76c9cadd3",22855361,1,4,0,675,182,185,3
"c3f63fe50d8e487c86bf8ef76c9cadd3","c3f63fe50d8e487c86bf8ef76c9cadd3",22855361,1,0,1,676,185,185,0
"c3f63fe50d8e487c86bf8ef76c9cadd3","0c7262dff33c4087bc660ccf40f92f9c",22855361,1,-20,0,677,185,169,-16
"0c7262dff33c4087bc660ccf40f92f9c","c8e371568a0c4391b25796ae4e91952e",22855361,1,23,0,678,169,186,17
"c8e371568a0c4391b25796ae4e91952e","7d932b23e1c84326ae5aa4d3c0d813d1",22855361,1,2,0,679,186,188,2
"7d932b23e1c84326ae5aa4d3c0d813d1","7d932b23e1c84326ae5aa4d3c0d813d1",22855361,1,0,1,680,188,188,0
"7d932b23e1c84326ae5aa4d3c0d813d1","c8e371568a0c4391b25796ae4e91952e",22855361,1,-2,0,681,188,186,-2
"c8e371568a0c4391b25796ae4e91952e","ab11d94c6c8948ea90b88f19d2cd502b",22855361,1,5,0,682,186,190,4
"ab11d94c6c8948ea90b88f19d2cd502b","ab11d94c6c8948ea90b88f19d2cd502b",22855361,1,0,1,683,190,190,0
"ab11d94c6c8948ea90b88f19d2cd502b","f992451ed6ad4e68bb9e68ad6be7c4be",22855361,1,2,0,684,190,192,2
"f992451ed6ad4e68bb9e68ad6be7c4be","f992451ed6ad4e68bb9e68ad6be7c4be",22855361,1,0,1,685,192,192,0
"f992451ed6ad4e68bb9e68ad6be7c4be","6cd2dcaac46847d4a0bc53f296d90375",22855361,1,3,0,686,192,194,2
"6cd2dcaac46847d4a0bc53f296d90375","07b44a7a51e94c78b411c753fc39dab0",22855361,1,-6,0,687,194,189,-5
"07b44a7a51e94c78b411c753fc39dab0","6cd2dcaac46847d4a0bc53f296d90375",22855361,1,6,0,688,189,194,5
"6cd2dcaac46847d4a0bc53f296d90375","2d2580c9411c4972909db508d6956a58",22855361,1,2,0,689,194,196,2
"2d2580c9411c4972909db508d6956a58","2d2580c9411c4972909db508d6956a58",22855361,2,0,1,690,196,196,0
"2d2580c9411c4972909db508d6956a58","5bddb3d9ed264f3984702f048c7e5340",22855361,1,1,0,692,196,197,1
"5bddb3d9ed264f3984702f048c7e5340","5bddb3d9ed264f3984702f048c7e5340",22855361,2,0,1,693,197,197,0
"5bddb3d9ed264f3984702f048c7e5340","d5e8e2bd12a2466b9d6d90855f0eb079",22855361,1,1,0,695,197,198,1
"d5e8e2bd12a2466b9d6d90855f0eb079","d5e8e2bd12a2466b9d6d90855f0eb079",22855361,2,0,1,696,198,198,0
"d5e8e2bd12a2466b9d6d90855f0eb079","017d7ca8e0394b91aaadc9574df2202c",22855361,1,-5,0,698,198,193,-5
"017d7ca8e0394b91aaadc9574df2202c","54e8e9f0ea3e45c4bf3b8ac799ee31b1",22855361,1,8,0,699,193,200,7
"54e8e9f0ea3e45c4bf3b8ac799ee31b1","54e8e9f0ea3e45c4bf3b8ac799ee31b1",22855361,1,0,1,700,200,200,0
"54e8e9f0ea3e45c4bf3b8ac799ee31b1","c614a00911be4877a075f19315530fb0",22855361,1,1,0,701,200,201,1
"c614a00911be4877a075f19315530fb0","c614a00911be4877a075f19315530fb0",22855361,6,0,1,702,201,201,0
"c614a00911be4877a075f19315530fb0","a6c21bd8b95249c7972820a7a7d76aff",22855361,1,1,0,708,201,202,1
"a6c21bd8b95249c7972820a7a7d76aff","a6c21bd8b95249c7972820a7a7d76aff",22855361,1,0,1,709,202,202,0
"a6c21bd8b95249c7972820a7a7d76aff","f9170dd6bc6442b4acd832747609b09a",22855361,1,-3,0,710,202,199,-3
"f9170dd6bc6442b4acd832747609b09a","6cd2dcaac46847d4a0bc53f296d90375",22855361,1,-6,0,711,199,194,-5
"6cd2dcaac46847d4a0bc53f296d90375","017d7ca8e0394b91aaadc9574df2202c",22855361,1,-1,0,712,194,193,-1
"017d7ca8e0394b91aaadc9574df2202c","c8e371568a0c4391b25796ae4e91952e",22855361,1,-9,0,713,193,186,-7
"c8e371568a0c4391b25796ae4e91952e","c8e371568a0c4391b25796ae4e91952e",22855361,3,0,1,714,186,186,0
"c8e371568a0c4391b25796ae4e91952e","bb329d880ab54120adaf203a693bb203",22855361,1,20,0,716,186,203,17
"bb329d880ab54120adaf203a693bb203","bb329d880ab54120adaf203a693bb203",22855361,1,0,1,717,203,203,0
"bb329d880ab54120adaf203a693bb203","f9170dd6bc6442b4acd832747609b09a",22855361,1,-4,0,718,203,199,-4
"f9170dd6bc6442b4acd832747609b09a","c8e371568a0c4391b25796ae4e91952e",22855361,1,-16,0,719,199,186,-13
"c8e371568a0c4391b25796ae4e91952e","334c2344009840079b1d0e1b7ce3d5a7",22855361,1,23,0,721,186,205,19
"334c2344009840079b1d0e1b7ce3d5a7","334c2344009840079b1d0e1b7ce3d5a7",22855361,1,0,1,722,205,205,0
"334c2344009840079b1d0e1b7ce3d5a7","c8e371568a0c4391b25796ae4e91952e",22855361,1,-23,0,723,205,186,-19
"c8e371568a0c4391b25796ae4e91952e","d7f13c8d63ec4e2aa673fbb9cf9c6933",22855361,1,26,0,724,186,206,20
"d7f13c8d63ec4e2aa673fbb9cf9c6933","7108f0e4c2584f1f9c471689ae4c885c",22855361,1,2,0,725,206,208,2
"7108f0e4c2584f1f9c471689ae4c885c","b9e80f77c3a44349863b19875725c384",22855361,1,-1,0,726,208,207,-1
"b9e80f77c3a44349863b19875725c384","b9e80f77c3a44349863b19875725c384",22855361,20,0,1,727,207,207,0
"b9e80f77c3a44349863b19875725c384","7108f0e4c2584f1f9c471689ae4c885c",22855361,1,1,0,747,207,208,1
"7108f0e4c2584f1f9c471689ae4c885c","7108f0e4c2584f1f9c471689ae4c885c",22855361,15,0,1,748,208,208,0
"7108f0e4c2584f1f9c471689ae4c885c","09400e101c5d4b439cf9a26b03aae558",22855361,1,3,0,763,208,210,2
"09400e101c5d4b439cf9a26b03aae558","d7f13c8d63ec4e2aa673fbb9cf9c6933",22855361,1,-5,0,764,210,206,-4
"d7f13c8d63ec4e2aa673fbb9cf9c6933","09400e101c5d4b439cf9a26b03aae558",22855361,1,5,0,765,206,210,4
"09400e101c5d4b439cf9a26b03aae558","a88efa7e50ce47159810ab553afa6d3a",22855361,1,2,0,766,210,212,2
"a88efa7e50ce47159810ab553afa6d3a","a88efa7e50ce47159810ab553afa6d3a",22855361,5,0,1,767,212,212,0
"a88efa7e50ce47159810ab553afa6d3a","a875096404ef4a9984b62d74cda916f9",22855361,1,-3,0,772,212,209,-3
"a875096404ef4a9984b62d74cda916f9","f7fb1952f56b4189b86a9f8b7862d2b8",22855361,1,7,0,773,209,215,6
"f7fb1952f56b4189b86a9f8b7862d2b8","be502a7a43c44bf7b682698de79d9369",22855361,1,-1,0,774,215,214,-1
"be502a7a43c44bf7b682698de79d9369","be502a7a43c44bf7b682698de79d9369",22855361,1,0,1,775,214,214,0
"be502a7a43c44bf7b682698de79d9369","f7fb1952f56b4189b86a9f8b7862d2b8",22855361,1,1,0,776,214,215,1
"f7fb1952f56b4189b86a9f8b7862d2b8","f7fb1952f56b4189b86a9f8b7862d2b8",22855361,11,0,1,777,215,215,0
"f7fb1952f56b4189b86a9f8b7862d2b8","b860ee85d8bc4a2f97958cfb71be3533",22855361,1,1,0,788,215,216,1
"b860ee85d8bc4a2f97958cfb71be3533","b860ee85d8bc4a2f97958cfb71be3533",22855361,5,0,1,789,216,216,0
"b860ee85d8bc4a2f97958cfb71be3533","ec341f459285443b8361f7f15638ff08",22855361,1,-3,0,794,216,213,-3
"ec341f459285443b8361f7f15638ff08","363837c182e04711840d896ae1e0339c",22855361,1,6,0,795,213,218,5
"363837c182e04711840d896ae1e0339c","363837c182e04711840d896ae1e0339c",22855361,12,0,1,796,218,218,0
"363837c182e04711840d896ae1e0339c","01b2051f8941460d89945e3b02d1ce78",22855361,1,-1,0,808,218,217,-1
"01b2051f8941460d89945e3b02d1ce78","91125ca626c5470eb145501f8c37f8db",22855361,1,4,0,809,217,220,3
"91125ca626c5470eb145501f8c37f8db","91125ca626c5470eb145501f8c37f8db",22855361,1,0,1,810,220,220,0
"91125ca626c5470eb145501f8c37f8db","1c6721b1f63f4d30ba7746ea8af02a52",22855361,1,3,0,811,220,221,1
"1c6721b1f63f4d30ba7746ea8af02a52","d7f13c8d63ec4e2aa673fbb9cf9c6933",22855361,2,-21,0,812,221,206,-15
"d7f13c8d63ec4e2aa673fbb9cf9c6933","77ecef8eff6b4a2caea7707669bf7475",22855361,1,22,0,813,206,222,16
"77ecef8eff6b4a2caea7707669bf7475","0c7262dff33c4087bc660ccf40f92f9c",22855361,1,-71,0,814,222,169,-53
"362fcb0699a14845ab29b2340093e528","eb515a26030b41f8a82a1e6114420bad",22855361,2,-2,0,826,174,173,-1
"b2275c3fad834f8d90737a2d9a6927d6","a9ac840f098c4bd0a2ee896214ce29cd",22855361,1,-7,0,840,172,168,-4
"b2275c3fad834f8d90737a2d9a6927d6","be95c065e45447c1bd8215ea6f130c7a",22855361,1,63,0,849,172,219,47
"be95c065e45447c1bd8215ea6f130c7a","d7f13c8d63ec4e2aa673fbb9cf9c6933",22855361,1,-17,0,850,219,206,-13
"d7f13c8d63ec4e2aa673fbb9cf9c6933","91125ca626c5470eb145501f8c37f8db",22855361,1,18,0,851,206,220,14
"91125ca626c5470eb145501f8c37f8db","d7f13c8d63ec4e2aa673fbb9cf9c6933",22855361,1,-18,0,852,220,206,-14
"d7f13c8d63ec4e2aa673fbb9cf9c6933","1c6721b1f63f4d30ba7746ea8af02a52",22855361,1,21,0,853,206,221,15
"1c6721b1f63f4d30ba7746ea8af02a52","77ecef8eff6b4a2caea7707669bf7475",22855361,2,1,0,854,221,222,1
"77ecef8eff6b4a2caea7707669bf7475","1c6721b1f63f4d30ba7746ea8af02a52",22855361,2,-1,0,855,222,221,-1
"d7f13c8d63ec4e2aa673fbb9cf9c6933","0c7262dff33c4087bc660ccf40f92f9c",22855361,1,-49,0,857,206,169,-37
"0c7262dff33c4087bc660ccf40f92f9c","ea38cc0e6e6e41edbabf210220808bf9",22855361,1,12,0,861,169,179,10
"b42cc17b7de840f181a704558d0bc845","67a089198fcb4e1c8f2385786c2b296f",22855361,1,-176,0,872,175,39,-136
"67a089198fcb4e1c8f2385786c2b296f","0c7262dff33c4087bc660ccf40f92f9c",22855361,1,169,0,875,39,169,130
"b42cc17b7de840f181a704558d0bc845","1c6721b1f63f4d30ba7746ea8af02a52",22855361,1,63,0,887,175,221,46
"1c6721b1f63f4d30ba7746ea8af02a52","1c6721b1f63f4d30ba7746ea8af02a52",22855361,1,0,1,888,221,221,0
"77ecef8eff6b4a2caea7707669bf7475","77ecef8eff6b4a2caea7707669bf7475",22855361,12,0,1,890,222,222,0
"1c6721b1f63f4d30ba7746ea8af02a52","d03cb855c70044cf8c35d9ec0de696e3",22855361,2,4,0,903,221,224,3
"d03cb855c70044cf8c35d9ec0de696e3","8b9ae98743bd4d4a8a87dff1c1244211",22855361,1,3,0,904,224,227,3
"8b9ae98743bd4d4a8a87dff1c1244211","d03cb855c70044cf8c35d9ec0de696e3",22855361,2,-3,0,905,227,224,-3
"d03cb855c70044cf8c35d9ec0de696e3","a49a937d6896486d9a5396654abcf2e1",22855361,1,2,0,906,224,226,2
"a49a937d6896486d9a5396654abcf2e1","a49a937d6896486d9a5396654abcf2e1",22855361,1,0,1,907,226,226,0
"a49a937d6896486d9a5396654abcf2e1","8b9ae98743bd4d4a8a87dff1c1244211",22855361,1,1,0,908,226,227,1
"8b9ae98743bd4d4a8a87dff1c1244211","8b9ae98743bd4d4a8a87dff1c1244211",22855361,24,0,1,909,227,227,0
"8b9ae98743bd4d4a8a87dff1c1244211","f7906d6f59b9489a91d2ef40db5a474d",22855361,2,-4,0,933,227,223,-4
"f7906d6f59b9489a91d2ef40db5a474d","2ab1535aac1346ba8801535bf729ef37",22855361,3,7,0,934,223,229,6
"2ab1535aac1346ba8801535bf729ef37","8b9ae98743bd4d4a8a87dff1c1244211",22855361,1,-3,0,935,229,227,-2
"d03cb855c70044cf8c35d9ec0de696e3","5152833676bf4c6cb317060be10f68db",22855361,1,5,0,937,224,228,4
"5152833676bf4c6cb317060be10f68db","a49a937d6896486d9a5396654abcf2e1",22855361,1,-3,0,938,228,226,-2
"a49a937d6896486d9a5396654abcf2e1","f7906d6f59b9489a91d2ef40db5a474d",22855361,1,-3,0,939,226,223,-3
"2ab1535aac1346ba8801535bf729ef37","2ab1535aac1346ba8801535bf729ef37",22855361,1,0,1,941,229,229,0
"2ab1535aac1346ba8801535bf729ef37","a4f40fb48a8542c8949bae1f002cd9bc",22855361,1,2,0,942,229,231,2
"a4f40fb48a8542c8949bae1f002cd9bc","a4f40fb48a8542c8949bae1f002cd9bc",22855361,2,0,1,943,231,231,0
"a4f40fb48a8542c8949bae1f002cd9bc","8972c23e32044edb8a78fa1eed4e5947",22855361,1,1,0,945,231,232,1
"8972c23e32044edb8a78fa1eed4e5947","8972c23e32044edb8a78fa1eed4e5947",22855361,1,0,1,946,232,232,0
"8972c23e32044edb8a78fa1eed4e5947","92feb4a40f8344d38b6f722e42a53295",22855361,1,1,0,947,232,233,1
"92feb4a40f8344d38b6f722e42a53295","92feb4a40f8344d38b6f722e42a53295",22855361,2,0,1,948,233,233,0
"92feb4a40f8344d38b6f722e42a53295","5152833676bf4c6cb317060be10f68db",22855361,1,-5,0,950,233,228,-5
"5152833676bf4c6cb317060be10f68db","ca3e28f290354c08aefe5b0f769604e6",22855361,1,8,0,951,228,235,7
"ca3e28f290354c08aefe5b0f769604e6","ca3e28f290354c08aefe5b0f769604e6",22855361,4,0,1,952,235,235,0
"ca3e28f290354c08aefe5b0f769604e6","79a35eea833e4c2c9d22fc53c3c6445c",22855361,1,1,0,956,235,236,1
"79a35eea833e4c2c9d22fc53c3c6445c","79a35eea833e4c2c9d22fc53c3c6445c",22855361,9,0,1,957,236,236,0
"79a35eea833e4c2c9d22fc53c3c6445c","8f68228b1518449e9615cdafee41a2bd",22855361,1,1,0,966,236,237,1
"8f68228b1518449e9615cdafee41a2bd","8f68228b1518449e9615cdafee41a2bd",22855361,1,0,1,967,237,237,0
"8f68228b1518449e9615cdafee41a2bd","cab89fa5c3ed45a5aa550fc0352d6a42",22855361,1,1,0,968,237,238,1
"cab89fa5c3ed45a5aa550fc0352d6a42","cab89fa5c3ed45a5aa550fc0352d6a42",22855361,1,0,1,969,238,238,0
"cab89fa5c3ed45a5aa550fc0352d6a42","66d4fad4f1cf4b46be0750a99ad7a35a",22855361,1,1,0,970,238,239,1
"66d4fad4f1cf4b46be0750a99ad7a35a","66d4fad4f1cf4b46be0750a99ad7a35a",22855361,1,0,1,971,239,239,0
"0b04c8e2f86d48c7aeb7e225819cd32b","f53da5fd9bfe412da4b80d4742563b6c",22855361,1,8,0,975,234,241,7
"f53da5fd9bfe412da4b80d4742563b6c","f53da5fd9bfe412da4b80d4742563b6c",22855361,1,0,1,976,241,241,0
"f53da5fd9bfe412da4b80d4742563b6c","2ae94c0cea4d480a9d5dca8fb1d7b542",22855361,1,3,0,977,241,242,1
"2ae94c0cea4d480a9d5dca8fb1d7b542","1c6721b1f63f4d30ba7746ea8af02a52",22855361,3,-27,0,978,242,221,-21
"1c6721b1f63f4d30ba7746ea8af02a52","1ebf23f9d994469a85206e4c7b1bf5f5",22855361,2,30,0,979,221,245,24
"d03cb855c70044cf8c35d9ec0de696e3","64dbedb3ce544f6aae8e10e0cf10f16d",22855361,1,19,0,983,224,240,16
"64dbedb3ce544f6aae8e10e0cf10f16d","8b9ae98743bd4d4a8a87dff1c1244211",22855361,1,-16,0,984,240,227,-13
"0b04c8e2f86d48c7aeb7e225819cd32b","2ae94c0cea4d480a9d5dca8fb1d7b542",22855361,1,11,0,989,234,242,8
"1ebf23f9d994469a85206e4c7b1bf5f5","1ebf23f9d994469a85206e4c7b1bf5f5",22855361,10,0,1,1000,245,245,0
"1ebf23f9d994469a85206e4c7b1bf5f5","85ae675b83e8422da842cfd25596af99",22855361,1,1,0,1002,245,246,1
"85ae675b83e8422da842cfd25596af99","85ae675b83e8422da842cfd25596af99",22855361,1,0,1,1003,246,246,0
"85ae675b83e8422da842cfd25596af99","fa235f0f364d47e4ae1c87f47bf8e6ba",22855361,1,8,0,1004,246,252,6
"fa235f0f364d47e4ae1c87f47bf8e6ba","2ae94c0cea4d480a9d5dca8fb1d7b542",22855361,1,-12,0,1005,252,242,-10
"2ae94c0cea4d480a9d5dca8fb1d7b542","fa235f0f364d47e4ae1c87f47bf8e6ba",22855361,1,12,0,1006,242,252,10
"fa235f0f364d47e4ae1c87f47bf8e6ba","79f7845465cc4ed19d8e4f1429541be0",22855361,1,2,0,1007,252,254,2
"79f7845465cc4ed19d8e4f1429541be0","79f7845465cc4ed19d8e4f1429541be0",22855361,2,0,1,1008,254,254,0
"79f7845465cc4ed19d8e4f1429541be0","6e83e23f56544a19b94067c1c558d9c0",22855361,1,-8,0,1010,254,247,-7
"6e83e23f56544a19b94067c1c558d9c0","00f61990949545828dd12f1303d47504",22855361,1,11,0,1011,247,256,9
"00f61990949545828dd12f1303d47504","00f61990949545828dd12f1303d47504",22855361,1,0,1,1012,256,256,0
"00f61990949545828dd12f1303d47504","ead7bb4b64e247d2ae632ab8a296b091",22855361,1,2,0,1013,256,258,2
"ead7bb4b64e247d2ae632ab8a296b091","ead7bb4b64e247d2ae632ab8a296b091",22855361,2,0,1,1014,258,258,0
"ead7bb4b64e247d2ae632ab8a296b091","41b0048dde734bb280bac6116baa8e27",22855361,1,1,0,1016,258,259,1
"41b0048dde734bb280bac6116baa8e27","41b0048dde734bb280bac6116baa8e27",22855361,2,0,1,1017,259,259,0
"41b0048dde734bb280bac6116baa8e27","b41c5a094a604ee0915327da5cc0beb7",22855361,1,1,0,1019,259,260,1
"b41c5a094a604ee0915327da5cc0beb7","b41c5a094a604ee0915327da5cc0beb7",22855361,2,0,1,1020,260,260,0
"b41c5a094a604ee0915327da5cc0beb7","d546341988904f069cfa86b21457d9d9",22855361,1,-10,0,1022,260,251,-9
"d546341988904f069cfa86b21457d9d9","28c171777c52431ab6b925073bd63d46",22855361,1,15,0,1023,251,264,13
"28c171777c52431ab6b925073bd63d46","28c171777c52431ab6b925073bd63d46",22855361,7,0,1,1024,264,264,0
"28c171777c52431ab6b925073bd63d46","ac160db940cb49ae8579162b1d52bb5d",22855361,1,2,0,1031,264,266,2
"ac160db940cb49ae8579162b1d52bb5d","ac160db940cb49ae8579162b1d52bb5d",22855361,3,0,1,1032,266,266,0
"ac160db940cb49ae8579162b1d52bb5d","d989ebcfc12a4b669f0100dc1aa14f1e",22855361,1,-12,0,1035,266,255,-11
"d989ebcfc12a4b669f0100dc1aa14f1e","c6fd49b485cc4874b0bbdd9c6171e09c",22855361,1,15,0,1036,255,268,13
"c6fd49b485cc4874b0bbdd9c6171e09c","c6fd49b485cc4874b0bbdd9c6171e09c",22855361,7,0,1,1037,268,268,0
"c6fd49b485cc4874b0bbdd9c6171e09c","44240778a97c4af0937817499b75707b",22855361,1,1,0,1044,268,269,1
"44240778a97c4af0937817499b75707b","44240778a97c4af0937817499b75707b",22855361,2,0,1,1045,269,269,0
"44240778a97c4af0937817499b75707b","7aa76d3e993840d8805f097cbdbcd44b",22855361,1,-9,0,1047,269,261,-8
"7aa76d3e993840d8805f097cbdbcd44b","865a4d3b43374da7944dc7d397f566d9",22855361,1,12,0,1048,261,271,10
"865a4d3b43374da7944dc7d397f566d9","865a4d3b43374da7944dc7d397f566d9",22855361,1,0,1,1049,271,271,0
"865a4d3b43374da7944dc7d397f566d9","2ae94c0cea4d480a9d5dca8fb1d7b542",22855361,1,-35,0,1050,271,242,-29
"2ae94c0cea4d480a9d5dca8fb1d7b542","0d987bed3ffa4ed0b9a2e62e97b7b30f",22855361,1,38,0,1051,242,272,30
"0d987bed3ffa4ed0b9a2e62e97b7b30f","0d987bed3ffa4ed0b9a2e62e97b7b30f",22855361,1,0,1,1052,272,272,0
"0d987bed3ffa4ed0b9a2e62e97b7b30f","82ae07bc0c9b4570a41799290d1ef399",22855361,1,4,0,1053,272,275,3
"82ae07bc0c9b4570a41799290d1ef399","bb5a47f5ea01454a8b79455422d3b9da",22855361,4,6,0,1054,275,280,5
"bb5a47f5ea01454a8b79455422d3b9da","bb5a47f5ea01454a8b79455422d3b9da",22855361,77,0,1,1055,280,280,0
"bb5a47f5ea01454a8b79455422d3b9da","94cecc3f1e7d484b8e068e79241dfd73",22855361,1,3,0,1112,280,281,1
"94cecc3f1e7d484b8e068e79241dfd73","0d987bed3ffa4ed0b9a2e62e97b7b30f",22855361,1,-13,0,1113,281,272,-9
"0d987bed3ffa4ed0b9a2e62e97b7b30f","a37477c4e4c14169ad44b06b493007f6",22855361,1,15,0,1114,272,283,11
"a37477c4e4c14169ad44b06b493007f6","94cecc3f1e7d484b8e068e79241dfd73",22855361,1,-2,0,1115,283,281,-2
"94cecc3f1e7d484b8e068e79241dfd73","fab84b4fab5940efb4ea868ef8d09396",22855361,1,5,0,1116,281,284,3
"fab84b4fab5940efb4ea868ef8d09396","fab84b4fab5940efb4ea868ef8d09396",22855361,3,0,1,1117,284,284,0
"fab84b4fab5940efb4ea868ef8d09396","4a29443515bb404cb8924e1c60a63b73",22855361,2,4,0,1118,284,285,1
"4a29443515bb404cb8924e1c60a63b73","208c9b2796c944db8dacaa96082520ea",22855361,3,3,0,1119,285,288,3
"208c9b2796c944db8dacaa96082520ea","fab84b4fab5940efb4ea868ef8d09396",22855361,1,-7,0,1120,288,284,-4
"208c9b2796c944db8dacaa96082520ea","208c9b2796c944db8dacaa96082520ea",22855361,1,0,1,1124,288,288,0
"208c9b2796c944db8dacaa96082520ea","4a29443515bb404cb8924e1c60a63b73",22855361,2,-3,0,1125,288,285,-3
"4a29443515bb404cb8924e1c60a63b73","7669a956527947d0add87455277e80b4",22855361,1,7,0,1126,285,291,6
"7669a956527947d0add87455277e80b4","7669a956527947d0add87455277e80b4",22855361,1,0,1,1127,291,291,0
"7669a956527947d0add87455277e80b4","6a9a3b5bde4a48daa896fe8c06eca56f",22855361,1,-2,0,1128,291,289,-2
"6a9a3b5bde4a48daa896fe8c06eca56f","869e967078f04da18dd0b0b9389a7424",22855361,1,5,0,1129,289,293,4
"869e967078f04da18dd0b0b9389a7424","869e967078f04da18dd0b0b9389a7424",22855361,1,0,1,1130,293,293,0
"869e967078f04da18dd0b0b9389a7424","51ab6291537748fab90d519aa09889d6",22855361,1,2,0,1131,293,295,2
"51ab6291537748fab90d519aa09889d6","51ab6291537748fab90d519aa09889d6",22855361,5,0,1,1132,295,295,0
"51ab6291537748fab90d519aa09889d6","34a6e49023fc4465bd5ca604330bbd1c",22855361,1,-3,0,1137,295,292,-3
"34a6e49023fc4465bd5ca604330bbd1c","ba0e59461bfb4a44b7b1c28a01f8d3b3",22855361,1,9,0,1138,292,299,7
"ba0e59461bfb4a44b7b1c28a01f8d3b3","21592f2a9e9c4b2f8c66ec5dbcbf6a2b",22855361,1,-4,0,1139,299,296,-3
"21592f2a9e9c4b2f8c66ec5dbcbf6a2b","ba0e59461bfb4a44b7b1c28a01f8d3b3",22855361,1,4,0,1140,296,299,3
"ba0e59461bfb4a44b7b1c28a01f8d3b3","ba0e59461bfb4a44b7b1c28a01f8d3b3",22855361,2,0,1,1141,299,299,0
"ba0e59461bfb4a44b7b1c28a01f8d3b3","0e0b36e731a645e7b1b8a88f5031ca38",22855361,1,2,0,1143,299,301,2
"0e0b36e731a645e7b1b8a88f5031ca38","0e0b36e731a645e7b1b8a88f5031ca38",22855361,5,0,1,1144,301,301,0
"0e0b36e731a645e7b1b8a88f5031ca38","a66a144637284c21afc6de17fea4bfb8",22855361,1,1,0,1149,301,302,1
"a66a144637284c21afc6de17fea4bfb8","a66a144637284c21afc6de17fea4bfb8",22855361,2,0,1,1150,302,302,0
"a66a144637284c21afc6de17fea4bfb8","7646a919d7e64fa990bca9b024ff089d",22855361,1,-4,0,1152,302,298,-4
"7646a919d7e64fa990bca9b024ff089d","4a29443515bb404cb8924e1c60a63b73",22855361,1,-17,0,1153,298,285,-13
"4a29443515bb404cb8924e1c60a63b73","e390b575229748ea8aac9364efe2bf00",22855361,1,24,0,1156,285,304,19
"e390b575229748ea8aac9364efe2bf00","e390b575229748ea8aac9364efe2bf00",22855361,1,0,1,1157,304,304,0
"e390b575229748ea8aac9364efe2bf00","3434c10e561d488a914e0f7d71907abd",22855361,1,3,0,1158,304,305,1
"3434c10e561d488a914e0f7d71907abd","4a29443515bb404cb8924e1c60a63b73",22855361,1,-27,0,1159,305,285,-20
"4a29443515bb404cb8924e1c60a63b73","53e7e900392747ccad52e711ab0f80d8",22855361,1,29,0,1160,285,307,22
"53e7e900392747ccad52e711ab0f80d8","3434c10e561d488a914e0f7d71907abd",22855361,2,-2,0,1161,307,305,-2
"3434c10e561d488a914e0f7d71907abd","53e7e900392747ccad52e711ab0f80d8",22855361,1,2,0,1162,305,307,2
"53e7e900392747ccad52e711ab0f80d8","53e7e900392747ccad52e711ab0f80d8",22855361,4,0,1,1163,307,307,0
"3434c10e561d488a914e0f7d71907abd","130acc2aeb0448fdbb2de63bc5cebe5b",22855361,1,5,0,1168,305,309,4
"130acc2aeb0448fdbb2de63bc5cebe5b","130acc2aeb0448fdbb2de63bc5cebe5b",22855361,1,0,1,1169,309,309,0
"130acc2aeb0448fdbb2de63bc5cebe5b","9c062b3251034ebe90f5054e2a3b5120",22855361,1,2,0,1170,309,311,2
"9c062b3251034ebe90f5054e2a3b5120","9c062b3251034ebe90f5054e2a3b5120",22855361,2,0,1,1171,311,311,0
"9c062b3251034ebe90f5054e2a3b5120","ea859f8207e44537889daeaba13ac2e8",22855361,1,1,0,1173,311,312,1
"ea859f8207e44537889daeaba13ac2e8","ea859f8207e44537889daeaba13ac2e8",22855361,1,0,1,1174,312,312,0
"ea859f8207e44537889daeaba13ac2e8","56d94971a7a94257aa330183a8ebd0ea",22855361,1,1,0,1175,312,313,1
"56d94971a7a94257aa330183a8ebd0ea","56d94971a7a94257aa330183a8ebd0ea",22855361,1,0,1,1176,313,313,0
"56d94971a7a94257aa330183a8ebd0ea","141c0df6cd1946539aadd1c9b7068cd4",22855361,1,-5,0,1177,313,308,-5
"141c0df6cd1946539aadd1c9b7068cd4","13255e63e0aa4abf85e5211bf613d43e",22855361,1,10,0,1178,308,317,9
"13255e63e0aa4abf85e5211bf613d43e","13255e63e0aa4abf85e5211bf613d43e",22855361,1,0,1,1179,317,317,0
"13255e63e0aa4abf85e5211bf613d43e","0c787d16c9504873b1a4d903cec09948",22855361,1,-3,0,1180,317,314,-3
"0c787d16c9504873b1a4d903cec09948","86c27d40179e419c8e9d150fb6afa5d0",22855361,1,6,0,1181,314,319,5
"86c27d40179e419c8e9d150fb6afa5d0","86c27d40179e419c8e9d150fb6afa5d0",22855361,2,0,1,1182,319,319,0
"86c27d40179e419c8e9d150fb6afa5d0","24f1363179ad4aaa965484a78471912b",22855361,1,5,0,1184,319,323,4
"24f1363179ad4aaa965484a78471912b","8d7e0b55cf9849cda222a0f2440cec55",22855361,1,-6,0,1185,323,318,-5
"8d7e0b55cf9849cda222a0f2440cec55","47edbb64109243e6b0f8f64cdef90c6c",22855361,1,9,0,1186,318,326,8
"47edbb64109243e6b0f8f64cdef90c6c","24f1363179ad4aaa965484a78471912b",22855361,1,-3,0,1187,326,323,-3
"24f1363179ad4aaa965484a78471912b","3628bdce1dd2429ba924d2d4d09448d2",22855361,1,-1,0,1188,323,322,-1
"3628bdce1dd2429ba924d2d4d09448d2","56b3fd1a212a4764be39d979fde3326e",22855361,1,7,0,1189,322,328,6
"56b3fd1a212a4764be39d979fde3326e","56b3fd1a212a4764be39d979fde3326e",22855361,1,0,1,1190,328,328,0
"56b3fd1a212a4764be39d979fde3326e","3434c10e561d488a914e0f7d71907abd",22855361,1,-28,0,1191,328,305,-23
"3434c10e561d488a914e0f7d71907abd","0c4079457ede49e3aeb5e86ed84bdf35",22855361,1,31,0,1192,305,329,24
"0c4079457ede49e3aeb5e86ed84bdf35","38aea304b4fa46e1b29bb72f5cea4c93",22855361,2,2,0,1193,329,331,2
"38aea304b4fa46e1b29bb72f5cea4c93","82ae07bc0c9b4570a41799290d1ef399",22855361,1,-78,0,1194,331,275,-56
"82ae07bc0c9b4570a41799290d1ef399","0d987bed3ffa4ed0b9a2e62e97b7b30f",22855361,1,-4,0,1195,275,272,-3
"0d987bed3ffa4ed0b9a2e62e97b7b30f","bb5a47f5ea01454a8b79455422d3b9da",22855361,1,10,0,1196,272,280,8
"bb5a47f5ea01454a8b79455422d3b9da","82ae07bc0c9b4570a41799290d1ef399",22855361,3,-6,0,1200,280,275,-5
"bb5a47f5ea01454a8b79455422d3b9da","bc5524e78a8544e2ae2fdc2f3462bbec",22855361,2,-1,0,1205,280,279,-1
"bc5524e78a8544e2ae2fdc2f3462bbec","bb5a47f5ea01454a8b79455422d3b9da",22855361,2,1,0,1206,279,280,1
"bb5a47f5ea01454a8b79455422d3b9da","0b04c8e2f86d48c7aeb7e225819cd32b",22855361,1,-59,0,1227,280,234,-46
"0b04c8e2f86d48c7aeb7e225819cd32b","1c6721b1f63f4d30ba7746ea8af02a52",22855361,1,-16,0,1228,234,221,-13
"1c6721b1f63f4d30ba7746ea8af02a52","66d4fad4f1cf4b46be0750a99ad7a35a",22855361,1,21,0,1229,221,239,18
"66d4fad4f1cf4b46be0750a99ad7a35a","0b04c8e2f86d48c7aeb7e225819cd32b",22855361,2,-5,0,1230,239,234,-5
"0b04c8e2f86d48c7aeb7e225819cd32b","64dbedb3ce544f6aae8e10e0cf10f16d",22855361,3,7,0,1231,234,240,6
"64dbedb3ce544f6aae8e10e0cf10f16d","0b04c8e2f86d48c7aeb7e225819cd32b",22855361,3,-7,0,1232,240,234,-6
"0b04c8e2f86d48c7aeb7e225819cd32b","2ab1535aac1346ba8801535bf729ef37",22855361,1,-6,0,1233,234,229,-5
"2ab1535aac1346ba8801535bf729ef37","5152833676bf4c6cb317060be10f68db",22855361,2,-1,0,1234,229,228,-1
"5152833676bf4c6cb317060be10f68db","0b04c8e2f86d48c7aeb7e225819cd32b",22855361,2,7,0,1235,228,234,6
"0b04c8e2f86d48c7aeb7e225819cd32b","0c7262dff33c4087bc660ccf40f92f9c",22855361,1,-86,0,1238,234,169,-65
"0c7262dff33c4087bc660ccf40f92f9c","0c7262dff33c4087bc660ccf40f92f9c",22855361,7,0,1,1239,169,169,0
"0c7262dff33c4087bc660ccf40f92f9c","b2275c3fad834f8d90737a2d9a6927d6",22855361,14,3,0,1240,169,172,3
"b2275c3fad834f8d90737a2d9a6927d6","eb515a26030b41f8a82a1e6114420bad",22855361,6,1,0,1241,172,173,1
"eb515a26030b41f8a82a1e6114420bad","b42cc17b7de840f181a704558d0bc845",22855361,3,3,0,1242,173,175,2
"b42cc17b7de840f181a704558d0bc845","0c7262dff33c4087bc660ccf40f92f9c",22855361,7,-7,0,1243,175,169,-6
"b2275c3fad834f8d90737a2d9a6927d6","362fcb0699a14845ab29b2340093e528",22855361,5,3,0,1245,172,174,2
"362fcb0699a14845ab29b2340093e528","0c7262dff33c4087bc660ccf40f92f9c",22855361,3,-6,0,1246,174,169,-5
"0c7262dff33c4087bc660ccf40f92f9c","a9ac840f098c4bd0a2ee896214ce29cd",22855361,3,-4,0,1247,169,168,-1
"a9ac840f098c4bd0a2ee896214ce29cd","a9ac840f098c4bd0a2ee896214ce29cd",22855361,2,0,1,1248,168,168,0
"a9ac840f098c4bd0a2ee896214ce29cd","0c7262dff33c4087bc660ccf40f92f9c",22855361,4,4,0,1249,168,169,1
"b2275c3fad834f8d90737a2d9a6927d6","0c7262dff33c4087bc660ccf40f92f9c",22855361,11,-3,0,1251,172,169,-3
"0c7262dff33c4087bc660ccf40f92f9c","b42cc17b7de840f181a704558d0bc845",22855361,12,7,0,1252,169,175,6
"b42cc17b7de840f181a704558d0bc845","362fcb0699a14845ab29b2340093e528",22855361,5,-1,0,1253,175,174,-1
"362fcb0699a14845ab29b2340093e528","b2275c3fad834f8d90737a2d9a6927d6",22855361,8,-3,0,1254,174,172,-2
"b42cc17b7de840f181a704558d0bc845","6e83e23f56544a19b94067c1c558d9c0",22855361,1,96,0,1263,175,247,72
"6e83e23f56544a19b94067c1c558d9c0","2ae94c0cea4d480a9d5dca8fb1d7b542",22855361,1,-6,0,1264,247,242,-5
"2ae94c0cea4d480a9d5dca8fb1d7b542","6e83e23f56544a19b94067c1c558d9c0",22855361,1,6,0,1265,242,247,5
"6e83e23f56544a19b94067c1c558d9c0","1ebf23f9d994469a85206e4c7b1bf5f5",22855361,1,-3,0,1266,247,245,-2
"1ebf23f9d994469a85206e4c7b1bf5f5","2ae94c0cea4d480a9d5dca8fb1d7b542",22855361,2,-3,0,1267,245,242,-3
"2ae94c0cea4d480a9d5dca8fb1d7b542","30c9ba177afc49a695625d2bdec40207",22855361,1,9,0,1268,242,250,8
"30c9ba177afc49a695625d2bdec40207","30c9ba177afc49a695625d2bdec40207",22855361,2,0,1,1269,250,250,0
"30c9ba177afc49a695625d2bdec40207","00f61990949545828dd12f1303d47504",22855361,1,8,0,1271,250,256,6
"00f61990949545828dd12f1303d47504","6e83e23f56544a19b94067c1c558d9c0",22855361,1,-11,0,1272,256,247,-9
"6e83e23f56544a19b94067c1c558d9c0","0c7262dff33c4087bc660ccf40f92f9c",22855361,1,-103,0,1273,247,169,-78
"b2275c3fad834f8d90737a2d9a6927d6","b42cc17b7de840f181a704558d0bc845",22855361,4,4,0,1276,172,175,3
"0c7262dff33c4087bc660ccf40f92f9c","362fcb0699a14845ab29b2340093e528",22855361,4,6,0,1278,169,174,5
"b2275c3fad834f8d90737a2d9a6927d6","fab84b4fab5940efb4ea868ef8d09396",22855361,1,150,0,1280,172,284,112
"fab84b4fab5940efb4ea868ef8d09396","0c4079457ede49e3aeb5e86ed84bdf35",22855361,1,62,0,1282,284,329,45
"0c4079457ede49e3aeb5e86ed84bdf35","0c4079457ede49e3aeb5e86ed84bdf35",22855361,1,0,1,1283,329,329,0
"38aea304b4fa46e1b29bb72f5cea4c93","38aea304b4fa46e1b29bb72f5cea4c93",22855361,5,0,1,1285,331,331,0
"38aea304b4fa46e1b29bb72f5cea4c93","e36d261332f14e79bb4b467aceaeb9b5",22855361,1,2,0,1290,331,333,2
"e36d261332f14e79bb4b467aceaeb9b5","e36d261332f14e79bb4b467aceaeb9b5",22855361,1,0,1,1291,333,333,0
"e36d261332f14e79bb4b467aceaeb9b5","c7e89b9d04744d2eab742fc24e3ef1ae",22855361,1,1,0,1292,333,334,1
"c7e89b9d04744d2eab742fc24e3ef1ae","c7e89b9d04744d2eab742fc24e3ef1ae",22855361,5,0,1,1293,334,334,0
"c7e89b9d04744d2eab742fc24e3ef1ae","fe49f8054b374a0ea4bb266ed135ff62",22855361,1,1,0,1298,334,335,1
"fe49f8054b374a0ea4bb266ed135ff62","fe49f8054b374a0ea4bb266ed135ff62",22855361,2,0,1,1299,335,335,0
"fe49f8054b374a0ea4bb266ed135ff62","d0a8f74af98642fe8360d22c42e45117",22855361,1,1,0,1301,335,336,1
"d0a8f74af98642fe8360d22c42e45117","d0a8f74af98642fe8360d22c42e45117",22855361,2,0,1,1302,336,336,0
"d0a8f74af98642fe8360d22c42e45117","0c4079457ede49e3aeb5e86ed84bdf35",22855361,1,-7,0,1304,336,329,-7
"0c4079457ede49e3aeb5e86ed84bdf35","a7c6339ca1da4368a18d471f0519f877",22855361,1,11,0,1305,329,339,10
"a7c6339ca1da4368a18d471f0519f877","a7c6339ca1da4368a18d471f0519f877",22855361,1,0,1,1306,339,339,0
"a7c6339ca1da4368a18d471f0519f877","b8b9418ab322418d9db9b40d96af873a",22855361,1,-2,0,1307,339,337,-2
"b8b9418ab322418d9db9b40d96af873a","bbc5139ca9024389a94db3a6f47dcff6",22855361,1,5,0,1308,337,341,4
"bbc5139ca9024389a94db3a6f47dcff6","bbc5139ca9024389a94db3a6f47dcff6",22855361,1,0,1,1309,341,341,0
"bbc5139ca9024389a94db3a6f47dcff6","4ee6ca9019ab4a1ab323f98094a9bd77",22855361,1,2,0,1310,341,343,2
"4ee6ca9019ab4a1ab323f98094a9bd77","4ee6ca9019ab4a1ab323f98094a9bd77",22855361,2,0,1,1311,343,343,0
"4ee6ca9019ab4a1ab323f98094a9bd77","b37947176785476f8b29d49a851366dc",22855361,1,1,0,1313,343,344,1
"b37947176785476f8b29d49a851366dc","b37947176785476f8b29d49a851366dc",22855361,2,0,1,1314,344,344,0
"b37947176785476f8b29d49a851366dc","fcea5b10d5a14a3b9324ffece8f6e1e5",22855361,1,1,0,1316,344,345,1
"fcea5b10d5a14a3b9324ffece8f6e1e5","fcea5b10d5a14a3b9324ffece8f6e1e5",22855361,8,0,1,1317,345,345,0
"fcea5b10d5a14a3b9324ffece8f6e1e5","c2490bc612d146edbe786556fab3651b",22855361,1,-5,0,1325,345,340,-5
"c2490bc612d146edbe786556fab3651b","6ac8bb048b854999a47edb35fe627f11",22855361,1,8,0,1326,340,347,7
"6ac8bb048b854999a47edb35fe627f11","6ac8bb048b854999a47edb35fe627f11",22855361,1,0,1,1327,347,347,0
"6ac8bb048b854999a47edb35fe627f11","0c4079457ede49e3aeb5e86ed84bdf35",22855361,1,-21,0,1328,347,329,-18
"0c4079457ede49e3aeb5e86ed84bdf35","30ead9794d4847abaf222ca966cc8630",22855361,1,24,0,1329,329,348,19
"30ead9794d4847abaf222ca966cc8630","c20993c944444fe085345591a8bd837e",22855361,1,3,0,1330,348,351,3
"c20993c944444fe085345591a8bd837e","09b9678ddc3d452ea4a3d46e15826065",22855361,1,2,0,1331,351,353,2
"09b9678ddc3d452ea4a3d46e15826065","897b7f51242c44aab2205c72fdcbf4cd",22855361,1,-1,0,1332,353,352,-1
"897b7f51242c44aab2205c72fdcbf4cd","eff0de7f2dbb42dfa1a2e686efab5b6d",22855361,1,2,0,1333,352,354,2
"eff0de7f2dbb42dfa1a2e686efab5b6d","c20993c944444fe085345591a8bd837e",22855361,1,-3,0,1334,354,351,-3
"c20993c944444fe085345591a8bd837e","c20993c944444fe085345591a8bd837e",22855361,3,0,1,1335,351,351,0
"c20993c944444fe085345591a8bd837e","897b7f51242c44aab2205c72fdcbf4cd",22855361,1,1,0,1338,351,352,1
"897b7f51242c44aab2205c72fdcbf4cd","897b7f51242c44aab2205c72fdcbf4cd",22855361,3,0,1,1339,352,352,0
"897b7f51242c44aab2205c72fdcbf4cd","09b9678ddc3d452ea4a3d46e15826065",22855361,1,1,0,1342,352,353,1
"09b9678ddc3d452ea4a3d46e15826065","09b9678ddc3d452ea4a3d46e15826065",22855361,3,0,1,1343,353,353,0
"09b9678ddc3d452ea4a3d46e15826065","eff0de7f2dbb42dfa1a2e686efab5b6d",22855361,1,1,0,1346,353,354,1
"eff0de7f2dbb42dfa1a2e686efab5b6d","eff0de7f2dbb42dfa1a2e686efab5b6d",22855361,3,0,1,1347,354,354,0
"eff0de7f2dbb42dfa1a2e686efab5b6d","2fe14166dc9642c3bc666b86a57f943d",22855361,1,4,0,1350,354,357,3
"2fe14166dc9642c3bc666b86a57f943d","30ead9794d4847abaf222ca966cc8630",22855361,1,-10,0,1351,357,348,-9
"30ead9794d4847abaf222ca966cc8630","2fe14166dc9642c3bc666b86a57f943d",22855361,1,10,0,1352,348,357,9
"2fe14166dc9642c3bc666b86a57f943d","2fe14166dc9642c3bc666b86a57f943d",22855361,1,0,1,1353,357,357,0
"2fe14166dc9642c3bc666b86a57f943d","44421dd1e13a47a388c4a19834b744c7",22855361,1,2,0,1354,357,359,2
"44421dd1e13a47a388c4a19834b744c7","44421dd1e13a47a388c4a19834b744c7",22855361,2,0,1,1355,359,359,0
"44421dd1e13a47a388c4a19834b744c7","cb5fc7ef85d547c4be1a7439d0bf6052",22855361,1,1,0,1357,359,360,1
"cb5fc7ef85d547c4be1a7439d0bf6052","cb5fc7ef85d547c4be1a7439d0bf6052",22855361,2,0,1,1358,360,360,0
"cb5fc7ef85d547c4be1a7439d0bf6052","0a8f150a4cf747acbde62f4721823da3",22855361,1,1,0,1360,360,361,1
"0a8f150a4cf747acbde62f4721823da3","0a8f150a4cf747acbde62f4721823da3",22855361,2,0,1,1361,361,361,0
"0a8f150a4cf747acbde62f4721823da3","ab8fdad974ae471f9f24c3f9dd04462e",22855361,1,1,0,1363,361,362,1
"ab8fdad974ae471f9f24c3f9dd04462e","ab8fdad974ae471f9f24c3f9dd04462e",22855361,2,0,1,1364,362,362,0
"ab8fdad974ae471f9f24c3f9dd04462e","1ba8fef685d74a8194b9db252eb704fb",22855361,1,-7,0,1366,362,355,-7
"1ba8fef685d74a8194b9db252eb704fb","52580888dadb4fe3baa795683ea227bd",22855361,1,10,0,1367,355,364,9
"52580888dadb4fe3baa795683ea227bd","52580888dadb4fe3baa795683ea227bd",22855361,1,0,1,1368,364,364,0
"52580888dadb4fe3baa795683ea227bd","492a3bc6a1254f23a7998587961b22a4",22855361,1,3,0,1369,364,366,2
"492a3bc6a1254f23a7998587961b22a4","f00179e251a045b39c3f7a54f9aa4acc",22855361,1,-4,0,1370,366,363,-3
"f00179e251a045b39c3f7a54f9aa4acc","492a3bc6a1254f23a7998587961b22a4",22855361,1,4,0,1371,363,366,3
"492a3bc6a1254f23a7998587961b22a4","492a3bc6a1254f23a7998587961b22a4",22855361,1,0,1,1372,366,366,0
"492a3bc6a1254f23a7998587961b22a4","072a190fd302456290895f9f04d6940a",22855361,2,-1,0,1373,366,365,-1
"072a190fd302456290895f9f04d6940a","cfa457d1743848e4bb5e4beced6448ed",22855361,1,5,0,1374,365,369,4
"cfa457d1743848e4bb5e4beced6448ed","cfa457d1743848e4bb5e4beced6448ed",22855361,1,0,1,1375,369,369,0
"cfa457d1743848e4bb5e4beced6448ed","30ead9794d4847abaf222ca966cc8630",22855361,1,-25,0,1376,369,348,-21
"30ead9794d4847abaf222ca966cc8630","b71bac264efb4abd97015447bd490db6",22855361,1,28,0,1377,348,370,22
"b71bac264efb4abd97015447bd490db6","fab84b4fab5940efb4ea868ef8d09396",22855361,1,-114,0,1378,370,284,-86
"fab84b4fab5940efb4ea868ef8d09396","c76574d21bc14aeea7ecd0b027f39858",22855361,1,109,0,1379,284,367,83
"c76574d21bc14aeea7ecd0b027f39858","30ead9794d4847abaf222ca966cc8630",22855361,1,-23,0,1380,367,348,-19
"30ead9794d4847abaf222ca966cc8630","c76574d21bc14aeea7ecd0b027f39858",22855361,1,23,0,1381,348,367,19
"c76574d21bc14aeea7ecd0b027f39858","492a3bc6a1254f23a7998587961b22a4",22855361,1,-2,0,1382,367,366,-1
"072a190fd302456290895f9f04d6940a","b71bac264efb4abd97015447bd490db6",22855361,1,8,0,1384,365,370,5
"b71bac264efb4abd97015447bd490db6","30ead9794d4847abaf222ca966cc8630",22855361,1,-28,0,1385,370,348,-22
"30ead9794d4847abaf222ca966cc8630","8d448d625b024c82a5eb240bbd7431d6",22855361,1,33,0,1386,348,374,26
"8d448d625b024c82a5eb240bbd7431d6","8d448d625b024c82a5eb240bbd7431d6",22855361,57,0,1,1387,374,374,0
"8d448d625b024c82a5eb240bbd7431d6","b71bac264efb4abd97015447bd490db6",22855361,2,-5,0,1391,374,370,-4
"b71bac264efb4abd97015447bd490db6","8d448d625b024c82a5eb240bbd7431d6",22855361,2,5,0,1392,370,374,4
"8d448d625b024c82a5eb240bbd7431d6","1b4550d0dab04078b3bf08a655345bdc",22855361,1,-1,0,1395,374,373,-1
"1b4550d0dab04078b3bf08a655345bdc","8d448d625b024c82a5eb240bbd7431d6",22855361,1,1,0,1396,373,374,1
"8d448d625b024c82a5eb240bbd7431d6","66baf19b6b904b70922329068c63746d",22855361,1,7,0,1450,374,376,2
"66baf19b6b904b70922329068c63746d","7f544639412e40a9ba27f43b415362ab",22855361,3,2,0,1451,376,378,2
"7f544639412e40a9ba27f43b415362ab","7f544639412e40a9ba27f43b415362ab",22855361,1,0,1,1452,378,378,0
"7f544639412e40a9ba27f43b415362ab","d5ae8642e15b46b8bd298b02274d4e9c",22855361,1,2,0,1453,378,380,2
"d5ae8642e15b46b8bd298b02274d4e9c","d5ae8642e15b46b8bd298b02274d4e9c",22855361,1,0,1,1454,380,380,0
"d5ae8642e15b46b8bd298b02274d4e9c","a0d10309a2dd456289147f84be9d37f9",22855361,1,1,0,1455,380,381,1
"a0d10309a2dd456289147f84be9d37f9","a0d10309a2dd456289147f84be9d37f9",22855361,2,0,1,1456,381,381,0
"a0d10309a2dd456289147f84be9d37f9","0fcbc3ca07b144138b8d85da581f09a8",22855361,1,1,0,1458,381,382,1
"0fcbc3ca07b144138b8d85da581f09a8","0fcbc3ca07b144138b8d85da581f09a8",22855361,2,0,1,1459,382,382,0
"0fcbc3ca07b144138b8d85da581f09a8","66baf19b6b904b70922329068c63746d",22855361,1,-6,0,1461,382,376,-6
"66baf19b6b904b70922329068c63746d","c2fca3669923477ab966ded303dea31c",22855361,1,8,0,1462,376,383,7
"c2fca3669923477ab966ded303dea31c","4890121ce5d74576b4632b77cfc23398",22855361,1,6,0,1463,383,388,5
"4890121ce5d74576b4632b77cfc23398","4890121ce5d74576b4632b77cfc23398",22855361,2,0,1,1464,388,388,0
"4890121ce5d74576b4632b77cfc23398","96bb2b3e85a34d8b9544514e89f6fe97",22855361,1,3,0,1466,388,390,2
"96bb2b3e85a34d8b9544514e89f6fe97","18d3b836dd804224883cc9180b60a8e1",22855361,1,-4,0,1467,390,387,-3
"18d3b836dd804224883cc9180b60a8e1","96bb2b3e85a34d8b9544514e89f6fe97",22855361,1,4,0,1468,387,390,3
"96bb2b3e85a34d8b9544514e89f6fe97","ac4e9b54acfe4670b4634859c7263cb5",22855361,1,2,0,1469,390,392,2
"ac4e9b54acfe4670b4634859c7263cb5","ac4e9b54acfe4670b4634859c7263cb5",22855361,1,0,1,1470,392,392,0
"ac4e9b54acfe4670b4634859c7263cb5","17f95d18bab743888e1736033dc3384d",22855361,2,-3,0,1471,392,389,-3
"17f95d18bab743888e1736033dc3384d","6f8881a745ac4c358a68b92c3b4abe81",22855361,3,6,0,1472,389,394,5
"6f8881a745ac4c358a68b92c3b4abe81","6f8881a745ac4c358a68b92c3b4abe81",22855361,2,0,1,1473,394,394,0
"6f8881a745ac4c358a68b92c3b4abe81","f7002c8484354eceac57bc7bd62c76c1",22855361,3,-1,0,1475,394,393,-1
"f7002c8484354eceac57bc7bd62c76c1","96bb2b3e85a34d8b9544514e89f6fe97",22855361,2,-4,0,1476,393,390,-3
"96bb2b3e85a34d8b9544514e89f6fe97","0c12af0a4e7f4002852cf84b2537c161",22855361,2,7,0,1477,390,395,5
"0c12af0a4e7f4002852cf84b2537c161","ac4e9b54acfe4670b4634859c7263cb5",22855361,1,-5,0,1478,395,392,-3
"0c12af0a4e7f4002852cf84b2537c161","17f95d18bab743888e1736033dc3384d",22855361,1,-8,0,1484,395,389,-6
"f7002c8484354eceac57bc7bd62c76c1","66baf19b6b904b70922329068c63746d",22855361,1,-21,0,1487,393,376,-17
"7f544639412e40a9ba27f43b415362ab","66baf19b6b904b70922329068c63746d",22855361,2,-2,0,1489,378,376,-2
"66baf19b6b904b70922329068c63746d","44a277ea44dc4ae689fab4b82f0b4098",22855361,1,26,0,1490,376,397,21
"44a277ea44dc4ae689fab4b82f0b4098","44a277ea44dc4ae689fab4b82f0b4098",22855361,1,0,1,1491,397,397,0
"44a277ea44dc4ae689fab4b82f0b4098","0c12af0a4e7f4002852cf84b2537c161",22855361,1,-2,0,1492,397,395,-2
"0c12af0a4e7f4002852cf84b2537c161","859e0b8d71694b12befb69ee698138f9",22855361,1,5,0,1493,395,399,4
"859e0b8d71694b12befb69ee698138f9","859e0b8d71694b12befb69ee698138f9",22855361,1,0,1,1494,399,399,0
"859e0b8d71694b12befb69ee698138f9","66baf19b6b904b70922329068c63746d",22855361,1,-29,0,1495,399,376,-23
"66baf19b6b904b70922329068c63746d","2b09a08242b54983aec7063990fb3f66",22855361,2,32,0,1496,376,400,24
"2b09a08242b54983aec7063990fb3f66","2b09a08242b54983aec7063990fb3f66",22855361,5,0,1,1497,400,400,0
"2b09a08242b54983aec7063990fb3f66","1f471b7a883a4df48211e8c6a81b59a7",22855361,1,1,0,1502,400,401,1
"1f471b7a883a4df48211e8c6a81b59a7","1f471b7a883a4df48211e8c6a81b59a7",22855361,1,0,1,1503,401,401,0
"1f471b7a883a4df48211e8c6a81b59a7","2b09a08242b54983aec7063990fb3f66",22855361,1,-1,0,1504,401,400,-1
"2b09a08242b54983aec7063990fb3f66","9de0d567bfa84fe5b77cb76f4a76a5d1",22855361,1,5,0,1505,400,404,4
"9de0d567bfa84fe5b77cb76f4a76a5d1","9de0d567bfa84fe5b77cb76f4a76a5d1",22855361,1,0,1,1506,404,404,0
"9de0d567bfa84fe5b77cb76f4a76a5d1","1157bd665ec4472fb58b751dc5099355",22855361,1,-1,0,1507,404,403,-1
"1157bd665ec4472fb58b751dc5099355","58fc9094275e4c49be3f4ba6d4acc0a4",22855361,1,5,0,1508,403,406,3
"58fc9094275e4c49be3f4ba6d4acc0a4","3c8a22d2f9c146ea956609e3ed4f2559",22855361,1,-2,0,1509,406,405,-1
"3c8a22d2f9c146ea956609e3ed4f2559","58fc9094275e4c49be3f4ba6d4acc0a4",22855361,1,2,0,1510,405,406,1
"58fc9094275e4c49be3f4ba6d4acc0a4","58fc9094275e4c49be3f4ba6d4acc0a4",22855361,5,0,1,1511,406,406,0
"58fc9094275e4c49be3f4ba6d4acc0a4","c1c1be90b2b14c1ab4a5e1ee3c241902",22855361,1,1,0,1514,406,407,1
"c1c1be90b2b14c1ab4a5e1ee3c241902","c1c1be90b2b14c1ab4a5e1ee3c241902",22855361,5,0,1,1515,407,407,0
"c1c1be90b2b14c1ab4a5e1ee3c241902","58fc9094275e4c49be3f4ba6d4acc0a4",22855361,1,-1,0,1520,407,406,-1
"58fc9094275e4c49be3f4ba6d4acc0a4","02b3a1bead9244c1ba2f857c7da8f82a",22855361,2,3,0,1521,406,408,2
"02b3a1bead9244c1ba2f857c7da8f82a","02b3a1bead9244c1ba2f857c7da8f82a",22855361,3,0,1,1522,408,408,0
"02b3a1bead9244c1ba2f857c7da8f82a","6206fc6479014bb193084c32409dc1b9",22855361,1,1,0,1524,408,409,1
"6206fc6479014bb193084c32409dc1b9","6206fc6479014bb193084c32409dc1b9",22855361,1,0,1,1525,409,409,0
"6206fc6479014bb193084c32409dc1b9","6a5f020451db426dacba9e2ea3fcc62a",22855361,1,2,0,1526,409,410,1
"6a5f020451db426dacba9e2ea3fcc62a","02b3a1bead9244c1ba2f857c7da8f82a",22855361,1,-3,0,1527,410,408,-2
"02b3a1bead9244c1ba2f857c7da8f82a","6a5f020451db426dacba9e2ea3fcc62a",22855361,1,3,0,1528,408,410,2
"6a5f020451db426dacba9e2ea3fcc62a","6a5f020451db426dacba9e2ea3fcc62a",22855361,2,0,1,1529,410,410,0
"6a5f020451db426dacba9e2ea3fcc62a","33a9d248b2e44588a5b07fc1342b9bc2",22855361,1,2,0,1531,410,411,1
"33a9d248b2e44588a5b07fc1342b9bc2","33a9d248b2e44588a5b07fc1342b9bc2",22855361,1,0,1,1532,411,411,0
"33a9d248b2e44588a5b07fc1342b9bc2","c6f26bd420634f1cb7989e76fe6b16c0",22855361,1,1,0,1533,411,412,1
"c6f26bd420634f1cb7989e76fe6b16c0","c6f26bd420634f1cb7989e76fe6b16c0",22855361,5,0,1,1534,412,412,0
"c6f26bd420634f1cb7989e76fe6b16c0","2a65ee6e2ac64f6a8a55fbe5373ec763",22855361,1,1,0,1539,412,413,1
"2a65ee6e2ac64f6a8a55fbe5373ec763","2a65ee6e2ac64f6a8a55fbe5373ec763",22855361,2,0,1,1540,413,413,0
"2a65ee6e2ac64f6a8a55fbe5373ec763","33a9d248b2e44588a5b07fc1342b9bc2",22855361,1,-2,0,1542,413,411,-2
"33a9d248b2e44588a5b07fc1342b9bc2","1fd0f6dadbc14ebc965faf6122190b96",22855361,1,5,0,1543,411,415,4
"1fd0f6dadbc14ebc965faf6122190b96","1fd0f6dadbc14ebc965faf6122190b96",22855361,1,0,1,1544,415,415,0
"1fd0f6dadbc14ebc965faf6122190b96","687055dad9fc40c3982478fe33ec01bf",22855361,1,-1,0,1545,415,414,-1
"687055dad9fc40c3982478fe33ec01bf","2add1669f08d4101913db15f8c23b3b7",22855361,1,3,0,1546,414,416,2
"2add1669f08d4101913db15f8c23b3b7","2add1669f08d4101913db15f8c23b3b7",22855361,1,0,1,1547,416,416,0
"2add1669f08d4101913db15f8c23b3b7","a2b4bd40cee2481ebd3fc179d6a5cd62",22855361,1,3,0,1548,416,417,1
"a2b4bd40cee2481ebd3fc179d6a5cd62","2b09a08242b54983aec7063990fb3f66",22855361,1,-27,0,1549,417,400,-17
"2b09a08242b54983aec7063990fb3f66","58fc9094275e4c49be3f4ba6d4acc0a4",22855361,2,9,0,1550,400,406,6
"58fc9094275e4c49be3f4ba6d4acc0a4","2b09a08242b54983aec7063990fb3f66",22855361,1,-9,0,1551,406,400,-6
"02b3a1bead9244c1ba2f857c7da8f82a","58fc9094275e4c49be3f4ba6d4acc0a4",22855361,1,-3,0,1556,408,406,-2
"58fc9094275e4c49be3f4ba6d4acc0a4","0c12af0a4e7f4002852cf84b2537c161",22855361,1,-17,0,1558,406,395,-11
"0c12af0a4e7f4002852cf84b2537c161","96bb2b3e85a34d8b9544514e89f6fe97",22855361,1,-7,0,1559,395,390,-5
"96bb2b3e85a34d8b9544514e89f6fe97","17f95d18bab743888e1736033dc3384d",22855361,1,-1,0,1560,390,389,-1
"17f95d18bab743888e1736033dc3384d","66baf19b6b904b70922329068c63746d",22855361,1,-16,0,1561,389,376,-13
"2b09a08242b54983aec7063990fb3f66","3c8a22d2f9c146ea956609e3ed4f2559",22855361,1,7,0,1565,400,405,5
"3c8a22d2f9c146ea956609e3ed4f2559","a2b4bd40cee2481ebd3fc179d6a5cd62",22855361,1,20,0,1566,405,417,12
"a2b4bd40cee2481ebd3fc179d6a5cd62","a2b4bd40cee2481ebd3fc179d6a5cd62",22855361,1,0,1,1567,417,417,0
"a2b4bd40cee2481ebd3fc179d6a5cd62","e34e59dce2204f228f3a84b6725df60f",22855361,1,2,0,1568,417,419,2
"e34e59dce2204f228f3a84b6725df60f","e34e59dce2204f228f3a84b6725df60f",22855361,1,0,1,1569,419,419,0
"e34e59dce2204f228f3a84b6725df60f","a2b4bd40cee2481ebd3fc179d6a5cd62",22855361,1,-2,0,1570,419,417,-2
"a2b4bd40cee2481ebd3fc179d6a5cd62","bec48fc2e1294c7eb3d0aca780d731b8",22855361,1,4,0,1571,417,420,3
"bec48fc2e1294c7eb3d0aca780d731b8","bec48fc2e1294c7eb3d0aca780d731b8",22855361,5,0,1,1572,420,420,0
"bec48fc2e1294c7eb3d0aca780d731b8","a24600b0e49245f6bdba8c893cfeddb0",22855361,1,7,0,1577,420,425,5
"a24600b0e49245f6bdba8c893cfeddb0","dbde19fcce2a4c1abdc7f685c293a23f",22855361,1,-4,0,1578,425,422,-3
"dbde19fcce2a4c1abdc7f685c293a23f","a24600b0e49245f6bdba8c893cfeddb0",22855361,1,4,0,1579,422,425,3
"a24600b0e49245f6bdba8c893cfeddb0","a24600b0e49245f6bdba8c893cfeddb0",22855361,3,0,1,1580,425,425,0
"a24600b0e49245f6bdba8c893cfeddb0","a2b4bd40cee2481ebd3fc179d6a5cd62",22855361,1,-11,0,1583,425,417,-8
"a2b4bd40cee2481ebd3fc179d6a5cd62","24cf8786024543f19b89bc20034e60d7",22855361,1,18,0,1584,417,428,11
"24cf8786024543f19b89bc20034e60d7","f2a73be2f46840b182d7bd095378004e",22855361,2,1,0,1585,428,429,1
"f2a73be2f46840b182d7bd095378004e","f2a73be2f46840b182d7bd095378004e",22855361,2,0,1,1586,429,429,0
"f2a73be2f46840b182d7bd095378004e","604551fd4266430cb860fef58fa7dd61",22855361,1,1,0,1588,429,430,1
"604551fd4266430cb860fef58fa7dd61","604551fd4266430cb860fef58fa7dd61",22855361,7,0,1,1589,430,430,0
"604551fd4266430cb860fef58fa7dd61","dce46f8904594a62a6377a3587aaa663",22855361,1,2,0,1596,430,431,1
"dce46f8904594a62a6377a3587aaa663","24cf8786024543f19b89bc20034e60d7",22855361,2,-4,0,1597,431,428,-3
"24cf8786024543f19b89bc20034e60d7","dce46f8904594a62a6377a3587aaa663",22855361,2,4,0,1598,428,431,3
"dce46f8904594a62a6377a3587aaa663","dce46f8904594a62a6377a3587aaa663",22855361,3,0,1,1599,431,431,0
"dce46f8904594a62a6377a3587aaa663","9b9d0a249052413c869753b99682b0ac",22855361,1,1,0,1601,431,432,1
"9b9d0a249052413c869753b99682b0ac","9b9d0a249052413c869753b99682b0ac",22855361,1,0,1,1602,432,432,0
"9b9d0a249052413c869753b99682b0ac","061c175cc90f45fbad883025394e78dd",22855361,1,1,0,1603,432,433,1
"061c175cc90f45fbad883025394e78dd","061c175cc90f45fbad883025394e78dd",22855361,1,0,1,1604,433,433,0
"061c175cc90f45fbad883025394e78dd","dce46f8904594a62a6377a3587aaa663",22855361,2,-2,0,1605,433,431,-2
"dce46f8904594a62a6377a3587aaa663","74a7f8712e5449c2bc0b43c6f90dafed",22855361,1,5,0,1606,431,435,4
"74a7f8712e5449c2bc0b43c6f90dafed","74a7f8712e5449c2bc0b43c6f90dafed",22855361,1,0,1,1607,435,435,0
"74a7f8712e5449c2bc0b43c6f90dafed","66ada10dde9f43018588f1ced9d477fc",22855361,1,-1,0,1608,435,434,-1
"66ada10dde9f43018588f1ced9d477fc","bf12c96466d840a69bed7020b3f18bb8",22855361,1,3,0,1609,434,436,2
"bf12c96466d840a69bed7020b3f18bb8","dce46f8904594a62a6377a3587aaa663",22855361,1,-7,0,1610,436,431,-5
"dce46f8904594a62a6377a3587aaa663","f2a73be2f46840b182d7bd095378004e",22855361,1,-3,0,1611,431,429,-2
"f2a73be2f46840b182d7bd095378004e","dce46f8904594a62a6377a3587aaa663",22855361,1,3,0,1612,429,431,2
"dce46f8904594a62a6377a3587aaa663","66ada10dde9f43018588f1ced9d477fc",22855361,2,4,0,1616,431,434,3
"66ada10dde9f43018588f1ced9d477fc","dce46f8904594a62a6377a3587aaa663",22855361,1,-4,0,1617,434,431,-3
"dce46f8904594a62a6377a3587aaa663","bf12c96466d840a69bed7020b3f18bb8",22855361,1,7,0,1618,431,436,5
"bf12c96466d840a69bed7020b3f18bb8","061c175cc90f45fbad883025394e78dd",22855361,1,-5,0,1619,436,433,-3
"66ada10dde9f43018588f1ced9d477fc","24cf8786024543f19b89bc20034e60d7",22855361,1,-8,0,1622,434,428,-6
"f2a73be2f46840b182d7bd095378004e","24cf8786024543f19b89bc20034e60d7",22855361,1,-1,0,1624,429,428,-1
"24cf8786024543f19b89bc20034e60d7","bf12c96466d840a69bed7020b3f18bb8",22855361,1,11,0,1625,428,436,8
"bf12c96466d840a69bed7020b3f18bb8","bf12c96466d840a69bed7020b3f18bb8",22855361,1,0,1,1626,436,436,0
"bf12c96466d840a69bed7020b3f18bb8","070600601c4c439288445d2f0724807d",22855361,1,3,0,1627,436,437,1
"070600601c4c439288445d2f0724807d","24cf8786024543f19b89bc20034e60d7",22855361,1,-14,0,1628,437,428,-9
"24cf8786024543f19b89bc20034e60d7","1823b6de7d334a7aaabc4570719af4d9",22855361,1,16,0,1629,428,439,11
"1823b6de7d334a7aaabc4570719af4d9","1823b6de7d334a7aaabc4570719af4d9",22855361,11,0,1,1630,439,439,0
"1823b6de7d334a7aaabc4570719af4d9","0380cd76a7d44bc3a4da1f15e4d68f89",22855361,1,2,0,1641,439,440,1
"0380cd76a7d44bc3a4da1f15e4d68f89","070600601c4c439288445d2f0724807d",22855361,1,-4,0,1642,440,437,-3
"070600601c4c439288445d2f0724807d","0380cd76a7d44bc3a4da1f15e4d68f89",22855361,1,4,0,1643,437,440,3
"0380cd76a7d44bc3a4da1f15e4d68f89","0380cd76a7d44bc3a4da1f15e4d68f89",22855361,2,0,1,1644,440,440,0
"0380cd76a7d44bc3a4da1f15e4d68f89","23b7673c8b5443108c2ef09382834a86",22855361,1,2,0,1646,440,441,1
"23b7673c8b5443108c2ef09382834a86","23b7673c8b5443108c2ef09382834a86",22855361,3,0,1,1647,441,441,0
"23b7673c8b5443108c2ef09382834a86","901e92500aea43c79f19f1b279050668",22855361,1,2,0,1650,441,442,1
"901e92500aea43c79f19f1b279050668","901e92500aea43c79f19f1b279050668",22855361,4,0,1,1651,442,442,0
"901e92500aea43c79f19f1b279050668","001339db8ced4cf78829ebe8b145449d",22855361,1,1,0,1655,442,443,1
"001339db8ced4cf78829ebe8b145449d","001339db8ced4cf78829ebe8b145449d",22855361,5,0,1,1656,443,443,0
"001339db8ced4cf78829ebe8b145449d","452745e0366e42ae81561bfddebcc6c3",22855361,1,1,0,1661,443,444,1
"452745e0366e42ae81561bfddebcc6c3","452745e0366e42ae81561bfddebcc6c3",22855361,2,0,1,1662,444,444,0
"452745e0366e42ae81561bfddebcc6c3","4660ff2089114e8db82ceb26a4f329e3",22855361,1,2,0,1664,444,445,1
"4660ff2089114e8db82ceb26a4f329e3","901e92500aea43c79f19f1b279050668",22855361,1,-4,0,1665,445,442,-3
"901e92500aea43c79f19f1b279050668","4660ff2089114e8db82ceb26a4f329e3",22855361,1,4,0,1666,442,445,3
"4660ff2089114e8db82ceb26a4f329e3","4660ff2089114e8db82ceb26a4f329e3",22855361,3,0,1,1667,445,445,0
"4660ff2089114e8db82ceb26a4f329e3","7bd5586eb9d8484eb74a433ee7bfe499",22855361,1,2,0,1670,445,446,1
"7bd5586eb9d8484eb74a433ee7bfe499","7bd5586eb9d8484eb74a433ee7bfe499",22855361,13,0,1,1671,446,446,0
"7bd5586eb9d8484eb74a433ee7bfe499","8a7f26e690f34dda97be16904518ca99",22855361,1,2,0,1684,446,447,1
"8a7f26e690f34dda97be16904518ca99","8a7f26e690f34dda97be16904518ca99",22855361,1,0,1,1685,447,447,0
"8a7f26e690f34dda97be16904518ca99","b2f0d654738f48158edff28e8d3a546e",22855361,1,5,0,1686,447,449,2
"b2f0d654738f48158edff28e8d3a546e","070600601c4c439288445d2f0724807d",22855361,1,-21,0,1687,449,437,-12
"070600601c4c439288445d2f0724807d","b2f0d654738f48158edff28e8d3a546e",22855361,1,21,0,1688,437,449,12
"b2f0d654738f48158edff28e8d3a546e","b2f0d654738f48158edff28e8d3a546e",22855361,1,0,1,1689,449,449,0
"b2f0d654738f48158edff28e8d3a546e","f60ee41ec635499abd48168342d32c2f",22855361,4,5,0,1690,449,453,4
"f60ee41ec635499abd48168342d32c2f","b2f0d654738f48158edff28e8d3a546e",22855361,2,-5,0,1691,453,449,-4
"f60ee41ec635499abd48168342d32c2f","f60ee41ec635499abd48168342d32c2f",22855361,62,0,1,1693,453,453,0
"f60ee41ec635499abd48168342d32c2f","9428d8bd9c5a47b2a235b254e5e27ded",22855361,2,-1,0,1742,453,452,-1
"9428d8bd9c5a47b2a235b254e5e27ded","b2f0d654738f48158edff28e8d3a546e",22855361,1,-4,0,1743,452,449,-3
"9428d8bd9c5a47b2a235b254e5e27ded","f60ee41ec635499abd48168342d32c2f",22855361,1,1,0,1753,452,453,1
"f60ee41ec635499abd48168342d32c2f","f67fbf45a5f146ed866965bc57c7c001",22855361,1,3,0,1762,453,454,1
"f67fbf45a5f146ed866965bc57c7c001","b2f0d654738f48158edff28e8d3a546e",22855361,1,-8,0,1763,454,449,-5
"b2f0d654738f48158edff28e8d3a546e","f67fbf45a5f146ed866965bc57c7c001",22855361,1,8,0,1764,449,454,5
"f67fbf45a5f146ed866965bc57c7c001","f67fbf45a5f146ed866965bc57c7c001",22855361,1,0,1,1765,454,454,0
"f67fbf45a5f146ed866965bc57c7c001","d937afe49bd24a07a550dda1c1155122",22855361,1,1,0,1766,454,455,1
"d937afe49bd24a07a550dda1c1155122","d937afe49bd24a07a550dda1c1155122",22855361,1,0,1,1767,455,455,0
"d937afe49bd24a07a550dda1c1155122","3628b3f7823443d0912a339096b69943",22855361,1,1,0,1768,455,456,1
"3628b3f7823443d0912a339096b69943","3628b3f7823443d0912a339096b69943",22855361,1,0,1,1769,456,456,0
"3628b3f7823443d0912a339096b69943","9e049ee647cf43ecbcb5ed792a8e7588",22855361,1,1,0,1770,456,457,1
"9e049ee647cf43ecbcb5ed792a8e7588","9e049ee647cf43ecbcb5ed792a8e7588",22855361,1,0,1,1771,457,457,0
"9e049ee647cf43ecbcb5ed792a8e7588","5256a214faaf410b93f76cea06428334",22855361,1,1,0,1772,457,458,1
"5256a214faaf410b93f76cea06428334","5256a214faaf410b93f76cea06428334",22855361,1,0,1,1773,458,458,0
"5256a214faaf410b93f76cea06428334","25c32b120fce40fa9b6c85133aeb4716",22855361,1,1,0,1774,458,459,1
"25c32b120fce40fa9b6c85133aeb4716","25c32b120fce40fa9b6c85133aeb4716",22855361,1,0,1,1775,459,459,0
"25c32b120fce40fa9b6c85133aeb4716","11bc14f2204949008b7d511b933363c1",22855361,1,1,0,1776,459,460,1
"11bc14f2204949008b7d511b933363c1","11bc14f2204949008b7d511b933363c1",22855361,1,0,1,1777,460,460,0
"11bc14f2204949008b7d511b933363c1","42de338840a34d15adb66e7b14fb9d2c",22855361,1,1,0,1778,460,461,1
"42de338840a34d15adb66e7b14fb9d2c","42de338840a34d15adb66e7b14fb9d2c",22855361,1,0,1,1779,461,461,0
"42de338840a34d15adb66e7b14fb9d2c","9da37c6210b1416b8079c274f70bf600",22855361,1,1,0,1780,461,462,1
"9da37c6210b1416b8079c274f70bf600","9da37c6210b1416b8079c274f70bf600",22855361,1,0,1,1781,462,462,0
"9da37c6210b1416b8079c274f70bf600","519119f1deac45ff9ab4f13529be5c6e",22855361,1,1,0,1782,462,463,1
"519119f1deac45ff9ab4f13529be5c6e","519119f1deac45ff9ab4f13529be5c6e",22855361,1,0,1,1783,463,463,0
"519119f1deac45ff9ab4f13529be5c6e","c5df9f40ec14463b9dcfdc73df3e9285",22855361,1,3,0,1784,463,464,1
"c5df9f40ec14463b9dcfdc73df3e9285","f67fbf45a5f146ed866965bc57c7c001",22855361,1,-12,0,1785,464,454,-10
"f67fbf45a5f146ed866965bc57c7c001","c5df9f40ec14463b9dcfdc73df3e9285",22855361,1,12,0,1786,454,464,10
"c5df9f40ec14463b9dcfdc73df3e9285","83d42d95cd844fc093fc09cee250edb8",22855361,2,3,0,1787,464,465,1
"83d42d95cd844fc093fc09cee250edb8","c5df9f40ec14463b9dcfdc73df3e9285",22855361,1,-3,0,1788,465,464,-1
"83d42d95cd844fc093fc09cee250edb8","eb2a0eb537344a9e891c761662e400b6",22855361,1,-632,0,1790,465,16,-449
"eb2a0eb537344a9e891c761662e400b6","56586aa865414f538729c7f7735d2bc6",22855361,1,-8,0,1791,16,12,-4
"56586aa865414f538729c7f7735d2bc6","5c5ceeee4562457ba6d41515aeebfbb1",22855361,1,10,0,1792,12,17,5
"5c5ceeee4562457ba6d41515aeebfbb1","eb2a0eb537344a9e891c761662e400b6",22855361,1,-2,0,1793,17,16,-1
"eb2a0eb537344a9e891c761662e400b6","83d42d95cd844fc093fc09cee250edb8",22855361,1,632,0,1794,16,465,449
"83d42d95cd844fc093fc09cee250edb8","83d42d95cd844fc093fc09cee250edb8",22855361,8,0,1,1795,465,465,0
"e2911e79efc2420eac45d9f671463d4b","e2911e79efc2420eac45d9f671463d4b",22855438,4,0,1,1,2,2,0
"e2911e79efc2420eac45d9f671463d4b","b613861cecf84ffcab01afb23f660475",22855438,1,-3,0,2,2,1,-1
"b613861cecf84ffcab01afb23f660475","b613861cecf84ffcab01afb23f660475",22855438,4,0,1,3,1,1,0
"b613861cecf84ffcab01afb23f660475","e2911e79efc2420eac45d9f671463d4b",22855438,1,3,0,7,1,2,1
"e2911e79efc2420eac45d9f671463d4b","519d1b8c59404d67b54e96c5c8a830b2",22855438,1,1,0,10,2,3,1
"519d1b8c59404d67b54e96c5c8a830b2","519d1b8c59404d67b54e96c5c8a830b2",22855438,1,0,1,11,3,3,0
"519d1b8c59404d67b54e96c5c8a830b2","e2911e79efc2420eac45d9f671463d4b",22855438,1,-1,0,12,3,2,-1
"e2911e79efc2420eac45d9f671463d4b","531db53f81f646edb0cdcfe0085b03b7",22855438,1,2,0,14,2,4,2
"531db53f81f646edb0cdcfe0085b03b7","531db53f81f646edb0cdcfe0085b03b7",22855438,1,0,1,15,4,4,0
"531db53f81f646edb0cdcfe0085b03b7","4f5f94b2f95141e0a9d53a61da2276da",22855438,1,1,0,16,4,5,1
"4f5f94b2f95141e0a9d53a61da2276da","4f5f94b2f95141e0a9d53a61da2276da",22855438,1,0,1,17,5,5,0
"4f5f94b2f95141e0a9d53a61da2276da","6d541c89590949f99af293c4f2333f67",22855438,1,1,0,18,5,6,1
"6d541c89590949f99af293c4f2333f67","6d541c89590949f99af293c4f2333f67",22855438,1,0,1,19,6,6,0
"6d541c89590949f99af293c4f2333f67","dd5cf0b9fe4c4f1d8f5ff8e4c04879cb",22855438,1,1,0,20,6,7,1
"dd5cf0b9fe4c4f1d8f5ff8e4c04879cb","dd5cf0b9fe4c4f1d8f5ff8e4c04879cb",22855438,1,0,1,21,7,7,0
"dd5cf0b9fe4c4f1d8f5ff8e4c04879cb","f96261861edc426abe2248be4f0a709a",22855438,1,1,0,22,7,8,1
"f96261861edc426abe2248be4f0a709a","f96261861edc426abe2248be4f0a709a",22855438,1,0,1,23,8,8,0
"f96261861edc426abe2248be4f0a709a","66b5e16f4f75454fb5b8172079f0fa83",22855438,1,1,0,24,8,9,1
"66b5e16f4f75454fb5b8172079f0fa83","66b5e16f4f75454fb5b8172079f0fa83",22855438,1,0,1,25,9,9,0
"66b5e16f4f75454fb5b8172079f0fa83","0680571d4698477995e41842c36a54b2",22855438,1,1,0,26,9,10,1
"0680571d4698477995e41842c36a54b2","0680571d4698477995e41842c36a54b2",22855438,1,0,1,27,10,10,0
"0680571d4698477995e41842c36a54b2","9112f2bffece48e08c6d2287be204085",22855438,1,1,0,28,10,11,1
"9112f2bffece48e08c6d2287be204085","9112f2bffece48e08c6d2287be204085",22855438,1,0,1,29,11,11,0
"9112f2bffece48e08c6d2287be204085","e2911e79efc2420eac45d9f671463d4b",22855438,1,-9,0,30,11,2,-9
"e2911e79efc2420eac45d9f671463d4b","56586aa865414f538729c7f7735d2bc6",22855438,1,12,0,31,2,12,10
"56586aa865414f538729c7f7735d2bc6","56586aa865414f538729c7f7735d2bc6",22855438,3,0,1,32,12,12,0
"56586aa865414f538729c7f7735d2bc6","b7f2b31585d94eb3bf86376714aa7070",22855438,1,2,0,35,12,13,1
"b7f2b31585d94eb3bf86376714aa7070","b7f2b31585d94eb3bf86376714aa7070",22855438,2,0,1,36,13,13,0
"b7f2b31585d94eb3bf86376714aa7070","3f1c815879794b929260d224becaff7e",22855438,1,2,0,38,13,14,1
"3f1c815879794b929260d224becaff7e","56586aa865414f538729c7f7735d2bc6",22855438,1,-4,0,39,14,12,-2
"56586aa865414f538729c7f7735d2bc6","eb2a0eb537344a9e891c761662e400b6",22855438,1,8,0,40,12,16,4
"5c5ceeee4562457ba6d41515aeebfbb1","5c5ceeee4562457ba6d41515aeebfbb1",22855438,1,0,1,42,17,17,0
"5c5ceeee4562457ba6d41515aeebfbb1","9afd71a5298d4333b6849dfce1b9422c",22855438,1,3,0,43,17,18,1
"9afd71a5298d4333b6849dfce1b9422c","9afd71a5298d4333b6849dfce1b9422c",22855438,2,0,1,46,18,18,0
"b7719e26494940efa49512aedd0aac79","d4f45188d3c84a02ba08454e6403a818",22855438,1,5,0,49,20,24,4
"d4c3b003e8274e429d2fa688d73fde6d","d4c3b003e8274e429d2fa688d73fde6d",22855438,4,0,1,51,22,22,0
"d4c3b003e8274e429d2fa688d73fde6d","9afd71a5298d4333b6849dfce1b9422c",22855438,1,-7,0,55,22,18,-4
"b7719e26494940efa49512aedd0aac79","b7719e26494940efa49512aedd0aac79",22855438,2,0,1,57,20,20,0
"4e51676dc72045d99c19b9fa7b22f8bc","afbf7250b99d47bea07172749483ca97",22855438,1,-3,0,65,29,28,-1
"4e51676dc72045d99c19b9fa7b22f8bc","51970cfa30e643e894e66ae85c8024cc",22855438,1,3,0,67,29,31,2
"51970cfa30e643e894e66ae85c8024cc","c33c17be71ae4d588da7369472e5bb1b",22855438,1,6,0,68,31,34,3
"c33c17be71ae4d588da7369472e5bb1b","4e51676dc72045d99c19b9fa7b22f8bc",22855438,1,-9,0,69,34,29,-5
"4e51676dc72045d99c19b9fa7b22f8bc","c33c17be71ae4d588da7369472e5bb1b",22855438,1,9,0,70,29,34,5
"c33c17be71ae4d588da7369472e5bb1b","93679be414554a11b1893002f2229a93",22855438,1,3,0,71,34,35,1
"93679be414554a11b1893002f2229a93","93679be414554a11b1893002f2229a93",22855438,1,0,1,72,35,35,0
"93679be414554a11b1893002f2229a93","7040a13096d746ac84b8fac8d9752058",22855438,1,3,0,73,35,36,1
"7040a13096d746ac84b8fac8d9752058","7040a13096d746ac84b8fac8d9752058",22855438,1,0,1,74,36,36,0
"7040a13096d746ac84b8fac8d9752058","9a0dc646f934470daf08c4b56ccf73db",22855438,1,3,0,75,36,37,1
"9a0dc646f934470daf08c4b56ccf73db","9a0dc646f934470daf08c4b56ccf73db",22855438,1,0,1,76,37,37,0
"9a0dc646f934470daf08c4b56ccf73db","fc0e049d56024bc9a02c9a9c435c3df7",22855438,1,3,0,77,37,38,1
"fc0e049d56024bc9a02c9a9c435c3df7","fc0e049d56024bc9a02c9a9c435c3df7",22855438,1,0,1,78,38,38,0
"fc0e049d56024bc9a02c9a9c435c3df7","67a089198fcb4e1c8f2385786c2b296f",22855438,1,4,0,79,38,39,1
"67a089198fcb4e1c8f2385786c2b296f","64d48c6c9c7940639a932219a6c87198",22855438,2,1,0,80,39,40,1
"64d48c6c9c7940639a932219a6c87198","67a089198fcb4e1c8f2385786c2b296f",22855438,2,-1,0,81,40,39,-1
"64d48c6c9c7940639a932219a6c87198","64d48c6c9c7940639a932219a6c87198",22855438,1,0,1,83,40,40,0
"67a089198fcb4e1c8f2385786c2b296f","b534b89233134e30a9b5645138bfa9ee",22855438,1,4,0,85,39,41,2
"b534b89233134e30a9b5645138bfa9ee","0e37b720d23b4e7f8b313e79313fd107",22855438,1,3,0,86,41,44,3
"0e37b720d23b4e7f8b313e79313fd107","0e37b720d23b4e7f8b313e79313fd107",22855438,1,0,1,87,44,44,0
"0e37b720d23b4e7f8b313e79313fd107","6875d67fdd5f48168b62719df449bebd",22855438,1,1,0,88,44,45,1
"6875d67fdd5f48168b62719df449bebd","6875d67fdd5f48168b62719df449bebd",22855438,1,0,1,89,45,45,0
"6875d67fdd5f48168b62719df449bebd","6e13d61a7bdb44bca949c9f86fab3be5",22855438,1,3,0,90,45,47,2
"6e13d61a7bdb44bca949c9f86fab3be5","b534b89233134e30a9b5645138bfa9ee",22855438,1,-7,0,91,47,41,-6
"b534b89233134e30a9b5645138bfa9ee","6e13d61a7bdb44bca949c9f86fab3be5",22855438,1,7,0,92,41,47,6
"6e13d61a7bdb44bca949c9f86fab3be5","195f78799f984cc2b06c48dfe36be751",22855438,1,2,0,93,47,49,2
"195f78799f984cc2b06c48dfe36be751","195f78799f984cc2b06c48dfe36be751",22855438,2,0,1,94,49,49,0
"195f78799f984cc2b06c48dfe36be751","d9c8d8c444a64dadbbb508652c721e17",22855438,1,-3,0,96,49,46,-3
"d9c8d8c444a64dadbbb508652c721e17","d0c74f735e024943943e40333d6d337f",22855438,1,6,0,97,46,51,5
"d0c74f735e024943943e40333d6d337f","d0c74f735e024943943e40333d6d337f",22855438,1,0,1,98,51,51,0
"d0c74f735e024943943e40333d6d337f","983f8ff320594b279a7f4a6fe132f9c5",22855438,1,2,0,99,51,53,2
"983f8ff320594b279a7f4a6fe132f9c5","983f8ff320594b279a7f4a6fe132f9c5",22855438,2,0,1,100,53,53,0
"983f8ff320594b279a7f4a6fe132f9c5","35adfa5d923046aebabfefd98f35ff05",22855438,1,1,0,102,53,54,1
"35adfa5d923046aebabfefd98f35ff05","35adfa5d923046aebabfefd98f35ff05",22855438,8,0,1,103,54,54,0
"35adfa5d923046aebabfefd98f35ff05","b6f8a98476224da1b40e555ececc7ed8",22855438,1,1,0,111,54,55,1
"b6f8a98476224da1b40e555ececc7ed8","b6f8a98476224da1b40e555ececc7ed8",22855438,2,0,1,112,55,55,0
"b6f8a98476224da1b40e555ececc7ed8","86e22cb5fe0e4b47a9489ecddf7ed78f",22855438,1,1,0,114,55,56,1
"86e22cb5fe0e4b47a9489ecddf7ed78f","86e22cb5fe0e4b47a9489ecddf7ed78f",22855438,2,0,1,115,56,56,0
"86e22cb5fe0e4b47a9489ecddf7ed78f","f924752d8a1149668870b1e7698486f7",22855438,1,-6,0,117,56,50,-6
"f924752d8a1149668870b1e7698486f7","78f30e4dcac84e3cbea8b2cc6e0d62b3",22855438,1,10,0,118,50,59,9
"78f30e4dcac84e3cbea8b2cc6e0d62b3","a1f2f12debe5432fb7a70bcd12bacfb9",22855438,3,-1,0,119,59,58,-1
"a1f2f12debe5432fb7a70bcd12bacfb9","b534b89233134e30a9b5645138bfa9ee",22855438,2,-20,0,120,58,41,-17
"b534b89233134e30a9b5645138bfa9ee","a1f2f12debe5432fb7a70bcd12bacfb9",22855438,2,20,0,121,41,58,17
"a1f2f12debe5432fb7a70bcd12bacfb9","78f30e4dcac84e3cbea8b2cc6e0d62b3",22855438,3,1,0,122,58,59,1
"78f30e4dcac84e3cbea8b2cc6e0d62b3","b534b89233134e30a9b5645138bfa9ee",22855438,1,-21,0,123,59,41,-18
"b534b89233134e30a9b5645138bfa9ee","78f30e4dcac84e3cbea8b2cc6e0d62b3",22855438,1,21,0,124,41,59,18
"a1f2f12debe5432fb7a70bcd12bacfb9","a1f2f12debe5432fb7a70bcd12bacfb9",22855438,27,0,1,126,58,58,0
"78f30e4dcac84e3cbea8b2cc6e0d62b3","78f30e4dcac84e3cbea8b2cc6e0d62b3",22855438,11,0,1,158,59,59,0
"78f30e4dcac84e3cbea8b2cc6e0d62b3","bc42d26810654ea9a1df1efe1e58c7d5",22855438,1,5,0,169,59,63,4
"bc42d26810654ea9a1df1efe1e58c7d5","12aa6e1672ac4e7aa6449a7a8609cd72",22855438,1,-7,0,170,63,57,-6
"12aa6e1672ac4e7aa6449a7a8609cd72","a0a418b8540d479fa6e0f653b701da8b",22855438,1,8,0,171,57,64,7
"a0a418b8540d479fa6e0f653b701da8b","4c943503763e4e349906eea3ed3c8e86",22855438,1,-3,0,172,64,61,-3
"4c943503763e4e349906eea3ed3c8e86","4c943503763e4e349906eea3ed3c8e86",22855438,1,0,1,173,61,61,0
"4c943503763e4e349906eea3ed3c8e86","bc42d26810654ea9a1df1efe1e58c7d5",22855438,1,2,0,174,61,63,2
"bc42d26810654ea9a1df1efe1e58c7d5","bc42d26810654ea9a1df1efe1e58c7d5",22855438,3,0,1,175,63,63,0
"bc42d26810654ea9a1df1efe1e58c7d5","a0a418b8540d479fa6e0f653b701da8b",22855438,1,1,0,178,63,64,1
"a0a418b8540d479fa6e0f653b701da8b","a0a418b8540d479fa6e0f653b701da8b",22855438,3,0,1,179,64,64,0
"a0a418b8540d479fa6e0f653b701da8b","309ccf3cc4fe429d9bfbaef53d3fa479",22855438,1,-4,0,182,64,60,-4
"309ccf3cc4fe429d9bfbaef53d3fa479","b534b89233134e30a9b5645138bfa9ee",22855438,1,-23,0,183,60,41,-19
"b534b89233134e30a9b5645138bfa9ee","d646286c8051419bbc2e31dd1db55ca8",22855438,1,33,0,184,41,67,26
"d646286c8051419bbc2e31dd1db55ca8","267f883678b24aed855fde42524975d9",22855438,1,4,0,185,67,71,4
"267f883678b24aed855fde42524975d9","267f883678b24aed855fde42524975d9",22855438,1,0,1,186,71,71,0
"267f883678b24aed855fde42524975d9","88fff56d0342490dbef9040750a20f6c",22855438,1,1,0,187,71,72,1
"88fff56d0342490dbef9040750a20f6c","88fff56d0342490dbef9040750a20f6c",22855438,1,0,1,188,72,72,0
"88fff56d0342490dbef9040750a20f6c","adb17b12b66c4a49a85fd34322f7df70",22855438,1,1,0,189,72,73,1
"adb17b12b66c4a49a85fd34322f7df70","adb17b12b66c4a49a85fd34322f7df70",22855438,1,0,1,190,73,73,0
"adb17b12b66c4a49a85fd34322f7df70","d646286c8051419bbc2e31dd1db55ca8",22855438,1,-6,0,191,73,67,-6
"a2becd407db34b189200a32546d9d569","a2becd407db34b189200a32546d9d569",22855438,1,0,1,193,75,75,0
"a2becd407db34b189200a32546d9d569","58c22b011d0f4c2ea6d13615edbb9eeb",22855438,1,2,0,194,75,77,2
"58c22b011d0f4c2ea6d13615edbb9eeb","58c22b011d0f4c2ea6d13615edbb9eeb",22855438,5,0,1,195,77,77,0
"58c22b011d0f4c2ea6d13615edbb9eeb","dd76e1861dc9461c830888729d091ee0",22855438,1,1,0,200,77,78,1
"dd76e1861dc9461c830888729d091ee0","dd76e1861dc9461c830888729d091ee0",22855438,8,0,1,201,78,78,0
"dd76e1861dc9461c830888729d091ee0","cd1d828f1a694b87913a7ea66c23803e",22855438,1,1,0,209,78,79,1
"cd1d828f1a694b87913a7ea66c23803e","cd1d828f1a694b87913a7ea66c23803e",22855438,2,0,1,210,79,79,0
"cd1d828f1a694b87913a7ea66c23803e","9176a3c2b4d2465fa8b0c67096c2a97e",22855438,1,1,0,212,79,80,1
"9176a3c2b4d2465fa8b0c67096c2a97e","9176a3c2b4d2465fa8b0c67096c2a97e",22855438,5,0,1,213,80,80,0
"9176a3c2b4d2465fa8b0c67096c2a97e","f8ec6445f7194e25b9101d4fbcb07a18",22855438,1,1,0,218,80,81,1
"f8ec6445f7194e25b9101d4fbcb07a18","f8ec6445f7194e25b9101d4fbcb07a18",22855438,5,0,1,219,81,81,0
"f8ec6445f7194e25b9101d4fbcb07a18","140d5b27b8574befad82c0a013b59dfa",22855438,1,-7,0,224,81,74,-7
"d18a9ea32855445f8736581f5cb119ce","f564483cbd7a407681aa2fcca518cf5f",22855438,1,4,0,226,82,85,3
"f564483cbd7a407681aa2fcca518cf5f","18fd01350bd5434ca636d59a599d768a",22855438,1,1,0,231,85,86,1
"18fd01350bd5434ca636d59a599d768a","18fd01350bd5434ca636d59a599d768a",22855438,8,0,1,232,86,86,0
"18fd01350bd5434ca636d59a599d768a","ae5ac430ea254e708a6f5deaaf7464ae",22855438,1,-2,0,240,86,84,-2
"c681290961c94c4caf23b529d1ae6b9a","6a9f0ef185fb47f0937e29daa1c71ed5",22855438,1,2,0,244,88,90,2
"6a9f0ef185fb47f0937e29daa1c71ed5","e20db35ced8544ddac5bc3839145e463",22855438,1,3,0,245,90,91,1
"e20db35ced8544ddac5bc3839145e463","d646286c8051419bbc2e31dd1db55ca8",22855438,1,-30,0,246,91,67,-24
"d646286c8051419bbc2e31dd1db55ca8","1febb706d7a34005ae8711ed49c76e64",22855438,1,33,0,247,67,94,27
"1febb706d7a34005ae8711ed49c76e64","1febb706d7a34005ae8711ed49c76e64",22855438,5,0,1,248,94,94,0
"1febb706d7a34005ae8711ed49c76e64","8f73ba6f5a0042f2850356ac38ac6f24",22855438,1,1,0,253,94,95,1
"8f73ba6f5a0042f2850356ac38ac6f24","8f73ba6f5a0042f2850356ac38ac6f24",22855438,5,0,1,254,95,95,0
"8f73ba6f5a0042f2850356ac38ac6f24","e2260b86653c46d7b14a41fb419dbf8c",22855438,1,1,0,259,95,96,1
"e2260b86653c46d7b14a41fb419dbf8c","e2260b86653c46d7b14a41fb419dbf8c",22855438,5,0,1,260,96,96,0
"e2260b86653c46d7b14a41fb419dbf8c","35eb641ad1d845bbba54915bce75a962",22855438,1,1,0,265,96,97,1
"35eb641ad1d845bbba54915bce75a962","35eb641ad1d845bbba54915bce75a962",22855438,5,0,1,266,97,97,0
"35eb641ad1d845bbba54915bce75a962","08be90ffbeea4795a138cd42ed8db56f",22855438,1,1,0,271,97,98,1
"08be90ffbeea4795a138cd42ed8db56f","08be90ffbeea4795a138cd42ed8db56f",22855438,5,0,1,272,98,98,0
"08be90ffbeea4795a138cd42ed8db56f","3007433c8f584dcbb5ac159c1c5f2be3",22855438,1,1,0,277,98,99,1
"3007433c8f584dcbb5ac159c1c5f2be3","00ae5f0c51874a73a41ebea838d95682",22855438,1,3,0,280,99,101,2
"00ae5f0c51874a73a41ebea838d95682","e20db35ced8544ddac5bc3839145e463",22855438,1,-11,0,281,101,91,-10
"e20db35ced8544ddac5bc3839145e463","d391c8b6e56a43a7b654e9dee02d904b",22855438,1,13,0,282,91,103,12
"d391c8b6e56a43a7b654e9dee02d904b","00ae5f0c51874a73a41ebea838d95682",22855438,3,-2,0,283,103,101,-2
"d391c8b6e56a43a7b654e9dee02d904b","d391c8b6e56a43a7b654e9dee02d904b",22855438,30,0,1,285,103,103,0
"6111116566fc4fd9abba409322bea245","a81b2235cb9c499eb9ea8ee0a8dd9725",22855438,1,1,0,322,104,105,1
"a81b2235cb9c499eb9ea8ee0a8dd9725","a81b2235cb9c499eb9ea8ee0a8dd9725",22855438,8,0,1,323,105,105,0
"a81b2235cb9c499eb9ea8ee0a8dd9725","2d4e0ab0ef3b4d73b82c72d4621a7579",22855438,1,1,0,331,105,106,1
"8bdebf492ebd4e62b0d522e8ab5e5197","73039f8c1eb9409cb4caee2cf968001e",22855438,1,-7,0,337,107,100,-7
"73039f8c1eb9409cb4caee2cf968001e","4280927ec4d643238aa49c32f9e06c6c",22855438,1,10,0,338,100,109,9
"4280927ec4d643238aa49c32f9e06c6c","4280927ec4d643238aa49c32f9e06c6c",22855438,1,0,1,339,109,109,0
"4280927ec4d643238aa49c32f9e06c6c","fc44e6a5f7654430af1227838224dceb",22855438,1,2,0,340,109,111,2
"fc44e6a5f7654430af1227838224dceb","fc44e6a5f7654430af1227838224dceb",22855438,2,0,1,341,111,111,0
"fc44e6a5f7654430af1227838224dceb","08111f75e22d409998cf8b85bd431f0a",22855438,1,-3,0,343,111,108,-3
"08111f75e22d409998cf8b85bd431f0a","a9ae0a3c070d455bb4369a8996313336",22855438,1,7,0,344,108,114,6
"a9ae0a3c070d455bb4369a8996313336","a9ae0a3c070d455bb4369a8996313336",22855438,1,0,1,345,114,114,0
"a9ae0a3c070d455bb4369a8996313336","e20db35ced8544ddac5bc3839145e463",22855438,1,-26,0,346,114,91,-23
"e20db35ced8544ddac5bc3839145e463","a9ae0a3c070d455bb4369a8996313336",22855438,1,26,0,347,91,114,23
"a9ae0a3c070d455bb4369a8996313336","71cec822bcff4f30a20e75dc63ef7b65",22855438,1,2,0,348,114,116,2
"71cec822bcff4f30a20e75dc63ef7b65","71cec822bcff4f30a20e75dc63ef7b65",22855438,3,0,1,349,116,116,0
"71cec822bcff4f30a20e75dc63ef7b65","37319e88176d4aefa91d7a9980dbae91",22855438,1,-4,0,352,116,112,-4
"37319e88176d4aefa91d7a9980dbae91","62bff51286ef4f348717a3cf6fe2318f",22855438,1,9,0,353,112,120,8
"62bff51286ef4f348717a3cf6fe2318f","b1cd0e7dc3ad4a8eb91a4bfdbeb025b0",22855438,1,-2,0,354,120,118,-2
"b1cd0e7dc3ad4a8eb91a4bfdbeb025b0","b1cd0e7dc3ad4a8eb91a4bfdbeb025b0",22855438,1,0,1,355,118,118,0
"b1cd0e7dc3ad4a8eb91a4bfdbeb025b0","62bff51286ef4f348717a3cf6fe2318f",22855438,1,2,0,356,118,120,2
"62bff51286ef4f348717a3cf6fe2318f","62bff51286ef4f348717a3cf6fe2318f",22855438,3,0,1,357,120,120,0
"62bff51286ef4f348717a3cf6fe2318f","779f9ddd1fd14d1e9e69f72219a1fdbd",22855438,1,3,0,360,120,121,1
"779f9ddd1fd14d1e9e69f72219a1fdbd","e20db35ced8544ddac5bc3839145e463",22855438,1,-36,0,361,121,91,-30
"e20db35ced8544ddac5bc3839145e463","ae26e6cda8ad4a3f81bd347560d9579f",22855438,1,40,0,362,91,125,34
"ae26e6cda8ad4a3f81bd347560d9579f","ae26e6cda8ad4a3f81bd347560d9579f",22855438,3,0,1,363,125,125,0
"ae26e6cda8ad4a3f81bd347560d9579f","ee48df95832b4374aa273ceb27ec1315",22855438,1,1,0,366,125,126,1
"ee48df95832b4374aa273ceb27ec1315","ee48df95832b4374aa273ceb27ec1315",22855438,1,0,1,367,126,126,0
"ee48df95832b4374aa273ceb27ec1315","7a439da90b394756ad1777fc4c6dead5",22855438,1,1,0,368,126,127,1
"7a439da90b394756ad1777fc4c6dead5","7a439da90b394756ad1777fc4c6dead5",22855438,5,0,1,369,127,127,0
"7a439da90b394756ad1777fc4c6dead5","779f9ddd1fd14d1e9e69f72219a1fdbd",22855438,1,-6,0,374,127,121,-6
"779f9ddd1fd14d1e9e69f72219a1fdbd","a8dd5213034441ac92724b4e83eb0bb2",22855438,1,9,0,375,121,129,8
"a8dd5213034441ac92724b4e83eb0bb2","a8dd5213034441ac92724b4e83eb0bb2",22855438,1,0,1,376,129,129,0
"a8dd5213034441ac92724b4e83eb0bb2","8115eab6556b45f5b415c3b8c26a12e5",22855438,1,2,0,377,129,131,2
"8115eab6556b45f5b415c3b8c26a12e5","8115eab6556b45f5b415c3b8c26a12e5",22855438,2,0,1,378,131,131,0
"8115eab6556b45f5b415c3b8c26a12e5","ec34b06efd844b46a4c4818ecdb9b8f4",22855438,1,1,0,380,131,132,1
"ec34b06efd844b46a4c4818ecdb9b8f4","ec34b06efd844b46a4c4818ecdb9b8f4",22855438,2,0,1,381,132,132,0
"ec34b06efd844b46a4c4818ecdb9b8f4","c2e1c2b9eac64109b343a088584b576b",22855438,1,1,0,383,132,133,1
"c2e1c2b9eac64109b343a088584b576b","c2e1c2b9eac64109b343a088584b576b",22855438,2,0,1,384,133,133,0
"c2e1c2b9eac64109b343a088584b576b","a8dd5213034441ac92724b4e83eb0bb2",22855438,1,-4,0,386,133,129,-4
"a8dd5213034441ac92724b4e83eb0bb2","579338175e0b4bbb8ef3b712b5d8b54e",22855438,1,-1,0,387,129,128,-1
"579338175e0b4bbb8ef3b712b5d8b54e","8bc5795d6a984a3eace4e2811e52dd4f",22855438,1,8,0,388,128,135,7
"cd4532ad48034873ba8bce2aac0c9808","df1de691dafe4549a18a4398ee9dfaf9",22855438,1,4,0,395,137,139,2
"df1de691dafe4549a18a4398ee9dfaf9","779f9ddd1fd14d1e9e69f72219a1fdbd",22855438,1,-23,0,396,139,121,-18
"779f9ddd1fd14d1e9e69f72219a1fdbd","6c5ad271a44743479bfaea29b1db8d02",22855438,1,27,0,397,121,143,22
"6c5ad271a44743479bfaea29b1db8d02","6c5ad271a44743479bfaea29b1db8d02",22855438,1,0,1,398,143,143,0
"402bba41861d43acb52a5abb89e8831e","df1de691dafe4549a18a4398ee9dfaf9",22855438,1,-6,0,409,145,139,-6
"8aae34f5ddbb4052a709b12e6b0d40fa","8aae34f5ddbb4052a709b12e6b0d40fa",22855438,1,0,1,411,147,147,0
"06882a8492d9499aa31555567f575ecb","f293c508f409466a8f27ddd7d1e40b20",22855438,1,1,0,430,154,155,1
"f293c508f409466a8f27ddd7d1e40b20","f293c508f409466a8f27ddd7d1e40b20",22855438,8,0,1,431,155,155,0
"f293c508f409466a8f27ddd7d1e40b20","cc4ddef5bbbe48ebb605141b347c4ed1",22855438,1,1,0,439,155,156,1
"cc4ddef5bbbe48ebb605141b347c4ed1","cc4ddef5bbbe48ebb605141b347c4ed1",22855438,5,0,1,440,156,156,0
"cc4ddef5bbbe48ebb605141b347c4ed1","d313cec988a84645bee413e8d4724a4b",22855438,1,3,0,445,156,158,2
"d313cec988a84645bee413e8d4724a4b","df1de691dafe4549a18a4398ee9dfaf9",22855438,1,-22,0,451,158,139,-19
"78adeee1fa2c4fe0bc73f7bca9fcee86","78adeee1fa2c4fe0bc73f7bca9fcee86",22855438,1,0,1,453,160,160,0
"65202579580f4ad38d734b4ee39d22a8","8959e6304a0348309a771e4d08d1b64a",22855438,1,-1,0,462,164,163,-1
"8959e6304a0348309a771e4d08d1b64a","78adeee1fa2c4fe0bc73f7bca9fcee86",22855438,1,-4,0,463,163,160,-3
"78adeee1fa2c4fe0bc73f7bca9fcee86","3cbcea2be0984e7dbd5a48195af10ce7",22855438,2,8,0,517,160,165,5
"3cbcea2be0984e7dbd5a48195af10ce7","82e6285962b8400d9d6fc32436022a94",22855438,2,2,0,518,165,167,2
"82e6285962b8400d9d6fc32436022a94","a9ac840f098c4bd0a2ee896214ce29cd",22855438,1,3,0,519,167,168,1
"a9ac840f098c4bd0a2ee896214ce29cd","3cbcea2be0984e7dbd5a48195af10ce7",22855438,1,-5,0,520,168,165,-3
"3cbcea2be0984e7dbd5a48195af10ce7","78adeee1fa2c4fe0bc73f7bca9fcee86",22855438,1,-8,0,521,165,160,-5
"82e6285962b8400d9d6fc32436022a94","3cbcea2be0984e7dbd5a48195af10ce7",22855438,1,-2,0,535,167,165,-2
"3cbcea2be0984e7dbd5a48195af10ce7","a9ac840f098c4bd0a2ee896214ce29cd",22855438,1,5,0,536,165,168,3
"a9ac840f098c4bd0a2ee896214ce29cd","a9ac840f098c4bd0a2ee896214ce29cd",22855438,1,0,1,537,168,168,0
"a9ac840f098c4bd0a2ee896214ce29cd","0c7262dff33c4087bc660ccf40f92f9c",22855438,1,4,0,538,168,169,1
"0c7262dff33c4087bc660ccf40f92f9c","b2275c3fad834f8d90737a2d9a6927d6",22855438,2,3,0,539,169,172,3
"b2275c3fad834f8d90737a2d9a6927d6","b2275c3fad834f8d90737a2d9a6927d6",22855438,25,0,1,540,172,172,0
"b2275c3fad834f8d90737a2d9a6927d6","0c7262dff33c4087bc660ccf40f92f9c",22855438,1,-3,0,549,172,169,-3
"b2275c3fad834f8d90737a2d9a6927d6","eb515a26030b41f8a82a1e6114420bad",22855438,1,1,0,567,172,173,1
"eb515a26030b41f8a82a1e6114420bad","eb515a26030b41f8a82a1e6114420bad",22855438,2,0,1,568,173,173,0
"eb515a26030b41f8a82a1e6114420bad","b42cc17b7de840f181a704558d0bc845",22855438,1,3,0,570,173,175,2
"b42cc17b7de840f181a704558d0bc845","0c7262dff33c4087bc660ccf40f92f9c",22855438,1,-7,0,571,175,169,-6
"0c7262dff33c4087bc660ccf40f92f9c","b42cc17b7de840f181a704558d0bc845",22855438,1,7,0,572,169,175,6
"b42cc17b7de840f181a704558d0bc845","801f9e9135034f49bf5f8b4bdefedb41",22855438,1,2,0,573,175,177,2
"801f9e9135034f49bf5f8b4bdefedb41","801f9e9135034f49bf5f8b4bdefedb41",22855438,7,0,1,574,177,177,0
"801f9e9135034f49bf5f8b4bdefedb41","362fcb0699a14845ab29b2340093e528",22855438,1,-3,0,581,177,174,-3
"362fcb0699a14845ab29b2340093e528","ea38cc0e6e6e41edbabf210220808bf9",22855438,1,6,0,582,174,179,5
"b87c552dd247427abe6ab5795b9c9d43","b87c552dd247427abe6ab5795b9c9d43",22855438,7,0,1,586,181,181,0
"30f660a1feb34582a739722532524f79","30f660a1feb34582a739722532524f79",22855438,9,0,1,595,183,183,0
"c8e371568a0c4391b25796ae4e91952e","ab11d94c6c8948ea90b88f19d2cd502b",22855438,1,5,0,610,186,190,4
"ab11d94c6c8948ea90b88f19d2cd502b","ab11d94c6c8948ea90b88f19d2cd502b",22855438,1,0,1,611,190,190,0
"ab11d94c6c8948ea90b88f19d2cd502b","f992451ed6ad4e68bb9e68ad6be7c4be",22855438,1,2,0,612,190,192,2
"f992451ed6ad4e68bb9e68ad6be7c4be","07b44a7a51e94c78b411c753fc39dab0",22855438,1,-3,0,614,192,189,-3
"07b44a7a51e94c78b411c753fc39dab0","6cd2dcaac46847d4a0bc53f296d90375",22855438,1,6,0,615,189,194,5
"6cd2dcaac46847d4a0bc53f296d90375","6cd2dcaac46847d4a0bc53f296d90375",22855438,1,0,1,616,194,194,0
"6cd2dcaac46847d4a0bc53f296d90375","2d2580c9411c4972909db508d6956a58",22855438,1,2,0,617,194,196,2
"d5e8e2bd12a2466b9d6d90855f0eb079","017d7ca8e0394b91aaadc9574df2202c",22855438,1,-5,0,626,198,193,-5
"017d7ca8e0394b91aaadc9574df2202c","54e8e9f0ea3e45c4bf3b8ac799ee31b1",22855438,1,8,0,627,193,200,7
"54e8e9f0ea3e45c4bf3b8ac799ee31b1","54e8e9f0ea3e45c4bf3b8ac799ee31b1",22855438,1,0,1,628,200,200,0
"54e8e9f0ea3e45c4bf3b8ac799ee31b1","c614a00911be4877a075f19315530fb0",22855438,1,1,0,629,200,201,1
"c614a00911be4877a075f19315530fb0","c614a00911be4877a075f19315530fb0",22855438,6,0,1,630,201,201,0
"c614a00911be4877a075f19315530fb0","a6c21bd8b95249c7972820a7a7d76aff",22855438,1,1,0,636,201,202,1
"a6c21bd8b95249c7972820a7a7d76aff","a6c21bd8b95249c7972820a7a7d76aff",22855438,1,0,1,637,202,202,0
"a6c21bd8b95249c7972820a7a7d76aff","bb329d880ab54120adaf203a693bb203",22855438,1,1,0,638,202,203,1
"bb329d880ab54120adaf203a693bb203","bb329d880ab54120adaf203a693bb203",22855438,1,0,1,639,203,203,0
"bb329d880ab54120adaf203a693bb203","f9170dd6bc6442b4acd832747609b09a",22855438,1,-4,0,640,203,199,-4
"f9170dd6bc6442b4acd832747609b09a","334c2344009840079b1d0e1b7ce3d5a7",22855438,1,7,0,641,199,205,6
"334c2344009840079b1d0e1b7ce3d5a7","334c2344009840079b1d0e1b7ce3d5a7",22855438,1,0,1,642,205,205,0
"334c2344009840079b1d0e1b7ce3d5a7","c8e371568a0c4391b25796ae4e91952e",22855438,1,-23,0,643,205,186,-19
"c8e371568a0c4391b25796ae4e91952e","d7f13c8d63ec4e2aa673fbb9cf9c6933",22855438,1,26,0,644,186,206,20
"d7f13c8d63ec4e2aa673fbb9cf9c6933","7108f0e4c2584f1f9c471689ae4c885c",22855438,2,2,0,645,206,208,2
"7108f0e4c2584f1f9c471689ae4c885c","b9e80f77c3a44349863b19875725c384",22855438,2,-1,0,646,208,207,-1
"b9e80f77c3a44349863b19875725c384","d7f13c8d63ec4e2aa673fbb9cf9c6933",22855438,1,-1,0,647,207,206,-1
"b9e80f77c3a44349863b19875725c384","b9e80f77c3a44349863b19875725c384",22855438,36,0,1,650,207,207,0
"b9e80f77c3a44349863b19875725c384","7108f0e4c2584f1f9c471689ae4c885c",22855438,1,1,0,686,207,208,1
"7108f0e4c2584f1f9c471689ae4c885c","7108f0e4c2584f1f9c471689ae4c885c",22855438,10,0,1,687,208,208,0
"7108f0e4c2584f1f9c471689ae4c885c","d7f13c8d63ec4e2aa673fbb9cf9c6933",22855438,1,-2,0,697,208,206,-2
"d7f13c8d63ec4e2aa673fbb9cf9c6933","09400e101c5d4b439cf9a26b03aae558",22855438,1,5,0,698,206,210,4
"09400e101c5d4b439cf9a26b03aae558","09400e101c5d4b439cf9a26b03aae558",22855438,1,0,1,699,210,210,0
"09400e101c5d4b439cf9a26b03aae558","a88efa7e50ce47159810ab553afa6d3a",22855438,1,2,0,700,210,212,2
"a88efa7e50ce47159810ab553afa6d3a","a88efa7e50ce47159810ab553afa6d3a",22855438,2,0,1,701,212,212,0
"a88efa7e50ce47159810ab553afa6d3a","a875096404ef4a9984b62d74cda916f9",22855438,1,-3,0,703,212,209,-3
"a875096404ef4a9984b62d74cda916f9","be502a7a43c44bf7b682698de79d9369",22855438,1,6,0,704,209,214,5
"be502a7a43c44bf7b682698de79d9369","f7fb1952f56b4189b86a9f8b7862d2b8",22855438,2,1,0,705,214,215,1
"f7fb1952f56b4189b86a9f8b7862d2b8","be502a7a43c44bf7b682698de79d9369",22855438,1,-1,0,706,215,214,-1
"f7fb1952f56b4189b86a9f8b7862d2b8","f7fb1952f56b4189b86a9f8b7862d2b8",22855438,11,0,1,708,215,215,0
"f7fb1952f56b4189b86a9f8b7862d2b8","b860ee85d8bc4a2f97958cfb71be3533",22855438,1,1,0,719,215,216,1
"b860ee85d8bc4a2f97958cfb71be3533","b860ee85d8bc4a2f97958cfb71be3533",22855438,5,0,1,720,216,216,0
"b860ee85d8bc4a2f97958cfb71be3533","ec341f459285443b8361f7f15638ff08",22855438,1,-3,0,725,216,213,-3
"ec341f459285443b8361f7f15638ff08","363837c182e04711840d896ae1e0339c",22855438,1,6,0,726,213,218,5
"363837c182e04711840d896ae1e0339c","363837c182e04711840d896ae1e0339c",22855438,17,0,1,727,218,218,0
"363837c182e04711840d896ae1e0339c","01b2051f8941460d89945e3b02d1ce78",22855438,1,-1,0,744,218,217,-1
"01b2051f8941460d89945e3b02d1ce78","d7f13c8d63ec4e2aa673fbb9cf9c6933",22855438,1,-14,0,745,217,206,-11
"d7f13c8d63ec4e2aa673fbb9cf9c6933","1c6721b1f63f4d30ba7746ea8af02a52",22855438,1,21,0,746,206,221,15
"1c6721b1f63f4d30ba7746ea8af02a52","77ecef8eff6b4a2caea7707669bf7475",22855438,1,1,0,747,221,222,1
"77ecef8eff6b4a2caea7707669bf7475","77ecef8eff6b4a2caea7707669bf7475",22855438,12,0,1,748,222,222,0
"77ecef8eff6b4a2caea7707669bf7475","8b9ae98743bd4d4a8a87dff1c1244211",22855438,1,6,0,760,222,227,5
"8b9ae98743bd4d4a8a87dff1c1244211","1c6721b1f63f4d30ba7746ea8af02a52",22855438,1,-7,0,761,227,221,-6
"1c6721b1f63f4d30ba7746ea8af02a52","d03cb855c70044cf8c35d9ec0de696e3",22855438,1,4,0,762,221,224,3
"d03cb855c70044cf8c35d9ec0de696e3","d03cb855c70044cf8c35d9ec0de696e3",22855438,2,0,1,763,224,224,0
"d03cb855c70044cf8c35d9ec0de696e3","a49a937d6896486d9a5396654abcf2e1",22855438,1,2,0,765,224,226,2
"a49a937d6896486d9a5396654abcf2e1","a49a937d6896486d9a5396654abcf2e1",22855438,5,0,1,766,226,226,0
"a49a937d6896486d9a5396654abcf2e1","8b9ae98743bd4d4a8a87dff1c1244211",22855438,1,1,0,771,226,227,1
"8b9ae98743bd4d4a8a87dff1c1244211","8b9ae98743bd4d4a8a87dff1c1244211",22855438,33,0,1,772,227,227,0
"8b9ae98743bd4d4a8a87dff1c1244211","2ab1535aac1346ba8801535bf729ef37",22855438,1,3,0,805,227,229,2
"2ab1535aac1346ba8801535bf729ef37","f7906d6f59b9489a91d2ef40db5a474d",22855438,1,-7,0,806,229,223,-6
"f7906d6f59b9489a91d2ef40db5a474d","2ab1535aac1346ba8801535bf729ef37",22855438,1,7,0,807,223,229,6
"2ab1535aac1346ba8801535bf729ef37","a4f40fb48a8542c8949bae1f002cd9bc",22855438,1,2,0,808,229,231,2
"a4f40fb48a8542c8949bae1f002cd9bc","a4f40fb48a8542c8949bae1f002cd9bc",22855438,8,0,1,809,231,231,0
"a4f40fb48a8542c8949bae1f002cd9bc","8972c23e32044edb8a78fa1eed4e5947",22855438,1,1,0,817,231,232,1
"8972c23e32044edb8a78fa1eed4e5947","8972c23e32044edb8a78fa1eed4e5947",22855438,5,0,1,818,232,232,0
"8972c23e32044edb8a78fa1eed4e5947","92feb4a40f8344d38b6f722e42a53295",22855438,1,1,0,823,232,233,1
"92feb4a40f8344d38b6f722e42a53295","92feb4a40f8344d38b6f722e42a53295",22855438,2,0,1,824,233,233,0
"92feb4a40f8344d38b6f722e42a53295","5152833676bf4c6cb317060be10f68db",22855438,1,-5,0,826,233,228,-5
"5152833676bf4c6cb317060be10f68db","ca3e28f290354c08aefe5b0f769604e6",22855438,1,8,0,827,228,235,7
"ca3e28f290354c08aefe5b0f769604e6","ca3e28f290354c08aefe5b0f769604e6",22855438,9,0,1,828,235,235,0
"ca3e28f290354c08aefe5b0f769604e6","79a35eea833e4c2c9d22fc53c3c6445c",22855438,1,1,0,837,235,236,1
"79a35eea833e4c2c9d22fc53c3c6445c","79a35eea833e4c2c9d22fc53c3c6445c",22855438,4,0,1,838,236,236,0
"79a35eea833e4c2c9d22fc53c3c6445c","8f68228b1518449e9615cdafee41a2bd",22855438,1,1,0,842,236,237,1
"8f68228b1518449e9615cdafee41a2bd","8f68228b1518449e9615cdafee41a2bd",22855438,1,0,1,843,237,237,0
"8f68228b1518449e9615cdafee41a2bd","cab89fa5c3ed45a5aa550fc0352d6a42",22855438,1,1,0,844,237,238,1
"cab89fa5c3ed45a5aa550fc0352d6a42","cab89fa5c3ed45a5aa550fc0352d6a42",22855438,5,0,1,845,238,238,0
"cab89fa5c3ed45a5aa550fc0352d6a42","66d4fad4f1cf4b46be0750a99ad7a35a",22855438,1,1,0,850,238,239,1
"66d4fad4f1cf4b46be0750a99ad7a35a","66d4fad4f1cf4b46be0750a99ad7a35a",22855438,1,0,1,851,239,239,0
"66d4fad4f1cf4b46be0750a99ad7a35a","0b04c8e2f86d48c7aeb7e225819cd32b",22855438,1,-5,0,852,239,234,-5
"0b04c8e2f86d48c7aeb7e225819cd32b","f53da5fd9bfe412da4b80d4742563b6c",22855438,1,8,0,853,234,241,7
"f53da5fd9bfe412da4b80d4742563b6c","f53da5fd9bfe412da4b80d4742563b6c",22855438,1,0,1,854,241,241,0
"f53da5fd9bfe412da4b80d4742563b6c","1c6721b1f63f4d30ba7746ea8af02a52",22855438,1,-24,0,855,241,221,-20
"1c6721b1f63f4d30ba7746ea8af02a52","2ae94c0cea4d480a9d5dca8fb1d7b542",22855438,1,27,0,856,221,242,21
"2ae94c0cea4d480a9d5dca8fb1d7b542","1ebf23f9d994469a85206e4c7b1bf5f5",22855438,1,3,0,857,242,245,3
"1ebf23f9d994469a85206e4c7b1bf5f5","1ebf23f9d994469a85206e4c7b1bf5f5",22855438,28,0,1,858,245,245,0
"1ebf23f9d994469a85206e4c7b1bf5f5","85ae675b83e8422da842cfd25596af99",22855438,1,1,0,886,245,246,1
"85ae675b83e8422da842cfd25596af99","85ae675b83e8422da842cfd25596af99",22855438,1,0,1,887,246,246,0
"85ae675b83e8422da842cfd25596af99","fa235f0f364d47e4ae1c87f47bf8e6ba",22855438,1,8,0,888,246,252,6
"fa235f0f364d47e4ae1c87f47bf8e6ba","2ae94c0cea4d480a9d5dca8fb1d7b542",22855438,1,-12,0,889,252,242,-10
"2ae94c0cea4d480a9d5dca8fb1d7b542","fa235f0f364d47e4ae1c87f47bf8e6ba",22855438,1,12,0,890,242,252,10
"fa235f0f364d47e4ae1c87f47bf8e6ba","79f7845465cc4ed19d8e4f1429541be0",22855438,1,2,0,891,252,254,2
"79f7845465cc4ed19d8e4f1429541be0","79f7845465cc4ed19d8e4f1429541be0",22855438,2,0,1,892,254,254,0
"79f7845465cc4ed19d8e4f1429541be0","fa235f0f364d47e4ae1c87f47bf8e6ba",22855438,1,-2,0,894,254,252,-2
"fa235f0f364d47e4ae1c87f47bf8e6ba","6e83e23f56544a19b94067c1c558d9c0",22855438,1,-6,0,895,252,247,-5
"00f61990949545828dd12f1303d47504","00f61990949545828dd12f1303d47504",22855438,1,0,1,897,256,256,0
"00f61990949545828dd12f1303d47504","ead7bb4b64e247d2ae632ab8a296b091",22855438,1,2,0,898,256,258,2
"ead7bb4b64e247d2ae632ab8a296b091","ead7bb4b64e247d2ae632ab8a296b091",22855438,2,0,1,899,258,258,0
"ead7bb4b64e247d2ae632ab8a296b091","41b0048dde734bb280bac6116baa8e27",22855438,1,1,0,901,258,259,1
"41b0048dde734bb280bac6116baa8e27","41b0048dde734bb280bac6116baa8e27",22855438,2,0,1,902,259,259,0
"41b0048dde734bb280bac6116baa8e27","b41c5a094a604ee0915327da5cc0beb7",22855438,1,1,0,904,259,260,1
"b41c5a094a604ee0915327da5cc0beb7","b41c5a094a604ee0915327da5cc0beb7",22855438,2,0,1,905,260,260,0
"b41c5a094a604ee0915327da5cc0beb7","d546341988904f069cfa86b21457d9d9",22855438,1,-10,0,907,260,251,-9
"d546341988904f069cfa86b21457d9d9","28c171777c52431ab6b925073bd63d46",22855438,1,15,0,908,251,264,13
"28c171777c52431ab6b925073bd63d46","28c171777c52431ab6b925073bd63d46",22855438,7,0,1,909,264,264,0
"28c171777c52431ab6b925073bd63d46","ac160db940cb49ae8579162b1d52bb5d",22855438,1,2,0,916,264,266,2
"ac160db940cb49ae8579162b1d52bb5d","ac160db940cb49ae8579162b1d52bb5d",22855438,7,0,1,917,266,266,0
"ac160db940cb49ae8579162b1d52bb5d","d989ebcfc12a4b669f0100dc1aa14f1e",22855438,1,-12,0,924,266,255,-11
"d989ebcfc12a4b669f0100dc1aa14f1e","c6fd49b485cc4874b0bbdd9c6171e09c",22855438,1,15,0,925,255,268,13
"c6fd49b485cc4874b0bbdd9c6171e09c","c6fd49b485cc4874b0bbdd9c6171e09c",22855438,7,0,1,926,268,268,0
"c6fd49b485cc4874b0bbdd9c6171e09c","44240778a97c4af0937817499b75707b",22855438,1,1,0,933,268,269,1
"44240778a97c4af0937817499b75707b","44240778a97c4af0937817499b75707b",22855438,2,0,1,934,269,269,0
"44240778a97c4af0937817499b75707b","7aa76d3e993840d8805f097cbdbcd44b",22855438,1,-9,0,936,269,261,-8
"7aa76d3e993840d8805f097cbdbcd44b","865a4d3b43374da7944dc7d397f566d9",22855438,1,12,0,937,261,271,10
"865a4d3b43374da7944dc7d397f566d9","865a4d3b43374da7944dc7d397f566d9",22855438,1,0,1,938,271,271,0
"865a4d3b43374da7944dc7d397f566d9","0d987bed3ffa4ed0b9a2e62e97b7b30f",22855438,1,3,0,939,271,272,1
"0d987bed3ffa4ed0b9a2e62e97b7b30f","2ae94c0cea4d480a9d5dca8fb1d7b542",22855438,1,-38,0,940,272,242,-30
"2ae94c0cea4d480a9d5dca8fb1d7b542","0d987bed3ffa4ed0b9a2e62e97b7b30f",22855438,1,38,0,941,242,272,30
"0d987bed3ffa4ed0b9a2e62e97b7b30f","0d987bed3ffa4ed0b9a2e62e97b7b30f",22855438,2,0,1,942,272,272,0
"0d987bed3ffa4ed0b9a2e62e97b7b30f","82ae07bc0c9b4570a41799290d1ef399",22855438,2,4,0,943,272,275,3
"82ae07bc0c9b4570a41799290d1ef399","0d987bed3ffa4ed0b9a2e62e97b7b30f",22855438,2,-4,0,944,275,272,-3
"82ae07bc0c9b4570a41799290d1ef399","bb5a47f5ea01454a8b79455422d3b9da",22855438,2,6,0,946,275,280,5
"bb5a47f5ea01454a8b79455422d3b9da","bc5524e78a8544e2ae2fdc2f3462bbec",22855438,2,-1,0,954,280,279,-1
"bc5524e78a8544e2ae2fdc2f3462bbec","bb5a47f5ea01454a8b79455422d3b9da",22855438,2,1,0,955,279,280,1
"bb5a47f5ea01454a8b79455422d3b9da","82ae07bc0c9b4570a41799290d1ef399",22855438,2,-6,0,963,280,275,-5
"82ae07bc0c9b4570a41799290d1ef399","bc5524e78a8544e2ae2fdc2f3462bbec",22855438,1,5,0,964,275,279,4
"bc5524e78a8544e2ae2fdc2f3462bbec","82ae07bc0c9b4570a41799290d1ef399",22855438,1,-5,0,965,279,275,-4
"0d987bed3ffa4ed0b9a2e62e97b7b30f","bb5a47f5ea01454a8b79455422d3b9da",22855438,3,10,0,968,272,280,8
"bb5a47f5ea01454a8b79455422d3b9da","0d987bed3ffa4ed0b9a2e62e97b7b30f",22855438,2,-10,0,988,280,272,-8
"bb5a47f5ea01454a8b79455422d3b9da","bb5a47f5ea01454a8b79455422d3b9da",22855438,101,0,1,1000,280,280,0
"bb5a47f5ea01454a8b79455422d3b9da","94cecc3f1e7d484b8e068e79241dfd73",22855438,2,3,0,1022,280,281,1
"94cecc3f1e7d484b8e068e79241dfd73","94cecc3f1e7d484b8e068e79241dfd73",22855438,1,0,1,1023,281,281,0
"94cecc3f1e7d484b8e068e79241dfd73","a37477c4e4c14169ad44b06b493007f6",22855438,2,2,0,1024,281,283,2
"a37477c4e4c14169ad44b06b493007f6","94cecc3f1e7d484b8e068e79241dfd73",22855438,1,-2,0,1025,283,281,-2
"a37477c4e4c14169ad44b06b493007f6","0d987bed3ffa4ed0b9a2e62e97b7b30f",22855438,1,-15,0,1027,283,272,-11
"0d987bed3ffa4ed0b9a2e62e97b7b30f","94cecc3f1e7d484b8e068e79241dfd73",22855438,1,13,0,1028,272,281,9
"94cecc3f1e7d484b8e068e79241dfd73","bb5a47f5ea01454a8b79455422d3b9da",22855438,1,-3,0,1029,281,280,-1
"94cecc3f1e7d484b8e068e79241dfd73","0d987bed3ffa4ed0b9a2e62e97b7b30f",22855438,1,-13,0,1073,281,272,-9
"0d987bed3ffa4ed0b9a2e62e97b7b30f","a37477c4e4c14169ad44b06b493007f6",22855438,1,15,0,1074,272,283,11
"a37477c4e4c14169ad44b06b493007f6","fab84b4fab5940efb4ea868ef8d09396",22855438,1,3,0,1075,283,284,1
"fab84b4fab5940efb4ea868ef8d09396","fab84b4fab5940efb4ea868ef8d09396",22855438,1,0,1,1076,284,284,0
"fab84b4fab5940efb4ea868ef8d09396","4a29443515bb404cb8924e1c60a63b73",22855438,1,4,0,1077,284,285,1
"4a29443515bb404cb8924e1c60a63b73","208c9b2796c944db8dacaa96082520ea",22855438,7,3,0,1078,285,288,3
"208c9b2796c944db8dacaa96082520ea","4a29443515bb404cb8924e1c60a63b73",22855438,8,-3,0,1079,288,285,-3
"4a29443515bb404cb8924e1c60a63b73","6a9a3b5bde4a48daa896fe8c06eca56f",22855438,3,5,0,1080,285,289,4
"6a9a3b5bde4a48daa896fe8c06eca56f","208c9b2796c944db8dacaa96082520ea",22855438,2,-2,0,1081,289,288,-1
"4a29443515bb404cb8924e1c60a63b73","7669a956527947d0add87455277e80b4",22855438,2,7,0,1083,285,291,6
"7669a956527947d0add87455277e80b4","7669a956527947d0add87455277e80b4",22855438,2,0,1,1084,291,291,0
"7669a956527947d0add87455277e80b4","869e967078f04da18dd0b0b9389a7424",22855438,2,3,0,1085,291,293,2
"869e967078f04da18dd0b0b9389a7424","6a9a3b5bde4a48daa896fe8c06eca56f",22855438,2,-5,0,1086,293,289,-4
"6a9a3b5bde4a48daa896fe8c06eca56f","869e967078f04da18dd0b0b9389a7424",22855438,2,5,0,1087,289,293,4
"869e967078f04da18dd0b0b9389a7424","51ab6291537748fab90d519aa09889d6",22855438,2,2,0,1088,293,295,2
"51ab6291537748fab90d519aa09889d6","51ab6291537748fab90d519aa09889d6",22855438,10,0,1,1089,295,295,0
"51ab6291537748fab90d519aa09889d6","34a6e49023fc4465bd5ca604330bbd1c",22855438,2,-3,0,1094,295,292,-3
"34a6e49023fc4465bd5ca604330bbd1c","ba0e59461bfb4a44b7b1c28a01f8d3b3",22855438,2,9,0,1095,292,299,7
"ba0e59461bfb4a44b7b1c28a01f8d3b3","21592f2a9e9c4b2f8c66ec5dbcbf6a2b",22855438,2,-4,0,1096,299,296,-3
"21592f2a9e9c4b2f8c66ec5dbcbf6a2b","ba0e59461bfb4a44b7b1c28a01f8d3b3",22855438,1,4,0,1097,296,299,3
"ba0e59461bfb4a44b7b1c28a01f8d3b3","0e0b36e731a645e7b1b8a88f5031ca38",22855438,1,2,0,1098,299,301,2
"0e0b36e731a645e7b1b8a88f5031ca38","0e0b36e731a645e7b1b8a88f5031ca38",22855438,4,0,1,1099,301,301,0
"0e0b36e731a645e7b1b8a88f5031ca38","a66a144637284c21afc6de17fea4bfb8",22855438,2,1,0,1101,301,302,1
"a66a144637284c21afc6de17fea4bfb8","a66a144637284c21afc6de17fea4bfb8",22855438,4,0,1,1102,302,302,0
"a66a144637284c21afc6de17fea4bfb8","7646a919d7e64fa990bca9b024ff089d",22855438,2,-4,0,1104,302,298,-4
"7646a919d7e64fa990bca9b024ff089d","e390b575229748ea8aac9364efe2bf00",22855438,2,7,0,1105,298,304,6
"e390b575229748ea8aac9364efe2bf00","e390b575229748ea8aac9364efe2bf00",22855438,2,0,1,1106,304,304,0
"e390b575229748ea8aac9364efe2bf00","3434c10e561d488a914e0f7d71907abd",22855438,1,3,0,1107,304,305,1
"3434c10e561d488a914e0f7d71907abd","4a29443515bb404cb8924e1c60a63b73",22855438,1,-27,0,1108,305,285,-20
"4a29443515bb404cb8924e1c60a63b73","53e7e900392747ccad52e711ab0f80d8",22855438,1,29,0,1109,285,307,22
"53e7e900392747ccad52e711ab0f80d8","53e7e900392747ccad52e711ab0f80d8",22855438,1,0,1,1110,307,307,0
"53e7e900392747ccad52e711ab0f80d8","3434c10e561d488a914e0f7d71907abd",22855438,1,-2,0,1111,307,305,-2
"3434c10e561d488a914e0f7d71907abd","130acc2aeb0448fdbb2de63bc5cebe5b",22855438,1,5,0,1112,305,309,4
"130acc2aeb0448fdbb2de63bc5cebe5b","130acc2aeb0448fdbb2de63bc5cebe5b",22855438,1,0,1,1113,309,309,0
"130acc2aeb0448fdbb2de63bc5cebe5b","9c062b3251034ebe90f5054e2a3b5120",22855438,1,2,0,1114,309,311,2
"9c062b3251034ebe90f5054e2a3b5120","9c062b3251034ebe90f5054e2a3b5120",22855438,5,0,1,1115,311,311,0
"9c062b3251034ebe90f5054e2a3b5120","ea859f8207e44537889daeaba13ac2e8",22855438,1,1,0,1120,311,312,1
"ea859f8207e44537889daeaba13ac2e8","ea859f8207e44537889daeaba13ac2e8",22855438,8,0,1,1121,312,312,0
"ea859f8207e44537889daeaba13ac2e8","56d94971a7a94257aa330183a8ebd0ea",22855438,1,1,0,1129,312,313,1
"56d94971a7a94257aa330183a8ebd0ea","56d94971a7a94257aa330183a8ebd0ea",22855438,1,0,1,1130,313,313,0
"56d94971a7a94257aa330183a8ebd0ea","141c0df6cd1946539aadd1c9b7068cd4",22855438,1,-5,0,1131,313,308,-5
"141c0df6cd1946539aadd1c9b7068cd4","13255e63e0aa4abf85e5211bf613d43e",22855438,1,10,0,1132,308,317,9
"13255e63e0aa4abf85e5211bf613d43e","13255e63e0aa4abf85e5211bf613d43e",22855438,1,0,1,1133,317,317,0
"13255e63e0aa4abf85e5211bf613d43e","0c787d16c9504873b1a4d903cec09948",22855438,1,-3,0,1134,317,314,-3
"0c787d16c9504873b1a4d903cec09948","86c27d40179e419c8e9d150fb6afa5d0",22855438,1,6,0,1135,314,319,5
"86c27d40179e419c8e9d150fb6afa5d0","86c27d40179e419c8e9d150fb6afa5d0",22855438,1,0,1,1136,319,319,0
"86c27d40179e419c8e9d150fb6afa5d0","8d7e0b55cf9849cda222a0f2440cec55",22855438,1,-1,0,1137,319,318,-1
"8d7e0b55cf9849cda222a0f2440cec55","47edbb64109243e6b0f8f64cdef90c6c",22855438,1,9,0,1138,318,326,8
"47edbb64109243e6b0f8f64cdef90c6c","24f1363179ad4aaa965484a78471912b",22855438,1,-3,0,1139,326,323,-3
"24f1363179ad4aaa965484a78471912b","24f1363179ad4aaa965484a78471912b",22855438,1,0,1,1140,323,323,0
"24f1363179ad4aaa965484a78471912b","3628bdce1dd2429ba924d2d4d09448d2",22855438,1,-1,0,1141,323,322,-1
"3628bdce1dd2429ba924d2d4d09448d2","56b3fd1a212a4764be39d979fde3326e",22855438,1,7,0,1142,322,328,6
"56b3fd1a212a4764be39d979fde3326e","56b3fd1a212a4764be39d979fde3326e",22855438,1,0,1,1143,328,328,0
"56b3fd1a212a4764be39d979fde3326e","0c4079457ede49e3aeb5e86ed84bdf35",22855438,1,3,0,1144,328,329,1
"0c4079457ede49e3aeb5e86ed84bdf35","3434c10e561d488a914e0f7d71907abd",22855438,1,-31,0,1145,329,305,-24
"3434c10e561d488a914e0f7d71907abd","38aea304b4fa46e1b29bb72f5cea4c93",22855438,1,33,0,1146,305,331,26
"38aea304b4fa46e1b29bb72f5cea4c93","38aea304b4fa46e1b29bb72f5cea4c93",22855438,2,0,1,1147,331,331,0
"38aea304b4fa46e1b29bb72f5cea4c93","e36d261332f14e79bb4b467aceaeb9b5",22855438,2,2,0,1148,331,333,2
"e36d261332f14e79bb4b467aceaeb9b5","e36d261332f14e79bb4b467aceaeb9b5",22855438,5,0,1,1149,333,333,0
"e36d261332f14e79bb4b467aceaeb9b5","c7e89b9d04744d2eab742fc24e3ef1ae",22855438,2,1,0,1153,333,334,1
"c7e89b9d04744d2eab742fc24e3ef1ae","c7e89b9d04744d2eab742fc24e3ef1ae",22855438,6,0,1,1154,334,334,0
"c7e89b9d04744d2eab742fc24e3ef1ae","fe49f8054b374a0ea4bb266ed135ff62",22855438,3,1,0,1156,334,335,1
"fe49f8054b374a0ea4bb266ed135ff62","fe49f8054b374a0ea4bb266ed135ff62",22855438,6,0,1,1157,335,335,0
"fe49f8054b374a0ea4bb266ed135ff62","d0a8f74af98642fe8360d22c42e45117",22855438,1,1,0,1159,335,336,1
"d0a8f74af98642fe8360d22c42e45117","d0a8f74af98642fe8360d22c42e45117",22855438,5,0,1,1160,336,336,0
"d0a8f74af98642fe8360d22c42e45117","0c4079457ede49e3aeb5e86ed84bdf35",22855438,1,-7,0,1165,336,329,-7
"0c4079457ede49e3aeb5e86ed84bdf35","a7c6339ca1da4368a18d471f0519f877",22855438,1,11,0,1166,329,339,10
"a7c6339ca1da4368a18d471f0519f877","a7c6339ca1da4368a18d471f0519f877",22855438,3,0,1,1167,339,339,0
"a7c6339ca1da4368a18d471f0519f877","bbc5139ca9024389a94db3a6f47dcff6",22855438,1,3,0,1170,339,341,2
"bbc5139ca9024389a94db3a6f47dcff6","b8b9418ab322418d9db9b40d96af873a",22855438,1,-5,0,1171,341,337,-4
"b8b9418ab322418d9db9b40d96af873a","bbc5139ca9024389a94db3a6f47dcff6",22855438,1,5,0,1172,337,341,4
"bbc5139ca9024389a94db3a6f47dcff6","4ee6ca9019ab4a1ab323f98094a9bd77",22855438,1,2,0,1173,341,343,2
"4ee6ca9019ab4a1ab323f98094a9bd77","4ee6ca9019ab4a1ab323f98094a9bd77",22855438,2,0,1,1174,343,343,0
"4ee6ca9019ab4a1ab323f98094a9bd77","b37947176785476f8b29d49a851366dc",22855438,1,1,0,1176,343,344,1
"b37947176785476f8b29d49a851366dc","b37947176785476f8b29d49a851366dc",22855438,2,0,1,1177,344,344,0
"b37947176785476f8b29d49a851366dc","fcea5b10d5a14a3b9324ffece8f6e1e5",22855438,1,1,0,1179,344,345,1
"fcea5b10d5a14a3b9324ffece8f6e1e5","fcea5b10d5a14a3b9324ffece8f6e1e5",22855438,5,0,1,1180,345,345,0
"fcea5b10d5a14a3b9324ffece8f6e1e5","c2490bc612d146edbe786556fab3651b",22855438,1,-5,0,1185,345,340,-5
"c2490bc612d146edbe786556fab3651b","6ac8bb048b854999a47edb35fe627f11",22855438,1,8,0,1186,340,347,7
"6ac8bb048b854999a47edb35fe627f11","6ac8bb048b854999a47edb35fe627f11",22855438,1,0,1,1187,347,347,0
"6ac8bb048b854999a47edb35fe627f11","0c4079457ede49e3aeb5e86ed84bdf35",22855438,1,-21,0,1188,347,329,-18
"0c4079457ede49e3aeb5e86ed84bdf35","30ead9794d4847abaf222ca966cc8630",22855438,1,24,0,1189,329,348,19
"30ead9794d4847abaf222ca966cc8630","897b7f51242c44aab2205c72fdcbf4cd",22855438,1,4,0,1190,348,352,4
"897b7f51242c44aab2205c72fdcbf4cd","eff0de7f2dbb42dfa1a2e686efab5b6d",22855438,1,2,0,1191,352,354,2
"eff0de7f2dbb42dfa1a2e686efab5b6d","c20993c944444fe085345591a8bd837e",22855438,1,-3,0,1192,354,351,-3
"c20993c944444fe085345591a8bd837e","09b9678ddc3d452ea4a3d46e15826065",22855438,1,2,0,1193,351,353,2
"09b9678ddc3d452ea4a3d46e15826065","897b7f51242c44aab2205c72fdcbf4cd",22855438,1,-1,0,1194,353,352,-1
"897b7f51242c44aab2205c72fdcbf4cd","897b7f51242c44aab2205c72fdcbf4cd",22855438,3,0,1,1195,352,352,0
"897b7f51242c44aab2205c72fdcbf4cd","09b9678ddc3d452ea4a3d46e15826065",22855438,1,1,0,1198,352,353,1
"09b9678ddc3d452ea4a3d46e15826065","09b9678ddc3d452ea4a3d46e15826065",22855438,3,0,1,1199,353,353,0
"09b9678ddc3d452ea4a3d46e15826065","eff0de7f2dbb42dfa1a2e686efab5b6d",22855438,1,1,0,1202,353,354,1
"eff0de7f2dbb42dfa1a2e686efab5b6d","eff0de7f2dbb42dfa1a2e686efab5b6d",22855438,3,0,1,1203,354,354,0
"eff0de7f2dbb42dfa1a2e686efab5b6d","30ead9794d4847abaf222ca966cc8630",22855438,1,-6,0,1206,354,348,-6
"30ead9794d4847abaf222ca966cc8630","2fe14166dc9642c3bc666b86a57f943d",22855438,1,10,0,1207,348,357,9
"2fe14166dc9642c3bc666b86a57f943d","2fe14166dc9642c3bc666b86a57f943d",22855438,2,0,1,1208,357,357,0
"2fe14166dc9642c3bc666b86a57f943d","44421dd1e13a47a388c4a19834b744c7",22855438,1,2,0,1210,357,359,2
"44421dd1e13a47a388c4a19834b744c7","44421dd1e13a47a388c4a19834b744c7",22855438,2,0,1,1211,359,359,0
"44421dd1e13a47a388c4a19834b744c7","cb5fc7ef85d547c4be1a7439d0bf6052",22855438,1,1,0,1213,359,360,1
"cb5fc7ef85d547c4be1a7439d0bf6052","cb5fc7ef85d547c4be1a7439d0bf6052",22855438,5,0,1,1214,360,360,0
"cb5fc7ef85d547c4be1a7439d0bf6052","0a8f150a4cf747acbde62f4721823da3",22855438,1,1,0,1219,360,361,1
"0a8f150a4cf747acbde62f4721823da3","0a8f150a4cf747acbde62f4721823da3",22855438,2,0,1,1220,361,361,0
"0a8f150a4cf747acbde62f4721823da3","ab8fdad974ae471f9f24c3f9dd04462e",22855438,1,1,0,1222,361,362,1
"ab8fdad974ae471f9f24c3f9dd04462e","ab8fdad974ae471f9f24c3f9dd04462e",22855438,2,0,1,1223,362,362,0
"ab8fdad974ae471f9f24c3f9dd04462e","1ba8fef685d74a8194b9db252eb704fb",22855438,1,-7,0,1225,362,355,-7
"1ba8fef685d74a8194b9db252eb704fb","52580888dadb4fe3baa795683ea227bd",22855438,1,10,0,1226,355,364,9
"52580888dadb4fe3baa795683ea227bd","52580888dadb4fe3baa795683ea227bd",22855438,1,0,1,1227,364,364,0
"52580888dadb4fe3baa795683ea227bd","f00179e251a045b39c3f7a54f9aa4acc",22855438,1,-1,0,1228,364,363,-1
"f00179e251a045b39c3f7a54f9aa4acc","492a3bc6a1254f23a7998587961b22a4",22855438,1,4,0,1229,363,366,3
"492a3bc6a1254f23a7998587961b22a4","492a3bc6a1254f23a7998587961b22a4",22855438,1,0,1,1230,366,366,0
"492a3bc6a1254f23a7998587961b22a4","072a190fd302456290895f9f04d6940a",22855438,1,-1,0,1231,366,365,-1
"072a190fd302456290895f9f04d6940a","cfa457d1743848e4bb5e4beced6448ed",22855438,1,5,0,1232,365,369,4
"cfa457d1743848e4bb5e4beced6448ed","cfa457d1743848e4bb5e4beced6448ed",22855438,1,0,1,1233,369,369,0
"cfa457d1743848e4bb5e4beced6448ed","30ead9794d4847abaf222ca966cc8630",22855438,1,-25,0,1234,369,348,-21
"30ead9794d4847abaf222ca966cc8630","b71bac264efb4abd97015447bd490db6",22855438,3,28,0,1235,348,370,22
"b71bac264efb4abd97015447bd490db6","8d448d625b024c82a5eb240bbd7431d6",22855438,6,5,0,1236,370,374,4
"8d448d625b024c82a5eb240bbd7431d6","8d448d625b024c82a5eb240bbd7431d6",22855438,84,0,1,1237,374,374,0
"8d448d625b024c82a5eb240bbd7431d6","b71bac264efb4abd97015447bd490db6",22855438,6,-5,0,1242,374,370,-4
"b71bac264efb4abd97015447bd490db6","d6d02b6ef04e4f17805504500b8ce441",22855438,4,8,0,1246,370,375,5
"d6d02b6ef04e4f17805504500b8ce441","d6d02b6ef04e4f17805504500b8ce441",22855438,14,0,1,1247,375,375,0
"d6d02b6ef04e4f17805504500b8ce441","b71bac264efb4abd97015447bd490db6",22855438,3,-8,0,1248,375,370,-5
"d6d02b6ef04e4f17805504500b8ce441","8d448d625b024c82a5eb240bbd7431d6",22855438,1,-3,0,1250,375,374,-1
"8d448d625b024c82a5eb240bbd7431d6","1b4550d0dab04078b3bf08a655345bdc",22855438,2,-1,0,1258,374,373,-1
"1b4550d0dab04078b3bf08a655345bdc","30ead9794d4847abaf222ca966cc8630",22855438,1,-32,0,1259,373,348,-25
"b71bac264efb4abd97015447bd490db6","30ead9794d4847abaf222ca966cc8630",22855438,1,-28,0,1261,370,348,-22
"b71bac264efb4abd97015447bd490db6","b71bac264efb4abd97015447bd490db6",22855438,2,0,1,1263,370,370,0
"1b4550d0dab04078b3bf08a655345bdc","8d448d625b024c82a5eb240bbd7431d6",22855438,2,1,0,1275,373,374,1
"b71bac264efb4abd97015447bd490db6","1b4550d0dab04078b3bf08a655345bdc",22855438,1,4,0,1284,370,373,3
"8d448d625b024c82a5eb240bbd7431d6","d6d02b6ef04e4f17805504500b8ce441",22855438,1,3,0,1353,374,375,1
"d6d02b6ef04e4f17805504500b8ce441","66baf19b6b904b70922329068c63746d",22855438,1,4,0,1357,375,376,1
"66baf19b6b904b70922329068c63746d","7f544639412e40a9ba27f43b415362ab",22855438,2,2,0,1358,376,378,2
"7f544639412e40a9ba27f43b415362ab","66baf19b6b904b70922329068c63746d",22855438,1,-2,0,1359,378,376,-2
"7f544639412e40a9ba27f43b415362ab","7f544639412e40a9ba27f43b415362ab",22855438,1,0,1,1361,378,378,0
"7f544639412e40a9ba27f43b415362ab","d5ae8642e15b46b8bd298b02274d4e9c",22855438,1,2,0,1362,378,380,2
"d5ae8642e15b46b8bd298b02274d4e9c","d5ae8642e15b46b8bd298b02274d4e9c",22855438,13,0,1,1363,380,380,0
"d5ae8642e15b46b8bd298b02274d4e9c","a0d10309a2dd456289147f84be9d37f9",22855438,1,1,0,1376,380,381,1
"a0d10309a2dd456289147f84be9d37f9","a0d10309a2dd456289147f84be9d37f9",22855438,2,0,1,1377,381,381,0
"a0d10309a2dd456289147f84be9d37f9","0fcbc3ca07b144138b8d85da581f09a8",22855438,1,1,0,1379,381,382,1
"0fcbc3ca07b144138b8d85da581f09a8","0fcbc3ca07b144138b8d85da581f09a8",22855438,2,0,1,1380,382,382,0
"0fcbc3ca07b144138b8d85da581f09a8","66baf19b6b904b70922329068c63746d",22855438,1,-6,0,1382,382,376,-6
"66baf19b6b904b70922329068c63746d","4890121ce5d74576b4632b77cfc23398",22855438,1,14,0,1383,376,388,12
"4890121ce5d74576b4632b77cfc23398","c2fca3669923477ab966ded303dea31c",22855438,1,-6,0,1384,388,383,-5
"c2fca3669923477ab966ded303dea31c","4890121ce5d74576b4632b77cfc23398",22855438,1,6,0,1385,383,388,5
"4890121ce5d74576b4632b77cfc23398","18d3b836dd804224883cc9180b60a8e1",22855438,2,-1,0,1386,388,387,-1
"18d3b836dd804224883cc9180b60a8e1","96bb2b3e85a34d8b9544514e89f6fe97",22855438,2,4,0,1387,387,390,3
"96bb2b3e85a34d8b9544514e89f6fe97","96bb2b3e85a34d8b9544514e89f6fe97",22855438,2,0,1,1388,390,390,0
"96bb2b3e85a34d8b9544514e89f6fe97","ac4e9b54acfe4670b4634859c7263cb5",22855438,1,2,0,1389,390,392,2
"ac4e9b54acfe4670b4634859c7263cb5","ac4e9b54acfe4670b4634859c7263cb5",22855438,3,0,1,1390,392,392,0
"ac4e9b54acfe4670b4634859c7263cb5","17f95d18bab743888e1736033dc3384d",22855438,1,-3,0,1393,392,389,-3
"17f95d18bab743888e1736033dc3384d","6f8881a745ac4c358a68b92c3b4abe81",22855438,1,6,0,1394,389,394,5
"6f8881a745ac4c358a68b92c3b4abe81","6f8881a745ac4c358a68b92c3b4abe81",22855438,4,0,1,1395,394,394,0
"6f8881a745ac4c358a68b92c3b4abe81","f7002c8484354eceac57bc7bd62c76c1",22855438,1,-1,0,1399,394,393,-1
"f7002c8484354eceac57bc7bd62c76c1","44a277ea44dc4ae689fab4b82f0b4098",22855438,2,5,0,1400,393,397,4
"44a277ea44dc4ae689fab4b82f0b4098","44a277ea44dc4ae689fab4b82f0b4098",22855438,2,0,1,1401,397,397,0
"44a277ea44dc4ae689fab4b82f0b4098","0c12af0a4e7f4002852cf84b2537c161",22855438,3,-2,0,1402,397,395,-2
"0c12af0a4e7f4002852cf84b2537c161","859e0b8d71694b12befb69ee698138f9",22855438,1,5,0,1403,395,399,4
"859e0b8d71694b12befb69ee698138f9","859e0b8d71694b12befb69ee698138f9",22855438,1,0,1,1404,399,399,0
"859e0b8d71694b12befb69ee698138f9","66baf19b6b904b70922329068c63746d",22855438,1,-29,0,1405,399,376,-23
"66baf19b6b904b70922329068c63746d","2b09a08242b54983aec7063990fb3f66",22855438,2,32,0,1406,376,400,24
"2b09a08242b54983aec7063990fb3f66","2b09a08242b54983aec7063990fb3f66",22855438,4,0,1,1407,400,400,0
"2b09a08242b54983aec7063990fb3f66","1f471b7a883a4df48211e8c6a81b59a7",22855438,2,1,0,1410,400,401,1
"1f471b7a883a4df48211e8c6a81b59a7","1f471b7a883a4df48211e8c6a81b59a7",22855438,2,0,1,1411,401,401,0
"1f471b7a883a4df48211e8c6a81b59a7","2b09a08242b54983aec7063990fb3f66",22855438,2,-1,0,1412,401,400,-1
"2b09a08242b54983aec7063990fb3f66","9de0d567bfa84fe5b77cb76f4a76a5d1",22855438,2,5,0,1413,400,404,4
"9de0d567bfa84fe5b77cb76f4a76a5d1","9de0d567bfa84fe5b77cb76f4a76a5d1",22855438,2,0,1,1414,404,404,0
"9de0d567bfa84fe5b77cb76f4a76a5d1","1157bd665ec4472fb58b751dc5099355",22855438,2,-1,0,1415,404,403,-1
"1157bd665ec4472fb58b751dc5099355","2b09a08242b54983aec7063990fb3f66",22855438,1,-4,0,1416,403,400,-3
"2b09a08242b54983aec7063990fb3f66","58fc9094275e4c49be3f4ba6d4acc0a4",22855438,2,9,0,1417,400,406,6
"58fc9094275e4c49be3f4ba6d4acc0a4","3c8a22d2f9c146ea956609e3ed4f2559",22855438,1,-2,0,1418,406,405,-1
"3c8a22d2f9c146ea956609e3ed4f2559","58fc9094275e4c49be3f4ba6d4acc0a4",22855438,1,2,0,1419,405,406,1
"58fc9094275e4c49be3f4ba6d4acc0a4","c1c1be90b2b14c1ab4a5e1ee3c241902",22855438,3,1,0,1420,406,407,1
"c1c1be90b2b14c1ab4a5e1ee3c241902","c1c1be90b2b14c1ab4a5e1ee3c241902",22855438,15,0,1,1421,407,407,0
"c1c1be90b2b14c1ab4a5e1ee3c241902","02b3a1bead9244c1ba2f857c7da8f82a",22855438,3,2,0,1426,407,408,1
"02b3a1bead9244c1ba2f857c7da8f82a","58fc9094275e4c49be3f4ba6d4acc0a4",22855438,4,-3,0,1427,408,406,-2
"58fc9094275e4c49be3f4ba6d4acc0a4","02b3a1bead9244c1ba2f857c7da8f82a",22855438,2,3,0,1428,406,408,2
"02b3a1bead9244c1ba2f857c7da8f82a","6206fc6479014bb193084c32409dc1b9",22855438,1,1,0,1429,408,409,1
"6206fc6479014bb193084c32409dc1b9","6206fc6479014bb193084c32409dc1b9",22855438,4,0,1,1430,409,409,0
"6206fc6479014bb193084c32409dc1b9","6a5f020451db426dacba9e2ea3fcc62a",22855438,1,2,0,1434,409,410,1
"6a5f020451db426dacba9e2ea3fcc62a","02b3a1bead9244c1ba2f857c7da8f82a",22855438,1,-3,0,1435,410,408,-2
"02b3a1bead9244c1ba2f857c7da8f82a","6a5f020451db426dacba9e2ea3fcc62a",22855438,1,3,0,1436,408,410,2
"6a5f020451db426dacba9e2ea3fcc62a","6a5f020451db426dacba9e2ea3fcc62a",22855438,6,0,1,1437,410,410,0
"6a5f020451db426dacba9e2ea3fcc62a","33a9d248b2e44588a5b07fc1342b9bc2",22855438,3,2,0,1439,410,411,1
"33a9d248b2e44588a5b07fc1342b9bc2","2b09a08242b54983aec7063990fb3f66",22855438,1,-17,0,1440,411,400,-11
"2b09a08242b54983aec7063990fb3f66","6a5f020451db426dacba9e2ea3fcc62a",22855438,1,15,0,1441,400,410,10
"33a9d248b2e44588a5b07fc1342b9bc2","6a5f020451db426dacba9e2ea3fcc62a",22855438,1,-2,0,1447,411,410,-1
"33a9d248b2e44588a5b07fc1342b9bc2","c6f26bd420634f1cb7989e76fe6b16c0",22855438,1,1,0,1449,411,412,1
"c6f26bd420634f1cb7989e76fe6b16c0","c6f26bd420634f1cb7989e76fe6b16c0",22855438,5,0,1,1450,412,412,0
"c6f26bd420634f1cb7989e76fe6b16c0","2a65ee6e2ac64f6a8a55fbe5373ec763",22855438,1,1,0,1455,412,413,1
"2a65ee6e2ac64f6a8a55fbe5373ec763","2a65ee6e2ac64f6a8a55fbe5373ec763",22855438,2,0,1,1456,413,413,0
"2a65ee6e2ac64f6a8a55fbe5373ec763","33a9d248b2e44588a5b07fc1342b9bc2",22855438,1,-2,0,1458,413,411,-2
"33a9d248b2e44588a5b07fc1342b9bc2","1fd0f6dadbc14ebc965faf6122190b96",22855438,1,5,0,1459,411,415,4
"1fd0f6dadbc14ebc965faf6122190b96","1fd0f6dadbc14ebc965faf6122190b96",22855438,1,0,1,1460,415,415,0
"1fd0f6dadbc14ebc965faf6122190b96","687055dad9fc40c3982478fe33ec01bf",22855438,1,-1,0,1461,415,414,-1
"687055dad9fc40c3982478fe33ec01bf","2b09a08242b54983aec7063990fb3f66",22855438,1,-21,0,1462,414,400,-14
"2b09a08242b54983aec7063990fb3f66","a2b4bd40cee2481ebd3fc179d6a5cd62",22855438,2,27,0,1463,400,417,17
"a2b4bd40cee2481ebd3fc179d6a5cd62","e34e59dce2204f228f3a84b6725df60f",22855438,1,2,0,1464,417,419,2
"e34e59dce2204f228f3a84b6725df60f","e34e59dce2204f228f3a84b6725df60f",22855438,1,0,1,1465,419,419,0
"e34e59dce2204f228f3a84b6725df60f","a2b4bd40cee2481ebd3fc179d6a5cd62",22855438,1,-2,0,1466,419,417,-2
"a2b4bd40cee2481ebd3fc179d6a5cd62","bec48fc2e1294c7eb3d0aca780d731b8",22855438,1,4,0,1467,417,420,3
"bec48fc2e1294c7eb3d0aca780d731b8","bec48fc2e1294c7eb3d0aca780d731b8",22855438,2,0,1,1468,420,420,0
"bec48fc2e1294c7eb3d0aca780d731b8","a24600b0e49245f6bdba8c893cfeddb0",22855438,1,7,0,1470,420,425,5
"a24600b0e49245f6bdba8c893cfeddb0","dbde19fcce2a4c1abdc7f685c293a23f",22855438,1,-4,0,1471,425,422,-3
"dbde19fcce2a4c1abdc7f685c293a23f","a24600b0e49245f6bdba8c893cfeddb0",22855438,1,4,0,1472,422,425,3
"a24600b0e49245f6bdba8c893cfeddb0","a24600b0e49245f6bdba8c893cfeddb0",22855438,3,0,1,1473,425,425,0
"a24600b0e49245f6bdba8c893cfeddb0","a2b4bd40cee2481ebd3fc179d6a5cd62",22855438,1,-11,0,1476,425,417,-8
"a2b4bd40cee2481ebd3fc179d6a5cd62","24cf8786024543f19b89bc20034e60d7",22855438,1,18,0,1477,417,428,11
"24cf8786024543f19b89bc20034e60d7","f2a73be2f46840b182d7bd095378004e",22855438,1,1,0,1478,428,429,1
"f2a73be2f46840b182d7bd095378004e","f2a73be2f46840b182d7bd095378004e",22855438,1,0,1,1479,429,429,0
"f2a73be2f46840b182d7bd095378004e","604551fd4266430cb860fef58fa7dd61",22855438,1,1,0,1480,429,430,1
"604551fd4266430cb860fef58fa7dd61","604551fd4266430cb860fef58fa7dd61",22855438,8,0,1,1481,430,430,0
"604551fd4266430cb860fef58fa7dd61","24cf8786024543f19b89bc20034e60d7",22855438,1,-2,0,1489,430,428,-2
"24cf8786024543f19b89bc20034e60d7","dce46f8904594a62a6377a3587aaa663",22855438,1,4,0,1490,428,431,3
"dce46f8904594a62a6377a3587aaa663","dce46f8904594a62a6377a3587aaa663",22855438,1,0,1,1491,431,431,0
"dce46f8904594a62a6377a3587aaa663","9b9d0a249052413c869753b99682b0ac",22855438,1,1,0,1492,431,432,1
"9b9d0a249052413c869753b99682b0ac","9b9d0a249052413c869753b99682b0ac",22855438,6,0,1,1493,432,432,0
"9b9d0a249052413c869753b99682b0ac","061c175cc90f45fbad883025394e78dd",22855438,1,1,0,1499,432,433,1
"061c175cc90f45fbad883025394e78dd","061c175cc90f45fbad883025394e78dd",22855438,5,0,1,1500,433,433,0
"061c175cc90f45fbad883025394e78dd","dce46f8904594a62a6377a3587aaa663",22855438,1,-2,0,1505,433,431,-2
"dce46f8904594a62a6377a3587aaa663","74a7f8712e5449c2bc0b43c6f90dafed",22855438,1,5,0,1506,431,435,4
"74a7f8712e5449c2bc0b43c6f90dafed","74a7f8712e5449c2bc0b43c6f90dafed",22855438,1,0,1,1507,435,435,0
"74a7f8712e5449c2bc0b43c6f90dafed","66ada10dde9f43018588f1ced9d477fc",22855438,1,-1,0,1508,435,434,-1
"66ada10dde9f43018588f1ced9d477fc","bf12c96466d840a69bed7020b3f18bb8",22855438,1,3,0,1509,434,436,2
"bf12c96466d840a69bed7020b3f18bb8","bf12c96466d840a69bed7020b3f18bb8",22855438,1,0,1,1510,436,436,0
"bf12c96466d840a69bed7020b3f18bb8","070600601c4c439288445d2f0724807d",22855438,1,3,0,1511,436,437,1
"070600601c4c439288445d2f0724807d","24cf8786024543f19b89bc20034e60d7",22855438,2,-14,0,1512,437,428,-9
"24cf8786024543f19b89bc20034e60d7","1823b6de7d334a7aaabc4570719af4d9",22855438,2,16,0,1513,428,439,11
"1823b6de7d334a7aaabc4570719af4d9","0380cd76a7d44bc3a4da1f15e4d68f89",22855438,3,2,0,1514,439,440,1
"0380cd76a7d44bc3a4da1f15e4d68f89","070600601c4c439288445d2f0724807d",22855438,3,-4,0,1515,440,437,-3
"070600601c4c439288445d2f0724807d","0380cd76a7d44bc3a4da1f15e4d68f89",22855438,2,4,0,1516,437,440,3
"0380cd76a7d44bc3a4da1f15e4d68f89","23b7673c8b5443108c2ef09382834a86",22855438,2,2,0,1517,440,441,1
"23b7673c8b5443108c2ef09382834a86","23b7673c8b5443108c2ef09382834a86",22855438,3,0,1,1518,441,441,0
"23b7673c8b5443108c2ef09382834a86","901e92500aea43c79f19f1b279050668",22855438,3,2,0,1519,441,442,1
"901e92500aea43c79f19f1b279050668","4660ff2089114e8db82ceb26a4f329e3",22855438,5,4,0,1520,442,445,3
"4660ff2089114e8db82ceb26a4f329e3","901e92500aea43c79f19f1b279050668",22855438,4,-4,0,1521,445,442,-3
"4660ff2089114e8db82ceb26a4f329e3","7bd5586eb9d8484eb74a433ee7bfe499",22855438,4,2,0,1523,445,446,1
"7bd5586eb9d8484eb74a433ee7bfe499","7bd5586eb9d8484eb74a433ee7bfe499",22855438,19,0,1,1524,446,446,0
"7bd5586eb9d8484eb74a433ee7bfe499","b2f0d654738f48158edff28e8d3a546e",22855438,1,7,0,1525,446,449,3
"b2f0d654738f48158edff28e8d3a546e","070600601c4c439288445d2f0724807d",22855438,4,-21,0,1526,449,437,-12
"070600601c4c439288445d2f0724807d","070600601c4c439288445d2f0724807d",22855438,1,0,1,1527,437,437,0
"070600601c4c439288445d2f0724807d","b2f0d654738f48158edff28e8d3a546e",22855438,5,21,0,1528,437,449,12
"b2f0d654738f48158edff28e8d3a546e","b2f0d654738f48158edff28e8d3a546e",22855438,2,0,1,1529,449,449,0
"070600601c4c439288445d2f0724807d","f60ee41ec635499abd48168342d32c2f",22855438,1,26,0,1533,437,453,16
"f60ee41ec635499abd48168342d32c2f","f60ee41ec635499abd48168342d32c2f",22855438,79,0,1,1534,453,453,0
"f60ee41ec635499abd48168342d32c2f","b2f0d654738f48158edff28e8d3a546e",22855438,4,-5,0,1536,453,449,-4
"b2f0d654738f48158edff28e8d3a546e","f60ee41ec635499abd48168342d32c2f",22855438,6,5,0,1537,449,453,4
"f60ee41ec635499abd48168342d32c2f","070600601c4c439288445d2f0724807d",22855438,1,-26,0,1542,453,437,-16
"b2f0d654738f48158edff28e8d3a546e","9428d8bd9c5a47b2a235b254e5e27ded",22855438,1,4,0,1544,449,452,3
"9428d8bd9c5a47b2a235b254e5e27ded","070600601c4c439288445d2f0724807d",22855438,1,-25,0,1545,452,437,-15
"b2f0d654738f48158edff28e8d3a546e","8a7f26e690f34dda97be16904518ca99",22855438,1,-5,0,1547,449,447,-2
"8a7f26e690f34dda97be16904518ca99","4660ff2089114e8db82ceb26a4f329e3",22855438,1,-4,0,1548,447,445,-2
"7bd5586eb9d8484eb74a433ee7bfe499","901e92500aea43c79f19f1b279050668",22855438,1,-6,0,1551,446,442,-4
"901e92500aea43c79f19f1b279050668","901e92500aea43c79f19f1b279050668",22855438,4,0,1,1552,442,442,0
"901e92500aea43c79f19f1b279050668","23b7673c8b5443108c2ef09382834a86",22855438,3,-2,0,1553,442,441,-1
"23b7673c8b5443108c2ef09382834a86","4660ff2089114e8db82ceb26a4f329e3",22855438,1,6,0,1554,441,445,4
"4660ff2089114e8db82ceb26a4f329e3","23b7673c8b5443108c2ef09382834a86",22855438,1,-6,0,1555,445,441,-4
"23b7673c8b5443108c2ef09382834a86","0380cd76a7d44bc3a4da1f15e4d68f89",22855438,2,-2,0,1556,441,440,-1
"0380cd76a7d44bc3a4da1f15e4d68f89","1823b6de7d334a7aaabc4570719af4d9",22855438,1,-2,0,1557,440,439,-1
"0380cd76a7d44bc3a4da1f15e4d68f89","b2f0d654738f48158edff28e8d3a546e",22855438,1,17,0,1559,440,449,9
"f60ee41ec635499abd48168342d32c2f","9428d8bd9c5a47b2a235b254e5e27ded",22855438,2,-1,0,1568,453,452,-1
"9428d8bd9c5a47b2a235b254e5e27ded","b2f0d654738f48158edff28e8d3a546e",22855438,1,-4,0,1569,452,449,-3
"070600601c4c439288445d2f0724807d","8a7f26e690f34dda97be16904518ca99",22855438,1,16,0,1571,437,447,10
"8a7f26e690f34dda97be16904518ca99","7bd5586eb9d8484eb74a433ee7bfe499",22855438,1,-2,0,1572,447,446,-1
"7bd5586eb9d8484eb74a433ee7bfe499","4660ff2089114e8db82ceb26a4f329e3",22855438,2,-2,0,1573,446,445,-1
"0380cd76a7d44bc3a4da1f15e4d68f89","24cf8786024543f19b89bc20034e60d7",22855438,1,-18,0,1581,440,428,-12
"24cf8786024543f19b89bc20034e60d7","0380cd76a7d44bc3a4da1f15e4d68f89",22855438,1,18,0,1582,428,440,12
"070600601c4c439288445d2f0724807d","1823b6de7d334a7aaabc4570719af4d9",22855438,1,2,0,1584,437,439,2
"1823b6de7d334a7aaabc4570719af4d9","070600601c4c439288445d2f0724807d",22855438,1,-2,0,1585,439,437,-2
"1823b6de7d334a7aaabc4570719af4d9","1823b6de7d334a7aaabc4570719af4d9",22855438,15,0,1,1588,439,439,0
"0380cd76a7d44bc3a4da1f15e4d68f89","0380cd76a7d44bc3a4da1f15e4d68f89",22855438,1,0,1,1606,440,440,0
"901e92500aea43c79f19f1b279050668","001339db8ced4cf78829ebe8b145449d",22855438,2,1,0,1612,442,443,1
"001339db8ced4cf78829ebe8b145449d","001339db8ced4cf78829ebe8b145449d",22855438,11,0,1,1613,443,443,0
"001339db8ced4cf78829ebe8b145449d","452745e0366e42ae81561bfddebcc6c3",22855438,2,1,0,1624,443,444,1
"452745e0366e42ae81561bfddebcc6c3","452745e0366e42ae81561bfddebcc6c3",22855438,8,0,1,1625,444,444,0
"452745e0366e42ae81561bfddebcc6c3","901e92500aea43c79f19f1b279050668",22855438,1,-2,0,1633,444,442,-2
"4660ff2089114e8db82ceb26a4f329e3","4660ff2089114e8db82ceb26a4f329e3",22855438,2,0,1,1635,445,445,0
"7bd5586eb9d8484eb74a433ee7bfe499","8a7f26e690f34dda97be16904518ca99",22855438,1,2,0,1655,446,447,1
"8a7f26e690f34dda97be16904518ca99","8a7f26e690f34dda97be16904518ca99",22855438,1,0,1,1656,447,447,0
"8a7f26e690f34dda97be16904518ca99","070600601c4c439288445d2f0724807d",22855438,1,-16,0,1657,447,437,-10
"b2f0d654738f48158edff28e8d3a546e","f67fbf45a5f146ed866965bc57c7c001",22855438,1,8,0,1715,449,454,5
"f67fbf45a5f146ed866965bc57c7c001","f67fbf45a5f146ed866965bc57c7c001",22855438,2,0,1,1716,454,454,0
"f67fbf45a5f146ed866965bc57c7c001","d937afe49bd24a07a550dda1c1155122",22855438,1,1,0,1718,454,455,1
"d937afe49bd24a07a550dda1c1155122","d937afe49bd24a07a550dda1c1155122",22855438,1,0,1,1719,455,455,0
"d937afe49bd24a07a550dda1c1155122","3628b3f7823443d0912a339096b69943",22855438,1,1,0,1720,455,456,1
"3628b3f7823443d0912a339096b69943","3628b3f7823443d0912a339096b69943",22855438,3,0,1,1721,456,456,0
"3628b3f7823443d0912a339096b69943","9e049ee647cf43ecbcb5ed792a8e7588",22855438,1,1,0,1724,456,457,1
"9e049ee647cf43ecbcb5ed792a8e7588","9e049ee647cf43ecbcb5ed792a8e7588",22855438,1,0,1,1725,457,457,0
"9e049ee647cf43ecbcb5ed792a8e7588","5256a214faaf410b93f76cea06428334",22855438,1,1,0,1726,457,458,1
"5256a214faaf410b93f76cea06428334","5256a214faaf410b93f76cea06428334",22855438,1,0,1,1727,458,458,0
"5256a214faaf410b93f76cea06428334","25c32b120fce40fa9b6c85133aeb4716",22855438,1,1,0,1728,458,459,1
"25c32b120fce40fa9b6c85133aeb4716","25c32b120fce40fa9b6c85133aeb4716",22855438,1,0,1,1729,459,459,0
"25c32b120fce40fa9b6c85133aeb4716","11bc14f2204949008b7d511b933363c1",22855438,1,1,0,1730,459,460,1
"11bc14f2204949008b7d511b933363c1","11bc14f2204949008b7d511b933363c1",22855438,5,0,1,1731,460,460,0
"11bc14f2204949008b7d511b933363c1","42de338840a34d15adb66e7b14fb9d2c",22855438,1,1,0,1736,460,461,1
"42de338840a34d15adb66e7b14fb9d2c","42de338840a34d15adb66e7b14fb9d2c",22855438,1,0,1,1737,461,461,0
"42de338840a34d15adb66e7b14fb9d2c","9da37c6210b1416b8079c274f70bf600",22855438,1,1,0,1738,461,462,1
"9da37c6210b1416b8079c274f70bf600","9da37c6210b1416b8079c274f70bf600",22855438,1,0,1,1739,462,462,0
"9da37c6210b1416b8079c274f70bf600","519119f1deac45ff9ab4f13529be5c6e",22855438,1,1,0,1740,462,463,1
"519119f1deac45ff9ab4f13529be5c6e","519119f1deac45ff9ab4f13529be5c6e",22855438,1,0,1,1741,463,463,0
"519119f1deac45ff9ab4f13529be5c6e","f67fbf45a5f146ed866965bc57c7c001",22855438,1,-9,0,1742,463,454,-9
"f67fbf45a5f146ed866965bc57c7c001","c5df9f40ec14463b9dcfdc73df3e9285",22855438,2,12,0,1743,454,464,10
"c5df9f40ec14463b9dcfdc73df3e9285","c5df9f40ec14463b9dcfdc73df3e9285",22855438,13,0,1,1744,464,464,0
"c5df9f40ec14463b9dcfdc73df3e9285","83d42d95cd844fc093fc09cee250edb8",22855438,7,3,0,1746,464,465,1
"83d42d95cd844fc093fc09cee250edb8","83d42d95cd844fc093fc09cee250edb8",22855438,9,0,1,1747,465,465,0
"83d42d95cd844fc093fc09cee250edb8","b2f0d654738f48158edff28e8d3a546e",22855438,1,-23,0,1748,465,449,-16
"9428d8bd9c5a47b2a235b254e5e27ded","f60ee41ec635499abd48168342d32c2f",22855438,1,1,0,1760,452,453,1
"f60ee41ec635499abd48168342d32c2f","f67fbf45a5f146ed866965bc57c7c001",22855438,1,3,0,1769,453,454,1
"f67fbf45a5f146ed866965bc57c7c001","b2f0d654738f48158edff28e8d3a546e",22855438,1,-8,0,1770,454,449,-5
"b2f0d654738f48158edff28e8d3a546e","c5df9f40ec14463b9dcfdc73df3e9285",22855438,1,20,0,1771,449,464,15
"c5df9f40ec14463b9dcfdc73df3e9285","f67fbf45a5f146ed866965bc57c7c001",22855438,1,-12,0,1772,464,454,-10
"83d42d95cd844fc093fc09cee250edb8","c5df9f40ec14463b9dcfdc73df3e9285",22855438,3,-3,0,1775,465,464,-1
"83d42d95cd844fc093fc09cee250edb8","eb2a0eb537344a9e891c761662e400b6",22855438,1,-632,0,1777,465,16,-449
"eb2a0eb537344a9e891c761662e400b6","56586aa865414f538729c7f7735d2bc6",22855438,2,-8,0,1778,16,12,-4
"56586aa865414f538729c7f7735d2bc6","5c5ceeee4562457ba6d41515aeebfbb1",22855438,2,10,0,1779,12,17,5
"5c5ceeee4562457ba6d41515aeebfbb1","56586aa865414f538729c7f7735d2bc6",22855438,1,-10,0,1780,17,12,-5
"56586aa865414f538729c7f7735d2bc6","9afd71a5298d4333b6849dfce1b9422c",22855438,2,13,0,1781,12,18,6
"9afd71a5298d4333b6849dfce1b9422c","b7719e26494940efa49512aedd0aac79",22855438,3,4,0,1782,18,20,2
"b7719e26494940efa49512aedd0aac79","9afd71a5298d4333b6849dfce1b9422c",22855438,2,-4,0,1783,20,18,-2
"9afd71a5298d4333b6849dfce1b9422c","d4f45188d3c84a02ba08454e6403a818",22855438,2,9,0,1784,18,24,6
"d4f45188d3c84a02ba08454e6403a818","d4c3b003e8274e429d2fa688d73fde6d",22855438,3,-2,0,1785,24,22,-2
"d4c3b003e8274e429d2fa688d73fde6d","b7719e26494940efa49512aedd0aac79",22855438,2,-3,0,1786,22,20,-2
"b7719e26494940efa49512aedd0aac79","afbf7250b99d47bea07172749483ca97",22855438,3,12,0,1787,20,28,8
"afbf7250b99d47bea07172749483ca97","b7719e26494940efa49512aedd0aac79",22855438,1,-12,0,1788,28,20,-8
"afbf7250b99d47bea07172749483ca97","4e51676dc72045d99c19b9fa7b22f8bc",22855438,3,3,0,1790,28,29,1
"4e51676dc72045d99c19b9fa7b22f8bc","eb2a0eb537344a9e891c761662e400b6",22855438,1,-24,0,1791,29,16,-13
"5c5ceeee4562457ba6d41515aeebfbb1","eb2a0eb537344a9e891c761662e400b6",22855438,2,-2,0,1794,17,16,-1
"eb2a0eb537344a9e891c761662e400b6","81c864a886d54a6b8ff85f7d736f4f95",22855438,1,-2,0,1795,16,15,-1
"81c864a886d54a6b8ff85f7d736f4f95","5c5ceeee4562457ba6d41515aeebfbb1",22855438,1,4,0,1796,15,17,2
"eb2a0eb537344a9e891c761662e400b6","5c5ceeee4562457ba6d41515aeebfbb1",22855438,2,2,0,1798,16,17,1
"5c5ceeee4562457ba6d41515aeebfbb1","81c864a886d54a6b8ff85f7d736f4f95",22855438,1,-4,0,1799,17,15,-2
"81c864a886d54a6b8ff85f7d736f4f95","9afd71a5298d4333b6849dfce1b9422c",22855438,1,7,0,1800,15,18,3
"9afd71a5298d4333b6849dfce1b9422c","56586aa865414f538729c7f7735d2bc6",22855438,2,-13,0,1801,18,12,-6
"56586aa865414f538729c7f7735d2bc6","d646286c8051419bbc2e31dd1db55ca8",22855438,1,94,0,1802,12,67,55
"d646286c8051419bbc2e31dd1db55ca8","d646286c8051419bbc2e31dd1db55ca8",22855438,1,0,1,1803,67,67,0
"d646286c8051419bbc2e31dd1db55ca8","a2becd407db34b189200a32546d9d569",22855438,2,9,0,1804,67,75,8
"a2becd407db34b189200a32546d9d569","d646286c8051419bbc2e31dd1db55ca8",22855438,1,-9,0,1805,75,67,-8
"d646286c8051419bbc2e31dd1db55ca8","140d5b27b8574befad82c0a013b59dfa",22855438,1,8,0,1806,67,74,7
"140d5b27b8574befad82c0a013b59dfa","d18a9ea32855445f8736581f5cb119ce",22855438,2,9,0,1807,74,82,8
"d18a9ea32855445f8736581f5cb119ce","6a9f0ef185fb47f0937e29daa1c71ed5",22855438,1,10,0,1808,82,90,8
"6a9f0ef185fb47f0937e29daa1c71ed5","ae5ac430ea254e708a6f5deaaf7464ae",22855438,2,-7,0,1809,90,84,-6
"ae5ac430ea254e708a6f5deaaf7464ae","6a9f0ef185fb47f0937e29daa1c71ed5",22855438,3,7,0,1810,84,90,6
"6a9f0ef185fb47f0937e29daa1c71ed5","6a9f0ef185fb47f0937e29daa1c71ed5",22855438,4,0,1,1811,90,90,0
"6a9f0ef185fb47f0937e29daa1c71ed5","d646286c8051419bbc2e31dd1db55ca8",22855438,1,-27,0,1814,90,67,-23
"d646286c8051419bbc2e31dd1db55ca8","e20db35ced8544ddac5bc3839145e463",22855438,2,30,0,1815,67,91,24
"e20db35ced8544ddac5bc3839145e463","00ae5f0c51874a73a41ebea838d95682",22855438,3,11,0,1816,91,101,10
"00ae5f0c51874a73a41ebea838d95682","d391c8b6e56a43a7b654e9dee02d904b",22855438,8,2,0,1817,101,103,2
"d391c8b6e56a43a7b654e9dee02d904b","e20db35ced8544ddac5bc3839145e463",22855438,1,-13,0,1818,103,91,-12
"e20db35ced8544ddac5bc3839145e463","4280927ec4d643238aa49c32f9e06c6c",22855438,1,20,0,1819,91,109,18
"4280927ec4d643238aa49c32f9e06c6c","73039f8c1eb9409cb4caee2cf968001e",22855438,3,-10,0,1820,109,100,-9
"73039f8c1eb9409cb4caee2cf968001e","00ae5f0c51874a73a41ebea838d95682",22855438,1,1,0,1821,100,101,1
"00ae5f0c51874a73a41ebea838d95682","08111f75e22d409998cf8b85bd431f0a",22855438,1,8,0,1822,101,108,7
"08111f75e22d409998cf8b85bd431f0a","d391c8b6e56a43a7b654e9dee02d904b",22855438,1,-6,0,1823,108,103,-5
"d391c8b6e56a43a7b654e9dee02d904b","6111116566fc4fd9abba409322bea245",22855438,3,1,0,1824,103,104,1
"6111116566fc4fd9abba409322bea245","6111116566fc4fd9abba409322bea245",22855438,6,0,1,1825,104,104,0
"6111116566fc4fd9abba409322bea245","2d4e0ab0ef3b4d73b82c72d4621a7579",22855438,2,2,0,1827,104,106,2
"2d4e0ab0ef3b4d73b82c72d4621a7579","2d4e0ab0ef3b4d73b82c72d4621a7579",22855438,6,0,1,1828,106,106,0
"2d4e0ab0ef3b4d73b82c72d4621a7579","8bdebf492ebd4e62b0d522e8ab5e5197",22855438,3,1,0,1830,106,107,1
"8bdebf492ebd4e62b0d522e8ab5e5197","8bdebf492ebd4e62b0d522e8ab5e5197",22855438,6,0,1,1831,107,107,0
"8bdebf492ebd4e62b0d522e8ab5e5197","4280927ec4d643238aa49c32f9e06c6c",22855438,2,3,0,1833,107,109,2
"73039f8c1eb9409cb4caee2cf968001e","08111f75e22d409998cf8b85bd431f0a",22855438,2,9,0,1835,100,108,8
"08111f75e22d409998cf8b85bd431f0a","00ae5f0c51874a73a41ebea838d95682",22855438,2,-8,0,1836,108,101,-7
"d391c8b6e56a43a7b654e9dee02d904b","b416d47c56a742199b5d7c7f19d6503a",22855438,1,38,0,1838,103,134,31
"b416d47c56a742199b5d7c7f19d6503a","779f9ddd1fd14d1e9e69f72219a1fdbd",22855438,1,-15,0,1839,134,121,-13
"779f9ddd1fd14d1e9e69f72219a1fdbd","8bc5795d6a984a3eace4e2811e52dd4f",22855438,1,16,0,1840,121,135,14
"8bc5795d6a984a3eace4e2811e52dd4f","8bc5795d6a984a3eace4e2811e52dd4f",22855438,4,0,1,1841,135,135,0
"8bc5795d6a984a3eace4e2811e52dd4f","b416d47c56a742199b5d7c7f19d6503a",22855438,2,-1,0,1842,135,134,-1
"b416d47c56a742199b5d7c7f19d6503a","cd4532ad48034873ba8bce2aac0c9808",22855438,2,4,0,1843,134,137,3
"cd4532ad48034873ba8bce2aac0c9808","cd4532ad48034873ba8bce2aac0c9808",22855438,2,0,1,1844,137,137,0
"cd4532ad48034873ba8bce2aac0c9808","779f9ddd1fd14d1e9e69f72219a1fdbd",22855438,1,-19,0,1845,137,121,-16
"779f9ddd1fd14d1e9e69f72219a1fdbd","df1de691dafe4549a18a4398ee9dfaf9",22855438,1,23,0,1846,121,139,18
"df1de691dafe4549a18a4398ee9dfaf9","6c5ad271a44743479bfaea29b1db8d02",22855438,1,4,0,1847,139,143,4
"6c5ad271a44743479bfaea29b1db8d02","83d311bed5374fee83d8d67a7d9d82dc",22855438,2,1,0,1848,143,144,1
"83d311bed5374fee83d8d67a7d9d82dc","83d311bed5374fee83d8d67a7d9d82dc",22855438,4,0,1,1849,144,144,0
"83d311bed5374fee83d8d67a7d9d82dc","402bba41861d43acb52a5abb89e8831e",22855438,2,1,0,1850,144,145,1
"402bba41861d43acb52a5abb89e8831e","402bba41861d43acb52a5abb89e8831e",22855438,7,0,1,1851,145,145,0
"402bba41861d43acb52a5abb89e8831e","8aae34f5ddbb4052a709b12e6b0d40fa",22855438,1,3,0,1853,145,147,2
"8aae34f5ddbb4052a709b12e6b0d40fa","df1de691dafe4549a18a4398ee9dfaf9",22855438,1,-9,0,1854,147,139,-8
"df1de691dafe4549a18a4398ee9dfaf9","645b3f0249f64f76af2e19eb4d0e55b7",22855438,1,11,0,1855,139,149,10
"645b3f0249f64f76af2e19eb4d0e55b7","645b3f0249f64f76af2e19eb4d0e55b7",22855438,7,0,1,1856,149,149,0
"645b3f0249f64f76af2e19eb4d0e55b7","7e7b8db5064d4369805ab370aac5ddfb",22855438,3,1,0,1858,149,150,1
"7e7b8db5064d4369805ab370aac5ddfb","7e7b8db5064d4369805ab370aac5ddfb",22855438,6,0,1,1859,150,150,0
"7e7b8db5064d4369805ab370aac5ddfb","8956d210ae7f41968fada86d4c979d6a",22855438,3,1,0,1861,150,151,1
"8956d210ae7f41968fada86d4c979d6a","8956d210ae7f41968fada86d4c979d6a",22855438,4,0,1,1862,151,151,0
"8956d210ae7f41968fada86d4c979d6a","f902b0f41b544d4dbf79664fd233648d",22855438,3,-5,0,1864,151,146,-5
"f902b0f41b544d4dbf79664fd233648d","ae781e8b775e4ccd93bc800dad5c8376",22855438,3,8,0,1865,146,153,7
"ae781e8b775e4ccd93bc800dad5c8376","ae781e8b775e4ccd93bc800dad5c8376",22855438,6,0,1,1866,153,153,0
"ae781e8b775e4ccd93bc800dad5c8376","06882a8492d9499aa31555567f575ecb",22855438,3,1,0,1868,153,154,1
"06882a8492d9499aa31555567f575ecb","06882a8492d9499aa31555567f575ecb",22855438,3,0,1,1869,154,154,0
"06882a8492d9499aa31555567f575ecb","f03480cf4eba413194d7af52fc0e7f28",22855438,1,-2,0,1870,154,152,-2
"f03480cf4eba413194d7af52fc0e7f28","d313cec988a84645bee413e8d4724a4b",22855438,3,7,0,1871,152,158,6
"d313cec988a84645bee413e8d4724a4b","d313cec988a84645bee413e8d4724a4b",22855438,6,0,1,1872,158,158,0
"d313cec988a84645bee413e8d4724a4b","dc60696c76a74368a60f72246e47700d",22855438,2,1,0,1874,158,159,1
"dc60696c76a74368a60f72246e47700d","dc60696c76a74368a60f72246e47700d",22855438,2,0,1,1875,159,159,0
"dc60696c76a74368a60f72246e47700d","78adeee1fa2c4fe0bc73f7bca9fcee86",22855438,1,3,0,1876,159,160,1
"78adeee1fa2c4fe0bc73f7bca9fcee86","df1de691dafe4549a18a4398ee9dfaf9",22855438,1,-26,0,1877,160,139,-21
"df1de691dafe4549a18a4398ee9dfaf9","65202579580f4ad38d734b4ee39d22a8",22855438,1,31,0,1878,139,164,25
"65202579580f4ad38d734b4ee39d22a8","65202579580f4ad38d734b4ee39d22a8",22855438,71,0,1,1879,164,164,0
"65202579580f4ad38d734b4ee39d22a8","78adeee1fa2c4fe0bc73f7bca9fcee86",22855438,4,-5,0,1884,164,160,-4
"78adeee1fa2c4fe0bc73f7bca9fcee86","65202579580f4ad38d734b4ee39d22a8",22855438,5,5,0,1885,160,164,4
"65202579580f4ad38d734b4ee39d22a8","d646286c8051419bbc2e31dd1db55ca8",22855438,1,-120,0,1887,164,67,-97
"d646286c8051419bbc2e31dd1db55ca8","ae5ac430ea254e708a6f5deaaf7464ae",22855438,1,20,0,1888,67,84,17
"ae5ac430ea254e708a6f5deaaf7464ae","f564483cbd7a407681aa2fcca518cf5f",22855438,1,1,0,1889,84,85,1
"f564483cbd7a407681aa2fcca518cf5f","f564483cbd7a407681aa2fcca518cf5f",22855438,5,0,1,1890,85,85,0
"f564483cbd7a407681aa2fcca518cf5f","6a9f0ef185fb47f0937e29daa1c71ed5",22855438,1,6,0,1891,85,90,5
"6a9f0ef185fb47f0937e29daa1c71ed5","c681290961c94c4caf23b529d1ae6b9a",22855438,2,-2,0,1895,90,88,-2
"c681290961c94c4caf23b529d1ae6b9a","c681290961c94c4caf23b529d1ae6b9a",22855438,2,0,1,1896,88,88,0
"c681290961c94c4caf23b529d1ae6b9a","d646286c8051419bbc2e31dd1db55ca8",22855438,1,-25,0,1897,88,67,-21
"e20db35ced8544ddac5bc3839145e463","3007433c8f584dcbb5ac159c1c5f2be3",22855438,1,8,0,1899,91,99,8
"3007433c8f584dcbb5ac159c1c5f2be3","3007433c8f584dcbb5ac159c1c5f2be3",22855438,4,0,1,1900,99,99,0
"3007433c8f584dcbb5ac159c1c5f2be3","e20db35ced8544ddac5bc3839145e463",22855438,1,-8,0,1902,99,91,-8
"d391c8b6e56a43a7b654e9dee02d904b","df1de691dafe4549a18a4398ee9dfaf9",22855438,1,46,0,1905,103,139,36
"df1de691dafe4549a18a4398ee9dfaf9","f902b0f41b544d4dbf79664fd233648d",22855438,1,8,0,1906,139,146,7
"f902b0f41b544d4dbf79664fd233648d","8aae34f5ddbb4052a709b12e6b0d40fa",22855438,1,1,0,1907,146,147,1
"8aae34f5ddbb4052a709b12e6b0d40fa","7e7b8db5064d4369805ab370aac5ddfb",22855438,1,3,0,1908,147,150,3
"7e7b8db5064d4369805ab370aac5ddfb","f902b0f41b544d4dbf79664fd233648d",22855438,1,-4,0,1911,150,146,-4
"06882a8492d9499aa31555567f575ecb","d313cec988a84645bee413e8d4724a4b",22855438,1,5,0,1917,154,158,4
"d313cec988a84645bee413e8d4724a4b","f03480cf4eba413194d7af52fc0e7f28",22855438,2,-7,0,1919,158,152,-6
"dc60696c76a74368a60f72246e47700d","df1de691dafe4549a18a4398ee9dfaf9",22855438,1,-23,0,1923,159,139,-20
"df1de691dafe4549a18a4398ee9dfaf9","78adeee1fa2c4fe0bc73f7bca9fcee86",22855438,2,26,0,1924,139,160,21
"78adeee1fa2c4fe0bc73f7bca9fcee86","139b097acfca451689d80c9c6eebdf7b",22855438,1,28,0,1925,160,178,18
"139b097acfca451689d80c9c6eebdf7b","0c7262dff33c4087bc660ccf40f92f9c",22855438,2,-11,0,1926,178,169,-9
"0c7262dff33c4087bc660ccf40f92f9c","ea38cc0e6e6e41edbabf210220808bf9",22855438,2,12,0,1927,169,179,10
"ea38cc0e6e6e41edbabf210220808bf9","b87c552dd247427abe6ab5795b9c9d43",22855438,4,2,0,1928,179,181,2
"b87c552dd247427abe6ab5795b9c9d43","139b097acfca451689d80c9c6eebdf7b",22855438,2,-3,0,1929,181,178,-3
"139b097acfca451689d80c9c6eebdf7b","2024b4885bd14338a39b7b509acbbd02",22855438,1,5,0,1930,178,182,4
"2024b4885bd14338a39b7b509acbbd02","c3f63fe50d8e487c86bf8ef76c9cadd3",22855438,2,4,0,1931,182,185,3
"c3f63fe50d8e487c86bf8ef76c9cadd3","c3f63fe50d8e487c86bf8ef76c9cadd3",22855438,2,0,1,1932,185,185,0
"c3f63fe50d8e487c86bf8ef76c9cadd3","c8e371568a0c4391b25796ae4e91952e",22855438,2,3,0,1933,185,186,1
"c8e371568a0c4391b25796ae4e91952e","0c7262dff33c4087bc660ccf40f92f9c",22855438,2,-23,0,1934,186,169,-17
"0c7262dff33c4087bc660ccf40f92f9c","7d932b23e1c84326ae5aa4d3c0d813d1",22855438,1,25,0,1935,169,188,19
"7d932b23e1c84326ae5aa4d3c0d813d1","7d932b23e1c84326ae5aa4d3c0d813d1",22855438,1,0,1,1936,188,188,0
"7d932b23e1c84326ae5aa4d3c0d813d1","ab11d94c6c8948ea90b88f19d2cd502b",22855438,1,3,0,1937,188,190,2
"ab11d94c6c8948ea90b88f19d2cd502b","c8e371568a0c4391b25796ae4e91952e",22855438,1,-5,0,1938,190,186,-4
"c8e371568a0c4391b25796ae4e91952e","f992451ed6ad4e68bb9e68ad6be7c4be",22855438,1,7,0,1939,186,192,6
"f992451ed6ad4e68bb9e68ad6be7c4be","f992451ed6ad4e68bb9e68ad6be7c4be",22855438,2,0,1,1940,192,192,0
"f992451ed6ad4e68bb9e68ad6be7c4be","6cd2dcaac46847d4a0bc53f296d90375",22855438,1,3,0,1941,192,194,2
"6cd2dcaac46847d4a0bc53f296d90375","07b44a7a51e94c78b411c753fc39dab0",22855438,1,-6,0,1942,194,189,-5
"07b44a7a51e94c78b411c753fc39dab0","2d2580c9411c4972909db508d6956a58",22855438,1,8,0,1943,189,196,7
"2d2580c9411c4972909db508d6956a58","2d2580c9411c4972909db508d6956a58",22855438,4,0,1,1944,196,196,0
"2d2580c9411c4972909db508d6956a58","5bddb3d9ed264f3984702f048c7e5340",22855438,2,1,0,1946,196,197,1
"5bddb3d9ed264f3984702f048c7e5340","5bddb3d9ed264f3984702f048c7e5340",22855438,4,0,1,1947,197,197,0
"5bddb3d9ed264f3984702f048c7e5340","d5e8e2bd12a2466b9d6d90855f0eb079",22855438,2,1,0,1949,197,198,1
"d5e8e2bd12a2466b9d6d90855f0eb079","d5e8e2bd12a2466b9d6d90855f0eb079",22855438,4,0,1,1950,198,198,0
"d5e8e2bd12a2466b9d6d90855f0eb079","f902b0f41b544d4dbf79664fd233648d",22855438,1,-72,0,1952,198,146,-52
"f902b0f41b544d4dbf79664fd233648d","df1de691dafe4549a18a4398ee9dfaf9",22855438,1,-8,0,1953,146,139,-7
"df1de691dafe4549a18a4398ee9dfaf9","8aae34f5ddbb4052a709b12e6b0d40fa",22855438,3,9,0,1954,139,147,8
"8aae34f5ddbb4052a709b12e6b0d40fa","645b3f0249f64f76af2e19eb4d0e55b7",22855438,2,2,0,1955,147,149,2
"f902b0f41b544d4dbf79664fd233648d","f03480cf4eba413194d7af52fc0e7f28",22855438,1,7,0,1959,146,152,6
"f03480cf4eba413194d7af52fc0e7f28","8aae34f5ddbb4052a709b12e6b0d40fa",22855438,1,-6,0,1960,152,147,-5
"8aae34f5ddbb4052a709b12e6b0d40fa","d6d02b6ef04e4f17805504500b8ce441",22855438,1,309,0,1961,147,375,228
"d6d02b6ef04e4f17805504500b8ce441","4a29443515bb404cb8924e1c60a63b73",22855438,1,-118,0,1965,375,285,-90
"4a29443515bb404cb8924e1c60a63b73","4a29443515bb404cb8924e1c60a63b73",22855438,5,0,1,1966,285,285,0
"21592f2a9e9c4b2f8c66ec5dbcbf6a2b","0e0b36e731a645e7b1b8a88f5031ca38",22855438,1,6,0,1980,296,301,5
"e390b575229748ea8aac9364efe2bf00","4a29443515bb404cb8924e1c60a63b73",22855438,1,-24,0,1989,304,285,-19
"4a29443515bb404cb8924e1c60a63b73","3434c10e561d488a914e0f7d71907abd",22855438,1,27,0,1990,285,305,20
"3434c10e561d488a914e0f7d71907abd","53e7e900392747ccad52e711ab0f80d8",22855438,1,2,0,1991,305,307,2
"53e7e900392747ccad52e711ab0f80d8","4a29443515bb404cb8924e1c60a63b73",22855438,1,-29,0,1992,307,285,-22
"6a9a3b5bde4a48daa896fe8c06eca56f","4a29443515bb404cb8924e1c60a63b73",22855438,1,-5,0,2003,289,285,-4
"208c9b2796c944db8dacaa96082520ea","208c9b2796c944db8dacaa96082520ea",22855438,2,0,1,2009,288,288,0
"208c9b2796c944db8dacaa96082520ea","df1de691dafe4549a18a4398ee9dfaf9",22855438,1,-203,0,2012,288,139,-149
"8aae34f5ddbb4052a709b12e6b0d40fa","139b097acfca451689d80c9c6eebdf7b",22855438,1,45,0,2014,147,178,31
"b87c552dd247427abe6ab5795b9c9d43","ea38cc0e6e6e41edbabf210220808bf9",22855438,2,-2,0,2018,181,179,-2
"ea38cc0e6e6e41edbabf210220808bf9","139b097acfca451689d80c9c6eebdf7b",22855438,1,-1,0,2019,179,178,-1
"139b097acfca451689d80c9c6eebdf7b","30f660a1feb34582a739722532524f79",22855438,2,6,0,2020,178,183,5
"30f660a1feb34582a739722532524f79","2024b4885bd14338a39b7b509acbbd02",22855438,3,-1,0,2021,183,182,-1
"2024b4885bd14338a39b7b509acbbd02","0c7262dff33c4087bc660ccf40f92f9c",22855438,2,-16,0,2022,182,169,-13
"0c7262dff33c4087bc660ccf40f92f9c","c8e371568a0c4391b25796ae4e91952e",22855438,2,23,0,2023,169,186,17
"c8e371568a0c4391b25796ae4e91952e","be95c065e45447c1bd8215ea6f130c7a",22855438,1,43,0,2024,186,219,33
"be95c065e45447c1bd8215ea6f130c7a","d7f13c8d63ec4e2aa673fbb9cf9c6933",22855438,1,-17,0,2025,219,206,-13
"d7f13c8d63ec4e2aa673fbb9cf9c6933","91125ca626c5470eb145501f8c37f8db",22855438,1,18,0,2026,206,220,14
"91125ca626c5470eb145501f8c37f8db","91125ca626c5470eb145501f8c37f8db",22855438,1,0,1,2027,220,220,0
"91125ca626c5470eb145501f8c37f8db","1c6721b1f63f4d30ba7746ea8af02a52",22855438,1,3,0,2028,220,221,1
"1c6721b1f63f4d30ba7746ea8af02a52","d7f13c8d63ec4e2aa673fbb9cf9c6933",22855438,1,-21,0,2029,221,206,-15
"d7f13c8d63ec4e2aa673fbb9cf9c6933","77ecef8eff6b4a2caea7707669bf7475",22855438,1,22,0,2030,206,222,16
"77ecef8eff6b4a2caea7707669bf7475","2024b4885bd14338a39b7b509acbbd02",22855438,1,-55,0,2031,222,182,-40
"0c7262dff33c4087bc660ccf40f92f9c","30f660a1feb34582a739722532524f79",22855438,1,17,0,2033,169,183,14
"2024b4885bd14338a39b7b509acbbd02","4a29443515bb404cb8924e1c60a63b73",22855438,1,141,0,2035,182,285,103
"4a29443515bb404cb8924e1c60a63b73","d6d02b6ef04e4f17805504500b8ce441",22855438,1,118,0,2040,285,375,90
"d6d02b6ef04e4f17805504500b8ce441","83d42d95cd844fc093fc09cee250edb8",22855438,1,139,0,2044,375,465,90
"83d42d95cd844fc093fc09cee250edb8","901e92500aea43c79f19f1b279050668",22855438,1,-36,0,2049,465,442,-23
"901e92500aea43c79f19f1b279050668","070600601c4c439288445d2f0724807d",22855438,1,-8,0,2050,442,437,-5
"070600601c4c439288445d2f0724807d","901e92500aea43c79f19f1b279050668",22855438,1,8,0,2051,437,442,5
"452745e0366e42ae81561bfddebcc6c3","4660ff2089114e8db82ceb26a4f329e3",22855438,1,2,0,2054,444,445,1
"4660ff2089114e8db82ceb26a4f329e3","2add1669f08d4101913db15f8c23b3b7",22855438,1,-47,0,2061,445,416,-29
"2add1669f08d4101913db15f8c23b3b7","2b09a08242b54983aec7063990fb3f66",22855438,2,-24,0,2062,416,400,-16
"2b09a08242b54983aec7063990fb3f66","2add1669f08d4101913db15f8c23b3b7",22855438,1,24,0,2063,400,416,16
"2add1669f08d4101913db15f8c23b3b7","2add1669f08d4101913db15f8c23b3b7",22855438,1,0,1,2064,416,416,0
"a2b4bd40cee2481ebd3fc179d6a5cd62","2b09a08242b54983aec7063990fb3f66",22855438,1,-27,0,2067,417,400,-17
"58fc9094275e4c49be3f4ba6d4acc0a4","58fc9094275e4c49be3f4ba6d4acc0a4",22855438,2,0,1,2069,406,406,0
"58fc9094275e4c49be3f4ba6d4acc0a4","d6d02b6ef04e4f17805504500b8ce441",22855438,1,-45,0,2089,406,375,-31
"d6d02b6ef04e4f17805504500b8ce441","c5df9f40ec14463b9dcfdc73df3e9285",22855438,1,136,0,2093,375,464,89
"83d42d95cd844fc093fc09cee250edb8","6e83e23f56544a19b94067c1c558d9c0",22855438,1,-311,0,2110,465,247,-218
"6e83e23f56544a19b94067c1c558d9c0","2ae94c0cea4d480a9d5dca8fb1d7b542",22855438,1,-6,0,2111,247,242,-5
"2ae94c0cea4d480a9d5dca8fb1d7b542","30c9ba177afc49a695625d2bdec40207",22855438,1,9,0,2112,242,250,8
"30c9ba177afc49a695625d2bdec40207","30c9ba177afc49a695625d2bdec40207",22855438,2,0,1,2113,250,250,0
"30c9ba177afc49a695625d2bdec40207","6e83e23f56544a19b94067c1c558d9c0",22855438,1,-3,0,2115,250,247,-3
"6e83e23f56544a19b94067c1c558d9c0","00f61990949545828dd12f1303d47504",22855438,2,11,0,2116,247,256,9
"00f61990949545828dd12f1303d47504","66baf19b6b904b70922329068c63746d",22855438,1,165,0,2117,256,376,120
"66baf19b6b904b70922329068c63746d","18d3b836dd804224883cc9180b60a8e1",22855438,1,13,0,2118,376,387,11
"18d3b836dd804224883cc9180b60a8e1","4890121ce5d74576b4632b77cfc23398",22855438,1,1,0,2119,387,388,1
"4890121ce5d74576b4632b77cfc23398","4890121ce5d74576b4632b77cfc23398",22855438,1,0,1,2120,388,388,0
"96bb2b3e85a34d8b9544514e89f6fe97","6f8881a745ac4c358a68b92c3b4abe81",22855438,1,5,0,2124,390,394,4
"6f8881a745ac4c358a68b92c3b4abe81","17f95d18bab743888e1736033dc3384d",22855438,1,-6,0,2125,394,389,-5
"17f95d18bab743888e1736033dc3384d","f7002c8484354eceac57bc7bd62c76c1",22855438,1,5,0,2126,389,393,4
"0c12af0a4e7f4002852cf84b2537c161","66baf19b6b904b70922329068c63746d",22855438,2,-24,0,2130,395,376,-19
"66baf19b6b904b70922329068c63746d","0c12af0a4e7f4002852cf84b2537c161",22855438,1,24,0,2131,376,395,19
"0c12af0a4e7f4002852cf84b2537c161","44a277ea44dc4ae689fab4b82f0b4098",22855438,1,2,0,2132,395,397,2
"1157bd665ec4472fb58b751dc5099355","c5df9f40ec14463b9dcfdc73df3e9285",22855438,1,96,0,2143,403,464,61
"83d42d95cd844fc093fc09cee250edb8","2b09a08242b54983aec7063990fb3f66",22855438,1,-103,0,2149,465,400,-65
"2b09a08242b54983aec7063990fb3f66","0c4079457ede49e3aeb5e86ed84bdf35",22855438,1,-96,0,2150,400,329,-71
"0c4079457ede49e3aeb5e86ed84bdf35","0c4079457ede49e3aeb5e86ed84bdf35",22855438,1,0,1,2151,329,329,0
"0c4079457ede49e3aeb5e86ed84bdf35","38aea304b4fa46e1b29bb72f5cea4c93",22855438,1,2,0,2152,329,331,2
"fe49f8054b374a0ea4bb266ed135ff62","0c4079457ede49e3aeb5e86ed84bdf35",22855438,2,-6,0,2161,335,329,-6
"0c4079457ede49e3aeb5e86ed84bdf35","b8b9418ab322418d9db9b40d96af873a",22855438,1,9,0,2162,329,337,8
"b8b9418ab322418d9db9b40d96af873a","38aea304b4fa46e1b29bb72f5cea4c93",22855438,1,-7,0,2163,337,331,-6
"38aea304b4fa46e1b29bb72f5cea4c93","c7e89b9d04744d2eab742fc24e3ef1ae",22855438,1,3,0,2165,331,334,3
"0c4079457ede49e3aeb5e86ed84bdf35","e20db35ced8544ddac5bc3839145e463",22855438,1,-317,0,2172,329,91,-238
"b613861cecf84ffcab01afb23f660475","b613861cecf84ffcab01afb23f660475",22855491,4,0,1,1,1,1,0
"b613861cecf84ffcab01afb23f660475","e2911e79efc2420eac45d9f671463d4b",22855491,1,3,0,5,1,2,1
"e2911e79efc2420eac45d9f671463d4b","e2911e79efc2420eac45d9f671463d4b",22855491,2,0,1,6,2,2,0
"e2911e79efc2420eac45d9f671463d4b","519d1b8c59404d67b54e96c5c8a830b2",22855491,1,1,0,8,2,3,1
"519d1b8c59404d67b54e96c5c8a830b2","519d1b8c59404d67b54e96c5c8a830b2",22855491,1,0,1,9,3,3,0
"519d1b8c59404d67b54e96c5c8a830b2","531db53f81f646edb0cdcfe0085b03b7",22855491,1,1,0,10,3,4,1
"531db53f81f646edb0cdcfe0085b03b7","531db53f81f646edb0cdcfe0085b03b7",22855491,1,0,1,11,4,4,0
"531db53f81f646edb0cdcfe0085b03b7","4f5f94b2f95141e0a9d53a61da2276da",22855491,1,1,0,12,4,5,1
"4f5f94b2f95141e0a9d53a61da2276da","4f5f94b2f95141e0a9d53a61da2276da",22855491,1,0,1,13,5,5,0
"4f5f94b2f95141e0a9d53a61da2276da","6d541c89590949f99af293c4f2333f67",22855491,1,1,0,14,5,6,1
"6d541c89590949f99af293c4f2333f67","6d541c89590949f99af293c4f2333f67",22855491,1,0,1,15,6,6,0
"6d541c89590949f99af293c4f2333f67","dd5cf0b9fe4c4f1d8f5ff8e4c04879cb",22855491,1,1,0,16,6,7,1
"dd5cf0b9fe4c4f1d8f5ff8e4c04879cb","dd5cf0b9fe4c4f1d8f5ff8e4c04879cb",22855491,1,0,1,17,7,7,0
"dd5cf0b9fe4c4f1d8f5ff8e4c04879cb","f96261861edc426abe2248be4f0a709a",22855491,1,1,0,18,7,8,1
"f96261861edc426abe2248be4f0a709a","f96261861edc426abe2248be4f0a709a",22855491,1,0,1,19,8,8,0
"f96261861edc426abe2248be4f0a709a","66b5e16f4f75454fb5b8172079f0fa83",22855491,1,1,0,20,8,9,1
"66b5e16f4f75454fb5b8172079f0fa83","66b5e16f4f75454fb5b8172079f0fa83",22855491,4,0,1,21,9,9,0
"66b5e16f4f75454fb5b8172079f0fa83","0680571d4698477995e41842c36a54b2",22855491,1,1,0,25,9,10,1
"0680571d4698477995e41842c36a54b2","0680571d4698477995e41842c36a54b2",22855491,1,0,1,26,10,10,0
"0680571d4698477995e41842c36a54b2","9112f2bffece48e08c6d2287be204085",22855491,1,1,0,27,10,11,1
"9112f2bffece48e08c6d2287be204085","9112f2bffece48e08c6d2287be204085",22855491,1,0,1,28,11,11,0
"9112f2bffece48e08c6d2287be204085","e2911e79efc2420eac45d9f671463d4b",22855491,1,-9,0,29,11,2,-9
"e2911e79efc2420eac45d9f671463d4b","56586aa865414f538729c7f7735d2bc6",22855491,1,12,0,30,2,12,10
"56586aa865414f538729c7f7735d2bc6","56586aa865414f538729c7f7735d2bc6",22855491,10,0,1,31,12,12,0
"56586aa865414f538729c7f7735d2bc6","b613861cecf84ffcab01afb23f660475",22855491,1,-15,0,32,12,1,-11
"b613861cecf84ffcab01afb23f660475","56586aa865414f538729c7f7735d2bc6",22855491,1,15,0,33,1,12,11
"56586aa865414f538729c7f7735d2bc6","b7f2b31585d94eb3bf86376714aa7070",22855491,4,2,0,37,12,13,1
"b7f2b31585d94eb3bf86376714aa7070","b7f2b31585d94eb3bf86376714aa7070",22855491,4,0,1,38,13,13,0
"b7f2b31585d94eb3bf86376714aa7070","3f1c815879794b929260d224becaff7e",22855491,1,2,0,39,13,14,1
"3f1c815879794b929260d224becaff7e","81c864a886d54a6b8ff85f7d736f4f95",22855491,1,2,0,40,14,15,1
"81c864a886d54a6b8ff85f7d736f4f95","5c5ceeee4562457ba6d41515aeebfbb1",22855491,1,4,0,41,15,17,2
"5c5ceeee4562457ba6d41515aeebfbb1","9afd71a5298d4333b6849dfce1b9422c",22855491,1,3,0,42,17,18,1
"9afd71a5298d4333b6849dfce1b9422c","56586aa865414f538729c7f7735d2bc6",22855491,1,-13,0,43,18,12,-6
"56586aa865414f538729c7f7735d2bc6","b7719e26494940efa49512aedd0aac79",22855491,1,17,0,44,12,20,8
"b7719e26494940efa49512aedd0aac79","9afd71a5298d4333b6849dfce1b9422c",22855491,2,-4,0,45,20,18,-2
"9afd71a5298d4333b6849dfce1b9422c","d4f45188d3c84a02ba08454e6403a818",22855491,2,9,0,46,18,24,6
"d4f45188d3c84a02ba08454e6403a818","d4c3b003e8274e429d2fa688d73fde6d",22855491,3,-2,0,47,24,22,-2
"d4c3b003e8274e429d2fa688d73fde6d","56586aa865414f538729c7f7735d2bc6",22855491,1,-20,0,48,22,12,-10
"b7f2b31585d94eb3bf86376714aa7070","56586aa865414f538729c7f7735d2bc6",22855491,2,-2,0,52,13,12,-1
"56586aa865414f538729c7f7735d2bc6","3f1c815879794b929260d224becaff7e",22855491,1,4,0,55,12,14,2
"3f1c815879794b929260d224becaff7e","56586aa865414f538729c7f7735d2bc6",22855491,1,-4,0,56,14,12,-2
"b7f2b31585d94eb3bf86376714aa7070","5c5ceeee4562457ba6d41515aeebfbb1",22855491,1,8,0,65,13,17,4
"5c5ceeee4562457ba6d41515aeebfbb1","3f1c815879794b929260d224becaff7e",22855491,1,-6,0,66,17,14,-3
"3f1c815879794b929260d224becaff7e","5c5ceeee4562457ba6d41515aeebfbb1",22855491,1,6,0,67,14,17,3
"5c5ceeee4562457ba6d41515aeebfbb1","56586aa865414f538729c7f7735d2bc6",22855491,1,-10,0,68,17,12,-5
"56586aa865414f538729c7f7735d2bc6","9afd71a5298d4333b6849dfce1b9422c",22855491,1,13,0,69,12,18,6
"9afd71a5298d4333b6849dfce1b9422c","b7719e26494940efa49512aedd0aac79",22855491,1,4,0,70,18,20,2
"d4c3b003e8274e429d2fa688d73fde6d","d4c3b003e8274e429d2fa688d73fde6d",22855491,2,0,1,74,22,22,0
"d4c3b003e8274e429d2fa688d73fde6d","5bc03c8f16354d04bd51f5bb93559ad3",22855491,1,4,0,75,22,26,4
"5bc03c8f16354d04bd51f5bb93559ad3","b7719e26494940efa49512aedd0aac79",22855491,1,-7,0,76,26,20,-6
"b7719e26494940efa49512aedd0aac79","a49d1bb4328949299686242fd0be5584",22855491,1,2,0,77,20,21,1
"a49d1bb4328949299686242fd0be5584","d4c3b003e8274e429d2fa688d73fde6d",22855491,1,1,0,78,21,22,1
"d4c3b003e8274e429d2fa688d73fde6d","d4f45188d3c84a02ba08454e6403a818",22855491,1,2,0,79,22,24,2
"d4c3b003e8274e429d2fa688d73fde6d","b7719e26494940efa49512aedd0aac79",22855491,1,-3,0,82,22,20,-2
"b7719e26494940efa49512aedd0aac79","b7719e26494940efa49512aedd0aac79",22855491,1,0,1,83,20,20,0
"b7719e26494940efa49512aedd0aac79","afbf7250b99d47bea07172749483ca97",22855491,1,12,0,84,20,28,8
"afbf7250b99d47bea07172749483ca97","4e51676dc72045d99c19b9fa7b22f8bc",22855491,2,3,0,85,28,29,1
"4e51676dc72045d99c19b9fa7b22f8bc","afbf7250b99d47bea07172749483ca97",22855491,1,-3,0,86,29,28,-1
"4e51676dc72045d99c19b9fa7b22f8bc","51970cfa30e643e894e66ae85c8024cc",22855491,1,3,0,88,29,31,2
"51970cfa30e643e894e66ae85c8024cc","c33c17be71ae4d588da7369472e5bb1b",22855491,1,6,0,89,31,34,3
"c33c17be71ae4d588da7369472e5bb1b","4e51676dc72045d99c19b9fa7b22f8bc",22855491,1,-9,0,90,34,29,-5
"4e51676dc72045d99c19b9fa7b22f8bc","c33c17be71ae4d588da7369472e5bb1b",22855491,1,9,0,91,29,34,5
"c33c17be71ae4d588da7369472e5bb1b","93679be414554a11b1893002f2229a93",22855491,1,3,0,92,34,35,1
"93679be414554a11b1893002f2229a93","7040a13096d746ac84b8fac8d9752058",22855491,2,3,0,93,35,36,1
"7040a13096d746ac84b8fac8d9752058","93679be414554a11b1893002f2229a93",22855491,1,-3,0,94,36,35,-1
"7040a13096d746ac84b8fac8d9752058","9a0dc646f934470daf08c4b56ccf73db",22855491,1,3,0,96,36,37,1
"9a0dc646f934470daf08c4b56ccf73db","fc0e049d56024bc9a02c9a9c435c3df7",22855491,2,3,0,97,37,38,1
"fc0e049d56024bc9a02c9a9c435c3df7","9a0dc646f934470daf08c4b56ccf73db",22855491,1,-3,0,98,38,37,-1
"fc0e049d56024bc9a02c9a9c435c3df7","67a089198fcb4e1c8f2385786c2b296f",22855491,1,4,0,100,38,39,1
"67a089198fcb4e1c8f2385786c2b296f","64d48c6c9c7940639a932219a6c87198",22855491,2,1,0,101,39,40,1
"64d48c6c9c7940639a932219a6c87198","64d48c6c9c7940639a932219a6c87198",22855491,5,0,1,102,40,40,0
"64d48c6c9c7940639a932219a6c87198","b534b89233134e30a9b5645138bfa9ee",22855491,1,3,0,106,40,41,1
"b534b89233134e30a9b5645138bfa9ee","67a089198fcb4e1c8f2385786c2b296f",22855491,1,-4,0,107,41,39,-2
"67a089198fcb4e1c8f2385786c2b296f","0e37b720d23b4e7f8b313e79313fd107",22855491,1,7,0,108,39,44,5
"0e37b720d23b4e7f8b313e79313fd107","0e37b720d23b4e7f8b313e79313fd107",22855491,3,0,1,109,44,44,0
"0e37b720d23b4e7f8b313e79313fd107","6875d67fdd5f48168b62719df449bebd",22855491,1,1,0,112,44,45,1
"6875d67fdd5f48168b62719df449bebd","6875d67fdd5f48168b62719df449bebd",22855491,1,0,1,113,45,45,0
"6875d67fdd5f48168b62719df449bebd","b534b89233134e30a9b5645138bfa9ee",22855491,1,-4,0,114,45,41,-4
"b534b89233134e30a9b5645138bfa9ee","6e13d61a7bdb44bca949c9f86fab3be5",22855491,3,7,0,115,41,47,6
"6e13d61a7bdb44bca949c9f86fab3be5","6e13d61a7bdb44bca949c9f86fab3be5",22855491,6,0,1,116,47,47,0
"6e13d61a7bdb44bca949c9f86fab3be5","195f78799f984cc2b06c48dfe36be751",22855491,1,2,0,118,47,49,2
"195f78799f984cc2b06c48dfe36be751","195f78799f984cc2b06c48dfe36be751",22855491,5,0,1,119,49,49,0
"195f78799f984cc2b06c48dfe36be751","d9c8d8c444a64dadbbb508652c721e17",22855491,1,-3,0,124,49,46,-3
"d9c8d8c444a64dadbbb508652c721e17","d0c74f735e024943943e40333d6d337f",22855491,3,6,0,125,46,51,5
"d0c74f735e024943943e40333d6d337f","d0c74f735e024943943e40333d6d337f",22855491,2,0,1,126,51,51,0
"d0c74f735e024943943e40333d6d337f","983f8ff320594b279a7f4a6fe132f9c5",22855491,1,2,0,128,51,53,2
"983f8ff320594b279a7f4a6fe132f9c5","983f8ff320594b279a7f4a6fe132f9c5",22855491,2,0,1,129,53,53,0
"983f8ff320594b279a7f4a6fe132f9c5","35adfa5d923046aebabfefd98f35ff05",22855491,1,1,0,131,53,54,1
"35adfa5d923046aebabfefd98f35ff05","35adfa5d923046aebabfefd98f35ff05",22855491,5,0,1,132,54,54,0
"35adfa5d923046aebabfefd98f35ff05","b6f8a98476224da1b40e555ececc7ed8",22855491,1,1,0,137,54,55,1
"b6f8a98476224da1b40e555ececc7ed8","b6f8a98476224da1b40e555ececc7ed8",22855491,8,0,1,138,55,55,0
"b6f8a98476224da1b40e555ececc7ed8","86e22cb5fe0e4b47a9489ecddf7ed78f",22855491,1,1,0,146,55,56,1
"86e22cb5fe0e4b47a9489ecddf7ed78f","86e22cb5fe0e4b47a9489ecddf7ed78f",22855491,2,0,1,147,56,56,0
"86e22cb5fe0e4b47a9489ecddf7ed78f","f924752d8a1149668870b1e7698486f7",22855491,1,-6,0,149,56,50,-6
"f924752d8a1149668870b1e7698486f7","78f30e4dcac84e3cbea8b2cc6e0d62b3",22855491,1,10,0,150,50,59,9
"78f30e4dcac84e3cbea8b2cc6e0d62b3","a1f2f12debe5432fb7a70bcd12bacfb9",22855491,3,-1,0,151,59,58,-1
"a1f2f12debe5432fb7a70bcd12bacfb9","6e13d61a7bdb44bca949c9f86fab3be5",22855491,1,-13,0,152,58,47,-11
"6e13d61a7bdb44bca949c9f86fab3be5","12aa6e1672ac4e7aa6449a7a8609cd72",22855491,1,12,0,153,47,57,10
"12aa6e1672ac4e7aa6449a7a8609cd72","6e13d61a7bdb44bca949c9f86fab3be5",22855491,1,-12,0,154,57,47,-10
"6e13d61a7bdb44bca949c9f86fab3be5","d0c74f735e024943943e40333d6d337f",22855491,2,5,0,156,47,51,4
"d0c74f735e024943943e40333d6d337f","d9c8d8c444a64dadbbb508652c721e17",22855491,2,-6,0,157,51,46,-5
"d9c8d8c444a64dadbbb508652c721e17","6e13d61a7bdb44bca949c9f86fab3be5",22855491,1,1,0,158,46,47,1
"6e13d61a7bdb44bca949c9f86fab3be5","f924752d8a1149668870b1e7698486f7",22855491,1,4,0,159,47,50,3
"f924752d8a1149668870b1e7698486f7","6e13d61a7bdb44bca949c9f86fab3be5",22855491,1,-4,0,160,50,47,-3
"d9c8d8c444a64dadbbb508652c721e17","f924752d8a1149668870b1e7698486f7",22855491,1,5,0,163,46,50,4
"f924752d8a1149668870b1e7698486f7","a1f2f12debe5432fb7a70bcd12bacfb9",22855491,2,9,0,164,50,58,8
"a1f2f12debe5432fb7a70bcd12bacfb9","78f30e4dcac84e3cbea8b2cc6e0d62b3",22855491,3,1,0,165,58,59,1
"a1f2f12debe5432fb7a70bcd12bacfb9","b534b89233134e30a9b5645138bfa9ee",22855491,1,-20,0,167,58,41,-17
"b534b89233134e30a9b5645138bfa9ee","d0c74f735e024943943e40333d6d337f",22855491,1,12,0,168,41,51,10
"d0c74f735e024943943e40333d6d337f","67a089198fcb4e1c8f2385786c2b296f",22855491,2,-16,0,169,51,39,-12
"67a089198fcb4e1c8f2385786c2b296f","3cbcea2be0984e7dbd5a48195af10ce7",22855491,1,160,0,170,39,165,126
"3cbcea2be0984e7dbd5a48195af10ce7","3cbcea2be0984e7dbd5a48195af10ce7",22855491,1,0,1,171,165,165,0
"3cbcea2be0984e7dbd5a48195af10ce7","82e6285962b8400d9d6fc32436022a94",22855491,3,2,0,172,165,167,2
"82e6285962b8400d9d6fc32436022a94","67a089198fcb4e1c8f2385786c2b296f",22855491,2,-162,0,173,167,39,-128
"67a089198fcb4e1c8f2385786c2b296f","d9c8d8c444a64dadbbb508652c721e17",22855491,1,10,0,174,39,46,7
"d9c8d8c444a64dadbbb508652c721e17","b534b89233134e30a9b5645138bfa9ee",22855491,1,-6,0,175,46,41,-5
"6e13d61a7bdb44bca949c9f86fab3be5","d9c8d8c444a64dadbbb508652c721e17",22855491,2,-1,0,179,47,46,-1
"d0c74f735e024943943e40333d6d337f","f924752d8a1149668870b1e7698486f7",22855491,1,-1,0,181,51,50,-1
"a1f2f12debe5432fb7a70bcd12bacfb9","a1f2f12debe5432fb7a70bcd12bacfb9",22855491,19,0,1,185,58,58,0
"78f30e4dcac84e3cbea8b2cc6e0d62b3","78f30e4dcac84e3cbea8b2cc6e0d62b3",22855491,11,0,1,205,59,59,0
"78f30e4dcac84e3cbea8b2cc6e0d62b3","a0a418b8540d479fa6e0f653b701da8b",22855491,1,6,0,216,59,64,5
"a0a418b8540d479fa6e0f653b701da8b","12aa6e1672ac4e7aa6449a7a8609cd72",22855491,1,-8,0,217,64,57,-7
"12aa6e1672ac4e7aa6449a7a8609cd72","bc42d26810654ea9a1df1efe1e58c7d5",22855491,1,7,0,218,57,63,6
"bc42d26810654ea9a1df1efe1e58c7d5","4c943503763e4e349906eea3ed3c8e86",22855491,1,-2,0,219,63,61,-2
"4c943503763e4e349906eea3ed3c8e86","4c943503763e4e349906eea3ed3c8e86",22855491,1,0,1,220,61,61,0
"4c943503763e4e349906eea3ed3c8e86","bc42d26810654ea9a1df1efe1e58c7d5",22855491,1,2,0,221,61,63,2
"bc42d26810654ea9a1df1efe1e58c7d5","bc42d26810654ea9a1df1efe1e58c7d5",22855491,3,0,1,222,63,63,0
"bc42d26810654ea9a1df1efe1e58c7d5","a0a418b8540d479fa6e0f653b701da8b",22855491,1,1,0,225,63,64,1
"a0a418b8540d479fa6e0f653b701da8b","a0a418b8540d479fa6e0f653b701da8b",22855491,3,0,1,226,64,64,0
"a0a418b8540d479fa6e0f653b701da8b","309ccf3cc4fe429d9bfbaef53d3fa479",22855491,1,-4,0,229,64,60,-4
"309ccf3cc4fe429d9bfbaef53d3fa479","d646286c8051419bbc2e31dd1db55ca8",22855491,1,10,0,230,60,67,7
"d646286c8051419bbc2e31dd1db55ca8","b534b89233134e30a9b5645138bfa9ee",22855491,1,-33,0,231,67,41,-26
"b534b89233134e30a9b5645138bfa9ee","267f883678b24aed855fde42524975d9",22855491,1,37,0,232,41,71,30
"267f883678b24aed855fde42524975d9","267f883678b24aed855fde42524975d9",22855491,1,0,1,233,71,71,0
"267f883678b24aed855fde42524975d9","88fff56d0342490dbef9040750a20f6c",22855491,1,1,0,234,71,72,1
"88fff56d0342490dbef9040750a20f6c","88fff56d0342490dbef9040750a20f6c",22855491,1,0,1,235,72,72,0
"88fff56d0342490dbef9040750a20f6c","adb17b12b66c4a49a85fd34322f7df70",22855491,1,1,0,236,72,73,1
"adb17b12b66c4a49a85fd34322f7df70","adb17b12b66c4a49a85fd34322f7df70",22855491,1,0,1,237,73,73,0
"adb17b12b66c4a49a85fd34322f7df70","d646286c8051419bbc2e31dd1db55ca8",22855491,1,-6,0,238,73,67,-6
"d646286c8051419bbc2e31dd1db55ca8","a2becd407db34b189200a32546d9d569",22855491,1,9,0,239,67,75,8
"a2becd407db34b189200a32546d9d569","58c22b011d0f4c2ea6d13615edbb9eeb",22855491,1,2,0,240,75,77,2
"58c22b011d0f4c2ea6d13615edbb9eeb","58c22b011d0f4c2ea6d13615edbb9eeb",22855491,2,0,1,241,77,77,0
"58c22b011d0f4c2ea6d13615edbb9eeb","dd76e1861dc9461c830888729d091ee0",22855491,1,1,0,243,77,78,1
"dd76e1861dc9461c830888729d091ee0","dd76e1861dc9461c830888729d091ee0",22855491,5,0,1,244,78,78,0
"dd76e1861dc9461c830888729d091ee0","cd1d828f1a694b87913a7ea66c23803e",22855491,1,1,0,249,78,79,1
"cd1d828f1a694b87913a7ea66c23803e","cd1d828f1a694b87913a7ea66c23803e",22855491,2,0,1,250,79,79,0
"cd1d828f1a694b87913a7ea66c23803e","9176a3c2b4d2465fa8b0c67096c2a97e",22855491,1,1,0,252,79,80,1
"9176a3c2b4d2465fa8b0c67096c2a97e","9176a3c2b4d2465fa8b0c67096c2a97e",22855491,5,0,1,253,80,80,0
"9176a3c2b4d2465fa8b0c67096c2a97e","f8ec6445f7194e25b9101d4fbcb07a18",22855491,1,1,0,258,80,81,1
"f8ec6445f7194e25b9101d4fbcb07a18","f8ec6445f7194e25b9101d4fbcb07a18",22855491,2,0,1,259,81,81,0
"f8ec6445f7194e25b9101d4fbcb07a18","140d5b27b8574befad82c0a013b59dfa",22855491,1,-7,0,261,81,74,-7
"140d5b27b8574befad82c0a013b59dfa","d18a9ea32855445f8736581f5cb119ce",22855491,1,9,0,262,74,82,8
"d18a9ea32855445f8736581f5cb119ce","f564483cbd7a407681aa2fcca518cf5f",22855491,1,4,0,263,82,85,3
"f564483cbd7a407681aa2fcca518cf5f","f564483cbd7a407681aa2fcca518cf5f",22855491,1,0,1,264,85,85,0
"f564483cbd7a407681aa2fcca518cf5f","18fd01350bd5434ca636d59a599d768a",22855491,1,1,0,265,85,86,1
"18fd01350bd5434ca636d59a599d768a","18fd01350bd5434ca636d59a599d768a",22855491,9,0,1,266,86,86,0
"18fd01350bd5434ca636d59a599d768a","ae5ac430ea254e708a6f5deaaf7464ae",22855491,1,-2,0,275,86,84,-2
"ae5ac430ea254e708a6f5deaaf7464ae","6a9f0ef185fb47f0937e29daa1c71ed5",22855491,1,7,0,276,84,90,6
"6a9f0ef185fb47f0937e29daa1c71ed5","c681290961c94c4caf23b529d1ae6b9a",22855491,1,-2,0,277,90,88,-2
"c681290961c94c4caf23b529d1ae6b9a","c681290961c94c4caf23b529d1ae6b9a",22855491,1,0,1,278,88,88,0
"c681290961c94c4caf23b529d1ae6b9a","6a9f0ef185fb47f0937e29daa1c71ed5",22855491,1,2,0,279,88,90,2
"6a9f0ef185fb47f0937e29daa1c71ed5","6a9f0ef185fb47f0937e29daa1c71ed5",22855491,3,0,1,280,90,90,0
"6a9f0ef185fb47f0937e29daa1c71ed5","d646286c8051419bbc2e31dd1db55ca8",22855491,1,-27,0,283,90,67,-23
"d646286c8051419bbc2e31dd1db55ca8","e20db35ced8544ddac5bc3839145e463",22855491,1,30,0,284,67,91,24
"e20db35ced8544ddac5bc3839145e463","67a089198fcb4e1c8f2385786c2b296f",22855491,1,-67,0,285,91,39,-52
"67a089198fcb4e1c8f2385786c2b296f","e20db35ced8544ddac5bc3839145e463",22855491,1,67,0,286,39,91,52
"e20db35ced8544ddac5bc3839145e463","e20db35ced8544ddac5bc3839145e463",22855491,1,0,1,287,91,91,0
"e20db35ced8544ddac5bc3839145e463","1febb706d7a34005ae8711ed49c76e64",22855491,1,3,0,288,91,94,3
"1febb706d7a34005ae8711ed49c76e64","1febb706d7a34005ae8711ed49c76e64",22855491,2,0,1,289,94,94,0
"1febb706d7a34005ae8711ed49c76e64","8f73ba6f5a0042f2850356ac38ac6f24",22855491,1,1,0,291,94,95,1
"8f73ba6f5a0042f2850356ac38ac6f24","8f73ba6f5a0042f2850356ac38ac6f24",22855491,5,0,1,292,95,95,0
"8f73ba6f5a0042f2850356ac38ac6f24","e2260b86653c46d7b14a41fb419dbf8c",22855491,1,1,0,294,95,96,1
"e2260b86653c46d7b14a41fb419dbf8c","e2260b86653c46d7b14a41fb419dbf8c",22855491,2,0,1,295,96,96,0
"e2260b86653c46d7b14a41fb419dbf8c","8f73ba6f5a0042f2850356ac38ac6f24",22855491,1,-1,0,297,96,95,-1
"8f73ba6f5a0042f2850356ac38ac6f24","35eb641ad1d845bbba54915bce75a962",22855491,1,2,0,301,95,97,2
"35eb641ad1d845bbba54915bce75a962","35eb641ad1d845bbba54915bce75a962",22855491,5,0,1,302,97,97,0
"35eb641ad1d845bbba54915bce75a962","08be90ffbeea4795a138cd42ed8db56f",22855491,1,1,0,307,97,98,1
"08be90ffbeea4795a138cd42ed8db56f","08be90ffbeea4795a138cd42ed8db56f",22855491,5,0,1,308,98,98,0
"08be90ffbeea4795a138cd42ed8db56f","3007433c8f584dcbb5ac159c1c5f2be3",22855491,1,1,0,313,98,99,1
"3007433c8f584dcbb5ac159c1c5f2be3","3007433c8f584dcbb5ac159c1c5f2be3",22855491,5,0,1,314,99,99,0
"3007433c8f584dcbb5ac159c1c5f2be3","e20db35ced8544ddac5bc3839145e463",22855491,1,-8,0,319,99,91,-8
"e20db35ced8544ddac5bc3839145e463","00ae5f0c51874a73a41ebea838d95682",22855491,1,11,0,320,91,101,10
"00ae5f0c51874a73a41ebea838d95682","d391c8b6e56a43a7b654e9dee02d904b",22855491,1,2,0,321,101,103,2
"d391c8b6e56a43a7b654e9dee02d904b","d391c8b6e56a43a7b654e9dee02d904b",22855491,16,0,1,322,103,103,0
"d391c8b6e56a43a7b654e9dee02d904b","6111116566fc4fd9abba409322bea245",22855491,1,1,0,338,103,104,1
"6111116566fc4fd9abba409322bea245","6111116566fc4fd9abba409322bea245",22855491,2,0,1,339,104,104,0
"6111116566fc4fd9abba409322bea245","a81b2235cb9c499eb9ea8ee0a8dd9725",22855491,1,1,0,341,104,105,1
"a81b2235cb9c499eb9ea8ee0a8dd9725","a81b2235cb9c499eb9ea8ee0a8dd9725",22855491,2,0,1,342,105,105,0
"a81b2235cb9c499eb9ea8ee0a8dd9725","2d4e0ab0ef3b4d73b82c72d4621a7579",22855491,1,1,0,344,105,106,1
"2d4e0ab0ef3b4d73b82c72d4621a7579","2d4e0ab0ef3b4d73b82c72d4621a7579",22855491,2,0,1,345,106,106,0
"2d4e0ab0ef3b4d73b82c72d4621a7579","8bdebf492ebd4e62b0d522e8ab5e5197",22855491,1,1,0,347,106,107,1
"8bdebf492ebd4e62b0d522e8ab5e5197","8bdebf492ebd4e62b0d522e8ab5e5197",22855491,2,0,1,348,107,107,0
"8bdebf492ebd4e62b0d522e8ab5e5197","73039f8c1eb9409cb4caee2cf968001e",22855491,1,-7,0,350,107,100,-7
"73039f8c1eb9409cb4caee2cf968001e","4280927ec4d643238aa49c32f9e06c6c",22855491,1,10,0,351,100,109,9
"4280927ec4d643238aa49c32f9e06c6c","fc44e6a5f7654430af1227838224dceb",22855491,1,2,0,352,109,111,2
"fc44e6a5f7654430af1227838224dceb","fc44e6a5f7654430af1227838224dceb",22855491,5,0,1,353,111,111,0
"fc44e6a5f7654430af1227838224dceb","08111f75e22d409998cf8b85bd431f0a",22855491,1,-3,0,358,111,108,-3
"08111f75e22d409998cf8b85bd431f0a","a9ae0a3c070d455bb4369a8996313336",22855491,1,7,0,359,108,114,6
"a9ae0a3c070d455bb4369a8996313336","71cec822bcff4f30a20e75dc63ef7b65",22855491,1,2,0,360,114,116,2
"71cec822bcff4f30a20e75dc63ef7b65","71cec822bcff4f30a20e75dc63ef7b65",22855491,3,0,1,361,116,116,0
"71cec822bcff4f30a20e75dc63ef7b65","37319e88176d4aefa91d7a9980dbae91",22855491,1,-4,0,364,116,112,-4
"37319e88176d4aefa91d7a9980dbae91","62bff51286ef4f348717a3cf6fe2318f",22855491,1,9,0,365,112,120,8
"62bff51286ef4f348717a3cf6fe2318f","b1cd0e7dc3ad4a8eb91a4bfdbeb025b0",22855491,1,-2,0,366,120,118,-2
"b1cd0e7dc3ad4a8eb91a4bfdbeb025b0","b1cd0e7dc3ad4a8eb91a4bfdbeb025b0",22855491,1,0,1,367,118,118,0
"b1cd0e7dc3ad4a8eb91a4bfdbeb025b0","62bff51286ef4f348717a3cf6fe2318f",22855491,1,2,0,368,118,120,2
"62bff51286ef4f348717a3cf6fe2318f","62bff51286ef4f348717a3cf6fe2318f",22855491,3,0,1,369,120,120,0
"62bff51286ef4f348717a3cf6fe2318f","779f9ddd1fd14d1e9e69f72219a1fdbd",22855491,1,3,0,372,120,121,1
"779f9ddd1fd14d1e9e69f72219a1fdbd","e20db35ced8544ddac5bc3839145e463",22855491,1,-36,0,373,121,91,-30
"e20db35ced8544ddac5bc3839145e463","ae26e6cda8ad4a3f81bd347560d9579f",22855491,1,40,0,374,91,125,34
"ae26e6cda8ad4a3f81bd347560d9579f","ae26e6cda8ad4a3f81bd347560d9579f",22855491,3,0,1,375,125,125,0
"ae26e6cda8ad4a3f81bd347560d9579f","ee48df95832b4374aa273ceb27ec1315",22855491,1,1,0,378,125,126,1
"ee48df95832b4374aa273ceb27ec1315","ee48df95832b4374aa273ceb27ec1315",22855491,1,0,1,379,126,126,0
"ee48df95832b4374aa273ceb27ec1315","7a439da90b394756ad1777fc4c6dead5",22855491,1,1,0,380,126,127,1
"7a439da90b394756ad1777fc4c6dead5","7a439da90b394756ad1777fc4c6dead5",22855491,1,0,1,381,127,127,0
"7a439da90b394756ad1777fc4c6dead5","779f9ddd1fd14d1e9e69f72219a1fdbd",22855491,1,-6,0,382,127,121,-6
"779f9ddd1fd14d1e9e69f72219a1fdbd","a8dd5213034441ac92724b4e83eb0bb2",22855491,1,9,0,383,121,129,8
"a8dd5213034441ac92724b4e83eb0bb2","8115eab6556b45f5b415c3b8c26a12e5",22855491,1,2,0,384,129,131,2
"8115eab6556b45f5b415c3b8c26a12e5","8115eab6556b45f5b415c3b8c26a12e5",22855491,2,0,1,385,131,131,0
"8115eab6556b45f5b415c3b8c26a12e5","ec34b06efd844b46a4c4818ecdb9b8f4",22855491,1,1,0,387,131,132,1
"ec34b06efd844b46a4c4818ecdb9b8f4","ec34b06efd844b46a4c4818ecdb9b8f4",22855491,5,0,1,388,132,132,0
"ec34b06efd844b46a4c4818ecdb9b8f4","c2e1c2b9eac64109b343a088584b576b",22855491,1,1,0,393,132,133,1
"c2e1c2b9eac64109b343a088584b576b","c2e1c2b9eac64109b343a088584b576b",22855491,2,0,1,394,133,133,0
"c2e1c2b9eac64109b343a088584b576b","579338175e0b4bbb8ef3b712b5d8b54e",22855491,1,-5,0,396,133,128,-5
"579338175e0b4bbb8ef3b712b5d8b54e","8bc5795d6a984a3eace4e2811e52dd4f",22855491,1,8,0,397,128,135,7
"8bc5795d6a984a3eace4e2811e52dd4f","8bc5795d6a984a3eace4e2811e52dd4f",22855491,1,0,1,398,135,135,0
"8bc5795d6a984a3eace4e2811e52dd4f","b416d47c56a742199b5d7c7f19d6503a",22855491,1,-1,0,399,135,134,-1
"b416d47c56a742199b5d7c7f19d6503a","cd4532ad48034873ba8bce2aac0c9808",22855491,1,4,0,400,134,137,3
"cd4532ad48034873ba8bce2aac0c9808","cd4532ad48034873ba8bce2aac0c9808",22855491,1,0,1,401,137,137,0
"cd4532ad48034873ba8bce2aac0c9808","df1de691dafe4549a18a4398ee9dfaf9",22855491,1,4,0,402,137,139,2
"df1de691dafe4549a18a4398ee9dfaf9","779f9ddd1fd14d1e9e69f72219a1fdbd",22855491,1,-23,0,403,139,121,-18
"779f9ddd1fd14d1e9e69f72219a1fdbd","6c5ad271a44743479bfaea29b1db8d02",22855491,1,27,0,404,121,143,22
"6c5ad271a44743479bfaea29b1db8d02","83d311bed5374fee83d8d67a7d9d82dc",22855491,1,1,0,405,143,144,1
"83d311bed5374fee83d8d67a7d9d82dc","83d311bed5374fee83d8d67a7d9d82dc",22855491,3,0,1,406,144,144,0
"83d311bed5374fee83d8d67a7d9d82dc","402bba41861d43acb52a5abb89e8831e",22855491,1,1,0,409,144,145,1
"402bba41861d43acb52a5abb89e8831e","402bba41861d43acb52a5abb89e8831e",22855491,2,0,1,410,145,145,0
"402bba41861d43acb52a5abb89e8831e","df1de691dafe4549a18a4398ee9dfaf9",22855491,1,-6,0,412,145,139,-6
"df1de691dafe4549a18a4398ee9dfaf9","8aae34f5ddbb4052a709b12e6b0d40fa",22855491,1,9,0,413,139,147,8
"8aae34f5ddbb4052a709b12e6b0d40fa","645b3f0249f64f76af2e19eb4d0e55b7",22855491,1,2,0,414,147,149,2
"645b3f0249f64f76af2e19eb4d0e55b7","645b3f0249f64f76af2e19eb4d0e55b7",22855491,5,0,1,415,149,149,0
"645b3f0249f64f76af2e19eb4d0e55b7","7e7b8db5064d4369805ab370aac5ddfb",22855491,1,1,0,420,149,150,1
"7e7b8db5064d4369805ab370aac5ddfb","7e7b8db5064d4369805ab370aac5ddfb",22855491,8,0,1,421,150,150,0
"7e7b8db5064d4369805ab370aac5ddfb","8956d210ae7f41968fada86d4c979d6a",22855491,1,1,0,429,150,151,1
"8956d210ae7f41968fada86d4c979d6a","8956d210ae7f41968fada86d4c979d6a",22855491,2,0,1,430,151,151,0
"8956d210ae7f41968fada86d4c979d6a","f902b0f41b544d4dbf79664fd233648d",22855491,1,-5,0,432,151,146,-5
"f902b0f41b544d4dbf79664fd233648d","ae781e8b775e4ccd93bc800dad5c8376",22855491,1,8,0,433,146,153,7
"ae781e8b775e4ccd93bc800dad5c8376","ae781e8b775e4ccd93bc800dad5c8376",22855491,9,0,1,434,153,153,0
"ae781e8b775e4ccd93bc800dad5c8376","06882a8492d9499aa31555567f575ecb",22855491,1,1,0,443,153,154,1
"06882a8492d9499aa31555567f575ecb","06882a8492d9499aa31555567f575ecb",22855491,1,0,1,444,154,154,0
"06882a8492d9499aa31555567f575ecb","f293c508f409466a8f27ddd7d1e40b20",22855491,1,1,0,445,154,155,1
"f293c508f409466a8f27ddd7d1e40b20","f293c508f409466a8f27ddd7d1e40b20",22855491,2,0,1,446,155,155,0
"f293c508f409466a8f27ddd7d1e40b20","cc4ddef5bbbe48ebb605141b347c4ed1",22855491,1,1,0,448,155,156,1
"cc4ddef5bbbe48ebb605141b347c4ed1","cc4ddef5bbbe48ebb605141b347c4ed1",22855491,1,0,1,449,156,156,0
"cc4ddef5bbbe48ebb605141b347c4ed1","d313cec988a84645bee413e8d4724a4b",22855491,1,3,0,450,156,158,2
"d313cec988a84645bee413e8d4724a4b","f03480cf4eba413194d7af52fc0e7f28",22855491,1,-7,0,451,158,152,-6
"f03480cf4eba413194d7af52fc0e7f28","d313cec988a84645bee413e8d4724a4b",22855491,1,7,0,452,152,158,6
"d313cec988a84645bee413e8d4724a4b","d313cec988a84645bee413e8d4724a4b",22855491,3,0,1,453,158,158,0
"d313cec988a84645bee413e8d4724a4b","dc60696c76a74368a60f72246e47700d",22855491,1,1,0,456,158,159,1
"dc60696c76a74368a60f72246e47700d","dc60696c76a74368a60f72246e47700d",22855491,1,0,1,457,159,159,0
"dc60696c76a74368a60f72246e47700d","78adeee1fa2c4fe0bc73f7bca9fcee86",22855491,1,3,0,458,159,160,1
"78adeee1fa2c4fe0bc73f7bca9fcee86","df1de691dafe4549a18a4398ee9dfaf9",22855491,1,-26,0,459,160,139,-21
"df1de691dafe4549a18a4398ee9dfaf9","65202579580f4ad38d734b4ee39d22a8",22855491,1,31,0,460,139,164,25
"65202579580f4ad38d734b4ee39d22a8","65202579580f4ad38d734b4ee39d22a8",22855491,66,0,1,461,164,164,0
"65202579580f4ad38d734b4ee39d22a8","78adeee1fa2c4fe0bc73f7bca9fcee86",22855491,3,-5,0,468,164,160,-4
"78adeee1fa2c4fe0bc73f7bca9fcee86","8959e6304a0348309a771e4d08d1b64a",22855491,1,4,0,469,160,163,3
"8959e6304a0348309a771e4d08d1b64a","78adeee1fa2c4fe0bc73f7bca9fcee86",22855491,1,-4,0,470,163,160,-3
"78adeee1fa2c4fe0bc73f7bca9fcee86","65202579580f4ad38d734b4ee39d22a8",22855491,2,5,0,471,160,164,4
"78adeee1fa2c4fe0bc73f7bca9fcee86","3cbcea2be0984e7dbd5a48195af10ce7",22855491,2,8,0,523,160,165,5
"67a089198fcb4e1c8f2385786c2b296f","67a089198fcb4e1c8f2385786c2b296f",22855491,2,0,1,526,39,39,0
"64d48c6c9c7940639a932219a6c87198","67a089198fcb4e1c8f2385786c2b296f",22855491,1,-1,0,530,40,39,-1
"67a089198fcb4e1c8f2385786c2b296f","b534b89233134e30a9b5645138bfa9ee",22855491,1,4,0,531,39,41,2
"b534b89233134e30a9b5645138bfa9ee","b534b89233134e30a9b5645138bfa9ee",22855491,1,0,1,532,41,41,0
"67a089198fcb4e1c8f2385786c2b296f","78adeee1fa2c4fe0bc73f7bca9fcee86",22855491,1,152,0,538,39,160,121
"82e6285962b8400d9d6fc32436022a94","3cbcea2be0984e7dbd5a48195af10ce7",22855491,1,-2,0,552,167,165,-2
"3cbcea2be0984e7dbd5a48195af10ce7","a9ac840f098c4bd0a2ee896214ce29cd",22855491,1,5,0,553,165,168,3
"a9ac840f098c4bd0a2ee896214ce29cd","0c7262dff33c4087bc660ccf40f92f9c",22855491,1,4,0,554,168,169,1
"0c7262dff33c4087bc660ccf40f92f9c","a9ac840f098c4bd0a2ee896214ce29cd",22855491,1,-4,0,555,169,168,-1
"a9ac840f098c4bd0a2ee896214ce29cd","b2275c3fad834f8d90737a2d9a6927d6",22855491,1,7,0,556,168,172,4
"b2275c3fad834f8d90737a2d9a6927d6","b2275c3fad834f8d90737a2d9a6927d6",22855491,28,0,1,557,172,172,0
"b2275c3fad834f8d90737a2d9a6927d6","eb515a26030b41f8a82a1e6114420bad",22855491,1,1,0,585,172,173,1
"eb515a26030b41f8a82a1e6114420bad","eb515a26030b41f8a82a1e6114420bad",22855491,5,0,1,586,173,173,0
"eb515a26030b41f8a82a1e6114420bad","0c7262dff33c4087bc660ccf40f92f9c",22855491,1,-4,0,591,173,169,-4
"0c7262dff33c4087bc660ccf40f92f9c","b42cc17b7de840f181a704558d0bc845",22855491,1,7,0,592,169,175,6
"b42cc17b7de840f181a704558d0bc845","b42cc17b7de840f181a704558d0bc845",22855491,1,0,1,593,175,175,0
"b42cc17b7de840f181a704558d0bc845","801f9e9135034f49bf5f8b4bdefedb41",22855491,1,2,0,594,175,177,2
"801f9e9135034f49bf5f8b4bdefedb41","801f9e9135034f49bf5f8b4bdefedb41",22855491,9,0,1,595,177,177,0
"801f9e9135034f49bf5f8b4bdefedb41","ea38cc0e6e6e41edbabf210220808bf9",22855491,1,3,0,604,177,179,2
"ea38cc0e6e6e41edbabf210220808bf9","362fcb0699a14845ab29b2340093e528",22855491,1,-6,0,605,179,174,-5
"362fcb0699a14845ab29b2340093e528","b87c552dd247427abe6ab5795b9c9d43",22855491,1,8,0,606,174,181,7
"b87c552dd247427abe6ab5795b9c9d43","ea38cc0e6e6e41edbabf210220808bf9",22855491,1,-2,0,607,181,179,-2
"ea38cc0e6e6e41edbabf210220808bf9","b87c552dd247427abe6ab5795b9c9d43",22855491,1,2,0,608,179,181,2
"b87c552dd247427abe6ab5795b9c9d43","b87c552dd247427abe6ab5795b9c9d43",22855491,9,0,1,609,181,181,0
"b87c552dd247427abe6ab5795b9c9d43","139b097acfca451689d80c9c6eebdf7b",22855491,1,-3,0,618,181,178,-3
"139b097acfca451689d80c9c6eebdf7b","30f660a1feb34582a739722532524f79",22855491,1,6,0,619,178,183,5
"30f660a1feb34582a739722532524f79","30f660a1feb34582a739722532524f79",22855491,3,0,1,620,183,183,0
"30f660a1feb34582a739722532524f79","2024b4885bd14338a39b7b509acbbd02",22855491,1,-1,0,623,183,182,-1
"2024b4885bd14338a39b7b509acbbd02","c3f63fe50d8e487c86bf8ef76c9cadd3",22855491,1,4,0,624,182,185,3
"c3f63fe50d8e487c86bf8ef76c9cadd3","c3f63fe50d8e487c86bf8ef76c9cadd3",22855491,1,0,1,625,185,185,0
"c3f63fe50d8e487c86bf8ef76c9cadd3","0c7262dff33c4087bc660ccf40f92f9c",22855491,1,-20,0,626,185,169,-16
"0c7262dff33c4087bc660ccf40f92f9c","c8e371568a0c4391b25796ae4e91952e",22855491,2,23,0,627,169,186,17
"c8e371568a0c4391b25796ae4e91952e","7d932b23e1c84326ae5aa4d3c0d813d1",22855491,1,2,0,628,186,188,2
"7d932b23e1c84326ae5aa4d3c0d813d1","7d932b23e1c84326ae5aa4d3c0d813d1",22855491,1,0,1,629,188,188,0
"7d932b23e1c84326ae5aa4d3c0d813d1","ab11d94c6c8948ea90b88f19d2cd502b",22855491,1,3,0,630,188,190,2
"ab11d94c6c8948ea90b88f19d2cd502b","c8e371568a0c4391b25796ae4e91952e",22855491,1,-5,0,631,190,186,-4
"c8e371568a0c4391b25796ae4e91952e","ab11d94c6c8948ea90b88f19d2cd502b",22855491,1,5,0,632,186,190,4
"ab11d94c6c8948ea90b88f19d2cd502b","f992451ed6ad4e68bb9e68ad6be7c4be",22855491,1,2,0,633,190,192,2
"f992451ed6ad4e68bb9e68ad6be7c4be","f992451ed6ad4e68bb9e68ad6be7c4be",22855491,1,0,1,634,192,192,0
"f992451ed6ad4e68bb9e68ad6be7c4be","07b44a7a51e94c78b411c753fc39dab0",22855491,1,-3,0,635,192,189,-3
"07b44a7a51e94c78b411c753fc39dab0","6cd2dcaac46847d4a0bc53f296d90375",22855491,1,6,0,636,189,194,5
"6cd2dcaac46847d4a0bc53f296d90375","6cd2dcaac46847d4a0bc53f296d90375",22855491,1,0,1,637,194,194,0
"6cd2dcaac46847d4a0bc53f296d90375","2d2580c9411c4972909db508d6956a58",22855491,1,2,0,638,194,196,2
"2d2580c9411c4972909db508d6956a58","2d2580c9411c4972909db508d6956a58",22855491,2,0,1,639,196,196,0
"2d2580c9411c4972909db508d6956a58","5bddb3d9ed264f3984702f048c7e5340",22855491,1,1,0,641,196,197,1
"5bddb3d9ed264f3984702f048c7e5340","5bddb3d9ed264f3984702f048c7e5340",22855491,2,0,1,642,197,197,0
"5bddb3d9ed264f3984702f048c7e5340","d5e8e2bd12a2466b9d6d90855f0eb079",22855491,1,1,0,644,197,198,1
"d5e8e2bd12a2466b9d6d90855f0eb079","d5e8e2bd12a2466b9d6d90855f0eb079",22855491,2,0,1,645,198,198,0
"d5e8e2bd12a2466b9d6d90855f0eb079","017d7ca8e0394b91aaadc9574df2202c",22855491,1,-5,0,647,198,193,-5
"017d7ca8e0394b91aaadc9574df2202c","54e8e9f0ea3e45c4bf3b8ac799ee31b1",22855491,1,8,0,648,193,200,7
"54e8e9f0ea3e45c4bf3b8ac799ee31b1","54e8e9f0ea3e45c4bf3b8ac799ee31b1",22855491,1,0,1,649,200,200,0
"54e8e9f0ea3e45c4bf3b8ac799ee31b1","c614a00911be4877a075f19315530fb0",22855491,1,1,0,650,200,201,1
"c614a00911be4877a075f19315530fb0","c614a00911be4877a075f19315530fb0",22855491,13,0,1,651,201,201,0
"c614a00911be4877a075f19315530fb0","a6c21bd8b95249c7972820a7a7d76aff",22855491,1,1,0,664,201,202,1
"a6c21bd8b95249c7972820a7a7d76aff","a6c21bd8b95249c7972820a7a7d76aff",22855491,1,0,1,665,202,202,0
"a6c21bd8b95249c7972820a7a7d76aff","bb329d880ab54120adaf203a693bb203",22855491,1,1,0,666,202,203,1
"bb329d880ab54120adaf203a693bb203","bb329d880ab54120adaf203a693bb203",22855491,1,0,1,667,203,203,0
"bb329d880ab54120adaf203a693bb203","f9170dd6bc6442b4acd832747609b09a",22855491,1,-4,0,668,203,199,-4
"f9170dd6bc6442b4acd832747609b09a","334c2344009840079b1d0e1b7ce3d5a7",22855491,1,7,0,669,199,205,6
"334c2344009840079b1d0e1b7ce3d5a7","334c2344009840079b1d0e1b7ce3d5a7",22855491,1,0,1,670,205,205,0
"334c2344009840079b1d0e1b7ce3d5a7","d7f13c8d63ec4e2aa673fbb9cf9c6933",22855491,1,3,0,671,205,206,1
"d7f13c8d63ec4e2aa673fbb9cf9c6933","c8e371568a0c4391b25796ae4e91952e",22855491,2,-26,0,672,206,186,-20
"c8e371568a0c4391b25796ae4e91952e","b9e80f77c3a44349863b19875725c384",22855491,1,27,0,673,186,207,21
"b9e80f77c3a44349863b19875725c384","7108f0e4c2584f1f9c471689ae4c885c",22855491,3,1,0,674,207,208,1
"7108f0e4c2584f1f9c471689ae4c885c","0c7262dff33c4087bc660ccf40f92f9c",22855491,1,-51,0,675,208,169,-39
"c8e371568a0c4391b25796ae4e91952e","017d7ca8e0394b91aaadc9574df2202c",22855491,1,9,0,677,186,193,7
"017d7ca8e0394b91aaadc9574df2202c","6cd2dcaac46847d4a0bc53f296d90375",22855491,1,1,0,678,193,194,1
"6cd2dcaac46847d4a0bc53f296d90375","017d7ca8e0394b91aaadc9574df2202c",22855491,1,-1,0,679,194,193,-1
"017d7ca8e0394b91aaadc9574df2202c","d7f13c8d63ec4e2aa673fbb9cf9c6933",22855491,1,17,0,680,193,206,13
"c8e371568a0c4391b25796ae4e91952e","f9170dd6bc6442b4acd832747609b09a",22855491,1,16,0,682,186,199,13
"f9170dd6bc6442b4acd832747609b09a","b9e80f77c3a44349863b19875725c384",22855491,1,11,0,683,199,207,8
"7108f0e4c2584f1f9c471689ae4c885c","b9e80f77c3a44349863b19875725c384",22855491,1,-1,0,685,208,207,-1
"b9e80f77c3a44349863b19875725c384","b9e80f77c3a44349863b19875725c384",22855491,19,0,1,686,207,207,0
"7108f0e4c2584f1f9c471689ae4c885c","7108f0e4c2584f1f9c471689ae4c885c",22855491,14,0,1,706,208,208,0
"7108f0e4c2584f1f9c471689ae4c885c","09400e101c5d4b439cf9a26b03aae558",22855491,1,3,0,720,208,210,2
"09400e101c5d4b439cf9a26b03aae558","d7f13c8d63ec4e2aa673fbb9cf9c6933",22855491,1,-5,0,721,210,206,-4
"d7f13c8d63ec4e2aa673fbb9cf9c6933","09400e101c5d4b439cf9a26b03aae558",22855491,1,5,0,722,206,210,4
"09400e101c5d4b439cf9a26b03aae558","a88efa7e50ce47159810ab553afa6d3a",22855491,1,2,0,723,210,212,2
"a88efa7e50ce47159810ab553afa6d3a","a88efa7e50ce47159810ab553afa6d3a",22855491,5,0,1,724,212,212,0
"a88efa7e50ce47159810ab553afa6d3a","f7fb1952f56b4189b86a9f8b7862d2b8",22855491,1,4,0,729,212,215,3
"f7fb1952f56b4189b86a9f8b7862d2b8","a875096404ef4a9984b62d74cda916f9",22855491,1,-7,0,730,215,209,-6
"a875096404ef4a9984b62d74cda916f9","be502a7a43c44bf7b682698de79d9369",22855491,1,6,0,731,209,214,5
"be502a7a43c44bf7b682698de79d9369","be502a7a43c44bf7b682698de79d9369",22855491,1,0,1,732,214,214,0
"be502a7a43c44bf7b682698de79d9369","f7fb1952f56b4189b86a9f8b7862d2b8",22855491,1,1,0,733,214,215,1
"f7fb1952f56b4189b86a9f8b7862d2b8","f7fb1952f56b4189b86a9f8b7862d2b8",22855491,23,0,1,734,215,215,0
"f7fb1952f56b4189b86a9f8b7862d2b8","b860ee85d8bc4a2f97958cfb71be3533",22855491,1,1,0,757,215,216,1
"b860ee85d8bc4a2f97958cfb71be3533","b860ee85d8bc4a2f97958cfb71be3533",22855491,5,0,1,758,216,216,0
"b860ee85d8bc4a2f97958cfb71be3533","ec341f459285443b8361f7f15638ff08",22855491,1,-3,0,763,216,213,-3
"ec341f459285443b8361f7f15638ff08","363837c182e04711840d896ae1e0339c",22855491,1,6,0,764,213,218,5
"363837c182e04711840d896ae1e0339c","363837c182e04711840d896ae1e0339c",22855491,12,0,1,765,218,218,0
"363837c182e04711840d896ae1e0339c","01b2051f8941460d89945e3b02d1ce78",22855491,1,-1,0,777,218,217,-1
"01b2051f8941460d89945e3b02d1ce78","91125ca626c5470eb145501f8c37f8db",22855491,1,4,0,778,217,220,3
"91125ca626c5470eb145501f8c37f8db","91125ca626c5470eb145501f8c37f8db",22855491,1,0,1,779,220,220,0
"91125ca626c5470eb145501f8c37f8db","1c6721b1f63f4d30ba7746ea8af02a52",22855491,1,3,0,780,220,221,1
"1c6721b1f63f4d30ba7746ea8af02a52","d7f13c8d63ec4e2aa673fbb9cf9c6933",22855491,1,-21,0,781,221,206,-15
"d7f13c8d63ec4e2aa673fbb9cf9c6933","77ecef8eff6b4a2caea7707669bf7475",22855491,1,22,0,782,206,222,16
"77ecef8eff6b4a2caea7707669bf7475","0c7262dff33c4087bc660ccf40f92f9c",22855491,1,-71,0,783,222,169,-53
"0c7262dff33c4087bc660ccf40f92f9c","1c6721b1f63f4d30ba7746ea8af02a52",22855491,1,70,0,784,169,221,52
"1c6721b1f63f4d30ba7746ea8af02a52","77ecef8eff6b4a2caea7707669bf7475",22855491,1,1,0,785,221,222,1
"77ecef8eff6b4a2caea7707669bf7475","77ecef8eff6b4a2caea7707669bf7475",22855491,12,0,1,786,222,222,0
"77ecef8eff6b4a2caea7707669bf7475","1c6721b1f63f4d30ba7746ea8af02a52",22855491,1,-1,0,798,222,221,-1
"1c6721b1f63f4d30ba7746ea8af02a52","d03cb855c70044cf8c35d9ec0de696e3",22855491,1,4,0,799,221,224,3
"d03cb855c70044cf8c35d9ec0de696e3","8b9ae98743bd4d4a8a87dff1c1244211",22855491,1,3,0,800,224,227,3
"8b9ae98743bd4d4a8a87dff1c1244211","d03cb855c70044cf8c35d9ec0de696e3",22855491,1,-3,0,801,227,224,-3
"d03cb855c70044cf8c35d9ec0de696e3","a49a937d6896486d9a5396654abcf2e1",22855491,1,2,0,802,224,226,2
"a49a937d6896486d9a5396654abcf2e1","a49a937d6896486d9a5396654abcf2e1",22855491,1,0,1,803,226,226,0
"a49a937d6896486d9a5396654abcf2e1","8b9ae98743bd4d4a8a87dff1c1244211",22855491,1,1,0,804,226,227,1
"8b9ae98743bd4d4a8a87dff1c1244211","8b9ae98743bd4d4a8a87dff1c1244211",22855491,29,0,1,805,227,227,0
"8b9ae98743bd4d4a8a87dff1c1244211","2ab1535aac1346ba8801535bf729ef37",22855491,1,3,0,834,227,229,2
"2ab1535aac1346ba8801535bf729ef37","f7906d6f59b9489a91d2ef40db5a474d",22855491,1,-7,0,835,229,223,-6
"f7906d6f59b9489a91d2ef40db5a474d","2ab1535aac1346ba8801535bf729ef37",22855491,1,7,0,836,223,229,6
"2ab1535aac1346ba8801535bf729ef37","a4f40fb48a8542c8949bae1f002cd9bc",22855491,1,2,0,837,229,231,2
"a4f40fb48a8542c8949bae1f002cd9bc","a4f40fb48a8542c8949bae1f002cd9bc",22855491,5,0,1,838,231,231,0
"a4f40fb48a8542c8949bae1f002cd9bc","8972c23e32044edb8a78fa1eed4e5947",22855491,1,1,0,843,231,232,1
"8972c23e32044edb8a78fa1eed4e5947","8972c23e32044edb8a78fa1eed4e5947",22855491,1,0,1,844,232,232,0
"8972c23e32044edb8a78fa1eed4e5947","92feb4a40f8344d38b6f722e42a53295",22855491,1,1,0,845,232,233,1
"92feb4a40f8344d38b6f722e42a53295","92feb4a40f8344d38b6f722e42a53295",22855491,2,0,1,846,233,233,0
"92feb4a40f8344d38b6f722e42a53295","5152833676bf4c6cb317060be10f68db",22855491,1,-5,0,848,233,228,-5
"5152833676bf4c6cb317060be10f68db","ca3e28f290354c08aefe5b0f769604e6",22855491,1,8,0,849,228,235,7
"ca3e28f290354c08aefe5b0f769604e6","ca3e28f290354c08aefe5b0f769604e6",22855491,4,0,1,850,235,235,0
"ca3e28f290354c08aefe5b0f769604e6","79a35eea833e4c2c9d22fc53c3c6445c",22855491,1,1,0,854,235,236,1
"79a35eea833e4c2c9d22fc53c3c6445c","79a35eea833e4c2c9d22fc53c3c6445c",22855491,9,0,1,855,236,236,0
"79a35eea833e4c2c9d22fc53c3c6445c","1c6721b1f63f4d30ba7746ea8af02a52",22855491,1,-18,0,864,236,221,-15
"1c6721b1f63f4d30ba7746ea8af02a52","cab89fa5c3ed45a5aa550fc0352d6a42",22855491,1,20,0,865,221,238,17
"cab89fa5c3ed45a5aa550fc0352d6a42","cab89fa5c3ed45a5aa550fc0352d6a42",22855491,5,0,1,866,238,238,0
"cab89fa5c3ed45a5aa550fc0352d6a42","8f68228b1518449e9615cdafee41a2bd",22855491,1,-1,0,871,238,237,-1
"8f68228b1518449e9615cdafee41a2bd","8f68228b1518449e9615cdafee41a2bd",22855491,1,0,1,872,237,237,0
"8f68228b1518449e9615cdafee41a2bd","0b04c8e2f86d48c7aeb7e225819cd32b",22855491,1,-3,0,873,237,234,-3
"0b04c8e2f86d48c7aeb7e225819cd32b","64dbedb3ce544f6aae8e10e0cf10f16d",22855491,1,7,0,874,234,240,6
"64dbedb3ce544f6aae8e10e0cf10f16d","cab89fa5c3ed45a5aa550fc0352d6a42",22855491,1,-3,0,875,240,238,-2
"cab89fa5c3ed45a5aa550fc0352d6a42","0b04c8e2f86d48c7aeb7e225819cd32b",22855491,1,-4,0,876,238,234,-4
"0b04c8e2f86d48c7aeb7e225819cd32b","2ae94c0cea4d480a9d5dca8fb1d7b542",22855491,1,11,0,877,234,242,8
"1ebf23f9d994469a85206e4c7b1bf5f5","4a29443515bb404cb8924e1c60a63b73",22855491,1,57,0,880,245,285,40
"4a29443515bb404cb8924e1c60a63b73","208c9b2796c944db8dacaa96082520ea",22855491,3,3,0,882,285,288,3
"208c9b2796c944db8dacaa96082520ea","208c9b2796c944db8dacaa96082520ea",22855491,1,0,1,883,288,288,0
"208c9b2796c944db8dacaa96082520ea","4a29443515bb404cb8924e1c60a63b73",22855491,3,-3,0,884,288,285,-3
"4a29443515bb404cb8924e1c60a63b73","7669a956527947d0add87455277e80b4",22855491,1,7,0,885,285,291,6
"7669a956527947d0add87455277e80b4","7669a956527947d0add87455277e80b4",22855491,1,0,1,886,291,291,0
"7669a956527947d0add87455277e80b4","6a9a3b5bde4a48daa896fe8c06eca56f",22855491,1,-2,0,887,291,289,-2
"6a9a3b5bde4a48daa896fe8c06eca56f","869e967078f04da18dd0b0b9389a7424",22855491,1,5,0,888,289,293,4
"869e967078f04da18dd0b0b9389a7424","869e967078f04da18dd0b0b9389a7424",22855491,1,0,1,889,293,293,0
"869e967078f04da18dd0b0b9389a7424","51ab6291537748fab90d519aa09889d6",22855491,1,2,0,890,293,295,2
"51ab6291537748fab90d519aa09889d6","51ab6291537748fab90d519aa09889d6",22855491,11,0,1,891,295,295,0
"51ab6291537748fab90d519aa09889d6","34a6e49023fc4465bd5ca604330bbd1c",22855491,1,-3,0,902,295,292,-3
"34a6e49023fc4465bd5ca604330bbd1c","ba0e59461bfb4a44b7b1c28a01f8d3b3",22855491,1,9,0,903,292,299,7
"ba0e59461bfb4a44b7b1c28a01f8d3b3","21592f2a9e9c4b2f8c66ec5dbcbf6a2b",22855491,1,-4,0,904,299,296,-3
"21592f2a9e9c4b2f8c66ec5dbcbf6a2b","ba0e59461bfb4a44b7b1c28a01f8d3b3",22855491,1,4,0,905,296,299,3
"ba0e59461bfb4a44b7b1c28a01f8d3b3","0e0b36e731a645e7b1b8a88f5031ca38",22855491,1,2,0,906,299,301,2
"0e0b36e731a645e7b1b8a88f5031ca38","0e0b36e731a645e7b1b8a88f5031ca38",22855491,5,0,1,907,301,301,0
"0e0b36e731a645e7b1b8a88f5031ca38","a66a144637284c21afc6de17fea4bfb8",22855491,1,1,0,912,301,302,1
"a66a144637284c21afc6de17fea4bfb8","a66a144637284c21afc6de17fea4bfb8",22855491,2,0,1,913,302,302,0
"a66a144637284c21afc6de17fea4bfb8","7646a919d7e64fa990bca9b024ff089d",22855491,1,-4,0,915,302,298,-4
"7646a919d7e64fa990bca9b024ff089d","4a29443515bb404cb8924e1c60a63b73",22855491,1,-17,0,916,298,285,-13
"4a29443515bb404cb8924e1c60a63b73","e390b575229748ea8aac9364efe2bf00",22855491,1,24,0,923,285,304,19
"e390b575229748ea8aac9364efe2bf00","e390b575229748ea8aac9364efe2bf00",22855491,1,0,1,924,304,304,0
"e390b575229748ea8aac9364efe2bf00","3434c10e561d488a914e0f7d71907abd",22855491,1,3,0,925,304,305,1
"3434c10e561d488a914e0f7d71907abd","4a29443515bb404cb8924e1c60a63b73",22855491,1,-27,0,926,305,285,-20
"4a29443515bb404cb8924e1c60a63b73","53e7e900392747ccad52e711ab0f80d8",22855491,1,29,0,927,285,307,22
"53e7e900392747ccad52e711ab0f80d8","53e7e900392747ccad52e711ab0f80d8",22855491,3,0,1,928,307,307,0
"53e7e900392747ccad52e711ab0f80d8","3434c10e561d488a914e0f7d71907abd",22855491,2,-2,0,929,307,305,-2
"3434c10e561d488a914e0f7d71907abd","53e7e900392747ccad52e711ab0f80d8",22855491,2,2,0,930,305,307,2
"53e7e900392747ccad52e711ab0f80d8","4a29443515bb404cb8924e1c60a63b73",22855491,1,-29,0,932,307,285,-22
"4a29443515bb404cb8924e1c60a63b73","43ea1b823a4b4e51b7c694c10725db82",22855491,1,54,0,933,285,327,42
"43ea1b823a4b4e51b7c694c10725db82","3434c10e561d488a914e0f7d71907abd",22855491,1,-27,0,934,327,305,-22
"3434c10e561d488a914e0f7d71907abd","43ea1b823a4b4e51b7c694c10725db82",22855491,1,27,0,935,305,327,22
"43ea1b823a4b4e51b7c694c10725db82","130acc2aeb0448fdbb2de63bc5cebe5b",22855491,1,-22,0,936,327,309,-18
"130acc2aeb0448fdbb2de63bc5cebe5b","4a29443515bb404cb8924e1c60a63b73",22855491,1,-32,0,937,309,285,-24
"4a29443515bb404cb8924e1c60a63b73","3434c10e561d488a914e0f7d71907abd",22855491,1,27,0,938,285,305,20
"3434c10e561d488a914e0f7d71907abd","3434c10e561d488a914e0f7d71907abd",22855491,2,0,1,939,305,305,0
"3434c10e561d488a914e0f7d71907abd","130acc2aeb0448fdbb2de63bc5cebe5b",22855491,1,5,0,943,305,309,4
"130acc2aeb0448fdbb2de63bc5cebe5b","130acc2aeb0448fdbb2de63bc5cebe5b",22855491,1,0,1,944,309,309,0
"130acc2aeb0448fdbb2de63bc5cebe5b","9c062b3251034ebe90f5054e2a3b5120",22855491,1,2,0,945,309,311,2
"9c062b3251034ebe90f5054e2a3b5120","9c062b3251034ebe90f5054e2a3b5120",22855491,2,0,1,946,311,311,0
"9c062b3251034ebe90f5054e2a3b5120","ea859f8207e44537889daeaba13ac2e8",22855491,1,1,0,948,311,312,1
"ea859f8207e44537889daeaba13ac2e8","ea859f8207e44537889daeaba13ac2e8",22855491,8,0,1,949,312,312,0
"ea859f8207e44537889daeaba13ac2e8","56d94971a7a94257aa330183a8ebd0ea",22855491,1,1,0,957,312,313,1
"56d94971a7a94257aa330183a8ebd0ea","56d94971a7a94257aa330183a8ebd0ea",22855491,1,0,1,958,313,313,0
"56d94971a7a94257aa330183a8ebd0ea","141c0df6cd1946539aadd1c9b7068cd4",22855491,1,-5,0,959,313,308,-5
"141c0df6cd1946539aadd1c9b7068cd4","13255e63e0aa4abf85e5211bf613d43e",22855491,1,10,0,960,308,317,9
"13255e63e0aa4abf85e5211bf613d43e","13255e63e0aa4abf85e5211bf613d43e",22855491,1,0,1,961,317,317,0
"13255e63e0aa4abf85e5211bf613d43e","86c27d40179e419c8e9d150fb6afa5d0",22855491,1,3,0,962,317,319,2
"86c27d40179e419c8e9d150fb6afa5d0","0c787d16c9504873b1a4d903cec09948",22855491,1,-6,0,963,319,314,-5
"0c787d16c9504873b1a4d903cec09948","86c27d40179e419c8e9d150fb6afa5d0",22855491,1,6,0,964,314,319,5
"86c27d40179e419c8e9d150fb6afa5d0","8d7e0b55cf9849cda222a0f2440cec55",22855491,1,-1,0,965,319,318,-1
"8d7e0b55cf9849cda222a0f2440cec55","24f1363179ad4aaa965484a78471912b",22855491,1,6,0,966,318,323,5
"24f1363179ad4aaa965484a78471912b","47edbb64109243e6b0f8f64cdef90c6c",22855491,1,3,0,967,323,326,3
"47edbb64109243e6b0f8f64cdef90c6c","24f1363179ad4aaa965484a78471912b",22855491,2,-3,0,968,326,323,-3
"24f1363179ad4aaa965484a78471912b","3434c10e561d488a914e0f7d71907abd",22855491,1,-22,0,969,323,305,-18
"3434c10e561d488a914e0f7d71907abd","47edbb64109243e6b0f8f64cdef90c6c",22855491,1,25,0,971,305,326,21
"24f1363179ad4aaa965484a78471912b","24f1363179ad4aaa965484a78471912b",22855491,3,0,1,973,323,323,0
"24f1363179ad4aaa965484a78471912b","3628bdce1dd2429ba924d2d4d09448d2",22855491,1,-1,0,976,323,322,-1
"3628bdce1dd2429ba924d2d4d09448d2","56b3fd1a212a4764be39d979fde3326e",22855491,1,7,0,977,322,328,6
"56b3fd1a212a4764be39d979fde3326e","56b3fd1a212a4764be39d979fde3326e",22855491,1,0,1,978,328,328,0
"56b3fd1a212a4764be39d979fde3326e","3434c10e561d488a914e0f7d71907abd",22855491,1,-28,0,979,328,305,-23
"3434c10e561d488a914e0f7d71907abd","0c4079457ede49e3aeb5e86ed84bdf35",22855491,1,31,0,980,305,329,24
"0c4079457ede49e3aeb5e86ed84bdf35","38aea304b4fa46e1b29bb72f5cea4c93",22855491,1,2,0,981,329,331,2
"38aea304b4fa46e1b29bb72f5cea4c93","38aea304b4fa46e1b29bb72f5cea4c93",22855491,1,0,1,982,331,331,0
"38aea304b4fa46e1b29bb72f5cea4c93","e36d261332f14e79bb4b467aceaeb9b5",22855491,1,2,0,983,331,333,2
"e36d261332f14e79bb4b467aceaeb9b5","e36d261332f14e79bb4b467aceaeb9b5",22855491,1,0,1,984,333,333,0
"e36d261332f14e79bb4b467aceaeb9b5","c7e89b9d04744d2eab742fc24e3ef1ae",22855491,1,1,0,985,333,334,1
"c7e89b9d04744d2eab742fc24e3ef1ae","c7e89b9d04744d2eab742fc24e3ef1ae",22855491,2,0,1,986,334,334,0
"c7e89b9d04744d2eab742fc24e3ef1ae","fe49f8054b374a0ea4bb266ed135ff62",22855491,1,1,0,988,334,335,1
"fe49f8054b374a0ea4bb266ed135ff62","fe49f8054b374a0ea4bb266ed135ff62",22855491,2,0,1,989,335,335,0
"fe49f8054b374a0ea4bb266ed135ff62","d0a8f74af98642fe8360d22c42e45117",22855491,1,1,0,991,335,336,1
"d0a8f74af98642fe8360d22c42e45117","d0a8f74af98642fe8360d22c42e45117",22855491,2,0,1,992,336,336,0
"d0a8f74af98642fe8360d22c42e45117","0c4079457ede49e3aeb5e86ed84bdf35",22855491,1,-7,0,994,336,329,-7
"0c4079457ede49e3aeb5e86ed84bdf35","a7c6339ca1da4368a18d471f0519f877",22855491,1,11,0,995,329,339,10
"a7c6339ca1da4368a18d471f0519f877","a7c6339ca1da4368a18d471f0519f877",22855491,1,0,1,996,339,339,0
"a7c6339ca1da4368a18d471f0519f877","bbc5139ca9024389a94db3a6f47dcff6",22855491,1,3,0,997,339,341,2
"bbc5139ca9024389a94db3a6f47dcff6","b8b9418ab322418d9db9b40d96af873a",22855491,1,-5,0,998,341,337,-4
"b8b9418ab322418d9db9b40d96af873a","bbc5139ca9024389a94db3a6f47dcff6",22855491,1,5,0,999,337,341,4
"bbc5139ca9024389a94db3a6f47dcff6","4ee6ca9019ab4a1ab323f98094a9bd77",22855491,1,2,0,1000,341,343,2
"4ee6ca9019ab4a1ab323f98094a9bd77","4ee6ca9019ab4a1ab323f98094a9bd77",22855491,2,0,1,1001,343,343,0
"4ee6ca9019ab4a1ab323f98094a9bd77","b37947176785476f8b29d49a851366dc",22855491,1,1,0,1003,343,344,1
"b37947176785476f8b29d49a851366dc","b37947176785476f8b29d49a851366dc",22855491,2,0,1,1004,344,344,0
"b37947176785476f8b29d49a851366dc","fcea5b10d5a14a3b9324ffece8f6e1e5",22855491,1,1,0,1006,344,345,1
"fcea5b10d5a14a3b9324ffece8f6e1e5","fcea5b10d5a14a3b9324ffece8f6e1e5",22855491,5,0,1,1007,345,345,0
"fcea5b10d5a14a3b9324ffece8f6e1e5","c2490bc612d146edbe786556fab3651b",22855491,1,-5,0,1012,345,340,-5
"c2490bc612d146edbe786556fab3651b","6ac8bb048b854999a47edb35fe627f11",22855491,1,8,0,1013,340,347,7
"6ac8bb048b854999a47edb35fe627f11","6ac8bb048b854999a47edb35fe627f11",22855491,1,0,1,1014,347,347,0
"6ac8bb048b854999a47edb35fe627f11","30ead9794d4847abaf222ca966cc8630",22855491,1,3,0,1015,347,348,1
"30ead9794d4847abaf222ca966cc8630","0c4079457ede49e3aeb5e86ed84bdf35",22855491,1,-24,0,1016,348,329,-19
"0c4079457ede49e3aeb5e86ed84bdf35","c20993c944444fe085345591a8bd837e",22855491,1,27,0,1017,329,351,22
"c20993c944444fe085345591a8bd837e","897b7f51242c44aab2205c72fdcbf4cd",22855491,2,1,0,1018,351,352,1
"897b7f51242c44aab2205c72fdcbf4cd","09b9678ddc3d452ea4a3d46e15826065",22855491,2,1,0,1019,352,353,1
"09b9678ddc3d452ea4a3d46e15826065","eff0de7f2dbb42dfa1a2e686efab5b6d",22855491,2,1,0,1020,353,354,1
"eff0de7f2dbb42dfa1a2e686efab5b6d","c20993c944444fe085345591a8bd837e",22855491,1,-3,0,1021,354,351,-3
"c20993c944444fe085345591a8bd837e","c20993c944444fe085345591a8bd837e",22855491,4,0,1,1022,351,351,0
"897b7f51242c44aab2205c72fdcbf4cd","897b7f51242c44aab2205c72fdcbf4cd",22855491,4,0,1,1026,352,352,0
"09b9678ddc3d452ea4a3d46e15826065","09b9678ddc3d452ea4a3d46e15826065",22855491,4,0,1,1030,353,353,0
"eff0de7f2dbb42dfa1a2e686efab5b6d","eff0de7f2dbb42dfa1a2e686efab5b6d",22855491,4,0,1,1034,354,354,0
"eff0de7f2dbb42dfa1a2e686efab5b6d","2fe14166dc9642c3bc666b86a57f943d",22855491,1,4,0,1037,354,357,3
"2fe14166dc9642c3bc666b86a57f943d","30ead9794d4847abaf222ca966cc8630",22855491,1,-10,0,1038,357,348,-9
"30ead9794d4847abaf222ca966cc8630","2fe14166dc9642c3bc666b86a57f943d",22855491,1,10,0,1039,348,357,9
"2fe14166dc9642c3bc666b86a57f943d","44421dd1e13a47a388c4a19834b744c7",22855491,1,2,0,1040,357,359,2
"44421dd1e13a47a388c4a19834b744c7","44421dd1e13a47a388c4a19834b744c7",22855491,2,0,1,1041,359,359,0
"44421dd1e13a47a388c4a19834b744c7","cb5fc7ef85d547c4be1a7439d0bf6052",22855491,1,1,0,1043,359,360,1
"cb5fc7ef85d547c4be1a7439d0bf6052","cb5fc7ef85d547c4be1a7439d0bf6052",22855491,2,0,1,1044,360,360,0
"cb5fc7ef85d547c4be1a7439d0bf6052","0a8f150a4cf747acbde62f4721823da3",22855491,1,1,0,1046,360,361,1
"0a8f150a4cf747acbde62f4721823da3","0a8f150a4cf747acbde62f4721823da3",22855491,5,0,1,1047,361,361,0
"0a8f150a4cf747acbde62f4721823da3","ab8fdad974ae471f9f24c3f9dd04462e",22855491,1,1,0,1052,361,362,1
"ab8fdad974ae471f9f24c3f9dd04462e","ab8fdad974ae471f9f24c3f9dd04462e",22855491,2,0,1,1053,362,362,0
"ab8fdad974ae471f9f24c3f9dd04462e","1ba8fef685d74a8194b9db252eb704fb",22855491,1,-7,0,1055,362,355,-7
"1ba8fef685d74a8194b9db252eb704fb","52580888dadb4fe3baa795683ea227bd",22855491,1,10,0,1056,355,364,9
"52580888dadb4fe3baa795683ea227bd","52580888dadb4fe3baa795683ea227bd",22855491,3,0,1,1057,364,364,0
"52580888dadb4fe3baa795683ea227bd","492a3bc6a1254f23a7998587961b22a4",22855491,1,3,0,1060,364,366,2
"492a3bc6a1254f23a7998587961b22a4","f00179e251a045b39c3f7a54f9aa4acc",22855491,1,-4,0,1061,366,363,-3
"f00179e251a045b39c3f7a54f9aa4acc","492a3bc6a1254f23a7998587961b22a4",22855491,1,4,0,1062,363,366,3
"492a3bc6a1254f23a7998587961b22a4","072a190fd302456290895f9f04d6940a",22855491,1,-1,0,1063,366,365,-1
"072a190fd302456290895f9f04d6940a","897b7f51242c44aab2205c72fdcbf4cd",22855491,1,-16,0,1064,365,352,-13
"897b7f51242c44aab2205c72fdcbf4cd","eff0de7f2dbb42dfa1a2e686efab5b6d",22855491,1,2,0,1066,352,354,2
"eff0de7f2dbb42dfa1a2e686efab5b6d","09b9678ddc3d452ea4a3d46e15826065",22855491,1,-1,0,1067,354,353,-1
"09b9678ddc3d452ea4a3d46e15826065","897b7f51242c44aab2205c72fdcbf4cd",22855491,1,-1,0,1069,353,352,-1
"897b7f51242c44aab2205c72fdcbf4cd","c20993c944444fe085345591a8bd837e",22855491,1,-1,0,1070,352,351,-1
"c20993c944444fe085345591a8bd837e","09b9678ddc3d452ea4a3d46e15826065",22855491,1,2,0,1072,351,353,2
"09b9678ddc3d452ea4a3d46e15826065","c20993c944444fe085345591a8bd837e",22855491,1,-2,0,1073,353,351,-2
"c20993c944444fe085345591a8bd837e","c76574d21bc14aeea7ecd0b027f39858",22855491,1,20,0,1074,351,367,16
"c76574d21bc14aeea7ecd0b027f39858","eff0de7f2dbb42dfa1a2e686efab5b6d",22855491,1,-17,0,1075,367,354,-13
"eff0de7f2dbb42dfa1a2e686efab5b6d","30ead9794d4847abaf222ca966cc8630",22855491,1,-6,0,1077,354,348,-6
"30ead9794d4847abaf222ca966cc8630","cfa457d1743848e4bb5e4beced6448ed",22855491,1,25,0,1078,348,369,21
"cfa457d1743848e4bb5e4beced6448ed","cfa457d1743848e4bb5e4beced6448ed",22855491,1,0,1,1079,369,369,0
"cfa457d1743848e4bb5e4beced6448ed","30ead9794d4847abaf222ca966cc8630",22855491,1,-25,0,1080,369,348,-21
"30ead9794d4847abaf222ca966cc8630","b71bac264efb4abd97015447bd490db6",22855491,1,28,0,1081,348,370,22
"b71bac264efb4abd97015447bd490db6","4a29443515bb404cb8924e1c60a63b73",22855491,1,-110,0,1082,370,285,-85
"4a29443515bb404cb8924e1c60a63b73","4a29443515bb404cb8924e1c60a63b73",22855491,4,0,1,1083,285,285,0
"4a29443515bb404cb8924e1c60a63b73","b71bac264efb4abd97015447bd490db6",22855491,1,110,0,1084,285,370,85
"b71bac264efb4abd97015447bd490db6","b71bac264efb4abd97015447bd490db6",22855491,1,0,1,1085,370,370,0
"b71bac264efb4abd97015447bd490db6","8d448d625b024c82a5eb240bbd7431d6",22855491,3,5,0,1086,370,374,4
"8d448d625b024c82a5eb240bbd7431d6","8d448d625b024c82a5eb240bbd7431d6",22855491,60,0,1,1087,374,374,0
"8d448d625b024c82a5eb240bbd7431d6","b71bac264efb4abd97015447bd490db6",22855491,2,-5,0,1094,374,370,-4
"8d448d625b024c82a5eb240bbd7431d6","4a29443515bb404cb8924e1c60a63b73",22855491,1,-115,0,1140,374,285,-89
"4a29443515bb404cb8924e1c60a63b73","d6d02b6ef04e4f17805504500b8ce441",22855491,1,118,0,1141,285,375,90
"d6d02b6ef04e4f17805504500b8ce441","d6d02b6ef04e4f17805504500b8ce441",22855491,4,0,1,1142,375,375,0
"d6d02b6ef04e4f17805504500b8ce441","b71bac264efb4abd97015447bd490db6",22855491,1,-8,0,1144,375,370,-5
"b71bac264efb4abd97015447bd490db6","d6d02b6ef04e4f17805504500b8ce441",22855491,1,8,0,1156,370,375,5
"d6d02b6ef04e4f17805504500b8ce441","66baf19b6b904b70922329068c63746d",22855491,1,4,0,1159,375,376,1
"66baf19b6b904b70922329068c63746d","7f544639412e40a9ba27f43b415362ab",22855491,2,2,0,1160,376,378,2
"7f544639412e40a9ba27f43b415362ab","66baf19b6b904b70922329068c63746d",22855491,1,-2,0,1161,378,376,-2
"7f544639412e40a9ba27f43b415362ab","d5ae8642e15b46b8bd298b02274d4e9c",22855491,1,2,0,1163,378,380,2
"d5ae8642e15b46b8bd298b02274d4e9c","d5ae8642e15b46b8bd298b02274d4e9c",22855491,4,0,1,1164,380,380,0
"d5ae8642e15b46b8bd298b02274d4e9c","a0d10309a2dd456289147f84be9d37f9",22855491,1,1,0,1168,380,381,1
"a0d10309a2dd456289147f84be9d37f9","a0d10309a2dd456289147f84be9d37f9",22855491,2,0,1,1169,381,381,0
"a0d10309a2dd456289147f84be9d37f9","0fcbc3ca07b144138b8d85da581f09a8",22855491,1,1,0,1171,381,382,1
"0fcbc3ca07b144138b8d85da581f09a8","0fcbc3ca07b144138b8d85da581f09a8",22855491,2,0,1,1172,382,382,0
"0fcbc3ca07b144138b8d85da581f09a8","66baf19b6b904b70922329068c63746d",22855491,1,-6,0,1174,382,376,-6
"66baf19b6b904b70922329068c63746d","c2fca3669923477ab966ded303dea31c",22855491,1,8,0,1175,376,383,7
"c2fca3669923477ab966ded303dea31c","4890121ce5d74576b4632b77cfc23398",22855491,1,6,0,1176,383,388,5
"4890121ce5d74576b4632b77cfc23398","96bb2b3e85a34d8b9544514e89f6fe97",22855491,1,3,0,1177,388,390,2
"96bb2b3e85a34d8b9544514e89f6fe97","18d3b836dd804224883cc9180b60a8e1",22855491,1,-4,0,1178,390,387,-3
"18d3b836dd804224883cc9180b60a8e1","7f544639412e40a9ba27f43b415362ab",22855491,1,-11,0,1179,387,378,-9
"7f544639412e40a9ba27f43b415362ab","17f95d18bab743888e1736033dc3384d",22855491,1,14,0,1180,378,389,11
"17f95d18bab743888e1736033dc3384d","96bb2b3e85a34d8b9544514e89f6fe97",22855491,1,1,0,1181,389,390,1
"96bb2b3e85a34d8b9544514e89f6fe97","66baf19b6b904b70922329068c63746d",22855491,1,-17,0,1182,390,376,-14
"66baf19b6b904b70922329068c63746d","ac4e9b54acfe4670b4634859c7263cb5",22855491,1,19,0,1183,376,392,16
"ac4e9b54acfe4670b4634859c7263cb5","ac4e9b54acfe4670b4634859c7263cb5",22855491,1,0,1,1184,392,392,0
"ac4e9b54acfe4670b4634859c7263cb5","6f8881a745ac4c358a68b92c3b4abe81",22855491,1,3,0,1185,392,394,2
"6f8881a745ac4c358a68b92c3b4abe81","17f95d18bab743888e1736033dc3384d",22855491,1,-6,0,1186,394,389,-5
"17f95d18bab743888e1736033dc3384d","f7002c8484354eceac57bc7bd62c76c1",22855491,1,5,0,1187,389,393,4
"f7002c8484354eceac57bc7bd62c76c1","44a277ea44dc4ae689fab4b82f0b4098",22855491,1,5,0,1188,393,397,4
"44a277ea44dc4ae689fab4b82f0b4098","44a277ea44dc4ae689fab4b82f0b4098",22855491,1,0,1,1189,397,397,0
"44a277ea44dc4ae689fab4b82f0b4098","0c12af0a4e7f4002852cf84b2537c161",22855491,1,-2,0,1190,397,395,-2
"0c12af0a4e7f4002852cf84b2537c161","859e0b8d71694b12befb69ee698138f9",22855491,1,5,0,1191,395,399,4
"859e0b8d71694b12befb69ee698138f9","859e0b8d71694b12befb69ee698138f9",22855491,1,0,1,1192,399,399,0
"859e0b8d71694b12befb69ee698138f9","66baf19b6b904b70922329068c63746d",22855491,1,-29,0,1193,399,376,-23
"66baf19b6b904b70922329068c63746d","2b09a08242b54983aec7063990fb3f66",22855491,1,32,0,1194,376,400,24
"2b09a08242b54983aec7063990fb3f66","2b09a08242b54983aec7063990fb3f66",22855491,1,0,1,1195,400,400,0
"2b09a08242b54983aec7063990fb3f66","1f471b7a883a4df48211e8c6a81b59a7",22855491,1,1,0,1196,400,401,1
"1f471b7a883a4df48211e8c6a81b59a7","1f471b7a883a4df48211e8c6a81b59a7",22855491,1,0,1,1197,401,401,0
"1f471b7a883a4df48211e8c6a81b59a7","2b09a08242b54983aec7063990fb3f66",22855491,1,-1,0,1198,401,400,-1
"2b09a08242b54983aec7063990fb3f66","9de0d567bfa84fe5b77cb76f4a76a5d1",22855491,1,5,0,1199,400,404,4
"9de0d567bfa84fe5b77cb76f4a76a5d1","9de0d567bfa84fe5b77cb76f4a76a5d1",22855491,1,0,1,1200,404,404,0
"9de0d567bfa84fe5b77cb76f4a76a5d1","1157bd665ec4472fb58b751dc5099355",22855491,1,-1,0,1201,404,403,-1
"1157bd665ec4472fb58b751dc5099355","3c8a22d2f9c146ea956609e3ed4f2559",22855491,1,3,0,1202,403,405,2
"3c8a22d2f9c146ea956609e3ed4f2559","58fc9094275e4c49be3f4ba6d4acc0a4",22855491,1,2,0,1203,405,406,1
"58fc9094275e4c49be3f4ba6d4acc0a4","c1c1be90b2b14c1ab4a5e1ee3c241902",22855491,1,1,0,1204,406,407,1
"c1c1be90b2b14c1ab4a5e1ee3c241902","c1c1be90b2b14c1ab4a5e1ee3c241902",22855491,5,0,1,1205,407,407,0
"c1c1be90b2b14c1ab4a5e1ee3c241902","02b3a1bead9244c1ba2f857c7da8f82a",22855491,1,2,0,1210,407,408,1
"02b3a1bead9244c1ba2f857c7da8f82a","58fc9094275e4c49be3f4ba6d4acc0a4",22855491,1,-3,0,1211,408,406,-2
"58fc9094275e4c49be3f4ba6d4acc0a4","6206fc6479014bb193084c32409dc1b9",22855491,1,4,0,1212,406,409,3
"6206fc6479014bb193084c32409dc1b9","6206fc6479014bb193084c32409dc1b9",22855491,4,0,1,1213,409,409,0
"6206fc6479014bb193084c32409dc1b9","6a5f020451db426dacba9e2ea3fcc62a",22855491,1,2,0,1217,409,410,1
"6a5f020451db426dacba9e2ea3fcc62a","02b3a1bead9244c1ba2f857c7da8f82a",22855491,1,-3,0,1218,410,408,-2
"02b3a1bead9244c1ba2f857c7da8f82a","6a5f020451db426dacba9e2ea3fcc62a",22855491,1,3,0,1219,408,410,2
"6a5f020451db426dacba9e2ea3fcc62a","33a9d248b2e44588a5b07fc1342b9bc2",22855491,1,2,0,1220,410,411,1
"33a9d248b2e44588a5b07fc1342b9bc2","33a9d248b2e44588a5b07fc1342b9bc2",22855491,2,0,1,1221,411,411,0
"33a9d248b2e44588a5b07fc1342b9bc2","c6f26bd420634f1cb7989e76fe6b16c0",22855491,1,1,0,1223,411,412,1
"c6f26bd420634f1cb7989e76fe6b16c0","c6f26bd420634f1cb7989e76fe6b16c0",22855491,5,0,1,1224,412,412,0
"c6f26bd420634f1cb7989e76fe6b16c0","2a65ee6e2ac64f6a8a55fbe5373ec763",22855491,1,1,0,1229,412,413,1
"2a65ee6e2ac64f6a8a55fbe5373ec763","2a65ee6e2ac64f6a8a55fbe5373ec763",22855491,2,0,1,1230,413,413,0
"2a65ee6e2ac64f6a8a55fbe5373ec763","33a9d248b2e44588a5b07fc1342b9bc2",22855491,1,-2,0,1232,413,411,-2
"33a9d248b2e44588a5b07fc1342b9bc2","1fd0f6dadbc14ebc965faf6122190b96",22855491,1,5,0,1233,411,415,4
"1fd0f6dadbc14ebc965faf6122190b96","1fd0f6dadbc14ebc965faf6122190b96",22855491,1,0,1,1234,415,415,0
"1fd0f6dadbc14ebc965faf6122190b96","687055dad9fc40c3982478fe33ec01bf",22855491,1,-1,0,1235,415,414,-1
"687055dad9fc40c3982478fe33ec01bf","2add1669f08d4101913db15f8c23b3b7",22855491,1,3,0,1236,414,416,2
"2add1669f08d4101913db15f8c23b3b7","2add1669f08d4101913db15f8c23b3b7",22855491,1,0,1,1237,416,416,0
"2add1669f08d4101913db15f8c23b3b7","a2b4bd40cee2481ebd3fc179d6a5cd62",22855491,1,3,0,1238,416,417,1
"a2b4bd40cee2481ebd3fc179d6a5cd62","2b09a08242b54983aec7063990fb3f66",22855491,1,-27,0,1239,417,400,-17
"2b09a08242b54983aec7063990fb3f66","66baf19b6b904b70922329068c63746d",22855491,1,-32,0,1240,400,376,-24
"66baf19b6b904b70922329068c63746d","a2b4bd40cee2481ebd3fc179d6a5cd62",22855491,1,59,0,1241,376,417,41
"a2b4bd40cee2481ebd3fc179d6a5cd62","a2b4bd40cee2481ebd3fc179d6a5cd62",22855491,1,0,1,1242,417,417,0
"a2b4bd40cee2481ebd3fc179d6a5cd62","e34e59dce2204f228f3a84b6725df60f",22855491,1,2,0,1243,417,419,2
"e34e59dce2204f228f3a84b6725df60f","e34e59dce2204f228f3a84b6725df60f",22855491,1,0,1,1244,419,419,0
"e34e59dce2204f228f3a84b6725df60f","a2b4bd40cee2481ebd3fc179d6a5cd62",22855491,1,-2,0,1245,419,417,-2
"a2b4bd40cee2481ebd3fc179d6a5cd62","bec48fc2e1294c7eb3d0aca780d731b8",22855491,1,4,0,1246,417,420,3
"bec48fc2e1294c7eb3d0aca780d731b8","bec48fc2e1294c7eb3d0aca780d731b8",22855491,1,0,1,1247,420,420,0
"bec48fc2e1294c7eb3d0aca780d731b8","a24600b0e49245f6bdba8c893cfeddb0",22855491,1,7,0,1248,420,425,5
"a24600b0e49245f6bdba8c893cfeddb0","dbde19fcce2a4c1abdc7f685c293a23f",22855491,1,-4,0,1249,425,422,-3
"dbde19fcce2a4c1abdc7f685c293a23f","a24600b0e49245f6bdba8c893cfeddb0",22855491,1,4,0,1250,422,425,3
"a24600b0e49245f6bdba8c893cfeddb0","a2b4bd40cee2481ebd3fc179d6a5cd62",22855491,1,-11,0,1251,425,417,-8
"a2b4bd40cee2481ebd3fc179d6a5cd62","24cf8786024543f19b89bc20034e60d7",22855491,1,18,0,1252,417,428,11
"24cf8786024543f19b89bc20034e60d7","f2a73be2f46840b182d7bd095378004e",22855491,1,1,0,1253,428,429,1
"f2a73be2f46840b182d7bd095378004e","604551fd4266430cb860fef58fa7dd61",22855491,1,1,0,1254,429,430,1
"604551fd4266430cb860fef58fa7dd61","604551fd4266430cb860fef58fa7dd61",22855491,4,0,1,1255,430,430,0
"604551fd4266430cb860fef58fa7dd61","dce46f8904594a62a6377a3587aaa663",22855491,1,2,0,1259,430,431,1
"dce46f8904594a62a6377a3587aaa663","24cf8786024543f19b89bc20034e60d7",22855491,1,-4,0,1260,431,428,-3
"24cf8786024543f19b89bc20034e60d7","9b9d0a249052413c869753b99682b0ac",22855491,1,5,0,1261,428,432,4
"9b9d0a249052413c869753b99682b0ac","9b9d0a249052413c869753b99682b0ac",22855491,3,0,1,1262,432,432,0
"9b9d0a249052413c869753b99682b0ac","061c175cc90f45fbad883025394e78dd",22855491,1,1,0,1265,432,433,1
"061c175cc90f45fbad883025394e78dd","061c175cc90f45fbad883025394e78dd",22855491,1,0,1,1266,433,433,0
"061c175cc90f45fbad883025394e78dd","dce46f8904594a62a6377a3587aaa663",22855491,1,-2,0,1267,433,431,-2
"dce46f8904594a62a6377a3587aaa663","74a7f8712e5449c2bc0b43c6f90dafed",22855491,1,5,0,1268,431,435,4
"74a7f8712e5449c2bc0b43c6f90dafed","74a7f8712e5449c2bc0b43c6f90dafed",22855491,1,0,1,1269,435,435,0
"74a7f8712e5449c2bc0b43c6f90dafed","66ada10dde9f43018588f1ced9d477fc",22855491,1,-1,0,1270,435,434,-1
"66ada10dde9f43018588f1ced9d477fc","bf12c96466d840a69bed7020b3f18bb8",22855491,1,3,0,1271,434,436,2
"bf12c96466d840a69bed7020b3f18bb8","bf12c96466d840a69bed7020b3f18bb8",22855491,1,0,1,1272,436,436,0
"bf12c96466d840a69bed7020b3f18bb8","24cf8786024543f19b89bc20034e60d7",22855491,1,-11,0,1273,436,428,-8
"24cf8786024543f19b89bc20034e60d7","070600601c4c439288445d2f0724807d",22855491,1,14,0,1274,428,437,9
"070600601c4c439288445d2f0724807d","1823b6de7d334a7aaabc4570719af4d9",22855491,1,2,0,1275,437,439,2
"1823b6de7d334a7aaabc4570719af4d9","1823b6de7d334a7aaabc4570719af4d9",22855491,14,0,1,1276,439,439,0
"1823b6de7d334a7aaabc4570719af4d9","0380cd76a7d44bc3a4da1f15e4d68f89",22855491,1,2,0,1290,439,440,1
"0380cd76a7d44bc3a4da1f15e4d68f89","070600601c4c439288445d2f0724807d",22855491,1,-4,0,1291,440,437,-3
"070600601c4c439288445d2f0724807d","23b7673c8b5443108c2ef09382834a86",22855491,1,6,0,1292,437,441,4
"23b7673c8b5443108c2ef09382834a86","0380cd76a7d44bc3a4da1f15e4d68f89",22855491,1,-2,0,1293,441,440,-1
"0380cd76a7d44bc3a4da1f15e4d68f89","23b7673c8b5443108c2ef09382834a86",22855491,1,2,0,1294,440,441,1
"23b7673c8b5443108c2ef09382834a86","901e92500aea43c79f19f1b279050668",22855491,1,2,0,1295,441,442,1
"901e92500aea43c79f19f1b279050668","001339db8ced4cf78829ebe8b145449d",22855491,1,1,0,1296,442,443,1
"001339db8ced4cf78829ebe8b145449d","001339db8ced4cf78829ebe8b145449d",22855491,11,0,1,1297,443,443,0
"001339db8ced4cf78829ebe8b145449d","452745e0366e42ae81561bfddebcc6c3",22855491,1,1,0,1308,443,444,1
"452745e0366e42ae81561bfddebcc6c3","452745e0366e42ae81561bfddebcc6c3",22855491,2,0,1,1309,444,444,0
"452745e0366e42ae81561bfddebcc6c3","901e92500aea43c79f19f1b279050668",22855491,1,-2,0,1311,444,442,-2
"901e92500aea43c79f19f1b279050668","4660ff2089114e8db82ceb26a4f329e3",22855491,1,4,0,1312,442,445,3
"4660ff2089114e8db82ceb26a4f329e3","4660ff2089114e8db82ceb26a4f329e3",22855491,1,0,1,1313,445,445,0
"4660ff2089114e8db82ceb26a4f329e3","7bd5586eb9d8484eb74a433ee7bfe499",22855491,1,2,0,1314,445,446,1
"7bd5586eb9d8484eb74a433ee7bfe499","7bd5586eb9d8484eb74a433ee7bfe499",22855491,13,0,1,1315,446,446,0
"7bd5586eb9d8484eb74a433ee7bfe499","8a7f26e690f34dda97be16904518ca99",22855491,1,2,0,1328,446,447,1
"8a7f26e690f34dda97be16904518ca99","8a7f26e690f34dda97be16904518ca99",22855491,1,0,1,1329,447,447,0
"8a7f26e690f34dda97be16904518ca99","070600601c4c439288445d2f0724807d",22855491,1,-16,0,1330,447,437,-10
"070600601c4c439288445d2f0724807d","b2f0d654738f48158edff28e8d3a546e",22855491,1,21,0,1331,437,449,12
"b2f0d654738f48158edff28e8d3a546e","1c6721b1f63f4d30ba7746ea8af02a52",22855491,1,-321,0,1332,449,221,-228
"1c6721b1f63f4d30ba7746ea8af02a52","f53da5fd9bfe412da4b80d4742563b6c",22855491,1,24,0,1333,221,241,20
"f53da5fd9bfe412da4b80d4742563b6c","f53da5fd9bfe412da4b80d4742563b6c",22855491,1,0,1,1334,241,241,0
"f53da5fd9bfe412da4b80d4742563b6c","2ae94c0cea4d480a9d5dca8fb1d7b542",22855491,1,3,0,1335,241,242,1
"2ae94c0cea4d480a9d5dca8fb1d7b542","1c6721b1f63f4d30ba7746ea8af02a52",22855491,2,-27,0,1336,242,221,-21
"1c6721b1f63f4d30ba7746ea8af02a52","1ebf23f9d994469a85206e4c7b1bf5f5",22855491,2,30,0,1337,221,245,24
"1ebf23f9d994469a85206e4c7b1bf5f5","1c6721b1f63f4d30ba7746ea8af02a52",22855491,1,-30,0,1338,245,221,-24
"1c6721b1f63f4d30ba7746ea8af02a52","64dbedb3ce544f6aae8e10e0cf10f16d",22855491,1,23,0,1339,221,240,19
"64dbedb3ce544f6aae8e10e0cf10f16d","66d4fad4f1cf4b46be0750a99ad7a35a",22855491,1,-2,0,1340,240,239,-1
"66d4fad4f1cf4b46be0750a99ad7a35a","66d4fad4f1cf4b46be0750a99ad7a35a",22855491,1,0,1,1341,239,239,0
"66d4fad4f1cf4b46be0750a99ad7a35a","2ae94c0cea4d480a9d5dca8fb1d7b542",22855491,1,6,0,1342,239,242,3
"2ae94c0cea4d480a9d5dca8fb1d7b542","1ebf23f9d994469a85206e4c7b1bf5f5",22855491,1,3,0,1343,242,245,3
"1ebf23f9d994469a85206e4c7b1bf5f5","1ebf23f9d994469a85206e4c7b1bf5f5",22855491,10,0,1,1344,245,245,0
"1ebf23f9d994469a85206e4c7b1bf5f5","85ae675b83e8422da842cfd25596af99",22855491,1,1,0,1354,245,246,1
"85ae675b83e8422da842cfd25596af99","85ae675b83e8422da842cfd25596af99",22855491,1,0,1,1355,246,246,0
"85ae675b83e8422da842cfd25596af99","2ae94c0cea4d480a9d5dca8fb1d7b542",22855491,1,-4,0,1356,246,242,-4
"2ae94c0cea4d480a9d5dca8fb1d7b542","30c9ba177afc49a695625d2bdec40207",22855491,1,9,0,1357,242,250,8
"30c9ba177afc49a695625d2bdec40207","30c9ba177afc49a695625d2bdec40207",22855491,2,0,1,1358,250,250,0
"30c9ba177afc49a695625d2bdec40207","00f61990949545828dd12f1303d47504",22855491,1,8,0,1360,250,256,6
"00f61990949545828dd12f1303d47504","6e83e23f56544a19b94067c1c558d9c0",22855491,1,-11,0,1361,256,247,-9
"6e83e23f56544a19b94067c1c558d9c0","ead7bb4b64e247d2ae632ab8a296b091",22855491,1,13,0,1362,247,258,11
"ead7bb4b64e247d2ae632ab8a296b091","ead7bb4b64e247d2ae632ab8a296b091",22855491,2,0,1,1363,258,258,0
"ead7bb4b64e247d2ae632ab8a296b091","41b0048dde734bb280bac6116baa8e27",22855491,1,1,0,1365,258,259,1
"41b0048dde734bb280bac6116baa8e27","41b0048dde734bb280bac6116baa8e27",22855491,2,0,1,1366,259,259,0
"41b0048dde734bb280bac6116baa8e27","b41c5a094a604ee0915327da5cc0beb7",22855491,1,1,0,1368,259,260,1
"b41c5a094a604ee0915327da5cc0beb7","b41c5a094a604ee0915327da5cc0beb7",22855491,2,0,1,1369,260,260,0
"b41c5a094a604ee0915327da5cc0beb7","d546341988904f069cfa86b21457d9d9",22855491,1,-10,0,1371,260,251,-9
"d546341988904f069cfa86b21457d9d9","28c171777c52431ab6b925073bd63d46",22855491,1,15,0,1372,251,264,13
"28c171777c52431ab6b925073bd63d46","28c171777c52431ab6b925073bd63d46",22855491,12,0,1,1373,264,264,0
"28c171777c52431ab6b925073bd63d46","ac160db940cb49ae8579162b1d52bb5d",22855491,1,2,0,1385,264,266,2
"ac160db940cb49ae8579162b1d52bb5d","ac160db940cb49ae8579162b1d52bb5d",22855491,7,0,1,1386,266,266,0
"ac160db940cb49ae8579162b1d52bb5d","d989ebcfc12a4b669f0100dc1aa14f1e",22855491,1,-12,0,1393,266,255,-11
"d989ebcfc12a4b669f0100dc1aa14f1e","c6fd49b485cc4874b0bbdd9c6171e09c",22855491,1,15,0,1394,255,268,13
"c6fd49b485cc4874b0bbdd9c6171e09c","c6fd49b485cc4874b0bbdd9c6171e09c",22855491,7,0,1,1395,268,268,0
"c6fd49b485cc4874b0bbdd9c6171e09c","44240778a97c4af0937817499b75707b",22855491,1,1,0,1402,268,269,1
"44240778a97c4af0937817499b75707b","44240778a97c4af0937817499b75707b",22855491,2,0,1,1403,269,269,0
"44240778a97c4af0937817499b75707b","7aa76d3e993840d8805f097cbdbcd44b",22855491,1,-9,0,1405,269,261,-8
"7aa76d3e993840d8805f097cbdbcd44b","2ae94c0cea4d480a9d5dca8fb1d7b542",22855491,1,-23,0,1406,261,242,-19
"2ae94c0cea4d480a9d5dca8fb1d7b542","865a4d3b43374da7944dc7d397f566d9",22855491,1,35,0,1407,242,271,29
"865a4d3b43374da7944dc7d397f566d9","865a4d3b43374da7944dc7d397f566d9",22855491,1,0,1,1408,271,271,0
"865a4d3b43374da7944dc7d397f566d9","0d987bed3ffa4ed0b9a2e62e97b7b30f",22855491,1,3,0,1409,271,272,1
"0d987bed3ffa4ed0b9a2e62e97b7b30f","2ae94c0cea4d480a9d5dca8fb1d7b542",22855491,1,-38,0,1410,272,242,-30
"2ae94c0cea4d480a9d5dca8fb1d7b542","a9ac840f098c4bd0a2ee896214ce29cd",22855491,1,-101,0,1411,242,168,-74
"a9ac840f098c4bd0a2ee896214ce29cd","0d987bed3ffa4ed0b9a2e62e97b7b30f",22855491,1,139,0,1412,168,272,104
"0d987bed3ffa4ed0b9a2e62e97b7b30f","0d987bed3ffa4ed0b9a2e62e97b7b30f",22855491,4,0,1,1413,272,272,0
"0d987bed3ffa4ed0b9a2e62e97b7b30f","bb5a47f5ea01454a8b79455422d3b9da",22855491,5,10,0,1414,272,280,8
"bb5a47f5ea01454a8b79455422d3b9da","bb5a47f5ea01454a8b79455422d3b9da",22855491,87,0,1,1415,280,280,0
"bb5a47f5ea01454a8b79455422d3b9da","82ae07bc0c9b4570a41799290d1ef399",22855491,2,-6,0,1416,280,275,-5
"82ae07bc0c9b4570a41799290d1ef399","bb5a47f5ea01454a8b79455422d3b9da",22855491,2,6,0,1417,275,280,5
"bb5a47f5ea01454a8b79455422d3b9da","bc5524e78a8544e2ae2fdc2f3462bbec",22855491,1,-1,0,1427,280,279,-1
"bc5524e78a8544e2ae2fdc2f3462bbec","82ae07bc0c9b4570a41799290d1ef399",22855491,1,-5,0,1428,279,275,-4
"82ae07bc0c9b4570a41799290d1ef399","0d987bed3ffa4ed0b9a2e62e97b7b30f",22855491,1,-4,0,1429,275,272,-3
"bb5a47f5ea01454a8b79455422d3b9da","f67fbf45a5f146ed866965bc57c7c001",22855491,1,254,0,1490,280,454,174
"f67fbf45a5f146ed866965bc57c7c001","f67fbf45a5f146ed866965bc57c7c001",22855491,2,0,1,1491,454,454,0
"f67fbf45a5f146ed866965bc57c7c001","d937afe49bd24a07a550dda1c1155122",22855491,1,1,0,1493,454,455,1
"d937afe49bd24a07a550dda1c1155122","d937afe49bd24a07a550dda1c1155122",22855491,1,0,1,1494,455,455,0
"d937afe49bd24a07a550dda1c1155122","3628b3f7823443d0912a339096b69943",22855491,1,1,0,1495,455,456,1
"3628b3f7823443d0912a339096b69943","3628b3f7823443d0912a339096b69943",22855491,1,0,1,1496,456,456,0
"3628b3f7823443d0912a339096b69943","9e049ee647cf43ecbcb5ed792a8e7588",22855491,1,1,0,1497,456,457,1
"9e049ee647cf43ecbcb5ed792a8e7588","9e049ee647cf43ecbcb5ed792a8e7588",22855491,1,0,1,1498,457,457,0
"9e049ee647cf43ecbcb5ed792a8e7588","5256a214faaf410b93f76cea06428334",22855491,1,1,0,1499,457,458,1
"5256a214faaf410b93f76cea06428334","5256a214faaf410b93f76cea06428334",22855491,1,0,1,1500,458,458,0
"5256a214faaf410b93f76cea06428334","25c32b120fce40fa9b6c85133aeb4716",22855491,1,1,0,1501,458,459,1
"25c32b120fce40fa9b6c85133aeb4716","25c32b120fce40fa9b6c85133aeb4716",22855491,1,0,1,1502,459,459,0
"25c32b120fce40fa9b6c85133aeb4716","11bc14f2204949008b7d511b933363c1",22855491,1,1,0,1503,459,460,1
"11bc14f2204949008b7d511b933363c1","11bc14f2204949008b7d511b933363c1",22855491,1,0,1,1504,460,460,0
"11bc14f2204949008b7d511b933363c1","42de338840a34d15adb66e7b14fb9d2c",22855491,1,1,0,1505,460,461,1
"42de338840a34d15adb66e7b14fb9d2c","42de338840a34d15adb66e7b14fb9d2c",22855491,1,0,1,1506,461,461,0
"42de338840a34d15adb66e7b14fb9d2c","9da37c6210b1416b8079c274f70bf600",22855491,1,1,0,1507,461,462,1
"9da37c6210b1416b8079c274f70bf600","9da37c6210b1416b8079c274f70bf600",22855491,1,0,1,1508,462,462,0
"9da37c6210b1416b8079c274f70bf600","519119f1deac45ff9ab4f13529be5c6e",22855491,1,1,0,1509,462,463,1
"519119f1deac45ff9ab4f13529be5c6e","519119f1deac45ff9ab4f13529be5c6e",22855491,1,0,1,1510,463,463,0
"519119f1deac45ff9ab4f13529be5c6e","c5df9f40ec14463b9dcfdc73df3e9285",22855491,1,3,0,1511,463,464,1
"c5df9f40ec14463b9dcfdc73df3e9285","f67fbf45a5f146ed866965bc57c7c001",22855491,1,-12,0,1512,464,454,-10
"f67fbf45a5f146ed866965bc57c7c001","c5df9f40ec14463b9dcfdc73df3e9285",22855491,1,12,0,1513,454,464,10
"c5df9f40ec14463b9dcfdc73df3e9285","b2f0d654738f48158edff28e8d3a546e",22855491,1,-20,0,1514,464,449,-15
"b2f0d654738f48158edff28e8d3a546e","f60ee41ec635499abd48168342d32c2f",22855491,3,5,0,1515,449,453,4
"f60ee41ec635499abd48168342d32c2f","f60ee41ec635499abd48168342d32c2f",22855491,58,0,1,1516,453,453,0
"f60ee41ec635499abd48168342d32c2f","b2f0d654738f48158edff28e8d3a546e",22855491,1,-5,0,1518,453,449,-4
"f60ee41ec635499abd48168342d32c2f","0d987bed3ffa4ed0b9a2e62e97b7b30f",22855491,2,-261,0,1567,453,272,-181
"bb5a47f5ea01454a8b79455422d3b9da","b2f0d654738f48158edff28e8d3a546e",22855491,1,246,0,1576,280,449,169
"bb5a47f5ea01454a8b79455422d3b9da","0d987bed3ffa4ed0b9a2e62e97b7b30f",22855491,1,-10,0,1598,280,272,-8
"e2911e79efc2420eac45d9f671463d4b","e2911e79efc2420eac45d9f671463d4b",22855679,3,0,1,1,2,2,0
"e2911e79efc2420eac45d9f671463d4b","b613861cecf84ffcab01afb23f660475",22855679,1,-3,0,2,2,1,-1
"b613861cecf84ffcab01afb23f660475","b613861cecf84ffcab01afb23f660475",22855679,4,0,1,3,1,1,0
"b613861cecf84ffcab01afb23f660475","e2911e79efc2420eac45d9f671463d4b",22855679,1,3,0,7,1,2,1
"e2911e79efc2420eac45d9f671463d4b","519d1b8c59404d67b54e96c5c8a830b2",22855679,1,1,0,10,2,3,1
"519d1b8c59404d67b54e96c5c8a830b2","519d1b8c59404d67b54e96c5c8a830b2",22855679,1,0,1,11,3,3,0
"519d1b8c59404d67b54e96c5c8a830b2","531db53f81f646edb0cdcfe0085b03b7",22855679,1,1,0,12,3,4,1
"531db53f81f646edb0cdcfe0085b03b7","531db53f81f646edb0cdcfe0085b03b7",22855679,1,0,1,13,4,4,0
"531db53f81f646edb0cdcfe0085b03b7","4f5f94b2f95141e0a9d53a61da2276da",22855679,1,1,0,14,4,5,1
"4f5f94b2f95141e0a9d53a61da2276da","4f5f94b2f95141e0a9d53a61da2276da",22855679,1,0,1,15,5,5,0
"4f5f94b2f95141e0a9d53a61da2276da","6d541c89590949f99af293c4f2333f67",22855679,1,1,0,16,5,6,1
"6d541c89590949f99af293c4f2333f67","6d541c89590949f99af293c4f2333f67",22855679,1,0,1,17,6,6,0
"6d541c89590949f99af293c4f2333f67","dd5cf0b9fe4c4f1d8f5ff8e4c04879cb",22855679,1,1,0,18,6,7,1
"dd5cf0b9fe4c4f1d8f5ff8e4c04879cb","dd5cf0b9fe4c4f1d8f5ff8e4c04879cb",22855679,1,0,1,19,7,7,0
"dd5cf0b9fe4c4f1d8f5ff8e4c04879cb","f96261861edc426abe2248be4f0a709a",22855679,1,1,0,20,7,8,1
"f96261861edc426abe2248be4f0a709a","f96261861edc426abe2248be4f0a709a",22855679,1,0,1,21,8,8,0
"f96261861edc426abe2248be4f0a709a","66b5e16f4f75454fb5b8172079f0fa83",22855679,1,1,0,22,8,9,1
"66b5e16f4f75454fb5b8172079f0fa83","66b5e16f4f75454fb5b8172079f0fa83",22855679,1,0,1,23,9,9,0
"66b5e16f4f75454fb5b8172079f0fa83","0680571d4698477995e41842c36a54b2",22855679,1,1,0,24,9,10,1
"0680571d4698477995e41842c36a54b2","0680571d4698477995e41842c36a54b2",22855679,1,0,1,25,10,10,0
"0680571d4698477995e41842c36a54b2","9112f2bffece48e08c6d2287be204085",22855679,1,1,0,26,10,11,1
"9112f2bffece48e08c6d2287be204085","9112f2bffece48e08c6d2287be204085",22855679,2,0,1,27,11,11,0
"9112f2bffece48e08c6d2287be204085","e2911e79efc2420eac45d9f671463d4b",22855679,1,-9,0,29,11,2,-9
"e2911e79efc2420eac45d9f671463d4b","56586aa865414f538729c7f7735d2bc6",22855679,1,12,0,30,2,12,10
"56586aa865414f538729c7f7735d2bc6","56586aa865414f538729c7f7735d2bc6",22855679,2,0,1,31,12,12,0
"56586aa865414f538729c7f7735d2bc6","b7f2b31585d94eb3bf86376714aa7070",22855679,2,2,0,33,12,13,1
"b7f2b31585d94eb3bf86376714aa7070","56586aa865414f538729c7f7735d2bc6",22855679,1,-2,0,34,13,12,-1
"b7f2b31585d94eb3bf86376714aa7070","b7f2b31585d94eb3bf86376714aa7070",22855679,1,0,1,36,13,13,0
"b7f2b31585d94eb3bf86376714aa7070","3f1c815879794b929260d224becaff7e",22855679,1,2,0,37,13,14,1
"3f1c815879794b929260d224becaff7e","5c5ceeee4562457ba6d41515aeebfbb1",22855679,1,6,0,38,14,17,3
"5c5ceeee4562457ba6d41515aeebfbb1","81c864a886d54a6b8ff85f7d736f4f95",22855679,2,-4,0,39,17,15,-2
"81c864a886d54a6b8ff85f7d736f4f95","5c5ceeee4562457ba6d41515aeebfbb1",22855679,1,4,0,40,15,17,2
"5c5ceeee4562457ba6d41515aeebfbb1","5c5ceeee4562457ba6d41515aeebfbb1",22855679,1,0,1,41,17,17,0
"5c5ceeee4562457ba6d41515aeebfbb1","eb2a0eb537344a9e891c761662e400b6",22855679,1,-2,0,42,17,16,-1
"eb2a0eb537344a9e891c761662e400b6","5c5ceeee4562457ba6d41515aeebfbb1",22855679,1,2,0,43,16,17,1
"81c864a886d54a6b8ff85f7d736f4f95","9afd71a5298d4333b6849dfce1b9422c",22855679,1,7,0,45,15,18,3
"9afd71a5298d4333b6849dfce1b9422c","56586aa865414f538729c7f7735d2bc6",22855679,1,-13,0,46,18,12,-6
"56586aa865414f538729c7f7735d2bc6","9afd71a5298d4333b6849dfce1b9422c",22855679,1,13,0,47,12,18,6
"9afd71a5298d4333b6849dfce1b9422c","b7719e26494940efa49512aedd0aac79",22855679,3,4,0,48,18,20,2
"b7719e26494940efa49512aedd0aac79","9afd71a5298d4333b6849dfce1b9422c",22855679,3,-4,0,49,20,18,-2
"9afd71a5298d4333b6849dfce1b9422c","d4f45188d3c84a02ba08454e6403a818",22855679,2,9,0,50,18,24,6
"d4f45188d3c84a02ba08454e6403a818","d4c3b003e8274e429d2fa688d73fde6d",22855679,5,-2,0,51,24,22,-2
"d4c3b003e8274e429d2fa688d73fde6d","d4c3b003e8274e429d2fa688d73fde6d",22855679,1,0,1,52,22,22,0
"d4c3b003e8274e429d2fa688d73fde6d","b7719e26494940efa49512aedd0aac79",22855679,4,-3,0,53,22,20,-2
"9afd71a5298d4333b6849dfce1b9422c","9afd71a5298d4333b6849dfce1b9422c",22855679,2,0,1,59,18,18,0
"b7719e26494940efa49512aedd0aac79","d4f45188d3c84a02ba08454e6403a818",22855679,1,5,0,61,20,24,4
"afbf7250b99d47bea07172749483ca97","4e51676dc72045d99c19b9fa7b22f8bc",22855679,2,3,0,66,28,29,1
"4e51676dc72045d99c19b9fa7b22f8bc","afbf7250b99d47bea07172749483ca97",22855679,1,-3,0,67,29,28,-1
"4e51676dc72045d99c19b9fa7b22f8bc","51970cfa30e643e894e66ae85c8024cc",22855679,2,3,0,69,29,31,2
"51970cfa30e643e894e66ae85c8024cc","c9c52446b6294aa5a9c2abaed536c37e",22855679,1,2,0,70,31,32,1
"c9c52446b6294aa5a9c2abaed536c37e","4e51676dc72045d99c19b9fa7b22f8bc",22855679,2,-5,0,71,32,29,-3
"51970cfa30e643e894e66ae85c8024cc","c33c17be71ae4d588da7369472e5bb1b",22855679,1,6,0,73,31,34,3
"c33c17be71ae4d588da7369472e5bb1b","4e51676dc72045d99c19b9fa7b22f8bc",22855679,1,-9,0,74,34,29,-5
"4e51676dc72045d99c19b9fa7b22f8bc","93679be414554a11b1893002f2229a93",22855679,1,12,0,75,29,35,6
"93679be414554a11b1893002f2229a93","c33c17be71ae4d588da7369472e5bb1b",22855679,1,-3,0,76,35,34,-1
"c33c17be71ae4d588da7369472e5bb1b","7040a13096d746ac84b8fac8d9752058",22855679,1,6,0,77,34,36,2
"7040a13096d746ac84b8fac8d9752058","93679be414554a11b1893002f2229a93",22855679,1,-3,0,78,36,35,-1
"93679be414554a11b1893002f2229a93","7040a13096d746ac84b8fac8d9752058",22855679,1,3,0,79,35,36,1
"7040a13096d746ac84b8fac8d9752058","9a0dc646f934470daf08c4b56ccf73db",22855679,1,3,0,80,36,37,1
"9a0dc646f934470daf08c4b56ccf73db","9a0dc646f934470daf08c4b56ccf73db",22855679,1,0,1,81,37,37,0
"9a0dc646f934470daf08c4b56ccf73db","fc0e049d56024bc9a02c9a9c435c3df7",22855679,1,3,0,82,37,38,1
"fc0e049d56024bc9a02c9a9c435c3df7","fc0e049d56024bc9a02c9a9c435c3df7",22855679,1,0,1,83,38,38,0
"fc0e049d56024bc9a02c9a9c435c3df7","67a089198fcb4e1c8f2385786c2b296f",22855679,1,4,0,84,38,39,1
"64d48c6c9c7940639a932219a6c87198","c9c52446b6294aa5a9c2abaed536c37e",22855679,1,-21,0,86,40,32,-8
"4e51676dc72045d99c19b9fa7b22f8bc","c9c52446b6294aa5a9c2abaed536c37e",22855679,1,5,0,88,29,32,3
"c9c52446b6294aa5a9c2abaed536c37e","51970cfa30e643e894e66ae85c8024cc",22855679,1,-2,0,89,32,31,-1
"51970cfa30e643e894e66ae85c8024cc","4e51676dc72045d99c19b9fa7b22f8bc",22855679,1,-3,0,90,31,29,-2
"4e51676dc72045d99c19b9fa7b22f8bc","c33c17be71ae4d588da7369472e5bb1b",22855679,1,9,0,91,29,34,5
"c33c17be71ae4d588da7369472e5bb1b","9afd71a5298d4333b6849dfce1b9422c",22855679,1,-28,0,92,34,18,-16
"d4c3b003e8274e429d2fa688d73fde6d","a49d1bb4328949299686242fd0be5584",22855679,1,-1,0,98,22,21,-1
"b7719e26494940efa49512aedd0aac79","a49d1bb4328949299686242fd0be5584",22855679,2,2,0,100,20,21,1
"a49d1bb4328949299686242fd0be5584","d4c3b003e8274e429d2fa688d73fde6d",22855679,1,1,0,101,21,22,1
"d4c3b003e8274e429d2fa688d73fde6d","d4f45188d3c84a02ba08454e6403a818",22855679,1,2,0,102,22,24,2
"d4f45188d3c84a02ba08454e6403a818","67a089198fcb4e1c8f2385786c2b296f",22855679,1,35,0,103,24,39,15
"67a089198fcb4e1c8f2385786c2b296f","64d48c6c9c7940639a932219a6c87198",22855679,5,1,0,104,39,40,1
"64d48c6c9c7940639a932219a6c87198","67a089198fcb4e1c8f2385786c2b296f",22855679,1,-1,0,105,40,39,-1
"67a089198fcb4e1c8f2385786c2b296f","67a089198fcb4e1c8f2385786c2b296f",22855679,1,0,1,106,39,39,0
"64d48c6c9c7940639a932219a6c87198","64d48c6c9c7940639a932219a6c87198",22855679,2,0,1,108,40,40,0
"64d48c6c9c7940639a932219a6c87198","b534b89233134e30a9b5645138bfa9ee",22855679,1,3,0,110,40,41,1
"b534b89233134e30a9b5645138bfa9ee","67a089198fcb4e1c8f2385786c2b296f",22855679,1,-4,0,111,41,39,-2
"67a089198fcb4e1c8f2385786c2b296f","0e37b720d23b4e7f8b313e79313fd107",22855679,1,7,0,112,39,44,5
"0e37b720d23b4e7f8b313e79313fd107","0e37b720d23b4e7f8b313e79313fd107",22855679,1,0,1,113,44,44,0
"0e37b720d23b4e7f8b313e79313fd107","6875d67fdd5f48168b62719df449bebd",22855679,1,1,0,114,44,45,1
"6875d67fdd5f48168b62719df449bebd","6875d67fdd5f48168b62719df449bebd",22855679,1,0,1,115,45,45,0
"6875d67fdd5f48168b62719df449bebd","6e13d61a7bdb44bca949c9f86fab3be5",22855679,1,3,0,116,45,47,2
"6e13d61a7bdb44bca949c9f86fab3be5","b534b89233134e30a9b5645138bfa9ee",22855679,1,-7,0,117,47,41,-6
"b534b89233134e30a9b5645138bfa9ee","6e13d61a7bdb44bca949c9f86fab3be5",22855679,2,7,0,118,41,47,6
"6e13d61a7bdb44bca949c9f86fab3be5","195f78799f984cc2b06c48dfe36be751",22855679,1,2,0,119,47,49,2
"195f78799f984cc2b06c48dfe36be751","195f78799f984cc2b06c48dfe36be751",22855679,2,0,1,120,49,49,0
"195f78799f984cc2b06c48dfe36be751","d9c8d8c444a64dadbbb508652c721e17",22855679,1,-3,0,122,49,46,-3
"d9c8d8c444a64dadbbb508652c721e17","d0c74f735e024943943e40333d6d337f",22855679,2,6,0,123,46,51,5
"d0c74f735e024943943e40333d6d337f","d0c74f735e024943943e40333d6d337f",22855679,1,0,1,124,51,51,0
"d0c74f735e024943943e40333d6d337f","983f8ff320594b279a7f4a6fe132f9c5",22855679,1,2,0,125,51,53,2
"983f8ff320594b279a7f4a6fe132f9c5","983f8ff320594b279a7f4a6fe132f9c5",22855679,2,0,1,126,53,53,0
"983f8ff320594b279a7f4a6fe132f9c5","35adfa5d923046aebabfefd98f35ff05",22855679,1,1,0,128,53,54,1
"35adfa5d923046aebabfefd98f35ff05","35adfa5d923046aebabfefd98f35ff05",22855679,2,0,1,129,54,54,0
"35adfa5d923046aebabfefd98f35ff05","b6f8a98476224da1b40e555ececc7ed8",22855679,1,1,0,131,54,55,1
"b6f8a98476224da1b40e555ececc7ed8","b6f8a98476224da1b40e555ececc7ed8",22855679,2,0,1,132,55,55,0
"b6f8a98476224da1b40e555ececc7ed8","86e22cb5fe0e4b47a9489ecddf7ed78f",22855679,1,1,0,134,55,56,1
"86e22cb5fe0e4b47a9489ecddf7ed78f","86e22cb5fe0e4b47a9489ecddf7ed78f",22855679,2,0,1,135,56,56,0
"86e22cb5fe0e4b47a9489ecddf7ed78f","78f30e4dcac84e3cbea8b2cc6e0d62b3",22855679,1,4,0,137,56,59,3
"78f30e4dcac84e3cbea8b2cc6e0d62b3","a1f2f12debe5432fb7a70bcd12bacfb9",22855679,1,-1,0,138,59,58,-1
"a1f2f12debe5432fb7a70bcd12bacfb9","f924752d8a1149668870b1e7698486f7",22855679,1,-9,0,139,58,50,-8
"f924752d8a1149668870b1e7698486f7","a1f2f12debe5432fb7a70bcd12bacfb9",22855679,1,9,0,140,50,58,8
"a1f2f12debe5432fb7a70bcd12bacfb9","a1f2f12debe5432fb7a70bcd12bacfb9",22855679,14,0,1,141,58,58,0
"a1f2f12debe5432fb7a70bcd12bacfb9","78f30e4dcac84e3cbea8b2cc6e0d62b3",22855679,1,1,0,155,58,59,1
"78f30e4dcac84e3cbea8b2cc6e0d62b3","78f30e4dcac84e3cbea8b2cc6e0d62b3",22855679,12,0,1,156,59,59,0
"78f30e4dcac84e3cbea8b2cc6e0d62b3","a0a418b8540d479fa6e0f653b701da8b",22855679,1,6,0,168,59,64,5
"a0a418b8540d479fa6e0f653b701da8b","bc42d26810654ea9a1df1efe1e58c7d5",22855679,2,-1,0,169,64,63,-1
"bc42d26810654ea9a1df1efe1e58c7d5","12aa6e1672ac4e7aa6449a7a8609cd72",22855679,1,-7,0,170,63,57,-6
"12aa6e1672ac4e7aa6449a7a8609cd72","4c943503763e4e349906eea3ed3c8e86",22855679,1,5,0,171,57,61,4
"4c943503763e4e349906eea3ed3c8e86","4c943503763e4e349906eea3ed3c8e86",22855679,1,0,1,172,61,61,0
"4c943503763e4e349906eea3ed3c8e86","bc42d26810654ea9a1df1efe1e58c7d5",22855679,1,2,0,173,61,63,2
"bc42d26810654ea9a1df1efe1e58c7d5","bc42d26810654ea9a1df1efe1e58c7d5",22855679,5,0,1,174,63,63,0
"bc42d26810654ea9a1df1efe1e58c7d5","a0a418b8540d479fa6e0f653b701da8b",22855679,1,1,0,177,63,64,1
"a0a418b8540d479fa6e0f653b701da8b","a0a418b8540d479fa6e0f653b701da8b",22855679,5,0,1,178,64,64,0
"a0a418b8540d479fa6e0f653b701da8b","309ccf3cc4fe429d9bfbaef53d3fa479",22855679,1,-4,0,181,64,60,-4
"309ccf3cc4fe429d9bfbaef53d3fa479","b534b89233134e30a9b5645138bfa9ee",22855679,2,-23,0,182,60,41,-19
"b534b89233134e30a9b5645138bfa9ee","309ccf3cc4fe429d9bfbaef53d3fa479",22855679,1,23,0,183,41,60,19
"309ccf3cc4fe429d9bfbaef53d3fa479","a0a418b8540d479fa6e0f653b701da8b",22855679,1,4,0,184,60,64,4
"bc42d26810654ea9a1df1efe1e58c7d5","309ccf3cc4fe429d9bfbaef53d3fa479",22855679,1,-3,0,190,63,60,-3
"b534b89233134e30a9b5645138bfa9ee","d646286c8051419bbc2e31dd1db55ca8",22855679,1,33,0,192,41,67,26
"d646286c8051419bbc2e31dd1db55ca8","67a089198fcb4e1c8f2385786c2b296f",22855679,1,-37,0,193,67,39,-28
"64d48c6c9c7940639a932219a6c87198","d646286c8051419bbc2e31dd1db55ca8",22855679,1,36,0,195,40,67,27
"d646286c8051419bbc2e31dd1db55ca8","267f883678b24aed855fde42524975d9",22855679,1,4,0,196,67,71,4
"267f883678b24aed855fde42524975d9","267f883678b24aed855fde42524975d9",22855679,1,0,1,197,71,71,0
"267f883678b24aed855fde42524975d9","88fff56d0342490dbef9040750a20f6c",22855679,1,1,0,198,71,72,1
"88fff56d0342490dbef9040750a20f6c","88fff56d0342490dbef9040750a20f6c",22855679,1,0,1,199,72,72,0
"88fff56d0342490dbef9040750a20f6c","adb17b12b66c4a49a85fd34322f7df70",22855679,1,1,0,200,72,73,1
"adb17b12b66c4a49a85fd34322f7df70","adb17b12b66c4a49a85fd34322f7df70",22855679,1,0,1,201,73,73,0
"adb17b12b66c4a49a85fd34322f7df70","d646286c8051419bbc2e31dd1db55ca8",22855679,1,-6,0,202,73,67,-6
"d646286c8051419bbc2e31dd1db55ca8","a2becd407db34b189200a32546d9d569",22855679,1,9,0,203,67,75,8
"a2becd407db34b189200a32546d9d569","a2becd407db34b189200a32546d9d569",22855679,2,0,1,204,75,75,0
"a2becd407db34b189200a32546d9d569","58c22b011d0f4c2ea6d13615edbb9eeb",22855679,1,2,0,206,75,77,2
"58c22b011d0f4c2ea6d13615edbb9eeb","58c22b011d0f4c2ea6d13615edbb9eeb",22855679,2,0,1,207,77,77,0
"58c22b011d0f4c2ea6d13615edbb9eeb","dd76e1861dc9461c830888729d091ee0",22855679,1,1,0,209,77,78,1
"dd76e1861dc9461c830888729d091ee0","dd76e1861dc9461c830888729d091ee0",22855679,8,0,1,210,78,78,0
"dd76e1861dc9461c830888729d091ee0","cd1d828f1a694b87913a7ea66c23803e",22855679,1,1,0,218,78,79,1
"cd1d828f1a694b87913a7ea66c23803e","cd1d828f1a694b87913a7ea66c23803e",22855679,2,0,1,219,79,79,0
"cd1d828f1a694b87913a7ea66c23803e","9176a3c2b4d2465fa8b0c67096c2a97e",22855679,1,1,0,221,79,80,1
"9176a3c2b4d2465fa8b0c67096c2a97e","9176a3c2b4d2465fa8b0c67096c2a97e",22855679,5,0,1,222,80,80,0
"9176a3c2b4d2465fa8b0c67096c2a97e","f8ec6445f7194e25b9101d4fbcb07a18",22855679,1,1,0,227,80,81,1
"f8ec6445f7194e25b9101d4fbcb07a18","f8ec6445f7194e25b9101d4fbcb07a18",22855679,2,0,1,228,81,81,0
"f8ec6445f7194e25b9101d4fbcb07a18","140d5b27b8574befad82c0a013b59dfa",22855679,1,-7,0,230,81,74,-7
"140d5b27b8574befad82c0a013b59dfa","d18a9ea32855445f8736581f5cb119ce",22855679,1,9,0,231,74,82,8
"d18a9ea32855445f8736581f5cb119ce","f564483cbd7a407681aa2fcca518cf5f",22855679,1,4,0,232,82,85,3
"f564483cbd7a407681aa2fcca518cf5f","f564483cbd7a407681aa2fcca518cf5f",22855679,1,0,1,233,85,85,0
"f564483cbd7a407681aa2fcca518cf5f","18fd01350bd5434ca636d59a599d768a",22855679,1,1,0,234,85,86,1
"18fd01350bd5434ca636d59a599d768a","18fd01350bd5434ca636d59a599d768a",22855679,9,0,1,235,86,86,0
"18fd01350bd5434ca636d59a599d768a","ae5ac430ea254e708a6f5deaaf7464ae",22855679,1,-2,0,244,86,84,-2
"ae5ac430ea254e708a6f5deaaf7464ae","6a9f0ef185fb47f0937e29daa1c71ed5",22855679,1,7,0,245,84,90,6
"6a9f0ef185fb47f0937e29daa1c71ed5","42fb58708eaf4e5daa82bfca61b6f5fd",22855679,1,-3,0,246,90,87,-3
"42fb58708eaf4e5daa82bfca61b6f5fd","ae5ac430ea254e708a6f5deaaf7464ae",22855679,1,-4,0,247,87,84,-3
"ae5ac430ea254e708a6f5deaaf7464ae","d18a9ea32855445f8736581f5cb119ce",22855679,1,-3,0,248,84,82,-2
"d18a9ea32855445f8736581f5cb119ce","6a9f0ef185fb47f0937e29daa1c71ed5",22855679,1,10,0,249,82,90,8
"6a9f0ef185fb47f0937e29daa1c71ed5","c681290961c94c4caf23b529d1ae6b9a",22855679,1,-2,0,250,90,88,-2
"c681290961c94c4caf23b529d1ae6b9a","c681290961c94c4caf23b529d1ae6b9a",22855679,1,0,1,251,88,88,0
"c681290961c94c4caf23b529d1ae6b9a","d646286c8051419bbc2e31dd1db55ca8",22855679,1,-25,0,252,88,67,-21
"d646286c8051419bbc2e31dd1db55ca8","e20db35ced8544ddac5bc3839145e463",22855679,1,30,0,253,67,91,24
"e20db35ced8544ddac5bc3839145e463","1febb706d7a34005ae8711ed49c76e64",22855679,1,3,0,254,91,94,3
"1febb706d7a34005ae8711ed49c76e64","1febb706d7a34005ae8711ed49c76e64",22855679,2,0,1,255,94,94,0
"1febb706d7a34005ae8711ed49c76e64","8f73ba6f5a0042f2850356ac38ac6f24",22855679,1,1,0,257,94,95,1
"8f73ba6f5a0042f2850356ac38ac6f24","8f73ba6f5a0042f2850356ac38ac6f24",22855679,5,0,1,258,95,95,0
"8f73ba6f5a0042f2850356ac38ac6f24","e2260b86653c46d7b14a41fb419dbf8c",22855679,1,1,0,263,95,96,1
"e2260b86653c46d7b14a41fb419dbf8c","e2260b86653c46d7b14a41fb419dbf8c",22855679,2,0,1,264,96,96,0
"e2260b86653c46d7b14a41fb419dbf8c","35eb641ad1d845bbba54915bce75a962",22855679,1,1,0,266,96,97,1
"35eb641ad1d845bbba54915bce75a962","35eb641ad1d845bbba54915bce75a962",22855679,2,0,1,267,97,97,0
"35eb641ad1d845bbba54915bce75a962","08be90ffbeea4795a138cd42ed8db56f",22855679,1,1,0,269,97,98,1
"08be90ffbeea4795a138cd42ed8db56f","08be90ffbeea4795a138cd42ed8db56f",22855679,6,0,1,270,98,98,0
"08be90ffbeea4795a138cd42ed8db56f","3007433c8f584dcbb5ac159c1c5f2be3",22855679,1,1,0,276,98,99,1
"3007433c8f584dcbb5ac159c1c5f2be3","3007433c8f584dcbb5ac159c1c5f2be3",22855679,5,0,1,277,99,99,0
"3007433c8f584dcbb5ac159c1c5f2be3","d391c8b6e56a43a7b654e9dee02d904b",22855679,1,5,0,282,99,103,4
"d391c8b6e56a43a7b654e9dee02d904b","e20db35ced8544ddac5bc3839145e463",22855679,1,-13,0,283,103,91,-12
"e20db35ced8544ddac5bc3839145e463","00ae5f0c51874a73a41ebea838d95682",22855679,2,11,0,284,91,101,10
"00ae5f0c51874a73a41ebea838d95682","00ae5f0c51874a73a41ebea838d95682",22855679,1,0,1,285,101,101,0
"00ae5f0c51874a73a41ebea838d95682","d391c8b6e56a43a7b654e9dee02d904b",22855679,2,2,0,286,101,103,2
"d391c8b6e56a43a7b654e9dee02d904b","d391c8b6e56a43a7b654e9dee02d904b",22855679,15,0,1,287,103,103,0
"d391c8b6e56a43a7b654e9dee02d904b","6111116566fc4fd9abba409322bea245",22855679,1,1,0,302,103,104,1
"6111116566fc4fd9abba409322bea245","6111116566fc4fd9abba409322bea245",22855679,2,0,1,303,104,104,0
"6111116566fc4fd9abba409322bea245","a81b2235cb9c499eb9ea8ee0a8dd9725",22855679,1,1,0,305,104,105,1
"a81b2235cb9c499eb9ea8ee0a8dd9725","a81b2235cb9c499eb9ea8ee0a8dd9725",22855679,2,0,1,306,105,105,0
"a81b2235cb9c499eb9ea8ee0a8dd9725","2d4e0ab0ef3b4d73b82c72d4621a7579",22855679,1,1,0,308,105,106,1
"2d4e0ab0ef3b4d73b82c72d4621a7579","2d4e0ab0ef3b4d73b82c72d4621a7579",22855679,2,0,1,309,106,106,0
"2d4e0ab0ef3b4d73b82c72d4621a7579","8bdebf492ebd4e62b0d522e8ab5e5197",22855679,1,1,0,311,106,107,1
"8bdebf492ebd4e62b0d522e8ab5e5197","8bdebf492ebd4e62b0d522e8ab5e5197",22855679,2,0,1,312,107,107,0
"8bdebf492ebd4e62b0d522e8ab5e5197","4280927ec4d643238aa49c32f9e06c6c",22855679,1,3,0,314,107,109,2
"4280927ec4d643238aa49c32f9e06c6c","73039f8c1eb9409cb4caee2cf968001e",22855679,1,-10,0,315,109,100,-9
"73039f8c1eb9409cb4caee2cf968001e","4280927ec4d643238aa49c32f9e06c6c",22855679,1,10,0,316,100,109,9
"4280927ec4d643238aa49c32f9e06c6c","4280927ec4d643238aa49c32f9e06c6c",22855679,1,0,1,317,109,109,0
"4280927ec4d643238aa49c32f9e06c6c","fc44e6a5f7654430af1227838224dceb",22855679,1,2,0,318,109,111,2
"fc44e6a5f7654430af1227838224dceb","fc44e6a5f7654430af1227838224dceb",22855679,2,0,1,319,111,111,0
"fc44e6a5f7654430af1227838224dceb","08111f75e22d409998cf8b85bd431f0a",22855679,1,-3,0,321,111,108,-3
"08111f75e22d409998cf8b85bd431f0a","a9ae0a3c070d455bb4369a8996313336",22855679,1,7,0,322,108,114,6
"a9ae0a3c070d455bb4369a8996313336","a9ae0a3c070d455bb4369a8996313336",22855679,1,0,1,323,114,114,0
"a9ae0a3c070d455bb4369a8996313336","e20db35ced8544ddac5bc3839145e463",22855679,1,-26,0,324,114,91,-23
"e20db35ced8544ddac5bc3839145e463","e20db35ced8544ddac5bc3839145e463",22855679,1,0,1,325,91,91,0
"e20db35ced8544ddac5bc3839145e463","a9ae0a3c070d455bb4369a8996313336",22855679,1,26,0,326,91,114,23
"a9ae0a3c070d455bb4369a8996313336","71cec822bcff4f30a20e75dc63ef7b65",22855679,1,2,0,327,114,116,2
"71cec822bcff4f30a20e75dc63ef7b65","71cec822bcff4f30a20e75dc63ef7b65",22855679,1,0,1,328,116,116,0
"71cec822bcff4f30a20e75dc63ef7b65","37319e88176d4aefa91d7a9980dbae91",22855679,1,-4,0,329,116,112,-4
"37319e88176d4aefa91d7a9980dbae91","62bff51286ef4f348717a3cf6fe2318f",22855679,1,9,0,330,112,120,8
"62bff51286ef4f348717a3cf6fe2318f","3ec3a3563847406fa73338f9e9999cf3",22855679,2,-3,0,331,120,117,-3
"3ec3a3563847406fa73338f9e9999cf3","e20db35ced8544ddac5bc3839145e463",22855679,1,-30,0,332,117,91,-26
"e20db35ced8544ddac5bc3839145e463","62bff51286ef4f348717a3cf6fe2318f",22855679,1,33,0,333,91,120,29
"3ec3a3563847406fa73338f9e9999cf3","62bff51286ef4f348717a3cf6fe2318f",22855679,1,3,0,335,117,120,3
"62bff51286ef4f348717a3cf6fe2318f","e20db35ced8544ddac5bc3839145e463",22855679,1,-33,0,336,120,91,-29
"e20db35ced8544ddac5bc3839145e463","b1cd0e7dc3ad4a8eb91a4bfdbeb025b0",22855679,1,31,0,337,91,118,27
"b1cd0e7dc3ad4a8eb91a4bfdbeb025b0","b1cd0e7dc3ad4a8eb91a4bfdbeb025b0",22855679,1,0,1,338,118,118,0
"b1cd0e7dc3ad4a8eb91a4bfdbeb025b0","62bff51286ef4f348717a3cf6fe2318f",22855679,1,2,0,339,118,120,2
"62bff51286ef4f348717a3cf6fe2318f","62bff51286ef4f348717a3cf6fe2318f",22855679,3,0,1,340,120,120,0
"62bff51286ef4f348717a3cf6fe2318f","779f9ddd1fd14d1e9e69f72219a1fdbd",22855679,1,3,0,343,120,121,1
"779f9ddd1fd14d1e9e69f72219a1fdbd","e20db35ced8544ddac5bc3839145e463",22855679,1,-36,0,344,121,91,-30
"e20db35ced8544ddac5bc3839145e463","779f9ddd1fd14d1e9e69f72219a1fdbd",22855679,1,36,0,345,91,121,30
"779f9ddd1fd14d1e9e69f72219a1fdbd","779f9ddd1fd14d1e9e69f72219a1fdbd",22855679,1,0,1,346,121,121,0
"779f9ddd1fd14d1e9e69f72219a1fdbd","ae26e6cda8ad4a3f81bd347560d9579f",22855679,1,4,0,347,121,125,4
"ae26e6cda8ad4a3f81bd347560d9579f","ae26e6cda8ad4a3f81bd347560d9579f",22855679,1,0,1,348,125,125,0
"ae26e6cda8ad4a3f81bd347560d9579f","ee48df95832b4374aa273ceb27ec1315",22855679,1,1,0,349,125,126,1
"ee48df95832b4374aa273ceb27ec1315","ee48df95832b4374aa273ceb27ec1315",22855679,1,0,1,350,126,126,0
"ee48df95832b4374aa273ceb27ec1315","7a439da90b394756ad1777fc4c6dead5",22855679,1,1,0,351,126,127,1
"7a439da90b394756ad1777fc4c6dead5","7a439da90b394756ad1777fc4c6dead5",22855679,1,0,1,352,127,127,0
"7a439da90b394756ad1777fc4c6dead5","a8dd5213034441ac92724b4e83eb0bb2",22855679,1,3,0,353,127,129,2
"a8dd5213034441ac92724b4e83eb0bb2","779f9ddd1fd14d1e9e69f72219a1fdbd",22855679,1,-9,0,354,129,121,-8
"779f9ddd1fd14d1e9e69f72219a1fdbd","a8dd5213034441ac92724b4e83eb0bb2",22855679,2,9,0,355,121,129,8
"a8dd5213034441ac92724b4e83eb0bb2","8115eab6556b45f5b415c3b8c26a12e5",22855679,2,2,0,356,129,131,2
"8115eab6556b45f5b415c3b8c26a12e5","8115eab6556b45f5b415c3b8c26a12e5",22855679,4,0,1,357,131,131,0
"8115eab6556b45f5b415c3b8c26a12e5","ec34b06efd844b46a4c4818ecdb9b8f4",22855679,2,1,0,359,131,132,1
"ec34b06efd844b46a4c4818ecdb9b8f4","ec34b06efd844b46a4c4818ecdb9b8f4",22855679,4,0,1,360,132,132,0
"ec34b06efd844b46a4c4818ecdb9b8f4","c2e1c2b9eac64109b343a088584b576b",22855679,2,1,0,362,132,133,1
"c2e1c2b9eac64109b343a088584b576b","c2e1c2b9eac64109b343a088584b576b",22855679,4,0,1,363,133,133,0
"c2e1c2b9eac64109b343a088584b576b","579338175e0b4bbb8ef3b712b5d8b54e",22855679,2,-5,0,365,133,128,-5
"579338175e0b4bbb8ef3b712b5d8b54e","579338175e0b4bbb8ef3b712b5d8b54e",22855679,1,0,1,366,128,128,0
"579338175e0b4bbb8ef3b712b5d8b54e","779f9ddd1fd14d1e9e69f72219a1fdbd",22855679,1,-8,0,367,128,121,-7
"a8dd5213034441ac92724b4e83eb0bb2","579338175e0b4bbb8ef3b712b5d8b54e",22855679,1,-1,0,369,129,128,-1
"579338175e0b4bbb8ef3b712b5d8b54e","b416d47c56a742199b5d7c7f19d6503a",22855679,1,7,0,370,128,134,6
"b416d47c56a742199b5d7c7f19d6503a","a8dd5213034441ac92724b4e83eb0bb2",22855679,1,-6,0,371,134,129,-5
"a8dd5213034441ac92724b4e83eb0bb2","a8dd5213034441ac92724b4e83eb0bb2",22855679,2,0,1,372,129,129,0
"579338175e0b4bbb8ef3b712b5d8b54e","8bc5795d6a984a3eace4e2811e52dd4f",22855679,1,8,0,384,128,135,7
"8bc5795d6a984a3eace4e2811e52dd4f","8bc5795d6a984a3eace4e2811e52dd4f",22855679,1,0,1,385,135,135,0
"8bc5795d6a984a3eace4e2811e52dd4f","b416d47c56a742199b5d7c7f19d6503a",22855679,1,-1,0,386,135,134,-1
"b416d47c56a742199b5d7c7f19d6503a","cd4532ad48034873ba8bce2aac0c9808",22855679,1,4,0,387,134,137,3
"cd4532ad48034873ba8bce2aac0c9808","cd4532ad48034873ba8bce2aac0c9808",22855679,2,0,1,388,137,137,0
"cd4532ad48034873ba8bce2aac0c9808","df1de691dafe4549a18a4398ee9dfaf9",22855679,1,4,0,390,137,139,2
"df1de691dafe4549a18a4398ee9dfaf9","779f9ddd1fd14d1e9e69f72219a1fdbd",22855679,1,-23,0,391,139,121,-18
"779f9ddd1fd14d1e9e69f72219a1fdbd","6c5ad271a44743479bfaea29b1db8d02",22855679,1,27,0,392,121,143,22
"6c5ad271a44743479bfaea29b1db8d02","78adeee1fa2c4fe0bc73f7bca9fcee86",22855679,1,22,0,393,143,160,17
"78adeee1fa2c4fe0bc73f7bca9fcee86","78adeee1fa2c4fe0bc73f7bca9fcee86",22855679,1,0,1,394,160,160,0
"78adeee1fa2c4fe0bc73f7bca9fcee86","65202579580f4ad38d734b4ee39d22a8",22855679,3,5,0,395,160,164,4
"65202579580f4ad38d734b4ee39d22a8","65202579580f4ad38d734b4ee39d22a8",22855679,58,0,1,396,164,164,0
"65202579580f4ad38d734b4ee39d22a8","78adeee1fa2c4fe0bc73f7bca9fcee86",22855679,1,-5,0,401,164,160,-4
"65202579580f4ad38d734b4ee39d22a8","67a089198fcb4e1c8f2385786c2b296f",22855679,1,-157,0,404,164,39,-125
"64d48c6c9c7940639a932219a6c87198","df1de691dafe4549a18a4398ee9dfaf9",22855679,1,125,0,406,40,139,99
"df1de691dafe4549a18a4398ee9dfaf9","df1de691dafe4549a18a4398ee9dfaf9",22855679,1,0,1,407,139,139,0
"df1de691dafe4549a18a4398ee9dfaf9","6c5ad271a44743479bfaea29b1db8d02",22855679,1,4,0,408,139,143,4
"6c5ad271a44743479bfaea29b1db8d02","6c5ad271a44743479bfaea29b1db8d02",22855679,2,0,1,409,143,143,0
"6c5ad271a44743479bfaea29b1db8d02","83d311bed5374fee83d8d67a7d9d82dc",22855679,1,1,0,411,143,144,1
"83d311bed5374fee83d8d67a7d9d82dc","83d311bed5374fee83d8d67a7d9d82dc",22855679,1,0,1,412,144,144,0
"83d311bed5374fee83d8d67a7d9d82dc","402bba41861d43acb52a5abb89e8831e",22855679,1,1,0,413,144,145,1
"402bba41861d43acb52a5abb89e8831e","402bba41861d43acb52a5abb89e8831e",22855679,2,0,1,414,145,145,0
"402bba41861d43acb52a5abb89e8831e","df1de691dafe4549a18a4398ee9dfaf9",22855679,1,-6,0,416,145,139,-6
"df1de691dafe4549a18a4398ee9dfaf9","8aae34f5ddbb4052a709b12e6b0d40fa",22855679,1,9,0,417,139,147,8
"8aae34f5ddbb4052a709b12e6b0d40fa","8aae34f5ddbb4052a709b12e6b0d40fa",22855679,1,0,1,418,147,147,0
"8aae34f5ddbb4052a709b12e6b0d40fa","645b3f0249f64f76af2e19eb4d0e55b7",22855679,1,2,0,419,147,149,2
"645b3f0249f64f76af2e19eb4d0e55b7","645b3f0249f64f76af2e19eb4d0e55b7",22855679,2,0,1,420,149,149,0
"645b3f0249f64f76af2e19eb4d0e55b7","7e7b8db5064d4369805ab370aac5ddfb",22855679,1,1,0,422,149,150,1
"7e7b8db5064d4369805ab370aac5ddfb","7e7b8db5064d4369805ab370aac5ddfb",22855679,2,0,1,423,150,150,0
"7e7b8db5064d4369805ab370aac5ddfb","8956d210ae7f41968fada86d4c979d6a",22855679,1,1,0,425,150,151,1
"8956d210ae7f41968fada86d4c979d6a","8956d210ae7f41968fada86d4c979d6a",22855679,2,0,1,426,151,151,0
"8956d210ae7f41968fada86d4c979d6a","f902b0f41b544d4dbf79664fd233648d",22855679,1,-5,0,428,151,146,-5
"f902b0f41b544d4dbf79664fd233648d","ae781e8b775e4ccd93bc800dad5c8376",22855679,1,8,0,429,146,153,7
"ae781e8b775e4ccd93bc800dad5c8376","ae781e8b775e4ccd93bc800dad5c8376",22855679,2,0,1,430,153,153,0
"ae781e8b775e4ccd93bc800dad5c8376","06882a8492d9499aa31555567f575ecb",22855679,1,1,0,432,153,154,1
"06882a8492d9499aa31555567f575ecb","06882a8492d9499aa31555567f575ecb",22855679,1,0,1,433,154,154,0
"06882a8492d9499aa31555567f575ecb","f293c508f409466a8f27ddd7d1e40b20",22855679,1,1,0,434,154,155,1
"f293c508f409466a8f27ddd7d1e40b20","f293c508f409466a8f27ddd7d1e40b20",22855679,2,0,1,435,155,155,0
"f293c508f409466a8f27ddd7d1e40b20","cc4ddef5bbbe48ebb605141b347c4ed1",22855679,1,1,0,437,155,156,1
"cc4ddef5bbbe48ebb605141b347c4ed1","cc4ddef5bbbe48ebb605141b347c4ed1",22855679,1,0,1,438,156,156,0
"cc4ddef5bbbe48ebb605141b347c4ed1","f03480cf4eba413194d7af52fc0e7f28",22855679,1,-4,0,439,156,152,-4
"f03480cf4eba413194d7af52fc0e7f28","d313cec988a84645bee413e8d4724a4b",22855679,1,7,0,440,152,158,6
"d313cec988a84645bee413e8d4724a4b","d313cec988a84645bee413e8d4724a4b",22855679,4,0,1,441,158,158,0
"d313cec988a84645bee413e8d4724a4b","dc60696c76a74368a60f72246e47700d",22855679,1,1,0,445,158,159,1
"dc60696c76a74368a60f72246e47700d","dc60696c76a74368a60f72246e47700d",22855679,1,0,1,446,159,159,0
"dc60696c76a74368a60f72246e47700d","78adeee1fa2c4fe0bc73f7bca9fcee86",22855679,1,3,0,447,159,160,1
"78adeee1fa2c4fe0bc73f7bca9fcee86","df1de691dafe4549a18a4398ee9dfaf9",22855679,1,-26,0,448,160,139,-21
"df1de691dafe4549a18a4398ee9dfaf9","d9c8d8c444a64dadbbb508652c721e17",22855679,1,-116,0,449,139,46,-93
"d9c8d8c444a64dadbbb508652c721e17","b534b89233134e30a9b5645138bfa9ee",22855679,1,-6,0,450,46,41,-5
"6e13d61a7bdb44bca949c9f86fab3be5","d9c8d8c444a64dadbbb508652c721e17",22855679,1,-1,0,452,47,46,-1
"d0c74f735e024943943e40333d6d337f","6e13d61a7bdb44bca949c9f86fab3be5",22855679,1,-5,0,454,51,47,-4
"6e13d61a7bdb44bca949c9f86fab3be5","f924752d8a1149668870b1e7698486f7",22855679,1,4,0,455,47,50,3
"f924752d8a1149668870b1e7698486f7","d646286c8051419bbc2e31dd1db55ca8",22855679,1,22,0,456,50,67,17
"d646286c8051419bbc2e31dd1db55ca8","d18a9ea32855445f8736581f5cb119ce",22855679,2,17,0,457,67,82,15
"d18a9ea32855445f8736581f5cb119ce","73039f8c1eb9409cb4caee2cf968001e",22855679,1,23,0,458,82,100,18
"73039f8c1eb9409cb4caee2cf968001e","e20db35ced8544ddac5bc3839145e463",22855679,1,-10,0,459,100,91,-9
"d391c8b6e56a43a7b654e9dee02d904b","8959e6304a0348309a771e4d08d1b64a",22855679,1,76,0,462,103,163,60
"8959e6304a0348309a771e4d08d1b64a","78adeee1fa2c4fe0bc73f7bca9fcee86",22855679,1,-4,0,463,163,160,-3
"65202579580f4ad38d734b4ee39d22a8","3cbcea2be0984e7dbd5a48195af10ce7",22855679,1,3,0,517,164,165,1
"3cbcea2be0984e7dbd5a48195af10ce7","78adeee1fa2c4fe0bc73f7bca9fcee86",22855679,1,-8,0,518,165,160,-5
"78adeee1fa2c4fe0bc73f7bca9fcee86","82e6285962b8400d9d6fc32436022a94",22855679,1,10,0,519,160,167,7
"82e6285962b8400d9d6fc32436022a94","3cbcea2be0984e7dbd5a48195af10ce7",22855679,1,-2,0,520,167,165,-2
"3cbcea2be0984e7dbd5a48195af10ce7","a9ac840f098c4bd0a2ee896214ce29cd",22855679,1,5,0,521,165,168,3
"a9ac840f098c4bd0a2ee896214ce29cd","0c7262dff33c4087bc660ccf40f92f9c",22855679,1,4,0,522,168,169,1
"0c7262dff33c4087bc660ccf40f92f9c","a9ac840f098c4bd0a2ee896214ce29cd",22855679,2,-4,0,523,169,168,-1
"a9ac840f098c4bd0a2ee896214ce29cd","b2275c3fad834f8d90737a2d9a6927d6",22855679,1,7,0,524,168,172,4
"b2275c3fad834f8d90737a2d9a6927d6","a49d1bb4328949299686242fd0be5584",22855679,1,-210,0,525,172,21,-151
"a49d1bb4328949299686242fd0be5584","b7719e26494940efa49512aedd0aac79",22855679,2,-2,0,526,21,20,-1
"b7719e26494940efa49512aedd0aac79","b7719e26494940efa49512aedd0aac79",22855679,2,0,1,527,20,20,0
"b7719e26494940efa49512aedd0aac79","afbf7250b99d47bea07172749483ca97",22855679,3,12,0,528,20,28,8
"afbf7250b99d47bea07172749483ca97","b7719e26494940efa49512aedd0aac79",22855679,1,-12,0,529,28,20,-8
"afbf7250b99d47bea07172749483ca97","a49d1bb4328949299686242fd0be5584",22855679,1,-10,0,531,28,21,-7
"a49d1bb4328949299686242fd0be5584","d4f45188d3c84a02ba08454e6403a818",22855679,2,3,0,532,21,24,3
"b7719e26494940efa49512aedd0aac79","0c7262dff33c4087bc660ccf40f92f9c",22855679,1,209,0,535,20,169,149
"0c7262dff33c4087bc660ccf40f92f9c","b2275c3fad834f8d90737a2d9a6927d6",22855679,2,3,0,536,169,172,3
"b2275c3fad834f8d90737a2d9a6927d6","0c7262dff33c4087bc660ccf40f92f9c",22855679,1,-3,0,537,172,169,-3
"0c7262dff33c4087bc660ccf40f92f9c","0c7262dff33c4087bc660ccf40f92f9c",22855679,1,0,1,538,169,169,0
"b2275c3fad834f8d90737a2d9a6927d6","b2275c3fad834f8d90737a2d9a6927d6",22855679,24,0,1,540,172,172,0
"b2275c3fad834f8d90737a2d9a6927d6","eb515a26030b41f8a82a1e6114420bad",22855679,1,1,0,564,172,173,1
"eb515a26030b41f8a82a1e6114420bad","eb515a26030b41f8a82a1e6114420bad",22855679,2,0,1,565,173,173,0
"eb515a26030b41f8a82a1e6114420bad","b42cc17b7de840f181a704558d0bc845",22855679,1,3,0,567,173,175,2
"b42cc17b7de840f181a704558d0bc845","0c7262dff33c4087bc660ccf40f92f9c",22855679,1,-7,0,568,175,169,-6
"0c7262dff33c4087bc660ccf40f92f9c","b42cc17b7de840f181a704558d0bc845",22855679,1,7,0,569,169,175,6
"b42cc17b7de840f181a704558d0bc845","801f9e9135034f49bf5f8b4bdefedb41",22855679,1,2,0,570,175,177,2
"801f9e9135034f49bf5f8b4bdefedb41","801f9e9135034f49bf5f8b4bdefedb41",22855679,11,0,1,571,177,177,0
"801f9e9135034f49bf5f8b4bdefedb41","362fcb0699a14845ab29b2340093e528",22855679,1,-3,0,582,177,174,-3
"362fcb0699a14845ab29b2340093e528","ea38cc0e6e6e41edbabf210220808bf9",22855679,1,6,0,583,174,179,5
"ea38cc0e6e6e41edbabf210220808bf9","b87c552dd247427abe6ab5795b9c9d43",22855679,2,2,0,584,179,181,2
"b87c552dd247427abe6ab5795b9c9d43","ea38cc0e6e6e41edbabf210220808bf9",22855679,1,-2,0,585,181,179,-2
"b87c552dd247427abe6ab5795b9c9d43","b87c552dd247427abe6ab5795b9c9d43",22855679,7,0,1,587,181,181,0
"b87c552dd247427abe6ab5795b9c9d43","139b097acfca451689d80c9c6eebdf7b",22855679,1,-3,0,594,181,178,-3
"139b097acfca451689d80c9c6eebdf7b","30f660a1feb34582a739722532524f79",22855679,1,6,0,595,178,183,5
"30f660a1feb34582a739722532524f79","30f660a1feb34582a739722532524f79",22855679,5,0,1,596,183,183,0
"30f660a1feb34582a739722532524f79","2024b4885bd14338a39b7b509acbbd02",22855679,1,-1,0,601,183,182,-1
"2024b4885bd14338a39b7b509acbbd02","c3f63fe50d8e487c86bf8ef76c9cadd3",22855679,1,4,0,602,182,185,3
"c3f63fe50d8e487c86bf8ef76c9cadd3","c3f63fe50d8e487c86bf8ef76c9cadd3",22855679,1,0,1,603,185,185,0
"c3f63fe50d8e487c86bf8ef76c9cadd3","0c7262dff33c4087bc660ccf40f92f9c",22855679,1,-20,0,604,185,169,-16
"0c7262dff33c4087bc660ccf40f92f9c","c8e371568a0c4391b25796ae4e91952e",22855679,2,23,0,605,169,186,17
"c8e371568a0c4391b25796ae4e91952e","0c7262dff33c4087bc660ccf40f92f9c",22855679,1,-23,0,606,186,169,-17
"a9ac840f098c4bd0a2ee896214ce29cd","a9ac840f098c4bd0a2ee896214ce29cd",22855679,1,0,1,608,168,168,0
"a9ac840f098c4bd0a2ee896214ce29cd","3cbcea2be0984e7dbd5a48195af10ce7",22855679,1,-5,0,609,168,165,-3
"3cbcea2be0984e7dbd5a48195af10ce7","3cbcea2be0984e7dbd5a48195af10ce7",22855679,1,0,1,610,165,165,0
"3cbcea2be0984e7dbd5a48195af10ce7","82e6285962b8400d9d6fc32436022a94",22855679,1,2,0,611,165,167,2
"82e6285962b8400d9d6fc32436022a94","0c7262dff33c4087bc660ccf40f92f9c",22855679,1,7,0,612,167,169,2
"c8e371568a0c4391b25796ae4e91952e","c8e371568a0c4391b25796ae4e91952e",22855679,1,0,1,614,186,186,0
"c8e371568a0c4391b25796ae4e91952e","7d932b23e1c84326ae5aa4d3c0d813d1",22855679,1,2,0,615,186,188,2
"7d932b23e1c84326ae5aa4d3c0d813d1","7d932b23e1c84326ae5aa4d3c0d813d1",22855679,1,0,1,616,188,188,0
"7d932b23e1c84326ae5aa4d3c0d813d1","c8e371568a0c4391b25796ae4e91952e",22855679,1,-2,0,617,188,186,-2
"c8e371568a0c4391b25796ae4e91952e","ab11d94c6c8948ea90b88f19d2cd502b",22855679,1,5,0,618,186,190,4
"ab11d94c6c8948ea90b88f19d2cd502b","ab11d94c6c8948ea90b88f19d2cd502b",22855679,2,0,1,619,190,190,0
"ab11d94c6c8948ea90b88f19d2cd502b","f992451ed6ad4e68bb9e68ad6be7c4be",22855679,1,2,0,621,190,192,2
"f992451ed6ad4e68bb9e68ad6be7c4be","f992451ed6ad4e68bb9e68ad6be7c4be",22855679,1,0,1,622,192,192,0
"f992451ed6ad4e68bb9e68ad6be7c4be","6cd2dcaac46847d4a0bc53f296d90375",22855679,1,3,0,623,192,194,2
"6cd2dcaac46847d4a0bc53f296d90375","07b44a7a51e94c78b411c753fc39dab0",22855679,1,-6,0,624,194,189,-5
"07b44a7a51e94c78b411c753fc39dab0","6cd2dcaac46847d4a0bc53f296d90375",22855679,1,6,0,625,189,194,5
"6cd2dcaac46847d4a0bc53f296d90375","2d2580c9411c4972909db508d6956a58",22855679,1,2,0,626,194,196,2
"2d2580c9411c4972909db508d6956a58","2d2580c9411c4972909db508d6956a58",22855679,5,0,1,627,196,196,0
"2d2580c9411c4972909db508d6956a58","5bddb3d9ed264f3984702f048c7e5340",22855679,1,1,0,632,196,197,1
"5bddb3d9ed264f3984702f048c7e5340","5bddb3d9ed264f3984702f048c7e5340",22855679,2,0,1,633,197,197,0
"5bddb3d9ed264f3984702f048c7e5340","d5e8e2bd12a2466b9d6d90855f0eb079",22855679,1,1,0,635,197,198,1
"d5e8e2bd12a2466b9d6d90855f0eb079","d5e8e2bd12a2466b9d6d90855f0eb079",22855679,2,0,1,636,198,198,0
"d5e8e2bd12a2466b9d6d90855f0eb079","017d7ca8e0394b91aaadc9574df2202c",22855679,1,-5,0,638,198,193,-5
"017d7ca8e0394b91aaadc9574df2202c","54e8e9f0ea3e45c4bf3b8ac799ee31b1",22855679,1,8,0,639,193,200,7
"54e8e9f0ea3e45c4bf3b8ac799ee31b1","54e8e9f0ea3e45c4bf3b8ac799ee31b1",22855679,1,0,1,640,200,200,0
"54e8e9f0ea3e45c4bf3b8ac799ee31b1","c614a00911be4877a075f19315530fb0",22855679,1,1,0,641,200,201,1
"c614a00911be4877a075f19315530fb0","c614a00911be4877a075f19315530fb0",22855679,6,0,1,642,201,201,0
"c614a00911be4877a075f19315530fb0","a6c21bd8b95249c7972820a7a7d76aff",22855679,1,1,0,648,201,202,1
"a6c21bd8b95249c7972820a7a7d76aff","a6c21bd8b95249c7972820a7a7d76aff",22855679,1,0,1,649,202,202,0
"a6c21bd8b95249c7972820a7a7d76aff","bb329d880ab54120adaf203a693bb203",22855679,1,1,0,650,202,203,1
"bb329d880ab54120adaf203a693bb203","bb329d880ab54120adaf203a693bb203",22855679,1,0,1,651,203,203,0
"bb329d880ab54120adaf203a693bb203","f9170dd6bc6442b4acd832747609b09a",22855679,1,-4,0,652,203,199,-4
"f9170dd6bc6442b4acd832747609b09a","334c2344009840079b1d0e1b7ce3d5a7",22855679,1,7,0,653,199,205,6
"334c2344009840079b1d0e1b7ce3d5a7","334c2344009840079b1d0e1b7ce3d5a7",22855679,1,0,1,654,205,205,0
"334c2344009840079b1d0e1b7ce3d5a7","d7f13c8d63ec4e2aa673fbb9cf9c6933",22855679,1,3,0,655,205,206,1
"d7f13c8d63ec4e2aa673fbb9cf9c6933","c8e371568a0c4391b25796ae4e91952e",22855679,1,-26,0,656,206,186,-20
"c8e371568a0c4391b25796ae4e91952e","b9e80f77c3a44349863b19875725c384",22855679,1,27,0,657,186,207,21
"b9e80f77c3a44349863b19875725c384","7108f0e4c2584f1f9c471689ae4c885c",22855679,3,1,0,658,207,208,1
"7108f0e4c2584f1f9c471689ae4c885c","d646286c8051419bbc2e31dd1db55ca8",22855679,1,-183,0,659,208,67,-141
"d18a9ea32855445f8736581f5cb119ce","017d7ca8e0394b91aaadc9574df2202c",22855679,1,147,0,661,82,193,111
"017d7ca8e0394b91aaadc9574df2202c","c8e371568a0c4391b25796ae4e91952e",22855679,1,-9,0,662,193,186,-7
"c8e371568a0c4391b25796ae4e91952e","6cd2dcaac46847d4a0bc53f296d90375",22855679,1,10,0,663,186,194,8
"6cd2dcaac46847d4a0bc53f296d90375","017d7ca8e0394b91aaadc9574df2202c",22855679,2,-1,0,664,194,193,-1
"017d7ca8e0394b91aaadc9574df2202c","6cd2dcaac46847d4a0bc53f296d90375",22855679,1,1,0,665,193,194,1
"6cd2dcaac46847d4a0bc53f296d90375","f9170dd6bc6442b4acd832747609b09a",22855679,1,6,0,666,194,199,5
"f9170dd6bc6442b4acd832747609b09a","6cd2dcaac46847d4a0bc53f296d90375",22855679,1,-6,0,667,199,194,-5
"6cd2dcaac46847d4a0bc53f296d90375","6cd2dcaac46847d4a0bc53f296d90375",22855679,1,0,1,668,194,194,0
"017d7ca8e0394b91aaadc9574df2202c","f9170dd6bc6442b4acd832747609b09a",22855679,1,7,0,670,193,199,6
"f9170dd6bc6442b4acd832747609b09a","c8e371568a0c4391b25796ae4e91952e",22855679,1,-16,0,671,199,186,-13
"c8e371568a0c4391b25796ae4e91952e","d7f13c8d63ec4e2aa673fbb9cf9c6933",22855679,1,26,0,672,186,206,20
"d7f13c8d63ec4e2aa673fbb9cf9c6933","b9e80f77c3a44349863b19875725c384",22855679,1,1,0,673,206,207,1
"7108f0e4c2584f1f9c471689ae4c885c","b9e80f77c3a44349863b19875725c384",22855679,1,-1,0,675,208,207,-1
"b9e80f77c3a44349863b19875725c384","b9e80f77c3a44349863b19875725c384",22855679,17,0,1,676,207,207,0
"7108f0e4c2584f1f9c471689ae4c885c","7108f0e4c2584f1f9c471689ae4c885c",22855679,12,0,1,694,208,208,0
"7108f0e4c2584f1f9c471689ae4c885c","d7f13c8d63ec4e2aa673fbb9cf9c6933",22855679,1,-2,0,706,208,206,-2
"d7f13c8d63ec4e2aa673fbb9cf9c6933","09400e101c5d4b439cf9a26b03aae558",22855679,1,5,0,707,206,210,4
"09400e101c5d4b439cf9a26b03aae558","09400e101c5d4b439cf9a26b03aae558",22855679,1,0,1,708,210,210,0
"09400e101c5d4b439cf9a26b03aae558","a88efa7e50ce47159810ab553afa6d3a",22855679,1,2,0,709,210,212,2
"a88efa7e50ce47159810ab553afa6d3a","a88efa7e50ce47159810ab553afa6d3a",22855679,5,0,1,710,212,212,0
"a88efa7e50ce47159810ab553afa6d3a","be502a7a43c44bf7b682698de79d9369",22855679,1,3,0,715,212,214,2
"be502a7a43c44bf7b682698de79d9369","a875096404ef4a9984b62d74cda916f9",22855679,1,-6,0,716,214,209,-5
"a875096404ef4a9984b62d74cda916f9","f7fb1952f56b4189b86a9f8b7862d2b8",22855679,1,7,0,717,209,215,6
"f7fb1952f56b4189b86a9f8b7862d2b8","be502a7a43c44bf7b682698de79d9369",22855679,1,-1,0,718,215,214,-1
"be502a7a43c44bf7b682698de79d9369","be502a7a43c44bf7b682698de79d9369",22855679,1,0,1,719,214,214,0
"be502a7a43c44bf7b682698de79d9369","f7fb1952f56b4189b86a9f8b7862d2b8",22855679,1,1,0,720,214,215,1
"f7fb1952f56b4189b86a9f8b7862d2b8","f7fb1952f56b4189b86a9f8b7862d2b8",22855679,15,0,1,721,215,215,0
"f7fb1952f56b4189b86a9f8b7862d2b8","b860ee85d8bc4a2f97958cfb71be3533",22855679,1,1,0,736,215,216,1
"b860ee85d8bc4a2f97958cfb71be3533","b860ee85d8bc4a2f97958cfb71be3533",22855679,2,0,1,737,216,216,0
"b860ee85d8bc4a2f97958cfb71be3533","ec341f459285443b8361f7f15638ff08",22855679,1,-3,0,739,216,213,-3
"ec341f459285443b8361f7f15638ff08","363837c182e04711840d896ae1e0339c",22855679,1,6,0,740,213,218,5
"363837c182e04711840d896ae1e0339c","363837c182e04711840d896ae1e0339c",22855679,13,0,1,741,218,218,0
"363837c182e04711840d896ae1e0339c","01b2051f8941460d89945e3b02d1ce78",22855679,1,-1,0,754,218,217,-1
"01b2051f8941460d89945e3b02d1ce78","91125ca626c5470eb145501f8c37f8db",22855679,1,4,0,755,217,220,3
"91125ca626c5470eb145501f8c37f8db","91125ca626c5470eb145501f8c37f8db",22855679,1,0,1,756,220,220,0
"91125ca626c5470eb145501f8c37f8db","d7f13c8d63ec4e2aa673fbb9cf9c6933",22855679,1,-18,0,757,220,206,-14
"d7f13c8d63ec4e2aa673fbb9cf9c6933","1c6721b1f63f4d30ba7746ea8af02a52",22855679,1,21,0,758,206,221,15
"1c6721b1f63f4d30ba7746ea8af02a52","77ecef8eff6b4a2caea7707669bf7475",22855679,1,1,0,759,221,222,1
"77ecef8eff6b4a2caea7707669bf7475","77ecef8eff6b4a2caea7707669bf7475",22855679,12,0,1,760,222,222,0
"77ecef8eff6b4a2caea7707669bf7475","1c6721b1f63f4d30ba7746ea8af02a52",22855679,1,-1,0,772,222,221,-1
"1c6721b1f63f4d30ba7746ea8af02a52","d03cb855c70044cf8c35d9ec0de696e3",22855679,1,4,0,773,221,224,3
"d03cb855c70044cf8c35d9ec0de696e3","8b9ae98743bd4d4a8a87dff1c1244211",22855679,1,3,0,774,224,227,3
"8b9ae98743bd4d4a8a87dff1c1244211","f7906d6f59b9489a91d2ef40db5a474d",22855679,1,-4,0,775,227,223,-4
"f7906d6f59b9489a91d2ef40db5a474d","77ecef8eff6b4a2caea7707669bf7475",22855679,1,-2,0,776,223,222,-1
"77ecef8eff6b4a2caea7707669bf7475","d03cb855c70044cf8c35d9ec0de696e3",22855679,1,3,0,777,222,224,2
"d03cb855c70044cf8c35d9ec0de696e3","1c6721b1f63f4d30ba7746ea8af02a52",22855679,1,-4,0,778,224,221,-3
"1c6721b1f63f4d30ba7746ea8af02a52","8b9ae98743bd4d4a8a87dff1c1244211",22855679,1,7,0,779,221,227,6
"8b9ae98743bd4d4a8a87dff1c1244211","d03cb855c70044cf8c35d9ec0de696e3",22855679,1,-3,0,780,227,224,-3
"d03cb855c70044cf8c35d9ec0de696e3","a49a937d6896486d9a5396654abcf2e1",22855679,1,2,0,781,224,226,2
"a49a937d6896486d9a5396654abcf2e1","a49a937d6896486d9a5396654abcf2e1",22855679,3,0,1,782,226,226,0
"a49a937d6896486d9a5396654abcf2e1","8b9ae98743bd4d4a8a87dff1c1244211",22855679,1,1,0,785,226,227,1
"8b9ae98743bd4d4a8a87dff1c1244211","8b9ae98743bd4d4a8a87dff1c1244211",22855679,26,0,1,786,227,227,0
"8b9ae98743bd4d4a8a87dff1c1244211","2ab1535aac1346ba8801535bf729ef37",22855679,1,3,0,812,227,229,2
"2ab1535aac1346ba8801535bf729ef37","f7906d6f59b9489a91d2ef40db5a474d",22855679,1,-7,0,813,229,223,-6
"f7906d6f59b9489a91d2ef40db5a474d","2ab1535aac1346ba8801535bf729ef37",22855679,1,7,0,814,223,229,6
"2ab1535aac1346ba8801535bf729ef37","a4f40fb48a8542c8949bae1f002cd9bc",22855679,1,2,0,815,229,231,2
"a4f40fb48a8542c8949bae1f002cd9bc","a4f40fb48a8542c8949bae1f002cd9bc",22855679,2,0,1,816,231,231,0
"a4f40fb48a8542c8949bae1f002cd9bc","8972c23e32044edb8a78fa1eed4e5947",22855679,1,1,0,818,231,232,1
"8972c23e32044edb8a78fa1eed4e5947","8972c23e32044edb8a78fa1eed4e5947",22855679,1,0,1,819,232,232,0
"8972c23e32044edb8a78fa1eed4e5947","92feb4a40f8344d38b6f722e42a53295",22855679,1,1,0,820,232,233,1
"92feb4a40f8344d38b6f722e42a53295","92feb4a40f8344d38b6f722e42a53295",22855679,2,0,1,821,233,233,0
"92feb4a40f8344d38b6f722e42a53295","5152833676bf4c6cb317060be10f68db",22855679,1,-5,0,823,233,228,-5
"5152833676bf4c6cb317060be10f68db","ca3e28f290354c08aefe5b0f769604e6",22855679,1,8,0,824,228,235,7
"ca3e28f290354c08aefe5b0f769604e6","ca3e28f290354c08aefe5b0f769604e6",22855679,9,0,1,825,235,235,0
"ca3e28f290354c08aefe5b0f769604e6","79a35eea833e4c2c9d22fc53c3c6445c",22855679,1,1,0,834,235,236,1
"79a35eea833e4c2c9d22fc53c3c6445c","79a35eea833e4c2c9d22fc53c3c6445c",22855679,14,0,1,835,236,236,0
"79a35eea833e4c2c9d22fc53c3c6445c","8f68228b1518449e9615cdafee41a2bd",22855679,1,1,0,849,236,237,1
"8f68228b1518449e9615cdafee41a2bd","8f68228b1518449e9615cdafee41a2bd",22855679,1,0,1,850,237,237,0
"8f68228b1518449e9615cdafee41a2bd","cab89fa5c3ed45a5aa550fc0352d6a42",22855679,1,1,0,851,237,238,1
"cab89fa5c3ed45a5aa550fc0352d6a42","cab89fa5c3ed45a5aa550fc0352d6a42",22855679,1,0,1,852,238,238,0
"cab89fa5c3ed45a5aa550fc0352d6a42","66d4fad4f1cf4b46be0750a99ad7a35a",22855679,1,1,0,853,238,239,1
"66d4fad4f1cf4b46be0750a99ad7a35a","66d4fad4f1cf4b46be0750a99ad7a35a",22855679,1,0,1,854,239,239,0
"66d4fad4f1cf4b46be0750a99ad7a35a","0b04c8e2f86d48c7aeb7e225819cd32b",22855679,1,-5,0,855,239,234,-5
"0b04c8e2f86d48c7aeb7e225819cd32b","f53da5fd9bfe412da4b80d4742563b6c",22855679,2,8,0,856,234,241,7
"f53da5fd9bfe412da4b80d4742563b6c","f53da5fd9bfe412da4b80d4742563b6c",22855679,4,0,1,857,241,241,0
"f53da5fd9bfe412da4b80d4742563b6c","2ae94c0cea4d480a9d5dca8fb1d7b542",22855679,1,3,0,858,241,242,1
"2ae94c0cea4d480a9d5dca8fb1d7b542","1c6721b1f63f4d30ba7746ea8af02a52",22855679,3,-27,0,859,242,221,-21
"1c6721b1f63f4d30ba7746ea8af02a52","1ebf23f9d994469a85206e4c7b1bf5f5",22855679,2,30,0,860,221,245,24
"1ebf23f9d994469a85206e4c7b1bf5f5","0c7262dff33c4087bc660ccf40f92f9c",22855679,1,-100,0,861,245,169,-76
"0c7262dff33c4087bc660ccf40f92f9c","1c6721b1f63f4d30ba7746ea8af02a52",22855679,1,70,0,862,169,221,52
"1c6721b1f63f4d30ba7746ea8af02a52","64dbedb3ce544f6aae8e10e0cf10f16d",22855679,1,23,0,863,221,240,19
"64dbedb3ce544f6aae8e10e0cf10f16d","2ae94c0cea4d480a9d5dca8fb1d7b542",22855679,1,4,0,864,240,242,2
"1ebf23f9d994469a85206e4c7b1bf5f5","1c6721b1f63f4d30ba7746ea8af02a52",22855679,2,-30,0,867,245,221,-24
"1c6721b1f63f4d30ba7746ea8af02a52","2ae94c0cea4d480a9d5dca8fb1d7b542",22855679,5,27,0,868,221,242,21
"2ae94c0cea4d480a9d5dca8fb1d7b542","f53da5fd9bfe412da4b80d4742563b6c",22855679,1,-3,0,869,242,241,-1
"f53da5fd9bfe412da4b80d4742563b6c","1c6721b1f63f4d30ba7746ea8af02a52",22855679,2,-24,0,871,241,221,-20
"2ae94c0cea4d480a9d5dca8fb1d7b542","1ebf23f9d994469a85206e4c7b1bf5f5",22855679,3,3,0,873,242,245,3
"1ebf23f9d994469a85206e4c7b1bf5f5","0b04c8e2f86d48c7aeb7e225819cd32b",22855679,1,-14,0,874,245,234,-11
"0b04c8e2f86d48c7aeb7e225819cd32b","1c6721b1f63f4d30ba7746ea8af02a52",22855679,1,-16,0,875,234,221,-13
"1c6721b1f63f4d30ba7746ea8af02a52","0b04c8e2f86d48c7aeb7e225819cd32b",22855679,1,16,0,876,221,234,13
"1ebf23f9d994469a85206e4c7b1bf5f5","1ebf23f9d994469a85206e4c7b1bf5f5",22855679,10,0,1,888,245,245,0
"1ebf23f9d994469a85206e4c7b1bf5f5","85ae675b83e8422da842cfd25596af99",22855679,1,1,0,898,245,246,1
"85ae675b83e8422da842cfd25596af99","85ae675b83e8422da842cfd25596af99",22855679,1,0,1,899,246,246,0
"85ae675b83e8422da842cfd25596af99","fa235f0f364d47e4ae1c87f47bf8e6ba",22855679,1,8,0,900,246,252,6
"fa235f0f364d47e4ae1c87f47bf8e6ba","2ae94c0cea4d480a9d5dca8fb1d7b542",22855679,1,-12,0,901,252,242,-10
"2ae94c0cea4d480a9d5dca8fb1d7b542","fa235f0f364d47e4ae1c87f47bf8e6ba",22855679,1,12,0,902,242,252,10
"fa235f0f364d47e4ae1c87f47bf8e6ba","79f7845465cc4ed19d8e4f1429541be0",22855679,1,2,0,903,252,254,2
"79f7845465cc4ed19d8e4f1429541be0","79f7845465cc4ed19d8e4f1429541be0",22855679,2,0,1,904,254,254,0
"79f7845465cc4ed19d8e4f1429541be0","fa235f0f364d47e4ae1c87f47bf8e6ba",22855679,1,-2,0,906,254,252,-2
"fa235f0f364d47e4ae1c87f47bf8e6ba","fa235f0f364d47e4ae1c87f47bf8e6ba",22855679,1,0,1,907,252,252,0
"fa235f0f364d47e4ae1c87f47bf8e6ba","00f61990949545828dd12f1303d47504",22855679,1,5,0,908,252,256,4
"00f61990949545828dd12f1303d47504","6e83e23f56544a19b94067c1c558d9c0",22855679,1,-11,0,909,256,247,-9
"6e83e23f56544a19b94067c1c558d9c0","00f61990949545828dd12f1303d47504",22855679,2,11,0,910,247,256,9
"00f61990949545828dd12f1303d47504","ead7bb4b64e247d2ae632ab8a296b091",22855679,1,2,0,911,256,258,2
"ead7bb4b64e247d2ae632ab8a296b091","ead7bb4b64e247d2ae632ab8a296b091",22855679,2,0,1,912,258,258,0
"ead7bb4b64e247d2ae632ab8a296b091","41b0048dde734bb280bac6116baa8e27",22855679,1,1,0,914,258,259,1
"41b0048dde734bb280bac6116baa8e27","41b0048dde734bb280bac6116baa8e27",22855679,2,0,1,915,259,259,0
"41b0048dde734bb280bac6116baa8e27","b41c5a094a604ee0915327da5cc0beb7",22855679,1,1,0,917,259,260,1
"b41c5a094a604ee0915327da5cc0beb7","b41c5a094a604ee0915327da5cc0beb7",22855679,2,0,1,918,260,260,0
"b41c5a094a604ee0915327da5cc0beb7","d546341988904f069cfa86b21457d9d9",22855679,1,-10,0,920,260,251,-9
"d546341988904f069cfa86b21457d9d9","28c171777c52431ab6b925073bd63d46",22855679,1,15,0,921,251,264,13
"28c171777c52431ab6b925073bd63d46","28c171777c52431ab6b925073bd63d46",22855679,7,0,1,922,264,264,0
"28c171777c52431ab6b925073bd63d46","ac160db940cb49ae8579162b1d52bb5d",22855679,1,2,0,929,264,266,2
"ac160db940cb49ae8579162b1d52bb5d","ac160db940cb49ae8579162b1d52bb5d",22855679,3,0,1,930,266,266,0
"ac160db940cb49ae8579162b1d52bb5d","d989ebcfc12a4b669f0100dc1aa14f1e",22855679,1,-12,0,933,266,255,-11
"d989ebcfc12a4b669f0100dc1aa14f1e","c6fd49b485cc4874b0bbdd9c6171e09c",22855679,1,15,0,934,255,268,13
"c6fd49b485cc4874b0bbdd9c6171e09c","c6fd49b485cc4874b0bbdd9c6171e09c",22855679,7,0,1,935,268,268,0
"c6fd49b485cc4874b0bbdd9c6171e09c","44240778a97c4af0937817499b75707b",22855679,3,1,0,938,268,269,1
"44240778a97c4af0937817499b75707b","44240778a97c4af0937817499b75707b",22855679,5,0,1,939,269,269,0
"44240778a97c4af0937817499b75707b","7aa76d3e993840d8805f097cbdbcd44b",22855679,4,-9,0,941,269,261,-8
"7aa76d3e993840d8805f097cbdbcd44b","7028800abe7d4e27b613d1d6cbe26bf7",22855679,4,7,0,942,261,267,6
"7028800abe7d4e27b613d1d6cbe26bf7","44240778a97c4af0937817499b75707b",22855679,1,2,0,943,267,269,2
"7028800abe7d4e27b613d1d6cbe26bf7","c6fd49b485cc4874b0bbdd9c6171e09c",22855679,2,1,0,947,267,268,1
"7028800abe7d4e27b613d1d6cbe26bf7","d989ebcfc12a4b669f0100dc1aa14f1e",22855679,1,-14,0,952,267,255,-12
"d989ebcfc12a4b669f0100dc1aa14f1e","7aa76d3e993840d8805f097cbdbcd44b",22855679,1,7,0,953,255,261,6
"7aa76d3e993840d8805f097cbdbcd44b","865a4d3b43374da7944dc7d397f566d9",22855679,1,12,0,963,261,271,10
"865a4d3b43374da7944dc7d397f566d9","865a4d3b43374da7944dc7d397f566d9",22855679,3,0,1,964,271,271,0
"865a4d3b43374da7944dc7d397f566d9","2ae94c0cea4d480a9d5dca8fb1d7b542",22855679,1,-35,0,967,271,242,-29
"2ae94c0cea4d480a9d5dca8fb1d7b542","0d987bed3ffa4ed0b9a2e62e97b7b30f",22855679,3,38,0,968,242,272,30
"0d987bed3ffa4ed0b9a2e62e97b7b30f","0d987bed3ffa4ed0b9a2e62e97b7b30f",22855679,3,0,1,969,272,272,0
"0d987bed3ffa4ed0b9a2e62e97b7b30f","2ae94c0cea4d480a9d5dca8fb1d7b542",22855679,2,-38,0,970,272,242,-30
"0d987bed3ffa4ed0b9a2e62e97b7b30f","82ae07bc0c9b4570a41799290d1ef399",22855679,2,4,0,974,272,275,3
"bb5a47f5ea01454a8b79455422d3b9da","bc5524e78a8544e2ae2fdc2f3462bbec",22855679,1,-1,0,984,280,279,-1
"bc5524e78a8544e2ae2fdc2f3462bbec","0c7262dff33c4087bc660ccf40f92f9c",22855679,1,-144,0,985,279,169,-110
"0c7262dff33c4087bc660ccf40f92f9c","6e83e23f56544a19b94067c1c558d9c0",22855679,1,103,0,986,169,247,78
"6e83e23f56544a19b94067c1c558d9c0","2ae94c0cea4d480a9d5dca8fb1d7b542",22855679,1,-6,0,987,247,242,-5
"2ae94c0cea4d480a9d5dca8fb1d7b542","30c9ba177afc49a695625d2bdec40207",22855679,1,9,0,988,242,250,8
"30c9ba177afc49a695625d2bdec40207","30c9ba177afc49a695625d2bdec40207",22855679,2,0,1,989,250,250,0
"30c9ba177afc49a695625d2bdec40207","6e83e23f56544a19b94067c1c558d9c0",22855679,1,-3,0,991,250,247,-3
"00f61990949545828dd12f1303d47504","0d987bed3ffa4ed0b9a2e62e97b7b30f",22855679,1,21,0,993,256,272,16
"82ae07bc0c9b4570a41799290d1ef399","0c7262dff33c4087bc660ccf40f92f9c",22855679,1,-139,0,997,275,169,-106
"0c7262dff33c4087bc660ccf40f92f9c","82ae07bc0c9b4570a41799290d1ef399",22855679,1,139,0,998,169,275,106
"82ae07bc0c9b4570a41799290d1ef399","0d987bed3ffa4ed0b9a2e62e97b7b30f",22855679,1,-4,0,999,275,272,-3
"0d987bed3ffa4ed0b9a2e62e97b7b30f","bb5a47f5ea01454a8b79455422d3b9da",22855679,4,10,0,1000,272,280,8
"bb5a47f5ea01454a8b79455422d3b9da","82ae07bc0c9b4570a41799290d1ef399",22855679,1,-6,0,1001,280,275,-5
"82ae07bc0c9b4570a41799290d1ef399","bb5a47f5ea01454a8b79455422d3b9da",22855679,2,6,0,1002,275,280,5
"bb5a47f5ea01454a8b79455422d3b9da","bb5a47f5ea01454a8b79455422d3b9da",22855679,91,0,1,1003,280,280,0
"bb5a47f5ea01454a8b79455422d3b9da","0c7262dff33c4087bc660ccf40f92f9c",22855679,2,-145,0,1009,280,169,-111
"0c7262dff33c4087bc660ccf40f92f9c","0d987bed3ffa4ed0b9a2e62e97b7b30f",22855679,2,135,0,1010,169,272,103
"0d987bed3ffa4ed0b9a2e62e97b7b30f","bc5524e78a8544e2ae2fdc2f3462bbec",22855679,1,9,0,1011,272,279,7
"bc5524e78a8544e2ae2fdc2f3462bbec","bb5a47f5ea01454a8b79455422d3b9da",22855679,1,1,0,1012,279,280,1
"bb5a47f5ea01454a8b79455422d3b9da","0d987bed3ffa4ed0b9a2e62e97b7b30f",22855679,3,-10,0,1020,280,272,-8
"0d987bed3ffa4ed0b9a2e62e97b7b30f","94cecc3f1e7d484b8e068e79241dfd73",22855679,1,13,0,1098,272,281,9
"94cecc3f1e7d484b8e068e79241dfd73","a37477c4e4c14169ad44b06b493007f6",22855679,1,2,0,1099,281,283,2
"a37477c4e4c14169ad44b06b493007f6","fab84b4fab5940efb4ea868ef8d09396",22855679,1,3,0,1100,283,284,1
"fab84b4fab5940efb4ea868ef8d09396","4a29443515bb404cb8924e1c60a63b73",22855679,3,4,0,1101,284,285,1
"4a29443515bb404cb8924e1c60a63b73","4a29443515bb404cb8924e1c60a63b73",22855679,5,0,1,1102,285,285,0
"4a29443515bb404cb8924e1c60a63b73","6a9a3b5bde4a48daa896fe8c06eca56f",22855679,9,5,0,1103,285,289,4
"6a9a3b5bde4a48daa896fe8c06eca56f","4a29443515bb404cb8924e1c60a63b73",22855679,3,-5,0,1104,289,285,-4
"4a29443515bb404cb8924e1c60a63b73","7669a956527947d0add87455277e80b4",22855679,1,7,0,1107,285,291,6
"7669a956527947d0add87455277e80b4","7669a956527947d0add87455277e80b4",22855679,1,0,1,1108,291,291,0
"7669a956527947d0add87455277e80b4","6a9a3b5bde4a48daa896fe8c06eca56f",22855679,1,-2,0,1109,291,289,-2
"6a9a3b5bde4a48daa896fe8c06eca56f","34a6e49023fc4465bd5ca604330bbd1c",22855679,1,4,0,1110,289,292,3
"34a6e49023fc4465bd5ca604330bbd1c","4a29443515bb404cb8924e1c60a63b73",22855679,1,-9,0,1111,292,285,-7
"6a9a3b5bde4a48daa896fe8c06eca56f","51ab6291537748fab90d519aa09889d6",22855679,2,7,0,1113,289,295,6
"51ab6291537748fab90d519aa09889d6","51ab6291537748fab90d519aa09889d6",22855679,5,0,1,1114,295,295,0
"51ab6291537748fab90d519aa09889d6","34a6e49023fc4465bd5ca604330bbd1c",22855679,3,-3,0,1119,295,292,-3
"34a6e49023fc4465bd5ca604330bbd1c","21592f2a9e9c4b2f8c66ec5dbcbf6a2b",22855679,5,5,0,1120,292,296,4
"21592f2a9e9c4b2f8c66ec5dbcbf6a2b","0e0b36e731a645e7b1b8a88f5031ca38",22855679,1,6,0,1121,296,301,5
"0e0b36e731a645e7b1b8a88f5031ca38","0e0b36e731a645e7b1b8a88f5031ca38",22855679,4,0,1,1122,301,301,0
"0e0b36e731a645e7b1b8a88f5031ca38","a66a144637284c21afc6de17fea4bfb8",22855679,2,1,0,1124,301,302,1
"a66a144637284c21afc6de17fea4bfb8","a66a144637284c21afc6de17fea4bfb8",22855679,3,0,1,1125,302,302,0
"a66a144637284c21afc6de17fea4bfb8","4a29443515bb404cb8924e1c60a63b73",22855679,1,-21,0,1126,302,285,-17
"4a29443515bb404cb8924e1c60a63b73","208c9b2796c944db8dacaa96082520ea",22855679,8,3,0,1127,285,288,3
"208c9b2796c944db8dacaa96082520ea","4a29443515bb404cb8924e1c60a63b73",22855679,12,-3,0,1128,288,285,-3
"208c9b2796c944db8dacaa96082520ea","6a9a3b5bde4a48daa896fe8c06eca56f",22855679,3,2,0,1130,288,289,1
"6a9a3b5bde4a48daa896fe8c06eca56f","208c9b2796c944db8dacaa96082520ea",22855679,5,-2,0,1131,289,288,-1
"208c9b2796c944db8dacaa96082520ea","208c9b2796c944db8dacaa96082520ea",22855679,9,0,1,1132,288,288,0
"4a29443515bb404cb8924e1c60a63b73","fab84b4fab5940efb4ea868ef8d09396",22855679,1,-4,0,1137,285,284,-1
"fab84b4fab5940efb4ea868ef8d09396","fab84b4fab5940efb4ea868ef8d09396",22855679,1,0,1,1138,284,284,0
"4a29443515bb404cb8924e1c60a63b73","869e967078f04da18dd0b0b9389a7424",22855679,2,10,0,1142,285,293,8
"869e967078f04da18dd0b0b9389a7424","6a9a3b5bde4a48daa896fe8c06eca56f",22855679,2,-5,0,1143,293,289,-4
"21592f2a9e9c4b2f8c66ec5dbcbf6a2b","208c9b2796c944db8dacaa96082520ea",22855679,2,-11,0,1147,296,288,-8
"208c9b2796c944db8dacaa96082520ea","fab84b4fab5940efb4ea868ef8d09396",22855679,1,-7,0,1148,288,284,-4
"6a9a3b5bde4a48daa896fe8c06eca56f","869e967078f04da18dd0b0b9389a7424",22855679,2,5,0,1167,289,293,4
"869e967078f04da18dd0b0b9389a7424","51ab6291537748fab90d519aa09889d6",22855679,1,2,0,1168,293,295,2
"21592f2a9e9c4b2f8c66ec5dbcbf6a2b","869e967078f04da18dd0b0b9389a7424",22855679,1,-4,0,1171,296,293,-3
"869e967078f04da18dd0b0b9389a7424","869e967078f04da18dd0b0b9389a7424",22855679,1,0,1,1172,293,293,0
"869e967078f04da18dd0b0b9389a7424","34a6e49023fc4465bd5ca604330bbd1c",22855679,2,-1,0,1173,293,292,-1
"6a9a3b5bde4a48daa896fe8c06eca56f","ba0e59461bfb4a44b7b1c28a01f8d3b3",22855679,2,13,0,1178,289,299,10
"ba0e59461bfb4a44b7b1c28a01f8d3b3","7646a919d7e64fa990bca9b024ff089d",22855679,2,-1,0,1179,299,298,-1
"7646a919d7e64fa990bca9b024ff089d","208c9b2796c944db8dacaa96082520ea",22855679,1,-14,0,1180,298,288,-10
"ba0e59461bfb4a44b7b1c28a01f8d3b3","ba0e59461bfb4a44b7b1c28a01f8d3b3",22855679,2,0,1,1189,299,299,0
"ba0e59461bfb4a44b7b1c28a01f8d3b3","0e0b36e731a645e7b1b8a88f5031ca38",22855679,1,2,0,1191,299,301,2
"a66a144637284c21afc6de17fea4bfb8","7646a919d7e64fa990bca9b024ff089d",22855679,1,-4,0,1197,302,298,-4
"7646a919d7e64fa990bca9b024ff089d","e390b575229748ea8aac9364efe2bf00",22855679,1,7,0,1198,298,304,6
"e390b575229748ea8aac9364efe2bf00","e390b575229748ea8aac9364efe2bf00",22855679,3,0,1,1199,304,304,0
"e390b575229748ea8aac9364efe2bf00","4a29443515bb404cb8924e1c60a63b73",22855679,1,-24,0,1202,304,285,-19
"4a29443515bb404cb8924e1c60a63b73","3434c10e561d488a914e0f7d71907abd",22855679,1,27,0,1203,285,305,20
"3434c10e561d488a914e0f7d71907abd","53e7e900392747ccad52e711ab0f80d8",22855679,1,2,0,1204,305,307,2
"53e7e900392747ccad52e711ab0f80d8","4a29443515bb404cb8924e1c60a63b73",22855679,1,-29,0,1205,307,285,-22
"21592f2a9e9c4b2f8c66ec5dbcbf6a2b","ba0e59461bfb4a44b7b1c28a01f8d3b3",22855679,1,4,0,1217,296,299,3
"7646a919d7e64fa990bca9b024ff089d","3434c10e561d488a914e0f7d71907abd",22855679,1,10,0,1219,298,305,7
"3434c10e561d488a914e0f7d71907abd","4a29443515bb404cb8924e1c60a63b73",22855679,1,-27,0,1220,305,285,-20
"4a29443515bb404cb8924e1c60a63b73","53e7e900392747ccad52e711ab0f80d8",22855679,1,29,0,1221,285,307,22
"53e7e900392747ccad52e711ab0f80d8","53e7e900392747ccad52e711ab0f80d8",22855679,1,0,1,1222,307,307,0
"53e7e900392747ccad52e711ab0f80d8","3434c10e561d488a914e0f7d71907abd",22855679,1,-2,0,1223,307,305,-2
"3434c10e561d488a914e0f7d71907abd","130acc2aeb0448fdbb2de63bc5cebe5b",22855679,2,5,0,1224,305,309,4
"130acc2aeb0448fdbb2de63bc5cebe5b","130acc2aeb0448fdbb2de63bc5cebe5b",22855679,1,0,1,1225,309,309,0
"130acc2aeb0448fdbb2de63bc5cebe5b","9c062b3251034ebe90f5054e2a3b5120",22855679,1,2,0,1226,309,311,2
"9c062b3251034ebe90f5054e2a3b5120","9c062b3251034ebe90f5054e2a3b5120",22855679,5,0,1,1227,311,311,0
"9c062b3251034ebe90f5054e2a3b5120","ea859f8207e44537889daeaba13ac2e8",22855679,1,1,0,1232,311,312,1
"ea859f8207e44537889daeaba13ac2e8","ea859f8207e44537889daeaba13ac2e8",22855679,1,0,1,1233,312,312,0
"ea859f8207e44537889daeaba13ac2e8","56d94971a7a94257aa330183a8ebd0ea",22855679,1,1,0,1234,312,313,1
"56d94971a7a94257aa330183a8ebd0ea","56d94971a7a94257aa330183a8ebd0ea",22855679,1,0,1,1235,313,313,0
"56d94971a7a94257aa330183a8ebd0ea","141c0df6cd1946539aadd1c9b7068cd4",22855679,1,-5,0,1236,313,308,-5
"141c0df6cd1946539aadd1c9b7068cd4","0c787d16c9504873b1a4d903cec09948",22855679,1,7,0,1237,308,314,6
"0c787d16c9504873b1a4d903cec09948","130acc2aeb0448fdbb2de63bc5cebe5b",22855679,1,-6,0,1238,314,309,-5
"130acc2aeb0448fdbb2de63bc5cebe5b","56d94971a7a94257aa330183a8ebd0ea",22855679,1,4,0,1239,309,313,4
"56d94971a7a94257aa330183a8ebd0ea","ea859f8207e44537889daeaba13ac2e8",22855679,1,-1,0,1240,313,312,-1
"ea859f8207e44537889daeaba13ac2e8","9c062b3251034ebe90f5054e2a3b5120",22855679,1,-1,0,1241,312,311,-1
"9c062b3251034ebe90f5054e2a3b5120","141c0df6cd1946539aadd1c9b7068cd4",22855679,1,-3,0,1242,311,308,-3
"141c0df6cd1946539aadd1c9b7068cd4","13255e63e0aa4abf85e5211bf613d43e",22855679,1,10,0,1243,308,317,9
"13255e63e0aa4abf85e5211bf613d43e","13255e63e0aa4abf85e5211bf613d43e",22855679,1,0,1,1244,317,317,0
"13255e63e0aa4abf85e5211bf613d43e","0c787d16c9504873b1a4d903cec09948",22855679,1,-3,0,1245,317,314,-3
"0c787d16c9504873b1a4d903cec09948","86c27d40179e419c8e9d150fb6afa5d0",22855679,1,6,0,1246,314,319,5
"86c27d40179e419c8e9d150fb6afa5d0","86c27d40179e419c8e9d150fb6afa5d0",22855679,1,0,1,1247,319,319,0
"86c27d40179e419c8e9d150fb6afa5d0","47edbb64109243e6b0f8f64cdef90c6c",22855679,1,8,0,1248,319,326,7
"47edbb64109243e6b0f8f64cdef90c6c","24f1363179ad4aaa965484a78471912b",22855679,1,-3,0,1249,326,323,-3
"24f1363179ad4aaa965484a78471912b","8d7e0b55cf9849cda222a0f2440cec55",22855679,1,-6,0,1250,323,318,-5
"8d7e0b55cf9849cda222a0f2440cec55","24f1363179ad4aaa965484a78471912b",22855679,1,6,0,1251,318,323,5
"24f1363179ad4aaa965484a78471912b","3628bdce1dd2429ba924d2d4d09448d2",22855679,1,-1,0,1252,323,322,-1
"3628bdce1dd2429ba924d2d4d09448d2","24f1363179ad4aaa965484a78471912b",22855679,1,1,0,1253,322,323,1
"24f1363179ad4aaa965484a78471912b","47edbb64109243e6b0f8f64cdef90c6c",22855679,1,3,0,1254,323,326,3
"47edbb64109243e6b0f8f64cdef90c6c","43ea1b823a4b4e51b7c694c10725db82",22855679,1,2,0,1255,326,327,1
"43ea1b823a4b4e51b7c694c10725db82","3628bdce1dd2429ba924d2d4d09448d2",22855679,1,-6,0,1256,327,322,-5
"3628bdce1dd2429ba924d2d4d09448d2","56b3fd1a212a4764be39d979fde3326e",22855679,1,7,0,1257,322,328,6
"56b3fd1a212a4764be39d979fde3326e","56b3fd1a212a4764be39d979fde3326e",22855679,1,0,1,1258,328,328,0
"56b3fd1a212a4764be39d979fde3326e","0c4079457ede49e3aeb5e86ed84bdf35",22855679,1,3,0,1259,328,329,1
"0c4079457ede49e3aeb5e86ed84bdf35","3434c10e561d488a914e0f7d71907abd",22855679,1,-31,0,1260,329,305,-24
"3434c10e561d488a914e0f7d71907abd","38aea304b4fa46e1b29bb72f5cea4c93",22855679,1,33,0,1261,305,331,26
"38aea304b4fa46e1b29bb72f5cea4c93","38aea304b4fa46e1b29bb72f5cea4c93",22855679,1,0,1,1262,331,331,0
"38aea304b4fa46e1b29bb72f5cea4c93","e36d261332f14e79bb4b467aceaeb9b5",22855679,1,2,0,1263,331,333,2
"e36d261332f14e79bb4b467aceaeb9b5","e36d261332f14e79bb4b467aceaeb9b5",22855679,1,0,1,1264,333,333,0
"e36d261332f14e79bb4b467aceaeb9b5","c7e89b9d04744d2eab742fc24e3ef1ae",22855679,1,1,0,1265,333,334,1
"c7e89b9d04744d2eab742fc24e3ef1ae","c7e89b9d04744d2eab742fc24e3ef1ae",22855679,5,0,1,1266,334,334,0
"c7e89b9d04744d2eab742fc24e3ef1ae","fe49f8054b374a0ea4bb266ed135ff62",22855679,1,1,0,1271,334,335,1
"fe49f8054b374a0ea4bb266ed135ff62","fe49f8054b374a0ea4bb266ed135ff62",22855679,2,0,1,1272,335,335,0
"fe49f8054b374a0ea4bb266ed135ff62","d0a8f74af98642fe8360d22c42e45117",22855679,1,1,0,1274,335,336,1
"d0a8f74af98642fe8360d22c42e45117","d0a8f74af98642fe8360d22c42e45117",22855679,2,0,1,1275,336,336,0
"d0a8f74af98642fe8360d22c42e45117","0c4079457ede49e3aeb5e86ed84bdf35",22855679,1,-7,0,1277,336,329,-7
"0c4079457ede49e3aeb5e86ed84bdf35","a7c6339ca1da4368a18d471f0519f877",22855679,1,11,0,1278,329,339,10
"a7c6339ca1da4368a18d471f0519f877","a7c6339ca1da4368a18d471f0519f877",22855679,1,0,1,1279,339,339,0
"a7c6339ca1da4368a18d471f0519f877","b8b9418ab322418d9db9b40d96af873a",22855679,1,-2,0,1280,339,337,-2
"b8b9418ab322418d9db9b40d96af873a","bbc5139ca9024389a94db3a6f47dcff6",22855679,2,5,0,1281,337,341,4
"bbc5139ca9024389a94db3a6f47dcff6","bbc5139ca9024389a94db3a6f47dcff6",22855679,1,0,1,1282,341,341,0
"bbc5139ca9024389a94db3a6f47dcff6","4ee6ca9019ab4a1ab323f98094a9bd77",22855679,2,2,0,1283,341,343,2
"4ee6ca9019ab4a1ab323f98094a9bd77","4ee6ca9019ab4a1ab323f98094a9bd77",22855679,2,0,1,1284,343,343,0
"4ee6ca9019ab4a1ab323f98094a9bd77","b37947176785476f8b29d49a851366dc",22855679,1,1,0,1286,343,344,1
"b37947176785476f8b29d49a851366dc","b37947176785476f8b29d49a851366dc",22855679,2,0,1,1287,344,344,0
"b37947176785476f8b29d49a851366dc","fcea5b10d5a14a3b9324ffece8f6e1e5",22855679,1,1,0,1289,344,345,1
"fcea5b10d5a14a3b9324ffece8f6e1e5","fcea5b10d5a14a3b9324ffece8f6e1e5",22855679,2,0,1,1290,345,345,0
"fcea5b10d5a14a3b9324ffece8f6e1e5","c2490bc612d146edbe786556fab3651b",22855679,1,-5,0,1292,345,340,-5
"c2490bc612d146edbe786556fab3651b","0c4079457ede49e3aeb5e86ed84bdf35",22855679,2,-13,0,1293,340,329,-11
"0c4079457ede49e3aeb5e86ed84bdf35","0c4079457ede49e3aeb5e86ed84bdf35",22855679,3,0,1,1294,329,329,0
"0c4079457ede49e3aeb5e86ed84bdf35","38aea304b4fa46e1b29bb72f5cea4c93",22855679,2,2,0,1296,329,331,2
"38aea304b4fa46e1b29bb72f5cea4c93","0c4079457ede49e3aeb5e86ed84bdf35",22855679,2,-2,0,1297,331,329,-2
"0c4079457ede49e3aeb5e86ed84bdf35","b8b9418ab322418d9db9b40d96af873a",22855679,1,9,0,1298,329,337,8
"b8b9418ab322418d9db9b40d96af873a","6ac8bb048b854999a47edb35fe627f11",22855679,1,12,0,1299,337,347,10
"6ac8bb048b854999a47edb35fe627f11","6ac8bb048b854999a47edb35fe627f11",22855679,1,0,1,1300,347,347,0
"6ac8bb048b854999a47edb35fe627f11","0c4079457ede49e3aeb5e86ed84bdf35",22855679,1,-21,0,1301,347,329,-18
"0c4079457ede49e3aeb5e86ed84bdf35","30ead9794d4847abaf222ca966cc8630",22855679,1,24,0,1302,329,348,19
"30ead9794d4847abaf222ca966cc8630","eff0de7f2dbb42dfa1a2e686efab5b6d",22855679,1,6,0,1303,348,354,6
"eff0de7f2dbb42dfa1a2e686efab5b6d","897b7f51242c44aab2205c72fdcbf4cd",22855679,1,-2,0,1304,354,352,-2
"897b7f51242c44aab2205c72fdcbf4cd","c20993c944444fe085345591a8bd837e",22855679,1,-1,0,1305,352,351,-1
"c20993c944444fe085345591a8bd837e","09b9678ddc3d452ea4a3d46e15826065",22855679,1,2,0,1306,351,353,2
"09b9678ddc3d452ea4a3d46e15826065","c20993c944444fe085345591a8bd837e",22855679,1,-2,0,1307,353,351,-2
"c20993c944444fe085345591a8bd837e","c20993c944444fe085345591a8bd837e",22855679,3,0,1,1308,351,351,0
"c20993c944444fe085345591a8bd837e","897b7f51242c44aab2205c72fdcbf4cd",22855679,1,1,0,1311,351,352,1
"897b7f51242c44aab2205c72fdcbf4cd","897b7f51242c44aab2205c72fdcbf4cd",22855679,3,0,1,1312,352,352,0
"897b7f51242c44aab2205c72fdcbf4cd","09b9678ddc3d452ea4a3d46e15826065",22855679,1,1,0,1315,352,353,1
"09b9678ddc3d452ea4a3d46e15826065","09b9678ddc3d452ea4a3d46e15826065",22855679,3,0,1,1316,353,353,0
"09b9678ddc3d452ea4a3d46e15826065","eff0de7f2dbb42dfa1a2e686efab5b6d",22855679,1,1,0,1319,353,354,1
"eff0de7f2dbb42dfa1a2e686efab5b6d","eff0de7f2dbb42dfa1a2e686efab5b6d",22855679,3,0,1,1320,354,354,0
"eff0de7f2dbb42dfa1a2e686efab5b6d","30ead9794d4847abaf222ca966cc8630",22855679,1,-6,0,1323,354,348,-6
"30ead9794d4847abaf222ca966cc8630","2fe14166dc9642c3bc666b86a57f943d",22855679,1,10,0,1324,348,357,9
"2fe14166dc9642c3bc666b86a57f943d","2fe14166dc9642c3bc666b86a57f943d",22855679,1,0,1,1325,357,357,0
"2fe14166dc9642c3bc666b86a57f943d","44421dd1e13a47a388c4a19834b744c7",22855679,3,2,0,1326,357,359,2
"44421dd1e13a47a388c4a19834b744c7","44421dd1e13a47a388c4a19834b744c7",22855679,2,0,1,1327,359,359,0
"44421dd1e13a47a388c4a19834b744c7","cb5fc7ef85d547c4be1a7439d0bf6052",22855679,1,1,0,1329,359,360,1
"cb5fc7ef85d547c4be1a7439d0bf6052","cb5fc7ef85d547c4be1a7439d0bf6052",22855679,4,0,1,1330,360,360,0
"cb5fc7ef85d547c4be1a7439d0bf6052","0a8f150a4cf747acbde62f4721823da3",22855679,1,1,0,1332,360,361,1
"0a8f150a4cf747acbde62f4721823da3","0a8f150a4cf747acbde62f4721823da3",22855679,2,0,1,1333,361,361,0
"0a8f150a4cf747acbde62f4721823da3","ab8fdad974ae471f9f24c3f9dd04462e",22855679,1,1,0,1335,361,362,1
"ab8fdad974ae471f9f24c3f9dd04462e","ab8fdad974ae471f9f24c3f9dd04462e",22855679,2,0,1,1336,362,362,0
"ab8fdad974ae471f9f24c3f9dd04462e","1ba8fef685d74a8194b9db252eb704fb",22855679,1,-7,0,1338,362,355,-7
"1ba8fef685d74a8194b9db252eb704fb","52580888dadb4fe3baa795683ea227bd",22855679,3,10,0,1339,355,364,9
"52580888dadb4fe3baa795683ea227bd","52580888dadb4fe3baa795683ea227bd",22855679,1,0,1,1340,364,364,0
"52580888dadb4fe3baa795683ea227bd","f00179e251a045b39c3f7a54f9aa4acc",22855679,2,-1,0,1341,364,363,-1
"f00179e251a045b39c3f7a54f9aa4acc","492a3bc6a1254f23a7998587961b22a4",22855679,1,4,0,1342,363,366,3
"492a3bc6a1254f23a7998587961b22a4","492a3bc6a1254f23a7998587961b22a4",22855679,1,0,1,1343,366,366,0
"492a3bc6a1254f23a7998587961b22a4","072a190fd302456290895f9f04d6940a",22855679,3,-1,0,1344,366,365,-1
"072a190fd302456290895f9f04d6940a","2fe14166dc9642c3bc666b86a57f943d",22855679,2,-10,0,1345,365,357,-8
"2fe14166dc9642c3bc666b86a57f943d","c76574d21bc14aeea7ecd0b027f39858",22855679,2,13,0,1346,357,367,10
"c76574d21bc14aeea7ecd0b027f39858","1ba8fef685d74a8194b9db252eb704fb",22855679,1,-15,0,1347,367,355,-12
"1ba8fef685d74a8194b9db252eb704fb","cfa457d1743848e4bb5e4beced6448ed",22855679,1,17,0,1348,355,369,14
"cfa457d1743848e4bb5e4beced6448ed","cfa457d1743848e4bb5e4beced6448ed",22855679,1,0,1,1349,369,369,0
"cfa457d1743848e4bb5e4beced6448ed","30ead9794d4847abaf222ca966cc8630",22855679,1,-25,0,1350,369,348,-21
"30ead9794d4847abaf222ca966cc8630","b71bac264efb4abd97015447bd490db6",22855679,1,28,0,1351,348,370,22
"b71bac264efb4abd97015447bd490db6","0c4079457ede49e3aeb5e86ed84bdf35",22855679,1,-52,0,1352,370,329,-41
"0c4079457ede49e3aeb5e86ed84bdf35","bbc5139ca9024389a94db3a6f47dcff6",22855679,2,14,0,1356,329,341,12
"bbc5139ca9024389a94db3a6f47dcff6","b8b9418ab322418d9db9b40d96af873a",22855679,1,-5,0,1357,341,337,-4
"b8b9418ab322418d9db9b40d96af873a","c2490bc612d146edbe786556fab3651b",22855679,1,4,0,1358,337,340,3
"c2490bc612d146edbe786556fab3651b","bbc5139ca9024389a94db3a6f47dcff6",22855679,3,1,0,1359,340,341,1
"bbc5139ca9024389a94db3a6f47dcff6","4a92daef4d504e1792575a26502bb7b7",22855679,3,6,0,1360,341,346,5
"4a92daef4d504e1792575a26502bb7b7","c2490bc612d146edbe786556fab3651b",22855679,3,-7,0,1361,346,340,-6
"c2490bc612d146edbe786556fab3651b","4a92daef4d504e1792575a26502bb7b7",22855679,1,7,0,1362,340,346,6
"4a92daef4d504e1792575a26502bb7b7","bbc5139ca9024389a94db3a6f47dcff6",22855679,1,-6,0,1363,346,341,-5
"bbc5139ca9024389a94db3a6f47dcff6","30ead9794d4847abaf222ca966cc8630",22855679,1,10,0,1367,341,348,7
"30ead9794d4847abaf222ca966cc8630","1ba8fef685d74a8194b9db252eb704fb",22855679,2,8,0,1368,348,355,7
"1ba8fef685d74a8194b9db252eb704fb","2fe14166dc9642c3bc666b86a57f943d",22855679,3,2,0,1369,355,357,2
"2fe14166dc9642c3bc666b86a57f943d","b71bac264efb4abd97015447bd490db6",22855679,1,18,0,1370,357,370,13
"b71bac264efb4abd97015447bd490db6","b71bac264efb4abd97015447bd490db6",22855679,1,0,1,1371,370,370,0
"b71bac264efb4abd97015447bd490db6","8d448d625b024c82a5eb240bbd7431d6",22855679,5,5,0,1372,370,374,4
"8d448d625b024c82a5eb240bbd7431d6","8d448d625b024c82a5eb240bbd7431d6",22855679,70,0,1,1373,374,374,0
"8d448d625b024c82a5eb240bbd7431d6","b71bac264efb4abd97015447bd490db6",22855679,3,-5,0,1374,374,370,-4
"8d448d625b024c82a5eb240bbd7431d6","1b4550d0dab04078b3bf08a655345bdc",22855679,1,-1,0,1403,374,373,-1
"1b4550d0dab04078b3bf08a655345bdc","8d448d625b024c82a5eb240bbd7431d6",22855679,1,1,0,1404,373,374,1
"8d448d625b024c82a5eb240bbd7431d6","d6d02b6ef04e4f17805504500b8ce441",22855679,1,3,0,1435,374,375,1
"d6d02b6ef04e4f17805504500b8ce441","b71bac264efb4abd97015447bd490db6",22855679,2,-8,0,1436,375,370,-5
"b71bac264efb4abd97015447bd490db6","d6d02b6ef04e4f17805504500b8ce441",22855679,2,8,0,1437,370,375,5
"d6d02b6ef04e4f17805504500b8ce441","d6d02b6ef04e4f17805504500b8ce441",22855679,20,0,1,1438,375,375,0
"d6d02b6ef04e4f17805504500b8ce441","66baf19b6b904b70922329068c63746d",22855679,3,4,0,1439,375,376,1
"66baf19b6b904b70922329068c63746d","7f544639412e40a9ba27f43b415362ab",22855679,4,2,0,1440,376,378,2
"7f544639412e40a9ba27f43b415362ab","b71bac264efb4abd97015447bd490db6",22855679,1,-14,0,1441,378,370,-8
"8d448d625b024c82a5eb240bbd7431d6","4a29443515bb404cb8924e1c60a63b73",22855679,1,-115,0,1450,374,285,-89
"4a29443515bb404cb8924e1c60a63b73","141c0df6cd1946539aadd1c9b7068cd4",22855679,1,31,0,1455,285,308,23
"141c0df6cd1946539aadd1c9b7068cd4","3434c10e561d488a914e0f7d71907abd",22855679,1,-4,0,1456,308,305,-3
"130acc2aeb0448fdbb2de63bc5cebe5b","141c0df6cd1946539aadd1c9b7068cd4",22855679,1,-1,0,1458,309,308,-1
"141c0df6cd1946539aadd1c9b7068cd4","4a29443515bb404cb8924e1c60a63b73",22855679,1,-31,0,1459,308,285,-23
"4a29443515bb404cb8924e1c60a63b73","c2490bc612d146edbe786556fab3651b",22855679,1,71,0,1460,285,340,55
"bbc5139ca9024389a94db3a6f47dcff6","c2490bc612d146edbe786556fab3651b",22855679,1,-1,0,1463,341,340,-1
"c2490bc612d146edbe786556fab3651b","b8b9418ab322418d9db9b40d96af873a",22855679,1,-4,0,1467,340,337,-3
"4ee6ca9019ab4a1ab323f98094a9bd77","c2490bc612d146edbe786556fab3651b",22855679,1,-3,0,1470,343,340,-3
"c2490bc612d146edbe786556fab3651b","4a29443515bb404cb8924e1c60a63b73",22855679,1,-71,0,1471,340,285,-55
"4a29443515bb404cb8924e1c60a63b73","30ead9794d4847abaf222ca966cc8630",22855679,1,82,0,1472,285,348,63
"2fe14166dc9642c3bc666b86a57f943d","1ba8fef685d74a8194b9db252eb704fb",22855679,1,-2,0,1475,357,355,-2
"f00179e251a045b39c3f7a54f9aa4acc","2fe14166dc9642c3bc666b86a57f943d",22855679,2,-7,0,1478,363,357,-6
"44421dd1e13a47a388c4a19834b744c7","52580888dadb4fe3baa795683ea227bd",22855679,1,6,0,1480,359,364,5
"52580888dadb4fe3baa795683ea227bd","1ba8fef685d74a8194b9db252eb704fb",22855679,3,-10,0,1481,364,355,-9
"1ba8fef685d74a8194b9db252eb704fb","f00179e251a045b39c3f7a54f9aa4acc",22855679,1,9,0,1482,355,363,8
"44421dd1e13a47a388c4a19834b744c7","1ba8fef685d74a8194b9db252eb704fb",22855679,1,-4,0,1485,359,355,-4
"52580888dadb4fe3baa795683ea227bd","2fe14166dc9642c3bc666b86a57f943d",22855679,1,-8,0,1487,364,357,-7
"2fe14166dc9642c3bc666b86a57f943d","f00179e251a045b39c3f7a54f9aa4acc",22855679,2,7,0,1488,357,363,6
"f00179e251a045b39c3f7a54f9aa4acc","1ba8fef685d74a8194b9db252eb704fb",22855679,1,-9,0,1489,363,355,-8
"1ba8fef685d74a8194b9db252eb704fb","492a3bc6a1254f23a7998587961b22a4",22855679,1,13,0,1490,355,366,11
"072a190fd302456290895f9f04d6940a","492a3bc6a1254f23a7998587961b22a4",22855679,1,1,0,1492,365,366,1
"492a3bc6a1254f23a7998587961b22a4","c76574d21bc14aeea7ecd0b027f39858",22855679,1,2,0,1493,366,367,1
"c76574d21bc14aeea7ecd0b027f39858","492a3bc6a1254f23a7998587961b22a4",22855679,1,-2,0,1494,367,366,-1
"c76574d21bc14aeea7ecd0b027f39858","2fe14166dc9642c3bc666b86a57f943d",22855679,1,-13,0,1498,367,357,-10
"2fe14166dc9642c3bc666b86a57f943d","52580888dadb4fe3baa795683ea227bd",22855679,1,8,0,1499,357,364,7
"f00179e251a045b39c3f7a54f9aa4acc","cb5fc7ef85d547c4be1a7439d0bf6052",22855679,1,-4,0,1503,363,360,-3
"cb5fc7ef85d547c4be1a7439d0bf6052","52580888dadb4fe3baa795683ea227bd",22855679,1,5,0,1506,360,364,4
"1ba8fef685d74a8194b9db252eb704fb","d6d02b6ef04e4f17805504500b8ce441",22855679,1,28,0,1508,355,375,20
"d6d02b6ef04e4f17805504500b8ce441","4a29443515bb404cb8924e1c60a63b73",22855679,1,-118,0,1511,375,285,-90
"4a29443515bb404cb8924e1c60a63b73","d6d02b6ef04e4f17805504500b8ce441",22855679,1,118,0,1512,285,375,90
"7f544639412e40a9ba27f43b415362ab","d6d02b6ef04e4f17805504500b8ce441",22855679,1,-6,0,1531,378,375,-3
"66baf19b6b904b70922329068c63746d","66baf19b6b904b70922329068c63746d",22855679,1,0,1,1537,376,376,0
"7f544639412e40a9ba27f43b415362ab","7f544639412e40a9ba27f43b415362ab",22855679,1,0,1,1539,378,378,0
"7f544639412e40a9ba27f43b415362ab","d5ae8642e15b46b8bd298b02274d4e9c",22855679,2,2,0,1540,378,380,2
"d5ae8642e15b46b8bd298b02274d4e9c","d5ae8642e15b46b8bd298b02274d4e9c",22855679,2,0,1,1541,380,380,0
"d5ae8642e15b46b8bd298b02274d4e9c","a0d10309a2dd456289147f84be9d37f9",22855679,1,1,0,1542,380,381,1
"a0d10309a2dd456289147f84be9d37f9","a0d10309a2dd456289147f84be9d37f9",22855679,2,0,1,1543,381,381,0
"a0d10309a2dd456289147f84be9d37f9","0fcbc3ca07b144138b8d85da581f09a8",22855679,1,1,0,1545,381,382,1
"0fcbc3ca07b144138b8d85da581f09a8","0fcbc3ca07b144138b8d85da581f09a8",22855679,2,0,1,1546,382,382,0
"0fcbc3ca07b144138b8d85da581f09a8","66baf19b6b904b70922329068c63746d",22855679,1,-6,0,1548,382,376,-6
"7f544639412e40a9ba27f43b415362ab","c2fca3669923477ab966ded303dea31c",22855679,1,6,0,1550,378,383,5
"c2fca3669923477ab966ded303dea31c","66baf19b6b904b70922329068c63746d",22855679,1,-8,0,1551,383,376,-7
"66baf19b6b904b70922329068c63746d","c2fca3669923477ab966ded303dea31c",22855679,1,8,0,1552,376,383,7
"c2fca3669923477ab966ded303dea31c","4890121ce5d74576b4632b77cfc23398",22855679,2,6,0,1553,383,388,5
"4890121ce5d74576b4632b77cfc23398","18d3b836dd804224883cc9180b60a8e1",22855679,2,-1,0,1554,388,387,-1
"18d3b836dd804224883cc9180b60a8e1","7f544639412e40a9ba27f43b415362ab",22855679,1,-11,0,1555,387,378,-9
"d5ae8642e15b46b8bd298b02274d4e9c","66baf19b6b904b70922329068c63746d",22855679,1,-4,0,1558,380,376,-4
"66baf19b6b904b70922329068c63746d","4890121ce5d74576b4632b77cfc23398",22855679,1,14,0,1559,376,388,12
"4890121ce5d74576b4632b77cfc23398","c2fca3669923477ab966ded303dea31c",22855679,1,-6,0,1560,388,383,-5
"18d3b836dd804224883cc9180b60a8e1","96bb2b3e85a34d8b9544514e89f6fe97",22855679,1,4,0,1563,387,390,3
"96bb2b3e85a34d8b9544514e89f6fe97","96bb2b3e85a34d8b9544514e89f6fe97",22855679,3,0,1,1564,390,390,0
"96bb2b3e85a34d8b9544514e89f6fe97","ac4e9b54acfe4670b4634859c7263cb5",22855679,2,2,0,1565,390,392,2
"ac4e9b54acfe4670b4634859c7263cb5","ac4e9b54acfe4670b4634859c7263cb5",22855679,3,0,1,1566,392,392,0
"ac4e9b54acfe4670b4634859c7263cb5","17f95d18bab743888e1736033dc3384d",22855679,1,-3,0,1569,392,389,-3
"17f95d18bab743888e1736033dc3384d","6f8881a745ac4c358a68b92c3b4abe81",22855679,3,6,0,1570,389,394,5
"6f8881a745ac4c358a68b92c3b4abe81","f7002c8484354eceac57bc7bd62c76c1",22855679,3,-1,0,1571,394,393,-1
"f7002c8484354eceac57bc7bd62c76c1","96bb2b3e85a34d8b9544514e89f6fe97",22855679,2,-4,0,1572,393,390,-3
"ac4e9b54acfe4670b4634859c7263cb5","6f8881a745ac4c358a68b92c3b4abe81",22855679,1,3,0,1574,392,394,2
"6f8881a745ac4c358a68b92c3b4abe81","17f95d18bab743888e1736033dc3384d",22855679,2,-6,0,1575,394,389,-5
"17f95d18bab743888e1736033dc3384d","96bb2b3e85a34d8b9544514e89f6fe97",22855679,1,1,0,1576,389,390,1
"96bb2b3e85a34d8b9544514e89f6fe97","f7002c8484354eceac57bc7bd62c76c1",22855679,1,4,0,1577,390,393,3
"f7002c8484354eceac57bc7bd62c76c1","17f95d18bab743888e1736033dc3384d",22855679,1,-5,0,1578,393,389,-4
"96bb2b3e85a34d8b9544514e89f6fe97","6f8881a745ac4c358a68b92c3b4abe81",22855679,1,5,0,1584,390,394,4
"f7002c8484354eceac57bc7bd62c76c1","44a277ea44dc4ae689fab4b82f0b4098",22855679,1,5,0,1588,393,397,4
"44a277ea44dc4ae689fab4b82f0b4098","44a277ea44dc4ae689fab4b82f0b4098",22855679,1,0,1,1589,397,397,0
"44a277ea44dc4ae689fab4b82f0b4098","0c12af0a4e7f4002852cf84b2537c161",22855679,1,-2,0,1590,397,395,-2
"0c12af0a4e7f4002852cf84b2537c161","859e0b8d71694b12befb69ee698138f9",22855679,1,5,0,1591,395,399,4
"859e0b8d71694b12befb69ee698138f9","859e0b8d71694b12befb69ee698138f9",22855679,1,0,1,1592,399,399,0
"859e0b8d71694b12befb69ee698138f9","2b09a08242b54983aec7063990fb3f66",22855679,1,3,0,1593,399,400,1
"2b09a08242b54983aec7063990fb3f66","66baf19b6b904b70922329068c63746d",22855679,1,-32,0,1594,400,376,-24
"66baf19b6b904b70922329068c63746d","2b09a08242b54983aec7063990fb3f66",22855679,1,32,0,1595,376,400,24
"2b09a08242b54983aec7063990fb3f66","2b09a08242b54983aec7063990fb3f66",22855679,4,0,1,1596,400,400,0
"2b09a08242b54983aec7063990fb3f66","1f471b7a883a4df48211e8c6a81b59a7",22855679,1,1,0,1600,400,401,1
"1f471b7a883a4df48211e8c6a81b59a7","1f471b7a883a4df48211e8c6a81b59a7",22855679,1,0,1,1601,401,401,0
"1f471b7a883a4df48211e8c6a81b59a7","2b09a08242b54983aec7063990fb3f66",22855679,1,-1,0,1602,401,400,-1
"2b09a08242b54983aec7063990fb3f66","9de0d567bfa84fe5b77cb76f4a76a5d1",22855679,1,5,0,1603,400,404,4
"9de0d567bfa84fe5b77cb76f4a76a5d1","9de0d567bfa84fe5b77cb76f4a76a5d1",22855679,1,0,1,1604,404,404,0
"9de0d567bfa84fe5b77cb76f4a76a5d1","1157bd665ec4472fb58b751dc5099355",22855679,1,-1,0,1605,404,403,-1
"1157bd665ec4472fb58b751dc5099355","3c8a22d2f9c146ea956609e3ed4f2559",22855679,1,3,0,1606,403,405,2
"3c8a22d2f9c146ea956609e3ed4f2559","58fc9094275e4c49be3f4ba6d4acc0a4",22855679,1,2,0,1607,405,406,1
"58fc9094275e4c49be3f4ba6d4acc0a4","58fc9094275e4c49be3f4ba6d4acc0a4",22855679,1,0,1,1608,406,406,0
"58fc9094275e4c49be3f4ba6d4acc0a4","c1c1be90b2b14c1ab4a5e1ee3c241902",22855679,1,1,0,1609,406,407,1
"c1c1be90b2b14c1ab4a5e1ee3c241902","c1c1be90b2b14c1ab4a5e1ee3c241902",22855679,5,0,1,1610,407,407,0
"c1c1be90b2b14c1ab4a5e1ee3c241902","02b3a1bead9244c1ba2f857c7da8f82a",22855679,1,2,0,1615,407,408,1
"02b3a1bead9244c1ba2f857c7da8f82a","58fc9094275e4c49be3f4ba6d4acc0a4",22855679,1,-3,0,1616,408,406,-2
"58fc9094275e4c49be3f4ba6d4acc0a4","02b3a1bead9244c1ba2f857c7da8f82a",22855679,1,3,0,1617,406,408,2
"02b3a1bead9244c1ba2f857c7da8f82a","02b3a1bead9244c1ba2f857c7da8f82a",22855679,1,0,1,1618,408,408,0
"02b3a1bead9244c1ba2f857c7da8f82a","6206fc6479014bb193084c32409dc1b9",22855679,1,1,0,1619,408,409,1
"6206fc6479014bb193084c32409dc1b9","6206fc6479014bb193084c32409dc1b9",22855679,1,0,1,1620,409,409,0
"6206fc6479014bb193084c32409dc1b9","6a5f020451db426dacba9e2ea3fcc62a",22855679,1,2,0,1621,409,410,1
"6a5f020451db426dacba9e2ea3fcc62a","02b3a1bead9244c1ba2f857c7da8f82a",22855679,1,-3,0,1622,410,408,-2
"02b3a1bead9244c1ba2f857c7da8f82a","6a5f020451db426dacba9e2ea3fcc62a",22855679,1,3,0,1623,408,410,2
"6a5f020451db426dacba9e2ea3fcc62a","33a9d248b2e44588a5b07fc1342b9bc2",22855679,2,2,0,1624,410,411,1
"33a9d248b2e44588a5b07fc1342b9bc2","6a5f020451db426dacba9e2ea3fcc62a",22855679,1,-2,0,1625,411,410,-1
"33a9d248b2e44588a5b07fc1342b9bc2","c6f26bd420634f1cb7989e76fe6b16c0",22855679,1,1,0,1627,411,412,1
"c6f26bd420634f1cb7989e76fe6b16c0","c6f26bd420634f1cb7989e76fe6b16c0",22855679,5,0,1,1628,412,412,0
"c6f26bd420634f1cb7989e76fe6b16c0","2a65ee6e2ac64f6a8a55fbe5373ec763",22855679,1,1,0,1633,412,413,1
"2a65ee6e2ac64f6a8a55fbe5373ec763","2a65ee6e2ac64f6a8a55fbe5373ec763",22855679,2,0,1,1634,413,413,0
"2a65ee6e2ac64f6a8a55fbe5373ec763","33a9d248b2e44588a5b07fc1342b9bc2",22855679,1,-2,0,1636,413,411,-2
"33a9d248b2e44588a5b07fc1342b9bc2","1fd0f6dadbc14ebc965faf6122190b96",22855679,1,5,0,1637,411,415,4
"1fd0f6dadbc14ebc965faf6122190b96","1fd0f6dadbc14ebc965faf6122190b96",22855679,1,0,1,1638,415,415,0
"1fd0f6dadbc14ebc965faf6122190b96","687055dad9fc40c3982478fe33ec01bf",22855679,1,-1,0,1639,415,414,-1
"687055dad9fc40c3982478fe33ec01bf","2add1669f08d4101913db15f8c23b3b7",22855679,1,3,0,1640,414,416,2
"2add1669f08d4101913db15f8c23b3b7","2add1669f08d4101913db15f8c23b3b7",22855679,1,0,1,1641,416,416,0
"2add1669f08d4101913db15f8c23b3b7","2b09a08242b54983aec7063990fb3f66",22855679,1,-24,0,1642,416,400,-16
"2b09a08242b54983aec7063990fb3f66","a2b4bd40cee2481ebd3fc179d6a5cd62",22855679,1,27,0,1643,400,417,17
"a2b4bd40cee2481ebd3fc179d6a5cd62","d6d02b6ef04e4f17805504500b8ce441",22855679,1,-63,0,1644,417,375,-42
"d6d02b6ef04e4f17805504500b8ce441","a2b4bd40cee2481ebd3fc179d6a5cd62",22855679,1,63,0,1649,375,417,42
"a2b4bd40cee2481ebd3fc179d6a5cd62","a2b4bd40cee2481ebd3fc179d6a5cd62",22855679,2,0,1,1650,417,417,0
"a2b4bd40cee2481ebd3fc179d6a5cd62","e34e59dce2204f228f3a84b6725df60f",22855679,1,2,0,1651,417,419,2
"e34e59dce2204f228f3a84b6725df60f","e34e59dce2204f228f3a84b6725df60f",22855679,1,0,1,1652,419,419,0
"e34e59dce2204f228f3a84b6725df60f","a2b4bd40cee2481ebd3fc179d6a5cd62",22855679,1,-2,0,1653,419,417,-2
"a2b4bd40cee2481ebd3fc179d6a5cd62","bec48fc2e1294c7eb3d0aca780d731b8",22855679,2,4,0,1654,417,420,3
"bec48fc2e1294c7eb3d0aca780d731b8","bec48fc2e1294c7eb3d0aca780d731b8",22855679,7,0,1,1655,420,420,0
"bec48fc2e1294c7eb3d0aca780d731b8","dbde19fcce2a4c1abdc7f685c293a23f",22855679,3,3,0,1659,420,422,2
"dbde19fcce2a4c1abdc7f685c293a23f","bec48fc2e1294c7eb3d0aca780d731b8",22855679,1,-3,0,1660,422,420,-2
"bec48fc2e1294c7eb3d0aca780d731b8","a2b4bd40cee2481ebd3fc179d6a5cd62",22855679,1,-4,0,1661,420,417,-3
"dbde19fcce2a4c1abdc7f685c293a23f","a24600b0e49245f6bdba8c893cfeddb0",22855679,1,4,0,1665,422,425,3
"a24600b0e49245f6bdba8c893cfeddb0","a24600b0e49245f6bdba8c893cfeddb0",22855679,3,0,1,1666,425,425,0
"a24600b0e49245f6bdba8c893cfeddb0","5d290f75e44b4bdb8256c600debbb44d",22855679,1,2,0,1669,425,426,1
"5d290f75e44b4bdb8256c600debbb44d","bec48fc2e1294c7eb3d0aca780d731b8",22855679,1,-9,0,1670,426,420,-6
"dbde19fcce2a4c1abdc7f685c293a23f","a2b4bd40cee2481ebd3fc179d6a5cd62",22855679,1,-7,0,1674,422,417,-5
"a2b4bd40cee2481ebd3fc179d6a5cd62","24cf8786024543f19b89bc20034e60d7",22855679,2,18,0,1675,417,428,11
"24cf8786024543f19b89bc20034e60d7","f2a73be2f46840b182d7bd095378004e",22855679,2,1,0,1676,428,429,1
"f2a73be2f46840b182d7bd095378004e","24cf8786024543f19b89bc20034e60d7",22855679,1,-1,0,1677,429,428,-1
"24cf8786024543f19b89bc20034e60d7","a2b4bd40cee2481ebd3fc179d6a5cd62",22855679,1,-18,0,1678,428,417,-11
"f2a73be2f46840b182d7bd095378004e","f2a73be2f46840b182d7bd095378004e",22855679,2,0,1,1682,429,429,0
"f2a73be2f46840b182d7bd095378004e","604551fd4266430cb860fef58fa7dd61",22855679,1,1,0,1684,429,430,1
"604551fd4266430cb860fef58fa7dd61","604551fd4266430cb860fef58fa7dd61",22855679,1,0,1,1685,430,430,0
"604551fd4266430cb860fef58fa7dd61","24cf8786024543f19b89bc20034e60d7",22855679,1,-2,0,1686,430,428,-2
"24cf8786024543f19b89bc20034e60d7","dce46f8904594a62a6377a3587aaa663",22855679,3,4,0,1687,428,431,3
"dce46f8904594a62a6377a3587aaa663","dce46f8904594a62a6377a3587aaa663",22855679,6,0,1,1688,431,431,0
"dce46f8904594a62a6377a3587aaa663","9b9d0a249052413c869753b99682b0ac",22855679,3,1,0,1690,431,432,1
"9b9d0a249052413c869753b99682b0ac","9b9d0a249052413c869753b99682b0ac",22855679,4,0,1,1691,432,432,0
"9b9d0a249052413c869753b99682b0ac","061c175cc90f45fbad883025394e78dd",22855679,1,1,0,1694,432,433,1
"061c175cc90f45fbad883025394e78dd","061c175cc90f45fbad883025394e78dd",22855679,6,0,1,1695,433,433,0
"061c175cc90f45fbad883025394e78dd","dce46f8904594a62a6377a3587aaa663",22855679,3,-2,0,1701,433,431,-2
"dce46f8904594a62a6377a3587aaa663","66ada10dde9f43018588f1ced9d477fc",22855679,4,4,0,1703,431,434,3
"66ada10dde9f43018588f1ced9d477fc","061c175cc90f45fbad883025394e78dd",22855679,1,-2,0,1704,434,433,-1
"66ada10dde9f43018588f1ced9d477fc","dce46f8904594a62a6377a3587aaa663",22855679,3,-4,0,1708,434,431,-3
"9b9d0a249052413c869753b99682b0ac","dce46f8904594a62a6377a3587aaa663",22855679,2,-1,0,1711,432,431,-1
"dce46f8904594a62a6377a3587aaa663","74a7f8712e5449c2bc0b43c6f90dafed",22855679,1,5,0,1712,431,435,4
"74a7f8712e5449c2bc0b43c6f90dafed","74a7f8712e5449c2bc0b43c6f90dafed",22855679,1,0,1,1713,435,435,0
"74a7f8712e5449c2bc0b43c6f90dafed","66ada10dde9f43018588f1ced9d477fc",22855679,1,-1,0,1714,435,434,-1
"dce46f8904594a62a6377a3587aaa663","bf12c96466d840a69bed7020b3f18bb8",22855679,1,7,0,1716,431,436,5
"bf12c96466d840a69bed7020b3f18bb8","061c175cc90f45fbad883025394e78dd",22855679,1,-5,0,1717,436,433,-3
"66ada10dde9f43018588f1ced9d477fc","bf12c96466d840a69bed7020b3f18bb8",22855679,1,3,0,1720,434,436,2
"bf12c96466d840a69bed7020b3f18bb8","bf12c96466d840a69bed7020b3f18bb8",22855679,1,0,1,1721,436,436,0
"bf12c96466d840a69bed7020b3f18bb8","070600601c4c439288445d2f0724807d",22855679,1,3,0,1722,436,437,1
"070600601c4c439288445d2f0724807d","24cf8786024543f19b89bc20034e60d7",22855679,1,-14,0,1723,437,428,-9
"24cf8786024543f19b89bc20034e60d7","1823b6de7d334a7aaabc4570719af4d9",22855679,1,16,0,1724,428,439,11
"1823b6de7d334a7aaabc4570719af4d9","24cf8786024543f19b89bc20034e60d7",22855679,1,-16,0,1725,439,428,-11
"dce46f8904594a62a6377a3587aaa663","24cf8786024543f19b89bc20034e60d7",22855679,1,-4,0,1733,431,428,-3
"dce46f8904594a62a6377a3587aaa663","070600601c4c439288445d2f0724807d",22855679,1,10,0,1735,431,437,6
"070600601c4c439288445d2f0724807d","070600601c4c439288445d2f0724807d",22855679,1,0,1,1736,437,437,0
"070600601c4c439288445d2f0724807d","1823b6de7d334a7aaabc4570719af4d9",22855679,1,2,0,1737,437,439,2
"1823b6de7d334a7aaabc4570719af4d9","1823b6de7d334a7aaabc4570719af4d9",22855679,20,0,1,1738,439,439,0
"1823b6de7d334a7aaabc4570719af4d9","0380cd76a7d44bc3a4da1f15e4d68f89",22855679,1,2,0,1758,439,440,1
"0380cd76a7d44bc3a4da1f15e4d68f89","070600601c4c439288445d2f0724807d",22855679,1,-4,0,1759,440,437,-3
"070600601c4c439288445d2f0724807d","0380cd76a7d44bc3a4da1f15e4d68f89",22855679,1,4,0,1760,437,440,3
"0380cd76a7d44bc3a4da1f15e4d68f89","0380cd76a7d44bc3a4da1f15e4d68f89",22855679,1,0,1,1761,440,440,0
"0380cd76a7d44bc3a4da1f15e4d68f89","23b7673c8b5443108c2ef09382834a86",22855679,1,2,0,1762,440,441,1
"23b7673c8b5443108c2ef09382834a86","23b7673c8b5443108c2ef09382834a86",22855679,2,0,1,1763,441,441,0
"23b7673c8b5443108c2ef09382834a86","901e92500aea43c79f19f1b279050668",22855679,1,2,0,1765,441,442,1
"901e92500aea43c79f19f1b279050668","901e92500aea43c79f19f1b279050668",22855679,2,0,1,1766,442,442,0
"901e92500aea43c79f19f1b279050668","001339db8ced4cf78829ebe8b145449d",22855679,1,1,0,1768,442,443,1
"001339db8ced4cf78829ebe8b145449d","001339db8ced4cf78829ebe8b145449d",22855679,2,0,1,1769,443,443,0
"001339db8ced4cf78829ebe8b145449d","452745e0366e42ae81561bfddebcc6c3",22855679,1,1,0,1771,443,444,1
"452745e0366e42ae81561bfddebcc6c3","452745e0366e42ae81561bfddebcc6c3",22855679,2,0,1,1772,444,444,0
"452745e0366e42ae81561bfddebcc6c3","901e92500aea43c79f19f1b279050668",22855679,1,-2,0,1774,444,442,-2
"901e92500aea43c79f19f1b279050668","4660ff2089114e8db82ceb26a4f329e3",22855679,1,4,0,1775,442,445,3
"4660ff2089114e8db82ceb26a4f329e3","4660ff2089114e8db82ceb26a4f329e3",22855679,2,0,1,1776,445,445,0
"4660ff2089114e8db82ceb26a4f329e3","7bd5586eb9d8484eb74a433ee7bfe499",22855679,1,2,0,1778,445,446,1
"7bd5586eb9d8484eb74a433ee7bfe499","7bd5586eb9d8484eb74a433ee7bfe499",22855679,15,0,1,1779,446,446,0
"7bd5586eb9d8484eb74a433ee7bfe499","8a7f26e690f34dda97be16904518ca99",22855679,1,2,0,1794,446,447,1
"8a7f26e690f34dda97be16904518ca99","8a7f26e690f34dda97be16904518ca99",22855679,2,0,1,1795,447,447,0
"8a7f26e690f34dda97be16904518ca99","b2f0d654738f48158edff28e8d3a546e",22855679,1,5,0,1796,447,449,2
"b2f0d654738f48158edff28e8d3a546e","070600601c4c439288445d2f0724807d",22855679,1,-21,0,1797,449,437,-12
"070600601c4c439288445d2f0724807d","f60ee41ec635499abd48168342d32c2f",22855679,1,26,0,1798,437,453,16
"f60ee41ec635499abd48168342d32c2f","f60ee41ec635499abd48168342d32c2f",22855679,56,0,1,1799,453,453,0
"f60ee41ec635499abd48168342d32c2f","b2f0d654738f48158edff28e8d3a546e",22855679,2,-5,0,1801,453,449,-4
"b2f0d654738f48158edff28e8d3a546e","f60ee41ec635499abd48168342d32c2f",22855679,1,5,0,1802,449,453,4
"b2f0d654738f48158edff28e8d3a546e","f67fbf45a5f146ed866965bc57c7c001",22855679,1,8,0,1851,449,454,5
"f67fbf45a5f146ed866965bc57c7c001","f67fbf45a5f146ed866965bc57c7c001",22855679,2,0,1,1852,454,454,0
"f67fbf45a5f146ed866965bc57c7c001","d937afe49bd24a07a550dda1c1155122",22855679,1,1,0,1854,454,455,1
"d937afe49bd24a07a550dda1c1155122","d937afe49bd24a07a550dda1c1155122",22855679,1,0,1,1855,455,455,0
"d937afe49bd24a07a550dda1c1155122","3628b3f7823443d0912a339096b69943",22855679,1,1,0,1856,455,456,1
"3628b3f7823443d0912a339096b69943","3628b3f7823443d0912a339096b69943",22855679,1,0,1,1857,456,456,0
"3628b3f7823443d0912a339096b69943","9e049ee647cf43ecbcb5ed792a8e7588",22855679,1,1,0,1858,456,457,1
"9e049ee647cf43ecbcb5ed792a8e7588","9e049ee647cf43ecbcb5ed792a8e7588",22855679,1,0,1,1859,457,457,0
"9e049ee647cf43ecbcb5ed792a8e7588","5256a214faaf410b93f76cea06428334",22855679,1,1,0,1860,457,458,1
"5256a214faaf410b93f76cea06428334","5256a214faaf410b93f76cea06428334",22855679,1,0,1,1861,458,458,0
"5256a214faaf410b93f76cea06428334","25c32b120fce40fa9b6c85133aeb4716",22855679,1,1,0,1862,458,459,1
"25c32b120fce40fa9b6c85133aeb4716","25c32b120fce40fa9b6c85133aeb4716",22855679,3,0,1,1863,459,459,0
"25c32b120fce40fa9b6c85133aeb4716","11bc14f2204949008b7d511b933363c1",22855679,1,1,0,1866,459,460,1
"11bc14f2204949008b7d511b933363c1","11bc14f2204949008b7d511b933363c1",22855679,3,0,1,1867,460,460,0
"11bc14f2204949008b7d511b933363c1","42de338840a34d15adb66e7b14fb9d2c",22855679,1,1,0,1870,460,461,1
"42de338840a34d15adb66e7b14fb9d2c","42de338840a34d15adb66e7b14fb9d2c",22855679,1,0,1,1871,461,461,0
"42de338840a34d15adb66e7b14fb9d2c","9da37c6210b1416b8079c274f70bf600",22855679,1,1,0,1872,461,462,1
"9da37c6210b1416b8079c274f70bf600","9da37c6210b1416b8079c274f70bf600",22855679,3,0,1,1873,462,462,0
"9da37c6210b1416b8079c274f70bf600","519119f1deac45ff9ab4f13529be5c6e",22855679,1,1,0,1876,462,463,1
"519119f1deac45ff9ab4f13529be5c6e","519119f1deac45ff9ab4f13529be5c6e",22855679,1,0,1,1877,463,463,0
"519119f1deac45ff9ab4f13529be5c6e","c5df9f40ec14463b9dcfdc73df3e9285",22855679,1,3,0,1878,463,464,1
"c5df9f40ec14463b9dcfdc73df3e9285","f67fbf45a5f146ed866965bc57c7c001",22855679,1,-12,0,1879,464,454,-10
"f67fbf45a5f146ed866965bc57c7c001","c5df9f40ec14463b9dcfdc73df3e9285",22855679,1,12,0,1880,454,464,10
"c5df9f40ec14463b9dcfdc73df3e9285","c5df9f40ec14463b9dcfdc73df3e9285",22855679,6,0,1,1881,464,464,0
"c5df9f40ec14463b9dcfdc73df3e9285","83d42d95cd844fc093fc09cee250edb8",22855679,3,3,0,1882,464,465,1
"83d42d95cd844fc093fc09cee250edb8","83d42d95cd844fc093fc09cee250edb8",22855679,7,0,1,1883,465,465,0
"83d42d95cd844fc093fc09cee250edb8","c5df9f40ec14463b9dcfdc73df3e9285",22855679,2,-3,0,1885,465,464,-1
"c5df9f40ec14463b9dcfdc73df3e9285","8a7f26e690f34dda97be16904518ca99",22855679,1,-25,0,1888,464,447,-17
"8a7f26e690f34dda97be16904518ca99","070600601c4c439288445d2f0724807d",22855679,1,-16,0,1889,447,437,-10
"070600601c4c439288445d2f0724807d","8a7f26e690f34dda97be16904518ca99",22855679,1,16,0,1890,437,447,10
"8a7f26e690f34dda97be16904518ca99","7bd5586eb9d8484eb74a433ee7bfe499",22855679,1,-2,0,1892,447,446,-1
"7bd5586eb9d8484eb74a433ee7bfe499","d6d02b6ef04e4f17805504500b8ce441",22855679,1,-109,0,1893,446,375,-71
"d6d02b6ef04e4f17805504500b8ce441","b2f0d654738f48158edff28e8d3a546e",22855679,1,116,0,1896,375,449,74
"b2f0d654738f48158edff28e8d3a546e","9428d8bd9c5a47b2a235b254e5e27ded",22855679,1,4,0,1897,449,452,3
"9428d8bd9c5a47b2a235b254e5e27ded","f60ee41ec635499abd48168342d32c2f",22855679,1,1,0,1898,452,453,1
"f60ee41ec635499abd48168342d32c2f","c5df9f40ec14463b9dcfdc73df3e9285",22855679,1,15,0,1906,453,464,11
"c5df9f40ec14463b9dcfdc73df3e9285","d6d02b6ef04e4f17805504500b8ce441",22855679,1,-136,0,1909,464,375,-89
"d6d02b6ef04e4f17805504500b8ce441","c5df9f40ec14463b9dcfdc73df3e9285",22855679,1,136,0,1912,375,464,89
"b613861cecf84ffcab01afb23f660475","b613861cecf84ffcab01afb23f660475",22856177,5,0,1,1,1,1,0
"b613861cecf84ffcab01afb23f660475","e2911e79efc2420eac45d9f671463d4b",22856177,1,3,0,6,1,2,1
"e2911e79efc2420eac45d9f671463d4b","519d1b8c59404d67b54e96c5c8a830b2",22856177,1,1,0,10,2,3,1
"519d1b8c59404d67b54e96c5c8a830b2","519d1b8c59404d67b54e96c5c8a830b2",22856177,1,0,1,11,3,3,0
"519d1b8c59404d67b54e96c5c8a830b2","531db53f81f646edb0cdcfe0085b03b7",22856177,1,1,0,12,3,4,1
"531db53f81f646edb0cdcfe0085b03b7","531db53f81f646edb0cdcfe0085b03b7",22856177,1,0,1,13,4,4,0
"531db53f81f646edb0cdcfe0085b03b7","4f5f94b2f95141e0a9d53a61da2276da",22856177,1,1,0,14,4,5,1
"4f5f94b2f95141e0a9d53a61da2276da","4f5f94b2f95141e0a9d53a61da2276da",22856177,1,0,1,15,5,5,0
"4f5f94b2f95141e0a9d53a61da2276da","6d541c89590949f99af293c4f2333f67",22856177,1,1,0,16,5,6,1
"6d541c89590949f99af293c4f2333f67","6d541c89590949f99af293c4f2333f67",22856177,1,0,1,17,6,6,0
"6d541c89590949f99af293c4f2333f67","dd5cf0b9fe4c4f1d8f5ff8e4c04879cb",22856177,1,1,0,18,6,7,1
"dd5cf0b9fe4c4f1d8f5ff8e4c04879cb","dd5cf0b9fe4c4f1d8f5ff8e4c04879cb",22856177,1,0,1,19,7,7,0
"dd5cf0b9fe4c4f1d8f5ff8e4c04879cb","f96261861edc426abe2248be4f0a709a",22856177,1,1,0,20,7,8,1
"f96261861edc426abe2248be4f0a709a","f96261861edc426abe2248be4f0a709a",22856177,1,0,1,21,8,8,0
"f96261861edc426abe2248be4f0a709a","66b5e16f4f75454fb5b8172079f0fa83",22856177,1,1,0,22,8,9,1
"66b5e16f4f75454fb5b8172079f0fa83","66b5e16f4f75454fb5b8172079f0fa83",22856177,1,0,1,23,9,9,0
"66b5e16f4f75454fb5b8172079f0fa83","0680571d4698477995e41842c36a54b2",22856177,1,1,0,24,9,10,1
"0680571d4698477995e41842c36a54b2","0680571d4698477995e41842c36a54b2",22856177,2,0,1,25,10,10,0
"0680571d4698477995e41842c36a54b2","66b5e16f4f75454fb5b8172079f0fa83",22856177,1,-1,0,27,10,9,-1
"66b5e16f4f75454fb5b8172079f0fa83","f96261861edc426abe2248be4f0a709a",22856177,1,-1,0,28,9,8,-1
"f96261861edc426abe2248be4f0a709a","56586aa865414f538729c7f7735d2bc6",22856177,1,6,0,29,8,12,4
"56586aa865414f538729c7f7735d2bc6","e2911e79efc2420eac45d9f671463d4b",22856177,1,-12,0,30,12,2,-10
"e2911e79efc2420eac45d9f671463d4b","e2911e79efc2420eac45d9f671463d4b",22856177,4,0,1,31,2,2,0
"e2911e79efc2420eac45d9f671463d4b","56586aa865414f538729c7f7735d2bc6",22856177,2,12,0,32,2,12,10
"56586aa865414f538729c7f7735d2bc6","9112f2bffece48e08c6d2287be204085",22856177,1,-3,0,33,12,11,-1
"9112f2bffece48e08c6d2287be204085","9112f2bffece48e08c6d2287be204085",22856177,1,0,1,34,11,11,0
"9112f2bffece48e08c6d2287be204085","e2911e79efc2420eac45d9f671463d4b",22856177,1,-9,0,35,11,2,-9
"56586aa865414f538729c7f7735d2bc6","56586aa865414f538729c7f7735d2bc6",22856177,1,0,1,37,12,12,0
"56586aa865414f538729c7f7735d2bc6","9afd71a5298d4333b6849dfce1b9422c",22856177,1,13,0,38,12,18,6
"9afd71a5298d4333b6849dfce1b9422c","9afd71a5298d4333b6849dfce1b9422c",22856177,1,0,1,39,18,18,0
"9afd71a5298d4333b6849dfce1b9422c","a49d1bb4328949299686242fd0be5584",22856177,1,6,0,40,18,21,3
"a49d1bb4328949299686242fd0be5584","b7719e26494940efa49512aedd0aac79",22856177,1,-2,0,41,21,20,-1
"afbf7250b99d47bea07172749483ca97","b7719e26494940efa49512aedd0aac79",22856177,1,-12,0,43,28,20,-8
"afbf7250b99d47bea07172749483ca97","4e51676dc72045d99c19b9fa7b22f8bc",22856177,1,3,0,45,28,29,1
"4e51676dc72045d99c19b9fa7b22f8bc","4e51676dc72045d99c19b9fa7b22f8bc",22856177,1,0,1,46,29,29,0
"4e51676dc72045d99c19b9fa7b22f8bc","51970cfa30e643e894e66ae85c8024cc",22856177,1,3,0,47,29,31,2
"51970cfa30e643e894e66ae85c8024cc","c33c17be71ae4d588da7369472e5bb1b",22856177,1,6,0,48,31,34,3
"c33c17be71ae4d588da7369472e5bb1b","4e51676dc72045d99c19b9fa7b22f8bc",22856177,1,-9,0,49,34,29,-5
"4e51676dc72045d99c19b9fa7b22f8bc","93679be414554a11b1893002f2229a93",22856177,1,12,0,50,29,35,6
"93679be414554a11b1893002f2229a93","c33c17be71ae4d588da7369472e5bb1b",22856177,1,-3,0,51,35,34,-1
"c33c17be71ae4d588da7369472e5bb1b","93679be414554a11b1893002f2229a93",22856177,1,3,0,52,34,35,1
"93679be414554a11b1893002f2229a93","7040a13096d746ac84b8fac8d9752058",22856177,1,3,0,53,35,36,1
"7040a13096d746ac84b8fac8d9752058","9a0dc646f934470daf08c4b56ccf73db",22856177,2,3,0,54,36,37,1
"9a0dc646f934470daf08c4b56ccf73db","7040a13096d746ac84b8fac8d9752058",22856177,1,-3,0,55,37,36,-1
"9a0dc646f934470daf08c4b56ccf73db","fc0e049d56024bc9a02c9a9c435c3df7",22856177,1,3,0,57,37,38,1
"fc0e049d56024bc9a02c9a9c435c3df7","67a089198fcb4e1c8f2385786c2b296f",22856177,1,4,0,58,38,39,1
"67a089198fcb4e1c8f2385786c2b296f","fc0e049d56024bc9a02c9a9c435c3df7",22856177,1,-4,0,59,39,38,-1
"fc0e049d56024bc9a02c9a9c435c3df7","64d48c6c9c7940639a932219a6c87198",22856177,1,5,0,60,38,40,2
"64d48c6c9c7940639a932219a6c87198","64d48c6c9c7940639a932219a6c87198",22856177,1,0,1,61,40,40,0
"64d48c6c9c7940639a932219a6c87198","b534b89233134e30a9b5645138bfa9ee",22856177,1,3,0,62,40,41,1
"b534b89233134e30a9b5645138bfa9ee","67a089198fcb4e1c8f2385786c2b296f",22856177,1,-4,0,63,41,39,-2
"b534b89233134e30a9b5645138bfa9ee","b534b89233134e30a9b5645138bfa9ee",22856177,3,0,1,65,41,41,0
"b534b89233134e30a9b5645138bfa9ee","0e37b720d23b4e7f8b313e79313fd107",22856177,1,3,0,68,41,44,3
"0e37b720d23b4e7f8b313e79313fd107","0e37b720d23b4e7f8b313e79313fd107",22856177,3,0,1,69,44,44,0
"0e37b720d23b4e7f8b313e79313fd107","6875d67fdd5f48168b62719df449bebd",22856177,1,1,0,72,44,45,1
"6875d67fdd5f48168b62719df449bebd","6875d67fdd5f48168b62719df449bebd",22856177,1,0,1,73,45,45,0
"6875d67fdd5f48168b62719df449bebd","6e13d61a7bdb44bca949c9f86fab3be5",22856177,1,3,0,74,45,47,2
"6e13d61a7bdb44bca949c9f86fab3be5","b534b89233134e30a9b5645138bfa9ee",22856177,1,-7,0,75,47,41,-6
"b534b89233134e30a9b5645138bfa9ee","6e13d61a7bdb44bca949c9f86fab3be5",22856177,1,7,0,76,41,47,6
"6e13d61a7bdb44bca949c9f86fab3be5","d0c74f735e024943943e40333d6d337f",22856177,1,5,0,77,47,51,4
"d0c74f735e024943943e40333d6d337f","d9c8d8c444a64dadbbb508652c721e17",22856177,1,-6,0,78,51,46,-5
"d9c8d8c444a64dadbbb508652c721e17","d0c74f735e024943943e40333d6d337f",22856177,1,6,0,79,46,51,5
"d0c74f735e024943943e40333d6d337f","983f8ff320594b279a7f4a6fe132f9c5",22856177,1,2,0,80,51,53,2
"983f8ff320594b279a7f4a6fe132f9c5","983f8ff320594b279a7f4a6fe132f9c5",22856177,3,0,1,81,53,53,0
"983f8ff320594b279a7f4a6fe132f9c5","35adfa5d923046aebabfefd98f35ff05",22856177,1,1,0,84,53,54,1
"35adfa5d923046aebabfefd98f35ff05","35adfa5d923046aebabfefd98f35ff05",22856177,3,0,1,85,54,54,0
"35adfa5d923046aebabfefd98f35ff05","f924752d8a1149668870b1e7698486f7",22856177,1,-4,0,88,54,50,-4
"f924752d8a1149668870b1e7698486f7","a1f2f12debe5432fb7a70bcd12bacfb9",22856177,1,9,0,89,50,58,8
"78f30e4dcac84e3cbea8b2cc6e0d62b3","a1f2f12debe5432fb7a70bcd12bacfb9",22856177,1,-1,0,91,59,58,-1
"a1f2f12debe5432fb7a70bcd12bacfb9","a1f2f12debe5432fb7a70bcd12bacfb9",22856177,30,0,1,100,58,58,0
"a1f2f12debe5432fb7a70bcd12bacfb9","78f30e4dcac84e3cbea8b2cc6e0d62b3",22856177,2,1,0,122,58,59,1
"78f30e4dcac84e3cbea8b2cc6e0d62b3","78f30e4dcac84e3cbea8b2cc6e0d62b3",22856177,15,0,1,123,59,59,0
"78f30e4dcac84e3cbea8b2cc6e0d62b3","a0a418b8540d479fa6e0f653b701da8b",22856177,1,6,0,138,59,64,5
"a0a418b8540d479fa6e0f653b701da8b","bc42d26810654ea9a1df1efe1e58c7d5",22856177,2,-1,0,139,64,63,-1
"bc42d26810654ea9a1df1efe1e58c7d5","12aa6e1672ac4e7aa6449a7a8609cd72",22856177,1,-7,0,140,63,57,-6
"12aa6e1672ac4e7aa6449a7a8609cd72","a0a418b8540d479fa6e0f653b701da8b",22856177,1,8,0,141,57,64,7
"a0a418b8540d479fa6e0f653b701da8b","a0a418b8540d479fa6e0f653b701da8b",22856177,3,0,1,142,64,64,0
"bc42d26810654ea9a1df1efe1e58c7d5","bc42d26810654ea9a1df1efe1e58c7d5",22856177,3,0,1,146,63,63,0
"bc42d26810654ea9a1df1efe1e58c7d5","4c943503763e4e349906eea3ed3c8e86",22856177,1,-2,0,149,63,61,-2
"4c943503763e4e349906eea3ed3c8e86","4c943503763e4e349906eea3ed3c8e86",22856177,1,0,1,150,61,61,0
"4c943503763e4e349906eea3ed3c8e86","309ccf3cc4fe429d9bfbaef53d3fa479",22856177,1,-1,0,151,61,60,-1
"309ccf3cc4fe429d9bfbaef53d3fa479","d646286c8051419bbc2e31dd1db55ca8",22856177,1,10,0,152,60,67,7
"b534b89233134e30a9b5645138bfa9ee","267f883678b24aed855fde42524975d9",22856177,1,37,0,154,41,71,30
"267f883678b24aed855fde42524975d9","267f883678b24aed855fde42524975d9",22856177,1,0,1,155,71,71,0
"267f883678b24aed855fde42524975d9","88fff56d0342490dbef9040750a20f6c",22856177,1,1,0,156,71,72,1
"88fff56d0342490dbef9040750a20f6c","88fff56d0342490dbef9040750a20f6c",22856177,1,0,1,157,72,72,0
"88fff56d0342490dbef9040750a20f6c","adb17b12b66c4a49a85fd34322f7df70",22856177,1,1,0,158,72,73,1
"adb17b12b66c4a49a85fd34322f7df70","adb17b12b66c4a49a85fd34322f7df70",22856177,1,0,1,159,73,73,0
"adb17b12b66c4a49a85fd34322f7df70","a2becd407db34b189200a32546d9d569",22856177,1,3,0,160,73,75,2
"a2becd407db34b189200a32546d9d569","d646286c8051419bbc2e31dd1db55ca8",22856177,1,-9,0,161,75,67,-8
"d646286c8051419bbc2e31dd1db55ca8","a2becd407db34b189200a32546d9d569",22856177,1,9,0,162,67,75,8
"a2becd407db34b189200a32546d9d569","140d5b27b8574befad82c0a013b59dfa",22856177,1,-1,0,163,75,74,-1
"140d5b27b8574befad82c0a013b59dfa","d18a9ea32855445f8736581f5cb119ce",22856177,1,9,0,164,74,82,8
"d18a9ea32855445f8736581f5cb119ce","f564483cbd7a407681aa2fcca518cf5f",22856177,1,4,0,165,82,85,3
"f564483cbd7a407681aa2fcca518cf5f","f564483cbd7a407681aa2fcca518cf5f",22856177,6,0,1,166,85,85,0
"f564483cbd7a407681aa2fcca518cf5f","18fd01350bd5434ca636d59a599d768a",22856177,1,1,0,172,85,86,1
"18fd01350bd5434ca636d59a599d768a","18fd01350bd5434ca636d59a599d768a",22856177,8,0,1,173,86,86,0
"18fd01350bd5434ca636d59a599d768a","6a9f0ef185fb47f0937e29daa1c71ed5",22856177,1,5,0,181,86,90,4
"6a9f0ef185fb47f0937e29daa1c71ed5","ae5ac430ea254e708a6f5deaaf7464ae",22856177,1,-7,0,182,90,84,-6
"ae5ac430ea254e708a6f5deaaf7464ae","6a9f0ef185fb47f0937e29daa1c71ed5",22856177,1,7,0,183,84,90,6
"6a9f0ef185fb47f0937e29daa1c71ed5","6a9f0ef185fb47f0937e29daa1c71ed5",22856177,7,0,1,184,90,90,0
"6a9f0ef185fb47f0937e29daa1c71ed5","c681290961c94c4caf23b529d1ae6b9a",22856177,1,-2,0,187,90,88,-2
"c681290961c94c4caf23b529d1ae6b9a","c681290961c94c4caf23b529d1ae6b9a",22856177,1,0,1,188,88,88,0
"c681290961c94c4caf23b529d1ae6b9a","d646286c8051419bbc2e31dd1db55ca8",22856177,1,-25,0,189,88,67,-21
"d646286c8051419bbc2e31dd1db55ca8","e20db35ced8544ddac5bc3839145e463",22856177,4,30,0,190,67,91,24
"e20db35ced8544ddac5bc3839145e463","1febb706d7a34005ae8711ed49c76e64",22856177,1,3,0,191,91,94,3
"1febb706d7a34005ae8711ed49c76e64","1febb706d7a34005ae8711ed49c76e64",22856177,2,0,1,192,94,94,0
"1febb706d7a34005ae8711ed49c76e64","08be90ffbeea4795a138cd42ed8db56f",22856177,1,4,0,194,94,98,4
"08be90ffbeea4795a138cd42ed8db56f","08be90ffbeea4795a138cd42ed8db56f",22856177,5,0,1,195,98,98,0
"08be90ffbeea4795a138cd42ed8db56f","e20db35ced8544ddac5bc3839145e463",22856177,1,-7,0,200,98,91,-7
"e20db35ced8544ddac5bc3839145e463","d391c8b6e56a43a7b654e9dee02d904b",22856177,2,13,0,201,91,103,12
"d391c8b6e56a43a7b654e9dee02d904b","00ae5f0c51874a73a41ebea838d95682",22856177,1,-2,0,202,103,101,-2
"00ae5f0c51874a73a41ebea838d95682","67a089198fcb4e1c8f2385786c2b296f",22856177,1,-78,0,203,101,39,-62
"67a089198fcb4e1c8f2385786c2b296f","e20db35ced8544ddac5bc3839145e463",22856177,1,67,0,204,39,91,52
"e20db35ced8544ddac5bc3839145e463","73039f8c1eb9409cb4caee2cf968001e",22856177,1,10,0,205,91,100,9
"73039f8c1eb9409cb4caee2cf968001e","00ae5f0c51874a73a41ebea838d95682",22856177,1,1,0,206,100,101,1
"00ae5f0c51874a73a41ebea838d95682","d391c8b6e56a43a7b654e9dee02d904b",22856177,1,2,0,207,101,103,2
"d391c8b6e56a43a7b654e9dee02d904b","73039f8c1eb9409cb4caee2cf968001e",22856177,1,-3,0,208,103,100,-3
"73039f8c1eb9409cb4caee2cf968001e","d646286c8051419bbc2e31dd1db55ca8",22856177,1,-40,0,209,100,67,-33
"e20db35ced8544ddac5bc3839145e463","6a9f0ef185fb47f0937e29daa1c71ed5",22856177,1,-3,0,211,91,90,-1
"6a9f0ef185fb47f0937e29daa1c71ed5","d646286c8051419bbc2e31dd1db55ca8",22856177,2,-27,0,214,90,67,-23
"d391c8b6e56a43a7b654e9dee02d904b","e20db35ced8544ddac5bc3839145e463",22856177,1,-13,0,217,103,91,-12
"e20db35ced8544ddac5bc3839145e463","00ae5f0c51874a73a41ebea838d95682",22856177,1,11,0,218,91,101,10
"00ae5f0c51874a73a41ebea838d95682","4280927ec4d643238aa49c32f9e06c6c",22856177,1,9,0,219,101,109,8
"4280927ec4d643238aa49c32f9e06c6c","73039f8c1eb9409cb4caee2cf968001e",22856177,1,-10,0,220,109,100,-9
"73039f8c1eb9409cb4caee2cf968001e","08111f75e22d409998cf8b85bd431f0a",22856177,1,9,0,221,100,108,8
"08111f75e22d409998cf8b85bd431f0a","a9ae0a3c070d455bb4369a8996313336",22856177,1,7,0,222,108,114,6
"a9ae0a3c070d455bb4369a8996313336","71cec822bcff4f30a20e75dc63ef7b65",22856177,1,2,0,223,114,116,2
"71cec822bcff4f30a20e75dc63ef7b65","71cec822bcff4f30a20e75dc63ef7b65",22856177,1,0,1,224,116,116,0
"71cec822bcff4f30a20e75dc63ef7b65","37319e88176d4aefa91d7a9980dbae91",22856177,1,-4,0,225,116,112,-4
"37319e88176d4aefa91d7a9980dbae91","62bff51286ef4f348717a3cf6fe2318f",22856177,1,9,0,226,112,120,8
"62bff51286ef4f348717a3cf6fe2318f","b1cd0e7dc3ad4a8eb91a4bfdbeb025b0",22856177,1,-2,0,227,120,118,-2
"b1cd0e7dc3ad4a8eb91a4bfdbeb025b0","b1cd0e7dc3ad4a8eb91a4bfdbeb025b0",22856177,1,0,1,228,118,118,0
"b1cd0e7dc3ad4a8eb91a4bfdbeb025b0","62bff51286ef4f348717a3cf6fe2318f",22856177,1,2,0,229,118,120,2
"62bff51286ef4f348717a3cf6fe2318f","62bff51286ef4f348717a3cf6fe2318f",22856177,3,0,1,230,120,120,0
"62bff51286ef4f348717a3cf6fe2318f","e20db35ced8544ddac5bc3839145e463",22856177,1,-33,0,233,120,91,-29
"e20db35ced8544ddac5bc3839145e463","779f9ddd1fd14d1e9e69f72219a1fdbd",22856177,1,36,0,234,91,121,30
"779f9ddd1fd14d1e9e69f72219a1fdbd","a8dd5213034441ac92724b4e83eb0bb2",22856177,1,9,0,235,121,129,8
"a8dd5213034441ac92724b4e83eb0bb2","779f9ddd1fd14d1e9e69f72219a1fdbd",22856177,1,-9,0,236,129,121,-8
"779f9ddd1fd14d1e9e69f72219a1fdbd","579338175e0b4bbb8ef3b712b5d8b54e",22856177,1,8,0,237,121,128,7
"579338175e0b4bbb8ef3b712b5d8b54e","8bc5795d6a984a3eace4e2811e52dd4f",22856177,1,8,0,238,128,135,7
"8bc5795d6a984a3eace4e2811e52dd4f","8bc5795d6a984a3eace4e2811e52dd4f",22856177,1,0,1,239,135,135,0
"8bc5795d6a984a3eace4e2811e52dd4f","b416d47c56a742199b5d7c7f19d6503a",22856177,1,-1,0,240,135,134,-1
"b416d47c56a742199b5d7c7f19d6503a","cd4532ad48034873ba8bce2aac0c9808",22856177,1,4,0,241,134,137,3
"cd4532ad48034873ba8bce2aac0c9808","cd4532ad48034873ba8bce2aac0c9808",22856177,1,0,1,242,137,137,0
"cd4532ad48034873ba8bce2aac0c9808","779f9ddd1fd14d1e9e69f72219a1fdbd",22856177,1,-19,0,243,137,121,-16
"779f9ddd1fd14d1e9e69f72219a1fdbd","df1de691dafe4549a18a4398ee9dfaf9",22856177,1,23,0,244,121,139,18
"df1de691dafe4549a18a4398ee9dfaf9","6c5ad271a44743479bfaea29b1db8d02",22856177,1,4,0,245,139,143,4
"6c5ad271a44743479bfaea29b1db8d02","8aae34f5ddbb4052a709b12e6b0d40fa",22856177,1,5,0,246,143,147,4
"8aae34f5ddbb4052a709b12e6b0d40fa","df1de691dafe4549a18a4398ee9dfaf9",22856177,1,-9,0,247,147,139,-8
"df1de691dafe4549a18a4398ee9dfaf9","f902b0f41b544d4dbf79664fd233648d",22856177,1,8,0,248,139,146,7
"f902b0f41b544d4dbf79664fd233648d","ae781e8b775e4ccd93bc800dad5c8376",22856177,1,8,0,249,146,153,7
"ae781e8b775e4ccd93bc800dad5c8376","ae781e8b775e4ccd93bc800dad5c8376",22856177,5,0,1,250,153,153,0
"ae781e8b775e4ccd93bc800dad5c8376","06882a8492d9499aa31555567f575ecb",22856177,1,1,0,255,153,154,1
"06882a8492d9499aa31555567f575ecb","06882a8492d9499aa31555567f575ecb",22856177,1,0,1,256,154,154,0
"06882a8492d9499aa31555567f575ecb","f293c508f409466a8f27ddd7d1e40b20",22856177,1,1,0,257,154,155,1
"f293c508f409466a8f27ddd7d1e40b20","f293c508f409466a8f27ddd7d1e40b20",22856177,5,0,1,258,155,155,0
"f293c508f409466a8f27ddd7d1e40b20","cc4ddef5bbbe48ebb605141b347c4ed1",22856177,1,1,0,263,155,156,1
"cc4ddef5bbbe48ebb605141b347c4ed1","cc4ddef5bbbe48ebb605141b347c4ed1",22856177,1,0,1,264,156,156,0
"cc4ddef5bbbe48ebb605141b347c4ed1","d313cec988a84645bee413e8d4724a4b",22856177,1,3,0,265,156,158,2
"d313cec988a84645bee413e8d4724a4b","f03480cf4eba413194d7af52fc0e7f28",22856177,1,-7,0,266,158,152,-6
"f03480cf4eba413194d7af52fc0e7f28","d313cec988a84645bee413e8d4724a4b",22856177,1,7,0,267,152,158,6
"d313cec988a84645bee413e8d4724a4b","d313cec988a84645bee413e8d4724a4b",22856177,6,0,1,268,158,158,0
"d313cec988a84645bee413e8d4724a4b","78adeee1fa2c4fe0bc73f7bca9fcee86",22856177,1,4,0,271,158,160,2
"78adeee1fa2c4fe0bc73f7bca9fcee86","df1de691dafe4549a18a4398ee9dfaf9",22856177,1,-26,0,272,160,139,-21
"df1de691dafe4549a18a4398ee9dfaf9","df1de691dafe4549a18a4398ee9dfaf9",22856177,1,0,1,273,139,139,0
"df1de691dafe4549a18a4398ee9dfaf9","78adeee1fa2c4fe0bc73f7bca9fcee86",22856177,2,26,0,274,139,160,21
"78adeee1fa2c4fe0bc73f7bca9fcee86","d313cec988a84645bee413e8d4724a4b",22856177,1,-4,0,275,160,158,-2
"d313cec988a84645bee413e8d4724a4b","8aae34f5ddbb4052a709b12e6b0d40fa",22856177,1,-13,0,278,158,147,-11
"8aae34f5ddbb4052a709b12e6b0d40fa","f4ce60b4a944484082ccb701b48b3da1",22856177,1,12,0,279,147,157,10
"f4ce60b4a944484082ccb701b48b3da1","d313cec988a84645bee413e8d4724a4b",22856177,1,1,0,280,157,158,1
"d313cec988a84645bee413e8d4724a4b","f902b0f41b544d4dbf79664fd233648d",22856177,1,-14,0,281,158,146,-12
"f902b0f41b544d4dbf79664fd233648d","d313cec988a84645bee413e8d4724a4b",22856177,1,14,0,282,146,158,12
"d313cec988a84645bee413e8d4724a4b","dc60696c76a74368a60f72246e47700d",22856177,1,1,0,284,158,159,1
"dc60696c76a74368a60f72246e47700d","dc60696c76a74368a60f72246e47700d",22856177,1,0,1,285,159,159,0
"dc60696c76a74368a60f72246e47700d","df1de691dafe4549a18a4398ee9dfaf9",22856177,1,-23,0,286,159,139,-20
"78adeee1fa2c4fe0bc73f7bca9fcee86","67a089198fcb4e1c8f2385786c2b296f",22856177,1,-152,0,288,160,39,-121
"67a089198fcb4e1c8f2385786c2b296f","3cbcea2be0984e7dbd5a48195af10ce7",22856177,1,160,0,289,39,165,126
"3cbcea2be0984e7dbd5a48195af10ce7","3cbcea2be0984e7dbd5a48195af10ce7",22856177,1,0,1,290,165,165,0
"82e6285962b8400d9d6fc32436022a94","67a089198fcb4e1c8f2385786c2b296f",22856177,1,-162,0,292,167,39,-128
"67a089198fcb4e1c8f2385786c2b296f","a9ac840f098c4bd0a2ee896214ce29cd",22856177,1,165,0,293,39,168,129
"a9ac840f098c4bd0a2ee896214ce29cd","a9ac840f098c4bd0a2ee896214ce29cd",22856177,2,0,1,294,168,168,0
"a9ac840f098c4bd0a2ee896214ce29cd","3cbcea2be0984e7dbd5a48195af10ce7",22856177,1,-5,0,295,168,165,-3
"3cbcea2be0984e7dbd5a48195af10ce7","78adeee1fa2c4fe0bc73f7bca9fcee86",22856177,1,-8,0,296,165,160,-5
"78adeee1fa2c4fe0bc73f7bca9fcee86","8959e6304a0348309a771e4d08d1b64a",22856177,1,4,0,297,160,163,3
"8959e6304a0348309a771e4d08d1b64a","65202579580f4ad38d734b4ee39d22a8",22856177,1,1,0,298,163,164,1
"67a089198fcb4e1c8f2385786c2b296f","0c7262dff33c4087bc660ccf40f92f9c",22856177,1,169,0,307,39,169,130
"0c7262dff33c4087bc660ccf40f92f9c","67a089198fcb4e1c8f2385786c2b296f",22856177,1,-169,0,308,169,39,-130
"67a089198fcb4e1c8f2385786c2b296f","b2275c3fad834f8d90737a2d9a6927d6",22856177,1,172,0,309,39,172,133
"b2275c3fad834f8d90737a2d9a6927d6","f661500307d74c908e9207d949ceb4aa",22856177,1,-51,0,310,172,136,-36
"f661500307d74c908e9207d949ceb4aa","779f9ddd1fd14d1e9e69f72219a1fdbd",22856177,1,-18,0,311,136,121,-15
"779f9ddd1fd14d1e9e69f72219a1fdbd","67a089198fcb4e1c8f2385786c2b296f",22856177,1,-103,0,312,121,39,-82
"67a089198fcb4e1c8f2385786c2b296f","0d987bed3ffa4ed0b9a2e62e97b7b30f",22856177,1,304,0,313,39,272,233
"0c7262dff33c4087bc660ccf40f92f9c","b2275c3fad834f8d90737a2d9a6927d6",22856177,2,3,0,316,169,172,3
"b2275c3fad834f8d90737a2d9a6927d6","a9ac840f098c4bd0a2ee896214ce29cd",22856177,1,-7,0,317,172,168,-4
"a9ac840f098c4bd0a2ee896214ce29cd","d646286c8051419bbc2e31dd1db55ca8",22856177,1,-128,0,319,168,67,-101
"d646286c8051419bbc2e31dd1db55ca8","6a9f0ef185fb47f0937e29daa1c71ed5",22856177,1,27,0,320,67,90,23
"e20db35ced8544ddac5bc3839145e463","78adeee1fa2c4fe0bc73f7bca9fcee86",22856177,1,85,0,325,91,160,69
"78adeee1fa2c4fe0bc73f7bca9fcee86","78adeee1fa2c4fe0bc73f7bca9fcee86",22856177,2,0,1,326,160,160,0
"65202579580f4ad38d734b4ee39d22a8","b7719e26494940efa49512aedd0aac79",22856177,1,-197,0,336,164,20,-144
"b7719e26494940efa49512aedd0aac79","b7719e26494940efa49512aedd0aac79",22856177,1,0,1,337,20,20,0
"b7719e26494940efa49512aedd0aac79","afbf7250b99d47bea07172749483ca97",22856177,3,12,0,338,20,28,8
"afbf7250b99d47bea07172749483ca97","0c7262dff33c4087bc660ccf40f92f9c",22856177,1,197,0,339,28,169,141
"b2275c3fad834f8d90737a2d9a6927d6","b2275c3fad834f8d90737a2d9a6927d6",22856177,30,0,1,341,172,172,0
"b2275c3fad834f8d90737a2d9a6927d6","eb515a26030b41f8a82a1e6114420bad",22856177,1,1,0,371,172,173,1
"eb515a26030b41f8a82a1e6114420bad","eb515a26030b41f8a82a1e6114420bad",22856177,2,0,1,372,173,173,0
"eb515a26030b41f8a82a1e6114420bad","0c7262dff33c4087bc660ccf40f92f9c",22856177,1,-4,0,374,173,169,-4
"0c7262dff33c4087bc660ccf40f92f9c","b42cc17b7de840f181a704558d0bc845",22856177,1,7,0,375,169,175,6
"b42cc17b7de840f181a704558d0bc845","ea38cc0e6e6e41edbabf210220808bf9",22856177,1,5,0,376,175,179,4
"ea38cc0e6e6e41edbabf210220808bf9","b87c552dd247427abe6ab5795b9c9d43",22856177,2,2,0,377,179,181,2
"b87c552dd247427abe6ab5795b9c9d43","362fcb0699a14845ab29b2340093e528",22856177,1,-8,0,378,181,174,-7
"362fcb0699a14845ab29b2340093e528","139b097acfca451689d80c9c6eebdf7b",22856177,1,5,0,379,174,178,4
"139b097acfca451689d80c9c6eebdf7b","b42cc17b7de840f181a704558d0bc845",22856177,1,-4,0,380,178,175,-3
"b42cc17b7de840f181a704558d0bc845","801f9e9135034f49bf5f8b4bdefedb41",22856177,1,2,0,381,175,177,2
"801f9e9135034f49bf5f8b4bdefedb41","801f9e9135034f49bf5f8b4bdefedb41",22856177,7,0,1,382,177,177,0
"801f9e9135034f49bf5f8b4bdefedb41","362fcb0699a14845ab29b2340093e528",22856177,1,-3,0,389,177,174,-3
"362fcb0699a14845ab29b2340093e528","ea38cc0e6e6e41edbabf210220808bf9",22856177,1,6,0,390,174,179,5
"b87c552dd247427abe6ab5795b9c9d43","b87c552dd247427abe6ab5795b9c9d43",22856177,8,0,1,392,181,181,0
"b87c552dd247427abe6ab5795b9c9d43","139b097acfca451689d80c9c6eebdf7b",22856177,1,-3,0,400,181,178,-3
"139b097acfca451689d80c9c6eebdf7b","30f660a1feb34582a739722532524f79",22856177,1,6,0,401,178,183,5
"30f660a1feb34582a739722532524f79","30f660a1feb34582a739722532524f79",22856177,6,0,1,402,183,183,0
"30f660a1feb34582a739722532524f79","2024b4885bd14338a39b7b509acbbd02",22856177,1,-1,0,407,183,182,-1
"2024b4885bd14338a39b7b509acbbd02","30f660a1feb34582a739722532524f79",22856177,1,1,0,408,182,183,1
"30f660a1feb34582a739722532524f79","0c7262dff33c4087bc660ccf40f92f9c",22856177,1,-17,0,410,183,169,-14
"0c7262dff33c4087bc660ccf40f92f9c","0c7262dff33c4087bc660ccf40f92f9c",22856177,2,0,1,411,169,169,0
"0c7262dff33c4087bc660ccf40f92f9c","c8e371568a0c4391b25796ae4e91952e",22856177,2,23,0,413,169,186,17
"c8e371568a0c4391b25796ae4e91952e","c8e371568a0c4391b25796ae4e91952e",22856177,1,0,1,414,186,186,0
"c8e371568a0c4391b25796ae4e91952e","ab11d94c6c8948ea90b88f19d2cd502b",22856177,1,5,0,415,186,190,4
"ab11d94c6c8948ea90b88f19d2cd502b","c8e371568a0c4391b25796ae4e91952e",22856177,1,-5,0,416,190,186,-4
"c8e371568a0c4391b25796ae4e91952e","07b44a7a51e94c78b411c753fc39dab0",22856177,1,4,0,417,186,189,3
"07b44a7a51e94c78b411c753fc39dab0","6cd2dcaac46847d4a0bc53f296d90375",22856177,1,6,0,418,189,194,5
"6cd2dcaac46847d4a0bc53f296d90375","017d7ca8e0394b91aaadc9574df2202c",22856177,1,-1,0,419,194,193,-1
"017d7ca8e0394b91aaadc9574df2202c","54e8e9f0ea3e45c4bf3b8ac799ee31b1",22856177,1,8,0,420,193,200,7
"54e8e9f0ea3e45c4bf3b8ac799ee31b1","54e8e9f0ea3e45c4bf3b8ac799ee31b1",22856177,1,0,1,421,200,200,0
"54e8e9f0ea3e45c4bf3b8ac799ee31b1","c614a00911be4877a075f19315530fb0",22856177,1,1,0,422,200,201,1
"c614a00911be4877a075f19315530fb0","c614a00911be4877a075f19315530fb0",22856177,6,0,1,423,201,201,0
"c614a00911be4877a075f19315530fb0","a6c21bd8b95249c7972820a7a7d76aff",22856177,1,1,0,429,201,202,1
"a6c21bd8b95249c7972820a7a7d76aff","a6c21bd8b95249c7972820a7a7d76aff",22856177,1,0,1,430,202,202,0
"a6c21bd8b95249c7972820a7a7d76aff","bb329d880ab54120adaf203a693bb203",22856177,1,1,0,431,202,203,1
"bb329d880ab54120adaf203a693bb203","bb329d880ab54120adaf203a693bb203",22856177,1,0,1,432,203,203,0
"bb329d880ab54120adaf203a693bb203","f9170dd6bc6442b4acd832747609b09a",22856177,1,-4,0,433,203,199,-4
"f9170dd6bc6442b4acd832747609b09a","334c2344009840079b1d0e1b7ce3d5a7",22856177,1,7,0,434,199,205,6
"334c2344009840079b1d0e1b7ce3d5a7","334c2344009840079b1d0e1b7ce3d5a7",22856177,1,0,1,435,205,205,0
"334c2344009840079b1d0e1b7ce3d5a7","d7f13c8d63ec4e2aa673fbb9cf9c6933",22856177,1,3,0,436,205,206,1
"d7f13c8d63ec4e2aa673fbb9cf9c6933","c8e371568a0c4391b25796ae4e91952e",22856177,1,-26,0,437,206,186,-20
"c8e371568a0c4391b25796ae4e91952e","b9e80f77c3a44349863b19875725c384",22856177,1,27,0,438,186,207,21
"b9e80f77c3a44349863b19875725c384","7108f0e4c2584f1f9c471689ae4c885c",22856177,1,1,0,439,207,208,1
"7108f0e4c2584f1f9c471689ae4c885c","d7f13c8d63ec4e2aa673fbb9cf9c6933",22856177,1,-2,0,440,208,206,-2
"d7f13c8d63ec4e2aa673fbb9cf9c6933","09400e101c5d4b439cf9a26b03aae558",22856177,1,5,0,441,206,210,4
"09400e101c5d4b439cf9a26b03aae558","a88efa7e50ce47159810ab553afa6d3a",22856177,2,2,0,442,210,212,2
"a88efa7e50ce47159810ab553afa6d3a","a88efa7e50ce47159810ab553afa6d3a",22856177,10,0,1,443,212,212,0
"a88efa7e50ce47159810ab553afa6d3a","be502a7a43c44bf7b682698de79d9369",22856177,2,3,0,445,212,214,2
"be502a7a43c44bf7b682698de79d9369","a875096404ef4a9984b62d74cda916f9",22856177,1,-6,0,446,214,209,-5
"a875096404ef4a9984b62d74cda916f9","f7fb1952f56b4189b86a9f8b7862d2b8",22856177,1,7,0,447,209,215,6
"f7fb1952f56b4189b86a9f8b7862d2b8","ec341f459285443b8361f7f15638ff08",22856177,1,-2,0,448,215,213,-2
"ec341f459285443b8361f7f15638ff08","363837c182e04711840d896ae1e0339c",22856177,1,6,0,449,213,218,5
"363837c182e04711840d896ae1e0339c","363837c182e04711840d896ae1e0339c",22856177,23,0,1,450,218,218,0
"363837c182e04711840d896ae1e0339c","01b2051f8941460d89945e3b02d1ce78",22856177,1,-1,0,473,218,217,-1
"01b2051f8941460d89945e3b02d1ce78","0c7262dff33c4087bc660ccf40f92f9c",22856177,1,-63,0,474,217,169,-48
"0c7262dff33c4087bc660ccf40f92f9c","fab84b4fab5940efb4ea868ef8d09396",22856177,1,153,0,475,169,284,115
"fab84b4fab5940efb4ea868ef8d09396","fab84b4fab5940efb4ea868ef8d09396",22856177,2,0,1,476,284,284,0
"fab84b4fab5940efb4ea868ef8d09396","94cecc3f1e7d484b8e068e79241dfd73",22856177,2,-5,0,478,284,281,-3
"94cecc3f1e7d484b8e068e79241dfd73","94cecc3f1e7d484b8e068e79241dfd73",22856177,3,0,1,479,281,281,0
"0c7262dff33c4087bc660ccf40f92f9c","2024b4885bd14338a39b7b509acbbd02",22856177,1,16,0,484,169,182,13
"2024b4885bd14338a39b7b509acbbd02","0c7262dff33c4087bc660ccf40f92f9c",22856177,1,-16,0,485,182,169,-13
"0c7262dff33c4087bc660ccf40f92f9c","c3f63fe50d8e487c86bf8ef76c9cadd3",22856177,1,20,0,486,169,185,16
"c3f63fe50d8e487c86bf8ef76c9cadd3","c3f63fe50d8e487c86bf8ef76c9cadd3",22856177,1,0,1,487,185,185,0
"c3f63fe50d8e487c86bf8ef76c9cadd3","0c7262dff33c4087bc660ccf40f92f9c",22856177,1,-20,0,488,185,169,-16
"c8e371568a0c4391b25796ae4e91952e","d7f13c8d63ec4e2aa673fbb9cf9c6933",22856177,1,26,0,490,186,206,20
"d7f13c8d63ec4e2aa673fbb9cf9c6933","d7f13c8d63ec4e2aa673fbb9cf9c6933",22856177,2,0,1,491,206,206,0
"d7f13c8d63ec4e2aa673fbb9cf9c6933","a875096404ef4a9984b62d74cda916f9",22856177,1,4,0,493,206,209,3
"a875096404ef4a9984b62d74cda916f9","09400e101c5d4b439cf9a26b03aae558",22856177,1,1,0,494,209,210,1
"09400e101c5d4b439cf9a26b03aae558","09400e101c5d4b439cf9a26b03aae558",22856177,1,0,1,495,210,210,0
"be502a7a43c44bf7b682698de79d9369","f7fb1952f56b4189b86a9f8b7862d2b8",22856177,2,1,0,506,214,215,1
"f7fb1952f56b4189b86a9f8b7862d2b8","a875096404ef4a9984b62d74cda916f9",22856177,1,-7,0,507,215,209,-6
"a875096404ef4a9984b62d74cda916f9","be502a7a43c44bf7b682698de79d9369",22856177,1,6,0,508,209,214,5
"f7fb1952f56b4189b86a9f8b7862d2b8","f7fb1952f56b4189b86a9f8b7862d2b8",22856177,11,0,1,510,215,215,0
"f7fb1952f56b4189b86a9f8b7862d2b8","363837c182e04711840d896ae1e0339c",22856177,1,4,0,521,215,218,3
"363837c182e04711840d896ae1e0339c","ec341f459285443b8361f7f15638ff08",22856177,1,-6,0,522,218,213,-5
"ec341f459285443b8361f7f15638ff08","01b2051f8941460d89945e3b02d1ce78",22856177,1,5,0,523,213,217,4
"01b2051f8941460d89945e3b02d1ce78","91125ca626c5470eb145501f8c37f8db",22856177,1,4,0,524,217,220,3
"91125ca626c5470eb145501f8c37f8db","91125ca626c5470eb145501f8c37f8db",22856177,1,0,1,525,220,220,0
"91125ca626c5470eb145501f8c37f8db","1c6721b1f63f4d30ba7746ea8af02a52",22856177,1,3,0,526,220,221,1
"1c6721b1f63f4d30ba7746ea8af02a52","d7f13c8d63ec4e2aa673fbb9cf9c6933",22856177,1,-21,0,527,221,206,-15
"d7f13c8d63ec4e2aa673fbb9cf9c6933","77ecef8eff6b4a2caea7707669bf7475",22856177,1,22,0,528,206,222,16
"77ecef8eff6b4a2caea7707669bf7475","77ecef8eff6b4a2caea7707669bf7475",22856177,4,0,1,529,222,222,0
"77ecef8eff6b4a2caea7707669bf7475","8b9ae98743bd4d4a8a87dff1c1244211",22856177,1,6,0,533,222,227,5
"8b9ae98743bd4d4a8a87dff1c1244211","d03cb855c70044cf8c35d9ec0de696e3",22856177,1,-3,0,534,227,224,-3
"d03cb855c70044cf8c35d9ec0de696e3","1c6721b1f63f4d30ba7746ea8af02a52",22856177,1,-4,0,535,224,221,-3
"1c6721b1f63f4d30ba7746ea8af02a52","f7906d6f59b9489a91d2ef40db5a474d",22856177,1,3,0,536,221,223,2
"f7906d6f59b9489a91d2ef40db5a474d","2ab1535aac1346ba8801535bf729ef37",22856177,1,7,0,537,223,229,6
"2ab1535aac1346ba8801535bf729ef37","a4f40fb48a8542c8949bae1f002cd9bc",22856177,1,2,0,538,229,231,2
"a4f40fb48a8542c8949bae1f002cd9bc","a4f40fb48a8542c8949bae1f002cd9bc",22856177,8,0,1,539,231,231,0
"a4f40fb48a8542c8949bae1f002cd9bc","8972c23e32044edb8a78fa1eed4e5947",22856177,1,1,0,547,231,232,1
"8972c23e32044edb8a78fa1eed4e5947","8972c23e32044edb8a78fa1eed4e5947",22856177,3,0,1,548,232,232,0
"8972c23e32044edb8a78fa1eed4e5947","92feb4a40f8344d38b6f722e42a53295",22856177,1,1,0,551,232,233,1
"92feb4a40f8344d38b6f722e42a53295","92feb4a40f8344d38b6f722e42a53295",22856177,2,0,1,552,233,233,0
"92feb4a40f8344d38b6f722e42a53295","5152833676bf4c6cb317060be10f68db",22856177,1,-5,0,554,233,228,-5
"5152833676bf4c6cb317060be10f68db","ca3e28f290354c08aefe5b0f769604e6",22856177,1,8,0,555,228,235,7
"ca3e28f290354c08aefe5b0f769604e6","ca3e28f290354c08aefe5b0f769604e6",22856177,9,0,1,556,235,235,0
"ca3e28f290354c08aefe5b0f769604e6","79a35eea833e4c2c9d22fc53c3c6445c",22856177,1,1,0,565,235,236,1
"79a35eea833e4c2c9d22fc53c3c6445c","79a35eea833e4c2c9d22fc53c3c6445c",22856177,4,0,1,566,236,236,0
"79a35eea833e4c2c9d22fc53c3c6445c","8f68228b1518449e9615cdafee41a2bd",22856177,1,1,0,570,236,237,1
"8f68228b1518449e9615cdafee41a2bd","8f68228b1518449e9615cdafee41a2bd",22856177,1,0,1,571,237,237,0
"8f68228b1518449e9615cdafee41a2bd","cab89fa5c3ed45a5aa550fc0352d6a42",22856177,1,1,0,572,237,238,1
"cab89fa5c3ed45a5aa550fc0352d6a42","cab89fa5c3ed45a5aa550fc0352d6a42",22856177,6,0,1,573,238,238,0
"cab89fa5c3ed45a5aa550fc0352d6a42","1c6721b1f63f4d30ba7746ea8af02a52",22856177,1,-20,0,579,238,221,-17
"1c6721b1f63f4d30ba7746ea8af02a52","0b04c8e2f86d48c7aeb7e225819cd32b",22856177,1,16,0,580,221,234,13
"0b04c8e2f86d48c7aeb7e225819cd32b","1c6721b1f63f4d30ba7746ea8af02a52",22856177,1,-16,0,581,234,221,-13
"1c6721b1f63f4d30ba7746ea8af02a52","2ae94c0cea4d480a9d5dca8fb1d7b542",22856177,2,27,0,582,221,242,21
"1ebf23f9d994469a85206e4c7b1bf5f5","fa235f0f364d47e4ae1c87f47bf8e6ba",22856177,1,9,0,584,245,252,7
"fa235f0f364d47e4ae1c87f47bf8e6ba","2ae94c0cea4d480a9d5dca8fb1d7b542",22856177,1,-12,0,585,252,242,-10
"2ae94c0cea4d480a9d5dca8fb1d7b542","fa235f0f364d47e4ae1c87f47bf8e6ba",22856177,2,12,0,586,242,252,10
"fa235f0f364d47e4ae1c87f47bf8e6ba","79f7845465cc4ed19d8e4f1429541be0",22856177,1,2,0,587,252,254,2
"79f7845465cc4ed19d8e4f1429541be0","79f7845465cc4ed19d8e4f1429541be0",22856177,2,0,1,588,254,254,0
"79f7845465cc4ed19d8e4f1429541be0","6e83e23f56544a19b94067c1c558d9c0",22856177,1,-8,0,590,254,247,-7
"d546341988904f069cfa86b21457d9d9","28c171777c52431ab6b925073bd63d46",22856177,1,15,0,593,251,264,13
"28c171777c52431ab6b925073bd63d46","28c171777c52431ab6b925073bd63d46",22856177,7,0,1,594,264,264,0
"28c171777c52431ab6b925073bd63d46","ac160db940cb49ae8579162b1d52bb5d",22856177,1,2,0,601,264,266,2
"ac160db940cb49ae8579162b1d52bb5d","ac160db940cb49ae8579162b1d52bb5d",22856177,7,0,1,602,266,266,0
"ac160db940cb49ae8579162b1d52bb5d","d989ebcfc12a4b669f0100dc1aa14f1e",22856177,1,-12,0,609,266,255,-11
"d989ebcfc12a4b669f0100dc1aa14f1e","c6fd49b485cc4874b0bbdd9c6171e09c",22856177,1,15,0,610,255,268,13
"c6fd49b485cc4874b0bbdd9c6171e09c","c6fd49b485cc4874b0bbdd9c6171e09c",22856177,12,0,1,611,268,268,0
"c6fd49b485cc4874b0bbdd9c6171e09c","44240778a97c4af0937817499b75707b",22856177,1,1,0,623,268,269,1
"44240778a97c4af0937817499b75707b","44240778a97c4af0937817499b75707b",22856177,2,0,1,624,269,269,0
"44240778a97c4af0937817499b75707b","7aa76d3e993840d8805f097cbdbcd44b",22856177,1,-9,0,626,269,261,-8
"bb5a47f5ea01454a8b79455422d3b9da","94cecc3f1e7d484b8e068e79241dfd73",22856177,1,3,0,639,280,281,1
"0d987bed3ffa4ed0b9a2e62e97b7b30f","a37477c4e4c14169ad44b06b493007f6",22856177,1,15,0,641,272,283,11
"a37477c4e4c14169ad44b06b493007f6","fab84b4fab5940efb4ea868ef8d09396",22856177,1,3,0,646,283,284,1
"94cecc3f1e7d484b8e068e79241dfd73","1c6721b1f63f4d30ba7746ea8af02a52",22856177,1,-78,0,648,281,221,-60
"1c6721b1f63f4d30ba7746ea8af02a52","f53da5fd9bfe412da4b80d4742563b6c",22856177,1,24,0,649,221,241,20
"f53da5fd9bfe412da4b80d4742563b6c","f53da5fd9bfe412da4b80d4742563b6c",22856177,1,0,1,650,241,241,0
"f53da5fd9bfe412da4b80d4742563b6c","2ae94c0cea4d480a9d5dca8fb1d7b542",22856177,1,3,0,651,241,242,1
"2ae94c0cea4d480a9d5dca8fb1d7b542","865a4d3b43374da7944dc7d397f566d9",22856177,1,35,0,652,242,271,29
"865a4d3b43374da7944dc7d397f566d9","865a4d3b43374da7944dc7d397f566d9",22856177,1,0,1,653,271,271,0
"865a4d3b43374da7944dc7d397f566d9","1c6721b1f63f4d30ba7746ea8af02a52",22856177,1,-62,0,654,271,221,-50
"1c6721b1f63f4d30ba7746ea8af02a52","1c6721b1f63f4d30ba7746ea8af02a52",22856177,1,0,1,655,221,221,0
"fa235f0f364d47e4ae1c87f47bf8e6ba","00f61990949545828dd12f1303d47504",22856177,1,5,0,660,252,256,4
"00f61990949545828dd12f1303d47504","6e83e23f56544a19b94067c1c558d9c0",22856177,1,-11,0,661,256,247,-9
"6e83e23f56544a19b94067c1c558d9c0","d546341988904f069cfa86b21457d9d9",22856177,1,5,0,662,247,251,4
"2ae94c0cea4d480a9d5dca8fb1d7b542","4a29443515bb404cb8924e1c60a63b73",22856177,1,60,0,667,242,285,43
"4a29443515bb404cb8924e1c60a63b73","4a29443515bb404cb8924e1c60a63b73",22856177,1,0,1,668,285,285,0
"4a29443515bb404cb8924e1c60a63b73","208c9b2796c944db8dacaa96082520ea",22856177,1,3,0,669,285,288,3
"208c9b2796c944db8dacaa96082520ea","208c9b2796c944db8dacaa96082520ea",22856177,1,0,1,670,288,288,0
"208c9b2796c944db8dacaa96082520ea","4a29443515bb404cb8924e1c60a63b73",22856177,1,-3,0,671,288,285,-3
"4a29443515bb404cb8924e1c60a63b73","7669a956527947d0add87455277e80b4",22856177,1,7,0,672,285,291,6
"7669a956527947d0add87455277e80b4","7669a956527947d0add87455277e80b4",22856177,1,0,1,673,291,291,0
"7669a956527947d0add87455277e80b4","869e967078f04da18dd0b0b9389a7424",22856177,1,3,0,674,291,293,2
"869e967078f04da18dd0b0b9389a7424","6a9a3b5bde4a48daa896fe8c06eca56f",22856177,1,-5,0,675,293,289,-4
"6a9a3b5bde4a48daa896fe8c06eca56f","869e967078f04da18dd0b0b9389a7424",22856177,1,5,0,676,289,293,4
"869e967078f04da18dd0b0b9389a7424","869e967078f04da18dd0b0b9389a7424",22856177,4,0,1,677,293,293,0
"869e967078f04da18dd0b0b9389a7424","51ab6291537748fab90d519aa09889d6",22856177,1,2,0,681,293,295,2
"51ab6291537748fab90d519aa09889d6","51ab6291537748fab90d519aa09889d6",22856177,11,0,1,682,295,295,0
"51ab6291537748fab90d519aa09889d6","34a6e49023fc4465bd5ca604330bbd1c",22856177,1,-3,0,693,295,292,-3
"34a6e49023fc4465bd5ca604330bbd1c","21592f2a9e9c4b2f8c66ec5dbcbf6a2b",22856177,1,5,0,694,292,296,4
"21592f2a9e9c4b2f8c66ec5dbcbf6a2b","ba0e59461bfb4a44b7b1c28a01f8d3b3",22856177,1,4,0,695,296,299,3
"ba0e59461bfb4a44b7b1c28a01f8d3b3","ba0e59461bfb4a44b7b1c28a01f8d3b3",22856177,1,0,1,696,299,299,0
"ba0e59461bfb4a44b7b1c28a01f8d3b3","0e0b36e731a645e7b1b8a88f5031ca38",22856177,1,2,0,697,299,301,2
"0e0b36e731a645e7b1b8a88f5031ca38","0e0b36e731a645e7b1b8a88f5031ca38",22856177,8,0,1,698,301,301,0
"0e0b36e731a645e7b1b8a88f5031ca38","ba0e59461bfb4a44b7b1c28a01f8d3b3",22856177,1,-2,0,706,301,299,-2
"ba0e59461bfb4a44b7b1c28a01f8d3b3","a66a144637284c21afc6de17fea4bfb8",22856177,1,3,0,707,299,302,3
"a66a144637284c21afc6de17fea4bfb8","a66a144637284c21afc6de17fea4bfb8",22856177,2,0,1,708,302,302,0
"a66a144637284c21afc6de17fea4bfb8","7646a919d7e64fa990bca9b024ff089d",22856177,1,-4,0,710,302,298,-4
"7646a919d7e64fa990bca9b024ff089d","e390b575229748ea8aac9364efe2bf00",22856177,1,7,0,711,298,304,6
"e390b575229748ea8aac9364efe2bf00","e390b575229748ea8aac9364efe2bf00",22856177,1,0,1,712,304,304,0
"e390b575229748ea8aac9364efe2bf00","3434c10e561d488a914e0f7d71907abd",22856177,1,3,0,713,304,305,1
"3434c10e561d488a914e0f7d71907abd","4a29443515bb404cb8924e1c60a63b73",22856177,1,-27,0,714,305,285,-20
"4a29443515bb404cb8924e1c60a63b73","53e7e900392747ccad52e711ab0f80d8",22856177,1,29,0,715,285,307,22
"53e7e900392747ccad52e711ab0f80d8","53e7e900392747ccad52e711ab0f80d8",22856177,2,0,1,716,307,307,0
"53e7e900392747ccad52e711ab0f80d8","3434c10e561d488a914e0f7d71907abd",22856177,1,-2,0,718,307,305,-2
"3434c10e561d488a914e0f7d71907abd","130acc2aeb0448fdbb2de63bc5cebe5b",22856177,1,5,0,719,305,309,4
"130acc2aeb0448fdbb2de63bc5cebe5b","9c062b3251034ebe90f5054e2a3b5120",22856177,1,2,0,720,309,311,2
"9c062b3251034ebe90f5054e2a3b5120","9c062b3251034ebe90f5054e2a3b5120",22856177,2,0,1,721,311,311,0
"9c062b3251034ebe90f5054e2a3b5120","ea859f8207e44537889daeaba13ac2e8",22856177,1,1,0,723,311,312,1
"ea859f8207e44537889daeaba13ac2e8","ea859f8207e44537889daeaba13ac2e8",22856177,9,0,1,724,312,312,0
"ea859f8207e44537889daeaba13ac2e8","141c0df6cd1946539aadd1c9b7068cd4",22856177,1,-4,0,733,312,308,-4
"141c0df6cd1946539aadd1c9b7068cd4","13255e63e0aa4abf85e5211bf613d43e",22856177,1,10,0,734,308,317,9
"13255e63e0aa4abf85e5211bf613d43e","13255e63e0aa4abf85e5211bf613d43e",22856177,1,0,1,735,317,317,0
"13255e63e0aa4abf85e5211bf613d43e","0c787d16c9504873b1a4d903cec09948",22856177,1,-3,0,736,317,314,-3
"0c787d16c9504873b1a4d903cec09948","86c27d40179e419c8e9d150fb6afa5d0",22856177,1,6,0,737,314,319,5
"86c27d40179e419c8e9d150fb6afa5d0","86c27d40179e419c8e9d150fb6afa5d0",22856177,1,0,1,738,319,319,0
"86c27d40179e419c8e9d150fb6afa5d0","47edbb64109243e6b0f8f64cdef90c6c",22856177,1,8,0,739,319,326,7
"47edbb64109243e6b0f8f64cdef90c6c","24f1363179ad4aaa965484a78471912b",22856177,1,-3,0,740,326,323,-3
"24f1363179ad4aaa965484a78471912b","8d7e0b55cf9849cda222a0f2440cec55",22856177,1,-6,0,741,323,318,-5
"8d7e0b55cf9849cda222a0f2440cec55","24f1363179ad4aaa965484a78471912b",22856177,1,6,0,742,318,323,5
"24f1363179ad4aaa965484a78471912b","3628bdce1dd2429ba924d2d4d09448d2",22856177,1,-1,0,743,323,322,-1
"3628bdce1dd2429ba924d2d4d09448d2","56b3fd1a212a4764be39d979fde3326e",22856177,1,7,0,744,322,328,6
"56b3fd1a212a4764be39d979fde3326e","56b3fd1a212a4764be39d979fde3326e",22856177,1,0,1,745,328,328,0
"56b3fd1a212a4764be39d979fde3326e","3434c10e561d488a914e0f7d71907abd",22856177,1,-28,0,746,328,305,-23
"3434c10e561d488a914e0f7d71907abd","0c4079457ede49e3aeb5e86ed84bdf35",22856177,1,31,0,747,305,329,24
"38aea304b4fa46e1b29bb72f5cea4c93","0c4079457ede49e3aeb5e86ed84bdf35",22856177,2,-2,0,749,331,329,-2
"38aea304b4fa46e1b29bb72f5cea4c93","38aea304b4fa46e1b29bb72f5cea4c93",22856177,1,0,1,751,331,331,0
"0c4079457ede49e3aeb5e86ed84bdf35","a7c6339ca1da4368a18d471f0519f877",22856177,1,11,0,753,329,339,10
"a7c6339ca1da4368a18d471f0519f877","a7c6339ca1da4368a18d471f0519f877",22856177,1,0,1,754,339,339,0
"a7c6339ca1da4368a18d471f0519f877","b8b9418ab322418d9db9b40d96af873a",22856177,1,-2,0,755,339,337,-2
"bbc5139ca9024389a94db3a6f47dcff6","bbc5139ca9024389a94db3a6f47dcff6",22856177,1,0,1,757,341,341,0
"bbc5139ca9024389a94db3a6f47dcff6","4ee6ca9019ab4a1ab323f98094a9bd77",22856177,1,2,0,758,341,343,2
"4ee6ca9019ab4a1ab323f98094a9bd77","4ee6ca9019ab4a1ab323f98094a9bd77",22856177,2,0,1,759,343,343,0
"4ee6ca9019ab4a1ab323f98094a9bd77","b37947176785476f8b29d49a851366dc",22856177,1,1,0,761,343,344,1
"b37947176785476f8b29d49a851366dc","b37947176785476f8b29d49a851366dc",22856177,2,0,1,762,344,344,0
"b37947176785476f8b29d49a851366dc","fcea5b10d5a14a3b9324ffece8f6e1e5",22856177,1,1,0,764,344,345,1
"fcea5b10d5a14a3b9324ffece8f6e1e5","fcea5b10d5a14a3b9324ffece8f6e1e5",22856177,2,0,1,765,345,345,0
"fcea5b10d5a14a3b9324ffece8f6e1e5","c2490bc612d146edbe786556fab3651b",22856177,1,-5,0,767,345,340,-5
"c2490bc612d146edbe786556fab3651b","6ac8bb048b854999a47edb35fe627f11",22856177,1,8,0,768,340,347,7
"6ac8bb048b854999a47edb35fe627f11","6ac8bb048b854999a47edb35fe627f11",22856177,1,0,1,769,347,347,0
"6ac8bb048b854999a47edb35fe627f11","30ead9794d4847abaf222ca966cc8630",22856177,1,3,0,770,347,348,1
"30ead9794d4847abaf222ca966cc8630","0c4079457ede49e3aeb5e86ed84bdf35",22856177,1,-24,0,771,348,329,-19
"0c4079457ede49e3aeb5e86ed84bdf35","c20993c944444fe085345591a8bd837e",22856177,1,27,0,772,329,351,22
"eff0de7f2dbb42dfa1a2e686efab5b6d","897b7f51242c44aab2205c72fdcbf4cd",22856177,1,-2,0,775,354,352,-2
"897b7f51242c44aab2205c72fdcbf4cd","c20993c944444fe085345591a8bd837e",22856177,1,-1,0,776,352,351,-1
"c20993c944444fe085345591a8bd837e","c20993c944444fe085345591a8bd837e",22856177,5,0,1,777,351,351,0
"eff0de7f2dbb42dfa1a2e686efab5b6d","30ead9794d4847abaf222ca966cc8630",22856177,1,-6,0,792,354,348,-6
"30ead9794d4847abaf222ca966cc8630","2fe14166dc9642c3bc666b86a57f943d",22856177,2,10,0,793,348,357,9
"2fe14166dc9642c3bc666b86a57f943d","2fe14166dc9642c3bc666b86a57f943d",22856177,1,0,1,794,357,357,0
"2fe14166dc9642c3bc666b86a57f943d","44421dd1e13a47a388c4a19834b744c7",22856177,1,2,0,795,357,359,2
"44421dd1e13a47a388c4a19834b744c7","44421dd1e13a47a388c4a19834b744c7",22856177,2,0,1,796,359,359,0
"44421dd1e13a47a388c4a19834b744c7","cb5fc7ef85d547c4be1a7439d0bf6052",22856177,1,1,0,798,359,360,1
"cb5fc7ef85d547c4be1a7439d0bf6052","cb5fc7ef85d547c4be1a7439d0bf6052",22856177,2,0,1,799,360,360,0
"cb5fc7ef85d547c4be1a7439d0bf6052","1ba8fef685d74a8194b9db252eb704fb",22856177,1,-5,0,801,360,355,-5
"1ba8fef685d74a8194b9db252eb704fb","52580888dadb4fe3baa795683ea227bd",22856177,1,10,0,802,355,364,9
"52580888dadb4fe3baa795683ea227bd","52580888dadb4fe3baa795683ea227bd",22856177,1,0,1,803,364,364,0
"52580888dadb4fe3baa795683ea227bd","f00179e251a045b39c3f7a54f9aa4acc",22856177,1,-1,0,804,364,363,-1
"f00179e251a045b39c3f7a54f9aa4acc","492a3bc6a1254f23a7998587961b22a4",22856177,1,4,0,805,363,366,3
"492a3bc6a1254f23a7998587961b22a4","072a190fd302456290895f9f04d6940a",22856177,2,-1,0,806,366,365,-1
"072a190fd302456290895f9f04d6940a","30ead9794d4847abaf222ca966cc8630",22856177,1,-20,0,807,365,348,-17
"30ead9794d4847abaf222ca966cc8630","b71bac264efb4abd97015447bd490db6",22856177,1,28,0,808,348,370,22
"d6d02b6ef04e4f17805504500b8ce441","66baf19b6b904b70922329068c63746d",22856177,1,4,0,822,375,376,1
"66baf19b6b904b70922329068c63746d","7f544639412e40a9ba27f43b415362ab",22856177,2,2,0,823,376,378,2
"7f544639412e40a9ba27f43b415362ab","30ead9794d4847abaf222ca966cc8630",22856177,1,-42,0,824,378,348,-30
"2fe14166dc9642c3bc666b86a57f943d","c76574d21bc14aeea7ecd0b027f39858",22856177,1,13,0,826,357,367,10
"c76574d21bc14aeea7ecd0b027f39858","2fe14166dc9642c3bc666b86a57f943d",22856177,1,-13,0,827,367,357,-10
"2fe14166dc9642c3bc666b86a57f943d","1ba8fef685d74a8194b9db252eb704fb",22856177,1,-2,0,828,357,355,-2
"1ba8fef685d74a8194b9db252eb704fb","072a190fd302456290895f9f04d6940a",22856177,1,12,0,829,355,365,10
"072a190fd302456290895f9f04d6940a","492a3bc6a1254f23a7998587961b22a4",22856177,1,1,0,830,365,366,1
"492a3bc6a1254f23a7998587961b22a4","cfa457d1743848e4bb5e4beced6448ed",22856177,1,4,0,831,366,369,3
"cfa457d1743848e4bb5e4beced6448ed","897b7f51242c44aab2205c72fdcbf4cd",22856177,1,-21,0,832,369,352,-17
"eff0de7f2dbb42dfa1a2e686efab5b6d","c76574d21bc14aeea7ecd0b027f39858",22856177,1,17,0,835,354,367,13
"c76574d21bc14aeea7ecd0b027f39858","897b7f51242c44aab2205c72fdcbf4cd",22856177,1,-19,0,836,367,352,-15
"09b9678ddc3d452ea4a3d46e15826065","c20993c944444fe085345591a8bd837e",22856177,1,-2,0,838,353,351,-2
"c20993c944444fe085345591a8bd837e","eff0de7f2dbb42dfa1a2e686efab5b6d",22856177,1,3,0,841,351,354,3
"eff0de7f2dbb42dfa1a2e686efab5b6d","09b9678ddc3d452ea4a3d46e15826065",22856177,1,-1,0,842,354,353,-1
"09b9678ddc3d452ea4a3d46e15826065","30ead9794d4847abaf222ca966cc8630",22856177,1,-5,0,845,353,348,-5
"30ead9794d4847abaf222ca966cc8630","492a3bc6a1254f23a7998587961b22a4",22856177,1,21,0,846,348,366,18
"072a190fd302456290895f9f04d6940a","cfa457d1743848e4bb5e4beced6448ed",22856177,1,5,0,848,365,369,4
"cfa457d1743848e4bb5e4beced6448ed","cfa457d1743848e4bb5e4beced6448ed",22856177,2,0,1,849,369,369,0
"cfa457d1743848e4bb5e4beced6448ed","66baf19b6b904b70922329068c63746d",22856177,1,15,0,851,369,376,7
"7f544639412e40a9ba27f43b415362ab","7f544639412e40a9ba27f43b415362ab",22856177,1,0,1,853,378,378,0
"7f544639412e40a9ba27f43b415362ab","d5ae8642e15b46b8bd298b02274d4e9c",22856177,1,2,0,854,378,380,2
"d5ae8642e15b46b8bd298b02274d4e9c","d5ae8642e15b46b8bd298b02274d4e9c",22856177,13,0,1,855,380,380,0
"d5ae8642e15b46b8bd298b02274d4e9c","a0d10309a2dd456289147f84be9d37f9",22856177,1,1,0,868,380,381,1
"a0d10309a2dd456289147f84be9d37f9","a0d10309a2dd456289147f84be9d37f9",22856177,2,0,1,869,381,381,0
"a0d10309a2dd456289147f84be9d37f9","0fcbc3ca07b144138b8d85da581f09a8",22856177,1,1,0,871,381,382,1
"0fcbc3ca07b144138b8d85da581f09a8","0fcbc3ca07b144138b8d85da581f09a8",22856177,2,0,1,872,382,382,0
"0fcbc3ca07b144138b8d85da581f09a8","66baf19b6b904b70922329068c63746d",22856177,1,-6,0,874,382,376,-6
"66baf19b6b904b70922329068c63746d","4890121ce5d74576b4632b77cfc23398",22856177,1,14,0,875,376,388,12
"4890121ce5d74576b4632b77cfc23398","c2fca3669923477ab966ded303dea31c",22856177,1,-6,0,876,388,383,-5
"c2fca3669923477ab966ded303dea31c","4890121ce5d74576b4632b77cfc23398",22856177,1,6,0,877,383,388,5
"4890121ce5d74576b4632b77cfc23398","18d3b836dd804224883cc9180b60a8e1",22856177,1,-1,0,878,388,387,-1
"18d3b836dd804224883cc9180b60a8e1","96bb2b3e85a34d8b9544514e89f6fe97",22856177,1,4,0,879,387,390,3
"96bb2b3e85a34d8b9544514e89f6fe97","96bb2b3e85a34d8b9544514e89f6fe97",22856177,1,0,1,880,390,390,0
"96bb2b3e85a34d8b9544514e89f6fe97","6f8881a745ac4c358a68b92c3b4abe81",22856177,1,5,0,881,390,394,4
"6f8881a745ac4c358a68b92c3b4abe81","17f95d18bab743888e1736033dc3384d",22856177,1,-6,0,882,394,389,-5
"17f95d18bab743888e1736033dc3384d","6f8881a745ac4c358a68b92c3b4abe81",22856177,1,6,0,883,389,394,5
"6f8881a745ac4c358a68b92c3b4abe81","f7002c8484354eceac57bc7bd62c76c1",22856177,2,-1,0,884,394,393,-1
"f7002c8484354eceac57bc7bd62c76c1","44a277ea44dc4ae689fab4b82f0b4098",22856177,1,5,0,885,393,397,4
"44a277ea44dc4ae689fab4b82f0b4098","44a277ea44dc4ae689fab4b82f0b4098",22856177,1,0,1,886,397,397,0
"44a277ea44dc4ae689fab4b82f0b4098","0c12af0a4e7f4002852cf84b2537c161",22856177,1,-2,0,887,397,395,-2
"0c12af0a4e7f4002852cf84b2537c161","df8191ec5e584c838a899c378941a566",22856177,1,4,0,888,395,398,3
"df8191ec5e584c838a899c378941a566","6f8881a745ac4c358a68b92c3b4abe81",22856177,1,-6,0,889,398,394,-4
"6f8881a745ac4c358a68b92c3b4abe81","6f8881a745ac4c358a68b92c3b4abe81",22856177,1,0,1,890,394,394,0
"f7002c8484354eceac57bc7bd62c76c1","859e0b8d71694b12befb69ee698138f9",22856177,1,8,0,892,393,399,6
"859e0b8d71694b12befb69ee698138f9","859e0b8d71694b12befb69ee698138f9",22856177,1,0,1,893,399,399,0
"859e0b8d71694b12befb69ee698138f9","2b09a08242b54983aec7063990fb3f66",22856177,1,3,0,894,399,400,1
"2b09a08242b54983aec7063990fb3f66","66baf19b6b904b70922329068c63746d",22856177,1,-32,0,895,400,376,-24
"66baf19b6b904b70922329068c63746d","2b09a08242b54983aec7063990fb3f66",22856177,1,32,0,896,376,400,24
"2b09a08242b54983aec7063990fb3f66","2b09a08242b54983aec7063990fb3f66",22856177,3,0,1,897,400,400,0
"2b09a08242b54983aec7063990fb3f66","1f471b7a883a4df48211e8c6a81b59a7",22856177,1,1,0,900,400,401,1
"1f471b7a883a4df48211e8c6a81b59a7","1f471b7a883a4df48211e8c6a81b59a7",22856177,3,0,1,901,401,401,0
"1f471b7a883a4df48211e8c6a81b59a7","2b09a08242b54983aec7063990fb3f66",22856177,1,-1,0,904,401,400,-1
"2b09a08242b54983aec7063990fb3f66","9de0d567bfa84fe5b77cb76f4a76a5d1",22856177,1,5,0,905,400,404,4
"9de0d567bfa84fe5b77cb76f4a76a5d1","9de0d567bfa84fe5b77cb76f4a76a5d1",22856177,1,0,1,906,404,404,0
"9de0d567bfa84fe5b77cb76f4a76a5d1","1157bd665ec4472fb58b751dc5099355",22856177,1,-1,0,907,404,403,-1
"1157bd665ec4472fb58b751dc5099355","3c8a22d2f9c146ea956609e3ed4f2559",22856177,1,3,0,908,403,405,2
"3c8a22d2f9c146ea956609e3ed4f2559","58fc9094275e4c49be3f4ba6d4acc0a4",22856177,1,2,0,909,405,406,1
"58fc9094275e4c49be3f4ba6d4acc0a4","c1c1be90b2b14c1ab4a5e1ee3c241902",22856177,1,1,0,910,406,407,1
"c1c1be90b2b14c1ab4a5e1ee3c241902","c1c1be90b2b14c1ab4a5e1ee3c241902",22856177,5,0,1,911,407,407,0
"c1c1be90b2b14c1ab4a5e1ee3c241902","58fc9094275e4c49be3f4ba6d4acc0a4",22856177,1,-1,0,916,407,406,-1
"58fc9094275e4c49be3f4ba6d4acc0a4","02b3a1bead9244c1ba2f857c7da8f82a",22856177,1,3,0,917,406,408,2
"02b3a1bead9244c1ba2f857c7da8f82a","02b3a1bead9244c1ba2f857c7da8f82a",22856177,1,0,1,918,408,408,0
"02b3a1bead9244c1ba2f857c7da8f82a","6206fc6479014bb193084c32409dc1b9",22856177,1,1,0,919,408,409,1
"6206fc6479014bb193084c32409dc1b9","6206fc6479014bb193084c32409dc1b9",22856177,9,0,1,920,409,409,0
"6206fc6479014bb193084c32409dc1b9","02b3a1bead9244c1ba2f857c7da8f82a",22856177,1,-1,0,929,409,408,-1
"02b3a1bead9244c1ba2f857c7da8f82a","6a5f020451db426dacba9e2ea3fcc62a",22856177,1,3,0,930,408,410,2
"6a5f020451db426dacba9e2ea3fcc62a","6a5f020451db426dacba9e2ea3fcc62a",22856177,2,0,1,931,410,410,0
"6a5f020451db426dacba9e2ea3fcc62a","33a9d248b2e44588a5b07fc1342b9bc2",22856177,1,2,0,933,410,411,1
"33a9d248b2e44588a5b07fc1342b9bc2","33a9d248b2e44588a5b07fc1342b9bc2",22856177,7,0,1,934,411,411,0
"33a9d248b2e44588a5b07fc1342b9bc2","2b09a08242b54983aec7063990fb3f66",22856177,1,-17,0,936,411,400,-11
"2b09a08242b54983aec7063990fb3f66","33a9d248b2e44588a5b07fc1342b9bc2",22856177,1,17,0,937,400,411,11
"33a9d248b2e44588a5b07fc1342b9bc2","687055dad9fc40c3982478fe33ec01bf",22856177,1,4,0,938,411,414,3
"687055dad9fc40c3982478fe33ec01bf","33a9d248b2e44588a5b07fc1342b9bc2",22856177,1,-4,0,939,414,411,-3
"33a9d248b2e44588a5b07fc1342b9bc2","c6f26bd420634f1cb7989e76fe6b16c0",22856177,1,1,0,945,411,412,1
"c6f26bd420634f1cb7989e76fe6b16c0","c6f26bd420634f1cb7989e76fe6b16c0",22856177,5,0,1,946,412,412,0
"c6f26bd420634f1cb7989e76fe6b16c0","2a65ee6e2ac64f6a8a55fbe5373ec763",22856177,1,1,0,951,412,413,1
"2a65ee6e2ac64f6a8a55fbe5373ec763","2a65ee6e2ac64f6a8a55fbe5373ec763",22856177,2,0,1,952,413,413,0
"2a65ee6e2ac64f6a8a55fbe5373ec763","33a9d248b2e44588a5b07fc1342b9bc2",22856177,1,-2,0,954,413,411,-2
"33a9d248b2e44588a5b07fc1342b9bc2","1fd0f6dadbc14ebc965faf6122190b96",22856177,1,5,0,955,411,415,4
"1fd0f6dadbc14ebc965faf6122190b96","1fd0f6dadbc14ebc965faf6122190b96",22856177,1,0,1,956,415,415,0
"1fd0f6dadbc14ebc965faf6122190b96","687055dad9fc40c3982478fe33ec01bf",22856177,1,-1,0,957,415,414,-1
"687055dad9fc40c3982478fe33ec01bf","2add1669f08d4101913db15f8c23b3b7",22856177,1,3,0,958,414,416,2
"2add1669f08d4101913db15f8c23b3b7","2add1669f08d4101913db15f8c23b3b7",22856177,1,0,1,959,416,416,0
"2add1669f08d4101913db15f8c23b3b7","a2b4bd40cee2481ebd3fc179d6a5cd62",22856177,1,3,0,960,416,417,1
"a2b4bd40cee2481ebd3fc179d6a5cd62","2b09a08242b54983aec7063990fb3f66",22856177,1,-27,0,961,417,400,-17
"2b09a08242b54983aec7063990fb3f66","78adeee1fa2c4fe0bc73f7bca9fcee86",22856177,1,-328,0,962,400,160,-240
"8d448d625b024c82a5eb240bbd7431d6","a2b4bd40cee2481ebd3fc179d6a5cd62",22856177,1,66,0,981,374,417,43
"a2b4bd40cee2481ebd3fc179d6a5cd62","a2b4bd40cee2481ebd3fc179d6a5cd62",22856177,2,0,1,982,417,417,0
"a2b4bd40cee2481ebd3fc179d6a5cd62","e34e59dce2204f228f3a84b6725df60f",22856177,1,2,0,983,417,419,2
"e34e59dce2204f228f3a84b6725df60f","e34e59dce2204f228f3a84b6725df60f",22856177,1,0,1,984,419,419,0
"e34e59dce2204f228f3a84b6725df60f","bec48fc2e1294c7eb3d0aca780d731b8",22856177,1,2,0,985,419,420,1
"bec48fc2e1294c7eb3d0aca780d731b8","a2b4bd40cee2481ebd3fc179d6a5cd62",22856177,1,-4,0,986,420,417,-3
"a2b4bd40cee2481ebd3fc179d6a5cd62","bec48fc2e1294c7eb3d0aca780d731b8",22856177,1,4,0,988,417,420,3
"bec48fc2e1294c7eb3d0aca780d731b8","bec48fc2e1294c7eb3d0aca780d731b8",22856177,1,0,1,989,420,420,0
"bec48fc2e1294c7eb3d0aca780d731b8","a24600b0e49245f6bdba8c893cfeddb0",22856177,1,7,0,990,420,425,5
"a24600b0e49245f6bdba8c893cfeddb0","dbde19fcce2a4c1abdc7f685c293a23f",22856177,1,-4,0,991,425,422,-3
"dbde19fcce2a4c1abdc7f685c293a23f","a24600b0e49245f6bdba8c893cfeddb0",22856177,1,4,0,992,422,425,3
"a24600b0e49245f6bdba8c893cfeddb0","a2b4bd40cee2481ebd3fc179d6a5cd62",22856177,1,-11,0,993,425,417,-8
"f2a73be2f46840b182d7bd095378004e","604551fd4266430cb860fef58fa7dd61",22856177,1,1,0,996,429,430,1
"604551fd4266430cb860fef58fa7dd61","604551fd4266430cb860fef58fa7dd61",22856177,9,0,1,1000,430,430,0
"604551fd4266430cb860fef58fa7dd61","24cf8786024543f19b89bc20034e60d7",22856177,1,-2,0,1006,430,428,-2
"24cf8786024543f19b89bc20034e60d7","dce46f8904594a62a6377a3587aaa663",22856177,2,4,0,1007,428,431,3
"dce46f8904594a62a6377a3587aaa663","dce46f8904594a62a6377a3587aaa663",22856177,4,0,1,1008,431,431,0
"dce46f8904594a62a6377a3587aaa663","66ada10dde9f43018588f1ced9d477fc",22856177,1,4,0,1010,431,434,3
"66ada10dde9f43018588f1ced9d477fc","dce46f8904594a62a6377a3587aaa663",22856177,1,-4,0,1011,434,431,-3
"dce46f8904594a62a6377a3587aaa663","f2a73be2f46840b182d7bd095378004e",22856177,1,-3,0,1012,431,429,-2
"f2a73be2f46840b182d7bd095378004e","a2b4bd40cee2481ebd3fc179d6a5cd62",22856177,1,-19,0,1013,429,417,-12
"a2b4bd40cee2481ebd3fc179d6a5cd62","24cf8786024543f19b89bc20034e60d7",22856177,3,18,0,1014,417,428,11
"24cf8786024543f19b89bc20034e60d7","a2b4bd40cee2481ebd3fc179d6a5cd62",22856177,1,-18,0,1015,428,417,-11
"24cf8786024543f19b89bc20034e60d7","f2a73be2f46840b182d7bd095378004e",22856177,2,1,0,1017,428,429,1
"f2a73be2f46840b182d7bd095378004e","dce46f8904594a62a6377a3587aaa663",22856177,1,3,0,1018,429,431,2
"dce46f8904594a62a6377a3587aaa663","24cf8786024543f19b89bc20034e60d7",22856177,1,-4,0,1019,431,428,-3
"dce46f8904594a62a6377a3587aaa663","74a7f8712e5449c2bc0b43c6f90dafed",22856177,1,5,0,1021,431,435,4
"74a7f8712e5449c2bc0b43c6f90dafed","74a7f8712e5449c2bc0b43c6f90dafed",22856177,1,0,1,1022,435,435,0
"74a7f8712e5449c2bc0b43c6f90dafed","66ada10dde9f43018588f1ced9d477fc",22856177,1,-1,0,1023,435,434,-1
"66ada10dde9f43018588f1ced9d477fc","bf12c96466d840a69bed7020b3f18bb8",22856177,1,3,0,1024,434,436,2
"bf12c96466d840a69bed7020b3f18bb8","dce46f8904594a62a6377a3587aaa663",22856177,1,-7,0,1025,436,431,-5
"dce46f8904594a62a6377a3587aaa663","bf12c96466d840a69bed7020b3f18bb8",22856177,1,7,0,1028,431,436,5
"bf12c96466d840a69bed7020b3f18bb8","bf12c96466d840a69bed7020b3f18bb8",22856177,1,0,1,1029,436,436,0
"bf12c96466d840a69bed7020b3f18bb8","24cf8786024543f19b89bc20034e60d7",22856177,1,-11,0,1030,436,428,-8
"24cf8786024543f19b89bc20034e60d7","070600601c4c439288445d2f0724807d",22856177,1,14,0,1031,428,437,9
"070600601c4c439288445d2f0724807d","1823b6de7d334a7aaabc4570719af4d9",22856177,1,2,0,1032,437,439,2
"1823b6de7d334a7aaabc4570719af4d9","1823b6de7d334a7aaabc4570719af4d9",22856177,14,0,1,1033,439,439,0
"1823b6de7d334a7aaabc4570719af4d9","0380cd76a7d44bc3a4da1f15e4d68f89",22856177,1,2,0,1047,439,440,1
"0380cd76a7d44bc3a4da1f15e4d68f89","070600601c4c439288445d2f0724807d",22856177,1,-4,0,1048,440,437,-3
"070600601c4c439288445d2f0724807d","0380cd76a7d44bc3a4da1f15e4d68f89",22856177,1,4,0,1049,437,440,3
"0380cd76a7d44bc3a4da1f15e4d68f89","23b7673c8b5443108c2ef09382834a86",22856177,1,2,0,1050,440,441,1
"23b7673c8b5443108c2ef09382834a86","901e92500aea43c79f19f1b279050668",22856177,1,2,0,1051,441,442,1
"901e92500aea43c79f19f1b279050668","23b7673c8b5443108c2ef09382834a86",22856177,1,-2,0,1052,442,441,-1
"23b7673c8b5443108c2ef09382834a86","070600601c4c439288445d2f0724807d",22856177,1,-6,0,1053,441,437,-4
"070600601c4c439288445d2f0724807d","901e92500aea43c79f19f1b279050668",22856177,1,8,0,1054,437,442,5
"901e92500aea43c79f19f1b279050668","001339db8ced4cf78829ebe8b145449d",22856177,1,1,0,1055,442,443,1
"001339db8ced4cf78829ebe8b145449d","001339db8ced4cf78829ebe8b145449d",22856177,11,0,1,1056,443,443,0
"001339db8ced4cf78829ebe8b145449d","452745e0366e42ae81561bfddebcc6c3",22856177,1,1,0,1067,443,444,1
"452745e0366e42ae81561bfddebcc6c3","452745e0366e42ae81561bfddebcc6c3",22856177,2,0,1,1068,444,444,0
"452745e0366e42ae81561bfddebcc6c3","901e92500aea43c79f19f1b279050668",22856177,1,-2,0,1070,444,442,-2
"901e92500aea43c79f19f1b279050668","4660ff2089114e8db82ceb26a4f329e3",22856177,1,4,0,1071,442,445,3
"4660ff2089114e8db82ceb26a4f329e3","7bd5586eb9d8484eb74a433ee7bfe499",22856177,2,2,0,1072,445,446,1
"7bd5586eb9d8484eb74a433ee7bfe499","4660ff2089114e8db82ceb26a4f329e3",22856177,1,-2,0,1073,446,445,-1
"7bd5586eb9d8484eb74a433ee7bfe499","7bd5586eb9d8484eb74a433ee7bfe499",22856177,13,0,1,1075,446,446,0
"7bd5586eb9d8484eb74a433ee7bfe499","070600601c4c439288445d2f0724807d",22856177,2,-14,0,1080,446,437,-9
"070600601c4c439288445d2f0724807d","7bd5586eb9d8484eb74a433ee7bfe499",22856177,1,14,0,1081,437,446,9
"070600601c4c439288445d2f0724807d","8a7f26e690f34dda97be16904518ca99",22856177,1,16,0,1091,437,447,10
"8a7f26e690f34dda97be16904518ca99","23b7673c8b5443108c2ef09382834a86",22856177,1,-10,0,1092,447,441,-6
"23b7673c8b5443108c2ef09382834a86","23b7673c8b5443108c2ef09382834a86",22856177,2,0,1,1093,441,441,0
"23b7673c8b5443108c2ef09382834a86","8a7f26e690f34dda97be16904518ca99",22856177,1,10,0,1095,441,447,6
"8a7f26e690f34dda97be16904518ca99","901e92500aea43c79f19f1b279050668",22856177,1,-8,0,1096,447,442,-5
"901e92500aea43c79f19f1b279050668","901e92500aea43c79f19f1b279050668",22856177,3,0,1,1097,442,442,0
"901e92500aea43c79f19f1b279050668","8a7f26e690f34dda97be16904518ca99",22856177,1,8,0,1100,442,447,5
"8a7f26e690f34dda97be16904518ca99","8a7f26e690f34dda97be16904518ca99",22856177,1,0,1,1101,447,447,0
"8a7f26e690f34dda97be16904518ca99","b2f0d654738f48158edff28e8d3a546e",22856177,1,5,0,1102,447,449,2
"b2f0d654738f48158edff28e8d3a546e","070600601c4c439288445d2f0724807d",22856177,1,-21,0,1103,449,437,-12
"070600601c4c439288445d2f0724807d","d6d02b6ef04e4f17805504500b8ce441",22856177,1,-95,0,1104,437,375,-62
"d6d02b6ef04e4f17805504500b8ce441","d6d02b6ef04e4f17805504500b8ce441",22856177,3,0,1,1105,375,375,0
"d6d02b6ef04e4f17805504500b8ce441","b2f0d654738f48158edff28e8d3a546e",22856177,2,116,0,1106,375,449,74
"b2f0d654738f48158edff28e8d3a546e","f60ee41ec635499abd48168342d32c2f",22856177,6,5,0,1107,449,453,4
"f60ee41ec635499abd48168342d32c2f","f60ee41ec635499abd48168342d32c2f",22856177,71,0,1,1108,453,453,0
"f60ee41ec635499abd48168342d32c2f","b2f0d654738f48158edff28e8d3a546e",22856177,4,-5,0,1114,453,449,-4
"b2f0d654738f48158edff28e8d3a546e","f67fbf45a5f146ed866965bc57c7c001",22856177,2,8,0,1117,449,454,5
"f67fbf45a5f146ed866965bc57c7c001","f67fbf45a5f146ed866965bc57c7c001",22856177,2,0,1,1118,454,454,0
"f67fbf45a5f146ed866965bc57c7c001","d937afe49bd24a07a550dda1c1155122",22856177,1,1,0,1120,454,455,1
"d937afe49bd24a07a550dda1c1155122","d937afe49bd24a07a550dda1c1155122",22856177,1,0,1,1121,455,455,0
"d937afe49bd24a07a550dda1c1155122","3628b3f7823443d0912a339096b69943",22856177,1,1,0,1122,455,456,1
"3628b3f7823443d0912a339096b69943","3628b3f7823443d0912a339096b69943",22856177,1,0,1,1123,456,456,0
"3628b3f7823443d0912a339096b69943","9e049ee647cf43ecbcb5ed792a8e7588",22856177,1,1,0,1124,456,457,1
"9e049ee647cf43ecbcb5ed792a8e7588","9e049ee647cf43ecbcb5ed792a8e7588",22856177,1,0,1,1125,457,457,0
"9e049ee647cf43ecbcb5ed792a8e7588","5256a214faaf410b93f76cea06428334",22856177,1,1,0,1126,457,458,1
"5256a214faaf410b93f76cea06428334","5256a214faaf410b93f76cea06428334",22856177,1,0,1,1127,458,458,0
"5256a214faaf410b93f76cea06428334","25c32b120fce40fa9b6c85133aeb4716",22856177,1,1,0,1128,458,459,1
"25c32b120fce40fa9b6c85133aeb4716","25c32b120fce40fa9b6c85133aeb4716",22856177,6,0,1,1129,459,459,0
"25c32b120fce40fa9b6c85133aeb4716","11bc14f2204949008b7d511b933363c1",22856177,1,1,0,1135,459,460,1
"11bc14f2204949008b7d511b933363c1","11bc14f2204949008b7d511b933363c1",22856177,5,0,1,1136,460,460,0
"11bc14f2204949008b7d511b933363c1","42de338840a34d15adb66e7b14fb9d2c",22856177,1,1,0,1141,460,461,1
"42de338840a34d15adb66e7b14fb9d2c","42de338840a34d15adb66e7b14fb9d2c",22856177,1,0,1,1142,461,461,0
"42de338840a34d15adb66e7b14fb9d2c","9da37c6210b1416b8079c274f70bf600",22856177,1,1,0,1143,461,462,1
"9da37c6210b1416b8079c274f70bf600","9da37c6210b1416b8079c274f70bf600",22856177,5,0,1,1144,462,462,0
"9da37c6210b1416b8079c274f70bf600","519119f1deac45ff9ab4f13529be5c6e",22856177,1,1,0,1149,462,463,1
"519119f1deac45ff9ab4f13529be5c6e","519119f1deac45ff9ab4f13529be5c6e",22856177,6,0,1,1150,463,463,0
"519119f1deac45ff9ab4f13529be5c6e","f67fbf45a5f146ed866965bc57c7c001",22856177,1,-9,0,1156,463,454,-9
"f67fbf45a5f146ed866965bc57c7c001","c5df9f40ec14463b9dcfdc73df3e9285",22856177,1,12,0,1157,454,464,10
"c5df9f40ec14463b9dcfdc73df3e9285","c5df9f40ec14463b9dcfdc73df3e9285",22856177,3,0,1,1158,464,464,0
"c5df9f40ec14463b9dcfdc73df3e9285","83d42d95cd844fc093fc09cee250edb8",22856177,2,3,0,1161,464,465,1
"83d42d95cd844fc093fc09cee250edb8","c5df9f40ec14463b9dcfdc73df3e9285",22856177,1,-3,0,1162,465,464,-1
"83d42d95cd844fc093fc09cee250edb8","83d42d95cd844fc093fc09cee250edb8",22856177,1,0,1,1164,465,465,0
"83d42d95cd844fc093fc09cee250edb8","78adeee1fa2c4fe0bc73f7bca9fcee86",22856177,1,-431,0,1165,465,160,-305
"78adeee1fa2c4fe0bc73f7bca9fcee86","65202579580f4ad38d734b4ee39d22a8",22856177,6,5,0,1166,160,164,4
"65202579580f4ad38d734b4ee39d22a8","65202579580f4ad38d734b4ee39d22a8",22856177,95,0,1,1167,164,164,0
"65202579580f4ad38d734b4ee39d22a8","0d987bed3ffa4ed0b9a2e62e97b7b30f",22856177,2,147,0,1174,164,272,108
"0d987bed3ffa4ed0b9a2e62e97b7b30f","b71bac264efb4abd97015447bd490db6",22856177,3,132,0,1175,272,370,98
"b71bac264efb4abd97015447bd490db6","8d448d625b024c82a5eb240bbd7431d6",22856177,7,5,0,1176,370,374,4
"8d448d625b024c82a5eb240bbd7431d6","8d448d625b024c82a5eb240bbd7431d6",22856177,78,0,1,1177,374,374,0
"8d448d625b024c82a5eb240bbd7431d6","b2f0d654738f48158edff28e8d3a546e",22856177,1,119,0,1184,374,449,75
"f60ee41ec635499abd48168342d32c2f","78adeee1fa2c4fe0bc73f7bca9fcee86",22856177,1,-413,0,1193,453,160,-293
"65202579580f4ad38d734b4ee39d22a8","67a089198fcb4e1c8f2385786c2b296f",22856177,2,-157,0,1202,164,39,-125
"67a089198fcb4e1c8f2385786c2b296f","b534b89233134e30a9b5645138bfa9ee",22856177,2,4,0,1203,39,41,2
"b534b89233134e30a9b5645138bfa9ee","d9c8d8c444a64dadbbb508652c721e17",22856177,1,6,0,1204,41,46,5
"d9c8d8c444a64dadbbb508652c721e17","6e13d61a7bdb44bca949c9f86fab3be5",22856177,1,1,0,1205,46,47,1
"6e13d61a7bdb44bca949c9f86fab3be5","195f78799f984cc2b06c48dfe36be751",22856177,1,2,0,1206,47,49,2
"195f78799f984cc2b06c48dfe36be751","195f78799f984cc2b06c48dfe36be751",22856177,2,0,1,1207,49,49,0
"195f78799f984cc2b06c48dfe36be751","d9c8d8c444a64dadbbb508652c721e17",22856177,1,-3,0,1209,49,46,-3
"d9c8d8c444a64dadbbb508652c721e17","d646286c8051419bbc2e31dd1db55ca8",22856177,1,27,0,1210,46,67,21
"d646286c8051419bbc2e31dd1db55ca8","b534b89233134e30a9b5645138bfa9ee",22856177,2,-33,0,1211,67,41,-26
"b534b89233134e30a9b5645138bfa9ee","78adeee1fa2c4fe0bc73f7bca9fcee86",22856177,1,148,0,1212,41,160,119
"65202579580f4ad38d734b4ee39d22a8","78adeee1fa2c4fe0bc73f7bca9fcee86",22856177,2,-5,0,1234,164,160,-4
"78adeee1fa2c4fe0bc73f7bca9fcee86","3cbcea2be0984e7dbd5a48195af10ce7",22856177,2,8,0,1235,160,165,5
"3cbcea2be0984e7dbd5a48195af10ce7","82e6285962b8400d9d6fc32436022a94",22856177,3,2,0,1236,165,167,2
"82e6285962b8400d9d6fc32436022a94","78adeee1fa2c4fe0bc73f7bca9fcee86",22856177,1,-10,0,1237,167,160,-7
"82e6285962b8400d9d6fc32436022a94","0d987bed3ffa4ed0b9a2e62e97b7b30f",22856177,1,142,0,1282,167,272,105
"8d448d625b024c82a5eb240bbd7431d6","1b4550d0dab04078b3bf08a655345bdc",22856177,1,-1,0,1292,374,373,-1
"1b4550d0dab04078b3bf08a655345bdc","4a29443515bb404cb8924e1c60a63b73",22856177,1,-114,0,1293,373,285,-88
"4a29443515bb404cb8924e1c60a63b73","0c4079457ede49e3aeb5e86ed84bdf35",22856177,1,58,0,1294,285,329,44
"0c4079457ede49e3aeb5e86ed84bdf35","0c4079457ede49e3aeb5e86ed84bdf35",22856177,1,0,1,1295,329,329,0
"0c4079457ede49e3aeb5e86ed84bdf35","38aea304b4fa46e1b29bb72f5cea4c93",22856177,3,2,0,1296,329,331,2
"38aea304b4fa46e1b29bb72f5cea4c93","e36d261332f14e79bb4b467aceaeb9b5",22856177,1,2,0,1297,331,333,2
"e36d261332f14e79bb4b467aceaeb9b5","e36d261332f14e79bb4b467aceaeb9b5",22856177,1,0,1,1298,333,333,0
"e36d261332f14e79bb4b467aceaeb9b5","0c4079457ede49e3aeb5e86ed84bdf35",22856177,1,-4,0,1299,333,329,-4
"0c4079457ede49e3aeb5e86ed84bdf35","b8b9418ab322418d9db9b40d96af873a",22856177,1,9,0,1300,329,337,8
"b8b9418ab322418d9db9b40d96af873a","bbc5139ca9024389a94db3a6f47dcff6",22856177,2,5,0,1301,337,341,4
"bbc5139ca9024389a94db3a6f47dcff6","c2490bc612d146edbe786556fab3651b",22856177,1,-1,0,1302,341,340,-1
"c2490bc612d146edbe786556fab3651b","0c4079457ede49e3aeb5e86ed84bdf35",22856177,1,-13,0,1303,340,329,-11
"0c4079457ede49e3aeb5e86ed84bdf35","30ead9794d4847abaf222ca966cc8630",22856177,1,24,0,1304,329,348,19
"30ead9794d4847abaf222ca966cc8630","c20993c944444fe085345591a8bd837e",22856177,1,3,0,1305,348,351,3
"c20993c944444fe085345591a8bd837e","09b9678ddc3d452ea4a3d46e15826065",22856177,2,2,0,1306,351,353,2
"09b9678ddc3d452ea4a3d46e15826065","897b7f51242c44aab2205c72fdcbf4cd",22856177,2,-1,0,1307,353,352,-1
"897b7f51242c44aab2205c72fdcbf4cd","eff0de7f2dbb42dfa1a2e686efab5b6d",22856177,2,2,0,1308,352,354,2
"eff0de7f2dbb42dfa1a2e686efab5b6d","c20993c944444fe085345591a8bd837e",22856177,2,-3,0,1309,354,351,-3
"c20993c944444fe085345591a8bd837e","897b7f51242c44aab2205c72fdcbf4cd",22856177,2,1,0,1310,351,352,1
"897b7f51242c44aab2205c72fdcbf4cd","897b7f51242c44aab2205c72fdcbf4cd",22856177,4,0,1,1311,352,352,0
"897b7f51242c44aab2205c72fdcbf4cd","09b9678ddc3d452ea4a3d46e15826065",22856177,4,1,0,1312,352,353,1
"09b9678ddc3d452ea4a3d46e15826065","09b9678ddc3d452ea4a3d46e15826065",22856177,4,0,1,1313,353,353,0
"09b9678ddc3d452ea4a3d46e15826065","eff0de7f2dbb42dfa1a2e686efab5b6d",22856177,3,1,0,1314,353,354,1
"eff0de7f2dbb42dfa1a2e686efab5b6d","eff0de7f2dbb42dfa1a2e686efab5b6d",22856177,5,0,1,1315,354,354,0
"c20993c944444fe085345591a8bd837e","b71bac264efb4abd97015447bd490db6",22856177,1,25,0,1317,351,370,19
"8d448d625b024c82a5eb240bbd7431d6","b71bac264efb4abd97015447bd490db6",22856177,2,-5,0,1322,374,370,-4
"8d448d625b024c82a5eb240bbd7431d6","d6d02b6ef04e4f17805504500b8ce441",22856177,2,3,0,1372,374,375,1
"d6d02b6ef04e4f17805504500b8ce441","b71bac264efb4abd97015447bd490db6",22856177,2,-8,0,1373,375,370,-5
"b71bac264efb4abd97015447bd490db6","d6d02b6ef04e4f17805504500b8ce441",22856177,2,8,0,1374,370,375,5
"f60ee41ec635499abd48168342d32c2f","9428d8bd9c5a47b2a235b254e5e27ded",22856177,1,-1,0,1384,453,452,-1
"9428d8bd9c5a47b2a235b254e5e27ded","b2f0d654738f48158edff28e8d3a546e",22856177,1,-4,0,1385,452,449,-3
"b2f0d654738f48158edff28e8d3a546e","0d987bed3ffa4ed0b9a2e62e97b7b30f",22856177,1,-256,0,1386,449,272,-177
"0d987bed3ffa4ed0b9a2e62e97b7b30f","0d987bed3ffa4ed0b9a2e62e97b7b30f",22856177,9,0,1,1387,272,272,0
"0d987bed3ffa4ed0b9a2e62e97b7b30f","b2f0d654738f48158edff28e8d3a546e",22856177,1,256,0,1388,272,449,177
"f67fbf45a5f146ed866965bc57c7c001","0d987bed3ffa4ed0b9a2e62e97b7b30f",22856177,1,-264,0,1445,454,272,-182
"0d987bed3ffa4ed0b9a2e62e97b7b30f","82ae07bc0c9b4570a41799290d1ef399",22856177,5,4,0,1446,272,275,3
"82ae07bc0c9b4570a41799290d1ef399","0d987bed3ffa4ed0b9a2e62e97b7b30f",22856177,5,-4,0,1447,275,272,-3
"82ae07bc0c9b4570a41799290d1ef399","2ae94c0cea4d480a9d5dca8fb1d7b542",22856177,2,-42,0,1449,275,242,-33
"2ae94c0cea4d480a9d5dca8fb1d7b542","0d987bed3ffa4ed0b9a2e62e97b7b30f",22856177,6,38,0,1450,242,272,30
"0d987bed3ffa4ed0b9a2e62e97b7b30f","0c7262dff33c4087bc660ccf40f92f9c",22856177,3,-135,0,1451,272,169,-103
"0c7262dff33c4087bc660ccf40f92f9c","2ae94c0cea4d480a9d5dca8fb1d7b542",22856177,1,97,0,1452,169,242,73
"2ae94c0cea4d480a9d5dca8fb1d7b542","2ae94c0cea4d480a9d5dca8fb1d7b542",22856177,1,0,1,1453,242,242,0
"2ae94c0cea4d480a9d5dca8fb1d7b542","1ebf23f9d994469a85206e4c7b1bf5f5",22856177,3,3,0,1454,242,245,3
"1ebf23f9d994469a85206e4c7b1bf5f5","1ebf23f9d994469a85206e4c7b1bf5f5",22856177,15,0,1,1455,245,245,0
"1ebf23f9d994469a85206e4c7b1bf5f5","2ae94c0cea4d480a9d5dca8fb1d7b542",22856177,2,-3,0,1470,245,242,-3
"2ae94c0cea4d480a9d5dca8fb1d7b542","30c9ba177afc49a695625d2bdec40207",22856177,1,9,0,1471,242,250,8
"30c9ba177afc49a695625d2bdec40207","30c9ba177afc49a695625d2bdec40207",22856177,2,0,1,1472,250,250,0
"30c9ba177afc49a695625d2bdec40207","6e83e23f56544a19b94067c1c558d9c0",22856177,1,-3,0,1474,250,247,-3
"6e83e23f56544a19b94067c1c558d9c0","00f61990949545828dd12f1303d47504",22856177,3,11,0,1475,247,256,9
"00f61990949545828dd12f1303d47504","41b0048dde734bb280bac6116baa8e27",22856177,1,3,0,1476,256,259,3
"41b0048dde734bb280bac6116baa8e27","41b0048dde734bb280bac6116baa8e27",22856177,5,0,1,1477,259,259,0
"41b0048dde734bb280bac6116baa8e27","d546341988904f069cfa86b21457d9d9",22856177,1,-9,0,1482,259,251,-8
"d546341988904f069cfa86b21457d9d9","d989ebcfc12a4b669f0100dc1aa14f1e",22856177,3,5,0,1483,251,255,4
"d989ebcfc12a4b669f0100dc1aa14f1e","7aa76d3e993840d8805f097cbdbcd44b",22856177,4,7,0,1484,255,261,6
"7aa76d3e993840d8805f097cbdbcd44b","2ae94c0cea4d480a9d5dca8fb1d7b542",22856177,3,-23,0,1485,261,242,-19
"0d987bed3ffa4ed0b9a2e62e97b7b30f","bb5a47f5ea01454a8b79455422d3b9da",22856177,10,10,0,1488,272,280,8
"bb5a47f5ea01454a8b79455422d3b9da","bb5a47f5ea01454a8b79455422d3b9da",22856177,139,0,1,1489,280,280,0
"bb5a47f5ea01454a8b79455422d3b9da","82ae07bc0c9b4570a41799290d1ef399",22856177,6,-6,0,1493,280,275,-5
"82ae07bc0c9b4570a41799290d1ef399","bb5a47f5ea01454a8b79455422d3b9da",22856177,7,6,0,1494,275,280,5
"bb5a47f5ea01454a8b79455422d3b9da","bc5524e78a8544e2ae2fdc2f3462bbec",22856177,3,-1,0,1497,280,279,-1
"bc5524e78a8544e2ae2fdc2f3462bbec","82ae07bc0c9b4570a41799290d1ef399",22856177,3,-5,0,1498,279,275,-4
"0d987bed3ffa4ed0b9a2e62e97b7b30f","2ae94c0cea4d480a9d5dca8fb1d7b542",22856177,3,-38,0,1500,272,242,-30
"2ae94c0cea4d480a9d5dca8fb1d7b542","7028800abe7d4e27b613d1d6cbe26bf7",22856177,1,30,0,1501,242,267,25
"7028800abe7d4e27b613d1d6cbe26bf7","7aa76d3e993840d8805f097cbdbcd44b",22856177,2,-7,0,1502,267,261,-6
"7aa76d3e993840d8805f097cbdbcd44b","d989ebcfc12a4b669f0100dc1aa14f1e",22856177,1,-7,0,1503,261,255,-6
"7aa76d3e993840d8805f097cbdbcd44b","0d987bed3ffa4ed0b9a2e62e97b7b30f",22856177,2,15,0,1505,261,272,11
"0d987bed3ffa4ed0b9a2e62e97b7b30f","7028800abe7d4e27b613d1d6cbe26bf7",22856177,1,-8,0,1524,272,267,-5
"7aa76d3e993840d8805f097cbdbcd44b","00f61990949545828dd12f1303d47504",22856177,1,-6,0,1526,261,256,-5
"00f61990949545828dd12f1303d47504","d989ebcfc12a4b669f0100dc1aa14f1e",22856177,1,-1,0,1527,256,255,-1
"d989ebcfc12a4b669f0100dc1aa14f1e","d546341988904f069cfa86b21457d9d9",22856177,1,-5,0,1528,255,251,-4
"d546341988904f069cfa86b21457d9d9","6e83e23f56544a19b94067c1c558d9c0",22856177,1,-5,0,1529,251,247,-4
"00f61990949545828dd12f1303d47504","d546341988904f069cfa86b21457d9d9",22856177,2,-6,0,1531,256,251,-5
"bb5a47f5ea01454a8b79455422d3b9da","0d987bed3ffa4ed0b9a2e62e97b7b30f",22856177,6,-10,0,1560,280,272,-8
"0d987bed3ffa4ed0b9a2e62e97b7b30f","94cecc3f1e7d484b8e068e79241dfd73",22856177,3,13,0,1590,272,281,9
"94cecc3f1e7d484b8e068e79241dfd73","a37477c4e4c14169ad44b06b493007f6",22856177,5,2,0,1591,281,283,2
"a37477c4e4c14169ad44b06b493007f6","94cecc3f1e7d484b8e068e79241dfd73",22856177,2,-2,0,1592,283,281,-2
"94cecc3f1e7d484b8e068e79241dfd73","0d987bed3ffa4ed0b9a2e62e97b7b30f",22856177,2,-13,0,1593,281,272,-9
"bb5a47f5ea01454a8b79455422d3b9da","d6d02b6ef04e4f17805504500b8ce441",22856177,1,130,0,1606,280,375,95
"d6d02b6ef04e4f17805504500b8ce441","bc5524e78a8544e2ae2fdc2f3462bbec",22856177,1,-131,0,1608,375,279,-96
"bc5524e78a8544e2ae2fdc2f3462bbec","0d987bed3ffa4ed0b9a2e62e97b7b30f",22856177,1,-9,0,1609,279,272,-7
"a37477c4e4c14169ad44b06b493007f6","0d987bed3ffa4ed0b9a2e62e97b7b30f",22856177,2,-15,0,1621,283,272,-11
"b613861cecf84ffcab01afb23f660475","b613861cecf84ffcab01afb23f660475",22856350,5,0,1,1,1,1,0
"b613861cecf84ffcab01afb23f660475","e2911e79efc2420eac45d9f671463d4b",22856350,1,3,0,4,1,2,1
"e2911e79efc2420eac45d9f671463d4b","b613861cecf84ffcab01afb23f660475",22856350,1,-3,0,5,2,1,-1
"b613861cecf84ffcab01afb23f660475","56586aa865414f538729c7f7735d2bc6",22856350,1,15,0,7,1,12,11
"e2911e79efc2420eac45d9f671463d4b","e2911e79efc2420eac45d9f671463d4b",22856350,3,0,1,10,2,2,0
"e2911e79efc2420eac45d9f671463d4b","519d1b8c59404d67b54e96c5c8a830b2",22856350,1,1,0,13,2,3,1
"519d1b8c59404d67b54e96c5c8a830b2","519d1b8c59404d67b54e96c5c8a830b2",22856350,1,0,1,14,3,3,0
"519d1b8c59404d67b54e96c5c8a830b2","531db53f81f646edb0cdcfe0085b03b7",22856350,1,1,0,15,3,4,1
"531db53f81f646edb0cdcfe0085b03b7","531db53f81f646edb0cdcfe0085b03b7",22856350,1,0,1,16,4,4,0
"531db53f81f646edb0cdcfe0085b03b7","4f5f94b2f95141e0a9d53a61da2276da",22856350,1,1,0,17,4,5,1
"4f5f94b2f95141e0a9d53a61da2276da","4f5f94b2f95141e0a9d53a61da2276da",22856350,1,0,1,18,5,5,0
"4f5f94b2f95141e0a9d53a61da2276da","6d541c89590949f99af293c4f2333f67",22856350,1,1,0,19,5,6,1
"6d541c89590949f99af293c4f2333f67","6d541c89590949f99af293c4f2333f67",22856350,1,0,1,20,6,6,0
"6d541c89590949f99af293c4f2333f67","dd5cf0b9fe4c4f1d8f5ff8e4c04879cb",22856350,1,1,0,21,6,7,1
"dd5cf0b9fe4c4f1d8f5ff8e4c04879cb","dd5cf0b9fe4c4f1d8f5ff8e4c04879cb",22856350,1,0,1,22,7,7,0
"dd5cf0b9fe4c4f1d8f5ff8e4c04879cb","f96261861edc426abe2248be4f0a709a",22856350,1,1,0,23,7,8,1
"f96261861edc426abe2248be4f0a709a","f96261861edc426abe2248be4f0a709a",22856350,1,0,1,24,8,8,0
"f96261861edc426abe2248be4f0a709a","66b5e16f4f75454fb5b8172079f0fa83",22856350,1,1,0,25,8,9,1
"66b5e16f4f75454fb5b8172079f0fa83","66b5e16f4f75454fb5b8172079f0fa83",22856350,1,0,1,26,9,9,0
"66b5e16f4f75454fb5b8172079f0fa83","0680571d4698477995e41842c36a54b2",22856350,1,1,0,27,9,10,1
"0680571d4698477995e41842c36a54b2","0680571d4698477995e41842c36a54b2",22856350,1,0,1,28,10,10,0
"0680571d4698477995e41842c36a54b2","9112f2bffece48e08c6d2287be204085",22856350,1,1,0,29,10,11,1
"9112f2bffece48e08c6d2287be204085","9112f2bffece48e08c6d2287be204085",22856350,1,0,1,30,11,11,0
"9112f2bffece48e08c6d2287be204085","56586aa865414f538729c7f7735d2bc6",22856350,1,3,0,31,11,12,1
"56586aa865414f538729c7f7735d2bc6","e2911e79efc2420eac45d9f671463d4b",22856350,2,-12,0,32,12,2,-10
"e2911e79efc2420eac45d9f671463d4b","56586aa865414f538729c7f7735d2bc6",22856350,1,12,0,33,2,12,10
"56586aa865414f538729c7f7735d2bc6","56586aa865414f538729c7f7735d2bc6",22856350,11,0,1,34,12,12,0
"56586aa865414f538729c7f7735d2bc6","b7f2b31585d94eb3bf86376714aa7070",22856350,2,2,0,37,12,13,1
"b7f2b31585d94eb3bf86376714aa7070","b7f2b31585d94eb3bf86376714aa7070",22856350,4,0,1,38,13,13,0
"b7f2b31585d94eb3bf86376714aa7070","3f1c815879794b929260d224becaff7e",22856350,2,2,0,41,13,14,1
"3f1c815879794b929260d224becaff7e","56586aa865414f538729c7f7735d2bc6",22856350,1,-4,0,42,14,12,-2
"56586aa865414f538729c7f7735d2bc6","5c5ceeee4562457ba6d41515aeebfbb1",22856350,2,10,0,44,12,17,5
"5c5ceeee4562457ba6d41515aeebfbb1","56586aa865414f538729c7f7735d2bc6",22856350,3,-10,0,45,17,12,-5
"56586aa865414f538729c7f7735d2bc6","eb2a0eb537344a9e891c761662e400b6",22856350,1,8,0,46,12,16,4
"eb2a0eb537344a9e891c761662e400b6","81c864a886d54a6b8ff85f7d736f4f95",22856350,1,-2,0,47,16,15,-1
"81c864a886d54a6b8ff85f7d736f4f95","5c5ceeee4562457ba6d41515aeebfbb1",22856350,2,4,0,48,15,17,2
"5c5ceeee4562457ba6d41515aeebfbb1","5c5ceeee4562457ba6d41515aeebfbb1",22856350,7,0,1,49,17,17,0
"5c5ceeee4562457ba6d41515aeebfbb1","9afd71a5298d4333b6849dfce1b9422c",22856350,1,3,0,61,17,18,1
"9afd71a5298d4333b6849dfce1b9422c","56586aa865414f538729c7f7735d2bc6",22856350,1,-13,0,62,18,12,-6
"3f1c815879794b929260d224becaff7e","81c864a886d54a6b8ff85f7d736f4f95",22856350,1,2,0,69,14,15,1
"56586aa865414f538729c7f7735d2bc6","9afd71a5298d4333b6849dfce1b9422c",22856350,1,13,0,72,12,18,6
"9afd71a5298d4333b6849dfce1b9422c","b7719e26494940efa49512aedd0aac79",22856350,1,4,0,73,18,20,2
"b7719e26494940efa49512aedd0aac79","9afd71a5298d4333b6849dfce1b9422c",22856350,1,-4,0,74,20,18,-2
"9afd71a5298d4333b6849dfce1b9422c","d4c3b003e8274e429d2fa688d73fde6d",22856350,1,7,0,75,18,22,4
"d4c3b003e8274e429d2fa688d73fde6d","d4f45188d3c84a02ba08454e6403a818",22856350,1,2,0,76,22,24,2
"d4f45188d3c84a02ba08454e6403a818","d4c3b003e8274e429d2fa688d73fde6d",22856350,1,-2,0,77,24,22,-2
"d4c3b003e8274e429d2fa688d73fde6d","d4c3b003e8274e429d2fa688d73fde6d",22856350,1,0,1,78,22,22,0
"d4c3b003e8274e429d2fa688d73fde6d","b7719e26494940efa49512aedd0aac79",22856350,1,-3,0,79,22,20,-2
"b7719e26494940efa49512aedd0aac79","b7719e26494940efa49512aedd0aac79",22856350,1,0,1,80,20,20,0
"b7719e26494940efa49512aedd0aac79","afbf7250b99d47bea07172749483ca97",22856350,1,12,0,81,20,28,8
"afbf7250b99d47bea07172749483ca97","afbf7250b99d47bea07172749483ca97",22856350,1,0,1,82,28,28,0
"afbf7250b99d47bea07172749483ca97","4e51676dc72045d99c19b9fa7b22f8bc",22856350,1,3,0,83,28,29,1
"4e51676dc72045d99c19b9fa7b22f8bc","4e51676dc72045d99c19b9fa7b22f8bc",22856350,1,0,1,84,29,29,0
"4e51676dc72045d99c19b9fa7b22f8bc","51970cfa30e643e894e66ae85c8024cc",22856350,1,3,0,85,29,31,2
"51970cfa30e643e894e66ae85c8024cc","c33c17be71ae4d588da7369472e5bb1b",22856350,1,6,0,86,31,34,3
"c33c17be71ae4d588da7369472e5bb1b","4e51676dc72045d99c19b9fa7b22f8bc",22856350,1,-9,0,87,34,29,-5
"4e51676dc72045d99c19b9fa7b22f8bc","c33c17be71ae4d588da7369472e5bb1b",22856350,1,9,0,88,29,34,5
"c33c17be71ae4d588da7369472e5bb1b","93679be414554a11b1893002f2229a93",22856350,1,3,0,89,34,35,1
"93679be414554a11b1893002f2229a93","93679be414554a11b1893002f2229a93",22856350,1,0,1,90,35,35,0
"93679be414554a11b1893002f2229a93","7040a13096d746ac84b8fac8d9752058",22856350,1,3,0,91,35,36,1
"7040a13096d746ac84b8fac8d9752058","7040a13096d746ac84b8fac8d9752058",22856350,1,0,1,92,36,36,0
"7040a13096d746ac84b8fac8d9752058","9a0dc646f934470daf08c4b56ccf73db",22856350,1,3,0,93,36,37,1
"9a0dc646f934470daf08c4b56ccf73db","9a0dc646f934470daf08c4b56ccf73db",22856350,1,0,1,94,37,37,0
"9a0dc646f934470daf08c4b56ccf73db","fc0e049d56024bc9a02c9a9c435c3df7",22856350,1,3,0,95,37,38,1
"fc0e049d56024bc9a02c9a9c435c3df7","b613861cecf84ffcab01afb23f660475",22856350,1,-68,0,96,38,1,-37
"b613861cecf84ffcab01afb23f660475","67a089198fcb4e1c8f2385786c2b296f",22856350,1,72,0,98,1,39,38
"64d48c6c9c7940639a932219a6c87198","67a089198fcb4e1c8f2385786c2b296f",22856350,3,-1,0,100,40,39,-1
"67a089198fcb4e1c8f2385786c2b296f","67a089198fcb4e1c8f2385786c2b296f",22856350,2,0,1,101,39,39,0
"67a089198fcb4e1c8f2385786c2b296f","64d48c6c9c7940639a932219a6c87198",22856350,4,1,0,103,39,40,1
"64d48c6c9c7940639a932219a6c87198","64d48c6c9c7940639a932219a6c87198",22856350,3,0,1,104,40,40,0
"67a089198fcb4e1c8f2385786c2b296f","b534b89233134e30a9b5645138bfa9ee",22856350,1,4,0,110,39,41,2
"b534b89233134e30a9b5645138bfa9ee","0e37b720d23b4e7f8b313e79313fd107",22856350,1,3,0,111,41,44,3
"0e37b720d23b4e7f8b313e79313fd107","0e37b720d23b4e7f8b313e79313fd107",22856350,1,0,1,112,44,44,0
"0e37b720d23b4e7f8b313e79313fd107","6875d67fdd5f48168b62719df449bebd",22856350,1,1,0,113,44,45,1
"6875d67fdd5f48168b62719df449bebd","6875d67fdd5f48168b62719df449bebd",22856350,1,0,1,114,45,45,0
"6875d67fdd5f48168b62719df449bebd","6e13d61a7bdb44bca949c9f86fab3be5",22856350,1,3,0,115,45,47,2
"6e13d61a7bdb44bca949c9f86fab3be5","b534b89233134e30a9b5645138bfa9ee",22856350,1,-7,0,116,47,41,-6
"b534b89233134e30a9b5645138bfa9ee","6e13d61a7bdb44bca949c9f86fab3be5",22856350,2,7,0,117,41,47,6
"6e13d61a7bdb44bca949c9f86fab3be5","6e13d61a7bdb44bca949c9f86fab3be5",22856350,1,0,1,118,47,47,0
"6e13d61a7bdb44bca949c9f86fab3be5","195f78799f984cc2b06c48dfe36be751",22856350,1,2,0,119,47,49,2
"195f78799f984cc2b06c48dfe36be751","195f78799f984cc2b06c48dfe36be751",22856350,2,0,1,120,49,49,0
"195f78799f984cc2b06c48dfe36be751","d9c8d8c444a64dadbbb508652c721e17",22856350,1,-3,0,122,49,46,-3
"d9c8d8c444a64dadbbb508652c721e17","d0c74f735e024943943e40333d6d337f",22856350,2,6,0,123,46,51,5
"d0c74f735e024943943e40333d6d337f","d0c74f735e024943943e40333d6d337f",22856350,3,0,1,124,51,51,0
"d0c74f735e024943943e40333d6d337f","67a089198fcb4e1c8f2385786c2b296f",22856350,1,-16,0,126,51,39,-12
"67a089198fcb4e1c8f2385786c2b296f","d9c8d8c444a64dadbbb508652c721e17",22856350,1,10,0,127,39,46,7
"d9c8d8c444a64dadbbb508652c721e17","b534b89233134e30a9b5645138bfa9ee",22856350,1,-6,0,128,46,41,-5
"6e13d61a7bdb44bca949c9f86fab3be5","d9c8d8c444a64dadbbb508652c721e17",22856350,1,-1,0,130,47,46,-1
"d0c74f735e024943943e40333d6d337f","983f8ff320594b279a7f4a6fe132f9c5",22856350,1,2,0,133,51,53,2
"983f8ff320594b279a7f4a6fe132f9c5","983f8ff320594b279a7f4a6fe132f9c5",22856350,2,0,1,134,53,53,0
"983f8ff320594b279a7f4a6fe132f9c5","35adfa5d923046aebabfefd98f35ff05",22856350,1,1,0,136,53,54,1
"35adfa5d923046aebabfefd98f35ff05","35adfa5d923046aebabfefd98f35ff05",22856350,2,0,1,137,54,54,0
"35adfa5d923046aebabfefd98f35ff05","b6f8a98476224da1b40e555ececc7ed8",22856350,1,1,0,139,54,55,1
"b6f8a98476224da1b40e555ececc7ed8","b6f8a98476224da1b40e555ececc7ed8",22856350,2,0,1,140,55,55,0
"b6f8a98476224da1b40e555ececc7ed8","86e22cb5fe0e4b47a9489ecddf7ed78f",22856350,1,1,0,142,55,56,1
"86e22cb5fe0e4b47a9489ecddf7ed78f","86e22cb5fe0e4b47a9489ecddf7ed78f",22856350,2,0,1,143,56,56,0
"86e22cb5fe0e4b47a9489ecddf7ed78f","78f30e4dcac84e3cbea8b2cc6e0d62b3",22856350,1,4,0,145,56,59,3
"78f30e4dcac84e3cbea8b2cc6e0d62b3","a1f2f12debe5432fb7a70bcd12bacfb9",22856350,2,-1,0,146,59,58,-1
"a1f2f12debe5432fb7a70bcd12bacfb9","f924752d8a1149668870b1e7698486f7",22856350,1,-9,0,147,58,50,-8
"f924752d8a1149668870b1e7698486f7","78f30e4dcac84e3cbea8b2cc6e0d62b3",22856350,1,10,0,148,50,59,9
"78f30e4dcac84e3cbea8b2cc6e0d62b3","78f30e4dcac84e3cbea8b2cc6e0d62b3",22856350,11,0,1,149,59,59,0
"a1f2f12debe5432fb7a70bcd12bacfb9","a1f2f12debe5432fb7a70bcd12bacfb9",22856350,9,0,1,161,58,58,0
"a1f2f12debe5432fb7a70bcd12bacfb9","12aa6e1672ac4e7aa6449a7a8609cd72",22856350,1,-1,0,170,58,57,-1
"12aa6e1672ac4e7aa6449a7a8609cd72","bc42d26810654ea9a1df1efe1e58c7d5",22856350,1,7,0,171,57,63,6
"bc42d26810654ea9a1df1efe1e58c7d5","a0a418b8540d479fa6e0f653b701da8b",22856350,2,1,0,172,63,64,1
"a0a418b8540d479fa6e0f653b701da8b","309ccf3cc4fe429d9bfbaef53d3fa479",22856350,1,-4,0,173,64,60,-4
"309ccf3cc4fe429d9bfbaef53d3fa479","b534b89233134e30a9b5645138bfa9ee",22856350,1,-23,0,174,60,41,-19
"b534b89233134e30a9b5645138bfa9ee","bc42d26810654ea9a1df1efe1e58c7d5",22856350,1,26,0,175,41,63,22
"a0a418b8540d479fa6e0f653b701da8b","4c943503763e4e349906eea3ed3c8e86",22856350,1,-3,0,177,64,61,-3
"4c943503763e4e349906eea3ed3c8e86","4c943503763e4e349906eea3ed3c8e86",22856350,1,0,1,178,61,61,0
"4c943503763e4e349906eea3ed3c8e86","a0a418b8540d479fa6e0f653b701da8b",22856350,1,3,0,179,61,64,3
"a0a418b8540d479fa6e0f653b701da8b","a0a418b8540d479fa6e0f653b701da8b",22856350,3,0,1,180,64,64,0
"a0a418b8540d479fa6e0f653b701da8b","bc42d26810654ea9a1df1efe1e58c7d5",22856350,1,-1,0,183,64,63,-1
"bc42d26810654ea9a1df1efe1e58c7d5","bc42d26810654ea9a1df1efe1e58c7d5",22856350,3,0,1,184,63,63,0
"bc42d26810654ea9a1df1efe1e58c7d5","309ccf3cc4fe429d9bfbaef53d3fa479",22856350,1,-3,0,187,63,60,-3
"309ccf3cc4fe429d9bfbaef53d3fa479","d646286c8051419bbc2e31dd1db55ca8",22856350,1,10,0,188,60,67,7
"d646286c8051419bbc2e31dd1db55ca8","b534b89233134e30a9b5645138bfa9ee",22856350,1,-33,0,189,67,41,-26
"b534b89233134e30a9b5645138bfa9ee","267f883678b24aed855fde42524975d9",22856350,1,37,0,190,41,71,30
"267f883678b24aed855fde42524975d9","267f883678b24aed855fde42524975d9",22856350,1,0,1,191,71,71,0
"267f883678b24aed855fde42524975d9","88fff56d0342490dbef9040750a20f6c",22856350,1,1,0,192,71,72,1
"88fff56d0342490dbef9040750a20f6c","88fff56d0342490dbef9040750a20f6c",22856350,1,0,1,193,72,72,0
"88fff56d0342490dbef9040750a20f6c","adb17b12b66c4a49a85fd34322f7df70",22856350,1,1,0,194,72,73,1
"adb17b12b66c4a49a85fd34322f7df70","adb17b12b66c4a49a85fd34322f7df70",22856350,1,0,1,195,73,73,0
"adb17b12b66c4a49a85fd34322f7df70","d646286c8051419bbc2e31dd1db55ca8",22856350,1,-6,0,196,73,67,-6
"d646286c8051419bbc2e31dd1db55ca8","a2becd407db34b189200a32546d9d569",22856350,1,9,0,197,67,75,8
"a2becd407db34b189200a32546d9d569","a2becd407db34b189200a32546d9d569",22856350,2,0,1,198,75,75,0
"a2becd407db34b189200a32546d9d569","58c22b011d0f4c2ea6d13615edbb9eeb",22856350,1,2,0,200,75,77,2
"58c22b011d0f4c2ea6d13615edbb9eeb","58c22b011d0f4c2ea6d13615edbb9eeb",22856350,2,0,1,201,77,77,0
"58c22b011d0f4c2ea6d13615edbb9eeb","dd76e1861dc9461c830888729d091ee0",22856350,1,1,0,203,77,78,1
"dd76e1861dc9461c830888729d091ee0","dd76e1861dc9461c830888729d091ee0",22856350,8,0,1,204,78,78,0
"dd76e1861dc9461c830888729d091ee0","cd1d828f1a694b87913a7ea66c23803e",22856350,1,1,0,212,78,79,1
"cd1d828f1a694b87913a7ea66c23803e","cd1d828f1a694b87913a7ea66c23803e",22856350,2,0,1,213,79,79,0
"cd1d828f1a694b87913a7ea66c23803e","9176a3c2b4d2465fa8b0c67096c2a97e",22856350,1,1,0,215,79,80,1
"9176a3c2b4d2465fa8b0c67096c2a97e","9176a3c2b4d2465fa8b0c67096c2a97e",22856350,5,0,1,216,80,80,0
"9176a3c2b4d2465fa8b0c67096c2a97e","f8ec6445f7194e25b9101d4fbcb07a18",22856350,1,1,0,221,80,81,1
"f8ec6445f7194e25b9101d4fbcb07a18","f8ec6445f7194e25b9101d4fbcb07a18",22856350,2,0,1,222,81,81,0
"f8ec6445f7194e25b9101d4fbcb07a18","140d5b27b8574befad82c0a013b59dfa",22856350,1,-7,0,224,81,74,-7
"140d5b27b8574befad82c0a013b59dfa","d18a9ea32855445f8736581f5cb119ce",22856350,1,9,0,225,74,82,8
"d18a9ea32855445f8736581f5cb119ce","f564483cbd7a407681aa2fcca518cf5f",22856350,1,4,0,226,82,85,3
"f564483cbd7a407681aa2fcca518cf5f","f564483cbd7a407681aa2fcca518cf5f",22856350,4,0,1,227,85,85,0
"f564483cbd7a407681aa2fcca518cf5f","18fd01350bd5434ca636d59a599d768a",22856350,1,1,0,231,85,86,1
"18fd01350bd5434ca636d59a599d768a","18fd01350bd5434ca636d59a599d768a",22856350,5,0,1,232,86,86,0
"18fd01350bd5434ca636d59a599d768a","6a9f0ef185fb47f0937e29daa1c71ed5",22856350,1,5,0,237,86,90,4
"6a9f0ef185fb47f0937e29daa1c71ed5","ae5ac430ea254e708a6f5deaaf7464ae",22856350,1,-7,0,238,90,84,-6
"ae5ac430ea254e708a6f5deaaf7464ae","c681290961c94c4caf23b529d1ae6b9a",22856350,1,5,0,239,84,88,4
"c681290961c94c4caf23b529d1ae6b9a","c681290961c94c4caf23b529d1ae6b9a",22856350,1,0,1,240,88,88,0
"c681290961c94c4caf23b529d1ae6b9a","6a9f0ef185fb47f0937e29daa1c71ed5",22856350,1,2,0,241,88,90,2
"6a9f0ef185fb47f0937e29daa1c71ed5","6a9f0ef185fb47f0937e29daa1c71ed5",22856350,3,0,1,242,90,90,0
"6a9f0ef185fb47f0937e29daa1c71ed5","e20db35ced8544ddac5bc3839145e463",22856350,1,3,0,245,90,91,1
"e20db35ced8544ddac5bc3839145e463","d646286c8051419bbc2e31dd1db55ca8",22856350,1,-30,0,246,91,67,-24
"d646286c8051419bbc2e31dd1db55ca8","67a089198fcb4e1c8f2385786c2b296f",22856350,1,-37,0,247,67,39,-28
"67a089198fcb4e1c8f2385786c2b296f","e20db35ced8544ddac5bc3839145e463",22856350,1,67,0,248,39,91,52
"e20db35ced8544ddac5bc3839145e463","e20db35ced8544ddac5bc3839145e463",22856350,1,0,1,249,91,91,0
"e20db35ced8544ddac5bc3839145e463","1febb706d7a34005ae8711ed49c76e64",22856350,1,3,0,250,91,94,3
"1febb706d7a34005ae8711ed49c76e64","1febb706d7a34005ae8711ed49c76e64",22856350,2,0,1,251,94,94,0
"1febb706d7a34005ae8711ed49c76e64","8f73ba6f5a0042f2850356ac38ac6f24",22856350,1,1,0,253,94,95,1
"8f73ba6f5a0042f2850356ac38ac6f24","8f73ba6f5a0042f2850356ac38ac6f24",22856350,5,0,1,254,95,95,0
"8f73ba6f5a0042f2850356ac38ac6f24","e2260b86653c46d7b14a41fb419dbf8c",22856350,1,1,0,259,95,96,1
"e2260b86653c46d7b14a41fb419dbf8c","e2260b86653c46d7b14a41fb419dbf8c",22856350,2,0,1,260,96,96,0
"e2260b86653c46d7b14a41fb419dbf8c","35eb641ad1d845bbba54915bce75a962",22856350,1,1,0,262,96,97,1
"35eb641ad1d845bbba54915bce75a962","35eb641ad1d845bbba54915bce75a962",22856350,2,0,1,263,97,97,0
"35eb641ad1d845bbba54915bce75a962","08be90ffbeea4795a138cd42ed8db56f",22856350,1,1,0,265,97,98,1
"08be90ffbeea4795a138cd42ed8db56f","08be90ffbeea4795a138cd42ed8db56f",22856350,2,0,1,266,98,98,0
"08be90ffbeea4795a138cd42ed8db56f","3007433c8f584dcbb5ac159c1c5f2be3",22856350,1,1,0,268,98,99,1
"3007433c8f584dcbb5ac159c1c5f2be3","3007433c8f584dcbb5ac159c1c5f2be3",22856350,5,0,1,269,99,99,0
"3007433c8f584dcbb5ac159c1c5f2be3","00ae5f0c51874a73a41ebea838d95682",22856350,1,3,0,274,99,101,2
"00ae5f0c51874a73a41ebea838d95682","e20db35ced8544ddac5bc3839145e463",22856350,1,-11,0,275,101,91,-10
"e20db35ced8544ddac5bc3839145e463","d391c8b6e56a43a7b654e9dee02d904b",22856350,1,13,0,276,91,103,12
"d391c8b6e56a43a7b654e9dee02d904b","00ae5f0c51874a73a41ebea838d95682",22856350,1,-2,0,277,103,101,-2
"00ae5f0c51874a73a41ebea838d95682","00ae5f0c51874a73a41ebea838d95682",22856350,3,0,1,278,101,101,0
"00ae5f0c51874a73a41ebea838d95682","d391c8b6e56a43a7b654e9dee02d904b",22856350,1,2,0,281,101,103,2
"d391c8b6e56a43a7b654e9dee02d904b","d391c8b6e56a43a7b654e9dee02d904b",22856350,17,0,1,282,103,103,0
"d391c8b6e56a43a7b654e9dee02d904b","6111116566fc4fd9abba409322bea245",22856350,1,1,0,299,103,104,1
"6111116566fc4fd9abba409322bea245","6111116566fc4fd9abba409322bea245",22856350,2,0,1,300,104,104,0
"6111116566fc4fd9abba409322bea245","a81b2235cb9c499eb9ea8ee0a8dd9725",22856350,1,1,0,302,104,105,1
"a81b2235cb9c499eb9ea8ee0a8dd9725","a81b2235cb9c499eb9ea8ee0a8dd9725",22856350,5,0,1,303,105,105,0
"a81b2235cb9c499eb9ea8ee0a8dd9725","2d4e0ab0ef3b4d73b82c72d4621a7579",22856350,1,1,0,308,105,106,1
"2d4e0ab0ef3b4d73b82c72d4621a7579","2d4e0ab0ef3b4d73b82c72d4621a7579",22856350,2,0,1,309,106,106,0
"2d4e0ab0ef3b4d73b82c72d4621a7579","8bdebf492ebd4e62b0d522e8ab5e5197",22856350,1,1,0,311,106,107,1
"8bdebf492ebd4e62b0d522e8ab5e5197","8bdebf492ebd4e62b0d522e8ab5e5197",22856350,5,0,1,312,107,107,0
"8bdebf492ebd4e62b0d522e8ab5e5197","73039f8c1eb9409cb4caee2cf968001e",22856350,1,-7,0,317,107,100,-7
"73039f8c1eb9409cb4caee2cf968001e","4280927ec4d643238aa49c32f9e06c6c",22856350,1,10,0,318,100,109,9
"4280927ec4d643238aa49c32f9e06c6c","4280927ec4d643238aa49c32f9e06c6c",22856350,2,0,1,319,109,109,0
"4280927ec4d643238aa49c32f9e06c6c","fc44e6a5f7654430af1227838224dceb",22856350,1,2,0,321,109,111,2
"fc44e6a5f7654430af1227838224dceb","fc44e6a5f7654430af1227838224dceb",22856350,5,0,1,322,111,111,0
"fc44e6a5f7654430af1227838224dceb","a9ae0a3c070d455bb4369a8996313336",22856350,1,4,0,327,111,114,3
"a9ae0a3c070d455bb4369a8996313336","08111f75e22d409998cf8b85bd431f0a",22856350,1,-7,0,328,114,108,-6
"08111f75e22d409998cf8b85bd431f0a","a9ae0a3c070d455bb4369a8996313336",22856350,1,7,0,329,108,114,6
"a9ae0a3c070d455bb4369a8996313336","62bff51286ef4f348717a3cf6fe2318f",22856350,1,7,0,330,114,120,6
"62bff51286ef4f348717a3cf6fe2318f","37319e88176d4aefa91d7a9980dbae91",22856350,1,-9,0,331,120,112,-8
"37319e88176d4aefa91d7a9980dbae91","b1cd0e7dc3ad4a8eb91a4bfdbeb025b0",22856350,1,7,0,332,112,118,6
"b1cd0e7dc3ad4a8eb91a4bfdbeb025b0","b1cd0e7dc3ad4a8eb91a4bfdbeb025b0",22856350,1,0,1,333,118,118,0
"b1cd0e7dc3ad4a8eb91a4bfdbeb025b0","62bff51286ef4f348717a3cf6fe2318f",22856350,1,2,0,334,118,120,2
"62bff51286ef4f348717a3cf6fe2318f","62bff51286ef4f348717a3cf6fe2318f",22856350,7,0,1,335,120,120,0
"62bff51286ef4f348717a3cf6fe2318f","779f9ddd1fd14d1e9e69f72219a1fdbd",22856350,1,3,0,338,120,121,1
"779f9ddd1fd14d1e9e69f72219a1fdbd","e20db35ced8544ddac5bc3839145e463",22856350,1,-36,0,339,121,91,-30
"e20db35ced8544ddac5bc3839145e463","ae26e6cda8ad4a3f81bd347560d9579f",22856350,1,40,0,340,91,125,34
"ae26e6cda8ad4a3f81bd347560d9579f","ae26e6cda8ad4a3f81bd347560d9579f",22856350,1,0,1,341,125,125,0
"ae26e6cda8ad4a3f81bd347560d9579f","ee48df95832b4374aa273ceb27ec1315",22856350,1,1,0,342,125,126,1
"ee48df95832b4374aa273ceb27ec1315","ee48df95832b4374aa273ceb27ec1315",22856350,1,0,1,343,126,126,0
"ee48df95832b4374aa273ceb27ec1315","7a439da90b394756ad1777fc4c6dead5",22856350,1,1,0,344,126,127,1
"7a439da90b394756ad1777fc4c6dead5","7a439da90b394756ad1777fc4c6dead5",22856350,1,0,1,345,127,127,0
"7a439da90b394756ad1777fc4c6dead5","779f9ddd1fd14d1e9e69f72219a1fdbd",22856350,1,-6,0,346,127,121,-6
"779f9ddd1fd14d1e9e69f72219a1fdbd","a8dd5213034441ac92724b4e83eb0bb2",22856350,2,9,0,347,121,129,8
"a8dd5213034441ac92724b4e83eb0bb2","a8dd5213034441ac92724b4e83eb0bb2",22856350,2,0,1,348,129,129,0
"a8dd5213034441ac92724b4e83eb0bb2","8115eab6556b45f5b415c3b8c26a12e5",22856350,1,2,0,350,129,131,2
"8115eab6556b45f5b415c3b8c26a12e5","8115eab6556b45f5b415c3b8c26a12e5",22856350,2,0,1,351,131,131,0
"8115eab6556b45f5b415c3b8c26a12e5","ec34b06efd844b46a4c4818ecdb9b8f4",22856350,1,1,0,353,131,132,1
"ec34b06efd844b46a4c4818ecdb9b8f4","ec34b06efd844b46a4c4818ecdb9b8f4",22856350,5,0,1,354,132,132,0
"ec34b06efd844b46a4c4818ecdb9b8f4","c2e1c2b9eac64109b343a088584b576b",22856350,1,1,0,359,132,133,1
"c2e1c2b9eac64109b343a088584b576b","c2e1c2b9eac64109b343a088584b576b",22856350,2,0,1,360,133,133,0
"c2e1c2b9eac64109b343a088584b576b","579338175e0b4bbb8ef3b712b5d8b54e",22856350,1,-5,0,362,133,128,-5
"579338175e0b4bbb8ef3b712b5d8b54e","8bc5795d6a984a3eace4e2811e52dd4f",22856350,1,8,0,363,128,135,7
"8bc5795d6a984a3eace4e2811e52dd4f","8bc5795d6a984a3eace4e2811e52dd4f",22856350,1,0,1,364,135,135,0
"8bc5795d6a984a3eace4e2811e52dd4f","b416d47c56a742199b5d7c7f19d6503a",22856350,1,-1,0,365,135,134,-1
"b416d47c56a742199b5d7c7f19d6503a","779f9ddd1fd14d1e9e69f72219a1fdbd",22856350,1,-15,0,366,134,121,-13
"779f9ddd1fd14d1e9e69f72219a1fdbd","df1de691dafe4549a18a4398ee9dfaf9",22856350,2,23,0,367,121,139,18
"df1de691dafe4549a18a4398ee9dfaf9","6c5ad271a44743479bfaea29b1db8d02",22856350,4,4,0,368,139,143,4
"6c5ad271a44743479bfaea29b1db8d02","67a089198fcb4e1c8f2385786c2b296f",22856350,3,-130,0,369,143,39,-104
"67a089198fcb4e1c8f2385786c2b296f","37319e88176d4aefa91d7a9980dbae91",22856350,2,91,0,370,39,112,73
"37319e88176d4aefa91d7a9980dbae91","e20db35ced8544ddac5bc3839145e463",22856350,2,-24,0,371,112,91,-21
"e20db35ced8544ddac5bc3839145e463","a9ae0a3c070d455bb4369a8996313336",22856350,2,26,0,372,91,114,23
"a9ae0a3c070d455bb4369a8996313336","71cec822bcff4f30a20e75dc63ef7b65",22856350,1,2,0,373,114,116,2
"71cec822bcff4f30a20e75dc63ef7b65","71cec822bcff4f30a20e75dc63ef7b65",22856350,1,0,1,374,116,116,0
"71cec822bcff4f30a20e75dc63ef7b65","37319e88176d4aefa91d7a9980dbae91",22856350,1,-4,0,375,116,112,-4
"37319e88176d4aefa91d7a9980dbae91","62bff51286ef4f348717a3cf6fe2318f",22856350,2,9,0,376,112,120,8
"62bff51286ef4f348717a3cf6fe2318f","67a089198fcb4e1c8f2385786c2b296f",22856350,2,-100,0,379,120,39,-81
"67a089198fcb4e1c8f2385786c2b296f","579338175e0b4bbb8ef3b712b5d8b54e",22856350,1,111,0,380,39,128,89
"579338175e0b4bbb8ef3b712b5d8b54e","779f9ddd1fd14d1e9e69f72219a1fdbd",22856350,1,-8,0,381,128,121,-7
"a8dd5213034441ac92724b4e83eb0bb2","579338175e0b4bbb8ef3b712b5d8b54e",22856350,2,-1,0,383,129,128,-1
"579338175e0b4bbb8ef3b712b5d8b54e","b416d47c56a742199b5d7c7f19d6503a",22856350,2,7,0,384,128,134,6
"b416d47c56a742199b5d7c7f19d6503a","a8dd5213034441ac92724b4e83eb0bb2",22856350,1,-6,0,385,134,129,-5
"b416d47c56a742199b5d7c7f19d6503a","cd4532ad48034873ba8bce2aac0c9808",22856350,1,4,0,388,134,137,3
"cd4532ad48034873ba8bce2aac0c9808","cd4532ad48034873ba8bce2aac0c9808",22856350,3,0,1,389,137,137,0
"cd4532ad48034873ba8bce2aac0c9808","779f9ddd1fd14d1e9e69f72219a1fdbd",22856350,1,-19,0,392,137,121,-16
"a9ae0a3c070d455bb4369a8996313336","37319e88176d4aefa91d7a9980dbae91",22856350,1,-2,0,399,114,112,-2
"67a089198fcb4e1c8f2385786c2b296f","78adeee1fa2c4fe0bc73f7bca9fcee86",22856350,1,152,0,404,39,160,121
"78adeee1fa2c4fe0bc73f7bca9fcee86","78adeee1fa2c4fe0bc73f7bca9fcee86",22856350,5,0,1,405,160,160,0
"78adeee1fa2c4fe0bc73f7bca9fcee86","65202579580f4ad38d734b4ee39d22a8",22856350,4,5,0,407,160,164,4
"65202579580f4ad38d734b4ee39d22a8","65202579580f4ad38d734b4ee39d22a8",22856350,64,0,1,408,164,164,0
"65202579580f4ad38d734b4ee39d22a8","78adeee1fa2c4fe0bc73f7bca9fcee86",22856350,5,-5,0,415,164,160,-4
"78adeee1fa2c4fe0bc73f7bca9fcee86","3cbcea2be0984e7dbd5a48195af10ce7",22856350,2,8,0,416,160,165,5
"3cbcea2be0984e7dbd5a48195af10ce7","3cbcea2be0984e7dbd5a48195af10ce7",22856350,1,0,1,417,165,165,0
"3cbcea2be0984e7dbd5a48195af10ce7","82e6285962b8400d9d6fc32436022a94",22856350,2,2,0,418,165,167,2
"82e6285962b8400d9d6fc32436022a94","67a089198fcb4e1c8f2385786c2b296f",22856350,2,-162,0,419,167,39,-128
"67a089198fcb4e1c8f2385786c2b296f","df1de691dafe4549a18a4398ee9dfaf9",22856350,1,126,0,420,39,139,100
"df1de691dafe4549a18a4398ee9dfaf9","df1de691dafe4549a18a4398ee9dfaf9",22856350,2,0,1,421,139,139,0
"67a089198fcb4e1c8f2385786c2b296f","a9ac840f098c4bd0a2ee896214ce29cd",22856350,2,165,0,424,39,168,129
"a9ac840f098c4bd0a2ee896214ce29cd","a9ac840f098c4bd0a2ee896214ce29cd",22856350,3,0,1,425,168,168,0
"a9ac840f098c4bd0a2ee896214ce29cd","df1de691dafe4549a18a4398ee9dfaf9",22856350,1,-39,0,427,168,139,-29
"6c5ad271a44743479bfaea29b1db8d02","6c5ad271a44743479bfaea29b1db8d02",22856350,2,0,1,430,143,143,0
"6c5ad271a44743479bfaea29b1db8d02","83d311bed5374fee83d8d67a7d9d82dc",22856350,1,1,0,432,143,144,1
"83d311bed5374fee83d8d67a7d9d82dc","83d311bed5374fee83d8d67a7d9d82dc",22856350,1,0,1,433,144,144,0
"83d311bed5374fee83d8d67a7d9d82dc","402bba41861d43acb52a5abb89e8831e",22856350,1,1,0,434,144,145,1
"402bba41861d43acb52a5abb89e8831e","402bba41861d43acb52a5abb89e8831e",22856350,5,0,1,435,145,145,0
"402bba41861d43acb52a5abb89e8831e","8aae34f5ddbb4052a709b12e6b0d40fa",22856350,1,3,0,440,145,147,2
"8aae34f5ddbb4052a709b12e6b0d40fa","df1de691dafe4549a18a4398ee9dfaf9",22856350,1,-9,0,441,147,139,-8
"df1de691dafe4549a18a4398ee9dfaf9","8aae34f5ddbb4052a709b12e6b0d40fa",22856350,1,9,0,442,139,147,8
"8aae34f5ddbb4052a709b12e6b0d40fa","8aae34f5ddbb4052a709b12e6b0d40fa",22856350,1,0,1,443,147,147,0
"8aae34f5ddbb4052a709b12e6b0d40fa","645b3f0249f64f76af2e19eb4d0e55b7",22856350,1,2,0,444,147,149,2
"645b3f0249f64f76af2e19eb4d0e55b7","645b3f0249f64f76af2e19eb4d0e55b7",22856350,8,0,1,445,149,149,0
"645b3f0249f64f76af2e19eb4d0e55b7","7e7b8db5064d4369805ab370aac5ddfb",22856350,1,1,0,453,149,150,1
"7e7b8db5064d4369805ab370aac5ddfb","7e7b8db5064d4369805ab370aac5ddfb",22856350,2,0,1,454,150,150,0
"7e7b8db5064d4369805ab370aac5ddfb","8956d210ae7f41968fada86d4c979d6a",22856350,1,1,0,456,150,151,1
"8956d210ae7f41968fada86d4c979d6a","8956d210ae7f41968fada86d4c979d6a",22856350,2,0,1,457,151,151,0
"8956d210ae7f41968fada86d4c979d6a","f902b0f41b544d4dbf79664fd233648d",22856350,1,-5,0,459,151,146,-5
"f902b0f41b544d4dbf79664fd233648d","ae781e8b775e4ccd93bc800dad5c8376",22856350,1,8,0,460,146,153,7
"ae781e8b775e4ccd93bc800dad5c8376","ae781e8b775e4ccd93bc800dad5c8376",22856350,2,0,1,461,153,153,0
"ae781e8b775e4ccd93bc800dad5c8376","06882a8492d9499aa31555567f575ecb",22856350,1,1,0,463,153,154,1
"06882a8492d9499aa31555567f575ecb","06882a8492d9499aa31555567f575ecb",22856350,1,0,1,464,154,154,0
"06882a8492d9499aa31555567f575ecb","f293c508f409466a8f27ddd7d1e40b20",22856350,1,1,0,465,154,155,1
"f293c508f409466a8f27ddd7d1e40b20","f293c508f409466a8f27ddd7d1e40b20",22856350,5,0,1,466,155,155,0
"f293c508f409466a8f27ddd7d1e40b20","cc4ddef5bbbe48ebb605141b347c4ed1",22856350,1,1,0,471,155,156,1
"cc4ddef5bbbe48ebb605141b347c4ed1","cc4ddef5bbbe48ebb605141b347c4ed1",22856350,1,0,1,472,156,156,0
"cc4ddef5bbbe48ebb605141b347c4ed1","d313cec988a84645bee413e8d4724a4b",22856350,1,3,0,473,156,158,2
"d313cec988a84645bee413e8d4724a4b","f03480cf4eba413194d7af52fc0e7f28",22856350,1,-7,0,474,158,152,-6
"f03480cf4eba413194d7af52fc0e7f28","d313cec988a84645bee413e8d4724a4b",22856350,1,7,0,475,152,158,6
"d313cec988a84645bee413e8d4724a4b","d313cec988a84645bee413e8d4724a4b",22856350,5,0,1,476,158,158,0
"d313cec988a84645bee413e8d4724a4b","dc60696c76a74368a60f72246e47700d",22856350,1,1,0,479,158,159,1
"dc60696c76a74368a60f72246e47700d","dc60696c76a74368a60f72246e47700d",22856350,3,0,1,480,159,159,0
"dc60696c76a74368a60f72246e47700d","78adeee1fa2c4fe0bc73f7bca9fcee86",22856350,1,3,0,483,159,160,1
"78adeee1fa2c4fe0bc73f7bca9fcee86","df1de691dafe4549a18a4398ee9dfaf9",22856350,1,-26,0,484,160,139,-21
"df1de691dafe4549a18a4398ee9dfaf9","65202579580f4ad38d734b4ee39d22a8",22856350,1,31,0,485,139,164,25
"a9ac840f098c4bd0a2ee896214ce29cd","67a089198fcb4e1c8f2385786c2b296f",22856350,1,-165,0,558,168,39,-129
"67a089198fcb4e1c8f2385786c2b296f","208c9b2796c944db8dacaa96082520ea",22856350,1,329,0,559,39,288,249
"208c9b2796c944db8dacaa96082520ea","4a29443515bb404cb8924e1c60a63b73",22856350,2,-3,0,560,288,285,-3
"4a29443515bb404cb8924e1c60a63b73","4a29443515bb404cb8924e1c60a63b73",22856350,3,0,1,561,285,285,0
"4a29443515bb404cb8924e1c60a63b73","0c7262dff33c4087bc660ccf40f92f9c",22856350,1,-157,0,562,285,169,-116
"0c7262dff33c4087bc660ccf40f92f9c","b2275c3fad834f8d90737a2d9a6927d6",22856350,1,3,0,563,169,172,3
"b2275c3fad834f8d90737a2d9a6927d6","b2275c3fad834f8d90737a2d9a6927d6",22856350,34,0,1,564,172,172,0
"b2275c3fad834f8d90737a2d9a6927d6","a9ac840f098c4bd0a2ee896214ce29cd",22856350,1,-7,0,576,172,168,-4
"a9ac840f098c4bd0a2ee896214ce29cd","0c7262dff33c4087bc660ccf40f92f9c",22856350,1,4,0,577,168,169,1
"0c7262dff33c4087bc660ccf40f92f9c","0c7262dff33c4087bc660ccf40f92f9c",22856350,1,0,1,578,169,169,0
"0c7262dff33c4087bc660ccf40f92f9c","a9ac840f098c4bd0a2ee896214ce29cd",22856350,1,-4,0,579,169,168,-1
"a9ac840f098c4bd0a2ee896214ce29cd","b2275c3fad834f8d90737a2d9a6927d6",22856350,1,7,0,580,168,172,4
"b2275c3fad834f8d90737a2d9a6927d6","eb515a26030b41f8a82a1e6114420bad",22856350,1,1,0,603,172,173,1
"eb515a26030b41f8a82a1e6114420bad","eb515a26030b41f8a82a1e6114420bad",22856350,2,0,1,604,173,173,0
"eb515a26030b41f8a82a1e6114420bad","0c7262dff33c4087bc660ccf40f92f9c",22856350,1,-4,0,606,173,169,-4
"0c7262dff33c4087bc660ccf40f92f9c","801f9e9135034f49bf5f8b4bdefedb41",22856350,1,9,0,607,169,177,8
"801f9e9135034f49bf5f8b4bdefedb41","801f9e9135034f49bf5f8b4bdefedb41",22856350,4,0,1,608,177,177,0
"801f9e9135034f49bf5f8b4bdefedb41","362fcb0699a14845ab29b2340093e528",22856350,1,-3,0,612,177,174,-3
"362fcb0699a14845ab29b2340093e528","b87c552dd247427abe6ab5795b9c9d43",22856350,1,8,0,613,174,181,7
"b87c552dd247427abe6ab5795b9c9d43","b87c552dd247427abe6ab5795b9c9d43",22856350,1,0,1,614,181,181,0
"b87c552dd247427abe6ab5795b9c9d43","139b097acfca451689d80c9c6eebdf7b",22856350,2,-3,0,615,181,178,-3
"139b097acfca451689d80c9c6eebdf7b","2024b4885bd14338a39b7b509acbbd02",22856350,1,5,0,616,178,182,4
"2024b4885bd14338a39b7b509acbbd02","b87c552dd247427abe6ab5795b9c9d43",22856350,1,-2,0,617,182,181,-1
"139b097acfca451689d80c9c6eebdf7b","30f660a1feb34582a739722532524f79",22856350,1,6,0,619,178,183,5
"30f660a1feb34582a739722532524f79","30f660a1feb34582a739722532524f79",22856350,5,0,1,620,183,183,0
"30f660a1feb34582a739722532524f79","2024b4885bd14338a39b7b509acbbd02",22856350,1,-1,0,625,183,182,-1
"2024b4885bd14338a39b7b509acbbd02","c3f63fe50d8e487c86bf8ef76c9cadd3",22856350,1,4,0,626,182,185,3
"c3f63fe50d8e487c86bf8ef76c9cadd3","c3f63fe50d8e487c86bf8ef76c9cadd3",22856350,1,0,1,627,185,185,0
"c3f63fe50d8e487c86bf8ef76c9cadd3","0c7262dff33c4087bc660ccf40f92f9c",22856350,1,-20,0,628,185,169,-16
"0c7262dff33c4087bc660ccf40f92f9c","c8e371568a0c4391b25796ae4e91952e",22856350,1,23,0,629,169,186,17
"c8e371568a0c4391b25796ae4e91952e","7d932b23e1c84326ae5aa4d3c0d813d1",22856350,1,2,0,630,186,188,2
"7d932b23e1c84326ae5aa4d3c0d813d1","7d932b23e1c84326ae5aa4d3c0d813d1",22856350,1,0,1,631,188,188,0
"7d932b23e1c84326ae5aa4d3c0d813d1","c8e371568a0c4391b25796ae4e91952e",22856350,1,-2,0,632,188,186,-2
"c8e371568a0c4391b25796ae4e91952e","f992451ed6ad4e68bb9e68ad6be7c4be",22856350,1,7,0,633,186,192,6
"f992451ed6ad4e68bb9e68ad6be7c4be","f992451ed6ad4e68bb9e68ad6be7c4be",22856350,5,0,1,634,192,192,0
"f992451ed6ad4e68bb9e68ad6be7c4be","07b44a7a51e94c78b411c753fc39dab0",22856350,1,-3,0,639,192,189,-3
"07b44a7a51e94c78b411c753fc39dab0","017d7ca8e0394b91aaadc9574df2202c",22856350,1,5,0,640,189,193,4
"017d7ca8e0394b91aaadc9574df2202c","07b44a7a51e94c78b411c753fc39dab0",22856350,1,-5,0,641,193,189,-4
"07b44a7a51e94c78b411c753fc39dab0","2d2580c9411c4972909db508d6956a58",22856350,1,8,0,642,189,196,7
"2d2580c9411c4972909db508d6956a58","2d2580c9411c4972909db508d6956a58",22856350,5,0,1,643,196,196,0
"2d2580c9411c4972909db508d6956a58","d5e8e2bd12a2466b9d6d90855f0eb079",22856350,1,2,0,648,196,198,2
"d5e8e2bd12a2466b9d6d90855f0eb079","d5e8e2bd12a2466b9d6d90855f0eb079",22856350,2,0,1,649,198,198,0
"d5e8e2bd12a2466b9d6d90855f0eb079","017d7ca8e0394b91aaadc9574df2202c",22856350,1,-5,0,651,198,193,-5
"017d7ca8e0394b91aaadc9574df2202c","54e8e9f0ea3e45c4bf3b8ac799ee31b1",22856350,1,8,0,652,193,200,7
"54e8e9f0ea3e45c4bf3b8ac799ee31b1","54e8e9f0ea3e45c4bf3b8ac799ee31b1",22856350,1,0,1,653,200,200,0
"54e8e9f0ea3e45c4bf3b8ac799ee31b1","c614a00911be4877a075f19315530fb0",22856350,1,1,0,654,200,201,1
"c614a00911be4877a075f19315530fb0","c614a00911be4877a075f19315530fb0",22856350,6,0,1,655,201,201,0
"c614a00911be4877a075f19315530fb0","a6c21bd8b95249c7972820a7a7d76aff",22856350,1,1,0,661,201,202,1
"a6c21bd8b95249c7972820a7a7d76aff","a6c21bd8b95249c7972820a7a7d76aff",22856350,1,0,1,662,202,202,0
"a6c21bd8b95249c7972820a7a7d76aff","bb329d880ab54120adaf203a693bb203",22856350,1,1,0,663,202,203,1
"bb329d880ab54120adaf203a693bb203","bb329d880ab54120adaf203a693bb203",22856350,1,0,1,664,203,203,0
"bb329d880ab54120adaf203a693bb203","f9170dd6bc6442b4acd832747609b09a",22856350,1,-4,0,665,203,199,-4
"f9170dd6bc6442b4acd832747609b09a","334c2344009840079b1d0e1b7ce3d5a7",22856350,1,7,0,666,199,205,6
"334c2344009840079b1d0e1b7ce3d5a7","334c2344009840079b1d0e1b7ce3d5a7",22856350,1,0,1,667,205,205,0
"334c2344009840079b1d0e1b7ce3d5a7","d7f13c8d63ec4e2aa673fbb9cf9c6933",22856350,1,3,0,668,205,206,1
"d7f13c8d63ec4e2aa673fbb9cf9c6933","c8e371568a0c4391b25796ae4e91952e",22856350,1,-26,0,669,206,186,-20
"c8e371568a0c4391b25796ae4e91952e","b9e80f77c3a44349863b19875725c384",22856350,1,27,0,670,186,207,21
"b9e80f77c3a44349863b19875725c384","7108f0e4c2584f1f9c471689ae4c885c",22856350,2,1,0,671,207,208,1
"7108f0e4c2584f1f9c471689ae4c885c","d7f13c8d63ec4e2aa673fbb9cf9c6933",22856350,2,-2,0,672,208,206,-2
"d7f13c8d63ec4e2aa673fbb9cf9c6933","7108f0e4c2584f1f9c471689ae4c885c",22856350,1,2,0,673,206,208,2
"7108f0e4c2584f1f9c471689ae4c885c","b9e80f77c3a44349863b19875725c384",22856350,1,-1,0,674,208,207,-1
"b9e80f77c3a44349863b19875725c384","b9e80f77c3a44349863b19875725c384",22856350,12,0,1,675,207,207,0
"7108f0e4c2584f1f9c471689ae4c885c","7108f0e4c2584f1f9c471689ae4c885c",22856350,11,0,1,688,208,208,0
"d7f13c8d63ec4e2aa673fbb9cf9c6933","a88efa7e50ce47159810ab553afa6d3a",22856350,1,7,0,700,206,212,6
"a88efa7e50ce47159810ab553afa6d3a","a88efa7e50ce47159810ab553afa6d3a",22856350,5,0,1,701,212,212,0
"a88efa7e50ce47159810ab553afa6d3a","a875096404ef4a9984b62d74cda916f9",22856350,1,-3,0,706,212,209,-3
"a875096404ef4a9984b62d74cda916f9","f7fb1952f56b4189b86a9f8b7862d2b8",22856350,1,7,0,707,209,215,6
"f7fb1952f56b4189b86a9f8b7862d2b8","b860ee85d8bc4a2f97958cfb71be3533",22856350,2,1,0,708,215,216,1
"b860ee85d8bc4a2f97958cfb71be3533","b860ee85d8bc4a2f97958cfb71be3533",22856350,4,0,1,709,216,216,0
"b860ee85d8bc4a2f97958cfb71be3533","363837c182e04711840d896ae1e0339c",22856350,2,3,0,711,216,218,2
"363837c182e04711840d896ae1e0339c","ec341f459285443b8361f7f15638ff08",22856350,3,-6,0,712,218,213,-5
"ec341f459285443b8361f7f15638ff08","363837c182e04711840d896ae1e0339c",22856350,1,6,0,713,213,218,5
"363837c182e04711840d896ae1e0339c","363837c182e04711840d896ae1e0339c",22856350,12,0,1,714,218,218,0
"363837c182e04711840d896ae1e0339c","01b2051f8941460d89945e3b02d1ce78",22856350,1,-1,0,726,218,217,-1
"01b2051f8941460d89945e3b02d1ce78","be95c065e45447c1bd8215ea6f130c7a",22856350,1,3,0,727,217,219,2
"be95c065e45447c1bd8215ea6f130c7a","363837c182e04711840d896ae1e0339c",22856350,1,-2,0,728,219,218,-1
"363837c182e04711840d896ae1e0339c","f7fb1952f56b4189b86a9f8b7862d2b8",22856350,1,-4,0,729,218,215,-3
"f7fb1952f56b4189b86a9f8b7862d2b8","01b2051f8941460d89945e3b02d1ce78",22856350,1,3,0,730,215,217,2
"01b2051f8941460d89945e3b02d1ce78","ec341f459285443b8361f7f15638ff08",22856350,1,-5,0,731,217,213,-4
"ec341f459285443b8361f7f15638ff08","91125ca626c5470eb145501f8c37f8db",22856350,1,9,0,732,213,220,7
"91125ca626c5470eb145501f8c37f8db","91125ca626c5470eb145501f8c37f8db",22856350,1,0,1,733,220,220,0
"91125ca626c5470eb145501f8c37f8db","1c6721b1f63f4d30ba7746ea8af02a52",22856350,1,3,0,734,220,221,1
"1c6721b1f63f4d30ba7746ea8af02a52","d7f13c8d63ec4e2aa673fbb9cf9c6933",22856350,3,-21,0,735,221,206,-15
"d7f13c8d63ec4e2aa673fbb9cf9c6933","77ecef8eff6b4a2caea7707669bf7475",22856350,2,22,0,736,206,222,16
"77ecef8eff6b4a2caea7707669bf7475","1c6721b1f63f4d30ba7746ea8af02a52",22856350,7,-1,0,737,222,221,-1
"1c6721b1f63f4d30ba7746ea8af02a52","77ecef8eff6b4a2caea7707669bf7475",22856350,7,1,0,738,221,222,1
"77ecef8eff6b4a2caea7707669bf7475","77ecef8eff6b4a2caea7707669bf7475",22856350,13,0,1,739,222,222,0
"77ecef8eff6b4a2caea7707669bf7475","8b9ae98743bd4d4a8a87dff1c1244211",22856350,2,6,0,752,222,227,5
"8b9ae98743bd4d4a8a87dff1c1244211","1c6721b1f63f4d30ba7746ea8af02a52",22856350,2,-7,0,753,227,221,-6
"1c6721b1f63f4d30ba7746ea8af02a52","f7906d6f59b9489a91d2ef40db5a474d",22856350,2,3,0,754,221,223,2
"f7906d6f59b9489a91d2ef40db5a474d","a4f40fb48a8542c8949bae1f002cd9bc",22856350,1,9,0,755,223,231,8
"a4f40fb48a8542c8949bae1f002cd9bc","a4f40fb48a8542c8949bae1f002cd9bc",22856350,2,0,1,756,231,231,0
"a4f40fb48a8542c8949bae1f002cd9bc","5152833676bf4c6cb317060be10f68db",22856350,1,-3,0,758,231,228,-3
"5152833676bf4c6cb317060be10f68db","ca3e28f290354c08aefe5b0f769604e6",22856350,1,8,0,759,228,235,7
"ca3e28f290354c08aefe5b0f769604e6","ca3e28f290354c08aefe5b0f769604e6",22856350,9,0,1,760,235,235,0
"ca3e28f290354c08aefe5b0f769604e6","79a35eea833e4c2c9d22fc53c3c6445c",22856350,1,1,0,769,235,236,1
"79a35eea833e4c2c9d22fc53c3c6445c","79a35eea833e4c2c9d22fc53c3c6445c",22856350,4,0,1,770,236,236,0
"79a35eea833e4c2c9d22fc53c3c6445c","cab89fa5c3ed45a5aa550fc0352d6a42",22856350,1,2,0,774,236,238,2
"cab89fa5c3ed45a5aa550fc0352d6a42","cab89fa5c3ed45a5aa550fc0352d6a42",22856350,5,0,1,775,238,238,0
"cab89fa5c3ed45a5aa550fc0352d6a42","1c6721b1f63f4d30ba7746ea8af02a52",22856350,1,-20,0,780,238,221,-17
"1c6721b1f63f4d30ba7746ea8af02a52","1c6721b1f63f4d30ba7746ea8af02a52",22856350,1,0,1,790,221,221,0
"1c6721b1f63f4d30ba7746ea8af02a52","d03cb855c70044cf8c35d9ec0de696e3",22856350,2,4,0,793,221,224,3
"d03cb855c70044cf8c35d9ec0de696e3","0b04c8e2f86d48c7aeb7e225819cd32b",22856350,1,12,0,794,224,234,10
"0b04c8e2f86d48c7aeb7e225819cd32b","8b9ae98743bd4d4a8a87dff1c1244211",22856350,1,-9,0,795,234,227,-7
"8b9ae98743bd4d4a8a87dff1c1244211","77ecef8eff6b4a2caea7707669bf7475",22856350,1,-6,0,796,227,222,-5
"77ecef8eff6b4a2caea7707669bf7475","f7906d6f59b9489a91d2ef40db5a474d",22856350,1,2,0,797,222,223,1
"f7906d6f59b9489a91d2ef40db5a474d","1c6721b1f63f4d30ba7746ea8af02a52",22856350,1,-3,0,798,223,221,-2
"d7f13c8d63ec4e2aa673fbb9cf9c6933","be502a7a43c44bf7b682698de79d9369",22856350,1,10,0,800,206,214,8
"be502a7a43c44bf7b682698de79d9369","f7fb1952f56b4189b86a9f8b7862d2b8",22856350,2,1,0,801,214,215,1
"f7fb1952f56b4189b86a9f8b7862d2b8","be95c065e45447c1bd8215ea6f130c7a",22856350,1,6,0,802,215,219,4
"be95c065e45447c1bd8215ea6f130c7a","f7fb1952f56b4189b86a9f8b7862d2b8",22856350,1,-6,0,803,219,215,-4
"f7fb1952f56b4189b86a9f8b7862d2b8","f7fb1952f56b4189b86a9f8b7862d2b8",22856350,11,0,1,804,215,215,0
"ec341f459285443b8361f7f15638ff08","01b2051f8941460d89945e3b02d1ce78",22856350,2,5,0,820,213,217,4
"01b2051f8941460d89945e3b02d1ce78","be502a7a43c44bf7b682698de79d9369",22856350,1,-4,0,821,217,214,-3
"f7fb1952f56b4189b86a9f8b7862d2b8","363837c182e04711840d896ae1e0339c",22856350,1,4,0,823,215,218,3
"01b2051f8941460d89945e3b02d1ce78","1c6721b1f63f4d30ba7746ea8af02a52",22856350,1,7,0,826,217,221,4
"1c6721b1f63f4d30ba7746ea8af02a52","8b9ae98743bd4d4a8a87dff1c1244211",22856350,1,7,0,830,221,227,6
"8b9ae98743bd4d4a8a87dff1c1244211","d03cb855c70044cf8c35d9ec0de696e3",22856350,3,-3,0,831,227,224,-3
"d03cb855c70044cf8c35d9ec0de696e3","1c6721b1f63f4d30ba7746ea8af02a52",22856350,1,-4,0,832,224,221,-3
"f7906d6f59b9489a91d2ef40db5a474d","d03cb855c70044cf8c35d9ec0de696e3",22856350,1,1,0,836,223,224,1
"d03cb855c70044cf8c35d9ec0de696e3","8b9ae98743bd4d4a8a87dff1c1244211",22856350,2,3,0,837,224,227,3
"d03cb855c70044cf8c35d9ec0de696e3","d03cb855c70044cf8c35d9ec0de696e3",22856350,1,0,1,839,224,224,0
"d03cb855c70044cf8c35d9ec0de696e3","a49a937d6896486d9a5396654abcf2e1",22856350,1,2,0,840,224,226,2
"a49a937d6896486d9a5396654abcf2e1","a49a937d6896486d9a5396654abcf2e1",22856350,6,0,1,841,226,226,0
"a49a937d6896486d9a5396654abcf2e1","8b9ae98743bd4d4a8a87dff1c1244211",22856350,1,1,0,847,226,227,1
"8b9ae98743bd4d4a8a87dff1c1244211","8b9ae98743bd4d4a8a87dff1c1244211",22856350,19,0,1,848,227,227,0
"8b9ae98743bd4d4a8a87dff1c1244211","f7906d6f59b9489a91d2ef40db5a474d",22856350,1,-4,0,867,227,223,-4
"f7906d6f59b9489a91d2ef40db5a474d","2ab1535aac1346ba8801535bf729ef37",22856350,2,7,0,868,223,229,6
"2ab1535aac1346ba8801535bf729ef37","2ab1535aac1346ba8801535bf729ef37",22856350,6,0,1,869,229,229,0
"2ab1535aac1346ba8801535bf729ef37","1c6721b1f63f4d30ba7746ea8af02a52",22856350,1,-10,0,872,229,221,-8
"d03cb855c70044cf8c35d9ec0de696e3","f7906d6f59b9489a91d2ef40db5a474d",22856350,1,-1,0,876,224,223,-1
"2ab1535aac1346ba8801535bf729ef37","8972c23e32044edb8a78fa1eed4e5947",22856350,1,3,0,881,229,232,3
"8972c23e32044edb8a78fa1eed4e5947","8972c23e32044edb8a78fa1eed4e5947",22856350,1,0,1,882,232,232,0
"8972c23e32044edb8a78fa1eed4e5947","92feb4a40f8344d38b6f722e42a53295",22856350,1,1,0,883,232,233,1
"92feb4a40f8344d38b6f722e42a53295","92feb4a40f8344d38b6f722e42a53295",22856350,2,0,1,884,233,233,0
"92feb4a40f8344d38b6f722e42a53295","5152833676bf4c6cb317060be10f68db",22856350,1,-5,0,886,233,228,-5
"5152833676bf4c6cb317060be10f68db","8f68228b1518449e9615cdafee41a2bd",22856350,1,10,0,887,228,237,9
"8f68228b1518449e9615cdafee41a2bd","8f68228b1518449e9615cdafee41a2bd",22856350,1,0,1,888,237,237,0
"8f68228b1518449e9615cdafee41a2bd","66d4fad4f1cf4b46be0750a99ad7a35a",22856350,1,2,0,889,237,239,2
"66d4fad4f1cf4b46be0750a99ad7a35a","66d4fad4f1cf4b46be0750a99ad7a35a",22856350,1,0,1,890,239,239,0
"66d4fad4f1cf4b46be0750a99ad7a35a","0b04c8e2f86d48c7aeb7e225819cd32b",22856350,1,-5,0,891,239,234,-5
"0b04c8e2f86d48c7aeb7e225819cd32b","f53da5fd9bfe412da4b80d4742563b6c",22856350,1,8,0,892,234,241,7
"f53da5fd9bfe412da4b80d4742563b6c","f53da5fd9bfe412da4b80d4742563b6c",22856350,1,0,1,893,241,241,0
"f53da5fd9bfe412da4b80d4742563b6c","1c6721b1f63f4d30ba7746ea8af02a52",22856350,1,-24,0,894,241,221,-20
"1c6721b1f63f4d30ba7746ea8af02a52","2ae94c0cea4d480a9d5dca8fb1d7b542",22856350,1,27,0,895,221,242,21
"2ae94c0cea4d480a9d5dca8fb1d7b542","1ebf23f9d994469a85206e4c7b1bf5f5",22856350,1,3,0,896,242,245,3
"1ebf23f9d994469a85206e4c7b1bf5f5","1ebf23f9d994469a85206e4c7b1bf5f5",22856350,10,0,1,897,245,245,0
"1ebf23f9d994469a85206e4c7b1bf5f5","85ae675b83e8422da842cfd25596af99",22856350,1,1,0,907,245,246,1
"85ae675b83e8422da842cfd25596af99","85ae675b83e8422da842cfd25596af99",22856350,1,0,1,908,246,246,0
"85ae675b83e8422da842cfd25596af99","2ae94c0cea4d480a9d5dca8fb1d7b542",22856350,1,-4,0,909,246,242,-4
"2ae94c0cea4d480a9d5dca8fb1d7b542","30c9ba177afc49a695625d2bdec40207",22856350,1,9,0,910,242,250,8
"30c9ba177afc49a695625d2bdec40207","30c9ba177afc49a695625d2bdec40207",22856350,2,0,1,911,250,250,0
"30c9ba177afc49a695625d2bdec40207","6e83e23f56544a19b94067c1c558d9c0",22856350,1,-3,0,913,250,247,-3
"6e83e23f56544a19b94067c1c558d9c0","00f61990949545828dd12f1303d47504",22856350,1,11,0,914,247,256,9
"00f61990949545828dd12f1303d47504","00f61990949545828dd12f1303d47504",22856350,2,0,1,915,256,256,0
"00f61990949545828dd12f1303d47504","ead7bb4b64e247d2ae632ab8a296b091",22856350,1,2,0,917,256,258,2
"ead7bb4b64e247d2ae632ab8a296b091","ead7bb4b64e247d2ae632ab8a296b091",22856350,2,0,1,918,258,258,0
"ead7bb4b64e247d2ae632ab8a296b091","41b0048dde734bb280bac6116baa8e27",22856350,1,1,0,920,258,259,1
"41b0048dde734bb280bac6116baa8e27","41b0048dde734bb280bac6116baa8e27",22856350,2,0,1,921,259,259,0
"41b0048dde734bb280bac6116baa8e27","b41c5a094a604ee0915327da5cc0beb7",22856350,1,1,0,923,259,260,1
"b41c5a094a604ee0915327da5cc0beb7","b41c5a094a604ee0915327da5cc0beb7",22856350,2,0,1,924,260,260,0
"b41c5a094a604ee0915327da5cc0beb7","d546341988904f069cfa86b21457d9d9",22856350,1,-10,0,926,260,251,-9
"d546341988904f069cfa86b21457d9d9","28c171777c52431ab6b925073bd63d46",22856350,1,15,0,927,251,264,13
"28c171777c52431ab6b925073bd63d46","28c171777c52431ab6b925073bd63d46",22856350,14,0,1,928,264,264,0
"28c171777c52431ab6b925073bd63d46","ac160db940cb49ae8579162b1d52bb5d",22856350,1,2,0,942,264,266,2
"ac160db940cb49ae8579162b1d52bb5d","ac160db940cb49ae8579162b1d52bb5d",22856350,9,0,1,943,266,266,0
"ac160db940cb49ae8579162b1d52bb5d","d989ebcfc12a4b669f0100dc1aa14f1e",22856350,1,-12,0,952,266,255,-11
"d989ebcfc12a4b669f0100dc1aa14f1e","c6fd49b485cc4874b0bbdd9c6171e09c",22856350,1,15,0,953,255,268,13
"c6fd49b485cc4874b0bbdd9c6171e09c","c6fd49b485cc4874b0bbdd9c6171e09c",22856350,7,0,1,954,268,268,0
"c6fd49b485cc4874b0bbdd9c6171e09c","44240778a97c4af0937817499b75707b",22856350,1,1,0,961,268,269,1
"44240778a97c4af0937817499b75707b","44240778a97c4af0937817499b75707b",22856350,2,0,1,962,269,269,0
"44240778a97c4af0937817499b75707b","7aa76d3e993840d8805f097cbdbcd44b",22856350,1,-9,0,964,269,261,-8
"7aa76d3e993840d8805f097cbdbcd44b","865a4d3b43374da7944dc7d397f566d9",22856350,1,12,0,965,261,271,10
"865a4d3b43374da7944dc7d397f566d9","865a4d3b43374da7944dc7d397f566d9",22856350,1,0,1,966,271,271,0
"865a4d3b43374da7944dc7d397f566d9","2ae94c0cea4d480a9d5dca8fb1d7b542",22856350,1,-35,0,967,271,242,-29
"2ae94c0cea4d480a9d5dca8fb1d7b542","0d987bed3ffa4ed0b9a2e62e97b7b30f",22856350,1,38,0,968,242,272,30
"0d987bed3ffa4ed0b9a2e62e97b7b30f","0c7262dff33c4087bc660ccf40f92f9c",22856350,1,-135,0,969,272,169,-103
"0c7262dff33c4087bc660ccf40f92f9c","a875096404ef4a9984b62d74cda916f9",22856350,1,53,0,970,169,209,40
"a875096404ef4a9984b62d74cda916f9","d7f13c8d63ec4e2aa673fbb9cf9c6933",22856350,1,-4,0,971,209,206,-3
"d7f13c8d63ec4e2aa673fbb9cf9c6933","09400e101c5d4b439cf9a26b03aae558",22856350,1,5,0,972,206,210,4
"09400e101c5d4b439cf9a26b03aae558","0c7262dff33c4087bc660ccf40f92f9c",22856350,1,-54,0,973,210,169,-41
"0c7262dff33c4087bc660ccf40f92f9c","4a29443515bb404cb8924e1c60a63b73",22856350,1,157,0,974,169,285,116
"4a29443515bb404cb8924e1c60a63b73","208c9b2796c944db8dacaa96082520ea",22856350,2,3,0,976,285,288,3
"208c9b2796c944db8dacaa96082520ea","208c9b2796c944db8dacaa96082520ea",22856350,5,0,1,977,288,288,0
"208c9b2796c944db8dacaa96082520ea","67a089198fcb4e1c8f2385786c2b296f",22856350,1,-329,0,980,288,39,-249
"64d48c6c9c7940639a932219a6c87198","df1de691dafe4549a18a4398ee9dfaf9",22856350,1,125,0,982,40,139,99
"df1de691dafe4549a18a4398ee9dfaf9","d313cec988a84645bee413e8d4724a4b",22856350,1,22,0,983,139,158,19
"d313cec988a84645bee413e8d4724a4b","fab84b4fab5940efb4ea868ef8d09396",22856350,1,174,0,986,158,284,126
"fab84b4fab5940efb4ea868ef8d09396","4a29443515bb404cb8924e1c60a63b73",22856350,1,4,0,987,284,285,1
"4a29443515bb404cb8924e1c60a63b73","7669a956527947d0add87455277e80b4",22856350,1,7,0,993,285,291,6
"7669a956527947d0add87455277e80b4","7669a956527947d0add87455277e80b4",22856350,1,0,1,994,291,291,0
"7669a956527947d0add87455277e80b4","869e967078f04da18dd0b0b9389a7424",22856350,1,3,0,995,291,293,2
"869e967078f04da18dd0b0b9389a7424","6a9a3b5bde4a48daa896fe8c06eca56f",22856350,1,-5,0,996,293,289,-4
"6a9a3b5bde4a48daa896fe8c06eca56f","869e967078f04da18dd0b0b9389a7424",22856350,1,5,0,997,289,293,4
"869e967078f04da18dd0b0b9389a7424","869e967078f04da18dd0b0b9389a7424",22856350,1,0,1,998,293,293,0
"869e967078f04da18dd0b0b9389a7424","51ab6291537748fab90d519aa09889d6",22856350,1,2,0,999,293,295,2
"51ab6291537748fab90d519aa09889d6","51ab6291537748fab90d519aa09889d6",22856350,5,0,1,1000,295,295,0
"51ab6291537748fab90d519aa09889d6","34a6e49023fc4465bd5ca604330bbd1c",22856350,1,-3,0,1005,295,292,-3
"34a6e49023fc4465bd5ca604330bbd1c","ba0e59461bfb4a44b7b1c28a01f8d3b3",22856350,2,9,0,1006,292,299,7
"ba0e59461bfb4a44b7b1c28a01f8d3b3","21592f2a9e9c4b2f8c66ec5dbcbf6a2b",22856350,2,-4,0,1007,299,296,-3
"21592f2a9e9c4b2f8c66ec5dbcbf6a2b","ba0e59461bfb4a44b7b1c28a01f8d3b3",22856350,1,4,0,1008,296,299,3
"ba0e59461bfb4a44b7b1c28a01f8d3b3","ba0e59461bfb4a44b7b1c28a01f8d3b3",22856350,1,0,1,1009,299,299,0
"ba0e59461bfb4a44b7b1c28a01f8d3b3","0e0b36e731a645e7b1b8a88f5031ca38",22856350,1,2,0,1010,299,301,2
"0e0b36e731a645e7b1b8a88f5031ca38","0e0b36e731a645e7b1b8a88f5031ca38",22856350,8,0,1,1011,301,301,0
"0e0b36e731a645e7b1b8a88f5031ca38","a66a144637284c21afc6de17fea4bfb8",22856350,1,1,0,1019,301,302,1
"a66a144637284c21afc6de17fea4bfb8","a66a144637284c21afc6de17fea4bfb8",22856350,2,0,1,1020,302,302,0
"a66a144637284c21afc6de17fea4bfb8","7646a919d7e64fa990bca9b024ff089d",22856350,1,-4,0,1022,302,298,-4
"7646a919d7e64fa990bca9b024ff089d","ba0e59461bfb4a44b7b1c28a01f8d3b3",22856350,1,1,0,1023,298,299,1
"ba0e59461bfb4a44b7b1c28a01f8d3b3","2c5bb2cbd0014420ad8c95d40e38efd1",22856350,1,5,0,1024,299,303,4
"2c5bb2cbd0014420ad8c95d40e38efd1","7646a919d7e64fa990bca9b024ff089d",22856350,1,-6,0,1025,303,298,-5
"7646a919d7e64fa990bca9b024ff089d","4a29443515bb404cb8924e1c60a63b73",22856350,1,-17,0,1026,298,285,-13
"4a29443515bb404cb8924e1c60a63b73","3434c10e561d488a914e0f7d71907abd",22856350,1,27,0,1027,285,305,20
"3434c10e561d488a914e0f7d71907abd","53e7e900392747ccad52e711ab0f80d8",22856350,1,2,0,1028,305,307,2
"53e7e900392747ccad52e711ab0f80d8","53e7e900392747ccad52e711ab0f80d8",22856350,2,0,1,1029,307,307,0
"53e7e900392747ccad52e711ab0f80d8","3434c10e561d488a914e0f7d71907abd",22856350,1,-2,0,1031,307,305,-2
"3434c10e561d488a914e0f7d71907abd","130acc2aeb0448fdbb2de63bc5cebe5b",22856350,1,5,0,1032,305,309,4
"130acc2aeb0448fdbb2de63bc5cebe5b","130acc2aeb0448fdbb2de63bc5cebe5b",22856350,2,0,1,1033,309,309,0
"130acc2aeb0448fdbb2de63bc5cebe5b","9c062b3251034ebe90f5054e2a3b5120",22856350,1,2,0,1035,309,311,2
"9c062b3251034ebe90f5054e2a3b5120","9c062b3251034ebe90f5054e2a3b5120",22856350,2,0,1,1036,311,311,0
"9c062b3251034ebe90f5054e2a3b5120","130acc2aeb0448fdbb2de63bc5cebe5b",22856350,1,-2,0,1038,311,309,-2
"130acc2aeb0448fdbb2de63bc5cebe5b","ea859f8207e44537889daeaba13ac2e8",22856350,1,3,0,1039,309,312,3
"ea859f8207e44537889daeaba13ac2e8","ea859f8207e44537889daeaba13ac2e8",22856350,1,0,1,1040,312,312,0
"ea859f8207e44537889daeaba13ac2e8","56d94971a7a94257aa330183a8ebd0ea",22856350,1,1,0,1041,312,313,1
"56d94971a7a94257aa330183a8ebd0ea","56d94971a7a94257aa330183a8ebd0ea",22856350,1,0,1,1042,313,313,0
"56d94971a7a94257aa330183a8ebd0ea","141c0df6cd1946539aadd1c9b7068cd4",22856350,1,-5,0,1043,313,308,-5
"141c0df6cd1946539aadd1c9b7068cd4","13255e63e0aa4abf85e5211bf613d43e",22856350,1,10,0,1044,308,317,9
"13255e63e0aa4abf85e5211bf613d43e","13255e63e0aa4abf85e5211bf613d43e",22856350,1,0,1,1045,317,317,0
"13255e63e0aa4abf85e5211bf613d43e","86c27d40179e419c8e9d150fb6afa5d0",22856350,1,3,0,1046,317,319,2
"86c27d40179e419c8e9d150fb6afa5d0","0c787d16c9504873b1a4d903cec09948",22856350,1,-6,0,1047,319,314,-5
"0c787d16c9504873b1a4d903cec09948","86c27d40179e419c8e9d150fb6afa5d0",22856350,1,6,0,1048,314,319,5
"86c27d40179e419c8e9d150fb6afa5d0","86c27d40179e419c8e9d150fb6afa5d0",22856350,1,0,1,1049,319,319,0
"86c27d40179e419c8e9d150fb6afa5d0","24f1363179ad4aaa965484a78471912b",22856350,1,5,0,1050,319,323,4
"24f1363179ad4aaa965484a78471912b","47edbb64109243e6b0f8f64cdef90c6c",22856350,1,3,0,1051,323,326,3
"47edbb64109243e6b0f8f64cdef90c6c","8d7e0b55cf9849cda222a0f2440cec55",22856350,1,-9,0,1052,326,318,-8
"8d7e0b55cf9849cda222a0f2440cec55","24f1363179ad4aaa965484a78471912b",22856350,1,6,0,1053,318,323,5
"24f1363179ad4aaa965484a78471912b","24f1363179ad4aaa965484a78471912b",22856350,1,0,1,1054,323,323,0
"24f1363179ad4aaa965484a78471912b","3628bdce1dd2429ba924d2d4d09448d2",22856350,1,-1,0,1055,323,322,-1
"3628bdce1dd2429ba924d2d4d09448d2","3434c10e561d488a914e0f7d71907abd",22856350,1,-21,0,1056,322,305,-17
"3434c10e561d488a914e0f7d71907abd","0c4079457ede49e3aeb5e86ed84bdf35",22856350,1,31,0,1057,305,329,24
"0c4079457ede49e3aeb5e86ed84bdf35","38aea304b4fa46e1b29bb72f5cea4c93",22856350,1,2,0,1058,329,331,2
"38aea304b4fa46e1b29bb72f5cea4c93","38aea304b4fa46e1b29bb72f5cea4c93",22856350,2,0,1,1059,331,331,0
"38aea304b4fa46e1b29bb72f5cea4c93","e36d261332f14e79bb4b467aceaeb9b5",22856350,1,2,0,1061,331,333,2
"e36d261332f14e79bb4b467aceaeb9b5","e36d261332f14e79bb4b467aceaeb9b5",22856350,1,0,1,1062,333,333,0
"e36d261332f14e79bb4b467aceaeb9b5","c7e89b9d04744d2eab742fc24e3ef1ae",22856350,1,1,0,1063,333,334,1
"c7e89b9d04744d2eab742fc24e3ef1ae","c7e89b9d04744d2eab742fc24e3ef1ae",22856350,2,0,1,1064,334,334,0
"c7e89b9d04744d2eab742fc24e3ef1ae","fe49f8054b374a0ea4bb266ed135ff62",22856350,1,1,0,1066,334,335,1
"fe49f8054b374a0ea4bb266ed135ff62","fe49f8054b374a0ea4bb266ed135ff62",22856350,2,0,1,1067,335,335,0
"fe49f8054b374a0ea4bb266ed135ff62","d0a8f74af98642fe8360d22c42e45117",22856350,1,1,0,1069,335,336,1
"d0a8f74af98642fe8360d22c42e45117","d0a8f74af98642fe8360d22c42e45117",22856350,2,0,1,1070,336,336,0
"d0a8f74af98642fe8360d22c42e45117","0c4079457ede49e3aeb5e86ed84bdf35",22856350,1,-7,0,1072,336,329,-7
"0c4079457ede49e3aeb5e86ed84bdf35","a7c6339ca1da4368a18d471f0519f877",22856350,1,11,0,1073,329,339,10
"a7c6339ca1da4368a18d471f0519f877","a7c6339ca1da4368a18d471f0519f877",22856350,1,0,1,1074,339,339,0
"a7c6339ca1da4368a18d471f0519f877","bbc5139ca9024389a94db3a6f47dcff6",22856350,1,3,0,1075,339,341,2
"bbc5139ca9024389a94db3a6f47dcff6","b8b9418ab322418d9db9b40d96af873a",22856350,1,-5,0,1076,341,337,-4
"b8b9418ab322418d9db9b40d96af873a","bbc5139ca9024389a94db3a6f47dcff6",22856350,1,5,0,1077,337,341,4
"bbc5139ca9024389a94db3a6f47dcff6","bbc5139ca9024389a94db3a6f47dcff6",22856350,2,0,1,1078,341,341,0
"bbc5139ca9024389a94db3a6f47dcff6","4ee6ca9019ab4a1ab323f98094a9bd77",22856350,1,2,0,1080,341,343,2
"4ee6ca9019ab4a1ab323f98094a9bd77","4ee6ca9019ab4a1ab323f98094a9bd77",22856350,2,0,1,1081,343,343,0
"4ee6ca9019ab4a1ab323f98094a9bd77","b37947176785476f8b29d49a851366dc",22856350,1,1,0,1083,343,344,1
"b37947176785476f8b29d49a851366dc","b37947176785476f8b29d49a851366dc",22856350,2,0,1,1084,344,344,0
"b37947176785476f8b29d49a851366dc","fcea5b10d5a14a3b9324ffece8f6e1e5",22856350,1,1,0,1086,344,345,1
"fcea5b10d5a14a3b9324ffece8f6e1e5","fcea5b10d5a14a3b9324ffece8f6e1e5",22856350,2,0,1,1087,345,345,0
"fcea5b10d5a14a3b9324ffece8f6e1e5","c2490bc612d146edbe786556fab3651b",22856350,1,-5,0,1089,345,340,-5
"c2490bc612d146edbe786556fab3651b","0c4079457ede49e3aeb5e86ed84bdf35",22856350,1,-13,0,1090,340,329,-11
"0c4079457ede49e3aeb5e86ed84bdf35","30ead9794d4847abaf222ca966cc8630",22856350,1,24,0,1091,329,348,19
"30ead9794d4847abaf222ca966cc8630","eff0de7f2dbb42dfa1a2e686efab5b6d",22856350,3,6,0,1092,348,354,6
"eff0de7f2dbb42dfa1a2e686efab5b6d","897b7f51242c44aab2205c72fdcbf4cd",22856350,2,-2,0,1093,354,352,-2
"897b7f51242c44aab2205c72fdcbf4cd","09b9678ddc3d452ea4a3d46e15826065",22856350,2,1,0,1094,352,353,1
"09b9678ddc3d452ea4a3d46e15826065","c20993c944444fe085345591a8bd837e",22856350,2,-2,0,1095,353,351,-2
"c20993c944444fe085345591a8bd837e","30ead9794d4847abaf222ca966cc8630",22856350,1,-3,0,1096,351,348,-3
"30ead9794d4847abaf222ca966cc8630","0c4079457ede49e3aeb5e86ed84bdf35",22856350,1,-24,0,1097,348,329,-19
"0c4079457ede49e3aeb5e86ed84bdf35","b71bac264efb4abd97015447bd490db6",22856350,1,52,0,1098,329,370,41
"b71bac264efb4abd97015447bd490db6","30ead9794d4847abaf222ca966cc8630",22856350,2,-28,0,1099,370,348,-22
"30ead9794d4847abaf222ca966cc8630","30ead9794d4847abaf222ca966cc8630",22856350,2,0,1,1100,348,348,0
"eff0de7f2dbb42dfa1a2e686efab5b6d","09b9678ddc3d452ea4a3d46e15826065",22856350,1,-1,0,1102,354,353,-1
"09b9678ddc3d452ea4a3d46e15826065","897b7f51242c44aab2205c72fdcbf4cd",22856350,1,-1,0,1103,353,352,-1
"897b7f51242c44aab2205c72fdcbf4cd","c20993c944444fe085345591a8bd837e",22856350,2,-1,0,1104,352,351,-1
"c20993c944444fe085345591a8bd837e","4a29443515bb404cb8924e1c60a63b73",22856350,1,-85,0,1105,351,285,-66
"4a29443515bb404cb8924e1c60a63b73","34a6e49023fc4465bd5ca604330bbd1c",22856350,1,9,0,1106,285,292,7
"34a6e49023fc4465bd5ca604330bbd1c","869e967078f04da18dd0b0b9389a7424",22856350,1,1,0,1107,292,293,1
"869e967078f04da18dd0b0b9389a7424","34a6e49023fc4465bd5ca604330bbd1c",22856350,1,-1,0,1108,293,292,-1
"21592f2a9e9c4b2f8c66ec5dbcbf6a2b","7646a919d7e64fa990bca9b024ff089d",22856350,1,3,0,1111,296,298,2
"7646a919d7e64fa990bca9b024ff089d","e390b575229748ea8aac9364efe2bf00",22856350,1,7,0,1112,298,304,6
"e390b575229748ea8aac9364efe2bf00","e390b575229748ea8aac9364efe2bf00",22856350,1,0,1,1113,304,304,0
"e390b575229748ea8aac9364efe2bf00","4a29443515bb404cb8924e1c60a63b73",22856350,1,-24,0,1114,304,285,-19
"4a29443515bb404cb8924e1c60a63b73","43ea1b823a4b4e51b7c694c10725db82",22856350,1,54,0,1115,285,327,42
"43ea1b823a4b4e51b7c694c10725db82","3434c10e561d488a914e0f7d71907abd",22856350,1,-27,0,1116,327,305,-22
"3434c10e561d488a914e0f7d71907abd","56b3fd1a212a4764be39d979fde3326e",22856350,1,28,0,1117,305,328,23
"56b3fd1a212a4764be39d979fde3326e","56b3fd1a212a4764be39d979fde3326e",22856350,1,0,1,1118,328,328,0
"56b3fd1a212a4764be39d979fde3326e","4a29443515bb404cb8924e1c60a63b73",22856350,1,-55,0,1119,328,285,-43
"4a29443515bb404cb8924e1c60a63b73","4a92daef4d504e1792575a26502bb7b7",22856350,1,78,0,1120,285,346,61
"4a92daef4d504e1792575a26502bb7b7","0c4079457ede49e3aeb5e86ed84bdf35",22856350,1,-20,0,1121,346,329,-17
"0c4079457ede49e3aeb5e86ed84bdf35","6ac8bb048b854999a47edb35fe627f11",22856350,1,21,0,1122,329,347,18
"6ac8bb048b854999a47edb35fe627f11","6ac8bb048b854999a47edb35fe627f11",22856350,1,0,1,1123,347,347,0
"6ac8bb048b854999a47edb35fe627f11","30ead9794d4847abaf222ca966cc8630",22856350,1,3,0,1124,347,348,1
"c20993c944444fe085345591a8bd837e","09b9678ddc3d452ea4a3d46e15826065",22856350,1,2,0,1129,351,353,2
"c20993c944444fe085345591a8bd837e","c20993c944444fe085345591a8bd837e",22856350,3,0,1,1131,351,351,0
"c20993c944444fe085345591a8bd837e","897b7f51242c44aab2205c72fdcbf4cd",22856350,1,1,0,1134,351,352,1
"897b7f51242c44aab2205c72fdcbf4cd","897b7f51242c44aab2205c72fdcbf4cd",22856350,3,0,1,1135,352,352,0
"09b9678ddc3d452ea4a3d46e15826065","09b9678ddc3d452ea4a3d46e15826065",22856350,3,0,1,1139,353,353,0
"09b9678ddc3d452ea4a3d46e15826065","eff0de7f2dbb42dfa1a2e686efab5b6d",22856350,1,1,0,1142,353,354,1
"eff0de7f2dbb42dfa1a2e686efab5b6d","eff0de7f2dbb42dfa1a2e686efab5b6d",22856350,3,0,1,1143,354,354,0
"eff0de7f2dbb42dfa1a2e686efab5b6d","2fe14166dc9642c3bc666b86a57f943d",22856350,1,4,0,1146,354,357,3
"2fe14166dc9642c3bc666b86a57f943d","30ead9794d4847abaf222ca966cc8630",22856350,1,-10,0,1147,357,348,-9
"30ead9794d4847abaf222ca966cc8630","2fe14166dc9642c3bc666b86a57f943d",22856350,1,10,0,1148,348,357,9
"2fe14166dc9642c3bc666b86a57f943d","2fe14166dc9642c3bc666b86a57f943d",22856350,1,0,1,1149,357,357,0
"2fe14166dc9642c3bc666b86a57f943d","44421dd1e13a47a388c4a19834b744c7",22856350,1,2,0,1150,357,359,2
"44421dd1e13a47a388c4a19834b744c7","44421dd1e13a47a388c4a19834b744c7",22856350,2,0,1,1151,359,359,0
"44421dd1e13a47a388c4a19834b744c7","cb5fc7ef85d547c4be1a7439d0bf6052",22856350,1,1,0,1153,359,360,1
"cb5fc7ef85d547c4be1a7439d0bf6052","cb5fc7ef85d547c4be1a7439d0bf6052",22856350,5,0,1,1154,360,360,0
"cb5fc7ef85d547c4be1a7439d0bf6052","0a8f150a4cf747acbde62f4721823da3",22856350,1,1,0,1159,360,361,1
"0a8f150a4cf747acbde62f4721823da3","0a8f150a4cf747acbde62f4721823da3",22856350,2,0,1,1160,361,361,0
"0a8f150a4cf747acbde62f4721823da3","2fe14166dc9642c3bc666b86a57f943d",22856350,1,-4,0,1162,361,357,-4
"2fe14166dc9642c3bc666b86a57f943d","ab8fdad974ae471f9f24c3f9dd04462e",22856350,1,5,0,1163,357,362,5
"ab8fdad974ae471f9f24c3f9dd04462e","ab8fdad974ae471f9f24c3f9dd04462e",22856350,2,0,1,1164,362,362,0
"ab8fdad974ae471f9f24c3f9dd04462e","1ba8fef685d74a8194b9db252eb704fb",22856350,1,-7,0,1166,362,355,-7
"1ba8fef685d74a8194b9db252eb704fb","52580888dadb4fe3baa795683ea227bd",22856350,1,10,0,1167,355,364,9
"52580888dadb4fe3baa795683ea227bd","52580888dadb4fe3baa795683ea227bd",22856350,2,0,1,1168,364,364,0
"52580888dadb4fe3baa795683ea227bd","f00179e251a045b39c3f7a54f9aa4acc",22856350,1,-1,0,1170,364,363,-1
"f00179e251a045b39c3f7a54f9aa4acc","492a3bc6a1254f23a7998587961b22a4",22856350,1,4,0,1171,363,366,3
"492a3bc6a1254f23a7998587961b22a4","492a3bc6a1254f23a7998587961b22a4",22856350,2,0,1,1172,366,366,0
"492a3bc6a1254f23a7998587961b22a4","072a190fd302456290895f9f04d6940a",22856350,1,-1,0,1174,366,365,-1
"072a190fd302456290895f9f04d6940a","2fe14166dc9642c3bc666b86a57f943d",22856350,1,-10,0,1175,365,357,-8
"2fe14166dc9642c3bc666b86a57f943d","c76574d21bc14aeea7ecd0b027f39858",22856350,1,13,0,1176,357,367,10
"c76574d21bc14aeea7ecd0b027f39858","1ba8fef685d74a8194b9db252eb704fb",22856350,1,-15,0,1177,367,355,-12
"1ba8fef685d74a8194b9db252eb704fb","cfa457d1743848e4bb5e4beced6448ed",22856350,1,17,0,1178,355,369,14
"cfa457d1743848e4bb5e4beced6448ed","cfa457d1743848e4bb5e4beced6448ed",22856350,2,0,1,1179,369,369,0
"cfa457d1743848e4bb5e4beced6448ed","b71bac264efb4abd97015447bd490db6",22856350,1,3,0,1181,369,370,1
"30ead9794d4847abaf222ca966cc8630","b2f0d654738f48158edff28e8d3a546e",22856350,1,152,0,1183,348,449,101
"b2f0d654738f48158edff28e8d3a546e","b2f0d654738f48158edff28e8d3a546e",22856350,1,0,1,1184,449,449,0
"b2f0d654738f48158edff28e8d3a546e","66baf19b6b904b70922329068c63746d",22856350,1,-112,0,1185,449,376,-73
"66baf19b6b904b70922329068c63746d","0d987bed3ffa4ed0b9a2e62e97b7b30f",22856350,1,-144,0,1186,376,272,-104
"0d987bed3ffa4ed0b9a2e62e97b7b30f","82ae07bc0c9b4570a41799290d1ef399",22856350,1,4,0,1187,272,275,3
"82ae07bc0c9b4570a41799290d1ef399","82ae07bc0c9b4570a41799290d1ef399",22856350,1,0,1,1188,275,275,0
"82ae07bc0c9b4570a41799290d1ef399","66baf19b6b904b70922329068c63746d",22856350,1,140,0,1189,275,376,101
"66baf19b6b904b70922329068c63746d","66baf19b6b904b70922329068c63746d",22856350,1,0,1,1190,376,376,0
"66baf19b6b904b70922329068c63746d","7f544639412e40a9ba27f43b415362ab",22856350,3,2,0,1191,376,378,2
"7f544639412e40a9ba27f43b415362ab","7f544639412e40a9ba27f43b415362ab",22856350,4,0,1,1192,378,378,0
"7f544639412e40a9ba27f43b415362ab","a0d10309a2dd456289147f84be9d37f9",22856350,1,3,0,1196,378,381,3
"a0d10309a2dd456289147f84be9d37f9","a0d10309a2dd456289147f84be9d37f9",22856350,2,0,1,1197,381,381,0
"a0d10309a2dd456289147f84be9d37f9","d5ae8642e15b46b8bd298b02274d4e9c",22856350,1,-1,0,1199,381,380,-1
"d5ae8642e15b46b8bd298b02274d4e9c","d5ae8642e15b46b8bd298b02274d4e9c",22856350,1,0,1,1200,380,380,0
"d5ae8642e15b46b8bd298b02274d4e9c","0fcbc3ca07b144138b8d85da581f09a8",22856350,1,2,0,1201,380,382,2
"0fcbc3ca07b144138b8d85da581f09a8","0fcbc3ca07b144138b8d85da581f09a8",22856350,8,0,1,1202,382,382,0
"0fcbc3ca07b144138b8d85da581f09a8","66baf19b6b904b70922329068c63746d",22856350,1,-6,0,1210,382,376,-6
"66baf19b6b904b70922329068c63746d","c2fca3669923477ab966ded303dea31c",22856350,1,8,0,1211,376,383,7
"c2fca3669923477ab966ded303dea31c","4890121ce5d74576b4632b77cfc23398",22856350,1,6,0,1212,383,388,5
"4890121ce5d74576b4632b77cfc23398","4890121ce5d74576b4632b77cfc23398",22856350,2,0,1,1213,388,388,0
"4890121ce5d74576b4632b77cfc23398","96bb2b3e85a34d8b9544514e89f6fe97",22856350,1,3,0,1215,388,390,2
"96bb2b3e85a34d8b9544514e89f6fe97","18d3b836dd804224883cc9180b60a8e1",22856350,1,-4,0,1216,390,387,-3
"18d3b836dd804224883cc9180b60a8e1","96bb2b3e85a34d8b9544514e89f6fe97",22856350,1,4,0,1217,387,390,3
"96bb2b3e85a34d8b9544514e89f6fe97","96bb2b3e85a34d8b9544514e89f6fe97",22856350,1,0,1,1218,390,390,0
"96bb2b3e85a34d8b9544514e89f6fe97","6f8881a745ac4c358a68b92c3b4abe81",22856350,1,5,0,1219,390,394,4
"6f8881a745ac4c358a68b92c3b4abe81","17f95d18bab743888e1736033dc3384d",22856350,2,-6,0,1220,394,389,-5
"17f95d18bab743888e1736033dc3384d","96bb2b3e85a34d8b9544514e89f6fe97",22856350,1,1,0,1221,389,390,1
"96bb2b3e85a34d8b9544514e89f6fe97","f7002c8484354eceac57bc7bd62c76c1",22856350,1,4,0,1222,390,393,3
"f7002c8484354eceac57bc7bd62c76c1","ac4e9b54acfe4670b4634859c7263cb5",22856350,1,-2,0,1223,393,392,-1
"ac4e9b54acfe4670b4634859c7263cb5","ac4e9b54acfe4670b4634859c7263cb5",22856350,1,0,1,1224,392,392,0
"ac4e9b54acfe4670b4634859c7263cb5","6f8881a745ac4c358a68b92c3b4abe81",22856350,1,3,0,1225,392,394,2
"17f95d18bab743888e1736033dc3384d","6f8881a745ac4c358a68b92c3b4abe81",22856350,1,6,0,1227,389,394,5
"6f8881a745ac4c358a68b92c3b4abe81","6f8881a745ac4c358a68b92c3b4abe81",22856350,1,0,1,1228,394,394,0
"6f8881a745ac4c358a68b92c3b4abe81","f7002c8484354eceac57bc7bd62c76c1",22856350,1,-1,0,1229,394,393,-1
"f7002c8484354eceac57bc7bd62c76c1","6f8881a745ac4c358a68b92c3b4abe81",22856350,1,1,0,1230,393,394,1
"6f8881a745ac4c358a68b92c3b4abe81","0c12af0a4e7f4002852cf84b2537c161",22856350,1,2,0,1231,394,395,1
"0c12af0a4e7f4002852cf84b2537c161","f7002c8484354eceac57bc7bd62c76c1",22856350,1,-3,0,1232,395,393,-2
"f7002c8484354eceac57bc7bd62c76c1","66baf19b6b904b70922329068c63746d",22856350,1,-21,0,1233,393,376,-17
"7f544639412e40a9ba27f43b415362ab","66baf19b6b904b70922329068c63746d",22856350,2,-2,0,1235,378,376,-2
"66baf19b6b904b70922329068c63746d","df8191ec5e584c838a899c378941a566",22856350,1,28,0,1236,376,398,22
"df8191ec5e584c838a899c378941a566","44a277ea44dc4ae689fab4b82f0b4098",22856350,1,-2,0,1237,398,397,-1
"44a277ea44dc4ae689fab4b82f0b4098","44a277ea44dc4ae689fab4b82f0b4098",22856350,1,0,1,1238,397,397,0
"44a277ea44dc4ae689fab4b82f0b4098","0c12af0a4e7f4002852cf84b2537c161",22856350,1,-2,0,1239,397,395,-2
"0c12af0a4e7f4002852cf84b2537c161","66baf19b6b904b70922329068c63746d",22856350,1,-24,0,1240,395,376,-19
"66baf19b6b904b70922329068c63746d","859e0b8d71694b12befb69ee698138f9",22856350,1,29,0,1243,376,399,23
"859e0b8d71694b12befb69ee698138f9","859e0b8d71694b12befb69ee698138f9",22856350,1,0,1,1244,399,399,0
"859e0b8d71694b12befb69ee698138f9","66baf19b6b904b70922329068c63746d",22856350,1,-29,0,1245,399,376,-23
"66baf19b6b904b70922329068c63746d","2b09a08242b54983aec7063990fb3f66",22856350,1,32,0,1246,376,400,24
"2b09a08242b54983aec7063990fb3f66","2b09a08242b54983aec7063990fb3f66",22856350,6,0,1,1247,400,400,0
"2b09a08242b54983aec7063990fb3f66","1f471b7a883a4df48211e8c6a81b59a7",22856350,1,1,0,1253,400,401,1
"1f471b7a883a4df48211e8c6a81b59a7","1f471b7a883a4df48211e8c6a81b59a7",22856350,1,0,1,1254,401,401,0
"1f471b7a883a4df48211e8c6a81b59a7","2b09a08242b54983aec7063990fb3f66",22856350,1,-1,0,1255,401,400,-1
"2b09a08242b54983aec7063990fb3f66","9de0d567bfa84fe5b77cb76f4a76a5d1",22856350,1,5,0,1256,400,404,4
"9de0d567bfa84fe5b77cb76f4a76a5d1","9de0d567bfa84fe5b77cb76f4a76a5d1",22856350,1,0,1,1257,404,404,0
"9de0d567bfa84fe5b77cb76f4a76a5d1","1157bd665ec4472fb58b751dc5099355",22856350,1,-1,0,1258,404,403,-1
"1157bd665ec4472fb58b751dc5099355","58fc9094275e4c49be3f4ba6d4acc0a4",22856350,1,5,0,1259,403,406,3
"58fc9094275e4c49be3f4ba6d4acc0a4","3c8a22d2f9c146ea956609e3ed4f2559",22856350,1,-2,0,1260,406,405,-1
"3c8a22d2f9c146ea956609e3ed4f2559","58fc9094275e4c49be3f4ba6d4acc0a4",22856350,1,2,0,1261,405,406,1
"58fc9094275e4c49be3f4ba6d4acc0a4","58fc9094275e4c49be3f4ba6d4acc0a4",22856350,1,0,1,1262,406,406,0
"58fc9094275e4c49be3f4ba6d4acc0a4","c1c1be90b2b14c1ab4a5e1ee3c241902",22856350,1,1,0,1263,406,407,1
"c1c1be90b2b14c1ab4a5e1ee3c241902","c1c1be90b2b14c1ab4a5e1ee3c241902",22856350,5,0,1,1264,407,407,0
"c1c1be90b2b14c1ab4a5e1ee3c241902","02b3a1bead9244c1ba2f857c7da8f82a",22856350,1,2,0,1269,407,408,1
"02b3a1bead9244c1ba2f857c7da8f82a","58fc9094275e4c49be3f4ba6d4acc0a4",22856350,1,-3,0,1270,408,406,-2
"58fc9094275e4c49be3f4ba6d4acc0a4","02b3a1bead9244c1ba2f857c7da8f82a",22856350,1,3,0,1271,406,408,2
"02b3a1bead9244c1ba2f857c7da8f82a","02b3a1bead9244c1ba2f857c7da8f82a",22856350,2,0,1,1272,408,408,0
"02b3a1bead9244c1ba2f857c7da8f82a","6206fc6479014bb193084c32409dc1b9",22856350,1,1,0,1274,408,409,1
"6206fc6479014bb193084c32409dc1b9","6206fc6479014bb193084c32409dc1b9",22856350,1,0,1,1275,409,409,0
"6206fc6479014bb193084c32409dc1b9","6a5f020451db426dacba9e2ea3fcc62a",22856350,1,2,0,1276,409,410,1
"6a5f020451db426dacba9e2ea3fcc62a","02b3a1bead9244c1ba2f857c7da8f82a",22856350,1,-3,0,1277,410,408,-2
"02b3a1bead9244c1ba2f857c7da8f82a","6a5f020451db426dacba9e2ea3fcc62a",22856350,1,3,0,1278,408,410,2
"6a5f020451db426dacba9e2ea3fcc62a","6a5f020451db426dacba9e2ea3fcc62a",22856350,1,0,1,1279,410,410,0
"6a5f020451db426dacba9e2ea3fcc62a","33a9d248b2e44588a5b07fc1342b9bc2",22856350,2,2,0,1280,410,411,1
"33a9d248b2e44588a5b07fc1342b9bc2","6a5f020451db426dacba9e2ea3fcc62a",22856350,1,-2,0,1281,411,410,-1
"33a9d248b2e44588a5b07fc1342b9bc2","33a9d248b2e44588a5b07fc1342b9bc2",22856350,2,0,1,1283,411,411,0
"33a9d248b2e44588a5b07fc1342b9bc2","c6f26bd420634f1cb7989e76fe6b16c0",22856350,1,1,0,1285,411,412,1
"c6f26bd420634f1cb7989e76fe6b16c0","c6f26bd420634f1cb7989e76fe6b16c0",22856350,5,0,1,1286,412,412,0
"c6f26bd420634f1cb7989e76fe6b16c0","2a65ee6e2ac64f6a8a55fbe5373ec763",22856350,1,1,0,1291,412,413,1
"2a65ee6e2ac64f6a8a55fbe5373ec763","2a65ee6e2ac64f6a8a55fbe5373ec763",22856350,2,0,1,1292,413,413,0
"2a65ee6e2ac64f6a8a55fbe5373ec763","33a9d248b2e44588a5b07fc1342b9bc2",22856350,1,-2,0,1294,413,411,-2
"33a9d248b2e44588a5b07fc1342b9bc2","687055dad9fc40c3982478fe33ec01bf",22856350,1,4,0,1295,411,414,3
"687055dad9fc40c3982478fe33ec01bf","2b09a08242b54983aec7063990fb3f66",22856350,2,-21,0,1296,414,400,-14
"2b09a08242b54983aec7063990fb3f66","1fd0f6dadbc14ebc965faf6122190b96",22856350,1,22,0,1297,400,415,15
"1fd0f6dadbc14ebc965faf6122190b96","1fd0f6dadbc14ebc965faf6122190b96",22856350,1,0,1,1298,415,415,0
"1fd0f6dadbc14ebc965faf6122190b96","687055dad9fc40c3982478fe33ec01bf",22856350,1,-1,0,1299,415,414,-1
"2b09a08242b54983aec7063990fb3f66","687055dad9fc40c3982478fe33ec01bf",22856350,1,21,0,1301,400,414,14
"687055dad9fc40c3982478fe33ec01bf","2add1669f08d4101913db15f8c23b3b7",22856350,1,3,0,1302,414,416,2
"2add1669f08d4101913db15f8c23b3b7","2add1669f08d4101913db15f8c23b3b7",22856350,1,0,1,1303,416,416,0
"2add1669f08d4101913db15f8c23b3b7","a2b4bd40cee2481ebd3fc179d6a5cd62",22856350,1,3,0,1304,416,417,1
"a2b4bd40cee2481ebd3fc179d6a5cd62","2b09a08242b54983aec7063990fb3f66",22856350,1,-27,0,1305,417,400,-17
"2b09a08242b54983aec7063990fb3f66","a2b4bd40cee2481ebd3fc179d6a5cd62",22856350,1,27,0,1306,400,417,17
"a2b4bd40cee2481ebd3fc179d6a5cd62","a2b4bd40cee2481ebd3fc179d6a5cd62",22856350,1,0,1,1307,417,417,0
"a2b4bd40cee2481ebd3fc179d6a5cd62","e34e59dce2204f228f3a84b6725df60f",22856350,1,2,0,1308,417,419,2
"e34e59dce2204f228f3a84b6725df60f","e34e59dce2204f228f3a84b6725df60f",22856350,1,0,1,1309,419,419,0
"e34e59dce2204f228f3a84b6725df60f","a2b4bd40cee2481ebd3fc179d6a5cd62",22856350,1,-2,0,1310,419,417,-2
"a2b4bd40cee2481ebd3fc179d6a5cd62","bec48fc2e1294c7eb3d0aca780d731b8",22856350,1,4,0,1311,417,420,3
"bec48fc2e1294c7eb3d0aca780d731b8","bec48fc2e1294c7eb3d0aca780d731b8",22856350,3,0,1,1312,420,420,0
"bec48fc2e1294c7eb3d0aca780d731b8","a24600b0e49245f6bdba8c893cfeddb0",22856350,1,7,0,1315,420,425,5
"a24600b0e49245f6bdba8c893cfeddb0","dbde19fcce2a4c1abdc7f685c293a23f",22856350,1,-4,0,1316,425,422,-3
"dbde19fcce2a4c1abdc7f685c293a23f","a24600b0e49245f6bdba8c893cfeddb0",22856350,1,4,0,1317,422,425,3
"a24600b0e49245f6bdba8c893cfeddb0","a24600b0e49245f6bdba8c893cfeddb0",22856350,2,0,1,1318,425,425,0
"a24600b0e49245f6bdba8c893cfeddb0","a2b4bd40cee2481ebd3fc179d6a5cd62",22856350,1,-11,0,1320,425,417,-8
"a2b4bd40cee2481ebd3fc179d6a5cd62","24cf8786024543f19b89bc20034e60d7",22856350,1,18,0,1321,417,428,11
"24cf8786024543f19b89bc20034e60d7","f2a73be2f46840b182d7bd095378004e",22856350,2,1,0,1322,428,429,1
"f2a73be2f46840b182d7bd095378004e","f2a73be2f46840b182d7bd095378004e",22856350,3,0,1,1323,429,429,0
"f2a73be2f46840b182d7bd095378004e","24cf8786024543f19b89bc20034e60d7",22856350,2,-1,0,1325,429,428,-1
"24cf8786024543f19b89bc20034e60d7","24cf8786024543f19b89bc20034e60d7",22856350,1,0,1,1326,428,428,0
"f2a73be2f46840b182d7bd095378004e","604551fd4266430cb860fef58fa7dd61",22856350,1,1,0,1329,429,430,1
"604551fd4266430cb860fef58fa7dd61","604551fd4266430cb860fef58fa7dd61",22856350,4,0,1,1330,430,430,0
"604551fd4266430cb860fef58fa7dd61","f2a73be2f46840b182d7bd095378004e",22856350,1,-1,0,1334,430,429,-1
"24cf8786024543f19b89bc20034e60d7","dce46f8904594a62a6377a3587aaa663",22856350,1,4,0,1336,428,431,3
"dce46f8904594a62a6377a3587aaa663","dce46f8904594a62a6377a3587aaa663",22856350,3,0,1,1337,431,431,0
"dce46f8904594a62a6377a3587aaa663","9b9d0a249052413c869753b99682b0ac",22856350,1,1,0,1340,431,432,1
"9b9d0a249052413c869753b99682b0ac","9b9d0a249052413c869753b99682b0ac",22856350,1,0,1,1341,432,432,0
"9b9d0a249052413c869753b99682b0ac","061c175cc90f45fbad883025394e78dd",22856350,1,1,0,1342,432,433,1
"061c175cc90f45fbad883025394e78dd","061c175cc90f45fbad883025394e78dd",22856350,4,0,1,1343,433,433,0
"061c175cc90f45fbad883025394e78dd","dce46f8904594a62a6377a3587aaa663",22856350,1,-2,0,1347,433,431,-2
"dce46f8904594a62a6377a3587aaa663","74a7f8712e5449c2bc0b43c6f90dafed",22856350,1,5,0,1348,431,435,4
"74a7f8712e5449c2bc0b43c6f90dafed","74a7f8712e5449c2bc0b43c6f90dafed",22856350,2,0,1,1349,435,435,0
"74a7f8712e5449c2bc0b43c6f90dafed","dce46f8904594a62a6377a3587aaa663",22856350,1,-5,0,1351,435,431,-4
"dce46f8904594a62a6377a3587aaa663","66ada10dde9f43018588f1ced9d477fc",22856350,2,4,0,1352,431,434,3
"66ada10dde9f43018588f1ced9d477fc","dce46f8904594a62a6377a3587aaa663",22856350,1,-4,0,1353,434,431,-3
"66ada10dde9f43018588f1ced9d477fc","bf12c96466d840a69bed7020b3f18bb8",22856350,1,3,0,1355,434,436,2
"bf12c96466d840a69bed7020b3f18bb8","bf12c96466d840a69bed7020b3f18bb8",22856350,1,0,1,1356,436,436,0
"bf12c96466d840a69bed7020b3f18bb8","24cf8786024543f19b89bc20034e60d7",22856350,1,-11,0,1357,436,428,-8
"24cf8786024543f19b89bc20034e60d7","070600601c4c439288445d2f0724807d",22856350,1,14,0,1358,428,437,9
"070600601c4c439288445d2f0724807d","1823b6de7d334a7aaabc4570719af4d9",22856350,2,2,0,1359,437,439,2
"1823b6de7d334a7aaabc4570719af4d9","070600601c4c439288445d2f0724807d",22856350,2,-2,0,1360,439,437,-2
"070600601c4c439288445d2f0724807d","070600601c4c439288445d2f0724807d",22856350,1,0,1,1361,437,437,0
"1823b6de7d334a7aaabc4570719af4d9","1823b6de7d334a7aaabc4570719af4d9",22856350,10,0,1,1363,439,439,0
"070600601c4c439288445d2f0724807d","0380cd76a7d44bc3a4da1f15e4d68f89",22856350,1,4,0,1374,437,440,3
"0380cd76a7d44bc3a4da1f15e4d68f89","0380cd76a7d44bc3a4da1f15e4d68f89",22856350,4,0,1,1375,440,440,0
"0380cd76a7d44bc3a4da1f15e4d68f89","23b7673c8b5443108c2ef09382834a86",22856350,1,2,0,1379,440,441,1
"23b7673c8b5443108c2ef09382834a86","23b7673c8b5443108c2ef09382834a86",22856350,2,0,1,1380,441,441,0
"23b7673c8b5443108c2ef09382834a86","901e92500aea43c79f19f1b279050668",22856350,2,2,0,1382,441,442,1
"901e92500aea43c79f19f1b279050668","23b7673c8b5443108c2ef09382834a86",22856350,1,-2,0,1383,442,441,-1
"901e92500aea43c79f19f1b279050668","901e92500aea43c79f19f1b279050668",22856350,2,0,1,1385,442,442,0
"901e92500aea43c79f19f1b279050668","001339db8ced4cf78829ebe8b145449d",22856350,1,1,0,1387,442,443,1
"001339db8ced4cf78829ebe8b145449d","001339db8ced4cf78829ebe8b145449d",22856350,12,0,1,1388,443,443,0
"001339db8ced4cf78829ebe8b145449d","452745e0366e42ae81561bfddebcc6c3",22856350,1,1,0,1400,443,444,1
"452745e0366e42ae81561bfddebcc6c3","452745e0366e42ae81561bfddebcc6c3",22856350,2,0,1,1401,444,444,0
"452745e0366e42ae81561bfddebcc6c3","4660ff2089114e8db82ceb26a4f329e3",22856350,1,2,0,1403,444,445,1
"4660ff2089114e8db82ceb26a4f329e3","901e92500aea43c79f19f1b279050668",22856350,1,-4,0,1404,445,442,-3
"901e92500aea43c79f19f1b279050668","4660ff2089114e8db82ceb26a4f329e3",22856350,1,4,0,1405,442,445,3
"4660ff2089114e8db82ceb26a4f329e3","4660ff2089114e8db82ceb26a4f329e3",22856350,3,0,1,1406,445,445,0
"4660ff2089114e8db82ceb26a4f329e3","7bd5586eb9d8484eb74a433ee7bfe499",22856350,1,2,0,1409,445,446,1
"7bd5586eb9d8484eb74a433ee7bfe499","7bd5586eb9d8484eb74a433ee7bfe499",22856350,15,0,1,1410,446,446,0
"7bd5586eb9d8484eb74a433ee7bfe499","8a7f26e690f34dda97be16904518ca99",22856350,1,2,0,1425,446,447,1
"8a7f26e690f34dda97be16904518ca99","8a7f26e690f34dda97be16904518ca99",22856350,1,0,1,1426,447,447,0
"8a7f26e690f34dda97be16904518ca99","070600601c4c439288445d2f0724807d",22856350,1,-16,0,1427,447,437,-10
"070600601c4c439288445d2f0724807d","b2f0d654738f48158edff28e8d3a546e",22856350,1,21,0,1428,437,449,12
"b2f0d654738f48158edff28e8d3a546e","f60ee41ec635499abd48168342d32c2f",22856350,2,5,0,1429,449,453,4
"f60ee41ec635499abd48168342d32c2f","f60ee41ec635499abd48168342d32c2f",22856350,6,0,1,1430,453,453,0
"f60ee41ec635499abd48168342d32c2f","b2f0d654738f48158edff28e8d3a546e",22856350,2,-5,0,1434,453,449,-4
"b2f0d654738f48158edff28e8d3a546e","f67fbf45a5f146ed866965bc57c7c001",22856350,1,8,0,1439,449,454,5
"f67fbf45a5f146ed866965bc57c7c001","f67fbf45a5f146ed866965bc57c7c001",22856350,2,0,1,1440,454,454,0
"f67fbf45a5f146ed866965bc57c7c001","d937afe49bd24a07a550dda1c1155122",22856350,1,1,0,1442,454,455,1
"d937afe49bd24a07a550dda1c1155122","d937afe49bd24a07a550dda1c1155122",22856350,1,0,1,1443,455,455,0
"d937afe49bd24a07a550dda1c1155122","3628b3f7823443d0912a339096b69943",22856350,1,1,0,1444,455,456,1
"3628b3f7823443d0912a339096b69943","3628b3f7823443d0912a339096b69943",22856350,1,0,1,1445,456,456,0
"3628b3f7823443d0912a339096b69943","9e049ee647cf43ecbcb5ed792a8e7588",22856350,1,1,0,1446,456,457,1
"9e049ee647cf43ecbcb5ed792a8e7588","9e049ee647cf43ecbcb5ed792a8e7588",22856350,1,0,1,1447,457,457,0
"9e049ee647cf43ecbcb5ed792a8e7588","5256a214faaf410b93f76cea06428334",22856350,1,1,0,1448,457,458,1
"5256a214faaf410b93f76cea06428334","5256a214faaf410b93f76cea06428334",22856350,1,0,1,1449,458,458,0
"5256a214faaf410b93f76cea06428334","25c32b120fce40fa9b6c85133aeb4716",22856350,1,1,0,1450,458,459,1
"25c32b120fce40fa9b6c85133aeb4716","25c32b120fce40fa9b6c85133aeb4716",22856350,1,0,1,1451,459,459,0
"25c32b120fce40fa9b6c85133aeb4716","11bc14f2204949008b7d511b933363c1",22856350,1,1,0,1452,459,460,1
"11bc14f2204949008b7d511b933363c1","11bc14f2204949008b7d511b933363c1",22856350,1,0,1,1453,460,460,0
"11bc14f2204949008b7d511b933363c1","42de338840a34d15adb66e7b14fb9d2c",22856350,1,1,0,1454,460,461,1
"42de338840a34d15adb66e7b14fb9d2c","42de338840a34d15adb66e7b14fb9d2c",22856350,1,0,1,1455,461,461,0
"42de338840a34d15adb66e7b14fb9d2c","9da37c6210b1416b8079c274f70bf600",22856350,1,1,0,1456,461,462,1
"9da37c6210b1416b8079c274f70bf600","9da37c6210b1416b8079c274f70bf600",22856350,1,0,1,1457,462,462,0
"9da37c6210b1416b8079c274f70bf600","519119f1deac45ff9ab4f13529be5c6e",22856350,1,1,0,1458,462,463,1
"519119f1deac45ff9ab4f13529be5c6e","519119f1deac45ff9ab4f13529be5c6e",22856350,1,0,1,1459,463,463,0
"519119f1deac45ff9ab4f13529be5c6e","c5df9f40ec14463b9dcfdc73df3e9285",22856350,1,3,0,1460,463,464,1
"c5df9f40ec14463b9dcfdc73df3e9285","c5df9f40ec14463b9dcfdc73df3e9285",22856350,2,0,1,1461,464,464,0
"c5df9f40ec14463b9dcfdc73df3e9285","83d42d95cd844fc093fc09cee250edb8",22856350,2,3,0,1463,464,465,1
"83d42d95cd844fc093fc09cee250edb8","c5df9f40ec14463b9dcfdc73df3e9285",22856350,1,-3,0,1464,465,464,-1
"83d42d95cd844fc093fc09cee250edb8","83d42d95cd844fc093fc09cee250edb8",22856350,3,0,1,1466,465,465,0
"b613861cecf84ffcab01afb23f660475","b613861cecf84ffcab01afb23f660475",22856528,3,0,1,1,1,1,0
"b613861cecf84ffcab01afb23f660475","e2911e79efc2420eac45d9f671463d4b",22856528,2,3,0,4,1,2,1
"e2911e79efc2420eac45d9f671463d4b","b613861cecf84ffcab01afb23f660475",22856528,1,-3,0,5,2,1,-1
"e2911e79efc2420eac45d9f671463d4b","519d1b8c59404d67b54e96c5c8a830b2",22856528,1,1,0,9,2,3,1
"519d1b8c59404d67b54e96c5c8a830b2","519d1b8c59404d67b54e96c5c8a830b2",22856528,1,0,1,10,3,3,0
"519d1b8c59404d67b54e96c5c8a830b2","531db53f81f646edb0cdcfe0085b03b7",22856528,1,1,0,11,3,4,1
"531db53f81f646edb0cdcfe0085b03b7","531db53f81f646edb0cdcfe0085b03b7",22856528,1,0,1,12,4,4,0
"531db53f81f646edb0cdcfe0085b03b7","4f5f94b2f95141e0a9d53a61da2276da",22856528,1,1,0,13,4,5,1
"4f5f94b2f95141e0a9d53a61da2276da","4f5f94b2f95141e0a9d53a61da2276da",22856528,1,0,1,14,5,5,0
"4f5f94b2f95141e0a9d53a61da2276da","6d541c89590949f99af293c4f2333f67",22856528,1,1,0,15,5,6,1
"6d541c89590949f99af293c4f2333f67","6d541c89590949f99af293c4f2333f67",22856528,1,0,1,16,6,6,0
"6d541c89590949f99af293c4f2333f67","dd5cf0b9fe4c4f1d8f5ff8e4c04879cb",22856528,1,1,0,17,6,7,1
"dd5cf0b9fe4c4f1d8f5ff8e4c04879cb","dd5cf0b9fe4c4f1d8f5ff8e4c04879cb",22856528,2,0,1,18,7,7,0
"dd5cf0b9fe4c4f1d8f5ff8e4c04879cb","e2911e79efc2420eac45d9f671463d4b",22856528,1,-5,0,20,7,2,-5
"e2911e79efc2420eac45d9f671463d4b","e2911e79efc2420eac45d9f671463d4b",22856528,3,0,1,21,2,2,0
"e2911e79efc2420eac45d9f671463d4b","f96261861edc426abe2248be4f0a709a",22856528,1,6,0,22,2,8,6
"f96261861edc426abe2248be4f0a709a","f96261861edc426abe2248be4f0a709a",22856528,2,0,1,23,8,8,0
"f96261861edc426abe2248be4f0a709a","66b5e16f4f75454fb5b8172079f0fa83",22856528,1,1,0,25,8,9,1
"66b5e16f4f75454fb5b8172079f0fa83","66b5e16f4f75454fb5b8172079f0fa83",22856528,2,0,1,26,9,9,0
"66b5e16f4f75454fb5b8172079f0fa83","0680571d4698477995e41842c36a54b2",22856528,1,1,0,28,9,10,1
"0680571d4698477995e41842c36a54b2","0680571d4698477995e41842c36a54b2",22856528,2,0,1,29,10,10,0
"0680571d4698477995e41842c36a54b2","9112f2bffece48e08c6d2287be204085",22856528,1,1,0,31,10,11,1
"9112f2bffece48e08c6d2287be204085","9112f2bffece48e08c6d2287be204085",22856528,2,0,1,32,11,11,0
"9112f2bffece48e08c6d2287be204085","e2911e79efc2420eac45d9f671463d4b",22856528,1,-9,0,34,11,2,-9
"e2911e79efc2420eac45d9f671463d4b","56586aa865414f538729c7f7735d2bc6",22856528,1,12,0,35,2,12,10
"56586aa865414f538729c7f7735d2bc6","56586aa865414f538729c7f7735d2bc6",22856528,3,0,1,36,12,12,0
"56586aa865414f538729c7f7735d2bc6","b7f2b31585d94eb3bf86376714aa7070",22856528,2,2,0,39,12,13,1
"b7f2b31585d94eb3bf86376714aa7070","b7f2b31585d94eb3bf86376714aa7070",22856528,4,0,1,40,13,13,0
"b7f2b31585d94eb3bf86376714aa7070","56586aa865414f538729c7f7735d2bc6",22856528,1,-2,0,41,13,12,-1
"b7f2b31585d94eb3bf86376714aa7070","3f1c815879794b929260d224becaff7e",22856528,1,2,0,45,13,14,1
"3f1c815879794b929260d224becaff7e","81c864a886d54a6b8ff85f7d736f4f95",22856528,1,2,0,46,14,15,1
"81c864a886d54a6b8ff85f7d736f4f95","3f1c815879794b929260d224becaff7e",22856528,1,-2,0,47,15,14,-1
"3f1c815879794b929260d224becaff7e","b7f2b31585d94eb3bf86376714aa7070",22856528,1,-2,0,48,14,13,-1
"b7f2b31585d94eb3bf86376714aa7070","81c864a886d54a6b8ff85f7d736f4f95",22856528,1,4,0,50,13,15,2
"81c864a886d54a6b8ff85f7d736f4f95","5c5ceeee4562457ba6d41515aeebfbb1",22856528,1,4,0,51,15,17,2
"5c5ceeee4562457ba6d41515aeebfbb1","5c5ceeee4562457ba6d41515aeebfbb1",22856528,1,0,1,52,17,17,0
"5c5ceeee4562457ba6d41515aeebfbb1","56586aa865414f538729c7f7735d2bc6",22856528,2,-10,0,53,17,12,-5
"56586aa865414f538729c7f7735d2bc6","9afd71a5298d4333b6849dfce1b9422c",22856528,2,13,0,54,12,18,6
"9afd71a5298d4333b6849dfce1b9422c","9afd71a5298d4333b6849dfce1b9422c",22856528,1,0,1,55,18,18,0
"9afd71a5298d4333b6849dfce1b9422c","b7719e26494940efa49512aedd0aac79",22856528,1,4,0,56,18,20,2
"b7719e26494940efa49512aedd0aac79","9afd71a5298d4333b6849dfce1b9422c",22856528,1,-4,0,57,20,18,-2
"9afd71a5298d4333b6849dfce1b9422c","d4f45188d3c84a02ba08454e6403a818",22856528,1,9,0,58,18,24,6
"d4f45188d3c84a02ba08454e6403a818","d4c3b003e8274e429d2fa688d73fde6d",22856528,1,-2,0,59,24,22,-2
"d4c3b003e8274e429d2fa688d73fde6d","d4c3b003e8274e429d2fa688d73fde6d",22856528,1,0,1,60,22,22,0
"d4c3b003e8274e429d2fa688d73fde6d","b7719e26494940efa49512aedd0aac79",22856528,1,-3,0,61,22,20,-2
"b7719e26494940efa49512aedd0aac79","afbf7250b99d47bea07172749483ca97",22856528,2,12,0,62,20,28,8
"afbf7250b99d47bea07172749483ca97","b7719e26494940efa49512aedd0aac79",22856528,1,-12,0,63,28,20,-8
"afbf7250b99d47bea07172749483ca97","4e51676dc72045d99c19b9fa7b22f8bc",22856528,1,3,0,65,28,29,1
"4e51676dc72045d99c19b9fa7b22f8bc","4e51676dc72045d99c19b9fa7b22f8bc",22856528,1,0,1,66,29,29,0
"4e51676dc72045d99c19b9fa7b22f8bc","51970cfa30e643e894e66ae85c8024cc",22856528,1,3,0,67,29,31,2
"51970cfa30e643e894e66ae85c8024cc","4e51676dc72045d99c19b9fa7b22f8bc",22856528,1,-3,0,68,31,29,-2
"4e51676dc72045d99c19b9fa7b22f8bc","c33c17be71ae4d588da7369472e5bb1b",22856528,1,9,0,69,29,34,5
"c33c17be71ae4d588da7369472e5bb1b","93679be414554a11b1893002f2229a93",22856528,2,3,0,70,34,35,1
"93679be414554a11b1893002f2229a93","c33c17be71ae4d588da7369472e5bb1b",22856528,2,-3,0,71,35,34,-1
"c33c17be71ae4d588da7369472e5bb1b","7040a13096d746ac84b8fac8d9752058",22856528,1,6,0,72,34,36,2
"7040a13096d746ac84b8fac8d9752058","93679be414554a11b1893002f2229a93",22856528,3,-3,0,73,36,35,-1
"93679be414554a11b1893002f2229a93","9a0dc646f934470daf08c4b56ccf73db",22856528,2,6,0,74,35,37,2
"9a0dc646f934470daf08c4b56ccf73db","7040a13096d746ac84b8fac8d9752058",22856528,2,-3,0,75,37,36,-1
"7040a13096d746ac84b8fac8d9752058","7040a13096d746ac84b8fac8d9752058",22856528,1,0,1,76,36,36,0
"7040a13096d746ac84b8fac8d9752058","9a0dc646f934470daf08c4b56ccf73db",22856528,2,3,0,77,36,37,1
"9a0dc646f934470daf08c4b56ccf73db","93679be414554a11b1893002f2229a93",22856528,1,-6,0,78,37,35,-2
"93679be414554a11b1893002f2229a93","7040a13096d746ac84b8fac8d9752058",22856528,2,3,0,79,35,36,1
"c33c17be71ae4d588da7369472e5bb1b","c33c17be71ae4d588da7369472e5bb1b",22856528,1,0,1,82,34,34,0
"9a0dc646f934470daf08c4b56ccf73db","fc0e049d56024bc9a02c9a9c435c3df7",22856528,1,3,0,89,37,38,1
"fc0e049d56024bc9a02c9a9c435c3df7","b613861cecf84ffcab01afb23f660475",22856528,1,-68,0,90,38,1,-37
"b613861cecf84ffcab01afb23f660475","fc0e049d56024bc9a02c9a9c435c3df7",22856528,1,68,0,91,1,38,37
"fc0e049d56024bc9a02c9a9c435c3df7","fc0e049d56024bc9a02c9a9c435c3df7",22856528,2,0,1,92,38,38,0
"fc0e049d56024bc9a02c9a9c435c3df7","afbf7250b99d47bea07172749483ca97",22856528,1,-24,0,94,38,28,-10
"afbf7250b99d47bea07172749483ca97","afbf7250b99d47bea07172749483ca97",22856528,1,0,1,95,28,28,0
"afbf7250b99d47bea07172749483ca97","67a089198fcb4e1c8f2385786c2b296f",22856528,1,28,0,96,28,39,11
"67a089198fcb4e1c8f2385786c2b296f","64d48c6c9c7940639a932219a6c87198",22856528,2,1,0,97,39,40,1
"64d48c6c9c7940639a932219a6c87198","64d48c6c9c7940639a932219a6c87198",22856528,1,0,1,100,40,40,0
"64d48c6c9c7940639a932219a6c87198","67a089198fcb4e1c8f2385786c2b296f",22856528,2,-1,0,101,40,39,-1
"67a089198fcb4e1c8f2385786c2b296f","b534b89233134e30a9b5645138bfa9ee",22856528,1,4,0,102,39,41,2
"b534b89233134e30a9b5645138bfa9ee","0e37b720d23b4e7f8b313e79313fd107",22856528,1,3,0,103,41,44,3
"0e37b720d23b4e7f8b313e79313fd107","0e37b720d23b4e7f8b313e79313fd107",22856528,1,0,1,104,44,44,0
"0e37b720d23b4e7f8b313e79313fd107","6875d67fdd5f48168b62719df449bebd",22856528,1,1,0,105,44,45,1
"6875d67fdd5f48168b62719df449bebd","6875d67fdd5f48168b62719df449bebd",22856528,1,0,1,106,45,45,0
"6875d67fdd5f48168b62719df449bebd","b534b89233134e30a9b5645138bfa9ee",22856528,1,-4,0,107,45,41,-4
"b534b89233134e30a9b5645138bfa9ee","6e13d61a7bdb44bca949c9f86fab3be5",22856528,1,7,0,108,41,47,6
"6e13d61a7bdb44bca949c9f86fab3be5","6e13d61a7bdb44bca949c9f86fab3be5",22856528,1,0,1,109,47,47,0
"6e13d61a7bdb44bca949c9f86fab3be5","195f78799f984cc2b06c48dfe36be751",22856528,1,2,0,110,47,49,2
"195f78799f984cc2b06c48dfe36be751","195f78799f984cc2b06c48dfe36be751",22856528,2,0,1,111,49,49,0
"195f78799f984cc2b06c48dfe36be751","d9c8d8c444a64dadbbb508652c721e17",22856528,1,-3,0,113,49,46,-3
"d9c8d8c444a64dadbbb508652c721e17","d0c74f735e024943943e40333d6d337f",22856528,1,6,0,114,46,51,5
"d0c74f735e024943943e40333d6d337f","d0c74f735e024943943e40333d6d337f",22856528,1,0,1,115,51,51,0
"d0c74f735e024943943e40333d6d337f","983f8ff320594b279a7f4a6fe132f9c5",22856528,1,2,0,116,51,53,2
"983f8ff320594b279a7f4a6fe132f9c5","983f8ff320594b279a7f4a6fe132f9c5",22856528,2,0,1,117,53,53,0
"983f8ff320594b279a7f4a6fe132f9c5","35adfa5d923046aebabfefd98f35ff05",22856528,1,1,0,119,53,54,1
"35adfa5d923046aebabfefd98f35ff05","35adfa5d923046aebabfefd98f35ff05",22856528,5,0,1,120,54,54,0
"35adfa5d923046aebabfefd98f35ff05","b6f8a98476224da1b40e555ececc7ed8",22856528,1,1,0,125,54,55,1
"b6f8a98476224da1b40e555ececc7ed8","b6f8a98476224da1b40e555ececc7ed8",22856528,2,0,1,126,55,55,0
"b6f8a98476224da1b40e555ececc7ed8","86e22cb5fe0e4b47a9489ecddf7ed78f",22856528,1,1,0,128,55,56,1
"86e22cb5fe0e4b47a9489ecddf7ed78f","86e22cb5fe0e4b47a9489ecddf7ed78f",22856528,2,0,1,129,56,56,0
"86e22cb5fe0e4b47a9489ecddf7ed78f","f924752d8a1149668870b1e7698486f7",22856528,1,-6,0,131,56,50,-6
"f924752d8a1149668870b1e7698486f7","78f30e4dcac84e3cbea8b2cc6e0d62b3",22856528,1,10,0,132,50,59,9
"78f30e4dcac84e3cbea8b2cc6e0d62b3","a1f2f12debe5432fb7a70bcd12bacfb9",22856528,1,-1,0,133,59,58,-1
"a1f2f12debe5432fb7a70bcd12bacfb9","a1f2f12debe5432fb7a70bcd12bacfb9",22856528,18,0,1,134,58,58,0
"a1f2f12debe5432fb7a70bcd12bacfb9","78f30e4dcac84e3cbea8b2cc6e0d62b3",22856528,1,1,0,152,58,59,1
"78f30e4dcac84e3cbea8b2cc6e0d62b3","78f30e4dcac84e3cbea8b2cc6e0d62b3",22856528,13,0,1,153,59,59,0
"78f30e4dcac84e3cbea8b2cc6e0d62b3","12aa6e1672ac4e7aa6449a7a8609cd72",22856528,1,-2,0,166,59,57,-2
"12aa6e1672ac4e7aa6449a7a8609cd72","a0a418b8540d479fa6e0f653b701da8b",22856528,1,8,0,167,57,64,7
"a0a418b8540d479fa6e0f653b701da8b","bc42d26810654ea9a1df1efe1e58c7d5",22856528,2,-1,0,168,64,63,-1
"bc42d26810654ea9a1df1efe1e58c7d5","4c943503763e4e349906eea3ed3c8e86",22856528,1,-2,0,169,63,61,-2
"4c943503763e4e349906eea3ed3c8e86","4c943503763e4e349906eea3ed3c8e86",22856528,1,0,1,170,61,61,0
"4c943503763e4e349906eea3ed3c8e86","309ccf3cc4fe429d9bfbaef53d3fa479",22856528,1,-1,0,171,61,60,-1
"309ccf3cc4fe429d9bfbaef53d3fa479","d646286c8051419bbc2e31dd1db55ca8",22856528,1,10,0,172,60,67,7
"d646286c8051419bbc2e31dd1db55ca8","b534b89233134e30a9b5645138bfa9ee",22856528,1,-33,0,173,67,41,-26
"b534b89233134e30a9b5645138bfa9ee","b534b89233134e30a9b5645138bfa9ee",22856528,1,0,1,174,41,41,0
"b534b89233134e30a9b5645138bfa9ee","d646286c8051419bbc2e31dd1db55ca8",22856528,2,33,0,175,41,67,26
"d646286c8051419bbc2e31dd1db55ca8","a0a418b8540d479fa6e0f653b701da8b",22856528,1,-6,0,176,67,64,-3
"bc42d26810654ea9a1df1efe1e58c7d5","7af822066add4e7f8e007e4eee31a8bf",22856528,1,3,0,178,63,65,2
"7af822066add4e7f8e007e4eee31a8bf","309ccf3cc4fe429d9bfbaef53d3fa479",22856528,1,-6,0,179,65,60,-5
"309ccf3cc4fe429d9bfbaef53d3fa479","b534b89233134e30a9b5645138bfa9ee",22856528,1,-23,0,180,60,41,-19
"d646286c8051419bbc2e31dd1db55ca8","267f883678b24aed855fde42524975d9",22856528,1,4,0,182,67,71,4
"267f883678b24aed855fde42524975d9","267f883678b24aed855fde42524975d9",22856528,1,0,1,183,71,71,0
"267f883678b24aed855fde42524975d9","88fff56d0342490dbef9040750a20f6c",22856528,1,1,0,184,71,72,1
"88fff56d0342490dbef9040750a20f6c","88fff56d0342490dbef9040750a20f6c",22856528,1,0,1,185,72,72,0
"88fff56d0342490dbef9040750a20f6c","adb17b12b66c4a49a85fd34322f7df70",22856528,1,1,0,186,72,73,1
"adb17b12b66c4a49a85fd34322f7df70","adb17b12b66c4a49a85fd34322f7df70",22856528,1,0,1,187,73,73,0
"adb17b12b66c4a49a85fd34322f7df70","d646286c8051419bbc2e31dd1db55ca8",22856528,1,-6,0,188,73,67,-6
"d646286c8051419bbc2e31dd1db55ca8","a2becd407db34b189200a32546d9d569",22856528,1,9,0,189,67,75,8
"a2becd407db34b189200a32546d9d569","a2becd407db34b189200a32546d9d569",22856528,1,0,1,190,75,75,0
"a2becd407db34b189200a32546d9d569","58c22b011d0f4c2ea6d13615edbb9eeb",22856528,1,2,0,191,75,77,2
"58c22b011d0f4c2ea6d13615edbb9eeb","58c22b011d0f4c2ea6d13615edbb9eeb",22856528,5,0,1,192,77,77,0
"58c22b011d0f4c2ea6d13615edbb9eeb","dd76e1861dc9461c830888729d091ee0",22856528,1,1,0,197,77,78,1
"dd76e1861dc9461c830888729d091ee0","dd76e1861dc9461c830888729d091ee0",22856528,5,0,1,198,78,78,0
"dd76e1861dc9461c830888729d091ee0","cd1d828f1a694b87913a7ea66c23803e",22856528,1,1,0,203,78,79,1
"cd1d828f1a694b87913a7ea66c23803e","cd1d828f1a694b87913a7ea66c23803e",22856528,2,0,1,204,79,79,0
"cd1d828f1a694b87913a7ea66c23803e","9176a3c2b4d2465fa8b0c67096c2a97e",22856528,1,1,0,206,79,80,1
"9176a3c2b4d2465fa8b0c67096c2a97e","9176a3c2b4d2465fa8b0c67096c2a97e",22856528,5,0,1,207,80,80,0
"9176a3c2b4d2465fa8b0c67096c2a97e","f8ec6445f7194e25b9101d4fbcb07a18",22856528,1,1,0,212,80,81,1
"f8ec6445f7194e25b9101d4fbcb07a18","f8ec6445f7194e25b9101d4fbcb07a18",22856528,2,0,1,213,81,81,0
"f8ec6445f7194e25b9101d4fbcb07a18","140d5b27b8574befad82c0a013b59dfa",22856528,1,-7,0,215,81,74,-7
"140d5b27b8574befad82c0a013b59dfa","d18a9ea32855445f8736581f5cb119ce",22856528,1,9,0,216,74,82,8
"d18a9ea32855445f8736581f5cb119ce","f564483cbd7a407681aa2fcca518cf5f",22856528,1,4,0,217,82,85,3
"f564483cbd7a407681aa2fcca518cf5f","f564483cbd7a407681aa2fcca518cf5f",22856528,4,0,1,218,85,85,0
"f564483cbd7a407681aa2fcca518cf5f","18fd01350bd5434ca636d59a599d768a",22856528,1,1,0,222,85,86,1
"18fd01350bd5434ca636d59a599d768a","18fd01350bd5434ca636d59a599d768a",22856528,9,0,1,223,86,86,0
"18fd01350bd5434ca636d59a599d768a","6a9f0ef185fb47f0937e29daa1c71ed5",22856528,1,5,0,232,86,90,4
"6a9f0ef185fb47f0937e29daa1c71ed5","ae5ac430ea254e708a6f5deaaf7464ae",22856528,1,-7,0,233,90,84,-6
"ae5ac430ea254e708a6f5deaaf7464ae","c681290961c94c4caf23b529d1ae6b9a",22856528,1,5,0,234,84,88,4
"c681290961c94c4caf23b529d1ae6b9a","c681290961c94c4caf23b529d1ae6b9a",22856528,1,0,1,235,88,88,0
"c681290961c94c4caf23b529d1ae6b9a","6a9f0ef185fb47f0937e29daa1c71ed5",22856528,1,2,0,236,88,90,2
"6a9f0ef185fb47f0937e29daa1c71ed5","6a9f0ef185fb47f0937e29daa1c71ed5",22856528,3,0,1,237,90,90,0
"6a9f0ef185fb47f0937e29daa1c71ed5","d646286c8051419bbc2e31dd1db55ca8",22856528,1,-27,0,240,90,67,-23
"d646286c8051419bbc2e31dd1db55ca8","e20db35ced8544ddac5bc3839145e463",22856528,1,30,0,241,67,91,24
"e20db35ced8544ddac5bc3839145e463","e20db35ced8544ddac5bc3839145e463",22856528,1,0,1,242,91,91,0
"e20db35ced8544ddac5bc3839145e463","1febb706d7a34005ae8711ed49c76e64",22856528,1,3,0,243,91,94,3
"1febb706d7a34005ae8711ed49c76e64","1febb706d7a34005ae8711ed49c76e64",22856528,2,0,1,244,94,94,0
"1febb706d7a34005ae8711ed49c76e64","8f73ba6f5a0042f2850356ac38ac6f24",22856528,1,1,0,246,94,95,1
"8f73ba6f5a0042f2850356ac38ac6f24","8f73ba6f5a0042f2850356ac38ac6f24",22856528,5,0,1,247,95,95,0
"8f73ba6f5a0042f2850356ac38ac6f24","e2260b86653c46d7b14a41fb419dbf8c",22856528,1,1,0,252,95,96,1
"e2260b86653c46d7b14a41fb419dbf8c","e2260b86653c46d7b14a41fb419dbf8c",22856528,2,0,1,253,96,96,0
"e2260b86653c46d7b14a41fb419dbf8c","35eb641ad1d845bbba54915bce75a962",22856528,1,1,0,255,96,97,1
"35eb641ad1d845bbba54915bce75a962","35eb641ad1d845bbba54915bce75a962",22856528,2,0,1,256,97,97,0
"35eb641ad1d845bbba54915bce75a962","08be90ffbeea4795a138cd42ed8db56f",22856528,1,1,0,258,97,98,1
"08be90ffbeea4795a138cd42ed8db56f","08be90ffbeea4795a138cd42ed8db56f",22856528,5,0,1,259,98,98,0
"08be90ffbeea4795a138cd42ed8db56f","3007433c8f584dcbb5ac159c1c5f2be3",22856528,1,1,0,264,98,99,1
"3007433c8f584dcbb5ac159c1c5f2be3","3007433c8f584dcbb5ac159c1c5f2be3",22856528,5,0,1,265,99,99,0
"3007433c8f584dcbb5ac159c1c5f2be3","08be90ffbeea4795a138cd42ed8db56f",22856528,1,-1,0,270,99,98,-1
"08be90ffbeea4795a138cd42ed8db56f","00ae5f0c51874a73a41ebea838d95682",22856528,1,4,0,271,98,101,3
"00ae5f0c51874a73a41ebea838d95682","e20db35ced8544ddac5bc3839145e463",22856528,1,-11,0,272,101,91,-10
"e20db35ced8544ddac5bc3839145e463","d391c8b6e56a43a7b654e9dee02d904b",22856528,1,13,0,273,91,103,12
"d391c8b6e56a43a7b654e9dee02d904b","d391c8b6e56a43a7b654e9dee02d904b",22856528,15,0,1,276,103,103,0
"d391c8b6e56a43a7b654e9dee02d904b","6111116566fc4fd9abba409322bea245",22856528,1,1,0,291,103,104,1
"6111116566fc4fd9abba409322bea245","6111116566fc4fd9abba409322bea245",22856528,2,0,1,292,104,104,0
"6111116566fc4fd9abba409322bea245","a81b2235cb9c499eb9ea8ee0a8dd9725",22856528,1,1,0,294,104,105,1
"a81b2235cb9c499eb9ea8ee0a8dd9725","a81b2235cb9c499eb9ea8ee0a8dd9725",22856528,2,0,1,295,105,105,0
"a81b2235cb9c499eb9ea8ee0a8dd9725","2d4e0ab0ef3b4d73b82c72d4621a7579",22856528,1,1,0,297,105,106,1
"2d4e0ab0ef3b4d73b82c72d4621a7579","2d4e0ab0ef3b4d73b82c72d4621a7579",22856528,2,0,1,298,106,106,0
"2d4e0ab0ef3b4d73b82c72d4621a7579","8bdebf492ebd4e62b0d522e8ab5e5197",22856528,1,1,0,300,106,107,1
"8bdebf492ebd4e62b0d522e8ab5e5197","8bdebf492ebd4e62b0d522e8ab5e5197",22856528,2,0,1,301,107,107,0
"8bdebf492ebd4e62b0d522e8ab5e5197","4280927ec4d643238aa49c32f9e06c6c",22856528,1,3,0,303,107,109,2
"73039f8c1eb9409cb4caee2cf968001e","4280927ec4d643238aa49c32f9e06c6c",22856528,1,10,0,305,100,109,9
"4280927ec4d643238aa49c32f9e06c6c","fc44e6a5f7654430af1227838224dceb",22856528,1,2,0,306,109,111,2
"fc44e6a5f7654430af1227838224dceb","fc44e6a5f7654430af1227838224dceb",22856528,2,0,1,307,111,111,0
"fc44e6a5f7654430af1227838224dceb","08111f75e22d409998cf8b85bd431f0a",22856528,1,-3,0,309,111,108,-3
"08111f75e22d409998cf8b85bd431f0a","a9ae0a3c070d455bb4369a8996313336",22856528,1,7,0,310,108,114,6
"a9ae0a3c070d455bb4369a8996313336","a9ae0a3c070d455bb4369a8996313336",22856528,2,0,1,311,114,114,0
"a9ae0a3c070d455bb4369a8996313336","71cec822bcff4f30a20e75dc63ef7b65",22856528,1,2,0,313,114,116,2
"71cec822bcff4f30a20e75dc63ef7b65","71cec822bcff4f30a20e75dc63ef7b65",22856528,1,0,1,314,116,116,0
"71cec822bcff4f30a20e75dc63ef7b65","37319e88176d4aefa91d7a9980dbae91",22856528,1,-4,0,315,116,112,-4
"b1cd0e7dc3ad4a8eb91a4bfdbeb025b0","779f9ddd1fd14d1e9e69f72219a1fdbd",22856528,1,5,0,320,118,121,3
"779f9ddd1fd14d1e9e69f72219a1fdbd","e20db35ced8544ddac5bc3839145e463",22856528,1,-36,0,321,121,91,-30
"e20db35ced8544ddac5bc3839145e463","ae26e6cda8ad4a3f81bd347560d9579f",22856528,1,40,0,322,91,125,34
"ae26e6cda8ad4a3f81bd347560d9579f","ae26e6cda8ad4a3f81bd347560d9579f",22856528,3,0,1,323,125,125,0
"ae26e6cda8ad4a3f81bd347560d9579f","ee48df95832b4374aa273ceb27ec1315",22856528,1,1,0,326,125,126,1
"ee48df95832b4374aa273ceb27ec1315","ee48df95832b4374aa273ceb27ec1315",22856528,1,0,1,327,126,126,0
"ee48df95832b4374aa273ceb27ec1315","7a439da90b394756ad1777fc4c6dead5",22856528,1,1,0,328,126,127,1
"7a439da90b394756ad1777fc4c6dead5","7a439da90b394756ad1777fc4c6dead5",22856528,1,0,1,329,127,127,0
"7a439da90b394756ad1777fc4c6dead5","779f9ddd1fd14d1e9e69f72219a1fdbd",22856528,1,-6,0,330,127,121,-6
"a8dd5213034441ac92724b4e83eb0bb2","a8dd5213034441ac92724b4e83eb0bb2",22856528,1,0,1,332,129,129,0
"a8dd5213034441ac92724b4e83eb0bb2","8115eab6556b45f5b415c3b8c26a12e5",22856528,1,2,0,333,129,131,2
"8115eab6556b45f5b415c3b8c26a12e5","8115eab6556b45f5b415c3b8c26a12e5",22856528,11,0,1,334,131,131,0
"8115eab6556b45f5b415c3b8c26a12e5","ec34b06efd844b46a4c4818ecdb9b8f4",22856528,1,1,0,345,131,132,1
"ec34b06efd844b46a4c4818ecdb9b8f4","ec34b06efd844b46a4c4818ecdb9b8f4",22856528,5,0,1,346,132,132,0
"ec34b06efd844b46a4c4818ecdb9b8f4","c2e1c2b9eac64109b343a088584b576b",22856528,1,1,0,351,132,133,1
"c2e1c2b9eac64109b343a088584b576b","c2e1c2b9eac64109b343a088584b576b",22856528,2,0,1,352,133,133,0
"c2e1c2b9eac64109b343a088584b576b","579338175e0b4bbb8ef3b712b5d8b54e",22856528,1,-5,0,354,133,128,-5
"579338175e0b4bbb8ef3b712b5d8b54e","8bc5795d6a984a3eace4e2811e52dd4f",22856528,1,8,0,355,128,135,7
"8bc5795d6a984a3eace4e2811e52dd4f","8bc5795d6a984a3eace4e2811e52dd4f",22856528,1,0,1,356,135,135,0
"8bc5795d6a984a3eace4e2811e52dd4f","b416d47c56a742199b5d7c7f19d6503a",22856528,1,-1,0,357,135,134,-1
"b416d47c56a742199b5d7c7f19d6503a","cd4532ad48034873ba8bce2aac0c9808",22856528,1,4,0,358,134,137,3
"cd4532ad48034873ba8bce2aac0c9808","cd4532ad48034873ba8bce2aac0c9808",22856528,1,0,1,359,137,137,0
"cd4532ad48034873ba8bce2aac0c9808","779f9ddd1fd14d1e9e69f72219a1fdbd",22856528,1,-19,0,360,137,121,-16
"6c5ad271a44743479bfaea29b1db8d02","6c5ad271a44743479bfaea29b1db8d02",22856528,1,0,1,363,143,143,0
"6c5ad271a44743479bfaea29b1db8d02","83d311bed5374fee83d8d67a7d9d82dc",22856528,1,1,0,364,143,144,1
"83d311bed5374fee83d8d67a7d9d82dc","83d311bed5374fee83d8d67a7d9d82dc",22856528,1,0,1,365,144,144,0
"83d311bed5374fee83d8d67a7d9d82dc","402bba41861d43acb52a5abb89e8831e",22856528,1,1,0,366,144,145,1
"402bba41861d43acb52a5abb89e8831e","402bba41861d43acb52a5abb89e8831e",22856528,2,0,1,367,145,145,0
"402bba41861d43acb52a5abb89e8831e","8aae34f5ddbb4052a709b12e6b0d40fa",22856528,1,3,0,369,145,147,2
"8aae34f5ddbb4052a709b12e6b0d40fa","df1de691dafe4549a18a4398ee9dfaf9",22856528,1,-9,0,370,147,139,-8
"8aae34f5ddbb4052a709b12e6b0d40fa","645b3f0249f64f76af2e19eb4d0e55b7",22856528,1,2,0,372,147,149,2
"645b3f0249f64f76af2e19eb4d0e55b7","645b3f0249f64f76af2e19eb4d0e55b7",22856528,2,0,1,373,149,149,0
"645b3f0249f64f76af2e19eb4d0e55b7","7e7b8db5064d4369805ab370aac5ddfb",22856528,1,1,0,375,149,150,1
"7e7b8db5064d4369805ab370aac5ddfb","7e7b8db5064d4369805ab370aac5ddfb",22856528,5,0,1,376,150,150,0
"7e7b8db5064d4369805ab370aac5ddfb","8956d210ae7f41968fada86d4c979d6a",22856528,1,1,0,381,150,151,1
"8956d210ae7f41968fada86d4c979d6a","8956d210ae7f41968fada86d4c979d6a",22856528,2,0,1,382,151,151,0
"8956d210ae7f41968fada86d4c979d6a","f902b0f41b544d4dbf79664fd233648d",22856528,1,-5,0,384,151,146,-5
"f902b0f41b544d4dbf79664fd233648d","ae781e8b775e4ccd93bc800dad5c8376",22856528,1,8,0,385,146,153,7
"ae781e8b775e4ccd93bc800dad5c8376","ae781e8b775e4ccd93bc800dad5c8376",22856528,2,0,1,386,153,153,0
"ae781e8b775e4ccd93bc800dad5c8376","06882a8492d9499aa31555567f575ecb",22856528,1,1,0,388,153,154,1
"06882a8492d9499aa31555567f575ecb","06882a8492d9499aa31555567f575ecb",22856528,1,0,1,389,154,154,0
"06882a8492d9499aa31555567f575ecb","f293c508f409466a8f27ddd7d1e40b20",22856528,1,1,0,390,154,155,1
"f293c508f409466a8f27ddd7d1e40b20","f293c508f409466a8f27ddd7d1e40b20",22856528,2,0,1,391,155,155,0
"f293c508f409466a8f27ddd7d1e40b20","cc4ddef5bbbe48ebb605141b347c4ed1",22856528,1,1,0,393,155,156,1
"cc4ddef5bbbe48ebb605141b347c4ed1","cc4ddef5bbbe48ebb605141b347c4ed1",22856528,1,0,1,394,156,156,0
"cc4ddef5bbbe48ebb605141b347c4ed1","f03480cf4eba413194d7af52fc0e7f28",22856528,1,-4,0,395,156,152,-4
"df1de691dafe4549a18a4398ee9dfaf9","f8c6e9dd315640039488619b16128971",22856528,1,28,0,403,139,162,23
"f8c6e9dd315640039488619b16128971","f8c6e9dd315640039488619b16128971",22856528,3,0,1,404,162,162,0
"f8c6e9dd315640039488619b16128971","78adeee1fa2c4fe0bc73f7bca9fcee86",22856528,3,-2,0,405,162,160,-2
"78adeee1fa2c4fe0bc73f7bca9fcee86","f8c6e9dd315640039488619b16128971",22856528,1,2,0,406,160,162,2
"78adeee1fa2c4fe0bc73f7bca9fcee86","b534b89233134e30a9b5645138bfa9ee",22856528,1,-148,0,409,160,41,-119
"b534b89233134e30a9b5645138bfa9ee","d9c8d8c444a64dadbbb508652c721e17",22856528,1,6,0,410,41,46,5
"d9c8d8c444a64dadbbb508652c721e17","6e13d61a7bdb44bca949c9f86fab3be5",22856528,1,1,0,411,46,47,1
"6e13d61a7bdb44bca949c9f86fab3be5","f8c6e9dd315640039488619b16128971",22856528,1,143,0,412,47,162,115
"65202579580f4ad38d734b4ee39d22a8","3cbcea2be0984e7dbd5a48195af10ce7",22856528,1,3,0,424,164,165,1
"3cbcea2be0984e7dbd5a48195af10ce7","78adeee1fa2c4fe0bc73f7bca9fcee86",22856528,1,-8,0,425,165,160,-5
"78adeee1fa2c4fe0bc73f7bca9fcee86","82e6285962b8400d9d6fc32436022a94",22856528,1,10,0,426,160,167,7
"82e6285962b8400d9d6fc32436022a94","3cbcea2be0984e7dbd5a48195af10ce7",22856528,1,-2,0,427,167,165,-2
"3cbcea2be0984e7dbd5a48195af10ce7","a9ac840f098c4bd0a2ee896214ce29cd",22856528,2,5,0,428,165,168,3
"a9ac840f098c4bd0a2ee896214ce29cd","3cbcea2be0984e7dbd5a48195af10ce7",22856528,1,-5,0,429,168,165,-3
"a9ac840f098c4bd0a2ee896214ce29cd","0c7262dff33c4087bc660ccf40f92f9c",22856528,1,4,0,431,168,169,1
"0c7262dff33c4087bc660ccf40f92f9c","a9ac840f098c4bd0a2ee896214ce29cd",22856528,1,-4,0,432,169,168,-1
"a9ac840f098c4bd0a2ee896214ce29cd","b2275c3fad834f8d90737a2d9a6927d6",22856528,1,7,0,433,168,172,4
"b2275c3fad834f8d90737a2d9a6927d6","0c7262dff33c4087bc660ccf40f92f9c",22856528,2,-3,0,434,172,169,-3
"0c7262dff33c4087bc660ccf40f92f9c","b2275c3fad834f8d90737a2d9a6927d6",22856528,2,3,0,435,169,172,3
"b2275c3fad834f8d90737a2d9a6927d6","b2275c3fad834f8d90737a2d9a6927d6",22856528,20,0,1,438,172,172,0
"b2275c3fad834f8d90737a2d9a6927d6","eb515a26030b41f8a82a1e6114420bad",22856528,1,1,0,458,172,173,1
"eb515a26030b41f8a82a1e6114420bad","eb515a26030b41f8a82a1e6114420bad",22856528,2,0,1,459,173,173,0
"eb515a26030b41f8a82a1e6114420bad","b42cc17b7de840f181a704558d0bc845",22856528,1,3,0,461,173,175,2
"b42cc17b7de840f181a704558d0bc845","0c7262dff33c4087bc660ccf40f92f9c",22856528,1,-7,0,462,175,169,-6
"0c7262dff33c4087bc660ccf40f92f9c","b42cc17b7de840f181a704558d0bc845",22856528,1,7,0,463,169,175,6
"b42cc17b7de840f181a704558d0bc845","b42cc17b7de840f181a704558d0bc845",22856528,1,0,1,464,175,175,0
"b42cc17b7de840f181a704558d0bc845","801f9e9135034f49bf5f8b4bdefedb41",22856528,1,2,0,465,175,177,2
"801f9e9135034f49bf5f8b4bdefedb41","801f9e9135034f49bf5f8b4bdefedb41",22856528,7,0,1,466,177,177,0
"801f9e9135034f49bf5f8b4bdefedb41","ea38cc0e6e6e41edbabf210220808bf9",22856528,1,3,0,473,177,179,2
"ea38cc0e6e6e41edbabf210220808bf9","362fcb0699a14845ab29b2340093e528",22856528,1,-6,0,474,179,174,-5
"362fcb0699a14845ab29b2340093e528","b87c552dd247427abe6ab5795b9c9d43",22856528,1,8,0,475,174,181,7
"b87c552dd247427abe6ab5795b9c9d43","ea38cc0e6e6e41edbabf210220808bf9",22856528,1,-2,0,476,181,179,-2
"ea38cc0e6e6e41edbabf210220808bf9","b87c552dd247427abe6ab5795b9c9d43",22856528,1,2,0,477,179,181,2
"b87c552dd247427abe6ab5795b9c9d43","b87c552dd247427abe6ab5795b9c9d43",22856528,7,0,1,478,181,181,0
"b87c552dd247427abe6ab5795b9c9d43","139b097acfca451689d80c9c6eebdf7b",22856528,1,-3,0,485,181,178,-3
"139b097acfca451689d80c9c6eebdf7b","30f660a1feb34582a739722532524f79",22856528,1,6,0,486,178,183,5
"30f660a1feb34582a739722532524f79","30f660a1feb34582a739722532524f79",22856528,5,0,1,487,183,183,0
"30f660a1feb34582a739722532524f79","2024b4885bd14338a39b7b509acbbd02",22856528,1,-1,0,492,183,182,-1
"2024b4885bd14338a39b7b509acbbd02","c3f63fe50d8e487c86bf8ef76c9cadd3",22856528,1,4,0,493,182,185,3
"c3f63fe50d8e487c86bf8ef76c9cadd3","c3f63fe50d8e487c86bf8ef76c9cadd3",22856528,1,0,1,494,185,185,0
"c3f63fe50d8e487c86bf8ef76c9cadd3","c8e371568a0c4391b25796ae4e91952e",22856528,1,3,0,495,185,186,1
"c8e371568a0c4391b25796ae4e91952e","0c7262dff33c4087bc660ccf40f92f9c",22856528,1,-23,0,496,186,169,-17
"0c7262dff33c4087bc660ccf40f92f9c","7d932b23e1c84326ae5aa4d3c0d813d1",22856528,1,25,0,497,169,188,19
"7d932b23e1c84326ae5aa4d3c0d813d1","7d932b23e1c84326ae5aa4d3c0d813d1",22856528,1,0,1,498,188,188,0
"7d932b23e1c84326ae5aa4d3c0d813d1","c8e371568a0c4391b25796ae4e91952e",22856528,1,-2,0,499,188,186,-2
"c8e371568a0c4391b25796ae4e91952e","ab11d94c6c8948ea90b88f19d2cd502b",22856528,2,5,0,500,186,190,4
"ab11d94c6c8948ea90b88f19d2cd502b","ab11d94c6c8948ea90b88f19d2cd502b",22856528,5,0,1,501,190,190,0
"ab11d94c6c8948ea90b88f19d2cd502b","c8e371568a0c4391b25796ae4e91952e",22856528,1,-5,0,505,190,186,-4
"ab11d94c6c8948ea90b88f19d2cd502b","f992451ed6ad4e68bb9e68ad6be7c4be",22856528,1,2,0,508,190,192,2
"f992451ed6ad4e68bb9e68ad6be7c4be","f992451ed6ad4e68bb9e68ad6be7c4be",22856528,1,0,1,509,192,192,0
"f992451ed6ad4e68bb9e68ad6be7c4be","07b44a7a51e94c78b411c753fc39dab0",22856528,1,-3,0,510,192,189,-3
"07b44a7a51e94c78b411c753fc39dab0","6cd2dcaac46847d4a0bc53f296d90375",22856528,1,6,0,511,189,194,5
"6cd2dcaac46847d4a0bc53f296d90375","6cd2dcaac46847d4a0bc53f296d90375",22856528,1,0,1,512,194,194,0
"6cd2dcaac46847d4a0bc53f296d90375","2d2580c9411c4972909db508d6956a58",22856528,1,2,0,513,194,196,2
"2d2580c9411c4972909db508d6956a58","2d2580c9411c4972909db508d6956a58",22856528,2,0,1,514,196,196,0
"2d2580c9411c4972909db508d6956a58","5bddb3d9ed264f3984702f048c7e5340",22856528,1,1,0,516,196,197,1
"5bddb3d9ed264f3984702f048c7e5340","5bddb3d9ed264f3984702f048c7e5340",22856528,2,0,1,517,197,197,0
"5bddb3d9ed264f3984702f048c7e5340","d5e8e2bd12a2466b9d6d90855f0eb079",22856528,1,1,0,519,197,198,1
"d5e8e2bd12a2466b9d6d90855f0eb079","d5e8e2bd12a2466b9d6d90855f0eb079",22856528,2,0,1,520,198,198,0
"d5e8e2bd12a2466b9d6d90855f0eb079","017d7ca8e0394b91aaadc9574df2202c",22856528,1,-5,0,522,198,193,-5
"017d7ca8e0394b91aaadc9574df2202c","54e8e9f0ea3e45c4bf3b8ac799ee31b1",22856528,1,8,0,523,193,200,7
"54e8e9f0ea3e45c4bf3b8ac799ee31b1","54e8e9f0ea3e45c4bf3b8ac799ee31b1",22856528,1,0,1,524,200,200,0
"54e8e9f0ea3e45c4bf3b8ac799ee31b1","c614a00911be4877a075f19315530fb0",22856528,1,1,0,525,200,201,1
"c614a00911be4877a075f19315530fb0","c614a00911be4877a075f19315530fb0",22856528,6,0,1,526,201,201,0
"c614a00911be4877a075f19315530fb0","a6c21bd8b95249c7972820a7a7d76aff",22856528,1,1,0,532,201,202,1
"a6c21bd8b95249c7972820a7a7d76aff","a6c21bd8b95249c7972820a7a7d76aff",22856528,1,0,1,533,202,202,0
"a6c21bd8b95249c7972820a7a7d76aff","bb329d880ab54120adaf203a693bb203",22856528,1,1,0,534,202,203,1
"bb329d880ab54120adaf203a693bb203","bb329d880ab54120adaf203a693bb203",22856528,1,0,1,535,203,203,0
"bb329d880ab54120adaf203a693bb203","f9170dd6bc6442b4acd832747609b09a",22856528,1,-4,0,536,203,199,-4
"f9170dd6bc6442b4acd832747609b09a","334c2344009840079b1d0e1b7ce3d5a7",22856528,1,7,0,537,199,205,6
"334c2344009840079b1d0e1b7ce3d5a7","334c2344009840079b1d0e1b7ce3d5a7",22856528,1,0,1,538,205,205,0
"334c2344009840079b1d0e1b7ce3d5a7","c8e371568a0c4391b25796ae4e91952e",22856528,1,-23,0,539,205,186,-19
"c8e371568a0c4391b25796ae4e91952e","d7f13c8d63ec4e2aa673fbb9cf9c6933",22856528,1,26,0,540,186,206,20
"d7f13c8d63ec4e2aa673fbb9cf9c6933","b9e80f77c3a44349863b19875725c384",22856528,1,1,0,541,206,207,1
"b9e80f77c3a44349863b19875725c384","7108f0e4c2584f1f9c471689ae4c885c",22856528,2,1,0,542,207,208,1
"7108f0e4c2584f1f9c471689ae4c885c","b9e80f77c3a44349863b19875725c384",22856528,1,-1,0,543,208,207,-1
"b9e80f77c3a44349863b19875725c384","b9e80f77c3a44349863b19875725c384",22856528,13,0,1,544,207,207,0
"7108f0e4c2584f1f9c471689ae4c885c","7108f0e4c2584f1f9c471689ae4c885c",22856528,17,0,1,558,208,208,0
"7108f0e4c2584f1f9c471689ae4c885c","d7f13c8d63ec4e2aa673fbb9cf9c6933",22856528,1,-2,0,575,208,206,-2
"d7f13c8d63ec4e2aa673fbb9cf9c6933","09400e101c5d4b439cf9a26b03aae558",22856528,1,5,0,576,206,210,4
"09400e101c5d4b439cf9a26b03aae558","09400e101c5d4b439cf9a26b03aae558",22856528,1,0,1,577,210,210,0
"09400e101c5d4b439cf9a26b03aae558","a88efa7e50ce47159810ab553afa6d3a",22856528,1,2,0,578,210,212,2
"a88efa7e50ce47159810ab553afa6d3a","a88efa7e50ce47159810ab553afa6d3a",22856528,5,0,1,579,212,212,0
"a88efa7e50ce47159810ab553afa6d3a","a875096404ef4a9984b62d74cda916f9",22856528,1,-3,0,584,212,209,-3
"a875096404ef4a9984b62d74cda916f9","f7fb1952f56b4189b86a9f8b7862d2b8",22856528,1,7,0,585,209,215,6
"f7fb1952f56b4189b86a9f8b7862d2b8","be502a7a43c44bf7b682698de79d9369",22856528,2,-1,0,586,215,214,-1
"be502a7a43c44bf7b682698de79d9369","be502a7a43c44bf7b682698de79d9369",22856528,1,0,1,587,214,214,0
"be502a7a43c44bf7b682698de79d9369","ec341f459285443b8361f7f15638ff08",22856528,1,-1,0,588,214,213,-1
"ec341f459285443b8361f7f15638ff08","363837c182e04711840d896ae1e0339c",22856528,2,6,0,589,213,218,5
"363837c182e04711840d896ae1e0339c","01b2051f8941460d89945e3b02d1ce78",22856528,2,-1,0,590,218,217,-1
"01b2051f8941460d89945e3b02d1ce78","be502a7a43c44bf7b682698de79d9369",22856528,1,-4,0,591,217,214,-3
"be502a7a43c44bf7b682698de79d9369","f7fb1952f56b4189b86a9f8b7862d2b8",22856528,2,1,0,592,214,215,1
"f7fb1952f56b4189b86a9f8b7862d2b8","f7fb1952f56b4189b86a9f8b7862d2b8",22856528,13,0,1,595,215,215,0
"f7fb1952f56b4189b86a9f8b7862d2b8","b860ee85d8bc4a2f97958cfb71be3533",22856528,1,1,0,608,215,216,1
"b860ee85d8bc4a2f97958cfb71be3533","b860ee85d8bc4a2f97958cfb71be3533",22856528,2,0,1,609,216,216,0
"b860ee85d8bc4a2f97958cfb71be3533","ec341f459285443b8361f7f15638ff08",22856528,1,-3,0,611,216,213,-3
"363837c182e04711840d896ae1e0339c","363837c182e04711840d896ae1e0339c",22856528,12,0,1,613,218,218,0
"01b2051f8941460d89945e3b02d1ce78","91125ca626c5470eb145501f8c37f8db",22856528,1,4,0,626,217,220,3
"91125ca626c5470eb145501f8c37f8db","91125ca626c5470eb145501f8c37f8db",22856528,1,0,1,627,220,220,0
"91125ca626c5470eb145501f8c37f8db","d7f13c8d63ec4e2aa673fbb9cf9c6933",22856528,1,-18,0,628,220,206,-14
"d7f13c8d63ec4e2aa673fbb9cf9c6933","1c6721b1f63f4d30ba7746ea8af02a52",22856528,1,21,0,629,206,221,15
"1c6721b1f63f4d30ba7746ea8af02a52","77ecef8eff6b4a2caea7707669bf7475",22856528,1,1,0,630,221,222,1
"77ecef8eff6b4a2caea7707669bf7475","77ecef8eff6b4a2caea7707669bf7475",22856528,12,0,1,631,222,222,0
"77ecef8eff6b4a2caea7707669bf7475","1c6721b1f63f4d30ba7746ea8af02a52",22856528,1,-1,0,643,222,221,-1
"1c6721b1f63f4d30ba7746ea8af02a52","d03cb855c70044cf8c35d9ec0de696e3",22856528,1,4,0,644,221,224,3
"d03cb855c70044cf8c35d9ec0de696e3","8b9ae98743bd4d4a8a87dff1c1244211",22856528,1,3,0,645,224,227,3
"8b9ae98743bd4d4a8a87dff1c1244211","d03cb855c70044cf8c35d9ec0de696e3",22856528,1,-3,0,646,227,224,-3
"d03cb855c70044cf8c35d9ec0de696e3","a49a937d6896486d9a5396654abcf2e1",22856528,1,2,0,647,224,226,2
"a49a937d6896486d9a5396654abcf2e1","a49a937d6896486d9a5396654abcf2e1",22856528,1,0,1,648,226,226,0
"a49a937d6896486d9a5396654abcf2e1","8b9ae98743bd4d4a8a87dff1c1244211",22856528,1,1,0,649,226,227,1
"8b9ae98743bd4d4a8a87dff1c1244211","8b9ae98743bd4d4a8a87dff1c1244211",22856528,19,0,1,650,227,227,0
"8b9ae98743bd4d4a8a87dff1c1244211","2ab1535aac1346ba8801535bf729ef37",22856528,1,3,0,669,227,229,2
"2ab1535aac1346ba8801535bf729ef37","f7906d6f59b9489a91d2ef40db5a474d",22856528,1,-7,0,670,229,223,-6
"f7906d6f59b9489a91d2ef40db5a474d","a4f40fb48a8542c8949bae1f002cd9bc",22856528,1,9,0,671,223,231,8
"a4f40fb48a8542c8949bae1f002cd9bc","a4f40fb48a8542c8949bae1f002cd9bc",22856528,2,0,1,672,231,231,0
"a4f40fb48a8542c8949bae1f002cd9bc","8972c23e32044edb8a78fa1eed4e5947",22856528,1,1,0,674,231,232,1
"8972c23e32044edb8a78fa1eed4e5947","8972c23e32044edb8a78fa1eed4e5947",22856528,1,0,1,675,232,232,0
"8972c23e32044edb8a78fa1eed4e5947","92feb4a40f8344d38b6f722e42a53295",22856528,1,1,0,676,232,233,1
"92feb4a40f8344d38b6f722e42a53295","92feb4a40f8344d38b6f722e42a53295",22856528,2,0,1,677,233,233,0
"92feb4a40f8344d38b6f722e42a53295","5152833676bf4c6cb317060be10f68db",22856528,1,-5,0,679,233,228,-5
"5152833676bf4c6cb317060be10f68db","ca3e28f290354c08aefe5b0f769604e6",22856528,1,8,0,680,228,235,7
"ca3e28f290354c08aefe5b0f769604e6","ca3e28f290354c08aefe5b0f769604e6",22856528,4,0,1,681,235,235,0
"ca3e28f290354c08aefe5b0f769604e6","79a35eea833e4c2c9d22fc53c3c6445c",22856528,1,1,0,685,235,236,1
"79a35eea833e4c2c9d22fc53c3c6445c","79a35eea833e4c2c9d22fc53c3c6445c",22856528,4,0,1,686,236,236,0
"79a35eea833e4c2c9d22fc53c3c6445c","8f68228b1518449e9615cdafee41a2bd",22856528,1,1,0,690,236,237,1
"8f68228b1518449e9615cdafee41a2bd","8f68228b1518449e9615cdafee41a2bd",22856528,7,0,1,691,237,237,0
"8f68228b1518449e9615cdafee41a2bd","cab89fa5c3ed45a5aa550fc0352d6a42",22856528,1,1,0,698,237,238,1
"cab89fa5c3ed45a5aa550fc0352d6a42","cab89fa5c3ed45a5aa550fc0352d6a42",22856528,3,0,1,699,238,238,0
"cab89fa5c3ed45a5aa550fc0352d6a42","0b04c8e2f86d48c7aeb7e225819cd32b",22856528,1,-4,0,702,238,234,-4
"0b04c8e2f86d48c7aeb7e225819cd32b","f53da5fd9bfe412da4b80d4742563b6c",22856528,1,8,0,703,234,241,7
"1ebf23f9d994469a85206e4c7b1bf5f5","1ebf23f9d994469a85206e4c7b1bf5f5",22856528,11,0,1,710,245,245,0
"1ebf23f9d994469a85206e4c7b1bf5f5","85ae675b83e8422da842cfd25596af99",22856528,1,1,0,721,245,246,1
"85ae675b83e8422da842cfd25596af99","85ae675b83e8422da842cfd25596af99",22856528,1,0,1,722,246,246,0
"85ae675b83e8422da842cfd25596af99","fa235f0f364d47e4ae1c87f47bf8e6ba",22856528,1,8,0,723,246,252,6
"fa235f0f364d47e4ae1c87f47bf8e6ba","2ae94c0cea4d480a9d5dca8fb1d7b542",22856528,1,-12,0,724,252,242,-10
"2ae94c0cea4d480a9d5dca8fb1d7b542","fa235f0f364d47e4ae1c87f47bf8e6ba",22856528,1,12,0,725,242,252,10
"fa235f0f364d47e4ae1c87f47bf8e6ba","79f7845465cc4ed19d8e4f1429541be0",22856528,1,2,0,726,252,254,2
"79f7845465cc4ed19d8e4f1429541be0","79f7845465cc4ed19d8e4f1429541be0",22856528,2,0,1,727,254,254,0
"79f7845465cc4ed19d8e4f1429541be0","6e83e23f56544a19b94067c1c558d9c0",22856528,1,-8,0,729,254,247,-7
"6e83e23f56544a19b94067c1c558d9c0","00f61990949545828dd12f1303d47504",22856528,1,11,0,730,247,256,9
"00f61990949545828dd12f1303d47504","ead7bb4b64e247d2ae632ab8a296b091",22856528,1,2,0,731,256,258,2
"ead7bb4b64e247d2ae632ab8a296b091","ead7bb4b64e247d2ae632ab8a296b091",22856528,2,0,1,732,258,258,0
"ead7bb4b64e247d2ae632ab8a296b091","41b0048dde734bb280bac6116baa8e27",22856528,1,1,0,734,258,259,1
"41b0048dde734bb280bac6116baa8e27","41b0048dde734bb280bac6116baa8e27",22856528,2,0,1,735,259,259,0
"41b0048dde734bb280bac6116baa8e27","b41c5a094a604ee0915327da5cc0beb7",22856528,1,1,0,737,259,260,1
"b41c5a094a604ee0915327da5cc0beb7","b41c5a094a604ee0915327da5cc0beb7",22856528,2,0,1,738,260,260,0
"b41c5a094a604ee0915327da5cc0beb7","d546341988904f069cfa86b21457d9d9",22856528,1,-10,0,740,260,251,-9
"d546341988904f069cfa86b21457d9d9","28c171777c52431ab6b925073bd63d46",22856528,1,15,0,741,251,264,13
"28c171777c52431ab6b925073bd63d46","28c171777c52431ab6b925073bd63d46",22856528,7,0,1,742,264,264,0
"28c171777c52431ab6b925073bd63d46","ac160db940cb49ae8579162b1d52bb5d",22856528,1,2,0,749,264,266,2
"ac160db940cb49ae8579162b1d52bb5d","ac160db940cb49ae8579162b1d52bb5d",22856528,3,0,1,750,266,266,0
"ac160db940cb49ae8579162b1d52bb5d","d989ebcfc12a4b669f0100dc1aa14f1e",22856528,1,-12,0,753,266,255,-11
"d989ebcfc12a4b669f0100dc1aa14f1e","c6fd49b485cc4874b0bbdd9c6171e09c",22856528,1,15,0,754,255,268,13
"c6fd49b485cc4874b0bbdd9c6171e09c","c6fd49b485cc4874b0bbdd9c6171e09c",22856528,3,0,1,755,268,268,0
"c6fd49b485cc4874b0bbdd9c6171e09c","44240778a97c4af0937817499b75707b",22856528,1,1,0,758,268,269,1
"44240778a97c4af0937817499b75707b","44240778a97c4af0937817499b75707b",22856528,2,0,1,759,269,269,0
"44240778a97c4af0937817499b75707b","7aa76d3e993840d8805f097cbdbcd44b",22856528,1,-9,0,761,269,261,-8
"7aa76d3e993840d8805f097cbdbcd44b","865a4d3b43374da7944dc7d397f566d9",22856528,1,12,0,762,261,271,10
"865a4d3b43374da7944dc7d397f566d9","865a4d3b43374da7944dc7d397f566d9",22856528,3,0,1,763,271,271,0
"865a4d3b43374da7944dc7d397f566d9","2ae94c0cea4d480a9d5dca8fb1d7b542",22856528,1,-35,0,766,271,242,-29
"2ae94c0cea4d480a9d5dca8fb1d7b542","0d987bed3ffa4ed0b9a2e62e97b7b30f",22856528,1,38,0,767,242,272,30
"0d987bed3ffa4ed0b9a2e62e97b7b30f","82ae07bc0c9b4570a41799290d1ef399",22856528,2,4,0,769,272,275,3
"82ae07bc0c9b4570a41799290d1ef399","0d987bed3ffa4ed0b9a2e62e97b7b30f",22856528,2,-4,0,770,275,272,-3
"bb5a47f5ea01454a8b79455422d3b9da","bc5524e78a8544e2ae2fdc2f3462bbec",22856528,2,-1,0,780,280,279,-1
"bc5524e78a8544e2ae2fdc2f3462bbec","82ae07bc0c9b4570a41799290d1ef399",22856528,1,-5,0,781,279,275,-4
"bc5524e78a8544e2ae2fdc2f3462bbec","bb5a47f5ea01454a8b79455422d3b9da",22856528,1,1,0,815,279,280,1
"bb5a47f5ea01454a8b79455422d3b9da","94cecc3f1e7d484b8e068e79241dfd73",22856528,1,3,0,859,280,281,1
"94cecc3f1e7d484b8e068e79241dfd73","0d987bed3ffa4ed0b9a2e62e97b7b30f",22856528,1,-13,0,860,281,272,-9
"0d987bed3ffa4ed0b9a2e62e97b7b30f","a37477c4e4c14169ad44b06b493007f6",22856528,1,15,0,861,272,283,11
"a37477c4e4c14169ad44b06b493007f6","94cecc3f1e7d484b8e068e79241dfd73",22856528,1,-2,0,862,283,281,-2
"94cecc3f1e7d484b8e068e79241dfd73","fab84b4fab5940efb4ea868ef8d09396",22856528,1,5,0,863,281,284,3
"fab84b4fab5940efb4ea868ef8d09396","fab84b4fab5940efb4ea868ef8d09396",22856528,1,0,1,864,284,284,0
"fab84b4fab5940efb4ea868ef8d09396","4a29443515bb404cb8924e1c60a63b73",22856528,1,4,0,865,284,285,1
"4a29443515bb404cb8924e1c60a63b73","208c9b2796c944db8dacaa96082520ea",22856528,4,3,0,866,285,288,3
"208c9b2796c944db8dacaa96082520ea","4a29443515bb404cb8924e1c60a63b73",22856528,4,-3,0,867,288,285,-3
"208c9b2796c944db8dacaa96082520ea","eb2a0eb537344a9e891c761662e400b6",22856528,1,-378,0,869,288,16,-272
"eb2a0eb537344a9e891c761662e400b6","56586aa865414f538729c7f7735d2bc6",22856528,2,-8,0,870,16,12,-4
"56586aa865414f538729c7f7735d2bc6","5c5ceeee4562457ba6d41515aeebfbb1",22856528,2,10,0,871,12,17,5
"9afd71a5298d4333b6849dfce1b9422c","eb2a0eb537344a9e891c761662e400b6",22856528,1,-5,0,874,18,16,-2
"5c5ceeee4562457ba6d41515aeebfbb1","eb2a0eb537344a9e891c761662e400b6",22856528,1,-2,0,877,17,16,-1
"eb2a0eb537344a9e891c761662e400b6","3f1c815879794b929260d224becaff7e",22856528,1,-4,0,878,16,14,-2
"3f1c815879794b929260d224becaff7e","4a29443515bb404cb8924e1c60a63b73",22856528,1,379,0,879,14,285,271
"4a29443515bb404cb8924e1c60a63b73","a44e39b057914e0fb4fa95d0fd6b8060",22856528,1,2,0,880,285,287,2
"a44e39b057914e0fb4fa95d0fd6b8060","208c9b2796c944db8dacaa96082520ea",22856528,1,1,0,881,287,288,1
"208c9b2796c944db8dacaa96082520ea","208c9b2796c944db8dacaa96082520ea",22856528,1,0,1,884,288,288,0
"4a29443515bb404cb8924e1c60a63b73","7669a956527947d0add87455277e80b4",22856528,1,7,0,886,285,291,6
"7669a956527947d0add87455277e80b4","7669a956527947d0add87455277e80b4",22856528,1,0,1,887,291,291,0
"7669a956527947d0add87455277e80b4","6a9a3b5bde4a48daa896fe8c06eca56f",22856528,1,-2,0,888,291,289,-2
"6a9a3b5bde4a48daa896fe8c06eca56f","869e967078f04da18dd0b0b9389a7424",22856528,1,5,0,889,289,293,4
"869e967078f04da18dd0b0b9389a7424","869e967078f04da18dd0b0b9389a7424",22856528,1,0,1,890,293,293,0
"869e967078f04da18dd0b0b9389a7424","51ab6291537748fab90d519aa09889d6",22856528,1,2,0,891,293,295,2
"51ab6291537748fab90d519aa09889d6","51ab6291537748fab90d519aa09889d6",22856528,5,0,1,892,295,295,0
"51ab6291537748fab90d519aa09889d6","34a6e49023fc4465bd5ca604330bbd1c",22856528,1,-3,0,897,295,292,-3
"34a6e49023fc4465bd5ca604330bbd1c","ba0e59461bfb4a44b7b1c28a01f8d3b3",22856528,1,9,0,898,292,299,7
"ba0e59461bfb4a44b7b1c28a01f8d3b3","21592f2a9e9c4b2f8c66ec5dbcbf6a2b",22856528,1,-4,0,899,299,296,-3
"21592f2a9e9c4b2f8c66ec5dbcbf6a2b","ba0e59461bfb4a44b7b1c28a01f8d3b3",22856528,1,4,0,900,296,299,3
"ba0e59461bfb4a44b7b1c28a01f8d3b3","0e0b36e731a645e7b1b8a88f5031ca38",22856528,1,2,0,901,299,301,2
"0e0b36e731a645e7b1b8a88f5031ca38","0e0b36e731a645e7b1b8a88f5031ca38",22856528,5,0,1,902,301,301,0
"0e0b36e731a645e7b1b8a88f5031ca38","a66a144637284c21afc6de17fea4bfb8",22856528,1,1,0,907,301,302,1
"a66a144637284c21afc6de17fea4bfb8","a66a144637284c21afc6de17fea4bfb8",22856528,2,0,1,908,302,302,0
"a66a144637284c21afc6de17fea4bfb8","7646a919d7e64fa990bca9b024ff089d",22856528,1,-4,0,910,302,298,-4
"7646a919d7e64fa990bca9b024ff089d","4a29443515bb404cb8924e1c60a63b73",22856528,1,-17,0,911,298,285,-13
"4a29443515bb404cb8924e1c60a63b73","e390b575229748ea8aac9364efe2bf00",22856528,1,24,0,914,285,304,19
"e390b575229748ea8aac9364efe2bf00","e390b575229748ea8aac9364efe2bf00",22856528,1,0,1,915,304,304,0
"e390b575229748ea8aac9364efe2bf00","3434c10e561d488a914e0f7d71907abd",22856528,1,3,0,916,304,305,1
"3434c10e561d488a914e0f7d71907abd","4a29443515bb404cb8924e1c60a63b73",22856528,1,-27,0,917,305,285,-20
"4a29443515bb404cb8924e1c60a63b73","53e7e900392747ccad52e711ab0f80d8",22856528,1,29,0,918,285,307,22
"53e7e900392747ccad52e711ab0f80d8","53e7e900392747ccad52e711ab0f80d8",22856528,1,0,1,919,307,307,0
"53e7e900392747ccad52e711ab0f80d8","3434c10e561d488a914e0f7d71907abd",22856528,2,-2,0,920,307,305,-2
"3434c10e561d488a914e0f7d71907abd","130acc2aeb0448fdbb2de63bc5cebe5b",22856528,1,5,0,921,305,309,4
"130acc2aeb0448fdbb2de63bc5cebe5b","130acc2aeb0448fdbb2de63bc5cebe5b",22856528,2,0,1,922,309,309,0
"130acc2aeb0448fdbb2de63bc5cebe5b","9c062b3251034ebe90f5054e2a3b5120",22856528,1,2,0,924,309,311,2
"9c062b3251034ebe90f5054e2a3b5120","9c062b3251034ebe90f5054e2a3b5120",22856528,2,0,1,925,311,311,0
"9c062b3251034ebe90f5054e2a3b5120","ea859f8207e44537889daeaba13ac2e8",22856528,1,1,0,927,311,312,1
"ea859f8207e44537889daeaba13ac2e8","ea859f8207e44537889daeaba13ac2e8",22856528,1,0,1,928,312,312,0
"ea859f8207e44537889daeaba13ac2e8","56d94971a7a94257aa330183a8ebd0ea",22856528,1,1,0,929,312,313,1
"56d94971a7a94257aa330183a8ebd0ea","56d94971a7a94257aa330183a8ebd0ea",22856528,1,0,1,930,313,313,0
"56d94971a7a94257aa330183a8ebd0ea","141c0df6cd1946539aadd1c9b7068cd4",22856528,1,-5,0,931,313,308,-5
"141c0df6cd1946539aadd1c9b7068cd4","13255e63e0aa4abf85e5211bf613d43e",22856528,1,10,0,932,308,317,9
"13255e63e0aa4abf85e5211bf613d43e","13255e63e0aa4abf85e5211bf613d43e",22856528,1,0,1,933,317,317,0
"13255e63e0aa4abf85e5211bf613d43e","0c787d16c9504873b1a4d903cec09948",22856528,1,-3,0,934,317,314,-3
"0c787d16c9504873b1a4d903cec09948","86c27d40179e419c8e9d150fb6afa5d0",22856528,1,6,0,935,314,319,5
"47edbb64109243e6b0f8f64cdef90c6c","86c27d40179e419c8e9d150fb6afa5d0",22856528,1,-8,0,939,326,319,-7
"86c27d40179e419c8e9d150fb6afa5d0","3628bdce1dd2429ba924d2d4d09448d2",22856528,1,4,0,940,319,322,3
"3628bdce1dd2429ba924d2d4d09448d2","3434c10e561d488a914e0f7d71907abd",22856528,1,-21,0,941,322,305,-17
"3434c10e561d488a914e0f7d71907abd","53e7e900392747ccad52e711ab0f80d8",22856528,1,2,0,942,305,307,2
"86c27d40179e419c8e9d150fb6afa5d0","24f1363179ad4aaa965484a78471912b",22856528,1,5,0,945,319,323,4
"47edbb64109243e6b0f8f64cdef90c6c","8d7e0b55cf9849cda222a0f2440cec55",22856528,1,-9,0,947,326,318,-8
"8d7e0b55cf9849cda222a0f2440cec55","3628bdce1dd2429ba924d2d4d09448d2",22856528,1,5,0,948,318,322,4
"3628bdce1dd2429ba924d2d4d09448d2","56b3fd1a212a4764be39d979fde3326e",22856528,1,7,0,949,322,328,6
"56b3fd1a212a4764be39d979fde3326e","56b3fd1a212a4764be39d979fde3326e",22856528,1,0,1,950,328,328,0
"56b3fd1a212a4764be39d979fde3326e","3434c10e561d488a914e0f7d71907abd",22856528,1,-28,0,951,328,305,-23
"3434c10e561d488a914e0f7d71907abd","0c4079457ede49e3aeb5e86ed84bdf35",22856528,1,31,0,952,305,329,24
"38aea304b4fa46e1b29bb72f5cea4c93","e36d261332f14e79bb4b467aceaeb9b5",22856528,1,2,0,954,331,333,2
"e36d261332f14e79bb4b467aceaeb9b5","e36d261332f14e79bb4b467aceaeb9b5",22856528,1,0,1,955,333,333,0
"e36d261332f14e79bb4b467aceaeb9b5","c7e89b9d04744d2eab742fc24e3ef1ae",22856528,1,1,0,956,333,334,1
"c7e89b9d04744d2eab742fc24e3ef1ae","c7e89b9d04744d2eab742fc24e3ef1ae",22856528,2,0,1,957,334,334,0
"c7e89b9d04744d2eab742fc24e3ef1ae","fe49f8054b374a0ea4bb266ed135ff62",22856528,1,1,0,959,334,335,1
"fe49f8054b374a0ea4bb266ed135ff62","fe49f8054b374a0ea4bb266ed135ff62",22856528,2,0,1,960,335,335,0
"fe49f8054b374a0ea4bb266ed135ff62","d0a8f74af98642fe8360d22c42e45117",22856528,1,1,0,962,335,336,1
"d0a8f74af98642fe8360d22c42e45117","d0a8f74af98642fe8360d22c42e45117",22856528,2,0,1,963,336,336,0
"d0a8f74af98642fe8360d22c42e45117","0c4079457ede49e3aeb5e86ed84bdf35",22856528,1,-7,0,965,336,329,-7
"0c4079457ede49e3aeb5e86ed84bdf35","a7c6339ca1da4368a18d471f0519f877",22856528,1,11,0,967,329,339,10
"a7c6339ca1da4368a18d471f0519f877","a7c6339ca1da4368a18d471f0519f877",22856528,1,0,1,968,339,339,0
"a7c6339ca1da4368a18d471f0519f877","bbc5139ca9024389a94db3a6f47dcff6",22856528,1,3,0,969,339,341,2
"bbc5139ca9024389a94db3a6f47dcff6","b8b9418ab322418d9db9b40d96af873a",22856528,2,-5,0,970,341,337,-4
"b8b9418ab322418d9db9b40d96af873a","bbc5139ca9024389a94db3a6f47dcff6",22856528,1,5,0,971,337,341,4
"bbc5139ca9024389a94db3a6f47dcff6","4ee6ca9019ab4a1ab323f98094a9bd77",22856528,1,2,0,972,341,343,2
"4ee6ca9019ab4a1ab323f98094a9bd77","4ee6ca9019ab4a1ab323f98094a9bd77",22856528,2,0,1,973,343,343,0
"4ee6ca9019ab4a1ab323f98094a9bd77","b37947176785476f8b29d49a851366dc",22856528,1,1,0,975,343,344,1
"b37947176785476f8b29d49a851366dc","b37947176785476f8b29d49a851366dc",22856528,2,0,1,976,344,344,0
"b37947176785476f8b29d49a851366dc","fcea5b10d5a14a3b9324ffece8f6e1e5",22856528,1,1,0,978,344,345,1
"fcea5b10d5a14a3b9324ffece8f6e1e5","fcea5b10d5a14a3b9324ffece8f6e1e5",22856528,2,0,1,979,345,345,0
"fcea5b10d5a14a3b9324ffece8f6e1e5","c2490bc612d146edbe786556fab3651b",22856528,1,-5,0,981,345,340,-5
"c2490bc612d146edbe786556fab3651b","30ead9794d4847abaf222ca966cc8630",22856528,1,11,0,982,340,348,8
"30ead9794d4847abaf222ca966cc8630","0c4079457ede49e3aeb5e86ed84bdf35",22856528,1,-24,0,983,348,329,-19
"0c4079457ede49e3aeb5e86ed84bdf35","897b7f51242c44aab2205c72fdcbf4cd",22856528,1,28,0,984,329,352,23
"c20993c944444fe085345591a8bd837e","09b9678ddc3d452ea4a3d46e15826065",22856528,1,2,0,986,351,353,2
"eff0de7f2dbb42dfa1a2e686efab5b6d","0c4079457ede49e3aeb5e86ed84bdf35",22856528,1,-30,0,988,354,329,-25
"30ead9794d4847abaf222ca966cc8630","30ead9794d4847abaf222ca966cc8630",22856528,1,0,1,990,348,348,0
"eff0de7f2dbb42dfa1a2e686efab5b6d","897b7f51242c44aab2205c72fdcbf4cd",22856528,1,-2,0,992,354,352,-2
"09b9678ddc3d452ea4a3d46e15826065","c20993c944444fe085345591a8bd837e",22856528,1,-2,0,994,353,351,-2
"c20993c944444fe085345591a8bd837e","0c4079457ede49e3aeb5e86ed84bdf35",22856528,1,-27,0,995,351,329,-22
"0c4079457ede49e3aeb5e86ed84bdf35","bbc5139ca9024389a94db3a6f47dcff6",22856528,1,14,0,996,329,341,12
"b8b9418ab322418d9db9b40d96af873a","c2490bc612d146edbe786556fab3651b",22856528,1,4,0,998,337,340,3
"c2490bc612d146edbe786556fab3651b","6ac8bb048b854999a47edb35fe627f11",22856528,1,8,0,999,340,347,7
"6ac8bb048b854999a47edb35fe627f11","6ac8bb048b854999a47edb35fe627f11",22856528,1,0,1,1000,347,347,0
"6ac8bb048b854999a47edb35fe627f11","0c4079457ede49e3aeb5e86ed84bdf35",22856528,1,-21,0,1001,347,329,-18
"0c4079457ede49e3aeb5e86ed84bdf35","30ead9794d4847abaf222ca966cc8630",22856528,2,24,0,1002,329,348,19
"30ead9794d4847abaf222ca966cc8630","eff0de7f2dbb42dfa1a2e686efab5b6d",22856528,2,6,0,1003,348,354,6
"eff0de7f2dbb42dfa1a2e686efab5b6d","09b9678ddc3d452ea4a3d46e15826065",22856528,1,-1,0,1004,354,353,-1
"09b9678ddc3d452ea4a3d46e15826065","897b7f51242c44aab2205c72fdcbf4cd",22856528,1,-1,0,1005,353,352,-1
"897b7f51242c44aab2205c72fdcbf4cd","c20993c944444fe085345591a8bd837e",22856528,2,-1,0,1006,352,351,-1
"c20993c944444fe085345591a8bd837e","c20993c944444fe085345591a8bd837e",22856528,4,0,1,1007,351,351,0
"c20993c944444fe085345591a8bd837e","897b7f51242c44aab2205c72fdcbf4cd",22856528,1,1,0,1011,351,352,1
"897b7f51242c44aab2205c72fdcbf4cd","897b7f51242c44aab2205c72fdcbf4cd",22856528,3,0,1,1012,352,352,0
"897b7f51242c44aab2205c72fdcbf4cd","09b9678ddc3d452ea4a3d46e15826065",22856528,2,1,0,1015,352,353,1
"09b9678ddc3d452ea4a3d46e15826065","09b9678ddc3d452ea4a3d46e15826065",22856528,3,0,1,1016,353,353,0
"09b9678ddc3d452ea4a3d46e15826065","eff0de7f2dbb42dfa1a2e686efab5b6d",22856528,2,1,0,1019,353,354,1
"eff0de7f2dbb42dfa1a2e686efab5b6d","eff0de7f2dbb42dfa1a2e686efab5b6d",22856528,3,0,1,1020,354,354,0
"eff0de7f2dbb42dfa1a2e686efab5b6d","2fe14166dc9642c3bc666b86a57f943d",22856528,1,4,0,1023,354,357,3
"2fe14166dc9642c3bc666b86a57f943d","30ead9794d4847abaf222ca966cc8630",22856528,1,-10,0,1024,357,348,-9
"30ead9794d4847abaf222ca966cc8630","2fe14166dc9642c3bc666b86a57f943d",22856528,1,10,0,1025,348,357,9
"2fe14166dc9642c3bc666b86a57f943d","2fe14166dc9642c3bc666b86a57f943d",22856528,1,0,1,1026,357,357,0
"2fe14166dc9642c3bc666b86a57f943d","44421dd1e13a47a388c4a19834b744c7",22856528,1,2,0,1027,357,359,2
"44421dd1e13a47a388c4a19834b744c7","44421dd1e13a47a388c4a19834b744c7",22856528,2,0,1,1028,359,359,0
"44421dd1e13a47a388c4a19834b744c7","cb5fc7ef85d547c4be1a7439d0bf6052",22856528,1,1,0,1030,359,360,1
"cb5fc7ef85d547c4be1a7439d0bf6052","cb5fc7ef85d547c4be1a7439d0bf6052",22856528,2,0,1,1031,360,360,0
"cb5fc7ef85d547c4be1a7439d0bf6052","0a8f150a4cf747acbde62f4721823da3",22856528,1,1,0,1033,360,361,1
"0a8f150a4cf747acbde62f4721823da3","0a8f150a4cf747acbde62f4721823da3",22856528,2,0,1,1034,361,361,0
"0a8f150a4cf747acbde62f4721823da3","ab8fdad974ae471f9f24c3f9dd04462e",22856528,1,1,0,1036,361,362,1
"ab8fdad974ae471f9f24c3f9dd04462e","ab8fdad974ae471f9f24c3f9dd04462e",22856528,2,0,1,1037,362,362,0
"ab8fdad974ae471f9f24c3f9dd04462e","1ba8fef685d74a8194b9db252eb704fb",22856528,1,-7,0,1039,362,355,-7
"1ba8fef685d74a8194b9db252eb704fb","52580888dadb4fe3baa795683ea227bd",22856528,1,10,0,1040,355,364,9
"52580888dadb4fe3baa795683ea227bd","52580888dadb4fe3baa795683ea227bd",22856528,2,0,1,1041,364,364,0
"52580888dadb4fe3baa795683ea227bd","492a3bc6a1254f23a7998587961b22a4",22856528,1,3,0,1043,364,366,2
"492a3bc6a1254f23a7998587961b22a4","f00179e251a045b39c3f7a54f9aa4acc",22856528,1,-4,0,1044,366,363,-3
"f00179e251a045b39c3f7a54f9aa4acc","492a3bc6a1254f23a7998587961b22a4",22856528,1,4,0,1045,363,366,3
"492a3bc6a1254f23a7998587961b22a4","492a3bc6a1254f23a7998587961b22a4",22856528,1,0,1,1046,366,366,0
"492a3bc6a1254f23a7998587961b22a4","072a190fd302456290895f9f04d6940a",22856528,1,-1,0,1047,366,365,-1
"072a190fd302456290895f9f04d6940a","cfa457d1743848e4bb5e4beced6448ed",22856528,1,5,0,1048,365,369,4
"cfa457d1743848e4bb5e4beced6448ed","c76574d21bc14aeea7ecd0b027f39858",22856528,1,-2,0,1049,369,367,-2
"c76574d21bc14aeea7ecd0b027f39858","492a3bc6a1254f23a7998587961b22a4",22856528,1,-2,0,1050,367,366,-1
"492a3bc6a1254f23a7998587961b22a4","52580888dadb4fe3baa795683ea227bd",22856528,1,-3,0,1051,366,364,-2
"52580888dadb4fe3baa795683ea227bd","072a190fd302456290895f9f04d6940a",22856528,1,2,0,1052,364,365,1
"072a190fd302456290895f9f04d6940a","f00179e251a045b39c3f7a54f9aa4acc",22856528,1,-3,0,1053,365,363,-2
"f00179e251a045b39c3f7a54f9aa4acc","2fe14166dc9642c3bc666b86a57f943d",22856528,1,-7,0,1054,363,357,-6
"2fe14166dc9642c3bc666b86a57f943d","1ba8fef685d74a8194b9db252eb704fb",22856528,1,-2,0,1055,357,355,-2
"1ba8fef685d74a8194b9db252eb704fb","cfa457d1743848e4bb5e4beced6448ed",22856528,1,17,0,1056,355,369,14
"cfa457d1743848e4bb5e4beced6448ed","cfa457d1743848e4bb5e4beced6448ed",22856528,1,0,1,1057,369,369,0
"cfa457d1743848e4bb5e4beced6448ed","30ead9794d4847abaf222ca966cc8630",22856528,1,-25,0,1058,369,348,-21
"30ead9794d4847abaf222ca966cc8630","b71bac264efb4abd97015447bd490db6",22856528,1,28,0,1059,348,370,22
"b71bac264efb4abd97015447bd490db6","8d448d625b024c82a5eb240bbd7431d6",22856528,3,5,0,1060,370,374,4
"8d448d625b024c82a5eb240bbd7431d6","8d448d625b024c82a5eb240bbd7431d6",22856528,58,0,1,1061,374,374,0
"8d448d625b024c82a5eb240bbd7431d6","b71bac264efb4abd97015447bd490db6",22856528,2,-5,0,1062,374,370,-4
"b71bac264efb4abd97015447bd490db6","d6d02b6ef04e4f17805504500b8ce441",22856528,1,8,0,1115,370,375,5
"d6d02b6ef04e4f17805504500b8ce441","d6d02b6ef04e4f17805504500b8ce441",22856528,3,0,1,1116,375,375,0
"d6d02b6ef04e4f17805504500b8ce441","66baf19b6b904b70922329068c63746d",22856528,1,4,0,1117,375,376,1
"66baf19b6b904b70922329068c63746d","66baf19b6b904b70922329068c63746d",22856528,2,0,1,1118,376,376,0
"66baf19b6b904b70922329068c63746d","7f544639412e40a9ba27f43b415362ab",22856528,2,2,0,1119,376,378,2
"7f544639412e40a9ba27f43b415362ab","7f544639412e40a9ba27f43b415362ab",22856528,1,0,1,1120,378,378,0
"7f544639412e40a9ba27f43b415362ab","d5ae8642e15b46b8bd298b02274d4e9c",22856528,1,2,0,1121,378,380,2
"d5ae8642e15b46b8bd298b02274d4e9c","d5ae8642e15b46b8bd298b02274d4e9c",22856528,1,0,1,1122,380,380,0
"d5ae8642e15b46b8bd298b02274d4e9c","a0d10309a2dd456289147f84be9d37f9",22856528,1,1,0,1123,380,381,1
"a0d10309a2dd456289147f84be9d37f9","a0d10309a2dd456289147f84be9d37f9",22856528,2,0,1,1124,381,381,0
"a0d10309a2dd456289147f84be9d37f9","0fcbc3ca07b144138b8d85da581f09a8",22856528,1,1,0,1126,381,382,1
"0fcbc3ca07b144138b8d85da581f09a8","0fcbc3ca07b144138b8d85da581f09a8",22856528,2,0,1,1127,382,382,0
"0fcbc3ca07b144138b8d85da581f09a8","66baf19b6b904b70922329068c63746d",22856528,1,-6,0,1129,382,376,-6
"66baf19b6b904b70922329068c63746d","c2fca3669923477ab966ded303dea31c",22856528,1,8,0,1130,376,383,7
"c2fca3669923477ab966ded303dea31c","4890121ce5d74576b4632b77cfc23398",22856528,1,6,0,1131,383,388,5
"4890121ce5d74576b4632b77cfc23398","4890121ce5d74576b4632b77cfc23398",22856528,1,0,1,1132,388,388,0
"4890121ce5d74576b4632b77cfc23398","18d3b836dd804224883cc9180b60a8e1",22856528,1,-1,0,1133,388,387,-1
"18d3b836dd804224883cc9180b60a8e1","96bb2b3e85a34d8b9544514e89f6fe97",22856528,1,4,0,1134,387,390,3
"96bb2b3e85a34d8b9544514e89f6fe97","96bb2b3e85a34d8b9544514e89f6fe97",22856528,1,0,1,1135,390,390,0
"96bb2b3e85a34d8b9544514e89f6fe97","ac4e9b54acfe4670b4634859c7263cb5",22856528,1,2,0,1136,390,392,2
"ac4e9b54acfe4670b4634859c7263cb5","ac4e9b54acfe4670b4634859c7263cb5",22856528,1,0,1,1137,392,392,0
"ac4e9b54acfe4670b4634859c7263cb5","17f95d18bab743888e1736033dc3384d",22856528,1,-3,0,1138,392,389,-3
"17f95d18bab743888e1736033dc3384d","6f8881a745ac4c358a68b92c3b4abe81",22856528,1,6,0,1139,389,394,5
"6f8881a745ac4c358a68b92c3b4abe81","6f8881a745ac4c358a68b92c3b4abe81",22856528,1,0,1,1140,394,394,0
"6f8881a745ac4c358a68b92c3b4abe81","f7002c8484354eceac57bc7bd62c76c1",22856528,1,-1,0,1141,394,393,-1
"f7002c8484354eceac57bc7bd62c76c1","44a277ea44dc4ae689fab4b82f0b4098",22856528,1,5,0,1142,393,397,4
"44a277ea44dc4ae689fab4b82f0b4098","44a277ea44dc4ae689fab4b82f0b4098",22856528,1,0,1,1143,397,397,0
"44a277ea44dc4ae689fab4b82f0b4098","0c12af0a4e7f4002852cf84b2537c161",22856528,1,-2,0,1144,397,395,-2
"0c12af0a4e7f4002852cf84b2537c161","859e0b8d71694b12befb69ee698138f9",22856528,1,5,0,1145,395,399,4
"859e0b8d71694b12befb69ee698138f9","859e0b8d71694b12befb69ee698138f9",22856528,1,0,1,1146,399,399,0
"859e0b8d71694b12befb69ee698138f9","2b09a08242b54983aec7063990fb3f66",22856528,1,3,0,1147,399,400,1
"2b09a08242b54983aec7063990fb3f66","66baf19b6b904b70922329068c63746d",22856528,1,-32,0,1148,400,376,-24
"66baf19b6b904b70922329068c63746d","2b09a08242b54983aec7063990fb3f66",22856528,1,32,0,1149,376,400,24
"2b09a08242b54983aec7063990fb3f66","2b09a08242b54983aec7063990fb3f66",22856528,1,0,1,1150,400,400,0
"2b09a08242b54983aec7063990fb3f66","1f471b7a883a4df48211e8c6a81b59a7",22856528,1,1,0,1151,400,401,1
"1f471b7a883a4df48211e8c6a81b59a7","1f471b7a883a4df48211e8c6a81b59a7",22856528,1,0,1,1152,401,401,0
"1f471b7a883a4df48211e8c6a81b59a7","2b09a08242b54983aec7063990fb3f66",22856528,1,-1,0,1153,401,400,-1
"2b09a08242b54983aec7063990fb3f66","9de0d567bfa84fe5b77cb76f4a76a5d1",22856528,1,5,0,1154,400,404,4
"9de0d567bfa84fe5b77cb76f4a76a5d1","9de0d567bfa84fe5b77cb76f4a76a5d1",22856528,1,0,1,1155,404,404,0
"9de0d567bfa84fe5b77cb76f4a76a5d1","1157bd665ec4472fb58b751dc5099355",22856528,1,-1,0,1156,404,403,-1
"1157bd665ec4472fb58b751dc5099355","3c8a22d2f9c146ea956609e3ed4f2559",22856528,1,3,0,1157,403,405,2
"3c8a22d2f9c146ea956609e3ed4f2559","58fc9094275e4c49be3f4ba6d4acc0a4",22856528,1,2,0,1158,405,406,1
"58fc9094275e4c49be3f4ba6d4acc0a4","58fc9094275e4c49be3f4ba6d4acc0a4",22856528,1,0,1,1159,406,406,0
"58fc9094275e4c49be3f4ba6d4acc0a4","c1c1be90b2b14c1ab4a5e1ee3c241902",22856528,1,1,0,1160,406,407,1
"c1c1be90b2b14c1ab4a5e1ee3c241902","c1c1be90b2b14c1ab4a5e1ee3c241902",22856528,5,0,1,1161,407,407,0
"c1c1be90b2b14c1ab4a5e1ee3c241902","02b3a1bead9244c1ba2f857c7da8f82a",22856528,1,2,0,1166,407,408,1
"02b3a1bead9244c1ba2f857c7da8f82a","58fc9094275e4c49be3f4ba6d4acc0a4",22856528,1,-3,0,1167,408,406,-2
"58fc9094275e4c49be3f4ba6d4acc0a4","02b3a1bead9244c1ba2f857c7da8f82a",22856528,1,3,0,1168,406,408,2
"02b3a1bead9244c1ba2f857c7da8f82a","6206fc6479014bb193084c32409dc1b9",22856528,1,1,0,1169,408,409,1
"6206fc6479014bb193084c32409dc1b9","6206fc6479014bb193084c32409dc1b9",22856528,1,0,1,1170,409,409,0
"6206fc6479014bb193084c32409dc1b9","02b3a1bead9244c1ba2f857c7da8f82a",22856528,1,-1,0,1171,409,408,-1
"02b3a1bead9244c1ba2f857c7da8f82a","6a5f020451db426dacba9e2ea3fcc62a",22856528,1,3,0,1172,408,410,2
"6a5f020451db426dacba9e2ea3fcc62a","6a5f020451db426dacba9e2ea3fcc62a",22856528,6,0,1,1173,410,410,0
"6a5f020451db426dacba9e2ea3fcc62a","33a9d248b2e44588a5b07fc1342b9bc2",22856528,1,2,0,1179,410,411,1
"33a9d248b2e44588a5b07fc1342b9bc2","33a9d248b2e44588a5b07fc1342b9bc2",22856528,1,0,1,1180,411,411,0
"33a9d248b2e44588a5b07fc1342b9bc2","c6f26bd420634f1cb7989e76fe6b16c0",22856528,1,1,0,1181,411,412,1
"c6f26bd420634f1cb7989e76fe6b16c0","c6f26bd420634f1cb7989e76fe6b16c0",22856528,5,0,1,1182,412,412,0
"c6f26bd420634f1cb7989e76fe6b16c0","2a65ee6e2ac64f6a8a55fbe5373ec763",22856528,1,1,0,1187,412,413,1
"2a65ee6e2ac64f6a8a55fbe5373ec763","2a65ee6e2ac64f6a8a55fbe5373ec763",22856528,2,0,1,1188,413,413,0
"2a65ee6e2ac64f6a8a55fbe5373ec763","33a9d248b2e44588a5b07fc1342b9bc2",22856528,1,-2,0,1190,413,411,-2
"33a9d248b2e44588a5b07fc1342b9bc2","1fd0f6dadbc14ebc965faf6122190b96",22856528,1,5,0,1191,411,415,4
"1fd0f6dadbc14ebc965faf6122190b96","1fd0f6dadbc14ebc965faf6122190b96",22856528,1,0,1,1192,415,415,0
"1fd0f6dadbc14ebc965faf6122190b96","687055dad9fc40c3982478fe33ec01bf",22856528,1,-1,0,1193,415,414,-1
"687055dad9fc40c3982478fe33ec01bf","2add1669f08d4101913db15f8c23b3b7",22856528,1,3,0,1194,414,416,2
"2add1669f08d4101913db15f8c23b3b7","2add1669f08d4101913db15f8c23b3b7",22856528,1,0,1,1195,416,416,0
"2add1669f08d4101913db15f8c23b3b7","2b09a08242b54983aec7063990fb3f66",22856528,1,-24,0,1196,416,400,-16
"2b09a08242b54983aec7063990fb3f66","a2b4bd40cee2481ebd3fc179d6a5cd62",22856528,1,27,0,1197,400,417,17
"a2b4bd40cee2481ebd3fc179d6a5cd62","e34e59dce2204f228f3a84b6725df60f",22856528,1,2,0,1198,417,419,2
"e34e59dce2204f228f3a84b6725df60f","e34e59dce2204f228f3a84b6725df60f",22856528,1,0,1,1199,419,419,0
"e34e59dce2204f228f3a84b6725df60f","bec48fc2e1294c7eb3d0aca780d731b8",22856528,1,2,0,1200,419,420,1
"bec48fc2e1294c7eb3d0aca780d731b8","a2b4bd40cee2481ebd3fc179d6a5cd62",22856528,1,-4,0,1201,420,417,-3
"a2b4bd40cee2481ebd3fc179d6a5cd62","bec48fc2e1294c7eb3d0aca780d731b8",22856528,1,4,0,1202,417,420,3
"bec48fc2e1294c7eb3d0aca780d731b8","bec48fc2e1294c7eb3d0aca780d731b8",22856528,1,0,1,1203,420,420,0
"bec48fc2e1294c7eb3d0aca780d731b8","dbde19fcce2a4c1abdc7f685c293a23f",22856528,1,3,0,1204,420,422,2
"dbde19fcce2a4c1abdc7f685c293a23f","a24600b0e49245f6bdba8c893cfeddb0",22856528,1,4,0,1205,422,425,3
"a24600b0e49245f6bdba8c893cfeddb0","a24600b0e49245f6bdba8c893cfeddb0",22856528,2,0,1,1206,425,425,0
"a24600b0e49245f6bdba8c893cfeddb0","a2b4bd40cee2481ebd3fc179d6a5cd62",22856528,1,-11,0,1208,425,417,-8
"a2b4bd40cee2481ebd3fc179d6a5cd62","24cf8786024543f19b89bc20034e60d7",22856528,1,18,0,1209,417,428,11
"24cf8786024543f19b89bc20034e60d7","f2a73be2f46840b182d7bd095378004e",22856528,1,1,0,1210,428,429,1
"f2a73be2f46840b182d7bd095378004e","f2a73be2f46840b182d7bd095378004e",22856528,1,0,1,1211,429,429,0
"f2a73be2f46840b182d7bd095378004e","604551fd4266430cb860fef58fa7dd61",22856528,1,1,0,1212,429,430,1
"604551fd4266430cb860fef58fa7dd61","604551fd4266430cb860fef58fa7dd61",22856528,9,0,1,1213,430,430,0
"604551fd4266430cb860fef58fa7dd61","dce46f8904594a62a6377a3587aaa663",22856528,1,2,0,1222,430,431,1
"dce46f8904594a62a6377a3587aaa663","24cf8786024543f19b89bc20034e60d7",22856528,1,-4,0,1223,431,428,-3
"24cf8786024543f19b89bc20034e60d7","dce46f8904594a62a6377a3587aaa663",22856528,1,4,0,1224,428,431,3
"dce46f8904594a62a6377a3587aaa663","dce46f8904594a62a6377a3587aaa663",22856528,1,0,1,1225,431,431,0
"dce46f8904594a62a6377a3587aaa663","9b9d0a249052413c869753b99682b0ac",22856528,1,1,0,1226,431,432,1
"9b9d0a249052413c869753b99682b0ac","9b9d0a249052413c869753b99682b0ac",22856528,6,0,1,1227,432,432,0
"9b9d0a249052413c869753b99682b0ac","061c175cc90f45fbad883025394e78dd",22856528,1,1,0,1233,432,433,1
"061c175cc90f45fbad883025394e78dd","061c175cc90f45fbad883025394e78dd",22856528,4,0,1,1234,433,433,0
"061c175cc90f45fbad883025394e78dd","dce46f8904594a62a6377a3587aaa663",22856528,1,-2,0,1238,433,431,-2
"dce46f8904594a62a6377a3587aaa663","74a7f8712e5449c2bc0b43c6f90dafed",22856528,1,5,0,1239,431,435,4
"74a7f8712e5449c2bc0b43c6f90dafed","74a7f8712e5449c2bc0b43c6f90dafed",22856528,1,0,1,1240,435,435,0
"74a7f8712e5449c2bc0b43c6f90dafed","66ada10dde9f43018588f1ced9d477fc",22856528,1,-1,0,1241,435,434,-1
"66ada10dde9f43018588f1ced9d477fc","bf12c96466d840a69bed7020b3f18bb8",22856528,1,3,0,1242,434,436,2
"bf12c96466d840a69bed7020b3f18bb8","bf12c96466d840a69bed7020b3f18bb8",22856528,1,0,1,1243,436,436,0
"bf12c96466d840a69bed7020b3f18bb8","24cf8786024543f19b89bc20034e60d7",22856528,1,-11,0,1244,436,428,-8
"24cf8786024543f19b89bc20034e60d7","070600601c4c439288445d2f0724807d",22856528,1,14,0,1245,428,437,9
"070600601c4c439288445d2f0724807d","1823b6de7d334a7aaabc4570719af4d9",22856528,1,2,0,1246,437,439,2
"1823b6de7d334a7aaabc4570719af4d9","1823b6de7d334a7aaabc4570719af4d9",22856528,11,0,1,1247,439,439,0
"1823b6de7d334a7aaabc4570719af4d9","070600601c4c439288445d2f0724807d",22856528,1,-2,0,1258,439,437,-2
"070600601c4c439288445d2f0724807d","0380cd76a7d44bc3a4da1f15e4d68f89",22856528,1,4,0,1259,437,440,3
"0380cd76a7d44bc3a4da1f15e4d68f89","0380cd76a7d44bc3a4da1f15e4d68f89",22856528,2,0,1,1260,440,440,0
"0380cd76a7d44bc3a4da1f15e4d68f89","23b7673c8b5443108c2ef09382834a86",22856528,1,2,0,1262,440,441,1
"23b7673c8b5443108c2ef09382834a86","23b7673c8b5443108c2ef09382834a86",22856528,1,0,1,1263,441,441,0
"23b7673c8b5443108c2ef09382834a86","901e92500aea43c79f19f1b279050668",22856528,2,2,0,1264,441,442,1
"901e92500aea43c79f19f1b279050668","23b7673c8b5443108c2ef09382834a86",22856528,1,-2,0,1265,442,441,-1
"901e92500aea43c79f19f1b279050668","001339db8ced4cf78829ebe8b145449d",22856528,1,1,0,1267,442,443,1
"001339db8ced4cf78829ebe8b145449d","001339db8ced4cf78829ebe8b145449d",22856528,2,0,1,1268,443,443,0
"001339db8ced4cf78829ebe8b145449d","452745e0366e42ae81561bfddebcc6c3",22856528,1,1,0,1270,443,444,1
"452745e0366e42ae81561bfddebcc6c3","452745e0366e42ae81561bfddebcc6c3",22856528,2,0,1,1271,444,444,0
"452745e0366e42ae81561bfddebcc6c3","901e92500aea43c79f19f1b279050668",22856528,1,-2,0,1273,444,442,-2
"901e92500aea43c79f19f1b279050668","4660ff2089114e8db82ceb26a4f329e3",22856528,1,4,0,1274,442,445,3
"4660ff2089114e8db82ceb26a4f329e3","4660ff2089114e8db82ceb26a4f329e3",22856528,2,0,1,1275,445,445,0
"4660ff2089114e8db82ceb26a4f329e3","7bd5586eb9d8484eb74a433ee7bfe499",22856528,1,2,0,1277,445,446,1
"7bd5586eb9d8484eb74a433ee7bfe499","7bd5586eb9d8484eb74a433ee7bfe499",22856528,9,0,1,1278,446,446,0
"7bd5586eb9d8484eb74a433ee7bfe499","8a7f26e690f34dda97be16904518ca99",22856528,1,2,0,1287,446,447,1
"8a7f26e690f34dda97be16904518ca99","8a7f26e690f34dda97be16904518ca99",22856528,1,0,1,1288,447,447,0
"8a7f26e690f34dda97be16904518ca99","b2f0d654738f48158edff28e8d3a546e",22856528,1,5,0,1289,447,449,2
"b2f0d654738f48158edff28e8d3a546e","070600601c4c439288445d2f0724807d",22856528,1,-21,0,1290,449,437,-12
"070600601c4c439288445d2f0724807d","f60ee41ec635499abd48168342d32c2f",22856528,1,26,0,1291,437,453,16
"f60ee41ec635499abd48168342d32c2f","f60ee41ec635499abd48168342d32c2f",22856528,57,0,1,1292,453,453,0
"f60ee41ec635499abd48168342d32c2f","b2f0d654738f48158edff28e8d3a546e",22856528,3,-5,0,1297,453,449,-4
"b2f0d654738f48158edff28e8d3a546e","f60ee41ec635499abd48168342d32c2f",22856528,3,5,0,1298,449,453,4
"b2f0d654738f48158edff28e8d3a546e","f67fbf45a5f146ed866965bc57c7c001",22856528,1,8,0,1347,449,454,5
"f67fbf45a5f146ed866965bc57c7c001","f67fbf45a5f146ed866965bc57c7c001",22856528,2,0,1,1348,454,454,0
"f67fbf45a5f146ed866965bc57c7c001","d937afe49bd24a07a550dda1c1155122",22856528,1,1,0,1350,454,455,1
"d937afe49bd24a07a550dda1c1155122","d937afe49bd24a07a550dda1c1155122",22856528,1,0,1,1351,455,455,0
"d937afe49bd24a07a550dda1c1155122","3628b3f7823443d0912a339096b69943",22856528,1,1,0,1352,455,456,1
"3628b3f7823443d0912a339096b69943","3628b3f7823443d0912a339096b69943",22856528,1,0,1,1353,456,456,0
"3628b3f7823443d0912a339096b69943","9e049ee647cf43ecbcb5ed792a8e7588",22856528,1,1,0,1354,456,457,1
"9e049ee647cf43ecbcb5ed792a8e7588","9e049ee647cf43ecbcb5ed792a8e7588",22856528,1,0,1,1355,457,457,0
"9e049ee647cf43ecbcb5ed792a8e7588","5256a214faaf410b93f76cea06428334",22856528,1,1,0,1356,457,458,1
"5256a214faaf410b93f76cea06428334","5256a214faaf410b93f76cea06428334",22856528,1,0,1,1357,458,458,0
"5256a214faaf410b93f76cea06428334","25c32b120fce40fa9b6c85133aeb4716",22856528,1,1,0,1358,458,459,1
"25c32b120fce40fa9b6c85133aeb4716","25c32b120fce40fa9b6c85133aeb4716",22856528,1,0,1,1359,459,459,0
"25c32b120fce40fa9b6c85133aeb4716","11bc14f2204949008b7d511b933363c1",22856528,1,1,0,1360,459,460,1
"11bc14f2204949008b7d511b933363c1","11bc14f2204949008b7d511b933363c1",22856528,1,0,1,1361,460,460,0
"11bc14f2204949008b7d511b933363c1","42de338840a34d15adb66e7b14fb9d2c",22856528,1,1,0,1362,460,461,1
"42de338840a34d15adb66e7b14fb9d2c","42de338840a34d15adb66e7b14fb9d2c",22856528,3,0,1,1363,461,461,0
"42de338840a34d15adb66e7b14fb9d2c","9da37c6210b1416b8079c274f70bf600",22856528,1,1,0,1366,461,462,1
"9da37c6210b1416b8079c274f70bf600","9da37c6210b1416b8079c274f70bf600",22856528,3,0,1,1367,462,462,0
"9da37c6210b1416b8079c274f70bf600","519119f1deac45ff9ab4f13529be5c6e",22856528,1,1,0,1370,462,463,1
"519119f1deac45ff9ab4f13529be5c6e","519119f1deac45ff9ab4f13529be5c6e",22856528,1,0,1,1371,463,463,0
"519119f1deac45ff9ab4f13529be5c6e","f67fbf45a5f146ed866965bc57c7c001",22856528,1,-9,0,1372,463,454,-9
"f67fbf45a5f146ed866965bc57c7c001","c5df9f40ec14463b9dcfdc73df3e9285",22856528,1,12,0,1373,454,464,10
"c5df9f40ec14463b9dcfdc73df3e9285","c5df9f40ec14463b9dcfdc73df3e9285",22856528,2,0,1,1374,464,464,0
"c5df9f40ec14463b9dcfdc73df3e9285","83d42d95cd844fc093fc09cee250edb8",22856528,1,3,0,1376,464,465,1
"83d42d95cd844fc093fc09cee250edb8","83d42d95cd844fc093fc09cee250edb8",22856528,3,0,1,1377,465,465,0
"83d42d95cd844fc093fc09cee250edb8","78adeee1fa2c4fe0bc73f7bca9fcee86",22856528,1,-431,0,1380,465,160,-305
"78adeee1fa2c4fe0bc73f7bca9fcee86","78adeee1fa2c4fe0bc73f7bca9fcee86",22856528,1,0,1,1381,160,160,0
"78adeee1fa2c4fe0bc73f7bca9fcee86","65202579580f4ad38d734b4ee39d22a8",22856528,6,5,0,1382,160,164,4
"65202579580f4ad38d734b4ee39d22a8","65202579580f4ad38d734b4ee39d22a8",22856528,63,0,1,1383,164,164,0
"65202579580f4ad38d734b4ee39d22a8","78adeee1fa2c4fe0bc73f7bca9fcee86",22856528,3,-5,0,1384,164,160,-4
"65202579580f4ad38d734b4ee39d22a8","5152833676bf4c6cb317060be10f68db",22856528,1,91,0,1436,164,228,64
"5152833676bf4c6cb317060be10f68db","1c6721b1f63f4d30ba7746ea8af02a52",22856528,1,-9,0,1437,228,221,-7
"1c6721b1f63f4d30ba7746ea8af02a52","2ab1535aac1346ba8801535bf729ef37",22856528,1,10,0,1438,221,229,8
"2ab1535aac1346ba8801535bf729ef37","5152833676bf4c6cb317060be10f68db",22856528,1,-1,0,1439,229,228,-1
"5152833676bf4c6cb317060be10f68db","66d4fad4f1cf4b46be0750a99ad7a35a",22856528,1,12,0,1440,228,239,11
"66d4fad4f1cf4b46be0750a99ad7a35a","66d4fad4f1cf4b46be0750a99ad7a35a",22856528,1,0,1,1441,239,239,0
"66d4fad4f1cf4b46be0750a99ad7a35a","0b04c8e2f86d48c7aeb7e225819cd32b",22856528,1,-5,0,1442,239,234,-5
"0b04c8e2f86d48c7aeb7e225819cd32b","64dbedb3ce544f6aae8e10e0cf10f16d",22856528,2,7,0,1443,234,240,6
"64dbedb3ce544f6aae8e10e0cf10f16d","0b04c8e2f86d48c7aeb7e225819cd32b",22856528,2,-7,0,1444,240,234,-6
"0b04c8e2f86d48c7aeb7e225819cd32b","1c6721b1f63f4d30ba7746ea8af02a52",22856528,1,-16,0,1447,234,221,-13
"1c6721b1f63f4d30ba7746ea8af02a52","2ae94c0cea4d480a9d5dca8fb1d7b542",22856528,3,27,0,1448,221,242,21
"2ae94c0cea4d480a9d5dca8fb1d7b542","1ebf23f9d994469a85206e4c7b1bf5f5",22856528,3,3,0,1449,242,245,3
"1ebf23f9d994469a85206e4c7b1bf5f5","2ae94c0cea4d480a9d5dca8fb1d7b542",22856528,1,-3,0,1450,245,242,-3
"2ae94c0cea4d480a9d5dca8fb1d7b542","30c9ba177afc49a695625d2bdec40207",22856528,1,9,0,1451,242,250,8
"30c9ba177afc49a695625d2bdec40207","30c9ba177afc49a695625d2bdec40207",22856528,2,0,1,1452,250,250,0
"30c9ba177afc49a695625d2bdec40207","00f61990949545828dd12f1303d47504",22856528,1,8,0,1454,250,256,6
"00f61990949545828dd12f1303d47504","6e83e23f56544a19b94067c1c558d9c0",22856528,2,-11,0,1455,256,247,-9
"6e83e23f56544a19b94067c1c558d9c0","d546341988904f069cfa86b21457d9d9",22856528,1,5,0,1456,247,251,4
"d546341988904f069cfa86b21457d9d9","d989ebcfc12a4b669f0100dc1aa14f1e",22856528,1,5,0,1457,251,255,4
"d989ebcfc12a4b669f0100dc1aa14f1e","7aa76d3e993840d8805f097cbdbcd44b",22856528,1,7,0,1458,255,261,6
"7aa76d3e993840d8805f097cbdbcd44b","0d987bed3ffa4ed0b9a2e62e97b7b30f",22856528,1,15,0,1459,261,272,11
"0d987bed3ffa4ed0b9a2e62e97b7b30f","2ae94c0cea4d480a9d5dca8fb1d7b542",22856528,1,-38,0,1460,272,242,-30
"2ae94c0cea4d480a9d5dca8fb1d7b542","6e83e23f56544a19b94067c1c558d9c0",22856528,1,6,0,1461,242,247,5
"6e83e23f56544a19b94067c1c558d9c0","2ae94c0cea4d480a9d5dca8fb1d7b542",22856528,1,-6,0,1462,247,242,-5
"2ae94c0cea4d480a9d5dca8fb1d7b542","00f61990949545828dd12f1303d47504",22856528,2,17,0,1463,242,256,14
"6e83e23f56544a19b94067c1c558d9c0","73039f8c1eb9409cb4caee2cf968001e",22856528,1,-195,0,1465,247,100,-147
"73039f8c1eb9409cb4caee2cf968001e","e20db35ced8544ddac5bc3839145e463",22856528,2,-10,0,1466,100,91,-9
"e20db35ced8544ddac5bc3839145e463","00ae5f0c51874a73a41ebea838d95682",22856528,3,11,0,1467,91,101,10
"00ae5f0c51874a73a41ebea838d95682","d391c8b6e56a43a7b654e9dee02d904b",22856528,4,2,0,1468,101,103,2
"d391c8b6e56a43a7b654e9dee02d904b","f4ce60b4a944484082ccb701b48b3da1",22856528,1,67,0,1469,103,157,54
"f4ce60b4a944484082ccb701b48b3da1","df1de691dafe4549a18a4398ee9dfaf9",22856528,1,-21,0,1470,157,139,-18
"df1de691dafe4549a18a4398ee9dfaf9","d313cec988a84645bee413e8d4724a4b",22856528,1,22,0,1471,139,158,19
"d313cec988a84645bee413e8d4724a4b","d313cec988a84645bee413e8d4724a4b",22856528,7,0,1,1472,158,158,0
"d313cec988a84645bee413e8d4724a4b","dc60696c76a74368a60f72246e47700d",22856528,1,1,0,1474,158,159,1
"dc60696c76a74368a60f72246e47700d","dc60696c76a74368a60f72246e47700d",22856528,1,0,1,1475,159,159,0
"dc60696c76a74368a60f72246e47700d","df1de691dafe4549a18a4398ee9dfaf9",22856528,1,-23,0,1476,159,139,-20
"df1de691dafe4549a18a4398ee9dfaf9","78adeee1fa2c4fe0bc73f7bca9fcee86",22856528,1,26,0,1477,139,160,21
"78adeee1fa2c4fe0bc73f7bca9fcee86","579338175e0b4bbb8ef3b712b5d8b54e",22856528,1,-41,0,1478,160,128,-32
"579338175e0b4bbb8ef3b712b5d8b54e","779f9ddd1fd14d1e9e69f72219a1fdbd",22856528,1,-8,0,1479,128,121,-7
"779f9ddd1fd14d1e9e69f72219a1fdbd","a8dd5213034441ac92724b4e83eb0bb2",22856528,3,9,0,1480,121,129,8
"a8dd5213034441ac92724b4e83eb0bb2","579338175e0b4bbb8ef3b712b5d8b54e",22856528,1,-1,0,1481,129,128,-1
"579338175e0b4bbb8ef3b712b5d8b54e","73039f8c1eb9409cb4caee2cf968001e",22856528,1,-34,0,1482,128,100,-28
"d391c8b6e56a43a7b654e9dee02d904b","00ae5f0c51874a73a41ebea838d95682",22856528,2,-2,0,1486,103,101,-2
"00ae5f0c51874a73a41ebea838d95682","8d7e0b55cf9849cda222a0f2440cec55",22856528,1,291,0,1487,101,318,217
"8d7e0b55cf9849cda222a0f2440cec55","3434c10e561d488a914e0f7d71907abd",22856528,1,-16,0,1488,318,305,-13
"3434c10e561d488a914e0f7d71907abd","86c27d40179e419c8e9d150fb6afa5d0",22856528,2,17,0,1489,305,319,14
"86c27d40179e419c8e9d150fb6afa5d0","8d7e0b55cf9849cda222a0f2440cec55",22856528,2,-1,0,1490,319,318,-1
"8d7e0b55cf9849cda222a0f2440cec55","24f1363179ad4aaa965484a78471912b",22856528,2,6,0,1491,318,323,5
"24f1363179ad4aaa965484a78471912b","47edbb64109243e6b0f8f64cdef90c6c",22856528,3,3,0,1492,323,326,3
"47edbb64109243e6b0f8f64cdef90c6c","0c4079457ede49e3aeb5e86ed84bdf35",22856528,1,6,0,1493,326,329,3
"0c4079457ede49e3aeb5e86ed84bdf35","0c4079457ede49e3aeb5e86ed84bdf35",22856528,2,0,1,1494,329,329,0
"0c4079457ede49e3aeb5e86ed84bdf35","38aea304b4fa46e1b29bb72f5cea4c93",22856528,2,2,0,1495,329,331,2
"38aea304b4fa46e1b29bb72f5cea4c93","d6d02b6ef04e4f17805504500b8ce441",22856528,1,58,0,1496,331,375,44
"d6d02b6ef04e4f17805504500b8ce441","78adeee1fa2c4fe0bc73f7bca9fcee86",22856528,1,-292,0,1499,375,160,-215
"65202579580f4ad38d734b4ee39d22a8","0d987bed3ffa4ed0b9a2e62e97b7b30f",22856528,1,147,0,1509,164,272,108
"0d987bed3ffa4ed0b9a2e62e97b7b30f","0d987bed3ffa4ed0b9a2e62e97b7b30f",22856528,2,0,1,1510,272,272,0
"0d987bed3ffa4ed0b9a2e62e97b7b30f","bb5a47f5ea01454a8b79455422d3b9da",22856528,2,10,0,1511,272,280,8
"bb5a47f5ea01454a8b79455422d3b9da","bb5a47f5ea01454a8b79455422d3b9da",22856528,82,0,1,1512,280,280,0
"bb5a47f5ea01454a8b79455422d3b9da","82ae07bc0c9b4570a41799290d1ef399",22856528,3,-6,0,1516,280,275,-5
"82ae07bc0c9b4570a41799290d1ef399","bb5a47f5ea01454a8b79455422d3b9da",22856528,4,6,0,1517,275,280,5
"bb5a47f5ea01454a8b79455422d3b9da","b71bac264efb4abd97015447bd490db6",22856528,1,122,0,1520,280,370,90
"8d448d625b024c82a5eb240bbd7431d6","b2f0d654738f48158edff28e8d3a546e",22856528,1,119,0,1529,374,449,75
"f60ee41ec635499abd48168342d32c2f","e20db35ced8544ddac5bc3839145e463",22856528,1,-498,0,1538,453,91,-362
"d391c8b6e56a43a7b654e9dee02d904b","4280927ec4d643238aa49c32f9e06c6c",22856528,1,7,0,1541,103,109,6
"4280927ec4d643238aa49c32f9e06c6c","73039f8c1eb9409cb4caee2cf968001e",22856528,2,-10,0,1542,109,100,-9
"73039f8c1eb9409cb4caee2cf968001e","a9ae0a3c070d455bb4369a8996313336",22856528,1,16,0,1543,100,114,14
"a9ae0a3c070d455bb4369a8996313336","08111f75e22d409998cf8b85bd431f0a",22856528,1,-7,0,1544,114,108,-6
"08111f75e22d409998cf8b85bd431f0a","37319e88176d4aefa91d7a9980dbae91",22856528,1,5,0,1545,108,112,4
"37319e88176d4aefa91d7a9980dbae91","62bff51286ef4f348717a3cf6fe2318f",22856528,2,9,0,1546,112,120,8
"62bff51286ef4f348717a3cf6fe2318f","b1cd0e7dc3ad4a8eb91a4bfdbeb025b0",22856528,2,-2,0,1547,120,118,-2
"b1cd0e7dc3ad4a8eb91a4bfdbeb025b0","b1cd0e7dc3ad4a8eb91a4bfdbeb025b0",22856528,3,0,1,1548,118,118,0
"b1cd0e7dc3ad4a8eb91a4bfdbeb025b0","62bff51286ef4f348717a3cf6fe2318f",22856528,1,2,0,1549,118,120,2
"62bff51286ef4f348717a3cf6fe2318f","62bff51286ef4f348717a3cf6fe2318f",22856528,3,0,1,1550,120,120,0
"62bff51286ef4f348717a3cf6fe2318f","e20db35ced8544ddac5bc3839145e463",22856528,1,-33,0,1553,120,91,-29
"e20db35ced8544ddac5bc3839145e463","779f9ddd1fd14d1e9e69f72219a1fdbd",22856528,1,36,0,1554,91,121,30
"a8dd5213034441ac92724b4e83eb0bb2","779f9ddd1fd14d1e9e69f72219a1fdbd",22856528,1,-9,0,1556,129,121,-8
"779f9ddd1fd14d1e9e69f72219a1fdbd","579338175e0b4bbb8ef3b712b5d8b54e",22856528,1,8,0,1557,121,128,7
"579338175e0b4bbb8ef3b712b5d8b54e","b416d47c56a742199b5d7c7f19d6503a",22856528,1,7,0,1558,128,134,6
"b416d47c56a742199b5d7c7f19d6503a","779f9ddd1fd14d1e9e69f72219a1fdbd",22856528,1,-15,0,1559,134,121,-13
"779f9ddd1fd14d1e9e69f72219a1fdbd","df1de691dafe4549a18a4398ee9dfaf9",22856528,2,23,0,1560,121,139,18
"df1de691dafe4549a18a4398ee9dfaf9","6c5ad271a44743479bfaea29b1db8d02",22856528,2,4,0,1561,139,143,4
"6c5ad271a44743479bfaea29b1db8d02","df1de691dafe4549a18a4398ee9dfaf9",22856528,1,-4,0,1562,143,139,-4
"df1de691dafe4549a18a4398ee9dfaf9","8aae34f5ddbb4052a709b12e6b0d40fa",22856528,2,9,0,1563,139,147,8
"8aae34f5ddbb4052a709b12e6b0d40fa","f902b0f41b544d4dbf79664fd233648d",22856528,1,-1,0,1564,147,146,-1
"f902b0f41b544d4dbf79664fd233648d","d313cec988a84645bee413e8d4724a4b",22856528,1,14,0,1565,146,158,12
"d313cec988a84645bee413e8d4724a4b","f03480cf4eba413194d7af52fc0e7f28",22856528,1,-7,0,1567,158,152,-6
"f03480cf4eba413194d7af52fc0e7f28","d313cec988a84645bee413e8d4724a4b",22856528,2,7,0,1568,152,158,6
"d313cec988a84645bee413e8d4724a4b","78adeee1fa2c4fe0bc73f7bca9fcee86",22856528,2,4,0,1569,158,160,2
"78adeee1fa2c4fe0bc73f7bca9fcee86","df1de691dafe4549a18a4398ee9dfaf9",22856528,2,-26,0,1570,160,139,-21
"df1de691dafe4549a18a4398ee9dfaf9","2ae94c0cea4d480a9d5dca8fb1d7b542",22856528,1,140,0,1571,139,242,103
"00f61990949545828dd12f1303d47504","1c6721b1f63f4d30ba7746ea8af02a52",22856528,1,-44,0,1573,256,221,-35
"1c6721b1f63f4d30ba7746ea8af02a52","f53da5fd9bfe412da4b80d4742563b6c",22856528,1,24,0,1574,221,241,20
"f53da5fd9bfe412da4b80d4742563b6c","f53da5fd9bfe412da4b80d4742563b6c",22856528,4,0,1,1575,241,241,0
"f53da5fd9bfe412da4b80d4742563b6c","1c6721b1f63f4d30ba7746ea8af02a52",22856528,2,-24,0,1576,241,221,-20
"1ebf23f9d994469a85206e4c7b1bf5f5","66baf19b6b904b70922329068c63746d",22856528,1,179,0,1579,245,376,131
"b613861cecf84ffcab01afb23f660475","b613861cecf84ffcab01afb23f660475",22856637,4,0,1,1,1,1,0
"b613861cecf84ffcab01afb23f660475","e2911e79efc2420eac45d9f671463d4b",22856637,2,3,0,3,1,2,1
"e2911e79efc2420eac45d9f671463d4b","b613861cecf84ffcab01afb23f660475",22856637,1,-3,0,4,2,1,-1
"e2911e79efc2420eac45d9f671463d4b","e2911e79efc2420eac45d9f671463d4b",22856637,2,0,1,6,2,2,0
"e2911e79efc2420eac45d9f671463d4b","519d1b8c59404d67b54e96c5c8a830b2",22856637,1,1,0,8,2,3,1
"519d1b8c59404d67b54e96c5c8a830b2","519d1b8c59404d67b54e96c5c8a830b2",22856637,1,0,1,9,3,3,0
"519d1b8c59404d67b54e96c5c8a830b2","531db53f81f646edb0cdcfe0085b03b7",22856637,1,1,0,10,3,4,1
"531db53f81f646edb0cdcfe0085b03b7","531db53f81f646edb0cdcfe0085b03b7",22856637,1,0,1,11,4,4,0
"531db53f81f646edb0cdcfe0085b03b7","4f5f94b2f95141e0a9d53a61da2276da",22856637,1,1,0,12,4,5,1
"4f5f94b2f95141e0a9d53a61da2276da","4f5f94b2f95141e0a9d53a61da2276da",22856637,1,0,1,13,5,5,0
"4f5f94b2f95141e0a9d53a61da2276da","6d541c89590949f99af293c4f2333f67",22856637,1,1,0,14,5,6,1
"6d541c89590949f99af293c4f2333f67","6d541c89590949f99af293c4f2333f67",22856637,1,0,1,15,6,6,0
"6d541c89590949f99af293c4f2333f67","dd5cf0b9fe4c4f1d8f5ff8e4c04879cb",22856637,1,1,0,16,6,7,1
"dd5cf0b9fe4c4f1d8f5ff8e4c04879cb","dd5cf0b9fe4c4f1d8f5ff8e4c04879cb",22856637,2,0,1,17,7,7,0
"dd5cf0b9fe4c4f1d8f5ff8e4c04879cb","6d541c89590949f99af293c4f2333f67",22856637,1,-1,0,19,7,6,-1
"6d541c89590949f99af293c4f2333f67","4f5f94b2f95141e0a9d53a61da2276da",22856637,1,-1,0,20,6,5,-1
"4f5f94b2f95141e0a9d53a61da2276da","f96261861edc426abe2248be4f0a709a",22856637,1,3,0,21,5,8,3
"f96261861edc426abe2248be4f0a709a","f96261861edc426abe2248be4f0a709a",22856637,2,0,1,22,8,8,0
"f96261861edc426abe2248be4f0a709a","66b5e16f4f75454fb5b8172079f0fa83",22856637,1,1,0,24,8,9,1
"66b5e16f4f75454fb5b8172079f0fa83","66b5e16f4f75454fb5b8172079f0fa83",22856637,1,0,1,25,9,9,0
"66b5e16f4f75454fb5b8172079f0fa83","0680571d4698477995e41842c36a54b2",22856637,1,1,0,26,9,10,1
"0680571d4698477995e41842c36a54b2","0680571d4698477995e41842c36a54b2",22856637,1,0,1,27,10,10,0
"0680571d4698477995e41842c36a54b2","9112f2bffece48e08c6d2287be204085",22856637,1,1,0,28,10,11,1
"9112f2bffece48e08c6d2287be204085","9112f2bffece48e08c6d2287be204085",22856637,1,0,1,29,11,11,0
"9112f2bffece48e08c6d2287be204085","56586aa865414f538729c7f7735d2bc6",22856637,1,3,0,30,11,12,1
"56586aa865414f538729c7f7735d2bc6","e2911e79efc2420eac45d9f671463d4b",22856637,1,-12,0,31,12,2,-10
"e2911e79efc2420eac45d9f671463d4b","56586aa865414f538729c7f7735d2bc6",22856637,1,12,0,32,2,12,10
"b7f2b31585d94eb3bf86376714aa7070","3f1c815879794b929260d224becaff7e",22856637,2,2,0,38,13,14,1
"3f1c815879794b929260d224becaff7e","81c864a886d54a6b8ff85f7d736f4f95",22856637,2,2,0,39,14,15,1
"81c864a886d54a6b8ff85f7d736f4f95","5c5ceeee4562457ba6d41515aeebfbb1",22856637,2,4,0,40,15,17,2
"5c5ceeee4562457ba6d41515aeebfbb1","5c5ceeee4562457ba6d41515aeebfbb1",22856637,3,0,1,41,17,17,0
"5c5ceeee4562457ba6d41515aeebfbb1","9afd71a5298d4333b6849dfce1b9422c",22856637,1,3,0,42,17,18,1
"9afd71a5298d4333b6849dfce1b9422c","56586aa865414f538729c7f7735d2bc6",22856637,1,-13,0,43,18,12,-6
"56586aa865414f538729c7f7735d2bc6","9afd71a5298d4333b6849dfce1b9422c",22856637,1,13,0,44,12,18,6
"9afd71a5298d4333b6849dfce1b9422c","9afd71a5298d4333b6849dfce1b9422c",22856637,1,0,1,45,18,18,0
"9afd71a5298d4333b6849dfce1b9422c","a49d1bb4328949299686242fd0be5584",22856637,1,6,0,46,18,21,3
"a49d1bb4328949299686242fd0be5584","b7719e26494940efa49512aedd0aac79",22856637,1,-2,0,47,21,20,-1
"b7719e26494940efa49512aedd0aac79","b7719e26494940efa49512aedd0aac79",22856637,1,0,1,48,20,20,0
"b7719e26494940efa49512aedd0aac79","afbf7250b99d47bea07172749483ca97",22856637,1,12,0,49,20,28,8
"afbf7250b99d47bea07172749483ca97","afbf7250b99d47bea07172749483ca97",22856637,1,0,1,50,28,28,0
"afbf7250b99d47bea07172749483ca97","4e51676dc72045d99c19b9fa7b22f8bc",22856637,1,3,0,51,28,29,1
"4e51676dc72045d99c19b9fa7b22f8bc","4e51676dc72045d99c19b9fa7b22f8bc",22856637,1,0,1,52,29,29,0
"4e51676dc72045d99c19b9fa7b22f8bc","51970cfa30e643e894e66ae85c8024cc",22856637,1,3,0,53,29,31,2
"51970cfa30e643e894e66ae85c8024cc","c33c17be71ae4d588da7369472e5bb1b",22856637,1,6,0,54,31,34,3
"c33c17be71ae4d588da7369472e5bb1b","4e51676dc72045d99c19b9fa7b22f8bc",22856637,1,-9,0,55,34,29,-5
"4e51676dc72045d99c19b9fa7b22f8bc","c33c17be71ae4d588da7369472e5bb1b",22856637,1,9,0,56,29,34,5
"c33c17be71ae4d588da7369472e5bb1b","93679be414554a11b1893002f2229a93",22856637,1,3,0,57,34,35,1
"93679be414554a11b1893002f2229a93","93679be414554a11b1893002f2229a93",22856637,1,0,1,58,35,35,0
"93679be414554a11b1893002f2229a93","7040a13096d746ac84b8fac8d9752058",22856637,1,3,0,59,35,36,1
"7040a13096d746ac84b8fac8d9752058","7040a13096d746ac84b8fac8d9752058",22856637,1,0,1,60,36,36,0
"7040a13096d746ac84b8fac8d9752058","9a0dc646f934470daf08c4b56ccf73db",22856637,1,3,0,61,36,37,1
"9a0dc646f934470daf08c4b56ccf73db","9a0dc646f934470daf08c4b56ccf73db",22856637,2,0,1,62,37,37,0
"9a0dc646f934470daf08c4b56ccf73db","fc0e049d56024bc9a02c9a9c435c3df7",22856637,2,3,0,63,37,38,1
"fc0e049d56024bc9a02c9a9c435c3df7","67a089198fcb4e1c8f2385786c2b296f",22856637,1,4,0,64,38,39,1
"67a089198fcb4e1c8f2385786c2b296f","fc0e049d56024bc9a02c9a9c435c3df7",22856637,2,-4,0,65,39,38,-1
"fc0e049d56024bc9a02c9a9c435c3df7","64d48c6c9c7940639a932219a6c87198",22856637,2,5,0,66,38,40,2
"64d48c6c9c7940639a932219a6c87198","b534b89233134e30a9b5645138bfa9ee",22856637,1,3,0,68,40,41,1
"b534b89233134e30a9b5645138bfa9ee","67a089198fcb4e1c8f2385786c2b296f",22856637,1,-4,0,69,41,39,-2
"67a089198fcb4e1c8f2385786c2b296f","9a0dc646f934470daf08c4b56ccf73db",22856637,1,-7,0,70,39,37,-2
"fc0e049d56024bc9a02c9a9c435c3df7","9a0dc646f934470daf08c4b56ccf73db",22856637,1,-3,0,73,38,37,-1
"9a0dc646f934470daf08c4b56ccf73db","67a089198fcb4e1c8f2385786c2b296f",22856637,1,7,0,74,37,39,2
"5c5ceeee4562457ba6d41515aeebfbb1","c33c17be71ae4d588da7369472e5bb1b",22856637,1,31,0,93,17,34,17
"b613861cecf84ffcab01afb23f660475","3f1c815879794b929260d224becaff7e",22856637,1,19,0,97,1,14,13
"3f1c815879794b929260d224becaff7e","56586aa865414f538729c7f7735d2bc6",22856637,1,-4,0,98,14,12,-2
"b7f2b31585d94eb3bf86376714aa7070","56586aa865414f538729c7f7735d2bc6",22856637,3,-2,0,100,13,12,-1
"56586aa865414f538729c7f7735d2bc6","b7f2b31585d94eb3bf86376714aa7070",22856637,7,2,0,101,12,13,1
"b7f2b31585d94eb3bf86376714aa7070","b613861cecf84ffcab01afb23f660475",22856637,1,-17,0,102,13,1,-12
"b613861cecf84ffcab01afb23f660475","67a089198fcb4e1c8f2385786c2b296f",22856637,1,72,0,103,1,39,38
"67a089198fcb4e1c8f2385786c2b296f","67a089198fcb4e1c8f2385786c2b296f",22856637,1,0,1,104,39,39,0
"67a089198fcb4e1c8f2385786c2b296f","64d48c6c9c7940639a932219a6c87198",22856637,1,1,0,105,39,40,1
"64d48c6c9c7940639a932219a6c87198","64d48c6c9c7940639a932219a6c87198",22856637,2,0,1,106,40,40,0
"64d48c6c9c7940639a932219a6c87198","56586aa865414f538729c7f7735d2bc6",22856637,2,-58,0,107,40,12,-28
"56586aa865414f538729c7f7735d2bc6","56586aa865414f538729c7f7735d2bc6",22856637,9,0,1,108,12,12,0
"b7f2b31585d94eb3bf86376714aa7070","b7f2b31585d94eb3bf86376714aa7070",22856637,6,0,1,113,13,13,0
"b7f2b31585d94eb3bf86376714aa7070","b534b89233134e30a9b5645138bfa9ee",22856637,1,59,0,115,13,41,28
"b534b89233134e30a9b5645138bfa9ee","b534b89233134e30a9b5645138bfa9ee",22856637,1,0,1,116,41,41,0
"b534b89233134e30a9b5645138bfa9ee","0e37b720d23b4e7f8b313e79313fd107",22856637,1,3,0,117,41,44,3
"0e37b720d23b4e7f8b313e79313fd107","0e37b720d23b4e7f8b313e79313fd107",22856637,1,0,1,118,44,44,0
"0e37b720d23b4e7f8b313e79313fd107","6875d67fdd5f48168b62719df449bebd",22856637,1,1,0,119,44,45,1
"6875d67fdd5f48168b62719df449bebd","6875d67fdd5f48168b62719df449bebd",22856637,1,0,1,120,45,45,0
"6875d67fdd5f48168b62719df449bebd","6e13d61a7bdb44bca949c9f86fab3be5",22856637,1,3,0,121,45,47,2
"6e13d61a7bdb44bca949c9f86fab3be5","b534b89233134e30a9b5645138bfa9ee",22856637,1,-7,0,122,47,41,-6
"b534b89233134e30a9b5645138bfa9ee","6e13d61a7bdb44bca949c9f86fab3be5",22856637,1,7,0,123,41,47,6
"6e13d61a7bdb44bca949c9f86fab3be5","6e13d61a7bdb44bca949c9f86fab3be5",22856637,1,0,1,124,47,47,0
"6e13d61a7bdb44bca949c9f86fab3be5","195f78799f984cc2b06c48dfe36be751",22856637,1,2,0,125,47,49,2
"195f78799f984cc2b06c48dfe36be751","195f78799f984cc2b06c48dfe36be751",22856637,2,0,1,126,49,49,0
"195f78799f984cc2b06c48dfe36be751","d9c8d8c444a64dadbbb508652c721e17",22856637,1,-3,0,128,49,46,-3
"d9c8d8c444a64dadbbb508652c721e17","d0c74f735e024943943e40333d6d337f",22856637,1,6,0,129,46,51,5
"d0c74f735e024943943e40333d6d337f","d0c74f735e024943943e40333d6d337f",22856637,1,0,1,130,51,51,0
"d0c74f735e024943943e40333d6d337f","983f8ff320594b279a7f4a6fe132f9c5",22856637,1,2,0,131,51,53,2
"983f8ff320594b279a7f4a6fe132f9c5","983f8ff320594b279a7f4a6fe132f9c5",22856637,2,0,1,132,53,53,0
"983f8ff320594b279a7f4a6fe132f9c5","35adfa5d923046aebabfefd98f35ff05",22856637,1,1,0,134,53,54,1
"35adfa5d923046aebabfefd98f35ff05","35adfa5d923046aebabfefd98f35ff05",22856637,5,0,1,135,54,54,0
"35adfa5d923046aebabfefd98f35ff05","b6f8a98476224da1b40e555ececc7ed8",22856637,1,1,0,140,54,55,1
"b6f8a98476224da1b40e555ececc7ed8","b6f8a98476224da1b40e555ececc7ed8",22856637,2,0,1,141,55,55,0
"b6f8a98476224da1b40e555ececc7ed8","86e22cb5fe0e4b47a9489ecddf7ed78f",22856637,1,1,0,143,55,56,1
"86e22cb5fe0e4b47a9489ecddf7ed78f","86e22cb5fe0e4b47a9489ecddf7ed78f",22856637,5,0,1,144,56,56,0
"86e22cb5fe0e4b47a9489ecddf7ed78f","a1f2f12debe5432fb7a70bcd12bacfb9",22856637,1,3,0,149,56,58,2
"a1f2f12debe5432fb7a70bcd12bacfb9","f924752d8a1149668870b1e7698486f7",22856637,1,-9,0,150,58,50,-8
"f924752d8a1149668870b1e7698486f7","78f30e4dcac84e3cbea8b2cc6e0d62b3",22856637,1,10,0,151,50,59,9
"78f30e4dcac84e3cbea8b2cc6e0d62b3","a1f2f12debe5432fb7a70bcd12bacfb9",22856637,1,-1,0,152,59,58,-1
"a1f2f12debe5432fb7a70bcd12bacfb9","a1f2f12debe5432fb7a70bcd12bacfb9",22856637,13,0,1,153,58,58,0
"a1f2f12debe5432fb7a70bcd12bacfb9","78f30e4dcac84e3cbea8b2cc6e0d62b3",22856637,1,1,0,166,58,59,1
"78f30e4dcac84e3cbea8b2cc6e0d62b3","78f30e4dcac84e3cbea8b2cc6e0d62b3",22856637,7,0,1,167,59,59,0
"78f30e4dcac84e3cbea8b2cc6e0d62b3","12aa6e1672ac4e7aa6449a7a8609cd72",22856637,1,-2,0,174,59,57,-2
"12aa6e1672ac4e7aa6449a7a8609cd72","a0a418b8540d479fa6e0f653b701da8b",22856637,1,8,0,175,57,64,7
"a0a418b8540d479fa6e0f653b701da8b","bc42d26810654ea9a1df1efe1e58c7d5",22856637,1,-1,0,176,64,63,-1
"bc42d26810654ea9a1df1efe1e58c7d5","4c943503763e4e349906eea3ed3c8e86",22856637,1,-2,0,177,63,61,-2
"4c943503763e4e349906eea3ed3c8e86","4c943503763e4e349906eea3ed3c8e86",22856637,1,0,1,178,61,61,0
"4c943503763e4e349906eea3ed3c8e86","bc42d26810654ea9a1df1efe1e58c7d5",22856637,1,2,0,179,61,63,2
"bc42d26810654ea9a1df1efe1e58c7d5","bc42d26810654ea9a1df1efe1e58c7d5",22856637,3,0,1,180,63,63,0
"bc42d26810654ea9a1df1efe1e58c7d5","a0a418b8540d479fa6e0f653b701da8b",22856637,1,1,0,183,63,64,1
"a0a418b8540d479fa6e0f653b701da8b","a0a418b8540d479fa6e0f653b701da8b",22856637,3,0,1,184,64,64,0
"a0a418b8540d479fa6e0f653b701da8b","309ccf3cc4fe429d9bfbaef53d3fa479",22856637,1,-4,0,187,64,60,-4
"309ccf3cc4fe429d9bfbaef53d3fa479","b534b89233134e30a9b5645138bfa9ee",22856637,1,-23,0,188,60,41,-19
"b534b89233134e30a9b5645138bfa9ee","d646286c8051419bbc2e31dd1db55ca8",22856637,1,33,0,189,41,67,26
"d646286c8051419bbc2e31dd1db55ca8","267f883678b24aed855fde42524975d9",22856637,1,4,0,190,67,71,4
"267f883678b24aed855fde42524975d9","267f883678b24aed855fde42524975d9",22856637,1,0,1,191,71,71,0
"267f883678b24aed855fde42524975d9","88fff56d0342490dbef9040750a20f6c",22856637,1,1,0,192,71,72,1
"88fff56d0342490dbef9040750a20f6c","88fff56d0342490dbef9040750a20f6c",22856637,3,0,1,193,72,72,0
"88fff56d0342490dbef9040750a20f6c","adb17b12b66c4a49a85fd34322f7df70",22856637,1,1,0,196,72,73,1
"adb17b12b66c4a49a85fd34322f7df70","adb17b12b66c4a49a85fd34322f7df70",22856637,1,0,1,197,73,73,0
"adb17b12b66c4a49a85fd34322f7df70","d646286c8051419bbc2e31dd1db55ca8",22856637,1,-6,0,198,73,67,-6
"d646286c8051419bbc2e31dd1db55ca8","a2becd407db34b189200a32546d9d569",22856637,1,9,0,199,67,75,8
"a2becd407db34b189200a32546d9d569","58c22b011d0f4c2ea6d13615edbb9eeb",22856637,1,2,0,200,75,77,2
"58c22b011d0f4c2ea6d13615edbb9eeb","58c22b011d0f4c2ea6d13615edbb9eeb",22856637,7,0,1,201,77,77,0
"58c22b011d0f4c2ea6d13615edbb9eeb","dd76e1861dc9461c830888729d091ee0",22856637,1,1,0,206,77,78,1
"dd76e1861dc9461c830888729d091ee0","dd76e1861dc9461c830888729d091ee0",22856637,5,0,1,207,78,78,0
"dd76e1861dc9461c830888729d091ee0","58c22b011d0f4c2ea6d13615edbb9eeb",22856637,1,-1,0,212,78,77,-1
"58c22b011d0f4c2ea6d13615edbb9eeb","cd1d828f1a694b87913a7ea66c23803e",22856637,1,2,0,215,77,79,2
"cd1d828f1a694b87913a7ea66c23803e","cd1d828f1a694b87913a7ea66c23803e",22856637,2,0,1,216,79,79,0
"cd1d828f1a694b87913a7ea66c23803e","9176a3c2b4d2465fa8b0c67096c2a97e",22856637,1,1,0,218,79,80,1
"9176a3c2b4d2465fa8b0c67096c2a97e","9176a3c2b4d2465fa8b0c67096c2a97e",22856637,11,0,1,219,80,80,0
"9176a3c2b4d2465fa8b0c67096c2a97e","f8ec6445f7194e25b9101d4fbcb07a18",22856637,1,1,0,230,80,81,1
"f8ec6445f7194e25b9101d4fbcb07a18","f8ec6445f7194e25b9101d4fbcb07a18",22856637,2,0,1,231,81,81,0
"f8ec6445f7194e25b9101d4fbcb07a18","a2becd407db34b189200a32546d9d569",22856637,1,-6,0,233,81,75,-6
"a2becd407db34b189200a32546d9d569","140d5b27b8574befad82c0a013b59dfa",22856637,1,-1,0,234,75,74,-1
"140d5b27b8574befad82c0a013b59dfa","d18a9ea32855445f8736581f5cb119ce",22856637,1,9,0,235,74,82,8
"d18a9ea32855445f8736581f5cb119ce","f564483cbd7a407681aa2fcca518cf5f",22856637,1,4,0,236,82,85,3
"f564483cbd7a407681aa2fcca518cf5f","f564483cbd7a407681aa2fcca518cf5f",22856637,1,0,1,237,85,85,0
"f564483cbd7a407681aa2fcca518cf5f","18fd01350bd5434ca636d59a599d768a",22856637,1,1,0,238,85,86,1
"18fd01350bd5434ca636d59a599d768a","18fd01350bd5434ca636d59a599d768a",22856637,9,0,1,239,86,86,0
"18fd01350bd5434ca636d59a599d768a","ae5ac430ea254e708a6f5deaaf7464ae",22856637,1,-2,0,248,86,84,-2
"ae5ac430ea254e708a6f5deaaf7464ae","6a9f0ef185fb47f0937e29daa1c71ed5",22856637,1,7,0,249,84,90,6
"6a9f0ef185fb47f0937e29daa1c71ed5","c681290961c94c4caf23b529d1ae6b9a",22856637,1,-2,0,250,90,88,-2
"c681290961c94c4caf23b529d1ae6b9a","c681290961c94c4caf23b529d1ae6b9a",22856637,1,0,1,251,88,88,0
"c681290961c94c4caf23b529d1ae6b9a","6a9f0ef185fb47f0937e29daa1c71ed5",22856637,1,2,0,252,88,90,2
"6a9f0ef185fb47f0937e29daa1c71ed5","6a9f0ef185fb47f0937e29daa1c71ed5",22856637,3,0,1,253,90,90,0
"6a9f0ef185fb47f0937e29daa1c71ed5","e20db35ced8544ddac5bc3839145e463",22856637,1,3,0,256,90,91,1
"e20db35ced8544ddac5bc3839145e463","d646286c8051419bbc2e31dd1db55ca8",22856637,1,-30,0,257,91,67,-24
"d646286c8051419bbc2e31dd1db55ca8","1febb706d7a34005ae8711ed49c76e64",22856637,1,33,0,258,67,94,27
"1febb706d7a34005ae8711ed49c76e64","1febb706d7a34005ae8711ed49c76e64",22856637,2,0,1,259,94,94,0
"1febb706d7a34005ae8711ed49c76e64","8f73ba6f5a0042f2850356ac38ac6f24",22856637,1,1,0,261,94,95,1
"8f73ba6f5a0042f2850356ac38ac6f24","8f73ba6f5a0042f2850356ac38ac6f24",22856637,5,0,1,262,95,95,0
"8f73ba6f5a0042f2850356ac38ac6f24","e2260b86653c46d7b14a41fb419dbf8c",22856637,1,1,0,267,95,96,1
"e2260b86653c46d7b14a41fb419dbf8c","e2260b86653c46d7b14a41fb419dbf8c",22856637,2,0,1,268,96,96,0
"e2260b86653c46d7b14a41fb419dbf8c","35eb641ad1d845bbba54915bce75a962",22856637,1,1,0,270,96,97,1
"35eb641ad1d845bbba54915bce75a962","35eb641ad1d845bbba54915bce75a962",22856637,5,0,1,271,97,97,0
"35eb641ad1d845bbba54915bce75a962","08be90ffbeea4795a138cd42ed8db56f",22856637,1,1,0,276,97,98,1
"08be90ffbeea4795a138cd42ed8db56f","08be90ffbeea4795a138cd42ed8db56f",22856637,6,0,1,277,98,98,0
"08be90ffbeea4795a138cd42ed8db56f","3007433c8f584dcbb5ac159c1c5f2be3",22856637,1,1,0,283,98,99,1
"3007433c8f584dcbb5ac159c1c5f2be3","3007433c8f584dcbb5ac159c1c5f2be3",22856637,6,0,1,284,99,99,0
"3007433c8f584dcbb5ac159c1c5f2be3","e20db35ced8544ddac5bc3839145e463",22856637,1,-8,0,290,99,91,-8
"e20db35ced8544ddac5bc3839145e463","00ae5f0c51874a73a41ebea838d95682",22856637,1,11,0,291,91,101,10
"00ae5f0c51874a73a41ebea838d95682","d391c8b6e56a43a7b654e9dee02d904b",22856637,1,2,0,292,101,103,2
"d391c8b6e56a43a7b654e9dee02d904b","8bdebf492ebd4e62b0d522e8ab5e5197",22856637,1,4,0,293,103,107,4
"8bdebf492ebd4e62b0d522e8ab5e5197","8bdebf492ebd4e62b0d522e8ab5e5197",22856637,6,0,1,294,107,107,0
"8bdebf492ebd4e62b0d522e8ab5e5197","2d4e0ab0ef3b4d73b82c72d4621a7579",22856637,1,-1,0,300,107,106,-1
"2d4e0ab0ef3b4d73b82c72d4621a7579","2d4e0ab0ef3b4d73b82c72d4621a7579",22856637,2,0,1,301,106,106,0
"2d4e0ab0ef3b4d73b82c72d4621a7579","a81b2235cb9c499eb9ea8ee0a8dd9725",22856637,1,-1,0,303,106,105,-1
"a81b2235cb9c499eb9ea8ee0a8dd9725","a81b2235cb9c499eb9ea8ee0a8dd9725",22856637,2,0,1,304,105,105,0
"a81b2235cb9c499eb9ea8ee0a8dd9725","6111116566fc4fd9abba409322bea245",22856637,1,-1,0,306,105,104,-1
"6111116566fc4fd9abba409322bea245","6111116566fc4fd9abba409322bea245",22856637,2,0,1,307,104,104,0
"6111116566fc4fd9abba409322bea245","d391c8b6e56a43a7b654e9dee02d904b",22856637,1,-1,0,309,104,103,-1
"d391c8b6e56a43a7b654e9dee02d904b","d391c8b6e56a43a7b654e9dee02d904b",22856637,15,0,1,310,103,103,0
"d391c8b6e56a43a7b654e9dee02d904b","00ae5f0c51874a73a41ebea838d95682",22856637,1,-2,0,325,103,101,-2
"00ae5f0c51874a73a41ebea838d95682","73039f8c1eb9409cb4caee2cf968001e",22856637,1,-1,0,326,101,100,-1
"73039f8c1eb9409cb4caee2cf968001e","4280927ec4d643238aa49c32f9e06c6c",22856637,1,10,0,327,100,109,9
"4280927ec4d643238aa49c32f9e06c6c","4280927ec4d643238aa49c32f9e06c6c",22856637,1,0,1,328,109,109,0
"4280927ec4d643238aa49c32f9e06c6c","fc44e6a5f7654430af1227838224dceb",22856637,1,2,0,329,109,111,2
"fc44e6a5f7654430af1227838224dceb","fc44e6a5f7654430af1227838224dceb",22856637,2,0,1,330,111,111,0
"fc44e6a5f7654430af1227838224dceb","08111f75e22d409998cf8b85bd431f0a",22856637,1,-3,0,332,111,108,-3
"08111f75e22d409998cf8b85bd431f0a","a9ae0a3c070d455bb4369a8996313336",22856637,1,7,0,333,108,114,6
"a9ae0a3c070d455bb4369a8996313336","71cec822bcff4f30a20e75dc63ef7b65",22856637,1,2,0,334,114,116,2
"71cec822bcff4f30a20e75dc63ef7b65","71cec822bcff4f30a20e75dc63ef7b65",22856637,1,0,1,335,116,116,0
"71cec822bcff4f30a20e75dc63ef7b65","a9ae0a3c070d455bb4369a8996313336",22856637,1,-2,0,336,116,114,-2
"a9ae0a3c070d455bb4369a8996313336","62bff51286ef4f348717a3cf6fe2318f",22856637,1,7,0,337,114,120,6
"62bff51286ef4f348717a3cf6fe2318f","37319e88176d4aefa91d7a9980dbae91",22856637,1,-9,0,338,120,112,-8
"37319e88176d4aefa91d7a9980dbae91","3ec3a3563847406fa73338f9e9999cf3",22856637,1,6,0,339,112,117,5
"3ec3a3563847406fa73338f9e9999cf3","62bff51286ef4f348717a3cf6fe2318f",22856637,2,3,0,340,117,120,3
"62bff51286ef4f348717a3cf6fe2318f","e20db35ced8544ddac5bc3839145e463",22856637,2,-33,0,341,120,91,-29
"e20db35ced8544ddac5bc3839145e463","3ec3a3563847406fa73338f9e9999cf3",22856637,1,30,0,342,91,117,26
"e20db35ced8544ddac5bc3839145e463","b1cd0e7dc3ad4a8eb91a4bfdbeb025b0",22856637,1,31,0,345,91,118,27
"b1cd0e7dc3ad4a8eb91a4bfdbeb025b0","b1cd0e7dc3ad4a8eb91a4bfdbeb025b0",22856637,2,0,1,346,118,118,0
"b1cd0e7dc3ad4a8eb91a4bfdbeb025b0","62bff51286ef4f348717a3cf6fe2318f",22856637,1,2,0,348,118,120,2
"62bff51286ef4f348717a3cf6fe2318f","62bff51286ef4f348717a3cf6fe2318f",22856637,3,0,1,349,120,120,0
"62bff51286ef4f348717a3cf6fe2318f","779f9ddd1fd14d1e9e69f72219a1fdbd",22856637,1,3,0,352,120,121,1
"779f9ddd1fd14d1e9e69f72219a1fdbd","e20db35ced8544ddac5bc3839145e463",22856637,1,-36,0,353,121,91,-30
"e20db35ced8544ddac5bc3839145e463","67a089198fcb4e1c8f2385786c2b296f",22856637,1,-67,0,354,91,39,-52
"67a089198fcb4e1c8f2385786c2b296f","779f9ddd1fd14d1e9e69f72219a1fdbd",22856637,1,103,0,355,39,121,82
"779f9ddd1fd14d1e9e69f72219a1fdbd","779f9ddd1fd14d1e9e69f72219a1fdbd",22856637,3,0,1,356,121,121,0
"779f9ddd1fd14d1e9e69f72219a1fdbd","ae26e6cda8ad4a3f81bd347560d9579f",22856637,1,4,0,357,121,125,4
"ae26e6cda8ad4a3f81bd347560d9579f","ae26e6cda8ad4a3f81bd347560d9579f",22856637,3,0,1,358,125,125,0
"ae26e6cda8ad4a3f81bd347560d9579f","ee48df95832b4374aa273ceb27ec1315",22856637,1,1,0,361,125,126,1
"ee48df95832b4374aa273ceb27ec1315","ee48df95832b4374aa273ceb27ec1315",22856637,1,0,1,362,126,126,0
"ee48df95832b4374aa273ceb27ec1315","7a439da90b394756ad1777fc4c6dead5",22856637,1,1,0,363,126,127,1
"7a439da90b394756ad1777fc4c6dead5","7a439da90b394756ad1777fc4c6dead5",22856637,1,0,1,364,127,127,0
"7a439da90b394756ad1777fc4c6dead5","779f9ddd1fd14d1e9e69f72219a1fdbd",22856637,1,-6,0,365,127,121,-6
"779f9ddd1fd14d1e9e69f72219a1fdbd","a8dd5213034441ac92724b4e83eb0bb2",22856637,2,9,0,366,121,129,8
"a8dd5213034441ac92724b4e83eb0bb2","8115eab6556b45f5b415c3b8c26a12e5",22856637,1,2,0,367,129,131,2
"8115eab6556b45f5b415c3b8c26a12e5","8115eab6556b45f5b415c3b8c26a12e5",22856637,2,0,1,368,131,131,0
"8115eab6556b45f5b415c3b8c26a12e5","ec34b06efd844b46a4c4818ecdb9b8f4",22856637,1,1,0,370,131,132,1
"ec34b06efd844b46a4c4818ecdb9b8f4","ec34b06efd844b46a4c4818ecdb9b8f4",22856637,8,0,1,371,132,132,0
"ec34b06efd844b46a4c4818ecdb9b8f4","c2e1c2b9eac64109b343a088584b576b",22856637,1,1,0,379,132,133,1
"c2e1c2b9eac64109b343a088584b576b","c2e1c2b9eac64109b343a088584b576b",22856637,2,0,1,380,133,133,0
"c2e1c2b9eac64109b343a088584b576b","a8dd5213034441ac92724b4e83eb0bb2",22856637,1,-4,0,382,133,129,-4
"a8dd5213034441ac92724b4e83eb0bb2","579338175e0b4bbb8ef3b712b5d8b54e",22856637,2,-1,0,383,129,128,-1
"579338175e0b4bbb8ef3b712b5d8b54e","8bc5795d6a984a3eace4e2811e52dd4f",22856637,1,8,0,384,128,135,7
"8bc5795d6a984a3eace4e2811e52dd4f","8bc5795d6a984a3eace4e2811e52dd4f",22856637,1,0,1,385,135,135,0
"8bc5795d6a984a3eace4e2811e52dd4f","b416d47c56a742199b5d7c7f19d6503a",22856637,1,-1,0,386,135,134,-1
"b416d47c56a742199b5d7c7f19d6503a","f661500307d74c908e9207d949ceb4aa",22856637,1,3,0,387,134,136,2
"f661500307d74c908e9207d949ceb4aa","a8dd5213034441ac92724b4e83eb0bb2",22856637,1,-9,0,388,136,129,-7
"a8dd5213034441ac92724b4e83eb0bb2","b416d47c56a742199b5d7c7f19d6503a",22856637,1,6,0,389,129,134,5
"b416d47c56a742199b5d7c7f19d6503a","579338175e0b4bbb8ef3b712b5d8b54e",22856637,1,-7,0,390,134,128,-6
"579338175e0b4bbb8ef3b712b5d8b54e","cd4532ad48034873ba8bce2aac0c9808",22856637,1,11,0,391,128,137,9
"cd4532ad48034873ba8bce2aac0c9808","cd4532ad48034873ba8bce2aac0c9808",22856637,1,0,1,392,137,137,0
"cd4532ad48034873ba8bce2aac0c9808","df1de691dafe4549a18a4398ee9dfaf9",22856637,1,4,0,393,137,139,2
"df1de691dafe4549a18a4398ee9dfaf9","779f9ddd1fd14d1e9e69f72219a1fdbd",22856637,1,-23,0,394,139,121,-18
"779f9ddd1fd14d1e9e69f72219a1fdbd","6c5ad271a44743479bfaea29b1db8d02",22856637,1,27,0,395,121,143,22
"6c5ad271a44743479bfaea29b1db8d02","83d311bed5374fee83d8d67a7d9d82dc",22856637,1,1,0,396,143,144,1
"83d311bed5374fee83d8d67a7d9d82dc","83d311bed5374fee83d8d67a7d9d82dc",22856637,1,0,1,397,144,144,0
"83d311bed5374fee83d8d67a7d9d82dc","402bba41861d43acb52a5abb89e8831e",22856637,1,1,0,398,144,145,1
"402bba41861d43acb52a5abb89e8831e","402bba41861d43acb52a5abb89e8831e",22856637,2,0,1,399,145,145,0
"402bba41861d43acb52a5abb89e8831e","6c5ad271a44743479bfaea29b1db8d02",22856637,1,-2,0,401,145,143,-2
"6c5ad271a44743479bfaea29b1db8d02","8aae34f5ddbb4052a709b12e6b0d40fa",22856637,1,5,0,402,143,147,4
"8aae34f5ddbb4052a709b12e6b0d40fa","df1de691dafe4549a18a4398ee9dfaf9",22856637,1,-9,0,403,147,139,-8
"df1de691dafe4549a18a4398ee9dfaf9","645b3f0249f64f76af2e19eb4d0e55b7",22856637,1,11,0,404,139,149,10
"645b3f0249f64f76af2e19eb4d0e55b7","645b3f0249f64f76af2e19eb4d0e55b7",22856637,6,0,1,405,149,149,0
"645b3f0249f64f76af2e19eb4d0e55b7","7e7b8db5064d4369805ab370aac5ddfb",22856637,1,1,0,411,149,150,1
"7e7b8db5064d4369805ab370aac5ddfb","7e7b8db5064d4369805ab370aac5ddfb",22856637,2,0,1,412,150,150,0
"7e7b8db5064d4369805ab370aac5ddfb","8956d210ae7f41968fada86d4c979d6a",22856637,1,1,0,414,150,151,1
"8956d210ae7f41968fada86d4c979d6a","8956d210ae7f41968fada86d4c979d6a",22856637,2,0,1,415,151,151,0
"8956d210ae7f41968fada86d4c979d6a","8aae34f5ddbb4052a709b12e6b0d40fa",22856637,1,-4,0,417,151,147,-4
"8aae34f5ddbb4052a709b12e6b0d40fa","f902b0f41b544d4dbf79664fd233648d",22856637,1,-1,0,418,147,146,-1
"f902b0f41b544d4dbf79664fd233648d","ae781e8b775e4ccd93bc800dad5c8376",22856637,1,8,0,419,146,153,7
"ae781e8b775e4ccd93bc800dad5c8376","ae781e8b775e4ccd93bc800dad5c8376",22856637,2,0,1,420,153,153,0
"ae781e8b775e4ccd93bc800dad5c8376","06882a8492d9499aa31555567f575ecb",22856637,1,1,0,422,153,154,1
"06882a8492d9499aa31555567f575ecb","06882a8492d9499aa31555567f575ecb",22856637,3,0,1,423,154,154,0
"06882a8492d9499aa31555567f575ecb","f293c508f409466a8f27ddd7d1e40b20",22856637,1,1,0,426,154,155,1
"f293c508f409466a8f27ddd7d1e40b20","f293c508f409466a8f27ddd7d1e40b20",22856637,10,0,1,427,155,155,0
"f293c508f409466a8f27ddd7d1e40b20","cc4ddef5bbbe48ebb605141b347c4ed1",22856637,1,1,0,437,155,156,1
"cc4ddef5bbbe48ebb605141b347c4ed1","cc4ddef5bbbe48ebb605141b347c4ed1",22856637,3,0,1,438,156,156,0
"cc4ddef5bbbe48ebb605141b347c4ed1","d313cec988a84645bee413e8d4724a4b",22856637,1,3,0,441,156,158,2
"d313cec988a84645bee413e8d4724a4b","f03480cf4eba413194d7af52fc0e7f28",22856637,1,-7,0,442,158,152,-6
"f03480cf4eba413194d7af52fc0e7f28","d313cec988a84645bee413e8d4724a4b",22856637,1,7,0,443,152,158,6
"d313cec988a84645bee413e8d4724a4b","d313cec988a84645bee413e8d4724a4b",22856637,3,0,1,444,158,158,0
"d313cec988a84645bee413e8d4724a4b","dc60696c76a74368a60f72246e47700d",22856637,1,1,0,447,158,159,1
"dc60696c76a74368a60f72246e47700d","dc60696c76a74368a60f72246e47700d",22856637,3,0,1,448,159,159,0
"dc60696c76a74368a60f72246e47700d","df1de691dafe4549a18a4398ee9dfaf9",22856637,1,-23,0,451,159,139,-20
"df1de691dafe4549a18a4398ee9dfaf9","78adeee1fa2c4fe0bc73f7bca9fcee86",22856637,1,26,0,452,139,160,21
"65202579580f4ad38d734b4ee39d22a8","78adeee1fa2c4fe0bc73f7bca9fcee86",22856637,2,-5,0,457,164,160,-4
"65202579580f4ad38d734b4ee39d22a8","8959e6304a0348309a771e4d08d1b64a",22856637,1,-1,0,462,164,163,-1
"8959e6304a0348309a771e4d08d1b64a","65202579580f4ad38d734b4ee39d22a8",22856637,1,1,0,463,163,164,1
"65202579580f4ad38d734b4ee39d22a8","3cbcea2be0984e7dbd5a48195af10ce7",22856637,1,3,0,519,164,165,1
"3cbcea2be0984e7dbd5a48195af10ce7","78adeee1fa2c4fe0bc73f7bca9fcee86",22856637,1,-8,0,520,165,160,-5
"78adeee1fa2c4fe0bc73f7bca9fcee86","82e6285962b8400d9d6fc32436022a94",22856637,1,10,0,521,160,167,7
"82e6285962b8400d9d6fc32436022a94","a9ac840f098c4bd0a2ee896214ce29cd",22856637,1,3,0,522,167,168,1
"a9ac840f098c4bd0a2ee896214ce29cd","a9ac840f098c4bd0a2ee896214ce29cd",22856637,1,0,1,523,168,168,0
"a9ac840f098c4bd0a2ee896214ce29cd","0c7262dff33c4087bc660ccf40f92f9c",22856637,1,4,0,524,168,169,1
"0c7262dff33c4087bc660ccf40f92f9c","a9ac840f098c4bd0a2ee896214ce29cd",22856637,1,-4,0,525,169,168,-1
"a9ac840f098c4bd0a2ee896214ce29cd","b2275c3fad834f8d90737a2d9a6927d6",22856637,1,7,0,526,168,172,4
"b2275c3fad834f8d90737a2d9a6927d6","3cbcea2be0984e7dbd5a48195af10ce7",22856637,1,-12,0,527,172,165,-7
"82e6285962b8400d9d6fc32436022a94","c33c17be71ae4d588da7369472e5bb1b",22856637,1,-178,0,530,167,34,-133
"c33c17be71ae4d588da7369472e5bb1b","c33c17be71ae4d588da7369472e5bb1b",22856637,2,0,1,531,34,34,0
"c33c17be71ae4d588da7369472e5bb1b","b613861cecf84ffcab01afb23f660475",22856637,2,-56,0,532,34,1,-33
"b613861cecf84ffcab01afb23f660475","779f9ddd1fd14d1e9e69f72219a1fdbd",22856637,1,175,0,534,1,121,120
"579338175e0b4bbb8ef3b712b5d8b54e","0c7262dff33c4087bc660ccf40f92f9c",22856637,1,58,0,539,128,169,41
"0c7262dff33c4087bc660ccf40f92f9c","0c7262dff33c4087bc660ccf40f92f9c",22856637,1,0,1,540,169,169,0
"0c7262dff33c4087bc660ccf40f92f9c","b2275c3fad834f8d90737a2d9a6927d6",22856637,1,3,0,541,169,172,3
"b2275c3fad834f8d90737a2d9a6927d6","b2275c3fad834f8d90737a2d9a6927d6",22856637,30,0,1,542,172,172,0
"b2275c3fad834f8d90737a2d9a6927d6","eb515a26030b41f8a82a1e6114420bad",22856637,1,1,0,572,172,173,1
"eb515a26030b41f8a82a1e6114420bad","eb515a26030b41f8a82a1e6114420bad",22856637,5,0,1,573,173,173,0
"eb515a26030b41f8a82a1e6114420bad","b42cc17b7de840f181a704558d0bc845",22856637,1,3,0,578,173,175,2
"b42cc17b7de840f181a704558d0bc845","0c7262dff33c4087bc660ccf40f92f9c",22856637,1,-7,0,579,175,169,-6
"0c7262dff33c4087bc660ccf40f92f9c","b42cc17b7de840f181a704558d0bc845",22856637,1,7,0,580,169,175,6
"b42cc17b7de840f181a704558d0bc845","b42cc17b7de840f181a704558d0bc845",22856637,3,0,1,581,175,175,0
"b42cc17b7de840f181a704558d0bc845","801f9e9135034f49bf5f8b4bdefedb41",22856637,1,2,0,583,175,177,2
"801f9e9135034f49bf5f8b4bdefedb41","801f9e9135034f49bf5f8b4bdefedb41",22856637,4,0,1,584,177,177,0
"801f9e9135034f49bf5f8b4bdefedb41","ea38cc0e6e6e41edbabf210220808bf9",22856637,1,3,0,588,177,179,2
"ea38cc0e6e6e41edbabf210220808bf9","362fcb0699a14845ab29b2340093e528",22856637,1,-6,0,589,179,174,-5
"362fcb0699a14845ab29b2340093e528","b42cc17b7de840f181a704558d0bc845",22856637,1,1,0,590,174,175,1
"b42cc17b7de840f181a704558d0bc845","139b097acfca451689d80c9c6eebdf7b",22856637,1,4,0,591,175,178,3
"139b097acfca451689d80c9c6eebdf7b","b87c552dd247427abe6ab5795b9c9d43",22856637,1,3,0,592,178,181,3
"b87c552dd247427abe6ab5795b9c9d43","b42cc17b7de840f181a704558d0bc845",22856637,1,-7,0,593,181,175,-6
"b42cc17b7de840f181a704558d0bc845","362fcb0699a14845ab29b2340093e528",22856637,1,-1,0,595,175,174,-1
"362fcb0699a14845ab29b2340093e528","ea38cc0e6e6e41edbabf210220808bf9",22856637,1,6,0,596,174,179,5
"ea38cc0e6e6e41edbabf210220808bf9","b87c552dd247427abe6ab5795b9c9d43",22856637,1,2,0,597,179,181,2
"b87c552dd247427abe6ab5795b9c9d43","b87c552dd247427abe6ab5795b9c9d43",22856637,8,0,1,598,181,181,0
"b87c552dd247427abe6ab5795b9c9d43","ea38cc0e6e6e41edbabf210220808bf9",22856637,1,-2,0,606,181,179,-2
"ea38cc0e6e6e41edbabf210220808bf9","ea38cc0e6e6e41edbabf210220808bf9",22856637,1,0,1,607,179,179,0
"ea38cc0e6e6e41edbabf210220808bf9","139b097acfca451689d80c9c6eebdf7b",22856637,1,-1,0,608,179,178,-1
"139b097acfca451689d80c9c6eebdf7b","30f660a1feb34582a739722532524f79",22856637,1,6,0,609,178,183,5
"30f660a1feb34582a739722532524f79","30f660a1feb34582a739722532524f79",22856637,7,0,1,610,183,183,0
"30f660a1feb34582a739722532524f79","2024b4885bd14338a39b7b509acbbd02",22856637,1,-1,0,617,183,182,-1
"2024b4885bd14338a39b7b509acbbd02","0c7262dff33c4087bc660ccf40f92f9c",22856637,1,-16,0,618,182,169,-13
"0c7262dff33c4087bc660ccf40f92f9c","c8e371568a0c4391b25796ae4e91952e",22856637,2,23,0,619,169,186,17
"c8e371568a0c4391b25796ae4e91952e","c8e371568a0c4391b25796ae4e91952e",22856637,2,0,1,620,186,186,0
"c8e371568a0c4391b25796ae4e91952e","0c7262dff33c4087bc660ccf40f92f9c",22856637,2,-23,0,621,186,169,-17
"0c7262dff33c4087bc660ccf40f92f9c","c3f63fe50d8e487c86bf8ef76c9cadd3",22856637,2,20,0,622,169,185,16
"c3f63fe50d8e487c86bf8ef76c9cadd3","c3f63fe50d8e487c86bf8ef76c9cadd3",22856637,5,0,1,623,185,185,0
"c3f63fe50d8e487c86bf8ef76c9cadd3","c8e371568a0c4391b25796ae4e91952e",22856637,1,3,0,627,185,186,1
"c3f63fe50d8e487c86bf8ef76c9cadd3","0c7262dff33c4087bc660ccf40f92f9c",22856637,1,-20,0,631,185,169,-16
"c8e371568a0c4391b25796ae4e91952e","7d932b23e1c84326ae5aa4d3c0d813d1",22856637,1,2,0,634,186,188,2
"7d932b23e1c84326ae5aa4d3c0d813d1","7d932b23e1c84326ae5aa4d3c0d813d1",22856637,1,0,1,635,188,188,0
"7d932b23e1c84326ae5aa4d3c0d813d1","ab11d94c6c8948ea90b88f19d2cd502b",22856637,1,3,0,636,188,190,2
"ab11d94c6c8948ea90b88f19d2cd502b","c8e371568a0c4391b25796ae4e91952e",22856637,3,-5,0,637,190,186,-4
"c8e371568a0c4391b25796ae4e91952e","f992451ed6ad4e68bb9e68ad6be7c4be",22856637,1,7,0,638,186,192,6
"f992451ed6ad4e68bb9e68ad6be7c4be","f992451ed6ad4e68bb9e68ad6be7c4be",22856637,3,0,1,639,192,192,0
"f992451ed6ad4e68bb9e68ad6be7c4be","07b44a7a51e94c78b411c753fc39dab0",22856637,1,-3,0,642,192,189,-3
"07b44a7a51e94c78b411c753fc39dab0","c8e371568a0c4391b25796ae4e91952e",22856637,1,-4,0,643,189,186,-3
"c8e371568a0c4391b25796ae4e91952e","ab11d94c6c8948ea90b88f19d2cd502b",22856637,2,5,0,644,186,190,4
"c8e371568a0c4391b25796ae4e91952e","07b44a7a51e94c78b411c753fc39dab0",22856637,1,4,0,648,186,189,3
"07b44a7a51e94c78b411c753fc39dab0","ab11d94c6c8948ea90b88f19d2cd502b",22856637,1,1,0,649,189,190,1
"ab11d94c6c8948ea90b88f19d2cd502b","ab11d94c6c8948ea90b88f19d2cd502b",22856637,4,0,1,650,190,190,0
"ab11d94c6c8948ea90b88f19d2cd502b","07b44a7a51e94c78b411c753fc39dab0",22856637,1,-1,0,654,190,189,-1
"07b44a7a51e94c78b411c753fc39dab0","6cd2dcaac46847d4a0bc53f296d90375",22856637,1,6,0,655,189,194,5
"6cd2dcaac46847d4a0bc53f296d90375","2d2580c9411c4972909db508d6956a58",22856637,1,2,0,656,194,196,2
"2d2580c9411c4972909db508d6956a58","2d2580c9411c4972909db508d6956a58",22856637,2,0,1,657,196,196,0
"2d2580c9411c4972909db508d6956a58","5bddb3d9ed264f3984702f048c7e5340",22856637,1,1,0,659,196,197,1
"5bddb3d9ed264f3984702f048c7e5340","5bddb3d9ed264f3984702f048c7e5340",22856637,2,0,1,660,197,197,0
"5bddb3d9ed264f3984702f048c7e5340","d5e8e2bd12a2466b9d6d90855f0eb079",22856637,1,1,0,662,197,198,1
"d5e8e2bd12a2466b9d6d90855f0eb079","d5e8e2bd12a2466b9d6d90855f0eb079",22856637,2,0,1,663,198,198,0
"d5e8e2bd12a2466b9d6d90855f0eb079","6cd2dcaac46847d4a0bc53f296d90375",22856637,1,-4,0,665,198,194,-4
"6cd2dcaac46847d4a0bc53f296d90375","017d7ca8e0394b91aaadc9574df2202c",22856637,1,-1,0,666,194,193,-1
"017d7ca8e0394b91aaadc9574df2202c","54e8e9f0ea3e45c4bf3b8ac799ee31b1",22856637,1,8,0,667,193,200,7
"54e8e9f0ea3e45c4bf3b8ac799ee31b1","54e8e9f0ea3e45c4bf3b8ac799ee31b1",22856637,1,0,1,668,200,200,0
"54e8e9f0ea3e45c4bf3b8ac799ee31b1","a6c21bd8b95249c7972820a7a7d76aff",22856637,1,2,0,669,200,202,2
"a6c21bd8b95249c7972820a7a7d76aff","a6c21bd8b95249c7972820a7a7d76aff",22856637,1,0,1,670,202,202,0
"a6c21bd8b95249c7972820a7a7d76aff","bb329d880ab54120adaf203a693bb203",22856637,1,1,0,671,202,203,1
"bb329d880ab54120adaf203a693bb203","bb329d880ab54120adaf203a693bb203",22856637,1,0,1,672,203,203,0
"bb329d880ab54120adaf203a693bb203","f9170dd6bc6442b4acd832747609b09a",22856637,1,-4,0,673,203,199,-4
"f9170dd6bc6442b4acd832747609b09a","334c2344009840079b1d0e1b7ce3d5a7",22856637,1,7,0,674,199,205,6
"334c2344009840079b1d0e1b7ce3d5a7","334c2344009840079b1d0e1b7ce3d5a7",22856637,1,0,1,675,205,205,0
"334c2344009840079b1d0e1b7ce3d5a7","b54257a550b94ebc9538f3a90eee9d7e",22856637,1,-1,0,676,205,204,-1
"b54257a550b94ebc9538f3a90eee9d7e","c614a00911be4877a075f19315530fb0",22856637,1,-4,0,677,204,201,-3
"c614a00911be4877a075f19315530fb0","c614a00911be4877a075f19315530fb0",22856637,6,0,1,678,201,201,0
"c614a00911be4877a075f19315530fb0","f9170dd6bc6442b4acd832747609b09a",22856637,1,-2,0,684,201,199,-2
"f9170dd6bc6442b4acd832747609b09a","d7f13c8d63ec4e2aa673fbb9cf9c6933",22856637,1,10,0,685,199,206,7
"d7f13c8d63ec4e2aa673fbb9cf9c6933","c8e371568a0c4391b25796ae4e91952e",22856637,1,-26,0,686,206,186,-20
"c8e371568a0c4391b25796ae4e91952e","b9e80f77c3a44349863b19875725c384",22856637,1,27,0,687,186,207,21
"b9e80f77c3a44349863b19875725c384","7108f0e4c2584f1f9c471689ae4c885c",22856637,2,1,0,688,207,208,1
"7108f0e4c2584f1f9c471689ae4c885c","b9e80f77c3a44349863b19875725c384",22856637,2,-1,0,689,208,207,-1
"b9e80f77c3a44349863b19875725c384","b9e80f77c3a44349863b19875725c384",22856637,13,0,1,690,207,207,0
"7108f0e4c2584f1f9c471689ae4c885c","7108f0e4c2584f1f9c471689ae4c885c",22856637,10,0,1,702,208,208,0
"7108f0e4c2584f1f9c471689ae4c885c","d7f13c8d63ec4e2aa673fbb9cf9c6933",22856637,1,-2,0,712,208,206,-2
"d7f13c8d63ec4e2aa673fbb9cf9c6933","09400e101c5d4b439cf9a26b03aae558",22856637,2,5,0,713,206,210,4
"09400e101c5d4b439cf9a26b03aae558","a875096404ef4a9984b62d74cda916f9",22856637,2,-1,0,714,210,209,-1
"a875096404ef4a9984b62d74cda916f9","7108f0e4c2584f1f9c471689ae4c885c",22856637,1,-2,0,715,209,208,-1
"b9e80f77c3a44349863b19875725c384","d7f13c8d63ec4e2aa673fbb9cf9c6933",22856637,1,-1,0,719,207,206,-1
"09400e101c5d4b439cf9a26b03aae558","a88efa7e50ce47159810ab553afa6d3a",22856637,1,2,0,721,210,212,2
"a88efa7e50ce47159810ab553afa6d3a","a88efa7e50ce47159810ab553afa6d3a",22856637,5,0,1,722,212,212,0
"a88efa7e50ce47159810ab553afa6d3a","09400e101c5d4b439cf9a26b03aae558",22856637,1,-2,0,727,212,210,-2
"09400e101c5d4b439cf9a26b03aae558","09400e101c5d4b439cf9a26b03aae558",22856637,2,0,1,728,210,210,0
"a875096404ef4a9984b62d74cda916f9","be502a7a43c44bf7b682698de79d9369",22856637,1,6,0,731,209,214,5
"be502a7a43c44bf7b682698de79d9369","f7fb1952f56b4189b86a9f8b7862d2b8",22856637,1,1,0,732,214,215,1
"f7fb1952f56b4189b86a9f8b7862d2b8","f7fb1952f56b4189b86a9f8b7862d2b8",22856637,14,0,1,733,215,215,0
"f7fb1952f56b4189b86a9f8b7862d2b8","b860ee85d8bc4a2f97958cfb71be3533",22856637,1,1,0,747,215,216,1
"b860ee85d8bc4a2f97958cfb71be3533","b860ee85d8bc4a2f97958cfb71be3533",22856637,7,0,1,748,216,216,0
"b860ee85d8bc4a2f97958cfb71be3533","be502a7a43c44bf7b682698de79d9369",22856637,1,-2,0,753,216,214,-2
"be502a7a43c44bf7b682698de79d9369","b860ee85d8bc4a2f97958cfb71be3533",22856637,1,2,0,754,214,216,2
"b860ee85d8bc4a2f97958cfb71be3533","ec341f459285443b8361f7f15638ff08",22856637,1,-3,0,757,216,213,-3
"ec341f459285443b8361f7f15638ff08","363837c182e04711840d896ae1e0339c",22856637,1,6,0,758,213,218,5
"363837c182e04711840d896ae1e0339c","363837c182e04711840d896ae1e0339c",22856637,27,0,1,759,218,218,0
"363837c182e04711840d896ae1e0339c","01b2051f8941460d89945e3b02d1ce78",22856637,3,-1,0,774,218,217,-1
"01b2051f8941460d89945e3b02d1ce78","be95c065e45447c1bd8215ea6f130c7a",22856637,2,3,0,775,217,219,2
"be95c065e45447c1bd8215ea6f130c7a","363837c182e04711840d896ae1e0339c",22856637,2,-2,0,776,219,218,-1
"01b2051f8941460d89945e3b02d1ce78","91125ca626c5470eb145501f8c37f8db",22856637,1,4,0,790,217,220,3
"91125ca626c5470eb145501f8c37f8db","91125ca626c5470eb145501f8c37f8db",22856637,1,0,1,791,220,220,0
"91125ca626c5470eb145501f8c37f8db","d7f13c8d63ec4e2aa673fbb9cf9c6933",22856637,1,-18,0,792,220,206,-14
"d7f13c8d63ec4e2aa673fbb9cf9c6933","1c6721b1f63f4d30ba7746ea8af02a52",22856637,1,21,0,793,206,221,15
"1c6721b1f63f4d30ba7746ea8af02a52","0c7262dff33c4087bc660ccf40f92f9c",22856637,1,-70,0,794,221,169,-52
"0c7262dff33c4087bc660ccf40f92f9c","77ecef8eff6b4a2caea7707669bf7475",22856637,1,71,0,795,169,222,53
"77ecef8eff6b4a2caea7707669bf7475","01b2051f8941460d89945e3b02d1ce78",22856637,1,-8,0,796,222,217,-5
"01b2051f8941460d89945e3b02d1ce78","d7f13c8d63ec4e2aa673fbb9cf9c6933",22856637,1,-14,0,797,217,206,-11
"d7f13c8d63ec4e2aa673fbb9cf9c6933","363837c182e04711840d896ae1e0339c",22856637,1,15,0,798,206,218,12
"363837c182e04711840d896ae1e0339c","0c7262dff33c4087bc660ccf40f92f9c",22856637,1,-64,0,802,218,169,-49
"0c7262dff33c4087bc660ccf40f92f9c","1c6721b1f63f4d30ba7746ea8af02a52",22856637,1,70,0,803,169,221,52
"1c6721b1f63f4d30ba7746ea8af02a52","1c6721b1f63f4d30ba7746ea8af02a52",22856637,1,0,1,804,221,221,0
"1c6721b1f63f4d30ba7746ea8af02a52","77ecef8eff6b4a2caea7707669bf7475",22856637,1,1,0,805,221,222,1
"77ecef8eff6b4a2caea7707669bf7475","77ecef8eff6b4a2caea7707669bf7475",22856637,12,0,1,806,222,222,0
"77ecef8eff6b4a2caea7707669bf7475","1c6721b1f63f4d30ba7746ea8af02a52",22856637,1,-1,0,818,222,221,-1
"1c6721b1f63f4d30ba7746ea8af02a52","d03cb855c70044cf8c35d9ec0de696e3",22856637,1,4,0,819,221,224,3
"d03cb855c70044cf8c35d9ec0de696e3","8b9ae98743bd4d4a8a87dff1c1244211",22856637,1,3,0,820,224,227,3
"8b9ae98743bd4d4a8a87dff1c1244211","a49a937d6896486d9a5396654abcf2e1",22856637,1,-1,0,821,227,226,-1
"a49a937d6896486d9a5396654abcf2e1","a49a937d6896486d9a5396654abcf2e1",22856637,3,0,1,822,226,226,0
"a49a937d6896486d9a5396654abcf2e1","8b9ae98743bd4d4a8a87dff1c1244211",22856637,1,1,0,825,226,227,1
"8b9ae98743bd4d4a8a87dff1c1244211","8b9ae98743bd4d4a8a87dff1c1244211",22856637,21,0,1,826,227,227,0
"8b9ae98743bd4d4a8a87dff1c1244211","d03cb855c70044cf8c35d9ec0de696e3",22856637,1,-3,0,847,227,224,-3
"d03cb855c70044cf8c35d9ec0de696e3","d03cb855c70044cf8c35d9ec0de696e3",22856637,1,0,1,848,224,224,0
"d03cb855c70044cf8c35d9ec0de696e3","2ab1535aac1346ba8801535bf729ef37",22856637,1,6,0,849,224,229,5
"2ab1535aac1346ba8801535bf729ef37","f7906d6f59b9489a91d2ef40db5a474d",22856637,1,-7,0,850,229,223,-6
"f7906d6f59b9489a91d2ef40db5a474d","a4f40fb48a8542c8949bae1f002cd9bc",22856637,1,9,0,851,223,231,8
"a4f40fb48a8542c8949bae1f002cd9bc","a4f40fb48a8542c8949bae1f002cd9bc",22856637,2,0,1,852,231,231,0
"a4f40fb48a8542c8949bae1f002cd9bc","8972c23e32044edb8a78fa1eed4e5947",22856637,1,1,0,854,231,232,1
"8972c23e32044edb8a78fa1eed4e5947","8972c23e32044edb8a78fa1eed4e5947",22856637,3,0,1,855,232,232,0
"8972c23e32044edb8a78fa1eed4e5947","92feb4a40f8344d38b6f722e42a53295",22856637,1,1,0,858,232,233,1
"92feb4a40f8344d38b6f722e42a53295","92feb4a40f8344d38b6f722e42a53295",22856637,2,0,1,859,233,233,0
"92feb4a40f8344d38b6f722e42a53295","2ab1535aac1346ba8801535bf729ef37",22856637,1,-4,0,861,233,229,-4
"2ab1535aac1346ba8801535bf729ef37","5152833676bf4c6cb317060be10f68db",22856637,1,-1,0,862,229,228,-1
"5152833676bf4c6cb317060be10f68db","ca3e28f290354c08aefe5b0f769604e6",22856637,1,8,0,863,228,235,7
"ca3e28f290354c08aefe5b0f769604e6","ca3e28f290354c08aefe5b0f769604e6",22856637,14,0,1,864,235,235,0
"ca3e28f290354c08aefe5b0f769604e6","79a35eea833e4c2c9d22fc53c3c6445c",22856637,1,1,0,878,235,236,1
"79a35eea833e4c2c9d22fc53c3c6445c","79a35eea833e4c2c9d22fc53c3c6445c",22856637,14,0,1,879,236,236,0
"79a35eea833e4c2c9d22fc53c3c6445c","8f68228b1518449e9615cdafee41a2bd",22856637,1,1,0,893,236,237,1
"8f68228b1518449e9615cdafee41a2bd","8f68228b1518449e9615cdafee41a2bd",22856637,1,0,1,894,237,237,0
"8f68228b1518449e9615cdafee41a2bd","cab89fa5c3ed45a5aa550fc0352d6a42",22856637,1,1,0,895,237,238,1
"cab89fa5c3ed45a5aa550fc0352d6a42","cab89fa5c3ed45a5aa550fc0352d6a42",22856637,3,0,1,896,238,238,0
"cab89fa5c3ed45a5aa550fc0352d6a42","66d4fad4f1cf4b46be0750a99ad7a35a",22856637,1,1,0,899,238,239,1
"66d4fad4f1cf4b46be0750a99ad7a35a","66d4fad4f1cf4b46be0750a99ad7a35a",22856637,1,0,1,900,239,239,0
"66d4fad4f1cf4b46be0750a99ad7a35a","0b04c8e2f86d48c7aeb7e225819cd32b",22856637,1,-5,0,901,239,234,-5
"0b04c8e2f86d48c7aeb7e225819cd32b","f53da5fd9bfe412da4b80d4742563b6c",22856637,1,8,0,902,234,241,7
"f53da5fd9bfe412da4b80d4742563b6c","f53da5fd9bfe412da4b80d4742563b6c",22856637,1,0,1,903,241,241,0
"f53da5fd9bfe412da4b80d4742563b6c","2ae94c0cea4d480a9d5dca8fb1d7b542",22856637,1,3,0,904,241,242,1
"2ae94c0cea4d480a9d5dca8fb1d7b542","1c6721b1f63f4d30ba7746ea8af02a52",22856637,1,-27,0,905,242,221,-21
"1c6721b1f63f4d30ba7746ea8af02a52","1ebf23f9d994469a85206e4c7b1bf5f5",22856637,1,30,0,906,221,245,24
"1ebf23f9d994469a85206e4c7b1bf5f5","1ebf23f9d994469a85206e4c7b1bf5f5",22856637,10,0,1,907,245,245,0
"1ebf23f9d994469a85206e4c7b1bf5f5","85ae675b83e8422da842cfd25596af99",22856637,1,1,0,917,245,246,1
"85ae675b83e8422da842cfd25596af99","85ae675b83e8422da842cfd25596af99",22856637,1,0,1,918,246,246,0
"85ae675b83e8422da842cfd25596af99","fa235f0f364d47e4ae1c87f47bf8e6ba",22856637,1,8,0,919,246,252,6
"fa235f0f364d47e4ae1c87f47bf8e6ba","2ae94c0cea4d480a9d5dca8fb1d7b542",22856637,1,-12,0,920,252,242,-10
"2ae94c0cea4d480a9d5dca8fb1d7b542","79f7845465cc4ed19d8e4f1429541be0",22856637,1,14,0,921,242,254,12
"79f7845465cc4ed19d8e4f1429541be0","79f7845465cc4ed19d8e4f1429541be0",22856637,2,0,1,922,254,254,0
"79f7845465cc4ed19d8e4f1429541be0","fa235f0f364d47e4ae1c87f47bf8e6ba",22856637,1,-2,0,924,254,252,-2
"fa235f0f364d47e4ae1c87f47bf8e6ba","fa235f0f364d47e4ae1c87f47bf8e6ba",22856637,1,0,1,925,252,252,0
"fa235f0f364d47e4ae1c87f47bf8e6ba","00f61990949545828dd12f1303d47504",22856637,1,5,0,926,252,256,4
"00f61990949545828dd12f1303d47504","6e83e23f56544a19b94067c1c558d9c0",22856637,1,-11,0,927,256,247,-9
"6e83e23f56544a19b94067c1c558d9c0","ead7bb4b64e247d2ae632ab8a296b091",22856637,1,13,0,928,247,258,11
"ead7bb4b64e247d2ae632ab8a296b091","ead7bb4b64e247d2ae632ab8a296b091",22856637,2,0,1,929,258,258,0
"ead7bb4b64e247d2ae632ab8a296b091","41b0048dde734bb280bac6116baa8e27",22856637,1,1,0,931,258,259,1
"41b0048dde734bb280bac6116baa8e27","41b0048dde734bb280bac6116baa8e27",22856637,6,0,1,932,259,259,0
"41b0048dde734bb280bac6116baa8e27","b41c5a094a604ee0915327da5cc0beb7",22856637,1,1,0,938,259,260,1
"b41c5a094a604ee0915327da5cc0beb7","b41c5a094a604ee0915327da5cc0beb7",22856637,2,0,1,939,260,260,0
"b41c5a094a604ee0915327da5cc0beb7","00f61990949545828dd12f1303d47504",22856637,1,-4,0,941,260,256,-4
"00f61990949545828dd12f1303d47504","d546341988904f069cfa86b21457d9d9",22856637,1,-6,0,942,256,251,-5
"d546341988904f069cfa86b21457d9d9","28c171777c52431ab6b925073bd63d46",22856637,1,15,0,943,251,264,13
"28c171777c52431ab6b925073bd63d46","28c171777c52431ab6b925073bd63d46",22856637,10,0,1,944,264,264,0
"28c171777c52431ab6b925073bd63d46","ac160db940cb49ae8579162b1d52bb5d",22856637,2,2,0,951,264,266,2
"ac160db940cb49ae8579162b1d52bb5d","ac160db940cb49ae8579162b1d52bb5d",22856637,9,0,1,952,266,266,0
"ac160db940cb49ae8579162b1d52bb5d","d989ebcfc12a4b669f0100dc1aa14f1e",22856637,2,-12,0,959,266,255,-11
"d989ebcfc12a4b669f0100dc1aa14f1e","7aa76d3e993840d8805f097cbdbcd44b",22856637,1,7,0,960,255,261,6
"7aa76d3e993840d8805f097cbdbcd44b","28c171777c52431ab6b925073bd63d46",22856637,1,3,0,961,261,264,3
"d989ebcfc12a4b669f0100dc1aa14f1e","ac160db940cb49ae8579162b1d52bb5d",22856637,1,12,0,969,255,266,11
"ac160db940cb49ae8579162b1d52bb5d","c6fd49b485cc4874b0bbdd9c6171e09c",22856637,1,3,0,970,266,268,2
"c6fd49b485cc4874b0bbdd9c6171e09c","c6fd49b485cc4874b0bbdd9c6171e09c",22856637,8,0,1,971,268,268,0
"c6fd49b485cc4874b0bbdd9c6171e09c","44240778a97c4af0937817499b75707b",22856637,1,1,0,979,268,269,1
"44240778a97c4af0937817499b75707b","44240778a97c4af0937817499b75707b",22856637,5,0,1,980,269,269,0
"44240778a97c4af0937817499b75707b","7aa76d3e993840d8805f097cbdbcd44b",22856637,1,-9,0,985,269,261,-8
"7aa76d3e993840d8805f097cbdbcd44b","865a4d3b43374da7944dc7d397f566d9",22856637,1,12,0,986,261,271,10
"865a4d3b43374da7944dc7d397f566d9","865a4d3b43374da7944dc7d397f566d9",22856637,1,0,1,987,271,271,0
"865a4d3b43374da7944dc7d397f566d9","2ae94c0cea4d480a9d5dca8fb1d7b542",22856637,1,-35,0,988,271,242,-29
"2ae94c0cea4d480a9d5dca8fb1d7b542","0d987bed3ffa4ed0b9a2e62e97b7b30f",22856637,1,38,0,989,242,272,30
"0d987bed3ffa4ed0b9a2e62e97b7b30f","0d987bed3ffa4ed0b9a2e62e97b7b30f",22856637,1,0,1,990,272,272,0
"bb5a47f5ea01454a8b79455422d3b9da","bc5524e78a8544e2ae2fdc2f3462bbec",22856637,1,-1,0,1000,280,279,-1
"bc5524e78a8544e2ae2fdc2f3462bbec","0d987bed3ffa4ed0b9a2e62e97b7b30f",22856637,1,-9,0,1001,279,272,-7
"0d987bed3ffa4ed0b9a2e62e97b7b30f","bb5a47f5ea01454a8b79455422d3b9da",22856637,3,10,0,1002,272,280,8
"bb5a47f5ea01454a8b79455422d3b9da","bb5a47f5ea01454a8b79455422d3b9da",22856637,83,0,1,1003,280,280,0
"bb5a47f5ea01454a8b79455422d3b9da","82ae07bc0c9b4570a41799290d1ef399",22856637,2,-6,0,1009,280,275,-5
"82ae07bc0c9b4570a41799290d1ef399","bb5a47f5ea01454a8b79455422d3b9da",22856637,3,6,0,1010,275,280,5
"bb5a47f5ea01454a8b79455422d3b9da","3cbcea2be0984e7dbd5a48195af10ce7",22856637,1,-154,0,1061,280,165,-115
"3cbcea2be0984e7dbd5a48195af10ce7","3cbcea2be0984e7dbd5a48195af10ce7",22856637,3,0,1,1062,165,165,0
"3cbcea2be0984e7dbd5a48195af10ce7","82e6285962b8400d9d6fc32436022a94",22856637,3,2,0,1063,165,167,2
"82e6285962b8400d9d6fc32436022a94","8959e6304a0348309a771e4d08d1b64a",22856637,1,-6,0,1064,167,163,-4
"8959e6304a0348309a771e4d08d1b64a","78adeee1fa2c4fe0bc73f7bca9fcee86",22856637,1,-4,0,1065,163,160,-3
"78adeee1fa2c4fe0bc73f7bca9fcee86","65202579580f4ad38d734b4ee39d22a8",22856637,4,5,0,1066,160,164,4
"65202579580f4ad38d734b4ee39d22a8","65202579580f4ad38d734b4ee39d22a8",22856637,68,0,1,1067,164,164,0
"65202579580f4ad38d734b4ee39d22a8","94cecc3f1e7d484b8e068e79241dfd73",22856637,1,160,0,1076,164,281,117
"94cecc3f1e7d484b8e068e79241dfd73","94cecc3f1e7d484b8e068e79241dfd73",22856637,2,0,1,1077,281,281,0
"94cecc3f1e7d484b8e068e79241dfd73","a37477c4e4c14169ad44b06b493007f6",22856637,2,2,0,1078,281,283,2
"a37477c4e4c14169ad44b06b493007f6","94cecc3f1e7d484b8e068e79241dfd73",22856637,1,-2,0,1079,283,281,-2
"94cecc3f1e7d484b8e068e79241dfd73","0d987bed3ffa4ed0b9a2e62e97b7b30f",22856637,1,-13,0,1080,281,272,-9
"bb5a47f5ea01454a8b79455422d3b9da","0d987bed3ffa4ed0b9a2e62e97b7b30f",22856637,1,-10,0,1089,280,272,-8
"0d987bed3ffa4ed0b9a2e62e97b7b30f","82ae07bc0c9b4570a41799290d1ef399",22856637,1,4,0,1090,272,275,3
"82ae07bc0c9b4570a41799290d1ef399","82ae07bc0c9b4570a41799290d1ef399",22856637,1,0,1,1091,275,275,0
"bb5a47f5ea01454a8b79455422d3b9da","fab84b4fab5940efb4ea868ef8d09396",22856637,1,8,0,1100,280,284,4
"fab84b4fab5940efb4ea868ef8d09396","fab84b4fab5940efb4ea868ef8d09396",22856637,3,0,1,1101,284,284,0
"fab84b4fab5940efb4ea868ef8d09396","4a29443515bb404cb8924e1c60a63b73",22856637,1,4,0,1104,284,285,1
"4a29443515bb404cb8924e1c60a63b73","4a29443515bb404cb8924e1c60a63b73",22856637,3,0,1,1105,285,285,0
"4a29443515bb404cb8924e1c60a63b73","208c9b2796c944db8dacaa96082520ea",22856637,2,3,0,1106,285,288,3
"208c9b2796c944db8dacaa96082520ea","208c9b2796c944db8dacaa96082520ea",22856637,5,0,1,1107,288,288,0
"208c9b2796c944db8dacaa96082520ea","6a9a3b5bde4a48daa896fe8c06eca56f",22856637,1,2,0,1109,288,289,1
"6a9a3b5bde4a48daa896fe8c06eca56f","208c9b2796c944db8dacaa96082520ea",22856637,1,-2,0,1110,289,288,-1
"208c9b2796c944db8dacaa96082520ea","4a29443515bb404cb8924e1c60a63b73",22856637,2,-3,0,1111,288,285,-3
"4a29443515bb404cb8924e1c60a63b73","7669a956527947d0add87455277e80b4",22856637,2,7,0,1113,285,291,6
"7669a956527947d0add87455277e80b4","7669a956527947d0add87455277e80b4",22856637,3,0,1,1114,291,291,0
"7669a956527947d0add87455277e80b4","6a9a3b5bde4a48daa896fe8c06eca56f",22856637,1,-2,0,1116,291,289,-2
"6a9a3b5bde4a48daa896fe8c06eca56f","869e967078f04da18dd0b0b9389a7424",22856637,2,5,0,1117,289,293,4
"869e967078f04da18dd0b0b9389a7424","51ab6291537748fab90d519aa09889d6",22856637,1,2,0,1118,293,295,2
"51ab6291537748fab90d519aa09889d6","51ab6291537748fab90d519aa09889d6",22856637,5,0,1,1119,295,295,0
"51ab6291537748fab90d519aa09889d6","34a6e49023fc4465bd5ca604330bbd1c",22856637,1,-3,0,1124,295,292,-3
"34a6e49023fc4465bd5ca604330bbd1c","869e967078f04da18dd0b0b9389a7424",22856637,1,1,0,1125,292,293,1
"869e967078f04da18dd0b0b9389a7424","21592f2a9e9c4b2f8c66ec5dbcbf6a2b",22856637,1,4,0,1126,293,296,3
"21592f2a9e9c4b2f8c66ec5dbcbf6a2b","34a6e49023fc4465bd5ca604330bbd1c",22856637,1,-5,0,1127,296,292,-4
"34a6e49023fc4465bd5ca604330bbd1c","94cecc3f1e7d484b8e068e79241dfd73",22856637,1,-18,0,1128,292,281,-11
"a37477c4e4c14169ad44b06b493007f6","0d987bed3ffa4ed0b9a2e62e97b7b30f",22856637,1,-15,0,1131,283,272,-11
"0d987bed3ffa4ed0b9a2e62e97b7b30f","bc5524e78a8544e2ae2fdc2f3462bbec",22856637,1,9,0,1132,272,279,7
"bc5524e78a8544e2ae2fdc2f3462bbec","bb5a47f5ea01454a8b79455422d3b9da",22856637,1,1,0,1133,279,280,1
"bb5a47f5ea01454a8b79455422d3b9da","4a29443515bb404cb8924e1c60a63b73",22856637,1,12,0,1141,280,285,5
"7669a956527947d0add87455277e80b4","869e967078f04da18dd0b0b9389a7424",22856637,1,3,0,1150,291,293,2
"869e967078f04da18dd0b0b9389a7424","6a9a3b5bde4a48daa896fe8c06eca56f",22856637,1,-5,0,1151,293,289,-4
"869e967078f04da18dd0b0b9389a7424","34a6e49023fc4465bd5ca604330bbd1c",22856637,1,-1,0,1153,293,292,-1
"34a6e49023fc4465bd5ca604330bbd1c","ba0e59461bfb4a44b7b1c28a01f8d3b3",22856637,1,9,0,1154,292,299,7
"ba0e59461bfb4a44b7b1c28a01f8d3b3","21592f2a9e9c4b2f8c66ec5dbcbf6a2b",22856637,1,-4,0,1155,299,296,-3
"21592f2a9e9c4b2f8c66ec5dbcbf6a2b","0e0b36e731a645e7b1b8a88f5031ca38",22856637,1,6,0,1156,296,301,5
"0e0b36e731a645e7b1b8a88f5031ca38","0e0b36e731a645e7b1b8a88f5031ca38",22856637,7,0,1,1157,301,301,0
"0e0b36e731a645e7b1b8a88f5031ca38","ba0e59461bfb4a44b7b1c28a01f8d3b3",22856637,1,-2,0,1162,301,299,-2
"ba0e59461bfb4a44b7b1c28a01f8d3b3","0e0b36e731a645e7b1b8a88f5031ca38",22856637,1,2,0,1163,299,301,2
"0e0b36e731a645e7b1b8a88f5031ca38","a66a144637284c21afc6de17fea4bfb8",22856637,1,1,0,1166,301,302,1
"a66a144637284c21afc6de17fea4bfb8","a66a144637284c21afc6de17fea4bfb8",22856637,2,0,1,1167,302,302,0
"a66a144637284c21afc6de17fea4bfb8","7646a919d7e64fa990bca9b024ff089d",22856637,1,-4,0,1169,302,298,-4
"7646a919d7e64fa990bca9b024ff089d","e390b575229748ea8aac9364efe2bf00",22856637,1,7,0,1170,298,304,6
"e390b575229748ea8aac9364efe2bf00","e390b575229748ea8aac9364efe2bf00",22856637,1,0,1,1171,304,304,0
"e390b575229748ea8aac9364efe2bf00","4a29443515bb404cb8924e1c60a63b73",22856637,1,-24,0,1172,304,285,-19
"4a29443515bb404cb8924e1c60a63b73","3434c10e561d488a914e0f7d71907abd",22856637,1,27,0,1173,285,305,20
"3434c10e561d488a914e0f7d71907abd","53e7e900392747ccad52e711ab0f80d8",22856637,1,2,0,1174,305,307,2
"53e7e900392747ccad52e711ab0f80d8","53e7e900392747ccad52e711ab0f80d8",22856637,1,0,1,1175,307,307,0
"53e7e900392747ccad52e711ab0f80d8","130acc2aeb0448fdbb2de63bc5cebe5b",22856637,1,3,0,1176,307,309,2
"130acc2aeb0448fdbb2de63bc5cebe5b","3434c10e561d488a914e0f7d71907abd",22856637,1,-5,0,1177,309,305,-4
"3434c10e561d488a914e0f7d71907abd","130acc2aeb0448fdbb2de63bc5cebe5b",22856637,1,5,0,1178,305,309,4
"130acc2aeb0448fdbb2de63bc5cebe5b","9c062b3251034ebe90f5054e2a3b5120",22856637,1,2,0,1179,309,311,2
"9c062b3251034ebe90f5054e2a3b5120","9c062b3251034ebe90f5054e2a3b5120",22856637,2,0,1,1180,311,311,0
"9c062b3251034ebe90f5054e2a3b5120","ea859f8207e44537889daeaba13ac2e8",22856637,1,1,0,1182,311,312,1
"ea859f8207e44537889daeaba13ac2e8","ea859f8207e44537889daeaba13ac2e8",22856637,7,0,1,1183,312,312,0
"ea859f8207e44537889daeaba13ac2e8","56d94971a7a94257aa330183a8ebd0ea",22856637,1,1,0,1190,312,313,1
"56d94971a7a94257aa330183a8ebd0ea","56d94971a7a94257aa330183a8ebd0ea",22856637,1,0,1,1191,313,313,0
"56d94971a7a94257aa330183a8ebd0ea","141c0df6cd1946539aadd1c9b7068cd4",22856637,1,-5,0,1192,313,308,-5
"141c0df6cd1946539aadd1c9b7068cd4","13255e63e0aa4abf85e5211bf613d43e",22856637,1,10,0,1193,308,317,9
"13255e63e0aa4abf85e5211bf613d43e","13255e63e0aa4abf85e5211bf613d43e",22856637,1,0,1,1194,317,317,0
"13255e63e0aa4abf85e5211bf613d43e","86c27d40179e419c8e9d150fb6afa5d0",22856637,1,3,0,1195,317,319,2
"86c27d40179e419c8e9d150fb6afa5d0","0c787d16c9504873b1a4d903cec09948",22856637,1,-6,0,1196,319,314,-5
"0c787d16c9504873b1a4d903cec09948","86c27d40179e419c8e9d150fb6afa5d0",22856637,1,6,0,1197,314,319,5
"86c27d40179e419c8e9d150fb6afa5d0","47edbb64109243e6b0f8f64cdef90c6c",22856637,1,8,0,1198,319,326,7
"47edbb64109243e6b0f8f64cdef90c6c","8d7e0b55cf9849cda222a0f2440cec55",22856637,1,-9,0,1199,326,318,-8
"8d7e0b55cf9849cda222a0f2440cec55","24f1363179ad4aaa965484a78471912b",22856637,1,6,0,1200,318,323,5
"24f1363179ad4aaa965484a78471912b","24f1363179ad4aaa965484a78471912b",22856637,1,0,1,1201,323,323,0
"24f1363179ad4aaa965484a78471912b","3628bdce1dd2429ba924d2d4d09448d2",22856637,1,-1,0,1202,323,322,-1
"3628bdce1dd2429ba924d2d4d09448d2","56b3fd1a212a4764be39d979fde3326e",22856637,1,7,0,1203,322,328,6
"56b3fd1a212a4764be39d979fde3326e","56b3fd1a212a4764be39d979fde3326e",22856637,1,0,1,1204,328,328,0
"56b3fd1a212a4764be39d979fde3326e","3434c10e561d488a914e0f7d71907abd",22856637,1,-28,0,1205,328,305,-23
"3434c10e561d488a914e0f7d71907abd","0c4079457ede49e3aeb5e86ed84bdf35",22856637,1,31,0,1206,305,329,24
"0c4079457ede49e3aeb5e86ed84bdf35","38aea304b4fa46e1b29bb72f5cea4c93",22856637,1,2,0,1207,329,331,2
"38aea304b4fa46e1b29bb72f5cea4c93","38aea304b4fa46e1b29bb72f5cea4c93",22856637,1,0,1,1208,331,331,0
"38aea304b4fa46e1b29bb72f5cea4c93","e36d261332f14e79bb4b467aceaeb9b5",22856637,1,2,0,1209,331,333,2
"e36d261332f14e79bb4b467aceaeb9b5","e36d261332f14e79bb4b467aceaeb9b5",22856637,4,0,1,1210,333,333,0
"e36d261332f14e79bb4b467aceaeb9b5","c7e89b9d04744d2eab742fc24e3ef1ae",22856637,1,1,0,1214,333,334,1
"c7e89b9d04744d2eab742fc24e3ef1ae","c7e89b9d04744d2eab742fc24e3ef1ae",22856637,2,0,1,1215,334,334,0
"c7e89b9d04744d2eab742fc24e3ef1ae","fe49f8054b374a0ea4bb266ed135ff62",22856637,1,1,0,1217,334,335,1
"fe49f8054b374a0ea4bb266ed135ff62","fe49f8054b374a0ea4bb266ed135ff62",22856637,2,0,1,1218,335,335,0
"fe49f8054b374a0ea4bb266ed135ff62","d0a8f74af98642fe8360d22c42e45117",22856637,1,1,0,1220,335,336,1
"d0a8f74af98642fe8360d22c42e45117","d0a8f74af98642fe8360d22c42e45117",22856637,2,0,1,1221,336,336,0
"d0a8f74af98642fe8360d22c42e45117","0c4079457ede49e3aeb5e86ed84bdf35",22856637,1,-7,0,1223,336,329,-7
"0c4079457ede49e3aeb5e86ed84bdf35","a7c6339ca1da4368a18d471f0519f877",22856637,1,11,0,1224,329,339,10
"a7c6339ca1da4368a18d471f0519f877","a7c6339ca1da4368a18d471f0519f877",22856637,1,0,1,1225,339,339,0
"a7c6339ca1da4368a18d471f0519f877","b8b9418ab322418d9db9b40d96af873a",22856637,1,-2,0,1226,339,337,-2
"b8b9418ab322418d9db9b40d96af873a","bbc5139ca9024389a94db3a6f47dcff6",22856637,1,5,0,1227,337,341,4
"bbc5139ca9024389a94db3a6f47dcff6","bbc5139ca9024389a94db3a6f47dcff6",22856637,1,0,1,1228,341,341,0
"bbc5139ca9024389a94db3a6f47dcff6","4ee6ca9019ab4a1ab323f98094a9bd77",22856637,1,2,0,1229,341,343,2
"4ee6ca9019ab4a1ab323f98094a9bd77","4ee6ca9019ab4a1ab323f98094a9bd77",22856637,8,0,1,1230,343,343,0
"4ee6ca9019ab4a1ab323f98094a9bd77","b37947176785476f8b29d49a851366dc",22856637,1,1,0,1238,343,344,1
"b37947176785476f8b29d49a851366dc","b37947176785476f8b29d49a851366dc",22856637,2,0,1,1239,344,344,0
"b37947176785476f8b29d49a851366dc","fcea5b10d5a14a3b9324ffece8f6e1e5",22856637,1,1,0,1241,344,345,1
"fcea5b10d5a14a3b9324ffece8f6e1e5","fcea5b10d5a14a3b9324ffece8f6e1e5",22856637,5,0,1,1242,345,345,0
"fcea5b10d5a14a3b9324ffece8f6e1e5","c2490bc612d146edbe786556fab3651b",22856637,1,-5,0,1247,345,340,-5
"c2490bc612d146edbe786556fab3651b","6ac8bb048b854999a47edb35fe627f11",22856637,1,8,0,1248,340,347,7
"6ac8bb048b854999a47edb35fe627f11","6ac8bb048b854999a47edb35fe627f11",22856637,1,0,1,1249,347,347,0
"6ac8bb048b854999a47edb35fe627f11","0c4079457ede49e3aeb5e86ed84bdf35",22856637,1,-21,0,1250,347,329,-18
"0c4079457ede49e3aeb5e86ed84bdf35","30ead9794d4847abaf222ca966cc8630",22856637,1,24,0,1251,329,348,19
"30ead9794d4847abaf222ca966cc8630","09b9678ddc3d452ea4a3d46e15826065",22856637,1,5,0,1252,348,353,5
"09b9678ddc3d452ea4a3d46e15826065","897b7f51242c44aab2205c72fdcbf4cd",22856637,1,-1,0,1253,353,352,-1
"897b7f51242c44aab2205c72fdcbf4cd","eff0de7f2dbb42dfa1a2e686efab5b6d",22856637,1,2,0,1254,352,354,2
"eff0de7f2dbb42dfa1a2e686efab5b6d","c20993c944444fe085345591a8bd837e",22856637,1,-3,0,1255,354,351,-3
"c20993c944444fe085345591a8bd837e","c20993c944444fe085345591a8bd837e",22856637,4,0,1,1256,351,351,0
"c20993c944444fe085345591a8bd837e","897b7f51242c44aab2205c72fdcbf4cd",22856637,1,1,0,1260,351,352,1
"897b7f51242c44aab2205c72fdcbf4cd","897b7f51242c44aab2205c72fdcbf4cd",22856637,3,0,1,1261,352,352,0
"897b7f51242c44aab2205c72fdcbf4cd","09b9678ddc3d452ea4a3d46e15826065",22856637,1,1,0,1264,352,353,1
"09b9678ddc3d452ea4a3d46e15826065","09b9678ddc3d452ea4a3d46e15826065",22856637,3,0,1,1265,353,353,0
"09b9678ddc3d452ea4a3d46e15826065","eff0de7f2dbb42dfa1a2e686efab5b6d",22856637,1,1,0,1268,353,354,1
"eff0de7f2dbb42dfa1a2e686efab5b6d","eff0de7f2dbb42dfa1a2e686efab5b6d",22856637,3,0,1,1269,354,354,0
"eff0de7f2dbb42dfa1a2e686efab5b6d","30ead9794d4847abaf222ca966cc8630",22856637,1,-6,0,1272,354,348,-6
"30ead9794d4847abaf222ca966cc8630","2fe14166dc9642c3bc666b86a57f943d",22856637,1,10,0,1273,348,357,9
"2fe14166dc9642c3bc666b86a57f943d","44421dd1e13a47a388c4a19834b744c7",22856637,1,2,0,1274,357,359,2
"44421dd1e13a47a388c4a19834b744c7","44421dd1e13a47a388c4a19834b744c7",22856637,2,0,1,1275,359,359,0
"44421dd1e13a47a388c4a19834b744c7","cb5fc7ef85d547c4be1a7439d0bf6052",22856637,1,1,0,1277,359,360,1
"cb5fc7ef85d547c4be1a7439d0bf6052","cb5fc7ef85d547c4be1a7439d0bf6052",22856637,5,0,1,1278,360,360,0
"cb5fc7ef85d547c4be1a7439d0bf6052","0a8f150a4cf747acbde62f4721823da3",22856637,1,1,0,1283,360,361,1
"0a8f150a4cf747acbde62f4721823da3","0a8f150a4cf747acbde62f4721823da3",22856637,5,0,1,1284,361,361,0
"0a8f150a4cf747acbde62f4721823da3","ab8fdad974ae471f9f24c3f9dd04462e",22856637,1,1,0,1289,361,362,1
"ab8fdad974ae471f9f24c3f9dd04462e","ab8fdad974ae471f9f24c3f9dd04462e",22856637,2,0,1,1290,362,362,0
"ab8fdad974ae471f9f24c3f9dd04462e","2fe14166dc9642c3bc666b86a57f943d",22856637,1,-5,0,1292,362,357,-5
"2fe14166dc9642c3bc666b86a57f943d","52580888dadb4fe3baa795683ea227bd",22856637,1,8,0,1293,357,364,7
"52580888dadb4fe3baa795683ea227bd","1ba8fef685d74a8194b9db252eb704fb",22856637,1,-10,0,1294,364,355,-9
"1ba8fef685d74a8194b9db252eb704fb","52580888dadb4fe3baa795683ea227bd",22856637,1,10,0,1295,355,364,9
"52580888dadb4fe3baa795683ea227bd","52580888dadb4fe3baa795683ea227bd",22856637,1,0,1,1296,364,364,0
"52580888dadb4fe3baa795683ea227bd","f00179e251a045b39c3f7a54f9aa4acc",22856637,1,-1,0,1297,364,363,-1
"f00179e251a045b39c3f7a54f9aa4acc","492a3bc6a1254f23a7998587961b22a4",22856637,1,4,0,1298,363,366,3
"492a3bc6a1254f23a7998587961b22a4","492a3bc6a1254f23a7998587961b22a4",22856637,1,0,1,1299,366,366,0
"492a3bc6a1254f23a7998587961b22a4","072a190fd302456290895f9f04d6940a",22856637,1,-1,0,1300,366,365,-1
"072a190fd302456290895f9f04d6940a","cfa457d1743848e4bb5e4beced6448ed",22856637,1,5,0,1301,365,369,4
"cfa457d1743848e4bb5e4beced6448ed","cfa457d1743848e4bb5e4beced6448ed",22856637,1,0,1,1302,369,369,0
"cfa457d1743848e4bb5e4beced6448ed","30ead9794d4847abaf222ca966cc8630",22856637,1,-25,0,1303,369,348,-21
"30ead9794d4847abaf222ca966cc8630","b71bac264efb4abd97015447bd490db6",22856637,1,28,0,1304,348,370,22
"b71bac264efb4abd97015447bd490db6","4a29443515bb404cb8924e1c60a63b73",22856637,1,-110,0,1305,370,285,-85
"4a29443515bb404cb8924e1c60a63b73","b71bac264efb4abd97015447bd490db6",22856637,1,110,0,1306,285,370,85
"b71bac264efb4abd97015447bd490db6","b71bac264efb4abd97015447bd490db6",22856637,1,0,1,1307,370,370,0
"b71bac264efb4abd97015447bd490db6","8d448d625b024c82a5eb240bbd7431d6",22856637,4,5,0,1308,370,374,4
"8d448d625b024c82a5eb240bbd7431d6","8d448d625b024c82a5eb240bbd7431d6",22856637,65,0,1,1309,374,374,0
"8d448d625b024c82a5eb240bbd7431d6","b71bac264efb4abd97015447bd490db6",22856637,2,-5,0,1311,374,370,-4
"8d448d625b024c82a5eb240bbd7431d6","d6d02b6ef04e4f17805504500b8ce441",22856637,1,3,0,1362,374,375,1
"d6d02b6ef04e4f17805504500b8ce441","b71bac264efb4abd97015447bd490db6",22856637,3,-8,0,1363,375,370,-5
"b71bac264efb4abd97015447bd490db6","d6d02b6ef04e4f17805504500b8ce441",22856637,3,8,0,1364,370,375,5
"d6d02b6ef04e4f17805504500b8ce441","d6d02b6ef04e4f17805504500b8ce441",22856637,13,0,1,1365,375,375,0
"d6d02b6ef04e4f17805504500b8ce441","66baf19b6b904b70922329068c63746d",22856637,2,4,0,1366,375,376,1
"66baf19b6b904b70922329068c63746d","7f544639412e40a9ba27f43b415362ab",22856637,2,2,0,1367,376,378,2
"7f544639412e40a9ba27f43b415362ab","d6d02b6ef04e4f17805504500b8ce441",22856637,1,-6,0,1368,378,375,-3
"d6d02b6ef04e4f17805504500b8ce441","4a29443515bb404cb8924e1c60a63b73",22856637,1,-118,0,1386,375,285,-90
"4a29443515bb404cb8924e1c60a63b73","3628bdce1dd2429ba924d2d4d09448d2",22856637,1,48,0,1387,285,322,37
"3628bdce1dd2429ba924d2d4d09448d2","3434c10e561d488a914e0f7d71907abd",22856637,1,-21,0,1388,322,305,-17
"3434c10e561d488a914e0f7d71907abd","47edbb64109243e6b0f8f64cdef90c6c",22856637,1,25,0,1389,305,326,21
"47edbb64109243e6b0f8f64cdef90c6c","24f1363179ad4aaa965484a78471912b",22856637,1,-3,0,1390,326,323,-3
"24f1363179ad4aaa965484a78471912b","d6d02b6ef04e4f17805504500b8ce441",22856637,1,69,0,1391,323,375,52
"7f544639412e40a9ba27f43b415362ab","d5ae8642e15b46b8bd298b02274d4e9c",22856637,1,2,0,1399,378,380,2
"d5ae8642e15b46b8bd298b02274d4e9c","d5ae8642e15b46b8bd298b02274d4e9c",22856637,1,0,1,1400,380,380,0
"d5ae8642e15b46b8bd298b02274d4e9c","a0d10309a2dd456289147f84be9d37f9",22856637,1,1,0,1401,380,381,1
"a0d10309a2dd456289147f84be9d37f9","a0d10309a2dd456289147f84be9d37f9",22856637,2,0,1,1402,381,381,0
"a0d10309a2dd456289147f84be9d37f9","0fcbc3ca07b144138b8d85da581f09a8",22856637,1,1,0,1404,381,382,1
"0fcbc3ca07b144138b8d85da581f09a8","0fcbc3ca07b144138b8d85da581f09a8",22856637,2,0,1,1405,382,382,0
"0fcbc3ca07b144138b8d85da581f09a8","7f544639412e40a9ba27f43b415362ab",22856637,1,-4,0,1407,382,378,-4
"7f544639412e40a9ba27f43b415362ab","7f544639412e40a9ba27f43b415362ab",22856637,1,0,1,1408,378,378,0
"7f544639412e40a9ba27f43b415362ab","66baf19b6b904b70922329068c63746d",22856637,1,-2,0,1409,378,376,-2
"66baf19b6b904b70922329068c63746d","c2fca3669923477ab966ded303dea31c",22856637,1,8,0,1410,376,383,7
"c2fca3669923477ab966ded303dea31c","4890121ce5d74576b4632b77cfc23398",22856637,1,6,0,1411,383,388,5
"4890121ce5d74576b4632b77cfc23398","4890121ce5d74576b4632b77cfc23398",22856637,1,0,1,1412,388,388,0
"4890121ce5d74576b4632b77cfc23398","18d3b836dd804224883cc9180b60a8e1",22856637,1,-1,0,1413,388,387,-1
"18d3b836dd804224883cc9180b60a8e1","96bb2b3e85a34d8b9544514e89f6fe97",22856637,2,4,0,1414,387,390,3
"96bb2b3e85a34d8b9544514e89f6fe97","4890121ce5d74576b4632b77cfc23398",22856637,1,-3,0,1415,390,388,-2
"4890121ce5d74576b4632b77cfc23398","17f95d18bab743888e1736033dc3384d",22856637,1,2,0,1416,388,389,1
"17f95d18bab743888e1736033dc3384d","18d3b836dd804224883cc9180b60a8e1",22856637,1,-3,0,1417,389,387,-2
"96bb2b3e85a34d8b9544514e89f6fe97","3cbcea2be0984e7dbd5a48195af10ce7",22856637,1,-305,0,1419,390,165,-225
"82e6285962b8400d9d6fc32436022a94","17f95d18bab743888e1736033dc3384d",22856637,1,302,0,1422,167,389,222
"17f95d18bab743888e1736033dc3384d","66baf19b6b904b70922329068c63746d",22856637,1,-16,0,1423,389,376,-13
"66baf19b6b904b70922329068c63746d","96bb2b3e85a34d8b9544514e89f6fe97",22856637,1,17,0,1424,376,390,14
"96bb2b3e85a34d8b9544514e89f6fe97","96bb2b3e85a34d8b9544514e89f6fe97",22856637,1,0,1,1425,390,390,0
"96bb2b3e85a34d8b9544514e89f6fe97","ac4e9b54acfe4670b4634859c7263cb5",22856637,1,2,0,1426,390,392,2
"ac4e9b54acfe4670b4634859c7263cb5","ac4e9b54acfe4670b4634859c7263cb5",22856637,1,0,1,1427,392,392,0
"ac4e9b54acfe4670b4634859c7263cb5","6f8881a745ac4c358a68b92c3b4abe81",22856637,1,3,0,1428,392,394,2
"6f8881a745ac4c358a68b92c3b4abe81","17f95d18bab743888e1736033dc3384d",22856637,1,-6,0,1429,394,389,-5
"17f95d18bab743888e1736033dc3384d","6f8881a745ac4c358a68b92c3b4abe81",22856637,1,6,0,1430,389,394,5
"6f8881a745ac4c358a68b92c3b4abe81","f7002c8484354eceac57bc7bd62c76c1",22856637,1,-1,0,1431,394,393,-1
"f7002c8484354eceac57bc7bd62c76c1","44a277ea44dc4ae689fab4b82f0b4098",22856637,1,5,0,1432,393,397,4
"44a277ea44dc4ae689fab4b82f0b4098","44a277ea44dc4ae689fab4b82f0b4098",22856637,1,0,1,1433,397,397,0
"44a277ea44dc4ae689fab4b82f0b4098","0c12af0a4e7f4002852cf84b2537c161",22856637,1,-2,0,1434,397,395,-2
"0c12af0a4e7f4002852cf84b2537c161","859e0b8d71694b12befb69ee698138f9",22856637,1,5,0,1435,395,399,4
"859e0b8d71694b12befb69ee698138f9","859e0b8d71694b12befb69ee698138f9",22856637,1,0,1,1436,399,399,0
"859e0b8d71694b12befb69ee698138f9","66baf19b6b904b70922329068c63746d",22856637,1,-29,0,1437,399,376,-23
"66baf19b6b904b70922329068c63746d","2b09a08242b54983aec7063990fb3f66",22856637,2,32,0,1438,376,400,24
"2b09a08242b54983aec7063990fb3f66","2b09a08242b54983aec7063990fb3f66",22856637,6,0,1,1439,400,400,0
"2b09a08242b54983aec7063990fb3f66","66baf19b6b904b70922329068c63746d",22856637,1,-32,0,1440,400,376,-24
"66baf19b6b904b70922329068c63746d","c5df9f40ec14463b9dcfdc73df3e9285",22856637,1,132,0,1441,376,464,88
"c5df9f40ec14463b9dcfdc73df3e9285","c5df9f40ec14463b9dcfdc73df3e9285",22856637,3,0,1,1442,464,464,0
"c5df9f40ec14463b9dcfdc73df3e9285","d6d02b6ef04e4f17805504500b8ce441",22856637,1,-136,0,1444,464,375,-89
"d6d02b6ef04e4f17805504500b8ce441","2b09a08242b54983aec7063990fb3f66",22856637,1,36,0,1448,375,400,25
"2b09a08242b54983aec7063990fb3f66","1f471b7a883a4df48211e8c6a81b59a7",22856637,1,1,0,1453,400,401,1
"1f471b7a883a4df48211e8c6a81b59a7","1f471b7a883a4df48211e8c6a81b59a7",22856637,1,0,1,1454,401,401,0
"1f471b7a883a4df48211e8c6a81b59a7","2b09a08242b54983aec7063990fb3f66",22856637,1,-1,0,1455,401,400,-1
"2b09a08242b54983aec7063990fb3f66","9de0d567bfa84fe5b77cb76f4a76a5d1",22856637,1,5,0,1456,400,404,4
"9de0d567bfa84fe5b77cb76f4a76a5d1","9de0d567bfa84fe5b77cb76f4a76a5d1",22856637,2,0,1,1457,404,404,0
"9de0d567bfa84fe5b77cb76f4a76a5d1","1157bd665ec4472fb58b751dc5099355",22856637,2,-1,0,1458,404,403,-1
"1157bd665ec4472fb58b751dc5099355","3c8a22d2f9c146ea956609e3ed4f2559",22856637,3,3,0,1459,403,405,2
"3c8a22d2f9c146ea956609e3ed4f2559","58fc9094275e4c49be3f4ba6d4acc0a4",22856637,2,2,0,1460,405,406,1
"58fc9094275e4c49be3f4ba6d4acc0a4","58fc9094275e4c49be3f4ba6d4acc0a4",22856637,2,0,1,1461,406,406,0
"58fc9094275e4c49be3f4ba6d4acc0a4","9de0d567bfa84fe5b77cb76f4a76a5d1",22856637,1,-4,0,1462,406,404,-2
"1157bd665ec4472fb58b751dc5099355","66baf19b6b904b70922329068c63746d",22856637,2,-36,0,1465,403,376,-27
"66baf19b6b904b70922329068c63746d","3c8a22d2f9c146ea956609e3ed4f2559",22856637,1,39,0,1466,376,405,29
"3c8a22d2f9c146ea956609e3ed4f2559","2b09a08242b54983aec7063990fb3f66",22856637,2,-7,0,1467,405,400,-5
"2b09a08242b54983aec7063990fb3f66","1157bd665ec4472fb58b751dc5099355",22856637,4,4,0,1469,400,403,3
"1157bd665ec4472fb58b751dc5099355","1157bd665ec4472fb58b751dc5099355",22856637,2,0,1,1470,403,403,0
"58fc9094275e4c49be3f4ba6d4acc0a4","c1c1be90b2b14c1ab4a5e1ee3c241902",22856637,1,1,0,1474,406,407,1
"c1c1be90b2b14c1ab4a5e1ee3c241902","c1c1be90b2b14c1ab4a5e1ee3c241902",22856637,5,0,1,1475,407,407,0
"c1c1be90b2b14c1ab4a5e1ee3c241902","02b3a1bead9244c1ba2f857c7da8f82a",22856637,1,2,0,1480,407,408,1
"02b3a1bead9244c1ba2f857c7da8f82a","58fc9094275e4c49be3f4ba6d4acc0a4",22856637,1,-3,0,1481,408,406,-2
"58fc9094275e4c49be3f4ba6d4acc0a4","02b3a1bead9244c1ba2f857c7da8f82a",22856637,1,3,0,1482,406,408,2
"02b3a1bead9244c1ba2f857c7da8f82a","02b3a1bead9244c1ba2f857c7da8f82a",22856637,1,0,1,1483,408,408,0
"02b3a1bead9244c1ba2f857c7da8f82a","3c8a22d2f9c146ea956609e3ed4f2559",22856637,1,-5,0,1484,408,405,-3
"3c8a22d2f9c146ea956609e3ed4f2559","02b3a1bead9244c1ba2f857c7da8f82a",22856637,1,5,0,1485,405,408,3
"02b3a1bead9244c1ba2f857c7da8f82a","6206fc6479014bb193084c32409dc1b9",22856637,1,1,0,1486,408,409,1
"6206fc6479014bb193084c32409dc1b9","6206fc6479014bb193084c32409dc1b9",22856637,4,0,1,1487,409,409,0
"6206fc6479014bb193084c32409dc1b9","6a5f020451db426dacba9e2ea3fcc62a",22856637,1,2,0,1491,409,410,1
"6a5f020451db426dacba9e2ea3fcc62a","02b3a1bead9244c1ba2f857c7da8f82a",22856637,1,-3,0,1492,410,408,-2
"02b3a1bead9244c1ba2f857c7da8f82a","6a5f020451db426dacba9e2ea3fcc62a",22856637,1,3,0,1493,408,410,2
"6a5f020451db426dacba9e2ea3fcc62a","6a5f020451db426dacba9e2ea3fcc62a",22856637,1,0,1,1494,410,410,0
"6a5f020451db426dacba9e2ea3fcc62a","33a9d248b2e44588a5b07fc1342b9bc2",22856637,1,2,0,1495,410,411,1
"33a9d248b2e44588a5b07fc1342b9bc2","33a9d248b2e44588a5b07fc1342b9bc2",22856637,1,0,1,1496,411,411,0
"33a9d248b2e44588a5b07fc1342b9bc2","c6f26bd420634f1cb7989e76fe6b16c0",22856637,1,1,0,1497,411,412,1
"c6f26bd420634f1cb7989e76fe6b16c0","c6f26bd420634f1cb7989e76fe6b16c0",22856637,5,0,1,1498,412,412,0
"c6f26bd420634f1cb7989e76fe6b16c0","2a65ee6e2ac64f6a8a55fbe5373ec763",22856637,1,1,0,1503,412,413,1
"2a65ee6e2ac64f6a8a55fbe5373ec763","2a65ee6e2ac64f6a8a55fbe5373ec763",22856637,2,0,1,1504,413,413,0
"2a65ee6e2ac64f6a8a55fbe5373ec763","33a9d248b2e44588a5b07fc1342b9bc2",22856637,1,-2,0,1506,413,411,-2
"33a9d248b2e44588a5b07fc1342b9bc2","1fd0f6dadbc14ebc965faf6122190b96",22856637,1,5,0,1507,411,415,4
"1fd0f6dadbc14ebc965faf6122190b96","1fd0f6dadbc14ebc965faf6122190b96",22856637,1,0,1,1508,415,415,0
"1fd0f6dadbc14ebc965faf6122190b96","687055dad9fc40c3982478fe33ec01bf",22856637,1,-1,0,1509,415,414,-1
"687055dad9fc40c3982478fe33ec01bf","2add1669f08d4101913db15f8c23b3b7",22856637,1,3,0,1510,414,416,2
"2add1669f08d4101913db15f8c23b3b7","2add1669f08d4101913db15f8c23b3b7",22856637,1,0,1,1511,416,416,0
"2add1669f08d4101913db15f8c23b3b7","2b09a08242b54983aec7063990fb3f66",22856637,1,-24,0,1512,416,400,-16
"2b09a08242b54983aec7063990fb3f66","a2b4bd40cee2481ebd3fc179d6a5cd62",22856637,1,27,0,1513,400,417,17
"a2b4bd40cee2481ebd3fc179d6a5cd62","66baf19b6b904b70922329068c63746d",22856637,1,-59,0,1514,417,376,-41
"1157bd665ec4472fb58b751dc5099355","2b09a08242b54983aec7063990fb3f66",22856637,1,-4,0,1521,403,400,-3
"66baf19b6b904b70922329068c63746d","a2b4bd40cee2481ebd3fc179d6a5cd62",22856637,1,59,0,1524,376,417,41
"a2b4bd40cee2481ebd3fc179d6a5cd62","a2b4bd40cee2481ebd3fc179d6a5cd62",22856637,1,0,1,1525,417,417,0
"a2b4bd40cee2481ebd3fc179d6a5cd62","e34e59dce2204f228f3a84b6725df60f",22856637,1,2,0,1526,417,419,2
"e34e59dce2204f228f3a84b6725df60f","e34e59dce2204f228f3a84b6725df60f",22856637,1,0,1,1527,419,419,0
"e34e59dce2204f228f3a84b6725df60f","a2b4bd40cee2481ebd3fc179d6a5cd62",22856637,2,-2,0,1528,419,417,-2
"a2b4bd40cee2481ebd3fc179d6a5cd62","bec48fc2e1294c7eb3d0aca780d731b8",22856637,3,4,0,1529,417,420,3
"bec48fc2e1294c7eb3d0aca780d731b8","bec48fc2e1294c7eb3d0aca780d731b8",22856637,4,0,1,1530,420,420,0
"bec48fc2e1294c7eb3d0aca780d731b8","a2b4bd40cee2481ebd3fc179d6a5cd62",22856637,1,-4,0,1532,420,417,-3
"bec48fc2e1294c7eb3d0aca780d731b8","e34e59dce2204f228f3a84b6725df60f",22856637,1,-2,0,1534,420,419,-1
"bec48fc2e1294c7eb3d0aca780d731b8","dbde19fcce2a4c1abdc7f685c293a23f",22856637,1,3,0,1539,420,422,2
"dbde19fcce2a4c1abdc7f685c293a23f","a24600b0e49245f6bdba8c893cfeddb0",22856637,2,4,0,1540,422,425,3
"a24600b0e49245f6bdba8c893cfeddb0","a24600b0e49245f6bdba8c893cfeddb0",22856637,4,0,1,1541,425,425,0
"a24600b0e49245f6bdba8c893cfeddb0","dbde19fcce2a4c1abdc7f685c293a23f",22856637,1,-4,0,1543,425,422,-3
"a24600b0e49245f6bdba8c893cfeddb0","24cf8786024543f19b89bc20034e60d7",22856637,1,7,0,1547,425,428,3
"24cf8786024543f19b89bc20034e60d7","a2b4bd40cee2481ebd3fc179d6a5cd62",22856637,1,-18,0,1548,428,417,-11
"a2b4bd40cee2481ebd3fc179d6a5cd62","f2a73be2f46840b182d7bd095378004e",22856637,1,19,0,1549,417,429,12
"f2a73be2f46840b182d7bd095378004e","dce46f8904594a62a6377a3587aaa663",22856637,1,3,0,1550,429,431,2
"dce46f8904594a62a6377a3587aaa663","24cf8786024543f19b89bc20034e60d7",22856637,2,-4,0,1551,431,428,-3
"24cf8786024543f19b89bc20034e60d7","dce46f8904594a62a6377a3587aaa663",22856637,2,4,0,1552,428,431,3
"dce46f8904594a62a6377a3587aaa663","66ada10dde9f43018588f1ced9d477fc",22856637,1,4,0,1553,431,434,3
"66ada10dde9f43018588f1ced9d477fc","f2a73be2f46840b182d7bd095378004e",22856637,1,-7,0,1554,434,429,-5
"f2a73be2f46840b182d7bd095378004e","bf12c96466d840a69bed7020b3f18bb8",22856637,2,10,0,1555,429,436,7
"bf12c96466d840a69bed7020b3f18bb8","66baf19b6b904b70922329068c63746d",22856637,1,-88,0,1556,436,376,-60
"66baf19b6b904b70922329068c63746d","24cf8786024543f19b89bc20034e60d7",22856637,1,77,0,1557,376,428,52
"24cf8786024543f19b89bc20034e60d7","f2a73be2f46840b182d7bd095378004e",22856637,2,1,0,1558,428,429,1
"f2a73be2f46840b182d7bd095378004e","24cf8786024543f19b89bc20034e60d7",22856637,1,-1,0,1559,429,428,-1
"bf12c96466d840a69bed7020b3f18bb8","f2a73be2f46840b182d7bd095378004e",22856637,1,-10,0,1562,436,429,-7
"f2a73be2f46840b182d7bd095378004e","604551fd4266430cb860fef58fa7dd61",22856637,1,1,0,1563,429,430,1
"604551fd4266430cb860fef58fa7dd61","604551fd4266430cb860fef58fa7dd61",22856637,4,0,1,1564,430,430,0
"604551fd4266430cb860fef58fa7dd61","dce46f8904594a62a6377a3587aaa663",22856637,1,2,0,1568,430,431,1
"dce46f8904594a62a6377a3587aaa663","9b9d0a249052413c869753b99682b0ac",22856637,1,1,0,1571,431,432,1
"9b9d0a249052413c869753b99682b0ac","9b9d0a249052413c869753b99682b0ac",22856637,3,0,1,1572,432,432,0
"9b9d0a249052413c869753b99682b0ac","061c175cc90f45fbad883025394e78dd",22856637,1,1,0,1575,432,433,1
"061c175cc90f45fbad883025394e78dd","061c175cc90f45fbad883025394e78dd",22856637,6,0,1,1576,433,433,0
"061c175cc90f45fbad883025394e78dd","dce46f8904594a62a6377a3587aaa663",22856637,1,-2,0,1582,433,431,-2
"dce46f8904594a62a6377a3587aaa663","74a7f8712e5449c2bc0b43c6f90dafed",22856637,1,5,0,1583,431,435,4
"74a7f8712e5449c2bc0b43c6f90dafed","74a7f8712e5449c2bc0b43c6f90dafed",22856637,1,0,1,1584,435,435,0
"74a7f8712e5449c2bc0b43c6f90dafed","66ada10dde9f43018588f1ced9d477fc",22856637,1,-1,0,1585,435,434,-1
"66ada10dde9f43018588f1ced9d477fc","bf12c96466d840a69bed7020b3f18bb8",22856637,1,3,0,1586,434,436,2
"bf12c96466d840a69bed7020b3f18bb8","bf12c96466d840a69bed7020b3f18bb8",22856637,1,0,1,1587,436,436,0
"bf12c96466d840a69bed7020b3f18bb8","070600601c4c439288445d2f0724807d",22856637,1,3,0,1588,436,437,1
"070600601c4c439288445d2f0724807d","24cf8786024543f19b89bc20034e60d7",22856637,1,-14,0,1589,437,428,-9
"24cf8786024543f19b89bc20034e60d7","1823b6de7d334a7aaabc4570719af4d9",22856637,1,16,0,1590,428,439,11
"1823b6de7d334a7aaabc4570719af4d9","1823b6de7d334a7aaabc4570719af4d9",22856637,10,0,1,1591,439,439,0
"1823b6de7d334a7aaabc4570719af4d9","0380cd76a7d44bc3a4da1f15e4d68f89",22856637,1,2,0,1601,439,440,1
"0380cd76a7d44bc3a4da1f15e4d68f89","070600601c4c439288445d2f0724807d",22856637,1,-4,0,1602,440,437,-3
"070600601c4c439288445d2f0724807d","0380cd76a7d44bc3a4da1f15e4d68f89",22856637,2,4,0,1603,437,440,3
"0380cd76a7d44bc3a4da1f15e4d68f89","1823b6de7d334a7aaabc4570719af4d9",22856637,1,-2,0,1604,440,439,-1
"1823b6de7d334a7aaabc4570719af4d9","070600601c4c439288445d2f0724807d",22856637,1,-2,0,1605,439,437,-2
"0380cd76a7d44bc3a4da1f15e4d68f89","0380cd76a7d44bc3a4da1f15e4d68f89",22856637,2,0,1,1607,440,440,0
"0380cd76a7d44bc3a4da1f15e4d68f89","23b7673c8b5443108c2ef09382834a86",22856637,1,2,0,1609,440,441,1
"23b7673c8b5443108c2ef09382834a86","23b7673c8b5443108c2ef09382834a86",22856637,2,0,1,1610,441,441,0
"23b7673c8b5443108c2ef09382834a86","901e92500aea43c79f19f1b279050668",22856637,1,2,0,1612,441,442,1
"901e92500aea43c79f19f1b279050668","901e92500aea43c79f19f1b279050668",22856637,1,0,1,1613,442,442,0
"901e92500aea43c79f19f1b279050668","001339db8ced4cf78829ebe8b145449d",22856637,1,1,0,1614,442,443,1
"001339db8ced4cf78829ebe8b145449d","001339db8ced4cf78829ebe8b145449d",22856637,9,0,1,1615,443,443,0
"001339db8ced4cf78829ebe8b145449d","452745e0366e42ae81561bfddebcc6c3",22856637,1,1,0,1624,443,444,1
"452745e0366e42ae81561bfddebcc6c3","452745e0366e42ae81561bfddebcc6c3",22856637,5,0,1,1625,444,444,0
"452745e0366e42ae81561bfddebcc6c3","901e92500aea43c79f19f1b279050668",22856637,1,-2,0,1630,444,442,-2
"901e92500aea43c79f19f1b279050668","4660ff2089114e8db82ceb26a4f329e3",22856637,1,4,0,1631,442,445,3
"4660ff2089114e8db82ceb26a4f329e3","4660ff2089114e8db82ceb26a4f329e3",22856637,3,0,1,1632,445,445,0
"4660ff2089114e8db82ceb26a4f329e3","7bd5586eb9d8484eb74a433ee7bfe499",22856637,2,2,0,1635,445,446,1
"7bd5586eb9d8484eb74a433ee7bfe499","4660ff2089114e8db82ceb26a4f329e3",22856637,1,-2,0,1636,446,445,-1
"7bd5586eb9d8484eb74a433ee7bfe499","7bd5586eb9d8484eb74a433ee7bfe499",22856637,16,0,1,1638,446,446,0
"7bd5586eb9d8484eb74a433ee7bfe499","8a7f26e690f34dda97be16904518ca99",22856637,2,2,0,1652,446,447,1
"8a7f26e690f34dda97be16904518ca99","7bd5586eb9d8484eb74a433ee7bfe499",22856637,2,-2,0,1653,447,446,-1
"8a7f26e690f34dda97be16904518ca99","8a7f26e690f34dda97be16904518ca99",22856637,2,0,1,1656,447,447,0
"7bd5586eb9d8484eb74a433ee7bfe499","b2f0d654738f48158edff28e8d3a546e",22856637,1,7,0,1660,446,449,3
"b2f0d654738f48158edff28e8d3a546e","070600601c4c439288445d2f0724807d",22856637,1,-21,0,1661,449,437,-12
"070600601c4c439288445d2f0724807d","66baf19b6b904b70922329068c63746d",22856637,1,-91,0,1662,437,376,-61
"66baf19b6b904b70922329068c63746d","66baf19b6b904b70922329068c63746d",22856637,1,0,1,1663,376,376,0
"66baf19b6b904b70922329068c63746d","b2f0d654738f48158edff28e8d3a546e",22856637,1,112,0,1664,376,449,73
"b2f0d654738f48158edff28e8d3a546e","b2f0d654738f48158edff28e8d3a546e",22856637,1,0,1,1665,449,449,0
"b2f0d654738f48158edff28e8d3a546e","f60ee41ec635499abd48168342d32c2f",22856637,2,5,0,1666,449,453,4
"f60ee41ec635499abd48168342d32c2f","f60ee41ec635499abd48168342d32c2f",22856637,51,0,1,1667,453,453,0
"f60ee41ec635499abd48168342d32c2f","b2f0d654738f48158edff28e8d3a546e",22856637,1,-5,0,1668,453,449,-4
"f60ee41ec635499abd48168342d32c2f","f67fbf45a5f146ed866965bc57c7c001",22856637,1,3,0,1720,453,454,1
"f67fbf45a5f146ed866965bc57c7c001","b2f0d654738f48158edff28e8d3a546e",22856637,1,-8,0,1721,454,449,-5
"b2f0d654738f48158edff28e8d3a546e","f67fbf45a5f146ed866965bc57c7c001",22856637,1,8,0,1722,449,454,5
"f67fbf45a5f146ed866965bc57c7c001","f67fbf45a5f146ed866965bc57c7c001",22856637,1,0,1,1723,454,454,0
"f67fbf45a5f146ed866965bc57c7c001","d937afe49bd24a07a550dda1c1155122",22856637,1,1,0,1724,454,455,1
"d937afe49bd24a07a550dda1c1155122","d937afe49bd24a07a550dda1c1155122",22856637,3,0,1,1725,455,455,0
"d937afe49bd24a07a550dda1c1155122","3628b3f7823443d0912a339096b69943",22856637,1,1,0,1728,455,456,1
"3628b3f7823443d0912a339096b69943","3628b3f7823443d0912a339096b69943",22856637,1,0,1,1729,456,456,0
"3628b3f7823443d0912a339096b69943","9e049ee647cf43ecbcb5ed792a8e7588",22856637,1,1,0,1730,456,457,1
"9e049ee647cf43ecbcb5ed792a8e7588","9e049ee647cf43ecbcb5ed792a8e7588",22856637,1,0,1,1731,457,457,0
"9e049ee647cf43ecbcb5ed792a8e7588","5256a214faaf410b93f76cea06428334",22856637,1,1,0,1732,457,458,1
"5256a214faaf410b93f76cea06428334","5256a214faaf410b93f76cea06428334",22856637,1,0,1,1733,458,458,0
"5256a214faaf410b93f76cea06428334","25c32b120fce40fa9b6c85133aeb4716",22856637,1,1,0,1734,458,459,1
"25c32b120fce40fa9b6c85133aeb4716","25c32b120fce40fa9b6c85133aeb4716",22856637,3,0,1,1735,459,459,0
"25c32b120fce40fa9b6c85133aeb4716","11bc14f2204949008b7d511b933363c1",22856637,1,1,0,1738,459,460,1
"11bc14f2204949008b7d511b933363c1","11bc14f2204949008b7d511b933363c1",22856637,1,0,1,1739,460,460,0
"11bc14f2204949008b7d511b933363c1","42de338840a34d15adb66e7b14fb9d2c",22856637,1,1,0,1740,460,461,1
"42de338840a34d15adb66e7b14fb9d2c","42de338840a34d15adb66e7b14fb9d2c",22856637,3,0,1,1741,461,461,0
"42de338840a34d15adb66e7b14fb9d2c","9da37c6210b1416b8079c274f70bf600",22856637,1,1,0,1744,461,462,1
"9da37c6210b1416b8079c274f70bf600","9da37c6210b1416b8079c274f70bf600",22856637,10,0,1,1745,462,462,0
"9da37c6210b1416b8079c274f70bf600","519119f1deac45ff9ab4f13529be5c6e",22856637,1,1,0,1755,462,463,1
"519119f1deac45ff9ab4f13529be5c6e","519119f1deac45ff9ab4f13529be5c6e",22856637,1,0,1,1756,463,463,0
"519119f1deac45ff9ab4f13529be5c6e","f67fbf45a5f146ed866965bc57c7c001",22856637,1,-9,0,1757,463,454,-9
"f67fbf45a5f146ed866965bc57c7c001","c5df9f40ec14463b9dcfdc73df3e9285",22856637,1,12,0,1758,454,464,10
"c5df9f40ec14463b9dcfdc73df3e9285","1b4550d0dab04078b3bf08a655345bdc",22856637,1,-140,0,1760,464,373,-91
"1b4550d0dab04078b3bf08a655345bdc","b71bac264efb4abd97015447bd490db6",22856637,1,-4,0,1761,373,370,-3
"b613861cecf84ffcab01afb23f660475","b613861cecf84ffcab01afb23f660475",22856849,6,0,1,1,1,1,0
"b613861cecf84ffcab01afb23f660475","e2911e79efc2420eac45d9f671463d4b",22856849,1,3,0,7,1,2,1
"e2911e79efc2420eac45d9f671463d4b","519d1b8c59404d67b54e96c5c8a830b2",22856849,1,1,0,10,2,3,1
"519d1b8c59404d67b54e96c5c8a830b2","519d1b8c59404d67b54e96c5c8a830b2",22856849,1,0,1,11,3,3,0
"519d1b8c59404d67b54e96c5c8a830b2","531db53f81f646edb0cdcfe0085b03b7",22856849,1,1,0,12,3,4,1
"531db53f81f646edb0cdcfe0085b03b7","531db53f81f646edb0cdcfe0085b03b7",22856849,1,0,1,13,4,4,0
"531db53f81f646edb0cdcfe0085b03b7","4f5f94b2f95141e0a9d53a61da2276da",22856849,1,1,0,14,4,5,1
"4f5f94b2f95141e0a9d53a61da2276da","4f5f94b2f95141e0a9d53a61da2276da",22856849,1,0,1,15,5,5,0
"4f5f94b2f95141e0a9d53a61da2276da","6d541c89590949f99af293c4f2333f67",22856849,1,1,0,16,5,6,1
"6d541c89590949f99af293c4f2333f67","6d541c89590949f99af293c4f2333f67",22856849,1,0,1,17,6,6,0
"6d541c89590949f99af293c4f2333f67","dd5cf0b9fe4c4f1d8f5ff8e4c04879cb",22856849,1,1,0,18,6,7,1
"dd5cf0b9fe4c4f1d8f5ff8e4c04879cb","dd5cf0b9fe4c4f1d8f5ff8e4c04879cb",22856849,1,0,1,19,7,7,0
"dd5cf0b9fe4c4f1d8f5ff8e4c04879cb","f96261861edc426abe2248be4f0a709a",22856849,1,1,0,20,7,8,1
"f96261861edc426abe2248be4f0a709a","f96261861edc426abe2248be4f0a709a",22856849,1,0,1,21,8,8,0
"f96261861edc426abe2248be4f0a709a","66b5e16f4f75454fb5b8172079f0fa83",22856849,1,1,0,22,8,9,1
"66b5e16f4f75454fb5b8172079f0fa83","66b5e16f4f75454fb5b8172079f0fa83",22856849,1,0,1,23,9,9,0
"66b5e16f4f75454fb5b8172079f0fa83","0680571d4698477995e41842c36a54b2",22856849,1,1,0,24,9,10,1
"0680571d4698477995e41842c36a54b2","0680571d4698477995e41842c36a54b2",22856849,1,0,1,25,10,10,0
"0680571d4698477995e41842c36a54b2","56586aa865414f538729c7f7735d2bc6",22856849,1,4,0,26,10,12,2
"56586aa865414f538729c7f7735d2bc6","e2911e79efc2420eac45d9f671463d4b",22856849,2,-12,0,27,12,2,-10
"e2911e79efc2420eac45d9f671463d4b","9112f2bffece48e08c6d2287be204085",22856849,1,9,0,28,2,11,9
"9112f2bffece48e08c6d2287be204085","56586aa865414f538729c7f7735d2bc6",22856849,1,3,0,29,11,12,1
"e2911e79efc2420eac45d9f671463d4b","e2911e79efc2420eac45d9f671463d4b",22856849,3,0,1,31,2,2,0
"e2911e79efc2420eac45d9f671463d4b","56586aa865414f538729c7f7735d2bc6",22856849,1,12,0,32,2,12,10
"56586aa865414f538729c7f7735d2bc6","56586aa865414f538729c7f7735d2bc6",22856849,4,0,1,33,12,12,0
"56586aa865414f538729c7f7735d2bc6","b7f2b31585d94eb3bf86376714aa7070",22856849,1,2,0,37,12,13,1
"b7f2b31585d94eb3bf86376714aa7070","b7f2b31585d94eb3bf86376714aa7070",22856849,4,0,1,38,13,13,0
"b7f2b31585d94eb3bf86376714aa7070","b613861cecf84ffcab01afb23f660475",22856849,1,-17,0,42,13,1,-12
"b613861cecf84ffcab01afb23f660475","eb2a0eb537344a9e891c761662e400b6",22856849,1,23,0,43,1,16,15
"eb2a0eb537344a9e891c761662e400b6","56586aa865414f538729c7f7735d2bc6",22856849,1,-8,0,44,16,12,-4
"56586aa865414f538729c7f7735d2bc6","5c5ceeee4562457ba6d41515aeebfbb1",22856849,2,10,0,45,12,17,5
"5c5ceeee4562457ba6d41515aeebfbb1","5c5ceeee4562457ba6d41515aeebfbb1",22856849,3,0,1,46,17,17,0
"5c5ceeee4562457ba6d41515aeebfbb1","56586aa865414f538729c7f7735d2bc6",22856849,2,-10,0,49,17,12,-5
"56586aa865414f538729c7f7735d2bc6","9afd71a5298d4333b6849dfce1b9422c",22856849,2,13,0,50,12,18,6
"9afd71a5298d4333b6849dfce1b9422c","9afd71a5298d4333b6849dfce1b9422c",22856849,4,0,1,51,18,18,0
"9afd71a5298d4333b6849dfce1b9422c","56586aa865414f538729c7f7735d2bc6",22856849,1,-13,0,54,18,12,-6
"5c5ceeee4562457ba6d41515aeebfbb1","eb2a0eb537344a9e891c761662e400b6",22856849,1,-2,0,56,17,16,-1
"eb2a0eb537344a9e891c761662e400b6","5c5ceeee4562457ba6d41515aeebfbb1",22856849,1,2,0,57,16,17,1
"5c5ceeee4562457ba6d41515aeebfbb1","81c864a886d54a6b8ff85f7d736f4f95",22856849,1,-4,0,58,17,15,-2
"81c864a886d54a6b8ff85f7d736f4f95","5c5ceeee4562457ba6d41515aeebfbb1",22856849,1,4,0,59,15,17,2
"9afd71a5298d4333b6849dfce1b9422c","b7719e26494940efa49512aedd0aac79",22856849,2,4,0,62,18,20,2
"b7719e26494940efa49512aedd0aac79","9afd71a5298d4333b6849dfce1b9422c",22856849,2,-4,0,63,20,18,-2
"9afd71a5298d4333b6849dfce1b9422c","d4f45188d3c84a02ba08454e6403a818",22856849,1,9,0,64,18,24,6
"d4c3b003e8274e429d2fa688d73fde6d","d4c3b003e8274e429d2fa688d73fde6d",22856849,6,0,1,66,22,22,0
"d4c3b003e8274e429d2fa688d73fde6d","b7719e26494940efa49512aedd0aac79",22856849,3,-3,0,67,22,20,-2
"afbf7250b99d47bea07172749483ca97","b613861cecf84ffcab01afb23f660475",22856849,1,-44,0,70,28,1,-27
"b613861cecf84ffcab01afb23f660475","a49d1bb4328949299686242fd0be5584",22856849,1,34,0,71,1,21,20
"b7719e26494940efa49512aedd0aac79","d4f45188d3c84a02ba08454e6403a818",22856849,1,5,0,80,20,24,4
"51970cfa30e643e894e66ae85c8024cc","c33c17be71ae4d588da7369472e5bb1b",22856849,1,6,0,98,31,34,3
"4e51676dc72045d99c19b9fa7b22f8bc","93679be414554a11b1893002f2229a93",22856849,2,12,0,100,29,35,6
"93679be414554a11b1893002f2229a93","c33c17be71ae4d588da7369472e5bb1b",22856849,2,-3,0,101,35,34,-1
"c33c17be71ae4d588da7369472e5bb1b","7040a13096d746ac84b8fac8d9752058",22856849,2,6,0,102,34,36,2
"7040a13096d746ac84b8fac8d9752058","93679be414554a11b1893002f2229a93",22856849,2,-3,0,103,36,35,-1
"93679be414554a11b1893002f2229a93","9a0dc646f934470daf08c4b56ccf73db",22856849,2,6,0,104,35,37,2
"9a0dc646f934470daf08c4b56ccf73db","7040a13096d746ac84b8fac8d9752058",22856849,2,-3,0,105,37,36,-1
"7040a13096d746ac84b8fac8d9752058","9a0dc646f934470daf08c4b56ccf73db",22856849,1,3,0,106,36,37,1
"9a0dc646f934470daf08c4b56ccf73db","fc0e049d56024bc9a02c9a9c435c3df7",22856849,1,3,0,107,37,38,1
"fc0e049d56024bc9a02c9a9c435c3df7","b613861cecf84ffcab01afb23f660475",22856849,1,-68,0,108,38,1,-37
"b613861cecf84ffcab01afb23f660475","4e51676dc72045d99c19b9fa7b22f8bc",22856849,2,47,0,109,1,29,28
"4e51676dc72045d99c19b9fa7b22f8bc","c9c52446b6294aa5a9c2abaed536c37e",22856849,2,5,0,110,29,32,3
"c9c52446b6294aa5a9c2abaed536c37e","b613861cecf84ffcab01afb23f660475",22856849,1,-52,0,111,32,1,-31
"c9c52446b6294aa5a9c2abaed536c37e","c33c17be71ae4d588da7369472e5bb1b",22856849,1,4,0,114,32,34,2
"c33c17be71ae4d588da7369472e5bb1b","4e51676dc72045d99c19b9fa7b22f8bc",22856849,4,-9,0,115,34,29,-5
"4e51676dc72045d99c19b9fa7b22f8bc","51970cfa30e643e894e66ae85c8024cc",22856849,4,3,0,116,29,31,2
"51970cfa30e643e894e66ae85c8024cc","4e51676dc72045d99c19b9fa7b22f8bc",22856849,3,-3,0,117,31,29,-2
"4e51676dc72045d99c19b9fa7b22f8bc","c33c17be71ae4d588da7369472e5bb1b",22856849,4,9,0,120,29,34,5
"c33c17be71ae4d588da7369472e5bb1b","a49d1bb4328949299686242fd0be5584",22856849,1,-22,0,123,34,21,-13
"b7719e26494940efa49512aedd0aac79","a49d1bb4328949299686242fd0be5584",22856849,2,2,0,125,20,21,1
"a49d1bb4328949299686242fd0be5584","d4f45188d3c84a02ba08454e6403a818",22856849,2,3,0,126,21,24,3
"d4f45188d3c84a02ba08454e6403a818","d4c3b003e8274e429d2fa688d73fde6d",22856849,4,-2,0,127,24,22,-2
"d4c3b003e8274e429d2fa688d73fde6d","a49d1bb4328949299686242fd0be5584",22856849,1,-1,0,128,22,21,-1
"afbf7250b99d47bea07172749483ca97","c9c52446b6294aa5a9c2abaed536c37e",22856849,1,8,0,132,28,32,4
"c9c52446b6294aa5a9c2abaed536c37e","4e51676dc72045d99c19b9fa7b22f8bc",22856849,1,-5,0,133,32,29,-3
"7040a13096d746ac84b8fac8d9752058","fc0e049d56024bc9a02c9a9c435c3df7",22856849,1,6,0,142,36,38,2
"fc0e049d56024bc9a02c9a9c435c3df7","9a0dc646f934470daf08c4b56ccf73db",22856849,1,-3,0,143,38,37,-1
"9a0dc646f934470daf08c4b56ccf73db","67a089198fcb4e1c8f2385786c2b296f",22856849,1,7,0,144,37,39,2
"67a089198fcb4e1c8f2385786c2b296f","fc0e049d56024bc9a02c9a9c435c3df7",22856849,1,-4,0,145,39,38,-1
"fc0e049d56024bc9a02c9a9c435c3df7","64d48c6c9c7940639a932219a6c87198",22856849,1,5,0,146,38,40,2
"64d48c6c9c7940639a932219a6c87198","67a089198fcb4e1c8f2385786c2b296f",22856849,1,-1,0,147,40,39,-1
"67a089198fcb4e1c8f2385786c2b296f","67a089198fcb4e1c8f2385786c2b296f",22856849,2,0,1,148,39,39,0
"67a089198fcb4e1c8f2385786c2b296f","64d48c6c9c7940639a932219a6c87198",22856849,1,1,0,150,39,40,1
"64d48c6c9c7940639a932219a6c87198","64d48c6c9c7940639a932219a6c87198",22856849,4,0,1,151,40,40,0
"64d48c6c9c7940639a932219a6c87198","b534b89233134e30a9b5645138bfa9ee",22856849,1,3,0,155,40,41,1
"b534b89233134e30a9b5645138bfa9ee","b534b89233134e30a9b5645138bfa9ee",22856849,2,0,1,156,41,41,0
"b534b89233134e30a9b5645138bfa9ee","0e37b720d23b4e7f8b313e79313fd107",22856849,1,3,0,157,41,44,3
"0e37b720d23b4e7f8b313e79313fd107","0e37b720d23b4e7f8b313e79313fd107",22856849,1,0,1,158,44,44,0
"0e37b720d23b4e7f8b313e79313fd107","6875d67fdd5f48168b62719df449bebd",22856849,1,1,0,159,44,45,1
"6875d67fdd5f48168b62719df449bebd","6875d67fdd5f48168b62719df449bebd",22856849,1,0,1,160,45,45,0
"6875d67fdd5f48168b62719df449bebd","b534b89233134e30a9b5645138bfa9ee",22856849,1,-4,0,161,45,41,-4
"b534b89233134e30a9b5645138bfa9ee","6e13d61a7bdb44bca949c9f86fab3be5",22856849,2,7,0,162,41,47,6
"6e13d61a7bdb44bca949c9f86fab3be5","6e13d61a7bdb44bca949c9f86fab3be5",22856849,13,0,1,163,47,47,0
"6e13d61a7bdb44bca949c9f86fab3be5","195f78799f984cc2b06c48dfe36be751",22856849,1,2,0,176,47,49,2
"195f78799f984cc2b06c48dfe36be751","195f78799f984cc2b06c48dfe36be751",22856849,2,0,1,177,49,49,0
"195f78799f984cc2b06c48dfe36be751","d0c74f735e024943943e40333d6d337f",22856849,1,3,0,179,49,51,2
"d0c74f735e024943943e40333d6d337f","d9c8d8c444a64dadbbb508652c721e17",22856849,2,-6,0,180,51,46,-5
"d9c8d8c444a64dadbbb508652c721e17","d0c74f735e024943943e40333d6d337f",22856849,1,6,0,181,46,51,5
"d0c74f735e024943943e40333d6d337f","d0c74f735e024943943e40333d6d337f",22856849,1,0,1,182,51,51,0
"d0c74f735e024943943e40333d6d337f","983f8ff320594b279a7f4a6fe132f9c5",22856849,1,2,0,183,51,53,2
"983f8ff320594b279a7f4a6fe132f9c5","983f8ff320594b279a7f4a6fe132f9c5",22856849,2,0,1,184,53,53,0
"983f8ff320594b279a7f4a6fe132f9c5","35adfa5d923046aebabfefd98f35ff05",22856849,1,1,0,186,53,54,1
"35adfa5d923046aebabfefd98f35ff05","35adfa5d923046aebabfefd98f35ff05",22856849,2,0,1,187,54,54,0
"35adfa5d923046aebabfefd98f35ff05","b6f8a98476224da1b40e555ececc7ed8",22856849,1,1,0,189,54,55,1
"b6f8a98476224da1b40e555ececc7ed8","b6f8a98476224da1b40e555ececc7ed8",22856849,2,0,1,190,55,55,0
"b6f8a98476224da1b40e555ececc7ed8","86e22cb5fe0e4b47a9489ecddf7ed78f",22856849,1,1,0,192,55,56,1
"86e22cb5fe0e4b47a9489ecddf7ed78f","86e22cb5fe0e4b47a9489ecddf7ed78f",22856849,2,0,1,193,56,56,0
"86e22cb5fe0e4b47a9489ecddf7ed78f","f924752d8a1149668870b1e7698486f7",22856849,1,-6,0,195,56,50,-6
"f924752d8a1149668870b1e7698486f7","a1f2f12debe5432fb7a70bcd12bacfb9",22856849,1,9,0,196,50,58,8
"a1f2f12debe5432fb7a70bcd12bacfb9","78f30e4dcac84e3cbea8b2cc6e0d62b3",22856849,2,1,0,197,58,59,1
"78f30e4dcac84e3cbea8b2cc6e0d62b3","a1f2f12debe5432fb7a70bcd12bacfb9",22856849,2,-1,0,198,59,58,-1
"a1f2f12debe5432fb7a70bcd12bacfb9","a1f2f12debe5432fb7a70bcd12bacfb9",22856849,9,0,1,199,58,58,0
"78f30e4dcac84e3cbea8b2cc6e0d62b3","78f30e4dcac84e3cbea8b2cc6e0d62b3",22856849,12,0,1,209,59,59,0
"78f30e4dcac84e3cbea8b2cc6e0d62b3","12aa6e1672ac4e7aa6449a7a8609cd72",22856849,1,-2,0,221,59,57,-2
"12aa6e1672ac4e7aa6449a7a8609cd72","a0a418b8540d479fa6e0f653b701da8b",22856849,1,8,0,222,57,64,7
"a0a418b8540d479fa6e0f653b701da8b","bc42d26810654ea9a1df1efe1e58c7d5",22856849,1,-1,0,223,64,63,-1
"bc42d26810654ea9a1df1efe1e58c7d5","4c943503763e4e349906eea3ed3c8e86",22856849,1,-2,0,224,63,61,-2
"4c943503763e4e349906eea3ed3c8e86","4c943503763e4e349906eea3ed3c8e86",22856849,2,0,1,225,61,61,0
"4c943503763e4e349906eea3ed3c8e86","309ccf3cc4fe429d9bfbaef53d3fa479",22856849,1,-1,0,227,61,60,-1
"309ccf3cc4fe429d9bfbaef53d3fa479","d646286c8051419bbc2e31dd1db55ca8",22856849,1,10,0,228,60,67,7
"d646286c8051419bbc2e31dd1db55ca8","b534b89233134e30a9b5645138bfa9ee",22856849,1,-33,0,229,67,41,-26
"b534b89233134e30a9b5645138bfa9ee","267f883678b24aed855fde42524975d9",22856849,1,37,0,230,41,71,30
"267f883678b24aed855fde42524975d9","267f883678b24aed855fde42524975d9",22856849,1,0,1,231,71,71,0
"267f883678b24aed855fde42524975d9","88fff56d0342490dbef9040750a20f6c",22856849,1,1,0,232,71,72,1
"88fff56d0342490dbef9040750a20f6c","88fff56d0342490dbef9040750a20f6c",22856849,1,0,1,233,72,72,0
"88fff56d0342490dbef9040750a20f6c","adb17b12b66c4a49a85fd34322f7df70",22856849,1,1,0,234,72,73,1
"adb17b12b66c4a49a85fd34322f7df70","adb17b12b66c4a49a85fd34322f7df70",22856849,1,0,1,235,73,73,0
"adb17b12b66c4a49a85fd34322f7df70","d646286c8051419bbc2e31dd1db55ca8",22856849,1,-6,0,236,73,67,-6
"d646286c8051419bbc2e31dd1db55ca8","a2becd407db34b189200a32546d9d569",22856849,1,9,0,237,67,75,8
"a2becd407db34b189200a32546d9d569","a2becd407db34b189200a32546d9d569",22856849,8,0,1,238,75,75,0
"a2becd407db34b189200a32546d9d569","58c22b011d0f4c2ea6d13615edbb9eeb",22856849,1,2,0,246,75,77,2
"58c22b011d0f4c2ea6d13615edbb9eeb","58c22b011d0f4c2ea6d13615edbb9eeb",22856849,2,0,1,247,77,77,0
"58c22b011d0f4c2ea6d13615edbb9eeb","dd76e1861dc9461c830888729d091ee0",22856849,1,1,0,249,77,78,1
"dd76e1861dc9461c830888729d091ee0","dd76e1861dc9461c830888729d091ee0",22856849,2,0,1,250,78,78,0
"dd76e1861dc9461c830888729d091ee0","cd1d828f1a694b87913a7ea66c23803e",22856849,1,1,0,252,78,79,1
"cd1d828f1a694b87913a7ea66c23803e","cd1d828f1a694b87913a7ea66c23803e",22856849,2,0,1,253,79,79,0
"cd1d828f1a694b87913a7ea66c23803e","9176a3c2b4d2465fa8b0c67096c2a97e",22856849,1,1,0,255,79,80,1
"9176a3c2b4d2465fa8b0c67096c2a97e","9176a3c2b4d2465fa8b0c67096c2a97e",22856849,12,0,1,256,80,80,0
"9176a3c2b4d2465fa8b0c67096c2a97e","f8ec6445f7194e25b9101d4fbcb07a18",22856849,1,1,0,268,80,81,1
"f8ec6445f7194e25b9101d4fbcb07a18","f8ec6445f7194e25b9101d4fbcb07a18",22856849,2,0,1,269,81,81,0
"f8ec6445f7194e25b9101d4fbcb07a18","140d5b27b8574befad82c0a013b59dfa",22856849,1,-7,0,271,81,74,-7
"140d5b27b8574befad82c0a013b59dfa","d18a9ea32855445f8736581f5cb119ce",22856849,1,9,0,272,74,82,8
"d18a9ea32855445f8736581f5cb119ce","f564483cbd7a407681aa2fcca518cf5f",22856849,1,4,0,273,82,85,3
"f564483cbd7a407681aa2fcca518cf5f","f564483cbd7a407681aa2fcca518cf5f",22856849,7,0,1,274,85,85,0
"f564483cbd7a407681aa2fcca518cf5f","18fd01350bd5434ca636d59a599d768a",22856849,1,1,0,281,85,86,1
"18fd01350bd5434ca636d59a599d768a","18fd01350bd5434ca636d59a599d768a",22856849,8,0,1,282,86,86,0
"18fd01350bd5434ca636d59a599d768a","6a9f0ef185fb47f0937e29daa1c71ed5",22856849,1,5,0,290,86,90,4
"6a9f0ef185fb47f0937e29daa1c71ed5","ae5ac430ea254e708a6f5deaaf7464ae",22856849,1,-7,0,291,90,84,-6
"ae5ac430ea254e708a6f5deaaf7464ae","c681290961c94c4caf23b529d1ae6b9a",22856849,1,5,0,292,84,88,4
"c681290961c94c4caf23b529d1ae6b9a","c681290961c94c4caf23b529d1ae6b9a",22856849,1,0,1,293,88,88,0
"c681290961c94c4caf23b529d1ae6b9a","6a9f0ef185fb47f0937e29daa1c71ed5",22856849,1,2,0,294,88,90,2
"6a9f0ef185fb47f0937e29daa1c71ed5","6a9f0ef185fb47f0937e29daa1c71ed5",22856849,3,0,1,295,90,90,0
"6a9f0ef185fb47f0937e29daa1c71ed5","e20db35ced8544ddac5bc3839145e463",22856849,1,3,0,298,90,91,1
"e20db35ced8544ddac5bc3839145e463","d646286c8051419bbc2e31dd1db55ca8",22856849,1,-30,0,299,91,67,-24
"d646286c8051419bbc2e31dd1db55ca8","1febb706d7a34005ae8711ed49c76e64",22856849,1,33,0,300,67,94,27
"1febb706d7a34005ae8711ed49c76e64","1febb706d7a34005ae8711ed49c76e64",22856849,2,0,1,301,94,94,0
"1febb706d7a34005ae8711ed49c76e64","8f73ba6f5a0042f2850356ac38ac6f24",22856849,1,1,0,303,94,95,1
"8f73ba6f5a0042f2850356ac38ac6f24","8f73ba6f5a0042f2850356ac38ac6f24",22856849,5,0,1,304,95,95,0
"8f73ba6f5a0042f2850356ac38ac6f24","e2260b86653c46d7b14a41fb419dbf8c",22856849,1,1,0,309,95,96,1
"e2260b86653c46d7b14a41fb419dbf8c","e2260b86653c46d7b14a41fb419dbf8c",22856849,2,0,1,310,96,96,0
"e2260b86653c46d7b14a41fb419dbf8c","35eb641ad1d845bbba54915bce75a962",22856849,1,1,0,312,96,97,1
"35eb641ad1d845bbba54915bce75a962","35eb641ad1d845bbba54915bce75a962",22856849,2,0,1,313,97,97,0
"35eb641ad1d845bbba54915bce75a962","08be90ffbeea4795a138cd42ed8db56f",22856849,1,1,0,315,97,98,1
"08be90ffbeea4795a138cd42ed8db56f","08be90ffbeea4795a138cd42ed8db56f",22856849,5,0,1,316,98,98,0
"08be90ffbeea4795a138cd42ed8db56f","3007433c8f584dcbb5ac159c1c5f2be3",22856849,1,1,0,321,98,99,1
"3007433c8f584dcbb5ac159c1c5f2be3","3007433c8f584dcbb5ac159c1c5f2be3",22856849,2,0,1,322,99,99,0
"3007433c8f584dcbb5ac159c1c5f2be3","e20db35ced8544ddac5bc3839145e463",22856849,1,-8,0,324,99,91,-8
"e20db35ced8544ddac5bc3839145e463","00ae5f0c51874a73a41ebea838d95682",22856849,1,11,0,325,91,101,10
"00ae5f0c51874a73a41ebea838d95682","d391c8b6e56a43a7b654e9dee02d904b",22856849,2,2,0,326,101,103,2
"d391c8b6e56a43a7b654e9dee02d904b","00ae5f0c51874a73a41ebea838d95682",22856849,1,-2,0,327,103,101,-2
"00ae5f0c51874a73a41ebea838d95682","00ae5f0c51874a73a41ebea838d95682",22856849,3,0,1,328,101,101,0
"d391c8b6e56a43a7b654e9dee02d904b","d391c8b6e56a43a7b654e9dee02d904b",22856849,21,0,1,332,103,103,0
"d391c8b6e56a43a7b654e9dee02d904b","6111116566fc4fd9abba409322bea245",22856849,1,1,0,353,103,104,1
"6111116566fc4fd9abba409322bea245","6111116566fc4fd9abba409322bea245",22856849,2,0,1,354,104,104,0
"6111116566fc4fd9abba409322bea245","a81b2235cb9c499eb9ea8ee0a8dd9725",22856849,1,1,0,356,104,105,1
"a81b2235cb9c499eb9ea8ee0a8dd9725","a81b2235cb9c499eb9ea8ee0a8dd9725",22856849,2,0,1,357,105,105,0
"a81b2235cb9c499eb9ea8ee0a8dd9725","2d4e0ab0ef3b4d73b82c72d4621a7579",22856849,1,1,0,359,105,106,1
"2d4e0ab0ef3b4d73b82c72d4621a7579","2d4e0ab0ef3b4d73b82c72d4621a7579",22856849,2,0,1,360,106,106,0
"2d4e0ab0ef3b4d73b82c72d4621a7579","8bdebf492ebd4e62b0d522e8ab5e5197",22856849,1,1,0,362,106,107,1
"8bdebf492ebd4e62b0d522e8ab5e5197","8bdebf492ebd4e62b0d522e8ab5e5197",22856849,2,0,1,363,107,107,0
"8bdebf492ebd4e62b0d522e8ab5e5197","73039f8c1eb9409cb4caee2cf968001e",22856849,1,-7,0,365,107,100,-7
"73039f8c1eb9409cb4caee2cf968001e","4280927ec4d643238aa49c32f9e06c6c",22856849,1,10,0,366,100,109,9
"4280927ec4d643238aa49c32f9e06c6c","4280927ec4d643238aa49c32f9e06c6c",22856849,3,0,1,367,109,109,0
"4280927ec4d643238aa49c32f9e06c6c","fc44e6a5f7654430af1227838224dceb",22856849,1,2,0,370,109,111,2
"fc44e6a5f7654430af1227838224dceb","fc44e6a5f7654430af1227838224dceb",22856849,2,0,1,371,111,111,0
"fc44e6a5f7654430af1227838224dceb","08111f75e22d409998cf8b85bd431f0a",22856849,1,-3,0,373,111,108,-3
"08111f75e22d409998cf8b85bd431f0a","a9ae0a3c070d455bb4369a8996313336",22856849,1,7,0,374,108,114,6
"a9ae0a3c070d455bb4369a8996313336","a9ae0a3c070d455bb4369a8996313336",22856849,1,0,1,375,114,114,0
"a9ae0a3c070d455bb4369a8996313336","71cec822bcff4f30a20e75dc63ef7b65",22856849,1,2,0,376,114,116,2
"71cec822bcff4f30a20e75dc63ef7b65","71cec822bcff4f30a20e75dc63ef7b65",22856849,6,0,1,377,116,116,0
"71cec822bcff4f30a20e75dc63ef7b65","37319e88176d4aefa91d7a9980dbae91",22856849,1,-4,0,383,116,112,-4
"37319e88176d4aefa91d7a9980dbae91","62bff51286ef4f348717a3cf6fe2318f",22856849,1,9,0,384,112,120,8
"62bff51286ef4f348717a3cf6fe2318f","b1cd0e7dc3ad4a8eb91a4bfdbeb025b0",22856849,1,-2,0,385,120,118,-2
"b1cd0e7dc3ad4a8eb91a4bfdbeb025b0","b1cd0e7dc3ad4a8eb91a4bfdbeb025b0",22856849,1,0,1,386,118,118,0
"b1cd0e7dc3ad4a8eb91a4bfdbeb025b0","62bff51286ef4f348717a3cf6fe2318f",22856849,1,2,0,387,118,120,2
"62bff51286ef4f348717a3cf6fe2318f","62bff51286ef4f348717a3cf6fe2318f",22856849,3,0,1,388,120,120,0
"62bff51286ef4f348717a3cf6fe2318f","779f9ddd1fd14d1e9e69f72219a1fdbd",22856849,1,3,0,391,120,121,1
"779f9ddd1fd14d1e9e69f72219a1fdbd","e20db35ced8544ddac5bc3839145e463",22856849,1,-36,0,392,121,91,-30
"e20db35ced8544ddac5bc3839145e463","ae26e6cda8ad4a3f81bd347560d9579f",22856849,1,40,0,393,91,125,34
"ae26e6cda8ad4a3f81bd347560d9579f","ae26e6cda8ad4a3f81bd347560d9579f",22856849,5,0,1,394,125,125,0
"ae26e6cda8ad4a3f81bd347560d9579f","ee48df95832b4374aa273ceb27ec1315",22856849,1,1,0,399,125,126,1
"ee48df95832b4374aa273ceb27ec1315","ee48df95832b4374aa273ceb27ec1315",22856849,1,0,1,400,126,126,0
"ee48df95832b4374aa273ceb27ec1315","7a439da90b394756ad1777fc4c6dead5",22856849,1,1,0,401,126,127,1
"7a439da90b394756ad1777fc4c6dead5","7a439da90b394756ad1777fc4c6dead5",22856849,1,0,1,402,127,127,0
"7a439da90b394756ad1777fc4c6dead5","a8dd5213034441ac92724b4e83eb0bb2",22856849,1,3,0,403,127,129,2
"a8dd5213034441ac92724b4e83eb0bb2","779f9ddd1fd14d1e9e69f72219a1fdbd",22856849,1,-9,0,404,129,121,-8
"779f9ddd1fd14d1e9e69f72219a1fdbd","a8dd5213034441ac92724b4e83eb0bb2",22856849,1,9,0,405,121,129,8
"a8dd5213034441ac92724b4e83eb0bb2","a8dd5213034441ac92724b4e83eb0bb2",22856849,1,0,1,406,129,129,0
"a8dd5213034441ac92724b4e83eb0bb2","8115eab6556b45f5b415c3b8c26a12e5",22856849,1,2,0,407,129,131,2
"8115eab6556b45f5b415c3b8c26a12e5","8115eab6556b45f5b415c3b8c26a12e5",22856849,2,0,1,408,131,131,0
"8115eab6556b45f5b415c3b8c26a12e5","ec34b06efd844b46a4c4818ecdb9b8f4",22856849,1,1,0,410,131,132,1
"ec34b06efd844b46a4c4818ecdb9b8f4","ec34b06efd844b46a4c4818ecdb9b8f4",22856849,2,0,1,411,132,132,0
"ec34b06efd844b46a4c4818ecdb9b8f4","c2e1c2b9eac64109b343a088584b576b",22856849,1,1,0,413,132,133,1
"c2e1c2b9eac64109b343a088584b576b","c2e1c2b9eac64109b343a088584b576b",22856849,2,0,1,414,133,133,0
"c2e1c2b9eac64109b343a088584b576b","579338175e0b4bbb8ef3b712b5d8b54e",22856849,1,-5,0,416,133,128,-5
"579338175e0b4bbb8ef3b712b5d8b54e","8bc5795d6a984a3eace4e2811e52dd4f",22856849,1,8,0,417,128,135,7
"8bc5795d6a984a3eace4e2811e52dd4f","8bc5795d6a984a3eace4e2811e52dd4f",22856849,6,0,1,418,135,135,0
"8bc5795d6a984a3eace4e2811e52dd4f","b416d47c56a742199b5d7c7f19d6503a",22856849,1,-1,0,424,135,134,-1
"b416d47c56a742199b5d7c7f19d6503a","cd4532ad48034873ba8bce2aac0c9808",22856849,1,4,0,425,134,137,3
"cd4532ad48034873ba8bce2aac0c9808","cd4532ad48034873ba8bce2aac0c9808",22856849,1,0,1,426,137,137,0
"cd4532ad48034873ba8bce2aac0c9808","df1de691dafe4549a18a4398ee9dfaf9",22856849,1,4,0,427,137,139,2
"df1de691dafe4549a18a4398ee9dfaf9","779f9ddd1fd14d1e9e69f72219a1fdbd",22856849,2,-23,0,428,139,121,-18
"779f9ddd1fd14d1e9e69f72219a1fdbd","6c5ad271a44743479bfaea29b1db8d02",22856849,1,27,0,429,121,143,22
"6c5ad271a44743479bfaea29b1db8d02","df1de691dafe4549a18a4398ee9dfaf9",22856849,2,-4,0,430,143,139,-4
"df1de691dafe4549a18a4398ee9dfaf9","f902b0f41b544d4dbf79664fd233648d",22856849,1,8,0,431,139,146,7
"f902b0f41b544d4dbf79664fd233648d","8aae34f5ddbb4052a709b12e6b0d40fa",22856849,1,1,0,432,146,147,1
"8aae34f5ddbb4052a709b12e6b0d40fa","df1de691dafe4549a18a4398ee9dfaf9",22856849,1,-9,0,433,147,139,-8
"df1de691dafe4549a18a4398ee9dfaf9","f03480cf4eba413194d7af52fc0e7f28",22856849,1,15,0,434,139,152,13
"f03480cf4eba413194d7af52fc0e7f28","d313cec988a84645bee413e8d4724a4b",22856849,2,7,0,435,152,158,6
"d313cec988a84645bee413e8d4724a4b","78adeee1fa2c4fe0bc73f7bca9fcee86",22856849,1,4,0,436,158,160,2
"78adeee1fa2c4fe0bc73f7bca9fcee86","df1de691dafe4549a18a4398ee9dfaf9",22856849,5,-26,0,437,160,139,-21
"df1de691dafe4549a18a4398ee9dfaf9","78adeee1fa2c4fe0bc73f7bca9fcee86",22856849,5,26,0,438,139,160,21
"78adeee1fa2c4fe0bc73f7bca9fcee86","d313cec988a84645bee413e8d4724a4b",22856849,1,-4,0,445,160,158,-2
"d313cec988a84645bee413e8d4724a4b","f4ce60b4a944484082ccb701b48b3da1",22856849,1,-1,0,446,158,157,-1
"f4ce60b4a944484082ccb701b48b3da1","f03480cf4eba413194d7af52fc0e7f28",22856849,1,-6,0,447,157,152,-5
"f03480cf4eba413194d7af52fc0e7f28","8aae34f5ddbb4052a709b12e6b0d40fa",22856849,1,-6,0,448,152,147,-5
"8aae34f5ddbb4052a709b12e6b0d40fa","f902b0f41b544d4dbf79664fd233648d",22856849,1,-1,0,449,147,146,-1
"f902b0f41b544d4dbf79664fd233648d","6c5ad271a44743479bfaea29b1db8d02",22856849,1,-4,0,450,146,143,-3
"6c5ad271a44743479bfaea29b1db8d02","779f9ddd1fd14d1e9e69f72219a1fdbd",22856849,1,-27,0,451,143,121,-22
"779f9ddd1fd14d1e9e69f72219a1fdbd","df1de691dafe4549a18a4398ee9dfaf9",22856849,2,23,0,452,121,139,18
"df1de691dafe4549a18a4398ee9dfaf9","df1de691dafe4549a18a4398ee9dfaf9",22856849,1,0,1,453,139,139,0
"df1de691dafe4549a18a4398ee9dfaf9","6c5ad271a44743479bfaea29b1db8d02",22856849,2,4,0,454,139,143,4
"779f9ddd1fd14d1e9e69f72219a1fdbd","779f9ddd1fd14d1e9e69f72219a1fdbd",22856849,1,0,1,457,121,121,0
"6c5ad271a44743479bfaea29b1db8d02","6c5ad271a44743479bfaea29b1db8d02",22856849,2,0,1,460,143,143,0
"6c5ad271a44743479bfaea29b1db8d02","83d311bed5374fee83d8d67a7d9d82dc",22856849,1,1,0,462,143,144,1
"83d311bed5374fee83d8d67a7d9d82dc","83d311bed5374fee83d8d67a7d9d82dc",22856849,1,0,1,463,144,144,0
"83d311bed5374fee83d8d67a7d9d82dc","402bba41861d43acb52a5abb89e8831e",22856849,1,1,0,464,144,145,1
"402bba41861d43acb52a5abb89e8831e","402bba41861d43acb52a5abb89e8831e",22856849,2,0,1,465,145,145,0
"402bba41861d43acb52a5abb89e8831e","df1de691dafe4549a18a4398ee9dfaf9",22856849,1,-6,0,467,145,139,-6
"df1de691dafe4549a18a4398ee9dfaf9","8aae34f5ddbb4052a709b12e6b0d40fa",22856849,1,9,0,468,139,147,8
"8aae34f5ddbb4052a709b12e6b0d40fa","8aae34f5ddbb4052a709b12e6b0d40fa",22856849,5,0,1,469,147,147,0
"8aae34f5ddbb4052a709b12e6b0d40fa","645b3f0249f64f76af2e19eb4d0e55b7",22856849,1,2,0,474,147,149,2
"645b3f0249f64f76af2e19eb4d0e55b7","645b3f0249f64f76af2e19eb4d0e55b7",22856849,2,0,1,475,149,149,0
"645b3f0249f64f76af2e19eb4d0e55b7","7e7b8db5064d4369805ab370aac5ddfb",22856849,1,1,0,477,149,150,1
"7e7b8db5064d4369805ab370aac5ddfb","7e7b8db5064d4369805ab370aac5ddfb",22856849,2,0,1,478,150,150,0
"7e7b8db5064d4369805ab370aac5ddfb","8956d210ae7f41968fada86d4c979d6a",22856849,1,1,0,480,150,151,1
"8956d210ae7f41968fada86d4c979d6a","8956d210ae7f41968fada86d4c979d6a",22856849,2,0,1,481,151,151,0
"8956d210ae7f41968fada86d4c979d6a","f902b0f41b544d4dbf79664fd233648d",22856849,1,-5,0,483,151,146,-5
"f902b0f41b544d4dbf79664fd233648d","ae781e8b775e4ccd93bc800dad5c8376",22856849,1,8,0,484,146,153,7
"ae781e8b775e4ccd93bc800dad5c8376","ae781e8b775e4ccd93bc800dad5c8376",22856849,2,0,1,485,153,153,0
"ae781e8b775e4ccd93bc800dad5c8376","06882a8492d9499aa31555567f575ecb",22856849,1,1,0,487,153,154,1
"06882a8492d9499aa31555567f575ecb","06882a8492d9499aa31555567f575ecb",22856849,1,0,1,488,154,154,0
"06882a8492d9499aa31555567f575ecb","f293c508f409466a8f27ddd7d1e40b20",22856849,1,1,0,489,154,155,1
"f293c508f409466a8f27ddd7d1e40b20","f293c508f409466a8f27ddd7d1e40b20",22856849,8,0,1,490,155,155,0
"f293c508f409466a8f27ddd7d1e40b20","cc4ddef5bbbe48ebb605141b347c4ed1",22856849,1,1,0,498,155,156,1
"cc4ddef5bbbe48ebb605141b347c4ed1","cc4ddef5bbbe48ebb605141b347c4ed1",22856849,4,0,1,499,156,156,0
"cc4ddef5bbbe48ebb605141b347c4ed1","d313cec988a84645bee413e8d4724a4b",22856849,1,3,0,503,156,158,2
"d313cec988a84645bee413e8d4724a4b","f03480cf4eba413194d7af52fc0e7f28",22856849,1,-7,0,504,158,152,-6
"d313cec988a84645bee413e8d4724a4b","d313cec988a84645bee413e8d4724a4b",22856849,3,0,1,506,158,158,0
"d313cec988a84645bee413e8d4724a4b","dc60696c76a74368a60f72246e47700d",22856849,1,1,0,509,158,159,1
"dc60696c76a74368a60f72246e47700d","dc60696c76a74368a60f72246e47700d",22856849,1,0,1,510,159,159,0
"dc60696c76a74368a60f72246e47700d","78adeee1fa2c4fe0bc73f7bca9fcee86",22856849,1,3,0,511,159,160,1
"78adeee1fa2c4fe0bc73f7bca9fcee86","78adeee1fa2c4fe0bc73f7bca9fcee86",22856849,1,0,1,514,160,160,0
"65202579580f4ad38d734b4ee39d22a8","78adeee1fa2c4fe0bc73f7bca9fcee86",22856849,4,-5,0,536,164,160,-4
"78adeee1fa2c4fe0bc73f7bca9fcee86","8959e6304a0348309a771e4d08d1b64a",22856849,1,4,0,537,160,163,3
"65202579580f4ad38d734b4ee39d22a8","3cbcea2be0984e7dbd5a48195af10ce7",22856849,1,3,0,548,164,165,1
"3cbcea2be0984e7dbd5a48195af10ce7","3cbcea2be0984e7dbd5a48195af10ce7",22856849,2,0,1,549,165,165,0
"82e6285962b8400d9d6fc32436022a94","67a089198fcb4e1c8f2385786c2b296f",22856849,1,-162,0,551,167,39,-128
"67a089198fcb4e1c8f2385786c2b296f","b534b89233134e30a9b5645138bfa9ee",22856849,1,4,0,552,39,41,2
"6e13d61a7bdb44bca949c9f86fab3be5","b534b89233134e30a9b5645138bfa9ee",22856849,1,-7,0,555,47,41,-6
"b534b89233134e30a9b5645138bfa9ee","d0c74f735e024943943e40333d6d337f",22856849,1,12,0,556,41,51,10
"d9c8d8c444a64dadbbb508652c721e17","f924752d8a1149668870b1e7698486f7",22856849,1,5,0,558,46,50,4
"f924752d8a1149668870b1e7698486f7","78f30e4dcac84e3cbea8b2cc6e0d62b3",22856849,1,10,0,559,50,59,9
"a1f2f12debe5432fb7a70bcd12bacfb9","3cbcea2be0984e7dbd5a48195af10ce7",22856849,1,136,0,561,58,165,107
"82e6285962b8400d9d6fc32436022a94","78adeee1fa2c4fe0bc73f7bca9fcee86",22856849,2,-10,0,564,167,160,-7
"78adeee1fa2c4fe0bc73f7bca9fcee86","a9ac840f098c4bd0a2ee896214ce29cd",22856849,1,13,0,609,160,168,8
"a9ac840f098c4bd0a2ee896214ce29cd","a9ac840f098c4bd0a2ee896214ce29cd",22856849,2,0,1,610,168,168,0
"a9ac840f098c4bd0a2ee896214ce29cd","0c7262dff33c4087bc660ccf40f92f9c",22856849,1,4,0,612,168,169,1
"0c7262dff33c4087bc660ccf40f92f9c","b2275c3fad834f8d90737a2d9a6927d6",22856849,2,3,0,613,169,172,3
"b2275c3fad834f8d90737a2d9a6927d6","8959e6304a0348309a771e4d08d1b64a",22856849,1,-16,0,614,172,163,-9
"65202579580f4ad38d734b4ee39d22a8","82ae07bc0c9b4570a41799290d1ef399",22856849,1,151,0,636,164,275,111
"82ae07bc0c9b4570a41799290d1ef399","0d987bed3ffa4ed0b9a2e62e97b7b30f",22856849,2,-4,0,637,275,272,-3
"0d987bed3ffa4ed0b9a2e62e97b7b30f","0c7262dff33c4087bc660ccf40f92f9c",22856849,1,-135,0,638,272,169,-103
"0c7262dff33c4087bc660ccf40f92f9c","0c7262dff33c4087bc660ccf40f92f9c",22856849,2,0,1,639,169,169,0
"b2275c3fad834f8d90737a2d9a6927d6","b2275c3fad834f8d90737a2d9a6927d6",22856849,65,0,1,641,172,172,0
"b2275c3fad834f8d90737a2d9a6927d6","eb515a26030b41f8a82a1e6114420bad",22856849,1,1,0,706,172,173,1
"eb515a26030b41f8a82a1e6114420bad","eb515a26030b41f8a82a1e6114420bad",22856849,2,0,1,707,173,173,0
"eb515a26030b41f8a82a1e6114420bad","b42cc17b7de840f181a704558d0bc845",22856849,1,3,0,709,173,175,2
"b42cc17b7de840f181a704558d0bc845","0c7262dff33c4087bc660ccf40f92f9c",22856849,1,-7,0,710,175,169,-6
"0c7262dff33c4087bc660ccf40f92f9c","b42cc17b7de840f181a704558d0bc845",22856849,1,7,0,711,169,175,6
"b42cc17b7de840f181a704558d0bc845","b42cc17b7de840f181a704558d0bc845",22856849,2,0,1,712,175,175,0
"b42cc17b7de840f181a704558d0bc845","801f9e9135034f49bf5f8b4bdefedb41",22856849,1,2,0,714,175,177,2
"801f9e9135034f49bf5f8b4bdefedb41","801f9e9135034f49bf5f8b4bdefedb41",22856849,6,0,1,715,177,177,0
"801f9e9135034f49bf5f8b4bdefedb41","ea38cc0e6e6e41edbabf210220808bf9",22856849,1,3,0,721,177,179,2
"ea38cc0e6e6e41edbabf210220808bf9","362fcb0699a14845ab29b2340093e528",22856849,1,-6,0,722,179,174,-5
"362fcb0699a14845ab29b2340093e528","b87c552dd247427abe6ab5795b9c9d43",22856849,1,8,0,723,174,181,7
"b87c552dd247427abe6ab5795b9c9d43","ea38cc0e6e6e41edbabf210220808bf9",22856849,1,-2,0,724,181,179,-2
"ea38cc0e6e6e41edbabf210220808bf9","ea38cc0e6e6e41edbabf210220808bf9",22856849,6,0,1,725,179,179,0
"ea38cc0e6e6e41edbabf210220808bf9","b87c552dd247427abe6ab5795b9c9d43",22856849,1,2,0,731,179,181,2
"b87c552dd247427abe6ab5795b9c9d43","b87c552dd247427abe6ab5795b9c9d43",22856849,7,0,1,732,181,181,0
"b87c552dd247427abe6ab5795b9c9d43","139b097acfca451689d80c9c6eebdf7b",22856849,1,-3,0,739,181,178,-3
"139b097acfca451689d80c9c6eebdf7b","30f660a1feb34582a739722532524f79",22856849,1,6,0,740,178,183,5
"30f660a1feb34582a739722532524f79","30f660a1feb34582a739722532524f79",22856849,5,0,1,741,183,183,0
"30f660a1feb34582a739722532524f79","2024b4885bd14338a39b7b509acbbd02",22856849,1,-1,0,746,183,182,-1
"2024b4885bd14338a39b7b509acbbd02","c3f63fe50d8e487c86bf8ef76c9cadd3",22856849,1,4,0,747,182,185,3
"c3f63fe50d8e487c86bf8ef76c9cadd3","c3f63fe50d8e487c86bf8ef76c9cadd3",22856849,1,0,1,748,185,185,0
"c3f63fe50d8e487c86bf8ef76c9cadd3","c8e371568a0c4391b25796ae4e91952e",22856849,1,3,0,749,185,186,1
"c8e371568a0c4391b25796ae4e91952e","0c7262dff33c4087bc660ccf40f92f9c",22856849,2,-23,0,750,186,169,-17
"0c7262dff33c4087bc660ccf40f92f9c","7d932b23e1c84326ae5aa4d3c0d813d1",22856849,1,25,0,751,169,188,19
"7d932b23e1c84326ae5aa4d3c0d813d1","7d932b23e1c84326ae5aa4d3c0d813d1",22856849,1,0,1,752,188,188,0
"7d932b23e1c84326ae5aa4d3c0d813d1","ab11d94c6c8948ea90b88f19d2cd502b",22856849,1,3,0,753,188,190,2
"ab11d94c6c8948ea90b88f19d2cd502b","c8e371568a0c4391b25796ae4e91952e",22856849,1,-5,0,754,190,186,-4
"c8e371568a0c4391b25796ae4e91952e","ab11d94c6c8948ea90b88f19d2cd502b",22856849,1,5,0,755,186,190,4
"ab11d94c6c8948ea90b88f19d2cd502b","ab11d94c6c8948ea90b88f19d2cd502b",22856849,3,0,1,756,190,190,0
"ab11d94c6c8948ea90b88f19d2cd502b","f992451ed6ad4e68bb9e68ad6be7c4be",22856849,1,2,0,759,190,192,2
"f992451ed6ad4e68bb9e68ad6be7c4be","f992451ed6ad4e68bb9e68ad6be7c4be",22856849,1,0,1,760,192,192,0
"f992451ed6ad4e68bb9e68ad6be7c4be","07b44a7a51e94c78b411c753fc39dab0",22856849,1,-3,0,761,192,189,-3
"07b44a7a51e94c78b411c753fc39dab0","6cd2dcaac46847d4a0bc53f296d90375",22856849,1,6,0,762,189,194,5
"6cd2dcaac46847d4a0bc53f296d90375","6cd2dcaac46847d4a0bc53f296d90375",22856849,2,0,1,763,194,194,0
"6cd2dcaac46847d4a0bc53f296d90375","2d2580c9411c4972909db508d6956a58",22856849,1,2,0,765,194,196,2
"2d2580c9411c4972909db508d6956a58","2d2580c9411c4972909db508d6956a58",22856849,2,0,1,766,196,196,0
"2d2580c9411c4972909db508d6956a58","5bddb3d9ed264f3984702f048c7e5340",22856849,1,1,0,768,196,197,1
"5bddb3d9ed264f3984702f048c7e5340","5bddb3d9ed264f3984702f048c7e5340",22856849,2,0,1,769,197,197,0
"5bddb3d9ed264f3984702f048c7e5340","d5e8e2bd12a2466b9d6d90855f0eb079",22856849,1,1,0,771,197,198,1
"d5e8e2bd12a2466b9d6d90855f0eb079","d5e8e2bd12a2466b9d6d90855f0eb079",22856849,2,0,1,772,198,198,0
"d5e8e2bd12a2466b9d6d90855f0eb079","017d7ca8e0394b91aaadc9574df2202c",22856849,1,-5,0,774,198,193,-5
"017d7ca8e0394b91aaadc9574df2202c","54e8e9f0ea3e45c4bf3b8ac799ee31b1",22856849,1,8,0,775,193,200,7
"54e8e9f0ea3e45c4bf3b8ac799ee31b1","54e8e9f0ea3e45c4bf3b8ac799ee31b1",22856849,3,0,1,776,200,200,0
"54e8e9f0ea3e45c4bf3b8ac799ee31b1","c614a00911be4877a075f19315530fb0",22856849,1,1,0,779,200,201,1
"c614a00911be4877a075f19315530fb0","c614a00911be4877a075f19315530fb0",22856849,13,0,1,780,201,201,0
"c614a00911be4877a075f19315530fb0","a6c21bd8b95249c7972820a7a7d76aff",22856849,1,1,0,793,201,202,1
"a6c21bd8b95249c7972820a7a7d76aff","a6c21bd8b95249c7972820a7a7d76aff",22856849,1,0,1,794,202,202,0
"a6c21bd8b95249c7972820a7a7d76aff","bb329d880ab54120adaf203a693bb203",22856849,1,1,0,795,202,203,1
"bb329d880ab54120adaf203a693bb203","bb329d880ab54120adaf203a693bb203",22856849,3,0,1,796,203,203,0
"bb329d880ab54120adaf203a693bb203","f9170dd6bc6442b4acd832747609b09a",22856849,1,-4,0,799,203,199,-4
"f9170dd6bc6442b4acd832747609b09a","334c2344009840079b1d0e1b7ce3d5a7",22856849,1,7,0,800,199,205,6
"334c2344009840079b1d0e1b7ce3d5a7","334c2344009840079b1d0e1b7ce3d5a7",22856849,3,0,1,801,205,205,0
"334c2344009840079b1d0e1b7ce3d5a7","d7f13c8d63ec4e2aa673fbb9cf9c6933",22856849,1,3,0,804,205,206,1
"d7f13c8d63ec4e2aa673fbb9cf9c6933","c8e371568a0c4391b25796ae4e91952e",22856849,3,-26,0,805,206,186,-20
"c8e371568a0c4391b25796ae4e91952e","b9e80f77c3a44349863b19875725c384",22856849,2,27,0,806,186,207,21
"b9e80f77c3a44349863b19875725c384","7108f0e4c2584f1f9c471689ae4c885c",22856849,4,1,0,807,207,208,1
"7108f0e4c2584f1f9c471689ae4c885c","1c6721b1f63f4d30ba7746ea8af02a52",22856849,1,19,0,808,208,221,13
"d7f13c8d63ec4e2aa673fbb9cf9c6933","1c6721b1f63f4d30ba7746ea8af02a52",22856849,1,21,0,810,206,221,15
"77ecef8eff6b4a2caea7707669bf7475","363837c182e04711840d896ae1e0339c",22856849,1,-7,0,812,222,218,-4
"363837c182e04711840d896ae1e0339c","be95c065e45447c1bd8215ea6f130c7a",22856849,1,2,0,813,218,219,1
"be95c065e45447c1bd8215ea6f130c7a","f7fb1952f56b4189b86a9f8b7862d2b8",22856849,1,-6,0,814,219,215,-4
"f7fb1952f56b4189b86a9f8b7862d2b8","01b2051f8941460d89945e3b02d1ce78",22856849,1,3,0,815,215,217,2
"01b2051f8941460d89945e3b02d1ce78","be502a7a43c44bf7b682698de79d9369",22856849,1,-4,0,816,217,214,-3
"be502a7a43c44bf7b682698de79d9369","09400e101c5d4b439cf9a26b03aae558",22856849,1,-5,0,817,214,210,-4
"09400e101c5d4b439cf9a26b03aae558","ec341f459285443b8361f7f15638ff08",22856849,1,4,0,818,210,213,3
"ec341f459285443b8361f7f15638ff08","7108f0e4c2584f1f9c471689ae4c885c",22856849,1,-7,0,819,213,208,-5
"7108f0e4c2584f1f9c471689ae4c885c","b9e80f77c3a44349863b19875725c384",22856849,3,-1,0,820,208,207,-1
"b9e80f77c3a44349863b19875725c384","a875096404ef4a9984b62d74cda916f9",22856849,1,3,0,821,207,209,2
"a875096404ef4a9984b62d74cda916f9","c8e371568a0c4391b25796ae4e91952e",22856849,1,-30,0,822,209,186,-23
"c8e371568a0c4391b25796ae4e91952e","d7f13c8d63ec4e2aa673fbb9cf9c6933",22856849,1,26,0,823,186,206,20
"d7f13c8d63ec4e2aa673fbb9cf9c6933","b54257a550b94ebc9538f3a90eee9d7e",22856849,1,-4,0,824,206,204,-2
"f9170dd6bc6442b4acd832747609b09a","6cd2dcaac46847d4a0bc53f296d90375",22856849,1,-6,0,826,199,194,-5
"6cd2dcaac46847d4a0bc53f296d90375","017d7ca8e0394b91aaadc9574df2202c",22856849,1,-1,0,827,194,193,-1
"017d7ca8e0394b91aaadc9574df2202c","017d7ca8e0394b91aaadc9574df2202c",22856849,2,0,1,828,193,193,0
"017d7ca8e0394b91aaadc9574df2202c","f9170dd6bc6442b4acd832747609b09a",22856849,1,7,0,830,193,199,6
"f9170dd6bc6442b4acd832747609b09a","d7f13c8d63ec4e2aa673fbb9cf9c6933",22856849,1,10,0,831,199,206,7
"09400e101c5d4b439cf9a26b03aae558","363837c182e04711840d896ae1e0339c",22856849,1,10,0,839,210,218,8
"363837c182e04711840d896ae1e0339c","a875096404ef4a9984b62d74cda916f9",22856849,1,-11,0,840,218,209,-9
"a875096404ef4a9984b62d74cda916f9","01b2051f8941460d89945e3b02d1ce78",22856849,1,10,0,841,209,217,8
"01b2051f8941460d89945e3b02d1ce78","1c6721b1f63f4d30ba7746ea8af02a52",22856849,1,7,0,842,217,221,4
"8b9ae98743bd4d4a8a87dff1c1244211","f7906d6f59b9489a91d2ef40db5a474d",22856849,1,-4,0,848,227,223,-4
"2ab1535aac1346ba8801535bf729ef37","0c7262dff33c4087bc660ccf40f92f9c",22856849,1,-80,0,850,229,169,-60
"0c7262dff33c4087bc660ccf40f92f9c","1c6721b1f63f4d30ba7746ea8af02a52",22856849,1,70,0,851,169,221,52
"1c6721b1f63f4d30ba7746ea8af02a52","f7906d6f59b9489a91d2ef40db5a474d",22856849,1,3,0,852,221,223,2
"f7906d6f59b9489a91d2ef40db5a474d","d03cb855c70044cf8c35d9ec0de696e3",22856849,1,1,0,853,223,224,1
"d03cb855c70044cf8c35d9ec0de696e3","8b9ae98743bd4d4a8a87dff1c1244211",22856849,1,3,0,854,224,227,3
"d03cb855c70044cf8c35d9ec0de696e3","2ab1535aac1346ba8801535bf729ef37",22856849,1,6,0,856,224,229,5
"2ab1535aac1346ba8801535bf729ef37","5152833676bf4c6cb317060be10f68db",22856849,1,-1,0,859,229,228,-1
"5152833676bf4c6cb317060be10f68db","0b04c8e2f86d48c7aeb7e225819cd32b",22856849,1,7,0,860,228,234,6
"1c6721b1f63f4d30ba7746ea8af02a52","2ae94c0cea4d480a9d5dca8fb1d7b542",22856849,1,27,0,862,221,242,21
"1ebf23f9d994469a85206e4c7b1bf5f5","0c7262dff33c4087bc660ccf40f92f9c",22856849,1,-100,0,864,245,169,-76
"0c7262dff33c4087bc660ccf40f92f9c","ec341f459285443b8361f7f15638ff08",22856849,1,58,0,865,169,213,44
"ec341f459285443b8361f7f15638ff08","d7f13c8d63ec4e2aa673fbb9cf9c6933",22856849,1,-9,0,866,213,206,-7
"d7f13c8d63ec4e2aa673fbb9cf9c6933","be502a7a43c44bf7b682698de79d9369",22856849,1,10,0,867,206,214,8
"be502a7a43c44bf7b682698de79d9369","0c7262dff33c4087bc660ccf40f92f9c",22856849,1,-59,0,870,214,169,-45
"0c7262dff33c4087bc660ccf40f92f9c","d546341988904f069cfa86b21457d9d9",22856849,1,108,0,871,169,251,82
"d546341988904f069cfa86b21457d9d9","2ae94c0cea4d480a9d5dca8fb1d7b542",22856849,1,-11,0,872,251,242,-9
"2ae94c0cea4d480a9d5dca8fb1d7b542","00f61990949545828dd12f1303d47504",22856849,1,17,0,873,242,256,14
"00f61990949545828dd12f1303d47504","00f61990949545828dd12f1303d47504",22856849,4,0,1,874,256,256,0
"00f61990949545828dd12f1303d47504","d989ebcfc12a4b669f0100dc1aa14f1e",22856849,1,-1,0,875,256,255,-1
"d989ebcfc12a4b669f0100dc1aa14f1e","2ae94c0cea4d480a9d5dca8fb1d7b542",22856849,2,-16,0,876,255,242,-13
"2ae94c0cea4d480a9d5dca8fb1d7b542","d989ebcfc12a4b669f0100dc1aa14f1e",22856849,2,16,0,877,242,255,13
"d989ebcfc12a4b669f0100dc1aa14f1e","00f61990949545828dd12f1303d47504",22856849,1,1,0,880,255,256,1
"00f61990949545828dd12f1303d47504","0c7262dff33c4087bc660ccf40f92f9c",22856849,1,-114,0,883,256,169,-87
"0c7262dff33c4087bc660ccf40f92f9c","d7f13c8d63ec4e2aa673fbb9cf9c6933",22856849,2,49,0,885,169,206,37
"d7f13c8d63ec4e2aa673fbb9cf9c6933","d7f13c8d63ec4e2aa673fbb9cf9c6933",22856849,3,0,1,886,206,206,0
"d7f13c8d63ec4e2aa673fbb9cf9c6933","b9e80f77c3a44349863b19875725c384",22856849,1,1,0,887,206,207,1
"0c7262dff33c4087bc660ccf40f92f9c","2ae94c0cea4d480a9d5dca8fb1d7b542",22856849,1,97,0,892,169,242,73
"2ae94c0cea4d480a9d5dca8fb1d7b542","2ae94c0cea4d480a9d5dca8fb1d7b542",22856849,1,0,1,893,242,242,0
"1ebf23f9d994469a85206e4c7b1bf5f5","1ebf23f9d994469a85206e4c7b1bf5f5",22856849,13,0,1,895,245,245,0
"1ebf23f9d994469a85206e4c7b1bf5f5","85ae675b83e8422da842cfd25596af99",22856849,1,1,0,908,245,246,1
"85ae675b83e8422da842cfd25596af99","85ae675b83e8422da842cfd25596af99",22856849,1,0,1,909,246,246,0
"85ae675b83e8422da842cfd25596af99","2ae94c0cea4d480a9d5dca8fb1d7b542",22856849,1,-4,0,910,246,242,-4
"fa235f0f364d47e4ae1c87f47bf8e6ba","fa235f0f364d47e4ae1c87f47bf8e6ba",22856849,6,0,1,912,252,252,0
"fa235f0f364d47e4ae1c87f47bf8e6ba","79f7845465cc4ed19d8e4f1429541be0",22856849,1,2,0,918,252,254,2
"79f7845465cc4ed19d8e4f1429541be0","79f7845465cc4ed19d8e4f1429541be0",22856849,2,0,1,919,254,254,0
"79f7845465cc4ed19d8e4f1429541be0","00f61990949545828dd12f1303d47504",22856849,1,3,0,921,254,256,2
"00f61990949545828dd12f1303d47504","ead7bb4b64e247d2ae632ab8a296b091",22856849,1,2,0,925,256,258,2
"ead7bb4b64e247d2ae632ab8a296b091","ead7bb4b64e247d2ae632ab8a296b091",22856849,2,0,1,926,258,258,0
"ead7bb4b64e247d2ae632ab8a296b091","41b0048dde734bb280bac6116baa8e27",22856849,1,1,0,928,258,259,1
"41b0048dde734bb280bac6116baa8e27","41b0048dde734bb280bac6116baa8e27",22856849,2,0,1,929,259,259,0
"41b0048dde734bb280bac6116baa8e27","b41c5a094a604ee0915327da5cc0beb7",22856849,1,1,0,931,259,260,1
"b41c5a094a604ee0915327da5cc0beb7","b41c5a094a604ee0915327da5cc0beb7",22856849,2,0,1,932,260,260,0
"b41c5a094a604ee0915327da5cc0beb7","d546341988904f069cfa86b21457d9d9",22856849,1,-10,0,934,260,251,-9
"d546341988904f069cfa86b21457d9d9","28c171777c52431ab6b925073bd63d46",22856849,1,15,0,935,251,264,13
"28c171777c52431ab6b925073bd63d46","28c171777c52431ab6b925073bd63d46",22856849,7,0,1,936,264,264,0
"28c171777c52431ab6b925073bd63d46","ac160db940cb49ae8579162b1d52bb5d",22856849,1,2,0,943,264,266,2
"ac160db940cb49ae8579162b1d52bb5d","ac160db940cb49ae8579162b1d52bb5d",22856849,7,0,1,944,266,266,0
"ac160db940cb49ae8579162b1d52bb5d","d989ebcfc12a4b669f0100dc1aa14f1e",22856849,1,-12,0,951,266,255,-11
"d989ebcfc12a4b669f0100dc1aa14f1e","c6fd49b485cc4874b0bbdd9c6171e09c",22856849,1,15,0,952,255,268,13
"c6fd49b485cc4874b0bbdd9c6171e09c","c6fd49b485cc4874b0bbdd9c6171e09c",22856849,3,0,1,953,268,268,0
"c6fd49b485cc4874b0bbdd9c6171e09c","44240778a97c4af0937817499b75707b",22856849,1,1,0,956,268,269,1
"44240778a97c4af0937817499b75707b","44240778a97c4af0937817499b75707b",22856849,2,0,1,957,269,269,0
"44240778a97c4af0937817499b75707b","7aa76d3e993840d8805f097cbdbcd44b",22856849,1,-9,0,959,269,261,-8
"7aa76d3e993840d8805f097cbdbcd44b","865a4d3b43374da7944dc7d397f566d9",22856849,1,12,0,960,261,271,10
"865a4d3b43374da7944dc7d397f566d9","865a4d3b43374da7944dc7d397f566d9",22856849,1,0,1,961,271,271,0
"865a4d3b43374da7944dc7d397f566d9","0d987bed3ffa4ed0b9a2e62e97b7b30f",22856849,1,3,0,962,271,272,1
"82ae07bc0c9b4570a41799290d1ef399","2ae94c0cea4d480a9d5dca8fb1d7b542",22856849,1,-42,0,968,275,242,-33
"2ae94c0cea4d480a9d5dca8fb1d7b542","d7f13c8d63ec4e2aa673fbb9cf9c6933",22856849,1,-48,0,971,242,206,-36
"d7f13c8d63ec4e2aa673fbb9cf9c6933","7108f0e4c2584f1f9c471689ae4c885c",22856849,2,2,0,973,206,208,2
"b9e80f77c3a44349863b19875725c384","0c7262dff33c4087bc660ccf40f92f9c",22856849,1,-50,0,975,207,169,-38
"b9e80f77c3a44349863b19875725c384","b9e80f77c3a44349863b19875725c384",22856849,13,0,1,980,207,207,0
"7108f0e4c2584f1f9c471689ae4c885c","7108f0e4c2584f1f9c471689ae4c885c",22856849,14,0,1,1000,208,208,0
"7108f0e4c2584f1f9c471689ae4c885c","d7f13c8d63ec4e2aa673fbb9cf9c6933",22856849,3,-2,0,1008,208,206,-2
"d7f13c8d63ec4e2aa673fbb9cf9c6933","09400e101c5d4b439cf9a26b03aae558",22856849,2,5,0,1009,206,210,4
"09400e101c5d4b439cf9a26b03aae558","09400e101c5d4b439cf9a26b03aae558",22856849,8,0,1,1010,210,210,0
"09400e101c5d4b439cf9a26b03aae558","a88efa7e50ce47159810ab553afa6d3a",22856849,1,2,0,1016,210,212,2
"a88efa7e50ce47159810ab553afa6d3a","a88efa7e50ce47159810ab553afa6d3a",22856849,2,0,1,1017,212,212,0
"a88efa7e50ce47159810ab553afa6d3a","be502a7a43c44bf7b682698de79d9369",22856849,1,3,0,1019,212,214,2
"be502a7a43c44bf7b682698de79d9369","a875096404ef4a9984b62d74cda916f9",22856849,1,-6,0,1020,214,209,-5
"a875096404ef4a9984b62d74cda916f9","f7fb1952f56b4189b86a9f8b7862d2b8",22856849,1,7,0,1021,209,215,6
"f7fb1952f56b4189b86a9f8b7862d2b8","be502a7a43c44bf7b682698de79d9369",22856849,2,-1,0,1022,215,214,-1
"be502a7a43c44bf7b682698de79d9369","be502a7a43c44bf7b682698de79d9369",22856849,3,0,1,1023,214,214,0
"be502a7a43c44bf7b682698de79d9369","f7fb1952f56b4189b86a9f8b7862d2b8",22856849,2,1,0,1026,214,215,1
"f7fb1952f56b4189b86a9f8b7862d2b8","f7fb1952f56b4189b86a9f8b7862d2b8",22856849,21,0,1,1027,215,215,0
"f7fb1952f56b4189b86a9f8b7862d2b8","b860ee85d8bc4a2f97958cfb71be3533",22856849,1,1,0,1048,215,216,1
"b860ee85d8bc4a2f97958cfb71be3533","b860ee85d8bc4a2f97958cfb71be3533",22856849,2,0,1,1049,216,216,0
"b860ee85d8bc4a2f97958cfb71be3533","ec341f459285443b8361f7f15638ff08",22856849,1,-3,0,1051,216,213,-3
"ec341f459285443b8361f7f15638ff08","363837c182e04711840d896ae1e0339c",22856849,1,6,0,1052,213,218,5
"363837c182e04711840d896ae1e0339c","363837c182e04711840d896ae1e0339c",22856849,13,0,1,1053,218,218,0
"363837c182e04711840d896ae1e0339c","01b2051f8941460d89945e3b02d1ce78",22856849,1,-1,0,1066,218,217,-1
"01b2051f8941460d89945e3b02d1ce78","91125ca626c5470eb145501f8c37f8db",22856849,1,4,0,1067,217,220,3
"91125ca626c5470eb145501f8c37f8db","91125ca626c5470eb145501f8c37f8db",22856849,1,0,1,1068,220,220,0
"91125ca626c5470eb145501f8c37f8db","1c6721b1f63f4d30ba7746ea8af02a52",22856849,1,3,0,1069,220,221,1
"1c6721b1f63f4d30ba7746ea8af02a52","d7f13c8d63ec4e2aa673fbb9cf9c6933",22856849,3,-21,0,1070,221,206,-15
"d7f13c8d63ec4e2aa673fbb9cf9c6933","77ecef8eff6b4a2caea7707669bf7475",22856849,2,22,0,1071,206,222,16
"77ecef8eff6b4a2caea7707669bf7475","0c7262dff33c4087bc660ccf40f92f9c",22856849,1,-71,0,1072,222,169,-53
"0c7262dff33c4087bc660ccf40f92f9c","7028800abe7d4e27b613d1d6cbe26bf7",22856849,1,127,0,1073,169,267,98
"7028800abe7d4e27b613d1d6cbe26bf7","2ae94c0cea4d480a9d5dca8fb1d7b542",22856849,2,-30,0,1074,267,242,-25
"2ae94c0cea4d480a9d5dca8fb1d7b542","0d987bed3ffa4ed0b9a2e62e97b7b30f",22856849,6,38,0,1075,242,272,30
"0d987bed3ffa4ed0b9a2e62e97b7b30f","2ae94c0cea4d480a9d5dca8fb1d7b542",22856849,4,-38,0,1076,272,242,-30
"0d987bed3ffa4ed0b9a2e62e97b7b30f","0d987bed3ffa4ed0b9a2e62e97b7b30f",22856849,4,0,1,1078,272,272,0
"0d987bed3ffa4ed0b9a2e62e97b7b30f","d7f13c8d63ec4e2aa673fbb9cf9c6933",22856849,1,-86,0,1079,272,206,-66
"d7f13c8d63ec4e2aa673fbb9cf9c6933","363837c182e04711840d896ae1e0339c",22856849,1,15,0,1080,206,218,12
"363837c182e04711840d896ae1e0339c","7aa76d3e993840d8805f097cbdbcd44b",22856849,1,56,0,1081,218,261,43
"7aa76d3e993840d8805f097cbdbcd44b","2ae94c0cea4d480a9d5dca8fb1d7b542",22856849,2,-23,0,1082,261,242,-19
"2ae94c0cea4d480a9d5dca8fb1d7b542","7028800abe7d4e27b613d1d6cbe26bf7",22856849,1,30,0,1083,242,267,25
"2ae94c0cea4d480a9d5dca8fb1d7b542","f9170dd6bc6442b4acd832747609b09a",22856849,1,-58,0,1085,242,199,-43
"f9170dd6bc6442b4acd832747609b09a","c8e371568a0c4391b25796ae4e91952e",22856849,2,-16,0,1086,199,186,-13
"c8e371568a0c4391b25796ae4e91952e","590fb7d4bca1466bacd357c1a234907c",22856849,1,108,0,1087,186,270,84
"590fb7d4bca1466bacd357c1a234907c","2ae94c0cea4d480a9d5dca8fb1d7b542",22856849,1,-34,0,1088,270,242,-28
"2ae94c0cea4d480a9d5dca8fb1d7b542","1ebf23f9d994469a85206e4c7b1bf5f5",22856849,3,3,0,1089,242,245,3
"1ebf23f9d994469a85206e4c7b1bf5f5","2ae94c0cea4d480a9d5dca8fb1d7b542",22856849,1,-3,0,1090,245,242,-3
"2ae94c0cea4d480a9d5dca8fb1d7b542","fa235f0f364d47e4ae1c87f47bf8e6ba",22856849,2,12,0,1091,242,252,10
"fa235f0f364d47e4ae1c87f47bf8e6ba","6e83e23f56544a19b94067c1c558d9c0",22856849,1,-6,0,1092,252,247,-5
"6e83e23f56544a19b94067c1c558d9c0","00f61990949545828dd12f1303d47504",22856849,2,11,0,1093,247,256,9
"00f61990949545828dd12f1303d47504","d546341988904f069cfa86b21457d9d9",22856849,1,-6,0,1094,256,251,-5
"d546341988904f069cfa86b21457d9d9","d989ebcfc12a4b669f0100dc1aa14f1e",22856849,2,5,0,1095,251,255,4
"d989ebcfc12a4b669f0100dc1aa14f1e","7aa76d3e993840d8805f097cbdbcd44b",22856849,2,7,0,1096,255,261,6
"7aa76d3e993840d8805f097cbdbcd44b","0d987bed3ffa4ed0b9a2e62e97b7b30f",22856849,1,15,0,1097,261,272,11
"2ae94c0cea4d480a9d5dca8fb1d7b542","0c7262dff33c4087bc660ccf40f92f9c",22856849,1,-97,0,1099,242,169,-73
"0c7262dff33c4087bc660ccf40f92f9c","0d987bed3ffa4ed0b9a2e62e97b7b30f",22856849,1,135,0,1100,169,272,103
"0d987bed3ffa4ed0b9a2e62e97b7b30f","1c6721b1f63f4d30ba7746ea8af02a52",22856849,1,-65,0,1101,272,221,-51
"1c6721b1f63f4d30ba7746ea8af02a52","1c6721b1f63f4d30ba7746ea8af02a52",22856849,1,0,1,1102,221,221,0
"1c6721b1f63f4d30ba7746ea8af02a52","77ecef8eff6b4a2caea7707669bf7475",22856849,2,1,0,1103,221,222,1
"77ecef8eff6b4a2caea7707669bf7475","77ecef8eff6b4a2caea7707669bf7475",22856849,12,0,1,1104,222,222,0
"77ecef8eff6b4a2caea7707669bf7475","d03cb855c70044cf8c35d9ec0de696e3",22856849,2,3,0,1116,222,224,2
"d03cb855c70044cf8c35d9ec0de696e3","1c6721b1f63f4d30ba7746ea8af02a52",22856849,2,-4,0,1117,224,221,-3
"1c6721b1f63f4d30ba7746ea8af02a52","8b9ae98743bd4d4a8a87dff1c1244211",22856849,2,7,0,1118,221,227,6
"8b9ae98743bd4d4a8a87dff1c1244211","d03cb855c70044cf8c35d9ec0de696e3",22856849,2,-3,0,1119,227,224,-3
"d03cb855c70044cf8c35d9ec0de696e3","a49a937d6896486d9a5396654abcf2e1",22856849,1,2,0,1120,224,226,2
"a49a937d6896486d9a5396654abcf2e1","a49a937d6896486d9a5396654abcf2e1",22856849,1,0,1,1121,226,226,0
"a49a937d6896486d9a5396654abcf2e1","8b9ae98743bd4d4a8a87dff1c1244211",22856849,1,1,0,1122,226,227,1
"8b9ae98743bd4d4a8a87dff1c1244211","8b9ae98743bd4d4a8a87dff1c1244211",22856849,27,0,1,1123,227,227,0
"8b9ae98743bd4d4a8a87dff1c1244211","2ab1535aac1346ba8801535bf729ef37",22856849,1,3,0,1150,227,229,2
"2ab1535aac1346ba8801535bf729ef37","f7906d6f59b9489a91d2ef40db5a474d",22856849,2,-7,0,1151,229,223,-6
"f7906d6f59b9489a91d2ef40db5a474d","2ab1535aac1346ba8801535bf729ef37",22856849,3,7,0,1152,223,229,6
"2ab1535aac1346ba8801535bf729ef37","2ab1535aac1346ba8801535bf729ef37",22856849,2,0,1,1153,229,229,0
"2ab1535aac1346ba8801535bf729ef37","a4f40fb48a8542c8949bae1f002cd9bc",22856849,1,2,0,1155,229,231,2
"a4f40fb48a8542c8949bae1f002cd9bc","a4f40fb48a8542c8949bae1f002cd9bc",22856849,2,0,1,1156,231,231,0
"a4f40fb48a8542c8949bae1f002cd9bc","8972c23e32044edb8a78fa1eed4e5947",22856849,1,1,0,1158,231,232,1
"8972c23e32044edb8a78fa1eed4e5947","8972c23e32044edb8a78fa1eed4e5947",22856849,1,0,1,1159,232,232,0
"8972c23e32044edb8a78fa1eed4e5947","92feb4a40f8344d38b6f722e42a53295",22856849,1,1,0,1160,232,233,1
"92feb4a40f8344d38b6f722e42a53295","92feb4a40f8344d38b6f722e42a53295",22856849,2,0,1,1161,233,233,0
"92feb4a40f8344d38b6f722e42a53295","5152833676bf4c6cb317060be10f68db",22856849,1,-5,0,1163,233,228,-5
"5152833676bf4c6cb317060be10f68db","ca3e28f290354c08aefe5b0f769604e6",22856849,1,8,0,1164,228,235,7
"ca3e28f290354c08aefe5b0f769604e6","ca3e28f290354c08aefe5b0f769604e6",22856849,9,0,1,1165,235,235,0
"ca3e28f290354c08aefe5b0f769604e6","79a35eea833e4c2c9d22fc53c3c6445c",22856849,1,1,0,1174,235,236,1
"79a35eea833e4c2c9d22fc53c3c6445c","79a35eea833e4c2c9d22fc53c3c6445c",22856849,4,0,1,1175,236,236,0
"79a35eea833e4c2c9d22fc53c3c6445c","8f68228b1518449e9615cdafee41a2bd",22856849,1,1,0,1179,236,237,1
"8f68228b1518449e9615cdafee41a2bd","8f68228b1518449e9615cdafee41a2bd",22856849,1,0,1,1180,237,237,0
"8f68228b1518449e9615cdafee41a2bd","cab89fa5c3ed45a5aa550fc0352d6a42",22856849,1,1,0,1181,237,238,1
"cab89fa5c3ed45a5aa550fc0352d6a42","cab89fa5c3ed45a5aa550fc0352d6a42",22856849,3,0,1,1182,238,238,0
"cab89fa5c3ed45a5aa550fc0352d6a42","0d987bed3ffa4ed0b9a2e62e97b7b30f",22856849,1,45,0,1185,238,272,34
"0d987bed3ffa4ed0b9a2e62e97b7b30f","2024b4885bd14338a39b7b509acbbd02",22856849,1,-119,0,1187,272,182,-90
"2024b4885bd14338a39b7b509acbbd02","0c7262dff33c4087bc660ccf40f92f9c",22856849,1,-16,0,1188,182,169,-13
"0c7262dff33c4087bc660ccf40f92f9c","2024b4885bd14338a39b7b509acbbd02",22856849,1,16,0,1189,169,182,13
"2024b4885bd14338a39b7b509acbbd02","f9170dd6bc6442b4acd832747609b09a",22856849,1,23,0,1190,182,199,17
"c8e371568a0c4391b25796ae4e91952e","f9170dd6bc6442b4acd832747609b09a",22856849,1,16,0,1192,186,199,13
"f9170dd6bc6442b4acd832747609b09a","b54257a550b94ebc9538f3a90eee9d7e",22856849,1,6,0,1193,199,204,5
"b54257a550b94ebc9538f3a90eee9d7e","f9170dd6bc6442b4acd832747609b09a",22856849,2,-6,0,1194,204,199,-5
"f9170dd6bc6442b4acd832747609b09a","0b04c8e2f86d48c7aeb7e225819cd32b",22856849,1,47,0,1195,199,234,35
"0b04c8e2f86d48c7aeb7e225819cd32b","1c6721b1f63f4d30ba7746ea8af02a52",22856849,3,-16,0,1196,234,221,-13
"1c6721b1f63f4d30ba7746ea8af02a52","66d4fad4f1cf4b46be0750a99ad7a35a",22856849,1,21,0,1197,221,239,18
"66d4fad4f1cf4b46be0750a99ad7a35a","66d4fad4f1cf4b46be0750a99ad7a35a",22856849,1,0,1,1198,239,239,0
"66d4fad4f1cf4b46be0750a99ad7a35a","0c7262dff33c4087bc660ccf40f92f9c",22856849,1,-91,0,1199,239,169,-70
"0c7262dff33c4087bc660ccf40f92f9c","64dbedb3ce544f6aae8e10e0cf10f16d",22856849,1,93,0,1200,169,240,71
"64dbedb3ce544f6aae8e10e0cf10f16d","1c6721b1f63f4d30ba7746ea8af02a52",22856849,1,-23,0,1201,240,221,-19
"1c6721b1f63f4d30ba7746ea8af02a52","f53da5fd9bfe412da4b80d4742563b6c",22856849,1,24,0,1202,221,241,20
"f53da5fd9bfe412da4b80d4742563b6c","f53da5fd9bfe412da4b80d4742563b6c",22856849,1,0,1,1203,241,241,0
"f53da5fd9bfe412da4b80d4742563b6c","8959e6304a0348309a771e4d08d1b64a",22856849,1,-107,0,1204,241,163,-78
"8959e6304a0348309a771e4d08d1b64a","78adeee1fa2c4fe0bc73f7bca9fcee86",22856849,4,-4,0,1205,163,160,-3
"78adeee1fa2c4fe0bc73f7bca9fcee86","65202579580f4ad38d734b4ee39d22a8",22856849,7,5,0,1206,160,164,4
"65202579580f4ad38d734b4ee39d22a8","65202579580f4ad38d734b4ee39d22a8",22856849,102,0,1,1207,164,164,0
"65202579580f4ad38d734b4ee39d22a8","8959e6304a0348309a771e4d08d1b64a",22856849,1,-1,0,1227,164,163,-1
"78adeee1fa2c4fe0bc73f7bca9fcee86","3cbcea2be0984e7dbd5a48195af10ce7",22856849,2,8,0,1229,160,165,5
"3cbcea2be0984e7dbd5a48195af10ce7","82e6285962b8400d9d6fc32436022a94",22856849,4,2,0,1230,165,167,2
"82e6285962b8400d9d6fc32436022a94","a49d1bb4328949299686242fd0be5584",22856849,1,-200,0,1231,167,21,-146
"a49d1bb4328949299686242fd0be5584","b7719e26494940efa49512aedd0aac79",22856849,5,-2,0,1232,21,20,-1
"b7719e26494940efa49512aedd0aac79","b7719e26494940efa49512aedd0aac79",22856849,5,0,1,1233,20,20,0
"b7719e26494940efa49512aedd0aac79","afbf7250b99d47bea07172749483ca97",22856849,5,12,0,1234,20,28,8
"afbf7250b99d47bea07172749483ca97","4e51676dc72045d99c19b9fa7b22f8bc",22856849,6,3,0,1235,28,29,1
"4e51676dc72045d99c19b9fa7b22f8bc","afbf7250b99d47bea07172749483ca97",22856849,3,-3,0,1236,29,28,-1
"4e51676dc72045d99c19b9fa7b22f8bc","1c6721b1f63f4d30ba7746ea8af02a52",22856849,1,264,0,1238,29,221,192
"1c6721b1f63f4d30ba7746ea8af02a52","0c7262dff33c4087bc660ccf40f92f9c",22856849,1,-70,0,1239,221,169,-52
"0c7262dff33c4087bc660ccf40f92f9c","b54257a550b94ebc9538f3a90eee9d7e",22856849,1,45,0,1240,169,204,35
"b54257a550b94ebc9538f3a90eee9d7e","c8e371568a0c4391b25796ae4e91952e",22856849,1,-22,0,1241,204,186,-18
"c8e371568a0c4391b25796ae4e91952e","0b04c8e2f86d48c7aeb7e225819cd32b",22856849,1,63,0,1242,186,234,48
"1c6721b1f63f4d30ba7746ea8af02a52","bc5524e78a8544e2ae2fdc2f3462bbec",22856849,1,74,0,1244,221,279,58
"bc5524e78a8544e2ae2fdc2f3462bbec","0d987bed3ffa4ed0b9a2e62e97b7b30f",22856849,4,-9,0,1245,279,272,-7
"0d987bed3ffa4ed0b9a2e62e97b7b30f","bb5a47f5ea01454a8b79455422d3b9da",22856849,5,10,0,1246,272,280,8
"bb5a47f5ea01454a8b79455422d3b9da","bb5a47f5ea01454a8b79455422d3b9da",22856849,109,0,1,1247,280,280,0
"bb5a47f5ea01454a8b79455422d3b9da","bc5524e78a8544e2ae2fdc2f3462bbec",22856849,3,-1,0,1264,280,279,-1
"0d987bed3ffa4ed0b9a2e62e97b7b30f","94cecc3f1e7d484b8e068e79241dfd73",22856849,1,13,0,1306,272,281,9
"94cecc3f1e7d484b8e068e79241dfd73","a37477c4e4c14169ad44b06b493007f6",22856849,4,2,0,1307,281,283,2
"a37477c4e4c14169ad44b06b493007f6","94cecc3f1e7d484b8e068e79241dfd73",22856849,3,-2,0,1308,283,281,-2
"94cecc3f1e7d484b8e068e79241dfd73","0d987bed3ffa4ed0b9a2e62e97b7b30f",22856849,1,-13,0,1309,281,272,-9
"bb5a47f5ea01454a8b79455422d3b9da","0c7262dff33c4087bc660ccf40f92f9c",22856849,1,-145,0,1319,280,169,-111
"0c7262dff33c4087bc660ccf40f92f9c","6e83e23f56544a19b94067c1c558d9c0",22856849,1,103,0,1320,169,247,78
"6e83e23f56544a19b94067c1c558d9c0","2ae94c0cea4d480a9d5dca8fb1d7b542",22856849,2,-6,0,1321,247,242,-5
"bb5a47f5ea01454a8b79455422d3b9da","6e83e23f56544a19b94067c1c558d9c0",22856849,1,-42,0,1332,280,247,-33
"2ae94c0cea4d480a9d5dca8fb1d7b542","30c9ba177afc49a695625d2bdec40207",22856849,1,9,0,1334,242,250,8
"30c9ba177afc49a695625d2bdec40207","30c9ba177afc49a695625d2bdec40207",22856849,5,0,1,1335,250,250,0
"30c9ba177afc49a695625d2bdec40207","00f61990949545828dd12f1303d47504",22856849,1,8,0,1340,250,256,6
"00f61990949545828dd12f1303d47504","6e83e23f56544a19b94067c1c558d9c0",22856849,2,-11,0,1341,256,247,-9
"6e83e23f56544a19b94067c1c558d9c0","d546341988904f069cfa86b21457d9d9",22856849,1,5,0,1342,247,251,4
"0d987bed3ffa4ed0b9a2e62e97b7b30f","82ae07bc0c9b4570a41799290d1ef399",22856849,3,4,0,1349,272,275,3
"82ae07bc0c9b4570a41799290d1ef399","bb5a47f5ea01454a8b79455422d3b9da",22856849,1,6,0,1350,275,280,5
"bb5a47f5ea01454a8b79455422d3b9da","c8e371568a0c4391b25796ae4e91952e",22856849,1,-122,0,1393,280,186,-94
"c8e371568a0c4391b25796ae4e91952e","b71bac264efb4abd97015447bd490db6",22856849,2,244,0,1394,186,370,184
"b71bac264efb4abd97015447bd490db6","b71bac264efb4abd97015447bd490db6",22856849,1,0,1,1395,370,370,0
"b71bac264efb4abd97015447bd490db6","4a29443515bb404cb8924e1c60a63b73",22856849,1,-110,0,1396,370,285,-85
"4a29443515bb404cb8924e1c60a63b73","4a29443515bb404cb8924e1c60a63b73",22856849,2,0,1,1397,285,285,0
"4a29443515bb404cb8924e1c60a63b73","208c9b2796c944db8dacaa96082520ea",22856849,2,3,0,1398,285,288,3
"208c9b2796c944db8dacaa96082520ea","4a29443515bb404cb8924e1c60a63b73",22856849,2,-3,0,1399,288,285,-3
"208c9b2796c944db8dacaa96082520ea","208c9b2796c944db8dacaa96082520ea",22856849,3,0,1,1402,288,288,0
"4a29443515bb404cb8924e1c60a63b73","7669a956527947d0add87455277e80b4",22856849,1,7,0,1406,285,291,6
"7669a956527947d0add87455277e80b4","7669a956527947d0add87455277e80b4",22856849,1,0,1,1407,291,291,0
"7669a956527947d0add87455277e80b4","869e967078f04da18dd0b0b9389a7424",22856849,1,3,0,1408,291,293,2
"869e967078f04da18dd0b0b9389a7424","6a9a3b5bde4a48daa896fe8c06eca56f",22856849,1,-5,0,1409,293,289,-4
"6a9a3b5bde4a48daa896fe8c06eca56f","869e967078f04da18dd0b0b9389a7424",22856849,1,5,0,1410,289,293,4
"869e967078f04da18dd0b0b9389a7424","869e967078f04da18dd0b0b9389a7424",22856849,6,0,1,1411,293,293,0
"869e967078f04da18dd0b0b9389a7424","51ab6291537748fab90d519aa09889d6",22856849,1,2,0,1417,293,295,2
"51ab6291537748fab90d519aa09889d6","51ab6291537748fab90d519aa09889d6",22856849,5,0,1,1418,295,295,0
"51ab6291537748fab90d519aa09889d6","34a6e49023fc4465bd5ca604330bbd1c",22856849,1,-3,0,1423,295,292,-3
"34a6e49023fc4465bd5ca604330bbd1c","21592f2a9e9c4b2f8c66ec5dbcbf6a2b",22856849,1,5,0,1424,292,296,4
"21592f2a9e9c4b2f8c66ec5dbcbf6a2b","ba0e59461bfb4a44b7b1c28a01f8d3b3",22856849,1,4,0,1425,296,299,3
"ba0e59461bfb4a44b7b1c28a01f8d3b3","ba0e59461bfb4a44b7b1c28a01f8d3b3",22856849,3,0,1,1426,299,299,0
"ba0e59461bfb4a44b7b1c28a01f8d3b3","0e0b36e731a645e7b1b8a88f5031ca38",22856849,1,2,0,1429,299,301,2
"0e0b36e731a645e7b1b8a88f5031ca38","0e0b36e731a645e7b1b8a88f5031ca38",22856849,2,0,1,1430,301,301,0
"0e0b36e731a645e7b1b8a88f5031ca38","a66a144637284c21afc6de17fea4bfb8",22856849,1,1,0,1432,301,302,1
"a66a144637284c21afc6de17fea4bfb8","a66a144637284c21afc6de17fea4bfb8",22856849,2,0,1,1433,302,302,0
"a66a144637284c21afc6de17fea4bfb8","7646a919d7e64fa990bca9b024ff089d",22856849,1,-4,0,1435,302,298,-4
"7646a919d7e64fa990bca9b024ff089d","e390b575229748ea8aac9364efe2bf00",22856849,1,7,0,1436,298,304,6
"e390b575229748ea8aac9364efe2bf00","e390b575229748ea8aac9364efe2bf00",22856849,1,0,1,1437,304,304,0
"e390b575229748ea8aac9364efe2bf00","4a29443515bb404cb8924e1c60a63b73",22856849,1,-24,0,1438,304,285,-19
"4a29443515bb404cb8924e1c60a63b73","3434c10e561d488a914e0f7d71907abd",22856849,2,27,0,1439,285,305,20
"3434c10e561d488a914e0f7d71907abd","53e7e900392747ccad52e711ab0f80d8",22856849,2,2,0,1440,305,307,2
"53e7e900392747ccad52e711ab0f80d8","53e7e900392747ccad52e711ab0f80d8",22856849,10,0,1,1441,307,307,0
"53e7e900392747ccad52e711ab0f80d8","3434c10e561d488a914e0f7d71907abd",22856849,1,-2,0,1451,307,305,-2
"3434c10e561d488a914e0f7d71907abd","130acc2aeb0448fdbb2de63bc5cebe5b",22856849,1,5,0,1452,305,309,4
"130acc2aeb0448fdbb2de63bc5cebe5b","130acc2aeb0448fdbb2de63bc5cebe5b",22856849,6,0,1,1453,309,309,0
"130acc2aeb0448fdbb2de63bc5cebe5b","9c062b3251034ebe90f5054e2a3b5120",22856849,1,2,0,1459,309,311,2
"9c062b3251034ebe90f5054e2a3b5120","9c062b3251034ebe90f5054e2a3b5120",22856849,8,0,1,1460,311,311,0
"9c062b3251034ebe90f5054e2a3b5120","ea859f8207e44537889daeaba13ac2e8",22856849,1,1,0,1468,311,312,1
"ea859f8207e44537889daeaba13ac2e8","ea859f8207e44537889daeaba13ac2e8",22856849,1,0,1,1469,312,312,0
"ea859f8207e44537889daeaba13ac2e8","56d94971a7a94257aa330183a8ebd0ea",22856849,1,1,0,1470,312,313,1
"56d94971a7a94257aa330183a8ebd0ea","56d94971a7a94257aa330183a8ebd0ea",22856849,1,0,1,1471,313,313,0
"56d94971a7a94257aa330183a8ebd0ea","141c0df6cd1946539aadd1c9b7068cd4",22856849,1,-5,0,1472,313,308,-5
"141c0df6cd1946539aadd1c9b7068cd4","4a29443515bb404cb8924e1c60a63b73",22856849,1,-31,0,1473,308,285,-23
"53e7e900392747ccad52e711ab0f80d8","4a29443515bb404cb8924e1c60a63b73",22856849,1,-29,0,1476,307,285,-22
"4a29443515bb404cb8924e1c60a63b73","0c4079457ede49e3aeb5e86ed84bdf35",22856849,2,58,0,1477,285,329,44
"0c4079457ede49e3aeb5e86ed84bdf35","0c4079457ede49e3aeb5e86ed84bdf35",22856849,1,0,1,1478,329,329,0
"0c4079457ede49e3aeb5e86ed84bdf35","38aea304b4fa46e1b29bb72f5cea4c93",22856849,2,2,0,1479,329,331,2
"38aea304b4fa46e1b29bb72f5cea4c93","38aea304b4fa46e1b29bb72f5cea4c93",22856849,6,0,1,1480,331,331,0
"38aea304b4fa46e1b29bb72f5cea4c93","e36d261332f14e79bb4b467aceaeb9b5",22856849,1,2,0,1486,331,333,2
"e36d261332f14e79bb4b467aceaeb9b5","e36d261332f14e79bb4b467aceaeb9b5",22856849,1,0,1,1487,333,333,0
"e36d261332f14e79bb4b467aceaeb9b5","c7e89b9d04744d2eab742fc24e3ef1ae",22856849,1,1,0,1488,333,334,1
"c7e89b9d04744d2eab742fc24e3ef1ae","c7e89b9d04744d2eab742fc24e3ef1ae",22856849,2,0,1,1489,334,334,0
"c7e89b9d04744d2eab742fc24e3ef1ae","fe49f8054b374a0ea4bb266ed135ff62",22856849,1,1,0,1491,334,335,1
"fe49f8054b374a0ea4bb266ed135ff62","fe49f8054b374a0ea4bb266ed135ff62",22856849,2,0,1,1492,335,335,0
"fe49f8054b374a0ea4bb266ed135ff62","d0a8f74af98642fe8360d22c42e45117",22856849,1,1,0,1494,335,336,1
"d0a8f74af98642fe8360d22c42e45117","d0a8f74af98642fe8360d22c42e45117",22856849,2,0,1,1495,336,336,0
"d0a8f74af98642fe8360d22c42e45117","0c4079457ede49e3aeb5e86ed84bdf35",22856849,1,-7,0,1497,336,329,-7
"0c4079457ede49e3aeb5e86ed84bdf35","4a29443515bb404cb8924e1c60a63b73",22856849,1,-58,0,1498,329,285,-44
"4a29443515bb404cb8924e1c60a63b73","30ead9794d4847abaf222ca966cc8630",22856849,1,82,0,1499,285,348,63
"30ead9794d4847abaf222ca966cc8630","2fe14166dc9642c3bc666b86a57f943d",22856849,2,10,0,1500,348,357,9
"2fe14166dc9642c3bc666b86a57f943d","2fe14166dc9642c3bc666b86a57f943d",22856849,13,0,1,1501,357,357,0
"2fe14166dc9642c3bc666b86a57f943d","44421dd1e13a47a388c4a19834b744c7",22856849,1,2,0,1511,357,359,2
"44421dd1e13a47a388c4a19834b744c7","44421dd1e13a47a388c4a19834b744c7",22856849,2,0,1,1512,359,359,0
"44421dd1e13a47a388c4a19834b744c7","cb5fc7ef85d547c4be1a7439d0bf6052",22856849,1,1,0,1514,359,360,1
"cb5fc7ef85d547c4be1a7439d0bf6052","cb5fc7ef85d547c4be1a7439d0bf6052",22856849,2,0,1,1515,360,360,0
"cb5fc7ef85d547c4be1a7439d0bf6052","0a8f150a4cf747acbde62f4721823da3",22856849,1,1,0,1517,360,361,1
"0a8f150a4cf747acbde62f4721823da3","0a8f150a4cf747acbde62f4721823da3",22856849,2,0,1,1518,361,361,0
"0a8f150a4cf747acbde62f4721823da3","ab8fdad974ae471f9f24c3f9dd04462e",22856849,1,1,0,1520,361,362,1
"ab8fdad974ae471f9f24c3f9dd04462e","ab8fdad974ae471f9f24c3f9dd04462e",22856849,2,0,1,1521,362,362,0
"ab8fdad974ae471f9f24c3f9dd04462e","1ba8fef685d74a8194b9db252eb704fb",22856849,1,-7,0,1523,362,355,-7
"1ba8fef685d74a8194b9db252eb704fb","52580888dadb4fe3baa795683ea227bd",22856849,2,10,0,1524,355,364,9
"52580888dadb4fe3baa795683ea227bd","52580888dadb4fe3baa795683ea227bd",22856849,11,0,1,1525,364,364,0
"52580888dadb4fe3baa795683ea227bd","f00179e251a045b39c3f7a54f9aa4acc",22856849,1,-1,0,1528,364,363,-1
"f00179e251a045b39c3f7a54f9aa4acc","492a3bc6a1254f23a7998587961b22a4",22856849,2,4,0,1529,363,366,3
"492a3bc6a1254f23a7998587961b22a4","492a3bc6a1254f23a7998587961b22a4",22856849,2,0,1,1530,366,366,0
"492a3bc6a1254f23a7998587961b22a4","072a190fd302456290895f9f04d6940a",22856849,2,-1,0,1532,366,365,-1
"072a190fd302456290895f9f04d6940a","94cecc3f1e7d484b8e068e79241dfd73",22856849,1,-111,0,1533,365,281,-84
"94cecc3f1e7d484b8e068e79241dfd73","94cecc3f1e7d484b8e068e79241dfd73",22856849,2,0,1,1534,281,281,0
"94cecc3f1e7d484b8e068e79241dfd73","fab84b4fab5940efb4ea868ef8d09396",22856849,2,5,0,1537,281,284,3
"fab84b4fab5940efb4ea868ef8d09396","fab84b4fab5940efb4ea868ef8d09396",22856849,1,0,1,1538,284,284,0
"fab84b4fab5940efb4ea868ef8d09396","94cecc3f1e7d484b8e068e79241dfd73",22856849,2,-5,0,1539,284,281,-3
"a37477c4e4c14169ad44b06b493007f6","d6d02b6ef04e4f17805504500b8ce441",22856849,1,125,0,1546,283,375,92
"d6d02b6ef04e4f17805504500b8ce441","d6d02b6ef04e4f17805504500b8ce441",22856849,22,0,1,1547,375,375,0
"d6d02b6ef04e4f17805504500b8ce441","0c787d16c9504873b1a4d903cec09948",22856849,1,-80,0,1549,375,314,-61
"0c787d16c9504873b1a4d903cec09948","3434c10e561d488a914e0f7d71907abd",22856849,1,-11,0,1550,314,305,-9
"3434c10e561d488a914e0f7d71907abd","13255e63e0aa4abf85e5211bf613d43e",22856849,1,14,0,1551,305,317,12
"13255e63e0aa4abf85e5211bf613d43e","13255e63e0aa4abf85e5211bf613d43e",22856849,1,0,1,1552,317,317,0
"13255e63e0aa4abf85e5211bf613d43e","86c27d40179e419c8e9d150fb6afa5d0",22856849,1,3,0,1553,317,319,2
"86c27d40179e419c8e9d150fb6afa5d0","0c787d16c9504873b1a4d903cec09948",22856849,1,-6,0,1554,319,314,-5
"0c787d16c9504873b1a4d903cec09948","4a29443515bb404cb8924e1c60a63b73",22856849,1,-38,0,1555,314,285,-29
"4a29443515bb404cb8924e1c60a63b73","8d7e0b55cf9849cda222a0f2440cec55",22856849,1,43,0,1556,285,318,33
"8d7e0b55cf9849cda222a0f2440cec55","3434c10e561d488a914e0f7d71907abd",22856849,1,-16,0,1557,318,305,-13
"3434c10e561d488a914e0f7d71907abd","86c27d40179e419c8e9d150fb6afa5d0",22856849,1,17,0,1558,305,319,14
"86c27d40179e419c8e9d150fb6afa5d0","86c27d40179e419c8e9d150fb6afa5d0",22856849,11,0,1,1559,319,319,0
"86c27d40179e419c8e9d150fb6afa5d0","47edbb64109243e6b0f8f64cdef90c6c",22856849,2,8,0,1570,319,326,7
"47edbb64109243e6b0f8f64cdef90c6c","24f1363179ad4aaa965484a78471912b",22856849,2,-3,0,1571,326,323,-3
"24f1363179ad4aaa965484a78471912b","8d7e0b55cf9849cda222a0f2440cec55",22856849,2,-6,0,1572,323,318,-5
"8d7e0b55cf9849cda222a0f2440cec55","3628bdce1dd2429ba924d2d4d09448d2",22856849,1,5,0,1573,318,322,4
"3628bdce1dd2429ba924d2d4d09448d2","0c787d16c9504873b1a4d903cec09948",22856849,1,-10,0,1574,322,314,-8
"0c787d16c9504873b1a4d903cec09948","86c27d40179e419c8e9d150fb6afa5d0",22856849,1,6,0,1575,314,319,5
"8d7e0b55cf9849cda222a0f2440cec55","24f1363179ad4aaa965484a78471912b",22856849,1,6,0,1579,318,323,5
"24f1363179ad4aaa965484a78471912b","3628bdce1dd2429ba924d2d4d09448d2",22856849,1,-1,0,1580,323,322,-1
"3628bdce1dd2429ba924d2d4d09448d2","56b3fd1a212a4764be39d979fde3326e",22856849,1,7,0,1581,322,328,6
"56b3fd1a212a4764be39d979fde3326e","56b3fd1a212a4764be39d979fde3326e",22856849,1,0,1,1582,328,328,0
"56b3fd1a212a4764be39d979fde3326e","3434c10e561d488a914e0f7d71907abd",22856849,1,-28,0,1583,328,305,-23
"3434c10e561d488a914e0f7d71907abd","0c4079457ede49e3aeb5e86ed84bdf35",22856849,1,31,0,1584,305,329,24
"38aea304b4fa46e1b29bb72f5cea4c93","4a29443515bb404cb8924e1c60a63b73",22856849,1,-60,0,1586,331,285,-46
"0c4079457ede49e3aeb5e86ed84bdf35","a7c6339ca1da4368a18d471f0519f877",22856849,1,11,0,1588,329,339,10
"a7c6339ca1da4368a18d471f0519f877","a7c6339ca1da4368a18d471f0519f877",22856849,1,0,1,1589,339,339,0
"a7c6339ca1da4368a18d471f0519f877","bbc5139ca9024389a94db3a6f47dcff6",22856849,1,3,0,1590,339,341,2
"bbc5139ca9024389a94db3a6f47dcff6","b8b9418ab322418d9db9b40d96af873a",22856849,1,-5,0,1591,341,337,-4
"b8b9418ab322418d9db9b40d96af873a","bbc5139ca9024389a94db3a6f47dcff6",22856849,1,5,0,1592,337,341,4
"bbc5139ca9024389a94db3a6f47dcff6","bbc5139ca9024389a94db3a6f47dcff6",22856849,3,0,1,1593,341,341,0
"bbc5139ca9024389a94db3a6f47dcff6","c2490bc612d146edbe786556fab3651b",22856849,1,-1,0,1594,341,340,-1
"c2490bc612d146edbe786556fab3651b","0c4079457ede49e3aeb5e86ed84bdf35",22856849,1,-13,0,1595,340,329,-11
"0c4079457ede49e3aeb5e86ed84bdf35","bbc5139ca9024389a94db3a6f47dcff6",22856849,1,14,0,1596,329,341,12
"bbc5139ca9024389a94db3a6f47dcff6","4ee6ca9019ab4a1ab323f98094a9bd77",22856849,1,2,0,1599,341,343,2
"4ee6ca9019ab4a1ab323f98094a9bd77","4ee6ca9019ab4a1ab323f98094a9bd77",22856849,5,0,1,1600,343,343,0
"4ee6ca9019ab4a1ab323f98094a9bd77","b37947176785476f8b29d49a851366dc",22856849,1,1,0,1605,343,344,1
"b37947176785476f8b29d49a851366dc","b37947176785476f8b29d49a851366dc",22856849,2,0,1,1606,344,344,0
"b37947176785476f8b29d49a851366dc","fcea5b10d5a14a3b9324ffece8f6e1e5",22856849,1,1,0,1608,344,345,1
"fcea5b10d5a14a3b9324ffece8f6e1e5","fcea5b10d5a14a3b9324ffece8f6e1e5",22856849,2,0,1,1609,345,345,0
"fcea5b10d5a14a3b9324ffece8f6e1e5","c2490bc612d146edbe786556fab3651b",22856849,1,-5,0,1611,345,340,-5
"c2490bc612d146edbe786556fab3651b","6ac8bb048b854999a47edb35fe627f11",22856849,1,8,0,1612,340,347,7
"6ac8bb048b854999a47edb35fe627f11","6ac8bb048b854999a47edb35fe627f11",22856849,1,0,1,1613,347,347,0
"6ac8bb048b854999a47edb35fe627f11","0c4079457ede49e3aeb5e86ed84bdf35",22856849,1,-21,0,1614,347,329,-18
"0c4079457ede49e3aeb5e86ed84bdf35","30ead9794d4847abaf222ca966cc8630",22856849,1,24,0,1615,329,348,19
"30ead9794d4847abaf222ca966cc8630","09b9678ddc3d452ea4a3d46e15826065",22856849,1,5,0,1616,348,353,5
"09b9678ddc3d452ea4a3d46e15826065","c20993c944444fe085345591a8bd837e",22856849,1,-2,0,1617,353,351,-2
"c20993c944444fe085345591a8bd837e","897b7f51242c44aab2205c72fdcbf4cd",22856849,2,1,0,1618,351,352,1
"897b7f51242c44aab2205c72fdcbf4cd","eff0de7f2dbb42dfa1a2e686efab5b6d",22856849,1,2,0,1619,352,354,2
"eff0de7f2dbb42dfa1a2e686efab5b6d","c20993c944444fe085345591a8bd837e",22856849,1,-3,0,1620,354,351,-3
"c20993c944444fe085345591a8bd837e","c20993c944444fe085345591a8bd837e",22856849,3,0,1,1621,351,351,0
"897b7f51242c44aab2205c72fdcbf4cd","897b7f51242c44aab2205c72fdcbf4cd",22856849,3,0,1,1625,352,352,0
"897b7f51242c44aab2205c72fdcbf4cd","09b9678ddc3d452ea4a3d46e15826065",22856849,1,1,0,1628,352,353,1
"09b9678ddc3d452ea4a3d46e15826065","09b9678ddc3d452ea4a3d46e15826065",22856849,3,0,1,1629,353,353,0
"09b9678ddc3d452ea4a3d46e15826065","eff0de7f2dbb42dfa1a2e686efab5b6d",22856849,1,1,0,1632,353,354,1
"eff0de7f2dbb42dfa1a2e686efab5b6d","eff0de7f2dbb42dfa1a2e686efab5b6d",22856849,3,0,1,1633,354,354,0
"eff0de7f2dbb42dfa1a2e686efab5b6d","30ead9794d4847abaf222ca966cc8630",22856849,1,-6,0,1636,354,348,-6
"2fe14166dc9642c3bc666b86a57f943d","1ba8fef685d74a8194b9db252eb704fb",22856849,1,-2,0,1641,357,355,-2
"52580888dadb4fe3baa795683ea227bd","492a3bc6a1254f23a7998587961b22a4",22856849,1,3,0,1651,364,366,2
"492a3bc6a1254f23a7998587961b22a4","f00179e251a045b39c3f7a54f9aa4acc",22856849,1,-4,0,1652,366,363,-3
"072a190fd302456290895f9f04d6940a","cfa457d1743848e4bb5e4beced6448ed",22856849,1,5,0,1655,365,369,4
"cfa457d1743848e4bb5e4beced6448ed","cfa457d1743848e4bb5e4beced6448ed",22856849,1,0,1,1656,369,369,0
"cfa457d1743848e4bb5e4beced6448ed","b71bac264efb4abd97015447bd490db6",22856849,1,3,0,1657,369,370,1
"b71bac264efb4abd97015447bd490db6","30ead9794d4847abaf222ca966cc8630",22856849,1,-28,0,1658,370,348,-22
"30ead9794d4847abaf222ca966cc8630","d6d02b6ef04e4f17805504500b8ce441",22856849,1,36,0,1659,348,375,27
"d6d02b6ef04e4f17805504500b8ce441","c8e371568a0c4391b25796ae4e91952e",22856849,1,-252,0,1663,375,186,-189
"b71bac264efb4abd97015447bd490db6","8d448d625b024c82a5eb240bbd7431d6",22856849,5,5,0,1665,370,374,4
"8d448d625b024c82a5eb240bbd7431d6","8d448d625b024c82a5eb240bbd7431d6",22856849,64,0,1,1666,374,374,0
"8d448d625b024c82a5eb240bbd7431d6","b71bac264efb4abd97015447bd490db6",22856849,3,-5,0,1669,374,370,-4
"8d448d625b024c82a5eb240bbd7431d6","1b4550d0dab04078b3bf08a655345bdc",22856849,2,-1,0,1674,374,373,-1
"1b4550d0dab04078b3bf08a655345bdc","b71bac264efb4abd97015447bd490db6",22856849,2,-4,0,1675,373,370,-3
"b71bac264efb4abd97015447bd490db6","d6d02b6ef04e4f17805504500b8ce441",22856849,2,8,0,1731,370,375,5
"d6d02b6ef04e4f17805504500b8ce441","66baf19b6b904b70922329068c63746d",22856849,2,4,0,1734,375,376,1
"66baf19b6b904b70922329068c63746d","7f544639412e40a9ba27f43b415362ab",22856849,3,2,0,1735,376,378,2
"7f544639412e40a9ba27f43b415362ab","d6d02b6ef04e4f17805504500b8ce441",22856849,2,-6,0,1736,378,375,-3
"d6d02b6ef04e4f17805504500b8ce441","b71bac264efb4abd97015447bd490db6",22856849,1,-8,0,1740,375,370,-5
"d6d02b6ef04e4f17805504500b8ce441","a49d1bb4328949299686242fd0be5584",22856849,1,-482,0,1753,375,21,-354
"afbf7250b99d47bea07172749483ca97","afbf7250b99d47bea07172749483ca97",22856849,2,0,1,1757,28,28,0
"4e51676dc72045d99c19b9fa7b22f8bc","4e51676dc72045d99c19b9fa7b22f8bc",22856849,2,0,1,1759,29,29,0
"c33c17be71ae4d588da7369472e5bb1b","66baf19b6b904b70922329068c63746d",22856849,1,464,0,1763,34,376,342
"7f544639412e40a9ba27f43b415362ab","7f544639412e40a9ba27f43b415362ab",22856849,7,0,1,1765,378,378,0
"7f544639412e40a9ba27f43b415362ab","d5ae8642e15b46b8bd298b02274d4e9c",22856849,1,2,0,1772,378,380,2
"d5ae8642e15b46b8bd298b02274d4e9c","d5ae8642e15b46b8bd298b02274d4e9c",22856849,1,0,1,1773,380,380,0
"d5ae8642e15b46b8bd298b02274d4e9c","a0d10309a2dd456289147f84be9d37f9",22856849,1,1,0,1774,380,381,1
"a0d10309a2dd456289147f84be9d37f9","a0d10309a2dd456289147f84be9d37f9",22856849,2,0,1,1775,381,381,0
"a0d10309a2dd456289147f84be9d37f9","0fcbc3ca07b144138b8d85da581f09a8",22856849,1,1,0,1777,381,382,1
"0fcbc3ca07b144138b8d85da581f09a8","0fcbc3ca07b144138b8d85da581f09a8",22856849,2,0,1,1778,382,382,0
"0fcbc3ca07b144138b8d85da581f09a8","66baf19b6b904b70922329068c63746d",22856849,1,-6,0,1780,382,376,-6
"66baf19b6b904b70922329068c63746d","4890121ce5d74576b4632b77cfc23398",22856849,1,14,0,1781,376,388,12
"4890121ce5d74576b4632b77cfc23398","c2fca3669923477ab966ded303dea31c",22856849,1,-6,0,1782,388,383,-5
"c2fca3669923477ab966ded303dea31c","4890121ce5d74576b4632b77cfc23398",22856849,1,6,0,1783,383,388,5
"4890121ce5d74576b4632b77cfc23398","4890121ce5d74576b4632b77cfc23398",22856849,1,0,1,1784,388,388,0
"4890121ce5d74576b4632b77cfc23398","18d3b836dd804224883cc9180b60a8e1",22856849,1,-1,0,1785,388,387,-1
"18d3b836dd804224883cc9180b60a8e1","96bb2b3e85a34d8b9544514e89f6fe97",22856849,1,4,0,1786,387,390,3
"96bb2b3e85a34d8b9544514e89f6fe97","96bb2b3e85a34d8b9544514e89f6fe97",22856849,2,0,1,1787,390,390,0
"96bb2b3e85a34d8b9544514e89f6fe97","ac4e9b54acfe4670b4634859c7263cb5",22856849,1,2,0,1789,390,392,2
"ac4e9b54acfe4670b4634859c7263cb5","ac4e9b54acfe4670b4634859c7263cb5",22856849,1,0,1,1790,392,392,0
"ac4e9b54acfe4670b4634859c7263cb5","6f8881a745ac4c358a68b92c3b4abe81",22856849,1,3,0,1791,392,394,2
"6f8881a745ac4c358a68b92c3b4abe81","17f95d18bab743888e1736033dc3384d",22856849,1,-6,0,1792,394,389,-5
"17f95d18bab743888e1736033dc3384d","6f8881a745ac4c358a68b92c3b4abe81",22856849,1,6,0,1793,389,394,5
"6f8881a745ac4c358a68b92c3b4abe81","6f8881a745ac4c358a68b92c3b4abe81",22856849,3,0,1,1794,394,394,0
"6f8881a745ac4c358a68b92c3b4abe81","f7002c8484354eceac57bc7bd62c76c1",22856849,1,-1,0,1797,394,393,-1
"f7002c8484354eceac57bc7bd62c76c1","44a277ea44dc4ae689fab4b82f0b4098",22856849,1,5,0,1798,393,397,4
"44a277ea44dc4ae689fab4b82f0b4098","44a277ea44dc4ae689fab4b82f0b4098",22856849,2,0,1,1799,397,397,0
"44a277ea44dc4ae689fab4b82f0b4098","0c12af0a4e7f4002852cf84b2537c161",22856849,1,-2,0,1801,397,395,-2
"0c12af0a4e7f4002852cf84b2537c161","859e0b8d71694b12befb69ee698138f9",22856849,1,5,0,1802,395,399,4
"859e0b8d71694b12befb69ee698138f9","859e0b8d71694b12befb69ee698138f9",22856849,1,0,1,1803,399,399,0
"859e0b8d71694b12befb69ee698138f9","2b09a08242b54983aec7063990fb3f66",22856849,1,3,0,1804,399,400,1
"2b09a08242b54983aec7063990fb3f66","66baf19b6b904b70922329068c63746d",22856849,2,-32,0,1805,400,376,-24
"66baf19b6b904b70922329068c63746d","2b09a08242b54983aec7063990fb3f66",22856849,2,32,0,1806,376,400,24
"2b09a08242b54983aec7063990fb3f66","2b09a08242b54983aec7063990fb3f66",22856849,5,0,1,1809,400,400,0
"2b09a08242b54983aec7063990fb3f66","1f471b7a883a4df48211e8c6a81b59a7",22856849,1,1,0,1813,400,401,1
"1f471b7a883a4df48211e8c6a81b59a7","1f471b7a883a4df48211e8c6a81b59a7",22856849,1,0,1,1814,401,401,0
"1f471b7a883a4df48211e8c6a81b59a7","2b09a08242b54983aec7063990fb3f66",22856849,1,-1,0,1815,401,400,-1
"2b09a08242b54983aec7063990fb3f66","1157bd665ec4472fb58b751dc5099355",22856849,1,4,0,1816,400,403,3
"1157bd665ec4472fb58b751dc5099355","58fc9094275e4c49be3f4ba6d4acc0a4",22856849,1,5,0,1817,403,406,3
"58fc9094275e4c49be3f4ba6d4acc0a4","3c8a22d2f9c146ea956609e3ed4f2559",22856849,1,-2,0,1818,406,405,-1
"3c8a22d2f9c146ea956609e3ed4f2559","58fc9094275e4c49be3f4ba6d4acc0a4",22856849,1,2,0,1819,405,406,1
"58fc9094275e4c49be3f4ba6d4acc0a4","58fc9094275e4c49be3f4ba6d4acc0a4",22856849,12,0,1,1820,406,406,0
"58fc9094275e4c49be3f4ba6d4acc0a4","c1c1be90b2b14c1ab4a5e1ee3c241902",22856849,1,1,0,1827,406,407,1
"c1c1be90b2b14c1ab4a5e1ee3c241902","c1c1be90b2b14c1ab4a5e1ee3c241902",22856849,5,0,1,1828,407,407,0
"c1c1be90b2b14c1ab4a5e1ee3c241902","58fc9094275e4c49be3f4ba6d4acc0a4",22856849,1,-1,0,1833,407,406,-1
"58fc9094275e4c49be3f4ba6d4acc0a4","02b3a1bead9244c1ba2f857c7da8f82a",22856849,4,3,0,1834,406,408,2
"02b3a1bead9244c1ba2f857c7da8f82a","02b3a1bead9244c1ba2f857c7da8f82a",22856849,4,0,1,1835,408,408,0
"02b3a1bead9244c1ba2f857c7da8f82a","6206fc6479014bb193084c32409dc1b9",22856849,1,1,0,1838,408,409,1
"6206fc6479014bb193084c32409dc1b9","6206fc6479014bb193084c32409dc1b9",22856849,1,0,1,1839,409,409,0
"6206fc6479014bb193084c32409dc1b9","02b3a1bead9244c1ba2f857c7da8f82a",22856849,1,-1,0,1840,409,408,-1
"02b3a1bead9244c1ba2f857c7da8f82a","6a5f020451db426dacba9e2ea3fcc62a",22856849,2,3,0,1841,408,410,2
"6a5f020451db426dacba9e2ea3fcc62a","6a5f020451db426dacba9e2ea3fcc62a",22856849,9,0,1,1842,410,410,0
"6a5f020451db426dacba9e2ea3fcc62a","33a9d248b2e44588a5b07fc1342b9bc2",22856849,2,2,0,1845,410,411,1
"33a9d248b2e44588a5b07fc1342b9bc2","33a9d248b2e44588a5b07fc1342b9bc2",22856849,16,0,1,1846,411,411,0
"33a9d248b2e44588a5b07fc1342b9bc2","2b09a08242b54983aec7063990fb3f66",22856849,1,-17,0,1859,411,400,-11
"2b09a08242b54983aec7063990fb3f66","33a9d248b2e44588a5b07fc1342b9bc2",22856849,1,17,0,1860,400,411,11
"33a9d248b2e44588a5b07fc1342b9bc2","c6f26bd420634f1cb7989e76fe6b16c0",22856849,1,1,0,1863,411,412,1
"c6f26bd420634f1cb7989e76fe6b16c0","c6f26bd420634f1cb7989e76fe6b16c0",22856849,5,0,1,1864,412,412,0
"c6f26bd420634f1cb7989e76fe6b16c0","2a65ee6e2ac64f6a8a55fbe5373ec763",22856849,1,1,0,1869,412,413,1
"2a65ee6e2ac64f6a8a55fbe5373ec763","2a65ee6e2ac64f6a8a55fbe5373ec763",22856849,2,0,1,1870,413,413,0
"2a65ee6e2ac64f6a8a55fbe5373ec763","33a9d248b2e44588a5b07fc1342b9bc2",22856849,1,-2,0,1872,413,411,-2
"33a9d248b2e44588a5b07fc1342b9bc2","687055dad9fc40c3982478fe33ec01bf",22856849,1,4,0,1873,411,414,3
"687055dad9fc40c3982478fe33ec01bf","a2b4bd40cee2481ebd3fc179d6a5cd62",22856849,1,6,0,1874,414,417,3
"a2b4bd40cee2481ebd3fc179d6a5cd62","2b09a08242b54983aec7063990fb3f66",22856849,2,-27,0,1875,417,400,-17
"2b09a08242b54983aec7063990fb3f66","a2b4bd40cee2481ebd3fc179d6a5cd62",22856849,1,27,0,1876,400,417,17
"a2b4bd40cee2481ebd3fc179d6a5cd62","bec48fc2e1294c7eb3d0aca780d731b8",22856849,3,4,0,1877,417,420,3
"bec48fc2e1294c7eb3d0aca780d731b8","bec48fc2e1294c7eb3d0aca780d731b8",22856849,9,0,1,1878,420,420,0
"bec48fc2e1294c7eb3d0aca780d731b8","a2b4bd40cee2481ebd3fc179d6a5cd62",22856849,2,-4,0,1885,420,417,-3
"a2b4bd40cee2481ebd3fc179d6a5cd62","a2b4bd40cee2481ebd3fc179d6a5cd62",22856849,2,0,1,1886,417,417,0
"a2b4bd40cee2481ebd3fc179d6a5cd62","a24600b0e49245f6bdba8c893cfeddb0",22856849,1,11,0,1887,417,425,8
"a24600b0e49245f6bdba8c893cfeddb0","a2b4bd40cee2481ebd3fc179d6a5cd62",22856849,2,-11,0,1888,425,417,-8
"a2b4bd40cee2481ebd3fc179d6a5cd62","66baf19b6b904b70922329068c63746d",22856849,1,-59,0,1889,417,376,-41
"66baf19b6b904b70922329068c63746d","bec48fc2e1294c7eb3d0aca780d731b8",22856849,1,63,0,1890,376,420,44
"bec48fc2e1294c7eb3d0aca780d731b8","a24600b0e49245f6bdba8c893cfeddb0",22856849,2,7,0,1894,420,425,5
"a24600b0e49245f6bdba8c893cfeddb0","dbde19fcce2a4c1abdc7f685c293a23f",22856849,2,-4,0,1895,425,422,-3
"dbde19fcce2a4c1abdc7f685c293a23f","a24600b0e49245f6bdba8c893cfeddb0",22856849,2,4,0,1896,422,425,3
"a24600b0e49245f6bdba8c893cfeddb0","a24600b0e49245f6bdba8c893cfeddb0",22856849,2,0,1,1903,425,425,0
"a24600b0e49245f6bdba8c893cfeddb0","24cf8786024543f19b89bc20034e60d7",22856849,1,7,0,1905,425,428,3
"24cf8786024543f19b89bc20034e60d7","a2b4bd40cee2481ebd3fc179d6a5cd62",22856849,1,-18,0,1906,428,417,-11
"a2b4bd40cee2481ebd3fc179d6a5cd62","24cf8786024543f19b89bc20034e60d7",22856849,2,18,0,1908,417,428,11
"24cf8786024543f19b89bc20034e60d7","f2a73be2f46840b182d7bd095378004e",22856849,5,1,0,1909,428,429,1
"f2a73be2f46840b182d7bd095378004e","f2a73be2f46840b182d7bd095378004e",22856849,11,0,1,1910,429,429,0
"f2a73be2f46840b182d7bd095378004e","66baf19b6b904b70922329068c63746d",22856849,1,-78,0,1913,429,376,-53
"66baf19b6b904b70922329068c63746d","24cf8786024543f19b89bc20034e60d7",22856849,2,77,0,1914,376,428,52
"24cf8786024543f19b89bc20034e60d7","24cf8786024543f19b89bc20034e60d7",22856849,5,0,1,1915,428,428,0
"f2a73be2f46840b182d7bd095378004e","604551fd4266430cb860fef58fa7dd61",22856849,1,1,0,1926,429,430,1
"604551fd4266430cb860fef58fa7dd61","604551fd4266430cb860fef58fa7dd61",22856849,1,0,1,1927,430,430,0
"604551fd4266430cb860fef58fa7dd61","24cf8786024543f19b89bc20034e60d7",22856849,1,-2,0,1928,430,428,-2
"24cf8786024543f19b89bc20034e60d7","dce46f8904594a62a6377a3587aaa663",22856849,3,4,0,1929,428,431,3
"dce46f8904594a62a6377a3587aaa663","dce46f8904594a62a6377a3587aaa663",22856849,16,0,1,1930,431,431,0
"dce46f8904594a62a6377a3587aaa663","9b9d0a249052413c869753b99682b0ac",22856849,1,1,0,1935,431,432,1
"9b9d0a249052413c869753b99682b0ac","9b9d0a249052413c869753b99682b0ac",22856849,7,0,1,1936,432,432,0
"9b9d0a249052413c869753b99682b0ac","061c175cc90f45fbad883025394e78dd",22856849,1,1,0,1943,432,433,1
"061c175cc90f45fbad883025394e78dd","061c175cc90f45fbad883025394e78dd",22856849,5,0,1,1944,433,433,0
"061c175cc90f45fbad883025394e78dd","dce46f8904594a62a6377a3587aaa663",22856849,1,-2,0,1949,433,431,-2
"dce46f8904594a62a6377a3587aaa663","66ada10dde9f43018588f1ced9d477fc",22856849,1,4,0,1950,431,434,3
"66ada10dde9f43018588f1ced9d477fc","24cf8786024543f19b89bc20034e60d7",22856849,2,-8,0,1951,434,428,-6
"24cf8786024543f19b89bc20034e60d7","070600601c4c439288445d2f0724807d",22856849,1,14,0,1952,428,437,9
"070600601c4c439288445d2f0724807d","1823b6de7d334a7aaabc4570719af4d9",22856849,1,2,0,1953,437,439,2
"1823b6de7d334a7aaabc4570719af4d9","1823b6de7d334a7aaabc4570719af4d9",22856849,11,0,1,1954,439,439,0
"1823b6de7d334a7aaabc4570719af4d9","070600601c4c439288445d2f0724807d",22856849,1,-2,0,1965,439,437,-2
"070600601c4c439288445d2f0724807d","0380cd76a7d44bc3a4da1f15e4d68f89",22856849,1,4,0,1966,437,440,3
"0380cd76a7d44bc3a4da1f15e4d68f89","0380cd76a7d44bc3a4da1f15e4d68f89",22856849,2,0,1,1967,440,440,0
"0380cd76a7d44bc3a4da1f15e4d68f89","23b7673c8b5443108c2ef09382834a86",22856849,3,2,0,1969,440,441,1
"23b7673c8b5443108c2ef09382834a86","0380cd76a7d44bc3a4da1f15e4d68f89",22856849,2,-2,0,1970,441,440,-1
"23b7673c8b5443108c2ef09382834a86","23b7673c8b5443108c2ef09382834a86",22856849,2,0,1,1972,441,441,0
"23b7673c8b5443108c2ef09382834a86","901e92500aea43c79f19f1b279050668",22856849,3,2,0,1974,441,442,1
"901e92500aea43c79f19f1b279050668","23b7673c8b5443108c2ef09382834a86",22856849,1,-2,0,1975,442,441,-1
"901e92500aea43c79f19f1b279050668","901e92500aea43c79f19f1b279050668",22856849,2,0,1,1977,442,442,0
"901e92500aea43c79f19f1b279050668","001339db8ced4cf78829ebe8b145449d",22856849,1,1,0,1978,442,443,1
"001339db8ced4cf78829ebe8b145449d","001339db8ced4cf78829ebe8b145449d",22856849,6,0,1,1979,443,443,0
"001339db8ced4cf78829ebe8b145449d","452745e0366e42ae81561bfddebcc6c3",22856849,1,1,0,1985,443,444,1
"452745e0366e42ae81561bfddebcc6c3","452745e0366e42ae81561bfddebcc6c3",22856849,2,0,1,1986,444,444,0
"452745e0366e42ae81561bfddebcc6c3","901e92500aea43c79f19f1b279050668",22856849,1,-2,0,1988,444,442,-2
"901e92500aea43c79f19f1b279050668","4660ff2089114e8db82ceb26a4f329e3",22856849,2,4,0,1989,442,445,3
"4660ff2089114e8db82ceb26a4f329e3","4660ff2089114e8db82ceb26a4f329e3",22856849,6,0,1,1990,445,445,0
"4660ff2089114e8db82ceb26a4f329e3","7bd5586eb9d8484eb74a433ee7bfe499",22856849,2,2,0,1993,445,446,1
"7bd5586eb9d8484eb74a433ee7bfe499","7bd5586eb9d8484eb74a433ee7bfe499",22856849,14,0,1,1994,446,446,0
"7bd5586eb9d8484eb74a433ee7bfe499","070600601c4c439288445d2f0724807d",22856849,1,-14,0,2007,446,437,-9
"070600601c4c439288445d2f0724807d","b2f0d654738f48158edff28e8d3a546e",22856849,1,21,0,2008,437,449,12
"b2f0d654738f48158edff28e8d3a546e","66baf19b6b904b70922329068c63746d",22856849,1,-112,0,2009,449,376,-73
"66baf19b6b904b70922329068c63746d","dce46f8904594a62a6377a3587aaa663",22856849,1,81,0,2010,376,431,55
"dce46f8904594a62a6377a3587aaa663","24cf8786024543f19b89bc20034e60d7",22856849,1,-4,0,2011,431,428,-3
"dce46f8904594a62a6377a3587aaa663","4660ff2089114e8db82ceb26a4f329e3",22856849,1,22,0,2013,431,445,14
"4660ff2089114e8db82ceb26a4f329e3","070600601c4c439288445d2f0724807d",22856849,1,-12,0,2014,445,437,-8
"070600601c4c439288445d2f0724807d","4660ff2089114e8db82ceb26a4f329e3",22856849,1,12,0,2015,437,445,8
"4660ff2089114e8db82ceb26a4f329e3","b2f0d654738f48158edff28e8d3a546e",22856849,1,9,0,2018,445,449,4
"b2f0d654738f48158edff28e8d3a546e","b2f0d654738f48158edff28e8d3a546e",22856849,1,0,1,2019,449,449,0
"b2f0d654738f48158edff28e8d3a546e","f60ee41ec635499abd48168342d32c2f",22856849,4,5,0,2020,449,453,4
"f60ee41ec635499abd48168342d32c2f","b2f0d654738f48158edff28e8d3a546e",22856849,2,-5,0,2021,453,449,-4
"f60ee41ec635499abd48168342d32c2f","f60ee41ec635499abd48168342d32c2f",22856849,66,0,1,2023,453,453,0
"f60ee41ec635499abd48168342d32c2f","66baf19b6b904b70922329068c63746d",22856849,1,-117,0,2029,453,376,-77
"66baf19b6b904b70922329068c63746d","9428d8bd9c5a47b2a235b254e5e27ded",22856849,1,116,0,2030,376,452,76
"9428d8bd9c5a47b2a235b254e5e27ded","b2f0d654738f48158edff28e8d3a546e",22856849,2,-4,0,2031,452,449,-3
"f60ee41ec635499abd48168342d32c2f","2b09a08242b54983aec7063990fb3f66",22856849,1,-85,0,2040,453,400,-53
"2b09a08242b54983aec7063990fb3f66","9de0d567bfa84fe5b77cb76f4a76a5d1",22856849,1,5,0,2042,400,404,4
"9de0d567bfa84fe5b77cb76f4a76a5d1","9de0d567bfa84fe5b77cb76f4a76a5d1",22856849,1,0,1,2043,404,404,0
"9de0d567bfa84fe5b77cb76f4a76a5d1","d6d02b6ef04e4f17805504500b8ce441",22856849,1,-41,0,2044,404,375,-29
"d6d02b6ef04e4f17805504500b8ce441","2b09a08242b54983aec7063990fb3f66",22856849,1,36,0,2053,375,400,25
"2b09a08242b54983aec7063990fb3f66","687055dad9fc40c3982478fe33ec01bf",22856849,2,21,0,2054,400,414,14
"687055dad9fc40c3982478fe33ec01bf","687055dad9fc40c3982478fe33ec01bf",22856849,1,0,1,2055,414,414,0
"687055dad9fc40c3982478fe33ec01bf","6a5f020451db426dacba9e2ea3fcc62a",22856849,2,-6,0,2056,414,410,-4
"33a9d248b2e44588a5b07fc1342b9bc2","6a5f020451db426dacba9e2ea3fcc62a",22856849,1,-2,0,2061,411,410,-1
"6a5f020451db426dacba9e2ea3fcc62a","02b3a1bead9244c1ba2f857c7da8f82a",22856849,2,-3,0,2064,410,408,-2
"02b3a1bead9244c1ba2f857c7da8f82a","58fc9094275e4c49be3f4ba6d4acc0a4",22856849,4,-3,0,2065,408,406,-2
"58fc9094275e4c49be3f4ba6d4acc0a4","1fd0f6dadbc14ebc965faf6122190b96",22856849,1,13,0,2073,406,415,9
"1fd0f6dadbc14ebc965faf6122190b96","6a5f020451db426dacba9e2ea3fcc62a",22856849,1,-7,0,2074,415,410,-5
"6a5f020451db426dacba9e2ea3fcc62a","687055dad9fc40c3982478fe33ec01bf",22856849,1,6,0,2075,410,414,4
"687055dad9fc40c3982478fe33ec01bf","02b3a1bead9244c1ba2f857c7da8f82a",22856849,1,-9,0,2076,414,408,-6
"02b3a1bead9244c1ba2f857c7da8f82a","1fd0f6dadbc14ebc965faf6122190b96",22856849,1,10,0,2084,408,415,7
"1fd0f6dadbc14ebc965faf6122190b96","687055dad9fc40c3982478fe33ec01bf",22856849,2,-1,0,2085,415,414,-1
"6a5f020451db426dacba9e2ea3fcc62a","2b09a08242b54983aec7063990fb3f66",22856849,1,-15,0,2089,410,400,-10
"687055dad9fc40c3982478fe33ec01bf","1fd0f6dadbc14ebc965faf6122190b96",22856849,1,1,0,2091,414,415,1
"1fd0f6dadbc14ebc965faf6122190b96","1fd0f6dadbc14ebc965faf6122190b96",22856849,1,0,1,2092,415,415,0
"687055dad9fc40c3982478fe33ec01bf","2add1669f08d4101913db15f8c23b3b7",22856849,1,3,0,2094,414,416,2
"2add1669f08d4101913db15f8c23b3b7","2add1669f08d4101913db15f8c23b3b7",22856849,2,0,1,2095,416,416,0
"2add1669f08d4101913db15f8c23b3b7","a2b4bd40cee2481ebd3fc179d6a5cd62",22856849,1,3,0,2097,416,417,1
"2b09a08242b54983aec7063990fb3f66","e34e59dce2204f228f3a84b6725df60f",22856849,1,29,0,2099,400,419,19
"e34e59dce2204f228f3a84b6725df60f","e34e59dce2204f228f3a84b6725df60f",22856849,1,0,1,2100,419,419,0
"e34e59dce2204f228f3a84b6725df60f","d6d02b6ef04e4f17805504500b8ce441",22856849,1,-65,0,2101,419,375,-44
"d6d02b6ef04e4f17805504500b8ce441","4a29443515bb404cb8924e1c60a63b73",22856849,1,-118,0,2104,375,285,-90
"4a29443515bb404cb8924e1c60a63b73","d6d02b6ef04e4f17805504500b8ce441",22856849,1,118,0,2105,285,375,90
"d6d02b6ef04e4f17805504500b8ce441","24cf8786024543f19b89bc20034e60d7",22856849,1,81,0,2108,375,428,53
"24cf8786024543f19b89bc20034e60d7","66ada10dde9f43018588f1ced9d477fc",22856849,2,8,0,2109,428,434,6
"66ada10dde9f43018588f1ced9d477fc","dce46f8904594a62a6377a3587aaa663",22856849,1,-4,0,2110,434,431,-3
"dce46f8904594a62a6377a3587aaa663","f2a73be2f46840b182d7bd095378004e",22856849,1,-3,0,2112,431,429,-2
"f2a73be2f46840b182d7bd095378004e","a2b4bd40cee2481ebd3fc179d6a5cd62",22856849,1,-19,0,2113,429,417,-12
"24cf8786024543f19b89bc20034e60d7","66baf19b6b904b70922329068c63746d",22856849,1,-77,0,2115,428,376,-52
"f2a73be2f46840b182d7bd095378004e","24cf8786024543f19b89bc20034e60d7",22856849,3,-1,0,2119,429,428,-1
"dce46f8904594a62a6377a3587aaa663","74a7f8712e5449c2bc0b43c6f90dafed",22856849,1,5,0,2137,431,435,4
"74a7f8712e5449c2bc0b43c6f90dafed","74a7f8712e5449c2bc0b43c6f90dafed",22856849,2,0,1,2138,435,435,0
"74a7f8712e5449c2bc0b43c6f90dafed","66ada10dde9f43018588f1ced9d477fc",22856849,1,-1,0,2140,435,434,-1
"66ada10dde9f43018588f1ced9d477fc","bf12c96466d840a69bed7020b3f18bb8",22856849,1,3,0,2141,434,436,2
"bf12c96466d840a69bed7020b3f18bb8","bf12c96466d840a69bed7020b3f18bb8",22856849,1,0,1,2142,436,436,0
"bf12c96466d840a69bed7020b3f18bb8","24cf8786024543f19b89bc20034e60d7",22856849,1,-11,0,2143,436,428,-8
"24cf8786024543f19b89bc20034e60d7","8a7f26e690f34dda97be16904518ca99",22856849,1,30,0,2146,428,447,19
"8a7f26e690f34dda97be16904518ca99","070600601c4c439288445d2f0724807d",22856849,1,-16,0,2147,447,437,-10
"070600601c4c439288445d2f0724807d","8a7f26e690f34dda97be16904518ca99",22856849,1,16,0,2148,437,447,10
"8a7f26e690f34dda97be16904518ca99","8a7f26e690f34dda97be16904518ca99",22856849,1,0,1,2149,447,447,0
"8a7f26e690f34dda97be16904518ca99","b2f0d654738f48158edff28e8d3a546e",22856849,1,5,0,2150,447,449,2
"b2f0d654738f48158edff28e8d3a546e","070600601c4c439288445d2f0724807d",22856849,2,-21,0,2151,449,437,-12
"070600601c4c439288445d2f0724807d","bf12c96466d840a69bed7020b3f18bb8",22856849,1,-3,0,2152,437,436,-1
"bf12c96466d840a69bed7020b3f18bb8","070600601c4c439288445d2f0724807d",22856849,1,3,0,2153,436,437,1
"070600601c4c439288445d2f0724807d","24cf8786024543f19b89bc20034e60d7",22856849,1,-14,0,2154,437,428,-9
"24cf8786024543f19b89bc20034e60d7","1823b6de7d334a7aaabc4570719af4d9",22856849,1,16,0,2155,428,439,11
"1823b6de7d334a7aaabc4570719af4d9","0380cd76a7d44bc3a4da1f15e4d68f89",22856849,1,2,0,2156,439,440,1
"0380cd76a7d44bc3a4da1f15e4d68f89","070600601c4c439288445d2f0724807d",22856849,1,-4,0,2157,440,437,-3
"070600601c4c439288445d2f0724807d","23b7673c8b5443108c2ef09382834a86",22856849,1,6,0,2158,437,441,4
"7bd5586eb9d8484eb74a433ee7bfe499","b2f0d654738f48158edff28e8d3a546e",22856849,1,7,0,2167,446,449,3
"070600601c4c439288445d2f0724807d","f60ee41ec635499abd48168342d32c2f",22856849,1,26,0,2169,437,453,16
"f60ee41ec635499abd48168342d32c2f","9428d8bd9c5a47b2a235b254e5e27ded",22856849,1,-1,0,2225,453,452,-1
"b2f0d654738f48158edff28e8d3a546e","f67fbf45a5f146ed866965bc57c7c001",22856849,1,8,0,2227,449,454,5
"f67fbf45a5f146ed866965bc57c7c001","f67fbf45a5f146ed866965bc57c7c001",22856849,2,0,1,2228,454,454,0
"f67fbf45a5f146ed866965bc57c7c001","d937afe49bd24a07a550dda1c1155122",22856849,1,1,0,2230,454,455,1
"d937afe49bd24a07a550dda1c1155122","d937afe49bd24a07a550dda1c1155122",22856849,1,0,1,2231,455,455,0
"d937afe49bd24a07a550dda1c1155122","3628b3f7823443d0912a339096b69943",22856849,1,1,0,2232,455,456,1
"3628b3f7823443d0912a339096b69943","3628b3f7823443d0912a339096b69943",22856849,1,0,1,2233,456,456,0
"3628b3f7823443d0912a339096b69943","9e049ee647cf43ecbcb5ed792a8e7588",22856849,1,1,0,2234,456,457,1
"9e049ee647cf43ecbcb5ed792a8e7588","9e049ee647cf43ecbcb5ed792a8e7588",22856849,1,0,1,2235,457,457,0
"9e049ee647cf43ecbcb5ed792a8e7588","5256a214faaf410b93f76cea06428334",22856849,1,1,0,2236,457,458,1
"5256a214faaf410b93f76cea06428334","5256a214faaf410b93f76cea06428334",22856849,1,0,1,2237,458,458,0
"5256a214faaf410b93f76cea06428334","25c32b120fce40fa9b6c85133aeb4716",22856849,1,1,0,2238,458,459,1
"25c32b120fce40fa9b6c85133aeb4716","25c32b120fce40fa9b6c85133aeb4716",22856849,1,0,1,2239,459,459,0
"25c32b120fce40fa9b6c85133aeb4716","11bc14f2204949008b7d511b933363c1",22856849,1,1,0,2240,459,460,1
"11bc14f2204949008b7d511b933363c1","11bc14f2204949008b7d511b933363c1",22856849,1,0,1,2241,460,460,0
"11bc14f2204949008b7d511b933363c1","42de338840a34d15adb66e7b14fb9d2c",22856849,1,1,0,2242,460,461,1
"42de338840a34d15adb66e7b14fb9d2c","42de338840a34d15adb66e7b14fb9d2c",22856849,3,0,1,2243,461,461,0
"42de338840a34d15adb66e7b14fb9d2c","9da37c6210b1416b8079c274f70bf600",22856849,1,1,0,2246,461,462,1
"9da37c6210b1416b8079c274f70bf600","9da37c6210b1416b8079c274f70bf600",22856849,1,0,1,2247,462,462,0
"9da37c6210b1416b8079c274f70bf600","519119f1deac45ff9ab4f13529be5c6e",22856849,1,1,0,2248,462,463,1
"519119f1deac45ff9ab4f13529be5c6e","519119f1deac45ff9ab4f13529be5c6e",22856849,1,0,1,2249,463,463,0
"519119f1deac45ff9ab4f13529be5c6e","c5df9f40ec14463b9dcfdc73df3e9285",22856849,1,3,0,2250,463,464,1
"c5df9f40ec14463b9dcfdc73df3e9285","f67fbf45a5f146ed866965bc57c7c001",22856849,1,-12,0,2251,464,454,-10
"f67fbf45a5f146ed866965bc57c7c001","c5df9f40ec14463b9dcfdc73df3e9285",22856849,1,12,0,2252,454,464,10
"c5df9f40ec14463b9dcfdc73df3e9285","c5df9f40ec14463b9dcfdc73df3e9285",22856849,7,0,1,2253,464,464,0
"c5df9f40ec14463b9dcfdc73df3e9285","d6d02b6ef04e4f17805504500b8ce441",22856849,1,-136,0,2260,464,375,-89
"d6d02b6ef04e4f17805504500b8ce441","83d42d95cd844fc093fc09cee250edb8",22856849,1,139,0,2263,375,465,90
"83d42d95cd844fc093fc09cee250edb8","83d42d95cd844fc093fc09cee250edb8",22856849,4,0,1,2264,465,465,0
"b613861cecf84ffcab01afb23f660475","b613861cecf84ffcab01afb23f660475",22857335,3,0,1,1,1,1,0
"b613861cecf84ffcab01afb23f660475","e2911e79efc2420eac45d9f671463d4b",22857335,2,3,0,4,1,2,1
"e2911e79efc2420eac45d9f671463d4b","b613861cecf84ffcab01afb23f660475",22857335,1,-3,0,5,2,1,-1
"e2911e79efc2420eac45d9f671463d4b","519d1b8c59404d67b54e96c5c8a830b2",22857335,1,1,0,8,2,3,1
"519d1b8c59404d67b54e96c5c8a830b2","519d1b8c59404d67b54e96c5c8a830b2",22857335,1,0,1,9,3,3,0
"519d1b8c59404d67b54e96c5c8a830b2","531db53f81f646edb0cdcfe0085b03b7",22857335,1,1,0,10,3,4,1
"531db53f81f646edb0cdcfe0085b03b7","531db53f81f646edb0cdcfe0085b03b7",22857335,1,0,1,11,4,4,0
"531db53f81f646edb0cdcfe0085b03b7","4f5f94b2f95141e0a9d53a61da2276da",22857335,1,1,0,12,4,5,1
"4f5f94b2f95141e0a9d53a61da2276da","4f5f94b2f95141e0a9d53a61da2276da",22857335,1,0,1,13,5,5,0
"4f5f94b2f95141e0a9d53a61da2276da","6d541c89590949f99af293c4f2333f67",22857335,1,1,0,14,5,6,1
"6d541c89590949f99af293c4f2333f67","6d541c89590949f99af293c4f2333f67",22857335,1,0,1,15,6,6,0
"6d541c89590949f99af293c4f2333f67","dd5cf0b9fe4c4f1d8f5ff8e4c04879cb",22857335,1,1,0,16,6,7,1
"dd5cf0b9fe4c4f1d8f5ff8e4c04879cb","dd5cf0b9fe4c4f1d8f5ff8e4c04879cb",22857335,1,0,1,17,7,7,0
"dd5cf0b9fe4c4f1d8f5ff8e4c04879cb","f96261861edc426abe2248be4f0a709a",22857335,1,1,0,18,7,8,1
"f96261861edc426abe2248be4f0a709a","f96261861edc426abe2248be4f0a709a",22857335,1,0,1,19,8,8,0
"f96261861edc426abe2248be4f0a709a","66b5e16f4f75454fb5b8172079f0fa83",22857335,1,1,0,20,8,9,1
"66b5e16f4f75454fb5b8172079f0fa83","66b5e16f4f75454fb5b8172079f0fa83",22857335,1,0,1,21,9,9,0
"66b5e16f4f75454fb5b8172079f0fa83","0680571d4698477995e41842c36a54b2",22857335,1,1,0,22,9,10,1
"0680571d4698477995e41842c36a54b2","0680571d4698477995e41842c36a54b2",22857335,1,0,1,23,10,10,0
"0680571d4698477995e41842c36a54b2","9112f2bffece48e08c6d2287be204085",22857335,1,1,0,24,10,11,1
"9112f2bffece48e08c6d2287be204085","9112f2bffece48e08c6d2287be204085",22857335,1,0,1,25,11,11,0
"9112f2bffece48e08c6d2287be204085","56586aa865414f538729c7f7735d2bc6",22857335,1,3,0,26,11,12,1
"56586aa865414f538729c7f7735d2bc6","e2911e79efc2420eac45d9f671463d4b",22857335,3,-12,0,27,12,2,-10
"e2911e79efc2420eac45d9f671463d4b","56586aa865414f538729c7f7735d2bc6",22857335,3,12,0,28,2,12,10
"56586aa865414f538729c7f7735d2bc6","56586aa865414f538729c7f7735d2bc6",22857335,12,0,1,29,12,12,0
"56586aa865414f538729c7f7735d2bc6","b7f2b31585d94eb3bf86376714aa7070",22857335,8,2,0,32,12,13,1
"b7f2b31585d94eb3bf86376714aa7070","b7f2b31585d94eb3bf86376714aa7070",22857335,4,0,1,33,13,13,0
"b7f2b31585d94eb3bf86376714aa7070","3f1c815879794b929260d224becaff7e",22857335,5,2,0,35,13,14,1
"3f1c815879794b929260d224becaff7e","56586aa865414f538729c7f7735d2bc6",22857335,1,-4,0,36,14,12,-2
"56586aa865414f538729c7f7735d2bc6","5c5ceeee4562457ba6d41515aeebfbb1",22857335,1,10,0,37,12,17,5
"5c5ceeee4562457ba6d41515aeebfbb1","eb2a0eb537344a9e891c761662e400b6",22857335,1,-2,0,38,17,16,-1
"eb2a0eb537344a9e891c761662e400b6","5c5ceeee4562457ba6d41515aeebfbb1",22857335,1,2,0,39,16,17,1
"5c5ceeee4562457ba6d41515aeebfbb1","5c5ceeee4562457ba6d41515aeebfbb1",22857335,1,0,1,40,17,17,0
"5c5ceeee4562457ba6d41515aeebfbb1","3f1c815879794b929260d224becaff7e",22857335,1,-6,0,41,17,14,-3
"3f1c815879794b929260d224becaff7e","eb2a0eb537344a9e891c761662e400b6",22857335,1,4,0,42,14,16,2
"eb2a0eb537344a9e891c761662e400b6","b7f2b31585d94eb3bf86376714aa7070",22857335,1,-6,0,43,16,13,-3
"b7f2b31585d94eb3bf86376714aa7070","56586aa865414f538729c7f7735d2bc6",22857335,3,-2,0,44,13,12,-1
"b7f2b31585d94eb3bf86376714aa7070","81c864a886d54a6b8ff85f7d736f4f95",22857335,2,4,0,46,13,15,2
"81c864a886d54a6b8ff85f7d736f4f95","56586aa865414f538729c7f7735d2bc6",22857335,2,-6,0,47,15,12,-3
"e2911e79efc2420eac45d9f671463d4b","e2911e79efc2420eac45d9f671463d4b",22857335,2,0,1,49,2,2,0
"3f1c815879794b929260d224becaff7e","81c864a886d54a6b8ff85f7d736f4f95",22857335,2,2,0,58,14,15,1
"81c864a886d54a6b8ff85f7d736f4f95","3f1c815879794b929260d224becaff7e",22857335,1,-2,0,59,15,14,-1
"3f1c815879794b929260d224becaff7e","5c5ceeee4562457ba6d41515aeebfbb1",22857335,2,6,0,66,14,17,3
"5c5ceeee4562457ba6d41515aeebfbb1","56586aa865414f538729c7f7735d2bc6",22857335,2,-10,0,67,17,12,-5
"5c5ceeee4562457ba6d41515aeebfbb1","81c864a886d54a6b8ff85f7d736f4f95",22857335,1,-4,0,79,17,15,-2
"81c864a886d54a6b8ff85f7d736f4f95","5c5ceeee4562457ba6d41515aeebfbb1",22857335,2,4,0,80,15,17,2
"56586aa865414f538729c7f7735d2bc6","9afd71a5298d4333b6849dfce1b9422c",22857335,2,13,0,82,12,18,6
"9afd71a5298d4333b6849dfce1b9422c","56586aa865414f538729c7f7735d2bc6",22857335,2,-13,0,83,18,12,-6
"3f1c815879794b929260d224becaff7e","b7f2b31585d94eb3bf86376714aa7070",22857335,1,-2,0,88,14,13,-1
"5c5ceeee4562457ba6d41515aeebfbb1","9afd71a5298d4333b6849dfce1b9422c",22857335,1,3,0,91,17,18,1
"b7719e26494940efa49512aedd0aac79","d4f45188d3c84a02ba08454e6403a818",22857335,1,5,0,96,20,24,4
"d4f45188d3c84a02ba08454e6403a818","d4c3b003e8274e429d2fa688d73fde6d",22857335,1,-2,0,97,24,22,-2
"d4c3b003e8274e429d2fa688d73fde6d","b7719e26494940efa49512aedd0aac79",22857335,1,-3,0,98,22,20,-2
"b7719e26494940efa49512aedd0aac79","afbf7250b99d47bea07172749483ca97",22857335,7,12,0,100,20,28,8
"afbf7250b99d47bea07172749483ca97","afbf7250b99d47bea07172749483ca97",22857335,4,0,1,101,28,28,0
"afbf7250b99d47bea07172749483ca97","b7719e26494940efa49512aedd0aac79",22857335,5,-12,0,102,28,20,-8
"b7719e26494940efa49512aedd0aac79","b7719e26494940efa49512aedd0aac79",22857335,6,0,1,103,20,20,0
"afbf7250b99d47bea07172749483ca97","4e51676dc72045d99c19b9fa7b22f8bc",22857335,5,3,0,106,28,29,1
"4e51676dc72045d99c19b9fa7b22f8bc","4e51676dc72045d99c19b9fa7b22f8bc",22857335,2,0,1,107,29,29,0
"4e51676dc72045d99c19b9fa7b22f8bc","51970cfa30e643e894e66ae85c8024cc",22857335,3,3,0,108,29,31,2
"51970cfa30e643e894e66ae85c8024cc","4e51676dc72045d99c19b9fa7b22f8bc",22857335,1,-3,0,109,31,29,-2
"4e51676dc72045d99c19b9fa7b22f8bc","c33c17be71ae4d588da7369472e5bb1b",22857335,2,9,0,110,29,34,5
"c33c17be71ae4d588da7369472e5bb1b","c33c17be71ae4d588da7369472e5bb1b",22857335,1,0,1,111,34,34,0
"c33c17be71ae4d588da7369472e5bb1b","93679be414554a11b1893002f2229a93",22857335,2,3,0,112,34,35,1
"93679be414554a11b1893002f2229a93","93679be414554a11b1893002f2229a93",22857335,2,0,1,113,35,35,0
"93679be414554a11b1893002f2229a93","7040a13096d746ac84b8fac8d9752058",22857335,2,3,0,114,35,36,1
"7040a13096d746ac84b8fac8d9752058","7040a13096d746ac84b8fac8d9752058",22857335,1,0,1,115,36,36,0
"7040a13096d746ac84b8fac8d9752058","9a0dc646f934470daf08c4b56ccf73db",22857335,2,3,0,116,36,37,1
"9a0dc646f934470daf08c4b56ccf73db","9a0dc646f934470daf08c4b56ccf73db",22857335,1,0,1,117,37,37,0
"9a0dc646f934470daf08c4b56ccf73db","fc0e049d56024bc9a02c9a9c435c3df7",22857335,1,3,0,118,37,38,1
"fc0e049d56024bc9a02c9a9c435c3df7","9afd71a5298d4333b6849dfce1b9422c",22857335,1,-40,0,119,38,18,-20
"9afd71a5298d4333b6849dfce1b9422c","9afd71a5298d4333b6849dfce1b9422c",22857335,4,0,1,120,18,18,0
"9afd71a5298d4333b6849dfce1b9422c","b7719e26494940efa49512aedd0aac79",22857335,3,4,0,122,18,20,2
"b7719e26494940efa49512aedd0aac79","d4c3b003e8274e429d2fa688d73fde6d",22857335,1,3,0,123,20,22,2
"d4c3b003e8274e429d2fa688d73fde6d","d4f45188d3c84a02ba08454e6403a818",22857335,1,2,0,124,22,24,2
"d4f45188d3c84a02ba08454e6403a818","b613861cecf84ffcab01afb23f660475",22857335,1,-37,0,125,24,1,-23
"b613861cecf84ffcab01afb23f660475","a49d1bb4328949299686242fd0be5584",22857335,2,34,0,126,1,21,20
"a49d1bb4328949299686242fd0be5584","b7719e26494940efa49512aedd0aac79",22857335,6,-2,0,127,21,20,-1
"afbf7250b99d47bea07172749483ca97","b613861cecf84ffcab01afb23f660475",22857335,1,-44,0,130,28,1,-27
"b7719e26494940efa49512aedd0aac79","4e51676dc72045d99c19b9fa7b22f8bc",22857335,3,15,0,135,20,29,9
"4e51676dc72045d99c19b9fa7b22f8bc","afbf7250b99d47bea07172749483ca97",22857335,4,-3,0,136,29,28,-1
"51970cfa30e643e894e66ae85c8024cc","c33c17be71ae4d588da7369472e5bb1b",22857335,2,6,0,139,31,34,3
"c33c17be71ae4d588da7369472e5bb1b","4e51676dc72045d99c19b9fa7b22f8bc",22857335,2,-9,0,140,34,29,-5
"9a0dc646f934470daf08c4b56ccf73db","7040a13096d746ac84b8fac8d9752058",22857335,1,-3,0,146,37,36,-1
"7040a13096d746ac84b8fac8d9752058","fc0e049d56024bc9a02c9a9c435c3df7",22857335,1,6,0,147,36,38,2
"fc0e049d56024bc9a02c9a9c435c3df7","9a0dc646f934470daf08c4b56ccf73db",22857335,1,-3,0,148,38,37,-1
"9a0dc646f934470daf08c4b56ccf73db","a49d1bb4328949299686242fd0be5584",22857335,1,-31,0,149,37,21,-16
"b7719e26494940efa49512aedd0aac79","9afd71a5298d4333b6849dfce1b9422c",22857335,1,-4,0,152,20,18,-2
"b7719e26494940efa49512aedd0aac79","a49d1bb4328949299686242fd0be5584",22857335,2,2,0,155,20,21,1
"a49d1bb4328949299686242fd0be5584","afbf7250b99d47bea07172749483ca97",22857335,1,10,0,156,21,28,7
"4e51676dc72045d99c19b9fa7b22f8bc","a49d1bb4328949299686242fd0be5584",22857335,1,-13,0,168,29,21,-8
"afbf7250b99d47bea07172749483ca97","78adeee1fa2c4fe0bc73f7bca9fcee86",22857335,1,180,0,179,28,160,132
"78adeee1fa2c4fe0bc73f7bca9fcee86","78adeee1fa2c4fe0bc73f7bca9fcee86",22857335,3,0,1,180,160,160,0
"78adeee1fa2c4fe0bc73f7bca9fcee86","8959e6304a0348309a771e4d08d1b64a",22857335,3,4,0,181,160,163,3
"8959e6304a0348309a771e4d08d1b64a","78adeee1fa2c4fe0bc73f7bca9fcee86",22857335,2,-4,0,182,163,160,-3
"78adeee1fa2c4fe0bc73f7bca9fcee86","65202579580f4ad38d734b4ee39d22a8",22857335,11,5,0,183,160,164,4
"65202579580f4ad38d734b4ee39d22a8","65202579580f4ad38d734b4ee39d22a8",22857335,125,0,1,184,164,164,0
"65202579580f4ad38d734b4ee39d22a8","df1de691dafe4549a18a4398ee9dfaf9",22857335,1,-31,0,191,164,139,-25
"df1de691dafe4549a18a4398ee9dfaf9","f03480cf4eba413194d7af52fc0e7f28",22857335,2,15,0,192,139,152,13
"f03480cf4eba413194d7af52fc0e7f28","df1de691dafe4549a18a4398ee9dfaf9",22857335,1,-15,0,193,152,139,-13
"f03480cf4eba413194d7af52fc0e7f28","8aae34f5ddbb4052a709b12e6b0d40fa",22857335,1,-6,0,195,152,147,-5
"8aae34f5ddbb4052a709b12e6b0d40fa","f902b0f41b544d4dbf79664fd233648d",22857335,1,-1,0,196,147,146,-1
"f902b0f41b544d4dbf79664fd233648d","6c5ad271a44743479bfaea29b1db8d02",22857335,1,-4,0,197,146,143,-3
"6c5ad271a44743479bfaea29b1db8d02","df1de691dafe4549a18a4398ee9dfaf9",22857335,2,-4,0,198,143,139,-4
"df1de691dafe4549a18a4398ee9dfaf9","df1de691dafe4549a18a4398ee9dfaf9",22857335,4,0,1,199,139,139,0
"df1de691dafe4549a18a4398ee9dfaf9","779f9ddd1fd14d1e9e69f72219a1fdbd",22857335,4,-23,0,200,139,121,-18
"779f9ddd1fd14d1e9e69f72219a1fdbd","779f9ddd1fd14d1e9e69f72219a1fdbd",22857335,4,0,1,201,121,121,0
"779f9ddd1fd14d1e9e69f72219a1fdbd","df1de691dafe4549a18a4398ee9dfaf9",22857335,3,23,0,202,121,139,18
"df1de691dafe4549a18a4398ee9dfaf9","67a089198fcb4e1c8f2385786c2b296f",22857335,1,-126,0,212,139,39,-100
"67a089198fcb4e1c8f2385786c2b296f","64d48c6c9c7940639a932219a6c87198",22857335,1,1,0,213,39,40,1
"64d48c6c9c7940639a932219a6c87198","64d48c6c9c7940639a932219a6c87198",22857335,1,0,1,214,40,40,0
"64d48c6c9c7940639a932219a6c87198","b534b89233134e30a9b5645138bfa9ee",22857335,1,3,0,215,40,41,1
"b534b89233134e30a9b5645138bfa9ee","67a089198fcb4e1c8f2385786c2b296f",22857335,2,-4,0,216,41,39,-2
"67a089198fcb4e1c8f2385786c2b296f","b534b89233134e30a9b5645138bfa9ee",22857335,2,4,0,217,39,41,2
"b534b89233134e30a9b5645138bfa9ee","0e37b720d23b4e7f8b313e79313fd107",22857335,1,3,0,218,41,44,3
"0e37b720d23b4e7f8b313e79313fd107","0e37b720d23b4e7f8b313e79313fd107",22857335,1,0,1,219,44,44,0
"0e37b720d23b4e7f8b313e79313fd107","6875d67fdd5f48168b62719df449bebd",22857335,1,1,0,220,44,45,1
"6875d67fdd5f48168b62719df449bebd","6875d67fdd5f48168b62719df449bebd",22857335,1,0,1,221,45,45,0
"6875d67fdd5f48168b62719df449bebd","b534b89233134e30a9b5645138bfa9ee",22857335,1,-4,0,222,45,41,-4
"b534b89233134e30a9b5645138bfa9ee","6e13d61a7bdb44bca949c9f86fab3be5",22857335,4,7,0,223,41,47,6
"6e13d61a7bdb44bca949c9f86fab3be5","b534b89233134e30a9b5645138bfa9ee",22857335,2,-7,0,224,47,41,-6
"6e13d61a7bdb44bca949c9f86fab3be5","d9c8d8c444a64dadbbb508652c721e17",22857335,2,-1,0,226,47,46,-1
"d9c8d8c444a64dadbbb508652c721e17","6e13d61a7bdb44bca949c9f86fab3be5",22857335,1,1,0,227,46,47,1
"6e13d61a7bdb44bca949c9f86fab3be5","6e13d61a7bdb44bca949c9f86fab3be5",22857335,11,0,1,230,47,47,0
"6e13d61a7bdb44bca949c9f86fab3be5","195f78799f984cc2b06c48dfe36be751",22857335,1,2,0,233,47,49,2
"195f78799f984cc2b06c48dfe36be751","195f78799f984cc2b06c48dfe36be751",22857335,2,0,1,234,49,49,0
"195f78799f984cc2b06c48dfe36be751","d0c74f735e024943943e40333d6d337f",22857335,1,3,0,236,49,51,2
"d0c74f735e024943943e40333d6d337f","d9c8d8c444a64dadbbb508652c721e17",22857335,2,-6,0,237,51,46,-5
"d9c8d8c444a64dadbbb508652c721e17","d0c74f735e024943943e40333d6d337f",22857335,2,6,0,238,46,51,5
"d0c74f735e024943943e40333d6d337f","983f8ff320594b279a7f4a6fe132f9c5",22857335,1,2,0,239,51,53,2
"983f8ff320594b279a7f4a6fe132f9c5","983f8ff320594b279a7f4a6fe132f9c5",22857335,2,0,1,240,53,53,0
"983f8ff320594b279a7f4a6fe132f9c5","35adfa5d923046aebabfefd98f35ff05",22857335,1,1,0,242,53,54,1
"35adfa5d923046aebabfefd98f35ff05","35adfa5d923046aebabfefd98f35ff05",22857335,3,0,1,243,54,54,0
"35adfa5d923046aebabfefd98f35ff05","b6f8a98476224da1b40e555ececc7ed8",22857335,1,1,0,246,54,55,1
"b6f8a98476224da1b40e555ececc7ed8","b6f8a98476224da1b40e555ececc7ed8",22857335,2,0,1,247,55,55,0
"b6f8a98476224da1b40e555ececc7ed8","86e22cb5fe0e4b47a9489ecddf7ed78f",22857335,1,1,0,249,55,56,1
"86e22cb5fe0e4b47a9489ecddf7ed78f","86e22cb5fe0e4b47a9489ecddf7ed78f",22857335,2,0,1,250,56,56,0
"86e22cb5fe0e4b47a9489ecddf7ed78f","f924752d8a1149668870b1e7698486f7",22857335,1,-6,0,252,56,50,-6
"f924752d8a1149668870b1e7698486f7","78f30e4dcac84e3cbea8b2cc6e0d62b3",22857335,2,10,0,253,50,59,9
"78f30e4dcac84e3cbea8b2cc6e0d62b3","a1f2f12debe5432fb7a70bcd12bacfb9",22857335,3,-1,0,254,59,58,-1
"a1f2f12debe5432fb7a70bcd12bacfb9","d0c74f735e024943943e40333d6d337f",22857335,1,-8,0,255,58,51,-7
"d0c74f735e024943943e40333d6d337f","12aa6e1672ac4e7aa6449a7a8609cd72",22857335,1,7,0,256,51,57,6
"12aa6e1672ac4e7aa6449a7a8609cd72","6e13d61a7bdb44bca949c9f86fab3be5",22857335,2,-12,0,257,57,47,-10
"6e13d61a7bdb44bca949c9f86fab3be5","f924752d8a1149668870b1e7698486f7",22857335,1,4,0,258,47,50,3
"f924752d8a1149668870b1e7698486f7","6e13d61a7bdb44bca949c9f86fab3be5",22857335,1,-4,0,259,50,47,-3
"6e13d61a7bdb44bca949c9f86fab3be5","d0c74f735e024943943e40333d6d337f",22857335,1,5,0,260,47,51,4
"d9c8d8c444a64dadbbb508652c721e17","78f30e4dcac84e3cbea8b2cc6e0d62b3",22857335,1,15,0,262,46,59,13
"78f30e4dcac84e3cbea8b2cc6e0d62b3","f924752d8a1149668870b1e7698486f7",22857335,1,-10,0,263,59,50,-9
"f924752d8a1149668870b1e7698486f7","a1f2f12debe5432fb7a70bcd12bacfb9",22857335,2,9,0,264,50,58,8
"a1f2f12debe5432fb7a70bcd12bacfb9","12aa6e1672ac4e7aa6449a7a8609cd72",22857335,1,-1,0,265,58,57,-1
"12aa6e1672ac4e7aa6449a7a8609cd72","d0c74f735e024943943e40333d6d337f",22857335,1,-7,0,266,57,51,-6
"d0c74f735e024943943e40333d6d337f","d0c74f735e024943943e40333d6d337f",22857335,1,0,1,267,51,51,0
"d0c74f735e024943943e40333d6d337f","f924752d8a1149668870b1e7698486f7",22857335,1,-1,0,268,51,50,-1
"a1f2f12debe5432fb7a70bcd12bacfb9","78f30e4dcac84e3cbea8b2cc6e0d62b3",22857335,2,1,0,270,58,59,1
"78f30e4dcac84e3cbea8b2cc6e0d62b3","12aa6e1672ac4e7aa6449a7a8609cd72",22857335,2,-2,0,271,59,57,-2
"d0c74f735e024943943e40333d6d337f","a1f2f12debe5432fb7a70bcd12bacfb9",22857335,1,8,0,283,51,58,7
"a1f2f12debe5432fb7a70bcd12bacfb9","f924752d8a1149668870b1e7698486f7",22857335,1,-9,0,284,58,50,-8
"a1f2f12debe5432fb7a70bcd12bacfb9","a1f2f12debe5432fb7a70bcd12bacfb9",22857335,11,0,1,287,58,58,0
"78f30e4dcac84e3cbea8b2cc6e0d62b3","78f30e4dcac84e3cbea8b2cc6e0d62b3",22857335,9,0,1,299,59,59,0
"12aa6e1672ac4e7aa6449a7a8609cd72","a0a418b8540d479fa6e0f653b701da8b",22857335,1,8,0,309,57,64,7
"a0a418b8540d479fa6e0f653b701da8b","bc42d26810654ea9a1df1efe1e58c7d5",22857335,2,-1,0,310,64,63,-1
"bc42d26810654ea9a1df1efe1e58c7d5","bc42d26810654ea9a1df1efe1e58c7d5",22857335,8,0,1,311,63,63,0
"bc42d26810654ea9a1df1efe1e58c7d5","a0a418b8540d479fa6e0f653b701da8b",22857335,4,1,0,315,63,64,1
"a0a418b8540d479fa6e0f653b701da8b","a0a418b8540d479fa6e0f653b701da8b",22857335,9,0,1,316,64,64,0
"a0a418b8540d479fa6e0f653b701da8b","309ccf3cc4fe429d9bfbaef53d3fa479",22857335,1,-4,0,319,64,60,-4
"309ccf3cc4fe429d9bfbaef53d3fa479","b534b89233134e30a9b5645138bfa9ee",22857335,2,-23,0,320,60,41,-19
"b534b89233134e30a9b5645138bfa9ee","d646286c8051419bbc2e31dd1db55ca8",22857335,2,33,0,321,41,67,26
"d646286c8051419bbc2e31dd1db55ca8","a2becd407db34b189200a32546d9d569",22857335,3,9,0,322,67,75,8
"a2becd407db34b189200a32546d9d569","d646286c8051419bbc2e31dd1db55ca8",22857335,3,-9,0,323,75,67,-8
"d646286c8051419bbc2e31dd1db55ca8","140d5b27b8574befad82c0a013b59dfa",22857335,2,8,0,324,67,74,7
"140d5b27b8574befad82c0a013b59dfa","d18a9ea32855445f8736581f5cb119ce",22857335,3,9,0,325,74,82,8
"d18a9ea32855445f8736581f5cb119ce","ae5ac430ea254e708a6f5deaaf7464ae",22857335,2,3,0,326,82,84,2
"ae5ac430ea254e708a6f5deaaf7464ae","6a9f0ef185fb47f0937e29daa1c71ed5",22857335,3,7,0,327,84,90,6
"6a9f0ef185fb47f0937e29daa1c71ed5","d646286c8051419bbc2e31dd1db55ca8",22857335,1,-27,0,328,90,67,-23
"d646286c8051419bbc2e31dd1db55ca8","e20db35ced8544ddac5bc3839145e463",22857335,3,30,0,329,67,91,24
"e20db35ced8544ddac5bc3839145e463","42fb58708eaf4e5daa82bfca61b6f5fd",22857335,1,-6,0,330,91,87,-4
"42fb58708eaf4e5daa82bfca61b6f5fd","e20db35ced8544ddac5bc3839145e463",22857335,1,6,0,331,87,91,4
"e20db35ced8544ddac5bc3839145e463","e20db35ced8544ddac5bc3839145e463",22857335,2,0,1,332,91,91,0
"e20db35ced8544ddac5bc3839145e463","d646286c8051419bbc2e31dd1db55ca8",22857335,2,-30,0,333,91,67,-24
"d646286c8051419bbc2e31dd1db55ca8","d646286c8051419bbc2e31dd1db55ca8",22857335,2,0,1,334,67,67,0
"d646286c8051419bbc2e31dd1db55ca8","6a9f0ef185fb47f0937e29daa1c71ed5",22857335,1,27,0,337,67,90,23
"6a9f0ef185fb47f0937e29daa1c71ed5","67a089198fcb4e1c8f2385786c2b296f",22857335,1,-64,0,338,90,39,-51
"b534b89233134e30a9b5645138bfa9ee","309ccf3cc4fe429d9bfbaef53d3fa479",22857335,2,23,0,340,41,60,19
"309ccf3cc4fe429d9bfbaef53d3fa479","bc42d26810654ea9a1df1efe1e58c7d5",22857335,2,3,0,341,60,63,3
"bc42d26810654ea9a1df1efe1e58c7d5","4c943503763e4e349906eea3ed3c8e86",22857335,1,-2,0,347,63,61,-2
"4c943503763e4e349906eea3ed3c8e86","4c943503763e4e349906eea3ed3c8e86",22857335,2,0,1,348,61,61,0
"4c943503763e4e349906eea3ed3c8e86","309ccf3cc4fe429d9bfbaef53d3fa479",22857335,1,-1,0,350,61,60,-1
"6a9f0ef185fb47f0937e29daa1c71ed5","3cbcea2be0984e7dbd5a48195af10ce7",22857335,1,96,0,359,90,165,75
"3cbcea2be0984e7dbd5a48195af10ce7","3cbcea2be0984e7dbd5a48195af10ce7",22857335,2,0,1,360,165,165,0
"3cbcea2be0984e7dbd5a48195af10ce7","82e6285962b8400d9d6fc32436022a94",22857335,3,2,0,361,165,167,2
"82e6285962b8400d9d6fc32436022a94","78adeee1fa2c4fe0bc73f7bca9fcee86",22857335,2,-10,0,362,167,160,-7
"78adeee1fa2c4fe0bc73f7bca9fcee86","3cbcea2be0984e7dbd5a48195af10ce7",22857335,2,8,0,363,160,165,5
"3cbcea2be0984e7dbd5a48195af10ce7","65202579580f4ad38d734b4ee39d22a8",22857335,1,-3,0,364,165,164,-1
"65202579580f4ad38d734b4ee39d22a8","a49d1bb4328949299686242fd0be5584",22857335,1,-195,0,372,164,21,-143
"4e51676dc72045d99c19b9fa7b22f8bc","a9ac840f098c4bd0a2ee896214ce29cd",22857335,1,190,0,378,29,168,139
"a9ac840f098c4bd0a2ee896214ce29cd","a9ac840f098c4bd0a2ee896214ce29cd",22857335,6,0,1,379,168,168,0
"a9ac840f098c4bd0a2ee896214ce29cd","67a089198fcb4e1c8f2385786c2b296f",22857335,3,-165,0,380,168,39,-129
"67a089198fcb4e1c8f2385786c2b296f","67a089198fcb4e1c8f2385786c2b296f",22857335,2,0,1,381,39,39,0
"67a089198fcb4e1c8f2385786c2b296f","a9ac840f098c4bd0a2ee896214ce29cd",22857335,2,165,0,383,39,168,129
"67a089198fcb4e1c8f2385786c2b296f","d646286c8051419bbc2e31dd1db55ca8",22857335,2,37,0,385,39,67,28
"d646286c8051419bbc2e31dd1db55ca8","267f883678b24aed855fde42524975d9",22857335,1,4,0,387,67,71,4
"267f883678b24aed855fde42524975d9","267f883678b24aed855fde42524975d9",22857335,1,0,1,388,71,71,0
"267f883678b24aed855fde42524975d9","88fff56d0342490dbef9040750a20f6c",22857335,1,1,0,389,71,72,1
"88fff56d0342490dbef9040750a20f6c","88fff56d0342490dbef9040750a20f6c",22857335,1,0,1,390,72,72,0
"88fff56d0342490dbef9040750a20f6c","adb17b12b66c4a49a85fd34322f7df70",22857335,1,1,0,391,72,73,1
"adb17b12b66c4a49a85fd34322f7df70","adb17b12b66c4a49a85fd34322f7df70",22857335,1,0,1,392,73,73,0
"adb17b12b66c4a49a85fd34322f7df70","a2becd407db34b189200a32546d9d569",22857335,1,3,0,393,73,75,2
"a2becd407db34b189200a32546d9d569","a2becd407db34b189200a32546d9d569",22857335,1,0,1,396,75,75,0
"a2becd407db34b189200a32546d9d569","58c22b011d0f4c2ea6d13615edbb9eeb",22857335,1,2,0,397,75,77,2
"58c22b011d0f4c2ea6d13615edbb9eeb","58c22b011d0f4c2ea6d13615edbb9eeb",22857335,5,0,1,398,77,77,0
"58c22b011d0f4c2ea6d13615edbb9eeb","dd76e1861dc9461c830888729d091ee0",22857335,1,1,0,403,77,78,1
"dd76e1861dc9461c830888729d091ee0","dd76e1861dc9461c830888729d091ee0",22857335,2,0,1,404,78,78,0
"dd76e1861dc9461c830888729d091ee0","cd1d828f1a694b87913a7ea66c23803e",22857335,1,1,0,406,78,79,1
"cd1d828f1a694b87913a7ea66c23803e","cd1d828f1a694b87913a7ea66c23803e",22857335,2,0,1,407,79,79,0
"cd1d828f1a694b87913a7ea66c23803e","9176a3c2b4d2465fa8b0c67096c2a97e",22857335,1,1,0,409,79,80,1
"9176a3c2b4d2465fa8b0c67096c2a97e","9176a3c2b4d2465fa8b0c67096c2a97e",22857335,5,0,1,410,80,80,0
"9176a3c2b4d2465fa8b0c67096c2a97e","f8ec6445f7194e25b9101d4fbcb07a18",22857335,1,1,0,415,80,81,1
"f8ec6445f7194e25b9101d4fbcb07a18","f8ec6445f7194e25b9101d4fbcb07a18",22857335,2,0,1,416,81,81,0
"f8ec6445f7194e25b9101d4fbcb07a18","140d5b27b8574befad82c0a013b59dfa",22857335,1,-7,0,418,81,74,-7
"d18a9ea32855445f8736581f5cb119ce","f564483cbd7a407681aa2fcca518cf5f",22857335,1,4,0,420,82,85,3
"f564483cbd7a407681aa2fcca518cf5f","f564483cbd7a407681aa2fcca518cf5f",22857335,1,0,1,421,85,85,0
"f564483cbd7a407681aa2fcca518cf5f","18fd01350bd5434ca636d59a599d768a",22857335,1,1,0,422,85,86,1
"18fd01350bd5434ca636d59a599d768a","18fd01350bd5434ca636d59a599d768a",22857335,8,0,1,423,86,86,0
"18fd01350bd5434ca636d59a599d768a","ae5ac430ea254e708a6f5deaaf7464ae",22857335,1,-2,0,431,86,84,-2
"6a9f0ef185fb47f0937e29daa1c71ed5","6a9f0ef185fb47f0937e29daa1c71ed5",22857335,8,0,1,433,90,90,0
"6a9f0ef185fb47f0937e29daa1c71ed5","a2becd407db34b189200a32546d9d569",22857335,1,-18,0,437,90,75,-15
"a2becd407db34b189200a32546d9d569","42fb58708eaf4e5daa82bfca61b6f5fd",22857335,1,15,0,438,75,87,12
"42fb58708eaf4e5daa82bfca61b6f5fd","140d5b27b8574befad82c0a013b59dfa",22857335,1,-16,0,439,87,74,-13
"140d5b27b8574befad82c0a013b59dfa","6a9f0ef185fb47f0937e29daa1c71ed5",22857335,1,19,0,440,74,90,16
"6a9f0ef185fb47f0937e29daa1c71ed5","c681290961c94c4caf23b529d1ae6b9a",22857335,1,-2,0,443,90,88,-2
"c681290961c94c4caf23b529d1ae6b9a","c681290961c94c4caf23b529d1ae6b9a",22857335,1,0,1,444,88,88,0
"c681290961c94c4caf23b529d1ae6b9a","d646286c8051419bbc2e31dd1db55ca8",22857335,1,-25,0,445,88,67,-21
"e20db35ced8544ddac5bc3839145e463","67a089198fcb4e1c8f2385786c2b296f",22857335,1,-67,0,447,91,39,-52
"67a089198fcb4e1c8f2385786c2b296f","e20db35ced8544ddac5bc3839145e463",22857335,1,67,0,448,39,91,52
"e20db35ced8544ddac5bc3839145e463","1febb706d7a34005ae8711ed49c76e64",22857335,1,3,0,450,91,94,3
"1febb706d7a34005ae8711ed49c76e64","1febb706d7a34005ae8711ed49c76e64",22857335,3,0,1,451,94,94,0
"1febb706d7a34005ae8711ed49c76e64","8f73ba6f5a0042f2850356ac38ac6f24",22857335,1,1,0,454,94,95,1
"8f73ba6f5a0042f2850356ac38ac6f24","8f73ba6f5a0042f2850356ac38ac6f24",22857335,3,0,1,455,95,95,0
"8f73ba6f5a0042f2850356ac38ac6f24","e2260b86653c46d7b14a41fb419dbf8c",22857335,1,1,0,458,95,96,1
"e2260b86653c46d7b14a41fb419dbf8c","e2260b86653c46d7b14a41fb419dbf8c",22857335,3,0,1,459,96,96,0
"e2260b86653c46d7b14a41fb419dbf8c","35eb641ad1d845bbba54915bce75a962",22857335,1,1,0,462,96,97,1
"35eb641ad1d845bbba54915bce75a962","35eb641ad1d845bbba54915bce75a962",22857335,3,0,1,463,97,97,0
"35eb641ad1d845bbba54915bce75a962","08be90ffbeea4795a138cd42ed8db56f",22857335,1,1,0,466,97,98,1
"08be90ffbeea4795a138cd42ed8db56f","08be90ffbeea4795a138cd42ed8db56f",22857335,6,0,1,467,98,98,0
"08be90ffbeea4795a138cd42ed8db56f","3007433c8f584dcbb5ac159c1c5f2be3",22857335,1,1,0,473,98,99,1
"3007433c8f584dcbb5ac159c1c5f2be3","3007433c8f584dcbb5ac159c1c5f2be3",22857335,3,0,1,474,99,99,0
"3007433c8f584dcbb5ac159c1c5f2be3","00ae5f0c51874a73a41ebea838d95682",22857335,1,3,0,477,99,101,2
"00ae5f0c51874a73a41ebea838d95682","e20db35ced8544ddac5bc3839145e463",22857335,2,-11,0,478,101,91,-10
"e20db35ced8544ddac5bc3839145e463","d391c8b6e56a43a7b654e9dee02d904b",22857335,1,13,0,479,91,103,12
"d391c8b6e56a43a7b654e9dee02d904b","00ae5f0c51874a73a41ebea838d95682",22857335,2,-2,0,480,103,101,-2
"00ae5f0c51874a73a41ebea838d95682","00ae5f0c51874a73a41ebea838d95682",22857335,2,0,1,481,101,101,0
"00ae5f0c51874a73a41ebea838d95682","d391c8b6e56a43a7b654e9dee02d904b",22857335,3,2,0,483,101,103,2
"d391c8b6e56a43a7b654e9dee02d904b","d391c8b6e56a43a7b654e9dee02d904b",22857335,15,0,1,484,103,103,0
"d391c8b6e56a43a7b654e9dee02d904b","6111116566fc4fd9abba409322bea245",22857335,1,1,0,499,103,104,1
"6111116566fc4fd9abba409322bea245","6111116566fc4fd9abba409322bea245",22857335,2,0,1,500,104,104,0
"6111116566fc4fd9abba409322bea245","a81b2235cb9c499eb9ea8ee0a8dd9725",22857335,1,1,0,502,104,105,1
"a81b2235cb9c499eb9ea8ee0a8dd9725","a81b2235cb9c499eb9ea8ee0a8dd9725",22857335,2,0,1,503,105,105,0
"a81b2235cb9c499eb9ea8ee0a8dd9725","2d4e0ab0ef3b4d73b82c72d4621a7579",22857335,1,1,0,505,105,106,1
"2d4e0ab0ef3b4d73b82c72d4621a7579","2d4e0ab0ef3b4d73b82c72d4621a7579",22857335,2,0,1,506,106,106,0
"2d4e0ab0ef3b4d73b82c72d4621a7579","8bdebf492ebd4e62b0d522e8ab5e5197",22857335,1,1,0,508,106,107,1
"8bdebf492ebd4e62b0d522e8ab5e5197","8bdebf492ebd4e62b0d522e8ab5e5197",22857335,2,0,1,509,107,107,0
"8bdebf492ebd4e62b0d522e8ab5e5197","73039f8c1eb9409cb4caee2cf968001e",22857335,1,-7,0,511,107,100,-7
"73039f8c1eb9409cb4caee2cf968001e","4280927ec4d643238aa49c32f9e06c6c",22857335,1,10,0,512,100,109,9
"4280927ec4d643238aa49c32f9e06c6c","4280927ec4d643238aa49c32f9e06c6c",22857335,6,0,1,513,109,109,0
"4280927ec4d643238aa49c32f9e06c6c","e20db35ced8544ddac5bc3839145e463",22857335,1,-20,0,519,109,91,-18
"e20db35ced8544ddac5bc3839145e463","08111f75e22d409998cf8b85bd431f0a",22857335,1,19,0,520,91,108,17
"08111f75e22d409998cf8b85bd431f0a","4280927ec4d643238aa49c32f9e06c6c",22857335,1,1,0,521,108,109,1
"4280927ec4d643238aa49c32f9e06c6c","fc44e6a5f7654430af1227838224dceb",22857335,1,2,0,522,109,111,2
"fc44e6a5f7654430af1227838224dceb","fc44e6a5f7654430af1227838224dceb",22857335,2,0,1,523,111,111,0
"fc44e6a5f7654430af1227838224dceb","a9ae0a3c070d455bb4369a8996313336",22857335,1,4,0,525,111,114,3
"a9ae0a3c070d455bb4369a8996313336","08111f75e22d409998cf8b85bd431f0a",22857335,1,-7,0,526,114,108,-6
"08111f75e22d409998cf8b85bd431f0a","a9ae0a3c070d455bb4369a8996313336",22857335,1,7,0,527,108,114,6
"a9ae0a3c070d455bb4369a8996313336","71cec822bcff4f30a20e75dc63ef7b65",22857335,1,2,0,528,114,116,2
"71cec822bcff4f30a20e75dc63ef7b65","71cec822bcff4f30a20e75dc63ef7b65",22857335,6,0,1,529,116,116,0
"71cec822bcff4f30a20e75dc63ef7b65","62bff51286ef4f348717a3cf6fe2318f",22857335,1,5,0,535,116,120,4
"62bff51286ef4f348717a3cf6fe2318f","37319e88176d4aefa91d7a9980dbae91",22857335,1,-9,0,536,120,112,-8
"37319e88176d4aefa91d7a9980dbae91","7af822066add4e7f8e007e4eee31a8bf",22857335,1,-58,0,537,112,65,-47
"7af822066add4e7f8e007e4eee31a8bf","b534b89233134e30a9b5645138bfa9ee",22857335,1,-29,0,538,65,41,-24
"67a089198fcb4e1c8f2385786c2b296f","3ec3a3563847406fa73338f9e9999cf3",22857335,1,97,0,540,39,117,78
"3ec3a3563847406fa73338f9e9999cf3","e20db35ced8544ddac5bc3839145e463",22857335,3,-30,0,541,117,91,-26
"e20db35ced8544ddac5bc3839145e463","62bff51286ef4f348717a3cf6fe2318f",22857335,3,33,0,542,91,120,29
"62bff51286ef4f348717a3cf6fe2318f","3ec3a3563847406fa73338f9e9999cf3",22857335,4,-3,0,543,120,117,-3
"e20db35ced8544ddac5bc3839145e463","00ae5f0c51874a73a41ebea838d95682",22857335,1,11,0,545,91,101,10
"d391c8b6e56a43a7b654e9dee02d904b","4280927ec4d643238aa49c32f9e06c6c",22857335,1,7,0,547,103,109,6
"4280927ec4d643238aa49c32f9e06c6c","73039f8c1eb9409cb4caee2cf968001e",22857335,1,-10,0,548,109,100,-9
"73039f8c1eb9409cb4caee2cf968001e","08111f75e22d409998cf8b85bd431f0a",22857335,1,9,0,549,100,108,8
"08111f75e22d409998cf8b85bd431f0a","e20db35ced8544ddac5bc3839145e463",22857335,1,-19,0,550,108,91,-17
"3ec3a3563847406fa73338f9e9999cf3","00ae5f0c51874a73a41ebea838d95682",22857335,1,-19,0,556,117,101,-16
"d391c8b6e56a43a7b654e9dee02d904b","e20db35ced8544ddac5bc3839145e463",22857335,1,-13,0,558,103,91,-12
"e20db35ced8544ddac5bc3839145e463","73039f8c1eb9409cb4caee2cf968001e",22857335,2,10,0,559,91,100,9
"73039f8c1eb9409cb4caee2cf968001e","62bff51286ef4f348717a3cf6fe2318f",22857335,2,23,0,560,100,120,20
"3ec3a3563847406fa73338f9e9999cf3","d391c8b6e56a43a7b654e9dee02d904b",22857335,1,-17,0,562,117,103,-14
"62bff51286ef4f348717a3cf6fe2318f","b1cd0e7dc3ad4a8eb91a4bfdbeb025b0",22857335,1,-2,0,567,120,118,-2
"b1cd0e7dc3ad4a8eb91a4bfdbeb025b0","b1cd0e7dc3ad4a8eb91a4bfdbeb025b0",22857335,1,0,1,568,118,118,0
"b1cd0e7dc3ad4a8eb91a4bfdbeb025b0","62bff51286ef4f348717a3cf6fe2318f",22857335,1,2,0,569,118,120,2
"62bff51286ef4f348717a3cf6fe2318f","62bff51286ef4f348717a3cf6fe2318f",22857335,5,0,1,570,120,120,0
"62bff51286ef4f348717a3cf6fe2318f","e20db35ced8544ddac5bc3839145e463",22857335,2,-33,0,573,120,91,-29
"e20db35ced8544ddac5bc3839145e463","779f9ddd1fd14d1e9e69f72219a1fdbd",22857335,2,36,0,574,91,121,30
"779f9ddd1fd14d1e9e69f72219a1fdbd","e20db35ced8544ddac5bc3839145e463",22857335,1,-36,0,575,121,91,-30
"e20db35ced8544ddac5bc3839145e463","3ec3a3563847406fa73338f9e9999cf3",22857335,1,30,0,576,91,117,26
"3ec3a3563847406fa73338f9e9999cf3","62bff51286ef4f348717a3cf6fe2318f",22857335,1,3,0,577,117,120,3
"779f9ddd1fd14d1e9e69f72219a1fdbd","ae26e6cda8ad4a3f81bd347560d9579f",22857335,1,4,0,582,121,125,4
"ae26e6cda8ad4a3f81bd347560d9579f","ae26e6cda8ad4a3f81bd347560d9579f",22857335,1,0,1,583,125,125,0
"ae26e6cda8ad4a3f81bd347560d9579f","ee48df95832b4374aa273ceb27ec1315",22857335,1,1,0,584,125,126,1
"ee48df95832b4374aa273ceb27ec1315","ee48df95832b4374aa273ceb27ec1315",22857335,1,0,1,585,126,126,0
"ee48df95832b4374aa273ceb27ec1315","7a439da90b394756ad1777fc4c6dead5",22857335,1,1,0,586,126,127,1
"7a439da90b394756ad1777fc4c6dead5","7a439da90b394756ad1777fc4c6dead5",22857335,1,0,1,587,127,127,0
"7a439da90b394756ad1777fc4c6dead5","779f9ddd1fd14d1e9e69f72219a1fdbd",22857335,1,-6,0,588,127,121,-6
"779f9ddd1fd14d1e9e69f72219a1fdbd","a8dd5213034441ac92724b4e83eb0bb2",22857335,1,9,0,589,121,129,8
"a8dd5213034441ac92724b4e83eb0bb2","a8dd5213034441ac92724b4e83eb0bb2",22857335,1,0,1,590,129,129,0
"a8dd5213034441ac92724b4e83eb0bb2","8115eab6556b45f5b415c3b8c26a12e5",22857335,1,2,0,591,129,131,2
"8115eab6556b45f5b415c3b8c26a12e5","8115eab6556b45f5b415c3b8c26a12e5",22857335,2,0,1,592,131,131,0
"8115eab6556b45f5b415c3b8c26a12e5","ec34b06efd844b46a4c4818ecdb9b8f4",22857335,1,1,0,594,131,132,1
"ec34b06efd844b46a4c4818ecdb9b8f4","ec34b06efd844b46a4c4818ecdb9b8f4",22857335,5,0,1,595,132,132,0
"ec34b06efd844b46a4c4818ecdb9b8f4","c2e1c2b9eac64109b343a088584b576b",22857335,1,1,0,600,132,133,1
"c2e1c2b9eac64109b343a088584b576b","c2e1c2b9eac64109b343a088584b576b",22857335,2,0,1,601,133,133,0
"c2e1c2b9eac64109b343a088584b576b","579338175e0b4bbb8ef3b712b5d8b54e",22857335,1,-5,0,603,133,128,-5
"579338175e0b4bbb8ef3b712b5d8b54e","8bc5795d6a984a3eace4e2811e52dd4f",22857335,1,8,0,604,128,135,7
"8bc5795d6a984a3eace4e2811e52dd4f","8bc5795d6a984a3eace4e2811e52dd4f",22857335,1,0,1,605,135,135,0
"8bc5795d6a984a3eace4e2811e52dd4f","b416d47c56a742199b5d7c7f19d6503a",22857335,1,-1,0,606,135,134,-1
"b416d47c56a742199b5d7c7f19d6503a","f661500307d74c908e9207d949ceb4aa",22857335,1,3,0,607,134,136,2
"f661500307d74c908e9207d949ceb4aa","b416d47c56a742199b5d7c7f19d6503a",22857335,1,-3,0,608,136,134,-2
"b416d47c56a742199b5d7c7f19d6503a","67a089198fcb4e1c8f2385786c2b296f",22857335,1,-118,0,609,134,39,-95
"67a089198fcb4e1c8f2385786c2b296f","f661500307d74c908e9207d949ceb4aa",22857335,1,121,0,610,39,136,97
"f661500307d74c908e9207d949ceb4aa","779f9ddd1fd14d1e9e69f72219a1fdbd",22857335,1,-18,0,611,136,121,-15
"779f9ddd1fd14d1e9e69f72219a1fdbd","cd4532ad48034873ba8bce2aac0c9808",22857335,1,19,0,612,121,137,16
"cd4532ad48034873ba8bce2aac0c9808","cd4532ad48034873ba8bce2aac0c9808",22857335,3,0,1,613,137,137,0
"cd4532ad48034873ba8bce2aac0c9808","df1de691dafe4549a18a4398ee9dfaf9",22857335,1,4,0,616,137,139,2
"779f9ddd1fd14d1e9e69f72219a1fdbd","6c5ad271a44743479bfaea29b1db8d02",22857335,1,27,0,618,121,143,22
"df1de691dafe4549a18a4398ee9dfaf9","6c5ad271a44743479bfaea29b1db8d02",22857335,1,4,0,621,139,143,4
"6c5ad271a44743479bfaea29b1db8d02","6c5ad271a44743479bfaea29b1db8d02",22857335,1,0,1,622,143,143,0
"6c5ad271a44743479bfaea29b1db8d02","83d311bed5374fee83d8d67a7d9d82dc",22857335,1,1,0,623,143,144,1
"83d311bed5374fee83d8d67a7d9d82dc","83d311bed5374fee83d8d67a7d9d82dc",22857335,1,0,1,624,144,144,0
"83d311bed5374fee83d8d67a7d9d82dc","402bba41861d43acb52a5abb89e8831e",22857335,1,1,0,625,144,145,1
"402bba41861d43acb52a5abb89e8831e","402bba41861d43acb52a5abb89e8831e",22857335,2,0,1,626,145,145,0
"402bba41861d43acb52a5abb89e8831e","df1de691dafe4549a18a4398ee9dfaf9",22857335,1,-6,0,628,145,139,-6
"df1de691dafe4549a18a4398ee9dfaf9","8aae34f5ddbb4052a709b12e6b0d40fa",22857335,1,9,0,629,139,147,8
"8aae34f5ddbb4052a709b12e6b0d40fa","8aae34f5ddbb4052a709b12e6b0d40fa",22857335,1,0,1,630,147,147,0
"8aae34f5ddbb4052a709b12e6b0d40fa","645b3f0249f64f76af2e19eb4d0e55b7",22857335,1,2,0,631,147,149,2
"645b3f0249f64f76af2e19eb4d0e55b7","645b3f0249f64f76af2e19eb4d0e55b7",22857335,5,0,1,632,149,149,0
"645b3f0249f64f76af2e19eb4d0e55b7","7e7b8db5064d4369805ab370aac5ddfb",22857335,1,1,0,637,149,150,1
"7e7b8db5064d4369805ab370aac5ddfb","7e7b8db5064d4369805ab370aac5ddfb",22857335,5,0,1,638,150,150,0
"7e7b8db5064d4369805ab370aac5ddfb","8956d210ae7f41968fada86d4c979d6a",22857335,1,1,0,643,150,151,1
"8956d210ae7f41968fada86d4c979d6a","8956d210ae7f41968fada86d4c979d6a",22857335,2,0,1,644,151,151,0
"8956d210ae7f41968fada86d4c979d6a","f902b0f41b544d4dbf79664fd233648d",22857335,1,-5,0,646,151,146,-5
"f902b0f41b544d4dbf79664fd233648d","ae781e8b775e4ccd93bc800dad5c8376",22857335,1,8,0,647,146,153,7
"ae781e8b775e4ccd93bc800dad5c8376","ae781e8b775e4ccd93bc800dad5c8376",22857335,2,0,1,648,153,153,0
"ae781e8b775e4ccd93bc800dad5c8376","06882a8492d9499aa31555567f575ecb",22857335,1,1,0,650,153,154,1
"06882a8492d9499aa31555567f575ecb","06882a8492d9499aa31555567f575ecb",22857335,1,0,1,651,154,154,0
"06882a8492d9499aa31555567f575ecb","f293c508f409466a8f27ddd7d1e40b20",22857335,1,1,0,652,154,155,1
"f293c508f409466a8f27ddd7d1e40b20","f293c508f409466a8f27ddd7d1e40b20",22857335,2,0,1,653,155,155,0
"f293c508f409466a8f27ddd7d1e40b20","cc4ddef5bbbe48ebb605141b347c4ed1",22857335,1,1,0,655,155,156,1
"cc4ddef5bbbe48ebb605141b347c4ed1","cc4ddef5bbbe48ebb605141b347c4ed1",22857335,1,0,1,656,156,156,0
"cc4ddef5bbbe48ebb605141b347c4ed1","d313cec988a84645bee413e8d4724a4b",22857335,1,3,0,657,156,158,2
"d313cec988a84645bee413e8d4724a4b","f03480cf4eba413194d7af52fc0e7f28",22857335,1,-7,0,658,158,152,-6
"f03480cf4eba413194d7af52fc0e7f28","d313cec988a84645bee413e8d4724a4b",22857335,1,7,0,659,152,158,6
"d313cec988a84645bee413e8d4724a4b","d313cec988a84645bee413e8d4724a4b",22857335,3,0,1,660,158,158,0
"d313cec988a84645bee413e8d4724a4b","dc60696c76a74368a60f72246e47700d",22857335,1,1,0,663,158,159,1
"dc60696c76a74368a60f72246e47700d","dc60696c76a74368a60f72246e47700d",22857335,1,0,1,664,159,159,0
"dc60696c76a74368a60f72246e47700d","df1de691dafe4549a18a4398ee9dfaf9",22857335,1,-23,0,665,159,139,-20
"df1de691dafe4549a18a4398ee9dfaf9","78adeee1fa2c4fe0bc73f7bca9fcee86",22857335,1,26,0,666,139,160,21
"65202579580f4ad38d734b4ee39d22a8","78adeee1fa2c4fe0bc73f7bca9fcee86",22857335,7,-5,0,673,164,160,-4
"65202579580f4ad38d734b4ee39d22a8","a9ac840f098c4bd0a2ee896214ce29cd",22857335,1,8,0,676,164,168,4
"a9ac840f098c4bd0a2ee896214ce29cd","0c7262dff33c4087bc660ccf40f92f9c",22857335,4,4,0,679,168,169,1
"0c7262dff33c4087bc660ccf40f92f9c","b2275c3fad834f8d90737a2d9a6927d6",22857335,3,3,0,680,169,172,3
"b2275c3fad834f8d90737a2d9a6927d6","3cbcea2be0984e7dbd5a48195af10ce7",22857335,1,-12,0,681,172,165,-7
"82e6285962b8400d9d6fc32436022a94","67a089198fcb4e1c8f2385786c2b296f",22857335,1,-162,0,684,167,39,-128
"67a089198fcb4e1c8f2385786c2b296f","78adeee1fa2c4fe0bc73f7bca9fcee86",22857335,1,152,0,685,39,160,121
"65202579580f4ad38d734b4ee39d22a8","8959e6304a0348309a771e4d08d1b64a",22857335,1,-1,0,696,164,163,-1
"8959e6304a0348309a771e4d08d1b64a","b534b89233134e30a9b5645138bfa9ee",22857335,1,-152,0,697,163,41,-122
"6e13d61a7bdb44bca949c9f86fab3be5","bc42d26810654ea9a1df1efe1e58c7d5",22857335,1,19,0,699,47,63,16
"a0a418b8540d479fa6e0f653b701da8b","d9c8d8c444a64dadbbb508652c721e17",22857335,1,-21,0,703,64,46,-18
"d9c8d8c444a64dadbbb508652c721e17","bc42d26810654ea9a1df1efe1e58c7d5",22857335,1,20,0,704,46,63,17
"bc42d26810654ea9a1df1efe1e58c7d5","309ccf3cc4fe429d9bfbaef53d3fa479",22857335,1,-3,0,706,63,60,-3
"309ccf3cc4fe429d9bfbaef53d3fa479","78f30e4dcac84e3cbea8b2cc6e0d62b3",22857335,1,-2,0,707,60,59,-1
"a1f2f12debe5432fb7a70bcd12bacfb9","78adeee1fa2c4fe0bc73f7bca9fcee86",22857335,1,128,0,709,58,160,102
"65202579580f4ad38d734b4ee39d22a8","b534b89233134e30a9b5645138bfa9ee",22857335,1,-153,0,720,164,41,-123
"a0a418b8540d479fa6e0f653b701da8b","67a089198fcb4e1c8f2385786c2b296f",22857335,1,-31,0,728,64,39,-25
"d646286c8051419bbc2e31dd1db55ca8","42fb58708eaf4e5daa82bfca61b6f5fd",22857335,1,24,0,730,67,87,20
"42fb58708eaf4e5daa82bfca61b6f5fd","6a9f0ef185fb47f0937e29daa1c71ed5",22857335,1,3,0,731,87,90,3
"6a9f0ef185fb47f0937e29daa1c71ed5","78adeee1fa2c4fe0bc73f7bca9fcee86",22857335,1,88,0,734,90,160,70
"8959e6304a0348309a771e4d08d1b64a","65202579580f4ad38d734b4ee39d22a8",22857335,2,1,0,736,163,164,1
"65202579580f4ad38d734b4ee39d22a8","67a089198fcb4e1c8f2385786c2b296f",22857335,1,-157,0,759,164,39,-125
"67a089198fcb4e1c8f2385786c2b296f","8959e6304a0348309a771e4d08d1b64a",22857335,1,156,0,763,39,163,124
"65202579580f4ad38d734b4ee39d22a8","3cbcea2be0984e7dbd5a48195af10ce7",22857335,1,3,0,837,164,165,1
"3cbcea2be0984e7dbd5a48195af10ce7","78adeee1fa2c4fe0bc73f7bca9fcee86",22857335,1,-8,0,838,165,160,-5
"78adeee1fa2c4fe0bc73f7bca9fcee86","82e6285962b8400d9d6fc32436022a94",22857335,1,10,0,839,160,167,7
"82e6285962b8400d9d6fc32436022a94","3cbcea2be0984e7dbd5a48195af10ce7",22857335,1,-2,0,852,167,165,-2
"3cbcea2be0984e7dbd5a48195af10ce7","a9ac840f098c4bd0a2ee896214ce29cd",22857335,1,5,0,853,165,168,3
"0c7262dff33c4087bc660ccf40f92f9c","a9ac840f098c4bd0a2ee896214ce29cd",22857335,3,-4,0,855,169,168,-1
"a9ac840f098c4bd0a2ee896214ce29cd","b2275c3fad834f8d90737a2d9a6927d6",22857335,1,7,0,856,168,172,4
"b2275c3fad834f8d90737a2d9a6927d6","0c7262dff33c4087bc660ccf40f92f9c",22857335,2,-3,0,857,172,169,-3
"b2275c3fad834f8d90737a2d9a6927d6","b2275c3fad834f8d90737a2d9a6927d6",22857335,20,0,1,867,172,172,0
"b2275c3fad834f8d90737a2d9a6927d6","eb515a26030b41f8a82a1e6114420bad",22857335,1,1,0,887,172,173,1
"eb515a26030b41f8a82a1e6114420bad","eb515a26030b41f8a82a1e6114420bad",22857335,2,0,1,888,173,173,0
"eb515a26030b41f8a82a1e6114420bad","b42cc17b7de840f181a704558d0bc845",22857335,1,3,0,890,173,175,2
"b42cc17b7de840f181a704558d0bc845","0c7262dff33c4087bc660ccf40f92f9c",22857335,1,-7,0,891,175,169,-6
"0c7262dff33c4087bc660ccf40f92f9c","b42cc17b7de840f181a704558d0bc845",22857335,1,7,0,892,169,175,6
"b42cc17b7de840f181a704558d0bc845","b42cc17b7de840f181a704558d0bc845",22857335,5,0,1,893,175,175,0
"b42cc17b7de840f181a704558d0bc845","801f9e9135034f49bf5f8b4bdefedb41",22857335,1,2,0,898,175,177,2
"801f9e9135034f49bf5f8b4bdefedb41","801f9e9135034f49bf5f8b4bdefedb41",22857335,4,0,1,899,177,177,0
"801f9e9135034f49bf5f8b4bdefedb41","362fcb0699a14845ab29b2340093e528",22857335,1,-3,0,903,177,174,-3
"362fcb0699a14845ab29b2340093e528","ea38cc0e6e6e41edbabf210220808bf9",22857335,1,6,0,904,174,179,5
"ea38cc0e6e6e41edbabf210220808bf9","b87c552dd247427abe6ab5795b9c9d43",22857335,2,2,0,905,179,181,2
"b87c552dd247427abe6ab5795b9c9d43","ea38cc0e6e6e41edbabf210220808bf9",22857335,1,-2,0,906,181,179,-2
"ea38cc0e6e6e41edbabf210220808bf9","ea38cc0e6e6e41edbabf210220808bf9",22857335,1,0,1,907,179,179,0
"b87c552dd247427abe6ab5795b9c9d43","b87c552dd247427abe6ab5795b9c9d43",22857335,7,0,1,909,181,181,0
"b87c552dd247427abe6ab5795b9c9d43","139b097acfca451689d80c9c6eebdf7b",22857335,1,-3,0,916,181,178,-3
"139b097acfca451689d80c9c6eebdf7b","30f660a1feb34582a739722532524f79",22857335,1,6,0,917,178,183,5
"30f660a1feb34582a739722532524f79","30f660a1feb34582a739722532524f79",22857335,7,0,1,918,183,183,0
"30f660a1feb34582a739722532524f79","2024b4885bd14338a39b7b509acbbd02",22857335,2,-1,0,924,183,182,-1
"2024b4885bd14338a39b7b509acbbd02","cf4c280bad6a43e6b131d8385ef9ef3f",22857335,1,3,0,925,182,184,2
"cf4c280bad6a43e6b131d8385ef9ef3f","30f660a1feb34582a739722532524f79",22857335,1,-2,0,926,184,183,-1
"2024b4885bd14338a39b7b509acbbd02","c3f63fe50d8e487c86bf8ef76c9cadd3",22857335,1,4,0,929,182,185,3
"c3f63fe50d8e487c86bf8ef76c9cadd3","c3f63fe50d8e487c86bf8ef76c9cadd3",22857335,1,0,1,930,185,185,0
"c3f63fe50d8e487c86bf8ef76c9cadd3","0c7262dff33c4087bc660ccf40f92f9c",22857335,1,-20,0,931,185,169,-16
"c8e371568a0c4391b25796ae4e91952e","0c7262dff33c4087bc660ccf40f92f9c",22857335,1,-23,0,933,186,169,-17
"0c7262dff33c4087bc660ccf40f92f9c","0c7262dff33c4087bc660ccf40f92f9c",22857335,1,0,1,934,169,169,0
"c8e371568a0c4391b25796ae4e91952e","7d932b23e1c84326ae5aa4d3c0d813d1",22857335,1,2,0,936,186,188,2
"7d932b23e1c84326ae5aa4d3c0d813d1","7d932b23e1c84326ae5aa4d3c0d813d1",22857335,1,0,1,937,188,188,0
"7d932b23e1c84326ae5aa4d3c0d813d1","c8e371568a0c4391b25796ae4e91952e",22857335,1,-2,0,938,188,186,-2
"ab11d94c6c8948ea90b88f19d2cd502b","ab11d94c6c8948ea90b88f19d2cd502b",22857335,5,0,1,940,190,190,0
"f992451ed6ad4e68bb9e68ad6be7c4be","f992451ed6ad4e68bb9e68ad6be7c4be",22857335,2,0,1,944,192,192,0
"f992451ed6ad4e68bb9e68ad6be7c4be","07b44a7a51e94c78b411c753fc39dab0",22857335,2,-3,0,945,192,189,-3
"07b44a7a51e94c78b411c753fc39dab0","6cd2dcaac46847d4a0bc53f296d90375",22857335,2,6,0,946,189,194,5
"6cd2dcaac46847d4a0bc53f296d90375","6cd2dcaac46847d4a0bc53f296d90375",22857335,2,0,1,947,194,194,0
"6cd2dcaac46847d4a0bc53f296d90375","2d2580c9411c4972909db508d6956a58",22857335,1,2,0,949,194,196,2
"2d2580c9411c4972909db508d6956a58","2d2580c9411c4972909db508d6956a58",22857335,3,0,1,950,196,196,0
"2d2580c9411c4972909db508d6956a58","5bddb3d9ed264f3984702f048c7e5340",22857335,1,1,0,953,196,197,1
"5bddb3d9ed264f3984702f048c7e5340","5bddb3d9ed264f3984702f048c7e5340",22857335,2,0,1,954,197,197,0
"5bddb3d9ed264f3984702f048c7e5340","d5e8e2bd12a2466b9d6d90855f0eb079",22857335,1,1,0,956,197,198,1
"d5e8e2bd12a2466b9d6d90855f0eb079","d5e8e2bd12a2466b9d6d90855f0eb079",22857335,2,0,1,957,198,198,0
"d5e8e2bd12a2466b9d6d90855f0eb079","017d7ca8e0394b91aaadc9574df2202c",22857335,1,-5,0,959,198,193,-5
"017d7ca8e0394b91aaadc9574df2202c","54e8e9f0ea3e45c4bf3b8ac799ee31b1",22857335,1,8,0,960,193,200,7
"54e8e9f0ea3e45c4bf3b8ac799ee31b1","54e8e9f0ea3e45c4bf3b8ac799ee31b1",22857335,1,0,1,961,200,200,0
"54e8e9f0ea3e45c4bf3b8ac799ee31b1","c614a00911be4877a075f19315530fb0",22857335,1,1,0,962,200,201,1
"c614a00911be4877a075f19315530fb0","c614a00911be4877a075f19315530fb0",22857335,6,0,1,963,201,201,0
"c614a00911be4877a075f19315530fb0","a6c21bd8b95249c7972820a7a7d76aff",22857335,1,1,0,969,201,202,1
"a6c21bd8b95249c7972820a7a7d76aff","a6c21bd8b95249c7972820a7a7d76aff",22857335,1,0,1,970,202,202,0
"a6c21bd8b95249c7972820a7a7d76aff","bb329d880ab54120adaf203a693bb203",22857335,1,1,0,971,202,203,1
"bb329d880ab54120adaf203a693bb203","bb329d880ab54120adaf203a693bb203",22857335,1,0,1,972,203,203,0
"bb329d880ab54120adaf203a693bb203","f9170dd6bc6442b4acd832747609b09a",22857335,1,-4,0,973,203,199,-4
"f9170dd6bc6442b4acd832747609b09a","334c2344009840079b1d0e1b7ce3d5a7",22857335,1,7,0,974,199,205,6
"334c2344009840079b1d0e1b7ce3d5a7","334c2344009840079b1d0e1b7ce3d5a7",22857335,1,0,1,975,205,205,0
"334c2344009840079b1d0e1b7ce3d5a7","d7f13c8d63ec4e2aa673fbb9cf9c6933",22857335,1,3,0,976,205,206,1
"c8e371568a0c4391b25796ae4e91952e","b9e80f77c3a44349863b19875725c384",22857335,1,27,0,978,186,207,21
"7108f0e4c2584f1f9c471689ae4c885c","07b44a7a51e94c78b411c753fc39dab0",22857335,1,-24,0,980,208,189,-19
"f992451ed6ad4e68bb9e68ad6be7c4be","6cd2dcaac46847d4a0bc53f296d90375",22857335,1,3,0,987,192,194,2
"07b44a7a51e94c78b411c753fc39dab0","07b44a7a51e94c78b411c753fc39dab0",22857335,1,0,1,989,189,189,0
"6cd2dcaac46847d4a0bc53f296d90375","d7f13c8d63ec4e2aa673fbb9cf9c6933",22857335,1,16,0,995,194,206,12
"d7f13c8d63ec4e2aa673fbb9cf9c6933","d7f13c8d63ec4e2aa673fbb9cf9c6933",22857335,1,0,1,996,206,206,0
"b9e80f77c3a44349863b19875725c384","c8e371568a0c4391b25796ae4e91952e",22857335,1,-27,0,999,207,186,-21
"c8e371568a0c4391b25796ae4e91952e","d7f13c8d63ec4e2aa673fbb9cf9c6933",22857335,2,26,0,1000,186,206,20
"d7f13c8d63ec4e2aa673fbb9cf9c6933","c8e371568a0c4391b25796ae4e91952e",22857335,2,-26,0,1001,206,186,-20
"d7f13c8d63ec4e2aa673fbb9cf9c6933","7108f0e4c2584f1f9c471689ae4c885c",22857335,2,2,0,1003,206,208,2
"7108f0e4c2584f1f9c471689ae4c885c","b9e80f77c3a44349863b19875725c384",22857335,3,-1,0,1004,208,207,-1
"b9e80f77c3a44349863b19875725c384","b9e80f77c3a44349863b19875725c384",22857335,16,0,1,1005,207,207,0
"b9e80f77c3a44349863b19875725c384","7108f0e4c2584f1f9c471689ae4c885c",22857335,2,1,0,1021,207,208,1
"7108f0e4c2584f1f9c471689ae4c885c","7108f0e4c2584f1f9c471689ae4c885c",22857335,10,0,1,1022,208,208,0
"7108f0e4c2584f1f9c471689ae4c885c","d7f13c8d63ec4e2aa673fbb9cf9c6933",22857335,1,-2,0,1032,208,206,-2
"d7f13c8d63ec4e2aa673fbb9cf9c6933","09400e101c5d4b439cf9a26b03aae558",22857335,3,5,0,1033,206,210,4
"09400e101c5d4b439cf9a26b03aae558","d7f13c8d63ec4e2aa673fbb9cf9c6933",22857335,1,-5,0,1034,210,206,-4
"09400e101c5d4b439cf9a26b03aae558","7108f0e4c2584f1f9c471689ae4c885c",22857335,1,-3,0,1036,210,208,-2
"b9e80f77c3a44349863b19875725c384","a875096404ef4a9984b62d74cda916f9",22857335,1,3,0,1038,207,209,2
"a875096404ef4a9984b62d74cda916f9","d7f13c8d63ec4e2aa673fbb9cf9c6933",22857335,1,-4,0,1039,209,206,-3
"09400e101c5d4b439cf9a26b03aae558","09400e101c5d4b439cf9a26b03aae558",22857335,5,0,1,1041,210,210,0
"09400e101c5d4b439cf9a26b03aae558","a88efa7e50ce47159810ab553afa6d3a",22857335,1,2,0,1046,210,212,2
"a88efa7e50ce47159810ab553afa6d3a","a88efa7e50ce47159810ab553afa6d3a",22857335,2,0,1,1047,212,212,0
"a88efa7e50ce47159810ab553afa6d3a","f7fb1952f56b4189b86a9f8b7862d2b8",22857335,1,4,0,1049,212,215,3
"f7fb1952f56b4189b86a9f8b7862d2b8","be502a7a43c44bf7b682698de79d9369",22857335,1,-1,0,1050,215,214,-1
"be502a7a43c44bf7b682698de79d9369","a875096404ef4a9984b62d74cda916f9",22857335,1,-6,0,1051,214,209,-5
"a875096404ef4a9984b62d74cda916f9","be502a7a43c44bf7b682698de79d9369",22857335,1,6,0,1052,209,214,5
"be502a7a43c44bf7b682698de79d9369","be502a7a43c44bf7b682698de79d9369",22857335,1,0,1,1053,214,214,0
"be502a7a43c44bf7b682698de79d9369","f7fb1952f56b4189b86a9f8b7862d2b8",22857335,1,1,0,1054,214,215,1
"f7fb1952f56b4189b86a9f8b7862d2b8","f7fb1952f56b4189b86a9f8b7862d2b8",22857335,11,0,1,1055,215,215,0
"f7fb1952f56b4189b86a9f8b7862d2b8","b860ee85d8bc4a2f97958cfb71be3533",22857335,1,1,0,1066,215,216,1
"b860ee85d8bc4a2f97958cfb71be3533","b860ee85d8bc4a2f97958cfb71be3533",22857335,2,0,1,1067,216,216,0
"b860ee85d8bc4a2f97958cfb71be3533","ec341f459285443b8361f7f15638ff08",22857335,1,-3,0,1069,216,213,-3
"ec341f459285443b8361f7f15638ff08","363837c182e04711840d896ae1e0339c",22857335,1,6,0,1070,213,218,5
"363837c182e04711840d896ae1e0339c","363837c182e04711840d896ae1e0339c",22857335,13,0,1,1071,218,218,0
"363837c182e04711840d896ae1e0339c","01b2051f8941460d89945e3b02d1ce78",22857335,1,-1,0,1084,218,217,-1
"01b2051f8941460d89945e3b02d1ce78","91125ca626c5470eb145501f8c37f8db",22857335,1,4,0,1085,217,220,3
"91125ca626c5470eb145501f8c37f8db","91125ca626c5470eb145501f8c37f8db",22857335,1,0,1,1086,220,220,0
"91125ca626c5470eb145501f8c37f8db","1c6721b1f63f4d30ba7746ea8af02a52",22857335,1,3,0,1087,220,221,1
"1c6721b1f63f4d30ba7746ea8af02a52","d7f13c8d63ec4e2aa673fbb9cf9c6933",22857335,2,-21,0,1088,221,206,-15
"d7f13c8d63ec4e2aa673fbb9cf9c6933","77ecef8eff6b4a2caea7707669bf7475",22857335,2,22,0,1089,206,222,16
"77ecef8eff6b4a2caea7707669bf7475","0c7262dff33c4087bc660ccf40f92f9c",22857335,1,-71,0,1090,222,169,-53
"0c7262dff33c4087bc660ccf40f92f9c","c8e371568a0c4391b25796ae4e91952e",22857335,3,23,0,1091,169,186,17
"c8e371568a0c4391b25796ae4e91952e","07b44a7a51e94c78b411c753fc39dab0",22857335,1,4,0,1092,186,189,3
"07b44a7a51e94c78b411c753fc39dab0","ab11d94c6c8948ea90b88f19d2cd502b",22857335,1,1,0,1093,189,190,1
"ab11d94c6c8948ea90b88f19d2cd502b","0c7262dff33c4087bc660ccf40f92f9c",22857335,1,-28,0,1094,190,169,-21
"0c7262dff33c4087bc660ccf40f92f9c","d7f13c8d63ec4e2aa673fbb9cf9c6933",22857335,1,49,0,1095,169,206,37
"d7f13c8d63ec4e2aa673fbb9cf9c6933","be95c065e45447c1bd8215ea6f130c7a",22857335,1,17,0,1096,206,219,13
"be95c065e45447c1bd8215ea6f130c7a","d7f13c8d63ec4e2aa673fbb9cf9c6933",22857335,1,-17,0,1097,219,206,-13
"d7f13c8d63ec4e2aa673fbb9cf9c6933","1c6721b1f63f4d30ba7746ea8af02a52",22857335,1,21,0,1098,206,221,15
"77ecef8eff6b4a2caea7707669bf7475","0d987bed3ffa4ed0b9a2e62e97b7b30f",22857335,1,64,0,1101,222,272,50
"0d987bed3ffa4ed0b9a2e62e97b7b30f","bb5a47f5ea01454a8b79455422d3b9da",22857335,5,10,0,1102,272,280,8
"bb5a47f5ea01454a8b79455422d3b9da","bb5a47f5ea01454a8b79455422d3b9da",22857335,104,0,1,1103,280,280,0
"bb5a47f5ea01454a8b79455422d3b9da","1b4550d0dab04078b3bf08a655345bdc",22857335,1,126,0,1110,280,373,93
"1b4550d0dab04078b3bf08a655345bdc","b71bac264efb4abd97015447bd490db6",22857335,1,-4,0,1111,373,370,-3
"b71bac264efb4abd97015447bd490db6","8d448d625b024c82a5eb240bbd7431d6",22857335,6,5,0,1112,370,374,4
"8d448d625b024c82a5eb240bbd7431d6","8d448d625b024c82a5eb240bbd7431d6",22857335,70,0,1,1113,374,374,0
"8d448d625b024c82a5eb240bbd7431d6","f67fbf45a5f146ed866965bc57c7c001",22857335,1,127,0,1120,374,454,80
"f67fbf45a5f146ed866965bc57c7c001","f67fbf45a5f146ed866965bc57c7c001",22857335,3,0,1,1121,454,454,0
"f67fbf45a5f146ed866965bc57c7c001","b71bac264efb4abd97015447bd490db6",22857335,1,-132,0,1122,454,370,-84
"b71bac264efb4abd97015447bd490db6","b71bac264efb4abd97015447bd490db6",22857335,3,0,1,1123,370,370,0
"b71bac264efb4abd97015447bd490db6","30ead9794d4847abaf222ca966cc8630",22857335,1,-28,0,1125,370,348,-22
"30ead9794d4847abaf222ca966cc8630","b71bac264efb4abd97015447bd490db6",22857335,2,28,0,1126,348,370,22
"b71bac264efb4abd97015447bd490db6","4a29443515bb404cb8924e1c60a63b73",22857335,1,-110,0,1127,370,285,-85
"4a29443515bb404cb8924e1c60a63b73","c76574d21bc14aeea7ecd0b027f39858",22857335,1,105,0,1128,285,367,82
"c76574d21bc14aeea7ecd0b027f39858","30ead9794d4847abaf222ca966cc8630",22857335,1,-23,0,1129,367,348,-19
"30ead9794d4847abaf222ca966cc8630","4a29443515bb404cb8924e1c60a63b73",22857335,1,-82,0,1130,348,285,-63
"4a29443515bb404cb8924e1c60a63b73","07b44a7a51e94c78b411c753fc39dab0",22857335,1,-130,0,1131,285,189,-96
"07b44a7a51e94c78b411c753fc39dab0","c8e371568a0c4391b25796ae4e91952e",22857335,3,-4,0,1132,189,186,-3
"c8e371568a0c4391b25796ae4e91952e","ab11d94c6c8948ea90b88f19d2cd502b",22857335,4,5,0,1133,186,190,4
"ab11d94c6c8948ea90b88f19d2cd502b","f992451ed6ad4e68bb9e68ad6be7c4be",22857335,4,2,0,1134,190,192,2
"f992451ed6ad4e68bb9e68ad6be7c4be","ab11d94c6c8948ea90b88f19d2cd502b",22857335,1,-2,0,1135,192,190,-2
"ab11d94c6c8948ea90b88f19d2cd502b","6cd2dcaac46847d4a0bc53f296d90375",22857335,1,5,0,1136,190,194,4
"6cd2dcaac46847d4a0bc53f296d90375","07b44a7a51e94c78b411c753fc39dab0",22857335,2,-6,0,1137,194,189,-5
"07b44a7a51e94c78b411c753fc39dab0","1c6721b1f63f4d30ba7746ea8af02a52",22857335,1,43,0,1138,189,221,32
"1c6721b1f63f4d30ba7746ea8af02a52","1c6721b1f63f4d30ba7746ea8af02a52",22857335,1,0,1,1139,221,221,0
"1c6721b1f63f4d30ba7746ea8af02a52","77ecef8eff6b4a2caea7707669bf7475",22857335,1,1,0,1140,221,222,1
"77ecef8eff6b4a2caea7707669bf7475","77ecef8eff6b4a2caea7707669bf7475",22857335,14,0,1,1141,222,222,0
"77ecef8eff6b4a2caea7707669bf7475","1c6721b1f63f4d30ba7746ea8af02a52",22857335,1,-1,0,1155,222,221,-1
"1c6721b1f63f4d30ba7746ea8af02a52","d03cb855c70044cf8c35d9ec0de696e3",22857335,1,4,0,1156,221,224,3
"d03cb855c70044cf8c35d9ec0de696e3","8b9ae98743bd4d4a8a87dff1c1244211",22857335,1,3,0,1157,224,227,3
"8b9ae98743bd4d4a8a87dff1c1244211","d03cb855c70044cf8c35d9ec0de696e3",22857335,1,-3,0,1158,227,224,-3
"d03cb855c70044cf8c35d9ec0de696e3","a49a937d6896486d9a5396654abcf2e1",22857335,1,2,0,1159,224,226,2
"a49a937d6896486d9a5396654abcf2e1","a49a937d6896486d9a5396654abcf2e1",22857335,3,0,1,1160,226,226,0
"a49a937d6896486d9a5396654abcf2e1","8b9ae98743bd4d4a8a87dff1c1244211",22857335,1,1,0,1163,226,227,1
"8b9ae98743bd4d4a8a87dff1c1244211","8b9ae98743bd4d4a8a87dff1c1244211",22857335,17,0,1,1164,227,227,0
"8b9ae98743bd4d4a8a87dff1c1244211","f7906d6f59b9489a91d2ef40db5a474d",22857335,1,-4,0,1181,227,223,-4
"f7906d6f59b9489a91d2ef40db5a474d","2ab1535aac1346ba8801535bf729ef37",22857335,1,7,0,1182,223,229,6
"2ab1535aac1346ba8801535bf729ef37","2ab1535aac1346ba8801535bf729ef37",22857335,5,0,1,1183,229,229,0
"2ab1535aac1346ba8801535bf729ef37","a4f40fb48a8542c8949bae1f002cd9bc",22857335,1,2,0,1188,229,231,2
"a4f40fb48a8542c8949bae1f002cd9bc","a4f40fb48a8542c8949bae1f002cd9bc",22857335,2,0,1,1189,231,231,0
"a4f40fb48a8542c8949bae1f002cd9bc","8972c23e32044edb8a78fa1eed4e5947",22857335,1,1,0,1191,231,232,1
"8972c23e32044edb8a78fa1eed4e5947","8972c23e32044edb8a78fa1eed4e5947",22857335,5,0,1,1192,232,232,0
"8972c23e32044edb8a78fa1eed4e5947","92feb4a40f8344d38b6f722e42a53295",22857335,1,1,0,1197,232,233,1
"92feb4a40f8344d38b6f722e42a53295","92feb4a40f8344d38b6f722e42a53295",22857335,2,0,1,1198,233,233,0
"92feb4a40f8344d38b6f722e42a53295","5152833676bf4c6cb317060be10f68db",22857335,1,-5,0,1200,233,228,-5
"5152833676bf4c6cb317060be10f68db","5152833676bf4c6cb317060be10f68db",22857335,1,0,1,1201,228,228,0
"5152833676bf4c6cb317060be10f68db","1c6721b1f63f4d30ba7746ea8af02a52",22857335,1,-9,0,1202,228,221,-7
"1c6721b1f63f4d30ba7746ea8af02a52","2ab1535aac1346ba8801535bf729ef37",22857335,1,10,0,1203,221,229,8
"2ab1535aac1346ba8801535bf729ef37","5152833676bf4c6cb317060be10f68db",22857335,1,-1,0,1204,229,228,-1
"5152833676bf4c6cb317060be10f68db","ca3e28f290354c08aefe5b0f769604e6",22857335,1,8,0,1205,228,235,7
"ca3e28f290354c08aefe5b0f769604e6","ca3e28f290354c08aefe5b0f769604e6",22857335,4,0,1,1206,235,235,0
"ca3e28f290354c08aefe5b0f769604e6","79a35eea833e4c2c9d22fc53c3c6445c",22857335,1,1,0,1210,235,236,1
"79a35eea833e4c2c9d22fc53c3c6445c","79a35eea833e4c2c9d22fc53c3c6445c",22857335,9,0,1,1211,236,236,0
"79a35eea833e4c2c9d22fc53c3c6445c","8f68228b1518449e9615cdafee41a2bd",22857335,1,1,0,1220,236,237,1
"8f68228b1518449e9615cdafee41a2bd","8f68228b1518449e9615cdafee41a2bd",22857335,1,0,1,1221,237,237,0
"8f68228b1518449e9615cdafee41a2bd","cab89fa5c3ed45a5aa550fc0352d6a42",22857335,1,1,0,1222,237,238,1
"cab89fa5c3ed45a5aa550fc0352d6a42","cab89fa5c3ed45a5aa550fc0352d6a42",22857335,3,0,1,1223,238,238,0
"cab89fa5c3ed45a5aa550fc0352d6a42","66d4fad4f1cf4b46be0750a99ad7a35a",22857335,1,1,0,1226,238,239,1
"66d4fad4f1cf4b46be0750a99ad7a35a","66d4fad4f1cf4b46be0750a99ad7a35a",22857335,1,0,1,1227,239,239,0
"66d4fad4f1cf4b46be0750a99ad7a35a","0b04c8e2f86d48c7aeb7e225819cd32b",22857335,1,-5,0,1228,239,234,-5
"0b04c8e2f86d48c7aeb7e225819cd32b","f53da5fd9bfe412da4b80d4742563b6c",22857335,1,8,0,1229,234,241,7
"f53da5fd9bfe412da4b80d4742563b6c","f53da5fd9bfe412da4b80d4742563b6c",22857335,1,0,1,1230,241,241,0
"f53da5fd9bfe412da4b80d4742563b6c","1c6721b1f63f4d30ba7746ea8af02a52",22857335,1,-24,0,1231,241,221,-20
"1c6721b1f63f4d30ba7746ea8af02a52","2ae94c0cea4d480a9d5dca8fb1d7b542",22857335,3,27,0,1232,221,242,21
"2ae94c0cea4d480a9d5dca8fb1d7b542","1ebf23f9d994469a85206e4c7b1bf5f5",22857335,3,3,0,1233,242,245,3
"1ebf23f9d994469a85206e4c7b1bf5f5","1ebf23f9d994469a85206e4c7b1bf5f5",22857335,11,0,1,1234,245,245,0
"1ebf23f9d994469a85206e4c7b1bf5f5","85ae675b83e8422da842cfd25596af99",22857335,1,1,0,1245,245,246,1
"85ae675b83e8422da842cfd25596af99","85ae675b83e8422da842cfd25596af99",22857335,1,0,1,1246,246,246,0
"85ae675b83e8422da842cfd25596af99","2ae94c0cea4d480a9d5dca8fb1d7b542",22857335,1,-4,0,1247,246,242,-4
"2ae94c0cea4d480a9d5dca8fb1d7b542","30c9ba177afc49a695625d2bdec40207",22857335,1,9,0,1248,242,250,8
"30c9ba177afc49a695625d2bdec40207","30c9ba177afc49a695625d2bdec40207",22857335,2,0,1,1249,250,250,0
"30c9ba177afc49a695625d2bdec40207","00f61990949545828dd12f1303d47504",22857335,1,8,0,1251,250,256,6
"00f61990949545828dd12f1303d47504","6e83e23f56544a19b94067c1c558d9c0",22857335,2,-11,0,1252,256,247,-9
"6e83e23f56544a19b94067c1c558d9c0","00f61990949545828dd12f1303d47504",22857335,2,11,0,1253,247,256,9
"00f61990949545828dd12f1303d47504","ead7bb4b64e247d2ae632ab8a296b091",22857335,1,2,0,1254,256,258,2
"ead7bb4b64e247d2ae632ab8a296b091","ead7bb4b64e247d2ae632ab8a296b091",22857335,2,0,1,1255,258,258,0
"ead7bb4b64e247d2ae632ab8a296b091","41b0048dde734bb280bac6116baa8e27",22857335,1,1,0,1257,258,259,1
"41b0048dde734bb280bac6116baa8e27","41b0048dde734bb280bac6116baa8e27",22857335,2,0,1,1258,259,259,0
"41b0048dde734bb280bac6116baa8e27","b41c5a094a604ee0915327da5cc0beb7",22857335,1,1,0,1260,259,260,1
"b41c5a094a604ee0915327da5cc0beb7","b41c5a094a604ee0915327da5cc0beb7",22857335,2,0,1,1261,260,260,0
"b41c5a094a604ee0915327da5cc0beb7","d546341988904f069cfa86b21457d9d9",22857335,1,-10,0,1263,260,251,-9
"d546341988904f069cfa86b21457d9d9","28c171777c52431ab6b925073bd63d46",22857335,1,15,0,1264,251,264,13
"28c171777c52431ab6b925073bd63d46","28c171777c52431ab6b925073bd63d46",22857335,7,0,1,1265,264,264,0
"28c171777c52431ab6b925073bd63d46","ac160db940cb49ae8579162b1d52bb5d",22857335,1,2,0,1272,264,266,2
"ac160db940cb49ae8579162b1d52bb5d","ac160db940cb49ae8579162b1d52bb5d",22857335,3,0,1,1273,266,266,0
"ac160db940cb49ae8579162b1d52bb5d","d989ebcfc12a4b669f0100dc1aa14f1e",22857335,1,-12,0,1276,266,255,-11
"d989ebcfc12a4b669f0100dc1aa14f1e","c6fd49b485cc4874b0bbdd9c6171e09c",22857335,1,15,0,1277,255,268,13
"c6fd49b485cc4874b0bbdd9c6171e09c","c6fd49b485cc4874b0bbdd9c6171e09c",22857335,7,0,1,1278,268,268,0
"c6fd49b485cc4874b0bbdd9c6171e09c","44240778a97c4af0937817499b75707b",22857335,1,1,0,1285,268,269,1
"44240778a97c4af0937817499b75707b","44240778a97c4af0937817499b75707b",22857335,2,0,1,1286,269,269,0
"44240778a97c4af0937817499b75707b","7aa76d3e993840d8805f097cbdbcd44b",22857335,1,-9,0,1288,269,261,-8
"7aa76d3e993840d8805f097cbdbcd44b","7028800abe7d4e27b613d1d6cbe26bf7",22857335,1,7,0,1289,261,267,6
"7028800abe7d4e27b613d1d6cbe26bf7","00f61990949545828dd12f1303d47504",22857335,2,-13,0,1290,267,256,-11
"00f61990949545828dd12f1303d47504","7aa76d3e993840d8805f097cbdbcd44b",22857335,1,6,0,1291,256,261,5
"7aa76d3e993840d8805f097cbdbcd44b","d546341988904f069cfa86b21457d9d9",22857335,1,-12,0,1292,261,251,-10
"d546341988904f069cfa86b21457d9d9","d989ebcfc12a4b669f0100dc1aa14f1e",22857335,1,5,0,1293,251,255,4
"d989ebcfc12a4b669f0100dc1aa14f1e","7aa76d3e993840d8805f097cbdbcd44b",22857335,1,7,0,1294,255,261,6
"7aa76d3e993840d8805f097cbdbcd44b","d989ebcfc12a4b669f0100dc1aa14f1e",22857335,1,-7,0,1295,261,255,-6
"d989ebcfc12a4b669f0100dc1aa14f1e","7028800abe7d4e27b613d1d6cbe26bf7",22857335,1,14,0,1296,255,267,12
"7028800abe7d4e27b613d1d6cbe26bf7","2ae94c0cea4d480a9d5dca8fb1d7b542",22857335,1,-30,0,1297,267,242,-25
"2ae94c0cea4d480a9d5dca8fb1d7b542","6e83e23f56544a19b94067c1c558d9c0",22857335,2,6,0,1298,242,247,5
"6e83e23f56544a19b94067c1c558d9c0","6e83e23f56544a19b94067c1c558d9c0",22857335,1,0,1,1299,247,247,0
"6e83e23f56544a19b94067c1c558d9c0","1ebf23f9d994469a85206e4c7b1bf5f5",22857335,1,-3,0,1300,247,245,-2
"1ebf23f9d994469a85206e4c7b1bf5f5","2ae94c0cea4d480a9d5dca8fb1d7b542",22857335,5,-3,0,1301,245,242,-3
"2ae94c0cea4d480a9d5dca8fb1d7b542","1c6721b1f63f4d30ba7746ea8af02a52",22857335,2,-27,0,1302,242,221,-21
"1c6721b1f63f4d30ba7746ea8af02a52","64dbedb3ce544f6aae8e10e0cf10f16d",22857335,1,23,0,1303,221,240,19
"64dbedb3ce544f6aae8e10e0cf10f16d","0b04c8e2f86d48c7aeb7e225819cd32b",22857335,1,-7,0,1304,240,234,-6
"0b04c8e2f86d48c7aeb7e225819cd32b","1c6721b1f63f4d30ba7746ea8af02a52",22857335,1,-16,0,1305,234,221,-13
"2ae94c0cea4d480a9d5dca8fb1d7b542","7028800abe7d4e27b613d1d6cbe26bf7",22857335,3,30,0,1309,242,267,25
"7028800abe7d4e27b613d1d6cbe26bf7","7aa76d3e993840d8805f097cbdbcd44b",22857335,1,-7,0,1310,267,261,-6
"7aa76d3e993840d8805f097cbdbcd44b","1ebf23f9d994469a85206e4c7b1bf5f5",22857335,1,-20,0,1311,261,245,-16
"1ebf23f9d994469a85206e4c7b1bf5f5","7028800abe7d4e27b613d1d6cbe26bf7",22857335,1,27,0,1312,245,267,22
"7028800abe7d4e27b613d1d6cbe26bf7","1c6721b1f63f4d30ba7746ea8af02a52",22857335,1,-57,0,1313,267,221,-46
"1c6721b1f63f4d30ba7746ea8af02a52","1ebf23f9d994469a85206e4c7b1bf5f5",22857335,1,30,0,1316,221,245,24
"7028800abe7d4e27b613d1d6cbe26bf7","1ebf23f9d994469a85206e4c7b1bf5f5",22857335,1,-27,0,1319,267,245,-22
"2ae94c0cea4d480a9d5dca8fb1d7b542","865a4d3b43374da7944dc7d397f566d9",22857335,1,35,0,1321,242,271,29
"865a4d3b43374da7944dc7d397f566d9","865a4d3b43374da7944dc7d397f566d9",22857335,1,0,1,1322,271,271,0
"865a4d3b43374da7944dc7d397f566d9","2ae94c0cea4d480a9d5dca8fb1d7b542",22857335,1,-35,0,1323,271,242,-29
"2ae94c0cea4d480a9d5dca8fb1d7b542","0d987bed3ffa4ed0b9a2e62e97b7b30f",22857335,2,38,0,1324,242,272,30
"0d987bed3ffa4ed0b9a2e62e97b7b30f","0d987bed3ffa4ed0b9a2e62e97b7b30f",22857335,4,0,1,1325,272,272,0
"0d987bed3ffa4ed0b9a2e62e97b7b30f","82ae07bc0c9b4570a41799290d1ef399",22857335,2,4,0,1326,272,275,3
"82ae07bc0c9b4570a41799290d1ef399","bb5a47f5ea01454a8b79455422d3b9da",22857335,5,6,0,1327,275,280,5
"bb5a47f5ea01454a8b79455422d3b9da","2ae94c0cea4d480a9d5dca8fb1d7b542",22857335,1,-48,0,1335,280,242,-38
"6e83e23f56544a19b94067c1c558d9c0","2ae94c0cea4d480a9d5dca8fb1d7b542",22857335,1,-6,0,1339,247,242,-5
"82ae07bc0c9b4570a41799290d1ef399","0d987bed3ffa4ed0b9a2e62e97b7b30f",22857335,1,-4,0,1343,275,272,-3
"0d987bed3ffa4ed0b9a2e62e97b7b30f","2ae94c0cea4d480a9d5dca8fb1d7b542",22857335,1,-38,0,1344,272,242,-30
"00f61990949545828dd12f1303d47504","d546341988904f069cfa86b21457d9d9",22857335,1,-6,0,1347,256,251,-5
"d546341988904f069cfa86b21457d9d9","00f61990949545828dd12f1303d47504",22857335,1,6,0,1348,251,256,5
"00f61990949545828dd12f1303d47504","00f61990949545828dd12f1303d47504",22857335,2,0,1,1351,256,256,0
"00f61990949545828dd12f1303d47504","0d987bed3ffa4ed0b9a2e62e97b7b30f",22857335,1,21,0,1353,256,272,16
"bb5a47f5ea01454a8b79455422d3b9da","82ae07bc0c9b4570a41799290d1ef399",22857335,3,-6,0,1358,280,275,-5
"bb5a47f5ea01454a8b79455422d3b9da","bc5524e78a8544e2ae2fdc2f3462bbec",22857335,3,-1,0,1365,280,279,-1
"bc5524e78a8544e2ae2fdc2f3462bbec","82ae07bc0c9b4570a41799290d1ef399",22857335,1,-5,0,1366,279,275,-4
"bc5524e78a8544e2ae2fdc2f3462bbec","bb5a47f5ea01454a8b79455422d3b9da",22857335,1,1,0,1376,279,280,1
"bb5a47f5ea01454a8b79455422d3b9da","0d987bed3ffa4ed0b9a2e62e97b7b30f",22857335,2,-10,0,1387,280,272,-8
"bc5524e78a8544e2ae2fdc2f3462bbec","0d987bed3ffa4ed0b9a2e62e97b7b30f",22857335,1,-9,0,1414,279,272,-7
"0d987bed3ffa4ed0b9a2e62e97b7b30f","94cecc3f1e7d484b8e068e79241dfd73",22857335,1,13,0,1457,272,281,9
"94cecc3f1e7d484b8e068e79241dfd73","a37477c4e4c14169ad44b06b493007f6",22857335,1,2,0,1458,281,283,2
"a37477c4e4c14169ad44b06b493007f6","94cecc3f1e7d484b8e068e79241dfd73",22857335,2,-2,0,1459,283,281,-2
"94cecc3f1e7d484b8e068e79241dfd73","fab84b4fab5940efb4ea868ef8d09396",22857335,2,5,0,1460,281,284,3
"fab84b4fab5940efb4ea868ef8d09396","4a29443515bb404cb8924e1c60a63b73",22857335,4,4,0,1461,284,285,1
"4a29443515bb404cb8924e1c60a63b73","fab84b4fab5940efb4ea868ef8d09396",22857335,2,-4,0,1462,285,284,-1
"fab84b4fab5940efb4ea868ef8d09396","208c9b2796c944db8dacaa96082520ea",22857335,1,7,0,1463,284,288,4
"208c9b2796c944db8dacaa96082520ea","208c9b2796c944db8dacaa96082520ea",22857335,1,0,1,1464,288,288,0
"208c9b2796c944db8dacaa96082520ea","4a29443515bb404cb8924e1c60a63b73",22857335,4,-3,0,1465,288,285,-3
"4a29443515bb404cb8924e1c60a63b73","0d987bed3ffa4ed0b9a2e62e97b7b30f",22857335,1,-22,0,1466,285,272,-13
"bb5a47f5ea01454a8b79455422d3b9da","94cecc3f1e7d484b8e068e79241dfd73",22857335,1,3,0,1475,280,281,1
"94cecc3f1e7d484b8e068e79241dfd73","0d987bed3ffa4ed0b9a2e62e97b7b30f",22857335,1,-13,0,1476,281,272,-9
"0d987bed3ffa4ed0b9a2e62e97b7b30f","a37477c4e4c14169ad44b06b493007f6",22857335,1,15,0,1477,272,283,11
"94cecc3f1e7d484b8e068e79241dfd73","94cecc3f1e7d484b8e068e79241dfd73",22857335,1,0,1,1479,281,281,0
"fab84b4fab5940efb4ea868ef8d09396","fab84b4fab5940efb4ea868ef8d09396",22857335,1,0,1,1481,284,284,0
"4a29443515bb404cb8924e1c60a63b73","208c9b2796c944db8dacaa96082520ea",22857335,4,3,0,1483,285,288,3
"208c9b2796c944db8dacaa96082520ea","fab84b4fab5940efb4ea868ef8d09396",22857335,1,-7,0,1484,288,284,-4
"4a29443515bb404cb8924e1c60a63b73","4a29443515bb404cb8924e1c60a63b73",22857335,3,0,1,1490,285,285,0
"208c9b2796c944db8dacaa96082520ea","6a9a3b5bde4a48daa896fe8c06eca56f",22857335,1,2,0,1494,288,289,1
"6a9a3b5bde4a48daa896fe8c06eca56f","208c9b2796c944db8dacaa96082520ea",22857335,1,-2,0,1495,289,288,-1
"4a29443515bb404cb8924e1c60a63b73","7669a956527947d0add87455277e80b4",22857335,1,7,0,1497,285,291,6
"7669a956527947d0add87455277e80b4","7669a956527947d0add87455277e80b4",22857335,1,0,1,1498,291,291,0
"7669a956527947d0add87455277e80b4","6a9a3b5bde4a48daa896fe8c06eca56f",22857335,1,-2,0,1499,291,289,-2
"6a9a3b5bde4a48daa896fe8c06eca56f","869e967078f04da18dd0b0b9389a7424",22857335,1,5,0,1500,289,293,4
"869e967078f04da18dd0b0b9389a7424","869e967078f04da18dd0b0b9389a7424",22857335,3,0,1,1501,293,293,0
"869e967078f04da18dd0b0b9389a7424","51ab6291537748fab90d519aa09889d6",22857335,1,2,0,1504,293,295,2
"51ab6291537748fab90d519aa09889d6","51ab6291537748fab90d519aa09889d6",22857335,5,0,1,1505,295,295,0
"51ab6291537748fab90d519aa09889d6","34a6e49023fc4465bd5ca604330bbd1c",22857335,1,-3,0,1510,295,292,-3
"34a6e49023fc4465bd5ca604330bbd1c","ba0e59461bfb4a44b7b1c28a01f8d3b3",22857335,1,9,0,1511,292,299,7
"ba0e59461bfb4a44b7b1c28a01f8d3b3","21592f2a9e9c4b2f8c66ec5dbcbf6a2b",22857335,1,-4,0,1512,299,296,-3
"21592f2a9e9c4b2f8c66ec5dbcbf6a2b","ba0e59461bfb4a44b7b1c28a01f8d3b3",22857335,1,4,0,1513,296,299,3
"ba0e59461bfb4a44b7b1c28a01f8d3b3","ba0e59461bfb4a44b7b1c28a01f8d3b3",22857335,1,0,1,1514,299,299,0
"ba0e59461bfb4a44b7b1c28a01f8d3b3","0e0b36e731a645e7b1b8a88f5031ca38",22857335,1,2,0,1515,299,301,2
"0e0b36e731a645e7b1b8a88f5031ca38","0e0b36e731a645e7b1b8a88f5031ca38",22857335,5,0,1,1516,301,301,0
"0e0b36e731a645e7b1b8a88f5031ca38","a66a144637284c21afc6de17fea4bfb8",22857335,1,1,0,1521,301,302,1
"a66a144637284c21afc6de17fea4bfb8","a66a144637284c21afc6de17fea4bfb8",22857335,2,0,1,1522,302,302,0
"a66a144637284c21afc6de17fea4bfb8","7646a919d7e64fa990bca9b024ff089d",22857335,1,-4,0,1524,302,298,-4
"7646a919d7e64fa990bca9b024ff089d","e390b575229748ea8aac9364efe2bf00",22857335,1,7,0,1525,298,304,6
"e390b575229748ea8aac9364efe2bf00","e390b575229748ea8aac9364efe2bf00",22857335,1,0,1,1526,304,304,0
"e390b575229748ea8aac9364efe2bf00","3434c10e561d488a914e0f7d71907abd",22857335,1,3,0,1527,304,305,1
"3434c10e561d488a914e0f7d71907abd","4a29443515bb404cb8924e1c60a63b73",22857335,1,-27,0,1528,305,285,-20
"4a29443515bb404cb8924e1c60a63b73","53e7e900392747ccad52e711ab0f80d8",22857335,1,29,0,1529,285,307,22
"53e7e900392747ccad52e711ab0f80d8","3434c10e561d488a914e0f7d71907abd",22857335,3,-2,0,1530,307,305,-2
"3434c10e561d488a914e0f7d71907abd","3434c10e561d488a914e0f7d71907abd",22857335,2,0,1,1531,305,305,0
"3434c10e561d488a914e0f7d71907abd","53e7e900392747ccad52e711ab0f80d8",22857335,3,2,0,1532,305,307,2
"53e7e900392747ccad52e711ab0f80d8","53e7e900392747ccad52e711ab0f80d8",22857335,4,0,1,1533,307,307,0
"3434c10e561d488a914e0f7d71907abd","130acc2aeb0448fdbb2de63bc5cebe5b",22857335,1,5,0,1541,305,309,4
"130acc2aeb0448fdbb2de63bc5cebe5b","130acc2aeb0448fdbb2de63bc5cebe5b",22857335,1,0,1,1542,309,309,0
"130acc2aeb0448fdbb2de63bc5cebe5b","9c062b3251034ebe90f5054e2a3b5120",22857335,1,2,0,1543,309,311,2
"9c062b3251034ebe90f5054e2a3b5120","9c062b3251034ebe90f5054e2a3b5120",22857335,2,0,1,1544,311,311,0
"9c062b3251034ebe90f5054e2a3b5120","ea859f8207e44537889daeaba13ac2e8",22857335,1,1,0,1546,311,312,1
"ea859f8207e44537889daeaba13ac2e8","ea859f8207e44537889daeaba13ac2e8",22857335,1,0,1,1547,312,312,0
"ea859f8207e44537889daeaba13ac2e8","56d94971a7a94257aa330183a8ebd0ea",22857335,1,1,0,1548,312,313,1
"56d94971a7a94257aa330183a8ebd0ea","56d94971a7a94257aa330183a8ebd0ea",22857335,1,0,1,1549,313,313,0
"56d94971a7a94257aa330183a8ebd0ea","141c0df6cd1946539aadd1c9b7068cd4",22857335,1,-5,0,1550,313,308,-5
"141c0df6cd1946539aadd1c9b7068cd4","13255e63e0aa4abf85e5211bf613d43e",22857335,1,10,0,1551,308,317,9
"13255e63e0aa4abf85e5211bf613d43e","13255e63e0aa4abf85e5211bf613d43e",22857335,1,0,1,1552,317,317,0
"13255e63e0aa4abf85e5211bf613d43e","0c787d16c9504873b1a4d903cec09948",22857335,1,-3,0,1553,317,314,-3
"0c787d16c9504873b1a4d903cec09948","86c27d40179e419c8e9d150fb6afa5d0",22857335,1,6,0,1554,314,319,5
"86c27d40179e419c8e9d150fb6afa5d0","86c27d40179e419c8e9d150fb6afa5d0",22857335,1,0,1,1555,319,319,0
"86c27d40179e419c8e9d150fb6afa5d0","8d7e0b55cf9849cda222a0f2440cec55",22857335,1,-1,0,1556,319,318,-1
"8d7e0b55cf9849cda222a0f2440cec55","47edbb64109243e6b0f8f64cdef90c6c",22857335,1,9,0,1557,318,326,8
"47edbb64109243e6b0f8f64cdef90c6c","24f1363179ad4aaa965484a78471912b",22857335,1,-3,0,1558,326,323,-3
"24f1363179ad4aaa965484a78471912b","24f1363179ad4aaa965484a78471912b",22857335,5,0,1,1559,323,323,0
"24f1363179ad4aaa965484a78471912b","3434c10e561d488a914e0f7d71907abd",22857335,2,-22,0,1564,323,305,-18
"53e7e900392747ccad52e711ab0f80d8","24f1363179ad4aaa965484a78471912b",22857335,1,20,0,1566,307,323,16
"3434c10e561d488a914e0f7d71907abd","47edbb64109243e6b0f8f64cdef90c6c",22857335,1,25,0,1568,305,326,21
"47edbb64109243e6b0f8f64cdef90c6c","3628bdce1dd2429ba924d2d4d09448d2",22857335,1,-4,0,1569,326,322,-4
"3628bdce1dd2429ba924d2d4d09448d2","56b3fd1a212a4764be39d979fde3326e",22857335,1,7,0,1570,322,328,6
"56b3fd1a212a4764be39d979fde3326e","56b3fd1a212a4764be39d979fde3326e",22857335,1,0,1,1571,328,328,0
"56b3fd1a212a4764be39d979fde3326e","0c4079457ede49e3aeb5e86ed84bdf35",22857335,1,3,0,1572,328,329,1
"0c4079457ede49e3aeb5e86ed84bdf35","3434c10e561d488a914e0f7d71907abd",22857335,2,-31,0,1573,329,305,-24
"3434c10e561d488a914e0f7d71907abd","38aea304b4fa46e1b29bb72f5cea4c93",22857335,1,33,0,1574,305,331,26
"38aea304b4fa46e1b29bb72f5cea4c93","4a29443515bb404cb8924e1c60a63b73",22857335,1,-60,0,1575,331,285,-46
"4a29443515bb404cb8924e1c60a63b73","0c4079457ede49e3aeb5e86ed84bdf35",22857335,1,58,0,1576,285,329,44
"0c4079457ede49e3aeb5e86ed84bdf35","38aea304b4fa46e1b29bb72f5cea4c93",22857335,3,2,0,1577,329,331,2
"38aea304b4fa46e1b29bb72f5cea4c93","3434c10e561d488a914e0f7d71907abd",22857335,1,-33,0,1578,331,305,-26
"3434c10e561d488a914e0f7d71907abd","0c4079457ede49e3aeb5e86ed84bdf35",22857335,2,31,0,1579,305,329,24
"38aea304b4fa46e1b29bb72f5cea4c93","38aea304b4fa46e1b29bb72f5cea4c93",22857335,7,0,1,1583,331,331,0
"38aea304b4fa46e1b29bb72f5cea4c93","e36d261332f14e79bb4b467aceaeb9b5",22857335,1,2,0,1586,331,333,2
"e36d261332f14e79bb4b467aceaeb9b5","e36d261332f14e79bb4b467aceaeb9b5",22857335,1,0,1,1587,333,333,0
"e36d261332f14e79bb4b467aceaeb9b5","c7e89b9d04744d2eab742fc24e3ef1ae",22857335,1,1,0,1588,333,334,1
"c7e89b9d04744d2eab742fc24e3ef1ae","c7e89b9d04744d2eab742fc24e3ef1ae",22857335,2,0,1,1589,334,334,0
"c7e89b9d04744d2eab742fc24e3ef1ae","fe49f8054b374a0ea4bb266ed135ff62",22857335,1,1,0,1591,334,335,1
"fe49f8054b374a0ea4bb266ed135ff62","fe49f8054b374a0ea4bb266ed135ff62",22857335,2,0,1,1592,335,335,0
"fe49f8054b374a0ea4bb266ed135ff62","d0a8f74af98642fe8360d22c42e45117",22857335,1,1,0,1594,335,336,1
"d0a8f74af98642fe8360d22c42e45117","d0a8f74af98642fe8360d22c42e45117",22857335,2,0,1,1595,336,336,0
"d0a8f74af98642fe8360d22c42e45117","0c4079457ede49e3aeb5e86ed84bdf35",22857335,1,-7,0,1597,336,329,-7
"0c4079457ede49e3aeb5e86ed84bdf35","a7c6339ca1da4368a18d471f0519f877",22857335,1,11,0,1598,329,339,10
"a7c6339ca1da4368a18d471f0519f877","a7c6339ca1da4368a18d471f0519f877",22857335,1,0,1,1599,339,339,0
"a7c6339ca1da4368a18d471f0519f877","b8b9418ab322418d9db9b40d96af873a",22857335,1,-2,0,1600,339,337,-2
"b8b9418ab322418d9db9b40d96af873a","bbc5139ca9024389a94db3a6f47dcff6",22857335,2,5,0,1601,337,341,4
"bbc5139ca9024389a94db3a6f47dcff6","bbc5139ca9024389a94db3a6f47dcff6",22857335,2,0,1,1602,341,341,0
"bbc5139ca9024389a94db3a6f47dcff6","4ee6ca9019ab4a1ab323f98094a9bd77",22857335,1,2,0,1603,341,343,2
"4ee6ca9019ab4a1ab323f98094a9bd77","4ee6ca9019ab4a1ab323f98094a9bd77",22857335,2,0,1,1604,343,343,0
"4ee6ca9019ab4a1ab323f98094a9bd77","b37947176785476f8b29d49a851366dc",22857335,1,1,0,1606,343,344,1
"b37947176785476f8b29d49a851366dc","b37947176785476f8b29d49a851366dc",22857335,2,0,1,1607,344,344,0
"b37947176785476f8b29d49a851366dc","fcea5b10d5a14a3b9324ffece8f6e1e5",22857335,1,1,0,1609,344,345,1
"fcea5b10d5a14a3b9324ffece8f6e1e5","fcea5b10d5a14a3b9324ffece8f6e1e5",22857335,2,0,1,1610,345,345,0
"fcea5b10d5a14a3b9324ffece8f6e1e5","c2490bc612d146edbe786556fab3651b",22857335,1,-5,0,1612,345,340,-5
"c2490bc612d146edbe786556fab3651b","0c4079457ede49e3aeb5e86ed84bdf35",22857335,1,-13,0,1613,340,329,-11
"0c4079457ede49e3aeb5e86ed84bdf35","0c4079457ede49e3aeb5e86ed84bdf35",22857335,1,0,1,1614,329,329,0
"38aea304b4fa46e1b29bb72f5cea4c93","0c4079457ede49e3aeb5e86ed84bdf35",22857335,2,-2,0,1618,331,329,-2
"0c4079457ede49e3aeb5e86ed84bdf35","b8b9418ab322418d9db9b40d96af873a",22857335,1,9,0,1619,329,337,8
"bbc5139ca9024389a94db3a6f47dcff6","c2490bc612d146edbe786556fab3651b",22857335,3,-1,0,1621,341,340,-1
"c2490bc612d146edbe786556fab3651b","4a92daef4d504e1792575a26502bb7b7",22857335,2,7,0,1622,340,346,6
"4a92daef4d504e1792575a26502bb7b7","bbc5139ca9024389a94db3a6f47dcff6",22857335,2,-6,0,1623,346,341,-5
"c2490bc612d146edbe786556fab3651b","6ac8bb048b854999a47edb35fe627f11",22857335,1,8,0,1626,340,347,7
"6ac8bb048b854999a47edb35fe627f11","4a92daef4d504e1792575a26502bb7b7",22857335,1,-1,0,1627,347,346,-1
"4a92daef4d504e1792575a26502bb7b7","b8b9418ab322418d9db9b40d96af873a",22857335,1,-11,0,1631,346,337,-9
"b8b9418ab322418d9db9b40d96af873a","38aea304b4fa46e1b29bb72f5cea4c93",22857335,1,-7,0,1632,337,331,-6
"0c4079457ede49e3aeb5e86ed84bdf35","6ac8bb048b854999a47edb35fe627f11",22857335,1,21,0,1636,329,347,18
"6ac8bb048b854999a47edb35fe627f11","6ac8bb048b854999a47edb35fe627f11",22857335,1,0,1,1637,347,347,0
"6ac8bb048b854999a47edb35fe627f11","0c4079457ede49e3aeb5e86ed84bdf35",22857335,1,-21,0,1638,347,329,-18
"0c4079457ede49e3aeb5e86ed84bdf35","30ead9794d4847abaf222ca966cc8630",22857335,3,24,0,1639,329,348,19
"30ead9794d4847abaf222ca966cc8630","897b7f51242c44aab2205c72fdcbf4cd",22857335,1,4,0,1640,348,352,4
"897b7f51242c44aab2205c72fdcbf4cd","c20993c944444fe085345591a8bd837e",22857335,1,-1,0,1641,352,351,-1
"c20993c944444fe085345591a8bd837e","09b9678ddc3d452ea4a3d46e15826065",22857335,1,2,0,1642,351,353,2
"09b9678ddc3d452ea4a3d46e15826065","eff0de7f2dbb42dfa1a2e686efab5b6d",22857335,4,1,0,1643,353,354,1
"eff0de7f2dbb42dfa1a2e686efab5b6d","4a29443515bb404cb8924e1c60a63b73",22857335,1,-88,0,1644,354,285,-69
"4a29443515bb404cb8924e1c60a63b73","30ead9794d4847abaf222ca966cc8630",22857335,1,82,0,1646,285,348,63
"30ead9794d4847abaf222ca966cc8630","c20993c944444fe085345591a8bd837e",22857335,2,3,0,1647,348,351,3
"c20993c944444fe085345591a8bd837e","897b7f51242c44aab2205c72fdcbf4cd",22857335,5,1,0,1648,351,352,1
"897b7f51242c44aab2205c72fdcbf4cd","09b9678ddc3d452ea4a3d46e15826065",22857335,4,1,0,1649,352,353,1
"eff0de7f2dbb42dfa1a2e686efab5b6d","30ead9794d4847abaf222ca966cc8630",22857335,3,-6,0,1651,354,348,-6
"30ead9794d4847abaf222ca966cc8630","09b9678ddc3d452ea4a3d46e15826065",22857335,1,5,0,1652,348,353,5
"09b9678ddc3d452ea4a3d46e15826065","c20993c944444fe085345591a8bd837e",22857335,2,-2,0,1653,353,351,-2
"c20993c944444fe085345591a8bd837e","eff0de7f2dbb42dfa1a2e686efab5b6d",22857335,1,3,0,1654,351,354,3
"eff0de7f2dbb42dfa1a2e686efab5b6d","897b7f51242c44aab2205c72fdcbf4cd",22857335,1,-2,0,1655,354,352,-2
"897b7f51242c44aab2205c72fdcbf4cd","0c4079457ede49e3aeb5e86ed84bdf35",22857335,1,-28,0,1656,352,329,-23
"30ead9794d4847abaf222ca966cc8630","0c4079457ede49e3aeb5e86ed84bdf35",22857335,1,-24,0,1658,348,329,-19
"eff0de7f2dbb42dfa1a2e686efab5b6d","c20993c944444fe085345591a8bd837e",22857335,1,-3,0,1664,354,351,-3
"c20993c944444fe085345591a8bd837e","c20993c944444fe085345591a8bd837e",22857335,4,0,1,1665,351,351,0
"897b7f51242c44aab2205c72fdcbf4cd","897b7f51242c44aab2205c72fdcbf4cd",22857335,4,0,1,1669,352,352,0
"09b9678ddc3d452ea4a3d46e15826065","09b9678ddc3d452ea4a3d46e15826065",22857335,4,0,1,1673,353,353,0
"eff0de7f2dbb42dfa1a2e686efab5b6d","eff0de7f2dbb42dfa1a2e686efab5b6d",22857335,5,0,1,1677,354,354,0
"30ead9794d4847abaf222ca966cc8630","2fe14166dc9642c3bc666b86a57f943d",22857335,2,10,0,1681,348,357,9
"2fe14166dc9642c3bc666b86a57f943d","2fe14166dc9642c3bc666b86a57f943d",22857335,4,0,1,1682,357,357,0
"2fe14166dc9642c3bc666b86a57f943d","44421dd1e13a47a388c4a19834b744c7",22857335,1,2,0,1686,357,359,2
"44421dd1e13a47a388c4a19834b744c7","44421dd1e13a47a388c4a19834b744c7",22857335,2,0,1,1687,359,359,0
"44421dd1e13a47a388c4a19834b744c7","cb5fc7ef85d547c4be1a7439d0bf6052",22857335,1,1,0,1689,359,360,1
"cb5fc7ef85d547c4be1a7439d0bf6052","cb5fc7ef85d547c4be1a7439d0bf6052",22857335,2,0,1,1690,360,360,0
"cb5fc7ef85d547c4be1a7439d0bf6052","0a8f150a4cf747acbde62f4721823da3",22857335,1,1,0,1692,360,361,1
"0a8f150a4cf747acbde62f4721823da3","0a8f150a4cf747acbde62f4721823da3",22857335,2,0,1,1693,361,361,0
"0a8f150a4cf747acbde62f4721823da3","ab8fdad974ae471f9f24c3f9dd04462e",22857335,1,1,0,1695,361,362,1
"ab8fdad974ae471f9f24c3f9dd04462e","ab8fdad974ae471f9f24c3f9dd04462e",22857335,2,0,1,1696,362,362,0
"ab8fdad974ae471f9f24c3f9dd04462e","1ba8fef685d74a8194b9db252eb704fb",22857335,1,-7,0,1698,362,355,-7
"1ba8fef685d74a8194b9db252eb704fb","52580888dadb4fe3baa795683ea227bd",22857335,1,10,0,1699,355,364,9
"52580888dadb4fe3baa795683ea227bd","52580888dadb4fe3baa795683ea227bd",22857335,1,0,1,1700,364,364,0
"52580888dadb4fe3baa795683ea227bd","492a3bc6a1254f23a7998587961b22a4",22857335,1,3,0,1701,364,366,2
"492a3bc6a1254f23a7998587961b22a4","f00179e251a045b39c3f7a54f9aa4acc",22857335,1,-4,0,1702,366,363,-3
"f00179e251a045b39c3f7a54f9aa4acc","492a3bc6a1254f23a7998587961b22a4",22857335,1,4,0,1703,363,366,3
"492a3bc6a1254f23a7998587961b22a4","072a190fd302456290895f9f04d6940a",22857335,1,-1,0,1704,366,365,-1
"072a190fd302456290895f9f04d6940a","c20993c944444fe085345591a8bd837e",22857335,1,-17,0,1705,365,351,-14
"09b9678ddc3d452ea4a3d46e15826065","c76574d21bc14aeea7ecd0b027f39858",22857335,1,18,0,1709,353,367,14
"c76574d21bc14aeea7ecd0b027f39858","09b9678ddc3d452ea4a3d46e15826065",22857335,1,-18,0,1710,367,353,-14
"897b7f51242c44aab2205c72fdcbf4cd","eff0de7f2dbb42dfa1a2e686efab5b6d",22857335,1,2,0,1715,352,354,2
"2fe14166dc9642c3bc666b86a57f943d","1ba8fef685d74a8194b9db252eb704fb",22857335,1,-2,0,1720,357,355,-2
"1ba8fef685d74a8194b9db252eb704fb","c76574d21bc14aeea7ecd0b027f39858",22857335,1,15,0,1721,355,367,12
"c76574d21bc14aeea7ecd0b027f39858","52580888dadb4fe3baa795683ea227bd",22857335,1,-5,0,1722,367,364,-3
"52580888dadb4fe3baa795683ea227bd","f00179e251a045b39c3f7a54f9aa4acc",22857335,1,-1,0,1723,364,363,-1
"f00179e251a045b39c3f7a54f9aa4acc","cfa457d1743848e4bb5e4beced6448ed",22857335,1,8,0,1724,363,369,6
"cfa457d1743848e4bb5e4beced6448ed","cfa457d1743848e4bb5e4beced6448ed",22857335,2,0,1,1725,369,369,0
"cfa457d1743848e4bb5e4beced6448ed","30ead9794d4847abaf222ca966cc8630",22857335,1,-25,0,1727,369,348,-21
"8d448d625b024c82a5eb240bbd7431d6","b71bac264efb4abd97015447bd490db6",22857335,3,-5,0,1735,374,370,-4
"8d448d625b024c82a5eb240bbd7431d6","d6d02b6ef04e4f17805504500b8ce441",22857335,2,3,0,1738,374,375,1
"d6d02b6ef04e4f17805504500b8ce441","b71bac264efb4abd97015447bd490db6",22857335,2,-8,0,1739,375,370,-5
"b71bac264efb4abd97015447bd490db6","d6d02b6ef04e4f17805504500b8ce441",22857335,2,8,0,1740,370,375,5
"d6d02b6ef04e4f17805504500b8ce441","4a29443515bb404cb8924e1c60a63b73",22857335,1,-118,0,1741,375,285,-90
"4a29443515bb404cb8924e1c60a63b73","66baf19b6b904b70922329068c63746d",22857335,1,122,0,1742,285,376,91
"66baf19b6b904b70922329068c63746d","66baf19b6b904b70922329068c63746d",22857335,1,0,1,1743,376,376,0
"66baf19b6b904b70922329068c63746d","7f544639412e40a9ba27f43b415362ab",22857335,1,2,0,1744,376,378,2
"7f544639412e40a9ba27f43b415362ab","7f544639412e40a9ba27f43b415362ab",22857335,4,0,1,1745,378,378,0
"7f544639412e40a9ba27f43b415362ab","d5ae8642e15b46b8bd298b02274d4e9c",22857335,1,2,0,1749,378,380,2
"d5ae8642e15b46b8bd298b02274d4e9c","d5ae8642e15b46b8bd298b02274d4e9c",22857335,1,0,1,1750,380,380,0
"d5ae8642e15b46b8bd298b02274d4e9c","a0d10309a2dd456289147f84be9d37f9",22857335,1,1,0,1751,380,381,1
"a0d10309a2dd456289147f84be9d37f9","a0d10309a2dd456289147f84be9d37f9",22857335,2,0,1,1752,381,381,0
"a0d10309a2dd456289147f84be9d37f9","0fcbc3ca07b144138b8d85da581f09a8",22857335,1,1,0,1754,381,382,1
"0fcbc3ca07b144138b8d85da581f09a8","0fcbc3ca07b144138b8d85da581f09a8",22857335,2,0,1,1755,382,382,0
"0fcbc3ca07b144138b8d85da581f09a8","66baf19b6b904b70922329068c63746d",22857335,1,-6,0,1757,382,376,-6
"66baf19b6b904b70922329068c63746d","c2fca3669923477ab966ded303dea31c",22857335,1,8,0,1758,376,383,7
"c2fca3669923477ab966ded303dea31c","4890121ce5d74576b4632b77cfc23398",22857335,1,6,0,1759,383,388,5
"4890121ce5d74576b4632b77cfc23398","4890121ce5d74576b4632b77cfc23398",22857335,1,0,1,1760,388,388,0
"4890121ce5d74576b4632b77cfc23398","18d3b836dd804224883cc9180b60a8e1",22857335,2,-1,0,1761,388,387,-1
"18d3b836dd804224883cc9180b60a8e1","96bb2b3e85a34d8b9544514e89f6fe97",22857335,2,4,0,1762,387,390,3
"96bb2b3e85a34d8b9544514e89f6fe97","96bb2b3e85a34d8b9544514e89f6fe97",22857335,3,0,1,1763,390,390,0
"96bb2b3e85a34d8b9544514e89f6fe97","17f95d18bab743888e1736033dc3384d",22857335,1,-1,0,1766,390,389,-1
"17f95d18bab743888e1736033dc3384d","7f544639412e40a9ba27f43b415362ab",22857335,1,-14,0,1767,389,378,-11
"7f544639412e40a9ba27f43b415362ab","66baf19b6b904b70922329068c63746d",22857335,1,-2,0,1768,378,376,-2
"66baf19b6b904b70922329068c63746d","96bb2b3e85a34d8b9544514e89f6fe97",22857335,1,17,0,1769,376,390,14
"96bb2b3e85a34d8b9544514e89f6fe97","ac4e9b54acfe4670b4634859c7263cb5",22857335,1,2,0,1770,390,392,2
"ac4e9b54acfe4670b4634859c7263cb5","ac4e9b54acfe4670b4634859c7263cb5",22857335,1,0,1,1771,392,392,0
"ac4e9b54acfe4670b4634859c7263cb5","6f8881a745ac4c358a68b92c3b4abe81",22857335,1,3,0,1772,392,394,2
"6f8881a745ac4c358a68b92c3b4abe81","17f95d18bab743888e1736033dc3384d",22857335,2,-6,0,1773,394,389,-5
"17f95d18bab743888e1736033dc3384d","6f8881a745ac4c358a68b92c3b4abe81",22857335,1,6,0,1774,389,394,5
"6f8881a745ac4c358a68b92c3b4abe81","6f8881a745ac4c358a68b92c3b4abe81",22857335,7,0,1,1775,394,394,0
"6f8881a745ac4c358a68b92c3b4abe81","f7002c8484354eceac57bc7bd62c76c1",22857335,3,-1,0,1777,394,393,-1
"f7002c8484354eceac57bc7bd62c76c1","30ead9794d4847abaf222ca966cc8630",22857335,1,-61,0,1778,393,348,-45
"30ead9794d4847abaf222ca966cc8630","c76574d21bc14aeea7ecd0b027f39858",22857335,2,23,0,1779,348,367,19
"c76574d21bc14aeea7ecd0b027f39858","f7002c8484354eceac57bc7bd62c76c1",22857335,1,38,0,1780,367,393,26
"f7002c8484354eceac57bc7bd62c76c1","66baf19b6b904b70922329068c63746d",22857335,3,-21,0,1781,393,376,-17
"66baf19b6b904b70922329068c63746d","6f8881a745ac4c358a68b92c3b4abe81",22857335,4,22,0,1782,376,394,18
"f7002c8484354eceac57bc7bd62c76c1","0c12af0a4e7f4002852cf84b2537c161",22857335,1,3,0,1786,393,395,2
"0c12af0a4e7f4002852cf84b2537c161","4890121ce5d74576b4632b77cfc23398",22857335,1,-10,0,1787,395,388,-7
"96bb2b3e85a34d8b9544514e89f6fe97","6f8881a745ac4c358a68b92c3b4abe81",22857335,1,5,0,1790,390,394,4
"17f95d18bab743888e1736033dc3384d","f7002c8484354eceac57bc7bd62c76c1",22857335,1,5,0,1792,389,393,4
"f7002c8484354eceac57bc7bd62c76c1","44a277ea44dc4ae689fab4b82f0b4098",22857335,1,5,0,1793,393,397,4
"44a277ea44dc4ae689fab4b82f0b4098","44a277ea44dc4ae689fab4b82f0b4098",22857335,1,0,1,1794,397,397,0
"44a277ea44dc4ae689fab4b82f0b4098","0c12af0a4e7f4002852cf84b2537c161",22857335,1,-2,0,1795,397,395,-2
"0c12af0a4e7f4002852cf84b2537c161","859e0b8d71694b12befb69ee698138f9",22857335,1,5,0,1796,395,399,4
"859e0b8d71694b12befb69ee698138f9","859e0b8d71694b12befb69ee698138f9",22857335,2,0,1,1797,399,399,0
"859e0b8d71694b12befb69ee698138f9","2b09a08242b54983aec7063990fb3f66",22857335,1,3,0,1799,399,400,1
"2b09a08242b54983aec7063990fb3f66","66baf19b6b904b70922329068c63746d",22857335,1,-32,0,1800,400,376,-24
"66baf19b6b904b70922329068c63746d","2b09a08242b54983aec7063990fb3f66",22857335,1,32,0,1801,376,400,24
"2b09a08242b54983aec7063990fb3f66","2b09a08242b54983aec7063990fb3f66",22857335,8,0,1,1802,400,400,0
"2b09a08242b54983aec7063990fb3f66","1f471b7a883a4df48211e8c6a81b59a7",22857335,1,1,0,1809,400,401,1
"1f471b7a883a4df48211e8c6a81b59a7","1f471b7a883a4df48211e8c6a81b59a7",22857335,1,0,1,1810,401,401,0
"1f471b7a883a4df48211e8c6a81b59a7","2b09a08242b54983aec7063990fb3f66",22857335,1,-1,0,1811,401,400,-1
"2b09a08242b54983aec7063990fb3f66","1157bd665ec4472fb58b751dc5099355",22857335,1,4,0,1812,400,403,3
"1157bd665ec4472fb58b751dc5099355","2b09a08242b54983aec7063990fb3f66",22857335,1,-4,0,1813,403,400,-3
"2b09a08242b54983aec7063990fb3f66","9de0d567bfa84fe5b77cb76f4a76a5d1",22857335,1,5,0,1815,400,404,4
"9de0d567bfa84fe5b77cb76f4a76a5d1","9de0d567bfa84fe5b77cb76f4a76a5d1",22857335,1,0,1,1816,404,404,0
"9de0d567bfa84fe5b77cb76f4a76a5d1","1157bd665ec4472fb58b751dc5099355",22857335,1,-1,0,1817,404,403,-1
"1157bd665ec4472fb58b751dc5099355","3c8a22d2f9c146ea956609e3ed4f2559",22857335,1,3,0,1818,403,405,2
"3c8a22d2f9c146ea956609e3ed4f2559","58fc9094275e4c49be3f4ba6d4acc0a4",22857335,1,2,0,1819,405,406,1
"58fc9094275e4c49be3f4ba6d4acc0a4","58fc9094275e4c49be3f4ba6d4acc0a4",22857335,1,0,1,1820,406,406,0
"58fc9094275e4c49be3f4ba6d4acc0a4","c1c1be90b2b14c1ab4a5e1ee3c241902",22857335,1,1,0,1821,406,407,1
"c1c1be90b2b14c1ab4a5e1ee3c241902","c1c1be90b2b14c1ab4a5e1ee3c241902",22857335,5,0,1,1822,407,407,0
"c1c1be90b2b14c1ab4a5e1ee3c241902","02b3a1bead9244c1ba2f857c7da8f82a",22857335,1,2,0,1827,407,408,1
"02b3a1bead9244c1ba2f857c7da8f82a","58fc9094275e4c49be3f4ba6d4acc0a4",22857335,1,-3,0,1828,408,406,-2
"58fc9094275e4c49be3f4ba6d4acc0a4","02b3a1bead9244c1ba2f857c7da8f82a",22857335,1,3,0,1829,406,408,2
"02b3a1bead9244c1ba2f857c7da8f82a","6206fc6479014bb193084c32409dc1b9",22857335,1,1,0,1830,408,409,1
"6206fc6479014bb193084c32409dc1b9","6206fc6479014bb193084c32409dc1b9",22857335,4,0,1,1831,409,409,0
"6206fc6479014bb193084c32409dc1b9","02b3a1bead9244c1ba2f857c7da8f82a",22857335,1,-1,0,1835,409,408,-1
"02b3a1bead9244c1ba2f857c7da8f82a","6a5f020451db426dacba9e2ea3fcc62a",22857335,1,3,0,1836,408,410,2
"6a5f020451db426dacba9e2ea3fcc62a","6a5f020451db426dacba9e2ea3fcc62a",22857335,4,0,1,1837,410,410,0
"6a5f020451db426dacba9e2ea3fcc62a","33a9d248b2e44588a5b07fc1342b9bc2",22857335,1,2,0,1841,410,411,1
"33a9d248b2e44588a5b07fc1342b9bc2","33a9d248b2e44588a5b07fc1342b9bc2",22857335,6,0,1,1842,411,411,0
"33a9d248b2e44588a5b07fc1342b9bc2","c6f26bd420634f1cb7989e76fe6b16c0",22857335,1,1,0,1847,411,412,1
"c6f26bd420634f1cb7989e76fe6b16c0","c6f26bd420634f1cb7989e76fe6b16c0",22857335,5,0,1,1848,412,412,0
"c6f26bd420634f1cb7989e76fe6b16c0","2a65ee6e2ac64f6a8a55fbe5373ec763",22857335,1,1,0,1853,412,413,1
"2a65ee6e2ac64f6a8a55fbe5373ec763","2a65ee6e2ac64f6a8a55fbe5373ec763",22857335,2,0,1,1854,413,413,0
"2a65ee6e2ac64f6a8a55fbe5373ec763","33a9d248b2e44588a5b07fc1342b9bc2",22857335,1,-2,0,1856,413,411,-2
"33a9d248b2e44588a5b07fc1342b9bc2","1fd0f6dadbc14ebc965faf6122190b96",22857335,2,5,0,1857,411,415,4
"1fd0f6dadbc14ebc965faf6122190b96","1fd0f6dadbc14ebc965faf6122190b96",22857335,3,0,1,1858,415,415,0
"1fd0f6dadbc14ebc965faf6122190b96","687055dad9fc40c3982478fe33ec01bf",22857335,3,-1,0,1859,415,414,-1
"687055dad9fc40c3982478fe33ec01bf","2add1669f08d4101913db15f8c23b3b7",22857335,2,3,0,1860,414,416,2
"2add1669f08d4101913db15f8c23b3b7","33a9d248b2e44588a5b07fc1342b9bc2",22857335,1,-7,0,1861,416,411,-5
"687055dad9fc40c3982478fe33ec01bf","66baf19b6b904b70922329068c63746d",22857335,1,-53,0,1865,414,376,-38
"66baf19b6b904b70922329068c63746d","687055dad9fc40c3982478fe33ec01bf",22857335,1,53,0,1866,376,414,38
"687055dad9fc40c3982478fe33ec01bf","2b09a08242b54983aec7063990fb3f66",22857335,2,-21,0,1867,414,400,-14
"2b09a08242b54983aec7063990fb3f66","687055dad9fc40c3982478fe33ec01bf",22857335,1,21,0,1868,400,414,14
"2add1669f08d4101913db15f8c23b3b7","2add1669f08d4101913db15f8c23b3b7",22857335,1,0,1,1870,416,416,0
"2add1669f08d4101913db15f8c23b3b7","a2b4bd40cee2481ebd3fc179d6a5cd62",22857335,1,3,0,1871,416,417,1
"a2b4bd40cee2481ebd3fc179d6a5cd62","2b09a08242b54983aec7063990fb3f66",22857335,3,-27,0,1872,417,400,-17
"2b09a08242b54983aec7063990fb3f66","f67fbf45a5f146ed866965bc57c7c001",22857335,1,88,0,1873,400,454,54
"f67fbf45a5f146ed866965bc57c7c001","f7002c8484354eceac57bc7bd62c76c1",22857335,1,-99,0,1874,454,393,-61
"f7002c8484354eceac57bc7bd62c76c1","a2b4bd40cee2481ebd3fc179d6a5cd62",22857335,1,38,0,1881,393,417,24
"a2b4bd40cee2481ebd3fc179d6a5cd62","a2b4bd40cee2481ebd3fc179d6a5cd62",22857335,3,0,1,1882,417,417,0
"a2b4bd40cee2481ebd3fc179d6a5cd62","2add1669f08d4101913db15f8c23b3b7",22857335,1,-3,0,1883,417,416,-1
"2add1669f08d4101913db15f8c23b3b7","2b09a08242b54983aec7063990fb3f66",22857335,1,-24,0,1884,416,400,-16
"2b09a08242b54983aec7063990fb3f66","a2b4bd40cee2481ebd3fc179d6a5cd62",22857335,1,27,0,1885,400,417,17
"2b09a08242b54983aec7063990fb3f66","e34e59dce2204f228f3a84b6725df60f",22857335,1,29,0,1887,400,419,19
"e34e59dce2204f228f3a84b6725df60f","e34e59dce2204f228f3a84b6725df60f",22857335,1,0,1,1888,419,419,0
"e34e59dce2204f228f3a84b6725df60f","bec48fc2e1294c7eb3d0aca780d731b8",22857335,1,2,0,1889,419,420,1
"bec48fc2e1294c7eb3d0aca780d731b8","a2b4bd40cee2481ebd3fc179d6a5cd62",22857335,4,-4,0,1890,420,417,-3
"a2b4bd40cee2481ebd3fc179d6a5cd62","bec48fc2e1294c7eb3d0aca780d731b8",22857335,5,4,0,1893,417,420,3
"bec48fc2e1294c7eb3d0aca780d731b8","bec48fc2e1294c7eb3d0aca780d731b8",22857335,3,0,1,1896,420,420,0
"bec48fc2e1294c7eb3d0aca780d731b8","a24600b0e49245f6bdba8c893cfeddb0",22857335,1,7,0,1898,420,425,5
"a24600b0e49245f6bdba8c893cfeddb0","dbde19fcce2a4c1abdc7f685c293a23f",22857335,1,-4,0,1899,425,422,-3
"dbde19fcce2a4c1abdc7f685c293a23f","a24600b0e49245f6bdba8c893cfeddb0",22857335,2,4,0,1900,422,425,3
"a24600b0e49245f6bdba8c893cfeddb0","a24600b0e49245f6bdba8c893cfeddb0",22857335,7,0,1,1901,425,425,0
"a24600b0e49245f6bdba8c893cfeddb0","24cf8786024543f19b89bc20034e60d7",22857335,1,7,0,1907,425,428,3
"24cf8786024543f19b89bc20034e60d7","a2b4bd40cee2481ebd3fc179d6a5cd62",22857335,1,-18,0,1908,428,417,-11
"a2b4bd40cee2481ebd3fc179d6a5cd62","f2a73be2f46840b182d7bd095378004e",22857335,1,19,0,1909,417,429,12
"f2a73be2f46840b182d7bd095378004e","a2b4bd40cee2481ebd3fc179d6a5cd62",22857335,1,-19,0,1910,429,417,-12
"bec48fc2e1294c7eb3d0aca780d731b8","dbde19fcce2a4c1abdc7f685c293a23f",22857335,1,3,0,1917,420,422,2
"a24600b0e49245f6bdba8c893cfeddb0","a2b4bd40cee2481ebd3fc179d6a5cd62",22857335,1,-11,0,1920,425,417,-8
"a2b4bd40cee2481ebd3fc179d6a5cd62","24cf8786024543f19b89bc20034e60d7",22857335,1,18,0,1921,417,428,11
"24cf8786024543f19b89bc20034e60d7","f2a73be2f46840b182d7bd095378004e",22857335,2,1,0,1922,428,429,1
"f2a73be2f46840b182d7bd095378004e","f2a73be2f46840b182d7bd095378004e",22857335,2,0,1,1923,429,429,0
"f2a73be2f46840b182d7bd095378004e","604551fd4266430cb860fef58fa7dd61",22857335,1,1,0,1924,429,430,1
"604551fd4266430cb860fef58fa7dd61","604551fd4266430cb860fef58fa7dd61",22857335,4,0,1,1925,430,430,0
"604551fd4266430cb860fef58fa7dd61","dce46f8904594a62a6377a3587aaa663",22857335,1,2,0,1929,430,431,1
"dce46f8904594a62a6377a3587aaa663","24cf8786024543f19b89bc20034e60d7",22857335,4,-4,0,1930,431,428,-3
"24cf8786024543f19b89bc20034e60d7","dce46f8904594a62a6377a3587aaa663",22857335,3,4,0,1931,428,431,3
"f2a73be2f46840b182d7bd095378004e","dce46f8904594a62a6377a3587aaa663",22857335,2,3,0,1935,429,431,2
"dce46f8904594a62a6377a3587aaa663","dce46f8904594a62a6377a3587aaa663",22857335,2,0,1,1938,431,431,0
"dce46f8904594a62a6377a3587aaa663","9b9d0a249052413c869753b99682b0ac",22857335,1,1,0,1939,431,432,1
"9b9d0a249052413c869753b99682b0ac","9b9d0a249052413c869753b99682b0ac",22857335,4,0,1,1940,432,432,0
"9b9d0a249052413c869753b99682b0ac","061c175cc90f45fbad883025394e78dd",22857335,1,1,0,1944,432,433,1
"061c175cc90f45fbad883025394e78dd","061c175cc90f45fbad883025394e78dd",22857335,5,0,1,1945,433,433,0
"061c175cc90f45fbad883025394e78dd","dce46f8904594a62a6377a3587aaa663",22857335,1,-2,0,1950,433,431,-2
"dce46f8904594a62a6377a3587aaa663","66ada10dde9f43018588f1ced9d477fc",22857335,1,4,0,1952,431,434,3
"66ada10dde9f43018588f1ced9d477fc","dce46f8904594a62a6377a3587aaa663",22857335,1,-4,0,1953,434,431,-3
"dce46f8904594a62a6377a3587aaa663","f2a73be2f46840b182d7bd095378004e",22857335,1,-3,0,1954,431,429,-2
"dce46f8904594a62a6377a3587aaa663","74a7f8712e5449c2bc0b43c6f90dafed",22857335,1,5,0,1958,431,435,4
"74a7f8712e5449c2bc0b43c6f90dafed","74a7f8712e5449c2bc0b43c6f90dafed",22857335,1,0,1,1959,435,435,0
"74a7f8712e5449c2bc0b43c6f90dafed","66ada10dde9f43018588f1ced9d477fc",22857335,1,-1,0,1960,435,434,-1
"66ada10dde9f43018588f1ced9d477fc","bf12c96466d840a69bed7020b3f18bb8",22857335,1,3,0,1961,434,436,2
"bf12c96466d840a69bed7020b3f18bb8","bf12c96466d840a69bed7020b3f18bb8",22857335,1,0,1,1962,436,436,0
"bf12c96466d840a69bed7020b3f18bb8","070600601c4c439288445d2f0724807d",22857335,1,3,0,1963,436,437,1
"070600601c4c439288445d2f0724807d","24cf8786024543f19b89bc20034e60d7",22857335,1,-14,0,1964,437,428,-9
"24cf8786024543f19b89bc20034e60d7","1823b6de7d334a7aaabc4570719af4d9",22857335,1,16,0,1965,428,439,11
"1823b6de7d334a7aaabc4570719af4d9","070600601c4c439288445d2f0724807d",22857335,2,-2,0,1966,439,437,-2
"070600601c4c439288445d2f0724807d","1823b6de7d334a7aaabc4570719af4d9",22857335,1,2,0,1967,437,439,2
"1823b6de7d334a7aaabc4570719af4d9","1823b6de7d334a7aaabc4570719af4d9",22857335,11,0,1,1968,439,439,0
"070600601c4c439288445d2f0724807d","0380cd76a7d44bc3a4da1f15e4d68f89",22857335,2,4,0,1980,437,440,3
"0380cd76a7d44bc3a4da1f15e4d68f89","070600601c4c439288445d2f0724807d",22857335,1,-4,0,1981,440,437,-3
"0380cd76a7d44bc3a4da1f15e4d68f89","0380cd76a7d44bc3a4da1f15e4d68f89",22857335,2,0,1,1983,440,440,0
"0380cd76a7d44bc3a4da1f15e4d68f89","23b7673c8b5443108c2ef09382834a86",22857335,1,2,0,1985,440,441,1
"23b7673c8b5443108c2ef09382834a86","23b7673c8b5443108c2ef09382834a86",22857335,3,0,1,1986,441,441,0
"23b7673c8b5443108c2ef09382834a86","901e92500aea43c79f19f1b279050668",22857335,1,2,0,1989,441,442,1
"901e92500aea43c79f19f1b279050668","901e92500aea43c79f19f1b279050668",22857335,3,0,1,1990,442,442,0
"901e92500aea43c79f19f1b279050668","001339db8ced4cf78829ebe8b145449d",22857335,1,1,0,1993,442,443,1
"001339db8ced4cf78829ebe8b145449d","001339db8ced4cf78829ebe8b145449d",22857335,2,0,1,1994,443,443,0
"001339db8ced4cf78829ebe8b145449d","452745e0366e42ae81561bfddebcc6c3",22857335,1,1,0,1996,443,444,1
"452745e0366e42ae81561bfddebcc6c3","452745e0366e42ae81561bfddebcc6c3",22857335,2,0,1,1997,444,444,0
"452745e0366e42ae81561bfddebcc6c3","901e92500aea43c79f19f1b279050668",22857335,1,-2,0,1999,444,442,-2
"901e92500aea43c79f19f1b279050668","4660ff2089114e8db82ceb26a4f329e3",22857335,1,4,0,2000,442,445,3
"4660ff2089114e8db82ceb26a4f329e3","4660ff2089114e8db82ceb26a4f329e3",22857335,2,0,1,2001,445,445,0
"4660ff2089114e8db82ceb26a4f329e3","7bd5586eb9d8484eb74a433ee7bfe499",22857335,1,2,0,2003,445,446,1
"7bd5586eb9d8484eb74a433ee7bfe499","7bd5586eb9d8484eb74a433ee7bfe499",22857335,12,0,1,2004,446,446,0
"7bd5586eb9d8484eb74a433ee7bfe499","8a7f26e690f34dda97be16904518ca99",22857335,1,2,0,2016,446,447,1
"8a7f26e690f34dda97be16904518ca99","8a7f26e690f34dda97be16904518ca99",22857335,1,0,1,2017,447,447,0
"8a7f26e690f34dda97be16904518ca99","070600601c4c439288445d2f0724807d",22857335,1,-16,0,2018,447,437,-10
"070600601c4c439288445d2f0724807d","b2f0d654738f48158edff28e8d3a546e",22857335,1,21,0,2019,437,449,12
"b2f0d654738f48158edff28e8d3a546e","b2f0d654738f48158edff28e8d3a546e",22857335,4,0,1,2020,449,449,0
"b2f0d654738f48158edff28e8d3a546e","f60ee41ec635499abd48168342d32c2f",22857335,5,5,0,2021,449,453,4
"f60ee41ec635499abd48168342d32c2f","f60ee41ec635499abd48168342d32c2f",22857335,64,0,1,2022,453,453,0
"f60ee41ec635499abd48168342d32c2f","f67fbf45a5f146ed866965bc57c7c001",22857335,1,3,0,2029,453,454,1
"f67fbf45a5f146ed866965bc57c7c001","d937afe49bd24a07a550dda1c1155122",22857335,1,1,0,2032,454,455,1
"d937afe49bd24a07a550dda1c1155122","d937afe49bd24a07a550dda1c1155122",22857335,1,0,1,2033,455,455,0
"d937afe49bd24a07a550dda1c1155122","3628b3f7823443d0912a339096b69943",22857335,1,1,0,2034,455,456,1
"3628b3f7823443d0912a339096b69943","3628b3f7823443d0912a339096b69943",22857335,1,0,1,2035,456,456,0
"3628b3f7823443d0912a339096b69943","9e049ee647cf43ecbcb5ed792a8e7588",22857335,1,1,0,2036,456,457,1
"9e049ee647cf43ecbcb5ed792a8e7588","9e049ee647cf43ecbcb5ed792a8e7588",22857335,1,0,1,2037,457,457,0
"9e049ee647cf43ecbcb5ed792a8e7588","5256a214faaf410b93f76cea06428334",22857335,1,1,0,2038,457,458,1
"5256a214faaf410b93f76cea06428334","5256a214faaf410b93f76cea06428334",22857335,1,0,1,2039,458,458,0
"5256a214faaf410b93f76cea06428334","25c32b120fce40fa9b6c85133aeb4716",22857335,1,1,0,2040,458,459,1
"25c32b120fce40fa9b6c85133aeb4716","25c32b120fce40fa9b6c85133aeb4716",22857335,1,0,1,2041,459,459,0
"25c32b120fce40fa9b6c85133aeb4716","11bc14f2204949008b7d511b933363c1",22857335,1,1,0,2042,459,460,1
"11bc14f2204949008b7d511b933363c1","11bc14f2204949008b7d511b933363c1",22857335,3,0,1,2043,460,460,0
"11bc14f2204949008b7d511b933363c1","42de338840a34d15adb66e7b14fb9d2c",22857335,1,1,0,2046,460,461,1
"42de338840a34d15adb66e7b14fb9d2c","42de338840a34d15adb66e7b14fb9d2c",22857335,1,0,1,2047,461,461,0
"42de338840a34d15adb66e7b14fb9d2c","9da37c6210b1416b8079c274f70bf600",22857335,1,1,0,2048,461,462,1
"9da37c6210b1416b8079c274f70bf600","9da37c6210b1416b8079c274f70bf600",22857335,1,0,1,2049,462,462,0
"9da37c6210b1416b8079c274f70bf600","519119f1deac45ff9ab4f13529be5c6e",22857335,1,1,0,2050,462,463,1
"519119f1deac45ff9ab4f13529be5c6e","519119f1deac45ff9ab4f13529be5c6e",22857335,1,0,1,2051,463,463,0
"519119f1deac45ff9ab4f13529be5c6e","c5df9f40ec14463b9dcfdc73df3e9285",22857335,1,3,0,2052,463,464,1
"c5df9f40ec14463b9dcfdc73df3e9285","f67fbf45a5f146ed866965bc57c7c001",22857335,1,-12,0,2053,464,454,-10
"f67fbf45a5f146ed866965bc57c7c001","c5df9f40ec14463b9dcfdc73df3e9285",22857335,1,12,0,2054,454,464,10
"c5df9f40ec14463b9dcfdc73df3e9285","83d42d95cd844fc093fc09cee250edb8",22857335,1,3,0,2055,464,465,1
"83d42d95cd844fc093fc09cee250edb8","83d42d95cd844fc093fc09cee250edb8",22857335,4,0,1,2056,465,465,0
"83d42d95cd844fc093fc09cee250edb8","fab84b4fab5940efb4ea868ef8d09396",22857335,1,-261,0,2060,465,284,-181
"fab84b4fab5940efb4ea868ef8d09396","f7002c8484354eceac57bc7bd62c76c1",22857335,1,147,0,2061,284,393,109
"6f8881a745ac4c358a68b92c3b4abe81","66baf19b6b904b70922329068c63746d",22857335,1,-22,0,2064,394,376,-18
"6f8881a745ac4c358a68b92c3b4abe81","b2f0d654738f48158edff28e8d3a546e",22857335,1,90,0,2066,394,449,55
"f60ee41ec635499abd48168342d32c2f","b2f0d654738f48158edff28e8d3a546e",22857335,3,-5,0,2073,453,449,-4
"f60ee41ec635499abd48168342d32c2f","c5df9f40ec14463b9dcfdc73df3e9285",22857335,1,15,0,2134,453,464,11
"c5df9f40ec14463b9dcfdc73df3e9285","c5df9f40ec14463b9dcfdc73df3e9285",22857335,2,0,1,2135,464,464,0
"c5df9f40ec14463b9dcfdc73df3e9285","687055dad9fc40c3982478fe33ec01bf",22857335,1,-79,0,2137,464,414,-50
"2b09a08242b54983aec7063990fb3f66","1fd0f6dadbc14ebc965faf6122190b96",22857335,1,22,0,2139,400,415,15
"687055dad9fc40c3982478fe33ec01bf","a2b4bd40cee2481ebd3fc179d6a5cd62",22857335,1,6,0,2143,414,417,3
"2b09a08242b54983aec7063990fb3f66","b71bac264efb4abd97015447bd490db6",22857335,1,-44,0,2145,400,370,-30
"8d448d625b024c82a5eb240bbd7431d6","1b4550d0dab04078b3bf08a655345bdc",22857335,1,-1,0,2156,374,373,-1
"1b4550d0dab04078b3bf08a655345bdc","8d448d625b024c82a5eb240bbd7431d6",22857335,1,1,0,2157,373,374,1
"d6d02b6ef04e4f17805504500b8ce441","30ead9794d4847abaf222ca966cc8630",22857335,1,-36,0,2214,375,348,-27
"c76574d21bc14aeea7ecd0b027f39858","2fe14166dc9642c3bc666b86a57f943d",22857335,1,-13,0,2216,367,357,-10
"2fe14166dc9642c3bc666b86a57f943d","4a29443515bb404cb8924e1c60a63b73",22857335,1,-92,0,2217,357,285,-72
"e2911e79efc2420eac45d9f671463d4b","e2911e79efc2420eac45d9f671463d4b",22862565,2,0,1,1,2,2,0
"e2911e79efc2420eac45d9f671463d4b","b613861cecf84ffcab01afb23f660475",22862565,2,-3,0,2,2,1,-1
"b613861cecf84ffcab01afb23f660475","b613861cecf84ffcab01afb23f660475",22862565,3,0,1,3,1,1,0
"b613861cecf84ffcab01afb23f660475","e2911e79efc2420eac45d9f671463d4b",22862565,2,3,0,6,1,2,1
"e2911e79efc2420eac45d9f671463d4b","519d1b8c59404d67b54e96c5c8a830b2",22862565,1,1,0,10,2,3,1
"519d1b8c59404d67b54e96c5c8a830b2","519d1b8c59404d67b54e96c5c8a830b2",22862565,1,0,1,11,3,3,0
"519d1b8c59404d67b54e96c5c8a830b2","531db53f81f646edb0cdcfe0085b03b7",22862565,1,1,0,12,3,4,1
"531db53f81f646edb0cdcfe0085b03b7","531db53f81f646edb0cdcfe0085b03b7",22862565,1,0,1,13,4,4,0
"531db53f81f646edb0cdcfe0085b03b7","4f5f94b2f95141e0a9d53a61da2276da",22862565,1,1,0,14,4,5,1
"4f5f94b2f95141e0a9d53a61da2276da","4f5f94b2f95141e0a9d53a61da2276da",22862565,1,0,1,15,5,5,0
"4f5f94b2f95141e0a9d53a61da2276da","6d541c89590949f99af293c4f2333f67",22862565,1,1,0,16,5,6,1
"6d541c89590949f99af293c4f2333f67","6d541c89590949f99af293c4f2333f67",22862565,1,0,1,17,6,6,0
"6d541c89590949f99af293c4f2333f67","dd5cf0b9fe4c4f1d8f5ff8e4c04879cb",22862565,1,1,0,18,6,7,1
"dd5cf0b9fe4c4f1d8f5ff8e4c04879cb","dd5cf0b9fe4c4f1d8f5ff8e4c04879cb",22862565,1,0,1,19,7,7,0
"dd5cf0b9fe4c4f1d8f5ff8e4c04879cb","f96261861edc426abe2248be4f0a709a",22862565,1,1,0,20,7,8,1
"f96261861edc426abe2248be4f0a709a","f96261861edc426abe2248be4f0a709a",22862565,1,0,1,21,8,8,0
"f96261861edc426abe2248be4f0a709a","66b5e16f4f75454fb5b8172079f0fa83",22862565,1,1,0,22,8,9,1
"66b5e16f4f75454fb5b8172079f0fa83","66b5e16f4f75454fb5b8172079f0fa83",22862565,1,0,1,23,9,9,0
"66b5e16f4f75454fb5b8172079f0fa83","0680571d4698477995e41842c36a54b2",22862565,1,1,0,24,9,10,1
"0680571d4698477995e41842c36a54b2","0680571d4698477995e41842c36a54b2",22862565,1,0,1,25,10,10,0
"0680571d4698477995e41842c36a54b2","9112f2bffece48e08c6d2287be204085",22862565,1,1,0,26,10,11,1
"9112f2bffece48e08c6d2287be204085","9112f2bffece48e08c6d2287be204085",22862565,1,0,1,27,11,11,0
"9112f2bffece48e08c6d2287be204085","e2911e79efc2420eac45d9f671463d4b",22862565,1,-9,0,28,11,2,-9
"e2911e79efc2420eac45d9f671463d4b","56586aa865414f538729c7f7735d2bc6",22862565,1,12,0,29,2,12,10
"56586aa865414f538729c7f7735d2bc6","56586aa865414f538729c7f7735d2bc6",22862565,3,0,1,30,12,12,0
"56586aa865414f538729c7f7735d2bc6","b7f2b31585d94eb3bf86376714aa7070",22862565,1,2,0,33,12,13,1
"b7f2b31585d94eb3bf86376714aa7070","b7f2b31585d94eb3bf86376714aa7070",22862565,2,0,1,34,13,13,0
"b7f2b31585d94eb3bf86376714aa7070","3f1c815879794b929260d224becaff7e",22862565,1,2,0,36,13,14,1
"3f1c815879794b929260d224becaff7e","5c5ceeee4562457ba6d41515aeebfbb1",22862565,1,6,0,37,14,17,3
"5c5ceeee4562457ba6d41515aeebfbb1","81c864a886d54a6b8ff85f7d736f4f95",22862565,1,-4,0,38,17,15,-2
"81c864a886d54a6b8ff85f7d736f4f95","5c5ceeee4562457ba6d41515aeebfbb1",22862565,1,4,0,39,15,17,2
"5c5ceeee4562457ba6d41515aeebfbb1","56586aa865414f538729c7f7735d2bc6",22862565,1,-10,0,40,17,12,-5
"56586aa865414f538729c7f7735d2bc6","9afd71a5298d4333b6849dfce1b9422c",22862565,1,13,0,41,12,18,6
"9afd71a5298d4333b6849dfce1b9422c","b7719e26494940efa49512aedd0aac79",22862565,1,4,0,42,18,20,2
"b7719e26494940efa49512aedd0aac79","9afd71a5298d4333b6849dfce1b9422c",22862565,1,-4,0,43,20,18,-2
"9afd71a5298d4333b6849dfce1b9422c","d4f45188d3c84a02ba08454e6403a818",22862565,1,9,0,44,18,24,6
"d4f45188d3c84a02ba08454e6403a818","d4c3b003e8274e429d2fa688d73fde6d",22862565,1,-2,0,45,24,22,-2
"d4c3b003e8274e429d2fa688d73fde6d","d4c3b003e8274e429d2fa688d73fde6d",22862565,2,0,1,46,22,22,0
"d4c3b003e8274e429d2fa688d73fde6d","b7719e26494940efa49512aedd0aac79",22862565,2,-3,0,48,22,20,-2
"b7719e26494940efa49512aedd0aac79","b7719e26494940efa49512aedd0aac79",22862565,5,0,1,49,20,20,0
"b7719e26494940efa49512aedd0aac79","afbf7250b99d47bea07172749483ca97",22862565,4,12,0,50,20,28,8
"afbf7250b99d47bea07172749483ca97","afbf7250b99d47bea07172749483ca97",22862565,3,0,1,51,28,28,0
"afbf7250b99d47bea07172749483ca97","4e51676dc72045d99c19b9fa7b22f8bc",22862565,3,3,0,52,28,29,1
"4e51676dc72045d99c19b9fa7b22f8bc","4e51676dc72045d99c19b9fa7b22f8bc",22862565,1,0,1,53,29,29,0
"4e51676dc72045d99c19b9fa7b22f8bc","51970cfa30e643e894e66ae85c8024cc",22862565,2,3,0,54,29,31,2
"51970cfa30e643e894e66ae85c8024cc","4e51676dc72045d99c19b9fa7b22f8bc",22862565,2,-3,0,55,31,29,-2
"4e51676dc72045d99c19b9fa7b22f8bc","c33c17be71ae4d588da7369472e5bb1b",22862565,3,9,0,56,29,34,5
"93679be414554a11b1893002f2229a93","c33c17be71ae4d588da7369472e5bb1b",22862565,2,-3,0,58,35,34,-1
"fc0e049d56024bc9a02c9a9c435c3df7","9a0dc646f934470daf08c4b56ccf73db",22862565,1,-3,0,64,38,37,-1
"9a0dc646f934470daf08c4b56ccf73db","b7719e26494940efa49512aedd0aac79",22862565,1,-33,0,65,37,20,-17
"afbf7250b99d47bea07172749483ca97","b7719e26494940efa49512aedd0aac79",22862565,2,-12,0,68,28,20,-8
"b7719e26494940efa49512aedd0aac79","a49d1bb4328949299686242fd0be5584",22862565,1,2,0,69,20,21,1
"a49d1bb4328949299686242fd0be5584","d4c3b003e8274e429d2fa688d73fde6d",22862565,2,1,0,70,21,22,1
"d4c3b003e8274e429d2fa688d73fde6d","d4f45188d3c84a02ba08454e6403a818",22862565,1,2,0,71,22,24,2
"d4f45188d3c84a02ba08454e6403a818","b7719e26494940efa49512aedd0aac79",22862565,1,-5,0,72,24,20,-4
"b7719e26494940efa49512aedd0aac79","d4f45188d3c84a02ba08454e6403a818",22862565,1,5,0,73,20,24,4
"d4f45188d3c84a02ba08454e6403a818","a49d1bb4328949299686242fd0be5584",22862565,1,-3,0,74,24,21,-3
"4e51676dc72045d99c19b9fa7b22f8bc","afbf7250b99d47bea07172749483ca97",22862565,1,-3,0,86,29,28,-1
"c33c17be71ae4d588da7369472e5bb1b","4e51676dc72045d99c19b9fa7b22f8bc",22862565,1,-9,0,91,34,29,-5
"9a0dc646f934470daf08c4b56ccf73db","7040a13096d746ac84b8fac8d9752058",22862565,1,-3,0,98,37,36,-1
"7040a13096d746ac84b8fac8d9752058","67a089198fcb4e1c8f2385786c2b296f",22862565,1,10,0,99,36,39,3
"67a089198fcb4e1c8f2385786c2b296f","67a089198fcb4e1c8f2385786c2b296f",22862565,1,0,1,100,39,39,0
"67a089198fcb4e1c8f2385786c2b296f","64d48c6c9c7940639a932219a6c87198",22862565,2,1,0,101,39,40,1
"64d48c6c9c7940639a932219a6c87198","64d48c6c9c7940639a932219a6c87198",22862565,2,0,1,102,40,40,0
"64d48c6c9c7940639a932219a6c87198","67a089198fcb4e1c8f2385786c2b296f",22862565,1,-1,0,104,40,39,-1
"67a089198fcb4e1c8f2385786c2b296f","b534b89233134e30a9b5645138bfa9ee",22862565,1,4,0,105,39,41,2
"b534b89233134e30a9b5645138bfa9ee","b534b89233134e30a9b5645138bfa9ee",22862565,2,0,1,106,41,41,0
"b534b89233134e30a9b5645138bfa9ee","0e37b720d23b4e7f8b313e79313fd107",22862565,1,3,0,107,41,44,3
"0e37b720d23b4e7f8b313e79313fd107","0e37b720d23b4e7f8b313e79313fd107",22862565,3,0,1,108,44,44,0
"0e37b720d23b4e7f8b313e79313fd107","6875d67fdd5f48168b62719df449bebd",22862565,1,1,0,111,44,45,1
"6875d67fdd5f48168b62719df449bebd","6875d67fdd5f48168b62719df449bebd",22862565,1,0,1,112,45,45,0
"6875d67fdd5f48168b62719df449bebd","b534b89233134e30a9b5645138bfa9ee",22862565,1,-4,0,113,45,41,-4
"b534b89233134e30a9b5645138bfa9ee","6e13d61a7bdb44bca949c9f86fab3be5",22862565,2,7,0,114,41,47,6
"6e13d61a7bdb44bca949c9f86fab3be5","6e13d61a7bdb44bca949c9f86fab3be5",22862565,1,0,1,115,47,47,0
"6e13d61a7bdb44bca949c9f86fab3be5","195f78799f984cc2b06c48dfe36be751",22862565,1,2,0,116,47,49,2
"195f78799f984cc2b06c48dfe36be751","195f78799f984cc2b06c48dfe36be751",22862565,2,0,1,117,49,49,0
"195f78799f984cc2b06c48dfe36be751","d9c8d8c444a64dadbbb508652c721e17",22862565,1,-3,0,119,49,46,-3
"d9c8d8c444a64dadbbb508652c721e17","d0c74f735e024943943e40333d6d337f",22862565,2,6,0,120,46,51,5
"d0c74f735e024943943e40333d6d337f","d0c74f735e024943943e40333d6d337f",22862565,1,0,1,121,51,51,0
"d0c74f735e024943943e40333d6d337f","983f8ff320594b279a7f4a6fe132f9c5",22862565,2,2,0,122,51,53,2
"983f8ff320594b279a7f4a6fe132f9c5","983f8ff320594b279a7f4a6fe132f9c5",22862565,4,0,1,123,53,53,0
"983f8ff320594b279a7f4a6fe132f9c5","35adfa5d923046aebabfefd98f35ff05",22862565,2,1,0,125,53,54,1
"35adfa5d923046aebabfefd98f35ff05","35adfa5d923046aebabfefd98f35ff05",22862565,4,0,1,126,54,54,0
"35adfa5d923046aebabfefd98f35ff05","b6f8a98476224da1b40e555ececc7ed8",22862565,2,1,0,128,54,55,1
"b6f8a98476224da1b40e555ececc7ed8","b6f8a98476224da1b40e555ececc7ed8",22862565,4,0,1,129,55,55,0
"b6f8a98476224da1b40e555ececc7ed8","86e22cb5fe0e4b47a9489ecddf7ed78f",22862565,2,1,0,131,55,56,1
"86e22cb5fe0e4b47a9489ecddf7ed78f","86e22cb5fe0e4b47a9489ecddf7ed78f",22862565,4,0,1,132,56,56,0
"86e22cb5fe0e4b47a9489ecddf7ed78f","f924752d8a1149668870b1e7698486f7",22862565,2,-6,0,134,56,50,-6
"f924752d8a1149668870b1e7698486f7","a1f2f12debe5432fb7a70bcd12bacfb9",22862565,3,9,0,135,50,58,8
"a1f2f12debe5432fb7a70bcd12bacfb9","78f30e4dcac84e3cbea8b2cc6e0d62b3",22862565,4,1,0,136,58,59,1
"78f30e4dcac84e3cbea8b2cc6e0d62b3","a1f2f12debe5432fb7a70bcd12bacfb9",22862565,3,-1,0,137,59,58,-1
"a1f2f12debe5432fb7a70bcd12bacfb9","a1f2f12debe5432fb7a70bcd12bacfb9",22862565,35,0,1,138,58,58,0
"78f30e4dcac84e3cbea8b2cc6e0d62b3","78f30e4dcac84e3cbea8b2cc6e0d62b3",22862565,11,0,1,174,59,59,0
"78f30e4dcac84e3cbea8b2cc6e0d62b3","a0a418b8540d479fa6e0f653b701da8b",22862565,1,6,0,185,59,64,5
"a0a418b8540d479fa6e0f653b701da8b","bc42d26810654ea9a1df1efe1e58c7d5",22862565,2,-1,0,186,64,63,-1
"bc42d26810654ea9a1df1efe1e58c7d5","12aa6e1672ac4e7aa6449a7a8609cd72",22862565,1,-7,0,187,63,57,-6
"12aa6e1672ac4e7aa6449a7a8609cd72","4c943503763e4e349906eea3ed3c8e86",22862565,1,5,0,188,57,61,4
"4c943503763e4e349906eea3ed3c8e86","4c943503763e4e349906eea3ed3c8e86",22862565,1,0,1,189,61,61,0
"4c943503763e4e349906eea3ed3c8e86","b534b89233134e30a9b5645138bfa9ee",22862565,1,-24,0,190,61,41,-20
"6e13d61a7bdb44bca949c9f86fab3be5","d9c8d8c444a64dadbbb508652c721e17",22862565,1,-1,0,193,47,46,-1
"d0c74f735e024943943e40333d6d337f","f924752d8a1149668870b1e7698486f7",22862565,2,-1,0,195,51,50,-1
"78f30e4dcac84e3cbea8b2cc6e0d62b3","12aa6e1672ac4e7aa6449a7a8609cd72",22862565,2,-2,0,198,59,57,-2
"12aa6e1672ac4e7aa6449a7a8609cd72","a0a418b8540d479fa6e0f653b701da8b",22862565,1,8,0,199,57,64,7
"bc42d26810654ea9a1df1efe1e58c7d5","309ccf3cc4fe429d9bfbaef53d3fa479",22862565,2,-3,0,201,63,60,-3
"309ccf3cc4fe429d9bfbaef53d3fa479","d0c74f735e024943943e40333d6d337f",22862565,1,-11,0,202,60,51,-9
"f924752d8a1149668870b1e7698486f7","78f30e4dcac84e3cbea8b2cc6e0d62b3",22862565,2,10,0,204,50,59,9
"a1f2f12debe5432fb7a70bcd12bacfb9","d0c74f735e024943943e40333d6d337f",22862565,1,-8,0,206,58,51,-7
"d0c74f735e024943943e40333d6d337f","12aa6e1672ac4e7aa6449a7a8609cd72",22862565,1,7,0,207,51,57,6
"12aa6e1672ac4e7aa6449a7a8609cd72","f924752d8a1149668870b1e7698486f7",22862565,1,-8,0,208,57,50,-7
"a1f2f12debe5432fb7a70bcd12bacfb9","12aa6e1672ac4e7aa6449a7a8609cd72",22862565,1,-1,0,211,58,57,-1
"12aa6e1672ac4e7aa6449a7a8609cd72","bc42d26810654ea9a1df1efe1e58c7d5",22862565,1,7,0,212,57,63,6
"bc42d26810654ea9a1df1efe1e58c7d5","a0a418b8540d479fa6e0f653b701da8b",22862565,1,1,0,213,63,64,1
"a0a418b8540d479fa6e0f653b701da8b","7af822066add4e7f8e007e4eee31a8bf",22862565,1,2,0,214,64,65,1
"7af822066add4e7f8e007e4eee31a8bf","bc42d26810654ea9a1df1efe1e58c7d5",22862565,1,-3,0,215,65,63,-2
"bc42d26810654ea9a1df1efe1e58c7d5","bc42d26810654ea9a1df1efe1e58c7d5",22862565,3,0,1,216,63,63,0
"309ccf3cc4fe429d9bfbaef53d3fa479","b534b89233134e30a9b5645138bfa9ee",22862565,1,-23,0,220,60,41,-19
"b534b89233134e30a9b5645138bfa9ee","d0c74f735e024943943e40333d6d337f",22862565,2,12,0,221,41,51,10
"d0c74f735e024943943e40333d6d337f","b534b89233134e30a9b5645138bfa9ee",22862565,1,-12,0,222,51,41,-10
"12aa6e1672ac4e7aa6449a7a8609cd72","d646286c8051419bbc2e31dd1db55ca8",22862565,1,14,0,240,57,67,10
"d646286c8051419bbc2e31dd1db55ca8","b534b89233134e30a9b5645138bfa9ee",22862565,1,-33,0,241,67,41,-26
"b534b89233134e30a9b5645138bfa9ee","a2becd407db34b189200a32546d9d569",22862565,1,42,0,242,41,75,34
"a2becd407db34b189200a32546d9d569","d646286c8051419bbc2e31dd1db55ca8",22862565,1,-9,0,243,75,67,-8
"d646286c8051419bbc2e31dd1db55ca8","a2becd407db34b189200a32546d9d569",22862565,1,9,0,244,67,75,8
"a2becd407db34b189200a32546d9d569","a2becd407db34b189200a32546d9d569",22862565,2,0,1,245,75,75,0
"a2becd407db34b189200a32546d9d569","58c22b011d0f4c2ea6d13615edbb9eeb",22862565,1,2,0,247,75,77,2
"58c22b011d0f4c2ea6d13615edbb9eeb","58c22b011d0f4c2ea6d13615edbb9eeb",22862565,2,0,1,248,77,77,0
"58c22b011d0f4c2ea6d13615edbb9eeb","dd76e1861dc9461c830888729d091ee0",22862565,1,1,0,250,77,78,1
"dd76e1861dc9461c830888729d091ee0","dd76e1861dc9461c830888729d091ee0",22862565,5,0,1,251,78,78,0
"dd76e1861dc9461c830888729d091ee0","cd1d828f1a694b87913a7ea66c23803e",22862565,1,1,0,256,78,79,1
"cd1d828f1a694b87913a7ea66c23803e","cd1d828f1a694b87913a7ea66c23803e",22862565,2,0,1,257,79,79,0
"cd1d828f1a694b87913a7ea66c23803e","9176a3c2b4d2465fa8b0c67096c2a97e",22862565,1,1,0,259,79,80,1
"9176a3c2b4d2465fa8b0c67096c2a97e","9176a3c2b4d2465fa8b0c67096c2a97e",22862565,5,0,1,260,80,80,0
"9176a3c2b4d2465fa8b0c67096c2a97e","f8ec6445f7194e25b9101d4fbcb07a18",22862565,1,1,0,265,80,81,1
"f8ec6445f7194e25b9101d4fbcb07a18","f8ec6445f7194e25b9101d4fbcb07a18",22862565,2,0,1,266,81,81,0
"f8ec6445f7194e25b9101d4fbcb07a18","140d5b27b8574befad82c0a013b59dfa",22862565,1,-7,0,268,81,74,-7
"140d5b27b8574befad82c0a013b59dfa","d646286c8051419bbc2e31dd1db55ca8",22862565,1,-8,0,269,74,67,-7
"d646286c8051419bbc2e31dd1db55ca8","d18a9ea32855445f8736581f5cb119ce",22862565,1,17,0,270,67,82,15
"d18a9ea32855445f8736581f5cb119ce","d646286c8051419bbc2e31dd1db55ca8",22862565,1,-17,0,271,82,67,-15
"d646286c8051419bbc2e31dd1db55ca8","f564483cbd7a407681aa2fcca518cf5f",22862565,1,21,0,272,67,85,18
"f564483cbd7a407681aa2fcca518cf5f","f564483cbd7a407681aa2fcca518cf5f",22862565,9,0,1,273,85,85,0
"f564483cbd7a407681aa2fcca518cf5f","18fd01350bd5434ca636d59a599d768a",22862565,1,1,0,282,85,86,1
"18fd01350bd5434ca636d59a599d768a","18fd01350bd5434ca636d59a599d768a",22862565,5,0,1,283,86,86,0
"18fd01350bd5434ca636d59a599d768a","ae5ac430ea254e708a6f5deaaf7464ae",22862565,1,-2,0,288,86,84,-2
"ae5ac430ea254e708a6f5deaaf7464ae","6a9f0ef185fb47f0937e29daa1c71ed5",22862565,1,7,0,289,84,90,6
"6a9f0ef185fb47f0937e29daa1c71ed5","6a9f0ef185fb47f0937e29daa1c71ed5",22862565,6,0,1,290,90,90,0
"6a9f0ef185fb47f0937e29daa1c71ed5","c681290961c94c4caf23b529d1ae6b9a",22862565,1,-2,0,294,90,88,-2
"c681290961c94c4caf23b529d1ae6b9a","c681290961c94c4caf23b529d1ae6b9a",22862565,1,0,1,295,88,88,0
"c681290961c94c4caf23b529d1ae6b9a","e20db35ced8544ddac5bc3839145e463",22862565,1,5,0,296,88,91,3
"e20db35ced8544ddac5bc3839145e463","d646286c8051419bbc2e31dd1db55ca8",22862565,1,-30,0,297,91,67,-24
"d646286c8051419bbc2e31dd1db55ca8","1febb706d7a34005ae8711ed49c76e64",22862565,1,33,0,298,67,94,27
"1febb706d7a34005ae8711ed49c76e64","1febb706d7a34005ae8711ed49c76e64",22862565,2,0,1,299,94,94,0
"1febb706d7a34005ae8711ed49c76e64","8f73ba6f5a0042f2850356ac38ac6f24",22862565,1,1,0,301,94,95,1
"8f73ba6f5a0042f2850356ac38ac6f24","8f73ba6f5a0042f2850356ac38ac6f24",22862565,5,0,1,302,95,95,0
"8f73ba6f5a0042f2850356ac38ac6f24","e2260b86653c46d7b14a41fb419dbf8c",22862565,1,1,0,307,95,96,1
"e2260b86653c46d7b14a41fb419dbf8c","e2260b86653c46d7b14a41fb419dbf8c",22862565,2,0,1,308,96,96,0
"e2260b86653c46d7b14a41fb419dbf8c","35eb641ad1d845bbba54915bce75a962",22862565,1,1,0,310,96,97,1
"35eb641ad1d845bbba54915bce75a962","35eb641ad1d845bbba54915bce75a962",22862565,5,0,1,311,97,97,0
"35eb641ad1d845bbba54915bce75a962","08be90ffbeea4795a138cd42ed8db56f",22862565,1,1,0,316,97,98,1
"08be90ffbeea4795a138cd42ed8db56f","08be90ffbeea4795a138cd42ed8db56f",22862565,5,0,1,317,98,98,0
"08be90ffbeea4795a138cd42ed8db56f","3007433c8f584dcbb5ac159c1c5f2be3",22862565,1,1,0,322,98,99,1
"3007433c8f584dcbb5ac159c1c5f2be3","3007433c8f584dcbb5ac159c1c5f2be3",22862565,2,0,1,323,99,99,0
"3007433c8f584dcbb5ac159c1c5f2be3","00ae5f0c51874a73a41ebea838d95682",22862565,1,3,0,325,99,101,2
"00ae5f0c51874a73a41ebea838d95682","e20db35ced8544ddac5bc3839145e463",22862565,1,-11,0,326,101,91,-10
"e20db35ced8544ddac5bc3839145e463","d391c8b6e56a43a7b654e9dee02d904b",22862565,1,13,0,327,91,103,12
"d391c8b6e56a43a7b654e9dee02d904b","00ae5f0c51874a73a41ebea838d95682",22862565,1,-2,0,328,103,101,-2
"00ae5f0c51874a73a41ebea838d95682","d391c8b6e56a43a7b654e9dee02d904b",22862565,2,2,0,329,101,103,2
"d391c8b6e56a43a7b654e9dee02d904b","d391c8b6e56a43a7b654e9dee02d904b",22862565,20,0,1,330,103,103,0
"d391c8b6e56a43a7b654e9dee02d904b","6111116566fc4fd9abba409322bea245",22862565,1,1,0,350,103,104,1
"6111116566fc4fd9abba409322bea245","6111116566fc4fd9abba409322bea245",22862565,2,0,1,351,104,104,0
"6111116566fc4fd9abba409322bea245","a81b2235cb9c499eb9ea8ee0a8dd9725",22862565,1,1,0,353,104,105,1
"a81b2235cb9c499eb9ea8ee0a8dd9725","a81b2235cb9c499eb9ea8ee0a8dd9725",22862565,2,0,1,354,105,105,0
"a81b2235cb9c499eb9ea8ee0a8dd9725","2d4e0ab0ef3b4d73b82c72d4621a7579",22862565,1,1,0,356,105,106,1
"2d4e0ab0ef3b4d73b82c72d4621a7579","2d4e0ab0ef3b4d73b82c72d4621a7579",22862565,2,0,1,357,106,106,0
"2d4e0ab0ef3b4d73b82c72d4621a7579","8bdebf492ebd4e62b0d522e8ab5e5197",22862565,1,1,0,359,106,107,1
"8bdebf492ebd4e62b0d522e8ab5e5197","8bdebf492ebd4e62b0d522e8ab5e5197",22862565,2,0,1,360,107,107,0
"8bdebf492ebd4e62b0d522e8ab5e5197","73039f8c1eb9409cb4caee2cf968001e",22862565,1,-7,0,362,107,100,-7
"73039f8c1eb9409cb4caee2cf968001e","4280927ec4d643238aa49c32f9e06c6c",22862565,2,10,0,363,100,109,9
"4280927ec4d643238aa49c32f9e06c6c","4280927ec4d643238aa49c32f9e06c6c",22862565,2,0,1,364,109,109,0
"4280927ec4d643238aa49c32f9e06c6c","e20db35ced8544ddac5bc3839145e463",22862565,1,-20,0,365,109,91,-18
"e20db35ced8544ddac5bc3839145e463","4280927ec4d643238aa49c32f9e06c6c",22862565,1,20,0,366,91,109,18
"4280927ec4d643238aa49c32f9e06c6c","08111f75e22d409998cf8b85bd431f0a",22862565,1,-1,0,367,109,108,-1
"08111f75e22d409998cf8b85bd431f0a","00ae5f0c51874a73a41ebea838d95682",22862565,1,-8,0,368,108,101,-7
"d391c8b6e56a43a7b654e9dee02d904b","73039f8c1eb9409cb4caee2cf968001e",22862565,1,-3,0,370,103,100,-3
"4280927ec4d643238aa49c32f9e06c6c","fc44e6a5f7654430af1227838224dceb",22862565,1,2,0,373,109,111,2
"fc44e6a5f7654430af1227838224dceb","fc44e6a5f7654430af1227838224dceb",22862565,2,0,1,374,111,111,0
"fc44e6a5f7654430af1227838224dceb","a9ae0a3c070d455bb4369a8996313336",22862565,1,4,0,376,111,114,3
"a9ae0a3c070d455bb4369a8996313336","08111f75e22d409998cf8b85bd431f0a",22862565,1,-7,0,377,114,108,-6
"08111f75e22d409998cf8b85bd431f0a","a9ae0a3c070d455bb4369a8996313336",22862565,1,7,0,378,108,114,6
"a9ae0a3c070d455bb4369a8996313336","71cec822bcff4f30a20e75dc63ef7b65",22862565,1,2,0,379,114,116,2
"71cec822bcff4f30a20e75dc63ef7b65","71cec822bcff4f30a20e75dc63ef7b65",22862565,3,0,1,380,116,116,0
"71cec822bcff4f30a20e75dc63ef7b65","62bff51286ef4f348717a3cf6fe2318f",22862565,1,5,0,383,116,120,4
"62bff51286ef4f348717a3cf6fe2318f","37319e88176d4aefa91d7a9980dbae91",22862565,1,-9,0,384,120,112,-8
"37319e88176d4aefa91d7a9980dbae91","b1cd0e7dc3ad4a8eb91a4bfdbeb025b0",22862565,1,7,0,385,112,118,6
"b1cd0e7dc3ad4a8eb91a4bfdbeb025b0","b1cd0e7dc3ad4a8eb91a4bfdbeb025b0",22862565,1,0,1,386,118,118,0
"b1cd0e7dc3ad4a8eb91a4bfdbeb025b0","62bff51286ef4f348717a3cf6fe2318f",22862565,1,2,0,387,118,120,2
"62bff51286ef4f348717a3cf6fe2318f","62bff51286ef4f348717a3cf6fe2318f",22862565,3,0,1,388,120,120,0
"62bff51286ef4f348717a3cf6fe2318f","779f9ddd1fd14d1e9e69f72219a1fdbd",22862565,1,3,0,391,120,121,1
"779f9ddd1fd14d1e9e69f72219a1fdbd","e20db35ced8544ddac5bc3839145e463",22862565,1,-36,0,392,121,91,-30
"e20db35ced8544ddac5bc3839145e463","ae26e6cda8ad4a3f81bd347560d9579f",22862565,1,40,0,393,91,125,34
"ae26e6cda8ad4a3f81bd347560d9579f","ae26e6cda8ad4a3f81bd347560d9579f",22862565,5,0,1,394,125,125,0
"ae26e6cda8ad4a3f81bd347560d9579f","ee48df95832b4374aa273ceb27ec1315",22862565,1,1,0,399,125,126,1
"ee48df95832b4374aa273ceb27ec1315","ee48df95832b4374aa273ceb27ec1315",22862565,1,0,1,400,126,126,0
"ee48df95832b4374aa273ceb27ec1315","7a439da90b394756ad1777fc4c6dead5",22862565,1,1,0,401,126,127,1
"7a439da90b394756ad1777fc4c6dead5","7a439da90b394756ad1777fc4c6dead5",22862565,3,0,1,402,127,127,0
"7a439da90b394756ad1777fc4c6dead5","779f9ddd1fd14d1e9e69f72219a1fdbd",22862565,1,-6,0,405,127,121,-6
"779f9ddd1fd14d1e9e69f72219a1fdbd","a8dd5213034441ac92724b4e83eb0bb2",22862565,1,9,0,406,121,129,8
"a8dd5213034441ac92724b4e83eb0bb2","a8dd5213034441ac92724b4e83eb0bb2",22862565,1,0,1,407,129,129,0
"a8dd5213034441ac92724b4e83eb0bb2","8115eab6556b45f5b415c3b8c26a12e5",22862565,1,2,0,408,129,131,2
"8115eab6556b45f5b415c3b8c26a12e5","8115eab6556b45f5b415c3b8c26a12e5",22862565,2,0,1,409,131,131,0
"8115eab6556b45f5b415c3b8c26a12e5","ec34b06efd844b46a4c4818ecdb9b8f4",22862565,1,1,0,411,131,132,1
"ec34b06efd844b46a4c4818ecdb9b8f4","ec34b06efd844b46a4c4818ecdb9b8f4",22862565,2,0,1,412,132,132,0
"ec34b06efd844b46a4c4818ecdb9b8f4","c2e1c2b9eac64109b343a088584b576b",22862565,1,1,0,414,132,133,1
"c2e1c2b9eac64109b343a088584b576b","c2e1c2b9eac64109b343a088584b576b",22862565,2,0,1,415,133,133,0
"c2e1c2b9eac64109b343a088584b576b","579338175e0b4bbb8ef3b712b5d8b54e",22862565,1,-5,0,417,133,128,-5
"579338175e0b4bbb8ef3b712b5d8b54e","8bc5795d6a984a3eace4e2811e52dd4f",22862565,1,8,0,418,128,135,7
"8bc5795d6a984a3eace4e2811e52dd4f","8bc5795d6a984a3eace4e2811e52dd4f",22862565,1,0,1,419,135,135,0
"8bc5795d6a984a3eace4e2811e52dd4f","b416d47c56a742199b5d7c7f19d6503a",22862565,2,-1,0,420,135,134,-1
"b416d47c56a742199b5d7c7f19d6503a","f661500307d74c908e9207d949ceb4aa",22862565,1,3,0,421,134,136,2
"f661500307d74c908e9207d949ceb4aa","8bc5795d6a984a3eace4e2811e52dd4f",22862565,1,-2,0,422,136,135,-1
"b416d47c56a742199b5d7c7f19d6503a","cd4532ad48034873ba8bce2aac0c9808",22862565,1,4,0,424,134,137,3
"cd4532ad48034873ba8bce2aac0c9808","cd4532ad48034873ba8bce2aac0c9808",22862565,1,0,1,425,137,137,0
"cd4532ad48034873ba8bce2aac0c9808","df1de691dafe4549a18a4398ee9dfaf9",22862565,1,4,0,426,137,139,2
"df1de691dafe4549a18a4398ee9dfaf9","779f9ddd1fd14d1e9e69f72219a1fdbd",22862565,1,-23,0,427,139,121,-18
"779f9ddd1fd14d1e9e69f72219a1fdbd","6c5ad271a44743479bfaea29b1db8d02",22862565,1,27,0,428,121,143,22
"6c5ad271a44743479bfaea29b1db8d02","6c5ad271a44743479bfaea29b1db8d02",22862565,1,0,1,429,143,143,0
"6c5ad271a44743479bfaea29b1db8d02","83d311bed5374fee83d8d67a7d9d82dc",22862565,1,1,0,430,143,144,1
"83d311bed5374fee83d8d67a7d9d82dc","83d311bed5374fee83d8d67a7d9d82dc",22862565,1,0,1,431,144,144,0
"83d311bed5374fee83d8d67a7d9d82dc","402bba41861d43acb52a5abb89e8831e",22862565,1,1,0,432,144,145,1
"402bba41861d43acb52a5abb89e8831e","402bba41861d43acb52a5abb89e8831e",22862565,2,0,1,433,145,145,0
"402bba41861d43acb52a5abb89e8831e","df1de691dafe4549a18a4398ee9dfaf9",22862565,1,-6,0,435,145,139,-6
"df1de691dafe4549a18a4398ee9dfaf9","8aae34f5ddbb4052a709b12e6b0d40fa",22862565,1,9,0,436,139,147,8
"8aae34f5ddbb4052a709b12e6b0d40fa","8aae34f5ddbb4052a709b12e6b0d40fa",22862565,1,0,1,437,147,147,0
"8aae34f5ddbb4052a709b12e6b0d40fa","645b3f0249f64f76af2e19eb4d0e55b7",22862565,1,2,0,438,147,149,2
"645b3f0249f64f76af2e19eb4d0e55b7","645b3f0249f64f76af2e19eb4d0e55b7",22862565,2,0,1,439,149,149,0
"645b3f0249f64f76af2e19eb4d0e55b7","7e7b8db5064d4369805ab370aac5ddfb",22862565,1,1,0,441,149,150,1
"7e7b8db5064d4369805ab370aac5ddfb","7e7b8db5064d4369805ab370aac5ddfb",22862565,2,0,1,442,150,150,0
"7e7b8db5064d4369805ab370aac5ddfb","8956d210ae7f41968fada86d4c979d6a",22862565,1,1,0,444,150,151,1
"8956d210ae7f41968fada86d4c979d6a","8956d210ae7f41968fada86d4c979d6a",22862565,2,0,1,445,151,151,0
"8956d210ae7f41968fada86d4c979d6a","f902b0f41b544d4dbf79664fd233648d",22862565,1,-5,0,447,151,146,-5
"f902b0f41b544d4dbf79664fd233648d","ae781e8b775e4ccd93bc800dad5c8376",22862565,1,8,0,448,146,153,7
"ae781e8b775e4ccd93bc800dad5c8376","ae781e8b775e4ccd93bc800dad5c8376",22862565,5,0,1,449,153,153,0
"ae781e8b775e4ccd93bc800dad5c8376","06882a8492d9499aa31555567f575ecb",22862565,1,1,0,454,153,154,1
"06882a8492d9499aa31555567f575ecb","06882a8492d9499aa31555567f575ecb",22862565,1,0,1,455,154,154,0
"06882a8492d9499aa31555567f575ecb","f293c508f409466a8f27ddd7d1e40b20",22862565,1,1,0,456,154,155,1
"f293c508f409466a8f27ddd7d1e40b20","f293c508f409466a8f27ddd7d1e40b20",22862565,9,0,1,457,155,155,0
"f293c508f409466a8f27ddd7d1e40b20","cc4ddef5bbbe48ebb605141b347c4ed1",22862565,1,1,0,466,155,156,1
"cc4ddef5bbbe48ebb605141b347c4ed1","cc4ddef5bbbe48ebb605141b347c4ed1",22862565,1,0,1,467,156,156,0
"cc4ddef5bbbe48ebb605141b347c4ed1","f03480cf4eba413194d7af52fc0e7f28",22862565,1,-4,0,468,156,152,-4
"f03480cf4eba413194d7af52fc0e7f28","d313cec988a84645bee413e8d4724a4b",22862565,1,7,0,469,152,158,6
"d313cec988a84645bee413e8d4724a4b","d313cec988a84645bee413e8d4724a4b",22862565,4,0,1,470,158,158,0
"d313cec988a84645bee413e8d4724a4b","dc60696c76a74368a60f72246e47700d",22862565,1,1,0,474,158,159,1
"dc60696c76a74368a60f72246e47700d","dc60696c76a74368a60f72246e47700d",22862565,1,0,1,475,159,159,0
"dc60696c76a74368a60f72246e47700d","df1de691dafe4549a18a4398ee9dfaf9",22862565,1,-23,0,476,159,139,-20
"df1de691dafe4549a18a4398ee9dfaf9","78adeee1fa2c4fe0bc73f7bca9fcee86",22862565,1,26,0,477,139,160,21
"65202579580f4ad38d734b4ee39d22a8","8959e6304a0348309a771e4d08d1b64a",22862565,1,-1,0,499,164,163,-1
"8959e6304a0348309a771e4d08d1b64a","65202579580f4ad38d734b4ee39d22a8",22862565,1,1,0,500,163,164,1
"82e6285962b8400d9d6fc32436022a94","3cbcea2be0984e7dbd5a48195af10ce7",22862565,2,-2,0,537,167,165,-2
"3cbcea2be0984e7dbd5a48195af10ce7","3cbcea2be0984e7dbd5a48195af10ce7",22862565,1,0,1,538,165,165,0
"3cbcea2be0984e7dbd5a48195af10ce7","a9ac840f098c4bd0a2ee896214ce29cd",22862565,1,5,0,541,165,168,3
"a9ac840f098c4bd0a2ee896214ce29cd","0c7262dff33c4087bc660ccf40f92f9c",22862565,1,4,0,542,168,169,1
"0c7262dff33c4087bc660ccf40f92f9c","a9ac840f098c4bd0a2ee896214ce29cd",22862565,1,-4,0,543,169,168,-1
"a9ac840f098c4bd0a2ee896214ce29cd","b2275c3fad834f8d90737a2d9a6927d6",22862565,1,7,0,544,168,172,4
"b2275c3fad834f8d90737a2d9a6927d6","b2275c3fad834f8d90737a2d9a6927d6",22862565,25,0,1,545,172,172,0
"b2275c3fad834f8d90737a2d9a6927d6","0c7262dff33c4087bc660ccf40f92f9c",22862565,1,-3,0,570,172,169,-3
"0c7262dff33c4087bc660ccf40f92f9c","b42cc17b7de840f181a704558d0bc845",22862565,2,7,0,571,169,175,6
"b42cc17b7de840f181a704558d0bc845","362fcb0699a14845ab29b2340093e528",22862565,1,-1,0,572,175,174,-1
"362fcb0699a14845ab29b2340093e528","b2275c3fad834f8d90737a2d9a6927d6",22862565,1,-3,0,573,174,172,-2
"b2275c3fad834f8d90737a2d9a6927d6","eb515a26030b41f8a82a1e6114420bad",22862565,1,1,0,574,172,173,1
"eb515a26030b41f8a82a1e6114420bad","eb515a26030b41f8a82a1e6114420bad",22862565,2,0,1,575,173,173,0
"eb515a26030b41f8a82a1e6114420bad","0c7262dff33c4087bc660ccf40f92f9c",22862565,1,-4,0,577,173,169,-4
"b42cc17b7de840f181a704558d0bc845","b42cc17b7de840f181a704558d0bc845",22862565,1,0,1,579,175,175,0
"b42cc17b7de840f181a704558d0bc845","801f9e9135034f49bf5f8b4bdefedb41",22862565,1,2,0,580,175,177,2
"801f9e9135034f49bf5f8b4bdefedb41","801f9e9135034f49bf5f8b4bdefedb41",22862565,8,0,1,581,177,177,0
"801f9e9135034f49bf5f8b4bdefedb41","362fcb0699a14845ab29b2340093e528",22862565,1,-3,0,589,177,174,-3
"362fcb0699a14845ab29b2340093e528","ea38cc0e6e6e41edbabf210220808bf9",22862565,1,6,0,590,174,179,5
"ea38cc0e6e6e41edbabf210220808bf9","b87c552dd247427abe6ab5795b9c9d43",22862565,2,2,0,591,179,181,2
"b87c552dd247427abe6ab5795b9c9d43","ea38cc0e6e6e41edbabf210220808bf9",22862565,1,-2,0,592,181,179,-2
"b87c552dd247427abe6ab5795b9c9d43","b87c552dd247427abe6ab5795b9c9d43",22862565,7,0,1,594,181,181,0
"b87c552dd247427abe6ab5795b9c9d43","139b097acfca451689d80c9c6eebdf7b",22862565,1,-3,0,601,181,178,-3
"139b097acfca451689d80c9c6eebdf7b","30f660a1feb34582a739722532524f79",22862565,1,6,0,602,178,183,5
"30f660a1feb34582a739722532524f79","30f660a1feb34582a739722532524f79",22862565,5,0,1,603,183,183,0
"30f660a1feb34582a739722532524f79","2024b4885bd14338a39b7b509acbbd02",22862565,1,-1,0,608,183,182,-1
"2024b4885bd14338a39b7b509acbbd02","c3f63fe50d8e487c86bf8ef76c9cadd3",22862565,1,4,0,609,182,185,3
"c3f63fe50d8e487c86bf8ef76c9cadd3","c3f63fe50d8e487c86bf8ef76c9cadd3",22862565,1,0,1,610,185,185,0
"c3f63fe50d8e487c86bf8ef76c9cadd3","c8e371568a0c4391b25796ae4e91952e",22862565,1,3,0,611,185,186,1
"c8e371568a0c4391b25796ae4e91952e","0c7262dff33c4087bc660ccf40f92f9c",22862565,1,-23,0,612,186,169,-17
"0c7262dff33c4087bc660ccf40f92f9c","7d932b23e1c84326ae5aa4d3c0d813d1",22862565,1,25,0,613,169,188,19
"7d932b23e1c84326ae5aa4d3c0d813d1","7d932b23e1c84326ae5aa4d3c0d813d1",22862565,1,0,1,614,188,188,0
"7d932b23e1c84326ae5aa4d3c0d813d1","ab11d94c6c8948ea90b88f19d2cd502b",22862565,1,3,0,615,188,190,2
"ab11d94c6c8948ea90b88f19d2cd502b","c8e371568a0c4391b25796ae4e91952e",22862565,1,-5,0,616,190,186,-4
"c8e371568a0c4391b25796ae4e91952e","ab11d94c6c8948ea90b88f19d2cd502b",22862565,2,5,0,617,186,190,4
"ab11d94c6c8948ea90b88f19d2cd502b","f992451ed6ad4e68bb9e68ad6be7c4be",22862565,1,2,0,618,190,192,2
"f992451ed6ad4e68bb9e68ad6be7c4be","f992451ed6ad4e68bb9e68ad6be7c4be",22862565,1,0,1,619,192,192,0
"f992451ed6ad4e68bb9e68ad6be7c4be","07b44a7a51e94c78b411c753fc39dab0",22862565,1,-3,0,620,192,189,-3
"07b44a7a51e94c78b411c753fc39dab0","6cd2dcaac46847d4a0bc53f296d90375",22862565,2,6,0,621,189,194,5
"6cd2dcaac46847d4a0bc53f296d90375","c8e371568a0c4391b25796ae4e91952e",22862565,1,-10,0,622,194,186,-8
"c8e371568a0c4391b25796ae4e91952e","6cd2dcaac46847d4a0bc53f296d90375",22862565,1,10,0,623,186,194,8
"6cd2dcaac46847d4a0bc53f296d90375","017d7ca8e0394b91aaadc9574df2202c",22862565,2,-1,0,624,194,193,-1
"017d7ca8e0394b91aaadc9574df2202c","c8e371568a0c4391b25796ae4e91952e",22862565,1,-9,0,625,193,186,-7
"ab11d94c6c8948ea90b88f19d2cd502b","07b44a7a51e94c78b411c753fc39dab0",22862565,1,-1,0,627,190,189,-1
"017d7ca8e0394b91aaadc9574df2202c","6cd2dcaac46847d4a0bc53f296d90375",22862565,1,1,0,630,193,194,1
"6cd2dcaac46847d4a0bc53f296d90375","2d2580c9411c4972909db508d6956a58",22862565,1,2,0,631,194,196,2
"2d2580c9411c4972909db508d6956a58","2d2580c9411c4972909db508d6956a58",22862565,5,0,1,632,196,196,0
"2d2580c9411c4972909db508d6956a58","5bddb3d9ed264f3984702f048c7e5340",22862565,1,1,0,637,196,197,1
"5bddb3d9ed264f3984702f048c7e5340","5bddb3d9ed264f3984702f048c7e5340",22862565,2,0,1,638,197,197,0
"5bddb3d9ed264f3984702f048c7e5340","d5e8e2bd12a2466b9d6d90855f0eb079",22862565,1,1,0,640,197,198,1
"d5e8e2bd12a2466b9d6d90855f0eb079","d5e8e2bd12a2466b9d6d90855f0eb079",22862565,2,0,1,641,198,198,0
"d5e8e2bd12a2466b9d6d90855f0eb079","017d7ca8e0394b91aaadc9574df2202c",22862565,1,-5,0,643,198,193,-5
"017d7ca8e0394b91aaadc9574df2202c","54e8e9f0ea3e45c4bf3b8ac799ee31b1",22862565,1,8,0,644,193,200,7
"54e8e9f0ea3e45c4bf3b8ac799ee31b1","54e8e9f0ea3e45c4bf3b8ac799ee31b1",22862565,1,0,1,645,200,200,0
"54e8e9f0ea3e45c4bf3b8ac799ee31b1","c614a00911be4877a075f19315530fb0",22862565,1,1,0,646,200,201,1
"c614a00911be4877a075f19315530fb0","c614a00911be4877a075f19315530fb0",22862565,6,0,1,647,201,201,0
"c614a00911be4877a075f19315530fb0","a6c21bd8b95249c7972820a7a7d76aff",22862565,1,1,0,653,201,202,1
"a6c21bd8b95249c7972820a7a7d76aff","a6c21bd8b95249c7972820a7a7d76aff",22862565,1,0,1,654,202,202,0
"a6c21bd8b95249c7972820a7a7d76aff","f9170dd6bc6442b4acd832747609b09a",22862565,1,-3,0,655,202,199,-3
"f9170dd6bc6442b4acd832747609b09a","b54257a550b94ebc9538f3a90eee9d7e",22862565,1,6,0,656,199,204,5
"b54257a550b94ebc9538f3a90eee9d7e","bb329d880ab54120adaf203a693bb203",22862565,1,-2,0,657,204,203,-1
"bb329d880ab54120adaf203a693bb203","bb329d880ab54120adaf203a693bb203",22862565,1,0,1,658,203,203,0
"bb329d880ab54120adaf203a693bb203","f9170dd6bc6442b4acd832747609b09a",22862565,1,-4,0,659,203,199,-4
"f9170dd6bc6442b4acd832747609b09a","334c2344009840079b1d0e1b7ce3d5a7",22862565,1,7,0,660,199,205,6
"334c2344009840079b1d0e1b7ce3d5a7","334c2344009840079b1d0e1b7ce3d5a7",22862565,3,0,1,661,205,205,0
"334c2344009840079b1d0e1b7ce3d5a7","c8e371568a0c4391b25796ae4e91952e",22862565,1,-23,0,664,205,186,-19
"c8e371568a0c4391b25796ae4e91952e","d7f13c8d63ec4e2aa673fbb9cf9c6933",22862565,1,26,0,665,186,206,20
"d7f13c8d63ec4e2aa673fbb9cf9c6933","b9e80f77c3a44349863b19875725c384",22862565,1,1,0,666,206,207,1
"b9e80f77c3a44349863b19875725c384","7108f0e4c2584f1f9c471689ae4c885c",22862565,2,1,0,667,207,208,1
"7108f0e4c2584f1f9c471689ae4c885c","b9e80f77c3a44349863b19875725c384",22862565,1,-1,0,668,208,207,-1
"b9e80f77c3a44349863b19875725c384","b9e80f77c3a44349863b19875725c384",22862565,17,0,1,669,207,207,0
"7108f0e4c2584f1f9c471689ae4c885c","7108f0e4c2584f1f9c471689ae4c885c",22862565,15,0,1,687,208,208,0
"7108f0e4c2584f1f9c471689ae4c885c","d7f13c8d63ec4e2aa673fbb9cf9c6933",22862565,1,-2,0,702,208,206,-2
"d7f13c8d63ec4e2aa673fbb9cf9c6933","09400e101c5d4b439cf9a26b03aae558",22862565,1,5,0,703,206,210,4
"09400e101c5d4b439cf9a26b03aae558","09400e101c5d4b439cf9a26b03aae558",22862565,1,0,1,704,210,210,0
"09400e101c5d4b439cf9a26b03aae558","a88efa7e50ce47159810ab553afa6d3a",22862565,1,2,0,705,210,212,2
"a88efa7e50ce47159810ab553afa6d3a","a88efa7e50ce47159810ab553afa6d3a",22862565,2,0,1,706,212,212,0
"a88efa7e50ce47159810ab553afa6d3a","a875096404ef4a9984b62d74cda916f9",22862565,1,-3,0,708,212,209,-3
"a875096404ef4a9984b62d74cda916f9","be502a7a43c44bf7b682698de79d9369",22862565,1,6,0,709,209,214,5
"be502a7a43c44bf7b682698de79d9369","f7fb1952f56b4189b86a9f8b7862d2b8",22862565,3,1,0,710,214,215,1
"f7fb1952f56b4189b86a9f8b7862d2b8","be502a7a43c44bf7b682698de79d9369",22862565,1,-1,0,711,215,214,-1
"be502a7a43c44bf7b682698de79d9369","be502a7a43c44bf7b682698de79d9369",22862565,1,0,1,712,214,214,0
"f7fb1952f56b4189b86a9f8b7862d2b8","f7fb1952f56b4189b86a9f8b7862d2b8",22862565,17,0,1,714,215,215,0
"f7fb1952f56b4189b86a9f8b7862d2b8","b860ee85d8bc4a2f97958cfb71be3533",22862565,1,1,0,731,215,216,1
"b860ee85d8bc4a2f97958cfb71be3533","b860ee85d8bc4a2f97958cfb71be3533",22862565,5,0,1,732,216,216,0
"b860ee85d8bc4a2f97958cfb71be3533","ec341f459285443b8361f7f15638ff08",22862565,1,-3,0,737,216,213,-3
"ec341f459285443b8361f7f15638ff08","363837c182e04711840d896ae1e0339c",22862565,2,6,0,738,213,218,5
"363837c182e04711840d896ae1e0339c","363837c182e04711840d896ae1e0339c",22862565,12,0,1,739,218,218,0
"363837c182e04711840d896ae1e0339c","01b2051f8941460d89945e3b02d1ce78",22862565,3,-1,0,751,218,217,-1
"01b2051f8941460d89945e3b02d1ce78","be502a7a43c44bf7b682698de79d9369",22862565,1,-4,0,752,217,214,-3
"f7fb1952f56b4189b86a9f8b7862d2b8","be95c065e45447c1bd8215ea6f130c7a",22862565,1,6,0,754,215,219,4
"be95c065e45447c1bd8215ea6f130c7a","ec341f459285443b8361f7f15638ff08",22862565,1,-8,0,755,219,213,-6
"01b2051f8941460d89945e3b02d1ce78","be95c065e45447c1bd8215ea6f130c7a",22862565,1,3,0,758,217,219,2
"be95c065e45447c1bd8215ea6f130c7a","363837c182e04711840d896ae1e0339c",22862565,1,-2,0,759,219,218,-1
"01b2051f8941460d89945e3b02d1ce78","91125ca626c5470eb145501f8c37f8db",22862565,1,4,0,761,217,220,3
"91125ca626c5470eb145501f8c37f8db","91125ca626c5470eb145501f8c37f8db",22862565,1,0,1,762,220,220,0
"91125ca626c5470eb145501f8c37f8db","d7f13c8d63ec4e2aa673fbb9cf9c6933",22862565,1,-18,0,763,220,206,-14
"d7f13c8d63ec4e2aa673fbb9cf9c6933","1c6721b1f63f4d30ba7746ea8af02a52",22862565,1,21,0,764,206,221,15
"1c6721b1f63f4d30ba7746ea8af02a52","77ecef8eff6b4a2caea7707669bf7475",22862565,2,1,0,765,221,222,1
"77ecef8eff6b4a2caea7707669bf7475","1c6721b1f63f4d30ba7746ea8af02a52",22862565,2,-1,0,766,222,221,-1
"1c6721b1f63f4d30ba7746ea8af02a52","1c6721b1f63f4d30ba7746ea8af02a52",22862565,1,0,1,767,221,221,0
"77ecef8eff6b4a2caea7707669bf7475","77ecef8eff6b4a2caea7707669bf7475",22862565,14,0,1,769,222,222,0
"1c6721b1f63f4d30ba7746ea8af02a52","d03cb855c70044cf8c35d9ec0de696e3",22862565,1,4,0,784,221,224,3
"d03cb855c70044cf8c35d9ec0de696e3","8b9ae98743bd4d4a8a87dff1c1244211",22862565,1,3,0,785,224,227,3
"8b9ae98743bd4d4a8a87dff1c1244211","d03cb855c70044cf8c35d9ec0de696e3",22862565,2,-3,0,786,227,224,-3
"d03cb855c70044cf8c35d9ec0de696e3","d03cb855c70044cf8c35d9ec0de696e3",22862565,5,0,1,787,224,224,0
"d03cb855c70044cf8c35d9ec0de696e3","f7906d6f59b9489a91d2ef40db5a474d",22862565,1,-1,0,791,224,223,-1
"f7906d6f59b9489a91d2ef40db5a474d","1c6721b1f63f4d30ba7746ea8af02a52",22862565,1,-3,0,792,223,221,-2
"1c6721b1f63f4d30ba7746ea8af02a52","8b9ae98743bd4d4a8a87dff1c1244211",22862565,1,7,0,793,221,227,6
"d03cb855c70044cf8c35d9ec0de696e3","a49a937d6896486d9a5396654abcf2e1",22862565,1,2,0,796,224,226,2
"a49a937d6896486d9a5396654abcf2e1","a49a937d6896486d9a5396654abcf2e1",22862565,5,0,1,797,226,226,0
"a49a937d6896486d9a5396654abcf2e1","8b9ae98743bd4d4a8a87dff1c1244211",22862565,1,1,0,802,226,227,1
"8b9ae98743bd4d4a8a87dff1c1244211","8b9ae98743bd4d4a8a87dff1c1244211",22862565,26,0,1,803,227,227,0
"8b9ae98743bd4d4a8a87dff1c1244211","f7906d6f59b9489a91d2ef40db5a474d",22862565,1,-4,0,829,227,223,-4
"f7906d6f59b9489a91d2ef40db5a474d","2ab1535aac1346ba8801535bf729ef37",22862565,1,7,0,830,223,229,6
"2ab1535aac1346ba8801535bf729ef37","2ab1535aac1346ba8801535bf729ef37",22862565,2,0,1,831,229,229,0
"2ab1535aac1346ba8801535bf729ef37","a4f40fb48a8542c8949bae1f002cd9bc",22862565,1,2,0,833,229,231,2
"a4f40fb48a8542c8949bae1f002cd9bc","a4f40fb48a8542c8949bae1f002cd9bc",22862565,2,0,1,834,231,231,0
"a4f40fb48a8542c8949bae1f002cd9bc","8972c23e32044edb8a78fa1eed4e5947",22862565,1,1,0,836,231,232,1
"8972c23e32044edb8a78fa1eed4e5947","8972c23e32044edb8a78fa1eed4e5947",22862565,1,0,1,837,232,232,0
"8972c23e32044edb8a78fa1eed4e5947","92feb4a40f8344d38b6f722e42a53295",22862565,1,1,0,838,232,233,1
"92feb4a40f8344d38b6f722e42a53295","92feb4a40f8344d38b6f722e42a53295",22862565,2,0,1,839,233,233,0
"92feb4a40f8344d38b6f722e42a53295","5152833676bf4c6cb317060be10f68db",22862565,1,-5,0,841,233,228,-5
"5152833676bf4c6cb317060be10f68db","ca3e28f290354c08aefe5b0f769604e6",22862565,1,8,0,842,228,235,7
"ca3e28f290354c08aefe5b0f769604e6","ca3e28f290354c08aefe5b0f769604e6",22862565,14,0,1,843,235,235,0
"ca3e28f290354c08aefe5b0f769604e6","79a35eea833e4c2c9d22fc53c3c6445c",22862565,1,1,0,857,235,236,1
"79a35eea833e4c2c9d22fc53c3c6445c","79a35eea833e4c2c9d22fc53c3c6445c",22862565,4,0,1,858,236,236,0
"79a35eea833e4c2c9d22fc53c3c6445c","8f68228b1518449e9615cdafee41a2bd",22862565,1,1,0,862,236,237,1
"8f68228b1518449e9615cdafee41a2bd","8f68228b1518449e9615cdafee41a2bd",22862565,1,0,1,863,237,237,0
"8f68228b1518449e9615cdafee41a2bd","cab89fa5c3ed45a5aa550fc0352d6a42",22862565,1,1,0,864,237,238,1
"cab89fa5c3ed45a5aa550fc0352d6a42","cab89fa5c3ed45a5aa550fc0352d6a42",22862565,1,0,1,865,238,238,0
"cab89fa5c3ed45a5aa550fc0352d6a42","66d4fad4f1cf4b46be0750a99ad7a35a",22862565,1,1,0,866,238,239,1
"66d4fad4f1cf4b46be0750a99ad7a35a","66d4fad4f1cf4b46be0750a99ad7a35a",22862565,1,0,1,867,239,239,0
"66d4fad4f1cf4b46be0750a99ad7a35a","0b04c8e2f86d48c7aeb7e225819cd32b",22862565,1,-5,0,868,239,234,-5
"0b04c8e2f86d48c7aeb7e225819cd32b","d646286c8051419bbc2e31dd1db55ca8",22862565,1,-218,0,869,234,67,-167
"d646286c8051419bbc2e31dd1db55ca8","6a9f0ef185fb47f0937e29daa1c71ed5",22862565,1,27,0,870,67,90,23
"6a9f0ef185fb47f0937e29daa1c71ed5","5152833676bf4c6cb317060be10f68db",22862565,1,184,0,873,90,228,138
"5152833676bf4c6cb317060be10f68db","1c6721b1f63f4d30ba7746ea8af02a52",22862565,1,-9,0,874,228,221,-7
"1c6721b1f63f4d30ba7746ea8af02a52","2ab1535aac1346ba8801535bf729ef37",22862565,1,10,0,875,221,229,8
"2ab1535aac1346ba8801535bf729ef37","5152833676bf4c6cb317060be10f68db",22862565,1,-1,0,876,229,228,-1
"5152833676bf4c6cb317060be10f68db","0b04c8e2f86d48c7aeb7e225819cd32b",22862565,1,7,0,877,228,234,6
"0b04c8e2f86d48c7aeb7e225819cd32b","f53da5fd9bfe412da4b80d4742563b6c",22862565,1,8,0,878,234,241,7
"f53da5fd9bfe412da4b80d4742563b6c","f53da5fd9bfe412da4b80d4742563b6c",22862565,1,0,1,879,241,241,0
"f53da5fd9bfe412da4b80d4742563b6c","1c6721b1f63f4d30ba7746ea8af02a52",22862565,1,-24,0,880,241,221,-20
"1c6721b1f63f4d30ba7746ea8af02a52","2ae94c0cea4d480a9d5dca8fb1d7b542",22862565,1,27,0,881,221,242,21
"2ae94c0cea4d480a9d5dca8fb1d7b542","1ebf23f9d994469a85206e4c7b1bf5f5",22862565,1,3,0,882,242,245,3
"1ebf23f9d994469a85206e4c7b1bf5f5","1ebf23f9d994469a85206e4c7b1bf5f5",22862565,14,0,1,883,245,245,0
"1ebf23f9d994469a85206e4c7b1bf5f5","85ae675b83e8422da842cfd25596af99",22862565,1,1,0,897,245,246,1
"85ae675b83e8422da842cfd25596af99","85ae675b83e8422da842cfd25596af99",22862565,1,0,1,898,246,246,0
"85ae675b83e8422da842cfd25596af99","2ae94c0cea4d480a9d5dca8fb1d7b542",22862565,1,-4,0,899,246,242,-4
"2ae94c0cea4d480a9d5dca8fb1d7b542","30c9ba177afc49a695625d2bdec40207",22862565,1,9,0,900,242,250,8
"30c9ba177afc49a695625d2bdec40207","30c9ba177afc49a695625d2bdec40207",22862565,2,0,1,901,250,250,0
"30c9ba177afc49a695625d2bdec40207","6e83e23f56544a19b94067c1c558d9c0",22862565,1,-3,0,903,250,247,-3
"6e83e23f56544a19b94067c1c558d9c0","00f61990949545828dd12f1303d47504",22862565,1,11,0,904,247,256,9
"00f61990949545828dd12f1303d47504","00f61990949545828dd12f1303d47504",22862565,1,0,1,905,256,256,0
"00f61990949545828dd12f1303d47504","ead7bb4b64e247d2ae632ab8a296b091",22862565,1,2,0,906,256,258,2
"ead7bb4b64e247d2ae632ab8a296b091","ead7bb4b64e247d2ae632ab8a296b091",22862565,5,0,1,907,258,258,0
"ead7bb4b64e247d2ae632ab8a296b091","41b0048dde734bb280bac6116baa8e27",22862565,1,1,0,912,258,259,1
"41b0048dde734bb280bac6116baa8e27","41b0048dde734bb280bac6116baa8e27",22862565,5,0,1,913,259,259,0
"41b0048dde734bb280bac6116baa8e27","b41c5a094a604ee0915327da5cc0beb7",22862565,1,1,0,918,259,260,1
"b41c5a094a604ee0915327da5cc0beb7","b41c5a094a604ee0915327da5cc0beb7",22862565,2,0,1,919,260,260,0
"b41c5a094a604ee0915327da5cc0beb7","d546341988904f069cfa86b21457d9d9",22862565,1,-10,0,921,260,251,-9
"d546341988904f069cfa86b21457d9d9","28c171777c52431ab6b925073bd63d46",22862565,1,15,0,922,251,264,13
"28c171777c52431ab6b925073bd63d46","28c171777c52431ab6b925073bd63d46",22862565,11,0,1,923,264,264,0
"28c171777c52431ab6b925073bd63d46","ac160db940cb49ae8579162b1d52bb5d",22862565,1,2,0,934,264,266,2
"ac160db940cb49ae8579162b1d52bb5d","ac160db940cb49ae8579162b1d52bb5d",22862565,11,0,1,935,266,266,0
"ac160db940cb49ae8579162b1d52bb5d","d989ebcfc12a4b669f0100dc1aa14f1e",22862565,1,-12,0,946,266,255,-11
"d989ebcfc12a4b669f0100dc1aa14f1e","c6fd49b485cc4874b0bbdd9c6171e09c",22862565,1,15,0,947,255,268,13
"c6fd49b485cc4874b0bbdd9c6171e09c","c6fd49b485cc4874b0bbdd9c6171e09c",22862565,7,0,1,948,268,268,0
"c6fd49b485cc4874b0bbdd9c6171e09c","44240778a97c4af0937817499b75707b",22862565,1,1,0,955,268,269,1
"44240778a97c4af0937817499b75707b","44240778a97c4af0937817499b75707b",22862565,2,0,1,956,269,269,0
"44240778a97c4af0937817499b75707b","7aa76d3e993840d8805f097cbdbcd44b",22862565,1,-9,0,958,269,261,-8
"7aa76d3e993840d8805f097cbdbcd44b","865a4d3b43374da7944dc7d397f566d9",22862565,1,12,0,959,261,271,10
"865a4d3b43374da7944dc7d397f566d9","865a4d3b43374da7944dc7d397f566d9",22862565,1,0,1,960,271,271,0
"865a4d3b43374da7944dc7d397f566d9","0d987bed3ffa4ed0b9a2e62e97b7b30f",22862565,1,3,0,961,271,272,1
"0d987bed3ffa4ed0b9a2e62e97b7b30f","2ae94c0cea4d480a9d5dca8fb1d7b542",22862565,1,-38,0,962,272,242,-30
"2ae94c0cea4d480a9d5dca8fb1d7b542","0d987bed3ffa4ed0b9a2e62e97b7b30f",22862565,1,38,0,963,242,272,30
"0d987bed3ffa4ed0b9a2e62e97b7b30f","82ae07bc0c9b4570a41799290d1ef399",22862565,1,4,0,964,272,275,3
"82ae07bc0c9b4570a41799290d1ef399","bb5a47f5ea01454a8b79455422d3b9da",22862565,1,6,0,965,275,280,5
"bb5a47f5ea01454a8b79455422d3b9da","bb5a47f5ea01454a8b79455422d3b9da",22862565,63,0,1,1000,280,280,0
"bb5a47f5ea01454a8b79455422d3b9da","94cecc3f1e7d484b8e068e79241dfd73",22862565,1,3,0,1029,280,281,1
"94cecc3f1e7d484b8e068e79241dfd73","0d987bed3ffa4ed0b9a2e62e97b7b30f",22862565,1,-13,0,1030,281,272,-9
"0d987bed3ffa4ed0b9a2e62e97b7b30f","a37477c4e4c14169ad44b06b493007f6",22862565,1,15,0,1031,272,283,11
"a37477c4e4c14169ad44b06b493007f6","94cecc3f1e7d484b8e068e79241dfd73",22862565,1,-2,0,1032,283,281,-2
"94cecc3f1e7d484b8e068e79241dfd73","fab84b4fab5940efb4ea868ef8d09396",22862565,1,5,0,1033,281,284,3
"fab84b4fab5940efb4ea868ef8d09396","4a29443515bb404cb8924e1c60a63b73",22862565,1,4,0,1034,284,285,1
"4a29443515bb404cb8924e1c60a63b73","fab84b4fab5940efb4ea868ef8d09396",22862565,1,-4,0,1035,285,284,-1
"fab84b4fab5940efb4ea868ef8d09396","208c9b2796c944db8dacaa96082520ea",22862565,1,7,0,1036,284,288,4
"208c9b2796c944db8dacaa96082520ea","4a29443515bb404cb8924e1c60a63b73",22862565,4,-3,0,1037,288,285,-3
"4a29443515bb404cb8924e1c60a63b73","208c9b2796c944db8dacaa96082520ea",22862565,3,3,0,1038,285,288,3
"208c9b2796c944db8dacaa96082520ea","208c9b2796c944db8dacaa96082520ea",22862565,2,0,1,1039,288,288,0
"4a29443515bb404cb8924e1c60a63b73","4a29443515bb404cb8924e1c60a63b73",22862565,1,0,1,1041,285,285,0
"4a29443515bb404cb8924e1c60a63b73","7669a956527947d0add87455277e80b4",22862565,1,7,0,1044,285,291,6
"7669a956527947d0add87455277e80b4","7669a956527947d0add87455277e80b4",22862565,1,0,1,1045,291,291,0
"7669a956527947d0add87455277e80b4","869e967078f04da18dd0b0b9389a7424",22862565,1,3,0,1046,291,293,2
"869e967078f04da18dd0b0b9389a7424","6a9a3b5bde4a48daa896fe8c06eca56f",22862565,1,-5,0,1047,293,289,-4
"6a9a3b5bde4a48daa896fe8c06eca56f","869e967078f04da18dd0b0b9389a7424",22862565,1,5,0,1048,289,293,4
"869e967078f04da18dd0b0b9389a7424","51ab6291537748fab90d519aa09889d6",22862565,1,2,0,1049,293,295,2
"51ab6291537748fab90d519aa09889d6","51ab6291537748fab90d519aa09889d6",22862565,5,0,1,1050,295,295,0
"51ab6291537748fab90d519aa09889d6","34a6e49023fc4465bd5ca604330bbd1c",22862565,1,-3,0,1055,295,292,-3
"34a6e49023fc4465bd5ca604330bbd1c","4a29443515bb404cb8924e1c60a63b73",22862565,1,-9,0,1056,292,285,-7
"4a29443515bb404cb8924e1c60a63b73","21592f2a9e9c4b2f8c66ec5dbcbf6a2b",22862565,1,14,0,1060,285,296,11
"21592f2a9e9c4b2f8c66ec5dbcbf6a2b","ba0e59461bfb4a44b7b1c28a01f8d3b3",22862565,1,4,0,1061,296,299,3
"ba0e59461bfb4a44b7b1c28a01f8d3b3","ba0e59461bfb4a44b7b1c28a01f8d3b3",22862565,3,0,1,1062,299,299,0
"ba0e59461bfb4a44b7b1c28a01f8d3b3","0e0b36e731a645e7b1b8a88f5031ca38",22862565,1,2,0,1065,299,301,2
"0e0b36e731a645e7b1b8a88f5031ca38","0e0b36e731a645e7b1b8a88f5031ca38",22862565,5,0,1,1066,301,301,0
"0e0b36e731a645e7b1b8a88f5031ca38","a66a144637284c21afc6de17fea4bfb8",22862565,1,1,0,1071,301,302,1
"a66a144637284c21afc6de17fea4bfb8","a66a144637284c21afc6de17fea4bfb8",22862565,2,0,1,1072,302,302,0
"a66a144637284c21afc6de17fea4bfb8","7646a919d7e64fa990bca9b024ff089d",22862565,1,-4,0,1074,302,298,-4
"7646a919d7e64fa990bca9b024ff089d","e390b575229748ea8aac9364efe2bf00",22862565,1,7,0,1075,298,304,6
"e390b575229748ea8aac9364efe2bf00","e390b575229748ea8aac9364efe2bf00",22862565,1,0,1,1076,304,304,0
"e390b575229748ea8aac9364efe2bf00","4a29443515bb404cb8924e1c60a63b73",22862565,1,-24,0,1077,304,285,-19
"4a29443515bb404cb8924e1c60a63b73","3434c10e561d488a914e0f7d71907abd",22862565,1,27,0,1078,285,305,20
"3434c10e561d488a914e0f7d71907abd","53e7e900392747ccad52e711ab0f80d8",22862565,1,2,0,1079,305,307,2
"53e7e900392747ccad52e711ab0f80d8","53e7e900392747ccad52e711ab0f80d8",22862565,2,0,1,1080,307,307,0
"53e7e900392747ccad52e711ab0f80d8","3434c10e561d488a914e0f7d71907abd",22862565,1,-2,0,1082,307,305,-2
"3434c10e561d488a914e0f7d71907abd","130acc2aeb0448fdbb2de63bc5cebe5b",22862565,1,5,0,1083,305,309,4
"130acc2aeb0448fdbb2de63bc5cebe5b","130acc2aeb0448fdbb2de63bc5cebe5b",22862565,1,0,1,1084,309,309,0
"130acc2aeb0448fdbb2de63bc5cebe5b","9c062b3251034ebe90f5054e2a3b5120",22862565,1,2,0,1085,309,311,2
"9c062b3251034ebe90f5054e2a3b5120","9c062b3251034ebe90f5054e2a3b5120",22862565,2,0,1,1086,311,311,0
"9c062b3251034ebe90f5054e2a3b5120","ea859f8207e44537889daeaba13ac2e8",22862565,1,1,0,1088,311,312,1
"ea859f8207e44537889daeaba13ac2e8","ea859f8207e44537889daeaba13ac2e8",22862565,4,0,1,1089,312,312,0
"ea859f8207e44537889daeaba13ac2e8","56d94971a7a94257aa330183a8ebd0ea",22862565,1,1,0,1093,312,313,1
"56d94971a7a94257aa330183a8ebd0ea","56d94971a7a94257aa330183a8ebd0ea",22862565,7,0,1,1094,313,313,0
"56d94971a7a94257aa330183a8ebd0ea","141c0df6cd1946539aadd1c9b7068cd4",22862565,1,-5,0,1101,313,308,-5
"141c0df6cd1946539aadd1c9b7068cd4","13255e63e0aa4abf85e5211bf613d43e",22862565,1,10,0,1102,308,317,9
"13255e63e0aa4abf85e5211bf613d43e","13255e63e0aa4abf85e5211bf613d43e",22862565,3,0,1,1103,317,317,0
"13255e63e0aa4abf85e5211bf613d43e","0c787d16c9504873b1a4d903cec09948",22862565,1,-3,0,1106,317,314,-3
"0c787d16c9504873b1a4d903cec09948","86c27d40179e419c8e9d150fb6afa5d0",22862565,1,6,0,1107,314,319,5
"86c27d40179e419c8e9d150fb6afa5d0","86c27d40179e419c8e9d150fb6afa5d0",22862565,1,0,1,1108,319,319,0
"86c27d40179e419c8e9d150fb6afa5d0","47edbb64109243e6b0f8f64cdef90c6c",22862565,1,8,0,1109,319,326,7
"47edbb64109243e6b0f8f64cdef90c6c","8d7e0b55cf9849cda222a0f2440cec55",22862565,1,-9,0,1110,326,318,-8
"8d7e0b55cf9849cda222a0f2440cec55","24f1363179ad4aaa965484a78471912b",22862565,1,6,0,1111,318,323,5
"24f1363179ad4aaa965484a78471912b","24f1363179ad4aaa965484a78471912b",22862565,1,0,1,1112,323,323,0
"24f1363179ad4aaa965484a78471912b","3628bdce1dd2429ba924d2d4d09448d2",22862565,1,-1,0,1113,323,322,-1
"3628bdce1dd2429ba924d2d4d09448d2","56b3fd1a212a4764be39d979fde3326e",22862565,1,7,0,1114,322,328,6
"56b3fd1a212a4764be39d979fde3326e","56b3fd1a212a4764be39d979fde3326e",22862565,1,0,1,1115,328,328,0
"56b3fd1a212a4764be39d979fde3326e","3434c10e561d488a914e0f7d71907abd",22862565,1,-28,0,1116,328,305,-23
"3434c10e561d488a914e0f7d71907abd","0c4079457ede49e3aeb5e86ed84bdf35",22862565,1,31,0,1117,305,329,24
"0c4079457ede49e3aeb5e86ed84bdf35","38aea304b4fa46e1b29bb72f5cea4c93",22862565,1,2,0,1118,329,331,2
"38aea304b4fa46e1b29bb72f5cea4c93","38aea304b4fa46e1b29bb72f5cea4c93",22862565,1,0,1,1119,331,331,0
"38aea304b4fa46e1b29bb72f5cea4c93","e36d261332f14e79bb4b467aceaeb9b5",22862565,1,2,0,1120,331,333,2
"e36d261332f14e79bb4b467aceaeb9b5","e36d261332f14e79bb4b467aceaeb9b5",22862565,1,0,1,1121,333,333,0
"e36d261332f14e79bb4b467aceaeb9b5","c7e89b9d04744d2eab742fc24e3ef1ae",22862565,1,1,0,1122,333,334,1
"c7e89b9d04744d2eab742fc24e3ef1ae","c7e89b9d04744d2eab742fc24e3ef1ae",22862565,2,0,1,1123,334,334,0
"c7e89b9d04744d2eab742fc24e3ef1ae","fe49f8054b374a0ea4bb266ed135ff62",22862565,1,1,0,1125,334,335,1
"fe49f8054b374a0ea4bb266ed135ff62","fe49f8054b374a0ea4bb266ed135ff62",22862565,2,0,1,1126,335,335,0
"fe49f8054b374a0ea4bb266ed135ff62","d0a8f74af98642fe8360d22c42e45117",22862565,1,1,0,1128,335,336,1
"d0a8f74af98642fe8360d22c42e45117","d0a8f74af98642fe8360d22c42e45117",22862565,2,0,1,1129,336,336,0
"d0a8f74af98642fe8360d22c42e45117","0c4079457ede49e3aeb5e86ed84bdf35",22862565,1,-7,0,1131,336,329,-7
"0c4079457ede49e3aeb5e86ed84bdf35","a7c6339ca1da4368a18d471f0519f877",22862565,1,11,0,1132,329,339,10
"a7c6339ca1da4368a18d471f0519f877","a7c6339ca1da4368a18d471f0519f877",22862565,1,0,1,1133,339,339,0
"a7c6339ca1da4368a18d471f0519f877","bbc5139ca9024389a94db3a6f47dcff6",22862565,1,3,0,1134,339,341,2
"bbc5139ca9024389a94db3a6f47dcff6","b8b9418ab322418d9db9b40d96af873a",22862565,1,-5,0,1135,341,337,-4
"b8b9418ab322418d9db9b40d96af873a","bbc5139ca9024389a94db3a6f47dcff6",22862565,1,5,0,1136,337,341,4
"bbc5139ca9024389a94db3a6f47dcff6","bbc5139ca9024389a94db3a6f47dcff6",22862565,1,0,1,1137,341,341,0
"bbc5139ca9024389a94db3a6f47dcff6","4ee6ca9019ab4a1ab323f98094a9bd77",22862565,1,2,0,1138,341,343,2
"4ee6ca9019ab4a1ab323f98094a9bd77","4ee6ca9019ab4a1ab323f98094a9bd77",22862565,5,0,1,1139,343,343,0
"4ee6ca9019ab4a1ab323f98094a9bd77","b37947176785476f8b29d49a851366dc",22862565,1,1,0,1144,343,344,1
"b37947176785476f8b29d49a851366dc","b37947176785476f8b29d49a851366dc",22862565,2,0,1,1145,344,344,0
"b37947176785476f8b29d49a851366dc","fcea5b10d5a14a3b9324ffece8f6e1e5",22862565,1,1,0,1147,344,345,1
"fcea5b10d5a14a3b9324ffece8f6e1e5","fcea5b10d5a14a3b9324ffece8f6e1e5",22862565,2,0,1,1148,345,345,0
"fcea5b10d5a14a3b9324ffece8f6e1e5","c2490bc612d146edbe786556fab3651b",22862565,1,-5,0,1150,345,340,-5
"c2490bc612d146edbe786556fab3651b","6ac8bb048b854999a47edb35fe627f11",22862565,1,8,0,1151,340,347,7
"6ac8bb048b854999a47edb35fe627f11","6ac8bb048b854999a47edb35fe627f11",22862565,1,0,1,1152,347,347,0
"6ac8bb048b854999a47edb35fe627f11","0c4079457ede49e3aeb5e86ed84bdf35",22862565,1,-21,0,1153,347,329,-18
"0c4079457ede49e3aeb5e86ed84bdf35","30ead9794d4847abaf222ca966cc8630",22862565,1,24,0,1154,329,348,19
"30ead9794d4847abaf222ca966cc8630","897b7f51242c44aab2205c72fdcbf4cd",22862565,1,4,0,1155,348,352,4
"897b7f51242c44aab2205c72fdcbf4cd","09b9678ddc3d452ea4a3d46e15826065",22862565,2,1,0,1156,352,353,1
"09b9678ddc3d452ea4a3d46e15826065","c20993c944444fe085345591a8bd837e",22862565,1,-2,0,1157,353,351,-2
"c20993c944444fe085345591a8bd837e","eff0de7f2dbb42dfa1a2e686efab5b6d",22862565,1,3,0,1158,351,354,3
"eff0de7f2dbb42dfa1a2e686efab5b6d","c20993c944444fe085345591a8bd837e",22862565,1,-3,0,1159,354,351,-3
"c20993c944444fe085345591a8bd837e","c20993c944444fe085345591a8bd837e",22862565,3,0,1,1160,351,351,0
"c20993c944444fe085345591a8bd837e","897b7f51242c44aab2205c72fdcbf4cd",22862565,1,1,0,1163,351,352,1
"897b7f51242c44aab2205c72fdcbf4cd","897b7f51242c44aab2205c72fdcbf4cd",22862565,3,0,1,1164,352,352,0
"09b9678ddc3d452ea4a3d46e15826065","09b9678ddc3d452ea4a3d46e15826065",22862565,3,0,1,1168,353,353,0
"09b9678ddc3d452ea4a3d46e15826065","eff0de7f2dbb42dfa1a2e686efab5b6d",22862565,1,1,0,1171,353,354,1
"eff0de7f2dbb42dfa1a2e686efab5b6d","eff0de7f2dbb42dfa1a2e686efab5b6d",22862565,3,0,1,1172,354,354,0
"eff0de7f2dbb42dfa1a2e686efab5b6d","30ead9794d4847abaf222ca966cc8630",22862565,1,-6,0,1175,354,348,-6
"30ead9794d4847abaf222ca966cc8630","2fe14166dc9642c3bc666b86a57f943d",22862565,1,10,0,1176,348,357,9
"2fe14166dc9642c3bc666b86a57f943d","2fe14166dc9642c3bc666b86a57f943d",22862565,7,0,1,1177,357,357,0
"2fe14166dc9642c3bc666b86a57f943d","44421dd1e13a47a388c4a19834b744c7",22862565,1,2,0,1184,357,359,2
"44421dd1e13a47a388c4a19834b744c7","44421dd1e13a47a388c4a19834b744c7",22862565,2,0,1,1185,359,359,0
"44421dd1e13a47a388c4a19834b744c7","cb5fc7ef85d547c4be1a7439d0bf6052",22862565,1,1,0,1187,359,360,1
"cb5fc7ef85d547c4be1a7439d0bf6052","cb5fc7ef85d547c4be1a7439d0bf6052",22862565,5,0,1,1188,360,360,0
"cb5fc7ef85d547c4be1a7439d0bf6052","0a8f150a4cf747acbde62f4721823da3",22862565,1,1,0,1193,360,361,1
"0a8f150a4cf747acbde62f4721823da3","0a8f150a4cf747acbde62f4721823da3",22862565,2,0,1,1194,361,361,0
"0a8f150a4cf747acbde62f4721823da3","ab8fdad974ae471f9f24c3f9dd04462e",22862565,1,1,0,1196,361,362,1
"ab8fdad974ae471f9f24c3f9dd04462e","ab8fdad974ae471f9f24c3f9dd04462e",22862565,2,0,1,1197,362,362,0
"ab8fdad974ae471f9f24c3f9dd04462e","52580888dadb4fe3baa795683ea227bd",22862565,1,3,0,1199,362,364,2
"52580888dadb4fe3baa795683ea227bd","1ba8fef685d74a8194b9db252eb704fb",22862565,1,-10,0,1200,364,355,-9
"1ba8fef685d74a8194b9db252eb704fb","52580888dadb4fe3baa795683ea227bd",22862565,1,10,0,1201,355,364,9
"52580888dadb4fe3baa795683ea227bd","52580888dadb4fe3baa795683ea227bd",22862565,1,0,1,1202,364,364,0
"52580888dadb4fe3baa795683ea227bd","f00179e251a045b39c3f7a54f9aa4acc",22862565,1,-1,0,1203,364,363,-1
"f00179e251a045b39c3f7a54f9aa4acc","492a3bc6a1254f23a7998587961b22a4",22862565,1,4,0,1204,363,366,3
"492a3bc6a1254f23a7998587961b22a4","492a3bc6a1254f23a7998587961b22a4",22862565,1,0,1,1205,366,366,0
"492a3bc6a1254f23a7998587961b22a4","072a190fd302456290895f9f04d6940a",22862565,1,-1,0,1206,366,365,-1
"072a190fd302456290895f9f04d6940a","cfa457d1743848e4bb5e4beced6448ed",22862565,1,5,0,1207,365,369,4
"cfa457d1743848e4bb5e4beced6448ed","cfa457d1743848e4bb5e4beced6448ed",22862565,3,0,1,1208,369,369,0
"cfa457d1743848e4bb5e4beced6448ed","30ead9794d4847abaf222ca966cc8630",22862565,1,-25,0,1211,369,348,-21
"30ead9794d4847abaf222ca966cc8630","b71bac264efb4abd97015447bd490db6",22862565,2,28,0,1212,348,370,22
"b71bac264efb4abd97015447bd490db6","b71bac264efb4abd97015447bd490db6",22862565,2,0,1,1213,370,370,0
"b71bac264efb4abd97015447bd490db6","30ead9794d4847abaf222ca966cc8630",22862565,1,-28,0,1215,370,348,-22
"30ead9794d4847abaf222ca966cc8630","30ead9794d4847abaf222ca966cc8630",22862565,1,0,1,1216,348,348,0
"b71bac264efb4abd97015447bd490db6","8d448d625b024c82a5eb240bbd7431d6",22862565,2,5,0,1218,370,374,4
"8d448d625b024c82a5eb240bbd7431d6","8d448d625b024c82a5eb240bbd7431d6",22862565,51,0,1,1219,374,374,0
"8d448d625b024c82a5eb240bbd7431d6","b71bac264efb4abd97015447bd490db6",22862565,2,-5,0,1220,374,370,-4
"b71bac264efb4abd97015447bd490db6","d6d02b6ef04e4f17805504500b8ce441",22862565,1,8,0,1273,370,375,5
"d6d02b6ef04e4f17805504500b8ce441","d6d02b6ef04e4f17805504500b8ce441",22862565,2,0,1,1274,375,375,0
"d6d02b6ef04e4f17805504500b8ce441","66baf19b6b904b70922329068c63746d",22862565,1,4,0,1276,375,376,1
"66baf19b6b904b70922329068c63746d","7f544639412e40a9ba27f43b415362ab",22862565,3,2,0,1277,376,378,2
"7f544639412e40a9ba27f43b415362ab","66baf19b6b904b70922329068c63746d",22862565,2,-2,0,1278,378,376,-2
"7f544639412e40a9ba27f43b415362ab","7f544639412e40a9ba27f43b415362ab",22862565,1,0,1,1280,378,378,0
"7f544639412e40a9ba27f43b415362ab","d5ae8642e15b46b8bd298b02274d4e9c",22862565,1,2,0,1281,378,380,2
"d5ae8642e15b46b8bd298b02274d4e9c","d5ae8642e15b46b8bd298b02274d4e9c",22862565,1,0,1,1282,380,380,0
"d5ae8642e15b46b8bd298b02274d4e9c","a0d10309a2dd456289147f84be9d37f9",22862565,1,1,0,1283,380,381,1
"a0d10309a2dd456289147f84be9d37f9","a0d10309a2dd456289147f84be9d37f9",22862565,2,0,1,1284,381,381,0
"a0d10309a2dd456289147f84be9d37f9","0fcbc3ca07b144138b8d85da581f09a8",22862565,1,1,0,1286,381,382,1
"0fcbc3ca07b144138b8d85da581f09a8","0fcbc3ca07b144138b8d85da581f09a8",22862565,5,0,1,1287,382,382,0
"0fcbc3ca07b144138b8d85da581f09a8","66baf19b6b904b70922329068c63746d",22862565,1,-6,0,1292,382,376,-6
"66baf19b6b904b70922329068c63746d","c2fca3669923477ab966ded303dea31c",22862565,1,8,0,1293,376,383,7
"c2fca3669923477ab966ded303dea31c","4890121ce5d74576b4632b77cfc23398",22862565,1,6,0,1294,383,388,5
"4890121ce5d74576b4632b77cfc23398","4890121ce5d74576b4632b77cfc23398",22862565,1,0,1,1295,388,388,0
"4890121ce5d74576b4632b77cfc23398","18d3b836dd804224883cc9180b60a8e1",22862565,1,-1,0,1296,388,387,-1
"18d3b836dd804224883cc9180b60a8e1","96bb2b3e85a34d8b9544514e89f6fe97",22862565,1,4,0,1297,387,390,3
"96bb2b3e85a34d8b9544514e89f6fe97","96bb2b3e85a34d8b9544514e89f6fe97",22862565,6,0,1,1298,390,390,0
"96bb2b3e85a34d8b9544514e89f6fe97","ac4e9b54acfe4670b4634859c7263cb5",22862565,1,2,0,1300,390,392,2
"ac4e9b54acfe4670b4634859c7263cb5","ac4e9b54acfe4670b4634859c7263cb5",22862565,1,0,1,1301,392,392,0
"ac4e9b54acfe4670b4634859c7263cb5","17f95d18bab743888e1736033dc3384d",22862565,1,-3,0,1302,392,389,-3
"17f95d18bab743888e1736033dc3384d","6f8881a745ac4c358a68b92c3b4abe81",22862565,3,6,0,1303,389,394,5
"6f8881a745ac4c358a68b92c3b4abe81","f7002c8484354eceac57bc7bd62c76c1",22862565,3,-1,0,1304,394,393,-1
"f7002c8484354eceac57bc7bd62c76c1","96bb2b3e85a34d8b9544514e89f6fe97",22862565,1,-4,0,1305,393,390,-3
"96bb2b3e85a34d8b9544514e89f6fe97","17f95d18bab743888e1736033dc3384d",22862565,4,-1,0,1309,390,389,-1
"6f8881a745ac4c358a68b92c3b4abe81","6f8881a745ac4c358a68b92c3b4abe81",22862565,1,0,1,1311,394,394,0
"f7002c8484354eceac57bc7bd62c76c1","66baf19b6b904b70922329068c63746d",22862565,1,-21,0,1313,393,376,-17
"66baf19b6b904b70922329068c63746d","0c12af0a4e7f4002852cf84b2537c161",22862565,1,24,0,1316,376,395,19
"0c12af0a4e7f4002852cf84b2537c161","df8191ec5e584c838a899c378941a566",22862565,1,4,0,1317,395,398,3
"df8191ec5e584c838a899c378941a566","687055dad9fc40c3982478fe33ec01bf",22862565,1,25,0,1318,398,414,16
"687055dad9fc40c3982478fe33ec01bf","2b09a08242b54983aec7063990fb3f66",22862565,1,-21,0,1319,414,400,-14
"2b09a08242b54983aec7063990fb3f66","17f95d18bab743888e1736033dc3384d",22862565,1,-16,0,1320,400,389,-11
"17f95d18bab743888e1736033dc3384d","66baf19b6b904b70922329068c63746d",22862565,2,-16,0,1321,389,376,-13
"66baf19b6b904b70922329068c63746d","96bb2b3e85a34d8b9544514e89f6fe97",22862565,3,17,0,1322,376,390,14
"f7002c8484354eceac57bc7bd62c76c1","44a277ea44dc4ae689fab4b82f0b4098",22862565,1,5,0,1327,393,397,4
"44a277ea44dc4ae689fab4b82f0b4098","44a277ea44dc4ae689fab4b82f0b4098",22862565,1,0,1,1328,397,397,0
"44a277ea44dc4ae689fab4b82f0b4098","0c12af0a4e7f4002852cf84b2537c161",22862565,1,-2,0,1329,397,395,-2
"0c12af0a4e7f4002852cf84b2537c161","66baf19b6b904b70922329068c63746d",22862565,1,-24,0,1330,395,376,-19
"17f95d18bab743888e1736033dc3384d","859e0b8d71694b12befb69ee698138f9",22862565,1,13,0,1336,389,399,10
"859e0b8d71694b12befb69ee698138f9","859e0b8d71694b12befb69ee698138f9",22862565,1,0,1,1337,399,399,0
"859e0b8d71694b12befb69ee698138f9","66baf19b6b904b70922329068c63746d",22862565,1,-29,0,1338,399,376,-23
"66baf19b6b904b70922329068c63746d","2b09a08242b54983aec7063990fb3f66",22862565,1,32,0,1339,376,400,24
"2b09a08242b54983aec7063990fb3f66","2b09a08242b54983aec7063990fb3f66",22862565,6,0,1,1340,400,400,0
"2b09a08242b54983aec7063990fb3f66","1f471b7a883a4df48211e8c6a81b59a7",22862565,1,1,0,1346,400,401,1
"1f471b7a883a4df48211e8c6a81b59a7","1f471b7a883a4df48211e8c6a81b59a7",22862565,1,0,1,1347,401,401,0
"1f471b7a883a4df48211e8c6a81b59a7","2b09a08242b54983aec7063990fb3f66",22862565,1,-1,0,1348,401,400,-1
"2b09a08242b54983aec7063990fb3f66","9de0d567bfa84fe5b77cb76f4a76a5d1",22862565,1,5,0,1349,400,404,4
"9de0d567bfa84fe5b77cb76f4a76a5d1","9de0d567bfa84fe5b77cb76f4a76a5d1",22862565,1,0,1,1350,404,404,0
"9de0d567bfa84fe5b77cb76f4a76a5d1","1157bd665ec4472fb58b751dc5099355",22862565,1,-1,0,1351,404,403,-1
"1157bd665ec4472fb58b751dc5099355","58fc9094275e4c49be3f4ba6d4acc0a4",22862565,1,5,0,1352,403,406,3
"58fc9094275e4c49be3f4ba6d4acc0a4","58fc9094275e4c49be3f4ba6d4acc0a4",22862565,1,0,1,1353,406,406,0
"58fc9094275e4c49be3f4ba6d4acc0a4","3c8a22d2f9c146ea956609e3ed4f2559",22862565,2,-2,0,1354,406,405,-1
"3c8a22d2f9c146ea956609e3ed4f2559","58fc9094275e4c49be3f4ba6d4acc0a4",22862565,2,2,0,1355,405,406,1
"58fc9094275e4c49be3f4ba6d4acc0a4","c1c1be90b2b14c1ab4a5e1ee3c241902",22862565,1,1,0,1358,406,407,1
"c1c1be90b2b14c1ab4a5e1ee3c241902","c1c1be90b2b14c1ab4a5e1ee3c241902",22862565,5,0,1,1359,407,407,0
"c1c1be90b2b14c1ab4a5e1ee3c241902","58fc9094275e4c49be3f4ba6d4acc0a4",22862565,1,-1,0,1364,407,406,-1
"58fc9094275e4c49be3f4ba6d4acc0a4","02b3a1bead9244c1ba2f857c7da8f82a",22862565,1,3,0,1365,406,408,2
"02b3a1bead9244c1ba2f857c7da8f82a","02b3a1bead9244c1ba2f857c7da8f82a",22862565,1,0,1,1366,408,408,0
"02b3a1bead9244c1ba2f857c7da8f82a","6206fc6479014bb193084c32409dc1b9",22862565,1,1,0,1367,408,409,1
"6206fc6479014bb193084c32409dc1b9","6206fc6479014bb193084c32409dc1b9",22862565,1,0,1,1368,409,409,0
"6206fc6479014bb193084c32409dc1b9","02b3a1bead9244c1ba2f857c7da8f82a",22862565,1,-1,0,1369,409,408,-1
"02b3a1bead9244c1ba2f857c7da8f82a","6a5f020451db426dacba9e2ea3fcc62a",22862565,1,3,0,1370,408,410,2
"6a5f020451db426dacba9e2ea3fcc62a","6a5f020451db426dacba9e2ea3fcc62a",22862565,5,0,1,1371,410,410,0
"6a5f020451db426dacba9e2ea3fcc62a","33a9d248b2e44588a5b07fc1342b9bc2",22862565,1,2,0,1376,410,411,1
"33a9d248b2e44588a5b07fc1342b9bc2","33a9d248b2e44588a5b07fc1342b9bc2",22862565,2,0,1,1377,411,411,0
"33a9d248b2e44588a5b07fc1342b9bc2","c6f26bd420634f1cb7989e76fe6b16c0",22862565,1,1,0,1379,411,412,1
"c6f26bd420634f1cb7989e76fe6b16c0","c6f26bd420634f1cb7989e76fe6b16c0",22862565,5,0,1,1380,412,412,0
"c6f26bd420634f1cb7989e76fe6b16c0","2a65ee6e2ac64f6a8a55fbe5373ec763",22862565,1,1,0,1385,412,413,1
"2a65ee6e2ac64f6a8a55fbe5373ec763","2a65ee6e2ac64f6a8a55fbe5373ec763",22862565,2,0,1,1386,413,413,0
"2a65ee6e2ac64f6a8a55fbe5373ec763","33a9d248b2e44588a5b07fc1342b9bc2",22862565,1,-2,0,1388,413,411,-2
"33a9d248b2e44588a5b07fc1342b9bc2","1fd0f6dadbc14ebc965faf6122190b96",22862565,1,5,0,1389,411,415,4
"1fd0f6dadbc14ebc965faf6122190b96","1fd0f6dadbc14ebc965faf6122190b96",22862565,1,0,1,1390,415,415,0
"1fd0f6dadbc14ebc965faf6122190b96","687055dad9fc40c3982478fe33ec01bf",22862565,1,-1,0,1391,415,414,-1
"687055dad9fc40c3982478fe33ec01bf","2add1669f08d4101913db15f8c23b3b7",22862565,1,3,0,1392,414,416,2
"2add1669f08d4101913db15f8c23b3b7","2add1669f08d4101913db15f8c23b3b7",22862565,1,0,1,1393,416,416,0
"2add1669f08d4101913db15f8c23b3b7","2b09a08242b54983aec7063990fb3f66",22862565,1,-24,0,1394,416,400,-16
"2b09a08242b54983aec7063990fb3f66","a2b4bd40cee2481ebd3fc179d6a5cd62",22862565,1,27,0,1395,400,417,17
"a2b4bd40cee2481ebd3fc179d6a5cd62","e34e59dce2204f228f3a84b6725df60f",22862565,1,2,0,1396,417,419,2
"e34e59dce2204f228f3a84b6725df60f","e34e59dce2204f228f3a84b6725df60f",22862565,1,0,1,1397,419,419,0
"e34e59dce2204f228f3a84b6725df60f","a2b4bd40cee2481ebd3fc179d6a5cd62",22862565,1,-2,0,1398,419,417,-2
"a2b4bd40cee2481ebd3fc179d6a5cd62","bec48fc2e1294c7eb3d0aca780d731b8",22862565,3,4,0,1399,417,420,3
"bec48fc2e1294c7eb3d0aca780d731b8","bec48fc2e1294c7eb3d0aca780d731b8",22862565,7,0,1,1400,420,420,0
"bec48fc2e1294c7eb3d0aca780d731b8","dbde19fcce2a4c1abdc7f685c293a23f",22862565,3,3,0,1402,420,422,2
"dbde19fcce2a4c1abdc7f685c293a23f","a24600b0e49245f6bdba8c893cfeddb0",22862565,2,4,0,1403,422,425,3
"a24600b0e49245f6bdba8c893cfeddb0","a24600b0e49245f6bdba8c893cfeddb0",22862565,3,0,1,1404,425,425,0
"a24600b0e49245f6bdba8c893cfeddb0","a2b4bd40cee2481ebd3fc179d6a5cd62",22862565,3,-11,0,1406,425,417,-8
"a2b4bd40cee2481ebd3fc179d6a5cd62","24cf8786024543f19b89bc20034e60d7",22862565,6,18,0,1407,417,428,11
"24cf8786024543f19b89bc20034e60d7","f2a73be2f46840b182d7bd095378004e",22862565,3,1,0,1408,428,429,1
"f2a73be2f46840b182d7bd095378004e","24cf8786024543f19b89bc20034e60d7",22862565,1,-1,0,1409,429,428,-1
"24cf8786024543f19b89bc20034e60d7","a2b4bd40cee2481ebd3fc179d6a5cd62",22862565,2,-18,0,1410,428,417,-11
"a2b4bd40cee2481ebd3fc179d6a5cd62","a2b4bd40cee2481ebd3fc179d6a5cd62",22862565,3,0,1,1411,417,417,0
"f2a73be2f46840b182d7bd095378004e","f2a73be2f46840b182d7bd095378004e",22862565,1,0,1,1415,429,429,0
"f2a73be2f46840b182d7bd095378004e","604551fd4266430cb860fef58fa7dd61",22862565,1,1,0,1416,429,430,1
"604551fd4266430cb860fef58fa7dd61","604551fd4266430cb860fef58fa7dd61",22862565,1,0,1,1417,430,430,0
"604551fd4266430cb860fef58fa7dd61","24cf8786024543f19b89bc20034e60d7",22862565,1,-2,0,1418,430,428,-2
"24cf8786024543f19b89bc20034e60d7","dce46f8904594a62a6377a3587aaa663",22862565,1,4,0,1419,428,431,3
"dce46f8904594a62a6377a3587aaa663","dce46f8904594a62a6377a3587aaa663",22862565,2,0,1,1420,431,431,0
"dce46f8904594a62a6377a3587aaa663","9b9d0a249052413c869753b99682b0ac",22862565,1,1,0,1422,431,432,1
"9b9d0a249052413c869753b99682b0ac","9b9d0a249052413c869753b99682b0ac",22862565,3,0,1,1423,432,432,0
"9b9d0a249052413c869753b99682b0ac","061c175cc90f45fbad883025394e78dd",22862565,1,1,0,1426,432,433,1
"061c175cc90f45fbad883025394e78dd","061c175cc90f45fbad883025394e78dd",22862565,4,0,1,1427,433,433,0
"061c175cc90f45fbad883025394e78dd","dce46f8904594a62a6377a3587aaa663",22862565,1,-2,0,1431,433,431,-2
"dce46f8904594a62a6377a3587aaa663","74a7f8712e5449c2bc0b43c6f90dafed",22862565,1,5,0,1432,431,435,4
"74a7f8712e5449c2bc0b43c6f90dafed","74a7f8712e5449c2bc0b43c6f90dafed",22862565,1,0,1,1433,435,435,0
"74a7f8712e5449c2bc0b43c6f90dafed","66ada10dde9f43018588f1ced9d477fc",22862565,1,-1,0,1434,435,434,-1
"66ada10dde9f43018588f1ced9d477fc","bf12c96466d840a69bed7020b3f18bb8",22862565,1,3,0,1435,434,436,2
"bf12c96466d840a69bed7020b3f18bb8","bf12c96466d840a69bed7020b3f18bb8",22862565,1,0,1,1436,436,436,0
"bf12c96466d840a69bed7020b3f18bb8","070600601c4c439288445d2f0724807d",22862565,1,3,0,1437,436,437,1
"070600601c4c439288445d2f0724807d","24cf8786024543f19b89bc20034e60d7",22862565,1,-14,0,1438,437,428,-9
"24cf8786024543f19b89bc20034e60d7","1823b6de7d334a7aaabc4570719af4d9",22862565,1,16,0,1439,428,439,11
"1823b6de7d334a7aaabc4570719af4d9","1823b6de7d334a7aaabc4570719af4d9",22862565,11,0,1,1440,439,439,0
"1823b6de7d334a7aaabc4570719af4d9","070600601c4c439288445d2f0724807d",22862565,1,-2,0,1451,439,437,-2
"070600601c4c439288445d2f0724807d","0380cd76a7d44bc3a4da1f15e4d68f89",22862565,1,4,0,1452,437,440,3
"0380cd76a7d44bc3a4da1f15e4d68f89","0380cd76a7d44bc3a4da1f15e4d68f89",22862565,1,0,1,1453,440,440,0
"0380cd76a7d44bc3a4da1f15e4d68f89","23b7673c8b5443108c2ef09382834a86",22862565,2,2,0,1454,440,441,1
"23b7673c8b5443108c2ef09382834a86","0380cd76a7d44bc3a4da1f15e4d68f89",22862565,1,-2,0,1455,441,440,-1
"23b7673c8b5443108c2ef09382834a86","23b7673c8b5443108c2ef09382834a86",22862565,1,0,1,1457,441,441,0
"23b7673c8b5443108c2ef09382834a86","901e92500aea43c79f19f1b279050668",22862565,1,2,0,1458,441,442,1
"901e92500aea43c79f19f1b279050668","901e92500aea43c79f19f1b279050668",22862565,1,0,1,1459,442,442,0
"901e92500aea43c79f19f1b279050668","001339db8ced4cf78829ebe8b145449d",22862565,1,1,0,1460,442,443,1
"001339db8ced4cf78829ebe8b145449d","001339db8ced4cf78829ebe8b145449d",22862565,8,0,1,1461,443,443,0
"001339db8ced4cf78829ebe8b145449d","452745e0366e42ae81561bfddebcc6c3",22862565,1,1,0,1469,443,444,1
"452745e0366e42ae81561bfddebcc6c3","452745e0366e42ae81561bfddebcc6c3",22862565,5,0,1,1470,444,444,0
"452745e0366e42ae81561bfddebcc6c3","901e92500aea43c79f19f1b279050668",22862565,1,-2,0,1475,444,442,-2
"901e92500aea43c79f19f1b279050668","4660ff2089114e8db82ceb26a4f329e3",22862565,1,4,0,1476,442,445,3
"4660ff2089114e8db82ceb26a4f329e3","4660ff2089114e8db82ceb26a4f329e3",22862565,2,0,1,1477,445,445,0
"4660ff2089114e8db82ceb26a4f329e3","7bd5586eb9d8484eb74a433ee7bfe499",22862565,1,2,0,1479,445,446,1
"7bd5586eb9d8484eb74a433ee7bfe499","7bd5586eb9d8484eb74a433ee7bfe499",22862565,15,0,1,1480,446,446,0
"7bd5586eb9d8484eb74a433ee7bfe499","8a7f26e690f34dda97be16904518ca99",22862565,1,2,0,1495,446,447,1
"8a7f26e690f34dda97be16904518ca99","8a7f26e690f34dda97be16904518ca99",22862565,1,0,1,1496,447,447,0
"8a7f26e690f34dda97be16904518ca99","b2f0d654738f48158edff28e8d3a546e",22862565,1,5,0,1497,447,449,2
"b2f0d654738f48158edff28e8d3a546e","070600601c4c439288445d2f0724807d",22862565,2,-21,0,1498,449,437,-12
"070600601c4c439288445d2f0724807d","b2f0d654738f48158edff28e8d3a546e",22862565,2,21,0,1499,437,449,12
"b2f0d654738f48158edff28e8d3a546e","f60ee41ec635499abd48168342d32c2f",22862565,4,5,0,1500,449,453,4
"f60ee41ec635499abd48168342d32c2f","f60ee41ec635499abd48168342d32c2f",22862565,62,0,1,1501,453,453,0
"f60ee41ec635499abd48168342d32c2f","9428d8bd9c5a47b2a235b254e5e27ded",22862565,2,-1,0,1508,453,452,-1
"9428d8bd9c5a47b2a235b254e5e27ded","070600601c4c439288445d2f0724807d",22862565,1,-25,0,1509,452,437,-15
"070600601c4c439288445d2f0724807d","78adeee1fa2c4fe0bc73f7bca9fcee86",22862565,1,-387,0,1512,437,160,-277
"78adeee1fa2c4fe0bc73f7bca9fcee86","78adeee1fa2c4fe0bc73f7bca9fcee86",22862565,5,0,1,1513,160,160,0
"78adeee1fa2c4fe0bc73f7bca9fcee86","65202579580f4ad38d734b4ee39d22a8",22862565,6,5,0,1515,160,164,4
"65202579580f4ad38d734b4ee39d22a8","65202579580f4ad38d734b4ee39d22a8",22862565,71,0,1,1516,164,164,0
"65202579580f4ad38d734b4ee39d22a8","78adeee1fa2c4fe0bc73f7bca9fcee86",22862565,6,-5,0,1545,164,160,-4
"78adeee1fa2c4fe0bc73f7bca9fcee86","3cbcea2be0984e7dbd5a48195af10ce7",22862565,2,8,0,1546,160,165,5
"3cbcea2be0984e7dbd5a48195af10ce7","82e6285962b8400d9d6fc32436022a94",22862565,3,2,0,1547,165,167,2
"82e6285962b8400d9d6fc32436022a94","b2f0d654738f48158edff28e8d3a546e",22862565,1,398,0,1548,167,449,282
"f60ee41ec635499abd48168342d32c2f","b2f0d654738f48158edff28e8d3a546e",22862565,2,-5,0,1551,453,449,-4
"9428d8bd9c5a47b2a235b254e5e27ded","f60ee41ec635499abd48168342d32c2f",22862565,1,1,0,1559,452,453,1
"f60ee41ec635499abd48168342d32c2f","f67fbf45a5f146ed866965bc57c7c001",22862565,1,3,0,1611,453,454,1
"f67fbf45a5f146ed866965bc57c7c001","b2f0d654738f48158edff28e8d3a546e",22862565,1,-8,0,1612,454,449,-5
"b2f0d654738f48158edff28e8d3a546e","f67fbf45a5f146ed866965bc57c7c001",22862565,1,8,0,1613,449,454,5
"f67fbf45a5f146ed866965bc57c7c001","f67fbf45a5f146ed866965bc57c7c001",22862565,1,0,1,1614,454,454,0
"f67fbf45a5f146ed866965bc57c7c001","d937afe49bd24a07a550dda1c1155122",22862565,1,1,0,1615,454,455,1
"d937afe49bd24a07a550dda1c1155122","d937afe49bd24a07a550dda1c1155122",22862565,3,0,1,1616,455,455,0
"d937afe49bd24a07a550dda1c1155122","3628b3f7823443d0912a339096b69943",22862565,1,1,0,1619,455,456,1
"3628b3f7823443d0912a339096b69943","3628b3f7823443d0912a339096b69943",22862565,1,0,1,1620,456,456,0
"3628b3f7823443d0912a339096b69943","9e049ee647cf43ecbcb5ed792a8e7588",22862565,1,1,0,1621,456,457,1
"9e049ee647cf43ecbcb5ed792a8e7588","9e049ee647cf43ecbcb5ed792a8e7588",22862565,1,0,1,1622,457,457,0
"9e049ee647cf43ecbcb5ed792a8e7588","5256a214faaf410b93f76cea06428334",22862565,1,1,0,1623,457,458,1
"5256a214faaf410b93f76cea06428334","5256a214faaf410b93f76cea06428334",22862565,1,0,1,1624,458,458,0
"5256a214faaf410b93f76cea06428334","25c32b120fce40fa9b6c85133aeb4716",22862565,1,1,0,1625,458,459,1
"25c32b120fce40fa9b6c85133aeb4716","25c32b120fce40fa9b6c85133aeb4716",22862565,3,0,1,1626,459,459,0
"25c32b120fce40fa9b6c85133aeb4716","11bc14f2204949008b7d511b933363c1",22862565,1,1,0,1629,459,460,1
"11bc14f2204949008b7d511b933363c1","11bc14f2204949008b7d511b933363c1",22862565,1,0,1,1630,460,460,0
"11bc14f2204949008b7d511b933363c1","42de338840a34d15adb66e7b14fb9d2c",22862565,1,1,0,1631,460,461,1
"42de338840a34d15adb66e7b14fb9d2c","42de338840a34d15adb66e7b14fb9d2c",22862565,1,0,1,1632,461,461,0
"42de338840a34d15adb66e7b14fb9d2c","9da37c6210b1416b8079c274f70bf600",22862565,1,1,0,1633,461,462,1
"9da37c6210b1416b8079c274f70bf600","9da37c6210b1416b8079c274f70bf600",22862565,1,0,1,1634,462,462,0
"9da37c6210b1416b8079c274f70bf600","519119f1deac45ff9ab4f13529be5c6e",22862565,1,1,0,1635,462,463,1
"519119f1deac45ff9ab4f13529be5c6e","519119f1deac45ff9ab4f13529be5c6e",22862565,1,0,1,1636,463,463,0
"519119f1deac45ff9ab4f13529be5c6e","f67fbf45a5f146ed866965bc57c7c001",22862565,1,-9,0,1637,463,454,-9
"f67fbf45a5f146ed866965bc57c7c001","c5df9f40ec14463b9dcfdc73df3e9285",22862565,1,12,0,1638,454,464,10
"c5df9f40ec14463b9dcfdc73df3e9285","c5df9f40ec14463b9dcfdc73df3e9285",22862565,4,0,1,1639,464,464,0
"c5df9f40ec14463b9dcfdc73df3e9285","83d42d95cd844fc093fc09cee250edb8",22862565,1,3,0,1641,464,465,1
"83d42d95cd844fc093fc09cee250edb8","83d42d95cd844fc093fc09cee250edb8",22862565,3,0,1,1642,465,465,0
"83d42d95cd844fc093fc09cee250edb8","bec48fc2e1294c7eb3d0aca780d731b8",22862565,1,-72,0,1645,465,420,-45
"bec48fc2e1294c7eb3d0aca780d731b8","a2b4bd40cee2481ebd3fc179d6a5cd62",22862565,1,-4,0,1646,420,417,-3
"dbde19fcce2a4c1abdc7f685c293a23f","bec48fc2e1294c7eb3d0aca780d731b8",22862565,1,-3,0,1653,422,420,-2
"24cf8786024543f19b89bc20034e60d7","a24600b0e49245f6bdba8c893cfeddb0",22862565,1,-7,0,1658,428,425,-3
"24cf8786024543f19b89bc20034e60d7","3fec92ad186c423d818a522c6ce08604",22862565,1,-13,0,1661,428,421,-7
"3fec92ad186c423d818a522c6ce08604","3fec92ad186c423d818a522c6ce08604",22862565,1,0,1,1662,421,421,0
"3fec92ad186c423d818a522c6ce08604","a2b4bd40cee2481ebd3fc179d6a5cd62",22862565,1,-5,0,1663,421,417,-4
"bec48fc2e1294c7eb3d0aca780d731b8","a24600b0e49245f6bdba8c893cfeddb0",22862565,1,7,0,1666,420,425,5
"a24600b0e49245f6bdba8c893cfeddb0","dbde19fcce2a4c1abdc7f685c293a23f",22862565,1,-4,0,1668,425,422,-3
"dbde19fcce2a4c1abdc7f685c293a23f","a2b4bd40cee2481ebd3fc179d6a5cd62",22862565,1,-7,0,1669,422,417,-5
"24cf8786024543f19b89bc20034e60d7","24cf8786024543f19b89bc20034e60d7",22862565,1,0,1,1671,428,428,0
"f2a73be2f46840b182d7bd095378004e","c5df9f40ec14463b9dcfdc73df3e9285",22862565,1,54,0,1676,429,464,35
"c5df9f40ec14463b9dcfdc73df3e9285","c33c17be71ae4d588da7369472e5bb1b",22862565,1,-596,0,1679,464,34,-430
"c33c17be71ae4d588da7369472e5bb1b","c33c17be71ae4d588da7369472e5bb1b",22862565,2,0,1,1680,34,34,0
"c33c17be71ae4d588da7369472e5bb1b","93679be414554a11b1893002f2229a93",22862565,5,3,0,1682,34,35,1
"93679be414554a11b1893002f2229a93","93679be414554a11b1893002f2229a93",22862565,1,0,1,1683,35,35,0
"93679be414554a11b1893002f2229a93","7040a13096d746ac84b8fac8d9752058",22862565,3,3,0,1684,35,36,1
"7040a13096d746ac84b8fac8d9752058","7040a13096d746ac84b8fac8d9752058",22862565,2,0,1,1685,36,36,0
"7040a13096d746ac84b8fac8d9752058","9a0dc646f934470daf08c4b56ccf73db",22862565,3,3,0,1686,36,37,1
"9a0dc646f934470daf08c4b56ccf73db","9a0dc646f934470daf08c4b56ccf73db",22862565,1,0,1,1687,37,37,0
"9a0dc646f934470daf08c4b56ccf73db","fc0e049d56024bc9a02c9a9c435c3df7",22862565,2,3,0,1688,37,38,1
"fc0e049d56024bc9a02c9a9c435c3df7","fc0e049d56024bc9a02c9a9c435c3df7",22862565,1,0,1,1689,38,38,0
"fc0e049d56024bc9a02c9a9c435c3df7","67a089198fcb4e1c8f2385786c2b296f",22862565,1,4,0,1690,38,39,1
"67a089198fcb4e1c8f2385786c2b296f","67a089198fcb4e1c8f2385786c2b296f",22886094,2,0,1,1,39,39,0
"67a089198fcb4e1c8f2385786c2b296f","b613861cecf84ffcab01afb23f660475",22886094,1,-72,0,2,39,1,-38
"b613861cecf84ffcab01afb23f660475","b613861cecf84ffcab01afb23f660475",22886094,4,0,1,3,1,1,0
"b613861cecf84ffcab01afb23f660475","e2911e79efc2420eac45d9f671463d4b",22886094,1,3,0,7,1,2,1
"e2911e79efc2420eac45d9f671463d4b","e2911e79efc2420eac45d9f671463d4b",22886094,2,0,1,8,2,2,0
"e2911e79efc2420eac45d9f671463d4b","519d1b8c59404d67b54e96c5c8a830b2",22886094,1,1,0,10,2,3,1
"519d1b8c59404d67b54e96c5c8a830b2","519d1b8c59404d67b54e96c5c8a830b2",22886094,2,0,1,11,3,3,0
"519d1b8c59404d67b54e96c5c8a830b2","531db53f81f646edb0cdcfe0085b03b7",22886094,1,1,0,13,3,4,1
"531db53f81f646edb0cdcfe0085b03b7","531db53f81f646edb0cdcfe0085b03b7",22886094,1,0,1,14,4,4,0
"531db53f81f646edb0cdcfe0085b03b7","4f5f94b2f95141e0a9d53a61da2276da",22886094,1,1,0,15,4,5,1
"4f5f94b2f95141e0a9d53a61da2276da","4f5f94b2f95141e0a9d53a61da2276da",22886094,1,0,1,16,5,5,0
"4f5f94b2f95141e0a9d53a61da2276da","6d541c89590949f99af293c4f2333f67",22886094,1,1,0,17,5,6,1
"6d541c89590949f99af293c4f2333f67","6d541c89590949f99af293c4f2333f67",22886094,1,0,1,18,6,6,0
"6d541c89590949f99af293c4f2333f67","dd5cf0b9fe4c4f1d8f5ff8e4c04879cb",22886094,1,1,0,19,6,7,1
"dd5cf0b9fe4c4f1d8f5ff8e4c04879cb","dd5cf0b9fe4c4f1d8f5ff8e4c04879cb",22886094,8,0,1,20,7,7,0
"dd5cf0b9fe4c4f1d8f5ff8e4c04879cb","f96261861edc426abe2248be4f0a709a",22886094,1,1,0,28,7,8,1
"f96261861edc426abe2248be4f0a709a","f96261861edc426abe2248be4f0a709a",22886094,2,0,1,29,8,8,0
"f96261861edc426abe2248be4f0a709a","66b5e16f4f75454fb5b8172079f0fa83",22886094,1,1,0,31,8,9,1
"66b5e16f4f75454fb5b8172079f0fa83","66b5e16f4f75454fb5b8172079f0fa83",22886094,4,0,1,32,9,9,0
"66b5e16f4f75454fb5b8172079f0fa83","0680571d4698477995e41842c36a54b2",22886094,1,1,0,36,9,10,1
"0680571d4698477995e41842c36a54b2","0680571d4698477995e41842c36a54b2",22886094,2,0,1,37,10,10,0
"0680571d4698477995e41842c36a54b2","9112f2bffece48e08c6d2287be204085",22886094,1,1,0,39,10,11,1
"9112f2bffece48e08c6d2287be204085","9112f2bffece48e08c6d2287be204085",22886094,2,0,1,40,11,11,0
"9112f2bffece48e08c6d2287be204085","56586aa865414f538729c7f7735d2bc6",22886094,1,3,0,42,11,12,1
"56586aa865414f538729c7f7735d2bc6","e2911e79efc2420eac45d9f671463d4b",22886094,1,-12,0,43,12,2,-10
"e2911e79efc2420eac45d9f671463d4b","56586aa865414f538729c7f7735d2bc6",22886094,1,12,0,44,2,12,10
"56586aa865414f538729c7f7735d2bc6","67a089198fcb4e1c8f2385786c2b296f",22886094,1,57,0,45,12,39,27
"67a089198fcb4e1c8f2385786c2b296f","64d48c6c9c7940639a932219a6c87198",22886094,2,1,0,46,39,40,1
"64d48c6c9c7940639a932219a6c87198","56586aa865414f538729c7f7735d2bc6",22886094,1,-58,0,47,40,12,-28
"56586aa865414f538729c7f7735d2bc6","56586aa865414f538729c7f7735d2bc6",22886094,6,0,1,48,12,12,0
"56586aa865414f538729c7f7735d2bc6","b7f2b31585d94eb3bf86376714aa7070",22886094,1,2,0,54,12,13,1
"b7f2b31585d94eb3bf86376714aa7070","b7f2b31585d94eb3bf86376714aa7070",22886094,2,0,1,55,13,13,0
"b7f2b31585d94eb3bf86376714aa7070","3f1c815879794b929260d224becaff7e",22886094,1,2,0,57,13,14,1
"3f1c815879794b929260d224becaff7e","5c5ceeee4562457ba6d41515aeebfbb1",22886094,1,6,0,58,14,17,3
"5c5ceeee4562457ba6d41515aeebfbb1","81c864a886d54a6b8ff85f7d736f4f95",22886094,1,-4,0,59,17,15,-2
"b7719e26494940efa49512aedd0aac79","d4c3b003e8274e429d2fa688d73fde6d",22886094,1,3,0,65,20,22,2
"d4c3b003e8274e429d2fa688d73fde6d","d4f45188d3c84a02ba08454e6403a818",22886094,1,2,0,66,22,24,2
"d4c3b003e8274e429d2fa688d73fde6d","d4c3b003e8274e429d2fa688d73fde6d",22886094,4,0,1,68,22,22,0
"afbf7250b99d47bea07172749483ca97","b7719e26494940efa49512aedd0aac79",22886094,1,-12,0,74,28,20,-8
"51970cfa30e643e894e66ae85c8024cc","4e51676dc72045d99c19b9fa7b22f8bc",22886094,1,-3,0,79,31,29,-2
"93679be414554a11b1893002f2229a93","c33c17be71ae4d588da7369472e5bb1b",22886094,1,-3,0,82,35,34,-1
"7040a13096d746ac84b8fac8d9752058","7040a13096d746ac84b8fac8d9752058",22886094,1,0,1,85,36,36,0
"7040a13096d746ac84b8fac8d9752058","9a0dc646f934470daf08c4b56ccf73db",22886094,1,3,0,86,36,37,1
"9a0dc646f934470daf08c4b56ccf73db","9a0dc646f934470daf08c4b56ccf73db",22886094,1,0,1,87,37,37,0
"9a0dc646f934470daf08c4b56ccf73db","fc0e049d56024bc9a02c9a9c435c3df7",22886094,1,3,0,88,37,38,1
"fc0e049d56024bc9a02c9a9c435c3df7","67a089198fcb4e1c8f2385786c2b296f",22886094,1,4,0,89,38,39,1
"64d48c6c9c7940639a932219a6c87198","64d48c6c9c7940639a932219a6c87198",22886094,1,0,1,95,40,40,0
"64d48c6c9c7940639a932219a6c87198","b534b89233134e30a9b5645138bfa9ee",22886094,1,3,0,96,40,41,1
"b534b89233134e30a9b5645138bfa9ee","67a089198fcb4e1c8f2385786c2b296f",22886094,1,-4,0,97,41,39,-2
"67a089198fcb4e1c8f2385786c2b296f","0e37b720d23b4e7f8b313e79313fd107",22886094,1,7,0,98,39,44,5
"0e37b720d23b4e7f8b313e79313fd107","0e37b720d23b4e7f8b313e79313fd107",22886094,2,0,1,100,44,44,0
"0e37b720d23b4e7f8b313e79313fd107","6875d67fdd5f48168b62719df449bebd",22886094,1,1,0,101,44,45,1
"6875d67fdd5f48168b62719df449bebd","6875d67fdd5f48168b62719df449bebd",22886094,2,0,1,102,45,45,0
"6875d67fdd5f48168b62719df449bebd","b534b89233134e30a9b5645138bfa9ee",22886094,1,-4,0,104,45,41,-4
"b534b89233134e30a9b5645138bfa9ee","6e13d61a7bdb44bca949c9f86fab3be5",22886094,1,7,0,105,41,47,6
"6e13d61a7bdb44bca949c9f86fab3be5","6e13d61a7bdb44bca949c9f86fab3be5",22886094,4,0,1,106,47,47,0
"6e13d61a7bdb44bca949c9f86fab3be5","195f78799f984cc2b06c48dfe36be751",22886094,1,2,0,110,47,49,2
"195f78799f984cc2b06c48dfe36be751","195f78799f984cc2b06c48dfe36be751",22886094,2,0,1,111,49,49,0
"195f78799f984cc2b06c48dfe36be751","d0c74f735e024943943e40333d6d337f",22886094,1,3,0,113,49,51,2
"d0c74f735e024943943e40333d6d337f","d9c8d8c444a64dadbbb508652c721e17",22886094,1,-6,0,114,51,46,-5
"d9c8d8c444a64dadbbb508652c721e17","d0c74f735e024943943e40333d6d337f",22886094,1,6,0,115,46,51,5
"d0c74f735e024943943e40333d6d337f","d0c74f735e024943943e40333d6d337f",22886094,2,0,1,116,51,51,0
"d0c74f735e024943943e40333d6d337f","983f8ff320594b279a7f4a6fe132f9c5",22886094,1,2,0,118,51,53,2
"983f8ff320594b279a7f4a6fe132f9c5","983f8ff320594b279a7f4a6fe132f9c5",22886094,2,0,1,119,53,53,0
"983f8ff320594b279a7f4a6fe132f9c5","35adfa5d923046aebabfefd98f35ff05",22886094,1,1,0,121,53,54,1
"35adfa5d923046aebabfefd98f35ff05","35adfa5d923046aebabfefd98f35ff05",22886094,2,0,1,122,54,54,0
"35adfa5d923046aebabfefd98f35ff05","b6f8a98476224da1b40e555ececc7ed8",22886094,1,1,0,124,54,55,1
"b6f8a98476224da1b40e555ececc7ed8","b6f8a98476224da1b40e555ececc7ed8",22886094,2,0,1,125,55,55,0
"b6f8a98476224da1b40e555ececc7ed8","86e22cb5fe0e4b47a9489ecddf7ed78f",22886094,1,1,0,127,55,56,1
"86e22cb5fe0e4b47a9489ecddf7ed78f","86e22cb5fe0e4b47a9489ecddf7ed78f",22886094,2,0,1,128,56,56,0
"86e22cb5fe0e4b47a9489ecddf7ed78f","f924752d8a1149668870b1e7698486f7",22886094,1,-6,0,130,56,50,-6
"f924752d8a1149668870b1e7698486f7","78f30e4dcac84e3cbea8b2cc6e0d62b3",22886094,1,10,0,131,50,59,9
"78f30e4dcac84e3cbea8b2cc6e0d62b3","a1f2f12debe5432fb7a70bcd12bacfb9",22886094,1,-1,0,132,59,58,-1
"a1f2f12debe5432fb7a70bcd12bacfb9","a1f2f12debe5432fb7a70bcd12bacfb9",22886094,63,0,1,133,58,58,0
"a1f2f12debe5432fb7a70bcd12bacfb9","78f30e4dcac84e3cbea8b2cc6e0d62b3",22886094,1,1,0,196,58,59,1
"78f30e4dcac84e3cbea8b2cc6e0d62b3","78f30e4dcac84e3cbea8b2cc6e0d62b3",22886094,7,0,1,197,59,59,0
"78f30e4dcac84e3cbea8b2cc6e0d62b3","a0a418b8540d479fa6e0f653b701da8b",22886094,1,6,0,204,59,64,5
"a0a418b8540d479fa6e0f653b701da8b","12aa6e1672ac4e7aa6449a7a8609cd72",22886094,1,-8,0,205,64,57,-7
"12aa6e1672ac4e7aa6449a7a8609cd72","bc42d26810654ea9a1df1efe1e58c7d5",22886094,1,7,0,206,57,63,6
"bc42d26810654ea9a1df1efe1e58c7d5","4c943503763e4e349906eea3ed3c8e86",22886094,1,-2,0,207,63,61,-2
"4c943503763e4e349906eea3ed3c8e86","4c943503763e4e349906eea3ed3c8e86",22886094,1,0,1,208,61,61,0
"4c943503763e4e349906eea3ed3c8e86","bc42d26810654ea9a1df1efe1e58c7d5",22886094,1,2,0,209,61,63,2
"bc42d26810654ea9a1df1efe1e58c7d5","bc42d26810654ea9a1df1efe1e58c7d5",22886094,3,0,1,210,63,63,0
"bc42d26810654ea9a1df1efe1e58c7d5","a0a418b8540d479fa6e0f653b701da8b",22886094,1,1,0,213,63,64,1
"a0a418b8540d479fa6e0f653b701da8b","a0a418b8540d479fa6e0f653b701da8b",22886094,3,0,1,214,64,64,0
"a0a418b8540d479fa6e0f653b701da8b","309ccf3cc4fe429d9bfbaef53d3fa479",22886094,1,-4,0,217,64,60,-4
"309ccf3cc4fe429d9bfbaef53d3fa479","d646286c8051419bbc2e31dd1db55ca8",22886094,1,10,0,218,60,67,7
"d646286c8051419bbc2e31dd1db55ca8","b534b89233134e30a9b5645138bfa9ee",22886094,1,-33,0,219,67,41,-26
"b534b89233134e30a9b5645138bfa9ee","267f883678b24aed855fde42524975d9",22886094,1,37,0,220,41,71,30
"267f883678b24aed855fde42524975d9","267f883678b24aed855fde42524975d9",22886094,1,0,1,221,71,71,0
"267f883678b24aed855fde42524975d9","88fff56d0342490dbef9040750a20f6c",22886094,1,1,0,222,71,72,1
"88fff56d0342490dbef9040750a20f6c","88fff56d0342490dbef9040750a20f6c",22886094,1,0,1,223,72,72,0
"88fff56d0342490dbef9040750a20f6c","adb17b12b66c4a49a85fd34322f7df70",22886094,1,1,0,224,72,73,1
"adb17b12b66c4a49a85fd34322f7df70","adb17b12b66c4a49a85fd34322f7df70",22886094,1,0,1,225,73,73,0
"adb17b12b66c4a49a85fd34322f7df70","d646286c8051419bbc2e31dd1db55ca8",22886094,1,-6,0,226,73,67,-6
"d646286c8051419bbc2e31dd1db55ca8","a2becd407db34b189200a32546d9d569",22886094,1,9,0,227,67,75,8
"a2becd407db34b189200a32546d9d569","a2becd407db34b189200a32546d9d569",22886094,10,0,1,228,75,75,0
"a2becd407db34b189200a32546d9d569","58c22b011d0f4c2ea6d13615edbb9eeb",22886094,1,2,0,238,75,77,2
"58c22b011d0f4c2ea6d13615edbb9eeb","58c22b011d0f4c2ea6d13615edbb9eeb",22886094,2,0,1,239,77,77,0
"58c22b011d0f4c2ea6d13615edbb9eeb","dd76e1861dc9461c830888729d091ee0",22886094,1,1,0,241,77,78,1
"dd76e1861dc9461c830888729d091ee0","dd76e1861dc9461c830888729d091ee0",22886094,5,0,1,242,78,78,0
"dd76e1861dc9461c830888729d091ee0","cd1d828f1a694b87913a7ea66c23803e",22886094,1,1,0,247,78,79,1
"cd1d828f1a694b87913a7ea66c23803e","cd1d828f1a694b87913a7ea66c23803e",22886094,2,0,1,248,79,79,0
"cd1d828f1a694b87913a7ea66c23803e","9176a3c2b4d2465fa8b0c67096c2a97e",22886094,1,1,0,250,79,80,1
"9176a3c2b4d2465fa8b0c67096c2a97e","9176a3c2b4d2465fa8b0c67096c2a97e",22886094,5,0,1,251,80,80,0
"9176a3c2b4d2465fa8b0c67096c2a97e","f8ec6445f7194e25b9101d4fbcb07a18",22886094,1,1,0,256,80,81,1
"f8ec6445f7194e25b9101d4fbcb07a18","f8ec6445f7194e25b9101d4fbcb07a18",22886094,2,0,1,257,81,81,0
"f8ec6445f7194e25b9101d4fbcb07a18","140d5b27b8574befad82c0a013b59dfa",22886094,1,-7,0,259,81,74,-7
"140d5b27b8574befad82c0a013b59dfa","d18a9ea32855445f8736581f5cb119ce",22886094,1,9,0,260,74,82,8
"d18a9ea32855445f8736581f5cb119ce","f564483cbd7a407681aa2fcca518cf5f",22886094,1,4,0,261,82,85,3
"f564483cbd7a407681aa2fcca518cf5f","f564483cbd7a407681aa2fcca518cf5f",22886094,1,0,1,262,85,85,0
"f564483cbd7a407681aa2fcca518cf5f","18fd01350bd5434ca636d59a599d768a",22886094,1,1,0,263,85,86,1
"18fd01350bd5434ca636d59a599d768a","18fd01350bd5434ca636d59a599d768a",22886094,2,0,1,264,86,86,0
"18fd01350bd5434ca636d59a599d768a","6a9f0ef185fb47f0937e29daa1c71ed5",22886094,1,5,0,266,86,90,4
"6a9f0ef185fb47f0937e29daa1c71ed5","ae5ac430ea254e708a6f5deaaf7464ae",22886094,1,-7,0,267,90,84,-6
"ae5ac430ea254e708a6f5deaaf7464ae","c681290961c94c4caf23b529d1ae6b9a",22886094,1,5,0,268,84,88,4
"c681290961c94c4caf23b529d1ae6b9a","c681290961c94c4caf23b529d1ae6b9a",22886094,1,0,1,269,88,88,0
"c681290961c94c4caf23b529d1ae6b9a","6a9f0ef185fb47f0937e29daa1c71ed5",22886094,1,2,0,270,88,90,2
"6a9f0ef185fb47f0937e29daa1c71ed5","6a9f0ef185fb47f0937e29daa1c71ed5",22886094,3,0,1,271,90,90,0
"6a9f0ef185fb47f0937e29daa1c71ed5","e20db35ced8544ddac5bc3839145e463",22886094,1,3,0,274,90,91,1
"e20db35ced8544ddac5bc3839145e463","d646286c8051419bbc2e31dd1db55ca8",22886094,1,-30,0,275,91,67,-24
"d646286c8051419bbc2e31dd1db55ca8","1febb706d7a34005ae8711ed49c76e64",22886094,1,33,0,276,67,94,27
"1febb706d7a34005ae8711ed49c76e64","1febb706d7a34005ae8711ed49c76e64",22886094,2,0,1,277,94,94,0
"1febb706d7a34005ae8711ed49c76e64","8f73ba6f5a0042f2850356ac38ac6f24",22886094,1,1,0,279,94,95,1
"8f73ba6f5a0042f2850356ac38ac6f24","8f73ba6f5a0042f2850356ac38ac6f24",22886094,2,0,1,280,95,95,0
"8f73ba6f5a0042f2850356ac38ac6f24","e2260b86653c46d7b14a41fb419dbf8c",22886094,1,1,0,282,95,96,1
"e2260b86653c46d7b14a41fb419dbf8c","e2260b86653c46d7b14a41fb419dbf8c",22886094,2,0,1,283,96,96,0
"e2260b86653c46d7b14a41fb419dbf8c","35eb641ad1d845bbba54915bce75a962",22886094,1,1,0,285,96,97,1
"35eb641ad1d845bbba54915bce75a962","35eb641ad1d845bbba54915bce75a962",22886094,6,0,1,286,97,97,0
"35eb641ad1d845bbba54915bce75a962","08be90ffbeea4795a138cd42ed8db56f",22886094,1,1,0,291,97,98,1
"08be90ffbeea4795a138cd42ed8db56f","08be90ffbeea4795a138cd42ed8db56f",22886094,7,0,1,292,98,98,0
"08be90ffbeea4795a138cd42ed8db56f","35eb641ad1d845bbba54915bce75a962",22886094,1,-1,0,299,98,97,-1
"35eb641ad1d845bbba54915bce75a962","3007433c8f584dcbb5ac159c1c5f2be3",22886094,1,2,0,301,97,99,2
"3007433c8f584dcbb5ac159c1c5f2be3","3007433c8f584dcbb5ac159c1c5f2be3",22886094,5,0,1,302,99,99,0
"3007433c8f584dcbb5ac159c1c5f2be3","e20db35ced8544ddac5bc3839145e463",22886094,1,-8,0,307,99,91,-8
"e20db35ced8544ddac5bc3839145e463","d391c8b6e56a43a7b654e9dee02d904b",22886094,2,13,0,308,91,103,12
"d391c8b6e56a43a7b654e9dee02d904b","00ae5f0c51874a73a41ebea838d95682",22886094,1,-2,0,309,103,101,-2
"00ae5f0c51874a73a41ebea838d95682","00ae5f0c51874a73a41ebea838d95682",22886094,4,0,1,310,101,101,0
"00ae5f0c51874a73a41ebea838d95682","d391c8b6e56a43a7b654e9dee02d904b",22886094,1,2,0,314,101,103,2
"d391c8b6e56a43a7b654e9dee02d904b","d391c8b6e56a43a7b654e9dee02d904b",22886094,15,0,1,315,103,103,0
"d391c8b6e56a43a7b654e9dee02d904b","6111116566fc4fd9abba409322bea245",22886094,1,1,0,330,103,104,1
"6111116566fc4fd9abba409322bea245","6111116566fc4fd9abba409322bea245",22886094,2,0,1,331,104,104,0
"6111116566fc4fd9abba409322bea245","a81b2235cb9c499eb9ea8ee0a8dd9725",22886094,1,1,0,333,104,105,1
"a81b2235cb9c499eb9ea8ee0a8dd9725","a81b2235cb9c499eb9ea8ee0a8dd9725",22886094,2,0,1,334,105,105,0
"a81b2235cb9c499eb9ea8ee0a8dd9725","2d4e0ab0ef3b4d73b82c72d4621a7579",22886094,1,1,0,336,105,106,1
"2d4e0ab0ef3b4d73b82c72d4621a7579","2d4e0ab0ef3b4d73b82c72d4621a7579",22886094,2,0,1,337,106,106,0
"2d4e0ab0ef3b4d73b82c72d4621a7579","8bdebf492ebd4e62b0d522e8ab5e5197",22886094,1,1,0,339,106,107,1
"8bdebf492ebd4e62b0d522e8ab5e5197","8bdebf492ebd4e62b0d522e8ab5e5197",22886094,2,0,1,340,107,107,0
"8bdebf492ebd4e62b0d522e8ab5e5197","4280927ec4d643238aa49c32f9e06c6c",22886094,1,3,0,342,107,109,2
"4280927ec4d643238aa49c32f9e06c6c","73039f8c1eb9409cb4caee2cf968001e",22886094,1,-10,0,343,109,100,-9
"73039f8c1eb9409cb4caee2cf968001e","4280927ec4d643238aa49c32f9e06c6c",22886094,2,10,0,344,100,109,9
"4280927ec4d643238aa49c32f9e06c6c","fc44e6a5f7654430af1227838224dceb",22886094,1,2,0,345,109,111,2
"fc44e6a5f7654430af1227838224dceb","fc44e6a5f7654430af1227838224dceb",22886094,2,0,1,346,111,111,0
"fc44e6a5f7654430af1227838224dceb","08111f75e22d409998cf8b85bd431f0a",22886094,1,-3,0,348,111,108,-3
"08111f75e22d409998cf8b85bd431f0a","a9ae0a3c070d455bb4369a8996313336",22886094,2,7,0,349,108,114,6
"a9ae0a3c070d455bb4369a8996313336","a9ae0a3c070d455bb4369a8996313336",22886094,1,0,1,350,114,114,0
"a9ae0a3c070d455bb4369a8996313336","e20db35ced8544ddac5bc3839145e463",22886094,1,-26,0,351,114,91,-23
"e20db35ced8544ddac5bc3839145e463","00ae5f0c51874a73a41ebea838d95682",22886094,1,11,0,352,91,101,10
"00ae5f0c51874a73a41ebea838d95682","e20db35ced8544ddac5bc3839145e463",22886094,1,-11,0,353,101,91,-10
"d391c8b6e56a43a7b654e9dee02d904b","73039f8c1eb9409cb4caee2cf968001e",22886094,1,-3,0,355,103,100,-3
"4280927ec4d643238aa49c32f9e06c6c","08111f75e22d409998cf8b85bd431f0a",22886094,1,-1,0,357,109,108,-1
"a9ae0a3c070d455bb4369a8996313336","71cec822bcff4f30a20e75dc63ef7b65",22886094,1,2,0,359,114,116,2
"71cec822bcff4f30a20e75dc63ef7b65","71cec822bcff4f30a20e75dc63ef7b65",22886094,1,0,1,360,116,116,0
"71cec822bcff4f30a20e75dc63ef7b65","62bff51286ef4f348717a3cf6fe2318f",22886094,1,5,0,361,116,120,4
"62bff51286ef4f348717a3cf6fe2318f","37319e88176d4aefa91d7a9980dbae91",22886094,1,-9,0,362,120,112,-8
"37319e88176d4aefa91d7a9980dbae91","b1cd0e7dc3ad4a8eb91a4bfdbeb025b0",22886094,1,7,0,363,112,118,6
"b1cd0e7dc3ad4a8eb91a4bfdbeb025b0","b1cd0e7dc3ad4a8eb91a4bfdbeb025b0",22886094,2,0,1,364,118,118,0
"b1cd0e7dc3ad4a8eb91a4bfdbeb025b0","62bff51286ef4f348717a3cf6fe2318f",22886094,1,2,0,366,118,120,2
"62bff51286ef4f348717a3cf6fe2318f","62bff51286ef4f348717a3cf6fe2318f",22886094,3,0,1,367,120,120,0
"62bff51286ef4f348717a3cf6fe2318f","e20db35ced8544ddac5bc3839145e463",22886094,1,-33,0,370,120,91,-29
"e20db35ced8544ddac5bc3839145e463","779f9ddd1fd14d1e9e69f72219a1fdbd",22886094,1,36,0,371,91,121,30
"779f9ddd1fd14d1e9e69f72219a1fdbd","67a089198fcb4e1c8f2385786c2b296f",22886094,1,-103,0,372,121,39,-82
"67a089198fcb4e1c8f2385786c2b296f","779f9ddd1fd14d1e9e69f72219a1fdbd",22886094,1,103,0,373,39,121,82
"779f9ddd1fd14d1e9e69f72219a1fdbd","779f9ddd1fd14d1e9e69f72219a1fdbd",22886094,2,0,1,374,121,121,0
"779f9ddd1fd14d1e9e69f72219a1fdbd","ae26e6cda8ad4a3f81bd347560d9579f",22886094,1,4,0,375,121,125,4
"ae26e6cda8ad4a3f81bd347560d9579f","ae26e6cda8ad4a3f81bd347560d9579f",22886094,1,0,1,376,125,125,0
"ae26e6cda8ad4a3f81bd347560d9579f","ee48df95832b4374aa273ceb27ec1315",22886094,1,1,0,377,125,126,1
"ee48df95832b4374aa273ceb27ec1315","ee48df95832b4374aa273ceb27ec1315",22886094,1,0,1,378,126,126,0
"ee48df95832b4374aa273ceb27ec1315","7a439da90b394756ad1777fc4c6dead5",22886094,1,1,0,379,126,127,1
"7a439da90b394756ad1777fc4c6dead5","7a439da90b394756ad1777fc4c6dead5",22886094,1,0,1,380,127,127,0
"7a439da90b394756ad1777fc4c6dead5","a8dd5213034441ac92724b4e83eb0bb2",22886094,1,3,0,381,127,129,2
"a8dd5213034441ac92724b4e83eb0bb2","779f9ddd1fd14d1e9e69f72219a1fdbd",22886094,1,-9,0,382,129,121,-8
"779f9ddd1fd14d1e9e69f72219a1fdbd","a8dd5213034441ac92724b4e83eb0bb2",22886094,1,9,0,383,121,129,8
"a8dd5213034441ac92724b4e83eb0bb2","8115eab6556b45f5b415c3b8c26a12e5",22886094,1,2,0,384,129,131,2
"8115eab6556b45f5b415c3b8c26a12e5","8115eab6556b45f5b415c3b8c26a12e5",22886094,2,0,1,385,131,131,0
"8115eab6556b45f5b415c3b8c26a12e5","ec34b06efd844b46a4c4818ecdb9b8f4",22886094,1,1,0,387,131,132,1
"ec34b06efd844b46a4c4818ecdb9b8f4","ec34b06efd844b46a4c4818ecdb9b8f4",22886094,6,0,1,388,132,132,0
"ec34b06efd844b46a4c4818ecdb9b8f4","c2e1c2b9eac64109b343a088584b576b",22886094,1,1,0,394,132,133,1
"c2e1c2b9eac64109b343a088584b576b","c2e1c2b9eac64109b343a088584b576b",22886094,2,0,1,395,133,133,0
"c2e1c2b9eac64109b343a088584b576b","579338175e0b4bbb8ef3b712b5d8b54e",22886094,1,-5,0,397,133,128,-5
"579338175e0b4bbb8ef3b712b5d8b54e","8bc5795d6a984a3eace4e2811e52dd4f",22886094,1,8,0,398,128,135,7
"8bc5795d6a984a3eace4e2811e52dd4f","8bc5795d6a984a3eace4e2811e52dd4f",22886094,1,0,1,399,135,135,0
"8bc5795d6a984a3eace4e2811e52dd4f","b416d47c56a742199b5d7c7f19d6503a",22886094,1,-1,0,400,135,134,-1
"b416d47c56a742199b5d7c7f19d6503a","cd4532ad48034873ba8bce2aac0c9808",22886094,1,4,0,401,134,137,3
"cd4532ad48034873ba8bce2aac0c9808","cd4532ad48034873ba8bce2aac0c9808",22886094,2,0,1,402,137,137,0
"cd4532ad48034873ba8bce2aac0c9808","779f9ddd1fd14d1e9e69f72219a1fdbd",22886094,1,-19,0,403,137,121,-16
"779f9ddd1fd14d1e9e69f72219a1fdbd","df1de691dafe4549a18a4398ee9dfaf9",22886094,1,23,0,404,121,139,18
"df1de691dafe4549a18a4398ee9dfaf9","6c5ad271a44743479bfaea29b1db8d02",22886094,1,4,0,405,139,143,4
"6c5ad271a44743479bfaea29b1db8d02","6c5ad271a44743479bfaea29b1db8d02",22886094,1,0,1,406,143,143,0
"6c5ad271a44743479bfaea29b1db8d02","83d311bed5374fee83d8d67a7d9d82dc",22886094,1,1,0,407,143,144,1
"83d311bed5374fee83d8d67a7d9d82dc","83d311bed5374fee83d8d67a7d9d82dc",22886094,1,0,1,408,144,144,0
"83d311bed5374fee83d8d67a7d9d82dc","402bba41861d43acb52a5abb89e8831e",22886094,1,1,0,409,144,145,1
"402bba41861d43acb52a5abb89e8831e","402bba41861d43acb52a5abb89e8831e",22886094,2,0,1,410,145,145,0
"402bba41861d43acb52a5abb89e8831e","8aae34f5ddbb4052a709b12e6b0d40fa",22886094,1,3,0,412,145,147,2
"8aae34f5ddbb4052a709b12e6b0d40fa","df1de691dafe4549a18a4398ee9dfaf9",22886094,1,-9,0,413,147,139,-8
"df1de691dafe4549a18a4398ee9dfaf9","8aae34f5ddbb4052a709b12e6b0d40fa",22886094,2,9,0,414,139,147,8
"8aae34f5ddbb4052a709b12e6b0d40fa","645b3f0249f64f76af2e19eb4d0e55b7",22886094,1,2,0,415,147,149,2
"645b3f0249f64f76af2e19eb4d0e55b7","645b3f0249f64f76af2e19eb4d0e55b7",22886094,5,0,1,416,149,149,0
"645b3f0249f64f76af2e19eb4d0e55b7","7e7b8db5064d4369805ab370aac5ddfb",22886094,1,1,0,421,149,150,1
"7e7b8db5064d4369805ab370aac5ddfb","7e7b8db5064d4369805ab370aac5ddfb",22886094,2,0,1,422,150,150,0
"7e7b8db5064d4369805ab370aac5ddfb","8956d210ae7f41968fada86d4c979d6a",22886094,1,1,0,424,150,151,1
"8956d210ae7f41968fada86d4c979d6a","8956d210ae7f41968fada86d4c979d6a",22886094,2,0,1,425,151,151,0
"8956d210ae7f41968fada86d4c979d6a","f902b0f41b544d4dbf79664fd233648d",22886094,1,-5,0,427,151,146,-5
"f902b0f41b544d4dbf79664fd233648d","ae781e8b775e4ccd93bc800dad5c8376",22886094,1,8,0,428,146,153,7
"ae781e8b775e4ccd93bc800dad5c8376","ae781e8b775e4ccd93bc800dad5c8376",22886094,2,0,1,429,153,153,0
"ae781e8b775e4ccd93bc800dad5c8376","06882a8492d9499aa31555567f575ecb",22886094,1,1,0,431,153,154,1
"06882a8492d9499aa31555567f575ecb","06882a8492d9499aa31555567f575ecb",22886094,1,0,1,432,154,154,0
"06882a8492d9499aa31555567f575ecb","f293c508f409466a8f27ddd7d1e40b20",22886094,1,1,0,433,154,155,1
"f293c508f409466a8f27ddd7d1e40b20","f293c508f409466a8f27ddd7d1e40b20",22886094,2,0,1,434,155,155,0
"f293c508f409466a8f27ddd7d1e40b20","cc4ddef5bbbe48ebb605141b347c4ed1",22886094,1,1,0,436,155,156,1
"cc4ddef5bbbe48ebb605141b347c4ed1","cc4ddef5bbbe48ebb605141b347c4ed1",22886094,3,0,1,437,156,156,0
"cc4ddef5bbbe48ebb605141b347c4ed1","f03480cf4eba413194d7af52fc0e7f28",22886094,1,-4,0,440,156,152,-4
"f03480cf4eba413194d7af52fc0e7f28","d313cec988a84645bee413e8d4724a4b",22886094,2,7,0,441,152,158,6
"d313cec988a84645bee413e8d4724a4b","d313cec988a84645bee413e8d4724a4b",22886094,6,0,1,442,158,158,0
"d313cec988a84645bee413e8d4724a4b","dc60696c76a74368a60f72246e47700d",22886094,1,1,0,446,158,159,1
"dc60696c76a74368a60f72246e47700d","dc60696c76a74368a60f72246e47700d",22886094,1,0,1,447,159,159,0
"dc60696c76a74368a60f72246e47700d","78adeee1fa2c4fe0bc73f7bca9fcee86",22886094,1,3,0,448,159,160,1
"78adeee1fa2c4fe0bc73f7bca9fcee86","df1de691dafe4549a18a4398ee9dfaf9",22886094,1,-26,0,449,160,139,-21
"df1de691dafe4549a18a4398ee9dfaf9","78adeee1fa2c4fe0bc73f7bca9fcee86",22886094,1,26,0,450,139,160,21
"65202579580f4ad38d734b4ee39d22a8","8959e6304a0348309a771e4d08d1b64a",22886094,2,-1,0,459,164,163,-1
"8959e6304a0348309a771e4d08d1b64a","65202579580f4ad38d734b4ee39d22a8",22886094,3,1,0,460,163,164,1
"65202579580f4ad38d734b4ee39d22a8","3cbcea2be0984e7dbd5a48195af10ce7",22886094,1,3,0,524,164,165,1
"3cbcea2be0984e7dbd5a48195af10ce7","78adeee1fa2c4fe0bc73f7bca9fcee86",22886094,1,-8,0,525,165,160,-5
"78adeee1fa2c4fe0bc73f7bca9fcee86","82e6285962b8400d9d6fc32436022a94",22886094,1,10,0,526,160,167,7
"82e6285962b8400d9d6fc32436022a94","3cbcea2be0984e7dbd5a48195af10ce7",22886094,2,-2,0,527,167,165,-2
"3cbcea2be0984e7dbd5a48195af10ce7","a9ac840f098c4bd0a2ee896214ce29cd",22886094,1,5,0,528,165,168,3
"a9ac840f098c4bd0a2ee896214ce29cd","0c7262dff33c4087bc660ccf40f92f9c",22886094,1,4,0,529,168,169,1
"0c7262dff33c4087bc660ccf40f92f9c","a9ac840f098c4bd0a2ee896214ce29cd",22886094,1,-4,0,530,169,168,-1
"a9ac840f098c4bd0a2ee896214ce29cd","b2275c3fad834f8d90737a2d9a6927d6",22886094,1,7,0,531,168,172,4
"b2275c3fad834f8d90737a2d9a6927d6","0c7262dff33c4087bc660ccf40f92f9c",22886094,2,-3,0,532,172,169,-3
"0c7262dff33c4087bc660ccf40f92f9c","b2275c3fad834f8d90737a2d9a6927d6",22886094,2,3,0,533,169,172,3
"78adeee1fa2c4fe0bc73f7bca9fcee86","8959e6304a0348309a771e4d08d1b64a",22886094,1,4,0,536,160,163,3
"78adeee1fa2c4fe0bc73f7bca9fcee86","3cbcea2be0984e7dbd5a48195af10ce7",22886094,1,8,0,548,160,165,5
"3cbcea2be0984e7dbd5a48195af10ce7","82e6285962b8400d9d6fc32436022a94",22886094,2,2,0,549,165,167,2
"3cbcea2be0984e7dbd5a48195af10ce7","3cbcea2be0984e7dbd5a48195af10ce7",22886094,2,0,1,551,165,165,0
"82e6285962b8400d9d6fc32436022a94","a9ac840f098c4bd0a2ee896214ce29cd",22886094,1,3,0,554,167,168,1
"a9ac840f098c4bd0a2ee896214ce29cd","3cbcea2be0984e7dbd5a48195af10ce7",22886094,1,-5,0,555,168,165,-3
"3cbcea2be0984e7dbd5a48195af10ce7","67a089198fcb4e1c8f2385786c2b296f",22886094,1,-160,0,556,165,39,-126
"67a089198fcb4e1c8f2385786c2b296f","b416d47c56a742199b5d7c7f19d6503a",22886094,1,118,0,557,39,134,95
"b416d47c56a742199b5d7c7f19d6503a","779f9ddd1fd14d1e9e69f72219a1fdbd",22886094,1,-15,0,558,134,121,-13
"779f9ddd1fd14d1e9e69f72219a1fdbd","f661500307d74c908e9207d949ceb4aa",22886094,1,18,0,560,121,136,15
"f661500307d74c908e9207d949ceb4aa","cd4532ad48034873ba8bce2aac0c9808",22886094,1,1,0,561,136,137,1
"cd4532ad48034873ba8bce2aac0c9808","df1de691dafe4549a18a4398ee9dfaf9",22886094,1,4,0,563,137,139,2
"df1de691dafe4549a18a4398ee9dfaf9","779f9ddd1fd14d1e9e69f72219a1fdbd",22886094,2,-23,0,564,139,121,-18
"779f9ddd1fd14d1e9e69f72219a1fdbd","6c5ad271a44743479bfaea29b1db8d02",22886094,2,27,0,565,121,143,22
"6c5ad271a44743479bfaea29b1db8d02","67a089198fcb4e1c8f2385786c2b296f",22886094,1,-130,0,566,143,39,-104
"67a089198fcb4e1c8f2385786c2b296f","e449fc6047844f2eb8caee5c269d5c1c",22886094,1,123,0,567,39,138,99
"e449fc6047844f2eb8caee5c269d5c1c","779f9ddd1fd14d1e9e69f72219a1fdbd",22886094,1,-20,0,568,138,121,-17
"779f9ddd1fd14d1e9e69f72219a1fdbd","e449fc6047844f2eb8caee5c269d5c1c",22886094,1,20,0,569,121,138,17
"e449fc6047844f2eb8caee5c269d5c1c","df1de691dafe4549a18a4398ee9dfaf9",22886094,1,3,0,570,138,139,1
"6c5ad271a44743479bfaea29b1db8d02","df1de691dafe4549a18a4398ee9dfaf9",22886094,1,-4,0,573,143,139,-4
"8aae34f5ddbb4052a709b12e6b0d40fa","f902b0f41b544d4dbf79664fd233648d",22886094,1,-1,0,575,147,146,-1
"f902b0f41b544d4dbf79664fd233648d","f03480cf4eba413194d7af52fc0e7f28",22886094,1,7,0,576,146,152,6
"d313cec988a84645bee413e8d4724a4b","0c7262dff33c4087bc660ccf40f92f9c",22886094,1,21,0,580,158,169,11
"b2275c3fad834f8d90737a2d9a6927d6","b2275c3fad834f8d90737a2d9a6927d6",22886094,26,0,1,583,172,172,0
"b2275c3fad834f8d90737a2d9a6927d6","eb515a26030b41f8a82a1e6114420bad",22886094,1,1,0,609,172,173,1
"eb515a26030b41f8a82a1e6114420bad","eb515a26030b41f8a82a1e6114420bad",22886094,2,0,1,610,173,173,0
"eb515a26030b41f8a82a1e6114420bad","0c7262dff33c4087bc660ccf40f92f9c",22886094,1,-4,0,612,173,169,-4
"0c7262dff33c4087bc660ccf40f92f9c","b42cc17b7de840f181a704558d0bc845",22886094,1,7,0,613,169,175,6
"b42cc17b7de840f181a704558d0bc845","b42cc17b7de840f181a704558d0bc845",22886094,10,0,1,614,175,175,0
"b42cc17b7de840f181a704558d0bc845","801f9e9135034f49bf5f8b4bdefedb41",22886094,1,2,0,624,175,177,2
"801f9e9135034f49bf5f8b4bdefedb41","801f9e9135034f49bf5f8b4bdefedb41",22886094,7,0,1,625,177,177,0
"801f9e9135034f49bf5f8b4bdefedb41","362fcb0699a14845ab29b2340093e528",22886094,1,-3,0,632,177,174,-3
"362fcb0699a14845ab29b2340093e528","ea38cc0e6e6e41edbabf210220808bf9",22886094,1,6,0,633,174,179,5
"ea38cc0e6e6e41edbabf210220808bf9","b87c552dd247427abe6ab5795b9c9d43",22886094,2,2,0,634,179,181,2
"b87c552dd247427abe6ab5795b9c9d43","ea38cc0e6e6e41edbabf210220808bf9",22886094,1,-2,0,635,181,179,-2
"ea38cc0e6e6e41edbabf210220808bf9","ea38cc0e6e6e41edbabf210220808bf9",22886094,5,0,1,636,179,179,0
"b87c552dd247427abe6ab5795b9c9d43","b87c552dd247427abe6ab5795b9c9d43",22886094,7,0,1,642,181,181,0
"b87c552dd247427abe6ab5795b9c9d43","139b097acfca451689d80c9c6eebdf7b",22886094,1,-3,0,649,181,178,-3
"139b097acfca451689d80c9c6eebdf7b","30f660a1feb34582a739722532524f79",22886094,1,6,0,650,178,183,5
"30f660a1feb34582a739722532524f79","30f660a1feb34582a739722532524f79",22886094,5,0,1,651,183,183,0
"30f660a1feb34582a739722532524f79","2024b4885bd14338a39b7b509acbbd02",22886094,1,-1,0,656,183,182,-1
"2024b4885bd14338a39b7b509acbbd02","c3f63fe50d8e487c86bf8ef76c9cadd3",22886094,1,4,0,657,182,185,3
"c3f63fe50d8e487c86bf8ef76c9cadd3","c3f63fe50d8e487c86bf8ef76c9cadd3",22886094,3,0,1,658,185,185,0
"c3f63fe50d8e487c86bf8ef76c9cadd3","0c7262dff33c4087bc660ccf40f92f9c",22886094,1,-20,0,661,185,169,-16
"0c7262dff33c4087bc660ccf40f92f9c","c8e371568a0c4391b25796ae4e91952e",22886094,3,23,0,662,169,186,17
"c8e371568a0c4391b25796ae4e91952e","7d932b23e1c84326ae5aa4d3c0d813d1",22886094,1,2,0,663,186,188,2
"7d932b23e1c84326ae5aa4d3c0d813d1","7d932b23e1c84326ae5aa4d3c0d813d1",22886094,1,0,1,664,188,188,0
"7d932b23e1c84326ae5aa4d3c0d813d1","ab11d94c6c8948ea90b88f19d2cd502b",22886094,1,3,0,665,188,190,2
"ab11d94c6c8948ea90b88f19d2cd502b","c8e371568a0c4391b25796ae4e91952e",22886094,1,-5,0,666,190,186,-4
"c8e371568a0c4391b25796ae4e91952e","ab11d94c6c8948ea90b88f19d2cd502b",22886094,1,5,0,667,186,190,4
"ab11d94c6c8948ea90b88f19d2cd502b","ab11d94c6c8948ea90b88f19d2cd502b",22886094,6,0,1,668,190,190,0
"ab11d94c6c8948ea90b88f19d2cd502b","f992451ed6ad4e68bb9e68ad6be7c4be",22886094,1,2,0,674,190,192,2
"f992451ed6ad4e68bb9e68ad6be7c4be","f992451ed6ad4e68bb9e68ad6be7c4be",22886094,1,0,1,675,192,192,0
"f992451ed6ad4e68bb9e68ad6be7c4be","07b44a7a51e94c78b411c753fc39dab0",22886094,1,-3,0,676,192,189,-3
"07b44a7a51e94c78b411c753fc39dab0","6cd2dcaac46847d4a0bc53f296d90375",22886094,1,6,0,677,189,194,5
"6cd2dcaac46847d4a0bc53f296d90375","6cd2dcaac46847d4a0bc53f296d90375",22886094,6,0,1,678,194,194,0
"6cd2dcaac46847d4a0bc53f296d90375","2d2580c9411c4972909db508d6956a58",22886094,1,2,0,684,194,196,2
"2d2580c9411c4972909db508d6956a58","2d2580c9411c4972909db508d6956a58",22886094,5,0,1,685,196,196,0
"2d2580c9411c4972909db508d6956a58","5bddb3d9ed264f3984702f048c7e5340",22886094,1,1,0,690,196,197,1
"5bddb3d9ed264f3984702f048c7e5340","5bddb3d9ed264f3984702f048c7e5340",22886094,2,0,1,691,197,197,0
"5bddb3d9ed264f3984702f048c7e5340","d5e8e2bd12a2466b9d6d90855f0eb079",22886094,1,1,0,693,197,198,1
"d5e8e2bd12a2466b9d6d90855f0eb079","d5e8e2bd12a2466b9d6d90855f0eb079",22886094,2,0,1,694,198,198,0
"d5e8e2bd12a2466b9d6d90855f0eb079","017d7ca8e0394b91aaadc9574df2202c",22886094,1,-5,0,696,198,193,-5
"017d7ca8e0394b91aaadc9574df2202c","54e8e9f0ea3e45c4bf3b8ac799ee31b1",22886094,1,8,0,697,193,200,7
"54e8e9f0ea3e45c4bf3b8ac799ee31b1","54e8e9f0ea3e45c4bf3b8ac799ee31b1",22886094,1,0,1,698,200,200,0
"54e8e9f0ea3e45c4bf3b8ac799ee31b1","c614a00911be4877a075f19315530fb0",22886094,1,1,0,699,200,201,1
"c614a00911be4877a075f19315530fb0","c614a00911be4877a075f19315530fb0",22886094,6,0,1,700,201,201,0
"c614a00911be4877a075f19315530fb0","a6c21bd8b95249c7972820a7a7d76aff",22886094,1,1,0,706,201,202,1
"a6c21bd8b95249c7972820a7a7d76aff","a6c21bd8b95249c7972820a7a7d76aff",22886094,3,0,1,707,202,202,0
"a6c21bd8b95249c7972820a7a7d76aff","bb329d880ab54120adaf203a693bb203",22886094,1,1,0,710,202,203,1
"bb329d880ab54120adaf203a693bb203","bb329d880ab54120adaf203a693bb203",22886094,1,0,1,711,203,203,0
"bb329d880ab54120adaf203a693bb203","f9170dd6bc6442b4acd832747609b09a",22886094,1,-4,0,712,203,199,-4
"f9170dd6bc6442b4acd832747609b09a","334c2344009840079b1d0e1b7ce3d5a7",22886094,1,7,0,713,199,205,6
"334c2344009840079b1d0e1b7ce3d5a7","334c2344009840079b1d0e1b7ce3d5a7",22886094,1,0,1,714,205,205,0
"334c2344009840079b1d0e1b7ce3d5a7","c8e371568a0c4391b25796ae4e91952e",22886094,1,-23,0,715,205,186,-19
"c8e371568a0c4391b25796ae4e91952e","d7f13c8d63ec4e2aa673fbb9cf9c6933",22886094,1,26,0,716,186,206,20
"d7f13c8d63ec4e2aa673fbb9cf9c6933","b9e80f77c3a44349863b19875725c384",22886094,1,1,0,717,206,207,1
"b9e80f77c3a44349863b19875725c384","7108f0e4c2584f1f9c471689ae4c885c",22886094,4,1,0,718,207,208,1
"7108f0e4c2584f1f9c471689ae4c885c","0c7262dff33c4087bc660ccf40f92f9c",22886094,2,-51,0,719,208,169,-39
"c8e371568a0c4391b25796ae4e91952e","f9170dd6bc6442b4acd832747609b09a",22886094,2,16,0,721,186,199,13
"f9170dd6bc6442b4acd832747609b09a","f9170dd6bc6442b4acd832747609b09a",22886094,2,0,1,722,199,199,0
"f9170dd6bc6442b4acd832747609b09a","d7f13c8d63ec4e2aa673fbb9cf9c6933",22886094,2,10,0,723,199,206,7
"d7f13c8d63ec4e2aa673fbb9cf9c6933","c8e371568a0c4391b25796ae4e91952e",22886094,2,-26,0,724,206,186,-20
"c8e371568a0c4391b25796ae4e91952e","b9e80f77c3a44349863b19875725c384",22886094,2,27,0,725,186,207,21
"7108f0e4c2584f1f9c471689ae4c885c","b9e80f77c3a44349863b19875725c384",22886094,1,-1,0,735,208,207,-1
"b9e80f77c3a44349863b19875725c384","b9e80f77c3a44349863b19875725c384",22886094,11,0,1,736,207,207,0
"7108f0e4c2584f1f9c471689ae4c885c","7108f0e4c2584f1f9c471689ae4c885c",22886094,10,0,1,748,208,208,0
"7108f0e4c2584f1f9c471689ae4c885c","d7f13c8d63ec4e2aa673fbb9cf9c6933",22886094,1,-2,0,758,208,206,-2
"a88efa7e50ce47159810ab553afa6d3a","a875096404ef4a9984b62d74cda916f9",22886094,1,-3,0,772,212,209,-3
"be502a7a43c44bf7b682698de79d9369","be502a7a43c44bf7b682698de79d9369",22886094,6,0,1,775,214,214,0
"f7fb1952f56b4189b86a9f8b7862d2b8","f7fb1952f56b4189b86a9f8b7862d2b8",22886094,13,0,1,782,215,215,0
"f7fb1952f56b4189b86a9f8b7862d2b8","b860ee85d8bc4a2f97958cfb71be3533",22886094,1,1,0,795,215,216,1
"b860ee85d8bc4a2f97958cfb71be3533","b860ee85d8bc4a2f97958cfb71be3533",22886094,2,0,1,796,216,216,0
"b860ee85d8bc4a2f97958cfb71be3533","ec341f459285443b8361f7f15638ff08",22886094,1,-3,0,798,216,213,-3
"363837c182e04711840d896ae1e0339c","363837c182e04711840d896ae1e0339c",22886094,12,0,1,800,218,218,0
"01b2051f8941460d89945e3b02d1ce78","91125ca626c5470eb145501f8c37f8db",22886094,1,4,0,813,217,220,3
"91125ca626c5470eb145501f8c37f8db","91125ca626c5470eb145501f8c37f8db",22886094,1,0,1,814,220,220,0
"91125ca626c5470eb145501f8c37f8db","d7f13c8d63ec4e2aa673fbb9cf9c6933",22886094,1,-18,0,815,220,206,-14
"77ecef8eff6b4a2caea7707669bf7475","77ecef8eff6b4a2caea7707669bf7475",22886094,13,0,1,818,222,222,0
"77ecef8eff6b4a2caea7707669bf7475","8b9ae98743bd4d4a8a87dff1c1244211",22886094,1,6,0,831,222,227,5
"8b9ae98743bd4d4a8a87dff1c1244211","d03cb855c70044cf8c35d9ec0de696e3",22886094,1,-3,0,832,227,224,-3
"d03cb855c70044cf8c35d9ec0de696e3","d03cb855c70044cf8c35d9ec0de696e3",22886094,1,0,1,835,224,224,0
"d03cb855c70044cf8c35d9ec0de696e3","a49a937d6896486d9a5396654abcf2e1",22886094,1,2,0,836,224,226,2
"a49a937d6896486d9a5396654abcf2e1","a49a937d6896486d9a5396654abcf2e1",22886094,1,0,1,837,226,226,0
"a49a937d6896486d9a5396654abcf2e1","8b9ae98743bd4d4a8a87dff1c1244211",22886094,1,1,0,838,226,227,1
"8b9ae98743bd4d4a8a87dff1c1244211","8b9ae98743bd4d4a8a87dff1c1244211",22886094,15,0,1,839,227,227,0
"f7906d6f59b9489a91d2ef40db5a474d","2ab1535aac1346ba8801535bf729ef37",22886094,1,7,0,856,223,229,6
"2ab1535aac1346ba8801535bf729ef37","2ab1535aac1346ba8801535bf729ef37",22886094,2,0,1,857,229,229,0
"2ab1535aac1346ba8801535bf729ef37","a4f40fb48a8542c8949bae1f002cd9bc",22886094,1,2,0,859,229,231,2
"a4f40fb48a8542c8949bae1f002cd9bc","a4f40fb48a8542c8949bae1f002cd9bc",22886094,2,0,1,860,231,231,0
"a4f40fb48a8542c8949bae1f002cd9bc","8972c23e32044edb8a78fa1eed4e5947",22886094,1,1,0,862,231,232,1
"8972c23e32044edb8a78fa1eed4e5947","8972c23e32044edb8a78fa1eed4e5947",22886094,1,0,1,863,232,232,0
"8972c23e32044edb8a78fa1eed4e5947","92feb4a40f8344d38b6f722e42a53295",22886094,1,1,0,864,232,233,1
"92feb4a40f8344d38b6f722e42a53295","92feb4a40f8344d38b6f722e42a53295",22886094,2,0,1,865,233,233,0
"92feb4a40f8344d38b6f722e42a53295","5152833676bf4c6cb317060be10f68db",22886094,1,-5,0,867,233,228,-5
"5152833676bf4c6cb317060be10f68db","ca3e28f290354c08aefe5b0f769604e6",22886094,1,8,0,868,228,235,7
"ca3e28f290354c08aefe5b0f769604e6","ca3e28f290354c08aefe5b0f769604e6",22886094,14,0,1,869,235,235,0
"ca3e28f290354c08aefe5b0f769604e6","79a35eea833e4c2c9d22fc53c3c6445c",22886094,1,1,0,883,235,236,1
"79a35eea833e4c2c9d22fc53c3c6445c","79a35eea833e4c2c9d22fc53c3c6445c",22886094,9,0,1,884,236,236,0
"79a35eea833e4c2c9d22fc53c3c6445c","8f68228b1518449e9615cdafee41a2bd",22886094,1,1,0,893,236,237,1
"8f68228b1518449e9615cdafee41a2bd","8f68228b1518449e9615cdafee41a2bd",22886094,1,0,1,894,237,237,0
"8f68228b1518449e9615cdafee41a2bd","cab89fa5c3ed45a5aa550fc0352d6a42",22886094,1,1,0,895,237,238,1
"cab89fa5c3ed45a5aa550fc0352d6a42","cab89fa5c3ed45a5aa550fc0352d6a42",22886094,3,0,1,896,238,238,0
"cab89fa5c3ed45a5aa550fc0352d6a42","66d4fad4f1cf4b46be0750a99ad7a35a",22886094,1,1,0,899,238,239,1
"66d4fad4f1cf4b46be0750a99ad7a35a","66d4fad4f1cf4b46be0750a99ad7a35a",22886094,1,0,1,900,239,239,0
"66d4fad4f1cf4b46be0750a99ad7a35a","0b04c8e2f86d48c7aeb7e225819cd32b",22886094,1,-5,0,901,239,234,-5
"0b04c8e2f86d48c7aeb7e225819cd32b","f53da5fd9bfe412da4b80d4742563b6c",22886094,1,8,0,902,234,241,7
"f53da5fd9bfe412da4b80d4742563b6c","f53da5fd9bfe412da4b80d4742563b6c",22886094,1,0,1,903,241,241,0
"f53da5fd9bfe412da4b80d4742563b6c","2ae94c0cea4d480a9d5dca8fb1d7b542",22886094,1,3,0,904,241,242,1
"1ebf23f9d994469a85206e4c7b1bf5f5","0c7262dff33c4087bc660ccf40f92f9c",22886094,1,-100,0,907,245,169,-76
"be502a7a43c44bf7b682698de79d9369","a875096404ef4a9984b62d74cda916f9",22886094,1,-6,0,912,214,209,-5
"f7fb1952f56b4189b86a9f8b7862d2b8","363837c182e04711840d896ae1e0339c",22886094,1,4,0,914,215,218,3
"1ebf23f9d994469a85206e4c7b1bf5f5","1ebf23f9d994469a85206e4c7b1bf5f5",22886094,10,0,1,924,245,245,0
"1ebf23f9d994469a85206e4c7b1bf5f5","85ae675b83e8422da842cfd25596af99",22886094,1,1,0,934,245,246,1
"85ae675b83e8422da842cfd25596af99","85ae675b83e8422da842cfd25596af99",22886094,1,0,1,935,246,246,0
"85ae675b83e8422da842cfd25596af99","2ae94c0cea4d480a9d5dca8fb1d7b542",22886094,1,-4,0,936,246,242,-4
"fa235f0f364d47e4ae1c87f47bf8e6ba","fa235f0f364d47e4ae1c87f47bf8e6ba",22886094,12,0,1,938,252,252,0
"fa235f0f364d47e4ae1c87f47bf8e6ba","79f7845465cc4ed19d8e4f1429541be0",22886094,1,2,0,950,252,254,2
"79f7845465cc4ed19d8e4f1429541be0","79f7845465cc4ed19d8e4f1429541be0",22886094,2,0,1,951,254,254,0
"79f7845465cc4ed19d8e4f1429541be0","6e83e23f56544a19b94067c1c558d9c0",22886094,1,-8,0,953,254,247,-7
"6e83e23f56544a19b94067c1c558d9c0","00f61990949545828dd12f1303d47504",22886094,1,11,0,954,247,256,9
"00f61990949545828dd12f1303d47504","00f61990949545828dd12f1303d47504",22886094,8,0,1,955,256,256,0
"00f61990949545828dd12f1303d47504","ead7bb4b64e247d2ae632ab8a296b091",22886094,1,2,0,963,256,258,2
"ead7bb4b64e247d2ae632ab8a296b091","ead7bb4b64e247d2ae632ab8a296b091",22886094,2,0,1,964,258,258,0
"ead7bb4b64e247d2ae632ab8a296b091","41b0048dde734bb280bac6116baa8e27",22886094,1,1,0,966,258,259,1
"41b0048dde734bb280bac6116baa8e27","41b0048dde734bb280bac6116baa8e27",22886094,2,0,1,967,259,259,0
"41b0048dde734bb280bac6116baa8e27","b41c5a094a604ee0915327da5cc0beb7",22886094,1,1,0,969,259,260,1
"b41c5a094a604ee0915327da5cc0beb7","b41c5a094a604ee0915327da5cc0beb7",22886094,2,0,1,970,260,260,0
"b41c5a094a604ee0915327da5cc0beb7","d546341988904f069cfa86b21457d9d9",22886094,1,-10,0,972,260,251,-9
"d546341988904f069cfa86b21457d9d9","28c171777c52431ab6b925073bd63d46",22886094,1,15,0,973,251,264,13
"28c171777c52431ab6b925073bd63d46","28c171777c52431ab6b925073bd63d46",22886094,7,0,1,974,264,264,0
"28c171777c52431ab6b925073bd63d46","ac160db940cb49ae8579162b1d52bb5d",22886094,1,2,0,981,264,266,2
"ac160db940cb49ae8579162b1d52bb5d","ac160db940cb49ae8579162b1d52bb5d",22886094,7,0,1,982,266,266,0
"ac160db940cb49ae8579162b1d52bb5d","d989ebcfc12a4b669f0100dc1aa14f1e",22886094,1,-12,0,989,266,255,-11
"d989ebcfc12a4b669f0100dc1aa14f1e","c6fd49b485cc4874b0bbdd9c6171e09c",22886094,1,15,0,990,255,268,13
"c6fd49b485cc4874b0bbdd9c6171e09c","c6fd49b485cc4874b0bbdd9c6171e09c",22886094,3,0,1,991,268,268,0
"c6fd49b485cc4874b0bbdd9c6171e09c","44240778a97c4af0937817499b75707b",22886094,1,1,0,994,268,269,1
"44240778a97c4af0937817499b75707b","44240778a97c4af0937817499b75707b",22886094,2,0,1,995,269,269,0
"44240778a97c4af0937817499b75707b","7aa76d3e993840d8805f097cbdbcd44b",22886094,1,-9,0,997,269,261,-8
"7aa76d3e993840d8805f097cbdbcd44b","865a4d3b43374da7944dc7d397f566d9",22886094,1,12,0,998,261,271,10
"865a4d3b43374da7944dc7d397f566d9","865a4d3b43374da7944dc7d397f566d9",22886094,1,0,1,999,271,271,0
"865a4d3b43374da7944dc7d397f566d9","0d987bed3ffa4ed0b9a2e62e97b7b30f",22886094,1,3,0,1000,271,272,1
"0d987bed3ffa4ed0b9a2e62e97b7b30f","2ae94c0cea4d480a9d5dca8fb1d7b542",22886094,2,-38,0,1001,272,242,-30
"2ae94c0cea4d480a9d5dca8fb1d7b542","0d987bed3ffa4ed0b9a2e62e97b7b30f",22886094,2,38,0,1002,242,272,30
"0d987bed3ffa4ed0b9a2e62e97b7b30f","0d987bed3ffa4ed0b9a2e62e97b7b30f",22886094,1,0,1,1003,272,272,0
"0d987bed3ffa4ed0b9a2e62e97b7b30f","bb5a47f5ea01454a8b79455422d3b9da",22886094,4,10,0,1004,272,280,8
"bb5a47f5ea01454a8b79455422d3b9da","bb5a47f5ea01454a8b79455422d3b9da",22886094,86,0,1,1005,280,280,0
"bb5a47f5ea01454a8b79455422d3b9da","82ae07bc0c9b4570a41799290d1ef399",22886094,2,-6,0,1012,280,275,-5
"82ae07bc0c9b4570a41799290d1ef399","bc5524e78a8544e2ae2fdc2f3462bbec",22886094,1,5,0,1013,275,279,4
"bc5524e78a8544e2ae2fdc2f3462bbec","82ae07bc0c9b4570a41799290d1ef399",22886094,2,-5,0,1014,279,275,-4
"82ae07bc0c9b4570a41799290d1ef399","0d987bed3ffa4ed0b9a2e62e97b7b30f",22886094,7,-4,0,1015,275,272,-3
"0d987bed3ffa4ed0b9a2e62e97b7b30f","82ae07bc0c9b4570a41799290d1ef399",22886094,6,4,0,1016,272,275,3
"82ae07bc0c9b4570a41799290d1ef399","bb5a47f5ea01454a8b79455422d3b9da",22886094,2,6,0,1023,275,280,5
"bb5a47f5ea01454a8b79455422d3b9da","bc5524e78a8544e2ae2fdc2f3462bbec",22886094,1,-1,0,1031,280,279,-1
"0d987bed3ffa4ed0b9a2e62e97b7b30f","0c7262dff33c4087bc660ccf40f92f9c",22886094,1,-135,0,1038,272,169,-103
"0c7262dff33c4087bc660ccf40f92f9c","2ae94c0cea4d480a9d5dca8fb1d7b542",22886094,2,97,0,1039,169,242,73
"2ae94c0cea4d480a9d5dca8fb1d7b542","2ae94c0cea4d480a9d5dca8fb1d7b542",22886094,2,0,1,1040,242,242,0
"2ae94c0cea4d480a9d5dca8fb1d7b542","1ebf23f9d994469a85206e4c7b1bf5f5",22886094,3,3,0,1041,242,245,3
"1ebf23f9d994469a85206e4c7b1bf5f5","fa235f0f364d47e4ae1c87f47bf8e6ba",22886094,1,9,0,1042,245,252,7
"fa235f0f364d47e4ae1c87f47bf8e6ba","2ae94c0cea4d480a9d5dca8fb1d7b542",22886094,1,-12,0,1043,252,242,-10
"2ae94c0cea4d480a9d5dca8fb1d7b542","00f61990949545828dd12f1303d47504",22886094,2,17,0,1044,242,256,14
"00f61990949545828dd12f1303d47504","6e83e23f56544a19b94067c1c558d9c0",22886094,3,-11,0,1045,256,247,-9
"6e83e23f56544a19b94067c1c558d9c0","d546341988904f069cfa86b21457d9d9",22886094,3,5,0,1046,247,251,4
"d546341988904f069cfa86b21457d9d9","d989ebcfc12a4b669f0100dc1aa14f1e",22886094,3,5,0,1047,251,255,4
"d989ebcfc12a4b669f0100dc1aa14f1e","7aa76d3e993840d8805f097cbdbcd44b",22886094,1,7,0,1048,255,261,6
"7aa76d3e993840d8805f097cbdbcd44b","7028800abe7d4e27b613d1d6cbe26bf7",22886094,2,7,0,1049,261,267,6
"7028800abe7d4e27b613d1d6cbe26bf7","7aa76d3e993840d8805f097cbdbcd44b",22886094,1,-7,0,1050,267,261,-6
"7aa76d3e993840d8805f097cbdbcd44b","00f61990949545828dd12f1303d47504",22886094,1,-6,0,1051,261,256,-5
"00f61990949545828dd12f1303d47504","d989ebcfc12a4b669f0100dc1aa14f1e",22886094,1,-1,0,1052,256,255,-1
"d989ebcfc12a4b669f0100dc1aa14f1e","00f61990949545828dd12f1303d47504",22886094,1,1,0,1053,255,256,1
"00f61990949545828dd12f1303d47504","0c7262dff33c4087bc660ccf40f92f9c",22886094,1,-114,0,1054,256,169,-87
"0c7262dff33c4087bc660ccf40f92f9c","bc5524e78a8544e2ae2fdc2f3462bbec",22886094,1,144,0,1055,169,279,110
"bc5524e78a8544e2ae2fdc2f3462bbec","0d987bed3ffa4ed0b9a2e62e97b7b30f",22886094,1,-9,0,1056,279,272,-7
"bb5a47f5ea01454a8b79455422d3b9da","94cecc3f1e7d484b8e068e79241dfd73",22886094,1,3,0,1115,280,281,1
"94cecc3f1e7d484b8e068e79241dfd73","0d987bed3ffa4ed0b9a2e62e97b7b30f",22886094,1,-13,0,1116,281,272,-9
"0d987bed3ffa4ed0b9a2e62e97b7b30f","a37477c4e4c14169ad44b06b493007f6",22886094,1,15,0,1117,272,283,11
"a37477c4e4c14169ad44b06b493007f6","0c7262dff33c4087bc660ccf40f92f9c",22886094,2,-150,0,1118,283,169,-114
"0c7262dff33c4087bc660ccf40f92f9c","7aa76d3e993840d8805f097cbdbcd44b",22886094,1,120,0,1119,169,261,92
"7aa76d3e993840d8805f097cbdbcd44b","2ae94c0cea4d480a9d5dca8fb1d7b542",22886094,1,-23,0,1120,261,242,-19
"2ae94c0cea4d480a9d5dca8fb1d7b542","7aa76d3e993840d8805f097cbdbcd44b",22886094,1,23,0,1121,242,261,19
"7aa76d3e993840d8805f097cbdbcd44b","0d987bed3ffa4ed0b9a2e62e97b7b30f",22886094,1,15,0,1122,261,272,11
"bb5a47f5ea01454a8b79455422d3b9da","0d987bed3ffa4ed0b9a2e62e97b7b30f",22886094,2,-10,0,1134,280,272,-8
"0d987bed3ffa4ed0b9a2e62e97b7b30f","94cecc3f1e7d484b8e068e79241dfd73",22886094,2,13,0,1135,272,281,9
"94cecc3f1e7d484b8e068e79241dfd73","a37477c4e4c14169ad44b06b493007f6",22886094,2,2,0,1136,281,283,2
"0c7262dff33c4087bc660ccf40f92f9c","a875096404ef4a9984b62d74cda916f9",22886094,2,53,0,1138,169,209,40
"a875096404ef4a9984b62d74cda916f9","d7f13c8d63ec4e2aa673fbb9cf9c6933",22886094,4,-4,0,1139,209,206,-3
"d7f13c8d63ec4e2aa673fbb9cf9c6933","09400e101c5d4b439cf9a26b03aae558",22886094,5,5,0,1140,206,210,4
"09400e101c5d4b439cf9a26b03aae558","be502a7a43c44bf7b682698de79d9369",22886094,2,5,0,1141,210,214,4
"be502a7a43c44bf7b682698de79d9369","f7fb1952f56b4189b86a9f8b7862d2b8",22886094,5,1,0,1142,214,215,1
"f7fb1952f56b4189b86a9f8b7862d2b8","a875096404ef4a9984b62d74cda916f9",22886094,3,-7,0,1143,215,209,-6
"a875096404ef4a9984b62d74cda916f9","363837c182e04711840d896ae1e0339c",22886094,1,11,0,1144,209,218,9
"363837c182e04711840d896ae1e0339c","ec341f459285443b8361f7f15638ff08",22886094,3,-6,0,1145,218,213,-5
"ec341f459285443b8361f7f15638ff08","01b2051f8941460d89945e3b02d1ce78",22886094,2,5,0,1146,213,217,4
"01b2051f8941460d89945e3b02d1ce78","d7f13c8d63ec4e2aa673fbb9cf9c6933",22886094,5,-14,0,1147,217,206,-11
"d7f13c8d63ec4e2aa673fbb9cf9c6933","1c6721b1f63f4d30ba7746ea8af02a52",22886094,4,21,0,1148,206,221,15
"1c6721b1f63f4d30ba7746ea8af02a52","77ecef8eff6b4a2caea7707669bf7475",22886094,4,1,0,1149,221,222,1
"77ecef8eff6b4a2caea7707669bf7475","d03cb855c70044cf8c35d9ec0de696e3",22886094,1,3,0,1150,222,224,2
"d03cb855c70044cf8c35d9ec0de696e3","1c6721b1f63f4d30ba7746ea8af02a52",22886094,2,-4,0,1151,224,221,-3
"1c6721b1f63f4d30ba7746ea8af02a52","8b9ae98743bd4d4a8a87dff1c1244211",22886094,1,7,0,1152,221,227,6
"8b9ae98743bd4d4a8a87dff1c1244211","01b2051f8941460d89945e3b02d1ce78",22886094,1,-14,0,1153,227,217,-10
"d7f13c8d63ec4e2aa673fbb9cf9c6933","363837c182e04711840d896ae1e0339c",22886094,2,15,0,1155,206,218,12
"363837c182e04711840d896ae1e0339c","01b2051f8941460d89945e3b02d1ce78",22886094,4,-1,0,1156,218,217,-1
"77ecef8eff6b4a2caea7707669bf7475","1c6721b1f63f4d30ba7746ea8af02a52",22886094,2,-1,0,1160,222,221,-1
"1c6721b1f63f4d30ba7746ea8af02a52","d03cb855c70044cf8c35d9ec0de696e3",22886094,3,4,0,1161,221,224,3
"d03cb855c70044cf8c35d9ec0de696e3","8b9ae98743bd4d4a8a87dff1c1244211",22886094,2,3,0,1162,224,227,3
"8b9ae98743bd4d4a8a87dff1c1244211","2ab1535aac1346ba8801535bf729ef37",22886094,3,3,0,1163,227,229,2
"2ab1535aac1346ba8801535bf729ef37","f7906d6f59b9489a91d2ef40db5a474d",22886094,3,-7,0,1164,229,223,-6
"f7906d6f59b9489a91d2ef40db5a474d","5152833676bf4c6cb317060be10f68db",22886094,2,6,0,1165,223,228,5
"5152833676bf4c6cb317060be10f68db","0b04c8e2f86d48c7aeb7e225819cd32b",22886094,2,7,0,1166,228,234,6
"0b04c8e2f86d48c7aeb7e225819cd32b","2ae94c0cea4d480a9d5dca8fb1d7b542",22886094,1,11,0,1167,234,242,8
"2ae94c0cea4d480a9d5dca8fb1d7b542","1c6721b1f63f4d30ba7746ea8af02a52",22886094,2,-27,0,1168,242,221,-21
"1c6721b1f63f4d30ba7746ea8af02a52","1ebf23f9d994469a85206e4c7b1bf5f5",22886094,2,30,0,1169,221,245,24
"1ebf23f9d994469a85206e4c7b1bf5f5","2ae94c0cea4d480a9d5dca8fb1d7b542",22886094,2,-3,0,1170,245,242,-3
"2ae94c0cea4d480a9d5dca8fb1d7b542","fa235f0f364d47e4ae1c87f47bf8e6ba",22886094,2,12,0,1171,242,252,10
"fa235f0f364d47e4ae1c87f47bf8e6ba","6e83e23f56544a19b94067c1c558d9c0",22886094,1,-6,0,1172,252,247,-5
"6e83e23f56544a19b94067c1c558d9c0","7aa76d3e993840d8805f097cbdbcd44b",22886094,1,17,0,1173,247,261,14
"7028800abe7d4e27b613d1d6cbe26bf7","0c7262dff33c4087bc660ccf40f92f9c",22886094,1,-127,0,1175,267,169,-98
"0c7262dff33c4087bc660ccf40f92f9c","0c7262dff33c4087bc660ccf40f92f9c",22886094,2,0,1,1176,169,169,0
"0c7262dff33c4087bc660ccf40f92f9c","0d987bed3ffa4ed0b9a2e62e97b7b30f",22886094,1,135,0,1177,169,272,103
"a37477c4e4c14169ad44b06b493007f6","fab84b4fab5940efb4ea868ef8d09396",22886094,1,3,0,1191,283,284,1
"fab84b4fab5940efb4ea868ef8d09396","94cecc3f1e7d484b8e068e79241dfd73",22886094,1,-5,0,1192,284,281,-3
"94cecc3f1e7d484b8e068e79241dfd73","fab84b4fab5940efb4ea868ef8d09396",22886094,1,5,0,1193,281,284,3
"fab84b4fab5940efb4ea868ef8d09396","4a29443515bb404cb8924e1c60a63b73",22886094,1,4,0,1194,284,285,1
"4a29443515bb404cb8924e1c60a63b73","208c9b2796c944db8dacaa96082520ea",22886094,2,3,0,1195,285,288,3
"208c9b2796c944db8dacaa96082520ea","2ae94c0cea4d480a9d5dca8fb1d7b542",22886094,1,-63,0,1196,288,242,-46
"2ae94c0cea4d480a9d5dca8fb1d7b542","6e83e23f56544a19b94067c1c558d9c0",22886094,1,6,0,1197,242,247,5
"6e83e23f56544a19b94067c1c558d9c0","30c9ba177afc49a695625d2bdec40207",22886094,1,3,0,1198,247,250,3
"30c9ba177afc49a695625d2bdec40207","30c9ba177afc49a695625d2bdec40207",22886094,2,0,1,1199,250,250,0
"30c9ba177afc49a695625d2bdec40207","00f61990949545828dd12f1303d47504",22886094,1,8,0,1201,250,256,6
"d989ebcfc12a4b669f0100dc1aa14f1e","a875096404ef4a9984b62d74cda916f9",22886094,1,-60,0,1205,255,209,-46
"09400e101c5d4b439cf9a26b03aae558","a875096404ef4a9984b62d74cda916f9",22886094,3,-1,0,1208,210,209,-1
"a875096404ef4a9984b62d74cda916f9","be502a7a43c44bf7b682698de79d9369",22886094,3,6,0,1209,209,214,5
"f7fb1952f56b4189b86a9f8b7862d2b8","ec341f459285443b8361f7f15638ff08",22886094,2,-2,0,1211,215,213,-2
"ec341f459285443b8361f7f15638ff08","09400e101c5d4b439cf9a26b03aae558",22886094,3,-4,0,1212,213,210,-3
"09400e101c5d4b439cf9a26b03aae558","a88efa7e50ce47159810ab553afa6d3a",22886094,4,2,0,1213,210,212,2
"a88efa7e50ce47159810ab553afa6d3a","a88efa7e50ce47159810ab553afa6d3a",22886094,9,0,1,1214,212,212,0
"a88efa7e50ce47159810ab553afa6d3a","f7fb1952f56b4189b86a9f8b7862d2b8",22886094,1,4,0,1216,212,215,3
"be502a7a43c44bf7b682698de79d9369","363837c182e04711840d896ae1e0339c",22886094,1,5,0,1219,214,218,4
"ec341f459285443b8361f7f15638ff08","0c7262dff33c4087bc660ccf40f92f9c",22886094,1,-58,0,1221,213,169,-44
"0c7262dff33c4087bc660ccf40f92f9c","01b2051f8941460d89945e3b02d1ce78",22886094,1,63,0,1222,169,217,48
"77ecef8eff6b4a2caea7707669bf7475","0c7262dff33c4087bc660ccf40f92f9c",22886094,2,-71,0,1229,222,169,-53
"0c7262dff33c4087bc660ccf40f92f9c","78adeee1fa2c4fe0bc73f7bca9fcee86",22886094,2,-17,0,1230,169,160,-9
"78adeee1fa2c4fe0bc73f7bca9fcee86","78adeee1fa2c4fe0bc73f7bca9fcee86",22886094,1,0,1,1231,160,160,0
"78adeee1fa2c4fe0bc73f7bca9fcee86","65202579580f4ad38d734b4ee39d22a8",22886094,5,5,0,1232,160,164,4
"65202579580f4ad38d734b4ee39d22a8","65202579580f4ad38d734b4ee39d22a8",22886094,79,0,1,1233,164,164,0
"65202579580f4ad38d734b4ee39d22a8","78adeee1fa2c4fe0bc73f7bca9fcee86",22886094,4,-5,0,1235,164,160,-4
"65202579580f4ad38d734b4ee39d22a8","eb2a0eb537344a9e891c761662e400b6",22886094,1,-206,0,1241,164,16,-148
"eb2a0eb537344a9e891c761662e400b6","56586aa865414f538729c7f7735d2bc6",22886094,1,-8,0,1242,16,12,-4
"56586aa865414f538729c7f7735d2bc6","5c5ceeee4562457ba6d41515aeebfbb1",22886094,3,10,0,1243,12,17,5
"5c5ceeee4562457ba6d41515aeebfbb1","56586aa865414f538729c7f7735d2bc6",22886094,3,-10,0,1244,17,12,-5
"56586aa865414f538729c7f7735d2bc6","9afd71a5298d4333b6849dfce1b9422c",22886094,2,13,0,1245,12,18,6
"9afd71a5298d4333b6849dfce1b9422c","9afd71a5298d4333b6849dfce1b9422c",22886094,2,0,1,1246,18,18,0
"9afd71a5298d4333b6849dfce1b9422c","b7719e26494940efa49512aedd0aac79",22886094,2,4,0,1247,18,20,2
"b7719e26494940efa49512aedd0aac79","d4f45188d3c84a02ba08454e6403a818",22886094,1,5,0,1248,20,24,4
"d4f45188d3c84a02ba08454e6403a818","d4c3b003e8274e429d2fa688d73fde6d",22886094,2,-2,0,1249,24,22,-2
"d4c3b003e8274e429d2fa688d73fde6d","b7719e26494940efa49512aedd0aac79",22886094,2,-3,0,1250,22,20,-2
"b7719e26494940efa49512aedd0aac79","b7719e26494940efa49512aedd0aac79",22886094,1,0,1,1251,20,20,0
"b7719e26494940efa49512aedd0aac79","afbf7250b99d47bea07172749483ca97",22886094,3,12,0,1252,20,28,8
"afbf7250b99d47bea07172749483ca97","afbf7250b99d47bea07172749483ca97",22886094,1,0,1,1253,28,28,0
"afbf7250b99d47bea07172749483ca97","4e51676dc72045d99c19b9fa7b22f8bc",22886094,2,3,0,1254,28,29,1
"4e51676dc72045d99c19b9fa7b22f8bc","4e51676dc72045d99c19b9fa7b22f8bc",22886094,2,0,1,1255,29,29,0
"4e51676dc72045d99c19b9fa7b22f8bc","51970cfa30e643e894e66ae85c8024cc",22886094,2,3,0,1256,29,31,2
"51970cfa30e643e894e66ae85c8024cc","c33c17be71ae4d588da7369472e5bb1b",22886094,1,6,0,1257,31,34,3
"c33c17be71ae4d588da7369472e5bb1b","4e51676dc72045d99c19b9fa7b22f8bc",22886094,1,-9,0,1258,34,29,-5
"4e51676dc72045d99c19b9fa7b22f8bc","c33c17be71ae4d588da7369472e5bb1b",22886094,2,9,0,1259,29,34,5
"c33c17be71ae4d588da7369472e5bb1b","93679be414554a11b1893002f2229a93",22886094,3,3,0,1260,34,35,1
"93679be414554a11b1893002f2229a93","7040a13096d746ac84b8fac8d9752058",22886094,2,3,0,1261,35,36,1
"7040a13096d746ac84b8fac8d9752058","93679be414554a11b1893002f2229a93",22886094,1,-3,0,1262,36,35,-1
"93679be414554a11b1893002f2229a93","9a0dc646f934470daf08c4b56ccf73db",22886094,1,6,0,1263,35,37,2
"9a0dc646f934470daf08c4b56ccf73db","7040a13096d746ac84b8fac8d9752058",22886094,1,-3,0,1264,37,36,-1
"7040a13096d746ac84b8fac8d9752058","fc0e049d56024bc9a02c9a9c435c3df7",22886094,1,6,0,1265,36,38,2
"fc0e049d56024bc9a02c9a9c435c3df7","9a0dc646f934470daf08c4b56ccf73db",22886094,1,-3,0,1266,38,37,-1
"9a0dc646f934470daf08c4b56ccf73db","67a089198fcb4e1c8f2385786c2b296f",22886094,1,7,0,1267,37,39,2
"67a089198fcb4e1c8f2385786c2b296f","fc0e049d56024bc9a02c9a9c435c3df7",22886094,2,-4,0,1268,39,38,-1
"fc0e049d56024bc9a02c9a9c435c3df7","64d48c6c9c7940639a932219a6c87198",22886094,2,5,0,1269,38,40,2
"64d48c6c9c7940639a932219a6c87198","67a089198fcb4e1c8f2385786c2b296f",22886094,2,-1,0,1270,40,39,-1
"67a089198fcb4e1c8f2385786c2b296f","b534b89233134e30a9b5645138bfa9ee",22886094,1,4,0,1271,39,41,2
"b534b89233134e30a9b5645138bfa9ee","56586aa865414f538729c7f7735d2bc6",22886094,1,-61,0,1272,41,12,-29
"5c5ceeee4562457ba6d41515aeebfbb1","eb2a0eb537344a9e891c761662e400b6",22886094,1,-2,0,1274,17,16,-1
"eb2a0eb537344a9e891c761662e400b6","81c864a886d54a6b8ff85f7d736f4f95",22886094,1,-2,0,1275,16,15,-1
"81c864a886d54a6b8ff85f7d736f4f95","5c5ceeee4562457ba6d41515aeebfbb1",22886094,2,4,0,1276,15,17,2
"5c5ceeee4562457ba6d41515aeebfbb1","d7f13c8d63ec4e2aa673fbb9cf9c6933",22886094,1,265,0,1279,17,206,189
"d7f13c8d63ec4e2aa673fbb9cf9c6933","a875096404ef4a9984b62d74cda916f9",22886094,1,4,0,1280,206,209,3
"a875096404ef4a9984b62d74cda916f9","09400e101c5d4b439cf9a26b03aae558",22886094,1,1,0,1281,209,210,1
"a88efa7e50ce47159810ab553afa6d3a","be502a7a43c44bf7b682698de79d9369",22886094,1,3,0,1285,212,214,2
"a875096404ef4a9984b62d74cda916f9","ec341f459285443b8361f7f15638ff08",22886094,1,5,0,1288,209,213,4
"09400e101c5d4b439cf9a26b03aae558","09400e101c5d4b439cf9a26b03aae558",22886094,10,0,1,1290,210,210,0
"a875096404ef4a9984b62d74cda916f9","f7fb1952f56b4189b86a9f8b7862d2b8",22886094,3,7,0,1295,209,215,6
"f7fb1952f56b4189b86a9f8b7862d2b8","be502a7a43c44bf7b682698de79d9369",22886094,2,-1,0,1296,215,214,-1
"be502a7a43c44bf7b682698de79d9369","ec341f459285443b8361f7f15638ff08",22886094,1,-1,0,1297,214,213,-1
"a88efa7e50ce47159810ab553afa6d3a","4a29443515bb404cb8924e1c60a63b73",22886094,1,101,0,1300,212,285,73
"4a29443515bb404cb8924e1c60a63b73","4a29443515bb404cb8924e1c60a63b73",22886094,2,0,1,1301,285,285,0
"208c9b2796c944db8dacaa96082520ea","208c9b2796c944db8dacaa96082520ea",22886094,1,0,1,1303,288,288,0
"208c9b2796c944db8dacaa96082520ea","4a29443515bb404cb8924e1c60a63b73",22886094,1,-3,0,1304,288,285,-3
"4a29443515bb404cb8924e1c60a63b73","7669a956527947d0add87455277e80b4",22886094,1,7,0,1305,285,291,6
"7669a956527947d0add87455277e80b4","7669a956527947d0add87455277e80b4",22886094,1,0,1,1306,291,291,0
"7669a956527947d0add87455277e80b4","6a9a3b5bde4a48daa896fe8c06eca56f",22886094,1,-2,0,1307,291,289,-2
"6a9a3b5bde4a48daa896fe8c06eca56f","869e967078f04da18dd0b0b9389a7424",22886094,1,5,0,1308,289,293,4
"869e967078f04da18dd0b0b9389a7424","869e967078f04da18dd0b0b9389a7424",22886094,1,0,1,1309,293,293,0
"869e967078f04da18dd0b0b9389a7424","51ab6291537748fab90d519aa09889d6",22886094,1,2,0,1310,293,295,2
"51ab6291537748fab90d519aa09889d6","51ab6291537748fab90d519aa09889d6",22886094,5,0,1,1311,295,295,0
"51ab6291537748fab90d519aa09889d6","34a6e49023fc4465bd5ca604330bbd1c",22886094,1,-3,0,1316,295,292,-3
"34a6e49023fc4465bd5ca604330bbd1c","ba0e59461bfb4a44b7b1c28a01f8d3b3",22886094,1,9,0,1317,292,299,7
"ba0e59461bfb4a44b7b1c28a01f8d3b3","21592f2a9e9c4b2f8c66ec5dbcbf6a2b",22886094,2,-4,0,1318,299,296,-3
"21592f2a9e9c4b2f8c66ec5dbcbf6a2b","7646a919d7e64fa990bca9b024ff089d",22886094,1,3,0,1319,296,298,2
"7646a919d7e64fa990bca9b024ff089d","ba0e59461bfb4a44b7b1c28a01f8d3b3",22886094,2,1,0,1320,298,299,1
"21592f2a9e9c4b2f8c66ec5dbcbf6a2b","ba0e59461bfb4a44b7b1c28a01f8d3b3",22886094,1,4,0,1322,296,299,3
"ba0e59461bfb4a44b7b1c28a01f8d3b3","0e0b36e731a645e7b1b8a88f5031ca38",22886094,1,2,0,1323,299,301,2
"0e0b36e731a645e7b1b8a88f5031ca38","0e0b36e731a645e7b1b8a88f5031ca38",22886094,5,0,1,1324,301,301,0
"0e0b36e731a645e7b1b8a88f5031ca38","a66a144637284c21afc6de17fea4bfb8",22886094,1,1,0,1329,301,302,1
"a66a144637284c21afc6de17fea4bfb8","a66a144637284c21afc6de17fea4bfb8",22886094,2,0,1,1330,302,302,0
"a66a144637284c21afc6de17fea4bfb8","7646a919d7e64fa990bca9b024ff089d",22886094,1,-4,0,1332,302,298,-4
"7646a919d7e64fa990bca9b024ff089d","e390b575229748ea8aac9364efe2bf00",22886094,1,7,0,1333,298,304,6
"e390b575229748ea8aac9364efe2bf00","e390b575229748ea8aac9364efe2bf00",22886094,1,0,1,1334,304,304,0
"e390b575229748ea8aac9364efe2bf00","3434c10e561d488a914e0f7d71907abd",22886094,1,3,0,1335,304,305,1
"3434c10e561d488a914e0f7d71907abd","4a29443515bb404cb8924e1c60a63b73",22886094,2,-27,0,1336,305,285,-20
"4a29443515bb404cb8924e1c60a63b73","53e7e900392747ccad52e711ab0f80d8",22886094,2,29,0,1337,285,307,22
"53e7e900392747ccad52e711ab0f80d8","4a29443515bb404cb8924e1c60a63b73",22886094,1,-29,0,1338,307,285,-22
"4a29443515bb404cb8924e1c60a63b73","a875096404ef4a9984b62d74cda916f9",22886094,1,-104,0,1339,285,209,-76
"ec341f459285443b8361f7f15638ff08","363837c182e04711840d896ae1e0339c",22886094,2,6,0,1346,213,218,5
"01b2051f8941460d89945e3b02d1ce78","1c6721b1f63f4d30ba7746ea8af02a52",22886094,2,7,0,1348,217,221,4
"1c6721b1f63f4d30ba7746ea8af02a52","d7f13c8d63ec4e2aa673fbb9cf9c6933",22886094,2,-21,0,1349,221,206,-15
"d7f13c8d63ec4e2aa673fbb9cf9c6933","77ecef8eff6b4a2caea7707669bf7475",22886094,2,22,0,1350,206,222,16
"0b04c8e2f86d48c7aeb7e225819cd32b","1c6721b1f63f4d30ba7746ea8af02a52",22886094,1,-16,0,1358,234,221,-13
"1c6721b1f63f4d30ba7746ea8af02a52","2ae94c0cea4d480a9d5dca8fb1d7b542",22886094,1,27,0,1359,221,242,21
"d989ebcfc12a4b669f0100dc1aa14f1e","7646a919d7e64fa990bca9b024ff089d",22886094,1,61,0,1366,255,298,43
"7646a919d7e64fa990bca9b024ff089d","4a29443515bb404cb8924e1c60a63b73",22886094,3,-17,0,1367,298,285,-13
"4a29443515bb404cb8924e1c60a63b73","ba0e59461bfb4a44b7b1c28a01f8d3b3",22886094,2,18,0,1368,285,299,14
"ba0e59461bfb4a44b7b1c28a01f8d3b3","7646a919d7e64fa990bca9b024ff089d",22886094,2,-1,0,1369,299,298,-1
"7646a919d7e64fa990bca9b024ff089d","3434c10e561d488a914e0f7d71907abd",22886094,1,10,0,1370,298,305,7
"53e7e900392747ccad52e711ab0f80d8","53e7e900392747ccad52e711ab0f80d8",22886094,3,0,1,1373,307,307,0
"53e7e900392747ccad52e711ab0f80d8","130acc2aeb0448fdbb2de63bc5cebe5b",22886094,1,3,0,1376,307,309,2
"130acc2aeb0448fdbb2de63bc5cebe5b","3434c10e561d488a914e0f7d71907abd",22886094,1,-5,0,1377,309,305,-4
"3434c10e561d488a914e0f7d71907abd","130acc2aeb0448fdbb2de63bc5cebe5b",22886094,1,5,0,1378,305,309,4
"130acc2aeb0448fdbb2de63bc5cebe5b","130acc2aeb0448fdbb2de63bc5cebe5b",22886094,1,0,1,1379,309,309,0
"130acc2aeb0448fdbb2de63bc5cebe5b","9c062b3251034ebe90f5054e2a3b5120",22886094,1,2,0,1380,309,311,2
"9c062b3251034ebe90f5054e2a3b5120","9c062b3251034ebe90f5054e2a3b5120",22886094,2,0,1,1381,311,311,0
"9c062b3251034ebe90f5054e2a3b5120","ea859f8207e44537889daeaba13ac2e8",22886094,1,1,0,1383,311,312,1
"ea859f8207e44537889daeaba13ac2e8","ea859f8207e44537889daeaba13ac2e8",22886094,1,0,1,1384,312,312,0
"ea859f8207e44537889daeaba13ac2e8","56d94971a7a94257aa330183a8ebd0ea",22886094,1,1,0,1385,312,313,1
"56d94971a7a94257aa330183a8ebd0ea","56d94971a7a94257aa330183a8ebd0ea",22886094,4,0,1,1386,313,313,0
"56d94971a7a94257aa330183a8ebd0ea","141c0df6cd1946539aadd1c9b7068cd4",22886094,1,-5,0,1390,313,308,-5
"141c0df6cd1946539aadd1c9b7068cd4","13255e63e0aa4abf85e5211bf613d43e",22886094,1,10,0,1391,308,317,9
"13255e63e0aa4abf85e5211bf613d43e","13255e63e0aa4abf85e5211bf613d43e",22886094,1,0,1,1392,317,317,0
"13255e63e0aa4abf85e5211bf613d43e","86c27d40179e419c8e9d150fb6afa5d0",22886094,1,3,0,1393,317,319,2
"86c27d40179e419c8e9d150fb6afa5d0","0c787d16c9504873b1a4d903cec09948",22886094,1,-6,0,1394,319,314,-5
"0c787d16c9504873b1a4d903cec09948","86c27d40179e419c8e9d150fb6afa5d0",22886094,1,6,0,1395,314,319,5
"86c27d40179e419c8e9d150fb6afa5d0","24f1363179ad4aaa965484a78471912b",22886094,1,5,0,1396,319,323,4
"24f1363179ad4aaa965484a78471912b","47edbb64109243e6b0f8f64cdef90c6c",22886094,2,3,0,1397,323,326,3
"47edbb64109243e6b0f8f64cdef90c6c","8d7e0b55cf9849cda222a0f2440cec55",22886094,1,-9,0,1398,326,318,-8
"8d7e0b55cf9849cda222a0f2440cec55","24f1363179ad4aaa965484a78471912b",22886094,1,6,0,1399,318,323,5
"24f1363179ad4aaa965484a78471912b","24f1363179ad4aaa965484a78471912b",22886094,7,0,1,1400,323,323,0
"24f1363179ad4aaa965484a78471912b","3628bdce1dd2429ba924d2d4d09448d2",22886094,1,-1,0,1407,323,322,-1
"3628bdce1dd2429ba924d2d4d09448d2","43ea1b823a4b4e51b7c694c10725db82",22886094,1,6,0,1408,322,327,5
"43ea1b823a4b4e51b7c694c10725db82","24f1363179ad4aaa965484a78471912b",22886094,1,-5,0,1409,327,323,-4
"47edbb64109243e6b0f8f64cdef90c6c","3628bdce1dd2429ba924d2d4d09448d2",22886094,1,-4,0,1411,326,322,-4
"3628bdce1dd2429ba924d2d4d09448d2","56b3fd1a212a4764be39d979fde3326e",22886094,1,7,0,1412,322,328,6
"56b3fd1a212a4764be39d979fde3326e","56b3fd1a212a4764be39d979fde3326e",22886094,1,0,1,1413,328,328,0
"56b3fd1a212a4764be39d979fde3326e","3434c10e561d488a914e0f7d71907abd",22886094,1,-28,0,1414,328,305,-23
"3434c10e561d488a914e0f7d71907abd","0c4079457ede49e3aeb5e86ed84bdf35",22886094,1,31,0,1415,305,329,24
"0c4079457ede49e3aeb5e86ed84bdf35","38aea304b4fa46e1b29bb72f5cea4c93",22886094,2,2,0,1416,329,331,2
"38aea304b4fa46e1b29bb72f5cea4c93","38aea304b4fa46e1b29bb72f5cea4c93",22886094,10,0,1,1417,331,331,0
"38aea304b4fa46e1b29bb72f5cea4c93","e36d261332f14e79bb4b467aceaeb9b5",22886094,1,2,0,1427,331,333,2
"e36d261332f14e79bb4b467aceaeb9b5","e36d261332f14e79bb4b467aceaeb9b5",22886094,1,0,1,1428,333,333,0
"e36d261332f14e79bb4b467aceaeb9b5","c7e89b9d04744d2eab742fc24e3ef1ae",22886094,1,1,0,1429,333,334,1
"c7e89b9d04744d2eab742fc24e3ef1ae","c7e89b9d04744d2eab742fc24e3ef1ae",22886094,2,0,1,1430,334,334,0
"c7e89b9d04744d2eab742fc24e3ef1ae","fe49f8054b374a0ea4bb266ed135ff62",22886094,1,1,0,1432,334,335,1
"fe49f8054b374a0ea4bb266ed135ff62","fe49f8054b374a0ea4bb266ed135ff62",22886094,2,0,1,1433,335,335,0
"fe49f8054b374a0ea4bb266ed135ff62","d0a8f74af98642fe8360d22c42e45117",22886094,1,1,0,1435,335,336,1
"d0a8f74af98642fe8360d22c42e45117","d0a8f74af98642fe8360d22c42e45117",22886094,2,0,1,1436,336,336,0
"d0a8f74af98642fe8360d22c42e45117","0c4079457ede49e3aeb5e86ed84bdf35",22886094,1,-7,0,1438,336,329,-7
"0c4079457ede49e3aeb5e86ed84bdf35","a7c6339ca1da4368a18d471f0519f877",22886094,1,11,0,1439,329,339,10
"a7c6339ca1da4368a18d471f0519f877","a7c6339ca1da4368a18d471f0519f877",22886094,1,0,1,1440,339,339,0
"a7c6339ca1da4368a18d471f0519f877","bbc5139ca9024389a94db3a6f47dcff6",22886094,1,3,0,1441,339,341,2
"bbc5139ca9024389a94db3a6f47dcff6","b8b9418ab322418d9db9b40d96af873a",22886094,1,-5,0,1442,341,337,-4
"b8b9418ab322418d9db9b40d96af873a","bbc5139ca9024389a94db3a6f47dcff6",22886094,1,5,0,1443,337,341,4
"bbc5139ca9024389a94db3a6f47dcff6","4ee6ca9019ab4a1ab323f98094a9bd77",22886094,1,2,0,1444,341,343,2
"4ee6ca9019ab4a1ab323f98094a9bd77","4ee6ca9019ab4a1ab323f98094a9bd77",22886094,2,0,1,1445,343,343,0
"4ee6ca9019ab4a1ab323f98094a9bd77","b37947176785476f8b29d49a851366dc",22886094,1,1,0,1447,343,344,1
"b37947176785476f8b29d49a851366dc","b37947176785476f8b29d49a851366dc",22886094,2,0,1,1448,344,344,0
"b37947176785476f8b29d49a851366dc","fcea5b10d5a14a3b9324ffece8f6e1e5",22886094,1,1,0,1450,344,345,1
"fcea5b10d5a14a3b9324ffece8f6e1e5","fcea5b10d5a14a3b9324ffece8f6e1e5",22886094,2,0,1,1451,345,345,0
"fcea5b10d5a14a3b9324ffece8f6e1e5","c2490bc612d146edbe786556fab3651b",22886094,1,-5,0,1453,345,340,-5
"c2490bc612d146edbe786556fab3651b","bbc5139ca9024389a94db3a6f47dcff6",22886094,1,1,0,1454,340,341,1
"bbc5139ca9024389a94db3a6f47dcff6","4a92daef4d504e1792575a26502bb7b7",22886094,1,6,0,1455,341,346,5
"4a92daef4d504e1792575a26502bb7b7","c2490bc612d146edbe786556fab3651b",22886094,1,-7,0,1456,346,340,-6
"c2490bc612d146edbe786556fab3651b","6ac8bb048b854999a47edb35fe627f11",22886094,1,8,0,1457,340,347,7
"6ac8bb048b854999a47edb35fe627f11","6ac8bb048b854999a47edb35fe627f11",22886094,1,0,1,1458,347,347,0
"6ac8bb048b854999a47edb35fe627f11","0c4079457ede49e3aeb5e86ed84bdf35",22886094,1,-21,0,1459,347,329,-18
"0c4079457ede49e3aeb5e86ed84bdf35","30ead9794d4847abaf222ca966cc8630",22886094,1,24,0,1460,329,348,19
"30ead9794d4847abaf222ca966cc8630","c20993c944444fe085345591a8bd837e",22886094,1,3,0,1461,348,351,3
"c20993c944444fe085345591a8bd837e","897b7f51242c44aab2205c72fdcbf4cd",22886094,2,1,0,1462,351,352,1
"897b7f51242c44aab2205c72fdcbf4cd","09b9678ddc3d452ea4a3d46e15826065",22886094,2,1,0,1463,352,353,1
"09b9678ddc3d452ea4a3d46e15826065","eff0de7f2dbb42dfa1a2e686efab5b6d",22886094,2,1,0,1464,353,354,1
"eff0de7f2dbb42dfa1a2e686efab5b6d","4a29443515bb404cb8924e1c60a63b73",22886094,1,-88,0,1465,354,285,-69
"4a29443515bb404cb8924e1c60a63b73","7646a919d7e64fa990bca9b024ff089d",22886094,1,17,0,1467,285,298,13
"4a29443515bb404cb8924e1c60a63b73","30ead9794d4847abaf222ca966cc8630",22886094,1,82,0,1471,285,348,63
"30ead9794d4847abaf222ca966cc8630","30ead9794d4847abaf222ca966cc8630",22886094,1,0,1,1472,348,348,0
"30ead9794d4847abaf222ca966cc8630","897b7f51242c44aab2205c72fdcbf4cd",22886094,1,4,0,1473,348,352,4
"897b7f51242c44aab2205c72fdcbf4cd","c20993c944444fe085345591a8bd837e",22886094,1,-1,0,1474,352,351,-1
"c20993c944444fe085345591a8bd837e","eff0de7f2dbb42dfa1a2e686efab5b6d",22886094,1,3,0,1475,351,354,3
"eff0de7f2dbb42dfa1a2e686efab5b6d","09b9678ddc3d452ea4a3d46e15826065",22886094,1,-1,0,1476,354,353,-1
"09b9678ddc3d452ea4a3d46e15826065","c20993c944444fe085345591a8bd837e",22886094,1,-2,0,1477,353,351,-2
"c20993c944444fe085345591a8bd837e","c20993c944444fe085345591a8bd837e",22886094,3,0,1,1478,351,351,0
"897b7f51242c44aab2205c72fdcbf4cd","897b7f51242c44aab2205c72fdcbf4cd",22886094,3,0,1,1482,352,352,0
"09b9678ddc3d452ea4a3d46e15826065","09b9678ddc3d452ea4a3d46e15826065",22886094,3,0,1,1486,353,353,0
"eff0de7f2dbb42dfa1a2e686efab5b6d","eff0de7f2dbb42dfa1a2e686efab5b6d",22886094,3,0,1,1490,354,354,0
"eff0de7f2dbb42dfa1a2e686efab5b6d","30ead9794d4847abaf222ca966cc8630",22886094,1,-6,0,1493,354,348,-6
"30ead9794d4847abaf222ca966cc8630","2fe14166dc9642c3bc666b86a57f943d",22886094,1,10,0,1494,348,357,9
"2fe14166dc9642c3bc666b86a57f943d","2fe14166dc9642c3bc666b86a57f943d",22886094,4,0,1,1495,357,357,0
"2fe14166dc9642c3bc666b86a57f943d","44421dd1e13a47a388c4a19834b744c7",22886094,1,2,0,1499,357,359,2
"44421dd1e13a47a388c4a19834b744c7","44421dd1e13a47a388c4a19834b744c7",22886094,2,0,1,1500,359,359,0
"44421dd1e13a47a388c4a19834b744c7","cb5fc7ef85d547c4be1a7439d0bf6052",22886094,1,1,0,1502,359,360,1
"cb5fc7ef85d547c4be1a7439d0bf6052","cb5fc7ef85d547c4be1a7439d0bf6052",22886094,2,0,1,1503,360,360,0
"cb5fc7ef85d547c4be1a7439d0bf6052","0a8f150a4cf747acbde62f4721823da3",22886094,1,1,0,1505,360,361,1
"0a8f150a4cf747acbde62f4721823da3","0a8f150a4cf747acbde62f4721823da3",22886094,2,0,1,1506,361,361,0
"0a8f150a4cf747acbde62f4721823da3","ab8fdad974ae471f9f24c3f9dd04462e",22886094,1,1,0,1508,361,362,1
"ab8fdad974ae471f9f24c3f9dd04462e","ab8fdad974ae471f9f24c3f9dd04462e",22886094,2,0,1,1509,362,362,0
"ab8fdad974ae471f9f24c3f9dd04462e","1ba8fef685d74a8194b9db252eb704fb",22886094,1,-7,0,1511,362,355,-7
"1ba8fef685d74a8194b9db252eb704fb","52580888dadb4fe3baa795683ea227bd",22886094,1,10,0,1512,355,364,9
"52580888dadb4fe3baa795683ea227bd","52580888dadb4fe3baa795683ea227bd",22886094,6,0,1,1513,364,364,0
"52580888dadb4fe3baa795683ea227bd","f00179e251a045b39c3f7a54f9aa4acc",22886094,1,-1,0,1519,364,363,-1
"f00179e251a045b39c3f7a54f9aa4acc","492a3bc6a1254f23a7998587961b22a4",22886094,1,4,0,1520,363,366,3
"492a3bc6a1254f23a7998587961b22a4","492a3bc6a1254f23a7998587961b22a4",22886094,1,0,1,1521,366,366,0
"492a3bc6a1254f23a7998587961b22a4","072a190fd302456290895f9f04d6940a",22886094,2,-1,0,1522,366,365,-1
"072a190fd302456290895f9f04d6940a","492a3bc6a1254f23a7998587961b22a4",22886094,1,1,0,1523,365,366,1
"492a3bc6a1254f23a7998587961b22a4","c76574d21bc14aeea7ecd0b027f39858",22886094,1,2,0,1524,366,367,1
"c76574d21bc14aeea7ecd0b027f39858","072a190fd302456290895f9f04d6940a",22886094,1,-3,0,1525,367,365,-2
"072a190fd302456290895f9f04d6940a","52580888dadb4fe3baa795683ea227bd",22886094,2,-2,0,1526,365,364,-1
"52580888dadb4fe3baa795683ea227bd","2fe14166dc9642c3bc666b86a57f943d",22886094,2,-8,0,1527,364,357,-7
"2fe14166dc9642c3bc666b86a57f943d","f00179e251a045b39c3f7a54f9aa4acc",22886094,2,7,0,1528,357,363,6
"f00179e251a045b39c3f7a54f9aa4acc","52580888dadb4fe3baa795683ea227bd",22886094,2,1,0,1529,363,364,1
"52580888dadb4fe3baa795683ea227bd","1ba8fef685d74a8194b9db252eb704fb",22886094,2,-10,0,1530,364,355,-9
"1ba8fef685d74a8194b9db252eb704fb","f00179e251a045b39c3f7a54f9aa4acc",22886094,2,9,0,1531,355,363,8
"f00179e251a045b39c3f7a54f9aa4acc","c76574d21bc14aeea7ecd0b027f39858",22886094,1,6,0,1532,363,367,4
"c76574d21bc14aeea7ecd0b027f39858","492a3bc6a1254f23a7998587961b22a4",22886094,1,-2,0,1533,367,366,-1
"f00179e251a045b39c3f7a54f9aa4acc","cfa457d1743848e4bb5e4beced6448ed",22886094,1,8,0,1541,363,369,6
"cfa457d1743848e4bb5e4beced6448ed","cfa457d1743848e4bb5e4beced6448ed",22886094,1,0,1,1542,369,369,0
"cfa457d1743848e4bb5e4beced6448ed","b71bac264efb4abd97015447bd490db6",22886094,1,3,0,1543,369,370,1
"b71bac264efb4abd97015447bd490db6","30ead9794d4847abaf222ca966cc8630",22886094,3,-28,0,1544,370,348,-22
"30ead9794d4847abaf222ca966cc8630","8d448d625b024c82a5eb240bbd7431d6",22886094,1,33,0,1545,348,374,26
"8d448d625b024c82a5eb240bbd7431d6","8d448d625b024c82a5eb240bbd7431d6",22886094,80,0,1,1546,374,374,0
"8d448d625b024c82a5eb240bbd7431d6","b71bac264efb4abd97015447bd490db6",22886094,2,-5,0,1553,374,370,-4
"b71bac264efb4abd97015447bd490db6","b71bac264efb4abd97015447bd490db6",22886094,1,0,1,1554,370,370,0
"b71bac264efb4abd97015447bd490db6","1b4550d0dab04078b3bf08a655345bdc",22886094,1,4,0,1555,370,373,3
"1b4550d0dab04078b3bf08a655345bdc","b71bac264efb4abd97015447bd490db6",22886094,4,-4,0,1556,373,370,-3
"b71bac264efb4abd97015447bd490db6","8d448d625b024c82a5eb240bbd7431d6",22886094,4,5,0,1557,370,374,4
"8d448d625b024c82a5eb240bbd7431d6","1b4550d0dab04078b3bf08a655345bdc",22886094,2,-1,0,1565,374,373,-1
"30ead9794d4847abaf222ca966cc8630","b71bac264efb4abd97015447bd490db6",22886094,2,28,0,1568,348,370,22
"8d448d625b024c82a5eb240bbd7431d6","7646a919d7e64fa990bca9b024ff089d",22886094,1,-98,0,1579,374,298,-76
"ba0e59461bfb4a44b7b1c28a01f8d3b3","4a29443515bb404cb8924e1c60a63b73",22886094,1,-18,0,1582,299,285,-14
"4a29443515bb404cb8924e1c60a63b73","0c4079457ede49e3aeb5e86ed84bdf35",22886094,1,58,0,1583,285,329,44
"0c4079457ede49e3aeb5e86ed84bdf35","0c4079457ede49e3aeb5e86ed84bdf35",22886094,1,0,1,1584,329,329,0
"38aea304b4fa46e1b29bb72f5cea4c93","4a29443515bb404cb8924e1c60a63b73",22886094,1,-60,0,1586,331,285,-46
"4a29443515bb404cb8924e1c60a63b73","1b4550d0dab04078b3bf08a655345bdc",22886094,1,114,0,1587,285,373,88
"b71bac264efb4abd97015447bd490db6","d6d02b6ef04e4f17805504500b8ce441",22886094,1,8,0,1653,370,375,5
"d6d02b6ef04e4f17805504500b8ce441","d6d02b6ef04e4f17805504500b8ce441",22886094,5,0,1,1654,375,375,0
"d6d02b6ef04e4f17805504500b8ce441","66baf19b6b904b70922329068c63746d",22886094,1,4,0,1656,375,376,1
"66baf19b6b904b70922329068c63746d","7f544639412e40a9ba27f43b415362ab",22886094,2,2,0,1657,376,378,2
"7f544639412e40a9ba27f43b415362ab","7f544639412e40a9ba27f43b415362ab",22886094,4,0,1,1658,378,378,0
"7f544639412e40a9ba27f43b415362ab","d5ae8642e15b46b8bd298b02274d4e9c",22886094,1,2,0,1662,378,380,2
"d5ae8642e15b46b8bd298b02274d4e9c","d5ae8642e15b46b8bd298b02274d4e9c",22886094,1,0,1,1663,380,380,0
"d5ae8642e15b46b8bd298b02274d4e9c","a0d10309a2dd456289147f84be9d37f9",22886094,1,1,0,1664,380,381,1
"a0d10309a2dd456289147f84be9d37f9","a0d10309a2dd456289147f84be9d37f9",22886094,2,0,1,1665,381,381,0
"a0d10309a2dd456289147f84be9d37f9","0fcbc3ca07b144138b8d85da581f09a8",22886094,1,1,0,1667,381,382,1
"0fcbc3ca07b144138b8d85da581f09a8","0fcbc3ca07b144138b8d85da581f09a8",22886094,2,0,1,1668,382,382,0
"0fcbc3ca07b144138b8d85da581f09a8","66baf19b6b904b70922329068c63746d",22886094,1,-6,0,1670,382,376,-6
"66baf19b6b904b70922329068c63746d","c2fca3669923477ab966ded303dea31c",22886094,1,8,0,1671,376,383,7
"c2fca3669923477ab966ded303dea31c","4890121ce5d74576b4632b77cfc23398",22886094,3,6,0,1672,383,388,5
"4890121ce5d74576b4632b77cfc23398","18d3b836dd804224883cc9180b60a8e1",22886094,3,-1,0,1673,388,387,-1
"18d3b836dd804224883cc9180b60a8e1","c2fca3669923477ab966ded303dea31c",22886094,1,-5,0,1674,387,383,-4
"4890121ce5d74576b4632b77cfc23398","4890121ce5d74576b4632b77cfc23398",22886094,1,0,1,1676,388,388,0
"18d3b836dd804224883cc9180b60a8e1","96bb2b3e85a34d8b9544514e89f6fe97",22886094,2,4,0,1678,387,390,3
"96bb2b3e85a34d8b9544514e89f6fe97","96bb2b3e85a34d8b9544514e89f6fe97",22886094,2,0,1,1679,390,390,0
"96bb2b3e85a34d8b9544514e89f6fe97","ac4e9b54acfe4670b4634859c7263cb5",22886094,1,2,0,1681,390,392,2
"ac4e9b54acfe4670b4634859c7263cb5","ac4e9b54acfe4670b4634859c7263cb5",22886094,1,0,1,1682,392,392,0
"ac4e9b54acfe4670b4634859c7263cb5","6f8881a745ac4c358a68b92c3b4abe81",22886094,1,3,0,1683,392,394,2
"6f8881a745ac4c358a68b92c3b4abe81","17f95d18bab743888e1736033dc3384d",22886094,1,-6,0,1684,394,389,-5
"17f95d18bab743888e1736033dc3384d","6f8881a745ac4c358a68b92c3b4abe81",22886094,3,6,0,1685,389,394,5
"6f8881a745ac4c358a68b92c3b4abe81","6f8881a745ac4c358a68b92c3b4abe81",22886094,5,0,1,1686,394,394,0
"6f8881a745ac4c358a68b92c3b4abe81","f7002c8484354eceac57bc7bd62c76c1",22886094,3,-1,0,1691,394,393,-1
"f7002c8484354eceac57bc7bd62c76c1","0c12af0a4e7f4002852cf84b2537c161",22886094,2,3,0,1692,393,395,2
"0c12af0a4e7f4002852cf84b2537c161","c2fca3669923477ab966ded303dea31c",22886094,1,-16,0,1693,395,383,-12
"96bb2b3e85a34d8b9544514e89f6fe97","17f95d18bab743888e1736033dc3384d",22886094,1,-1,0,1697,390,389,-1
"f7002c8484354eceac57bc7bd62c76c1","7f544639412e40a9ba27f43b415362ab",22886094,1,-19,0,1700,393,378,-15
"7f544639412e40a9ba27f43b415362ab","66baf19b6b904b70922329068c63746d",22886094,2,-2,0,1701,378,376,-2
"66baf19b6b904b70922329068c63746d","44a277ea44dc4ae689fab4b82f0b4098",22886094,1,26,0,1702,376,397,21
"44a277ea44dc4ae689fab4b82f0b4098","44a277ea44dc4ae689fab4b82f0b4098",22886094,1,0,1,1703,397,397,0
"44a277ea44dc4ae689fab4b82f0b4098","0c12af0a4e7f4002852cf84b2537c161",22886094,1,-2,0,1704,397,395,-2
"0c12af0a4e7f4002852cf84b2537c161","859e0b8d71694b12befb69ee698138f9",22886094,1,5,0,1705,395,399,4
"859e0b8d71694b12befb69ee698138f9","859e0b8d71694b12befb69ee698138f9",22886094,1,0,1,1706,399,399,0
"859e0b8d71694b12befb69ee698138f9","2b09a08242b54983aec7063990fb3f66",22886094,1,3,0,1707,399,400,1
"2b09a08242b54983aec7063990fb3f66","66baf19b6b904b70922329068c63746d",22886094,4,-32,0,1708,400,376,-24
"66baf19b6b904b70922329068c63746d","2b09a08242b54983aec7063990fb3f66",22886094,3,32,0,1709,376,400,24
"2b09a08242b54983aec7063990fb3f66","2b09a08242b54983aec7063990fb3f66",22886094,6,0,1,1712,400,400,0
"2b09a08242b54983aec7063990fb3f66","1f471b7a883a4df48211e8c6a81b59a7",22886094,1,1,0,1718,400,401,1
"1f471b7a883a4df48211e8c6a81b59a7","1f471b7a883a4df48211e8c6a81b59a7",22886094,1,0,1,1719,401,401,0
"1f471b7a883a4df48211e8c6a81b59a7","2b09a08242b54983aec7063990fb3f66",22886094,1,-1,0,1720,401,400,-1
"2b09a08242b54983aec7063990fb3f66","9de0d567bfa84fe5b77cb76f4a76a5d1",22886094,1,5,0,1721,400,404,4
"9de0d567bfa84fe5b77cb76f4a76a5d1","9de0d567bfa84fe5b77cb76f4a76a5d1",22886094,1,0,1,1722,404,404,0
"9de0d567bfa84fe5b77cb76f4a76a5d1","1157bd665ec4472fb58b751dc5099355",22886094,1,-1,0,1723,404,403,-1
"1157bd665ec4472fb58b751dc5099355","58fc9094275e4c49be3f4ba6d4acc0a4",22886094,1,5,0,1724,403,406,3
"58fc9094275e4c49be3f4ba6d4acc0a4","3c8a22d2f9c146ea956609e3ed4f2559",22886094,1,-2,0,1725,406,405,-1
"3c8a22d2f9c146ea956609e3ed4f2559","58fc9094275e4c49be3f4ba6d4acc0a4",22886094,1,2,0,1726,405,406,1
"58fc9094275e4c49be3f4ba6d4acc0a4","c1c1be90b2b14c1ab4a5e1ee3c241902",22886094,1,1,0,1727,406,407,1
"c1c1be90b2b14c1ab4a5e1ee3c241902","c1c1be90b2b14c1ab4a5e1ee3c241902",22886094,5,0,1,1728,407,407,0
"c1c1be90b2b14c1ab4a5e1ee3c241902","02b3a1bead9244c1ba2f857c7da8f82a",22886094,1,2,0,1733,407,408,1
"02b3a1bead9244c1ba2f857c7da8f82a","58fc9094275e4c49be3f4ba6d4acc0a4",22886094,3,-3,0,1734,408,406,-2
"58fc9094275e4c49be3f4ba6d4acc0a4","02b3a1bead9244c1ba2f857c7da8f82a",22886094,3,3,0,1735,406,408,2
"02b3a1bead9244c1ba2f857c7da8f82a","02b3a1bead9244c1ba2f857c7da8f82a",22886094,5,0,1,1736,408,408,0
"02b3a1bead9244c1ba2f857c7da8f82a","6206fc6479014bb193084c32409dc1b9",22886094,1,1,0,1741,408,409,1
"6206fc6479014bb193084c32409dc1b9","6206fc6479014bb193084c32409dc1b9",22886094,1,0,1,1742,409,409,0
"6206fc6479014bb193084c32409dc1b9","02b3a1bead9244c1ba2f857c7da8f82a",22886094,1,-1,0,1743,409,408,-1
"02b3a1bead9244c1ba2f857c7da8f82a","6a5f020451db426dacba9e2ea3fcc62a",22886094,2,3,0,1744,408,410,2
"6a5f020451db426dacba9e2ea3fcc62a","6a5f020451db426dacba9e2ea3fcc62a",22886094,10,0,1,1745,410,410,0
"6a5f020451db426dacba9e2ea3fcc62a","33a9d248b2e44588a5b07fc1342b9bc2",22886094,3,2,0,1755,410,411,1
"33a9d248b2e44588a5b07fc1342b9bc2","6a5f020451db426dacba9e2ea3fcc62a",22886094,2,-2,0,1756,411,410,-1
"33a9d248b2e44588a5b07fc1342b9bc2","33a9d248b2e44588a5b07fc1342b9bc2",22886094,9,0,1,1758,411,411,0
"33a9d248b2e44588a5b07fc1342b9bc2","c6f26bd420634f1cb7989e76fe6b16c0",22886094,1,1,0,1767,411,412,1
"c6f26bd420634f1cb7989e76fe6b16c0","c6f26bd420634f1cb7989e76fe6b16c0",22886094,5,0,1,1768,412,412,0
"c6f26bd420634f1cb7989e76fe6b16c0","2a65ee6e2ac64f6a8a55fbe5373ec763",22886094,1,1,0,1773,412,413,1
"2a65ee6e2ac64f6a8a55fbe5373ec763","2a65ee6e2ac64f6a8a55fbe5373ec763",22886094,2,0,1,1774,413,413,0
"2a65ee6e2ac64f6a8a55fbe5373ec763","33a9d248b2e44588a5b07fc1342b9bc2",22886094,1,-2,0,1776,413,411,-2
"33a9d248b2e44588a5b07fc1342b9bc2","1fd0f6dadbc14ebc965faf6122190b96",22886094,1,5,0,1777,411,415,4
"1fd0f6dadbc14ebc965faf6122190b96","687055dad9fc40c3982478fe33ec01bf",22886094,2,-1,0,1778,415,414,-1
"687055dad9fc40c3982478fe33ec01bf","33a9d248b2e44588a5b07fc1342b9bc2",22886094,1,-4,0,1779,414,411,-3
"33a9d248b2e44588a5b07fc1342b9bc2","02b3a1bead9244c1ba2f857c7da8f82a",22886094,1,-5,0,1782,411,408,-3
"6a5f020451db426dacba9e2ea3fcc62a","02b3a1bead9244c1ba2f857c7da8f82a",22886094,1,-3,0,1784,410,408,-2
"02b3a1bead9244c1ba2f857c7da8f82a","1fd0f6dadbc14ebc965faf6122190b96",22886094,1,10,0,1789,408,415,7
"1fd0f6dadbc14ebc965faf6122190b96","1fd0f6dadbc14ebc965faf6122190b96",22886094,1,0,1,1790,415,415,0
"687055dad9fc40c3982478fe33ec01bf","2add1669f08d4101913db15f8c23b3b7",22886094,1,3,0,1792,414,416,2
"2add1669f08d4101913db15f8c23b3b7","2add1669f08d4101913db15f8c23b3b7",22886094,1,0,1,1793,416,416,0
"2add1669f08d4101913db15f8c23b3b7","a2b4bd40cee2481ebd3fc179d6a5cd62",22886094,1,3,0,1794,416,417,1
"a2b4bd40cee2481ebd3fc179d6a5cd62","2b09a08242b54983aec7063990fb3f66",22886094,1,-27,0,1795,417,400,-17
"66baf19b6b904b70922329068c63746d","d6d02b6ef04e4f17805504500b8ce441",22886094,1,-4,0,1797,376,375,-1
"d6d02b6ef04e4f17805504500b8ce441","4a29443515bb404cb8924e1c60a63b73",22886094,1,-118,0,1801,375,285,-90
"4a29443515bb404cb8924e1c60a63b73","f00179e251a045b39c3f7a54f9aa4acc",22886094,1,99,0,1802,285,363,78
"f00179e251a045b39c3f7a54f9aa4acc","30ead9794d4847abaf222ca966cc8630",22886094,1,-17,0,1803,363,348,-15
"30ead9794d4847abaf222ca966cc8630","52580888dadb4fe3baa795683ea227bd",22886094,1,18,0,1804,348,364,16
"52580888dadb4fe3baa795683ea227bd","a2b4bd40cee2481ebd3fc179d6a5cd62",22886094,1,81,0,1805,364,417,53
"a2b4bd40cee2481ebd3fc179d6a5cd62","a2b4bd40cee2481ebd3fc179d6a5cd62",22886094,1,0,1,1806,417,417,0
"a2b4bd40cee2481ebd3fc179d6a5cd62","e34e59dce2204f228f3a84b6725df60f",22886094,1,2,0,1807,417,419,2
"e34e59dce2204f228f3a84b6725df60f","e34e59dce2204f228f3a84b6725df60f",22886094,1,0,1,1808,419,419,0
"e34e59dce2204f228f3a84b6725df60f","bec48fc2e1294c7eb3d0aca780d731b8",22886094,1,2,0,1809,419,420,1
"bec48fc2e1294c7eb3d0aca780d731b8","a2b4bd40cee2481ebd3fc179d6a5cd62",22886094,2,-4,0,1810,420,417,-3
"a2b4bd40cee2481ebd3fc179d6a5cd62","bec48fc2e1294c7eb3d0aca780d731b8",22886094,2,4,0,1811,417,420,3
"bec48fc2e1294c7eb3d0aca780d731b8","bec48fc2e1294c7eb3d0aca780d731b8",22886094,2,0,1,1812,420,420,0
"bec48fc2e1294c7eb3d0aca780d731b8","a24600b0e49245f6bdba8c893cfeddb0",22886094,1,7,0,1814,420,425,5
"a24600b0e49245f6bdba8c893cfeddb0","dbde19fcce2a4c1abdc7f685c293a23f",22886094,1,-4,0,1815,425,422,-3
"dbde19fcce2a4c1abdc7f685c293a23f","a24600b0e49245f6bdba8c893cfeddb0",22886094,1,4,0,1816,422,425,3
"a24600b0e49245f6bdba8c893cfeddb0","a24600b0e49245f6bdba8c893cfeddb0",22886094,1,0,1,1817,425,425,0
"a24600b0e49245f6bdba8c893cfeddb0","a2b4bd40cee2481ebd3fc179d6a5cd62",22886094,1,-11,0,1818,425,417,-8
"a2b4bd40cee2481ebd3fc179d6a5cd62","24cf8786024543f19b89bc20034e60d7",22886094,1,18,0,1819,417,428,11
"24cf8786024543f19b89bc20034e60d7","f2a73be2f46840b182d7bd095378004e",22886094,2,1,0,1820,428,429,1
"f2a73be2f46840b182d7bd095378004e","66baf19b6b904b70922329068c63746d",22886094,1,-78,0,1821,429,376,-53
"66baf19b6b904b70922329068c63746d","24cf8786024543f19b89bc20034e60d7",22886094,1,77,0,1822,376,428,52
"24cf8786024543f19b89bc20034e60d7","24cf8786024543f19b89bc20034e60d7",22886094,1,0,1,1823,428,428,0
"f2a73be2f46840b182d7bd095378004e","f2a73be2f46840b182d7bd095378004e",22886094,2,0,1,1825,429,429,0
"f2a73be2f46840b182d7bd095378004e","604551fd4266430cb860fef58fa7dd61",22886094,1,1,0,1827,429,430,1
"604551fd4266430cb860fef58fa7dd61","604551fd4266430cb860fef58fa7dd61",22886094,1,0,1,1828,430,430,0
"604551fd4266430cb860fef58fa7dd61","dce46f8904594a62a6377a3587aaa663",22886094,1,2,0,1829,430,431,1
"dce46f8904594a62a6377a3587aaa663","24cf8786024543f19b89bc20034e60d7",22886094,3,-4,0,1830,431,428,-3
"24cf8786024543f19b89bc20034e60d7","dce46f8904594a62a6377a3587aaa663",22886094,2,4,0,1831,428,431,3
"dce46f8904594a62a6377a3587aaa663","dce46f8904594a62a6377a3587aaa663",22886094,3,0,1,1832,431,431,0
"dce46f8904594a62a6377a3587aaa663","9b9d0a249052413c869753b99682b0ac",22886094,1,1,0,1833,431,432,1
"9b9d0a249052413c869753b99682b0ac","9b9d0a249052413c869753b99682b0ac",22886094,3,0,1,1834,432,432,0
"9b9d0a249052413c869753b99682b0ac","061c175cc90f45fbad883025394e78dd",22886094,1,1,0,1837,432,433,1
"061c175cc90f45fbad883025394e78dd","061c175cc90f45fbad883025394e78dd",22886094,6,0,1,1838,433,433,0
"061c175cc90f45fbad883025394e78dd","dce46f8904594a62a6377a3587aaa663",22886094,2,-2,0,1844,433,431,-2
"dce46f8904594a62a6377a3587aaa663","f2a73be2f46840b182d7bd095378004e",22886094,1,-3,0,1846,431,429,-2
"f2a73be2f46840b182d7bd095378004e","dce46f8904594a62a6377a3587aaa663",22886094,1,3,0,1847,429,431,2
"24cf8786024543f19b89bc20034e60d7","061c175cc90f45fbad883025394e78dd",22886094,1,6,0,1849,428,433,5
"dce46f8904594a62a6377a3587aaa663","66ada10dde9f43018588f1ced9d477fc",22886094,1,4,0,1851,431,434,3
"66ada10dde9f43018588f1ced9d477fc","dce46f8904594a62a6377a3587aaa663",22886094,1,-4,0,1852,434,431,-3
"dce46f8904594a62a6377a3587aaa663","74a7f8712e5449c2bc0b43c6f90dafed",22886094,1,5,0,1854,431,435,4
"74a7f8712e5449c2bc0b43c6f90dafed","74a7f8712e5449c2bc0b43c6f90dafed",22886094,1,0,1,1855,435,435,0
"74a7f8712e5449c2bc0b43c6f90dafed","66ada10dde9f43018588f1ced9d477fc",22886094,1,-1,0,1856,435,434,-1
"66ada10dde9f43018588f1ced9d477fc","bf12c96466d840a69bed7020b3f18bb8",22886094,1,3,0,1857,434,436,2
"bf12c96466d840a69bed7020b3f18bb8","bf12c96466d840a69bed7020b3f18bb8",22886094,2,0,1,1858,436,436,0
"bf12c96466d840a69bed7020b3f18bb8","070600601c4c439288445d2f0724807d",22886094,1,3,0,1860,436,437,1
"070600601c4c439288445d2f0724807d","24cf8786024543f19b89bc20034e60d7",22886094,1,-14,0,1861,437,428,-9
"24cf8786024543f19b89bc20034e60d7","1823b6de7d334a7aaabc4570719af4d9",22886094,1,16,0,1862,428,439,11
"1823b6de7d334a7aaabc4570719af4d9","b2f0d654738f48158edff28e8d3a546e",22886094,1,19,0,1863,439,449,10
"b2f0d654738f48158edff28e8d3a546e","b2f0d654738f48158edff28e8d3a546e",22886094,2,0,1,1864,449,449,0
"b2f0d654738f48158edff28e8d3a546e","66baf19b6b904b70922329068c63746d",22886094,1,-112,0,1865,449,376,-73
"66baf19b6b904b70922329068c63746d","b2f0d654738f48158edff28e8d3a546e",22886094,2,112,0,1866,376,449,73
"b2f0d654738f48158edff28e8d3a546e","070600601c4c439288445d2f0724807d",22886094,2,-21,0,1867,449,437,-12
"070600601c4c439288445d2f0724807d","070600601c4c439288445d2f0724807d",22886094,1,0,1,1868,437,437,0
"070600601c4c439288445d2f0724807d","1823b6de7d334a7aaabc4570719af4d9",22886094,1,2,0,1869,437,439,2
"1823b6de7d334a7aaabc4570719af4d9","1823b6de7d334a7aaabc4570719af4d9",22886094,11,0,1,1870,439,439,0
"1823b6de7d334a7aaabc4570719af4d9","0380cd76a7d44bc3a4da1f15e4d68f89",22886094,1,2,0,1881,439,440,1
"0380cd76a7d44bc3a4da1f15e4d68f89","070600601c4c439288445d2f0724807d",22886094,1,-4,0,1882,440,437,-3
"070600601c4c439288445d2f0724807d","0380cd76a7d44bc3a4da1f15e4d68f89",22886094,1,4,0,1883,437,440,3
"0380cd76a7d44bc3a4da1f15e4d68f89","23b7673c8b5443108c2ef09382834a86",22886094,2,2,0,1884,440,441,1
"23b7673c8b5443108c2ef09382834a86","0380cd76a7d44bc3a4da1f15e4d68f89",22886094,1,-2,0,1885,441,440,-1
"23b7673c8b5443108c2ef09382834a86","23b7673c8b5443108c2ef09382834a86",22886094,4,0,1,1887,441,441,0
"23b7673c8b5443108c2ef09382834a86","901e92500aea43c79f19f1b279050668",22886094,1,2,0,1888,441,442,1
"901e92500aea43c79f19f1b279050668","901e92500aea43c79f19f1b279050668",22886094,1,0,1,1889,442,442,0
"901e92500aea43c79f19f1b279050668","001339db8ced4cf78829ebe8b145449d",22886094,1,1,0,1890,442,443,1
"001339db8ced4cf78829ebe8b145449d","001339db8ced4cf78829ebe8b145449d",22886094,2,0,1,1891,443,443,0
"001339db8ced4cf78829ebe8b145449d","452745e0366e42ae81561bfddebcc6c3",22886094,1,1,0,1893,443,444,1
"452745e0366e42ae81561bfddebcc6c3","452745e0366e42ae81561bfddebcc6c3",22886094,2,0,1,1894,444,444,0
"452745e0366e42ae81561bfddebcc6c3","4660ff2089114e8db82ceb26a4f329e3",22886094,1,2,0,1896,444,445,1
"4660ff2089114e8db82ceb26a4f329e3","901e92500aea43c79f19f1b279050668",22886094,1,-4,0,1897,445,442,-3
"901e92500aea43c79f19f1b279050668","4660ff2089114e8db82ceb26a4f329e3",22886094,1,4,0,1898,442,445,3
"4660ff2089114e8db82ceb26a4f329e3","4660ff2089114e8db82ceb26a4f329e3",22886094,1,0,1,1899,445,445,0
"4660ff2089114e8db82ceb26a4f329e3","7bd5586eb9d8484eb74a433ee7bfe499",22886094,2,2,0,1900,445,446,1
"7bd5586eb9d8484eb74a433ee7bfe499","4660ff2089114e8db82ceb26a4f329e3",22886094,1,-2,0,1901,446,445,-1
"7bd5586eb9d8484eb74a433ee7bfe499","7bd5586eb9d8484eb74a433ee7bfe499",22886094,12,0,1,1903,446,446,0
"7bd5586eb9d8484eb74a433ee7bfe499","8a7f26e690f34dda97be16904518ca99",22886094,1,2,0,1915,446,447,1
"8a7f26e690f34dda97be16904518ca99","8a7f26e690f34dda97be16904518ca99",22886094,1,0,1,1916,447,447,0
"8a7f26e690f34dda97be16904518ca99","b2f0d654738f48158edff28e8d3a546e",22886094,1,5,0,1917,447,449,2
"070600601c4c439288445d2f0724807d","f60ee41ec635499abd48168342d32c2f",22886094,1,26,0,1919,437,453,16
"f60ee41ec635499abd48168342d32c2f","f60ee41ec635499abd48168342d32c2f",22886094,57,0,1,1920,453,453,0
"f60ee41ec635499abd48168342d32c2f","b2f0d654738f48158edff28e8d3a546e",22886094,3,-5,0,1923,453,449,-4
"b2f0d654738f48158edff28e8d3a546e","f60ee41ec635499abd48168342d32c2f",22886094,3,5,0,1924,449,453,4
"f60ee41ec635499abd48168342d32c2f","9428d8bd9c5a47b2a235b254e5e27ded",22886094,1,-1,0,1928,453,452,-1
"9428d8bd9c5a47b2a235b254e5e27ded","66baf19b6b904b70922329068c63746d",22886094,1,-116,0,1929,452,376,-76
"66baf19b6b904b70922329068c63746d","66baf19b6b904b70922329068c63746d",22886094,1,0,1,1930,376,376,0
"66baf19b6b904b70922329068c63746d","4890121ce5d74576b4632b77cfc23398",22886094,1,14,0,1933,376,388,12
"4890121ce5d74576b4632b77cfc23398","c2fca3669923477ab966ded303dea31c",22886094,1,-6,0,1934,388,383,-5
"c2fca3669923477ab966ded303dea31c","96bb2b3e85a34d8b9544514e89f6fe97",22886094,1,9,0,1935,383,390,7
"96bb2b3e85a34d8b9544514e89f6fe97","18d3b836dd804224883cc9180b60a8e1",22886094,1,-4,0,1936,390,387,-3
"18d3b836dd804224883cc9180b60a8e1","17f95d18bab743888e1736033dc3384d",22886094,1,3,0,1937,387,389,2
"0c12af0a4e7f4002852cf84b2537c161","2b09a08242b54983aec7063990fb3f66",22886094,1,8,0,1941,395,400,5
"2b09a08242b54983aec7063990fb3f66","6a5f020451db426dacba9e2ea3fcc62a",22886094,2,15,0,1944,400,410,10
"6a5f020451db426dacba9e2ea3fcc62a","2b09a08242b54983aec7063990fb3f66",22886094,1,-15,0,1945,410,400,-10
"6a5f020451db426dacba9e2ea3fcc62a","bec48fc2e1294c7eb3d0aca780d731b8",22886094,1,16,0,1947,410,420,10
"bec48fc2e1294c7eb3d0aca780d731b8","dce46f8904594a62a6377a3587aaa663",22886094,1,18,0,1950,420,431,11
"dce46f8904594a62a6377a3587aaa663","66baf19b6b904b70922329068c63746d",22886094,1,-81,0,1953,431,376,-55
"66baf19b6b904b70922329068c63746d","f67fbf45a5f146ed866965bc57c7c001",22886094,1,120,0,1954,376,454,78
"f67fbf45a5f146ed866965bc57c7c001","f67fbf45a5f146ed866965bc57c7c001",22886094,5,0,1,1955,454,454,0
"f67fbf45a5f146ed866965bc57c7c001","66baf19b6b904b70922329068c63746d",22886094,1,-120,0,1956,454,376,-78
"b2f0d654738f48158edff28e8d3a546e","f67fbf45a5f146ed866965bc57c7c001",22886094,1,8,0,2014,449,454,5
"f67fbf45a5f146ed866965bc57c7c001","d937afe49bd24a07a550dda1c1155122",22886094,1,1,0,2019,454,455,1
"d937afe49bd24a07a550dda1c1155122","d937afe49bd24a07a550dda1c1155122",22886094,1,0,1,2020,455,455,0
"d937afe49bd24a07a550dda1c1155122","3628b3f7823443d0912a339096b69943",22886094,1,1,0,2021,455,456,1
"3628b3f7823443d0912a339096b69943","3628b3f7823443d0912a339096b69943",22886094,1,0,1,2022,456,456,0
"3628b3f7823443d0912a339096b69943","9e049ee647cf43ecbcb5ed792a8e7588",22886094,1,1,0,2023,456,457,1
"9e049ee647cf43ecbcb5ed792a8e7588","9e049ee647cf43ecbcb5ed792a8e7588",22886094,1,0,1,2024,457,457,0
"9e049ee647cf43ecbcb5ed792a8e7588","5256a214faaf410b93f76cea06428334",22886094,1,1,0,2025,457,458,1
"5256a214faaf410b93f76cea06428334","5256a214faaf410b93f76cea06428334",22886094,1,0,1,2026,458,458,0
"5256a214faaf410b93f76cea06428334","25c32b120fce40fa9b6c85133aeb4716",22886094,1,1,0,2027,458,459,1
"25c32b120fce40fa9b6c85133aeb4716","25c32b120fce40fa9b6c85133aeb4716",22886094,1,0,1,2028,459,459,0
"25c32b120fce40fa9b6c85133aeb4716","11bc14f2204949008b7d511b933363c1",22886094,1,1,0,2029,459,460,1
"11bc14f2204949008b7d511b933363c1","11bc14f2204949008b7d511b933363c1",22886094,1,0,1,2030,460,460,0
"11bc14f2204949008b7d511b933363c1","42de338840a34d15adb66e7b14fb9d2c",22886094,1,1,0,2031,460,461,1
"42de338840a34d15adb66e7b14fb9d2c","42de338840a34d15adb66e7b14fb9d2c",22886094,1,0,1,2032,461,461,0
"42de338840a34d15adb66e7b14fb9d2c","9da37c6210b1416b8079c274f70bf600",22886094,1,1,0,2033,461,462,1
"9da37c6210b1416b8079c274f70bf600","9da37c6210b1416b8079c274f70bf600",22886094,1,0,1,2034,462,462,0
"9da37c6210b1416b8079c274f70bf600","519119f1deac45ff9ab4f13529be5c6e",22886094,1,1,0,2035,462,463,1
"519119f1deac45ff9ab4f13529be5c6e","519119f1deac45ff9ab4f13529be5c6e",22886094,1,0,1,2036,463,463,0
"519119f1deac45ff9ab4f13529be5c6e","c5df9f40ec14463b9dcfdc73df3e9285",22886094,1,3,0,2037,463,464,1
"c5df9f40ec14463b9dcfdc73df3e9285","f67fbf45a5f146ed866965bc57c7c001",22886094,1,-12,0,2038,464,454,-10
"f67fbf45a5f146ed866965bc57c7c001","c5df9f40ec14463b9dcfdc73df3e9285",22886094,1,12,0,2039,454,464,10
"c5df9f40ec14463b9dcfdc73df3e9285","83d42d95cd844fc093fc09cee250edb8",22886094,2,3,0,2040,464,465,1
"83d42d95cd844fc093fc09cee250edb8","c5df9f40ec14463b9dcfdc73df3e9285",22886094,1,-3,0,2041,465,464,-1
"83d42d95cd844fc093fc09cee250edb8","83d42d95cd844fc093fc09cee250edb8",22886094,7,0,1,2043,465,465,0
"83d42d95cd844fc093fc09cee250edb8","070600601c4c439288445d2f0724807d",22886094,1,-44,0,2050,465,437,-28
"070600601c4c439288445d2f0724807d","23b7673c8b5443108c2ef09382834a86",22886094,1,6,0,2051,437,441,4
"b613861cecf84ffcab01afb23f660475","b613861cecf84ffcab01afb23f660475",22888374,3,0,1,1,1,1,0
"519d1b8c59404d67b54e96c5c8a830b2","531db53f81f646edb0cdcfe0085b03b7",22888374,2,1,0,10,3,4,1
"531db53f81f646edb0cdcfe0085b03b7","531db53f81f646edb0cdcfe0085b03b7",22888374,2,0,1,11,4,4,0
"531db53f81f646edb0cdcfe0085b03b7","4f5f94b2f95141e0a9d53a61da2276da",22888374,2,1,0,12,4,5,1
"4f5f94b2f95141e0a9d53a61da2276da","4f5f94b2f95141e0a9d53a61da2276da",22888374,2,0,1,13,5,5,0
"4f5f94b2f95141e0a9d53a61da2276da","6d541c89590949f99af293c4f2333f67",22888374,1,1,0,14,5,6,1
"6d541c89590949f99af293c4f2333f67","6d541c89590949f99af293c4f2333f67",22888374,1,0,1,15,6,6,0
"6d541c89590949f99af293c4f2333f67","dd5cf0b9fe4c4f1d8f5ff8e4c04879cb",22888374,1,1,0,16,6,7,1
"dd5cf0b9fe4c4f1d8f5ff8e4c04879cb","dd5cf0b9fe4c4f1d8f5ff8e4c04879cb",22888374,1,0,1,17,7,7,0
"dd5cf0b9fe4c4f1d8f5ff8e4c04879cb","f96261861edc426abe2248be4f0a709a",22888374,1,1,0,18,7,8,1
"f96261861edc426abe2248be4f0a709a","f96261861edc426abe2248be4f0a709a",22888374,1,0,1,19,8,8,0
"f96261861edc426abe2248be4f0a709a","66b5e16f4f75454fb5b8172079f0fa83",22888374,1,1,0,20,8,9,1
"66b5e16f4f75454fb5b8172079f0fa83","66b5e16f4f75454fb5b8172079f0fa83",22888374,1,0,1,21,9,9,0
"66b5e16f4f75454fb5b8172079f0fa83","0680571d4698477995e41842c36a54b2",22888374,1,1,0,22,9,10,1
"0680571d4698477995e41842c36a54b2","0680571d4698477995e41842c36a54b2",22888374,1,0,1,23,10,10,0
"0680571d4698477995e41842c36a54b2","e2911e79efc2420eac45d9f671463d4b",22888374,1,-8,0,24,10,2,-8
"56586aa865414f538729c7f7735d2bc6","9112f2bffece48e08c6d2287be204085",22888374,1,-3,0,26,12,11,-1
"9112f2bffece48e08c6d2287be204085","e2911e79efc2420eac45d9f671463d4b",22888374,1,-9,0,27,11,2,-9
"e2911e79efc2420eac45d9f671463d4b","e2911e79efc2420eac45d9f671463d4b",22888374,6,0,1,28,2,2,0
"e2911e79efc2420eac45d9f671463d4b","519d1b8c59404d67b54e96c5c8a830b2",22888374,2,1,0,33,2,3,1
"519d1b8c59404d67b54e96c5c8a830b2","519d1b8c59404d67b54e96c5c8a830b2",22888374,2,0,1,34,3,3,0
"4f5f94b2f95141e0a9d53a61da2276da","e2911e79efc2420eac45d9f671463d4b",22888374,1,-3,0,39,5,2,-3
"56586aa865414f538729c7f7735d2bc6","b7f2b31585d94eb3bf86376714aa7070",22888374,2,2,0,45,12,13,1
"b7f2b31585d94eb3bf86376714aa7070","3f1c815879794b929260d224becaff7e",22888374,2,2,0,47,13,14,1
"3f1c815879794b929260d224becaff7e","5c5ceeee4562457ba6d41515aeebfbb1",22888374,2,6,0,48,14,17,3
"5c5ceeee4562457ba6d41515aeebfbb1","81c864a886d54a6b8ff85f7d736f4f95",22888374,2,-4,0,49,17,15,-2
"81c864a886d54a6b8ff85f7d736f4f95","5c5ceeee4562457ba6d41515aeebfbb1",22888374,1,4,0,50,15,17,2
"5c5ceeee4562457ba6d41515aeebfbb1","56586aa865414f538729c7f7735d2bc6",22888374,1,-10,0,51,17,12,-5
"81c864a886d54a6b8ff85f7d736f4f95","56586aa865414f538729c7f7735d2bc6",22888374,1,-6,0,59,15,12,-3
"9afd71a5298d4333b6849dfce1b9422c","b7719e26494940efa49512aedd0aac79",22888374,1,4,0,61,18,20,2
"9afd71a5298d4333b6849dfce1b9422c","d4f45188d3c84a02ba08454e6403a818",22888374,1,9,0,63,18,24,6
"d4f45188d3c84a02ba08454e6403a818","d4c3b003e8274e429d2fa688d73fde6d",22888374,1,-2,0,64,24,22,-2
"d4c3b003e8274e429d2fa688d73fde6d","d4c3b003e8274e429d2fa688d73fde6d",22888374,1,0,1,65,22,22,0
"b7719e26494940efa49512aedd0aac79","b7719e26494940efa49512aedd0aac79",22888374,2,0,1,67,20,20,0
"4e51676dc72045d99c19b9fa7b22f8bc","51970cfa30e643e894e66ae85c8024cc",22888374,1,3,0,75,29,31,2
"51970cfa30e643e894e66ae85c8024cc","4e51676dc72045d99c19b9fa7b22f8bc",22888374,1,-3,0,76,31,29,-2
"4e51676dc72045d99c19b9fa7b22f8bc","c33c17be71ae4d588da7369472e5bb1b",22888374,1,9,0,77,29,34,5
"c33c17be71ae4d588da7369472e5bb1b","c33c17be71ae4d588da7369472e5bb1b",22888374,1,0,1,78,34,34,0
"c33c17be71ae4d588da7369472e5bb1b","93679be414554a11b1893002f2229a93",22888374,1,3,0,79,34,35,1
"93679be414554a11b1893002f2229a93","93679be414554a11b1893002f2229a93",22888374,1,0,1,80,35,35,0
"93679be414554a11b1893002f2229a93","7040a13096d746ac84b8fac8d9752058",22888374,1,3,0,81,35,36,1
"7040a13096d746ac84b8fac8d9752058","7040a13096d746ac84b8fac8d9752058",22888374,1,0,1,82,36,36,0
"9a0dc646f934470daf08c4b56ccf73db","9a0dc646f934470daf08c4b56ccf73db",22888374,1,0,1,84,37,37,0
"fc0e049d56024bc9a02c9a9c435c3df7","67a089198fcb4e1c8f2385786c2b296f",22888374,1,4,0,86,38,39,1
"b534b89233134e30a9b5645138bfa9ee","b534b89233134e30a9b5645138bfa9ee",22888374,1,0,1,96,41,41,0
"b534b89233134e30a9b5645138bfa9ee","0e37b720d23b4e7f8b313e79313fd107",22888374,1,3,0,97,41,44,3
"0e37b720d23b4e7f8b313e79313fd107","0e37b720d23b4e7f8b313e79313fd107",22888374,1,0,1,98,44,44,0
"0e37b720d23b4e7f8b313e79313fd107","6875d67fdd5f48168b62719df449bebd",22888374,1,1,0,99,44,45,1
"6875d67fdd5f48168b62719df449bebd","6875d67fdd5f48168b62719df449bebd",22888374,1,0,1,100,45,45,0
"6875d67fdd5f48168b62719df449bebd","6e13d61a7bdb44bca949c9f86fab3be5",22888374,1,3,0,101,45,47,2
"6e13d61a7bdb44bca949c9f86fab3be5","b534b89233134e30a9b5645138bfa9ee",22888374,1,-7,0,102,47,41,-6
"b534b89233134e30a9b5645138bfa9ee","6e13d61a7bdb44bca949c9f86fab3be5",22888374,1,7,0,103,41,47,6
"6e13d61a7bdb44bca949c9f86fab3be5","6e13d61a7bdb44bca949c9f86fab3be5",22888374,1,0,1,104,47,47,0
"6e13d61a7bdb44bca949c9f86fab3be5","195f78799f984cc2b06c48dfe36be751",22888374,1,2,0,105,47,49,2
"195f78799f984cc2b06c48dfe36be751","195f78799f984cc2b06c48dfe36be751",22888374,2,0,1,106,49,49,0
"195f78799f984cc2b06c48dfe36be751","d9c8d8c444a64dadbbb508652c721e17",22888374,1,-3,0,108,49,46,-3
"d9c8d8c444a64dadbbb508652c721e17","d0c74f735e024943943e40333d6d337f",22888374,1,6,0,109,46,51,5
"d0c74f735e024943943e40333d6d337f","d0c74f735e024943943e40333d6d337f",22888374,1,0,1,110,51,51,0
"d0c74f735e024943943e40333d6d337f","983f8ff320594b279a7f4a6fe132f9c5",22888374,1,2,0,111,51,53,2
"983f8ff320594b279a7f4a6fe132f9c5","983f8ff320594b279a7f4a6fe132f9c5",22888374,2,0,1,112,53,53,0
"983f8ff320594b279a7f4a6fe132f9c5","35adfa5d923046aebabfefd98f35ff05",22888374,1,1,0,114,53,54,1
"35adfa5d923046aebabfefd98f35ff05","35adfa5d923046aebabfefd98f35ff05",22888374,8,0,1,115,54,54,0
"35adfa5d923046aebabfefd98f35ff05","b6f8a98476224da1b40e555ececc7ed8",22888374,1,1,0,123,54,55,1
"b6f8a98476224da1b40e555ececc7ed8","b6f8a98476224da1b40e555ececc7ed8",22888374,2,0,1,124,55,55,0
"b6f8a98476224da1b40e555ececc7ed8","86e22cb5fe0e4b47a9489ecddf7ed78f",22888374,1,1,0,126,55,56,1
"86e22cb5fe0e4b47a9489ecddf7ed78f","86e22cb5fe0e4b47a9489ecddf7ed78f",22888374,2,0,1,127,56,56,0
"86e22cb5fe0e4b47a9489ecddf7ed78f","f924752d8a1149668870b1e7698486f7",22888374,1,-6,0,129,56,50,-6
"f924752d8a1149668870b1e7698486f7","a1f2f12debe5432fb7a70bcd12bacfb9",22888374,1,9,0,130,50,58,8
"a1f2f12debe5432fb7a70bcd12bacfb9","78f30e4dcac84e3cbea8b2cc6e0d62b3",22888374,3,1,0,131,58,59,1
"78f30e4dcac84e3cbea8b2cc6e0d62b3","a1f2f12debe5432fb7a70bcd12bacfb9",22888374,2,-1,0,132,59,58,-1
"a1f2f12debe5432fb7a70bcd12bacfb9","a1f2f12debe5432fb7a70bcd12bacfb9",22888374,23,0,1,133,58,58,0
"78f30e4dcac84e3cbea8b2cc6e0d62b3","78f30e4dcac84e3cbea8b2cc6e0d62b3",22888374,29,0,1,157,59,59,0
"78f30e4dcac84e3cbea8b2cc6e0d62b3","12aa6e1672ac4e7aa6449a7a8609cd72",22888374,1,-2,0,186,59,57,-2
"12aa6e1672ac4e7aa6449a7a8609cd72","bc42d26810654ea9a1df1efe1e58c7d5",22888374,1,7,0,187,57,63,6
"a0a418b8540d479fa6e0f653b701da8b","4c943503763e4e349906eea3ed3c8e86",22888374,1,-3,0,189,64,61,-3
"4c943503763e4e349906eea3ed3c8e86","4c943503763e4e349906eea3ed3c8e86",22888374,1,0,1,190,61,61,0
"4c943503763e4e349906eea3ed3c8e86","bc42d26810654ea9a1df1efe1e58c7d5",22888374,1,2,0,191,61,63,2
"309ccf3cc4fe429d9bfbaef53d3fa479","b534b89233134e30a9b5645138bfa9ee",22888374,1,-23,0,200,60,41,-19
"b534b89233134e30a9b5645138bfa9ee","d646286c8051419bbc2e31dd1db55ca8",22888374,1,33,0,201,41,67,26
"d646286c8051419bbc2e31dd1db55ca8","267f883678b24aed855fde42524975d9",22888374,1,4,0,202,67,71,4
"267f883678b24aed855fde42524975d9","267f883678b24aed855fde42524975d9",22888374,1,0,1,203,71,71,0
"267f883678b24aed855fde42524975d9","88fff56d0342490dbef9040750a20f6c",22888374,1,1,0,204,71,72,1
"88fff56d0342490dbef9040750a20f6c","88fff56d0342490dbef9040750a20f6c",22888374,1,0,1,205,72,72,0
"88fff56d0342490dbef9040750a20f6c","adb17b12b66c4a49a85fd34322f7df70",22888374,1,1,0,206,72,73,1
"adb17b12b66c4a49a85fd34322f7df70","adb17b12b66c4a49a85fd34322f7df70",22888374,1,0,1,207,73,73,0
"adb17b12b66c4a49a85fd34322f7df70","d646286c8051419bbc2e31dd1db55ca8",22888374,1,-6,0,208,73,67,-6
"d646286c8051419bbc2e31dd1db55ca8","a2becd407db34b189200a32546d9d569",22888374,1,9,0,209,67,75,8
"a2becd407db34b189200a32546d9d569","a2becd407db34b189200a32546d9d569",22888374,3,0,1,210,75,75,0
"a2becd407db34b189200a32546d9d569","58c22b011d0f4c2ea6d13615edbb9eeb",22888374,1,2,0,213,75,77,2
"58c22b011d0f4c2ea6d13615edbb9eeb","58c22b011d0f4c2ea6d13615edbb9eeb",22888374,4,0,1,214,77,77,0
"58c22b011d0f4c2ea6d13615edbb9eeb","dd76e1861dc9461c830888729d091ee0",22888374,1,1,0,216,77,78,1
"dd76e1861dc9461c830888729d091ee0","dd76e1861dc9461c830888729d091ee0",22888374,7,0,1,217,78,78,0
"dd76e1861dc9461c830888729d091ee0","cd1d828f1a694b87913a7ea66c23803e",22888374,1,1,0,222,78,79,1
"cd1d828f1a694b87913a7ea66c23803e","cd1d828f1a694b87913a7ea66c23803e",22888374,4,0,1,223,79,79,0
"cd1d828f1a694b87913a7ea66c23803e","9176a3c2b4d2465fa8b0c67096c2a97e",22888374,1,1,0,225,79,80,1
"9176a3c2b4d2465fa8b0c67096c2a97e","9176a3c2b4d2465fa8b0c67096c2a97e",22888374,18,0,1,226,80,80,0
"9176a3c2b4d2465fa8b0c67096c2a97e","cd1d828f1a694b87913a7ea66c23803e",22888374,1,-1,0,244,80,79,-1
"cd1d828f1a694b87913a7ea66c23803e","dd76e1861dc9461c830888729d091ee0",22888374,1,-1,0,247,79,78,-1
"dd76e1861dc9461c830888729d091ee0","58c22b011d0f4c2ea6d13615edbb9eeb",22888374,1,-1,0,250,78,77,-1
"58c22b011d0f4c2ea6d13615edbb9eeb","f8ec6445f7194e25b9101d4fbcb07a18",22888374,1,4,0,253,77,81,4
"f8ec6445f7194e25b9101d4fbcb07a18","f8ec6445f7194e25b9101d4fbcb07a18",22888374,8,0,1,254,81,81,0
"f8ec6445f7194e25b9101d4fbcb07a18","140d5b27b8574befad82c0a013b59dfa",22888374,1,-7,0,262,81,74,-7
"140d5b27b8574befad82c0a013b59dfa","d18a9ea32855445f8736581f5cb119ce",22888374,1,9,0,263,74,82,8
"d18a9ea32855445f8736581f5cb119ce","f564483cbd7a407681aa2fcca518cf5f",22888374,1,4,0,264,82,85,3
"f564483cbd7a407681aa2fcca518cf5f","f564483cbd7a407681aa2fcca518cf5f",22888374,1,0,1,265,85,85,0
"f564483cbd7a407681aa2fcca518cf5f","18fd01350bd5434ca636d59a599d768a",22888374,1,1,0,266,85,86,1
"18fd01350bd5434ca636d59a599d768a","18fd01350bd5434ca636d59a599d768a",22888374,8,0,1,267,86,86,0
"18fd01350bd5434ca636d59a599d768a","6a9f0ef185fb47f0937e29daa1c71ed5",22888374,1,5,0,275,86,90,4
"6a9f0ef185fb47f0937e29daa1c71ed5","ae5ac430ea254e708a6f5deaaf7464ae",22888374,1,-7,0,276,90,84,-6
"ae5ac430ea254e708a6f5deaaf7464ae","c681290961c94c4caf23b529d1ae6b9a",22888374,1,5,0,277,84,88,4
"c681290961c94c4caf23b529d1ae6b9a","c681290961c94c4caf23b529d1ae6b9a",22888374,1,0,1,278,88,88,0
"c681290961c94c4caf23b529d1ae6b9a","6a9f0ef185fb47f0937e29daa1c71ed5",22888374,1,2,0,279,88,90,2
"6a9f0ef185fb47f0937e29daa1c71ed5","d646286c8051419bbc2e31dd1db55ca8",22888374,1,-27,0,283,90,67,-23
"e20db35ced8544ddac5bc3839145e463","1febb706d7a34005ae8711ed49c76e64",22888374,1,3,0,285,91,94,3
"1febb706d7a34005ae8711ed49c76e64","1febb706d7a34005ae8711ed49c76e64",22888374,2,0,1,286,94,94,0
"1febb706d7a34005ae8711ed49c76e64","8f73ba6f5a0042f2850356ac38ac6f24",22888374,1,1,0,288,94,95,1
"8f73ba6f5a0042f2850356ac38ac6f24","8f73ba6f5a0042f2850356ac38ac6f24",22888374,5,0,1,289,95,95,0
"8f73ba6f5a0042f2850356ac38ac6f24","e2260b86653c46d7b14a41fb419dbf8c",22888374,1,1,0,294,95,96,1
"e2260b86653c46d7b14a41fb419dbf8c","e2260b86653c46d7b14a41fb419dbf8c",22888374,2,0,1,295,96,96,0
"e2260b86653c46d7b14a41fb419dbf8c","35eb641ad1d845bbba54915bce75a962",22888374,1,1,0,297,96,97,1
"35eb641ad1d845bbba54915bce75a962","35eb641ad1d845bbba54915bce75a962",22888374,5,0,1,298,97,97,0
"35eb641ad1d845bbba54915bce75a962","08be90ffbeea4795a138cd42ed8db56f",22888374,1,1,0,303,97,98,1
"08be90ffbeea4795a138cd42ed8db56f","08be90ffbeea4795a138cd42ed8db56f",22888374,5,0,1,304,98,98,0
"08be90ffbeea4795a138cd42ed8db56f","3007433c8f584dcbb5ac159c1c5f2be3",22888374,1,1,0,309,98,99,1
"3007433c8f584dcbb5ac159c1c5f2be3","3007433c8f584dcbb5ac159c1c5f2be3",22888374,5,0,1,310,99,99,0
"3007433c8f584dcbb5ac159c1c5f2be3","e20db35ced8544ddac5bc3839145e463",22888374,1,-8,0,315,99,91,-8
"e20db35ced8544ddac5bc3839145e463","d391c8b6e56a43a7b654e9dee02d904b",22888374,1,13,0,316,91,103,12
"d391c8b6e56a43a7b654e9dee02d904b","00ae5f0c51874a73a41ebea838d95682",22888374,1,-2,0,317,103,101,-2
"00ae5f0c51874a73a41ebea838d95682","00ae5f0c51874a73a41ebea838d95682",22888374,2,0,1,318,101,101,0
"d391c8b6e56a43a7b654e9dee02d904b","d391c8b6e56a43a7b654e9dee02d904b",22888374,15,0,1,321,103,103,0
"d391c8b6e56a43a7b654e9dee02d904b","6111116566fc4fd9abba409322bea245",22888374,1,1,0,336,103,104,1
"6111116566fc4fd9abba409322bea245","6111116566fc4fd9abba409322bea245",22888374,2,0,1,337,104,104,0
"6111116566fc4fd9abba409322bea245","a81b2235cb9c499eb9ea8ee0a8dd9725",22888374,1,1,0,339,104,105,1
"a81b2235cb9c499eb9ea8ee0a8dd9725","a81b2235cb9c499eb9ea8ee0a8dd9725",22888374,8,0,1,340,105,105,0
"a81b2235cb9c499eb9ea8ee0a8dd9725","2d4e0ab0ef3b4d73b82c72d4621a7579",22888374,1,1,0,348,105,106,1
"2d4e0ab0ef3b4d73b82c72d4621a7579","2d4e0ab0ef3b4d73b82c72d4621a7579",22888374,2,0,1,349,106,106,0
"2d4e0ab0ef3b4d73b82c72d4621a7579","8bdebf492ebd4e62b0d522e8ab5e5197",22888374,1,1,0,351,106,107,1
"8bdebf492ebd4e62b0d522e8ab5e5197","8bdebf492ebd4e62b0d522e8ab5e5197",22888374,2,0,1,352,107,107,0
"8bdebf492ebd4e62b0d522e8ab5e5197","73039f8c1eb9409cb4caee2cf968001e",22888374,1,-7,0,354,107,100,-7
"73039f8c1eb9409cb4caee2cf968001e","4280927ec4d643238aa49c32f9e06c6c",22888374,1,10,0,355,100,109,9
"4280927ec4d643238aa49c32f9e06c6c","4280927ec4d643238aa49c32f9e06c6c",22888374,2,0,1,356,109,109,0
"4280927ec4d643238aa49c32f9e06c6c","fc44e6a5f7654430af1227838224dceb",22888374,1,2,0,358,109,111,2
"fc44e6a5f7654430af1227838224dceb","fc44e6a5f7654430af1227838224dceb",22888374,2,0,1,359,111,111,0
"fc44e6a5f7654430af1227838224dceb","08111f75e22d409998cf8b85bd431f0a",22888374,1,-3,0,361,111,108,-3
"08111f75e22d409998cf8b85bd431f0a","a9ae0a3c070d455bb4369a8996313336",22888374,1,7,0,362,108,114,6
"a9ae0a3c070d455bb4369a8996313336","a9ae0a3c070d455bb4369a8996313336",22888374,1,0,1,363,114,114,0
"a9ae0a3c070d455bb4369a8996313336","71cec822bcff4f30a20e75dc63ef7b65",22888374,1,2,0,364,114,116,2
"71cec822bcff4f30a20e75dc63ef7b65","71cec822bcff4f30a20e75dc63ef7b65",22888374,3,0,1,365,116,116,0
"71cec822bcff4f30a20e75dc63ef7b65","37319e88176d4aefa91d7a9980dbae91",22888374,1,-4,0,368,116,112,-4
"37319e88176d4aefa91d7a9980dbae91","62bff51286ef4f348717a3cf6fe2318f",22888374,1,9,0,369,112,120,8
"62bff51286ef4f348717a3cf6fe2318f","b1cd0e7dc3ad4a8eb91a4bfdbeb025b0",22888374,1,-2,0,370,120,118,-2
"b1cd0e7dc3ad4a8eb91a4bfdbeb025b0","b1cd0e7dc3ad4a8eb91a4bfdbeb025b0",22888374,1,0,1,371,118,118,0
"b1cd0e7dc3ad4a8eb91a4bfdbeb025b0","62bff51286ef4f348717a3cf6fe2318f",22888374,1,2,0,372,118,120,2
"62bff51286ef4f348717a3cf6fe2318f","779f9ddd1fd14d1e9e69f72219a1fdbd",22888374,1,3,0,376,120,121,1
"e20db35ced8544ddac5bc3839145e463","779f9ddd1fd14d1e9e69f72219a1fdbd",22888374,1,36,0,378,91,121,30
"779f9ddd1fd14d1e9e69f72219a1fdbd","ae26e6cda8ad4a3f81bd347560d9579f",22888374,1,4,0,379,121,125,4
"ae26e6cda8ad4a3f81bd347560d9579f","ae26e6cda8ad4a3f81bd347560d9579f",22888374,1,0,1,380,125,125,0
"ae26e6cda8ad4a3f81bd347560d9579f","ee48df95832b4374aa273ceb27ec1315",22888374,1,1,0,381,125,126,1
"ee48df95832b4374aa273ceb27ec1315","ee48df95832b4374aa273ceb27ec1315",22888374,1,0,1,382,126,126,0
"ee48df95832b4374aa273ceb27ec1315","7a439da90b394756ad1777fc4c6dead5",22888374,1,1,0,383,126,127,1
"7a439da90b394756ad1777fc4c6dead5","7a439da90b394756ad1777fc4c6dead5",22888374,1,0,1,384,127,127,0
"7a439da90b394756ad1777fc4c6dead5","779f9ddd1fd14d1e9e69f72219a1fdbd",22888374,1,-6,0,385,127,121,-6
"779f9ddd1fd14d1e9e69f72219a1fdbd","a8dd5213034441ac92724b4e83eb0bb2",22888374,1,9,0,386,121,129,8
"a8dd5213034441ac92724b4e83eb0bb2","a8dd5213034441ac92724b4e83eb0bb2",22888374,2,0,1,387,129,129,0
"a8dd5213034441ac92724b4e83eb0bb2","8115eab6556b45f5b415c3b8c26a12e5",22888374,1,2,0,389,129,131,2
"8115eab6556b45f5b415c3b8c26a12e5","8115eab6556b45f5b415c3b8c26a12e5",22888374,2,0,1,390,131,131,0
"8115eab6556b45f5b415c3b8c26a12e5","ec34b06efd844b46a4c4818ecdb9b8f4",22888374,1,1,0,392,131,132,1
"ec34b06efd844b46a4c4818ecdb9b8f4","ec34b06efd844b46a4c4818ecdb9b8f4",22888374,2,0,1,393,132,132,0
"ec34b06efd844b46a4c4818ecdb9b8f4","c2e1c2b9eac64109b343a088584b576b",22888374,1,1,0,395,132,133,1
"c2e1c2b9eac64109b343a088584b576b","c2e1c2b9eac64109b343a088584b576b",22888374,2,0,1,396,133,133,0
"c2e1c2b9eac64109b343a088584b576b","579338175e0b4bbb8ef3b712b5d8b54e",22888374,1,-5,0,398,133,128,-5
"579338175e0b4bbb8ef3b712b5d8b54e","8bc5795d6a984a3eace4e2811e52dd4f",22888374,1,8,0,399,128,135,7
"8bc5795d6a984a3eace4e2811e52dd4f","8bc5795d6a984a3eace4e2811e52dd4f",22888374,5,0,1,400,135,135,0
"8bc5795d6a984a3eace4e2811e52dd4f","b416d47c56a742199b5d7c7f19d6503a",22888374,1,-1,0,405,135,134,-1
"b416d47c56a742199b5d7c7f19d6503a","cd4532ad48034873ba8bce2aac0c9808",22888374,1,4,0,406,134,137,3
"cd4532ad48034873ba8bce2aac0c9808","cd4532ad48034873ba8bce2aac0c9808",22888374,3,0,1,407,137,137,0
"cd4532ad48034873ba8bce2aac0c9808","779f9ddd1fd14d1e9e69f72219a1fdbd",22888374,1,-19,0,410,137,121,-16
"779f9ddd1fd14d1e9e69f72219a1fdbd","df1de691dafe4549a18a4398ee9dfaf9",22888374,1,23,0,411,121,139,18
"df1de691dafe4549a18a4398ee9dfaf9","6c5ad271a44743479bfaea29b1db8d02",22888374,1,4,0,412,139,143,4
"6c5ad271a44743479bfaea29b1db8d02","6c5ad271a44743479bfaea29b1db8d02",22888374,2,0,1,413,143,143,0
"6c5ad271a44743479bfaea29b1db8d02","83d311bed5374fee83d8d67a7d9d82dc",22888374,1,1,0,415,143,144,1
"83d311bed5374fee83d8d67a7d9d82dc","83d311bed5374fee83d8d67a7d9d82dc",22888374,1,0,1,416,144,144,0
"83d311bed5374fee83d8d67a7d9d82dc","402bba41861d43acb52a5abb89e8831e",22888374,1,1,0,417,144,145,1
"402bba41861d43acb52a5abb89e8831e","402bba41861d43acb52a5abb89e8831e",22888374,2,0,1,418,145,145,0
"402bba41861d43acb52a5abb89e8831e","df1de691dafe4549a18a4398ee9dfaf9",22888374,1,-6,0,420,145,139,-6
"df1de691dafe4549a18a4398ee9dfaf9","8aae34f5ddbb4052a709b12e6b0d40fa",22888374,1,9,0,421,139,147,8
"8aae34f5ddbb4052a709b12e6b0d40fa","8aae34f5ddbb4052a709b12e6b0d40fa",22888374,2,0,1,422,147,147,0
"8aae34f5ddbb4052a709b12e6b0d40fa","645b3f0249f64f76af2e19eb4d0e55b7",22888374,1,2,0,424,147,149,2
"645b3f0249f64f76af2e19eb4d0e55b7","645b3f0249f64f76af2e19eb4d0e55b7",22888374,5,0,1,425,149,149,0
"645b3f0249f64f76af2e19eb4d0e55b7","7e7b8db5064d4369805ab370aac5ddfb",22888374,1,1,0,430,149,150,1
"7e7b8db5064d4369805ab370aac5ddfb","7e7b8db5064d4369805ab370aac5ddfb",22888374,2,0,1,431,150,150,0
"7e7b8db5064d4369805ab370aac5ddfb","8956d210ae7f41968fada86d4c979d6a",22888374,1,1,0,433,150,151,1
"8956d210ae7f41968fada86d4c979d6a","8956d210ae7f41968fada86d4c979d6a",22888374,5,0,1,434,151,151,0
"8956d210ae7f41968fada86d4c979d6a","f902b0f41b544d4dbf79664fd233648d",22888374,1,-5,0,439,151,146,-5
"f902b0f41b544d4dbf79664fd233648d","ae781e8b775e4ccd93bc800dad5c8376",22888374,1,8,0,440,146,153,7
"ae781e8b775e4ccd93bc800dad5c8376","ae781e8b775e4ccd93bc800dad5c8376",22888374,2,0,1,441,153,153,0
"ae781e8b775e4ccd93bc800dad5c8376","06882a8492d9499aa31555567f575ecb",22888374,1,1,0,443,153,154,1
"06882a8492d9499aa31555567f575ecb","06882a8492d9499aa31555567f575ecb",22888374,1,0,1,444,154,154,0
"06882a8492d9499aa31555567f575ecb","f293c508f409466a8f27ddd7d1e40b20",22888374,1,1,0,445,154,155,1
"f293c508f409466a8f27ddd7d1e40b20","f293c508f409466a8f27ddd7d1e40b20",22888374,5,0,1,446,155,155,0
"f293c508f409466a8f27ddd7d1e40b20","cc4ddef5bbbe48ebb605141b347c4ed1",22888374,1,1,0,451,155,156,1
"cc4ddef5bbbe48ebb605141b347c4ed1","cc4ddef5bbbe48ebb605141b347c4ed1",22888374,1,0,1,452,156,156,0
"cc4ddef5bbbe48ebb605141b347c4ed1","f03480cf4eba413194d7af52fc0e7f28",22888374,1,-4,0,453,156,152,-4
"f03480cf4eba413194d7af52fc0e7f28","d313cec988a84645bee413e8d4724a4b",22888374,2,7,0,454,152,158,6
"d313cec988a84645bee413e8d4724a4b","dc60696c76a74368a60f72246e47700d",22888374,2,1,0,459,158,159,1
"dc60696c76a74368a60f72246e47700d","dc60696c76a74368a60f72246e47700d",22888374,4,0,1,460,159,159,0
"dc60696c76a74368a60f72246e47700d","f4ce60b4a944484082ccb701b48b3da1",22888374,1,-2,0,461,159,157,-2
"dc60696c76a74368a60f72246e47700d","df1de691dafe4549a18a4398ee9dfaf9",22888374,1,-23,0,470,159,139,-20
"65202579580f4ad38d734b4ee39d22a8","3cbcea2be0984e7dbd5a48195af10ce7",22888374,1,3,0,481,164,165,1
"78adeee1fa2c4fe0bc73f7bca9fcee86","82e6285962b8400d9d6fc32436022a94",22888374,1,10,0,483,160,167,7
"65202579580f4ad38d734b4ee39d22a8","78adeee1fa2c4fe0bc73f7bca9fcee86",22888374,1,-5,0,528,164,160,-4
"78adeee1fa2c4fe0bc73f7bca9fcee86","3cbcea2be0984e7dbd5a48195af10ce7",22888374,1,8,0,529,160,165,5
"82e6285962b8400d9d6fc32436022a94","a9ac840f098c4bd0a2ee896214ce29cd",22888374,1,3,0,531,167,168,1
"a9ac840f098c4bd0a2ee896214ce29cd","0c7262dff33c4087bc660ccf40f92f9c",22888374,1,4,0,534,168,169,1
"0c7262dff33c4087bc660ccf40f92f9c","b2275c3fad834f8d90737a2d9a6927d6",22888374,3,3,0,535,169,172,3
"b2275c3fad834f8d90737a2d9a6927d6","b2275c3fad834f8d90737a2d9a6927d6",22888374,23,0,1,538,172,172,0
"b2275c3fad834f8d90737a2d9a6927d6","eb515a26030b41f8a82a1e6114420bad",22888374,1,1,0,561,172,173,1
"eb515a26030b41f8a82a1e6114420bad","eb515a26030b41f8a82a1e6114420bad",22888374,2,0,1,562,173,173,0
"eb515a26030b41f8a82a1e6114420bad","0c7262dff33c4087bc660ccf40f92f9c",22888374,1,-4,0,564,173,169,-4
"0c7262dff33c4087bc660ccf40f92f9c","b42cc17b7de840f181a704558d0bc845",22888374,1,7,0,565,169,175,6
"b42cc17b7de840f181a704558d0bc845","b42cc17b7de840f181a704558d0bc845",22888374,8,0,1,566,175,175,0
"b42cc17b7de840f181a704558d0bc845","0c7262dff33c4087bc660ccf40f92f9c",22888374,1,-7,0,569,175,169,-6
"b2275c3fad834f8d90737a2d9a6927d6","b42cc17b7de840f181a704558d0bc845",22888374,1,4,0,571,172,175,3
"b42cc17b7de840f181a704558d0bc845","362fcb0699a14845ab29b2340093e528",22888374,1,-1,0,577,175,174,-1
"362fcb0699a14845ab29b2340093e528","ea38cc0e6e6e41edbabf210220808bf9",22888374,2,6,0,578,174,179,5
"139b097acfca451689d80c9c6eebdf7b","801f9e9135034f49bf5f8b4bdefedb41",22888374,1,-2,0,582,178,177,-1
"801f9e9135034f49bf5f8b4bdefedb41","801f9e9135034f49bf5f8b4bdefedb41",22888374,10,0,1,583,177,177,0
"801f9e9135034f49bf5f8b4bdefedb41","b87c552dd247427abe6ab5795b9c9d43",22888374,1,5,0,593,177,181,4
"b87c552dd247427abe6ab5795b9c9d43","ea38cc0e6e6e41edbabf210220808bf9",22888374,1,-2,0,594,181,179,-2
"ea38cc0e6e6e41edbabf210220808bf9","362fcb0699a14845ab29b2340093e528",22888374,1,-6,0,595,179,174,-5
"ea38cc0e6e6e41edbabf210220808bf9","ea38cc0e6e6e41edbabf210220808bf9",22888374,1,0,1,597,179,179,0
"b87c552dd247427abe6ab5795b9c9d43","b87c552dd247427abe6ab5795b9c9d43",22888374,13,0,1,599,181,181,0
"b87c552dd247427abe6ab5795b9c9d43","139b097acfca451689d80c9c6eebdf7b",22888374,1,-3,0,612,181,178,-3
"139b097acfca451689d80c9c6eebdf7b","30f660a1feb34582a739722532524f79",22888374,1,6,0,613,178,183,5
"30f660a1feb34582a739722532524f79","30f660a1feb34582a739722532524f79",22888374,5,0,1,614,183,183,0
"30f660a1feb34582a739722532524f79","2024b4885bd14338a39b7b509acbbd02",22888374,1,-1,0,619,183,182,-1
"2024b4885bd14338a39b7b509acbbd02","c3f63fe50d8e487c86bf8ef76c9cadd3",22888374,1,4,0,620,182,185,3
"c3f63fe50d8e487c86bf8ef76c9cadd3","c3f63fe50d8e487c86bf8ef76c9cadd3",22888374,1,0,1,621,185,185,0
"c3f63fe50d8e487c86bf8ef76c9cadd3","0c7262dff33c4087bc660ccf40f92f9c",22888374,1,-20,0,622,185,169,-16
"c8e371568a0c4391b25796ae4e91952e","7d932b23e1c84326ae5aa4d3c0d813d1",22888374,1,2,0,624,186,188,2
"7d932b23e1c84326ae5aa4d3c0d813d1","7d932b23e1c84326ae5aa4d3c0d813d1",22888374,3,0,1,625,188,188,0
"7d932b23e1c84326ae5aa4d3c0d813d1","ab11d94c6c8948ea90b88f19d2cd502b",22888374,1,3,0,628,188,190,2
"ab11d94c6c8948ea90b88f19d2cd502b","c8e371568a0c4391b25796ae4e91952e",22888374,1,-5,0,629,190,186,-4
"c8e371568a0c4391b25796ae4e91952e","ab11d94c6c8948ea90b88f19d2cd502b",22888374,1,5,0,630,186,190,4
"ab11d94c6c8948ea90b88f19d2cd502b","ab11d94c6c8948ea90b88f19d2cd502b",22888374,1,0,1,631,190,190,0
"ab11d94c6c8948ea90b88f19d2cd502b","f992451ed6ad4e68bb9e68ad6be7c4be",22888374,1,2,0,632,190,192,2
"f992451ed6ad4e68bb9e68ad6be7c4be","f992451ed6ad4e68bb9e68ad6be7c4be",22888374,1,0,1,633,192,192,0
"f992451ed6ad4e68bb9e68ad6be7c4be","07b44a7a51e94c78b411c753fc39dab0",22888374,1,-3,0,634,192,189,-3
"07b44a7a51e94c78b411c753fc39dab0","6cd2dcaac46847d4a0bc53f296d90375",22888374,1,6,0,635,189,194,5
"6cd2dcaac46847d4a0bc53f296d90375","6cd2dcaac46847d4a0bc53f296d90375",22888374,3,0,1,636,194,194,0
"6cd2dcaac46847d4a0bc53f296d90375","2d2580c9411c4972909db508d6956a58",22888374,1,2,0,639,194,196,2
"2d2580c9411c4972909db508d6956a58","2d2580c9411c4972909db508d6956a58",22888374,5,0,1,640,196,196,0
"2d2580c9411c4972909db508d6956a58","5bddb3d9ed264f3984702f048c7e5340",22888374,1,1,0,645,196,197,1
"5bddb3d9ed264f3984702f048c7e5340","5bddb3d9ed264f3984702f048c7e5340",22888374,2,0,1,646,197,197,0
"5bddb3d9ed264f3984702f048c7e5340","d5e8e2bd12a2466b9d6d90855f0eb079",22888374,1,1,0,648,197,198,1
"d5e8e2bd12a2466b9d6d90855f0eb079","d5e8e2bd12a2466b9d6d90855f0eb079",22888374,2,0,1,649,198,198,0
"d5e8e2bd12a2466b9d6d90855f0eb079","017d7ca8e0394b91aaadc9574df2202c",22888374,1,-5,0,651,198,193,-5
"017d7ca8e0394b91aaadc9574df2202c","54e8e9f0ea3e45c4bf3b8ac799ee31b1",22888374,1,8,0,652,193,200,7
"54e8e9f0ea3e45c4bf3b8ac799ee31b1","54e8e9f0ea3e45c4bf3b8ac799ee31b1",22888374,1,0,1,653,200,200,0
"54e8e9f0ea3e45c4bf3b8ac799ee31b1","c614a00911be4877a075f19315530fb0",22888374,1,1,0,654,200,201,1
"c614a00911be4877a075f19315530fb0","c614a00911be4877a075f19315530fb0",22888374,6,0,1,655,201,201,0
"c614a00911be4877a075f19315530fb0","a6c21bd8b95249c7972820a7a7d76aff",22888374,1,1,0,661,201,202,1
"a6c21bd8b95249c7972820a7a7d76aff","a6c21bd8b95249c7972820a7a7d76aff",22888374,1,0,1,662,202,202,0
"a6c21bd8b95249c7972820a7a7d76aff","bb329d880ab54120adaf203a693bb203",22888374,1,1,0,663,202,203,1
"bb329d880ab54120adaf203a693bb203","bb329d880ab54120adaf203a693bb203",22888374,1,0,1,664,203,203,0
"bb329d880ab54120adaf203a693bb203","f9170dd6bc6442b4acd832747609b09a",22888374,1,-4,0,665,203,199,-4
"f9170dd6bc6442b4acd832747609b09a","334c2344009840079b1d0e1b7ce3d5a7",22888374,1,7,0,666,199,205,6
"334c2344009840079b1d0e1b7ce3d5a7","334c2344009840079b1d0e1b7ce3d5a7",22888374,1,0,1,667,205,205,0
"334c2344009840079b1d0e1b7ce3d5a7","c8e371568a0c4391b25796ae4e91952e",22888374,1,-23,0,668,205,186,-19
"b9e80f77c3a44349863b19875725c384","b9e80f77c3a44349863b19875725c384",22888374,16,0,1,672,207,207,0
"7108f0e4c2584f1f9c471689ae4c885c","7108f0e4c2584f1f9c471689ae4c885c",22888374,14,0,1,689,208,208,0
"09400e101c5d4b439cf9a26b03aae558","09400e101c5d4b439cf9a26b03aae558",22888374,4,0,1,707,210,210,0
"09400e101c5d4b439cf9a26b03aae558","a88efa7e50ce47159810ab553afa6d3a",22888374,1,2,0,711,210,212,2
"a88efa7e50ce47159810ab553afa6d3a","a88efa7e50ce47159810ab553afa6d3a",22888374,2,0,1,712,212,212,0
"a88efa7e50ce47159810ab553afa6d3a","be502a7a43c44bf7b682698de79d9369",22888374,1,3,0,714,212,214,2
"be502a7a43c44bf7b682698de79d9369","be502a7a43c44bf7b682698de79d9369",22888374,1,0,1,718,214,214,0
"be502a7a43c44bf7b682698de79d9369","f7fb1952f56b4189b86a9f8b7862d2b8",22888374,2,1,0,719,214,215,1
"f7fb1952f56b4189b86a9f8b7862d2b8","f7fb1952f56b4189b86a9f8b7862d2b8",22888374,30,0,1,720,215,215,0
"f7fb1952f56b4189b86a9f8b7862d2b8","b860ee85d8bc4a2f97958cfb71be3533",22888374,1,1,0,750,215,216,1
"b860ee85d8bc4a2f97958cfb71be3533","b860ee85d8bc4a2f97958cfb71be3533",22888374,2,0,1,751,216,216,0
"b860ee85d8bc4a2f97958cfb71be3533","ec341f459285443b8361f7f15638ff08",22888374,1,-3,0,753,216,213,-3
"363837c182e04711840d896ae1e0339c","363837c182e04711840d896ae1e0339c",22888374,12,0,1,755,218,218,0
"77ecef8eff6b4a2caea7707669bf7475","77ecef8eff6b4a2caea7707669bf7475",22888374,12,0,1,773,222,222,0
"d03cb855c70044cf8c35d9ec0de696e3","a49a937d6896486d9a5396654abcf2e1",22888374,1,2,0,791,224,226,2
"a49a937d6896486d9a5396654abcf2e1","a49a937d6896486d9a5396654abcf2e1",22888374,1,0,1,792,226,226,0
"a49a937d6896486d9a5396654abcf2e1","8b9ae98743bd4d4a8a87dff1c1244211",22888374,1,1,0,793,226,227,1
"8b9ae98743bd4d4a8a87dff1c1244211","8b9ae98743bd4d4a8a87dff1c1244211",22888374,52,0,1,794,227,227,0
"2ab1535aac1346ba8801535bf729ef37","2ab1535aac1346ba8801535bf729ef37",22888374,3,0,1,848,229,229,0
"2ab1535aac1346ba8801535bf729ef37","a4f40fb48a8542c8949bae1f002cd9bc",22888374,1,2,0,851,229,231,2
"a4f40fb48a8542c8949bae1f002cd9bc","a4f40fb48a8542c8949bae1f002cd9bc",22888374,2,0,1,852,231,231,0
"a4f40fb48a8542c8949bae1f002cd9bc","8972c23e32044edb8a78fa1eed4e5947",22888374,1,1,0,854,231,232,1
"8972c23e32044edb8a78fa1eed4e5947","8972c23e32044edb8a78fa1eed4e5947",22888374,1,0,1,855,232,232,0
"8972c23e32044edb8a78fa1eed4e5947","92feb4a40f8344d38b6f722e42a53295",22888374,1,1,0,856,232,233,1
"92feb4a40f8344d38b6f722e42a53295","92feb4a40f8344d38b6f722e42a53295",22888374,2,0,1,857,233,233,0
"92feb4a40f8344d38b6f722e42a53295","5152833676bf4c6cb317060be10f68db",22888374,1,-5,0,859,233,228,-5
"5152833676bf4c6cb317060be10f68db","ca3e28f290354c08aefe5b0f769604e6",22888374,1,8,0,860,228,235,7
"ca3e28f290354c08aefe5b0f769604e6","ca3e28f290354c08aefe5b0f769604e6",22888374,4,0,1,861,235,235,0
"ca3e28f290354c08aefe5b0f769604e6","79a35eea833e4c2c9d22fc53c3c6445c",22888374,1,1,0,865,235,236,1
"79a35eea833e4c2c9d22fc53c3c6445c","79a35eea833e4c2c9d22fc53c3c6445c",22888374,4,0,1,866,236,236,0
"79a35eea833e4c2c9d22fc53c3c6445c","8f68228b1518449e9615cdafee41a2bd",22888374,1,1,0,870,236,237,1
"8f68228b1518449e9615cdafee41a2bd","8f68228b1518449e9615cdafee41a2bd",22888374,1,0,1,871,237,237,0
"8f68228b1518449e9615cdafee41a2bd","cab89fa5c3ed45a5aa550fc0352d6a42",22888374,1,1,0,872,237,238,1
"cab89fa5c3ed45a5aa550fc0352d6a42","cab89fa5c3ed45a5aa550fc0352d6a42",22888374,3,0,1,873,238,238,0
"cab89fa5c3ed45a5aa550fc0352d6a42","66d4fad4f1cf4b46be0750a99ad7a35a",22888374,1,1,0,876,238,239,1
"66d4fad4f1cf4b46be0750a99ad7a35a","66d4fad4f1cf4b46be0750a99ad7a35a",22888374,1,0,1,877,239,239,0
"66d4fad4f1cf4b46be0750a99ad7a35a","0b04c8e2f86d48c7aeb7e225819cd32b",22888374,1,-5,0,878,239,234,-5
"0b04c8e2f86d48c7aeb7e225819cd32b","f53da5fd9bfe412da4b80d4742563b6c",22888374,1,8,0,879,234,241,7
"f53da5fd9bfe412da4b80d4742563b6c","f53da5fd9bfe412da4b80d4742563b6c",22888374,1,0,1,880,241,241,0
"f53da5fd9bfe412da4b80d4742563b6c","1c6721b1f63f4d30ba7746ea8af02a52",22888374,1,-24,0,881,241,221,-20
"1ebf23f9d994469a85206e4c7b1bf5f5","1ebf23f9d994469a85206e4c7b1bf5f5",22888374,22,0,1,884,245,245,0
"1ebf23f9d994469a85206e4c7b1bf5f5","85ae675b83e8422da842cfd25596af99",22888374,1,1,0,906,245,246,1
"85ae675b83e8422da842cfd25596af99","85ae675b83e8422da842cfd25596af99",22888374,1,0,1,907,246,246,0
"85ae675b83e8422da842cfd25596af99","2ae94c0cea4d480a9d5dca8fb1d7b542",22888374,1,-4,0,908,246,242,-4
"2ae94c0cea4d480a9d5dca8fb1d7b542","fa235f0f364d47e4ae1c87f47bf8e6ba",22888374,2,12,0,909,242,252,10
"fa235f0f364d47e4ae1c87f47bf8e6ba","d7f13c8d63ec4e2aa673fbb9cf9c6933",22888374,1,-60,0,910,252,206,-46
"09400e101c5d4b439cf9a26b03aae558","a875096404ef4a9984b62d74cda916f9",22888374,1,-1,0,915,210,209,-1
"a875096404ef4a9984b62d74cda916f9","be502a7a43c44bf7b682698de79d9369",22888374,1,6,0,916,209,214,5
"f7fb1952f56b4189b86a9f8b7862d2b8","363837c182e04711840d896ae1e0339c",22888374,1,4,0,918,215,218,3
"363837c182e04711840d896ae1e0339c","ec341f459285443b8361f7f15638ff08",22888374,1,-6,0,919,218,213,-5
"ec341f459285443b8361f7f15638ff08","01b2051f8941460d89945e3b02d1ce78",22888374,1,5,0,920,213,217,4
"8b9ae98743bd4d4a8a87dff1c1244211","2ab1535aac1346ba8801535bf729ef37",22888374,1,3,0,927,227,229,2
"2ae94c0cea4d480a9d5dca8fb1d7b542","1c6721b1f63f4d30ba7746ea8af02a52",22888374,1,-27,0,933,242,221,-21
"1ebf23f9d994469a85206e4c7b1bf5f5","fa235f0f364d47e4ae1c87f47bf8e6ba",22888374,1,9,0,936,245,252,7
"fa235f0f364d47e4ae1c87f47bf8e6ba","2ae94c0cea4d480a9d5dca8fb1d7b542",22888374,1,-12,0,937,252,242,-10
"fa235f0f364d47e4ae1c87f47bf8e6ba","fa235f0f364d47e4ae1c87f47bf8e6ba",22888374,2,0,1,939,252,252,0
"fa235f0f364d47e4ae1c87f47bf8e6ba","79f7845465cc4ed19d8e4f1429541be0",22888374,1,2,0,941,252,254,2
"79f7845465cc4ed19d8e4f1429541be0","79f7845465cc4ed19d8e4f1429541be0",22888374,2,0,1,942,254,254,0
"79f7845465cc4ed19d8e4f1429541be0","6e83e23f56544a19b94067c1c558d9c0",22888374,1,-8,0,944,254,247,-7
"00f61990949545828dd12f1303d47504","00f61990949545828dd12f1303d47504",22888374,4,0,1,946,256,256,0
"00f61990949545828dd12f1303d47504","ead7bb4b64e247d2ae632ab8a296b091",22888374,1,2,0,950,256,258,2
"ead7bb4b64e247d2ae632ab8a296b091","ead7bb4b64e247d2ae632ab8a296b091",22888374,2,0,1,951,258,258,0
"ead7bb4b64e247d2ae632ab8a296b091","41b0048dde734bb280bac6116baa8e27",22888374,1,1,0,953,258,259,1
"41b0048dde734bb280bac6116baa8e27","41b0048dde734bb280bac6116baa8e27",22888374,2,0,1,954,259,259,0
"41b0048dde734bb280bac6116baa8e27","b41c5a094a604ee0915327da5cc0beb7",22888374,1,1,0,956,259,260,1
"b41c5a094a604ee0915327da5cc0beb7","b41c5a094a604ee0915327da5cc0beb7",22888374,5,0,1,957,260,260,0
"b41c5a094a604ee0915327da5cc0beb7","d546341988904f069cfa86b21457d9d9",22888374,1,-10,0,962,260,251,-9
"d546341988904f069cfa86b21457d9d9","28c171777c52431ab6b925073bd63d46",22888374,1,15,0,963,251,264,13
"28c171777c52431ab6b925073bd63d46","28c171777c52431ab6b925073bd63d46",22888374,11,0,1,964,264,264,0
"28c171777c52431ab6b925073bd63d46","ac160db940cb49ae8579162b1d52bb5d",22888374,1,2,0,975,264,266,2
"ac160db940cb49ae8579162b1d52bb5d","ac160db940cb49ae8579162b1d52bb5d",22888374,7,0,1,976,266,266,0
"ac160db940cb49ae8579162b1d52bb5d","d989ebcfc12a4b669f0100dc1aa14f1e",22888374,1,-12,0,983,266,255,-11
"d989ebcfc12a4b669f0100dc1aa14f1e","c6fd49b485cc4874b0bbdd9c6171e09c",22888374,1,15,0,984,255,268,13
"c6fd49b485cc4874b0bbdd9c6171e09c","c6fd49b485cc4874b0bbdd9c6171e09c",22888374,7,0,1,985,268,268,0
"c6fd49b485cc4874b0bbdd9c6171e09c","44240778a97c4af0937817499b75707b",22888374,1,1,0,992,268,269,1
"44240778a97c4af0937817499b75707b","44240778a97c4af0937817499b75707b",22888374,2,0,1,993,269,269,0
"44240778a97c4af0937817499b75707b","7aa76d3e993840d8805f097cbdbcd44b",22888374,1,-9,0,995,269,261,-8
"7aa76d3e993840d8805f097cbdbcd44b","865a4d3b43374da7944dc7d397f566d9",22888374,1,12,0,996,261,271,10
"865a4d3b43374da7944dc7d397f566d9","865a4d3b43374da7944dc7d397f566d9",22888374,1,0,1,997,271,271,0
"865a4d3b43374da7944dc7d397f566d9","2ae94c0cea4d480a9d5dca8fb1d7b542",22888374,1,-35,0,998,271,242,-29
"0d987bed3ffa4ed0b9a2e62e97b7b30f","d7f13c8d63ec4e2aa673fbb9cf9c6933",22888374,1,-86,0,1000,272,206,-66
"d7f13c8d63ec4e2aa673fbb9cf9c6933","b9e80f77c3a44349863b19875725c384",22888374,4,1,0,1001,206,207,1
"b9e80f77c3a44349863b19875725c384","7108f0e4c2584f1f9c471689ae4c885c",22888374,5,1,0,1002,207,208,1
"7108f0e4c2584f1f9c471689ae4c885c","09400e101c5d4b439cf9a26b03aae558",22888374,1,3,0,1003,208,210,2
"09400e101c5d4b439cf9a26b03aae558","d7f13c8d63ec4e2aa673fbb9cf9c6933",22888374,2,-5,0,1004,210,206,-4
"d7f13c8d63ec4e2aa673fbb9cf9c6933","a875096404ef4a9984b62d74cda916f9",22888374,1,4,0,1005,206,209,3
"a875096404ef4a9984b62d74cda916f9","f7fb1952f56b4189b86a9f8b7862d2b8",22888374,3,7,0,1006,209,215,6
"f7fb1952f56b4189b86a9f8b7862d2b8","be502a7a43c44bf7b682698de79d9369",22888374,2,-1,0,1007,215,214,-1
"be502a7a43c44bf7b682698de79d9369","ec341f459285443b8361f7f15638ff08",22888374,1,-1,0,1008,214,213,-1
"ec341f459285443b8361f7f15638ff08","363837c182e04711840d896ae1e0339c",22888374,3,6,0,1009,213,218,5
"363837c182e04711840d896ae1e0339c","01b2051f8941460d89945e3b02d1ce78",22888374,3,-1,0,1010,218,217,-1
"01b2051f8941460d89945e3b02d1ce78","91125ca626c5470eb145501f8c37f8db",22888374,2,4,0,1011,217,220,3
"91125ca626c5470eb145501f8c37f8db","91125ca626c5470eb145501f8c37f8db",22888374,2,0,1,1012,220,220,0
"91125ca626c5470eb145501f8c37f8db","1c6721b1f63f4d30ba7746ea8af02a52",22888374,2,3,0,1013,220,221,1
"1c6721b1f63f4d30ba7746ea8af02a52","d7f13c8d63ec4e2aa673fbb9cf9c6933",22888374,4,-21,0,1014,221,206,-15
"d7f13c8d63ec4e2aa673fbb9cf9c6933","77ecef8eff6b4a2caea7707669bf7475",22888374,3,22,0,1015,206,222,16
"77ecef8eff6b4a2caea7707669bf7475","1c6721b1f63f4d30ba7746ea8af02a52",22888374,3,-1,0,1016,222,221,-1
"1c6721b1f63f4d30ba7746ea8af02a52","8b9ae98743bd4d4a8a87dff1c1244211",22888374,3,7,0,1017,221,227,6
"8b9ae98743bd4d4a8a87dff1c1244211","d03cb855c70044cf8c35d9ec0de696e3",22888374,3,-3,0,1018,227,224,-3
"d03cb855c70044cf8c35d9ec0de696e3","f7906d6f59b9489a91d2ef40db5a474d",22888374,1,-1,0,1019,224,223,-1
"f7906d6f59b9489a91d2ef40db5a474d","2ab1535aac1346ba8801535bf729ef37",22888374,3,7,0,1020,223,229,6
"2ab1535aac1346ba8801535bf729ef37","5152833676bf4c6cb317060be10f68db",22888374,2,-1,0,1021,229,228,-1
"5152833676bf4c6cb317060be10f68db","0b04c8e2f86d48c7aeb7e225819cd32b",22888374,4,7,0,1022,228,234,6
"0b04c8e2f86d48c7aeb7e225819cd32b","1c6721b1f63f4d30ba7746ea8af02a52",22888374,4,-16,0,1023,234,221,-13
"1c6721b1f63f4d30ba7746ea8af02a52","2ae94c0cea4d480a9d5dca8fb1d7b542",22888374,6,27,0,1024,221,242,21
"2ae94c0cea4d480a9d5dca8fb1d7b542","1ebf23f9d994469a85206e4c7b1bf5f5",22888374,5,3,0,1025,242,245,3
"1ebf23f9d994469a85206e4c7b1bf5f5","2ae94c0cea4d480a9d5dca8fb1d7b542",22888374,3,-3,0,1026,245,242,-3
"2ae94c0cea4d480a9d5dca8fb1d7b542","6e83e23f56544a19b94067c1c558d9c0",22888374,1,6,0,1027,242,247,5
"6e83e23f56544a19b94067c1c558d9c0","00f61990949545828dd12f1303d47504",22888374,3,11,0,1028,247,256,9
"00f61990949545828dd12f1303d47504","d546341988904f069cfa86b21457d9d9",22888374,2,-6,0,1029,256,251,-5
"d546341988904f069cfa86b21457d9d9","30c9ba177afc49a695625d2bdec40207",22888374,1,-2,0,1030,251,250,-1
"30c9ba177afc49a695625d2bdec40207","30c9ba177afc49a695625d2bdec40207",22888374,2,0,1,1031,250,250,0
"30c9ba177afc49a695625d2bdec40207","6e83e23f56544a19b94067c1c558d9c0",22888374,1,-3,0,1033,250,247,-3
"d546341988904f069cfa86b21457d9d9","d989ebcfc12a4b669f0100dc1aa14f1e",22888374,3,5,0,1036,251,255,4
"d989ebcfc12a4b669f0100dc1aa14f1e","7aa76d3e993840d8805f097cbdbcd44b",22888374,3,7,0,1037,255,261,6
"7aa76d3e993840d8805f097cbdbcd44b","0d987bed3ffa4ed0b9a2e62e97b7b30f",22888374,2,15,0,1038,261,272,11
"0d987bed3ffa4ed0b9a2e62e97b7b30f","2ae94c0cea4d480a9d5dca8fb1d7b542",22888374,2,-38,0,1039,272,242,-30
"2ae94c0cea4d480a9d5dca8fb1d7b542","0d987bed3ffa4ed0b9a2e62e97b7b30f",22888374,4,38,0,1040,242,272,30
"0d987bed3ffa4ed0b9a2e62e97b7b30f","82ae07bc0c9b4570a41799290d1ef399",22888374,1,4,0,1041,272,275,3
"82ae07bc0c9b4570a41799290d1ef399","bb5a47f5ea01454a8b79455422d3b9da",22888374,3,6,0,1042,275,280,5
"bb5a47f5ea01454a8b79455422d3b9da","bb5a47f5ea01454a8b79455422d3b9da",22888374,21,0,1,1043,280,280,0
"bb5a47f5ea01454a8b79455422d3b9da","d7f13c8d63ec4e2aa673fbb9cf9c6933",22888374,1,-96,0,1052,280,206,-74
"d7f13c8d63ec4e2aa673fbb9cf9c6933","1c6721b1f63f4d30ba7746ea8af02a52",22888374,4,21,0,1053,206,221,15
"77ecef8eff6b4a2caea7707669bf7475","d03cb855c70044cf8c35d9ec0de696e3",22888374,2,3,0,1056,222,224,2
"d03cb855c70044cf8c35d9ec0de696e3","1c6721b1f63f4d30ba7746ea8af02a52",22888374,2,-4,0,1057,224,221,-3
"d03cb855c70044cf8c35d9ec0de696e3","d03cb855c70044cf8c35d9ec0de696e3",22888374,3,0,1,1060,224,224,0
"d03cb855c70044cf8c35d9ec0de696e3","2ab1535aac1346ba8801535bf729ef37",22888374,1,6,0,1061,224,229,5
"2ab1535aac1346ba8801535bf729ef37","f7906d6f59b9489a91d2ef40db5a474d",22888374,2,-7,0,1062,229,223,-6
"f7906d6f59b9489a91d2ef40db5a474d","5152833676bf4c6cb317060be10f68db",22888374,2,6,0,1063,223,228,5
"2ae94c0cea4d480a9d5dca8fb1d7b542","00f61990949545828dd12f1303d47504",22888374,2,17,0,1069,242,256,14
"00f61990949545828dd12f1303d47504","6e83e23f56544a19b94067c1c558d9c0",22888374,2,-11,0,1070,256,247,-9
"6e83e23f56544a19b94067c1c558d9c0","d546341988904f069cfa86b21457d9d9",22888374,2,5,0,1071,247,251,4
"7aa76d3e993840d8805f097cbdbcd44b","2ae94c0cea4d480a9d5dca8fb1d7b542",22888374,1,-23,0,1074,261,242,-19
"0d987bed3ffa4ed0b9a2e62e97b7b30f","0d987bed3ffa4ed0b9a2e62e97b7b30f",22888374,1,0,1,1076,272,272,0
"0d987bed3ffa4ed0b9a2e62e97b7b30f","bb5a47f5ea01454a8b79455422d3b9da",22888374,2,10,0,1077,272,280,8
"bb5a47f5ea01454a8b79455422d3b9da","82ae07bc0c9b4570a41799290d1ef399",22888374,2,-6,0,1083,280,275,-5
"bb5a47f5ea01454a8b79455422d3b9da","94cecc3f1e7d484b8e068e79241dfd73",22888374,1,3,0,1086,280,281,1
"94cecc3f1e7d484b8e068e79241dfd73","0d987bed3ffa4ed0b9a2e62e97b7b30f",22888374,1,-13,0,1087,281,272,-9
"0d987bed3ffa4ed0b9a2e62e97b7b30f","a37477c4e4c14169ad44b06b493007f6",22888374,1,15,0,1088,272,283,11
"a37477c4e4c14169ad44b06b493007f6","94cecc3f1e7d484b8e068e79241dfd73",22888374,1,-2,0,1089,283,281,-2
"94cecc3f1e7d484b8e068e79241dfd73","fab84b4fab5940efb4ea868ef8d09396",22888374,2,5,0,1090,281,284,3
"fab84b4fab5940efb4ea868ef8d09396","fab84b4fab5940efb4ea868ef8d09396",22888374,1,0,1,1091,284,284,0
"fab84b4fab5940efb4ea868ef8d09396","4a29443515bb404cb8924e1c60a63b73",22888374,2,4,0,1092,284,285,1
"4a29443515bb404cb8924e1c60a63b73","208c9b2796c944db8dacaa96082520ea",22888374,2,3,0,1093,285,288,3
"208c9b2796c944db8dacaa96082520ea","208c9b2796c944db8dacaa96082520ea",22888374,4,0,1,1094,288,288,0
"208c9b2796c944db8dacaa96082520ea","4a29443515bb404cb8924e1c60a63b73",22888374,1,-3,0,1098,288,285,-3
"4a29443515bb404cb8924e1c60a63b73","7669a956527947d0add87455277e80b4",22888374,1,7,0,1099,285,291,6
"7669a956527947d0add87455277e80b4","7669a956527947d0add87455277e80b4",22888374,1,0,1,1100,291,291,0
"7669a956527947d0add87455277e80b4","6a9a3b5bde4a48daa896fe8c06eca56f",22888374,1,-2,0,1101,291,289,-2
"6a9a3b5bde4a48daa896fe8c06eca56f","869e967078f04da18dd0b0b9389a7424",22888374,2,5,0,1102,289,293,4
"869e967078f04da18dd0b0b9389a7424","869e967078f04da18dd0b0b9389a7424",22888374,4,0,1,1103,293,293,0
"869e967078f04da18dd0b0b9389a7424","51ab6291537748fab90d519aa09889d6",22888374,1,2,0,1107,293,295,2
"51ab6291537748fab90d519aa09889d6","51ab6291537748fab90d519aa09889d6",22888374,5,0,1,1108,295,295,0
"51ab6291537748fab90d519aa09889d6","34a6e49023fc4465bd5ca604330bbd1c",22888374,1,-3,0,1113,295,292,-3
"34a6e49023fc4465bd5ca604330bbd1c","ba0e59461bfb4a44b7b1c28a01f8d3b3",22888374,1,9,0,1114,292,299,7
"ba0e59461bfb4a44b7b1c28a01f8d3b3","21592f2a9e9c4b2f8c66ec5dbcbf6a2b",22888374,1,-4,0,1115,299,296,-3
"21592f2a9e9c4b2f8c66ec5dbcbf6a2b","ba0e59461bfb4a44b7b1c28a01f8d3b3",22888374,2,4,0,1116,296,299,3
"ba0e59461bfb4a44b7b1c28a01f8d3b3","ba0e59461bfb4a44b7b1c28a01f8d3b3",22888374,1,0,1,1117,299,299,0
"ba0e59461bfb4a44b7b1c28a01f8d3b3","0e0b36e731a645e7b1b8a88f5031ca38",22888374,1,2,0,1118,299,301,2
"0e0b36e731a645e7b1b8a88f5031ca38","0e0b36e731a645e7b1b8a88f5031ca38",22888374,5,0,1,1119,301,301,0
"0e0b36e731a645e7b1b8a88f5031ca38","a66a144637284c21afc6de17fea4bfb8",22888374,1,1,0,1124,301,302,1
"a66a144637284c21afc6de17fea4bfb8","a66a144637284c21afc6de17fea4bfb8",22888374,2,0,1,1125,302,302,0
"a66a144637284c21afc6de17fea4bfb8","7646a919d7e64fa990bca9b024ff089d",22888374,1,-4,0,1127,302,298,-4
"7646a919d7e64fa990bca9b024ff089d","e390b575229748ea8aac9364efe2bf00",22888374,1,7,0,1128,298,304,6
"e390b575229748ea8aac9364efe2bf00","e390b575229748ea8aac9364efe2bf00",22888374,1,0,1,1129,304,304,0
"e390b575229748ea8aac9364efe2bf00","3434c10e561d488a914e0f7d71907abd",22888374,1,3,0,1130,304,305,1
"3434c10e561d488a914e0f7d71907abd","4a29443515bb404cb8924e1c60a63b73",22888374,2,-27,0,1131,305,285,-20
"4a29443515bb404cb8924e1c60a63b73","53e7e900392747ccad52e711ab0f80d8",22888374,2,29,0,1132,285,307,22
"53e7e900392747ccad52e711ab0f80d8","53e7e900392747ccad52e711ab0f80d8",22888374,3,0,1,1133,307,307,0
"53e7e900392747ccad52e711ab0f80d8","3434c10e561d488a914e0f7d71907abd",22888374,1,-2,0,1136,307,305,-2
"3434c10e561d488a914e0f7d71907abd","130acc2aeb0448fdbb2de63bc5cebe5b",22888374,1,5,0,1137,305,309,4
"130acc2aeb0448fdbb2de63bc5cebe5b","130acc2aeb0448fdbb2de63bc5cebe5b",22888374,2,0,1,1138,309,309,0
"130acc2aeb0448fdbb2de63bc5cebe5b","9c062b3251034ebe90f5054e2a3b5120",22888374,1,2,0,1140,309,311,2
"9c062b3251034ebe90f5054e2a3b5120","9c062b3251034ebe90f5054e2a3b5120",22888374,2,0,1,1141,311,311,0
"9c062b3251034ebe90f5054e2a3b5120","ea859f8207e44537889daeaba13ac2e8",22888374,1,1,0,1143,311,312,1
"ea859f8207e44537889daeaba13ac2e8","ea859f8207e44537889daeaba13ac2e8",22888374,1,0,1,1144,312,312,0
"ea859f8207e44537889daeaba13ac2e8","56d94971a7a94257aa330183a8ebd0ea",22888374,1,1,0,1145,312,313,1
"56d94971a7a94257aa330183a8ebd0ea","56d94971a7a94257aa330183a8ebd0ea",22888374,1,0,1,1146,313,313,0
"56d94971a7a94257aa330183a8ebd0ea","141c0df6cd1946539aadd1c9b7068cd4",22888374,1,-5,0,1147,313,308,-5
"141c0df6cd1946539aadd1c9b7068cd4","13255e63e0aa4abf85e5211bf613d43e",22888374,1,10,0,1148,308,317,9
"13255e63e0aa4abf85e5211bf613d43e","13255e63e0aa4abf85e5211bf613d43e",22888374,3,0,1,1149,317,317,0
"13255e63e0aa4abf85e5211bf613d43e","0c787d16c9504873b1a4d903cec09948",22888374,1,-3,0,1152,317,314,-3
"0c787d16c9504873b1a4d903cec09948","86c27d40179e419c8e9d150fb6afa5d0",22888374,2,6,0,1153,314,319,5
"86c27d40179e419c8e9d150fb6afa5d0","86c27d40179e419c8e9d150fb6afa5d0",22888374,7,0,1,1154,319,319,0
"86c27d40179e419c8e9d150fb6afa5d0","8d7e0b55cf9849cda222a0f2440cec55",22888374,2,-1,0,1161,319,318,-1
"8d7e0b55cf9849cda222a0f2440cec55","47edbb64109243e6b0f8f64cdef90c6c",22888374,2,9,0,1162,318,326,8
"47edbb64109243e6b0f8f64cdef90c6c","24f1363179ad4aaa965484a78471912b",22888374,2,-3,0,1163,326,323,-3
"24f1363179ad4aaa965484a78471912b","24f1363179ad4aaa965484a78471912b",22888374,2,0,1,1164,323,323,0
"24f1363179ad4aaa965484a78471912b","3628bdce1dd2429ba924d2d4d09448d2",22888374,2,-1,0,1166,323,322,-1
"3628bdce1dd2429ba924d2d4d09448d2","56b3fd1a212a4764be39d979fde3326e",22888374,1,7,0,1167,322,328,6
"56b3fd1a212a4764be39d979fde3326e","56b3fd1a212a4764be39d979fde3326e",22888374,1,0,1,1168,328,328,0
"56b3fd1a212a4764be39d979fde3326e","3434c10e561d488a914e0f7d71907abd",22888374,1,-28,0,1169,328,305,-23
"3434c10e561d488a914e0f7d71907abd","0c4079457ede49e3aeb5e86ed84bdf35",22888374,3,31,0,1170,305,329,24
"0c4079457ede49e3aeb5e86ed84bdf35","38aea304b4fa46e1b29bb72f5cea4c93",22888374,2,2,0,1171,329,331,2
"38aea304b4fa46e1b29bb72f5cea4c93","38aea304b4fa46e1b29bb72f5cea4c93",22888374,4,0,1,1172,331,331,0
"38aea304b4fa46e1b29bb72f5cea4c93","e36d261332f14e79bb4b467aceaeb9b5",22888374,1,2,0,1176,331,333,2
"e36d261332f14e79bb4b467aceaeb9b5","e36d261332f14e79bb4b467aceaeb9b5",22888374,1,0,1,1177,333,333,0
"e36d261332f14e79bb4b467aceaeb9b5","c7e89b9d04744d2eab742fc24e3ef1ae",22888374,1,1,0,1178,333,334,1
"c7e89b9d04744d2eab742fc24e3ef1ae","c7e89b9d04744d2eab742fc24e3ef1ae",22888374,2,0,1,1179,334,334,0
"c7e89b9d04744d2eab742fc24e3ef1ae","fe49f8054b374a0ea4bb266ed135ff62",22888374,1,1,0,1181,334,335,1
"fe49f8054b374a0ea4bb266ed135ff62","fe49f8054b374a0ea4bb266ed135ff62",22888374,2,0,1,1182,335,335,0
"fe49f8054b374a0ea4bb266ed135ff62","d0a8f74af98642fe8360d22c42e45117",22888374,1,1,0,1184,335,336,1
"d0a8f74af98642fe8360d22c42e45117","d0a8f74af98642fe8360d22c42e45117",22888374,2,0,1,1185,336,336,0
"d0a8f74af98642fe8360d22c42e45117","0c4079457ede49e3aeb5e86ed84bdf35",22888374,1,-7,0,1187,336,329,-7
"0c4079457ede49e3aeb5e86ed84bdf35","a7c6339ca1da4368a18d471f0519f877",22888374,1,11,0,1188,329,339,10
"a7c6339ca1da4368a18d471f0519f877","a7c6339ca1da4368a18d471f0519f877",22888374,1,0,1,1189,339,339,0
"a7c6339ca1da4368a18d471f0519f877","bbc5139ca9024389a94db3a6f47dcff6",22888374,1,3,0,1190,339,341,2
"bbc5139ca9024389a94db3a6f47dcff6","b8b9418ab322418d9db9b40d96af873a",22888374,1,-5,0,1191,341,337,-4
"b8b9418ab322418d9db9b40d96af873a","bbc5139ca9024389a94db3a6f47dcff6",22888374,2,5,0,1192,337,341,4
"bbc5139ca9024389a94db3a6f47dcff6","bbc5139ca9024389a94db3a6f47dcff6",22888374,2,0,1,1193,341,341,0
"bbc5139ca9024389a94db3a6f47dcff6","4ee6ca9019ab4a1ab323f98094a9bd77",22888374,1,2,0,1195,341,343,2
"4ee6ca9019ab4a1ab323f98094a9bd77","4ee6ca9019ab4a1ab323f98094a9bd77",22888374,2,0,1,1196,343,343,0
"4ee6ca9019ab4a1ab323f98094a9bd77","b37947176785476f8b29d49a851366dc",22888374,1,1,0,1198,343,344,1
"b37947176785476f8b29d49a851366dc","b37947176785476f8b29d49a851366dc",22888374,2,0,1,1199,344,344,0
"b37947176785476f8b29d49a851366dc","fcea5b10d5a14a3b9324ffece8f6e1e5",22888374,1,1,0,1201,344,345,1
"fcea5b10d5a14a3b9324ffece8f6e1e5","fcea5b10d5a14a3b9324ffece8f6e1e5",22888374,5,0,1,1202,345,345,0
"fcea5b10d5a14a3b9324ffece8f6e1e5","c2490bc612d146edbe786556fab3651b",22888374,1,-5,0,1207,345,340,-5
"c2490bc612d146edbe786556fab3651b","6ac8bb048b854999a47edb35fe627f11",22888374,1,8,0,1208,340,347,7
"6ac8bb048b854999a47edb35fe627f11","6ac8bb048b854999a47edb35fe627f11",22888374,1,0,1,1209,347,347,0
"6ac8bb048b854999a47edb35fe627f11","0c4079457ede49e3aeb5e86ed84bdf35",22888374,1,-21,0,1210,347,329,-18
"0c4079457ede49e3aeb5e86ed84bdf35","30ead9794d4847abaf222ca966cc8630",22888374,2,24,0,1211,329,348,19
"30ead9794d4847abaf222ca966cc8630","eff0de7f2dbb42dfa1a2e686efab5b6d",22888374,1,6,0,1212,348,354,6
"eff0de7f2dbb42dfa1a2e686efab5b6d","897b7f51242c44aab2205c72fdcbf4cd",22888374,3,-2,0,1213,354,352,-2
"897b7f51242c44aab2205c72fdcbf4cd","c20993c944444fe085345591a8bd837e",22888374,2,-1,0,1214,352,351,-1
"c20993c944444fe085345591a8bd837e","09b9678ddc3d452ea4a3d46e15826065",22888374,1,2,0,1215,351,353,2
"09b9678ddc3d452ea4a3d46e15826065","897b7f51242c44aab2205c72fdcbf4cd",22888374,2,-1,0,1216,353,352,-1
"897b7f51242c44aab2205c72fdcbf4cd","897b7f51242c44aab2205c72fdcbf4cd",22888374,3,0,1,1217,352,352,0
"897b7f51242c44aab2205c72fdcbf4cd","09b9678ddc3d452ea4a3d46e15826065",22888374,1,1,0,1220,352,353,1
"09b9678ddc3d452ea4a3d46e15826065","09b9678ddc3d452ea4a3d46e15826065",22888374,5,0,1,1221,353,353,0
"09b9678ddc3d452ea4a3d46e15826065","eff0de7f2dbb42dfa1a2e686efab5b6d",22888374,1,1,0,1224,353,354,1
"eff0de7f2dbb42dfa1a2e686efab5b6d","eff0de7f2dbb42dfa1a2e686efab5b6d",22888374,3,0,1,1225,354,354,0
"eff0de7f2dbb42dfa1a2e686efab5b6d","2fe14166dc9642c3bc666b86a57f943d",22888374,1,4,0,1228,354,357,3
"2fe14166dc9642c3bc666b86a57f943d","30ead9794d4847abaf222ca966cc8630",22888374,1,-10,0,1229,357,348,-9
"30ead9794d4847abaf222ca966cc8630","2fe14166dc9642c3bc666b86a57f943d",22888374,2,10,0,1230,348,357,9
"2fe14166dc9642c3bc666b86a57f943d","2fe14166dc9642c3bc666b86a57f943d",22888374,1,0,1,1231,357,357,0
"2fe14166dc9642c3bc666b86a57f943d","44421dd1e13a47a388c4a19834b744c7",22888374,1,2,0,1232,357,359,2
"44421dd1e13a47a388c4a19834b744c7","44421dd1e13a47a388c4a19834b744c7",22888374,2,0,1,1233,359,359,0
"44421dd1e13a47a388c4a19834b744c7","cb5fc7ef85d547c4be1a7439d0bf6052",22888374,1,1,0,1235,359,360,1
"cb5fc7ef85d547c4be1a7439d0bf6052","cb5fc7ef85d547c4be1a7439d0bf6052",22888374,2,0,1,1236,360,360,0
"cb5fc7ef85d547c4be1a7439d0bf6052","0a8f150a4cf747acbde62f4721823da3",22888374,1,1,0,1238,360,361,1
"0a8f150a4cf747acbde62f4721823da3","0a8f150a4cf747acbde62f4721823da3",22888374,5,0,1,1239,361,361,0
"0a8f150a4cf747acbde62f4721823da3","ab8fdad974ae471f9f24c3f9dd04462e",22888374,1,1,0,1244,361,362,1
"ab8fdad974ae471f9f24c3f9dd04462e","ab8fdad974ae471f9f24c3f9dd04462e",22888374,2,0,1,1245,362,362,0
"ab8fdad974ae471f9f24c3f9dd04462e","52580888dadb4fe3baa795683ea227bd",22888374,1,3,0,1247,362,364,2
"52580888dadb4fe3baa795683ea227bd","1ba8fef685d74a8194b9db252eb704fb",22888374,2,-10,0,1248,364,355,-9
"1ba8fef685d74a8194b9db252eb704fb","52580888dadb4fe3baa795683ea227bd",22888374,1,10,0,1249,355,364,9
"52580888dadb4fe3baa795683ea227bd","52580888dadb4fe3baa795683ea227bd",22888374,1,0,1,1250,364,364,0
"52580888dadb4fe3baa795683ea227bd","f00179e251a045b39c3f7a54f9aa4acc",22888374,1,-1,0,1251,364,363,-1
"f00179e251a045b39c3f7a54f9aa4acc","492a3bc6a1254f23a7998587961b22a4",22888374,2,4,0,1252,363,366,3
"492a3bc6a1254f23a7998587961b22a4","492a3bc6a1254f23a7998587961b22a4",22888374,2,0,1,1253,366,366,0
"492a3bc6a1254f23a7998587961b22a4","072a190fd302456290895f9f04d6940a",22888374,2,-1,0,1255,366,365,-1
"072a190fd302456290895f9f04d6940a","cfa457d1743848e4bb5e4beced6448ed",22888374,1,5,0,1256,365,369,4
"cfa457d1743848e4bb5e4beced6448ed","cfa457d1743848e4bb5e4beced6448ed",22888374,1,0,1,1257,369,369,0
"cfa457d1743848e4bb5e4beced6448ed","b71bac264efb4abd97015447bd490db6",22888374,1,3,0,1258,369,370,1
"b71bac264efb4abd97015447bd490db6","30ead9794d4847abaf222ca966cc8630",22888374,1,-28,0,1259,370,348,-22
"30ead9794d4847abaf222ca966cc8630","8d448d625b024c82a5eb240bbd7431d6",22888374,1,33,0,1260,348,374,26
"8d448d625b024c82a5eb240bbd7431d6","8d448d625b024c82a5eb240bbd7431d6",22888374,26,0,1,1261,374,374,0
"8d448d625b024c82a5eb240bbd7431d6","b71bac264efb4abd97015447bd490db6",22888374,3,-5,0,1263,374,370,-4
"b71bac264efb4abd97015447bd490db6","8d448d625b024c82a5eb240bbd7431d6",22888374,3,5,0,1264,370,374,4
"b71bac264efb4abd97015447bd490db6","d6d02b6ef04e4f17805504500b8ce441",22888374,2,8,0,1283,370,375,5
"d6d02b6ef04e4f17805504500b8ce441","d6d02b6ef04e4f17805504500b8ce441",22888374,3,0,1,1284,375,375,0
"d6d02b6ef04e4f17805504500b8ce441","66baf19b6b904b70922329068c63746d",22888374,2,4,0,1286,375,376,1
"66baf19b6b904b70922329068c63746d","7f544639412e40a9ba27f43b415362ab",22888374,2,2,0,1287,376,378,2
"7f544639412e40a9ba27f43b415362ab","7f544639412e40a9ba27f43b415362ab",22888374,4,0,1,1288,378,378,0
"7f544639412e40a9ba27f43b415362ab","d5ae8642e15b46b8bd298b02274d4e9c",22888374,1,2,0,1292,378,380,2
"d5ae8642e15b46b8bd298b02274d4e9c","d5ae8642e15b46b8bd298b02274d4e9c",22888374,1,0,1,1293,380,380,0
"d5ae8642e15b46b8bd298b02274d4e9c","a0d10309a2dd456289147f84be9d37f9",22888374,1,1,0,1294,380,381,1
"a0d10309a2dd456289147f84be9d37f9","a0d10309a2dd456289147f84be9d37f9",22888374,2,0,1,1295,381,381,0
"a0d10309a2dd456289147f84be9d37f9","0fcbc3ca07b144138b8d85da581f09a8",22888374,1,1,0,1297,381,382,1
"0fcbc3ca07b144138b8d85da581f09a8","0fcbc3ca07b144138b8d85da581f09a8",22888374,8,0,1,1298,382,382,0
"0fcbc3ca07b144138b8d85da581f09a8","66baf19b6b904b70922329068c63746d",22888374,1,-6,0,1306,382,376,-6
"66baf19b6b904b70922329068c63746d","4890121ce5d74576b4632b77cfc23398",22888374,1,14,0,1307,376,388,12
"4890121ce5d74576b4632b77cfc23398","c2fca3669923477ab966ded303dea31c",22888374,1,-6,0,1308,388,383,-5
"c2fca3669923477ab966ded303dea31c","4890121ce5d74576b4632b77cfc23398",22888374,2,6,0,1309,383,388,5
"4890121ce5d74576b4632b77cfc23398","4890121ce5d74576b4632b77cfc23398",22888374,1,0,1,1310,388,388,0
"4890121ce5d74576b4632b77cfc23398","96bb2b3e85a34d8b9544514e89f6fe97",22888374,2,3,0,1311,388,390,2
"96bb2b3e85a34d8b9544514e89f6fe97","18d3b836dd804224883cc9180b60a8e1",22888374,2,-4,0,1312,390,387,-3
"18d3b836dd804224883cc9180b60a8e1","96bb2b3e85a34d8b9544514e89f6fe97",22888374,1,4,0,1313,387,390,3
"96bb2b3e85a34d8b9544514e89f6fe97","96bb2b3e85a34d8b9544514e89f6fe97",22888374,1,0,1,1314,390,390,0
"96bb2b3e85a34d8b9544514e89f6fe97","ac4e9b54acfe4670b4634859c7263cb5",22888374,1,2,0,1315,390,392,2
"ac4e9b54acfe4670b4634859c7263cb5","ac4e9b54acfe4670b4634859c7263cb5",22888374,1,0,1,1316,392,392,0
"ac4e9b54acfe4670b4634859c7263cb5","6f8881a745ac4c358a68b92c3b4abe81",22888374,1,3,0,1317,392,394,2
"6f8881a745ac4c358a68b92c3b4abe81","17f95d18bab743888e1736033dc3384d",22888374,1,-6,0,1318,394,389,-5
"17f95d18bab743888e1736033dc3384d","6f8881a745ac4c358a68b92c3b4abe81",22888374,2,6,0,1319,389,394,5
"6f8881a745ac4c358a68b92c3b4abe81","6f8881a745ac4c358a68b92c3b4abe81",22888374,1,0,1,1320,394,394,0
"6f8881a745ac4c358a68b92c3b4abe81","f7002c8484354eceac57bc7bd62c76c1",22888374,2,-1,0,1321,394,393,-1
"f7002c8484354eceac57bc7bd62c76c1","44a277ea44dc4ae689fab4b82f0b4098",22888374,1,5,0,1322,393,397,4
"44a277ea44dc4ae689fab4b82f0b4098","44a277ea44dc4ae689fab4b82f0b4098",22888374,3,0,1,1323,397,397,0
"44a277ea44dc4ae689fab4b82f0b4098","0c12af0a4e7f4002852cf84b2537c161",22888374,1,-2,0,1326,397,395,-2
"0c12af0a4e7f4002852cf84b2537c161","859e0b8d71694b12befb69ee698138f9",22888374,1,5,0,1327,395,399,4
"859e0b8d71694b12befb69ee698138f9","859e0b8d71694b12befb69ee698138f9",22888374,1,0,1,1328,399,399,0
"859e0b8d71694b12befb69ee698138f9","2b09a08242b54983aec7063990fb3f66",22888374,1,3,0,1329,399,400,1
"2b09a08242b54983aec7063990fb3f66","66baf19b6b904b70922329068c63746d",22888374,1,-32,0,1330,400,376,-24
"66baf19b6b904b70922329068c63746d","2b09a08242b54983aec7063990fb3f66",22888374,2,32,0,1331,376,400,24
"2b09a08242b54983aec7063990fb3f66","2b09a08242b54983aec7063990fb3f66",22888374,5,0,1,1332,400,400,0
"2b09a08242b54983aec7063990fb3f66","1f471b7a883a4df48211e8c6a81b59a7",22888374,1,1,0,1335,400,401,1
"1f471b7a883a4df48211e8c6a81b59a7","1f471b7a883a4df48211e8c6a81b59a7",22888374,1,0,1,1336,401,401,0
"1f471b7a883a4df48211e8c6a81b59a7","2b09a08242b54983aec7063990fb3f66",22888374,1,-1,0,1337,401,400,-1
"2b09a08242b54983aec7063990fb3f66","9de0d567bfa84fe5b77cb76f4a76a5d1",22888374,1,5,0,1338,400,404,4
"9de0d567bfa84fe5b77cb76f4a76a5d1","9de0d567bfa84fe5b77cb76f4a76a5d1",22888374,1,0,1,1339,404,404,0
"9de0d567bfa84fe5b77cb76f4a76a5d1","1157bd665ec4472fb58b751dc5099355",22888374,1,-1,0,1340,404,403,-1
"1157bd665ec4472fb58b751dc5099355","3c8a22d2f9c146ea956609e3ed4f2559",22888374,2,3,0,1341,403,405,2
"3c8a22d2f9c146ea956609e3ed4f2559","58fc9094275e4c49be3f4ba6d4acc0a4",22888374,2,2,0,1342,405,406,1
"58fc9094275e4c49be3f4ba6d4acc0a4","58fc9094275e4c49be3f4ba6d4acc0a4",22888374,3,0,1,1343,406,406,0
"58fc9094275e4c49be3f4ba6d4acc0a4","c1c1be90b2b14c1ab4a5e1ee3c241902",22888374,1,1,0,1345,406,407,1
"c1c1be90b2b14c1ab4a5e1ee3c241902","c1c1be90b2b14c1ab4a5e1ee3c241902",22888374,5,0,1,1346,407,407,0
"c1c1be90b2b14c1ab4a5e1ee3c241902","58fc9094275e4c49be3f4ba6d4acc0a4",22888374,1,-1,0,1351,407,406,-1
"58fc9094275e4c49be3f4ba6d4acc0a4","02b3a1bead9244c1ba2f857c7da8f82a",22888374,2,3,0,1352,406,408,2
"02b3a1bead9244c1ba2f857c7da8f82a","02b3a1bead9244c1ba2f857c7da8f82a",22888374,2,0,1,1353,408,408,0
"02b3a1bead9244c1ba2f857c7da8f82a","6206fc6479014bb193084c32409dc1b9",22888374,1,1,0,1355,408,409,1
"6206fc6479014bb193084c32409dc1b9","6206fc6479014bb193084c32409dc1b9",22888374,8,0,1,1356,409,409,0
"6206fc6479014bb193084c32409dc1b9","6a5f020451db426dacba9e2ea3fcc62a",22888374,1,2,0,1364,409,410,1
"6a5f020451db426dacba9e2ea3fcc62a","02b3a1bead9244c1ba2f857c7da8f82a",22888374,1,-3,0,1365,410,408,-2
"02b3a1bead9244c1ba2f857c7da8f82a","6a5f020451db426dacba9e2ea3fcc62a",22888374,2,3,0,1366,408,410,2
"6a5f020451db426dacba9e2ea3fcc62a","6a5f020451db426dacba9e2ea3fcc62a",22888374,3,0,1,1367,410,410,0
"6a5f020451db426dacba9e2ea3fcc62a","33a9d248b2e44588a5b07fc1342b9bc2",22888374,2,2,0,1369,410,411,1
"33a9d248b2e44588a5b07fc1342b9bc2","33a9d248b2e44588a5b07fc1342b9bc2",22888374,3,0,1,1370,411,411,0
"33a9d248b2e44588a5b07fc1342b9bc2","c6f26bd420634f1cb7989e76fe6b16c0",22888374,1,1,0,1372,411,412,1
"c6f26bd420634f1cb7989e76fe6b16c0","c6f26bd420634f1cb7989e76fe6b16c0",22888374,5,0,1,1373,412,412,0
"c6f26bd420634f1cb7989e76fe6b16c0","2a65ee6e2ac64f6a8a55fbe5373ec763",22888374,1,1,0,1378,412,413,1
"2a65ee6e2ac64f6a8a55fbe5373ec763","2a65ee6e2ac64f6a8a55fbe5373ec763",22888374,2,0,1,1379,413,413,0
"2a65ee6e2ac64f6a8a55fbe5373ec763","33a9d248b2e44588a5b07fc1342b9bc2",22888374,1,-2,0,1381,413,411,-2
"33a9d248b2e44588a5b07fc1342b9bc2","1fd0f6dadbc14ebc965faf6122190b96",22888374,1,5,0,1382,411,415,4
"1fd0f6dadbc14ebc965faf6122190b96","1fd0f6dadbc14ebc965faf6122190b96",22888374,1,0,1,1383,415,415,0
"1fd0f6dadbc14ebc965faf6122190b96","687055dad9fc40c3982478fe33ec01bf",22888374,1,-1,0,1384,415,414,-1
"687055dad9fc40c3982478fe33ec01bf","2add1669f08d4101913db15f8c23b3b7",22888374,1,3,0,1385,414,416,2
"2add1669f08d4101913db15f8c23b3b7","2add1669f08d4101913db15f8c23b3b7",22888374,1,0,1,1386,416,416,0
"2add1669f08d4101913db15f8c23b3b7","2b09a08242b54983aec7063990fb3f66",22888374,1,-24,0,1387,416,400,-16
"2b09a08242b54983aec7063990fb3f66","a2b4bd40cee2481ebd3fc179d6a5cd62",22888374,1,27,0,1388,400,417,17
"a2b4bd40cee2481ebd3fc179d6a5cd62","e34e59dce2204f228f3a84b6725df60f",22888374,1,2,0,1389,417,419,2
"e34e59dce2204f228f3a84b6725df60f","e34e59dce2204f228f3a84b6725df60f",22888374,1,0,1,1390,419,419,0
"e34e59dce2204f228f3a84b6725df60f","a2b4bd40cee2481ebd3fc179d6a5cd62",22888374,1,-2,0,1391,419,417,-2
"a2b4bd40cee2481ebd3fc179d6a5cd62","bec48fc2e1294c7eb3d0aca780d731b8",22888374,3,4,0,1392,417,420,3
"bec48fc2e1294c7eb3d0aca780d731b8","bec48fc2e1294c7eb3d0aca780d731b8",22888374,3,0,1,1393,420,420,0
"bec48fc2e1294c7eb3d0aca780d731b8","dbde19fcce2a4c1abdc7f685c293a23f",22888374,2,3,0,1396,420,422,2
"dbde19fcce2a4c1abdc7f685c293a23f","a24600b0e49245f6bdba8c893cfeddb0",22888374,2,4,0,1397,422,425,3
"a24600b0e49245f6bdba8c893cfeddb0","a24600b0e49245f6bdba8c893cfeddb0",22888374,4,0,1,1398,425,425,0
"a24600b0e49245f6bdba8c893cfeddb0","d7f13c8d63ec4e2aa673fbb9cf9c6933",22888374,1,-300,0,1401,425,206,-219
"d7f13c8d63ec4e2aa673fbb9cf9c6933","7108f0e4c2584f1f9c471689ae4c885c",22888374,2,2,0,1402,206,208,2
"7108f0e4c2584f1f9c471689ae4c885c","b9e80f77c3a44349863b19875725c384",22888374,2,-1,0,1403,208,207,-1
"b9e80f77c3a44349863b19875725c384","d7f13c8d63ec4e2aa673fbb9cf9c6933",22888374,1,-1,0,1404,207,206,-1
"d7f13c8d63ec4e2aa673fbb9cf9c6933","09400e101c5d4b439cf9a26b03aae558",22888374,4,5,0,1405,206,210,4
"09400e101c5d4b439cf9a26b03aae558","be502a7a43c44bf7b682698de79d9369",22888374,1,5,0,1406,210,214,4
"be502a7a43c44bf7b682698de79d9369","a875096404ef4a9984b62d74cda916f9",22888374,2,-6,0,1407,214,209,-5
"f7fb1952f56b4189b86a9f8b7862d2b8","ec341f459285443b8361f7f15638ff08",22888374,1,-2,0,1409,215,213,-2
"01b2051f8941460d89945e3b02d1ce78","d7f13c8d63ec4e2aa673fbb9cf9c6933",22888374,2,-14,0,1412,217,206,-11
"1c6721b1f63f4d30ba7746ea8af02a52","1c6721b1f63f4d30ba7746ea8af02a52",22888374,1,0,1,1414,221,221,0
"d7f13c8d63ec4e2aa673fbb9cf9c6933","d7f13c8d63ec4e2aa673fbb9cf9c6933",22888374,1,0,1,1416,206,206,0
"1c6721b1f63f4d30ba7746ea8af02a52","77ecef8eff6b4a2caea7707669bf7475",22888374,2,1,0,1418,221,222,1
"1c6721b1f63f4d30ba7746ea8af02a52","d03cb855c70044cf8c35d9ec0de696e3",22888374,2,4,0,1420,221,224,3
"d03cb855c70044cf8c35d9ec0de696e3","8b9ae98743bd4d4a8a87dff1c1244211",22888374,2,3,0,1421,224,227,3
"8b9ae98743bd4d4a8a87dff1c1244211","f7906d6f59b9489a91d2ef40db5a474d",22888374,2,-4,0,1422,227,223,-4
"bb5a47f5ea01454a8b79455422d3b9da","0d987bed3ffa4ed0b9a2e62e97b7b30f",22888374,1,-10,0,1447,280,272,-8
"0d987bed3ffa4ed0b9a2e62e97b7b30f","94cecc3f1e7d484b8e068e79241dfd73",22888374,1,13,0,1448,272,281,9
"94cecc3f1e7d484b8e068e79241dfd73","a37477c4e4c14169ad44b06b493007f6",22888374,1,2,0,1449,281,283,2
"a37477c4e4c14169ad44b06b493007f6","fab84b4fab5940efb4ea868ef8d09396",22888374,1,3,0,1450,283,284,1
"fab84b4fab5940efb4ea868ef8d09396","94cecc3f1e7d484b8e068e79241dfd73",22888374,1,-5,0,1451,284,281,-3
"4a29443515bb404cb8924e1c60a63b73","4a29443515bb404cb8924e1c60a63b73",22888374,1,0,1,1454,285,285,0
"208c9b2796c944db8dacaa96082520ea","6a9a3b5bde4a48daa896fe8c06eca56f",22888374,1,2,0,1456,288,289,1
"869e967078f04da18dd0b0b9389a7424","34a6e49023fc4465bd5ca604330bbd1c",22888374,1,-1,0,1458,293,292,-1
"34a6e49023fc4465bd5ca604330bbd1c","21592f2a9e9c4b2f8c66ec5dbcbf6a2b",22888374,1,5,0,1459,292,296,4
"ba0e59461bfb4a44b7b1c28a01f8d3b3","7646a919d7e64fa990bca9b024ff089d",22888374,1,-1,0,1461,299,298,-1
"7646a919d7e64fa990bca9b024ff089d","3434c10e561d488a914e0f7d71907abd",22888374,1,10,0,1462,298,305,7
"53e7e900392747ccad52e711ab0f80d8","130acc2aeb0448fdbb2de63bc5cebe5b",22888374,1,3,0,1465,307,309,2
"130acc2aeb0448fdbb2de63bc5cebe5b","3434c10e561d488a914e0f7d71907abd",22888374,1,-5,0,1466,309,305,-4
"3434c10e561d488a914e0f7d71907abd","141c0df6cd1946539aadd1c9b7068cd4",22888374,1,4,0,1467,305,308,3
"141c0df6cd1946539aadd1c9b7068cd4","0c787d16c9504873b1a4d903cec09948",22888374,1,7,0,1468,308,314,6
"3628bdce1dd2429ba924d2d4d09448d2","3434c10e561d488a914e0f7d71907abd",22888374,1,-21,0,1474,322,305,-17
"0c4079457ede49e3aeb5e86ed84bdf35","0c4079457ede49e3aeb5e86ed84bdf35",22888374,2,0,1,1476,329,329,0
"0c4079457ede49e3aeb5e86ed84bdf35","3434c10e561d488a914e0f7d71907abd",22888374,1,-31,0,1477,329,305,-24
"3434c10e561d488a914e0f7d71907abd","3434c10e561d488a914e0f7d71907abd",22888374,1,0,1,1478,305,305,0
"38aea304b4fa46e1b29bb72f5cea4c93","0c4079457ede49e3aeb5e86ed84bdf35",22888374,1,-2,0,1481,331,329,-2
"0c4079457ede49e3aeb5e86ed84bdf35","b8b9418ab322418d9db9b40d96af873a",22888374,1,9,0,1482,329,337,8
"bbc5139ca9024389a94db3a6f47dcff6","c2490bc612d146edbe786556fab3651b",22888374,1,-1,0,1484,341,340,-1
"c2490bc612d146edbe786556fab3651b","30ead9794d4847abaf222ca966cc8630",22888374,1,11,0,1485,340,348,8
"30ead9794d4847abaf222ca966cc8630","0c4079457ede49e3aeb5e86ed84bdf35",22888374,1,-24,0,1486,348,329,-19
"30ead9794d4847abaf222ca966cc8630","09b9678ddc3d452ea4a3d46e15826065",22888374,1,5,0,1489,348,353,5
"897b7f51242c44aab2205c72fdcbf4cd","eff0de7f2dbb42dfa1a2e686efab5b6d",22888374,2,2,0,1493,352,354,2
"c20993c944444fe085345591a8bd837e","eff0de7f2dbb42dfa1a2e686efab5b6d",22888374,1,3,0,1496,351,354,3
"eff0de7f2dbb42dfa1a2e686efab5b6d","30ead9794d4847abaf222ca966cc8630",22888374,1,-6,0,1499,354,348,-6
"2fe14166dc9642c3bc666b86a57f943d","52580888dadb4fe3baa795683ea227bd",22888374,1,8,0,1501,357,364,7
"1ba8fef685d74a8194b9db252eb704fb","f00179e251a045b39c3f7a54f9aa4acc",22888374,1,9,0,1503,355,363,8
"072a190fd302456290895f9f04d6940a","30ead9794d4847abaf222ca966cc8630",22888374,1,-20,0,1506,365,348,-17
"30ead9794d4847abaf222ca966cc8630","b71bac264efb4abd97015447bd490db6",22888374,1,28,0,1507,348,370,22
"8d448d625b024c82a5eb240bbd7431d6","d6d02b6ef04e4f17805504500b8ce441",22888374,1,3,0,1518,374,375,1
"d6d02b6ef04e4f17805504500b8ce441","b71bac264efb4abd97015447bd490db6",22888374,1,-8,0,1519,375,370,-5
"7f544639412e40a9ba27f43b415362ab","66baf19b6b904b70922329068c63746d",22888374,1,-2,0,1524,378,376,-2
"66baf19b6b904b70922329068c63746d","c2fca3669923477ab966ded303dea31c",22888374,1,8,0,1525,376,383,7
"18d3b836dd804224883cc9180b60a8e1","17f95d18bab743888e1736033dc3384d",22888374,1,3,0,1529,387,389,2
"f7002c8484354eceac57bc7bd62c76c1","0c12af0a4e7f4002852cf84b2537c161",22888374,1,3,0,1532,393,395,2
"0c12af0a4e7f4002852cf84b2537c161","66baf19b6b904b70922329068c63746d",22888374,1,-24,0,1533,395,376,-19
"2b09a08242b54983aec7063990fb3f66","1157bd665ec4472fb58b751dc5099355",22888374,1,4,0,1537,400,403,3
"33a9d248b2e44588a5b07fc1342b9bc2","687055dad9fc40c3982478fe33ec01bf",22888374,1,4,0,1546,411,414,3
"687055dad9fc40c3982478fe33ec01bf","a2b4bd40cee2481ebd3fc179d6a5cd62",22888374,1,6,0,1547,414,417,3
"bec48fc2e1294c7eb3d0aca780d731b8","a2b4bd40cee2481ebd3fc179d6a5cd62",22888374,1,-4,0,1549,420,417,-3
"a24600b0e49245f6bdba8c893cfeddb0","a2b4bd40cee2481ebd3fc179d6a5cd62",22888374,1,-11,0,1554,425,417,-8
"a2b4bd40cee2481ebd3fc179d6a5cd62","24cf8786024543f19b89bc20034e60d7",22888374,1,18,0,1555,417,428,11
"24cf8786024543f19b89bc20034e60d7","f2a73be2f46840b182d7bd095378004e",22888374,1,1,0,1556,428,429,1
"f2a73be2f46840b182d7bd095378004e","f2a73be2f46840b182d7bd095378004e",22888374,3,0,1,1557,429,429,0
"f2a73be2f46840b182d7bd095378004e","604551fd4266430cb860fef58fa7dd61",22888374,1,1,0,1560,429,430,1
"604551fd4266430cb860fef58fa7dd61","604551fd4266430cb860fef58fa7dd61",22888374,7,0,1,1561,430,430,0
"604551fd4266430cb860fef58fa7dd61","dce46f8904594a62a6377a3587aaa663",22888374,1,2,0,1568,430,431,1
"dce46f8904594a62a6377a3587aaa663","24cf8786024543f19b89bc20034e60d7",22888374,1,-4,0,1569,431,428,-3
"24cf8786024543f19b89bc20034e60d7","dce46f8904594a62a6377a3587aaa663",22888374,1,4,0,1570,428,431,3
"dce46f8904594a62a6377a3587aaa663","dce46f8904594a62a6377a3587aaa663",22888374,1,0,1,1571,431,431,0
"dce46f8904594a62a6377a3587aaa663","9b9d0a249052413c869753b99682b0ac",22888374,1,1,0,1572,431,432,1
"9b9d0a249052413c869753b99682b0ac","9b9d0a249052413c869753b99682b0ac",22888374,6,0,1,1573,432,432,0
"9b9d0a249052413c869753b99682b0ac","061c175cc90f45fbad883025394e78dd",22888374,1,1,0,1579,432,433,1
"061c175cc90f45fbad883025394e78dd","061c175cc90f45fbad883025394e78dd",22888374,5,0,1,1580,433,433,0
"061c175cc90f45fbad883025394e78dd","dce46f8904594a62a6377a3587aaa663",22888374,1,-2,0,1585,433,431,-2
"dce46f8904594a62a6377a3587aaa663","74a7f8712e5449c2bc0b43c6f90dafed",22888374,1,5,0,1586,431,435,4
"74a7f8712e5449c2bc0b43c6f90dafed","74a7f8712e5449c2bc0b43c6f90dafed",22888374,1,0,1,1587,435,435,0
"74a7f8712e5449c2bc0b43c6f90dafed","66ada10dde9f43018588f1ced9d477fc",22888374,1,-1,0,1588,435,434,-1
"66ada10dde9f43018588f1ced9d477fc","bf12c96466d840a69bed7020b3f18bb8",22888374,1,3,0,1589,434,436,2
"bf12c96466d840a69bed7020b3f18bb8","bf12c96466d840a69bed7020b3f18bb8",22888374,3,0,1,1590,436,436,0
"bf12c96466d840a69bed7020b3f18bb8","070600601c4c439288445d2f0724807d",22888374,1,3,0,1593,436,437,1
"070600601c4c439288445d2f0724807d","24cf8786024543f19b89bc20034e60d7",22888374,1,-14,0,1594,437,428,-9
"24cf8786024543f19b89bc20034e60d7","1823b6de7d334a7aaabc4570719af4d9",22888374,1,16,0,1595,428,439,11
"1823b6de7d334a7aaabc4570719af4d9","1823b6de7d334a7aaabc4570719af4d9",22888374,23,0,1,1596,439,439,0
"1823b6de7d334a7aaabc4570719af4d9","0380cd76a7d44bc3a4da1f15e4d68f89",22888374,1,2,0,1619,439,440,1
"0380cd76a7d44bc3a4da1f15e4d68f89","070600601c4c439288445d2f0724807d",22888374,1,-4,0,1620,440,437,-3
"070600601c4c439288445d2f0724807d","0380cd76a7d44bc3a4da1f15e4d68f89",22888374,1,4,0,1621,437,440,3
"0380cd76a7d44bc3a4da1f15e4d68f89","23b7673c8b5443108c2ef09382834a86",22888374,1,2,0,1622,440,441,1
"23b7673c8b5443108c2ef09382834a86","23b7673c8b5443108c2ef09382834a86",22888374,1,0,1,1623,441,441,0
"23b7673c8b5443108c2ef09382834a86","901e92500aea43c79f19f1b279050668",22888374,1,2,0,1624,441,442,1
"901e92500aea43c79f19f1b279050668","901e92500aea43c79f19f1b279050668",22888374,1,0,1,1625,442,442,0
"901e92500aea43c79f19f1b279050668","001339db8ced4cf78829ebe8b145449d",22888374,1,1,0,1626,442,443,1
"001339db8ced4cf78829ebe8b145449d","001339db8ced4cf78829ebe8b145449d",22888374,11,0,1,1627,443,443,0
"001339db8ced4cf78829ebe8b145449d","452745e0366e42ae81561bfddebcc6c3",22888374,1,1,0,1638,443,444,1
"452745e0366e42ae81561bfddebcc6c3","452745e0366e42ae81561bfddebcc6c3",22888374,2,0,1,1639,444,444,0
"452745e0366e42ae81561bfddebcc6c3","4660ff2089114e8db82ceb26a4f329e3",22888374,1,2,0,1641,444,445,1
"4660ff2089114e8db82ceb26a4f329e3","901e92500aea43c79f19f1b279050668",22888374,1,-4,0,1642,445,442,-3
"901e92500aea43c79f19f1b279050668","4660ff2089114e8db82ceb26a4f329e3",22888374,1,4,0,1643,442,445,3
"4660ff2089114e8db82ceb26a4f329e3","7bd5586eb9d8484eb74a433ee7bfe499",22888374,1,2,0,1644,445,446,1
"7bd5586eb9d8484eb74a433ee7bfe499","7bd5586eb9d8484eb74a433ee7bfe499",22888374,21,0,1,1645,446,446,0
"7bd5586eb9d8484eb74a433ee7bfe499","8a7f26e690f34dda97be16904518ca99",22888374,1,2,0,1666,446,447,1
"8a7f26e690f34dda97be16904518ca99","8a7f26e690f34dda97be16904518ca99",22888374,3,0,1,1667,447,447,0
"8a7f26e690f34dda97be16904518ca99","b2f0d654738f48158edff28e8d3a546e",22888374,1,5,0,1670,447,449,2
"b2f0d654738f48158edff28e8d3a546e","070600601c4c439288445d2f0724807d",22888374,1,-21,0,1671,449,437,-12
"070600601c4c439288445d2f0724807d","b2f0d654738f48158edff28e8d3a546e",22888374,1,21,0,1672,437,449,12
"b2f0d654738f48158edff28e8d3a546e","f60ee41ec635499abd48168342d32c2f",22888374,1,5,0,1673,449,453,4
"f60ee41ec635499abd48168342d32c2f","f60ee41ec635499abd48168342d32c2f",22888374,20,0,1,1674,453,453,0
"f60ee41ec635499abd48168342d32c2f","b2f0d654738f48158edff28e8d3a546e",22888374,1,-5,0,1694,453,449,-4
"b2f0d654738f48158edff28e8d3a546e","f67fbf45a5f146ed866965bc57c7c001",22888374,1,8,0,1695,449,454,5
"f67fbf45a5f146ed866965bc57c7c001","f67fbf45a5f146ed866965bc57c7c001",22888374,10,0,1,1696,454,454,0
"f67fbf45a5f146ed866965bc57c7c001","d937afe49bd24a07a550dda1c1155122",22888374,1,1,0,1706,454,455,1
"d937afe49bd24a07a550dda1c1155122","d937afe49bd24a07a550dda1c1155122",22888374,5,0,1,1707,455,455,0
"d937afe49bd24a07a550dda1c1155122","3628b3f7823443d0912a339096b69943",22888374,1,1,0,1712,455,456,1
"3628b3f7823443d0912a339096b69943","3628b3f7823443d0912a339096b69943",22888374,1,0,1,1713,456,456,0
"3628b3f7823443d0912a339096b69943","9e049ee647cf43ecbcb5ed792a8e7588",22888374,1,1,0,1714,456,457,1
"9e049ee647cf43ecbcb5ed792a8e7588","9e049ee647cf43ecbcb5ed792a8e7588",22888374,1,0,1,1715,457,457,0
"9e049ee647cf43ecbcb5ed792a8e7588","5256a214faaf410b93f76cea06428334",22888374,1,1,0,1716,457,458,1
"5256a214faaf410b93f76cea06428334","5256a214faaf410b93f76cea06428334",22888374,1,0,1,1717,458,458,0
"5256a214faaf410b93f76cea06428334","25c32b120fce40fa9b6c85133aeb4716",22888374,1,1,0,1718,458,459,1
"25c32b120fce40fa9b6c85133aeb4716","25c32b120fce40fa9b6c85133aeb4716",22888374,1,0,1,1719,459,459,0
"25c32b120fce40fa9b6c85133aeb4716","11bc14f2204949008b7d511b933363c1",22888374,1,1,0,1720,459,460,1
"11bc14f2204949008b7d511b933363c1","11bc14f2204949008b7d511b933363c1",22888374,5,0,1,1721,460,460,0
"11bc14f2204949008b7d511b933363c1","42de338840a34d15adb66e7b14fb9d2c",22888374,1,1,0,1726,460,461,1
"42de338840a34d15adb66e7b14fb9d2c","42de338840a34d15adb66e7b14fb9d2c",22888374,1,0,1,1727,461,461,0
"42de338840a34d15adb66e7b14fb9d2c","9da37c6210b1416b8079c274f70bf600",22888374,1,1,0,1728,461,462,1
"9da37c6210b1416b8079c274f70bf600","9da37c6210b1416b8079c274f70bf600",22888374,3,0,1,1729,462,462,0
"9da37c6210b1416b8079c274f70bf600","519119f1deac45ff9ab4f13529be5c6e",22888374,1,1,0,1732,462,463,1
"519119f1deac45ff9ab4f13529be5c6e","519119f1deac45ff9ab4f13529be5c6e",22888374,5,0,1,1733,463,463,0
"519119f1deac45ff9ab4f13529be5c6e","f67fbf45a5f146ed866965bc57c7c001",22888374,1,-9,0,1738,463,454,-9
"f67fbf45a5f146ed866965bc57c7c001","c5df9f40ec14463b9dcfdc73df3e9285",22888374,1,12,0,1739,454,464,10
"c5df9f40ec14463b9dcfdc73df3e9285","c5df9f40ec14463b9dcfdc73df3e9285",22888374,2,0,1,1740,464,464,0
"c5df9f40ec14463b9dcfdc73df3e9285","83d42d95cd844fc093fc09cee250edb8",22888374,1,3,0,1742,464,465,1
"83d42d95cd844fc093fc09cee250edb8","83d42d95cd844fc093fc09cee250edb8",22888374,2,0,1,1743,465,465,0
"83d42d95cd844fc093fc09cee250edb8","d7f13c8d63ec4e2aa673fbb9cf9c6933",22888374,1,-365,0,1745,465,206,-259
"7108f0e4c2584f1f9c471689ae4c885c","d7f13c8d63ec4e2aa673fbb9cf9c6933",22888374,3,-2,0,1748,208,206,-2
"d7f13c8d63ec4e2aa673fbb9cf9c6933","c8e371568a0c4391b25796ae4e91952e",22888374,1,-26,0,1749,206,186,-20
"c8e371568a0c4391b25796ae4e91952e","b54257a550b94ebc9538f3a90eee9d7e",22888374,1,22,0,1750,186,204,18
"b54257a550b94ebc9538f3a90eee9d7e","f9170dd6bc6442b4acd832747609b09a",22888374,2,-6,0,1751,204,199,-5
"f9170dd6bc6442b4acd832747609b09a","6cd2dcaac46847d4a0bc53f296d90375",22888374,2,-6,0,1752,199,194,-5
"6cd2dcaac46847d4a0bc53f296d90375","ab11d94c6c8948ea90b88f19d2cd502b",22888374,1,-5,0,1753,194,190,-4
"ab11d94c6c8948ea90b88f19d2cd502b","017d7ca8e0394b91aaadc9574df2202c",22888374,1,4,0,1754,190,193,3
"017d7ca8e0394b91aaadc9574df2202c","07b44a7a51e94c78b411c753fc39dab0",22888374,1,-5,0,1755,193,189,-4
"07b44a7a51e94c78b411c753fc39dab0","0c7262dff33c4087bc660ccf40f92f9c",22888374,2,-27,0,1756,189,169,-20
"0c7262dff33c4087bc660ccf40f92f9c","c8e371568a0c4391b25796ae4e91952e",22888374,4,23,0,1757,169,186,17
"c8e371568a0c4391b25796ae4e91952e","c8e371568a0c4391b25796ae4e91952e",22888374,1,0,1,1758,186,186,0
"c8e371568a0c4391b25796ae4e91952e","0c7262dff33c4087bc660ccf40f92f9c",22888374,2,-23,0,1759,186,169,-17
"0c7262dff33c4087bc660ccf40f92f9c","cf4c280bad6a43e6b131d8385ef9ef3f",22888374,1,19,0,1762,169,184,15
"cf4c280bad6a43e6b131d8385ef9ef3f","ea38cc0e6e6e41edbabf210220808bf9",22888374,1,-7,0,1763,184,179,-5
"ea38cc0e6e6e41edbabf210220808bf9","2024b4885bd14338a39b7b509acbbd02",22888374,1,4,0,1764,179,182,3
"2024b4885bd14338a39b7b509acbbd02","b87c552dd247427abe6ab5795b9c9d43",22888374,1,-2,0,1765,182,181,-1
"b87c552dd247427abe6ab5795b9c9d43","b42cc17b7de840f181a704558d0bc845",22888374,2,-7,0,1766,181,175,-6
"b42cc17b7de840f181a704558d0bc845","139b097acfca451689d80c9c6eebdf7b",22888374,3,4,0,1767,175,178,3
"139b097acfca451689d80c9c6eebdf7b","362fcb0699a14845ab29b2340093e528",22888374,1,-5,0,1768,178,174,-4
"362fcb0699a14845ab29b2340093e528","b2275c3fad834f8d90737a2d9a6927d6",22888374,1,-3,0,1769,174,172,-2
"b2275c3fad834f8d90737a2d9a6927d6","0c7262dff33c4087bc660ccf40f92f9c",22888374,2,-3,0,1770,172,169,-3
"0c7262dff33c4087bc660ccf40f92f9c","a9ac840f098c4bd0a2ee896214ce29cd",22888374,2,-4,0,1771,169,168,-1
"a9ac840f098c4bd0a2ee896214ce29cd","a9ac840f098c4bd0a2ee896214ce29cd",22888374,1,0,1,1772,168,168,0
"a9ac840f098c4bd0a2ee896214ce29cd","3cbcea2be0984e7dbd5a48195af10ce7",22888374,3,-5,0,1773,168,165,-3
"3cbcea2be0984e7dbd5a48195af10ce7","3cbcea2be0984e7dbd5a48195af10ce7",22888374,1,0,1,1774,165,165,0
"3cbcea2be0984e7dbd5a48195af10ce7","a9ac840f098c4bd0a2ee896214ce29cd",22888374,2,5,0,1775,165,168,3
"a9ac840f098c4bd0a2ee896214ce29cd","82e6285962b8400d9d6fc32436022a94",22888374,1,-3,0,1776,168,167,-1
"82e6285962b8400d9d6fc32436022a94","3cbcea2be0984e7dbd5a48195af10ce7",22888374,4,-2,0,1777,167,165,-2
"3cbcea2be0984e7dbd5a48195af10ce7","78adeee1fa2c4fe0bc73f7bca9fcee86",22888374,4,-8,0,1778,165,160,-5
"78adeee1fa2c4fe0bc73f7bca9fcee86","65202579580f4ad38d734b4ee39d22a8",22888374,4,5,0,1779,160,164,4
"65202579580f4ad38d734b4ee39d22a8","65202579580f4ad38d734b4ee39d22a8",22888374,60,0,1,1780,164,164,0
"65202579580f4ad38d734b4ee39d22a8","8959e6304a0348309a771e4d08d1b64a",22888374,2,-1,0,1787,164,163,-1
"8959e6304a0348309a771e4d08d1b64a","df1de691dafe4549a18a4398ee9dfaf9",22888374,2,-30,0,1788,163,139,-24
"df1de691dafe4549a18a4398ee9dfaf9","78adeee1fa2c4fe0bc73f7bca9fcee86",22888374,3,26,0,1789,139,160,21
"78adeee1fa2c4fe0bc73f7bca9fcee86","d313cec988a84645bee413e8d4724a4b",22888374,1,-4,0,1790,160,158,-2
"d313cec988a84645bee413e8d4724a4b","d313cec988a84645bee413e8d4724a4b",22888374,10,0,1,1791,158,158,0
"d313cec988a84645bee413e8d4724a4b","f4ce60b4a944484082ccb701b48b3da1",22888374,2,-1,0,1793,158,157,-1
"f4ce60b4a944484082ccb701b48b3da1","f03480cf4eba413194d7af52fc0e7f28",22888374,3,-6,0,1794,157,152,-5
"f03480cf4eba413194d7af52fc0e7f28","8aae34f5ddbb4052a709b12e6b0d40fa",22888374,2,-6,0,1795,152,147,-5
"8aae34f5ddbb4052a709b12e6b0d40fa","f902b0f41b544d4dbf79664fd233648d",22888374,2,-1,0,1796,147,146,-1
"f902b0f41b544d4dbf79664fd233648d","6c5ad271a44743479bfaea29b1db8d02",22888374,1,-4,0,1797,146,143,-3
"6c5ad271a44743479bfaea29b1db8d02","df1de691dafe4549a18a4398ee9dfaf9",22888374,1,-4,0,1798,143,139,-4
"df1de691dafe4549a18a4398ee9dfaf9","779f9ddd1fd14d1e9e69f72219a1fdbd",22888374,2,-23,0,1799,139,121,-18
"779f9ddd1fd14d1e9e69f72219a1fdbd","f661500307d74c908e9207d949ceb4aa",22888374,1,18,0,1800,121,136,15
"f661500307d74c908e9207d949ceb4aa","b416d47c56a742199b5d7c7f19d6503a",22888374,2,-3,0,1801,136,134,-2
"b416d47c56a742199b5d7c7f19d6503a","a8dd5213034441ac92724b4e83eb0bb2",22888374,2,-6,0,1802,134,129,-5
"a8dd5213034441ac92724b4e83eb0bb2","579338175e0b4bbb8ef3b712b5d8b54e",22888374,2,-1,0,1803,129,128,-1
"579338175e0b4bbb8ef3b712b5d8b54e","779f9ddd1fd14d1e9e69f72219a1fdbd",22888374,2,-8,0,1804,128,121,-7
"779f9ddd1fd14d1e9e69f72219a1fdbd","e20db35ced8544ddac5bc3839145e463",22888374,3,-36,0,1805,121,91,-30
"e20db35ced8544ddac5bc3839145e463","62bff51286ef4f348717a3cf6fe2318f",22888374,2,33,0,1806,91,120,29
"62bff51286ef4f348717a3cf6fe2318f","62bff51286ef4f348717a3cf6fe2318f",22888374,7,0,1,1807,120,120,0
"62bff51286ef4f348717a3cf6fe2318f","3ec3a3563847406fa73338f9e9999cf3",22888374,1,-3,0,1809,120,117,-3
"3ec3a3563847406fa73338f9e9999cf3","a9ae0a3c070d455bb4369a8996313336",22888374,1,-4,0,1810,117,114,-3
"a9ae0a3c070d455bb4369a8996313336","4280927ec4d643238aa49c32f9e06c6c",22888374,1,-6,0,1811,114,109,-5
"4280927ec4d643238aa49c32f9e06c6c","37319e88176d4aefa91d7a9980dbae91",22888374,1,4,0,1812,109,112,3
"37319e88176d4aefa91d7a9980dbae91","08111f75e22d409998cf8b85bd431f0a",22888374,1,-5,0,1813,112,108,-4
"08111f75e22d409998cf8b85bd431f0a","00ae5f0c51874a73a41ebea838d95682",22888374,1,-8,0,1814,108,101,-7
"00ae5f0c51874a73a41ebea838d95682","d391c8b6e56a43a7b654e9dee02d904b",22888374,2,2,0,1815,101,103,2
"d391c8b6e56a43a7b654e9dee02d904b","73039f8c1eb9409cb4caee2cf968001e",22888374,2,-3,0,1816,103,100,-3
"73039f8c1eb9409cb4caee2cf968001e","e20db35ced8544ddac5bc3839145e463",22888374,1,-10,0,1817,100,91,-9
"e20db35ced8544ddac5bc3839145e463","d646286c8051419bbc2e31dd1db55ca8",22888374,1,-30,0,1818,91,67,-24
"d646286c8051419bbc2e31dd1db55ca8","6a9f0ef185fb47f0937e29daa1c71ed5",22888374,1,27,0,1819,67,90,23
"6a9f0ef185fb47f0937e29daa1c71ed5","6a9f0ef185fb47f0937e29daa1c71ed5",22888374,7,0,1,1820,90,90,0
"6a9f0ef185fb47f0937e29daa1c71ed5","42fb58708eaf4e5daa82bfca61b6f5fd",22888374,2,-3,0,1822,90,87,-3
"42fb58708eaf4e5daa82bfca61b6f5fd","ae5ac430ea254e708a6f5deaaf7464ae",22888374,2,-4,0,1823,87,84,-3
"ae5ac430ea254e708a6f5deaaf7464ae","d18a9ea32855445f8736581f5cb119ce",22888374,1,-3,0,1824,84,82,-2
"d18a9ea32855445f8736581f5cb119ce","a2becd407db34b189200a32546d9d569",22888374,1,-8,0,1825,82,75,-7
"a2becd407db34b189200a32546d9d569","140d5b27b8574befad82c0a013b59dfa",22888374,1,-1,0,1826,75,74,-1
"140d5b27b8574befad82c0a013b59dfa","d646286c8051419bbc2e31dd1db55ca8",22888374,2,-8,0,1827,74,67,-7
"d646286c8051419bbc2e31dd1db55ca8","b534b89233134e30a9b5645138bfa9ee",22888374,2,-33,0,1828,67,41,-26
"b534b89233134e30a9b5645138bfa9ee","a0a418b8540d479fa6e0f653b701da8b",22888374,1,27,0,1829,41,64,23
"a0a418b8540d479fa6e0f653b701da8b","7af822066add4e7f8e007e4eee31a8bf",22888374,1,2,0,1830,64,65,1
"7af822066add4e7f8e007e4eee31a8bf","bc42d26810654ea9a1df1efe1e58c7d5",22888374,1,-3,0,1831,65,63,-2
"bc42d26810654ea9a1df1efe1e58c7d5","bc42d26810654ea9a1df1efe1e58c7d5",22888374,6,0,1,1832,63,63,0
"bc42d26810654ea9a1df1efe1e58c7d5","a0a418b8540d479fa6e0f653b701da8b",22888374,4,1,0,1834,63,64,1
"a0a418b8540d479fa6e0f653b701da8b","a0a418b8540d479fa6e0f653b701da8b",22888374,6,0,1,1835,64,64,0
"a0a418b8540d479fa6e0f653b701da8b","309ccf3cc4fe429d9bfbaef53d3fa479",22888374,2,-4,0,1836,64,60,-4
"309ccf3cc4fe429d9bfbaef53d3fa479","a1f2f12debe5432fb7a70bcd12bacfb9",22888374,1,-3,0,1837,60,58,-2
"78f30e4dcac84e3cbea8b2cc6e0d62b3","d0c74f735e024943943e40333d6d337f",22888374,1,-9,0,1839,59,51,-8
"d0c74f735e024943943e40333d6d337f","12aa6e1672ac4e7aa6449a7a8609cd72",22888374,2,7,0,1840,51,57,6
"12aa6e1672ac4e7aa6449a7a8609cd72","f924752d8a1149668870b1e7698486f7",22888374,2,-8,0,1841,57,50,-7
"f924752d8a1149668870b1e7698486f7","6e13d61a7bdb44bca949c9f86fab3be5",22888374,2,-4,0,1842,50,47,-3
"6e13d61a7bdb44bca949c9f86fab3be5","d9c8d8c444a64dadbbb508652c721e17",22888374,2,-1,0,1843,47,46,-1
"d9c8d8c444a64dadbbb508652c721e17","b534b89233134e30a9b5645138bfa9ee",22888374,2,-6,0,1844,46,41,-5
"b534b89233134e30a9b5645138bfa9ee","67a089198fcb4e1c8f2385786c2b296f",22888374,2,-4,0,1845,41,39,-2
"67a089198fcb4e1c8f2385786c2b296f","64d48c6c9c7940639a932219a6c87198",22888374,3,1,0,1846,39,40,1
"64d48c6c9c7940639a932219a6c87198","67a089198fcb4e1c8f2385786c2b296f",22888374,5,-1,0,1847,40,39,-1
"67a089198fcb4e1c8f2385786c2b296f","fc0e049d56024bc9a02c9a9c435c3df7",22888374,4,-4,0,1848,39,38,-1
"fc0e049d56024bc9a02c9a9c435c3df7","fc0e049d56024bc9a02c9a9c435c3df7",22888374,1,0,1,1849,38,38,0
"fc0e049d56024bc9a02c9a9c435c3df7","9a0dc646f934470daf08c4b56ccf73db",22888374,3,-3,0,1850,38,37,-1
"9a0dc646f934470daf08c4b56ccf73db","fc0e049d56024bc9a02c9a9c435c3df7",22888374,3,3,0,1851,37,38,1
"9a0dc646f934470daf08c4b56ccf73db","67a089198fcb4e1c8f2385786c2b296f",22888374,1,7,0,1853,37,39,2
"fc0e049d56024bc9a02c9a9c435c3df7","64d48c6c9c7940639a932219a6c87198",22888374,2,5,0,1855,38,40,2
"64d48c6c9c7940639a932219a6c87198","64d48c6c9c7940639a932219a6c87198",22888374,9,0,1,1856,40,40,0
"67a089198fcb4e1c8f2385786c2b296f","b534b89233134e30a9b5645138bfa9ee",22888374,2,4,0,1863,39,41,2
"b534b89233134e30a9b5645138bfa9ee","d7f13c8d63ec4e2aa673fbb9cf9c6933",22888374,1,214,0,1864,41,206,165
"7108f0e4c2584f1f9c471689ae4c885c","c8e371568a0c4391b25796ae4e91952e",22888374,1,-28,0,1867,208,186,-22
"c8e371568a0c4391b25796ae4e91952e","d7f13c8d63ec4e2aa673fbb9cf9c6933",22888374,2,26,0,1868,186,206,20
"d7f13c8d63ec4e2aa673fbb9cf9c6933","b54257a550b94ebc9538f3a90eee9d7e",22888374,1,-4,0,1869,206,204,-2
"6cd2dcaac46847d4a0bc53f296d90375","017d7ca8e0394b91aaadc9574df2202c",22888374,1,-1,0,1872,194,193,-1
"017d7ca8e0394b91aaadc9574df2202c","ab11d94c6c8948ea90b88f19d2cd502b",22888374,1,-4,0,1873,193,190,-3
"ab11d94c6c8948ea90b88f19d2cd502b","07b44a7a51e94c78b411c753fc39dab0",22888374,1,-1,0,1874,190,189,-1
"c8e371568a0c4391b25796ae4e91952e","cf4c280bad6a43e6b131d8385ef9ef3f",22888374,1,-4,0,1877,186,184,-2
"cf4c280bad6a43e6b131d8385ef9ef3f","2024b4885bd14338a39b7b509acbbd02",22888374,1,-3,0,1878,184,182,-2
"2024b4885bd14338a39b7b509acbbd02","ea38cc0e6e6e41edbabf210220808bf9",22888374,1,-4,0,1879,182,179,-3
"ea38cc0e6e6e41edbabf210220808bf9","b87c552dd247427abe6ab5795b9c9d43",22888374,3,2,0,1880,179,181,2
"b87c552dd247427abe6ab5795b9c9d43","362fcb0699a14845ab29b2340093e528",22888374,1,-8,0,1881,181,174,-7
"362fcb0699a14845ab29b2340093e528","b42cc17b7de840f181a704558d0bc845",22888374,1,1,0,1882,174,175,1
"139b097acfca451689d80c9c6eebdf7b","0c7262dff33c4087bc660ccf40f92f9c",22888374,1,-11,0,1884,178,169,-9
"a9ac840f098c4bd0a2ee896214ce29cd","b2275c3fad834f8d90737a2d9a6927d6",22888374,1,7,0,1886,168,172,4
"b2275c3fad834f8d90737a2d9a6927d6","a9ac840f098c4bd0a2ee896214ce29cd",22888374,1,-7,0,1887,172,168,-4
"3cbcea2be0984e7dbd5a48195af10ce7","82e6285962b8400d9d6fc32436022a94",22888374,3,2,0,1889,165,167,2
"78adeee1fa2c4fe0bc73f7bca9fcee86","78adeee1fa2c4fe0bc73f7bca9fcee86",22888374,2,0,1,1903,160,160,0
"78adeee1fa2c4fe0bc73f7bca9fcee86","df1de691dafe4549a18a4398ee9dfaf9",22888374,1,-26,0,1904,160,139,-21
"df1de691dafe4549a18a4398ee9dfaf9","d313cec988a84645bee413e8d4724a4b",22888374,1,22,0,1905,139,158,19
"f902b0f41b544d4dbf79664fd233648d","df1de691dafe4549a18a4398ee9dfaf9",22888374,1,-8,0,1912,146,139,-7
"779f9ddd1fd14d1e9e69f72219a1fdbd","6c5ad271a44743479bfaea29b1db8d02",22888374,1,27,0,1914,121,143,22
"6c5ad271a44743479bfaea29b1db8d02","f661500307d74c908e9207d949ceb4aa",22888374,1,-9,0,1915,143,136,-7
"62bff51286ef4f348717a3cf6fe2318f","a9ae0a3c070d455bb4369a8996313336",22888374,1,-7,0,1924,120,114,-6
"a9ae0a3c070d455bb4369a8996313336","3ec3a3563847406fa73338f9e9999cf3",22888374,1,4,0,1925,114,117,3
"3ec3a3563847406fa73338f9e9999cf3","37319e88176d4aefa91d7a9980dbae91",22888374,1,-6,0,1926,117,112,-5
"37319e88176d4aefa91d7a9980dbae91","4280927ec4d643238aa49c32f9e06c6c",22888374,1,-4,0,1927,112,109,-3
"4280927ec4d643238aa49c32f9e06c6c","00ae5f0c51874a73a41ebea838d95682",22888374,1,-9,0,1928,109,101,-8
"00ae5f0c51874a73a41ebea838d95682","08111f75e22d409998cf8b85bd431f0a",22888374,1,8,0,1929,101,108,7
"08111f75e22d409998cf8b85bd431f0a","d391c8b6e56a43a7b654e9dee02d904b",22888374,1,-6,0,1930,108,103,-5
"73039f8c1eb9409cb4caee2cf968001e","d646286c8051419bbc2e31dd1db55ca8",22888374,1,-40,0,1932,100,67,-33
"d646286c8051419bbc2e31dd1db55ca8","e20db35ced8544ddac5bc3839145e463",22888374,2,30,0,1933,67,91,24
"e20db35ced8544ddac5bc3839145e463","6a9f0ef185fb47f0937e29daa1c71ed5",22888374,1,-3,0,1934,91,90,-1
"ae5ac430ea254e708a6f5deaaf7464ae","a2becd407db34b189200a32546d9d569",22888374,1,-11,0,1939,84,75,-9
"a2becd407db34b189200a32546d9d569","d18a9ea32855445f8736581f5cb119ce",22888374,1,8,0,1940,75,82,7
"d18a9ea32855445f8736581f5cb119ce","140d5b27b8574befad82c0a013b59dfa",22888374,1,-9,0,1941,82,74,-8
"b534b89233134e30a9b5645138bfa9ee","bc42d26810654ea9a1df1efe1e58c7d5",22888374,1,26,0,1944,41,63,22
"a0a418b8540d479fa6e0f653b701da8b","bc42d26810654ea9a1df1efe1e58c7d5",22888374,1,-1,0,1949,64,63,-1
"bc42d26810654ea9a1df1efe1e58c7d5","7af822066add4e7f8e007e4eee31a8bf",22888374,1,3,0,1950,63,65,2
"7af822066add4e7f8e007e4eee31a8bf","309ccf3cc4fe429d9bfbaef53d3fa479",22888374,1,-6,0,1951,65,60,-5
"309ccf3cc4fe429d9bfbaef53d3fa479","78f30e4dcac84e3cbea8b2cc6e0d62b3",22888374,1,-2,0,1952,60,59,-1
"a1f2f12debe5432fb7a70bcd12bacfb9","d0c74f735e024943943e40333d6d337f",22888374,1,-8,0,1954,58,51,-7
"fc0e049d56024bc9a02c9a9c435c3df7","7040a13096d746ac84b8fac8d9752058",22888374,1,-6,0,1966,38,36,-2
"7040a13096d746ac84b8fac8d9752058","9a0dc646f934470daf08c4b56ccf73db",22888374,2,3,0,1967,36,37,1
"9a0dc646f934470daf08c4b56ccf73db","7040a13096d746ac84b8fac8d9752058",22888374,1,-3,0,1968,37,36,-1
"7040a13096d746ac84b8fac8d9752058","93679be414554a11b1893002f2229a93",22888374,1,-3,0,1969,36,35,-1
"93679be414554a11b1893002f2229a93","070600601c4c439288445d2f0724807d",22888374,1,552,0,1970,35,437,402
"070600601c4c439288445d2f0724807d","7bd5586eb9d8484eb74a433ee7bfe499",22888374,1,14,0,1971,437,446,9
"7bd5586eb9d8484eb74a433ee7bfe499","afbf7250b99d47bea07172749483ca97",22888374,1,-581,0,1972,446,28,-418
"afbf7250b99d47bea07172749483ca97","afbf7250b99d47bea07172749483ca97",22888374,2,0,1,1973,28,28,0
"afbf7250b99d47bea07172749483ca97","4e51676dc72045d99c19b9fa7b22f8bc",22888374,2,3,0,1974,28,29,1
"4e51676dc72045d99c19b9fa7b22f8bc","4e51676dc72045d99c19b9fa7b22f8bc",22888374,2,0,1,1975,29,29,0
"4e51676dc72045d99c19b9fa7b22f8bc","afbf7250b99d47bea07172749483ca97",22888374,1,-3,0,1976,29,28,-1
"afbf7250b99d47bea07172749483ca97","b7719e26494940efa49512aedd0aac79",22888374,2,-12,0,1977,28,20,-8
"b7719e26494940efa49512aedd0aac79","afbf7250b99d47bea07172749483ca97",22888374,3,12,0,1978,20,28,8
"afbf7250b99d47bea07172749483ca97","d4f45188d3c84a02ba08454e6403a818",22888374,1,-7,0,1979,28,24,-4
"d4f45188d3c84a02ba08454e6403a818","a49d1bb4328949299686242fd0be5584",22888374,1,-3,0,1980,24,21,-3
"a49d1bb4328949299686242fd0be5584","d4c3b003e8274e429d2fa688d73fde6d",22888374,1,1,0,1981,21,22,1
"d4c3b003e8274e429d2fa688d73fde6d","b7719e26494940efa49512aedd0aac79",22888374,2,-3,0,1982,22,20,-2
"b7719e26494940efa49512aedd0aac79","9afd71a5298d4333b6849dfce1b9422c",22888374,2,-4,0,1983,20,18,-2
"9afd71a5298d4333b6849dfce1b9422c","56586aa865414f538729c7f7735d2bc6",22888374,1,-13,0,1984,18,12,-6
"56586aa865414f538729c7f7735d2bc6","9afd71a5298d4333b6849dfce1b9422c",22888374,2,13,0,1985,12,18,6
"9afd71a5298d4333b6849dfce1b9422c","5c5ceeee4562457ba6d41515aeebfbb1",22888374,1,-3,0,1986,18,17,-1
"5c5ceeee4562457ba6d41515aeebfbb1","eb2a0eb537344a9e891c761662e400b6",22888374,1,-2,0,1987,17,16,-1
"eb2a0eb537344a9e891c761662e400b6","81c864a886d54a6b8ff85f7d736f4f95",22888374,1,-2,0,1988,16,15,-1
"81c864a886d54a6b8ff85f7d736f4f95","3f1c815879794b929260d224becaff7e",22888374,1,-2,0,1989,15,14,-1
"3f1c815879794b929260d224becaff7e","b7f2b31585d94eb3bf86376714aa7070",22888374,1,-2,0,1990,14,13,-1
"b7f2b31585d94eb3bf86376714aa7070","b7f2b31585d94eb3bf86376714aa7070",22888374,3,0,1,1991,13,13,0
"b7f2b31585d94eb3bf86376714aa7070","56586aa865414f538729c7f7735d2bc6",22888374,1,-2,0,1992,13,12,-1
"56586aa865414f538729c7f7735d2bc6","56586aa865414f538729c7f7735d2bc6",22888374,9,0,1,1993,12,12,0
"56586aa865414f538729c7f7735d2bc6","e2911e79efc2420eac45d9f671463d4b",22888374,2,-12,0,1994,12,2,-10
"e2911e79efc2420eac45d9f671463d4b","b613861cecf84ffcab01afb23f660475",22888374,3,-3,0,1995,2,1,-1
"b613861cecf84ffcab01afb23f660475","e2911e79efc2420eac45d9f671463d4b",22888374,4,3,0,1996,1,2,1
"e2911e79efc2420eac45d9f671463d4b","9112f2bffece48e08c6d2287be204085",22888374,1,9,0,1999,2,11,9
"9112f2bffece48e08c6d2287be204085","56586aa865414f538729c7f7735d2bc6",22888374,1,3,0,2000,11,12,1
"e2911e79efc2420eac45d9f671463d4b","56586aa865414f538729c7f7735d2bc6",22888374,3,12,0,2002,2,12,10
"b613861cecf84ffcab01afb23f660475","b613861cecf84ffcab01afb23f660475",22891963,3,0,1,1,1,1,0
"b613861cecf84ffcab01afb23f660475","e2911e79efc2420eac45d9f671463d4b",22891963,2,3,0,4,1,2,1
"e2911e79efc2420eac45d9f671463d4b","b613861cecf84ffcab01afb23f660475",22891963,1,-3,0,5,2,1,-1
"e2911e79efc2420eac45d9f671463d4b","e2911e79efc2420eac45d9f671463d4b",22891963,1,0,1,7,2,2,0
"e2911e79efc2420eac45d9f671463d4b","519d1b8c59404d67b54e96c5c8a830b2",22891963,1,1,0,8,2,3,1
"519d1b8c59404d67b54e96c5c8a830b2","519d1b8c59404d67b54e96c5c8a830b2",22891963,1,0,1,9,3,3,0
"519d1b8c59404d67b54e96c5c8a830b2","531db53f81f646edb0cdcfe0085b03b7",22891963,1,1,0,10,3,4,1
"531db53f81f646edb0cdcfe0085b03b7","531db53f81f646edb0cdcfe0085b03b7",22891963,1,0,1,11,4,4,0
"531db53f81f646edb0cdcfe0085b03b7","4f5f94b2f95141e0a9d53a61da2276da",22891963,1,1,0,12,4,5,1
"4f5f94b2f95141e0a9d53a61da2276da","4f5f94b2f95141e0a9d53a61da2276da",22891963,1,0,1,13,5,5,0
"4f5f94b2f95141e0a9d53a61da2276da","6d541c89590949f99af293c4f2333f67",22891963,1,1,0,14,5,6,1
"6d541c89590949f99af293c4f2333f67","6d541c89590949f99af293c4f2333f67",22891963,1,0,1,15,6,6,0
"6d541c89590949f99af293c4f2333f67","dd5cf0b9fe4c4f1d8f5ff8e4c04879cb",22891963,1,1,0,16,6,7,1
"dd5cf0b9fe4c4f1d8f5ff8e4c04879cb","dd5cf0b9fe4c4f1d8f5ff8e4c04879cb",22891963,1,0,1,17,7,7,0
"dd5cf0b9fe4c4f1d8f5ff8e4c04879cb","f96261861edc426abe2248be4f0a709a",22891963,1,1,0,18,7,8,1
"f96261861edc426abe2248be4f0a709a","f96261861edc426abe2248be4f0a709a",22891963,1,0,1,19,8,8,0
"f96261861edc426abe2248be4f0a709a","66b5e16f4f75454fb5b8172079f0fa83",22891963,1,1,0,20,8,9,1
"66b5e16f4f75454fb5b8172079f0fa83","66b5e16f4f75454fb5b8172079f0fa83",22891963,1,0,1,21,9,9,0
"66b5e16f4f75454fb5b8172079f0fa83","0680571d4698477995e41842c36a54b2",22891963,1,1,0,22,9,10,1
"0680571d4698477995e41842c36a54b2","0680571d4698477995e41842c36a54b2",22891963,1,0,1,23,10,10,0
"0680571d4698477995e41842c36a54b2","9112f2bffece48e08c6d2287be204085",22891963,1,1,0,24,10,11,1
"9112f2bffece48e08c6d2287be204085","9112f2bffece48e08c6d2287be204085",22891963,1,0,1,25,11,11,0
"9112f2bffece48e08c6d2287be204085","56586aa865414f538729c7f7735d2bc6",22891963,1,3,0,26,11,12,1
"56586aa865414f538729c7f7735d2bc6","e2911e79efc2420eac45d9f671463d4b",22891963,1,-12,0,27,12,2,-10
"e2911e79efc2420eac45d9f671463d4b","56586aa865414f538729c7f7735d2bc6",22891963,1,12,0,28,2,12,10
"56586aa865414f538729c7f7735d2bc6","56586aa865414f538729c7f7735d2bc6",22891963,4,0,1,29,12,12,0
"56586aa865414f538729c7f7735d2bc6","b7f2b31585d94eb3bf86376714aa7070",22891963,3,2,0,31,12,13,1
"b7f2b31585d94eb3bf86376714aa7070","b7f2b31585d94eb3bf86376714aa7070",22891963,2,0,1,32,13,13,0
"b7f2b31585d94eb3bf86376714aa7070","3f1c815879794b929260d224becaff7e",22891963,2,2,0,34,13,14,1
"3f1c815879794b929260d224becaff7e","5c5ceeee4562457ba6d41515aeebfbb1",22891963,2,6,0,35,14,17,3
"5c5ceeee4562457ba6d41515aeebfbb1","56586aa865414f538729c7f7735d2bc6",22891963,2,-10,0,36,17,12,-5
"b7f2b31585d94eb3bf86376714aa7070","56586aa865414f538729c7f7735d2bc6",22891963,1,-2,0,40,13,12,-1
"5c5ceeee4562457ba6d41515aeebfbb1","81c864a886d54a6b8ff85f7d736f4f95",22891963,1,-4,0,44,17,15,-2
"81c864a886d54a6b8ff85f7d736f4f95","5c5ceeee4562457ba6d41515aeebfbb1",22891963,1,4,0,45,15,17,2
"56586aa865414f538729c7f7735d2bc6","9afd71a5298d4333b6849dfce1b9422c",22891963,1,13,0,47,12,18,6
"9afd71a5298d4333b6849dfce1b9422c","9afd71a5298d4333b6849dfce1b9422c",22891963,3,0,1,48,18,18,0
"9afd71a5298d4333b6849dfce1b9422c","b7719e26494940efa49512aedd0aac79",22891963,1,4,0,51,18,20,2
"b7719e26494940efa49512aedd0aac79","d4f45188d3c84a02ba08454e6403a818",22891963,1,5,0,52,20,24,4
"d4f45188d3c84a02ba08454e6403a818","d4c3b003e8274e429d2fa688d73fde6d",22891963,1,-2,0,53,24,22,-2
"d4c3b003e8274e429d2fa688d73fde6d","d4c3b003e8274e429d2fa688d73fde6d",22891963,1,0,1,54,22,22,0
"d4c3b003e8274e429d2fa688d73fde6d","b7719e26494940efa49512aedd0aac79",22891963,1,-3,0,55,22,20,-2
"b7719e26494940efa49512aedd0aac79","b7719e26494940efa49512aedd0aac79",22891963,1,0,1,56,20,20,0
"b7719e26494940efa49512aedd0aac79","afbf7250b99d47bea07172749483ca97",22891963,1,12,0,57,20,28,8
"afbf7250b99d47bea07172749483ca97","4e51676dc72045d99c19b9fa7b22f8bc",22891963,2,3,0,58,28,29,1
"4e51676dc72045d99c19b9fa7b22f8bc","afbf7250b99d47bea07172749483ca97",22891963,1,-3,0,59,29,28,-1
"4e51676dc72045d99c19b9fa7b22f8bc","51970cfa30e643e894e66ae85c8024cc",22891963,1,3,0,61,29,31,2
"51970cfa30e643e894e66ae85c8024cc","c33c17be71ae4d588da7369472e5bb1b",22891963,1,6,0,62,31,34,3
"c33c17be71ae4d588da7369472e5bb1b","4e51676dc72045d99c19b9fa7b22f8bc",22891963,1,-9,0,63,34,29,-5
"4e51676dc72045d99c19b9fa7b22f8bc","c33c17be71ae4d588da7369472e5bb1b",22891963,1,9,0,64,29,34,5
"c33c17be71ae4d588da7369472e5bb1b","93679be414554a11b1893002f2229a93",22891963,1,3,0,65,34,35,1
"93679be414554a11b1893002f2229a93","93679be414554a11b1893002f2229a93",22891963,1,0,1,66,35,35,0
"93679be414554a11b1893002f2229a93","7040a13096d746ac84b8fac8d9752058",22891963,1,3,0,67,35,36,1
"7040a13096d746ac84b8fac8d9752058","7040a13096d746ac84b8fac8d9752058",22891963,1,0,1,68,36,36,0
"7040a13096d746ac84b8fac8d9752058","9a0dc646f934470daf08c4b56ccf73db",22891963,1,3,0,69,36,37,1
"fc0e049d56024bc9a02c9a9c435c3df7","67a089198fcb4e1c8f2385786c2b296f",22891963,1,4,0,72,38,39,1
"67a089198fcb4e1c8f2385786c2b296f","fc0e049d56024bc9a02c9a9c435c3df7",22891963,1,-4,0,73,39,38,-1
"fc0e049d56024bc9a02c9a9c435c3df7","64d48c6c9c7940639a932219a6c87198",22891963,1,5,0,74,38,40,2
"64d48c6c9c7940639a932219a6c87198","67a089198fcb4e1c8f2385786c2b296f",22891963,3,-1,0,75,40,39,-1
"67a089198fcb4e1c8f2385786c2b296f","64d48c6c9c7940639a932219a6c87198",22891963,2,1,0,76,39,40,1
"64d48c6c9c7940639a932219a6c87198","64d48c6c9c7940639a932219a6c87198",22891963,1,0,1,79,40,40,0
"67a089198fcb4e1c8f2385786c2b296f","b534b89233134e30a9b5645138bfa9ee",22891963,1,4,0,81,39,41,2
"b534b89233134e30a9b5645138bfa9ee","0e37b720d23b4e7f8b313e79313fd107",22891963,1,3,0,82,41,44,3
"0e37b720d23b4e7f8b313e79313fd107","0e37b720d23b4e7f8b313e79313fd107",22891963,1,0,1,83,44,44,0
"0e37b720d23b4e7f8b313e79313fd107","6875d67fdd5f48168b62719df449bebd",22891963,1,1,0,84,44,45,1
"6875d67fdd5f48168b62719df449bebd","6875d67fdd5f48168b62719df449bebd",22891963,1,0,1,85,45,45,0
"6875d67fdd5f48168b62719df449bebd","6e13d61a7bdb44bca949c9f86fab3be5",22891963,1,3,0,86,45,47,2
"6e13d61a7bdb44bca949c9f86fab3be5","b534b89233134e30a9b5645138bfa9ee",22891963,1,-7,0,87,47,41,-6
"b534b89233134e30a9b5645138bfa9ee","6e13d61a7bdb44bca949c9f86fab3be5",22891963,1,7,0,88,41,47,6
"6e13d61a7bdb44bca949c9f86fab3be5","6e13d61a7bdb44bca949c9f86fab3be5",22891963,2,0,1,89,47,47,0
"6e13d61a7bdb44bca949c9f86fab3be5","195f78799f984cc2b06c48dfe36be751",22891963,1,2,0,91,47,49,2
"195f78799f984cc2b06c48dfe36be751","195f78799f984cc2b06c48dfe36be751",22891963,2,0,1,92,49,49,0
"195f78799f984cc2b06c48dfe36be751","d0c74f735e024943943e40333d6d337f",22891963,1,3,0,94,49,51,2
"d0c74f735e024943943e40333d6d337f","d9c8d8c444a64dadbbb508652c721e17",22891963,1,-6,0,95,51,46,-5
"d9c8d8c444a64dadbbb508652c721e17","d0c74f735e024943943e40333d6d337f",22891963,1,6,0,96,46,51,5
"d0c74f735e024943943e40333d6d337f","983f8ff320594b279a7f4a6fe132f9c5",22891963,1,2,0,97,51,53,2
"983f8ff320594b279a7f4a6fe132f9c5","983f8ff320594b279a7f4a6fe132f9c5",22891963,2,0,1,98,53,53,0
"983f8ff320594b279a7f4a6fe132f9c5","35adfa5d923046aebabfefd98f35ff05",22891963,1,1,0,100,53,54,1
"35adfa5d923046aebabfefd98f35ff05","35adfa5d923046aebabfefd98f35ff05",22891963,8,0,1,101,54,54,0
"35adfa5d923046aebabfefd98f35ff05","b6f8a98476224da1b40e555ececc7ed8",22891963,1,1,0,109,54,55,1
"b6f8a98476224da1b40e555ececc7ed8","b6f8a98476224da1b40e555ececc7ed8",22891963,2,0,1,110,55,55,0
"b6f8a98476224da1b40e555ececc7ed8","86e22cb5fe0e4b47a9489ecddf7ed78f",22891963,1,1,0,112,55,56,1
"86e22cb5fe0e4b47a9489ecddf7ed78f","86e22cb5fe0e4b47a9489ecddf7ed78f",22891963,2,0,1,113,56,56,0
"86e22cb5fe0e4b47a9489ecddf7ed78f","78f30e4dcac84e3cbea8b2cc6e0d62b3",22891963,1,4,0,115,56,59,3
"78f30e4dcac84e3cbea8b2cc6e0d62b3","f924752d8a1149668870b1e7698486f7",22891963,1,-10,0,116,59,50,-9
"f924752d8a1149668870b1e7698486f7","a1f2f12debe5432fb7a70bcd12bacfb9",22891963,1,9,0,117,50,58,8
"a1f2f12debe5432fb7a70bcd12bacfb9","a1f2f12debe5432fb7a70bcd12bacfb9",22891963,12,0,1,118,58,58,0
"a1f2f12debe5432fb7a70bcd12bacfb9","78f30e4dcac84e3cbea8b2cc6e0d62b3",22891963,1,1,0,130,58,59,1
"78f30e4dcac84e3cbea8b2cc6e0d62b3","78f30e4dcac84e3cbea8b2cc6e0d62b3",22891963,7,0,1,131,59,59,0
"78f30e4dcac84e3cbea8b2cc6e0d62b3","12aa6e1672ac4e7aa6449a7a8609cd72",22891963,1,-2,0,138,59,57,-2
"12aa6e1672ac4e7aa6449a7a8609cd72","bc42d26810654ea9a1df1efe1e58c7d5",22891963,1,7,0,139,57,63,6
"bc42d26810654ea9a1df1efe1e58c7d5","a0a418b8540d479fa6e0f653b701da8b",22891963,2,1,0,140,63,64,1
"a0a418b8540d479fa6e0f653b701da8b","4c943503763e4e349906eea3ed3c8e86",22891963,1,-3,0,141,64,61,-3
"4c943503763e4e349906eea3ed3c8e86","4c943503763e4e349906eea3ed3c8e86",22891963,1,0,1,142,61,61,0
"4c943503763e4e349906eea3ed3c8e86","bc42d26810654ea9a1df1efe1e58c7d5",22891963,1,2,0,143,61,63,2
"bc42d26810654ea9a1df1efe1e58c7d5","bc42d26810654ea9a1df1efe1e58c7d5",22891963,3,0,1,144,63,63,0
"a0a418b8540d479fa6e0f653b701da8b","a0a418b8540d479fa6e0f653b701da8b",22891963,3,0,1,148,64,64,0
"a0a418b8540d479fa6e0f653b701da8b","309ccf3cc4fe429d9bfbaef53d3fa479",22891963,1,-4,0,151,64,60,-4
"309ccf3cc4fe429d9bfbaef53d3fa479","b534b89233134e30a9b5645138bfa9ee",22891963,1,-23,0,152,60,41,-19
"b534b89233134e30a9b5645138bfa9ee","d646286c8051419bbc2e31dd1db55ca8",22891963,1,33,0,153,41,67,26
"d646286c8051419bbc2e31dd1db55ca8","267f883678b24aed855fde42524975d9",22891963,1,4,0,154,67,71,4
"267f883678b24aed855fde42524975d9","267f883678b24aed855fde42524975d9",22891963,1,0,1,155,71,71,0
"267f883678b24aed855fde42524975d9","88fff56d0342490dbef9040750a20f6c",22891963,1,1,0,156,71,72,1
"88fff56d0342490dbef9040750a20f6c","88fff56d0342490dbef9040750a20f6c",22891963,1,0,1,157,72,72,0
"88fff56d0342490dbef9040750a20f6c","adb17b12b66c4a49a85fd34322f7df70",22891963,1,1,0,158,72,73,1
"adb17b12b66c4a49a85fd34322f7df70","adb17b12b66c4a49a85fd34322f7df70",22891963,1,0,1,159,73,73,0
"adb17b12b66c4a49a85fd34322f7df70","a2becd407db34b189200a32546d9d569",22891963,1,3,0,160,73,75,2
"a2becd407db34b189200a32546d9d569","d646286c8051419bbc2e31dd1db55ca8",22891963,1,-9,0,161,75,67,-8
"d646286c8051419bbc2e31dd1db55ca8","a2becd407db34b189200a32546d9d569",22891963,1,9,0,162,67,75,8
"a2becd407db34b189200a32546d9d569","a2becd407db34b189200a32546d9d569",22891963,2,0,1,163,75,75,0
"a2becd407db34b189200a32546d9d569","58c22b011d0f4c2ea6d13615edbb9eeb",22891963,1,2,0,165,75,77,2
"58c22b011d0f4c2ea6d13615edbb9eeb","58c22b011d0f4c2ea6d13615edbb9eeb",22891963,11,0,1,166,77,77,0
"58c22b011d0f4c2ea6d13615edbb9eeb","dd76e1861dc9461c830888729d091ee0",22891963,1,1,0,177,77,78,1
"dd76e1861dc9461c830888729d091ee0","dd76e1861dc9461c830888729d091ee0",22891963,8,0,1,178,78,78,0
"dd76e1861dc9461c830888729d091ee0","cd1d828f1a694b87913a7ea66c23803e",22891963,1,1,0,186,78,79,1
"cd1d828f1a694b87913a7ea66c23803e","cd1d828f1a694b87913a7ea66c23803e",22891963,2,0,1,187,79,79,0
"cd1d828f1a694b87913a7ea66c23803e","9176a3c2b4d2465fa8b0c67096c2a97e",22891963,1,1,0,189,79,80,1
"9176a3c2b4d2465fa8b0c67096c2a97e","9176a3c2b4d2465fa8b0c67096c2a97e",22891963,5,0,1,190,80,80,0
"9176a3c2b4d2465fa8b0c67096c2a97e","f8ec6445f7194e25b9101d4fbcb07a18",22891963,1,1,0,195,80,81,1
"f8ec6445f7194e25b9101d4fbcb07a18","f8ec6445f7194e25b9101d4fbcb07a18",22891963,2,0,1,196,81,81,0
"f8ec6445f7194e25b9101d4fbcb07a18","140d5b27b8574befad82c0a013b59dfa",22891963,1,-7,0,198,81,74,-7
"140d5b27b8574befad82c0a013b59dfa","d18a9ea32855445f8736581f5cb119ce",22891963,1,9,0,199,74,82,8
"d18a9ea32855445f8736581f5cb119ce","f564483cbd7a407681aa2fcca518cf5f",22891963,1,4,0,200,82,85,3
"f564483cbd7a407681aa2fcca518cf5f","f564483cbd7a407681aa2fcca518cf5f",22891963,1,0,1,201,85,85,0
"f564483cbd7a407681aa2fcca518cf5f","18fd01350bd5434ca636d59a599d768a",22891963,1,1,0,202,85,86,1
"18fd01350bd5434ca636d59a599d768a","18fd01350bd5434ca636d59a599d768a",22891963,8,0,1,203,86,86,0
"18fd01350bd5434ca636d59a599d768a","ae5ac430ea254e708a6f5deaaf7464ae",22891963,1,-2,0,211,86,84,-2
"ae5ac430ea254e708a6f5deaaf7464ae","6a9f0ef185fb47f0937e29daa1c71ed5",22891963,1,7,0,212,84,90,6
"6a9f0ef185fb47f0937e29daa1c71ed5","c681290961c94c4caf23b529d1ae6b9a",22891963,1,-2,0,213,90,88,-2
"c681290961c94c4caf23b529d1ae6b9a","c681290961c94c4caf23b529d1ae6b9a",22891963,1,0,1,214,88,88,0
"c681290961c94c4caf23b529d1ae6b9a","6a9f0ef185fb47f0937e29daa1c71ed5",22891963,1,2,0,215,88,90,2
"6a9f0ef185fb47f0937e29daa1c71ed5","6a9f0ef185fb47f0937e29daa1c71ed5",22891963,3,0,1,216,90,90,0
"6a9f0ef185fb47f0937e29daa1c71ed5","d646286c8051419bbc2e31dd1db55ca8",22891963,1,-27,0,219,90,67,-23
"d646286c8051419bbc2e31dd1db55ca8","e20db35ced8544ddac5bc3839145e463",22891963,1,30,0,220,67,91,24
"e20db35ced8544ddac5bc3839145e463","e20db35ced8544ddac5bc3839145e463",22891963,3,0,1,221,91,91,0
"e20db35ced8544ddac5bc3839145e463","1febb706d7a34005ae8711ed49c76e64",22891963,1,3,0,224,91,94,3
"1febb706d7a34005ae8711ed49c76e64","1febb706d7a34005ae8711ed49c76e64",22891963,5,0,1,225,94,94,0
"1febb706d7a34005ae8711ed49c76e64","8f73ba6f5a0042f2850356ac38ac6f24",22891963,1,1,0,230,94,95,1
"8f73ba6f5a0042f2850356ac38ac6f24","8f73ba6f5a0042f2850356ac38ac6f24",22891963,5,0,1,231,95,95,0
"8f73ba6f5a0042f2850356ac38ac6f24","e2260b86653c46d7b14a41fb419dbf8c",22891963,1,1,0,236,95,96,1
"e2260b86653c46d7b14a41fb419dbf8c","e2260b86653c46d7b14a41fb419dbf8c",22891963,2,0,1,237,96,96,0
"e2260b86653c46d7b14a41fb419dbf8c","35eb641ad1d845bbba54915bce75a962",22891963,1,1,0,239,96,97,1
"35eb641ad1d845bbba54915bce75a962","35eb641ad1d845bbba54915bce75a962",22891963,5,0,1,240,97,97,0
"35eb641ad1d845bbba54915bce75a962","08be90ffbeea4795a138cd42ed8db56f",22891963,1,1,0,245,97,98,1
"08be90ffbeea4795a138cd42ed8db56f","08be90ffbeea4795a138cd42ed8db56f",22891963,5,0,1,246,98,98,0
"08be90ffbeea4795a138cd42ed8db56f","3007433c8f584dcbb5ac159c1c5f2be3",22891963,1,1,0,251,98,99,1
"3007433c8f584dcbb5ac159c1c5f2be3","3007433c8f584dcbb5ac159c1c5f2be3",22891963,2,0,1,252,99,99,0
"3007433c8f584dcbb5ac159c1c5f2be3","e20db35ced8544ddac5bc3839145e463",22891963,1,-8,0,254,99,91,-8
"e20db35ced8544ddac5bc3839145e463","00ae5f0c51874a73a41ebea838d95682",22891963,1,11,0,255,91,101,10
"00ae5f0c51874a73a41ebea838d95682","d391c8b6e56a43a7b654e9dee02d904b",22891963,2,2,0,256,101,103,2
"d391c8b6e56a43a7b654e9dee02d904b","00ae5f0c51874a73a41ebea838d95682",22891963,1,-2,0,257,103,101,-2
"00ae5f0c51874a73a41ebea838d95682","00ae5f0c51874a73a41ebea838d95682",22891963,1,0,1,258,101,101,0
"d391c8b6e56a43a7b654e9dee02d904b","d391c8b6e56a43a7b654e9dee02d904b",22891963,15,0,1,260,103,103,0
"d391c8b6e56a43a7b654e9dee02d904b","6111116566fc4fd9abba409322bea245",22891963,1,1,0,275,103,104,1
"6111116566fc4fd9abba409322bea245","6111116566fc4fd9abba409322bea245",22891963,2,0,1,276,104,104,0
"6111116566fc4fd9abba409322bea245","a81b2235cb9c499eb9ea8ee0a8dd9725",22891963,1,1,0,278,104,105,1
"a81b2235cb9c499eb9ea8ee0a8dd9725","a81b2235cb9c499eb9ea8ee0a8dd9725",22891963,2,0,1,279,105,105,0
"a81b2235cb9c499eb9ea8ee0a8dd9725","2d4e0ab0ef3b4d73b82c72d4621a7579",22891963,1,1,0,281,105,106,1
"2d4e0ab0ef3b4d73b82c72d4621a7579","2d4e0ab0ef3b4d73b82c72d4621a7579",22891963,2,0,1,282,106,106,0
"2d4e0ab0ef3b4d73b82c72d4621a7579","8bdebf492ebd4e62b0d522e8ab5e5197",22891963,1,1,0,284,106,107,1
"8bdebf492ebd4e62b0d522e8ab5e5197","8bdebf492ebd4e62b0d522e8ab5e5197",22891963,2,0,1,285,107,107,0
"8bdebf492ebd4e62b0d522e8ab5e5197","73039f8c1eb9409cb4caee2cf968001e",22891963,1,-7,0,287,107,100,-7
"73039f8c1eb9409cb4caee2cf968001e","4280927ec4d643238aa49c32f9e06c6c",22891963,1,10,0,288,100,109,9
"4280927ec4d643238aa49c32f9e06c6c","fc44e6a5f7654430af1227838224dceb",22891963,1,2,0,290,109,111,2
"fc44e6a5f7654430af1227838224dceb","fc44e6a5f7654430af1227838224dceb",22891963,2,0,1,291,111,111,0
"fc44e6a5f7654430af1227838224dceb","08111f75e22d409998cf8b85bd431f0a",22891963,1,-3,0,293,111,108,-3
"a9ae0a3c070d455bb4369a8996313336","a9ae0a3c070d455bb4369a8996313336",22891963,11,0,1,295,114,114,0
"a9ae0a3c070d455bb4369a8996313336","4280927ec4d643238aa49c32f9e06c6c",22891963,1,-6,0,306,114,109,-5
"4280927ec4d643238aa49c32f9e06c6c","37319e88176d4aefa91d7a9980dbae91",22891963,1,4,0,307,109,112,3
"37319e88176d4aefa91d7a9980dbae91","a9ae0a3c070d455bb4369a8996313336",22891963,1,2,0,308,112,114,2
"a9ae0a3c070d455bb4369a8996313336","08111f75e22d409998cf8b85bd431f0a",22891963,1,-7,0,309,114,108,-6
"08111f75e22d409998cf8b85bd431f0a","71cec822bcff4f30a20e75dc63ef7b65",22891963,1,9,0,310,108,116,8
"71cec822bcff4f30a20e75dc63ef7b65","71cec822bcff4f30a20e75dc63ef7b65",22891963,1,0,1,311,116,116,0
"71cec822bcff4f30a20e75dc63ef7b65","62bff51286ef4f348717a3cf6fe2318f",22891963,1,5,0,312,116,120,4
"37319e88176d4aefa91d7a9980dbae91","b1cd0e7dc3ad4a8eb91a4bfdbeb025b0",22891963,1,7,0,314,112,118,6
"b1cd0e7dc3ad4a8eb91a4bfdbeb025b0","b1cd0e7dc3ad4a8eb91a4bfdbeb025b0",22891963,1,0,1,315,118,118,0
"b1cd0e7dc3ad4a8eb91a4bfdbeb025b0","62bff51286ef4f348717a3cf6fe2318f",22891963,1,2,0,316,118,120,2
"62bff51286ef4f348717a3cf6fe2318f","779f9ddd1fd14d1e9e69f72219a1fdbd",22891963,1,3,0,320,120,121,1
"779f9ddd1fd14d1e9e69f72219a1fdbd","e20db35ced8544ddac5bc3839145e463",22891963,1,-36,0,321,121,91,-30
"e20db35ced8544ddac5bc3839145e463","ae26e6cda8ad4a3f81bd347560d9579f",22891963,1,40,0,322,91,125,34
"ae26e6cda8ad4a3f81bd347560d9579f","ae26e6cda8ad4a3f81bd347560d9579f",22891963,3,0,1,323,125,125,0
"ae26e6cda8ad4a3f81bd347560d9579f","ee48df95832b4374aa273ceb27ec1315",22891963,1,1,0,326,125,126,1
"ee48df95832b4374aa273ceb27ec1315","ee48df95832b4374aa273ceb27ec1315",22891963,1,0,1,327,126,126,0
"ee48df95832b4374aa273ceb27ec1315","7a439da90b394756ad1777fc4c6dead5",22891963,1,1,0,328,126,127,1
"7a439da90b394756ad1777fc4c6dead5","7a439da90b394756ad1777fc4c6dead5",22891963,1,0,1,329,127,127,0
"7a439da90b394756ad1777fc4c6dead5","a8dd5213034441ac92724b4e83eb0bb2",22891963,1,3,0,330,127,129,2
"a8dd5213034441ac92724b4e83eb0bb2","779f9ddd1fd14d1e9e69f72219a1fdbd",22891963,1,-9,0,331,129,121,-8
"779f9ddd1fd14d1e9e69f72219a1fdbd","c2e1c2b9eac64109b343a088584b576b",22891963,1,13,0,332,121,133,12
"c2e1c2b9eac64109b343a088584b576b","c2e1c2b9eac64109b343a088584b576b",22891963,2,0,1,333,133,133,0
"c2e1c2b9eac64109b343a088584b576b","ec34b06efd844b46a4c4818ecdb9b8f4",22891963,1,-1,0,335,133,132,-1
"ec34b06efd844b46a4c4818ecdb9b8f4","ec34b06efd844b46a4c4818ecdb9b8f4",22891963,5,0,1,336,132,132,0
"ec34b06efd844b46a4c4818ecdb9b8f4","8115eab6556b45f5b415c3b8c26a12e5",22891963,1,-1,0,341,132,131,-1
"8115eab6556b45f5b415c3b8c26a12e5","8115eab6556b45f5b415c3b8c26a12e5",22891963,2,0,1,342,131,131,0
"8115eab6556b45f5b415c3b8c26a12e5","a8dd5213034441ac92724b4e83eb0bb2",22891963,1,-2,0,344,131,129,-2
"a8dd5213034441ac92724b4e83eb0bb2","579338175e0b4bbb8ef3b712b5d8b54e",22891963,1,-1,0,345,129,128,-1
"579338175e0b4bbb8ef3b712b5d8b54e","8bc5795d6a984a3eace4e2811e52dd4f",22891963,1,8,0,346,128,135,7
"8bc5795d6a984a3eace4e2811e52dd4f","8bc5795d6a984a3eace4e2811e52dd4f",22891963,1,0,1,347,135,135,0
"8bc5795d6a984a3eace4e2811e52dd4f","b416d47c56a742199b5d7c7f19d6503a",22891963,1,-1,0,348,135,134,-1
"b416d47c56a742199b5d7c7f19d6503a","cd4532ad48034873ba8bce2aac0c9808",22891963,1,4,0,349,134,137,3
"cd4532ad48034873ba8bce2aac0c9808","cd4532ad48034873ba8bce2aac0c9808",22891963,1,0,1,350,137,137,0
"cd4532ad48034873ba8bce2aac0c9808","779f9ddd1fd14d1e9e69f72219a1fdbd",22891963,1,-19,0,351,137,121,-16
"779f9ddd1fd14d1e9e69f72219a1fdbd","df1de691dafe4549a18a4398ee9dfaf9",22891963,1,23,0,352,121,139,18
"df1de691dafe4549a18a4398ee9dfaf9","6c5ad271a44743479bfaea29b1db8d02",22891963,2,4,0,353,139,143,4
"6c5ad271a44743479bfaea29b1db8d02","e9312892f6234d46afcb2e1369d2d4ed",22891963,1,-3,0,354,143,140,-3
"e9312892f6234d46afcb2e1369d2d4ed","e9312892f6234d46afcb2e1369d2d4ed",22891963,1,0,1,355,140,140,0
"e9312892f6234d46afcb2e1369d2d4ed","df1de691dafe4549a18a4398ee9dfaf9",22891963,1,-1,0,356,140,139,-1
"6c5ad271a44743479bfaea29b1db8d02","83d311bed5374fee83d8d67a7d9d82dc",22891963,1,1,0,358,143,144,1
"83d311bed5374fee83d8d67a7d9d82dc","83d311bed5374fee83d8d67a7d9d82dc",22891963,1,0,1,359,144,144,0
"83d311bed5374fee83d8d67a7d9d82dc","402bba41861d43acb52a5abb89e8831e",22891963,1,1,0,360,144,145,1
"402bba41861d43acb52a5abb89e8831e","402bba41861d43acb52a5abb89e8831e",22891963,2,0,1,361,145,145,0
"402bba41861d43acb52a5abb89e8831e","6c5ad271a44743479bfaea29b1db8d02",22891963,1,-2,0,363,145,143,-2
"6c5ad271a44743479bfaea29b1db8d02","8aae34f5ddbb4052a709b12e6b0d40fa",22891963,1,5,0,364,143,147,4
"8aae34f5ddbb4052a709b12e6b0d40fa","df1de691dafe4549a18a4398ee9dfaf9",22891963,1,-9,0,365,147,139,-8
"df1de691dafe4549a18a4398ee9dfaf9","645b3f0249f64f76af2e19eb4d0e55b7",22891963,1,11,0,366,139,149,10
"645b3f0249f64f76af2e19eb4d0e55b7","645b3f0249f64f76af2e19eb4d0e55b7",22891963,2,0,1,367,149,149,0
"645b3f0249f64f76af2e19eb4d0e55b7","7e7b8db5064d4369805ab370aac5ddfb",22891963,1,1,0,369,149,150,1
"7e7b8db5064d4369805ab370aac5ddfb","7e7b8db5064d4369805ab370aac5ddfb",22891963,5,0,1,370,150,150,0
"7e7b8db5064d4369805ab370aac5ddfb","8956d210ae7f41968fada86d4c979d6a",22891963,1,1,0,375,150,151,1
"8956d210ae7f41968fada86d4c979d6a","8956d210ae7f41968fada86d4c979d6a",22891963,2,0,1,376,151,151,0
"8956d210ae7f41968fada86d4c979d6a","8aae34f5ddbb4052a709b12e6b0d40fa",22891963,1,-4,0,378,151,147,-4
"8aae34f5ddbb4052a709b12e6b0d40fa","f902b0f41b544d4dbf79664fd233648d",22891963,1,-1,0,379,147,146,-1
"f902b0f41b544d4dbf79664fd233648d","ae781e8b775e4ccd93bc800dad5c8376",22891963,1,8,0,380,146,153,7
"ae781e8b775e4ccd93bc800dad5c8376","ae781e8b775e4ccd93bc800dad5c8376",22891963,5,0,1,381,153,153,0
"ae781e8b775e4ccd93bc800dad5c8376","06882a8492d9499aa31555567f575ecb",22891963,1,1,0,386,153,154,1
"06882a8492d9499aa31555567f575ecb","06882a8492d9499aa31555567f575ecb",22891963,1,0,1,387,154,154,0
"06882a8492d9499aa31555567f575ecb","f293c508f409466a8f27ddd7d1e40b20",22891963,1,1,0,388,154,155,1
"f293c508f409466a8f27ddd7d1e40b20","f293c508f409466a8f27ddd7d1e40b20",22891963,2,0,1,389,155,155,0
"f293c508f409466a8f27ddd7d1e40b20","cc4ddef5bbbe48ebb605141b347c4ed1",22891963,1,1,0,391,155,156,1
"cc4ddef5bbbe48ebb605141b347c4ed1","cc4ddef5bbbe48ebb605141b347c4ed1",22891963,1,0,1,392,156,156,0
"cc4ddef5bbbe48ebb605141b347c4ed1","f03480cf4eba413194d7af52fc0e7f28",22891963,1,-4,0,393,156,152,-4
"f03480cf4eba413194d7af52fc0e7f28","d313cec988a84645bee413e8d4724a4b",22891963,1,7,0,394,152,158,6
"d313cec988a84645bee413e8d4724a4b","d313cec988a84645bee413e8d4724a4b",22891963,4,0,1,395,158,158,0
"d313cec988a84645bee413e8d4724a4b","dc60696c76a74368a60f72246e47700d",22891963,1,1,0,399,158,159,1
"dc60696c76a74368a60f72246e47700d","dc60696c76a74368a60f72246e47700d",22891963,1,0,1,400,159,159,0
"dc60696c76a74368a60f72246e47700d","78adeee1fa2c4fe0bc73f7bca9fcee86",22891963,1,3,0,401,159,160,1
"78adeee1fa2c4fe0bc73f7bca9fcee86","df1de691dafe4549a18a4398ee9dfaf9",22891963,1,-26,0,402,160,139,-21
"df1de691dafe4549a18a4398ee9dfaf9","78adeee1fa2c4fe0bc73f7bca9fcee86",22891963,1,26,0,403,139,160,21
"78adeee1fa2c4fe0bc73f7bca9fcee86","65202579580f4ad38d734b4ee39d22a8",22891963,4,5,0,404,160,164,4
"65202579580f4ad38d734b4ee39d22a8","65202579580f4ad38d734b4ee39d22a8",22891963,74,0,1,405,164,164,0
"65202579580f4ad38d734b4ee39d22a8","8959e6304a0348309a771e4d08d1b64a",22891963,1,-1,0,412,164,163,-1
"8959e6304a0348309a771e4d08d1b64a","65202579580f4ad38d734b4ee39d22a8",22891963,1,1,0,413,163,164,1
"65202579580f4ad38d734b4ee39d22a8","78adeee1fa2c4fe0bc73f7bca9fcee86",22891963,2,-5,0,421,164,160,-4
"78adeee1fa2c4fe0bc73f7bca9fcee86","3cbcea2be0984e7dbd5a48195af10ce7",22891963,1,8,0,468,160,165,5
"3cbcea2be0984e7dbd5a48195af10ce7","82e6285962b8400d9d6fc32436022a94",22891963,2,2,0,469,165,167,2
"82e6285962b8400d9d6fc32436022a94","78adeee1fa2c4fe0bc73f7bca9fcee86",22891963,1,-10,0,470,167,160,-7
"65202579580f4ad38d734b4ee39d22a8","3cbcea2be0984e7dbd5a48195af10ce7",22891963,1,3,0,479,164,165,1
"82e6285962b8400d9d6fc32436022a94","a9ac840f098c4bd0a2ee896214ce29cd",22891963,1,3,0,481,167,168,1
"a9ac840f098c4bd0a2ee896214ce29cd","a9ac840f098c4bd0a2ee896214ce29cd",22891963,1,0,1,482,168,168,0
"a9ac840f098c4bd0a2ee896214ce29cd","0c7262dff33c4087bc660ccf40f92f9c",22891963,1,4,0,483,168,169,1
"0c7262dff33c4087bc660ccf40f92f9c","b2275c3fad834f8d90737a2d9a6927d6",22891963,2,3,0,484,169,172,3
"b2275c3fad834f8d90737a2d9a6927d6","a9ac840f098c4bd0a2ee896214ce29cd",22891963,1,-7,0,485,172,168,-4
"a9ac840f098c4bd0a2ee896214ce29cd","78adeee1fa2c4fe0bc73f7bca9fcee86",22891963,1,-13,0,486,168,160,-8
"65202579580f4ad38d734b4ee39d22a8","0c7262dff33c4087bc660ccf40f92f9c",22891963,1,12,0,497,164,169,5
"b2275c3fad834f8d90737a2d9a6927d6","b2275c3fad834f8d90737a2d9a6927d6",22891963,29,0,1,499,172,172,0
"b2275c3fad834f8d90737a2d9a6927d6","eb515a26030b41f8a82a1e6114420bad",22891963,1,1,0,528,172,173,1
"eb515a26030b41f8a82a1e6114420bad","eb515a26030b41f8a82a1e6114420bad",22891963,2,0,1,529,173,173,0
"eb515a26030b41f8a82a1e6114420bad","b42cc17b7de840f181a704558d0bc845",22891963,1,3,0,531,173,175,2
"b42cc17b7de840f181a704558d0bc845","0c7262dff33c4087bc660ccf40f92f9c",22891963,1,-7,0,532,175,169,-6
"0c7262dff33c4087bc660ccf40f92f9c","b42cc17b7de840f181a704558d0bc845",22891963,1,7,0,533,169,175,6
"b42cc17b7de840f181a704558d0bc845","801f9e9135034f49bf5f8b4bdefedb41",22891963,1,2,0,534,175,177,2
"801f9e9135034f49bf5f8b4bdefedb41","801f9e9135034f49bf5f8b4bdefedb41",22891963,2,0,1,535,177,177,0
"801f9e9135034f49bf5f8b4bdefedb41","ea38cc0e6e6e41edbabf210220808bf9",22891963,1,3,0,537,177,179,2
"ea38cc0e6e6e41edbabf210220808bf9","362fcb0699a14845ab29b2340093e528",22891963,1,-6,0,538,179,174,-5
"362fcb0699a14845ab29b2340093e528","b87c552dd247427abe6ab5795b9c9d43",22891963,1,8,0,539,174,181,7
"b87c552dd247427abe6ab5795b9c9d43","b87c552dd247427abe6ab5795b9c9d43",22891963,7,0,1,542,181,181,0
"b87c552dd247427abe6ab5795b9c9d43","139b097acfca451689d80c9c6eebdf7b",22891963,1,-3,0,549,181,178,-3
"139b097acfca451689d80c9c6eebdf7b","30f660a1feb34582a739722532524f79",22891963,1,6,0,550,178,183,5
"30f660a1feb34582a739722532524f79","30f660a1feb34582a739722532524f79",22891963,7,0,1,551,183,183,0
"30f660a1feb34582a739722532524f79","2024b4885bd14338a39b7b509acbbd02",22891963,1,-1,0,558,183,182,-1
"2024b4885bd14338a39b7b509acbbd02","c3f63fe50d8e487c86bf8ef76c9cadd3",22891963,1,4,0,559,182,185,3
"c3f63fe50d8e487c86bf8ef76c9cadd3","c3f63fe50d8e487c86bf8ef76c9cadd3",22891963,1,0,1,560,185,185,0
"c3f63fe50d8e487c86bf8ef76c9cadd3","c8e371568a0c4391b25796ae4e91952e",22891963,1,3,0,561,185,186,1
"c8e371568a0c4391b25796ae4e91952e","0c7262dff33c4087bc660ccf40f92f9c",22891963,1,-23,0,562,186,169,-17
"0c7262dff33c4087bc660ccf40f92f9c","7d932b23e1c84326ae5aa4d3c0d813d1",22891963,1,25,0,563,169,188,19
"7d932b23e1c84326ae5aa4d3c0d813d1","7d932b23e1c84326ae5aa4d3c0d813d1",22891963,1,0,1,564,188,188,0
"7d932b23e1c84326ae5aa4d3c0d813d1","c8e371568a0c4391b25796ae4e91952e",22891963,1,-2,0,565,188,186,-2
"c8e371568a0c4391b25796ae4e91952e","ab11d94c6c8948ea90b88f19d2cd502b",22891963,2,5,0,566,186,190,4
"ab11d94c6c8948ea90b88f19d2cd502b","07b44a7a51e94c78b411c753fc39dab0",22891963,1,-1,0,567,190,189,-1
"07b44a7a51e94c78b411c753fc39dab0","c8e371568a0c4391b25796ae4e91952e",22891963,1,-4,0,568,189,186,-3
"ab11d94c6c8948ea90b88f19d2cd502b","f992451ed6ad4e68bb9e68ad6be7c4be",22891963,1,2,0,570,190,192,2
"f992451ed6ad4e68bb9e68ad6be7c4be","f992451ed6ad4e68bb9e68ad6be7c4be",22891963,1,0,1,571,192,192,0
"f992451ed6ad4e68bb9e68ad6be7c4be","ab11d94c6c8948ea90b88f19d2cd502b",22891963,1,-2,0,572,192,190,-2
"ab11d94c6c8948ea90b88f19d2cd502b","6cd2dcaac46847d4a0bc53f296d90375",22891963,1,5,0,573,190,194,4
"6cd2dcaac46847d4a0bc53f296d90375","07b44a7a51e94c78b411c753fc39dab0",22891963,1,-6,0,574,194,189,-5
"07b44a7a51e94c78b411c753fc39dab0","2d2580c9411c4972909db508d6956a58",22891963,1,8,0,575,189,196,7
"2d2580c9411c4972909db508d6956a58","2d2580c9411c4972909db508d6956a58",22891963,2,0,1,576,196,196,0
"2d2580c9411c4972909db508d6956a58","5bddb3d9ed264f3984702f048c7e5340",22891963,1,1,0,578,196,197,1
"5bddb3d9ed264f3984702f048c7e5340","5bddb3d9ed264f3984702f048c7e5340",22891963,2,0,1,579,197,197,0
"5bddb3d9ed264f3984702f048c7e5340","d5e8e2bd12a2466b9d6d90855f0eb079",22891963,1,1,0,581,197,198,1
"d5e8e2bd12a2466b9d6d90855f0eb079","d5e8e2bd12a2466b9d6d90855f0eb079",22891963,2,0,1,582,198,198,0
"d5e8e2bd12a2466b9d6d90855f0eb079","6cd2dcaac46847d4a0bc53f296d90375",22891963,1,-4,0,584,198,194,-4
"6cd2dcaac46847d4a0bc53f296d90375","017d7ca8e0394b91aaadc9574df2202c",22891963,1,-1,0,585,194,193,-1
"017d7ca8e0394b91aaadc9574df2202c","54e8e9f0ea3e45c4bf3b8ac799ee31b1",22891963,1,8,0,586,193,200,7
"54e8e9f0ea3e45c4bf3b8ac799ee31b1","54e8e9f0ea3e45c4bf3b8ac799ee31b1",22891963,1,0,1,587,200,200,0
"54e8e9f0ea3e45c4bf3b8ac799ee31b1","c614a00911be4877a075f19315530fb0",22891963,1,1,0,588,200,201,1
"c614a00911be4877a075f19315530fb0","c614a00911be4877a075f19315530fb0",22891963,6,0,1,589,201,201,0
"c614a00911be4877a075f19315530fb0","a6c21bd8b95249c7972820a7a7d76aff",22891963,1,1,0,595,201,202,1
"a6c21bd8b95249c7972820a7a7d76aff","a6c21bd8b95249c7972820a7a7d76aff",22891963,1,0,1,596,202,202,0
"a6c21bd8b95249c7972820a7a7d76aff","bb329d880ab54120adaf203a693bb203",22891963,1,1,0,597,202,203,1
"bb329d880ab54120adaf203a693bb203","bb329d880ab54120adaf203a693bb203",22891963,1,0,1,598,203,203,0
"bb329d880ab54120adaf203a693bb203","f9170dd6bc6442b4acd832747609b09a",22891963,1,-4,0,599,203,199,-4
"f9170dd6bc6442b4acd832747609b09a","6cd2dcaac46847d4a0bc53f296d90375",22891963,1,-6,0,600,199,194,-5
"6cd2dcaac46847d4a0bc53f296d90375","b54257a550b94ebc9538f3a90eee9d7e",22891963,1,12,0,601,194,204,10
"b54257a550b94ebc9538f3a90eee9d7e","017d7ca8e0394b91aaadc9574df2202c",22891963,1,-13,0,602,204,193,-11
"017d7ca8e0394b91aaadc9574df2202c","f9170dd6bc6442b4acd832747609b09a",22891963,1,7,0,603,193,199,6
"f9170dd6bc6442b4acd832747609b09a","334c2344009840079b1d0e1b7ce3d5a7",22891963,1,7,0,604,199,205,6
"334c2344009840079b1d0e1b7ce3d5a7","334c2344009840079b1d0e1b7ce3d5a7",22891963,1,0,1,605,205,205,0
"334c2344009840079b1d0e1b7ce3d5a7","d7f13c8d63ec4e2aa673fbb9cf9c6933",22891963,1,3,0,606,205,206,1
"d7f13c8d63ec4e2aa673fbb9cf9c6933","c8e371568a0c4391b25796ae4e91952e",22891963,1,-26,0,607,206,186,-20
"c8e371568a0c4391b25796ae4e91952e","b9e80f77c3a44349863b19875725c384",22891963,1,27,0,608,186,207,21
"b9e80f77c3a44349863b19875725c384","7108f0e4c2584f1f9c471689ae4c885c",22891963,2,1,0,609,207,208,1
"7108f0e4c2584f1f9c471689ae4c885c","b9e80f77c3a44349863b19875725c384",22891963,1,-1,0,610,208,207,-1
"b9e80f77c3a44349863b19875725c384","b9e80f77c3a44349863b19875725c384",22891963,16,0,1,611,207,207,0
"7108f0e4c2584f1f9c471689ae4c885c","7108f0e4c2584f1f9c471689ae4c885c",22891963,10,0,1,628,208,208,0
"7108f0e4c2584f1f9c471689ae4c885c","09400e101c5d4b439cf9a26b03aae558",22891963,1,3,0,638,208,210,2
"09400e101c5d4b439cf9a26b03aae558","d7f13c8d63ec4e2aa673fbb9cf9c6933",22891963,1,-5,0,639,210,206,-4
"d7f13c8d63ec4e2aa673fbb9cf9c6933","09400e101c5d4b439cf9a26b03aae558",22891963,1,5,0,640,206,210,4
"09400e101c5d4b439cf9a26b03aae558","a88efa7e50ce47159810ab553afa6d3a",22891963,1,2,0,641,210,212,2
"a88efa7e50ce47159810ab553afa6d3a","a88efa7e50ce47159810ab553afa6d3a",22891963,2,0,1,642,212,212,0
"a88efa7e50ce47159810ab553afa6d3a","f7fb1952f56b4189b86a9f8b7862d2b8",22891963,1,4,0,644,212,215,3
"f7fb1952f56b4189b86a9f8b7862d2b8","be502a7a43c44bf7b682698de79d9369",22891963,1,-1,0,645,215,214,-1
"be502a7a43c44bf7b682698de79d9369","a875096404ef4a9984b62d74cda916f9",22891963,1,-6,0,646,214,209,-5
"a875096404ef4a9984b62d74cda916f9","be502a7a43c44bf7b682698de79d9369",22891963,1,6,0,647,209,214,5
"be502a7a43c44bf7b682698de79d9369","f7fb1952f56b4189b86a9f8b7862d2b8",22891963,1,1,0,648,214,215,1
"f7fb1952f56b4189b86a9f8b7862d2b8","f7fb1952f56b4189b86a9f8b7862d2b8",22891963,17,0,1,649,215,215,0
"f7fb1952f56b4189b86a9f8b7862d2b8","b860ee85d8bc4a2f97958cfb71be3533",22891963,1,1,0,666,215,216,1
"b860ee85d8bc4a2f97958cfb71be3533","b860ee85d8bc4a2f97958cfb71be3533",22891963,2,0,1,667,216,216,0
"b860ee85d8bc4a2f97958cfb71be3533","ec341f459285443b8361f7f15638ff08",22891963,1,-3,0,669,216,213,-3
"ec341f459285443b8361f7f15638ff08","363837c182e04711840d896ae1e0339c",22891963,1,6,0,670,213,218,5
"363837c182e04711840d896ae1e0339c","363837c182e04711840d896ae1e0339c",22891963,15,0,1,671,218,218,0
"363837c182e04711840d896ae1e0339c","01b2051f8941460d89945e3b02d1ce78",22891963,1,-1,0,686,218,217,-1
"01b2051f8941460d89945e3b02d1ce78","91125ca626c5470eb145501f8c37f8db",22891963,1,4,0,687,217,220,3
"91125ca626c5470eb145501f8c37f8db","91125ca626c5470eb145501f8c37f8db",22891963,1,0,1,688,220,220,0
"91125ca626c5470eb145501f8c37f8db","d7f13c8d63ec4e2aa673fbb9cf9c6933",22891963,1,-18,0,689,220,206,-14
"d7f13c8d63ec4e2aa673fbb9cf9c6933","1c6721b1f63f4d30ba7746ea8af02a52",22891963,1,21,0,690,206,221,15
"1c6721b1f63f4d30ba7746ea8af02a52","77ecef8eff6b4a2caea7707669bf7475",22891963,1,1,0,691,221,222,1
"77ecef8eff6b4a2caea7707669bf7475","77ecef8eff6b4a2caea7707669bf7475",22891963,12,0,1,692,222,222,0
"77ecef8eff6b4a2caea7707669bf7475","8b9ae98743bd4d4a8a87dff1c1244211",22891963,1,6,0,704,222,227,5
"8b9ae98743bd4d4a8a87dff1c1244211","1c6721b1f63f4d30ba7746ea8af02a52",22891963,1,-7,0,705,227,221,-6
"1c6721b1f63f4d30ba7746ea8af02a52","d03cb855c70044cf8c35d9ec0de696e3",22891963,1,4,0,706,221,224,3
"d03cb855c70044cf8c35d9ec0de696e3","d03cb855c70044cf8c35d9ec0de696e3",22891963,1,0,1,707,224,224,0
"d03cb855c70044cf8c35d9ec0de696e3","a49a937d6896486d9a5396654abcf2e1",22891963,1,2,0,708,224,226,2
"a49a937d6896486d9a5396654abcf2e1","a49a937d6896486d9a5396654abcf2e1",22891963,1,0,1,709,226,226,0
"a49a937d6896486d9a5396654abcf2e1","8b9ae98743bd4d4a8a87dff1c1244211",22891963,1,1,0,710,226,227,1
"8b9ae98743bd4d4a8a87dff1c1244211","8b9ae98743bd4d4a8a87dff1c1244211",22891963,19,0,1,711,227,227,0
"8b9ae98743bd4d4a8a87dff1c1244211","f7906d6f59b9489a91d2ef40db5a474d",22891963,1,-4,0,730,227,223,-4
"f7906d6f59b9489a91d2ef40db5a474d","2ab1535aac1346ba8801535bf729ef37",22891963,1,7,0,731,223,229,6
"2ab1535aac1346ba8801535bf729ef37","2ab1535aac1346ba8801535bf729ef37",22891963,1,0,1,732,229,229,0
"2ab1535aac1346ba8801535bf729ef37","a4f40fb48a8542c8949bae1f002cd9bc",22891963,1,2,0,733,229,231,2
"a4f40fb48a8542c8949bae1f002cd9bc","a4f40fb48a8542c8949bae1f002cd9bc",22891963,2,0,1,734,231,231,0
"a4f40fb48a8542c8949bae1f002cd9bc","8972c23e32044edb8a78fa1eed4e5947",22891963,1,1,0,736,231,232,1
"8972c23e32044edb8a78fa1eed4e5947","8972c23e32044edb8a78fa1eed4e5947",22891963,1,0,1,737,232,232,0
"8972c23e32044edb8a78fa1eed4e5947","92feb4a40f8344d38b6f722e42a53295",22891963,1,1,0,738,232,233,1
"92feb4a40f8344d38b6f722e42a53295","92feb4a40f8344d38b6f722e42a53295",22891963,2,0,1,739,233,233,0
"92feb4a40f8344d38b6f722e42a53295","5152833676bf4c6cb317060be10f68db",22891963,1,-5,0,741,233,228,-5
"5152833676bf4c6cb317060be10f68db","ca3e28f290354c08aefe5b0f769604e6",22891963,1,8,0,742,228,235,7
"ca3e28f290354c08aefe5b0f769604e6","ca3e28f290354c08aefe5b0f769604e6",22891963,4,0,1,743,235,235,0
"ca3e28f290354c08aefe5b0f769604e6","79a35eea833e4c2c9d22fc53c3c6445c",22891963,1,1,0,747,235,236,1
"79a35eea833e4c2c9d22fc53c3c6445c","79a35eea833e4c2c9d22fc53c3c6445c",22891963,9,0,1,748,236,236,0
"79a35eea833e4c2c9d22fc53c3c6445c","8f68228b1518449e9615cdafee41a2bd",22891963,1,1,0,757,236,237,1
"8f68228b1518449e9615cdafee41a2bd","8f68228b1518449e9615cdafee41a2bd",22891963,1,0,1,758,237,237,0
"8f68228b1518449e9615cdafee41a2bd","cab89fa5c3ed45a5aa550fc0352d6a42",22891963,1,1,0,759,237,238,1
"cab89fa5c3ed45a5aa550fc0352d6a42","cab89fa5c3ed45a5aa550fc0352d6a42",22891963,1,0,1,760,238,238,0
"cab89fa5c3ed45a5aa550fc0352d6a42","66d4fad4f1cf4b46be0750a99ad7a35a",22891963,1,1,0,761,238,239,1
"66d4fad4f1cf4b46be0750a99ad7a35a","66d4fad4f1cf4b46be0750a99ad7a35a",22891963,1,0,1,762,239,239,0
"66d4fad4f1cf4b46be0750a99ad7a35a","0b04c8e2f86d48c7aeb7e225819cd32b",22891963,1,-5,0,763,239,234,-5
"0b04c8e2f86d48c7aeb7e225819cd32b","f53da5fd9bfe412da4b80d4742563b6c",22891963,1,8,0,764,234,241,7
"f53da5fd9bfe412da4b80d4742563b6c","f53da5fd9bfe412da4b80d4742563b6c",22891963,1,0,1,765,241,241,0
"f53da5fd9bfe412da4b80d4742563b6c","1c6721b1f63f4d30ba7746ea8af02a52",22891963,1,-24,0,766,241,221,-20
"1c6721b1f63f4d30ba7746ea8af02a52","2ae94c0cea4d480a9d5dca8fb1d7b542",22891963,1,27,0,767,221,242,21
"2ae94c0cea4d480a9d5dca8fb1d7b542","1ebf23f9d994469a85206e4c7b1bf5f5",22891963,2,3,0,768,242,245,3
"1ebf23f9d994469a85206e4c7b1bf5f5","2ae94c0cea4d480a9d5dca8fb1d7b542",22891963,1,-3,0,769,245,242,-3
"2ae94c0cea4d480a9d5dca8fb1d7b542","2ae94c0cea4d480a9d5dca8fb1d7b542",22891963,1,0,1,770,242,242,0
"1ebf23f9d994469a85206e4c7b1bf5f5","1ebf23f9d994469a85206e4c7b1bf5f5",22891963,10,0,1,772,245,245,0
"1ebf23f9d994469a85206e4c7b1bf5f5","85ae675b83e8422da842cfd25596af99",22891963,1,1,0,782,245,246,1
"85ae675b83e8422da842cfd25596af99","85ae675b83e8422da842cfd25596af99",22891963,1,0,1,783,246,246,0
"85ae675b83e8422da842cfd25596af99","fa235f0f364d47e4ae1c87f47bf8e6ba",22891963,1,8,0,784,246,252,6
"fa235f0f364d47e4ae1c87f47bf8e6ba","2ae94c0cea4d480a9d5dca8fb1d7b542",22891963,1,-12,0,785,252,242,-10
"2ae94c0cea4d480a9d5dca8fb1d7b542","fa235f0f364d47e4ae1c87f47bf8e6ba",22891963,1,12,0,786,242,252,10
"fa235f0f364d47e4ae1c87f47bf8e6ba","79f7845465cc4ed19d8e4f1429541be0",22891963,1,2,0,787,252,254,2
"79f7845465cc4ed19d8e4f1429541be0","79f7845465cc4ed19d8e4f1429541be0",22891963,2,0,1,788,254,254,0
"79f7845465cc4ed19d8e4f1429541be0","00f61990949545828dd12f1303d47504",22891963,1,3,0,790,254,256,2
"00f61990949545828dd12f1303d47504","6e83e23f56544a19b94067c1c558d9c0",22891963,1,-11,0,791,256,247,-9
"6e83e23f56544a19b94067c1c558d9c0","ead7bb4b64e247d2ae632ab8a296b091",22891963,1,13,0,792,247,258,11
"ead7bb4b64e247d2ae632ab8a296b091","ead7bb4b64e247d2ae632ab8a296b091",22891963,2,0,1,793,258,258,0
"ead7bb4b64e247d2ae632ab8a296b091","41b0048dde734bb280bac6116baa8e27",22891963,1,1,0,795,258,259,1
"41b0048dde734bb280bac6116baa8e27","41b0048dde734bb280bac6116baa8e27",22891963,2,0,1,796,259,259,0
"41b0048dde734bb280bac6116baa8e27","b41c5a094a604ee0915327da5cc0beb7",22891963,1,1,0,798,259,260,1
"b41c5a094a604ee0915327da5cc0beb7","b41c5a094a604ee0915327da5cc0beb7",22891963,5,0,1,799,260,260,0
"b41c5a094a604ee0915327da5cc0beb7","00f61990949545828dd12f1303d47504",22891963,1,-4,0,804,260,256,-4
"00f61990949545828dd12f1303d47504","d546341988904f069cfa86b21457d9d9",22891963,1,-6,0,805,256,251,-5
"d546341988904f069cfa86b21457d9d9","28c171777c52431ab6b925073bd63d46",22891963,1,15,0,806,251,264,13
"28c171777c52431ab6b925073bd63d46","28c171777c52431ab6b925073bd63d46",22891963,3,0,1,807,264,264,0
"28c171777c52431ab6b925073bd63d46","ac160db940cb49ae8579162b1d52bb5d",22891963,1,2,0,810,264,266,2
"ac160db940cb49ae8579162b1d52bb5d","ac160db940cb49ae8579162b1d52bb5d",22891963,3,0,1,811,266,266,0
"ac160db940cb49ae8579162b1d52bb5d","d989ebcfc12a4b669f0100dc1aa14f1e",22891963,1,-12,0,814,266,255,-11
"d989ebcfc12a4b669f0100dc1aa14f1e","c6fd49b485cc4874b0bbdd9c6171e09c",22891963,1,15,0,815,255,268,13
"c6fd49b485cc4874b0bbdd9c6171e09c","c6fd49b485cc4874b0bbdd9c6171e09c",22891963,7,0,1,816,268,268,0
"c6fd49b485cc4874b0bbdd9c6171e09c","44240778a97c4af0937817499b75707b",22891963,1,1,0,823,268,269,1
"44240778a97c4af0937817499b75707b","44240778a97c4af0937817499b75707b",22891963,2,0,1,824,269,269,0
"44240778a97c4af0937817499b75707b","7aa76d3e993840d8805f097cbdbcd44b",22891963,1,-9,0,826,269,261,-8
"7aa76d3e993840d8805f097cbdbcd44b","865a4d3b43374da7944dc7d397f566d9",22891963,1,12,0,827,261,271,10
"865a4d3b43374da7944dc7d397f566d9","865a4d3b43374da7944dc7d397f566d9",22891963,1,0,1,828,271,271,0
"865a4d3b43374da7944dc7d397f566d9","0d987bed3ffa4ed0b9a2e62e97b7b30f",22891963,1,3,0,829,271,272,1
"0d987bed3ffa4ed0b9a2e62e97b7b30f","2ae94c0cea4d480a9d5dca8fb1d7b542",22891963,1,-38,0,830,272,242,-30
"2ae94c0cea4d480a9d5dca8fb1d7b542","0d987bed3ffa4ed0b9a2e62e97b7b30f",22891963,1,38,0,831,242,272,30
"0d987bed3ffa4ed0b9a2e62e97b7b30f","bb5a47f5ea01454a8b79455422d3b9da",22891963,2,10,0,832,272,280,8
"bb5a47f5ea01454a8b79455422d3b9da","bb5a47f5ea01454a8b79455422d3b9da",22891963,65,0,1,833,280,280,0
"bb5a47f5ea01454a8b79455422d3b9da","82ae07bc0c9b4570a41799290d1ef399",22891963,1,-6,0,838,280,275,-5
"82ae07bc0c9b4570a41799290d1ef399","bb5a47f5ea01454a8b79455422d3b9da",22891963,1,6,0,839,275,280,5
"bb5a47f5ea01454a8b79455422d3b9da","0d987bed3ffa4ed0b9a2e62e97b7b30f",22891963,1,-10,0,891,280,272,-8
"bb5a47f5ea01454a8b79455422d3b9da","94cecc3f1e7d484b8e068e79241dfd73",22891963,1,3,0,902,280,281,1
"94cecc3f1e7d484b8e068e79241dfd73","0d987bed3ffa4ed0b9a2e62e97b7b30f",22891963,1,-13,0,903,281,272,-9
"0d987bed3ffa4ed0b9a2e62e97b7b30f","a37477c4e4c14169ad44b06b493007f6",22891963,1,15,0,904,272,283,11
"a37477c4e4c14169ad44b06b493007f6","94cecc3f1e7d484b8e068e79241dfd73",22891963,1,-2,0,905,283,281,-2
"94cecc3f1e7d484b8e068e79241dfd73","fab84b4fab5940efb4ea868ef8d09396",22891963,1,5,0,906,281,284,3
"fab84b4fab5940efb4ea868ef8d09396","4a29443515bb404cb8924e1c60a63b73",22891963,1,4,0,907,284,285,1
"4a29443515bb404cb8924e1c60a63b73","fab84b4fab5940efb4ea868ef8d09396",22891963,1,-4,0,908,285,284,-1
"fab84b4fab5940efb4ea868ef8d09396","208c9b2796c944db8dacaa96082520ea",22891963,1,7,0,909,284,288,4
"208c9b2796c944db8dacaa96082520ea","4a29443515bb404cb8924e1c60a63b73",22891963,2,-3,0,910,288,285,-3
"4a29443515bb404cb8924e1c60a63b73","208c9b2796c944db8dacaa96082520ea",22891963,1,3,0,911,285,288,3
"208c9b2796c944db8dacaa96082520ea","208c9b2796c944db8dacaa96082520ea",22891963,1,0,1,912,288,288,0
"4a29443515bb404cb8924e1c60a63b73","7669a956527947d0add87455277e80b4",22891963,1,7,0,914,285,291,6
"7669a956527947d0add87455277e80b4","7669a956527947d0add87455277e80b4",22891963,1,0,1,915,291,291,0
"7669a956527947d0add87455277e80b4","6a9a3b5bde4a48daa896fe8c06eca56f",22891963,1,-2,0,916,291,289,-2
"6a9a3b5bde4a48daa896fe8c06eca56f","869e967078f04da18dd0b0b9389a7424",22891963,1,5,0,917,289,293,4
"869e967078f04da18dd0b0b9389a7424","869e967078f04da18dd0b0b9389a7424",22891963,1,0,1,918,293,293,0
"869e967078f04da18dd0b0b9389a7424","51ab6291537748fab90d519aa09889d6",22891963,1,2,0,919,293,295,2
"51ab6291537748fab90d519aa09889d6","51ab6291537748fab90d519aa09889d6",22891963,5,0,1,920,295,295,0
"51ab6291537748fab90d519aa09889d6","34a6e49023fc4465bd5ca604330bbd1c",22891963,1,-3,0,925,295,292,-3
"34a6e49023fc4465bd5ca604330bbd1c","21592f2a9e9c4b2f8c66ec5dbcbf6a2b",22891963,1,5,0,926,292,296,4
"21592f2a9e9c4b2f8c66ec5dbcbf6a2b","ba0e59461bfb4a44b7b1c28a01f8d3b3",22891963,1,4,0,927,296,299,3
"ba0e59461bfb4a44b7b1c28a01f8d3b3","ba0e59461bfb4a44b7b1c28a01f8d3b3",22891963,1,0,1,928,299,299,0
"ba0e59461bfb4a44b7b1c28a01f8d3b3","0e0b36e731a645e7b1b8a88f5031ca38",22891963,1,2,0,929,299,301,2
"0e0b36e731a645e7b1b8a88f5031ca38","0e0b36e731a645e7b1b8a88f5031ca38",22891963,2,0,1,930,301,301,0
"0e0b36e731a645e7b1b8a88f5031ca38","a66a144637284c21afc6de17fea4bfb8",22891963,1,1,0,932,301,302,1
"a66a144637284c21afc6de17fea4bfb8","a66a144637284c21afc6de17fea4bfb8",22891963,2,0,1,933,302,302,0
"a66a144637284c21afc6de17fea4bfb8","7646a919d7e64fa990bca9b024ff089d",22891963,1,-4,0,935,302,298,-4
"7646a919d7e64fa990bca9b024ff089d","e390b575229748ea8aac9364efe2bf00",22891963,1,7,0,936,298,304,6
"e390b575229748ea8aac9364efe2bf00","e390b575229748ea8aac9364efe2bf00",22891963,1,0,1,937,304,304,0
"e390b575229748ea8aac9364efe2bf00","3434c10e561d488a914e0f7d71907abd",22891963,1,3,0,938,304,305,1
"3434c10e561d488a914e0f7d71907abd","4a29443515bb404cb8924e1c60a63b73",22891963,1,-27,0,939,305,285,-20
"4a29443515bb404cb8924e1c60a63b73","53e7e900392747ccad52e711ab0f80d8",22891963,1,29,0,940,285,307,22
"53e7e900392747ccad52e711ab0f80d8","53e7e900392747ccad52e711ab0f80d8",22891963,1,0,1,941,307,307,0
"53e7e900392747ccad52e711ab0f80d8","3434c10e561d488a914e0f7d71907abd",22891963,1,-2,0,942,307,305,-2
"3434c10e561d488a914e0f7d71907abd","130acc2aeb0448fdbb2de63bc5cebe5b",22891963,1,5,0,943,305,309,4
"130acc2aeb0448fdbb2de63bc5cebe5b","130acc2aeb0448fdbb2de63bc5cebe5b",22891963,1,0,1,944,309,309,0
"130acc2aeb0448fdbb2de63bc5cebe5b","9c062b3251034ebe90f5054e2a3b5120",22891963,1,2,0,945,309,311,2
"9c062b3251034ebe90f5054e2a3b5120","9c062b3251034ebe90f5054e2a3b5120",22891963,5,0,1,946,311,311,0
"9c062b3251034ebe90f5054e2a3b5120","ea859f8207e44537889daeaba13ac2e8",22891963,1,1,0,951,311,312,1
"ea859f8207e44537889daeaba13ac2e8","ea859f8207e44537889daeaba13ac2e8",22891963,4,0,1,952,312,312,0
"ea859f8207e44537889daeaba13ac2e8","56d94971a7a94257aa330183a8ebd0ea",22891963,1,1,0,956,312,313,1
"56d94971a7a94257aa330183a8ebd0ea","56d94971a7a94257aa330183a8ebd0ea",22891963,1,0,1,957,313,313,0
"56d94971a7a94257aa330183a8ebd0ea","141c0df6cd1946539aadd1c9b7068cd4",22891963,1,-5,0,958,313,308,-5
"141c0df6cd1946539aadd1c9b7068cd4","13255e63e0aa4abf85e5211bf613d43e",22891963,1,10,0,959,308,317,9
"13255e63e0aa4abf85e5211bf613d43e","13255e63e0aa4abf85e5211bf613d43e",22891963,1,0,1,960,317,317,0
"13255e63e0aa4abf85e5211bf613d43e","0c787d16c9504873b1a4d903cec09948",22891963,1,-3,0,961,317,314,-3
"0c787d16c9504873b1a4d903cec09948","86c27d40179e419c8e9d150fb6afa5d0",22891963,1,6,0,962,314,319,5
"86c27d40179e419c8e9d150fb6afa5d0","86c27d40179e419c8e9d150fb6afa5d0",22891963,1,0,1,963,319,319,0
"86c27d40179e419c8e9d150fb6afa5d0","47edbb64109243e6b0f8f64cdef90c6c",22891963,1,8,0,964,319,326,7
"47edbb64109243e6b0f8f64cdef90c6c","24f1363179ad4aaa965484a78471912b",22891963,1,-3,0,965,326,323,-3
"24f1363179ad4aaa965484a78471912b","8d7e0b55cf9849cda222a0f2440cec55",22891963,1,-6,0,966,323,318,-5
"8d7e0b55cf9849cda222a0f2440cec55","24f1363179ad4aaa965484a78471912b",22891963,1,6,0,967,318,323,5
"24f1363179ad4aaa965484a78471912b","3628bdce1dd2429ba924d2d4d09448d2",22891963,1,-1,0,968,323,322,-1
"3628bdce1dd2429ba924d2d4d09448d2","56b3fd1a212a4764be39d979fde3326e",22891963,1,7,0,969,322,328,6
"56b3fd1a212a4764be39d979fde3326e","56b3fd1a212a4764be39d979fde3326e",22891963,1,0,1,970,328,328,0
"56b3fd1a212a4764be39d979fde3326e","0c4079457ede49e3aeb5e86ed84bdf35",22891963,1,3,0,971,328,329,1
"0c4079457ede49e3aeb5e86ed84bdf35","3434c10e561d488a914e0f7d71907abd",22891963,1,-31,0,972,329,305,-24
"3434c10e561d488a914e0f7d71907abd","38aea304b4fa46e1b29bb72f5cea4c93",22891963,1,33,0,973,305,331,26
"38aea304b4fa46e1b29bb72f5cea4c93","0c4079457ede49e3aeb5e86ed84bdf35",22891963,1,-2,0,974,331,329,-2
"0c4079457ede49e3aeb5e86ed84bdf35","38aea304b4fa46e1b29bb72f5cea4c93",22891963,1,2,0,975,329,331,2
"38aea304b4fa46e1b29bb72f5cea4c93","38aea304b4fa46e1b29bb72f5cea4c93",22891963,1,0,1,976,331,331,0
"38aea304b4fa46e1b29bb72f5cea4c93","e36d261332f14e79bb4b467aceaeb9b5",22891963,1,2,0,977,331,333,2
"e36d261332f14e79bb4b467aceaeb9b5","e36d261332f14e79bb4b467aceaeb9b5",22891963,1,0,1,978,333,333,0
"e36d261332f14e79bb4b467aceaeb9b5","c7e89b9d04744d2eab742fc24e3ef1ae",22891963,1,1,0,979,333,334,1
"c7e89b9d04744d2eab742fc24e3ef1ae","c7e89b9d04744d2eab742fc24e3ef1ae",22891963,2,0,1,980,334,334,0
"c7e89b9d04744d2eab742fc24e3ef1ae","fe49f8054b374a0ea4bb266ed135ff62",22891963,1,1,0,982,334,335,1
"fe49f8054b374a0ea4bb266ed135ff62","fe49f8054b374a0ea4bb266ed135ff62",22891963,2,0,1,983,335,335,0
"fe49f8054b374a0ea4bb266ed135ff62","d0a8f74af98642fe8360d22c42e45117",22891963,1,1,0,985,335,336,1
"d0a8f74af98642fe8360d22c42e45117","d0a8f74af98642fe8360d22c42e45117",22891963,2,0,1,986,336,336,0
"d0a8f74af98642fe8360d22c42e45117","0c4079457ede49e3aeb5e86ed84bdf35",22891963,1,-7,0,988,336,329,-7
"0c4079457ede49e3aeb5e86ed84bdf35","a7c6339ca1da4368a18d471f0519f877",22891963,1,11,0,989,329,339,10
"a7c6339ca1da4368a18d471f0519f877","a7c6339ca1da4368a18d471f0519f877",22891963,1,0,1,990,339,339,0
"a7c6339ca1da4368a18d471f0519f877","bbc5139ca9024389a94db3a6f47dcff6",22891963,1,3,0,991,339,341,2
"bbc5139ca9024389a94db3a6f47dcff6","b8b9418ab322418d9db9b40d96af873a",22891963,1,-5,0,992,341,337,-4
"b8b9418ab322418d9db9b40d96af873a","bbc5139ca9024389a94db3a6f47dcff6",22891963,1,5,0,993,337,341,4
"bbc5139ca9024389a94db3a6f47dcff6","bbc5139ca9024389a94db3a6f47dcff6",22891963,1,0,1,994,341,341,0
"bbc5139ca9024389a94db3a6f47dcff6","4ee6ca9019ab4a1ab323f98094a9bd77",22891963,1,2,0,995,341,343,2
"4ee6ca9019ab4a1ab323f98094a9bd77","4ee6ca9019ab4a1ab323f98094a9bd77",22891963,2,0,1,996,343,343,0
"4ee6ca9019ab4a1ab323f98094a9bd77","b37947176785476f8b29d49a851366dc",22891963,1,1,0,998,343,344,1
"b37947176785476f8b29d49a851366dc","b37947176785476f8b29d49a851366dc",22891963,2,0,1,1000,344,344,0
"b37947176785476f8b29d49a851366dc","fcea5b10d5a14a3b9324ffece8f6e1e5",22891963,1,1,0,1001,344,345,1
"fcea5b10d5a14a3b9324ffece8f6e1e5","fcea5b10d5a14a3b9324ffece8f6e1e5",22891963,2,0,1,1002,345,345,0
"fcea5b10d5a14a3b9324ffece8f6e1e5","c2490bc612d146edbe786556fab3651b",22891963,1,-5,0,1004,345,340,-5
"c2490bc612d146edbe786556fab3651b","6ac8bb048b854999a47edb35fe627f11",22891963,1,8,0,1005,340,347,7
"6ac8bb048b854999a47edb35fe627f11","6ac8bb048b854999a47edb35fe627f11",22891963,1,0,1,1006,347,347,0
"6ac8bb048b854999a47edb35fe627f11","30ead9794d4847abaf222ca966cc8630",22891963,1,3,0,1007,347,348,1
"30ead9794d4847abaf222ca966cc8630","0c4079457ede49e3aeb5e86ed84bdf35",22891963,1,-24,0,1008,348,329,-19
"0c4079457ede49e3aeb5e86ed84bdf35","eff0de7f2dbb42dfa1a2e686efab5b6d",22891963,1,30,0,1009,329,354,25
"eff0de7f2dbb42dfa1a2e686efab5b6d","09b9678ddc3d452ea4a3d46e15826065",22891963,2,-1,0,1010,354,353,-1
"09b9678ddc3d452ea4a3d46e15826065","c20993c944444fe085345591a8bd837e",22891963,2,-2,0,1011,353,351,-2
"c20993c944444fe085345591a8bd837e","897b7f51242c44aab2205c72fdcbf4cd",22891963,3,1,0,1012,351,352,1
"897b7f51242c44aab2205c72fdcbf4cd","c20993c944444fe085345591a8bd837e",22891963,2,-1,0,1013,352,351,-1
"c20993c944444fe085345591a8bd837e","c20993c944444fe085345591a8bd837e",22891963,4,0,1,1014,351,351,0
"897b7f51242c44aab2205c72fdcbf4cd","897b7f51242c44aab2205c72fdcbf4cd",22891963,3,0,1,1018,352,352,0
"897b7f51242c44aab2205c72fdcbf4cd","09b9678ddc3d452ea4a3d46e15826065",22891963,1,1,0,1021,352,353,1
"09b9678ddc3d452ea4a3d46e15826065","09b9678ddc3d452ea4a3d46e15826065",22891963,4,0,1,1022,353,353,0
"09b9678ddc3d452ea4a3d46e15826065","eff0de7f2dbb42dfa1a2e686efab5b6d",22891963,2,1,0,1025,353,354,1
"eff0de7f2dbb42dfa1a2e686efab5b6d","eff0de7f2dbb42dfa1a2e686efab5b6d",22891963,4,0,1,1026,354,354,0
"eff0de7f2dbb42dfa1a2e686efab5b6d","2fe14166dc9642c3bc666b86a57f943d",22891963,1,4,0,1029,354,357,3
"2fe14166dc9642c3bc666b86a57f943d","30ead9794d4847abaf222ca966cc8630",22891963,1,-10,0,1030,357,348,-9
"30ead9794d4847abaf222ca966cc8630","30ead9794d4847abaf222ca966cc8630",22891963,1,0,1,1031,348,348,0
"30ead9794d4847abaf222ca966cc8630","1ba8fef685d74a8194b9db252eb704fb",22891963,1,8,0,1032,348,355,7
"1ba8fef685d74a8194b9db252eb704fb","2fe14166dc9642c3bc666b86a57f943d",22891963,1,2,0,1033,355,357,2
"2fe14166dc9642c3bc666b86a57f943d","2fe14166dc9642c3bc666b86a57f943d",22891963,1,0,1,1034,357,357,0
"2fe14166dc9642c3bc666b86a57f943d","44421dd1e13a47a388c4a19834b744c7",22891963,1,2,0,1035,357,359,2
"44421dd1e13a47a388c4a19834b744c7","44421dd1e13a47a388c4a19834b744c7",22891963,2,0,1,1036,359,359,0
"44421dd1e13a47a388c4a19834b744c7","cb5fc7ef85d547c4be1a7439d0bf6052",22891963,1,1,0,1038,359,360,1
"cb5fc7ef85d547c4be1a7439d0bf6052","cb5fc7ef85d547c4be1a7439d0bf6052",22891963,2,0,1,1039,360,360,0
"cb5fc7ef85d547c4be1a7439d0bf6052","0a8f150a4cf747acbde62f4721823da3",22891963,1,1,0,1041,360,361,1
"0a8f150a4cf747acbde62f4721823da3","0a8f150a4cf747acbde62f4721823da3",22891963,5,0,1,1042,361,361,0
"0a8f150a4cf747acbde62f4721823da3","ab8fdad974ae471f9f24c3f9dd04462e",22891963,1,1,0,1047,361,362,1
"ab8fdad974ae471f9f24c3f9dd04462e","ab8fdad974ae471f9f24c3f9dd04462e",22891963,2,0,1,1048,362,362,0
"ab8fdad974ae471f9f24c3f9dd04462e","1ba8fef685d74a8194b9db252eb704fb",22891963,1,-7,0,1050,362,355,-7
"1ba8fef685d74a8194b9db252eb704fb","52580888dadb4fe3baa795683ea227bd",22891963,1,10,0,1051,355,364,9
"52580888dadb4fe3baa795683ea227bd","52580888dadb4fe3baa795683ea227bd",22891963,1,0,1,1052,364,364,0
"52580888dadb4fe3baa795683ea227bd","f00179e251a045b39c3f7a54f9aa4acc",22891963,1,-1,0,1053,364,363,-1
"f00179e251a045b39c3f7a54f9aa4acc","492a3bc6a1254f23a7998587961b22a4",22891963,1,4,0,1054,363,366,3
"492a3bc6a1254f23a7998587961b22a4","492a3bc6a1254f23a7998587961b22a4",22891963,1,0,1,1055,366,366,0
"492a3bc6a1254f23a7998587961b22a4","072a190fd302456290895f9f04d6940a",22891963,1,-1,0,1056,366,365,-1
"072a190fd302456290895f9f04d6940a","eff0de7f2dbb42dfa1a2e686efab5b6d",22891963,1,-14,0,1057,365,354,-11
"897b7f51242c44aab2205c72fdcbf4cd","c76574d21bc14aeea7ecd0b027f39858",22891963,1,19,0,1061,352,367,15
"c76574d21bc14aeea7ecd0b027f39858","897b7f51242c44aab2205c72fdcbf4cd",22891963,1,-19,0,1062,367,352,-15
"c20993c944444fe085345591a8bd837e","09b9678ddc3d452ea4a3d46e15826065",22891963,1,2,0,1065,351,353,2
"eff0de7f2dbb42dfa1a2e686efab5b6d","897b7f51242c44aab2205c72fdcbf4cd",22891963,1,-2,0,1069,354,352,-2
"897b7f51242c44aab2205c72fdcbf4cd","30ead9794d4847abaf222ca966cc8630",22891963,1,-4,0,1070,352,348,-4
"30ead9794d4847abaf222ca966cc8630","cfa457d1743848e4bb5e4beced6448ed",22891963,1,25,0,1071,348,369,21
"cfa457d1743848e4bb5e4beced6448ed","cfa457d1743848e4bb5e4beced6448ed",22891963,1,0,1,1072,369,369,0
"cfa457d1743848e4bb5e4beced6448ed","30ead9794d4847abaf222ca966cc8630",22891963,1,-25,0,1073,369,348,-21
"30ead9794d4847abaf222ca966cc8630","b71bac264efb4abd97015447bd490db6",22891963,1,28,0,1074,348,370,22
"b71bac264efb4abd97015447bd490db6","8d448d625b024c82a5eb240bbd7431d6",22891963,3,5,0,1075,370,374,4
"8d448d625b024c82a5eb240bbd7431d6","8d448d625b024c82a5eb240bbd7431d6",22891963,58,0,1,1076,374,374,0
"8d448d625b024c82a5eb240bbd7431d6","b71bac264efb4abd97015447bd490db6",22891963,2,-5,0,1082,374,370,-4
"8d448d625b024c82a5eb240bbd7431d6","d6d02b6ef04e4f17805504500b8ce441",22891963,1,3,0,1127,374,375,1
"d6d02b6ef04e4f17805504500b8ce441","b71bac264efb4abd97015447bd490db6",22891963,2,-8,0,1128,375,370,-5
"b71bac264efb4abd97015447bd490db6","d6d02b6ef04e4f17805504500b8ce441",22891963,2,8,0,1129,370,375,5
"d6d02b6ef04e4f17805504500b8ce441","d6d02b6ef04e4f17805504500b8ce441",22891963,1,0,1,1143,375,375,0
"d6d02b6ef04e4f17805504500b8ce441","66baf19b6b904b70922329068c63746d",22891963,1,4,0,1144,375,376,1
"66baf19b6b904b70922329068c63746d","66baf19b6b904b70922329068c63746d",22891963,3,0,1,1145,376,376,0
"66baf19b6b904b70922329068c63746d","7f544639412e40a9ba27f43b415362ab",22891963,2,2,0,1146,376,378,2
"7f544639412e40a9ba27f43b415362ab","7f544639412e40a9ba27f43b415362ab",22891963,4,0,1,1147,378,378,0
"7f544639412e40a9ba27f43b415362ab","d5ae8642e15b46b8bd298b02274d4e9c",22891963,1,2,0,1151,378,380,2
"d5ae8642e15b46b8bd298b02274d4e9c","d5ae8642e15b46b8bd298b02274d4e9c",22891963,1,0,1,1152,380,380,0
"d5ae8642e15b46b8bd298b02274d4e9c","a0d10309a2dd456289147f84be9d37f9",22891963,1,1,0,1153,380,381,1
"a0d10309a2dd456289147f84be9d37f9","a0d10309a2dd456289147f84be9d37f9",22891963,2,0,1,1154,381,381,0
"a0d10309a2dd456289147f84be9d37f9","0fcbc3ca07b144138b8d85da581f09a8",22891963,1,1,0,1156,381,382,1
"0fcbc3ca07b144138b8d85da581f09a8","0fcbc3ca07b144138b8d85da581f09a8",22891963,2,0,1,1157,382,382,0
"0fcbc3ca07b144138b8d85da581f09a8","66baf19b6b904b70922329068c63746d",22891963,1,-6,0,1159,382,376,-6
"66baf19b6b904b70922329068c63746d","4890121ce5d74576b4632b77cfc23398",22891963,1,14,0,1160,376,388,12
"4890121ce5d74576b4632b77cfc23398","c2fca3669923477ab966ded303dea31c",22891963,1,-6,0,1161,388,383,-5
"c2fca3669923477ab966ded303dea31c","4890121ce5d74576b4632b77cfc23398",22891963,1,6,0,1162,383,388,5
"4890121ce5d74576b4632b77cfc23398","96bb2b3e85a34d8b9544514e89f6fe97",22891963,1,3,0,1163,388,390,2
"96bb2b3e85a34d8b9544514e89f6fe97","18d3b836dd804224883cc9180b60a8e1",22891963,1,-4,0,1164,390,387,-3
"18d3b836dd804224883cc9180b60a8e1","96bb2b3e85a34d8b9544514e89f6fe97",22891963,1,4,0,1165,387,390,3
"96bb2b3e85a34d8b9544514e89f6fe97","ac4e9b54acfe4670b4634859c7263cb5",22891963,1,2,0,1166,390,392,2
"ac4e9b54acfe4670b4634859c7263cb5","ac4e9b54acfe4670b4634859c7263cb5",22891963,1,0,1,1167,392,392,0
"ac4e9b54acfe4670b4634859c7263cb5","6f8881a745ac4c358a68b92c3b4abe81",22891963,1,3,0,1168,392,394,2
"6f8881a745ac4c358a68b92c3b4abe81","17f95d18bab743888e1736033dc3384d",22891963,1,-6,0,1169,394,389,-5
"17f95d18bab743888e1736033dc3384d","6f8881a745ac4c358a68b92c3b4abe81",22891963,1,6,0,1170,389,394,5
"6f8881a745ac4c358a68b92c3b4abe81","f7002c8484354eceac57bc7bd62c76c1",22891963,1,-1,0,1171,394,393,-1
"f7002c8484354eceac57bc7bd62c76c1","44a277ea44dc4ae689fab4b82f0b4098",22891963,1,5,0,1172,393,397,4
"44a277ea44dc4ae689fab4b82f0b4098","44a277ea44dc4ae689fab4b82f0b4098",22891963,1,0,1,1173,397,397,0
"44a277ea44dc4ae689fab4b82f0b4098","0c12af0a4e7f4002852cf84b2537c161",22891963,1,-2,0,1174,397,395,-2
"0c12af0a4e7f4002852cf84b2537c161","859e0b8d71694b12befb69ee698138f9",22891963,1,5,0,1175,395,399,4
"859e0b8d71694b12befb69ee698138f9","859e0b8d71694b12befb69ee698138f9",22891963,1,0,1,1176,399,399,0
"859e0b8d71694b12befb69ee698138f9","66baf19b6b904b70922329068c63746d",22891963,1,-29,0,1177,399,376,-23
"66baf19b6b904b70922329068c63746d","2b09a08242b54983aec7063990fb3f66",22891963,1,32,0,1178,376,400,24
"2b09a08242b54983aec7063990fb3f66","2b09a08242b54983aec7063990fb3f66",22891963,2,0,1,1179,400,400,0
"2b09a08242b54983aec7063990fb3f66","1f471b7a883a4df48211e8c6a81b59a7",22891963,1,1,0,1181,400,401,1
"1f471b7a883a4df48211e8c6a81b59a7","1f471b7a883a4df48211e8c6a81b59a7",22891963,1,0,1,1182,401,401,0
"1f471b7a883a4df48211e8c6a81b59a7","2b09a08242b54983aec7063990fb3f66",22891963,1,-1,0,1183,401,400,-1
"2b09a08242b54983aec7063990fb3f66","9de0d567bfa84fe5b77cb76f4a76a5d1",22891963,1,5,0,1184,400,404,4
"9de0d567bfa84fe5b77cb76f4a76a5d1","9de0d567bfa84fe5b77cb76f4a76a5d1",22891963,1,0,1,1185,404,404,0
"9de0d567bfa84fe5b77cb76f4a76a5d1","1157bd665ec4472fb58b751dc5099355",22891963,1,-1,0,1186,404,403,-1
"1157bd665ec4472fb58b751dc5099355","58fc9094275e4c49be3f4ba6d4acc0a4",22891963,1,5,0,1187,403,406,3
"58fc9094275e4c49be3f4ba6d4acc0a4","2b09a08242b54983aec7063990fb3f66",22891963,1,-9,0,1188,406,400,-6
"2b09a08242b54983aec7063990fb3f66","58fc9094275e4c49be3f4ba6d4acc0a4",22891963,1,9,0,1189,400,406,6
"58fc9094275e4c49be3f4ba6d4acc0a4","58fc9094275e4c49be3f4ba6d4acc0a4",22891963,1,0,1,1190,406,406,0
"58fc9094275e4c49be3f4ba6d4acc0a4","c1c1be90b2b14c1ab4a5e1ee3c241902",22891963,1,1,0,1191,406,407,1
"c1c1be90b2b14c1ab4a5e1ee3c241902","c1c1be90b2b14c1ab4a5e1ee3c241902",22891963,5,0,1,1192,407,407,0
"c1c1be90b2b14c1ab4a5e1ee3c241902","02b3a1bead9244c1ba2f857c7da8f82a",22891963,1,2,0,1197,407,408,1
"02b3a1bead9244c1ba2f857c7da8f82a","58fc9094275e4c49be3f4ba6d4acc0a4",22891963,1,-3,0,1198,408,406,-2
"58fc9094275e4c49be3f4ba6d4acc0a4","02b3a1bead9244c1ba2f857c7da8f82a",22891963,1,3,0,1199,406,408,2
"02b3a1bead9244c1ba2f857c7da8f82a","6206fc6479014bb193084c32409dc1b9",22891963,1,1,0,1200,408,409,1
"6206fc6479014bb193084c32409dc1b9","6206fc6479014bb193084c32409dc1b9",22891963,4,0,1,1201,409,409,0
"6206fc6479014bb193084c32409dc1b9","02b3a1bead9244c1ba2f857c7da8f82a",22891963,1,-1,0,1205,409,408,-1
"02b3a1bead9244c1ba2f857c7da8f82a","6a5f020451db426dacba9e2ea3fcc62a",22891963,1,3,0,1206,408,410,2
"6a5f020451db426dacba9e2ea3fcc62a","6a5f020451db426dacba9e2ea3fcc62a",22891963,2,0,1,1207,410,410,0
"6a5f020451db426dacba9e2ea3fcc62a","33a9d248b2e44588a5b07fc1342b9bc2",22891963,1,2,0,1209,410,411,1
"33a9d248b2e44588a5b07fc1342b9bc2","33a9d248b2e44588a5b07fc1342b9bc2",22891963,1,0,1,1210,411,411,0
"33a9d248b2e44588a5b07fc1342b9bc2","c6f26bd420634f1cb7989e76fe6b16c0",22891963,1,1,0,1211,411,412,1
"c6f26bd420634f1cb7989e76fe6b16c0","c6f26bd420634f1cb7989e76fe6b16c0",22891963,5,0,1,1212,412,412,0
"c6f26bd420634f1cb7989e76fe6b16c0","2a65ee6e2ac64f6a8a55fbe5373ec763",22891963,1,1,0,1217,412,413,1
"2a65ee6e2ac64f6a8a55fbe5373ec763","2a65ee6e2ac64f6a8a55fbe5373ec763",22891963,2,0,1,1218,413,413,0
"2a65ee6e2ac64f6a8a55fbe5373ec763","33a9d248b2e44588a5b07fc1342b9bc2",22891963,1,-2,0,1220,413,411,-2
"33a9d248b2e44588a5b07fc1342b9bc2","1fd0f6dadbc14ebc965faf6122190b96",22891963,1,5,0,1221,411,415,4
"1fd0f6dadbc14ebc965faf6122190b96","1fd0f6dadbc14ebc965faf6122190b96",22891963,1,0,1,1222,415,415,0
"1fd0f6dadbc14ebc965faf6122190b96","687055dad9fc40c3982478fe33ec01bf",22891963,1,-1,0,1223,415,414,-1
"687055dad9fc40c3982478fe33ec01bf","2add1669f08d4101913db15f8c23b3b7",22891963,1,3,0,1224,414,416,2
"2add1669f08d4101913db15f8c23b3b7","2add1669f08d4101913db15f8c23b3b7",22891963,1,0,1,1225,416,416,0
"2add1669f08d4101913db15f8c23b3b7","2b09a08242b54983aec7063990fb3f66",22891963,1,-24,0,1226,416,400,-16
"2b09a08242b54983aec7063990fb3f66","a2b4bd40cee2481ebd3fc179d6a5cd62",22891963,1,27,0,1227,400,417,17
"a2b4bd40cee2481ebd3fc179d6a5cd62","e34e59dce2204f228f3a84b6725df60f",22891963,1,2,0,1228,417,419,2
"e34e59dce2204f228f3a84b6725df60f","e34e59dce2204f228f3a84b6725df60f",22891963,1,0,1,1229,419,419,0
"e34e59dce2204f228f3a84b6725df60f","bec48fc2e1294c7eb3d0aca780d731b8",22891963,1,2,0,1230,419,420,1
"bec48fc2e1294c7eb3d0aca780d731b8","a2b4bd40cee2481ebd3fc179d6a5cd62",22891963,1,-4,0,1231,420,417,-3
"a2b4bd40cee2481ebd3fc179d6a5cd62","bec48fc2e1294c7eb3d0aca780d731b8",22891963,1,4,0,1232,417,420,3
"bec48fc2e1294c7eb3d0aca780d731b8","bec48fc2e1294c7eb3d0aca780d731b8",22891963,1,0,1,1233,420,420,0
"bec48fc2e1294c7eb3d0aca780d731b8","dbde19fcce2a4c1abdc7f685c293a23f",22891963,1,3,0,1234,420,422,2
"dbde19fcce2a4c1abdc7f685c293a23f","a24600b0e49245f6bdba8c893cfeddb0",22891963,1,4,0,1235,422,425,3
"a24600b0e49245f6bdba8c893cfeddb0","a24600b0e49245f6bdba8c893cfeddb0",22891963,4,0,1,1236,425,425,0
"a24600b0e49245f6bdba8c893cfeddb0","a2b4bd40cee2481ebd3fc179d6a5cd62",22891963,2,-11,0,1238,425,417,-8
"a2b4bd40cee2481ebd3fc179d6a5cd62","24cf8786024543f19b89bc20034e60d7",22891963,1,18,0,1239,417,428,11
"24cf8786024543f19b89bc20034e60d7","f2a73be2f46840b182d7bd095378004e",22891963,1,1,0,1240,428,429,1
"f2a73be2f46840b182d7bd095378004e","f2a73be2f46840b182d7bd095378004e",22891963,1,0,1,1241,429,429,0
"f2a73be2f46840b182d7bd095378004e","604551fd4266430cb860fef58fa7dd61",22891963,1,1,0,1242,429,430,1
"604551fd4266430cb860fef58fa7dd61","604551fd4266430cb860fef58fa7dd61",22891963,8,0,1,1243,430,430,0
"604551fd4266430cb860fef58fa7dd61","24cf8786024543f19b89bc20034e60d7",22891963,1,-2,0,1251,430,428,-2
"24cf8786024543f19b89bc20034e60d7","dce46f8904594a62a6377a3587aaa663",22891963,1,4,0,1252,428,431,3
"dce46f8904594a62a6377a3587aaa663","dce46f8904594a62a6377a3587aaa663",22891963,3,0,1,1253,431,431,0
"dce46f8904594a62a6377a3587aaa663","9b9d0a249052413c869753b99682b0ac",22891963,1,1,0,1256,431,432,1
"9b9d0a249052413c869753b99682b0ac","9b9d0a249052413c869753b99682b0ac",22891963,5,0,1,1257,432,432,0
"9b9d0a249052413c869753b99682b0ac","061c175cc90f45fbad883025394e78dd",22891963,1,1,0,1262,432,433,1
"061c175cc90f45fbad883025394e78dd","061c175cc90f45fbad883025394e78dd",22891963,5,0,1,1263,433,433,0
"061c175cc90f45fbad883025394e78dd","dce46f8904594a62a6377a3587aaa663",22891963,1,-2,0,1268,433,431,-2
"dce46f8904594a62a6377a3587aaa663","74a7f8712e5449c2bc0b43c6f90dafed",22891963,1,5,0,1269,431,435,4
"74a7f8712e5449c2bc0b43c6f90dafed","74a7f8712e5449c2bc0b43c6f90dafed",22891963,1,0,1,1270,435,435,0
"74a7f8712e5449c2bc0b43c6f90dafed","66ada10dde9f43018588f1ced9d477fc",22891963,1,-1,0,1271,435,434,-1
"66ada10dde9f43018588f1ced9d477fc","24cf8786024543f19b89bc20034e60d7",22891963,1,-8,0,1272,434,428,-6
"24cf8786024543f19b89bc20034e60d7","bf12c96466d840a69bed7020b3f18bb8",22891963,1,11,0,1273,428,436,8
"bf12c96466d840a69bed7020b3f18bb8","bf12c96466d840a69bed7020b3f18bb8",22891963,2,0,1,1274,436,436,0
"bf12c96466d840a69bed7020b3f18bb8","070600601c4c439288445d2f0724807d",22891963,1,3,0,1276,436,437,1
"070600601c4c439288445d2f0724807d","24cf8786024543f19b89bc20034e60d7",22891963,1,-14,0,1277,437,428,-9
"24cf8786024543f19b89bc20034e60d7","1823b6de7d334a7aaabc4570719af4d9",22891963,1,16,0,1278,428,439,11
"1823b6de7d334a7aaabc4570719af4d9","1823b6de7d334a7aaabc4570719af4d9",22891963,11,0,1,1279,439,439,0
"1823b6de7d334a7aaabc4570719af4d9","070600601c4c439288445d2f0724807d",22891963,1,-2,0,1290,439,437,-2
"070600601c4c439288445d2f0724807d","0380cd76a7d44bc3a4da1f15e4d68f89",22891963,1,4,0,1291,437,440,3
"0380cd76a7d44bc3a4da1f15e4d68f89","0380cd76a7d44bc3a4da1f15e4d68f89",22891963,2,0,1,1292,440,440,0
"0380cd76a7d44bc3a4da1f15e4d68f89","23b7673c8b5443108c2ef09382834a86",22891963,1,2,0,1294,440,441,1
"23b7673c8b5443108c2ef09382834a86","23b7673c8b5443108c2ef09382834a86",22891963,2,0,1,1295,441,441,0
"23b7673c8b5443108c2ef09382834a86","901e92500aea43c79f19f1b279050668",22891963,1,2,0,1297,441,442,1
"901e92500aea43c79f19f1b279050668","901e92500aea43c79f19f1b279050668",22891963,1,0,1,1298,442,442,0
"901e92500aea43c79f19f1b279050668","001339db8ced4cf78829ebe8b145449d",22891963,1,1,0,1299,442,443,1
"001339db8ced4cf78829ebe8b145449d","001339db8ced4cf78829ebe8b145449d",22891963,11,0,1,1300,443,443,0
"001339db8ced4cf78829ebe8b145449d","452745e0366e42ae81561bfddebcc6c3",22891963,1,1,0,1311,443,444,1
"452745e0366e42ae81561bfddebcc6c3","452745e0366e42ae81561bfddebcc6c3",22891963,2,0,1,1312,444,444,0
"452745e0366e42ae81561bfddebcc6c3","901e92500aea43c79f19f1b279050668",22891963,1,-2,0,1314,444,442,-2
"901e92500aea43c79f19f1b279050668","4660ff2089114e8db82ceb26a4f329e3",22891963,2,4,0,1315,442,445,3
"4660ff2089114e8db82ceb26a4f329e3","4660ff2089114e8db82ceb26a4f329e3",22891963,2,0,1,1316,445,445,0
"4660ff2089114e8db82ceb26a4f329e3","7bd5586eb9d8484eb74a433ee7bfe499",22891963,1,2,0,1318,445,446,1
"7bd5586eb9d8484eb74a433ee7bfe499","7bd5586eb9d8484eb74a433ee7bfe499",22891963,12,0,1,1319,446,446,0
"7bd5586eb9d8484eb74a433ee7bfe499","8a7f26e690f34dda97be16904518ca99",22891963,1,2,0,1328,446,447,1
"8a7f26e690f34dda97be16904518ca99","8a7f26e690f34dda97be16904518ca99",22891963,1,0,1,1329,447,447,0
"8a7f26e690f34dda97be16904518ca99","b2f0d654738f48158edff28e8d3a546e",22891963,1,5,0,1330,447,449,2
"b2f0d654738f48158edff28e8d3a546e","070600601c4c439288445d2f0724807d",22891963,2,-21,0,1331,449,437,-12
"070600601c4c439288445d2f0724807d","f60ee41ec635499abd48168342d32c2f",22891963,1,26,0,1332,437,453,16
"f60ee41ec635499abd48168342d32c2f","f60ee41ec635499abd48168342d32c2f",22891963,74,0,1,1333,453,453,0
"f60ee41ec635499abd48168342d32c2f","b2f0d654738f48158edff28e8d3a546e",22891963,4,-5,0,1340,453,449,-4
"b2f0d654738f48158edff28e8d3a546e","9428d8bd9c5a47b2a235b254e5e27ded",22891963,2,4,0,1341,449,452,3
"9428d8bd9c5a47b2a235b254e5e27ded","f60ee41ec635499abd48168342d32c2f",22891963,2,1,0,1342,452,453,1
"b2f0d654738f48158edff28e8d3a546e","f60ee41ec635499abd48168342d32c2f",22891963,2,5,0,1345,449,453,4
"b2f0d654738f48158edff28e8d3a546e","f67fbf45a5f146ed866965bc57c7c001",22891963,2,8,0,1397,449,454,5
"f67fbf45a5f146ed866965bc57c7c001","f67fbf45a5f146ed866965bc57c7c001",22891963,3,0,1,1398,454,454,0
"f67fbf45a5f146ed866965bc57c7c001","d937afe49bd24a07a550dda1c1155122",22891963,1,1,0,1400,454,455,1
"d937afe49bd24a07a550dda1c1155122","d937afe49bd24a07a550dda1c1155122",22891963,1,0,1,1401,455,455,0
"d937afe49bd24a07a550dda1c1155122","3628b3f7823443d0912a339096b69943",22891963,1,1,0,1402,455,456,1
"3628b3f7823443d0912a339096b69943","3628b3f7823443d0912a339096b69943",22891963,1,0,1,1403,456,456,0
"3628b3f7823443d0912a339096b69943","9e049ee647cf43ecbcb5ed792a8e7588",22891963,1,1,0,1404,456,457,1
"9e049ee647cf43ecbcb5ed792a8e7588","9e049ee647cf43ecbcb5ed792a8e7588",22891963,1,0,1,1405,457,457,0
"9e049ee647cf43ecbcb5ed792a8e7588","5256a214faaf410b93f76cea06428334",22891963,1,1,0,1406,457,458,1
"5256a214faaf410b93f76cea06428334","5256a214faaf410b93f76cea06428334",22891963,1,0,1,1407,458,458,0
"5256a214faaf410b93f76cea06428334","25c32b120fce40fa9b6c85133aeb4716",22891963,1,1,0,1408,458,459,1
"25c32b120fce40fa9b6c85133aeb4716","25c32b120fce40fa9b6c85133aeb4716",22891963,1,0,1,1409,459,459,0
"25c32b120fce40fa9b6c85133aeb4716","11bc14f2204949008b7d511b933363c1",22891963,1,1,0,1410,459,460,1
"11bc14f2204949008b7d511b933363c1","11bc14f2204949008b7d511b933363c1",22891963,1,0,1,1411,460,460,0
"11bc14f2204949008b7d511b933363c1","42de338840a34d15adb66e7b14fb9d2c",22891963,1,1,0,1412,460,461,1
"42de338840a34d15adb66e7b14fb9d2c","42de338840a34d15adb66e7b14fb9d2c",22891963,1,0,1,1413,461,461,0
"42de338840a34d15adb66e7b14fb9d2c","9da37c6210b1416b8079c274f70bf600",22891963,1,1,0,1414,461,462,1
"9da37c6210b1416b8079c274f70bf600","9da37c6210b1416b8079c274f70bf600",22891963,1,0,1,1415,462,462,0
"9da37c6210b1416b8079c274f70bf600","519119f1deac45ff9ab4f13529be5c6e",22891963,1,1,0,1416,462,463,1
"519119f1deac45ff9ab4f13529be5c6e","519119f1deac45ff9ab4f13529be5c6e",22891963,1,0,1,1417,463,463,0
"519119f1deac45ff9ab4f13529be5c6e","c5df9f40ec14463b9dcfdc73df3e9285",22891963,1,3,0,1418,463,464,1
"c5df9f40ec14463b9dcfdc73df3e9285","f67fbf45a5f146ed866965bc57c7c001",22891963,1,-12,0,1419,464,454,-10
"f67fbf45a5f146ed866965bc57c7c001","c5df9f40ec14463b9dcfdc73df3e9285",22891963,2,12,0,1420,454,464,10
"c5df9f40ec14463b9dcfdc73df3e9285","83d42d95cd844fc093fc09cee250edb8",22891963,3,3,0,1421,464,465,1
"83d42d95cd844fc093fc09cee250edb8","c5df9f40ec14463b9dcfdc73df3e9285",22891963,1,-3,0,1422,465,464,-1
"83d42d95cd844fc093fc09cee250edb8","9a0dc646f934470daf08c4b56ccf73db",22891963,1,-590,0,1424,465,37,-428
"9a0dc646f934470daf08c4b56ccf73db","9a0dc646f934470daf08c4b56ccf73db",22891963,3,0,1,1425,37,37,0
"9a0dc646f934470daf08c4b56ccf73db","fc0e049d56024bc9a02c9a9c435c3df7",22891963,2,3,0,1427,37,38,1
"fc0e049d56024bc9a02c9a9c435c3df7","e20db35ced8544ddac5bc3839145e463",22891963,1,71,0,1428,38,91,53
"e20db35ced8544ddac5bc3839145e463","08111f75e22d409998cf8b85bd431f0a",22891963,2,19,0,1429,91,108,17
"08111f75e22d409998cf8b85bd431f0a","4280927ec4d643238aa49c32f9e06c6c",22891963,2,1,0,1430,108,109,1
"4280927ec4d643238aa49c32f9e06c6c","4280927ec4d643238aa49c32f9e06c6c",22891963,2,0,1,1431,109,109,0
"4280927ec4d643238aa49c32f9e06c6c","08111f75e22d409998cf8b85bd431f0a",22891963,2,-1,0,1432,109,108,-1
"08111f75e22d409998cf8b85bd431f0a","a9ae0a3c070d455bb4369a8996313336",22891963,3,7,0,1433,108,114,6
"a9ae0a3c070d455bb4369a8996313336","139b097acfca451689d80c9c6eebdf7b",22891963,1,87,0,1434,114,178,64
"139b097acfca451689d80c9c6eebdf7b","0c7262dff33c4087bc660ccf40f92f9c",22891963,1,-11,0,1435,178,169,-9
"0c7262dff33c4087bc660ccf40f92f9c","ea38cc0e6e6e41edbabf210220808bf9",22891963,1,12,0,1436,169,179,10
"ea38cc0e6e6e41edbabf210220808bf9","b87c552dd247427abe6ab5795b9c9d43",22891963,2,2,0,1437,179,181,2
"b87c552dd247427abe6ab5795b9c9d43","ea38cc0e6e6e41edbabf210220808bf9",22891963,2,-2,0,1438,181,179,-2
"ea38cc0e6e6e41edbabf210220808bf9","139b097acfca451689d80c9c6eebdf7b",22891963,1,-1,0,1439,179,178,-1
"139b097acfca451689d80c9c6eebdf7b","b2f0d654738f48158edff28e8d3a546e",22891963,1,380,0,1440,178,449,271
"f60ee41ec635499abd48168342d32c2f","66baf19b6b904b70922329068c63746d",22891963,1,-117,0,1452,453,376,-77
"66baf19b6b904b70922329068c63746d","83d42d95cd844fc093fc09cee250edb8",22891963,1,135,0,1454,376,465,89
"83d42d95cd844fc093fc09cee250edb8","83d42d95cd844fc093fc09cee250edb8",22891963,6,0,1,1455,465,465,0
"83d42d95cd844fc093fc09cee250edb8","a24600b0e49245f6bdba8c893cfeddb0",22891963,1,-65,0,1459,465,425,-40
"a2b4bd40cee2481ebd3fc179d6a5cd62","a24600b0e49245f6bdba8c893cfeddb0",22891963,1,11,0,1461,417,425,8
"a24600b0e49245f6bdba8c893cfeddb0","24cf8786024543f19b89bc20034e60d7",22891963,1,7,0,1464,425,428,3
"24cf8786024543f19b89bc20034e60d7","a2b4bd40cee2481ebd3fc179d6a5cd62",22891963,1,-18,0,1465,428,417,-11
"a2b4bd40cee2481ebd3fc179d6a5cd62","f2a73be2f46840b182d7bd095378004e",22891963,1,19,0,1466,417,429,12
"f2a73be2f46840b182d7bd095378004e","66baf19b6b904b70922329068c63746d",22891963,1,-78,0,1467,429,376,-53
"7f544639412e40a9ba27f43b415362ab","66baf19b6b904b70922329068c63746d",22891963,1,-2,0,1470,378,376,-2
"66baf19b6b904b70922329068c63746d","070600601c4c439288445d2f0724807d",22891963,1,91,0,1471,376,437,61
"070600601c4c439288445d2f0724807d","070600601c4c439288445d2f0724807d",22891963,1,0,1,1472,437,437,0
"070600601c4c439288445d2f0724807d","1823b6de7d334a7aaabc4570719af4d9",22891963,1,2,0,1473,437,439,2
"1823b6de7d334a7aaabc4570719af4d9","0380cd76a7d44bc3a4da1f15e4d68f89",22891963,1,2,0,1474,439,440,1
"0380cd76a7d44bc3a4da1f15e4d68f89","070600601c4c439288445d2f0724807d",22891963,1,-4,0,1475,440,437,-3
"070600601c4c439288445d2f0724807d","901e92500aea43c79f19f1b279050668",22891963,2,8,0,1476,437,442,5
"901e92500aea43c79f19f1b279050668","070600601c4c439288445d2f0724807d",22891963,1,-8,0,1477,442,437,-5
"4660ff2089114e8db82ceb26a4f329e3","901e92500aea43c79f19f1b279050668",22891963,1,-4,0,1480,445,442,-3
"901e92500aea43c79f19f1b279050668","7bd5586eb9d8484eb74a433ee7bfe499",22891963,1,6,0,1481,442,446,4
"7bd5586eb9d8484eb74a433ee7bfe499","070600601c4c439288445d2f0724807d",22891963,2,-14,0,1482,446,437,-9
"070600601c4c439288445d2f0724807d","7bd5586eb9d8484eb74a433ee7bfe499",22891963,3,14,0,1483,437,446,9
"7bd5586eb9d8484eb74a433ee7bfe499","b2f0d654738f48158edff28e8d3a546e",22891963,1,7,0,1485,446,449,3
"070600601c4c439288445d2f0724807d","e20db35ced8544ddac5bc3839145e463",22891963,1,-472,0,1487,437,91,-346
"a9ae0a3c070d455bb4369a8996313336","62bff51286ef4f348717a3cf6fe2318f",22891963,1,7,0,1492,114,120,6
"62bff51286ef4f348717a3cf6fe2318f","37319e88176d4aefa91d7a9980dbae91",22891963,2,-9,0,1493,120,112,-8
"37319e88176d4aefa91d7a9980dbae91","62bff51286ef4f348717a3cf6fe2318f",22891963,1,9,0,1494,112,120,8
"62bff51286ef4f348717a3cf6fe2318f","62bff51286ef4f348717a3cf6fe2318f",22891963,4,0,1,1495,120,120,0
"62bff51286ef4f348717a3cf6fe2318f","e20db35ced8544ddac5bc3839145e463",22891963,1,-33,0,1496,120,91,-29
"e20db35ced8544ddac5bc3839145e463","779f9ddd1fd14d1e9e69f72219a1fdbd",22891963,1,36,0,1497,91,121,30
"779f9ddd1fd14d1e9e69f72219a1fdbd","070600601c4c439288445d2f0724807d",22891963,1,436,0,1498,121,437,316
"070600601c4c439288445d2f0724807d","b2f0d654738f48158edff28e8d3a546e",22891963,1,21,0,1502,437,449,12
"b2f0d654738f48158edff28e8d3a546e","b2f0d654738f48158edff28e8d3a546e",22891963,1,0,1,1503,449,449,0
"c5df9f40ec14463b9dcfdc73df3e9285","c5df9f40ec14463b9dcfdc73df3e9285",22891963,2,0,1,1516,464,464,0
"83d42d95cd844fc093fc09cee250edb8","070600601c4c439288445d2f0724807d",22891963,1,-44,0,1521,465,437,-28
"b613861cecf84ffcab01afb23f660475","b613861cecf84ffcab01afb23f660475",22900626,4,0,1,1,1,1,0
"b613861cecf84ffcab01afb23f660475","e2911e79efc2420eac45d9f671463d4b",22900626,1,3,0,5,1,2,1
"e2911e79efc2420eac45d9f671463d4b","519d1b8c59404d67b54e96c5c8a830b2",22900626,1,1,0,8,2,3,1
"519d1b8c59404d67b54e96c5c8a830b2","519d1b8c59404d67b54e96c5c8a830b2",22900626,1,0,1,9,3,3,0
"519d1b8c59404d67b54e96c5c8a830b2","531db53f81f646edb0cdcfe0085b03b7",22900626,1,1,0,10,3,4,1
"531db53f81f646edb0cdcfe0085b03b7","531db53f81f646edb0cdcfe0085b03b7",22900626,1,0,1,11,4,4,0
"531db53f81f646edb0cdcfe0085b03b7","4f5f94b2f95141e0a9d53a61da2276da",22900626,1,1,0,12,4,5,1
"4f5f94b2f95141e0a9d53a61da2276da","4f5f94b2f95141e0a9d53a61da2276da",22900626,1,0,1,13,5,5,0
"4f5f94b2f95141e0a9d53a61da2276da","6d541c89590949f99af293c4f2333f67",22900626,1,1,0,14,5,6,1
"6d541c89590949f99af293c4f2333f67","6d541c89590949f99af293c4f2333f67",22900626,1,0,1,15,6,6,0
"6d541c89590949f99af293c4f2333f67","dd5cf0b9fe4c4f1d8f5ff8e4c04879cb",22900626,1,1,0,16,6,7,1
"dd5cf0b9fe4c4f1d8f5ff8e4c04879cb","dd5cf0b9fe4c4f1d8f5ff8e4c04879cb",22900626,4,0,1,17,7,7,0
"dd5cf0b9fe4c4f1d8f5ff8e4c04879cb","f96261861edc426abe2248be4f0a709a",22900626,1,1,0,21,7,8,1
"f96261861edc426abe2248be4f0a709a","f96261861edc426abe2248be4f0a709a",22900626,1,0,1,22,8,8,0
"f96261861edc426abe2248be4f0a709a","66b5e16f4f75454fb5b8172079f0fa83",22900626,1,1,0,23,8,9,1
"66b5e16f4f75454fb5b8172079f0fa83","66b5e16f4f75454fb5b8172079f0fa83",22900626,1,0,1,24,9,9,0
"66b5e16f4f75454fb5b8172079f0fa83","0680571d4698477995e41842c36a54b2",22900626,1,1,0,25,9,10,1
"0680571d4698477995e41842c36a54b2","0680571d4698477995e41842c36a54b2",22900626,1,0,1,26,10,10,0
"0680571d4698477995e41842c36a54b2","56586aa865414f538729c7f7735d2bc6",22900626,1,4,0,27,10,12,2
"56586aa865414f538729c7f7735d2bc6","e2911e79efc2420eac45d9f671463d4b",22900626,3,-12,0,28,12,2,-10
"e2911e79efc2420eac45d9f671463d4b","9112f2bffece48e08c6d2287be204085",22900626,1,9,0,29,2,11,9
"9112f2bffece48e08c6d2287be204085","9112f2bffece48e08c6d2287be204085",22900626,1,0,1,30,11,11,0
"9112f2bffece48e08c6d2287be204085","e2911e79efc2420eac45d9f671463d4b",22900626,1,-9,0,31,11,2,-9
"e2911e79efc2420eac45d9f671463d4b","e2911e79efc2420eac45d9f671463d4b",22900626,4,0,1,32,2,2,0
"e2911e79efc2420eac45d9f671463d4b","56586aa865414f538729c7f7735d2bc6",22900626,3,12,0,33,2,12,10
"56586aa865414f538729c7f7735d2bc6","56586aa865414f538729c7f7735d2bc6",22900626,5,0,1,36,12,12,0
"56586aa865414f538729c7f7735d2bc6","b7f2b31585d94eb3bf86376714aa7070",22900626,1,2,0,44,12,13,1
"b7f2b31585d94eb3bf86376714aa7070","b7f2b31585d94eb3bf86376714aa7070",22900626,3,0,1,45,13,13,0
"b7f2b31585d94eb3bf86376714aa7070","3f1c815879794b929260d224becaff7e",22900626,1,2,0,48,13,14,1
"3f1c815879794b929260d224becaff7e","5c5ceeee4562457ba6d41515aeebfbb1",22900626,1,6,0,49,14,17,3
"5c5ceeee4562457ba6d41515aeebfbb1","81c864a886d54a6b8ff85f7d736f4f95",22900626,1,-4,0,50,17,15,-2
"81c864a886d54a6b8ff85f7d736f4f95","5c5ceeee4562457ba6d41515aeebfbb1",22900626,1,4,0,51,15,17,2
"5c5ceeee4562457ba6d41515aeebfbb1","56586aa865414f538729c7f7735d2bc6",22900626,1,-10,0,52,17,12,-5
"56586aa865414f538729c7f7735d2bc6","9afd71a5298d4333b6849dfce1b9422c",22900626,1,13,0,53,12,18,6
"9afd71a5298d4333b6849dfce1b9422c","9afd71a5298d4333b6849dfce1b9422c",22900626,5,0,1,54,18,18,0
"9afd71a5298d4333b6849dfce1b9422c","b7719e26494940efa49512aedd0aac79",22900626,1,4,0,59,18,20,2
"b7719e26494940efa49512aedd0aac79","d4f45188d3c84a02ba08454e6403a818",22900626,1,5,0,60,20,24,4
"d4c3b003e8274e429d2fa688d73fde6d","b613861cecf84ffcab01afb23f660475",22900626,1,-35,0,62,22,1,-21
"b613861cecf84ffcab01afb23f660475","a49d1bb4328949299686242fd0be5584",22900626,1,34,0,63,1,21,20
"b7719e26494940efa49512aedd0aac79","afbf7250b99d47bea07172749483ca97",22900626,1,12,0,66,20,28,8
"afbf7250b99d47bea07172749483ca97","b7719e26494940efa49512aedd0aac79",22900626,1,-12,0,67,28,20,-8
"b7719e26494940efa49512aedd0aac79","4e51676dc72045d99c19b9fa7b22f8bc",22900626,1,15,0,68,20,29,9
"4e51676dc72045d99c19b9fa7b22f8bc","afbf7250b99d47bea07172749483ca97",22900626,1,-3,0,69,29,28,-1
"afbf7250b99d47bea07172749483ca97","4e51676dc72045d99c19b9fa7b22f8bc",22900626,1,3,0,70,28,29,1
"4e51676dc72045d99c19b9fa7b22f8bc","51970cfa30e643e894e66ae85c8024cc",22900626,1,3,0,71,29,31,2
"51970cfa30e643e894e66ae85c8024cc","4e51676dc72045d99c19b9fa7b22f8bc",22900626,1,-3,0,72,31,29,-2
"93679be414554a11b1893002f2229a93","93679be414554a11b1893002f2229a93",22900626,1,0,1,80,35,35,0
"93679be414554a11b1893002f2229a93","7040a13096d746ac84b8fac8d9752058",22900626,1,3,0,81,35,36,1
"7040a13096d746ac84b8fac8d9752058","9a0dc646f934470daf08c4b56ccf73db",22900626,1,3,0,82,36,37,1
"9a0dc646f934470daf08c4b56ccf73db","7040a13096d746ac84b8fac8d9752058",22900626,1,-3,0,83,37,36,-1
"7040a13096d746ac84b8fac8d9752058","fc0e049d56024bc9a02c9a9c435c3df7",22900626,1,6,0,84,36,38,2
"fc0e049d56024bc9a02c9a9c435c3df7","9a0dc646f934470daf08c4b56ccf73db",22900626,1,-3,0,85,38,37,-1
"9a0dc646f934470daf08c4b56ccf73db","67a089198fcb4e1c8f2385786c2b296f",22900626,1,7,0,86,37,39,2
"67a089198fcb4e1c8f2385786c2b296f","fc0e049d56024bc9a02c9a9c435c3df7",22900626,1,-4,0,87,39,38,-1
"fc0e049d56024bc9a02c9a9c435c3df7","64d48c6c9c7940639a932219a6c87198",22900626,1,5,0,88,38,40,2
"64d48c6c9c7940639a932219a6c87198","64d48c6c9c7940639a932219a6c87198",22900626,2,0,1,89,40,40,0
"64d48c6c9c7940639a932219a6c87198","67a089198fcb4e1c8f2385786c2b296f",22900626,1,-1,0,91,40,39,-1
"67a089198fcb4e1c8f2385786c2b296f","b534b89233134e30a9b5645138bfa9ee",22900626,1,4,0,92,39,41,2
"b534b89233134e30a9b5645138bfa9ee","0e37b720d23b4e7f8b313e79313fd107",22900626,1,3,0,93,41,44,3
"0e37b720d23b4e7f8b313e79313fd107","0e37b720d23b4e7f8b313e79313fd107",22900626,1,0,1,94,44,44,0
"0e37b720d23b4e7f8b313e79313fd107","6875d67fdd5f48168b62719df449bebd",22900626,1,1,0,95,44,45,1
"6875d67fdd5f48168b62719df449bebd","6875d67fdd5f48168b62719df449bebd",22900626,1,0,1,96,45,45,0
"6875d67fdd5f48168b62719df449bebd","b534b89233134e30a9b5645138bfa9ee",22900626,1,-4,0,97,45,41,-4
"b534b89233134e30a9b5645138bfa9ee","6e13d61a7bdb44bca949c9f86fab3be5",22900626,1,7,0,98,41,47,6
"6e13d61a7bdb44bca949c9f86fab3be5","6e13d61a7bdb44bca949c9f86fab3be5",22900626,2,0,1,100,47,47,0
"6e13d61a7bdb44bca949c9f86fab3be5","195f78799f984cc2b06c48dfe36be751",22900626,1,2,0,101,47,49,2
"195f78799f984cc2b06c48dfe36be751","195f78799f984cc2b06c48dfe36be751",22900626,2,0,1,102,49,49,0
"195f78799f984cc2b06c48dfe36be751","d9c8d8c444a64dadbbb508652c721e17",22900626,1,-3,0,104,49,46,-3
"d9c8d8c444a64dadbbb508652c721e17","d0c74f735e024943943e40333d6d337f",22900626,1,6,0,105,46,51,5
"d0c74f735e024943943e40333d6d337f","d0c74f735e024943943e40333d6d337f",22900626,1,0,1,106,51,51,0
"d0c74f735e024943943e40333d6d337f","983f8ff320594b279a7f4a6fe132f9c5",22900626,1,2,0,107,51,53,2
"983f8ff320594b279a7f4a6fe132f9c5","983f8ff320594b279a7f4a6fe132f9c5",22900626,2,0,1,108,53,53,0
"983f8ff320594b279a7f4a6fe132f9c5","35adfa5d923046aebabfefd98f35ff05",22900626,1,1,0,110,53,54,1
"35adfa5d923046aebabfefd98f35ff05","35adfa5d923046aebabfefd98f35ff05",22900626,2,0,1,111,54,54,0
"35adfa5d923046aebabfefd98f35ff05","b6f8a98476224da1b40e555ececc7ed8",22900626,1,1,0,113,54,55,1
"b6f8a98476224da1b40e555ececc7ed8","b6f8a98476224da1b40e555ececc7ed8",22900626,5,0,1,114,55,55,0
"b6f8a98476224da1b40e555ececc7ed8","86e22cb5fe0e4b47a9489ecddf7ed78f",22900626,1,1,0,119,55,56,1
"86e22cb5fe0e4b47a9489ecddf7ed78f","86e22cb5fe0e4b47a9489ecddf7ed78f",22900626,2,0,1,120,56,56,0
"86e22cb5fe0e4b47a9489ecddf7ed78f","f924752d8a1149668870b1e7698486f7",22900626,1,-6,0,122,56,50,-6
"f924752d8a1149668870b1e7698486f7","a1f2f12debe5432fb7a70bcd12bacfb9",22900626,1,9,0,123,50,58,8
"a1f2f12debe5432fb7a70bcd12bacfb9","78f30e4dcac84e3cbea8b2cc6e0d62b3",22900626,2,1,0,124,58,59,1
"78f30e4dcac84e3cbea8b2cc6e0d62b3","a1f2f12debe5432fb7a70bcd12bacfb9",22900626,1,-1,0,125,59,58,-1
"a1f2f12debe5432fb7a70bcd12bacfb9","a1f2f12debe5432fb7a70bcd12bacfb9",22900626,9,0,1,126,58,58,0
"78f30e4dcac84e3cbea8b2cc6e0d62b3","78f30e4dcac84e3cbea8b2cc6e0d62b3",22900626,8,0,1,136,59,59,0
"78f30e4dcac84e3cbea8b2cc6e0d62b3","bc42d26810654ea9a1df1efe1e58c7d5",22900626,1,5,0,144,59,63,4
"bc42d26810654ea9a1df1efe1e58c7d5","12aa6e1672ac4e7aa6449a7a8609cd72",22900626,1,-7,0,145,63,57,-6
"12aa6e1672ac4e7aa6449a7a8609cd72","a0a418b8540d479fa6e0f653b701da8b",22900626,1,8,0,146,57,64,7
"a0a418b8540d479fa6e0f653b701da8b","4c943503763e4e349906eea3ed3c8e86",22900626,1,-3,0,147,64,61,-3
"4c943503763e4e349906eea3ed3c8e86","4c943503763e4e349906eea3ed3c8e86",22900626,1,0,1,148,61,61,0
"4c943503763e4e349906eea3ed3c8e86","309ccf3cc4fe429d9bfbaef53d3fa479",22900626,1,-1,0,149,61,60,-1
"309ccf3cc4fe429d9bfbaef53d3fa479","7af822066add4e7f8e007e4eee31a8bf",22900626,1,6,0,150,60,65,5
"7af822066add4e7f8e007e4eee31a8bf","a0a418b8540d479fa6e0f653b701da8b",22900626,1,-2,0,151,65,64,-1
"a0a418b8540d479fa6e0f653b701da8b","bc42d26810654ea9a1df1efe1e58c7d5",22900626,1,-1,0,152,64,63,-1
"bc42d26810654ea9a1df1efe1e58c7d5","309ccf3cc4fe429d9bfbaef53d3fa479",22900626,1,-3,0,153,63,60,-3
"309ccf3cc4fe429d9bfbaef53d3fa479","b534b89233134e30a9b5645138bfa9ee",22900626,1,-23,0,154,60,41,-19
"b534b89233134e30a9b5645138bfa9ee","d646286c8051419bbc2e31dd1db55ca8",22900626,1,33,0,155,41,67,26
"d646286c8051419bbc2e31dd1db55ca8","d646286c8051419bbc2e31dd1db55ca8",22900626,6,0,1,156,67,67,0
"d646286c8051419bbc2e31dd1db55ca8","267f883678b24aed855fde42524975d9",22900626,1,4,0,158,67,71,4
"267f883678b24aed855fde42524975d9","267f883678b24aed855fde42524975d9",22900626,1,0,1,159,71,71,0
"267f883678b24aed855fde42524975d9","88fff56d0342490dbef9040750a20f6c",22900626,1,1,0,160,71,72,1
"88fff56d0342490dbef9040750a20f6c","88fff56d0342490dbef9040750a20f6c",22900626,1,0,1,161,72,72,0
"88fff56d0342490dbef9040750a20f6c","adb17b12b66c4a49a85fd34322f7df70",22900626,1,1,0,162,72,73,1
"adb17b12b66c4a49a85fd34322f7df70","adb17b12b66c4a49a85fd34322f7df70",22900626,1,0,1,163,73,73,0
"adb17b12b66c4a49a85fd34322f7df70","d646286c8051419bbc2e31dd1db55ca8",22900626,1,-6,0,164,73,67,-6
"d646286c8051419bbc2e31dd1db55ca8","a2becd407db34b189200a32546d9d569",22900626,3,9,0,165,67,75,8
"a2becd407db34b189200a32546d9d569","a2becd407db34b189200a32546d9d569",22900626,3,0,1,166,75,75,0
"a2becd407db34b189200a32546d9d569","d646286c8051419bbc2e31dd1db55ca8",22900626,2,-9,0,167,75,67,-8
"a2becd407db34b189200a32546d9d569","58c22b011d0f4c2ea6d13615edbb9eeb",22900626,1,2,0,173,75,77,2
"58c22b011d0f4c2ea6d13615edbb9eeb","58c22b011d0f4c2ea6d13615edbb9eeb",22900626,8,0,1,174,77,77,0
"58c22b011d0f4c2ea6d13615edbb9eeb","dd76e1861dc9461c830888729d091ee0",22900626,1,1,0,182,77,78,1
"dd76e1861dc9461c830888729d091ee0","dd76e1861dc9461c830888729d091ee0",22900626,5,0,1,183,78,78,0
"dd76e1861dc9461c830888729d091ee0","cd1d828f1a694b87913a7ea66c23803e",22900626,1,1,0,188,78,79,1
"cd1d828f1a694b87913a7ea66c23803e","cd1d828f1a694b87913a7ea66c23803e",22900626,5,0,1,189,79,79,0
"cd1d828f1a694b87913a7ea66c23803e","9176a3c2b4d2465fa8b0c67096c2a97e",22900626,1,1,0,194,79,80,1
"9176a3c2b4d2465fa8b0c67096c2a97e","9176a3c2b4d2465fa8b0c67096c2a97e",22900626,5,0,1,195,80,80,0
"9176a3c2b4d2465fa8b0c67096c2a97e","f8ec6445f7194e25b9101d4fbcb07a18",22900626,1,1,0,200,80,81,1
"f8ec6445f7194e25b9101d4fbcb07a18","f8ec6445f7194e25b9101d4fbcb07a18",22900626,2,0,1,201,81,81,0
"f8ec6445f7194e25b9101d4fbcb07a18","140d5b27b8574befad82c0a013b59dfa",22900626,1,-7,0,203,81,74,-7
"140d5b27b8574befad82c0a013b59dfa","d18a9ea32855445f8736581f5cb119ce",22900626,1,9,0,204,74,82,8
"d18a9ea32855445f8736581f5cb119ce","f564483cbd7a407681aa2fcca518cf5f",22900626,1,4,0,205,82,85,3
"18fd01350bd5434ca636d59a599d768a","18fd01350bd5434ca636d59a599d768a",22900626,9,0,1,212,86,86,0
"6a9f0ef185fb47f0937e29daa1c71ed5","c681290961c94c4caf23b529d1ae6b9a",22900626,1,-2,0,223,90,88,-2
"c681290961c94c4caf23b529d1ae6b9a","c681290961c94c4caf23b529d1ae6b9a",22900626,1,0,1,224,88,88,0
"c681290961c94c4caf23b529d1ae6b9a","6a9f0ef185fb47f0937e29daa1c71ed5",22900626,1,2,0,225,88,90,2
"6a9f0ef185fb47f0937e29daa1c71ed5","e20db35ced8544ddac5bc3839145e463",22900626,2,3,0,229,90,91,1
"e20db35ced8544ddac5bc3839145e463","d646286c8051419bbc2e31dd1db55ca8",22900626,2,-30,0,230,91,67,-24
"d646286c8051419bbc2e31dd1db55ca8","e20db35ced8544ddac5bc3839145e463",22900626,2,30,0,232,67,91,24
"e20db35ced8544ddac5bc3839145e463","1febb706d7a34005ae8711ed49c76e64",22900626,1,3,0,233,91,94,3
"1febb706d7a34005ae8711ed49c76e64","1febb706d7a34005ae8711ed49c76e64",22900626,2,0,1,234,94,94,0
"1febb706d7a34005ae8711ed49c76e64","8f73ba6f5a0042f2850356ac38ac6f24",22900626,1,1,0,236,94,95,1
"8f73ba6f5a0042f2850356ac38ac6f24","8f73ba6f5a0042f2850356ac38ac6f24",22900626,5,0,1,237,95,95,0
"8f73ba6f5a0042f2850356ac38ac6f24","e2260b86653c46d7b14a41fb419dbf8c",22900626,1,1,0,242,95,96,1
"e2260b86653c46d7b14a41fb419dbf8c","e2260b86653c46d7b14a41fb419dbf8c",22900626,2,0,1,243,96,96,0
"e2260b86653c46d7b14a41fb419dbf8c","35eb641ad1d845bbba54915bce75a962",22900626,1,1,0,245,96,97,1
"35eb641ad1d845bbba54915bce75a962","35eb641ad1d845bbba54915bce75a962",22900626,5,0,1,246,97,97,0
"35eb641ad1d845bbba54915bce75a962","08be90ffbeea4795a138cd42ed8db56f",22900626,1,1,0,251,97,98,1
"08be90ffbeea4795a138cd42ed8db56f","08be90ffbeea4795a138cd42ed8db56f",22900626,2,0,1,252,98,98,0
"08be90ffbeea4795a138cd42ed8db56f","3007433c8f584dcbb5ac159c1c5f2be3",22900626,1,1,0,254,98,99,1
"3007433c8f584dcbb5ac159c1c5f2be3","3007433c8f584dcbb5ac159c1c5f2be3",22900626,5,0,1,255,99,99,0
"3007433c8f584dcbb5ac159c1c5f2be3","e20db35ced8544ddac5bc3839145e463",22900626,1,-8,0,260,99,91,-8
"e20db35ced8544ddac5bc3839145e463","00ae5f0c51874a73a41ebea838d95682",22900626,2,11,0,261,91,101,10
"00ae5f0c51874a73a41ebea838d95682","d391c8b6e56a43a7b654e9dee02d904b",22900626,2,2,0,262,101,103,2
"d391c8b6e56a43a7b654e9dee02d904b","00ae5f0c51874a73a41ebea838d95682",22900626,1,-2,0,263,103,101,-2
"d391c8b6e56a43a7b654e9dee02d904b","d391c8b6e56a43a7b654e9dee02d904b",22900626,16,0,1,265,103,103,0
"d391c8b6e56a43a7b654e9dee02d904b","6111116566fc4fd9abba409322bea245",22900626,1,1,0,281,103,104,1
"6111116566fc4fd9abba409322bea245","6111116566fc4fd9abba409322bea245",22900626,2,0,1,282,104,104,0
"6111116566fc4fd9abba409322bea245","a81b2235cb9c499eb9ea8ee0a8dd9725",22900626,1,1,0,284,104,105,1
"a81b2235cb9c499eb9ea8ee0a8dd9725","a81b2235cb9c499eb9ea8ee0a8dd9725",22900626,5,0,1,285,105,105,0
"a81b2235cb9c499eb9ea8ee0a8dd9725","2d4e0ab0ef3b4d73b82c72d4621a7579",22900626,1,1,0,290,105,106,1
"2d4e0ab0ef3b4d73b82c72d4621a7579","2d4e0ab0ef3b4d73b82c72d4621a7579",22900626,2,0,1,291,106,106,0
"2d4e0ab0ef3b4d73b82c72d4621a7579","8bdebf492ebd4e62b0d522e8ab5e5197",22900626,1,1,0,293,106,107,1
"8bdebf492ebd4e62b0d522e8ab5e5197","8bdebf492ebd4e62b0d522e8ab5e5197",22900626,2,0,1,294,107,107,0
"8bdebf492ebd4e62b0d522e8ab5e5197","73039f8c1eb9409cb4caee2cf968001e",22900626,1,-7,0,296,107,100,-7
"73039f8c1eb9409cb4caee2cf968001e","4280927ec4d643238aa49c32f9e06c6c",22900626,1,10,0,297,100,109,9
"4280927ec4d643238aa49c32f9e06c6c","4280927ec4d643238aa49c32f9e06c6c",22900626,4,0,1,298,109,109,0
"4280927ec4d643238aa49c32f9e06c6c","fc44e6a5f7654430af1227838224dceb",22900626,1,2,0,302,109,111,2
"fc44e6a5f7654430af1227838224dceb","fc44e6a5f7654430af1227838224dceb",22900626,2,0,1,303,111,111,0
"fc44e6a5f7654430af1227838224dceb","08111f75e22d409998cf8b85bd431f0a",22900626,1,-3,0,305,111,108,-3
"a9ae0a3c070d455bb4369a8996313336","a9ae0a3c070d455bb4369a8996313336",22900626,1,0,1,307,114,114,0
"a9ae0a3c070d455bb4369a8996313336","71cec822bcff4f30a20e75dc63ef7b65",22900626,1,2,0,308,114,116,2
"71cec822bcff4f30a20e75dc63ef7b65","71cec822bcff4f30a20e75dc63ef7b65",22900626,1,0,1,309,116,116,0
"71cec822bcff4f30a20e75dc63ef7b65","37319e88176d4aefa91d7a9980dbae91",22900626,1,-4,0,310,116,112,-4
"37319e88176d4aefa91d7a9980dbae91","62bff51286ef4f348717a3cf6fe2318f",22900626,2,9,0,311,112,120,8
"62bff51286ef4f348717a3cf6fe2318f","b1cd0e7dc3ad4a8eb91a4bfdbeb025b0",22900626,1,-2,0,312,120,118,-2
"b1cd0e7dc3ad4a8eb91a4bfdbeb025b0","b1cd0e7dc3ad4a8eb91a4bfdbeb025b0",22900626,1,0,1,313,118,118,0
"b1cd0e7dc3ad4a8eb91a4bfdbeb025b0","62bff51286ef4f348717a3cf6fe2318f",22900626,1,2,0,314,118,120,2
"62bff51286ef4f348717a3cf6fe2318f","62bff51286ef4f348717a3cf6fe2318f",22900626,5,0,1,315,120,120,0
"62bff51286ef4f348717a3cf6fe2318f","779f9ddd1fd14d1e9e69f72219a1fdbd",22900626,2,3,0,318,120,121,1
"779f9ddd1fd14d1e9e69f72219a1fdbd","e20db35ced8544ddac5bc3839145e463",22900626,2,-36,0,319,121,91,-30
"e20db35ced8544ddac5bc3839145e463","ae26e6cda8ad4a3f81bd347560d9579f",22900626,1,40,0,320,91,125,34
"ae26e6cda8ad4a3f81bd347560d9579f","ae26e6cda8ad4a3f81bd347560d9579f",22900626,1,0,1,321,125,125,0
"ae26e6cda8ad4a3f81bd347560d9579f","ee48df95832b4374aa273ceb27ec1315",22900626,1,1,0,322,125,126,1
"ee48df95832b4374aa273ceb27ec1315","ee48df95832b4374aa273ceb27ec1315",22900626,3,0,1,323,126,126,0
"ee48df95832b4374aa273ceb27ec1315","7a439da90b394756ad1777fc4c6dead5",22900626,1,1,0,326,126,127,1
"7a439da90b394756ad1777fc4c6dead5","7a439da90b394756ad1777fc4c6dead5",22900626,1,0,1,327,127,127,0
"7a439da90b394756ad1777fc4c6dead5","779f9ddd1fd14d1e9e69f72219a1fdbd",22900626,1,-6,0,328,127,121,-6
"779f9ddd1fd14d1e9e69f72219a1fdbd","a8dd5213034441ac92724b4e83eb0bb2",22900626,2,9,0,329,121,129,8
"a8dd5213034441ac92724b4e83eb0bb2","a8dd5213034441ac92724b4e83eb0bb2",22900626,3,0,1,330,129,129,0
"a8dd5213034441ac92724b4e83eb0bb2","e20db35ced8544ddac5bc3839145e463",22900626,1,-45,0,331,129,91,-38
"e20db35ced8544ddac5bc3839145e463","e20db35ced8544ddac5bc3839145e463",22900626,1,0,1,332,91,91,0
"e20db35ced8544ddac5bc3839145e463","579338175e0b4bbb8ef3b712b5d8b54e",22900626,1,44,0,333,91,128,37
"579338175e0b4bbb8ef3b712b5d8b54e","579338175e0b4bbb8ef3b712b5d8b54e",22900626,1,0,1,334,128,128,0
"579338175e0b4bbb8ef3b712b5d8b54e","779f9ddd1fd14d1e9e69f72219a1fdbd",22900626,1,-8,0,335,128,121,-7
"a8dd5213034441ac92724b4e83eb0bb2","8115eab6556b45f5b415c3b8c26a12e5",22900626,1,2,0,339,129,131,2
"8115eab6556b45f5b415c3b8c26a12e5","8115eab6556b45f5b415c3b8c26a12e5",22900626,5,0,1,340,131,131,0
"8115eab6556b45f5b415c3b8c26a12e5","ec34b06efd844b46a4c4818ecdb9b8f4",22900626,1,1,0,345,131,132,1
"ec34b06efd844b46a4c4818ecdb9b8f4","ec34b06efd844b46a4c4818ecdb9b8f4",22900626,8,0,1,346,132,132,0
"ec34b06efd844b46a4c4818ecdb9b8f4","c2e1c2b9eac64109b343a088584b576b",22900626,1,1,0,354,132,133,1
"c2e1c2b9eac64109b343a088584b576b","c2e1c2b9eac64109b343a088584b576b",22900626,2,0,1,355,133,133,0
"c2e1c2b9eac64109b343a088584b576b","579338175e0b4bbb8ef3b712b5d8b54e",22900626,1,-5,0,357,133,128,-5
"579338175e0b4bbb8ef3b712b5d8b54e","8bc5795d6a984a3eace4e2811e52dd4f",22900626,1,8,0,358,128,135,7
"8bc5795d6a984a3eace4e2811e52dd4f","8bc5795d6a984a3eace4e2811e52dd4f",22900626,5,0,1,359,135,135,0
"8bc5795d6a984a3eace4e2811e52dd4f","b416d47c56a742199b5d7c7f19d6503a",22900626,1,-1,0,364,135,134,-1
"b416d47c56a742199b5d7c7f19d6503a","cd4532ad48034873ba8bce2aac0c9808",22900626,1,4,0,365,134,137,3
"6c5ad271a44743479bfaea29b1db8d02","6c5ad271a44743479bfaea29b1db8d02",22900626,1,0,1,370,143,143,0
"6c5ad271a44743479bfaea29b1db8d02","83d311bed5374fee83d8d67a7d9d82dc",22900626,1,1,0,371,143,144,1
"83d311bed5374fee83d8d67a7d9d82dc","83d311bed5374fee83d8d67a7d9d82dc",22900626,1,0,1,372,144,144,0
"83d311bed5374fee83d8d67a7d9d82dc","402bba41861d43acb52a5abb89e8831e",22900626,1,1,0,373,144,145,1
"402bba41861d43acb52a5abb89e8831e","402bba41861d43acb52a5abb89e8831e",22900626,2,0,1,374,145,145,0
"402bba41861d43acb52a5abb89e8831e","8aae34f5ddbb4052a709b12e6b0d40fa",22900626,1,3,0,376,145,147,2
"8aae34f5ddbb4052a709b12e6b0d40fa","df1de691dafe4549a18a4398ee9dfaf9",22900626,1,-9,0,377,147,139,-8
"df1de691dafe4549a18a4398ee9dfaf9","8aae34f5ddbb4052a709b12e6b0d40fa",22900626,1,9,0,378,139,147,8
"8aae34f5ddbb4052a709b12e6b0d40fa","645b3f0249f64f76af2e19eb4d0e55b7",22900626,1,2,0,379,147,149,2
"645b3f0249f64f76af2e19eb4d0e55b7","645b3f0249f64f76af2e19eb4d0e55b7",22900626,2,0,1,380,149,149,0
"645b3f0249f64f76af2e19eb4d0e55b7","7e7b8db5064d4369805ab370aac5ddfb",22900626,1,1,0,382,149,150,1
"7e7b8db5064d4369805ab370aac5ddfb","7e7b8db5064d4369805ab370aac5ddfb",22900626,2,0,1,383,150,150,0
"7e7b8db5064d4369805ab370aac5ddfb","8956d210ae7f41968fada86d4c979d6a",22900626,1,1,0,385,150,151,1
"8956d210ae7f41968fada86d4c979d6a","8956d210ae7f41968fada86d4c979d6a",22900626,2,0,1,386,151,151,0
"8956d210ae7f41968fada86d4c979d6a","f902b0f41b544d4dbf79664fd233648d",22900626,1,-5,0,388,151,146,-5
"f902b0f41b544d4dbf79664fd233648d","ae781e8b775e4ccd93bc800dad5c8376",22900626,1,8,0,389,146,153,7
"ae781e8b775e4ccd93bc800dad5c8376","ae781e8b775e4ccd93bc800dad5c8376",22900626,2,0,1,390,153,153,0
"ae781e8b775e4ccd93bc800dad5c8376","06882a8492d9499aa31555567f575ecb",22900626,1,1,0,392,153,154,1
"06882a8492d9499aa31555567f575ecb","06882a8492d9499aa31555567f575ecb",22900626,1,0,1,393,154,154,0
"06882a8492d9499aa31555567f575ecb","f293c508f409466a8f27ddd7d1e40b20",22900626,1,1,0,394,154,155,1
"f293c508f409466a8f27ddd7d1e40b20","f293c508f409466a8f27ddd7d1e40b20",22900626,9,0,1,395,155,155,0
"f293c508f409466a8f27ddd7d1e40b20","cc4ddef5bbbe48ebb605141b347c4ed1",22900626,1,1,0,404,155,156,1
"cc4ddef5bbbe48ebb605141b347c4ed1","cc4ddef5bbbe48ebb605141b347c4ed1",22900626,3,0,1,405,156,156,0
"cc4ddef5bbbe48ebb605141b347c4ed1","d313cec988a84645bee413e8d4724a4b",22900626,1,3,0,408,156,158,2
"d313cec988a84645bee413e8d4724a4b","f03480cf4eba413194d7af52fc0e7f28",22900626,1,-7,0,409,158,152,-6
"f03480cf4eba413194d7af52fc0e7f28","d313cec988a84645bee413e8d4724a4b",22900626,1,7,0,410,152,158,6
"d313cec988a84645bee413e8d4724a4b","d313cec988a84645bee413e8d4724a4b",22900626,3,0,1,411,158,158,0
"d313cec988a84645bee413e8d4724a4b","dc60696c76a74368a60f72246e47700d",22900626,1,1,0,414,158,159,1
"dc60696c76a74368a60f72246e47700d","dc60696c76a74368a60f72246e47700d",22900626,1,0,1,415,159,159,0
"dc60696c76a74368a60f72246e47700d","df1de691dafe4549a18a4398ee9dfaf9",22900626,1,-23,0,416,159,139,-20
"df1de691dafe4549a18a4398ee9dfaf9","78adeee1fa2c4fe0bc73f7bca9fcee86",22900626,1,26,0,417,139,160,21
"78adeee1fa2c4fe0bc73f7bca9fcee86","ae5ac430ea254e708a6f5deaaf7464ae",22900626,1,-95,0,418,160,84,-76
"d646286c8051419bbc2e31dd1db55ca8","ae5ac430ea254e708a6f5deaaf7464ae",22900626,1,20,0,420,67,84,17
"6a9f0ef185fb47f0937e29daa1c71ed5","f8c6e9dd315640039488619b16128971",22900626,1,90,0,424,90,162,72
"f8c6e9dd315640039488619b16128971","f8c6e9dd315640039488619b16128971",22900626,1,0,1,425,162,162,0
"f8c6e9dd315640039488619b16128971","78adeee1fa2c4fe0bc73f7bca9fcee86",22900626,1,-2,0,426,162,160,-2
"78adeee1fa2c4fe0bc73f7bca9fcee86","65202579580f4ad38d734b4ee39d22a8",22900626,2,5,0,427,160,164,4
"65202579580f4ad38d734b4ee39d22a8","78adeee1fa2c4fe0bc73f7bca9fcee86",22900626,1,-5,0,428,164,160,-4
"65202579580f4ad38d734b4ee39d22a8","65202579580f4ad38d734b4ee39d22a8",22900626,49,0,1,430,164,164,0
"65202579580f4ad38d734b4ee39d22a8","3cbcea2be0984e7dbd5a48195af10ce7",22900626,1,3,0,479,164,165,1
"3cbcea2be0984e7dbd5a48195af10ce7","78adeee1fa2c4fe0bc73f7bca9fcee86",22900626,1,-8,0,480,165,160,-5
"78adeee1fa2c4fe0bc73f7bca9fcee86","82e6285962b8400d9d6fc32436022a94",22900626,1,10,0,481,160,167,7
"82e6285962b8400d9d6fc32436022a94","a9ac840f098c4bd0a2ee896214ce29cd",22900626,1,3,0,482,167,168,1
"a9ac840f098c4bd0a2ee896214ce29cd","3cbcea2be0984e7dbd5a48195af10ce7",22900626,1,-5,0,483,168,165,-3
"a9ac840f098c4bd0a2ee896214ce29cd","a9ac840f098c4bd0a2ee896214ce29cd",22900626,3,0,1,485,168,168,0
"a9ac840f098c4bd0a2ee896214ce29cd","d646286c8051419bbc2e31dd1db55ca8",22900626,1,-128,0,488,168,67,-101
"e20db35ced8544ddac5bc3839145e463","d391c8b6e56a43a7b654e9dee02d904b",22900626,1,13,0,497,91,103,12
"d391c8b6e56a43a7b654e9dee02d904b","e20db35ced8544ddac5bc3839145e463",22900626,1,-13,0,498,103,91,-12
"00ae5f0c51874a73a41ebea838d95682","ae5ac430ea254e708a6f5deaaf7464ae",22900626,1,-21,0,500,101,84,-17
"d646286c8051419bbc2e31dd1db55ca8","4280927ec4d643238aa49c32f9e06c6c",22900626,1,50,0,508,67,109,42
"4280927ec4d643238aa49c32f9e06c6c","e20db35ced8544ddac5bc3839145e463",22900626,1,-20,0,509,109,91,-18
"a9ae0a3c070d455bb4369a8996313336","37319e88176d4aefa91d7a9980dbae91",22900626,1,-2,0,512,114,112,-2
"e20db35ced8544ddac5bc3839145e463","779f9ddd1fd14d1e9e69f72219a1fdbd",22900626,1,36,0,518,91,121,30
"6c5ad271a44743479bfaea29b1db8d02","3cbcea2be0984e7dbd5a48195af10ce7",22900626,1,30,0,524,143,165,22
"a9ac840f098c4bd0a2ee896214ce29cd","0c7262dff33c4087bc660ccf40f92f9c",22900626,1,4,0,529,168,169,1
"0c7262dff33c4087bc660ccf40f92f9c","0c7262dff33c4087bc660ccf40f92f9c",22900626,2,0,1,530,169,169,0
"0c7262dff33c4087bc660ccf40f92f9c","b2275c3fad834f8d90737a2d9a6927d6",22900626,1,3,0,531,169,172,3
"b2275c3fad834f8d90737a2d9a6927d6","b2275c3fad834f8d90737a2d9a6927d6",22900626,34,0,1,532,172,172,0
"b2275c3fad834f8d90737a2d9a6927d6","eb515a26030b41f8a82a1e6114420bad",22900626,1,1,0,566,172,173,1
"eb515a26030b41f8a82a1e6114420bad","eb515a26030b41f8a82a1e6114420bad",22900626,2,0,1,567,173,173,0
"eb515a26030b41f8a82a1e6114420bad","b42cc17b7de840f181a704558d0bc845",22900626,1,3,0,569,173,175,2
"b42cc17b7de840f181a704558d0bc845","0c7262dff33c4087bc660ccf40f92f9c",22900626,1,-7,0,570,175,169,-6
"0c7262dff33c4087bc660ccf40f92f9c","b42cc17b7de840f181a704558d0bc845",22900626,1,7,0,571,169,175,6
"b42cc17b7de840f181a704558d0bc845","801f9e9135034f49bf5f8b4bdefedb41",22900626,1,2,0,572,175,177,2
"801f9e9135034f49bf5f8b4bdefedb41","801f9e9135034f49bf5f8b4bdefedb41",22900626,4,0,1,573,177,177,0
"801f9e9135034f49bf5f8b4bdefedb41","362fcb0699a14845ab29b2340093e528",22900626,1,-3,0,577,177,174,-3
"362fcb0699a14845ab29b2340093e528","ea38cc0e6e6e41edbabf210220808bf9",22900626,1,6,0,578,174,179,5
"b87c552dd247427abe6ab5795b9c9d43","b87c552dd247427abe6ab5795b9c9d43",22900626,7,0,1,582,181,181,0
"139b097acfca451689d80c9c6eebdf7b","30f660a1feb34582a739722532524f79",22900626,1,6,0,590,178,183,5
"30f660a1feb34582a739722532524f79","30f660a1feb34582a739722532524f79",22900626,5,0,1,591,183,183,0
"30f660a1feb34582a739722532524f79","2024b4885bd14338a39b7b509acbbd02",22900626,1,-1,0,596,183,182,-1
"2024b4885bd14338a39b7b509acbbd02","c3f63fe50d8e487c86bf8ef76c9cadd3",22900626,1,4,0,597,182,185,3
"c3f63fe50d8e487c86bf8ef76c9cadd3","c3f63fe50d8e487c86bf8ef76c9cadd3",22900626,1,0,1,598,185,185,0
"c3f63fe50d8e487c86bf8ef76c9cadd3","0c7262dff33c4087bc660ccf40f92f9c",22900626,1,-20,0,599,185,169,-16
"0c7262dff33c4087bc660ccf40f92f9c","c8e371568a0c4391b25796ae4e91952e",22900626,1,23,0,600,169,186,17
"c8e371568a0c4391b25796ae4e91952e","7d932b23e1c84326ae5aa4d3c0d813d1",22900626,1,2,0,601,186,188,2
"7d932b23e1c84326ae5aa4d3c0d813d1","7d932b23e1c84326ae5aa4d3c0d813d1",22900626,1,0,1,602,188,188,0
"7d932b23e1c84326ae5aa4d3c0d813d1","ab11d94c6c8948ea90b88f19d2cd502b",22900626,1,3,0,603,188,190,2
"ab11d94c6c8948ea90b88f19d2cd502b","c8e371568a0c4391b25796ae4e91952e",22900626,1,-5,0,604,190,186,-4
"c8e371568a0c4391b25796ae4e91952e","ab11d94c6c8948ea90b88f19d2cd502b",22900626,2,5,0,605,186,190,4
"ab11d94c6c8948ea90b88f19d2cd502b","f992451ed6ad4e68bb9e68ad6be7c4be",22900626,1,2,0,606,190,192,2
"f992451ed6ad4e68bb9e68ad6be7c4be","f992451ed6ad4e68bb9e68ad6be7c4be",22900626,1,0,1,607,192,192,0
"f992451ed6ad4e68bb9e68ad6be7c4be","07b44a7a51e94c78b411c753fc39dab0",22900626,1,-3,0,608,192,189,-3
"07b44a7a51e94c78b411c753fc39dab0","6cd2dcaac46847d4a0bc53f296d90375",22900626,2,6,0,609,189,194,5
"6cd2dcaac46847d4a0bc53f296d90375","6cd2dcaac46847d4a0bc53f296d90375",22900626,3,0,1,610,194,194,0
"6cd2dcaac46847d4a0bc53f296d90375","2d2580c9411c4972909db508d6956a58",22900626,1,2,0,612,194,196,2
"2d2580c9411c4972909db508d6956a58","2d2580c9411c4972909db508d6956a58",22900626,2,0,1,613,196,196,0
"2d2580c9411c4972909db508d6956a58","5bddb3d9ed264f3984702f048c7e5340",22900626,1,1,0,615,196,197,1
"5bddb3d9ed264f3984702f048c7e5340","5bddb3d9ed264f3984702f048c7e5340",22900626,2,0,1,616,197,197,0
"5bddb3d9ed264f3984702f048c7e5340","d5e8e2bd12a2466b9d6d90855f0eb079",22900626,1,1,0,618,197,198,1
"d5e8e2bd12a2466b9d6d90855f0eb079","d5e8e2bd12a2466b9d6d90855f0eb079",22900626,2,0,1,619,198,198,0
"d5e8e2bd12a2466b9d6d90855f0eb079","017d7ca8e0394b91aaadc9574df2202c",22900626,1,-5,0,621,198,193,-5
"017d7ca8e0394b91aaadc9574df2202c","54e8e9f0ea3e45c4bf3b8ac799ee31b1",22900626,1,8,0,622,193,200,7
"54e8e9f0ea3e45c4bf3b8ac799ee31b1","54e8e9f0ea3e45c4bf3b8ac799ee31b1",22900626,1,0,1,623,200,200,0
"54e8e9f0ea3e45c4bf3b8ac799ee31b1","c614a00911be4877a075f19315530fb0",22900626,1,1,0,624,200,201,1
"c614a00911be4877a075f19315530fb0","c614a00911be4877a075f19315530fb0",22900626,6,0,1,625,201,201,0
"c614a00911be4877a075f19315530fb0","a6c21bd8b95249c7972820a7a7d76aff",22900626,1,1,0,631,201,202,1
"a6c21bd8b95249c7972820a7a7d76aff","a6c21bd8b95249c7972820a7a7d76aff",22900626,1,0,1,632,202,202,0
"a6c21bd8b95249c7972820a7a7d76aff","bb329d880ab54120adaf203a693bb203",22900626,1,1,0,633,202,203,1
"bb329d880ab54120adaf203a693bb203","bb329d880ab54120adaf203a693bb203",22900626,2,0,1,634,203,203,0
"bb329d880ab54120adaf203a693bb203","0c7262dff33c4087bc660ccf40f92f9c",22900626,1,-43,0,635,203,169,-34
"0c7262dff33c4087bc660ccf40f92f9c","a9ac840f098c4bd0a2ee896214ce29cd",22900626,1,-4,0,636,169,168,-1
"a9ac840f098c4bd0a2ee896214ce29cd","c8e371568a0c4391b25796ae4e91952e",22900626,1,27,0,637,168,186,18
"c8e371568a0c4391b25796ae4e91952e","c8e371568a0c4391b25796ae4e91952e",22900626,3,0,1,638,186,186,0
"ab11d94c6c8948ea90b88f19d2cd502b","07b44a7a51e94c78b411c753fc39dab0",22900626,1,-1,0,641,190,189,-1
"6cd2dcaac46847d4a0bc53f296d90375","017d7ca8e0394b91aaadc9574df2202c",22900626,2,-1,0,643,194,193,-1
"017d7ca8e0394b91aaadc9574df2202c","bb329d880ab54120adaf203a693bb203",22900626,1,11,0,644,193,203,10
"bb329d880ab54120adaf203a693bb203","f9170dd6bc6442b4acd832747609b09a",22900626,1,-4,0,646,203,199,-4
"f9170dd6bc6442b4acd832747609b09a","334c2344009840079b1d0e1b7ce3d5a7",22900626,1,7,0,647,199,205,6
"334c2344009840079b1d0e1b7ce3d5a7","334c2344009840079b1d0e1b7ce3d5a7",22900626,2,0,1,648,205,205,0
"334c2344009840079b1d0e1b7ce3d5a7","c8e371568a0c4391b25796ae4e91952e",22900626,2,-23,0,649,205,186,-19
"c8e371568a0c4391b25796ae4e91952e","334c2344009840079b1d0e1b7ce3d5a7",22900626,1,23,0,651,186,205,19
"c8e371568a0c4391b25796ae4e91952e","d7f13c8d63ec4e2aa673fbb9cf9c6933",22900626,2,26,0,654,186,206,20
"d7f13c8d63ec4e2aa673fbb9cf9c6933","b9e80f77c3a44349863b19875725c384",22900626,1,1,0,655,206,207,1
"b9e80f77c3a44349863b19875725c384","7108f0e4c2584f1f9c471689ae4c885c",22900626,2,1,0,656,207,208,1
"7108f0e4c2584f1f9c471689ae4c885c","b9e80f77c3a44349863b19875725c384",22900626,2,-1,0,657,208,207,-1
"b9e80f77c3a44349863b19875725c384","b9e80f77c3a44349863b19875725c384",22900626,13,0,1,658,207,207,0
"7108f0e4c2584f1f9c471689ae4c885c","7108f0e4c2584f1f9c471689ae4c885c",22900626,20,0,1,672,208,208,0
"7108f0e4c2584f1f9c471689ae4c885c","09400e101c5d4b439cf9a26b03aae558",22900626,1,3,0,692,208,210,2
"09400e101c5d4b439cf9a26b03aae558","d7f13c8d63ec4e2aa673fbb9cf9c6933",22900626,1,-5,0,693,210,206,-4
"d7f13c8d63ec4e2aa673fbb9cf9c6933","09400e101c5d4b439cf9a26b03aae558",22900626,1,5,0,694,206,210,4
"09400e101c5d4b439cf9a26b03aae558","a88efa7e50ce47159810ab553afa6d3a",22900626,1,2,0,695,210,212,2
"a88efa7e50ce47159810ab553afa6d3a","a88efa7e50ce47159810ab553afa6d3a",22900626,2,0,1,696,212,212,0
"a88efa7e50ce47159810ab553afa6d3a","be502a7a43c44bf7b682698de79d9369",22900626,1,3,0,698,212,214,2
"be502a7a43c44bf7b682698de79d9369","a875096404ef4a9984b62d74cda916f9",22900626,1,-6,0,699,214,209,-5
"a875096404ef4a9984b62d74cda916f9","f7fb1952f56b4189b86a9f8b7862d2b8",22900626,1,7,0,700,209,215,6
"f7fb1952f56b4189b86a9f8b7862d2b8","be502a7a43c44bf7b682698de79d9369",22900626,1,-1,0,701,215,214,-1
"be502a7a43c44bf7b682698de79d9369","f7fb1952f56b4189b86a9f8b7862d2b8",22900626,1,1,0,702,214,215,1
"f7fb1952f56b4189b86a9f8b7862d2b8","f7fb1952f56b4189b86a9f8b7862d2b8",22900626,13,0,1,703,215,215,0
"f7fb1952f56b4189b86a9f8b7862d2b8","b860ee85d8bc4a2f97958cfb71be3533",22900626,1,1,0,716,215,216,1
"b860ee85d8bc4a2f97958cfb71be3533","b860ee85d8bc4a2f97958cfb71be3533",22900626,2,0,1,717,216,216,0
"b860ee85d8bc4a2f97958cfb71be3533","ec341f459285443b8361f7f15638ff08",22900626,1,-3,0,719,216,213,-3
"363837c182e04711840d896ae1e0339c","363837c182e04711840d896ae1e0339c",22900626,19,0,1,721,218,218,0
"01b2051f8941460d89945e3b02d1ce78","91125ca626c5470eb145501f8c37f8db",22900626,1,4,0,741,217,220,3
"91125ca626c5470eb145501f8c37f8db","91125ca626c5470eb145501f8c37f8db",22900626,2,0,1,742,220,220,0
"91125ca626c5470eb145501f8c37f8db","1c6721b1f63f4d30ba7746ea8af02a52",22900626,1,3,0,743,220,221,1
"1c6721b1f63f4d30ba7746ea8af02a52","d7f13c8d63ec4e2aa673fbb9cf9c6933",22900626,3,-21,0,744,221,206,-15
"d7f13c8d63ec4e2aa673fbb9cf9c6933","77ecef8eff6b4a2caea7707669bf7475",22900626,1,22,0,745,206,222,16
"77ecef8eff6b4a2caea7707669bf7475","d646286c8051419bbc2e31dd1db55ca8",22900626,1,-203,0,746,222,67,-155
"d646286c8051419bbc2e31dd1db55ca8","91125ca626c5470eb145501f8c37f8db",22900626,1,199,0,747,67,220,153
"91125ca626c5470eb145501f8c37f8db","d7f13c8d63ec4e2aa673fbb9cf9c6933",22900626,1,-18,0,749,220,206,-14
"d7f13c8d63ec4e2aa673fbb9cf9c6933","d7f13c8d63ec4e2aa673fbb9cf9c6933",22900626,1,0,1,750,206,206,0
"d7f13c8d63ec4e2aa673fbb9cf9c6933","1c6721b1f63f4d30ba7746ea8af02a52",22900626,5,21,0,751,206,221,15
"1c6721b1f63f4d30ba7746ea8af02a52","77ecef8eff6b4a2caea7707669bf7475",22900626,4,1,0,752,221,222,1
"77ecef8eff6b4a2caea7707669bf7475","d7f13c8d63ec4e2aa673fbb9cf9c6933",22900626,1,-22,0,753,222,206,-16
"77ecef8eff6b4a2caea7707669bf7475","77ecef8eff6b4a2caea7707669bf7475",22900626,12,0,1,760,222,222,0
"77ecef8eff6b4a2caea7707669bf7475","1c6721b1f63f4d30ba7746ea8af02a52",22900626,2,-1,0,772,222,221,-1
"1c6721b1f63f4d30ba7746ea8af02a52","d03cb855c70044cf8c35d9ec0de696e3",22900626,2,4,0,773,221,224,3
"d03cb855c70044cf8c35d9ec0de696e3","8b9ae98743bd4d4a8a87dff1c1244211",22900626,2,3,0,774,224,227,3
"8b9ae98743bd4d4a8a87dff1c1244211","d03cb855c70044cf8c35d9ec0de696e3",22900626,2,-3,0,775,227,224,-3
"d03cb855c70044cf8c35d9ec0de696e3","a49a937d6896486d9a5396654abcf2e1",22900626,1,2,0,776,224,226,2
"a49a937d6896486d9a5396654abcf2e1","a49a937d6896486d9a5396654abcf2e1",22900626,3,0,1,777,226,226,0
"a49a937d6896486d9a5396654abcf2e1","8b9ae98743bd4d4a8a87dff1c1244211",22900626,1,1,0,780,226,227,1
"8b9ae98743bd4d4a8a87dff1c1244211","8b9ae98743bd4d4a8a87dff1c1244211",22900626,35,0,1,781,227,227,0
"8b9ae98743bd4d4a8a87dff1c1244211","2ab1535aac1346ba8801535bf729ef37",22900626,1,3,0,816,227,229,2
"2ab1535aac1346ba8801535bf729ef37","f7906d6f59b9489a91d2ef40db5a474d",22900626,1,-7,0,817,229,223,-6
"f7906d6f59b9489a91d2ef40db5a474d","2ab1535aac1346ba8801535bf729ef37",22900626,3,7,0,818,223,229,6
"2ab1535aac1346ba8801535bf729ef37","a4f40fb48a8542c8949bae1f002cd9bc",22900626,1,2,0,819,229,231,2
"a4f40fb48a8542c8949bae1f002cd9bc","a4f40fb48a8542c8949bae1f002cd9bc",22900626,5,0,1,820,231,231,0
"a4f40fb48a8542c8949bae1f002cd9bc","8972c23e32044edb8a78fa1eed4e5947",22900626,1,1,0,825,231,232,1
"8972c23e32044edb8a78fa1eed4e5947","8972c23e32044edb8a78fa1eed4e5947",22900626,1,0,1,826,232,232,0
"8972c23e32044edb8a78fa1eed4e5947","92feb4a40f8344d38b6f722e42a53295",22900626,1,1,0,827,232,233,1
"92feb4a40f8344d38b6f722e42a53295","92feb4a40f8344d38b6f722e42a53295",22900626,2,0,1,828,233,233,0
"92feb4a40f8344d38b6f722e42a53295","5152833676bf4c6cb317060be10f68db",22900626,1,-5,0,830,233,228,-5
"5152833676bf4c6cb317060be10f68db","ca3e28f290354c08aefe5b0f769604e6",22900626,1,8,0,831,228,235,7
"ca3e28f290354c08aefe5b0f769604e6","ca3e28f290354c08aefe5b0f769604e6",22900626,9,0,1,832,235,235,0
"ca3e28f290354c08aefe5b0f769604e6","79a35eea833e4c2c9d22fc53c3c6445c",22900626,1,1,0,841,235,236,1
"79a35eea833e4c2c9d22fc53c3c6445c","79a35eea833e4c2c9d22fc53c3c6445c",22900626,4,0,1,842,236,236,0
"79a35eea833e4c2c9d22fc53c3c6445c","8f68228b1518449e9615cdafee41a2bd",22900626,1,1,0,846,236,237,1
"8f68228b1518449e9615cdafee41a2bd","8f68228b1518449e9615cdafee41a2bd",22900626,1,0,1,847,237,237,0
"8f68228b1518449e9615cdafee41a2bd","cab89fa5c3ed45a5aa550fc0352d6a42",22900626,1,1,0,848,237,238,1
"cab89fa5c3ed45a5aa550fc0352d6a42","cab89fa5c3ed45a5aa550fc0352d6a42",22900626,6,0,1,849,238,238,0
"cab89fa5c3ed45a5aa550fc0352d6a42","66d4fad4f1cf4b46be0750a99ad7a35a",22900626,1,1,0,855,238,239,1
"66d4fad4f1cf4b46be0750a99ad7a35a","66d4fad4f1cf4b46be0750a99ad7a35a",22900626,2,0,1,856,239,239,0
"66d4fad4f1cf4b46be0750a99ad7a35a","cab89fa5c3ed45a5aa550fc0352d6a42",22900626,1,-1,0,857,239,238,-1
"cab89fa5c3ed45a5aa550fc0352d6a42","1c6721b1f63f4d30ba7746ea8af02a52",22900626,1,-20,0,858,238,221,-17
"77ecef8eff6b4a2caea7707669bf7475","8b9ae98743bd4d4a8a87dff1c1244211",22900626,1,6,0,860,222,227,5
"d03cb855c70044cf8c35d9ec0de696e3","1c6721b1f63f4d30ba7746ea8af02a52",22900626,1,-4,0,862,224,221,-3
"1c6721b1f63f4d30ba7746ea8af02a52","f7906d6f59b9489a91d2ef40db5a474d",22900626,1,3,0,863,221,223,2
"2ab1535aac1346ba8801535bf729ef37","5152833676bf4c6cb317060be10f68db",22900626,2,-1,0,865,229,228,-1
"5152833676bf4c6cb317060be10f68db","66d4fad4f1cf4b46be0750a99ad7a35a",22900626,1,12,0,866,228,239,11
"66d4fad4f1cf4b46be0750a99ad7a35a","0b04c8e2f86d48c7aeb7e225819cd32b",22900626,1,-5,0,868,239,234,-5
"0b04c8e2f86d48c7aeb7e225819cd32b","d7f13c8d63ec4e2aa673fbb9cf9c6933",22900626,1,-37,0,869,234,206,-28
"8b9ae98743bd4d4a8a87dff1c1244211","f7906d6f59b9489a91d2ef40db5a474d",22900626,1,-4,0,875,227,223,-4
"5152833676bf4c6cb317060be10f68db","0b04c8e2f86d48c7aeb7e225819cd32b",22900626,1,7,0,878,228,234,6
"0b04c8e2f86d48c7aeb7e225819cd32b","f53da5fd9bfe412da4b80d4742563b6c",22900626,1,8,0,879,234,241,7
"f53da5fd9bfe412da4b80d4742563b6c","f53da5fd9bfe412da4b80d4742563b6c",22900626,1,0,1,880,241,241,0
"f53da5fd9bfe412da4b80d4742563b6c","1c6721b1f63f4d30ba7746ea8af02a52",22900626,1,-24,0,881,241,221,-20
"1c6721b1f63f4d30ba7746ea8af02a52","2ae94c0cea4d480a9d5dca8fb1d7b542",22900626,1,27,0,882,221,242,21
"2ae94c0cea4d480a9d5dca8fb1d7b542","1ebf23f9d994469a85206e4c7b1bf5f5",22900626,2,3,0,883,242,245,3
"1ebf23f9d994469a85206e4c7b1bf5f5","0c7262dff33c4087bc660ccf40f92f9c",22900626,1,-100,0,884,245,169,-76
"0c7262dff33c4087bc660ccf40f92f9c","017d7ca8e0394b91aaadc9574df2202c",22900626,1,32,0,885,169,193,24
"017d7ca8e0394b91aaadc9574df2202c","c8e371568a0c4391b25796ae4e91952e",22900626,2,-9,0,886,193,186,-7
"c8e371568a0c4391b25796ae4e91952e","017d7ca8e0394b91aaadc9574df2202c",22900626,1,9,0,887,186,193,7
"c8e371568a0c4391b25796ae4e91952e","6cd2dcaac46847d4a0bc53f296d90375",22900626,1,10,0,889,186,194,8
"017d7ca8e0394b91aaadc9574df2202c","f9170dd6bc6442b4acd832747609b09a",22900626,1,7,0,892,193,199,6
"f9170dd6bc6442b4acd832747609b09a","c8e371568a0c4391b25796ae4e91952e",22900626,1,-16,0,893,199,186,-13
"d7f13c8d63ec4e2aa673fbb9cf9c6933","7108f0e4c2584f1f9c471689ae4c885c",22900626,1,2,0,895,206,208,2
"b9e80f77c3a44349863b19875725c384","d7f13c8d63ec4e2aa673fbb9cf9c6933",22900626,1,-1,0,897,207,206,-1
"d7f13c8d63ec4e2aa673fbb9cf9c6933","139b097acfca451689d80c9c6eebdf7b",22900626,1,-38,0,898,206,178,-28
"0c7262dff33c4087bc660ccf40f92f9c","139b097acfca451689d80c9c6eebdf7b",22900626,1,11,0,905,169,178,9
"b87c552dd247427abe6ab5795b9c9d43","d646286c8051419bbc2e31dd1db55ca8",22900626,1,-146,0,908,181,67,-114
"d646286c8051419bbc2e31dd1db55ca8","2ae94c0cea4d480a9d5dca8fb1d7b542",22900626,1,229,0,910,67,242,175
"2ae94c0cea4d480a9d5dca8fb1d7b542","2ae94c0cea4d480a9d5dca8fb1d7b542",22900626,1,0,1,911,242,242,0
"1ebf23f9d994469a85206e4c7b1bf5f5","1ebf23f9d994469a85206e4c7b1bf5f5",22900626,11,0,1,913,245,245,0
"1ebf23f9d994469a85206e4c7b1bf5f5","85ae675b83e8422da842cfd25596af99",22900626,1,1,0,924,245,246,1
"85ae675b83e8422da842cfd25596af99","85ae675b83e8422da842cfd25596af99",22900626,1,0,1,925,246,246,0
"85ae675b83e8422da842cfd25596af99","2ae94c0cea4d480a9d5dca8fb1d7b542",22900626,1,-4,0,926,246,242,-4
"2ae94c0cea4d480a9d5dca8fb1d7b542","fa235f0f364d47e4ae1c87f47bf8e6ba",22900626,1,12,0,927,242,252,10
"fa235f0f364d47e4ae1c87f47bf8e6ba","fa235f0f364d47e4ae1c87f47bf8e6ba",22900626,1,0,1,928,252,252,0
"fa235f0f364d47e4ae1c87f47bf8e6ba","79f7845465cc4ed19d8e4f1429541be0",22900626,1,2,0,929,252,254,2
"79f7845465cc4ed19d8e4f1429541be0","79f7845465cc4ed19d8e4f1429541be0",22900626,2,0,1,930,254,254,0
"79f7845465cc4ed19d8e4f1429541be0","00f61990949545828dd12f1303d47504",22900626,1,3,0,932,254,256,2
"00f61990949545828dd12f1303d47504","ead7bb4b64e247d2ae632ab8a296b091",22900626,1,2,0,935,256,258,2
"ead7bb4b64e247d2ae632ab8a296b091","ead7bb4b64e247d2ae632ab8a296b091",22900626,2,0,1,936,258,258,0
"ead7bb4b64e247d2ae632ab8a296b091","41b0048dde734bb280bac6116baa8e27",22900626,1,1,0,938,258,259,1
"41b0048dde734bb280bac6116baa8e27","41b0048dde734bb280bac6116baa8e27",22900626,2,0,1,939,259,259,0
"41b0048dde734bb280bac6116baa8e27","b41c5a094a604ee0915327da5cc0beb7",22900626,1,1,0,941,259,260,1
"b41c5a094a604ee0915327da5cc0beb7","b41c5a094a604ee0915327da5cc0beb7",22900626,5,0,1,942,260,260,0
"b41c5a094a604ee0915327da5cc0beb7","d546341988904f069cfa86b21457d9d9",22900626,1,-10,0,947,260,251,-9
"d546341988904f069cfa86b21457d9d9","28c171777c52431ab6b925073bd63d46",22900626,1,15,0,948,251,264,13
"28c171777c52431ab6b925073bd63d46","28c171777c52431ab6b925073bd63d46",22900626,3,0,1,949,264,264,0
"28c171777c52431ab6b925073bd63d46","ac160db940cb49ae8579162b1d52bb5d",22900626,1,2,0,952,264,266,2
"ac160db940cb49ae8579162b1d52bb5d","ac160db940cb49ae8579162b1d52bb5d",22900626,7,0,1,953,266,266,0
"ac160db940cb49ae8579162b1d52bb5d","d989ebcfc12a4b669f0100dc1aa14f1e",22900626,1,-12,0,960,266,255,-11
"d989ebcfc12a4b669f0100dc1aa14f1e","c6fd49b485cc4874b0bbdd9c6171e09c",22900626,1,15,0,961,255,268,13
"c6fd49b485cc4874b0bbdd9c6171e09c","c6fd49b485cc4874b0bbdd9c6171e09c",22900626,3,0,1,962,268,268,0
"c6fd49b485cc4874b0bbdd9c6171e09c","44240778a97c4af0937817499b75707b",22900626,1,1,0,965,268,269,1
"44240778a97c4af0937817499b75707b","44240778a97c4af0937817499b75707b",22900626,2,0,1,966,269,269,0
"44240778a97c4af0937817499b75707b","7aa76d3e993840d8805f097cbdbcd44b",22900626,1,-9,0,968,269,261,-8
"7aa76d3e993840d8805f097cbdbcd44b","865a4d3b43374da7944dc7d397f566d9",22900626,1,12,0,969,261,271,10
"865a4d3b43374da7944dc7d397f566d9","865a4d3b43374da7944dc7d397f566d9",22900626,1,0,1,970,271,271,0
"865a4d3b43374da7944dc7d397f566d9","0d987bed3ffa4ed0b9a2e62e97b7b30f",22900626,1,3,0,971,271,272,1
"0d987bed3ffa4ed0b9a2e62e97b7b30f","2ae94c0cea4d480a9d5dca8fb1d7b542",22900626,1,-38,0,972,272,242,-30
"0d987bed3ffa4ed0b9a2e62e97b7b30f","0d987bed3ffa4ed0b9a2e62e97b7b30f",22900626,2,0,1,974,272,272,0
"bb5a47f5ea01454a8b79455422d3b9da","82ae07bc0c9b4570a41799290d1ef399",22900626,1,-6,0,984,280,275,-5
"82ae07bc0c9b4570a41799290d1ef399","bb5a47f5ea01454a8b79455422d3b9da",22900626,1,6,0,985,275,280,5
"bb5a47f5ea01454a8b79455422d3b9da","bb5a47f5ea01454a8b79455422d3b9da",22900626,63,0,1,1000,280,280,0
"bb5a47f5ea01454a8b79455422d3b9da","0d987bed3ffa4ed0b9a2e62e97b7b30f",22900626,1,-10,0,1035,280,272,-8
"0d987bed3ffa4ed0b9a2e62e97b7b30f","94cecc3f1e7d484b8e068e79241dfd73",22900626,1,13,0,1036,272,281,9
"94cecc3f1e7d484b8e068e79241dfd73","a37477c4e4c14169ad44b06b493007f6",22900626,1,2,0,1037,281,283,2
"a37477c4e4c14169ad44b06b493007f6","fab84b4fab5940efb4ea868ef8d09396",22900626,1,3,0,1038,283,284,1
"fab84b4fab5940efb4ea868ef8d09396","94cecc3f1e7d484b8e068e79241dfd73",22900626,1,-5,0,1039,284,281,-3
"94cecc3f1e7d484b8e068e79241dfd73","4a29443515bb404cb8924e1c60a63b73",22900626,1,9,0,1040,281,285,4
"4a29443515bb404cb8924e1c60a63b73","fab84b4fab5940efb4ea868ef8d09396",22900626,1,-4,0,1041,285,284,-1
"fab84b4fab5940efb4ea868ef8d09396","208c9b2796c944db8dacaa96082520ea",22900626,1,7,0,1042,284,288,4
"208c9b2796c944db8dacaa96082520ea","208c9b2796c944db8dacaa96082520ea",22900626,1,0,1,1043,288,288,0
"208c9b2796c944db8dacaa96082520ea","4a29443515bb404cb8924e1c60a63b73",22900626,1,-3,0,1044,288,285,-3
"4a29443515bb404cb8924e1c60a63b73","7669a956527947d0add87455277e80b4",22900626,1,7,0,1045,285,291,6
"7669a956527947d0add87455277e80b4","7669a956527947d0add87455277e80b4",22900626,1,0,1,1046,291,291,0
"7669a956527947d0add87455277e80b4","6a9a3b5bde4a48daa896fe8c06eca56f",22900626,1,-2,0,1047,291,289,-2
"6a9a3b5bde4a48daa896fe8c06eca56f","869e967078f04da18dd0b0b9389a7424",22900626,1,5,0,1048,289,293,4
"869e967078f04da18dd0b0b9389a7424","869e967078f04da18dd0b0b9389a7424",22900626,3,0,1,1049,293,293,0
"869e967078f04da18dd0b0b9389a7424","51ab6291537748fab90d519aa09889d6",22900626,1,2,0,1052,293,295,2
"51ab6291537748fab90d519aa09889d6","51ab6291537748fab90d519aa09889d6",22900626,5,0,1,1053,295,295,0
"51ab6291537748fab90d519aa09889d6","34a6e49023fc4465bd5ca604330bbd1c",22900626,1,-3,0,1058,295,292,-3
"34a6e49023fc4465bd5ca604330bbd1c","ba0e59461bfb4a44b7b1c28a01f8d3b3",22900626,1,9,0,1059,292,299,7
"ba0e59461bfb4a44b7b1c28a01f8d3b3","21592f2a9e9c4b2f8c66ec5dbcbf6a2b",22900626,1,-4,0,1060,299,296,-3
"21592f2a9e9c4b2f8c66ec5dbcbf6a2b","ba0e59461bfb4a44b7b1c28a01f8d3b3",22900626,1,4,0,1061,296,299,3
"ba0e59461bfb4a44b7b1c28a01f8d3b3","0e0b36e731a645e7b1b8a88f5031ca38",22900626,4,2,0,1062,299,301,2
"0e0b36e731a645e7b1b8a88f5031ca38","0e0b36e731a645e7b1b8a88f5031ca38",22900626,9,0,1,1063,301,301,0
"0e0b36e731a645e7b1b8a88f5031ca38","a66a144637284c21afc6de17fea4bfb8",22900626,3,1,0,1072,301,302,1
"a66a144637284c21afc6de17fea4bfb8","a66a144637284c21afc6de17fea4bfb8",22900626,4,0,1,1073,302,302,0
"a66a144637284c21afc6de17fea4bfb8","7646a919d7e64fa990bca9b024ff089d",22900626,3,-4,0,1075,302,298,-4
"7646a919d7e64fa990bca9b024ff089d","4a29443515bb404cb8924e1c60a63b73",22900626,2,-17,0,1076,298,285,-13
"4a29443515bb404cb8924e1c60a63b73","e390b575229748ea8aac9364efe2bf00",22900626,1,24,0,1077,285,304,19
"e390b575229748ea8aac9364efe2bf00","e390b575229748ea8aac9364efe2bf00",22900626,1,0,1,1078,304,304,0
"e390b575229748ea8aac9364efe2bf00","4a29443515bb404cb8924e1c60a63b73",22900626,1,-24,0,1079,304,285,-19
"4a29443515bb404cb8924e1c60a63b73","4a29443515bb404cb8924e1c60a63b73",22900626,2,0,1,1080,285,285,0
"4a29443515bb404cb8924e1c60a63b73","3434c10e561d488a914e0f7d71907abd",22900626,1,27,0,1082,285,305,20
"3434c10e561d488a914e0f7d71907abd","53e7e900392747ccad52e711ab0f80d8",22900626,2,2,0,1083,305,307,2
"53e7e900392747ccad52e711ab0f80d8","53e7e900392747ccad52e711ab0f80d8",22900626,1,0,1,1084,307,307,0
"53e7e900392747ccad52e711ab0f80d8","3434c10e561d488a914e0f7d71907abd",22900626,2,-2,0,1085,307,305,-2
"3434c10e561d488a914e0f7d71907abd","130acc2aeb0448fdbb2de63bc5cebe5b",22900626,1,5,0,1086,305,309,4
"130acc2aeb0448fdbb2de63bc5cebe5b","130acc2aeb0448fdbb2de63bc5cebe5b",22900626,1,0,1,1087,309,309,0
"130acc2aeb0448fdbb2de63bc5cebe5b","9c062b3251034ebe90f5054e2a3b5120",22900626,1,2,0,1088,309,311,2
"9c062b3251034ebe90f5054e2a3b5120","9c062b3251034ebe90f5054e2a3b5120",22900626,2,0,1,1089,311,311,0
"9c062b3251034ebe90f5054e2a3b5120","ea859f8207e44537889daeaba13ac2e8",22900626,1,1,0,1091,311,312,1
"ea859f8207e44537889daeaba13ac2e8","ea859f8207e44537889daeaba13ac2e8",22900626,10,0,1,1092,312,312,0
"ea859f8207e44537889daeaba13ac2e8","56d94971a7a94257aa330183a8ebd0ea",22900626,1,1,0,1102,312,313,1
"56d94971a7a94257aa330183a8ebd0ea","56d94971a7a94257aa330183a8ebd0ea",22900626,1,0,1,1103,313,313,0
"56d94971a7a94257aa330183a8ebd0ea","141c0df6cd1946539aadd1c9b7068cd4",22900626,1,-5,0,1104,313,308,-5
"141c0df6cd1946539aadd1c9b7068cd4","13255e63e0aa4abf85e5211bf613d43e",22900626,1,10,0,1105,308,317,9
"13255e63e0aa4abf85e5211bf613d43e","13255e63e0aa4abf85e5211bf613d43e",22900626,1,0,1,1106,317,317,0
"13255e63e0aa4abf85e5211bf613d43e","86c27d40179e419c8e9d150fb6afa5d0",22900626,1,3,0,1107,317,319,2
"86c27d40179e419c8e9d150fb6afa5d0","0c787d16c9504873b1a4d903cec09948",22900626,1,-6,0,1108,319,314,-5
"0c787d16c9504873b1a4d903cec09948","86c27d40179e419c8e9d150fb6afa5d0",22900626,1,6,0,1109,314,319,5
"86c27d40179e419c8e9d150fb6afa5d0","47edbb64109243e6b0f8f64cdef90c6c",22900626,1,8,0,1110,319,326,7
"47edbb64109243e6b0f8f64cdef90c6c","24f1363179ad4aaa965484a78471912b",22900626,1,-3,0,1111,326,323,-3
"24f1363179ad4aaa965484a78471912b","8d7e0b55cf9849cda222a0f2440cec55",22900626,1,-6,0,1112,323,318,-5
"8d7e0b55cf9849cda222a0f2440cec55","24f1363179ad4aaa965484a78471912b",22900626,1,6,0,1113,318,323,5
"24f1363179ad4aaa965484a78471912b","3628bdce1dd2429ba924d2d4d09448d2",22900626,1,-1,0,1114,323,322,-1
"3628bdce1dd2429ba924d2d4d09448d2","3434c10e561d488a914e0f7d71907abd",22900626,1,-21,0,1115,322,305,-17
"3434c10e561d488a914e0f7d71907abd","56b3fd1a212a4764be39d979fde3326e",22900626,1,28,0,1118,305,328,23
"56b3fd1a212a4764be39d979fde3326e","56b3fd1a212a4764be39d979fde3326e",22900626,1,0,1,1119,328,328,0
"56b3fd1a212a4764be39d979fde3326e","3434c10e561d488a914e0f7d71907abd",22900626,1,-28,0,1120,328,305,-23
"3434c10e561d488a914e0f7d71907abd","0c4079457ede49e3aeb5e86ed84bdf35",22900626,1,31,0,1121,305,329,24
"0c4079457ede49e3aeb5e86ed84bdf35","38aea304b4fa46e1b29bb72f5cea4c93",22900626,1,2,0,1122,329,331,2
"38aea304b4fa46e1b29bb72f5cea4c93","38aea304b4fa46e1b29bb72f5cea4c93",22900626,1,0,1,1123,331,331,0
"38aea304b4fa46e1b29bb72f5cea4c93","e36d261332f14e79bb4b467aceaeb9b5",22900626,1,2,0,1124,331,333,2
"e36d261332f14e79bb4b467aceaeb9b5","e36d261332f14e79bb4b467aceaeb9b5",22900626,1,0,1,1125,333,333,0
"e36d261332f14e79bb4b467aceaeb9b5","c7e89b9d04744d2eab742fc24e3ef1ae",22900626,1,1,0,1126,333,334,1
"c7e89b9d04744d2eab742fc24e3ef1ae","c7e89b9d04744d2eab742fc24e3ef1ae",22900626,5,0,1,1127,334,334,0
"c7e89b9d04744d2eab742fc24e3ef1ae","fe49f8054b374a0ea4bb266ed135ff62",22900626,1,1,0,1132,334,335,1
"fe49f8054b374a0ea4bb266ed135ff62","fe49f8054b374a0ea4bb266ed135ff62",22900626,5,0,1,1133,335,335,0
"fe49f8054b374a0ea4bb266ed135ff62","d0a8f74af98642fe8360d22c42e45117",22900626,1,1,0,1138,335,336,1
"d0a8f74af98642fe8360d22c42e45117","d0a8f74af98642fe8360d22c42e45117",22900626,2,0,1,1139,336,336,0
"d0a8f74af98642fe8360d22c42e45117","0c4079457ede49e3aeb5e86ed84bdf35",22900626,1,-7,0,1141,336,329,-7
"0c4079457ede49e3aeb5e86ed84bdf35","a7c6339ca1da4368a18d471f0519f877",22900626,1,11,0,1142,329,339,10
"a7c6339ca1da4368a18d471f0519f877","a7c6339ca1da4368a18d471f0519f877",22900626,1,0,1,1143,339,339,0
"a7c6339ca1da4368a18d471f0519f877","b8b9418ab322418d9db9b40d96af873a",22900626,1,-2,0,1144,339,337,-2
"b8b9418ab322418d9db9b40d96af873a","bbc5139ca9024389a94db3a6f47dcff6",22900626,1,5,0,1145,337,341,4
"bbc5139ca9024389a94db3a6f47dcff6","4a29443515bb404cb8924e1c60a63b73",22900626,1,-72,0,1146,341,285,-56
"4a29443515bb404cb8924e1c60a63b73","0c4079457ede49e3aeb5e86ed84bdf35",22900626,1,58,0,1147,285,329,44
"0c4079457ede49e3aeb5e86ed84bdf35","c2490bc612d146edbe786556fab3651b",22900626,1,13,0,1148,329,340,11
"c2490bc612d146edbe786556fab3651b","bbc5139ca9024389a94db3a6f47dcff6",22900626,1,1,0,1149,340,341,1
"bbc5139ca9024389a94db3a6f47dcff6","bbc5139ca9024389a94db3a6f47dcff6",22900626,1,0,1,1150,341,341,0
"bbc5139ca9024389a94db3a6f47dcff6","4ee6ca9019ab4a1ab323f98094a9bd77",22900626,1,2,0,1151,341,343,2
"4ee6ca9019ab4a1ab323f98094a9bd77","4ee6ca9019ab4a1ab323f98094a9bd77",22900626,8,0,1,1152,343,343,0
"4ee6ca9019ab4a1ab323f98094a9bd77","b37947176785476f8b29d49a851366dc",22900626,1,1,0,1160,343,344,1
"b37947176785476f8b29d49a851366dc","b37947176785476f8b29d49a851366dc",22900626,2,0,1,1161,344,344,0
"b37947176785476f8b29d49a851366dc","fcea5b10d5a14a3b9324ffece8f6e1e5",22900626,1,1,0,1163,344,345,1
"fcea5b10d5a14a3b9324ffece8f6e1e5","fcea5b10d5a14a3b9324ffece8f6e1e5",22900626,2,0,1,1164,345,345,0
"fcea5b10d5a14a3b9324ffece8f6e1e5","c2490bc612d146edbe786556fab3651b",22900626,1,-5,0,1166,345,340,-5
"c2490bc612d146edbe786556fab3651b","6ac8bb048b854999a47edb35fe627f11",22900626,1,8,0,1167,340,347,7
"6ac8bb048b854999a47edb35fe627f11","6ac8bb048b854999a47edb35fe627f11",22900626,1,0,1,1168,347,347,0
"6ac8bb048b854999a47edb35fe627f11","30ead9794d4847abaf222ca966cc8630",22900626,1,3,0,1169,347,348,1
"30ead9794d4847abaf222ca966cc8630","0c4079457ede49e3aeb5e86ed84bdf35",22900626,1,-24,0,1170,348,329,-19
"0c4079457ede49e3aeb5e86ed84bdf35","897b7f51242c44aab2205c72fdcbf4cd",22900626,1,28,0,1171,329,352,23
"897b7f51242c44aab2205c72fdcbf4cd","c20993c944444fe085345591a8bd837e",22900626,2,-1,0,1172,352,351,-1
"c20993c944444fe085345591a8bd837e","eff0de7f2dbb42dfa1a2e686efab5b6d",22900626,2,3,0,1173,351,354,3
"eff0de7f2dbb42dfa1a2e686efab5b6d","09b9678ddc3d452ea4a3d46e15826065",22900626,2,-1,0,1174,354,353,-1
"09b9678ddc3d452ea4a3d46e15826065","4a29443515bb404cb8924e1c60a63b73",22900626,1,-87,0,1175,353,285,-68
"4a29443515bb404cb8924e1c60a63b73","0d987bed3ffa4ed0b9a2e62e97b7b30f",22900626,1,-22,0,1176,285,272,-13
"0d987bed3ffa4ed0b9a2e62e97b7b30f","bb5a47f5ea01454a8b79455422d3b9da",22900626,2,10,0,1177,272,280,8
"bb5a47f5ea01454a8b79455422d3b9da","30ead9794d4847abaf222ca966cc8630",22900626,1,94,0,1185,280,348,68
"30ead9794d4847abaf222ca966cc8630","30ead9794d4847abaf222ca966cc8630",22900626,1,0,1,1186,348,348,0
"30ead9794d4847abaf222ca966cc8630","c20993c944444fe085345591a8bd837e",22900626,1,3,0,1187,348,351,3
"09b9678ddc3d452ea4a3d46e15826065","897b7f51242c44aab2205c72fdcbf4cd",22900626,1,-1,0,1190,353,352,-1
"c20993c944444fe085345591a8bd837e","c20993c944444fe085345591a8bd837e",22900626,3,0,1,1192,351,351,0
"c20993c944444fe085345591a8bd837e","897b7f51242c44aab2205c72fdcbf4cd",22900626,1,1,0,1195,351,352,1
"897b7f51242c44aab2205c72fdcbf4cd","897b7f51242c44aab2205c72fdcbf4cd",22900626,3,0,1,1196,352,352,0
"897b7f51242c44aab2205c72fdcbf4cd","09b9678ddc3d452ea4a3d46e15826065",22900626,1,1,0,1199,352,353,1
"09b9678ddc3d452ea4a3d46e15826065","09b9678ddc3d452ea4a3d46e15826065",22900626,3,0,1,1200,353,353,0
"09b9678ddc3d452ea4a3d46e15826065","eff0de7f2dbb42dfa1a2e686efab5b6d",22900626,1,1,0,1203,353,354,1
"eff0de7f2dbb42dfa1a2e686efab5b6d","eff0de7f2dbb42dfa1a2e686efab5b6d",22900626,3,0,1,1204,354,354,0
"eff0de7f2dbb42dfa1a2e686efab5b6d","30ead9794d4847abaf222ca966cc8630",22900626,1,-6,0,1207,354,348,-6
"30ead9794d4847abaf222ca966cc8630","2fe14166dc9642c3bc666b86a57f943d",22900626,1,10,0,1208,348,357,9
"2fe14166dc9642c3bc666b86a57f943d","2fe14166dc9642c3bc666b86a57f943d",22900626,1,0,1,1209,357,357,0
"2fe14166dc9642c3bc666b86a57f943d","44421dd1e13a47a388c4a19834b744c7",22900626,1,2,0,1210,357,359,2
"44421dd1e13a47a388c4a19834b744c7","44421dd1e13a47a388c4a19834b744c7",22900626,2,0,1,1211,359,359,0
"44421dd1e13a47a388c4a19834b744c7","cb5fc7ef85d547c4be1a7439d0bf6052",22900626,1,1,0,1213,359,360,1
"cb5fc7ef85d547c4be1a7439d0bf6052","cb5fc7ef85d547c4be1a7439d0bf6052",22900626,2,0,1,1214,360,360,0
"cb5fc7ef85d547c4be1a7439d0bf6052","0a8f150a4cf747acbde62f4721823da3",22900626,1,1,0,1216,360,361,1
"0a8f150a4cf747acbde62f4721823da3","0a8f150a4cf747acbde62f4721823da3",22900626,2,0,1,1217,361,361,0
"0a8f150a4cf747acbde62f4721823da3","ab8fdad974ae471f9f24c3f9dd04462e",22900626,1,1,0,1219,361,362,1
"ab8fdad974ae471f9f24c3f9dd04462e","ab8fdad974ae471f9f24c3f9dd04462e",22900626,2,0,1,1220,362,362,0
"ab8fdad974ae471f9f24c3f9dd04462e","52580888dadb4fe3baa795683ea227bd",22900626,1,3,0,1222,362,364,2
"52580888dadb4fe3baa795683ea227bd","1ba8fef685d74a8194b9db252eb704fb",22900626,1,-10,0,1223,364,355,-9
"1ba8fef685d74a8194b9db252eb704fb","52580888dadb4fe3baa795683ea227bd",22900626,1,10,0,1224,355,364,9
"52580888dadb4fe3baa795683ea227bd","f00179e251a045b39c3f7a54f9aa4acc",22900626,1,-1,0,1225,364,363,-1
"f00179e251a045b39c3f7a54f9aa4acc","492a3bc6a1254f23a7998587961b22a4",22900626,1,4,0,1226,363,366,3
"492a3bc6a1254f23a7998587961b22a4","492a3bc6a1254f23a7998587961b22a4",22900626,1,0,1,1227,366,366,0
"492a3bc6a1254f23a7998587961b22a4","072a190fd302456290895f9f04d6940a",22900626,1,-1,0,1228,366,365,-1
"072a190fd302456290895f9f04d6940a","cfa457d1743848e4bb5e4beced6448ed",22900626,1,5,0,1229,365,369,4
"cfa457d1743848e4bb5e4beced6448ed","cfa457d1743848e4bb5e4beced6448ed",22900626,1,0,1,1230,369,369,0
"cfa457d1743848e4bb5e4beced6448ed","30ead9794d4847abaf222ca966cc8630",22900626,1,-25,0,1231,369,348,-21
"30ead9794d4847abaf222ca966cc8630","b71bac264efb4abd97015447bd490db6",22900626,1,28,0,1232,348,370,22
"b71bac264efb4abd97015447bd490db6","8d448d625b024c82a5eb240bbd7431d6",22900626,4,5,0,1233,370,374,4
"8d448d625b024c82a5eb240bbd7431d6","8d448d625b024c82a5eb240bbd7431d6",22900626,62,0,1,1234,374,374,0
"8d448d625b024c82a5eb240bbd7431d6","b71bac264efb4abd97015447bd490db6",22900626,3,-5,0,1239,374,370,-4
"b71bac264efb4abd97015447bd490db6","d6d02b6ef04e4f17805504500b8ce441",22900626,3,8,0,1287,370,375,5
"d6d02b6ef04e4f17805504500b8ce441","d6d02b6ef04e4f17805504500b8ce441",22900626,25,0,1,1288,375,375,0
"d6d02b6ef04e4f17805504500b8ce441","66baf19b6b904b70922329068c63746d",22900626,2,4,0,1290,375,376,1
"66baf19b6b904b70922329068c63746d","7f544639412e40a9ba27f43b415362ab",22900626,5,2,0,1291,376,378,2
"7f544639412e40a9ba27f43b415362ab","7f544639412e40a9ba27f43b415362ab",22900626,5,0,1,1292,378,378,0
"7f544639412e40a9ba27f43b415362ab","b71bac264efb4abd97015447bd490db6",22900626,1,-14,0,1293,378,370,-8
"8d448d625b024c82a5eb240bbd7431d6","66baf19b6b904b70922329068c63746d",22900626,1,7,0,1302,374,376,2
"66baf19b6b904b70922329068c63746d","66baf19b6b904b70922329068c63746d",22900626,1,0,1,1303,376,376,0
"7f544639412e40a9ba27f43b415362ab","d5ae8642e15b46b8bd298b02274d4e9c",22900626,1,2,0,1309,378,380,2
"d5ae8642e15b46b8bd298b02274d4e9c","d5ae8642e15b46b8bd298b02274d4e9c",22900626,1,0,1,1310,380,380,0
"d5ae8642e15b46b8bd298b02274d4e9c","a0d10309a2dd456289147f84be9d37f9",22900626,1,1,0,1311,380,381,1
"a0d10309a2dd456289147f84be9d37f9","a0d10309a2dd456289147f84be9d37f9",22900626,2,0,1,1312,381,381,0
"a0d10309a2dd456289147f84be9d37f9","0fcbc3ca07b144138b8d85da581f09a8",22900626,1,1,0,1314,381,382,1
"0fcbc3ca07b144138b8d85da581f09a8","0fcbc3ca07b144138b8d85da581f09a8",22900626,2,0,1,1315,382,382,0
"0fcbc3ca07b144138b8d85da581f09a8","66baf19b6b904b70922329068c63746d",22900626,1,-6,0,1317,382,376,-6
"66baf19b6b904b70922329068c63746d","c2fca3669923477ab966ded303dea31c",22900626,1,8,0,1318,376,383,7
"c2fca3669923477ab966ded303dea31c","4890121ce5d74576b4632b77cfc23398",22900626,1,6,0,1319,383,388,5
"4890121ce5d74576b4632b77cfc23398","4890121ce5d74576b4632b77cfc23398",22900626,1,0,1,1320,388,388,0
"4890121ce5d74576b4632b77cfc23398","18d3b836dd804224883cc9180b60a8e1",22900626,1,-1,0,1321,388,387,-1
"18d3b836dd804224883cc9180b60a8e1","96bb2b3e85a34d8b9544514e89f6fe97",22900626,1,4,0,1322,387,390,3
"96bb2b3e85a34d8b9544514e89f6fe97","96bb2b3e85a34d8b9544514e89f6fe97",22900626,1,0,1,1323,390,390,0
"96bb2b3e85a34d8b9544514e89f6fe97","ac4e9b54acfe4670b4634859c7263cb5",22900626,1,2,0,1324,390,392,2
"ac4e9b54acfe4670b4634859c7263cb5","ac4e9b54acfe4670b4634859c7263cb5",22900626,1,0,1,1325,392,392,0
"ac4e9b54acfe4670b4634859c7263cb5","17f95d18bab743888e1736033dc3384d",22900626,1,-3,0,1326,392,389,-3
"17f95d18bab743888e1736033dc3384d","6f8881a745ac4c358a68b92c3b4abe81",22900626,1,6,0,1327,389,394,5
"6f8881a745ac4c358a68b92c3b4abe81","6f8881a745ac4c358a68b92c3b4abe81",22900626,1,0,1,1328,394,394,0
"6f8881a745ac4c358a68b92c3b4abe81","f7002c8484354eceac57bc7bd62c76c1",22900626,1,-1,0,1329,394,393,-1
"f7002c8484354eceac57bc7bd62c76c1","66baf19b6b904b70922329068c63746d",22900626,1,-21,0,1330,393,376,-17
"7f544639412e40a9ba27f43b415362ab","66baf19b6b904b70922329068c63746d",22900626,2,-2,0,1332,378,376,-2
"66baf19b6b904b70922329068c63746d","44a277ea44dc4ae689fab4b82f0b4098",22900626,1,26,0,1333,376,397,21
"44a277ea44dc4ae689fab4b82f0b4098","44a277ea44dc4ae689fab4b82f0b4098",22900626,1,0,1,1334,397,397,0
"44a277ea44dc4ae689fab4b82f0b4098","0c12af0a4e7f4002852cf84b2537c161",22900626,1,-2,0,1335,397,395,-2
"0c12af0a4e7f4002852cf84b2537c161","66baf19b6b904b70922329068c63746d",22900626,1,-24,0,1336,395,376,-19
"66baf19b6b904b70922329068c63746d","2b09a08242b54983aec7063990fb3f66",22900626,3,32,0,1339,376,400,24
"2b09a08242b54983aec7063990fb3f66","66baf19b6b904b70922329068c63746d",22900626,1,-32,0,1340,400,376,-24
"2b09a08242b54983aec7063990fb3f66","2b09a08242b54983aec7063990fb3f66",22900626,7,0,1,1342,400,400,0
"2b09a08242b54983aec7063990fb3f66","1f471b7a883a4df48211e8c6a81b59a7",22900626,1,1,0,1343,400,401,1
"1f471b7a883a4df48211e8c6a81b59a7","1f471b7a883a4df48211e8c6a81b59a7",22900626,1,0,1,1344,401,401,0
"1f471b7a883a4df48211e8c6a81b59a7","2b09a08242b54983aec7063990fb3f66",22900626,1,-1,0,1345,401,400,-1
"2b09a08242b54983aec7063990fb3f66","9de0d567bfa84fe5b77cb76f4a76a5d1",22900626,1,5,0,1346,400,404,4
"9de0d567bfa84fe5b77cb76f4a76a5d1","9de0d567bfa84fe5b77cb76f4a76a5d1",22900626,1,0,1,1347,404,404,0
"9de0d567bfa84fe5b77cb76f4a76a5d1","1157bd665ec4472fb58b751dc5099355",22900626,1,-1,0,1348,404,403,-1
"1157bd665ec4472fb58b751dc5099355","3c8a22d2f9c146ea956609e3ed4f2559",22900626,2,3,0,1349,403,405,2
"3c8a22d2f9c146ea956609e3ed4f2559","58fc9094275e4c49be3f4ba6d4acc0a4",22900626,3,2,0,1350,405,406,1
"58fc9094275e4c49be3f4ba6d4acc0a4","58fc9094275e4c49be3f4ba6d4acc0a4",22900626,2,0,1,1351,406,406,0
"58fc9094275e4c49be3f4ba6d4acc0a4","c1c1be90b2b14c1ab4a5e1ee3c241902",22900626,1,1,0,1352,406,407,1
"c1c1be90b2b14c1ab4a5e1ee3c241902","c1c1be90b2b14c1ab4a5e1ee3c241902",22900626,5,0,1,1353,407,407,0
"c1c1be90b2b14c1ab4a5e1ee3c241902","58fc9094275e4c49be3f4ba6d4acc0a4",22900626,1,-1,0,1358,407,406,-1
"58fc9094275e4c49be3f4ba6d4acc0a4","02b3a1bead9244c1ba2f857c7da8f82a",22900626,1,3,0,1359,406,408,2
"02b3a1bead9244c1ba2f857c7da8f82a","02b3a1bead9244c1ba2f857c7da8f82a",22900626,4,0,1,1360,408,408,0
"02b3a1bead9244c1ba2f857c7da8f82a","6206fc6479014bb193084c32409dc1b9",22900626,1,1,0,1364,408,409,1
"6206fc6479014bb193084c32409dc1b9","6206fc6479014bb193084c32409dc1b9",22900626,1,0,1,1365,409,409,0
"6206fc6479014bb193084c32409dc1b9","6a5f020451db426dacba9e2ea3fcc62a",22900626,1,2,0,1366,409,410,1
"6a5f020451db426dacba9e2ea3fcc62a","02b3a1bead9244c1ba2f857c7da8f82a",22900626,1,-3,0,1367,410,408,-2
"02b3a1bead9244c1ba2f857c7da8f82a","6a5f020451db426dacba9e2ea3fcc62a",22900626,1,3,0,1368,408,410,2
"6a5f020451db426dacba9e2ea3fcc62a","6a5f020451db426dacba9e2ea3fcc62a",22900626,1,0,1,1369,410,410,0
"6a5f020451db426dacba9e2ea3fcc62a","33a9d248b2e44588a5b07fc1342b9bc2",22900626,1,2,0,1370,410,411,1
"33a9d248b2e44588a5b07fc1342b9bc2","33a9d248b2e44588a5b07fc1342b9bc2",22900626,1,0,1,1371,411,411,0
"33a9d248b2e44588a5b07fc1342b9bc2","c6f26bd420634f1cb7989e76fe6b16c0",22900626,1,1,0,1372,411,412,1
"c6f26bd420634f1cb7989e76fe6b16c0","c6f26bd420634f1cb7989e76fe6b16c0",22900626,5,0,1,1373,412,412,0
"c6f26bd420634f1cb7989e76fe6b16c0","2a65ee6e2ac64f6a8a55fbe5373ec763",22900626,1,1,0,1378,412,413,1
"2a65ee6e2ac64f6a8a55fbe5373ec763","2a65ee6e2ac64f6a8a55fbe5373ec763",22900626,2,0,1,1379,413,413,0
"2a65ee6e2ac64f6a8a55fbe5373ec763","33a9d248b2e44588a5b07fc1342b9bc2",22900626,1,-2,0,1381,413,411,-2
"33a9d248b2e44588a5b07fc1342b9bc2","2b09a08242b54983aec7063990fb3f66",22900626,1,-17,0,1382,411,400,-11
"2b09a08242b54983aec7063990fb3f66","1fd0f6dadbc14ebc965faf6122190b96",22900626,1,22,0,1385,400,415,15
"1fd0f6dadbc14ebc965faf6122190b96","1fd0f6dadbc14ebc965faf6122190b96",22900626,1,0,1,1386,415,415,0
"1fd0f6dadbc14ebc965faf6122190b96","687055dad9fc40c3982478fe33ec01bf",22900626,1,-1,0,1387,415,414,-1
"687055dad9fc40c3982478fe33ec01bf","2b09a08242b54983aec7063990fb3f66",22900626,1,-21,0,1388,414,400,-14
"2b09a08242b54983aec7063990fb3f66","2add1669f08d4101913db15f8c23b3b7",22900626,1,24,0,1391,400,416,16
"2add1669f08d4101913db15f8c23b3b7","2add1669f08d4101913db15f8c23b3b7",22900626,1,0,1,1392,416,416,0
"2add1669f08d4101913db15f8c23b3b7","a2b4bd40cee2481ebd3fc179d6a5cd62",22900626,1,3,0,1393,416,417,1
"a2b4bd40cee2481ebd3fc179d6a5cd62","2b09a08242b54983aec7063990fb3f66",22900626,1,-27,0,1394,417,400,-17
"2b09a08242b54983aec7063990fb3f66","e34e59dce2204f228f3a84b6725df60f",22900626,1,29,0,1395,400,419,19
"e34e59dce2204f228f3a84b6725df60f","e34e59dce2204f228f3a84b6725df60f",22900626,2,0,1,1396,419,419,0
"e34e59dce2204f228f3a84b6725df60f","66baf19b6b904b70922329068c63746d",22900626,1,-61,0,1397,419,376,-43
"66baf19b6b904b70922329068c63746d","a2b4bd40cee2481ebd3fc179d6a5cd62",22900626,3,59,0,1398,376,417,41
"a2b4bd40cee2481ebd3fc179d6a5cd62","a2b4bd40cee2481ebd3fc179d6a5cd62",22900626,3,0,1,1399,417,417,0
"a2b4bd40cee2481ebd3fc179d6a5cd62","bec48fc2e1294c7eb3d0aca780d731b8",22900626,4,4,0,1400,417,420,3
"bec48fc2e1294c7eb3d0aca780d731b8","a2b4bd40cee2481ebd3fc179d6a5cd62",22900626,4,-4,0,1401,420,417,-3
"bec48fc2e1294c7eb3d0aca780d731b8","bec48fc2e1294c7eb3d0aca780d731b8",22900626,2,0,1,1405,420,420,0
"bec48fc2e1294c7eb3d0aca780d731b8","a24600b0e49245f6bdba8c893cfeddb0",22900626,1,7,0,1407,420,425,5
"a24600b0e49245f6bdba8c893cfeddb0","dbde19fcce2a4c1abdc7f685c293a23f",22900626,1,-4,0,1408,425,422,-3
"dbde19fcce2a4c1abdc7f685c293a23f","a24600b0e49245f6bdba8c893cfeddb0",22900626,1,4,0,1409,422,425,3
"a24600b0e49245f6bdba8c893cfeddb0","a24600b0e49245f6bdba8c893cfeddb0",22900626,1,0,1,1410,425,425,0
"a24600b0e49245f6bdba8c893cfeddb0","a2b4bd40cee2481ebd3fc179d6a5cd62",22900626,1,-11,0,1411,425,417,-8
"a2b4bd40cee2481ebd3fc179d6a5cd62","24cf8786024543f19b89bc20034e60d7",22900626,5,18,0,1412,417,428,11
"24cf8786024543f19b89bc20034e60d7","f2a73be2f46840b182d7bd095378004e",22900626,4,1,0,1413,428,429,1
"f2a73be2f46840b182d7bd095378004e","f2a73be2f46840b182d7bd095378004e",22900626,1,0,1,1414,429,429,0
"f2a73be2f46840b182d7bd095378004e","604551fd4266430cb860fef58fa7dd61",22900626,1,1,0,1415,429,430,1
"604551fd4266430cb860fef58fa7dd61","604551fd4266430cb860fef58fa7dd61",22900626,9,0,1,1416,430,430,0
"604551fd4266430cb860fef58fa7dd61","dce46f8904594a62a6377a3587aaa663",22900626,1,2,0,1425,430,431,1
"dce46f8904594a62a6377a3587aaa663","24cf8786024543f19b89bc20034e60d7",22900626,1,-4,0,1426,431,428,-3
"24cf8786024543f19b89bc20034e60d7","dce46f8904594a62a6377a3587aaa663",22900626,1,4,0,1427,428,431,3
"dce46f8904594a62a6377a3587aaa663","9b9d0a249052413c869753b99682b0ac",22900626,1,1,0,1428,431,432,1
"9b9d0a249052413c869753b99682b0ac","9b9d0a249052413c869753b99682b0ac",22900626,3,0,1,1429,432,432,0
"9b9d0a249052413c869753b99682b0ac","061c175cc90f45fbad883025394e78dd",22900626,1,1,0,1432,432,433,1
"061c175cc90f45fbad883025394e78dd","061c175cc90f45fbad883025394e78dd",22900626,6,0,1,1433,433,433,0
"061c175cc90f45fbad883025394e78dd","dce46f8904594a62a6377a3587aaa663",22900626,1,-2,0,1439,433,431,-2
"dce46f8904594a62a6377a3587aaa663","74a7f8712e5449c2bc0b43c6f90dafed",22900626,1,5,0,1440,431,435,4
"74a7f8712e5449c2bc0b43c6f90dafed","74a7f8712e5449c2bc0b43c6f90dafed",22900626,1,0,1,1441,435,435,0
"74a7f8712e5449c2bc0b43c6f90dafed","66ada10dde9f43018588f1ced9d477fc",22900626,1,-1,0,1442,435,434,-1
"66ada10dde9f43018588f1ced9d477fc","24cf8786024543f19b89bc20034e60d7",22900626,1,-8,0,1443,434,428,-6
"f2a73be2f46840b182d7bd095378004e","66baf19b6b904b70922329068c63746d",22900626,2,-78,0,1445,429,376,-53
"66baf19b6b904b70922329068c63746d","bf12c96466d840a69bed7020b3f18bb8",22900626,1,88,0,1446,376,436,60
"bf12c96466d840a69bed7020b3f18bb8","24cf8786024543f19b89bc20034e60d7",22900626,1,-11,0,1447,436,428,-8
"24cf8786024543f19b89bc20034e60d7","bf12c96466d840a69bed7020b3f18bb8",22900626,1,11,0,1448,428,436,8
"bf12c96466d840a69bed7020b3f18bb8","bf12c96466d840a69bed7020b3f18bb8",22900626,1,0,1,1449,436,436,0
"bf12c96466d840a69bed7020b3f18bb8","070600601c4c439288445d2f0724807d",22900626,1,3,0,1450,436,437,1
"070600601c4c439288445d2f0724807d","24cf8786024543f19b89bc20034e60d7",22900626,1,-14,0,1451,437,428,-9
"24cf8786024543f19b89bc20034e60d7","1823b6de7d334a7aaabc4570719af4d9",22900626,1,16,0,1452,428,439,11
"1823b6de7d334a7aaabc4570719af4d9","24cf8786024543f19b89bc20034e60d7",22900626,1,-16,0,1453,439,428,-11
"24cf8786024543f19b89bc20034e60d7","66baf19b6b904b70922329068c63746d",22900626,2,-77,0,1454,428,376,-52
"66baf19b6b904b70922329068c63746d","070600601c4c439288445d2f0724807d",22900626,2,91,0,1455,376,437,61
"070600601c4c439288445d2f0724807d","070600601c4c439288445d2f0724807d",22900626,2,0,1,1456,437,437,0
"070600601c4c439288445d2f0724807d","1823b6de7d334a7aaabc4570719af4d9",22900626,2,2,0,1457,437,439,2
"1823b6de7d334a7aaabc4570719af4d9","1823b6de7d334a7aaabc4570719af4d9",22900626,13,0,1,1458,439,439,0
"1823b6de7d334a7aaabc4570719af4d9","070600601c4c439288445d2f0724807d",22900626,2,-2,0,1471,439,437,-2
"070600601c4c439288445d2f0724807d","0380cd76a7d44bc3a4da1f15e4d68f89",22900626,2,4,0,1472,437,440,3
"0380cd76a7d44bc3a4da1f15e4d68f89","0380cd76a7d44bc3a4da1f15e4d68f89",22900626,4,0,1,1473,440,440,0
"0380cd76a7d44bc3a4da1f15e4d68f89","23b7673c8b5443108c2ef09382834a86",22900626,1,2,0,1477,440,441,1
"23b7673c8b5443108c2ef09382834a86","23b7673c8b5443108c2ef09382834a86",22900626,2,0,1,1478,441,441,0
"23b7673c8b5443108c2ef09382834a86","901e92500aea43c79f19f1b279050668",22900626,1,2,0,1480,441,442,1
"901e92500aea43c79f19f1b279050668","901e92500aea43c79f19f1b279050668",22900626,1,0,1,1481,442,442,0
"901e92500aea43c79f19f1b279050668","001339db8ced4cf78829ebe8b145449d",22900626,1,1,0,1482,442,443,1
"001339db8ced4cf78829ebe8b145449d","001339db8ced4cf78829ebe8b145449d",22900626,5,0,1,1483,443,443,0
"001339db8ced4cf78829ebe8b145449d","452745e0366e42ae81561bfddebcc6c3",22900626,1,1,0,1488,443,444,1
"452745e0366e42ae81561bfddebcc6c3","452745e0366e42ae81561bfddebcc6c3",22900626,2,0,1,1489,444,444,0
"452745e0366e42ae81561bfddebcc6c3","4660ff2089114e8db82ceb26a4f329e3",22900626,1,2,0,1491,444,445,1
"4660ff2089114e8db82ceb26a4f329e3","901e92500aea43c79f19f1b279050668",22900626,1,-4,0,1492,445,442,-3
"901e92500aea43c79f19f1b279050668","4660ff2089114e8db82ceb26a4f329e3",22900626,1,4,0,1493,442,445,3
"4660ff2089114e8db82ceb26a4f329e3","7bd5586eb9d8484eb74a433ee7bfe499",22900626,2,2,0,1494,445,446,1
"7bd5586eb9d8484eb74a433ee7bfe499","4660ff2089114e8db82ceb26a4f329e3",22900626,1,-2,0,1495,446,445,-1
"7bd5586eb9d8484eb74a433ee7bfe499","7bd5586eb9d8484eb74a433ee7bfe499",22900626,9,0,1,1497,446,446,0
"7bd5586eb9d8484eb74a433ee7bfe499","8a7f26e690f34dda97be16904518ca99",22900626,1,2,0,1506,446,447,1
"8a7f26e690f34dda97be16904518ca99","8a7f26e690f34dda97be16904518ca99",22900626,1,0,1,1507,447,447,0
"8a7f26e690f34dda97be16904518ca99","070600601c4c439288445d2f0724807d",22900626,1,-16,0,1508,447,437,-10
"070600601c4c439288445d2f0724807d","b2f0d654738f48158edff28e8d3a546e",22900626,1,21,0,1509,437,449,12
"b2f0d654738f48158edff28e8d3a546e","f60ee41ec635499abd48168342d32c2f",22900626,3,5,0,1510,449,453,4
"f60ee41ec635499abd48168342d32c2f","f60ee41ec635499abd48168342d32c2f",22900626,65,0,1,1511,453,453,0
"f60ee41ec635499abd48168342d32c2f","b2f0d654738f48158edff28e8d3a546e",22900626,3,-5,0,1518,453,449,-4
"b2f0d654738f48158edff28e8d3a546e","f67fbf45a5f146ed866965bc57c7c001",22900626,2,8,0,1563,449,454,5
"f67fbf45a5f146ed866965bc57c7c001","f67fbf45a5f146ed866965bc57c7c001",22900626,2,0,1,1564,454,454,0
"f67fbf45a5f146ed866965bc57c7c001","d937afe49bd24a07a550dda1c1155122",22900626,1,1,0,1566,454,455,1
"d937afe49bd24a07a550dda1c1155122","d937afe49bd24a07a550dda1c1155122",22900626,5,0,1,1567,455,455,0
"d937afe49bd24a07a550dda1c1155122","3628b3f7823443d0912a339096b69943",22900626,1,1,0,1572,455,456,1
"3628b3f7823443d0912a339096b69943","3628b3f7823443d0912a339096b69943",22900626,1,0,1,1573,456,456,0
"3628b3f7823443d0912a339096b69943","9e049ee647cf43ecbcb5ed792a8e7588",22900626,1,1,0,1574,456,457,1
"9e049ee647cf43ecbcb5ed792a8e7588","9e049ee647cf43ecbcb5ed792a8e7588",22900626,1,0,1,1575,457,457,0
"9e049ee647cf43ecbcb5ed792a8e7588","5256a214faaf410b93f76cea06428334",22900626,1,1,0,1576,457,458,1
"5256a214faaf410b93f76cea06428334","5256a214faaf410b93f76cea06428334",22900626,1,0,1,1577,458,458,0
"5256a214faaf410b93f76cea06428334","25c32b120fce40fa9b6c85133aeb4716",22900626,1,1,0,1578,458,459,1
"25c32b120fce40fa9b6c85133aeb4716","25c32b120fce40fa9b6c85133aeb4716",22900626,1,0,1,1579,459,459,0
"25c32b120fce40fa9b6c85133aeb4716","11bc14f2204949008b7d511b933363c1",22900626,1,1,0,1580,459,460,1
"11bc14f2204949008b7d511b933363c1","11bc14f2204949008b7d511b933363c1",22900626,1,0,1,1581,460,460,0
"11bc14f2204949008b7d511b933363c1","42de338840a34d15adb66e7b14fb9d2c",22900626,1,1,0,1582,460,461,1
"42de338840a34d15adb66e7b14fb9d2c","42de338840a34d15adb66e7b14fb9d2c",22900626,1,0,1,1583,461,461,0
"42de338840a34d15adb66e7b14fb9d2c","9da37c6210b1416b8079c274f70bf600",22900626,1,1,0,1584,461,462,1
"9da37c6210b1416b8079c274f70bf600","9da37c6210b1416b8079c274f70bf600",22900626,1,0,1,1585,462,462,0
"9da37c6210b1416b8079c274f70bf600","519119f1deac45ff9ab4f13529be5c6e",22900626,1,1,0,1586,462,463,1
"519119f1deac45ff9ab4f13529be5c6e","519119f1deac45ff9ab4f13529be5c6e",22900626,1,0,1,1587,463,463,0
"519119f1deac45ff9ab4f13529be5c6e","c5df9f40ec14463b9dcfdc73df3e9285",22900626,1,3,0,1588,463,464,1
"c5df9f40ec14463b9dcfdc73df3e9285","f67fbf45a5f146ed866965bc57c7c001",22900626,1,-12,0,1589,464,454,-10
"f67fbf45a5f146ed866965bc57c7c001","c5df9f40ec14463b9dcfdc73df3e9285",22900626,1,12,0,1590,454,464,10
"c5df9f40ec14463b9dcfdc73df3e9285","b7719e26494940efa49512aedd0aac79",22900626,1,-620,0,1591,464,20,-444
"b7719e26494940efa49512aedd0aac79","a49d1bb4328949299686242fd0be5584",22900626,2,2,0,1592,20,21,1
"a49d1bb4328949299686242fd0be5584","a49d1bb4328949299686242fd0be5584",22900626,2,0,1,1593,21,21,0
"a49d1bb4328949299686242fd0be5584","b7719e26494940efa49512aedd0aac79",22900626,2,-2,0,1594,21,20,-1
"a49d1bb4328949299686242fd0be5584","d4f45188d3c84a02ba08454e6403a818",22900626,1,3,0,1596,21,24,3
"d4f45188d3c84a02ba08454e6403a818","d4c3b003e8274e429d2fa688d73fde6d",22900626,2,-2,0,1597,24,22,-2
"d4c3b003e8274e429d2fa688d73fde6d","d4c3b003e8274e429d2fa688d73fde6d",22900626,1,0,1,1598,22,22,0
"d4c3b003e8274e429d2fa688d73fde6d","b7719e26494940efa49512aedd0aac79",22900626,1,-3,0,1599,22,20,-2
"b7719e26494940efa49512aedd0aac79","c9c52446b6294aa5a9c2abaed536c37e",22900626,1,20,0,1600,20,32,12
"c9c52446b6294aa5a9c2abaed536c37e","4e51676dc72045d99c19b9fa7b22f8bc",22900626,1,-5,0,1601,32,29,-3
"4e51676dc72045d99c19b9fa7b22f8bc","4e51676dc72045d99c19b9fa7b22f8bc",22900626,1,0,1,1602,29,29,0
"4e51676dc72045d99c19b9fa7b22f8bc","c33c17be71ae4d588da7369472e5bb1b",22900626,2,9,0,1603,29,34,5
"c33c17be71ae4d588da7369472e5bb1b","93679be414554a11b1893002f2229a93",22900626,4,3,0,1604,34,35,1
"93679be414554a11b1893002f2229a93","c33c17be71ae4d588da7369472e5bb1b",22900626,3,-3,0,1605,35,34,-1
"c33c17be71ae4d588da7369472e5bb1b","ae5ac430ea254e708a6f5deaaf7464ae",22900626,1,73,0,1606,34,84,50
"ae5ac430ea254e708a6f5deaaf7464ae","d646286c8051419bbc2e31dd1db55ca8",22900626,5,-20,0,1607,84,67,-17
"d646286c8051419bbc2e31dd1db55ca8","6a9f0ef185fb47f0937e29daa1c71ed5",22900626,3,27,0,1608,67,90,23
"6a9f0ef185fb47f0937e29daa1c71ed5","6a9f0ef185fb47f0937e29daa1c71ed5",22900626,16,0,1,1609,90,90,0
"6a9f0ef185fb47f0937e29daa1c71ed5","ae5ac430ea254e708a6f5deaaf7464ae",22900626,5,-7,0,1611,90,84,-6
"ae5ac430ea254e708a6f5deaaf7464ae","42fb58708eaf4e5daa82bfca61b6f5fd",22900626,1,4,0,1612,84,87,3
"42fb58708eaf4e5daa82bfca61b6f5fd","f564483cbd7a407681aa2fcca518cf5f",22900626,1,-3,0,1613,87,85,-2
"f564483cbd7a407681aa2fcca518cf5f","f564483cbd7a407681aa2fcca518cf5f",22900626,6,0,1,1614,85,85,0
"f564483cbd7a407681aa2fcca518cf5f","18fd01350bd5434ca636d59a599d768a",22900626,2,1,0,1615,85,86,1
"18fd01350bd5434ca636d59a599d768a","ae5ac430ea254e708a6f5deaaf7464ae",22900626,2,-2,0,1616,86,84,-2
"ae5ac430ea254e708a6f5deaaf7464ae","6a9f0ef185fb47f0937e29daa1c71ed5",22900626,4,7,0,1617,84,90,6
"6a9f0ef185fb47f0937e29daa1c71ed5","42fb58708eaf4e5daa82bfca61b6f5fd",22900626,1,-3,0,1620,90,87,-3
"42fb58708eaf4e5daa82bfca61b6f5fd","6a9f0ef185fb47f0937e29daa1c71ed5",22900626,1,3,0,1621,87,90,3
"ae5ac430ea254e708a6f5deaaf7464ae","e20db35ced8544ddac5bc3839145e463",22900626,1,10,0,1625,84,91,7
"e20db35ced8544ddac5bc3839145e463","08111f75e22d409998cf8b85bd431f0a",22900626,2,19,0,1626,91,108,17
"08111f75e22d409998cf8b85bd431f0a","4280927ec4d643238aa49c32f9e06c6c",22900626,1,1,0,1627,108,109,1
"4280927ec4d643238aa49c32f9e06c6c","08111f75e22d409998cf8b85bd431f0a",22900626,1,-1,0,1628,109,108,-1
"08111f75e22d409998cf8b85bd431f0a","a9ae0a3c070d455bb4369a8996313336",22900626,3,7,0,1629,108,114,6
"a9ae0a3c070d455bb4369a8996313336","4280927ec4d643238aa49c32f9e06c6c",22900626,1,-6,0,1630,114,109,-5
"4280927ec4d643238aa49c32f9e06c6c","37319e88176d4aefa91d7a9980dbae91",22900626,1,4,0,1631,109,112,3
"37319e88176d4aefa91d7a9980dbae91","4280927ec4d643238aa49c32f9e06c6c",22900626,1,-4,0,1632,112,109,-3
"4280927ec4d643238aa49c32f9e06c6c","66baf19b6b904b70922329068c63746d",22900626,1,361,0,1633,109,376,267
"66baf19b6b904b70922329068c63746d","3cbcea2be0984e7dbd5a48195af10ce7",22900626,1,-288,0,1634,376,165,-211
"3cbcea2be0984e7dbd5a48195af10ce7","3cbcea2be0984e7dbd5a48195af10ce7",22900626,3,0,1,1635,165,165,0
"3cbcea2be0984e7dbd5a48195af10ce7","82e6285962b8400d9d6fc32436022a94",22900626,3,2,0,1636,165,167,2
"82e6285962b8400d9d6fc32436022a94","3cbcea2be0984e7dbd5a48195af10ce7",22900626,3,-2,0,1637,167,165,-2
"3cbcea2be0984e7dbd5a48195af10ce7","a9ac840f098c4bd0a2ee896214ce29cd",22900626,4,5,0,1638,165,168,3
"a9ac840f098c4bd0a2ee896214ce29cd","67a089198fcb4e1c8f2385786c2b296f",22900626,1,-165,0,1639,168,39,-129
"67a089198fcb4e1c8f2385786c2b296f","c33c17be71ae4d588da7369472e5bb1b",22900626,1,-16,0,1640,39,34,-5
"c33c17be71ae4d588da7369472e5bb1b","c33c17be71ae4d588da7369472e5bb1b",22900626,2,0,1,1641,34,34,0
"c33c17be71ae4d588da7369472e5bb1b","b613861cecf84ffcab01afb23f660475",22900626,1,-56,0,1642,34,1,-33
"b613861cecf84ffcab01afb23f660475","f661500307d74c908e9207d949ceb4aa",22900626,1,193,0,1643,1,136,135
"f661500307d74c908e9207d949ceb4aa","779f9ddd1fd14d1e9e69f72219a1fdbd",22900626,2,-18,0,1644,136,121,-15
"779f9ddd1fd14d1e9e69f72219a1fdbd","cd4532ad48034873ba8bce2aac0c9808",22900626,3,19,0,1645,121,137,16
"cd4532ad48034873ba8bce2aac0c9808","cd4532ad48034873ba8bce2aac0c9808",22900626,4,0,1,1646,137,137,0
"cd4532ad48034873ba8bce2aac0c9808","779f9ddd1fd14d1e9e69f72219a1fdbd",22900626,1,-19,0,1647,137,121,-16
"779f9ddd1fd14d1e9e69f72219a1fdbd","df1de691dafe4549a18a4398ee9dfaf9",22900626,1,23,0,1648,121,139,18
"df1de691dafe4549a18a4398ee9dfaf9","6c5ad271a44743479bfaea29b1db8d02",22900626,1,4,0,1649,139,143,4
"6c5ad271a44743479bfaea29b1db8d02","67a089198fcb4e1c8f2385786c2b296f",22900626,2,-130,0,1650,143,39,-104
"67a089198fcb4e1c8f2385786c2b296f","e20db35ced8544ddac5bc3839145e463",22900626,1,67,0,1651,39,91,52
"e20db35ced8544ddac5bc3839145e463","4280927ec4d643238aa49c32f9e06c6c",22900626,1,20,0,1652,91,109,18
"4280927ec4d643238aa49c32f9e06c6c","67a089198fcb4e1c8f2385786c2b296f",22900626,1,-87,0,1653,109,39,-70
"67a089198fcb4e1c8f2385786c2b296f","ae5ac430ea254e708a6f5deaaf7464ae",22900626,1,57,0,1654,39,84,45
"d646286c8051419bbc2e31dd1db55ca8","18fd01350bd5434ca636d59a599d768a",22900626,1,22,0,1656,67,86,19
"18fd01350bd5434ca636d59a599d768a","f564483cbd7a407681aa2fcca518cf5f",22900626,1,-1,0,1657,86,85,-1
"f564483cbd7a407681aa2fcca518cf5f","6a9f0ef185fb47f0937e29daa1c71ed5",22900626,1,6,0,1658,85,90,5
"ae5ac430ea254e708a6f5deaaf7464ae","67a089198fcb4e1c8f2385786c2b296f",22900626,1,-57,0,1662,84,39,-45
"67a089198fcb4e1c8f2385786c2b296f","f661500307d74c908e9207d949ceb4aa",22900626,1,121,0,1663,39,136,97
"cd4532ad48034873ba8bce2aac0c9808","df1de691dafe4549a18a4398ee9dfaf9",22900626,3,4,0,1667,137,139,2
"df1de691dafe4549a18a4398ee9dfaf9","779f9ddd1fd14d1e9e69f72219a1fdbd",22900626,3,-23,0,1668,139,121,-18
"779f9ddd1fd14d1e9e69f72219a1fdbd","6c5ad271a44743479bfaea29b1db8d02",22900626,3,27,0,1669,121,143,22
"67a089198fcb4e1c8f2385786c2b296f","3cbcea2be0984e7dbd5a48195af10ce7",22900626,1,160,0,1671,39,165,126
"a9ac840f098c4bd0a2ee896214ce29cd","139b097acfca451689d80c9c6eebdf7b",22900626,1,15,0,1676,168,178,10
"139b097acfca451689d80c9c6eebdf7b","0c7262dff33c4087bc660ccf40f92f9c",22900626,3,-11,0,1677,178,169,-9
"0c7262dff33c4087bc660ccf40f92f9c","ea38cc0e6e6e41edbabf210220808bf9",22900626,2,12,0,1678,169,179,10
"ea38cc0e6e6e41edbabf210220808bf9","b87c552dd247427abe6ab5795b9c9d43",22900626,6,2,0,1679,179,181,2
"b87c552dd247427abe6ab5795b9c9d43","139b097acfca451689d80c9c6eebdf7b",22900626,3,-3,0,1680,181,178,-3
"139b097acfca451689d80c9c6eebdf7b","2024b4885bd14338a39b7b509acbbd02",22900626,1,5,0,1681,178,182,4
"2024b4885bd14338a39b7b509acbbd02","ea38cc0e6e6e41edbabf210220808bf9",22900626,1,-4,0,1682,182,179,-3
"b87c552dd247427abe6ab5795b9c9d43","ea38cc0e6e6e41edbabf210220808bf9",22900626,3,-2,0,1684,181,179,-2
"ea38cc0e6e6e41edbabf210220808bf9","139b097acfca451689d80c9c6eebdf7b",22900626,2,-1,0,1685,179,178,-1
"139b097acfca451689d80c9c6eebdf7b","ea38cc0e6e6e41edbabf210220808bf9",22900626,2,1,0,1686,178,179,1
"ea38cc0e6e6e41edbabf210220808bf9","2024b4885bd14338a39b7b509acbbd02",22900626,1,4,0,1687,179,182,3
"2024b4885bd14338a39b7b509acbbd02","b87c552dd247427abe6ab5795b9c9d43",22900626,1,-2,0,1688,182,181,-1
"139b097acfca451689d80c9c6eebdf7b","01b2051f8941460d89945e3b02d1ce78",22900626,1,52,0,1691,178,217,39
"01b2051f8941460d89945e3b02d1ce78","d7f13c8d63ec4e2aa673fbb9cf9c6933",22900626,1,-14,0,1692,217,206,-11
"d7f13c8d63ec4e2aa673fbb9cf9c6933","363837c182e04711840d896ae1e0339c",22900626,1,15,0,1693,206,218,12
"363837c182e04711840d896ae1e0339c","01b2051f8941460d89945e3b02d1ce78",22900626,3,-1,0,1694,218,217,-1
"01b2051f8941460d89945e3b02d1ce78","be502a7a43c44bf7b682698de79d9369",22900626,1,-4,0,1695,217,214,-3
"be502a7a43c44bf7b682698de79d9369","be95c065e45447c1bd8215ea6f130c7a",22900626,1,7,0,1696,214,219,5
"be95c065e45447c1bd8215ea6f130c7a","f7fb1952f56b4189b86a9f8b7862d2b8",22900626,1,-6,0,1697,219,215,-4
"f7fb1952f56b4189b86a9f8b7862d2b8","ec341f459285443b8361f7f15638ff08",22900626,1,-2,0,1698,215,213,-2
"ec341f459285443b8361f7f15638ff08","363837c182e04711840d896ae1e0339c",22900626,2,6,0,1699,213,218,5
"01b2051f8941460d89945e3b02d1ce78","6e83e23f56544a19b94067c1c558d9c0",22900626,1,40,0,1701,217,247,30
"6e83e23f56544a19b94067c1c558d9c0","2ae94c0cea4d480a9d5dca8fb1d7b542",22900626,1,-6,0,1702,247,242,-5
"2ae94c0cea4d480a9d5dca8fb1d7b542","6e83e23f56544a19b94067c1c558d9c0",22900626,1,6,0,1703,242,247,5
"6e83e23f56544a19b94067c1c558d9c0","00f61990949545828dd12f1303d47504",22900626,2,11,0,1704,247,256,9
"00f61990949545828dd12f1303d47504","d546341988904f069cfa86b21457d9d9",22900626,1,-6,0,1705,256,251,-5
"d546341988904f069cfa86b21457d9d9","6e83e23f56544a19b94067c1c558d9c0",22900626,1,-5,0,1706,251,247,-4
"6e83e23f56544a19b94067c1c558d9c0","1ebf23f9d994469a85206e4c7b1bf5f5",22900626,1,-3,0,1707,247,245,-2
"1ebf23f9d994469a85206e4c7b1bf5f5","2ae94c0cea4d480a9d5dca8fb1d7b542",22900626,1,-3,0,1708,245,242,-3
"2ae94c0cea4d480a9d5dca8fb1d7b542","30c9ba177afc49a695625d2bdec40207",22900626,1,9,0,1709,242,250,8
"30c9ba177afc49a695625d2bdec40207","30c9ba177afc49a695625d2bdec40207",22900626,2,0,1,1710,250,250,0
"30c9ba177afc49a695625d2bdec40207","00f61990949545828dd12f1303d47504",22900626,1,8,0,1712,250,256,6
"00f61990949545828dd12f1303d47504","6e83e23f56544a19b94067c1c558d9c0",22900626,2,-11,0,1713,256,247,-9
"6e83e23f56544a19b94067c1c558d9c0","d546341988904f069cfa86b21457d9d9",22900626,1,5,0,1714,247,251,4
"d546341988904f069cfa86b21457d9d9","d989ebcfc12a4b669f0100dc1aa14f1e",22900626,1,5,0,1715,251,255,4
"d989ebcfc12a4b669f0100dc1aa14f1e","7aa76d3e993840d8805f097cbdbcd44b",22900626,1,7,0,1716,255,261,6
"7aa76d3e993840d8805f097cbdbcd44b","2ae94c0cea4d480a9d5dca8fb1d7b542",22900626,1,-23,0,1717,261,242,-19
"2ae94c0cea4d480a9d5dca8fb1d7b542","0d987bed3ffa4ed0b9a2e62e97b7b30f",22900626,2,38,0,1718,242,272,30
"0d987bed3ffa4ed0b9a2e62e97b7b30f","0c7262dff33c4087bc660ccf40f92f9c",22900626,1,-135,0,1719,272,169,-103
"0c7262dff33c4087bc660ccf40f92f9c","4a29443515bb404cb8924e1c60a63b73",22900626,1,157,0,1720,169,285,116
"4a29443515bb404cb8924e1c60a63b73","7646a919d7e64fa990bca9b024ff089d",22900626,1,17,0,1721,285,298,13
"7646a919d7e64fa990bca9b024ff089d","ba0e59461bfb4a44b7b1c28a01f8d3b3",22900626,1,1,0,1722,298,299,1
"0e0b36e731a645e7b1b8a88f5031ca38","7646a919d7e64fa990bca9b024ff089d",22900626,1,-3,0,1724,301,298,-3
"7646a919d7e64fa990bca9b024ff089d","2c5bb2cbd0014420ad8c95d40e38efd1",22900626,3,6,0,1725,298,303,5
"2c5bb2cbd0014420ad8c95d40e38efd1","ba0e59461bfb4a44b7b1c28a01f8d3b3",22900626,3,-5,0,1726,303,299,-4
"ba0e59461bfb4a44b7b1c28a01f8d3b3","7646a919d7e64fa990bca9b024ff089d",22900626,1,-1,0,1739,299,298,-1
"4a29443515bb404cb8924e1c60a63b73","d6d02b6ef04e4f17805504500b8ce441",22900626,2,118,0,1741,285,375,90
"d6d02b6ef04e4f17805504500b8ce441","4a29443515bb404cb8924e1c60a63b73",22900626,5,-118,0,1745,375,285,-90
"7f544639412e40a9ba27f43b415362ab","d6d02b6ef04e4f17805504500b8ce441",22900626,1,-6,0,1752,378,375,-3
"d6d02b6ef04e4f17805504500b8ce441","b71bac264efb4abd97015447bd490db6",22900626,2,-8,0,1755,375,370,-5
"d6d02b6ef04e4f17805504500b8ce441","8d448d625b024c82a5eb240bbd7431d6",22900626,1,-3,0,1758,375,374,-1
"8d448d625b024c82a5eb240bbd7431d6","d6d02b6ef04e4f17805504500b8ce441",22900626,1,3,0,1766,374,375,1
"4a29443515bb404cb8924e1c60a63b73","ba0e59461bfb4a44b7b1c28a01f8d3b3",22900626,1,18,0,1771,285,299,14
"ba0e59461bfb4a44b7b1c28a01f8d3b3","d6d02b6ef04e4f17805504500b8ce441",22900626,1,100,0,1772,299,375,76
"4a29443515bb404cb8924e1c60a63b73","66baf19b6b904b70922329068c63746d",22900626,1,122,0,1777,285,376,91
"66baf19b6b904b70922329068c63746d","df8191ec5e584c838a899c378941a566",22900626,1,28,0,1778,376,398,22
"df8191ec5e584c838a899c378941a566","859e0b8d71694b12befb69ee698138f9",22900626,1,1,0,1779,398,399,1
"859e0b8d71694b12befb69ee698138f9","859e0b8d71694b12befb69ee698138f9",22900626,1,0,1,1780,399,399,0
"859e0b8d71694b12befb69ee698138f9","66baf19b6b904b70922329068c63746d",22900626,1,-29,0,1781,399,376,-23
"2b09a08242b54983aec7063990fb3f66","3c8a22d2f9c146ea956609e3ed4f2559",22900626,1,7,0,1785,400,405,5
"58fc9094275e4c49be3f4ba6d4acc0a4","3c8a22d2f9c146ea956609e3ed4f2559",22900626,1,-2,0,1788,406,405,-1
"3c8a22d2f9c146ea956609e3ed4f2559","1157bd665ec4472fb58b751dc5099355",22900626,1,-3,0,1789,405,403,-2
"58fc9094275e4c49be3f4ba6d4acc0a4","66baf19b6b904b70922329068c63746d",22900626,1,-41,0,1792,406,376,-30
"a2b4bd40cee2481ebd3fc179d6a5cd62","e34e59dce2204f228f3a84b6725df60f",22900626,1,2,0,1795,417,419,2
"e34e59dce2204f228f3a84b6725df60f","bec48fc2e1294c7eb3d0aca780d731b8",22900626,2,2,0,1797,419,420,1
"bec48fc2e1294c7eb3d0aca780d731b8","e34e59dce2204f228f3a84b6725df60f",22900626,1,-2,0,1800,420,419,-1
"a2b4bd40cee2481ebd3fc179d6a5cd62","66baf19b6b904b70922329068c63746d",22900626,1,-59,0,1803,417,376,-41
"a2b4bd40cee2481ebd3fc179d6a5cd62","5d290f75e44b4bdb8256c600debbb44d",22900626,1,13,0,1805,417,426,9
"5d290f75e44b4bdb8256c600debbb44d","a2b4bd40cee2481ebd3fc179d6a5cd62",22900626,2,-13,0,1806,426,417,-9
"66baf19b6b904b70922329068c63746d","5d290f75e44b4bdb8256c600debbb44d",22900626,1,72,0,1810,376,426,50
"24cf8786024543f19b89bc20034e60d7","a2b4bd40cee2481ebd3fc179d6a5cd62",22900626,2,-18,0,1813,428,417,-11
"a2b4bd40cee2481ebd3fc179d6a5cd62","f2a73be2f46840b182d7bd095378004e",22900626,1,19,0,1814,417,429,12
"f2a73be2f46840b182d7bd095378004e","24cf8786024543f19b89bc20034e60d7",22900626,1,-1,0,1815,429,428,-1
"f2a73be2f46840b182d7bd095378004e","a2b4bd40cee2481ebd3fc179d6a5cd62",22900626,1,-19,0,1820,429,417,-12
"0380cd76a7d44bc3a4da1f15e4d68f89","66baf19b6b904b70922329068c63746d",22900626,1,-95,0,1828,440,376,-64
"66baf19b6b904b70922329068c63746d","9428d8bd9c5a47b2a235b254e5e27ded",22900626,1,116,0,1829,376,452,76
"9428d8bd9c5a47b2a235b254e5e27ded","b2f0d654738f48158edff28e8d3a546e",22900626,1,-4,0,1830,452,449,-3
"f67fbf45a5f146ed866965bc57c7c001","66baf19b6b904b70922329068c63746d",22900626,1,-120,0,1843,454,376,-78
"66baf19b6b904b70922329068c63746d","b2f0d654738f48158edff28e8d3a546e",22900626,1,112,0,1844,376,449,73
"b2f0d654738f48158edff28e8d3a546e","9428d8bd9c5a47b2a235b254e5e27ded",22900626,1,4,0,1845,449,452,3
"9428d8bd9c5a47b2a235b254e5e27ded","f60ee41ec635499abd48168342d32c2f",22900626,1,1,0,1846,452,453,1
"f60ee41ec635499abd48168342d32c2f","f67fbf45a5f146ed866965bc57c7c001",22900626,1,3,0,1854,453,454,1
"f67fbf45a5f146ed866965bc57c7c001","b2f0d654738f48158edff28e8d3a546e",22900626,1,-8,0,1855,454,449,-5
"b2f0d654738f48158edff28e8d3a546e","66baf19b6b904b70922329068c63746d",22900626,1,-112,0,1856,449,376,-73
"66baf19b6b904b70922329068c63746d","c5df9f40ec14463b9dcfdc73df3e9285",22900626,1,132,0,1857,376,464,88
"c5df9f40ec14463b9dcfdc73df3e9285","c5df9f40ec14463b9dcfdc73df3e9285",22900626,6,0,1,1858,464,464,0
"c5df9f40ec14463b9dcfdc73df3e9285","83d42d95cd844fc093fc09cee250edb8",22900626,2,3,0,1861,464,465,1
"83d42d95cd844fc093fc09cee250edb8","83d42d95cd844fc093fc09cee250edb8",22900626,5,0,1,1862,465,465,0
"83d42d95cd844fc093fc09cee250edb8","66baf19b6b904b70922329068c63746d",22900626,2,-135,0,1865,465,376,-89
"66baf19b6b904b70922329068c63746d","d6d02b6ef04e4f17805504500b8ce441",22900626,2,-4,0,1866,376,375,-1
"4a29443515bb404cb8924e1c60a63b73","c5df9f40ec14463b9dcfdc73df3e9285",22900626,1,254,0,1871,285,464,179
"b613861cecf84ffcab01afb23f660475","b613861cecf84ffcab01afb23f660475",22901385,4,0,1,1,1,1,0
"b613861cecf84ffcab01afb23f660475","e2911e79efc2420eac45d9f671463d4b",22901385,1,3,0,5,1,2,1
"e2911e79efc2420eac45d9f671463d4b","e2911e79efc2420eac45d9f671463d4b",22901385,2,0,1,6,2,2,0
"e2911e79efc2420eac45d9f671463d4b","519d1b8c59404d67b54e96c5c8a830b2",22901385,1,1,0,8,2,3,1
"519d1b8c59404d67b54e96c5c8a830b2","519d1b8c59404d67b54e96c5c8a830b2",22901385,1,0,1,9,3,3,0
"519d1b8c59404d67b54e96c5c8a830b2","531db53f81f646edb0cdcfe0085b03b7",22901385,1,1,0,10,3,4,1
"531db53f81f646edb0cdcfe0085b03b7","531db53f81f646edb0cdcfe0085b03b7",22901385,1,0,1,11,4,4,0
"531db53f81f646edb0cdcfe0085b03b7","4f5f94b2f95141e0a9d53a61da2276da",22901385,1,1,0,12,4,5,1
"4f5f94b2f95141e0a9d53a61da2276da","4f5f94b2f95141e0a9d53a61da2276da",22901385,1,0,1,13,5,5,0
"4f5f94b2f95141e0a9d53a61da2276da","6d541c89590949f99af293c4f2333f67",22901385,1,1,0,14,5,6,1
"6d541c89590949f99af293c4f2333f67","6d541c89590949f99af293c4f2333f67",22901385,1,0,1,15,6,6,0
"6d541c89590949f99af293c4f2333f67","dd5cf0b9fe4c4f1d8f5ff8e4c04879cb",22901385,1,1,0,16,6,7,1
"dd5cf0b9fe4c4f1d8f5ff8e4c04879cb","dd5cf0b9fe4c4f1d8f5ff8e4c04879cb",22901385,1,0,1,17,7,7,0
"dd5cf0b9fe4c4f1d8f5ff8e4c04879cb","f96261861edc426abe2248be4f0a709a",22901385,1,1,0,18,7,8,1
"f96261861edc426abe2248be4f0a709a","f96261861edc426abe2248be4f0a709a",22901385,1,0,1,19,8,8,0
"f96261861edc426abe2248be4f0a709a","66b5e16f4f75454fb5b8172079f0fa83",22901385,1,1,0,20,8,9,1
"66b5e16f4f75454fb5b8172079f0fa83","66b5e16f4f75454fb5b8172079f0fa83",22901385,1,0,1,21,9,9,0
"66b5e16f4f75454fb5b8172079f0fa83","0680571d4698477995e41842c36a54b2",22901385,1,1,0,22,9,10,1
"0680571d4698477995e41842c36a54b2","0680571d4698477995e41842c36a54b2",22901385,1,0,1,23,10,10,0
"0680571d4698477995e41842c36a54b2","9112f2bffece48e08c6d2287be204085",22901385,1,1,0,24,10,11,1
"9112f2bffece48e08c6d2287be204085","9112f2bffece48e08c6d2287be204085",22901385,1,0,1,25,11,11,0
"9112f2bffece48e08c6d2287be204085","56586aa865414f538729c7f7735d2bc6",22901385,1,3,0,26,11,12,1
"56586aa865414f538729c7f7735d2bc6","e2911e79efc2420eac45d9f671463d4b",22901385,1,-12,0,27,12,2,-10
"e2911e79efc2420eac45d9f671463d4b","56586aa865414f538729c7f7735d2bc6",22901385,1,12,0,28,2,12,10
"56586aa865414f538729c7f7735d2bc6","56586aa865414f538729c7f7735d2bc6",22901385,1,0,1,29,12,12,0
"56586aa865414f538729c7f7735d2bc6","b7f2b31585d94eb3bf86376714aa7070",22901385,2,2,0,30,12,13,1
"b7f2b31585d94eb3bf86376714aa7070","56586aa865414f538729c7f7735d2bc6",22901385,1,-2,0,31,13,12,-1
"b7f2b31585d94eb3bf86376714aa7070","b7f2b31585d94eb3bf86376714aa7070",22901385,1,0,1,33,13,13,0
"b7f2b31585d94eb3bf86376714aa7070","3f1c815879794b929260d224becaff7e",22901385,1,2,0,34,13,14,1
"3f1c815879794b929260d224becaff7e","81c864a886d54a6b8ff85f7d736f4f95",22901385,1,2,0,35,14,15,1
"81c864a886d54a6b8ff85f7d736f4f95","5c5ceeee4562457ba6d41515aeebfbb1",22901385,1,4,0,36,15,17,2
"5c5ceeee4562457ba6d41515aeebfbb1","5c5ceeee4562457ba6d41515aeebfbb1",22901385,1,0,1,37,17,17,0
"5c5ceeee4562457ba6d41515aeebfbb1","9afd71a5298d4333b6849dfce1b9422c",22901385,1,3,0,38,17,18,1
"9afd71a5298d4333b6849dfce1b9422c","56586aa865414f538729c7f7735d2bc6",22901385,1,-13,0,39,18,12,-6
"56586aa865414f538729c7f7735d2bc6","b7719e26494940efa49512aedd0aac79",22901385,1,17,0,40,12,20,8
"b7719e26494940efa49512aedd0aac79","9afd71a5298d4333b6849dfce1b9422c",22901385,1,-4,0,41,20,18,-2
"9afd71a5298d4333b6849dfce1b9422c","d4f45188d3c84a02ba08454e6403a818",22901385,1,9,0,42,18,24,6
"d4f45188d3c84a02ba08454e6403a818","d4c3b003e8274e429d2fa688d73fde6d",22901385,1,-2,0,43,24,22,-2
"d4c3b003e8274e429d2fa688d73fde6d","d4c3b003e8274e429d2fa688d73fde6d",22901385,1,0,1,44,22,22,0
"d4c3b003e8274e429d2fa688d73fde6d","5bc03c8f16354d04bd51f5bb93559ad3",22901385,1,4,0,45,22,26,4
"5bc03c8f16354d04bd51f5bb93559ad3","b7719e26494940efa49512aedd0aac79",22901385,1,-7,0,46,26,20,-6
"b7719e26494940efa49512aedd0aac79","afbf7250b99d47bea07172749483ca97",22901385,1,12,0,47,20,28,8
"afbf7250b99d47bea07172749483ca97","b7719e26494940efa49512aedd0aac79",22901385,1,-12,0,48,28,20,-8
"b7719e26494940efa49512aedd0aac79","4e51676dc72045d99c19b9fa7b22f8bc",22901385,1,15,0,49,20,29,9
"4e51676dc72045d99c19b9fa7b22f8bc","afbf7250b99d47bea07172749483ca97",22901385,1,-3,0,50,29,28,-1
"afbf7250b99d47bea07172749483ca97","4e51676dc72045d99c19b9fa7b22f8bc",22901385,1,3,0,51,28,29,1
"4e51676dc72045d99c19b9fa7b22f8bc","51970cfa30e643e894e66ae85c8024cc",22901385,1,3,0,52,29,31,2
"51970cfa30e643e894e66ae85c8024cc","c33c17be71ae4d588da7369472e5bb1b",22901385,1,6,0,53,31,34,3
"c33c17be71ae4d588da7369472e5bb1b","4e51676dc72045d99c19b9fa7b22f8bc",22901385,1,-9,0,54,34,29,-5
"4e51676dc72045d99c19b9fa7b22f8bc","c33c17be71ae4d588da7369472e5bb1b",22901385,1,9,0,55,29,34,5
"c33c17be71ae4d588da7369472e5bb1b","93679be414554a11b1893002f2229a93",22901385,1,3,0,56,34,35,1
"93679be414554a11b1893002f2229a93","7040a13096d746ac84b8fac8d9752058",22901385,2,3,0,57,35,36,1
"7040a13096d746ac84b8fac8d9752058","93679be414554a11b1893002f2229a93",22901385,1,-3,0,58,36,35,-1
"7040a13096d746ac84b8fac8d9752058","9a0dc646f934470daf08c4b56ccf73db",22901385,1,3,0,60,36,37,1
"9a0dc646f934470daf08c4b56ccf73db","fc0e049d56024bc9a02c9a9c435c3df7",22901385,1,3,0,61,37,38,1
"fc0e049d56024bc9a02c9a9c435c3df7","9a0dc646f934470daf08c4b56ccf73db",22901385,1,-3,0,62,38,37,-1
"9a0dc646f934470daf08c4b56ccf73db","67a089198fcb4e1c8f2385786c2b296f",22901385,1,7,0,63,37,39,2
"67a089198fcb4e1c8f2385786c2b296f","fc0e049d56024bc9a02c9a9c435c3df7",22901385,1,-4,0,64,39,38,-1
"fc0e049d56024bc9a02c9a9c435c3df7","64d48c6c9c7940639a932219a6c87198",22901385,1,5,0,65,38,40,2
"64d48c6c9c7940639a932219a6c87198","64d48c6c9c7940639a932219a6c87198",22901385,1,0,1,66,40,40,0
"64d48c6c9c7940639a932219a6c87198","67a089198fcb4e1c8f2385786c2b296f",22901385,1,-1,0,67,40,39,-1
"67a089198fcb4e1c8f2385786c2b296f","b534b89233134e30a9b5645138bfa9ee",22901385,1,4,0,68,39,41,2
"b534b89233134e30a9b5645138bfa9ee","0e37b720d23b4e7f8b313e79313fd107",22901385,1,3,0,69,41,44,3
"0e37b720d23b4e7f8b313e79313fd107","0e37b720d23b4e7f8b313e79313fd107",22901385,5,0,1,70,44,44,0
"0e37b720d23b4e7f8b313e79313fd107","6875d67fdd5f48168b62719df449bebd",22901385,1,1,0,75,44,45,1
"6875d67fdd5f48168b62719df449bebd","6875d67fdd5f48168b62719df449bebd",22901385,1,0,1,76,45,45,0
"6875d67fdd5f48168b62719df449bebd","b534b89233134e30a9b5645138bfa9ee",22901385,1,-4,0,77,45,41,-4
"b534b89233134e30a9b5645138bfa9ee","6e13d61a7bdb44bca949c9f86fab3be5",22901385,1,7,0,78,41,47,6
"6e13d61a7bdb44bca949c9f86fab3be5","6e13d61a7bdb44bca949c9f86fab3be5",22901385,3,0,1,79,47,47,0
"6e13d61a7bdb44bca949c9f86fab3be5","195f78799f984cc2b06c48dfe36be751",22901385,1,2,0,82,47,49,2
"195f78799f984cc2b06c48dfe36be751","195f78799f984cc2b06c48dfe36be751",22901385,2,0,1,83,49,49,0
"195f78799f984cc2b06c48dfe36be751","d0c74f735e024943943e40333d6d337f",22901385,1,3,0,85,49,51,2
"d0c74f735e024943943e40333d6d337f","d9c8d8c444a64dadbbb508652c721e17",22901385,1,-6,0,86,51,46,-5
"d9c8d8c444a64dadbbb508652c721e17","d0c74f735e024943943e40333d6d337f",22901385,1,6,0,87,46,51,5
"d0c74f735e024943943e40333d6d337f","983f8ff320594b279a7f4a6fe132f9c5",22901385,1,2,0,88,51,53,2
"983f8ff320594b279a7f4a6fe132f9c5","983f8ff320594b279a7f4a6fe132f9c5",22901385,2,0,1,89,53,53,0
"983f8ff320594b279a7f4a6fe132f9c5","35adfa5d923046aebabfefd98f35ff05",22901385,1,1,0,91,53,54,1
"35adfa5d923046aebabfefd98f35ff05","35adfa5d923046aebabfefd98f35ff05",22901385,5,0,1,92,54,54,0
"35adfa5d923046aebabfefd98f35ff05","b6f8a98476224da1b40e555ececc7ed8",22901385,1,1,0,97,54,55,1
"b6f8a98476224da1b40e555ececc7ed8","b6f8a98476224da1b40e555ececc7ed8",22901385,5,0,1,100,55,55,0
"b6f8a98476224da1b40e555ececc7ed8","86e22cb5fe0e4b47a9489ecddf7ed78f",22901385,1,1,0,103,55,56,1
"86e22cb5fe0e4b47a9489ecddf7ed78f","86e22cb5fe0e4b47a9489ecddf7ed78f",22901385,2,0,1,104,56,56,0
"86e22cb5fe0e4b47a9489ecddf7ed78f","f924752d8a1149668870b1e7698486f7",22901385,1,-6,0,106,56,50,-6
"f924752d8a1149668870b1e7698486f7","a1f2f12debe5432fb7a70bcd12bacfb9",22901385,1,9,0,107,50,58,8
"a1f2f12debe5432fb7a70bcd12bacfb9","78f30e4dcac84e3cbea8b2cc6e0d62b3",22901385,2,1,0,108,58,59,1
"78f30e4dcac84e3cbea8b2cc6e0d62b3","a1f2f12debe5432fb7a70bcd12bacfb9",22901385,1,-1,0,109,59,58,-1
"a1f2f12debe5432fb7a70bcd12bacfb9","a1f2f12debe5432fb7a70bcd12bacfb9",22901385,22,0,1,110,58,58,0
"78f30e4dcac84e3cbea8b2cc6e0d62b3","78f30e4dcac84e3cbea8b2cc6e0d62b3",22901385,19,0,1,133,59,59,0
"78f30e4dcac84e3cbea8b2cc6e0d62b3","12aa6e1672ac4e7aa6449a7a8609cd72",22901385,1,-2,0,152,59,57,-2
"12aa6e1672ac4e7aa6449a7a8609cd72","a0a418b8540d479fa6e0f653b701da8b",22901385,1,8,0,153,57,64,7
"a0a418b8540d479fa6e0f653b701da8b","bc42d26810654ea9a1df1efe1e58c7d5",22901385,1,-1,0,154,64,63,-1
"bc42d26810654ea9a1df1efe1e58c7d5","4c943503763e4e349906eea3ed3c8e86",22901385,1,-2,0,155,63,61,-2
"4c943503763e4e349906eea3ed3c8e86","4c943503763e4e349906eea3ed3c8e86",22901385,1,0,1,156,61,61,0
"4c943503763e4e349906eea3ed3c8e86","bc42d26810654ea9a1df1efe1e58c7d5",22901385,1,2,0,157,61,63,2
"bc42d26810654ea9a1df1efe1e58c7d5","bc42d26810654ea9a1df1efe1e58c7d5",22901385,3,0,1,158,63,63,0
"bc42d26810654ea9a1df1efe1e58c7d5","a0a418b8540d479fa6e0f653b701da8b",22901385,1,1,0,161,63,64,1
"a0a418b8540d479fa6e0f653b701da8b","a0a418b8540d479fa6e0f653b701da8b",22901385,3,0,1,162,64,64,0
"a0a418b8540d479fa6e0f653b701da8b","309ccf3cc4fe429d9bfbaef53d3fa479",22901385,1,-4,0,165,64,60,-4
"309ccf3cc4fe429d9bfbaef53d3fa479","d646286c8051419bbc2e31dd1db55ca8",22901385,1,10,0,166,60,67,7
"d646286c8051419bbc2e31dd1db55ca8","b534b89233134e30a9b5645138bfa9ee",22901385,1,-33,0,167,67,41,-26
"b534b89233134e30a9b5645138bfa9ee","d646286c8051419bbc2e31dd1db55ca8",22901385,1,33,0,168,41,67,26
"d646286c8051419bbc2e31dd1db55ca8","d646286c8051419bbc2e31dd1db55ca8",22901385,1,0,1,169,67,67,0
"d646286c8051419bbc2e31dd1db55ca8","267f883678b24aed855fde42524975d9",22901385,1,4,0,170,67,71,4
"267f883678b24aed855fde42524975d9","267f883678b24aed855fde42524975d9",22901385,1,0,1,171,71,71,0
"267f883678b24aed855fde42524975d9","88fff56d0342490dbef9040750a20f6c",22901385,1,1,0,172,71,72,1
"88fff56d0342490dbef9040750a20f6c","88fff56d0342490dbef9040750a20f6c",22901385,1,0,1,173,72,72,0
"88fff56d0342490dbef9040750a20f6c","adb17b12b66c4a49a85fd34322f7df70",22901385,1,1,0,174,72,73,1
"adb17b12b66c4a49a85fd34322f7df70","adb17b12b66c4a49a85fd34322f7df70",22901385,1,0,1,175,73,73,0
"adb17b12b66c4a49a85fd34322f7df70","d646286c8051419bbc2e31dd1db55ca8",22901385,1,-6,0,176,73,67,-6
"d646286c8051419bbc2e31dd1db55ca8","a2becd407db34b189200a32546d9d569",22901385,1,9,0,177,67,75,8
"a2becd407db34b189200a32546d9d569","a2becd407db34b189200a32546d9d569",22901385,1,0,1,178,75,75,0
"a2becd407db34b189200a32546d9d569","58c22b011d0f4c2ea6d13615edbb9eeb",22901385,1,2,0,179,75,77,2
"58c22b011d0f4c2ea6d13615edbb9eeb","58c22b011d0f4c2ea6d13615edbb9eeb",22901385,2,0,1,180,77,77,0
"58c22b011d0f4c2ea6d13615edbb9eeb","dd76e1861dc9461c830888729d091ee0",22901385,1,1,0,182,77,78,1
"dd76e1861dc9461c830888729d091ee0","dd76e1861dc9461c830888729d091ee0",22901385,2,0,1,183,78,78,0
"dd76e1861dc9461c830888729d091ee0","cd1d828f1a694b87913a7ea66c23803e",22901385,1,1,0,185,78,79,1
"cd1d828f1a694b87913a7ea66c23803e","cd1d828f1a694b87913a7ea66c23803e",22901385,2,0,1,186,79,79,0
"cd1d828f1a694b87913a7ea66c23803e","9176a3c2b4d2465fa8b0c67096c2a97e",22901385,1,1,0,188,79,80,1
"9176a3c2b4d2465fa8b0c67096c2a97e","9176a3c2b4d2465fa8b0c67096c2a97e",22901385,11,0,1,189,80,80,0
"9176a3c2b4d2465fa8b0c67096c2a97e","f8ec6445f7194e25b9101d4fbcb07a18",22901385,1,1,0,200,80,81,1
"f8ec6445f7194e25b9101d4fbcb07a18","f8ec6445f7194e25b9101d4fbcb07a18",22901385,2,0,1,201,81,81,0
"f8ec6445f7194e25b9101d4fbcb07a18","140d5b27b8574befad82c0a013b59dfa",22901385,1,-7,0,203,81,74,-7
"140d5b27b8574befad82c0a013b59dfa","d18a9ea32855445f8736581f5cb119ce",22901385,1,9,0,204,74,82,8
"d18a9ea32855445f8736581f5cb119ce","f564483cbd7a407681aa2fcca518cf5f",22901385,1,4,0,205,82,85,3
"f564483cbd7a407681aa2fcca518cf5f","f564483cbd7a407681aa2fcca518cf5f",22901385,4,0,1,206,85,85,0
"f564483cbd7a407681aa2fcca518cf5f","18fd01350bd5434ca636d59a599d768a",22901385,1,1,0,210,85,86,1
"18fd01350bd5434ca636d59a599d768a","18fd01350bd5434ca636d59a599d768a",22901385,9,0,1,211,86,86,0
"18fd01350bd5434ca636d59a599d768a","ae5ac430ea254e708a6f5deaaf7464ae",22901385,1,-2,0,220,86,84,-2
"ae5ac430ea254e708a6f5deaaf7464ae","6a9f0ef185fb47f0937e29daa1c71ed5",22901385,1,7,0,221,84,90,6
"6a9f0ef185fb47f0937e29daa1c71ed5","c681290961c94c4caf23b529d1ae6b9a",22901385,1,-2,0,222,90,88,-2
"c681290961c94c4caf23b529d1ae6b9a","c681290961c94c4caf23b529d1ae6b9a",22901385,1,0,1,223,88,88,0
"c681290961c94c4caf23b529d1ae6b9a","6a9f0ef185fb47f0937e29daa1c71ed5",22901385,1,2,0,224,88,90,2
"6a9f0ef185fb47f0937e29daa1c71ed5","6a9f0ef185fb47f0937e29daa1c71ed5",22901385,3,0,1,225,90,90,0
"6a9f0ef185fb47f0937e29daa1c71ed5","d646286c8051419bbc2e31dd1db55ca8",22901385,1,-27,0,228,90,67,-23
"d646286c8051419bbc2e31dd1db55ca8","e20db35ced8544ddac5bc3839145e463",22901385,1,30,0,229,67,91,24
"e20db35ced8544ddac5bc3839145e463","1febb706d7a34005ae8711ed49c76e64",22901385,1,3,0,230,91,94,3
"1febb706d7a34005ae8711ed49c76e64","1febb706d7a34005ae8711ed49c76e64",22901385,2,0,1,231,94,94,0
"1febb706d7a34005ae8711ed49c76e64","8f73ba6f5a0042f2850356ac38ac6f24",22901385,1,1,0,233,94,95,1
"8f73ba6f5a0042f2850356ac38ac6f24","8f73ba6f5a0042f2850356ac38ac6f24",22901385,5,0,1,234,95,95,0
"8f73ba6f5a0042f2850356ac38ac6f24","e2260b86653c46d7b14a41fb419dbf8c",22901385,1,1,0,239,95,96,1
"e2260b86653c46d7b14a41fb419dbf8c","e2260b86653c46d7b14a41fb419dbf8c",22901385,2,0,1,240,96,96,0
"e2260b86653c46d7b14a41fb419dbf8c","35eb641ad1d845bbba54915bce75a962",22901385,1,1,0,242,96,97,1
"35eb641ad1d845bbba54915bce75a962","35eb641ad1d845bbba54915bce75a962",22901385,2,0,1,243,97,97,0
"35eb641ad1d845bbba54915bce75a962","08be90ffbeea4795a138cd42ed8db56f",22901385,1,1,0,245,97,98,1
"08be90ffbeea4795a138cd42ed8db56f","08be90ffbeea4795a138cd42ed8db56f",22901385,6,0,1,246,98,98,0
"08be90ffbeea4795a138cd42ed8db56f","3007433c8f584dcbb5ac159c1c5f2be3",22901385,1,1,0,252,98,99,1
"3007433c8f584dcbb5ac159c1c5f2be3","3007433c8f584dcbb5ac159c1c5f2be3",22901385,2,0,1,253,99,99,0
"3007433c8f584dcbb5ac159c1c5f2be3","00ae5f0c51874a73a41ebea838d95682",22901385,1,3,0,255,99,101,2
"00ae5f0c51874a73a41ebea838d95682","e20db35ced8544ddac5bc3839145e463",22901385,1,-11,0,256,101,91,-10
"e20db35ced8544ddac5bc3839145e463","d391c8b6e56a43a7b654e9dee02d904b",22901385,1,13,0,257,91,103,12
"d391c8b6e56a43a7b654e9dee02d904b","00ae5f0c51874a73a41ebea838d95682",22901385,1,-2,0,258,103,101,-2
"00ae5f0c51874a73a41ebea838d95682","00ae5f0c51874a73a41ebea838d95682",22901385,2,0,1,259,101,101,0
"00ae5f0c51874a73a41ebea838d95682","d391c8b6e56a43a7b654e9dee02d904b",22901385,1,2,0,261,101,103,2
"d391c8b6e56a43a7b654e9dee02d904b","d391c8b6e56a43a7b654e9dee02d904b",22901385,15,0,1,262,103,103,0
"d391c8b6e56a43a7b654e9dee02d904b","6111116566fc4fd9abba409322bea245",22901385,1,1,0,277,103,104,1
"6111116566fc4fd9abba409322bea245","6111116566fc4fd9abba409322bea245",22901385,2,0,1,278,104,104,0
"6111116566fc4fd9abba409322bea245","a81b2235cb9c499eb9ea8ee0a8dd9725",22901385,1,1,0,280,104,105,1
"a81b2235cb9c499eb9ea8ee0a8dd9725","a81b2235cb9c499eb9ea8ee0a8dd9725",22901385,2,0,1,281,105,105,0
"a81b2235cb9c499eb9ea8ee0a8dd9725","2d4e0ab0ef3b4d73b82c72d4621a7579",22901385,1,1,0,283,105,106,1
"2d4e0ab0ef3b4d73b82c72d4621a7579","2d4e0ab0ef3b4d73b82c72d4621a7579",22901385,2,0,1,284,106,106,0
"2d4e0ab0ef3b4d73b82c72d4621a7579","8bdebf492ebd4e62b0d522e8ab5e5197",22901385,1,1,0,286,106,107,1
"8bdebf492ebd4e62b0d522e8ab5e5197","8bdebf492ebd4e62b0d522e8ab5e5197",22901385,2,0,1,287,107,107,0
"8bdebf492ebd4e62b0d522e8ab5e5197","73039f8c1eb9409cb4caee2cf968001e",22901385,1,-7,0,289,107,100,-7
"73039f8c1eb9409cb4caee2cf968001e","4280927ec4d643238aa49c32f9e06c6c",22901385,1,10,0,290,100,109,9
"4280927ec4d643238aa49c32f9e06c6c","4280927ec4d643238aa49c32f9e06c6c",22901385,1,0,1,291,109,109,0
"4280927ec4d643238aa49c32f9e06c6c","fc44e6a5f7654430af1227838224dceb",22901385,1,2,0,292,109,111,2
"fc44e6a5f7654430af1227838224dceb","fc44e6a5f7654430af1227838224dceb",22901385,2,0,1,293,111,111,0
"fc44e6a5f7654430af1227838224dceb","a9ae0a3c070d455bb4369a8996313336",22901385,1,4,0,295,111,114,3
"a9ae0a3c070d455bb4369a8996313336","08111f75e22d409998cf8b85bd431f0a",22901385,1,-7,0,296,114,108,-6
"08111f75e22d409998cf8b85bd431f0a","71cec822bcff4f30a20e75dc63ef7b65",22901385,1,9,0,297,108,116,8
"71cec822bcff4f30a20e75dc63ef7b65","71cec822bcff4f30a20e75dc63ef7b65",22901385,1,0,1,298,116,116,0
"71cec822bcff4f30a20e75dc63ef7b65","37319e88176d4aefa91d7a9980dbae91",22901385,1,-4,0,299,116,112,-4
"37319e88176d4aefa91d7a9980dbae91","62bff51286ef4f348717a3cf6fe2318f",22901385,1,9,0,300,112,120,8
"62bff51286ef4f348717a3cf6fe2318f","b1cd0e7dc3ad4a8eb91a4bfdbeb025b0",22901385,1,-2,0,301,120,118,-2
"b1cd0e7dc3ad4a8eb91a4bfdbeb025b0","b1cd0e7dc3ad4a8eb91a4bfdbeb025b0",22901385,1,0,1,302,118,118,0
"b1cd0e7dc3ad4a8eb91a4bfdbeb025b0","62bff51286ef4f348717a3cf6fe2318f",22901385,1,2,0,303,118,120,2
"62bff51286ef4f348717a3cf6fe2318f","62bff51286ef4f348717a3cf6fe2318f",22901385,3,0,1,304,120,120,0
"62bff51286ef4f348717a3cf6fe2318f","e20db35ced8544ddac5bc3839145e463",22901385,1,-33,0,307,120,91,-29
"e20db35ced8544ddac5bc3839145e463","779f9ddd1fd14d1e9e69f72219a1fdbd",22901385,1,36,0,308,91,121,30
"779f9ddd1fd14d1e9e69f72219a1fdbd","ae26e6cda8ad4a3f81bd347560d9579f",22901385,1,4,0,309,121,125,4
"ae26e6cda8ad4a3f81bd347560d9579f","ae26e6cda8ad4a3f81bd347560d9579f",22901385,5,0,1,310,125,125,0
"ae26e6cda8ad4a3f81bd347560d9579f","ee48df95832b4374aa273ceb27ec1315",22901385,1,1,0,315,125,126,1
"ee48df95832b4374aa273ceb27ec1315","ee48df95832b4374aa273ceb27ec1315",22901385,1,0,1,316,126,126,0
"ee48df95832b4374aa273ceb27ec1315","7a439da90b394756ad1777fc4c6dead5",22901385,1,1,0,317,126,127,1
"7a439da90b394756ad1777fc4c6dead5","7a439da90b394756ad1777fc4c6dead5",22901385,1,0,1,318,127,127,0
"7a439da90b394756ad1777fc4c6dead5","a8dd5213034441ac92724b4e83eb0bb2",22901385,1,3,0,319,127,129,2
"a8dd5213034441ac92724b4e83eb0bb2","779f9ddd1fd14d1e9e69f72219a1fdbd",22901385,1,-9,0,320,129,121,-8
"779f9ddd1fd14d1e9e69f72219a1fdbd","a8dd5213034441ac92724b4e83eb0bb2",22901385,1,9,0,321,121,129,8
"a8dd5213034441ac92724b4e83eb0bb2","8115eab6556b45f5b415c3b8c26a12e5",22901385,1,2,0,322,129,131,2
"8115eab6556b45f5b415c3b8c26a12e5","8115eab6556b45f5b415c3b8c26a12e5",22901385,2,0,1,323,131,131,0
"8115eab6556b45f5b415c3b8c26a12e5","ec34b06efd844b46a4c4818ecdb9b8f4",22901385,1,1,0,325,131,132,1
"ec34b06efd844b46a4c4818ecdb9b8f4","ec34b06efd844b46a4c4818ecdb9b8f4",22901385,5,0,1,326,132,132,0
"ec34b06efd844b46a4c4818ecdb9b8f4","c2e1c2b9eac64109b343a088584b576b",22901385,1,1,0,331,132,133,1
"c2e1c2b9eac64109b343a088584b576b","c2e1c2b9eac64109b343a088584b576b",22901385,2,0,1,332,133,133,0
"c2e1c2b9eac64109b343a088584b576b","579338175e0b4bbb8ef3b712b5d8b54e",22901385,1,-5,0,334,133,128,-5
"579338175e0b4bbb8ef3b712b5d8b54e","8bc5795d6a984a3eace4e2811e52dd4f",22901385,1,8,0,335,128,135,7
"8bc5795d6a984a3eace4e2811e52dd4f","8bc5795d6a984a3eace4e2811e52dd4f",22901385,3,0,1,336,135,135,0
"8bc5795d6a984a3eace4e2811e52dd4f","b416d47c56a742199b5d7c7f19d6503a",22901385,1,-1,0,339,135,134,-1
"b416d47c56a742199b5d7c7f19d6503a","cd4532ad48034873ba8bce2aac0c9808",22901385,1,4,0,340,134,137,3
"cd4532ad48034873ba8bce2aac0c9808","cd4532ad48034873ba8bce2aac0c9808",22901385,1,0,1,341,137,137,0
"cd4532ad48034873ba8bce2aac0c9808","779f9ddd1fd14d1e9e69f72219a1fdbd",22901385,1,-19,0,342,137,121,-16
"779f9ddd1fd14d1e9e69f72219a1fdbd","df1de691dafe4549a18a4398ee9dfaf9",22901385,1,23,0,343,121,139,18
"df1de691dafe4549a18a4398ee9dfaf9","6c5ad271a44743479bfaea29b1db8d02",22901385,1,4,0,344,139,143,4
"6c5ad271a44743479bfaea29b1db8d02","83d311bed5374fee83d8d67a7d9d82dc",22901385,1,1,0,345,143,144,1
"83d311bed5374fee83d8d67a7d9d82dc","83d311bed5374fee83d8d67a7d9d82dc",22901385,1,0,1,346,144,144,0
"83d311bed5374fee83d8d67a7d9d82dc","402bba41861d43acb52a5abb89e8831e",22901385,1,1,0,347,144,145,1
"402bba41861d43acb52a5abb89e8831e","402bba41861d43acb52a5abb89e8831e",22901385,2,0,1,348,145,145,0
"402bba41861d43acb52a5abb89e8831e","df1de691dafe4549a18a4398ee9dfaf9",22901385,1,-6,0,350,145,139,-6
"df1de691dafe4549a18a4398ee9dfaf9","8aae34f5ddbb4052a709b12e6b0d40fa",22901385,2,9,0,351,139,147,8
"8aae34f5ddbb4052a709b12e6b0d40fa","8aae34f5ddbb4052a709b12e6b0d40fa",22901385,1,0,1,352,147,147,0
"8aae34f5ddbb4052a709b12e6b0d40fa","645b3f0249f64f76af2e19eb4d0e55b7",22901385,1,2,0,353,147,149,2
"645b3f0249f64f76af2e19eb4d0e55b7","645b3f0249f64f76af2e19eb4d0e55b7",22901385,5,0,1,354,149,149,0
"645b3f0249f64f76af2e19eb4d0e55b7","7e7b8db5064d4369805ab370aac5ddfb",22901385,1,1,0,359,149,150,1
"7e7b8db5064d4369805ab370aac5ddfb","7e7b8db5064d4369805ab370aac5ddfb",22901385,2,0,1,360,150,150,0
"7e7b8db5064d4369805ab370aac5ddfb","8956d210ae7f41968fada86d4c979d6a",22901385,1,1,0,362,150,151,1
"8956d210ae7f41968fada86d4c979d6a","8956d210ae7f41968fada86d4c979d6a",22901385,2,0,1,363,151,151,0
"8956d210ae7f41968fada86d4c979d6a","f902b0f41b544d4dbf79664fd233648d",22901385,1,-5,0,365,151,146,-5
"f902b0f41b544d4dbf79664fd233648d","ae781e8b775e4ccd93bc800dad5c8376",22901385,1,8,0,366,146,153,7
"ae781e8b775e4ccd93bc800dad5c8376","ae781e8b775e4ccd93bc800dad5c8376",22901385,2,0,1,367,153,153,0
"ae781e8b775e4ccd93bc800dad5c8376","06882a8492d9499aa31555567f575ecb",22901385,1,1,0,369,153,154,1
"06882a8492d9499aa31555567f575ecb","06882a8492d9499aa31555567f575ecb",22901385,1,0,1,370,154,154,0
"06882a8492d9499aa31555567f575ecb","f293c508f409466a8f27ddd7d1e40b20",22901385,1,1,0,371,154,155,1
"f293c508f409466a8f27ddd7d1e40b20","f293c508f409466a8f27ddd7d1e40b20",22901385,8,0,1,372,155,155,0
"f293c508f409466a8f27ddd7d1e40b20","cc4ddef5bbbe48ebb605141b347c4ed1",22901385,1,1,0,380,155,156,1
"cc4ddef5bbbe48ebb605141b347c4ed1","cc4ddef5bbbe48ebb605141b347c4ed1",22901385,1,0,1,381,156,156,0
"cc4ddef5bbbe48ebb605141b347c4ed1","f03480cf4eba413194d7af52fc0e7f28",22901385,1,-4,0,382,156,152,-4
"f03480cf4eba413194d7af52fc0e7f28","d313cec988a84645bee413e8d4724a4b",22901385,1,7,0,383,152,158,6
"d313cec988a84645bee413e8d4724a4b","d313cec988a84645bee413e8d4724a4b",22901385,6,0,1,384,158,158,0
"d313cec988a84645bee413e8d4724a4b","dc60696c76a74368a60f72246e47700d",22901385,1,1,0,388,158,159,1
"dc60696c76a74368a60f72246e47700d","dc60696c76a74368a60f72246e47700d",22901385,3,0,1,389,159,159,0
"dc60696c76a74368a60f72246e47700d","78adeee1fa2c4fe0bc73f7bca9fcee86",22901385,1,3,0,392,159,160,1
"78adeee1fa2c4fe0bc73f7bca9fcee86","df1de691dafe4549a18a4398ee9dfaf9",22901385,1,-26,0,393,160,139,-21
"df1de691dafe4549a18a4398ee9dfaf9","65202579580f4ad38d734b4ee39d22a8",22901385,1,31,0,394,139,164,25
"b2275c3fad834f8d90737a2d9a6927d6","0c7262dff33c4087bc660ccf40f92f9c",22901385,1,-3,0,413,172,169,-3
"0c7262dff33c4087bc660ccf40f92f9c","0c7262dff33c4087bc660ccf40f92f9c",22901385,3,0,1,414,169,169,0
"b2275c3fad834f8d90737a2d9a6927d6","b2275c3fad834f8d90737a2d9a6927d6",22901385,20,0,1,416,172,172,0
"b2275c3fad834f8d90737a2d9a6927d6","eb515a26030b41f8a82a1e6114420bad",22901385,1,1,0,436,172,173,1
"eb515a26030b41f8a82a1e6114420bad","eb515a26030b41f8a82a1e6114420bad",22901385,2,0,1,437,173,173,0
"eb515a26030b41f8a82a1e6114420bad","0c7262dff33c4087bc660ccf40f92f9c",22901385,1,-4,0,439,173,169,-4
"0c7262dff33c4087bc660ccf40f92f9c","b42cc17b7de840f181a704558d0bc845",22901385,2,7,0,440,169,175,6
"b42cc17b7de840f181a704558d0bc845","801f9e9135034f49bf5f8b4bdefedb41",22901385,1,2,0,441,175,177,2
"801f9e9135034f49bf5f8b4bdefedb41","801f9e9135034f49bf5f8b4bdefedb41",22901385,4,0,1,442,177,177,0
"801f9e9135034f49bf5f8b4bdefedb41","362fcb0699a14845ab29b2340093e528",22901385,1,-3,0,446,177,174,-3
"362fcb0699a14845ab29b2340093e528","ea38cc0e6e6e41edbabf210220808bf9",22901385,2,6,0,447,174,179,5
"ea38cc0e6e6e41edbabf210220808bf9","b87c552dd247427abe6ab5795b9c9d43",22901385,2,2,0,448,179,181,2
"b87c552dd247427abe6ab5795b9c9d43","b87c552dd247427abe6ab5795b9c9d43",22901385,9,0,1,449,181,181,0
"b87c552dd247427abe6ab5795b9c9d43","ea38cc0e6e6e41edbabf210220808bf9",22901385,1,-2,0,458,181,179,-2
"ea38cc0e6e6e41edbabf210220808bf9","139b097acfca451689d80c9c6eebdf7b",22901385,1,-1,0,459,179,178,-1
"139b097acfca451689d80c9c6eebdf7b","30f660a1feb34582a739722532524f79",22901385,2,6,0,460,178,183,5
"30f660a1feb34582a739722532524f79","30f660a1feb34582a739722532524f79",22901385,4,0,1,461,183,183,0
"30f660a1feb34582a739722532524f79","2024b4885bd14338a39b7b509acbbd02",22901385,2,-1,0,462,183,182,-1
"2024b4885bd14338a39b7b509acbbd02","c3f63fe50d8e487c86bf8ef76c9cadd3",22901385,1,4,0,463,182,185,3
"c3f63fe50d8e487c86bf8ef76c9cadd3","c3f63fe50d8e487c86bf8ef76c9cadd3",22901385,1,0,1,464,185,185,0
"c3f63fe50d8e487c86bf8ef76c9cadd3","c8e371568a0c4391b25796ae4e91952e",22901385,1,3,0,465,185,186,1
"c8e371568a0c4391b25796ae4e91952e","0c7262dff33c4087bc660ccf40f92f9c",22901385,1,-23,0,466,186,169,-17
"0c7262dff33c4087bc660ccf40f92f9c","7d932b23e1c84326ae5aa4d3c0d813d1",22901385,1,25,0,467,169,188,19
"7d932b23e1c84326ae5aa4d3c0d813d1","7d932b23e1c84326ae5aa4d3c0d813d1",22901385,1,0,1,468,188,188,0
"7d932b23e1c84326ae5aa4d3c0d813d1","c8e371568a0c4391b25796ae4e91952e",22901385,1,-2,0,469,188,186,-2
"c8e371568a0c4391b25796ae4e91952e","ab11d94c6c8948ea90b88f19d2cd502b",22901385,3,5,0,470,186,190,4
"ab11d94c6c8948ea90b88f19d2cd502b","ab11d94c6c8948ea90b88f19d2cd502b",22901385,1,0,1,471,190,190,0
"ab11d94c6c8948ea90b88f19d2cd502b","f992451ed6ad4e68bb9e68ad6be7c4be",22901385,1,2,0,472,190,192,2
"f992451ed6ad4e68bb9e68ad6be7c4be","f992451ed6ad4e68bb9e68ad6be7c4be",22901385,1,0,1,473,192,192,0
"f992451ed6ad4e68bb9e68ad6be7c4be","07b44a7a51e94c78b411c753fc39dab0",22901385,1,-3,0,474,192,189,-3
"07b44a7a51e94c78b411c753fc39dab0","6cd2dcaac46847d4a0bc53f296d90375",22901385,2,6,0,475,189,194,5
"6cd2dcaac46847d4a0bc53f296d90375","6cd2dcaac46847d4a0bc53f296d90375",22901385,1,0,1,476,194,194,0
"6cd2dcaac46847d4a0bc53f296d90375","2d2580c9411c4972909db508d6956a58",22901385,1,2,0,477,194,196,2
"2d2580c9411c4972909db508d6956a58","2d2580c9411c4972909db508d6956a58",22901385,2,0,1,478,196,196,0
"2d2580c9411c4972909db508d6956a58","5bddb3d9ed264f3984702f048c7e5340",22901385,1,1,0,480,196,197,1
"5bddb3d9ed264f3984702f048c7e5340","5bddb3d9ed264f3984702f048c7e5340",22901385,2,0,1,481,197,197,0
"5bddb3d9ed264f3984702f048c7e5340","d5e8e2bd12a2466b9d6d90855f0eb079",22901385,1,1,0,483,197,198,1
"d5e8e2bd12a2466b9d6d90855f0eb079","d5e8e2bd12a2466b9d6d90855f0eb079",22901385,2,0,1,484,198,198,0
"d5e8e2bd12a2466b9d6d90855f0eb079","017d7ca8e0394b91aaadc9574df2202c",22901385,1,-5,0,486,198,193,-5
"017d7ca8e0394b91aaadc9574df2202c","54e8e9f0ea3e45c4bf3b8ac799ee31b1",22901385,2,8,0,487,193,200,7
"54e8e9f0ea3e45c4bf3b8ac799ee31b1","54e8e9f0ea3e45c4bf3b8ac799ee31b1",22901385,3,0,1,488,200,200,0
"54e8e9f0ea3e45c4bf3b8ac799ee31b1","c614a00911be4877a075f19315530fb0",22901385,1,1,0,491,200,201,1
"c614a00911be4877a075f19315530fb0","c614a00911be4877a075f19315530fb0",22901385,6,0,1,492,201,201,0
"c614a00911be4877a075f19315530fb0","a6c21bd8b95249c7972820a7a7d76aff",22901385,1,1,0,498,201,202,1
"a6c21bd8b95249c7972820a7a7d76aff","a6c21bd8b95249c7972820a7a7d76aff",22901385,1,0,1,499,202,202,0
"a6c21bd8b95249c7972820a7a7d76aff","f9170dd6bc6442b4acd832747609b09a",22901385,1,-3,0,500,202,199,-3
"f9170dd6bc6442b4acd832747609b09a","b54257a550b94ebc9538f3a90eee9d7e",22901385,2,6,0,501,199,204,5
"b54257a550b94ebc9538f3a90eee9d7e","f9170dd6bc6442b4acd832747609b09a",22901385,2,-6,0,502,204,199,-5
"f9170dd6bc6442b4acd832747609b09a","0c7262dff33c4087bc660ccf40f92f9c",22901385,1,-39,0,503,199,169,-30
"0c7262dff33c4087bc660ccf40f92f9c","c8e371568a0c4391b25796ae4e91952e",22901385,3,23,0,505,169,186,17
"c8e371568a0c4391b25796ae4e91952e","c8e371568a0c4391b25796ae4e91952e",22901385,1,0,1,506,186,186,0
"ab11d94c6c8948ea90b88f19d2cd502b","07b44a7a51e94c78b411c753fc39dab0",22901385,1,-1,0,508,190,189,-1
"07b44a7a51e94c78b411c753fc39dab0","7d932b23e1c84326ae5aa4d3c0d813d1",22901385,1,-2,0,509,189,188,-1
"7d932b23e1c84326ae5aa4d3c0d813d1","ab11d94c6c8948ea90b88f19d2cd502b",22901385,1,3,0,510,188,190,2
"ab11d94c6c8948ea90b88f19d2cd502b","c8e371568a0c4391b25796ae4e91952e",22901385,2,-5,0,511,190,186,-4
"c8e371568a0c4391b25796ae4e91952e","f992451ed6ad4e68bb9e68ad6be7c4be",22901385,1,7,0,512,186,192,6
"f992451ed6ad4e68bb9e68ad6be7c4be","6cd2dcaac46847d4a0bc53f296d90375",22901385,1,3,0,513,192,194,2
"6cd2dcaac46847d4a0bc53f296d90375","07b44a7a51e94c78b411c753fc39dab0",22901385,1,-6,0,514,194,189,-5
"07b44a7a51e94c78b411c753fc39dab0","017d7ca8e0394b91aaadc9574df2202c",22901385,1,5,0,515,189,193,4
"54e8e9f0ea3e45c4bf3b8ac799ee31b1","bb329d880ab54120adaf203a693bb203",22901385,1,3,0,517,200,203,3
"bb329d880ab54120adaf203a693bb203","bb329d880ab54120adaf203a693bb203",22901385,1,0,1,518,203,203,0
"bb329d880ab54120adaf203a693bb203","f9170dd6bc6442b4acd832747609b09a",22901385,1,-4,0,519,203,199,-4
"f9170dd6bc6442b4acd832747609b09a","d7f13c8d63ec4e2aa673fbb9cf9c6933",22901385,2,10,0,522,199,206,7
"d7f13c8d63ec4e2aa673fbb9cf9c6933","c8e371568a0c4391b25796ae4e91952e",22901385,2,-26,0,523,206,186,-20
"c8e371568a0c4391b25796ae4e91952e","b9e80f77c3a44349863b19875725c384",22901385,2,27,0,524,186,207,21
"b9e80f77c3a44349863b19875725c384","7108f0e4c2584f1f9c471689ae4c885c",22901385,4,1,0,525,207,208,1
"7108f0e4c2584f1f9c471689ae4c885c","c8e371568a0c4391b25796ae4e91952e",22901385,1,-28,0,526,208,186,-22
"c8e371568a0c4391b25796ae4e91952e","d7f13c8d63ec4e2aa673fbb9cf9c6933",22901385,2,26,0,527,186,206,20
"d7f13c8d63ec4e2aa673fbb9cf9c6933","334c2344009840079b1d0e1b7ce3d5a7",22901385,1,-3,0,528,206,205,-1
"334c2344009840079b1d0e1b7ce3d5a7","334c2344009840079b1d0e1b7ce3d5a7",22901385,1,0,1,529,205,205,0
"334c2344009840079b1d0e1b7ce3d5a7","c8e371568a0c4391b25796ae4e91952e",22901385,1,-23,0,530,205,186,-19
"d7f13c8d63ec4e2aa673fbb9cf9c6933","7108f0e4c2584f1f9c471689ae4c885c",22901385,2,2,0,532,206,208,2
"7108f0e4c2584f1f9c471689ae4c885c","b9e80f77c3a44349863b19875725c384",22901385,2,-1,0,533,208,207,-1
"b9e80f77c3a44349863b19875725c384","d7f13c8d63ec4e2aa673fbb9cf9c6933",22901385,1,-1,0,534,207,206,-1
"d7f13c8d63ec4e2aa673fbb9cf9c6933","d7f13c8d63ec4e2aa673fbb9cf9c6933",22901385,1,0,1,535,206,206,0
"b9e80f77c3a44349863b19875725c384","b9e80f77c3a44349863b19875725c384",22901385,14,0,1,538,207,207,0
"7108f0e4c2584f1f9c471689ae4c885c","7108f0e4c2584f1f9c471689ae4c885c",22901385,15,0,1,553,208,208,0
"7108f0e4c2584f1f9c471689ae4c885c","a875096404ef4a9984b62d74cda916f9",22901385,1,2,0,567,208,209,1
"a875096404ef4a9984b62d74cda916f9","d7f13c8d63ec4e2aa673fbb9cf9c6933",22901385,1,-4,0,568,209,206,-3
"d7f13c8d63ec4e2aa673fbb9cf9c6933","09400e101c5d4b439cf9a26b03aae558",22901385,2,5,0,569,206,210,4
"09400e101c5d4b439cf9a26b03aae558","a88efa7e50ce47159810ab553afa6d3a",22901385,1,2,0,570,210,212,2
"a88efa7e50ce47159810ab553afa6d3a","a88efa7e50ce47159810ab553afa6d3a",22901385,21,0,1,571,212,212,0
"a88efa7e50ce47159810ab553afa6d3a","a875096404ef4a9984b62d74cda916f9",22901385,1,-3,0,592,212,209,-3
"a875096404ef4a9984b62d74cda916f9","be502a7a43c44bf7b682698de79d9369",22901385,1,6,0,593,209,214,5
"be502a7a43c44bf7b682698de79d9369","f7fb1952f56b4189b86a9f8b7862d2b8",22901385,1,1,0,594,214,215,1
"f7fb1952f56b4189b86a9f8b7862d2b8","f7fb1952f56b4189b86a9f8b7862d2b8",22901385,15,0,1,595,215,215,0
"f7fb1952f56b4189b86a9f8b7862d2b8","b860ee85d8bc4a2f97958cfb71be3533",22901385,1,1,0,610,215,216,1
"b860ee85d8bc4a2f97958cfb71be3533","b860ee85d8bc4a2f97958cfb71be3533",22901385,2,0,1,611,216,216,0
"b860ee85d8bc4a2f97958cfb71be3533","ec341f459285443b8361f7f15638ff08",22901385,1,-3,0,613,216,213,-3
"ec341f459285443b8361f7f15638ff08","363837c182e04711840d896ae1e0339c",22901385,1,6,0,614,213,218,5
"363837c182e04711840d896ae1e0339c","363837c182e04711840d896ae1e0339c",22901385,12,0,1,615,218,218,0
"363837c182e04711840d896ae1e0339c","01b2051f8941460d89945e3b02d1ce78",22901385,1,-1,0,627,218,217,-1
"01b2051f8941460d89945e3b02d1ce78","91125ca626c5470eb145501f8c37f8db",22901385,1,4,0,628,217,220,3
"91125ca626c5470eb145501f8c37f8db","91125ca626c5470eb145501f8c37f8db",22901385,1,0,1,629,220,220,0
"91125ca626c5470eb145501f8c37f8db","1c6721b1f63f4d30ba7746ea8af02a52",22901385,1,3,0,630,220,221,1
"1c6721b1f63f4d30ba7746ea8af02a52","d7f13c8d63ec4e2aa673fbb9cf9c6933",22901385,1,-21,0,631,221,206,-15
"d7f13c8d63ec4e2aa673fbb9cf9c6933","77ecef8eff6b4a2caea7707669bf7475",22901385,1,22,0,632,206,222,16
"77ecef8eff6b4a2caea7707669bf7475","77ecef8eff6b4a2caea7707669bf7475",22901385,13,0,1,633,222,222,0
"77ecef8eff6b4a2caea7707669bf7475","1c6721b1f63f4d30ba7746ea8af02a52",22901385,1,-1,0,646,222,221,-1
"1c6721b1f63f4d30ba7746ea8af02a52","d03cb855c70044cf8c35d9ec0de696e3",22901385,3,4,0,647,221,224,3
"d03cb855c70044cf8c35d9ec0de696e3","8b9ae98743bd4d4a8a87dff1c1244211",22901385,3,3,0,648,224,227,3
"8b9ae98743bd4d4a8a87dff1c1244211","a49a937d6896486d9a5396654abcf2e1",22901385,1,-1,0,649,227,226,-1
"a49a937d6896486d9a5396654abcf2e1","a49a937d6896486d9a5396654abcf2e1",22901385,6,0,1,650,226,226,0
"a49a937d6896486d9a5396654abcf2e1","8b9ae98743bd4d4a8a87dff1c1244211",22901385,1,1,0,656,226,227,1
"8b9ae98743bd4d4a8a87dff1c1244211","8b9ae98743bd4d4a8a87dff1c1244211",22901385,33,0,1,657,227,227,0
"8b9ae98743bd4d4a8a87dff1c1244211","2ab1535aac1346ba8801535bf729ef37",22901385,3,3,0,690,227,229,2
"2ab1535aac1346ba8801535bf729ef37","f7906d6f59b9489a91d2ef40db5a474d",22901385,3,-7,0,691,229,223,-6
"f7906d6f59b9489a91d2ef40db5a474d","a4f40fb48a8542c8949bae1f002cd9bc",22901385,1,9,0,692,223,231,8
"a4f40fb48a8542c8949bae1f002cd9bc","a4f40fb48a8542c8949bae1f002cd9bc",22901385,2,0,1,693,231,231,0
"a4f40fb48a8542c8949bae1f002cd9bc","8972c23e32044edb8a78fa1eed4e5947",22901385,1,1,0,695,231,232,1
"8972c23e32044edb8a78fa1eed4e5947","8972c23e32044edb8a78fa1eed4e5947",22901385,1,0,1,696,232,232,0
"8972c23e32044edb8a78fa1eed4e5947","92feb4a40f8344d38b6f722e42a53295",22901385,1,1,0,697,232,233,1
"92feb4a40f8344d38b6f722e42a53295","92feb4a40f8344d38b6f722e42a53295",22901385,2,0,1,698,233,233,0
"92feb4a40f8344d38b6f722e42a53295","5152833676bf4c6cb317060be10f68db",22901385,1,-5,0,700,233,228,-5
"5152833676bf4c6cb317060be10f68db","2ab1535aac1346ba8801535bf729ef37",22901385,1,1,0,701,228,229,1
"2ab1535aac1346ba8801535bf729ef37","0b04c8e2f86d48c7aeb7e225819cd32b",22901385,2,6,0,702,229,234,5
"0b04c8e2f86d48c7aeb7e225819cd32b","5152833676bf4c6cb317060be10f68db",22901385,2,-7,0,703,234,228,-6
"5152833676bf4c6cb317060be10f68db","ca3e28f290354c08aefe5b0f769604e6",22901385,1,8,0,704,228,235,7
"ca3e28f290354c08aefe5b0f769604e6","ca3e28f290354c08aefe5b0f769604e6",22901385,14,0,1,705,235,235,0
"ca3e28f290354c08aefe5b0f769604e6","79a35eea833e4c2c9d22fc53c3c6445c",22901385,1,1,0,719,235,236,1
"79a35eea833e4c2c9d22fc53c3c6445c","79a35eea833e4c2c9d22fc53c3c6445c",22901385,9,0,1,720,236,236,0
"79a35eea833e4c2c9d22fc53c3c6445c","8f68228b1518449e9615cdafee41a2bd",22901385,1,1,0,729,236,237,1
"8f68228b1518449e9615cdafee41a2bd","8f68228b1518449e9615cdafee41a2bd",22901385,1,0,1,730,237,237,0
"8f68228b1518449e9615cdafee41a2bd","cab89fa5c3ed45a5aa550fc0352d6a42",22901385,1,1,0,731,237,238,1
"cab89fa5c3ed45a5aa550fc0352d6a42","cab89fa5c3ed45a5aa550fc0352d6a42",22901385,5,0,1,732,238,238,0
"cab89fa5c3ed45a5aa550fc0352d6a42","2ab1535aac1346ba8801535bf729ef37",22901385,1,-10,0,737,238,229,-9
"5152833676bf4c6cb317060be10f68db","0b04c8e2f86d48c7aeb7e225819cd32b",22901385,2,7,0,740,228,234,6
"0b04c8e2f86d48c7aeb7e225819cd32b","f53da5fd9bfe412da4b80d4742563b6c",22901385,2,8,0,741,234,241,7
"f53da5fd9bfe412da4b80d4742563b6c","f53da5fd9bfe412da4b80d4742563b6c",22901385,5,0,1,742,241,241,0
"f53da5fd9bfe412da4b80d4742563b6c","f7906d6f59b9489a91d2ef40db5a474d",22901385,1,-21,0,745,241,223,-18
"f7906d6f59b9489a91d2ef40db5a474d","1c6721b1f63f4d30ba7746ea8af02a52",22901385,2,-3,0,746,223,221,-2
"f7906d6f59b9489a91d2ef40db5a474d","5152833676bf4c6cb317060be10f68db",22901385,2,6,0,751,223,228,5
"5152833676bf4c6cb317060be10f68db","0c7262dff33c4087bc660ccf40f92f9c",22901385,1,-79,0,752,228,169,-59
"0c7262dff33c4087bc660ccf40f92f9c","64dbedb3ce544f6aae8e10e0cf10f16d",22901385,1,93,0,753,169,240,71
"64dbedb3ce544f6aae8e10e0cf10f16d","1c6721b1f63f4d30ba7746ea8af02a52",22901385,1,-23,0,754,240,221,-19
"1c6721b1f63f4d30ba7746ea8af02a52","f53da5fd9bfe412da4b80d4742563b6c",22901385,1,24,0,755,221,241,20
"f53da5fd9bfe412da4b80d4742563b6c","64dbedb3ce544f6aae8e10e0cf10f16d",22901385,1,-1,0,757,241,240,-1
"64dbedb3ce544f6aae8e10e0cf10f16d","8b9ae98743bd4d4a8a87dff1c1244211",22901385,1,-16,0,758,240,227,-13
"8b9ae98743bd4d4a8a87dff1c1244211","d03cb855c70044cf8c35d9ec0de696e3",22901385,1,-3,0,759,227,224,-3
"d03cb855c70044cf8c35d9ec0de696e3","f7906d6f59b9489a91d2ef40db5a474d",22901385,1,-1,0,760,224,223,-1
"f7906d6f59b9489a91d2ef40db5a474d","2ab1535aac1346ba8801535bf729ef37",22901385,1,7,0,761,223,229,6
"2ab1535aac1346ba8801535bf729ef37","5152833676bf4c6cb317060be10f68db",22901385,1,-1,0,762,229,228,-1
"5152833676bf4c6cb317060be10f68db","66d4fad4f1cf4b46be0750a99ad7a35a",22901385,1,12,0,763,228,239,11
"66d4fad4f1cf4b46be0750a99ad7a35a","66d4fad4f1cf4b46be0750a99ad7a35a",22901385,1,0,1,764,239,239,0
"66d4fad4f1cf4b46be0750a99ad7a35a","0b04c8e2f86d48c7aeb7e225819cd32b",22901385,1,-5,0,765,239,234,-5
"f53da5fd9bfe412da4b80d4742563b6c","1c6721b1f63f4d30ba7746ea8af02a52",22901385,1,-24,0,768,241,221,-20
"1c6721b1f63f4d30ba7746ea8af02a52","2ae94c0cea4d480a9d5dca8fb1d7b542",22901385,1,27,0,769,221,242,21
"2ae94c0cea4d480a9d5dca8fb1d7b542","1ebf23f9d994469a85206e4c7b1bf5f5",22901385,1,3,0,770,242,245,3
"1ebf23f9d994469a85206e4c7b1bf5f5","1ebf23f9d994469a85206e4c7b1bf5f5",22901385,11,0,1,771,245,245,0
"1ebf23f9d994469a85206e4c7b1bf5f5","85ae675b83e8422da842cfd25596af99",22901385,1,1,0,782,245,246,1
"85ae675b83e8422da842cfd25596af99","85ae675b83e8422da842cfd25596af99",22901385,1,0,1,783,246,246,0
"85ae675b83e8422da842cfd25596af99","2ae94c0cea4d480a9d5dca8fb1d7b542",22901385,1,-4,0,784,246,242,-4
"2ae94c0cea4d480a9d5dca8fb1d7b542","30c9ba177afc49a695625d2bdec40207",22901385,1,9,0,785,242,250,8
"30c9ba177afc49a695625d2bdec40207","30c9ba177afc49a695625d2bdec40207",22901385,2,0,1,786,250,250,0
"30c9ba177afc49a695625d2bdec40207","6e83e23f56544a19b94067c1c558d9c0",22901385,1,-3,0,788,250,247,-3
"6e83e23f56544a19b94067c1c558d9c0","00f61990949545828dd12f1303d47504",22901385,1,11,0,789,247,256,9
"00f61990949545828dd12f1303d47504","ead7bb4b64e247d2ae632ab8a296b091",22901385,1,2,0,790,256,258,2
"ead7bb4b64e247d2ae632ab8a296b091","ead7bb4b64e247d2ae632ab8a296b091",22901385,5,0,1,791,258,258,0
"ead7bb4b64e247d2ae632ab8a296b091","41b0048dde734bb280bac6116baa8e27",22901385,1,1,0,796,258,259,1
"41b0048dde734bb280bac6116baa8e27","41b0048dde734bb280bac6116baa8e27",22901385,9,0,1,797,259,259,0
"41b0048dde734bb280bac6116baa8e27","b41c5a094a604ee0915327da5cc0beb7",22901385,1,1,0,806,259,260,1
"b41c5a094a604ee0915327da5cc0beb7","b41c5a094a604ee0915327da5cc0beb7",22901385,2,0,1,807,260,260,0
"b41c5a094a604ee0915327da5cc0beb7","d546341988904f069cfa86b21457d9d9",22901385,1,-10,0,809,260,251,-9
"d546341988904f069cfa86b21457d9d9","28c171777c52431ab6b925073bd63d46",22901385,1,15,0,810,251,264,13
"28c171777c52431ab6b925073bd63d46","28c171777c52431ab6b925073bd63d46",22901385,3,0,1,811,264,264,0
"28c171777c52431ab6b925073bd63d46","ac160db940cb49ae8579162b1d52bb5d",22901385,1,2,0,814,264,266,2
"ac160db940cb49ae8579162b1d52bb5d","ac160db940cb49ae8579162b1d52bb5d",22901385,8,0,1,815,266,266,0
"ac160db940cb49ae8579162b1d52bb5d","d989ebcfc12a4b669f0100dc1aa14f1e",22901385,1,-12,0,823,266,255,-11
"d989ebcfc12a4b669f0100dc1aa14f1e","c6fd49b485cc4874b0bbdd9c6171e09c",22901385,1,15,0,824,255,268,13
"c6fd49b485cc4874b0bbdd9c6171e09c","c6fd49b485cc4874b0bbdd9c6171e09c",22901385,12,0,1,825,268,268,0
"c6fd49b485cc4874b0bbdd9c6171e09c","44240778a97c4af0937817499b75707b",22901385,1,1,0,837,268,269,1
"44240778a97c4af0937817499b75707b","44240778a97c4af0937817499b75707b",22901385,2,0,1,838,269,269,0
"44240778a97c4af0937817499b75707b","7aa76d3e993840d8805f097cbdbcd44b",22901385,1,-9,0,840,269,261,-8
"7aa76d3e993840d8805f097cbdbcd44b","865a4d3b43374da7944dc7d397f566d9",22901385,1,12,0,841,261,271,10
"865a4d3b43374da7944dc7d397f566d9","865a4d3b43374da7944dc7d397f566d9",22901385,1,0,1,842,271,271,0
"865a4d3b43374da7944dc7d397f566d9","2ae94c0cea4d480a9d5dca8fb1d7b542",22901385,1,-35,0,843,271,242,-29
"2ae94c0cea4d480a9d5dca8fb1d7b542","0d987bed3ffa4ed0b9a2e62e97b7b30f",22901385,2,38,0,844,242,272,30
"0d987bed3ffa4ed0b9a2e62e97b7b30f","0d987bed3ffa4ed0b9a2e62e97b7b30f",22901385,1,0,1,845,272,272,0
"0d987bed3ffa4ed0b9a2e62e97b7b30f","82ae07bc0c9b4570a41799290d1ef399",22901385,1,4,0,846,272,275,3
"82ae07bc0c9b4570a41799290d1ef399","bb5a47f5ea01454a8b79455422d3b9da",22901385,2,6,0,847,275,280,5
"bb5a47f5ea01454a8b79455422d3b9da","bb5a47f5ea01454a8b79455422d3b9da",22901385,71,0,1,848,280,280,0
"bb5a47f5ea01454a8b79455422d3b9da","94cecc3f1e7d484b8e068e79241dfd73",22901385,1,3,0,855,280,281,1
"94cecc3f1e7d484b8e068e79241dfd73","94cecc3f1e7d484b8e068e79241dfd73",22901385,1,0,1,856,281,281,0
"94cecc3f1e7d484b8e068e79241dfd73","a37477c4e4c14169ad44b06b493007f6",22901385,2,2,0,857,281,283,2
"a37477c4e4c14169ad44b06b493007f6","fab84b4fab5940efb4ea868ef8d09396",22901385,1,3,0,858,283,284,1
"fab84b4fab5940efb4ea868ef8d09396","94cecc3f1e7d484b8e068e79241dfd73",22901385,1,-5,0,859,284,281,-3
"94cecc3f1e7d484b8e068e79241dfd73","4a29443515bb404cb8924e1c60a63b73",22901385,1,9,0,860,281,285,4
"4a29443515bb404cb8924e1c60a63b73","fab84b4fab5940efb4ea868ef8d09396",22901385,2,-4,0,861,285,284,-1
"fab84b4fab5940efb4ea868ef8d09396","208c9b2796c944db8dacaa96082520ea",22901385,2,7,0,862,284,288,4
"208c9b2796c944db8dacaa96082520ea","0c7262dff33c4087bc660ccf40f92f9c",22901385,1,-160,0,863,288,169,-119
"c8e371568a0c4391b25796ae4e91952e","07b44a7a51e94c78b411c753fc39dab0",22901385,1,4,0,868,186,189,3
"6cd2dcaac46847d4a0bc53f296d90375","017d7ca8e0394b91aaadc9574df2202c",22901385,1,-1,0,870,194,193,-1
"017d7ca8e0394b91aaadc9574df2202c","f9170dd6bc6442b4acd832747609b09a",22901385,1,7,0,871,193,199,6
"7108f0e4c2584f1f9c471689ae4c885c","d7f13c8d63ec4e2aa673fbb9cf9c6933",22901385,1,-2,0,876,208,206,-2
"09400e101c5d4b439cf9a26b03aae558","a875096404ef4a9984b62d74cda916f9",22901385,1,-1,0,878,210,209,-1
"a875096404ef4a9984b62d74cda916f9","b9e80f77c3a44349863b19875725c384",22901385,1,-3,0,879,209,207,-2
"7108f0e4c2584f1f9c471689ae4c885c","362fcb0699a14845ab29b2340093e528",22901385,1,-45,0,882,208,174,-34
"362fcb0699a14845ab29b2340093e528","0c7262dff33c4087bc660ccf40f92f9c",22901385,1,-6,0,883,174,169,-5
"b42cc17b7de840f181a704558d0bc845","362fcb0699a14845ab29b2340093e528",22901385,1,-1,0,885,175,174,-1
"b87c552dd247427abe6ab5795b9c9d43","139b097acfca451689d80c9c6eebdf7b",22901385,1,-3,0,888,181,178,-3
"2024b4885bd14338a39b7b509acbbd02","0c7262dff33c4087bc660ccf40f92f9c",22901385,1,-16,0,894,182,169,-13
"c8e371568a0c4391b25796ae4e91952e","f7906d6f59b9489a91d2ef40db5a474d",22901385,1,50,0,896,186,223,37
"0b04c8e2f86d48c7aeb7e225819cd32b","2ae94c0cea4d480a9d5dca8fb1d7b542",22901385,1,11,0,904,234,242,8
"2ae94c0cea4d480a9d5dca8fb1d7b542","1c6721b1f63f4d30ba7746ea8af02a52",22901385,1,-27,0,905,242,221,-21
"1c6721b1f63f4d30ba7746ea8af02a52","1ebf23f9d994469a85206e4c7b1bf5f5",22901385,1,30,0,906,221,245,24
"1ebf23f9d994469a85206e4c7b1bf5f5","2ae94c0cea4d480a9d5dca8fb1d7b542",22901385,1,-3,0,907,245,242,-3
"2ae94c0cea4d480a9d5dca8fb1d7b542","00f61990949545828dd12f1303d47504",22901385,1,17,0,908,242,256,14
"00f61990949545828dd12f1303d47504","6e83e23f56544a19b94067c1c558d9c0",22901385,1,-11,0,909,256,247,-9
"6e83e23f56544a19b94067c1c558d9c0","d546341988904f069cfa86b21457d9d9",22901385,1,5,0,910,247,251,4
"d546341988904f069cfa86b21457d9d9","d989ebcfc12a4b669f0100dc1aa14f1e",22901385,1,5,0,911,251,255,4
"d989ebcfc12a4b669f0100dc1aa14f1e","7aa76d3e993840d8805f097cbdbcd44b",22901385,1,7,0,912,255,261,6
"7aa76d3e993840d8805f097cbdbcd44b","0d987bed3ffa4ed0b9a2e62e97b7b30f",22901385,1,15,0,913,261,272,11
"0d987bed3ffa4ed0b9a2e62e97b7b30f","2ae94c0cea4d480a9d5dca8fb1d7b542",22901385,1,-38,0,914,272,242,-30
"0d987bed3ffa4ed0b9a2e62e97b7b30f","bb5a47f5ea01454a8b79455422d3b9da",22901385,1,10,0,916,272,280,8
"bb5a47f5ea01454a8b79455422d3b9da","82ae07bc0c9b4570a41799290d1ef399",22901385,1,-6,0,918,280,275,-5
"bb5a47f5ea01454a8b79455422d3b9da","0d987bed3ffa4ed0b9a2e62e97b7b30f",22901385,1,-10,0,983,280,272,-8
"0d987bed3ffa4ed0b9a2e62e97b7b30f","94cecc3f1e7d484b8e068e79241dfd73",22901385,1,13,0,984,272,281,9
"a37477c4e4c14169ad44b06b493007f6","94cecc3f1e7d484b8e068e79241dfd73",22901385,1,-2,0,986,283,281,-2
"94cecc3f1e7d484b8e068e79241dfd73","fab84b4fab5940efb4ea868ef8d09396",22901385,1,5,0,987,281,284,3
"fab84b4fab5940efb4ea868ef8d09396","4a29443515bb404cb8924e1c60a63b73",22901385,1,4,0,988,284,285,1
"208c9b2796c944db8dacaa96082520ea","f902b0f41b544d4dbf79664fd233648d",22901385,1,-195,0,991,288,146,-142
"f902b0f41b544d4dbf79664fd233648d","df1de691dafe4549a18a4398ee9dfaf9",22901385,1,-8,0,992,146,139,-7
"8aae34f5ddbb4052a709b12e6b0d40fa","f902b0f41b544d4dbf79664fd233648d",22901385,1,-1,0,994,147,146,-1
"f902b0f41b544d4dbf79664fd233648d","d313cec988a84645bee413e8d4724a4b",22901385,1,14,0,995,146,158,12
"d313cec988a84645bee413e8d4724a4b","f03480cf4eba413194d7af52fc0e7f28",22901385,1,-7,0,998,158,152,-6
"f03480cf4eba413194d7af52fc0e7f28","df1de691dafe4549a18a4398ee9dfaf9",22901385,1,-15,0,999,152,139,-13
"df1de691dafe4549a18a4398ee9dfaf9","78adeee1fa2c4fe0bc73f7bca9fcee86",22901385,1,26,0,1000,139,160,21
"78adeee1fa2c4fe0bc73f7bca9fcee86","65202579580f4ad38d734b4ee39d22a8",22901385,4,5,0,1001,160,164,4
"65202579580f4ad38d734b4ee39d22a8","65202579580f4ad38d734b4ee39d22a8",22901385,69,0,1,1002,164,164,0
"65202579580f4ad38d734b4ee39d22a8","78adeee1fa2c4fe0bc73f7bca9fcee86",22901385,4,-5,0,1008,164,160,-4
"78adeee1fa2c4fe0bc73f7bca9fcee86","3cbcea2be0984e7dbd5a48195af10ce7",22901385,2,8,0,1028,160,165,5
"3cbcea2be0984e7dbd5a48195af10ce7","82e6285962b8400d9d6fc32436022a94",22901385,3,2,0,1029,165,167,2
"82e6285962b8400d9d6fc32436022a94","3cbcea2be0984e7dbd5a48195af10ce7",22901385,4,-2,0,1030,167,165,-2
"3cbcea2be0984e7dbd5a48195af10ce7","78adeee1fa2c4fe0bc73f7bca9fcee86",22901385,2,-8,0,1031,165,160,-5
"65202579580f4ad38d734b4ee39d22a8","3cbcea2be0984e7dbd5a48195af10ce7",22901385,1,3,0,1073,164,165,1
"78adeee1fa2c4fe0bc73f7bca9fcee86","82e6285962b8400d9d6fc32436022a94",22901385,1,10,0,1075,160,167,7
"3cbcea2be0984e7dbd5a48195af10ce7","a9ac840f098c4bd0a2ee896214ce29cd",22901385,2,5,0,1077,165,168,3
"a9ac840f098c4bd0a2ee896214ce29cd","a9ac840f098c4bd0a2ee896214ce29cd",22901385,2,0,1,1078,168,168,0
"a9ac840f098c4bd0a2ee896214ce29cd","0c7262dff33c4087bc660ccf40f92f9c",22901385,2,4,0,1079,168,169,1
"0c7262dff33c4087bc660ccf40f92f9c","b2275c3fad834f8d90737a2d9a6927d6",22901385,3,3,0,1080,169,172,3
"b2275c3fad834f8d90737a2d9a6927d6","4a29443515bb404cb8924e1c60a63b73",22901385,1,154,0,1081,172,285,113
"4a29443515bb404cb8924e1c60a63b73","4a29443515bb404cb8924e1c60a63b73",22901385,1,0,1,1082,285,285,0
"4a29443515bb404cb8924e1c60a63b73","208c9b2796c944db8dacaa96082520ea",22901385,1,3,0,1083,285,288,3
"208c9b2796c944db8dacaa96082520ea","4a29443515bb404cb8924e1c60a63b73",22901385,1,-3,0,1084,288,285,-3
"4a29443515bb404cb8924e1c60a63b73","7669a956527947d0add87455277e80b4",22901385,1,7,0,1085,285,291,6
"7669a956527947d0add87455277e80b4","7669a956527947d0add87455277e80b4",22901385,1,0,1,1086,291,291,0
"7669a956527947d0add87455277e80b4","869e967078f04da18dd0b0b9389a7424",22901385,1,3,0,1087,291,293,2
"869e967078f04da18dd0b0b9389a7424","6a9a3b5bde4a48daa896fe8c06eca56f",22901385,1,-5,0,1088,293,289,-4
"6a9a3b5bde4a48daa896fe8c06eca56f","51ab6291537748fab90d519aa09889d6",22901385,1,7,0,1089,289,295,6
"51ab6291537748fab90d519aa09889d6","51ab6291537748fab90d519aa09889d6",22901385,5,0,1,1090,295,295,0
"51ab6291537748fab90d519aa09889d6","34a6e49023fc4465bd5ca604330bbd1c",22901385,1,-3,0,1095,295,292,-3
"34a6e49023fc4465bd5ca604330bbd1c","ba0e59461bfb4a44b7b1c28a01f8d3b3",22901385,1,9,0,1096,292,299,7
"ba0e59461bfb4a44b7b1c28a01f8d3b3","21592f2a9e9c4b2f8c66ec5dbcbf6a2b",22901385,1,-4,0,1097,299,296,-3
"21592f2a9e9c4b2f8c66ec5dbcbf6a2b","0e0b36e731a645e7b1b8a88f5031ca38",22901385,1,6,0,1098,296,301,5
"0e0b36e731a645e7b1b8a88f5031ca38","0e0b36e731a645e7b1b8a88f5031ca38",22901385,2,0,1,1099,301,301,0
"0e0b36e731a645e7b1b8a88f5031ca38","a66a144637284c21afc6de17fea4bfb8",22901385,1,1,0,1101,301,302,1
"a66a144637284c21afc6de17fea4bfb8","a66a144637284c21afc6de17fea4bfb8",22901385,2,0,1,1102,302,302,0
"a66a144637284c21afc6de17fea4bfb8","7646a919d7e64fa990bca9b024ff089d",22901385,1,-4,0,1104,302,298,-4
"7646a919d7e64fa990bca9b024ff089d","ba0e59461bfb4a44b7b1c28a01f8d3b3",22901385,1,1,0,1105,298,299,1
"ba0e59461bfb4a44b7b1c28a01f8d3b3","2c5bb2cbd0014420ad8c95d40e38efd1",22901385,1,5,0,1106,299,303,4
"2c5bb2cbd0014420ad8c95d40e38efd1","7646a919d7e64fa990bca9b024ff089d",22901385,1,-6,0,1107,303,298,-5
"7646a919d7e64fa990bca9b024ff089d","2c5bb2cbd0014420ad8c95d40e38efd1",22901385,1,6,0,1108,298,303,5
"2c5bb2cbd0014420ad8c95d40e38efd1","4a29443515bb404cb8924e1c60a63b73",22901385,1,-23,0,1109,303,285,-18
"4a29443515bb404cb8924e1c60a63b73","e390b575229748ea8aac9364efe2bf00",22901385,1,24,0,1110,285,304,19
"e390b575229748ea8aac9364efe2bf00","e390b575229748ea8aac9364efe2bf00",22901385,1,0,1,1111,304,304,0
"e390b575229748ea8aac9364efe2bf00","4a29443515bb404cb8924e1c60a63b73",22901385,1,-24,0,1112,304,285,-19
"4a29443515bb404cb8924e1c60a63b73","3434c10e561d488a914e0f7d71907abd",22901385,1,27,0,1113,285,305,20
"3434c10e561d488a914e0f7d71907abd","53e7e900392747ccad52e711ab0f80d8",22901385,1,2,0,1114,305,307,2
"53e7e900392747ccad52e711ab0f80d8","130acc2aeb0448fdbb2de63bc5cebe5b",22901385,2,3,0,1115,307,309,2
"130acc2aeb0448fdbb2de63bc5cebe5b","3434c10e561d488a914e0f7d71907abd",22901385,2,-5,0,1116,309,305,-4
"3434c10e561d488a914e0f7d71907abd","9c062b3251034ebe90f5054e2a3b5120",22901385,1,7,0,1117,305,311,6
"9c062b3251034ebe90f5054e2a3b5120","9c062b3251034ebe90f5054e2a3b5120",22901385,2,0,1,1118,311,311,0
"9c062b3251034ebe90f5054e2a3b5120","ea859f8207e44537889daeaba13ac2e8",22901385,1,1,0,1120,311,312,1
"ea859f8207e44537889daeaba13ac2e8","ea859f8207e44537889daeaba13ac2e8",22901385,10,0,1,1121,312,312,0
"ea859f8207e44537889daeaba13ac2e8","56d94971a7a94257aa330183a8ebd0ea",22901385,1,1,0,1131,312,313,1
"56d94971a7a94257aa330183a8ebd0ea","56d94971a7a94257aa330183a8ebd0ea",22901385,10,0,1,1132,313,313,0
"56d94971a7a94257aa330183a8ebd0ea","141c0df6cd1946539aadd1c9b7068cd4",22901385,1,-5,0,1142,313,308,-5
"141c0df6cd1946539aadd1c9b7068cd4","13255e63e0aa4abf85e5211bf613d43e",22901385,1,10,0,1143,308,317,9
"13255e63e0aa4abf85e5211bf613d43e","13255e63e0aa4abf85e5211bf613d43e",22901385,1,0,1,1144,317,317,0
"13255e63e0aa4abf85e5211bf613d43e","86c27d40179e419c8e9d150fb6afa5d0",22901385,1,3,0,1145,317,319,2
"86c27d40179e419c8e9d150fb6afa5d0","0c787d16c9504873b1a4d903cec09948",22901385,2,-6,0,1146,319,314,-5
"0c787d16c9504873b1a4d903cec09948","8d7e0b55cf9849cda222a0f2440cec55",22901385,1,5,0,1147,314,318,4
"8d7e0b55cf9849cda222a0f2440cec55","47edbb64109243e6b0f8f64cdef90c6c",22901385,3,9,0,1148,318,326,8
"47edbb64109243e6b0f8f64cdef90c6c","24f1363179ad4aaa965484a78471912b",22901385,1,-3,0,1149,326,323,-3
"24f1363179ad4aaa965484a78471912b","3628bdce1dd2429ba924d2d4d09448d2",22901385,1,-1,0,1150,323,322,-1
"3628bdce1dd2429ba924d2d4d09448d2","43ea1b823a4b4e51b7c694c10725db82",22901385,2,6,0,1151,322,327,5
"43ea1b823a4b4e51b7c694c10725db82","24f1363179ad4aaa965484a78471912b",22901385,1,-5,0,1152,327,323,-4
"24f1363179ad4aaa965484a78471912b","47edbb64109243e6b0f8f64cdef90c6c",22901385,2,3,0,1153,323,326,3
"47edbb64109243e6b0f8f64cdef90c6c","86c27d40179e419c8e9d150fb6afa5d0",22901385,1,-8,0,1154,326,319,-7
"86c27d40179e419c8e9d150fb6afa5d0","3628bdce1dd2429ba924d2d4d09448d2",22901385,1,4,0,1155,319,322,3
"3628bdce1dd2429ba924d2d4d09448d2","8d7e0b55cf9849cda222a0f2440cec55",22901385,1,-5,0,1156,322,318,-4
"8d7e0b55cf9849cda222a0f2440cec55","0c787d16c9504873b1a4d903cec09948",22901385,1,-5,0,1157,318,314,-4
"0c787d16c9504873b1a4d903cec09948","130acc2aeb0448fdbb2de63bc5cebe5b",22901385,1,-6,0,1158,314,309,-5
"130acc2aeb0448fdbb2de63bc5cebe5b","141c0df6cd1946539aadd1c9b7068cd4",22901385,1,-1,0,1159,309,308,-1
"141c0df6cd1946539aadd1c9b7068cd4","0c787d16c9504873b1a4d903cec09948",22901385,1,7,0,1160,308,314,6
"0c787d16c9504873b1a4d903cec09948","86c27d40179e419c8e9d150fb6afa5d0",22901385,2,6,0,1161,314,319,5
"86c27d40179e419c8e9d150fb6afa5d0","24f1363179ad4aaa965484a78471912b",22901385,2,5,0,1162,319,323,4
"47edbb64109243e6b0f8f64cdef90c6c","8d7e0b55cf9849cda222a0f2440cec55",22901385,1,-9,0,1164,326,318,-8
"8d7e0b55cf9849cda222a0f2440cec55","3628bdce1dd2429ba924d2d4d09448d2",22901385,1,5,0,1165,318,322,4
"43ea1b823a4b4e51b7c694c10725db82","3434c10e561d488a914e0f7d71907abd",22901385,1,-27,0,1167,327,305,-22
"3434c10e561d488a914e0f7d71907abd","56b3fd1a212a4764be39d979fde3326e",22901385,1,28,0,1168,305,328,23
"56b3fd1a212a4764be39d979fde3326e","56b3fd1a212a4764be39d979fde3326e",22901385,2,0,1,1169,328,328,0
"56b3fd1a212a4764be39d979fde3326e","4a29443515bb404cb8924e1c60a63b73",22901385,1,-55,0,1170,328,285,-43
"4a29443515bb404cb8924e1c60a63b73","2c5bb2cbd0014420ad8c95d40e38efd1",22901385,1,23,0,1171,285,303,18
"2c5bb2cbd0014420ad8c95d40e38efd1","3434c10e561d488a914e0f7d71907abd",22901385,1,4,0,1172,303,305,2
"3434c10e561d488a914e0f7d71907abd","4a29443515bb404cb8924e1c60a63b73",22901385,1,-27,0,1173,305,285,-20
"4a29443515bb404cb8924e1c60a63b73","53e7e900392747ccad52e711ab0f80d8",22901385,1,29,0,1174,285,307,22
"3434c10e561d488a914e0f7d71907abd","141c0df6cd1946539aadd1c9b7068cd4",22901385,1,4,0,1177,305,308,3
"141c0df6cd1946539aadd1c9b7068cd4","86c27d40179e419c8e9d150fb6afa5d0",22901385,1,13,0,1178,308,319,11
"0c787d16c9504873b1a4d903cec09948","24f1363179ad4aaa965484a78471912b",22901385,1,11,0,1180,314,323,9
"24f1363179ad4aaa965484a78471912b","8d7e0b55cf9849cda222a0f2440cec55",22901385,2,-6,0,1181,323,318,-5
"47edbb64109243e6b0f8f64cdef90c6c","3628bdce1dd2429ba924d2d4d09448d2",22901385,1,-4,0,1183,326,322,-4
"3628bdce1dd2429ba924d2d4d09448d2","56b3fd1a212a4764be39d979fde3326e",22901385,1,7,0,1184,322,328,6
"56b3fd1a212a4764be39d979fde3326e","3434c10e561d488a914e0f7d71907abd",22901385,1,-28,0,1186,328,305,-23
"3434c10e561d488a914e0f7d71907abd","0c4079457ede49e3aeb5e86ed84bdf35",22901385,1,31,0,1187,305,329,24
"0c4079457ede49e3aeb5e86ed84bdf35","38aea304b4fa46e1b29bb72f5cea4c93",22901385,1,2,0,1188,329,331,2
"38aea304b4fa46e1b29bb72f5cea4c93","e36d261332f14e79bb4b467aceaeb9b5",22901385,1,2,0,1189,331,333,2
"e36d261332f14e79bb4b467aceaeb9b5","e36d261332f14e79bb4b467aceaeb9b5",22901385,1,0,1,1190,333,333,0
"e36d261332f14e79bb4b467aceaeb9b5","c7e89b9d04744d2eab742fc24e3ef1ae",22901385,1,1,0,1191,333,334,1
"c7e89b9d04744d2eab742fc24e3ef1ae","c7e89b9d04744d2eab742fc24e3ef1ae",22901385,5,0,1,1192,334,334,0
"c7e89b9d04744d2eab742fc24e3ef1ae","fe49f8054b374a0ea4bb266ed135ff62",22901385,1,1,0,1197,334,335,1
"fe49f8054b374a0ea4bb266ed135ff62","fe49f8054b374a0ea4bb266ed135ff62",22901385,2,0,1,1198,335,335,0
"fe49f8054b374a0ea4bb266ed135ff62","d0a8f74af98642fe8360d22c42e45117",22901385,1,1,0,1200,335,336,1
"d0a8f74af98642fe8360d22c42e45117","d0a8f74af98642fe8360d22c42e45117",22901385,2,0,1,1201,336,336,0
"d0a8f74af98642fe8360d22c42e45117","0c4079457ede49e3aeb5e86ed84bdf35",22901385,1,-7,0,1203,336,329,-7
"0c4079457ede49e3aeb5e86ed84bdf35","a7c6339ca1da4368a18d471f0519f877",22901385,1,11,0,1204,329,339,10
"a7c6339ca1da4368a18d471f0519f877","a7c6339ca1da4368a18d471f0519f877",22901385,1,0,1,1205,339,339,0
"a7c6339ca1da4368a18d471f0519f877","bbc5139ca9024389a94db3a6f47dcff6",22901385,1,3,0,1206,339,341,2
"bbc5139ca9024389a94db3a6f47dcff6","b8b9418ab322418d9db9b40d96af873a",22901385,1,-5,0,1207,341,337,-4
"b8b9418ab322418d9db9b40d96af873a","4ee6ca9019ab4a1ab323f98094a9bd77",22901385,1,7,0,1208,337,343,6
"4ee6ca9019ab4a1ab323f98094a9bd77","4ee6ca9019ab4a1ab323f98094a9bd77",22901385,2,0,1,1209,343,343,0
"4ee6ca9019ab4a1ab323f98094a9bd77","b37947176785476f8b29d49a851366dc",22901385,1,1,0,1211,343,344,1
"b37947176785476f8b29d49a851366dc","b37947176785476f8b29d49a851366dc",22901385,2,0,1,1212,344,344,0
"b37947176785476f8b29d49a851366dc","fcea5b10d5a14a3b9324ffece8f6e1e5",22901385,1,1,0,1214,344,345,1
"fcea5b10d5a14a3b9324ffece8f6e1e5","fcea5b10d5a14a3b9324ffece8f6e1e5",22901385,2,0,1,1215,345,345,0
"fcea5b10d5a14a3b9324ffece8f6e1e5","c2490bc612d146edbe786556fab3651b",22901385,1,-5,0,1217,345,340,-5
"c2490bc612d146edbe786556fab3651b","0c4079457ede49e3aeb5e86ed84bdf35",22901385,1,-13,0,1218,340,329,-11
"0c4079457ede49e3aeb5e86ed84bdf35","4a92daef4d504e1792575a26502bb7b7",22901385,1,20,0,1219,329,346,17
"4a92daef4d504e1792575a26502bb7b7","6ac8bb048b854999a47edb35fe627f11",22901385,1,1,0,1220,346,347,1
"6ac8bb048b854999a47edb35fe627f11","6ac8bb048b854999a47edb35fe627f11",22901385,1,0,1,1221,347,347,0
"6ac8bb048b854999a47edb35fe627f11","0c4079457ede49e3aeb5e86ed84bdf35",22901385,1,-21,0,1222,347,329,-18
"0c4079457ede49e3aeb5e86ed84bdf35","30ead9794d4847abaf222ca966cc8630",22901385,1,24,0,1223,329,348,19
"30ead9794d4847abaf222ca966cc8630","09b9678ddc3d452ea4a3d46e15826065",22901385,1,5,0,1224,348,353,5
"09b9678ddc3d452ea4a3d46e15826065","eff0de7f2dbb42dfa1a2e686efab5b6d",22901385,2,1,0,1225,353,354,1
"eff0de7f2dbb42dfa1a2e686efab5b6d","897b7f51242c44aab2205c72fdcbf4cd",22901385,2,-2,0,1226,354,352,-2
"897b7f51242c44aab2205c72fdcbf4cd","c20993c944444fe085345591a8bd837e",22901385,1,-1,0,1227,352,351,-1
"c20993c944444fe085345591a8bd837e","c20993c944444fe085345591a8bd837e",22901385,5,0,1,1228,351,351,0
"c20993c944444fe085345591a8bd837e","897b7f51242c44aab2205c72fdcbf4cd",22901385,1,1,0,1232,351,352,1
"897b7f51242c44aab2205c72fdcbf4cd","897b7f51242c44aab2205c72fdcbf4cd",22901385,4,0,1,1233,352,352,0
"897b7f51242c44aab2205c72fdcbf4cd","09b9678ddc3d452ea4a3d46e15826065",22901385,1,1,0,1236,352,353,1
"09b9678ddc3d452ea4a3d46e15826065","09b9678ddc3d452ea4a3d46e15826065",22901385,5,0,1,1237,353,353,0
"eff0de7f2dbb42dfa1a2e686efab5b6d","eff0de7f2dbb42dfa1a2e686efab5b6d",22901385,4,0,1,1241,354,354,0
"eff0de7f2dbb42dfa1a2e686efab5b6d","30ead9794d4847abaf222ca966cc8630",22901385,1,-6,0,1244,354,348,-6
"30ead9794d4847abaf222ca966cc8630","2fe14166dc9642c3bc666b86a57f943d",22901385,1,10,0,1245,348,357,9
"2fe14166dc9642c3bc666b86a57f943d","44421dd1e13a47a388c4a19834b744c7",22901385,1,2,0,1246,357,359,2
"44421dd1e13a47a388c4a19834b744c7","44421dd1e13a47a388c4a19834b744c7",22901385,2,0,1,1247,359,359,0
"44421dd1e13a47a388c4a19834b744c7","cb5fc7ef85d547c4be1a7439d0bf6052",22901385,1,1,0,1249,359,360,1
"cb5fc7ef85d547c4be1a7439d0bf6052","cb5fc7ef85d547c4be1a7439d0bf6052",22901385,2,0,1,1250,360,360,0
"cb5fc7ef85d547c4be1a7439d0bf6052","0a8f150a4cf747acbde62f4721823da3",22901385,1,1,0,1252,360,361,1
"0a8f150a4cf747acbde62f4721823da3","0a8f150a4cf747acbde62f4721823da3",22901385,2,0,1,1253,361,361,0
"0a8f150a4cf747acbde62f4721823da3","ab8fdad974ae471f9f24c3f9dd04462e",22901385,1,1,0,1255,361,362,1
"ab8fdad974ae471f9f24c3f9dd04462e","ab8fdad974ae471f9f24c3f9dd04462e",22901385,2,0,1,1256,362,362,0
"ab8fdad974ae471f9f24c3f9dd04462e","52580888dadb4fe3baa795683ea227bd",22901385,1,3,0,1258,362,364,2
"52580888dadb4fe3baa795683ea227bd","1ba8fef685d74a8194b9db252eb704fb",22901385,1,-10,0,1259,364,355,-9
"1ba8fef685d74a8194b9db252eb704fb","492a3bc6a1254f23a7998587961b22a4",22901385,1,13,0,1260,355,366,11
"492a3bc6a1254f23a7998587961b22a4","f00179e251a045b39c3f7a54f9aa4acc",22901385,2,-4,0,1261,366,363,-3
"f00179e251a045b39c3f7a54f9aa4acc","072a190fd302456290895f9f04d6940a",22901385,2,3,0,1262,363,365,2
"072a190fd302456290895f9f04d6940a","cfa457d1743848e4bb5e4beced6448ed",22901385,1,5,0,1263,365,369,4
"cfa457d1743848e4bb5e4beced6448ed","cfa457d1743848e4bb5e4beced6448ed",22901385,1,0,1,1264,369,369,0
"cfa457d1743848e4bb5e4beced6448ed","b71bac264efb4abd97015447bd490db6",22901385,1,3,0,1265,369,370,1
"b71bac264efb4abd97015447bd490db6","30ead9794d4847abaf222ca966cc8630",22901385,2,-28,0,1266,370,348,-22
"30ead9794d4847abaf222ca966cc8630","8d448d625b024c82a5eb240bbd7431d6",22901385,2,33,0,1267,348,374,26
"8d448d625b024c82a5eb240bbd7431d6","8d448d625b024c82a5eb240bbd7431d6",22901385,62,0,1,1268,374,374,0
"8d448d625b024c82a5eb240bbd7431d6","b71bac264efb4abd97015447bd490db6",22901385,2,-5,0,1274,374,370,-4
"b71bac264efb4abd97015447bd490db6","8d448d625b024c82a5eb240bbd7431d6",22901385,1,5,0,1275,370,374,4
"8d448d625b024c82a5eb240bbd7431d6","d6d02b6ef04e4f17805504500b8ce441",22901385,1,3,0,1325,374,375,1
"d6d02b6ef04e4f17805504500b8ce441","b71bac264efb4abd97015447bd490db6",22901385,1,-8,0,1326,375,370,-5
"b71bac264efb4abd97015447bd490db6","d6d02b6ef04e4f17805504500b8ce441",22901385,2,8,0,1327,370,375,5
"d6d02b6ef04e4f17805504500b8ce441","d6d02b6ef04e4f17805504500b8ce441",22901385,3,0,1,1328,375,375,0
"d6d02b6ef04e4f17805504500b8ce441","66baf19b6b904b70922329068c63746d",22901385,2,4,0,1329,375,376,1
"66baf19b6b904b70922329068c63746d","7f544639412e40a9ba27f43b415362ab",22901385,6,2,0,1330,376,378,2
"7f544639412e40a9ba27f43b415362ab","66baf19b6b904b70922329068c63746d",22901385,5,-2,0,1331,378,376,-2
"7f544639412e40a9ba27f43b415362ab","d5ae8642e15b46b8bd298b02274d4e9c",22901385,1,2,0,1333,378,380,2
"d5ae8642e15b46b8bd298b02274d4e9c","d5ae8642e15b46b8bd298b02274d4e9c",22901385,1,0,1,1334,380,380,0
"d5ae8642e15b46b8bd298b02274d4e9c","a0d10309a2dd456289147f84be9d37f9",22901385,1,1,0,1335,380,381,1
"a0d10309a2dd456289147f84be9d37f9","a0d10309a2dd456289147f84be9d37f9",22901385,2,0,1,1336,381,381,0
"a0d10309a2dd456289147f84be9d37f9","0fcbc3ca07b144138b8d85da581f09a8",22901385,1,1,0,1338,381,382,1
"0fcbc3ca07b144138b8d85da581f09a8","0fcbc3ca07b144138b8d85da581f09a8",22901385,2,0,1,1339,382,382,0
"0fcbc3ca07b144138b8d85da581f09a8","66baf19b6b904b70922329068c63746d",22901385,1,-6,0,1341,382,376,-6
"66baf19b6b904b70922329068c63746d","c2fca3669923477ab966ded303dea31c",22901385,1,8,0,1342,376,383,7
"c2fca3669923477ab966ded303dea31c","4890121ce5d74576b4632b77cfc23398",22901385,1,6,0,1343,383,388,5
"4890121ce5d74576b4632b77cfc23398","96bb2b3e85a34d8b9544514e89f6fe97",22901385,1,3,0,1344,388,390,2
"96bb2b3e85a34d8b9544514e89f6fe97","18d3b836dd804224883cc9180b60a8e1",22901385,2,-4,0,1345,390,387,-3
"18d3b836dd804224883cc9180b60a8e1","66baf19b6b904b70922329068c63746d",22901385,1,-13,0,1346,387,376,-11
"66baf19b6b904b70922329068c63746d","66baf19b6b904b70922329068c63746d",22901385,4,0,1,1347,376,376,0
"66baf19b6b904b70922329068c63746d","17f95d18bab743888e1736033dc3384d",22901385,2,16,0,1351,376,389,13
"17f95d18bab743888e1736033dc3384d","96bb2b3e85a34d8b9544514e89f6fe97",22901385,2,1,0,1352,389,390,1
"96bb2b3e85a34d8b9544514e89f6fe97","ac4e9b54acfe4670b4634859c7263cb5",22901385,2,2,0,1353,390,392,2
"ac4e9b54acfe4670b4634859c7263cb5","ac4e9b54acfe4670b4634859c7263cb5",22901385,3,0,1,1354,392,392,0
"ac4e9b54acfe4670b4634859c7263cb5","17f95d18bab743888e1736033dc3384d",22901385,2,-3,0,1356,392,389,-3
"17f95d18bab743888e1736033dc3384d","6f8881a745ac4c358a68b92c3b4abe81",22901385,3,6,0,1357,389,394,5
"6f8881a745ac4c358a68b92c3b4abe81","f7002c8484354eceac57bc7bd62c76c1",22901385,3,-1,0,1358,394,393,-1
"f7002c8484354eceac57bc7bd62c76c1","0c12af0a4e7f4002852cf84b2537c161",22901385,4,3,0,1359,393,395,2
"0c12af0a4e7f4002852cf84b2537c161","6f8881a745ac4c358a68b92c3b4abe81",22901385,2,-2,0,1360,395,394,-1
"0c12af0a4e7f4002852cf84b2537c161","66baf19b6b904b70922329068c63746d",22901385,2,-24,0,1363,395,376,-19
"66baf19b6b904b70922329068c63746d","44a277ea44dc4ae689fab4b82f0b4098",22901385,1,26,0,1364,376,397,21
"44a277ea44dc4ae689fab4b82f0b4098","44a277ea44dc4ae689fab4b82f0b4098",22901385,1,0,1,1365,397,397,0
"44a277ea44dc4ae689fab4b82f0b4098","0c12af0a4e7f4002852cf84b2537c161",22901385,1,-2,0,1366,397,395,-2
"0c12af0a4e7f4002852cf84b2537c161","df8191ec5e584c838a899c378941a566",22901385,1,4,0,1367,395,398,3
"df8191ec5e584c838a899c378941a566","66baf19b6b904b70922329068c63746d",22901385,2,-28,0,1368,398,376,-22
"66baf19b6b904b70922329068c63746d","859e0b8d71694b12befb69ee698138f9",22901385,1,29,0,1369,376,399,23
"859e0b8d71694b12befb69ee698138f9","859e0b8d71694b12befb69ee698138f9",22901385,1,0,1,1370,399,399,0
"859e0b8d71694b12befb69ee698138f9","66baf19b6b904b70922329068c63746d",22901385,1,-29,0,1371,399,376,-23
"66baf19b6b904b70922329068c63746d","2b09a08242b54983aec7063990fb3f66",22901385,3,32,0,1372,376,400,24
"2b09a08242b54983aec7063990fb3f66","2b09a08242b54983aec7063990fb3f66",22901385,3,0,1,1373,400,400,0
"2b09a08242b54983aec7063990fb3f66","1f471b7a883a4df48211e8c6a81b59a7",22901385,1,1,0,1374,400,401,1
"1f471b7a883a4df48211e8c6a81b59a7","1f471b7a883a4df48211e8c6a81b59a7",22901385,1,0,1,1375,401,401,0
"1f471b7a883a4df48211e8c6a81b59a7","2b09a08242b54983aec7063990fb3f66",22901385,1,-1,0,1376,401,400,-1
"2b09a08242b54983aec7063990fb3f66","66baf19b6b904b70922329068c63746d",22901385,2,-32,0,1377,400,376,-24
"66baf19b6b904b70922329068c63746d","0c12af0a4e7f4002852cf84b2537c161",22901385,1,24,0,1378,376,395,19
"6f8881a745ac4c358a68b92c3b4abe81","0c12af0a4e7f4002852cf84b2537c161",22901385,1,2,0,1380,394,395,1
"0c12af0a4e7f4002852cf84b2537c161","96bb2b3e85a34d8b9544514e89f6fe97",22901385,1,-7,0,1381,395,390,-5
"96bb2b3e85a34d8b9544514e89f6fe97","f7002c8484354eceac57bc7bd62c76c1",22901385,1,4,0,1382,390,393,3
"f7002c8484354eceac57bc7bd62c76c1","66baf19b6b904b70922329068c63746d",22901385,1,-21,0,1383,393,376,-17
"66baf19b6b904b70922329068c63746d","4890121ce5d74576b4632b77cfc23398",22901385,3,14,0,1387,376,388,12
"4890121ce5d74576b4632b77cfc23398","c2fca3669923477ab966ded303dea31c",22901385,3,-6,0,1388,388,383,-5
"c2fca3669923477ab966ded303dea31c","96bb2b3e85a34d8b9544514e89f6fe97",22901385,1,9,0,1389,383,390,7
"18d3b836dd804224883cc9180b60a8e1","6f8881a745ac4c358a68b92c3b4abe81",22901385,1,9,0,1391,387,394,7
"6f8881a745ac4c358a68b92c3b4abe81","17f95d18bab743888e1736033dc3384d",22901385,2,-6,0,1392,394,389,-5
"17f95d18bab743888e1736033dc3384d","f7002c8484354eceac57bc7bd62c76c1",22901385,2,5,0,1393,389,393,4
"2b09a08242b54983aec7063990fb3f66","30ead9794d4847abaf222ca966cc8630",22901385,1,-72,0,1398,400,348,-52
"30ead9794d4847abaf222ca966cc8630","30ead9794d4847abaf222ca966cc8630",22901385,1,0,1,1399,348,348,0
"30ead9794d4847abaf222ca966cc8630","897b7f51242c44aab2205c72fdcbf4cd",22901385,1,4,0,1400,348,352,4
"897b7f51242c44aab2205c72fdcbf4cd","eff0de7f2dbb42dfa1a2e686efab5b6d",22901385,2,2,0,1401,352,354,2
"eff0de7f2dbb42dfa1a2e686efab5b6d","c20993c944444fe085345591a8bd837e",22901385,1,-3,0,1406,354,351,-3
"c20993c944444fe085345591a8bd837e","09b9678ddc3d452ea4a3d46e15826065",22901385,1,2,0,1407,351,353,2
"09b9678ddc3d452ea4a3d46e15826065","c20993c944444fe085345591a8bd837e",22901385,1,-2,0,1410,353,351,-2
"c20993c944444fe085345591a8bd837e","2fe14166dc9642c3bc666b86a57f943d",22901385,1,7,0,1412,351,357,6
"2fe14166dc9642c3bc666b86a57f943d","30ead9794d4847abaf222ca966cc8630",22901385,1,-10,0,1413,357,348,-9
"30ead9794d4847abaf222ca966cc8630","1ba8fef685d74a8194b9db252eb704fb",22901385,1,8,0,1414,348,355,7
"1ba8fef685d74a8194b9db252eb704fb","52580888dadb4fe3baa795683ea227bd",22901385,1,10,0,1415,355,364,9
"52580888dadb4fe3baa795683ea227bd","492a3bc6a1254f23a7998587961b22a4",22901385,1,3,0,1416,364,366,2
"072a190fd302456290895f9f04d6940a","b71bac264efb4abd97015447bd490db6",22901385,1,8,0,1419,365,370,5
"b71bac264efb4abd97015447bd490db6","b71bac264efb4abd97015447bd490db6",22901385,1,0,1,1430,370,370,0
"c2fca3669923477ab966ded303dea31c","18d3b836dd804224883cc9180b60a8e1",22901385,2,5,0,1439,383,387,4
"18d3b836dd804224883cc9180b60a8e1","96bb2b3e85a34d8b9544514e89f6fe97",22901385,2,4,0,1440,387,390,3
"96bb2b3e85a34d8b9544514e89f6fe97","6f8881a745ac4c358a68b92c3b4abe81",22901385,1,5,0,1441,390,394,4
"0c12af0a4e7f4002852cf84b2537c161","2b09a08242b54983aec7063990fb3f66",22901385,1,8,0,1445,395,400,5
"2b09a08242b54983aec7063990fb3f66","3434c10e561d488a914e0f7d71907abd",22901385,1,-127,0,1449,400,305,-95
"3434c10e561d488a914e0f7d71907abd","0c787d16c9504873b1a4d903cec09948",22901385,1,11,0,1450,305,314,9
"0c787d16c9504873b1a4d903cec09948","0c787d16c9504873b1a4d903cec09948",22901385,1,0,1,1451,314,314,0
"47edbb64109243e6b0f8f64cdef90c6c","0c4079457ede49e3aeb5e86ed84bdf35",22901385,1,6,0,1456,326,329,3
"0c4079457ede49e3aeb5e86ed84bdf35","b8b9418ab322418d9db9b40d96af873a",22901385,1,9,0,1457,329,337,8
"b8b9418ab322418d9db9b40d96af873a","2b09a08242b54983aec7063990fb3f66",22901385,1,87,0,1458,337,400,63
"2b09a08242b54983aec7063990fb3f66","1157bd665ec4472fb58b751dc5099355",22901385,1,4,0,1459,400,403,3
"1157bd665ec4472fb58b751dc5099355","9de0d567bfa84fe5b77cb76f4a76a5d1",22901385,1,1,0,1460,403,404,1
"9de0d567bfa84fe5b77cb76f4a76a5d1","9de0d567bfa84fe5b77cb76f4a76a5d1",22901385,1,0,1,1461,404,404,0
"9de0d567bfa84fe5b77cb76f4a76a5d1","1157bd665ec4472fb58b751dc5099355",22901385,1,-1,0,1462,404,403,-1
"1157bd665ec4472fb58b751dc5099355","58fc9094275e4c49be3f4ba6d4acc0a4",22901385,1,5,0,1463,403,406,3
"58fc9094275e4c49be3f4ba6d4acc0a4","3c8a22d2f9c146ea956609e3ed4f2559",22901385,1,-2,0,1464,406,405,-1
"3c8a22d2f9c146ea956609e3ed4f2559","c1c1be90b2b14c1ab4a5e1ee3c241902",22901385,1,3,0,1465,405,407,2
"c1c1be90b2b14c1ab4a5e1ee3c241902","c1c1be90b2b14c1ab4a5e1ee3c241902",22901385,5,0,1,1466,407,407,0
"c1c1be90b2b14c1ab4a5e1ee3c241902","58fc9094275e4c49be3f4ba6d4acc0a4",22901385,1,-1,0,1471,407,406,-1
"58fc9094275e4c49be3f4ba6d4acc0a4","02b3a1bead9244c1ba2f857c7da8f82a",22901385,1,3,0,1472,406,408,2
"02b3a1bead9244c1ba2f857c7da8f82a","6206fc6479014bb193084c32409dc1b9",22901385,1,1,0,1473,408,409,1
"6206fc6479014bb193084c32409dc1b9","6206fc6479014bb193084c32409dc1b9",22901385,9,0,1,1474,409,409,0
"6206fc6479014bb193084c32409dc1b9","6a5f020451db426dacba9e2ea3fcc62a",22901385,1,2,0,1483,409,410,1
"6a5f020451db426dacba9e2ea3fcc62a","02b3a1bead9244c1ba2f857c7da8f82a",22901385,3,-3,0,1484,410,408,-2
"02b3a1bead9244c1ba2f857c7da8f82a","66baf19b6b904b70922329068c63746d",22901385,1,-44,0,1485,408,376,-32
"96bb2b3e85a34d8b9544514e89f6fe97","17f95d18bab743888e1736033dc3384d",22901385,1,-1,0,1488,390,389,-1
"f7002c8484354eceac57bc7bd62c76c1","2b09a08242b54983aec7063990fb3f66",22901385,1,11,0,1491,393,400,7
"2b09a08242b54983aec7063990fb3f66","6a5f020451db426dacba9e2ea3fcc62a",22901385,1,15,0,1492,400,410,10
"6a5f020451db426dacba9e2ea3fcc62a","6a5f020451db426dacba9e2ea3fcc62a",22901385,1,0,1,1493,410,410,0
"6a5f020451db426dacba9e2ea3fcc62a","33a9d248b2e44588a5b07fc1342b9bc2",22901385,2,2,0,1494,410,411,1
"33a9d248b2e44588a5b07fc1342b9bc2","66baf19b6b904b70922329068c63746d",22901385,1,-49,0,1495,411,376,-35
"6f8881a745ac4c358a68b92c3b4abe81","2b09a08242b54983aec7063990fb3f66",22901385,1,10,0,1507,394,400,6
"2b09a08242b54983aec7063990fb3f66","33a9d248b2e44588a5b07fc1342b9bc2",22901385,1,17,0,1508,400,411,11
"33a9d248b2e44588a5b07fc1342b9bc2","33a9d248b2e44588a5b07fc1342b9bc2",22901385,1,0,1,1509,411,411,0
"33a9d248b2e44588a5b07fc1342b9bc2","6a5f020451db426dacba9e2ea3fcc62a",22901385,2,-2,0,1510,411,410,-1
"02b3a1bead9244c1ba2f857c7da8f82a","6a5f020451db426dacba9e2ea3fcc62a",22901385,2,3,0,1512,408,410,2
"6a5f020451db426dacba9e2ea3fcc62a","c6f26bd420634f1cb7989e76fe6b16c0",22901385,1,3,0,1517,410,412,2
"c6f26bd420634f1cb7989e76fe6b16c0","c6f26bd420634f1cb7989e76fe6b16c0",22901385,5,0,1,1518,412,412,0
"c6f26bd420634f1cb7989e76fe6b16c0","2a65ee6e2ac64f6a8a55fbe5373ec763",22901385,1,1,0,1523,412,413,1
"2a65ee6e2ac64f6a8a55fbe5373ec763","2a65ee6e2ac64f6a8a55fbe5373ec763",22901385,2,0,1,1524,413,413,0
"2a65ee6e2ac64f6a8a55fbe5373ec763","33a9d248b2e44588a5b07fc1342b9bc2",22901385,1,-2,0,1526,413,411,-2
"33a9d248b2e44588a5b07fc1342b9bc2","1fd0f6dadbc14ebc965faf6122190b96",22901385,1,5,0,1527,411,415,4
"1fd0f6dadbc14ebc965faf6122190b96","1fd0f6dadbc14ebc965faf6122190b96",22901385,1,0,1,1528,415,415,0
"1fd0f6dadbc14ebc965faf6122190b96","687055dad9fc40c3982478fe33ec01bf",22901385,1,-1,0,1529,415,414,-1
"687055dad9fc40c3982478fe33ec01bf","df8191ec5e584c838a899c378941a566",22901385,1,-25,0,1530,414,398,-16
"66baf19b6b904b70922329068c63746d","2add1669f08d4101913db15f8c23b3b7",22901385,1,56,0,1532,376,416,40
"2add1669f08d4101913db15f8c23b3b7","2b09a08242b54983aec7063990fb3f66",22901385,2,-24,0,1533,416,400,-16
"2b09a08242b54983aec7063990fb3f66","2add1669f08d4101913db15f8c23b3b7",22901385,1,24,0,1534,400,416,16
"2add1669f08d4101913db15f8c23b3b7","2add1669f08d4101913db15f8c23b3b7",22901385,1,0,1,1535,416,416,0
"2b09a08242b54983aec7063990fb3f66","a2b4bd40cee2481ebd3fc179d6a5cd62",22901385,1,27,0,1537,400,417,17
"a2b4bd40cee2481ebd3fc179d6a5cd62","e34e59dce2204f228f3a84b6725df60f",22901385,1,2,0,1538,417,419,2
"e34e59dce2204f228f3a84b6725df60f","e34e59dce2204f228f3a84b6725df60f",22901385,1,0,1,1539,419,419,0
"e34e59dce2204f228f3a84b6725df60f","a2b4bd40cee2481ebd3fc179d6a5cd62",22901385,1,-2,0,1540,419,417,-2
"a2b4bd40cee2481ebd3fc179d6a5cd62","bec48fc2e1294c7eb3d0aca780d731b8",22901385,1,4,0,1541,417,420,3
"bec48fc2e1294c7eb3d0aca780d731b8","bec48fc2e1294c7eb3d0aca780d731b8",22901385,1,0,1,1542,420,420,0
"bec48fc2e1294c7eb3d0aca780d731b8","a24600b0e49245f6bdba8c893cfeddb0",22901385,1,7,0,1543,420,425,5
"a24600b0e49245f6bdba8c893cfeddb0","dbde19fcce2a4c1abdc7f685c293a23f",22901385,1,-4,0,1544,425,422,-3
"dbde19fcce2a4c1abdc7f685c293a23f","a24600b0e49245f6bdba8c893cfeddb0",22901385,1,4,0,1545,422,425,3
"a24600b0e49245f6bdba8c893cfeddb0","a2b4bd40cee2481ebd3fc179d6a5cd62",22901385,1,-11,0,1546,425,417,-8
"a2b4bd40cee2481ebd3fc179d6a5cd62","24cf8786024543f19b89bc20034e60d7",22901385,1,18,0,1547,417,428,11
"24cf8786024543f19b89bc20034e60d7","f2a73be2f46840b182d7bd095378004e",22901385,1,1,0,1548,428,429,1
"f2a73be2f46840b182d7bd095378004e","604551fd4266430cb860fef58fa7dd61",22901385,1,1,0,1549,429,430,1
"604551fd4266430cb860fef58fa7dd61","604551fd4266430cb860fef58fa7dd61",22901385,9,0,1,1550,430,430,0
"604551fd4266430cb860fef58fa7dd61","dce46f8904594a62a6377a3587aaa663",22901385,1,2,0,1559,430,431,1
"dce46f8904594a62a6377a3587aaa663","24cf8786024543f19b89bc20034e60d7",22901385,1,-4,0,1560,431,428,-3
"24cf8786024543f19b89bc20034e60d7","9b9d0a249052413c869753b99682b0ac",22901385,1,5,0,1561,428,432,4
"9b9d0a249052413c869753b99682b0ac","9b9d0a249052413c869753b99682b0ac",22901385,8,0,1,1562,432,432,0
"9b9d0a249052413c869753b99682b0ac","061c175cc90f45fbad883025394e78dd",22901385,1,1,0,1570,432,433,1
"061c175cc90f45fbad883025394e78dd","061c175cc90f45fbad883025394e78dd",22901385,7,0,1,1571,433,433,0
"061c175cc90f45fbad883025394e78dd","dce46f8904594a62a6377a3587aaa663",22901385,1,-2,0,1578,433,431,-2
"dce46f8904594a62a6377a3587aaa663","74a7f8712e5449c2bc0b43c6f90dafed",22901385,1,5,0,1579,431,435,4
"74a7f8712e5449c2bc0b43c6f90dafed","74a7f8712e5449c2bc0b43c6f90dafed",22901385,4,0,1,1580,435,435,0
"74a7f8712e5449c2bc0b43c6f90dafed","66ada10dde9f43018588f1ced9d477fc",22901385,1,-1,0,1584,435,434,-1
"66ada10dde9f43018588f1ced9d477fc","bf12c96466d840a69bed7020b3f18bb8",22901385,1,3,0,1585,434,436,2
"bf12c96466d840a69bed7020b3f18bb8","bf12c96466d840a69bed7020b3f18bb8",22901385,1,0,1,1586,436,436,0
"bf12c96466d840a69bed7020b3f18bb8","24cf8786024543f19b89bc20034e60d7",22901385,1,-11,0,1587,436,428,-8
"24cf8786024543f19b89bc20034e60d7","070600601c4c439288445d2f0724807d",22901385,1,14,0,1588,428,437,9
"070600601c4c439288445d2f0724807d","1823b6de7d334a7aaabc4570719af4d9",22901385,1,2,0,1589,437,439,2
"1823b6de7d334a7aaabc4570719af4d9","1823b6de7d334a7aaabc4570719af4d9",22901385,10,0,1,1590,439,439,0
"1823b6de7d334a7aaabc4570719af4d9","070600601c4c439288445d2f0724807d",22901385,1,-2,0,1600,439,437,-2
"070600601c4c439288445d2f0724807d","0380cd76a7d44bc3a4da1f15e4d68f89",22901385,1,4,0,1601,437,440,3
"0380cd76a7d44bc3a4da1f15e4d68f89","23b7673c8b5443108c2ef09382834a86",22901385,1,2,0,1602,440,441,1
"23b7673c8b5443108c2ef09382834a86","0380cd76a7d44bc3a4da1f15e4d68f89",22901385,1,-2,0,1603,441,440,-1
"0380cd76a7d44bc3a4da1f15e4d68f89","901e92500aea43c79f19f1b279050668",22901385,1,4,0,1604,440,442,2
"901e92500aea43c79f19f1b279050668","23b7673c8b5443108c2ef09382834a86",22901385,1,-2,0,1605,442,441,-1
"23b7673c8b5443108c2ef09382834a86","001339db8ced4cf78829ebe8b145449d",22901385,1,3,0,1606,441,443,2
"001339db8ced4cf78829ebe8b145449d","001339db8ced4cf78829ebe8b145449d",22901385,2,0,1,1607,443,443,0
"001339db8ced4cf78829ebe8b145449d","452745e0366e42ae81561bfddebcc6c3",22901385,1,1,0,1609,443,444,1
"452745e0366e42ae81561bfddebcc6c3","452745e0366e42ae81561bfddebcc6c3",22901385,2,0,1,1610,444,444,0
"452745e0366e42ae81561bfddebcc6c3","901e92500aea43c79f19f1b279050668",22901385,1,-2,0,1612,444,442,-2
"901e92500aea43c79f19f1b279050668","4660ff2089114e8db82ceb26a4f329e3",22901385,1,4,0,1613,442,445,3
"4660ff2089114e8db82ceb26a4f329e3","7bd5586eb9d8484eb74a433ee7bfe499",22901385,2,2,0,1614,445,446,1
"7bd5586eb9d8484eb74a433ee7bfe499","4660ff2089114e8db82ceb26a4f329e3",22901385,1,-2,0,1615,446,445,-1
"7bd5586eb9d8484eb74a433ee7bfe499","7bd5586eb9d8484eb74a433ee7bfe499",22901385,13,0,1,1617,446,446,0
"7bd5586eb9d8484eb74a433ee7bfe499","8a7f26e690f34dda97be16904518ca99",22901385,1,2,0,1630,446,447,1
"8a7f26e690f34dda97be16904518ca99","8a7f26e690f34dda97be16904518ca99",22901385,1,0,1,1631,447,447,0
"8a7f26e690f34dda97be16904518ca99","070600601c4c439288445d2f0724807d",22901385,1,-16,0,1632,447,437,-10
"070600601c4c439288445d2f0724807d","b2f0d654738f48158edff28e8d3a546e",22901385,1,21,0,1633,437,449,12
"b2f0d654738f48158edff28e8d3a546e","b2f0d654738f48158edff28e8d3a546e",22901385,1,0,1,1634,449,449,0
"b2f0d654738f48158edff28e8d3a546e","f60ee41ec635499abd48168342d32c2f",22901385,2,5,0,1635,449,453,4
"f60ee41ec635499abd48168342d32c2f","f60ee41ec635499abd48168342d32c2f",22901385,67,0,1,1636,453,453,0
"f60ee41ec635499abd48168342d32c2f","b2f0d654738f48158edff28e8d3a546e",22901385,2,-5,0,1694,453,449,-4
"b2f0d654738f48158edff28e8d3a546e","f67fbf45a5f146ed866965bc57c7c001",22901385,2,8,0,1695,449,454,5
"f67fbf45a5f146ed866965bc57c7c001","b2f0d654738f48158edff28e8d3a546e",22901385,1,-8,0,1696,454,449,-5
"f67fbf45a5f146ed866965bc57c7c001","f67fbf45a5f146ed866965bc57c7c001",22901385,3,0,1,1709,454,454,0
"f67fbf45a5f146ed866965bc57c7c001","e20db35ced8544ddac5bc3839145e463",22901385,1,-501,0,1711,454,91,-363
"e20db35ced8544ddac5bc3839145e463","e20db35ced8544ddac5bc3839145e463",22901385,1,0,1,1712,91,91,0
"e20db35ced8544ddac5bc3839145e463","f67fbf45a5f146ed866965bc57c7c001",22901385,1,501,0,1713,91,454,363
"f67fbf45a5f146ed866965bc57c7c001","d937afe49bd24a07a550dda1c1155122",22901385,1,1,0,1715,454,455,1
"d937afe49bd24a07a550dda1c1155122","d937afe49bd24a07a550dda1c1155122",22901385,1,0,1,1716,455,455,0
"d937afe49bd24a07a550dda1c1155122","3628b3f7823443d0912a339096b69943",22901385,1,1,0,1717,455,456,1
"3628b3f7823443d0912a339096b69943","3628b3f7823443d0912a339096b69943",22901385,1,0,1,1718,456,456,0
"3628b3f7823443d0912a339096b69943","9e049ee647cf43ecbcb5ed792a8e7588",22901385,1,1,0,1719,456,457,1
"9e049ee647cf43ecbcb5ed792a8e7588","9e049ee647cf43ecbcb5ed792a8e7588",22901385,1,0,1,1720,457,457,0
"9e049ee647cf43ecbcb5ed792a8e7588","5256a214faaf410b93f76cea06428334",22901385,1,1,0,1721,457,458,1
"5256a214faaf410b93f76cea06428334","5256a214faaf410b93f76cea06428334",22901385,1,0,1,1722,458,458,0
"5256a214faaf410b93f76cea06428334","25c32b120fce40fa9b6c85133aeb4716",22901385,1,1,0,1723,458,459,1
"25c32b120fce40fa9b6c85133aeb4716","25c32b120fce40fa9b6c85133aeb4716",22901385,1,0,1,1724,459,459,0
"25c32b120fce40fa9b6c85133aeb4716","42de338840a34d15adb66e7b14fb9d2c",22901385,1,2,0,1725,459,461,2
"42de338840a34d15adb66e7b14fb9d2c","42de338840a34d15adb66e7b14fb9d2c",22901385,1,0,1,1726,461,461,0
"42de338840a34d15adb66e7b14fb9d2c","11bc14f2204949008b7d511b933363c1",22901385,1,-1,0,1727,461,460,-1
"11bc14f2204949008b7d511b933363c1","11bc14f2204949008b7d511b933363c1",22901385,1,0,1,1728,460,460,0
"11bc14f2204949008b7d511b933363c1","9da37c6210b1416b8079c274f70bf600",22901385,1,2,0,1729,460,462,2
"9da37c6210b1416b8079c274f70bf600","9da37c6210b1416b8079c274f70bf600",22901385,1,0,1,1730,462,462,0
"9da37c6210b1416b8079c274f70bf600","519119f1deac45ff9ab4f13529be5c6e",22901385,1,1,0,1731,462,463,1
"519119f1deac45ff9ab4f13529be5c6e","519119f1deac45ff9ab4f13529be5c6e",22901385,5,0,1,1732,463,463,0
"519119f1deac45ff9ab4f13529be5c6e","c5df9f40ec14463b9dcfdc73df3e9285",22901385,1,3,0,1737,463,464,1
"c5df9f40ec14463b9dcfdc73df3e9285","f67fbf45a5f146ed866965bc57c7c001",22901385,1,-12,0,1738,464,454,-10
"f67fbf45a5f146ed866965bc57c7c001","c5df9f40ec14463b9dcfdc73df3e9285",22901385,1,12,0,1739,454,464,10
"c5df9f40ec14463b9dcfdc73df3e9285","83d42d95cd844fc093fc09cee250edb8",22901385,2,3,0,1740,464,465,1
"83d42d95cd844fc093fc09cee250edb8","c5df9f40ec14463b9dcfdc73df3e9285",22901385,1,-3,0,1741,465,464,-1
"83d42d95cd844fc093fc09cee250edb8","83d42d95cd844fc093fc09cee250edb8",22901385,1,0,1,1743,465,465,0
"0c7262dff33c4087bc660ccf40f92f9c","e2911e79efc2420eac45d9f671463d4b",22902417,1,-238,0,1,169,2,-167
"e2911e79efc2420eac45d9f671463d4b","b613861cecf84ffcab01afb23f660475",22902417,1,-3,0,3,2,1,-1
"b613861cecf84ffcab01afb23f660475","b613861cecf84ffcab01afb23f660475",22902417,4,0,1,4,1,1,0
"b613861cecf84ffcab01afb23f660475","e2911e79efc2420eac45d9f671463d4b",22902417,1,3,0,8,1,2,1
"e2911e79efc2420eac45d9f671463d4b","e2911e79efc2420eac45d9f671463d4b",22902417,3,0,1,10,2,2,0
"e2911e79efc2420eac45d9f671463d4b","519d1b8c59404d67b54e96c5c8a830b2",22902417,1,1,0,11,2,3,1
"519d1b8c59404d67b54e96c5c8a830b2","519d1b8c59404d67b54e96c5c8a830b2",22902417,1,0,1,12,3,3,0
"519d1b8c59404d67b54e96c5c8a830b2","531db53f81f646edb0cdcfe0085b03b7",22902417,1,1,0,13,3,4,1
"531db53f81f646edb0cdcfe0085b03b7","531db53f81f646edb0cdcfe0085b03b7",22902417,1,0,1,14,4,4,0
"531db53f81f646edb0cdcfe0085b03b7","4f5f94b2f95141e0a9d53a61da2276da",22902417,1,1,0,15,4,5,1
"4f5f94b2f95141e0a9d53a61da2276da","4f5f94b2f95141e0a9d53a61da2276da",22902417,1,0,1,16,5,5,0
"4f5f94b2f95141e0a9d53a61da2276da","6d541c89590949f99af293c4f2333f67",22902417,1,1,0,17,5,6,1
"6d541c89590949f99af293c4f2333f67","6d541c89590949f99af293c4f2333f67",22902417,1,0,1,18,6,6,0
"6d541c89590949f99af293c4f2333f67","dd5cf0b9fe4c4f1d8f5ff8e4c04879cb",22902417,1,1,0,19,6,7,1
"dd5cf0b9fe4c4f1d8f5ff8e4c04879cb","dd5cf0b9fe4c4f1d8f5ff8e4c04879cb",22902417,1,0,1,20,7,7,0
"dd5cf0b9fe4c4f1d8f5ff8e4c04879cb","f96261861edc426abe2248be4f0a709a",22902417,1,1,0,21,7,8,1
"f96261861edc426abe2248be4f0a709a","f96261861edc426abe2248be4f0a709a",22902417,1,0,1,22,8,8,0
"f96261861edc426abe2248be4f0a709a","66b5e16f4f75454fb5b8172079f0fa83",22902417,1,1,0,23,8,9,1
"66b5e16f4f75454fb5b8172079f0fa83","66b5e16f4f75454fb5b8172079f0fa83",22902417,1,0,1,24,9,9,0
"66b5e16f4f75454fb5b8172079f0fa83","0680571d4698477995e41842c36a54b2",22902417,1,1,0,25,9,10,1
"0680571d4698477995e41842c36a54b2","0680571d4698477995e41842c36a54b2",22902417,1,0,1,26,10,10,0
"0680571d4698477995e41842c36a54b2","9112f2bffece48e08c6d2287be204085",22902417,1,1,0,27,10,11,1
"9112f2bffece48e08c6d2287be204085","9112f2bffece48e08c6d2287be204085",22902417,1,0,1,28,11,11,0
"9112f2bffece48e08c6d2287be204085","56586aa865414f538729c7f7735d2bc6",22902417,1,3,0,29,11,12,1
"56586aa865414f538729c7f7735d2bc6","e2911e79efc2420eac45d9f671463d4b",22902417,1,-12,0,30,12,2,-10
"e2911e79efc2420eac45d9f671463d4b","56586aa865414f538729c7f7735d2bc6",22902417,1,12,0,31,2,12,10
"56586aa865414f538729c7f7735d2bc6","56586aa865414f538729c7f7735d2bc6",22902417,3,0,1,32,12,12,0
"56586aa865414f538729c7f7735d2bc6","b7f2b31585d94eb3bf86376714aa7070",22902417,1,2,0,35,12,13,1
"b7f2b31585d94eb3bf86376714aa7070","b7f2b31585d94eb3bf86376714aa7070",22902417,2,0,1,36,13,13,0
"b7f2b31585d94eb3bf86376714aa7070","3f1c815879794b929260d224becaff7e",22902417,1,2,0,38,13,14,1
"3f1c815879794b929260d224becaff7e","81c864a886d54a6b8ff85f7d736f4f95",22902417,1,2,0,39,14,15,1
"81c864a886d54a6b8ff85f7d736f4f95","5c5ceeee4562457ba6d41515aeebfbb1",22902417,1,4,0,40,15,17,2
"5c5ceeee4562457ba6d41515aeebfbb1","b613861cecf84ffcab01afb23f660475",22902417,1,-25,0,41,17,1,-16
"b613861cecf84ffcab01afb23f660475","9afd71a5298d4333b6849dfce1b9422c",22902417,1,28,0,42,1,18,17
"b7719e26494940efa49512aedd0aac79","9afd71a5298d4333b6849dfce1b9422c",22902417,1,-4,0,45,20,18,-2
"9afd71a5298d4333b6849dfce1b9422c","d4f45188d3c84a02ba08454e6403a818",22902417,1,9,0,46,18,24,6
"d4c3b003e8274e429d2fa688d73fde6d","67a089198fcb4e1c8f2385786c2b296f",22902417,1,37,0,48,22,39,17
"64d48c6c9c7940639a932219a6c87198","64d48c6c9c7940639a932219a6c87198",22902417,3,0,1,51,40,40,0
"64d48c6c9c7940639a932219a6c87198","b534b89233134e30a9b5645138bfa9ee",22902417,1,3,0,54,40,41,1
"b534b89233134e30a9b5645138bfa9ee","67a089198fcb4e1c8f2385786c2b296f",22902417,1,-4,0,55,41,39,-2
"67a089198fcb4e1c8f2385786c2b296f","0e37b720d23b4e7f8b313e79313fd107",22902417,1,7,0,56,39,44,5
"0e37b720d23b4e7f8b313e79313fd107","0e37b720d23b4e7f8b313e79313fd107",22902417,1,0,1,57,44,44,0
"0e37b720d23b4e7f8b313e79313fd107","6875d67fdd5f48168b62719df449bebd",22902417,1,1,0,58,44,45,1
"6875d67fdd5f48168b62719df449bebd","6875d67fdd5f48168b62719df449bebd",22902417,1,0,1,59,45,45,0
"6875d67fdd5f48168b62719df449bebd","b534b89233134e30a9b5645138bfa9ee",22902417,1,-4,0,60,45,41,-4
"6e13d61a7bdb44bca949c9f86fab3be5","6e13d61a7bdb44bca949c9f86fab3be5",22902417,2,0,1,62,47,47,0
"6e13d61a7bdb44bca949c9f86fab3be5","195f78799f984cc2b06c48dfe36be751",22902417,1,2,0,64,47,49,2
"195f78799f984cc2b06c48dfe36be751","195f78799f984cc2b06c48dfe36be751",22902417,2,0,1,65,49,49,0
"195f78799f984cc2b06c48dfe36be751","d9c8d8c444a64dadbbb508652c721e17",22902417,1,-3,0,67,49,46,-3
"d9c8d8c444a64dadbbb508652c721e17","d0c74f735e024943943e40333d6d337f",22902417,1,6,0,68,46,51,5
"d0c74f735e024943943e40333d6d337f","d0c74f735e024943943e40333d6d337f",22902417,1,0,1,69,51,51,0
"d0c74f735e024943943e40333d6d337f","983f8ff320594b279a7f4a6fe132f9c5",22902417,1,2,0,70,51,53,2
"983f8ff320594b279a7f4a6fe132f9c5","983f8ff320594b279a7f4a6fe132f9c5",22902417,2,0,1,71,53,53,0
"983f8ff320594b279a7f4a6fe132f9c5","35adfa5d923046aebabfefd98f35ff05",22902417,1,1,0,73,53,54,1
"35adfa5d923046aebabfefd98f35ff05","35adfa5d923046aebabfefd98f35ff05",22902417,5,0,1,74,54,54,0
"35adfa5d923046aebabfefd98f35ff05","b6f8a98476224da1b40e555ececc7ed8",22902417,1,1,0,79,54,55,1
"b6f8a98476224da1b40e555ececc7ed8","b6f8a98476224da1b40e555ececc7ed8",22902417,2,0,1,80,55,55,0
"b6f8a98476224da1b40e555ececc7ed8","86e22cb5fe0e4b47a9489ecddf7ed78f",22902417,1,1,0,82,55,56,1
"86e22cb5fe0e4b47a9489ecddf7ed78f","86e22cb5fe0e4b47a9489ecddf7ed78f",22902417,2,0,1,83,56,56,0
"86e22cb5fe0e4b47a9489ecddf7ed78f","f924752d8a1149668870b1e7698486f7",22902417,1,-6,0,85,56,50,-6
"f924752d8a1149668870b1e7698486f7","a1f2f12debe5432fb7a70bcd12bacfb9",22902417,2,9,0,86,50,58,8
"78f30e4dcac84e3cbea8b2cc6e0d62b3","a1f2f12debe5432fb7a70bcd12bacfb9",22902417,1,-1,0,88,59,58,-1
"a1f2f12debe5432fb7a70bcd12bacfb9","b534b89233134e30a9b5645138bfa9ee",22902417,1,-20,0,91,58,41,-17
"b534b89233134e30a9b5645138bfa9ee","b534b89233134e30a9b5645138bfa9ee",22902417,1,0,1,92,41,41,0
"b534b89233134e30a9b5645138bfa9ee","a1f2f12debe5432fb7a70bcd12bacfb9",22902417,1,20,0,93,41,58,17
"78f30e4dcac84e3cbea8b2cc6e0d62b3","d0c74f735e024943943e40333d6d337f",22902417,1,-9,0,95,59,51,-8
"d0c74f735e024943943e40333d6d337f","12aa6e1672ac4e7aa6449a7a8609cd72",22902417,1,7,0,96,51,57,6
"12aa6e1672ac4e7aa6449a7a8609cd72","78f30e4dcac84e3cbea8b2cc6e0d62b3",22902417,1,2,0,97,57,59,2
"78f30e4dcac84e3cbea8b2cc6e0d62b3","f924752d8a1149668870b1e7698486f7",22902417,1,-10,0,98,59,50,-9
"a1f2f12debe5432fb7a70bcd12bacfb9","a1f2f12debe5432fb7a70bcd12bacfb9",22902417,30,0,1,100,58,58,0
"a1f2f12debe5432fb7a70bcd12bacfb9","78f30e4dcac84e3cbea8b2cc6e0d62b3",22902417,3,1,0,128,58,59,1
"78f30e4dcac84e3cbea8b2cc6e0d62b3","78f30e4dcac84e3cbea8b2cc6e0d62b3",22902417,9,0,1,129,59,59,0
"78f30e4dcac84e3cbea8b2cc6e0d62b3","12aa6e1672ac4e7aa6449a7a8609cd72",22902417,1,-2,0,138,59,57,-2
"12aa6e1672ac4e7aa6449a7a8609cd72","a0a418b8540d479fa6e0f653b701da8b",22902417,1,8,0,139,57,64,7
"a0a418b8540d479fa6e0f653b701da8b","bc42d26810654ea9a1df1efe1e58c7d5",22902417,1,-1,0,140,64,63,-1
"bc42d26810654ea9a1df1efe1e58c7d5","4c943503763e4e349906eea3ed3c8e86",22902417,1,-2,0,141,63,61,-2
"4c943503763e4e349906eea3ed3c8e86","4c943503763e4e349906eea3ed3c8e86",22902417,4,0,1,142,61,61,0
"4c943503763e4e349906eea3ed3c8e86","bc42d26810654ea9a1df1efe1e58c7d5",22902417,1,2,0,146,61,63,2
"bc42d26810654ea9a1df1efe1e58c7d5","bc42d26810654ea9a1df1efe1e58c7d5",22902417,3,0,1,147,63,63,0
"bc42d26810654ea9a1df1efe1e58c7d5","a0a418b8540d479fa6e0f653b701da8b",22902417,1,1,0,150,63,64,1
"a0a418b8540d479fa6e0f653b701da8b","a0a418b8540d479fa6e0f653b701da8b",22902417,3,0,1,151,64,64,0
"a0a418b8540d479fa6e0f653b701da8b","309ccf3cc4fe429d9bfbaef53d3fa479",22902417,1,-4,0,154,64,60,-4
"309ccf3cc4fe429d9bfbaef53d3fa479","d646286c8051419bbc2e31dd1db55ca8",22902417,1,10,0,155,60,67,7
"d646286c8051419bbc2e31dd1db55ca8","b534b89233134e30a9b5645138bfa9ee",22902417,1,-33,0,156,67,41,-26
"b534b89233134e30a9b5645138bfa9ee","267f883678b24aed855fde42524975d9",22902417,1,37,0,157,41,71,30
"267f883678b24aed855fde42524975d9","267f883678b24aed855fde42524975d9",22902417,1,0,1,158,71,71,0
"267f883678b24aed855fde42524975d9","88fff56d0342490dbef9040750a20f6c",22902417,1,1,0,159,71,72,1
"88fff56d0342490dbef9040750a20f6c","88fff56d0342490dbef9040750a20f6c",22902417,1,0,1,160,72,72,0
"88fff56d0342490dbef9040750a20f6c","adb17b12b66c4a49a85fd34322f7df70",22902417,1,1,0,161,72,73,1
"adb17b12b66c4a49a85fd34322f7df70","adb17b12b66c4a49a85fd34322f7df70",22902417,2,0,1,162,73,73,0
"adb17b12b66c4a49a85fd34322f7df70","a2becd407db34b189200a32546d9d569",22902417,1,3,0,164,73,75,2
"a2becd407db34b189200a32546d9d569","d646286c8051419bbc2e31dd1db55ca8",22902417,1,-9,0,165,75,67,-8
"d646286c8051419bbc2e31dd1db55ca8","a2becd407db34b189200a32546d9d569",22902417,1,9,0,166,67,75,8
"a2becd407db34b189200a32546d9d569","58c22b011d0f4c2ea6d13615edbb9eeb",22902417,1,2,0,167,75,77,2
"58c22b011d0f4c2ea6d13615edbb9eeb","58c22b011d0f4c2ea6d13615edbb9eeb",22902417,8,0,1,168,77,77,0
"58c22b011d0f4c2ea6d13615edbb9eeb","dd76e1861dc9461c830888729d091ee0",22902417,1,1,0,176,77,78,1
"dd76e1861dc9461c830888729d091ee0","dd76e1861dc9461c830888729d091ee0",22902417,5,0,1,177,78,78,0
"dd76e1861dc9461c830888729d091ee0","cd1d828f1a694b87913a7ea66c23803e",22902417,1,1,0,182,78,79,1
"cd1d828f1a694b87913a7ea66c23803e","cd1d828f1a694b87913a7ea66c23803e",22902417,5,0,1,183,79,79,0
"cd1d828f1a694b87913a7ea66c23803e","9176a3c2b4d2465fa8b0c67096c2a97e",22902417,1,1,0,188,79,80,1
"9176a3c2b4d2465fa8b0c67096c2a97e","9176a3c2b4d2465fa8b0c67096c2a97e",22902417,12,0,1,189,80,80,0
"9176a3c2b4d2465fa8b0c67096c2a97e","f8ec6445f7194e25b9101d4fbcb07a18",22902417,1,1,0,201,80,81,1
"f8ec6445f7194e25b9101d4fbcb07a18","f8ec6445f7194e25b9101d4fbcb07a18",22902417,2,0,1,202,81,81,0
"f8ec6445f7194e25b9101d4fbcb07a18","140d5b27b8574befad82c0a013b59dfa",22902417,1,-7,0,204,81,74,-7
"140d5b27b8574befad82c0a013b59dfa","d18a9ea32855445f8736581f5cb119ce",22902417,1,9,0,205,74,82,8
"d18a9ea32855445f8736581f5cb119ce","f564483cbd7a407681aa2fcca518cf5f",22902417,1,4,0,206,82,85,3
"f564483cbd7a407681aa2fcca518cf5f","f564483cbd7a407681aa2fcca518cf5f",22902417,9,0,1,207,85,85,0
"f564483cbd7a407681aa2fcca518cf5f","18fd01350bd5434ca636d59a599d768a",22902417,1,1,0,216,85,86,1
"18fd01350bd5434ca636d59a599d768a","18fd01350bd5434ca636d59a599d768a",22902417,8,0,1,217,86,86,0
"18fd01350bd5434ca636d59a599d768a","ae5ac430ea254e708a6f5deaaf7464ae",22902417,1,-2,0,225,86,84,-2
"ae5ac430ea254e708a6f5deaaf7464ae","6a9f0ef185fb47f0937e29daa1c71ed5",22902417,1,7,0,226,84,90,6
"6a9f0ef185fb47f0937e29daa1c71ed5","c681290961c94c4caf23b529d1ae6b9a",22902417,1,-2,0,227,90,88,-2
"c681290961c94c4caf23b529d1ae6b9a","c681290961c94c4caf23b529d1ae6b9a",22902417,1,0,1,228,88,88,0
"c681290961c94c4caf23b529d1ae6b9a","6a9f0ef185fb47f0937e29daa1c71ed5",22902417,1,2,0,229,88,90,2
"6a9f0ef185fb47f0937e29daa1c71ed5","6a9f0ef185fb47f0937e29daa1c71ed5",22902417,3,0,1,230,90,90,0
"6a9f0ef185fb47f0937e29daa1c71ed5","e20db35ced8544ddac5bc3839145e463",22902417,1,3,0,233,90,91,1
"e20db35ced8544ddac5bc3839145e463","d646286c8051419bbc2e31dd1db55ca8",22902417,1,-30,0,234,91,67,-24
"d646286c8051419bbc2e31dd1db55ca8","1febb706d7a34005ae8711ed49c76e64",22902417,1,33,0,235,67,94,27
"1febb706d7a34005ae8711ed49c76e64","1febb706d7a34005ae8711ed49c76e64",22902417,5,0,1,236,94,94,0
"1febb706d7a34005ae8711ed49c76e64","8f73ba6f5a0042f2850356ac38ac6f24",22902417,1,1,0,241,94,95,1
"8f73ba6f5a0042f2850356ac38ac6f24","8f73ba6f5a0042f2850356ac38ac6f24",22902417,5,0,1,242,95,95,0
"8f73ba6f5a0042f2850356ac38ac6f24","e2260b86653c46d7b14a41fb419dbf8c",22902417,1,1,0,247,95,96,1
"e2260b86653c46d7b14a41fb419dbf8c","e2260b86653c46d7b14a41fb419dbf8c",22902417,2,0,1,248,96,96,0
"e2260b86653c46d7b14a41fb419dbf8c","35eb641ad1d845bbba54915bce75a962",22902417,1,1,0,250,96,97,1
"35eb641ad1d845bbba54915bce75a962","35eb641ad1d845bbba54915bce75a962",22902417,5,0,1,251,97,97,0
"35eb641ad1d845bbba54915bce75a962","08be90ffbeea4795a138cd42ed8db56f",22902417,1,1,0,256,97,98,1
"08be90ffbeea4795a138cd42ed8db56f","08be90ffbeea4795a138cd42ed8db56f",22902417,5,0,1,257,98,98,0
"08be90ffbeea4795a138cd42ed8db56f","3007433c8f584dcbb5ac159c1c5f2be3",22902417,1,1,0,262,98,99,1
"3007433c8f584dcbb5ac159c1c5f2be3","3007433c8f584dcbb5ac159c1c5f2be3",22902417,5,0,1,263,99,99,0
"3007433c8f584dcbb5ac159c1c5f2be3","00ae5f0c51874a73a41ebea838d95682",22902417,1,3,0,268,99,101,2
"00ae5f0c51874a73a41ebea838d95682","e20db35ced8544ddac5bc3839145e463",22902417,1,-11,0,269,101,91,-10
"e20db35ced8544ddac5bc3839145e463","d391c8b6e56a43a7b654e9dee02d904b",22902417,1,13,0,270,91,103,12
"d391c8b6e56a43a7b654e9dee02d904b","00ae5f0c51874a73a41ebea838d95682",22902417,1,-2,0,271,103,101,-2
"00ae5f0c51874a73a41ebea838d95682","00ae5f0c51874a73a41ebea838d95682",22902417,1,0,1,272,101,101,0
"d391c8b6e56a43a7b654e9dee02d904b","d391c8b6e56a43a7b654e9dee02d904b",22902417,29,0,1,274,103,103,0
"d391c8b6e56a43a7b654e9dee02d904b","6111116566fc4fd9abba409322bea245",22902417,1,1,0,303,103,104,1
"6111116566fc4fd9abba409322bea245","6111116566fc4fd9abba409322bea245",22902417,5,0,1,304,104,104,0
"6111116566fc4fd9abba409322bea245","a81b2235cb9c499eb9ea8ee0a8dd9725",22902417,1,1,0,309,104,105,1
"a81b2235cb9c499eb9ea8ee0a8dd9725","a81b2235cb9c499eb9ea8ee0a8dd9725",22902417,2,0,1,310,105,105,0
"a81b2235cb9c499eb9ea8ee0a8dd9725","2d4e0ab0ef3b4d73b82c72d4621a7579",22902417,1,1,0,312,105,106,1
"2d4e0ab0ef3b4d73b82c72d4621a7579","2d4e0ab0ef3b4d73b82c72d4621a7579",22902417,2,0,1,313,106,106,0
"2d4e0ab0ef3b4d73b82c72d4621a7579","8bdebf492ebd4e62b0d522e8ab5e5197",22902417,1,1,0,315,106,107,1
"8bdebf492ebd4e62b0d522e8ab5e5197","8bdebf492ebd4e62b0d522e8ab5e5197",22902417,2,0,1,316,107,107,0
"8bdebf492ebd4e62b0d522e8ab5e5197","73039f8c1eb9409cb4caee2cf968001e",22902417,1,-7,0,318,107,100,-7
"73039f8c1eb9409cb4caee2cf968001e","4280927ec4d643238aa49c32f9e06c6c",22902417,1,10,0,319,100,109,9
"4280927ec4d643238aa49c32f9e06c6c","4280927ec4d643238aa49c32f9e06c6c",22902417,1,0,1,320,109,109,0
"4280927ec4d643238aa49c32f9e06c6c","fc44e6a5f7654430af1227838224dceb",22902417,1,2,0,321,109,111,2
"fc44e6a5f7654430af1227838224dceb","fc44e6a5f7654430af1227838224dceb",22902417,8,0,1,322,111,111,0
"fc44e6a5f7654430af1227838224dceb","a9ae0a3c070d455bb4369a8996313336",22902417,1,4,0,330,111,114,3
"08111f75e22d409998cf8b85bd431f0a","a9ae0a3c070d455bb4369a8996313336",22902417,1,7,0,332,108,114,6
"a9ae0a3c070d455bb4369a8996313336","71cec822bcff4f30a20e75dc63ef7b65",22902417,1,2,0,333,114,116,2
"71cec822bcff4f30a20e75dc63ef7b65","71cec822bcff4f30a20e75dc63ef7b65",22902417,1,0,1,334,116,116,0
"71cec822bcff4f30a20e75dc63ef7b65","37319e88176d4aefa91d7a9980dbae91",22902417,1,-4,0,335,116,112,-4
"62bff51286ef4f348717a3cf6fe2318f","b1cd0e7dc3ad4a8eb91a4bfdbeb025b0",22902417,1,-2,0,337,120,118,-2
"b1cd0e7dc3ad4a8eb91a4bfdbeb025b0","b1cd0e7dc3ad4a8eb91a4bfdbeb025b0",22902417,1,0,1,338,118,118,0
"b1cd0e7dc3ad4a8eb91a4bfdbeb025b0","62bff51286ef4f348717a3cf6fe2318f",22902417,1,2,0,339,118,120,2
"62bff51286ef4f348717a3cf6fe2318f","779f9ddd1fd14d1e9e69f72219a1fdbd",22902417,1,3,0,343,120,121,1
"779f9ddd1fd14d1e9e69f72219a1fdbd","e20db35ced8544ddac5bc3839145e463",22902417,1,-36,0,344,121,91,-30
"e20db35ced8544ddac5bc3839145e463","ae26e6cda8ad4a3f81bd347560d9579f",22902417,1,40,0,345,91,125,34
"ae26e6cda8ad4a3f81bd347560d9579f","ae26e6cda8ad4a3f81bd347560d9579f",22902417,1,0,1,346,125,125,0
"ae26e6cda8ad4a3f81bd347560d9579f","ee48df95832b4374aa273ceb27ec1315",22902417,1,1,0,347,125,126,1
"ee48df95832b4374aa273ceb27ec1315","ee48df95832b4374aa273ceb27ec1315",22902417,1,0,1,348,126,126,0
"ee48df95832b4374aa273ceb27ec1315","7a439da90b394756ad1777fc4c6dead5",22902417,1,1,0,349,126,127,1
"7a439da90b394756ad1777fc4c6dead5","7a439da90b394756ad1777fc4c6dead5",22902417,1,0,1,350,127,127,0
"7a439da90b394756ad1777fc4c6dead5","779f9ddd1fd14d1e9e69f72219a1fdbd",22902417,1,-6,0,351,127,121,-6
"779f9ddd1fd14d1e9e69f72219a1fdbd","a8dd5213034441ac92724b4e83eb0bb2",22902417,1,9,0,352,121,129,8
"a8dd5213034441ac92724b4e83eb0bb2","a8dd5213034441ac92724b4e83eb0bb2",22902417,1,0,1,353,129,129,0
"a8dd5213034441ac92724b4e83eb0bb2","8115eab6556b45f5b415c3b8c26a12e5",22902417,1,2,0,354,129,131,2
"8115eab6556b45f5b415c3b8c26a12e5","8115eab6556b45f5b415c3b8c26a12e5",22902417,2,0,1,355,131,131,0
"8115eab6556b45f5b415c3b8c26a12e5","ec34b06efd844b46a4c4818ecdb9b8f4",22902417,1,1,0,357,131,132,1
"ec34b06efd844b46a4c4818ecdb9b8f4","ec34b06efd844b46a4c4818ecdb9b8f4",22902417,2,0,1,358,132,132,0
"ec34b06efd844b46a4c4818ecdb9b8f4","c2e1c2b9eac64109b343a088584b576b",22902417,1,1,0,360,132,133,1
"c2e1c2b9eac64109b343a088584b576b","c2e1c2b9eac64109b343a088584b576b",22902417,2,0,1,361,133,133,0
"c2e1c2b9eac64109b343a088584b576b","579338175e0b4bbb8ef3b712b5d8b54e",22902417,1,-5,0,363,133,128,-5
"579338175e0b4bbb8ef3b712b5d8b54e","8bc5795d6a984a3eace4e2811e52dd4f",22902417,1,8,0,364,128,135,7
"8bc5795d6a984a3eace4e2811e52dd4f","8bc5795d6a984a3eace4e2811e52dd4f",22902417,1,0,1,365,135,135,0
"8bc5795d6a984a3eace4e2811e52dd4f","b416d47c56a742199b5d7c7f19d6503a",22902417,1,-1,0,366,135,134,-1
"b416d47c56a742199b5d7c7f19d6503a","cd4532ad48034873ba8bce2aac0c9808",22902417,1,4,0,367,134,137,3
"cd4532ad48034873ba8bce2aac0c9808","cd4532ad48034873ba8bce2aac0c9808",22902417,1,0,1,368,137,137,0
"cd4532ad48034873ba8bce2aac0c9808","779f9ddd1fd14d1e9e69f72219a1fdbd",22902417,1,-19,0,369,137,121,-16
"779f9ddd1fd14d1e9e69f72219a1fdbd","df1de691dafe4549a18a4398ee9dfaf9",22902417,1,23,0,370,121,139,18
"df1de691dafe4549a18a4398ee9dfaf9","6c5ad271a44743479bfaea29b1db8d02",22902417,1,4,0,371,139,143,4
"6c5ad271a44743479bfaea29b1db8d02","83d311bed5374fee83d8d67a7d9d82dc",22902417,1,1,0,372,143,144,1
"83d311bed5374fee83d8d67a7d9d82dc","83d311bed5374fee83d8d67a7d9d82dc",22902417,1,0,1,373,144,144,0
"83d311bed5374fee83d8d67a7d9d82dc","402bba41861d43acb52a5abb89e8831e",22902417,1,1,0,374,144,145,1
"402bba41861d43acb52a5abb89e8831e","402bba41861d43acb52a5abb89e8831e",22902417,2,0,1,375,145,145,0
"402bba41861d43acb52a5abb89e8831e","df1de691dafe4549a18a4398ee9dfaf9",22902417,1,-6,0,377,145,139,-6
"df1de691dafe4549a18a4398ee9dfaf9","8aae34f5ddbb4052a709b12e6b0d40fa",22902417,1,9,0,378,139,147,8
"8aae34f5ddbb4052a709b12e6b0d40fa","8aae34f5ddbb4052a709b12e6b0d40fa",22902417,1,0,1,379,147,147,0
"8aae34f5ddbb4052a709b12e6b0d40fa","645b3f0249f64f76af2e19eb4d0e55b7",22902417,1,2,0,380,147,149,2
"645b3f0249f64f76af2e19eb4d0e55b7","645b3f0249f64f76af2e19eb4d0e55b7",22902417,9,0,1,381,149,149,0
"645b3f0249f64f76af2e19eb4d0e55b7","7e7b8db5064d4369805ab370aac5ddfb",22902417,1,1,0,390,149,150,1
"7e7b8db5064d4369805ab370aac5ddfb","7e7b8db5064d4369805ab370aac5ddfb",22902417,2,0,1,391,150,150,0
"7e7b8db5064d4369805ab370aac5ddfb","8956d210ae7f41968fada86d4c979d6a",22902417,1,1,0,393,150,151,1
"8956d210ae7f41968fada86d4c979d6a","8956d210ae7f41968fada86d4c979d6a",22902417,2,0,1,394,151,151,0
"8956d210ae7f41968fada86d4c979d6a","f902b0f41b544d4dbf79664fd233648d",22902417,1,-5,0,396,151,146,-5
"f902b0f41b544d4dbf79664fd233648d","ae781e8b775e4ccd93bc800dad5c8376",22902417,1,8,0,397,146,153,7
"ae781e8b775e4ccd93bc800dad5c8376","ae781e8b775e4ccd93bc800dad5c8376",22902417,2,0,1,398,153,153,0
"ae781e8b775e4ccd93bc800dad5c8376","06882a8492d9499aa31555567f575ecb",22902417,1,1,0,400,153,154,1
"06882a8492d9499aa31555567f575ecb","06882a8492d9499aa31555567f575ecb",22902417,1,0,1,401,154,154,0
"06882a8492d9499aa31555567f575ecb","f293c508f409466a8f27ddd7d1e40b20",22902417,1,1,0,402,154,155,1
"f293c508f409466a8f27ddd7d1e40b20","f293c508f409466a8f27ddd7d1e40b20",22902417,2,0,1,403,155,155,0
"f293c508f409466a8f27ddd7d1e40b20","cc4ddef5bbbe48ebb605141b347c4ed1",22902417,1,1,0,405,155,156,1
"cc4ddef5bbbe48ebb605141b347c4ed1","cc4ddef5bbbe48ebb605141b347c4ed1",22902417,1,0,1,406,156,156,0
"cc4ddef5bbbe48ebb605141b347c4ed1","d313cec988a84645bee413e8d4724a4b",22902417,1,3,0,407,156,158,2
"d313cec988a84645bee413e8d4724a4b","f03480cf4eba413194d7af52fc0e7f28",22902417,1,-7,0,408,158,152,-6
"f03480cf4eba413194d7af52fc0e7f28","d313cec988a84645bee413e8d4724a4b",22902417,1,7,0,409,152,158,6
"d313cec988a84645bee413e8d4724a4b","d313cec988a84645bee413e8d4724a4b",22902417,3,0,1,410,158,158,0
"d313cec988a84645bee413e8d4724a4b","dc60696c76a74368a60f72246e47700d",22902417,1,1,0,413,158,159,1
"dc60696c76a74368a60f72246e47700d","dc60696c76a74368a60f72246e47700d",22902417,1,0,1,414,159,159,0
"dc60696c76a74368a60f72246e47700d","78adeee1fa2c4fe0bc73f7bca9fcee86",22902417,1,3,0,415,159,160,1
"78adeee1fa2c4fe0bc73f7bca9fcee86","df1de691dafe4549a18a4398ee9dfaf9",22902417,1,-26,0,416,160,139,-21
"df1de691dafe4549a18a4398ee9dfaf9","65202579580f4ad38d734b4ee39d22a8",22902417,1,31,0,417,139,164,25
"65202579580f4ad38d734b4ee39d22a8","65202579580f4ad38d734b4ee39d22a8",22902417,61,0,1,418,164,164,0
"65202579580f4ad38d734b4ee39d22a8","78adeee1fa2c4fe0bc73f7bca9fcee86",22902417,2,-5,0,421,164,160,-4
"78adeee1fa2c4fe0bc73f7bca9fcee86","65202579580f4ad38d734b4ee39d22a8",22902417,1,5,0,422,160,164,4
"65202579580f4ad38d734b4ee39d22a8","0c7262dff33c4087bc660ccf40f92f9c",22902417,1,12,0,461,164,169,5
"0c7262dff33c4087bc660ccf40f92f9c","b2275c3fad834f8d90737a2d9a6927d6",22902417,1,3,0,462,169,172,3
"b2275c3fad834f8d90737a2d9a6927d6","78adeee1fa2c4fe0bc73f7bca9fcee86",22902417,1,-20,0,463,172,160,-12
"78adeee1fa2c4fe0bc73f7bca9fcee86","78adeee1fa2c4fe0bc73f7bca9fcee86",22902417,2,0,1,464,160,160,0
"78adeee1fa2c4fe0bc73f7bca9fcee86","8959e6304a0348309a771e4d08d1b64a",22902417,1,4,0,466,160,163,3
"8959e6304a0348309a771e4d08d1b64a","65202579580f4ad38d734b4ee39d22a8",22902417,1,1,0,467,163,164,1
"78adeee1fa2c4fe0bc73f7bca9fcee86","3cbcea2be0984e7dbd5a48195af10ce7",22902417,1,8,0,489,160,165,5
"3cbcea2be0984e7dbd5a48195af10ce7","82e6285962b8400d9d6fc32436022a94",22902417,1,2,0,490,165,167,2
"82e6285962b8400d9d6fc32436022a94","a9ac840f098c4bd0a2ee896214ce29cd",22902417,1,3,0,491,167,168,1
"a9ac840f098c4bd0a2ee896214ce29cd","a9ac840f098c4bd0a2ee896214ce29cd",22902417,1,0,1,492,168,168,0
"a9ac840f098c4bd0a2ee896214ce29cd","0c7262dff33c4087bc660ccf40f92f9c",22902417,1,4,0,493,168,169,1
"0c7262dff33c4087bc660ccf40f92f9c","a9ac840f098c4bd0a2ee896214ce29cd",22902417,1,-4,0,494,169,168,-1
"a9ac840f098c4bd0a2ee896214ce29cd","b2275c3fad834f8d90737a2d9a6927d6",22902417,1,7,0,495,168,172,4
"b2275c3fad834f8d90737a2d9a6927d6","b2275c3fad834f8d90737a2d9a6927d6",22902417,37,0,1,496,172,172,0
"b2275c3fad834f8d90737a2d9a6927d6","eb515a26030b41f8a82a1e6114420bad",22902417,1,1,0,533,172,173,1
"eb515a26030b41f8a82a1e6114420bad","eb515a26030b41f8a82a1e6114420bad",22902417,2,0,1,534,173,173,0
"eb515a26030b41f8a82a1e6114420bad","b42cc17b7de840f181a704558d0bc845",22902417,1,3,0,536,173,175,2
"b42cc17b7de840f181a704558d0bc845","0c7262dff33c4087bc660ccf40f92f9c",22902417,1,-7,0,537,175,169,-6
"0c7262dff33c4087bc660ccf40f92f9c","b42cc17b7de840f181a704558d0bc845",22902417,1,7,0,538,169,175,6
"b42cc17b7de840f181a704558d0bc845","b42cc17b7de840f181a704558d0bc845",22902417,3,0,1,539,175,175,0
"b42cc17b7de840f181a704558d0bc845","801f9e9135034f49bf5f8b4bdefedb41",22902417,1,2,0,542,175,177,2
"801f9e9135034f49bf5f8b4bdefedb41","801f9e9135034f49bf5f8b4bdefedb41",22902417,9,0,1,543,177,177,0
"801f9e9135034f49bf5f8b4bdefedb41","362fcb0699a14845ab29b2340093e528",22902417,1,-3,0,552,177,174,-3
"362fcb0699a14845ab29b2340093e528","ea38cc0e6e6e41edbabf210220808bf9",22902417,1,6,0,553,174,179,5
"ea38cc0e6e6e41edbabf210220808bf9","b87c552dd247427abe6ab5795b9c9d43",22902417,2,2,0,554,179,181,2
"b87c552dd247427abe6ab5795b9c9d43","ea38cc0e6e6e41edbabf210220808bf9",22902417,1,-2,0,555,181,179,-2
"b87c552dd247427abe6ab5795b9c9d43","b87c552dd247427abe6ab5795b9c9d43",22902417,7,0,1,557,181,181,0
"b87c552dd247427abe6ab5795b9c9d43","139b097acfca451689d80c9c6eebdf7b",22902417,1,-3,0,564,181,178,-3
"139b097acfca451689d80c9c6eebdf7b","30f660a1feb34582a739722532524f79",22902417,1,6,0,565,178,183,5
"30f660a1feb34582a739722532524f79","30f660a1feb34582a739722532524f79",22902417,10,0,1,566,183,183,0
"30f660a1feb34582a739722532524f79","2024b4885bd14338a39b7b509acbbd02",22902417,1,-1,0,576,183,182,-1
"2024b4885bd14338a39b7b509acbbd02","c3f63fe50d8e487c86bf8ef76c9cadd3",22902417,1,4,0,577,182,185,3
"c3f63fe50d8e487c86bf8ef76c9cadd3","c3f63fe50d8e487c86bf8ef76c9cadd3",22902417,1,0,1,578,185,185,0
"c3f63fe50d8e487c86bf8ef76c9cadd3","0c7262dff33c4087bc660ccf40f92f9c",22902417,1,-20,0,579,185,169,-16
"0c7262dff33c4087bc660ccf40f92f9c","c8e371568a0c4391b25796ae4e91952e",22902417,1,23,0,580,169,186,17
"c8e371568a0c4391b25796ae4e91952e","0c7262dff33c4087bc660ccf40f92f9c",22902417,1,-23,0,581,186,169,-17
"0c7262dff33c4087bc660ccf40f92f9c","362fcb0699a14845ab29b2340093e528",22902417,1,6,0,582,169,174,5
"362fcb0699a14845ab29b2340093e528","b42cc17b7de840f181a704558d0bc845",22902417,1,1,0,583,174,175,1
"b42cc17b7de840f181a704558d0bc845","ea38cc0e6e6e41edbabf210220808bf9",22902417,1,5,0,584,175,179,4
"ea38cc0e6e6e41edbabf210220808bf9","362fcb0699a14845ab29b2340093e528",22902417,1,-6,0,585,179,174,-5
"362fcb0699a14845ab29b2340093e528","b87c552dd247427abe6ab5795b9c9d43",22902417,1,8,0,586,174,181,7
"b87c552dd247427abe6ab5795b9c9d43","c8e371568a0c4391b25796ae4e91952e",22902417,1,9,0,587,181,186,5
"c8e371568a0c4391b25796ae4e91952e","c8e371568a0c4391b25796ae4e91952e",22902417,4,0,1,588,186,186,0
"c8e371568a0c4391b25796ae4e91952e","7d932b23e1c84326ae5aa4d3c0d813d1",22902417,1,2,0,589,186,188,2
"7d932b23e1c84326ae5aa4d3c0d813d1","7d932b23e1c84326ae5aa4d3c0d813d1",22902417,1,0,1,590,188,188,0
"7d932b23e1c84326ae5aa4d3c0d813d1","ab11d94c6c8948ea90b88f19d2cd502b",22902417,1,3,0,591,188,190,2
"ab11d94c6c8948ea90b88f19d2cd502b","c8e371568a0c4391b25796ae4e91952e",22902417,1,-5,0,592,190,186,-4
"c8e371568a0c4391b25796ae4e91952e","ab11d94c6c8948ea90b88f19d2cd502b",22902417,1,5,0,593,186,190,4
"ab11d94c6c8948ea90b88f19d2cd502b","ab11d94c6c8948ea90b88f19d2cd502b",22902417,1,0,1,594,190,190,0
"ab11d94c6c8948ea90b88f19d2cd502b","f992451ed6ad4e68bb9e68ad6be7c4be",22902417,1,2,0,595,190,192,2
"f992451ed6ad4e68bb9e68ad6be7c4be","f992451ed6ad4e68bb9e68ad6be7c4be",22902417,5,0,1,596,192,192,0
"f992451ed6ad4e68bb9e68ad6be7c4be","07b44a7a51e94c78b411c753fc39dab0",22902417,1,-3,0,601,192,189,-3
"07b44a7a51e94c78b411c753fc39dab0","6cd2dcaac46847d4a0bc53f296d90375",22902417,1,6,0,602,189,194,5
"6cd2dcaac46847d4a0bc53f296d90375","6cd2dcaac46847d4a0bc53f296d90375",22902417,1,0,1,603,194,194,0
"6cd2dcaac46847d4a0bc53f296d90375","2d2580c9411c4972909db508d6956a58",22902417,1,2,0,604,194,196,2
"2d2580c9411c4972909db508d6956a58","2d2580c9411c4972909db508d6956a58",22902417,8,0,1,605,196,196,0
"2d2580c9411c4972909db508d6956a58","5bddb3d9ed264f3984702f048c7e5340",22902417,1,1,0,613,196,197,1
"5bddb3d9ed264f3984702f048c7e5340","5bddb3d9ed264f3984702f048c7e5340",22902417,5,0,1,614,197,197,0
"5bddb3d9ed264f3984702f048c7e5340","d5e8e2bd12a2466b9d6d90855f0eb079",22902417,1,1,0,619,197,198,1
"d5e8e2bd12a2466b9d6d90855f0eb079","d5e8e2bd12a2466b9d6d90855f0eb079",22902417,2,0,1,620,198,198,0
"d5e8e2bd12a2466b9d6d90855f0eb079","6cd2dcaac46847d4a0bc53f296d90375",22902417,1,-4,0,622,198,194,-4
"6cd2dcaac46847d4a0bc53f296d90375","017d7ca8e0394b91aaadc9574df2202c",22902417,1,-1,0,623,194,193,-1
"017d7ca8e0394b91aaadc9574df2202c","54e8e9f0ea3e45c4bf3b8ac799ee31b1",22902417,1,8,0,624,193,200,7
"54e8e9f0ea3e45c4bf3b8ac799ee31b1","54e8e9f0ea3e45c4bf3b8ac799ee31b1",22902417,1,0,1,625,200,200,0
"54e8e9f0ea3e45c4bf3b8ac799ee31b1","c614a00911be4877a075f19315530fb0",22902417,1,1,0,626,200,201,1
"c614a00911be4877a075f19315530fb0","c614a00911be4877a075f19315530fb0",22902417,6,0,1,627,201,201,0
"c614a00911be4877a075f19315530fb0","a6c21bd8b95249c7972820a7a7d76aff",22902417,1,1,0,633,201,202,1
"a6c21bd8b95249c7972820a7a7d76aff","a6c21bd8b95249c7972820a7a7d76aff",22902417,3,0,1,634,202,202,0
"a6c21bd8b95249c7972820a7a7d76aff","bb329d880ab54120adaf203a693bb203",22902417,1,1,0,637,202,203,1
"bb329d880ab54120adaf203a693bb203","bb329d880ab54120adaf203a693bb203",22902417,3,0,1,638,203,203,0
"bb329d880ab54120adaf203a693bb203","f9170dd6bc6442b4acd832747609b09a",22902417,1,-4,0,641,203,199,-4
"f9170dd6bc6442b4acd832747609b09a","c8e371568a0c4391b25796ae4e91952e",22902417,1,-16,0,642,199,186,-13
"c8e371568a0c4391b25796ae4e91952e","f9170dd6bc6442b4acd832747609b09a",22902417,1,16,0,645,186,199,13
"f9170dd6bc6442b4acd832747609b09a","b54257a550b94ebc9538f3a90eee9d7e",22902417,1,6,0,646,199,204,5
"b54257a550b94ebc9538f3a90eee9d7e","b54257a550b94ebc9538f3a90eee9d7e",22902417,3,0,1,647,204,204,0
"b54257a550b94ebc9538f3a90eee9d7e","6cd2dcaac46847d4a0bc53f296d90375",22902417,1,-12,0,649,204,194,-10
"6cd2dcaac46847d4a0bc53f296d90375","b54257a550b94ebc9538f3a90eee9d7e",22902417,1,12,0,650,194,204,10
"b54257a550b94ebc9538f3a90eee9d7e","017d7ca8e0394b91aaadc9574df2202c",22902417,1,-13,0,651,204,193,-11
"017d7ca8e0394b91aaadc9574df2202c","c8e371568a0c4391b25796ae4e91952e",22902417,1,-9,0,652,193,186,-7
"c8e371568a0c4391b25796ae4e91952e","b54257a550b94ebc9538f3a90eee9d7e",22902417,1,22,0,654,186,204,18
"b54257a550b94ebc9538f3a90eee9d7e","f9170dd6bc6442b4acd832747609b09a",22902417,1,-6,0,656,204,199,-5
"f9170dd6bc6442b4acd832747609b09a","f9170dd6bc6442b4acd832747609b09a",22902417,1,0,1,657,199,199,0
"f9170dd6bc6442b4acd832747609b09a","334c2344009840079b1d0e1b7ce3d5a7",22902417,1,7,0,658,199,205,6
"334c2344009840079b1d0e1b7ce3d5a7","334c2344009840079b1d0e1b7ce3d5a7",22902417,1,0,1,659,205,205,0
"334c2344009840079b1d0e1b7ce3d5a7","c8e371568a0c4391b25796ae4e91952e",22902417,1,-23,0,660,205,186,-19
"c8e371568a0c4391b25796ae4e91952e","d7f13c8d63ec4e2aa673fbb9cf9c6933",22902417,1,26,0,661,186,206,20
"d7f13c8d63ec4e2aa673fbb9cf9c6933","d7f13c8d63ec4e2aa673fbb9cf9c6933",22902417,1,0,1,662,206,206,0
"d7f13c8d63ec4e2aa673fbb9cf9c6933","c8e371568a0c4391b25796ae4e91952e",22902417,1,-26,0,663,206,186,-20
"c8e371568a0c4391b25796ae4e91952e","b9e80f77c3a44349863b19875725c384",22902417,1,27,0,664,186,207,21
"b9e80f77c3a44349863b19875725c384","7108f0e4c2584f1f9c471689ae4c885c",22902417,2,1,0,665,207,208,1
"7108f0e4c2584f1f9c471689ae4c885c","b9e80f77c3a44349863b19875725c384",22902417,1,-1,0,666,208,207,-1
"b9e80f77c3a44349863b19875725c384","b9e80f77c3a44349863b19875725c384",22902417,15,0,1,667,207,207,0
"7108f0e4c2584f1f9c471689ae4c885c","7108f0e4c2584f1f9c471689ae4c885c",22902417,10,0,1,683,208,208,0
"7108f0e4c2584f1f9c471689ae4c885c","d7f13c8d63ec4e2aa673fbb9cf9c6933",22902417,1,-2,0,693,208,206,-2
"d7f13c8d63ec4e2aa673fbb9cf9c6933","09400e101c5d4b439cf9a26b03aae558",22902417,1,5,0,694,206,210,4
"09400e101c5d4b439cf9a26b03aae558","09400e101c5d4b439cf9a26b03aae558",22902417,1,0,1,695,210,210,0
"09400e101c5d4b439cf9a26b03aae558","a88efa7e50ce47159810ab553afa6d3a",22902417,1,2,0,696,210,212,2
"a88efa7e50ce47159810ab553afa6d3a","a88efa7e50ce47159810ab553afa6d3a",22902417,5,0,1,697,212,212,0
"a88efa7e50ce47159810ab553afa6d3a","be502a7a43c44bf7b682698de79d9369",22902417,1,3,0,702,212,214,2
"be502a7a43c44bf7b682698de79d9369","a875096404ef4a9984b62d74cda916f9",22902417,1,-6,0,703,214,209,-5
"a875096404ef4a9984b62d74cda916f9","f7fb1952f56b4189b86a9f8b7862d2b8",22902417,1,7,0,704,209,215,6
"f7fb1952f56b4189b86a9f8b7862d2b8","be502a7a43c44bf7b682698de79d9369",22902417,1,-1,0,705,215,214,-1
"be502a7a43c44bf7b682698de79d9369","f7fb1952f56b4189b86a9f8b7862d2b8",22902417,1,1,0,706,214,215,1
"f7fb1952f56b4189b86a9f8b7862d2b8","f7fb1952f56b4189b86a9f8b7862d2b8",22902417,16,0,1,707,215,215,0
"f7fb1952f56b4189b86a9f8b7862d2b8","b860ee85d8bc4a2f97958cfb71be3533",22902417,1,1,0,723,215,216,1
"b860ee85d8bc4a2f97958cfb71be3533","b860ee85d8bc4a2f97958cfb71be3533",22902417,2,0,1,724,216,216,0
"b860ee85d8bc4a2f97958cfb71be3533","ec341f459285443b8361f7f15638ff08",22902417,1,-3,0,726,216,213,-3
"ec341f459285443b8361f7f15638ff08","363837c182e04711840d896ae1e0339c",22902417,1,6,0,727,213,218,5
"363837c182e04711840d896ae1e0339c","363837c182e04711840d896ae1e0339c",22902417,22,0,1,728,218,218,0
"363837c182e04711840d896ae1e0339c","01b2051f8941460d89945e3b02d1ce78",22902417,1,-1,0,750,218,217,-1
"01b2051f8941460d89945e3b02d1ce78","91125ca626c5470eb145501f8c37f8db",22902417,1,4,0,751,217,220,3
"91125ca626c5470eb145501f8c37f8db","91125ca626c5470eb145501f8c37f8db",22902417,1,0,1,752,220,220,0
"91125ca626c5470eb145501f8c37f8db","1c6721b1f63f4d30ba7746ea8af02a52",22902417,1,3,0,753,220,221,1
"1c6721b1f63f4d30ba7746ea8af02a52","d7f13c8d63ec4e2aa673fbb9cf9c6933",22902417,1,-21,0,754,221,206,-15
"d7f13c8d63ec4e2aa673fbb9cf9c6933","77ecef8eff6b4a2caea7707669bf7475",22902417,1,22,0,755,206,222,16
"77ecef8eff6b4a2caea7707669bf7475","77ecef8eff6b4a2caea7707669bf7475",22902417,12,0,1,756,222,222,0
"77ecef8eff6b4a2caea7707669bf7475","1c6721b1f63f4d30ba7746ea8af02a52",22902417,1,-1,0,768,222,221,-1
"1c6721b1f63f4d30ba7746ea8af02a52","d03cb855c70044cf8c35d9ec0de696e3",22902417,1,4,0,769,221,224,3
"d03cb855c70044cf8c35d9ec0de696e3","8b9ae98743bd4d4a8a87dff1c1244211",22902417,1,3,0,770,224,227,3
"8b9ae98743bd4d4a8a87dff1c1244211","d03cb855c70044cf8c35d9ec0de696e3",22902417,1,-3,0,771,227,224,-3
"d03cb855c70044cf8c35d9ec0de696e3","a49a937d6896486d9a5396654abcf2e1",22902417,1,2,0,772,224,226,2
"a49a937d6896486d9a5396654abcf2e1","a49a937d6896486d9a5396654abcf2e1",22902417,3,0,1,773,226,226,0
"a49a937d6896486d9a5396654abcf2e1","8b9ae98743bd4d4a8a87dff1c1244211",22902417,1,1,0,776,226,227,1
"8b9ae98743bd4d4a8a87dff1c1244211","8b9ae98743bd4d4a8a87dff1c1244211",22902417,26,0,1,777,227,227,0
"8b9ae98743bd4d4a8a87dff1c1244211","f7906d6f59b9489a91d2ef40db5a474d",22902417,1,-4,0,803,227,223,-4
"f7906d6f59b9489a91d2ef40db5a474d","2ab1535aac1346ba8801535bf729ef37",22902417,1,7,0,804,223,229,6
"2ab1535aac1346ba8801535bf729ef37","2ab1535aac1346ba8801535bf729ef37",22902417,4,0,1,805,229,229,0
"2ab1535aac1346ba8801535bf729ef37","a4f40fb48a8542c8949bae1f002cd9bc",22902417,1,2,0,809,229,231,2
"a4f40fb48a8542c8949bae1f002cd9bc","a4f40fb48a8542c8949bae1f002cd9bc",22902417,2,0,1,810,231,231,0
"a4f40fb48a8542c8949bae1f002cd9bc","8972c23e32044edb8a78fa1eed4e5947",22902417,1,1,0,812,231,232,1
"8972c23e32044edb8a78fa1eed4e5947","8972c23e32044edb8a78fa1eed4e5947",22902417,1,0,1,813,232,232,0
"8972c23e32044edb8a78fa1eed4e5947","92feb4a40f8344d38b6f722e42a53295",22902417,1,1,0,814,232,233,1
"92feb4a40f8344d38b6f722e42a53295","92feb4a40f8344d38b6f722e42a53295",22902417,2,0,1,815,233,233,0
"92feb4a40f8344d38b6f722e42a53295","5152833676bf4c6cb317060be10f68db",22902417,1,-5,0,817,233,228,-5
"5152833676bf4c6cb317060be10f68db","ca3e28f290354c08aefe5b0f769604e6",22902417,1,8,0,818,228,235,7
"ca3e28f290354c08aefe5b0f769604e6","ca3e28f290354c08aefe5b0f769604e6",22902417,4,0,1,819,235,235,0
"ca3e28f290354c08aefe5b0f769604e6","79a35eea833e4c2c9d22fc53c3c6445c",22902417,1,1,0,823,235,236,1
"79a35eea833e4c2c9d22fc53c3c6445c","79a35eea833e4c2c9d22fc53c3c6445c",22902417,9,0,1,824,236,236,0
"79a35eea833e4c2c9d22fc53c3c6445c","8f68228b1518449e9615cdafee41a2bd",22902417,1,1,0,833,236,237,1
"8f68228b1518449e9615cdafee41a2bd","8f68228b1518449e9615cdafee41a2bd",22902417,1,0,1,834,237,237,0
"8f68228b1518449e9615cdafee41a2bd","cab89fa5c3ed45a5aa550fc0352d6a42",22902417,1,1,0,835,237,238,1
"cab89fa5c3ed45a5aa550fc0352d6a42","cab89fa5c3ed45a5aa550fc0352d6a42",22902417,1,0,1,836,238,238,0
"cab89fa5c3ed45a5aa550fc0352d6a42","66d4fad4f1cf4b46be0750a99ad7a35a",22902417,1,1,0,837,238,239,1
"66d4fad4f1cf4b46be0750a99ad7a35a","66d4fad4f1cf4b46be0750a99ad7a35a",22902417,1,0,1,838,239,239,0
"66d4fad4f1cf4b46be0750a99ad7a35a","0b04c8e2f86d48c7aeb7e225819cd32b",22902417,1,-5,0,839,239,234,-5
"0b04c8e2f86d48c7aeb7e225819cd32b","f53da5fd9bfe412da4b80d4742563b6c",22902417,1,8,0,840,234,241,7
"f53da5fd9bfe412da4b80d4742563b6c","f53da5fd9bfe412da4b80d4742563b6c",22902417,1,0,1,841,241,241,0
"f53da5fd9bfe412da4b80d4742563b6c","2ae94c0cea4d480a9d5dca8fb1d7b542",22902417,1,3,0,842,241,242,1
"2ae94c0cea4d480a9d5dca8fb1d7b542","1c6721b1f63f4d30ba7746ea8af02a52",22902417,1,-27,0,843,242,221,-21
"1c6721b1f63f4d30ba7746ea8af02a52","1ebf23f9d994469a85206e4c7b1bf5f5",22902417,1,30,0,844,221,245,24
"1ebf23f9d994469a85206e4c7b1bf5f5","2ae94c0cea4d480a9d5dca8fb1d7b542",22902417,2,-3,0,845,245,242,-3
"2ae94c0cea4d480a9d5dca8fb1d7b542","1ebf23f9d994469a85206e4c7b1bf5f5",22902417,2,3,0,846,242,245,3
"1ebf23f9d994469a85206e4c7b1bf5f5","1ebf23f9d994469a85206e4c7b1bf5f5",22902417,10,0,1,847,245,245,0
"1ebf23f9d994469a85206e4c7b1bf5f5","85ae675b83e8422da842cfd25596af99",22902417,1,1,0,857,245,246,1
"85ae675b83e8422da842cfd25596af99","85ae675b83e8422da842cfd25596af99",22902417,1,0,1,858,246,246,0
"85ae675b83e8422da842cfd25596af99","2ae94c0cea4d480a9d5dca8fb1d7b542",22902417,1,-4,0,859,246,242,-4
"2ae94c0cea4d480a9d5dca8fb1d7b542","30c9ba177afc49a695625d2bdec40207",22902417,1,9,0,860,242,250,8
"30c9ba177afc49a695625d2bdec40207","30c9ba177afc49a695625d2bdec40207",22902417,2,0,1,861,250,250,0
"30c9ba177afc49a695625d2bdec40207","6e83e23f56544a19b94067c1c558d9c0",22902417,1,-3,0,863,250,247,-3
"6e83e23f56544a19b94067c1c558d9c0","00f61990949545828dd12f1303d47504",22902417,1,11,0,864,247,256,9
"00f61990949545828dd12f1303d47504","00f61990949545828dd12f1303d47504",22902417,1,0,1,865,256,256,0
"00f61990949545828dd12f1303d47504","ead7bb4b64e247d2ae632ab8a296b091",22902417,1,2,0,866,256,258,2
"ead7bb4b64e247d2ae632ab8a296b091","ead7bb4b64e247d2ae632ab8a296b091",22902417,2,0,1,867,258,258,0
"ead7bb4b64e247d2ae632ab8a296b091","41b0048dde734bb280bac6116baa8e27",22902417,1,1,0,869,258,259,1
"41b0048dde734bb280bac6116baa8e27","41b0048dde734bb280bac6116baa8e27",22902417,2,0,1,870,259,259,0
"41b0048dde734bb280bac6116baa8e27","b41c5a094a604ee0915327da5cc0beb7",22902417,1,1,0,872,259,260,1
"b41c5a094a604ee0915327da5cc0beb7","b41c5a094a604ee0915327da5cc0beb7",22902417,2,0,1,873,260,260,0
"b41c5a094a604ee0915327da5cc0beb7","d546341988904f069cfa86b21457d9d9",22902417,1,-10,0,875,260,251,-9
"d546341988904f069cfa86b21457d9d9","28c171777c52431ab6b925073bd63d46",22902417,1,15,0,876,251,264,13
"28c171777c52431ab6b925073bd63d46","28c171777c52431ab6b925073bd63d46",22902417,3,0,1,877,264,264,0
"28c171777c52431ab6b925073bd63d46","ac160db940cb49ae8579162b1d52bb5d",22902417,1,2,0,880,264,266,2
"ac160db940cb49ae8579162b1d52bb5d","ac160db940cb49ae8579162b1d52bb5d",22902417,7,0,1,881,266,266,0
"ac160db940cb49ae8579162b1d52bb5d","d989ebcfc12a4b669f0100dc1aa14f1e",22902417,1,-12,0,888,266,255,-11
"d989ebcfc12a4b669f0100dc1aa14f1e","c6fd49b485cc4874b0bbdd9c6171e09c",22902417,1,15,0,889,255,268,13
"c6fd49b485cc4874b0bbdd9c6171e09c","c6fd49b485cc4874b0bbdd9c6171e09c",22902417,7,0,1,890,268,268,0
"c6fd49b485cc4874b0bbdd9c6171e09c","44240778a97c4af0937817499b75707b",22902417,1,1,0,897,268,269,1
"44240778a97c4af0937817499b75707b","44240778a97c4af0937817499b75707b",22902417,2,0,1,898,269,269,0
"44240778a97c4af0937817499b75707b","7aa76d3e993840d8805f097cbdbcd44b",22902417,1,-9,0,900,269,261,-8
"7aa76d3e993840d8805f097cbdbcd44b","865a4d3b43374da7944dc7d397f566d9",22902417,1,12,0,901,261,271,10
"865a4d3b43374da7944dc7d397f566d9","865a4d3b43374da7944dc7d397f566d9",22902417,1,0,1,902,271,271,0
"865a4d3b43374da7944dc7d397f566d9","2ae94c0cea4d480a9d5dca8fb1d7b542",22902417,1,-35,0,903,271,242,-29
"2ae94c0cea4d480a9d5dca8fb1d7b542","0d987bed3ffa4ed0b9a2e62e97b7b30f",22902417,2,38,0,904,242,272,30
"0d987bed3ffa4ed0b9a2e62e97b7b30f","0d987bed3ffa4ed0b9a2e62e97b7b30f",22902417,2,0,1,905,272,272,0
"0d987bed3ffa4ed0b9a2e62e97b7b30f","82ae07bc0c9b4570a41799290d1ef399",22902417,2,4,0,906,272,275,3
"82ae07bc0c9b4570a41799290d1ef399","2ae94c0cea4d480a9d5dca8fb1d7b542",22902417,1,-42,0,907,275,242,-33
"2ae94c0cea4d480a9d5dca8fb1d7b542","00f61990949545828dd12f1303d47504",22902417,1,17,0,910,242,256,14
"00f61990949545828dd12f1303d47504","6e83e23f56544a19b94067c1c558d9c0",22902417,1,-11,0,911,256,247,-9
"6e83e23f56544a19b94067c1c558d9c0","d546341988904f069cfa86b21457d9d9",22902417,1,5,0,912,247,251,4
"d546341988904f069cfa86b21457d9d9","d989ebcfc12a4b669f0100dc1aa14f1e",22902417,1,5,0,913,251,255,4
"d989ebcfc12a4b669f0100dc1aa14f1e","7aa76d3e993840d8805f097cbdbcd44b",22902417,1,7,0,914,255,261,6
"7aa76d3e993840d8805f097cbdbcd44b","2ae94c0cea4d480a9d5dca8fb1d7b542",22902417,1,-23,0,915,261,242,-19
"0d987bed3ffa4ed0b9a2e62e97b7b30f","bb5a47f5ea01454a8b79455422d3b9da",22902417,1,10,0,918,272,280,8
"bb5a47f5ea01454a8b79455422d3b9da","82ae07bc0c9b4570a41799290d1ef399",22902417,1,-6,0,919,280,275,-5
"82ae07bc0c9b4570a41799290d1ef399","bb5a47f5ea01454a8b79455422d3b9da",22902417,2,6,0,920,275,280,5
"bb5a47f5ea01454a8b79455422d3b9da","bb5a47f5ea01454a8b79455422d3b9da",22902417,63,0,1,921,280,280,0
"bb5a47f5ea01454a8b79455422d3b9da","bc5524e78a8544e2ae2fdc2f3462bbec",22902417,1,-1,0,927,280,279,-1
"bc5524e78a8544e2ae2fdc2f3462bbec","82ae07bc0c9b4570a41799290d1ef399",22902417,1,-5,0,928,279,275,-4
"82ae07bc0c9b4570a41799290d1ef399","0d987bed3ffa4ed0b9a2e62e97b7b30f",22902417,1,-4,0,929,275,272,-3
"bb5a47f5ea01454a8b79455422d3b9da","94cecc3f1e7d484b8e068e79241dfd73",22902417,1,3,0,989,280,281,1
"94cecc3f1e7d484b8e068e79241dfd73","0d987bed3ffa4ed0b9a2e62e97b7b30f",22902417,1,-13,0,990,281,272,-9
"0d987bed3ffa4ed0b9a2e62e97b7b30f","a37477c4e4c14169ad44b06b493007f6",22902417,1,15,0,991,272,283,11
"a37477c4e4c14169ad44b06b493007f6","94cecc3f1e7d484b8e068e79241dfd73",22902417,1,-2,0,992,283,281,-2
"94cecc3f1e7d484b8e068e79241dfd73","fab84b4fab5940efb4ea868ef8d09396",22902417,1,5,0,993,281,284,3
"fab84b4fab5940efb4ea868ef8d09396","4a29443515bb404cb8924e1c60a63b73",22902417,1,4,0,994,284,285,1
"4a29443515bb404cb8924e1c60a63b73","fab84b4fab5940efb4ea868ef8d09396",22902417,1,-4,0,995,285,284,-1
"fab84b4fab5940efb4ea868ef8d09396","208c9b2796c944db8dacaa96082520ea",22902417,1,7,0,996,284,288,4
"208c9b2796c944db8dacaa96082520ea","208c9b2796c944db8dacaa96082520ea",22902417,1,0,1,997,288,288,0
"208c9b2796c944db8dacaa96082520ea","4a29443515bb404cb8924e1c60a63b73",22902417,1,-3,0,998,288,285,-3
"4a29443515bb404cb8924e1c60a63b73","7669a956527947d0add87455277e80b4",22902417,1,7,0,999,285,291,6
"7669a956527947d0add87455277e80b4","7669a956527947d0add87455277e80b4",22902417,1,0,1,1000,291,291,0
"7669a956527947d0add87455277e80b4","6a9a3b5bde4a48daa896fe8c06eca56f",22902417,1,-2,0,1001,291,289,-2
"6a9a3b5bde4a48daa896fe8c06eca56f","869e967078f04da18dd0b0b9389a7424",22902417,1,5,0,1002,289,293,4
"869e967078f04da18dd0b0b9389a7424","869e967078f04da18dd0b0b9389a7424",22902417,1,0,1,1003,293,293,0
"869e967078f04da18dd0b0b9389a7424","51ab6291537748fab90d519aa09889d6",22902417,1,2,0,1004,293,295,2
"51ab6291537748fab90d519aa09889d6","51ab6291537748fab90d519aa09889d6",22902417,11,0,1,1005,295,295,0
"51ab6291537748fab90d519aa09889d6","34a6e49023fc4465bd5ca604330bbd1c",22902417,1,-3,0,1016,295,292,-3
"34a6e49023fc4465bd5ca604330bbd1c","21592f2a9e9c4b2f8c66ec5dbcbf6a2b",22902417,1,5,0,1017,292,296,4
"21592f2a9e9c4b2f8c66ec5dbcbf6a2b","ba0e59461bfb4a44b7b1c28a01f8d3b3",22902417,1,4,0,1018,296,299,3
"ba0e59461bfb4a44b7b1c28a01f8d3b3","ba0e59461bfb4a44b7b1c28a01f8d3b3",22902417,2,0,1,1019,299,299,0
"ba0e59461bfb4a44b7b1c28a01f8d3b3","0e0b36e731a645e7b1b8a88f5031ca38",22902417,1,2,0,1021,299,301,2
"0e0b36e731a645e7b1b8a88f5031ca38","0e0b36e731a645e7b1b8a88f5031ca38",22902417,2,0,1,1022,301,301,0
"0e0b36e731a645e7b1b8a88f5031ca38","a66a144637284c21afc6de17fea4bfb8",22902417,1,1,0,1024,301,302,1
"a66a144637284c21afc6de17fea4bfb8","a66a144637284c21afc6de17fea4bfb8",22902417,2,0,1,1025,302,302,0
"a66a144637284c21afc6de17fea4bfb8","7646a919d7e64fa990bca9b024ff089d",22902417,1,-4,0,1027,302,298,-4
"7646a919d7e64fa990bca9b024ff089d","e390b575229748ea8aac9364efe2bf00",22902417,1,7,0,1028,298,304,6
"e390b575229748ea8aac9364efe2bf00","e390b575229748ea8aac9364efe2bf00",22902417,1,0,1,1029,304,304,0
"e390b575229748ea8aac9364efe2bf00","4a29443515bb404cb8924e1c60a63b73",22902417,1,-24,0,1030,304,285,-19
"4a29443515bb404cb8924e1c60a63b73","3434c10e561d488a914e0f7d71907abd",22902417,1,27,0,1031,285,305,20
"3434c10e561d488a914e0f7d71907abd","53e7e900392747ccad52e711ab0f80d8",22902417,1,2,0,1032,305,307,2
"53e7e900392747ccad52e711ab0f80d8","53e7e900392747ccad52e711ab0f80d8",22902417,2,0,1,1033,307,307,0
"53e7e900392747ccad52e711ab0f80d8","3434c10e561d488a914e0f7d71907abd",22902417,1,-2,0,1035,307,305,-2
"3434c10e561d488a914e0f7d71907abd","130acc2aeb0448fdbb2de63bc5cebe5b",22902417,1,5,0,1036,305,309,4
"130acc2aeb0448fdbb2de63bc5cebe5b","130acc2aeb0448fdbb2de63bc5cebe5b",22902417,1,0,1,1037,309,309,0
"130acc2aeb0448fdbb2de63bc5cebe5b","9c062b3251034ebe90f5054e2a3b5120",22902417,1,2,0,1038,309,311,2
"9c062b3251034ebe90f5054e2a3b5120","9c062b3251034ebe90f5054e2a3b5120",22902417,2,0,1,1039,311,311,0
"9c062b3251034ebe90f5054e2a3b5120","ea859f8207e44537889daeaba13ac2e8",22902417,1,1,0,1041,311,312,1
"ea859f8207e44537889daeaba13ac2e8","ea859f8207e44537889daeaba13ac2e8",22902417,1,0,1,1042,312,312,0
"ea859f8207e44537889daeaba13ac2e8","56d94971a7a94257aa330183a8ebd0ea",22902417,1,1,0,1043,312,313,1
"56d94971a7a94257aa330183a8ebd0ea","56d94971a7a94257aa330183a8ebd0ea",22902417,1,0,1,1044,313,313,0
"56d94971a7a94257aa330183a8ebd0ea","141c0df6cd1946539aadd1c9b7068cd4",22902417,1,-5,0,1045,313,308,-5
"141c0df6cd1946539aadd1c9b7068cd4","13255e63e0aa4abf85e5211bf613d43e",22902417,1,10,0,1046,308,317,9
"13255e63e0aa4abf85e5211bf613d43e","13255e63e0aa4abf85e5211bf613d43e",22902417,3,0,1,1047,317,317,0
"13255e63e0aa4abf85e5211bf613d43e","0c787d16c9504873b1a4d903cec09948",22902417,1,-3,0,1050,317,314,-3
"0c787d16c9504873b1a4d903cec09948","86c27d40179e419c8e9d150fb6afa5d0",22902417,1,6,0,1051,314,319,5
"86c27d40179e419c8e9d150fb6afa5d0","86c27d40179e419c8e9d150fb6afa5d0",22902417,1,0,1,1052,319,319,0
"86c27d40179e419c8e9d150fb6afa5d0","47edbb64109243e6b0f8f64cdef90c6c",22902417,1,8,0,1053,319,326,7
"47edbb64109243e6b0f8f64cdef90c6c","8d7e0b55cf9849cda222a0f2440cec55",22902417,1,-9,0,1054,326,318,-8
"8d7e0b55cf9849cda222a0f2440cec55","24f1363179ad4aaa965484a78471912b",22902417,1,6,0,1055,318,323,5
"24f1363179ad4aaa965484a78471912b","24f1363179ad4aaa965484a78471912b",22902417,1,0,1,1056,323,323,0
"24f1363179ad4aaa965484a78471912b","3628bdce1dd2429ba924d2d4d09448d2",22902417,1,-1,0,1057,323,322,-1
"3628bdce1dd2429ba924d2d4d09448d2","56b3fd1a212a4764be39d979fde3326e",22902417,1,7,0,1058,322,328,6
"56b3fd1a212a4764be39d979fde3326e","56b3fd1a212a4764be39d979fde3326e",22902417,1,0,1,1059,328,328,0
"56b3fd1a212a4764be39d979fde3326e","3434c10e561d488a914e0f7d71907abd",22902417,1,-28,0,1060,328,305,-23
"3434c10e561d488a914e0f7d71907abd","0c4079457ede49e3aeb5e86ed84bdf35",22902417,1,31,0,1061,305,329,24
"0c4079457ede49e3aeb5e86ed84bdf35","38aea304b4fa46e1b29bb72f5cea4c93",22902417,1,2,0,1062,329,331,2
"38aea304b4fa46e1b29bb72f5cea4c93","38aea304b4fa46e1b29bb72f5cea4c93",22902417,4,0,1,1063,331,331,0
"38aea304b4fa46e1b29bb72f5cea4c93","e36d261332f14e79bb4b467aceaeb9b5",22902417,1,2,0,1067,331,333,2
"e36d261332f14e79bb4b467aceaeb9b5","e36d261332f14e79bb4b467aceaeb9b5",22902417,1,0,1,1068,333,333,0
"e36d261332f14e79bb4b467aceaeb9b5","c7e89b9d04744d2eab742fc24e3ef1ae",22902417,1,1,0,1069,333,334,1
"c7e89b9d04744d2eab742fc24e3ef1ae","c7e89b9d04744d2eab742fc24e3ef1ae",22902417,2,0,1,1070,334,334,0
"c7e89b9d04744d2eab742fc24e3ef1ae","fe49f8054b374a0ea4bb266ed135ff62",22902417,1,1,0,1072,334,335,1
"fe49f8054b374a0ea4bb266ed135ff62","fe49f8054b374a0ea4bb266ed135ff62",22902417,5,0,1,1073,335,335,0
"fe49f8054b374a0ea4bb266ed135ff62","d0a8f74af98642fe8360d22c42e45117",22902417,1,1,0,1078,335,336,1
"d0a8f74af98642fe8360d22c42e45117","d0a8f74af98642fe8360d22c42e45117",22902417,2,0,1,1079,336,336,0
"d0a8f74af98642fe8360d22c42e45117","0c4079457ede49e3aeb5e86ed84bdf35",22902417,1,-7,0,1081,336,329,-7
"0c4079457ede49e3aeb5e86ed84bdf35","a7c6339ca1da4368a18d471f0519f877",22902417,1,11,0,1082,329,339,10
"a7c6339ca1da4368a18d471f0519f877","a7c6339ca1da4368a18d471f0519f877",22902417,1,0,1,1083,339,339,0
"a7c6339ca1da4368a18d471f0519f877","b8b9418ab322418d9db9b40d96af873a",22902417,1,-2,0,1084,339,337,-2
"b8b9418ab322418d9db9b40d96af873a","bbc5139ca9024389a94db3a6f47dcff6",22902417,1,5,0,1085,337,341,4
"bbc5139ca9024389a94db3a6f47dcff6","bbc5139ca9024389a94db3a6f47dcff6",22902417,1,0,1,1086,341,341,0
"bbc5139ca9024389a94db3a6f47dcff6","4ee6ca9019ab4a1ab323f98094a9bd77",22902417,1,2,0,1087,341,343,2
"4ee6ca9019ab4a1ab323f98094a9bd77","4ee6ca9019ab4a1ab323f98094a9bd77",22902417,2,0,1,1088,343,343,0
"4ee6ca9019ab4a1ab323f98094a9bd77","b37947176785476f8b29d49a851366dc",22902417,1,1,0,1090,343,344,1
"b37947176785476f8b29d49a851366dc","b37947176785476f8b29d49a851366dc",22902417,2,0,1,1091,344,344,0
"b37947176785476f8b29d49a851366dc","fcea5b10d5a14a3b9324ffece8f6e1e5",22902417,1,1,0,1093,344,345,1
"fcea5b10d5a14a3b9324ffece8f6e1e5","fcea5b10d5a14a3b9324ffece8f6e1e5",22902417,2,0,1,1094,345,345,0
"fcea5b10d5a14a3b9324ffece8f6e1e5","c2490bc612d146edbe786556fab3651b",22902417,1,-5,0,1096,345,340,-5
"c2490bc612d146edbe786556fab3651b","6ac8bb048b854999a47edb35fe627f11",22902417,1,8,0,1097,340,347,7
"6ac8bb048b854999a47edb35fe627f11","6ac8bb048b854999a47edb35fe627f11",22902417,1,0,1,1098,347,347,0
"6ac8bb048b854999a47edb35fe627f11","0c4079457ede49e3aeb5e86ed84bdf35",22902417,1,-21,0,1099,347,329,-18
"0c4079457ede49e3aeb5e86ed84bdf35","30ead9794d4847abaf222ca966cc8630",22902417,1,24,0,1100,329,348,19
"30ead9794d4847abaf222ca966cc8630","09b9678ddc3d452ea4a3d46e15826065",22902417,1,5,0,1101,348,353,5
"09b9678ddc3d452ea4a3d46e15826065","c20993c944444fe085345591a8bd837e",22902417,1,-2,0,1102,353,351,-2
"c20993c944444fe085345591a8bd837e","897b7f51242c44aab2205c72fdcbf4cd",22902417,2,1,0,1103,351,352,1
"897b7f51242c44aab2205c72fdcbf4cd","eff0de7f2dbb42dfa1a2e686efab5b6d",22902417,1,2,0,1104,352,354,2
"eff0de7f2dbb42dfa1a2e686efab5b6d","c20993c944444fe085345591a8bd837e",22902417,1,-3,0,1105,354,351,-3
"c20993c944444fe085345591a8bd837e","c20993c944444fe085345591a8bd837e",22902417,3,0,1,1106,351,351,0
"897b7f51242c44aab2205c72fdcbf4cd","897b7f51242c44aab2205c72fdcbf4cd",22902417,3,0,1,1110,352,352,0
"897b7f51242c44aab2205c72fdcbf4cd","09b9678ddc3d452ea4a3d46e15826065",22902417,1,1,0,1113,352,353,1
"09b9678ddc3d452ea4a3d46e15826065","09b9678ddc3d452ea4a3d46e15826065",22902417,3,0,1,1114,353,353,0
"09b9678ddc3d452ea4a3d46e15826065","eff0de7f2dbb42dfa1a2e686efab5b6d",22902417,1,1,0,1117,353,354,1
"eff0de7f2dbb42dfa1a2e686efab5b6d","eff0de7f2dbb42dfa1a2e686efab5b6d",22902417,3,0,1,1118,354,354,0
"eff0de7f2dbb42dfa1a2e686efab5b6d","30ead9794d4847abaf222ca966cc8630",22902417,1,-6,0,1121,354,348,-6
"30ead9794d4847abaf222ca966cc8630","2fe14166dc9642c3bc666b86a57f943d",22902417,1,10,0,1122,348,357,9
"2fe14166dc9642c3bc666b86a57f943d","2fe14166dc9642c3bc666b86a57f943d",22902417,1,0,1,1123,357,357,0
"2fe14166dc9642c3bc666b86a57f943d","44421dd1e13a47a388c4a19834b744c7",22902417,1,2,0,1124,357,359,2
"44421dd1e13a47a388c4a19834b744c7","44421dd1e13a47a388c4a19834b744c7",22902417,2,0,1,1125,359,359,0
"44421dd1e13a47a388c4a19834b744c7","cb5fc7ef85d547c4be1a7439d0bf6052",22902417,1,1,0,1127,359,360,1
"cb5fc7ef85d547c4be1a7439d0bf6052","cb5fc7ef85d547c4be1a7439d0bf6052",22902417,2,0,1,1128,360,360,0
"cb5fc7ef85d547c4be1a7439d0bf6052","0a8f150a4cf747acbde62f4721823da3",22902417,1,1,0,1130,360,361,1
"0a8f150a4cf747acbde62f4721823da3","0a8f150a4cf747acbde62f4721823da3",22902417,2,0,1,1131,361,361,0
"0a8f150a4cf747acbde62f4721823da3","ab8fdad974ae471f9f24c3f9dd04462e",22902417,1,1,0,1133,361,362,1
"ab8fdad974ae471f9f24c3f9dd04462e","ab8fdad974ae471f9f24c3f9dd04462e",22902417,2,0,1,1134,362,362,0
"ab8fdad974ae471f9f24c3f9dd04462e","52580888dadb4fe3baa795683ea227bd",22902417,1,3,0,1136,362,364,2
"52580888dadb4fe3baa795683ea227bd","1ba8fef685d74a8194b9db252eb704fb",22902417,1,-10,0,1137,364,355,-9
"1ba8fef685d74a8194b9db252eb704fb","52580888dadb4fe3baa795683ea227bd",22902417,1,10,0,1138,355,364,9
"52580888dadb4fe3baa795683ea227bd","52580888dadb4fe3baa795683ea227bd",22902417,1,0,1,1139,364,364,0
"52580888dadb4fe3baa795683ea227bd","f00179e251a045b39c3f7a54f9aa4acc",22902417,1,-1,0,1140,364,363,-1
"f00179e251a045b39c3f7a54f9aa4acc","492a3bc6a1254f23a7998587961b22a4",22902417,1,4,0,1141,363,366,3
"492a3bc6a1254f23a7998587961b22a4","492a3bc6a1254f23a7998587961b22a4",22902417,1,0,1,1142,366,366,0
"492a3bc6a1254f23a7998587961b22a4","072a190fd302456290895f9f04d6940a",22902417,1,-1,0,1143,366,365,-1
"072a190fd302456290895f9f04d6940a","cfa457d1743848e4bb5e4beced6448ed",22902417,1,5,0,1144,365,369,4
"cfa457d1743848e4bb5e4beced6448ed","cfa457d1743848e4bb5e4beced6448ed",22902417,1,0,1,1145,369,369,0
"cfa457d1743848e4bb5e4beced6448ed","30ead9794d4847abaf222ca966cc8630",22902417,1,-25,0,1146,369,348,-21
"30ead9794d4847abaf222ca966cc8630","b71bac264efb4abd97015447bd490db6",22902417,1,28,0,1147,348,370,22
"b71bac264efb4abd97015447bd490db6","8d448d625b024c82a5eb240bbd7431d6",22902417,2,5,0,1148,370,374,4
"8d448d625b024c82a5eb240bbd7431d6","b71bac264efb4abd97015447bd490db6",22902417,2,-5,0,1149,374,370,-4
"8d448d625b024c82a5eb240bbd7431d6","8d448d625b024c82a5eb240bbd7431d6",22902417,51,0,1,1151,374,374,0
"b71bac264efb4abd97015447bd490db6","d6d02b6ef04e4f17805504500b8ce441",22902417,1,8,0,1203,370,375,5
"d6d02b6ef04e4f17805504500b8ce441","d6d02b6ef04e4f17805504500b8ce441",22902417,2,0,1,1204,375,375,0
"d6d02b6ef04e4f17805504500b8ce441","66baf19b6b904b70922329068c63746d",22902417,1,4,0,1206,375,376,1
"66baf19b6b904b70922329068c63746d","7f544639412e40a9ba27f43b415362ab",22902417,2,2,0,1207,376,378,2
"7f544639412e40a9ba27f43b415362ab","66baf19b6b904b70922329068c63746d",22902417,1,-2,0,1208,378,376,-2
"66baf19b6b904b70922329068c63746d","66baf19b6b904b70922329068c63746d",22902417,1,0,1,1209,376,376,0
"7f544639412e40a9ba27f43b415362ab","7f544639412e40a9ba27f43b415362ab",22902417,1,0,1,1211,378,378,0
"7f544639412e40a9ba27f43b415362ab","d5ae8642e15b46b8bd298b02274d4e9c",22902417,1,2,0,1212,378,380,2
"d5ae8642e15b46b8bd298b02274d4e9c","d5ae8642e15b46b8bd298b02274d4e9c",22902417,1,0,1,1213,380,380,0
"d5ae8642e15b46b8bd298b02274d4e9c","a0d10309a2dd456289147f84be9d37f9",22902417,1,1,0,1214,380,381,1
"a0d10309a2dd456289147f84be9d37f9","a0d10309a2dd456289147f84be9d37f9",22902417,2,0,1,1215,381,381,0
"a0d10309a2dd456289147f84be9d37f9","0fcbc3ca07b144138b8d85da581f09a8",22902417,1,1,0,1217,381,382,1
"0fcbc3ca07b144138b8d85da581f09a8","0fcbc3ca07b144138b8d85da581f09a8",22902417,5,0,1,1218,382,382,0
"0fcbc3ca07b144138b8d85da581f09a8","66baf19b6b904b70922329068c63746d",22902417,1,-6,0,1223,382,376,-6
"66baf19b6b904b70922329068c63746d","4890121ce5d74576b4632b77cfc23398",22902417,1,14,0,1224,376,388,12
"4890121ce5d74576b4632b77cfc23398","c2fca3669923477ab966ded303dea31c",22902417,1,-6,0,1225,388,383,-5
"c2fca3669923477ab966ded303dea31c","4890121ce5d74576b4632b77cfc23398",22902417,1,6,0,1226,383,388,5
"4890121ce5d74576b4632b77cfc23398","96bb2b3e85a34d8b9544514e89f6fe97",22902417,1,3,0,1227,388,390,2
"96bb2b3e85a34d8b9544514e89f6fe97","18d3b836dd804224883cc9180b60a8e1",22902417,1,-4,0,1228,390,387,-3
"18d3b836dd804224883cc9180b60a8e1","96bb2b3e85a34d8b9544514e89f6fe97",22902417,1,4,0,1229,387,390,3
"96bb2b3e85a34d8b9544514e89f6fe97","ac4e9b54acfe4670b4634859c7263cb5",22902417,1,2,0,1230,390,392,2
"ac4e9b54acfe4670b4634859c7263cb5","ac4e9b54acfe4670b4634859c7263cb5",22902417,1,0,1,1231,392,392,0
"ac4e9b54acfe4670b4634859c7263cb5","17f95d18bab743888e1736033dc3384d",22902417,1,-3,0,1232,392,389,-3
"17f95d18bab743888e1736033dc3384d","6f8881a745ac4c358a68b92c3b4abe81",22902417,1,6,0,1233,389,394,5
"6f8881a745ac4c358a68b92c3b4abe81","6f8881a745ac4c358a68b92c3b4abe81",22902417,1,0,1,1234,394,394,0
"6f8881a745ac4c358a68b92c3b4abe81","f7002c8484354eceac57bc7bd62c76c1",22902417,1,-1,0,1235,394,393,-1
"f7002c8484354eceac57bc7bd62c76c1","44a277ea44dc4ae689fab4b82f0b4098",22902417,1,5,0,1236,393,397,4
"44a277ea44dc4ae689fab4b82f0b4098","44a277ea44dc4ae689fab4b82f0b4098",22902417,1,0,1,1237,397,397,0
"44a277ea44dc4ae689fab4b82f0b4098","0c12af0a4e7f4002852cf84b2537c161",22902417,1,-2,0,1238,397,395,-2
"0c12af0a4e7f4002852cf84b2537c161","859e0b8d71694b12befb69ee698138f9",22902417,1,5,0,1239,395,399,4
"859e0b8d71694b12befb69ee698138f9","859e0b8d71694b12befb69ee698138f9",22902417,1,0,1,1240,399,399,0
"859e0b8d71694b12befb69ee698138f9","2b09a08242b54983aec7063990fb3f66",22902417,1,3,0,1241,399,400,1
"2b09a08242b54983aec7063990fb3f66","66baf19b6b904b70922329068c63746d",22902417,1,-32,0,1242,400,376,-24
"66baf19b6b904b70922329068c63746d","2b09a08242b54983aec7063990fb3f66",22902417,1,32,0,1243,376,400,24
"2b09a08242b54983aec7063990fb3f66","2b09a08242b54983aec7063990fb3f66",22902417,1,0,1,1244,400,400,0
"2b09a08242b54983aec7063990fb3f66","1f471b7a883a4df48211e8c6a81b59a7",22902417,1,1,0,1245,400,401,1
"1f471b7a883a4df48211e8c6a81b59a7","1f471b7a883a4df48211e8c6a81b59a7",22902417,1,0,1,1246,401,401,0
"1f471b7a883a4df48211e8c6a81b59a7","2b09a08242b54983aec7063990fb3f66",22902417,1,-1,0,1247,401,400,-1
"2b09a08242b54983aec7063990fb3f66","9de0d567bfa84fe5b77cb76f4a76a5d1",22902417,1,5,0,1248,400,404,4
"9de0d567bfa84fe5b77cb76f4a76a5d1","9de0d567bfa84fe5b77cb76f4a76a5d1",22902417,14,0,1,1249,404,404,0
"9de0d567bfa84fe5b77cb76f4a76a5d1","1157bd665ec4472fb58b751dc5099355",22902417,2,-1,0,1254,404,403,-1
"1157bd665ec4472fb58b751dc5099355","9de0d567bfa84fe5b77cb76f4a76a5d1",22902417,1,1,0,1255,403,404,1
"1157bd665ec4472fb58b751dc5099355","1157bd665ec4472fb58b751dc5099355",22902417,1,0,1,1263,403,403,0
"1157bd665ec4472fb58b751dc5099355","3c8a22d2f9c146ea956609e3ed4f2559",22902417,1,3,0,1264,403,405,2
"3c8a22d2f9c146ea956609e3ed4f2559","9de0d567bfa84fe5b77cb76f4a76a5d1",22902417,1,-2,0,1265,405,404,-1
"9de0d567bfa84fe5b77cb76f4a76a5d1","58fc9094275e4c49be3f4ba6d4acc0a4",22902417,1,4,0,1269,404,406,2
"58fc9094275e4c49be3f4ba6d4acc0a4","3c8a22d2f9c146ea956609e3ed4f2559",22902417,1,-2,0,1270,406,405,-1
"3c8a22d2f9c146ea956609e3ed4f2559","58fc9094275e4c49be3f4ba6d4acc0a4",22902417,1,2,0,1271,405,406,1
"58fc9094275e4c49be3f4ba6d4acc0a4","c1c1be90b2b14c1ab4a5e1ee3c241902",22902417,1,1,0,1272,406,407,1
"c1c1be90b2b14c1ab4a5e1ee3c241902","c1c1be90b2b14c1ab4a5e1ee3c241902",22902417,5,0,1,1273,407,407,0
"c1c1be90b2b14c1ab4a5e1ee3c241902","02b3a1bead9244c1ba2f857c7da8f82a",22902417,1,2,0,1278,407,408,1
"02b3a1bead9244c1ba2f857c7da8f82a","58fc9094275e4c49be3f4ba6d4acc0a4",22902417,1,-3,0,1279,408,406,-2
"58fc9094275e4c49be3f4ba6d4acc0a4","02b3a1bead9244c1ba2f857c7da8f82a",22902417,1,3,0,1280,406,408,2
"02b3a1bead9244c1ba2f857c7da8f82a","6206fc6479014bb193084c32409dc1b9",22902417,1,1,0,1281,408,409,1
"6206fc6479014bb193084c32409dc1b9","6206fc6479014bb193084c32409dc1b9",22902417,1,0,1,1282,409,409,0
"6206fc6479014bb193084c32409dc1b9","6a5f020451db426dacba9e2ea3fcc62a",22902417,1,2,0,1283,409,410,1
"6a5f020451db426dacba9e2ea3fcc62a","02b3a1bead9244c1ba2f857c7da8f82a",22902417,1,-3,0,1284,410,408,-2
"02b3a1bead9244c1ba2f857c7da8f82a","6a5f020451db426dacba9e2ea3fcc62a",22902417,1,3,0,1285,408,410,2
"6a5f020451db426dacba9e2ea3fcc62a","6a5f020451db426dacba9e2ea3fcc62a",22902417,1,0,1,1286,410,410,0
"6a5f020451db426dacba9e2ea3fcc62a","33a9d248b2e44588a5b07fc1342b9bc2",22902417,2,2,0,1287,410,411,1
"33a9d248b2e44588a5b07fc1342b9bc2","6a5f020451db426dacba9e2ea3fcc62a",22902417,1,-2,0,1288,411,410,-1
"33a9d248b2e44588a5b07fc1342b9bc2","c6f26bd420634f1cb7989e76fe6b16c0",22902417,1,1,0,1290,411,412,1
"c6f26bd420634f1cb7989e76fe6b16c0","c6f26bd420634f1cb7989e76fe6b16c0",22902417,5,0,1,1291,412,412,0
"c6f26bd420634f1cb7989e76fe6b16c0","2a65ee6e2ac64f6a8a55fbe5373ec763",22902417,1,1,0,1296,412,413,1
"2a65ee6e2ac64f6a8a55fbe5373ec763","2a65ee6e2ac64f6a8a55fbe5373ec763",22902417,2,0,1,1297,413,413,0
"2a65ee6e2ac64f6a8a55fbe5373ec763","33a9d248b2e44588a5b07fc1342b9bc2",22902417,1,-2,0,1299,413,411,-2
"33a9d248b2e44588a5b07fc1342b9bc2","1fd0f6dadbc14ebc965faf6122190b96",22902417,1,5,0,1300,411,415,4
"1fd0f6dadbc14ebc965faf6122190b96","1fd0f6dadbc14ebc965faf6122190b96",22902417,1,0,1,1301,415,415,0
"1fd0f6dadbc14ebc965faf6122190b96","687055dad9fc40c3982478fe33ec01bf",22902417,1,-1,0,1302,415,414,-1
"687055dad9fc40c3982478fe33ec01bf","2add1669f08d4101913db15f8c23b3b7",22902417,1,3,0,1303,414,416,2
"2add1669f08d4101913db15f8c23b3b7","2add1669f08d4101913db15f8c23b3b7",22902417,1,0,1,1304,416,416,0
"2add1669f08d4101913db15f8c23b3b7","2b09a08242b54983aec7063990fb3f66",22902417,1,-24,0,1305,416,400,-16
"2b09a08242b54983aec7063990fb3f66","a2b4bd40cee2481ebd3fc179d6a5cd62",22902417,1,27,0,1306,400,417,17
"a2b4bd40cee2481ebd3fc179d6a5cd62","e34e59dce2204f228f3a84b6725df60f",22902417,1,2,0,1307,417,419,2
"e34e59dce2204f228f3a84b6725df60f","e34e59dce2204f228f3a84b6725df60f",22902417,1,0,1,1308,419,419,0
"e34e59dce2204f228f3a84b6725df60f","a2b4bd40cee2481ebd3fc179d6a5cd62",22902417,1,-2,0,1309,419,417,-2
"a2b4bd40cee2481ebd3fc179d6a5cd62","bec48fc2e1294c7eb3d0aca780d731b8",22902417,1,4,0,1310,417,420,3
"bec48fc2e1294c7eb3d0aca780d731b8","bec48fc2e1294c7eb3d0aca780d731b8",22902417,2,0,1,1311,420,420,0
"bec48fc2e1294c7eb3d0aca780d731b8","a24600b0e49245f6bdba8c893cfeddb0",22902417,1,7,0,1313,420,425,5
"a24600b0e49245f6bdba8c893cfeddb0","dbde19fcce2a4c1abdc7f685c293a23f",22902417,1,-4,0,1314,425,422,-3
"dbde19fcce2a4c1abdc7f685c293a23f","a24600b0e49245f6bdba8c893cfeddb0",22902417,1,4,0,1315,422,425,3
"a24600b0e49245f6bdba8c893cfeddb0","a24600b0e49245f6bdba8c893cfeddb0",22902417,1,0,1,1316,425,425,0
"a24600b0e49245f6bdba8c893cfeddb0","a2b4bd40cee2481ebd3fc179d6a5cd62",22902417,1,-11,0,1317,425,417,-8
"a2b4bd40cee2481ebd3fc179d6a5cd62","24cf8786024543f19b89bc20034e60d7",22902417,1,18,0,1318,417,428,11
"24cf8786024543f19b89bc20034e60d7","f2a73be2f46840b182d7bd095378004e",22902417,2,1,0,1319,428,429,1
"f2a73be2f46840b182d7bd095378004e","f2a73be2f46840b182d7bd095378004e",22902417,1,0,1,1320,429,429,0
"f2a73be2f46840b182d7bd095378004e","604551fd4266430cb860fef58fa7dd61",22902417,1,1,0,1321,429,430,1
"604551fd4266430cb860fef58fa7dd61","604551fd4266430cb860fef58fa7dd61",22902417,9,0,1,1322,430,430,0
"604551fd4266430cb860fef58fa7dd61","24cf8786024543f19b89bc20034e60d7",22902417,1,-2,0,1331,430,428,-2
"24cf8786024543f19b89bc20034e60d7","dce46f8904594a62a6377a3587aaa663",22902417,2,4,0,1332,428,431,3
"dce46f8904594a62a6377a3587aaa663","dce46f8904594a62a6377a3587aaa663",22902417,4,0,1,1333,431,431,0
"dce46f8904594a62a6377a3587aaa663","24cf8786024543f19b89bc20034e60d7",22902417,1,-4,0,1335,431,428,-3
"24cf8786024543f19b89bc20034e60d7","24cf8786024543f19b89bc20034e60d7",22902417,1,0,1,1336,428,428,0
"f2a73be2f46840b182d7bd095378004e","24cf8786024543f19b89bc20034e60d7",22902417,1,-1,0,1338,429,428,-1
"dce46f8904594a62a6377a3587aaa663","9b9d0a249052413c869753b99682b0ac",22902417,1,1,0,1342,431,432,1
"9b9d0a249052413c869753b99682b0ac","9b9d0a249052413c869753b99682b0ac",22902417,1,0,1,1343,432,432,0
"9b9d0a249052413c869753b99682b0ac","061c175cc90f45fbad883025394e78dd",22902417,1,1,0,1344,432,433,1
"061c175cc90f45fbad883025394e78dd","061c175cc90f45fbad883025394e78dd",22902417,4,0,1,1345,433,433,0
"061c175cc90f45fbad883025394e78dd","dce46f8904594a62a6377a3587aaa663",22902417,1,-2,0,1349,433,431,-2
"dce46f8904594a62a6377a3587aaa663","74a7f8712e5449c2bc0b43c6f90dafed",22902417,1,5,0,1350,431,435,4
"74a7f8712e5449c2bc0b43c6f90dafed","74a7f8712e5449c2bc0b43c6f90dafed",22902417,1,0,1,1351,435,435,0
"74a7f8712e5449c2bc0b43c6f90dafed","66ada10dde9f43018588f1ced9d477fc",22902417,1,-1,0,1352,435,434,-1
"66ada10dde9f43018588f1ced9d477fc","bf12c96466d840a69bed7020b3f18bb8",22902417,1,3,0,1353,434,436,2
"bf12c96466d840a69bed7020b3f18bb8","bf12c96466d840a69bed7020b3f18bb8",22902417,1,0,1,1354,436,436,0
"bf12c96466d840a69bed7020b3f18bb8","070600601c4c439288445d2f0724807d",22902417,1,3,0,1355,436,437,1
"070600601c4c439288445d2f0724807d","24cf8786024543f19b89bc20034e60d7",22902417,1,-14,0,1356,437,428,-9
"24cf8786024543f19b89bc20034e60d7","1823b6de7d334a7aaabc4570719af4d9",22902417,1,16,0,1357,428,439,11
"1823b6de7d334a7aaabc4570719af4d9","1823b6de7d334a7aaabc4570719af4d9",22902417,11,0,1,1358,439,439,0
"1823b6de7d334a7aaabc4570719af4d9","070600601c4c439288445d2f0724807d",22902417,1,-2,0,1369,439,437,-2
"070600601c4c439288445d2f0724807d","0380cd76a7d44bc3a4da1f15e4d68f89",22902417,1,4,0,1370,437,440,3
"0380cd76a7d44bc3a4da1f15e4d68f89","0380cd76a7d44bc3a4da1f15e4d68f89",22902417,4,0,1,1371,440,440,0
"0380cd76a7d44bc3a4da1f15e4d68f89","23b7673c8b5443108c2ef09382834a86",22902417,1,2,0,1375,440,441,1
"23b7673c8b5443108c2ef09382834a86","23b7673c8b5443108c2ef09382834a86",22902417,2,0,1,1376,441,441,0
"23b7673c8b5443108c2ef09382834a86","901e92500aea43c79f19f1b279050668",22902417,1,2,0,1378,441,442,1
"901e92500aea43c79f19f1b279050668","901e92500aea43c79f19f1b279050668",22902417,1,0,1,1379,442,442,0
"901e92500aea43c79f19f1b279050668","001339db8ced4cf78829ebe8b145449d",22902417,1,1,0,1380,442,443,1
"001339db8ced4cf78829ebe8b145449d","001339db8ced4cf78829ebe8b145449d",22902417,5,0,1,1381,443,443,0
"001339db8ced4cf78829ebe8b145449d","452745e0366e42ae81561bfddebcc6c3",22902417,1,1,0,1386,443,444,1
"452745e0366e42ae81561bfddebcc6c3","452745e0366e42ae81561bfddebcc6c3",22902417,2,0,1,1387,444,444,0
"452745e0366e42ae81561bfddebcc6c3","901e92500aea43c79f19f1b279050668",22902417,1,-2,0,1389,444,442,-2
"901e92500aea43c79f19f1b279050668","4660ff2089114e8db82ceb26a4f329e3",22902417,1,4,0,1390,442,445,3
"4660ff2089114e8db82ceb26a4f329e3","4660ff2089114e8db82ceb26a4f329e3",22902417,2,0,1,1391,445,445,0
"4660ff2089114e8db82ceb26a4f329e3","7bd5586eb9d8484eb74a433ee7bfe499",22902417,1,2,0,1393,445,446,1
"7bd5586eb9d8484eb74a433ee7bfe499","7bd5586eb9d8484eb74a433ee7bfe499",22902417,10,0,1,1394,446,446,0
"7bd5586eb9d8484eb74a433ee7bfe499","8a7f26e690f34dda97be16904518ca99",22902417,1,2,0,1404,446,447,1
"8a7f26e690f34dda97be16904518ca99","8a7f26e690f34dda97be16904518ca99",22902417,1,0,1,1405,447,447,0
"8a7f26e690f34dda97be16904518ca99","b2f0d654738f48158edff28e8d3a546e",22902417,1,5,0,1406,447,449,2
"b2f0d654738f48158edff28e8d3a546e","070600601c4c439288445d2f0724807d",22902417,1,-21,0,1407,449,437,-12
"070600601c4c439288445d2f0724807d","f60ee41ec635499abd48168342d32c2f",22902417,1,26,0,1408,437,453,16
"f60ee41ec635499abd48168342d32c2f","f60ee41ec635499abd48168342d32c2f",22902417,66,0,1,1409,453,453,0
"f60ee41ec635499abd48168342d32c2f","b2f0d654738f48158edff28e8d3a546e",22902417,4,-5,0,1410,453,449,-4
"b2f0d654738f48158edff28e8d3a546e","f60ee41ec635499abd48168342d32c2f",22902417,4,5,0,1411,449,453,4
"b2f0d654738f48158edff28e8d3a546e","f67fbf45a5f146ed866965bc57c7c001",22902417,1,8,0,1463,449,454,5
"f67fbf45a5f146ed866965bc57c7c001","f67fbf45a5f146ed866965bc57c7c001",22902417,2,0,1,1464,454,454,0
"f67fbf45a5f146ed866965bc57c7c001","d937afe49bd24a07a550dda1c1155122",22902417,1,1,0,1466,454,455,1
"d937afe49bd24a07a550dda1c1155122","d937afe49bd24a07a550dda1c1155122",22902417,1,0,1,1467,455,455,0
"d937afe49bd24a07a550dda1c1155122","3628b3f7823443d0912a339096b69943",22902417,1,1,0,1468,455,456,1
"3628b3f7823443d0912a339096b69943","3628b3f7823443d0912a339096b69943",22902417,1,0,1,1469,456,456,0
"3628b3f7823443d0912a339096b69943","9e049ee647cf43ecbcb5ed792a8e7588",22902417,1,1,0,1470,456,457,1
"9e049ee647cf43ecbcb5ed792a8e7588","9e049ee647cf43ecbcb5ed792a8e7588",22902417,1,0,1,1471,457,457,0
"9e049ee647cf43ecbcb5ed792a8e7588","5256a214faaf410b93f76cea06428334",22902417,1,1,0,1472,457,458,1
"5256a214faaf410b93f76cea06428334","5256a214faaf410b93f76cea06428334",22902417,1,0,1,1473,458,458,0
"5256a214faaf410b93f76cea06428334","25c32b120fce40fa9b6c85133aeb4716",22902417,1,1,0,1474,458,459,1
"25c32b120fce40fa9b6c85133aeb4716","25c32b120fce40fa9b6c85133aeb4716",22902417,1,0,1,1475,459,459,0
"25c32b120fce40fa9b6c85133aeb4716","11bc14f2204949008b7d511b933363c1",22902417,1,1,0,1476,459,460,1
"11bc14f2204949008b7d511b933363c1","11bc14f2204949008b7d511b933363c1",22902417,1,0,1,1477,460,460,0
"11bc14f2204949008b7d511b933363c1","42de338840a34d15adb66e7b14fb9d2c",22902417,1,1,0,1478,460,461,1
"42de338840a34d15adb66e7b14fb9d2c","42de338840a34d15adb66e7b14fb9d2c",22902417,1,0,1,1479,461,461,0
"42de338840a34d15adb66e7b14fb9d2c","9da37c6210b1416b8079c274f70bf600",22902417,1,1,0,1480,461,462,1
"9da37c6210b1416b8079c274f70bf600","9da37c6210b1416b8079c274f70bf600",22902417,1,0,1,1481,462,462,0
"9da37c6210b1416b8079c274f70bf600","519119f1deac45ff9ab4f13529be5c6e",22902417,1,1,0,1482,462,463,1
"519119f1deac45ff9ab4f13529be5c6e","519119f1deac45ff9ab4f13529be5c6e",22902417,1,0,1,1483,463,463,0
"519119f1deac45ff9ab4f13529be5c6e","f67fbf45a5f146ed866965bc57c7c001",22902417,1,-9,0,1484,463,454,-9
"f67fbf45a5f146ed866965bc57c7c001","c5df9f40ec14463b9dcfdc73df3e9285",22902417,1,12,0,1485,454,464,10
"c5df9f40ec14463b9dcfdc73df3e9285","c5df9f40ec14463b9dcfdc73df3e9285",22902417,2,0,1,1486,464,464,0
"c5df9f40ec14463b9dcfdc73df3e9285","83d42d95cd844fc093fc09cee250edb8",22902417,1,3,0,1488,464,465,1
"83d42d95cd844fc093fc09cee250edb8","83d42d95cd844fc093fc09cee250edb8",22902417,3,0,1,1489,465,465,0
"83d42d95cd844fc093fc09cee250edb8","9afd71a5298d4333b6849dfce1b9422c",22902417,1,-627,0,1492,465,18,-447
"9afd71a5298d4333b6849dfce1b9422c","9afd71a5298d4333b6849dfce1b9422c",22902417,3,0,1,1493,18,18,0
"9afd71a5298d4333b6849dfce1b9422c","b7719e26494940efa49512aedd0aac79",22902417,2,4,0,1495,18,20,2
"b7719e26494940efa49512aedd0aac79","d4f45188d3c84a02ba08454e6403a818",22902417,1,5,0,1496,20,24,4
"d4f45188d3c84a02ba08454e6403a818","d4c3b003e8274e429d2fa688d73fde6d",22902417,2,-2,0,1497,24,22,-2
"d4c3b003e8274e429d2fa688d73fde6d","b7719e26494940efa49512aedd0aac79",22902417,1,-3,0,1498,22,20,-2
"b7719e26494940efa49512aedd0aac79","afbf7250b99d47bea07172749483ca97",22902417,2,12,0,1499,20,28,8
"afbf7250b99d47bea07172749483ca97","b7719e26494940efa49512aedd0aac79",22902417,1,-12,0,1500,28,20,-8
"afbf7250b99d47bea07172749483ca97","4e51676dc72045d99c19b9fa7b22f8bc",22902417,1,3,0,1502,28,29,1
"4e51676dc72045d99c19b9fa7b22f8bc","4e51676dc72045d99c19b9fa7b22f8bc",22902417,1,0,1,1503,29,29,0
"4e51676dc72045d99c19b9fa7b22f8bc","51970cfa30e643e894e66ae85c8024cc",22902417,1,3,0,1504,29,31,2
"51970cfa30e643e894e66ae85c8024cc","c33c17be71ae4d588da7369472e5bb1b",22902417,1,6,0,1505,31,34,3
"c33c17be71ae4d588da7369472e5bb1b","4e51676dc72045d99c19b9fa7b22f8bc",22902417,1,-9,0,1506,34,29,-5
"4e51676dc72045d99c19b9fa7b22f8bc","c33c17be71ae4d588da7369472e5bb1b",22902417,1,9,0,1507,29,34,5
"c33c17be71ae4d588da7369472e5bb1b","93679be414554a11b1893002f2229a93",22902417,1,3,0,1508,34,35,1
"93679be414554a11b1893002f2229a93","93679be414554a11b1893002f2229a93",22902417,1,0,1,1509,35,35,0
"93679be414554a11b1893002f2229a93","7040a13096d746ac84b8fac8d9752058",22902417,1,3,0,1510,35,36,1
"7040a13096d746ac84b8fac8d9752058","7040a13096d746ac84b8fac8d9752058",22902417,1,0,1,1511,36,36,0
"7040a13096d746ac84b8fac8d9752058","9a0dc646f934470daf08c4b56ccf73db",22902417,1,3,0,1512,36,37,1
"9a0dc646f934470daf08c4b56ccf73db","9a0dc646f934470daf08c4b56ccf73db",22902417,1,0,1,1513,37,37,0
"9a0dc646f934470daf08c4b56ccf73db","fc0e049d56024bc9a02c9a9c435c3df7",22902417,1,3,0,1514,37,38,1
"fc0e049d56024bc9a02c9a9c435c3df7","67a089198fcb4e1c8f2385786c2b296f",22902417,1,4,0,1515,38,39,1
"67a089198fcb4e1c8f2385786c2b296f","fc0e049d56024bc9a02c9a9c435c3df7",22902417,1,-4,0,1516,39,38,-1
"fc0e049d56024bc9a02c9a9c435c3df7","64d48c6c9c7940639a932219a6c87198",22902417,1,5,0,1517,38,40,2
"64d48c6c9c7940639a932219a6c87198","67a089198fcb4e1c8f2385786c2b296f",22902417,1,-1,0,1518,40,39,-1
"67a089198fcb4e1c8f2385786c2b296f","b534b89233134e30a9b5645138bfa9ee",22902417,1,4,0,1519,39,41,2
"b534b89233134e30a9b5645138bfa9ee","6e13d61a7bdb44bca949c9f86fab3be5",22902417,2,7,0,1520,41,47,6
"6e13d61a7bdb44bca949c9f86fab3be5","b534b89233134e30a9b5645138bfa9ee",22902417,1,-7,0,1521,47,41,-6
"b534b89233134e30a9b5645138bfa9ee","d0c74f735e024943943e40333d6d337f",22902417,1,12,0,1522,41,51,10
"d0c74f735e024943943e40333d6d337f","d9c8d8c444a64dadbbb508652c721e17",22902417,1,-6,0,1523,51,46,-5
"d9c8d8c444a64dadbbb508652c721e17","f924752d8a1149668870b1e7698486f7",22902417,1,5,0,1524,46,50,4
"f924752d8a1149668870b1e7698486f7","67a089198fcb4e1c8f2385786c2b296f",22902417,1,-15,0,1525,50,39,-11
"67a089198fcb4e1c8f2385786c2b296f","67a089198fcb4e1c8f2385786c2b296f",22902417,2,0,1,1526,39,39,0
"67a089198fcb4e1c8f2385786c2b296f","64d48c6c9c7940639a932219a6c87198",22902417,2,1,0,1527,39,40,1
"64d48c6c9c7940639a932219a6c87198","e20db35ced8544ddac5bc3839145e463",22902417,1,66,0,1528,40,91,51
"e20db35ced8544ddac5bc3839145e463","e20db35ced8544ddac5bc3839145e463",22902417,2,0,1,1529,91,91,0
"e20db35ced8544ddac5bc3839145e463","00ae5f0c51874a73a41ebea838d95682",22902417,1,11,0,1531,91,101,10
"00ae5f0c51874a73a41ebea838d95682","d391c8b6e56a43a7b654e9dee02d904b",22902417,2,2,0,1532,101,103,2
"d391c8b6e56a43a7b654e9dee02d904b","4280927ec4d643238aa49c32f9e06c6c",22902417,1,7,0,1533,103,109,6
"4280927ec4d643238aa49c32f9e06c6c","73039f8c1eb9409cb4caee2cf968001e",22902417,1,-10,0,1534,109,100,-9
"73039f8c1eb9409cb4caee2cf968001e","a9ae0a3c070d455bb4369a8996313336",22902417,1,16,0,1535,100,114,14
"a9ae0a3c070d455bb4369a8996313336","08111f75e22d409998cf8b85bd431f0a",22902417,2,-7,0,1536,114,108,-6
"08111f75e22d409998cf8b85bd431f0a","37319e88176d4aefa91d7a9980dbae91",22902417,1,5,0,1537,108,112,4
"37319e88176d4aefa91d7a9980dbae91","62bff51286ef4f348717a3cf6fe2318f",22902417,2,9,0,1538,112,120,8
"62bff51286ef4f348717a3cf6fe2318f","62bff51286ef4f348717a3cf6fe2318f",22902417,5,0,1,1539,120,120,0
"62bff51286ef4f348717a3cf6fe2318f","b2f0d654738f48158edff28e8d3a546e",22902417,1,460,0,1541,120,449,329
"b2f0d654738f48158edff28e8d3a546e","b2f0d654738f48158edff28e8d3a546e",22902417,1,0,1,1551,449,449,0
"f60ee41ec635499abd48168342d32c2f","f67fbf45a5f146ed866965bc57c7c001",22902417,1,3,0,1563,453,454,1
"f67fbf45a5f146ed866965bc57c7c001","b2f0d654738f48158edff28e8d3a546e",22902417,1,-8,0,1564,454,449,-5
"b2f0d654738f48158edff28e8d3a546e","c33c17be71ae4d588da7369472e5bb1b",22902417,1,-576,0,1565,449,34,-415
"c33c17be71ae4d588da7369472e5bb1b","c33c17be71ae4d588da7369472e5bb1b",22902417,1,0,1,1566,34,34,0
"0c7262dff33c4087bc660ccf40f92f9c","b613861cecf84ffcab01afb23f660475",22930920,1,-241,0,1,169,1,-168
"b613861cecf84ffcab01afb23f660475","b613861cecf84ffcab01afb23f660475",22930920,6,0,1,2,1,1,0
"e2911e79efc2420eac45d9f671463d4b","b613861cecf84ffcab01afb23f660475",22930920,1,-3,0,4,2,1,-1
"b613861cecf84ffcab01afb23f660475","e2911e79efc2420eac45d9f671463d4b",22930920,2,3,0,10,1,2,1
"e2911e79efc2420eac45d9f671463d4b","e2911e79efc2420eac45d9f671463d4b",22930920,2,0,1,11,2,2,0
"e2911e79efc2420eac45d9f671463d4b","519d1b8c59404d67b54e96c5c8a830b2",22930920,1,1,0,13,2,3,1
"519d1b8c59404d67b54e96c5c8a830b2","519d1b8c59404d67b54e96c5c8a830b2",22930920,1,0,1,14,3,3,0
"519d1b8c59404d67b54e96c5c8a830b2","531db53f81f646edb0cdcfe0085b03b7",22930920,1,1,0,15,3,4,1
"531db53f81f646edb0cdcfe0085b03b7","531db53f81f646edb0cdcfe0085b03b7",22930920,1,0,1,16,4,4,0
"531db53f81f646edb0cdcfe0085b03b7","4f5f94b2f95141e0a9d53a61da2276da",22930920,1,1,0,17,4,5,1
"4f5f94b2f95141e0a9d53a61da2276da","4f5f94b2f95141e0a9d53a61da2276da",22930920,1,0,1,18,5,5,0
"4f5f94b2f95141e0a9d53a61da2276da","6d541c89590949f99af293c4f2333f67",22930920,1,1,0,19,5,6,1
"6d541c89590949f99af293c4f2333f67","6d541c89590949f99af293c4f2333f67",22930920,1,0,1,20,6,6,0
"6d541c89590949f99af293c4f2333f67","dd5cf0b9fe4c4f1d8f5ff8e4c04879cb",22930920,1,1,0,21,6,7,1
"dd5cf0b9fe4c4f1d8f5ff8e4c04879cb","dd5cf0b9fe4c4f1d8f5ff8e4c04879cb",22930920,1,0,1,22,7,7,0
"dd5cf0b9fe4c4f1d8f5ff8e4c04879cb","f96261861edc426abe2248be4f0a709a",22930920,1,1,0,23,7,8,1
"f96261861edc426abe2248be4f0a709a","f96261861edc426abe2248be4f0a709a",22930920,1,0,1,24,8,8,0
"f96261861edc426abe2248be4f0a709a","66b5e16f4f75454fb5b8172079f0fa83",22930920,1,1,0,25,8,9,1
"66b5e16f4f75454fb5b8172079f0fa83","66b5e16f4f75454fb5b8172079f0fa83",22930920,1,0,1,26,9,9,0
"66b5e16f4f75454fb5b8172079f0fa83","0680571d4698477995e41842c36a54b2",22930920,1,1,0,27,9,10,1
"0680571d4698477995e41842c36a54b2","0680571d4698477995e41842c36a54b2",22930920,1,0,1,28,10,10,0
"0680571d4698477995e41842c36a54b2","9112f2bffece48e08c6d2287be204085",22930920,1,1,0,29,10,11,1
"9112f2bffece48e08c6d2287be204085","9112f2bffece48e08c6d2287be204085",22930920,1,0,1,30,11,11,0
"9112f2bffece48e08c6d2287be204085","e2911e79efc2420eac45d9f671463d4b",22930920,1,-9,0,31,11,2,-9
"e2911e79efc2420eac45d9f671463d4b","56586aa865414f538729c7f7735d2bc6",22930920,1,12,0,32,2,12,10
"56586aa865414f538729c7f7735d2bc6","56586aa865414f538729c7f7735d2bc6",22930920,3,0,1,33,12,12,0
"56586aa865414f538729c7f7735d2bc6","b7f2b31585d94eb3bf86376714aa7070",22930920,1,2,0,36,12,13,1
"b7f2b31585d94eb3bf86376714aa7070","b7f2b31585d94eb3bf86376714aa7070",22930920,2,0,1,37,13,13,0
"b7f2b31585d94eb3bf86376714aa7070","3f1c815879794b929260d224becaff7e",22930920,1,2,0,39,13,14,1
"3f1c815879794b929260d224becaff7e","5c5ceeee4562457ba6d41515aeebfbb1",22930920,1,6,0,40,14,17,3
"5c5ceeee4562457ba6d41515aeebfbb1","81c864a886d54a6b8ff85f7d736f4f95",22930920,1,-4,0,41,17,15,-2
"81c864a886d54a6b8ff85f7d736f4f95","5c5ceeee4562457ba6d41515aeebfbb1",22930920,1,4,0,42,15,17,2
"5c5ceeee4562457ba6d41515aeebfbb1","5c5ceeee4562457ba6d41515aeebfbb1",22930920,1,0,1,43,17,17,0
"5c5ceeee4562457ba6d41515aeebfbb1","9afd71a5298d4333b6849dfce1b9422c",22930920,1,3,0,44,17,18,1
"9afd71a5298d4333b6849dfce1b9422c","56586aa865414f538729c7f7735d2bc6",22930920,1,-13,0,45,18,12,-6
"56586aa865414f538729c7f7735d2bc6","9afd71a5298d4333b6849dfce1b9422c",22930920,1,13,0,46,12,18,6
"9afd71a5298d4333b6849dfce1b9422c","b7719e26494940efa49512aedd0aac79",22930920,1,4,0,47,18,20,2
"b7719e26494940efa49512aedd0aac79","d4f45188d3c84a02ba08454e6403a818",22930920,2,5,0,48,20,24,4
"d4c3b003e8274e429d2fa688d73fde6d","b7719e26494940efa49512aedd0aac79",22930920,1,-3,0,54,22,20,-2
"d4c3b003e8274e429d2fa688d73fde6d","5bc03c8f16354d04bd51f5bb93559ad3",22930920,1,4,0,65,22,26,4
"5bc03c8f16354d04bd51f5bb93559ad3","b7719e26494940efa49512aedd0aac79",22930920,1,-7,0,66,26,20,-6
"b7719e26494940efa49512aedd0aac79","b7719e26494940efa49512aedd0aac79",22930920,1,0,1,67,20,20,0
"b7719e26494940efa49512aedd0aac79","afbf7250b99d47bea07172749483ca97",22930920,1,12,0,68,20,28,8
"afbf7250b99d47bea07172749483ca97","afbf7250b99d47bea07172749483ca97",22930920,1,0,1,69,28,28,0
"afbf7250b99d47bea07172749483ca97","4e51676dc72045d99c19b9fa7b22f8bc",22930920,1,3,0,70,28,29,1
"4e51676dc72045d99c19b9fa7b22f8bc","4e51676dc72045d99c19b9fa7b22f8bc",22930920,1,0,1,71,29,29,0
"4e51676dc72045d99c19b9fa7b22f8bc","51970cfa30e643e894e66ae85c8024cc",22930920,1,3,0,72,29,31,2
"51970cfa30e643e894e66ae85c8024cc","4e51676dc72045d99c19b9fa7b22f8bc",22930920,1,-3,0,73,31,29,-2
"4e51676dc72045d99c19b9fa7b22f8bc","c33c17be71ae4d588da7369472e5bb1b",22930920,1,9,0,74,29,34,5
"c33c17be71ae4d588da7369472e5bb1b","93679be414554a11b1893002f2229a93",22930920,2,3,0,75,34,35,1
"93679be414554a11b1893002f2229a93","c33c17be71ae4d588da7369472e5bb1b",22930920,1,-3,0,76,35,34,-1
"93679be414554a11b1893002f2229a93","7040a13096d746ac84b8fac8d9752058",22930920,1,3,0,78,35,36,1
"7040a13096d746ac84b8fac8d9752058","7040a13096d746ac84b8fac8d9752058",22930920,1,0,1,79,36,36,0
"7040a13096d746ac84b8fac8d9752058","9a0dc646f934470daf08c4b56ccf73db",22930920,1,3,0,80,36,37,1
"9a0dc646f934470daf08c4b56ccf73db","fc0e049d56024bc9a02c9a9c435c3df7",22930920,2,3,0,81,37,38,1
"fc0e049d56024bc9a02c9a9c435c3df7","9a0dc646f934470daf08c4b56ccf73db",22930920,1,-3,0,82,38,37,-1
"fc0e049d56024bc9a02c9a9c435c3df7","67a089198fcb4e1c8f2385786c2b296f",22930920,1,4,0,84,38,39,1
"67a089198fcb4e1c8f2385786c2b296f","64d48c6c9c7940639a932219a6c87198",22930920,1,1,0,85,39,40,1
"64d48c6c9c7940639a932219a6c87198","78adeee1fa2c4fe0bc73f7bca9fcee86",22930920,1,151,0,86,40,160,120
"78adeee1fa2c4fe0bc73f7bca9fcee86","64d48c6c9c7940639a932219a6c87198",22930920,1,-151,0,88,160,40,-120
"64d48c6c9c7940639a932219a6c87198","64d48c6c9c7940639a932219a6c87198",22930920,1,0,1,89,40,40,0
"64d48c6c9c7940639a932219a6c87198","67a089198fcb4e1c8f2385786c2b296f",22930920,1,-1,0,90,40,39,-1
"67a089198fcb4e1c8f2385786c2b296f","b534b89233134e30a9b5645138bfa9ee",22930920,1,4,0,91,39,41,2
"b534b89233134e30a9b5645138bfa9ee","0e37b720d23b4e7f8b313e79313fd107",22930920,1,3,0,92,41,44,3
"0e37b720d23b4e7f8b313e79313fd107","0e37b720d23b4e7f8b313e79313fd107",22930920,1,0,1,93,44,44,0
"0e37b720d23b4e7f8b313e79313fd107","6875d67fdd5f48168b62719df449bebd",22930920,1,1,0,94,44,45,1
"6875d67fdd5f48168b62719df449bebd","6875d67fdd5f48168b62719df449bebd",22930920,1,0,1,95,45,45,0
"6875d67fdd5f48168b62719df449bebd","b534b89233134e30a9b5645138bfa9ee",22930920,1,-4,0,96,45,41,-4
"6e13d61a7bdb44bca949c9f86fab3be5","6e13d61a7bdb44bca949c9f86fab3be5",22930920,19,0,1,100,47,47,0
"6e13d61a7bdb44bca949c9f86fab3be5","195f78799f984cc2b06c48dfe36be751",22930920,1,2,0,117,47,49,2
"195f78799f984cc2b06c48dfe36be751","195f78799f984cc2b06c48dfe36be751",22930920,2,0,1,118,49,49,0
"195f78799f984cc2b06c48dfe36be751","d0c74f735e024943943e40333d6d337f",22930920,1,3,0,120,49,51,2
"d0c74f735e024943943e40333d6d337f","d9c8d8c444a64dadbbb508652c721e17",22930920,1,-6,0,121,51,46,-5
"d9c8d8c444a64dadbbb508652c721e17","d0c74f735e024943943e40333d6d337f",22930920,3,6,0,122,46,51,5
"d0c74f735e024943943e40333d6d337f","983f8ff320594b279a7f4a6fe132f9c5",22930920,1,2,0,123,51,53,2
"983f8ff320594b279a7f4a6fe132f9c5","983f8ff320594b279a7f4a6fe132f9c5",22930920,2,0,1,124,53,53,0
"983f8ff320594b279a7f4a6fe132f9c5","35adfa5d923046aebabfefd98f35ff05",22930920,1,1,0,126,53,54,1
"35adfa5d923046aebabfefd98f35ff05","35adfa5d923046aebabfefd98f35ff05",22930920,5,0,1,127,54,54,0
"35adfa5d923046aebabfefd98f35ff05","b6f8a98476224da1b40e555ececc7ed8",22930920,1,1,0,132,54,55,1
"b6f8a98476224da1b40e555ececc7ed8","b6f8a98476224da1b40e555ececc7ed8",22930920,2,0,1,133,55,55,0
"b6f8a98476224da1b40e555ececc7ed8","86e22cb5fe0e4b47a9489ecddf7ed78f",22930920,1,1,0,135,55,56,1
"86e22cb5fe0e4b47a9489ecddf7ed78f","86e22cb5fe0e4b47a9489ecddf7ed78f",22930920,2,0,1,136,56,56,0
"86e22cb5fe0e4b47a9489ecddf7ed78f","f924752d8a1149668870b1e7698486f7",22930920,1,-6,0,138,56,50,-6
"f924752d8a1149668870b1e7698486f7","78f30e4dcac84e3cbea8b2cc6e0d62b3",22930920,2,10,0,139,50,59,9
"78f30e4dcac84e3cbea8b2cc6e0d62b3","a1f2f12debe5432fb7a70bcd12bacfb9",22930920,3,-1,0,140,59,58,-1
"a1f2f12debe5432fb7a70bcd12bacfb9","b534b89233134e30a9b5645138bfa9ee",22930920,1,-20,0,141,58,41,-17
"b534b89233134e30a9b5645138bfa9ee","6e13d61a7bdb44bca949c9f86fab3be5",22930920,3,7,0,142,41,47,6
"6e13d61a7bdb44bca949c9f86fab3be5","b534b89233134e30a9b5645138bfa9ee",22930920,1,-7,0,143,47,41,-6
"b534b89233134e30a9b5645138bfa9ee","d9c8d8c444a64dadbbb508652c721e17",22930920,1,6,0,144,41,46,5
"d0c74f735e024943943e40333d6d337f","f924752d8a1149668870b1e7698486f7",22930920,1,-1,0,146,51,50,-1
"f924752d8a1149668870b1e7698486f7","a1f2f12debe5432fb7a70bcd12bacfb9",22930920,1,9,0,147,50,58,8
"a1f2f12debe5432fb7a70bcd12bacfb9","78f30e4dcac84e3cbea8b2cc6e0d62b3",22930920,2,1,0,148,58,59,1
"78f30e4dcac84e3cbea8b2cc6e0d62b3","b534b89233134e30a9b5645138bfa9ee",22930920,1,-21,0,149,59,41,-18
"b534b89233134e30a9b5645138bfa9ee","b534b89233134e30a9b5645138bfa9ee",22930920,1,0,1,150,41,41,0
"6e13d61a7bdb44bca949c9f86fab3be5","d9c8d8c444a64dadbbb508652c721e17",22930920,1,-1,0,152,47,46,-1
"d0c74f735e024943943e40333d6d337f","a1f2f12debe5432fb7a70bcd12bacfb9",22930920,1,8,0,154,51,58,7
"a1f2f12debe5432fb7a70bcd12bacfb9","f924752d8a1149668870b1e7698486f7",22930920,1,-9,0,155,58,50,-8
"a1f2f12debe5432fb7a70bcd12bacfb9","a1f2f12debe5432fb7a70bcd12bacfb9",22930920,11,0,1,158,58,58,0
"78f30e4dcac84e3cbea8b2cc6e0d62b3","78f30e4dcac84e3cbea8b2cc6e0d62b3",22930920,7,0,1,170,59,59,0
"78f30e4dcac84e3cbea8b2cc6e0d62b3","12aa6e1672ac4e7aa6449a7a8609cd72",22930920,1,-2,0,177,59,57,-2
"12aa6e1672ac4e7aa6449a7a8609cd72","a0a418b8540d479fa6e0f653b701da8b",22930920,2,8,0,178,57,64,7
"a0a418b8540d479fa6e0f653b701da8b","bc42d26810654ea9a1df1efe1e58c7d5",22930920,2,-1,0,179,64,63,-1
"bc42d26810654ea9a1df1efe1e58c7d5","4c943503763e4e349906eea3ed3c8e86",22930920,1,-2,0,180,63,61,-2
"4c943503763e4e349906eea3ed3c8e86","4c943503763e4e349906eea3ed3c8e86",22930920,1,0,1,181,61,61,0
"4c943503763e4e349906eea3ed3c8e86","bc42d26810654ea9a1df1efe1e58c7d5",22930920,1,2,0,182,61,63,2
"bc42d26810654ea9a1df1efe1e58c7d5","bc42d26810654ea9a1df1efe1e58c7d5",22930920,5,0,1,183,63,63,0
"bc42d26810654ea9a1df1efe1e58c7d5","a0a418b8540d479fa6e0f653b701da8b",22930920,2,1,0,186,63,64,1
"a0a418b8540d479fa6e0f653b701da8b","a0a418b8540d479fa6e0f653b701da8b",22930920,4,0,1,187,64,64,0
"a0a418b8540d479fa6e0f653b701da8b","309ccf3cc4fe429d9bfbaef53d3fa479",22930920,2,-4,0,190,64,60,-4
"309ccf3cc4fe429d9bfbaef53d3fa479","b534b89233134e30a9b5645138bfa9ee",22930920,1,-23,0,191,60,41,-19
"b534b89233134e30a9b5645138bfa9ee","d646286c8051419bbc2e31dd1db55ca8",22930920,1,33,0,192,41,67,26
"d646286c8051419bbc2e31dd1db55ca8","267f883678b24aed855fde42524975d9",22930920,1,4,0,193,67,71,4
"267f883678b24aed855fde42524975d9","267f883678b24aed855fde42524975d9",22930920,1,0,1,194,71,71,0
"267f883678b24aed855fde42524975d9","88fff56d0342490dbef9040750a20f6c",22930920,1,1,0,195,71,72,1
"88fff56d0342490dbef9040750a20f6c","88fff56d0342490dbef9040750a20f6c",22930920,1,0,1,196,72,72,0
"88fff56d0342490dbef9040750a20f6c","adb17b12b66c4a49a85fd34322f7df70",22930920,1,1,0,197,72,73,1
"adb17b12b66c4a49a85fd34322f7df70","adb17b12b66c4a49a85fd34322f7df70",22930920,1,0,1,198,73,73,0
"adb17b12b66c4a49a85fd34322f7df70","d646286c8051419bbc2e31dd1db55ca8",22930920,1,-6,0,199,73,67,-6
"d646286c8051419bbc2e31dd1db55ca8","a2becd407db34b189200a32546d9d569",22930920,1,9,0,200,67,75,8
"a2becd407db34b189200a32546d9d569","58c22b011d0f4c2ea6d13615edbb9eeb",22930920,1,2,0,201,75,77,2
"58c22b011d0f4c2ea6d13615edbb9eeb","58c22b011d0f4c2ea6d13615edbb9eeb",22930920,8,0,1,202,77,77,0
"58c22b011d0f4c2ea6d13615edbb9eeb","dd76e1861dc9461c830888729d091ee0",22930920,1,1,0,210,77,78,1
"dd76e1861dc9461c830888729d091ee0","dd76e1861dc9461c830888729d091ee0",22930920,5,0,1,211,78,78,0
"dd76e1861dc9461c830888729d091ee0","cd1d828f1a694b87913a7ea66c23803e",22930920,1,1,0,216,78,79,1
"cd1d828f1a694b87913a7ea66c23803e","cd1d828f1a694b87913a7ea66c23803e",22930920,2,0,1,217,79,79,0
"cd1d828f1a694b87913a7ea66c23803e","9176a3c2b4d2465fa8b0c67096c2a97e",22930920,1,1,0,219,79,80,1
"9176a3c2b4d2465fa8b0c67096c2a97e","9176a3c2b4d2465fa8b0c67096c2a97e",22930920,11,0,1,220,80,80,0
"9176a3c2b4d2465fa8b0c67096c2a97e","f8ec6445f7194e25b9101d4fbcb07a18",22930920,1,1,0,231,80,81,1
"f8ec6445f7194e25b9101d4fbcb07a18","f8ec6445f7194e25b9101d4fbcb07a18",22930920,2,0,1,232,81,81,0
"f8ec6445f7194e25b9101d4fbcb07a18","140d5b27b8574befad82c0a013b59dfa",22930920,1,-7,0,234,81,74,-7
"140d5b27b8574befad82c0a013b59dfa","d18a9ea32855445f8736581f5cb119ce",22930920,1,9,0,235,74,82,8
"d18a9ea32855445f8736581f5cb119ce","f564483cbd7a407681aa2fcca518cf5f",22930920,1,4,0,236,82,85,3
"f564483cbd7a407681aa2fcca518cf5f","f564483cbd7a407681aa2fcca518cf5f",22930920,4,0,1,237,85,85,0
"f564483cbd7a407681aa2fcca518cf5f","18fd01350bd5434ca636d59a599d768a",22930920,1,1,0,241,85,86,1
"18fd01350bd5434ca636d59a599d768a","18fd01350bd5434ca636d59a599d768a",22930920,8,0,1,242,86,86,0
"18fd01350bd5434ca636d59a599d768a","ae5ac430ea254e708a6f5deaaf7464ae",22930920,1,-2,0,250,86,84,-2
"ae5ac430ea254e708a6f5deaaf7464ae","6a9f0ef185fb47f0937e29daa1c71ed5",22930920,1,7,0,251,84,90,6
"6a9f0ef185fb47f0937e29daa1c71ed5","e20db35ced8544ddac5bc3839145e463",22930920,2,3,0,252,90,91,1
"e20db35ced8544ddac5bc3839145e463","d646286c8051419bbc2e31dd1db55ca8",22930920,2,-30,0,253,91,67,-24
"d646286c8051419bbc2e31dd1db55ca8","d646286c8051419bbc2e31dd1db55ca8",22930920,1,0,1,254,67,67,0
"d646286c8051419bbc2e31dd1db55ca8","e20db35ced8544ddac5bc3839145e463",22930920,1,30,0,255,67,91,24
"e20db35ced8544ddac5bc3839145e463","6a9f0ef185fb47f0937e29daa1c71ed5",22930920,1,-3,0,256,91,90,-1
"6a9f0ef185fb47f0937e29daa1c71ed5","c681290961c94c4caf23b529d1ae6b9a",22930920,1,-2,0,257,90,88,-2
"c681290961c94c4caf23b529d1ae6b9a","c681290961c94c4caf23b529d1ae6b9a",22930920,1,0,1,258,88,88,0
"c681290961c94c4caf23b529d1ae6b9a","6a9f0ef185fb47f0937e29daa1c71ed5",22930920,1,2,0,259,88,90,2
"6a9f0ef185fb47f0937e29daa1c71ed5","6a9f0ef185fb47f0937e29daa1c71ed5",22930920,3,0,1,260,90,90,0
"d646286c8051419bbc2e31dd1db55ca8","78adeee1fa2c4fe0bc73f7bca9fcee86",22930920,1,115,0,265,67,160,93
"65202579580f4ad38d734b4ee39d22a8","78adeee1fa2c4fe0bc73f7bca9fcee86",22930920,2,-5,0,267,164,160,-4
"65202579580f4ad38d734b4ee39d22a8","b534b89233134e30a9b5645138bfa9ee",22930920,2,-153,0,290,164,41,-123
"b534b89233134e30a9b5645138bfa9ee","78adeee1fa2c4fe0bc73f7bca9fcee86",22930920,1,148,0,291,41,160,119
"78adeee1fa2c4fe0bc73f7bca9fcee86","78adeee1fa2c4fe0bc73f7bca9fcee86",22930920,4,0,1,292,160,160,0
"b534b89233134e30a9b5645138bfa9ee","0d987bed3ffa4ed0b9a2e62e97b7b30f",22930920,1,300,0,338,41,272,231
"0d987bed3ffa4ed0b9a2e62e97b7b30f","0d987bed3ffa4ed0b9a2e62e97b7b30f",22930920,4,0,1,339,272,272,0
"bb5a47f5ea01454a8b79455422d3b9da","82ae07bc0c9b4570a41799290d1ef399",22930920,2,-6,0,341,280,275,-5
"82ae07bc0c9b4570a41799290d1ef399","bb5a47f5ea01454a8b79455422d3b9da",22930920,3,6,0,342,275,280,5
"bb5a47f5ea01454a8b79455422d3b9da","b7719e26494940efa49512aedd0aac79",22930920,1,-354,0,349,280,20,-260
"b7719e26494940efa49512aedd0aac79","a49d1bb4328949299686242fd0be5584",22930920,2,2,0,350,20,21,1
"a49d1bb4328949299686242fd0be5584","b7719e26494940efa49512aedd0aac79",22930920,1,-2,0,351,21,20,-1
"a49d1bb4328949299686242fd0be5584","d4f45188d3c84a02ba08454e6403a818",22930920,1,3,0,353,21,24,3
"d4f45188d3c84a02ba08454e6403a818","d4c3b003e8274e429d2fa688d73fde6d",22930920,3,-2,0,354,24,22,-2
"d4c3b003e8274e429d2fa688d73fde6d","d4c3b003e8274e429d2fa688d73fde6d",22930920,13,0,1,355,22,22,0
"d4c3b003e8274e429d2fa688d73fde6d","b534b89233134e30a9b5645138bfa9ee",22930920,1,41,0,356,22,41,19
"b534b89233134e30a9b5645138bfa9ee","12aa6e1672ac4e7aa6449a7a8609cd72",22930920,1,19,0,357,41,57,16
"12aa6e1672ac4e7aa6449a7a8609cd72","78f30e4dcac84e3cbea8b2cc6e0d62b3",22930920,1,2,0,358,57,59,2
"a1f2f12debe5432fb7a70bcd12bacfb9","12aa6e1672ac4e7aa6449a7a8609cd72",22930920,1,-1,0,360,58,57,-1
"309ccf3cc4fe429d9bfbaef53d3fa479","67a089198fcb4e1c8f2385786c2b296f",22930920,1,-27,0,368,60,39,-21
"67a089198fcb4e1c8f2385786c2b296f","e20db35ced8544ddac5bc3839145e463",22930920,1,67,0,369,39,91,52
"e20db35ced8544ddac5bc3839145e463","1febb706d7a34005ae8711ed49c76e64",22930920,1,3,0,370,91,94,3
"1febb706d7a34005ae8711ed49c76e64","1febb706d7a34005ae8711ed49c76e64",22930920,2,0,1,371,94,94,0
"1febb706d7a34005ae8711ed49c76e64","8f73ba6f5a0042f2850356ac38ac6f24",22930920,1,1,0,373,94,95,1
"8f73ba6f5a0042f2850356ac38ac6f24","8f73ba6f5a0042f2850356ac38ac6f24",22930920,5,0,1,374,95,95,0
"8f73ba6f5a0042f2850356ac38ac6f24","e2260b86653c46d7b14a41fb419dbf8c",22930920,1,1,0,379,95,96,1
"e2260b86653c46d7b14a41fb419dbf8c","e2260b86653c46d7b14a41fb419dbf8c",22930920,2,0,1,380,96,96,0
"e2260b86653c46d7b14a41fb419dbf8c","35eb641ad1d845bbba54915bce75a962",22930920,1,1,0,382,96,97,1
"35eb641ad1d845bbba54915bce75a962","35eb641ad1d845bbba54915bce75a962",22930920,2,0,1,383,97,97,0
"35eb641ad1d845bbba54915bce75a962","08be90ffbeea4795a138cd42ed8db56f",22930920,1,1,0,385,97,98,1
"08be90ffbeea4795a138cd42ed8db56f","08be90ffbeea4795a138cd42ed8db56f",22930920,5,0,1,386,98,98,0
"08be90ffbeea4795a138cd42ed8db56f","3007433c8f584dcbb5ac159c1c5f2be3",22930920,1,1,0,391,98,99,1
"3007433c8f584dcbb5ac159c1c5f2be3","3007433c8f584dcbb5ac159c1c5f2be3",22930920,5,0,1,392,99,99,0
"3007433c8f584dcbb5ac159c1c5f2be3","e20db35ced8544ddac5bc3839145e463",22930920,1,-8,0,397,99,91,-8
"e20db35ced8544ddac5bc3839145e463","00ae5f0c51874a73a41ebea838d95682",22930920,1,11,0,398,91,101,10
"00ae5f0c51874a73a41ebea838d95682","d391c8b6e56a43a7b654e9dee02d904b",22930920,2,2,0,399,101,103,2
"d391c8b6e56a43a7b654e9dee02d904b","00ae5f0c51874a73a41ebea838d95682",22930920,1,-2,0,400,103,101,-2
"00ae5f0c51874a73a41ebea838d95682","00ae5f0c51874a73a41ebea838d95682",22930920,5,0,1,401,101,101,0
"d391c8b6e56a43a7b654e9dee02d904b","d391c8b6e56a43a7b654e9dee02d904b",22930920,18,0,1,407,103,103,0
"d391c8b6e56a43a7b654e9dee02d904b","6111116566fc4fd9abba409322bea245",22930920,1,1,0,425,103,104,1
"6111116566fc4fd9abba409322bea245","6111116566fc4fd9abba409322bea245",22930920,2,0,1,426,104,104,0
"6111116566fc4fd9abba409322bea245","2d4e0ab0ef3b4d73b82c72d4621a7579",22930920,1,2,0,428,104,106,2
"2d4e0ab0ef3b4d73b82c72d4621a7579","2d4e0ab0ef3b4d73b82c72d4621a7579",22930920,2,0,1,429,106,106,0
"2d4e0ab0ef3b4d73b82c72d4621a7579","8bdebf492ebd4e62b0d522e8ab5e5197",22930920,1,1,0,431,106,107,1
"8bdebf492ebd4e62b0d522e8ab5e5197","8bdebf492ebd4e62b0d522e8ab5e5197",22930920,8,0,1,432,107,107,0
"8bdebf492ebd4e62b0d522e8ab5e5197","4280927ec4d643238aa49c32f9e06c6c",22930920,1,3,0,440,107,109,2
"4280927ec4d643238aa49c32f9e06c6c","73039f8c1eb9409cb4caee2cf968001e",22930920,1,-10,0,441,109,100,-9
"73039f8c1eb9409cb4caee2cf968001e","4280927ec4d643238aa49c32f9e06c6c",22930920,1,10,0,442,100,109,9
"4280927ec4d643238aa49c32f9e06c6c","fc44e6a5f7654430af1227838224dceb",22930920,1,2,0,443,109,111,2
"fc44e6a5f7654430af1227838224dceb","fc44e6a5f7654430af1227838224dceb",22930920,2,0,1,444,111,111,0
"fc44e6a5f7654430af1227838224dceb","08111f75e22d409998cf8b85bd431f0a",22930920,1,-3,0,446,111,108,-3
"08111f75e22d409998cf8b85bd431f0a","a9ae0a3c070d455bb4369a8996313336",22930920,1,7,0,447,108,114,6
"a9ae0a3c070d455bb4369a8996313336","a9ae0a3c070d455bb4369a8996313336",22930920,2,0,1,448,114,114,0
"a9ae0a3c070d455bb4369a8996313336","71cec822bcff4f30a20e75dc63ef7b65",22930920,1,2,0,450,114,116,2
"71cec822bcff4f30a20e75dc63ef7b65","71cec822bcff4f30a20e75dc63ef7b65",22930920,5,0,1,451,116,116,0
"71cec822bcff4f30a20e75dc63ef7b65","37319e88176d4aefa91d7a9980dbae91",22930920,1,-4,0,456,116,112,-4
"37319e88176d4aefa91d7a9980dbae91","62bff51286ef4f348717a3cf6fe2318f",22930920,1,9,0,457,112,120,8
"62bff51286ef4f348717a3cf6fe2318f","62bff51286ef4f348717a3cf6fe2318f",22930920,4,0,1,458,120,120,0
"62bff51286ef4f348717a3cf6fe2318f","779f9ddd1fd14d1e9e69f72219a1fdbd",22930920,1,3,0,462,120,121,1
"779f9ddd1fd14d1e9e69f72219a1fdbd","e20db35ced8544ddac5bc3839145e463",22930920,1,-36,0,463,121,91,-30
"e20db35ced8544ddac5bc3839145e463","ae26e6cda8ad4a3f81bd347560d9579f",22930920,1,40,0,464,91,125,34
"ae26e6cda8ad4a3f81bd347560d9579f","ae26e6cda8ad4a3f81bd347560d9579f",22930920,1,0,1,465,125,125,0
"ae26e6cda8ad4a3f81bd347560d9579f","ee48df95832b4374aa273ceb27ec1315",22930920,1,1,0,466,125,126,1
"ee48df95832b4374aa273ceb27ec1315","ee48df95832b4374aa273ceb27ec1315",22930920,3,0,1,467,126,126,0
"ee48df95832b4374aa273ceb27ec1315","7a439da90b394756ad1777fc4c6dead5",22930920,1,1,0,470,126,127,1
"7a439da90b394756ad1777fc4c6dead5","7a439da90b394756ad1777fc4c6dead5",22930920,1,0,1,471,127,127,0
"7a439da90b394756ad1777fc4c6dead5","779f9ddd1fd14d1e9e69f72219a1fdbd",22930920,1,-6,0,472,127,121,-6
"779f9ddd1fd14d1e9e69f72219a1fdbd","a8dd5213034441ac92724b4e83eb0bb2",22930920,2,9,0,473,121,129,8
"a8dd5213034441ac92724b4e83eb0bb2","a8dd5213034441ac92724b4e83eb0bb2",22930920,4,0,1,474,129,129,0
"a8dd5213034441ac92724b4e83eb0bb2","8115eab6556b45f5b415c3b8c26a12e5",22930920,1,2,0,478,129,131,2
"8115eab6556b45f5b415c3b8c26a12e5","8115eab6556b45f5b415c3b8c26a12e5",22930920,2,0,1,479,131,131,0
"8115eab6556b45f5b415c3b8c26a12e5","ec34b06efd844b46a4c4818ecdb9b8f4",22930920,1,1,0,481,131,132,1
"ec34b06efd844b46a4c4818ecdb9b8f4","ec34b06efd844b46a4c4818ecdb9b8f4",22930920,2,0,1,482,132,132,0
"ec34b06efd844b46a4c4818ecdb9b8f4","c2e1c2b9eac64109b343a088584b576b",22930920,1,1,0,484,132,133,1
"c2e1c2b9eac64109b343a088584b576b","c2e1c2b9eac64109b343a088584b576b",22930920,2,0,1,485,133,133,0
"c2e1c2b9eac64109b343a088584b576b","579338175e0b4bbb8ef3b712b5d8b54e",22930920,1,-5,0,487,133,128,-5
"579338175e0b4bbb8ef3b712b5d8b54e","8bc5795d6a984a3eace4e2811e52dd4f",22930920,1,8,0,488,128,135,7
"8bc5795d6a984a3eace4e2811e52dd4f","8bc5795d6a984a3eace4e2811e52dd4f",22930920,3,0,1,489,135,135,0
"8bc5795d6a984a3eace4e2811e52dd4f","b416d47c56a742199b5d7c7f19d6503a",22930920,1,-1,0,492,135,134,-1
"b416d47c56a742199b5d7c7f19d6503a","779f9ddd1fd14d1e9e69f72219a1fdbd",22930920,1,-15,0,493,134,121,-13
"779f9ddd1fd14d1e9e69f72219a1fdbd","779f9ddd1fd14d1e9e69f72219a1fdbd",22930920,1,0,1,494,121,121,0
"a8dd5213034441ac92724b4e83eb0bb2","579338175e0b4bbb8ef3b712b5d8b54e",22930920,1,-1,0,496,129,128,-1
"579338175e0b4bbb8ef3b712b5d8b54e","b416d47c56a742199b5d7c7f19d6503a",22930920,2,7,0,497,128,134,6
"b416d47c56a742199b5d7c7f19d6503a","f661500307d74c908e9207d949ceb4aa",22930920,1,3,0,498,134,136,2
"f661500307d74c908e9207d949ceb4aa","a8dd5213034441ac92724b4e83eb0bb2",22930920,1,-9,0,499,136,129,-7
"a8dd5213034441ac92724b4e83eb0bb2","b416d47c56a742199b5d7c7f19d6503a",22930920,1,6,0,500,129,134,5
"b416d47c56a742199b5d7c7f19d6503a","579338175e0b4bbb8ef3b712b5d8b54e",22930920,1,-7,0,501,134,128,-6
"579338175e0b4bbb8ef3b712b5d8b54e","a8dd5213034441ac92724b4e83eb0bb2",22930920,1,1,0,502,128,129,1
"a8dd5213034441ac92724b4e83eb0bb2","779f9ddd1fd14d1e9e69f72219a1fdbd",22930920,1,-9,0,503,129,121,-8
"779f9ddd1fd14d1e9e69f72219a1fdbd","579338175e0b4bbb8ef3b712b5d8b54e",22930920,1,8,0,504,121,128,7
"b416d47c56a742199b5d7c7f19d6503a","cd4532ad48034873ba8bce2aac0c9808",22930920,1,4,0,506,134,137,3
"cd4532ad48034873ba8bce2aac0c9808","cd4532ad48034873ba8bce2aac0c9808",22930920,1,0,1,507,137,137,0
"cd4532ad48034873ba8bce2aac0c9808","779f9ddd1fd14d1e9e69f72219a1fdbd",22930920,1,-19,0,508,137,121,-16
"779f9ddd1fd14d1e9e69f72219a1fdbd","df1de691dafe4549a18a4398ee9dfaf9",22930920,1,23,0,509,121,139,18
"df1de691dafe4549a18a4398ee9dfaf9","6c5ad271a44743479bfaea29b1db8d02",22930920,2,4,0,510,139,143,4
"6c5ad271a44743479bfaea29b1db8d02","6c5ad271a44743479bfaea29b1db8d02",22930920,1,0,1,511,143,143,0
"6c5ad271a44743479bfaea29b1db8d02","83d311bed5374fee83d8d67a7d9d82dc",22930920,1,1,0,512,143,144,1
"83d311bed5374fee83d8d67a7d9d82dc","83d311bed5374fee83d8d67a7d9d82dc",22930920,1,0,1,513,144,144,0
"83d311bed5374fee83d8d67a7d9d82dc","402bba41861d43acb52a5abb89e8831e",22930920,1,1,0,514,144,145,1
"402bba41861d43acb52a5abb89e8831e","402bba41861d43acb52a5abb89e8831e",22930920,2,0,1,515,145,145,0
"402bba41861d43acb52a5abb89e8831e","df1de691dafe4549a18a4398ee9dfaf9",22930920,1,-6,0,517,145,139,-6
"df1de691dafe4549a18a4398ee9dfaf9","8aae34f5ddbb4052a709b12e6b0d40fa",22930920,1,9,0,518,139,147,8
"8aae34f5ddbb4052a709b12e6b0d40fa","8aae34f5ddbb4052a709b12e6b0d40fa",22930920,2,0,1,519,147,147,0
"8aae34f5ddbb4052a709b12e6b0d40fa","645b3f0249f64f76af2e19eb4d0e55b7",22930920,1,2,0,521,147,149,2
"645b3f0249f64f76af2e19eb4d0e55b7","645b3f0249f64f76af2e19eb4d0e55b7",22930920,5,0,1,522,149,149,0
"645b3f0249f64f76af2e19eb4d0e55b7","7e7b8db5064d4369805ab370aac5ddfb",22930920,1,1,0,527,149,150,1
"7e7b8db5064d4369805ab370aac5ddfb","7e7b8db5064d4369805ab370aac5ddfb",22930920,5,0,1,528,150,150,0
"7e7b8db5064d4369805ab370aac5ddfb","8956d210ae7f41968fada86d4c979d6a",22930920,1,1,0,533,150,151,1
"8956d210ae7f41968fada86d4c979d6a","8956d210ae7f41968fada86d4c979d6a",22930920,2,0,1,534,151,151,0
"8956d210ae7f41968fada86d4c979d6a","f902b0f41b544d4dbf79664fd233648d",22930920,1,-5,0,536,151,146,-5
"f902b0f41b544d4dbf79664fd233648d","ae781e8b775e4ccd93bc800dad5c8376",22930920,1,8,0,537,146,153,7
"ae781e8b775e4ccd93bc800dad5c8376","ae781e8b775e4ccd93bc800dad5c8376",22930920,2,0,1,538,153,153,0
"ae781e8b775e4ccd93bc800dad5c8376","06882a8492d9499aa31555567f575ecb",22930920,1,1,0,540,153,154,1
"06882a8492d9499aa31555567f575ecb","06882a8492d9499aa31555567f575ecb",22930920,1,0,1,541,154,154,0
"06882a8492d9499aa31555567f575ecb","f293c508f409466a8f27ddd7d1e40b20",22930920,1,1,0,542,154,155,1
"f293c508f409466a8f27ddd7d1e40b20","f293c508f409466a8f27ddd7d1e40b20",22930920,2,0,1,543,155,155,0
"f293c508f409466a8f27ddd7d1e40b20","cc4ddef5bbbe48ebb605141b347c4ed1",22930920,1,1,0,545,155,156,1
"cc4ddef5bbbe48ebb605141b347c4ed1","cc4ddef5bbbe48ebb605141b347c4ed1",22930920,3,0,1,546,156,156,0
"cc4ddef5bbbe48ebb605141b347c4ed1","f03480cf4eba413194d7af52fc0e7f28",22930920,1,-4,0,549,156,152,-4
"f03480cf4eba413194d7af52fc0e7f28","d313cec988a84645bee413e8d4724a4b",22930920,1,7,0,550,152,158,6
"d313cec988a84645bee413e8d4724a4b","d313cec988a84645bee413e8d4724a4b",22930920,4,0,1,551,158,158,0
"d313cec988a84645bee413e8d4724a4b","dc60696c76a74368a60f72246e47700d",22930920,1,1,0,555,158,159,1
"dc60696c76a74368a60f72246e47700d","dc60696c76a74368a60f72246e47700d",22930920,1,0,1,556,159,159,0
"dc60696c76a74368a60f72246e47700d","df1de691dafe4549a18a4398ee9dfaf9",22930920,1,-23,0,557,159,139,-20
"df1de691dafe4549a18a4398ee9dfaf9","78adeee1fa2c4fe0bc73f7bca9fcee86",22930920,1,26,0,558,139,160,21
"78adeee1fa2c4fe0bc73f7bca9fcee86","3cbcea2be0984e7dbd5a48195af10ce7",22930920,1,8,0,569,160,165,5
"3cbcea2be0984e7dbd5a48195af10ce7","82e6285962b8400d9d6fc32436022a94",22930920,1,2,0,570,165,167,2
"82e6285962b8400d9d6fc32436022a94","a9ac840f098c4bd0a2ee896214ce29cd",22930920,1,3,0,571,167,168,1
"a9ac840f098c4bd0a2ee896214ce29cd","3cbcea2be0984e7dbd5a48195af10ce7",22930920,1,-5,0,572,168,165,-3
"3cbcea2be0984e7dbd5a48195af10ce7","a9ac840f098c4bd0a2ee896214ce29cd",22930920,1,5,0,573,165,168,3
"a9ac840f098c4bd0a2ee896214ce29cd","0c7262dff33c4087bc660ccf40f92f9c",22930920,1,4,0,574,168,169,1
"0c7262dff33c4087bc660ccf40f92f9c","b2275c3fad834f8d90737a2d9a6927d6",22930920,1,3,0,575,169,172,3
"b2275c3fad834f8d90737a2d9a6927d6","b2275c3fad834f8d90737a2d9a6927d6",22930920,39,0,1,576,172,172,0
"b2275c3fad834f8d90737a2d9a6927d6","eb515a26030b41f8a82a1e6114420bad",22930920,1,1,0,615,172,173,1
"eb515a26030b41f8a82a1e6114420bad","eb515a26030b41f8a82a1e6114420bad",22930920,8,0,1,616,173,173,0
"eb515a26030b41f8a82a1e6114420bad","b42cc17b7de840f181a704558d0bc845",22930920,1,3,0,624,173,175,2
"b42cc17b7de840f181a704558d0bc845","0c7262dff33c4087bc660ccf40f92f9c",22930920,1,-7,0,625,175,169,-6
"0c7262dff33c4087bc660ccf40f92f9c","b42cc17b7de840f181a704558d0bc845",22930920,1,7,0,626,169,175,6
"b42cc17b7de840f181a704558d0bc845","b42cc17b7de840f181a704558d0bc845",22930920,2,0,1,627,175,175,0
"b42cc17b7de840f181a704558d0bc845","801f9e9135034f49bf5f8b4bdefedb41",22930920,1,2,0,629,175,177,2
"801f9e9135034f49bf5f8b4bdefedb41","801f9e9135034f49bf5f8b4bdefedb41",22930920,7,0,1,630,177,177,0
"801f9e9135034f49bf5f8b4bdefedb41","362fcb0699a14845ab29b2340093e528",22930920,1,-3,0,637,177,174,-3
"362fcb0699a14845ab29b2340093e528","ea38cc0e6e6e41edbabf210220808bf9",22930920,1,6,0,638,174,179,5
"ea38cc0e6e6e41edbabf210220808bf9","b87c552dd247427abe6ab5795b9c9d43",22930920,2,2,0,639,179,181,2
"b87c552dd247427abe6ab5795b9c9d43","ea38cc0e6e6e41edbabf210220808bf9",22930920,1,-2,0,640,181,179,-2
"b87c552dd247427abe6ab5795b9c9d43","b87c552dd247427abe6ab5795b9c9d43",22930920,7,0,1,642,181,181,0
"b87c552dd247427abe6ab5795b9c9d43","139b097acfca451689d80c9c6eebdf7b",22930920,1,-3,0,649,181,178,-3
"139b097acfca451689d80c9c6eebdf7b","30f660a1feb34582a739722532524f79",22930920,1,6,0,650,178,183,5
"30f660a1feb34582a739722532524f79","30f660a1feb34582a739722532524f79",22930920,7,0,1,651,183,183,0
"30f660a1feb34582a739722532524f79","2024b4885bd14338a39b7b509acbbd02",22930920,1,-1,0,658,183,182,-1
"2024b4885bd14338a39b7b509acbbd02","c3f63fe50d8e487c86bf8ef76c9cadd3",22930920,1,4,0,659,182,185,3
"c3f63fe50d8e487c86bf8ef76c9cadd3","c3f63fe50d8e487c86bf8ef76c9cadd3",22930920,1,0,1,660,185,185,0
"c3f63fe50d8e487c86bf8ef76c9cadd3","0c7262dff33c4087bc660ccf40f92f9c",22930920,1,-20,0,661,185,169,-16
"0c7262dff33c4087bc660ccf40f92f9c","c8e371568a0c4391b25796ae4e91952e",22930920,1,23,0,662,169,186,17
"c8e371568a0c4391b25796ae4e91952e","7d932b23e1c84326ae5aa4d3c0d813d1",22930920,1,2,0,663,186,188,2
"7d932b23e1c84326ae5aa4d3c0d813d1","7d932b23e1c84326ae5aa4d3c0d813d1",22930920,1,0,1,664,188,188,0
"7d932b23e1c84326ae5aa4d3c0d813d1","ab11d94c6c8948ea90b88f19d2cd502b",22930920,1,3,0,665,188,190,2
"ab11d94c6c8948ea90b88f19d2cd502b","c8e371568a0c4391b25796ae4e91952e",22930920,1,-5,0,666,190,186,-4
"c8e371568a0c4391b25796ae4e91952e","ab11d94c6c8948ea90b88f19d2cd502b",22930920,2,5,0,667,186,190,4
"ab11d94c6c8948ea90b88f19d2cd502b","ab11d94c6c8948ea90b88f19d2cd502b",22930920,4,0,1,668,190,190,0
"ab11d94c6c8948ea90b88f19d2cd502b","f992451ed6ad4e68bb9e68ad6be7c4be",22930920,1,2,0,672,190,192,2
"f992451ed6ad4e68bb9e68ad6be7c4be","f992451ed6ad4e68bb9e68ad6be7c4be",22930920,1,0,1,673,192,192,0
"f992451ed6ad4e68bb9e68ad6be7c4be","07b44a7a51e94c78b411c753fc39dab0",22930920,1,-3,0,674,192,189,-3
"07b44a7a51e94c78b411c753fc39dab0","6cd2dcaac46847d4a0bc53f296d90375",22930920,1,6,0,675,189,194,5
"6cd2dcaac46847d4a0bc53f296d90375","6cd2dcaac46847d4a0bc53f296d90375",22930920,1,0,1,676,194,194,0
"6cd2dcaac46847d4a0bc53f296d90375","2d2580c9411c4972909db508d6956a58",22930920,1,2,0,677,194,196,2
"2d2580c9411c4972909db508d6956a58","2d2580c9411c4972909db508d6956a58",22930920,5,0,1,678,196,196,0
"2d2580c9411c4972909db508d6956a58","5bddb3d9ed264f3984702f048c7e5340",22930920,1,1,0,683,196,197,1
"5bddb3d9ed264f3984702f048c7e5340","5bddb3d9ed264f3984702f048c7e5340",22930920,2,0,1,684,197,197,0
"5bddb3d9ed264f3984702f048c7e5340","d5e8e2bd12a2466b9d6d90855f0eb079",22930920,1,1,0,686,197,198,1
"d5e8e2bd12a2466b9d6d90855f0eb079","d5e8e2bd12a2466b9d6d90855f0eb079",22930920,2,0,1,687,198,198,0
"d5e8e2bd12a2466b9d6d90855f0eb079","017d7ca8e0394b91aaadc9574df2202c",22930920,1,-5,0,689,198,193,-5
"017d7ca8e0394b91aaadc9574df2202c","54e8e9f0ea3e45c4bf3b8ac799ee31b1",22930920,1,8,0,690,193,200,7
"54e8e9f0ea3e45c4bf3b8ac799ee31b1","54e8e9f0ea3e45c4bf3b8ac799ee31b1",22930920,1,0,1,691,200,200,0
"54e8e9f0ea3e45c4bf3b8ac799ee31b1","c614a00911be4877a075f19315530fb0",22930920,1,1,0,692,200,201,1
"c614a00911be4877a075f19315530fb0","c614a00911be4877a075f19315530fb0",22930920,6,0,1,693,201,201,0
"c614a00911be4877a075f19315530fb0","a6c21bd8b95249c7972820a7a7d76aff",22930920,1,1,0,699,201,202,1
"a6c21bd8b95249c7972820a7a7d76aff","a6c21bd8b95249c7972820a7a7d76aff",22930920,1,0,1,700,202,202,0
"a6c21bd8b95249c7972820a7a7d76aff","bb329d880ab54120adaf203a693bb203",22930920,1,1,0,701,202,203,1
"bb329d880ab54120adaf203a693bb203","bb329d880ab54120adaf203a693bb203",22930920,1,0,1,702,203,203,0
"bb329d880ab54120adaf203a693bb203","f9170dd6bc6442b4acd832747609b09a",22930920,1,-4,0,703,203,199,-4
"f9170dd6bc6442b4acd832747609b09a","c8e371568a0c4391b25796ae4e91952e",22930920,1,-16,0,704,199,186,-13
"c8e371568a0c4391b25796ae4e91952e","c8e371568a0c4391b25796ae4e91952e",22930920,1,0,1,705,186,186,0
"ab11d94c6c8948ea90b88f19d2cd502b","6cd2dcaac46847d4a0bc53f296d90375",22930920,1,5,0,707,190,194,4
"6cd2dcaac46847d4a0bc53f296d90375","07b44a7a51e94c78b411c753fc39dab0",22930920,1,-6,0,708,194,189,-5
"07b44a7a51e94c78b411c753fc39dab0","017d7ca8e0394b91aaadc9574df2202c",22930920,1,5,0,709,189,193,4
"017d7ca8e0394b91aaadc9574df2202c","f9170dd6bc6442b4acd832747609b09a",22930920,1,7,0,710,193,199,6
"f9170dd6bc6442b4acd832747609b09a","334c2344009840079b1d0e1b7ce3d5a7",22930920,1,7,0,711,199,205,6
"334c2344009840079b1d0e1b7ce3d5a7","334c2344009840079b1d0e1b7ce3d5a7",22930920,1,0,1,712,205,205,0
"334c2344009840079b1d0e1b7ce3d5a7","c8e371568a0c4391b25796ae4e91952e",22930920,1,-23,0,713,205,186,-19
"c8e371568a0c4391b25796ae4e91952e","d7f13c8d63ec4e2aa673fbb9cf9c6933",22930920,1,26,0,714,186,206,20
"d7f13c8d63ec4e2aa673fbb9cf9c6933","7108f0e4c2584f1f9c471689ae4c885c",22930920,1,2,0,715,206,208,2
"7108f0e4c2584f1f9c471689ae4c885c","b9e80f77c3a44349863b19875725c384",22930920,1,-1,0,716,208,207,-1
"b9e80f77c3a44349863b19875725c384","b9e80f77c3a44349863b19875725c384",22930920,22,0,1,717,207,207,0
"b9e80f77c3a44349863b19875725c384","7108f0e4c2584f1f9c471689ae4c885c",22930920,1,1,0,739,207,208,1
"7108f0e4c2584f1f9c471689ae4c885c","7108f0e4c2584f1f9c471689ae4c885c",22930920,11,0,1,740,208,208,0
"7108f0e4c2584f1f9c471689ae4c885c","09400e101c5d4b439cf9a26b03aae558",22930920,1,3,0,751,208,210,2
"09400e101c5d4b439cf9a26b03aae558","d7f13c8d63ec4e2aa673fbb9cf9c6933",22930920,1,-5,0,752,210,206,-4
"d7f13c8d63ec4e2aa673fbb9cf9c6933","09400e101c5d4b439cf9a26b03aae558",22930920,1,5,0,753,206,210,4
"09400e101c5d4b439cf9a26b03aae558","a88efa7e50ce47159810ab553afa6d3a",22930920,1,2,0,754,210,212,2
"a88efa7e50ce47159810ab553afa6d3a","a88efa7e50ce47159810ab553afa6d3a",22930920,5,0,1,755,212,212,0
"a88efa7e50ce47159810ab553afa6d3a","a875096404ef4a9984b62d74cda916f9",22930920,1,-3,0,760,212,209,-3
"a875096404ef4a9984b62d74cda916f9","be502a7a43c44bf7b682698de79d9369",22930920,1,6,0,761,209,214,5
"be502a7a43c44bf7b682698de79d9369","f7fb1952f56b4189b86a9f8b7862d2b8",22930920,2,1,0,762,214,215,1
"f7fb1952f56b4189b86a9f8b7862d2b8","be502a7a43c44bf7b682698de79d9369",22930920,1,-1,0,763,215,214,-1
"be502a7a43c44bf7b682698de79d9369","be502a7a43c44bf7b682698de79d9369",22930920,4,0,1,764,214,214,0
"f7fb1952f56b4189b86a9f8b7862d2b8","f7fb1952f56b4189b86a9f8b7862d2b8",22930920,11,0,1,769,215,215,0
"f7fb1952f56b4189b86a9f8b7862d2b8","b860ee85d8bc4a2f97958cfb71be3533",22930920,1,1,0,780,215,216,1
"b860ee85d8bc4a2f97958cfb71be3533","b860ee85d8bc4a2f97958cfb71be3533",22930920,2,0,1,781,216,216,0
"b860ee85d8bc4a2f97958cfb71be3533","ec341f459285443b8361f7f15638ff08",22930920,1,-3,0,783,216,213,-3
"ec341f459285443b8361f7f15638ff08","363837c182e04711840d896ae1e0339c",22930920,1,6,0,784,213,218,5
"363837c182e04711840d896ae1e0339c","363837c182e04711840d896ae1e0339c",22930920,13,0,1,785,218,218,0
"363837c182e04711840d896ae1e0339c","01b2051f8941460d89945e3b02d1ce78",22930920,1,-1,0,798,218,217,-1
"01b2051f8941460d89945e3b02d1ce78","91125ca626c5470eb145501f8c37f8db",22930920,1,4,0,799,217,220,3
"91125ca626c5470eb145501f8c37f8db","91125ca626c5470eb145501f8c37f8db",22930920,3,0,1,800,220,220,0
"91125ca626c5470eb145501f8c37f8db","d7f13c8d63ec4e2aa673fbb9cf9c6933",22930920,1,-18,0,803,220,206,-14
"d7f13c8d63ec4e2aa673fbb9cf9c6933","1c6721b1f63f4d30ba7746ea8af02a52",22930920,1,21,0,804,206,221,15
"1c6721b1f63f4d30ba7746ea8af02a52","77ecef8eff6b4a2caea7707669bf7475",22930920,1,1,0,805,221,222,1
"77ecef8eff6b4a2caea7707669bf7475","77ecef8eff6b4a2caea7707669bf7475",22930920,12,0,1,806,222,222,0
"77ecef8eff6b4a2caea7707669bf7475","1c6721b1f63f4d30ba7746ea8af02a52",22930920,1,-1,0,818,222,221,-1
"1c6721b1f63f4d30ba7746ea8af02a52","d03cb855c70044cf8c35d9ec0de696e3",22930920,1,4,0,819,221,224,3
"d03cb855c70044cf8c35d9ec0de696e3","8b9ae98743bd4d4a8a87dff1c1244211",22930920,1,3,0,820,224,227,3
"8b9ae98743bd4d4a8a87dff1c1244211","d03cb855c70044cf8c35d9ec0de696e3",22930920,1,-3,0,821,227,224,-3
"d03cb855c70044cf8c35d9ec0de696e3","d03cb855c70044cf8c35d9ec0de696e3",22930920,3,0,1,822,224,224,0
"d03cb855c70044cf8c35d9ec0de696e3","a49a937d6896486d9a5396654abcf2e1",22930920,1,2,0,825,224,226,2
"a49a937d6896486d9a5396654abcf2e1","a49a937d6896486d9a5396654abcf2e1",22930920,3,0,1,826,226,226,0
"a49a937d6896486d9a5396654abcf2e1","8b9ae98743bd4d4a8a87dff1c1244211",22930920,1,1,0,829,226,227,1
"8b9ae98743bd4d4a8a87dff1c1244211","8b9ae98743bd4d4a8a87dff1c1244211",22930920,33,0,1,830,227,227,0
"8b9ae98743bd4d4a8a87dff1c1244211","2ab1535aac1346ba8801535bf729ef37",22930920,1,3,0,863,227,229,2
"2ab1535aac1346ba8801535bf729ef37","f7906d6f59b9489a91d2ef40db5a474d",22930920,1,-7,0,864,229,223,-6
"f7906d6f59b9489a91d2ef40db5a474d","2ab1535aac1346ba8801535bf729ef37",22930920,1,7,0,865,223,229,6
"2ab1535aac1346ba8801535bf729ef37","2ab1535aac1346ba8801535bf729ef37",22930920,2,0,1,866,229,229,0
"2ab1535aac1346ba8801535bf729ef37","a4f40fb48a8542c8949bae1f002cd9bc",22930920,1,2,0,868,229,231,2
"a4f40fb48a8542c8949bae1f002cd9bc","a4f40fb48a8542c8949bae1f002cd9bc",22930920,2,0,1,869,231,231,0
"a4f40fb48a8542c8949bae1f002cd9bc","8972c23e32044edb8a78fa1eed4e5947",22930920,1,1,0,871,231,232,1
"8972c23e32044edb8a78fa1eed4e5947","8972c23e32044edb8a78fa1eed4e5947",22930920,3,0,1,872,232,232,0
"8972c23e32044edb8a78fa1eed4e5947","92feb4a40f8344d38b6f722e42a53295",22930920,1,1,0,875,232,233,1
"92feb4a40f8344d38b6f722e42a53295","92feb4a40f8344d38b6f722e42a53295",22930920,2,0,1,876,233,233,0
"92feb4a40f8344d38b6f722e42a53295","5152833676bf4c6cb317060be10f68db",22930920,1,-5,0,878,233,228,-5
"5152833676bf4c6cb317060be10f68db","ca3e28f290354c08aefe5b0f769604e6",22930920,1,8,0,879,228,235,7
"ca3e28f290354c08aefe5b0f769604e6","ca3e28f290354c08aefe5b0f769604e6",22930920,14,0,1,880,235,235,0
"ca3e28f290354c08aefe5b0f769604e6","79a35eea833e4c2c9d22fc53c3c6445c",22930920,1,1,0,894,235,236,1
"79a35eea833e4c2c9d22fc53c3c6445c","79a35eea833e4c2c9d22fc53c3c6445c",22930920,14,0,1,895,236,236,0
"79a35eea833e4c2c9d22fc53c3c6445c","8f68228b1518449e9615cdafee41a2bd",22930920,1,1,0,909,236,237,1
"8f68228b1518449e9615cdafee41a2bd","8f68228b1518449e9615cdafee41a2bd",22930920,3,0,1,910,237,237,0
"8f68228b1518449e9615cdafee41a2bd","cab89fa5c3ed45a5aa550fc0352d6a42",22930920,1,1,0,913,237,238,1
"cab89fa5c3ed45a5aa550fc0352d6a42","cab89fa5c3ed45a5aa550fc0352d6a42",22930920,1,0,1,914,238,238,0
"cab89fa5c3ed45a5aa550fc0352d6a42","66d4fad4f1cf4b46be0750a99ad7a35a",22930920,1,1,0,915,238,239,1
"66d4fad4f1cf4b46be0750a99ad7a35a","66d4fad4f1cf4b46be0750a99ad7a35a",22930920,1,0,1,916,239,239,0
"66d4fad4f1cf4b46be0750a99ad7a35a","0b04c8e2f86d48c7aeb7e225819cd32b",22930920,1,-5,0,917,239,234,-5
"0b04c8e2f86d48c7aeb7e225819cd32b","df1de691dafe4549a18a4398ee9dfaf9",22930920,1,-129,0,918,234,139,-95
"6c5ad271a44743479bfaea29b1db8d02","0d987bed3ffa4ed0b9a2e62e97b7b30f",22930920,1,174,0,920,143,272,129
"0d987bed3ffa4ed0b9a2e62e97b7b30f","82ae07bc0c9b4570a41799290d1ef399",22930920,1,4,0,923,272,275,3
"bb5a47f5ea01454a8b79455422d3b9da","0d987bed3ffa4ed0b9a2e62e97b7b30f",22930920,2,-10,0,939,280,272,-8
"0d987bed3ffa4ed0b9a2e62e97b7b30f","94cecc3f1e7d484b8e068e79241dfd73",22930920,1,13,0,994,272,281,9
"94cecc3f1e7d484b8e068e79241dfd73","a37477c4e4c14169ad44b06b493007f6",22930920,1,2,0,995,281,283,2
"a37477c4e4c14169ad44b06b493007f6","fab84b4fab5940efb4ea868ef8d09396",22930920,1,3,0,996,283,284,1
"fab84b4fab5940efb4ea868ef8d09396","94cecc3f1e7d484b8e068e79241dfd73",22930920,1,-5,0,997,284,281,-3
"94cecc3f1e7d484b8e068e79241dfd73","fab84b4fab5940efb4ea868ef8d09396",22930920,1,5,0,998,281,284,3
"fab84b4fab5940efb4ea868ef8d09396","4a29443515bb404cb8924e1c60a63b73",22930920,1,4,0,999,284,285,1
"4a29443515bb404cb8924e1c60a63b73","208c9b2796c944db8dacaa96082520ea",22930920,1,3,0,1000,285,288,3
"208c9b2796c944db8dacaa96082520ea","b71bac264efb4abd97015447bd490db6",22930920,1,107,0,1001,288,370,82
"b71bac264efb4abd97015447bd490db6","b71bac264efb4abd97015447bd490db6",22930920,1,0,1,1002,370,370,0
"b71bac264efb4abd97015447bd490db6","0c4079457ede49e3aeb5e86ed84bdf35",22930920,1,-52,0,1003,370,329,-41
"0c4079457ede49e3aeb5e86ed84bdf35","0c4079457ede49e3aeb5e86ed84bdf35",22930920,2,0,1,1004,329,329,0
"0c4079457ede49e3aeb5e86ed84bdf35","38aea304b4fa46e1b29bb72f5cea4c93",22930920,2,2,0,1005,329,331,2
"38aea304b4fa46e1b29bb72f5cea4c93","38aea304b4fa46e1b29bb72f5cea4c93",22930920,1,0,1,1006,331,331,0
"38aea304b4fa46e1b29bb72f5cea4c93","e36d261332f14e79bb4b467aceaeb9b5",22930920,1,2,0,1007,331,333,2
"e36d261332f14e79bb4b467aceaeb9b5","e36d261332f14e79bb4b467aceaeb9b5",22930920,1,0,1,1008,333,333,0
"e36d261332f14e79bb4b467aceaeb9b5","c7e89b9d04744d2eab742fc24e3ef1ae",22930920,1,1,0,1009,333,334,1
"c7e89b9d04744d2eab742fc24e3ef1ae","c7e89b9d04744d2eab742fc24e3ef1ae",22930920,2,0,1,1010,334,334,0
"c7e89b9d04744d2eab742fc24e3ef1ae","fe49f8054b374a0ea4bb266ed135ff62",22930920,1,1,0,1012,334,335,1
"fe49f8054b374a0ea4bb266ed135ff62","fe49f8054b374a0ea4bb266ed135ff62",22930920,5,0,1,1013,335,335,0
"fe49f8054b374a0ea4bb266ed135ff62","d0a8f74af98642fe8360d22c42e45117",22930920,1,1,0,1018,335,336,1
"d0a8f74af98642fe8360d22c42e45117","d0a8f74af98642fe8360d22c42e45117",22930920,5,0,1,1019,336,336,0
"d0a8f74af98642fe8360d22c42e45117","0c4079457ede49e3aeb5e86ed84bdf35",22930920,1,-7,0,1024,336,329,-7
"0c4079457ede49e3aeb5e86ed84bdf35","a7c6339ca1da4368a18d471f0519f877",22930920,1,11,0,1025,329,339,10
"a7c6339ca1da4368a18d471f0519f877","a7c6339ca1da4368a18d471f0519f877",22930920,1,0,1,1026,339,339,0
"a7c6339ca1da4368a18d471f0519f877","b8b9418ab322418d9db9b40d96af873a",22930920,1,-2,0,1027,339,337,-2
"b8b9418ab322418d9db9b40d96af873a","bbc5139ca9024389a94db3a6f47dcff6",22930920,1,5,0,1028,337,341,4
"bbc5139ca9024389a94db3a6f47dcff6","bbc5139ca9024389a94db3a6f47dcff6",22930920,5,0,1,1029,341,341,0
"bbc5139ca9024389a94db3a6f47dcff6","4ee6ca9019ab4a1ab323f98094a9bd77",22930920,1,2,0,1034,341,343,2
"4ee6ca9019ab4a1ab323f98094a9bd77","4ee6ca9019ab4a1ab323f98094a9bd77",22930920,2,0,1,1035,343,343,0
"4ee6ca9019ab4a1ab323f98094a9bd77","b37947176785476f8b29d49a851366dc",22930920,1,1,0,1037,343,344,1
"b37947176785476f8b29d49a851366dc","b37947176785476f8b29d49a851366dc",22930920,2,0,1,1038,344,344,0
"b37947176785476f8b29d49a851366dc","fcea5b10d5a14a3b9324ffece8f6e1e5",22930920,1,1,0,1040,344,345,1
"fcea5b10d5a14a3b9324ffece8f6e1e5","fcea5b10d5a14a3b9324ffece8f6e1e5",22930920,2,0,1,1041,345,345,0
"fcea5b10d5a14a3b9324ffece8f6e1e5","c2490bc612d146edbe786556fab3651b",22930920,1,-5,0,1043,345,340,-5
"c2490bc612d146edbe786556fab3651b","b7719e26494940efa49512aedd0aac79",22930920,1,-437,0,1044,340,20,-320
"b7719e26494940efa49512aedd0aac79","0c4079457ede49e3aeb5e86ed84bdf35",22930920,1,424,0,1045,20,329,309
"38aea304b4fa46e1b29bb72f5cea4c93","6ac8bb048b854999a47edb35fe627f11",22930920,1,19,0,1048,331,347,16
"6ac8bb048b854999a47edb35fe627f11","6ac8bb048b854999a47edb35fe627f11",22930920,3,0,1,1049,347,347,0
"6ac8bb048b854999a47edb35fe627f11","0c4079457ede49e3aeb5e86ed84bdf35",22930920,1,-21,0,1052,347,329,-18
"0c4079457ede49e3aeb5e86ed84bdf35","30ead9794d4847abaf222ca966cc8630",22930920,1,24,0,1053,329,348,19
"30ead9794d4847abaf222ca966cc8630","897b7f51242c44aab2205c72fdcbf4cd",22930920,1,4,0,1054,348,352,4
"897b7f51242c44aab2205c72fdcbf4cd","09b9678ddc3d452ea4a3d46e15826065",22930920,2,1,0,1055,352,353,1
"09b9678ddc3d452ea4a3d46e15826065","eff0de7f2dbb42dfa1a2e686efab5b6d",22930920,2,1,0,1056,353,354,1
"eff0de7f2dbb42dfa1a2e686efab5b6d","c20993c944444fe085345591a8bd837e",22930920,1,-3,0,1057,354,351,-3
"c20993c944444fe085345591a8bd837e","c20993c944444fe085345591a8bd837e",22930920,4,0,1,1058,351,351,0
"c20993c944444fe085345591a8bd837e","897b7f51242c44aab2205c72fdcbf4cd",22930920,1,1,0,1062,351,352,1
"897b7f51242c44aab2205c72fdcbf4cd","897b7f51242c44aab2205c72fdcbf4cd",22930920,3,0,1,1063,352,352,0
"09b9678ddc3d452ea4a3d46e15826065","09b9678ddc3d452ea4a3d46e15826065",22930920,3,0,1,1067,353,353,0
"eff0de7f2dbb42dfa1a2e686efab5b6d","eff0de7f2dbb42dfa1a2e686efab5b6d",22930920,3,0,1,1071,354,354,0
"eff0de7f2dbb42dfa1a2e686efab5b6d","30ead9794d4847abaf222ca966cc8630",22930920,1,-6,0,1074,354,348,-6
"30ead9794d4847abaf222ca966cc8630","2fe14166dc9642c3bc666b86a57f943d",22930920,1,10,0,1075,348,357,9
"2fe14166dc9642c3bc666b86a57f943d","2fe14166dc9642c3bc666b86a57f943d",22930920,5,0,1,1076,357,357,0
"2fe14166dc9642c3bc666b86a57f943d","44421dd1e13a47a388c4a19834b744c7",22930920,1,2,0,1081,357,359,2
"44421dd1e13a47a388c4a19834b744c7","44421dd1e13a47a388c4a19834b744c7",22930920,2,0,1,1082,359,359,0
"44421dd1e13a47a388c4a19834b744c7","cb5fc7ef85d547c4be1a7439d0bf6052",22930920,1,1,0,1084,359,360,1
"cb5fc7ef85d547c4be1a7439d0bf6052","cb5fc7ef85d547c4be1a7439d0bf6052",22930920,6,0,1,1085,360,360,0
"cb5fc7ef85d547c4be1a7439d0bf6052","0a8f150a4cf747acbde62f4721823da3",22930920,1,1,0,1091,360,361,1
"0a8f150a4cf747acbde62f4721823da3","0a8f150a4cf747acbde62f4721823da3",22930920,5,0,1,1092,361,361,0
"0a8f150a4cf747acbde62f4721823da3","ab8fdad974ae471f9f24c3f9dd04462e",22930920,1,1,0,1097,361,362,1
"ab8fdad974ae471f9f24c3f9dd04462e","ab8fdad974ae471f9f24c3f9dd04462e",22930920,2,0,1,1098,362,362,0
"ab8fdad974ae471f9f24c3f9dd04462e","1ba8fef685d74a8194b9db252eb704fb",22930920,1,-7,0,1100,362,355,-7
"1ba8fef685d74a8194b9db252eb704fb","52580888dadb4fe3baa795683ea227bd",22930920,1,10,0,1101,355,364,9
"52580888dadb4fe3baa795683ea227bd","52580888dadb4fe3baa795683ea227bd",22930920,1,0,1,1102,364,364,0
"52580888dadb4fe3baa795683ea227bd","f00179e251a045b39c3f7a54f9aa4acc",22930920,1,-1,0,1103,364,363,-1
"f00179e251a045b39c3f7a54f9aa4acc","492a3bc6a1254f23a7998587961b22a4",22930920,1,4,0,1104,363,366,3
"492a3bc6a1254f23a7998587961b22a4","492a3bc6a1254f23a7998587961b22a4",22930920,1,0,1,1105,366,366,0
"492a3bc6a1254f23a7998587961b22a4","072a190fd302456290895f9f04d6940a",22930920,1,-1,0,1106,366,365,-1
"072a190fd302456290895f9f04d6940a","b71bac264efb4abd97015447bd490db6",22930920,1,8,0,1107,365,370,5
"b71bac264efb4abd97015447bd490db6","8d448d625b024c82a5eb240bbd7431d6",22930920,3,5,0,1108,370,374,4
"8d448d625b024c82a5eb240bbd7431d6","8d448d625b024c82a5eb240bbd7431d6",22930920,56,0,1,1109,374,374,0
"8d448d625b024c82a5eb240bbd7431d6","b71bac264efb4abd97015447bd490db6",22930920,2,-5,0,1112,374,370,-4
"b71bac264efb4abd97015447bd490db6","d6d02b6ef04e4f17805504500b8ce441",22930920,1,8,0,1161,370,375,5
"d6d02b6ef04e4f17805504500b8ce441","d6d02b6ef04e4f17805504500b8ce441",22930920,2,0,1,1162,375,375,0
"d6d02b6ef04e4f17805504500b8ce441","66baf19b6b904b70922329068c63746d",22930920,1,4,0,1164,375,376,1
"66baf19b6b904b70922329068c63746d","7f544639412e40a9ba27f43b415362ab",22930920,3,2,0,1165,376,378,2
"7f544639412e40a9ba27f43b415362ab","66baf19b6b904b70922329068c63746d",22930920,1,-2,0,1166,378,376,-2
"7f544639412e40a9ba27f43b415362ab","b2f0d654738f48158edff28e8d3a546e",22930920,1,110,0,1168,378,449,71
"b2f0d654738f48158edff28e8d3a546e","b2f0d654738f48158edff28e8d3a546e",22930920,1,0,1,1169,449,449,0
"b2f0d654738f48158edff28e8d3a546e","f60ee41ec635499abd48168342d32c2f",22930920,4,5,0,1170,449,453,4
"f60ee41ec635499abd48168342d32c2f","f60ee41ec635499abd48168342d32c2f",22930920,63,0,1,1171,453,453,0
"f60ee41ec635499abd48168342d32c2f","b2f0d654738f48158edff28e8d3a546e",22930920,1,-5,0,1178,453,449,-4
"f60ee41ec635499abd48168342d32c2f","f67fbf45a5f146ed866965bc57c7c001",22930920,1,3,0,1222,453,454,1
"f67fbf45a5f146ed866965bc57c7c001","b2f0d654738f48158edff28e8d3a546e",22930920,1,-8,0,1223,454,449,-5
"b2f0d654738f48158edff28e8d3a546e","f67fbf45a5f146ed866965bc57c7c001",22930920,1,8,0,1224,449,454,5
"f67fbf45a5f146ed866965bc57c7c001","f67fbf45a5f146ed866965bc57c7c001",22930920,1,0,1,1225,454,454,0
"f67fbf45a5f146ed866965bc57c7c001","d937afe49bd24a07a550dda1c1155122",22930920,1,1,0,1226,454,455,1
"d937afe49bd24a07a550dda1c1155122","d937afe49bd24a07a550dda1c1155122",22930920,1,0,1,1227,455,455,0
"d937afe49bd24a07a550dda1c1155122","3628b3f7823443d0912a339096b69943",22930920,1,1,0,1228,455,456,1
"3628b3f7823443d0912a339096b69943","3628b3f7823443d0912a339096b69943",22930920,1,0,1,1229,456,456,0
"3628b3f7823443d0912a339096b69943","9e049ee647cf43ecbcb5ed792a8e7588",22930920,1,1,0,1230,456,457,1
"9e049ee647cf43ecbcb5ed792a8e7588","9e049ee647cf43ecbcb5ed792a8e7588",22930920,1,0,1,1231,457,457,0
"9e049ee647cf43ecbcb5ed792a8e7588","5256a214faaf410b93f76cea06428334",22930920,1,1,0,1232,457,458,1
"5256a214faaf410b93f76cea06428334","5256a214faaf410b93f76cea06428334",22930920,1,0,1,1233,458,458,0
"5256a214faaf410b93f76cea06428334","25c32b120fce40fa9b6c85133aeb4716",22930920,1,1,0,1234,458,459,1
"25c32b120fce40fa9b6c85133aeb4716","25c32b120fce40fa9b6c85133aeb4716",22930920,6,0,1,1235,459,459,0
"25c32b120fce40fa9b6c85133aeb4716","11bc14f2204949008b7d511b933363c1",22930920,1,1,0,1241,459,460,1
"11bc14f2204949008b7d511b933363c1","11bc14f2204949008b7d511b933363c1",22930920,1,0,1,1242,460,460,0
"11bc14f2204949008b7d511b933363c1","42de338840a34d15adb66e7b14fb9d2c",22930920,1,1,0,1243,460,461,1
"42de338840a34d15adb66e7b14fb9d2c","42de338840a34d15adb66e7b14fb9d2c",22930920,1,0,1,1244,461,461,0
"42de338840a34d15adb66e7b14fb9d2c","9da37c6210b1416b8079c274f70bf600",22930920,1,1,0,1245,461,462,1
"9da37c6210b1416b8079c274f70bf600","9da37c6210b1416b8079c274f70bf600",22930920,1,0,1,1246,462,462,0
"9da37c6210b1416b8079c274f70bf600","519119f1deac45ff9ab4f13529be5c6e",22930920,1,1,0,1247,462,463,1
"519119f1deac45ff9ab4f13529be5c6e","519119f1deac45ff9ab4f13529be5c6e",22930920,3,0,1,1248,463,463,0
"519119f1deac45ff9ab4f13529be5c6e","f67fbf45a5f146ed866965bc57c7c001",22930920,1,-9,0,1251,463,454,-9
"f67fbf45a5f146ed866965bc57c7c001","c5df9f40ec14463b9dcfdc73df3e9285",22930920,1,12,0,1252,454,464,10
"c5df9f40ec14463b9dcfdc73df3e9285","c5df9f40ec14463b9dcfdc73df3e9285",22930920,1,0,1,1253,464,464,0
"c5df9f40ec14463b9dcfdc73df3e9285","83d42d95cd844fc093fc09cee250edb8",22930920,2,3,0,1254,464,465,1
"83d42d95cd844fc093fc09cee250edb8","c5df9f40ec14463b9dcfdc73df3e9285",22930920,1,-3,0,1255,465,464,-1
"83d42d95cd844fc093fc09cee250edb8","83d42d95cd844fc093fc09cee250edb8",22930920,1,0,1,1257,465,465,0
"83d42d95cd844fc093fc09cee250edb8","66baf19b6b904b70922329068c63746d",22930920,1,-135,0,1258,465,376,-89
"66baf19b6b904b70922329068c63746d","66baf19b6b904b70922329068c63746d",22930920,1,0,1,1259,376,376,0
"7f544639412e40a9ba27f43b415362ab","7f544639412e40a9ba27f43b415362ab",22930920,2,0,1,1261,378,378,0
"7f544639412e40a9ba27f43b415362ab","d5ae8642e15b46b8bd298b02274d4e9c",22930920,1,2,0,1263,378,380,2
"d5ae8642e15b46b8bd298b02274d4e9c","d5ae8642e15b46b8bd298b02274d4e9c",22930920,1,0,1,1264,380,380,0
"d5ae8642e15b46b8bd298b02274d4e9c","a0d10309a2dd456289147f84be9d37f9",22930920,1,1,0,1265,380,381,1
"a0d10309a2dd456289147f84be9d37f9","a0d10309a2dd456289147f84be9d37f9",22930920,5,0,1,1266,381,381,0
"a0d10309a2dd456289147f84be9d37f9","0fcbc3ca07b144138b8d85da581f09a8",22930920,1,1,0,1271,381,382,1
"0fcbc3ca07b144138b8d85da581f09a8","0fcbc3ca07b144138b8d85da581f09a8",22930920,8,0,1,1272,382,382,0
"0fcbc3ca07b144138b8d85da581f09a8","66baf19b6b904b70922329068c63746d",22930920,1,-6,0,1280,382,376,-6
"66baf19b6b904b70922329068c63746d","4890121ce5d74576b4632b77cfc23398",22930920,1,14,0,1281,376,388,12
"4890121ce5d74576b4632b77cfc23398","c2fca3669923477ab966ded303dea31c",22930920,1,-6,0,1282,388,383,-5
"c2fca3669923477ab966ded303dea31c","4890121ce5d74576b4632b77cfc23398",22930920,1,6,0,1283,383,388,5
"4890121ce5d74576b4632b77cfc23398","18d3b836dd804224883cc9180b60a8e1",22930920,1,-1,0,1284,388,387,-1
"18d3b836dd804224883cc9180b60a8e1","96bb2b3e85a34d8b9544514e89f6fe97",22930920,1,4,0,1285,387,390,3
"96bb2b3e85a34d8b9544514e89f6fe97","96bb2b3e85a34d8b9544514e89f6fe97",22930920,1,0,1,1286,390,390,0
"96bb2b3e85a34d8b9544514e89f6fe97","ac4e9b54acfe4670b4634859c7263cb5",22930920,1,2,0,1287,390,392,2
"ac4e9b54acfe4670b4634859c7263cb5","ac4e9b54acfe4670b4634859c7263cb5",22930920,3,0,1,1288,392,392,0
"ac4e9b54acfe4670b4634859c7263cb5","17f95d18bab743888e1736033dc3384d",22930920,1,-3,0,1291,392,389,-3
"17f95d18bab743888e1736033dc3384d","6f8881a745ac4c358a68b92c3b4abe81",22930920,1,6,0,1292,389,394,5
"6f8881a745ac4c358a68b92c3b4abe81","6f8881a745ac4c358a68b92c3b4abe81",22930920,3,0,1,1293,394,394,0
"6f8881a745ac4c358a68b92c3b4abe81","f7002c8484354eceac57bc7bd62c76c1",22930920,1,-1,0,1296,394,393,-1
"f7002c8484354eceac57bc7bd62c76c1","44a277ea44dc4ae689fab4b82f0b4098",22930920,1,5,0,1297,393,397,4
"44a277ea44dc4ae689fab4b82f0b4098","44a277ea44dc4ae689fab4b82f0b4098",22930920,1,0,1,1298,397,397,0
"44a277ea44dc4ae689fab4b82f0b4098","0c12af0a4e7f4002852cf84b2537c161",22930920,1,-2,0,1299,397,395,-2
"0c12af0a4e7f4002852cf84b2537c161","859e0b8d71694b12befb69ee698138f9",22930920,1,5,0,1300,395,399,4
"859e0b8d71694b12befb69ee698138f9","859e0b8d71694b12befb69ee698138f9",22930920,1,0,1,1301,399,399,0
"859e0b8d71694b12befb69ee698138f9","66baf19b6b904b70922329068c63746d",22930920,1,-29,0,1302,399,376,-23
"66baf19b6b904b70922329068c63746d","2b09a08242b54983aec7063990fb3f66",22930920,1,32,0,1303,376,400,24
"2b09a08242b54983aec7063990fb3f66","2b09a08242b54983aec7063990fb3f66",22930920,2,0,1,1304,400,400,0
"2b09a08242b54983aec7063990fb3f66","1f471b7a883a4df48211e8c6a81b59a7",22930920,1,1,0,1306,400,401,1
"1f471b7a883a4df48211e8c6a81b59a7","1f471b7a883a4df48211e8c6a81b59a7",22930920,1,0,1,1307,401,401,0
"1f471b7a883a4df48211e8c6a81b59a7","2b09a08242b54983aec7063990fb3f66",22930920,1,-1,0,1308,401,400,-1
"2b09a08242b54983aec7063990fb3f66","9de0d567bfa84fe5b77cb76f4a76a5d1",22930920,1,5,0,1309,400,404,4
"9de0d567bfa84fe5b77cb76f4a76a5d1","9de0d567bfa84fe5b77cb76f4a76a5d1",22930920,1,0,1,1310,404,404,0
"9de0d567bfa84fe5b77cb76f4a76a5d1","1157bd665ec4472fb58b751dc5099355",22930920,1,-1,0,1311,404,403,-1
"1157bd665ec4472fb58b751dc5099355","78adeee1fa2c4fe0bc73f7bca9fcee86",22930920,1,-332,0,1312,403,160,-243
"78adeee1fa2c4fe0bc73f7bca9fcee86","65202579580f4ad38d734b4ee39d22a8",22930920,5,5,0,1313,160,164,4
"65202579580f4ad38d734b4ee39d22a8","65202579580f4ad38d734b4ee39d22a8",22930920,77,0,1,1314,164,164,0
"65202579580f4ad38d734b4ee39d22a8","bc5524e78a8544e2ae2fdc2f3462bbec",22930920,1,156,0,1321,164,279,115
"bc5524e78a8544e2ae2fdc2f3462bbec","0d987bed3ffa4ed0b9a2e62e97b7b30f",22930920,1,-9,0,1322,279,272,-7
"0d987bed3ffa4ed0b9a2e62e97b7b30f","bb5a47f5ea01454a8b79455422d3b9da",22930920,3,10,0,1323,272,280,8
"bb5a47f5ea01454a8b79455422d3b9da","bb5a47f5ea01454a8b79455422d3b9da",22930920,76,0,1,1324,280,280,0
"bb5a47f5ea01454a8b79455422d3b9da","1b4550d0dab04078b3bf08a655345bdc",22930920,1,126,0,1331,280,373,93
"1b4550d0dab04078b3bf08a655345bdc","b71bac264efb4abd97015447bd490db6",22930920,1,-4,0,1332,373,370,-3
"8d448d625b024c82a5eb240bbd7431d6","9428d8bd9c5a47b2a235b254e5e27ded",22930920,1,123,0,1341,374,452,78
"9428d8bd9c5a47b2a235b254e5e27ded","b2f0d654738f48158edff28e8d3a546e",22930920,2,-4,0,1342,452,449,-3
"f60ee41ec635499abd48168342d32c2f","3c8a22d2f9c146ea956609e3ed4f2559",22930920,1,-78,0,1351,453,405,-48
"3c8a22d2f9c146ea956609e3ed4f2559","58fc9094275e4c49be3f4ba6d4acc0a4",22930920,1,2,0,1352,405,406,1
"58fc9094275e4c49be3f4ba6d4acc0a4","58fc9094275e4c49be3f4ba6d4acc0a4",22930920,2,0,1,1353,406,406,0
"58fc9094275e4c49be3f4ba6d4acc0a4","02b3a1bead9244c1ba2f857c7da8f82a",22930920,1,3,0,1355,406,408,2
"02b3a1bead9244c1ba2f857c7da8f82a","6a5f020451db426dacba9e2ea3fcc62a",22930920,1,3,0,1356,408,410,2
"6a5f020451db426dacba9e2ea3fcc62a","02b3a1bead9244c1ba2f857c7da8f82a",22930920,1,-3,0,1357,410,408,-2
"02b3a1bead9244c1ba2f857c7da8f82a","33a9d248b2e44588a5b07fc1342b9bc2",22930920,1,5,0,1358,408,411,3
"33a9d248b2e44588a5b07fc1342b9bc2","6a5f020451db426dacba9e2ea3fcc62a",22930920,1,-2,0,1359,411,410,-1
"6a5f020451db426dacba9e2ea3fcc62a","33a9d248b2e44588a5b07fc1342b9bc2",22930920,1,2,0,1360,410,411,1
"33a9d248b2e44588a5b07fc1342b9bc2","9428d8bd9c5a47b2a235b254e5e27ded",22930920,1,67,0,1361,411,452,41
"f60ee41ec635499abd48168342d32c2f","1fd0f6dadbc14ebc965faf6122190b96",22930920,1,-63,0,1371,453,415,-38
"1fd0f6dadbc14ebc965faf6122190b96","1fd0f6dadbc14ebc965faf6122190b96",22930920,1,0,1,1372,415,415,0
"1fd0f6dadbc14ebc965faf6122190b96","687055dad9fc40c3982478fe33ec01bf",22930920,1,-1,0,1373,415,414,-1
"687055dad9fc40c3982478fe33ec01bf","2add1669f08d4101913db15f8c23b3b7",22930920,1,3,0,1374,414,416,2
"2add1669f08d4101913db15f8c23b3b7","2add1669f08d4101913db15f8c23b3b7",22930920,1,0,1,1375,416,416,0
"2add1669f08d4101913db15f8c23b3b7","2b09a08242b54983aec7063990fb3f66",22930920,1,-24,0,1376,416,400,-16
"2b09a08242b54983aec7063990fb3f66","a2b4bd40cee2481ebd3fc179d6a5cd62",22930920,1,27,0,1377,400,417,17
"a2b4bd40cee2481ebd3fc179d6a5cd62","e34e59dce2204f228f3a84b6725df60f",22930920,1,2,0,1378,417,419,2
"e34e59dce2204f228f3a84b6725df60f","e34e59dce2204f228f3a84b6725df60f",22930920,1,0,1,1379,419,419,0
"e34e59dce2204f228f3a84b6725df60f","bec48fc2e1294c7eb3d0aca780d731b8",22930920,1,2,0,1380,419,420,1
"bec48fc2e1294c7eb3d0aca780d731b8","a2b4bd40cee2481ebd3fc179d6a5cd62",22930920,1,-4,0,1381,420,417,-3
"a2b4bd40cee2481ebd3fc179d6a5cd62","bec48fc2e1294c7eb3d0aca780d731b8",22930920,1,4,0,1382,417,420,3
"bec48fc2e1294c7eb3d0aca780d731b8","a24600b0e49245f6bdba8c893cfeddb0",22930920,1,7,0,1383,420,425,5
"a24600b0e49245f6bdba8c893cfeddb0","dbde19fcce2a4c1abdc7f685c293a23f",22930920,1,-4,0,1384,425,422,-3
"dbde19fcce2a4c1abdc7f685c293a23f","a24600b0e49245f6bdba8c893cfeddb0",22930920,1,4,0,1385,422,425,3
"a24600b0e49245f6bdba8c893cfeddb0","a2b4bd40cee2481ebd3fc179d6a5cd62",22930920,1,-11,0,1386,425,417,-8
"a2b4bd40cee2481ebd3fc179d6a5cd62","24cf8786024543f19b89bc20034e60d7",22930920,1,18,0,1387,417,428,11
"24cf8786024543f19b89bc20034e60d7","f2a73be2f46840b182d7bd095378004e",22930920,1,1,0,1388,428,429,1
"f2a73be2f46840b182d7bd095378004e","dce46f8904594a62a6377a3587aaa663",22930920,1,3,0,1389,429,431,2
"dce46f8904594a62a6377a3587aaa663","24cf8786024543f19b89bc20034e60d7",22930920,1,-4,0,1390,431,428,-3
"24cf8786024543f19b89bc20034e60d7","dce46f8904594a62a6377a3587aaa663",22930920,1,4,0,1391,428,431,3
"dce46f8904594a62a6377a3587aaa663","74a7f8712e5449c2bc0b43c6f90dafed",22930920,1,5,0,1392,431,435,4
"74a7f8712e5449c2bc0b43c6f90dafed","74a7f8712e5449c2bc0b43c6f90dafed",22930920,1,0,1,1393,435,435,0
"74a7f8712e5449c2bc0b43c6f90dafed","66ada10dde9f43018588f1ced9d477fc",22930920,1,-1,0,1394,435,434,-1
"66ada10dde9f43018588f1ced9d477fc","bf12c96466d840a69bed7020b3f18bb8",22930920,1,3,0,1395,434,436,2
"bf12c96466d840a69bed7020b3f18bb8","bf12c96466d840a69bed7020b3f18bb8",22930920,1,0,1,1396,436,436,0
"bf12c96466d840a69bed7020b3f18bb8","070600601c4c439288445d2f0724807d",22930920,1,3,0,1397,436,437,1
"070600601c4c439288445d2f0724807d","24cf8786024543f19b89bc20034e60d7",22930920,1,-14,0,1398,437,428,-9
"24cf8786024543f19b89bc20034e60d7","1823b6de7d334a7aaabc4570719af4d9",22930920,1,16,0,1399,428,439,11
"1823b6de7d334a7aaabc4570719af4d9","1823b6de7d334a7aaabc4570719af4d9",22930920,16,0,1,1400,439,439,0
"1823b6de7d334a7aaabc4570719af4d9","070600601c4c439288445d2f0724807d",22930920,1,-2,0,1416,439,437,-2
"070600601c4c439288445d2f0724807d","0380cd76a7d44bc3a4da1f15e4d68f89",22930920,1,4,0,1417,437,440,3
"0380cd76a7d44bc3a4da1f15e4d68f89","0380cd76a7d44bc3a4da1f15e4d68f89",22930920,1,0,1,1418,440,440,0
"0380cd76a7d44bc3a4da1f15e4d68f89","23b7673c8b5443108c2ef09382834a86",22930920,1,2,0,1419,440,441,1
"23b7673c8b5443108c2ef09382834a86","23b7673c8b5443108c2ef09382834a86",22930920,1,0,1,1420,441,441,0
"23b7673c8b5443108c2ef09382834a86","901e92500aea43c79f19f1b279050668",22930920,1,2,0,1421,441,442,1
"901e92500aea43c79f19f1b279050668","901e92500aea43c79f19f1b279050668",22930920,1,0,1,1422,442,442,0
"901e92500aea43c79f19f1b279050668","4660ff2089114e8db82ceb26a4f329e3",22930920,1,4,0,1423,442,445,3
"4660ff2089114e8db82ceb26a4f329e3","4660ff2089114e8db82ceb26a4f329e3",22930920,1,0,1,1424,445,445,0
"4660ff2089114e8db82ceb26a4f329e3","7bd5586eb9d8484eb74a433ee7bfe499",22930920,1,2,0,1425,445,446,1
"7bd5586eb9d8484eb74a433ee7bfe499","7bd5586eb9d8484eb74a433ee7bfe499",22930920,25,0,1,1426,446,446,0
"7bd5586eb9d8484eb74a433ee7bfe499","8a7f26e690f34dda97be16904518ca99",22930920,1,2,0,1451,446,447,1
"8a7f26e690f34dda97be16904518ca99","8a7f26e690f34dda97be16904518ca99",22930920,1,0,1,1452,447,447,0
"8a7f26e690f34dda97be16904518ca99","b534b89233134e30a9b5645138bfa9ee",22930920,1,-551,0,1453,447,41,-406
