"from","to","user_id","weight","dis","sl","seq_min","ordF","ordT","disRevised"
"b613861cecf84ffcab01afb23f660475","b613861cecf84ffcab01afb23f660475",7542749,3,0,1,1,1,1,0
"b613861cecf84ffcab01afb23f660475","e2911e79efc2420eac45d9f671463d4b",7542749,2,3,0,4,1,2,1
"e2911e79efc2420eac45d9f671463d4b","b613861cecf84ffcab01afb23f660475",7542749,1,-3,0,5,2,1,-1
"e2911e79efc2420eac45d9f671463d4b","e2911e79efc2420eac45d9f671463d4b",7542749,1,0,1,7,2,2,0
"e2911e79efc2420eac45d9f671463d4b","519d1b8c59404d67b54e96c5c8a830b2",7542749,1,1,0,8,2,3,1
"519d1b8c59404d67b54e96c5c8a830b2","519d1b8c59404d67b54e96c5c8a830b2",7542749,1,0,1,9,3,3,0
"519d1b8c59404d67b54e96c5c8a830b2","531db53f81f646edb0cdcfe0085b03b7",7542749,1,1,0,10,3,4,1
"531db53f81f646edb0cdcfe0085b03b7","531db53f81f646edb0cdcfe0085b03b7",7542749,1,0,1,11,4,4,0
"531db53f81f646edb0cdcfe0085b03b7","4f5f94b2f95141e0a9d53a61da2276da",7542749,1,1,0,12,4,5,1
"4f5f94b2f95141e0a9d53a61da2276da","4f5f94b2f95141e0a9d53a61da2276da",7542749,1,0,1,13,5,5,0
"4f5f94b2f95141e0a9d53a61da2276da","6d541c89590949f99af293c4f2333f67",7542749,1,1,0,14,5,6,1
"6d541c89590949f99af293c4f2333f67","6d541c89590949f99af293c4f2333f67",7542749,1,0,1,15,6,6,0
"6d541c89590949f99af293c4f2333f67","dd5cf0b9fe4c4f1d8f5ff8e4c04879cb",7542749,1,1,0,16,6,7,1
"dd5cf0b9fe4c4f1d8f5ff8e4c04879cb","dd5cf0b9fe4c4f1d8f5ff8e4c04879cb",7542749,2,0,1,17,7,7,0
"dd5cf0b9fe4c4f1d8f5ff8e4c04879cb","6d541c89590949f99af293c4f2333f67",7542749,1,-1,0,19,7,6,-1
"6d541c89590949f99af293c4f2333f67","4f5f94b2f95141e0a9d53a61da2276da",7542749,1,-1,0,20,6,5,-1
"4f5f94b2f95141e0a9d53a61da2276da","531db53f81f646edb0cdcfe0085b03b7",7542749,1,-1,0,21,5,4,-1
"531db53f81f646edb0cdcfe0085b03b7","519d1b8c59404d67b54e96c5c8a830b2",7542749,1,-1,0,22,4,3,-1
"519d1b8c59404d67b54e96c5c8a830b2","f96261861edc426abe2248be4f0a709a",7542749,1,5,0,23,3,8,5
"f96261861edc426abe2248be4f0a709a","f96261861edc426abe2248be4f0a709a",7542749,2,0,1,24,8,8,0
"f96261861edc426abe2248be4f0a709a","66b5e16f4f75454fb5b8172079f0fa83",7542749,1,1,0,26,8,9,1
"66b5e16f4f75454fb5b8172079f0fa83","66b5e16f4f75454fb5b8172079f0fa83",7542749,2,0,1,27,9,9,0
"66b5e16f4f75454fb5b8172079f0fa83","0680571d4698477995e41842c36a54b2",7542749,1,1,0,29,9,10,1
"0680571d4698477995e41842c36a54b2","0680571d4698477995e41842c36a54b2",7542749,2,0,1,30,10,10,0
"0680571d4698477995e41842c36a54b2","9112f2bffece48e08c6d2287be204085",7542749,1,1,0,32,10,11,1
"9112f2bffece48e08c6d2287be204085","9112f2bffece48e08c6d2287be204085",7542749,2,0,1,33,11,11,0
"9112f2bffece48e08c6d2287be204085","e2911e79efc2420eac45d9f671463d4b",7542749,1,-9,0,35,11,2,-9
"e2911e79efc2420eac45d9f671463d4b","56586aa865414f538729c7f7735d2bc6",7542749,1,12,0,36,2,12,10
"56586aa865414f538729c7f7735d2bc6","56586aa865414f538729c7f7735d2bc6",7542749,10,0,1,37,12,12,0
"56586aa865414f538729c7f7735d2bc6","b7f2b31585d94eb3bf86376714aa7070",7542749,3,2,0,42,12,13,1
"b7f2b31585d94eb3bf86376714aa7070","56586aa865414f538729c7f7735d2bc6",7542749,1,-2,0,43,13,12,-1
"b7f2b31585d94eb3bf86376714aa7070","b7f2b31585d94eb3bf86376714aa7070",7542749,2,0,1,45,13,13,0
"b7f2b31585d94eb3bf86376714aa7070","3f1c815879794b929260d224becaff7e",7542749,2,2,0,46,13,14,1
"3f1c815879794b929260d224becaff7e","5c5ceeee4562457ba6d41515aeebfbb1",7542749,2,6,0,47,14,17,3
"5c5ceeee4562457ba6d41515aeebfbb1","81c864a886d54a6b8ff85f7d736f4f95",7542749,2,-4,0,48,17,15,-2
"81c864a886d54a6b8ff85f7d736f4f95","56586aa865414f538729c7f7735d2bc6",7542749,1,-6,0,49,15,12,-3
"56586aa865414f538729c7f7735d2bc6","5c5ceeee4562457ba6d41515aeebfbb1",7542749,1,10,0,52,12,17,5
"5c5ceeee4562457ba6d41515aeebfbb1","56586aa865414f538729c7f7735d2bc6",7542749,1,-10,0,53,17,12,-5
"81c864a886d54a6b8ff85f7d736f4f95","5c5ceeee4562457ba6d41515aeebfbb1",7542749,1,4,0,62,15,17,2
"5c5ceeee4562457ba6d41515aeebfbb1","9afd71a5298d4333b6849dfce1b9422c",7542749,1,3,0,63,17,18,1
"9afd71a5298d4333b6849dfce1b9422c","56586aa865414f538729c7f7735d2bc6",7542749,1,-13,0,64,18,12,-6
"56586aa865414f538729c7f7735d2bc6","9afd71a5298d4333b6849dfce1b9422c",7542749,1,13,0,65,12,18,6
"9afd71a5298d4333b6849dfce1b9422c","9afd71a5298d4333b6849dfce1b9422c",7542749,3,0,1,66,18,18,0
"9afd71a5298d4333b6849dfce1b9422c","b7719e26494940efa49512aedd0aac79",7542749,2,4,0,68,18,20,2
"a49d1bb4328949299686242fd0be5584","afbf7250b99d47bea07172749483ca97",7542749,2,10,0,73,21,28,7
"afbf7250b99d47bea07172749483ca97","b7719e26494940efa49512aedd0aac79",7542749,2,-12,0,74,28,20,-8
"b7719e26494940efa49512aedd0aac79","4e51676dc72045d99c19b9fa7b22f8bc",7542749,1,15,0,75,20,29,9
"4e51676dc72045d99c19b9fa7b22f8bc","afbf7250b99d47bea07172749483ca97",7542749,1,-3,0,76,29,28,-1
"afbf7250b99d47bea07172749483ca97","4e51676dc72045d99c19b9fa7b22f8bc",7542749,1,3,0,77,28,29,1
"4e51676dc72045d99c19b9fa7b22f8bc","51970cfa30e643e894e66ae85c8024cc",7542749,1,3,0,78,29,31,2
"51970cfa30e643e894e66ae85c8024cc","4e51676dc72045d99c19b9fa7b22f8bc",7542749,1,-3,0,79,31,29,-2
"4e51676dc72045d99c19b9fa7b22f8bc","c33c17be71ae4d588da7369472e5bb1b",7542749,1,9,0,80,29,34,5
"c33c17be71ae4d588da7369472e5bb1b","c33c17be71ae4d588da7369472e5bb1b",7542749,1,0,1,81,34,34,0
"c33c17be71ae4d588da7369472e5bb1b","93679be414554a11b1893002f2229a93",7542749,1,3,0,82,34,35,1
"93679be414554a11b1893002f2229a93","7040a13096d746ac84b8fac8d9752058",7542749,1,3,0,83,35,36,1
"7040a13096d746ac84b8fac8d9752058","93679be414554a11b1893002f2229a93",7542749,1,-3,0,84,36,35,-1
"93679be414554a11b1893002f2229a93","b613861cecf84ffcab01afb23f660475",7542749,1,-59,0,85,35,1,-34
"b613861cecf84ffcab01afb23f660475","b7719e26494940efa49512aedd0aac79",7542749,1,32,0,86,1,20,19
"b7719e26494940efa49512aedd0aac79","b613861cecf84ffcab01afb23f660475",7542749,1,-32,0,90,20,1,-19
"b613861cecf84ffcab01afb23f660475","9afd71a5298d4333b6849dfce1b9422c",7542749,1,28,0,91,1,18,17
"b7719e26494940efa49512aedd0aac79","9afd71a5298d4333b6849dfce1b9422c",7542749,1,-4,0,94,20,18,-2
"9afd71a5298d4333b6849dfce1b9422c","d4f45188d3c84a02ba08454e6403a818",7542749,1,9,0,95,18,24,6
"d4f45188d3c84a02ba08454e6403a818","d4c3b003e8274e429d2fa688d73fde6d",7542749,4,-2,0,100,24,22,-2
"d4c3b003e8274e429d2fa688d73fde6d","5bc03c8f16354d04bd51f5bb93559ad3",7542749,1,4,0,101,22,26,4
"5bc03c8f16354d04bd51f5bb93559ad3","d4c3b003e8274e429d2fa688d73fde6d",7542749,1,-4,0,102,26,22,-4
"d4c3b003e8274e429d2fa688d73fde6d","d4c3b003e8274e429d2fa688d73fde6d",7542749,2,0,1,103,22,22,0
"d4c3b003e8274e429d2fa688d73fde6d","b7719e26494940efa49512aedd0aac79",7542749,3,-3,0,104,22,20,-2
"b7719e26494940efa49512aedd0aac79","b7719e26494940efa49512aedd0aac79",7542749,1,0,1,105,20,20,0
"b7719e26494940efa49512aedd0aac79","7040a13096d746ac84b8fac8d9752058",7542749,1,30,0,106,20,36,16
"7040a13096d746ac84b8fac8d9752058","7040a13096d746ac84b8fac8d9752058",7542749,1,0,1,107,36,36,0
"7040a13096d746ac84b8fac8d9752058","9a0dc646f934470daf08c4b56ccf73db",7542749,1,3,0,108,36,37,1
"9a0dc646f934470daf08c4b56ccf73db","7040a13096d746ac84b8fac8d9752058",7542749,1,-3,0,109,37,36,-1
"7040a13096d746ac84b8fac8d9752058","fc0e049d56024bc9a02c9a9c435c3df7",7542749,1,6,0,110,36,38,2
"fc0e049d56024bc9a02c9a9c435c3df7","9a0dc646f934470daf08c4b56ccf73db",7542749,1,-3,0,111,38,37,-1
"9a0dc646f934470daf08c4b56ccf73db","fc0e049d56024bc9a02c9a9c435c3df7",7542749,1,3,0,112,37,38,1
"fc0e049d56024bc9a02c9a9c435c3df7","67a089198fcb4e1c8f2385786c2b296f",7542749,1,4,0,113,38,39,1
"67a089198fcb4e1c8f2385786c2b296f","64d48c6c9c7940639a932219a6c87198",7542749,2,1,0,114,39,40,1
"64d48c6c9c7940639a932219a6c87198","67a089198fcb4e1c8f2385786c2b296f",7542749,2,-1,0,115,40,39,-1
"67a089198fcb4e1c8f2385786c2b296f","78adeee1fa2c4fe0bc73f7bca9fcee86",7542749,5,152,0,116,39,160,121
"78adeee1fa2c4fe0bc73f7bca9fcee86","78adeee1fa2c4fe0bc73f7bca9fcee86",7542749,2,0,1,117,160,160,0
"78adeee1fa2c4fe0bc73f7bca9fcee86","67a089198fcb4e1c8f2385786c2b296f",7542749,3,-152,0,118,160,39,-121
"67a089198fcb4e1c8f2385786c2b296f","67a089198fcb4e1c8f2385786c2b296f",7542749,3,0,1,124,39,39,0
"78adeee1fa2c4fe0bc73f7bca9fcee86","0c7262dff33c4087bc660ccf40f92f9c",7542749,1,17,0,126,160,169,9
"0c7262dff33c4087bc660ccf40f92f9c","b2275c3fad834f8d90737a2d9a6927d6",7542749,5,3,0,127,169,172,3
"b2275c3fad834f8d90737a2d9a6927d6","67a089198fcb4e1c8f2385786c2b296f",7542749,1,-172,0,128,172,39,-133
"64d48c6c9c7940639a932219a6c87198","64d48c6c9c7940639a932219a6c87198",7542749,5,0,1,131,40,40,0
"67a089198fcb4e1c8f2385786c2b296f","b534b89233134e30a9b5645138bfa9ee",7542749,2,4,0,137,39,41,2
"b534b89233134e30a9b5645138bfa9ee","0e37b720d23b4e7f8b313e79313fd107",7542749,1,3,0,138,41,44,3
"0e37b720d23b4e7f8b313e79313fd107","0e37b720d23b4e7f8b313e79313fd107",7542749,1,0,1,139,44,44,0
"0e37b720d23b4e7f8b313e79313fd107","6875d67fdd5f48168b62719df449bebd",7542749,1,1,0,140,44,45,1
"6875d67fdd5f48168b62719df449bebd","6875d67fdd5f48168b62719df449bebd",7542749,1,0,1,141,45,45,0
"6875d67fdd5f48168b62719df449bebd","b534b89233134e30a9b5645138bfa9ee",7542749,1,-4,0,142,45,41,-4
"b534b89233134e30a9b5645138bfa9ee","6e13d61a7bdb44bca949c9f86fab3be5",7542749,2,7,0,143,41,47,6
"6e13d61a7bdb44bca949c9f86fab3be5","6e13d61a7bdb44bca949c9f86fab3be5",7542749,7,0,1,144,47,47,0
"6e13d61a7bdb44bca949c9f86fab3be5","195f78799f984cc2b06c48dfe36be751",7542749,3,2,0,151,47,49,2
"195f78799f984cc2b06c48dfe36be751","195f78799f984cc2b06c48dfe36be751",7542749,2,0,1,152,49,49,0
"195f78799f984cc2b06c48dfe36be751","d0c74f735e024943943e40333d6d337f",7542749,2,3,0,154,49,51,2
"d0c74f735e024943943e40333d6d337f","d9c8d8c444a64dadbbb508652c721e17",7542749,2,-6,0,155,51,46,-5
"d9c8d8c444a64dadbbb508652c721e17","d0c74f735e024943943e40333d6d337f",7542749,2,6,0,156,46,51,5
"d0c74f735e024943943e40333d6d337f","d0c74f735e024943943e40333d6d337f",7542749,3,0,1,157,51,51,0
"d0c74f735e024943943e40333d6d337f","983f8ff320594b279a7f4a6fe132f9c5",7542749,1,2,0,160,51,53,2
"983f8ff320594b279a7f4a6fe132f9c5","983f8ff320594b279a7f4a6fe132f9c5",7542749,2,0,1,161,53,53,0
"983f8ff320594b279a7f4a6fe132f9c5","35adfa5d923046aebabfefd98f35ff05",7542749,2,1,0,163,53,54,1
"35adfa5d923046aebabfefd98f35ff05","35adfa5d923046aebabfefd98f35ff05",7542749,9,0,1,164,54,54,0
"35adfa5d923046aebabfefd98f35ff05","b6f8a98476224da1b40e555ececc7ed8",7542749,2,1,0,173,54,55,1
"b6f8a98476224da1b40e555ececc7ed8","b6f8a98476224da1b40e555ececc7ed8",7542749,2,0,1,174,55,55,0
"b6f8a98476224da1b40e555ececc7ed8","86e22cb5fe0e4b47a9489ecddf7ed78f",7542749,2,1,0,176,55,56,1
"86e22cb5fe0e4b47a9489ecddf7ed78f","86e22cb5fe0e4b47a9489ecddf7ed78f",7542749,2,0,1,177,56,56,0
"86e22cb5fe0e4b47a9489ecddf7ed78f","a1f2f12debe5432fb7a70bcd12bacfb9",7542749,1,3,0,179,56,58,2
"a1f2f12debe5432fb7a70bcd12bacfb9","f924752d8a1149668870b1e7698486f7",7542749,1,-9,0,180,58,50,-8
"f924752d8a1149668870b1e7698486f7","78f30e4dcac84e3cbea8b2cc6e0d62b3",7542749,1,10,0,181,50,59,9
"78f30e4dcac84e3cbea8b2cc6e0d62b3","a1f2f12debe5432fb7a70bcd12bacfb9",7542749,2,-1,0,182,59,58,-1
"a1f2f12debe5432fb7a70bcd12bacfb9","a1f2f12debe5432fb7a70bcd12bacfb9",7542749,10,0,1,183,58,58,0
"a1f2f12debe5432fb7a70bcd12bacfb9","78f30e4dcac84e3cbea8b2cc6e0d62b3",7542749,1,1,0,193,58,59,1
"78f30e4dcac84e3cbea8b2cc6e0d62b3","78f30e4dcac84e3cbea8b2cc6e0d62b3",7542749,7,0,1,194,59,59,0
"78f30e4dcac84e3cbea8b2cc6e0d62b3","a0a418b8540d479fa6e0f653b701da8b",7542749,1,6,0,201,59,64,5
"a0a418b8540d479fa6e0f653b701da8b","bc42d26810654ea9a1df1efe1e58c7d5",7542749,3,-1,0,202,64,63,-1
"bc42d26810654ea9a1df1efe1e58c7d5","12aa6e1672ac4e7aa6449a7a8609cd72",7542749,1,-7,0,203,63,57,-6
"12aa6e1672ac4e7aa6449a7a8609cd72","4c943503763e4e349906eea3ed3c8e86",7542749,1,5,0,204,57,61,4
"4c943503763e4e349906eea3ed3c8e86","4c943503763e4e349906eea3ed3c8e86",7542749,1,0,1,205,61,61,0
"4c943503763e4e349906eea3ed3c8e86","bc42d26810654ea9a1df1efe1e58c7d5",7542749,1,2,0,206,61,63,2
"bc42d26810654ea9a1df1efe1e58c7d5","bc42d26810654ea9a1df1efe1e58c7d5",7542749,6,0,1,207,63,63,0
"bc42d26810654ea9a1df1efe1e58c7d5","a0a418b8540d479fa6e0f653b701da8b",7542749,3,1,0,210,63,64,1
"a0a418b8540d479fa6e0f653b701da8b","a0a418b8540d479fa6e0f653b701da8b",7542749,6,0,1,211,64,64,0
"a0a418b8540d479fa6e0f653b701da8b","309ccf3cc4fe429d9bfbaef53d3fa479",7542749,1,-4,0,214,64,60,-4
"309ccf3cc4fe429d9bfbaef53d3fa479","7af822066add4e7f8e007e4eee31a8bf",7542749,1,6,0,215,60,65,5
"7af822066add4e7f8e007e4eee31a8bf","7af822066add4e7f8e007e4eee31a8bf",7542749,1,0,1,216,65,65,0
"7af822066add4e7f8e007e4eee31a8bf","b534b89233134e30a9b5645138bfa9ee",7542749,1,-29,0,217,65,41,-24
"b534b89233134e30a9b5645138bfa9ee","d646286c8051419bbc2e31dd1db55ca8",7542749,2,33,0,218,41,67,26
"d646286c8051419bbc2e31dd1db55ca8","b534b89233134e30a9b5645138bfa9ee",7542749,3,-33,0,219,67,41,-26
"d646286c8051419bbc2e31dd1db55ca8","d646286c8051419bbc2e31dd1db55ca8",7542749,3,0,1,221,67,67,0
"d646286c8051419bbc2e31dd1db55ca8","267f883678b24aed855fde42524975d9",7542749,1,4,0,224,67,71,4
"267f883678b24aed855fde42524975d9","267f883678b24aed855fde42524975d9",7542749,1,0,1,225,71,71,0
"267f883678b24aed855fde42524975d9","88fff56d0342490dbef9040750a20f6c",7542749,1,1,0,226,71,72,1
"88fff56d0342490dbef9040750a20f6c","88fff56d0342490dbef9040750a20f6c",7542749,1,0,1,227,72,72,0
"88fff56d0342490dbef9040750a20f6c","adb17b12b66c4a49a85fd34322f7df70",7542749,1,1,0,228,72,73,1
"adb17b12b66c4a49a85fd34322f7df70","adb17b12b66c4a49a85fd34322f7df70",7542749,1,0,1,229,73,73,0
"adb17b12b66c4a49a85fd34322f7df70","d646286c8051419bbc2e31dd1db55ca8",7542749,1,-6,0,230,73,67,-6
"d646286c8051419bbc2e31dd1db55ca8","a2becd407db34b189200a32546d9d569",7542749,2,9,0,231,67,75,8
"a2becd407db34b189200a32546d9d569","a2becd407db34b189200a32546d9d569",7542749,12,0,1,232,75,75,0
"a2becd407db34b189200a32546d9d569","58c22b011d0f4c2ea6d13615edbb9eeb",7542749,1,2,0,244,75,77,2
"58c22b011d0f4c2ea6d13615edbb9eeb","58c22b011d0f4c2ea6d13615edbb9eeb",7542749,2,0,1,245,77,77,0
"58c22b011d0f4c2ea6d13615edbb9eeb","dd76e1861dc9461c830888729d091ee0",7542749,1,1,0,247,77,78,1
"dd76e1861dc9461c830888729d091ee0","dd76e1861dc9461c830888729d091ee0",7542749,5,0,1,248,78,78,0
"dd76e1861dc9461c830888729d091ee0","cd1d828f1a694b87913a7ea66c23803e",7542749,1,1,0,253,78,79,1
"cd1d828f1a694b87913a7ea66c23803e","cd1d828f1a694b87913a7ea66c23803e",7542749,2,0,1,254,79,79,0
"cd1d828f1a694b87913a7ea66c23803e","9176a3c2b4d2465fa8b0c67096c2a97e",7542749,1,1,0,256,79,80,1
"9176a3c2b4d2465fa8b0c67096c2a97e","9176a3c2b4d2465fa8b0c67096c2a97e",7542749,5,0,1,257,80,80,0
"9176a3c2b4d2465fa8b0c67096c2a97e","f8ec6445f7194e25b9101d4fbcb07a18",7542749,1,1,0,262,80,81,1
"f8ec6445f7194e25b9101d4fbcb07a18","f8ec6445f7194e25b9101d4fbcb07a18",7542749,2,0,1,263,81,81,0
"f8ec6445f7194e25b9101d4fbcb07a18","140d5b27b8574befad82c0a013b59dfa",7542749,1,-7,0,265,81,74,-7
"140d5b27b8574befad82c0a013b59dfa","d18a9ea32855445f8736581f5cb119ce",7542749,2,9,0,266,74,82,8
"d18a9ea32855445f8736581f5cb119ce","f564483cbd7a407681aa2fcca518cf5f",7542749,1,4,0,267,82,85,3
"f564483cbd7a407681aa2fcca518cf5f","f564483cbd7a407681aa2fcca518cf5f",7542749,1,0,1,268,85,85,0
"f564483cbd7a407681aa2fcca518cf5f","18fd01350bd5434ca636d59a599d768a",7542749,1,1,0,269,85,86,1
"18fd01350bd5434ca636d59a599d768a","18fd01350bd5434ca636d59a599d768a",7542749,9,0,1,270,86,86,0
"18fd01350bd5434ca636d59a599d768a","ae5ac430ea254e708a6f5deaaf7464ae",7542749,1,-2,0,279,86,84,-2
"ae5ac430ea254e708a6f5deaaf7464ae","6a9f0ef185fb47f0937e29daa1c71ed5",7542749,1,7,0,280,84,90,6
"6a9f0ef185fb47f0937e29daa1c71ed5","c681290961c94c4caf23b529d1ae6b9a",7542749,1,-2,0,281,90,88,-2
"c681290961c94c4caf23b529d1ae6b9a","c681290961c94c4caf23b529d1ae6b9a",7542749,1,0,1,282,88,88,0
"c681290961c94c4caf23b529d1ae6b9a","6a9f0ef185fb47f0937e29daa1c71ed5",7542749,1,2,0,283,88,90,2
"6a9f0ef185fb47f0937e29daa1c71ed5","6a9f0ef185fb47f0937e29daa1c71ed5",7542749,3,0,1,284,90,90,0
"6a9f0ef185fb47f0937e29daa1c71ed5","d646286c8051419bbc2e31dd1db55ca8",7542749,1,-27,0,287,90,67,-23
"d646286c8051419bbc2e31dd1db55ca8","e20db35ced8544ddac5bc3839145e463",7542749,1,30,0,288,67,91,24
"e20db35ced8544ddac5bc3839145e463","67a089198fcb4e1c8f2385786c2b296f",7542749,1,-67,0,289,91,39,-52
"67a089198fcb4e1c8f2385786c2b296f","e20db35ced8544ddac5bc3839145e463",7542749,1,67,0,290,39,91,52
"e20db35ced8544ddac5bc3839145e463","e20db35ced8544ddac5bc3839145e463",7542749,2,0,1,291,91,91,0
"e20db35ced8544ddac5bc3839145e463","1febb706d7a34005ae8711ed49c76e64",7542749,1,3,0,293,91,94,3
"1febb706d7a34005ae8711ed49c76e64","1febb706d7a34005ae8711ed49c76e64",7542749,2,0,1,294,94,94,0
"1febb706d7a34005ae8711ed49c76e64","8f73ba6f5a0042f2850356ac38ac6f24",7542749,1,1,0,296,94,95,1
"8f73ba6f5a0042f2850356ac38ac6f24","8f73ba6f5a0042f2850356ac38ac6f24",7542749,5,0,1,297,95,95,0
"8f73ba6f5a0042f2850356ac38ac6f24","e2260b86653c46d7b14a41fb419dbf8c",7542749,1,1,0,302,95,96,1
"e2260b86653c46d7b14a41fb419dbf8c","e2260b86653c46d7b14a41fb419dbf8c",7542749,2,0,1,303,96,96,0
"e2260b86653c46d7b14a41fb419dbf8c","35eb641ad1d845bbba54915bce75a962",7542749,1,1,0,305,96,97,1
"35eb641ad1d845bbba54915bce75a962","35eb641ad1d845bbba54915bce75a962",7542749,2,0,1,306,97,97,0
"35eb641ad1d845bbba54915bce75a962","08be90ffbeea4795a138cd42ed8db56f",7542749,1,1,0,308,97,98,1
"08be90ffbeea4795a138cd42ed8db56f","08be90ffbeea4795a138cd42ed8db56f",7542749,2,0,1,309,98,98,0
"08be90ffbeea4795a138cd42ed8db56f","3007433c8f584dcbb5ac159c1c5f2be3",7542749,1,1,0,311,98,99,1
"3007433c8f584dcbb5ac159c1c5f2be3","3007433c8f584dcbb5ac159c1c5f2be3",7542749,5,0,1,312,99,99,0
"3007433c8f584dcbb5ac159c1c5f2be3","e20db35ced8544ddac5bc3839145e463",7542749,1,-8,0,317,99,91,-8
"e20db35ced8544ddac5bc3839145e463","d391c8b6e56a43a7b654e9dee02d904b",7542749,1,13,0,318,91,103,12
"d391c8b6e56a43a7b654e9dee02d904b","00ae5f0c51874a73a41ebea838d95682",7542749,1,-2,0,319,103,101,-2
"00ae5f0c51874a73a41ebea838d95682","00ae5f0c51874a73a41ebea838d95682",7542749,10,0,1,320,101,101,0
"00ae5f0c51874a73a41ebea838d95682","d391c8b6e56a43a7b654e9dee02d904b",7542749,1,2,0,330,101,103,2
"d391c8b6e56a43a7b654e9dee02d904b","d391c8b6e56a43a7b654e9dee02d904b",7542749,15,0,1,331,103,103,0
"d391c8b6e56a43a7b654e9dee02d904b","6111116566fc4fd9abba409322bea245",7542749,1,1,0,346,103,104,1
"6111116566fc4fd9abba409322bea245","6111116566fc4fd9abba409322bea245",7542749,2,0,1,347,104,104,0
"6111116566fc4fd9abba409322bea245","a81b2235cb9c499eb9ea8ee0a8dd9725",7542749,1,1,0,349,104,105,1
"a81b2235cb9c499eb9ea8ee0a8dd9725","a81b2235cb9c499eb9ea8ee0a8dd9725",7542749,2,0,1,350,105,105,0
"a81b2235cb9c499eb9ea8ee0a8dd9725","2d4e0ab0ef3b4d73b82c72d4621a7579",7542749,1,1,0,352,105,106,1
"2d4e0ab0ef3b4d73b82c72d4621a7579","2d4e0ab0ef3b4d73b82c72d4621a7579",7542749,2,0,1,353,106,106,0
"2d4e0ab0ef3b4d73b82c72d4621a7579","8bdebf492ebd4e62b0d522e8ab5e5197",7542749,1,1,0,355,106,107,1
"8bdebf492ebd4e62b0d522e8ab5e5197","8bdebf492ebd4e62b0d522e8ab5e5197",7542749,2,0,1,356,107,107,0
"8bdebf492ebd4e62b0d522e8ab5e5197","73039f8c1eb9409cb4caee2cf968001e",7542749,1,-7,0,358,107,100,-7
"73039f8c1eb9409cb4caee2cf968001e","4280927ec4d643238aa49c32f9e06c6c",7542749,1,10,0,359,100,109,9
"4280927ec4d643238aa49c32f9e06c6c","08111f75e22d409998cf8b85bd431f0a",7542749,1,-1,0,360,109,108,-1
"08111f75e22d409998cf8b85bd431f0a","e20db35ced8544ddac5bc3839145e463",7542749,1,-19,0,361,108,91,-17
"e20db35ced8544ddac5bc3839145e463","08111f75e22d409998cf8b85bd431f0a",7542749,1,19,0,362,91,108,17
"08111f75e22d409998cf8b85bd431f0a","4280927ec4d643238aa49c32f9e06c6c",7542749,1,1,0,363,108,109,1
"4280927ec4d643238aa49c32f9e06c6c","4280927ec4d643238aa49c32f9e06c6c",7542749,1,0,1,364,109,109,0
"4280927ec4d643238aa49c32f9e06c6c","fc44e6a5f7654430af1227838224dceb",7542749,1,2,0,365,109,111,2
"fc44e6a5f7654430af1227838224dceb","fc44e6a5f7654430af1227838224dceb",7542749,2,0,1,366,111,111,0
"fc44e6a5f7654430af1227838224dceb","08111f75e22d409998cf8b85bd431f0a",7542749,1,-3,0,368,111,108,-3
"08111f75e22d409998cf8b85bd431f0a","a9ae0a3c070d455bb4369a8996313336",7542749,1,7,0,369,108,114,6
"a9ae0a3c070d455bb4369a8996313336","a9ae0a3c070d455bb4369a8996313336",7542749,1,0,1,370,114,114,0
"a9ae0a3c070d455bb4369a8996313336","e20db35ced8544ddac5bc3839145e463",7542749,1,-26,0,371,114,91,-23
"e20db35ced8544ddac5bc3839145e463","a9ae0a3c070d455bb4369a8996313336",7542749,1,26,0,372,91,114,23
"a9ae0a3c070d455bb4369a8996313336","71cec822bcff4f30a20e75dc63ef7b65",7542749,1,2,0,373,114,116,2
"71cec822bcff4f30a20e75dc63ef7b65","71cec822bcff4f30a20e75dc63ef7b65",7542749,1,0,1,374,116,116,0
"71cec822bcff4f30a20e75dc63ef7b65","37319e88176d4aefa91d7a9980dbae91",7542749,1,-4,0,375,116,112,-4
"37319e88176d4aefa91d7a9980dbae91","62bff51286ef4f348717a3cf6fe2318f",7542749,1,9,0,376,112,120,8
"62bff51286ef4f348717a3cf6fe2318f","3ec3a3563847406fa73338f9e9999cf3",7542749,1,-3,0,377,120,117,-3
"3ec3a3563847406fa73338f9e9999cf3","62bff51286ef4f348717a3cf6fe2318f",7542749,1,3,0,378,117,120,3
"62bff51286ef4f348717a3cf6fe2318f","e20db35ced8544ddac5bc3839145e463",7542749,2,-33,0,379,120,91,-29
"e20db35ced8544ddac5bc3839145e463","b1cd0e7dc3ad4a8eb91a4bfdbeb025b0",7542749,1,31,0,380,91,118,27
"b1cd0e7dc3ad4a8eb91a4bfdbeb025b0","b1cd0e7dc3ad4a8eb91a4bfdbeb025b0",7542749,1,0,1,381,118,118,0
"b1cd0e7dc3ad4a8eb91a4bfdbeb025b0","62bff51286ef4f348717a3cf6fe2318f",7542749,1,2,0,382,118,120,2
"62bff51286ef4f348717a3cf6fe2318f","62bff51286ef4f348717a3cf6fe2318f",7542749,3,0,1,383,120,120,0
"e20db35ced8544ddac5bc3839145e463","779f9ddd1fd14d1e9e69f72219a1fdbd",7542749,1,36,0,387,91,121,30
"779f9ddd1fd14d1e9e69f72219a1fdbd","ae26e6cda8ad4a3f81bd347560d9579f",7542749,1,4,0,388,121,125,4
"ae26e6cda8ad4a3f81bd347560d9579f","ae26e6cda8ad4a3f81bd347560d9579f",7542749,1,0,1,389,125,125,0
"ae26e6cda8ad4a3f81bd347560d9579f","ee48df95832b4374aa273ceb27ec1315",7542749,1,1,0,390,125,126,1
"ee48df95832b4374aa273ceb27ec1315","ee48df95832b4374aa273ceb27ec1315",7542749,1,0,1,391,126,126,0
"ee48df95832b4374aa273ceb27ec1315","7a439da90b394756ad1777fc4c6dead5",7542749,1,1,0,392,126,127,1
"7a439da90b394756ad1777fc4c6dead5","7a439da90b394756ad1777fc4c6dead5",7542749,3,0,1,393,127,127,0
"7a439da90b394756ad1777fc4c6dead5","779f9ddd1fd14d1e9e69f72219a1fdbd",7542749,1,-6,0,396,127,121,-6
"779f9ddd1fd14d1e9e69f72219a1fdbd","a8dd5213034441ac92724b4e83eb0bb2",7542749,1,9,0,397,121,129,8
"a8dd5213034441ac92724b4e83eb0bb2","a8dd5213034441ac92724b4e83eb0bb2",7542749,6,0,1,398,129,129,0
"a8dd5213034441ac92724b4e83eb0bb2","8115eab6556b45f5b415c3b8c26a12e5",7542749,1,2,0,404,129,131,2
"8115eab6556b45f5b415c3b8c26a12e5","8115eab6556b45f5b415c3b8c26a12e5",7542749,2,0,1,405,131,131,0
"8115eab6556b45f5b415c3b8c26a12e5","ec34b06efd844b46a4c4818ecdb9b8f4",7542749,1,1,0,407,131,132,1
"ec34b06efd844b46a4c4818ecdb9b8f4","ec34b06efd844b46a4c4818ecdb9b8f4",7542749,2,0,1,408,132,132,0
"ec34b06efd844b46a4c4818ecdb9b8f4","c2e1c2b9eac64109b343a088584b576b",7542749,1,1,0,410,132,133,1
"c2e1c2b9eac64109b343a088584b576b","c2e1c2b9eac64109b343a088584b576b",7542749,2,0,1,411,133,133,0
"c2e1c2b9eac64109b343a088584b576b","579338175e0b4bbb8ef3b712b5d8b54e",7542749,1,-5,0,413,133,128,-5
"579338175e0b4bbb8ef3b712b5d8b54e","8bc5795d6a984a3eace4e2811e52dd4f",7542749,1,8,0,414,128,135,7
"8bc5795d6a984a3eace4e2811e52dd4f","8bc5795d6a984a3eace4e2811e52dd4f",7542749,1,0,1,415,135,135,0
"8bc5795d6a984a3eace4e2811e52dd4f","b416d47c56a742199b5d7c7f19d6503a",7542749,1,-1,0,416,135,134,-1
"b416d47c56a742199b5d7c7f19d6503a","cd4532ad48034873ba8bce2aac0c9808",7542749,1,4,0,417,134,137,3
"cd4532ad48034873ba8bce2aac0c9808","cd4532ad48034873ba8bce2aac0c9808",7542749,1,0,1,418,137,137,0
"cd4532ad48034873ba8bce2aac0c9808","df1de691dafe4549a18a4398ee9dfaf9",7542749,1,4,0,419,137,139,2
"df1de691dafe4549a18a4398ee9dfaf9","779f9ddd1fd14d1e9e69f72219a1fdbd",7542749,1,-23,0,420,139,121,-18
"779f9ddd1fd14d1e9e69f72219a1fdbd","6c5ad271a44743479bfaea29b1db8d02",7542749,1,27,0,421,121,143,22
"6c5ad271a44743479bfaea29b1db8d02","67a089198fcb4e1c8f2385786c2b296f",7542749,1,-130,0,422,143,39,-104
"67a089198fcb4e1c8f2385786c2b296f","140d5b27b8574befad82c0a013b59dfa",7542749,1,45,0,423,39,74,35
"140d5b27b8574befad82c0a013b59dfa","d646286c8051419bbc2e31dd1db55ca8",7542749,1,-8,0,424,74,67,-7
"a2becd407db34b189200a32546d9d569","f8ec6445f7194e25b9101d4fbcb07a18",7542749,1,6,0,426,75,81,6
"f8ec6445f7194e25b9101d4fbcb07a18","9176a3c2b4d2465fa8b0c67096c2a97e",7542749,1,-1,0,427,81,80,-1
"9176a3c2b4d2465fa8b0c67096c2a97e","cd1d828f1a694b87913a7ea66c23803e",7542749,1,-1,0,428,80,79,-1
"cd1d828f1a694b87913a7ea66c23803e","dd76e1861dc9461c830888729d091ee0",7542749,1,-1,0,429,79,78,-1
"dd76e1861dc9461c830888729d091ee0","58c22b011d0f4c2ea6d13615edbb9eeb",7542749,1,-1,0,430,78,77,-1
"58c22b011d0f4c2ea6d13615edbb9eeb","140d5b27b8574befad82c0a013b59dfa",7542749,1,-3,0,431,77,74,-3
"d18a9ea32855445f8736581f5cb119ce","67a089198fcb4e1c8f2385786c2b296f",7542749,1,-54,0,433,82,39,-43
"b534b89233134e30a9b5645138bfa9ee","d9c8d8c444a64dadbbb508652c721e17",7542749,1,6,0,435,41,46,5
"d9c8d8c444a64dadbbb508652c721e17","6e13d61a7bdb44bca949c9f86fab3be5",7542749,1,1,0,436,46,47,1
"d9c8d8c444a64dadbbb508652c721e17","983f8ff320594b279a7f4a6fe132f9c5",7542749,1,8,0,440,46,53,7
"86e22cb5fe0e4b47a9489ecddf7ed78f","78f30e4dcac84e3cbea8b2cc6e0d62b3",7542749,1,4,0,444,56,59,3
"78f30e4dcac84e3cbea8b2cc6e0d62b3","f924752d8a1149668870b1e7698486f7",7542749,1,-10,0,445,59,50,-9
"f924752d8a1149668870b1e7698486f7","a1f2f12debe5432fb7a70bcd12bacfb9",7542749,1,9,0,446,50,58,8
"a1f2f12debe5432fb7a70bcd12bacfb9","12aa6e1672ac4e7aa6449a7a8609cd72",7542749,1,-1,0,447,58,57,-1
"12aa6e1672ac4e7aa6449a7a8609cd72","bc42d26810654ea9a1df1efe1e58c7d5",7542749,1,7,0,448,57,63,6
"bc42d26810654ea9a1df1efe1e58c7d5","309ccf3cc4fe429d9bfbaef53d3fa479",7542749,1,-3,0,454,63,60,-3
"309ccf3cc4fe429d9bfbaef53d3fa479","d646286c8051419bbc2e31dd1db55ca8",7542749,2,10,0,455,60,67,7
"b534b89233134e30a9b5645138bfa9ee","67a089198fcb4e1c8f2385786c2b296f",7542749,2,-4,0,457,41,39,-2
"67a089198fcb4e1c8f2385786c2b296f","d9c8d8c444a64dadbbb508652c721e17",7542749,1,10,0,458,39,46,7
"d9c8d8c444a64dadbbb508652c721e17","b534b89233134e30a9b5645138bfa9ee",7542749,1,-6,0,459,46,41,-5
"195f78799f984cc2b06c48dfe36be751","f924752d8a1149668870b1e7698486f7",7542749,1,2,0,462,49,50,1
"f924752d8a1149668870b1e7698486f7","d9c8d8c444a64dadbbb508652c721e17",7542749,1,-5,0,463,50,46,-4
"d0c74f735e024943943e40333d6d337f","78f30e4dcac84e3cbea8b2cc6e0d62b3",7542749,1,9,0,465,51,59,8
"a1f2f12debe5432fb7a70bcd12bacfb9","a0a418b8540d479fa6e0f653b701da8b",7542749,1,7,0,467,58,64,6
"a0a418b8540d479fa6e0f653b701da8b","12aa6e1672ac4e7aa6449a7a8609cd72",7542749,1,-8,0,473,64,57,-7
"12aa6e1672ac4e7aa6449a7a8609cd72","309ccf3cc4fe429d9bfbaef53d3fa479",7542749,1,4,0,474,57,60,3
"78adeee1fa2c4fe0bc73f7bca9fcee86","8959e6304a0348309a771e4d08d1b64a",7542749,1,4,0,480,160,163,3
"8959e6304a0348309a771e4d08d1b64a","65202579580f4ad38d734b4ee39d22a8",7542749,1,1,0,481,163,164,1
"65202579580f4ad38d734b4ee39d22a8","b7719e26494940efa49512aedd0aac79",7542749,1,-197,0,489,164,20,-144
"b7719e26494940efa49512aedd0aac79","d4f45188d3c84a02ba08454e6403a818",7542749,3,5,0,490,20,24,4
"d4c3b003e8274e429d2fa688d73fde6d","3cbcea2be0984e7dbd5a48195af10ce7",7542749,1,197,0,492,22,165,143
"82e6285962b8400d9d6fc32436022a94","a9ac840f098c4bd0a2ee896214ce29cd",7542749,1,3,0,495,167,168,1
"a9ac840f098c4bd0a2ee896214ce29cd","3cbcea2be0984e7dbd5a48195af10ce7",7542749,1,-5,0,496,168,165,-3
"3cbcea2be0984e7dbd5a48195af10ce7","0c7262dff33c4087bc660ccf40f92f9c",7542749,1,9,0,497,165,169,4
"0c7262dff33c4087bc660ccf40f92f9c","a9ac840f098c4bd0a2ee896214ce29cd",7542749,2,-4,0,498,169,168,-1
"a9ac840f098c4bd0a2ee896214ce29cd","b2275c3fad834f8d90737a2d9a6927d6",7542749,1,7,0,499,168,172,4
"b2275c3fad834f8d90737a2d9a6927d6","0c7262dff33c4087bc660ccf40f92f9c",7542749,2,-3,0,500,172,169,-3
"b2275c3fad834f8d90737a2d9a6927d6","df1de691dafe4549a18a4398ee9dfaf9",7542749,1,-46,0,502,172,139,-33
"df1de691dafe4549a18a4398ee9dfaf9","df1de691dafe4549a18a4398ee9dfaf9",7542749,2,0,1,503,139,139,0
"df1de691dafe4549a18a4398ee9dfaf9","6c5ad271a44743479bfaea29b1db8d02",7542749,1,4,0,504,139,143,4
"6c5ad271a44743479bfaea29b1db8d02","6c5ad271a44743479bfaea29b1db8d02",7542749,1,0,1,505,143,143,0
"6c5ad271a44743479bfaea29b1db8d02","83d311bed5374fee83d8d67a7d9d82dc",7542749,1,1,0,506,143,144,1
"83d311bed5374fee83d8d67a7d9d82dc","83d311bed5374fee83d8d67a7d9d82dc",7542749,1,0,1,507,144,144,0
"83d311bed5374fee83d8d67a7d9d82dc","402bba41861d43acb52a5abb89e8831e",7542749,1,1,0,508,144,145,1
"402bba41861d43acb52a5abb89e8831e","402bba41861d43acb52a5abb89e8831e",7542749,2,0,1,509,145,145,0
"402bba41861d43acb52a5abb89e8831e","8aae34f5ddbb4052a709b12e6b0d40fa",7542749,1,3,0,511,145,147,2
"8aae34f5ddbb4052a709b12e6b0d40fa","df1de691dafe4549a18a4398ee9dfaf9",7542749,1,-9,0,512,147,139,-8
"df1de691dafe4549a18a4398ee9dfaf9","8aae34f5ddbb4052a709b12e6b0d40fa",7542749,3,9,0,513,139,147,8
"8aae34f5ddbb4052a709b12e6b0d40fa","8aae34f5ddbb4052a709b12e6b0d40fa",7542749,8,0,1,514,147,147,0
"8aae34f5ddbb4052a709b12e6b0d40fa","645b3f0249f64f76af2e19eb4d0e55b7",7542749,1,2,0,521,147,149,2
"645b3f0249f64f76af2e19eb4d0e55b7","645b3f0249f64f76af2e19eb4d0e55b7",7542749,9,0,1,522,149,149,0
"645b3f0249f64f76af2e19eb4d0e55b7","7e7b8db5064d4369805ab370aac5ddfb",7542749,1,1,0,531,149,150,1
"7e7b8db5064d4369805ab370aac5ddfb","7e7b8db5064d4369805ab370aac5ddfb",7542749,6,0,1,532,150,150,0
"7e7b8db5064d4369805ab370aac5ddfb","8956d210ae7f41968fada86d4c979d6a",7542749,2,1,0,534,150,151,1
"8956d210ae7f41968fada86d4c979d6a","8956d210ae7f41968fada86d4c979d6a",7542749,4,0,1,535,151,151,0
"8956d210ae7f41968fada86d4c979d6a","f902b0f41b544d4dbf79664fd233648d",7542749,2,-5,0,537,151,146,-5
"f902b0f41b544d4dbf79664fd233648d","ae781e8b775e4ccd93bc800dad5c8376",7542749,1,8,0,538,146,153,7
"ae781e8b775e4ccd93bc800dad5c8376","ae781e8b775e4ccd93bc800dad5c8376",7542749,2,0,1,539,153,153,0
"ae781e8b775e4ccd93bc800dad5c8376","06882a8492d9499aa31555567f575ecb",7542749,1,1,0,541,153,154,1
"06882a8492d9499aa31555567f575ecb","06882a8492d9499aa31555567f575ecb",7542749,1,0,1,542,154,154,0
"06882a8492d9499aa31555567f575ecb","f293c508f409466a8f27ddd7d1e40b20",7542749,1,1,0,543,154,155,1
"f293c508f409466a8f27ddd7d1e40b20","f293c508f409466a8f27ddd7d1e40b20",7542749,2,0,1,544,155,155,0
"f293c508f409466a8f27ddd7d1e40b20","cc4ddef5bbbe48ebb605141b347c4ed1",7542749,1,1,0,546,155,156,1
"cc4ddef5bbbe48ebb605141b347c4ed1","cc4ddef5bbbe48ebb605141b347c4ed1",7542749,1,0,1,547,156,156,0
"cc4ddef5bbbe48ebb605141b347c4ed1","d313cec988a84645bee413e8d4724a4b",7542749,1,3,0,548,156,158,2
"d313cec988a84645bee413e8d4724a4b","f03480cf4eba413194d7af52fc0e7f28",7542749,1,-7,0,549,158,152,-6
"f03480cf4eba413194d7af52fc0e7f28","d313cec988a84645bee413e8d4724a4b",7542749,1,7,0,550,152,158,6
"d313cec988a84645bee413e8d4724a4b","d313cec988a84645bee413e8d4724a4b",7542749,5,0,1,551,158,158,0
"d313cec988a84645bee413e8d4724a4b","dc60696c76a74368a60f72246e47700d",7542749,1,1,0,554,158,159,1
"dc60696c76a74368a60f72246e47700d","dc60696c76a74368a60f72246e47700d",7542749,1,0,1,555,159,159,0
"dc60696c76a74368a60f72246e47700d","df1de691dafe4549a18a4398ee9dfaf9",7542749,2,-23,0,556,159,139,-20
"df1de691dafe4549a18a4398ee9dfaf9","78adeee1fa2c4fe0bc73f7bca9fcee86",7542749,2,26,0,557,139,160,21
"82e6285962b8400d9d6fc32436022a94","dc60696c76a74368a60f72246e47700d",7542749,1,-13,0,570,167,159,-8
"df1de691dafe4549a18a4398ee9dfaf9","dc60696c76a74368a60f72246e47700d",7542749,1,23,0,572,139,159,20
"dc60696c76a74368a60f72246e47700d","d313cec988a84645bee413e8d4724a4b",7542749,1,-1,0,573,159,158,-1
"d313cec988a84645bee413e8d4724a4b","df1de691dafe4549a18a4398ee9dfaf9",7542749,1,-22,0,576,158,139,-19
"3cbcea2be0984e7dbd5a48195af10ce7","78adeee1fa2c4fe0bc73f7bca9fcee86",7542749,1,-8,0,588,165,160,-5
"78adeee1fa2c4fe0bc73f7bca9fcee86","82e6285962b8400d9d6fc32436022a94",7542749,1,10,0,589,160,167,7
"82e6285962b8400d9d6fc32436022a94","3cbcea2be0984e7dbd5a48195af10ce7",7542749,1,-2,0,590,167,165,-2
"3cbcea2be0984e7dbd5a48195af10ce7","a9ac840f098c4bd0a2ee896214ce29cd",7542749,1,5,0,591,165,168,3
"a9ac840f098c4bd0a2ee896214ce29cd","67a089198fcb4e1c8f2385786c2b296f",7542749,1,-165,0,592,168,39,-129
"67a089198fcb4e1c8f2385786c2b296f","0d987bed3ffa4ed0b9a2e62e97b7b30f",7542749,1,304,0,593,39,272,233
"0d987bed3ffa4ed0b9a2e62e97b7b30f","0d987bed3ffa4ed0b9a2e62e97b7b30f",7542749,2,0,1,594,272,272,0
"bb5a47f5ea01454a8b79455422d3b9da","0c7262dff33c4087bc660ccf40f92f9c",7542749,1,-145,0,614,280,169,-111
"0c7262dff33c4087bc660ccf40f92f9c","0c7262dff33c4087bc660ccf40f92f9c",7542749,2,0,1,615,169,169,0
"b2275c3fad834f8d90737a2d9a6927d6","a9ac840f098c4bd0a2ee896214ce29cd",7542749,1,-7,0,617,172,168,-4
"a9ac840f098c4bd0a2ee896214ce29cd","0c7262dff33c4087bc660ccf40f92f9c",7542749,2,4,0,618,168,169,1
"b2275c3fad834f8d90737a2d9a6927d6","b2275c3fad834f8d90737a2d9a6927d6",7542749,26,0,1,625,172,172,0
"b2275c3fad834f8d90737a2d9a6927d6","eb515a26030b41f8a82a1e6114420bad",7542749,1,1,0,651,172,173,1
"eb515a26030b41f8a82a1e6114420bad","eb515a26030b41f8a82a1e6114420bad",7542749,2,0,1,652,173,173,0
"eb515a26030b41f8a82a1e6114420bad","0c7262dff33c4087bc660ccf40f92f9c",7542749,1,-4,0,654,173,169,-4
"0c7262dff33c4087bc660ccf40f92f9c","b42cc17b7de840f181a704558d0bc845",7542749,1,7,0,655,169,175,6
"b42cc17b7de840f181a704558d0bc845","b42cc17b7de840f181a704558d0bc845",7542749,9,0,1,656,175,175,0
"b42cc17b7de840f181a704558d0bc845","801f9e9135034f49bf5f8b4bdefedb41",7542749,1,2,0,665,175,177,2
"801f9e9135034f49bf5f8b4bdefedb41","801f9e9135034f49bf5f8b4bdefedb41",7542749,4,0,1,666,177,177,0
"801f9e9135034f49bf5f8b4bdefedb41","362fcb0699a14845ab29b2340093e528",7542749,1,-3,0,670,177,174,-3
"362fcb0699a14845ab29b2340093e528","ea38cc0e6e6e41edbabf210220808bf9",7542749,1,6,0,671,174,179,5
"ea38cc0e6e6e41edbabf210220808bf9","b87c552dd247427abe6ab5795b9c9d43",7542749,2,2,0,672,179,181,2
"b87c552dd247427abe6ab5795b9c9d43","ea38cc0e6e6e41edbabf210220808bf9",7542749,1,-2,0,673,181,179,-2
"ea38cc0e6e6e41edbabf210220808bf9","ea38cc0e6e6e41edbabf210220808bf9",7542749,5,0,1,674,179,179,0
"b87c552dd247427abe6ab5795b9c9d43","b87c552dd247427abe6ab5795b9c9d43",7542749,7,0,1,680,181,181,0
"b87c552dd247427abe6ab5795b9c9d43","139b097acfca451689d80c9c6eebdf7b",7542749,1,-3,0,687,181,178,-3
"139b097acfca451689d80c9c6eebdf7b","30f660a1feb34582a739722532524f79",7542749,1,6,0,688,178,183,5
"30f660a1feb34582a739722532524f79","30f660a1feb34582a739722532524f79",7542749,5,0,1,689,183,183,0
"30f660a1feb34582a739722532524f79","2024b4885bd14338a39b7b509acbbd02",7542749,1,-1,0,694,183,182,-1
"2024b4885bd14338a39b7b509acbbd02","c3f63fe50d8e487c86bf8ef76c9cadd3",7542749,1,4,0,695,182,185,3
"c3f63fe50d8e487c86bf8ef76c9cadd3","c3f63fe50d8e487c86bf8ef76c9cadd3",7542749,1,0,1,696,185,185,0
"c3f63fe50d8e487c86bf8ef76c9cadd3","0c7262dff33c4087bc660ccf40f92f9c",7542749,1,-20,0,697,185,169,-16
"0c7262dff33c4087bc660ccf40f92f9c","c8e371568a0c4391b25796ae4e91952e",7542749,1,23,0,698,169,186,17
"c8e371568a0c4391b25796ae4e91952e","7d932b23e1c84326ae5aa4d3c0d813d1",7542749,1,2,0,699,186,188,2
"7d932b23e1c84326ae5aa4d3c0d813d1","7d932b23e1c84326ae5aa4d3c0d813d1",7542749,1,0,1,700,188,188,0
"7d932b23e1c84326ae5aa4d3c0d813d1","c8e371568a0c4391b25796ae4e91952e",7542749,1,-2,0,701,188,186,-2
"c8e371568a0c4391b25796ae4e91952e","ab11d94c6c8948ea90b88f19d2cd502b",7542749,2,5,0,702,186,190,4
"ab11d94c6c8948ea90b88f19d2cd502b","0c7262dff33c4087bc660ccf40f92f9c",7542749,1,-28,0,703,190,169,-21
"0c7262dff33c4087bc660ccf40f92f9c","df1de691dafe4549a18a4398ee9dfaf9",7542749,1,-43,0,704,169,139,-30
"df1de691dafe4549a18a4398ee9dfaf9","f902b0f41b544d4dbf79664fd233648d",7542749,2,8,0,705,139,146,7
"f902b0f41b544d4dbf79664fd233648d","8aae34f5ddbb4052a709b12e6b0d40fa",7542749,2,1,0,706,146,147,1
"8aae34f5ddbb4052a709b12e6b0d40fa","7e7b8db5064d4369805ab370aac5ddfb",7542749,2,3,0,707,147,150,3
"f902b0f41b544d4dbf79664fd233648d","f902b0f41b544d4dbf79664fd233648d",7542749,1,0,1,714,146,146,0
"f902b0f41b544d4dbf79664fd233648d","df1de691dafe4549a18a4398ee9dfaf9",7542749,2,-8,0,715,146,139,-7
"7e7b8db5064d4369805ab370aac5ddfb","f902b0f41b544d4dbf79664fd233648d",7542749,1,-4,0,720,150,146,-4
"8aae34f5ddbb4052a709b12e6b0d40fa","f902b0f41b544d4dbf79664fd233648d",7542749,1,-1,0,726,147,146,-1
"f902b0f41b544d4dbf79664fd233648d","c8e371568a0c4391b25796ae4e91952e",7542749,1,58,0,727,146,186,40
"c8e371568a0c4391b25796ae4e91952e","07b44a7a51e94c78b411c753fc39dab0",7542749,1,4,0,728,186,189,3
"07b44a7a51e94c78b411c753fc39dab0","ab11d94c6c8948ea90b88f19d2cd502b",7542749,1,1,0,729,189,190,1
"ab11d94c6c8948ea90b88f19d2cd502b","f992451ed6ad4e68bb9e68ad6be7c4be",7542749,1,2,0,730,190,192,2
"f992451ed6ad4e68bb9e68ad6be7c4be","f992451ed6ad4e68bb9e68ad6be7c4be",7542749,1,0,1,731,192,192,0
"f992451ed6ad4e68bb9e68ad6be7c4be","c8e371568a0c4391b25796ae4e91952e",7542749,1,-7,0,732,192,186,-6
"ab11d94c6c8948ea90b88f19d2cd502b","ab11d94c6c8948ea90b88f19d2cd502b",7542749,12,0,1,734,190,190,0
"ab11d94c6c8948ea90b88f19d2cd502b","07b44a7a51e94c78b411c753fc39dab0",7542749,2,-1,0,746,190,189,-1
"07b44a7a51e94c78b411c753fc39dab0","6cd2dcaac46847d4a0bc53f296d90375",7542749,2,6,0,747,189,194,5
"6cd2dcaac46847d4a0bc53f296d90375","6cd2dcaac46847d4a0bc53f296d90375",7542749,8,0,1,748,194,194,0
"6cd2dcaac46847d4a0bc53f296d90375","2d2580c9411c4972909db508d6956a58",7542749,2,2,0,756,194,196,2
"2d2580c9411c4972909db508d6956a58","2d2580c9411c4972909db508d6956a58",7542749,4,0,1,757,196,196,0
"2d2580c9411c4972909db508d6956a58","5bddb3d9ed264f3984702f048c7e5340",7542749,2,1,0,759,196,197,1
"5bddb3d9ed264f3984702f048c7e5340","5bddb3d9ed264f3984702f048c7e5340",7542749,4,0,1,760,197,197,0
"5bddb3d9ed264f3984702f048c7e5340","d5e8e2bd12a2466b9d6d90855f0eb079",7542749,2,1,0,762,197,198,1
"d5e8e2bd12a2466b9d6d90855f0eb079","d5e8e2bd12a2466b9d6d90855f0eb079",7542749,4,0,1,763,198,198,0
"d5e8e2bd12a2466b9d6d90855f0eb079","017d7ca8e0394b91aaadc9574df2202c",7542749,2,-5,0,765,198,193,-5
"017d7ca8e0394b91aaadc9574df2202c","54e8e9f0ea3e45c4bf3b8ac799ee31b1",7542749,1,8,0,766,193,200,7
"54e8e9f0ea3e45c4bf3b8ac799ee31b1","54e8e9f0ea3e45c4bf3b8ac799ee31b1",7542749,1,0,1,767,200,200,0
"54e8e9f0ea3e45c4bf3b8ac799ee31b1","c614a00911be4877a075f19315530fb0",7542749,1,1,0,768,200,201,1
"c614a00911be4877a075f19315530fb0","c614a00911be4877a075f19315530fb0",7542749,6,0,1,769,201,201,0
"c614a00911be4877a075f19315530fb0","a6c21bd8b95249c7972820a7a7d76aff",7542749,1,1,0,775,201,202,1
"a6c21bd8b95249c7972820a7a7d76aff","a6c21bd8b95249c7972820a7a7d76aff",7542749,1,0,1,776,202,202,0
"a6c21bd8b95249c7972820a7a7d76aff","bb329d880ab54120adaf203a693bb203",7542749,1,1,0,777,202,203,1
"bb329d880ab54120adaf203a693bb203","bb329d880ab54120adaf203a693bb203",7542749,1,0,1,778,203,203,0
"bb329d880ab54120adaf203a693bb203","f9170dd6bc6442b4acd832747609b09a",7542749,1,-4,0,779,203,199,-4
"f9170dd6bc6442b4acd832747609b09a","334c2344009840079b1d0e1b7ce3d5a7",7542749,1,7,0,780,199,205,6
"334c2344009840079b1d0e1b7ce3d5a7","334c2344009840079b1d0e1b7ce3d5a7",7542749,1,0,1,781,205,205,0
"334c2344009840079b1d0e1b7ce3d5a7","d7f13c8d63ec4e2aa673fbb9cf9c6933",7542749,1,3,0,782,205,206,1
"d7f13c8d63ec4e2aa673fbb9cf9c6933","c8e371568a0c4391b25796ae4e91952e",7542749,2,-26,0,783,206,186,-20
"c8e371568a0c4391b25796ae4e91952e","7108f0e4c2584f1f9c471689ae4c885c",7542749,1,28,0,784,186,208,22
"7108f0e4c2584f1f9c471689ae4c885c","b9e80f77c3a44349863b19875725c384",7542749,1,-1,0,785,208,207,-1
"b9e80f77c3a44349863b19875725c384","b9e80f77c3a44349863b19875725c384",7542749,12,0,1,786,207,207,0
"b9e80f77c3a44349863b19875725c384","7108f0e4c2584f1f9c471689ae4c885c",7542749,2,1,0,798,207,208,1
"7108f0e4c2584f1f9c471689ae4c885c","7108f0e4c2584f1f9c471689ae4c885c",7542749,14,0,1,799,208,208,0
"7108f0e4c2584f1f9c471689ae4c885c","d7f13c8d63ec4e2aa673fbb9cf9c6933",7542749,1,-2,0,813,208,206,-2
"d7f13c8d63ec4e2aa673fbb9cf9c6933","09400e101c5d4b439cf9a26b03aae558",7542749,3,5,0,814,206,210,4
"09400e101c5d4b439cf9a26b03aae558","0c7262dff33c4087bc660ccf40f92f9c",7542749,1,-54,0,815,210,169,-41
"0c7262dff33c4087bc660ccf40f92f9c","017d7ca8e0394b91aaadc9574df2202c",7542749,1,32,0,816,169,193,24
"017d7ca8e0394b91aaadc9574df2202c","c8e371568a0c4391b25796ae4e91952e",7542749,1,-9,0,817,193,186,-7
"c8e371568a0c4391b25796ae4e91952e","6cd2dcaac46847d4a0bc53f296d90375",7542749,1,10,0,818,186,194,8
"6cd2dcaac46847d4a0bc53f296d90375","d5e8e2bd12a2466b9d6d90855f0eb079",7542749,1,4,0,819,194,198,4
"d5e8e2bd12a2466b9d6d90855f0eb079","6cd2dcaac46847d4a0bc53f296d90375",7542749,1,-4,0,820,198,194,-4
"6cd2dcaac46847d4a0bc53f296d90375","017d7ca8e0394b91aaadc9574df2202c",7542749,1,-1,0,821,194,193,-1
"017d7ca8e0394b91aaadc9574df2202c","f9170dd6bc6442b4acd832747609b09a",7542749,2,7,0,822,193,199,6
"f9170dd6bc6442b4acd832747609b09a","ab11d94c6c8948ea90b88f19d2cd502b",7542749,1,-11,0,823,199,190,-9
"f9170dd6bc6442b4acd832747609b09a","d7f13c8d63ec4e2aa673fbb9cf9c6933",7542749,1,10,0,837,199,206,7
"c8e371568a0c4391b25796ae4e91952e","b9e80f77c3a44349863b19875725c384",7542749,1,27,0,839,186,207,21
"7108f0e4c2584f1f9c471689ae4c885c","09400e101c5d4b439cf9a26b03aae558",7542749,1,3,0,841,208,210,2
"09400e101c5d4b439cf9a26b03aae558","d7f13c8d63ec4e2aa673fbb9cf9c6933",7542749,1,-5,0,842,210,206,-4
"d7f13c8d63ec4e2aa673fbb9cf9c6933","a88efa7e50ce47159810ab553afa6d3a",7542749,1,7,0,843,206,212,6
"a88efa7e50ce47159810ab553afa6d3a","a88efa7e50ce47159810ab553afa6d3a",7542749,7,0,1,844,212,212,0
"a88efa7e50ce47159810ab553afa6d3a","df1de691dafe4549a18a4398ee9dfaf9",7542749,1,-99,0,846,212,139,-73
"8aae34f5ddbb4052a709b12e6b0d40fa","a88efa7e50ce47159810ab553afa6d3a",7542749,1,90,0,848,147,212,65
"a88efa7e50ce47159810ab553afa6d3a","d7f13c8d63ec4e2aa673fbb9cf9c6933",7542749,1,-7,0,849,212,206,-6
"09400e101c5d4b439cf9a26b03aae558","be502a7a43c44bf7b682698de79d9369",7542749,2,5,0,851,210,214,4
"be502a7a43c44bf7b682698de79d9369","a875096404ef4a9984b62d74cda916f9",7542749,3,-6,0,852,214,209,-5
"a875096404ef4a9984b62d74cda916f9","f7fb1952f56b4189b86a9f8b7862d2b8",7542749,3,7,0,853,209,215,6
"f7fb1952f56b4189b86a9f8b7862d2b8","09400e101c5d4b439cf9a26b03aae558",7542749,1,-6,0,854,215,210,-5
"09400e101c5d4b439cf9a26b03aae558","ec341f459285443b8361f7f15638ff08",7542749,1,4,0,855,210,213,3
"ec341f459285443b8361f7f15638ff08","a88efa7e50ce47159810ab553afa6d3a",7542749,1,-2,0,856,213,212,-1
"a88efa7e50ce47159810ab553afa6d3a","09400e101c5d4b439cf9a26b03aae558",7542749,1,-2,0,860,212,210,-2
"09400e101c5d4b439cf9a26b03aae558","09400e101c5d4b439cf9a26b03aae558",7542749,10,0,1,861,210,210,0
"f7fb1952f56b4189b86a9f8b7862d2b8","ec341f459285443b8361f7f15638ff08",7542749,2,-2,0,873,215,213,-2
"ec341f459285443b8361f7f15638ff08","363837c182e04711840d896ae1e0339c",7542749,2,6,0,874,213,218,5
"363837c182e04711840d896ae1e0339c","f7fb1952f56b4189b86a9f8b7862d2b8",7542749,1,-4,0,875,218,215,-3
"f7fb1952f56b4189b86a9f8b7862d2b8","be502a7a43c44bf7b682698de79d9369",7542749,2,-1,0,876,215,214,-1
"be502a7a43c44bf7b682698de79d9369","01b2051f8941460d89945e3b02d1ce78",7542749,1,4,0,877,214,217,3
"01b2051f8941460d89945e3b02d1ce78","ec341f459285443b8361f7f15638ff08",7542749,1,-5,0,878,217,213,-4
"ec341f459285443b8361f7f15638ff08","09400e101c5d4b439cf9a26b03aae558",7542749,2,-4,0,879,213,210,-3
"09400e101c5d4b439cf9a26b03aae558","a88efa7e50ce47159810ab553afa6d3a",7542749,1,2,0,880,210,212,2
"a88efa7e50ce47159810ab553afa6d3a","be502a7a43c44bf7b682698de79d9369",7542749,1,3,0,883,212,214,2
"09400e101c5d4b439cf9a26b03aae558","a875096404ef4a9984b62d74cda916f9",7542749,2,-1,0,888,210,209,-1
"a875096404ef4a9984b62d74cda916f9","be502a7a43c44bf7b682698de79d9369",7542749,2,6,0,889,209,214,5
"be502a7a43c44bf7b682698de79d9369","f7fb1952f56b4189b86a9f8b7862d2b8",7542749,3,1,0,890,214,215,1
"be502a7a43c44bf7b682698de79d9369","be502a7a43c44bf7b682698de79d9369",7542749,7,0,1,892,214,214,0
"f7fb1952f56b4189b86a9f8b7862d2b8","f7fb1952f56b4189b86a9f8b7862d2b8",7542749,15,0,1,900,215,215,0
"f7fb1952f56b4189b86a9f8b7862d2b8","b860ee85d8bc4a2f97958cfb71be3533",7542749,1,1,0,915,215,216,1
"b860ee85d8bc4a2f97958cfb71be3533","b860ee85d8bc4a2f97958cfb71be3533",7542749,2,0,1,916,216,216,0
"b860ee85d8bc4a2f97958cfb71be3533","363837c182e04711840d896ae1e0339c",7542749,1,3,0,918,216,218,2
"363837c182e04711840d896ae1e0339c","ec341f459285443b8361f7f15638ff08",7542749,1,-6,0,919,218,213,-5
"363837c182e04711840d896ae1e0339c","363837c182e04711840d896ae1e0339c",7542749,11,0,1,921,218,218,0
"363837c182e04711840d896ae1e0339c","01b2051f8941460d89945e3b02d1ce78",7542749,1,-1,0,932,218,217,-1
"01b2051f8941460d89945e3b02d1ce78","91125ca626c5470eb145501f8c37f8db",7542749,1,4,0,933,217,220,3
"91125ca626c5470eb145501f8c37f8db","91125ca626c5470eb145501f8c37f8db",7542749,1,0,1,934,220,220,0
"91125ca626c5470eb145501f8c37f8db","1c6721b1f63f4d30ba7746ea8af02a52",7542749,1,3,0,935,220,221,1
"1c6721b1f63f4d30ba7746ea8af02a52","d7f13c8d63ec4e2aa673fbb9cf9c6933",7542749,1,-21,0,936,221,206,-15
"d7f13c8d63ec4e2aa673fbb9cf9c6933","77ecef8eff6b4a2caea7707669bf7475",7542749,1,22,0,937,206,222,16
"77ecef8eff6b4a2caea7707669bf7475","0c7262dff33c4087bc660ccf40f92f9c",7542749,1,-71,0,938,222,169,-53
"0c7262dff33c4087bc660ccf40f92f9c","a875096404ef4a9984b62d74cda916f9",7542749,1,53,0,939,169,209,40
"a875096404ef4a9984b62d74cda916f9","d7f13c8d63ec4e2aa673fbb9cf9c6933",7542749,1,-4,0,940,209,206,-3
"f7fb1952f56b4189b86a9f8b7862d2b8","0c7262dff33c4087bc660ccf40f92f9c",7542749,1,-60,0,946,215,169,-46
"0c7262dff33c4087bc660ccf40f92f9c","1c6721b1f63f4d30ba7746ea8af02a52",7542749,1,70,0,947,169,221,52
"1c6721b1f63f4d30ba7746ea8af02a52","1c6721b1f63f4d30ba7746ea8af02a52",7542749,1,0,1,948,221,221,0
"1c6721b1f63f4d30ba7746ea8af02a52","77ecef8eff6b4a2caea7707669bf7475",7542749,1,1,0,949,221,222,1
"77ecef8eff6b4a2caea7707669bf7475","77ecef8eff6b4a2caea7707669bf7475",7542749,14,0,1,950,222,222,0
"77ecef8eff6b4a2caea7707669bf7475","1c6721b1f63f4d30ba7746ea8af02a52",7542749,1,-1,0,964,222,221,-1
"1c6721b1f63f4d30ba7746ea8af02a52","d03cb855c70044cf8c35d9ec0de696e3",7542749,2,4,0,965,221,224,3
"d03cb855c70044cf8c35d9ec0de696e3","8b9ae98743bd4d4a8a87dff1c1244211",7542749,2,3,0,966,224,227,3
"8b9ae98743bd4d4a8a87dff1c1244211","1c6721b1f63f4d30ba7746ea8af02a52",7542749,1,-7,0,967,227,221,-6
"8b9ae98743bd4d4a8a87dff1c1244211","d03cb855c70044cf8c35d9ec0de696e3",7542749,1,-3,0,970,227,224,-3
"d03cb855c70044cf8c35d9ec0de696e3","d03cb855c70044cf8c35d9ec0de696e3",7542749,4,0,1,971,224,224,0
"d03cb855c70044cf8c35d9ec0de696e3","a49a937d6896486d9a5396654abcf2e1",7542749,1,2,0,975,224,226,2
"a49a937d6896486d9a5396654abcf2e1","a49a937d6896486d9a5396654abcf2e1",7542749,3,0,1,976,226,226,0
"a49a937d6896486d9a5396654abcf2e1","8b9ae98743bd4d4a8a87dff1c1244211",7542749,1,1,0,979,226,227,1
"8b9ae98743bd4d4a8a87dff1c1244211","8b9ae98743bd4d4a8a87dff1c1244211",7542749,13,0,1,980,227,227,0
"8b9ae98743bd4d4a8a87dff1c1244211","f7906d6f59b9489a91d2ef40db5a474d",7542749,1,-4,0,993,227,223,-4
"f7906d6f59b9489a91d2ef40db5a474d","2ab1535aac1346ba8801535bf729ef37",7542749,1,7,0,994,223,229,6
"2ab1535aac1346ba8801535bf729ef37","2ab1535aac1346ba8801535bf729ef37",7542749,9,0,1,1000,229,229,0
"2ab1535aac1346ba8801535bf729ef37","a4f40fb48a8542c8949bae1f002cd9bc",7542749,1,2,0,1004,229,231,2
"a4f40fb48a8542c8949bae1f002cd9bc","a4f40fb48a8542c8949bae1f002cd9bc",7542749,2,0,1,1005,231,231,0
"a4f40fb48a8542c8949bae1f002cd9bc","8972c23e32044edb8a78fa1eed4e5947",7542749,1,1,0,1007,231,232,1
"8972c23e32044edb8a78fa1eed4e5947","8972c23e32044edb8a78fa1eed4e5947",7542749,1,0,1,1008,232,232,0
"8972c23e32044edb8a78fa1eed4e5947","92feb4a40f8344d38b6f722e42a53295",7542749,1,1,0,1009,232,233,1
"92feb4a40f8344d38b6f722e42a53295","92feb4a40f8344d38b6f722e42a53295",7542749,2,0,1,1010,233,233,0
"92feb4a40f8344d38b6f722e42a53295","5152833676bf4c6cb317060be10f68db",7542749,1,-5,0,1012,233,228,-5
"5152833676bf4c6cb317060be10f68db","1c6721b1f63f4d30ba7746ea8af02a52",7542749,1,-9,0,1013,228,221,-7
"1c6721b1f63f4d30ba7746ea8af02a52","ca3e28f290354c08aefe5b0f769604e6",7542749,1,17,0,1014,221,235,14
"ca3e28f290354c08aefe5b0f769604e6","ca3e28f290354c08aefe5b0f769604e6",7542749,4,0,1,1015,235,235,0
"ca3e28f290354c08aefe5b0f769604e6","79a35eea833e4c2c9d22fc53c3c6445c",7542749,1,1,0,1019,235,236,1
"79a35eea833e4c2c9d22fc53c3c6445c","79a35eea833e4c2c9d22fc53c3c6445c",7542749,4,0,1,1020,236,236,0
"79a35eea833e4c2c9d22fc53c3c6445c","8f68228b1518449e9615cdafee41a2bd",7542749,1,1,0,1024,236,237,1
"8f68228b1518449e9615cdafee41a2bd","8f68228b1518449e9615cdafee41a2bd",7542749,1,0,1,1025,237,237,0
"8f68228b1518449e9615cdafee41a2bd","cab89fa5c3ed45a5aa550fc0352d6a42",7542749,1,1,0,1026,237,238,1
"cab89fa5c3ed45a5aa550fc0352d6a42","cab89fa5c3ed45a5aa550fc0352d6a42",7542749,3,0,1,1027,238,238,0
"cab89fa5c3ed45a5aa550fc0352d6a42","66d4fad4f1cf4b46be0750a99ad7a35a",7542749,1,1,0,1030,238,239,1
"66d4fad4f1cf4b46be0750a99ad7a35a","66d4fad4f1cf4b46be0750a99ad7a35a",7542749,1,0,1,1031,239,239,0
"66d4fad4f1cf4b46be0750a99ad7a35a","0b04c8e2f86d48c7aeb7e225819cd32b",7542749,1,-5,0,1032,239,234,-5
"0b04c8e2f86d48c7aeb7e225819cd32b","f53da5fd9bfe412da4b80d4742563b6c",7542749,1,8,0,1033,234,241,7
"f53da5fd9bfe412da4b80d4742563b6c","f53da5fd9bfe412da4b80d4742563b6c",7542749,1,0,1,1034,241,241,0
"f53da5fd9bfe412da4b80d4742563b6c","1c6721b1f63f4d30ba7746ea8af02a52",7542749,1,-24,0,1035,241,221,-20
"1c6721b1f63f4d30ba7746ea8af02a52","2ae94c0cea4d480a9d5dca8fb1d7b542",7542749,1,27,0,1036,221,242,21
"2ae94c0cea4d480a9d5dca8fb1d7b542","1ebf23f9d994469a85206e4c7b1bf5f5",7542749,2,3,0,1037,242,245,3
"1ebf23f9d994469a85206e4c7b1bf5f5","1ebf23f9d994469a85206e4c7b1bf5f5",7542749,10,0,1,1038,245,245,0
"1ebf23f9d994469a85206e4c7b1bf5f5","85ae675b83e8422da842cfd25596af99",7542749,1,1,0,1048,245,246,1
"85ae675b83e8422da842cfd25596af99","85ae675b83e8422da842cfd25596af99",7542749,1,0,1,1049,246,246,0
"85ae675b83e8422da842cfd25596af99","2ae94c0cea4d480a9d5dca8fb1d7b542",7542749,1,-4,0,1050,246,242,-4
"2ae94c0cea4d480a9d5dca8fb1d7b542","fa235f0f364d47e4ae1c87f47bf8e6ba",7542749,1,12,0,1051,242,252,10
"fa235f0f364d47e4ae1c87f47bf8e6ba","fa235f0f364d47e4ae1c87f47bf8e6ba",7542749,7,0,1,1052,252,252,0
"fa235f0f364d47e4ae1c87f47bf8e6ba","79f7845465cc4ed19d8e4f1429541be0",7542749,2,2,0,1059,252,254,2
"79f7845465cc4ed19d8e4f1429541be0","79f7845465cc4ed19d8e4f1429541be0",7542749,4,0,1,1060,254,254,0
"79f7845465cc4ed19d8e4f1429541be0","00f61990949545828dd12f1303d47504",7542749,1,3,0,1062,254,256,2
"00f61990949545828dd12f1303d47504","6e83e23f56544a19b94067c1c558d9c0",7542749,3,-11,0,1063,256,247,-9
"6e83e23f56544a19b94067c1c558d9c0","fa235f0f364d47e4ae1c87f47bf8e6ba",7542749,1,6,0,1064,247,252,5
"fa235f0f364d47e4ae1c87f47bf8e6ba","d546341988904f069cfa86b21457d9d9",7542749,1,-1,0,1065,252,251,-1
"d546341988904f069cfa86b21457d9d9","fa235f0f364d47e4ae1c87f47bf8e6ba",7542749,3,1,0,1066,251,252,1
"fa235f0f364d47e4ae1c87f47bf8e6ba","00f61990949545828dd12f1303d47504",7542749,2,5,0,1067,252,256,4
"6e83e23f56544a19b94067c1c558d9c0","d546341988904f069cfa86b21457d9d9",7542749,1,5,0,1069,247,251,4
"79f7845465cc4ed19d8e4f1429541be0","6e83e23f56544a19b94067c1c558d9c0",7542749,1,-8,0,1074,254,247,-7
"6e83e23f56544a19b94067c1c558d9c0","00f61990949545828dd12f1303d47504",7542749,3,11,0,1075,247,256,9
"00f61990949545828dd12f1303d47504","d546341988904f069cfa86b21457d9d9",7542749,3,-6,0,1076,256,251,-5
"6e83e23f56544a19b94067c1c558d9c0","ead7bb4b64e247d2ae632ab8a296b091",7542749,1,13,0,1080,247,258,11
"ead7bb4b64e247d2ae632ab8a296b091","ead7bb4b64e247d2ae632ab8a296b091",7542749,2,0,1,1081,258,258,0
"ead7bb4b64e247d2ae632ab8a296b091","00f61990949545828dd12f1303d47504",7542749,1,-2,0,1083,258,256,-2
"00f61990949545828dd12f1303d47504","41b0048dde734bb280bac6116baa8e27",7542749,1,3,0,1084,256,259,3
"41b0048dde734bb280bac6116baa8e27","41b0048dde734bb280bac6116baa8e27",7542749,2,0,1,1085,259,259,0
"41b0048dde734bb280bac6116baa8e27","b41c5a094a604ee0915327da5cc0beb7",7542749,1,1,0,1087,259,260,1
"b41c5a094a604ee0915327da5cc0beb7","b41c5a094a604ee0915327da5cc0beb7",7542749,2,0,1,1088,260,260,0
"b41c5a094a604ee0915327da5cc0beb7","d546341988904f069cfa86b21457d9d9",7542749,1,-10,0,1090,260,251,-9
"d546341988904f069cfa86b21457d9d9","28c171777c52431ab6b925073bd63d46",7542749,1,15,0,1091,251,264,13
"28c171777c52431ab6b925073bd63d46","28c171777c52431ab6b925073bd63d46",7542749,7,0,1,1092,264,264,0
"28c171777c52431ab6b925073bd63d46","ac160db940cb49ae8579162b1d52bb5d",7542749,1,2,0,1099,264,266,2
"ac160db940cb49ae8579162b1d52bb5d","ac160db940cb49ae8579162b1d52bb5d",7542749,3,0,1,1100,266,266,0
"ac160db940cb49ae8579162b1d52bb5d","d989ebcfc12a4b669f0100dc1aa14f1e",7542749,1,-12,0,1103,266,255,-11
"d989ebcfc12a4b669f0100dc1aa14f1e","c6fd49b485cc4874b0bbdd9c6171e09c",7542749,1,15,0,1104,255,268,13
"c6fd49b485cc4874b0bbdd9c6171e09c","c6fd49b485cc4874b0bbdd9c6171e09c",7542749,3,0,1,1105,268,268,0
"c6fd49b485cc4874b0bbdd9c6171e09c","44240778a97c4af0937817499b75707b",7542749,1,1,0,1108,268,269,1
"44240778a97c4af0937817499b75707b","44240778a97c4af0937817499b75707b",7542749,2,0,1,1109,269,269,0
"44240778a97c4af0937817499b75707b","7aa76d3e993840d8805f097cbdbcd44b",7542749,1,-9,0,1111,269,261,-8
"7aa76d3e993840d8805f097cbdbcd44b","865a4d3b43374da7944dc7d397f566d9",7542749,1,12,0,1112,261,271,10
"865a4d3b43374da7944dc7d397f566d9","865a4d3b43374da7944dc7d397f566d9",7542749,1,0,1,1113,271,271,0
"865a4d3b43374da7944dc7d397f566d9","0d987bed3ffa4ed0b9a2e62e97b7b30f",7542749,1,3,0,1114,271,272,1
"0d987bed3ffa4ed0b9a2e62e97b7b30f","2ae94c0cea4d480a9d5dca8fb1d7b542",7542749,2,-38,0,1115,272,242,-30
"2ae94c0cea4d480a9d5dca8fb1d7b542","2ae94c0cea4d480a9d5dca8fb1d7b542",7542749,1,0,1,1116,242,242,0
"1ebf23f9d994469a85206e4c7b1bf5f5","2ae94c0cea4d480a9d5dca8fb1d7b542",7542749,1,-3,0,1118,245,242,-3
"2ae94c0cea4d480a9d5dca8fb1d7b542","30c9ba177afc49a695625d2bdec40207",7542749,1,9,0,1119,242,250,8
"30c9ba177afc49a695625d2bdec40207","30c9ba177afc49a695625d2bdec40207",7542749,2,0,1,1120,250,250,0
"30c9ba177afc49a695625d2bdec40207","6e83e23f56544a19b94067c1c558d9c0",7542749,1,-3,0,1122,250,247,-3
"00f61990949545828dd12f1303d47504","00f61990949545828dd12f1303d47504",7542749,2,0,1,1124,256,256,0
"d546341988904f069cfa86b21457d9d9","d989ebcfc12a4b669f0100dc1aa14f1e",7542749,2,5,0,1127,251,255,4
"d989ebcfc12a4b669f0100dc1aa14f1e","6e83e23f56544a19b94067c1c558d9c0",7542749,1,-10,0,1128,255,247,-8
"d989ebcfc12a4b669f0100dc1aa14f1e","0d987bed3ffa4ed0b9a2e62e97b7b30f",7542749,1,22,0,1132,255,272,17
"2ae94c0cea4d480a9d5dca8fb1d7b542","7aa76d3e993840d8805f097cbdbcd44b",7542749,1,23,0,1134,242,261,19
"7aa76d3e993840d8805f097cbdbcd44b","0d987bed3ffa4ed0b9a2e62e97b7b30f",7542749,1,15,0,1135,261,272,11
"0d987bed3ffa4ed0b9a2e62e97b7b30f","82ae07bc0c9b4570a41799290d1ef399",7542749,2,4,0,1136,272,275,3
"82ae07bc0c9b4570a41799290d1ef399","bb5a47f5ea01454a8b79455422d3b9da",7542749,2,6,0,1137,275,280,5
"bb5a47f5ea01454a8b79455422d3b9da","bb5a47f5ea01454a8b79455422d3b9da",7542749,90,0,1,1138,280,280,0
"bb5a47f5ea01454a8b79455422d3b9da","0d987bed3ffa4ed0b9a2e62e97b7b30f",7542749,3,-10,0,1205,280,272,-8
"0d987bed3ffa4ed0b9a2e62e97b7b30f","94cecc3f1e7d484b8e068e79241dfd73",7542749,2,13,0,1206,272,281,9
"94cecc3f1e7d484b8e068e79241dfd73","a37477c4e4c14169ad44b06b493007f6",7542749,3,2,0,1207,281,283,2
"a37477c4e4c14169ad44b06b493007f6","b7719e26494940efa49512aedd0aac79",7542749,1,-359,0,1208,283,20,-263
"b7719e26494940efa49512aedd0aac79","a49d1bb4328949299686242fd0be5584",7542749,3,2,0,1209,20,21,1
"a49d1bb4328949299686242fd0be5584","a49d1bb4328949299686242fd0be5584",7542749,1,0,1,1210,21,21,0
"a49d1bb4328949299686242fd0be5584","b7719e26494940efa49512aedd0aac79",7542749,1,-2,0,1211,21,20,-1
"b7719e26494940efa49512aedd0aac79","afbf7250b99d47bea07172749483ca97",7542749,1,12,0,1212,20,28,8
"afbf7250b99d47bea07172749483ca97","b613861cecf84ffcab01afb23f660475",7542749,1,-44,0,1213,28,1,-27
"b613861cecf84ffcab01afb23f660475","3cbcea2be0984e7dbd5a48195af10ce7",7542749,1,232,0,1214,1,165,164
"3cbcea2be0984e7dbd5a48195af10ce7","3cbcea2be0984e7dbd5a48195af10ce7",7542749,2,0,1,1215,165,165,0
"3cbcea2be0984e7dbd5a48195af10ce7","82e6285962b8400d9d6fc32436022a94",7542749,5,2,0,1216,165,167,2
"82e6285962b8400d9d6fc32436022a94","fab84b4fab5940efb4ea868ef8d09396",7542749,1,160,0,1217,167,284,117
"fab84b4fab5940efb4ea868ef8d09396","fab84b4fab5940efb4ea868ef8d09396",7542749,4,0,1,1218,284,284,0
"fab84b4fab5940efb4ea868ef8d09396","94cecc3f1e7d484b8e068e79241dfd73",7542749,1,-5,0,1220,284,281,-3
"a37477c4e4c14169ad44b06b493007f6","fab84b4fab5940efb4ea868ef8d09396",7542749,1,3,0,1222,283,284,1
"fab84b4fab5940efb4ea868ef8d09396","4a29443515bb404cb8924e1c60a63b73",7542749,2,4,0,1224,284,285,1
"4a29443515bb404cb8924e1c60a63b73","208c9b2796c944db8dacaa96082520ea",7542749,3,3,0,1225,285,288,3
"208c9b2796c944db8dacaa96082520ea","0d987bed3ffa4ed0b9a2e62e97b7b30f",7542749,1,-25,0,1226,288,272,-16
"0d987bed3ffa4ed0b9a2e62e97b7b30f","bb5a47f5ea01454a8b79455422d3b9da",7542749,2,10,0,1227,272,280,8
"a37477c4e4c14169ad44b06b493007f6","94cecc3f1e7d484b8e068e79241dfd73",7542749,1,-2,0,1240,283,281,-2
"94cecc3f1e7d484b8e068e79241dfd73","fab84b4fab5940efb4ea868ef8d09396",7542749,1,5,0,1241,281,284,3
"208c9b2796c944db8dacaa96082520ea","8959e6304a0348309a771e4d08d1b64a",7542749,1,-173,0,1245,288,163,-125
"8959e6304a0348309a771e4d08d1b64a","78adeee1fa2c4fe0bc73f7bca9fcee86",7542749,1,-4,0,1246,163,160,-3
"78adeee1fa2c4fe0bc73f7bca9fcee86","65202579580f4ad38d734b4ee39d22a8",7542749,5,5,0,1247,160,164,4
"65202579580f4ad38d734b4ee39d22a8","65202579580f4ad38d734b4ee39d22a8",7542749,81,0,1,1248,164,164,0
"65202579580f4ad38d734b4ee39d22a8","78adeee1fa2c4fe0bc73f7bca9fcee86",7542749,5,-5,0,1300,164,160,-4
"78adeee1fa2c4fe0bc73f7bca9fcee86","3cbcea2be0984e7dbd5a48195af10ce7",7542749,4,8,0,1301,160,165,5
"82e6285962b8400d9d6fc32436022a94","b71bac264efb4abd97015447bd490db6",7542749,1,274,0,1303,167,370,203
"b71bac264efb4abd97015447bd490db6","b71bac264efb4abd97015447bd490db6",7542749,1,0,1,1304,370,370,0
"b71bac264efb4abd97015447bd490db6","78adeee1fa2c4fe0bc73f7bca9fcee86",7542749,1,-284,0,1305,370,160,-210
"82e6285962b8400d9d6fc32436022a94","4a29443515bb404cb8924e1c60a63b73",7542749,1,164,0,1319,167,285,118
"4a29443515bb404cb8924e1c60a63b73","4a29443515bb404cb8924e1c60a63b73",7542749,1,0,1,1320,285,285,0
"208c9b2796c944db8dacaa96082520ea","208c9b2796c944db8dacaa96082520ea",7542749,5,0,1,1322,288,288,0
"208c9b2796c944db8dacaa96082520ea","4a29443515bb404cb8924e1c60a63b73",7542749,1,-3,0,1327,288,285,-3
"4a29443515bb404cb8924e1c60a63b73","7669a956527947d0add87455277e80b4",7542749,1,7,0,1328,285,291,6
"7669a956527947d0add87455277e80b4","7669a956527947d0add87455277e80b4",7542749,1,0,1,1329,291,291,0
"7669a956527947d0add87455277e80b4","6a9a3b5bde4a48daa896fe8c06eca56f",7542749,1,-2,0,1330,291,289,-2
"6a9a3b5bde4a48daa896fe8c06eca56f","869e967078f04da18dd0b0b9389a7424",7542749,1,5,0,1331,289,293,4
"869e967078f04da18dd0b0b9389a7424","869e967078f04da18dd0b0b9389a7424",7542749,18,0,1,1332,293,293,0
"869e967078f04da18dd0b0b9389a7424","51ab6291537748fab90d519aa09889d6",7542749,1,2,0,1350,293,295,2
"51ab6291537748fab90d519aa09889d6","51ab6291537748fab90d519aa09889d6",7542749,5,0,1,1351,295,295,0
"51ab6291537748fab90d519aa09889d6","34a6e49023fc4465bd5ca604330bbd1c",7542749,1,-3,0,1356,295,292,-3
"34a6e49023fc4465bd5ca604330bbd1c","21592f2a9e9c4b2f8c66ec5dbcbf6a2b",7542749,1,5,0,1357,292,296,4
"21592f2a9e9c4b2f8c66ec5dbcbf6a2b","ba0e59461bfb4a44b7b1c28a01f8d3b3",7542749,1,4,0,1358,296,299,3
"ba0e59461bfb4a44b7b1c28a01f8d3b3","4a29443515bb404cb8924e1c60a63b73",7542749,1,-18,0,1359,299,285,-14
"4a29443515bb404cb8924e1c60a63b73","ba0e59461bfb4a44b7b1c28a01f8d3b3",7542749,1,18,0,1360,285,299,14
"ba0e59461bfb4a44b7b1c28a01f8d3b3","ba0e59461bfb4a44b7b1c28a01f8d3b3",7542749,10,0,1,1361,299,299,0
"ba0e59461bfb4a44b7b1c28a01f8d3b3","0e0b36e731a645e7b1b8a88f5031ca38",7542749,1,2,0,1371,299,301,2
"0e0b36e731a645e7b1b8a88f5031ca38","0e0b36e731a645e7b1b8a88f5031ca38",7542749,2,0,1,1372,301,301,0
"0e0b36e731a645e7b1b8a88f5031ca38","a66a144637284c21afc6de17fea4bfb8",7542749,1,1,0,1374,301,302,1
"a66a144637284c21afc6de17fea4bfb8","a66a144637284c21afc6de17fea4bfb8",7542749,2,0,1,1375,302,302,0
"a66a144637284c21afc6de17fea4bfb8","7646a919d7e64fa990bca9b024ff089d",7542749,1,-4,0,1377,302,298,-4
"7646a919d7e64fa990bca9b024ff089d","4a29443515bb404cb8924e1c60a63b73",7542749,1,-17,0,1378,298,285,-13
"4a29443515bb404cb8924e1c60a63b73","3434c10e561d488a914e0f7d71907abd",7542749,3,27,0,1379,285,305,20
"3434c10e561d488a914e0f7d71907abd","53e7e900392747ccad52e711ab0f80d8",7542749,3,2,0,1380,305,307,2
"53e7e900392747ccad52e711ab0f80d8","2c5bb2cbd0014420ad8c95d40e38efd1",7542749,1,-6,0,1381,307,303,-4
"2c5bb2cbd0014420ad8c95d40e38efd1","4a29443515bb404cb8924e1c60a63b73",7542749,1,-23,0,1382,303,285,-18
"4a29443515bb404cb8924e1c60a63b73","e390b575229748ea8aac9364efe2bf00",7542749,1,24,0,1383,285,304,19
"e390b575229748ea8aac9364efe2bf00","e390b575229748ea8aac9364efe2bf00",7542749,3,0,1,1384,304,304,0
"e390b575229748ea8aac9364efe2bf00","4a29443515bb404cb8924e1c60a63b73",7542749,1,-24,0,1387,304,285,-19
"53e7e900392747ccad52e711ab0f80d8","53e7e900392747ccad52e711ab0f80d8",7542749,8,0,1,1390,307,307,0
"53e7e900392747ccad52e711ab0f80d8","3434c10e561d488a914e0f7d71907abd",7542749,1,-2,0,1392,307,305,-2
"53e7e900392747ccad52e711ab0f80d8","130acc2aeb0448fdbb2de63bc5cebe5b",7542749,1,3,0,1400,307,309,2
"130acc2aeb0448fdbb2de63bc5cebe5b","3434c10e561d488a914e0f7d71907abd",7542749,1,-5,0,1401,309,305,-4
"3434c10e561d488a914e0f7d71907abd","9c062b3251034ebe90f5054e2a3b5120",7542749,1,7,0,1402,305,311,6
"9c062b3251034ebe90f5054e2a3b5120","9c062b3251034ebe90f5054e2a3b5120",7542749,2,0,1,1403,311,311,0
"9c062b3251034ebe90f5054e2a3b5120","ea859f8207e44537889daeaba13ac2e8",7542749,1,1,0,1405,311,312,1
"ea859f8207e44537889daeaba13ac2e8","ea859f8207e44537889daeaba13ac2e8",7542749,1,0,1,1406,312,312,0
"ea859f8207e44537889daeaba13ac2e8","56d94971a7a94257aa330183a8ebd0ea",7542749,1,1,0,1407,312,313,1
"56d94971a7a94257aa330183a8ebd0ea","56d94971a7a94257aa330183a8ebd0ea",7542749,1,0,1,1408,313,313,0
"56d94971a7a94257aa330183a8ebd0ea","130acc2aeb0448fdbb2de63bc5cebe5b",7542749,1,-4,0,1409,313,309,-4
"130acc2aeb0448fdbb2de63bc5cebe5b","130acc2aeb0448fdbb2de63bc5cebe5b",7542749,5,0,1,1410,309,309,0
"130acc2aeb0448fdbb2de63bc5cebe5b","141c0df6cd1946539aadd1c9b7068cd4",7542749,1,-1,0,1415,309,308,-1
"141c0df6cd1946539aadd1c9b7068cd4","13255e63e0aa4abf85e5211bf613d43e",7542749,1,10,0,1416,308,317,9
"13255e63e0aa4abf85e5211bf613d43e","13255e63e0aa4abf85e5211bf613d43e",7542749,3,0,1,1417,317,317,0
"13255e63e0aa4abf85e5211bf613d43e","86c27d40179e419c8e9d150fb6afa5d0",7542749,1,3,0,1420,317,319,2
"86c27d40179e419c8e9d150fb6afa5d0","0c787d16c9504873b1a4d903cec09948",7542749,1,-6,0,1421,319,314,-5
"0c787d16c9504873b1a4d903cec09948","86c27d40179e419c8e9d150fb6afa5d0",7542749,1,6,0,1422,314,319,5
"86c27d40179e419c8e9d150fb6afa5d0","86c27d40179e419c8e9d150fb6afa5d0",7542749,2,0,1,1423,319,319,0
"86c27d40179e419c8e9d150fb6afa5d0","8d7e0b55cf9849cda222a0f2440cec55",7542749,1,-1,0,1425,319,318,-1
"8d7e0b55cf9849cda222a0f2440cec55","47edbb64109243e6b0f8f64cdef90c6c",7542749,1,9,0,1426,318,326,8
"47edbb64109243e6b0f8f64cdef90c6c","24f1363179ad4aaa965484a78471912b",7542749,2,-3,0,1427,326,323,-3
"24f1363179ad4aaa965484a78471912b","24f1363179ad4aaa965484a78471912b",7542749,1,0,1,1428,323,323,0
"24f1363179ad4aaa965484a78471912b","3628bdce1dd2429ba924d2d4d09448d2",7542749,2,-1,0,1429,323,322,-1
"3628bdce1dd2429ba924d2d4d09448d2","56b3fd1a212a4764be39d979fde3326e",7542749,1,7,0,1430,322,328,6
"56b3fd1a212a4764be39d979fde3326e","56b3fd1a212a4764be39d979fde3326e",7542749,3,0,1,1431,328,328,0
"56b3fd1a212a4764be39d979fde3326e","3434c10e561d488a914e0f7d71907abd",7542749,1,-28,0,1434,328,305,-23
"3434c10e561d488a914e0f7d71907abd","0c4079457ede49e3aeb5e86ed84bdf35",7542749,1,31,0,1435,305,329,24
"0c4079457ede49e3aeb5e86ed84bdf35","38aea304b4fa46e1b29bb72f5cea4c93",7542749,2,2,0,1436,329,331,2
"38aea304b4fa46e1b29bb72f5cea4c93","4a29443515bb404cb8924e1c60a63b73",7542749,1,-60,0,1437,331,285,-46
"3434c10e561d488a914e0f7d71907abd","3628bdce1dd2429ba924d2d4d09448d2",7542749,1,21,0,1439,305,322,17
"3628bdce1dd2429ba924d2d4d09448d2","47edbb64109243e6b0f8f64cdef90c6c",7542749,1,4,0,1440,322,326,4
"3628bdce1dd2429ba924d2d4d09448d2","0c4079457ede49e3aeb5e86ed84bdf35",7542749,1,10,0,1443,322,329,7
"0c4079457ede49e3aeb5e86ed84bdf35","3434c10e561d488a914e0f7d71907abd",7542749,1,-31,0,1444,329,305,-24
"3434c10e561d488a914e0f7d71907abd","38aea304b4fa46e1b29bb72f5cea4c93",7542749,1,33,0,1445,305,331,26
"38aea304b4fa46e1b29bb72f5cea4c93","0c4079457ede49e3aeb5e86ed84bdf35",7542749,1,-2,0,1446,331,329,-2
"38aea304b4fa46e1b29bb72f5cea4c93","38aea304b4fa46e1b29bb72f5cea4c93",7542749,12,0,1,1448,331,331,0
"38aea304b4fa46e1b29bb72f5cea4c93","e36d261332f14e79bb4b467aceaeb9b5",7542749,1,2,0,1460,331,333,2
"e36d261332f14e79bb4b467aceaeb9b5","e36d261332f14e79bb4b467aceaeb9b5",7542749,1,0,1,1461,333,333,0
"e36d261332f14e79bb4b467aceaeb9b5","c7e89b9d04744d2eab742fc24e3ef1ae",7542749,1,1,0,1462,333,334,1
"c7e89b9d04744d2eab742fc24e3ef1ae","c7e89b9d04744d2eab742fc24e3ef1ae",7542749,2,0,1,1463,334,334,0
"c7e89b9d04744d2eab742fc24e3ef1ae","fe49f8054b374a0ea4bb266ed135ff62",7542749,1,1,0,1465,334,335,1
"fe49f8054b374a0ea4bb266ed135ff62","fe49f8054b374a0ea4bb266ed135ff62",7542749,2,0,1,1466,335,335,0
"fe49f8054b374a0ea4bb266ed135ff62","d0a8f74af98642fe8360d22c42e45117",7542749,1,1,0,1468,335,336,1
"d0a8f74af98642fe8360d22c42e45117","d0a8f74af98642fe8360d22c42e45117",7542749,2,0,1,1469,336,336,0
"d0a8f74af98642fe8360d22c42e45117","0c4079457ede49e3aeb5e86ed84bdf35",7542749,1,-7,0,1471,336,329,-7
"0c4079457ede49e3aeb5e86ed84bdf35","a7c6339ca1da4368a18d471f0519f877",7542749,1,11,0,1472,329,339,10
"a7c6339ca1da4368a18d471f0519f877","a7c6339ca1da4368a18d471f0519f877",7542749,4,0,1,1473,339,339,0
"a7c6339ca1da4368a18d471f0519f877","b8b9418ab322418d9db9b40d96af873a",7542749,1,-2,0,1477,339,337,-2
"b8b9418ab322418d9db9b40d96af873a","bbc5139ca9024389a94db3a6f47dcff6",7542749,1,5,0,1478,337,341,4
"bbc5139ca9024389a94db3a6f47dcff6","bbc5139ca9024389a94db3a6f47dcff6",7542749,15,0,1,1479,341,341,0
"bbc5139ca9024389a94db3a6f47dcff6","4ee6ca9019ab4a1ab323f98094a9bd77",7542749,1,2,0,1494,341,343,2
"4ee6ca9019ab4a1ab323f98094a9bd77","4ee6ca9019ab4a1ab323f98094a9bd77",7542749,2,0,1,1495,343,343,0
"4ee6ca9019ab4a1ab323f98094a9bd77","b37947176785476f8b29d49a851366dc",7542749,1,1,0,1497,343,344,1
"b37947176785476f8b29d49a851366dc","b37947176785476f8b29d49a851366dc",7542749,2,0,1,1498,344,344,0
"b37947176785476f8b29d49a851366dc","fcea5b10d5a14a3b9324ffece8f6e1e5",7542749,1,1,0,1500,344,345,1
"fcea5b10d5a14a3b9324ffece8f6e1e5","fcea5b10d5a14a3b9324ffece8f6e1e5",7542749,2,0,1,1501,345,345,0
"fcea5b10d5a14a3b9324ffece8f6e1e5","c2490bc612d146edbe786556fab3651b",7542749,1,-5,0,1503,345,340,-5
"c2490bc612d146edbe786556fab3651b","6ac8bb048b854999a47edb35fe627f11",7542749,1,8,0,1504,340,347,7
"6ac8bb048b854999a47edb35fe627f11","6ac8bb048b854999a47edb35fe627f11",7542749,8,0,1,1505,347,347,0
"6ac8bb048b854999a47edb35fe627f11","0c4079457ede49e3aeb5e86ed84bdf35",7542749,1,-21,0,1513,347,329,-18
"0c4079457ede49e3aeb5e86ed84bdf35","30ead9794d4847abaf222ca966cc8630",7542749,1,24,0,1514,329,348,19
"30ead9794d4847abaf222ca966cc8630","c20993c944444fe085345591a8bd837e",7542749,1,3,0,1515,348,351,3
"c20993c944444fe085345591a8bd837e","eff0de7f2dbb42dfa1a2e686efab5b6d",7542749,1,3,0,1516,351,354,3
"eff0de7f2dbb42dfa1a2e686efab5b6d","897b7f51242c44aab2205c72fdcbf4cd",7542749,1,-2,0,1517,354,352,-2
"897b7f51242c44aab2205c72fdcbf4cd","09b9678ddc3d452ea4a3d46e15826065",7542749,2,1,0,1518,352,353,1
"09b9678ddc3d452ea4a3d46e15826065","c20993c944444fe085345591a8bd837e",7542749,1,-2,0,1519,353,351,-2
"c20993c944444fe085345591a8bd837e","c20993c944444fe085345591a8bd837e",7542749,3,0,1,1520,351,351,0
"c20993c944444fe085345591a8bd837e","897b7f51242c44aab2205c72fdcbf4cd",7542749,1,1,0,1523,351,352,1
"897b7f51242c44aab2205c72fdcbf4cd","897b7f51242c44aab2205c72fdcbf4cd",7542749,3,0,1,1524,352,352,0
"09b9678ddc3d452ea4a3d46e15826065","09b9678ddc3d452ea4a3d46e15826065",7542749,3,0,1,1528,353,353,0
"09b9678ddc3d452ea4a3d46e15826065","eff0de7f2dbb42dfa1a2e686efab5b6d",7542749,1,1,0,1531,353,354,1
"eff0de7f2dbb42dfa1a2e686efab5b6d","eff0de7f2dbb42dfa1a2e686efab5b6d",7542749,3,0,1,1532,354,354,0
"eff0de7f2dbb42dfa1a2e686efab5b6d","2fe14166dc9642c3bc666b86a57f943d",7542749,1,4,0,1535,354,357,3
"2fe14166dc9642c3bc666b86a57f943d","30ead9794d4847abaf222ca966cc8630",7542749,2,-10,0,1536,357,348,-9
"30ead9794d4847abaf222ca966cc8630","44421dd1e13a47a388c4a19834b744c7",7542749,1,12,0,1537,348,359,11
"44421dd1e13a47a388c4a19834b744c7","44421dd1e13a47a388c4a19834b744c7",7542749,2,0,1,1538,359,359,0
"44421dd1e13a47a388c4a19834b744c7","cb5fc7ef85d547c4be1a7439d0bf6052",7542749,1,1,0,1540,359,360,1
"cb5fc7ef85d547c4be1a7439d0bf6052","cb5fc7ef85d547c4be1a7439d0bf6052",7542749,2,0,1,1541,360,360,0
"cb5fc7ef85d547c4be1a7439d0bf6052","0a8f150a4cf747acbde62f4721823da3",7542749,1,1,0,1543,360,361,1
"0a8f150a4cf747acbde62f4721823da3","0a8f150a4cf747acbde62f4721823da3",7542749,2,0,1,1544,361,361,0
"0a8f150a4cf747acbde62f4721823da3","ab8fdad974ae471f9f24c3f9dd04462e",7542749,1,1,0,1546,361,362,1
"ab8fdad974ae471f9f24c3f9dd04462e","ab8fdad974ae471f9f24c3f9dd04462e",7542749,2,0,1,1547,362,362,0
"ab8fdad974ae471f9f24c3f9dd04462e","30ead9794d4847abaf222ca966cc8630",7542749,1,-15,0,1549,362,348,-14
"30ead9794d4847abaf222ca966cc8630","2fe14166dc9642c3bc666b86a57f943d",7542749,2,10,0,1550,348,357,9
"2fe14166dc9642c3bc666b86a57f943d","2fe14166dc9642c3bc666b86a57f943d",7542749,14,0,1,1553,357,357,0
"2fe14166dc9642c3bc666b86a57f943d","52580888dadb4fe3baa795683ea227bd",7542749,1,8,0,1567,357,364,7
"52580888dadb4fe3baa795683ea227bd","1ba8fef685d74a8194b9db252eb704fb",7542749,1,-10,0,1568,364,355,-9
"1ba8fef685d74a8194b9db252eb704fb","52580888dadb4fe3baa795683ea227bd",7542749,1,10,0,1569,355,364,9
"52580888dadb4fe3baa795683ea227bd","52580888dadb4fe3baa795683ea227bd",7542749,8,0,1,1570,364,364,0
"52580888dadb4fe3baa795683ea227bd","f00179e251a045b39c3f7a54f9aa4acc",7542749,1,-1,0,1578,364,363,-1
"f00179e251a045b39c3f7a54f9aa4acc","492a3bc6a1254f23a7998587961b22a4",7542749,1,4,0,1579,363,366,3
"492a3bc6a1254f23a7998587961b22a4","492a3bc6a1254f23a7998587961b22a4",7542749,3,0,1,1580,366,366,0
"492a3bc6a1254f23a7998587961b22a4","072a190fd302456290895f9f04d6940a",7542749,1,-1,0,1583,366,365,-1
"072a190fd302456290895f9f04d6940a","cfa457d1743848e4bb5e4beced6448ed",7542749,1,5,0,1584,365,369,4
"cfa457d1743848e4bb5e4beced6448ed","cfa457d1743848e4bb5e4beced6448ed",7542749,2,0,1,1585,369,369,0
"cfa457d1743848e4bb5e4beced6448ed","30ead9794d4847abaf222ca966cc8630",7542749,1,-25,0,1587,369,348,-21
"30ead9794d4847abaf222ca966cc8630","b71bac264efb4abd97015447bd490db6",7542749,2,28,0,1588,348,370,22
"b71bac264efb4abd97015447bd490db6","30ead9794d4847abaf222ca966cc8630",7542749,2,-28,0,1589,370,348,-22
"30ead9794d4847abaf222ca966cc8630","8d448d625b024c82a5eb240bbd7431d6",7542749,1,33,0,1592,348,374,26
"8d448d625b024c82a5eb240bbd7431d6","b71bac264efb4abd97015447bd490db6",7542749,6,-5,0,1593,374,370,-4
"b71bac264efb4abd97015447bd490db6","8d448d625b024c82a5eb240bbd7431d6",7542749,7,5,0,1594,370,374,4
"8d448d625b024c82a5eb240bbd7431d6","8d448d625b024c82a5eb240bbd7431d6",7542749,95,0,1,1595,374,374,0
"8d448d625b024c82a5eb240bbd7431d6","d6d02b6ef04e4f17805504500b8ce441",7542749,1,3,0,1646,374,375,1
"d6d02b6ef04e4f17805504500b8ce441","b71bac264efb4abd97015447bd490db6",7542749,2,-8,0,1647,375,370,-5
"b71bac264efb4abd97015447bd490db6","d6d02b6ef04e4f17805504500b8ce441",7542749,4,8,0,1648,370,375,5
"d6d02b6ef04e4f17805504500b8ce441","d6d02b6ef04e4f17805504500b8ce441",7542749,6,0,1,1649,375,375,0
"d6d02b6ef04e4f17805504500b8ce441","66baf19b6b904b70922329068c63746d",7542749,2,4,0,1650,375,376,1
"66baf19b6b904b70922329068c63746d","7f544639412e40a9ba27f43b415362ab",7542749,3,2,0,1651,376,378,2
"7f544639412e40a9ba27f43b415362ab","b71bac264efb4abd97015447bd490db6",7542749,1,-14,0,1652,378,370,-8
"7f544639412e40a9ba27f43b415362ab","7f544639412e40a9ba27f43b415362ab",7542749,7,0,1,1669,378,378,0
"7f544639412e40a9ba27f43b415362ab","d5ae8642e15b46b8bd298b02274d4e9c",7542749,1,2,0,1675,378,380,2
"d5ae8642e15b46b8bd298b02274d4e9c","d5ae8642e15b46b8bd298b02274d4e9c",7542749,1,0,1,1676,380,380,0
"d5ae8642e15b46b8bd298b02274d4e9c","a0d10309a2dd456289147f84be9d37f9",7542749,1,1,0,1677,380,381,1
"a0d10309a2dd456289147f84be9d37f9","a0d10309a2dd456289147f84be9d37f9",7542749,2,0,1,1678,381,381,0
"a0d10309a2dd456289147f84be9d37f9","0fcbc3ca07b144138b8d85da581f09a8",7542749,1,1,0,1680,381,382,1
"0fcbc3ca07b144138b8d85da581f09a8","0fcbc3ca07b144138b8d85da581f09a8",7542749,2,0,1,1681,382,382,0
"0fcbc3ca07b144138b8d85da581f09a8","66baf19b6b904b70922329068c63746d",7542749,1,-6,0,1683,382,376,-6
"66baf19b6b904b70922329068c63746d","66baf19b6b904b70922329068c63746d",7542749,6,0,1,1684,376,376,0
"7f544639412e40a9ba27f43b415362ab","66baf19b6b904b70922329068c63746d",7542749,1,-2,0,1689,378,376,-2
"66baf19b6b904b70922329068c63746d","c2fca3669923477ab966ded303dea31c",7542749,1,8,0,1690,376,383,7
"c2fca3669923477ab966ded303dea31c","4890121ce5d74576b4632b77cfc23398",7542749,2,6,0,1691,383,388,5
"4890121ce5d74576b4632b77cfc23398","c2fca3669923477ab966ded303dea31c",7542749,1,-6,0,1692,388,383,-5
"4890121ce5d74576b4632b77cfc23398","4890121ce5d74576b4632b77cfc23398",7542749,4,0,1,1694,388,388,0
"4890121ce5d74576b4632b77cfc23398","18d3b836dd804224883cc9180b60a8e1",7542749,1,-1,0,1698,388,387,-1
"18d3b836dd804224883cc9180b60a8e1","96bb2b3e85a34d8b9544514e89f6fe97",7542749,1,4,0,1699,387,390,3
"96bb2b3e85a34d8b9544514e89f6fe97","66baf19b6b904b70922329068c63746d",7542749,1,-17,0,1700,390,376,-14
"66baf19b6b904b70922329068c63746d","b2f0d654738f48158edff28e8d3a546e",7542749,2,112,0,1701,376,449,73
"b2f0d654738f48158edff28e8d3a546e","b2f0d654738f48158edff28e8d3a546e",7542749,6,0,1,1702,449,449,0
"b2f0d654738f48158edff28e8d3a546e","f60ee41ec635499abd48168342d32c2f",7542749,4,5,0,1703,449,453,4
"f60ee41ec635499abd48168342d32c2f","f60ee41ec635499abd48168342d32c2f",7542749,77,0,1,1704,453,453,0
"f60ee41ec635499abd48168342d32c2f","b2f0d654738f48158edff28e8d3a546e",7542749,1,-5,0,1711,453,449,-4
"b2f0d654738f48158edff28e8d3a546e","66baf19b6b904b70922329068c63746d",7542749,1,-112,0,1712,449,376,-73
"f60ee41ec635499abd48168342d32c2f","66baf19b6b904b70922329068c63746d",7542749,1,-117,0,1723,453,376,-77
"66baf19b6b904b70922329068c63746d","17f95d18bab743888e1736033dc3384d",7542749,1,16,0,1724,376,389,13
"17f95d18bab743888e1736033dc3384d","66baf19b6b904b70922329068c63746d",7542749,1,-16,0,1725,389,376,-13
"66baf19b6b904b70922329068c63746d","96bb2b3e85a34d8b9544514e89f6fe97",7542749,1,17,0,1726,376,390,14
"96bb2b3e85a34d8b9544514e89f6fe97","96bb2b3e85a34d8b9544514e89f6fe97",7542749,2,0,1,1727,390,390,0
"96bb2b3e85a34d8b9544514e89f6fe97","ac4e9b54acfe4670b4634859c7263cb5",7542749,1,2,0,1729,390,392,2
"ac4e9b54acfe4670b4634859c7263cb5","ac4e9b54acfe4670b4634859c7263cb5",7542749,1,0,1,1730,392,392,0
"ac4e9b54acfe4670b4634859c7263cb5","6f8881a745ac4c358a68b92c3b4abe81",7542749,1,3,0,1731,392,394,2
"6f8881a745ac4c358a68b92c3b4abe81","17f95d18bab743888e1736033dc3384d",7542749,1,-6,0,1732,394,389,-5
"17f95d18bab743888e1736033dc3384d","6f8881a745ac4c358a68b92c3b4abe81",7542749,1,6,0,1733,389,394,5
"6f8881a745ac4c358a68b92c3b4abe81","6f8881a745ac4c358a68b92c3b4abe81",7542749,9,0,1,1734,394,394,0
"6f8881a745ac4c358a68b92c3b4abe81","f7002c8484354eceac57bc7bd62c76c1",7542749,4,-1,0,1742,394,393,-1
"f7002c8484354eceac57bc7bd62c76c1","44a277ea44dc4ae689fab4b82f0b4098",7542749,1,5,0,1743,393,397,4
"44a277ea44dc4ae689fab4b82f0b4098","44a277ea44dc4ae689fab4b82f0b4098",7542749,1,0,1,1744,397,397,0
"44a277ea44dc4ae689fab4b82f0b4098","0c12af0a4e7f4002852cf84b2537c161",7542749,1,-2,0,1745,397,395,-2
"0c12af0a4e7f4002852cf84b2537c161","6f8881a745ac4c358a68b92c3b4abe81",7542749,2,-2,0,1746,395,394,-1
"6f8881a745ac4c358a68b92c3b4abe81","df8191ec5e584c838a899c378941a566",7542749,1,6,0,1747,394,398,4
"df8191ec5e584c838a899c378941a566","6f8881a745ac4c358a68b92c3b4abe81",7542749,2,-6,0,1748,398,394,-4
"f7002c8484354eceac57bc7bd62c76c1","0c12af0a4e7f4002852cf84b2537c161",7542749,2,3,0,1750,393,395,2
"0c12af0a4e7f4002852cf84b2537c161","df8191ec5e584c838a899c378941a566",7542749,1,4,0,1751,395,398,3
"f7002c8484354eceac57bc7bd62c76c1","6f8881a745ac4c358a68b92c3b4abe81",7542749,1,1,0,1754,393,394,1
"6f8881a745ac4c358a68b92c3b4abe81","0c12af0a4e7f4002852cf84b2537c161",7542749,1,2,0,1755,394,395,1
"0c12af0a4e7f4002852cf84b2537c161","859e0b8d71694b12befb69ee698138f9",7542749,1,5,0,1760,395,399,4
"859e0b8d71694b12befb69ee698138f9","859e0b8d71694b12befb69ee698138f9",7542749,1,0,1,1761,399,399,0
"859e0b8d71694b12befb69ee698138f9","66baf19b6b904b70922329068c63746d",7542749,1,-29,0,1762,399,376,-23
"66baf19b6b904b70922329068c63746d","2b09a08242b54983aec7063990fb3f66",7542749,3,32,0,1763,376,400,24
"2b09a08242b54983aec7063990fb3f66","2b09a08242b54983aec7063990fb3f66",7542749,6,0,1,1764,400,400,0
"2b09a08242b54983aec7063990fb3f66","1f471b7a883a4df48211e8c6a81b59a7",7542749,1,1,0,1765,400,401,1
"1f471b7a883a4df48211e8c6a81b59a7","1f471b7a883a4df48211e8c6a81b59a7",7542749,1,0,1,1766,401,401,0
"1f471b7a883a4df48211e8c6a81b59a7","2b09a08242b54983aec7063990fb3f66",7542749,1,-1,0,1767,401,400,-1
"2b09a08242b54983aec7063990fb3f66","66baf19b6b904b70922329068c63746d",7542749,1,-32,0,1773,400,376,-24
"2b09a08242b54983aec7063990fb3f66","9de0d567bfa84fe5b77cb76f4a76a5d1",7542749,1,5,0,1776,400,404,4
"9de0d567bfa84fe5b77cb76f4a76a5d1","9de0d567bfa84fe5b77cb76f4a76a5d1",7542749,4,0,1,1777,404,404,0
"9de0d567bfa84fe5b77cb76f4a76a5d1","1157bd665ec4472fb58b751dc5099355",7542749,1,-1,0,1781,404,403,-1
"1157bd665ec4472fb58b751dc5099355","58fc9094275e4c49be3f4ba6d4acc0a4",7542749,1,5,0,1782,403,406,3
"58fc9094275e4c49be3f4ba6d4acc0a4","3c8a22d2f9c146ea956609e3ed4f2559",7542749,1,-2,0,1783,406,405,-1
"3c8a22d2f9c146ea956609e3ed4f2559","58fc9094275e4c49be3f4ba6d4acc0a4",7542749,1,2,0,1784,405,406,1
"58fc9094275e4c49be3f4ba6d4acc0a4","58fc9094275e4c49be3f4ba6d4acc0a4",7542749,10,0,1,1785,406,406,0
"58fc9094275e4c49be3f4ba6d4acc0a4","c1c1be90b2b14c1ab4a5e1ee3c241902",7542749,1,1,0,1795,406,407,1
"c1c1be90b2b14c1ab4a5e1ee3c241902","c1c1be90b2b14c1ab4a5e1ee3c241902",7542749,5,0,1,1796,407,407,0
"c1c1be90b2b14c1ab4a5e1ee3c241902","58fc9094275e4c49be3f4ba6d4acc0a4",7542749,1,-1,0,1801,407,406,-1
"58fc9094275e4c49be3f4ba6d4acc0a4","02b3a1bead9244c1ba2f857c7da8f82a",7542749,1,3,0,1802,406,408,2
"02b3a1bead9244c1ba2f857c7da8f82a","6206fc6479014bb193084c32409dc1b9",7542749,1,1,0,1803,408,409,1
"6206fc6479014bb193084c32409dc1b9","6206fc6479014bb193084c32409dc1b9",7542749,1,0,1,1804,409,409,0
"6206fc6479014bb193084c32409dc1b9","02b3a1bead9244c1ba2f857c7da8f82a",7542749,1,-1,0,1805,409,408,-1
"02b3a1bead9244c1ba2f857c7da8f82a","02b3a1bead9244c1ba2f857c7da8f82a",7542749,6,0,1,1806,408,408,0
"02b3a1bead9244c1ba2f857c7da8f82a","6a5f020451db426dacba9e2ea3fcc62a",7542749,2,3,0,1811,408,410,2
"6a5f020451db426dacba9e2ea3fcc62a","66baf19b6b904b70922329068c63746d",7542749,1,-47,0,1812,410,376,-34
"2b09a08242b54983aec7063990fb3f66","02b3a1bead9244c1ba2f857c7da8f82a",7542749,1,12,0,1815,400,408,8
"6a5f020451db426dacba9e2ea3fcc62a","6a5f020451db426dacba9e2ea3fcc62a",7542749,5,0,1,1818,410,410,0
"6a5f020451db426dacba9e2ea3fcc62a","33a9d248b2e44588a5b07fc1342b9bc2",7542749,1,2,0,1823,410,411,1
"33a9d248b2e44588a5b07fc1342b9bc2","33a9d248b2e44588a5b07fc1342b9bc2",7542749,16,0,1,1824,411,411,0
"33a9d248b2e44588a5b07fc1342b9bc2","c6f26bd420634f1cb7989e76fe6b16c0",7542749,1,1,0,1840,411,412,1
"c6f26bd420634f1cb7989e76fe6b16c0","c6f26bd420634f1cb7989e76fe6b16c0",7542749,5,0,1,1841,412,412,0
"c6f26bd420634f1cb7989e76fe6b16c0","2a65ee6e2ac64f6a8a55fbe5373ec763",7542749,1,1,0,1846,412,413,1
"2a65ee6e2ac64f6a8a55fbe5373ec763","2a65ee6e2ac64f6a8a55fbe5373ec763",7542749,2,0,1,1847,413,413,0
"2a65ee6e2ac64f6a8a55fbe5373ec763","33a9d248b2e44588a5b07fc1342b9bc2",7542749,1,-2,0,1849,413,411,-2
"33a9d248b2e44588a5b07fc1342b9bc2","1fd0f6dadbc14ebc965faf6122190b96",7542749,1,5,0,1850,411,415,4
"1fd0f6dadbc14ebc965faf6122190b96","1fd0f6dadbc14ebc965faf6122190b96",7542749,2,0,1,1851,415,415,0
"1fd0f6dadbc14ebc965faf6122190b96","687055dad9fc40c3982478fe33ec01bf",7542749,1,-1,0,1853,415,414,-1
"687055dad9fc40c3982478fe33ec01bf","2add1669f08d4101913db15f8c23b3b7",7542749,1,3,0,1854,414,416,2
"2add1669f08d4101913db15f8c23b3b7","2add1669f08d4101913db15f8c23b3b7",7542749,2,0,1,1855,416,416,0
"2add1669f08d4101913db15f8c23b3b7","a2b4bd40cee2481ebd3fc179d6a5cd62",7542749,1,3,0,1857,416,417,1
"a2b4bd40cee2481ebd3fc179d6a5cd62","2b09a08242b54983aec7063990fb3f66",7542749,1,-27,0,1858,417,400,-17
"2b09a08242b54983aec7063990fb3f66","e34e59dce2204f228f3a84b6725df60f",7542749,1,29,0,1859,400,419,19
"e34e59dce2204f228f3a84b6725df60f","e34e59dce2204f228f3a84b6725df60f",7542749,2,0,1,1860,419,419,0
"e34e59dce2204f228f3a84b6725df60f","a2b4bd40cee2481ebd3fc179d6a5cd62",7542749,1,-2,0,1862,419,417,-2
"a2b4bd40cee2481ebd3fc179d6a5cd62","bec48fc2e1294c7eb3d0aca780d731b8",7542749,2,4,0,1863,417,420,3
"bec48fc2e1294c7eb3d0aca780d731b8","66baf19b6b904b70922329068c63746d",7542749,1,-63,0,1864,420,376,-44
"66baf19b6b904b70922329068c63746d","a2b4bd40cee2481ebd3fc179d6a5cd62",7542749,2,59,0,1865,376,417,41
"a2b4bd40cee2481ebd3fc179d6a5cd62","a2b4bd40cee2481ebd3fc179d6a5cd62",7542749,1,0,1,1866,417,417,0
"bec48fc2e1294c7eb3d0aca780d731b8","bec48fc2e1294c7eb3d0aca780d731b8",7542749,6,0,1,1868,420,420,0
"bec48fc2e1294c7eb3d0aca780d731b8","a24600b0e49245f6bdba8c893cfeddb0",7542749,1,7,0,1874,420,425,5
"a24600b0e49245f6bdba8c893cfeddb0","dbde19fcce2a4c1abdc7f685c293a23f",7542749,2,-4,0,1875,425,422,-3
"dbde19fcce2a4c1abdc7f685c293a23f","a24600b0e49245f6bdba8c893cfeddb0",7542749,2,4,0,1876,422,425,3
"a24600b0e49245f6bdba8c893cfeddb0","a24600b0e49245f6bdba8c893cfeddb0",7542749,16,0,1,1877,425,425,0
"a24600b0e49245f6bdba8c893cfeddb0","a2b4bd40cee2481ebd3fc179d6a5cd62",7542749,1,-11,0,1884,425,417,-8
"a2b4bd40cee2481ebd3fc179d6a5cd62","24cf8786024543f19b89bc20034e60d7",7542749,1,18,0,1885,417,428,11
"24cf8786024543f19b89bc20034e60d7","a2b4bd40cee2481ebd3fc179d6a5cd62",7542749,2,-18,0,1886,428,417,-11
"a2b4bd40cee2481ebd3fc179d6a5cd62","f2a73be2f46840b182d7bd095378004e",7542749,2,19,0,1887,417,429,12
"f2a73be2f46840b182d7bd095378004e","66baf19b6b904b70922329068c63746d",7542749,2,-78,0,1888,429,376,-53
"a2b4bd40cee2481ebd3fc179d6a5cd62","a24600b0e49245f6bdba8c893cfeddb0",7542749,1,11,0,1890,417,425,8
"a24600b0e49245f6bdba8c893cfeddb0","5d290f75e44b4bdb8256c600debbb44d",7542749,2,2,0,1896,425,426,1
"5d290f75e44b4bdb8256c600debbb44d","a24600b0e49245f6bdba8c893cfeddb0",7542749,2,-2,0,1897,426,425,-1
"a24600b0e49245f6bdba8c893cfeddb0","24cf8786024543f19b89bc20034e60d7",7542749,1,7,0,1906,425,428,3
"66baf19b6b904b70922329068c63746d","24cf8786024543f19b89bc20034e60d7",7542749,1,77,0,1910,376,428,52
"24cf8786024543f19b89bc20034e60d7","f2a73be2f46840b182d7bd095378004e",7542749,1,1,0,1911,428,429,1
"f2a73be2f46840b182d7bd095378004e","f2a73be2f46840b182d7bd095378004e",7542749,5,0,1,1912,429,429,0
"f2a73be2f46840b182d7bd095378004e","604551fd4266430cb860fef58fa7dd61",7542749,1,1,0,1917,429,430,1
"604551fd4266430cb860fef58fa7dd61","604551fd4266430cb860fef58fa7dd61",7542749,1,0,1,1918,430,430,0
"604551fd4266430cb860fef58fa7dd61","24cf8786024543f19b89bc20034e60d7",7542749,1,-2,0,1919,430,428,-2
"24cf8786024543f19b89bc20034e60d7","dce46f8904594a62a6377a3587aaa663",7542749,1,4,0,1920,428,431,3
"dce46f8904594a62a6377a3587aaa663","dce46f8904594a62a6377a3587aaa663",7542749,20,0,1,1921,431,431,0
"dce46f8904594a62a6377a3587aaa663","9b9d0a249052413c869753b99682b0ac",7542749,1,1,0,1935,431,432,1
"9b9d0a249052413c869753b99682b0ac","9b9d0a249052413c869753b99682b0ac",7542749,1,0,1,1936,432,432,0
"9b9d0a249052413c869753b99682b0ac","061c175cc90f45fbad883025394e78dd",7542749,1,1,0,1937,432,433,1
"061c175cc90f45fbad883025394e78dd","061c175cc90f45fbad883025394e78dd",7542749,4,0,1,1938,433,433,0
"061c175cc90f45fbad883025394e78dd","dce46f8904594a62a6377a3587aaa663",7542749,1,-2,0,1942,433,431,-2
"dce46f8904594a62a6377a3587aaa663","66ada10dde9f43018588f1ced9d477fc",7542749,2,4,0,1944,431,434,3
"66ada10dde9f43018588f1ced9d477fc","dce46f8904594a62a6377a3587aaa663",7542749,2,-4,0,1945,434,431,-3
"dce46f8904594a62a6377a3587aaa663","74a7f8712e5449c2bc0b43c6f90dafed",7542749,1,5,0,1953,431,435,4
"74a7f8712e5449c2bc0b43c6f90dafed","74a7f8712e5449c2bc0b43c6f90dafed",7542749,1,0,1,1954,435,435,0
"74a7f8712e5449c2bc0b43c6f90dafed","66ada10dde9f43018588f1ced9d477fc",7542749,1,-1,0,1955,435,434,-1
"66ada10dde9f43018588f1ced9d477fc","bf12c96466d840a69bed7020b3f18bb8",7542749,1,3,0,1956,434,436,2
"bf12c96466d840a69bed7020b3f18bb8","bf12c96466d840a69bed7020b3f18bb8",7542749,4,0,1,1957,436,436,0
"bf12c96466d840a69bed7020b3f18bb8","24cf8786024543f19b89bc20034e60d7",7542749,1,-11,0,1961,436,428,-8
"24cf8786024543f19b89bc20034e60d7","070600601c4c439288445d2f0724807d",7542749,1,14,0,1962,428,437,9
"070600601c4c439288445d2f0724807d","1823b6de7d334a7aaabc4570719af4d9",7542749,2,2,0,1963,437,439,2
"1823b6de7d334a7aaabc4570719af4d9","66baf19b6b904b70922329068c63746d",7542749,1,-93,0,1964,439,376,-63
"66baf19b6b904b70922329068c63746d","070600601c4c439288445d2f0724807d",7542749,1,91,0,1965,376,437,61
"070600601c4c439288445d2f0724807d","070600601c4c439288445d2f0724807d",7542749,1,0,1,1966,437,437,0
"1823b6de7d334a7aaabc4570719af4d9","1823b6de7d334a7aaabc4570719af4d9",7542749,14,0,1,1968,439,439,0
"1823b6de7d334a7aaabc4570719af4d9","0380cd76a7d44bc3a4da1f15e4d68f89",7542749,1,2,0,1982,439,440,1
"0380cd76a7d44bc3a4da1f15e4d68f89","070600601c4c439288445d2f0724807d",7542749,1,-4,0,1983,440,437,-3
"070600601c4c439288445d2f0724807d","0380cd76a7d44bc3a4da1f15e4d68f89",7542749,1,4,0,1984,437,440,3
"0380cd76a7d44bc3a4da1f15e4d68f89","0380cd76a7d44bc3a4da1f15e4d68f89",7542749,5,0,1,1985,440,440,0
"0380cd76a7d44bc3a4da1f15e4d68f89","23b7673c8b5443108c2ef09382834a86",7542749,2,2,0,1990,440,441,1
"23b7673c8b5443108c2ef09382834a86","0380cd76a7d44bc3a4da1f15e4d68f89",7542749,1,-2,0,1991,441,440,-1
"23b7673c8b5443108c2ef09382834a86","901e92500aea43c79f19f1b279050668",7542749,2,2,0,1993,441,442,1
"901e92500aea43c79f19f1b279050668","23b7673c8b5443108c2ef09382834a86",7542749,1,-2,0,1994,442,441,-1
"901e92500aea43c79f19f1b279050668","901e92500aea43c79f19f1b279050668",7542749,2,0,1,1996,442,442,0
"901e92500aea43c79f19f1b279050668","001339db8ced4cf78829ebe8b145449d",7542749,1,1,0,1998,442,443,1
"001339db8ced4cf78829ebe8b145449d","001339db8ced4cf78829ebe8b145449d",7542749,2,0,1,1999,443,443,0
"001339db8ced4cf78829ebe8b145449d","452745e0366e42ae81561bfddebcc6c3",7542749,1,1,0,2001,443,444,1
"452745e0366e42ae81561bfddebcc6c3","452745e0366e42ae81561bfddebcc6c3",7542749,2,0,1,2002,444,444,0
"452745e0366e42ae81561bfddebcc6c3","4660ff2089114e8db82ceb26a4f329e3",7542749,1,2,0,2004,444,445,1
"4660ff2089114e8db82ceb26a4f329e3","901e92500aea43c79f19f1b279050668",7542749,1,-4,0,2005,445,442,-3
"901e92500aea43c79f19f1b279050668","070600601c4c439288445d2f0724807d",7542749,1,-8,0,2006,442,437,-5
"070600601c4c439288445d2f0724807d","4660ff2089114e8db82ceb26a4f329e3",7542749,1,12,0,2007,437,445,8
"4660ff2089114e8db82ceb26a4f329e3","4660ff2089114e8db82ceb26a4f329e3",7542749,2,0,1,2008,445,445,0
"4660ff2089114e8db82ceb26a4f329e3","7bd5586eb9d8484eb74a433ee7bfe499",7542749,1,2,0,2010,445,446,1
"7bd5586eb9d8484eb74a433ee7bfe499","7bd5586eb9d8484eb74a433ee7bfe499",7542749,9,0,1,2011,446,446,0
"7bd5586eb9d8484eb74a433ee7bfe499","8a7f26e690f34dda97be16904518ca99",7542749,1,2,0,2020,446,447,1
"8a7f26e690f34dda97be16904518ca99","8a7f26e690f34dda97be16904518ca99",7542749,4,0,1,2021,447,447,0
"8a7f26e690f34dda97be16904518ca99","070600601c4c439288445d2f0724807d",7542749,1,-16,0,2025,447,437,-10
"070600601c4c439288445d2f0724807d","b2f0d654738f48158edff28e8d3a546e",7542749,1,21,0,2026,437,449,12
"b2f0d654738f48158edff28e8d3a546e","070600601c4c439288445d2f0724807d",7542749,1,-21,0,2027,449,437,-12
"070600601c4c439288445d2f0724807d","c5df9f40ec14463b9dcfdc73df3e9285",7542749,1,41,0,2028,437,464,27
"c5df9f40ec14463b9dcfdc73df3e9285","c5df9f40ec14463b9dcfdc73df3e9285",7542749,4,0,1,2029,464,464,0
"c5df9f40ec14463b9dcfdc73df3e9285","83d42d95cd844fc093fc09cee250edb8",7542749,2,3,0,2031,464,465,1
"83d42d95cd844fc093fc09cee250edb8","83d42d95cd844fc093fc09cee250edb8",7542749,9,0,1,2032,465,465,0
"83d42d95cd844fc093fc09cee250edb8","f67fbf45a5f146ed866965bc57c7c001",7542749,1,-15,0,2039,465,454,-11
"f67fbf45a5f146ed866965bc57c7c001","f67fbf45a5f146ed866965bc57c7c001",7542749,3,0,1,2040,454,454,0
"f67fbf45a5f146ed866965bc57c7c001","d937afe49bd24a07a550dda1c1155122",7542749,1,1,0,2043,454,455,1
"d937afe49bd24a07a550dda1c1155122","d937afe49bd24a07a550dda1c1155122",7542749,1,0,1,2044,455,455,0
"d937afe49bd24a07a550dda1c1155122","3628b3f7823443d0912a339096b69943",7542749,1,1,0,2045,455,456,1
"3628b3f7823443d0912a339096b69943","3628b3f7823443d0912a339096b69943",7542749,1,0,1,2046,456,456,0
"3628b3f7823443d0912a339096b69943","9e049ee647cf43ecbcb5ed792a8e7588",7542749,1,1,0,2047,456,457,1
"9e049ee647cf43ecbcb5ed792a8e7588","9e049ee647cf43ecbcb5ed792a8e7588",7542749,1,0,1,2048,457,457,0
"9e049ee647cf43ecbcb5ed792a8e7588","5256a214faaf410b93f76cea06428334",7542749,1,1,0,2049,457,458,1
"5256a214faaf410b93f76cea06428334","5256a214faaf410b93f76cea06428334",7542749,1,0,1,2050,458,458,0
"5256a214faaf410b93f76cea06428334","25c32b120fce40fa9b6c85133aeb4716",7542749,1,1,0,2051,458,459,1
"25c32b120fce40fa9b6c85133aeb4716","25c32b120fce40fa9b6c85133aeb4716",7542749,2,0,1,2052,459,459,0
"25c32b120fce40fa9b6c85133aeb4716","11bc14f2204949008b7d511b933363c1",7542749,1,1,0,2054,459,460,1
"11bc14f2204949008b7d511b933363c1","11bc14f2204949008b7d511b933363c1",7542749,1,0,1,2055,460,460,0
"11bc14f2204949008b7d511b933363c1","42de338840a34d15adb66e7b14fb9d2c",7542749,1,1,0,2056,460,461,1
"42de338840a34d15adb66e7b14fb9d2c","42de338840a34d15adb66e7b14fb9d2c",7542749,1,0,1,2057,461,461,0
"42de338840a34d15adb66e7b14fb9d2c","9da37c6210b1416b8079c274f70bf600",7542749,1,1,0,2058,461,462,1
"9da37c6210b1416b8079c274f70bf600","9da37c6210b1416b8079c274f70bf600",7542749,1,0,1,2059,462,462,0
"9da37c6210b1416b8079c274f70bf600","519119f1deac45ff9ab4f13529be5c6e",7542749,1,1,0,2060,462,463,1
"519119f1deac45ff9ab4f13529be5c6e","519119f1deac45ff9ab4f13529be5c6e",7542749,1,0,1,2061,463,463,0
"519119f1deac45ff9ab4f13529be5c6e","f67fbf45a5f146ed866965bc57c7c001",7542749,1,-9,0,2062,463,454,-9
"f67fbf45a5f146ed866965bc57c7c001","c5df9f40ec14463b9dcfdc73df3e9285",7542749,1,12,0,2063,454,464,10
"83d42d95cd844fc093fc09cee250edb8","1b4550d0dab04078b3bf08a655345bdc",7542749,1,-143,0,2069,465,373,-92
"1b4550d0dab04078b3bf08a655345bdc","b71bac264efb4abd97015447bd490db6",7542749,1,-4,0,2070,373,370,-3
"d6d02b6ef04e4f17805504500b8ce441","4a29443515bb404cb8924e1c60a63b73",7542749,1,-118,0,2095,375,285,-90
"4a29443515bb404cb8924e1c60a63b73","b71bac264efb4abd97015447bd490db6",7542749,1,110,0,2096,285,370,85
"8d448d625b024c82a5eb240bbd7431d6","b2f0d654738f48158edff28e8d3a546e",7542749,1,119,0,2123,374,449,75
"f60ee41ec635499abd48168342d32c2f","f67fbf45a5f146ed866965bc57c7c001",7542749,1,3,0,2183,453,454,1
"f67fbf45a5f146ed866965bc57c7c001","b2f0d654738f48158edff28e8d3a546e",7542749,1,-8,0,2184,454,449,-5
"b613861cecf84ffcab01afb23f660475","b613861cecf84ffcab01afb23f660475",20260339,2,0,1,1,1,1,0
"b613861cecf84ffcab01afb23f660475","e2911e79efc2420eac45d9f671463d4b",20260339,2,3,0,3,1,2,1
"e2911e79efc2420eac45d9f671463d4b","b613861cecf84ffcab01afb23f660475",20260339,1,-3,0,4,2,1,-1
"e2911e79efc2420eac45d9f671463d4b","e2911e79efc2420eac45d9f671463d4b",20260339,1,0,1,6,2,2,0
"e2911e79efc2420eac45d9f671463d4b","519d1b8c59404d67b54e96c5c8a830b2",20260339,1,1,0,7,2,3,1
"519d1b8c59404d67b54e96c5c8a830b2","519d1b8c59404d67b54e96c5c8a830b2",20260339,1,0,1,8,3,3,0
"519d1b8c59404d67b54e96c5c8a830b2","531db53f81f646edb0cdcfe0085b03b7",20260339,1,1,0,9,3,4,1
"531db53f81f646edb0cdcfe0085b03b7","531db53f81f646edb0cdcfe0085b03b7",20260339,1,0,1,10,4,4,0
"531db53f81f646edb0cdcfe0085b03b7","4f5f94b2f95141e0a9d53a61da2276da",20260339,1,1,0,11,4,5,1
"4f5f94b2f95141e0a9d53a61da2276da","4f5f94b2f95141e0a9d53a61da2276da",20260339,1,0,1,12,5,5,0
"4f5f94b2f95141e0a9d53a61da2276da","6d541c89590949f99af293c4f2333f67",20260339,1,1,0,13,5,6,1
"6d541c89590949f99af293c4f2333f67","6d541c89590949f99af293c4f2333f67",20260339,1,0,1,14,6,6,0
"6d541c89590949f99af293c4f2333f67","dd5cf0b9fe4c4f1d8f5ff8e4c04879cb",20260339,1,1,0,15,6,7,1
"dd5cf0b9fe4c4f1d8f5ff8e4c04879cb","dd5cf0b9fe4c4f1d8f5ff8e4c04879cb",20260339,1,0,1,16,7,7,0
"dd5cf0b9fe4c4f1d8f5ff8e4c04879cb","f96261861edc426abe2248be4f0a709a",20260339,1,1,0,17,7,8,1
"f96261861edc426abe2248be4f0a709a","f96261861edc426abe2248be4f0a709a",20260339,1,0,1,18,8,8,0
"f96261861edc426abe2248be4f0a709a","66b5e16f4f75454fb5b8172079f0fa83",20260339,1,1,0,19,8,9,1
"66b5e16f4f75454fb5b8172079f0fa83","66b5e16f4f75454fb5b8172079f0fa83",20260339,1,0,1,20,9,9,0
"66b5e16f4f75454fb5b8172079f0fa83","0680571d4698477995e41842c36a54b2",20260339,1,1,0,21,9,10,1
"0680571d4698477995e41842c36a54b2","0680571d4698477995e41842c36a54b2",20260339,1,0,1,22,10,10,0
"0680571d4698477995e41842c36a54b2","9112f2bffece48e08c6d2287be204085",20260339,1,1,0,23,10,11,1
"9112f2bffece48e08c6d2287be204085","9112f2bffece48e08c6d2287be204085",20260339,2,0,1,24,11,11,0
"9112f2bffece48e08c6d2287be204085","56586aa865414f538729c7f7735d2bc6",20260339,1,3,0,25,11,12,1
"56586aa865414f538729c7f7735d2bc6","e2911e79efc2420eac45d9f671463d4b",20260339,4,-12,0,26,12,2,-10
"e2911e79efc2420eac45d9f671463d4b","56586aa865414f538729c7f7735d2bc6",20260339,4,12,0,27,2,12,10
"e2911e79efc2420eac45d9f671463d4b","9112f2bffece48e08c6d2287be204085",20260339,2,9,0,29,2,11,9
"9112f2bffece48e08c6d2287be204085","e2911e79efc2420eac45d9f671463d4b",20260339,2,-9,0,30,11,2,-9
"9112f2bffece48e08c6d2287be204085","0680571d4698477995e41842c36a54b2",20260339,1,-1,0,32,11,10,-1
"0680571d4698477995e41842c36a54b2","66b5e16f4f75454fb5b8172079f0fa83",20260339,1,-1,0,33,10,9,-1
"66b5e16f4f75454fb5b8172079f0fa83","56586aa865414f538729c7f7735d2bc6",20260339,1,5,0,34,9,12,3
"56586aa865414f538729c7f7735d2bc6","56586aa865414f538729c7f7735d2bc6",20260339,7,0,1,37,12,12,0
"56586aa865414f538729c7f7735d2bc6","9112f2bffece48e08c6d2287be204085",20260339,1,-3,0,42,12,11,-1
"56586aa865414f538729c7f7735d2bc6","b7f2b31585d94eb3bf86376714aa7070",20260339,1,2,0,50,12,13,1
"b7f2b31585d94eb3bf86376714aa7070","b7f2b31585d94eb3bf86376714aa7070",20260339,4,0,1,51,13,13,0
"b7f2b31585d94eb3bf86376714aa7070","3f1c815879794b929260d224becaff7e",20260339,1,2,0,55,13,14,1
"3f1c815879794b929260d224becaff7e","56586aa865414f538729c7f7735d2bc6",20260339,1,-4,0,56,14,12,-2
"56586aa865414f538729c7f7735d2bc6","eb2a0eb537344a9e891c761662e400b6",20260339,1,8,0,57,12,16,4
"eb2a0eb537344a9e891c761662e400b6","56586aa865414f538729c7f7735d2bc6",20260339,1,-8,0,58,16,12,-4
"56586aa865414f538729c7f7735d2bc6","5c5ceeee4562457ba6d41515aeebfbb1",20260339,1,10,0,59,12,17,5
"5c5ceeee4562457ba6d41515aeebfbb1","eb2a0eb537344a9e891c761662e400b6",20260339,1,-2,0,60,17,16,-1
"eb2a0eb537344a9e891c761662e400b6","81c864a886d54a6b8ff85f7d736f4f95",20260339,1,-2,0,61,16,15,-1
"81c864a886d54a6b8ff85f7d736f4f95","3f1c815879794b929260d224becaff7e",20260339,1,-2,0,62,15,14,-1
"3f1c815879794b929260d224becaff7e","5c5ceeee4562457ba6d41515aeebfbb1",20260339,1,6,0,63,14,17,3
"5c5ceeee4562457ba6d41515aeebfbb1","81c864a886d54a6b8ff85f7d736f4f95",20260339,1,-4,0,64,17,15,-2
"81c864a886d54a6b8ff85f7d736f4f95","5c5ceeee4562457ba6d41515aeebfbb1",20260339,1,4,0,65,15,17,2
"5c5ceeee4562457ba6d41515aeebfbb1","56586aa865414f538729c7f7735d2bc6",20260339,1,-10,0,66,17,12,-5
"56586aa865414f538729c7f7735d2bc6","9afd71a5298d4333b6849dfce1b9422c",20260339,1,13,0,67,12,18,6
"9afd71a5298d4333b6849dfce1b9422c","9afd71a5298d4333b6849dfce1b9422c",20260339,1,0,1,68,18,18,0
"9afd71a5298d4333b6849dfce1b9422c","b7719e26494940efa49512aedd0aac79",20260339,1,4,0,69,18,20,2
"b7719e26494940efa49512aedd0aac79","d4f45188d3c84a02ba08454e6403a818",20260339,1,5,0,70,20,24,4
"d4f45188d3c84a02ba08454e6403a818","d4c3b003e8274e429d2fa688d73fde6d",20260339,2,-2,0,71,24,22,-2
"d4c3b003e8274e429d2fa688d73fde6d","d4c3b003e8274e429d2fa688d73fde6d",20260339,1,0,1,72,22,22,0
"d4c3b003e8274e429d2fa688d73fde6d","b7719e26494940efa49512aedd0aac79",20260339,1,-3,0,73,22,20,-2
"b7719e26494940efa49512aedd0aac79","afbf7250b99d47bea07172749483ca97",20260339,2,12,0,74,20,28,8
"afbf7250b99d47bea07172749483ca97","b7719e26494940efa49512aedd0aac79",20260339,1,-12,0,75,28,20,-8
"afbf7250b99d47bea07172749483ca97","4e51676dc72045d99c19b9fa7b22f8bc",20260339,1,3,0,77,28,29,1
"4e51676dc72045d99c19b9fa7b22f8bc","4e51676dc72045d99c19b9fa7b22f8bc",20260339,1,0,1,78,29,29,0
"4e51676dc72045d99c19b9fa7b22f8bc","51970cfa30e643e894e66ae85c8024cc",20260339,1,3,0,79,29,31,2
"51970cfa30e643e894e66ae85c8024cc","c33c17be71ae4d588da7369472e5bb1b",20260339,1,6,0,80,31,34,3
"c33c17be71ae4d588da7369472e5bb1b","4e51676dc72045d99c19b9fa7b22f8bc",20260339,1,-9,0,81,34,29,-5
"4e51676dc72045d99c19b9fa7b22f8bc","93679be414554a11b1893002f2229a93",20260339,1,12,0,82,29,35,6
"93679be414554a11b1893002f2229a93","c33c17be71ae4d588da7369472e5bb1b",20260339,1,-3,0,83,35,34,-1
"c33c17be71ae4d588da7369472e5bb1b","93679be414554a11b1893002f2229a93",20260339,1,3,0,84,34,35,1
"93679be414554a11b1893002f2229a93","7040a13096d746ac84b8fac8d9752058",20260339,1,3,0,85,35,36,1
"7040a13096d746ac84b8fac8d9752058","7040a13096d746ac84b8fac8d9752058",20260339,1,0,1,86,36,36,0
"7040a13096d746ac84b8fac8d9752058","9a0dc646f934470daf08c4b56ccf73db",20260339,1,3,0,87,36,37,1
"9a0dc646f934470daf08c4b56ccf73db","9a0dc646f934470daf08c4b56ccf73db",20260339,1,0,1,88,37,37,0
"9a0dc646f934470daf08c4b56ccf73db","fc0e049d56024bc9a02c9a9c435c3df7",20260339,1,3,0,89,37,38,1
"fc0e049d56024bc9a02c9a9c435c3df7","a49d1bb4328949299686242fd0be5584",20260339,1,-34,0,90,38,21,-17
"a49d1bb4328949299686242fd0be5584","b7719e26494940efa49512aedd0aac79",20260339,1,-2,0,91,21,20,-1
"b7719e26494940efa49512aedd0aac79","a49d1bb4328949299686242fd0be5584",20260339,1,2,0,92,20,21,1
"a49d1bb4328949299686242fd0be5584","d4f45188d3c84a02ba08454e6403a818",20260339,1,3,0,93,21,24,3
"d4c3b003e8274e429d2fa688d73fde6d","67a089198fcb4e1c8f2385786c2b296f",20260339,1,37,0,95,22,39,17
"67a089198fcb4e1c8f2385786c2b296f","67a089198fcb4e1c8f2385786c2b296f",20260339,1,0,1,96,39,39,0
"67a089198fcb4e1c8f2385786c2b296f","64d48c6c9c7940639a932219a6c87198",20260339,1,1,0,97,39,40,1
"64d48c6c9c7940639a932219a6c87198","64d48c6c9c7940639a932219a6c87198",20260339,1,0,1,98,40,40,0
"64d48c6c9c7940639a932219a6c87198","b534b89233134e30a9b5645138bfa9ee",20260339,1,3,0,99,40,41,1
"b534b89233134e30a9b5645138bfa9ee","67a089198fcb4e1c8f2385786c2b296f",20260339,2,-4,0,100,41,39,-2
"67a089198fcb4e1c8f2385786c2b296f","0e37b720d23b4e7f8b313e79313fd107",20260339,1,7,0,101,39,44,5
"0e37b720d23b4e7f8b313e79313fd107","0e37b720d23b4e7f8b313e79313fd107",20260339,1,0,1,102,44,44,0
"0e37b720d23b4e7f8b313e79313fd107","6875d67fdd5f48168b62719df449bebd",20260339,1,1,0,103,44,45,1
"6875d67fdd5f48168b62719df449bebd","6875d67fdd5f48168b62719df449bebd",20260339,1,0,1,104,45,45,0
"6875d67fdd5f48168b62719df449bebd","b534b89233134e30a9b5645138bfa9ee",20260339,1,-4,0,105,45,41,-4
"b534b89233134e30a9b5645138bfa9ee","6e13d61a7bdb44bca949c9f86fab3be5",20260339,2,7,0,106,41,47,6
"6e13d61a7bdb44bca949c9f86fab3be5","6e13d61a7bdb44bca949c9f86fab3be5",20260339,4,0,1,107,47,47,0
"6e13d61a7bdb44bca949c9f86fab3be5","b534b89233134e30a9b5645138bfa9ee",20260339,1,-7,0,108,47,41,-6
"67a089198fcb4e1c8f2385786c2b296f","b534b89233134e30a9b5645138bfa9ee",20260339,1,4,0,110,39,41,2
"b534b89233134e30a9b5645138bfa9ee","b534b89233134e30a9b5645138bfa9ee",20260339,1,0,1,111,41,41,0
"6e13d61a7bdb44bca949c9f86fab3be5","195f78799f984cc2b06c48dfe36be751",20260339,1,2,0,116,47,49,2
"195f78799f984cc2b06c48dfe36be751","195f78799f984cc2b06c48dfe36be751",20260339,2,0,1,117,49,49,0
"195f78799f984cc2b06c48dfe36be751","d9c8d8c444a64dadbbb508652c721e17",20260339,1,-3,0,119,49,46,-3
"d9c8d8c444a64dadbbb508652c721e17","d0c74f735e024943943e40333d6d337f",20260339,1,6,0,120,46,51,5
"d0c74f735e024943943e40333d6d337f","d0c74f735e024943943e40333d6d337f",20260339,1,0,1,121,51,51,0
"d0c74f735e024943943e40333d6d337f","983f8ff320594b279a7f4a6fe132f9c5",20260339,1,2,0,122,51,53,2
"983f8ff320594b279a7f4a6fe132f9c5","983f8ff320594b279a7f4a6fe132f9c5",20260339,5,0,1,123,53,53,0
"983f8ff320594b279a7f4a6fe132f9c5","35adfa5d923046aebabfefd98f35ff05",20260339,1,1,0,128,53,54,1
"35adfa5d923046aebabfefd98f35ff05","35adfa5d923046aebabfefd98f35ff05",20260339,5,0,1,129,54,54,0
"35adfa5d923046aebabfefd98f35ff05","b6f8a98476224da1b40e555ececc7ed8",20260339,1,1,0,134,54,55,1
"b6f8a98476224da1b40e555ececc7ed8","b6f8a98476224da1b40e555ececc7ed8",20260339,2,0,1,135,55,55,0
"b6f8a98476224da1b40e555ececc7ed8","86e22cb5fe0e4b47a9489ecddf7ed78f",20260339,1,1,0,137,55,56,1
"86e22cb5fe0e4b47a9489ecddf7ed78f","86e22cb5fe0e4b47a9489ecddf7ed78f",20260339,2,0,1,138,56,56,0
"86e22cb5fe0e4b47a9489ecddf7ed78f","f924752d8a1149668870b1e7698486f7",20260339,1,-6,0,140,56,50,-6
"f924752d8a1149668870b1e7698486f7","a1f2f12debe5432fb7a70bcd12bacfb9",20260339,1,9,0,141,50,58,8
"a1f2f12debe5432fb7a70bcd12bacfb9","78f30e4dcac84e3cbea8b2cc6e0d62b3",20260339,2,1,0,142,58,59,1
"78f30e4dcac84e3cbea8b2cc6e0d62b3","a1f2f12debe5432fb7a70bcd12bacfb9",20260339,1,-1,0,143,59,58,-1
"a1f2f12debe5432fb7a70bcd12bacfb9","a1f2f12debe5432fb7a70bcd12bacfb9",20260339,12,0,1,144,58,58,0
"78f30e4dcac84e3cbea8b2cc6e0d62b3","78f30e4dcac84e3cbea8b2cc6e0d62b3",20260339,7,0,1,157,59,59,0
"78f30e4dcac84e3cbea8b2cc6e0d62b3","12aa6e1672ac4e7aa6449a7a8609cd72",20260339,1,-2,0,164,59,57,-2
"12aa6e1672ac4e7aa6449a7a8609cd72","bc42d26810654ea9a1df1efe1e58c7d5",20260339,1,7,0,165,57,63,6
"bc42d26810654ea9a1df1efe1e58c7d5","a0a418b8540d479fa6e0f653b701da8b",20260339,1,1,0,166,63,64,1
"a0a418b8540d479fa6e0f653b701da8b","bc42d26810654ea9a1df1efe1e58c7d5",20260339,1,-1,0,167,64,63,-1
"bc42d26810654ea9a1df1efe1e58c7d5","bc42d26810654ea9a1df1efe1e58c7d5",20260339,3,0,1,168,63,63,0
"bc42d26810654ea9a1df1efe1e58c7d5","4c943503763e4e349906eea3ed3c8e86",20260339,1,-2,0,171,63,61,-2
"4c943503763e4e349906eea3ed3c8e86","4c943503763e4e349906eea3ed3c8e86",20260339,1,0,1,172,61,61,0
"4c943503763e4e349906eea3ed3c8e86","a0a418b8540d479fa6e0f653b701da8b",20260339,1,3,0,173,61,64,3
"a0a418b8540d479fa6e0f653b701da8b","a0a418b8540d479fa6e0f653b701da8b",20260339,3,0,1,174,64,64,0
"a0a418b8540d479fa6e0f653b701da8b","309ccf3cc4fe429d9bfbaef53d3fa479",20260339,1,-4,0,177,64,60,-4
"309ccf3cc4fe429d9bfbaef53d3fa479","b534b89233134e30a9b5645138bfa9ee",20260339,1,-23,0,178,60,41,-19
"b534b89233134e30a9b5645138bfa9ee","d646286c8051419bbc2e31dd1db55ca8",20260339,1,33,0,179,41,67,26
"d646286c8051419bbc2e31dd1db55ca8","267f883678b24aed855fde42524975d9",20260339,1,4,0,180,67,71,4
"267f883678b24aed855fde42524975d9","267f883678b24aed855fde42524975d9",20260339,1,0,1,181,71,71,0
"267f883678b24aed855fde42524975d9","88fff56d0342490dbef9040750a20f6c",20260339,1,1,0,182,71,72,1
"88fff56d0342490dbef9040750a20f6c","88fff56d0342490dbef9040750a20f6c",20260339,1,0,1,183,72,72,0
"88fff56d0342490dbef9040750a20f6c","adb17b12b66c4a49a85fd34322f7df70",20260339,1,1,0,184,72,73,1
"adb17b12b66c4a49a85fd34322f7df70","adb17b12b66c4a49a85fd34322f7df70",20260339,1,0,1,185,73,73,0
"adb17b12b66c4a49a85fd34322f7df70","d646286c8051419bbc2e31dd1db55ca8",20260339,1,-6,0,186,73,67,-6
"d646286c8051419bbc2e31dd1db55ca8","a2becd407db34b189200a32546d9d569",20260339,1,9,0,187,67,75,8
"a2becd407db34b189200a32546d9d569","a2becd407db34b189200a32546d9d569",20260339,5,0,1,188,75,75,0
"a2becd407db34b189200a32546d9d569","58c22b011d0f4c2ea6d13615edbb9eeb",20260339,1,2,0,193,75,77,2
"58c22b011d0f4c2ea6d13615edbb9eeb","58c22b011d0f4c2ea6d13615edbb9eeb",20260339,2,0,1,194,77,77,0
"58c22b011d0f4c2ea6d13615edbb9eeb","dd76e1861dc9461c830888729d091ee0",20260339,1,1,0,196,77,78,1
"dd76e1861dc9461c830888729d091ee0","dd76e1861dc9461c830888729d091ee0",20260339,8,0,1,197,78,78,0
"dd76e1861dc9461c830888729d091ee0","cd1d828f1a694b87913a7ea66c23803e",20260339,1,1,0,205,78,79,1
"cd1d828f1a694b87913a7ea66c23803e","cd1d828f1a694b87913a7ea66c23803e",20260339,2,0,1,206,79,79,0
"cd1d828f1a694b87913a7ea66c23803e","9176a3c2b4d2465fa8b0c67096c2a97e",20260339,1,1,0,208,79,80,1
"9176a3c2b4d2465fa8b0c67096c2a97e","9176a3c2b4d2465fa8b0c67096c2a97e",20260339,5,0,1,209,80,80,0
"9176a3c2b4d2465fa8b0c67096c2a97e","f8ec6445f7194e25b9101d4fbcb07a18",20260339,1,1,0,214,80,81,1
"f8ec6445f7194e25b9101d4fbcb07a18","f8ec6445f7194e25b9101d4fbcb07a18",20260339,2,0,1,215,81,81,0
"f8ec6445f7194e25b9101d4fbcb07a18","140d5b27b8574befad82c0a013b59dfa",20260339,1,-7,0,217,81,74,-7
"140d5b27b8574befad82c0a013b59dfa","d18a9ea32855445f8736581f5cb119ce",20260339,1,9,0,218,74,82,8
"d18a9ea32855445f8736581f5cb119ce","f564483cbd7a407681aa2fcca518cf5f",20260339,1,4,0,219,82,85,3
"f564483cbd7a407681aa2fcca518cf5f","f564483cbd7a407681aa2fcca518cf5f",20260339,1,0,1,220,85,85,0
"f564483cbd7a407681aa2fcca518cf5f","18fd01350bd5434ca636d59a599d768a",20260339,1,1,0,221,85,86,1
"18fd01350bd5434ca636d59a599d768a","18fd01350bd5434ca636d59a599d768a",20260339,9,0,1,222,86,86,0
"18fd01350bd5434ca636d59a599d768a","ae5ac430ea254e708a6f5deaaf7464ae",20260339,1,-2,0,231,86,84,-2
"ae5ac430ea254e708a6f5deaaf7464ae","6a9f0ef185fb47f0937e29daa1c71ed5",20260339,1,7,0,232,84,90,6
"6a9f0ef185fb47f0937e29daa1c71ed5","c681290961c94c4caf23b529d1ae6b9a",20260339,1,-2,0,233,90,88,-2
"c681290961c94c4caf23b529d1ae6b9a","c681290961c94c4caf23b529d1ae6b9a",20260339,1,0,1,234,88,88,0
"c681290961c94c4caf23b529d1ae6b9a","6a9f0ef185fb47f0937e29daa1c71ed5",20260339,1,2,0,235,88,90,2
"6a9f0ef185fb47f0937e29daa1c71ed5","6a9f0ef185fb47f0937e29daa1c71ed5",20260339,3,0,1,236,90,90,0
"6a9f0ef185fb47f0937e29daa1c71ed5","d646286c8051419bbc2e31dd1db55ca8",20260339,1,-27,0,239,90,67,-23
"d646286c8051419bbc2e31dd1db55ca8","e20db35ced8544ddac5bc3839145e463",20260339,1,30,0,240,67,91,24
"e20db35ced8544ddac5bc3839145e463","1febb706d7a34005ae8711ed49c76e64",20260339,1,3,0,241,91,94,3
"1febb706d7a34005ae8711ed49c76e64","1febb706d7a34005ae8711ed49c76e64",20260339,2,0,1,242,94,94,0
"1febb706d7a34005ae8711ed49c76e64","8f73ba6f5a0042f2850356ac38ac6f24",20260339,1,1,0,244,94,95,1
"8f73ba6f5a0042f2850356ac38ac6f24","8f73ba6f5a0042f2850356ac38ac6f24",20260339,5,0,1,245,95,95,0
"8f73ba6f5a0042f2850356ac38ac6f24","e2260b86653c46d7b14a41fb419dbf8c",20260339,1,1,0,250,95,96,1
"e2260b86653c46d7b14a41fb419dbf8c","e2260b86653c46d7b14a41fb419dbf8c",20260339,2,0,1,251,96,96,0
"e2260b86653c46d7b14a41fb419dbf8c","35eb641ad1d845bbba54915bce75a962",20260339,1,1,0,253,96,97,1
"35eb641ad1d845bbba54915bce75a962","35eb641ad1d845bbba54915bce75a962",20260339,5,0,1,254,97,97,0
"35eb641ad1d845bbba54915bce75a962","08be90ffbeea4795a138cd42ed8db56f",20260339,1,1,0,259,97,98,1
"08be90ffbeea4795a138cd42ed8db56f","08be90ffbeea4795a138cd42ed8db56f",20260339,5,0,1,260,98,98,0
"08be90ffbeea4795a138cd42ed8db56f","3007433c8f584dcbb5ac159c1c5f2be3",20260339,1,1,0,265,98,99,1
"3007433c8f584dcbb5ac159c1c5f2be3","3007433c8f584dcbb5ac159c1c5f2be3",20260339,5,0,1,266,99,99,0
"3007433c8f584dcbb5ac159c1c5f2be3","e20db35ced8544ddac5bc3839145e463",20260339,1,-8,0,271,99,91,-8
"e20db35ced8544ddac5bc3839145e463","00ae5f0c51874a73a41ebea838d95682",20260339,1,11,0,272,91,101,10
"00ae5f0c51874a73a41ebea838d95682","d391c8b6e56a43a7b654e9dee02d904b",20260339,2,2,0,273,101,103,2
"d391c8b6e56a43a7b654e9dee02d904b","00ae5f0c51874a73a41ebea838d95682",20260339,1,-2,0,274,103,101,-2
"00ae5f0c51874a73a41ebea838d95682","00ae5f0c51874a73a41ebea838d95682",20260339,4,0,1,275,101,101,0
"d391c8b6e56a43a7b654e9dee02d904b","d391c8b6e56a43a7b654e9dee02d904b",20260339,16,0,1,280,103,103,0
"d391c8b6e56a43a7b654e9dee02d904b","6111116566fc4fd9abba409322bea245",20260339,1,1,0,296,103,104,1
"6111116566fc4fd9abba409322bea245","6111116566fc4fd9abba409322bea245",20260339,2,0,1,297,104,104,0
"6111116566fc4fd9abba409322bea245","a81b2235cb9c499eb9ea8ee0a8dd9725",20260339,1,1,0,299,104,105,1
"a81b2235cb9c499eb9ea8ee0a8dd9725","a81b2235cb9c499eb9ea8ee0a8dd9725",20260339,5,0,1,300,105,105,0
"a81b2235cb9c499eb9ea8ee0a8dd9725","2d4e0ab0ef3b4d73b82c72d4621a7579",20260339,1,1,0,305,105,106,1
"2d4e0ab0ef3b4d73b82c72d4621a7579","2d4e0ab0ef3b4d73b82c72d4621a7579",20260339,2,0,1,306,106,106,0
"2d4e0ab0ef3b4d73b82c72d4621a7579","8bdebf492ebd4e62b0d522e8ab5e5197",20260339,1,1,0,308,106,107,1
"8bdebf492ebd4e62b0d522e8ab5e5197","8bdebf492ebd4e62b0d522e8ab5e5197",20260339,2,0,1,309,107,107,0
"8bdebf492ebd4e62b0d522e8ab5e5197","73039f8c1eb9409cb4caee2cf968001e",20260339,1,-7,0,311,107,100,-7
"73039f8c1eb9409cb4caee2cf968001e","4280927ec4d643238aa49c32f9e06c6c",20260339,1,10,0,312,100,109,9
"4280927ec4d643238aa49c32f9e06c6c","4280927ec4d643238aa49c32f9e06c6c",20260339,1,0,1,313,109,109,0
"4280927ec4d643238aa49c32f9e06c6c","fc44e6a5f7654430af1227838224dceb",20260339,1,2,0,314,109,111,2
"fc44e6a5f7654430af1227838224dceb","fc44e6a5f7654430af1227838224dceb",20260339,2,0,1,315,111,111,0
"fc44e6a5f7654430af1227838224dceb","08111f75e22d409998cf8b85bd431f0a",20260339,1,-3,0,317,111,108,-3
"08111f75e22d409998cf8b85bd431f0a","a9ae0a3c070d455bb4369a8996313336",20260339,1,7,0,318,108,114,6
"a9ae0a3c070d455bb4369a8996313336","a9ae0a3c070d455bb4369a8996313336",20260339,2,0,1,319,114,114,0
"a9ae0a3c070d455bb4369a8996313336","71cec822bcff4f30a20e75dc63ef7b65",20260339,1,2,0,321,114,116,2
"71cec822bcff4f30a20e75dc63ef7b65","71cec822bcff4f30a20e75dc63ef7b65",20260339,1,0,1,322,116,116,0
"71cec822bcff4f30a20e75dc63ef7b65","37319e88176d4aefa91d7a9980dbae91",20260339,1,-4,0,323,116,112,-4
"37319e88176d4aefa91d7a9980dbae91","62bff51286ef4f348717a3cf6fe2318f",20260339,2,9,0,324,112,120,8
"62bff51286ef4f348717a3cf6fe2318f","a9ae0a3c070d455bb4369a8996313336",20260339,1,-7,0,325,120,114,-6
"a9ae0a3c070d455bb4369a8996313336","3ec3a3563847406fa73338f9e9999cf3",20260339,1,4,0,326,114,117,3
"3ec3a3563847406fa73338f9e9999cf3","37319e88176d4aefa91d7a9980dbae91",20260339,1,-6,0,327,117,112,-5
"62bff51286ef4f348717a3cf6fe2318f","b1cd0e7dc3ad4a8eb91a4bfdbeb025b0",20260339,1,-2,0,329,120,118,-2
"b1cd0e7dc3ad4a8eb91a4bfdbeb025b0","b1cd0e7dc3ad4a8eb91a4bfdbeb025b0",20260339,1,0,1,330,118,118,0
"b1cd0e7dc3ad4a8eb91a4bfdbeb025b0","62bff51286ef4f348717a3cf6fe2318f",20260339,1,2,0,331,118,120,2
"62bff51286ef4f348717a3cf6fe2318f","62bff51286ef4f348717a3cf6fe2318f",20260339,3,0,1,332,120,120,0
"62bff51286ef4f348717a3cf6fe2318f","779f9ddd1fd14d1e9e69f72219a1fdbd",20260339,1,3,0,335,120,121,1
"779f9ddd1fd14d1e9e69f72219a1fdbd","e20db35ced8544ddac5bc3839145e463",20260339,1,-36,0,336,121,91,-30
"e20db35ced8544ddac5bc3839145e463","ae26e6cda8ad4a3f81bd347560d9579f",20260339,1,40,0,337,91,125,34
"ae26e6cda8ad4a3f81bd347560d9579f","ae26e6cda8ad4a3f81bd347560d9579f",20260339,3,0,1,338,125,125,0
"ae26e6cda8ad4a3f81bd347560d9579f","ee48df95832b4374aa273ceb27ec1315",20260339,1,1,0,341,125,126,1
"ee48df95832b4374aa273ceb27ec1315","ee48df95832b4374aa273ceb27ec1315",20260339,1,0,1,342,126,126,0
"ee48df95832b4374aa273ceb27ec1315","7a439da90b394756ad1777fc4c6dead5",20260339,1,1,0,343,126,127,1
"7a439da90b394756ad1777fc4c6dead5","7a439da90b394756ad1777fc4c6dead5",20260339,1,0,1,344,127,127,0
"7a439da90b394756ad1777fc4c6dead5","779f9ddd1fd14d1e9e69f72219a1fdbd",20260339,1,-6,0,345,127,121,-6
"779f9ddd1fd14d1e9e69f72219a1fdbd","a8dd5213034441ac92724b4e83eb0bb2",20260339,1,9,0,346,121,129,8
"a8dd5213034441ac92724b4e83eb0bb2","a8dd5213034441ac92724b4e83eb0bb2",20260339,1,0,1,347,129,129,0
"a8dd5213034441ac92724b4e83eb0bb2","8115eab6556b45f5b415c3b8c26a12e5",20260339,1,2,0,348,129,131,2
"8115eab6556b45f5b415c3b8c26a12e5","8115eab6556b45f5b415c3b8c26a12e5",20260339,2,0,1,349,131,131,0
"8115eab6556b45f5b415c3b8c26a12e5","ec34b06efd844b46a4c4818ecdb9b8f4",20260339,1,1,0,351,131,132,1
"ec34b06efd844b46a4c4818ecdb9b8f4","ec34b06efd844b46a4c4818ecdb9b8f4",20260339,8,0,1,352,132,132,0
"ec34b06efd844b46a4c4818ecdb9b8f4","c2e1c2b9eac64109b343a088584b576b",20260339,1,1,0,360,132,133,1
"c2e1c2b9eac64109b343a088584b576b","c2e1c2b9eac64109b343a088584b576b",20260339,2,0,1,361,133,133,0
"c2e1c2b9eac64109b343a088584b576b","579338175e0b4bbb8ef3b712b5d8b54e",20260339,1,-5,0,363,133,128,-5
"579338175e0b4bbb8ef3b712b5d8b54e","8bc5795d6a984a3eace4e2811e52dd4f",20260339,1,8,0,364,128,135,7
"8bc5795d6a984a3eace4e2811e52dd4f","8bc5795d6a984a3eace4e2811e52dd4f",20260339,3,0,1,365,135,135,0
"8bc5795d6a984a3eace4e2811e52dd4f","b416d47c56a742199b5d7c7f19d6503a",20260339,1,-1,0,368,135,134,-1
"b416d47c56a742199b5d7c7f19d6503a","cd4532ad48034873ba8bce2aac0c9808",20260339,1,4,0,369,134,137,3
"cd4532ad48034873ba8bce2aac0c9808","cd4532ad48034873ba8bce2aac0c9808",20260339,1,0,1,370,137,137,0
"cd4532ad48034873ba8bce2aac0c9808","779f9ddd1fd14d1e9e69f72219a1fdbd",20260339,1,-19,0,371,137,121,-16
"779f9ddd1fd14d1e9e69f72219a1fdbd","df1de691dafe4549a18a4398ee9dfaf9",20260339,1,23,0,372,121,139,18
"df1de691dafe4549a18a4398ee9dfaf9","6c5ad271a44743479bfaea29b1db8d02",20260339,1,4,0,373,139,143,4
"6c5ad271a44743479bfaea29b1db8d02","df1de691dafe4549a18a4398ee9dfaf9",20260339,1,-4,0,374,143,139,-4
"df1de691dafe4549a18a4398ee9dfaf9","e9312892f6234d46afcb2e1369d2d4ed",20260339,1,1,0,375,139,140,1
"e9312892f6234d46afcb2e1369d2d4ed","e9312892f6234d46afcb2e1369d2d4ed",20260339,1,0,1,376,140,140,0
"e9312892f6234d46afcb2e1369d2d4ed","6c5ad271a44743479bfaea29b1db8d02",20260339,1,3,0,377,140,143,3
"6c5ad271a44743479bfaea29b1db8d02","6c5ad271a44743479bfaea29b1db8d02",20260339,1,0,1,378,143,143,0
"6c5ad271a44743479bfaea29b1db8d02","83d311bed5374fee83d8d67a7d9d82dc",20260339,1,1,0,379,143,144,1
"83d311bed5374fee83d8d67a7d9d82dc","83d311bed5374fee83d8d67a7d9d82dc",20260339,1,0,1,380,144,144,0
"83d311bed5374fee83d8d67a7d9d82dc","402bba41861d43acb52a5abb89e8831e",20260339,1,1,0,381,144,145,1
"402bba41861d43acb52a5abb89e8831e","402bba41861d43acb52a5abb89e8831e",20260339,2,0,1,382,145,145,0
"402bba41861d43acb52a5abb89e8831e","df1de691dafe4549a18a4398ee9dfaf9",20260339,1,-6,0,384,145,139,-6
"df1de691dafe4549a18a4398ee9dfaf9","8aae34f5ddbb4052a709b12e6b0d40fa",20260339,1,9,0,385,139,147,8
"8aae34f5ddbb4052a709b12e6b0d40fa","8aae34f5ddbb4052a709b12e6b0d40fa",20260339,1,0,1,386,147,147,0
"8aae34f5ddbb4052a709b12e6b0d40fa","645b3f0249f64f76af2e19eb4d0e55b7",20260339,1,2,0,387,147,149,2
"645b3f0249f64f76af2e19eb4d0e55b7","645b3f0249f64f76af2e19eb4d0e55b7",20260339,2,0,1,388,149,149,0
"645b3f0249f64f76af2e19eb4d0e55b7","7e7b8db5064d4369805ab370aac5ddfb",20260339,1,1,0,390,149,150,1
"7e7b8db5064d4369805ab370aac5ddfb","7e7b8db5064d4369805ab370aac5ddfb",20260339,2,0,1,391,150,150,0
"7e7b8db5064d4369805ab370aac5ddfb","8956d210ae7f41968fada86d4c979d6a",20260339,1,1,0,393,150,151,1
"8956d210ae7f41968fada86d4c979d6a","8956d210ae7f41968fada86d4c979d6a",20260339,2,0,1,394,151,151,0
"8956d210ae7f41968fada86d4c979d6a","f902b0f41b544d4dbf79664fd233648d",20260339,1,-5,0,396,151,146,-5
"f902b0f41b544d4dbf79664fd233648d","ae781e8b775e4ccd93bc800dad5c8376",20260339,1,8,0,397,146,153,7
"ae781e8b775e4ccd93bc800dad5c8376","ae781e8b775e4ccd93bc800dad5c8376",20260339,2,0,1,398,153,153,0
"ae781e8b775e4ccd93bc800dad5c8376","06882a8492d9499aa31555567f575ecb",20260339,1,1,0,400,153,154,1
"06882a8492d9499aa31555567f575ecb","06882a8492d9499aa31555567f575ecb",20260339,1,0,1,401,154,154,0
"06882a8492d9499aa31555567f575ecb","f293c508f409466a8f27ddd7d1e40b20",20260339,1,1,0,402,154,155,1
"f293c508f409466a8f27ddd7d1e40b20","f293c508f409466a8f27ddd7d1e40b20",20260339,2,0,1,403,155,155,0
"f293c508f409466a8f27ddd7d1e40b20","cc4ddef5bbbe48ebb605141b347c4ed1",20260339,1,1,0,405,155,156,1
"cc4ddef5bbbe48ebb605141b347c4ed1","cc4ddef5bbbe48ebb605141b347c4ed1",20260339,1,0,1,406,156,156,0
"cc4ddef5bbbe48ebb605141b347c4ed1","f03480cf4eba413194d7af52fc0e7f28",20260339,1,-4,0,407,156,152,-4
"f03480cf4eba413194d7af52fc0e7f28","d313cec988a84645bee413e8d4724a4b",20260339,1,7,0,408,152,158,6
"d313cec988a84645bee413e8d4724a4b","d313cec988a84645bee413e8d4724a4b",20260339,4,0,1,409,158,158,0
"d313cec988a84645bee413e8d4724a4b","dc60696c76a74368a60f72246e47700d",20260339,1,1,0,413,158,159,1
"dc60696c76a74368a60f72246e47700d","dc60696c76a74368a60f72246e47700d",20260339,1,0,1,414,159,159,0
"dc60696c76a74368a60f72246e47700d","78adeee1fa2c4fe0bc73f7bca9fcee86",20260339,1,3,0,415,159,160,1
"78adeee1fa2c4fe0bc73f7bca9fcee86","df1de691dafe4549a18a4398ee9dfaf9",20260339,1,-26,0,416,160,139,-21
"df1de691dafe4549a18a4398ee9dfaf9","78adeee1fa2c4fe0bc73f7bca9fcee86",20260339,1,26,0,417,139,160,21
"78adeee1fa2c4fe0bc73f7bca9fcee86","65202579580f4ad38d734b4ee39d22a8",20260339,3,5,0,418,160,164,4
"65202579580f4ad38d734b4ee39d22a8","65202579580f4ad38d734b4ee39d22a8",20260339,58,0,1,419,164,164,0
"65202579580f4ad38d734b4ee39d22a8","78adeee1fa2c4fe0bc73f7bca9fcee86",20260339,1,-5,0,420,164,160,-4
"65202579580f4ad38d734b4ee39d22a8","3cbcea2be0984e7dbd5a48195af10ce7",20260339,1,3,0,470,164,165,1
"3cbcea2be0984e7dbd5a48195af10ce7","78adeee1fa2c4fe0bc73f7bca9fcee86",20260339,1,-8,0,471,165,160,-5
"78adeee1fa2c4fe0bc73f7bca9fcee86","82e6285962b8400d9d6fc32436022a94",20260339,1,10,0,472,160,167,7
"82e6285962b8400d9d6fc32436022a94","3cbcea2be0984e7dbd5a48195af10ce7",20260339,1,-2,0,473,167,165,-2
"3cbcea2be0984e7dbd5a48195af10ce7","a9ac840f098c4bd0a2ee896214ce29cd",20260339,1,5,0,474,165,168,3
"a9ac840f098c4bd0a2ee896214ce29cd","0c7262dff33c4087bc660ccf40f92f9c",20260339,1,4,0,475,168,169,1
"0c7262dff33c4087bc660ccf40f92f9c","a9ac840f098c4bd0a2ee896214ce29cd",20260339,1,-4,0,476,169,168,-1
"a9ac840f098c4bd0a2ee896214ce29cd","b2275c3fad834f8d90737a2d9a6927d6",20260339,1,7,0,477,168,172,4
"b2275c3fad834f8d90737a2d9a6927d6","8959e6304a0348309a771e4d08d1b64a",20260339,1,-16,0,478,172,163,-9
"8959e6304a0348309a771e4d08d1b64a","78adeee1fa2c4fe0bc73f7bca9fcee86",20260339,1,-4,0,479,163,160,-3
"65202579580f4ad38d734b4ee39d22a8","0c7262dff33c4087bc660ccf40f92f9c",20260339,1,12,0,490,164,169,5
"0c7262dff33c4087bc660ccf40f92f9c","b2275c3fad834f8d90737a2d9a6927d6",20260339,1,3,0,491,169,172,3
"b2275c3fad834f8d90737a2d9a6927d6","b2275c3fad834f8d90737a2d9a6927d6",20260339,32,0,1,492,172,172,0
"b2275c3fad834f8d90737a2d9a6927d6","eb515a26030b41f8a82a1e6114420bad",20260339,1,1,0,524,172,173,1
"eb515a26030b41f8a82a1e6114420bad","eb515a26030b41f8a82a1e6114420bad",20260339,2,0,1,525,173,173,0
"eb515a26030b41f8a82a1e6114420bad","0c7262dff33c4087bc660ccf40f92f9c",20260339,1,-4,0,527,173,169,-4
"0c7262dff33c4087bc660ccf40f92f9c","b42cc17b7de840f181a704558d0bc845",20260339,1,7,0,528,169,175,6
"b42cc17b7de840f181a704558d0bc845","b42cc17b7de840f181a704558d0bc845",20260339,1,0,1,529,175,175,0
"b42cc17b7de840f181a704558d0bc845","801f9e9135034f49bf5f8b4bdefedb41",20260339,1,2,0,530,175,177,2
"801f9e9135034f49bf5f8b4bdefedb41","801f9e9135034f49bf5f8b4bdefedb41",20260339,4,0,1,531,177,177,0
"801f9e9135034f49bf5f8b4bdefedb41","362fcb0699a14845ab29b2340093e528",20260339,1,-3,0,535,177,174,-3
"362fcb0699a14845ab29b2340093e528","ea38cc0e6e6e41edbabf210220808bf9",20260339,1,6,0,536,174,179,5
"ea38cc0e6e6e41edbabf210220808bf9","b87c552dd247427abe6ab5795b9c9d43",20260339,2,2,0,537,179,181,2
"b87c552dd247427abe6ab5795b9c9d43","ea38cc0e6e6e41edbabf210220808bf9",20260339,1,-2,0,538,181,179,-2
"b87c552dd247427abe6ab5795b9c9d43","b87c552dd247427abe6ab5795b9c9d43",20260339,7,0,1,540,181,181,0
"b87c552dd247427abe6ab5795b9c9d43","139b097acfca451689d80c9c6eebdf7b",20260339,1,-3,0,547,181,178,-3
"139b097acfca451689d80c9c6eebdf7b","30f660a1feb34582a739722532524f79",20260339,1,6,0,548,178,183,5
"30f660a1feb34582a739722532524f79","30f660a1feb34582a739722532524f79",20260339,5,0,1,549,183,183,0
"30f660a1feb34582a739722532524f79","2024b4885bd14338a39b7b509acbbd02",20260339,1,-1,0,554,183,182,-1
"2024b4885bd14338a39b7b509acbbd02","c3f63fe50d8e487c86bf8ef76c9cadd3",20260339,1,4,0,555,182,185,3
"c3f63fe50d8e487c86bf8ef76c9cadd3","c3f63fe50d8e487c86bf8ef76c9cadd3",20260339,1,0,1,556,185,185,0
"c3f63fe50d8e487c86bf8ef76c9cadd3","0c7262dff33c4087bc660ccf40f92f9c",20260339,1,-20,0,557,185,169,-16
"0c7262dff33c4087bc660ccf40f92f9c","c8e371568a0c4391b25796ae4e91952e",20260339,1,23,0,558,169,186,17
"c8e371568a0c4391b25796ae4e91952e","7d932b23e1c84326ae5aa4d3c0d813d1",20260339,1,2,0,559,186,188,2
"7d932b23e1c84326ae5aa4d3c0d813d1","7d932b23e1c84326ae5aa4d3c0d813d1",20260339,1,0,1,560,188,188,0
"7d932b23e1c84326ae5aa4d3c0d813d1","c8e371568a0c4391b25796ae4e91952e",20260339,1,-2,0,561,188,186,-2
"c8e371568a0c4391b25796ae4e91952e","ab11d94c6c8948ea90b88f19d2cd502b",20260339,1,5,0,562,186,190,4
"ab11d94c6c8948ea90b88f19d2cd502b","ab11d94c6c8948ea90b88f19d2cd502b",20260339,1,0,1,563,190,190,0
"ab11d94c6c8948ea90b88f19d2cd502b","f992451ed6ad4e68bb9e68ad6be7c4be",20260339,1,2,0,564,190,192,2
"f992451ed6ad4e68bb9e68ad6be7c4be","f992451ed6ad4e68bb9e68ad6be7c4be",20260339,1,0,1,565,192,192,0
"f992451ed6ad4e68bb9e68ad6be7c4be","07b44a7a51e94c78b411c753fc39dab0",20260339,1,-3,0,566,192,189,-3
"07b44a7a51e94c78b411c753fc39dab0","6cd2dcaac46847d4a0bc53f296d90375",20260339,1,6,0,567,189,194,5
"6cd2dcaac46847d4a0bc53f296d90375","6cd2dcaac46847d4a0bc53f296d90375",20260339,1,0,1,568,194,194,0
"6cd2dcaac46847d4a0bc53f296d90375","2d2580c9411c4972909db508d6956a58",20260339,1,2,0,569,194,196,2
"2d2580c9411c4972909db508d6956a58","2d2580c9411c4972909db508d6956a58",20260339,8,0,1,570,196,196,0
"2d2580c9411c4972909db508d6956a58","5bddb3d9ed264f3984702f048c7e5340",20260339,1,1,0,578,196,197,1
"5bddb3d9ed264f3984702f048c7e5340","5bddb3d9ed264f3984702f048c7e5340",20260339,2,0,1,579,197,197,0
"5bddb3d9ed264f3984702f048c7e5340","d5e8e2bd12a2466b9d6d90855f0eb079",20260339,1,1,0,581,197,198,1
"d5e8e2bd12a2466b9d6d90855f0eb079","d5e8e2bd12a2466b9d6d90855f0eb079",20260339,2,0,1,582,198,198,0
"d5e8e2bd12a2466b9d6d90855f0eb079","017d7ca8e0394b91aaadc9574df2202c",20260339,1,-5,0,584,198,193,-5
"017d7ca8e0394b91aaadc9574df2202c","54e8e9f0ea3e45c4bf3b8ac799ee31b1",20260339,1,8,0,585,193,200,7
"54e8e9f0ea3e45c4bf3b8ac799ee31b1","54e8e9f0ea3e45c4bf3b8ac799ee31b1",20260339,1,0,1,586,200,200,0
"54e8e9f0ea3e45c4bf3b8ac799ee31b1","c614a00911be4877a075f19315530fb0",20260339,1,1,0,587,200,201,1
"c614a00911be4877a075f19315530fb0","c614a00911be4877a075f19315530fb0",20260339,6,0,1,588,201,201,0
"c614a00911be4877a075f19315530fb0","a6c21bd8b95249c7972820a7a7d76aff",20260339,1,1,0,594,201,202,1
"a6c21bd8b95249c7972820a7a7d76aff","a6c21bd8b95249c7972820a7a7d76aff",20260339,1,0,1,595,202,202,0
"a6c21bd8b95249c7972820a7a7d76aff","bb329d880ab54120adaf203a693bb203",20260339,1,1,0,596,202,203,1
"bb329d880ab54120adaf203a693bb203","bb329d880ab54120adaf203a693bb203",20260339,1,0,1,597,203,203,0
"bb329d880ab54120adaf203a693bb203","f9170dd6bc6442b4acd832747609b09a",20260339,1,-4,0,598,203,199,-4
"f9170dd6bc6442b4acd832747609b09a","334c2344009840079b1d0e1b7ce3d5a7",20260339,1,7,0,599,199,205,6
"334c2344009840079b1d0e1b7ce3d5a7","334c2344009840079b1d0e1b7ce3d5a7",20260339,1,0,1,600,205,205,0
"334c2344009840079b1d0e1b7ce3d5a7","d7f13c8d63ec4e2aa673fbb9cf9c6933",20260339,1,3,0,601,205,206,1
"d7f13c8d63ec4e2aa673fbb9cf9c6933","c8e371568a0c4391b25796ae4e91952e",20260339,1,-26,0,602,206,186,-20
"c8e371568a0c4391b25796ae4e91952e","b9e80f77c3a44349863b19875725c384",20260339,1,27,0,603,186,207,21
"b9e80f77c3a44349863b19875725c384","7108f0e4c2584f1f9c471689ae4c885c",20260339,2,1,0,604,207,208,1
"7108f0e4c2584f1f9c471689ae4c885c","b9e80f77c3a44349863b19875725c384",20260339,1,-1,0,605,208,207,-1
"b9e80f77c3a44349863b19875725c384","b9e80f77c3a44349863b19875725c384",20260339,23,0,1,606,207,207,0
"7108f0e4c2584f1f9c471689ae4c885c","7108f0e4c2584f1f9c471689ae4c885c",20260339,15,0,1,630,208,208,0
"7108f0e4c2584f1f9c471689ae4c885c","09400e101c5d4b439cf9a26b03aae558",20260339,1,3,0,645,208,210,2
"09400e101c5d4b439cf9a26b03aae558","d7f13c8d63ec4e2aa673fbb9cf9c6933",20260339,1,-5,0,646,210,206,-4
"d7f13c8d63ec4e2aa673fbb9cf9c6933","09400e101c5d4b439cf9a26b03aae558",20260339,1,5,0,647,206,210,4
"09400e101c5d4b439cf9a26b03aae558","a88efa7e50ce47159810ab553afa6d3a",20260339,1,2,0,648,210,212,2
"a88efa7e50ce47159810ab553afa6d3a","a88efa7e50ce47159810ab553afa6d3a",20260339,5,0,1,649,212,212,0
"a88efa7e50ce47159810ab553afa6d3a","a875096404ef4a9984b62d74cda916f9",20260339,1,-3,0,654,212,209,-3
"a875096404ef4a9984b62d74cda916f9","f7fb1952f56b4189b86a9f8b7862d2b8",20260339,1,7,0,655,209,215,6
"f7fb1952f56b4189b86a9f8b7862d2b8","be502a7a43c44bf7b682698de79d9369",20260339,3,-1,0,656,215,214,-1
"be502a7a43c44bf7b682698de79d9369","f7fb1952f56b4189b86a9f8b7862d2b8",20260339,2,1,0,657,214,215,1
"f7fb1952f56b4189b86a9f8b7862d2b8","f7fb1952f56b4189b86a9f8b7862d2b8",20260339,15,0,1,658,215,215,0
"be502a7a43c44bf7b682698de79d9369","b860ee85d8bc4a2f97958cfb71be3533",20260339,1,2,0,674,214,216,2
"b860ee85d8bc4a2f97958cfb71be3533","b860ee85d8bc4a2f97958cfb71be3533",20260339,2,0,1,675,216,216,0
"b860ee85d8bc4a2f97958cfb71be3533","ec341f459285443b8361f7f15638ff08",20260339,1,-3,0,677,216,213,-3
"ec341f459285443b8361f7f15638ff08","363837c182e04711840d896ae1e0339c",20260339,2,6,0,678,213,218,5
"363837c182e04711840d896ae1e0339c","363837c182e04711840d896ae1e0339c",20260339,12,0,1,679,218,218,0
"363837c182e04711840d896ae1e0339c","01b2051f8941460d89945e3b02d1ce78",20260339,2,-1,0,691,218,217,-1
"01b2051f8941460d89945e3b02d1ce78","d7f13c8d63ec4e2aa673fbb9cf9c6933",20260339,1,-14,0,692,217,206,-11
"d7f13c8d63ec4e2aa673fbb9cf9c6933","be95c065e45447c1bd8215ea6f130c7a",20260339,1,17,0,693,206,219,13
"be95c065e45447c1bd8215ea6f130c7a","01b2051f8941460d89945e3b02d1ce78",20260339,1,-3,0,694,219,217,-2
"01b2051f8941460d89945e3b02d1ce78","363837c182e04711840d896ae1e0339c",20260339,1,1,0,695,217,218,1
"363837c182e04711840d896ae1e0339c","be502a7a43c44bf7b682698de79d9369",20260339,1,-5,0,696,218,214,-4
"be502a7a43c44bf7b682698de79d9369","ec341f459285443b8361f7f15638ff08",20260339,1,-1,0,699,214,213,-1
"01b2051f8941460d89945e3b02d1ce78","91125ca626c5470eb145501f8c37f8db",20260339,1,4,0,702,217,220,3
"91125ca626c5470eb145501f8c37f8db","91125ca626c5470eb145501f8c37f8db",20260339,1,0,1,703,220,220,0
"91125ca626c5470eb145501f8c37f8db","1c6721b1f63f4d30ba7746ea8af02a52",20260339,1,3,0,704,220,221,1
"1c6721b1f63f4d30ba7746ea8af02a52","d7f13c8d63ec4e2aa673fbb9cf9c6933",20260339,1,-21,0,705,221,206,-15
"d7f13c8d63ec4e2aa673fbb9cf9c6933","77ecef8eff6b4a2caea7707669bf7475",20260339,1,22,0,706,206,222,16
"77ecef8eff6b4a2caea7707669bf7475","77ecef8eff6b4a2caea7707669bf7475",20260339,12,0,1,707,222,222,0
"77ecef8eff6b4a2caea7707669bf7475","1c6721b1f63f4d30ba7746ea8af02a52",20260339,1,-1,0,719,222,221,-1
"1c6721b1f63f4d30ba7746ea8af02a52","8b9ae98743bd4d4a8a87dff1c1244211",20260339,1,7,0,720,221,227,6
"8b9ae98743bd4d4a8a87dff1c1244211","d03cb855c70044cf8c35d9ec0de696e3",20260339,1,-3,0,721,227,224,-3
"d03cb855c70044cf8c35d9ec0de696e3","d03cb855c70044cf8c35d9ec0de696e3",20260339,1,0,1,722,224,224,0
"d03cb855c70044cf8c35d9ec0de696e3","a49a937d6896486d9a5396654abcf2e1",20260339,1,2,0,723,224,226,2
"a49a937d6896486d9a5396654abcf2e1","a49a937d6896486d9a5396654abcf2e1",20260339,1,0,1,724,226,226,0
"a49a937d6896486d9a5396654abcf2e1","8b9ae98743bd4d4a8a87dff1c1244211",20260339,1,1,0,725,226,227,1
"8b9ae98743bd4d4a8a87dff1c1244211","8b9ae98743bd4d4a8a87dff1c1244211",20260339,16,0,1,726,227,227,0
"8b9ae98743bd4d4a8a87dff1c1244211","f7906d6f59b9489a91d2ef40db5a474d",20260339,1,-4,0,742,227,223,-4
"f7906d6f59b9489a91d2ef40db5a474d","2ab1535aac1346ba8801535bf729ef37",20260339,1,7,0,743,223,229,6
"2ab1535aac1346ba8801535bf729ef37","2ab1535aac1346ba8801535bf729ef37",20260339,1,0,1,744,229,229,0
"2ab1535aac1346ba8801535bf729ef37","a4f40fb48a8542c8949bae1f002cd9bc",20260339,1,2,0,745,229,231,2
"a4f40fb48a8542c8949bae1f002cd9bc","a4f40fb48a8542c8949bae1f002cd9bc",20260339,2,0,1,746,231,231,0
"a4f40fb48a8542c8949bae1f002cd9bc","8972c23e32044edb8a78fa1eed4e5947",20260339,1,1,0,748,231,232,1
"8972c23e32044edb8a78fa1eed4e5947","8972c23e32044edb8a78fa1eed4e5947",20260339,1,0,1,749,232,232,0
"8972c23e32044edb8a78fa1eed4e5947","92feb4a40f8344d38b6f722e42a53295",20260339,1,1,0,750,232,233,1
"92feb4a40f8344d38b6f722e42a53295","92feb4a40f8344d38b6f722e42a53295",20260339,2,0,1,751,233,233,0
"92feb4a40f8344d38b6f722e42a53295","5152833676bf4c6cb317060be10f68db",20260339,1,-5,0,753,233,228,-5
"5152833676bf4c6cb317060be10f68db","ca3e28f290354c08aefe5b0f769604e6",20260339,1,8,0,754,228,235,7
"ca3e28f290354c08aefe5b0f769604e6","ca3e28f290354c08aefe5b0f769604e6",20260339,4,0,1,755,235,235,0
"ca3e28f290354c08aefe5b0f769604e6","79a35eea833e4c2c9d22fc53c3c6445c",20260339,1,1,0,759,235,236,1
"79a35eea833e4c2c9d22fc53c3c6445c","79a35eea833e4c2c9d22fc53c3c6445c",20260339,4,0,1,760,236,236,0
"79a35eea833e4c2c9d22fc53c3c6445c","8f68228b1518449e9615cdafee41a2bd",20260339,1,1,0,764,236,237,1
"8f68228b1518449e9615cdafee41a2bd","8f68228b1518449e9615cdafee41a2bd",20260339,1,0,1,765,237,237,0
"8f68228b1518449e9615cdafee41a2bd","cab89fa5c3ed45a5aa550fc0352d6a42",20260339,1,1,0,766,237,238,1
"cab89fa5c3ed45a5aa550fc0352d6a42","cab89fa5c3ed45a5aa550fc0352d6a42",20260339,1,0,1,767,238,238,0
"cab89fa5c3ed45a5aa550fc0352d6a42","66d4fad4f1cf4b46be0750a99ad7a35a",20260339,1,1,0,768,238,239,1
"66d4fad4f1cf4b46be0750a99ad7a35a","66d4fad4f1cf4b46be0750a99ad7a35a",20260339,1,0,1,769,239,239,0
"66d4fad4f1cf4b46be0750a99ad7a35a","0b04c8e2f86d48c7aeb7e225819cd32b",20260339,1,-5,0,770,239,234,-5
"0b04c8e2f86d48c7aeb7e225819cd32b","f53da5fd9bfe412da4b80d4742563b6c",20260339,1,8,0,771,234,241,7
"f53da5fd9bfe412da4b80d4742563b6c","f53da5fd9bfe412da4b80d4742563b6c",20260339,1,0,1,772,241,241,0
"f53da5fd9bfe412da4b80d4742563b6c","2ae94c0cea4d480a9d5dca8fb1d7b542",20260339,1,3,0,773,241,242,1
"2ae94c0cea4d480a9d5dca8fb1d7b542","1c6721b1f63f4d30ba7746ea8af02a52",20260339,1,-27,0,774,242,221,-21
"1c6721b1f63f4d30ba7746ea8af02a52","1ebf23f9d994469a85206e4c7b1bf5f5",20260339,1,30,0,775,221,245,24
"1ebf23f9d994469a85206e4c7b1bf5f5","1ebf23f9d994469a85206e4c7b1bf5f5",20260339,10,0,1,776,245,245,0
"1ebf23f9d994469a85206e4c7b1bf5f5","85ae675b83e8422da842cfd25596af99",20260339,1,1,0,786,245,246,1
"85ae675b83e8422da842cfd25596af99","85ae675b83e8422da842cfd25596af99",20260339,1,0,1,787,246,246,0
"85ae675b83e8422da842cfd25596af99","2ae94c0cea4d480a9d5dca8fb1d7b542",20260339,1,-4,0,788,246,242,-4
"2ae94c0cea4d480a9d5dca8fb1d7b542","fa235f0f364d47e4ae1c87f47bf8e6ba",20260339,1,12,0,789,242,252,10
"fa235f0f364d47e4ae1c87f47bf8e6ba","fa235f0f364d47e4ae1c87f47bf8e6ba",20260339,1,0,1,790,252,252,0
"fa235f0f364d47e4ae1c87f47bf8e6ba","79f7845465cc4ed19d8e4f1429541be0",20260339,1,2,0,791,252,254,2
"79f7845465cc4ed19d8e4f1429541be0","79f7845465cc4ed19d8e4f1429541be0",20260339,2,0,1,792,254,254,0
"79f7845465cc4ed19d8e4f1429541be0","00f61990949545828dd12f1303d47504",20260339,1,3,0,794,254,256,2
"00f61990949545828dd12f1303d47504","6e83e23f56544a19b94067c1c558d9c0",20260339,1,-11,0,795,256,247,-9
"6e83e23f56544a19b94067c1c558d9c0","00f61990949545828dd12f1303d47504",20260339,1,11,0,796,247,256,9
"00f61990949545828dd12f1303d47504","00f61990949545828dd12f1303d47504",20260339,1,0,1,797,256,256,0
"00f61990949545828dd12f1303d47504","ead7bb4b64e247d2ae632ab8a296b091",20260339,1,2,0,798,256,258,2
"ead7bb4b64e247d2ae632ab8a296b091","ead7bb4b64e247d2ae632ab8a296b091",20260339,2,0,1,799,258,258,0
"ead7bb4b64e247d2ae632ab8a296b091","41b0048dde734bb280bac6116baa8e27",20260339,1,1,0,801,258,259,1
"41b0048dde734bb280bac6116baa8e27","41b0048dde734bb280bac6116baa8e27",20260339,2,0,1,802,259,259,0
"41b0048dde734bb280bac6116baa8e27","b41c5a094a604ee0915327da5cc0beb7",20260339,1,1,0,804,259,260,1
"b41c5a094a604ee0915327da5cc0beb7","b41c5a094a604ee0915327da5cc0beb7",20260339,2,0,1,805,260,260,0
"b41c5a094a604ee0915327da5cc0beb7","d546341988904f069cfa86b21457d9d9",20260339,1,-10,0,807,260,251,-9
"d546341988904f069cfa86b21457d9d9","28c171777c52431ab6b925073bd63d46",20260339,1,15,0,808,251,264,13
"28c171777c52431ab6b925073bd63d46","28c171777c52431ab6b925073bd63d46",20260339,7,0,1,809,264,264,0
"28c171777c52431ab6b925073bd63d46","ac160db940cb49ae8579162b1d52bb5d",20260339,1,2,0,816,264,266,2
"ac160db940cb49ae8579162b1d52bb5d","ac160db940cb49ae8579162b1d52bb5d",20260339,3,0,1,817,266,266,0
"ac160db940cb49ae8579162b1d52bb5d","d989ebcfc12a4b669f0100dc1aa14f1e",20260339,1,-12,0,820,266,255,-11
"d989ebcfc12a4b669f0100dc1aa14f1e","44240778a97c4af0937817499b75707b",20260339,1,16,0,821,255,269,14
"44240778a97c4af0937817499b75707b","44240778a97c4af0937817499b75707b",20260339,2,0,1,822,269,269,0
"44240778a97c4af0937817499b75707b","c6fd49b485cc4874b0bbdd9c6171e09c",20260339,1,-1,0,824,269,268,-1
"c6fd49b485cc4874b0bbdd9c6171e09c","c6fd49b485cc4874b0bbdd9c6171e09c",20260339,7,0,1,825,268,268,0
"c6fd49b485cc4874b0bbdd9c6171e09c","7aa76d3e993840d8805f097cbdbcd44b",20260339,1,-8,0,832,268,261,-7
"7aa76d3e993840d8805f097cbdbcd44b","865a4d3b43374da7944dc7d397f566d9",20260339,1,12,0,833,261,271,10
"865a4d3b43374da7944dc7d397f566d9","865a4d3b43374da7944dc7d397f566d9",20260339,1,0,1,834,271,271,0
"865a4d3b43374da7944dc7d397f566d9","2ae94c0cea4d480a9d5dca8fb1d7b542",20260339,1,-35,0,835,271,242,-29
"2ae94c0cea4d480a9d5dca8fb1d7b542","0d987bed3ffa4ed0b9a2e62e97b7b30f",20260339,1,38,0,836,242,272,30
"0d987bed3ffa4ed0b9a2e62e97b7b30f","0d987bed3ffa4ed0b9a2e62e97b7b30f",20260339,2,0,1,837,272,272,0
"0d987bed3ffa4ed0b9a2e62e97b7b30f","bb5a47f5ea01454a8b79455422d3b9da",20260339,6,10,0,838,272,280,8
"bb5a47f5ea01454a8b79455422d3b9da","82ae07bc0c9b4570a41799290d1ef399",20260339,3,-6,0,839,280,275,-5
"82ae07bc0c9b4570a41799290d1ef399","bb5a47f5ea01454a8b79455422d3b9da",20260339,4,6,0,840,275,280,5
"bb5a47f5ea01454a8b79455422d3b9da","bb5a47f5ea01454a8b79455422d3b9da",20260339,112,0,1,841,280,280,0
"bb5a47f5ea01454a8b79455422d3b9da","bc5524e78a8544e2ae2fdc2f3462bbec",20260339,5,-1,0,847,280,279,-1
"bc5524e78a8544e2ae2fdc2f3462bbec","82ae07bc0c9b4570a41799290d1ef399",20260339,1,-5,0,848,279,275,-4
"82ae07bc0c9b4570a41799290d1ef399","0d987bed3ffa4ed0b9a2e62e97b7b30f",20260339,1,-4,0,849,275,272,-3
"bc5524e78a8544e2ae2fdc2f3462bbec","bb5a47f5ea01454a8b79455422d3b9da",20260339,2,1,0,864,279,280,1
"bb5a47f5ea01454a8b79455422d3b9da","0d987bed3ffa4ed0b9a2e62e97b7b30f",20260339,4,-10,0,866,280,272,-8
"0d987bed3ffa4ed0b9a2e62e97b7b30f","82ae07bc0c9b4570a41799290d1ef399",20260339,1,4,0,868,272,275,3
"0d987bed3ffa4ed0b9a2e62e97b7b30f","94cecc3f1e7d484b8e068e79241dfd73",20260339,2,13,0,940,272,281,9
"94cecc3f1e7d484b8e068e79241dfd73","a37477c4e4c14169ad44b06b493007f6",20260339,2,2,0,941,281,283,2
"a37477c4e4c14169ad44b06b493007f6","bc5524e78a8544e2ae2fdc2f3462bbec",20260339,1,-6,0,942,283,279,-4
"bc5524e78a8544e2ae2fdc2f3462bbec","0d987bed3ffa4ed0b9a2e62e97b7b30f",20260339,3,-9,0,943,279,272,-7
"a37477c4e4c14169ad44b06b493007f6","94cecc3f1e7d484b8e068e79241dfd73",20260339,1,-2,0,986,283,281,-2
"94cecc3f1e7d484b8e068e79241dfd73","fab84b4fab5940efb4ea868ef8d09396",20260339,1,5,0,987,281,284,3
"fab84b4fab5940efb4ea868ef8d09396","fab84b4fab5940efb4ea868ef8d09396",20260339,1,0,1,988,284,284,0
"fab84b4fab5940efb4ea868ef8d09396","4a29443515bb404cb8924e1c60a63b73",20260339,1,4,0,989,284,285,1
"4a29443515bb404cb8924e1c60a63b73","208c9b2796c944db8dacaa96082520ea",20260339,1,3,0,990,285,288,3
"208c9b2796c944db8dacaa96082520ea","208c9b2796c944db8dacaa96082520ea",20260339,2,0,1,991,288,288,0
"208c9b2796c944db8dacaa96082520ea","4a29443515bb404cb8924e1c60a63b73",20260339,1,-3,0,993,288,285,-3
"4a29443515bb404cb8924e1c60a63b73","7669a956527947d0add87455277e80b4",20260339,1,7,0,994,285,291,6
"7669a956527947d0add87455277e80b4","7669a956527947d0add87455277e80b4",20260339,1,0,1,995,291,291,0
"7669a956527947d0add87455277e80b4","6a9a3b5bde4a48daa896fe8c06eca56f",20260339,1,-2,0,996,291,289,-2
"869e967078f04da18dd0b0b9389a7424","4a29443515bb404cb8924e1c60a63b73",20260339,1,-10,0,1000,293,285,-8
"4a29443515bb404cb8924e1c60a63b73","869e967078f04da18dd0b0b9389a7424",20260339,1,10,0,1001,285,293,8
"869e967078f04da18dd0b0b9389a7424","1b4550d0dab04078b3bf08a655345bdc",20260339,1,104,0,1002,293,373,80
"1b4550d0dab04078b3bf08a655345bdc","b71bac264efb4abd97015447bd490db6",20260339,2,-4,0,1003,373,370,-3
"b71bac264efb4abd97015447bd490db6","8d448d625b024c82a5eb240bbd7431d6",20260339,7,5,0,1004,370,374,4
"8d448d625b024c82a5eb240bbd7431d6","8d448d625b024c82a5eb240bbd7431d6",20260339,85,0,1,1005,374,374,0
"8d448d625b024c82a5eb240bbd7431d6","b71bac264efb4abd97015447bd490db6",20260339,4,-5,0,1012,374,370,-4
"b71bac264efb4abd97015447bd490db6","1b4550d0dab04078b3bf08a655345bdc",20260339,1,4,0,1013,370,373,3
"1b4550d0dab04078b3bf08a655345bdc","1b4550d0dab04078b3bf08a655345bdc",20260339,1,0,1,1014,373,373,0
"1b4550d0dab04078b3bf08a655345bdc","8d448d625b024c82a5eb240bbd7431d6",20260339,1,1,0,1015,373,374,1
"8d448d625b024c82a5eb240bbd7431d6","6a9a3b5bde4a48daa896fe8c06eca56f",20260339,1,-110,0,1023,374,289,-85
"6a9a3b5bde4a48daa896fe8c06eca56f","4a29443515bb404cb8924e1c60a63b73",20260339,1,-5,0,1024,289,285,-4
"4a29443515bb404cb8924e1c60a63b73","6a9a3b5bde4a48daa896fe8c06eca56f",20260339,1,5,0,1025,285,289,4
"6a9a3b5bde4a48daa896fe8c06eca56f","869e967078f04da18dd0b0b9389a7424",20260339,2,5,0,1026,289,293,4
"869e967078f04da18dd0b0b9389a7424","869e967078f04da18dd0b0b9389a7424",20260339,7,0,1,1027,293,293,0
"869e967078f04da18dd0b0b9389a7424","51ab6291537748fab90d519aa09889d6",20260339,1,2,0,1032,293,295,2
"51ab6291537748fab90d519aa09889d6","51ab6291537748fab90d519aa09889d6",20260339,5,0,1,1033,295,295,0
"51ab6291537748fab90d519aa09889d6","34a6e49023fc4465bd5ca604330bbd1c",20260339,1,-3,0,1038,295,292,-3
"34a6e49023fc4465bd5ca604330bbd1c","ba0e59461bfb4a44b7b1c28a01f8d3b3",20260339,1,9,0,1039,292,299,7
"ba0e59461bfb4a44b7b1c28a01f8d3b3","21592f2a9e9c4b2f8c66ec5dbcbf6a2b",20260339,1,-4,0,1040,299,296,-3
"21592f2a9e9c4b2f8c66ec5dbcbf6a2b","ba0e59461bfb4a44b7b1c28a01f8d3b3",20260339,1,4,0,1041,296,299,3
"ba0e59461bfb4a44b7b1c28a01f8d3b3","0e0b36e731a645e7b1b8a88f5031ca38",20260339,1,2,0,1042,299,301,2
"0e0b36e731a645e7b1b8a88f5031ca38","0e0b36e731a645e7b1b8a88f5031ca38",20260339,2,0,1,1043,301,301,0
"0e0b36e731a645e7b1b8a88f5031ca38","a66a144637284c21afc6de17fea4bfb8",20260339,1,1,0,1045,301,302,1
"a66a144637284c21afc6de17fea4bfb8","a66a144637284c21afc6de17fea4bfb8",20260339,2,0,1,1046,302,302,0
"a66a144637284c21afc6de17fea4bfb8","7646a919d7e64fa990bca9b024ff089d",20260339,1,-4,0,1048,302,298,-4
"7646a919d7e64fa990bca9b024ff089d","e390b575229748ea8aac9364efe2bf00",20260339,1,7,0,1049,298,304,6
"e390b575229748ea8aac9364efe2bf00","e390b575229748ea8aac9364efe2bf00",20260339,1,0,1,1050,304,304,0
"e390b575229748ea8aac9364efe2bf00","4a29443515bb404cb8924e1c60a63b73",20260339,1,-24,0,1051,304,285,-19
"4a29443515bb404cb8924e1c60a63b73","3434c10e561d488a914e0f7d71907abd",20260339,1,27,0,1052,285,305,20
"3434c10e561d488a914e0f7d71907abd","53e7e900392747ccad52e711ab0f80d8",20260339,1,2,0,1053,305,307,2
"53e7e900392747ccad52e711ab0f80d8","53e7e900392747ccad52e711ab0f80d8",20260339,1,0,1,1054,307,307,0
"53e7e900392747ccad52e711ab0f80d8","3434c10e561d488a914e0f7d71907abd",20260339,1,-2,0,1055,307,305,-2
"3434c10e561d488a914e0f7d71907abd","130acc2aeb0448fdbb2de63bc5cebe5b",20260339,1,5,0,1056,305,309,4
"130acc2aeb0448fdbb2de63bc5cebe5b","130acc2aeb0448fdbb2de63bc5cebe5b",20260339,1,0,1,1057,309,309,0
"130acc2aeb0448fdbb2de63bc5cebe5b","9c062b3251034ebe90f5054e2a3b5120",20260339,1,2,0,1058,309,311,2
"9c062b3251034ebe90f5054e2a3b5120","9c062b3251034ebe90f5054e2a3b5120",20260339,2,0,1,1059,311,311,0
"9c062b3251034ebe90f5054e2a3b5120","ea859f8207e44537889daeaba13ac2e8",20260339,1,1,0,1061,311,312,1
"ea859f8207e44537889daeaba13ac2e8","ea859f8207e44537889daeaba13ac2e8",20260339,1,0,1,1062,312,312,0
"ea859f8207e44537889daeaba13ac2e8","56d94971a7a94257aa330183a8ebd0ea",20260339,1,1,0,1063,312,313,1
"56d94971a7a94257aa330183a8ebd0ea","56d94971a7a94257aa330183a8ebd0ea",20260339,1,0,1,1064,313,313,0
"56d94971a7a94257aa330183a8ebd0ea","141c0df6cd1946539aadd1c9b7068cd4",20260339,1,-5,0,1065,313,308,-5
"141c0df6cd1946539aadd1c9b7068cd4","13255e63e0aa4abf85e5211bf613d43e",20260339,1,10,0,1066,308,317,9
"13255e63e0aa4abf85e5211bf613d43e","13255e63e0aa4abf85e5211bf613d43e",20260339,1,0,1,1067,317,317,0
"13255e63e0aa4abf85e5211bf613d43e","0c787d16c9504873b1a4d903cec09948",20260339,1,-3,0,1068,317,314,-3
"0c787d16c9504873b1a4d903cec09948","86c27d40179e419c8e9d150fb6afa5d0",20260339,1,6,0,1069,314,319,5
"86c27d40179e419c8e9d150fb6afa5d0","86c27d40179e419c8e9d150fb6afa5d0",20260339,1,0,1,1070,319,319,0
"86c27d40179e419c8e9d150fb6afa5d0","8d7e0b55cf9849cda222a0f2440cec55",20260339,1,-1,0,1071,319,318,-1
"8d7e0b55cf9849cda222a0f2440cec55","47edbb64109243e6b0f8f64cdef90c6c",20260339,1,9,0,1072,318,326,8
"47edbb64109243e6b0f8f64cdef90c6c","24f1363179ad4aaa965484a78471912b",20260339,1,-3,0,1073,326,323,-3
"24f1363179ad4aaa965484a78471912b","24f1363179ad4aaa965484a78471912b",20260339,1,0,1,1074,323,323,0
"24f1363179ad4aaa965484a78471912b","3628bdce1dd2429ba924d2d4d09448d2",20260339,1,-1,0,1075,323,322,-1
"3628bdce1dd2429ba924d2d4d09448d2","56b3fd1a212a4764be39d979fde3326e",20260339,1,7,0,1076,322,328,6
"56b3fd1a212a4764be39d979fde3326e","56b3fd1a212a4764be39d979fde3326e",20260339,1,0,1,1077,328,328,0
"56b3fd1a212a4764be39d979fde3326e","3434c10e561d488a914e0f7d71907abd",20260339,1,-28,0,1078,328,305,-23
"3434c10e561d488a914e0f7d71907abd","0c4079457ede49e3aeb5e86ed84bdf35",20260339,1,31,0,1079,305,329,24
"0c4079457ede49e3aeb5e86ed84bdf35","38aea304b4fa46e1b29bb72f5cea4c93",20260339,1,2,0,1080,329,331,2
"38aea304b4fa46e1b29bb72f5cea4c93","38aea304b4fa46e1b29bb72f5cea4c93",20260339,4,0,1,1081,331,331,0
"38aea304b4fa46e1b29bb72f5cea4c93","e36d261332f14e79bb4b467aceaeb9b5",20260339,1,2,0,1082,331,333,2
"e36d261332f14e79bb4b467aceaeb9b5","e36d261332f14e79bb4b467aceaeb9b5",20260339,2,0,1,1083,333,333,0
"e36d261332f14e79bb4b467aceaeb9b5","c7e89b9d04744d2eab742fc24e3ef1ae",20260339,1,1,0,1085,333,334,1
"c7e89b9d04744d2eab742fc24e3ef1ae","c7e89b9d04744d2eab742fc24e3ef1ae",20260339,2,0,1,1086,334,334,0
"c7e89b9d04744d2eab742fc24e3ef1ae","fe49f8054b374a0ea4bb266ed135ff62",20260339,1,1,0,1088,334,335,1
"fe49f8054b374a0ea4bb266ed135ff62","fe49f8054b374a0ea4bb266ed135ff62",20260339,5,0,1,1089,335,335,0
"fe49f8054b374a0ea4bb266ed135ff62","38aea304b4fa46e1b29bb72f5cea4c93",20260339,1,-4,0,1094,335,331,-4
"38aea304b4fa46e1b29bb72f5cea4c93","d0a8f74af98642fe8360d22c42e45117",20260339,1,5,0,1095,331,336,5
"d0a8f74af98642fe8360d22c42e45117","d0a8f74af98642fe8360d22c42e45117",20260339,2,0,1,1096,336,336,0
"d0a8f74af98642fe8360d22c42e45117","0c4079457ede49e3aeb5e86ed84bdf35",20260339,1,-7,0,1098,336,329,-7
"0c4079457ede49e3aeb5e86ed84bdf35","a7c6339ca1da4368a18d471f0519f877",20260339,1,11,0,1099,329,339,10
"a7c6339ca1da4368a18d471f0519f877","a7c6339ca1da4368a18d471f0519f877",20260339,1,0,1,1100,339,339,0
"a7c6339ca1da4368a18d471f0519f877","b8b9418ab322418d9db9b40d96af873a",20260339,1,-2,0,1101,339,337,-2
"b8b9418ab322418d9db9b40d96af873a","bbc5139ca9024389a94db3a6f47dcff6",20260339,1,5,0,1102,337,341,4
"bbc5139ca9024389a94db3a6f47dcff6","bbc5139ca9024389a94db3a6f47dcff6",20260339,1,0,1,1103,341,341,0
"bbc5139ca9024389a94db3a6f47dcff6","4ee6ca9019ab4a1ab323f98094a9bd77",20260339,1,2,0,1104,341,343,2
"4ee6ca9019ab4a1ab323f98094a9bd77","4ee6ca9019ab4a1ab323f98094a9bd77",20260339,2,0,1,1105,343,343,0
"4ee6ca9019ab4a1ab323f98094a9bd77","b37947176785476f8b29d49a851366dc",20260339,1,1,0,1107,343,344,1
"b37947176785476f8b29d49a851366dc","b37947176785476f8b29d49a851366dc",20260339,2,0,1,1108,344,344,0
"b37947176785476f8b29d49a851366dc","fcea5b10d5a14a3b9324ffece8f6e1e5",20260339,1,1,0,1110,344,345,1
"fcea5b10d5a14a3b9324ffece8f6e1e5","fcea5b10d5a14a3b9324ffece8f6e1e5",20260339,2,0,1,1111,345,345,0
"fcea5b10d5a14a3b9324ffece8f6e1e5","c2490bc612d146edbe786556fab3651b",20260339,1,-5,0,1113,345,340,-5
"c2490bc612d146edbe786556fab3651b","38aea304b4fa46e1b29bb72f5cea4c93",20260339,1,-11,0,1114,340,331,-9
"38aea304b4fa46e1b29bb72f5cea4c93","4a92daef4d504e1792575a26502bb7b7",20260339,1,18,0,1115,331,346,15
"4a92daef4d504e1792575a26502bb7b7","38aea304b4fa46e1b29bb72f5cea4c93",20260339,1,-18,0,1116,346,331,-15
"38aea304b4fa46e1b29bb72f5cea4c93","0c4079457ede49e3aeb5e86ed84bdf35",20260339,1,-2,0,1120,331,329,-2
"0c4079457ede49e3aeb5e86ed84bdf35","6ac8bb048b854999a47edb35fe627f11",20260339,1,21,0,1121,329,347,18
"6ac8bb048b854999a47edb35fe627f11","6ac8bb048b854999a47edb35fe627f11",20260339,1,0,1,1122,347,347,0
"6ac8bb048b854999a47edb35fe627f11","30ead9794d4847abaf222ca966cc8630",20260339,1,3,0,1123,347,348,1
"30ead9794d4847abaf222ca966cc8630","0c4079457ede49e3aeb5e86ed84bdf35",20260339,1,-24,0,1124,348,329,-19
"0c4079457ede49e3aeb5e86ed84bdf35","c20993c944444fe085345591a8bd837e",20260339,1,27,0,1125,329,351,22
"c20993c944444fe085345591a8bd837e","09b9678ddc3d452ea4a3d46e15826065",20260339,1,2,0,1126,351,353,2
"09b9678ddc3d452ea4a3d46e15826065","897b7f51242c44aab2205c72fdcbf4cd",20260339,1,-1,0,1127,353,352,-1
"897b7f51242c44aab2205c72fdcbf4cd","eff0de7f2dbb42dfa1a2e686efab5b6d",20260339,1,2,0,1128,352,354,2
"eff0de7f2dbb42dfa1a2e686efab5b6d","c20993c944444fe085345591a8bd837e",20260339,1,-3,0,1129,354,351,-3
"c20993c944444fe085345591a8bd837e","c20993c944444fe085345591a8bd837e",20260339,3,0,1,1130,351,351,0
"c20993c944444fe085345591a8bd837e","897b7f51242c44aab2205c72fdcbf4cd",20260339,1,1,0,1133,351,352,1
"897b7f51242c44aab2205c72fdcbf4cd","897b7f51242c44aab2205c72fdcbf4cd",20260339,3,0,1,1134,352,352,0
"897b7f51242c44aab2205c72fdcbf4cd","09b9678ddc3d452ea4a3d46e15826065",20260339,1,1,0,1137,352,353,1
"09b9678ddc3d452ea4a3d46e15826065","09b9678ddc3d452ea4a3d46e15826065",20260339,3,0,1,1138,353,353,0
"09b9678ddc3d452ea4a3d46e15826065","eff0de7f2dbb42dfa1a2e686efab5b6d",20260339,1,1,0,1141,353,354,1
"eff0de7f2dbb42dfa1a2e686efab5b6d","eff0de7f2dbb42dfa1a2e686efab5b6d",20260339,3,0,1,1142,354,354,0
"eff0de7f2dbb42dfa1a2e686efab5b6d","30ead9794d4847abaf222ca966cc8630",20260339,1,-6,0,1145,354,348,-6
"30ead9794d4847abaf222ca966cc8630","2fe14166dc9642c3bc666b86a57f943d",20260339,2,10,0,1146,348,357,9
"2fe14166dc9642c3bc666b86a57f943d","2fe14166dc9642c3bc666b86a57f943d",20260339,1,0,1,1147,357,357,0
"2fe14166dc9642c3bc666b86a57f943d","44421dd1e13a47a388c4a19834b744c7",20260339,1,2,0,1148,357,359,2
"44421dd1e13a47a388c4a19834b744c7","44421dd1e13a47a388c4a19834b744c7",20260339,2,0,1,1149,359,359,0
"44421dd1e13a47a388c4a19834b744c7","cb5fc7ef85d547c4be1a7439d0bf6052",20260339,1,1,0,1151,359,360,1
"cb5fc7ef85d547c4be1a7439d0bf6052","cb5fc7ef85d547c4be1a7439d0bf6052",20260339,2,0,1,1152,360,360,0
"cb5fc7ef85d547c4be1a7439d0bf6052","0a8f150a4cf747acbde62f4721823da3",20260339,1,1,0,1154,360,361,1
"0a8f150a4cf747acbde62f4721823da3","0a8f150a4cf747acbde62f4721823da3",20260339,2,0,1,1155,361,361,0
"0a8f150a4cf747acbde62f4721823da3","ab8fdad974ae471f9f24c3f9dd04462e",20260339,1,1,0,1157,361,362,1
"ab8fdad974ae471f9f24c3f9dd04462e","ab8fdad974ae471f9f24c3f9dd04462e",20260339,2,0,1,1158,362,362,0
"ab8fdad974ae471f9f24c3f9dd04462e","1ba8fef685d74a8194b9db252eb704fb",20260339,1,-7,0,1160,362,355,-7
"1ba8fef685d74a8194b9db252eb704fb","52580888dadb4fe3baa795683ea227bd",20260339,1,10,0,1161,355,364,9
"52580888dadb4fe3baa795683ea227bd","52580888dadb4fe3baa795683ea227bd",20260339,1,0,1,1162,364,364,0
"52580888dadb4fe3baa795683ea227bd","f00179e251a045b39c3f7a54f9aa4acc",20260339,1,-1,0,1163,364,363,-1
"f00179e251a045b39c3f7a54f9aa4acc","492a3bc6a1254f23a7998587961b22a4",20260339,1,4,0,1164,363,366,3
"492a3bc6a1254f23a7998587961b22a4","492a3bc6a1254f23a7998587961b22a4",20260339,1,0,1,1165,366,366,0
"492a3bc6a1254f23a7998587961b22a4","072a190fd302456290895f9f04d6940a",20260339,1,-1,0,1166,366,365,-1
"072a190fd302456290895f9f04d6940a","1ba8fef685d74a8194b9db252eb704fb",20260339,1,-12,0,1167,365,355,-10
"1ba8fef685d74a8194b9db252eb704fb","30ead9794d4847abaf222ca966cc8630",20260339,1,-8,0,1168,355,348,-7
"2fe14166dc9642c3bc666b86a57f943d","cfa457d1743848e4bb5e4beced6448ed",20260339,1,15,0,1170,357,369,12
"cfa457d1743848e4bb5e4beced6448ed","cfa457d1743848e4bb5e4beced6448ed",20260339,1,0,1,1171,369,369,0
"cfa457d1743848e4bb5e4beced6448ed","30ead9794d4847abaf222ca966cc8630",20260339,1,-25,0,1172,369,348,-21
"30ead9794d4847abaf222ca966cc8630","b71bac264efb4abd97015447bd490db6",20260339,1,28,0,1173,348,370,22
"8d448d625b024c82a5eb240bbd7431d6","fc0771786a1e405986933843fdfd7eda",20260339,1,-3,0,1183,374,372,-2
"fc0771786a1e405986933843fdfd7eda","b71bac264efb4abd97015447bd490db6",20260339,1,-2,0,1184,372,370,-2
"8d448d625b024c82a5eb240bbd7431d6","d6d02b6ef04e4f17805504500b8ce441",20260339,2,3,0,1237,374,375,1
"d6d02b6ef04e4f17805504500b8ce441","b71bac264efb4abd97015447bd490db6",20260339,2,-8,0,1238,375,370,-5
"b71bac264efb4abd97015447bd490db6","d6d02b6ef04e4f17805504500b8ce441",20260339,2,8,0,1239,370,375,5
"d6d02b6ef04e4f17805504500b8ce441","d6d02b6ef04e4f17805504500b8ce441",20260339,2,0,1,1240,375,375,0
"d6d02b6ef04e4f17805504500b8ce441","66baf19b6b904b70922329068c63746d",20260339,2,4,0,1241,375,376,1
"66baf19b6b904b70922329068c63746d","7f544639412e40a9ba27f43b415362ab",20260339,2,2,0,1242,376,378,2
"7f544639412e40a9ba27f43b415362ab","1b4550d0dab04078b3bf08a655345bdc",20260339,1,-10,0,1243,378,373,-5
"7f544639412e40a9ba27f43b415362ab","7f544639412e40a9ba27f43b415362ab",20260339,1,0,1,1270,378,378,0
"7f544639412e40a9ba27f43b415362ab","d5ae8642e15b46b8bd298b02274d4e9c",20260339,1,2,0,1271,378,380,2
"d5ae8642e15b46b8bd298b02274d4e9c","d5ae8642e15b46b8bd298b02274d4e9c",20260339,1,0,1,1272,380,380,0
"d5ae8642e15b46b8bd298b02274d4e9c","a0d10309a2dd456289147f84be9d37f9",20260339,1,1,0,1273,380,381,1
"a0d10309a2dd456289147f84be9d37f9","a0d10309a2dd456289147f84be9d37f9",20260339,2,0,1,1274,381,381,0
"a0d10309a2dd456289147f84be9d37f9","0fcbc3ca07b144138b8d85da581f09a8",20260339,1,1,0,1276,381,382,1
"0fcbc3ca07b144138b8d85da581f09a8","0fcbc3ca07b144138b8d85da581f09a8",20260339,2,0,1,1277,382,382,0
"0fcbc3ca07b144138b8d85da581f09a8","66baf19b6b904b70922329068c63746d",20260339,1,-6,0,1279,382,376,-6
"66baf19b6b904b70922329068c63746d","c2fca3669923477ab966ded303dea31c",20260339,1,8,0,1280,376,383,7
"c2fca3669923477ab966ded303dea31c","4890121ce5d74576b4632b77cfc23398",20260339,1,6,0,1281,383,388,5
"4890121ce5d74576b4632b77cfc23398","4890121ce5d74576b4632b77cfc23398",20260339,1,0,1,1282,388,388,0
"4890121ce5d74576b4632b77cfc23398","18d3b836dd804224883cc9180b60a8e1",20260339,1,-1,0,1283,388,387,-1
"18d3b836dd804224883cc9180b60a8e1","96bb2b3e85a34d8b9544514e89f6fe97",20260339,1,4,0,1284,387,390,3
"96bb2b3e85a34d8b9544514e89f6fe97","96bb2b3e85a34d8b9544514e89f6fe97",20260339,1,0,1,1285,390,390,0
"96bb2b3e85a34d8b9544514e89f6fe97","ac4e9b54acfe4670b4634859c7263cb5",20260339,1,2,0,1286,390,392,2
"ac4e9b54acfe4670b4634859c7263cb5","ac4e9b54acfe4670b4634859c7263cb5",20260339,1,0,1,1287,392,392,0
"ac4e9b54acfe4670b4634859c7263cb5","17f95d18bab743888e1736033dc3384d",20260339,1,-3,0,1288,392,389,-3
"17f95d18bab743888e1736033dc3384d","6f8881a745ac4c358a68b92c3b4abe81",20260339,1,6,0,1289,389,394,5
"6f8881a745ac4c358a68b92c3b4abe81","6f8881a745ac4c358a68b92c3b4abe81",20260339,1,0,1,1290,394,394,0
"6f8881a745ac4c358a68b92c3b4abe81","f7002c8484354eceac57bc7bd62c76c1",20260339,2,-1,0,1291,394,393,-1
"f7002c8484354eceac57bc7bd62c76c1","44a277ea44dc4ae689fab4b82f0b4098",20260339,2,5,0,1292,393,397,4
"44a277ea44dc4ae689fab4b82f0b4098","7f544639412e40a9ba27f43b415362ab",20260339,1,-24,0,1293,397,378,-19
"7f544639412e40a9ba27f43b415362ab","0c12af0a4e7f4002852cf84b2537c161",20260339,1,22,0,1294,378,395,17
"0c12af0a4e7f4002852cf84b2537c161","66baf19b6b904b70922329068c63746d",20260339,1,-24,0,1295,395,376,-19
"66baf19b6b904b70922329068c63746d","4890121ce5d74576b4632b77cfc23398",20260339,1,14,0,1296,376,388,12
"4890121ce5d74576b4632b77cfc23398","c2fca3669923477ab966ded303dea31c",20260339,1,-6,0,1297,388,383,-5
"c2fca3669923477ab966ded303dea31c","18d3b836dd804224883cc9180b60a8e1",20260339,1,5,0,1298,383,387,4
"18d3b836dd804224883cc9180b60a8e1","7f544639412e40a9ba27f43b415362ab",20260339,1,-11,0,1299,387,378,-9
"7f544639412e40a9ba27f43b415362ab","66baf19b6b904b70922329068c63746d",20260339,1,-2,0,1300,378,376,-2
"66baf19b6b904b70922329068c63746d","6f8881a745ac4c358a68b92c3b4abe81",20260339,1,22,0,1301,376,394,18
"f7002c8484354eceac57bc7bd62c76c1","6f8881a745ac4c358a68b92c3b4abe81",20260339,1,1,0,1303,393,394,1
"6f8881a745ac4c358a68b92c3b4abe81","0c12af0a4e7f4002852cf84b2537c161",20260339,1,2,0,1304,394,395,1
"0c12af0a4e7f4002852cf84b2537c161","f7002c8484354eceac57bc7bd62c76c1",20260339,1,-3,0,1305,395,393,-2
"44a277ea44dc4ae689fab4b82f0b4098","44a277ea44dc4ae689fab4b82f0b4098",20260339,1,0,1,1307,397,397,0
"44a277ea44dc4ae689fab4b82f0b4098","0c12af0a4e7f4002852cf84b2537c161",20260339,1,-2,0,1308,397,395,-2
"0c12af0a4e7f4002852cf84b2537c161","859e0b8d71694b12befb69ee698138f9",20260339,1,5,0,1309,395,399,4
"859e0b8d71694b12befb69ee698138f9","859e0b8d71694b12befb69ee698138f9",20260339,1,0,1,1310,399,399,0
"859e0b8d71694b12befb69ee698138f9","66baf19b6b904b70922329068c63746d",20260339,1,-29,0,1311,399,376,-23
"66baf19b6b904b70922329068c63746d","2b09a08242b54983aec7063990fb3f66",20260339,1,32,0,1312,376,400,24
"2b09a08242b54983aec7063990fb3f66","2b09a08242b54983aec7063990fb3f66",20260339,4,0,1,1313,400,400,0
"2b09a08242b54983aec7063990fb3f66","1f471b7a883a4df48211e8c6a81b59a7",20260339,1,1,0,1315,400,401,1
"1f471b7a883a4df48211e8c6a81b59a7","1f471b7a883a4df48211e8c6a81b59a7",20260339,1,0,1,1316,401,401,0
"1f471b7a883a4df48211e8c6a81b59a7","2b09a08242b54983aec7063990fb3f66",20260339,1,-1,0,1317,401,400,-1
"2b09a08242b54983aec7063990fb3f66","9de0d567bfa84fe5b77cb76f4a76a5d1",20260339,1,5,0,1318,400,404,4
"9de0d567bfa84fe5b77cb76f4a76a5d1","9de0d567bfa84fe5b77cb76f4a76a5d1",20260339,1,0,1,1319,404,404,0
"9de0d567bfa84fe5b77cb76f4a76a5d1","1157bd665ec4472fb58b751dc5099355",20260339,1,-1,0,1320,404,403,-1
"1157bd665ec4472fb58b751dc5099355","2b09a08242b54983aec7063990fb3f66",20260339,1,-4,0,1321,403,400,-3
"2b09a08242b54983aec7063990fb3f66","58fc9094275e4c49be3f4ba6d4acc0a4",20260339,1,9,0,1322,400,406,6
"58fc9094275e4c49be3f4ba6d4acc0a4","3c8a22d2f9c146ea956609e3ed4f2559",20260339,1,-2,0,1323,406,405,-1
"3c8a22d2f9c146ea956609e3ed4f2559","58fc9094275e4c49be3f4ba6d4acc0a4",20260339,1,2,0,1324,405,406,1
"58fc9094275e4c49be3f4ba6d4acc0a4","c1c1be90b2b14c1ab4a5e1ee3c241902",20260339,1,1,0,1325,406,407,1
"c1c1be90b2b14c1ab4a5e1ee3c241902","c1c1be90b2b14c1ab4a5e1ee3c241902",20260339,5,0,1,1326,407,407,0
"c1c1be90b2b14c1ab4a5e1ee3c241902","58fc9094275e4c49be3f4ba6d4acc0a4",20260339,1,-1,0,1331,407,406,-1
"58fc9094275e4c49be3f4ba6d4acc0a4","02b3a1bead9244c1ba2f857c7da8f82a",20260339,1,3,0,1332,406,408,2
"02b3a1bead9244c1ba2f857c7da8f82a","02b3a1bead9244c1ba2f857c7da8f82a",20260339,4,0,1,1333,408,408,0
"02b3a1bead9244c1ba2f857c7da8f82a","6206fc6479014bb193084c32409dc1b9",20260339,1,1,0,1334,408,409,1
"6206fc6479014bb193084c32409dc1b9","6206fc6479014bb193084c32409dc1b9",20260339,1,0,1,1335,409,409,0
"6206fc6479014bb193084c32409dc1b9","02b3a1bead9244c1ba2f857c7da8f82a",20260339,1,-1,0,1336,409,408,-1
"02b3a1bead9244c1ba2f857c7da8f82a","6a5f020451db426dacba9e2ea3fcc62a",20260339,2,3,0,1337,408,410,2
"6a5f020451db426dacba9e2ea3fcc62a","6a5f020451db426dacba9e2ea3fcc62a",20260339,4,0,1,1338,410,410,0
"6a5f020451db426dacba9e2ea3fcc62a","33a9d248b2e44588a5b07fc1342b9bc2",20260339,2,2,0,1340,410,411,1
"33a9d248b2e44588a5b07fc1342b9bc2","2b09a08242b54983aec7063990fb3f66",20260339,1,-17,0,1341,411,400,-11
"2b09a08242b54983aec7063990fb3f66","6a5f020451db426dacba9e2ea3fcc62a",20260339,1,15,0,1342,400,410,10
"33a9d248b2e44588a5b07fc1342b9bc2","33a9d248b2e44588a5b07fc1342b9bc2",20260339,4,0,1,1346,411,411,0
"33a9d248b2e44588a5b07fc1342b9bc2","c6f26bd420634f1cb7989e76fe6b16c0",20260339,1,1,0,1350,411,412,1
"c6f26bd420634f1cb7989e76fe6b16c0","c6f26bd420634f1cb7989e76fe6b16c0",20260339,5,0,1,1351,412,412,0
"c6f26bd420634f1cb7989e76fe6b16c0","2a65ee6e2ac64f6a8a55fbe5373ec763",20260339,1,1,0,1356,412,413,1
"2a65ee6e2ac64f6a8a55fbe5373ec763","2a65ee6e2ac64f6a8a55fbe5373ec763",20260339,2,0,1,1357,413,413,0
"2a65ee6e2ac64f6a8a55fbe5373ec763","33a9d248b2e44588a5b07fc1342b9bc2",20260339,1,-2,0,1359,413,411,-2
"33a9d248b2e44588a5b07fc1342b9bc2","1fd0f6dadbc14ebc965faf6122190b96",20260339,1,5,0,1360,411,415,4
"1fd0f6dadbc14ebc965faf6122190b96","1fd0f6dadbc14ebc965faf6122190b96",20260339,1,0,1,1361,415,415,0
"1fd0f6dadbc14ebc965faf6122190b96","687055dad9fc40c3982478fe33ec01bf",20260339,1,-1,0,1362,415,414,-1
"687055dad9fc40c3982478fe33ec01bf","2add1669f08d4101913db15f8c23b3b7",20260339,1,3,0,1363,414,416,2
"2add1669f08d4101913db15f8c23b3b7","2b09a08242b54983aec7063990fb3f66",20260339,1,-24,0,1364,416,400,-16
"2b09a08242b54983aec7063990fb3f66","1157bd665ec4472fb58b751dc5099355",20260339,1,4,0,1366,400,403,3
"1157bd665ec4472fb58b751dc5099355","3c8a22d2f9c146ea956609e3ed4f2559",20260339,1,3,0,1367,403,405,2
"3c8a22d2f9c146ea956609e3ed4f2559","2add1669f08d4101913db15f8c23b3b7",20260339,1,17,0,1368,405,416,11
"2add1669f08d4101913db15f8c23b3b7","2add1669f08d4101913db15f8c23b3b7",20260339,1,0,1,1369,416,416,0
"2add1669f08d4101913db15f8c23b3b7","a2b4bd40cee2481ebd3fc179d6a5cd62",20260339,1,3,0,1370,416,417,1
"a2b4bd40cee2481ebd3fc179d6a5cd62","2b09a08242b54983aec7063990fb3f66",20260339,2,-27,0,1371,417,400,-17
"2b09a08242b54983aec7063990fb3f66","a2b4bd40cee2481ebd3fc179d6a5cd62",20260339,2,27,0,1372,400,417,17
"a2b4bd40cee2481ebd3fc179d6a5cd62","e34e59dce2204f228f3a84b6725df60f",20260339,1,2,0,1373,417,419,2
"e34e59dce2204f228f3a84b6725df60f","e34e59dce2204f228f3a84b6725df60f",20260339,1,0,1,1374,419,419,0
"e34e59dce2204f228f3a84b6725df60f","bec48fc2e1294c7eb3d0aca780d731b8",20260339,1,2,0,1375,419,420,1
"bec48fc2e1294c7eb3d0aca780d731b8","a2b4bd40cee2481ebd3fc179d6a5cd62",20260339,1,-4,0,1376,420,417,-3
"a2b4bd40cee2481ebd3fc179d6a5cd62","bec48fc2e1294c7eb3d0aca780d731b8",20260339,1,4,0,1377,417,420,3
"bec48fc2e1294c7eb3d0aca780d731b8","bec48fc2e1294c7eb3d0aca780d731b8",20260339,2,0,1,1378,420,420,0
"bec48fc2e1294c7eb3d0aca780d731b8","dbde19fcce2a4c1abdc7f685c293a23f",20260339,1,3,0,1379,420,422,2
"dbde19fcce2a4c1abdc7f685c293a23f","a24600b0e49245f6bdba8c893cfeddb0",20260339,1,4,0,1380,422,425,3
"a24600b0e49245f6bdba8c893cfeddb0","a24600b0e49245f6bdba8c893cfeddb0",20260339,3,0,1,1381,425,425,0
"a24600b0e49245f6bdba8c893cfeddb0","5d290f75e44b4bdb8256c600debbb44d",20260339,1,2,0,1383,425,426,1
"5d290f75e44b4bdb8256c600debbb44d","bec48fc2e1294c7eb3d0aca780d731b8",20260339,1,-9,0,1384,426,420,-6
"bec48fc2e1294c7eb3d0aca780d731b8","a24600b0e49245f6bdba8c893cfeddb0",20260339,1,7,0,1386,420,425,5
"a24600b0e49245f6bdba8c893cfeddb0","a2b4bd40cee2481ebd3fc179d6a5cd62",20260339,1,-11,0,1388,425,417,-8
"a2b4bd40cee2481ebd3fc179d6a5cd62","24cf8786024543f19b89bc20034e60d7",20260339,1,18,0,1389,417,428,11
"24cf8786024543f19b89bc20034e60d7","f2a73be2f46840b182d7bd095378004e",20260339,1,1,0,1390,428,429,1
"f2a73be2f46840b182d7bd095378004e","f2a73be2f46840b182d7bd095378004e",20260339,1,0,1,1391,429,429,0
"f2a73be2f46840b182d7bd095378004e","604551fd4266430cb860fef58fa7dd61",20260339,1,1,0,1392,429,430,1
"604551fd4266430cb860fef58fa7dd61","604551fd4266430cb860fef58fa7dd61",20260339,7,0,1,1393,430,430,0
"604551fd4266430cb860fef58fa7dd61","dce46f8904594a62a6377a3587aaa663",20260339,1,2,0,1400,430,431,1
"dce46f8904594a62a6377a3587aaa663","24cf8786024543f19b89bc20034e60d7",20260339,1,-4,0,1401,431,428,-3
"24cf8786024543f19b89bc20034e60d7","dce46f8904594a62a6377a3587aaa663",20260339,1,4,0,1402,428,431,3
"dce46f8904594a62a6377a3587aaa663","dce46f8904594a62a6377a3587aaa663",20260339,1,0,1,1403,431,431,0
"dce46f8904594a62a6377a3587aaa663","9b9d0a249052413c869753b99682b0ac",20260339,1,1,0,1404,431,432,1
"9b9d0a249052413c869753b99682b0ac","9b9d0a249052413c869753b99682b0ac",20260339,1,0,1,1405,432,432,0
"9b9d0a249052413c869753b99682b0ac","061c175cc90f45fbad883025394e78dd",20260339,1,1,0,1406,432,433,1
"061c175cc90f45fbad883025394e78dd","061c175cc90f45fbad883025394e78dd",20260339,4,0,1,1407,433,433,0
"061c175cc90f45fbad883025394e78dd","dce46f8904594a62a6377a3587aaa663",20260339,1,-2,0,1411,433,431,-2
"dce46f8904594a62a6377a3587aaa663","74a7f8712e5449c2bc0b43c6f90dafed",20260339,1,5,0,1412,431,435,4
"74a7f8712e5449c2bc0b43c6f90dafed","74a7f8712e5449c2bc0b43c6f90dafed",20260339,1,0,1,1413,435,435,0
"74a7f8712e5449c2bc0b43c6f90dafed","66ada10dde9f43018588f1ced9d477fc",20260339,1,-1,0,1414,435,434,-1
"66ada10dde9f43018588f1ced9d477fc","bf12c96466d840a69bed7020b3f18bb8",20260339,1,3,0,1415,434,436,2
"bf12c96466d840a69bed7020b3f18bb8","bf12c96466d840a69bed7020b3f18bb8",20260339,1,0,1,1416,436,436,0
"bf12c96466d840a69bed7020b3f18bb8","24cf8786024543f19b89bc20034e60d7",20260339,1,-11,0,1417,436,428,-8
"24cf8786024543f19b89bc20034e60d7","070600601c4c439288445d2f0724807d",20260339,1,14,0,1418,428,437,9
"070600601c4c439288445d2f0724807d","1823b6de7d334a7aaabc4570719af4d9",20260339,1,2,0,1419,437,439,2
"1823b6de7d334a7aaabc4570719af4d9","1823b6de7d334a7aaabc4570719af4d9",20260339,11,0,1,1420,439,439,0
"1823b6de7d334a7aaabc4570719af4d9","0380cd76a7d44bc3a4da1f15e4d68f89",20260339,1,2,0,1431,439,440,1
"0380cd76a7d44bc3a4da1f15e4d68f89","070600601c4c439288445d2f0724807d",20260339,1,-4,0,1432,440,437,-3
"070600601c4c439288445d2f0724807d","0380cd76a7d44bc3a4da1f15e4d68f89",20260339,1,4,0,1433,437,440,3
"0380cd76a7d44bc3a4da1f15e4d68f89","0380cd76a7d44bc3a4da1f15e4d68f89",20260339,1,0,1,1434,440,440,0
"0380cd76a7d44bc3a4da1f15e4d68f89","23b7673c8b5443108c2ef09382834a86",20260339,1,2,0,1435,440,441,1
"23b7673c8b5443108c2ef09382834a86","23b7673c8b5443108c2ef09382834a86",20260339,23,0,1,1436,441,441,0
"23b7673c8b5443108c2ef09382834a86","901e92500aea43c79f19f1b279050668",20260339,1,2,0,1438,441,442,1
"901e92500aea43c79f19f1b279050668","901e92500aea43c79f19f1b279050668",20260339,1,0,1,1439,442,442,0
"901e92500aea43c79f19f1b279050668","001339db8ced4cf78829ebe8b145449d",20260339,1,1,0,1440,442,443,1
"001339db8ced4cf78829ebe8b145449d","001339db8ced4cf78829ebe8b145449d",20260339,5,0,1,1441,443,443,0
"001339db8ced4cf78829ebe8b145449d","452745e0366e42ae81561bfddebcc6c3",20260339,1,1,0,1446,443,444,1
"452745e0366e42ae81561bfddebcc6c3","452745e0366e42ae81561bfddebcc6c3",20260339,2,0,1,1447,444,444,0
"452745e0366e42ae81561bfddebcc6c3","901e92500aea43c79f19f1b279050668",20260339,1,-2,0,1449,444,442,-2
"901e92500aea43c79f19f1b279050668","4660ff2089114e8db82ceb26a4f329e3",20260339,1,4,0,1450,442,445,3
"4660ff2089114e8db82ceb26a4f329e3","4660ff2089114e8db82ceb26a4f329e3",20260339,2,0,1,1451,445,445,0
"4660ff2089114e8db82ceb26a4f329e3","7bd5586eb9d8484eb74a433ee7bfe499",20260339,1,2,0,1453,445,446,1
"7bd5586eb9d8484eb74a433ee7bfe499","7bd5586eb9d8484eb74a433ee7bfe499",20260339,13,0,1,1454,446,446,0
"7bd5586eb9d8484eb74a433ee7bfe499","8a7f26e690f34dda97be16904518ca99",20260339,1,2,0,1467,446,447,1
"8a7f26e690f34dda97be16904518ca99","8a7f26e690f34dda97be16904518ca99",20260339,1,0,1,1468,447,447,0
"8a7f26e690f34dda97be16904518ca99","b2f0d654738f48158edff28e8d3a546e",20260339,1,5,0,1469,447,449,2
"b2f0d654738f48158edff28e8d3a546e","070600601c4c439288445d2f0724807d",20260339,1,-21,0,1470,449,437,-12
"070600601c4c439288445d2f0724807d","f60ee41ec635499abd48168342d32c2f",20260339,1,26,0,1471,437,453,16
"f60ee41ec635499abd48168342d32c2f","f60ee41ec635499abd48168342d32c2f",20260339,71,0,1,1472,453,453,0
"f60ee41ec635499abd48168342d32c2f","b2f0d654738f48158edff28e8d3a546e",20260339,5,-5,0,1478,453,449,-4
"b2f0d654738f48158edff28e8d3a546e","f60ee41ec635499abd48168342d32c2f",20260339,5,5,0,1479,449,453,4
"f60ee41ec635499abd48168342d32c2f","9428d8bd9c5a47b2a235b254e5e27ded",20260339,1,-1,0,1502,453,452,-1
"9428d8bd9c5a47b2a235b254e5e27ded","f60ee41ec635499abd48168342d32c2f",20260339,1,1,0,1503,452,453,1
"b2f0d654738f48158edff28e8d3a546e","f67fbf45a5f146ed866965bc57c7c001",20260339,1,8,0,1545,449,454,5
"f67fbf45a5f146ed866965bc57c7c001","f67fbf45a5f146ed866965bc57c7c001",20260339,5,0,1,1546,454,454,0
"f67fbf45a5f146ed866965bc57c7c001","d937afe49bd24a07a550dda1c1155122",20260339,1,1,0,1550,454,455,1
"d937afe49bd24a07a550dda1c1155122","d937afe49bd24a07a550dda1c1155122",20260339,5,0,1,1551,455,455,0
"d937afe49bd24a07a550dda1c1155122","3628b3f7823443d0912a339096b69943",20260339,1,1,0,1556,455,456,1
"3628b3f7823443d0912a339096b69943","3628b3f7823443d0912a339096b69943",20260339,1,0,1,1557,456,456,0
"3628b3f7823443d0912a339096b69943","9e049ee647cf43ecbcb5ed792a8e7588",20260339,1,1,0,1558,456,457,1
"9e049ee647cf43ecbcb5ed792a8e7588","9e049ee647cf43ecbcb5ed792a8e7588",20260339,1,0,1,1559,457,457,0
"9e049ee647cf43ecbcb5ed792a8e7588","5256a214faaf410b93f76cea06428334",20260339,1,1,0,1560,457,458,1
"5256a214faaf410b93f76cea06428334","5256a214faaf410b93f76cea06428334",20260339,1,0,1,1561,458,458,0
"5256a214faaf410b93f76cea06428334","25c32b120fce40fa9b6c85133aeb4716",20260339,1,1,0,1562,458,459,1
"25c32b120fce40fa9b6c85133aeb4716","25c32b120fce40fa9b6c85133aeb4716",20260339,5,0,1,1563,459,459,0
"25c32b120fce40fa9b6c85133aeb4716","f67fbf45a5f146ed866965bc57c7c001",20260339,1,-5,0,1564,459,454,-5
"f67fbf45a5f146ed866965bc57c7c001","9428d8bd9c5a47b2a235b254e5e27ded",20260339,1,-4,0,1566,454,452,-2
"9428d8bd9c5a47b2a235b254e5e27ded","b2f0d654738f48158edff28e8d3a546e",20260339,1,-4,0,1567,452,449,-3
"f60ee41ec635499abd48168342d32c2f","f67fbf45a5f146ed866965bc57c7c001",20260339,1,3,0,1578,453,454,1
"f67fbf45a5f146ed866965bc57c7c001","b2f0d654738f48158edff28e8d3a546e",20260339,1,-8,0,1579,454,449,-5
"b2f0d654738f48158edff28e8d3a546e","25c32b120fce40fa9b6c85133aeb4716",20260339,1,13,0,1580,449,459,10
"25c32b120fce40fa9b6c85133aeb4716","11bc14f2204949008b7d511b933363c1",20260339,1,1,0,1585,459,460,1
"11bc14f2204949008b7d511b933363c1","11bc14f2204949008b7d511b933363c1",20260339,6,0,1,1586,460,460,0
"11bc14f2204949008b7d511b933363c1","42de338840a34d15adb66e7b14fb9d2c",20260339,1,1,0,1592,460,461,1
"42de338840a34d15adb66e7b14fb9d2c","42de338840a34d15adb66e7b14fb9d2c",20260339,1,0,1,1593,461,461,0
"42de338840a34d15adb66e7b14fb9d2c","9da37c6210b1416b8079c274f70bf600",20260339,1,1,0,1594,461,462,1
"9da37c6210b1416b8079c274f70bf600","9da37c6210b1416b8079c274f70bf600",20260339,3,0,1,1595,462,462,0
"9da37c6210b1416b8079c274f70bf600","519119f1deac45ff9ab4f13529be5c6e",20260339,1,1,0,1598,462,463,1
"519119f1deac45ff9ab4f13529be5c6e","519119f1deac45ff9ab4f13529be5c6e",20260339,3,0,1,1599,463,463,0
"519119f1deac45ff9ab4f13529be5c6e","f67fbf45a5f146ed866965bc57c7c001",20260339,1,-9,0,1602,463,454,-9
"f67fbf45a5f146ed866965bc57c7c001","c5df9f40ec14463b9dcfdc73df3e9285",20260339,1,12,0,1603,454,464,10
"c5df9f40ec14463b9dcfdc73df3e9285","c5df9f40ec14463b9dcfdc73df3e9285",20260339,2,0,1,1604,464,464,0
"c5df9f40ec14463b9dcfdc73df3e9285","83d42d95cd844fc093fc09cee250edb8",20260339,1,3,0,1606,464,465,1
"83d42d95cd844fc093fc09cee250edb8","83d42d95cd844fc093fc09cee250edb8",20260339,8,0,1,1607,465,465,0
"83d42d95cd844fc093fc09cee250edb8","a2b4bd40cee2481ebd3fc179d6a5cd62",20260339,1,-76,0,1612,465,417,-48
"a2b4bd40cee2481ebd3fc179d6a5cd62","a2b4bd40cee2481ebd3fc179d6a5cd62",20260339,2,0,1,1613,417,417,0
"a2b4bd40cee2481ebd3fc179d6a5cd62","02b3a1bead9244c1ba2f857c7da8f82a",20260339,1,-15,0,1618,417,408,-9
"02b3a1bead9244c1ba2f857c7da8f82a","2b09a08242b54983aec7063990fb3f66",20260339,1,-12,0,1619,408,400,-8
"2b09a08242b54983aec7063990fb3f66","02b3a1bead9244c1ba2f857c7da8f82a",20260339,1,12,0,1620,400,408,8
"6a5f020451db426dacba9e2ea3fcc62a","83d42d95cd844fc093fc09cee250edb8",20260339,1,88,0,1625,410,465,55
"83d42d95cd844fc093fc09cee250edb8","070600601c4c439288445d2f0724807d",20260339,1,-44,0,1629,465,437,-28
"070600601c4c439288445d2f0724807d","070600601c4c439288445d2f0724807d",20260339,1,0,1,1630,437,437,0
"070600601c4c439288445d2f0724807d","23b7673c8b5443108c2ef09382834a86",20260339,4,6,0,1631,437,441,4
"23b7673c8b5443108c2ef09382834a86","070600601c4c439288445d2f0724807d",20260339,3,-6,0,1634,441,437,-4
"b613861cecf84ffcab01afb23f660475","b613861cecf84ffcab01afb23f660475",22071696,10,0,1,1,1,1,0
"b613861cecf84ffcab01afb23f660475","e2911e79efc2420eac45d9f671463d4b",22071696,1,3,0,11,1,2,1
"e2911e79efc2420eac45d9f671463d4b","e2911e79efc2420eac45d9f671463d4b",22071696,2,0,1,12,2,2,0
"e2911e79efc2420eac45d9f671463d4b","519d1b8c59404d67b54e96c5c8a830b2",22071696,1,1,0,14,2,3,1
"519d1b8c59404d67b54e96c5c8a830b2","519d1b8c59404d67b54e96c5c8a830b2",22071696,1,0,1,15,3,3,0
"519d1b8c59404d67b54e96c5c8a830b2","531db53f81f646edb0cdcfe0085b03b7",22071696,1,1,0,16,3,4,1
"531db53f81f646edb0cdcfe0085b03b7","531db53f81f646edb0cdcfe0085b03b7",22071696,1,0,1,17,4,4,0
"531db53f81f646edb0cdcfe0085b03b7","4f5f94b2f95141e0a9d53a61da2276da",22071696,1,1,0,18,4,5,1
"4f5f94b2f95141e0a9d53a61da2276da","4f5f94b2f95141e0a9d53a61da2276da",22071696,2,0,1,19,5,5,0
"4f5f94b2f95141e0a9d53a61da2276da","6d541c89590949f99af293c4f2333f67",22071696,1,1,0,21,5,6,1
"6d541c89590949f99af293c4f2333f67","6d541c89590949f99af293c4f2333f67",22071696,1,0,1,22,6,6,0
"6d541c89590949f99af293c4f2333f67","dd5cf0b9fe4c4f1d8f5ff8e4c04879cb",22071696,1,1,0,23,6,7,1
"dd5cf0b9fe4c4f1d8f5ff8e4c04879cb","dd5cf0b9fe4c4f1d8f5ff8e4c04879cb",22071696,1,0,1,24,7,7,0
"dd5cf0b9fe4c4f1d8f5ff8e4c04879cb","f96261861edc426abe2248be4f0a709a",22071696,1,1,0,25,7,8,1
"f96261861edc426abe2248be4f0a709a","f96261861edc426abe2248be4f0a709a",22071696,1,0,1,26,8,8,0
"f96261861edc426abe2248be4f0a709a","66b5e16f4f75454fb5b8172079f0fa83",22071696,1,1,0,27,8,9,1
"66b5e16f4f75454fb5b8172079f0fa83","66b5e16f4f75454fb5b8172079f0fa83",22071696,1,0,1,28,9,9,0
"66b5e16f4f75454fb5b8172079f0fa83","0680571d4698477995e41842c36a54b2",22071696,1,1,0,29,9,10,1
"0680571d4698477995e41842c36a54b2","0680571d4698477995e41842c36a54b2",22071696,1,0,1,30,10,10,0
"0680571d4698477995e41842c36a54b2","9112f2bffece48e08c6d2287be204085",22071696,1,1,0,31,10,11,1
"9112f2bffece48e08c6d2287be204085","9112f2bffece48e08c6d2287be204085",22071696,1,0,1,32,11,11,0
"9112f2bffece48e08c6d2287be204085","56586aa865414f538729c7f7735d2bc6",22071696,1,3,0,33,11,12,1
"56586aa865414f538729c7f7735d2bc6","e2911e79efc2420eac45d9f671463d4b",22071696,1,-12,0,34,12,2,-10
"e2911e79efc2420eac45d9f671463d4b","56586aa865414f538729c7f7735d2bc6",22071696,1,12,0,35,2,12,10
"56586aa865414f538729c7f7735d2bc6","56586aa865414f538729c7f7735d2bc6",22071696,2,0,1,36,12,12,0
"56586aa865414f538729c7f7735d2bc6","b7f2b31585d94eb3bf86376714aa7070",22071696,1,2,0,38,12,13,1
"b7f2b31585d94eb3bf86376714aa7070","b7f2b31585d94eb3bf86376714aa7070",22071696,2,0,1,39,13,13,0
"b7f2b31585d94eb3bf86376714aa7070","3f1c815879794b929260d224becaff7e",22071696,1,2,0,41,13,14,1
"3f1c815879794b929260d224becaff7e","81c864a886d54a6b8ff85f7d736f4f95",22071696,1,2,0,42,14,15,1
"81c864a886d54a6b8ff85f7d736f4f95","5c5ceeee4562457ba6d41515aeebfbb1",22071696,1,4,0,43,15,17,2
"5c5ceeee4562457ba6d41515aeebfbb1","5c5ceeee4562457ba6d41515aeebfbb1",22071696,1,0,1,44,17,17,0
"5c5ceeee4562457ba6d41515aeebfbb1","56586aa865414f538729c7f7735d2bc6",22071696,1,-10,0,45,17,12,-5
"56586aa865414f538729c7f7735d2bc6","9afd71a5298d4333b6849dfce1b9422c",22071696,1,13,0,46,12,18,6
"9afd71a5298d4333b6849dfce1b9422c","9afd71a5298d4333b6849dfce1b9422c",22071696,5,0,1,47,18,18,0
"9afd71a5298d4333b6849dfce1b9422c","b7719e26494940efa49512aedd0aac79",22071696,1,4,0,52,18,20,2
"b7719e26494940efa49512aedd0aac79","d4f45188d3c84a02ba08454e6403a818",22071696,3,5,0,53,20,24,4
"d4f45188d3c84a02ba08454e6403a818","d4c3b003e8274e429d2fa688d73fde6d",22071696,3,-2,0,54,24,22,-2
"d4c3b003e8274e429d2fa688d73fde6d","b7719e26494940efa49512aedd0aac79",22071696,3,-3,0,55,22,20,-2
"d4c3b003e8274e429d2fa688d73fde6d","d4c3b003e8274e429d2fa688d73fde6d",22071696,3,0,1,58,22,22,0
"b7719e26494940efa49512aedd0aac79","b7719e26494940efa49512aedd0aac79",22071696,2,0,1,62,20,20,0
"b7719e26494940efa49512aedd0aac79","a23ae40d7a9e4ee4828cc06415a3218c",22071696,1,9,0,63,20,27,7
"a23ae40d7a9e4ee4828cc06415a3218c","b7719e26494940efa49512aedd0aac79",22071696,1,-9,0,64,27,20,-7
"b7719e26494940efa49512aedd0aac79","afbf7250b99d47bea07172749483ca97",22071696,1,12,0,69,20,28,8
"afbf7250b99d47bea07172749483ca97","afbf7250b99d47bea07172749483ca97",22071696,1,0,1,70,28,28,0
"afbf7250b99d47bea07172749483ca97","4e51676dc72045d99c19b9fa7b22f8bc",22071696,1,3,0,71,28,29,1
"4e51676dc72045d99c19b9fa7b22f8bc","4e51676dc72045d99c19b9fa7b22f8bc",22071696,1,0,1,72,29,29,0
"4e51676dc72045d99c19b9fa7b22f8bc","51970cfa30e643e894e66ae85c8024cc",22071696,1,3,0,73,29,31,2
"51970cfa30e643e894e66ae85c8024cc","c33c17be71ae4d588da7369472e5bb1b",22071696,1,6,0,74,31,34,3
"c33c17be71ae4d588da7369472e5bb1b","4e51676dc72045d99c19b9fa7b22f8bc",22071696,1,-9,0,75,34,29,-5
"4e51676dc72045d99c19b9fa7b22f8bc","c33c17be71ae4d588da7369472e5bb1b",22071696,1,9,0,76,29,34,5
"c33c17be71ae4d588da7369472e5bb1b","93679be414554a11b1893002f2229a93",22071696,1,3,0,77,34,35,1
"93679be414554a11b1893002f2229a93","93679be414554a11b1893002f2229a93",22071696,1,0,1,78,35,35,0
"93679be414554a11b1893002f2229a93","7040a13096d746ac84b8fac8d9752058",22071696,1,3,0,79,35,36,1
"7040a13096d746ac84b8fac8d9752058","7040a13096d746ac84b8fac8d9752058",22071696,1,0,1,80,36,36,0
"7040a13096d746ac84b8fac8d9752058","9a0dc646f934470daf08c4b56ccf73db",22071696,1,3,0,81,36,37,1
"9a0dc646f934470daf08c4b56ccf73db","9a0dc646f934470daf08c4b56ccf73db",22071696,1,0,1,82,37,37,0
"9a0dc646f934470daf08c4b56ccf73db","fc0e049d56024bc9a02c9a9c435c3df7",22071696,1,3,0,83,37,38,1
"fc0e049d56024bc9a02c9a9c435c3df7","67a089198fcb4e1c8f2385786c2b296f",22071696,1,4,0,84,38,39,1
"67a089198fcb4e1c8f2385786c2b296f","fc0e049d56024bc9a02c9a9c435c3df7",22071696,1,-4,0,85,39,38,-1
"fc0e049d56024bc9a02c9a9c435c3df7","64d48c6c9c7940639a932219a6c87198",22071696,1,5,0,86,38,40,2
"64d48c6c9c7940639a932219a6c87198","67a089198fcb4e1c8f2385786c2b296f",22071696,1,-1,0,88,40,39,-1
"67a089198fcb4e1c8f2385786c2b296f","b534b89233134e30a9b5645138bfa9ee",22071696,1,4,0,89,39,41,2
"b534b89233134e30a9b5645138bfa9ee","0e37b720d23b4e7f8b313e79313fd107",22071696,1,3,0,90,41,44,3
"0e37b720d23b4e7f8b313e79313fd107","0e37b720d23b4e7f8b313e79313fd107",22071696,1,0,1,91,44,44,0
"0e37b720d23b4e7f8b313e79313fd107","6875d67fdd5f48168b62719df449bebd",22071696,1,1,0,92,44,45,1
"6875d67fdd5f48168b62719df449bebd","6875d67fdd5f48168b62719df449bebd",22071696,1,0,1,93,45,45,0
"6875d67fdd5f48168b62719df449bebd","b534b89233134e30a9b5645138bfa9ee",22071696,1,-4,0,94,45,41,-4
"6e13d61a7bdb44bca949c9f86fab3be5","6e13d61a7bdb44bca949c9f86fab3be5",22071696,3,0,1,96,47,47,0
"6e13d61a7bdb44bca949c9f86fab3be5","d9c8d8c444a64dadbbb508652c721e17",22071696,1,-1,0,99,47,46,-1
"d9c8d8c444a64dadbbb508652c721e17","d0c74f735e024943943e40333d6d337f",22071696,2,6,0,100,46,51,5
"d0c74f735e024943943e40333d6d337f","d0c74f735e024943943e40333d6d337f",22071696,3,0,1,101,51,51,0
"d0c74f735e024943943e40333d6d337f","f924752d8a1149668870b1e7698486f7",22071696,2,-1,0,104,51,50,-1
"f924752d8a1149668870b1e7698486f7","a1f2f12debe5432fb7a70bcd12bacfb9",22071696,2,9,0,105,50,58,8
"a1f2f12debe5432fb7a70bcd12bacfb9","78f30e4dcac84e3cbea8b2cc6e0d62b3",22071696,2,1,0,106,58,59,1
"78f30e4dcac84e3cbea8b2cc6e0d62b3","a1f2f12debe5432fb7a70bcd12bacfb9",22071696,1,-1,0,107,59,58,-1
"a1f2f12debe5432fb7a70bcd12bacfb9","a1f2f12debe5432fb7a70bcd12bacfb9",22071696,26,0,1,108,58,58,0
"78f30e4dcac84e3cbea8b2cc6e0d62b3","78f30e4dcac84e3cbea8b2cc6e0d62b3",22071696,21,0,1,135,59,59,0
"78f30e4dcac84e3cbea8b2cc6e0d62b3","a0a418b8540d479fa6e0f653b701da8b",22071696,2,6,0,156,59,64,5
"a0a418b8540d479fa6e0f653b701da8b","12aa6e1672ac4e7aa6449a7a8609cd72",22071696,1,-8,0,157,64,57,-7
"12aa6e1672ac4e7aa6449a7a8609cd72","bc42d26810654ea9a1df1efe1e58c7d5",22071696,2,7,0,158,57,63,6
"bc42d26810654ea9a1df1efe1e58c7d5","4c943503763e4e349906eea3ed3c8e86",22071696,1,-2,0,159,63,61,-2
"4c943503763e4e349906eea3ed3c8e86","4c943503763e4e349906eea3ed3c8e86",22071696,1,0,1,160,61,61,0
"4c943503763e4e349906eea3ed3c8e86","309ccf3cc4fe429d9bfbaef53d3fa479",22071696,1,-1,0,161,61,60,-1
"309ccf3cc4fe429d9bfbaef53d3fa479","d646286c8051419bbc2e31dd1db55ca8",22071696,1,10,0,162,60,67,7
"d646286c8051419bbc2e31dd1db55ca8","b534b89233134e30a9b5645138bfa9ee",22071696,3,-33,0,163,67,41,-26
"b534b89233134e30a9b5645138bfa9ee","267f883678b24aed855fde42524975d9",22071696,1,37,0,164,41,71,30
"267f883678b24aed855fde42524975d9","267f883678b24aed855fde42524975d9",22071696,1,0,1,165,71,71,0
"267f883678b24aed855fde42524975d9","88fff56d0342490dbef9040750a20f6c",22071696,1,1,0,166,71,72,1
"88fff56d0342490dbef9040750a20f6c","88fff56d0342490dbef9040750a20f6c",22071696,1,0,1,167,72,72,0
"88fff56d0342490dbef9040750a20f6c","adb17b12b66c4a49a85fd34322f7df70",22071696,1,1,0,168,72,73,1
"adb17b12b66c4a49a85fd34322f7df70","adb17b12b66c4a49a85fd34322f7df70",22071696,1,0,1,169,73,73,0
"adb17b12b66c4a49a85fd34322f7df70","a2becd407db34b189200a32546d9d569",22071696,1,3,0,170,73,75,2
"a2becd407db34b189200a32546d9d569","d646286c8051419bbc2e31dd1db55ca8",22071696,2,-9,0,171,75,67,-8
"d646286c8051419bbc2e31dd1db55ca8","67a089198fcb4e1c8f2385786c2b296f",22071696,1,-37,0,172,67,39,-28
"67a089198fcb4e1c8f2385786c2b296f","67a089198fcb4e1c8f2385786c2b296f",22071696,1,0,1,173,39,39,0
"67a089198fcb4e1c8f2385786c2b296f","64d48c6c9c7940639a932219a6c87198",22071696,1,1,0,174,39,40,1
"64d48c6c9c7940639a932219a6c87198","64d48c6c9c7940639a932219a6c87198",22071696,2,0,1,175,40,40,0
"64d48c6c9c7940639a932219a6c87198","b534b89233134e30a9b5645138bfa9ee",22071696,1,3,0,176,40,41,1
"b534b89233134e30a9b5645138bfa9ee","67a089198fcb4e1c8f2385786c2b296f",22071696,1,-4,0,177,41,39,-2
"67a089198fcb4e1c8f2385786c2b296f","6e13d61a7bdb44bca949c9f86fab3be5",22071696,1,11,0,178,39,47,8
"6e13d61a7bdb44bca949c9f86fab3be5","b534b89233134e30a9b5645138bfa9ee",22071696,1,-7,0,179,47,41,-6
"b534b89233134e30a9b5645138bfa9ee","d9c8d8c444a64dadbbb508652c721e17",22071696,1,6,0,180,41,46,5
"a1f2f12debe5432fb7a70bcd12bacfb9","12aa6e1672ac4e7aa6449a7a8609cd72",22071696,1,-1,0,184,58,57,-1
"bc42d26810654ea9a1df1efe1e58c7d5","78f30e4dcac84e3cbea8b2cc6e0d62b3",22071696,1,-5,0,186,63,59,-4
"a0a418b8540d479fa6e0f653b701da8b","309ccf3cc4fe429d9bfbaef53d3fa479",22071696,1,-4,0,188,64,60,-4
"309ccf3cc4fe429d9bfbaef53d3fa479","b534b89233134e30a9b5645138bfa9ee",22071696,1,-23,0,189,60,41,-19
"b534b89233134e30a9b5645138bfa9ee","d646286c8051419bbc2e31dd1db55ca8",22071696,4,33,0,190,41,67,26
"d646286c8051419bbc2e31dd1db55ca8","d646286c8051419bbc2e31dd1db55ca8",22071696,3,0,1,191,67,67,0
"d646286c8051419bbc2e31dd1db55ca8","a2becd407db34b189200a32546d9d569",22071696,2,9,0,196,67,75,8
"a2becd407db34b189200a32546d9d569","a2becd407db34b189200a32546d9d569",22071696,7,0,1,197,75,75,0
"a2becd407db34b189200a32546d9d569","d18a9ea32855445f8736581f5cb119ce",22071696,1,8,0,202,75,82,7
"d18a9ea32855445f8736581f5cb119ce","d646286c8051419bbc2e31dd1db55ca8",22071696,1,-17,0,203,82,67,-15
"d646286c8051419bbc2e31dd1db55ca8","d18a9ea32855445f8736581f5cb119ce",22071696,1,17,0,204,67,82,15
"d18a9ea32855445f8736581f5cb119ce","a2becd407db34b189200a32546d9d569",22071696,1,-8,0,205,82,75,-7
"a2becd407db34b189200a32546d9d569","140d5b27b8574befad82c0a013b59dfa",22071696,1,-1,0,208,75,74,-1
"140d5b27b8574befad82c0a013b59dfa","d18a9ea32855445f8736581f5cb119ce",22071696,2,9,0,209,74,82,8
"d18a9ea32855445f8736581f5cb119ce","f564483cbd7a407681aa2fcca518cf5f",22071696,1,4,0,210,82,85,3
"f564483cbd7a407681aa2fcca518cf5f","f564483cbd7a407681aa2fcca518cf5f",22071696,7,0,1,211,85,85,0
"f564483cbd7a407681aa2fcca518cf5f","d646286c8051419bbc2e31dd1db55ca8",22071696,1,-21,0,218,85,67,-18
"d646286c8051419bbc2e31dd1db55ca8","18fd01350bd5434ca636d59a599d768a",22071696,1,22,0,221,67,86,19
"18fd01350bd5434ca636d59a599d768a","18fd01350bd5434ca636d59a599d768a",22071696,5,0,1,222,86,86,0
"18fd01350bd5434ca636d59a599d768a","ae5ac430ea254e708a6f5deaaf7464ae",22071696,1,-2,0,227,86,84,-2
"ae5ac430ea254e708a6f5deaaf7464ae","6a9f0ef185fb47f0937e29daa1c71ed5",22071696,2,7,0,228,84,90,6
"6a9f0ef185fb47f0937e29daa1c71ed5","e20db35ced8544ddac5bc3839145e463",22071696,2,3,0,229,90,91,1
"e20db35ced8544ddac5bc3839145e463","d646286c8051419bbc2e31dd1db55ca8",22071696,3,-30,0,230,91,67,-24
"d646286c8051419bbc2e31dd1db55ca8","e20db35ced8544ddac5bc3839145e463",22071696,3,30,0,231,67,91,24
"e20db35ced8544ddac5bc3839145e463","62bff51286ef4f348717a3cf6fe2318f",22071696,1,33,0,232,91,120,29
"62bff51286ef4f348717a3cf6fe2318f","b1cd0e7dc3ad4a8eb91a4bfdbeb025b0",22071696,1,-2,0,233,120,118,-2
"b1cd0e7dc3ad4a8eb91a4bfdbeb025b0","3ec3a3563847406fa73338f9e9999cf3",22071696,1,-1,0,234,118,117,-1
"3ec3a3563847406fa73338f9e9999cf3","a9ae0a3c070d455bb4369a8996313336",22071696,1,-4,0,235,117,114,-3
"a9ae0a3c070d455bb4369a8996313336","4280927ec4d643238aa49c32f9e06c6c",22071696,1,-6,0,236,114,109,-5
"4280927ec4d643238aa49c32f9e06c6c","37319e88176d4aefa91d7a9980dbae91",22071696,1,4,0,237,109,112,3
"37319e88176d4aefa91d7a9980dbae91","08111f75e22d409998cf8b85bd431f0a",22071696,1,-5,0,238,112,108,-4
"08111f75e22d409998cf8b85bd431f0a","00ae5f0c51874a73a41ebea838d95682",22071696,1,-8,0,239,108,101,-7
"00ae5f0c51874a73a41ebea838d95682","d391c8b6e56a43a7b654e9dee02d904b",22071696,5,2,0,240,101,103,2
"d391c8b6e56a43a7b654e9dee02d904b","73039f8c1eb9409cb4caee2cf968001e",22071696,2,-3,0,241,103,100,-3
"73039f8c1eb9409cb4caee2cf968001e","e20db35ced8544ddac5bc3839145e463",22071696,1,-10,0,242,100,91,-9
"6a9f0ef185fb47f0937e29daa1c71ed5","d646286c8051419bbc2e31dd1db55ca8",22071696,1,-27,0,245,90,67,-23
"e20db35ced8544ddac5bc3839145e463","1febb706d7a34005ae8711ed49c76e64",22071696,1,3,0,247,91,94,3
"1febb706d7a34005ae8711ed49c76e64","1febb706d7a34005ae8711ed49c76e64",22071696,2,0,1,248,94,94,0
"1febb706d7a34005ae8711ed49c76e64","8f73ba6f5a0042f2850356ac38ac6f24",22071696,1,1,0,250,94,95,1
"8f73ba6f5a0042f2850356ac38ac6f24","8f73ba6f5a0042f2850356ac38ac6f24",22071696,5,0,1,251,95,95,0
"8f73ba6f5a0042f2850356ac38ac6f24","e2260b86653c46d7b14a41fb419dbf8c",22071696,1,1,0,256,95,96,1
"e2260b86653c46d7b14a41fb419dbf8c","e2260b86653c46d7b14a41fb419dbf8c",22071696,2,0,1,257,96,96,0
"e2260b86653c46d7b14a41fb419dbf8c","35eb641ad1d845bbba54915bce75a962",22071696,1,1,0,259,96,97,1
"35eb641ad1d845bbba54915bce75a962","35eb641ad1d845bbba54915bce75a962",22071696,5,0,1,260,97,97,0
"35eb641ad1d845bbba54915bce75a962","08be90ffbeea4795a138cd42ed8db56f",22071696,1,1,0,265,97,98,1
"08be90ffbeea4795a138cd42ed8db56f","08be90ffbeea4795a138cd42ed8db56f",22071696,5,0,1,266,98,98,0
"08be90ffbeea4795a138cd42ed8db56f","3007433c8f584dcbb5ac159c1c5f2be3",22071696,1,1,0,271,98,99,1
"3007433c8f584dcbb5ac159c1c5f2be3","3007433c8f584dcbb5ac159c1c5f2be3",22071696,5,0,1,272,99,99,0
"3007433c8f584dcbb5ac159c1c5f2be3","e20db35ced8544ddac5bc3839145e463",22071696,1,-8,0,277,99,91,-8
"e20db35ced8544ddac5bc3839145e463","00ae5f0c51874a73a41ebea838d95682",22071696,2,11,0,278,91,101,10
"d391c8b6e56a43a7b654e9dee02d904b","00ae5f0c51874a73a41ebea838d95682",22071696,2,-2,0,280,103,101,-2
"00ae5f0c51874a73a41ebea838d95682","00ae5f0c51874a73a41ebea838d95682",22071696,5,0,1,281,101,101,0
"00ae5f0c51874a73a41ebea838d95682","73039f8c1eb9409cb4caee2cf968001e",22071696,1,-1,0,285,101,100,-1
"73039f8c1eb9409cb4caee2cf968001e","4280927ec4d643238aa49c32f9e06c6c",22071696,2,10,0,286,100,109,9
"4280927ec4d643238aa49c32f9e06c6c","4280927ec4d643238aa49c32f9e06c6c",22071696,2,0,1,287,109,109,0
"4280927ec4d643238aa49c32f9e06c6c","08111f75e22d409998cf8b85bd431f0a",22071696,2,-1,0,289,109,108,-1
"08111f75e22d409998cf8b85bd431f0a","a9ae0a3c070d455bb4369a8996313336",22071696,3,7,0,290,108,114,6
"a9ae0a3c070d455bb4369a8996313336","a9ae0a3c070d455bb4369a8996313336",22071696,3,0,1,291,114,114,0
"a9ae0a3c070d455bb4369a8996313336","71cec822bcff4f30a20e75dc63ef7b65",22071696,1,2,0,294,114,116,2
"71cec822bcff4f30a20e75dc63ef7b65","71cec822bcff4f30a20e75dc63ef7b65",22071696,3,0,1,295,116,116,0
"71cec822bcff4f30a20e75dc63ef7b65","62bff51286ef4f348717a3cf6fe2318f",22071696,1,5,0,298,116,120,4
"62bff51286ef4f348717a3cf6fe2318f","37319e88176d4aefa91d7a9980dbae91",22071696,2,-9,0,299,120,112,-8
"37319e88176d4aefa91d7a9980dbae91","779f9ddd1fd14d1e9e69f72219a1fdbd",22071696,1,12,0,300,112,121,9
"779f9ddd1fd14d1e9e69f72219a1fdbd","e20db35ced8544ddac5bc3839145e463",22071696,1,-36,0,301,121,91,-30
"e20db35ced8544ddac5bc3839145e463","e20db35ced8544ddac5bc3839145e463",22071696,1,0,1,302,91,91,0
"e20db35ced8544ddac5bc3839145e463","73039f8c1eb9409cb4caee2cf968001e",22071696,1,10,0,303,91,100,9
"73039f8c1eb9409cb4caee2cf968001e","00ae5f0c51874a73a41ebea838d95682",22071696,1,1,0,304,100,101,1
"d391c8b6e56a43a7b654e9dee02d904b","d391c8b6e56a43a7b654e9dee02d904b",22071696,15,0,1,309,103,103,0
"d391c8b6e56a43a7b654e9dee02d904b","a81b2235cb9c499eb9ea8ee0a8dd9725",22071696,1,2,0,324,103,105,2
"a81b2235cb9c499eb9ea8ee0a8dd9725","a81b2235cb9c499eb9ea8ee0a8dd9725",22071696,2,0,1,325,105,105,0
"a81b2235cb9c499eb9ea8ee0a8dd9725","2d4e0ab0ef3b4d73b82c72d4621a7579",22071696,1,1,0,327,105,106,1
"2d4e0ab0ef3b4d73b82c72d4621a7579","2d4e0ab0ef3b4d73b82c72d4621a7579",22071696,2,0,1,328,106,106,0
"2d4e0ab0ef3b4d73b82c72d4621a7579","8bdebf492ebd4e62b0d522e8ab5e5197",22071696,1,1,0,330,106,107,1
"8bdebf492ebd4e62b0d522e8ab5e5197","8bdebf492ebd4e62b0d522e8ab5e5197",22071696,5,0,1,331,107,107,0
"8bdebf492ebd4e62b0d522e8ab5e5197","4280927ec4d643238aa49c32f9e06c6c",22071696,1,3,0,336,107,109,2
"4280927ec4d643238aa49c32f9e06c6c","73039f8c1eb9409cb4caee2cf968001e",22071696,1,-10,0,337,109,100,-9
"73039f8c1eb9409cb4caee2cf968001e","08111f75e22d409998cf8b85bd431f0a",22071696,1,9,0,338,100,108,8
"a9ae0a3c070d455bb4369a8996313336","62bff51286ef4f348717a3cf6fe2318f",22071696,1,7,0,340,114,120,6
"37319e88176d4aefa91d7a9980dbae91","b1cd0e7dc3ad4a8eb91a4bfdbeb025b0",22071696,1,7,0,342,112,118,6
"b1cd0e7dc3ad4a8eb91a4bfdbeb025b0","b1cd0e7dc3ad4a8eb91a4bfdbeb025b0",22071696,1,0,1,343,118,118,0
"b1cd0e7dc3ad4a8eb91a4bfdbeb025b0","62bff51286ef4f348717a3cf6fe2318f",22071696,1,2,0,344,118,120,2
"62bff51286ef4f348717a3cf6fe2318f","62bff51286ef4f348717a3cf6fe2318f",22071696,5,0,1,345,120,120,0
"62bff51286ef4f348717a3cf6fe2318f","e20db35ced8544ddac5bc3839145e463",22071696,2,-33,0,348,120,91,-29
"e20db35ced8544ddac5bc3839145e463","779f9ddd1fd14d1e9e69f72219a1fdbd",22071696,2,36,0,349,91,121,30
"779f9ddd1fd14d1e9e69f72219a1fdbd","ae26e6cda8ad4a3f81bd347560d9579f",22071696,1,4,0,350,121,125,4
"ae26e6cda8ad4a3f81bd347560d9579f","ae26e6cda8ad4a3f81bd347560d9579f",22071696,1,0,1,351,125,125,0
"ae26e6cda8ad4a3f81bd347560d9579f","ee48df95832b4374aa273ceb27ec1315",22071696,1,1,0,352,125,126,1
"ee48df95832b4374aa273ceb27ec1315","ee48df95832b4374aa273ceb27ec1315",22071696,1,0,1,353,126,126,0
"ee48df95832b4374aa273ceb27ec1315","7a439da90b394756ad1777fc4c6dead5",22071696,1,1,0,354,126,127,1
"7a439da90b394756ad1777fc4c6dead5","7a439da90b394756ad1777fc4c6dead5",22071696,1,0,1,355,127,127,0
"7a439da90b394756ad1777fc4c6dead5","a8dd5213034441ac92724b4e83eb0bb2",22071696,1,3,0,356,127,129,2
"a8dd5213034441ac92724b4e83eb0bb2","779f9ddd1fd14d1e9e69f72219a1fdbd",22071696,2,-9,0,357,129,121,-8
"779f9ddd1fd14d1e9e69f72219a1fdbd","a8dd5213034441ac92724b4e83eb0bb2",22071696,2,9,0,358,121,129,8
"a8dd5213034441ac92724b4e83eb0bb2","8115eab6556b45f5b415c3b8c26a12e5",22071696,1,2,0,359,129,131,2
"8115eab6556b45f5b415c3b8c26a12e5","8115eab6556b45f5b415c3b8c26a12e5",22071696,2,0,1,360,131,131,0
"8115eab6556b45f5b415c3b8c26a12e5","ec34b06efd844b46a4c4818ecdb9b8f4",22071696,1,1,0,362,131,132,1
"ec34b06efd844b46a4c4818ecdb9b8f4","ec34b06efd844b46a4c4818ecdb9b8f4",22071696,5,0,1,363,132,132,0
"ec34b06efd844b46a4c4818ecdb9b8f4","c2e1c2b9eac64109b343a088584b576b",22071696,1,1,0,368,132,133,1
"c2e1c2b9eac64109b343a088584b576b","c2e1c2b9eac64109b343a088584b576b",22071696,2,0,1,369,133,133,0
"c2e1c2b9eac64109b343a088584b576b","579338175e0b4bbb8ef3b712b5d8b54e",22071696,1,-5,0,371,133,128,-5
"579338175e0b4bbb8ef3b712b5d8b54e","8bc5795d6a984a3eace4e2811e52dd4f",22071696,1,8,0,372,128,135,7
"8bc5795d6a984a3eace4e2811e52dd4f","8bc5795d6a984a3eace4e2811e52dd4f",22071696,1,0,1,373,135,135,0
"8bc5795d6a984a3eace4e2811e52dd4f","b416d47c56a742199b5d7c7f19d6503a",22071696,1,-1,0,374,135,134,-1
"b416d47c56a742199b5d7c7f19d6503a","cd4532ad48034873ba8bce2aac0c9808",22071696,1,4,0,375,134,137,3
"cd4532ad48034873ba8bce2aac0c9808","cd4532ad48034873ba8bce2aac0c9808",22071696,1,0,1,376,137,137,0
"cd4532ad48034873ba8bce2aac0c9808","df1de691dafe4549a18a4398ee9dfaf9",22071696,1,4,0,377,137,139,2
"df1de691dafe4549a18a4398ee9dfaf9","779f9ddd1fd14d1e9e69f72219a1fdbd",22071696,6,-23,0,378,139,121,-18
"779f9ddd1fd14d1e9e69f72219a1fdbd","6c5ad271a44743479bfaea29b1db8d02",22071696,1,27,0,379,121,143,22
"6c5ad271a44743479bfaea29b1db8d02","6c5ad271a44743479bfaea29b1db8d02",22071696,1,0,1,380,143,143,0
"6c5ad271a44743479bfaea29b1db8d02","83d311bed5374fee83d8d67a7d9d82dc",22071696,1,1,0,381,143,144,1
"83d311bed5374fee83d8d67a7d9d82dc","83d311bed5374fee83d8d67a7d9d82dc",22071696,1,0,1,382,144,144,0
"83d311bed5374fee83d8d67a7d9d82dc","402bba41861d43acb52a5abb89e8831e",22071696,1,1,0,383,144,145,1
"402bba41861d43acb52a5abb89e8831e","402bba41861d43acb52a5abb89e8831e",22071696,2,0,1,384,145,145,0
"402bba41861d43acb52a5abb89e8831e","df1de691dafe4549a18a4398ee9dfaf9",22071696,1,-6,0,386,145,139,-6
"df1de691dafe4549a18a4398ee9dfaf9","8aae34f5ddbb4052a709b12e6b0d40fa",22071696,1,9,0,387,139,147,8
"8aae34f5ddbb4052a709b12e6b0d40fa","8aae34f5ddbb4052a709b12e6b0d40fa",22071696,1,0,1,388,147,147,0
"8aae34f5ddbb4052a709b12e6b0d40fa","645b3f0249f64f76af2e19eb4d0e55b7",22071696,1,2,0,389,147,149,2
"645b3f0249f64f76af2e19eb4d0e55b7","645b3f0249f64f76af2e19eb4d0e55b7",22071696,9,0,1,390,149,149,0
"645b3f0249f64f76af2e19eb4d0e55b7","7e7b8db5064d4369805ab370aac5ddfb",22071696,1,1,0,399,149,150,1
"7e7b8db5064d4369805ab370aac5ddfb","7e7b8db5064d4369805ab370aac5ddfb",22071696,8,0,1,400,150,150,0
"7e7b8db5064d4369805ab370aac5ddfb","8956d210ae7f41968fada86d4c979d6a",22071696,1,1,0,408,150,151,1
"8956d210ae7f41968fada86d4c979d6a","8956d210ae7f41968fada86d4c979d6a",22071696,2,0,1,409,151,151,0
"8956d210ae7f41968fada86d4c979d6a","f902b0f41b544d4dbf79664fd233648d",22071696,1,-5,0,411,151,146,-5
"f902b0f41b544d4dbf79664fd233648d","6c5ad271a44743479bfaea29b1db8d02",22071696,1,-4,0,412,146,143,-3
"6c5ad271a44743479bfaea29b1db8d02","f03480cf4eba413194d7af52fc0e7f28",22071696,1,11,0,413,143,152,9
"f03480cf4eba413194d7af52fc0e7f28","df1de691dafe4549a18a4398ee9dfaf9",22071696,1,-15,0,414,152,139,-13
"df1de691dafe4549a18a4398ee9dfaf9","ae781e8b775e4ccd93bc800dad5c8376",22071696,1,16,0,415,139,153,14
"ae781e8b775e4ccd93bc800dad5c8376","ae781e8b775e4ccd93bc800dad5c8376",22071696,2,0,1,416,153,153,0
"ae781e8b775e4ccd93bc800dad5c8376","06882a8492d9499aa31555567f575ecb",22071696,1,1,0,418,153,154,1
"06882a8492d9499aa31555567f575ecb","06882a8492d9499aa31555567f575ecb",22071696,1,0,1,419,154,154,0
"06882a8492d9499aa31555567f575ecb","f293c508f409466a8f27ddd7d1e40b20",22071696,1,1,0,420,154,155,1
"f293c508f409466a8f27ddd7d1e40b20","f293c508f409466a8f27ddd7d1e40b20",22071696,2,0,1,421,155,155,0
"f293c508f409466a8f27ddd7d1e40b20","cc4ddef5bbbe48ebb605141b347c4ed1",22071696,1,1,0,423,155,156,1
"cc4ddef5bbbe48ebb605141b347c4ed1","cc4ddef5bbbe48ebb605141b347c4ed1",22071696,3,0,1,424,156,156,0
"cc4ddef5bbbe48ebb605141b347c4ed1","f03480cf4eba413194d7af52fc0e7f28",22071696,1,-4,0,427,156,152,-4
"f03480cf4eba413194d7af52fc0e7f28","d313cec988a84645bee413e8d4724a4b",22071696,1,7,0,428,152,158,6
"d313cec988a84645bee413e8d4724a4b","d313cec988a84645bee413e8d4724a4b",22071696,6,0,1,429,158,158,0
"d313cec988a84645bee413e8d4724a4b","dc60696c76a74368a60f72246e47700d",22071696,1,1,0,433,158,159,1
"dc60696c76a74368a60f72246e47700d","dc60696c76a74368a60f72246e47700d",22071696,1,0,1,434,159,159,0
"dc60696c76a74368a60f72246e47700d","78adeee1fa2c4fe0bc73f7bca9fcee86",22071696,1,3,0,435,159,160,1
"78adeee1fa2c4fe0bc73f7bca9fcee86","df1de691dafe4549a18a4398ee9dfaf9",22071696,1,-26,0,436,160,139,-21
"df1de691dafe4549a18a4398ee9dfaf9","65202579580f4ad38d734b4ee39d22a8",22071696,1,31,0,437,139,164,25
"65202579580f4ad38d734b4ee39d22a8","65202579580f4ad38d734b4ee39d22a8",22071696,62,0,1,438,164,164,0
"65202579580f4ad38d734b4ee39d22a8","78adeee1fa2c4fe0bc73f7bca9fcee86",22071696,2,-5,0,440,164,160,-4
"78adeee1fa2c4fe0bc73f7bca9fcee86","65202579580f4ad38d734b4ee39d22a8",22071696,3,5,0,441,160,164,4
"65202579580f4ad38d734b4ee39d22a8","d9c8d8c444a64dadbbb508652c721e17",22071696,1,-147,0,461,164,46,-118
"d9c8d8c444a64dadbbb508652c721e17","b534b89233134e30a9b5645138bfa9ee",22071696,2,-6,0,462,46,41,-5
"b534b89233134e30a9b5645138bfa9ee","6e13d61a7bdb44bca949c9f86fab3be5",22071696,2,7,0,463,41,47,6
"6e13d61a7bdb44bca949c9f86fab3be5","195f78799f984cc2b06c48dfe36be751",22071696,1,2,0,464,47,49,2
"195f78799f984cc2b06c48dfe36be751","195f78799f984cc2b06c48dfe36be751",22071696,8,0,1,465,49,49,0
"195f78799f984cc2b06c48dfe36be751","d0c74f735e024943943e40333d6d337f",22071696,1,3,0,473,49,51,2
"d0c74f735e024943943e40333d6d337f","d9c8d8c444a64dadbbb508652c721e17",22071696,1,-6,0,474,51,46,-5
"b534b89233134e30a9b5645138bfa9ee","7af822066add4e7f8e007e4eee31a8bf",22071696,1,29,0,476,41,65,24
"7af822066add4e7f8e007e4eee31a8bf","b534b89233134e30a9b5645138bfa9ee",22071696,1,-29,0,477,65,41,-24
"d646286c8051419bbc2e31dd1db55ca8","140d5b27b8574befad82c0a013b59dfa",22071696,1,8,0,481,67,74,7
"d18a9ea32855445f8736581f5cb119ce","6a9f0ef185fb47f0937e29daa1c71ed5",22071696,1,10,0,483,82,90,8
"6a9f0ef185fb47f0937e29daa1c71ed5","ae5ac430ea254e708a6f5deaaf7464ae",22071696,1,-7,0,484,90,84,-6
"a9ae0a3c070d455bb4369a8996313336","37319e88176d4aefa91d7a9980dbae91",22071696,1,-2,0,498,114,112,-2
"37319e88176d4aefa91d7a9980dbae91","62bff51286ef4f348717a3cf6fe2318f",22071696,1,9,0,499,112,120,8
"779f9ddd1fd14d1e9e69f72219a1fdbd","779f9ddd1fd14d1e9e69f72219a1fdbd",22071696,3,0,1,506,121,121,0
"779f9ddd1fd14d1e9e69f72219a1fdbd","df1de691dafe4549a18a4398ee9dfaf9",22071696,7,23,0,508,121,139,18
"df1de691dafe4549a18a4398ee9dfaf9","579338175e0b4bbb8ef3b712b5d8b54e",22071696,1,-15,0,509,139,128,-11
"579338175e0b4bbb8ef3b712b5d8b54e","b416d47c56a742199b5d7c7f19d6503a",22071696,1,7,0,510,128,134,6
"b416d47c56a742199b5d7c7f19d6503a","779f9ddd1fd14d1e9e69f72219a1fdbd",22071696,1,-15,0,511,134,121,-13
"df1de691dafe4549a18a4398ee9dfaf9","df1de691dafe4549a18a4398ee9dfaf9",22071696,2,0,1,513,139,139,0
"df1de691dafe4549a18a4398ee9dfaf9","6c5ad271a44743479bfaea29b1db8d02",22071696,1,4,0,526,139,143,4
"6c5ad271a44743479bfaea29b1db8d02","8aae34f5ddbb4052a709b12e6b0d40fa",22071696,1,5,0,527,143,147,4
"8aae34f5ddbb4052a709b12e6b0d40fa","f902b0f41b544d4dbf79664fd233648d",22071696,1,-1,0,528,147,146,-1
"f902b0f41b544d4dbf79664fd233648d","df1de691dafe4549a18a4398ee9dfaf9",22071696,1,-8,0,529,146,139,-7
"df1de691dafe4549a18a4398ee9dfaf9","d313cec988a84645bee413e8d4724a4b",22071696,1,22,0,530,139,158,19
"d313cec988a84645bee413e8d4724a4b","df1de691dafe4549a18a4398ee9dfaf9",22071696,1,-22,0,533,158,139,-19
"df1de691dafe4549a18a4398ee9dfaf9","f03480cf4eba413194d7af52fc0e7f28",22071696,1,15,0,534,139,152,13
"f03480cf4eba413194d7af52fc0e7f28","78adeee1fa2c4fe0bc73f7bca9fcee86",22071696,1,11,0,535,152,160,8
"65202579580f4ad38d734b4ee39d22a8","3cbcea2be0984e7dbd5a48195af10ce7",22071696,1,3,0,580,164,165,1
"3cbcea2be0984e7dbd5a48195af10ce7","78adeee1fa2c4fe0bc73f7bca9fcee86",22071696,1,-8,0,581,165,160,-5
"78adeee1fa2c4fe0bc73f7bca9fcee86","82e6285962b8400d9d6fc32436022a94",22071696,1,10,0,582,160,167,7
"82e6285962b8400d9d6fc32436022a94","3cbcea2be0984e7dbd5a48195af10ce7",22071696,1,-2,0,583,167,165,-2
"3cbcea2be0984e7dbd5a48195af10ce7","a9ac840f098c4bd0a2ee896214ce29cd",22071696,1,5,0,584,165,168,3
"a9ac840f098c4bd0a2ee896214ce29cd","a9ac840f098c4bd0a2ee896214ce29cd",22071696,1,0,1,585,168,168,0
"a9ac840f098c4bd0a2ee896214ce29cd","0c7262dff33c4087bc660ccf40f92f9c",22071696,1,4,0,586,168,169,1
"0c7262dff33c4087bc660ccf40f92f9c","b2275c3fad834f8d90737a2d9a6927d6",22071696,1,3,0,587,169,172,3
"b2275c3fad834f8d90737a2d9a6927d6","b2275c3fad834f8d90737a2d9a6927d6",22071696,28,0,1,588,172,172,0
"b2275c3fad834f8d90737a2d9a6927d6","eb515a26030b41f8a82a1e6114420bad",22071696,1,1,0,616,172,173,1
"eb515a26030b41f8a82a1e6114420bad","eb515a26030b41f8a82a1e6114420bad",22071696,2,0,1,617,173,173,0
"eb515a26030b41f8a82a1e6114420bad","0c7262dff33c4087bc660ccf40f92f9c",22071696,1,-4,0,619,173,169,-4
"0c7262dff33c4087bc660ccf40f92f9c","b42cc17b7de840f181a704558d0bc845",22071696,3,7,0,620,169,175,6
"b42cc17b7de840f181a704558d0bc845","b42cc17b7de840f181a704558d0bc845",22071696,15,0,1,621,175,175,0
"b42cc17b7de840f181a704558d0bc845","0c7262dff33c4087bc660ccf40f92f9c",22071696,1,-7,0,624,175,169,-6
"b42cc17b7de840f181a704558d0bc845","801f9e9135034f49bf5f8b4bdefedb41",22071696,1,2,0,627,175,177,2
"801f9e9135034f49bf5f8b4bdefedb41","801f9e9135034f49bf5f8b4bdefedb41",22071696,11,0,1,628,177,177,0
"801f9e9135034f49bf5f8b4bdefedb41","ea38cc0e6e6e41edbabf210220808bf9",22071696,1,3,0,639,177,179,2
"ea38cc0e6e6e41edbabf210220808bf9","362fcb0699a14845ab29b2340093e528",22071696,1,-6,0,640,179,174,-5
"362fcb0699a14845ab29b2340093e528","b87c552dd247427abe6ab5795b9c9d43",22071696,1,8,0,641,174,181,7
"b87c552dd247427abe6ab5795b9c9d43","ea38cc0e6e6e41edbabf210220808bf9",22071696,1,-2,0,642,181,179,-2
"ea38cc0e6e6e41edbabf210220808bf9","b87c552dd247427abe6ab5795b9c9d43",22071696,1,2,0,643,179,181,2
"b87c552dd247427abe6ab5795b9c9d43","b87c552dd247427abe6ab5795b9c9d43",22071696,20,0,1,644,181,181,0
"b87c552dd247427abe6ab5795b9c9d43","139b097acfca451689d80c9c6eebdf7b",22071696,1,-3,0,664,181,178,-3
"139b097acfca451689d80c9c6eebdf7b","b42cc17b7de840f181a704558d0bc845",22071696,1,-4,0,665,178,175,-3
"b42cc17b7de840f181a704558d0bc845","2024b4885bd14338a39b7b509acbbd02",22071696,1,9,0,666,175,182,7
"2024b4885bd14338a39b7b509acbbd02","362fcb0699a14845ab29b2340093e528",22071696,1,-10,0,667,182,174,-8
"362fcb0699a14845ab29b2340093e528","b2275c3fad834f8d90737a2d9a6927d6",22071696,1,-3,0,668,174,172,-2
"b2275c3fad834f8d90737a2d9a6927d6","0c7262dff33c4087bc660ccf40f92f9c",22071696,1,-3,0,669,172,169,-3
"b42cc17b7de840f181a704558d0bc845","362fcb0699a14845ab29b2340093e528",22071696,1,-1,0,682,175,174,-1
"362fcb0699a14845ab29b2340093e528","30f660a1feb34582a739722532524f79",22071696,1,11,0,683,174,183,9
"30f660a1feb34582a739722532524f79","30f660a1feb34582a739722532524f79",22071696,5,0,1,684,183,183,0
"30f660a1feb34582a739722532524f79","2024b4885bd14338a39b7b509acbbd02",22071696,1,-1,0,689,183,182,-1
"2024b4885bd14338a39b7b509acbbd02","c3f63fe50d8e487c86bf8ef76c9cadd3",22071696,1,4,0,690,182,185,3
"c3f63fe50d8e487c86bf8ef76c9cadd3","c3f63fe50d8e487c86bf8ef76c9cadd3",22071696,1,0,1,691,185,185,0
"c3f63fe50d8e487c86bf8ef76c9cadd3","c8e371568a0c4391b25796ae4e91952e",22071696,1,3,0,692,185,186,1
"c8e371568a0c4391b25796ae4e91952e","0c7262dff33c4087bc660ccf40f92f9c",22071696,1,-23,0,693,186,169,-17
"0c7262dff33c4087bc660ccf40f92f9c","7d932b23e1c84326ae5aa4d3c0d813d1",22071696,1,25,0,694,169,188,19
"7d932b23e1c84326ae5aa4d3c0d813d1","7d932b23e1c84326ae5aa4d3c0d813d1",22071696,1,0,1,695,188,188,0
"7d932b23e1c84326ae5aa4d3c0d813d1","c8e371568a0c4391b25796ae4e91952e",22071696,1,-2,0,696,188,186,-2
"c8e371568a0c4391b25796ae4e91952e","ab11d94c6c8948ea90b88f19d2cd502b",22071696,1,5,0,697,186,190,4
"ab11d94c6c8948ea90b88f19d2cd502b","ab11d94c6c8948ea90b88f19d2cd502b",22071696,7,0,1,698,190,190,0
"ab11d94c6c8948ea90b88f19d2cd502b","07b44a7a51e94c78b411c753fc39dab0",22071696,1,-1,0,705,190,189,-1
"07b44a7a51e94c78b411c753fc39dab0","6cd2dcaac46847d4a0bc53f296d90375",22071696,2,6,0,706,189,194,5
"6cd2dcaac46847d4a0bc53f296d90375","017d7ca8e0394b91aaadc9574df2202c",22071696,1,-1,0,707,194,193,-1
"017d7ca8e0394b91aaadc9574df2202c","ab11d94c6c8948ea90b88f19d2cd502b",22071696,1,-4,0,708,193,190,-3
"ab11d94c6c8948ea90b88f19d2cd502b","f992451ed6ad4e68bb9e68ad6be7c4be",22071696,1,2,0,709,190,192,2
"f992451ed6ad4e68bb9e68ad6be7c4be","f992451ed6ad4e68bb9e68ad6be7c4be",22071696,1,0,1,710,192,192,0
"f992451ed6ad4e68bb9e68ad6be7c4be","6cd2dcaac46847d4a0bc53f296d90375",22071696,1,3,0,711,192,194,2
"6cd2dcaac46847d4a0bc53f296d90375","07b44a7a51e94c78b411c753fc39dab0",22071696,1,-6,0,712,194,189,-5
"6cd2dcaac46847d4a0bc53f296d90375","6cd2dcaac46847d4a0bc53f296d90375",22071696,1,0,1,714,194,194,0
"6cd2dcaac46847d4a0bc53f296d90375","2d2580c9411c4972909db508d6956a58",22071696,1,2,0,715,194,196,2
"2d2580c9411c4972909db508d6956a58","2d2580c9411c4972909db508d6956a58",22071696,8,0,1,716,196,196,0
"2d2580c9411c4972909db508d6956a58","5bddb3d9ed264f3984702f048c7e5340",22071696,1,1,0,724,196,197,1
"5bddb3d9ed264f3984702f048c7e5340","5bddb3d9ed264f3984702f048c7e5340",22071696,2,0,1,725,197,197,0
"5bddb3d9ed264f3984702f048c7e5340","d5e8e2bd12a2466b9d6d90855f0eb079",22071696,1,1,0,727,197,198,1
"d5e8e2bd12a2466b9d6d90855f0eb079","d5e8e2bd12a2466b9d6d90855f0eb079",22071696,2,0,1,728,198,198,0
"d5e8e2bd12a2466b9d6d90855f0eb079","017d7ca8e0394b91aaadc9574df2202c",22071696,1,-5,0,730,198,193,-5
"017d7ca8e0394b91aaadc9574df2202c","54e8e9f0ea3e45c4bf3b8ac799ee31b1",22071696,1,8,0,731,193,200,7
"54e8e9f0ea3e45c4bf3b8ac799ee31b1","54e8e9f0ea3e45c4bf3b8ac799ee31b1",22071696,1,0,1,732,200,200,0
"54e8e9f0ea3e45c4bf3b8ac799ee31b1","c614a00911be4877a075f19315530fb0",22071696,1,1,0,733,200,201,1
"c614a00911be4877a075f19315530fb0","c614a00911be4877a075f19315530fb0",22071696,13,0,1,734,201,201,0
"c614a00911be4877a075f19315530fb0","a6c21bd8b95249c7972820a7a7d76aff",22071696,1,1,0,747,201,202,1
"a6c21bd8b95249c7972820a7a7d76aff","a6c21bd8b95249c7972820a7a7d76aff",22071696,2,0,1,748,202,202,0
"a6c21bd8b95249c7972820a7a7d76aff","bb329d880ab54120adaf203a693bb203",22071696,1,1,0,749,202,203,1
"bb329d880ab54120adaf203a693bb203","bb329d880ab54120adaf203a693bb203",22071696,1,0,1,750,203,203,0
"bb329d880ab54120adaf203a693bb203","a6c21bd8b95249c7972820a7a7d76aff",22071696,1,-1,0,751,203,202,-1
"a6c21bd8b95249c7972820a7a7d76aff","f9170dd6bc6442b4acd832747609b09a",22071696,1,-3,0,753,202,199,-3
"f9170dd6bc6442b4acd832747609b09a","334c2344009840079b1d0e1b7ce3d5a7",22071696,1,7,0,754,199,205,6
"334c2344009840079b1d0e1b7ce3d5a7","334c2344009840079b1d0e1b7ce3d5a7",22071696,1,0,1,755,205,205,0
"334c2344009840079b1d0e1b7ce3d5a7","c8e371568a0c4391b25796ae4e91952e",22071696,1,-23,0,756,205,186,-19
"c8e371568a0c4391b25796ae4e91952e","d7f13c8d63ec4e2aa673fbb9cf9c6933",22071696,1,26,0,757,186,206,20
"d7f13c8d63ec4e2aa673fbb9cf9c6933","b9e80f77c3a44349863b19875725c384",22071696,1,1,0,758,206,207,1
"b9e80f77c3a44349863b19875725c384","7108f0e4c2584f1f9c471689ae4c885c",22071696,2,1,0,759,207,208,1
"7108f0e4c2584f1f9c471689ae4c885c","b9e80f77c3a44349863b19875725c384",22071696,2,-1,0,760,208,207,-1
"b9e80f77c3a44349863b19875725c384","b9e80f77c3a44349863b19875725c384",22071696,21,0,1,761,207,207,0
"7108f0e4c2584f1f9c471689ae4c885c","7108f0e4c2584f1f9c471689ae4c885c",22071696,13,0,1,783,208,208,0
"7108f0e4c2584f1f9c471689ae4c885c","09400e101c5d4b439cf9a26b03aae558",22071696,1,3,0,796,208,210,2
"09400e101c5d4b439cf9a26b03aae558","d7f13c8d63ec4e2aa673fbb9cf9c6933",22071696,1,-5,0,797,210,206,-4
"d7f13c8d63ec4e2aa673fbb9cf9c6933","09400e101c5d4b439cf9a26b03aae558",22071696,2,5,0,798,206,210,4
"09400e101c5d4b439cf9a26b03aae558","a88efa7e50ce47159810ab553afa6d3a",22071696,1,2,0,799,210,212,2
"a88efa7e50ce47159810ab553afa6d3a","a88efa7e50ce47159810ab553afa6d3a",22071696,8,0,1,800,212,212,0
"a88efa7e50ce47159810ab553afa6d3a","a875096404ef4a9984b62d74cda916f9",22071696,1,-3,0,808,212,209,-3
"a875096404ef4a9984b62d74cda916f9","f7fb1952f56b4189b86a9f8b7862d2b8",22071696,2,7,0,809,209,215,6
"f7fb1952f56b4189b86a9f8b7862d2b8","be502a7a43c44bf7b682698de79d9369",22071696,2,-1,0,810,215,214,-1
"be502a7a43c44bf7b682698de79d9369","be502a7a43c44bf7b682698de79d9369",22071696,4,0,1,811,214,214,0
"be502a7a43c44bf7b682698de79d9369","d7f13c8d63ec4e2aa673fbb9cf9c6933",22071696,1,-10,0,814,214,206,-8
"d7f13c8d63ec4e2aa673fbb9cf9c6933","7108f0e4c2584f1f9c471689ae4c885c",22071696,1,2,0,815,206,208,2
"b9e80f77c3a44349863b19875725c384","d7f13c8d63ec4e2aa673fbb9cf9c6933",22071696,1,-1,0,817,207,206,-1
"09400e101c5d4b439cf9a26b03aae558","09400e101c5d4b439cf9a26b03aae558",22071696,2,0,1,819,210,210,0
"09400e101c5d4b439cf9a26b03aae558","a875096404ef4a9984b62d74cda916f9",22071696,1,-1,0,821,210,209,-1
"be502a7a43c44bf7b682698de79d9369","f7fb1952f56b4189b86a9f8b7862d2b8",22071696,1,1,0,825,214,215,1
"f7fb1952f56b4189b86a9f8b7862d2b8","f7fb1952f56b4189b86a9f8b7862d2b8",22071696,17,0,1,826,215,215,0
"f7fb1952f56b4189b86a9f8b7862d2b8","b860ee85d8bc4a2f97958cfb71be3533",22071696,1,1,0,843,215,216,1
"b860ee85d8bc4a2f97958cfb71be3533","b860ee85d8bc4a2f97958cfb71be3533",22071696,5,0,1,844,216,216,0
"b860ee85d8bc4a2f97958cfb71be3533","ec341f459285443b8361f7f15638ff08",22071696,1,-3,0,849,216,213,-3
"ec341f459285443b8361f7f15638ff08","363837c182e04711840d896ae1e0339c",22071696,1,6,0,850,213,218,5
"363837c182e04711840d896ae1e0339c","363837c182e04711840d896ae1e0339c",22071696,16,0,1,851,218,218,0
"363837c182e04711840d896ae1e0339c","01b2051f8941460d89945e3b02d1ce78",22071696,1,-1,0,867,218,217,-1
"01b2051f8941460d89945e3b02d1ce78","91125ca626c5470eb145501f8c37f8db",22071696,1,4,0,868,217,220,3
"91125ca626c5470eb145501f8c37f8db","91125ca626c5470eb145501f8c37f8db",22071696,1,0,1,869,220,220,0
"91125ca626c5470eb145501f8c37f8db","d7f13c8d63ec4e2aa673fbb9cf9c6933",22071696,1,-18,0,870,220,206,-14
"d7f13c8d63ec4e2aa673fbb9cf9c6933","1c6721b1f63f4d30ba7746ea8af02a52",22071696,1,21,0,871,206,221,15
"1c6721b1f63f4d30ba7746ea8af02a52","77ecef8eff6b4a2caea7707669bf7475",22071696,1,1,0,872,221,222,1
"77ecef8eff6b4a2caea7707669bf7475","77ecef8eff6b4a2caea7707669bf7475",22071696,12,0,1,873,222,222,0
"77ecef8eff6b4a2caea7707669bf7475","d03cb855c70044cf8c35d9ec0de696e3",22071696,1,3,0,885,222,224,2
"d03cb855c70044cf8c35d9ec0de696e3","1c6721b1f63f4d30ba7746ea8af02a52",22071696,1,-4,0,886,224,221,-3
"1c6721b1f63f4d30ba7746ea8af02a52","8b9ae98743bd4d4a8a87dff1c1244211",22071696,1,7,0,887,221,227,6
"8b9ae98743bd4d4a8a87dff1c1244211","d03cb855c70044cf8c35d9ec0de696e3",22071696,1,-3,0,888,227,224,-3
"d03cb855c70044cf8c35d9ec0de696e3","a49a937d6896486d9a5396654abcf2e1",22071696,1,2,0,889,224,226,2
"a49a937d6896486d9a5396654abcf2e1","a49a937d6896486d9a5396654abcf2e1",22071696,3,0,1,890,226,226,0
"a49a937d6896486d9a5396654abcf2e1","8b9ae98743bd4d4a8a87dff1c1244211",22071696,1,1,0,893,226,227,1
"8b9ae98743bd4d4a8a87dff1c1244211","8b9ae98743bd4d4a8a87dff1c1244211",22071696,16,0,1,894,227,227,0
"8b9ae98743bd4d4a8a87dff1c1244211","f7906d6f59b9489a91d2ef40db5a474d",22071696,1,-4,0,910,227,223,-4
"f7906d6f59b9489a91d2ef40db5a474d","2ab1535aac1346ba8801535bf729ef37",22071696,1,7,0,911,223,229,6
"2ab1535aac1346ba8801535bf729ef37","2ab1535aac1346ba8801535bf729ef37",22071696,5,0,1,912,229,229,0
"2ab1535aac1346ba8801535bf729ef37","5152833676bf4c6cb317060be10f68db",22071696,1,-1,0,913,229,228,-1
"5152833676bf4c6cb317060be10f68db","1c6721b1f63f4d30ba7746ea8af02a52",22071696,1,-9,0,914,228,221,-7
"1c6721b1f63f4d30ba7746ea8af02a52","2ab1535aac1346ba8801535bf729ef37",22071696,2,10,0,915,221,229,8
"2ab1535aac1346ba8801535bf729ef37","1c6721b1f63f4d30ba7746ea8af02a52",22071696,1,-10,0,918,229,221,-8
"2ab1535aac1346ba8801535bf729ef37","a4f40fb48a8542c8949bae1f002cd9bc",22071696,1,2,0,922,229,231,2
"a4f40fb48a8542c8949bae1f002cd9bc","a4f40fb48a8542c8949bae1f002cd9bc",22071696,2,0,1,923,231,231,0
"a4f40fb48a8542c8949bae1f002cd9bc","8972c23e32044edb8a78fa1eed4e5947",22071696,1,1,0,925,231,232,1
"8972c23e32044edb8a78fa1eed4e5947","8972c23e32044edb8a78fa1eed4e5947",22071696,5,0,1,926,232,232,0
"8972c23e32044edb8a78fa1eed4e5947","92feb4a40f8344d38b6f722e42a53295",22071696,1,1,0,931,232,233,1
"92feb4a40f8344d38b6f722e42a53295","92feb4a40f8344d38b6f722e42a53295",22071696,2,0,1,932,233,233,0
"92feb4a40f8344d38b6f722e42a53295","5152833676bf4c6cb317060be10f68db",22071696,1,-5,0,934,233,228,-5
"5152833676bf4c6cb317060be10f68db","ca3e28f290354c08aefe5b0f769604e6",22071696,1,8,0,935,228,235,7
"ca3e28f290354c08aefe5b0f769604e6","ca3e28f290354c08aefe5b0f769604e6",22071696,4,0,1,936,235,235,0
"ca3e28f290354c08aefe5b0f769604e6","79a35eea833e4c2c9d22fc53c3c6445c",22071696,1,1,0,940,235,236,1
"79a35eea833e4c2c9d22fc53c3c6445c","79a35eea833e4c2c9d22fc53c3c6445c",22071696,9,0,1,941,236,236,0
"79a35eea833e4c2c9d22fc53c3c6445c","8f68228b1518449e9615cdafee41a2bd",22071696,1,1,0,950,236,237,1
"8f68228b1518449e9615cdafee41a2bd","8f68228b1518449e9615cdafee41a2bd",22071696,3,0,1,951,237,237,0
"8f68228b1518449e9615cdafee41a2bd","cab89fa5c3ed45a5aa550fc0352d6a42",22071696,1,1,0,954,237,238,1
"cab89fa5c3ed45a5aa550fc0352d6a42","cab89fa5c3ed45a5aa550fc0352d6a42",22071696,3,0,1,955,238,238,0
"cab89fa5c3ed45a5aa550fc0352d6a42","66d4fad4f1cf4b46be0750a99ad7a35a",22071696,1,1,0,958,238,239,1
"66d4fad4f1cf4b46be0750a99ad7a35a","66d4fad4f1cf4b46be0750a99ad7a35a",22071696,1,0,1,959,239,239,0
"66d4fad4f1cf4b46be0750a99ad7a35a","0b04c8e2f86d48c7aeb7e225819cd32b",22071696,1,-5,0,960,239,234,-5
"0b04c8e2f86d48c7aeb7e225819cd32b","f53da5fd9bfe412da4b80d4742563b6c",22071696,1,8,0,961,234,241,7
"f53da5fd9bfe412da4b80d4742563b6c","f53da5fd9bfe412da4b80d4742563b6c",22071696,1,0,1,962,241,241,0
"f53da5fd9bfe412da4b80d4742563b6c","1c6721b1f63f4d30ba7746ea8af02a52",22071696,1,-24,0,963,241,221,-20
"1c6721b1f63f4d30ba7746ea8af02a52","2ae94c0cea4d480a9d5dca8fb1d7b542",22071696,2,27,0,964,221,242,21
"2ae94c0cea4d480a9d5dca8fb1d7b542","1ebf23f9d994469a85206e4c7b1bf5f5",22071696,1,3,0,965,242,245,3
"1ebf23f9d994469a85206e4c7b1bf5f5","2ae94c0cea4d480a9d5dca8fb1d7b542",22071696,1,-3,0,966,245,242,-3
"2ae94c0cea4d480a9d5dca8fb1d7b542","1c6721b1f63f4d30ba7746ea8af02a52",22071696,2,-27,0,967,242,221,-21
"1c6721b1f63f4d30ba7746ea8af02a52","1ebf23f9d994469a85206e4c7b1bf5f5",22071696,1,30,0,970,221,245,24
"1ebf23f9d994469a85206e4c7b1bf5f5","1ebf23f9d994469a85206e4c7b1bf5f5",22071696,13,0,1,971,245,245,0
"1ebf23f9d994469a85206e4c7b1bf5f5","85ae675b83e8422da842cfd25596af99",22071696,1,1,0,984,245,246,1
"85ae675b83e8422da842cfd25596af99","85ae675b83e8422da842cfd25596af99",22071696,1,0,1,985,246,246,0
"85ae675b83e8422da842cfd25596af99","2ae94c0cea4d480a9d5dca8fb1d7b542",22071696,1,-4,0,986,246,242,-4
"2ae94c0cea4d480a9d5dca8fb1d7b542","30c9ba177afc49a695625d2bdec40207",22071696,1,9,0,987,242,250,8
"30c9ba177afc49a695625d2bdec40207","30c9ba177afc49a695625d2bdec40207",22071696,2,0,1,988,250,250,0
"30c9ba177afc49a695625d2bdec40207","00f61990949545828dd12f1303d47504",22071696,1,8,0,990,250,256,6
"00f61990949545828dd12f1303d47504","6e83e23f56544a19b94067c1c558d9c0",22071696,1,-11,0,991,256,247,-9
"6e83e23f56544a19b94067c1c558d9c0","00f61990949545828dd12f1303d47504",22071696,1,11,0,992,247,256,9
"00f61990949545828dd12f1303d47504","00f61990949545828dd12f1303d47504",22071696,1,0,1,993,256,256,0
"00f61990949545828dd12f1303d47504","ead7bb4b64e247d2ae632ab8a296b091",22071696,1,2,0,994,256,258,2
"ead7bb4b64e247d2ae632ab8a296b091","ead7bb4b64e247d2ae632ab8a296b091",22071696,8,0,1,1000,258,258,0
"ead7bb4b64e247d2ae632ab8a296b091","41b0048dde734bb280bac6116baa8e27",22071696,1,1,0,1003,258,259,1
"41b0048dde734bb280bac6116baa8e27","41b0048dde734bb280bac6116baa8e27",22071696,2,0,1,1004,259,259,0
"41b0048dde734bb280bac6116baa8e27","b41c5a094a604ee0915327da5cc0beb7",22071696,1,1,0,1006,259,260,1
"b41c5a094a604ee0915327da5cc0beb7","b41c5a094a604ee0915327da5cc0beb7",22071696,2,0,1,1007,260,260,0
"b41c5a094a604ee0915327da5cc0beb7","d546341988904f069cfa86b21457d9d9",22071696,1,-10,0,1009,260,251,-9
"d546341988904f069cfa86b21457d9d9","28c171777c52431ab6b925073bd63d46",22071696,1,15,0,1010,251,264,13
"28c171777c52431ab6b925073bd63d46","28c171777c52431ab6b925073bd63d46",22071696,11,0,1,1011,264,264,0
"28c171777c52431ab6b925073bd63d46","ac160db940cb49ae8579162b1d52bb5d",22071696,1,2,0,1022,264,266,2
"ac160db940cb49ae8579162b1d52bb5d","ac160db940cb49ae8579162b1d52bb5d",22071696,7,0,1,1023,266,266,0
"ac160db940cb49ae8579162b1d52bb5d","d989ebcfc12a4b669f0100dc1aa14f1e",22071696,1,-12,0,1030,266,255,-11
"d989ebcfc12a4b669f0100dc1aa14f1e","c6fd49b485cc4874b0bbdd9c6171e09c",22071696,1,15,0,1031,255,268,13
"c6fd49b485cc4874b0bbdd9c6171e09c","c6fd49b485cc4874b0bbdd9c6171e09c",22071696,3,0,1,1032,268,268,0
"c6fd49b485cc4874b0bbdd9c6171e09c","44240778a97c4af0937817499b75707b",22071696,1,1,0,1035,268,269,1
"44240778a97c4af0937817499b75707b","44240778a97c4af0937817499b75707b",22071696,2,0,1,1036,269,269,0
"44240778a97c4af0937817499b75707b","7aa76d3e993840d8805f097cbdbcd44b",22071696,1,-9,0,1038,269,261,-8
"7aa76d3e993840d8805f097cbdbcd44b","865a4d3b43374da7944dc7d397f566d9",22071696,1,12,0,1039,261,271,10
"865a4d3b43374da7944dc7d397f566d9","865a4d3b43374da7944dc7d397f566d9",22071696,2,0,1,1040,271,271,0
"865a4d3b43374da7944dc7d397f566d9","2ae94c0cea4d480a9d5dca8fb1d7b542",22071696,1,-35,0,1042,271,242,-29
"2ae94c0cea4d480a9d5dca8fb1d7b542","0d987bed3ffa4ed0b9a2e62e97b7b30f",22071696,3,38,0,1043,242,272,30
"0d987bed3ffa4ed0b9a2e62e97b7b30f","2ae94c0cea4d480a9d5dca8fb1d7b542",22071696,2,-38,0,1044,272,242,-30
"0d987bed3ffa4ed0b9a2e62e97b7b30f","7028800abe7d4e27b613d1d6cbe26bf7",22071696,1,-8,0,1046,272,267,-5
"7028800abe7d4e27b613d1d6cbe26bf7","7aa76d3e993840d8805f097cbdbcd44b",22071696,1,-7,0,1047,267,261,-6
"7aa76d3e993840d8805f097cbdbcd44b","0d987bed3ffa4ed0b9a2e62e97b7b30f",22071696,1,15,0,1048,261,272,11
"0d987bed3ffa4ed0b9a2e62e97b7b30f","82ae07bc0c9b4570a41799290d1ef399",22071696,1,4,0,1051,272,275,3
"82ae07bc0c9b4570a41799290d1ef399","bb5a47f5ea01454a8b79455422d3b9da",22071696,2,6,0,1052,275,280,5
"bb5a47f5ea01454a8b79455422d3b9da","bb5a47f5ea01454a8b79455422d3b9da",22071696,83,0,1,1053,280,280,0
"bb5a47f5ea01454a8b79455422d3b9da","94cecc3f1e7d484b8e068e79241dfd73",22071696,2,3,0,1060,280,281,1
"94cecc3f1e7d484b8e068e79241dfd73","0d987bed3ffa4ed0b9a2e62e97b7b30f",22071696,2,-13,0,1061,281,272,-9
"0d987bed3ffa4ed0b9a2e62e97b7b30f","a37477c4e4c14169ad44b06b493007f6",22071696,2,15,0,1062,272,283,11
"a37477c4e4c14169ad44b06b493007f6","94cecc3f1e7d484b8e068e79241dfd73",22071696,1,-2,0,1063,283,281,-2
"94cecc3f1e7d484b8e068e79241dfd73","fab84b4fab5940efb4ea868ef8d09396",22071696,1,5,0,1064,281,284,3
"fab84b4fab5940efb4ea868ef8d09396","4a29443515bb404cb8924e1c60a63b73",22071696,3,4,0,1065,284,285,1
"4a29443515bb404cb8924e1c60a63b73","fab84b4fab5940efb4ea868ef8d09396",22071696,2,-4,0,1066,285,284,-1
"fab84b4fab5940efb4ea868ef8d09396","208c9b2796c944db8dacaa96082520ea",22071696,1,7,0,1067,284,288,4
"208c9b2796c944db8dacaa96082520ea","208c9b2796c944db8dacaa96082520ea",22071696,6,0,1,1068,288,288,0
"208c9b2796c944db8dacaa96082520ea","4a29443515bb404cb8924e1c60a63b73",22071696,4,-3,0,1069,288,285,-3
"4a29443515bb404cb8924e1c60a63b73","208c9b2796c944db8dacaa96082520ea",22071696,3,3,0,1070,285,288,3
"4a29443515bb404cb8924e1c60a63b73","4a29443515bb404cb8924e1c60a63b73",22071696,1,0,1,1072,285,285,0
"208c9b2796c944db8dacaa96082520ea","fab84b4fab5940efb4ea868ef8d09396",22071696,1,-7,0,1074,288,284,-4
"4a29443515bb404cb8924e1c60a63b73","6a9a3b5bde4a48daa896fe8c06eca56f",22071696,1,5,0,1082,285,289,4
"6a9a3b5bde4a48daa896fe8c06eca56f","208c9b2796c944db8dacaa96082520ea",22071696,1,-2,0,1083,289,288,-1
"4a29443515bb404cb8924e1c60a63b73","7669a956527947d0add87455277e80b4",22071696,1,7,0,1088,285,291,6
"7669a956527947d0add87455277e80b4","7669a956527947d0add87455277e80b4",22071696,1,0,1,1089,291,291,0
"7669a956527947d0add87455277e80b4","869e967078f04da18dd0b0b9389a7424",22071696,1,3,0,1090,291,293,2
"869e967078f04da18dd0b0b9389a7424","6a9a3b5bde4a48daa896fe8c06eca56f",22071696,1,-5,0,1091,293,289,-4
"6a9a3b5bde4a48daa896fe8c06eca56f","869e967078f04da18dd0b0b9389a7424",22071696,1,5,0,1092,289,293,4
"869e967078f04da18dd0b0b9389a7424","869e967078f04da18dd0b0b9389a7424",22071696,6,0,1,1093,293,293,0
"869e967078f04da18dd0b0b9389a7424","51ab6291537748fab90d519aa09889d6",22071696,1,2,0,1099,293,295,2
"51ab6291537748fab90d519aa09889d6","51ab6291537748fab90d519aa09889d6",22071696,5,0,1,1100,295,295,0
"51ab6291537748fab90d519aa09889d6","34a6e49023fc4465bd5ca604330bbd1c",22071696,1,-3,0,1105,295,292,-3
"34a6e49023fc4465bd5ca604330bbd1c","ba0e59461bfb4a44b7b1c28a01f8d3b3",22071696,1,9,0,1106,292,299,7
"ba0e59461bfb4a44b7b1c28a01f8d3b3","21592f2a9e9c4b2f8c66ec5dbcbf6a2b",22071696,1,-4,0,1107,299,296,-3
"21592f2a9e9c4b2f8c66ec5dbcbf6a2b","ba0e59461bfb4a44b7b1c28a01f8d3b3",22071696,1,4,0,1108,296,299,3
"ba0e59461bfb4a44b7b1c28a01f8d3b3","ba0e59461bfb4a44b7b1c28a01f8d3b3",22071696,1,0,1,1109,299,299,0
"ba0e59461bfb4a44b7b1c28a01f8d3b3","0e0b36e731a645e7b1b8a88f5031ca38",22071696,1,2,0,1110,299,301,2
"0e0b36e731a645e7b1b8a88f5031ca38","0e0b36e731a645e7b1b8a88f5031ca38",22071696,5,0,1,1111,301,301,0
"0e0b36e731a645e7b1b8a88f5031ca38","a66a144637284c21afc6de17fea4bfb8",22071696,1,1,0,1116,301,302,1
"a66a144637284c21afc6de17fea4bfb8","a66a144637284c21afc6de17fea4bfb8",22071696,2,0,1,1117,302,302,0
"a66a144637284c21afc6de17fea4bfb8","7646a919d7e64fa990bca9b024ff089d",22071696,1,-4,0,1119,302,298,-4
"7646a919d7e64fa990bca9b024ff089d","e390b575229748ea8aac9364efe2bf00",22071696,1,7,0,1120,298,304,6
"e390b575229748ea8aac9364efe2bf00","e390b575229748ea8aac9364efe2bf00",22071696,1,0,1,1121,304,304,0
"e390b575229748ea8aac9364efe2bf00","3434c10e561d488a914e0f7d71907abd",22071696,1,3,0,1122,304,305,1
"3434c10e561d488a914e0f7d71907abd","4a29443515bb404cb8924e1c60a63b73",22071696,1,-27,0,1123,305,285,-20
"4a29443515bb404cb8924e1c60a63b73","53e7e900392747ccad52e711ab0f80d8",22071696,1,29,0,1124,285,307,22
"53e7e900392747ccad52e711ab0f80d8","53e7e900392747ccad52e711ab0f80d8",22071696,1,0,1,1125,307,307,0
"53e7e900392747ccad52e711ab0f80d8","3434c10e561d488a914e0f7d71907abd",22071696,1,-2,0,1126,307,305,-2
"3434c10e561d488a914e0f7d71907abd","130acc2aeb0448fdbb2de63bc5cebe5b",22071696,1,5,0,1127,305,309,4
"130acc2aeb0448fdbb2de63bc5cebe5b","130acc2aeb0448fdbb2de63bc5cebe5b",22071696,1,0,1,1128,309,309,0
"130acc2aeb0448fdbb2de63bc5cebe5b","9c062b3251034ebe90f5054e2a3b5120",22071696,1,2,0,1129,309,311,2
"9c062b3251034ebe90f5054e2a3b5120","9c062b3251034ebe90f5054e2a3b5120",22071696,2,0,1,1130,311,311,0
"9c062b3251034ebe90f5054e2a3b5120","ea859f8207e44537889daeaba13ac2e8",22071696,1,1,0,1132,311,312,1
"ea859f8207e44537889daeaba13ac2e8","ea859f8207e44537889daeaba13ac2e8",22071696,1,0,1,1133,312,312,0
"ea859f8207e44537889daeaba13ac2e8","56d94971a7a94257aa330183a8ebd0ea",22071696,1,1,0,1134,312,313,1
"56d94971a7a94257aa330183a8ebd0ea","56d94971a7a94257aa330183a8ebd0ea",22071696,1,0,1,1135,313,313,0
"56d94971a7a94257aa330183a8ebd0ea","141c0df6cd1946539aadd1c9b7068cd4",22071696,1,-5,0,1136,313,308,-5
"141c0df6cd1946539aadd1c9b7068cd4","13255e63e0aa4abf85e5211bf613d43e",22071696,1,10,0,1137,308,317,9
"13255e63e0aa4abf85e5211bf613d43e","13255e63e0aa4abf85e5211bf613d43e",22071696,1,0,1,1138,317,317,0
"13255e63e0aa4abf85e5211bf613d43e","0c787d16c9504873b1a4d903cec09948",22071696,1,-3,0,1139,317,314,-3
"0c787d16c9504873b1a4d903cec09948","86c27d40179e419c8e9d150fb6afa5d0",22071696,1,6,0,1140,314,319,5
"86c27d40179e419c8e9d150fb6afa5d0","86c27d40179e419c8e9d150fb6afa5d0",22071696,1,0,1,1141,319,319,0
"86c27d40179e419c8e9d150fb6afa5d0","47edbb64109243e6b0f8f64cdef90c6c",22071696,1,8,0,1142,319,326,7
"47edbb64109243e6b0f8f64cdef90c6c","24f1363179ad4aaa965484a78471912b",22071696,1,-3,0,1143,326,323,-3
"24f1363179ad4aaa965484a78471912b","8d7e0b55cf9849cda222a0f2440cec55",22071696,1,-6,0,1144,323,318,-5
"8d7e0b55cf9849cda222a0f2440cec55","24f1363179ad4aaa965484a78471912b",22071696,1,6,0,1145,318,323,5
"24f1363179ad4aaa965484a78471912b","24f1363179ad4aaa965484a78471912b",22071696,2,0,1,1146,323,323,0
"24f1363179ad4aaa965484a78471912b","3628bdce1dd2429ba924d2d4d09448d2",22071696,1,-1,0,1148,323,322,-1
"3628bdce1dd2429ba924d2d4d09448d2","56b3fd1a212a4764be39d979fde3326e",22071696,1,7,0,1149,322,328,6
"56b3fd1a212a4764be39d979fde3326e","56b3fd1a212a4764be39d979fde3326e",22071696,1,0,1,1150,328,328,0
"56b3fd1a212a4764be39d979fde3326e","0c4079457ede49e3aeb5e86ed84bdf35",22071696,1,3,0,1151,328,329,1
"0c4079457ede49e3aeb5e86ed84bdf35","3434c10e561d488a914e0f7d71907abd",22071696,1,-31,0,1152,329,305,-24
"3434c10e561d488a914e0f7d71907abd","38aea304b4fa46e1b29bb72f5cea4c93",22071696,1,33,0,1153,305,331,26
"38aea304b4fa46e1b29bb72f5cea4c93","38aea304b4fa46e1b29bb72f5cea4c93",22071696,7,0,1,1154,331,331,0
"38aea304b4fa46e1b29bb72f5cea4c93","e36d261332f14e79bb4b467aceaeb9b5",22071696,1,2,0,1156,331,333,2
"e36d261332f14e79bb4b467aceaeb9b5","e36d261332f14e79bb4b467aceaeb9b5",22071696,1,0,1,1157,333,333,0
"e36d261332f14e79bb4b467aceaeb9b5","c7e89b9d04744d2eab742fc24e3ef1ae",22071696,1,1,0,1158,333,334,1
"c7e89b9d04744d2eab742fc24e3ef1ae","c7e89b9d04744d2eab742fc24e3ef1ae",22071696,5,0,1,1159,334,334,0
"c7e89b9d04744d2eab742fc24e3ef1ae","fe49f8054b374a0ea4bb266ed135ff62",22071696,1,1,0,1164,334,335,1
"fe49f8054b374a0ea4bb266ed135ff62","fe49f8054b374a0ea4bb266ed135ff62",22071696,2,0,1,1165,335,335,0
"fe49f8054b374a0ea4bb266ed135ff62","d0a8f74af98642fe8360d22c42e45117",22071696,1,1,0,1167,335,336,1
"d0a8f74af98642fe8360d22c42e45117","d0a8f74af98642fe8360d22c42e45117",22071696,2,0,1,1168,336,336,0
"d0a8f74af98642fe8360d22c42e45117","bbc5139ca9024389a94db3a6f47dcff6",22071696,1,7,0,1170,336,341,5
"bbc5139ca9024389a94db3a6f47dcff6","b8b9418ab322418d9db9b40d96af873a",22071696,1,-5,0,1171,341,337,-4
"b8b9418ab322418d9db9b40d96af873a","0c4079457ede49e3aeb5e86ed84bdf35",22071696,1,-9,0,1172,337,329,-8
"0c4079457ede49e3aeb5e86ed84bdf35","c2490bc612d146edbe786556fab3651b",22071696,1,13,0,1173,329,340,11
"c2490bc612d146edbe786556fab3651b","a7c6339ca1da4368a18d471f0519f877",22071696,1,-2,0,1174,340,339,-1
"a7c6339ca1da4368a18d471f0519f877","a7c6339ca1da4368a18d471f0519f877",22071696,1,0,1,1175,339,339,0
"a7c6339ca1da4368a18d471f0519f877","b8b9418ab322418d9db9b40d96af873a",22071696,1,-2,0,1176,339,337,-2
"b8b9418ab322418d9db9b40d96af873a","bbc5139ca9024389a94db3a6f47dcff6",22071696,1,5,0,1177,337,341,4
"bbc5139ca9024389a94db3a6f47dcff6","bbc5139ca9024389a94db3a6f47dcff6",22071696,1,0,1,1178,341,341,0
"bbc5139ca9024389a94db3a6f47dcff6","4ee6ca9019ab4a1ab323f98094a9bd77",22071696,1,2,0,1179,341,343,2
"4ee6ca9019ab4a1ab323f98094a9bd77","4ee6ca9019ab4a1ab323f98094a9bd77",22071696,2,0,1,1180,343,343,0
"4ee6ca9019ab4a1ab323f98094a9bd77","b37947176785476f8b29d49a851366dc",22071696,1,1,0,1182,343,344,1
"b37947176785476f8b29d49a851366dc","b37947176785476f8b29d49a851366dc",22071696,2,0,1,1183,344,344,0
"b37947176785476f8b29d49a851366dc","fcea5b10d5a14a3b9324ffece8f6e1e5",22071696,1,1,0,1185,344,345,1
"fcea5b10d5a14a3b9324ffece8f6e1e5","fcea5b10d5a14a3b9324ffece8f6e1e5",22071696,2,0,1,1186,345,345,0
"fcea5b10d5a14a3b9324ffece8f6e1e5","c2490bc612d146edbe786556fab3651b",22071696,1,-5,0,1188,345,340,-5
"c2490bc612d146edbe786556fab3651b","6ac8bb048b854999a47edb35fe627f11",22071696,1,8,0,1189,340,347,7
"6ac8bb048b854999a47edb35fe627f11","6ac8bb048b854999a47edb35fe627f11",22071696,1,0,1,1190,347,347,0
"6ac8bb048b854999a47edb35fe627f11","0c4079457ede49e3aeb5e86ed84bdf35",22071696,1,-21,0,1191,347,329,-18
"0c4079457ede49e3aeb5e86ed84bdf35","30ead9794d4847abaf222ca966cc8630",22071696,2,24,0,1192,329,348,19
"30ead9794d4847abaf222ca966cc8630","09b9678ddc3d452ea4a3d46e15826065",22071696,1,5,0,1193,348,353,5
"09b9678ddc3d452ea4a3d46e15826065","c20993c944444fe085345591a8bd837e",22071696,2,-2,0,1194,353,351,-2
"c20993c944444fe085345591a8bd837e","eff0de7f2dbb42dfa1a2e686efab5b6d",22071696,1,3,0,1195,351,354,3
"eff0de7f2dbb42dfa1a2e686efab5b6d","897b7f51242c44aab2205c72fdcbf4cd",22071696,1,-2,0,1196,354,352,-2
"897b7f51242c44aab2205c72fdcbf4cd","c20993c944444fe085345591a8bd837e",22071696,1,-1,0,1197,352,351,-1
"c20993c944444fe085345591a8bd837e","c20993c944444fe085345591a8bd837e",22071696,4,0,1,1198,351,351,0
"c20993c944444fe085345591a8bd837e","897b7f51242c44aab2205c72fdcbf4cd",22071696,3,1,0,1201,351,352,1
"897b7f51242c44aab2205c72fdcbf4cd","897b7f51242c44aab2205c72fdcbf4cd",22071696,4,0,1,1202,352,352,0
"897b7f51242c44aab2205c72fdcbf4cd","09b9678ddc3d452ea4a3d46e15826065",22071696,2,1,0,1205,352,353,1
"09b9678ddc3d452ea4a3d46e15826065","09b9678ddc3d452ea4a3d46e15826065",22071696,4,0,1,1206,353,353,0
"09b9678ddc3d452ea4a3d46e15826065","eff0de7f2dbb42dfa1a2e686efab5b6d",22071696,2,1,0,1209,353,354,1
"eff0de7f2dbb42dfa1a2e686efab5b6d","eff0de7f2dbb42dfa1a2e686efab5b6d",22071696,4,0,1,1210,354,354,0
"eff0de7f2dbb42dfa1a2e686efab5b6d","30ead9794d4847abaf222ca966cc8630",22071696,1,-6,0,1213,354,348,-6
"30ead9794d4847abaf222ca966cc8630","2fe14166dc9642c3bc666b86a57f943d",22071696,2,10,0,1214,348,357,9
"2fe14166dc9642c3bc666b86a57f943d","2fe14166dc9642c3bc666b86a57f943d",22071696,3,0,1,1215,357,357,0
"2fe14166dc9642c3bc666b86a57f943d","1ba8fef685d74a8194b9db252eb704fb",22071696,1,-2,0,1216,357,355,-2
"1ba8fef685d74a8194b9db252eb704fb","30ead9794d4847abaf222ca966cc8630",22071696,1,-8,0,1217,355,348,-7
"2fe14166dc9642c3bc666b86a57f943d","44421dd1e13a47a388c4a19834b744c7",22071696,1,2,0,1221,357,359,2
"44421dd1e13a47a388c4a19834b744c7","44421dd1e13a47a388c4a19834b744c7",22071696,2,0,1,1222,359,359,0
"44421dd1e13a47a388c4a19834b744c7","cb5fc7ef85d547c4be1a7439d0bf6052",22071696,1,1,0,1224,359,360,1
"cb5fc7ef85d547c4be1a7439d0bf6052","cb5fc7ef85d547c4be1a7439d0bf6052",22071696,2,0,1,1225,360,360,0
"cb5fc7ef85d547c4be1a7439d0bf6052","0a8f150a4cf747acbde62f4721823da3",22071696,1,1,0,1227,360,361,1
"0a8f150a4cf747acbde62f4721823da3","0a8f150a4cf747acbde62f4721823da3",22071696,2,0,1,1228,361,361,0
"0a8f150a4cf747acbde62f4721823da3","ab8fdad974ae471f9f24c3f9dd04462e",22071696,1,1,0,1230,361,362,1
"ab8fdad974ae471f9f24c3f9dd04462e","ab8fdad974ae471f9f24c3f9dd04462e",22071696,2,0,1,1231,362,362,0
"ab8fdad974ae471f9f24c3f9dd04462e","52580888dadb4fe3baa795683ea227bd",22071696,1,3,0,1233,362,364,2
"52580888dadb4fe3baa795683ea227bd","1ba8fef685d74a8194b9db252eb704fb",22071696,1,-10,0,1234,364,355,-9
"1ba8fef685d74a8194b9db252eb704fb","52580888dadb4fe3baa795683ea227bd",22071696,1,10,0,1235,355,364,9
"52580888dadb4fe3baa795683ea227bd","52580888dadb4fe3baa795683ea227bd",22071696,4,0,1,1236,364,364,0
"52580888dadb4fe3baa795683ea227bd","30ead9794d4847abaf222ca966cc8630",22071696,1,-18,0,1237,364,348,-16
"30ead9794d4847abaf222ca966cc8630","f00179e251a045b39c3f7a54f9aa4acc",22071696,1,17,0,1238,348,363,15
"f00179e251a045b39c3f7a54f9aa4acc","30ead9794d4847abaf222ca966cc8630",22071696,1,-17,0,1239,363,348,-15
"30ead9794d4847abaf222ca966cc8630","52580888dadb4fe3baa795683ea227bd",22071696,2,18,0,1240,348,364,16
"52580888dadb4fe3baa795683ea227bd","492a3bc6a1254f23a7998587961b22a4",22071696,1,3,0,1244,364,366,2
"492a3bc6a1254f23a7998587961b22a4","f00179e251a045b39c3f7a54f9aa4acc",22071696,1,-4,0,1245,366,363,-3
"f00179e251a045b39c3f7a54f9aa4acc","492a3bc6a1254f23a7998587961b22a4",22071696,2,4,0,1246,363,366,3
"492a3bc6a1254f23a7998587961b22a4","492a3bc6a1254f23a7998587961b22a4",22071696,5,0,1,1247,366,366,0
"492a3bc6a1254f23a7998587961b22a4","072a190fd302456290895f9f04d6940a",22071696,2,-1,0,1252,366,365,-1
"072a190fd302456290895f9f04d6940a","30ead9794d4847abaf222ca966cc8630",22071696,1,-20,0,1253,365,348,-17
"52580888dadb4fe3baa795683ea227bd","f00179e251a045b39c3f7a54f9aa4acc",22071696,1,-1,0,1255,364,363,-1
"072a190fd302456290895f9f04d6940a","cfa457d1743848e4bb5e4beced6448ed",22071696,1,5,0,1258,365,369,4
"cfa457d1743848e4bb5e4beced6448ed","cfa457d1743848e4bb5e4beced6448ed",22071696,1,0,1,1259,369,369,0
"cfa457d1743848e4bb5e4beced6448ed","30ead9794d4847abaf222ca966cc8630",22071696,1,-25,0,1260,369,348,-21
"30ead9794d4847abaf222ca966cc8630","b71bac264efb4abd97015447bd490db6",22071696,2,28,0,1261,348,370,22
"b71bac264efb4abd97015447bd490db6","8d448d625b024c82a5eb240bbd7431d6",22071696,6,5,0,1262,370,374,4
"8d448d625b024c82a5eb240bbd7431d6","b71bac264efb4abd97015447bd490db6",22071696,5,-5,0,1263,374,370,-4
"8d448d625b024c82a5eb240bbd7431d6","8d448d625b024c82a5eb240bbd7431d6",22071696,78,0,1,1265,374,374,0
"b71bac264efb4abd97015447bd490db6","b71bac264efb4abd97015447bd490db6",22071696,1,0,1,1272,370,370,0
"b71bac264efb4abd97015447bd490db6","1b4550d0dab04078b3bf08a655345bdc",22071696,1,4,0,1273,370,373,3
"1b4550d0dab04078b3bf08a655345bdc","8d448d625b024c82a5eb240bbd7431d6",22071696,1,1,0,1274,373,374,1
"b71bac264efb4abd97015447bd490db6","d6d02b6ef04e4f17805504500b8ce441",22071696,2,8,0,1283,370,375,5
"d6d02b6ef04e4f17805504500b8ce441","d6d02b6ef04e4f17805504500b8ce441",22071696,6,0,1,1284,375,375,0
"d6d02b6ef04e4f17805504500b8ce441","66baf19b6b904b70922329068c63746d",22071696,1,4,0,1289,375,376,1
"66baf19b6b904b70922329068c63746d","7f544639412e40a9ba27f43b415362ab",22071696,2,2,0,1290,376,378,2
"7f544639412e40a9ba27f43b415362ab","7f544639412e40a9ba27f43b415362ab",22071696,2,0,1,1291,378,378,0
"7f544639412e40a9ba27f43b415362ab","66baf19b6b904b70922329068c63746d",22071696,1,-2,0,1293,378,376,-2
"7f544639412e40a9ba27f43b415362ab","c2fca3669923477ab966ded303dea31c",22071696,1,6,0,1295,378,383,5
"c2fca3669923477ab966ded303dea31c","d5ae8642e15b46b8bd298b02274d4e9c",22071696,1,-4,0,1296,383,380,-3
"d5ae8642e15b46b8bd298b02274d4e9c","d5ae8642e15b46b8bd298b02274d4e9c",22071696,1,0,1,1297,380,380,0
"d5ae8642e15b46b8bd298b02274d4e9c","a0d10309a2dd456289147f84be9d37f9",22071696,1,1,0,1298,380,381,1
"a0d10309a2dd456289147f84be9d37f9","a0d10309a2dd456289147f84be9d37f9",22071696,2,0,1,1299,381,381,0
"a0d10309a2dd456289147f84be9d37f9","0fcbc3ca07b144138b8d85da581f09a8",22071696,1,1,0,1301,381,382,1
"0fcbc3ca07b144138b8d85da581f09a8","0fcbc3ca07b144138b8d85da581f09a8",22071696,2,0,1,1302,382,382,0
"0fcbc3ca07b144138b8d85da581f09a8","66baf19b6b904b70922329068c63746d",22071696,1,-6,0,1304,382,376,-6
"66baf19b6b904b70922329068c63746d","4890121ce5d74576b4632b77cfc23398",22071696,1,14,0,1305,376,388,12
"4890121ce5d74576b4632b77cfc23398","c2fca3669923477ab966ded303dea31c",22071696,1,-6,0,1306,388,383,-5
"c2fca3669923477ab966ded303dea31c","4890121ce5d74576b4632b77cfc23398",22071696,1,6,0,1307,383,388,5
"4890121ce5d74576b4632b77cfc23398","96bb2b3e85a34d8b9544514e89f6fe97",22071696,1,3,0,1308,388,390,2
"96bb2b3e85a34d8b9544514e89f6fe97","18d3b836dd804224883cc9180b60a8e1",22071696,1,-4,0,1309,390,387,-3
"18d3b836dd804224883cc9180b60a8e1","96bb2b3e85a34d8b9544514e89f6fe97",22071696,1,4,0,1310,387,390,3
"96bb2b3e85a34d8b9544514e89f6fe97","ac4e9b54acfe4670b4634859c7263cb5",22071696,1,2,0,1311,390,392,2
"ac4e9b54acfe4670b4634859c7263cb5","ac4e9b54acfe4670b4634859c7263cb5",22071696,1,0,1,1312,392,392,0
"ac4e9b54acfe4670b4634859c7263cb5","17f95d18bab743888e1736033dc3384d",22071696,1,-3,0,1313,392,389,-3
"17f95d18bab743888e1736033dc3384d","6f8881a745ac4c358a68b92c3b4abe81",22071696,1,6,0,1314,389,394,5
"6f8881a745ac4c358a68b92c3b4abe81","6f8881a745ac4c358a68b92c3b4abe81",22071696,2,0,1,1315,394,394,0
"6f8881a745ac4c358a68b92c3b4abe81","f7002c8484354eceac57bc7bd62c76c1",22071696,1,-1,0,1317,394,393,-1
"f7002c8484354eceac57bc7bd62c76c1","44a277ea44dc4ae689fab4b82f0b4098",22071696,1,5,0,1318,393,397,4
"44a277ea44dc4ae689fab4b82f0b4098","44a277ea44dc4ae689fab4b82f0b4098",22071696,3,0,1,1319,397,397,0
"44a277ea44dc4ae689fab4b82f0b4098","0c12af0a4e7f4002852cf84b2537c161",22071696,1,-2,0,1322,397,395,-2
"0c12af0a4e7f4002852cf84b2537c161","859e0b8d71694b12befb69ee698138f9",22071696,1,5,0,1323,395,399,4
"859e0b8d71694b12befb69ee698138f9","859e0b8d71694b12befb69ee698138f9",22071696,3,0,1,1324,399,399,0
"859e0b8d71694b12befb69ee698138f9","2b09a08242b54983aec7063990fb3f66",22071696,1,3,0,1327,399,400,1
"2b09a08242b54983aec7063990fb3f66","66baf19b6b904b70922329068c63746d",22071696,1,-32,0,1328,400,376,-24
"66baf19b6b904b70922329068c63746d","2b09a08242b54983aec7063990fb3f66",22071696,1,32,0,1329,376,400,24
"2b09a08242b54983aec7063990fb3f66","2b09a08242b54983aec7063990fb3f66",22071696,5,0,1,1330,400,400,0
"2b09a08242b54983aec7063990fb3f66","1f471b7a883a4df48211e8c6a81b59a7",22071696,1,1,0,1335,400,401,1
"1f471b7a883a4df48211e8c6a81b59a7","1f471b7a883a4df48211e8c6a81b59a7",22071696,1,0,1,1336,401,401,0
"1f471b7a883a4df48211e8c6a81b59a7","2b09a08242b54983aec7063990fb3f66",22071696,1,-1,0,1337,401,400,-1
"2b09a08242b54983aec7063990fb3f66","9de0d567bfa84fe5b77cb76f4a76a5d1",22071696,1,5,0,1338,400,404,4
"9de0d567bfa84fe5b77cb76f4a76a5d1","9de0d567bfa84fe5b77cb76f4a76a5d1",22071696,1,0,1,1339,404,404,0
"9de0d567bfa84fe5b77cb76f4a76a5d1","1157bd665ec4472fb58b751dc5099355",22071696,1,-1,0,1340,404,403,-1
"1157bd665ec4472fb58b751dc5099355","3c8a22d2f9c146ea956609e3ed4f2559",22071696,1,3,0,1341,403,405,2
"3c8a22d2f9c146ea956609e3ed4f2559","58fc9094275e4c49be3f4ba6d4acc0a4",22071696,1,2,0,1342,405,406,1
"58fc9094275e4c49be3f4ba6d4acc0a4","2b09a08242b54983aec7063990fb3f66",22071696,1,-9,0,1343,406,400,-6
"2b09a08242b54983aec7063990fb3f66","58fc9094275e4c49be3f4ba6d4acc0a4",22071696,1,9,0,1344,400,406,6
"58fc9094275e4c49be3f4ba6d4acc0a4","58fc9094275e4c49be3f4ba6d4acc0a4",22071696,15,0,1,1345,406,406,0
"58fc9094275e4c49be3f4ba6d4acc0a4","c1c1be90b2b14c1ab4a5e1ee3c241902",22071696,1,1,0,1360,406,407,1
"c1c1be90b2b14c1ab4a5e1ee3c241902","c1c1be90b2b14c1ab4a5e1ee3c241902",22071696,5,0,1,1361,407,407,0
"c1c1be90b2b14c1ab4a5e1ee3c241902","58fc9094275e4c49be3f4ba6d4acc0a4",22071696,1,-1,0,1366,407,406,-1
"58fc9094275e4c49be3f4ba6d4acc0a4","02b3a1bead9244c1ba2f857c7da8f82a",22071696,1,3,0,1367,406,408,2
"02b3a1bead9244c1ba2f857c7da8f82a","02b3a1bead9244c1ba2f857c7da8f82a",22071696,19,0,1,1368,408,408,0
"02b3a1bead9244c1ba2f857c7da8f82a","6a5f020451db426dacba9e2ea3fcc62a",22071696,5,3,0,1387,408,410,2
"6a5f020451db426dacba9e2ea3fcc62a","02b3a1bead9244c1ba2f857c7da8f82a",22071696,2,-3,0,1388,410,408,-2
"6a5f020451db426dacba9e2ea3fcc62a","6206fc6479014bb193084c32409dc1b9",22071696,1,-2,0,1390,410,409,-1
"6206fc6479014bb193084c32409dc1b9","6206fc6479014bb193084c32409dc1b9",22071696,1,0,1,1391,409,409,0
"6206fc6479014bb193084c32409dc1b9","02b3a1bead9244c1ba2f857c7da8f82a",22071696,1,-1,0,1392,409,408,-1
"6a5f020451db426dacba9e2ea3fcc62a","6a5f020451db426dacba9e2ea3fcc62a",22071696,11,0,1,1394,410,410,0
"6a5f020451db426dacba9e2ea3fcc62a","33a9d248b2e44588a5b07fc1342b9bc2",22071696,2,2,0,1404,410,411,1
"33a9d248b2e44588a5b07fc1342b9bc2","33a9d248b2e44588a5b07fc1342b9bc2",22071696,18,0,1,1405,411,411,0
"33a9d248b2e44588a5b07fc1342b9bc2","02b3a1bead9244c1ba2f857c7da8f82a",22071696,1,-5,0,1421,411,408,-3
"02b3a1bead9244c1ba2f857c7da8f82a","2b09a08242b54983aec7063990fb3f66",22071696,1,-12,0,1422,408,400,-8
"2b09a08242b54983aec7063990fb3f66","02b3a1bead9244c1ba2f857c7da8f82a",22071696,1,12,0,1423,400,408,8
"33a9d248b2e44588a5b07fc1342b9bc2","c6f26bd420634f1cb7989e76fe6b16c0",22071696,1,1,0,1431,411,412,1
"c6f26bd420634f1cb7989e76fe6b16c0","c6f26bd420634f1cb7989e76fe6b16c0",22071696,5,0,1,1432,412,412,0
"c6f26bd420634f1cb7989e76fe6b16c0","2a65ee6e2ac64f6a8a55fbe5373ec763",22071696,1,1,0,1437,412,413,1
"2a65ee6e2ac64f6a8a55fbe5373ec763","2a65ee6e2ac64f6a8a55fbe5373ec763",22071696,2,0,1,1438,413,413,0
"2a65ee6e2ac64f6a8a55fbe5373ec763","33a9d248b2e44588a5b07fc1342b9bc2",22071696,1,-2,0,1440,413,411,-2
"33a9d248b2e44588a5b07fc1342b9bc2","1fd0f6dadbc14ebc965faf6122190b96",22071696,1,5,0,1441,411,415,4
"1fd0f6dadbc14ebc965faf6122190b96","1fd0f6dadbc14ebc965faf6122190b96",22071696,1,0,1,1442,415,415,0
"1fd0f6dadbc14ebc965faf6122190b96","687055dad9fc40c3982478fe33ec01bf",22071696,1,-1,0,1443,415,414,-1
"687055dad9fc40c3982478fe33ec01bf","2add1669f08d4101913db15f8c23b3b7",22071696,1,3,0,1444,414,416,2
"2add1669f08d4101913db15f8c23b3b7","2add1669f08d4101913db15f8c23b3b7",22071696,1,0,1,1445,416,416,0
"2add1669f08d4101913db15f8c23b3b7","a2b4bd40cee2481ebd3fc179d6a5cd62",22071696,1,3,0,1446,416,417,1
"a2b4bd40cee2481ebd3fc179d6a5cd62","2b09a08242b54983aec7063990fb3f66",22071696,1,-27,0,1447,417,400,-17
"2b09a08242b54983aec7063990fb3f66","e34e59dce2204f228f3a84b6725df60f",22071696,1,29,0,1448,400,419,19
"e34e59dce2204f228f3a84b6725df60f","e34e59dce2204f228f3a84b6725df60f",22071696,1,0,1,1449,419,419,0
"e34e59dce2204f228f3a84b6725df60f","bec48fc2e1294c7eb3d0aca780d731b8",22071696,1,2,0,1450,419,420,1
"bec48fc2e1294c7eb3d0aca780d731b8","a2b4bd40cee2481ebd3fc179d6a5cd62",22071696,2,-4,0,1451,420,417,-3
"a2b4bd40cee2481ebd3fc179d6a5cd62","bec48fc2e1294c7eb3d0aca780d731b8",22071696,2,4,0,1452,417,420,3
"bec48fc2e1294c7eb3d0aca780d731b8","bec48fc2e1294c7eb3d0aca780d731b8",22071696,2,0,1,1455,420,420,0
"bec48fc2e1294c7eb3d0aca780d731b8","dbde19fcce2a4c1abdc7f685c293a23f",22071696,1,3,0,1457,420,422,2
"dbde19fcce2a4c1abdc7f685c293a23f","a24600b0e49245f6bdba8c893cfeddb0",22071696,1,4,0,1458,422,425,3
"a24600b0e49245f6bdba8c893cfeddb0","a24600b0e49245f6bdba8c893cfeddb0",22071696,2,0,1,1459,425,425,0
"a24600b0e49245f6bdba8c893cfeddb0","a2b4bd40cee2481ebd3fc179d6a5cd62",22071696,1,-11,0,1461,425,417,-8
"a2b4bd40cee2481ebd3fc179d6a5cd62","24cf8786024543f19b89bc20034e60d7",22071696,1,18,0,1462,417,428,11
"24cf8786024543f19b89bc20034e60d7","f2a73be2f46840b182d7bd095378004e",22071696,1,1,0,1463,428,429,1
"f2a73be2f46840b182d7bd095378004e","f2a73be2f46840b182d7bd095378004e",22071696,1,0,1,1464,429,429,0
"f2a73be2f46840b182d7bd095378004e","604551fd4266430cb860fef58fa7dd61",22071696,1,1,0,1465,429,430,1
"604551fd4266430cb860fef58fa7dd61","604551fd4266430cb860fef58fa7dd61",22071696,8,0,1,1466,430,430,0
"604551fd4266430cb860fef58fa7dd61","dce46f8904594a62a6377a3587aaa663",22071696,1,2,0,1474,430,431,1
"dce46f8904594a62a6377a3587aaa663","24cf8786024543f19b89bc20034e60d7",22071696,1,-4,0,1475,431,428,-3
"24cf8786024543f19b89bc20034e60d7","dce46f8904594a62a6377a3587aaa663",22071696,1,4,0,1476,428,431,3
"dce46f8904594a62a6377a3587aaa663","dce46f8904594a62a6377a3587aaa663",22071696,2,0,1,1477,431,431,0
"dce46f8904594a62a6377a3587aaa663","9b9d0a249052413c869753b99682b0ac",22071696,1,1,0,1478,431,432,1
"9b9d0a249052413c869753b99682b0ac","9b9d0a249052413c869753b99682b0ac",22071696,7,0,1,1479,432,432,0
"9b9d0a249052413c869753b99682b0ac","061c175cc90f45fbad883025394e78dd",22071696,1,1,0,1486,432,433,1
"061c175cc90f45fbad883025394e78dd","061c175cc90f45fbad883025394e78dd",22071696,6,0,1,1487,433,433,0
"061c175cc90f45fbad883025394e78dd","dce46f8904594a62a6377a3587aaa663",22071696,1,-2,0,1493,433,431,-2
"dce46f8904594a62a6377a3587aaa663","74a7f8712e5449c2bc0b43c6f90dafed",22071696,1,5,0,1494,431,435,4
"74a7f8712e5449c2bc0b43c6f90dafed","74a7f8712e5449c2bc0b43c6f90dafed",22071696,1,0,1,1495,435,435,0
"74a7f8712e5449c2bc0b43c6f90dafed","66ada10dde9f43018588f1ced9d477fc",22071696,1,-1,0,1496,435,434,-1
"66ada10dde9f43018588f1ced9d477fc","24cf8786024543f19b89bc20034e60d7",22071696,1,-8,0,1497,434,428,-6
"24cf8786024543f19b89bc20034e60d7","bf12c96466d840a69bed7020b3f18bb8",22071696,1,11,0,1498,428,436,8
"bf12c96466d840a69bed7020b3f18bb8","bf12c96466d840a69bed7020b3f18bb8",22071696,2,0,1,1499,436,436,0
"bf12c96466d840a69bed7020b3f18bb8","dce46f8904594a62a6377a3587aaa663",22071696,1,-7,0,1500,436,431,-5
"dce46f8904594a62a6377a3587aaa663","bf12c96466d840a69bed7020b3f18bb8",22071696,1,7,0,1502,431,436,5
"bf12c96466d840a69bed7020b3f18bb8","24cf8786024543f19b89bc20034e60d7",22071696,1,-11,0,1504,436,428,-8
"24cf8786024543f19b89bc20034e60d7","070600601c4c439288445d2f0724807d",22071696,2,14,0,1505,428,437,9
"070600601c4c439288445d2f0724807d","1823b6de7d334a7aaabc4570719af4d9",22071696,4,2,0,1506,437,439,2
"1823b6de7d334a7aaabc4570719af4d9","c33c17be71ae4d588da7369472e5bb1b",22071696,1,-557,0,1507,439,34,-405
"c33c17be71ae4d588da7369472e5bb1b","070600601c4c439288445d2f0724807d",22071696,1,555,0,1508,34,437,403
"070600601c4c439288445d2f0724807d","070600601c4c439288445d2f0724807d",22071696,1,0,1,1509,437,437,0
"1823b6de7d334a7aaabc4570719af4d9","070600601c4c439288445d2f0724807d",22071696,3,-2,0,1511,439,437,-2
"070600601c4c439288445d2f0724807d","24cf8786024543f19b89bc20034e60d7",22071696,1,-14,0,1512,437,428,-9
"24cf8786024543f19b89bc20034e60d7","24cf8786024543f19b89bc20034e60d7",22071696,1,0,1,1513,428,428,0
"1823b6de7d334a7aaabc4570719af4d9","1823b6de7d334a7aaabc4570719af4d9",22071696,17,0,1,1516,439,439,0
"070600601c4c439288445d2f0724807d","0380cd76a7d44bc3a4da1f15e4d68f89",22071696,1,4,0,1536,437,440,3
"0380cd76a7d44bc3a4da1f15e4d68f89","0380cd76a7d44bc3a4da1f15e4d68f89",22071696,5,0,1,1537,440,440,0
"0380cd76a7d44bc3a4da1f15e4d68f89","23b7673c8b5443108c2ef09382834a86",22071696,1,2,0,1542,440,441,1
"23b7673c8b5443108c2ef09382834a86","23b7673c8b5443108c2ef09382834a86",22071696,5,0,1,1543,441,441,0
"23b7673c8b5443108c2ef09382834a86","901e92500aea43c79f19f1b279050668",22071696,1,2,0,1548,441,442,1
"901e92500aea43c79f19f1b279050668","901e92500aea43c79f19f1b279050668",22071696,4,0,1,1549,442,442,0
"901e92500aea43c79f19f1b279050668","4660ff2089114e8db82ceb26a4f329e3",22071696,1,4,0,1553,442,445,3
"4660ff2089114e8db82ceb26a4f329e3","4660ff2089114e8db82ceb26a4f329e3",22071696,2,0,1,1554,445,445,0
"4660ff2089114e8db82ceb26a4f329e3","7bd5586eb9d8484eb74a433ee7bfe499",22071696,1,2,0,1556,445,446,1
"7bd5586eb9d8484eb74a433ee7bfe499","7bd5586eb9d8484eb74a433ee7bfe499",22071696,25,0,1,1557,446,446,0
"7bd5586eb9d8484eb74a433ee7bfe499","8a7f26e690f34dda97be16904518ca99",22071696,1,2,0,1582,446,447,1
"8a7f26e690f34dda97be16904518ca99","8a7f26e690f34dda97be16904518ca99",22071696,1,0,1,1583,447,447,0
"8a7f26e690f34dda97be16904518ca99","070600601c4c439288445d2f0724807d",22071696,1,-16,0,1584,447,437,-10
"070600601c4c439288445d2f0724807d","b2f0d654738f48158edff28e8d3a546e",22071696,1,21,0,1585,437,449,12
"b2f0d654738f48158edff28e8d3a546e","b2f0d654738f48158edff28e8d3a546e",22071696,2,0,1,1586,449,449,0
"b2f0d654738f48158edff28e8d3a546e","f60ee41ec635499abd48168342d32c2f",22071696,7,5,0,1587,449,453,4
"f60ee41ec635499abd48168342d32c2f","f60ee41ec635499abd48168342d32c2f",22071696,93,0,1,1588,453,453,0
"f60ee41ec635499abd48168342d32c2f","f67fbf45a5f146ed866965bc57c7c001",22071696,2,3,0,1595,453,454,1
"f67fbf45a5f146ed866965bc57c7c001","b2f0d654738f48158edff28e8d3a546e",22071696,2,-8,0,1596,454,449,-5
"b2f0d654738f48158edff28e8d3a546e","f67fbf45a5f146ed866965bc57c7c001",22071696,2,8,0,1597,449,454,5
"f67fbf45a5f146ed866965bc57c7c001","f67fbf45a5f146ed866965bc57c7c001",22071696,1,0,1,1598,454,454,0
"f67fbf45a5f146ed866965bc57c7c001","d937afe49bd24a07a550dda1c1155122",22071696,1,1,0,1599,454,455,1
"d937afe49bd24a07a550dda1c1155122","d937afe49bd24a07a550dda1c1155122",22071696,3,0,1,1600,455,455,0
"d937afe49bd24a07a550dda1c1155122","3628b3f7823443d0912a339096b69943",22071696,1,1,0,1603,455,456,1
"3628b3f7823443d0912a339096b69943","3628b3f7823443d0912a339096b69943",22071696,1,0,1,1604,456,456,0
"3628b3f7823443d0912a339096b69943","9e049ee647cf43ecbcb5ed792a8e7588",22071696,1,1,0,1605,456,457,1
"9e049ee647cf43ecbcb5ed792a8e7588","9e049ee647cf43ecbcb5ed792a8e7588",22071696,1,0,1,1606,457,457,0
"9e049ee647cf43ecbcb5ed792a8e7588","5256a214faaf410b93f76cea06428334",22071696,1,1,0,1607,457,458,1
"5256a214faaf410b93f76cea06428334","5256a214faaf410b93f76cea06428334",22071696,1,0,1,1608,458,458,0
"5256a214faaf410b93f76cea06428334","25c32b120fce40fa9b6c85133aeb4716",22071696,1,1,0,1609,458,459,1
"25c32b120fce40fa9b6c85133aeb4716","25c32b120fce40fa9b6c85133aeb4716",22071696,1,0,1,1610,459,459,0
"25c32b120fce40fa9b6c85133aeb4716","11bc14f2204949008b7d511b933363c1",22071696,1,1,0,1611,459,460,1
"11bc14f2204949008b7d511b933363c1","11bc14f2204949008b7d511b933363c1",22071696,1,0,1,1612,460,460,0
"11bc14f2204949008b7d511b933363c1","42de338840a34d15adb66e7b14fb9d2c",22071696,1,1,0,1613,460,461,1
"42de338840a34d15adb66e7b14fb9d2c","42de338840a34d15adb66e7b14fb9d2c",22071696,1,0,1,1614,461,461,0
"42de338840a34d15adb66e7b14fb9d2c","9da37c6210b1416b8079c274f70bf600",22071696,1,1,0,1615,461,462,1
"9da37c6210b1416b8079c274f70bf600","9da37c6210b1416b8079c274f70bf600",22071696,7,0,1,1616,462,462,0
"9da37c6210b1416b8079c274f70bf600","519119f1deac45ff9ab4f13529be5c6e",22071696,1,1,0,1623,462,463,1
"519119f1deac45ff9ab4f13529be5c6e","519119f1deac45ff9ab4f13529be5c6e",22071696,1,0,1,1624,463,463,0
"519119f1deac45ff9ab4f13529be5c6e","f67fbf45a5f146ed866965bc57c7c001",22071696,1,-9,0,1625,463,454,-9
"f67fbf45a5f146ed866965bc57c7c001","c5df9f40ec14463b9dcfdc73df3e9285",22071696,1,12,0,1626,454,464,10
"c5df9f40ec14463b9dcfdc73df3e9285","c5df9f40ec14463b9dcfdc73df3e9285",22071696,1,0,1,1627,464,464,0
"c5df9f40ec14463b9dcfdc73df3e9285","83d42d95cd844fc093fc09cee250edb8",22071696,2,3,0,1628,464,465,1
"83d42d95cd844fc093fc09cee250edb8","c5df9f40ec14463b9dcfdc73df3e9285",22071696,1,-3,0,1629,465,464,-1
"83d42d95cd844fc093fc09cee250edb8","83d42d95cd844fc093fc09cee250edb8",22071696,5,0,1,1631,465,465,0
"83d42d95cd844fc093fc09cee250edb8","0d987bed3ffa4ed0b9a2e62e97b7b30f",22071696,1,-279,0,1636,465,272,-193
"0d987bed3ffa4ed0b9a2e62e97b7b30f","bb5a47f5ea01454a8b79455422d3b9da",22071696,4,10,0,1637,272,280,8
"bb5a47f5ea01454a8b79455422d3b9da","bc5524e78a8544e2ae2fdc2f3462bbec",22071696,2,-1,0,1645,280,279,-1
"bc5524e78a8544e2ae2fdc2f3462bbec","0d987bed3ffa4ed0b9a2e62e97b7b30f",22071696,1,-9,0,1646,279,272,-7
"bb5a47f5ea01454a8b79455422d3b9da","82ae07bc0c9b4570a41799290d1ef399",22071696,1,-6,0,1652,280,275,-5
"bc5524e78a8544e2ae2fdc2f3462bbec","bb5a47f5ea01454a8b79455422d3b9da",22071696,1,1,0,1657,279,280,1
"bb5a47f5ea01454a8b79455422d3b9da","0d987bed3ffa4ed0b9a2e62e97b7b30f",22071696,1,-10,0,1658,280,272,-8
"a37477c4e4c14169ad44b06b493007f6","b71bac264efb4abd97015447bd490db6",22071696,1,117,0,1719,283,370,87
"8d448d625b024c82a5eb240bbd7431d6","1b4550d0dab04078b3bf08a655345bdc",22071696,1,-1,0,1728,374,373,-1
"1b4550d0dab04078b3bf08a655345bdc","0c4079457ede49e3aeb5e86ed84bdf35",22071696,1,-56,0,1729,373,329,-44
"0c4079457ede49e3aeb5e86ed84bdf35","0c4079457ede49e3aeb5e86ed84bdf35",22071696,1,0,1,1730,329,329,0
"0c4079457ede49e3aeb5e86ed84bdf35","4a92daef4d504e1792575a26502bb7b7",22071696,1,20,0,1731,329,346,17
"4a92daef4d504e1792575a26502bb7b7","38aea304b4fa46e1b29bb72f5cea4c93",22071696,1,-18,0,1732,346,331,-15
"38aea304b4fa46e1b29bb72f5cea4c93","0c4079457ede49e3aeb5e86ed84bdf35",22071696,1,-2,0,1738,331,329,-2
"30ead9794d4847abaf222ca966cc8630","0c4079457ede49e3aeb5e86ed84bdf35",22071696,1,-24,0,1740,348,329,-19
"0c4079457ede49e3aeb5e86ed84bdf35","c20993c944444fe085345591a8bd837e",22071696,1,27,0,1741,329,351,22
"eff0de7f2dbb42dfa1a2e686efab5b6d","09b9678ddc3d452ea4a3d46e15826065",22071696,1,-1,0,1745,354,353,-1
"897b7f51242c44aab2205c72fdcbf4cd","eff0de7f2dbb42dfa1a2e686efab5b6d",22071696,1,2,0,1751,352,354,2
"eff0de7f2dbb42dfa1a2e686efab5b6d","2fe14166dc9642c3bc666b86a57f943d",22071696,1,4,0,1753,354,357,3
"2fe14166dc9642c3bc666b86a57f943d","30ead9794d4847abaf222ca966cc8630",22071696,1,-10,0,1754,357,348,-9
"d6d02b6ef04e4f17805504500b8ce441","0d987bed3ffa4ed0b9a2e62e97b7b30f",22071696,1,-140,0,1813,375,272,-103
"bb5a47f5ea01454a8b79455422d3b9da","b2f0d654738f48158edff28e8d3a546e",22071696,1,246,0,1822,280,449,169
"f60ee41ec635499abd48168342d32c2f","b2f0d654738f48158edff28e8d3a546e",22071696,4,-5,0,1876,453,449,-4
"f67fbf45a5f146ed866965bc57c7c001","b71bac264efb4abd97015447bd490db6",22071696,1,-132,0,1878,454,370,-84
"8d448d625b024c82a5eb240bbd7431d6","d646286c8051419bbc2e31dd1db55ca8",22071696,1,-404,0,1887,374,67,-307
"d646286c8051419bbc2e31dd1db55ca8","6a9f0ef185fb47f0937e29daa1c71ed5",22071696,2,27,0,1888,67,90,23
"6a9f0ef185fb47f0937e29daa1c71ed5","6a9f0ef185fb47f0937e29daa1c71ed5",22071696,5,0,1,1889,90,90,0
"6a9f0ef185fb47f0937e29daa1c71ed5","c681290961c94c4caf23b529d1ae6b9a",22071696,1,-2,0,1891,90,88,-2
"c681290961c94c4caf23b529d1ae6b9a","c681290961c94c4caf23b529d1ae6b9a",22071696,1,0,1,1892,88,88,0
"c681290961c94c4caf23b529d1ae6b9a","b2f0d654738f48158edff28e8d3a546e",22071696,1,498,0,1893,88,449,361
"f60ee41ec635499abd48168342d32c2f","9428d8bd9c5a47b2a235b254e5e27ded",22071696,1,-1,0,1902,453,452,-1
"9428d8bd9c5a47b2a235b254e5e27ded","f60ee41ec635499abd48168342d32c2f",22071696,1,1,0,1903,452,453,1
"b613861cecf84ffcab01afb23f660475","b613861cecf84ffcab01afb23f660475",22850084,4,0,1,1,1,1,0
"e2911e79efc2420eac45d9f671463d4b","e2911e79efc2420eac45d9f671463d4b",22850084,2,0,1,6,2,2,0
"e2911e79efc2420eac45d9f671463d4b","519d1b8c59404d67b54e96c5c8a830b2",22850084,1,1,0,8,2,3,1
"519d1b8c59404d67b54e96c5c8a830b2","519d1b8c59404d67b54e96c5c8a830b2",22850084,2,0,1,10,3,3,0
"519d1b8c59404d67b54e96c5c8a830b2","e2911e79efc2420eac45d9f671463d4b",22850084,1,-1,0,11,3,2,-1
"e2911e79efc2420eac45d9f671463d4b","531db53f81f646edb0cdcfe0085b03b7",22850084,1,2,0,12,2,4,2
"531db53f81f646edb0cdcfe0085b03b7","531db53f81f646edb0cdcfe0085b03b7",22850084,1,0,1,13,4,4,0
"531db53f81f646edb0cdcfe0085b03b7","4f5f94b2f95141e0a9d53a61da2276da",22850084,1,1,0,14,4,5,1
"4f5f94b2f95141e0a9d53a61da2276da","4f5f94b2f95141e0a9d53a61da2276da",22850084,1,0,1,15,5,5,0
"4f5f94b2f95141e0a9d53a61da2276da","6d541c89590949f99af293c4f2333f67",22850084,1,1,0,16,5,6,1
"6d541c89590949f99af293c4f2333f67","6d541c89590949f99af293c4f2333f67",22850084,1,0,1,17,6,6,0
"6d541c89590949f99af293c4f2333f67","dd5cf0b9fe4c4f1d8f5ff8e4c04879cb",22850084,1,1,0,18,6,7,1
"dd5cf0b9fe4c4f1d8f5ff8e4c04879cb","dd5cf0b9fe4c4f1d8f5ff8e4c04879cb",22850084,1,0,1,19,7,7,0
"dd5cf0b9fe4c4f1d8f5ff8e4c04879cb","f96261861edc426abe2248be4f0a709a",22850084,1,1,0,20,7,8,1
"f96261861edc426abe2248be4f0a709a","f96261861edc426abe2248be4f0a709a",22850084,1,0,1,21,8,8,0
"f96261861edc426abe2248be4f0a709a","66b5e16f4f75454fb5b8172079f0fa83",22850084,1,1,0,22,8,9,1
"66b5e16f4f75454fb5b8172079f0fa83","66b5e16f4f75454fb5b8172079f0fa83",22850084,1,0,1,23,9,9,0
"66b5e16f4f75454fb5b8172079f0fa83","0680571d4698477995e41842c36a54b2",22850084,1,1,0,24,9,10,1
"0680571d4698477995e41842c36a54b2","0680571d4698477995e41842c36a54b2",22850084,1,0,1,25,10,10,0
"0680571d4698477995e41842c36a54b2","9112f2bffece48e08c6d2287be204085",22850084,1,1,0,26,10,11,1
"9112f2bffece48e08c6d2287be204085","9112f2bffece48e08c6d2287be204085",22850084,1,0,1,27,11,11,0
"9112f2bffece48e08c6d2287be204085","56586aa865414f538729c7f7735d2bc6",22850084,1,3,0,28,11,12,1
"b7f2b31585d94eb3bf86376714aa7070","56586aa865414f538729c7f7735d2bc6",22850084,1,-2,0,33,13,12,-1
"3f1c815879794b929260d224becaff7e","81c864a886d54a6b8ff85f7d736f4f95",22850084,2,2,0,37,14,15,1
"81c864a886d54a6b8ff85f7d736f4f95","3f1c815879794b929260d224becaff7e",22850084,1,-2,0,38,15,14,-1
"81c864a886d54a6b8ff85f7d736f4f95","5c5ceeee4562457ba6d41515aeebfbb1",22850084,1,4,0,40,15,17,2
"5c5ceeee4562457ba6d41515aeebfbb1","5c5ceeee4562457ba6d41515aeebfbb1",22850084,1,0,1,41,17,17,0
"5c5ceeee4562457ba6d41515aeebfbb1","9afd71a5298d4333b6849dfce1b9422c",22850084,1,3,0,42,17,18,1
"9afd71a5298d4333b6849dfce1b9422c","56586aa865414f538729c7f7735d2bc6",22850084,2,-13,0,43,18,12,-6
"56586aa865414f538729c7f7735d2bc6","b7719e26494940efa49512aedd0aac79",22850084,1,17,0,44,12,20,8
"b7719e26494940efa49512aedd0aac79","9afd71a5298d4333b6849dfce1b9422c",22850084,3,-4,0,45,20,18,-2
"9afd71a5298d4333b6849dfce1b9422c","d4f45188d3c84a02ba08454e6403a818",22850084,2,9,0,46,18,24,6
"d4f45188d3c84a02ba08454e6403a818","d4c3b003e8274e429d2fa688d73fde6d",22850084,3,-2,0,47,24,22,-2
"d4c3b003e8274e429d2fa688d73fde6d","b7719e26494940efa49512aedd0aac79",22850084,2,-3,0,48,22,20,-2
"56586aa865414f538729c7f7735d2bc6","9afd71a5298d4333b6849dfce1b9422c",22850084,2,13,0,51,12,18,6
"9afd71a5298d4333b6849dfce1b9422c","5c5ceeee4562457ba6d41515aeebfbb1",22850084,1,-3,0,52,18,17,-1
"5c5ceeee4562457ba6d41515aeebfbb1","eb2a0eb537344a9e891c761662e400b6",22850084,1,-2,0,53,17,16,-1
"eb2a0eb537344a9e891c761662e400b6","5c5ceeee4562457ba6d41515aeebfbb1",22850084,1,2,0,54,16,17,1
"5c5ceeee4562457ba6d41515aeebfbb1","81c864a886d54a6b8ff85f7d736f4f95",22850084,1,-4,0,55,17,15,-2
"81c864a886d54a6b8ff85f7d736f4f95","56586aa865414f538729c7f7735d2bc6",22850084,1,-6,0,56,15,12,-3
"9afd71a5298d4333b6849dfce1b9422c","9afd71a5298d4333b6849dfce1b9422c",22850084,1,0,1,58,18,18,0
"9afd71a5298d4333b6849dfce1b9422c","b7719e26494940efa49512aedd0aac79",22850084,2,4,0,59,18,20,2
"b7719e26494940efa49512aedd0aac79","d4f45188d3c84a02ba08454e6403a818",22850084,1,5,0,60,20,24,4
"d4c3b003e8274e429d2fa688d73fde6d","9afd71a5298d4333b6849dfce1b9422c",22850084,1,-7,0,62,22,18,-4
"b7719e26494940efa49512aedd0aac79","b7719e26494940efa49512aedd0aac79",22850084,2,0,1,64,20,20,0
"d4c3b003e8274e429d2fa688d73fde6d","d4c3b003e8274e429d2fa688d73fde6d",22850084,1,0,1,68,22,22,0
"b7719e26494940efa49512aedd0aac79","a49d1bb4328949299686242fd0be5584",22850084,1,2,0,70,20,21,1
"a49d1bb4328949299686242fd0be5584","a49d1bb4328949299686242fd0be5584",22850084,1,0,1,71,21,21,0
"a49d1bb4328949299686242fd0be5584","d4c3b003e8274e429d2fa688d73fde6d",22850084,1,1,0,72,21,22,1
"d4c3b003e8274e429d2fa688d73fde6d","d4f45188d3c84a02ba08454e6403a818",22850084,1,2,0,73,22,24,2
"d4f45188d3c84a02ba08454e6403a818","b7719e26494940efa49512aedd0aac79",22850084,1,-5,0,74,24,20,-4
"b7719e26494940efa49512aedd0aac79","afbf7250b99d47bea07172749483ca97",22850084,1,12,0,76,20,28,8
"afbf7250b99d47bea07172749483ca97","4e51676dc72045d99c19b9fa7b22f8bc",22850084,2,3,0,77,28,29,1
"4e51676dc72045d99c19b9fa7b22f8bc","afbf7250b99d47bea07172749483ca97",22850084,1,-3,0,78,29,28,-1
"4e51676dc72045d99c19b9fa7b22f8bc","51970cfa30e643e894e66ae85c8024cc",22850084,1,3,0,80,29,31,2
"51970cfa30e643e894e66ae85c8024cc","c33c17be71ae4d588da7369472e5bb1b",22850084,1,6,0,81,31,34,3
"c33c17be71ae4d588da7369472e5bb1b","4e51676dc72045d99c19b9fa7b22f8bc",22850084,1,-9,0,82,34,29,-5
"4e51676dc72045d99c19b9fa7b22f8bc","93679be414554a11b1893002f2229a93",22850084,1,12,0,83,29,35,6
"93679be414554a11b1893002f2229a93","c33c17be71ae4d588da7369472e5bb1b",22850084,1,-3,0,84,35,34,-1
"c33c17be71ae4d588da7369472e5bb1b","7040a13096d746ac84b8fac8d9752058",22850084,1,6,0,85,34,36,2
"7040a13096d746ac84b8fac8d9752058","93679be414554a11b1893002f2229a93",22850084,1,-3,0,86,36,35,-1
"93679be414554a11b1893002f2229a93","7040a13096d746ac84b8fac8d9752058",22850084,1,3,0,87,35,36,1
"7040a13096d746ac84b8fac8d9752058","9a0dc646f934470daf08c4b56ccf73db",22850084,1,3,0,88,36,37,1
"9a0dc646f934470daf08c4b56ccf73db","9a0dc646f934470daf08c4b56ccf73db",22850084,1,0,1,89,37,37,0
"9a0dc646f934470daf08c4b56ccf73db","fc0e049d56024bc9a02c9a9c435c3df7",22850084,1,3,0,90,37,38,1
"fc0e049d56024bc9a02c9a9c435c3df7","b613861cecf84ffcab01afb23f660475",22850084,1,-68,0,91,38,1,-37
"b613861cecf84ffcab01afb23f660475","afbf7250b99d47bea07172749483ca97",22850084,1,44,0,92,1,28,27
"afbf7250b99d47bea07172749483ca97","afbf7250b99d47bea07172749483ca97",22850084,1,0,1,93,28,28,0
"afbf7250b99d47bea07172749483ca97","67a089198fcb4e1c8f2385786c2b296f",22850084,1,28,0,94,28,39,11
"67a089198fcb4e1c8f2385786c2b296f","64d48c6c9c7940639a932219a6c87198",22850084,1,1,0,95,39,40,1
"64d48c6c9c7940639a932219a6c87198","64d48c6c9c7940639a932219a6c87198",22850084,1,0,1,96,40,40,0
"64d48c6c9c7940639a932219a6c87198","b534b89233134e30a9b5645138bfa9ee",22850084,1,3,0,97,40,41,1
"b534b89233134e30a9b5645138bfa9ee","67a089198fcb4e1c8f2385786c2b296f",22850084,1,-4,0,98,41,39,-2
"67a089198fcb4e1c8f2385786c2b296f","0e37b720d23b4e7f8b313e79313fd107",22850084,1,7,0,99,39,44,5
"0e37b720d23b4e7f8b313e79313fd107","0e37b720d23b4e7f8b313e79313fd107",22850084,2,0,1,100,44,44,0
"0e37b720d23b4e7f8b313e79313fd107","6875d67fdd5f48168b62719df449bebd",22850084,1,1,0,102,44,45,1
"6875d67fdd5f48168b62719df449bebd","6875d67fdd5f48168b62719df449bebd",22850084,2,0,1,103,45,45,0
"6875d67fdd5f48168b62719df449bebd","0e37b720d23b4e7f8b313e79313fd107",22850084,1,-1,0,105,45,44,-1
"0e37b720d23b4e7f8b313e79313fd107","6e13d61a7bdb44bca949c9f86fab3be5",22850084,1,4,0,106,44,47,3
"6e13d61a7bdb44bca949c9f86fab3be5","b534b89233134e30a9b5645138bfa9ee",22850084,1,-7,0,107,47,41,-6
"b534b89233134e30a9b5645138bfa9ee","6e13d61a7bdb44bca949c9f86fab3be5",22850084,1,7,0,108,41,47,6
"6e13d61a7bdb44bca949c9f86fab3be5","d9c8d8c444a64dadbbb508652c721e17",22850084,2,-1,0,109,47,46,-1
"d9c8d8c444a64dadbbb508652c721e17","d0c74f735e024943943e40333d6d337f",22850084,2,6,0,110,46,51,5
"d0c74f735e024943943e40333d6d337f","f924752d8a1149668870b1e7698486f7",22850084,1,-1,0,111,51,50,-1
"f924752d8a1149668870b1e7698486f7","6e13d61a7bdb44bca949c9f86fab3be5",22850084,2,-4,0,112,50,47,-3
"6e13d61a7bdb44bca949c9f86fab3be5","195f78799f984cc2b06c48dfe36be751",22850084,1,2,0,113,47,49,2
"195f78799f984cc2b06c48dfe36be751","195f78799f984cc2b06c48dfe36be751",22850084,2,0,1,114,49,49,0
"195f78799f984cc2b06c48dfe36be751","d0c74f735e024943943e40333d6d337f",22850084,1,3,0,116,49,51,2
"d0c74f735e024943943e40333d6d337f","d9c8d8c444a64dadbbb508652c721e17",22850084,1,-6,0,117,51,46,-5
"d9c8d8c444a64dadbbb508652c721e17","f924752d8a1149668870b1e7698486f7",22850084,1,5,0,118,46,50,4
"d0c74f735e024943943e40333d6d337f","d0c74f735e024943943e40333d6d337f",22850084,1,0,1,122,51,51,0
"d0c74f735e024943943e40333d6d337f","983f8ff320594b279a7f4a6fe132f9c5",22850084,1,2,0,123,51,53,2
"983f8ff320594b279a7f4a6fe132f9c5","983f8ff320594b279a7f4a6fe132f9c5",22850084,2,0,1,124,53,53,0
"983f8ff320594b279a7f4a6fe132f9c5","35adfa5d923046aebabfefd98f35ff05",22850084,1,1,0,126,53,54,1
"35adfa5d923046aebabfefd98f35ff05","35adfa5d923046aebabfefd98f35ff05",22850084,5,0,1,127,54,54,0
"35adfa5d923046aebabfefd98f35ff05","b6f8a98476224da1b40e555ececc7ed8",22850084,1,1,0,132,54,55,1
"b6f8a98476224da1b40e555ececc7ed8","b6f8a98476224da1b40e555ececc7ed8",22850084,2,0,1,133,55,55,0
"b6f8a98476224da1b40e555ececc7ed8","86e22cb5fe0e4b47a9489ecddf7ed78f",22850084,1,1,0,135,55,56,1
"86e22cb5fe0e4b47a9489ecddf7ed78f","86e22cb5fe0e4b47a9489ecddf7ed78f",22850084,2,0,1,136,56,56,0
"86e22cb5fe0e4b47a9489ecddf7ed78f","a1f2f12debe5432fb7a70bcd12bacfb9",22850084,1,3,0,138,56,58,2
"a1f2f12debe5432fb7a70bcd12bacfb9","78f30e4dcac84e3cbea8b2cc6e0d62b3",22850084,3,1,0,139,58,59,1
"78f30e4dcac84e3cbea8b2cc6e0d62b3","f924752d8a1149668870b1e7698486f7",22850084,1,-10,0,140,59,50,-9
"f924752d8a1149668870b1e7698486f7","a1f2f12debe5432fb7a70bcd12bacfb9",22850084,1,9,0,141,50,58,8
"a1f2f12debe5432fb7a70bcd12bacfb9","a1f2f12debe5432fb7a70bcd12bacfb9",22850084,9,0,1,142,58,58,0
"78f30e4dcac84e3cbea8b2cc6e0d62b3","78f30e4dcac84e3cbea8b2cc6e0d62b3",22850084,17,0,1,152,59,59,0
"78f30e4dcac84e3cbea8b2cc6e0d62b3","b534b89233134e30a9b5645138bfa9ee",22850084,1,-21,0,169,59,41,-18
"b534b89233134e30a9b5645138bfa9ee","a1f2f12debe5432fb7a70bcd12bacfb9",22850084,1,20,0,170,41,58,17
"78f30e4dcac84e3cbea8b2cc6e0d62b3","b7719e26494940efa49512aedd0aac79",22850084,1,-65,0,172,59,20,-39
"b7719e26494940efa49512aedd0aac79","a0a418b8540d479fa6e0f653b701da8b",22850084,1,71,0,173,20,64,44
"a0a418b8540d479fa6e0f653b701da8b","bc42d26810654ea9a1df1efe1e58c7d5",22850084,2,-1,0,174,64,63,-1
"bc42d26810654ea9a1df1efe1e58c7d5","12aa6e1672ac4e7aa6449a7a8609cd72",22850084,1,-7,0,175,63,57,-6
"12aa6e1672ac4e7aa6449a7a8609cd72","67a089198fcb4e1c8f2385786c2b296f",22850084,1,-23,0,176,57,39,-18
"67a089198fcb4e1c8f2385786c2b296f","309ccf3cc4fe429d9bfbaef53d3fa479",22850084,1,27,0,177,39,60,21
"309ccf3cc4fe429d9bfbaef53d3fa479","b534b89233134e30a9b5645138bfa9ee",22850084,2,-23,0,178,60,41,-19
"b534b89233134e30a9b5645138bfa9ee","a0a418b8540d479fa6e0f653b701da8b",22850084,1,27,0,179,41,64,23
"bc42d26810654ea9a1df1efe1e58c7d5","b534b89233134e30a9b5645138bfa9ee",22850084,1,-26,0,181,63,41,-22
"b534b89233134e30a9b5645138bfa9ee","b7719e26494940efa49512aedd0aac79",22850084,1,-44,0,182,41,20,-21
"b7719e26494940efa49512aedd0aac79","bc42d26810654ea9a1df1efe1e58c7d5",22850084,1,70,0,183,20,63,43
"bc42d26810654ea9a1df1efe1e58c7d5","a0a418b8540d479fa6e0f653b701da8b",22850084,3,1,0,184,63,64,1
"a0a418b8540d479fa6e0f653b701da8b","b534b89233134e30a9b5645138bfa9ee",22850084,1,-27,0,185,64,41,-23
"b534b89233134e30a9b5645138bfa9ee","bc42d26810654ea9a1df1efe1e58c7d5",22850084,1,26,0,186,41,63,22
"a0a418b8540d479fa6e0f653b701da8b","4c943503763e4e349906eea3ed3c8e86",22850084,1,-3,0,188,64,61,-3
"4c943503763e4e349906eea3ed3c8e86","4c943503763e4e349906eea3ed3c8e86",22850084,1,0,1,189,61,61,0
"4c943503763e4e349906eea3ed3c8e86","bc42d26810654ea9a1df1efe1e58c7d5",22850084,1,2,0,190,61,63,2
"bc42d26810654ea9a1df1efe1e58c7d5","bc42d26810654ea9a1df1efe1e58c7d5",22850084,3,0,1,191,63,63,0
"a0a418b8540d479fa6e0f653b701da8b","a0a418b8540d479fa6e0f653b701da8b",22850084,3,0,1,195,64,64,0
"a0a418b8540d479fa6e0f653b701da8b","309ccf3cc4fe429d9bfbaef53d3fa479",22850084,1,-4,0,198,64,60,-4
"b534b89233134e30a9b5645138bfa9ee","d646286c8051419bbc2e31dd1db55ca8",22850084,1,33,0,200,41,67,26
"d646286c8051419bbc2e31dd1db55ca8","267f883678b24aed855fde42524975d9",22850084,1,4,0,201,67,71,4
"267f883678b24aed855fde42524975d9","267f883678b24aed855fde42524975d9",22850084,1,0,1,202,71,71,0
"267f883678b24aed855fde42524975d9","88fff56d0342490dbef9040750a20f6c",22850084,1,1,0,203,71,72,1
"88fff56d0342490dbef9040750a20f6c","88fff56d0342490dbef9040750a20f6c",22850084,1,0,1,204,72,72,0
"88fff56d0342490dbef9040750a20f6c","adb17b12b66c4a49a85fd34322f7df70",22850084,1,1,0,205,72,73,1
"adb17b12b66c4a49a85fd34322f7df70","adb17b12b66c4a49a85fd34322f7df70",22850084,1,0,1,206,73,73,0
"adb17b12b66c4a49a85fd34322f7df70","d646286c8051419bbc2e31dd1db55ca8",22850084,1,-6,0,207,73,67,-6
"d646286c8051419bbc2e31dd1db55ca8","a2becd407db34b189200a32546d9d569",22850084,2,9,0,208,67,75,8
"a2becd407db34b189200a32546d9d569","d646286c8051419bbc2e31dd1db55ca8",22850084,1,-9,0,209,75,67,-8
"d646286c8051419bbc2e31dd1db55ca8","d646286c8051419bbc2e31dd1db55ca8",22850084,1,0,1,210,67,67,0
"a2becd407db34b189200a32546d9d569","a2becd407db34b189200a32546d9d569",22850084,2,0,1,212,75,75,0
"a2becd407db34b189200a32546d9d569","dd76e1861dc9461c830888729d091ee0",22850084,1,3,0,213,75,78,3
"dd76e1861dc9461c830888729d091ee0","dd76e1861dc9461c830888729d091ee0",22850084,5,0,1,214,78,78,0
"dd76e1861dc9461c830888729d091ee0","cd1d828f1a694b87913a7ea66c23803e",22850084,1,1,0,219,78,79,1
"cd1d828f1a694b87913a7ea66c23803e","cd1d828f1a694b87913a7ea66c23803e",22850084,2,0,1,220,79,79,0
"cd1d828f1a694b87913a7ea66c23803e","9176a3c2b4d2465fa8b0c67096c2a97e",22850084,1,1,0,222,79,80,1
"9176a3c2b4d2465fa8b0c67096c2a97e","9176a3c2b4d2465fa8b0c67096c2a97e",22850084,5,0,1,223,80,80,0
"9176a3c2b4d2465fa8b0c67096c2a97e","f8ec6445f7194e25b9101d4fbcb07a18",22850084,1,1,0,228,80,81,1
"f8ec6445f7194e25b9101d4fbcb07a18","f8ec6445f7194e25b9101d4fbcb07a18",22850084,2,0,1,229,81,81,0
"f8ec6445f7194e25b9101d4fbcb07a18","58c22b011d0f4c2ea6d13615edbb9eeb",22850084,1,-4,0,231,81,77,-4
"58c22b011d0f4c2ea6d13615edbb9eeb","58c22b011d0f4c2ea6d13615edbb9eeb",22850084,4,0,1,232,77,77,0
"58c22b011d0f4c2ea6d13615edbb9eeb","a2becd407db34b189200a32546d9d569",22850084,1,-2,0,234,77,75,-2
"a2becd407db34b189200a32546d9d569","58c22b011d0f4c2ea6d13615edbb9eeb",22850084,1,2,0,236,75,77,2
"58c22b011d0f4c2ea6d13615edbb9eeb","140d5b27b8574befad82c0a013b59dfa",22850084,1,-3,0,239,77,74,-3
"140d5b27b8574befad82c0a013b59dfa","d18a9ea32855445f8736581f5cb119ce",22850084,1,9,0,240,74,82,8
"d18a9ea32855445f8736581f5cb119ce","f564483cbd7a407681aa2fcca518cf5f",22850084,1,4,0,241,82,85,3
"f564483cbd7a407681aa2fcca518cf5f","f564483cbd7a407681aa2fcca518cf5f",22850084,1,0,1,242,85,85,0
"f564483cbd7a407681aa2fcca518cf5f","18fd01350bd5434ca636d59a599d768a",22850084,1,1,0,243,85,86,1
"18fd01350bd5434ca636d59a599d768a","18fd01350bd5434ca636d59a599d768a",22850084,9,0,1,244,86,86,0
"18fd01350bd5434ca636d59a599d768a","ae5ac430ea254e708a6f5deaaf7464ae",22850084,1,-2,0,253,86,84,-2
"ae5ac430ea254e708a6f5deaaf7464ae","6a9f0ef185fb47f0937e29daa1c71ed5",22850084,1,7,0,254,84,90,6
"6a9f0ef185fb47f0937e29daa1c71ed5","6a9f0ef185fb47f0937e29daa1c71ed5",22850084,6,0,1,255,90,90,0
"6a9f0ef185fb47f0937e29daa1c71ed5","c681290961c94c4caf23b529d1ae6b9a",22850084,1,-2,0,259,90,88,-2
"c681290961c94c4caf23b529d1ae6b9a","c681290961c94c4caf23b529d1ae6b9a",22850084,1,0,1,260,88,88,0
"c681290961c94c4caf23b529d1ae6b9a","d646286c8051419bbc2e31dd1db55ca8",22850084,1,-25,0,261,88,67,-21
"d646286c8051419bbc2e31dd1db55ca8","e20db35ced8544ddac5bc3839145e463",22850084,2,30,0,262,67,91,24
"e20db35ced8544ddac5bc3839145e463","8f73ba6f5a0042f2850356ac38ac6f24",22850084,1,4,0,263,91,95,4
"8f73ba6f5a0042f2850356ac38ac6f24","8f73ba6f5a0042f2850356ac38ac6f24",22850084,5,0,1,264,95,95,0
"8f73ba6f5a0042f2850356ac38ac6f24","e2260b86653c46d7b14a41fb419dbf8c",22850084,1,1,0,269,95,96,1
"e2260b86653c46d7b14a41fb419dbf8c","e2260b86653c46d7b14a41fb419dbf8c",22850084,2,0,1,270,96,96,0
"e2260b86653c46d7b14a41fb419dbf8c","35eb641ad1d845bbba54915bce75a962",22850084,1,1,0,272,96,97,1
"35eb641ad1d845bbba54915bce75a962","35eb641ad1d845bbba54915bce75a962",22850084,5,0,1,273,97,97,0
"35eb641ad1d845bbba54915bce75a962","08be90ffbeea4795a138cd42ed8db56f",22850084,1,1,0,278,97,98,1
"08be90ffbeea4795a138cd42ed8db56f","08be90ffbeea4795a138cd42ed8db56f",22850084,6,0,1,279,98,98,0
"08be90ffbeea4795a138cd42ed8db56f","3007433c8f584dcbb5ac159c1c5f2be3",22850084,1,1,0,285,98,99,1
"3007433c8f584dcbb5ac159c1c5f2be3","3007433c8f584dcbb5ac159c1c5f2be3",22850084,5,0,1,286,99,99,0
"3007433c8f584dcbb5ac159c1c5f2be3","1febb706d7a34005ae8711ed49c76e64",22850084,1,-5,0,291,99,94,-5
"1febb706d7a34005ae8711ed49c76e64","1febb706d7a34005ae8711ed49c76e64",22850084,5,0,1,292,94,94,0
"1febb706d7a34005ae8711ed49c76e64","d391c8b6e56a43a7b654e9dee02d904b",22850084,1,10,0,297,94,103,9
"d391c8b6e56a43a7b654e9dee02d904b","00ae5f0c51874a73a41ebea838d95682",22850084,1,-2,0,298,103,101,-2
"00ae5f0c51874a73a41ebea838d95682","e20db35ced8544ddac5bc3839145e463",22850084,1,-11,0,299,101,91,-10
"e20db35ced8544ddac5bc3839145e463","00ae5f0c51874a73a41ebea838d95682",22850084,1,11,0,300,91,101,10
"00ae5f0c51874a73a41ebea838d95682","d391c8b6e56a43a7b654e9dee02d904b",22850084,1,2,0,301,101,103,2
"d391c8b6e56a43a7b654e9dee02d904b","d391c8b6e56a43a7b654e9dee02d904b",22850084,15,0,1,302,103,103,0
"d391c8b6e56a43a7b654e9dee02d904b","6111116566fc4fd9abba409322bea245",22850084,1,1,0,317,103,104,1
"6111116566fc4fd9abba409322bea245","6111116566fc4fd9abba409322bea245",22850084,2,0,1,318,104,104,0
"6111116566fc4fd9abba409322bea245","a81b2235cb9c499eb9ea8ee0a8dd9725",22850084,1,1,0,320,104,105,1
"a81b2235cb9c499eb9ea8ee0a8dd9725","a81b2235cb9c499eb9ea8ee0a8dd9725",22850084,2,0,1,321,105,105,0
"a81b2235cb9c499eb9ea8ee0a8dd9725","2d4e0ab0ef3b4d73b82c72d4621a7579",22850084,1,1,0,323,105,106,1
"2d4e0ab0ef3b4d73b82c72d4621a7579","2d4e0ab0ef3b4d73b82c72d4621a7579",22850084,2,0,1,324,106,106,0
"2d4e0ab0ef3b4d73b82c72d4621a7579","8bdebf492ebd4e62b0d522e8ab5e5197",22850084,1,1,0,326,106,107,1
"8bdebf492ebd4e62b0d522e8ab5e5197","8bdebf492ebd4e62b0d522e8ab5e5197",22850084,2,0,1,327,107,107,0
"8bdebf492ebd4e62b0d522e8ab5e5197","73039f8c1eb9409cb4caee2cf968001e",22850084,1,-7,0,329,107,100,-7
"73039f8c1eb9409cb4caee2cf968001e","4280927ec4d643238aa49c32f9e06c6c",22850084,1,10,0,330,100,109,9
"4280927ec4d643238aa49c32f9e06c6c","4280927ec4d643238aa49c32f9e06c6c",22850084,2,0,1,331,109,109,0
"4280927ec4d643238aa49c32f9e06c6c","fc44e6a5f7654430af1227838224dceb",22850084,1,2,0,333,109,111,2
"fc44e6a5f7654430af1227838224dceb","fc44e6a5f7654430af1227838224dceb",22850084,2,0,1,334,111,111,0
"fc44e6a5f7654430af1227838224dceb","08111f75e22d409998cf8b85bd431f0a",22850084,1,-3,0,336,111,108,-3
"08111f75e22d409998cf8b85bd431f0a","67a089198fcb4e1c8f2385786c2b296f",22850084,1,-86,0,337,108,39,-69
"67a089198fcb4e1c8f2385786c2b296f","37319e88176d4aefa91d7a9980dbae91",22850084,1,91,0,338,39,112,73
"37319e88176d4aefa91d7a9980dbae91","e20db35ced8544ddac5bc3839145e463",22850084,1,-24,0,339,112,91,-21
"e20db35ced8544ddac5bc3839145e463","e20db35ced8544ddac5bc3839145e463",22850084,1,0,1,340,91,91,0
"e20db35ced8544ddac5bc3839145e463","a9ae0a3c070d455bb4369a8996313336",22850084,1,26,0,341,91,114,23
"a9ae0a3c070d455bb4369a8996313336","a9ae0a3c070d455bb4369a8996313336",22850084,1,0,1,342,114,114,0
"a9ae0a3c070d455bb4369a8996313336","71cec822bcff4f30a20e75dc63ef7b65",22850084,1,2,0,343,114,116,2
"71cec822bcff4f30a20e75dc63ef7b65","71cec822bcff4f30a20e75dc63ef7b65",22850084,1,0,1,344,116,116,0
"71cec822bcff4f30a20e75dc63ef7b65","37319e88176d4aefa91d7a9980dbae91",22850084,1,-4,0,345,116,112,-4
"37319e88176d4aefa91d7a9980dbae91","62bff51286ef4f348717a3cf6fe2318f",22850084,1,9,0,346,112,120,8
"62bff51286ef4f348717a3cf6fe2318f","3ec3a3563847406fa73338f9e9999cf3",22850084,1,-3,0,347,120,117,-3
"3ec3a3563847406fa73338f9e9999cf3","e20db35ced8544ddac5bc3839145e463",22850084,1,-30,0,348,117,91,-26
"e20db35ced8544ddac5bc3839145e463","d646286c8051419bbc2e31dd1db55ca8",22850084,2,-30,0,349,91,67,-24
"d646286c8051419bbc2e31dd1db55ca8","6a9f0ef185fb47f0937e29daa1c71ed5",22850084,1,27,0,350,67,90,23
"6a9f0ef185fb47f0937e29daa1c71ed5","e20db35ced8544ddac5bc3839145e463",22850084,1,3,0,353,90,91,1
"e20db35ced8544ddac5bc3839145e463","62bff51286ef4f348717a3cf6fe2318f",22850084,1,33,0,356,91,120,29
"62bff51286ef4f348717a3cf6fe2318f","b1cd0e7dc3ad4a8eb91a4bfdbeb025b0",22850084,1,-2,0,357,120,118,-2
"b1cd0e7dc3ad4a8eb91a4bfdbeb025b0","b1cd0e7dc3ad4a8eb91a4bfdbeb025b0",22850084,3,0,1,358,118,118,0
"b1cd0e7dc3ad4a8eb91a4bfdbeb025b0","62bff51286ef4f348717a3cf6fe2318f",22850084,1,2,0,361,118,120,2
"62bff51286ef4f348717a3cf6fe2318f","62bff51286ef4f348717a3cf6fe2318f",22850084,3,0,1,362,120,120,0
"62bff51286ef4f348717a3cf6fe2318f","779f9ddd1fd14d1e9e69f72219a1fdbd",22850084,1,3,0,365,120,121,1
"779f9ddd1fd14d1e9e69f72219a1fdbd","e20db35ced8544ddac5bc3839145e463",22850084,1,-36,0,366,121,91,-30
"e20db35ced8544ddac5bc3839145e463","ae26e6cda8ad4a3f81bd347560d9579f",22850084,1,40,0,367,91,125,34
"ae26e6cda8ad4a3f81bd347560d9579f","ae26e6cda8ad4a3f81bd347560d9579f",22850084,1,0,1,368,125,125,0
"ae26e6cda8ad4a3f81bd347560d9579f","ee48df95832b4374aa273ceb27ec1315",22850084,1,1,0,369,125,126,1
"ee48df95832b4374aa273ceb27ec1315","ee48df95832b4374aa273ceb27ec1315",22850084,1,0,1,370,126,126,0
"ee48df95832b4374aa273ceb27ec1315","7a439da90b394756ad1777fc4c6dead5",22850084,1,1,0,371,126,127,1
"7a439da90b394756ad1777fc4c6dead5","7a439da90b394756ad1777fc4c6dead5",22850084,1,0,1,372,127,127,0
"7a439da90b394756ad1777fc4c6dead5","a8dd5213034441ac92724b4e83eb0bb2",22850084,1,3,0,373,127,129,2
"a8dd5213034441ac92724b4e83eb0bb2","779f9ddd1fd14d1e9e69f72219a1fdbd",22850084,1,-9,0,374,129,121,-8
"779f9ddd1fd14d1e9e69f72219a1fdbd","a8dd5213034441ac92724b4e83eb0bb2",22850084,1,9,0,375,121,129,8
"a8dd5213034441ac92724b4e83eb0bb2","8115eab6556b45f5b415c3b8c26a12e5",22850084,1,2,0,376,129,131,2
"8115eab6556b45f5b415c3b8c26a12e5","8115eab6556b45f5b415c3b8c26a12e5",22850084,2,0,1,377,131,131,0
"8115eab6556b45f5b415c3b8c26a12e5","ec34b06efd844b46a4c4818ecdb9b8f4",22850084,1,1,0,379,131,132,1
"ec34b06efd844b46a4c4818ecdb9b8f4","ec34b06efd844b46a4c4818ecdb9b8f4",22850084,2,0,1,380,132,132,0
"ec34b06efd844b46a4c4818ecdb9b8f4","c2e1c2b9eac64109b343a088584b576b",22850084,1,1,0,382,132,133,1
"c2e1c2b9eac64109b343a088584b576b","c2e1c2b9eac64109b343a088584b576b",22850084,2,0,1,383,133,133,0
"c2e1c2b9eac64109b343a088584b576b","579338175e0b4bbb8ef3b712b5d8b54e",22850084,1,-5,0,385,133,128,-5
"579338175e0b4bbb8ef3b712b5d8b54e","a8dd5213034441ac92724b4e83eb0bb2",22850084,1,1,0,386,128,129,1
"a8dd5213034441ac92724b4e83eb0bb2","b416d47c56a742199b5d7c7f19d6503a",22850084,1,6,0,387,129,134,5
"b416d47c56a742199b5d7c7f19d6503a","579338175e0b4bbb8ef3b712b5d8b54e",22850084,1,-7,0,388,134,128,-6
"579338175e0b4bbb8ef3b712b5d8b54e","8bc5795d6a984a3eace4e2811e52dd4f",22850084,1,8,0,389,128,135,7
"8bc5795d6a984a3eace4e2811e52dd4f","8bc5795d6a984a3eace4e2811e52dd4f",22850084,1,0,1,390,135,135,0
"8bc5795d6a984a3eace4e2811e52dd4f","b416d47c56a742199b5d7c7f19d6503a",22850084,1,-1,0,391,135,134,-1
"b416d47c56a742199b5d7c7f19d6503a","cd4532ad48034873ba8bce2aac0c9808",22850084,1,4,0,392,134,137,3
"cd4532ad48034873ba8bce2aac0c9808","cd4532ad48034873ba8bce2aac0c9808",22850084,1,0,1,393,137,137,0
"cd4532ad48034873ba8bce2aac0c9808","df1de691dafe4549a18a4398ee9dfaf9",22850084,1,4,0,394,137,139,2
"df1de691dafe4549a18a4398ee9dfaf9","779f9ddd1fd14d1e9e69f72219a1fdbd",22850084,1,-23,0,395,139,121,-18
"779f9ddd1fd14d1e9e69f72219a1fdbd","6c5ad271a44743479bfaea29b1db8d02",22850084,1,27,0,396,121,143,22
"6c5ad271a44743479bfaea29b1db8d02","6c5ad271a44743479bfaea29b1db8d02",22850084,1,0,1,397,143,143,0
"6c5ad271a44743479bfaea29b1db8d02","83d311bed5374fee83d8d67a7d9d82dc",22850084,1,1,0,398,143,144,1
"83d311bed5374fee83d8d67a7d9d82dc","83d311bed5374fee83d8d67a7d9d82dc",22850084,1,0,1,399,144,144,0
"83d311bed5374fee83d8d67a7d9d82dc","402bba41861d43acb52a5abb89e8831e",22850084,1,1,0,400,144,145,1
"402bba41861d43acb52a5abb89e8831e","402bba41861d43acb52a5abb89e8831e",22850084,2,0,1,401,145,145,0
"402bba41861d43acb52a5abb89e8831e","df1de691dafe4549a18a4398ee9dfaf9",22850084,1,-6,0,403,145,139,-6
"df1de691dafe4549a18a4398ee9dfaf9","8aae34f5ddbb4052a709b12e6b0d40fa",22850084,1,9,0,404,139,147,8
"8aae34f5ddbb4052a709b12e6b0d40fa","8aae34f5ddbb4052a709b12e6b0d40fa",22850084,1,0,1,405,147,147,0
"8aae34f5ddbb4052a709b12e6b0d40fa","645b3f0249f64f76af2e19eb4d0e55b7",22850084,1,2,0,406,147,149,2
"645b3f0249f64f76af2e19eb4d0e55b7","645b3f0249f64f76af2e19eb4d0e55b7",22850084,2,0,1,407,149,149,0
"645b3f0249f64f76af2e19eb4d0e55b7","7e7b8db5064d4369805ab370aac5ddfb",22850084,1,1,0,409,149,150,1
"7e7b8db5064d4369805ab370aac5ddfb","7e7b8db5064d4369805ab370aac5ddfb",22850084,2,0,1,410,150,150,0
"7e7b8db5064d4369805ab370aac5ddfb","8956d210ae7f41968fada86d4c979d6a",22850084,1,1,0,412,150,151,1
"8956d210ae7f41968fada86d4c979d6a","8956d210ae7f41968fada86d4c979d6a",22850084,2,0,1,413,151,151,0
"8956d210ae7f41968fada86d4c979d6a","f902b0f41b544d4dbf79664fd233648d",22850084,1,-5,0,415,151,146,-5
"f902b0f41b544d4dbf79664fd233648d","ae781e8b775e4ccd93bc800dad5c8376",22850084,1,8,0,416,146,153,7
"ae781e8b775e4ccd93bc800dad5c8376","ae781e8b775e4ccd93bc800dad5c8376",22850084,2,0,1,417,153,153,0
"ae781e8b775e4ccd93bc800dad5c8376","06882a8492d9499aa31555567f575ecb",22850084,1,1,0,419,153,154,1
"06882a8492d9499aa31555567f575ecb","06882a8492d9499aa31555567f575ecb",22850084,1,0,1,420,154,154,0
"06882a8492d9499aa31555567f575ecb","f293c508f409466a8f27ddd7d1e40b20",22850084,1,1,0,421,154,155,1
"f293c508f409466a8f27ddd7d1e40b20","f293c508f409466a8f27ddd7d1e40b20",22850084,2,0,1,422,155,155,0
"f293c508f409466a8f27ddd7d1e40b20","cc4ddef5bbbe48ebb605141b347c4ed1",22850084,1,1,0,424,155,156,1
"cc4ddef5bbbe48ebb605141b347c4ed1","cc4ddef5bbbe48ebb605141b347c4ed1",22850084,1,0,1,425,156,156,0
"cc4ddef5bbbe48ebb605141b347c4ed1","f03480cf4eba413194d7af52fc0e7f28",22850084,1,-4,0,426,156,152,-4
"f03480cf4eba413194d7af52fc0e7f28","d313cec988a84645bee413e8d4724a4b",22850084,1,7,0,427,152,158,6
"d313cec988a84645bee413e8d4724a4b","d313cec988a84645bee413e8d4724a4b",22850084,4,0,1,428,158,158,0
"d313cec988a84645bee413e8d4724a4b","dc60696c76a74368a60f72246e47700d",22850084,1,1,0,432,158,159,1
"dc60696c76a74368a60f72246e47700d","dc60696c76a74368a60f72246e47700d",22850084,1,0,1,433,159,159,0
"dc60696c76a74368a60f72246e47700d","df1de691dafe4549a18a4398ee9dfaf9",22850084,1,-23,0,434,159,139,-20
"df1de691dafe4549a18a4398ee9dfaf9","78adeee1fa2c4fe0bc73f7bca9fcee86",22850084,1,26,0,435,139,160,21
"78adeee1fa2c4fe0bc73f7bca9fcee86","65202579580f4ad38d734b4ee39d22a8",22850084,3,5,0,436,160,164,4
"65202579580f4ad38d734b4ee39d22a8","65202579580f4ad38d734b4ee39d22a8",22850084,61,0,1,437,164,164,0
"65202579580f4ad38d734b4ee39d22a8","78adeee1fa2c4fe0bc73f7bca9fcee86",22850084,3,-5,0,442,164,160,-4
"78adeee1fa2c4fe0bc73f7bca9fcee86","3cbcea2be0984e7dbd5a48195af10ce7",22850084,1,8,0,503,160,165,5
"3cbcea2be0984e7dbd5a48195af10ce7","82e6285962b8400d9d6fc32436022a94",22850084,2,2,0,504,165,167,2
"82e6285962b8400d9d6fc32436022a94","3cbcea2be0984e7dbd5a48195af10ce7",22850084,1,-2,0,505,167,165,-2
"3cbcea2be0984e7dbd5a48195af10ce7","a9ac840f098c4bd0a2ee896214ce29cd",22850084,1,5,0,506,165,168,3
"a9ac840f098c4bd0a2ee896214ce29cd","a9ac840f098c4bd0a2ee896214ce29cd",22850084,1,0,1,507,168,168,0
"a9ac840f098c4bd0a2ee896214ce29cd","0c7262dff33c4087bc660ccf40f92f9c",22850084,1,4,0,508,168,169,1
"0c7262dff33c4087bc660ccf40f92f9c","b2275c3fad834f8d90737a2d9a6927d6",22850084,3,3,0,509,169,172,3
"b2275c3fad834f8d90737a2d9a6927d6","0c7262dff33c4087bc660ccf40f92f9c",22850084,2,-3,0,510,172,169,-3
"b2275c3fad834f8d90737a2d9a6927d6","b2275c3fad834f8d90737a2d9a6927d6",22850084,20,0,1,514,172,172,0
"b2275c3fad834f8d90737a2d9a6927d6","eb515a26030b41f8a82a1e6114420bad",22850084,1,1,0,534,172,173,1
"eb515a26030b41f8a82a1e6114420bad","eb515a26030b41f8a82a1e6114420bad",22850084,2,0,1,535,173,173,0
"eb515a26030b41f8a82a1e6114420bad","b42cc17b7de840f181a704558d0bc845",22850084,1,3,0,537,173,175,2
"b42cc17b7de840f181a704558d0bc845","0c7262dff33c4087bc660ccf40f92f9c",22850084,1,-7,0,538,175,169,-6
"0c7262dff33c4087bc660ccf40f92f9c","b42cc17b7de840f181a704558d0bc845",22850084,1,7,0,539,169,175,6
"b42cc17b7de840f181a704558d0bc845","801f9e9135034f49bf5f8b4bdefedb41",22850084,1,2,0,540,175,177,2
"801f9e9135034f49bf5f8b4bdefedb41","801f9e9135034f49bf5f8b4bdefedb41",22850084,4,0,1,541,177,177,0
"801f9e9135034f49bf5f8b4bdefedb41","362fcb0699a14845ab29b2340093e528",22850084,1,-3,0,545,177,174,-3
"362fcb0699a14845ab29b2340093e528","b87c552dd247427abe6ab5795b9c9d43",22850084,1,8,0,546,174,181,7
"b87c552dd247427abe6ab5795b9c9d43","ea38cc0e6e6e41edbabf210220808bf9",22850084,1,-2,0,547,181,179,-2
"ea38cc0e6e6e41edbabf210220808bf9","ea38cc0e6e6e41edbabf210220808bf9",22850084,1,0,1,548,179,179,0
"ea38cc0e6e6e41edbabf210220808bf9","b87c552dd247427abe6ab5795b9c9d43",22850084,1,2,0,549,179,181,2
"b87c552dd247427abe6ab5795b9c9d43","b87c552dd247427abe6ab5795b9c9d43",22850084,9,0,1,550,181,181,0
"b87c552dd247427abe6ab5795b9c9d43","139b097acfca451689d80c9c6eebdf7b",22850084,1,-3,0,559,181,178,-3
"139b097acfca451689d80c9c6eebdf7b","30f660a1feb34582a739722532524f79",22850084,1,6,0,560,178,183,5
"30f660a1feb34582a739722532524f79","30f660a1feb34582a739722532524f79",22850084,3,0,1,561,183,183,0
"30f660a1feb34582a739722532524f79","2024b4885bd14338a39b7b509acbbd02",22850084,1,-1,0,564,183,182,-1
"2024b4885bd14338a39b7b509acbbd02","c3f63fe50d8e487c86bf8ef76c9cadd3",22850084,1,4,0,565,182,185,3
"c3f63fe50d8e487c86bf8ef76c9cadd3","c3f63fe50d8e487c86bf8ef76c9cadd3",22850084,1,0,1,566,185,185,0
"c3f63fe50d8e487c86bf8ef76c9cadd3","0c7262dff33c4087bc660ccf40f92f9c",22850084,1,-20,0,567,185,169,-16
"0c7262dff33c4087bc660ccf40f92f9c","c8e371568a0c4391b25796ae4e91952e",22850084,1,23,0,568,169,186,17
"c8e371568a0c4391b25796ae4e91952e","7d932b23e1c84326ae5aa4d3c0d813d1",22850084,1,2,0,569,186,188,2
"7d932b23e1c84326ae5aa4d3c0d813d1","7d932b23e1c84326ae5aa4d3c0d813d1",22850084,1,0,1,570,188,188,0
"7d932b23e1c84326ae5aa4d3c0d813d1","ab11d94c6c8948ea90b88f19d2cd502b",22850084,1,3,0,571,188,190,2
"ab11d94c6c8948ea90b88f19d2cd502b","c8e371568a0c4391b25796ae4e91952e",22850084,1,-5,0,572,190,186,-4
"c8e371568a0c4391b25796ae4e91952e","ab11d94c6c8948ea90b88f19d2cd502b",22850084,1,5,0,573,186,190,4
"ab11d94c6c8948ea90b88f19d2cd502b","f992451ed6ad4e68bb9e68ad6be7c4be",22850084,1,2,0,574,190,192,2
"f992451ed6ad4e68bb9e68ad6be7c4be","f992451ed6ad4e68bb9e68ad6be7c4be",22850084,1,0,1,575,192,192,0
"f992451ed6ad4e68bb9e68ad6be7c4be","07b44a7a51e94c78b411c753fc39dab0",22850084,1,-3,0,576,192,189,-3
"07b44a7a51e94c78b411c753fc39dab0","6cd2dcaac46847d4a0bc53f296d90375",22850084,1,6,0,577,189,194,5
"6cd2dcaac46847d4a0bc53f296d90375","0c7262dff33c4087bc660ccf40f92f9c",22850084,1,-33,0,578,194,169,-25
"0c7262dff33c4087bc660ccf40f92f9c","3cbcea2be0984e7dbd5a48195af10ce7",22850084,1,-9,0,579,169,165,-4
"3cbcea2be0984e7dbd5a48195af10ce7","3cbcea2be0984e7dbd5a48195af10ce7",22850084,1,0,1,580,165,165,0
"82e6285962b8400d9d6fc32436022a94","c8e371568a0c4391b25796ae4e91952e",22850084,1,30,0,582,167,186,19
"c8e371568a0c4391b25796ae4e91952e","6cd2dcaac46847d4a0bc53f296d90375",22850084,1,10,0,583,186,194,8
"6cd2dcaac46847d4a0bc53f296d90375","6cd2dcaac46847d4a0bc53f296d90375",22850084,1,0,1,584,194,194,0
"6cd2dcaac46847d4a0bc53f296d90375","2d2580c9411c4972909db508d6956a58",22850084,1,2,0,585,194,196,2
"2d2580c9411c4972909db508d6956a58","2d2580c9411c4972909db508d6956a58",22850084,5,0,1,586,196,196,0
"2d2580c9411c4972909db508d6956a58","5bddb3d9ed264f3984702f048c7e5340",22850084,1,1,0,591,196,197,1
"5bddb3d9ed264f3984702f048c7e5340","5bddb3d9ed264f3984702f048c7e5340",22850084,2,0,1,592,197,197,0
"5bddb3d9ed264f3984702f048c7e5340","d5e8e2bd12a2466b9d6d90855f0eb079",22850084,1,1,0,594,197,198,1
"d5e8e2bd12a2466b9d6d90855f0eb079","d5e8e2bd12a2466b9d6d90855f0eb079",22850084,2,0,1,595,198,198,0
"d5e8e2bd12a2466b9d6d90855f0eb079","017d7ca8e0394b91aaadc9574df2202c",22850084,1,-5,0,597,198,193,-5
"017d7ca8e0394b91aaadc9574df2202c","54e8e9f0ea3e45c4bf3b8ac799ee31b1",22850084,1,8,0,598,193,200,7
"54e8e9f0ea3e45c4bf3b8ac799ee31b1","54e8e9f0ea3e45c4bf3b8ac799ee31b1",22850084,1,0,1,599,200,200,0
"54e8e9f0ea3e45c4bf3b8ac799ee31b1","c614a00911be4877a075f19315530fb0",22850084,1,1,0,600,200,201,1
"c614a00911be4877a075f19315530fb0","c614a00911be4877a075f19315530fb0",22850084,6,0,1,601,201,201,0
"c614a00911be4877a075f19315530fb0","a6c21bd8b95249c7972820a7a7d76aff",22850084,1,1,0,607,201,202,1
"a6c21bd8b95249c7972820a7a7d76aff","a6c21bd8b95249c7972820a7a7d76aff",22850084,1,0,1,608,202,202,0
"a6c21bd8b95249c7972820a7a7d76aff","bb329d880ab54120adaf203a693bb203",22850084,1,1,0,609,202,203,1
"bb329d880ab54120adaf203a693bb203","bb329d880ab54120adaf203a693bb203",22850084,1,0,1,610,203,203,0
"bb329d880ab54120adaf203a693bb203","f9170dd6bc6442b4acd832747609b09a",22850084,1,-4,0,611,203,199,-4
"f9170dd6bc6442b4acd832747609b09a","334c2344009840079b1d0e1b7ce3d5a7",22850084,1,7,0,612,199,205,6
"334c2344009840079b1d0e1b7ce3d5a7","334c2344009840079b1d0e1b7ce3d5a7",22850084,1,0,1,613,205,205,0
"334c2344009840079b1d0e1b7ce3d5a7","c8e371568a0c4391b25796ae4e91952e",22850084,1,-23,0,614,205,186,-19
"c8e371568a0c4391b25796ae4e91952e","d7f13c8d63ec4e2aa673fbb9cf9c6933",22850084,1,26,0,615,186,206,20
"d7f13c8d63ec4e2aa673fbb9cf9c6933","7108f0e4c2584f1f9c471689ae4c885c",22850084,1,2,0,616,206,208,2
"7108f0e4c2584f1f9c471689ae4c885c","b9e80f77c3a44349863b19875725c384",22850084,1,-1,0,617,208,207,-1
"b9e80f77c3a44349863b19875725c384","b9e80f77c3a44349863b19875725c384",22850084,20,0,1,618,207,207,0
"b9e80f77c3a44349863b19875725c384","7108f0e4c2584f1f9c471689ae4c885c",22850084,1,1,0,638,207,208,1
"7108f0e4c2584f1f9c471689ae4c885c","7108f0e4c2584f1f9c471689ae4c885c",22850084,11,0,1,639,208,208,0
"7108f0e4c2584f1f9c471689ae4c885c","09400e101c5d4b439cf9a26b03aae558",22850084,1,3,0,650,208,210,2
"09400e101c5d4b439cf9a26b03aae558","d7f13c8d63ec4e2aa673fbb9cf9c6933",22850084,1,-5,0,651,210,206,-4
"d7f13c8d63ec4e2aa673fbb9cf9c6933","09400e101c5d4b439cf9a26b03aae558",22850084,1,5,0,652,206,210,4
"09400e101c5d4b439cf9a26b03aae558","a88efa7e50ce47159810ab553afa6d3a",22850084,1,2,0,653,210,212,2
"a88efa7e50ce47159810ab553afa6d3a","a88efa7e50ce47159810ab553afa6d3a",22850084,5,0,1,654,212,212,0
"a88efa7e50ce47159810ab553afa6d3a","be502a7a43c44bf7b682698de79d9369",22850084,1,3,0,659,212,214,2
"be502a7a43c44bf7b682698de79d9369","a875096404ef4a9984b62d74cda916f9",22850084,1,-6,0,660,214,209,-5
"a875096404ef4a9984b62d74cda916f9","f7fb1952f56b4189b86a9f8b7862d2b8",22850084,1,7,0,661,209,215,6
"f7fb1952f56b4189b86a9f8b7862d2b8","be502a7a43c44bf7b682698de79d9369",22850084,1,-1,0,662,215,214,-1
"be502a7a43c44bf7b682698de79d9369","f7fb1952f56b4189b86a9f8b7862d2b8",22850084,2,1,0,663,214,215,1
"f7fb1952f56b4189b86a9f8b7862d2b8","f7fb1952f56b4189b86a9f8b7862d2b8",22850084,25,0,1,664,215,215,0
"f7fb1952f56b4189b86a9f8b7862d2b8","d7f13c8d63ec4e2aa673fbb9cf9c6933",22850084,1,-11,0,681,215,206,-9
"d7f13c8d63ec4e2aa673fbb9cf9c6933","be502a7a43c44bf7b682698de79d9369",22850084,1,10,0,682,206,214,8
"f7fb1952f56b4189b86a9f8b7862d2b8","b860ee85d8bc4a2f97958cfb71be3533",22850084,1,1,0,692,215,216,1
"b860ee85d8bc4a2f97958cfb71be3533","b860ee85d8bc4a2f97958cfb71be3533",22850084,2,0,1,693,216,216,0
"b860ee85d8bc4a2f97958cfb71be3533","ec341f459285443b8361f7f15638ff08",22850084,1,-3,0,695,216,213,-3
"ec341f459285443b8361f7f15638ff08","363837c182e04711840d896ae1e0339c",22850084,1,6,0,696,213,218,5
"363837c182e04711840d896ae1e0339c","363837c182e04711840d896ae1e0339c",22850084,13,0,1,697,218,218,0
"363837c182e04711840d896ae1e0339c","01b2051f8941460d89945e3b02d1ce78",22850084,1,-1,0,710,218,217,-1
"01b2051f8941460d89945e3b02d1ce78","91125ca626c5470eb145501f8c37f8db",22850084,1,4,0,711,217,220,3
"91125ca626c5470eb145501f8c37f8db","91125ca626c5470eb145501f8c37f8db",22850084,1,0,1,712,220,220,0
"91125ca626c5470eb145501f8c37f8db","1c6721b1f63f4d30ba7746ea8af02a52",22850084,1,3,0,713,220,221,1
"1c6721b1f63f4d30ba7746ea8af02a52","d7f13c8d63ec4e2aa673fbb9cf9c6933",22850084,1,-21,0,714,221,206,-15
"d7f13c8d63ec4e2aa673fbb9cf9c6933","77ecef8eff6b4a2caea7707669bf7475",22850084,1,22,0,715,206,222,16
"77ecef8eff6b4a2caea7707669bf7475","0c7262dff33c4087bc660ccf40f92f9c",22850084,1,-71,0,716,222,169,-53
"0c7262dff33c4087bc660ccf40f92f9c","0c7262dff33c4087bc660ccf40f92f9c",22850084,1,0,1,717,169,169,0
"0c7262dff33c4087bc660ccf40f92f9c","1c6721b1f63f4d30ba7746ea8af02a52",22850084,1,70,0,718,169,221,52
"1c6721b1f63f4d30ba7746ea8af02a52","77ecef8eff6b4a2caea7707669bf7475",22850084,1,1,0,719,221,222,1
"77ecef8eff6b4a2caea7707669bf7475","77ecef8eff6b4a2caea7707669bf7475",22850084,12,0,1,720,222,222,0
"77ecef8eff6b4a2caea7707669bf7475","1c6721b1f63f4d30ba7746ea8af02a52",22850084,1,-1,0,732,222,221,-1
"1c6721b1f63f4d30ba7746ea8af02a52","d03cb855c70044cf8c35d9ec0de696e3",22850084,1,4,0,733,221,224,3
"d03cb855c70044cf8c35d9ec0de696e3","8b9ae98743bd4d4a8a87dff1c1244211",22850084,1,3,0,734,224,227,3
"8b9ae98743bd4d4a8a87dff1c1244211","d03cb855c70044cf8c35d9ec0de696e3",22850084,1,-3,0,735,227,224,-3
"d03cb855c70044cf8c35d9ec0de696e3","a49a937d6896486d9a5396654abcf2e1",22850084,1,2,0,736,224,226,2
"a49a937d6896486d9a5396654abcf2e1","a49a937d6896486d9a5396654abcf2e1",22850084,1,0,1,737,226,226,0
"a49a937d6896486d9a5396654abcf2e1","8b9ae98743bd4d4a8a87dff1c1244211",22850084,1,1,0,738,226,227,1
"8b9ae98743bd4d4a8a87dff1c1244211","8b9ae98743bd4d4a8a87dff1c1244211",22850084,16,0,1,739,227,227,0
"8b9ae98743bd4d4a8a87dff1c1244211","f7906d6f59b9489a91d2ef40db5a474d",22850084,1,-4,0,755,227,223,-4
"f7906d6f59b9489a91d2ef40db5a474d","2ab1535aac1346ba8801535bf729ef37",22850084,1,7,0,756,223,229,6
"2ab1535aac1346ba8801535bf729ef37","2ab1535aac1346ba8801535bf729ef37",22850084,1,0,1,757,229,229,0
"2ab1535aac1346ba8801535bf729ef37","a4f40fb48a8542c8949bae1f002cd9bc",22850084,1,2,0,758,229,231,2
"a4f40fb48a8542c8949bae1f002cd9bc","a4f40fb48a8542c8949bae1f002cd9bc",22850084,2,0,1,759,231,231,0
"a4f40fb48a8542c8949bae1f002cd9bc","8972c23e32044edb8a78fa1eed4e5947",22850084,1,1,0,761,231,232,1
"8972c23e32044edb8a78fa1eed4e5947","8972c23e32044edb8a78fa1eed4e5947",22850084,1,0,1,762,232,232,0
"8972c23e32044edb8a78fa1eed4e5947","92feb4a40f8344d38b6f722e42a53295",22850084,1,1,0,763,232,233,1
"92feb4a40f8344d38b6f722e42a53295","92feb4a40f8344d38b6f722e42a53295",22850084,2,0,1,764,233,233,0
"92feb4a40f8344d38b6f722e42a53295","5152833676bf4c6cb317060be10f68db",22850084,1,-5,0,766,233,228,-5
"5152833676bf4c6cb317060be10f68db","ca3e28f290354c08aefe5b0f769604e6",22850084,1,8,0,767,228,235,7
"ca3e28f290354c08aefe5b0f769604e6","ca3e28f290354c08aefe5b0f769604e6",22850084,9,0,1,768,235,235,0
"ca3e28f290354c08aefe5b0f769604e6","79a35eea833e4c2c9d22fc53c3c6445c",22850084,1,1,0,777,235,236,1
"79a35eea833e4c2c9d22fc53c3c6445c","79a35eea833e4c2c9d22fc53c3c6445c",22850084,4,0,1,778,236,236,0
"79a35eea833e4c2c9d22fc53c3c6445c","8f68228b1518449e9615cdafee41a2bd",22850084,1,1,0,782,236,237,1
"8f68228b1518449e9615cdafee41a2bd","8f68228b1518449e9615cdafee41a2bd",22850084,1,0,1,783,237,237,0
"8f68228b1518449e9615cdafee41a2bd","cab89fa5c3ed45a5aa550fc0352d6a42",22850084,1,1,0,784,237,238,1
"cab89fa5c3ed45a5aa550fc0352d6a42","cab89fa5c3ed45a5aa550fc0352d6a42",22850084,1,0,1,785,238,238,0
"cab89fa5c3ed45a5aa550fc0352d6a42","66d4fad4f1cf4b46be0750a99ad7a35a",22850084,1,1,0,786,238,239,1
"66d4fad4f1cf4b46be0750a99ad7a35a","66d4fad4f1cf4b46be0750a99ad7a35a",22850084,1,0,1,787,239,239,0
"66d4fad4f1cf4b46be0750a99ad7a35a","0b04c8e2f86d48c7aeb7e225819cd32b",22850084,1,-5,0,788,239,234,-5
"0b04c8e2f86d48c7aeb7e225819cd32b","f53da5fd9bfe412da4b80d4742563b6c",22850084,1,8,0,789,234,241,7
"f53da5fd9bfe412da4b80d4742563b6c","f53da5fd9bfe412da4b80d4742563b6c",22850084,1,0,1,790,241,241,0
"f53da5fd9bfe412da4b80d4742563b6c","1c6721b1f63f4d30ba7746ea8af02a52",22850084,1,-24,0,791,241,221,-20
"1c6721b1f63f4d30ba7746ea8af02a52","2ae94c0cea4d480a9d5dca8fb1d7b542",22850084,1,27,0,792,221,242,21
"2ae94c0cea4d480a9d5dca8fb1d7b542","1ebf23f9d994469a85206e4c7b1bf5f5",22850084,2,3,0,793,242,245,3
"1ebf23f9d994469a85206e4c7b1bf5f5","0c7262dff33c4087bc660ccf40f92f9c",22850084,1,-100,0,794,245,169,-76
"0c7262dff33c4087bc660ccf40f92f9c","2ae94c0cea4d480a9d5dca8fb1d7b542",22850084,1,97,0,795,169,242,73
"2ae94c0cea4d480a9d5dca8fb1d7b542","2ae94c0cea4d480a9d5dca8fb1d7b542",22850084,1,0,1,796,242,242,0
"1ebf23f9d994469a85206e4c7b1bf5f5","1ebf23f9d994469a85206e4c7b1bf5f5",22850084,10,0,1,798,245,245,0
"1ebf23f9d994469a85206e4c7b1bf5f5","85ae675b83e8422da842cfd25596af99",22850084,1,1,0,808,245,246,1
"85ae675b83e8422da842cfd25596af99","85ae675b83e8422da842cfd25596af99",22850084,1,0,1,809,246,246,0
"85ae675b83e8422da842cfd25596af99","fa235f0f364d47e4ae1c87f47bf8e6ba",22850084,1,8,0,810,246,252,6
"fa235f0f364d47e4ae1c87f47bf8e6ba","2ae94c0cea4d480a9d5dca8fb1d7b542",22850084,1,-12,0,811,252,242,-10
"2ae94c0cea4d480a9d5dca8fb1d7b542","fa235f0f364d47e4ae1c87f47bf8e6ba",22850084,1,12,0,812,242,252,10
"fa235f0f364d47e4ae1c87f47bf8e6ba","79f7845465cc4ed19d8e4f1429541be0",22850084,1,2,0,813,252,254,2
"79f7845465cc4ed19d8e4f1429541be0","79f7845465cc4ed19d8e4f1429541be0",22850084,2,0,1,814,254,254,0
"79f7845465cc4ed19d8e4f1429541be0","6e83e23f56544a19b94067c1c558d9c0",22850084,1,-8,0,816,254,247,-7
"6e83e23f56544a19b94067c1c558d9c0","00f61990949545828dd12f1303d47504",22850084,2,11,0,817,247,256,9
"00f61990949545828dd12f1303d47504","fa235f0f364d47e4ae1c87f47bf8e6ba",22850084,1,-5,0,818,256,252,-4
"fa235f0f364d47e4ae1c87f47bf8e6ba","d546341988904f069cfa86b21457d9d9",22850084,1,-1,0,819,252,251,-1
"d546341988904f069cfa86b21457d9d9","6e83e23f56544a19b94067c1c558d9c0",22850084,1,-5,0,820,251,247,-4
"00f61990949545828dd12f1303d47504","00f61990949545828dd12f1303d47504",22850084,1,0,1,822,256,256,0
"00f61990949545828dd12f1303d47504","ead7bb4b64e247d2ae632ab8a296b091",22850084,1,2,0,823,256,258,2
"ead7bb4b64e247d2ae632ab8a296b091","ead7bb4b64e247d2ae632ab8a296b091",22850084,2,0,1,824,258,258,0
"ead7bb4b64e247d2ae632ab8a296b091","41b0048dde734bb280bac6116baa8e27",22850084,1,1,0,826,258,259,1
"41b0048dde734bb280bac6116baa8e27","41b0048dde734bb280bac6116baa8e27",22850084,2,0,1,827,259,259,0
"41b0048dde734bb280bac6116baa8e27","b41c5a094a604ee0915327da5cc0beb7",22850084,1,1,0,829,259,260,1
"b41c5a094a604ee0915327da5cc0beb7","b41c5a094a604ee0915327da5cc0beb7",22850084,2,0,1,830,260,260,0
"b41c5a094a604ee0915327da5cc0beb7","d546341988904f069cfa86b21457d9d9",22850084,1,-10,0,832,260,251,-9
"d546341988904f069cfa86b21457d9d9","28c171777c52431ab6b925073bd63d46",22850084,1,15,0,833,251,264,13
"28c171777c52431ab6b925073bd63d46","28c171777c52431ab6b925073bd63d46",22850084,7,0,1,834,264,264,0
"28c171777c52431ab6b925073bd63d46","ac160db940cb49ae8579162b1d52bb5d",22850084,1,2,0,841,264,266,2
"ac160db940cb49ae8579162b1d52bb5d","ac160db940cb49ae8579162b1d52bb5d",22850084,3,0,1,842,266,266,0
"ac160db940cb49ae8579162b1d52bb5d","d989ebcfc12a4b669f0100dc1aa14f1e",22850084,1,-12,0,845,266,255,-11
"d989ebcfc12a4b669f0100dc1aa14f1e","c6fd49b485cc4874b0bbdd9c6171e09c",22850084,1,15,0,846,255,268,13
"c6fd49b485cc4874b0bbdd9c6171e09c","c6fd49b485cc4874b0bbdd9c6171e09c",22850084,3,0,1,847,268,268,0
"c6fd49b485cc4874b0bbdd9c6171e09c","44240778a97c4af0937817499b75707b",22850084,1,1,0,850,268,269,1
"44240778a97c4af0937817499b75707b","44240778a97c4af0937817499b75707b",22850084,2,0,1,851,269,269,0
"44240778a97c4af0937817499b75707b","7aa76d3e993840d8805f097cbdbcd44b",22850084,1,-9,0,853,269,261,-8
"7aa76d3e993840d8805f097cbdbcd44b","865a4d3b43374da7944dc7d397f566d9",22850084,1,12,0,854,261,271,10
"865a4d3b43374da7944dc7d397f566d9","865a4d3b43374da7944dc7d397f566d9",22850084,1,0,1,855,271,271,0
"865a4d3b43374da7944dc7d397f566d9","2ae94c0cea4d480a9d5dca8fb1d7b542",22850084,1,-35,0,856,271,242,-29
"2ae94c0cea4d480a9d5dca8fb1d7b542","0d987bed3ffa4ed0b9a2e62e97b7b30f",22850084,5,38,0,857,242,272,30
"0d987bed3ffa4ed0b9a2e62e97b7b30f","0d987bed3ffa4ed0b9a2e62e97b7b30f",22850084,6,0,1,858,272,272,0
"0d987bed3ffa4ed0b9a2e62e97b7b30f","82ae07bc0c9b4570a41799290d1ef399",22850084,3,4,0,860,272,275,3
"82ae07bc0c9b4570a41799290d1ef399","0d987bed3ffa4ed0b9a2e62e97b7b30f",22850084,3,-4,0,861,275,272,-3
"82ae07bc0c9b4570a41799290d1ef399","2ae94c0cea4d480a9d5dca8fb1d7b542",22850084,1,-42,0,865,275,242,-33
"0d987bed3ffa4ed0b9a2e62e97b7b30f","fa235f0f364d47e4ae1c87f47bf8e6ba",22850084,1,-26,0,867,272,252,-20
"fa235f0f364d47e4ae1c87f47bf8e6ba","7028800abe7d4e27b613d1d6cbe26bf7",22850084,1,18,0,868,252,267,15
"7028800abe7d4e27b613d1d6cbe26bf7","00f61990949545828dd12f1303d47504",22850084,1,-13,0,869,267,256,-11
"00f61990949545828dd12f1303d47504","6e83e23f56544a19b94067c1c558d9c0",22850084,1,-11,0,870,256,247,-9
"6e83e23f56544a19b94067c1c558d9c0","d546341988904f069cfa86b21457d9d9",22850084,1,5,0,871,247,251,4
"d546341988904f069cfa86b21457d9d9","d989ebcfc12a4b669f0100dc1aa14f1e",22850084,1,5,0,872,251,255,4
"d989ebcfc12a4b669f0100dc1aa14f1e","7aa76d3e993840d8805f097cbdbcd44b",22850084,1,7,0,873,255,261,6
"7aa76d3e993840d8805f097cbdbcd44b","0d987bed3ffa4ed0b9a2e62e97b7b30f",22850084,1,15,0,874,261,272,11
"0d987bed3ffa4ed0b9a2e62e97b7b30f","2ae94c0cea4d480a9d5dca8fb1d7b542",22850084,3,-38,0,875,272,242,-30
"0d987bed3ffa4ed0b9a2e62e97b7b30f","bb5a47f5ea01454a8b79455422d3b9da",22850084,5,10,0,881,272,280,8
"bb5a47f5ea01454a8b79455422d3b9da","82ae07bc0c9b4570a41799290d1ef399",22850084,3,-6,0,886,280,275,-5
"82ae07bc0c9b4570a41799290d1ef399","bb5a47f5ea01454a8b79455422d3b9da",22850084,3,6,0,887,275,280,5
"bb5a47f5ea01454a8b79455422d3b9da","bc5524e78a8544e2ae2fdc2f3462bbec",22850084,2,-1,0,890,280,279,-1
"bc5524e78a8544e2ae2fdc2f3462bbec","bb5a47f5ea01454a8b79455422d3b9da",22850084,1,1,0,891,279,280,1
"bc5524e78a8544e2ae2fdc2f3462bbec","82ae07bc0c9b4570a41799290d1ef399",22850084,1,-5,0,962,279,275,-4
"bb5a47f5ea01454a8b79455422d3b9da","bb5a47f5ea01454a8b79455422d3b9da",22850084,97,0,1,1000,280,280,0
"bb5a47f5ea01454a8b79455422d3b9da","0d987bed3ffa4ed0b9a2e62e97b7b30f",22850084,4,-10,0,1001,280,272,-8
"0d987bed3ffa4ed0b9a2e62e97b7b30f","94cecc3f1e7d484b8e068e79241dfd73",22850084,1,13,0,1002,272,281,9
"94cecc3f1e7d484b8e068e79241dfd73","a37477c4e4c14169ad44b06b493007f6",22850084,1,2,0,1003,281,283,2
"a37477c4e4c14169ad44b06b493007f6","fab84b4fab5940efb4ea868ef8d09396",22850084,1,3,0,1004,283,284,1
"fab84b4fab5940efb4ea868ef8d09396","94cecc3f1e7d484b8e068e79241dfd73",22850084,1,-5,0,1005,284,281,-3
"94cecc3f1e7d484b8e068e79241dfd73","4a29443515bb404cb8924e1c60a63b73",22850084,1,9,0,1006,281,285,4
"4a29443515bb404cb8924e1c60a63b73","fab84b4fab5940efb4ea868ef8d09396",22850084,1,-4,0,1007,285,284,-1
"fab84b4fab5940efb4ea868ef8d09396","208c9b2796c944db8dacaa96082520ea",22850084,1,7,0,1008,284,288,4
"208c9b2796c944db8dacaa96082520ea","0d987bed3ffa4ed0b9a2e62e97b7b30f",22850084,1,-25,0,1009,288,272,-16
"0d987bed3ffa4ed0b9a2e62e97b7b30f","4a29443515bb404cb8924e1c60a63b73",22850084,1,22,0,1010,272,285,13
"4a29443515bb404cb8924e1c60a63b73","4a29443515bb404cb8924e1c60a63b73",22850084,1,0,1,1011,285,285,0
"4a29443515bb404cb8924e1c60a63b73","208c9b2796c944db8dacaa96082520ea",22850084,1,3,0,1012,285,288,3
"208c9b2796c944db8dacaa96082520ea","208c9b2796c944db8dacaa96082520ea",22850084,1,0,1,1013,288,288,0
"208c9b2796c944db8dacaa96082520ea","4a29443515bb404cb8924e1c60a63b73",22850084,1,-3,0,1014,288,285,-3
"4a29443515bb404cb8924e1c60a63b73","7669a956527947d0add87455277e80b4",22850084,1,7,0,1015,285,291,6
"7669a956527947d0add87455277e80b4","7669a956527947d0add87455277e80b4",22850084,1,0,1,1016,291,291,0
"7669a956527947d0add87455277e80b4","6a9a3b5bde4a48daa896fe8c06eca56f",22850084,1,-2,0,1017,291,289,-2
"6a9a3b5bde4a48daa896fe8c06eca56f","869e967078f04da18dd0b0b9389a7424",22850084,1,5,0,1018,289,293,4
"869e967078f04da18dd0b0b9389a7424","869e967078f04da18dd0b0b9389a7424",22850084,1,0,1,1019,293,293,0
"869e967078f04da18dd0b0b9389a7424","51ab6291537748fab90d519aa09889d6",22850084,1,2,0,1020,293,295,2
"51ab6291537748fab90d519aa09889d6","51ab6291537748fab90d519aa09889d6",22850084,5,0,1,1021,295,295,0
"51ab6291537748fab90d519aa09889d6","34a6e49023fc4465bd5ca604330bbd1c",22850084,1,-3,0,1026,295,292,-3
"34a6e49023fc4465bd5ca604330bbd1c","21592f2a9e9c4b2f8c66ec5dbcbf6a2b",22850084,1,5,0,1027,292,296,4
"21592f2a9e9c4b2f8c66ec5dbcbf6a2b","ba0e59461bfb4a44b7b1c28a01f8d3b3",22850084,1,4,0,1028,296,299,3
"ba0e59461bfb4a44b7b1c28a01f8d3b3","ba0e59461bfb4a44b7b1c28a01f8d3b3",22850084,1,0,1,1029,299,299,0
"ba0e59461bfb4a44b7b1c28a01f8d3b3","0e0b36e731a645e7b1b8a88f5031ca38",22850084,1,2,0,1030,299,301,2
"0e0b36e731a645e7b1b8a88f5031ca38","0e0b36e731a645e7b1b8a88f5031ca38",22850084,2,0,1,1031,301,301,0
"0e0b36e731a645e7b1b8a88f5031ca38","a66a144637284c21afc6de17fea4bfb8",22850084,1,1,0,1033,301,302,1
"a66a144637284c21afc6de17fea4bfb8","a66a144637284c21afc6de17fea4bfb8",22850084,2,0,1,1034,302,302,0
"a66a144637284c21afc6de17fea4bfb8","7646a919d7e64fa990bca9b024ff089d",22850084,1,-4,0,1036,302,298,-4
"7646a919d7e64fa990bca9b024ff089d","e390b575229748ea8aac9364efe2bf00",22850084,1,7,0,1037,298,304,6
"e390b575229748ea8aac9364efe2bf00","e390b575229748ea8aac9364efe2bf00",22850084,1,0,1,1038,304,304,0
"e390b575229748ea8aac9364efe2bf00","4a29443515bb404cb8924e1c60a63b73",22850084,1,-24,0,1039,304,285,-19
"4a29443515bb404cb8924e1c60a63b73","3434c10e561d488a914e0f7d71907abd",22850084,1,27,0,1040,285,305,20
"3434c10e561d488a914e0f7d71907abd","53e7e900392747ccad52e711ab0f80d8",22850084,1,2,0,1041,305,307,2
"53e7e900392747ccad52e711ab0f80d8","53e7e900392747ccad52e711ab0f80d8",22850084,1,0,1,1042,307,307,0
"53e7e900392747ccad52e711ab0f80d8","3434c10e561d488a914e0f7d71907abd",22850084,1,-2,0,1043,307,305,-2
"3434c10e561d488a914e0f7d71907abd","130acc2aeb0448fdbb2de63bc5cebe5b",22850084,1,5,0,1044,305,309,4
"130acc2aeb0448fdbb2de63bc5cebe5b","130acc2aeb0448fdbb2de63bc5cebe5b",22850084,1,0,1,1045,309,309,0
"130acc2aeb0448fdbb2de63bc5cebe5b","9c062b3251034ebe90f5054e2a3b5120",22850084,1,2,0,1046,309,311,2
"9c062b3251034ebe90f5054e2a3b5120","9c062b3251034ebe90f5054e2a3b5120",22850084,2,0,1,1047,311,311,0
"9c062b3251034ebe90f5054e2a3b5120","ea859f8207e44537889daeaba13ac2e8",22850084,1,1,0,1049,311,312,1
"ea859f8207e44537889daeaba13ac2e8","ea859f8207e44537889daeaba13ac2e8",22850084,1,0,1,1050,312,312,0
"ea859f8207e44537889daeaba13ac2e8","56d94971a7a94257aa330183a8ebd0ea",22850084,1,1,0,1051,312,313,1
"56d94971a7a94257aa330183a8ebd0ea","56d94971a7a94257aa330183a8ebd0ea",22850084,1,0,1,1052,313,313,0
"56d94971a7a94257aa330183a8ebd0ea","141c0df6cd1946539aadd1c9b7068cd4",22850084,1,-5,0,1053,313,308,-5
"141c0df6cd1946539aadd1c9b7068cd4","13255e63e0aa4abf85e5211bf613d43e",22850084,1,10,0,1054,308,317,9
"13255e63e0aa4abf85e5211bf613d43e","13255e63e0aa4abf85e5211bf613d43e",22850084,3,0,1,1055,317,317,0
"13255e63e0aa4abf85e5211bf613d43e","0c787d16c9504873b1a4d903cec09948",22850084,1,-3,0,1058,317,314,-3
"0c787d16c9504873b1a4d903cec09948","86c27d40179e419c8e9d150fb6afa5d0",22850084,1,6,0,1059,314,319,5
"86c27d40179e419c8e9d150fb6afa5d0","86c27d40179e419c8e9d150fb6afa5d0",22850084,1,0,1,1060,319,319,0
"86c27d40179e419c8e9d150fb6afa5d0","47edbb64109243e6b0f8f64cdef90c6c",22850084,2,8,0,1061,319,326,7
"47edbb64109243e6b0f8f64cdef90c6c","8d7e0b55cf9849cda222a0f2440cec55",22850084,2,-9,0,1062,326,318,-8
"8d7e0b55cf9849cda222a0f2440cec55","24f1363179ad4aaa965484a78471912b",22850084,2,6,0,1063,318,323,5
"24f1363179ad4aaa965484a78471912b","3628bdce1dd2429ba924d2d4d09448d2",22850084,2,-1,0,1064,323,322,-1
"3628bdce1dd2429ba924d2d4d09448d2","86c27d40179e419c8e9d150fb6afa5d0",22850084,1,-4,0,1065,322,319,-3
"24f1363179ad4aaa965484a78471912b","24f1363179ad4aaa965484a78471912b",22850084,4,0,1,1069,323,323,0
"3628bdce1dd2429ba924d2d4d09448d2","3434c10e561d488a914e0f7d71907abd",22850084,1,-21,0,1074,322,305,-17
"3434c10e561d488a914e0f7d71907abd","56b3fd1a212a4764be39d979fde3326e",22850084,1,28,0,1075,305,328,23
"56b3fd1a212a4764be39d979fde3326e","56b3fd1a212a4764be39d979fde3326e",22850084,1,0,1,1076,328,328,0
"56b3fd1a212a4764be39d979fde3326e","0c4079457ede49e3aeb5e86ed84bdf35",22850084,1,3,0,1077,328,329,1
"0c4079457ede49e3aeb5e86ed84bdf35","3434c10e561d488a914e0f7d71907abd",22850084,1,-31,0,1078,329,305,-24
"3434c10e561d488a914e0f7d71907abd","38aea304b4fa46e1b29bb72f5cea4c93",22850084,1,33,0,1079,305,331,26
"38aea304b4fa46e1b29bb72f5cea4c93","38aea304b4fa46e1b29bb72f5cea4c93",22850084,1,0,1,1080,331,331,0
"38aea304b4fa46e1b29bb72f5cea4c93","e36d261332f14e79bb4b467aceaeb9b5",22850084,1,2,0,1081,331,333,2
"e36d261332f14e79bb4b467aceaeb9b5","e36d261332f14e79bb4b467aceaeb9b5",22850084,1,0,1,1082,333,333,0
"e36d261332f14e79bb4b467aceaeb9b5","c7e89b9d04744d2eab742fc24e3ef1ae",22850084,1,1,0,1083,333,334,1
"c7e89b9d04744d2eab742fc24e3ef1ae","c7e89b9d04744d2eab742fc24e3ef1ae",22850084,2,0,1,1084,334,334,0
"c7e89b9d04744d2eab742fc24e3ef1ae","fe49f8054b374a0ea4bb266ed135ff62",22850084,1,1,0,1086,334,335,1
"fe49f8054b374a0ea4bb266ed135ff62","fe49f8054b374a0ea4bb266ed135ff62",22850084,2,0,1,1087,335,335,0
"fe49f8054b374a0ea4bb266ed135ff62","d0a8f74af98642fe8360d22c42e45117",22850084,1,1,0,1089,335,336,1
"d0a8f74af98642fe8360d22c42e45117","d0a8f74af98642fe8360d22c42e45117",22850084,2,0,1,1090,336,336,0
"d0a8f74af98642fe8360d22c42e45117","0c4079457ede49e3aeb5e86ed84bdf35",22850084,1,-7,0,1092,336,329,-7
"0c4079457ede49e3aeb5e86ed84bdf35","a7c6339ca1da4368a18d471f0519f877",22850084,1,11,0,1093,329,339,10
"a7c6339ca1da4368a18d471f0519f877","a7c6339ca1da4368a18d471f0519f877",22850084,1,0,1,1094,339,339,0
"a7c6339ca1da4368a18d471f0519f877","bbc5139ca9024389a94db3a6f47dcff6",22850084,1,3,0,1095,339,341,2
"bbc5139ca9024389a94db3a6f47dcff6","b8b9418ab322418d9db9b40d96af873a",22850084,1,-5,0,1096,341,337,-4
"b8b9418ab322418d9db9b40d96af873a","bbc5139ca9024389a94db3a6f47dcff6",22850084,1,5,0,1097,337,341,4
"bbc5139ca9024389a94db3a6f47dcff6","bbc5139ca9024389a94db3a6f47dcff6",22850084,1,0,1,1098,341,341,0
"bbc5139ca9024389a94db3a6f47dcff6","4ee6ca9019ab4a1ab323f98094a9bd77",22850084,1,2,0,1099,341,343,2
"4ee6ca9019ab4a1ab323f98094a9bd77","4ee6ca9019ab4a1ab323f98094a9bd77",22850084,2,0,1,1100,343,343,0
"4ee6ca9019ab4a1ab323f98094a9bd77","b37947176785476f8b29d49a851366dc",22850084,1,1,0,1102,343,344,1
"b37947176785476f8b29d49a851366dc","b37947176785476f8b29d49a851366dc",22850084,2,0,1,1103,344,344,0
"b37947176785476f8b29d49a851366dc","fcea5b10d5a14a3b9324ffece8f6e1e5",22850084,1,1,0,1105,344,345,1
"fcea5b10d5a14a3b9324ffece8f6e1e5","fcea5b10d5a14a3b9324ffece8f6e1e5",22850084,2,0,1,1106,345,345,0
"fcea5b10d5a14a3b9324ffece8f6e1e5","c2490bc612d146edbe786556fab3651b",22850084,1,-5,0,1108,345,340,-5
"c2490bc612d146edbe786556fab3651b","6ac8bb048b854999a47edb35fe627f11",22850084,1,8,0,1109,340,347,7
"6ac8bb048b854999a47edb35fe627f11","6ac8bb048b854999a47edb35fe627f11",22850084,1,0,1,1110,347,347,0
"6ac8bb048b854999a47edb35fe627f11","0c4079457ede49e3aeb5e86ed84bdf35",22850084,1,-21,0,1111,347,329,-18
"0c4079457ede49e3aeb5e86ed84bdf35","30ead9794d4847abaf222ca966cc8630",22850084,1,24,0,1112,329,348,19
"30ead9794d4847abaf222ca966cc8630","eff0de7f2dbb42dfa1a2e686efab5b6d",22850084,1,6,0,1113,348,354,6
"eff0de7f2dbb42dfa1a2e686efab5b6d","09b9678ddc3d452ea4a3d46e15826065",22850084,1,-1,0,1114,354,353,-1
"09b9678ddc3d452ea4a3d46e15826065","c20993c944444fe085345591a8bd837e",22850084,1,-2,0,1115,353,351,-2
"c20993c944444fe085345591a8bd837e","897b7f51242c44aab2205c72fdcbf4cd",22850084,2,1,0,1116,351,352,1
"897b7f51242c44aab2205c72fdcbf4cd","c20993c944444fe085345591a8bd837e",22850084,1,-1,0,1117,352,351,-1
"c20993c944444fe085345591a8bd837e","c20993c944444fe085345591a8bd837e",22850084,3,0,1,1118,351,351,0
"897b7f51242c44aab2205c72fdcbf4cd","897b7f51242c44aab2205c72fdcbf4cd",22850084,3,0,1,1122,352,352,0
"897b7f51242c44aab2205c72fdcbf4cd","09b9678ddc3d452ea4a3d46e15826065",22850084,1,1,0,1125,352,353,1
"09b9678ddc3d452ea4a3d46e15826065","09b9678ddc3d452ea4a3d46e15826065",22850084,3,0,1,1126,353,353,0
"09b9678ddc3d452ea4a3d46e15826065","eff0de7f2dbb42dfa1a2e686efab5b6d",22850084,1,1,0,1129,353,354,1
"eff0de7f2dbb42dfa1a2e686efab5b6d","eff0de7f2dbb42dfa1a2e686efab5b6d",22850084,3,0,1,1130,354,354,0
"eff0de7f2dbb42dfa1a2e686efab5b6d","2fe14166dc9642c3bc666b86a57f943d",22850084,1,4,0,1133,354,357,3
"2fe14166dc9642c3bc666b86a57f943d","30ead9794d4847abaf222ca966cc8630",22850084,2,-10,0,1134,357,348,-9
"30ead9794d4847abaf222ca966cc8630","2fe14166dc9642c3bc666b86a57f943d",22850084,1,10,0,1135,348,357,9
"2fe14166dc9642c3bc666b86a57f943d","44421dd1e13a47a388c4a19834b744c7",22850084,1,2,0,1136,357,359,2
"44421dd1e13a47a388c4a19834b744c7","44421dd1e13a47a388c4a19834b744c7",22850084,2,0,1,1137,359,359,0
"44421dd1e13a47a388c4a19834b744c7","cb5fc7ef85d547c4be1a7439d0bf6052",22850084,1,1,0,1139,359,360,1
"cb5fc7ef85d547c4be1a7439d0bf6052","cb5fc7ef85d547c4be1a7439d0bf6052",22850084,2,0,1,1140,360,360,0
"cb5fc7ef85d547c4be1a7439d0bf6052","0a8f150a4cf747acbde62f4721823da3",22850084,1,1,0,1142,360,361,1
"0a8f150a4cf747acbde62f4721823da3","0a8f150a4cf747acbde62f4721823da3",22850084,2,0,1,1143,361,361,0
"0a8f150a4cf747acbde62f4721823da3","ab8fdad974ae471f9f24c3f9dd04462e",22850084,1,1,0,1145,361,362,1
"ab8fdad974ae471f9f24c3f9dd04462e","ab8fdad974ae471f9f24c3f9dd04462e",22850084,2,0,1,1146,362,362,0
"ab8fdad974ae471f9f24c3f9dd04462e","52580888dadb4fe3baa795683ea227bd",22850084,1,3,0,1148,362,364,2
"52580888dadb4fe3baa795683ea227bd","1ba8fef685d74a8194b9db252eb704fb",22850084,1,-10,0,1149,364,355,-9
"1ba8fef685d74a8194b9db252eb704fb","52580888dadb4fe3baa795683ea227bd",22850084,1,10,0,1150,355,364,9
"52580888dadb4fe3baa795683ea227bd","492a3bc6a1254f23a7998587961b22a4",22850084,1,3,0,1151,364,366,2
"492a3bc6a1254f23a7998587961b22a4","f00179e251a045b39c3f7a54f9aa4acc",22850084,1,-4,0,1152,366,363,-3
"f00179e251a045b39c3f7a54f9aa4acc","492a3bc6a1254f23a7998587961b22a4",22850084,1,4,0,1153,363,366,3
"492a3bc6a1254f23a7998587961b22a4","072a190fd302456290895f9f04d6940a",22850084,3,-1,0,1154,366,365,-1
"072a190fd302456290895f9f04d6940a","30ead9794d4847abaf222ca966cc8630",22850084,1,-20,0,1155,365,348,-17
"30ead9794d4847abaf222ca966cc8630","c76574d21bc14aeea7ecd0b027f39858",22850084,3,23,0,1156,348,367,19
"c76574d21bc14aeea7ecd0b027f39858","2fe14166dc9642c3bc666b86a57f943d",22850084,1,-13,0,1157,367,357,-10
"2fe14166dc9642c3bc666b86a57f943d","cfa457d1743848e4bb5e4beced6448ed",22850084,1,15,0,1158,357,369,12
"cfa457d1743848e4bb5e4beced6448ed","cfa457d1743848e4bb5e4beced6448ed",22850084,1,0,1,1159,369,369,0
"cfa457d1743848e4bb5e4beced6448ed","b71bac264efb4abd97015447bd490db6",22850084,1,3,0,1160,369,370,1
"b71bac264efb4abd97015447bd490db6","30ead9794d4847abaf222ca966cc8630",22850084,3,-28,0,1161,370,348,-22
"30ead9794d4847abaf222ca966cc8630","b71bac264efb4abd97015447bd490db6",22850084,2,28,0,1162,348,370,22
"b71bac264efb4abd97015447bd490db6","b613861cecf84ffcab01afb23f660475",22850084,1,-508,0,1163,370,1,-369
"b613861cecf84ffcab01afb23f660475","e2911e79efc2420eac45d9f671463d4b",22850084,2,3,0,1164,1,2,1
"e2911e79efc2420eac45d9f671463d4b","b613861cecf84ffcab01afb23f660475",22850084,1,-3,0,1165,2,1,-1
"b613861cecf84ffcab01afb23f660475","56586aa865414f538729c7f7735d2bc6",22850084,1,15,0,1166,1,12,11
"56586aa865414f538729c7f7735d2bc6","e2911e79efc2420eac45d9f671463d4b",22850084,2,-12,0,1167,12,2,-10
"e2911e79efc2420eac45d9f671463d4b","56586aa865414f538729c7f7735d2bc6",22850084,2,12,0,1168,2,12,10
"56586aa865414f538729c7f7735d2bc6","56586aa865414f538729c7f7735d2bc6",22850084,2,0,1,1169,12,12,0
"56586aa865414f538729c7f7735d2bc6","b7f2b31585d94eb3bf86376714aa7070",22850084,3,2,0,1170,12,13,1
"b7f2b31585d94eb3bf86376714aa7070","b7f2b31585d94eb3bf86376714aa7070",22850084,2,0,1,1171,13,13,0
"b7f2b31585d94eb3bf86376714aa7070","3f1c815879794b929260d224becaff7e",22850084,2,2,0,1172,13,14,1
"3f1c815879794b929260d224becaff7e","b71bac264efb4abd97015447bd490db6",22850084,1,489,0,1173,14,370,356
"b71bac264efb4abd97015447bd490db6","b71bac264efb4abd97015447bd490db6",22850084,1,0,1,1174,370,370,0
"b71bac264efb4abd97015447bd490db6","c76574d21bc14aeea7ecd0b027f39858",22850084,1,-5,0,1177,370,367,-3
"c76574d21bc14aeea7ecd0b027f39858","492a3bc6a1254f23a7998587961b22a4",22850084,2,-2,0,1178,367,366,-1
"072a190fd302456290895f9f04d6940a","52580888dadb4fe3baa795683ea227bd",22850084,2,-2,0,1180,365,364,-1
"52580888dadb4fe3baa795683ea227bd","2fe14166dc9642c3bc666b86a57f943d",22850084,1,-8,0,1181,364,357,-7
"2fe14166dc9642c3bc666b86a57f943d","f00179e251a045b39c3f7a54f9aa4acc",22850084,1,7,0,1182,357,363,6
"f00179e251a045b39c3f7a54f9aa4acc","b71bac264efb4abd97015447bd490db6",22850084,1,11,0,1183,363,370,7
"52580888dadb4fe3baa795683ea227bd","f00179e251a045b39c3f7a54f9aa4acc",22850084,2,-1,0,1189,364,363,-1
"f00179e251a045b39c3f7a54f9aa4acc","2fe14166dc9642c3bc666b86a57f943d",22850084,2,-7,0,1190,363,357,-6
"2fe14166dc9642c3bc666b86a57f943d","2fe14166dc9642c3bc666b86a57f943d",22850084,6,0,1,1191,357,357,0
"c76574d21bc14aeea7ecd0b027f39858","52580888dadb4fe3baa795683ea227bd",22850084,1,-5,0,1194,367,364,-3
"2fe14166dc9642c3bc666b86a57f943d","8d448d625b024c82a5eb240bbd7431d6",22850084,1,23,0,1202,357,374,17
"8d448d625b024c82a5eb240bbd7431d6","8d448d625b024c82a5eb240bbd7431d6",22850084,74,0,1,1203,374,374,0
"8d448d625b024c82a5eb240bbd7431d6","b71bac264efb4abd97015447bd490db6",22850084,3,-5,0,1210,374,370,-4
"b71bac264efb4abd97015447bd490db6","8d448d625b024c82a5eb240bbd7431d6",22850084,4,5,0,1211,370,374,4
"8d448d625b024c82a5eb240bbd7431d6","d6d02b6ef04e4f17805504500b8ce441",22850084,1,3,0,1265,374,375,1
"d6d02b6ef04e4f17805504500b8ce441","b71bac264efb4abd97015447bd490db6",22850084,2,-8,0,1266,375,370,-5
"b71bac264efb4abd97015447bd490db6","d6d02b6ef04e4f17805504500b8ce441",22850084,2,8,0,1267,370,375,5
"d6d02b6ef04e4f17805504500b8ce441","d6d02b6ef04e4f17805504500b8ce441",22850084,5,0,1,1268,375,375,0
"d6d02b6ef04e4f17805504500b8ce441","66baf19b6b904b70922329068c63746d",22850084,2,4,0,1269,375,376,1
"66baf19b6b904b70922329068c63746d","7f544639412e40a9ba27f43b415362ab",22850084,4,2,0,1270,376,378,2
"7f544639412e40a9ba27f43b415362ab","66baf19b6b904b70922329068c63746d",22850084,3,-2,0,1271,378,376,-2
"66baf19b6b904b70922329068c63746d","d6d02b6ef04e4f17805504500b8ce441",22850084,1,-4,0,1274,376,375,-1
"7f544639412e40a9ba27f43b415362ab","30ead9794d4847abaf222ca966cc8630",22850084,1,-42,0,1294,378,348,-30
"30ead9794d4847abaf222ca966cc8630","7f544639412e40a9ba27f43b415362ab",22850084,1,42,0,1295,348,378,30
"7f544639412e40a9ba27f43b415362ab","b71bac264efb4abd97015447bd490db6",22850084,1,-14,0,1296,378,370,-8
"8d448d625b024c82a5eb240bbd7431d6","7f544639412e40a9ba27f43b415362ab",22850084,1,9,0,1307,374,378,4
"7f544639412e40a9ba27f43b415362ab","d5ae8642e15b46b8bd298b02274d4e9c",22850084,1,2,0,1308,378,380,2
"d5ae8642e15b46b8bd298b02274d4e9c","d5ae8642e15b46b8bd298b02274d4e9c",22850084,1,0,1,1309,380,380,0
"d5ae8642e15b46b8bd298b02274d4e9c","a0d10309a2dd456289147f84be9d37f9",22850084,1,1,0,1310,380,381,1
"a0d10309a2dd456289147f84be9d37f9","a0d10309a2dd456289147f84be9d37f9",22850084,2,0,1,1311,381,381,0
"a0d10309a2dd456289147f84be9d37f9","0fcbc3ca07b144138b8d85da581f09a8",22850084,1,1,0,1313,381,382,1
"0fcbc3ca07b144138b8d85da581f09a8","0fcbc3ca07b144138b8d85da581f09a8",22850084,2,0,1,1314,382,382,0
"0fcbc3ca07b144138b8d85da581f09a8","66baf19b6b904b70922329068c63746d",22850084,1,-6,0,1316,382,376,-6
"66baf19b6b904b70922329068c63746d","4890121ce5d74576b4632b77cfc23398",22850084,1,14,0,1317,376,388,12
"4890121ce5d74576b4632b77cfc23398","c2fca3669923477ab966ded303dea31c",22850084,1,-6,0,1318,388,383,-5
"c2fca3669923477ab966ded303dea31c","4890121ce5d74576b4632b77cfc23398",22850084,1,6,0,1319,383,388,5
"4890121ce5d74576b4632b77cfc23398","18d3b836dd804224883cc9180b60a8e1",22850084,1,-1,0,1320,388,387,-1
"18d3b836dd804224883cc9180b60a8e1","96bb2b3e85a34d8b9544514e89f6fe97",22850084,1,4,0,1321,387,390,3
"96bb2b3e85a34d8b9544514e89f6fe97","96bb2b3e85a34d8b9544514e89f6fe97",22850084,1,0,1,1322,390,390,0
"96bb2b3e85a34d8b9544514e89f6fe97","ac4e9b54acfe4670b4634859c7263cb5",22850084,1,2,0,1323,390,392,2
"ac4e9b54acfe4670b4634859c7263cb5","ac4e9b54acfe4670b4634859c7263cb5",22850084,1,0,1,1324,392,392,0
"ac4e9b54acfe4670b4634859c7263cb5","17f95d18bab743888e1736033dc3384d",22850084,1,-3,0,1325,392,389,-3
"17f95d18bab743888e1736033dc3384d","6f8881a745ac4c358a68b92c3b4abe81",22850084,1,6,0,1326,389,394,5
"6f8881a745ac4c358a68b92c3b4abe81","6f8881a745ac4c358a68b92c3b4abe81",22850084,1,0,1,1327,394,394,0
"6f8881a745ac4c358a68b92c3b4abe81","f7002c8484354eceac57bc7bd62c76c1",22850084,1,-1,0,1328,394,393,-1
"f7002c8484354eceac57bc7bd62c76c1","44a277ea44dc4ae689fab4b82f0b4098",22850084,1,5,0,1329,393,397,4
"44a277ea44dc4ae689fab4b82f0b4098","44a277ea44dc4ae689fab4b82f0b4098",22850084,1,0,1,1330,397,397,0
"44a277ea44dc4ae689fab4b82f0b4098","0c12af0a4e7f4002852cf84b2537c161",22850084,1,-2,0,1331,397,395,-2
"0c12af0a4e7f4002852cf84b2537c161","859e0b8d71694b12befb69ee698138f9",22850084,1,5,0,1332,395,399,4
"859e0b8d71694b12befb69ee698138f9","859e0b8d71694b12befb69ee698138f9",22850084,1,0,1,1333,399,399,0
"859e0b8d71694b12befb69ee698138f9","66baf19b6b904b70922329068c63746d",22850084,1,-29,0,1334,399,376,-23
"66baf19b6b904b70922329068c63746d","2b09a08242b54983aec7063990fb3f66",22850084,1,32,0,1335,376,400,24
"2b09a08242b54983aec7063990fb3f66","2b09a08242b54983aec7063990fb3f66",22850084,5,0,1,1336,400,400,0
"2b09a08242b54983aec7063990fb3f66","1f471b7a883a4df48211e8c6a81b59a7",22850084,1,1,0,1339,400,401,1
"1f471b7a883a4df48211e8c6a81b59a7","1f471b7a883a4df48211e8c6a81b59a7",22850084,1,0,1,1340,401,401,0
"1f471b7a883a4df48211e8c6a81b59a7","2b09a08242b54983aec7063990fb3f66",22850084,1,-1,0,1341,401,400,-1
"2b09a08242b54983aec7063990fb3f66","1157bd665ec4472fb58b751dc5099355",22850084,1,4,0,1342,400,403,3
"1157bd665ec4472fb58b751dc5099355","58fc9094275e4c49be3f4ba6d4acc0a4",22850084,1,5,0,1343,403,406,3
"58fc9094275e4c49be3f4ba6d4acc0a4","3c8a22d2f9c146ea956609e3ed4f2559",22850084,1,-2,0,1344,406,405,-1
"3c8a22d2f9c146ea956609e3ed4f2559","58fc9094275e4c49be3f4ba6d4acc0a4",22850084,1,2,0,1345,405,406,1
"58fc9094275e4c49be3f4ba6d4acc0a4","c1c1be90b2b14c1ab4a5e1ee3c241902",22850084,1,1,0,1346,406,407,1
"c1c1be90b2b14c1ab4a5e1ee3c241902","c1c1be90b2b14c1ab4a5e1ee3c241902",22850084,5,0,1,1347,407,407,0
"c1c1be90b2b14c1ab4a5e1ee3c241902","02b3a1bead9244c1ba2f857c7da8f82a",22850084,1,2,0,1352,407,408,1
"02b3a1bead9244c1ba2f857c7da8f82a","58fc9094275e4c49be3f4ba6d4acc0a4",22850084,1,-3,0,1353,408,406,-2
"58fc9094275e4c49be3f4ba6d4acc0a4","02b3a1bead9244c1ba2f857c7da8f82a",22850084,1,3,0,1354,406,408,2
"02b3a1bead9244c1ba2f857c7da8f82a","6206fc6479014bb193084c32409dc1b9",22850084,1,1,0,1355,408,409,1
"6206fc6479014bb193084c32409dc1b9","6206fc6479014bb193084c32409dc1b9",22850084,1,0,1,1356,409,409,0
"6206fc6479014bb193084c32409dc1b9","02b3a1bead9244c1ba2f857c7da8f82a",22850084,1,-1,0,1357,409,408,-1
"02b3a1bead9244c1ba2f857c7da8f82a","6a5f020451db426dacba9e2ea3fcc62a",22850084,1,3,0,1358,408,410,2
"6a5f020451db426dacba9e2ea3fcc62a","6a5f020451db426dacba9e2ea3fcc62a",22850084,2,0,1,1359,410,410,0
"6a5f020451db426dacba9e2ea3fcc62a","33a9d248b2e44588a5b07fc1342b9bc2",22850084,1,2,0,1361,410,411,1
"33a9d248b2e44588a5b07fc1342b9bc2","33a9d248b2e44588a5b07fc1342b9bc2",22850084,1,0,1,1362,411,411,0
"33a9d248b2e44588a5b07fc1342b9bc2","c6f26bd420634f1cb7989e76fe6b16c0",22850084,1,1,0,1363,411,412,1
"c6f26bd420634f1cb7989e76fe6b16c0","c6f26bd420634f1cb7989e76fe6b16c0",22850084,5,0,1,1364,412,412,0
"c6f26bd420634f1cb7989e76fe6b16c0","2a65ee6e2ac64f6a8a55fbe5373ec763",22850084,1,1,0,1369,412,413,1
"2a65ee6e2ac64f6a8a55fbe5373ec763","2a65ee6e2ac64f6a8a55fbe5373ec763",22850084,2,0,1,1370,413,413,0
"2a65ee6e2ac64f6a8a55fbe5373ec763","33a9d248b2e44588a5b07fc1342b9bc2",22850084,1,-2,0,1372,413,411,-2
"33a9d248b2e44588a5b07fc1342b9bc2","1fd0f6dadbc14ebc965faf6122190b96",22850084,1,5,0,1373,411,415,4
"1fd0f6dadbc14ebc965faf6122190b96","1fd0f6dadbc14ebc965faf6122190b96",22850084,1,0,1,1374,415,415,0
"1fd0f6dadbc14ebc965faf6122190b96","687055dad9fc40c3982478fe33ec01bf",22850084,1,-1,0,1375,415,414,-1
"687055dad9fc40c3982478fe33ec01bf","2b09a08242b54983aec7063990fb3f66",22850084,1,-21,0,1376,414,400,-14
"2b09a08242b54983aec7063990fb3f66","58fc9094275e4c49be3f4ba6d4acc0a4",22850084,1,9,0,1379,400,406,6
"58fc9094275e4c49be3f4ba6d4acc0a4","58fc9094275e4c49be3f4ba6d4acc0a4",22850084,1,0,1,1380,406,406,0
"58fc9094275e4c49be3f4ba6d4acc0a4","6a5f020451db426dacba9e2ea3fcc62a",22850084,2,6,0,1381,406,410,4
"6a5f020451db426dacba9e2ea3fcc62a","58fc9094275e4c49be3f4ba6d4acc0a4",22850084,1,-6,0,1382,410,406,-4
"6a5f020451db426dacba9e2ea3fcc62a","2add1669f08d4101913db15f8c23b3b7",22850084,1,9,0,1384,410,416,6
"2add1669f08d4101913db15f8c23b3b7","2add1669f08d4101913db15f8c23b3b7",22850084,1,0,1,1385,416,416,0
"2add1669f08d4101913db15f8c23b3b7","2b09a08242b54983aec7063990fb3f66",22850084,1,-24,0,1386,416,400,-16
"2b09a08242b54983aec7063990fb3f66","a2b4bd40cee2481ebd3fc179d6a5cd62",22850084,1,27,0,1387,400,417,17
"a2b4bd40cee2481ebd3fc179d6a5cd62","a2b4bd40cee2481ebd3fc179d6a5cd62",22850084,2,0,1,1388,417,417,0
"a2b4bd40cee2481ebd3fc179d6a5cd62","e34e59dce2204f228f3a84b6725df60f",22850084,1,2,0,1389,417,419,2
"e34e59dce2204f228f3a84b6725df60f","e34e59dce2204f228f3a84b6725df60f",22850084,2,0,1,1390,419,419,0
"e34e59dce2204f228f3a84b6725df60f","a2b4bd40cee2481ebd3fc179d6a5cd62",22850084,2,-2,0,1391,419,417,-2
"a2b4bd40cee2481ebd3fc179d6a5cd62","bec48fc2e1294c7eb3d0aca780d731b8",22850084,2,4,0,1392,417,420,3
"bec48fc2e1294c7eb3d0aca780d731b8","66baf19b6b904b70922329068c63746d",22850084,1,-63,0,1393,420,376,-44
"66baf19b6b904b70922329068c63746d","e34e59dce2204f228f3a84b6725df60f",22850084,1,61,0,1394,376,419,43
"bec48fc2e1294c7eb3d0aca780d731b8","bec48fc2e1294c7eb3d0aca780d731b8",22850084,2,0,1,1399,420,420,0
"bec48fc2e1294c7eb3d0aca780d731b8","dbde19fcce2a4c1abdc7f685c293a23f",22850084,1,3,0,1401,420,422,2
"dbde19fcce2a4c1abdc7f685c293a23f","a24600b0e49245f6bdba8c893cfeddb0",22850084,1,4,0,1402,422,425,3
"a24600b0e49245f6bdba8c893cfeddb0","a24600b0e49245f6bdba8c893cfeddb0",22850084,2,0,1,1403,425,425,0
"a24600b0e49245f6bdba8c893cfeddb0","24cf8786024543f19b89bc20034e60d7",22850084,1,7,0,1405,425,428,3
"24cf8786024543f19b89bc20034e60d7","a2b4bd40cee2481ebd3fc179d6a5cd62",22850084,1,-18,0,1406,428,417,-11
"a2b4bd40cee2481ebd3fc179d6a5cd62","f2a73be2f46840b182d7bd095378004e",22850084,1,19,0,1407,417,429,12
"f2a73be2f46840b182d7bd095378004e","f2a73be2f46840b182d7bd095378004e",22850084,2,0,1,1408,429,429,0
"f2a73be2f46840b182d7bd095378004e","604551fd4266430cb860fef58fa7dd61",22850084,1,1,0,1410,429,430,1
"604551fd4266430cb860fef58fa7dd61","604551fd4266430cb860fef58fa7dd61",22850084,1,0,1,1411,430,430,0
"604551fd4266430cb860fef58fa7dd61","dce46f8904594a62a6377a3587aaa663",22850084,1,2,0,1412,430,431,1
"dce46f8904594a62a6377a3587aaa663","24cf8786024543f19b89bc20034e60d7",22850084,1,-4,0,1413,431,428,-3
"24cf8786024543f19b89bc20034e60d7","dce46f8904594a62a6377a3587aaa663",22850084,1,4,0,1414,428,431,3
"dce46f8904594a62a6377a3587aaa663","9b9d0a249052413c869753b99682b0ac",22850084,1,1,0,1415,431,432,1
"9b9d0a249052413c869753b99682b0ac","9b9d0a249052413c869753b99682b0ac",22850084,5,0,1,1416,432,432,0
"9b9d0a249052413c869753b99682b0ac","061c175cc90f45fbad883025394e78dd",22850084,1,1,0,1421,432,433,1
"061c175cc90f45fbad883025394e78dd","061c175cc90f45fbad883025394e78dd",22850084,1,0,1,1422,433,433,0
"061c175cc90f45fbad883025394e78dd","dce46f8904594a62a6377a3587aaa663",22850084,1,-2,0,1423,433,431,-2
"dce46f8904594a62a6377a3587aaa663","74a7f8712e5449c2bc0b43c6f90dafed",22850084,1,5,0,1424,431,435,4
"74a7f8712e5449c2bc0b43c6f90dafed","74a7f8712e5449c2bc0b43c6f90dafed",22850084,1,0,1,1425,435,435,0
"74a7f8712e5449c2bc0b43c6f90dafed","66ada10dde9f43018588f1ced9d477fc",22850084,1,-1,0,1426,435,434,-1
"66ada10dde9f43018588f1ced9d477fc","bf12c96466d840a69bed7020b3f18bb8",22850084,1,3,0,1427,434,436,2
"bf12c96466d840a69bed7020b3f18bb8","bf12c96466d840a69bed7020b3f18bb8",22850084,1,0,1,1428,436,436,0
"bf12c96466d840a69bed7020b3f18bb8","070600601c4c439288445d2f0724807d",22850084,1,3,0,1429,436,437,1
"070600601c4c439288445d2f0724807d","24cf8786024543f19b89bc20034e60d7",22850084,1,-14,0,1430,437,428,-9
"24cf8786024543f19b89bc20034e60d7","1823b6de7d334a7aaabc4570719af4d9",22850084,1,16,0,1431,428,439,11
"1823b6de7d334a7aaabc4570719af4d9","1823b6de7d334a7aaabc4570719af4d9",22850084,10,0,1,1432,439,439,0
"1823b6de7d334a7aaabc4570719af4d9","070600601c4c439288445d2f0724807d",22850084,1,-2,0,1442,439,437,-2
"070600601c4c439288445d2f0724807d","0380cd76a7d44bc3a4da1f15e4d68f89",22850084,2,4,0,1443,437,440,3
"0380cd76a7d44bc3a4da1f15e4d68f89","66baf19b6b904b70922329068c63746d",22850084,1,-95,0,1444,440,376,-64
"66baf19b6b904b70922329068c63746d","070600601c4c439288445d2f0724807d",22850084,1,91,0,1445,376,437,61
"0380cd76a7d44bc3a4da1f15e4d68f89","0380cd76a7d44bc3a4da1f15e4d68f89",22850084,1,0,1,1447,440,440,0
"0380cd76a7d44bc3a4da1f15e4d68f89","23b7673c8b5443108c2ef09382834a86",22850084,2,2,0,1448,440,441,1
"23b7673c8b5443108c2ef09382834a86","0380cd76a7d44bc3a4da1f15e4d68f89",22850084,1,-2,0,1449,441,440,-1
"23b7673c8b5443108c2ef09382834a86","901e92500aea43c79f19f1b279050668",22850084,2,2,0,1451,441,442,1
"901e92500aea43c79f19f1b279050668","23b7673c8b5443108c2ef09382834a86",22850084,1,-2,0,1452,442,441,-1
"901e92500aea43c79f19f1b279050668","001339db8ced4cf78829ebe8b145449d",22850084,1,1,0,1454,442,443,1
"001339db8ced4cf78829ebe8b145449d","001339db8ced4cf78829ebe8b145449d",22850084,8,0,1,1455,443,443,0
"001339db8ced4cf78829ebe8b145449d","452745e0366e42ae81561bfddebcc6c3",22850084,1,1,0,1463,443,444,1
"452745e0366e42ae81561bfddebcc6c3","452745e0366e42ae81561bfddebcc6c3",22850084,2,0,1,1464,444,444,0
"452745e0366e42ae81561bfddebcc6c3","901e92500aea43c79f19f1b279050668",22850084,1,-2,0,1466,444,442,-2
"901e92500aea43c79f19f1b279050668","4660ff2089114e8db82ceb26a4f329e3",22850084,1,4,0,1467,442,445,3
"4660ff2089114e8db82ceb26a4f329e3","4660ff2089114e8db82ceb26a4f329e3",22850084,2,0,1,1468,445,445,0
"4660ff2089114e8db82ceb26a4f329e3","7bd5586eb9d8484eb74a433ee7bfe499",22850084,2,2,0,1470,445,446,1
"7bd5586eb9d8484eb74a433ee7bfe499","4660ff2089114e8db82ceb26a4f329e3",22850084,1,-2,0,1471,446,445,-1
"7bd5586eb9d8484eb74a433ee7bfe499","7bd5586eb9d8484eb74a433ee7bfe499",22850084,8,0,1,1473,446,446,0
"7bd5586eb9d8484eb74a433ee7bfe499","8a7f26e690f34dda97be16904518ca99",22850084,1,2,0,1481,446,447,1
"8a7f26e690f34dda97be16904518ca99","8a7f26e690f34dda97be16904518ca99",22850084,1,0,1,1482,447,447,0
"8a7f26e690f34dda97be16904518ca99","070600601c4c439288445d2f0724807d",22850084,1,-16,0,1483,447,437,-10
"070600601c4c439288445d2f0724807d","b2f0d654738f48158edff28e8d3a546e",22850084,1,21,0,1484,437,449,12
"b2f0d654738f48158edff28e8d3a546e","f60ee41ec635499abd48168342d32c2f",22850084,3,5,0,1485,449,453,4
"f60ee41ec635499abd48168342d32c2f","f60ee41ec635499abd48168342d32c2f",22850084,58,0,1,1486,453,453,0
"f60ee41ec635499abd48168342d32c2f","b2f0d654738f48158edff28e8d3a546e",22850084,2,-5,0,1488,453,449,-4
"f60ee41ec635499abd48168342d32c2f","f67fbf45a5f146ed866965bc57c7c001",22850084,1,3,0,1537,453,454,1
"f67fbf45a5f146ed866965bc57c7c001","b2f0d654738f48158edff28e8d3a546e",22850084,1,-8,0,1538,454,449,-5
"b2f0d654738f48158edff28e8d3a546e","f67fbf45a5f146ed866965bc57c7c001",22850084,2,8,0,1539,449,454,5
"f67fbf45a5f146ed866965bc57c7c001","f67fbf45a5f146ed866965bc57c7c001",22850084,1,0,1,1540,454,454,0
"f67fbf45a5f146ed866965bc57c7c001","d937afe49bd24a07a550dda1c1155122",22850084,1,1,0,1541,454,455,1
"d937afe49bd24a07a550dda1c1155122","d937afe49bd24a07a550dda1c1155122",22850084,1,0,1,1542,455,455,0
"d937afe49bd24a07a550dda1c1155122","3628b3f7823443d0912a339096b69943",22850084,1,1,0,1543,455,456,1
"3628b3f7823443d0912a339096b69943","3628b3f7823443d0912a339096b69943",22850084,1,0,1,1544,456,456,0
"3628b3f7823443d0912a339096b69943","9e049ee647cf43ecbcb5ed792a8e7588",22850084,1,1,0,1545,456,457,1
"9e049ee647cf43ecbcb5ed792a8e7588","9e049ee647cf43ecbcb5ed792a8e7588",22850084,1,0,1,1546,457,457,0
"9e049ee647cf43ecbcb5ed792a8e7588","5256a214faaf410b93f76cea06428334",22850084,1,1,0,1547,457,458,1
"5256a214faaf410b93f76cea06428334","5256a214faaf410b93f76cea06428334",22850084,1,0,1,1548,458,458,0
"5256a214faaf410b93f76cea06428334","25c32b120fce40fa9b6c85133aeb4716",22850084,1,1,0,1549,458,459,1
"25c32b120fce40fa9b6c85133aeb4716","25c32b120fce40fa9b6c85133aeb4716",22850084,1,0,1,1550,459,459,0
"25c32b120fce40fa9b6c85133aeb4716","11bc14f2204949008b7d511b933363c1",22850084,1,1,0,1551,459,460,1
"11bc14f2204949008b7d511b933363c1","11bc14f2204949008b7d511b933363c1",22850084,1,0,1,1552,460,460,0
"11bc14f2204949008b7d511b933363c1","42de338840a34d15adb66e7b14fb9d2c",22850084,1,1,0,1553,460,461,1
"42de338840a34d15adb66e7b14fb9d2c","42de338840a34d15adb66e7b14fb9d2c",22850084,3,0,1,1554,461,461,0
"42de338840a34d15adb66e7b14fb9d2c","9da37c6210b1416b8079c274f70bf600",22850084,1,1,0,1557,461,462,1
"9da37c6210b1416b8079c274f70bf600","9da37c6210b1416b8079c274f70bf600",22850084,1,0,1,1558,462,462,0
"9da37c6210b1416b8079c274f70bf600","519119f1deac45ff9ab4f13529be5c6e",22850084,1,1,0,1559,462,463,1
"519119f1deac45ff9ab4f13529be5c6e","519119f1deac45ff9ab4f13529be5c6e",22850084,1,0,1,1560,463,463,0
"519119f1deac45ff9ab4f13529be5c6e","f67fbf45a5f146ed866965bc57c7c001",22850084,1,-9,0,1561,463,454,-9
"f67fbf45a5f146ed866965bc57c7c001","c5df9f40ec14463b9dcfdc73df3e9285",22850084,1,12,0,1562,454,464,10
"c5df9f40ec14463b9dcfdc73df3e9285","c5df9f40ec14463b9dcfdc73df3e9285",22850084,1,0,1,1563,464,464,0
"c5df9f40ec14463b9dcfdc73df3e9285","83d42d95cd844fc093fc09cee250edb8",22850084,2,3,0,1564,464,465,1
"83d42d95cd844fc093fc09cee250edb8","c5df9f40ec14463b9dcfdc73df3e9285",22850084,1,-3,0,1565,465,464,-1
"83d42d95cd844fc093fc09cee250edb8","83d42d95cd844fc093fc09cee250edb8",22850084,2,0,1,1567,465,465,0
"83d42d95cd844fc093fc09cee250edb8","b2f0d654738f48158edff28e8d3a546e",22850084,1,-23,0,1569,465,449,-16
"f67fbf45a5f146ed866965bc57c7c001","66baf19b6b904b70922329068c63746d",22850084,1,-120,0,1582,454,376,-78
"66baf19b6b904b70922329068c63746d","66baf19b6b904b70922329068c63746d",22850084,1,0,1,1583,376,376,0
"b613861cecf84ffcab01afb23f660475","b613861cecf84ffcab01afb23f660475",22850542,2,0,1,1,1,1,0
"b613861cecf84ffcab01afb23f660475","e2911e79efc2420eac45d9f671463d4b",22850542,2,3,0,3,1,2,1
"e2911e79efc2420eac45d9f671463d4b","b613861cecf84ffcab01afb23f660475",22850542,1,-3,0,4,2,1,-1
"e2911e79efc2420eac45d9f671463d4b","519d1b8c59404d67b54e96c5c8a830b2",22850542,1,1,0,8,2,3,1
"519d1b8c59404d67b54e96c5c8a830b2","519d1b8c59404d67b54e96c5c8a830b2",22850542,1,0,1,9,3,3,0
"519d1b8c59404d67b54e96c5c8a830b2","531db53f81f646edb0cdcfe0085b03b7",22850542,1,1,0,10,3,4,1
"531db53f81f646edb0cdcfe0085b03b7","531db53f81f646edb0cdcfe0085b03b7",22850542,1,0,1,11,4,4,0
"531db53f81f646edb0cdcfe0085b03b7","4f5f94b2f95141e0a9d53a61da2276da",22850542,1,1,0,12,4,5,1
"4f5f94b2f95141e0a9d53a61da2276da","4f5f94b2f95141e0a9d53a61da2276da",22850542,1,0,1,13,5,5,0
"4f5f94b2f95141e0a9d53a61da2276da","6d541c89590949f99af293c4f2333f67",22850542,1,1,0,14,5,6,1
"6d541c89590949f99af293c4f2333f67","6d541c89590949f99af293c4f2333f67",22850542,1,0,1,15,6,6,0
"6d541c89590949f99af293c4f2333f67","dd5cf0b9fe4c4f1d8f5ff8e4c04879cb",22850542,1,1,0,16,6,7,1
"dd5cf0b9fe4c4f1d8f5ff8e4c04879cb","dd5cf0b9fe4c4f1d8f5ff8e4c04879cb",22850542,4,0,1,17,7,7,0
"dd5cf0b9fe4c4f1d8f5ff8e4c04879cb","6d541c89590949f99af293c4f2333f67",22850542,1,-1,0,21,7,6,-1
"6d541c89590949f99af293c4f2333f67","4f5f94b2f95141e0a9d53a61da2276da",22850542,1,-1,0,22,6,5,-1
"4f5f94b2f95141e0a9d53a61da2276da","531db53f81f646edb0cdcfe0085b03b7",22850542,1,-1,0,23,5,4,-1
"531db53f81f646edb0cdcfe0085b03b7","f96261861edc426abe2248be4f0a709a",22850542,1,4,0,24,4,8,4
"f96261861edc426abe2248be4f0a709a","f96261861edc426abe2248be4f0a709a",22850542,2,0,1,25,8,8,0
"f96261861edc426abe2248be4f0a709a","66b5e16f4f75454fb5b8172079f0fa83",22850542,1,1,0,27,8,9,1
"66b5e16f4f75454fb5b8172079f0fa83","66b5e16f4f75454fb5b8172079f0fa83",22850542,2,0,1,28,9,9,0
"66b5e16f4f75454fb5b8172079f0fa83","0680571d4698477995e41842c36a54b2",22850542,1,1,0,30,9,10,1
"0680571d4698477995e41842c36a54b2","0680571d4698477995e41842c36a54b2",22850542,2,0,1,31,10,10,0
"0680571d4698477995e41842c36a54b2","e2911e79efc2420eac45d9f671463d4b",22850542,1,-8,0,33,10,2,-8
"56586aa865414f538729c7f7735d2bc6","e2911e79efc2420eac45d9f671463d4b",22850542,2,-12,0,35,12,2,-10
"e2911e79efc2420eac45d9f671463d4b","9112f2bffece48e08c6d2287be204085",22850542,1,9,0,37,2,11,9
"9112f2bffece48e08c6d2287be204085","9112f2bffece48e08c6d2287be204085",22850542,2,0,1,38,11,11,0
"9112f2bffece48e08c6d2287be204085","56586aa865414f538729c7f7735d2bc6",22850542,1,3,0,40,11,12,1
"56586aa865414f538729c7f7735d2bc6","b7f2b31585d94eb3bf86376714aa7070",22850542,1,2,0,45,12,13,1
"b7f2b31585d94eb3bf86376714aa7070","b7f2b31585d94eb3bf86376714aa7070",22850542,2,0,1,46,13,13,0
"b7f2b31585d94eb3bf86376714aa7070","3f1c815879794b929260d224becaff7e",22850542,1,2,0,48,13,14,1
"3f1c815879794b929260d224becaff7e","81c864a886d54a6b8ff85f7d736f4f95",22850542,1,2,0,49,14,15,1
"81c864a886d54a6b8ff85f7d736f4f95","5c5ceeee4562457ba6d41515aeebfbb1",22850542,1,4,0,50,15,17,2
"5c5ceeee4562457ba6d41515aeebfbb1","5c5ceeee4562457ba6d41515aeebfbb1",22850542,1,0,1,51,17,17,0
"5c5ceeee4562457ba6d41515aeebfbb1","56586aa865414f538729c7f7735d2bc6",22850542,1,-10,0,52,17,12,-5
"56586aa865414f538729c7f7735d2bc6","9afd71a5298d4333b6849dfce1b9422c",22850542,3,13,0,53,12,18,6
"9afd71a5298d4333b6849dfce1b9422c","56586aa865414f538729c7f7735d2bc6",22850542,2,-13,0,54,18,12,-6
"9afd71a5298d4333b6849dfce1b9422c","5c5ceeee4562457ba6d41515aeebfbb1",22850542,1,-3,0,56,18,17,-1
"5c5ceeee4562457ba6d41515aeebfbb1","9afd71a5298d4333b6849dfce1b9422c",22850542,1,3,0,57,17,18,1
"b7719e26494940efa49512aedd0aac79","9afd71a5298d4333b6849dfce1b9422c",22850542,1,-4,0,61,20,18,-2
"9afd71a5298d4333b6849dfce1b9422c","d4f45188d3c84a02ba08454e6403a818",22850542,1,9,0,62,18,24,6
"d4c3b003e8274e429d2fa688d73fde6d","d4c3b003e8274e429d2fa688d73fde6d",22850542,1,0,1,64,22,22,0
"4e51676dc72045d99c19b9fa7b22f8bc","afbf7250b99d47bea07172749483ca97",22850542,1,-3,0,69,29,28,-1
"51970cfa30e643e894e66ae85c8024cc","c33c17be71ae4d588da7369472e5bb1b",22850542,1,6,0,72,31,34,3
"c33c17be71ae4d588da7369472e5bb1b","4e51676dc72045d99c19b9fa7b22f8bc",22850542,1,-9,0,73,34,29,-5
"4e51676dc72045d99c19b9fa7b22f8bc","93679be414554a11b1893002f2229a93",22850542,1,12,0,74,29,35,6
"93679be414554a11b1893002f2229a93","c33c17be71ae4d588da7369472e5bb1b",22850542,1,-3,0,75,35,34,-1
"fc0e049d56024bc9a02c9a9c435c3df7","b613861cecf84ffcab01afb23f660475",22850542,1,-68,0,82,38,1,-37
"b613861cecf84ffcab01afb23f660475","9a0dc646f934470daf08c4b56ccf73db",22850542,1,65,0,83,1,37,36
"fc0e049d56024bc9a02c9a9c435c3df7","9a0dc646f934470daf08c4b56ccf73db",22850542,1,-3,0,88,38,37,-1
"9a0dc646f934470daf08c4b56ccf73db","b613861cecf84ffcab01afb23f660475",22850542,1,-65,0,89,37,1,-36
"b613861cecf84ffcab01afb23f660475","fc0e049d56024bc9a02c9a9c435c3df7",22850542,1,68,0,90,1,38,37
"67a089198fcb4e1c8f2385786c2b296f","fc0e049d56024bc9a02c9a9c435c3df7",22850542,1,-4,0,95,39,38,-1
"fc0e049d56024bc9a02c9a9c435c3df7","64d48c6c9c7940639a932219a6c87198",22850542,1,5,0,96,38,40,2
"64d48c6c9c7940639a932219a6c87198","a49d1bb4328949299686242fd0be5584",22850542,1,-39,0,97,40,21,-19
"afbf7250b99d47bea07172749483ca97","b7719e26494940efa49512aedd0aac79",22850542,1,-12,0,100,28,20,-8
"b7719e26494940efa49512aedd0aac79","b613861cecf84ffcab01afb23f660475",22850542,1,-32,0,101,20,1,-19
"b613861cecf84ffcab01afb23f660475","a49d1bb4328949299686242fd0be5584",22850542,1,34,0,102,1,21,20
"a49d1bb4328949299686242fd0be5584","b7719e26494940efa49512aedd0aac79",22850542,3,-2,0,103,21,20,-1
"b7719e26494940efa49512aedd0aac79","d4f45188d3c84a02ba08454e6403a818",22850542,1,5,0,104,20,24,4
"d4f45188d3c84a02ba08454e6403a818","a49d1bb4328949299686242fd0be5584",22850542,1,-3,0,105,24,21,-3
"a49d1bb4328949299686242fd0be5584","d4c3b003e8274e429d2fa688d73fde6d",22850542,1,1,0,106,21,22,1
"d4c3b003e8274e429d2fa688d73fde6d","b7719e26494940efa49512aedd0aac79",22850542,2,-3,0,107,22,20,-2
"b7719e26494940efa49512aedd0aac79","b7719e26494940efa49512aedd0aac79",22850542,3,0,1,108,20,20,0
"b7719e26494940efa49512aedd0aac79","67a089198fcb4e1c8f2385786c2b296f",22850542,1,40,0,109,20,39,19
"67a089198fcb4e1c8f2385786c2b296f","67a089198fcb4e1c8f2385786c2b296f",22850542,2,0,1,110,39,39,0
"67a089198fcb4e1c8f2385786c2b296f","64d48c6c9c7940639a932219a6c87198",22850542,2,1,0,112,39,40,1
"64d48c6c9c7940639a932219a6c87198","64d48c6c9c7940639a932219a6c87198",22850542,1,0,1,113,40,40,0
"64d48c6c9c7940639a932219a6c87198","67a089198fcb4e1c8f2385786c2b296f",22850542,1,-1,0,114,40,39,-1
"67a089198fcb4e1c8f2385786c2b296f","b534b89233134e30a9b5645138bfa9ee",22850542,1,4,0,115,39,41,2
"b534b89233134e30a9b5645138bfa9ee","0e37b720d23b4e7f8b313e79313fd107",22850542,1,3,0,116,41,44,3
"0e37b720d23b4e7f8b313e79313fd107","0e37b720d23b4e7f8b313e79313fd107",22850542,4,0,1,117,44,44,0
"0e37b720d23b4e7f8b313e79313fd107","6875d67fdd5f48168b62719df449bebd",22850542,1,1,0,121,44,45,1
"6875d67fdd5f48168b62719df449bebd","6875d67fdd5f48168b62719df449bebd",22850542,1,0,1,122,45,45,0
"6875d67fdd5f48168b62719df449bebd","b534b89233134e30a9b5645138bfa9ee",22850542,1,-4,0,123,45,41,-4
"b534b89233134e30a9b5645138bfa9ee","6e13d61a7bdb44bca949c9f86fab3be5",22850542,2,7,0,124,41,47,6
"6e13d61a7bdb44bca949c9f86fab3be5","6e13d61a7bdb44bca949c9f86fab3be5",22850542,4,0,1,125,47,47,0
"6e13d61a7bdb44bca949c9f86fab3be5","195f78799f984cc2b06c48dfe36be751",22850542,1,2,0,126,47,49,2
"195f78799f984cc2b06c48dfe36be751","195f78799f984cc2b06c48dfe36be751",22850542,2,0,1,127,49,49,0
"195f78799f984cc2b06c48dfe36be751","d9c8d8c444a64dadbbb508652c721e17",22850542,1,-3,0,129,49,46,-3
"d9c8d8c444a64dadbbb508652c721e17","d0c74f735e024943943e40333d6d337f",22850542,1,6,0,130,46,51,5
"d0c74f735e024943943e40333d6d337f","d0c74f735e024943943e40333d6d337f",22850542,1,0,1,131,51,51,0
"d0c74f735e024943943e40333d6d337f","983f8ff320594b279a7f4a6fe132f9c5",22850542,1,2,0,132,51,53,2
"983f8ff320594b279a7f4a6fe132f9c5","983f8ff320594b279a7f4a6fe132f9c5",22850542,2,0,1,133,53,53,0
"983f8ff320594b279a7f4a6fe132f9c5","35adfa5d923046aebabfefd98f35ff05",22850542,1,1,0,135,53,54,1
"35adfa5d923046aebabfefd98f35ff05","35adfa5d923046aebabfefd98f35ff05",22850542,5,0,1,136,54,54,0
"35adfa5d923046aebabfefd98f35ff05","b6f8a98476224da1b40e555ececc7ed8",22850542,1,1,0,141,54,55,1
"b6f8a98476224da1b40e555ececc7ed8","b6f8a98476224da1b40e555ececc7ed8",22850542,2,0,1,142,55,55,0
"b6f8a98476224da1b40e555ececc7ed8","86e22cb5fe0e4b47a9489ecddf7ed78f",22850542,1,1,0,144,55,56,1
"86e22cb5fe0e4b47a9489ecddf7ed78f","86e22cb5fe0e4b47a9489ecddf7ed78f",22850542,2,0,1,145,56,56,0
"86e22cb5fe0e4b47a9489ecddf7ed78f","f924752d8a1149668870b1e7698486f7",22850542,1,-6,0,147,56,50,-6
"f924752d8a1149668870b1e7698486f7","a1f2f12debe5432fb7a70bcd12bacfb9",22850542,1,9,0,148,50,58,8
"a1f2f12debe5432fb7a70bcd12bacfb9","78f30e4dcac84e3cbea8b2cc6e0d62b3",22850542,2,1,0,149,58,59,1
"78f30e4dcac84e3cbea8b2cc6e0d62b3","a1f2f12debe5432fb7a70bcd12bacfb9",22850542,1,-1,0,150,59,58,-1
"a1f2f12debe5432fb7a70bcd12bacfb9","a1f2f12debe5432fb7a70bcd12bacfb9",22850542,13,0,1,151,58,58,0
"78f30e4dcac84e3cbea8b2cc6e0d62b3","78f30e4dcac84e3cbea8b2cc6e0d62b3",22850542,18,0,1,165,59,59,0
"78f30e4dcac84e3cbea8b2cc6e0d62b3","bc42d26810654ea9a1df1efe1e58c7d5",22850542,1,5,0,183,59,63,4
"bc42d26810654ea9a1df1efe1e58c7d5","12aa6e1672ac4e7aa6449a7a8609cd72",22850542,1,-7,0,184,63,57,-6
"12aa6e1672ac4e7aa6449a7a8609cd72","a0a418b8540d479fa6e0f653b701da8b",22850542,1,8,0,185,57,64,7
"a0a418b8540d479fa6e0f653b701da8b","4c943503763e4e349906eea3ed3c8e86",22850542,2,-3,0,186,64,61,-3
"4c943503763e4e349906eea3ed3c8e86","4c943503763e4e349906eea3ed3c8e86",22850542,3,0,1,187,61,61,0
"4c943503763e4e349906eea3ed3c8e86","309ccf3cc4fe429d9bfbaef53d3fa479",22850542,1,-1,0,189,61,60,-1
"309ccf3cc4fe429d9bfbaef53d3fa479","bc42d26810654ea9a1df1efe1e58c7d5",22850542,1,3,0,190,60,63,3
"bc42d26810654ea9a1df1efe1e58c7d5","7af822066add4e7f8e007e4eee31a8bf",22850542,1,3,0,191,63,65,2
"7af822066add4e7f8e007e4eee31a8bf","a0a418b8540d479fa6e0f653b701da8b",22850542,1,-2,0,192,65,64,-1
"4c943503763e4e349906eea3ed3c8e86","a0a418b8540d479fa6e0f653b701da8b",22850542,1,3,0,195,61,64,3
"a0a418b8540d479fa6e0f653b701da8b","a0a418b8540d479fa6e0f653b701da8b",22850542,3,0,1,196,64,64,0
"a0a418b8540d479fa6e0f653b701da8b","bc42d26810654ea9a1df1efe1e58c7d5",22850542,1,-1,0,199,64,63,-1
"bc42d26810654ea9a1df1efe1e58c7d5","bc42d26810654ea9a1df1efe1e58c7d5",22850542,3,0,1,200,63,63,0
"bc42d26810654ea9a1df1efe1e58c7d5","309ccf3cc4fe429d9bfbaef53d3fa479",22850542,1,-3,0,203,63,60,-3
"309ccf3cc4fe429d9bfbaef53d3fa479","d646286c8051419bbc2e31dd1db55ca8",22850542,1,10,0,204,60,67,7
"d646286c8051419bbc2e31dd1db55ca8","b534b89233134e30a9b5645138bfa9ee",22850542,1,-33,0,205,67,41,-26
"b534b89233134e30a9b5645138bfa9ee","267f883678b24aed855fde42524975d9",22850542,1,37,0,206,41,71,30
"267f883678b24aed855fde42524975d9","267f883678b24aed855fde42524975d9",22850542,2,0,1,207,71,71,0
"267f883678b24aed855fde42524975d9","9afd71a5298d4333b6849dfce1b9422c",22850542,1,-85,0,209,71,18,-53
"9afd71a5298d4333b6849dfce1b9422c","9afd71a5298d4333b6849dfce1b9422c",22850542,2,0,1,210,18,18,0
"9afd71a5298d4333b6849dfce1b9422c","b7719e26494940efa49512aedd0aac79",22850542,2,4,0,212,18,20,2
"b7719e26494940efa49512aedd0aac79","d4c3b003e8274e429d2fa688d73fde6d",22850542,1,3,0,213,20,22,2
"d4c3b003e8274e429d2fa688d73fde6d","d4f45188d3c84a02ba08454e6403a818",22850542,1,2,0,214,22,24,2
"d4f45188d3c84a02ba08454e6403a818","b7719e26494940efa49512aedd0aac79",22850542,1,-5,0,215,24,20,-4
"b7719e26494940efa49512aedd0aac79","afbf7250b99d47bea07172749483ca97",22850542,3,12,0,217,20,28,8
"afbf7250b99d47bea07172749483ca97","afbf7250b99d47bea07172749483ca97",22850542,1,0,1,218,28,28,0
"afbf7250b99d47bea07172749483ca97","4e51676dc72045d99c19b9fa7b22f8bc",22850542,3,3,0,219,28,29,1
"4e51676dc72045d99c19b9fa7b22f8bc","4e51676dc72045d99c19b9fa7b22f8bc",22850542,1,0,1,220,29,29,0
"4e51676dc72045d99c19b9fa7b22f8bc","51970cfa30e643e894e66ae85c8024cc",22850542,2,3,0,221,29,31,2
"51970cfa30e643e894e66ae85c8024cc","4e51676dc72045d99c19b9fa7b22f8bc",22850542,1,-3,0,222,31,29,-2
"4e51676dc72045d99c19b9fa7b22f8bc","c33c17be71ae4d588da7369472e5bb1b",22850542,1,9,0,223,29,34,5
"c33c17be71ae4d588da7369472e5bb1b","c33c17be71ae4d588da7369472e5bb1b",22850542,1,0,1,224,34,34,0
"c33c17be71ae4d588da7369472e5bb1b","93679be414554a11b1893002f2229a93",22850542,2,3,0,225,34,35,1
"93679be414554a11b1893002f2229a93","93679be414554a11b1893002f2229a93",22850542,1,0,1,226,35,35,0
"93679be414554a11b1893002f2229a93","7040a13096d746ac84b8fac8d9752058",22850542,2,3,0,227,35,36,1
"7040a13096d746ac84b8fac8d9752058","7040a13096d746ac84b8fac8d9752058",22850542,2,0,1,228,36,36,0
"7040a13096d746ac84b8fac8d9752058","9a0dc646f934470daf08c4b56ccf73db",22850542,2,3,0,229,36,37,1
"9a0dc646f934470daf08c4b56ccf73db","9a0dc646f934470daf08c4b56ccf73db",22850542,4,0,1,230,37,37,0
"9a0dc646f934470daf08c4b56ccf73db","fc0e049d56024bc9a02c9a9c435c3df7",22850542,3,3,0,231,37,38,1
"fc0e049d56024bc9a02c9a9c435c3df7","fc0e049d56024bc9a02c9a9c435c3df7",22850542,5,0,1,232,38,38,0
"fc0e049d56024bc9a02c9a9c435c3df7","67a089198fcb4e1c8f2385786c2b296f",22850542,2,4,0,233,38,39,1
"64d48c6c9c7940639a932219a6c87198","e2911e79efc2420eac45d9f671463d4b",22850542,1,-70,0,235,40,2,-38
"e2911e79efc2420eac45d9f671463d4b","e2911e79efc2420eac45d9f671463d4b",22850542,5,0,1,236,2,2,0
"e2911e79efc2420eac45d9f671463d4b","56586aa865414f538729c7f7735d2bc6",22850542,3,12,0,238,2,12,10
"56586aa865414f538729c7f7735d2bc6","56586aa865414f538729c7f7735d2bc6",22850542,4,0,1,239,12,12,0
"56586aa865414f538729c7f7735d2bc6","88fff56d0342490dbef9040750a20f6c",22850542,1,99,0,241,12,72,60
"88fff56d0342490dbef9040750a20f6c","88fff56d0342490dbef9040750a20f6c",22850542,1,0,1,242,72,72,0
"88fff56d0342490dbef9040750a20f6c","adb17b12b66c4a49a85fd34322f7df70",22850542,1,1,0,243,72,73,1
"adb17b12b66c4a49a85fd34322f7df70","adb17b12b66c4a49a85fd34322f7df70",22850542,1,0,1,244,73,73,0
"adb17b12b66c4a49a85fd34322f7df70","a2becd407db34b189200a32546d9d569",22850542,1,3,0,245,73,75,2
"a2becd407db34b189200a32546d9d569","d646286c8051419bbc2e31dd1db55ca8",22850542,3,-9,0,246,75,67,-8
"d646286c8051419bbc2e31dd1db55ca8","d646286c8051419bbc2e31dd1db55ca8",22850542,2,0,1,247,67,67,0
"d646286c8051419bbc2e31dd1db55ca8","140d5b27b8574befad82c0a013b59dfa",22850542,1,8,0,248,67,74,7
"140d5b27b8574befad82c0a013b59dfa","d646286c8051419bbc2e31dd1db55ca8",22850542,1,-8,0,249,74,67,-7
"d646286c8051419bbc2e31dd1db55ca8","a2becd407db34b189200a32546d9d569",22850542,3,9,0,250,67,75,8
"a2becd407db34b189200a32546d9d569","a2becd407db34b189200a32546d9d569",22850542,3,0,1,254,75,75,0
"a2becd407db34b189200a32546d9d569","58c22b011d0f4c2ea6d13615edbb9eeb",22850542,1,2,0,257,75,77,2
"58c22b011d0f4c2ea6d13615edbb9eeb","58c22b011d0f4c2ea6d13615edbb9eeb",22850542,12,0,1,258,77,77,0
"58c22b011d0f4c2ea6d13615edbb9eeb","140d5b27b8574befad82c0a013b59dfa",22850542,1,-3,0,270,77,74,-3
"140d5b27b8574befad82c0a013b59dfa","a2becd407db34b189200a32546d9d569",22850542,1,1,0,271,74,75,1
"d646286c8051419bbc2e31dd1db55ca8","dd76e1861dc9461c830888729d091ee0",22850542,1,12,0,273,67,78,11
"dd76e1861dc9461c830888729d091ee0","dd76e1861dc9461c830888729d091ee0",22850542,5,0,1,274,78,78,0
"dd76e1861dc9461c830888729d091ee0","cd1d828f1a694b87913a7ea66c23803e",22850542,1,1,0,279,78,79,1
"cd1d828f1a694b87913a7ea66c23803e","cd1d828f1a694b87913a7ea66c23803e",22850542,2,0,1,280,79,79,0
"cd1d828f1a694b87913a7ea66c23803e","9176a3c2b4d2465fa8b0c67096c2a97e",22850542,1,1,0,282,79,80,1
"9176a3c2b4d2465fa8b0c67096c2a97e","9176a3c2b4d2465fa8b0c67096c2a97e",22850542,5,0,1,283,80,80,0
"9176a3c2b4d2465fa8b0c67096c2a97e","f8ec6445f7194e25b9101d4fbcb07a18",22850542,1,1,0,288,80,81,1
"f8ec6445f7194e25b9101d4fbcb07a18","f8ec6445f7194e25b9101d4fbcb07a18",22850542,2,0,1,289,81,81,0
"f8ec6445f7194e25b9101d4fbcb07a18","140d5b27b8574befad82c0a013b59dfa",22850542,1,-7,0,291,81,74,-7
"140d5b27b8574befad82c0a013b59dfa","d18a9ea32855445f8736581f5cb119ce",22850542,1,9,0,292,74,82,8
"d18a9ea32855445f8736581f5cb119ce","f564483cbd7a407681aa2fcca518cf5f",22850542,1,4,0,293,82,85,3
"f564483cbd7a407681aa2fcca518cf5f","f564483cbd7a407681aa2fcca518cf5f",22850542,1,0,1,294,85,85,0
"f564483cbd7a407681aa2fcca518cf5f","18fd01350bd5434ca636d59a599d768a",22850542,1,1,0,295,85,86,1
"18fd01350bd5434ca636d59a599d768a","18fd01350bd5434ca636d59a599d768a",22850542,8,0,1,296,86,86,0
"18fd01350bd5434ca636d59a599d768a","ae5ac430ea254e708a6f5deaaf7464ae",22850542,1,-2,0,304,86,84,-2
"ae5ac430ea254e708a6f5deaaf7464ae","6a9f0ef185fb47f0937e29daa1c71ed5",22850542,1,7,0,305,84,90,6
"6a9f0ef185fb47f0937e29daa1c71ed5","c681290961c94c4caf23b529d1ae6b9a",22850542,1,-2,0,306,90,88,-2
"c681290961c94c4caf23b529d1ae6b9a","c681290961c94c4caf23b529d1ae6b9a",22850542,1,0,1,307,88,88,0
"c681290961c94c4caf23b529d1ae6b9a","6a9f0ef185fb47f0937e29daa1c71ed5",22850542,1,2,0,308,88,90,2
"6a9f0ef185fb47f0937e29daa1c71ed5","6a9f0ef185fb47f0937e29daa1c71ed5",22850542,3,0,1,309,90,90,0
"6a9f0ef185fb47f0937e29daa1c71ed5","d646286c8051419bbc2e31dd1db55ca8",22850542,1,-27,0,312,90,67,-23
"d646286c8051419bbc2e31dd1db55ca8","e20db35ced8544ddac5bc3839145e463",22850542,1,30,0,313,67,91,24
"e20db35ced8544ddac5bc3839145e463","1febb706d7a34005ae8711ed49c76e64",22850542,1,3,0,314,91,94,3
"1febb706d7a34005ae8711ed49c76e64","1febb706d7a34005ae8711ed49c76e64",22850542,2,0,1,315,94,94,0
"1febb706d7a34005ae8711ed49c76e64","8f73ba6f5a0042f2850356ac38ac6f24",22850542,1,1,0,317,94,95,1
"8f73ba6f5a0042f2850356ac38ac6f24","8f73ba6f5a0042f2850356ac38ac6f24",22850542,5,0,1,318,95,95,0
"8f73ba6f5a0042f2850356ac38ac6f24","e2260b86653c46d7b14a41fb419dbf8c",22850542,1,1,0,323,95,96,1
"e2260b86653c46d7b14a41fb419dbf8c","e2260b86653c46d7b14a41fb419dbf8c",22850542,2,0,1,324,96,96,0
"e2260b86653c46d7b14a41fb419dbf8c","35eb641ad1d845bbba54915bce75a962",22850542,1,1,0,326,96,97,1
"35eb641ad1d845bbba54915bce75a962","35eb641ad1d845bbba54915bce75a962",22850542,5,0,1,327,97,97,0
"35eb641ad1d845bbba54915bce75a962","08be90ffbeea4795a138cd42ed8db56f",22850542,1,1,0,332,97,98,1
"08be90ffbeea4795a138cd42ed8db56f","08be90ffbeea4795a138cd42ed8db56f",22850542,2,0,1,333,98,98,0
"08be90ffbeea4795a138cd42ed8db56f","3007433c8f584dcbb5ac159c1c5f2be3",22850542,1,1,0,335,98,99,1
"3007433c8f584dcbb5ac159c1c5f2be3","3007433c8f584dcbb5ac159c1c5f2be3",22850542,5,0,1,336,99,99,0
"3007433c8f584dcbb5ac159c1c5f2be3","d391c8b6e56a43a7b654e9dee02d904b",22850542,1,5,0,341,99,103,4
"d391c8b6e56a43a7b654e9dee02d904b","00ae5f0c51874a73a41ebea838d95682",22850542,1,-2,0,342,103,101,-2
"00ae5f0c51874a73a41ebea838d95682","e20db35ced8544ddac5bc3839145e463",22850542,1,-11,0,343,101,91,-10
"e20db35ced8544ddac5bc3839145e463","00ae5f0c51874a73a41ebea838d95682",22850542,1,11,0,344,91,101,10
"00ae5f0c51874a73a41ebea838d95682","d391c8b6e56a43a7b654e9dee02d904b",22850542,1,2,0,345,101,103,2
"d391c8b6e56a43a7b654e9dee02d904b","d391c8b6e56a43a7b654e9dee02d904b",22850542,15,0,1,346,103,103,0
"d391c8b6e56a43a7b654e9dee02d904b","6111116566fc4fd9abba409322bea245",22850542,1,1,0,361,103,104,1
"6111116566fc4fd9abba409322bea245","6111116566fc4fd9abba409322bea245",22850542,2,0,1,362,104,104,0
"6111116566fc4fd9abba409322bea245","a81b2235cb9c499eb9ea8ee0a8dd9725",22850542,1,1,0,364,104,105,1
"a81b2235cb9c499eb9ea8ee0a8dd9725","a81b2235cb9c499eb9ea8ee0a8dd9725",22850542,5,0,1,365,105,105,0
"a81b2235cb9c499eb9ea8ee0a8dd9725","2d4e0ab0ef3b4d73b82c72d4621a7579",22850542,1,1,0,370,105,106,1
"2d4e0ab0ef3b4d73b82c72d4621a7579","2d4e0ab0ef3b4d73b82c72d4621a7579",22850542,2,0,1,371,106,106,0
"2d4e0ab0ef3b4d73b82c72d4621a7579","8bdebf492ebd4e62b0d522e8ab5e5197",22850542,1,1,0,373,106,107,1
"8bdebf492ebd4e62b0d522e8ab5e5197","8bdebf492ebd4e62b0d522e8ab5e5197",22850542,2,0,1,374,107,107,0
"8bdebf492ebd4e62b0d522e8ab5e5197","73039f8c1eb9409cb4caee2cf968001e",22850542,1,-7,0,376,107,100,-7
"73039f8c1eb9409cb4caee2cf968001e","4280927ec4d643238aa49c32f9e06c6c",22850542,1,10,0,377,100,109,9
"4280927ec4d643238aa49c32f9e06c6c","4280927ec4d643238aa49c32f9e06c6c",22850542,2,0,1,378,109,109,0
"4280927ec4d643238aa49c32f9e06c6c","fc44e6a5f7654430af1227838224dceb",22850542,1,2,0,380,109,111,2
"fc44e6a5f7654430af1227838224dceb","fc44e6a5f7654430af1227838224dceb",22850542,2,0,1,381,111,111,0
"fc44e6a5f7654430af1227838224dceb","08111f75e22d409998cf8b85bd431f0a",22850542,1,-3,0,383,111,108,-3
"08111f75e22d409998cf8b85bd431f0a","a9ae0a3c070d455bb4369a8996313336",22850542,1,7,0,384,108,114,6
"a9ae0a3c070d455bb4369a8996313336","a9ae0a3c070d455bb4369a8996313336",22850542,4,0,1,385,114,114,0
"a9ae0a3c070d455bb4369a8996313336","71cec822bcff4f30a20e75dc63ef7b65",22850542,1,2,0,389,114,116,2
"71cec822bcff4f30a20e75dc63ef7b65","71cec822bcff4f30a20e75dc63ef7b65",22850542,1,0,1,390,116,116,0
"71cec822bcff4f30a20e75dc63ef7b65","37319e88176d4aefa91d7a9980dbae91",22850542,1,-4,0,391,116,112,-4
"37319e88176d4aefa91d7a9980dbae91","62bff51286ef4f348717a3cf6fe2318f",22850542,1,9,0,392,112,120,8
"62bff51286ef4f348717a3cf6fe2318f","b1cd0e7dc3ad4a8eb91a4bfdbeb025b0",22850542,1,-2,0,393,120,118,-2
"b1cd0e7dc3ad4a8eb91a4bfdbeb025b0","b1cd0e7dc3ad4a8eb91a4bfdbeb025b0",22850542,1,0,1,394,118,118,0
"b1cd0e7dc3ad4a8eb91a4bfdbeb025b0","62bff51286ef4f348717a3cf6fe2318f",22850542,1,2,0,395,118,120,2
"62bff51286ef4f348717a3cf6fe2318f","62bff51286ef4f348717a3cf6fe2318f",22850542,3,0,1,396,120,120,0
"62bff51286ef4f348717a3cf6fe2318f","e20db35ced8544ddac5bc3839145e463",22850542,1,-33,0,399,120,91,-29
"e20db35ced8544ddac5bc3839145e463","779f9ddd1fd14d1e9e69f72219a1fdbd",22850542,1,36,0,400,91,121,30
"779f9ddd1fd14d1e9e69f72219a1fdbd","78adeee1fa2c4fe0bc73f7bca9fcee86",22850542,1,49,0,401,121,160,39
"78adeee1fa2c4fe0bc73f7bca9fcee86","ae26e6cda8ad4a3f81bd347560d9579f",22850542,1,-45,0,402,160,125,-35
"ae26e6cda8ad4a3f81bd347560d9579f","ae26e6cda8ad4a3f81bd347560d9579f",22850542,1,0,1,403,125,125,0
"ae26e6cda8ad4a3f81bd347560d9579f","ee48df95832b4374aa273ceb27ec1315",22850542,1,1,0,404,125,126,1
"ee48df95832b4374aa273ceb27ec1315","ee48df95832b4374aa273ceb27ec1315",22850542,1,0,1,405,126,126,0
"ee48df95832b4374aa273ceb27ec1315","7a439da90b394756ad1777fc4c6dead5",22850542,1,1,0,406,126,127,1
"7a439da90b394756ad1777fc4c6dead5","7a439da90b394756ad1777fc4c6dead5",22850542,1,0,1,407,127,127,0
"7a439da90b394756ad1777fc4c6dead5","a8dd5213034441ac92724b4e83eb0bb2",22850542,1,3,0,408,127,129,2
"a8dd5213034441ac92724b4e83eb0bb2","779f9ddd1fd14d1e9e69f72219a1fdbd",22850542,1,-9,0,409,129,121,-8
"779f9ddd1fd14d1e9e69f72219a1fdbd","a8dd5213034441ac92724b4e83eb0bb2",22850542,1,9,0,410,121,129,8
"a8dd5213034441ac92724b4e83eb0bb2","a8dd5213034441ac92724b4e83eb0bb2",22850542,1,0,1,411,129,129,0
"a8dd5213034441ac92724b4e83eb0bb2","8115eab6556b45f5b415c3b8c26a12e5",22850542,1,2,0,412,129,131,2
"8115eab6556b45f5b415c3b8c26a12e5","8115eab6556b45f5b415c3b8c26a12e5",22850542,2,0,1,413,131,131,0
"8115eab6556b45f5b415c3b8c26a12e5","ec34b06efd844b46a4c4818ecdb9b8f4",22850542,1,1,0,415,131,132,1
"ec34b06efd844b46a4c4818ecdb9b8f4","ec34b06efd844b46a4c4818ecdb9b8f4",22850542,2,0,1,416,132,132,0
"ec34b06efd844b46a4c4818ecdb9b8f4","c2e1c2b9eac64109b343a088584b576b",22850542,1,1,0,418,132,133,1
"c2e1c2b9eac64109b343a088584b576b","c2e1c2b9eac64109b343a088584b576b",22850542,2,0,1,419,133,133,0
"c2e1c2b9eac64109b343a088584b576b","579338175e0b4bbb8ef3b712b5d8b54e",22850542,1,-5,0,421,133,128,-5
"579338175e0b4bbb8ef3b712b5d8b54e","b416d47c56a742199b5d7c7f19d6503a",22850542,1,7,0,422,128,134,6
"b416d47c56a742199b5d7c7f19d6503a","b416d47c56a742199b5d7c7f19d6503a",22850542,1,0,1,423,134,134,0
"b416d47c56a742199b5d7c7f19d6503a","779f9ddd1fd14d1e9e69f72219a1fdbd",22850542,1,-15,0,424,134,121,-13
"779f9ddd1fd14d1e9e69f72219a1fdbd","b416d47c56a742199b5d7c7f19d6503a",22850542,1,15,0,425,121,134,13
"b416d47c56a742199b5d7c7f19d6503a","f661500307d74c908e9207d949ceb4aa",22850542,1,3,0,426,134,136,2
"f661500307d74c908e9207d949ceb4aa","8bc5795d6a984a3eace4e2811e52dd4f",22850542,1,-2,0,427,136,135,-1
"8bc5795d6a984a3eace4e2811e52dd4f","8bc5795d6a984a3eace4e2811e52dd4f",22850542,1,0,1,428,135,135,0
"8bc5795d6a984a3eace4e2811e52dd4f","b416d47c56a742199b5d7c7f19d6503a",22850542,1,-1,0,429,135,134,-1
"b416d47c56a742199b5d7c7f19d6503a","cd4532ad48034873ba8bce2aac0c9808",22850542,1,4,0,430,134,137,3
"cd4532ad48034873ba8bce2aac0c9808","cd4532ad48034873ba8bce2aac0c9808",22850542,1,0,1,431,137,137,0
"cd4532ad48034873ba8bce2aac0c9808","779f9ddd1fd14d1e9e69f72219a1fdbd",22850542,1,-19,0,432,137,121,-16
"779f9ddd1fd14d1e9e69f72219a1fdbd","df1de691dafe4549a18a4398ee9dfaf9",22850542,2,23,0,433,121,139,18
"df1de691dafe4549a18a4398ee9dfaf9","6c5ad271a44743479bfaea29b1db8d02",22850542,2,4,0,434,139,143,4
"6c5ad271a44743479bfaea29b1db8d02","df1de691dafe4549a18a4398ee9dfaf9",22850542,1,-4,0,435,143,139,-4
"df1de691dafe4549a18a4398ee9dfaf9","779f9ddd1fd14d1e9e69f72219a1fdbd",22850542,1,-23,0,436,139,121,-18
"779f9ddd1fd14d1e9e69f72219a1fdbd","779f9ddd1fd14d1e9e69f72219a1fdbd",22850542,1,0,1,437,121,121,0
"6c5ad271a44743479bfaea29b1db8d02","6c5ad271a44743479bfaea29b1db8d02",22850542,2,0,1,440,143,143,0
"6c5ad271a44743479bfaea29b1db8d02","83d311bed5374fee83d8d67a7d9d82dc",22850542,1,1,0,442,143,144,1
"83d311bed5374fee83d8d67a7d9d82dc","83d311bed5374fee83d8d67a7d9d82dc",22850542,1,0,1,443,144,144,0
"83d311bed5374fee83d8d67a7d9d82dc","402bba41861d43acb52a5abb89e8831e",22850542,1,1,0,444,144,145,1
"402bba41861d43acb52a5abb89e8831e","402bba41861d43acb52a5abb89e8831e",22850542,2,0,1,445,145,145,0
"402bba41861d43acb52a5abb89e8831e","8aae34f5ddbb4052a709b12e6b0d40fa",22850542,1,3,0,447,145,147,2
"8aae34f5ddbb4052a709b12e6b0d40fa","df1de691dafe4549a18a4398ee9dfaf9",22850542,1,-9,0,448,147,139,-8
"df1de691dafe4549a18a4398ee9dfaf9","8aae34f5ddbb4052a709b12e6b0d40fa",22850542,1,9,0,449,139,147,8
"8aae34f5ddbb4052a709b12e6b0d40fa","645b3f0249f64f76af2e19eb4d0e55b7",22850542,1,2,0,450,147,149,2
"645b3f0249f64f76af2e19eb4d0e55b7","645b3f0249f64f76af2e19eb4d0e55b7",22850542,2,0,1,451,149,149,0
"645b3f0249f64f76af2e19eb4d0e55b7","7e7b8db5064d4369805ab370aac5ddfb",22850542,1,1,0,453,149,150,1
"7e7b8db5064d4369805ab370aac5ddfb","7e7b8db5064d4369805ab370aac5ddfb",22850542,2,0,1,454,150,150,0
"7e7b8db5064d4369805ab370aac5ddfb","8956d210ae7f41968fada86d4c979d6a",22850542,1,1,0,456,150,151,1
"8956d210ae7f41968fada86d4c979d6a","8956d210ae7f41968fada86d4c979d6a",22850542,2,0,1,457,151,151,0
"8956d210ae7f41968fada86d4c979d6a","f902b0f41b544d4dbf79664fd233648d",22850542,1,-5,0,459,151,146,-5
"f902b0f41b544d4dbf79664fd233648d","ae781e8b775e4ccd93bc800dad5c8376",22850542,1,8,0,460,146,153,7
"ae781e8b775e4ccd93bc800dad5c8376","ae781e8b775e4ccd93bc800dad5c8376",22850542,2,0,1,461,153,153,0
"ae781e8b775e4ccd93bc800dad5c8376","06882a8492d9499aa31555567f575ecb",22850542,1,1,0,463,153,154,1
"06882a8492d9499aa31555567f575ecb","06882a8492d9499aa31555567f575ecb",22850542,1,0,1,464,154,154,0
"06882a8492d9499aa31555567f575ecb","f293c508f409466a8f27ddd7d1e40b20",22850542,1,1,0,465,154,155,1
"f293c508f409466a8f27ddd7d1e40b20","f293c508f409466a8f27ddd7d1e40b20",22850542,2,0,1,466,155,155,0
"f293c508f409466a8f27ddd7d1e40b20","cc4ddef5bbbe48ebb605141b347c4ed1",22850542,1,1,0,468,155,156,1
"cc4ddef5bbbe48ebb605141b347c4ed1","cc4ddef5bbbe48ebb605141b347c4ed1",22850542,1,0,1,469,156,156,0
"cc4ddef5bbbe48ebb605141b347c4ed1","d313cec988a84645bee413e8d4724a4b",22850542,1,3,0,470,156,158,2
"d313cec988a84645bee413e8d4724a4b","f03480cf4eba413194d7af52fc0e7f28",22850542,1,-7,0,471,158,152,-6
"f03480cf4eba413194d7af52fc0e7f28","d313cec988a84645bee413e8d4724a4b",22850542,1,7,0,472,152,158,6
"d313cec988a84645bee413e8d4724a4b","d313cec988a84645bee413e8d4724a4b",22850542,3,0,1,473,158,158,0
"d313cec988a84645bee413e8d4724a4b","dc60696c76a74368a60f72246e47700d",22850542,1,1,0,476,158,159,1
"dc60696c76a74368a60f72246e47700d","dc60696c76a74368a60f72246e47700d",22850542,1,0,1,477,159,159,0
"dc60696c76a74368a60f72246e47700d","78adeee1fa2c4fe0bc73f7bca9fcee86",22850542,1,3,0,478,159,160,1
"78adeee1fa2c4fe0bc73f7bca9fcee86","df1de691dafe4549a18a4398ee9dfaf9",22850542,1,-26,0,479,160,139,-21
"df1de691dafe4549a18a4398ee9dfaf9","65202579580f4ad38d734b4ee39d22a8",22850542,1,31,0,480,139,164,25
"65202579580f4ad38d734b4ee39d22a8","65202579580f4ad38d734b4ee39d22a8",22850542,74,0,1,481,164,164,0
"65202579580f4ad38d734b4ee39d22a8","78adeee1fa2c4fe0bc73f7bca9fcee86",22850542,2,-5,0,483,164,160,-4
"78adeee1fa2c4fe0bc73f7bca9fcee86","65202579580f4ad38d734b4ee39d22a8",22850542,5,5,0,484,160,164,4
"65202579580f4ad38d734b4ee39d22a8","3cbcea2be0984e7dbd5a48195af10ce7",22850542,2,3,0,489,164,165,1
"3cbcea2be0984e7dbd5a48195af10ce7","3cbcea2be0984e7dbd5a48195af10ce7",22850542,2,0,1,490,165,165,0
"3cbcea2be0984e7dbd5a48195af10ce7","82e6285962b8400d9d6fc32436022a94",22850542,2,2,0,491,165,167,2
"82e6285962b8400d9d6fc32436022a94","3cbcea2be0984e7dbd5a48195af10ce7",22850542,1,-2,0,492,167,165,-2
"3cbcea2be0984e7dbd5a48195af10ce7","a9ac840f098c4bd0a2ee896214ce29cd",22850542,2,5,0,493,165,168,3
"a9ac840f098c4bd0a2ee896214ce29cd","67a089198fcb4e1c8f2385786c2b296f",22850542,1,-165,0,494,168,39,-129
"67a089198fcb4e1c8f2385786c2b296f","a9ac840f098c4bd0a2ee896214ce29cd",22850542,1,165,0,495,39,168,129
"a9ac840f098c4bd0a2ee896214ce29cd","78adeee1fa2c4fe0bc73f7bca9fcee86",22850542,1,-13,0,496,168,160,-8
"78adeee1fa2c4fe0bc73f7bca9fcee86","78adeee1fa2c4fe0bc73f7bca9fcee86",22850542,2,0,1,497,160,160,0
"78adeee1fa2c4fe0bc73f7bca9fcee86","67a089198fcb4e1c8f2385786c2b296f",22850542,1,-152,0,498,160,39,-121
"67a089198fcb4e1c8f2385786c2b296f","d9c8d8c444a64dadbbb508652c721e17",22850542,1,10,0,499,39,46,7
"d9c8d8c444a64dadbbb508652c721e17","b534b89233134e30a9b5645138bfa9ee",22850542,1,-6,0,500,46,41,-5
"6e13d61a7bdb44bca949c9f86fab3be5","67a089198fcb4e1c8f2385786c2b296f",22850542,2,-11,0,502,47,39,-8
"67a089198fcb4e1c8f2385786c2b296f","a49d1bb4328949299686242fd0be5584",22850542,1,-38,0,503,39,21,-18
"b7719e26494940efa49512aedd0aac79","a49d1bb4328949299686242fd0be5584",22850542,1,2,0,505,20,21,1
"a49d1bb4328949299686242fd0be5584","d4f45188d3c84a02ba08454e6403a818",22850542,1,3,0,506,21,24,3
"d4f45188d3c84a02ba08454e6403a818","d4c3b003e8274e429d2fa688d73fde6d",22850542,2,-2,0,507,24,22,-2
"d4c3b003e8274e429d2fa688d73fde6d","5bc03c8f16354d04bd51f5bb93559ad3",22850542,1,4,0,508,22,26,4
"5bc03c8f16354d04bd51f5bb93559ad3","d646286c8051419bbc2e31dd1db55ca8",22850542,1,70,0,509,26,67,41
"a2becd407db34b189200a32546d9d569","b613861cecf84ffcab01afb23f660475",22850542,1,-118,0,511,75,1,-74
"b613861cecf84ffcab01afb23f660475","b534b89233134e30a9b5645138bfa9ee",22850542,1,76,0,512,1,41,40
"b534b89233134e30a9b5645138bfa9ee","d9c8d8c444a64dadbbb508652c721e17",22850542,1,6,0,513,41,46,5
"d9c8d8c444a64dadbbb508652c721e17","6e13d61a7bdb44bca949c9f86fab3be5",22850542,1,1,0,514,46,47,1
"67a089198fcb4e1c8f2385786c2b296f","78adeee1fa2c4fe0bc73f7bca9fcee86",22850542,1,152,0,519,39,160,121
"65202579580f4ad38d734b4ee39d22a8","8959e6304a0348309a771e4d08d1b64a",22850542,2,-1,0,532,164,163,-1
"8959e6304a0348309a771e4d08d1b64a","78adeee1fa2c4fe0bc73f7bca9fcee86",22850542,2,-4,0,533,163,160,-3
"3cbcea2be0984e7dbd5a48195af10ce7","78adeee1fa2c4fe0bc73f7bca9fcee86",22850542,1,-8,0,599,165,160,-5
"78adeee1fa2c4fe0bc73f7bca9fcee86","82e6285962b8400d9d6fc32436022a94",22850542,1,10,0,600,160,167,7
"82e6285962b8400d9d6fc32436022a94","a9ac840f098c4bd0a2ee896214ce29cd",22850542,1,3,0,601,167,168,1
"a9ac840f098c4bd0a2ee896214ce29cd","3cbcea2be0984e7dbd5a48195af10ce7",22850542,1,-5,0,602,168,165,-3
"a9ac840f098c4bd0a2ee896214ce29cd","0c7262dff33c4087bc660ccf40f92f9c",22850542,1,4,0,604,168,169,1
"0c7262dff33c4087bc660ccf40f92f9c","b2275c3fad834f8d90737a2d9a6927d6",22850542,2,3,0,605,169,172,3
"b2275c3fad834f8d90737a2d9a6927d6","0c7262dff33c4087bc660ccf40f92f9c",22850542,1,-3,0,606,172,169,-3
"0c7262dff33c4087bc660ccf40f92f9c","0c7262dff33c4087bc660ccf40f92f9c",22850542,1,0,1,607,169,169,0
"b2275c3fad834f8d90737a2d9a6927d6","b2275c3fad834f8d90737a2d9a6927d6",22850542,31,0,1,609,172,172,0
"b2275c3fad834f8d90737a2d9a6927d6","eb515a26030b41f8a82a1e6114420bad",22850542,1,1,0,640,172,173,1
"eb515a26030b41f8a82a1e6114420bad","eb515a26030b41f8a82a1e6114420bad",22850542,2,0,1,641,173,173,0
"eb515a26030b41f8a82a1e6114420bad","0c7262dff33c4087bc660ccf40f92f9c",22850542,1,-4,0,643,173,169,-4
"0c7262dff33c4087bc660ccf40f92f9c","b42cc17b7de840f181a704558d0bc845",22850542,1,7,0,644,169,175,6
"b42cc17b7de840f181a704558d0bc845","b42cc17b7de840f181a704558d0bc845",22850542,2,0,1,645,175,175,0
"b42cc17b7de840f181a704558d0bc845","801f9e9135034f49bf5f8b4bdefedb41",22850542,1,2,0,647,175,177,2
"801f9e9135034f49bf5f8b4bdefedb41","801f9e9135034f49bf5f8b4bdefedb41",22850542,4,0,1,648,177,177,0
"801f9e9135034f49bf5f8b4bdefedb41","ea38cc0e6e6e41edbabf210220808bf9",22850542,1,3,0,652,177,179,2
"ea38cc0e6e6e41edbabf210220808bf9","362fcb0699a14845ab29b2340093e528",22850542,1,-6,0,653,179,174,-5
"362fcb0699a14845ab29b2340093e528","b87c552dd247427abe6ab5795b9c9d43",22850542,1,8,0,654,174,181,7
"b87c552dd247427abe6ab5795b9c9d43","ea38cc0e6e6e41edbabf210220808bf9",22850542,1,-2,0,655,181,179,-2
"ea38cc0e6e6e41edbabf210220808bf9","ea38cc0e6e6e41edbabf210220808bf9",22850542,1,0,1,656,179,179,0
"ea38cc0e6e6e41edbabf210220808bf9","0c7262dff33c4087bc660ccf40f92f9c",22850542,1,-12,0,657,179,169,-10
"0c7262dff33c4087bc660ccf40f92f9c","ea38cc0e6e6e41edbabf210220808bf9",22850542,1,12,0,658,169,179,10
"ea38cc0e6e6e41edbabf210220808bf9","b87c552dd247427abe6ab5795b9c9d43",22850542,1,2,0,659,179,181,2
"b87c552dd247427abe6ab5795b9c9d43","b87c552dd247427abe6ab5795b9c9d43",22850542,8,0,1,660,181,181,0
"b87c552dd247427abe6ab5795b9c9d43","139b097acfca451689d80c9c6eebdf7b",22850542,1,-3,0,668,181,178,-3
"139b097acfca451689d80c9c6eebdf7b","30f660a1feb34582a739722532524f79",22850542,1,6,0,669,178,183,5
"30f660a1feb34582a739722532524f79","30f660a1feb34582a739722532524f79",22850542,3,0,1,670,183,183,0
"30f660a1feb34582a739722532524f79","2024b4885bd14338a39b7b509acbbd02",22850542,1,-1,0,673,183,182,-1
"2024b4885bd14338a39b7b509acbbd02","c3f63fe50d8e487c86bf8ef76c9cadd3",22850542,1,4,0,674,182,185,3
"c3f63fe50d8e487c86bf8ef76c9cadd3","c3f63fe50d8e487c86bf8ef76c9cadd3",22850542,1,0,1,675,185,185,0
"c3f63fe50d8e487c86bf8ef76c9cadd3","0c7262dff33c4087bc660ccf40f92f9c",22850542,1,-20,0,676,185,169,-16
"0c7262dff33c4087bc660ccf40f92f9c","c8e371568a0c4391b25796ae4e91952e",22850542,1,23,0,677,169,186,17
"c8e371568a0c4391b25796ae4e91952e","0c7262dff33c4087bc660ccf40f92f9c",22850542,1,-23,0,678,186,169,-17
"0c7262dff33c4087bc660ccf40f92f9c","3cbcea2be0984e7dbd5a48195af10ce7",22850542,1,-9,0,679,169,165,-4
"82e6285962b8400d9d6fc32436022a94","c8e371568a0c4391b25796ae4e91952e",22850542,1,30,0,682,167,186,19
"c8e371568a0c4391b25796ae4e91952e","c8e371568a0c4391b25796ae4e91952e",22850542,4,0,1,683,186,186,0
"c8e371568a0c4391b25796ae4e91952e","7d932b23e1c84326ae5aa4d3c0d813d1",22850542,1,2,0,685,186,188,2
"7d932b23e1c84326ae5aa4d3c0d813d1","7d932b23e1c84326ae5aa4d3c0d813d1",22850542,1,0,1,686,188,188,0
"7d932b23e1c84326ae5aa4d3c0d813d1","c8e371568a0c4391b25796ae4e91952e",22850542,1,-2,0,687,188,186,-2
"c8e371568a0c4391b25796ae4e91952e","ab11d94c6c8948ea90b88f19d2cd502b",22850542,2,5,0,688,186,190,4
"ab11d94c6c8948ea90b88f19d2cd502b","c8e371568a0c4391b25796ae4e91952e",22850542,1,-5,0,689,190,186,-4
"ab11d94c6c8948ea90b88f19d2cd502b","ab11d94c6c8948ea90b88f19d2cd502b",22850542,3,0,1,692,190,190,0
"ab11d94c6c8948ea90b88f19d2cd502b","f992451ed6ad4e68bb9e68ad6be7c4be",22850542,1,2,0,695,190,192,2
"f992451ed6ad4e68bb9e68ad6be7c4be","f992451ed6ad4e68bb9e68ad6be7c4be",22850542,1,0,1,696,192,192,0
"f992451ed6ad4e68bb9e68ad6be7c4be","07b44a7a51e94c78b411c753fc39dab0",22850542,1,-3,0,697,192,189,-3
"07b44a7a51e94c78b411c753fc39dab0","6cd2dcaac46847d4a0bc53f296d90375",22850542,1,6,0,698,189,194,5
"6cd2dcaac46847d4a0bc53f296d90375","6cd2dcaac46847d4a0bc53f296d90375",22850542,1,0,1,699,194,194,0
"6cd2dcaac46847d4a0bc53f296d90375","2d2580c9411c4972909db508d6956a58",22850542,1,2,0,700,194,196,2
"2d2580c9411c4972909db508d6956a58","2d2580c9411c4972909db508d6956a58",22850542,5,0,1,701,196,196,0
"2d2580c9411c4972909db508d6956a58","5bddb3d9ed264f3984702f048c7e5340",22850542,1,1,0,706,196,197,1
"5bddb3d9ed264f3984702f048c7e5340","5bddb3d9ed264f3984702f048c7e5340",22850542,2,0,1,707,197,197,0
"5bddb3d9ed264f3984702f048c7e5340","d5e8e2bd12a2466b9d6d90855f0eb079",22850542,1,1,0,709,197,198,1
"d5e8e2bd12a2466b9d6d90855f0eb079","d5e8e2bd12a2466b9d6d90855f0eb079",22850542,2,0,1,710,198,198,0
"d5e8e2bd12a2466b9d6d90855f0eb079","017d7ca8e0394b91aaadc9574df2202c",22850542,1,-5,0,712,198,193,-5
"017d7ca8e0394b91aaadc9574df2202c","54e8e9f0ea3e45c4bf3b8ac799ee31b1",22850542,1,8,0,713,193,200,7
"54e8e9f0ea3e45c4bf3b8ac799ee31b1","54e8e9f0ea3e45c4bf3b8ac799ee31b1",22850542,1,0,1,714,200,200,0
"54e8e9f0ea3e45c4bf3b8ac799ee31b1","c614a00911be4877a075f19315530fb0",22850542,1,1,0,715,200,201,1
"c614a00911be4877a075f19315530fb0","c614a00911be4877a075f19315530fb0",22850542,6,0,1,716,201,201,0
"c614a00911be4877a075f19315530fb0","a6c21bd8b95249c7972820a7a7d76aff",22850542,1,1,0,722,201,202,1
"a6c21bd8b95249c7972820a7a7d76aff","a6c21bd8b95249c7972820a7a7d76aff",22850542,1,0,1,723,202,202,0
"a6c21bd8b95249c7972820a7a7d76aff","bb329d880ab54120adaf203a693bb203",22850542,1,1,0,724,202,203,1
"bb329d880ab54120adaf203a693bb203","bb329d880ab54120adaf203a693bb203",22850542,1,0,1,725,203,203,0
"bb329d880ab54120adaf203a693bb203","f9170dd6bc6442b4acd832747609b09a",22850542,1,-4,0,726,203,199,-4
"f9170dd6bc6442b4acd832747609b09a","d7f13c8d63ec4e2aa673fbb9cf9c6933",22850542,1,10,0,727,199,206,7
"d7f13c8d63ec4e2aa673fbb9cf9c6933","d7f13c8d63ec4e2aa673fbb9cf9c6933",22850542,1,0,1,728,206,206,0
"d7f13c8d63ec4e2aa673fbb9cf9c6933","b9e80f77c3a44349863b19875725c384",22850542,5,1,0,729,206,207,1
"b9e80f77c3a44349863b19875725c384","7108f0e4c2584f1f9c471689ae4c885c",22850542,5,1,0,730,207,208,1
"7108f0e4c2584f1f9c471689ae4c885c","b9e80f77c3a44349863b19875725c384",22850542,4,-1,0,731,208,207,-1
"b9e80f77c3a44349863b19875725c384","b9e80f77c3a44349863b19875725c384",22850542,11,0,1,732,207,207,0
"b9e80f77c3a44349863b19875725c384","d7f13c8d63ec4e2aa673fbb9cf9c6933",22850542,4,-1,0,743,207,206,-1
"7108f0e4c2584f1f9c471689ae4c885c","7108f0e4c2584f1f9c471689ae4c885c",22850542,12,0,1,746,208,208,0
"7108f0e4c2584f1f9c471689ae4c885c","d7f13c8d63ec4e2aa673fbb9cf9c6933",22850542,1,-2,0,758,208,206,-2
"d7f13c8d63ec4e2aa673fbb9cf9c6933","09400e101c5d4b439cf9a26b03aae558",22850542,2,5,0,759,206,210,4
"09400e101c5d4b439cf9a26b03aae558","d7f13c8d63ec4e2aa673fbb9cf9c6933",22850542,1,-5,0,760,210,206,-4
"d7f13c8d63ec4e2aa673fbb9cf9c6933","7108f0e4c2584f1f9c471689ae4c885c",22850542,3,2,0,761,206,208,2
"09400e101c5d4b439cf9a26b03aae558","09400e101c5d4b439cf9a26b03aae558",22850542,1,0,1,765,210,210,0
"09400e101c5d4b439cf9a26b03aae558","a88efa7e50ce47159810ab553afa6d3a",22850542,1,2,0,766,210,212,2
"a88efa7e50ce47159810ab553afa6d3a","a88efa7e50ce47159810ab553afa6d3a",22850542,5,0,1,767,212,212,0
"a88efa7e50ce47159810ab553afa6d3a","a875096404ef4a9984b62d74cda916f9",22850542,1,-3,0,772,212,209,-3
"a875096404ef4a9984b62d74cda916f9","be502a7a43c44bf7b682698de79d9369",22850542,1,6,0,773,209,214,5
"be502a7a43c44bf7b682698de79d9369","f7fb1952f56b4189b86a9f8b7862d2b8",22850542,2,1,0,774,214,215,1
"f7fb1952f56b4189b86a9f8b7862d2b8","be502a7a43c44bf7b682698de79d9369",22850542,1,-1,0,775,215,214,-1
"f7fb1952f56b4189b86a9f8b7862d2b8","f7fb1952f56b4189b86a9f8b7862d2b8",22850542,16,0,1,777,215,215,0
"f7fb1952f56b4189b86a9f8b7862d2b8","b860ee85d8bc4a2f97958cfb71be3533",22850542,1,1,0,793,215,216,1
"b860ee85d8bc4a2f97958cfb71be3533","b860ee85d8bc4a2f97958cfb71be3533",22850542,2,0,1,794,216,216,0
"b860ee85d8bc4a2f97958cfb71be3533","ec341f459285443b8361f7f15638ff08",22850542,1,-3,0,796,216,213,-3
"ec341f459285443b8361f7f15638ff08","363837c182e04711840d896ae1e0339c",22850542,1,6,0,797,213,218,5
"363837c182e04711840d896ae1e0339c","363837c182e04711840d896ae1e0339c",22850542,24,0,1,798,218,218,0
"363837c182e04711840d896ae1e0339c","01b2051f8941460d89945e3b02d1ce78",22850542,3,-1,0,810,218,217,-1
"01b2051f8941460d89945e3b02d1ce78","1c6721b1f63f4d30ba7746ea8af02a52",22850542,1,7,0,811,217,221,4
"1c6721b1f63f4d30ba7746ea8af02a52","d7f13c8d63ec4e2aa673fbb9cf9c6933",22850542,1,-21,0,812,221,206,-15
"d7f13c8d63ec4e2aa673fbb9cf9c6933","77ecef8eff6b4a2caea7707669bf7475",22850542,1,22,0,813,206,222,16
"77ecef8eff6b4a2caea7707669bf7475","77ecef8eff6b4a2caea7707669bf7475",22850542,12,0,1,814,222,222,0
"77ecef8eff6b4a2caea7707669bf7475","d03cb855c70044cf8c35d9ec0de696e3",22850542,2,3,0,826,222,224,2
"d03cb855c70044cf8c35d9ec0de696e3","1c6721b1f63f4d30ba7746ea8af02a52",22850542,2,-4,0,827,224,221,-3
"1c6721b1f63f4d30ba7746ea8af02a52","8b9ae98743bd4d4a8a87dff1c1244211",22850542,3,7,0,828,221,227,6
"8b9ae98743bd4d4a8a87dff1c1244211","d03cb855c70044cf8c35d9ec0de696e3",22850542,3,-3,0,829,227,224,-3
"d03cb855c70044cf8c35d9ec0de696e3","a49a937d6896486d9a5396654abcf2e1",22850542,1,2,0,830,224,226,2
"a49a937d6896486d9a5396654abcf2e1","a49a937d6896486d9a5396654abcf2e1",22850542,1,0,1,831,226,226,0
"a49a937d6896486d9a5396654abcf2e1","8b9ae98743bd4d4a8a87dff1c1244211",22850542,1,1,0,832,226,227,1
"8b9ae98743bd4d4a8a87dff1c1244211","8b9ae98743bd4d4a8a87dff1c1244211",22850542,20,0,1,833,227,227,0
"8b9ae98743bd4d4a8a87dff1c1244211","f7906d6f59b9489a91d2ef40db5a474d",22850542,2,-4,0,853,227,223,-4
"f7906d6f59b9489a91d2ef40db5a474d","2ab1535aac1346ba8801535bf729ef37",22850542,4,7,0,854,223,229,6
"2ab1535aac1346ba8801535bf729ef37","d7f13c8d63ec4e2aa673fbb9cf9c6933",22850542,1,-31,0,855,229,206,-23
"7108f0e4c2584f1f9c471689ae4c885c","c8e371568a0c4391b25796ae4e91952e",22850542,1,-28,0,858,208,186,-22
"c8e371568a0c4391b25796ae4e91952e","b54257a550b94ebc9538f3a90eee9d7e",22850542,1,22,0,859,186,204,18
"b54257a550b94ebc9538f3a90eee9d7e","c8e371568a0c4391b25796ae4e91952e",22850542,2,-22,0,860,204,186,-18
"c8e371568a0c4391b25796ae4e91952e","d7f13c8d63ec4e2aa673fbb9cf9c6933",22850542,2,26,0,861,186,206,20
"7108f0e4c2584f1f9c471689ae4c885c","be502a7a43c44bf7b682698de79d9369",22850542,1,8,0,864,208,214,6
"be502a7a43c44bf7b682698de79d9369","d7f13c8d63ec4e2aa673fbb9cf9c6933",22850542,1,-10,0,865,214,206,-8
"d7f13c8d63ec4e2aa673fbb9cf9c6933","f7fb1952f56b4189b86a9f8b7862d2b8",22850542,1,11,0,866,206,215,9
"f7fb1952f56b4189b86a9f8b7862d2b8","0c7262dff33c4087bc660ccf40f92f9c",22850542,1,-60,0,867,215,169,-46
"0c7262dff33c4087bc660ccf40f92f9c","b54257a550b94ebc9538f3a90eee9d7e",22850542,1,45,0,868,169,204,35
"c8e371568a0c4391b25796ae4e91952e","334c2344009840079b1d0e1b7ce3d5a7",22850542,1,23,0,871,186,205,19
"334c2344009840079b1d0e1b7ce3d5a7","334c2344009840079b1d0e1b7ce3d5a7",22850542,1,0,1,872,205,205,0
"334c2344009840079b1d0e1b7ce3d5a7","c8e371568a0c4391b25796ae4e91952e",22850542,1,-23,0,873,205,186,-19
"d7f13c8d63ec4e2aa673fbb9cf9c6933","363837c182e04711840d896ae1e0339c",22850542,2,15,0,878,206,218,12
"01b2051f8941460d89945e3b02d1ce78","91125ca626c5470eb145501f8c37f8db",22850542,1,4,0,880,217,220,3
"91125ca626c5470eb145501f8c37f8db","91125ca626c5470eb145501f8c37f8db",22850542,1,0,1,881,220,220,0
"91125ca626c5470eb145501f8c37f8db","d7f13c8d63ec4e2aa673fbb9cf9c6933",22850542,1,-18,0,882,220,206,-14
"d7f13c8d63ec4e2aa673fbb9cf9c6933","1c6721b1f63f4d30ba7746ea8af02a52",22850542,1,21,0,883,206,221,15
"1c6721b1f63f4d30ba7746ea8af02a52","77ecef8eff6b4a2caea7707669bf7475",22850542,1,1,0,884,221,222,1
"2ab1535aac1346ba8801535bf729ef37","5152833676bf4c6cb317060be10f68db",22850542,2,-1,0,890,229,228,-1
"5152833676bf4c6cb317060be10f68db","d03cb855c70044cf8c35d9ec0de696e3",22850542,1,-5,0,891,228,224,-4
"d03cb855c70044cf8c35d9ec0de696e3","8b9ae98743bd4d4a8a87dff1c1244211",22850542,1,3,0,892,224,227,3
"8b9ae98743bd4d4a8a87dff1c1244211","0c7262dff33c4087bc660ccf40f92f9c",22850542,1,-77,0,893,227,169,-58
"0c7262dff33c4087bc660ccf40f92f9c","d7f13c8d63ec4e2aa673fbb9cf9c6933",22850542,1,49,0,894,169,206,37
"7108f0e4c2584f1f9c471689ae4c885c","5152833676bf4c6cb317060be10f68db",22850542,1,28,0,900,208,228,20
"5152833676bf4c6cb317060be10f68db","5152833676bf4c6cb317060be10f68db",22850542,1,0,1,901,228,228,0
"5152833676bf4c6cb317060be10f68db","1c6721b1f63f4d30ba7746ea8af02a52",22850542,1,-9,0,902,228,221,-7
"1c6721b1f63f4d30ba7746ea8af02a52","2ab1535aac1346ba8801535bf729ef37",22850542,1,10,0,903,221,229,8
"5152833676bf4c6cb317060be10f68db","8b9ae98743bd4d4a8a87dff1c1244211",22850542,1,-2,0,905,228,227,-1
"d03cb855c70044cf8c35d9ec0de696e3","2ab1535aac1346ba8801535bf729ef37",22850542,1,6,0,907,224,229,5
"2ab1535aac1346ba8801535bf729ef37","f7906d6f59b9489a91d2ef40db5a474d",22850542,1,-7,0,908,229,223,-6
"2ab1535aac1346ba8801535bf729ef37","2ab1535aac1346ba8801535bf729ef37",22850542,2,0,1,910,229,229,0
"2ab1535aac1346ba8801535bf729ef37","a4f40fb48a8542c8949bae1f002cd9bc",22850542,1,2,0,912,229,231,2
"a4f40fb48a8542c8949bae1f002cd9bc","a4f40fb48a8542c8949bae1f002cd9bc",22850542,2,0,1,913,231,231,0
"a4f40fb48a8542c8949bae1f002cd9bc","8972c23e32044edb8a78fa1eed4e5947",22850542,1,1,0,915,231,232,1
"8972c23e32044edb8a78fa1eed4e5947","8972c23e32044edb8a78fa1eed4e5947",22850542,1,0,1,916,232,232,0
"8972c23e32044edb8a78fa1eed4e5947","92feb4a40f8344d38b6f722e42a53295",22850542,1,1,0,917,232,233,1
"92feb4a40f8344d38b6f722e42a53295","92feb4a40f8344d38b6f722e42a53295",22850542,2,0,1,918,233,233,0
"92feb4a40f8344d38b6f722e42a53295","5152833676bf4c6cb317060be10f68db",22850542,1,-5,0,920,233,228,-5
"5152833676bf4c6cb317060be10f68db","ca3e28f290354c08aefe5b0f769604e6",22850542,1,8,0,921,228,235,7
"ca3e28f290354c08aefe5b0f769604e6","ca3e28f290354c08aefe5b0f769604e6",22850542,9,0,1,922,235,235,0
"ca3e28f290354c08aefe5b0f769604e6","79a35eea833e4c2c9d22fc53c3c6445c",22850542,1,1,0,931,235,236,1
"79a35eea833e4c2c9d22fc53c3c6445c","79a35eea833e4c2c9d22fc53c3c6445c",22850542,4,0,1,932,236,236,0
"79a35eea833e4c2c9d22fc53c3c6445c","8f68228b1518449e9615cdafee41a2bd",22850542,1,1,0,936,236,237,1
"8f68228b1518449e9615cdafee41a2bd","8f68228b1518449e9615cdafee41a2bd",22850542,1,0,1,937,237,237,0
"8f68228b1518449e9615cdafee41a2bd","cab89fa5c3ed45a5aa550fc0352d6a42",22850542,1,1,0,938,237,238,1
"cab89fa5c3ed45a5aa550fc0352d6a42","cab89fa5c3ed45a5aa550fc0352d6a42",22850542,4,0,1,939,238,238,0
"cab89fa5c3ed45a5aa550fc0352d6a42","66d4fad4f1cf4b46be0750a99ad7a35a",22850542,1,1,0,943,238,239,1
"66d4fad4f1cf4b46be0750a99ad7a35a","66d4fad4f1cf4b46be0750a99ad7a35a",22850542,1,0,1,944,239,239,0
"66d4fad4f1cf4b46be0750a99ad7a35a","0b04c8e2f86d48c7aeb7e225819cd32b",22850542,1,-5,0,945,239,234,-5
"0b04c8e2f86d48c7aeb7e225819cd32b","1c6721b1f63f4d30ba7746ea8af02a52",22850542,1,-16,0,946,234,221,-13
"1c6721b1f63f4d30ba7746ea8af02a52","2ae94c0cea4d480a9d5dca8fb1d7b542",22850542,2,27,0,947,221,242,21
"2ae94c0cea4d480a9d5dca8fb1d7b542","1ebf23f9d994469a85206e4c7b1bf5f5",22850542,3,3,0,948,242,245,3
"1ebf23f9d994469a85206e4c7b1bf5f5","2ae94c0cea4d480a9d5dca8fb1d7b542",22850542,1,-3,0,949,245,242,-3
"2ae94c0cea4d480a9d5dca8fb1d7b542","2ae94c0cea4d480a9d5dca8fb1d7b542",22850542,3,0,1,950,242,242,0
"1ebf23f9d994469a85206e4c7b1bf5f5","1c6721b1f63f4d30ba7746ea8af02a52",22850542,1,-30,0,953,245,221,-24
"2ae94c0cea4d480a9d5dca8fb1d7b542","f53da5fd9bfe412da4b80d4742563b6c",22850542,1,-3,0,955,242,241,-1
"f53da5fd9bfe412da4b80d4742563b6c","f53da5fd9bfe412da4b80d4742563b6c",22850542,1,0,1,956,241,241,0
"f53da5fd9bfe412da4b80d4742563b6c","0c7262dff33c4087bc660ccf40f92f9c",22850542,1,-94,0,957,241,169,-72
"0c7262dff33c4087bc660ccf40f92f9c","01b2051f8941460d89945e3b02d1ce78",22850542,1,63,0,958,169,217,48
"01b2051f8941460d89945e3b02d1ce78","d7f13c8d63ec4e2aa673fbb9cf9c6933",22850542,1,-14,0,959,217,206,-11
"01b2051f8941460d89945e3b02d1ce78","0c7262dff33c4087bc660ccf40f92f9c",22850542,1,-63,0,974,217,169,-48
"0c7262dff33c4087bc660ccf40f92f9c","f7906d6f59b9489a91d2ef40db5a474d",22850542,1,73,0,975,169,223,54
"f7906d6f59b9489a91d2ef40db5a474d","1c6721b1f63f4d30ba7746ea8af02a52",22850542,1,-3,0,976,223,221,-2
"d03cb855c70044cf8c35d9ec0de696e3","d03cb855c70044cf8c35d9ec0de696e3",22850542,1,0,1,979,224,224,0
"d03cb855c70044cf8c35d9ec0de696e3","f7906d6f59b9489a91d2ef40db5a474d",22850542,1,-1,0,980,224,223,-1
"2ab1535aac1346ba8801535bf729ef37","0c7262dff33c4087bc660ccf40f92f9c",22850542,1,-80,0,982,229,169,-60
"0c7262dff33c4087bc660ccf40f92f9c","2ae94c0cea4d480a9d5dca8fb1d7b542",22850542,1,97,0,983,169,242,73
"1ebf23f9d994469a85206e4c7b1bf5f5","1ebf23f9d994469a85206e4c7b1bf5f5",22850542,10,0,1,986,245,245,0
"1ebf23f9d994469a85206e4c7b1bf5f5","85ae675b83e8422da842cfd25596af99",22850542,1,1,0,996,245,246,1
"85ae675b83e8422da842cfd25596af99","85ae675b83e8422da842cfd25596af99",22850542,1,0,1,997,246,246,0
"85ae675b83e8422da842cfd25596af99","2ae94c0cea4d480a9d5dca8fb1d7b542",22850542,1,-4,0,998,246,242,-4
"2ae94c0cea4d480a9d5dca8fb1d7b542","30c9ba177afc49a695625d2bdec40207",22850542,1,9,0,999,242,250,8
"30c9ba177afc49a695625d2bdec40207","30c9ba177afc49a695625d2bdec40207",22850542,2,0,1,1000,250,250,0
"30c9ba177afc49a695625d2bdec40207","6e83e23f56544a19b94067c1c558d9c0",22850542,1,-3,0,1002,250,247,-3
"6e83e23f56544a19b94067c1c558d9c0","00f61990949545828dd12f1303d47504",22850542,1,11,0,1003,247,256,9
"00f61990949545828dd12f1303d47504","00f61990949545828dd12f1303d47504",22850542,2,0,1,1004,256,256,0
"00f61990949545828dd12f1303d47504","ead7bb4b64e247d2ae632ab8a296b091",22850542,1,2,0,1006,256,258,2
"ead7bb4b64e247d2ae632ab8a296b091","ead7bb4b64e247d2ae632ab8a296b091",22850542,2,0,1,1007,258,258,0
"ead7bb4b64e247d2ae632ab8a296b091","41b0048dde734bb280bac6116baa8e27",22850542,1,1,0,1009,258,259,1
"41b0048dde734bb280bac6116baa8e27","41b0048dde734bb280bac6116baa8e27",22850542,2,0,1,1010,259,259,0
"41b0048dde734bb280bac6116baa8e27","b41c5a094a604ee0915327da5cc0beb7",22850542,1,1,0,1012,259,260,1
"b41c5a094a604ee0915327da5cc0beb7","b41c5a094a604ee0915327da5cc0beb7",22850542,2,0,1,1013,260,260,0
"b41c5a094a604ee0915327da5cc0beb7","d546341988904f069cfa86b21457d9d9",22850542,1,-10,0,1015,260,251,-9
"d546341988904f069cfa86b21457d9d9","28c171777c52431ab6b925073bd63d46",22850542,1,15,0,1016,251,264,13
"28c171777c52431ab6b925073bd63d46","28c171777c52431ab6b925073bd63d46",22850542,7,0,1,1017,264,264,0
"28c171777c52431ab6b925073bd63d46","ac160db940cb49ae8579162b1d52bb5d",22850542,1,2,0,1024,264,266,2
"ac160db940cb49ae8579162b1d52bb5d","ac160db940cb49ae8579162b1d52bb5d",22850542,7,0,1,1025,266,266,0
"ac160db940cb49ae8579162b1d52bb5d","d989ebcfc12a4b669f0100dc1aa14f1e",22850542,1,-12,0,1032,266,255,-11
"d989ebcfc12a4b669f0100dc1aa14f1e","c6fd49b485cc4874b0bbdd9c6171e09c",22850542,1,15,0,1033,255,268,13
"c6fd49b485cc4874b0bbdd9c6171e09c","c6fd49b485cc4874b0bbdd9c6171e09c",22850542,3,0,1,1034,268,268,0
"c6fd49b485cc4874b0bbdd9c6171e09c","44240778a97c4af0937817499b75707b",22850542,1,1,0,1037,268,269,1
"44240778a97c4af0937817499b75707b","44240778a97c4af0937817499b75707b",22850542,2,0,1,1038,269,269,0
"44240778a97c4af0937817499b75707b","7aa76d3e993840d8805f097cbdbcd44b",22850542,1,-9,0,1040,269,261,-8
"7aa76d3e993840d8805f097cbdbcd44b","865a4d3b43374da7944dc7d397f566d9",22850542,1,12,0,1041,261,271,10
"865a4d3b43374da7944dc7d397f566d9","865a4d3b43374da7944dc7d397f566d9",22850542,1,0,1,1042,271,271,0
"865a4d3b43374da7944dc7d397f566d9","2ae94c0cea4d480a9d5dca8fb1d7b542",22850542,1,-35,0,1043,271,242,-29
"2ae94c0cea4d480a9d5dca8fb1d7b542","0d987bed3ffa4ed0b9a2e62e97b7b30f",22850542,1,38,0,1044,242,272,30
"0d987bed3ffa4ed0b9a2e62e97b7b30f","0d987bed3ffa4ed0b9a2e62e97b7b30f",22850542,1,0,1,1045,272,272,0
"0d987bed3ffa4ed0b9a2e62e97b7b30f","82ae07bc0c9b4570a41799290d1ef399",22850542,7,4,0,1046,272,275,3
"82ae07bc0c9b4570a41799290d1ef399","bb5a47f5ea01454a8b79455422d3b9da",22850542,2,6,0,1047,275,280,5
"bb5a47f5ea01454a8b79455422d3b9da","bb5a47f5ea01454a8b79455422d3b9da",22850542,79,0,1,1048,280,280,0
"bb5a47f5ea01454a8b79455422d3b9da","94cecc3f1e7d484b8e068e79241dfd73",22850542,1,3,0,1050,280,281,1
"94cecc3f1e7d484b8e068e79241dfd73","0d987bed3ffa4ed0b9a2e62e97b7b30f",22850542,2,-13,0,1051,281,272,-9
"0d987bed3ffa4ed0b9a2e62e97b7b30f","bb5a47f5ea01454a8b79455422d3b9da",22850542,3,10,0,1052,272,280,8
"bb5a47f5ea01454a8b79455422d3b9da","a37477c4e4c14169ad44b06b493007f6",22850542,1,5,0,1057,280,283,3
"a37477c4e4c14169ad44b06b493007f6","94cecc3f1e7d484b8e068e79241dfd73",22850542,4,-2,0,1058,283,281,-2
"94cecc3f1e7d484b8e068e79241dfd73","a37477c4e4c14169ad44b06b493007f6",22850542,3,2,0,1059,281,283,2
"bb5a47f5ea01454a8b79455422d3b9da","bc5524e78a8544e2ae2fdc2f3462bbec",22850542,1,-1,0,1072,280,279,-1
"bc5524e78a8544e2ae2fdc2f3462bbec","82ae07bc0c9b4570a41799290d1ef399",22850542,1,-5,0,1073,279,275,-4
"82ae07bc0c9b4570a41799290d1ef399","0d987bed3ffa4ed0b9a2e62e97b7b30f",22850542,6,-4,0,1074,275,272,-3
"bb5a47f5ea01454a8b79455422d3b9da","0d987bed3ffa4ed0b9a2e62e97b7b30f",22850542,1,-10,0,1144,280,272,-8
"0d987bed3ffa4ed0b9a2e62e97b7b30f","94cecc3f1e7d484b8e068e79241dfd73",22850542,1,13,0,1145,272,281,9
"94cecc3f1e7d484b8e068e79241dfd73","fab84b4fab5940efb4ea868ef8d09396",22850542,1,5,0,1148,281,284,3
"fab84b4fab5940efb4ea868ef8d09396","4a29443515bb404cb8924e1c60a63b73",22850542,1,4,0,1149,284,285,1
"4a29443515bb404cb8924e1c60a63b73","fab84b4fab5940efb4ea868ef8d09396",22850542,1,-4,0,1150,285,284,-1
"fab84b4fab5940efb4ea868ef8d09396","208c9b2796c944db8dacaa96082520ea",22850542,1,7,0,1151,284,288,4
"208c9b2796c944db8dacaa96082520ea","4a29443515bb404cb8924e1c60a63b73",22850542,2,-3,0,1152,288,285,-3
"4a29443515bb404cb8924e1c60a63b73","4a29443515bb404cb8924e1c60a63b73",22850542,2,0,1,1153,285,285,0
"4a29443515bb404cb8924e1c60a63b73","208c9b2796c944db8dacaa96082520ea",22850542,1,3,0,1155,285,288,3
"208c9b2796c944db8dacaa96082520ea","208c9b2796c944db8dacaa96082520ea",22850542,6,0,1,1156,288,288,0
"4a29443515bb404cb8924e1c60a63b73","7669a956527947d0add87455277e80b4",22850542,1,7,0,1163,285,291,6
"7669a956527947d0add87455277e80b4","7669a956527947d0add87455277e80b4",22850542,1,0,1,1164,291,291,0
"7669a956527947d0add87455277e80b4","6a9a3b5bde4a48daa896fe8c06eca56f",22850542,1,-2,0,1165,291,289,-2
"6a9a3b5bde4a48daa896fe8c06eca56f","869e967078f04da18dd0b0b9389a7424",22850542,1,5,0,1166,289,293,4
"869e967078f04da18dd0b0b9389a7424","869e967078f04da18dd0b0b9389a7424",22850542,4,0,1,1167,293,293,0
"869e967078f04da18dd0b0b9389a7424","51ab6291537748fab90d519aa09889d6",22850542,1,2,0,1171,293,295,2
"51ab6291537748fab90d519aa09889d6","51ab6291537748fab90d519aa09889d6",22850542,5,0,1,1172,295,295,0
"51ab6291537748fab90d519aa09889d6","34a6e49023fc4465bd5ca604330bbd1c",22850542,1,-3,0,1177,295,292,-3
"34a6e49023fc4465bd5ca604330bbd1c","21592f2a9e9c4b2f8c66ec5dbcbf6a2b",22850542,1,5,0,1178,292,296,4
"21592f2a9e9c4b2f8c66ec5dbcbf6a2b","ba0e59461bfb4a44b7b1c28a01f8d3b3",22850542,1,4,0,1179,296,299,3
"ba0e59461bfb4a44b7b1c28a01f8d3b3","ba0e59461bfb4a44b7b1c28a01f8d3b3",22850542,2,0,1,1180,299,299,0
"ba0e59461bfb4a44b7b1c28a01f8d3b3","0e0b36e731a645e7b1b8a88f5031ca38",22850542,1,2,0,1182,299,301,2
"0e0b36e731a645e7b1b8a88f5031ca38","0e0b36e731a645e7b1b8a88f5031ca38",22850542,2,0,1,1183,301,301,0
"0e0b36e731a645e7b1b8a88f5031ca38","a66a144637284c21afc6de17fea4bfb8",22850542,1,1,0,1185,301,302,1
"a66a144637284c21afc6de17fea4bfb8","a66a144637284c21afc6de17fea4bfb8",22850542,2,0,1,1186,302,302,0
"a66a144637284c21afc6de17fea4bfb8","7646a919d7e64fa990bca9b024ff089d",22850542,1,-4,0,1188,302,298,-4
"7646a919d7e64fa990bca9b024ff089d","e390b575229748ea8aac9364efe2bf00",22850542,1,7,0,1189,298,304,6
"e390b575229748ea8aac9364efe2bf00","e390b575229748ea8aac9364efe2bf00",22850542,1,0,1,1190,304,304,0
"e390b575229748ea8aac9364efe2bf00","4a29443515bb404cb8924e1c60a63b73",22850542,1,-24,0,1191,304,285,-19
"4a29443515bb404cb8924e1c60a63b73","3434c10e561d488a914e0f7d71907abd",22850542,1,27,0,1192,285,305,20
"3434c10e561d488a914e0f7d71907abd","53e7e900392747ccad52e711ab0f80d8",22850542,1,2,0,1193,305,307,2
"53e7e900392747ccad52e711ab0f80d8","53e7e900392747ccad52e711ab0f80d8",22850542,2,0,1,1194,307,307,0
"53e7e900392747ccad52e711ab0f80d8","3434c10e561d488a914e0f7d71907abd",22850542,1,-2,0,1196,307,305,-2
"3434c10e561d488a914e0f7d71907abd","130acc2aeb0448fdbb2de63bc5cebe5b",22850542,1,5,0,1197,305,309,4
"130acc2aeb0448fdbb2de63bc5cebe5b","130acc2aeb0448fdbb2de63bc5cebe5b",22850542,5,0,1,1198,309,309,0
"130acc2aeb0448fdbb2de63bc5cebe5b","9c062b3251034ebe90f5054e2a3b5120",22850542,1,2,0,1203,309,311,2
"9c062b3251034ebe90f5054e2a3b5120","9c062b3251034ebe90f5054e2a3b5120",22850542,2,0,1,1204,311,311,0
"9c062b3251034ebe90f5054e2a3b5120","ea859f8207e44537889daeaba13ac2e8",22850542,1,1,0,1206,311,312,1
"ea859f8207e44537889daeaba13ac2e8","ea859f8207e44537889daeaba13ac2e8",22850542,1,0,1,1207,312,312,0
"ea859f8207e44537889daeaba13ac2e8","56d94971a7a94257aa330183a8ebd0ea",22850542,1,1,0,1208,312,313,1
"56d94971a7a94257aa330183a8ebd0ea","56d94971a7a94257aa330183a8ebd0ea",22850542,1,0,1,1209,313,313,0
"56d94971a7a94257aa330183a8ebd0ea","141c0df6cd1946539aadd1c9b7068cd4",22850542,1,-5,0,1210,313,308,-5
"141c0df6cd1946539aadd1c9b7068cd4","13255e63e0aa4abf85e5211bf613d43e",22850542,1,10,0,1211,308,317,9
"13255e63e0aa4abf85e5211bf613d43e","13255e63e0aa4abf85e5211bf613d43e",22850542,2,0,1,1212,317,317,0
"13255e63e0aa4abf85e5211bf613d43e","0c787d16c9504873b1a4d903cec09948",22850542,1,-3,0,1214,317,314,-3
"0c787d16c9504873b1a4d903cec09948","86c27d40179e419c8e9d150fb6afa5d0",22850542,1,6,0,1215,314,319,5
"86c27d40179e419c8e9d150fb6afa5d0","86c27d40179e419c8e9d150fb6afa5d0",22850542,1,0,1,1216,319,319,0
"86c27d40179e419c8e9d150fb6afa5d0","24f1363179ad4aaa965484a78471912b",22850542,1,5,0,1217,319,323,4
"24f1363179ad4aaa965484a78471912b","47edbb64109243e6b0f8f64cdef90c6c",22850542,1,3,0,1218,323,326,3
"47edbb64109243e6b0f8f64cdef90c6c","8d7e0b55cf9849cda222a0f2440cec55",22850542,1,-9,0,1219,326,318,-8
"8d7e0b55cf9849cda222a0f2440cec55","24f1363179ad4aaa965484a78471912b",22850542,1,6,0,1220,318,323,5
"24f1363179ad4aaa965484a78471912b","3628bdce1dd2429ba924d2d4d09448d2",22850542,1,-1,0,1221,323,322,-1
"3628bdce1dd2429ba924d2d4d09448d2","56b3fd1a212a4764be39d979fde3326e",22850542,1,7,0,1222,322,328,6
"56b3fd1a212a4764be39d979fde3326e","56b3fd1a212a4764be39d979fde3326e",22850542,1,0,1,1223,328,328,0
"56b3fd1a212a4764be39d979fde3326e","0c4079457ede49e3aeb5e86ed84bdf35",22850542,1,3,0,1224,328,329,1
"0c4079457ede49e3aeb5e86ed84bdf35","3434c10e561d488a914e0f7d71907abd",22850542,1,-31,0,1225,329,305,-24
"3434c10e561d488a914e0f7d71907abd","38aea304b4fa46e1b29bb72f5cea4c93",22850542,1,33,0,1226,305,331,26
"38aea304b4fa46e1b29bb72f5cea4c93","38aea304b4fa46e1b29bb72f5cea4c93",22850542,2,0,1,1227,331,331,0
"38aea304b4fa46e1b29bb72f5cea4c93","e36d261332f14e79bb4b467aceaeb9b5",22850542,1,2,0,1229,331,333,2
"e36d261332f14e79bb4b467aceaeb9b5","e36d261332f14e79bb4b467aceaeb9b5",22850542,1,0,1,1230,333,333,0
"e36d261332f14e79bb4b467aceaeb9b5","c7e89b9d04744d2eab742fc24e3ef1ae",22850542,1,1,0,1231,333,334,1
"c7e89b9d04744d2eab742fc24e3ef1ae","c7e89b9d04744d2eab742fc24e3ef1ae",22850542,2,0,1,1232,334,334,0
"c7e89b9d04744d2eab742fc24e3ef1ae","fe49f8054b374a0ea4bb266ed135ff62",22850542,1,1,0,1234,334,335,1
"fe49f8054b374a0ea4bb266ed135ff62","fe49f8054b374a0ea4bb266ed135ff62",22850542,2,0,1,1235,335,335,0
"fe49f8054b374a0ea4bb266ed135ff62","d0a8f74af98642fe8360d22c42e45117",22850542,1,1,0,1237,335,336,1
"d0a8f74af98642fe8360d22c42e45117","d0a8f74af98642fe8360d22c42e45117",22850542,2,0,1,1238,336,336,0
"d0a8f74af98642fe8360d22c42e45117","0c4079457ede49e3aeb5e86ed84bdf35",22850542,1,-7,0,1240,336,329,-7
"0c4079457ede49e3aeb5e86ed84bdf35","a7c6339ca1da4368a18d471f0519f877",22850542,1,11,0,1241,329,339,10
"a7c6339ca1da4368a18d471f0519f877","a7c6339ca1da4368a18d471f0519f877",22850542,1,0,1,1242,339,339,0
"a7c6339ca1da4368a18d471f0519f877","b8b9418ab322418d9db9b40d96af873a",22850542,1,-2,0,1243,339,337,-2
"b8b9418ab322418d9db9b40d96af873a","bbc5139ca9024389a94db3a6f47dcff6",22850542,1,5,0,1244,337,341,4
"bbc5139ca9024389a94db3a6f47dcff6","bbc5139ca9024389a94db3a6f47dcff6",22850542,1,0,1,1245,341,341,0
"bbc5139ca9024389a94db3a6f47dcff6","4ee6ca9019ab4a1ab323f98094a9bd77",22850542,1,2,0,1246,341,343,2
"4ee6ca9019ab4a1ab323f98094a9bd77","4ee6ca9019ab4a1ab323f98094a9bd77",22850542,2,0,1,1247,343,343,0
"4ee6ca9019ab4a1ab323f98094a9bd77","b37947176785476f8b29d49a851366dc",22850542,1,1,0,1249,343,344,1
"b37947176785476f8b29d49a851366dc","b37947176785476f8b29d49a851366dc",22850542,2,0,1,1250,344,344,0
"b37947176785476f8b29d49a851366dc","fcea5b10d5a14a3b9324ffece8f6e1e5",22850542,1,1,0,1252,344,345,1
"fcea5b10d5a14a3b9324ffece8f6e1e5","fcea5b10d5a14a3b9324ffece8f6e1e5",22850542,2,0,1,1253,345,345,0
"fcea5b10d5a14a3b9324ffece8f6e1e5","c2490bc612d146edbe786556fab3651b",22850542,1,-5,0,1255,345,340,-5
"c2490bc612d146edbe786556fab3651b","6ac8bb048b854999a47edb35fe627f11",22850542,1,8,0,1256,340,347,7
"6ac8bb048b854999a47edb35fe627f11","6ac8bb048b854999a47edb35fe627f11",22850542,1,0,1,1257,347,347,0
"6ac8bb048b854999a47edb35fe627f11","30ead9794d4847abaf222ca966cc8630",22850542,1,3,0,1258,347,348,1
"30ead9794d4847abaf222ca966cc8630","0c4079457ede49e3aeb5e86ed84bdf35",22850542,1,-24,0,1259,348,329,-19
"0c4079457ede49e3aeb5e86ed84bdf35","eff0de7f2dbb42dfa1a2e686efab5b6d",22850542,1,30,0,1260,329,354,25
"eff0de7f2dbb42dfa1a2e686efab5b6d","c20993c944444fe085345591a8bd837e",22850542,1,-3,0,1261,354,351,-3
"c20993c944444fe085345591a8bd837e","897b7f51242c44aab2205c72fdcbf4cd",22850542,1,1,0,1262,351,352,1
"897b7f51242c44aab2205c72fdcbf4cd","09b9678ddc3d452ea4a3d46e15826065",22850542,1,1,0,1263,352,353,1
"09b9678ddc3d452ea4a3d46e15826065","897b7f51242c44aab2205c72fdcbf4cd",22850542,1,-1,0,1264,353,352,-1
"897b7f51242c44aab2205c72fdcbf4cd","897b7f51242c44aab2205c72fdcbf4cd",22850542,3,0,1,1265,352,352,0
"897b7f51242c44aab2205c72fdcbf4cd","c20993c944444fe085345591a8bd837e",22850542,1,-1,0,1268,352,351,-1
"c20993c944444fe085345591a8bd837e","c20993c944444fe085345591a8bd837e",22850542,3,0,1,1269,351,351,0
"c20993c944444fe085345591a8bd837e","09b9678ddc3d452ea4a3d46e15826065",22850542,1,2,0,1272,351,353,2
"09b9678ddc3d452ea4a3d46e15826065","09b9678ddc3d452ea4a3d46e15826065",22850542,3,0,1,1273,353,353,0
"09b9678ddc3d452ea4a3d46e15826065","eff0de7f2dbb42dfa1a2e686efab5b6d",22850542,1,1,0,1276,353,354,1
"eff0de7f2dbb42dfa1a2e686efab5b6d","eff0de7f2dbb42dfa1a2e686efab5b6d",22850542,3,0,1,1277,354,354,0
"eff0de7f2dbb42dfa1a2e686efab5b6d","30ead9794d4847abaf222ca966cc8630",22850542,1,-6,0,1280,354,348,-6
"30ead9794d4847abaf222ca966cc8630","2fe14166dc9642c3bc666b86a57f943d",22850542,1,10,0,1281,348,357,9
"2fe14166dc9642c3bc666b86a57f943d","2fe14166dc9642c3bc666b86a57f943d",22850542,2,0,1,1282,357,357,0
"2fe14166dc9642c3bc666b86a57f943d","44421dd1e13a47a388c4a19834b744c7",22850542,1,2,0,1284,357,359,2
"44421dd1e13a47a388c4a19834b744c7","44421dd1e13a47a388c4a19834b744c7",22850542,2,0,1,1285,359,359,0
"44421dd1e13a47a388c4a19834b744c7","cb5fc7ef85d547c4be1a7439d0bf6052",22850542,1,1,0,1287,359,360,1
"cb5fc7ef85d547c4be1a7439d0bf6052","cb5fc7ef85d547c4be1a7439d0bf6052",22850542,2,0,1,1288,360,360,0
"cb5fc7ef85d547c4be1a7439d0bf6052","0a8f150a4cf747acbde62f4721823da3",22850542,1,1,0,1290,360,361,1
"0a8f150a4cf747acbde62f4721823da3","0a8f150a4cf747acbde62f4721823da3",22850542,2,0,1,1291,361,361,0
"0a8f150a4cf747acbde62f4721823da3","ab8fdad974ae471f9f24c3f9dd04462e",22850542,1,1,0,1293,361,362,1
"ab8fdad974ae471f9f24c3f9dd04462e","ab8fdad974ae471f9f24c3f9dd04462e",22850542,2,0,1,1294,362,362,0
"ab8fdad974ae471f9f24c3f9dd04462e","1ba8fef685d74a8194b9db252eb704fb",22850542,1,-7,0,1296,362,355,-7
"1ba8fef685d74a8194b9db252eb704fb","52580888dadb4fe3baa795683ea227bd",22850542,1,10,0,1297,355,364,9
"52580888dadb4fe3baa795683ea227bd","52580888dadb4fe3baa795683ea227bd",22850542,1,0,1,1298,364,364,0
"52580888dadb4fe3baa795683ea227bd","f00179e251a045b39c3f7a54f9aa4acc",22850542,1,-1,0,1299,364,363,-1
"f00179e251a045b39c3f7a54f9aa4acc","492a3bc6a1254f23a7998587961b22a4",22850542,1,4,0,1300,363,366,3
"492a3bc6a1254f23a7998587961b22a4","492a3bc6a1254f23a7998587961b22a4",22850542,1,0,1,1301,366,366,0
"492a3bc6a1254f23a7998587961b22a4","072a190fd302456290895f9f04d6940a",22850542,1,-1,0,1302,366,365,-1
"072a190fd302456290895f9f04d6940a","30ead9794d4847abaf222ca966cc8630",22850542,1,-20,0,1303,365,348,-17
"30ead9794d4847abaf222ca966cc8630","b71bac264efb4abd97015447bd490db6",22850542,3,28,0,1304,348,370,22
"b71bac264efb4abd97015447bd490db6","30ead9794d4847abaf222ca966cc8630",22850542,1,-28,0,1305,370,348,-22
"b71bac264efb4abd97015447bd490db6","cfa457d1743848e4bb5e4beced6448ed",22850542,1,-3,0,1307,370,369,-1
"cfa457d1743848e4bb5e4beced6448ed","cfa457d1743848e4bb5e4beced6448ed",22850542,1,0,1,1308,369,369,0
"cfa457d1743848e4bb5e4beced6448ed","30ead9794d4847abaf222ca966cc8630",22850542,1,-25,0,1309,369,348,-21
"b71bac264efb4abd97015447bd490db6","4a29443515bb404cb8924e1c60a63b73",22850542,1,-110,0,1311,370,285,-85
"4a29443515bb404cb8924e1c60a63b73","b2f0d654738f48158edff28e8d3a546e",22850542,1,234,0,1312,285,449,164
"b2f0d654738f48158edff28e8d3a546e","b2f0d654738f48158edff28e8d3a546e",22850542,5,0,1,1313,449,449,0
"b2f0d654738f48158edff28e8d3a546e","b71bac264efb4abd97015447bd490db6",22850542,1,-124,0,1314,449,370,-79
"b71bac264efb4abd97015447bd490db6","b71bac264efb4abd97015447bd490db6",22850542,2,0,1,1315,370,370,0
"b71bac264efb4abd97015447bd490db6","bc5524e78a8544e2ae2fdc2f3462bbec",22850542,1,-123,0,1316,370,279,-91
"bc5524e78a8544e2ae2fdc2f3462bbec","0d987bed3ffa4ed0b9a2e62e97b7b30f",22850542,1,-9,0,1317,279,272,-7
"bb5a47f5ea01454a8b79455422d3b9da","0c7262dff33c4087bc660ccf40f92f9c",22850542,1,-145,0,1328,280,169,-111
"0c7262dff33c4087bc660ccf40f92f9c","b71bac264efb4abd97015447bd490db6",22850542,1,267,0,1329,169,370,201
"b71bac264efb4abd97015447bd490db6","8d448d625b024c82a5eb240bbd7431d6",22850542,4,5,0,1331,370,374,4
"8d448d625b024c82a5eb240bbd7431d6","8d448d625b024c82a5eb240bbd7431d6",22850542,67,0,1,1332,374,374,0
"8d448d625b024c82a5eb240bbd7431d6","b71bac264efb4abd97015447bd490db6",22850542,3,-5,0,1339,374,370,-4
"8d448d625b024c82a5eb240bbd7431d6","1b4550d0dab04078b3bf08a655345bdc",22850542,1,-1,0,1353,374,373,-1
"1b4550d0dab04078b3bf08a655345bdc","8d448d625b024c82a5eb240bbd7431d6",22850542,1,1,0,1354,373,374,1
"8d448d625b024c82a5eb240bbd7431d6","d6d02b6ef04e4f17805504500b8ce441",22850542,1,3,0,1396,374,375,1
"d6d02b6ef04e4f17805504500b8ce441","b71bac264efb4abd97015447bd490db6",22850542,1,-8,0,1397,375,370,-5
"b71bac264efb4abd97015447bd490db6","d6d02b6ef04e4f17805504500b8ce441",22850542,2,8,0,1398,370,375,5
"d6d02b6ef04e4f17805504500b8ce441","d6d02b6ef04e4f17805504500b8ce441",22850542,8,0,1,1399,375,375,0
"d6d02b6ef04e4f17805504500b8ce441","66baf19b6b904b70922329068c63746d",22850542,1,4,0,1400,375,376,1
"66baf19b6b904b70922329068c63746d","7f544639412e40a9ba27f43b415362ab",22850542,1,2,0,1401,376,378,2
"7f544639412e40a9ba27f43b415362ab","7f544639412e40a9ba27f43b415362ab",22850542,1,0,1,1402,378,378,0
"7f544639412e40a9ba27f43b415362ab","d5ae8642e15b46b8bd298b02274d4e9c",22850542,1,2,0,1403,378,380,2
"d5ae8642e15b46b8bd298b02274d4e9c","d5ae8642e15b46b8bd298b02274d4e9c",22850542,7,0,1,1404,380,380,0
"d5ae8642e15b46b8bd298b02274d4e9c","a0d10309a2dd456289147f84be9d37f9",22850542,1,1,0,1411,380,381,1
"a0d10309a2dd456289147f84be9d37f9","a0d10309a2dd456289147f84be9d37f9",22850542,2,0,1,1412,381,381,0
"a0d10309a2dd456289147f84be9d37f9","0fcbc3ca07b144138b8d85da581f09a8",22850542,1,1,0,1414,381,382,1
"0fcbc3ca07b144138b8d85da581f09a8","0fcbc3ca07b144138b8d85da581f09a8",22850542,2,0,1,1415,382,382,0
"0fcbc3ca07b144138b8d85da581f09a8","66baf19b6b904b70922329068c63746d",22850542,1,-6,0,1417,382,376,-6
"66baf19b6b904b70922329068c63746d","4890121ce5d74576b4632b77cfc23398",22850542,1,14,0,1418,376,388,12
"4890121ce5d74576b4632b77cfc23398","c2fca3669923477ab966ded303dea31c",22850542,1,-6,0,1419,388,383,-5
"c2fca3669923477ab966ded303dea31c","4890121ce5d74576b4632b77cfc23398",22850542,1,6,0,1420,383,388,5
"4890121ce5d74576b4632b77cfc23398","18d3b836dd804224883cc9180b60a8e1",22850542,1,-1,0,1421,388,387,-1
"18d3b836dd804224883cc9180b60a8e1","96bb2b3e85a34d8b9544514e89f6fe97",22850542,1,4,0,1422,387,390,3
"96bb2b3e85a34d8b9544514e89f6fe97","96bb2b3e85a34d8b9544514e89f6fe97",22850542,1,0,1,1423,390,390,0
"96bb2b3e85a34d8b9544514e89f6fe97","ac4e9b54acfe4670b4634859c7263cb5",22850542,1,2,0,1424,390,392,2
"ac4e9b54acfe4670b4634859c7263cb5","ac4e9b54acfe4670b4634859c7263cb5",22850542,1,0,1,1425,392,392,0
"ac4e9b54acfe4670b4634859c7263cb5","6f8881a745ac4c358a68b92c3b4abe81",22850542,1,3,0,1426,392,394,2
"6f8881a745ac4c358a68b92c3b4abe81","17f95d18bab743888e1736033dc3384d",22850542,1,-6,0,1427,394,389,-5
"17f95d18bab743888e1736033dc3384d","6f8881a745ac4c358a68b92c3b4abe81",22850542,1,6,0,1428,389,394,5
"6f8881a745ac4c358a68b92c3b4abe81","6f8881a745ac4c358a68b92c3b4abe81",22850542,1,0,1,1429,394,394,0
"6f8881a745ac4c358a68b92c3b4abe81","f7002c8484354eceac57bc7bd62c76c1",22850542,1,-1,0,1430,394,393,-1
"f7002c8484354eceac57bc7bd62c76c1","44a277ea44dc4ae689fab4b82f0b4098",22850542,1,5,0,1431,393,397,4
"44a277ea44dc4ae689fab4b82f0b4098","44a277ea44dc4ae689fab4b82f0b4098",22850542,1,0,1,1432,397,397,0
"44a277ea44dc4ae689fab4b82f0b4098","0c12af0a4e7f4002852cf84b2537c161",22850542,1,-2,0,1433,397,395,-2
"0c12af0a4e7f4002852cf84b2537c161","859e0b8d71694b12befb69ee698138f9",22850542,1,5,0,1434,395,399,4
"859e0b8d71694b12befb69ee698138f9","859e0b8d71694b12befb69ee698138f9",22850542,1,0,1,1435,399,399,0
"859e0b8d71694b12befb69ee698138f9","66baf19b6b904b70922329068c63746d",22850542,1,-29,0,1436,399,376,-23
"66baf19b6b904b70922329068c63746d","2b09a08242b54983aec7063990fb3f66",22850542,1,32,0,1437,376,400,24
"2b09a08242b54983aec7063990fb3f66","2b09a08242b54983aec7063990fb3f66",22850542,2,0,1,1438,400,400,0
"2b09a08242b54983aec7063990fb3f66","1f471b7a883a4df48211e8c6a81b59a7",22850542,1,1,0,1440,400,401,1
"1f471b7a883a4df48211e8c6a81b59a7","1f471b7a883a4df48211e8c6a81b59a7",22850542,1,0,1,1441,401,401,0
"1f471b7a883a4df48211e8c6a81b59a7","2b09a08242b54983aec7063990fb3f66",22850542,1,-1,0,1442,401,400,-1
"2b09a08242b54983aec7063990fb3f66","9de0d567bfa84fe5b77cb76f4a76a5d1",22850542,1,5,0,1443,400,404,4
"9de0d567bfa84fe5b77cb76f4a76a5d1","9de0d567bfa84fe5b77cb76f4a76a5d1",22850542,1,0,1,1444,404,404,0
"9de0d567bfa84fe5b77cb76f4a76a5d1","1157bd665ec4472fb58b751dc5099355",22850542,1,-1,0,1445,404,403,-1
"1157bd665ec4472fb58b751dc5099355","3c8a22d2f9c146ea956609e3ed4f2559",22850542,1,3,0,1446,403,405,2
"3c8a22d2f9c146ea956609e3ed4f2559","58fc9094275e4c49be3f4ba6d4acc0a4",22850542,1,2,0,1447,405,406,1
"58fc9094275e4c49be3f4ba6d4acc0a4","58fc9094275e4c49be3f4ba6d4acc0a4",22850542,1,0,1,1448,406,406,0
"58fc9094275e4c49be3f4ba6d4acc0a4","c1c1be90b2b14c1ab4a5e1ee3c241902",22850542,1,1,0,1449,406,407,1
"c1c1be90b2b14c1ab4a5e1ee3c241902","c1c1be90b2b14c1ab4a5e1ee3c241902",22850542,5,0,1,1450,407,407,0
"c1c1be90b2b14c1ab4a5e1ee3c241902","58fc9094275e4c49be3f4ba6d4acc0a4",22850542,1,-1,0,1455,407,406,-1
"58fc9094275e4c49be3f4ba6d4acc0a4","02b3a1bead9244c1ba2f857c7da8f82a",22850542,1,3,0,1456,406,408,2
"02b3a1bead9244c1ba2f857c7da8f82a","02b3a1bead9244c1ba2f857c7da8f82a",22850542,2,0,1,1457,408,408,0
"02b3a1bead9244c1ba2f857c7da8f82a","6206fc6479014bb193084c32409dc1b9",22850542,1,1,0,1459,408,409,1
"6206fc6479014bb193084c32409dc1b9","6206fc6479014bb193084c32409dc1b9",22850542,1,0,1,1460,409,409,0
"6206fc6479014bb193084c32409dc1b9","02b3a1bead9244c1ba2f857c7da8f82a",22850542,1,-1,0,1461,409,408,-1
"02b3a1bead9244c1ba2f857c7da8f82a","6a5f020451db426dacba9e2ea3fcc62a",22850542,1,3,0,1462,408,410,2
"6a5f020451db426dacba9e2ea3fcc62a","6a5f020451db426dacba9e2ea3fcc62a",22850542,3,0,1,1463,410,410,0
"6a5f020451db426dacba9e2ea3fcc62a","33a9d248b2e44588a5b07fc1342b9bc2",22850542,1,2,0,1466,410,411,1
"33a9d248b2e44588a5b07fc1342b9bc2","33a9d248b2e44588a5b07fc1342b9bc2",22850542,2,0,1,1467,411,411,0
"33a9d248b2e44588a5b07fc1342b9bc2","c6f26bd420634f1cb7989e76fe6b16c0",22850542,1,1,0,1469,411,412,1
"c6f26bd420634f1cb7989e76fe6b16c0","c6f26bd420634f1cb7989e76fe6b16c0",22850542,5,0,1,1470,412,412,0
"c6f26bd420634f1cb7989e76fe6b16c0","2a65ee6e2ac64f6a8a55fbe5373ec763",22850542,1,1,0,1475,412,413,1
"2a65ee6e2ac64f6a8a55fbe5373ec763","2a65ee6e2ac64f6a8a55fbe5373ec763",22850542,2,0,1,1476,413,413,0
"2a65ee6e2ac64f6a8a55fbe5373ec763","33a9d248b2e44588a5b07fc1342b9bc2",22850542,1,-2,0,1478,413,411,-2
"33a9d248b2e44588a5b07fc1342b9bc2","1fd0f6dadbc14ebc965faf6122190b96",22850542,1,5,0,1479,411,415,4
"1fd0f6dadbc14ebc965faf6122190b96","1fd0f6dadbc14ebc965faf6122190b96",22850542,1,0,1,1480,415,415,0
"1fd0f6dadbc14ebc965faf6122190b96","687055dad9fc40c3982478fe33ec01bf",22850542,1,-1,0,1481,415,414,-1
"687055dad9fc40c3982478fe33ec01bf","2add1669f08d4101913db15f8c23b3b7",22850542,1,3,0,1482,414,416,2
"2add1669f08d4101913db15f8c23b3b7","2add1669f08d4101913db15f8c23b3b7",22850542,1,0,1,1483,416,416,0
"2add1669f08d4101913db15f8c23b3b7","a2b4bd40cee2481ebd3fc179d6a5cd62",22850542,1,3,0,1484,416,417,1
"a2b4bd40cee2481ebd3fc179d6a5cd62","2b09a08242b54983aec7063990fb3f66",22850542,1,-27,0,1485,417,400,-17
"2b09a08242b54983aec7063990fb3f66","e34e59dce2204f228f3a84b6725df60f",22850542,1,29,0,1486,400,419,19
"e34e59dce2204f228f3a84b6725df60f","e34e59dce2204f228f3a84b6725df60f",22850542,1,0,1,1487,419,419,0
"e34e59dce2204f228f3a84b6725df60f","a2b4bd40cee2481ebd3fc179d6a5cd62",22850542,1,-2,0,1488,419,417,-2
"a2b4bd40cee2481ebd3fc179d6a5cd62","bec48fc2e1294c7eb3d0aca780d731b8",22850542,1,4,0,1489,417,420,3
"bec48fc2e1294c7eb3d0aca780d731b8","bec48fc2e1294c7eb3d0aca780d731b8",22850542,2,0,1,1490,420,420,0
"bec48fc2e1294c7eb3d0aca780d731b8","dbde19fcce2a4c1abdc7f685c293a23f",22850542,1,3,0,1492,420,422,2
"dbde19fcce2a4c1abdc7f685c293a23f","a24600b0e49245f6bdba8c893cfeddb0",22850542,1,4,0,1493,422,425,3
"a24600b0e49245f6bdba8c893cfeddb0","a24600b0e49245f6bdba8c893cfeddb0",22850542,2,0,1,1494,425,425,0
"a24600b0e49245f6bdba8c893cfeddb0","a2b4bd40cee2481ebd3fc179d6a5cd62",22850542,1,-11,0,1496,425,417,-8
"a2b4bd40cee2481ebd3fc179d6a5cd62","24cf8786024543f19b89bc20034e60d7",22850542,1,18,0,1497,417,428,11
"24cf8786024543f19b89bc20034e60d7","f2a73be2f46840b182d7bd095378004e",22850542,1,1,0,1498,428,429,1
"f2a73be2f46840b182d7bd095378004e","f2a73be2f46840b182d7bd095378004e",22850542,1,0,1,1499,429,429,0
"f2a73be2f46840b182d7bd095378004e","604551fd4266430cb860fef58fa7dd61",22850542,1,1,0,1500,429,430,1
"604551fd4266430cb860fef58fa7dd61","604551fd4266430cb860fef58fa7dd61",22850542,1,0,1,1501,430,430,0
"604551fd4266430cb860fef58fa7dd61","24cf8786024543f19b89bc20034e60d7",22850542,1,-2,0,1502,430,428,-2
"24cf8786024543f19b89bc20034e60d7","dce46f8904594a62a6377a3587aaa663",22850542,1,4,0,1503,428,431,3
"dce46f8904594a62a6377a3587aaa663","dce46f8904594a62a6377a3587aaa663",22850542,1,0,1,1504,431,431,0
"dce46f8904594a62a6377a3587aaa663","9b9d0a249052413c869753b99682b0ac",22850542,1,1,0,1505,431,432,1
"9b9d0a249052413c869753b99682b0ac","9b9d0a249052413c869753b99682b0ac",22850542,7,0,1,1506,432,432,0
"9b9d0a249052413c869753b99682b0ac","061c175cc90f45fbad883025394e78dd",22850542,1,1,0,1513,432,433,1
"061c175cc90f45fbad883025394e78dd","061c175cc90f45fbad883025394e78dd",22850542,1,0,1,1514,433,433,0
"061c175cc90f45fbad883025394e78dd","dce46f8904594a62a6377a3587aaa663",22850542,1,-2,0,1515,433,431,-2
"dce46f8904594a62a6377a3587aaa663","74a7f8712e5449c2bc0b43c6f90dafed",22850542,1,5,0,1516,431,435,4
"74a7f8712e5449c2bc0b43c6f90dafed","74a7f8712e5449c2bc0b43c6f90dafed",22850542,1,0,1,1517,435,435,0
"74a7f8712e5449c2bc0b43c6f90dafed","66ada10dde9f43018588f1ced9d477fc",22850542,1,-1,0,1518,435,434,-1
"66ada10dde9f43018588f1ced9d477fc","bf12c96466d840a69bed7020b3f18bb8",22850542,1,3,0,1519,434,436,2
"bf12c96466d840a69bed7020b3f18bb8","bf12c96466d840a69bed7020b3f18bb8",22850542,1,0,1,1520,436,436,0
"bf12c96466d840a69bed7020b3f18bb8","070600601c4c439288445d2f0724807d",22850542,1,3,0,1521,436,437,1
"070600601c4c439288445d2f0724807d","24cf8786024543f19b89bc20034e60d7",22850542,1,-14,0,1522,437,428,-9
"24cf8786024543f19b89bc20034e60d7","1823b6de7d334a7aaabc4570719af4d9",22850542,1,16,0,1523,428,439,11
"1823b6de7d334a7aaabc4570719af4d9","1823b6de7d334a7aaabc4570719af4d9",22850542,11,0,1,1524,439,439,0
"1823b6de7d334a7aaabc4570719af4d9","070600601c4c439288445d2f0724807d",22850542,1,-2,0,1535,439,437,-2
"070600601c4c439288445d2f0724807d","0380cd76a7d44bc3a4da1f15e4d68f89",22850542,1,4,0,1536,437,440,3
"0380cd76a7d44bc3a4da1f15e4d68f89","0380cd76a7d44bc3a4da1f15e4d68f89",22850542,2,0,1,1537,440,440,0
"0380cd76a7d44bc3a4da1f15e4d68f89","23b7673c8b5443108c2ef09382834a86",22850542,1,2,0,1539,440,441,1
"23b7673c8b5443108c2ef09382834a86","23b7673c8b5443108c2ef09382834a86",22850542,2,0,1,1540,441,441,0
"23b7673c8b5443108c2ef09382834a86","901e92500aea43c79f19f1b279050668",22850542,1,2,0,1542,441,442,1
"901e92500aea43c79f19f1b279050668","901e92500aea43c79f19f1b279050668",22850542,2,0,1,1543,442,442,0
"901e92500aea43c79f19f1b279050668","001339db8ced4cf78829ebe8b145449d",22850542,1,1,0,1545,442,443,1
"001339db8ced4cf78829ebe8b145449d","001339db8ced4cf78829ebe8b145449d",22850542,5,0,1,1546,443,443,0
"001339db8ced4cf78829ebe8b145449d","452745e0366e42ae81561bfddebcc6c3",22850542,1,1,0,1551,443,444,1
"452745e0366e42ae81561bfddebcc6c3","452745e0366e42ae81561bfddebcc6c3",22850542,2,0,1,1552,444,444,0
"452745e0366e42ae81561bfddebcc6c3","4660ff2089114e8db82ceb26a4f329e3",22850542,1,2,0,1554,444,445,1
"4660ff2089114e8db82ceb26a4f329e3","901e92500aea43c79f19f1b279050668",22850542,1,-4,0,1555,445,442,-3
"901e92500aea43c79f19f1b279050668","4660ff2089114e8db82ceb26a4f329e3",22850542,1,4,0,1556,442,445,3
"4660ff2089114e8db82ceb26a4f329e3","4660ff2089114e8db82ceb26a4f329e3",22850542,3,0,1,1557,445,445,0
"4660ff2089114e8db82ceb26a4f329e3","7bd5586eb9d8484eb74a433ee7bfe499",22850542,1,2,0,1560,445,446,1
"7bd5586eb9d8484eb74a433ee7bfe499","7bd5586eb9d8484eb74a433ee7bfe499",22850542,13,0,1,1561,446,446,0
"7bd5586eb9d8484eb74a433ee7bfe499","8a7f26e690f34dda97be16904518ca99",22850542,1,2,0,1574,446,447,1
"8a7f26e690f34dda97be16904518ca99","8a7f26e690f34dda97be16904518ca99",22850542,1,0,1,1575,447,447,0
"8a7f26e690f34dda97be16904518ca99","b2f0d654738f48158edff28e8d3a546e",22850542,1,5,0,1576,447,449,2
"b2f0d654738f48158edff28e8d3a546e","070600601c4c439288445d2f0724807d",22850542,1,-21,0,1577,449,437,-12
"070600601c4c439288445d2f0724807d","1b4550d0dab04078b3bf08a655345bdc",22850542,1,-99,0,1578,437,373,-64
"1b4550d0dab04078b3bf08a655345bdc","b71bac264efb4abd97015447bd490db6",22850542,1,-4,0,1579,373,370,-3
"d6d02b6ef04e4f17805504500b8ce441","b2f0d654738f48158edff28e8d3a546e",22850542,2,116,0,1594,375,449,74
"b2f0d654738f48158edff28e8d3a546e","d6d02b6ef04e4f17805504500b8ce441",22850542,1,-116,0,1596,449,375,-74
"b2f0d654738f48158edff28e8d3a546e","f60ee41ec635499abd48168342d32c2f",22850542,4,5,0,1604,449,453,4
"f60ee41ec635499abd48168342d32c2f","f60ee41ec635499abd48168342d32c2f",22850542,67,0,1,1605,453,453,0
"f60ee41ec635499abd48168342d32c2f","b2f0d654738f48158edff28e8d3a546e",22850542,3,-5,0,1610,453,449,-4
"b2f0d654738f48158edff28e8d3a546e","f7002c8484354eceac57bc7bd62c76c1",22850542,1,-91,0,1615,449,393,-56
"f7002c8484354eceac57bc7bd62c76c1","66baf19b6b904b70922329068c63746d",22850542,1,-21,0,1616,393,376,-17
"66baf19b6b904b70922329068c63746d","6f8881a745ac4c358a68b92c3b4abe81",22850542,1,22,0,1617,376,394,18
"6f8881a745ac4c358a68b92c3b4abe81","f60ee41ec635499abd48168342d32c2f",22850542,1,95,0,1618,394,453,59
"f60ee41ec635499abd48168342d32c2f","f67fbf45a5f146ed866965bc57c7c001",22850542,1,3,0,1674,453,454,1
"f67fbf45a5f146ed866965bc57c7c001","b2f0d654738f48158edff28e8d3a546e",22850542,1,-8,0,1675,454,449,-5
"b2f0d654738f48158edff28e8d3a546e","f67fbf45a5f146ed866965bc57c7c001",22850542,1,8,0,1676,449,454,5
"f67fbf45a5f146ed866965bc57c7c001","f67fbf45a5f146ed866965bc57c7c001",22850542,1,0,1,1677,454,454,0
"f67fbf45a5f146ed866965bc57c7c001","d937afe49bd24a07a550dda1c1155122",22850542,1,1,0,1678,454,455,1
"d937afe49bd24a07a550dda1c1155122","d937afe49bd24a07a550dda1c1155122",22850542,1,0,1,1679,455,455,0
"d937afe49bd24a07a550dda1c1155122","3628b3f7823443d0912a339096b69943",22850542,1,1,0,1680,455,456,1
"3628b3f7823443d0912a339096b69943","3628b3f7823443d0912a339096b69943",22850542,1,0,1,1681,456,456,0
"3628b3f7823443d0912a339096b69943","9e049ee647cf43ecbcb5ed792a8e7588",22850542,1,1,0,1682,456,457,1
"9e049ee647cf43ecbcb5ed792a8e7588","9e049ee647cf43ecbcb5ed792a8e7588",22850542,1,0,1,1683,457,457,0
"9e049ee647cf43ecbcb5ed792a8e7588","5256a214faaf410b93f76cea06428334",22850542,1,1,0,1684,457,458,1
"5256a214faaf410b93f76cea06428334","5256a214faaf410b93f76cea06428334",22850542,1,0,1,1685,458,458,0
"5256a214faaf410b93f76cea06428334","25c32b120fce40fa9b6c85133aeb4716",22850542,1,1,0,1686,458,459,1
"25c32b120fce40fa9b6c85133aeb4716","25c32b120fce40fa9b6c85133aeb4716",22850542,1,0,1,1687,459,459,0
"25c32b120fce40fa9b6c85133aeb4716","11bc14f2204949008b7d511b933363c1",22850542,1,1,0,1688,459,460,1
"11bc14f2204949008b7d511b933363c1","11bc14f2204949008b7d511b933363c1",22850542,1,0,1,1689,460,460,0
"11bc14f2204949008b7d511b933363c1","42de338840a34d15adb66e7b14fb9d2c",22850542,1,1,0,1690,460,461,1
"42de338840a34d15adb66e7b14fb9d2c","42de338840a34d15adb66e7b14fb9d2c",22850542,3,0,1,1691,461,461,0
"42de338840a34d15adb66e7b14fb9d2c","9da37c6210b1416b8079c274f70bf600",22850542,1,1,0,1694,461,462,1
"9da37c6210b1416b8079c274f70bf600","9da37c6210b1416b8079c274f70bf600",22850542,3,0,1,1695,462,462,0
"9da37c6210b1416b8079c274f70bf600","519119f1deac45ff9ab4f13529be5c6e",22850542,1,1,0,1698,462,463,1
"519119f1deac45ff9ab4f13529be5c6e","519119f1deac45ff9ab4f13529be5c6e",22850542,1,0,1,1699,463,463,0
"519119f1deac45ff9ab4f13529be5c6e","f67fbf45a5f146ed866965bc57c7c001",22850542,1,-9,0,1700,463,454,-9
"f67fbf45a5f146ed866965bc57c7c001","c5df9f40ec14463b9dcfdc73df3e9285",22850542,1,12,0,1701,454,464,10
"c5df9f40ec14463b9dcfdc73df3e9285","c5df9f40ec14463b9dcfdc73df3e9285",22850542,2,0,1,1702,464,464,0
"c5df9f40ec14463b9dcfdc73df3e9285","83d42d95cd844fc093fc09cee250edb8",22850542,1,3,0,1704,464,465,1
"83d42d95cd844fc093fc09cee250edb8","83d42d95cd844fc093fc09cee250edb8",22850542,3,0,1,1705,465,465,0
"83d42d95cd844fc093fc09cee250edb8","9428d8bd9c5a47b2a235b254e5e27ded",22850542,1,-19,0,1708,465,452,-13
"9428d8bd9c5a47b2a235b254e5e27ded","b2f0d654738f48158edff28e8d3a546e",22850542,1,-4,0,1709,452,449,-3
"b613861cecf84ffcab01afb23f660475","b613861cecf84ffcab01afb23f660475",22850590,6,0,1,1,1,1,0
"e2911e79efc2420eac45d9f671463d4b","519d1b8c59404d67b54e96c5c8a830b2",22850590,1,1,0,9,2,3,1
"519d1b8c59404d67b54e96c5c8a830b2","519d1b8c59404d67b54e96c5c8a830b2",22850590,1,0,1,10,3,3,0
"519d1b8c59404d67b54e96c5c8a830b2","531db53f81f646edb0cdcfe0085b03b7",22850590,1,1,0,11,3,4,1
"531db53f81f646edb0cdcfe0085b03b7","531db53f81f646edb0cdcfe0085b03b7",22850590,2,0,1,12,4,4,0
"531db53f81f646edb0cdcfe0085b03b7","519d1b8c59404d67b54e96c5c8a830b2",22850590,1,-1,0,14,4,3,-1
"519d1b8c59404d67b54e96c5c8a830b2","e2911e79efc2420eac45d9f671463d4b",22850590,1,-1,0,15,3,2,-1
"e2911e79efc2420eac45d9f671463d4b","4f5f94b2f95141e0a9d53a61da2276da",22850590,1,3,0,16,2,5,3
"4f5f94b2f95141e0a9d53a61da2276da","4f5f94b2f95141e0a9d53a61da2276da",22850590,2,0,1,17,5,5,0
"4f5f94b2f95141e0a9d53a61da2276da","6d541c89590949f99af293c4f2333f67",22850590,1,1,0,19,5,6,1
"6d541c89590949f99af293c4f2333f67","6d541c89590949f99af293c4f2333f67",22850590,2,0,1,20,6,6,0
"6d541c89590949f99af293c4f2333f67","dd5cf0b9fe4c4f1d8f5ff8e4c04879cb",22850590,1,1,0,22,6,7,1
"dd5cf0b9fe4c4f1d8f5ff8e4c04879cb","dd5cf0b9fe4c4f1d8f5ff8e4c04879cb",22850590,5,0,1,23,7,7,0
"dd5cf0b9fe4c4f1d8f5ff8e4c04879cb","f96261861edc426abe2248be4f0a709a",22850590,1,1,0,28,7,8,1
"f96261861edc426abe2248be4f0a709a","f96261861edc426abe2248be4f0a709a",22850590,2,0,1,29,8,8,0
"f96261861edc426abe2248be4f0a709a","66b5e16f4f75454fb5b8172079f0fa83",22850590,1,1,0,31,8,9,1
"66b5e16f4f75454fb5b8172079f0fa83","66b5e16f4f75454fb5b8172079f0fa83",22850590,2,0,1,32,9,9,0
"66b5e16f4f75454fb5b8172079f0fa83","0680571d4698477995e41842c36a54b2",22850590,1,1,0,34,9,10,1
"0680571d4698477995e41842c36a54b2","0680571d4698477995e41842c36a54b2",22850590,2,0,1,35,10,10,0
"0680571d4698477995e41842c36a54b2","9112f2bffece48e08c6d2287be204085",22850590,1,1,0,37,10,11,1
"9112f2bffece48e08c6d2287be204085","9112f2bffece48e08c6d2287be204085",22850590,2,0,1,38,11,11,0
"9112f2bffece48e08c6d2287be204085","e2911e79efc2420eac45d9f671463d4b",22850590,1,-9,0,40,11,2,-9
"3f1c815879794b929260d224becaff7e","b7f2b31585d94eb3bf86376714aa7070",22850590,1,-2,0,53,14,13,-1
"3f1c815879794b929260d224becaff7e","81c864a886d54a6b8ff85f7d736f4f95",22850590,1,2,0,55,14,15,1
"81c864a886d54a6b8ff85f7d736f4f95","5c5ceeee4562457ba6d41515aeebfbb1",22850590,1,4,0,56,15,17,2
"5c5ceeee4562457ba6d41515aeebfbb1","5c5ceeee4562457ba6d41515aeebfbb1",22850590,2,0,1,57,17,17,0
"5c5ceeee4562457ba6d41515aeebfbb1","9afd71a5298d4333b6849dfce1b9422c",22850590,1,3,0,59,17,18,1
"56586aa865414f538729c7f7735d2bc6","9afd71a5298d4333b6849dfce1b9422c",22850590,1,13,0,61,12,18,6
"9afd71a5298d4333b6849dfce1b9422c","9afd71a5298d4333b6849dfce1b9422c",22850590,2,0,1,62,18,18,0
"9afd71a5298d4333b6849dfce1b9422c","b7719e26494940efa49512aedd0aac79",22850590,2,4,0,63,18,20,2
"b7719e26494940efa49512aedd0aac79","d4f45188d3c84a02ba08454e6403a818",22850590,2,5,0,64,20,24,4
"d4f45188d3c84a02ba08454e6403a818","d4c3b003e8274e429d2fa688d73fde6d",22850590,3,-2,0,65,24,22,-2
"d4c3b003e8274e429d2fa688d73fde6d","b7719e26494940efa49512aedd0aac79",22850590,3,-3,0,66,22,20,-2
"b7719e26494940efa49512aedd0aac79","9afd71a5298d4333b6849dfce1b9422c",22850590,1,-4,0,67,20,18,-2
"d4c3b003e8274e429d2fa688d73fde6d","d4c3b003e8274e429d2fa688d73fde6d",22850590,2,0,1,73,22,22,0
"b7719e26494940efa49512aedd0aac79","afbf7250b99d47bea07172749483ca97",22850590,2,12,0,79,20,28,8
"afbf7250b99d47bea07172749483ca97","b7719e26494940efa49512aedd0aac79",22850590,1,-12,0,80,28,20,-8
"afbf7250b99d47bea07172749483ca97","4e51676dc72045d99c19b9fa7b22f8bc",22850590,1,3,0,82,28,29,1
"4e51676dc72045d99c19b9fa7b22f8bc","4e51676dc72045d99c19b9fa7b22f8bc",22850590,1,0,1,83,29,29,0
"4e51676dc72045d99c19b9fa7b22f8bc","51970cfa30e643e894e66ae85c8024cc",22850590,1,3,0,84,29,31,2
"51970cfa30e643e894e66ae85c8024cc","c33c17be71ae4d588da7369472e5bb1b",22850590,1,6,0,85,31,34,3
"c33c17be71ae4d588da7369472e5bb1b","4e51676dc72045d99c19b9fa7b22f8bc",22850590,1,-9,0,86,34,29,-5
"4e51676dc72045d99c19b9fa7b22f8bc","c33c17be71ae4d588da7369472e5bb1b",22850590,1,9,0,87,29,34,5
"c33c17be71ae4d588da7369472e5bb1b","93679be414554a11b1893002f2229a93",22850590,1,3,0,88,34,35,1
"93679be414554a11b1893002f2229a93","93679be414554a11b1893002f2229a93",22850590,1,0,1,89,35,35,0
"93679be414554a11b1893002f2229a93","7040a13096d746ac84b8fac8d9752058",22850590,1,3,0,90,35,36,1
"7040a13096d746ac84b8fac8d9752058","9a0dc646f934470daf08c4b56ccf73db",22850590,1,3,0,91,36,37,1
"9a0dc646f934470daf08c4b56ccf73db","7040a13096d746ac84b8fac8d9752058",22850590,1,-3,0,92,37,36,-1
"7040a13096d746ac84b8fac8d9752058","fc0e049d56024bc9a02c9a9c435c3df7",22850590,1,6,0,93,36,38,2
"fc0e049d56024bc9a02c9a9c435c3df7","9a0dc646f934470daf08c4b56ccf73db",22850590,1,-3,0,94,38,37,-1
"9a0dc646f934470daf08c4b56ccf73db","67a089198fcb4e1c8f2385786c2b296f",22850590,1,7,0,95,37,39,2
"67a089198fcb4e1c8f2385786c2b296f","fc0e049d56024bc9a02c9a9c435c3df7",22850590,1,-4,0,96,39,38,-1
"fc0e049d56024bc9a02c9a9c435c3df7","64d48c6c9c7940639a932219a6c87198",22850590,1,5,0,97,38,40,2
"64d48c6c9c7940639a932219a6c87198","67a089198fcb4e1c8f2385786c2b296f",22850590,2,-1,0,100,40,39,-1
"67a089198fcb4e1c8f2385786c2b296f","64d48c6c9c7940639a932219a6c87198",22850590,3,1,0,101,39,40,1
"64d48c6c9c7940639a932219a6c87198","e2911e79efc2420eac45d9f671463d4b",22850590,1,-70,0,102,40,2,-38
"e2911e79efc2420eac45d9f671463d4b","e2911e79efc2420eac45d9f671463d4b",22850590,7,0,1,103,2,2,0
"e2911e79efc2420eac45d9f671463d4b","78adeee1fa2c4fe0bc73f7bca9fcee86",22850590,1,221,0,104,2,160,158
"78adeee1fa2c4fe0bc73f7bca9fcee86","78adeee1fa2c4fe0bc73f7bca9fcee86",22850590,5,0,1,105,160,160,0
"78adeee1fa2c4fe0bc73f7bca9fcee86","67a089198fcb4e1c8f2385786c2b296f",22850590,3,-152,0,106,160,39,-121
"67a089198fcb4e1c8f2385786c2b296f","e2911e79efc2420eac45d9f671463d4b",22850590,1,-69,0,107,39,2,-37
"e2911e79efc2420eac45d9f671463d4b","b613861cecf84ffcab01afb23f660475",22850590,1,-3,0,109,2,1,-1
"b613861cecf84ffcab01afb23f660475","eb2a0eb537344a9e891c761662e400b6",22850590,1,23,0,111,1,16,15
"eb2a0eb537344a9e891c761662e400b6","56586aa865414f538729c7f7735d2bc6",22850590,1,-8,0,112,16,12,-4
"56586aa865414f538729c7f7735d2bc6","5c5ceeee4562457ba6d41515aeebfbb1",22850590,1,10,0,113,12,17,5
"5c5ceeee4562457ba6d41515aeebfbb1","b613861cecf84ffcab01afb23f660475",22850590,1,-25,0,114,17,1,-16
"b613861cecf84ffcab01afb23f660475","c33c17be71ae4d588da7369472e5bb1b",22850590,1,56,0,115,1,34,33
"c33c17be71ae4d588da7369472e5bb1b","e2911e79efc2420eac45d9f671463d4b",22850590,1,-53,0,116,34,2,-32
"e2911e79efc2420eac45d9f671463d4b","56586aa865414f538729c7f7735d2bc6",22850590,3,12,0,117,2,12,10
"56586aa865414f538729c7f7735d2bc6","56586aa865414f538729c7f7735d2bc6",22850590,9,0,1,118,12,12,0
"56586aa865414f538729c7f7735d2bc6","b7f2b31585d94eb3bf86376714aa7070",22850590,3,2,0,120,12,13,1
"b7f2b31585d94eb3bf86376714aa7070","b7f2b31585d94eb3bf86376714aa7070",22850590,6,0,1,121,13,13,0
"b7f2b31585d94eb3bf86376714aa7070","3f1c815879794b929260d224becaff7e",22850590,4,2,0,122,13,14,1
"3f1c815879794b929260d224becaff7e","78adeee1fa2c4fe0bc73f7bca9fcee86",22850590,1,205,0,123,14,160,146
"67a089198fcb4e1c8f2385786c2b296f","67a089198fcb4e1c8f2385786c2b296f",22850590,3,0,1,127,39,39,0
"64d48c6c9c7940639a932219a6c87198","64d48c6c9c7940639a932219a6c87198",22850590,8,0,1,131,40,40,0
"64d48c6c9c7940639a932219a6c87198","b534b89233134e30a9b5645138bfa9ee",22850590,1,3,0,137,40,41,1
"b534b89233134e30a9b5645138bfa9ee","67a089198fcb4e1c8f2385786c2b296f",22850590,2,-4,0,138,41,39,-2
"67a089198fcb4e1c8f2385786c2b296f","b534b89233134e30a9b5645138bfa9ee",22850590,2,4,0,139,39,41,2
"b534b89233134e30a9b5645138bfa9ee","0e37b720d23b4e7f8b313e79313fd107",22850590,1,3,0,144,41,44,3
"0e37b720d23b4e7f8b313e79313fd107","0e37b720d23b4e7f8b313e79313fd107",22850590,5,0,1,145,44,44,0
"0e37b720d23b4e7f8b313e79313fd107","6875d67fdd5f48168b62719df449bebd",22850590,1,1,0,150,44,45,1
"6875d67fdd5f48168b62719df449bebd","6875d67fdd5f48168b62719df449bebd",22850590,1,0,1,151,45,45,0
"6875d67fdd5f48168b62719df449bebd","b534b89233134e30a9b5645138bfa9ee",22850590,1,-4,0,152,45,41,-4
"b534b89233134e30a9b5645138bfa9ee","6e13d61a7bdb44bca949c9f86fab3be5",22850590,1,7,0,153,41,47,6
"6e13d61a7bdb44bca949c9f86fab3be5","6e13d61a7bdb44bca949c9f86fab3be5",22850590,2,0,1,154,47,47,0
"6e13d61a7bdb44bca949c9f86fab3be5","d0c74f735e024943943e40333d6d337f",22850590,1,5,0,156,47,51,4
"d0c74f735e024943943e40333d6d337f","d9c8d8c444a64dadbbb508652c721e17",22850590,1,-6,0,157,51,46,-5
"d9c8d8c444a64dadbbb508652c721e17","6e13d61a7bdb44bca949c9f86fab3be5",22850590,1,1,0,158,46,47,1
"6e13d61a7bdb44bca949c9f86fab3be5","f924752d8a1149668870b1e7698486f7",22850590,1,4,0,159,47,50,3
"f924752d8a1149668870b1e7698486f7","195f78799f984cc2b06c48dfe36be751",22850590,1,-2,0,160,50,49,-1
"195f78799f984cc2b06c48dfe36be751","195f78799f984cc2b06c48dfe36be751",22850590,2,0,1,161,49,49,0
"195f78799f984cc2b06c48dfe36be751","d9c8d8c444a64dadbbb508652c721e17",22850590,1,-3,0,163,49,46,-3
"d9c8d8c444a64dadbbb508652c721e17","d0c74f735e024943943e40333d6d337f",22850590,1,6,0,164,46,51,5
"d0c74f735e024943943e40333d6d337f","b534b89233134e30a9b5645138bfa9ee",22850590,1,-12,0,165,51,41,-10
"b534b89233134e30a9b5645138bfa9ee","d0c74f735e024943943e40333d6d337f",22850590,1,12,0,166,41,51,10
"d0c74f735e024943943e40333d6d337f","d0c74f735e024943943e40333d6d337f",22850590,4,0,1,167,51,51,0
"d0c74f735e024943943e40333d6d337f","983f8ff320594b279a7f4a6fe132f9c5",22850590,1,2,0,171,51,53,2
"983f8ff320594b279a7f4a6fe132f9c5","983f8ff320594b279a7f4a6fe132f9c5",22850590,2,0,1,172,53,53,0
"983f8ff320594b279a7f4a6fe132f9c5","35adfa5d923046aebabfefd98f35ff05",22850590,1,1,0,174,53,54,1
"35adfa5d923046aebabfefd98f35ff05","35adfa5d923046aebabfefd98f35ff05",22850590,5,0,1,175,54,54,0
"35adfa5d923046aebabfefd98f35ff05","b6f8a98476224da1b40e555ececc7ed8",22850590,1,1,0,180,54,55,1
"b6f8a98476224da1b40e555ececc7ed8","b6f8a98476224da1b40e555ececc7ed8",22850590,6,0,1,181,55,55,0
"b6f8a98476224da1b40e555ececc7ed8","86e22cb5fe0e4b47a9489ecddf7ed78f",22850590,1,1,0,187,55,56,1
"86e22cb5fe0e4b47a9489ecddf7ed78f","86e22cb5fe0e4b47a9489ecddf7ed78f",22850590,2,0,1,188,56,56,0
"86e22cb5fe0e4b47a9489ecddf7ed78f","a1f2f12debe5432fb7a70bcd12bacfb9",22850590,1,3,0,190,56,58,2
"a1f2f12debe5432fb7a70bcd12bacfb9","f924752d8a1149668870b1e7698486f7",22850590,1,-9,0,191,58,50,-8
"f924752d8a1149668870b1e7698486f7","78f30e4dcac84e3cbea8b2cc6e0d62b3",22850590,1,10,0,192,50,59,9
"78f30e4dcac84e3cbea8b2cc6e0d62b3","12aa6e1672ac4e7aa6449a7a8609cd72",22850590,1,-2,0,193,59,57,-2
"12aa6e1672ac4e7aa6449a7a8609cd72","12aa6e1672ac4e7aa6449a7a8609cd72",22850590,1,0,1,194,57,57,0
"12aa6e1672ac4e7aa6449a7a8609cd72","b534b89233134e30a9b5645138bfa9ee",22850590,1,-19,0,195,57,41,-16
"b534b89233134e30a9b5645138bfa9ee","78f30e4dcac84e3cbea8b2cc6e0d62b3",22850590,1,21,0,196,41,59,18
"78f30e4dcac84e3cbea8b2cc6e0d62b3","a1f2f12debe5432fb7a70bcd12bacfb9",22850590,1,-1,0,197,59,58,-1
"a1f2f12debe5432fb7a70bcd12bacfb9","a1f2f12debe5432fb7a70bcd12bacfb9",22850590,10,0,1,198,58,58,0
"a1f2f12debe5432fb7a70bcd12bacfb9","78f30e4dcac84e3cbea8b2cc6e0d62b3",22850590,1,1,0,208,58,59,1
"78f30e4dcac84e3cbea8b2cc6e0d62b3","78f30e4dcac84e3cbea8b2cc6e0d62b3",22850590,13,0,1,209,59,59,0
"78f30e4dcac84e3cbea8b2cc6e0d62b3","bc42d26810654ea9a1df1efe1e58c7d5",22850590,1,5,0,222,59,63,4
"bc42d26810654ea9a1df1efe1e58c7d5","12aa6e1672ac4e7aa6449a7a8609cd72",22850590,1,-7,0,223,63,57,-6
"12aa6e1672ac4e7aa6449a7a8609cd72","a0a418b8540d479fa6e0f653b701da8b",22850590,1,8,0,224,57,64,7
"a0a418b8540d479fa6e0f653b701da8b","4c943503763e4e349906eea3ed3c8e86",22850590,1,-3,0,225,64,61,-3
"4c943503763e4e349906eea3ed3c8e86","4c943503763e4e349906eea3ed3c8e86",22850590,1,0,1,226,61,61,0
"4c943503763e4e349906eea3ed3c8e86","bc42d26810654ea9a1df1efe1e58c7d5",22850590,1,2,0,227,61,63,2
"bc42d26810654ea9a1df1efe1e58c7d5","bc42d26810654ea9a1df1efe1e58c7d5",22850590,4,0,1,228,63,63,0
"bc42d26810654ea9a1df1efe1e58c7d5","309ccf3cc4fe429d9bfbaef53d3fa479",22850590,2,-3,0,231,63,60,-3
"309ccf3cc4fe429d9bfbaef53d3fa479","7af822066add4e7f8e007e4eee31a8bf",22850590,1,6,0,232,60,65,5
"7af822066add4e7f8e007e4eee31a8bf","bc42d26810654ea9a1df1efe1e58c7d5",22850590,1,-3,0,233,65,63,-2
"bc42d26810654ea9a1df1efe1e58c7d5","a0a418b8540d479fa6e0f653b701da8b",22850590,1,1,0,234,63,64,1
"a0a418b8540d479fa6e0f653b701da8b","bc42d26810654ea9a1df1efe1e58c7d5",22850590,1,-1,0,235,64,63,-1
"309ccf3cc4fe429d9bfbaef53d3fa479","b534b89233134e30a9b5645138bfa9ee",22850590,1,-23,0,238,60,41,-19
"b534b89233134e30a9b5645138bfa9ee","d646286c8051419bbc2e31dd1db55ca8",22850590,1,33,0,239,41,67,26
"d646286c8051419bbc2e31dd1db55ca8","267f883678b24aed855fde42524975d9",22850590,1,4,0,240,67,71,4
"267f883678b24aed855fde42524975d9","267f883678b24aed855fde42524975d9",22850590,2,0,1,241,71,71,0
"267f883678b24aed855fde42524975d9","88fff56d0342490dbef9040750a20f6c",22850590,1,1,0,243,71,72,1
"88fff56d0342490dbef9040750a20f6c","88fff56d0342490dbef9040750a20f6c",22850590,2,0,1,244,72,72,0
"88fff56d0342490dbef9040750a20f6c","adb17b12b66c4a49a85fd34322f7df70",22850590,1,1,0,246,72,73,1
"adb17b12b66c4a49a85fd34322f7df70","adb17b12b66c4a49a85fd34322f7df70",22850590,1,0,1,247,73,73,0
"adb17b12b66c4a49a85fd34322f7df70","d646286c8051419bbc2e31dd1db55ca8",22850590,1,-6,0,248,73,67,-6
"d646286c8051419bbc2e31dd1db55ca8","a2becd407db34b189200a32546d9d569",22850590,1,9,0,249,67,75,8
"a2becd407db34b189200a32546d9d569","a2becd407db34b189200a32546d9d569",22850590,3,0,1,250,75,75,0
"a2becd407db34b189200a32546d9d569","58c22b011d0f4c2ea6d13615edbb9eeb",22850590,1,2,0,253,75,77,2
"58c22b011d0f4c2ea6d13615edbb9eeb","58c22b011d0f4c2ea6d13615edbb9eeb",22850590,2,0,1,254,77,77,0
"58c22b011d0f4c2ea6d13615edbb9eeb","dd76e1861dc9461c830888729d091ee0",22850590,1,1,0,256,77,78,1
"dd76e1861dc9461c830888729d091ee0","dd76e1861dc9461c830888729d091ee0",22850590,5,0,1,257,78,78,0
"dd76e1861dc9461c830888729d091ee0","cd1d828f1a694b87913a7ea66c23803e",22850590,1,1,0,262,78,79,1
"cd1d828f1a694b87913a7ea66c23803e","cd1d828f1a694b87913a7ea66c23803e",22850590,2,0,1,263,79,79,0
"cd1d828f1a694b87913a7ea66c23803e","f8ec6445f7194e25b9101d4fbcb07a18",22850590,1,2,0,265,79,81,2
"f8ec6445f7194e25b9101d4fbcb07a18","f8ec6445f7194e25b9101d4fbcb07a18",22850590,2,0,1,266,81,81,0
"f8ec6445f7194e25b9101d4fbcb07a18","9176a3c2b4d2465fa8b0c67096c2a97e",22850590,1,-1,0,268,81,80,-1
"9176a3c2b4d2465fa8b0c67096c2a97e","9176a3c2b4d2465fa8b0c67096c2a97e",22850590,5,0,1,269,80,80,0
"9176a3c2b4d2465fa8b0c67096c2a97e","140d5b27b8574befad82c0a013b59dfa",22850590,1,-6,0,274,80,74,-6
"140d5b27b8574befad82c0a013b59dfa","38376f961ebc414db8f3b8f244f6d5ed",22850590,1,10,0,275,74,83,9
"38376f961ebc414db8f3b8f244f6d5ed","38376f961ebc414db8f3b8f244f6d5ed",22850590,1,0,1,276,83,83,0
"38376f961ebc414db8f3b8f244f6d5ed","d646286c8051419bbc2e31dd1db55ca8",22850590,1,-18,0,277,83,67,-16
"d646286c8051419bbc2e31dd1db55ca8","d18a9ea32855445f8736581f5cb119ce",22850590,1,17,0,278,67,82,15
"d18a9ea32855445f8736581f5cb119ce","d646286c8051419bbc2e31dd1db55ca8",22850590,1,-17,0,279,82,67,-15
"d646286c8051419bbc2e31dd1db55ca8","f564483cbd7a407681aa2fcca518cf5f",22850590,1,21,0,280,67,85,18
"f564483cbd7a407681aa2fcca518cf5f","f564483cbd7a407681aa2fcca518cf5f",22850590,1,0,1,281,85,85,0
"f564483cbd7a407681aa2fcca518cf5f","18fd01350bd5434ca636d59a599d768a",22850590,1,1,0,282,85,86,1
"18fd01350bd5434ca636d59a599d768a","18fd01350bd5434ca636d59a599d768a",22850590,9,0,1,283,86,86,0
"18fd01350bd5434ca636d59a599d768a","ae5ac430ea254e708a6f5deaaf7464ae",22850590,1,-2,0,292,86,84,-2
"ae5ac430ea254e708a6f5deaaf7464ae","6a9f0ef185fb47f0937e29daa1c71ed5",22850590,1,7,0,293,84,90,6
"6a9f0ef185fb47f0937e29daa1c71ed5","6a9f0ef185fb47f0937e29daa1c71ed5",22850590,6,0,1,294,90,90,0
"6a9f0ef185fb47f0937e29daa1c71ed5","c681290961c94c4caf23b529d1ae6b9a",22850590,1,-2,0,298,90,88,-2
"c681290961c94c4caf23b529d1ae6b9a","c681290961c94c4caf23b529d1ae6b9a",22850590,1,0,1,299,88,88,0
"c681290961c94c4caf23b529d1ae6b9a","d646286c8051419bbc2e31dd1db55ca8",22850590,1,-25,0,300,88,67,-21
"d646286c8051419bbc2e31dd1db55ca8","e20db35ced8544ddac5bc3839145e463",22850590,1,30,0,301,67,91,24
"e20db35ced8544ddac5bc3839145e463","1febb706d7a34005ae8711ed49c76e64",22850590,1,3,0,302,91,94,3
"1febb706d7a34005ae8711ed49c76e64","1febb706d7a34005ae8711ed49c76e64",22850590,2,0,1,303,94,94,0
"1febb706d7a34005ae8711ed49c76e64","8f73ba6f5a0042f2850356ac38ac6f24",22850590,1,1,0,305,94,95,1
"8f73ba6f5a0042f2850356ac38ac6f24","8f73ba6f5a0042f2850356ac38ac6f24",22850590,5,0,1,306,95,95,0
"8f73ba6f5a0042f2850356ac38ac6f24","e2260b86653c46d7b14a41fb419dbf8c",22850590,1,1,0,311,95,96,1
"e2260b86653c46d7b14a41fb419dbf8c","e2260b86653c46d7b14a41fb419dbf8c",22850590,2,0,1,312,96,96,0
"e2260b86653c46d7b14a41fb419dbf8c","35eb641ad1d845bbba54915bce75a962",22850590,1,1,0,314,96,97,1
"35eb641ad1d845bbba54915bce75a962","35eb641ad1d845bbba54915bce75a962",22850590,5,0,1,315,97,97,0
"35eb641ad1d845bbba54915bce75a962","08be90ffbeea4795a138cd42ed8db56f",22850590,1,1,0,320,97,98,1
"08be90ffbeea4795a138cd42ed8db56f","08be90ffbeea4795a138cd42ed8db56f",22850590,5,0,1,321,98,98,0
"08be90ffbeea4795a138cd42ed8db56f","3007433c8f584dcbb5ac159c1c5f2be3",22850590,1,1,0,326,98,99,1
"3007433c8f584dcbb5ac159c1c5f2be3","3007433c8f584dcbb5ac159c1c5f2be3",22850590,5,0,1,327,99,99,0
"3007433c8f584dcbb5ac159c1c5f2be3","e20db35ced8544ddac5bc3839145e463",22850590,1,-8,0,332,99,91,-8
"e20db35ced8544ddac5bc3839145e463","00ae5f0c51874a73a41ebea838d95682",22850590,1,11,0,333,91,101,10
"00ae5f0c51874a73a41ebea838d95682","d391c8b6e56a43a7b654e9dee02d904b",22850590,2,2,0,334,101,103,2
"d391c8b6e56a43a7b654e9dee02d904b","00ae5f0c51874a73a41ebea838d95682",22850590,1,-2,0,335,103,101,-2
"00ae5f0c51874a73a41ebea838d95682","00ae5f0c51874a73a41ebea838d95682",22850590,1,0,1,336,101,101,0
"d391c8b6e56a43a7b654e9dee02d904b","d391c8b6e56a43a7b654e9dee02d904b",22850590,15,0,1,338,103,103,0
"d391c8b6e56a43a7b654e9dee02d904b","6111116566fc4fd9abba409322bea245",22850590,1,1,0,353,103,104,1
"6111116566fc4fd9abba409322bea245","6111116566fc4fd9abba409322bea245",22850590,2,0,1,354,104,104,0
"6111116566fc4fd9abba409322bea245","a81b2235cb9c499eb9ea8ee0a8dd9725",22850590,1,1,0,356,104,105,1
"a81b2235cb9c499eb9ea8ee0a8dd9725","a81b2235cb9c499eb9ea8ee0a8dd9725",22850590,5,0,1,357,105,105,0
"a81b2235cb9c499eb9ea8ee0a8dd9725","2d4e0ab0ef3b4d73b82c72d4621a7579",22850590,1,1,0,362,105,106,1
"2d4e0ab0ef3b4d73b82c72d4621a7579","2d4e0ab0ef3b4d73b82c72d4621a7579",22850590,2,0,1,363,106,106,0
"2d4e0ab0ef3b4d73b82c72d4621a7579","8bdebf492ebd4e62b0d522e8ab5e5197",22850590,1,1,0,365,106,107,1
"8bdebf492ebd4e62b0d522e8ab5e5197","8bdebf492ebd4e62b0d522e8ab5e5197",22850590,5,0,1,366,107,107,0
"8bdebf492ebd4e62b0d522e8ab5e5197","73039f8c1eb9409cb4caee2cf968001e",22850590,1,-7,0,371,107,100,-7
"73039f8c1eb9409cb4caee2cf968001e","4280927ec4d643238aa49c32f9e06c6c",22850590,1,10,0,372,100,109,9
"4280927ec4d643238aa49c32f9e06c6c","4280927ec4d643238aa49c32f9e06c6c",22850590,11,0,1,373,109,109,0
"4280927ec4d643238aa49c32f9e06c6c","fc44e6a5f7654430af1227838224dceb",22850590,1,2,0,384,109,111,2
"fc44e6a5f7654430af1227838224dceb","fc44e6a5f7654430af1227838224dceb",22850590,2,0,1,385,111,111,0
"fc44e6a5f7654430af1227838224dceb","08111f75e22d409998cf8b85bd431f0a",22850590,1,-3,0,387,111,108,-3
"08111f75e22d409998cf8b85bd431f0a","a9ae0a3c070d455bb4369a8996313336",22850590,1,7,0,388,108,114,6
"a9ae0a3c070d455bb4369a8996313336","a9ae0a3c070d455bb4369a8996313336",22850590,1,0,1,389,114,114,0
"a9ae0a3c070d455bb4369a8996313336","e20db35ced8544ddac5bc3839145e463",22850590,1,-26,0,390,114,91,-23
"e20db35ced8544ddac5bc3839145e463","e20db35ced8544ddac5bc3839145e463",22850590,1,0,1,391,91,91,0
"e20db35ced8544ddac5bc3839145e463","a9ae0a3c070d455bb4369a8996313336",22850590,1,26,0,392,91,114,23
"a9ae0a3c070d455bb4369a8996313336","71cec822bcff4f30a20e75dc63ef7b65",22850590,1,2,0,393,114,116,2
"71cec822bcff4f30a20e75dc63ef7b65","71cec822bcff4f30a20e75dc63ef7b65",22850590,1,0,1,394,116,116,0
"71cec822bcff4f30a20e75dc63ef7b65","62bff51286ef4f348717a3cf6fe2318f",22850590,1,5,0,395,116,120,4
"62bff51286ef4f348717a3cf6fe2318f","37319e88176d4aefa91d7a9980dbae91",22850590,1,-9,0,396,120,112,-8
"37319e88176d4aefa91d7a9980dbae91","b1cd0e7dc3ad4a8eb91a4bfdbeb025b0",22850590,1,7,0,397,112,118,6
"b1cd0e7dc3ad4a8eb91a4bfdbeb025b0","b1cd0e7dc3ad4a8eb91a4bfdbeb025b0",22850590,1,0,1,398,118,118,0
"b1cd0e7dc3ad4a8eb91a4bfdbeb025b0","62bff51286ef4f348717a3cf6fe2318f",22850590,1,2,0,399,118,120,2
"62bff51286ef4f348717a3cf6fe2318f","62bff51286ef4f348717a3cf6fe2318f",22850590,5,0,1,400,120,120,0
"62bff51286ef4f348717a3cf6fe2318f","e20db35ced8544ddac5bc3839145e463",22850590,2,-33,0,403,120,91,-29
"e20db35ced8544ddac5bc3839145e463","779f9ddd1fd14d1e9e69f72219a1fdbd",22850590,2,36,0,404,91,121,30
"779f9ddd1fd14d1e9e69f72219a1fdbd","67a089198fcb4e1c8f2385786c2b296f",22850590,1,-103,0,405,121,39,-82
"67a089198fcb4e1c8f2385786c2b296f","78adeee1fa2c4fe0bc73f7bca9fcee86",22850590,1,152,0,406,39,160,121
"67a089198fcb4e1c8f2385786c2b296f","779f9ddd1fd14d1e9e69f72219a1fdbd",22850590,1,103,0,409,39,121,82
"779f9ddd1fd14d1e9e69f72219a1fdbd","779f9ddd1fd14d1e9e69f72219a1fdbd",22850590,2,0,1,410,121,121,0
"779f9ddd1fd14d1e9e69f72219a1fdbd","e20db35ced8544ddac5bc3839145e463",22850590,1,-36,0,412,121,91,-30
"e20db35ced8544ddac5bc3839145e463","62bff51286ef4f348717a3cf6fe2318f",22850590,1,33,0,413,91,120,29
"779f9ddd1fd14d1e9e69f72219a1fdbd","ae26e6cda8ad4a3f81bd347560d9579f",22850590,1,4,0,418,121,125,4
"ae26e6cda8ad4a3f81bd347560d9579f","ae26e6cda8ad4a3f81bd347560d9579f",22850590,3,0,1,419,125,125,0
"ae26e6cda8ad4a3f81bd347560d9579f","ee48df95832b4374aa273ceb27ec1315",22850590,1,1,0,422,125,126,1
"ee48df95832b4374aa273ceb27ec1315","ee48df95832b4374aa273ceb27ec1315",22850590,1,0,1,423,126,126,0
"ee48df95832b4374aa273ceb27ec1315","7a439da90b394756ad1777fc4c6dead5",22850590,1,1,0,424,126,127,1
"7a439da90b394756ad1777fc4c6dead5","7a439da90b394756ad1777fc4c6dead5",22850590,1,0,1,425,127,127,0
"7a439da90b394756ad1777fc4c6dead5","779f9ddd1fd14d1e9e69f72219a1fdbd",22850590,1,-6,0,426,127,121,-6
"779f9ddd1fd14d1e9e69f72219a1fdbd","a8dd5213034441ac92724b4e83eb0bb2",22850590,1,9,0,427,121,129,8
"a8dd5213034441ac92724b4e83eb0bb2","a8dd5213034441ac92724b4e83eb0bb2",22850590,2,0,1,428,129,129,0
"a8dd5213034441ac92724b4e83eb0bb2","8115eab6556b45f5b415c3b8c26a12e5",22850590,1,2,0,430,129,131,2
"8115eab6556b45f5b415c3b8c26a12e5","8115eab6556b45f5b415c3b8c26a12e5",22850590,2,0,1,431,131,131,0
"8115eab6556b45f5b415c3b8c26a12e5","ec34b06efd844b46a4c4818ecdb9b8f4",22850590,1,1,0,433,131,132,1
"ec34b06efd844b46a4c4818ecdb9b8f4","ec34b06efd844b46a4c4818ecdb9b8f4",22850590,2,0,1,434,132,132,0
"ec34b06efd844b46a4c4818ecdb9b8f4","c2e1c2b9eac64109b343a088584b576b",22850590,1,1,0,436,132,133,1
"c2e1c2b9eac64109b343a088584b576b","c2e1c2b9eac64109b343a088584b576b",22850590,2,0,1,437,133,133,0
"c2e1c2b9eac64109b343a088584b576b","579338175e0b4bbb8ef3b712b5d8b54e",22850590,1,-5,0,439,133,128,-5
"579338175e0b4bbb8ef3b712b5d8b54e","8bc5795d6a984a3eace4e2811e52dd4f",22850590,1,8,0,440,128,135,7
"8bc5795d6a984a3eace4e2811e52dd4f","8bc5795d6a984a3eace4e2811e52dd4f",22850590,1,0,1,441,135,135,0
"8bc5795d6a984a3eace4e2811e52dd4f","b416d47c56a742199b5d7c7f19d6503a",22850590,1,-1,0,442,135,134,-1
"b416d47c56a742199b5d7c7f19d6503a","cd4532ad48034873ba8bce2aac0c9808",22850590,1,4,0,443,134,137,3
"cd4532ad48034873ba8bce2aac0c9808","cd4532ad48034873ba8bce2aac0c9808",22850590,1,0,1,444,137,137,0
"cd4532ad48034873ba8bce2aac0c9808","779f9ddd1fd14d1e9e69f72219a1fdbd",22850590,1,-19,0,445,137,121,-16
"779f9ddd1fd14d1e9e69f72219a1fdbd","df1de691dafe4549a18a4398ee9dfaf9",22850590,3,23,0,446,121,139,18
"6c5ad271a44743479bfaea29b1db8d02","6c5ad271a44743479bfaea29b1db8d02",22850590,5,0,1,448,143,143,0
"6c5ad271a44743479bfaea29b1db8d02","83d311bed5374fee83d8d67a7d9d82dc",22850590,2,1,0,450,143,144,1
"83d311bed5374fee83d8d67a7d9d82dc","83d311bed5374fee83d8d67a7d9d82dc",22850590,2,0,1,451,144,144,0
"83d311bed5374fee83d8d67a7d9d82dc","402bba41861d43acb52a5abb89e8831e",22850590,2,1,0,452,144,145,1
"402bba41861d43acb52a5abb89e8831e","402bba41861d43acb52a5abb89e8831e",22850590,4,0,1,453,145,145,0
"402bba41861d43acb52a5abb89e8831e","df1de691dafe4549a18a4398ee9dfaf9",22850590,1,-6,0,455,145,139,-6
"df1de691dafe4549a18a4398ee9dfaf9","8aae34f5ddbb4052a709b12e6b0d40fa",22850590,3,9,0,456,139,147,8
"8aae34f5ddbb4052a709b12e6b0d40fa","6c5ad271a44743479bfaea29b1db8d02",22850590,2,-5,0,457,147,143,-4
"6c5ad271a44743479bfaea29b1db8d02","f902b0f41b544d4dbf79664fd233648d",22850590,3,4,0,458,143,146,3
"f902b0f41b544d4dbf79664fd233648d","8aae34f5ddbb4052a709b12e6b0d40fa",22850590,2,1,0,459,146,147,1
"f902b0f41b544d4dbf79664fd233648d","779f9ddd1fd14d1e9e69f72219a1fdbd",22850590,1,-31,0,463,146,121,-25
"df1de691dafe4549a18a4398ee9dfaf9","779f9ddd1fd14d1e9e69f72219a1fdbd",22850590,1,-23,0,465,139,121,-18
"6c5ad271a44743479bfaea29b1db8d02","df1de691dafe4549a18a4398ee9dfaf9",22850590,1,-4,0,471,143,139,-4
"8aae34f5ddbb4052a709b12e6b0d40fa","f902b0f41b544d4dbf79664fd233648d",22850590,1,-1,0,473,147,146,-1
"f902b0f41b544d4dbf79664fd233648d","f03480cf4eba413194d7af52fc0e7f28",22850590,2,7,0,474,146,152,6
"f03480cf4eba413194d7af52fc0e7f28","d313cec988a84645bee413e8d4724a4b",22850590,3,7,0,475,152,158,6
"d313cec988a84645bee413e8d4724a4b","f4ce60b4a944484082ccb701b48b3da1",22850590,1,-1,0,476,158,157,-1
"f4ce60b4a944484082ccb701b48b3da1","8aae34f5ddbb4052a709b12e6b0d40fa",22850590,1,-12,0,477,157,147,-10
"8aae34f5ddbb4052a709b12e6b0d40fa","8aae34f5ddbb4052a709b12e6b0d40fa",22850590,1,0,1,483,147,147,0
"8aae34f5ddbb4052a709b12e6b0d40fa","645b3f0249f64f76af2e19eb4d0e55b7",22850590,1,2,0,484,147,149,2
"645b3f0249f64f76af2e19eb4d0e55b7","645b3f0249f64f76af2e19eb4d0e55b7",22850590,5,0,1,485,149,149,0
"645b3f0249f64f76af2e19eb4d0e55b7","7e7b8db5064d4369805ab370aac5ddfb",22850590,1,1,0,490,149,150,1
"7e7b8db5064d4369805ab370aac5ddfb","7e7b8db5064d4369805ab370aac5ddfb",22850590,2,0,1,491,150,150,0
"7e7b8db5064d4369805ab370aac5ddfb","8956d210ae7f41968fada86d4c979d6a",22850590,1,1,0,493,150,151,1
"8956d210ae7f41968fada86d4c979d6a","8956d210ae7f41968fada86d4c979d6a",22850590,2,0,1,494,151,151,0
"8956d210ae7f41968fada86d4c979d6a","f902b0f41b544d4dbf79664fd233648d",22850590,1,-5,0,496,151,146,-5
"d313cec988a84645bee413e8d4724a4b","6c5ad271a44743479bfaea29b1db8d02",22850590,1,-18,0,499,158,143,-15
"6c5ad271a44743479bfaea29b1db8d02","f4ce60b4a944484082ccb701b48b3da1",22850590,1,17,0,500,143,157,14
"f4ce60b4a944484082ccb701b48b3da1","df1de691dafe4549a18a4398ee9dfaf9",22850590,1,-21,0,501,157,139,-18
"df1de691dafe4549a18a4398ee9dfaf9","ae781e8b775e4ccd93bc800dad5c8376",22850590,1,16,0,502,139,153,14
"ae781e8b775e4ccd93bc800dad5c8376","ae781e8b775e4ccd93bc800dad5c8376",22850590,2,0,1,503,153,153,0
"ae781e8b775e4ccd93bc800dad5c8376","06882a8492d9499aa31555567f575ecb",22850590,1,1,0,505,153,154,1
"06882a8492d9499aa31555567f575ecb","06882a8492d9499aa31555567f575ecb",22850590,1,0,1,506,154,154,0
"06882a8492d9499aa31555567f575ecb","f293c508f409466a8f27ddd7d1e40b20",22850590,1,1,0,507,154,155,1
"f293c508f409466a8f27ddd7d1e40b20","f293c508f409466a8f27ddd7d1e40b20",22850590,5,0,1,508,155,155,0
"f293c508f409466a8f27ddd7d1e40b20","cc4ddef5bbbe48ebb605141b347c4ed1",22850590,1,1,0,513,155,156,1
"cc4ddef5bbbe48ebb605141b347c4ed1","cc4ddef5bbbe48ebb605141b347c4ed1",22850590,1,0,1,514,156,156,0
"cc4ddef5bbbe48ebb605141b347c4ed1","d313cec988a84645bee413e8d4724a4b",22850590,1,3,0,515,156,158,2
"d313cec988a84645bee413e8d4724a4b","f03480cf4eba413194d7af52fc0e7f28",22850590,1,-7,0,516,158,152,-6
"d313cec988a84645bee413e8d4724a4b","d313cec988a84645bee413e8d4724a4b",22850590,3,0,1,518,158,158,0
"d313cec988a84645bee413e8d4724a4b","dc60696c76a74368a60f72246e47700d",22850590,1,1,0,521,158,159,1
"dc60696c76a74368a60f72246e47700d","dc60696c76a74368a60f72246e47700d",22850590,1,0,1,522,159,159,0
"dc60696c76a74368a60f72246e47700d","78adeee1fa2c4fe0bc73f7bca9fcee86",22850590,1,3,0,523,159,160,1
"78adeee1fa2c4fe0bc73f7bca9fcee86","df1de691dafe4549a18a4398ee9dfaf9",22850590,1,-26,0,524,160,139,-21
"df1de691dafe4549a18a4398ee9dfaf9","65202579580f4ad38d734b4ee39d22a8",22850590,1,31,0,525,139,164,25
"65202579580f4ad38d734b4ee39d22a8","65202579580f4ad38d734b4ee39d22a8",22850590,108,0,1,526,164,164,0
"65202579580f4ad38d734b4ee39d22a8","78adeee1fa2c4fe0bc73f7bca9fcee86",22850590,3,-5,0,530,164,160,-4
"78adeee1fa2c4fe0bc73f7bca9fcee86","65202579580f4ad38d734b4ee39d22a8",22850590,5,5,0,531,160,164,4
"65202579580f4ad38d734b4ee39d22a8","8959e6304a0348309a771e4d08d1b64a",22850590,1,-1,0,534,164,163,-1
"8959e6304a0348309a771e4d08d1b64a","65202579580f4ad38d734b4ee39d22a8",22850590,1,1,0,535,163,164,1
"65202579580f4ad38d734b4ee39d22a8","df1de691dafe4549a18a4398ee9dfaf9",22850590,1,-31,0,544,164,139,-25
"402bba41861d43acb52a5abb89e8831e","8aae34f5ddbb4052a709b12e6b0d40fa",22850590,1,3,0,552,145,147,2
"df1de691dafe4549a18a4398ee9dfaf9","d646286c8051419bbc2e31dd1db55ca8",22850590,1,-89,0,554,139,67,-72
"d646286c8051419bbc2e31dd1db55ca8","d646286c8051419bbc2e31dd1db55ca8",22850590,1,0,1,555,67,67,0
"d646286c8051419bbc2e31dd1db55ca8","6a9f0ef185fb47f0937e29daa1c71ed5",22850590,1,27,0,556,67,90,23
"6a9f0ef185fb47f0937e29daa1c71ed5","b7719e26494940efa49512aedd0aac79",22850590,1,-104,0,559,90,20,-70
"b7719e26494940efa49512aedd0aac79","a49d1bb4328949299686242fd0be5584",22850590,1,2,0,560,20,21,1
"a49d1bb4328949299686242fd0be5584","d4c3b003e8274e429d2fa688d73fde6d",22850590,1,1,0,561,21,22,1
"d4c3b003e8274e429d2fa688d73fde6d","d4f45188d3c84a02ba08454e6403a818",22850590,3,2,0,562,22,24,2
"d4f45188d3c84a02ba08454e6403a818","5bc03c8f16354d04bd51f5bb93559ad3",22850590,1,2,0,563,24,26,2
"5bc03c8f16354d04bd51f5bb93559ad3","b7719e26494940efa49512aedd0aac79",22850590,1,-7,0,564,26,20,-6
"b7719e26494940efa49512aedd0aac79","d4c3b003e8274e429d2fa688d73fde6d",22850590,2,3,0,565,20,22,2
"d4f45188d3c84a02ba08454e6403a818","3cbcea2be0984e7dbd5a48195af10ce7",22850590,1,195,0,567,24,165,141
"3cbcea2be0984e7dbd5a48195af10ce7","3cbcea2be0984e7dbd5a48195af10ce7",22850590,1,0,1,568,165,165,0
"3cbcea2be0984e7dbd5a48195af10ce7","82e6285962b8400d9d6fc32436022a94",22850590,2,2,0,569,165,167,2
"82e6285962b8400d9d6fc32436022a94","67a089198fcb4e1c8f2385786c2b296f",22850590,1,-162,0,570,167,39,-128
"67a089198fcb4e1c8f2385786c2b296f","a9ac840f098c4bd0a2ee896214ce29cd",22850590,1,165,0,571,39,168,129
"a9ac840f098c4bd0a2ee896214ce29cd","a9ac840f098c4bd0a2ee896214ce29cd",22850590,1,0,1,572,168,168,0
"a9ac840f098c4bd0a2ee896214ce29cd","78adeee1fa2c4fe0bc73f7bca9fcee86",22850590,1,-13,0,573,168,160,-8
"78adeee1fa2c4fe0bc73f7bca9fcee86","a9ac840f098c4bd0a2ee896214ce29cd",22850590,1,13,0,575,160,168,8
"a9ac840f098c4bd0a2ee896214ce29cd","3cbcea2be0984e7dbd5a48195af10ce7",22850590,1,-5,0,576,168,165,-3
"3cbcea2be0984e7dbd5a48195af10ce7","a9ac840f098c4bd0a2ee896214ce29cd",22850590,2,5,0,577,165,168,3
"a9ac840f098c4bd0a2ee896214ce29cd","82e6285962b8400d9d6fc32436022a94",22850590,1,-3,0,578,168,167,-1
"82e6285962b8400d9d6fc32436022a94","3cbcea2be0984e7dbd5a48195af10ce7",22850590,2,-2,0,579,167,165,-2
"3cbcea2be0984e7dbd5a48195af10ce7","78adeee1fa2c4fe0bc73f7bca9fcee86",22850590,1,-8,0,580,165,160,-5
"78adeee1fa2c4fe0bc73f7bca9fcee86","3cbcea2be0984e7dbd5a48195af10ce7",22850590,1,8,0,663,160,165,5
"a9ac840f098c4bd0a2ee896214ce29cd","0c7262dff33c4087bc660ccf40f92f9c",22850590,1,4,0,667,168,169,1
"0c7262dff33c4087bc660ccf40f92f9c","a9ac840f098c4bd0a2ee896214ce29cd",22850590,1,-4,0,668,169,168,-1
"a9ac840f098c4bd0a2ee896214ce29cd","b2275c3fad834f8d90737a2d9a6927d6",22850590,1,7,0,669,168,172,4
"b2275c3fad834f8d90737a2d9a6927d6","0c7262dff33c4087bc660ccf40f92f9c",22850590,1,-3,0,670,172,169,-3
"0d987bed3ffa4ed0b9a2e62e97b7b30f","0c7262dff33c4087bc660ccf40f92f9c",22850590,1,-135,0,675,272,169,-103
"0c7262dff33c4087bc660ccf40f92f9c","78adeee1fa2c4fe0bc73f7bca9fcee86",22850590,1,-17,0,676,169,160,-9
"65202579580f4ad38d734b4ee39d22a8","67a089198fcb4e1c8f2385786c2b296f",22850590,1,-157,0,685,164,39,-125
"67a089198fcb4e1c8f2385786c2b296f","0c7262dff33c4087bc660ccf40f92f9c",22850590,1,169,0,686,39,169,130
"0c7262dff33c4087bc660ccf40f92f9c","0c7262dff33c4087bc660ccf40f92f9c",22850590,2,0,1,687,169,169,0
"0c7262dff33c4087bc660ccf40f92f9c","b2275c3fad834f8d90737a2d9a6927d6",22850590,1,3,0,688,169,172,3
"b2275c3fad834f8d90737a2d9a6927d6","b2275c3fad834f8d90737a2d9a6927d6",22850590,20,0,1,689,172,172,0
"b2275c3fad834f8d90737a2d9a6927d6","eb515a26030b41f8a82a1e6114420bad",22850590,1,1,0,709,172,173,1
"eb515a26030b41f8a82a1e6114420bad","eb515a26030b41f8a82a1e6114420bad",22850590,2,0,1,710,173,173,0
"eb515a26030b41f8a82a1e6114420bad","0c7262dff33c4087bc660ccf40f92f9c",22850590,1,-4,0,712,173,169,-4
"0c7262dff33c4087bc660ccf40f92f9c","b42cc17b7de840f181a704558d0bc845",22850590,2,7,0,713,169,175,6
"b42cc17b7de840f181a704558d0bc845","b42cc17b7de840f181a704558d0bc845",22850590,11,0,1,714,175,175,0
"b42cc17b7de840f181a704558d0bc845","801f9e9135034f49bf5f8b4bdefedb41",22850590,1,2,0,724,175,177,2
"801f9e9135034f49bf5f8b4bdefedb41","801f9e9135034f49bf5f8b4bdefedb41",22850590,4,0,1,725,177,177,0
"801f9e9135034f49bf5f8b4bdefedb41","362fcb0699a14845ab29b2340093e528",22850590,1,-3,0,729,177,174,-3
"362fcb0699a14845ab29b2340093e528","ea38cc0e6e6e41edbabf210220808bf9",22850590,2,6,0,730,174,179,5
"ea38cc0e6e6e41edbabf210220808bf9","b87c552dd247427abe6ab5795b9c9d43",22850590,4,2,0,731,179,181,2
"b87c552dd247427abe6ab5795b9c9d43","0c7262dff33c4087bc660ccf40f92f9c",22850590,2,-14,0,732,181,169,-12
"b42cc17b7de840f181a704558d0bc845","362fcb0699a14845ab29b2340093e528",22850590,1,-1,0,735,175,174,-1
"0c7262dff33c4087bc660ccf40f92f9c","139b097acfca451689d80c9c6eebdf7b",22850590,1,11,0,739,169,178,9
"139b097acfca451689d80c9c6eebdf7b","0c7262dff33c4087bc660ccf40f92f9c",22850590,1,-11,0,740,178,169,-9
"0c7262dff33c4087bc660ccf40f92f9c","ea38cc0e6e6e41edbabf210220808bf9",22850590,1,12,0,741,169,179,10
"b87c552dd247427abe6ab5795b9c9d43","ea38cc0e6e6e41edbabf210220808bf9",22850590,1,-2,0,743,181,179,-2
"ea38cc0e6e6e41edbabf210220808bf9","ea38cc0e6e6e41edbabf210220808bf9",22850590,2,0,1,744,179,179,0
"b87c552dd247427abe6ab5795b9c9d43","b87c552dd247427abe6ab5795b9c9d43",22850590,7,0,1,747,181,181,0
"b87c552dd247427abe6ab5795b9c9d43","139b097acfca451689d80c9c6eebdf7b",22850590,1,-3,0,754,181,178,-3
"139b097acfca451689d80c9c6eebdf7b","30f660a1feb34582a739722532524f79",22850590,1,6,0,755,178,183,5
"30f660a1feb34582a739722532524f79","30f660a1feb34582a739722532524f79",22850590,5,0,1,756,183,183,0
"30f660a1feb34582a739722532524f79","2024b4885bd14338a39b7b509acbbd02",22850590,1,-1,0,761,183,182,-1
"2024b4885bd14338a39b7b509acbbd02","c3f63fe50d8e487c86bf8ef76c9cadd3",22850590,1,4,0,762,182,185,3
"c3f63fe50d8e487c86bf8ef76c9cadd3","c3f63fe50d8e487c86bf8ef76c9cadd3",22850590,3,0,1,763,185,185,0
"c3f63fe50d8e487c86bf8ef76c9cadd3","cf4c280bad6a43e6b131d8385ef9ef3f",22850590,1,-1,0,766,185,184,-1
"cf4c280bad6a43e6b131d8385ef9ef3f","cf4c280bad6a43e6b131d8385ef9ef3f",22850590,1,0,1,767,184,184,0
"cf4c280bad6a43e6b131d8385ef9ef3f","2024b4885bd14338a39b7b509acbbd02",22850590,1,-3,0,768,184,182,-2
"2024b4885bd14338a39b7b509acbbd02","c8e371568a0c4391b25796ae4e91952e",22850590,1,7,0,769,182,186,4
"c8e371568a0c4391b25796ae4e91952e","0c7262dff33c4087bc660ccf40f92f9c",22850590,1,-23,0,770,186,169,-17
"0c7262dff33c4087bc660ccf40f92f9c","c8e371568a0c4391b25796ae4e91952e",22850590,1,23,0,772,169,186,17
"c8e371568a0c4391b25796ae4e91952e","c8e371568a0c4391b25796ae4e91952e",22850590,1,0,1,773,186,186,0
"c8e371568a0c4391b25796ae4e91952e","7d932b23e1c84326ae5aa4d3c0d813d1",22850590,1,2,0,774,186,188,2
"7d932b23e1c84326ae5aa4d3c0d813d1","7d932b23e1c84326ae5aa4d3c0d813d1",22850590,1,0,1,775,188,188,0
"7d932b23e1c84326ae5aa4d3c0d813d1","ab11d94c6c8948ea90b88f19d2cd502b",22850590,1,3,0,776,188,190,2
"ab11d94c6c8948ea90b88f19d2cd502b","c8e371568a0c4391b25796ae4e91952e",22850590,1,-5,0,777,190,186,-4
"c8e371568a0c4391b25796ae4e91952e","ab11d94c6c8948ea90b88f19d2cd502b",22850590,1,5,0,778,186,190,4
"ab11d94c6c8948ea90b88f19d2cd502b","ab11d94c6c8948ea90b88f19d2cd502b",22850590,2,0,1,779,190,190,0
"ab11d94c6c8948ea90b88f19d2cd502b","f992451ed6ad4e68bb9e68ad6be7c4be",22850590,1,2,0,781,190,192,2
"f992451ed6ad4e68bb9e68ad6be7c4be","f992451ed6ad4e68bb9e68ad6be7c4be",22850590,3,0,1,782,192,192,0
"f992451ed6ad4e68bb9e68ad6be7c4be","07b44a7a51e94c78b411c753fc39dab0",22850590,1,-3,0,785,192,189,-3
"07b44a7a51e94c78b411c753fc39dab0","6cd2dcaac46847d4a0bc53f296d90375",22850590,1,6,0,786,189,194,5
"6cd2dcaac46847d4a0bc53f296d90375","6cd2dcaac46847d4a0bc53f296d90375",22850590,3,0,1,787,194,194,0
"6cd2dcaac46847d4a0bc53f296d90375","2d2580c9411c4972909db508d6956a58",22850590,1,2,0,790,194,196,2
"2d2580c9411c4972909db508d6956a58","2d2580c9411c4972909db508d6956a58",22850590,2,0,1,791,196,196,0
"2d2580c9411c4972909db508d6956a58","5bddb3d9ed264f3984702f048c7e5340",22850590,1,1,0,793,196,197,1
"5bddb3d9ed264f3984702f048c7e5340","5bddb3d9ed264f3984702f048c7e5340",22850590,2,0,1,794,197,197,0
"5bddb3d9ed264f3984702f048c7e5340","d5e8e2bd12a2466b9d6d90855f0eb079",22850590,1,1,0,796,197,198,1
"d5e8e2bd12a2466b9d6d90855f0eb079","d5e8e2bd12a2466b9d6d90855f0eb079",22850590,2,0,1,797,198,198,0
"d5e8e2bd12a2466b9d6d90855f0eb079","017d7ca8e0394b91aaadc9574df2202c",22850590,1,-5,0,799,198,193,-5
"017d7ca8e0394b91aaadc9574df2202c","54e8e9f0ea3e45c4bf3b8ac799ee31b1",22850590,1,8,0,800,193,200,7
"54e8e9f0ea3e45c4bf3b8ac799ee31b1","54e8e9f0ea3e45c4bf3b8ac799ee31b1",22850590,1,0,1,801,200,200,0
"54e8e9f0ea3e45c4bf3b8ac799ee31b1","c614a00911be4877a075f19315530fb0",22850590,1,1,0,802,200,201,1
"c614a00911be4877a075f19315530fb0","c614a00911be4877a075f19315530fb0",22850590,6,0,1,803,201,201,0
"c614a00911be4877a075f19315530fb0","a6c21bd8b95249c7972820a7a7d76aff",22850590,1,1,0,809,201,202,1
"a6c21bd8b95249c7972820a7a7d76aff","a6c21bd8b95249c7972820a7a7d76aff",22850590,1,0,1,810,202,202,0
"a6c21bd8b95249c7972820a7a7d76aff","bb329d880ab54120adaf203a693bb203",22850590,1,1,0,811,202,203,1
"bb329d880ab54120adaf203a693bb203","bb329d880ab54120adaf203a693bb203",22850590,1,0,1,812,203,203,0
"bb329d880ab54120adaf203a693bb203","f9170dd6bc6442b4acd832747609b09a",22850590,1,-4,0,813,203,199,-4
"f9170dd6bc6442b4acd832747609b09a","334c2344009840079b1d0e1b7ce3d5a7",22850590,1,7,0,814,199,205,6
"334c2344009840079b1d0e1b7ce3d5a7","334c2344009840079b1d0e1b7ce3d5a7",22850590,1,0,1,815,205,205,0
"334c2344009840079b1d0e1b7ce3d5a7","d7f13c8d63ec4e2aa673fbb9cf9c6933",22850590,1,3,0,816,205,206,1
"d7f13c8d63ec4e2aa673fbb9cf9c6933","c8e371568a0c4391b25796ae4e91952e",22850590,3,-26,0,817,206,186,-20
"c8e371568a0c4391b25796ae4e91952e","b9e80f77c3a44349863b19875725c384",22850590,2,27,0,818,186,207,21
"b9e80f77c3a44349863b19875725c384","7108f0e4c2584f1f9c471689ae4c885c",22850590,3,1,0,819,207,208,1
"7108f0e4c2584f1f9c471689ae4c885c","d7f13c8d63ec4e2aa673fbb9cf9c6933",22850590,1,-2,0,820,208,206,-2
"c8e371568a0c4391b25796ae4e91952e","78adeee1fa2c4fe0bc73f7bca9fcee86",22850590,1,-40,0,822,186,160,-26
"65202579580f4ad38d734b4ee39d22a8","c8e371568a0c4391b25796ae4e91952e",22850590,1,35,0,833,164,186,22
"c8e371568a0c4391b25796ae4e91952e","d7f13c8d63ec4e2aa673fbb9cf9c6933",22850590,1,26,0,834,186,206,20
"7108f0e4c2584f1f9c471689ae4c885c","b9e80f77c3a44349863b19875725c384",22850590,2,-1,0,838,208,207,-1
"b9e80f77c3a44349863b19875725c384","b9e80f77c3a44349863b19875725c384",22850590,26,0,1,839,207,207,0
"7108f0e4c2584f1f9c471689ae4c885c","7108f0e4c2584f1f9c471689ae4c885c",22850590,11,0,1,852,208,208,0
"b9e80f77c3a44349863b19875725c384","09400e101c5d4b439cf9a26b03aae558",22850590,1,4,0,878,207,210,3
"09400e101c5d4b439cf9a26b03aae558","d7f13c8d63ec4e2aa673fbb9cf9c6933",22850590,1,-5,0,879,210,206,-4
"d7f13c8d63ec4e2aa673fbb9cf9c6933","09400e101c5d4b439cf9a26b03aae558",22850590,1,5,0,880,206,210,4
"09400e101c5d4b439cf9a26b03aae558","09400e101c5d4b439cf9a26b03aae558",22850590,7,0,1,881,210,210,0
"09400e101c5d4b439cf9a26b03aae558","a88efa7e50ce47159810ab553afa6d3a",22850590,1,2,0,888,210,212,2
"a88efa7e50ce47159810ab553afa6d3a","a88efa7e50ce47159810ab553afa6d3a",22850590,5,0,1,889,212,212,0
"a88efa7e50ce47159810ab553afa6d3a","f7fb1952f56b4189b86a9f8b7862d2b8",22850590,1,4,0,894,212,215,3
"f7fb1952f56b4189b86a9f8b7862d2b8","be502a7a43c44bf7b682698de79d9369",22850590,1,-1,0,895,215,214,-1
"be502a7a43c44bf7b682698de79d9369","a875096404ef4a9984b62d74cda916f9",22850590,1,-6,0,896,214,209,-5
"a875096404ef4a9984b62d74cda916f9","be502a7a43c44bf7b682698de79d9369",22850590,1,6,0,897,209,214,5
"be502a7a43c44bf7b682698de79d9369","be502a7a43c44bf7b682698de79d9369",22850590,2,0,1,898,214,214,0
"be502a7a43c44bf7b682698de79d9369","f7fb1952f56b4189b86a9f8b7862d2b8",22850590,1,1,0,900,214,215,1
"f7fb1952f56b4189b86a9f8b7862d2b8","f7fb1952f56b4189b86a9f8b7862d2b8",22850590,13,0,1,901,215,215,0
"f7fb1952f56b4189b86a9f8b7862d2b8","b860ee85d8bc4a2f97958cfb71be3533",22850590,1,1,0,914,215,216,1
"b860ee85d8bc4a2f97958cfb71be3533","b860ee85d8bc4a2f97958cfb71be3533",22850590,2,0,1,915,216,216,0
"b860ee85d8bc4a2f97958cfb71be3533","ec341f459285443b8361f7f15638ff08",22850590,1,-3,0,917,216,213,-3
"ec341f459285443b8361f7f15638ff08","363837c182e04711840d896ae1e0339c",22850590,1,6,0,918,213,218,5
"363837c182e04711840d896ae1e0339c","363837c182e04711840d896ae1e0339c",22850590,17,0,1,919,218,218,0
"363837c182e04711840d896ae1e0339c","01b2051f8941460d89945e3b02d1ce78",22850590,1,-1,0,936,218,217,-1
"01b2051f8941460d89945e3b02d1ce78","91125ca626c5470eb145501f8c37f8db",22850590,1,4,0,937,217,220,3
"91125ca626c5470eb145501f8c37f8db","91125ca626c5470eb145501f8c37f8db",22850590,1,0,1,938,220,220,0
"91125ca626c5470eb145501f8c37f8db","d7f13c8d63ec4e2aa673fbb9cf9c6933",22850590,1,-18,0,939,220,206,-14
"d7f13c8d63ec4e2aa673fbb9cf9c6933","1c6721b1f63f4d30ba7746ea8af02a52",22850590,1,21,0,940,206,221,15
"1c6721b1f63f4d30ba7746ea8af02a52","77ecef8eff6b4a2caea7707669bf7475",22850590,1,1,0,941,221,222,1
"77ecef8eff6b4a2caea7707669bf7475","77ecef8eff6b4a2caea7707669bf7475",22850590,14,0,1,942,222,222,0
"77ecef8eff6b4a2caea7707669bf7475","d03cb855c70044cf8c35d9ec0de696e3",22850590,1,3,0,956,222,224,2
"d03cb855c70044cf8c35d9ec0de696e3","1c6721b1f63f4d30ba7746ea8af02a52",22850590,1,-4,0,957,224,221,-3
"1c6721b1f63f4d30ba7746ea8af02a52","8b9ae98743bd4d4a8a87dff1c1244211",22850590,1,7,0,958,221,227,6
"8b9ae98743bd4d4a8a87dff1c1244211","d03cb855c70044cf8c35d9ec0de696e3",22850590,1,-3,0,959,227,224,-3
"d03cb855c70044cf8c35d9ec0de696e3","d03cb855c70044cf8c35d9ec0de696e3",22850590,1,0,1,960,224,224,0
"d03cb855c70044cf8c35d9ec0de696e3","a49a937d6896486d9a5396654abcf2e1",22850590,1,2,0,961,224,226,2
"a49a937d6896486d9a5396654abcf2e1","a49a937d6896486d9a5396654abcf2e1",22850590,3,0,1,962,226,226,0
"a49a937d6896486d9a5396654abcf2e1","8b9ae98743bd4d4a8a87dff1c1244211",22850590,1,1,0,965,226,227,1
"8b9ae98743bd4d4a8a87dff1c1244211","8b9ae98743bd4d4a8a87dff1c1244211",22850590,19,0,1,966,227,227,0
"8b9ae98743bd4d4a8a87dff1c1244211","1c6721b1f63f4d30ba7746ea8af02a52",22850590,1,-7,0,983,227,221,-6
"1c6721b1f63f4d30ba7746ea8af02a52","d03cb855c70044cf8c35d9ec0de696e3",22850590,1,4,0,984,221,224,3
"d03cb855c70044cf8c35d9ec0de696e3","8b9ae98743bd4d4a8a87dff1c1244211",22850590,2,3,0,985,224,227,3
"8b9ae98743bd4d4a8a87dff1c1244211","f7906d6f59b9489a91d2ef40db5a474d",22850590,1,-4,0,988,227,223,-4
"f7906d6f59b9489a91d2ef40db5a474d","2ab1535aac1346ba8801535bf729ef37",22850590,1,7,0,989,223,229,6
"2ab1535aac1346ba8801535bf729ef37","5152833676bf4c6cb317060be10f68db",22850590,1,-1,0,991,229,228,-1
"5152833676bf4c6cb317060be10f68db","5152833676bf4c6cb317060be10f68db",22850590,1,0,1,992,228,228,0
"5152833676bf4c6cb317060be10f68db","d03cb855c70044cf8c35d9ec0de696e3",22850590,1,-5,0,993,228,224,-4
"8b9ae98743bd4d4a8a87dff1c1244211","2ab1535aac1346ba8801535bf729ef37",22850590,1,3,0,995,227,229,2
"2ab1535aac1346ba8801535bf729ef37","f7906d6f59b9489a91d2ef40db5a474d",22850590,1,-7,0,996,229,223,-6
"f7906d6f59b9489a91d2ef40db5a474d","5152833676bf4c6cb317060be10f68db",22850590,1,6,0,997,223,228,5
"5152833676bf4c6cb317060be10f68db","0b04c8e2f86d48c7aeb7e225819cd32b",22850590,1,7,0,998,228,234,6
"0b04c8e2f86d48c7aeb7e225819cd32b","2ab1535aac1346ba8801535bf729ef37",22850590,1,-6,0,999,234,229,-5
"2ab1535aac1346ba8801535bf729ef37","64dbedb3ce544f6aae8e10e0cf10f16d",22850590,1,13,0,1000,229,240,11
"64dbedb3ce544f6aae8e10e0cf10f16d","2ab1535aac1346ba8801535bf729ef37",22850590,1,-13,0,1001,240,229,-11
"2ab1535aac1346ba8801535bf729ef37","2ab1535aac1346ba8801535bf729ef37",22850590,2,0,1,1002,229,229,0
"2ab1535aac1346ba8801535bf729ef37","a4f40fb48a8542c8949bae1f002cd9bc",22850590,1,2,0,1003,229,231,2
"a4f40fb48a8542c8949bae1f002cd9bc","a4f40fb48a8542c8949bae1f002cd9bc",22850590,5,0,1,1004,231,231,0
"a4f40fb48a8542c8949bae1f002cd9bc","8972c23e32044edb8a78fa1eed4e5947",22850590,1,1,0,1009,231,232,1
"8972c23e32044edb8a78fa1eed4e5947","8972c23e32044edb8a78fa1eed4e5947",22850590,1,0,1,1010,232,232,0
"8972c23e32044edb8a78fa1eed4e5947","92feb4a40f8344d38b6f722e42a53295",22850590,1,1,0,1011,232,233,1
"92feb4a40f8344d38b6f722e42a53295","92feb4a40f8344d38b6f722e42a53295",22850590,2,0,1,1012,233,233,0
"92feb4a40f8344d38b6f722e42a53295","5152833676bf4c6cb317060be10f68db",22850590,1,-5,0,1014,233,228,-5
"5152833676bf4c6cb317060be10f68db","ca3e28f290354c08aefe5b0f769604e6",22850590,1,8,0,1015,228,235,7
"ca3e28f290354c08aefe5b0f769604e6","ca3e28f290354c08aefe5b0f769604e6",22850590,4,0,1,1016,235,235,0
"ca3e28f290354c08aefe5b0f769604e6","79a35eea833e4c2c9d22fc53c3c6445c",22850590,1,1,0,1020,235,236,1
"79a35eea833e4c2c9d22fc53c3c6445c","79a35eea833e4c2c9d22fc53c3c6445c",22850590,9,0,1,1021,236,236,0
"79a35eea833e4c2c9d22fc53c3c6445c","8f68228b1518449e9615cdafee41a2bd",22850590,1,1,0,1030,236,237,1
"8f68228b1518449e9615cdafee41a2bd","8f68228b1518449e9615cdafee41a2bd",22850590,1,0,1,1031,237,237,0
"8f68228b1518449e9615cdafee41a2bd","cab89fa5c3ed45a5aa550fc0352d6a42",22850590,1,1,0,1032,237,238,1
"cab89fa5c3ed45a5aa550fc0352d6a42","cab89fa5c3ed45a5aa550fc0352d6a42",22850590,1,0,1,1033,238,238,0
"cab89fa5c3ed45a5aa550fc0352d6a42","66d4fad4f1cf4b46be0750a99ad7a35a",22850590,1,1,0,1034,238,239,1
"66d4fad4f1cf4b46be0750a99ad7a35a","66d4fad4f1cf4b46be0750a99ad7a35a",22850590,1,0,1,1035,239,239,0
"66d4fad4f1cf4b46be0750a99ad7a35a","0b04c8e2f86d48c7aeb7e225819cd32b",22850590,1,-5,0,1036,239,234,-5
"0b04c8e2f86d48c7aeb7e225819cd32b","f53da5fd9bfe412da4b80d4742563b6c",22850590,1,8,0,1037,234,241,7
"f53da5fd9bfe412da4b80d4742563b6c","f53da5fd9bfe412da4b80d4742563b6c",22850590,1,0,1,1038,241,241,0
"f53da5fd9bfe412da4b80d4742563b6c","1c6721b1f63f4d30ba7746ea8af02a52",22850590,1,-24,0,1039,241,221,-20
"1c6721b1f63f4d30ba7746ea8af02a52","2ae94c0cea4d480a9d5dca8fb1d7b542",22850590,1,27,0,1040,221,242,21
"2ae94c0cea4d480a9d5dca8fb1d7b542","1ebf23f9d994469a85206e4c7b1bf5f5",22850590,3,3,0,1041,242,245,3
"1ebf23f9d994469a85206e4c7b1bf5f5","2ae94c0cea4d480a9d5dca8fb1d7b542",22850590,1,-3,0,1042,245,242,-3
"1ebf23f9d994469a85206e4c7b1bf5f5","0c7262dff33c4087bc660ccf40f92f9c",22850590,1,-100,0,1044,245,169,-76
"0c7262dff33c4087bc660ccf40f92f9c","2ae94c0cea4d480a9d5dca8fb1d7b542",22850590,1,97,0,1045,169,242,73
"2ae94c0cea4d480a9d5dca8fb1d7b542","2ae94c0cea4d480a9d5dca8fb1d7b542",22850590,1,0,1,1046,242,242,0
"1ebf23f9d994469a85206e4c7b1bf5f5","1ebf23f9d994469a85206e4c7b1bf5f5",22850590,11,0,1,1048,245,245,0
"1ebf23f9d994469a85206e4c7b1bf5f5","85ae675b83e8422da842cfd25596af99",22850590,1,1,0,1059,245,246,1
"85ae675b83e8422da842cfd25596af99","85ae675b83e8422da842cfd25596af99",22850590,1,0,1,1060,246,246,0
"85ae675b83e8422da842cfd25596af99","fa235f0f364d47e4ae1c87f47bf8e6ba",22850590,1,8,0,1061,246,252,6
"fa235f0f364d47e4ae1c87f47bf8e6ba","2ae94c0cea4d480a9d5dca8fb1d7b542",22850590,1,-12,0,1062,252,242,-10
"2ae94c0cea4d480a9d5dca8fb1d7b542","fa235f0f364d47e4ae1c87f47bf8e6ba",22850590,1,12,0,1063,242,252,10
"fa235f0f364d47e4ae1c87f47bf8e6ba","fa235f0f364d47e4ae1c87f47bf8e6ba",22850590,5,0,1,1064,252,252,0
"fa235f0f364d47e4ae1c87f47bf8e6ba","79f7845465cc4ed19d8e4f1429541be0",22850590,1,2,0,1069,252,254,2
"79f7845465cc4ed19d8e4f1429541be0","79f7845465cc4ed19d8e4f1429541be0",22850590,2,0,1,1070,254,254,0
"79f7845465cc4ed19d8e4f1429541be0","00f61990949545828dd12f1303d47504",22850590,1,3,0,1072,254,256,2
"00f61990949545828dd12f1303d47504","6e83e23f56544a19b94067c1c558d9c0",22850590,1,-11,0,1073,256,247,-9
"6e83e23f56544a19b94067c1c558d9c0","00f61990949545828dd12f1303d47504",22850590,2,11,0,1074,247,256,9
"00f61990949545828dd12f1303d47504","00f61990949545828dd12f1303d47504",22850590,3,0,1,1075,256,256,0
"00f61990949545828dd12f1303d47504","ead7bb4b64e247d2ae632ab8a296b091",22850590,1,2,0,1078,256,258,2
"ead7bb4b64e247d2ae632ab8a296b091","ead7bb4b64e247d2ae632ab8a296b091",22850590,5,0,1,1079,258,258,0
"ead7bb4b64e247d2ae632ab8a296b091","41b0048dde734bb280bac6116baa8e27",22850590,1,1,0,1084,258,259,1
"41b0048dde734bb280bac6116baa8e27","41b0048dde734bb280bac6116baa8e27",22850590,2,0,1,1085,259,259,0
"41b0048dde734bb280bac6116baa8e27","b41c5a094a604ee0915327da5cc0beb7",22850590,1,1,0,1087,259,260,1
"b41c5a094a604ee0915327da5cc0beb7","b41c5a094a604ee0915327da5cc0beb7",22850590,5,0,1,1088,260,260,0
"b41c5a094a604ee0915327da5cc0beb7","d546341988904f069cfa86b21457d9d9",22850590,1,-10,0,1093,260,251,-9
"d546341988904f069cfa86b21457d9d9","28c171777c52431ab6b925073bd63d46",22850590,1,15,0,1094,251,264,13
"28c171777c52431ab6b925073bd63d46","28c171777c52431ab6b925073bd63d46",22850590,3,0,1,1095,264,264,0
"28c171777c52431ab6b925073bd63d46","ac160db940cb49ae8579162b1d52bb5d",22850590,1,2,0,1098,264,266,2
"ac160db940cb49ae8579162b1d52bb5d","ac160db940cb49ae8579162b1d52bb5d",22850590,3,0,1,1099,266,266,0
"ac160db940cb49ae8579162b1d52bb5d","d989ebcfc12a4b669f0100dc1aa14f1e",22850590,1,-12,0,1102,266,255,-11
"d989ebcfc12a4b669f0100dc1aa14f1e","c6fd49b485cc4874b0bbdd9c6171e09c",22850590,1,15,0,1103,255,268,13
"c6fd49b485cc4874b0bbdd9c6171e09c","c6fd49b485cc4874b0bbdd9c6171e09c",22850590,3,0,1,1104,268,268,0
"c6fd49b485cc4874b0bbdd9c6171e09c","44240778a97c4af0937817499b75707b",22850590,1,1,0,1107,268,269,1
"44240778a97c4af0937817499b75707b","44240778a97c4af0937817499b75707b",22850590,5,0,1,1108,269,269,0
"44240778a97c4af0937817499b75707b","7aa76d3e993840d8805f097cbdbcd44b",22850590,1,-9,0,1113,269,261,-8
"7aa76d3e993840d8805f097cbdbcd44b","865a4d3b43374da7944dc7d397f566d9",22850590,1,12,0,1114,261,271,10
"865a4d3b43374da7944dc7d397f566d9","865a4d3b43374da7944dc7d397f566d9",22850590,1,0,1,1115,271,271,0
"865a4d3b43374da7944dc7d397f566d9","0d987bed3ffa4ed0b9a2e62e97b7b30f",22850590,1,3,0,1116,271,272,1
"0d987bed3ffa4ed0b9a2e62e97b7b30f","2ae94c0cea4d480a9d5dca8fb1d7b542",22850590,1,-38,0,1117,272,242,-30
"2ae94c0cea4d480a9d5dca8fb1d7b542","0d987bed3ffa4ed0b9a2e62e97b7b30f",22850590,1,38,0,1118,242,272,30
"0d987bed3ffa4ed0b9a2e62e97b7b30f","bb5a47f5ea01454a8b79455422d3b9da",22850590,8,10,0,1119,272,280,8
"bb5a47f5ea01454a8b79455422d3b9da","82ae07bc0c9b4570a41799290d1ef399",22850590,2,-6,0,1120,280,275,-5
"82ae07bc0c9b4570a41799290d1ef399","bb5a47f5ea01454a8b79455422d3b9da",22850590,3,6,0,1121,275,280,5
"bb5a47f5ea01454a8b79455422d3b9da","bb5a47f5ea01454a8b79455422d3b9da",22850590,133,0,1,1122,280,280,0
"bb5a47f5ea01454a8b79455422d3b9da","bc5524e78a8544e2ae2fdc2f3462bbec",22850590,5,-1,0,1128,280,279,-1
"bc5524e78a8544e2ae2fdc2f3462bbec","0d987bed3ffa4ed0b9a2e62e97b7b30f",22850590,3,-9,0,1129,279,272,-7
"bb5a47f5ea01454a8b79455422d3b9da","0c7262dff33c4087bc660ccf40f92f9c",22850590,2,-145,0,1138,280,169,-111
"0c7262dff33c4087bc660ccf40f92f9c","0d987bed3ffa4ed0b9a2e62e97b7b30f",22850590,3,135,0,1139,169,272,103
"bc5524e78a8544e2ae2fdc2f3462bbec","82ae07bc0c9b4570a41799290d1ef399",22850590,1,-5,0,1149,279,275,-4
"82ae07bc0c9b4570a41799290d1ef399","0d987bed3ffa4ed0b9a2e62e97b7b30f",22850590,3,-4,0,1150,275,272,-3
"0d987bed3ffa4ed0b9a2e62e97b7b30f","0d987bed3ffa4ed0b9a2e62e97b7b30f",22850590,3,0,1,1161,272,272,0
"0d987bed3ffa4ed0b9a2e62e97b7b30f","82ae07bc0c9b4570a41799290d1ef399",22850590,3,4,0,1163,272,275,3
"bb5a47f5ea01454a8b79455422d3b9da","0d987bed3ffa4ed0b9a2e62e97b7b30f",22850590,3,-10,0,1172,280,272,-8
"bc5524e78a8544e2ae2fdc2f3462bbec","bb5a47f5ea01454a8b79455422d3b9da",22850590,1,1,0,1219,279,280,1
"0d987bed3ffa4ed0b9a2e62e97b7b30f","94cecc3f1e7d484b8e068e79241dfd73",22850590,2,13,0,1279,272,281,9
"94cecc3f1e7d484b8e068e79241dfd73","a37477c4e4c14169ad44b06b493007f6",22850590,2,2,0,1280,281,283,2
"a37477c4e4c14169ad44b06b493007f6","94cecc3f1e7d484b8e068e79241dfd73",22850590,1,-2,0,1281,283,281,-2
"94cecc3f1e7d484b8e068e79241dfd73","fab84b4fab5940efb4ea868ef8d09396",22850590,1,5,0,1282,281,284,3
"fab84b4fab5940efb4ea868ef8d09396","fab84b4fab5940efb4ea868ef8d09396",22850590,1,0,1,1283,284,284,0
"fab84b4fab5940efb4ea868ef8d09396","4a29443515bb404cb8924e1c60a63b73",22850590,1,4,0,1284,284,285,1
"4a29443515bb404cb8924e1c60a63b73","208c9b2796c944db8dacaa96082520ea",22850590,2,3,0,1285,285,288,3
"208c9b2796c944db8dacaa96082520ea","4a29443515bb404cb8924e1c60a63b73",22850590,2,-3,0,1286,288,285,-3
"4a29443515bb404cb8924e1c60a63b73","0d987bed3ffa4ed0b9a2e62e97b7b30f",22850590,1,-22,0,1287,285,272,-13
"a37477c4e4c14169ad44b06b493007f6","df1de691dafe4549a18a4398ee9dfaf9",22850590,1,-193,0,1299,283,139,-144
"df1de691dafe4549a18a4398ee9dfaf9","df1de691dafe4549a18a4398ee9dfaf9",22850590,2,0,1,1300,139,139,0
"df1de691dafe4549a18a4398ee9dfaf9","6c5ad271a44743479bfaea29b1db8d02",22850590,5,4,0,1301,139,143,4
"6c5ad271a44743479bfaea29b1db8d02","8aae34f5ddbb4052a709b12e6b0d40fa",22850590,1,5,0,1302,143,147,4
"8aae34f5ddbb4052a709b12e6b0d40fa","df1de691dafe4549a18a4398ee9dfaf9",22850590,4,-9,0,1303,147,139,-8
"df1de691dafe4549a18a4398ee9dfaf9","6e83e23f56544a19b94067c1c558d9c0",22850590,1,146,0,1304,139,247,108
"6e83e23f56544a19b94067c1c558d9c0","2ae94c0cea4d480a9d5dca8fb1d7b542",22850590,1,-6,0,1305,247,242,-5
"2ae94c0cea4d480a9d5dca8fb1d7b542","30c9ba177afc49a695625d2bdec40207",22850590,1,9,0,1306,242,250,8
"30c9ba177afc49a695625d2bdec40207","30c9ba177afc49a695625d2bdec40207",22850590,2,0,1,1307,250,250,0
"30c9ba177afc49a695625d2bdec40207","6e83e23f56544a19b94067c1c558d9c0",22850590,1,-3,0,1309,250,247,-3
"00f61990949545828dd12f1303d47504","4a29443515bb404cb8924e1c60a63b73",22850590,1,43,0,1311,256,285,29
"4a29443515bb404cb8924e1c60a63b73","4a29443515bb404cb8924e1c60a63b73",22850590,1,0,1,1312,285,285,0
"208c9b2796c944db8dacaa96082520ea","208c9b2796c944db8dacaa96082520ea",22850590,2,0,1,1314,288,288,0
"4a29443515bb404cb8924e1c60a63b73","7669a956527947d0add87455277e80b4",22850590,1,7,0,1317,285,291,6
"7669a956527947d0add87455277e80b4","7669a956527947d0add87455277e80b4",22850590,1,0,1,1318,291,291,0
"7669a956527947d0add87455277e80b4","6a9a3b5bde4a48daa896fe8c06eca56f",22850590,1,-2,0,1319,291,289,-2
"6a9a3b5bde4a48daa896fe8c06eca56f","869e967078f04da18dd0b0b9389a7424",22850590,1,5,0,1320,289,293,4
"869e967078f04da18dd0b0b9389a7424","869e967078f04da18dd0b0b9389a7424",22850590,11,0,1,1321,293,293,0
"869e967078f04da18dd0b0b9389a7424","51ab6291537748fab90d519aa09889d6",22850590,1,2,0,1332,293,295,2
"51ab6291537748fab90d519aa09889d6","51ab6291537748fab90d519aa09889d6",22850590,5,0,1,1333,295,295,0
"51ab6291537748fab90d519aa09889d6","34a6e49023fc4465bd5ca604330bbd1c",22850590,1,-3,0,1338,295,292,-3
"34a6e49023fc4465bd5ca604330bbd1c","ba0e59461bfb4a44b7b1c28a01f8d3b3",22850590,1,9,0,1339,292,299,7
"ba0e59461bfb4a44b7b1c28a01f8d3b3","21592f2a9e9c4b2f8c66ec5dbcbf6a2b",22850590,1,-4,0,1340,299,296,-3
"21592f2a9e9c4b2f8c66ec5dbcbf6a2b","ba0e59461bfb4a44b7b1c28a01f8d3b3",22850590,1,4,0,1341,296,299,3
"ba0e59461bfb4a44b7b1c28a01f8d3b3","ba0e59461bfb4a44b7b1c28a01f8d3b3",22850590,1,0,1,1342,299,299,0
"ba0e59461bfb4a44b7b1c28a01f8d3b3","0e0b36e731a645e7b1b8a88f5031ca38",22850590,1,2,0,1343,299,301,2
"0e0b36e731a645e7b1b8a88f5031ca38","0e0b36e731a645e7b1b8a88f5031ca38",22850590,2,0,1,1344,301,301,0
"0e0b36e731a645e7b1b8a88f5031ca38","a66a144637284c21afc6de17fea4bfb8",22850590,1,1,0,1346,301,302,1
"a66a144637284c21afc6de17fea4bfb8","a66a144637284c21afc6de17fea4bfb8",22850590,2,0,1,1347,302,302,0
"a66a144637284c21afc6de17fea4bfb8","7646a919d7e64fa990bca9b024ff089d",22850590,1,-4,0,1349,302,298,-4
"7646a919d7e64fa990bca9b024ff089d","e390b575229748ea8aac9364efe2bf00",22850590,1,7,0,1350,298,304,6
"e390b575229748ea8aac9364efe2bf00","e390b575229748ea8aac9364efe2bf00",22850590,1,0,1,1351,304,304,0
"e390b575229748ea8aac9364efe2bf00","4a29443515bb404cb8924e1c60a63b73",22850590,1,-24,0,1352,304,285,-19
"4a29443515bb404cb8924e1c60a63b73","3434c10e561d488a914e0f7d71907abd",22850590,2,27,0,1353,285,305,20
"3434c10e561d488a914e0f7d71907abd","53e7e900392747ccad52e711ab0f80d8",22850590,2,2,0,1354,305,307,2
"53e7e900392747ccad52e711ab0f80d8","4a29443515bb404cb8924e1c60a63b73",22850590,1,-29,0,1355,307,285,-22
"53e7e900392747ccad52e711ab0f80d8","53e7e900392747ccad52e711ab0f80d8",22850590,3,0,1,1358,307,307,0
"53e7e900392747ccad52e711ab0f80d8","130acc2aeb0448fdbb2de63bc5cebe5b",22850590,1,3,0,1361,307,309,2
"130acc2aeb0448fdbb2de63bc5cebe5b","3434c10e561d488a914e0f7d71907abd",22850590,1,-5,0,1362,309,305,-4
"3434c10e561d488a914e0f7d71907abd","130acc2aeb0448fdbb2de63bc5cebe5b",22850590,1,5,0,1363,305,309,4
"130acc2aeb0448fdbb2de63bc5cebe5b","130acc2aeb0448fdbb2de63bc5cebe5b",22850590,1,0,1,1364,309,309,0
"130acc2aeb0448fdbb2de63bc5cebe5b","9c062b3251034ebe90f5054e2a3b5120",22850590,1,2,0,1365,309,311,2
"9c062b3251034ebe90f5054e2a3b5120","9c062b3251034ebe90f5054e2a3b5120",22850590,2,0,1,1366,311,311,0
"9c062b3251034ebe90f5054e2a3b5120","ea859f8207e44537889daeaba13ac2e8",22850590,1,1,0,1368,311,312,1
"ea859f8207e44537889daeaba13ac2e8","ea859f8207e44537889daeaba13ac2e8",22850590,1,0,1,1369,312,312,0
"ea859f8207e44537889daeaba13ac2e8","56d94971a7a94257aa330183a8ebd0ea",22850590,1,1,0,1370,312,313,1
"56d94971a7a94257aa330183a8ebd0ea","56d94971a7a94257aa330183a8ebd0ea",22850590,4,0,1,1371,313,313,0
"56d94971a7a94257aa330183a8ebd0ea","141c0df6cd1946539aadd1c9b7068cd4",22850590,1,-5,0,1375,313,308,-5
"141c0df6cd1946539aadd1c9b7068cd4","13255e63e0aa4abf85e5211bf613d43e",22850590,1,10,0,1376,308,317,9
"13255e63e0aa4abf85e5211bf613d43e","13255e63e0aa4abf85e5211bf613d43e",22850590,3,0,1,1377,317,317,0
"13255e63e0aa4abf85e5211bf613d43e","0c787d16c9504873b1a4d903cec09948",22850590,1,-3,0,1380,317,314,-3
"0c787d16c9504873b1a4d903cec09948","86c27d40179e419c8e9d150fb6afa5d0",22850590,1,6,0,1381,314,319,5
"86c27d40179e419c8e9d150fb6afa5d0","86c27d40179e419c8e9d150fb6afa5d0",22850590,2,0,1,1382,319,319,0
"86c27d40179e419c8e9d150fb6afa5d0","8d7e0b55cf9849cda222a0f2440cec55",22850590,1,-1,0,1384,319,318,-1
"8d7e0b55cf9849cda222a0f2440cec55","24f1363179ad4aaa965484a78471912b",22850590,1,6,0,1385,318,323,5
"24f1363179ad4aaa965484a78471912b","47edbb64109243e6b0f8f64cdef90c6c",22850590,1,3,0,1386,323,326,3
"47edbb64109243e6b0f8f64cdef90c6c","24f1363179ad4aaa965484a78471912b",22850590,1,-3,0,1387,326,323,-3
"24f1363179ad4aaa965484a78471912b","24f1363179ad4aaa965484a78471912b",22850590,2,0,1,1388,323,323,0
"24f1363179ad4aaa965484a78471912b","3628bdce1dd2429ba924d2d4d09448d2",22850590,1,-1,0,1390,323,322,-1
"3628bdce1dd2429ba924d2d4d09448d2","56b3fd1a212a4764be39d979fde3326e",22850590,1,7,0,1391,322,328,6
"56b3fd1a212a4764be39d979fde3326e","56b3fd1a212a4764be39d979fde3326e",22850590,1,0,1,1392,328,328,0
"56b3fd1a212a4764be39d979fde3326e","0c4079457ede49e3aeb5e86ed84bdf35",22850590,1,3,0,1393,328,329,1
"0c4079457ede49e3aeb5e86ed84bdf35","3434c10e561d488a914e0f7d71907abd",22850590,1,-31,0,1394,329,305,-24
"3434c10e561d488a914e0f7d71907abd","38aea304b4fa46e1b29bb72f5cea4c93",22850590,1,33,0,1395,305,331,26
"38aea304b4fa46e1b29bb72f5cea4c93","4a29443515bb404cb8924e1c60a63b73",22850590,2,-60,0,1396,331,285,-46
"4a29443515bb404cb8924e1c60a63b73","0c4079457ede49e3aeb5e86ed84bdf35",22850590,2,58,0,1397,285,329,44
"0c4079457ede49e3aeb5e86ed84bdf35","0c4079457ede49e3aeb5e86ed84bdf35",22850590,2,0,1,1398,329,329,0
"0c4079457ede49e3aeb5e86ed84bdf35","38aea304b4fa46e1b29bb72f5cea4c93",22850590,3,2,0,1399,329,331,2
"38aea304b4fa46e1b29bb72f5cea4c93","38aea304b4fa46e1b29bb72f5cea4c93",22850590,3,0,1,1404,331,331,0
"38aea304b4fa46e1b29bb72f5cea4c93","e36d261332f14e79bb4b467aceaeb9b5",22850590,1,2,0,1407,331,333,2
"e36d261332f14e79bb4b467aceaeb9b5","e36d261332f14e79bb4b467aceaeb9b5",22850590,1,0,1,1408,333,333,0
"e36d261332f14e79bb4b467aceaeb9b5","c7e89b9d04744d2eab742fc24e3ef1ae",22850590,1,1,0,1409,333,334,1
"c7e89b9d04744d2eab742fc24e3ef1ae","c7e89b9d04744d2eab742fc24e3ef1ae",22850590,8,0,1,1410,334,334,0
"c7e89b9d04744d2eab742fc24e3ef1ae","fe49f8054b374a0ea4bb266ed135ff62",22850590,1,1,0,1418,334,335,1
"fe49f8054b374a0ea4bb266ed135ff62","fe49f8054b374a0ea4bb266ed135ff62",22850590,2,0,1,1419,335,335,0
"fe49f8054b374a0ea4bb266ed135ff62","d0a8f74af98642fe8360d22c42e45117",22850590,1,1,0,1421,335,336,1
"d0a8f74af98642fe8360d22c42e45117","d0a8f74af98642fe8360d22c42e45117",22850590,2,0,1,1422,336,336,0
"d0a8f74af98642fe8360d22c42e45117","0c4079457ede49e3aeb5e86ed84bdf35",22850590,1,-7,0,1424,336,329,-7
"38aea304b4fa46e1b29bb72f5cea4c93","b8b9418ab322418d9db9b40d96af873a",22850590,1,7,0,1426,331,337,6
"b8b9418ab322418d9db9b40d96af873a","0c4079457ede49e3aeb5e86ed84bdf35",22850590,1,-9,0,1427,337,329,-8
"0c4079457ede49e3aeb5e86ed84bdf35","bbc5139ca9024389a94db3a6f47dcff6",22850590,1,14,0,1428,329,341,12
"bbc5139ca9024389a94db3a6f47dcff6","c2490bc612d146edbe786556fab3651b",22850590,1,-1,0,1429,341,340,-1
"c2490bc612d146edbe786556fab3651b","4a92daef4d504e1792575a26502bb7b7",22850590,1,7,0,1430,340,346,6
"4a92daef4d504e1792575a26502bb7b7","a7c6339ca1da4368a18d471f0519f877",22850590,1,-9,0,1431,346,339,-7
"a7c6339ca1da4368a18d471f0519f877","a7c6339ca1da4368a18d471f0519f877",22850590,1,0,1,1432,339,339,0
"a7c6339ca1da4368a18d471f0519f877","b8b9418ab322418d9db9b40d96af873a",22850590,1,-2,0,1433,339,337,-2
"b8b9418ab322418d9db9b40d96af873a","bbc5139ca9024389a94db3a6f47dcff6",22850590,1,5,0,1434,337,341,4
"bbc5139ca9024389a94db3a6f47dcff6","bbc5139ca9024389a94db3a6f47dcff6",22850590,7,0,1,1435,341,341,0
"bbc5139ca9024389a94db3a6f47dcff6","4ee6ca9019ab4a1ab323f98094a9bd77",22850590,1,2,0,1442,341,343,2
"4ee6ca9019ab4a1ab323f98094a9bd77","4ee6ca9019ab4a1ab323f98094a9bd77",22850590,2,0,1,1443,343,343,0
"4ee6ca9019ab4a1ab323f98094a9bd77","b37947176785476f8b29d49a851366dc",22850590,1,1,0,1445,343,344,1
"b37947176785476f8b29d49a851366dc","b37947176785476f8b29d49a851366dc",22850590,2,0,1,1446,344,344,0
"b37947176785476f8b29d49a851366dc","fcea5b10d5a14a3b9324ffece8f6e1e5",22850590,1,1,0,1448,344,345,1
"fcea5b10d5a14a3b9324ffece8f6e1e5","fcea5b10d5a14a3b9324ffece8f6e1e5",22850590,2,0,1,1449,345,345,0
"fcea5b10d5a14a3b9324ffece8f6e1e5","c2490bc612d146edbe786556fab3651b",22850590,1,-5,0,1451,345,340,-5
"c2490bc612d146edbe786556fab3651b","6ac8bb048b854999a47edb35fe627f11",22850590,1,8,0,1452,340,347,7
"6ac8bb048b854999a47edb35fe627f11","6ac8bb048b854999a47edb35fe627f11",22850590,1,0,1,1453,347,347,0
"6ac8bb048b854999a47edb35fe627f11","30ead9794d4847abaf222ca966cc8630",22850590,1,3,0,1454,347,348,1
"30ead9794d4847abaf222ca966cc8630","0c4079457ede49e3aeb5e86ed84bdf35",22850590,1,-24,0,1455,348,329,-19
"0c4079457ede49e3aeb5e86ed84bdf35","eff0de7f2dbb42dfa1a2e686efab5b6d",22850590,1,30,0,1456,329,354,25
"eff0de7f2dbb42dfa1a2e686efab5b6d","09b9678ddc3d452ea4a3d46e15826065",22850590,1,-1,0,1457,354,353,-1
"09b9678ddc3d452ea4a3d46e15826065","c20993c944444fe085345591a8bd837e",22850590,1,-2,0,1458,353,351,-2
"c20993c944444fe085345591a8bd837e","897b7f51242c44aab2205c72fdcbf4cd",22850590,3,1,0,1459,351,352,1
"897b7f51242c44aab2205c72fdcbf4cd","4a29443515bb404cb8924e1c60a63b73",22850590,2,-86,0,1460,352,285,-67
"4a29443515bb404cb8924e1c60a63b73","30ead9794d4847abaf222ca966cc8630",22850590,2,82,0,1461,285,348,63
"30ead9794d4847abaf222ca966cc8630","09b9678ddc3d452ea4a3d46e15826065",22850590,1,5,0,1462,348,353,5
"09b9678ddc3d452ea4a3d46e15826065","eff0de7f2dbb42dfa1a2e686efab5b6d",22850590,3,1,0,1463,353,354,1
"eff0de7f2dbb42dfa1a2e686efab5b6d","c20993c944444fe085345591a8bd837e",22850590,2,-3,0,1464,354,351,-3
"30ead9794d4847abaf222ca966cc8630","30ead9794d4847abaf222ca966cc8630",22850590,1,0,1,1468,348,348,0
"30ead9794d4847abaf222ca966cc8630","897b7f51242c44aab2205c72fdcbf4cd",22850590,1,4,0,1469,348,352,4
"897b7f51242c44aab2205c72fdcbf4cd","c20993c944444fe085345591a8bd837e",22850590,1,-1,0,1470,352,351,-1
"c20993c944444fe085345591a8bd837e","09b9678ddc3d452ea4a3d46e15826065",22850590,1,2,0,1471,351,353,2
"c20993c944444fe085345591a8bd837e","c20993c944444fe085345591a8bd837e",22850590,3,0,1,1474,351,351,0
"897b7f51242c44aab2205c72fdcbf4cd","897b7f51242c44aab2205c72fdcbf4cd",22850590,3,0,1,1478,352,352,0
"897b7f51242c44aab2205c72fdcbf4cd","09b9678ddc3d452ea4a3d46e15826065",22850590,1,1,0,1481,352,353,1
"09b9678ddc3d452ea4a3d46e15826065","09b9678ddc3d452ea4a3d46e15826065",22850590,3,0,1,1482,353,353,0
"eff0de7f2dbb42dfa1a2e686efab5b6d","eff0de7f2dbb42dfa1a2e686efab5b6d",22850590,3,0,1,1486,354,354,0
"eff0de7f2dbb42dfa1a2e686efab5b6d","30ead9794d4847abaf222ca966cc8630",22850590,1,-6,0,1489,354,348,-6
"30ead9794d4847abaf222ca966cc8630","2fe14166dc9642c3bc666b86a57f943d",22850590,1,10,0,1490,348,357,9
"2fe14166dc9642c3bc666b86a57f943d","2fe14166dc9642c3bc666b86a57f943d",22850590,4,0,1,1491,357,357,0
"2fe14166dc9642c3bc666b86a57f943d","44421dd1e13a47a388c4a19834b744c7",22850590,1,2,0,1492,357,359,2
"44421dd1e13a47a388c4a19834b744c7","44421dd1e13a47a388c4a19834b744c7",22850590,2,0,1,1493,359,359,0
"44421dd1e13a47a388c4a19834b744c7","2fe14166dc9642c3bc666b86a57f943d",22850590,1,-2,0,1495,359,357,-2
"2fe14166dc9642c3bc666b86a57f943d","cb5fc7ef85d547c4be1a7439d0bf6052",22850590,1,3,0,1499,357,360,3
"cb5fc7ef85d547c4be1a7439d0bf6052","cb5fc7ef85d547c4be1a7439d0bf6052",22850590,5,0,1,1500,360,360,0
"cb5fc7ef85d547c4be1a7439d0bf6052","0a8f150a4cf747acbde62f4721823da3",22850590,1,1,0,1505,360,361,1
"0a8f150a4cf747acbde62f4721823da3","0a8f150a4cf747acbde62f4721823da3",22850590,2,0,1,1506,361,361,0
"0a8f150a4cf747acbde62f4721823da3","ab8fdad974ae471f9f24c3f9dd04462e",22850590,1,1,0,1508,361,362,1
"ab8fdad974ae471f9f24c3f9dd04462e","ab8fdad974ae471f9f24c3f9dd04462e",22850590,2,0,1,1509,362,362,0
"ab8fdad974ae471f9f24c3f9dd04462e","1ba8fef685d74a8194b9db252eb704fb",22850590,1,-7,0,1511,362,355,-7
"1ba8fef685d74a8194b9db252eb704fb","52580888dadb4fe3baa795683ea227bd",22850590,1,10,0,1512,355,364,9
"52580888dadb4fe3baa795683ea227bd","52580888dadb4fe3baa795683ea227bd",22850590,4,0,1,1513,364,364,0
"52580888dadb4fe3baa795683ea227bd","f00179e251a045b39c3f7a54f9aa4acc",22850590,1,-1,0,1517,364,363,-1
"f00179e251a045b39c3f7a54f9aa4acc","492a3bc6a1254f23a7998587961b22a4",22850590,1,4,0,1518,363,366,3
"492a3bc6a1254f23a7998587961b22a4","492a3bc6a1254f23a7998587961b22a4",22850590,3,0,1,1519,366,366,0
"492a3bc6a1254f23a7998587961b22a4","072a190fd302456290895f9f04d6940a",22850590,1,-1,0,1522,366,365,-1
"072a190fd302456290895f9f04d6940a","cfa457d1743848e4bb5e4beced6448ed",22850590,1,5,0,1523,365,369,4
"cfa457d1743848e4bb5e4beced6448ed","cfa457d1743848e4bb5e4beced6448ed",22850590,1,0,1,1524,369,369,0
"cfa457d1743848e4bb5e4beced6448ed","30ead9794d4847abaf222ca966cc8630",22850590,1,-25,0,1525,369,348,-21
"30ead9794d4847abaf222ca966cc8630","b71bac264efb4abd97015447bd490db6",22850590,3,28,0,1526,348,370,22
"b71bac264efb4abd97015447bd490db6","30ead9794d4847abaf222ca966cc8630",22850590,2,-28,0,1527,370,348,-22
"b71bac264efb4abd97015447bd490db6","8d448d625b024c82a5eb240bbd7431d6",22850590,9,5,0,1531,370,374,4
"8d448d625b024c82a5eb240bbd7431d6","8d448d625b024c82a5eb240bbd7431d6",22850590,83,0,1,1532,374,374,0
"8d448d625b024c82a5eb240bbd7431d6","b71bac264efb4abd97015447bd490db6",22850590,5,-5,0,1537,374,370,-4
"8d448d625b024c82a5eb240bbd7431d6","1b4550d0dab04078b3bf08a655345bdc",22850590,2,-1,0,1540,374,373,-1
"1b4550d0dab04078b3bf08a655345bdc","8d448d625b024c82a5eb240bbd7431d6",22850590,1,1,0,1541,373,374,1
"1b4550d0dab04078b3bf08a655345bdc","b71bac264efb4abd97015447bd490db6",22850590,1,-4,0,1551,373,370,-3
"b71bac264efb4abd97015447bd490db6","b71bac264efb4abd97015447bd490db6",22850590,7,0,1,1561,370,370,0
"b71bac264efb4abd97015447bd490db6","4a29443515bb404cb8924e1c60a63b73",22850590,1,-110,0,1563,370,285,-85
"4a29443515bb404cb8924e1c60a63b73","b71bac264efb4abd97015447bd490db6",22850590,1,110,0,1564,285,370,85
"8d448d625b024c82a5eb240bbd7431d6","d6d02b6ef04e4f17805504500b8ce441",22850590,2,3,0,1578,374,375,1
"d6d02b6ef04e4f17805504500b8ce441","d6d02b6ef04e4f17805504500b8ce441",22850590,10,0,1,1579,375,375,0
"d6d02b6ef04e4f17805504500b8ce441","66baf19b6b904b70922329068c63746d",22850590,2,4,0,1582,375,376,1
"66baf19b6b904b70922329068c63746d","7f544639412e40a9ba27f43b415362ab",22850590,3,2,0,1583,376,378,2
"7f544639412e40a9ba27f43b415362ab","b2f0d654738f48158edff28e8d3a546e",22850590,2,110,0,1584,378,449,71
"b2f0d654738f48158edff28e8d3a546e","b2f0d654738f48158edff28e8d3a546e",22850590,2,0,1,1585,449,449,0
"b2f0d654738f48158edff28e8d3a546e","66baf19b6b904b70922329068c63746d",22850590,1,-112,0,1586,449,376,-73
"66baf19b6b904b70922329068c63746d","66baf19b6b904b70922329068c63746d",22850590,1,0,1,1587,376,376,0
"7f544639412e40a9ba27f43b415362ab","7f544639412e40a9ba27f43b415362ab",22850590,3,0,1,1589,378,378,0
"7f544639412e40a9ba27f43b415362ab","d5ae8642e15b46b8bd298b02274d4e9c",22850590,1,2,0,1592,378,380,2
"d5ae8642e15b46b8bd298b02274d4e9c","d5ae8642e15b46b8bd298b02274d4e9c",22850590,4,0,1,1593,380,380,0
"d5ae8642e15b46b8bd298b02274d4e9c","a0d10309a2dd456289147f84be9d37f9",22850590,1,1,0,1597,380,381,1
"a0d10309a2dd456289147f84be9d37f9","a0d10309a2dd456289147f84be9d37f9",22850590,2,0,1,1598,381,381,0
"a0d10309a2dd456289147f84be9d37f9","0fcbc3ca07b144138b8d85da581f09a8",22850590,1,1,0,1600,381,382,1
"0fcbc3ca07b144138b8d85da581f09a8","0fcbc3ca07b144138b8d85da581f09a8",22850590,8,0,1,1601,382,382,0
"0fcbc3ca07b144138b8d85da581f09a8","66baf19b6b904b70922329068c63746d",22850590,1,-6,0,1609,382,376,-6
"66baf19b6b904b70922329068c63746d","c2fca3669923477ab966ded303dea31c",22850590,1,8,0,1610,376,383,7
"c2fca3669923477ab966ded303dea31c","4890121ce5d74576b4632b77cfc23398",22850590,1,6,0,1611,383,388,5
"4890121ce5d74576b4632b77cfc23398","4890121ce5d74576b4632b77cfc23398",22850590,2,0,1,1612,388,388,0
"4890121ce5d74576b4632b77cfc23398","96bb2b3e85a34d8b9544514e89f6fe97",22850590,1,3,0,1614,388,390,2
"96bb2b3e85a34d8b9544514e89f6fe97","18d3b836dd804224883cc9180b60a8e1",22850590,1,-4,0,1615,390,387,-3
"18d3b836dd804224883cc9180b60a8e1","96bb2b3e85a34d8b9544514e89f6fe97",22850590,1,4,0,1616,387,390,3
"96bb2b3e85a34d8b9544514e89f6fe97","96bb2b3e85a34d8b9544514e89f6fe97",22850590,2,0,1,1617,390,390,0
"96bb2b3e85a34d8b9544514e89f6fe97","17f95d18bab743888e1736033dc3384d",22850590,1,-1,0,1619,390,389,-1
"17f95d18bab743888e1736033dc3384d","6f8881a745ac4c358a68b92c3b4abe81",22850590,2,6,0,1620,389,394,5
"6f8881a745ac4c358a68b92c3b4abe81","96bb2b3e85a34d8b9544514e89f6fe97",22850590,1,-5,0,1621,394,390,-4
"96bb2b3e85a34d8b9544514e89f6fe97","f7002c8484354eceac57bc7bd62c76c1",22850590,1,4,0,1622,390,393,3
"f7002c8484354eceac57bc7bd62c76c1","ac4e9b54acfe4670b4634859c7263cb5",22850590,1,-2,0,1623,393,392,-1
"ac4e9b54acfe4670b4634859c7263cb5","ac4e9b54acfe4670b4634859c7263cb5",22850590,3,0,1,1624,392,392,0
"ac4e9b54acfe4670b4634859c7263cb5","6f8881a745ac4c358a68b92c3b4abe81",22850590,1,3,0,1627,392,394,2
"6f8881a745ac4c358a68b92c3b4abe81","17f95d18bab743888e1736033dc3384d",22850590,1,-6,0,1628,394,389,-5
"6f8881a745ac4c358a68b92c3b4abe81","6f8881a745ac4c358a68b92c3b4abe81",22850590,2,0,1,1630,394,394,0
"6f8881a745ac4c358a68b92c3b4abe81","f7002c8484354eceac57bc7bd62c76c1",22850590,1,-1,0,1632,394,393,-1
"f7002c8484354eceac57bc7bd62c76c1","44a277ea44dc4ae689fab4b82f0b4098",22850590,1,5,0,1633,393,397,4
"44a277ea44dc4ae689fab4b82f0b4098","44a277ea44dc4ae689fab4b82f0b4098",22850590,1,0,1,1634,397,397,0
"44a277ea44dc4ae689fab4b82f0b4098","0c12af0a4e7f4002852cf84b2537c161",22850590,1,-2,0,1635,397,395,-2
"0c12af0a4e7f4002852cf84b2537c161","859e0b8d71694b12befb69ee698138f9",22850590,1,5,0,1636,395,399,4
"859e0b8d71694b12befb69ee698138f9","859e0b8d71694b12befb69ee698138f9",22850590,1,0,1,1637,399,399,0
"859e0b8d71694b12befb69ee698138f9","66baf19b6b904b70922329068c63746d",22850590,1,-29,0,1638,399,376,-23
"66baf19b6b904b70922329068c63746d","2b09a08242b54983aec7063990fb3f66",22850590,2,32,0,1639,376,400,24
"2b09a08242b54983aec7063990fb3f66","2b09a08242b54983aec7063990fb3f66",22850590,13,0,1,1640,400,400,0
"2b09a08242b54983aec7063990fb3f66","1f471b7a883a4df48211e8c6a81b59a7",22850590,1,1,0,1646,400,401,1
"1f471b7a883a4df48211e8c6a81b59a7","1f471b7a883a4df48211e8c6a81b59a7",22850590,1,0,1,1647,401,401,0
"1f471b7a883a4df48211e8c6a81b59a7","2b09a08242b54983aec7063990fb3f66",22850590,1,-1,0,1648,401,400,-1
"2b09a08242b54983aec7063990fb3f66","66baf19b6b904b70922329068c63746d",22850590,1,-32,0,1649,400,376,-24
"2b09a08242b54983aec7063990fb3f66","9de0d567bfa84fe5b77cb76f4a76a5d1",22850590,1,5,0,1654,400,404,4
"9de0d567bfa84fe5b77cb76f4a76a5d1","9de0d567bfa84fe5b77cb76f4a76a5d1",22850590,1,0,1,1655,404,404,0
"9de0d567bfa84fe5b77cb76f4a76a5d1","1157bd665ec4472fb58b751dc5099355",22850590,1,-1,0,1656,404,403,-1
"1157bd665ec4472fb58b751dc5099355","3c8a22d2f9c146ea956609e3ed4f2559",22850590,1,3,0,1657,403,405,2
"3c8a22d2f9c146ea956609e3ed4f2559","58fc9094275e4c49be3f4ba6d4acc0a4",22850590,1,2,0,1658,405,406,1
"58fc9094275e4c49be3f4ba6d4acc0a4","58fc9094275e4c49be3f4ba6d4acc0a4",22850590,3,0,1,1659,406,406,0
"58fc9094275e4c49be3f4ba6d4acc0a4","c1c1be90b2b14c1ab4a5e1ee3c241902",22850590,1,1,0,1662,406,407,1
"c1c1be90b2b14c1ab4a5e1ee3c241902","c1c1be90b2b14c1ab4a5e1ee3c241902",22850590,5,0,1,1663,407,407,0
"c1c1be90b2b14c1ab4a5e1ee3c241902","58fc9094275e4c49be3f4ba6d4acc0a4",22850590,1,-1,0,1668,407,406,-1
"58fc9094275e4c49be3f4ba6d4acc0a4","02b3a1bead9244c1ba2f857c7da8f82a",22850590,1,3,0,1669,406,408,2
"02b3a1bead9244c1ba2f857c7da8f82a","02b3a1bead9244c1ba2f857c7da8f82a",22850590,2,0,1,1670,408,408,0
"02b3a1bead9244c1ba2f857c7da8f82a","6206fc6479014bb193084c32409dc1b9",22850590,1,1,0,1672,408,409,1
"6206fc6479014bb193084c32409dc1b9","6206fc6479014bb193084c32409dc1b9",22850590,1,0,1,1673,409,409,0
"6206fc6479014bb193084c32409dc1b9","02b3a1bead9244c1ba2f857c7da8f82a",22850590,1,-1,0,1674,409,408,-1
"02b3a1bead9244c1ba2f857c7da8f82a","6a5f020451db426dacba9e2ea3fcc62a",22850590,1,3,0,1675,408,410,2
"6a5f020451db426dacba9e2ea3fcc62a","6a5f020451db426dacba9e2ea3fcc62a",22850590,2,0,1,1676,410,410,0
"6a5f020451db426dacba9e2ea3fcc62a","33a9d248b2e44588a5b07fc1342b9bc2",22850590,2,2,0,1678,410,411,1
"33a9d248b2e44588a5b07fc1342b9bc2","6a5f020451db426dacba9e2ea3fcc62a",22850590,1,-2,0,1679,411,410,-1
"33a9d248b2e44588a5b07fc1342b9bc2","33a9d248b2e44588a5b07fc1342b9bc2",22850590,3,0,1,1681,411,411,0
"33a9d248b2e44588a5b07fc1342b9bc2","c6f26bd420634f1cb7989e76fe6b16c0",22850590,1,1,0,1684,411,412,1
"c6f26bd420634f1cb7989e76fe6b16c0","c6f26bd420634f1cb7989e76fe6b16c0",22850590,5,0,1,1685,412,412,0
"c6f26bd420634f1cb7989e76fe6b16c0","2a65ee6e2ac64f6a8a55fbe5373ec763",22850590,1,1,0,1690,412,413,1
"2a65ee6e2ac64f6a8a55fbe5373ec763","2a65ee6e2ac64f6a8a55fbe5373ec763",22850590,2,0,1,1691,413,413,0
"2a65ee6e2ac64f6a8a55fbe5373ec763","33a9d248b2e44588a5b07fc1342b9bc2",22850590,1,-2,0,1693,413,411,-2
"33a9d248b2e44588a5b07fc1342b9bc2","1fd0f6dadbc14ebc965faf6122190b96",22850590,1,5,0,1694,411,415,4
"1fd0f6dadbc14ebc965faf6122190b96","1fd0f6dadbc14ebc965faf6122190b96",22850590,1,0,1,1695,415,415,0
"1fd0f6dadbc14ebc965faf6122190b96","687055dad9fc40c3982478fe33ec01bf",22850590,1,-1,0,1696,415,414,-1
"687055dad9fc40c3982478fe33ec01bf","2add1669f08d4101913db15f8c23b3b7",22850590,1,3,0,1697,414,416,2
"2add1669f08d4101913db15f8c23b3b7","2b09a08242b54983aec7063990fb3f66",22850590,1,-24,0,1698,416,400,-16
"2b09a08242b54983aec7063990fb3f66","a2b4bd40cee2481ebd3fc179d6a5cd62",22850590,7,27,0,1699,400,417,17
"a2b4bd40cee2481ebd3fc179d6a5cd62","2b09a08242b54983aec7063990fb3f66",22850590,7,-27,0,1700,417,400,-17
"a2b4bd40cee2481ebd3fc179d6a5cd62","a2b4bd40cee2481ebd3fc179d6a5cd62",22850590,5,0,1,1705,417,417,0
"2b09a08242b54983aec7063990fb3f66","2add1669f08d4101913db15f8c23b3b7",22850590,1,24,0,1721,400,416,16
"2add1669f08d4101913db15f8c23b3b7","a2b4bd40cee2481ebd3fc179d6a5cd62",22850590,1,3,0,1722,416,417,1
"a2b4bd40cee2481ebd3fc179d6a5cd62","e34e59dce2204f228f3a84b6725df60f",22850590,1,2,0,1724,417,419,2
"e34e59dce2204f228f3a84b6725df60f","e34e59dce2204f228f3a84b6725df60f",22850590,1,0,1,1725,419,419,0
"e34e59dce2204f228f3a84b6725df60f","bec48fc2e1294c7eb3d0aca780d731b8",22850590,1,2,0,1726,419,420,1
"bec48fc2e1294c7eb3d0aca780d731b8","a2b4bd40cee2481ebd3fc179d6a5cd62",22850590,1,-4,0,1727,420,417,-3
"a2b4bd40cee2481ebd3fc179d6a5cd62","bec48fc2e1294c7eb3d0aca780d731b8",22850590,2,4,0,1728,417,420,3
"bec48fc2e1294c7eb3d0aca780d731b8","bec48fc2e1294c7eb3d0aca780d731b8",22850590,7,0,1,1729,420,420,0
"bec48fc2e1294c7eb3d0aca780d731b8","dbde19fcce2a4c1abdc7f685c293a23f",22850590,2,3,0,1734,420,422,2
"dbde19fcce2a4c1abdc7f685c293a23f","a24600b0e49245f6bdba8c893cfeddb0",22850590,4,4,0,1735,422,425,3
"a24600b0e49245f6bdba8c893cfeddb0","a24600b0e49245f6bdba8c893cfeddb0",22850590,5,0,1,1736,425,425,0
"a24600b0e49245f6bdba8c893cfeddb0","a2b4bd40cee2481ebd3fc179d6a5cd62",22850590,2,-11,0,1738,425,417,-8
"a24600b0e49245f6bdba8c893cfeddb0","dbde19fcce2a4c1abdc7f685c293a23f",22850590,2,-4,0,1746,425,422,-3
"a24600b0e49245f6bdba8c893cfeddb0","5d290f75e44b4bdb8256c600debbb44d",22850590,1,2,0,1749,425,426,1
"5d290f75e44b4bdb8256c600debbb44d","a24600b0e49245f6bdba8c893cfeddb0",22850590,1,-2,0,1750,426,425,-1
"a2b4bd40cee2481ebd3fc179d6a5cd62","24cf8786024543f19b89bc20034e60d7",22850590,1,18,0,1754,417,428,11
"24cf8786024543f19b89bc20034e60d7","f2a73be2f46840b182d7bd095378004e",22850590,1,1,0,1755,428,429,1
"f2a73be2f46840b182d7bd095378004e","f2a73be2f46840b182d7bd095378004e",22850590,4,0,1,1756,429,429,0
"f2a73be2f46840b182d7bd095378004e","604551fd4266430cb860fef58fa7dd61",22850590,1,1,0,1760,429,430,1
"604551fd4266430cb860fef58fa7dd61","604551fd4266430cb860fef58fa7dd61",22850590,9,0,1,1761,430,430,0
"604551fd4266430cb860fef58fa7dd61","24cf8786024543f19b89bc20034e60d7",22850590,1,-2,0,1770,430,428,-2
"24cf8786024543f19b89bc20034e60d7","dce46f8904594a62a6377a3587aaa663",22850590,1,4,0,1771,428,431,3
"dce46f8904594a62a6377a3587aaa663","dce46f8904594a62a6377a3587aaa663",22850590,5,0,1,1772,431,431,0
"dce46f8904594a62a6377a3587aaa663","9b9d0a249052413c869753b99682b0ac",22850590,1,1,0,1774,431,432,1
"9b9d0a249052413c869753b99682b0ac","9b9d0a249052413c869753b99682b0ac",22850590,3,0,1,1775,432,432,0
"9b9d0a249052413c869753b99682b0ac","061c175cc90f45fbad883025394e78dd",22850590,1,1,0,1778,432,433,1
"061c175cc90f45fbad883025394e78dd","061c175cc90f45fbad883025394e78dd",22850590,6,0,1,1779,433,433,0
"061c175cc90f45fbad883025394e78dd","dce46f8904594a62a6377a3587aaa663",22850590,2,-2,0,1785,433,431,-2
"dce46f8904594a62a6377a3587aaa663","66ada10dde9f43018588f1ced9d477fc",22850590,3,4,0,1786,431,434,3
"66ada10dde9f43018588f1ced9d477fc","bf12c96466d840a69bed7020b3f18bb8",22850590,3,3,0,1787,434,436,2
"bf12c96466d840a69bed7020b3f18bb8","24cf8786024543f19b89bc20034e60d7",22850590,2,-11,0,1788,436,428,-8
"24cf8786024543f19b89bc20034e60d7","bf12c96466d840a69bed7020b3f18bb8",22850590,1,11,0,1789,428,436,8
"bf12c96466d840a69bed7020b3f18bb8","66ada10dde9f43018588f1ced9d477fc",22850590,1,-3,0,1790,436,434,-2
"bf12c96466d840a69bed7020b3f18bb8","dce46f8904594a62a6377a3587aaa663",22850590,1,-7,0,1792,436,431,-5
"dce46f8904594a62a6377a3587aaa663","061c175cc90f45fbad883025394e78dd",22850590,1,2,0,1794,431,433,2
"66ada10dde9f43018588f1ced9d477fc","dce46f8904594a62a6377a3587aaa663",22850590,2,-4,0,1798,434,431,-3
"dce46f8904594a62a6377a3587aaa663","74a7f8712e5449c2bc0b43c6f90dafed",22850590,1,5,0,1802,431,435,4
"74a7f8712e5449c2bc0b43c6f90dafed","74a7f8712e5449c2bc0b43c6f90dafed",22850590,1,0,1,1803,435,435,0
"74a7f8712e5449c2bc0b43c6f90dafed","66ada10dde9f43018588f1ced9d477fc",22850590,1,-1,0,1804,435,434,-1
"bf12c96466d840a69bed7020b3f18bb8","bf12c96466d840a69bed7020b3f18bb8",22850590,1,0,1,1806,436,436,0
"24cf8786024543f19b89bc20034e60d7","070600601c4c439288445d2f0724807d",22850590,1,14,0,1808,428,437,9
"070600601c4c439288445d2f0724807d","1823b6de7d334a7aaabc4570719af4d9",22850590,1,2,0,1809,437,439,2
"1823b6de7d334a7aaabc4570719af4d9","1823b6de7d334a7aaabc4570719af4d9",22850590,11,0,1,1810,439,439,0
"1823b6de7d334a7aaabc4570719af4d9","0380cd76a7d44bc3a4da1f15e4d68f89",22850590,1,2,0,1821,439,440,1
"0380cd76a7d44bc3a4da1f15e4d68f89","070600601c4c439288445d2f0724807d",22850590,1,-4,0,1822,440,437,-3
"070600601c4c439288445d2f0724807d","0380cd76a7d44bc3a4da1f15e4d68f89",22850590,1,4,0,1823,437,440,3
"0380cd76a7d44bc3a4da1f15e4d68f89","0380cd76a7d44bc3a4da1f15e4d68f89",22850590,4,0,1,1824,440,440,0
"0380cd76a7d44bc3a4da1f15e4d68f89","23b7673c8b5443108c2ef09382834a86",22850590,1,2,0,1828,440,441,1
"23b7673c8b5443108c2ef09382834a86","23b7673c8b5443108c2ef09382834a86",22850590,6,0,1,1829,441,441,0
"23b7673c8b5443108c2ef09382834a86","901e92500aea43c79f19f1b279050668",22850590,1,2,0,1835,441,442,1
"901e92500aea43c79f19f1b279050668","901e92500aea43c79f19f1b279050668",22850590,2,0,1,1836,442,442,0
"901e92500aea43c79f19f1b279050668","001339db8ced4cf78829ebe8b145449d",22850590,1,1,0,1838,442,443,1
"001339db8ced4cf78829ebe8b145449d","001339db8ced4cf78829ebe8b145449d",22850590,2,0,1,1839,443,443,0
"001339db8ced4cf78829ebe8b145449d","452745e0366e42ae81561bfddebcc6c3",22850590,1,1,0,1841,443,444,1
"452745e0366e42ae81561bfddebcc6c3","452745e0366e42ae81561bfddebcc6c3",22850590,5,0,1,1842,444,444,0
"452745e0366e42ae81561bfddebcc6c3","901e92500aea43c79f19f1b279050668",22850590,1,-2,0,1847,444,442,-2
"901e92500aea43c79f19f1b279050668","4660ff2089114e8db82ceb26a4f329e3",22850590,1,4,0,1848,442,445,3
"4660ff2089114e8db82ceb26a4f329e3","4660ff2089114e8db82ceb26a4f329e3",22850590,5,0,1,1849,445,445,0
"4660ff2089114e8db82ceb26a4f329e3","7bd5586eb9d8484eb74a433ee7bfe499",22850590,3,2,0,1851,445,446,1
"7bd5586eb9d8484eb74a433ee7bfe499","7bd5586eb9d8484eb74a433ee7bfe499",22850590,26,0,1,1852,446,446,0
"7bd5586eb9d8484eb74a433ee7bfe499","8a7f26e690f34dda97be16904518ca99",22850590,2,2,0,1853,446,447,1
"8a7f26e690f34dda97be16904518ca99","4660ff2089114e8db82ceb26a4f329e3",22850590,1,-4,0,1854,447,445,-2
"7bd5586eb9d8484eb74a433ee7bfe499","4660ff2089114e8db82ceb26a4f329e3",22850590,1,-2,0,1858,446,445,-1
"8a7f26e690f34dda97be16904518ca99","8a7f26e690f34dda97be16904518ca99",22850590,1,0,1,1887,447,447,0
"8a7f26e690f34dda97be16904518ca99","070600601c4c439288445d2f0724807d",22850590,1,-16,0,1888,447,437,-10
"070600601c4c439288445d2f0724807d","b2f0d654738f48158edff28e8d3a546e",22850590,1,21,0,1889,437,449,12
"b2f0d654738f48158edff28e8d3a546e","f60ee41ec635499abd48168342d32c2f",22850590,4,5,0,1891,449,453,4
"f60ee41ec635499abd48168342d32c2f","f60ee41ec635499abd48168342d32c2f",22850590,82,0,1,1892,453,453,0
"f60ee41ec635499abd48168342d32c2f","d6d02b6ef04e4f17805504500b8ce441",22850590,1,-121,0,1899,453,375,-78
"d6d02b6ef04e4f17805504500b8ce441","b71bac264efb4abd97015447bd490db6",22850590,2,-8,0,1903,375,370,-5
"b71bac264efb4abd97015447bd490db6","d6d02b6ef04e4f17805504500b8ce441",22850590,1,8,0,1961,370,375,5
"f60ee41ec635499abd48168342d32c2f","9428d8bd9c5a47b2a235b254e5e27ded",22850590,1,-1,0,1977,453,452,-1
"9428d8bd9c5a47b2a235b254e5e27ded","f60ee41ec635499abd48168342d32c2f",22850590,1,1,0,1978,452,453,1
"f60ee41ec635499abd48168342d32c2f","b2f0d654738f48158edff28e8d3a546e",22850590,1,-5,0,1979,453,449,-4
"f60ee41ec635499abd48168342d32c2f","f67fbf45a5f146ed866965bc57c7c001",22850590,1,3,0,2042,453,454,1
"f67fbf45a5f146ed866965bc57c7c001","b2f0d654738f48158edff28e8d3a546e",22850590,1,-8,0,2043,454,449,-5
"b2f0d654738f48158edff28e8d3a546e","f67fbf45a5f146ed866965bc57c7c001",22850590,1,8,0,2044,449,454,5
"f67fbf45a5f146ed866965bc57c7c001","f67fbf45a5f146ed866965bc57c7c001",22850590,1,0,1,2045,454,454,0
"f67fbf45a5f146ed866965bc57c7c001","d937afe49bd24a07a550dda1c1155122",22850590,1,1,0,2046,454,455,1
"d937afe49bd24a07a550dda1c1155122","d937afe49bd24a07a550dda1c1155122",22850590,3,0,1,2047,455,455,0
"d937afe49bd24a07a550dda1c1155122","3628b3f7823443d0912a339096b69943",22850590,1,1,0,2050,455,456,1
"3628b3f7823443d0912a339096b69943","3628b3f7823443d0912a339096b69943",22850590,3,0,1,2051,456,456,0
"3628b3f7823443d0912a339096b69943","9e049ee647cf43ecbcb5ed792a8e7588",22850590,1,1,0,2054,456,457,1
"9e049ee647cf43ecbcb5ed792a8e7588","9e049ee647cf43ecbcb5ed792a8e7588",22850590,1,0,1,2055,457,457,0
"9e049ee647cf43ecbcb5ed792a8e7588","5256a214faaf410b93f76cea06428334",22850590,1,1,0,2056,457,458,1
"5256a214faaf410b93f76cea06428334","5256a214faaf410b93f76cea06428334",22850590,1,0,1,2057,458,458,0
"5256a214faaf410b93f76cea06428334","25c32b120fce40fa9b6c85133aeb4716",22850590,1,1,0,2058,458,459,1
"25c32b120fce40fa9b6c85133aeb4716","25c32b120fce40fa9b6c85133aeb4716",22850590,1,0,1,2059,459,459,0
"25c32b120fce40fa9b6c85133aeb4716","11bc14f2204949008b7d511b933363c1",22850590,1,1,0,2060,459,460,1
"11bc14f2204949008b7d511b933363c1","11bc14f2204949008b7d511b933363c1",22850590,1,0,1,2061,460,460,0
"11bc14f2204949008b7d511b933363c1","42de338840a34d15adb66e7b14fb9d2c",22850590,1,1,0,2062,460,461,1
"42de338840a34d15adb66e7b14fb9d2c","42de338840a34d15adb66e7b14fb9d2c",22850590,3,0,1,2063,461,461,0
"42de338840a34d15adb66e7b14fb9d2c","9da37c6210b1416b8079c274f70bf600",22850590,1,1,0,2066,461,462,1
"9da37c6210b1416b8079c274f70bf600","9da37c6210b1416b8079c274f70bf600",22850590,5,0,1,2067,462,462,0
"9da37c6210b1416b8079c274f70bf600","519119f1deac45ff9ab4f13529be5c6e",22850590,1,1,0,2072,462,463,1
"519119f1deac45ff9ab4f13529be5c6e","519119f1deac45ff9ab4f13529be5c6e",22850590,1,0,1,2073,463,463,0
"519119f1deac45ff9ab4f13529be5c6e","f67fbf45a5f146ed866965bc57c7c001",22850590,1,-9,0,2074,463,454,-9
"f67fbf45a5f146ed866965bc57c7c001","c5df9f40ec14463b9dcfdc73df3e9285",22850590,1,12,0,2075,454,464,10
"c5df9f40ec14463b9dcfdc73df3e9285","c5df9f40ec14463b9dcfdc73df3e9285",22850590,2,0,1,2076,464,464,0
"c5df9f40ec14463b9dcfdc73df3e9285","83d42d95cd844fc093fc09cee250edb8",22850590,1,3,0,2078,464,465,1
"83d42d95cd844fc093fc09cee250edb8","83d42d95cd844fc093fc09cee250edb8",22850590,5,0,1,2079,465,465,0
"83d42d95cd844fc093fc09cee250edb8","b613861cecf84ffcab01afb23f660475",22850590,1,-655,0,2084,465,1,-464
"b613861cecf84ffcab01afb23f660475","e2911e79efc2420eac45d9f671463d4b",22850590,2,3,0,2086,1,2,1
"3f1c815879794b929260d224becaff7e","5c5ceeee4562457ba6d41515aeebfbb1",22850590,1,6,0,2095,14,17,3
"5c5ceeee4562457ba6d41515aeebfbb1","81c864a886d54a6b8ff85f7d736f4f95",22850590,1,-4,0,2096,17,15,-2
"81c864a886d54a6b8ff85f7d736f4f95","9afd71a5298d4333b6849dfce1b9422c",22850590,1,7,0,2097,15,18,3
"9afd71a5298d4333b6849dfce1b9422c","56586aa865414f538729c7f7735d2bc6",22850590,2,-13,0,2098,18,12,-6
"56586aa865414f538729c7f7735d2bc6","b71bac264efb4abd97015447bd490db6",22850590,1,493,0,2099,12,370,358
"8d448d625b024c82a5eb240bbd7431d6","b2f0d654738f48158edff28e8d3a546e",22850590,1,119,0,2108,374,449,75
"67a089198fcb4e1c8f2385786c2b296f","e2911e79efc2420eac45d9f671463d4b",22851474,1,-69,0,1,39,2,-37
"e2911e79efc2420eac45d9f671463d4b","b613861cecf84ffcab01afb23f660475",22851474,1,-3,0,3,2,1,-1
"b613861cecf84ffcab01afb23f660475","b613861cecf84ffcab01afb23f660475",22851474,6,0,1,4,1,1,0
"b613861cecf84ffcab01afb23f660475","e2911e79efc2420eac45d9f671463d4b",22851474,1,3,0,10,1,2,1
"e2911e79efc2420eac45d9f671463d4b","56586aa865414f538729c7f7735d2bc6",22851474,3,12,0,11,2,12,10
"56586aa865414f538729c7f7735d2bc6","e2911e79efc2420eac45d9f671463d4b",22851474,1,-12,0,12,12,2,-10
"56586aa865414f538729c7f7735d2bc6","9afd71a5298d4333b6849dfce1b9422c",22851474,4,13,0,14,12,18,6
"9afd71a5298d4333b6849dfce1b9422c","56586aa865414f538729c7f7735d2bc6",22851474,2,-13,0,15,18,12,-6
"9afd71a5298d4333b6849dfce1b9422c","e2911e79efc2420eac45d9f671463d4b",22851474,1,-25,0,17,18,2,-16
"e2911e79efc2420eac45d9f671463d4b","e2911e79efc2420eac45d9f671463d4b",22851474,5,0,1,18,2,2,0
"e2911e79efc2420eac45d9f671463d4b","519d1b8c59404d67b54e96c5c8a830b2",22851474,2,1,0,22,2,3,1
"519d1b8c59404d67b54e96c5c8a830b2","e2911e79efc2420eac45d9f671463d4b",22851474,1,-1,0,23,3,2,-1
"519d1b8c59404d67b54e96c5c8a830b2","6d541c89590949f99af293c4f2333f67",22851474,1,3,0,25,3,6,3
"6d541c89590949f99af293c4f2333f67","6d541c89590949f99af293c4f2333f67",22851474,1,0,1,26,6,6,0
"6d541c89590949f99af293c4f2333f67","531db53f81f646edb0cdcfe0085b03b7",22851474,1,-2,0,27,6,4,-2
"531db53f81f646edb0cdcfe0085b03b7","531db53f81f646edb0cdcfe0085b03b7",22851474,1,0,1,28,4,4,0
"531db53f81f646edb0cdcfe0085b03b7","4f5f94b2f95141e0a9d53a61da2276da",22851474,1,1,0,29,4,5,1
"4f5f94b2f95141e0a9d53a61da2276da","4f5f94b2f95141e0a9d53a61da2276da",22851474,1,0,1,30,5,5,0
"4f5f94b2f95141e0a9d53a61da2276da","66b5e16f4f75454fb5b8172079f0fa83",22851474,1,4,0,31,5,9,4
"66b5e16f4f75454fb5b8172079f0fa83","66b5e16f4f75454fb5b8172079f0fa83",22851474,1,0,1,32,9,9,0
"66b5e16f4f75454fb5b8172079f0fa83","f96261861edc426abe2248be4f0a709a",22851474,1,-1,0,33,9,8,-1
"f96261861edc426abe2248be4f0a709a","f96261861edc426abe2248be4f0a709a",22851474,1,0,1,34,8,8,0
"f96261861edc426abe2248be4f0a709a","0680571d4698477995e41842c36a54b2",22851474,1,2,0,35,8,10,2
"0680571d4698477995e41842c36a54b2","0680571d4698477995e41842c36a54b2",22851474,1,0,1,36,10,10,0
"0680571d4698477995e41842c36a54b2","9112f2bffece48e08c6d2287be204085",22851474,1,1,0,37,10,11,1
"9112f2bffece48e08c6d2287be204085","9112f2bffece48e08c6d2287be204085",22851474,1,0,1,38,11,11,0
"9112f2bffece48e08c6d2287be204085","dd5cf0b9fe4c4f1d8f5ff8e4c04879cb",22851474,1,-4,0,39,11,7,-4
"dd5cf0b9fe4c4f1d8f5ff8e4c04879cb","dd5cf0b9fe4c4f1d8f5ff8e4c04879cb",22851474,1,0,1,40,7,7,0
"dd5cf0b9fe4c4f1d8f5ff8e4c04879cb","e2911e79efc2420eac45d9f671463d4b",22851474,1,-5,0,41,7,2,-5
"56586aa865414f538729c7f7735d2bc6","56586aa865414f538729c7f7735d2bc6",22851474,3,0,1,43,12,12,0
"56586aa865414f538729c7f7735d2bc6","b7f2b31585d94eb3bf86376714aa7070",22851474,1,2,0,46,12,13,1
"b7f2b31585d94eb3bf86376714aa7070","b7f2b31585d94eb3bf86376714aa7070",22851474,1,0,1,47,13,13,0
"b7f2b31585d94eb3bf86376714aa7070","3f1c815879794b929260d224becaff7e",22851474,1,2,0,48,13,14,1
"3f1c815879794b929260d224becaff7e","5c5ceeee4562457ba6d41515aeebfbb1",22851474,1,6,0,49,14,17,3
"5c5ceeee4562457ba6d41515aeebfbb1","81c864a886d54a6b8ff85f7d736f4f95",22851474,1,-4,0,50,17,15,-2
"81c864a886d54a6b8ff85f7d736f4f95","56586aa865414f538729c7f7735d2bc6",22851474,1,-6,0,51,15,12,-3
"9afd71a5298d4333b6849dfce1b9422c","9afd71a5298d4333b6849dfce1b9422c",22851474,1,0,1,53,18,18,0
"56586aa865414f538729c7f7735d2bc6","5c5ceeee4562457ba6d41515aeebfbb1",22851474,1,10,0,55,12,17,5
"5c5ceeee4562457ba6d41515aeebfbb1","5c5ceeee4562457ba6d41515aeebfbb1",22851474,2,0,1,56,17,17,0
"5c5ceeee4562457ba6d41515aeebfbb1","56586aa865414f538729c7f7735d2bc6",22851474,1,-10,0,58,17,12,-5
"9afd71a5298d4333b6849dfce1b9422c","b7719e26494940efa49512aedd0aac79",22851474,1,4,0,60,18,20,2
"b7719e26494940efa49512aedd0aac79","9afd71a5298d4333b6849dfce1b9422c",22851474,1,-4,0,61,20,18,-2
"9afd71a5298d4333b6849dfce1b9422c","d4f45188d3c84a02ba08454e6403a818",22851474,1,9,0,62,18,24,6
"d4f45188d3c84a02ba08454e6403a818","d4c3b003e8274e429d2fa688d73fde6d",22851474,1,-2,0,63,24,22,-2
"d4c3b003e8274e429d2fa688d73fde6d","67a089198fcb4e1c8f2385786c2b296f",22851474,1,37,0,64,22,39,17
"64d48c6c9c7940639a932219a6c87198","b534b89233134e30a9b5645138bfa9ee",22851474,2,3,0,66,40,41,1
"b534b89233134e30a9b5645138bfa9ee","67a089198fcb4e1c8f2385786c2b296f",22851474,2,-4,0,67,41,39,-2
"67a089198fcb4e1c8f2385786c2b296f","0e37b720d23b4e7f8b313e79313fd107",22851474,1,7,0,72,39,44,5
"0e37b720d23b4e7f8b313e79313fd107","0e37b720d23b4e7f8b313e79313fd107",22851474,1,0,1,73,44,44,0
"0e37b720d23b4e7f8b313e79313fd107","6875d67fdd5f48168b62719df449bebd",22851474,1,1,0,74,44,45,1
"6875d67fdd5f48168b62719df449bebd","6875d67fdd5f48168b62719df449bebd",22851474,1,0,1,75,45,45,0
"6875d67fdd5f48168b62719df449bebd","b534b89233134e30a9b5645138bfa9ee",22851474,1,-4,0,76,45,41,-4
"b534b89233134e30a9b5645138bfa9ee","6e13d61a7bdb44bca949c9f86fab3be5",22851474,1,7,0,77,41,47,6
"6e13d61a7bdb44bca949c9f86fab3be5","195f78799f984cc2b06c48dfe36be751",22851474,1,2,0,78,47,49,2
"195f78799f984cc2b06c48dfe36be751","195f78799f984cc2b06c48dfe36be751",22851474,2,0,1,79,49,49,0
"195f78799f984cc2b06c48dfe36be751","d0c74f735e024943943e40333d6d337f",22851474,1,3,0,81,49,51,2
"d0c74f735e024943943e40333d6d337f","d9c8d8c444a64dadbbb508652c721e17",22851474,1,-6,0,82,51,46,-5
"d9c8d8c444a64dadbbb508652c721e17","983f8ff320594b279a7f4a6fe132f9c5",22851474,1,8,0,83,46,53,7
"983f8ff320594b279a7f4a6fe132f9c5","983f8ff320594b279a7f4a6fe132f9c5",22851474,2,0,1,84,53,53,0
"983f8ff320594b279a7f4a6fe132f9c5","35adfa5d923046aebabfefd98f35ff05",22851474,1,1,0,86,53,54,1
"35adfa5d923046aebabfefd98f35ff05","35adfa5d923046aebabfefd98f35ff05",22851474,9,0,1,87,54,54,0
"35adfa5d923046aebabfefd98f35ff05","b6f8a98476224da1b40e555ececc7ed8",22851474,1,1,0,96,54,55,1
"b6f8a98476224da1b40e555ececc7ed8","b6f8a98476224da1b40e555ececc7ed8",22851474,2,0,1,97,55,55,0
"b6f8a98476224da1b40e555ececc7ed8","86e22cb5fe0e4b47a9489ecddf7ed78f",22851474,1,1,0,99,55,56,1
"86e22cb5fe0e4b47a9489ecddf7ed78f","86e22cb5fe0e4b47a9489ecddf7ed78f",22851474,2,0,1,100,56,56,0
"86e22cb5fe0e4b47a9489ecddf7ed78f","f924752d8a1149668870b1e7698486f7",22851474,1,-6,0,102,56,50,-6
"f924752d8a1149668870b1e7698486f7","a1f2f12debe5432fb7a70bcd12bacfb9",22851474,1,9,0,103,50,58,8
"a1f2f12debe5432fb7a70bcd12bacfb9","78f30e4dcac84e3cbea8b2cc6e0d62b3",22851474,2,1,0,104,58,59,1
"78f30e4dcac84e3cbea8b2cc6e0d62b3","a1f2f12debe5432fb7a70bcd12bacfb9",22851474,1,-1,0,105,59,58,-1
"a1f2f12debe5432fb7a70bcd12bacfb9","a1f2f12debe5432fb7a70bcd12bacfb9",22851474,22,0,1,106,58,58,0
"78f30e4dcac84e3cbea8b2cc6e0d62b3","78f30e4dcac84e3cbea8b2cc6e0d62b3",22851474,11,0,1,129,59,59,0
"78f30e4dcac84e3cbea8b2cc6e0d62b3","a0a418b8540d479fa6e0f653b701da8b",22851474,1,6,0,140,59,64,5
"a0a418b8540d479fa6e0f653b701da8b","bc42d26810654ea9a1df1efe1e58c7d5",22851474,1,-1,0,141,64,63,-1
"bc42d26810654ea9a1df1efe1e58c7d5","12aa6e1672ac4e7aa6449a7a8609cd72",22851474,1,-7,0,142,63,57,-6
"12aa6e1672ac4e7aa6449a7a8609cd72","4c943503763e4e349906eea3ed3c8e86",22851474,1,5,0,143,57,61,4
"4c943503763e4e349906eea3ed3c8e86","4c943503763e4e349906eea3ed3c8e86",22851474,1,0,1,144,61,61,0
"4c943503763e4e349906eea3ed3c8e86","bc42d26810654ea9a1df1efe1e58c7d5",22851474,1,2,0,145,61,63,2
"bc42d26810654ea9a1df1efe1e58c7d5","bc42d26810654ea9a1df1efe1e58c7d5",22851474,3,0,1,146,63,63,0
"bc42d26810654ea9a1df1efe1e58c7d5","a0a418b8540d479fa6e0f653b701da8b",22851474,1,1,0,149,63,64,1
"a0a418b8540d479fa6e0f653b701da8b","a0a418b8540d479fa6e0f653b701da8b",22851474,3,0,1,150,64,64,0
"a0a418b8540d479fa6e0f653b701da8b","309ccf3cc4fe429d9bfbaef53d3fa479",22851474,1,-4,0,153,64,60,-4
"309ccf3cc4fe429d9bfbaef53d3fa479","b534b89233134e30a9b5645138bfa9ee",22851474,1,-23,0,154,60,41,-19
"b534b89233134e30a9b5645138bfa9ee","d646286c8051419bbc2e31dd1db55ca8",22851474,1,33,0,155,41,67,26
"d646286c8051419bbc2e31dd1db55ca8","267f883678b24aed855fde42524975d9",22851474,1,4,0,156,67,71,4
"267f883678b24aed855fde42524975d9","267f883678b24aed855fde42524975d9",22851474,1,0,1,157,71,71,0
"267f883678b24aed855fde42524975d9","88fff56d0342490dbef9040750a20f6c",22851474,1,1,0,158,71,72,1
"88fff56d0342490dbef9040750a20f6c","88fff56d0342490dbef9040750a20f6c",22851474,1,0,1,159,72,72,0
"88fff56d0342490dbef9040750a20f6c","adb17b12b66c4a49a85fd34322f7df70",22851474,1,1,0,160,72,73,1
"adb17b12b66c4a49a85fd34322f7df70","adb17b12b66c4a49a85fd34322f7df70",22851474,1,0,1,161,73,73,0
"adb17b12b66c4a49a85fd34322f7df70","d646286c8051419bbc2e31dd1db55ca8",22851474,1,-6,0,162,73,67,-6
"d646286c8051419bbc2e31dd1db55ca8","a2becd407db34b189200a32546d9d569",22851474,2,9,0,163,67,75,8
"a2becd407db34b189200a32546d9d569","58c22b011d0f4c2ea6d13615edbb9eeb",22851474,1,2,0,164,75,77,2
"58c22b011d0f4c2ea6d13615edbb9eeb","58c22b011d0f4c2ea6d13615edbb9eeb",22851474,11,0,1,165,77,77,0
"58c22b011d0f4c2ea6d13615edbb9eeb","dd76e1861dc9461c830888729d091ee0",22851474,1,1,0,176,77,78,1
"dd76e1861dc9461c830888729d091ee0","dd76e1861dc9461c830888729d091ee0",22851474,2,0,1,177,78,78,0
"dd76e1861dc9461c830888729d091ee0","cd1d828f1a694b87913a7ea66c23803e",22851474,1,1,0,179,78,79,1
"cd1d828f1a694b87913a7ea66c23803e","cd1d828f1a694b87913a7ea66c23803e",22851474,2,0,1,180,79,79,0
"cd1d828f1a694b87913a7ea66c23803e","9176a3c2b4d2465fa8b0c67096c2a97e",22851474,1,1,0,182,79,80,1
"9176a3c2b4d2465fa8b0c67096c2a97e","9176a3c2b4d2465fa8b0c67096c2a97e",22851474,11,0,1,183,80,80,0
"9176a3c2b4d2465fa8b0c67096c2a97e","f8ec6445f7194e25b9101d4fbcb07a18",22851474,1,1,0,194,80,81,1
"f8ec6445f7194e25b9101d4fbcb07a18","f8ec6445f7194e25b9101d4fbcb07a18",22851474,5,0,1,195,81,81,0
"f8ec6445f7194e25b9101d4fbcb07a18","140d5b27b8574befad82c0a013b59dfa",22851474,1,-7,0,200,81,74,-7
"140d5b27b8574befad82c0a013b59dfa","d18a9ea32855445f8736581f5cb119ce",22851474,2,9,0,201,74,82,8
"d18a9ea32855445f8736581f5cb119ce","f564483cbd7a407681aa2fcca518cf5f",22851474,1,4,0,202,82,85,3
"f564483cbd7a407681aa2fcca518cf5f","f564483cbd7a407681aa2fcca518cf5f",22851474,1,0,1,203,85,85,0
"f564483cbd7a407681aa2fcca518cf5f","18fd01350bd5434ca636d59a599d768a",22851474,1,1,0,204,85,86,1
"18fd01350bd5434ca636d59a599d768a","18fd01350bd5434ca636d59a599d768a",22851474,9,0,1,205,86,86,0
"18fd01350bd5434ca636d59a599d768a","6a9f0ef185fb47f0937e29daa1c71ed5",22851474,1,5,0,214,86,90,4
"6a9f0ef185fb47f0937e29daa1c71ed5","ae5ac430ea254e708a6f5deaaf7464ae",22851474,2,-7,0,215,90,84,-6
"ae5ac430ea254e708a6f5deaaf7464ae","c681290961c94c4caf23b529d1ae6b9a",22851474,2,5,0,216,84,88,4
"c681290961c94c4caf23b529d1ae6b9a","c681290961c94c4caf23b529d1ae6b9a",22851474,2,0,1,217,88,88,0
"c681290961c94c4caf23b529d1ae6b9a","d646286c8051419bbc2e31dd1db55ca8",22851474,1,-25,0,218,88,67,-21
"d646286c8051419bbc2e31dd1db55ca8","d646286c8051419bbc2e31dd1db55ca8",22851474,1,0,1,219,67,67,0
"a2becd407db34b189200a32546d9d569","140d5b27b8574befad82c0a013b59dfa",22851474,1,-1,0,221,75,74,-1
"d18a9ea32855445f8736581f5cb119ce","6a9f0ef185fb47f0937e29daa1c71ed5",22851474,1,10,0,223,82,90,8
"c681290961c94c4caf23b529d1ae6b9a","6a9f0ef185fb47f0937e29daa1c71ed5",22851474,1,2,0,227,88,90,2
"6a9f0ef185fb47f0937e29daa1c71ed5","d646286c8051419bbc2e31dd1db55ca8",22851474,1,-27,0,228,90,67,-23
"d646286c8051419bbc2e31dd1db55ca8","e20db35ced8544ddac5bc3839145e463",22851474,1,30,0,229,67,91,24
"e20db35ced8544ddac5bc3839145e463","1febb706d7a34005ae8711ed49c76e64",22851474,1,3,0,230,91,94,3
"1febb706d7a34005ae8711ed49c76e64","1febb706d7a34005ae8711ed49c76e64",22851474,2,0,1,231,94,94,0
"1febb706d7a34005ae8711ed49c76e64","8f73ba6f5a0042f2850356ac38ac6f24",22851474,1,1,0,233,94,95,1
"8f73ba6f5a0042f2850356ac38ac6f24","8f73ba6f5a0042f2850356ac38ac6f24",22851474,5,0,1,234,95,95,0
"8f73ba6f5a0042f2850356ac38ac6f24","e2260b86653c46d7b14a41fb419dbf8c",22851474,1,1,0,239,95,96,1
"e2260b86653c46d7b14a41fb419dbf8c","e2260b86653c46d7b14a41fb419dbf8c",22851474,2,0,1,240,96,96,0
"e2260b86653c46d7b14a41fb419dbf8c","35eb641ad1d845bbba54915bce75a962",22851474,1,1,0,242,96,97,1
"35eb641ad1d845bbba54915bce75a962","35eb641ad1d845bbba54915bce75a962",22851474,5,0,1,243,97,97,0
"35eb641ad1d845bbba54915bce75a962","08be90ffbeea4795a138cd42ed8db56f",22851474,1,1,0,248,97,98,1
"08be90ffbeea4795a138cd42ed8db56f","08be90ffbeea4795a138cd42ed8db56f",22851474,5,0,1,249,98,98,0
"08be90ffbeea4795a138cd42ed8db56f","3007433c8f584dcbb5ac159c1c5f2be3",22851474,1,1,0,254,98,99,1
"3007433c8f584dcbb5ac159c1c5f2be3","3007433c8f584dcbb5ac159c1c5f2be3",22851474,5,0,1,255,99,99,0
"3007433c8f584dcbb5ac159c1c5f2be3","00ae5f0c51874a73a41ebea838d95682",22851474,1,3,0,260,99,101,2
"00ae5f0c51874a73a41ebea838d95682","e20db35ced8544ddac5bc3839145e463",22851474,1,-11,0,261,101,91,-10
"e20db35ced8544ddac5bc3839145e463","d391c8b6e56a43a7b654e9dee02d904b",22851474,1,13,0,262,91,103,12
"d391c8b6e56a43a7b654e9dee02d904b","d391c8b6e56a43a7b654e9dee02d904b",22851474,32,0,1,263,103,103,0
"d391c8b6e56a43a7b654e9dee02d904b","6111116566fc4fd9abba409322bea245",22851474,1,1,0,295,103,104,1
"6111116566fc4fd9abba409322bea245","6111116566fc4fd9abba409322bea245",22851474,2,0,1,296,104,104,0
"6111116566fc4fd9abba409322bea245","a81b2235cb9c499eb9ea8ee0a8dd9725",22851474,1,1,0,298,104,105,1
"a81b2235cb9c499eb9ea8ee0a8dd9725","a81b2235cb9c499eb9ea8ee0a8dd9725",22851474,2,0,1,299,105,105,0
"a81b2235cb9c499eb9ea8ee0a8dd9725","2d4e0ab0ef3b4d73b82c72d4621a7579",22851474,1,1,0,301,105,106,1
"2d4e0ab0ef3b4d73b82c72d4621a7579","2d4e0ab0ef3b4d73b82c72d4621a7579",22851474,2,0,1,302,106,106,0
"2d4e0ab0ef3b4d73b82c72d4621a7579","8bdebf492ebd4e62b0d522e8ab5e5197",22851474,1,1,0,304,106,107,1
"8bdebf492ebd4e62b0d522e8ab5e5197","8bdebf492ebd4e62b0d522e8ab5e5197",22851474,2,0,1,305,107,107,0
"8bdebf492ebd4e62b0d522e8ab5e5197","73039f8c1eb9409cb4caee2cf968001e",22851474,1,-7,0,307,107,100,-7
"73039f8c1eb9409cb4caee2cf968001e","4280927ec4d643238aa49c32f9e06c6c",22851474,1,10,0,308,100,109,9
"4280927ec4d643238aa49c32f9e06c6c","fc44e6a5f7654430af1227838224dceb",22851474,1,2,0,309,109,111,2
"fc44e6a5f7654430af1227838224dceb","fc44e6a5f7654430af1227838224dceb",22851474,2,0,1,310,111,111,0
"fc44e6a5f7654430af1227838224dceb","08111f75e22d409998cf8b85bd431f0a",22851474,1,-3,0,312,111,108,-3
"08111f75e22d409998cf8b85bd431f0a","a9ae0a3c070d455bb4369a8996313336",22851474,1,7,0,313,108,114,6
"a9ae0a3c070d455bb4369a8996313336","37319e88176d4aefa91d7a9980dbae91",22851474,1,-2,0,314,114,112,-2
"37319e88176d4aefa91d7a9980dbae91","62bff51286ef4f348717a3cf6fe2318f",22851474,2,9,0,315,112,120,8
"62bff51286ef4f348717a3cf6fe2318f","e20db35ced8544ddac5bc3839145e463",22851474,2,-33,0,316,120,91,-29
"e20db35ced8544ddac5bc3839145e463","e20db35ced8544ddac5bc3839145e463",22851474,3,0,1,317,91,91,0
"e20db35ced8544ddac5bc3839145e463","779f9ddd1fd14d1e9e69f72219a1fdbd",22851474,8,36,0,318,91,121,30
"779f9ddd1fd14d1e9e69f72219a1fdbd","e20db35ced8544ddac5bc3839145e463",22851474,6,-36,0,319,121,91,-30
"779f9ddd1fd14d1e9e69f72219a1fdbd","779f9ddd1fd14d1e9e69f72219a1fdbd",22851474,5,0,1,323,121,121,0
"779f9ddd1fd14d1e9e69f72219a1fdbd","a8dd5213034441ac92724b4e83eb0bb2",22851474,2,9,0,337,121,129,8
"a8dd5213034441ac92724b4e83eb0bb2","579338175e0b4bbb8ef3b712b5d8b54e",22851474,1,-1,0,338,129,128,-1
"579338175e0b4bbb8ef3b712b5d8b54e","b416d47c56a742199b5d7c7f19d6503a",22851474,1,7,0,339,128,134,6
"b416d47c56a742199b5d7c7f19d6503a","779f9ddd1fd14d1e9e69f72219a1fdbd",22851474,1,-15,0,340,134,121,-13
"779f9ddd1fd14d1e9e69f72219a1fdbd","df1de691dafe4549a18a4398ee9dfaf9",22851474,1,23,0,341,121,139,18
"df1de691dafe4549a18a4398ee9dfaf9","6c5ad271a44743479bfaea29b1db8d02",22851474,1,4,0,342,139,143,4
"6c5ad271a44743479bfaea29b1db8d02","67a089198fcb4e1c8f2385786c2b296f",22851474,1,-130,0,343,143,39,-104
"67a089198fcb4e1c8f2385786c2b296f","64d48c6c9c7940639a932219a6c87198",22851474,5,1,0,344,39,40,1
"64d48c6c9c7940639a932219a6c87198","67a089198fcb4e1c8f2385786c2b296f",22851474,2,-1,0,345,40,39,-1
"67a089198fcb4e1c8f2385786c2b296f","b534b89233134e30a9b5645138bfa9ee",22851474,1,4,0,348,39,41,2
"b534b89233134e30a9b5645138bfa9ee","e20db35ced8544ddac5bc3839145e463",22851474,1,63,0,349,41,91,50
"e20db35ced8544ddac5bc3839145e463","62bff51286ef4f348717a3cf6fe2318f",22851474,1,33,0,350,91,120,29
"62bff51286ef4f348717a3cf6fe2318f","3ec3a3563847406fa73338f9e9999cf3",22851474,1,-3,0,351,120,117,-3
"3ec3a3563847406fa73338f9e9999cf3","37319e88176d4aefa91d7a9980dbae91",22851474,1,-6,0,352,117,112,-5
"37319e88176d4aefa91d7a9980dbae91","4280927ec4d643238aa49c32f9e06c6c",22851474,1,-4,0,353,112,109,-3
"4280927ec4d643238aa49c32f9e06c6c","08111f75e22d409998cf8b85bd431f0a",22851474,1,-1,0,354,109,108,-1
"08111f75e22d409998cf8b85bd431f0a","71cec822bcff4f30a20e75dc63ef7b65",22851474,1,9,0,355,108,116,8
"71cec822bcff4f30a20e75dc63ef7b65","71cec822bcff4f30a20e75dc63ef7b65",22851474,1,0,1,356,116,116,0
"71cec822bcff4f30a20e75dc63ef7b65","37319e88176d4aefa91d7a9980dbae91",22851474,1,-4,0,357,116,112,-4
"62bff51286ef4f348717a3cf6fe2318f","b1cd0e7dc3ad4a8eb91a4bfdbeb025b0",22851474,1,-2,0,359,120,118,-2
"b1cd0e7dc3ad4a8eb91a4bfdbeb025b0","b1cd0e7dc3ad4a8eb91a4bfdbeb025b0",22851474,1,0,1,360,118,118,0
"b1cd0e7dc3ad4a8eb91a4bfdbeb025b0","62bff51286ef4f348717a3cf6fe2318f",22851474,1,2,0,361,118,120,2
"62bff51286ef4f348717a3cf6fe2318f","62bff51286ef4f348717a3cf6fe2318f",22851474,3,0,1,362,120,120,0
"779f9ddd1fd14d1e9e69f72219a1fdbd","ae26e6cda8ad4a3f81bd347560d9579f",22851474,1,4,0,368,121,125,4
"ae26e6cda8ad4a3f81bd347560d9579f","ae26e6cda8ad4a3f81bd347560d9579f",22851474,1,0,1,369,125,125,0
"ae26e6cda8ad4a3f81bd347560d9579f","ee48df95832b4374aa273ceb27ec1315",22851474,1,1,0,370,125,126,1
"ee48df95832b4374aa273ceb27ec1315","ee48df95832b4374aa273ceb27ec1315",22851474,3,0,1,371,126,126,0
"ee48df95832b4374aa273ceb27ec1315","7a439da90b394756ad1777fc4c6dead5",22851474,1,1,0,374,126,127,1
"7a439da90b394756ad1777fc4c6dead5","7a439da90b394756ad1777fc4c6dead5",22851474,1,0,1,375,127,127,0
"7a439da90b394756ad1777fc4c6dead5","779f9ddd1fd14d1e9e69f72219a1fdbd",22851474,1,-6,0,376,127,121,-6
"a8dd5213034441ac92724b4e83eb0bb2","8115eab6556b45f5b415c3b8c26a12e5",22851474,1,2,0,378,129,131,2
"8115eab6556b45f5b415c3b8c26a12e5","8115eab6556b45f5b415c3b8c26a12e5",22851474,2,0,1,379,131,131,0
"8115eab6556b45f5b415c3b8c26a12e5","ec34b06efd844b46a4c4818ecdb9b8f4",22851474,1,1,0,381,131,132,1
"ec34b06efd844b46a4c4818ecdb9b8f4","ec34b06efd844b46a4c4818ecdb9b8f4",22851474,5,0,1,382,132,132,0
"ec34b06efd844b46a4c4818ecdb9b8f4","c2e1c2b9eac64109b343a088584b576b",22851474,1,1,0,387,132,133,1
"c2e1c2b9eac64109b343a088584b576b","c2e1c2b9eac64109b343a088584b576b",22851474,2,0,1,388,133,133,0
"c2e1c2b9eac64109b343a088584b576b","579338175e0b4bbb8ef3b712b5d8b54e",22851474,1,-5,0,390,133,128,-5
"579338175e0b4bbb8ef3b712b5d8b54e","8bc5795d6a984a3eace4e2811e52dd4f",22851474,1,8,0,391,128,135,7
"8bc5795d6a984a3eace4e2811e52dd4f","8bc5795d6a984a3eace4e2811e52dd4f",22851474,3,0,1,392,135,135,0
"8bc5795d6a984a3eace4e2811e52dd4f","b416d47c56a742199b5d7c7f19d6503a",22851474,1,-1,0,395,135,134,-1
"b416d47c56a742199b5d7c7f19d6503a","cd4532ad48034873ba8bce2aac0c9808",22851474,1,4,0,396,134,137,3
"cd4532ad48034873ba8bce2aac0c9808","cd4532ad48034873ba8bce2aac0c9808",22851474,2,0,1,397,137,137,0
"cd4532ad48034873ba8bce2aac0c9808","779f9ddd1fd14d1e9e69f72219a1fdbd",22851474,1,-19,0,399,137,121,-16
"779f9ddd1fd14d1e9e69f72219a1fdbd","cd4532ad48034873ba8bce2aac0c9808",22851474,1,19,0,400,121,137,16
"cd4532ad48034873ba8bce2aac0c9808","df1de691dafe4549a18a4398ee9dfaf9",22851474,1,4,0,401,137,139,2
"df1de691dafe4549a18a4398ee9dfaf9","df1de691dafe4549a18a4398ee9dfaf9",22851474,1,0,1,402,139,139,0
"df1de691dafe4549a18a4398ee9dfaf9","83d311bed5374fee83d8d67a7d9d82dc",22851474,1,5,0,403,139,144,5
"83d311bed5374fee83d8d67a7d9d82dc","83d311bed5374fee83d8d67a7d9d82dc",22851474,1,0,1,404,144,144,0
"83d311bed5374fee83d8d67a7d9d82dc","402bba41861d43acb52a5abb89e8831e",22851474,1,1,0,405,144,145,1
"402bba41861d43acb52a5abb89e8831e","402bba41861d43acb52a5abb89e8831e",22851474,2,0,1,406,145,145,0
"402bba41861d43acb52a5abb89e8831e","df1de691dafe4549a18a4398ee9dfaf9",22851474,1,-6,0,408,145,139,-6
"df1de691dafe4549a18a4398ee9dfaf9","8aae34f5ddbb4052a709b12e6b0d40fa",22851474,1,9,0,409,139,147,8
"8aae34f5ddbb4052a709b12e6b0d40fa","645b3f0249f64f76af2e19eb4d0e55b7",22851474,1,2,0,410,147,149,2
"645b3f0249f64f76af2e19eb4d0e55b7","645b3f0249f64f76af2e19eb4d0e55b7",22851474,2,0,1,411,149,149,0
"645b3f0249f64f76af2e19eb4d0e55b7","7e7b8db5064d4369805ab370aac5ddfb",22851474,1,1,0,413,149,150,1
"7e7b8db5064d4369805ab370aac5ddfb","7e7b8db5064d4369805ab370aac5ddfb",22851474,5,0,1,414,150,150,0
"7e7b8db5064d4369805ab370aac5ddfb","8956d210ae7f41968fada86d4c979d6a",22851474,1,1,0,419,150,151,1
"8956d210ae7f41968fada86d4c979d6a","8956d210ae7f41968fada86d4c979d6a",22851474,2,0,1,420,151,151,0
"8956d210ae7f41968fada86d4c979d6a","f902b0f41b544d4dbf79664fd233648d",22851474,1,-5,0,422,151,146,-5
"f902b0f41b544d4dbf79664fd233648d","ae781e8b775e4ccd93bc800dad5c8376",22851474,1,8,0,423,146,153,7
"ae781e8b775e4ccd93bc800dad5c8376","ae781e8b775e4ccd93bc800dad5c8376",22851474,2,0,1,424,153,153,0
"ae781e8b775e4ccd93bc800dad5c8376","06882a8492d9499aa31555567f575ecb",22851474,1,1,0,426,153,154,1
"06882a8492d9499aa31555567f575ecb","06882a8492d9499aa31555567f575ecb",22851474,1,0,1,427,154,154,0
"06882a8492d9499aa31555567f575ecb","f293c508f409466a8f27ddd7d1e40b20",22851474,1,1,0,428,154,155,1
"f293c508f409466a8f27ddd7d1e40b20","f293c508f409466a8f27ddd7d1e40b20",22851474,2,0,1,429,155,155,0
"f293c508f409466a8f27ddd7d1e40b20","cc4ddef5bbbe48ebb605141b347c4ed1",22851474,1,1,0,431,155,156,1
"cc4ddef5bbbe48ebb605141b347c4ed1","cc4ddef5bbbe48ebb605141b347c4ed1",22851474,3,0,1,432,156,156,0
"cc4ddef5bbbe48ebb605141b347c4ed1","f03480cf4eba413194d7af52fc0e7f28",22851474,1,-4,0,435,156,152,-4
"f03480cf4eba413194d7af52fc0e7f28","d313cec988a84645bee413e8d4724a4b",22851474,1,7,0,436,152,158,6
"d313cec988a84645bee413e8d4724a4b","dc60696c76a74368a60f72246e47700d",22851474,1,1,0,437,158,159,1
"dc60696c76a74368a60f72246e47700d","dc60696c76a74368a60f72246e47700d",22851474,3,0,1,438,159,159,0
"dc60696c76a74368a60f72246e47700d","78adeee1fa2c4fe0bc73f7bca9fcee86",22851474,1,3,0,441,159,160,1
"78adeee1fa2c4fe0bc73f7bca9fcee86","df1de691dafe4549a18a4398ee9dfaf9",22851474,1,-26,0,442,160,139,-21
"df1de691dafe4549a18a4398ee9dfaf9","0c7262dff33c4087bc660ccf40f92f9c",22851474,1,43,0,443,139,169,30
"0c7262dff33c4087bc660ccf40f92f9c","b2275c3fad834f8d90737a2d9a6927d6",22851474,3,3,0,444,169,172,3
"b2275c3fad834f8d90737a2d9a6927d6","78adeee1fa2c4fe0bc73f7bca9fcee86",22851474,2,-20,0,445,172,160,-12
"78adeee1fa2c4fe0bc73f7bca9fcee86","8959e6304a0348309a771e4d08d1b64a",22851474,1,4,0,446,160,163,3
"8959e6304a0348309a771e4d08d1b64a","65202579580f4ad38d734b4ee39d22a8",22851474,1,1,0,447,163,164,1
"65202579580f4ad38d734b4ee39d22a8","78adeee1fa2c4fe0bc73f7bca9fcee86",22851474,5,-5,0,453,164,160,-4
"78adeee1fa2c4fe0bc73f7bca9fcee86","3cbcea2be0984e7dbd5a48195af10ce7",22851474,3,8,0,480,160,165,5
"3cbcea2be0984e7dbd5a48195af10ce7","78adeee1fa2c4fe0bc73f7bca9fcee86",22851474,1,-8,0,481,165,160,-5
"78adeee1fa2c4fe0bc73f7bca9fcee86","82e6285962b8400d9d6fc32436022a94",22851474,1,10,0,482,160,167,7
"82e6285962b8400d9d6fc32436022a94","3cbcea2be0984e7dbd5a48195af10ce7",22851474,1,-2,0,483,167,165,-2
"3cbcea2be0984e7dbd5a48195af10ce7","a9ac840f098c4bd0a2ee896214ce29cd",22851474,1,5,0,484,165,168,3
"a9ac840f098c4bd0a2ee896214ce29cd","a9ac840f098c4bd0a2ee896214ce29cd",22851474,1,0,1,485,168,168,0
"a9ac840f098c4bd0a2ee896214ce29cd","0c7262dff33c4087bc660ccf40f92f9c",22851474,1,4,0,486,168,169,1
"3cbcea2be0984e7dbd5a48195af10ce7","82e6285962b8400d9d6fc32436022a94",22851474,2,2,0,521,165,167,2
"82e6285962b8400d9d6fc32436022a94","78adeee1fa2c4fe0bc73f7bca9fcee86",22851474,1,-10,0,522,167,160,-7
"82e6285962b8400d9d6fc32436022a94","67a089198fcb4e1c8f2385786c2b296f",22851474,1,-162,0,534,167,39,-128
"67a089198fcb4e1c8f2385786c2b296f","67a089198fcb4e1c8f2385786c2b296f",22851474,2,0,1,535,39,39,0
"64d48c6c9c7940639a932219a6c87198","0c7262dff33c4087bc660ccf40f92f9c",22851474,1,168,0,537,40,169,129
"b2275c3fad834f8d90737a2d9a6927d6","b2275c3fad834f8d90737a2d9a6927d6",22851474,32,0,1,539,172,172,0
"b2275c3fad834f8d90737a2d9a6927d6","eb515a26030b41f8a82a1e6114420bad",22851474,1,1,0,571,172,173,1
"eb515a26030b41f8a82a1e6114420bad","eb515a26030b41f8a82a1e6114420bad",22851474,2,0,1,572,173,173,0
"eb515a26030b41f8a82a1e6114420bad","b42cc17b7de840f181a704558d0bc845",22851474,1,3,0,574,173,175,2
"b42cc17b7de840f181a704558d0bc845","0c7262dff33c4087bc660ccf40f92f9c",22851474,1,-7,0,575,175,169,-6
"0c7262dff33c4087bc660ccf40f92f9c","801f9e9135034f49bf5f8b4bdefedb41",22851474,1,9,0,576,169,177,8
"801f9e9135034f49bf5f8b4bdefedb41","801f9e9135034f49bf5f8b4bdefedb41",22851474,4,0,1,577,177,177,0
"801f9e9135034f49bf5f8b4bdefedb41","362fcb0699a14845ab29b2340093e528",22851474,1,-3,0,581,177,174,-3
"362fcb0699a14845ab29b2340093e528","ea38cc0e6e6e41edbabf210220808bf9",22851474,1,6,0,582,174,179,5
"ea38cc0e6e6e41edbabf210220808bf9","b87c552dd247427abe6ab5795b9c9d43",22851474,1,2,0,583,179,181,2
"b87c552dd247427abe6ab5795b9c9d43","b87c552dd247427abe6ab5795b9c9d43",22851474,10,0,1,584,181,181,0
"b87c552dd247427abe6ab5795b9c9d43","139b097acfca451689d80c9c6eebdf7b",22851474,1,-3,0,594,181,178,-3
"139b097acfca451689d80c9c6eebdf7b","30f660a1feb34582a739722532524f79",22851474,1,6,0,595,178,183,5
"30f660a1feb34582a739722532524f79","30f660a1feb34582a739722532524f79",22851474,5,0,1,596,183,183,0
"30f660a1feb34582a739722532524f79","2024b4885bd14338a39b7b509acbbd02",22851474,1,-1,0,601,183,182,-1
"2024b4885bd14338a39b7b509acbbd02","c3f63fe50d8e487c86bf8ef76c9cadd3",22851474,1,4,0,602,182,185,3
"c3f63fe50d8e487c86bf8ef76c9cadd3","c3f63fe50d8e487c86bf8ef76c9cadd3",22851474,1,0,1,603,185,185,0
"c3f63fe50d8e487c86bf8ef76c9cadd3","c8e371568a0c4391b25796ae4e91952e",22851474,1,3,0,604,185,186,1
"c8e371568a0c4391b25796ae4e91952e","0c7262dff33c4087bc660ccf40f92f9c",22851474,1,-23,0,605,186,169,-17
"0c7262dff33c4087bc660ccf40f92f9c","7d932b23e1c84326ae5aa4d3c0d813d1",22851474,1,25,0,606,169,188,19
"7d932b23e1c84326ae5aa4d3c0d813d1","7d932b23e1c84326ae5aa4d3c0d813d1",22851474,3,0,1,607,188,188,0
"7d932b23e1c84326ae5aa4d3c0d813d1","c8e371568a0c4391b25796ae4e91952e",22851474,1,-2,0,610,188,186,-2
"c8e371568a0c4391b25796ae4e91952e","ab11d94c6c8948ea90b88f19d2cd502b",22851474,1,5,0,611,186,190,4
"ab11d94c6c8948ea90b88f19d2cd502b","f992451ed6ad4e68bb9e68ad6be7c4be",22851474,1,2,0,612,190,192,2
"f992451ed6ad4e68bb9e68ad6be7c4be","f992451ed6ad4e68bb9e68ad6be7c4be",22851474,1,0,1,613,192,192,0
"f992451ed6ad4e68bb9e68ad6be7c4be","07b44a7a51e94c78b411c753fc39dab0",22851474,1,-3,0,614,192,189,-3
"07b44a7a51e94c78b411c753fc39dab0","6cd2dcaac46847d4a0bc53f296d90375",22851474,1,6,0,615,189,194,5
"6cd2dcaac46847d4a0bc53f296d90375","2d2580c9411c4972909db508d6956a58",22851474,1,2,0,616,194,196,2
"2d2580c9411c4972909db508d6956a58","2d2580c9411c4972909db508d6956a58",22851474,2,0,1,617,196,196,0
"2d2580c9411c4972909db508d6956a58","5bddb3d9ed264f3984702f048c7e5340",22851474,1,1,0,619,196,197,1
"5bddb3d9ed264f3984702f048c7e5340","5bddb3d9ed264f3984702f048c7e5340",22851474,2,0,1,620,197,197,0
"5bddb3d9ed264f3984702f048c7e5340","d5e8e2bd12a2466b9d6d90855f0eb079",22851474,1,1,0,622,197,198,1
"d5e8e2bd12a2466b9d6d90855f0eb079","d5e8e2bd12a2466b9d6d90855f0eb079",22851474,2,0,1,623,198,198,0
"d5e8e2bd12a2466b9d6d90855f0eb079","017d7ca8e0394b91aaadc9574df2202c",22851474,1,-5,0,625,198,193,-5
"017d7ca8e0394b91aaadc9574df2202c","54e8e9f0ea3e45c4bf3b8ac799ee31b1",22851474,1,8,0,626,193,200,7
"54e8e9f0ea3e45c4bf3b8ac799ee31b1","54e8e9f0ea3e45c4bf3b8ac799ee31b1",22851474,1,0,1,627,200,200,0
"54e8e9f0ea3e45c4bf3b8ac799ee31b1","c614a00911be4877a075f19315530fb0",22851474,1,1,0,628,200,201,1
"c614a00911be4877a075f19315530fb0","c614a00911be4877a075f19315530fb0",22851474,6,0,1,629,201,201,0
"c614a00911be4877a075f19315530fb0","a6c21bd8b95249c7972820a7a7d76aff",22851474,1,1,0,635,201,202,1
"a6c21bd8b95249c7972820a7a7d76aff","a6c21bd8b95249c7972820a7a7d76aff",22851474,1,0,1,636,202,202,0
"a6c21bd8b95249c7972820a7a7d76aff","bb329d880ab54120adaf203a693bb203",22851474,1,1,0,637,202,203,1
"bb329d880ab54120adaf203a693bb203","bb329d880ab54120adaf203a693bb203",22851474,1,0,1,638,203,203,0
"bb329d880ab54120adaf203a693bb203","f9170dd6bc6442b4acd832747609b09a",22851474,1,-4,0,639,203,199,-4
"f9170dd6bc6442b4acd832747609b09a","334c2344009840079b1d0e1b7ce3d5a7",22851474,1,7,0,640,199,205,6
"334c2344009840079b1d0e1b7ce3d5a7","334c2344009840079b1d0e1b7ce3d5a7",22851474,1,0,1,641,205,205,0
"334c2344009840079b1d0e1b7ce3d5a7","c8e371568a0c4391b25796ae4e91952e",22851474,1,-23,0,642,205,186,-19
"c8e371568a0c4391b25796ae4e91952e","d7f13c8d63ec4e2aa673fbb9cf9c6933",22851474,1,26,0,643,186,206,20
"d7f13c8d63ec4e2aa673fbb9cf9c6933","b9e80f77c3a44349863b19875725c384",22851474,1,1,0,644,206,207,1
"b9e80f77c3a44349863b19875725c384","7108f0e4c2584f1f9c471689ae4c885c",22851474,2,1,0,645,207,208,1
"7108f0e4c2584f1f9c471689ae4c885c","b9e80f77c3a44349863b19875725c384",22851474,1,-1,0,646,208,207,-1
"b9e80f77c3a44349863b19875725c384","b9e80f77c3a44349863b19875725c384",22851474,25,0,1,647,207,207,0
"7108f0e4c2584f1f9c471689ae4c885c","7108f0e4c2584f1f9c471689ae4c885c",22851474,10,0,1,673,208,208,0
"7108f0e4c2584f1f9c471689ae4c885c","09400e101c5d4b439cf9a26b03aae558",22851474,1,3,0,683,208,210,2
"09400e101c5d4b439cf9a26b03aae558","d7f13c8d63ec4e2aa673fbb9cf9c6933",22851474,1,-5,0,684,210,206,-4
"d7f13c8d63ec4e2aa673fbb9cf9c6933","a88efa7e50ce47159810ab553afa6d3a",22851474,1,7,0,685,206,212,6
"a88efa7e50ce47159810ab553afa6d3a","a88efa7e50ce47159810ab553afa6d3a",22851474,5,0,1,686,212,212,0
"a88efa7e50ce47159810ab553afa6d3a","be502a7a43c44bf7b682698de79d9369",22851474,1,3,0,691,212,214,2
"be502a7a43c44bf7b682698de79d9369","a875096404ef4a9984b62d74cda916f9",22851474,1,-6,0,692,214,209,-5
"a875096404ef4a9984b62d74cda916f9","f7fb1952f56b4189b86a9f8b7862d2b8",22851474,1,7,0,693,209,215,6
"f7fb1952f56b4189b86a9f8b7862d2b8","f7fb1952f56b4189b86a9f8b7862d2b8",22851474,15,0,1,694,215,215,0
"f7fb1952f56b4189b86a9f8b7862d2b8","b860ee85d8bc4a2f97958cfb71be3533",22851474,1,1,0,709,215,216,1
"b860ee85d8bc4a2f97958cfb71be3533","b860ee85d8bc4a2f97958cfb71be3533",22851474,2,0,1,710,216,216,0
"b860ee85d8bc4a2f97958cfb71be3533","ec341f459285443b8361f7f15638ff08",22851474,1,-3,0,712,216,213,-3
"ec341f459285443b8361f7f15638ff08","363837c182e04711840d896ae1e0339c",22851474,1,6,0,713,213,218,5
"363837c182e04711840d896ae1e0339c","363837c182e04711840d896ae1e0339c",22851474,12,0,1,714,218,218,0
"363837c182e04711840d896ae1e0339c","01b2051f8941460d89945e3b02d1ce78",22851474,1,-1,0,726,218,217,-1
"01b2051f8941460d89945e3b02d1ce78","91125ca626c5470eb145501f8c37f8db",22851474,1,4,0,727,217,220,3
"91125ca626c5470eb145501f8c37f8db","91125ca626c5470eb145501f8c37f8db",22851474,1,0,1,728,220,220,0
"91125ca626c5470eb145501f8c37f8db","d7f13c8d63ec4e2aa673fbb9cf9c6933",22851474,1,-18,0,729,220,206,-14
"d7f13c8d63ec4e2aa673fbb9cf9c6933","1c6721b1f63f4d30ba7746ea8af02a52",22851474,1,21,0,730,206,221,15
"1c6721b1f63f4d30ba7746ea8af02a52","77ecef8eff6b4a2caea7707669bf7475",22851474,2,1,0,731,221,222,1
"77ecef8eff6b4a2caea7707669bf7475","1c6721b1f63f4d30ba7746ea8af02a52",22851474,1,-1,0,732,222,221,-1
"77ecef8eff6b4a2caea7707669bf7475","77ecef8eff6b4a2caea7707669bf7475",22851474,12,0,1,734,222,222,0
"77ecef8eff6b4a2caea7707669bf7475","d03cb855c70044cf8c35d9ec0de696e3",22851474,1,3,0,746,222,224,2
"d03cb855c70044cf8c35d9ec0de696e3","1c6721b1f63f4d30ba7746ea8af02a52",22851474,1,-4,0,747,224,221,-3
"1c6721b1f63f4d30ba7746ea8af02a52","8b9ae98743bd4d4a8a87dff1c1244211",22851474,1,7,0,748,221,227,6
"8b9ae98743bd4d4a8a87dff1c1244211","a49a937d6896486d9a5396654abcf2e1",22851474,1,-1,0,749,227,226,-1
"a49a937d6896486d9a5396654abcf2e1","a49a937d6896486d9a5396654abcf2e1",22851474,3,0,1,750,226,226,0
"a49a937d6896486d9a5396654abcf2e1","8b9ae98743bd4d4a8a87dff1c1244211",22851474,1,1,0,753,226,227,1
"8b9ae98743bd4d4a8a87dff1c1244211","8b9ae98743bd4d4a8a87dff1c1244211",22851474,27,0,1,754,227,227,0
"8b9ae98743bd4d4a8a87dff1c1244211","f7906d6f59b9489a91d2ef40db5a474d",22851474,1,-4,0,781,227,223,-4
"f7906d6f59b9489a91d2ef40db5a474d","2ab1535aac1346ba8801535bf729ef37",22851474,1,7,0,782,223,229,6
"2ab1535aac1346ba8801535bf729ef37","a4f40fb48a8542c8949bae1f002cd9bc",22851474,1,2,0,783,229,231,2
"a4f40fb48a8542c8949bae1f002cd9bc","a4f40fb48a8542c8949bae1f002cd9bc",22851474,2,0,1,784,231,231,0
"a4f40fb48a8542c8949bae1f002cd9bc","8972c23e32044edb8a78fa1eed4e5947",22851474,1,1,0,786,231,232,1
"8972c23e32044edb8a78fa1eed4e5947","8972c23e32044edb8a78fa1eed4e5947",22851474,3,0,1,787,232,232,0
"8972c23e32044edb8a78fa1eed4e5947","92feb4a40f8344d38b6f722e42a53295",22851474,1,1,0,790,232,233,1
"92feb4a40f8344d38b6f722e42a53295","92feb4a40f8344d38b6f722e42a53295",22851474,2,0,1,791,233,233,0
"92feb4a40f8344d38b6f722e42a53295","5152833676bf4c6cb317060be10f68db",22851474,1,-5,0,793,233,228,-5
"5152833676bf4c6cb317060be10f68db","ca3e28f290354c08aefe5b0f769604e6",22851474,1,8,0,794,228,235,7
"ca3e28f290354c08aefe5b0f769604e6","ca3e28f290354c08aefe5b0f769604e6",22851474,14,0,1,795,235,235,0
"ca3e28f290354c08aefe5b0f769604e6","79a35eea833e4c2c9d22fc53c3c6445c",22851474,1,1,0,809,235,236,1
"79a35eea833e4c2c9d22fc53c3c6445c","79a35eea833e4c2c9d22fc53c3c6445c",22851474,4,0,1,810,236,236,0
"79a35eea833e4c2c9d22fc53c3c6445c","8f68228b1518449e9615cdafee41a2bd",22851474,1,1,0,814,236,237,1
"8f68228b1518449e9615cdafee41a2bd","8f68228b1518449e9615cdafee41a2bd",22851474,2,0,1,815,237,237,0
"8f68228b1518449e9615cdafee41a2bd","cab89fa5c3ed45a5aa550fc0352d6a42",22851474,1,1,0,817,237,238,1
"cab89fa5c3ed45a5aa550fc0352d6a42","cab89fa5c3ed45a5aa550fc0352d6a42",22851474,5,0,1,818,238,238,0
"cab89fa5c3ed45a5aa550fc0352d6a42","66d4fad4f1cf4b46be0750a99ad7a35a",22851474,1,1,0,823,238,239,1
"66d4fad4f1cf4b46be0750a99ad7a35a","66d4fad4f1cf4b46be0750a99ad7a35a",22851474,1,0,1,824,239,239,0
"66d4fad4f1cf4b46be0750a99ad7a35a","0b04c8e2f86d48c7aeb7e225819cd32b",22851474,1,-5,0,825,239,234,-5
"0b04c8e2f86d48c7aeb7e225819cd32b","f53da5fd9bfe412da4b80d4742563b6c",22851474,1,8,0,826,234,241,7
"f53da5fd9bfe412da4b80d4742563b6c","f53da5fd9bfe412da4b80d4742563b6c",22851474,1,0,1,827,241,241,0
"f53da5fd9bfe412da4b80d4742563b6c","1c6721b1f63f4d30ba7746ea8af02a52",22851474,1,-24,0,828,241,221,-20
"1c6721b1f63f4d30ba7746ea8af02a52","2ae94c0cea4d480a9d5dca8fb1d7b542",22851474,1,27,0,829,221,242,21
"2ae94c0cea4d480a9d5dca8fb1d7b542","1ebf23f9d994469a85206e4c7b1bf5f5",22851474,3,3,0,830,242,245,3
"1ebf23f9d994469a85206e4c7b1bf5f5","2ae94c0cea4d480a9d5dca8fb1d7b542",22851474,2,-3,0,831,245,242,-3
"1ebf23f9d994469a85206e4c7b1bf5f5","1ebf23f9d994469a85206e4c7b1bf5f5",22851474,13,0,1,835,245,245,0
"1ebf23f9d994469a85206e4c7b1bf5f5","85ae675b83e8422da842cfd25596af99",22851474,1,1,0,848,245,246,1
"85ae675b83e8422da842cfd25596af99","85ae675b83e8422da842cfd25596af99",22851474,1,0,1,849,246,246,0
"85ae675b83e8422da842cfd25596af99","2ae94c0cea4d480a9d5dca8fb1d7b542",22851474,1,-4,0,850,246,242,-4
"2ae94c0cea4d480a9d5dca8fb1d7b542","30c9ba177afc49a695625d2bdec40207",22851474,1,9,0,851,242,250,8
"30c9ba177afc49a695625d2bdec40207","30c9ba177afc49a695625d2bdec40207",22851474,5,0,1,852,250,250,0
"30c9ba177afc49a695625d2bdec40207","6e83e23f56544a19b94067c1c558d9c0",22851474,1,-3,0,857,250,247,-3
"6e83e23f56544a19b94067c1c558d9c0","00f61990949545828dd12f1303d47504",22851474,1,11,0,858,247,256,9
"00f61990949545828dd12f1303d47504","ead7bb4b64e247d2ae632ab8a296b091",22851474,1,2,0,859,256,258,2
"ead7bb4b64e247d2ae632ab8a296b091","ead7bb4b64e247d2ae632ab8a296b091",22851474,2,0,1,860,258,258,0
"ead7bb4b64e247d2ae632ab8a296b091","41b0048dde734bb280bac6116baa8e27",22851474,1,1,0,862,258,259,1
"41b0048dde734bb280bac6116baa8e27","41b0048dde734bb280bac6116baa8e27",22851474,5,0,1,863,259,259,0
"41b0048dde734bb280bac6116baa8e27","b41c5a094a604ee0915327da5cc0beb7",22851474,1,1,0,868,259,260,1
"b41c5a094a604ee0915327da5cc0beb7","b41c5a094a604ee0915327da5cc0beb7",22851474,2,0,1,869,260,260,0
"b41c5a094a604ee0915327da5cc0beb7","d546341988904f069cfa86b21457d9d9",22851474,1,-10,0,871,260,251,-9
"d546341988904f069cfa86b21457d9d9","28c171777c52431ab6b925073bd63d46",22851474,1,15,0,872,251,264,13
"28c171777c52431ab6b925073bd63d46","28c171777c52431ab6b925073bd63d46",22851474,11,0,1,873,264,264,0
"28c171777c52431ab6b925073bd63d46","ac160db940cb49ae8579162b1d52bb5d",22851474,1,2,0,884,264,266,2
"ac160db940cb49ae8579162b1d52bb5d","ac160db940cb49ae8579162b1d52bb5d",22851474,11,0,1,885,266,266,0
"ac160db940cb49ae8579162b1d52bb5d","d989ebcfc12a4b669f0100dc1aa14f1e",22851474,1,-12,0,896,266,255,-11
"d989ebcfc12a4b669f0100dc1aa14f1e","c6fd49b485cc4874b0bbdd9c6171e09c",22851474,1,15,0,897,255,268,13
"c6fd49b485cc4874b0bbdd9c6171e09c","c6fd49b485cc4874b0bbdd9c6171e09c",22851474,7,0,1,898,268,268,0
"c6fd49b485cc4874b0bbdd9c6171e09c","44240778a97c4af0937817499b75707b",22851474,1,1,0,905,268,269,1
"44240778a97c4af0937817499b75707b","44240778a97c4af0937817499b75707b",22851474,2,0,1,906,269,269,0
"44240778a97c4af0937817499b75707b","7aa76d3e993840d8805f097cbdbcd44b",22851474,1,-9,0,908,269,261,-8
"7aa76d3e993840d8805f097cbdbcd44b","865a4d3b43374da7944dc7d397f566d9",22851474,1,12,0,909,261,271,10
"865a4d3b43374da7944dc7d397f566d9","865a4d3b43374da7944dc7d397f566d9",22851474,2,0,1,910,271,271,0
"865a4d3b43374da7944dc7d397f566d9","2ae94c0cea4d480a9d5dca8fb1d7b542",22851474,1,-35,0,912,271,242,-29
"2ae94c0cea4d480a9d5dca8fb1d7b542","0d987bed3ffa4ed0b9a2e62e97b7b30f",22851474,1,38,0,913,242,272,30
"0d987bed3ffa4ed0b9a2e62e97b7b30f","d646286c8051419bbc2e31dd1db55ca8",22851474,1,-267,0,914,272,67,-205
"d646286c8051419bbc2e31dd1db55ca8","6a9f0ef185fb47f0937e29daa1c71ed5",22851474,1,27,0,915,67,90,23
"6a9f0ef185fb47f0937e29daa1c71ed5","0d987bed3ffa4ed0b9a2e62e97b7b30f",22851474,1,240,0,916,90,272,182
"0d987bed3ffa4ed0b9a2e62e97b7b30f","0d987bed3ffa4ed0b9a2e62e97b7b30f",22851474,1,0,1,917,272,272,0
"bb5a47f5ea01454a8b79455422d3b9da","82ae07bc0c9b4570a41799290d1ef399",22851474,1,-6,0,926,280,275,-5
"82ae07bc0c9b4570a41799290d1ef399","bb5a47f5ea01454a8b79455422d3b9da",22851474,1,6,0,927,275,280,5
"bb5a47f5ea01454a8b79455422d3b9da","0d987bed3ffa4ed0b9a2e62e97b7b30f",22851474,1,-10,0,965,280,272,-8
"0d987bed3ffa4ed0b9a2e62e97b7b30f","94cecc3f1e7d484b8e068e79241dfd73",22851474,1,13,0,966,272,281,9
"94cecc3f1e7d484b8e068e79241dfd73","a37477c4e4c14169ad44b06b493007f6",22851474,1,2,0,967,281,283,2
"a37477c4e4c14169ad44b06b493007f6","fab84b4fab5940efb4ea868ef8d09396",22851474,1,3,0,968,283,284,1
"fab84b4fab5940efb4ea868ef8d09396","94cecc3f1e7d484b8e068e79241dfd73",22851474,3,-5,0,969,284,281,-3
"94cecc3f1e7d484b8e068e79241dfd73","94cecc3f1e7d484b8e068e79241dfd73",22851474,3,0,1,970,281,281,0
"94cecc3f1e7d484b8e068e79241dfd73","fab84b4fab5940efb4ea868ef8d09396",22851474,3,5,0,971,281,284,3
"fab84b4fab5940efb4ea868ef8d09396","fab84b4fab5940efb4ea868ef8d09396",22851474,3,0,1,974,284,284,0
"fab84b4fab5940efb4ea868ef8d09396","4a29443515bb404cb8924e1c60a63b73",22851474,1,4,0,981,284,285,1
"4a29443515bb404cb8924e1c60a63b73","208c9b2796c944db8dacaa96082520ea",22851474,2,3,0,982,285,288,3
"208c9b2796c944db8dacaa96082520ea","4a29443515bb404cb8924e1c60a63b73",22851474,2,-3,0,983,288,285,-3
"4a29443515bb404cb8924e1c60a63b73","4a29443515bb404cb8924e1c60a63b73",22851474,2,0,1,984,285,285,0
"4a29443515bb404cb8924e1c60a63b73","7669a956527947d0add87455277e80b4",22851474,1,7,0,988,285,291,6
"7669a956527947d0add87455277e80b4","7669a956527947d0add87455277e80b4",22851474,1,0,1,989,291,291,0
"7669a956527947d0add87455277e80b4","6a9a3b5bde4a48daa896fe8c06eca56f",22851474,1,-2,0,990,291,289,-2
"6a9a3b5bde4a48daa896fe8c06eca56f","869e967078f04da18dd0b0b9389a7424",22851474,1,5,0,991,289,293,4
"869e967078f04da18dd0b0b9389a7424","51ab6291537748fab90d519aa09889d6",22851474,1,2,0,992,293,295,2
"51ab6291537748fab90d519aa09889d6","51ab6291537748fab90d519aa09889d6",22851474,11,0,1,1000,295,295,0
"51ab6291537748fab90d519aa09889d6","34a6e49023fc4465bd5ca604330bbd1c",22851474,1,-3,0,1004,295,292,-3
"34a6e49023fc4465bd5ca604330bbd1c","ba0e59461bfb4a44b7b1c28a01f8d3b3",22851474,1,9,0,1005,292,299,7
"ba0e59461bfb4a44b7b1c28a01f8d3b3","21592f2a9e9c4b2f8c66ec5dbcbf6a2b",22851474,1,-4,0,1006,299,296,-3
"21592f2a9e9c4b2f8c66ec5dbcbf6a2b","0e0b36e731a645e7b1b8a88f5031ca38",22851474,1,6,0,1007,296,301,5
"0e0b36e731a645e7b1b8a88f5031ca38","0e0b36e731a645e7b1b8a88f5031ca38",22851474,8,0,1,1008,301,301,0
"0e0b36e731a645e7b1b8a88f5031ca38","a66a144637284c21afc6de17fea4bfb8",22851474,1,1,0,1016,301,302,1
"a66a144637284c21afc6de17fea4bfb8","a66a144637284c21afc6de17fea4bfb8",22851474,2,0,1,1017,302,302,0
"a66a144637284c21afc6de17fea4bfb8","7646a919d7e64fa990bca9b024ff089d",22851474,1,-4,0,1019,302,298,-4
"7646a919d7e64fa990bca9b024ff089d","e390b575229748ea8aac9364efe2bf00",22851474,1,7,0,1020,298,304,6
"e390b575229748ea8aac9364efe2bf00","e390b575229748ea8aac9364efe2bf00",22851474,1,0,1,1021,304,304,0
"e390b575229748ea8aac9364efe2bf00","3434c10e561d488a914e0f7d71907abd",22851474,1,3,0,1022,304,305,1
"3434c10e561d488a914e0f7d71907abd","4a29443515bb404cb8924e1c60a63b73",22851474,1,-27,0,1023,305,285,-20
"4a29443515bb404cb8924e1c60a63b73","53e7e900392747ccad52e711ab0f80d8",22851474,1,29,0,1024,285,307,22
"53e7e900392747ccad52e711ab0f80d8","3434c10e561d488a914e0f7d71907abd",22851474,1,-2,0,1025,307,305,-2
"3434c10e561d488a914e0f7d71907abd","130acc2aeb0448fdbb2de63bc5cebe5b",22851474,1,5,0,1026,305,309,4
"130acc2aeb0448fdbb2de63bc5cebe5b","9c062b3251034ebe90f5054e2a3b5120",22851474,1,2,0,1027,309,311,2
"9c062b3251034ebe90f5054e2a3b5120","9c062b3251034ebe90f5054e2a3b5120",22851474,2,0,1,1028,311,311,0
"9c062b3251034ebe90f5054e2a3b5120","ea859f8207e44537889daeaba13ac2e8",22851474,1,1,0,1030,311,312,1
"ea859f8207e44537889daeaba13ac2e8","ea859f8207e44537889daeaba13ac2e8",22851474,1,0,1,1031,312,312,0
"ea859f8207e44537889daeaba13ac2e8","56d94971a7a94257aa330183a8ebd0ea",22851474,1,1,0,1032,312,313,1
"56d94971a7a94257aa330183a8ebd0ea","56d94971a7a94257aa330183a8ebd0ea",22851474,4,0,1,1033,313,313,0
"56d94971a7a94257aa330183a8ebd0ea","141c0df6cd1946539aadd1c9b7068cd4",22851474,1,-5,0,1037,313,308,-5
"141c0df6cd1946539aadd1c9b7068cd4","13255e63e0aa4abf85e5211bf613d43e",22851474,1,10,0,1038,308,317,9
"13255e63e0aa4abf85e5211bf613d43e","13255e63e0aa4abf85e5211bf613d43e",22851474,3,0,1,1039,317,317,0
"13255e63e0aa4abf85e5211bf613d43e","0c787d16c9504873b1a4d903cec09948",22851474,1,-3,0,1042,317,314,-3
"0c787d16c9504873b1a4d903cec09948","86c27d40179e419c8e9d150fb6afa5d0",22851474,1,6,0,1043,314,319,5
"86c27d40179e419c8e9d150fb6afa5d0","8d7e0b55cf9849cda222a0f2440cec55",22851474,1,-1,0,1044,319,318,-1
"8d7e0b55cf9849cda222a0f2440cec55","47edbb64109243e6b0f8f64cdef90c6c",22851474,1,9,0,1045,318,326,8
"47edbb64109243e6b0f8f64cdef90c6c","24f1363179ad4aaa965484a78471912b",22851474,1,-3,0,1046,326,323,-3
"24f1363179ad4aaa965484a78471912b","3628bdce1dd2429ba924d2d4d09448d2",22851474,1,-1,0,1047,323,322,-1
"3628bdce1dd2429ba924d2d4d09448d2","56b3fd1a212a4764be39d979fde3326e",22851474,1,7,0,1048,322,328,6
"56b3fd1a212a4764be39d979fde3326e","56b3fd1a212a4764be39d979fde3326e",22851474,2,0,1,1049,328,328,0
"56b3fd1a212a4764be39d979fde3326e","3434c10e561d488a914e0f7d71907abd",22851474,1,-28,0,1050,328,305,-23
"3434c10e561d488a914e0f7d71907abd","56b3fd1a212a4764be39d979fde3326e",22851474,1,28,0,1051,305,328,23
"56b3fd1a212a4764be39d979fde3326e","0c4079457ede49e3aeb5e86ed84bdf35",22851474,1,3,0,1053,328,329,1
"0c4079457ede49e3aeb5e86ed84bdf35","38aea304b4fa46e1b29bb72f5cea4c93",22851474,1,2,0,1054,329,331,2
"38aea304b4fa46e1b29bb72f5cea4c93","e36d261332f14e79bb4b467aceaeb9b5",22851474,1,2,0,1055,331,333,2
"e36d261332f14e79bb4b467aceaeb9b5","e36d261332f14e79bb4b467aceaeb9b5",22851474,1,0,1,1056,333,333,0
"e36d261332f14e79bb4b467aceaeb9b5","c7e89b9d04744d2eab742fc24e3ef1ae",22851474,1,1,0,1057,333,334,1
"c7e89b9d04744d2eab742fc24e3ef1ae","c7e89b9d04744d2eab742fc24e3ef1ae",22851474,5,0,1,1058,334,334,0
"c7e89b9d04744d2eab742fc24e3ef1ae","fe49f8054b374a0ea4bb266ed135ff62",22851474,1,1,0,1063,334,335,1
"fe49f8054b374a0ea4bb266ed135ff62","fe49f8054b374a0ea4bb266ed135ff62",22851474,2,0,1,1064,335,335,0
"fe49f8054b374a0ea4bb266ed135ff62","d0a8f74af98642fe8360d22c42e45117",22851474,1,1,0,1066,335,336,1
"d0a8f74af98642fe8360d22c42e45117","d0a8f74af98642fe8360d22c42e45117",22851474,2,0,1,1067,336,336,0
"d0a8f74af98642fe8360d22c42e45117","0c4079457ede49e3aeb5e86ed84bdf35",22851474,1,-7,0,1069,336,329,-7
"0c4079457ede49e3aeb5e86ed84bdf35","a7c6339ca1da4368a18d471f0519f877",22851474,1,11,0,1070,329,339,10
"a7c6339ca1da4368a18d471f0519f877","a7c6339ca1da4368a18d471f0519f877",22851474,1,0,1,1071,339,339,0
"a7c6339ca1da4368a18d471f0519f877","b8b9418ab322418d9db9b40d96af873a",22851474,1,-2,0,1072,339,337,-2
"b8b9418ab322418d9db9b40d96af873a","bbc5139ca9024389a94db3a6f47dcff6",22851474,1,5,0,1073,337,341,4
"bbc5139ca9024389a94db3a6f47dcff6","4ee6ca9019ab4a1ab323f98094a9bd77",22851474,1,2,0,1074,341,343,2
"4ee6ca9019ab4a1ab323f98094a9bd77","4ee6ca9019ab4a1ab323f98094a9bd77",22851474,5,0,1,1075,343,343,0
"4ee6ca9019ab4a1ab323f98094a9bd77","b37947176785476f8b29d49a851366dc",22851474,1,1,0,1080,343,344,1
"b37947176785476f8b29d49a851366dc","b37947176785476f8b29d49a851366dc",22851474,5,0,1,1081,344,344,0
"b37947176785476f8b29d49a851366dc","fcea5b10d5a14a3b9324ffece8f6e1e5",22851474,1,1,0,1086,344,345,1
"fcea5b10d5a14a3b9324ffece8f6e1e5","fcea5b10d5a14a3b9324ffece8f6e1e5",22851474,5,0,1,1087,345,345,0
"fcea5b10d5a14a3b9324ffece8f6e1e5","c2490bc612d146edbe786556fab3651b",22851474,1,-5,0,1092,345,340,-5
"c2490bc612d146edbe786556fab3651b","6ac8bb048b854999a47edb35fe627f11",22851474,1,8,0,1093,340,347,7
"6ac8bb048b854999a47edb35fe627f11","6ac8bb048b854999a47edb35fe627f11",22851474,1,0,1,1094,347,347,0
"6ac8bb048b854999a47edb35fe627f11","0c4079457ede49e3aeb5e86ed84bdf35",22851474,1,-21,0,1095,347,329,-18
"0c4079457ede49e3aeb5e86ed84bdf35","30ead9794d4847abaf222ca966cc8630",22851474,1,24,0,1096,329,348,19
"30ead9794d4847abaf222ca966cc8630","eff0de7f2dbb42dfa1a2e686efab5b6d",22851474,1,6,0,1097,348,354,6
"eff0de7f2dbb42dfa1a2e686efab5b6d","09b9678ddc3d452ea4a3d46e15826065",22851474,2,-1,0,1098,354,353,-1
"09b9678ddc3d452ea4a3d46e15826065","c20993c944444fe085345591a8bd837e",22851474,2,-2,0,1099,353,351,-2
"c20993c944444fe085345591a8bd837e","897b7f51242c44aab2205c72fdcbf4cd",22851474,3,1,0,1100,351,352,1
"897b7f51242c44aab2205c72fdcbf4cd","30ead9794d4847abaf222ca966cc8630",22851474,1,-4,0,1101,352,348,-4
"30ead9794d4847abaf222ca966cc8630","30ead9794d4847abaf222ca966cc8630",22851474,1,0,1,1102,348,348,0
"30ead9794d4847abaf222ca966cc8630","c20993c944444fe085345591a8bd837e",22851474,1,3,0,1103,348,351,3
"897b7f51242c44aab2205c72fdcbf4cd","eff0de7f2dbb42dfa1a2e686efab5b6d",22851474,1,2,0,1105,352,354,2
"c20993c944444fe085345591a8bd837e","c20993c944444fe085345591a8bd837e",22851474,3,0,1,1108,351,351,0
"897b7f51242c44aab2205c72fdcbf4cd","897b7f51242c44aab2205c72fdcbf4cd",22851474,3,0,1,1112,352,352,0
"897b7f51242c44aab2205c72fdcbf4cd","09b9678ddc3d452ea4a3d46e15826065",22851474,1,1,0,1115,352,353,1
"09b9678ddc3d452ea4a3d46e15826065","09b9678ddc3d452ea4a3d46e15826065",22851474,3,0,1,1116,353,353,0
"09b9678ddc3d452ea4a3d46e15826065","eff0de7f2dbb42dfa1a2e686efab5b6d",22851474,1,1,0,1119,353,354,1
"eff0de7f2dbb42dfa1a2e686efab5b6d","eff0de7f2dbb42dfa1a2e686efab5b6d",22851474,3,0,1,1120,354,354,0
"eff0de7f2dbb42dfa1a2e686efab5b6d","2fe14166dc9642c3bc666b86a57f943d",22851474,1,4,0,1123,354,357,3
"2fe14166dc9642c3bc666b86a57f943d","30ead9794d4847abaf222ca966cc8630",22851474,1,-10,0,1124,357,348,-9
"30ead9794d4847abaf222ca966cc8630","44421dd1e13a47a388c4a19834b744c7",22851474,1,12,0,1125,348,359,11
"44421dd1e13a47a388c4a19834b744c7","44421dd1e13a47a388c4a19834b744c7",22851474,2,0,1,1126,359,359,0
"44421dd1e13a47a388c4a19834b744c7","cb5fc7ef85d547c4be1a7439d0bf6052",22851474,1,1,0,1128,359,360,1
"cb5fc7ef85d547c4be1a7439d0bf6052","cb5fc7ef85d547c4be1a7439d0bf6052",22851474,5,0,1,1129,360,360,0
"cb5fc7ef85d547c4be1a7439d0bf6052","0a8f150a4cf747acbde62f4721823da3",22851474,1,1,0,1134,360,361,1
"0a8f150a4cf747acbde62f4721823da3","0a8f150a4cf747acbde62f4721823da3",22851474,2,0,1,1135,361,361,0
"0a8f150a4cf747acbde62f4721823da3","ab8fdad974ae471f9f24c3f9dd04462e",22851474,1,1,0,1137,361,362,1
"ab8fdad974ae471f9f24c3f9dd04462e","ab8fdad974ae471f9f24c3f9dd04462e",22851474,2,0,1,1138,362,362,0
"ab8fdad974ae471f9f24c3f9dd04462e","1ba8fef685d74a8194b9db252eb704fb",22851474,1,-7,0,1140,362,355,-7
"1ba8fef685d74a8194b9db252eb704fb","52580888dadb4fe3baa795683ea227bd",22851474,1,10,0,1141,355,364,9
"52580888dadb4fe3baa795683ea227bd","492a3bc6a1254f23a7998587961b22a4",22851474,1,3,0,1142,364,366,2
"492a3bc6a1254f23a7998587961b22a4","f00179e251a045b39c3f7a54f9aa4acc",22851474,1,-4,0,1143,366,363,-3
"f00179e251a045b39c3f7a54f9aa4acc","072a190fd302456290895f9f04d6940a",22851474,1,3,0,1144,363,365,2
"072a190fd302456290895f9f04d6940a","cfa457d1743848e4bb5e4beced6448ed",22851474,1,5,0,1145,365,369,4
"cfa457d1743848e4bb5e4beced6448ed","cfa457d1743848e4bb5e4beced6448ed",22851474,1,0,1,1146,369,369,0
"cfa457d1743848e4bb5e4beced6448ed","b71bac264efb4abd97015447bd490db6",22851474,1,3,0,1147,369,370,1
"b71bac264efb4abd97015447bd490db6","30ead9794d4847abaf222ca966cc8630",22851474,1,-28,0,1148,370,348,-22
"30ead9794d4847abaf222ca966cc8630","b71bac264efb4abd97015447bd490db6",22851474,1,28,0,1149,348,370,22
"b71bac264efb4abd97015447bd490db6","b71bac264efb4abd97015447bd490db6",22851474,1,0,1,1150,370,370,0
"b71bac264efb4abd97015447bd490db6","8d448d625b024c82a5eb240bbd7431d6",22851474,3,5,0,1151,370,374,4
"8d448d625b024c82a5eb240bbd7431d6","8d448d625b024c82a5eb240bbd7431d6",22851474,69,0,1,1152,374,374,0
"8d448d625b024c82a5eb240bbd7431d6","b71bac264efb4abd97015447bd490db6",22851474,1,-5,0,1185,374,370,-4
"b71bac264efb4abd97015447bd490db6","d6d02b6ef04e4f17805504500b8ce441",22851474,1,8,0,1186,370,375,5
"d6d02b6ef04e4f17805504500b8ce441","d6d02b6ef04e4f17805504500b8ce441",22851474,2,0,1,1187,375,375,0
"d6d02b6ef04e4f17805504500b8ce441","66baf19b6b904b70922329068c63746d",22851474,1,4,0,1189,375,376,1
"66baf19b6b904b70922329068c63746d","7f544639412e40a9ba27f43b415362ab",22851474,3,2,0,1190,376,378,2
"7f544639412e40a9ba27f43b415362ab","66baf19b6b904b70922329068c63746d",22851474,2,-2,0,1191,378,376,-2
"66baf19b6b904b70922329068c63746d","66baf19b6b904b70922329068c63746d",22851474,2,0,1,1192,376,376,0
"7f544639412e40a9ba27f43b415362ab","d5ae8642e15b46b8bd298b02274d4e9c",22851474,1,2,0,1197,378,380,2
"d5ae8642e15b46b8bd298b02274d4e9c","d5ae8642e15b46b8bd298b02274d4e9c",22851474,1,0,1,1198,380,380,0
"d5ae8642e15b46b8bd298b02274d4e9c","a0d10309a2dd456289147f84be9d37f9",22851474,1,1,0,1199,380,381,1
"a0d10309a2dd456289147f84be9d37f9","a0d10309a2dd456289147f84be9d37f9",22851474,2,0,1,1200,381,381,0
"a0d10309a2dd456289147f84be9d37f9","0fcbc3ca07b144138b8d85da581f09a8",22851474,1,1,0,1202,381,382,1
"0fcbc3ca07b144138b8d85da581f09a8","0fcbc3ca07b144138b8d85da581f09a8",22851474,8,0,1,1203,382,382,0
"0fcbc3ca07b144138b8d85da581f09a8","66baf19b6b904b70922329068c63746d",22851474,1,-6,0,1211,382,376,-6
"66baf19b6b904b70922329068c63746d","c2fca3669923477ab966ded303dea31c",22851474,1,8,0,1212,376,383,7
"c2fca3669923477ab966ded303dea31c","4890121ce5d74576b4632b77cfc23398",22851474,1,6,0,1213,383,388,5
"4890121ce5d74576b4632b77cfc23398","96bb2b3e85a34d8b9544514e89f6fe97",22851474,1,3,0,1214,388,390,2
"96bb2b3e85a34d8b9544514e89f6fe97","18d3b836dd804224883cc9180b60a8e1",22851474,1,-4,0,1215,390,387,-3
"18d3b836dd804224883cc9180b60a8e1","ac4e9b54acfe4670b4634859c7263cb5",22851474,1,6,0,1216,387,392,5
"ac4e9b54acfe4670b4634859c7263cb5","ac4e9b54acfe4670b4634859c7263cb5",22851474,1,0,1,1217,392,392,0
"ac4e9b54acfe4670b4634859c7263cb5","17f95d18bab743888e1736033dc3384d",22851474,1,-3,0,1218,392,389,-3
"17f95d18bab743888e1736033dc3384d","6f8881a745ac4c358a68b92c3b4abe81",22851474,1,6,0,1219,389,394,5
"6f8881a745ac4c358a68b92c3b4abe81","f7002c8484354eceac57bc7bd62c76c1",22851474,1,-1,0,1220,394,393,-1
"f7002c8484354eceac57bc7bd62c76c1","44a277ea44dc4ae689fab4b82f0b4098",22851474,1,5,0,1221,393,397,4
"44a277ea44dc4ae689fab4b82f0b4098","44a277ea44dc4ae689fab4b82f0b4098",22851474,1,0,1,1222,397,397,0
"44a277ea44dc4ae689fab4b82f0b4098","0c12af0a4e7f4002852cf84b2537c161",22851474,1,-2,0,1223,397,395,-2
"0c12af0a4e7f4002852cf84b2537c161","859e0b8d71694b12befb69ee698138f9",22851474,1,5,0,1224,395,399,4
"859e0b8d71694b12befb69ee698138f9","859e0b8d71694b12befb69ee698138f9",22851474,1,0,1,1225,399,399,0
"859e0b8d71694b12befb69ee698138f9","2b09a08242b54983aec7063990fb3f66",22851474,1,3,0,1226,399,400,1
"2b09a08242b54983aec7063990fb3f66","66baf19b6b904b70922329068c63746d",22851474,1,-32,0,1227,400,376,-24
"66baf19b6b904b70922329068c63746d","2b09a08242b54983aec7063990fb3f66",22851474,1,32,0,1228,376,400,24
"2b09a08242b54983aec7063990fb3f66","1f471b7a883a4df48211e8c6a81b59a7",22851474,1,1,0,1229,400,401,1
"1f471b7a883a4df48211e8c6a81b59a7","1f471b7a883a4df48211e8c6a81b59a7",22851474,3,0,1,1230,401,401,0
"1f471b7a883a4df48211e8c6a81b59a7","2b09a08242b54983aec7063990fb3f66",22851474,1,-1,0,1233,401,400,-1
"2b09a08242b54983aec7063990fb3f66","9de0d567bfa84fe5b77cb76f4a76a5d1",22851474,1,5,0,1234,400,404,4
"9de0d567bfa84fe5b77cb76f4a76a5d1","9de0d567bfa84fe5b77cb76f4a76a5d1",22851474,1,0,1,1235,404,404,0
"9de0d567bfa84fe5b77cb76f4a76a5d1","1157bd665ec4472fb58b751dc5099355",22851474,1,-1,0,1236,404,403,-1
"1157bd665ec4472fb58b751dc5099355","58fc9094275e4c49be3f4ba6d4acc0a4",22851474,1,5,0,1237,403,406,3
"58fc9094275e4c49be3f4ba6d4acc0a4","3c8a22d2f9c146ea956609e3ed4f2559",22851474,1,-2,0,1238,406,405,-1
"3c8a22d2f9c146ea956609e3ed4f2559","c1c1be90b2b14c1ab4a5e1ee3c241902",22851474,1,3,0,1239,405,407,2
"c1c1be90b2b14c1ab4a5e1ee3c241902","c1c1be90b2b14c1ab4a5e1ee3c241902",22851474,5,0,1,1240,407,407,0
"c1c1be90b2b14c1ab4a5e1ee3c241902","58fc9094275e4c49be3f4ba6d4acc0a4",22851474,1,-1,0,1245,407,406,-1
"58fc9094275e4c49be3f4ba6d4acc0a4","02b3a1bead9244c1ba2f857c7da8f82a",22851474,1,3,0,1246,406,408,2
"02b3a1bead9244c1ba2f857c7da8f82a","6206fc6479014bb193084c32409dc1b9",22851474,1,1,0,1247,408,409,1
"6206fc6479014bb193084c32409dc1b9","6206fc6479014bb193084c32409dc1b9",22851474,1,0,1,1248,409,409,0
"6206fc6479014bb193084c32409dc1b9","02b3a1bead9244c1ba2f857c7da8f82a",22851474,1,-1,0,1249,409,408,-1
"02b3a1bead9244c1ba2f857c7da8f82a","6a5f020451db426dacba9e2ea3fcc62a",22851474,1,3,0,1250,408,410,2
"6a5f020451db426dacba9e2ea3fcc62a","6a5f020451db426dacba9e2ea3fcc62a",22851474,1,0,1,1251,410,410,0
"6a5f020451db426dacba9e2ea3fcc62a","33a9d248b2e44588a5b07fc1342b9bc2",22851474,1,2,0,1252,410,411,1
"33a9d248b2e44588a5b07fc1342b9bc2","c6f26bd420634f1cb7989e76fe6b16c0",22851474,1,1,0,1253,411,412,1
"c6f26bd420634f1cb7989e76fe6b16c0","c6f26bd420634f1cb7989e76fe6b16c0",22851474,5,0,1,1254,412,412,0
"c6f26bd420634f1cb7989e76fe6b16c0","2a65ee6e2ac64f6a8a55fbe5373ec763",22851474,1,1,0,1259,412,413,1
"2a65ee6e2ac64f6a8a55fbe5373ec763","2a65ee6e2ac64f6a8a55fbe5373ec763",22851474,2,0,1,1260,413,413,0
"2a65ee6e2ac64f6a8a55fbe5373ec763","33a9d248b2e44588a5b07fc1342b9bc2",22851474,1,-2,0,1262,413,411,-2
"33a9d248b2e44588a5b07fc1342b9bc2","1fd0f6dadbc14ebc965faf6122190b96",22851474,1,5,0,1263,411,415,4
"1fd0f6dadbc14ebc965faf6122190b96","1fd0f6dadbc14ebc965faf6122190b96",22851474,3,0,1,1264,415,415,0
"1fd0f6dadbc14ebc965faf6122190b96","687055dad9fc40c3982478fe33ec01bf",22851474,1,-1,0,1267,415,414,-1
"687055dad9fc40c3982478fe33ec01bf","2add1669f08d4101913db15f8c23b3b7",22851474,1,3,0,1268,414,416,2
"2add1669f08d4101913db15f8c23b3b7","2add1669f08d4101913db15f8c23b3b7",22851474,1,0,1,1269,416,416,0
"2add1669f08d4101913db15f8c23b3b7","2b09a08242b54983aec7063990fb3f66",22851474,1,-24,0,1270,416,400,-16
"2b09a08242b54983aec7063990fb3f66","a2b4bd40cee2481ebd3fc179d6a5cd62",22851474,1,27,0,1271,400,417,17
"a2b4bd40cee2481ebd3fc179d6a5cd62","e34e59dce2204f228f3a84b6725df60f",22851474,1,2,0,1272,417,419,2
"e34e59dce2204f228f3a84b6725df60f","e34e59dce2204f228f3a84b6725df60f",22851474,1,0,1,1273,419,419,0
"e34e59dce2204f228f3a84b6725df60f","bec48fc2e1294c7eb3d0aca780d731b8",22851474,1,2,0,1274,419,420,1
"bec48fc2e1294c7eb3d0aca780d731b8","a2b4bd40cee2481ebd3fc179d6a5cd62",22851474,1,-4,0,1275,420,417,-3
"a2b4bd40cee2481ebd3fc179d6a5cd62","bec48fc2e1294c7eb3d0aca780d731b8",22851474,1,4,0,1276,417,420,3
"bec48fc2e1294c7eb3d0aca780d731b8","a24600b0e49245f6bdba8c893cfeddb0",22851474,1,7,0,1277,420,425,5
"a24600b0e49245f6bdba8c893cfeddb0","dbde19fcce2a4c1abdc7f685c293a23f",22851474,1,-4,0,1278,425,422,-3
"dbde19fcce2a4c1abdc7f685c293a23f","a24600b0e49245f6bdba8c893cfeddb0",22851474,1,4,0,1279,422,425,3
"a24600b0e49245f6bdba8c893cfeddb0","a2b4bd40cee2481ebd3fc179d6a5cd62",22851474,1,-11,0,1280,425,417,-8
"a2b4bd40cee2481ebd3fc179d6a5cd62","24cf8786024543f19b89bc20034e60d7",22851474,1,18,0,1281,417,428,11
"24cf8786024543f19b89bc20034e60d7","f2a73be2f46840b182d7bd095378004e",22851474,1,1,0,1282,428,429,1
"f2a73be2f46840b182d7bd095378004e","604551fd4266430cb860fef58fa7dd61",22851474,1,1,0,1283,429,430,1
"604551fd4266430cb860fef58fa7dd61","604551fd4266430cb860fef58fa7dd61",22851474,8,0,1,1284,430,430,0
"604551fd4266430cb860fef58fa7dd61","dce46f8904594a62a6377a3587aaa663",22851474,1,2,0,1292,430,431,1
"dce46f8904594a62a6377a3587aaa663","24cf8786024543f19b89bc20034e60d7",22851474,1,-4,0,1293,431,428,-3
"24cf8786024543f19b89bc20034e60d7","9b9d0a249052413c869753b99682b0ac",22851474,1,5,0,1294,428,432,4
"9b9d0a249052413c869753b99682b0ac","9b9d0a249052413c869753b99682b0ac",22851474,1,0,1,1295,432,432,0
"9b9d0a249052413c869753b99682b0ac","061c175cc90f45fbad883025394e78dd",22851474,1,1,0,1296,432,433,1
"061c175cc90f45fbad883025394e78dd","061c175cc90f45fbad883025394e78dd",22851474,5,0,1,1297,433,433,0
"061c175cc90f45fbad883025394e78dd","dce46f8904594a62a6377a3587aaa663",22851474,1,-2,0,1302,433,431,-2
"dce46f8904594a62a6377a3587aaa663","66ada10dde9f43018588f1ced9d477fc",22851474,1,4,0,1303,431,434,3
"66ada10dde9f43018588f1ced9d477fc","24cf8786024543f19b89bc20034e60d7",22851474,1,-8,0,1304,434,428,-6
"24cf8786024543f19b89bc20034e60d7","24cf8786024543f19b89bc20034e60d7",22851474,1,0,1,1305,428,428,0
"24cf8786024543f19b89bc20034e60d7","070600601c4c439288445d2f0724807d",22851474,2,14,0,1306,428,437,9
"070600601c4c439288445d2f0724807d","070600601c4c439288445d2f0724807d",22851474,2,0,1,1307,437,437,0
"070600601c4c439288445d2f0724807d","1823b6de7d334a7aaabc4570719af4d9",22851474,2,2,0,1308,437,439,2
"1823b6de7d334a7aaabc4570719af4d9","0380cd76a7d44bc3a4da1f15e4d68f89",22851474,2,2,0,1309,439,440,1
"0380cd76a7d44bc3a4da1f15e4d68f89","070600601c4c439288445d2f0724807d",22851474,2,-4,0,1310,440,437,-3
"070600601c4c439288445d2f0724807d","0380cd76a7d44bc3a4da1f15e4d68f89",22851474,1,4,0,1311,437,440,3
"0380cd76a7d44bc3a4da1f15e4d68f89","23b7673c8b5443108c2ef09382834a86",22851474,2,2,0,1312,440,441,1
"23b7673c8b5443108c2ef09382834a86","901e92500aea43c79f19f1b279050668",22851474,3,2,0,1313,441,442,1
"901e92500aea43c79f19f1b279050668","23b7673c8b5443108c2ef09382834a86",22851474,1,-2,0,1314,442,441,-1
"901e92500aea43c79f19f1b279050668","4660ff2089114e8db82ceb26a4f329e3",22851474,2,4,0,1316,442,445,3
"4660ff2089114e8db82ceb26a4f329e3","7bd5586eb9d8484eb74a433ee7bfe499",22851474,2,2,0,1317,445,446,1
"7bd5586eb9d8484eb74a433ee7bfe499","7bd5586eb9d8484eb74a433ee7bfe499",22851474,24,0,1,1318,446,446,0
"7bd5586eb9d8484eb74a433ee7bfe499","4660ff2089114e8db82ceb26a4f329e3",22851474,1,-2,0,1319,446,445,-1
"4660ff2089114e8db82ceb26a4f329e3","070600601c4c439288445d2f0724807d",22851474,1,-12,0,1320,445,437,-8
"070600601c4c439288445d2f0724807d","b2f0d654738f48158edff28e8d3a546e",22851474,3,21,0,1321,437,449,12
"b2f0d654738f48158edff28e8d3a546e","070600601c4c439288445d2f0724807d",22851474,2,-21,0,1322,449,437,-12
"b2f0d654738f48158edff28e8d3a546e","b2f0d654738f48158edff28e8d3a546e",22851474,4,0,1,1324,449,449,0
"070600601c4c439288445d2f0724807d","8a7f26e690f34dda97be16904518ca99",22851474,1,16,0,1328,437,447,10
"8a7f26e690f34dda97be16904518ca99","7bd5586eb9d8484eb74a433ee7bfe499",22851474,1,-2,0,1329,447,446,-1
"7bd5586eb9d8484eb74a433ee7bfe499","1823b6de7d334a7aaabc4570719af4d9",22851474,1,-12,0,1330,446,439,-7
"1823b6de7d334a7aaabc4570719af4d9","7bd5586eb9d8484eb74a433ee7bfe499",22851474,1,12,0,1331,439,446,7
"7bd5586eb9d8484eb74a433ee7bfe499","070600601c4c439288445d2f0724807d",22851474,1,-14,0,1332,446,437,-9
"070600601c4c439288445d2f0724807d","24cf8786024543f19b89bc20034e60d7",22851474,1,-14,0,1333,437,428,-9
"24cf8786024543f19b89bc20034e60d7","bf12c96466d840a69bed7020b3f18bb8",22851474,1,11,0,1334,428,436,8
"bf12c96466d840a69bed7020b3f18bb8","74a7f8712e5449c2bc0b43c6f90dafed",22851474,1,-2,0,1335,436,435,-1
"74a7f8712e5449c2bc0b43c6f90dafed","74a7f8712e5449c2bc0b43c6f90dafed",22851474,1,0,1,1336,435,435,0
"74a7f8712e5449c2bc0b43c6f90dafed","66ada10dde9f43018588f1ced9d477fc",22851474,1,-1,0,1337,435,434,-1
"66ada10dde9f43018588f1ced9d477fc","bf12c96466d840a69bed7020b3f18bb8",22851474,1,3,0,1338,434,436,2
"bf12c96466d840a69bed7020b3f18bb8","bf12c96466d840a69bed7020b3f18bb8",22851474,1,0,1,1339,436,436,0
"bf12c96466d840a69bed7020b3f18bb8","24cf8786024543f19b89bc20034e60d7",22851474,1,-11,0,1340,436,428,-8
"1823b6de7d334a7aaabc4570719af4d9","1823b6de7d334a7aaabc4570719af4d9",22851474,13,0,1,1343,439,439,0
"070600601c4c439288445d2f0724807d","23b7673c8b5443108c2ef09382834a86",22851474,1,6,0,1358,437,441,4
"23b7673c8b5443108c2ef09382834a86","0380cd76a7d44bc3a4da1f15e4d68f89",22851474,1,-2,0,1359,441,440,-1
"901e92500aea43c79f19f1b279050668","001339db8ced4cf78829ebe8b145449d",22851474,1,1,0,1362,442,443,1
"001339db8ced4cf78829ebe8b145449d","001339db8ced4cf78829ebe8b145449d",22851474,11,0,1,1363,443,443,0
"001339db8ced4cf78829ebe8b145449d","452745e0366e42ae81561bfddebcc6c3",22851474,1,1,0,1374,443,444,1
"452745e0366e42ae81561bfddebcc6c3","452745e0366e42ae81561bfddebcc6c3",22851474,2,0,1,1375,444,444,0
"452745e0366e42ae81561bfddebcc6c3","901e92500aea43c79f19f1b279050668",22851474,1,-2,0,1377,444,442,-2
"4660ff2089114e8db82ceb26a4f329e3","4660ff2089114e8db82ceb26a4f329e3",22851474,1,0,1,1379,445,445,0
"7bd5586eb9d8484eb74a433ee7bfe499","8a7f26e690f34dda97be16904518ca99",22851474,1,2,0,1404,446,447,1
"8a7f26e690f34dda97be16904518ca99","8a7f26e690f34dda97be16904518ca99",22851474,1,0,1,1405,447,447,0
"8a7f26e690f34dda97be16904518ca99","070600601c4c439288445d2f0724807d",22851474,1,-16,0,1406,447,437,-10
"b2f0d654738f48158edff28e8d3a546e","f60ee41ec635499abd48168342d32c2f",22851474,6,5,0,1409,449,453,4
"f60ee41ec635499abd48168342d32c2f","f60ee41ec635499abd48168342d32c2f",22851474,82,0,1,1410,453,453,0
"f60ee41ec635499abd48168342d32c2f","9428d8bd9c5a47b2a235b254e5e27ded",22851474,1,-1,0,1421,453,452,-1
"9428d8bd9c5a47b2a235b254e5e27ded","b2f0d654738f48158edff28e8d3a546e",22851474,3,-4,0,1422,452,449,-3
"f60ee41ec635499abd48168342d32c2f","b2f0d654738f48158edff28e8d3a546e",22851474,3,-5,0,1453,453,449,-4
"b2f0d654738f48158edff28e8d3a546e","f67fbf45a5f146ed866965bc57c7c001",22851474,1,8,0,1454,449,454,5
"f67fbf45a5f146ed866965bc57c7c001","f67fbf45a5f146ed866965bc57c7c001",22851474,2,0,1,1455,454,454,0
"f67fbf45a5f146ed866965bc57c7c001","d937afe49bd24a07a550dda1c1155122",22851474,1,1,0,1457,454,455,1
"d937afe49bd24a07a550dda1c1155122","d937afe49bd24a07a550dda1c1155122",22851474,5,0,1,1458,455,455,0
"d937afe49bd24a07a550dda1c1155122","3628b3f7823443d0912a339096b69943",22851474,1,1,0,1463,455,456,1
"3628b3f7823443d0912a339096b69943","3628b3f7823443d0912a339096b69943",22851474,3,0,1,1464,456,456,0
"3628b3f7823443d0912a339096b69943","9e049ee647cf43ecbcb5ed792a8e7588",22851474,1,1,0,1467,456,457,1
"9e049ee647cf43ecbcb5ed792a8e7588","9e049ee647cf43ecbcb5ed792a8e7588",22851474,1,0,1,1468,457,457,0
"9e049ee647cf43ecbcb5ed792a8e7588","5256a214faaf410b93f76cea06428334",22851474,1,1,0,1469,457,458,1
"5256a214faaf410b93f76cea06428334","5256a214faaf410b93f76cea06428334",22851474,1,0,1,1470,458,458,0
"5256a214faaf410b93f76cea06428334","25c32b120fce40fa9b6c85133aeb4716",22851474,1,1,0,1471,458,459,1
"25c32b120fce40fa9b6c85133aeb4716","25c32b120fce40fa9b6c85133aeb4716",22851474,1,0,1,1472,459,459,0
"25c32b120fce40fa9b6c85133aeb4716","11bc14f2204949008b7d511b933363c1",22851474,1,1,0,1473,459,460,1
"11bc14f2204949008b7d511b933363c1","11bc14f2204949008b7d511b933363c1",22851474,1,0,1,1474,460,460,0
"11bc14f2204949008b7d511b933363c1","42de338840a34d15adb66e7b14fb9d2c",22851474,1,1,0,1475,460,461,1
"42de338840a34d15adb66e7b14fb9d2c","42de338840a34d15adb66e7b14fb9d2c",22851474,1,0,1,1476,461,461,0
"42de338840a34d15adb66e7b14fb9d2c","9da37c6210b1416b8079c274f70bf600",22851474,1,1,0,1477,461,462,1
"9da37c6210b1416b8079c274f70bf600","9da37c6210b1416b8079c274f70bf600",22851474,1,0,1,1478,462,462,0
"9da37c6210b1416b8079c274f70bf600","519119f1deac45ff9ab4f13529be5c6e",22851474,1,1,0,1479,462,463,1
"519119f1deac45ff9ab4f13529be5c6e","519119f1deac45ff9ab4f13529be5c6e",22851474,1,0,1,1480,463,463,0
"519119f1deac45ff9ab4f13529be5c6e","f67fbf45a5f146ed866965bc57c7c001",22851474,1,-9,0,1481,463,454,-9
"f67fbf45a5f146ed866965bc57c7c001","c5df9f40ec14463b9dcfdc73df3e9285",22851474,1,12,0,1482,454,464,10
"c5df9f40ec14463b9dcfdc73df3e9285","c5df9f40ec14463b9dcfdc73df3e9285",22851474,1,0,1,1483,464,464,0
"c5df9f40ec14463b9dcfdc73df3e9285","83d42d95cd844fc093fc09cee250edb8",22851474,2,3,0,1484,464,465,1
"83d42d95cd844fc093fc09cee250edb8","c5df9f40ec14463b9dcfdc73df3e9285",22851474,1,-3,0,1485,465,464,-1
"83d42d95cd844fc093fc09cee250edb8","83d42d95cd844fc093fc09cee250edb8",22851474,1,0,1,1487,465,465,0
"83d42d95cd844fc093fc09cee250edb8","78adeee1fa2c4fe0bc73f7bca9fcee86",22851474,1,-431,0,1488,465,160,-305
"78adeee1fa2c4fe0bc73f7bca9fcee86","65202579580f4ad38d734b4ee39d22a8",22851474,6,5,0,1489,160,164,4
"65202579580f4ad38d734b4ee39d22a8","65202579580f4ad38d734b4ee39d22a8",22851474,77,0,1,1490,164,164,0
"65202579580f4ad38d734b4ee39d22a8","0d987bed3ffa4ed0b9a2e62e97b7b30f",22851474,1,147,0,1497,164,272,108
"0d987bed3ffa4ed0b9a2e62e97b7b30f","bb5a47f5ea01454a8b79455422d3b9da",22851474,3,10,0,1498,272,280,8
"bb5a47f5ea01454a8b79455422d3b9da","bb5a47f5ea01454a8b79455422d3b9da",22851474,76,0,1,1499,280,280,0
"bb5a47f5ea01454a8b79455422d3b9da","9428d8bd9c5a47b2a235b254e5e27ded",22851474,1,250,0,1517,280,452,172
"f60ee41ec635499abd48168342d32c2f","1b4550d0dab04078b3bf08a655345bdc",22851474,1,-125,0,1560,453,373,-80
"1b4550d0dab04078b3bf08a655345bdc","b71bac264efb4abd97015447bd490db6",22851474,2,-4,0,1561,373,370,-3
"8d448d625b024c82a5eb240bbd7431d6","8959e6304a0348309a771e4d08d1b64a",22851474,1,-285,0,1592,374,163,-211
"8959e6304a0348309a771e4d08d1b64a","78adeee1fa2c4fe0bc73f7bca9fcee86",22851474,1,-4,0,1593,163,160,-3
"65202579580f4ad38d734b4ee39d22a8","bc5524e78a8544e2ae2fdc2f3462bbec",22851474,1,156,0,1602,164,279,115
"bc5524e78a8544e2ae2fdc2f3462bbec","0d987bed3ffa4ed0b9a2e62e97b7b30f",22851474,1,-9,0,1603,279,272,-7
"bb5a47f5ea01454a8b79455422d3b9da","1b4550d0dab04078b3bf08a655345bdc",22851474,1,126,0,1612,280,373,93
"8d448d625b024c82a5eb240bbd7431d6","9428d8bd9c5a47b2a235b254e5e27ded",22851474,1,123,0,1622,374,452,78
"f60ee41ec635499abd48168342d32c2f","0d987bed3ffa4ed0b9a2e62e97b7b30f",22851474,1,-261,0,1632,453,272,-181
"0d987bed3ffa4ed0b9a2e62e97b7b30f","bc5524e78a8544e2ae2fdc2f3462bbec",22851474,1,9,0,1633,272,279,7
"bc5524e78a8544e2ae2fdc2f3462bbec","bb5a47f5ea01454a8b79455422d3b9da",22851474,1,1,0,1634,279,280,1
"b7719e26494940efa49512aedd0aac79","b7719e26494940efa49512aedd0aac79",22852517,2,0,1,1,20,20,0
"b7719e26494940efa49512aedd0aac79","b613861cecf84ffcab01afb23f660475",22852517,1,-32,0,2,20,1,-19
"b613861cecf84ffcab01afb23f660475","b613861cecf84ffcab01afb23f660475",22852517,3,0,1,3,1,1,0
"b613861cecf84ffcab01afb23f660475","e2911e79efc2420eac45d9f671463d4b",22852517,1,3,0,6,1,2,1
"e2911e79efc2420eac45d9f671463d4b","e2911e79efc2420eac45d9f671463d4b",22852517,2,0,1,7,2,2,0
"e2911e79efc2420eac45d9f671463d4b","519d1b8c59404d67b54e96c5c8a830b2",22852517,1,1,0,9,2,3,1
"519d1b8c59404d67b54e96c5c8a830b2","519d1b8c59404d67b54e96c5c8a830b2",22852517,1,0,1,10,3,3,0
"519d1b8c59404d67b54e96c5c8a830b2","531db53f81f646edb0cdcfe0085b03b7",22852517,1,1,0,11,3,4,1
"531db53f81f646edb0cdcfe0085b03b7","531db53f81f646edb0cdcfe0085b03b7",22852517,4,0,1,12,4,4,0
"531db53f81f646edb0cdcfe0085b03b7","4f5f94b2f95141e0a9d53a61da2276da",22852517,1,1,0,16,4,5,1
"4f5f94b2f95141e0a9d53a61da2276da","4f5f94b2f95141e0a9d53a61da2276da",22852517,4,0,1,17,5,5,0
"4f5f94b2f95141e0a9d53a61da2276da","6d541c89590949f99af293c4f2333f67",22852517,1,1,0,21,5,6,1
"6d541c89590949f99af293c4f2333f67","6d541c89590949f99af293c4f2333f67",22852517,1,0,1,22,6,6,0
"6d541c89590949f99af293c4f2333f67","dd5cf0b9fe4c4f1d8f5ff8e4c04879cb",22852517,1,1,0,23,6,7,1
"dd5cf0b9fe4c4f1d8f5ff8e4c04879cb","dd5cf0b9fe4c4f1d8f5ff8e4c04879cb",22852517,1,0,1,24,7,7,0
"dd5cf0b9fe4c4f1d8f5ff8e4c04879cb","f96261861edc426abe2248be4f0a709a",22852517,1,1,0,25,7,8,1
"f96261861edc426abe2248be4f0a709a","f96261861edc426abe2248be4f0a709a",22852517,1,0,1,26,8,8,0
"f96261861edc426abe2248be4f0a709a","66b5e16f4f75454fb5b8172079f0fa83",22852517,1,1,0,27,8,9,1
"66b5e16f4f75454fb5b8172079f0fa83","66b5e16f4f75454fb5b8172079f0fa83",22852517,3,0,1,28,9,9,0
"66b5e16f4f75454fb5b8172079f0fa83","0680571d4698477995e41842c36a54b2",22852517,1,1,0,31,9,10,1
"0680571d4698477995e41842c36a54b2","0680571d4698477995e41842c36a54b2",22852517,1,0,1,32,10,10,0
"0680571d4698477995e41842c36a54b2","9112f2bffece48e08c6d2287be204085",22852517,1,1,0,33,10,11,1
"9112f2bffece48e08c6d2287be204085","9112f2bffece48e08c6d2287be204085",22852517,1,0,1,34,11,11,0
"9112f2bffece48e08c6d2287be204085","56586aa865414f538729c7f7735d2bc6",22852517,1,3,0,35,11,12,1
"56586aa865414f538729c7f7735d2bc6","e2911e79efc2420eac45d9f671463d4b",22852517,1,-12,0,36,12,2,-10
"e2911e79efc2420eac45d9f671463d4b","56586aa865414f538729c7f7735d2bc6",22852517,1,12,0,37,2,12,10
"56586aa865414f538729c7f7735d2bc6","b7f2b31585d94eb3bf86376714aa7070",22852517,4,2,0,39,12,13,1
"b7f2b31585d94eb3bf86376714aa7070","b7f2b31585d94eb3bf86376714aa7070",22852517,4,0,1,40,13,13,0
"b7f2b31585d94eb3bf86376714aa7070","3f1c815879794b929260d224becaff7e",22852517,3,2,0,41,13,14,1
"3f1c815879794b929260d224becaff7e","56586aa865414f538729c7f7735d2bc6",22852517,1,-4,0,42,14,12,-2
"b7f2b31585d94eb3bf86376714aa7070","56586aa865414f538729c7f7735d2bc6",22852517,1,-2,0,45,13,12,-1
"3f1c815879794b929260d224becaff7e","81c864a886d54a6b8ff85f7d736f4f95",22852517,1,2,0,48,14,15,1
"81c864a886d54a6b8ff85f7d736f4f95","5c5ceeee4562457ba6d41515aeebfbb1",22852517,1,4,0,49,15,17,2
"5c5ceeee4562457ba6d41515aeebfbb1","56586aa865414f538729c7f7735d2bc6",22852517,1,-10,0,50,17,12,-5
"56586aa865414f538729c7f7735d2bc6","9afd71a5298d4333b6849dfce1b9422c",22852517,1,13,0,51,12,18,6
"9afd71a5298d4333b6849dfce1b9422c","b7719e26494940efa49512aedd0aac79",22852517,1,4,0,52,18,20,2
"b7719e26494940efa49512aedd0aac79","9afd71a5298d4333b6849dfce1b9422c",22852517,1,-4,0,53,20,18,-2
"9afd71a5298d4333b6849dfce1b9422c","d4f45188d3c84a02ba08454e6403a818",22852517,1,9,0,54,18,24,6
"d4f45188d3c84a02ba08454e6403a818","d4c3b003e8274e429d2fa688d73fde6d",22852517,2,-2,0,55,24,22,-2
"d4c3b003e8274e429d2fa688d73fde6d","b7719e26494940efa49512aedd0aac79",22852517,2,-3,0,61,22,20,-2
"b7719e26494940efa49512aedd0aac79","afbf7250b99d47bea07172749483ca97",22852517,2,12,0,63,20,28,8
"afbf7250b99d47bea07172749483ca97","afbf7250b99d47bea07172749483ca97",22852517,1,0,1,64,28,28,0
"afbf7250b99d47bea07172749483ca97","b7719e26494940efa49512aedd0aac79",22852517,2,-12,0,65,28,20,-8
"b7719e26494940efa49512aedd0aac79","a49d1bb4328949299686242fd0be5584",22852517,1,2,0,66,20,21,1
"a49d1bb4328949299686242fd0be5584","d4f45188d3c84a02ba08454e6403a818",22852517,1,3,0,67,21,24,3
"4e51676dc72045d99c19b9fa7b22f8bc","afbf7250b99d47bea07172749483ca97",22852517,1,-3,0,73,29,28,-1
"afbf7250b99d47bea07172749483ca97","4e51676dc72045d99c19b9fa7b22f8bc",22852517,1,3,0,74,28,29,1
"4e51676dc72045d99c19b9fa7b22f8bc","51970cfa30e643e894e66ae85c8024cc",22852517,1,3,0,75,29,31,2
"51970cfa30e643e894e66ae85c8024cc","4e51676dc72045d99c19b9fa7b22f8bc",22852517,1,-3,0,76,31,29,-2
"9a0dc646f934470daf08c4b56ccf73db","56586aa865414f538729c7f7735d2bc6",22852517,1,-50,0,86,37,12,-25
"3f1c815879794b929260d224becaff7e","5c5ceeee4562457ba6d41515aeebfbb1",22852517,1,6,0,96,14,17,3
"5c5ceeee4562457ba6d41515aeebfbb1","5c5ceeee4562457ba6d41515aeebfbb1",22852517,2,0,1,97,17,17,0
"5c5ceeee4562457ba6d41515aeebfbb1","9afd71a5298d4333b6849dfce1b9422c",22852517,1,3,0,99,17,18,1
"9afd71a5298d4333b6849dfce1b9422c","56586aa865414f538729c7f7735d2bc6",22852517,1,-13,0,100,18,12,-6
"56586aa865414f538729c7f7735d2bc6","56586aa865414f538729c7f7735d2bc6",22852517,8,0,1,101,12,12,0
"56586aa865414f538729c7f7735d2bc6","b7719e26494940efa49512aedd0aac79",22852517,1,17,0,103,12,20,8
"b7719e26494940efa49512aedd0aac79","4e51676dc72045d99c19b9fa7b22f8bc",22852517,2,15,0,104,20,29,9
"4e51676dc72045d99c19b9fa7b22f8bc","93679be414554a11b1893002f2229a93",22852517,1,12,0,105,29,35,6
"93679be414554a11b1893002f2229a93","d4f45188d3c84a02ba08454e6403a818",22852517,1,-22,0,106,35,24,-11
"d4f45188d3c84a02ba08454e6403a818","a49d1bb4328949299686242fd0be5584",22852517,1,-3,0,107,24,21,-3
"a49d1bb4328949299686242fd0be5584","d4c3b003e8274e429d2fa688d73fde6d",22852517,1,1,0,108,21,22,1
"d4c3b003e8274e429d2fa688d73fde6d","d4c3b003e8274e429d2fa688d73fde6d",22852517,6,0,1,109,22,22,0
"d4c3b003e8274e429d2fa688d73fde6d","4e51676dc72045d99c19b9fa7b22f8bc",22852517,1,12,0,110,22,29,7
"4e51676dc72045d99c19b9fa7b22f8bc","c33c17be71ae4d588da7369472e5bb1b",22852517,5,9,0,111,29,34,5
"c33c17be71ae4d588da7369472e5bb1b","7040a13096d746ac84b8fac8d9752058",22852517,1,6,0,112,34,36,2
"7040a13096d746ac84b8fac8d9752058","93679be414554a11b1893002f2229a93",22852517,2,-3,0,113,36,35,-1
"93679be414554a11b1893002f2229a93","b7719e26494940efa49512aedd0aac79",22852517,1,-27,0,114,35,20,-15
"b7719e26494940efa49512aedd0aac79","9a0dc646f934470daf08c4b56ccf73db",22852517,1,33,0,115,20,37,17
"9a0dc646f934470daf08c4b56ccf73db","7040a13096d746ac84b8fac8d9752058",22852517,2,-3,0,116,37,36,-1
"7040a13096d746ac84b8fac8d9752058","9a0dc646f934470daf08c4b56ccf73db",22852517,3,3,0,117,36,37,1
"9a0dc646f934470daf08c4b56ccf73db","fc0e049d56024bc9a02c9a9c435c3df7",22852517,3,3,0,118,37,38,1
"fc0e049d56024bc9a02c9a9c435c3df7","7040a13096d746ac84b8fac8d9752058",22852517,1,-6,0,119,38,36,-2
"9a0dc646f934470daf08c4b56ccf73db","9a0dc646f934470daf08c4b56ccf73db",22852517,3,0,1,121,37,37,0
"7040a13096d746ac84b8fac8d9752058","fc0e049d56024bc9a02c9a9c435c3df7",22852517,1,6,0,123,36,38,2
"fc0e049d56024bc9a02c9a9c435c3df7","9a0dc646f934470daf08c4b56ccf73db",22852517,3,-3,0,124,38,37,-1
"9a0dc646f934470daf08c4b56ccf73db","4e51676dc72045d99c19b9fa7b22f8bc",22852517,1,-18,0,127,37,29,-8
"4e51676dc72045d99c19b9fa7b22f8bc","4e51676dc72045d99c19b9fa7b22f8bc",22852517,1,0,1,128,29,29,0
"c33c17be71ae4d588da7369472e5bb1b","c33c17be71ae4d588da7369472e5bb1b",22852517,3,0,1,130,34,34,0
"c33c17be71ae4d588da7369472e5bb1b","93679be414554a11b1893002f2229a93",22852517,2,3,0,132,34,35,1
"93679be414554a11b1893002f2229a93","93679be414554a11b1893002f2229a93",22852517,2,0,1,133,35,35,0
"93679be414554a11b1893002f2229a93","7040a13096d746ac84b8fac8d9752058",22852517,3,3,0,135,35,36,1
"7040a13096d746ac84b8fac8d9752058","4e51676dc72045d99c19b9fa7b22f8bc",22852517,1,-15,0,136,36,29,-7
"c33c17be71ae4d588da7369472e5bb1b","4e51676dc72045d99c19b9fa7b22f8bc",22852517,3,-9,0,138,34,29,-5
"4e51676dc72045d99c19b9fa7b22f8bc","c9c52446b6294aa5a9c2abaed536c37e",22852517,1,5,0,141,29,32,3
"c9c52446b6294aa5a9c2abaed536c37e","c33c17be71ae4d588da7369472e5bb1b",22852517,1,4,0,142,32,34,2
"4e51676dc72045d99c19b9fa7b22f8bc","9a0dc646f934470daf08c4b56ccf73db",22852517,1,18,0,144,29,37,8
"9a0dc646f934470daf08c4b56ccf73db","67a089198fcb4e1c8f2385786c2b296f",22852517,1,7,0,147,37,39,2
"67a089198fcb4e1c8f2385786c2b296f","67a089198fcb4e1c8f2385786c2b296f",22852517,1,0,1,148,39,39,0
"67a089198fcb4e1c8f2385786c2b296f","64d48c6c9c7940639a932219a6c87198",22852517,1,1,0,149,39,40,1
"64d48c6c9c7940639a932219a6c87198","64d48c6c9c7940639a932219a6c87198",22852517,2,0,1,150,40,40,0
"64d48c6c9c7940639a932219a6c87198","b534b89233134e30a9b5645138bfa9ee",22852517,1,3,0,152,40,41,1
"b534b89233134e30a9b5645138bfa9ee","67a089198fcb4e1c8f2385786c2b296f",22852517,1,-4,0,153,41,39,-2
"67a089198fcb4e1c8f2385786c2b296f","0e37b720d23b4e7f8b313e79313fd107",22852517,1,7,0,154,39,44,5
"0e37b720d23b4e7f8b313e79313fd107","0e37b720d23b4e7f8b313e79313fd107",22852517,1,0,1,155,44,44,0
"0e37b720d23b4e7f8b313e79313fd107","6875d67fdd5f48168b62719df449bebd",22852517,1,1,0,156,44,45,1
"6875d67fdd5f48168b62719df449bebd","6875d67fdd5f48168b62719df449bebd",22852517,1,0,1,157,45,45,0
"6875d67fdd5f48168b62719df449bebd","b534b89233134e30a9b5645138bfa9ee",22852517,1,-4,0,158,45,41,-4
"b534b89233134e30a9b5645138bfa9ee","6e13d61a7bdb44bca949c9f86fab3be5",22852517,1,7,0,159,41,47,6
"6e13d61a7bdb44bca949c9f86fab3be5","6e13d61a7bdb44bca949c9f86fab3be5",22852517,3,0,1,160,47,47,0
"6e13d61a7bdb44bca949c9f86fab3be5","195f78799f984cc2b06c48dfe36be751",22852517,1,2,0,163,47,49,2
"195f78799f984cc2b06c48dfe36be751","195f78799f984cc2b06c48dfe36be751",22852517,2,0,1,164,49,49,0
"195f78799f984cc2b06c48dfe36be751","d0c74f735e024943943e40333d6d337f",22852517,1,3,0,166,49,51,2
"d0c74f735e024943943e40333d6d337f","d9c8d8c444a64dadbbb508652c721e17",22852517,1,-6,0,167,51,46,-5
"d9c8d8c444a64dadbbb508652c721e17","d0c74f735e024943943e40333d6d337f",22852517,1,6,0,168,46,51,5
"d0c74f735e024943943e40333d6d337f","d0c74f735e024943943e40333d6d337f",22852517,1,0,1,169,51,51,0
"d0c74f735e024943943e40333d6d337f","983f8ff320594b279a7f4a6fe132f9c5",22852517,1,2,0,170,51,53,2
"983f8ff320594b279a7f4a6fe132f9c5","983f8ff320594b279a7f4a6fe132f9c5",22852517,2,0,1,171,53,53,0
"983f8ff320594b279a7f4a6fe132f9c5","35adfa5d923046aebabfefd98f35ff05",22852517,1,1,0,173,53,54,1
"35adfa5d923046aebabfefd98f35ff05","35adfa5d923046aebabfefd98f35ff05",22852517,5,0,1,174,54,54,0
"35adfa5d923046aebabfefd98f35ff05","b6f8a98476224da1b40e555ececc7ed8",22852517,1,1,0,179,54,55,1
"b6f8a98476224da1b40e555ececc7ed8","b6f8a98476224da1b40e555ececc7ed8",22852517,5,0,1,180,55,55,0
"b6f8a98476224da1b40e555ececc7ed8","86e22cb5fe0e4b47a9489ecddf7ed78f",22852517,1,1,0,185,55,56,1
"86e22cb5fe0e4b47a9489ecddf7ed78f","86e22cb5fe0e4b47a9489ecddf7ed78f",22852517,2,0,1,186,56,56,0
"86e22cb5fe0e4b47a9489ecddf7ed78f","f924752d8a1149668870b1e7698486f7",22852517,1,-6,0,188,56,50,-6
"f924752d8a1149668870b1e7698486f7","a1f2f12debe5432fb7a70bcd12bacfb9",22852517,1,9,0,189,50,58,8
"a1f2f12debe5432fb7a70bcd12bacfb9","78f30e4dcac84e3cbea8b2cc6e0d62b3",22852517,2,1,0,190,58,59,1
"78f30e4dcac84e3cbea8b2cc6e0d62b3","a1f2f12debe5432fb7a70bcd12bacfb9",22852517,1,-1,0,191,59,58,-1
"a1f2f12debe5432fb7a70bcd12bacfb9","a1f2f12debe5432fb7a70bcd12bacfb9",22852517,35,0,1,192,58,58,0
"78f30e4dcac84e3cbea8b2cc6e0d62b3","78f30e4dcac84e3cbea8b2cc6e0d62b3",22852517,9,0,1,228,59,59,0
"78f30e4dcac84e3cbea8b2cc6e0d62b3","a0a418b8540d479fa6e0f653b701da8b",22852517,1,6,0,237,59,64,5
"a0a418b8540d479fa6e0f653b701da8b","12aa6e1672ac4e7aa6449a7a8609cd72",22852517,1,-8,0,238,64,57,-7
"12aa6e1672ac4e7aa6449a7a8609cd72","bc42d26810654ea9a1df1efe1e58c7d5",22852517,1,7,0,239,57,63,6
"bc42d26810654ea9a1df1efe1e58c7d5","4c943503763e4e349906eea3ed3c8e86",22852517,1,-2,0,240,63,61,-2
"4c943503763e4e349906eea3ed3c8e86","4c943503763e4e349906eea3ed3c8e86",22852517,1,0,1,241,61,61,0
"4c943503763e4e349906eea3ed3c8e86","bc42d26810654ea9a1df1efe1e58c7d5",22852517,1,2,0,242,61,63,2
"bc42d26810654ea9a1df1efe1e58c7d5","bc42d26810654ea9a1df1efe1e58c7d5",22852517,3,0,1,243,63,63,0
"bc42d26810654ea9a1df1efe1e58c7d5","a0a418b8540d479fa6e0f653b701da8b",22852517,1,1,0,246,63,64,1
"a0a418b8540d479fa6e0f653b701da8b","a0a418b8540d479fa6e0f653b701da8b",22852517,3,0,1,247,64,64,0
"a0a418b8540d479fa6e0f653b701da8b","309ccf3cc4fe429d9bfbaef53d3fa479",22852517,1,-4,0,250,64,60,-4
"309ccf3cc4fe429d9bfbaef53d3fa479","d646286c8051419bbc2e31dd1db55ca8",22852517,1,10,0,251,60,67,7
"d646286c8051419bbc2e31dd1db55ca8","b534b89233134e30a9b5645138bfa9ee",22852517,1,-33,0,252,67,41,-26
"b534b89233134e30a9b5645138bfa9ee","267f883678b24aed855fde42524975d9",22852517,1,37,0,253,41,71,30
"267f883678b24aed855fde42524975d9","267f883678b24aed855fde42524975d9",22852517,1,0,1,254,71,71,0
"267f883678b24aed855fde42524975d9","88fff56d0342490dbef9040750a20f6c",22852517,1,1,0,255,71,72,1
"88fff56d0342490dbef9040750a20f6c","88fff56d0342490dbef9040750a20f6c",22852517,1,0,1,256,72,72,0
"88fff56d0342490dbef9040750a20f6c","adb17b12b66c4a49a85fd34322f7df70",22852517,1,1,0,257,72,73,1
"adb17b12b66c4a49a85fd34322f7df70","adb17b12b66c4a49a85fd34322f7df70",22852517,1,0,1,258,73,73,0
"adb17b12b66c4a49a85fd34322f7df70","a2becd407db34b189200a32546d9d569",22852517,1,3,0,259,73,75,2
"a2becd407db34b189200a32546d9d569","d646286c8051419bbc2e31dd1db55ca8",22852517,1,-9,0,260,75,67,-8
"d646286c8051419bbc2e31dd1db55ca8","a2becd407db34b189200a32546d9d569",22852517,1,9,0,261,67,75,8
"a2becd407db34b189200a32546d9d569","a2becd407db34b189200a32546d9d569",22852517,2,0,1,262,75,75,0
"a2becd407db34b189200a32546d9d569","58c22b011d0f4c2ea6d13615edbb9eeb",22852517,1,2,0,264,75,77,2
"58c22b011d0f4c2ea6d13615edbb9eeb","58c22b011d0f4c2ea6d13615edbb9eeb",22852517,11,0,1,265,77,77,0
"58c22b011d0f4c2ea6d13615edbb9eeb","dd76e1861dc9461c830888729d091ee0",22852517,1,1,0,276,77,78,1
"dd76e1861dc9461c830888729d091ee0","dd76e1861dc9461c830888729d091ee0",22852517,5,0,1,277,78,78,0
"dd76e1861dc9461c830888729d091ee0","cd1d828f1a694b87913a7ea66c23803e",22852517,1,1,0,282,78,79,1
"cd1d828f1a694b87913a7ea66c23803e","cd1d828f1a694b87913a7ea66c23803e",22852517,5,0,1,283,79,79,0
"cd1d828f1a694b87913a7ea66c23803e","9176a3c2b4d2465fa8b0c67096c2a97e",22852517,1,1,0,288,79,80,1
"9176a3c2b4d2465fa8b0c67096c2a97e","9176a3c2b4d2465fa8b0c67096c2a97e",22852517,5,0,1,289,80,80,0
"9176a3c2b4d2465fa8b0c67096c2a97e","f8ec6445f7194e25b9101d4fbcb07a18",22852517,1,1,0,294,80,81,1
"f8ec6445f7194e25b9101d4fbcb07a18","f8ec6445f7194e25b9101d4fbcb07a18",22852517,5,0,1,295,81,81,0
"f8ec6445f7194e25b9101d4fbcb07a18","140d5b27b8574befad82c0a013b59dfa",22852517,1,-7,0,300,81,74,-7
"140d5b27b8574befad82c0a013b59dfa","d18a9ea32855445f8736581f5cb119ce",22852517,1,9,0,301,74,82,8
"d18a9ea32855445f8736581f5cb119ce","f564483cbd7a407681aa2fcca518cf5f",22852517,1,4,0,302,82,85,3
"f564483cbd7a407681aa2fcca518cf5f","f564483cbd7a407681aa2fcca518cf5f",22852517,4,0,1,303,85,85,0
"f564483cbd7a407681aa2fcca518cf5f","18fd01350bd5434ca636d59a599d768a",22852517,1,1,0,307,85,86,1
"18fd01350bd5434ca636d59a599d768a","18fd01350bd5434ca636d59a599d768a",22852517,9,0,1,308,86,86,0
"18fd01350bd5434ca636d59a599d768a","ae5ac430ea254e708a6f5deaaf7464ae",22852517,1,-2,0,317,86,84,-2
"ae5ac430ea254e708a6f5deaaf7464ae","6a9f0ef185fb47f0937e29daa1c71ed5",22852517,1,7,0,318,84,90,6
"6a9f0ef185fb47f0937e29daa1c71ed5","c681290961c94c4caf23b529d1ae6b9a",22852517,1,-2,0,319,90,88,-2
"c681290961c94c4caf23b529d1ae6b9a","c681290961c94c4caf23b529d1ae6b9a",22852517,1,0,1,320,88,88,0
"c681290961c94c4caf23b529d1ae6b9a","6a9f0ef185fb47f0937e29daa1c71ed5",22852517,1,2,0,321,88,90,2
"6a9f0ef185fb47f0937e29daa1c71ed5","6a9f0ef185fb47f0937e29daa1c71ed5",22852517,3,0,1,322,90,90,0
"6a9f0ef185fb47f0937e29daa1c71ed5","e20db35ced8544ddac5bc3839145e463",22852517,1,3,0,325,90,91,1
"e20db35ced8544ddac5bc3839145e463","d646286c8051419bbc2e31dd1db55ca8",22852517,1,-30,0,326,91,67,-24
"d646286c8051419bbc2e31dd1db55ca8","1febb706d7a34005ae8711ed49c76e64",22852517,1,33,0,327,67,94,27
"1febb706d7a34005ae8711ed49c76e64","1febb706d7a34005ae8711ed49c76e64",22852517,2,0,1,328,94,94,0
"1febb706d7a34005ae8711ed49c76e64","8f73ba6f5a0042f2850356ac38ac6f24",22852517,1,1,0,330,94,95,1
"8f73ba6f5a0042f2850356ac38ac6f24","8f73ba6f5a0042f2850356ac38ac6f24",22852517,5,0,1,331,95,95,0
"8f73ba6f5a0042f2850356ac38ac6f24","e2260b86653c46d7b14a41fb419dbf8c",22852517,1,1,0,336,95,96,1
"e2260b86653c46d7b14a41fb419dbf8c","e2260b86653c46d7b14a41fb419dbf8c",22852517,2,0,1,337,96,96,0
"e2260b86653c46d7b14a41fb419dbf8c","35eb641ad1d845bbba54915bce75a962",22852517,1,1,0,339,96,97,1
"35eb641ad1d845bbba54915bce75a962","35eb641ad1d845bbba54915bce75a962",22852517,5,0,1,340,97,97,0
"35eb641ad1d845bbba54915bce75a962","08be90ffbeea4795a138cd42ed8db56f",22852517,1,1,0,345,97,98,1
"08be90ffbeea4795a138cd42ed8db56f","08be90ffbeea4795a138cd42ed8db56f",22852517,6,0,1,346,98,98,0
"08be90ffbeea4795a138cd42ed8db56f","3007433c8f584dcbb5ac159c1c5f2be3",22852517,1,1,0,352,98,99,1
"3007433c8f584dcbb5ac159c1c5f2be3","3007433c8f584dcbb5ac159c1c5f2be3",22852517,5,0,1,353,99,99,0
"3007433c8f584dcbb5ac159c1c5f2be3","e20db35ced8544ddac5bc3839145e463",22852517,1,-8,0,358,99,91,-8
"e20db35ced8544ddac5bc3839145e463","d391c8b6e56a43a7b654e9dee02d904b",22852517,1,13,0,359,91,103,12
"d391c8b6e56a43a7b654e9dee02d904b","00ae5f0c51874a73a41ebea838d95682",22852517,1,-2,0,360,103,101,-2
"00ae5f0c51874a73a41ebea838d95682","00ae5f0c51874a73a41ebea838d95682",22852517,3,0,1,361,101,101,0
"00ae5f0c51874a73a41ebea838d95682","d391c8b6e56a43a7b654e9dee02d904b",22852517,1,2,0,364,101,103,2
"d391c8b6e56a43a7b654e9dee02d904b","d391c8b6e56a43a7b654e9dee02d904b",22852517,15,0,1,365,103,103,0
"d391c8b6e56a43a7b654e9dee02d904b","6111116566fc4fd9abba409322bea245",22852517,1,1,0,380,103,104,1
"6111116566fc4fd9abba409322bea245","6111116566fc4fd9abba409322bea245",22852517,2,0,1,381,104,104,0
"6111116566fc4fd9abba409322bea245","a81b2235cb9c499eb9ea8ee0a8dd9725",22852517,1,1,0,383,104,105,1
"a81b2235cb9c499eb9ea8ee0a8dd9725","a81b2235cb9c499eb9ea8ee0a8dd9725",22852517,5,0,1,384,105,105,0
"a81b2235cb9c499eb9ea8ee0a8dd9725","2d4e0ab0ef3b4d73b82c72d4621a7579",22852517,1,1,0,389,105,106,1
"2d4e0ab0ef3b4d73b82c72d4621a7579","2d4e0ab0ef3b4d73b82c72d4621a7579",22852517,2,0,1,390,106,106,0
"2d4e0ab0ef3b4d73b82c72d4621a7579","8bdebf492ebd4e62b0d522e8ab5e5197",22852517,1,1,0,392,106,107,1
"8bdebf492ebd4e62b0d522e8ab5e5197","8bdebf492ebd4e62b0d522e8ab5e5197",22852517,2,0,1,393,107,107,0
"8bdebf492ebd4e62b0d522e8ab5e5197","4280927ec4d643238aa49c32f9e06c6c",22852517,1,3,0,395,107,109,2
"4280927ec4d643238aa49c32f9e06c6c","73039f8c1eb9409cb4caee2cf968001e",22852517,1,-10,0,396,109,100,-9
"73039f8c1eb9409cb4caee2cf968001e","4280927ec4d643238aa49c32f9e06c6c",22852517,1,10,0,397,100,109,9
"4280927ec4d643238aa49c32f9e06c6c","4280927ec4d643238aa49c32f9e06c6c",22852517,1,0,1,398,109,109,0
"4280927ec4d643238aa49c32f9e06c6c","fc44e6a5f7654430af1227838224dceb",22852517,1,2,0,399,109,111,2
"fc44e6a5f7654430af1227838224dceb","fc44e6a5f7654430af1227838224dceb",22852517,2,0,1,400,111,111,0
"fc44e6a5f7654430af1227838224dceb","08111f75e22d409998cf8b85bd431f0a",22852517,1,-3,0,402,111,108,-3
"08111f75e22d409998cf8b85bd431f0a","a9ae0a3c070d455bb4369a8996313336",22852517,1,7,0,403,108,114,6
"a9ae0a3c070d455bb4369a8996313336","a9ae0a3c070d455bb4369a8996313336",22852517,3,0,1,404,114,114,0
"a9ae0a3c070d455bb4369a8996313336","71cec822bcff4f30a20e75dc63ef7b65",22852517,1,2,0,407,114,116,2
"71cec822bcff4f30a20e75dc63ef7b65","71cec822bcff4f30a20e75dc63ef7b65",22852517,1,0,1,408,116,116,0
"71cec822bcff4f30a20e75dc63ef7b65","37319e88176d4aefa91d7a9980dbae91",22852517,1,-4,0,409,116,112,-4
"37319e88176d4aefa91d7a9980dbae91","62bff51286ef4f348717a3cf6fe2318f",22852517,1,9,0,410,112,120,8
"62bff51286ef4f348717a3cf6fe2318f","b1cd0e7dc3ad4a8eb91a4bfdbeb025b0",22852517,1,-2,0,411,120,118,-2
"b1cd0e7dc3ad4a8eb91a4bfdbeb025b0","b1cd0e7dc3ad4a8eb91a4bfdbeb025b0",22852517,1,0,1,412,118,118,0
"b1cd0e7dc3ad4a8eb91a4bfdbeb025b0","62bff51286ef4f348717a3cf6fe2318f",22852517,1,2,0,413,118,120,2
"62bff51286ef4f348717a3cf6fe2318f","62bff51286ef4f348717a3cf6fe2318f",22852517,3,0,1,414,120,120,0
"62bff51286ef4f348717a3cf6fe2318f","779f9ddd1fd14d1e9e69f72219a1fdbd",22852517,1,3,0,417,120,121,1
"779f9ddd1fd14d1e9e69f72219a1fdbd","e20db35ced8544ddac5bc3839145e463",22852517,1,-36,0,418,121,91,-30
"e20db35ced8544ddac5bc3839145e463","ae26e6cda8ad4a3f81bd347560d9579f",22852517,1,40,0,419,91,125,34
"ae26e6cda8ad4a3f81bd347560d9579f","ae26e6cda8ad4a3f81bd347560d9579f",22852517,1,0,1,420,125,125,0
"ae26e6cda8ad4a3f81bd347560d9579f","ee48df95832b4374aa273ceb27ec1315",22852517,1,1,0,421,125,126,1
"ee48df95832b4374aa273ceb27ec1315","ee48df95832b4374aa273ceb27ec1315",22852517,5,0,1,422,126,126,0
"ee48df95832b4374aa273ceb27ec1315","7a439da90b394756ad1777fc4c6dead5",22852517,1,1,0,427,126,127,1
"7a439da90b394756ad1777fc4c6dead5","7a439da90b394756ad1777fc4c6dead5",22852517,1,0,1,428,127,127,0
"7a439da90b394756ad1777fc4c6dead5","779f9ddd1fd14d1e9e69f72219a1fdbd",22852517,1,-6,0,429,127,121,-6
"779f9ddd1fd14d1e9e69f72219a1fdbd","a8dd5213034441ac92724b4e83eb0bb2",22852517,1,9,0,430,121,129,8
"a8dd5213034441ac92724b4e83eb0bb2","a8dd5213034441ac92724b4e83eb0bb2",22852517,2,0,1,431,129,129,0
"a8dd5213034441ac92724b4e83eb0bb2","8115eab6556b45f5b415c3b8c26a12e5",22852517,1,2,0,433,129,131,2
"8115eab6556b45f5b415c3b8c26a12e5","8115eab6556b45f5b415c3b8c26a12e5",22852517,2,0,1,434,131,131,0
"8115eab6556b45f5b415c3b8c26a12e5","ec34b06efd844b46a4c4818ecdb9b8f4",22852517,1,1,0,436,131,132,1
"ec34b06efd844b46a4c4818ecdb9b8f4","ec34b06efd844b46a4c4818ecdb9b8f4",22852517,8,0,1,437,132,132,0
"ec34b06efd844b46a4c4818ecdb9b8f4","c2e1c2b9eac64109b343a088584b576b",22852517,1,1,0,445,132,133,1
"c2e1c2b9eac64109b343a088584b576b","c2e1c2b9eac64109b343a088584b576b",22852517,2,0,1,446,133,133,0
"c2e1c2b9eac64109b343a088584b576b","579338175e0b4bbb8ef3b712b5d8b54e",22852517,1,-5,0,448,133,128,-5
"579338175e0b4bbb8ef3b712b5d8b54e","8bc5795d6a984a3eace4e2811e52dd4f",22852517,1,8,0,449,128,135,7
"8bc5795d6a984a3eace4e2811e52dd4f","8bc5795d6a984a3eace4e2811e52dd4f",22852517,1,0,1,450,135,135,0
"8bc5795d6a984a3eace4e2811e52dd4f","b416d47c56a742199b5d7c7f19d6503a",22852517,1,-1,0,451,135,134,-1
"b416d47c56a742199b5d7c7f19d6503a","cd4532ad48034873ba8bce2aac0c9808",22852517,1,4,0,452,134,137,3
"cd4532ad48034873ba8bce2aac0c9808","cd4532ad48034873ba8bce2aac0c9808",22852517,1,0,1,453,137,137,0
"cd4532ad48034873ba8bce2aac0c9808","779f9ddd1fd14d1e9e69f72219a1fdbd",22852517,1,-19,0,454,137,121,-16
"779f9ddd1fd14d1e9e69f72219a1fdbd","df1de691dafe4549a18a4398ee9dfaf9",22852517,1,23,0,455,121,139,18
"df1de691dafe4549a18a4398ee9dfaf9","6c5ad271a44743479bfaea29b1db8d02",22852517,1,4,0,456,139,143,4
"6c5ad271a44743479bfaea29b1db8d02","6c5ad271a44743479bfaea29b1db8d02",22852517,2,0,1,457,143,143,0
"6c5ad271a44743479bfaea29b1db8d02","83d311bed5374fee83d8d67a7d9d82dc",22852517,1,1,0,459,143,144,1
"83d311bed5374fee83d8d67a7d9d82dc","83d311bed5374fee83d8d67a7d9d82dc",22852517,1,0,1,460,144,144,0
"83d311bed5374fee83d8d67a7d9d82dc","402bba41861d43acb52a5abb89e8831e",22852517,1,1,0,461,144,145,1
"402bba41861d43acb52a5abb89e8831e","402bba41861d43acb52a5abb89e8831e",22852517,2,0,1,462,145,145,0
"402bba41861d43acb52a5abb89e8831e","df1de691dafe4549a18a4398ee9dfaf9",22852517,1,-6,0,464,145,139,-6
"df1de691dafe4549a18a4398ee9dfaf9","8aae34f5ddbb4052a709b12e6b0d40fa",22852517,1,9,0,465,139,147,8
"8aae34f5ddbb4052a709b12e6b0d40fa","8aae34f5ddbb4052a709b12e6b0d40fa",22852517,2,0,1,466,147,147,0
"8aae34f5ddbb4052a709b12e6b0d40fa","645b3f0249f64f76af2e19eb4d0e55b7",22852517,1,2,0,468,147,149,2
"645b3f0249f64f76af2e19eb4d0e55b7","645b3f0249f64f76af2e19eb4d0e55b7",22852517,5,0,1,469,149,149,0
"645b3f0249f64f76af2e19eb4d0e55b7","7e7b8db5064d4369805ab370aac5ddfb",22852517,1,1,0,474,149,150,1
"7e7b8db5064d4369805ab370aac5ddfb","7e7b8db5064d4369805ab370aac5ddfb",22852517,5,0,1,475,150,150,0
"7e7b8db5064d4369805ab370aac5ddfb","8956d210ae7f41968fada86d4c979d6a",22852517,1,1,0,480,150,151,1
"8956d210ae7f41968fada86d4c979d6a","8956d210ae7f41968fada86d4c979d6a",22852517,2,0,1,481,151,151,0
"8956d210ae7f41968fada86d4c979d6a","f902b0f41b544d4dbf79664fd233648d",22852517,1,-5,0,483,151,146,-5
"f902b0f41b544d4dbf79664fd233648d","ae781e8b775e4ccd93bc800dad5c8376",22852517,1,8,0,484,146,153,7
"ae781e8b775e4ccd93bc800dad5c8376","ae781e8b775e4ccd93bc800dad5c8376",22852517,2,0,1,485,153,153,0
"ae781e8b775e4ccd93bc800dad5c8376","06882a8492d9499aa31555567f575ecb",22852517,1,1,0,487,153,154,1
"06882a8492d9499aa31555567f575ecb","06882a8492d9499aa31555567f575ecb",22852517,1,0,1,488,154,154,0
"06882a8492d9499aa31555567f575ecb","f293c508f409466a8f27ddd7d1e40b20",22852517,1,1,0,489,154,155,1
"f293c508f409466a8f27ddd7d1e40b20","f293c508f409466a8f27ddd7d1e40b20",22852517,2,0,1,490,155,155,0
"f293c508f409466a8f27ddd7d1e40b20","cc4ddef5bbbe48ebb605141b347c4ed1",22852517,1,1,0,492,155,156,1
"cc4ddef5bbbe48ebb605141b347c4ed1","cc4ddef5bbbe48ebb605141b347c4ed1",22852517,3,0,1,493,156,156,0
"cc4ddef5bbbe48ebb605141b347c4ed1","f03480cf4eba413194d7af52fc0e7f28",22852517,1,-4,0,496,156,152,-4
"f03480cf4eba413194d7af52fc0e7f28","d313cec988a84645bee413e8d4724a4b",22852517,1,7,0,497,152,158,6
"d313cec988a84645bee413e8d4724a4b","d313cec988a84645bee413e8d4724a4b",22852517,4,0,1,498,158,158,0
"d313cec988a84645bee413e8d4724a4b","dc60696c76a74368a60f72246e47700d",22852517,1,1,0,502,158,159,1
"dc60696c76a74368a60f72246e47700d","dc60696c76a74368a60f72246e47700d",22852517,1,0,1,503,159,159,0
"dc60696c76a74368a60f72246e47700d","78adeee1fa2c4fe0bc73f7bca9fcee86",22852517,1,3,0,504,159,160,1
"78adeee1fa2c4fe0bc73f7bca9fcee86","df1de691dafe4549a18a4398ee9dfaf9",22852517,1,-26,0,505,160,139,-21
"df1de691dafe4549a18a4398ee9dfaf9","65202579580f4ad38d734b4ee39d22a8",22852517,1,31,0,506,139,164,25
"65202579580f4ad38d734b4ee39d22a8","65202579580f4ad38d734b4ee39d22a8",22852517,81,0,1,507,164,164,0
"65202579580f4ad38d734b4ee39d22a8","78adeee1fa2c4fe0bc73f7bca9fcee86",22852517,6,-5,0,513,164,160,-4
"78adeee1fa2c4fe0bc73f7bca9fcee86","65202579580f4ad38d734b4ee39d22a8",22852517,7,5,0,514,160,164,4
"65202579580f4ad38d734b4ee39d22a8","3cbcea2be0984e7dbd5a48195af10ce7",22852517,2,3,0,537,164,165,1
"3cbcea2be0984e7dbd5a48195af10ce7","3cbcea2be0984e7dbd5a48195af10ce7",22852517,1,0,1,538,165,165,0
"3cbcea2be0984e7dbd5a48195af10ce7","82e6285962b8400d9d6fc32436022a94",22852517,1,2,0,539,165,167,2
"82e6285962b8400d9d6fc32436022a94","8959e6304a0348309a771e4d08d1b64a",22852517,1,-6,0,540,167,163,-4
"8959e6304a0348309a771e4d08d1b64a","78adeee1fa2c4fe0bc73f7bca9fcee86",22852517,1,-4,0,541,163,160,-3
"78adeee1fa2c4fe0bc73f7bca9fcee86","78adeee1fa2c4fe0bc73f7bca9fcee86",22852517,1,0,1,573,160,160,0
"3cbcea2be0984e7dbd5a48195af10ce7","78adeee1fa2c4fe0bc73f7bca9fcee86",22852517,1,-8,0,608,165,160,-5
"78adeee1fa2c4fe0bc73f7bca9fcee86","82e6285962b8400d9d6fc32436022a94",22852517,1,10,0,609,160,167,7
"82e6285962b8400d9d6fc32436022a94","0c7262dff33c4087bc660ccf40f92f9c",22852517,1,7,0,610,167,169,2
"0c7262dff33c4087bc660ccf40f92f9c","b2275c3fad834f8d90737a2d9a6927d6",22852517,1,3,0,611,169,172,3
"b2275c3fad834f8d90737a2d9a6927d6","b2275c3fad834f8d90737a2d9a6927d6",22852517,20,0,1,612,172,172,0
"b2275c3fad834f8d90737a2d9a6927d6","eb515a26030b41f8a82a1e6114420bad",22852517,1,1,0,632,172,173,1
"eb515a26030b41f8a82a1e6114420bad","eb515a26030b41f8a82a1e6114420bad",22852517,2,0,1,633,173,173,0
"eb515a26030b41f8a82a1e6114420bad","b42cc17b7de840f181a704558d0bc845",22852517,1,3,0,635,173,175,2
"b42cc17b7de840f181a704558d0bc845","0c7262dff33c4087bc660ccf40f92f9c",22852517,1,-7,0,636,175,169,-6
"0c7262dff33c4087bc660ccf40f92f9c","801f9e9135034f49bf5f8b4bdefedb41",22852517,1,9,0,637,169,177,8
"801f9e9135034f49bf5f8b4bdefedb41","801f9e9135034f49bf5f8b4bdefedb41",22852517,10,0,1,638,177,177,0
"801f9e9135034f49bf5f8b4bdefedb41","b42cc17b7de840f181a704558d0bc845",22852517,1,-2,0,640,177,175,-2
"b42cc17b7de840f181a704558d0bc845","b42cc17b7de840f181a704558d0bc845",22852517,2,0,1,641,175,175,0
"b42cc17b7de840f181a704558d0bc845","801f9e9135034f49bf5f8b4bdefedb41",22852517,1,2,0,643,175,177,2
"801f9e9135034f49bf5f8b4bdefedb41","362fcb0699a14845ab29b2340093e528",22852517,1,-3,0,652,177,174,-3
"362fcb0699a14845ab29b2340093e528","ea38cc0e6e6e41edbabf210220808bf9",22852517,1,6,0,653,174,179,5
"ea38cc0e6e6e41edbabf210220808bf9","b87c552dd247427abe6ab5795b9c9d43",22852517,2,2,0,654,179,181,2
"b87c552dd247427abe6ab5795b9c9d43","ea38cc0e6e6e41edbabf210220808bf9",22852517,1,-2,0,655,181,179,-2
"ea38cc0e6e6e41edbabf210220808bf9","ea38cc0e6e6e41edbabf210220808bf9",22852517,1,0,1,656,179,179,0
"b87c552dd247427abe6ab5795b9c9d43","b87c552dd247427abe6ab5795b9c9d43",22852517,7,0,1,658,181,181,0
"b87c552dd247427abe6ab5795b9c9d43","139b097acfca451689d80c9c6eebdf7b",22852517,1,-3,0,665,181,178,-3
"139b097acfca451689d80c9c6eebdf7b","30f660a1feb34582a739722532524f79",22852517,1,6,0,666,178,183,5
"30f660a1feb34582a739722532524f79","30f660a1feb34582a739722532524f79",22852517,5,0,1,667,183,183,0
"30f660a1feb34582a739722532524f79","2024b4885bd14338a39b7b509acbbd02",22852517,1,-1,0,672,183,182,-1
"2024b4885bd14338a39b7b509acbbd02","c3f63fe50d8e487c86bf8ef76c9cadd3",22852517,1,4,0,673,182,185,3
"c3f63fe50d8e487c86bf8ef76c9cadd3","c3f63fe50d8e487c86bf8ef76c9cadd3",22852517,1,0,1,674,185,185,0
"c3f63fe50d8e487c86bf8ef76c9cadd3","c8e371568a0c4391b25796ae4e91952e",22852517,1,3,0,675,185,186,1
"c8e371568a0c4391b25796ae4e91952e","0c7262dff33c4087bc660ccf40f92f9c",22852517,1,-23,0,676,186,169,-17
"0c7262dff33c4087bc660ccf40f92f9c","7d932b23e1c84326ae5aa4d3c0d813d1",22852517,1,25,0,677,169,188,19
"7d932b23e1c84326ae5aa4d3c0d813d1","7d932b23e1c84326ae5aa4d3c0d813d1",22852517,1,0,1,678,188,188,0
"7d932b23e1c84326ae5aa4d3c0d813d1","c8e371568a0c4391b25796ae4e91952e",22852517,1,-2,0,679,188,186,-2
"c8e371568a0c4391b25796ae4e91952e","ab11d94c6c8948ea90b88f19d2cd502b",22852517,1,5,0,680,186,190,4
"ab11d94c6c8948ea90b88f19d2cd502b","ab11d94c6c8948ea90b88f19d2cd502b",22852517,3,0,1,681,190,190,0
"ab11d94c6c8948ea90b88f19d2cd502b","f992451ed6ad4e68bb9e68ad6be7c4be",22852517,1,2,0,684,190,192,2
"f992451ed6ad4e68bb9e68ad6be7c4be","f992451ed6ad4e68bb9e68ad6be7c4be",22852517,3,0,1,685,192,192,0
"f992451ed6ad4e68bb9e68ad6be7c4be","07b44a7a51e94c78b411c753fc39dab0",22852517,1,-3,0,688,192,189,-3
"07b44a7a51e94c78b411c753fc39dab0","6cd2dcaac46847d4a0bc53f296d90375",22852517,1,6,0,689,189,194,5
"6cd2dcaac46847d4a0bc53f296d90375","6cd2dcaac46847d4a0bc53f296d90375",22852517,1,0,1,690,194,194,0
"6cd2dcaac46847d4a0bc53f296d90375","2d2580c9411c4972909db508d6956a58",22852517,1,2,0,691,194,196,2
"2d2580c9411c4972909db508d6956a58","2d2580c9411c4972909db508d6956a58",22852517,2,0,1,692,196,196,0
"2d2580c9411c4972909db508d6956a58","5bddb3d9ed264f3984702f048c7e5340",22852517,1,1,0,694,196,197,1
"5bddb3d9ed264f3984702f048c7e5340","5bddb3d9ed264f3984702f048c7e5340",22852517,2,0,1,695,197,197,0
"5bddb3d9ed264f3984702f048c7e5340","d5e8e2bd12a2466b9d6d90855f0eb079",22852517,1,1,0,697,197,198,1
"d5e8e2bd12a2466b9d6d90855f0eb079","d5e8e2bd12a2466b9d6d90855f0eb079",22852517,2,0,1,698,198,198,0
"d5e8e2bd12a2466b9d6d90855f0eb079","017d7ca8e0394b91aaadc9574df2202c",22852517,1,-5,0,700,198,193,-5
"017d7ca8e0394b91aaadc9574df2202c","54e8e9f0ea3e45c4bf3b8ac799ee31b1",22852517,1,8,0,701,193,200,7
"54e8e9f0ea3e45c4bf3b8ac799ee31b1","54e8e9f0ea3e45c4bf3b8ac799ee31b1",22852517,1,0,1,702,200,200,0
"54e8e9f0ea3e45c4bf3b8ac799ee31b1","c614a00911be4877a075f19315530fb0",22852517,1,1,0,703,200,201,1
"c614a00911be4877a075f19315530fb0","c614a00911be4877a075f19315530fb0",22852517,6,0,1,704,201,201,0
"c614a00911be4877a075f19315530fb0","a6c21bd8b95249c7972820a7a7d76aff",22852517,1,1,0,710,201,202,1
"a6c21bd8b95249c7972820a7a7d76aff","a6c21bd8b95249c7972820a7a7d76aff",22852517,1,0,1,711,202,202,0
"a6c21bd8b95249c7972820a7a7d76aff","bb329d880ab54120adaf203a693bb203",22852517,1,1,0,712,202,203,1
"bb329d880ab54120adaf203a693bb203","bb329d880ab54120adaf203a693bb203",22852517,1,0,1,713,203,203,0
"bb329d880ab54120adaf203a693bb203","f9170dd6bc6442b4acd832747609b09a",22852517,1,-4,0,714,203,199,-4
"f9170dd6bc6442b4acd832747609b09a","334c2344009840079b1d0e1b7ce3d5a7",22852517,1,7,0,715,199,205,6
"334c2344009840079b1d0e1b7ce3d5a7","334c2344009840079b1d0e1b7ce3d5a7",22852517,1,0,1,716,205,205,0
"334c2344009840079b1d0e1b7ce3d5a7","c8e371568a0c4391b25796ae4e91952e",22852517,1,-23,0,717,205,186,-19
"c8e371568a0c4391b25796ae4e91952e","d7f13c8d63ec4e2aa673fbb9cf9c6933",22852517,1,26,0,718,186,206,20
"d7f13c8d63ec4e2aa673fbb9cf9c6933","b9e80f77c3a44349863b19875725c384",22852517,1,1,0,719,206,207,1
"b9e80f77c3a44349863b19875725c384","7108f0e4c2584f1f9c471689ae4c885c",22852517,2,1,0,720,207,208,1
"7108f0e4c2584f1f9c471689ae4c885c","b9e80f77c3a44349863b19875725c384",22852517,1,-1,0,721,208,207,-1
"b9e80f77c3a44349863b19875725c384","b9e80f77c3a44349863b19875725c384",22852517,16,0,1,722,207,207,0
"7108f0e4c2584f1f9c471689ae4c885c","7108f0e4c2584f1f9c471689ae4c885c",22852517,11,0,1,739,208,208,0
"7108f0e4c2584f1f9c471689ae4c885c","d7f13c8d63ec4e2aa673fbb9cf9c6933",22852517,1,-2,0,750,208,206,-2
"d7f13c8d63ec4e2aa673fbb9cf9c6933","09400e101c5d4b439cf9a26b03aae558",22852517,1,5,0,751,206,210,4
"09400e101c5d4b439cf9a26b03aae558","a88efa7e50ce47159810ab553afa6d3a",22852517,1,2,0,752,210,212,2
"a88efa7e50ce47159810ab553afa6d3a","a88efa7e50ce47159810ab553afa6d3a",22852517,5,0,1,753,212,212,0
"a88efa7e50ce47159810ab553afa6d3a","be502a7a43c44bf7b682698de79d9369",22852517,1,3,0,758,212,214,2
"be502a7a43c44bf7b682698de79d9369","a875096404ef4a9984b62d74cda916f9",22852517,1,-6,0,759,214,209,-5
"a875096404ef4a9984b62d74cda916f9","f7fb1952f56b4189b86a9f8b7862d2b8",22852517,1,7,0,760,209,215,6
"f7fb1952f56b4189b86a9f8b7862d2b8","be502a7a43c44bf7b682698de79d9369",22852517,1,-1,0,761,215,214,-1
"be502a7a43c44bf7b682698de79d9369","be502a7a43c44bf7b682698de79d9369",22852517,2,0,1,762,214,214,0
"be502a7a43c44bf7b682698de79d9369","f7fb1952f56b4189b86a9f8b7862d2b8",22852517,1,1,0,764,214,215,1
"f7fb1952f56b4189b86a9f8b7862d2b8","f7fb1952f56b4189b86a9f8b7862d2b8",22852517,15,0,1,765,215,215,0
"f7fb1952f56b4189b86a9f8b7862d2b8","b860ee85d8bc4a2f97958cfb71be3533",22852517,1,1,0,780,215,216,1
"b860ee85d8bc4a2f97958cfb71be3533","b860ee85d8bc4a2f97958cfb71be3533",22852517,5,0,1,781,216,216,0
"b860ee85d8bc4a2f97958cfb71be3533","ec341f459285443b8361f7f15638ff08",22852517,1,-3,0,786,216,213,-3
"ec341f459285443b8361f7f15638ff08","363837c182e04711840d896ae1e0339c",22852517,1,6,0,787,213,218,5
"363837c182e04711840d896ae1e0339c","363837c182e04711840d896ae1e0339c",22852517,14,0,1,788,218,218,0
"363837c182e04711840d896ae1e0339c","01b2051f8941460d89945e3b02d1ce78",22852517,1,-1,0,802,218,217,-1
"01b2051f8941460d89945e3b02d1ce78","91125ca626c5470eb145501f8c37f8db",22852517,1,4,0,803,217,220,3
"91125ca626c5470eb145501f8c37f8db","91125ca626c5470eb145501f8c37f8db",22852517,1,0,1,804,220,220,0
"91125ca626c5470eb145501f8c37f8db","d7f13c8d63ec4e2aa673fbb9cf9c6933",22852517,1,-18,0,805,220,206,-14
"d7f13c8d63ec4e2aa673fbb9cf9c6933","1c6721b1f63f4d30ba7746ea8af02a52",22852517,1,21,0,806,206,221,15
"1c6721b1f63f4d30ba7746ea8af02a52","77ecef8eff6b4a2caea7707669bf7475",22852517,1,1,0,807,221,222,1
"77ecef8eff6b4a2caea7707669bf7475","77ecef8eff6b4a2caea7707669bf7475",22852517,13,0,1,808,222,222,0
"77ecef8eff6b4a2caea7707669bf7475","d03cb855c70044cf8c35d9ec0de696e3",22852517,1,3,0,821,222,224,2
"d03cb855c70044cf8c35d9ec0de696e3","1c6721b1f63f4d30ba7746ea8af02a52",22852517,1,-4,0,822,224,221,-3
"1c6721b1f63f4d30ba7746ea8af02a52","8b9ae98743bd4d4a8a87dff1c1244211",22852517,1,7,0,823,221,227,6
"8b9ae98743bd4d4a8a87dff1c1244211","a49a937d6896486d9a5396654abcf2e1",22852517,1,-1,0,824,227,226,-1
"a49a937d6896486d9a5396654abcf2e1","a49a937d6896486d9a5396654abcf2e1",22852517,3,0,1,825,226,226,0
"a49a937d6896486d9a5396654abcf2e1","8b9ae98743bd4d4a8a87dff1c1244211",22852517,1,1,0,828,226,227,1
"8b9ae98743bd4d4a8a87dff1c1244211","8b9ae98743bd4d4a8a87dff1c1244211",22852517,27,0,1,829,227,227,0
"8b9ae98743bd4d4a8a87dff1c1244211","f7906d6f59b9489a91d2ef40db5a474d",22852517,1,-4,0,856,227,223,-4
"f7906d6f59b9489a91d2ef40db5a474d","2ab1535aac1346ba8801535bf729ef37",22852517,1,7,0,857,223,229,6
"2ab1535aac1346ba8801535bf729ef37","a4f40fb48a8542c8949bae1f002cd9bc",22852517,1,2,0,858,229,231,2
"a4f40fb48a8542c8949bae1f002cd9bc","a4f40fb48a8542c8949bae1f002cd9bc",22852517,2,0,1,859,231,231,0
"a4f40fb48a8542c8949bae1f002cd9bc","8972c23e32044edb8a78fa1eed4e5947",22852517,1,1,0,861,231,232,1
"8972c23e32044edb8a78fa1eed4e5947","8972c23e32044edb8a78fa1eed4e5947",22852517,3,0,1,862,232,232,0
"8972c23e32044edb8a78fa1eed4e5947","92feb4a40f8344d38b6f722e42a53295",22852517,1,1,0,865,232,233,1
"92feb4a40f8344d38b6f722e42a53295","92feb4a40f8344d38b6f722e42a53295",22852517,2,0,1,866,233,233,0
"92feb4a40f8344d38b6f722e42a53295","5152833676bf4c6cb317060be10f68db",22852517,1,-5,0,868,233,228,-5
"5152833676bf4c6cb317060be10f68db","ca3e28f290354c08aefe5b0f769604e6",22852517,1,8,0,869,228,235,7
"ca3e28f290354c08aefe5b0f769604e6","ca3e28f290354c08aefe5b0f769604e6",22852517,4,0,1,870,235,235,0
"ca3e28f290354c08aefe5b0f769604e6","79a35eea833e4c2c9d22fc53c3c6445c",22852517,1,1,0,874,235,236,1
"79a35eea833e4c2c9d22fc53c3c6445c","79a35eea833e4c2c9d22fc53c3c6445c",22852517,9,0,1,875,236,236,0
"79a35eea833e4c2c9d22fc53c3c6445c","8f68228b1518449e9615cdafee41a2bd",22852517,1,1,0,884,236,237,1
"8f68228b1518449e9615cdafee41a2bd","8f68228b1518449e9615cdafee41a2bd",22852517,1,0,1,885,237,237,0
"8f68228b1518449e9615cdafee41a2bd","cab89fa5c3ed45a5aa550fc0352d6a42",22852517,1,1,0,886,237,238,1
"cab89fa5c3ed45a5aa550fc0352d6a42","cab89fa5c3ed45a5aa550fc0352d6a42",22852517,5,0,1,887,238,238,0
"cab89fa5c3ed45a5aa550fc0352d6a42","66d4fad4f1cf4b46be0750a99ad7a35a",22852517,1,1,0,892,238,239,1
"66d4fad4f1cf4b46be0750a99ad7a35a","66d4fad4f1cf4b46be0750a99ad7a35a",22852517,1,0,1,893,239,239,0
"66d4fad4f1cf4b46be0750a99ad7a35a","0b04c8e2f86d48c7aeb7e225819cd32b",22852517,1,-5,0,894,239,234,-5
"0b04c8e2f86d48c7aeb7e225819cd32b","f53da5fd9bfe412da4b80d4742563b6c",22852517,1,8,0,895,234,241,7
"f53da5fd9bfe412da4b80d4742563b6c","f53da5fd9bfe412da4b80d4742563b6c",22852517,1,0,1,896,241,241,0
"f53da5fd9bfe412da4b80d4742563b6c","2ae94c0cea4d480a9d5dca8fb1d7b542",22852517,1,3,0,897,241,242,1
"2ae94c0cea4d480a9d5dca8fb1d7b542","1c6721b1f63f4d30ba7746ea8af02a52",22852517,1,-27,0,898,242,221,-21
"1c6721b1f63f4d30ba7746ea8af02a52","1ebf23f9d994469a85206e4c7b1bf5f5",22852517,1,30,0,899,221,245,24
"1ebf23f9d994469a85206e4c7b1bf5f5","1ebf23f9d994469a85206e4c7b1bf5f5",22852517,13,0,1,900,245,245,0
"1ebf23f9d994469a85206e4c7b1bf5f5","85ae675b83e8422da842cfd25596af99",22852517,1,1,0,913,245,246,1
"85ae675b83e8422da842cfd25596af99","85ae675b83e8422da842cfd25596af99",22852517,1,0,1,914,246,246,0
"85ae675b83e8422da842cfd25596af99","2ae94c0cea4d480a9d5dca8fb1d7b542",22852517,1,-4,0,915,246,242,-4
"2ae94c0cea4d480a9d5dca8fb1d7b542","fa235f0f364d47e4ae1c87f47bf8e6ba",22852517,1,12,0,916,242,252,10
"fa235f0f364d47e4ae1c87f47bf8e6ba","79f7845465cc4ed19d8e4f1429541be0",22852517,1,2,0,917,252,254,2
"79f7845465cc4ed19d8e4f1429541be0","79f7845465cc4ed19d8e4f1429541be0",22852517,2,0,1,918,254,254,0
"79f7845465cc4ed19d8e4f1429541be0","6e83e23f56544a19b94067c1c558d9c0",22852517,1,-8,0,920,254,247,-7
"6e83e23f56544a19b94067c1c558d9c0","00f61990949545828dd12f1303d47504",22852517,1,11,0,921,247,256,9
"00f61990949545828dd12f1303d47504","ead7bb4b64e247d2ae632ab8a296b091",22852517,1,2,0,922,256,258,2
"ead7bb4b64e247d2ae632ab8a296b091","ead7bb4b64e247d2ae632ab8a296b091",22852517,2,0,1,923,258,258,0
"ead7bb4b64e247d2ae632ab8a296b091","41b0048dde734bb280bac6116baa8e27",22852517,1,1,0,925,258,259,1
"41b0048dde734bb280bac6116baa8e27","41b0048dde734bb280bac6116baa8e27",22852517,5,0,1,926,259,259,0
"41b0048dde734bb280bac6116baa8e27","b41c5a094a604ee0915327da5cc0beb7",22852517,1,1,0,931,259,260,1
"b41c5a094a604ee0915327da5cc0beb7","b41c5a094a604ee0915327da5cc0beb7",22852517,2,0,1,932,260,260,0
"b41c5a094a604ee0915327da5cc0beb7","d546341988904f069cfa86b21457d9d9",22852517,1,-10,0,934,260,251,-9
"d546341988904f069cfa86b21457d9d9","28c171777c52431ab6b925073bd63d46",22852517,1,15,0,935,251,264,13
"28c171777c52431ab6b925073bd63d46","28c171777c52431ab6b925073bd63d46",22852517,11,0,1,936,264,264,0
"28c171777c52431ab6b925073bd63d46","ac160db940cb49ae8579162b1d52bb5d",22852517,1,2,0,947,264,266,2
"ac160db940cb49ae8579162b1d52bb5d","ac160db940cb49ae8579162b1d52bb5d",22852517,7,0,1,948,266,266,0
"ac160db940cb49ae8579162b1d52bb5d","d989ebcfc12a4b669f0100dc1aa14f1e",22852517,1,-12,0,955,266,255,-11
"d989ebcfc12a4b669f0100dc1aa14f1e","c6fd49b485cc4874b0bbdd9c6171e09c",22852517,1,15,0,956,255,268,13
"c6fd49b485cc4874b0bbdd9c6171e09c","c6fd49b485cc4874b0bbdd9c6171e09c",22852517,11,0,1,957,268,268,0
"c6fd49b485cc4874b0bbdd9c6171e09c","44240778a97c4af0937817499b75707b",22852517,1,1,0,968,268,269,1
"44240778a97c4af0937817499b75707b","44240778a97c4af0937817499b75707b",22852517,2,0,1,969,269,269,0
"44240778a97c4af0937817499b75707b","7aa76d3e993840d8805f097cbdbcd44b",22852517,1,-9,0,971,269,261,-8
"7aa76d3e993840d8805f097cbdbcd44b","865a4d3b43374da7944dc7d397f566d9",22852517,1,12,0,972,261,271,10
"865a4d3b43374da7944dc7d397f566d9","865a4d3b43374da7944dc7d397f566d9",22852517,1,0,1,973,271,271,0
"865a4d3b43374da7944dc7d397f566d9","0d987bed3ffa4ed0b9a2e62e97b7b30f",22852517,1,3,0,974,271,272,1
"0d987bed3ffa4ed0b9a2e62e97b7b30f","2ae94c0cea4d480a9d5dca8fb1d7b542",22852517,1,-38,0,975,272,242,-30
"2ae94c0cea4d480a9d5dca8fb1d7b542","0d987bed3ffa4ed0b9a2e62e97b7b30f",22852517,1,38,0,976,242,272,30
"bb5a47f5ea01454a8b79455422d3b9da","82ae07bc0c9b4570a41799290d1ef399",22852517,2,-6,0,978,280,275,-5
"82ae07bc0c9b4570a41799290d1ef399","bb5a47f5ea01454a8b79455422d3b9da",22852517,2,6,0,979,275,280,5
"bb5a47f5ea01454a8b79455422d3b9da","bc5524e78a8544e2ae2fdc2f3462bbec",22852517,1,-1,0,986,280,279,-1
"bc5524e78a8544e2ae2fdc2f3462bbec","bb5a47f5ea01454a8b79455422d3b9da",22852517,1,1,0,987,279,280,1
"bb5a47f5ea01454a8b79455422d3b9da","bb5a47f5ea01454a8b79455422d3b9da",22852517,80,0,1,1000,280,280,0
"bb5a47f5ea01454a8b79455422d3b9da","0c7262dff33c4087bc660ccf40f92f9c",22852517,1,-145,0,1014,280,169,-111
"0c7262dff33c4087bc660ccf40f92f9c","94cecc3f1e7d484b8e068e79241dfd73",22852517,1,148,0,1015,169,281,112
"94cecc3f1e7d484b8e068e79241dfd73","a37477c4e4c14169ad44b06b493007f6",22852517,2,2,0,1016,281,283,2
"a37477c4e4c14169ad44b06b493007f6","bc5524e78a8544e2ae2fdc2f3462bbec",22852517,2,-6,0,1017,283,279,-4
"bc5524e78a8544e2ae2fdc2f3462bbec","0d987bed3ffa4ed0b9a2e62e97b7b30f",22852517,2,-9,0,1018,279,272,-7
"0d987bed3ffa4ed0b9a2e62e97b7b30f","bb5a47f5ea01454a8b79455422d3b9da",22852517,3,10,0,1019,272,280,8
"bb5a47f5ea01454a8b79455422d3b9da","94cecc3f1e7d484b8e068e79241dfd73",22852517,1,3,0,1028,280,281,1
"94cecc3f1e7d484b8e068e79241dfd73","0d987bed3ffa4ed0b9a2e62e97b7b30f",22852517,1,-13,0,1029,281,272,-9
"0d987bed3ffa4ed0b9a2e62e97b7b30f","a37477c4e4c14169ad44b06b493007f6",22852517,1,15,0,1030,272,283,11
"bb5a47f5ea01454a8b79455422d3b9da","0d987bed3ffa4ed0b9a2e62e97b7b30f",22852517,1,-10,0,1076,280,272,-8
"0d987bed3ffa4ed0b9a2e62e97b7b30f","94cecc3f1e7d484b8e068e79241dfd73",22852517,1,13,0,1077,272,281,9
"a37477c4e4c14169ad44b06b493007f6","4a29443515bb404cb8924e1c60a63b73",22852517,1,7,0,1079,283,285,2
"4a29443515bb404cb8924e1c60a63b73","4a29443515bb404cb8924e1c60a63b73",22852517,1,0,1,1080,285,285,0
"4a29443515bb404cb8924e1c60a63b73","208c9b2796c944db8dacaa96082520ea",22852517,1,3,0,1081,285,288,3
"208c9b2796c944db8dacaa96082520ea","4a29443515bb404cb8924e1c60a63b73",22852517,1,-3,0,1082,288,285,-3
"4a29443515bb404cb8924e1c60a63b73","7669a956527947d0add87455277e80b4",22852517,1,7,0,1083,285,291,6
"7669a956527947d0add87455277e80b4","7669a956527947d0add87455277e80b4",22852517,1,0,1,1084,291,291,0
"7669a956527947d0add87455277e80b4","869e967078f04da18dd0b0b9389a7424",22852517,1,3,0,1085,291,293,2
"869e967078f04da18dd0b0b9389a7424","6a9a3b5bde4a48daa896fe8c06eca56f",22852517,1,-5,0,1086,293,289,-4
"6a9a3b5bde4a48daa896fe8c06eca56f","51ab6291537748fab90d519aa09889d6",22852517,1,7,0,1087,289,295,6
"51ab6291537748fab90d519aa09889d6","51ab6291537748fab90d519aa09889d6",22852517,11,0,1,1088,295,295,0
"51ab6291537748fab90d519aa09889d6","34a6e49023fc4465bd5ca604330bbd1c",22852517,1,-3,0,1099,295,292,-3
"34a6e49023fc4465bd5ca604330bbd1c","ba0e59461bfb4a44b7b1c28a01f8d3b3",22852517,1,9,0,1100,292,299,7
"ba0e59461bfb4a44b7b1c28a01f8d3b3","21592f2a9e9c4b2f8c66ec5dbcbf6a2b",22852517,1,-4,0,1101,299,296,-3
"21592f2a9e9c4b2f8c66ec5dbcbf6a2b","0e0b36e731a645e7b1b8a88f5031ca38",22852517,1,6,0,1102,296,301,5
"0e0b36e731a645e7b1b8a88f5031ca38","0e0b36e731a645e7b1b8a88f5031ca38",22852517,5,0,1,1103,301,301,0
"0e0b36e731a645e7b1b8a88f5031ca38","a66a144637284c21afc6de17fea4bfb8",22852517,1,1,0,1108,301,302,1
"a66a144637284c21afc6de17fea4bfb8","a66a144637284c21afc6de17fea4bfb8",22852517,2,0,1,1109,302,302,0
"a66a144637284c21afc6de17fea4bfb8","7646a919d7e64fa990bca9b024ff089d",22852517,1,-4,0,1111,302,298,-4
"7646a919d7e64fa990bca9b024ff089d","e390b575229748ea8aac9364efe2bf00",22852517,1,7,0,1112,298,304,6
"e390b575229748ea8aac9364efe2bf00","e390b575229748ea8aac9364efe2bf00",22852517,1,0,1,1113,304,304,0
"e390b575229748ea8aac9364efe2bf00","4a29443515bb404cb8924e1c60a63b73",22852517,1,-24,0,1114,304,285,-19
"4a29443515bb404cb8924e1c60a63b73","3434c10e561d488a914e0f7d71907abd",22852517,1,27,0,1115,285,305,20
"3434c10e561d488a914e0f7d71907abd","53e7e900392747ccad52e711ab0f80d8",22852517,3,2,0,1116,305,307,2
"53e7e900392747ccad52e711ab0f80d8","3434c10e561d488a914e0f7d71907abd",22852517,1,-2,0,1117,307,305,-2
"3434c10e561d488a914e0f7d71907abd","130acc2aeb0448fdbb2de63bc5cebe5b",22852517,1,5,0,1118,305,309,4
"130acc2aeb0448fdbb2de63bc5cebe5b","3434c10e561d488a914e0f7d71907abd",22852517,3,-5,0,1119,309,305,-4
"53e7e900392747ccad52e711ab0f80d8","130acc2aeb0448fdbb2de63bc5cebe5b",22852517,2,3,0,1121,307,309,2
"3434c10e561d488a914e0f7d71907abd","3434c10e561d488a914e0f7d71907abd",22852517,1,0,1,1123,305,305,0
"3434c10e561d488a914e0f7d71907abd","9c062b3251034ebe90f5054e2a3b5120",22852517,1,7,0,1127,305,311,6
"9c062b3251034ebe90f5054e2a3b5120","9c062b3251034ebe90f5054e2a3b5120",22852517,2,0,1,1128,311,311,0
"9c062b3251034ebe90f5054e2a3b5120","ea859f8207e44537889daeaba13ac2e8",22852517,1,1,0,1130,311,312,1
"ea859f8207e44537889daeaba13ac2e8","ea859f8207e44537889daeaba13ac2e8",22852517,9,0,1,1131,312,312,0
"ea859f8207e44537889daeaba13ac2e8","56d94971a7a94257aa330183a8ebd0ea",22852517,1,1,0,1140,312,313,1
"56d94971a7a94257aa330183a8ebd0ea","56d94971a7a94257aa330183a8ebd0ea",22852517,1,0,1,1141,313,313,0
"56d94971a7a94257aa330183a8ebd0ea","141c0df6cd1946539aadd1c9b7068cd4",22852517,1,-5,0,1142,313,308,-5
"141c0df6cd1946539aadd1c9b7068cd4","13255e63e0aa4abf85e5211bf613d43e",22852517,1,10,0,1143,308,317,9
"13255e63e0aa4abf85e5211bf613d43e","13255e63e0aa4abf85e5211bf613d43e",22852517,1,0,1,1144,317,317,0
"13255e63e0aa4abf85e5211bf613d43e","0c787d16c9504873b1a4d903cec09948",22852517,1,-3,0,1145,317,314,-3
"0c787d16c9504873b1a4d903cec09948","86c27d40179e419c8e9d150fb6afa5d0",22852517,1,6,0,1146,314,319,5
"86c27d40179e419c8e9d150fb6afa5d0","8d7e0b55cf9849cda222a0f2440cec55",22852517,1,-1,0,1147,319,318,-1
"8d7e0b55cf9849cda222a0f2440cec55","24f1363179ad4aaa965484a78471912b",22852517,1,6,0,1148,318,323,5
"24f1363179ad4aaa965484a78471912b","47edbb64109243e6b0f8f64cdef90c6c",22852517,1,3,0,1149,323,326,3
"47edbb64109243e6b0f8f64cdef90c6c","24f1363179ad4aaa965484a78471912b",22852517,1,-3,0,1150,326,323,-3
"24f1363179ad4aaa965484a78471912b","3628bdce1dd2429ba924d2d4d09448d2",22852517,1,-1,0,1151,323,322,-1
"3628bdce1dd2429ba924d2d4d09448d2","56b3fd1a212a4764be39d979fde3326e",22852517,1,7,0,1152,322,328,6
"56b3fd1a212a4764be39d979fde3326e","56b3fd1a212a4764be39d979fde3326e",22852517,1,0,1,1153,328,328,0
"56b3fd1a212a4764be39d979fde3326e","3434c10e561d488a914e0f7d71907abd",22852517,1,-28,0,1154,328,305,-23
"3434c10e561d488a914e0f7d71907abd","0c4079457ede49e3aeb5e86ed84bdf35",22852517,1,31,0,1155,305,329,24
"0c4079457ede49e3aeb5e86ed84bdf35","38aea304b4fa46e1b29bb72f5cea4c93",22852517,1,2,0,1156,329,331,2
"38aea304b4fa46e1b29bb72f5cea4c93","38aea304b4fa46e1b29bb72f5cea4c93",22852517,1,0,1,1157,331,331,0
"38aea304b4fa46e1b29bb72f5cea4c93","e36d261332f14e79bb4b467aceaeb9b5",22852517,1,2,0,1158,331,333,2
"e36d261332f14e79bb4b467aceaeb9b5","e36d261332f14e79bb4b467aceaeb9b5",22852517,1,0,1,1159,333,333,0
"e36d261332f14e79bb4b467aceaeb9b5","c7e89b9d04744d2eab742fc24e3ef1ae",22852517,1,1,0,1160,333,334,1
"c7e89b9d04744d2eab742fc24e3ef1ae","c7e89b9d04744d2eab742fc24e3ef1ae",22852517,5,0,1,1161,334,334,0
"c7e89b9d04744d2eab742fc24e3ef1ae","fe49f8054b374a0ea4bb266ed135ff62",22852517,1,1,0,1166,334,335,1
"fe49f8054b374a0ea4bb266ed135ff62","fe49f8054b374a0ea4bb266ed135ff62",22852517,2,0,1,1167,335,335,0
"fe49f8054b374a0ea4bb266ed135ff62","d0a8f74af98642fe8360d22c42e45117",22852517,1,1,0,1169,335,336,1
"d0a8f74af98642fe8360d22c42e45117","d0a8f74af98642fe8360d22c42e45117",22852517,2,0,1,1170,336,336,0
"d0a8f74af98642fe8360d22c42e45117","0c4079457ede49e3aeb5e86ed84bdf35",22852517,1,-7,0,1172,336,329,-7
"0c4079457ede49e3aeb5e86ed84bdf35","a7c6339ca1da4368a18d471f0519f877",22852517,1,11,0,1173,329,339,10
"a7c6339ca1da4368a18d471f0519f877","a7c6339ca1da4368a18d471f0519f877",22852517,2,0,1,1174,339,339,0
"a7c6339ca1da4368a18d471f0519f877","b8b9418ab322418d9db9b40d96af873a",22852517,1,-2,0,1176,339,337,-2
"b8b9418ab322418d9db9b40d96af873a","bbc5139ca9024389a94db3a6f47dcff6",22852517,1,5,0,1177,337,341,4
"bbc5139ca9024389a94db3a6f47dcff6","4ee6ca9019ab4a1ab323f98094a9bd77",22852517,1,2,0,1178,341,343,2
"4ee6ca9019ab4a1ab323f98094a9bd77","4ee6ca9019ab4a1ab323f98094a9bd77",22852517,2,0,1,1179,343,343,0
"4ee6ca9019ab4a1ab323f98094a9bd77","b37947176785476f8b29d49a851366dc",22852517,1,1,0,1181,343,344,1
"b37947176785476f8b29d49a851366dc","b37947176785476f8b29d49a851366dc",22852517,2,0,1,1182,344,344,0
"b37947176785476f8b29d49a851366dc","fcea5b10d5a14a3b9324ffece8f6e1e5",22852517,1,1,0,1184,344,345,1
"fcea5b10d5a14a3b9324ffece8f6e1e5","fcea5b10d5a14a3b9324ffece8f6e1e5",22852517,2,0,1,1185,345,345,0
"fcea5b10d5a14a3b9324ffece8f6e1e5","c2490bc612d146edbe786556fab3651b",22852517,1,-5,0,1187,345,340,-5
"c2490bc612d146edbe786556fab3651b","6ac8bb048b854999a47edb35fe627f11",22852517,1,8,0,1188,340,347,7
"6ac8bb048b854999a47edb35fe627f11","6ac8bb048b854999a47edb35fe627f11",22852517,1,0,1,1189,347,347,0
"6ac8bb048b854999a47edb35fe627f11","0c4079457ede49e3aeb5e86ed84bdf35",22852517,1,-21,0,1190,347,329,-18
"0c4079457ede49e3aeb5e86ed84bdf35","30ead9794d4847abaf222ca966cc8630",22852517,1,24,0,1191,329,348,19
"30ead9794d4847abaf222ca966cc8630","897b7f51242c44aab2205c72fdcbf4cd",22852517,1,4,0,1192,348,352,4
"897b7f51242c44aab2205c72fdcbf4cd","eff0de7f2dbb42dfa1a2e686efab5b6d",22852517,1,2,0,1193,352,354,2
"eff0de7f2dbb42dfa1a2e686efab5b6d","09b9678ddc3d452ea4a3d46e15826065",22852517,1,-1,0,1194,354,353,-1
"09b9678ddc3d452ea4a3d46e15826065","c20993c944444fe085345591a8bd837e",22852517,1,-2,0,1195,353,351,-2
"c20993c944444fe085345591a8bd837e","c20993c944444fe085345591a8bd837e",22852517,4,0,1,1196,351,351,0
"c20993c944444fe085345591a8bd837e","897b7f51242c44aab2205c72fdcbf4cd",22852517,1,1,0,1200,351,352,1
"897b7f51242c44aab2205c72fdcbf4cd","897b7f51242c44aab2205c72fdcbf4cd",22852517,3,0,1,1201,352,352,0
"897b7f51242c44aab2205c72fdcbf4cd","09b9678ddc3d452ea4a3d46e15826065",22852517,1,1,0,1204,352,353,1
"09b9678ddc3d452ea4a3d46e15826065","09b9678ddc3d452ea4a3d46e15826065",22852517,3,0,1,1205,353,353,0
"09b9678ddc3d452ea4a3d46e15826065","eff0de7f2dbb42dfa1a2e686efab5b6d",22852517,1,1,0,1208,353,354,1
"eff0de7f2dbb42dfa1a2e686efab5b6d","eff0de7f2dbb42dfa1a2e686efab5b6d",22852517,3,0,1,1209,354,354,0
"eff0de7f2dbb42dfa1a2e686efab5b6d","2fe14166dc9642c3bc666b86a57f943d",22852517,1,4,0,1212,354,357,3
"2fe14166dc9642c3bc666b86a57f943d","30ead9794d4847abaf222ca966cc8630",22852517,1,-10,0,1213,357,348,-9
"30ead9794d4847abaf222ca966cc8630","2fe14166dc9642c3bc666b86a57f943d",22852517,1,10,0,1214,348,357,9
"2fe14166dc9642c3bc666b86a57f943d","2fe14166dc9642c3bc666b86a57f943d",22852517,1,0,1,1215,357,357,0
"2fe14166dc9642c3bc666b86a57f943d","44421dd1e13a47a388c4a19834b744c7",22852517,1,2,0,1216,357,359,2
"44421dd1e13a47a388c4a19834b744c7","44421dd1e13a47a388c4a19834b744c7",22852517,2,0,1,1217,359,359,0
"44421dd1e13a47a388c4a19834b744c7","cb5fc7ef85d547c4be1a7439d0bf6052",22852517,1,1,0,1219,359,360,1
"cb5fc7ef85d547c4be1a7439d0bf6052","cb5fc7ef85d547c4be1a7439d0bf6052",22852517,2,0,1,1220,360,360,0
"cb5fc7ef85d547c4be1a7439d0bf6052","0a8f150a4cf747acbde62f4721823da3",22852517,1,1,0,1222,360,361,1
"0a8f150a4cf747acbde62f4721823da3","0a8f150a4cf747acbde62f4721823da3",22852517,2,0,1,1223,361,361,0
"0a8f150a4cf747acbde62f4721823da3","ab8fdad974ae471f9f24c3f9dd04462e",22852517,1,1,0,1225,361,362,1
"ab8fdad974ae471f9f24c3f9dd04462e","ab8fdad974ae471f9f24c3f9dd04462e",22852517,2,0,1,1226,362,362,0
"ab8fdad974ae471f9f24c3f9dd04462e","1ba8fef685d74a8194b9db252eb704fb",22852517,1,-7,0,1228,362,355,-7
"1ba8fef685d74a8194b9db252eb704fb","52580888dadb4fe3baa795683ea227bd",22852517,1,10,0,1229,355,364,9
"52580888dadb4fe3baa795683ea227bd","492a3bc6a1254f23a7998587961b22a4",22852517,1,3,0,1230,364,366,2
"492a3bc6a1254f23a7998587961b22a4","f00179e251a045b39c3f7a54f9aa4acc",22852517,1,-4,0,1231,366,363,-3
"f00179e251a045b39c3f7a54f9aa4acc","072a190fd302456290895f9f04d6940a",22852517,1,3,0,1232,363,365,2
"072a190fd302456290895f9f04d6940a","cfa457d1743848e4bb5e4beced6448ed",22852517,1,5,0,1233,365,369,4
"cfa457d1743848e4bb5e4beced6448ed","cfa457d1743848e4bb5e4beced6448ed",22852517,1,0,1,1234,369,369,0
"cfa457d1743848e4bb5e4beced6448ed","30ead9794d4847abaf222ca966cc8630",22852517,1,-25,0,1235,369,348,-21
"30ead9794d4847abaf222ca966cc8630","b71bac264efb4abd97015447bd490db6",22852517,1,28,0,1236,348,370,22
"b71bac264efb4abd97015447bd490db6","8d448d625b024c82a5eb240bbd7431d6",22852517,7,5,0,1237,370,374,4
"8d448d625b024c82a5eb240bbd7431d6","8d448d625b024c82a5eb240bbd7431d6",22852517,86,0,1,1238,374,374,0
"8d448d625b024c82a5eb240bbd7431d6","b71bac264efb4abd97015447bd490db6",22852517,6,-5,0,1241,374,370,-4
"b71bac264efb4abd97015447bd490db6","d6d02b6ef04e4f17805504500b8ce441",22852517,3,8,0,1301,370,375,5
"d6d02b6ef04e4f17805504500b8ce441","d6d02b6ef04e4f17805504500b8ce441",22852517,4,0,1,1302,375,375,0
"d6d02b6ef04e4f17805504500b8ce441","1b4550d0dab04078b3bf08a655345bdc",22852517,1,-4,0,1303,375,373,-2
"1b4550d0dab04078b3bf08a655345bdc","b71bac264efb4abd97015447bd490db6",22852517,2,-4,0,1304,373,370,-3
"d6d02b6ef04e4f17805504500b8ce441","b71bac264efb4abd97015447bd490db6",22852517,2,-8,0,1319,375,370,-5
"b71bac264efb4abd97015447bd490db6","1b4550d0dab04078b3bf08a655345bdc",22852517,1,4,0,1332,370,373,3
"1b4550d0dab04078b3bf08a655345bdc","8d448d625b024c82a5eb240bbd7431d6",22852517,1,1,0,1333,373,374,1
"8d448d625b024c82a5eb240bbd7431d6","1b4550d0dab04078b3bf08a655345bdc",22852517,1,-1,0,1341,374,373,-1
"8d448d625b024c82a5eb240bbd7431d6","66baf19b6b904b70922329068c63746d",22852517,1,7,0,1351,374,376,2
"66baf19b6b904b70922329068c63746d","7f544639412e40a9ba27f43b415362ab",22852517,1,2,0,1352,376,378,2
"7f544639412e40a9ba27f43b415362ab","d5ae8642e15b46b8bd298b02274d4e9c",22852517,1,2,0,1353,378,380,2
"d5ae8642e15b46b8bd298b02274d4e9c","d5ae8642e15b46b8bd298b02274d4e9c",22852517,1,0,1,1354,380,380,0
"d5ae8642e15b46b8bd298b02274d4e9c","a0d10309a2dd456289147f84be9d37f9",22852517,1,1,0,1355,380,381,1
"a0d10309a2dd456289147f84be9d37f9","a0d10309a2dd456289147f84be9d37f9",22852517,2,0,1,1356,381,381,0
"a0d10309a2dd456289147f84be9d37f9","0fcbc3ca07b144138b8d85da581f09a8",22852517,1,1,0,1358,381,382,1
"0fcbc3ca07b144138b8d85da581f09a8","0fcbc3ca07b144138b8d85da581f09a8",22852517,2,0,1,1359,382,382,0
"0fcbc3ca07b144138b8d85da581f09a8","66baf19b6b904b70922329068c63746d",22852517,1,-6,0,1361,382,376,-6
"66baf19b6b904b70922329068c63746d","4890121ce5d74576b4632b77cfc23398",22852517,1,14,0,1362,376,388,12
"4890121ce5d74576b4632b77cfc23398","c2fca3669923477ab966ded303dea31c",22852517,1,-6,0,1363,388,383,-5
"c2fca3669923477ab966ded303dea31c","96bb2b3e85a34d8b9544514e89f6fe97",22852517,1,9,0,1364,383,390,7
"96bb2b3e85a34d8b9544514e89f6fe97","18d3b836dd804224883cc9180b60a8e1",22852517,1,-4,0,1365,390,387,-3
"18d3b836dd804224883cc9180b60a8e1","96bb2b3e85a34d8b9544514e89f6fe97",22852517,1,4,0,1366,387,390,3
"96bb2b3e85a34d8b9544514e89f6fe97","ac4e9b54acfe4670b4634859c7263cb5",22852517,1,2,0,1367,390,392,2
"ac4e9b54acfe4670b4634859c7263cb5","ac4e9b54acfe4670b4634859c7263cb5",22852517,1,0,1,1368,392,392,0
"ac4e9b54acfe4670b4634859c7263cb5","17f95d18bab743888e1736033dc3384d",22852517,1,-3,0,1369,392,389,-3
"17f95d18bab743888e1736033dc3384d","6f8881a745ac4c358a68b92c3b4abe81",22852517,1,6,0,1370,389,394,5
"6f8881a745ac4c358a68b92c3b4abe81","f7002c8484354eceac57bc7bd62c76c1",22852517,1,-1,0,1371,394,393,-1
"f7002c8484354eceac57bc7bd62c76c1","44a277ea44dc4ae689fab4b82f0b4098",22852517,1,5,0,1372,393,397,4
"44a277ea44dc4ae689fab4b82f0b4098","44a277ea44dc4ae689fab4b82f0b4098",22852517,1,0,1,1373,397,397,0
"44a277ea44dc4ae689fab4b82f0b4098","0c12af0a4e7f4002852cf84b2537c161",22852517,1,-2,0,1374,397,395,-2
"0c12af0a4e7f4002852cf84b2537c161","859e0b8d71694b12befb69ee698138f9",22852517,1,5,0,1375,395,399,4
"859e0b8d71694b12befb69ee698138f9","859e0b8d71694b12befb69ee698138f9",22852517,1,0,1,1376,399,399,0
"859e0b8d71694b12befb69ee698138f9","2b09a08242b54983aec7063990fb3f66",22852517,1,3,0,1377,399,400,1
"2b09a08242b54983aec7063990fb3f66","66baf19b6b904b70922329068c63746d",22852517,1,-32,0,1378,400,376,-24
"66baf19b6b904b70922329068c63746d","2b09a08242b54983aec7063990fb3f66",22852517,1,32,0,1379,376,400,24
"2b09a08242b54983aec7063990fb3f66","1f471b7a883a4df48211e8c6a81b59a7",22852517,1,1,0,1380,400,401,1
"1f471b7a883a4df48211e8c6a81b59a7","1f471b7a883a4df48211e8c6a81b59a7",22852517,1,0,1,1381,401,401,0
"1f471b7a883a4df48211e8c6a81b59a7","2b09a08242b54983aec7063990fb3f66",22852517,1,-1,0,1382,401,400,-1
"2b09a08242b54983aec7063990fb3f66","9de0d567bfa84fe5b77cb76f4a76a5d1",22852517,1,5,0,1383,400,404,4
"9de0d567bfa84fe5b77cb76f4a76a5d1","9de0d567bfa84fe5b77cb76f4a76a5d1",22852517,1,0,1,1384,404,404,0
"9de0d567bfa84fe5b77cb76f4a76a5d1","1157bd665ec4472fb58b751dc5099355",22852517,1,-1,0,1385,404,403,-1
"1157bd665ec4472fb58b751dc5099355","58fc9094275e4c49be3f4ba6d4acc0a4",22852517,1,5,0,1386,403,406,3
"58fc9094275e4c49be3f4ba6d4acc0a4","3c8a22d2f9c146ea956609e3ed4f2559",22852517,1,-2,0,1387,406,405,-1
"3c8a22d2f9c146ea956609e3ed4f2559","c1c1be90b2b14c1ab4a5e1ee3c241902",22852517,1,3,0,1388,405,407,2
"c1c1be90b2b14c1ab4a5e1ee3c241902","c1c1be90b2b14c1ab4a5e1ee3c241902",22852517,5,0,1,1389,407,407,0
"c1c1be90b2b14c1ab4a5e1ee3c241902","58fc9094275e4c49be3f4ba6d4acc0a4",22852517,1,-1,0,1394,407,406,-1
"58fc9094275e4c49be3f4ba6d4acc0a4","02b3a1bead9244c1ba2f857c7da8f82a",22852517,1,3,0,1395,406,408,2
"02b3a1bead9244c1ba2f857c7da8f82a","6206fc6479014bb193084c32409dc1b9",22852517,1,1,0,1396,408,409,1
"6206fc6479014bb193084c32409dc1b9","6206fc6479014bb193084c32409dc1b9",22852517,1,0,1,1397,409,409,0
"6206fc6479014bb193084c32409dc1b9","02b3a1bead9244c1ba2f857c7da8f82a",22852517,1,-1,0,1398,409,408,-1
"02b3a1bead9244c1ba2f857c7da8f82a","6a5f020451db426dacba9e2ea3fcc62a",22852517,1,3,0,1399,408,410,2
"6a5f020451db426dacba9e2ea3fcc62a","6a5f020451db426dacba9e2ea3fcc62a",22852517,1,0,1,1400,410,410,0
"6a5f020451db426dacba9e2ea3fcc62a","33a9d248b2e44588a5b07fc1342b9bc2",22852517,1,2,0,1401,410,411,1
"33a9d248b2e44588a5b07fc1342b9bc2","c6f26bd420634f1cb7989e76fe6b16c0",22852517,1,1,0,1402,411,412,1
"c6f26bd420634f1cb7989e76fe6b16c0","c6f26bd420634f1cb7989e76fe6b16c0",22852517,11,0,1,1403,412,412,0
"c6f26bd420634f1cb7989e76fe6b16c0","2a65ee6e2ac64f6a8a55fbe5373ec763",22852517,1,1,0,1414,412,413,1
"2a65ee6e2ac64f6a8a55fbe5373ec763","2a65ee6e2ac64f6a8a55fbe5373ec763",22852517,2,0,1,1415,413,413,0
"2a65ee6e2ac64f6a8a55fbe5373ec763","33a9d248b2e44588a5b07fc1342b9bc2",22852517,1,-2,0,1417,413,411,-2
"33a9d248b2e44588a5b07fc1342b9bc2","1fd0f6dadbc14ebc965faf6122190b96",22852517,1,5,0,1418,411,415,4
"1fd0f6dadbc14ebc965faf6122190b96","1fd0f6dadbc14ebc965faf6122190b96",22852517,1,0,1,1419,415,415,0
"1fd0f6dadbc14ebc965faf6122190b96","687055dad9fc40c3982478fe33ec01bf",22852517,1,-1,0,1420,415,414,-1
"687055dad9fc40c3982478fe33ec01bf","2add1669f08d4101913db15f8c23b3b7",22852517,1,3,0,1421,414,416,2
"2add1669f08d4101913db15f8c23b3b7","2add1669f08d4101913db15f8c23b3b7",22852517,1,0,1,1422,416,416,0
"2add1669f08d4101913db15f8c23b3b7","2b09a08242b54983aec7063990fb3f66",22852517,1,-24,0,1423,416,400,-16
"2b09a08242b54983aec7063990fb3f66","a2b4bd40cee2481ebd3fc179d6a5cd62",22852517,1,27,0,1424,400,417,17
"a2b4bd40cee2481ebd3fc179d6a5cd62","e34e59dce2204f228f3a84b6725df60f",22852517,1,2,0,1425,417,419,2
"e34e59dce2204f228f3a84b6725df60f","e34e59dce2204f228f3a84b6725df60f",22852517,1,0,1,1426,419,419,0
"e34e59dce2204f228f3a84b6725df60f","bec48fc2e1294c7eb3d0aca780d731b8",22852517,1,2,0,1427,419,420,1
"bec48fc2e1294c7eb3d0aca780d731b8","a2b4bd40cee2481ebd3fc179d6a5cd62",22852517,1,-4,0,1428,420,417,-3
"a2b4bd40cee2481ebd3fc179d6a5cd62","bec48fc2e1294c7eb3d0aca780d731b8",22852517,1,4,0,1429,417,420,3
"bec48fc2e1294c7eb3d0aca780d731b8","a24600b0e49245f6bdba8c893cfeddb0",22852517,1,7,0,1430,420,425,5
"a24600b0e49245f6bdba8c893cfeddb0","dbde19fcce2a4c1abdc7f685c293a23f",22852517,1,-4,0,1431,425,422,-3
"dbde19fcce2a4c1abdc7f685c293a23f","a24600b0e49245f6bdba8c893cfeddb0",22852517,1,4,0,1432,422,425,3
"a24600b0e49245f6bdba8c893cfeddb0","a2b4bd40cee2481ebd3fc179d6a5cd62",22852517,1,-11,0,1433,425,417,-8
"a2b4bd40cee2481ebd3fc179d6a5cd62","24cf8786024543f19b89bc20034e60d7",22852517,1,18,0,1434,417,428,11
"24cf8786024543f19b89bc20034e60d7","f2a73be2f46840b182d7bd095378004e",22852517,1,1,0,1435,428,429,1
"f2a73be2f46840b182d7bd095378004e","604551fd4266430cb860fef58fa7dd61",22852517,1,1,0,1436,429,430,1
"604551fd4266430cb860fef58fa7dd61","604551fd4266430cb860fef58fa7dd61",22852517,1,0,1,1437,430,430,0
"604551fd4266430cb860fef58fa7dd61","dce46f8904594a62a6377a3587aaa663",22852517,1,2,0,1438,430,431,1
"dce46f8904594a62a6377a3587aaa663","24cf8786024543f19b89bc20034e60d7",22852517,1,-4,0,1439,431,428,-3
"24cf8786024543f19b89bc20034e60d7","9b9d0a249052413c869753b99682b0ac",22852517,1,5,0,1440,428,432,4
"9b9d0a249052413c869753b99682b0ac","9b9d0a249052413c869753b99682b0ac",22852517,7,0,1,1441,432,432,0
"9b9d0a249052413c869753b99682b0ac","061c175cc90f45fbad883025394e78dd",22852517,1,1,0,1448,432,433,1
"061c175cc90f45fbad883025394e78dd","061c175cc90f45fbad883025394e78dd",22852517,5,0,1,1449,433,433,0
"061c175cc90f45fbad883025394e78dd","dce46f8904594a62a6377a3587aaa663",22852517,1,-2,0,1454,433,431,-2
"dce46f8904594a62a6377a3587aaa663","74a7f8712e5449c2bc0b43c6f90dafed",22852517,1,5,0,1455,431,435,4
"74a7f8712e5449c2bc0b43c6f90dafed","74a7f8712e5449c2bc0b43c6f90dafed",22852517,1,0,1,1456,435,435,0
"74a7f8712e5449c2bc0b43c6f90dafed","66ada10dde9f43018588f1ced9d477fc",22852517,1,-1,0,1457,435,434,-1
"66ada10dde9f43018588f1ced9d477fc","bf12c96466d840a69bed7020b3f18bb8",22852517,1,3,0,1458,434,436,2
"bf12c96466d840a69bed7020b3f18bb8","bf12c96466d840a69bed7020b3f18bb8",22852517,1,0,1,1459,436,436,0
"bf12c96466d840a69bed7020b3f18bb8","24cf8786024543f19b89bc20034e60d7",22852517,1,-11,0,1460,436,428,-8
"24cf8786024543f19b89bc20034e60d7","070600601c4c439288445d2f0724807d",22852517,1,14,0,1461,428,437,9
"070600601c4c439288445d2f0724807d","1823b6de7d334a7aaabc4570719af4d9",22852517,2,2,0,1462,437,439,2
"1823b6de7d334a7aaabc4570719af4d9","1823b6de7d334a7aaabc4570719af4d9",22852517,12,0,1,1463,439,439,0
"1823b6de7d334a7aaabc4570719af4d9","070600601c4c439288445d2f0724807d",22852517,1,-2,0,1475,439,437,-2
"070600601c4c439288445d2f0724807d","0380cd76a7d44bc3a4da1f15e4d68f89",22852517,1,4,0,1476,437,440,3
"0380cd76a7d44bc3a4da1f15e4d68f89","0380cd76a7d44bc3a4da1f15e4d68f89",22852517,1,0,1,1477,440,440,0
"0380cd76a7d44bc3a4da1f15e4d68f89","23b7673c8b5443108c2ef09382834a86",22852517,1,2,0,1478,440,441,1
"23b7673c8b5443108c2ef09382834a86","901e92500aea43c79f19f1b279050668",22852517,1,2,0,1479,441,442,1
"901e92500aea43c79f19f1b279050668","23b7673c8b5443108c2ef09382834a86",22852517,1,-2,0,1480,442,441,-1
"23b7673c8b5443108c2ef09382834a86","001339db8ced4cf78829ebe8b145449d",22852517,1,3,0,1481,441,443,2
"001339db8ced4cf78829ebe8b145449d","001339db8ced4cf78829ebe8b145449d",22852517,5,0,1,1482,443,443,0
"001339db8ced4cf78829ebe8b145449d","452745e0366e42ae81561bfddebcc6c3",22852517,1,1,0,1487,443,444,1
"452745e0366e42ae81561bfddebcc6c3","452745e0366e42ae81561bfddebcc6c3",22852517,2,0,1,1488,444,444,0
"452745e0366e42ae81561bfddebcc6c3","901e92500aea43c79f19f1b279050668",22852517,1,-2,0,1490,444,442,-2
"901e92500aea43c79f19f1b279050668","4660ff2089114e8db82ceb26a4f329e3",22852517,1,4,0,1491,442,445,3
"4660ff2089114e8db82ceb26a4f329e3","4660ff2089114e8db82ceb26a4f329e3",22852517,1,0,1,1492,445,445,0
"4660ff2089114e8db82ceb26a4f329e3","7bd5586eb9d8484eb74a433ee7bfe499",22852517,1,2,0,1493,445,446,1
"7bd5586eb9d8484eb74a433ee7bfe499","7bd5586eb9d8484eb74a433ee7bfe499",22852517,16,0,1,1494,446,446,0
"7bd5586eb9d8484eb74a433ee7bfe499","8a7f26e690f34dda97be16904518ca99",22852517,1,2,0,1510,446,447,1
"8a7f26e690f34dda97be16904518ca99","8a7f26e690f34dda97be16904518ca99",22852517,1,0,1,1511,447,447,0
"8a7f26e690f34dda97be16904518ca99","070600601c4c439288445d2f0724807d",22852517,1,-16,0,1512,447,437,-10
"070600601c4c439288445d2f0724807d","b2f0d654738f48158edff28e8d3a546e",22852517,1,21,0,1513,437,449,12
"b2f0d654738f48158edff28e8d3a546e","f60ee41ec635499abd48168342d32c2f",22852517,3,5,0,1514,449,453,4
"f60ee41ec635499abd48168342d32c2f","f60ee41ec635499abd48168342d32c2f",22852517,59,0,1,1515,453,453,0
"f60ee41ec635499abd48168342d32c2f","b2f0d654738f48158edff28e8d3a546e",22852517,1,-5,0,1521,453,449,-4
"f60ee41ec635499abd48168342d32c2f","070600601c4c439288445d2f0724807d",22852517,1,-26,0,1545,453,437,-16
"1823b6de7d334a7aaabc4570719af4d9","f67fbf45a5f146ed866965bc57c7c001",22852517,1,27,0,1547,439,454,15
"f67fbf45a5f146ed866965bc57c7c001","f67fbf45a5f146ed866965bc57c7c001",22852517,2,0,1,1548,454,454,0
"f67fbf45a5f146ed866965bc57c7c001","b2f0d654738f48158edff28e8d3a546e",22852517,2,-8,0,1549,454,449,-5
"b2f0d654738f48158edff28e8d3a546e","b2f0d654738f48158edff28e8d3a546e",22852517,2,0,1,1550,449,449,0
"f60ee41ec635499abd48168342d32c2f","f67fbf45a5f146ed866965bc57c7c001",22852517,1,3,0,1584,453,454,1
"b2f0d654738f48158edff28e8d3a546e","f67fbf45a5f146ed866965bc57c7c001",22852517,1,8,0,1586,449,454,5
"f67fbf45a5f146ed866965bc57c7c001","d937afe49bd24a07a550dda1c1155122",22852517,1,1,0,1588,454,455,1
"d937afe49bd24a07a550dda1c1155122","d937afe49bd24a07a550dda1c1155122",22852517,1,0,1,1589,455,455,0
"d937afe49bd24a07a550dda1c1155122","3628b3f7823443d0912a339096b69943",22852517,1,1,0,1590,455,456,1
"3628b3f7823443d0912a339096b69943","3628b3f7823443d0912a339096b69943",22852517,1,0,1,1591,456,456,0
"3628b3f7823443d0912a339096b69943","9e049ee647cf43ecbcb5ed792a8e7588",22852517,1,1,0,1592,456,457,1
"9e049ee647cf43ecbcb5ed792a8e7588","9e049ee647cf43ecbcb5ed792a8e7588",22852517,3,0,1,1593,457,457,0
"9e049ee647cf43ecbcb5ed792a8e7588","5256a214faaf410b93f76cea06428334",22852517,1,1,0,1596,457,458,1
"5256a214faaf410b93f76cea06428334","5256a214faaf410b93f76cea06428334",22852517,1,0,1,1597,458,458,0
"5256a214faaf410b93f76cea06428334","25c32b120fce40fa9b6c85133aeb4716",22852517,1,1,0,1598,458,459,1
"25c32b120fce40fa9b6c85133aeb4716","25c32b120fce40fa9b6c85133aeb4716",22852517,5,0,1,1599,459,459,0
"25c32b120fce40fa9b6c85133aeb4716","11bc14f2204949008b7d511b933363c1",22852517,1,1,0,1604,459,460,1
"11bc14f2204949008b7d511b933363c1","11bc14f2204949008b7d511b933363c1",22852517,6,0,1,1605,460,460,0
"11bc14f2204949008b7d511b933363c1","25c32b120fce40fa9b6c85133aeb4716",22852517,1,-1,0,1611,460,459,-1
"25c32b120fce40fa9b6c85133aeb4716","42de338840a34d15adb66e7b14fb9d2c",22852517,1,2,0,1612,459,461,2
"42de338840a34d15adb66e7b14fb9d2c","42de338840a34d15adb66e7b14fb9d2c",22852517,5,0,1,1613,461,461,0
"42de338840a34d15adb66e7b14fb9d2c","9da37c6210b1416b8079c274f70bf600",22852517,1,1,0,1618,461,462,1
"9da37c6210b1416b8079c274f70bf600","9da37c6210b1416b8079c274f70bf600",22852517,1,0,1,1619,462,462,0
"9da37c6210b1416b8079c274f70bf600","519119f1deac45ff9ab4f13529be5c6e",22852517,1,1,0,1620,462,463,1
"519119f1deac45ff9ab4f13529be5c6e","519119f1deac45ff9ab4f13529be5c6e",22852517,1,0,1,1621,463,463,0
"519119f1deac45ff9ab4f13529be5c6e","c5df9f40ec14463b9dcfdc73df3e9285",22852517,1,3,0,1622,463,464,1
"c5df9f40ec14463b9dcfdc73df3e9285","f67fbf45a5f146ed866965bc57c7c001",22852517,1,-12,0,1623,464,454,-10
"f67fbf45a5f146ed866965bc57c7c001","c5df9f40ec14463b9dcfdc73df3e9285",22852517,1,12,0,1624,454,464,10
"b613861cecf84ffcab01afb23f660475","b613861cecf84ffcab01afb23f660475",22852678,7,0,1,1,1,1,0
"e2911e79efc2420eac45d9f671463d4b","e2911e79efc2420eac45d9f671463d4b",22852678,8,0,1,10,2,2,0
"e2911e79efc2420eac45d9f671463d4b","519d1b8c59404d67b54e96c5c8a830b2",22852678,1,1,0,12,2,3,1
"519d1b8c59404d67b54e96c5c8a830b2","519d1b8c59404d67b54e96c5c8a830b2",22852678,1,0,1,13,3,3,0
"519d1b8c59404d67b54e96c5c8a830b2","531db53f81f646edb0cdcfe0085b03b7",22852678,1,1,0,14,3,4,1
"531db53f81f646edb0cdcfe0085b03b7","531db53f81f646edb0cdcfe0085b03b7",22852678,1,0,1,15,4,4,0
"531db53f81f646edb0cdcfe0085b03b7","4f5f94b2f95141e0a9d53a61da2276da",22852678,1,1,0,16,4,5,1
"4f5f94b2f95141e0a9d53a61da2276da","4f5f94b2f95141e0a9d53a61da2276da",22852678,1,0,1,17,5,5,0
"4f5f94b2f95141e0a9d53a61da2276da","6d541c89590949f99af293c4f2333f67",22852678,1,1,0,18,5,6,1
"6d541c89590949f99af293c4f2333f67","6d541c89590949f99af293c4f2333f67",22852678,1,0,1,19,6,6,0
"6d541c89590949f99af293c4f2333f67","dd5cf0b9fe4c4f1d8f5ff8e4c04879cb",22852678,1,1,0,20,6,7,1
"dd5cf0b9fe4c4f1d8f5ff8e4c04879cb","dd5cf0b9fe4c4f1d8f5ff8e4c04879cb",22852678,2,0,1,21,7,7,0
"dd5cf0b9fe4c4f1d8f5ff8e4c04879cb","f96261861edc426abe2248be4f0a709a",22852678,1,1,0,22,7,8,1
"f96261861edc426abe2248be4f0a709a","f96261861edc426abe2248be4f0a709a",22852678,5,0,1,23,8,8,0
"f96261861edc426abe2248be4f0a709a","dd5cf0b9fe4c4f1d8f5ff8e4c04879cb",22852678,1,-1,0,28,8,7,-1
"dd5cf0b9fe4c4f1d8f5ff8e4c04879cb","66b5e16f4f75454fb5b8172079f0fa83",22852678,1,2,0,30,7,9,2
"66b5e16f4f75454fb5b8172079f0fa83","66b5e16f4f75454fb5b8172079f0fa83",22852678,1,0,1,31,9,9,0
"66b5e16f4f75454fb5b8172079f0fa83","0680571d4698477995e41842c36a54b2",22852678,1,1,0,32,9,10,1
"0680571d4698477995e41842c36a54b2","0680571d4698477995e41842c36a54b2",22852678,2,0,1,33,10,10,0
"0680571d4698477995e41842c36a54b2","9112f2bffece48e08c6d2287be204085",22852678,1,1,0,35,10,11,1
"9112f2bffece48e08c6d2287be204085","9112f2bffece48e08c6d2287be204085",22852678,1,0,1,36,11,11,0
"9112f2bffece48e08c6d2287be204085","e2911e79efc2420eac45d9f671463d4b",22852678,1,-9,0,37,11,2,-9
"b7f2b31585d94eb3bf86376714aa7070","56586aa865414f538729c7f7735d2bc6",22852678,1,-2,0,42,13,12,-1
"5c5ceeee4562457ba6d41515aeebfbb1","5c5ceeee4562457ba6d41515aeebfbb1",22852678,1,0,1,48,17,17,0
"d4c3b003e8274e429d2fa688d73fde6d","d4c3b003e8274e429d2fa688d73fde6d",22852678,2,0,1,55,22,22,0
"afbf7250b99d47bea07172749483ca97","afbf7250b99d47bea07172749483ca97",22852678,1,0,1,61,28,28,0
"51970cfa30e643e894e66ae85c8024cc","c33c17be71ae4d588da7369472e5bb1b",22852678,1,6,0,65,31,34,3
"c33c17be71ae4d588da7369472e5bb1b","4e51676dc72045d99c19b9fa7b22f8bc",22852678,1,-9,0,66,34,29,-5
"4e51676dc72045d99c19b9fa7b22f8bc","93679be414554a11b1893002f2229a93",22852678,1,12,0,67,29,35,6
"fc0e049d56024bc9a02c9a9c435c3df7","9a0dc646f934470daf08c4b56ccf73db",22852678,1,-3,0,74,38,37,-1
"9a0dc646f934470daf08c4b56ccf73db","b613861cecf84ffcab01afb23f660475",22852678,1,-65,0,75,37,1,-36
"b613861cecf84ffcab01afb23f660475","67a089198fcb4e1c8f2385786c2b296f",22852678,1,72,0,77,1,39,38
"64d48c6c9c7940639a932219a6c87198","64d48c6c9c7940639a932219a6c87198",22852678,2,0,1,79,40,40,0
"64d48c6c9c7940639a932219a6c87198","67a089198fcb4e1c8f2385786c2b296f",22852678,1,-1,0,81,40,39,-1
"67a089198fcb4e1c8f2385786c2b296f","b534b89233134e30a9b5645138bfa9ee",22852678,1,4,0,82,39,41,2
"b534b89233134e30a9b5645138bfa9ee","0e37b720d23b4e7f8b313e79313fd107",22852678,1,3,0,83,41,44,3
"0e37b720d23b4e7f8b313e79313fd107","0e37b720d23b4e7f8b313e79313fd107",22852678,3,0,1,84,44,44,0
"0e37b720d23b4e7f8b313e79313fd107","6875d67fdd5f48168b62719df449bebd",22852678,1,1,0,87,44,45,1
"6875d67fdd5f48168b62719df449bebd","6875d67fdd5f48168b62719df449bebd",22852678,1,0,1,88,45,45,0
"6875d67fdd5f48168b62719df449bebd","b534b89233134e30a9b5645138bfa9ee",22852678,1,-4,0,89,45,41,-4
"b534b89233134e30a9b5645138bfa9ee","6e13d61a7bdb44bca949c9f86fab3be5",22852678,1,7,0,90,41,47,6
"6e13d61a7bdb44bca949c9f86fab3be5","6e13d61a7bdb44bca949c9f86fab3be5",22852678,1,0,1,91,47,47,0
"6e13d61a7bdb44bca949c9f86fab3be5","195f78799f984cc2b06c48dfe36be751",22852678,1,2,0,92,47,49,2
"195f78799f984cc2b06c48dfe36be751","195f78799f984cc2b06c48dfe36be751",22852678,2,0,1,93,49,49,0
"195f78799f984cc2b06c48dfe36be751","d9c8d8c444a64dadbbb508652c721e17",22852678,1,-3,0,95,49,46,-3
"d9c8d8c444a64dadbbb508652c721e17","d0c74f735e024943943e40333d6d337f",22852678,1,6,0,96,46,51,5
"d0c74f735e024943943e40333d6d337f","d0c74f735e024943943e40333d6d337f",22852678,1,0,1,97,51,51,0
"d0c74f735e024943943e40333d6d337f","983f8ff320594b279a7f4a6fe132f9c5",22852678,1,2,0,98,51,53,2
"983f8ff320594b279a7f4a6fe132f9c5","983f8ff320594b279a7f4a6fe132f9c5",22852678,5,0,1,100,53,53,0
"983f8ff320594b279a7f4a6fe132f9c5","35adfa5d923046aebabfefd98f35ff05",22852678,1,1,0,104,53,54,1
"35adfa5d923046aebabfefd98f35ff05","35adfa5d923046aebabfefd98f35ff05",22852678,8,0,1,105,54,54,0
"35adfa5d923046aebabfefd98f35ff05","b6f8a98476224da1b40e555ececc7ed8",22852678,1,1,0,113,54,55,1
"b6f8a98476224da1b40e555ececc7ed8","b6f8a98476224da1b40e555ececc7ed8",22852678,2,0,1,114,55,55,0
"b6f8a98476224da1b40e555ececc7ed8","86e22cb5fe0e4b47a9489ecddf7ed78f",22852678,1,1,0,116,55,56,1
"86e22cb5fe0e4b47a9489ecddf7ed78f","86e22cb5fe0e4b47a9489ecddf7ed78f",22852678,2,0,1,117,56,56,0
"86e22cb5fe0e4b47a9489ecddf7ed78f","a1f2f12debe5432fb7a70bcd12bacfb9",22852678,1,3,0,119,56,58,2
"a1f2f12debe5432fb7a70bcd12bacfb9","78f30e4dcac84e3cbea8b2cc6e0d62b3",22852678,2,1,0,120,58,59,1
"78f30e4dcac84e3cbea8b2cc6e0d62b3","f924752d8a1149668870b1e7698486f7",22852678,1,-10,0,121,59,50,-9
"f924752d8a1149668870b1e7698486f7","a1f2f12debe5432fb7a70bcd12bacfb9",22852678,1,9,0,122,50,58,8
"a1f2f12debe5432fb7a70bcd12bacfb9","a1f2f12debe5432fb7a70bcd12bacfb9",22852678,52,0,1,123,58,58,0
"78f30e4dcac84e3cbea8b2cc6e0d62b3","78f30e4dcac84e3cbea8b2cc6e0d62b3",22852678,19,0,1,155,59,59,0
"78f30e4dcac84e3cbea8b2cc6e0d62b3","bc42d26810654ea9a1df1efe1e58c7d5",22852678,1,5,0,174,59,63,4
"bc42d26810654ea9a1df1efe1e58c7d5","a0a418b8540d479fa6e0f653b701da8b",22852678,3,1,0,175,63,64,1
"a0a418b8540d479fa6e0f653b701da8b","12aa6e1672ac4e7aa6449a7a8609cd72",22852678,2,-8,0,176,64,57,-7
"12aa6e1672ac4e7aa6449a7a8609cd72","4c943503763e4e349906eea3ed3c8e86",22852678,1,5,0,177,57,61,4
"4c943503763e4e349906eea3ed3c8e86","4c943503763e4e349906eea3ed3c8e86",22852678,1,0,1,178,61,61,0
"4c943503763e4e349906eea3ed3c8e86","bc42d26810654ea9a1df1efe1e58c7d5",22852678,1,2,0,179,61,63,2
"bc42d26810654ea9a1df1efe1e58c7d5","bc42d26810654ea9a1df1efe1e58c7d5",22852678,4,0,1,180,63,63,0
"a0a418b8540d479fa6e0f653b701da8b","a0a418b8540d479fa6e0f653b701da8b",22852678,4,0,1,184,64,64,0
"a0a418b8540d479fa6e0f653b701da8b","309ccf3cc4fe429d9bfbaef53d3fa479",22852678,1,-4,0,187,64,60,-4
"309ccf3cc4fe429d9bfbaef53d3fa479","d646286c8051419bbc2e31dd1db55ca8",22852678,1,10,0,188,60,67,7
"d646286c8051419bbc2e31dd1db55ca8","b534b89233134e30a9b5645138bfa9ee",22852678,1,-33,0,189,67,41,-26
"b534b89233134e30a9b5645138bfa9ee","267f883678b24aed855fde42524975d9",22852678,1,37,0,190,41,71,30
"267f883678b24aed855fde42524975d9","267f883678b24aed855fde42524975d9",22852678,1,0,1,191,71,71,0
"267f883678b24aed855fde42524975d9","88fff56d0342490dbef9040750a20f6c",22852678,1,1,0,192,71,72,1
"88fff56d0342490dbef9040750a20f6c","88fff56d0342490dbef9040750a20f6c",22852678,1,0,1,193,72,72,0
"88fff56d0342490dbef9040750a20f6c","adb17b12b66c4a49a85fd34322f7df70",22852678,1,1,0,194,72,73,1
"adb17b12b66c4a49a85fd34322f7df70","adb17b12b66c4a49a85fd34322f7df70",22852678,1,0,1,195,73,73,0
"adb17b12b66c4a49a85fd34322f7df70","d646286c8051419bbc2e31dd1db55ca8",22852678,1,-6,0,196,73,67,-6
"d646286c8051419bbc2e31dd1db55ca8","a2becd407db34b189200a32546d9d569",22852678,1,9,0,197,67,75,8
"a2becd407db34b189200a32546d9d569","a2becd407db34b189200a32546d9d569",22852678,2,0,1,198,75,75,0
"a2becd407db34b189200a32546d9d569","58c22b011d0f4c2ea6d13615edbb9eeb",22852678,1,2,0,200,75,77,2
"58c22b011d0f4c2ea6d13615edbb9eeb","58c22b011d0f4c2ea6d13615edbb9eeb",22852678,11,0,1,201,77,77,0
"58c22b011d0f4c2ea6d13615edbb9eeb","dd76e1861dc9461c830888729d091ee0",22852678,1,1,0,212,77,78,1
"dd76e1861dc9461c830888729d091ee0","dd76e1861dc9461c830888729d091ee0",22852678,5,0,1,213,78,78,0
"dd76e1861dc9461c830888729d091ee0","cd1d828f1a694b87913a7ea66c23803e",22852678,1,1,0,218,78,79,1
"cd1d828f1a694b87913a7ea66c23803e","cd1d828f1a694b87913a7ea66c23803e",22852678,2,0,1,219,79,79,0
"cd1d828f1a694b87913a7ea66c23803e","9176a3c2b4d2465fa8b0c67096c2a97e",22852678,1,1,0,221,79,80,1
"9176a3c2b4d2465fa8b0c67096c2a97e","9176a3c2b4d2465fa8b0c67096c2a97e",22852678,5,0,1,222,80,80,0
"9176a3c2b4d2465fa8b0c67096c2a97e","f8ec6445f7194e25b9101d4fbcb07a18",22852678,1,1,0,227,80,81,1
"f8ec6445f7194e25b9101d4fbcb07a18","f8ec6445f7194e25b9101d4fbcb07a18",22852678,8,0,1,228,81,81,0
"f8ec6445f7194e25b9101d4fbcb07a18","140d5b27b8574befad82c0a013b59dfa",22852678,1,-7,0,236,81,74,-7
"140d5b27b8574befad82c0a013b59dfa","d18a9ea32855445f8736581f5cb119ce",22852678,1,9,0,237,74,82,8
"d18a9ea32855445f8736581f5cb119ce","f564483cbd7a407681aa2fcca518cf5f",22852678,1,4,0,238,82,85,3
"f564483cbd7a407681aa2fcca518cf5f","f564483cbd7a407681aa2fcca518cf5f",22852678,3,0,1,239,85,85,0
"f564483cbd7a407681aa2fcca518cf5f","18fd01350bd5434ca636d59a599d768a",22852678,1,1,0,240,85,86,1
"18fd01350bd5434ca636d59a599d768a","18fd01350bd5434ca636d59a599d768a",22852678,8,0,1,241,86,86,0
"18fd01350bd5434ca636d59a599d768a","6a9f0ef185fb47f0937e29daa1c71ed5",22852678,2,5,0,249,86,90,4
"6a9f0ef185fb47f0937e29daa1c71ed5","ae5ac430ea254e708a6f5deaaf7464ae",22852678,4,-7,0,250,90,84,-6
"ae5ac430ea254e708a6f5deaaf7464ae","c681290961c94c4caf23b529d1ae6b9a",22852678,1,5,0,251,84,88,4
"c681290961c94c4caf23b529d1ae6b9a","c681290961c94c4caf23b529d1ae6b9a",22852678,1,0,1,252,88,88,0
"c681290961c94c4caf23b529d1ae6b9a","6a9f0ef185fb47f0937e29daa1c71ed5",22852678,1,2,0,253,88,90,2
"6a9f0ef185fb47f0937e29daa1c71ed5","6a9f0ef185fb47f0937e29daa1c71ed5",22852678,9,0,1,254,90,90,0
"6a9f0ef185fb47f0937e29daa1c71ed5","d646286c8051419bbc2e31dd1db55ca8",22852678,1,-27,0,257,90,67,-23
"d646286c8051419bbc2e31dd1db55ca8","e20db35ced8544ddac5bc3839145e463",22852678,1,30,0,258,67,91,24
"e20db35ced8544ddac5bc3839145e463","67a089198fcb4e1c8f2385786c2b296f",22852678,1,-67,0,259,91,39,-52
"67a089198fcb4e1c8f2385786c2b296f","12aa6e1672ac4e7aa6449a7a8609cd72",22852678,1,23,0,260,39,57,18
"12aa6e1672ac4e7aa6449a7a8609cd72","b534b89233134e30a9b5645138bfa9ee",22852678,1,-19,0,261,57,41,-16
"b534b89233134e30a9b5645138bfa9ee","78f30e4dcac84e3cbea8b2cc6e0d62b3",22852678,1,21,0,262,41,59,18
"78f30e4dcac84e3cbea8b2cc6e0d62b3","a1f2f12debe5432fb7a70bcd12bacfb9",22852678,1,-1,0,263,59,58,-1
"a1f2f12debe5432fb7a70bcd12bacfb9","bc42d26810654ea9a1df1efe1e58c7d5",22852678,1,6,0,285,58,63,5
"12aa6e1672ac4e7aa6449a7a8609cd72","a0a418b8540d479fa6e0f653b701da8b",22852678,1,8,0,288,57,64,7
"a0a418b8540d479fa6e0f653b701da8b","bc42d26810654ea9a1df1efe1e58c7d5",22852678,1,-1,0,290,64,63,-1
"bc42d26810654ea9a1df1efe1e58c7d5","67a089198fcb4e1c8f2385786c2b296f",22852678,1,-30,0,292,63,39,-24
"67a089198fcb4e1c8f2385786c2b296f","ae5ac430ea254e708a6f5deaaf7464ae",22852678,1,57,0,293,39,84,45
"ae5ac430ea254e708a6f5deaaf7464ae","d646286c8051419bbc2e31dd1db55ca8",22852678,2,-20,0,294,84,67,-17
"d646286c8051419bbc2e31dd1db55ca8","6a9f0ef185fb47f0937e29daa1c71ed5",22852678,1,27,0,295,67,90,23
"ae5ac430ea254e708a6f5deaaf7464ae","6a9f0ef185fb47f0937e29daa1c71ed5",22852678,3,7,0,297,84,90,6
"6a9f0ef185fb47f0937e29daa1c71ed5","42fb58708eaf4e5daa82bfca61b6f5fd",22852678,2,-3,0,299,90,87,-3
"42fb58708eaf4e5daa82bfca61b6f5fd","18fd01350bd5434ca636d59a599d768a",22852678,2,-2,0,300,87,86,-1
"18fd01350bd5434ca636d59a599d768a","ae5ac430ea254e708a6f5deaaf7464ae",22852678,1,-2,0,307,86,84,-2
"6a9f0ef185fb47f0937e29daa1c71ed5","67a089198fcb4e1c8f2385786c2b296f",22852678,1,-64,0,311,90,39,-51
"67a089198fcb4e1c8f2385786c2b296f","67a089198fcb4e1c8f2385786c2b296f",22852678,1,0,1,312,39,39,0
"67a089198fcb4e1c8f2385786c2b296f","b7719e26494940efa49512aedd0aac79",22852678,2,-40,0,313,39,20,-19
"b7719e26494940efa49512aedd0aac79","3cbcea2be0984e7dbd5a48195af10ce7",22852678,1,200,0,314,20,165,145
"3cbcea2be0984e7dbd5a48195af10ce7","3cbcea2be0984e7dbd5a48195af10ce7",22852678,2,0,1,315,165,165,0
"3cbcea2be0984e7dbd5a48195af10ce7","82e6285962b8400d9d6fc32436022a94",22852678,2,2,0,316,165,167,2
"82e6285962b8400d9d6fc32436022a94","78adeee1fa2c4fe0bc73f7bca9fcee86",22852678,1,-10,0,317,167,160,-7
"78adeee1fa2c4fe0bc73f7bca9fcee86","3cbcea2be0984e7dbd5a48195af10ce7",22852678,2,8,0,318,160,165,5
"3cbcea2be0984e7dbd5a48195af10ce7","65202579580f4ad38d734b4ee39d22a8",22852678,1,-3,0,319,165,164,-1
"65202579580f4ad38d734b4ee39d22a8","78adeee1fa2c4fe0bc73f7bca9fcee86",22852678,2,-5,0,327,164,160,-4
"65202579580f4ad38d734b4ee39d22a8","67a089198fcb4e1c8f2385786c2b296f",22852678,1,-157,0,336,164,39,-125
"67a089198fcb4e1c8f2385786c2b296f","e20db35ced8544ddac5bc3839145e463",22852678,1,67,0,337,39,91,52
"e20db35ced8544ddac5bc3839145e463","e20db35ced8544ddac5bc3839145e463",22852678,2,0,1,338,91,91,0
"e20db35ced8544ddac5bc3839145e463","1febb706d7a34005ae8711ed49c76e64",22852678,1,3,0,339,91,94,3
"1febb706d7a34005ae8711ed49c76e64","1febb706d7a34005ae8711ed49c76e64",22852678,2,0,1,340,94,94,0
"1febb706d7a34005ae8711ed49c76e64","8f73ba6f5a0042f2850356ac38ac6f24",22852678,1,1,0,342,94,95,1
"8f73ba6f5a0042f2850356ac38ac6f24","8f73ba6f5a0042f2850356ac38ac6f24",22852678,5,0,1,343,95,95,0
"8f73ba6f5a0042f2850356ac38ac6f24","e2260b86653c46d7b14a41fb419dbf8c",22852678,1,1,0,348,95,96,1
"e2260b86653c46d7b14a41fb419dbf8c","e2260b86653c46d7b14a41fb419dbf8c",22852678,2,0,1,349,96,96,0
"e2260b86653c46d7b14a41fb419dbf8c","35eb641ad1d845bbba54915bce75a962",22852678,1,1,0,351,96,97,1
"35eb641ad1d845bbba54915bce75a962","35eb641ad1d845bbba54915bce75a962",22852678,5,0,1,352,97,97,0
"35eb641ad1d845bbba54915bce75a962","08be90ffbeea4795a138cd42ed8db56f",22852678,1,1,0,357,97,98,1
"08be90ffbeea4795a138cd42ed8db56f","08be90ffbeea4795a138cd42ed8db56f",22852678,5,0,1,358,98,98,0
"08be90ffbeea4795a138cd42ed8db56f","3007433c8f584dcbb5ac159c1c5f2be3",22852678,1,1,0,363,98,99,1
"3007433c8f584dcbb5ac159c1c5f2be3","3007433c8f584dcbb5ac159c1c5f2be3",22852678,5,0,1,364,99,99,0
"3007433c8f584dcbb5ac159c1c5f2be3","00ae5f0c51874a73a41ebea838d95682",22852678,1,3,0,369,99,101,2
"00ae5f0c51874a73a41ebea838d95682","e20db35ced8544ddac5bc3839145e463",22852678,1,-11,0,370,101,91,-10
"e20db35ced8544ddac5bc3839145e463","d391c8b6e56a43a7b654e9dee02d904b",22852678,1,13,0,371,91,103,12
"d391c8b6e56a43a7b654e9dee02d904b","00ae5f0c51874a73a41ebea838d95682",22852678,1,-2,0,372,103,101,-2
"00ae5f0c51874a73a41ebea838d95682","d391c8b6e56a43a7b654e9dee02d904b",22852678,1,2,0,373,101,103,2
"d391c8b6e56a43a7b654e9dee02d904b","d391c8b6e56a43a7b654e9dee02d904b",22852678,22,0,1,374,103,103,0
"d391c8b6e56a43a7b654e9dee02d904b","6111116566fc4fd9abba409322bea245",22852678,1,1,0,396,103,104,1
"6111116566fc4fd9abba409322bea245","6111116566fc4fd9abba409322bea245",22852678,2,0,1,397,104,104,0
"6111116566fc4fd9abba409322bea245","a81b2235cb9c499eb9ea8ee0a8dd9725",22852678,1,1,0,399,104,105,1
"a81b2235cb9c499eb9ea8ee0a8dd9725","a81b2235cb9c499eb9ea8ee0a8dd9725",22852678,5,0,1,400,105,105,0
"a81b2235cb9c499eb9ea8ee0a8dd9725","2d4e0ab0ef3b4d73b82c72d4621a7579",22852678,1,1,0,405,105,106,1
"2d4e0ab0ef3b4d73b82c72d4621a7579","2d4e0ab0ef3b4d73b82c72d4621a7579",22852678,2,0,1,406,106,106,0
"2d4e0ab0ef3b4d73b82c72d4621a7579","8bdebf492ebd4e62b0d522e8ab5e5197",22852678,1,1,0,408,106,107,1
"8bdebf492ebd4e62b0d522e8ab5e5197","8bdebf492ebd4e62b0d522e8ab5e5197",22852678,2,0,1,409,107,107,0
"8bdebf492ebd4e62b0d522e8ab5e5197","4280927ec4d643238aa49c32f9e06c6c",22852678,1,3,0,411,107,109,2
"4280927ec4d643238aa49c32f9e06c6c","73039f8c1eb9409cb4caee2cf968001e",22852678,1,-10,0,412,109,100,-9
"73039f8c1eb9409cb4caee2cf968001e","4280927ec4d643238aa49c32f9e06c6c",22852678,1,10,0,413,100,109,9
"4280927ec4d643238aa49c32f9e06c6c","4280927ec4d643238aa49c32f9e06c6c",22852678,1,0,1,414,109,109,0
"4280927ec4d643238aa49c32f9e06c6c","fc44e6a5f7654430af1227838224dceb",22852678,2,2,0,415,109,111,2
"fc44e6a5f7654430af1227838224dceb","fc44e6a5f7654430af1227838224dceb",22852678,5,0,1,416,111,111,0
"fc44e6a5f7654430af1227838224dceb","08111f75e22d409998cf8b85bd431f0a",22852678,1,-3,0,418,111,108,-3
"08111f75e22d409998cf8b85bd431f0a","a9ae0a3c070d455bb4369a8996313336",22852678,1,7,0,419,108,114,6
"a9ae0a3c070d455bb4369a8996313336","a9ae0a3c070d455bb4369a8996313336",22852678,1,0,1,420,114,114,0
"a9ae0a3c070d455bb4369a8996313336","71cec822bcff4f30a20e75dc63ef7b65",22852678,2,2,0,421,114,116,2
"71cec822bcff4f30a20e75dc63ef7b65","71cec822bcff4f30a20e75dc63ef7b65",22852678,3,0,1,422,116,116,0
"71cec822bcff4f30a20e75dc63ef7b65","62bff51286ef4f348717a3cf6fe2318f",22852678,2,5,0,423,116,120,4
"62bff51286ef4f348717a3cf6fe2318f","37319e88176d4aefa91d7a9980dbae91",22852678,2,-9,0,424,120,112,-8
"37319e88176d4aefa91d7a9980dbae91","b1cd0e7dc3ad4a8eb91a4bfdbeb025b0",22852678,1,7,0,425,112,118,6
"b1cd0e7dc3ad4a8eb91a4bfdbeb025b0","b1cd0e7dc3ad4a8eb91a4bfdbeb025b0",22852678,1,0,1,426,118,118,0
"b1cd0e7dc3ad4a8eb91a4bfdbeb025b0","62bff51286ef4f348717a3cf6fe2318f",22852678,1,2,0,427,118,120,2
"62bff51286ef4f348717a3cf6fe2318f","62bff51286ef4f348717a3cf6fe2318f",22852678,4,0,1,428,120,120,0
"62bff51286ef4f348717a3cf6fe2318f","e20db35ced8544ddac5bc3839145e463",22852678,2,-33,0,431,120,91,-29
"e20db35ced8544ddac5bc3839145e463","779f9ddd1fd14d1e9e69f72219a1fdbd",22852678,1,36,0,432,91,121,30
"779f9ddd1fd14d1e9e69f72219a1fdbd","67a089198fcb4e1c8f2385786c2b296f",22852678,1,-103,0,433,121,39,-82
"67a089198fcb4e1c8f2385786c2b296f","08111f75e22d409998cf8b85bd431f0a",22852678,1,86,0,434,39,108,69
"08111f75e22d409998cf8b85bd431f0a","e20db35ced8544ddac5bc3839145e463",22852678,2,-19,0,435,108,91,-17
"e20db35ced8544ddac5bc3839145e463","4280927ec4d643238aa49c32f9e06c6c",22852678,1,20,0,436,91,109,18
"fc44e6a5f7654430af1227838224dceb","a9ae0a3c070d455bb4369a8996313336",22852678,1,4,0,441,111,114,3
"a9ae0a3c070d455bb4369a8996313336","08111f75e22d409998cf8b85bd431f0a",22852678,1,-7,0,442,114,108,-6
"e20db35ced8544ddac5bc3839145e463","37319e88176d4aefa91d7a9980dbae91",22852678,1,24,0,445,91,112,21
"37319e88176d4aefa91d7a9980dbae91","a9ae0a3c070d455bb4369a8996313336",22852678,1,2,0,446,112,114,2
"37319e88176d4aefa91d7a9980dbae91","62bff51286ef4f348717a3cf6fe2318f",22852678,1,9,0,452,112,120,8
"e20db35ced8544ddac5bc3839145e463","ae5ac430ea254e708a6f5deaaf7464ae",22852678,1,-10,0,455,91,84,-7
"d646286c8051419bbc2e31dd1db55ca8","f564483cbd7a407681aa2fcca518cf5f",22852678,1,21,0,457,67,85,18
"f564483cbd7a407681aa2fcca518cf5f","6a9f0ef185fb47f0937e29daa1c71ed5",22852678,1,6,0,460,85,90,5
"ae5ac430ea254e708a6f5deaaf7464ae","42fb58708eaf4e5daa82bfca61b6f5fd",22852678,1,4,0,464,84,87,3
"42fb58708eaf4e5daa82bfca61b6f5fd","779f9ddd1fd14d1e9e69f72219a1fdbd",22852678,1,42,0,465,87,121,34
"779f9ddd1fd14d1e9e69f72219a1fdbd","779f9ddd1fd14d1e9e69f72219a1fdbd",22852678,1,0,1,466,121,121,0
"779f9ddd1fd14d1e9e69f72219a1fdbd","ae26e6cda8ad4a3f81bd347560d9579f",22852678,1,4,0,467,121,125,4
"ae26e6cda8ad4a3f81bd347560d9579f","ae26e6cda8ad4a3f81bd347560d9579f",22852678,3,0,1,468,125,125,0
"ae26e6cda8ad4a3f81bd347560d9579f","ee48df95832b4374aa273ceb27ec1315",22852678,1,1,0,471,125,126,1
"ee48df95832b4374aa273ceb27ec1315","ee48df95832b4374aa273ceb27ec1315",22852678,1,0,1,472,126,126,0
"ee48df95832b4374aa273ceb27ec1315","7a439da90b394756ad1777fc4c6dead5",22852678,1,1,0,473,126,127,1
"7a439da90b394756ad1777fc4c6dead5","7a439da90b394756ad1777fc4c6dead5",22852678,1,0,1,474,127,127,0
"7a439da90b394756ad1777fc4c6dead5","a8dd5213034441ac92724b4e83eb0bb2",22852678,1,3,0,475,127,129,2
"a8dd5213034441ac92724b4e83eb0bb2","779f9ddd1fd14d1e9e69f72219a1fdbd",22852678,1,-9,0,476,129,121,-8
"779f9ddd1fd14d1e9e69f72219a1fdbd","a8dd5213034441ac92724b4e83eb0bb2",22852678,1,9,0,477,121,129,8
"a8dd5213034441ac92724b4e83eb0bb2","8115eab6556b45f5b415c3b8c26a12e5",22852678,1,2,0,478,129,131,2
"8115eab6556b45f5b415c3b8c26a12e5","8115eab6556b45f5b415c3b8c26a12e5",22852678,2,0,1,479,131,131,0
"8115eab6556b45f5b415c3b8c26a12e5","ec34b06efd844b46a4c4818ecdb9b8f4",22852678,1,1,0,481,131,132,1
"ec34b06efd844b46a4c4818ecdb9b8f4","ec34b06efd844b46a4c4818ecdb9b8f4",22852678,2,0,1,482,132,132,0
"ec34b06efd844b46a4c4818ecdb9b8f4","c2e1c2b9eac64109b343a088584b576b",22852678,1,1,0,484,132,133,1
"c2e1c2b9eac64109b343a088584b576b","c2e1c2b9eac64109b343a088584b576b",22852678,2,0,1,485,133,133,0
"c2e1c2b9eac64109b343a088584b576b","579338175e0b4bbb8ef3b712b5d8b54e",22852678,1,-5,0,487,133,128,-5
"579338175e0b4bbb8ef3b712b5d8b54e","8bc5795d6a984a3eace4e2811e52dd4f",22852678,1,8,0,488,128,135,7
"8bc5795d6a984a3eace4e2811e52dd4f","8bc5795d6a984a3eace4e2811e52dd4f",22852678,1,0,1,489,135,135,0
"8bc5795d6a984a3eace4e2811e52dd4f","b416d47c56a742199b5d7c7f19d6503a",22852678,1,-1,0,490,135,134,-1
"b416d47c56a742199b5d7c7f19d6503a","cd4532ad48034873ba8bce2aac0c9808",22852678,1,4,0,491,134,137,3
"cd4532ad48034873ba8bce2aac0c9808","cd4532ad48034873ba8bce2aac0c9808",22852678,1,0,1,492,137,137,0
"cd4532ad48034873ba8bce2aac0c9808","df1de691dafe4549a18a4398ee9dfaf9",22852678,1,4,0,493,137,139,2
"df1de691dafe4549a18a4398ee9dfaf9","779f9ddd1fd14d1e9e69f72219a1fdbd",22852678,1,-23,0,494,139,121,-18
"779f9ddd1fd14d1e9e69f72219a1fdbd","6c5ad271a44743479bfaea29b1db8d02",22852678,1,27,0,495,121,143,22
"6c5ad271a44743479bfaea29b1db8d02","67a089198fcb4e1c8f2385786c2b296f",22852678,1,-130,0,496,143,39,-104
"67a089198fcb4e1c8f2385786c2b296f","df1de691dafe4549a18a4398ee9dfaf9",22852678,1,126,0,497,39,139,100
"df1de691dafe4549a18a4398ee9dfaf9","df1de691dafe4549a18a4398ee9dfaf9",22852678,1,0,1,498,139,139,0
"df1de691dafe4549a18a4398ee9dfaf9","6c5ad271a44743479bfaea29b1db8d02",22852678,1,4,0,499,139,143,4
"6c5ad271a44743479bfaea29b1db8d02","6c5ad271a44743479bfaea29b1db8d02",22852678,1,0,1,500,143,143,0
"6c5ad271a44743479bfaea29b1db8d02","83d311bed5374fee83d8d67a7d9d82dc",22852678,1,1,0,501,143,144,1
"83d311bed5374fee83d8d67a7d9d82dc","83d311bed5374fee83d8d67a7d9d82dc",22852678,1,0,1,502,144,144,0
"83d311bed5374fee83d8d67a7d9d82dc","402bba41861d43acb52a5abb89e8831e",22852678,1,1,0,503,144,145,1
"402bba41861d43acb52a5abb89e8831e","402bba41861d43acb52a5abb89e8831e",22852678,2,0,1,504,145,145,0
"402bba41861d43acb52a5abb89e8831e","8aae34f5ddbb4052a709b12e6b0d40fa",22852678,1,3,0,506,145,147,2
"8aae34f5ddbb4052a709b12e6b0d40fa","df1de691dafe4549a18a4398ee9dfaf9",22852678,1,-9,0,507,147,139,-8
"df1de691dafe4549a18a4398ee9dfaf9","8aae34f5ddbb4052a709b12e6b0d40fa",22852678,1,9,0,508,139,147,8
"8aae34f5ddbb4052a709b12e6b0d40fa","645b3f0249f64f76af2e19eb4d0e55b7",22852678,1,2,0,509,147,149,2
"645b3f0249f64f76af2e19eb4d0e55b7","645b3f0249f64f76af2e19eb4d0e55b7",22852678,5,0,1,510,149,149,0
"645b3f0249f64f76af2e19eb4d0e55b7","7e7b8db5064d4369805ab370aac5ddfb",22852678,1,1,0,515,149,150,1
"7e7b8db5064d4369805ab370aac5ddfb","7e7b8db5064d4369805ab370aac5ddfb",22852678,2,0,1,516,150,150,0
"7e7b8db5064d4369805ab370aac5ddfb","8956d210ae7f41968fada86d4c979d6a",22852678,1,1,0,518,150,151,1
"8956d210ae7f41968fada86d4c979d6a","8956d210ae7f41968fada86d4c979d6a",22852678,2,0,1,519,151,151,0
"8956d210ae7f41968fada86d4c979d6a","f902b0f41b544d4dbf79664fd233648d",22852678,1,-5,0,521,151,146,-5
"f902b0f41b544d4dbf79664fd233648d","ae781e8b775e4ccd93bc800dad5c8376",22852678,1,8,0,522,146,153,7
"ae781e8b775e4ccd93bc800dad5c8376","ae781e8b775e4ccd93bc800dad5c8376",22852678,2,0,1,523,153,153,0
"ae781e8b775e4ccd93bc800dad5c8376","06882a8492d9499aa31555567f575ecb",22852678,1,1,0,525,153,154,1
"06882a8492d9499aa31555567f575ecb","06882a8492d9499aa31555567f575ecb",22852678,1,0,1,526,154,154,0
"06882a8492d9499aa31555567f575ecb","f293c508f409466a8f27ddd7d1e40b20",22852678,1,1,0,527,154,155,1
"f293c508f409466a8f27ddd7d1e40b20","f293c508f409466a8f27ddd7d1e40b20",22852678,2,0,1,528,155,155,0
"f293c508f409466a8f27ddd7d1e40b20","cc4ddef5bbbe48ebb605141b347c4ed1",22852678,1,1,0,530,155,156,1
"cc4ddef5bbbe48ebb605141b347c4ed1","cc4ddef5bbbe48ebb605141b347c4ed1",22852678,5,0,1,531,156,156,0
"cc4ddef5bbbe48ebb605141b347c4ed1","f03480cf4eba413194d7af52fc0e7f28",22852678,1,-4,0,536,156,152,-4
"f03480cf4eba413194d7af52fc0e7f28","d313cec988a84645bee413e8d4724a4b",22852678,1,7,0,537,152,158,6
"d313cec988a84645bee413e8d4724a4b","d313cec988a84645bee413e8d4724a4b",22852678,4,0,1,538,158,158,0
"d313cec988a84645bee413e8d4724a4b","dc60696c76a74368a60f72246e47700d",22852678,1,1,0,542,158,159,1
"dc60696c76a74368a60f72246e47700d","dc60696c76a74368a60f72246e47700d",22852678,1,0,1,543,159,159,0
"dc60696c76a74368a60f72246e47700d","78adeee1fa2c4fe0bc73f7bca9fcee86",22852678,1,3,0,544,159,160,1
"78adeee1fa2c4fe0bc73f7bca9fcee86","df1de691dafe4549a18a4398ee9dfaf9",22852678,1,-26,0,545,160,139,-21
"df1de691dafe4549a18a4398ee9dfaf9","78adeee1fa2c4fe0bc73f7bca9fcee86",22852678,1,26,0,546,139,160,21
"82e6285962b8400d9d6fc32436022a94","67a089198fcb4e1c8f2385786c2b296f",22852678,2,-162,0,550,167,39,-128
"67a089198fcb4e1c8f2385786c2b296f","78adeee1fa2c4fe0bc73f7bca9fcee86",22852678,2,152,0,551,39,160,121
"78adeee1fa2c4fe0bc73f7bca9fcee86","78adeee1fa2c4fe0bc73f7bca9fcee86",22852678,2,0,1,552,160,160,0
"78adeee1fa2c4fe0bc73f7bca9fcee86","67a089198fcb4e1c8f2385786c2b296f",22852678,1,-152,0,553,160,39,-121
"65202579580f4ad38d734b4ee39d22a8","3cbcea2be0984e7dbd5a48195af10ce7",22852678,1,3,0,610,164,165,1
"3cbcea2be0984e7dbd5a48195af10ce7","78adeee1fa2c4fe0bc73f7bca9fcee86",22852678,1,-8,0,611,165,160,-5
"78adeee1fa2c4fe0bc73f7bca9fcee86","82e6285962b8400d9d6fc32436022a94",22852678,1,10,0,612,160,167,7
"67a089198fcb4e1c8f2385786c2b296f","a9ac840f098c4bd0a2ee896214ce29cd",22852678,1,165,0,614,39,168,129
"a9ac840f098c4bd0a2ee896214ce29cd","a9ac840f098c4bd0a2ee896214ce29cd",22852678,1,0,1,615,168,168,0
"a9ac840f098c4bd0a2ee896214ce29cd","67a089198fcb4e1c8f2385786c2b296f",22852678,1,-165,0,616,168,39,-129
"b7719e26494940efa49512aedd0aac79","a49d1bb4328949299686242fd0be5584",22852678,1,2,0,618,20,21,1
"afbf7250b99d47bea07172749483ca97","b613861cecf84ffcab01afb23f660475",22852678,1,-44,0,621,28,1,-27
"b613861cecf84ffcab01afb23f660475","9afd71a5298d4333b6849dfce1b9422c",22852678,2,28,0,622,1,18,17
"9afd71a5298d4333b6849dfce1b9422c","b613861cecf84ffcab01afb23f660475",22852678,1,-28,0,624,18,1,-17
"b613861cecf84ffcab01afb23f660475","eb2a0eb537344a9e891c761662e400b6",22852678,1,23,0,626,1,16,15
"eb2a0eb537344a9e891c761662e400b6","56586aa865414f538729c7f7735d2bc6",22852678,2,-8,0,627,16,12,-4
"56586aa865414f538729c7f7735d2bc6","5c5ceeee4562457ba6d41515aeebfbb1",22852678,2,10,0,628,12,17,5
"5c5ceeee4562457ba6d41515aeebfbb1","eb2a0eb537344a9e891c761662e400b6",22852678,2,-2,0,629,17,16,-1
"eb2a0eb537344a9e891c761662e400b6","eb2a0eb537344a9e891c761662e400b6",22852678,1,0,1,630,16,16,0
"eb2a0eb537344a9e891c761662e400b6","b613861cecf84ffcab01afb23f660475",22852678,1,-23,0,634,16,1,-15
"9afd71a5298d4333b6849dfce1b9422c","0c7262dff33c4087bc660ccf40f92f9c",22852678,1,213,0,637,18,169,151
"0c7262dff33c4087bc660ccf40f92f9c","0c7262dff33c4087bc660ccf40f92f9c",22852678,1,0,1,638,169,169,0
"0c7262dff33c4087bc660ccf40f92f9c","b2275c3fad834f8d90737a2d9a6927d6",22852678,1,3,0,639,169,172,3
"b2275c3fad834f8d90737a2d9a6927d6","b2275c3fad834f8d90737a2d9a6927d6",22852678,21,0,1,640,172,172,0
"b2275c3fad834f8d90737a2d9a6927d6","eb515a26030b41f8a82a1e6114420bad",22852678,1,1,0,661,172,173,1
"eb515a26030b41f8a82a1e6114420bad","eb515a26030b41f8a82a1e6114420bad",22852678,2,0,1,662,173,173,0
"eb515a26030b41f8a82a1e6114420bad","b42cc17b7de840f181a704558d0bc845",22852678,1,3,0,664,173,175,2
"b42cc17b7de840f181a704558d0bc845","0c7262dff33c4087bc660ccf40f92f9c",22852678,1,-7,0,665,175,169,-6
"0c7262dff33c4087bc660ccf40f92f9c","b42cc17b7de840f181a704558d0bc845",22852678,1,7,0,666,169,175,6
"b42cc17b7de840f181a704558d0bc845","801f9e9135034f49bf5f8b4bdefedb41",22852678,1,2,0,667,175,177,2
"801f9e9135034f49bf5f8b4bdefedb41","801f9e9135034f49bf5f8b4bdefedb41",22852678,4,0,1,668,177,177,0
"801f9e9135034f49bf5f8b4bdefedb41","b87c552dd247427abe6ab5795b9c9d43",22852678,1,5,0,672,177,181,4
"ea38cc0e6e6e41edbabf210220808bf9","362fcb0699a14845ab29b2340093e528",22852678,1,-6,0,674,179,174,-5
"b87c552dd247427abe6ab5795b9c9d43","b87c552dd247427abe6ab5795b9c9d43",22852678,7,0,1,677,181,181,0
"139b097acfca451689d80c9c6eebdf7b","30f660a1feb34582a739722532524f79",22852678,1,6,0,685,178,183,5
"30f660a1feb34582a739722532524f79","30f660a1feb34582a739722532524f79",22852678,7,0,1,686,183,183,0
"30f660a1feb34582a739722532524f79","2024b4885bd14338a39b7b509acbbd02",22852678,1,-1,0,693,183,182,-1
"2024b4885bd14338a39b7b509acbbd02","c3f63fe50d8e487c86bf8ef76c9cadd3",22852678,1,4,0,694,182,185,3
"c3f63fe50d8e487c86bf8ef76c9cadd3","c3f63fe50d8e487c86bf8ef76c9cadd3",22852678,1,0,1,695,185,185,0
"c3f63fe50d8e487c86bf8ef76c9cadd3","c8e371568a0c4391b25796ae4e91952e",22852678,1,3,0,696,185,186,1
"c8e371568a0c4391b25796ae4e91952e","0c7262dff33c4087bc660ccf40f92f9c",22852678,1,-23,0,697,186,169,-17
"0c7262dff33c4087bc660ccf40f92f9c","7d932b23e1c84326ae5aa4d3c0d813d1",22852678,1,25,0,698,169,188,19
"7d932b23e1c84326ae5aa4d3c0d813d1","7d932b23e1c84326ae5aa4d3c0d813d1",22852678,1,0,1,699,188,188,0
"7d932b23e1c84326ae5aa4d3c0d813d1","c8e371568a0c4391b25796ae4e91952e",22852678,1,-2,0,700,188,186,-2
"ab11d94c6c8948ea90b88f19d2cd502b","ab11d94c6c8948ea90b88f19d2cd502b",22852678,1,0,1,702,190,190,0
"2d2580c9411c4972909db508d6956a58","5bddb3d9ed264f3984702f048c7e5340",22852678,1,1,0,711,196,197,1
"5bddb3d9ed264f3984702f048c7e5340","5bddb3d9ed264f3984702f048c7e5340",22852678,2,0,1,712,197,197,0
"5bddb3d9ed264f3984702f048c7e5340","d5e8e2bd12a2466b9d6d90855f0eb079",22852678,1,1,0,714,197,198,1
"d5e8e2bd12a2466b9d6d90855f0eb079","d5e8e2bd12a2466b9d6d90855f0eb079",22852678,2,0,1,715,198,198,0
"d5e8e2bd12a2466b9d6d90855f0eb079","017d7ca8e0394b91aaadc9574df2202c",22852678,1,-5,0,717,198,193,-5
"017d7ca8e0394b91aaadc9574df2202c","54e8e9f0ea3e45c4bf3b8ac799ee31b1",22852678,1,8,0,718,193,200,7
"54e8e9f0ea3e45c4bf3b8ac799ee31b1","54e8e9f0ea3e45c4bf3b8ac799ee31b1",22852678,1,0,1,719,200,200,0
"54e8e9f0ea3e45c4bf3b8ac799ee31b1","c614a00911be4877a075f19315530fb0",22852678,1,1,0,720,200,201,1
"c614a00911be4877a075f19315530fb0","c614a00911be4877a075f19315530fb0",22852678,6,0,1,721,201,201,0
"c614a00911be4877a075f19315530fb0","a6c21bd8b95249c7972820a7a7d76aff",22852678,1,1,0,727,201,202,1
"a6c21bd8b95249c7972820a7a7d76aff","a6c21bd8b95249c7972820a7a7d76aff",22852678,1,0,1,728,202,202,0
"a6c21bd8b95249c7972820a7a7d76aff","bb329d880ab54120adaf203a693bb203",22852678,1,1,0,729,202,203,1
"bb329d880ab54120adaf203a693bb203","bb329d880ab54120adaf203a693bb203",22852678,1,0,1,730,203,203,0
"bb329d880ab54120adaf203a693bb203","f9170dd6bc6442b4acd832747609b09a",22852678,1,-4,0,731,203,199,-4
"f9170dd6bc6442b4acd832747609b09a","334c2344009840079b1d0e1b7ce3d5a7",22852678,1,7,0,732,199,205,6
"334c2344009840079b1d0e1b7ce3d5a7","334c2344009840079b1d0e1b7ce3d5a7",22852678,1,0,1,733,205,205,0
"334c2344009840079b1d0e1b7ce3d5a7","d7f13c8d63ec4e2aa673fbb9cf9c6933",22852678,1,3,0,734,205,206,1
"c8e371568a0c4391b25796ae4e91952e","b9e80f77c3a44349863b19875725c384",22852678,1,27,0,736,186,207,21
"b9e80f77c3a44349863b19875725c384","7108f0e4c2584f1f9c471689ae4c885c",22852678,2,1,0,737,207,208,1
"7108f0e4c2584f1f9c471689ae4c885c","b9e80f77c3a44349863b19875725c384",22852678,1,-1,0,738,208,207,-1
"b9e80f77c3a44349863b19875725c384","b9e80f77c3a44349863b19875725c384",22852678,18,0,1,739,207,207,0
"7108f0e4c2584f1f9c471689ae4c885c","7108f0e4c2584f1f9c471689ae4c885c",22852678,10,0,1,758,208,208,0
"7108f0e4c2584f1f9c471689ae4c885c","09400e101c5d4b439cf9a26b03aae558",22852678,1,3,0,768,208,210,2
"09400e101c5d4b439cf9a26b03aae558","d7f13c8d63ec4e2aa673fbb9cf9c6933",22852678,1,-5,0,769,210,206,-4
"d7f13c8d63ec4e2aa673fbb9cf9c6933","09400e101c5d4b439cf9a26b03aae558",22852678,1,5,0,770,206,210,4
"09400e101c5d4b439cf9a26b03aae558","09400e101c5d4b439cf9a26b03aae558",22852678,1,0,1,771,210,210,0
"09400e101c5d4b439cf9a26b03aae558","a88efa7e50ce47159810ab553afa6d3a",22852678,1,2,0,772,210,212,2
"a88efa7e50ce47159810ab553afa6d3a","a88efa7e50ce47159810ab553afa6d3a",22852678,2,0,1,773,212,212,0
"a88efa7e50ce47159810ab553afa6d3a","be502a7a43c44bf7b682698de79d9369",22852678,1,3,0,775,212,214,2
"f7fb1952f56b4189b86a9f8b7862d2b8","a875096404ef4a9984b62d74cda916f9",22852678,1,-7,0,777,215,209,-6
"a875096404ef4a9984b62d74cda916f9","be502a7a43c44bf7b682698de79d9369",22852678,1,6,0,778,209,214,5
"f7fb1952f56b4189b86a9f8b7862d2b8","f7fb1952f56b4189b86a9f8b7862d2b8",22852678,22,0,1,780,215,215,0
"363837c182e04711840d896ae1e0339c","363837c182e04711840d896ae1e0339c",22852678,14,0,1,807,218,218,0
"363837c182e04711840d896ae1e0339c","01b2051f8941460d89945e3b02d1ce78",22852678,1,-1,0,821,218,217,-1
"01b2051f8941460d89945e3b02d1ce78","91125ca626c5470eb145501f8c37f8db",22852678,1,4,0,822,217,220,3
"91125ca626c5470eb145501f8c37f8db","91125ca626c5470eb145501f8c37f8db",22852678,1,0,1,823,220,220,0
"91125ca626c5470eb145501f8c37f8db","1c6721b1f63f4d30ba7746ea8af02a52",22852678,1,3,0,824,220,221,1
"1c6721b1f63f4d30ba7746ea8af02a52","d7f13c8d63ec4e2aa673fbb9cf9c6933",22852678,1,-21,0,825,221,206,-15
"d7f13c8d63ec4e2aa673fbb9cf9c6933","77ecef8eff6b4a2caea7707669bf7475",22852678,1,22,0,826,206,222,16
"77ecef8eff6b4a2caea7707669bf7475","77ecef8eff6b4a2caea7707669bf7475",22852678,12,0,1,827,222,222,0
"77ecef8eff6b4a2caea7707669bf7475","d03cb855c70044cf8c35d9ec0de696e3",22852678,1,3,0,839,222,224,2
"d03cb855c70044cf8c35d9ec0de696e3","1c6721b1f63f4d30ba7746ea8af02a52",22852678,1,-4,0,840,224,221,-3
"1c6721b1f63f4d30ba7746ea8af02a52","8b9ae98743bd4d4a8a87dff1c1244211",22852678,1,7,0,841,221,227,6
"8b9ae98743bd4d4a8a87dff1c1244211","d03cb855c70044cf8c35d9ec0de696e3",22852678,1,-3,0,842,227,224,-3
"d03cb855c70044cf8c35d9ec0de696e3","a49a937d6896486d9a5396654abcf2e1",22852678,1,2,0,843,224,226,2
"a49a937d6896486d9a5396654abcf2e1","a49a937d6896486d9a5396654abcf2e1",22852678,1,0,1,844,226,226,0
"a49a937d6896486d9a5396654abcf2e1","8b9ae98743bd4d4a8a87dff1c1244211",22852678,1,1,0,845,226,227,1
"8b9ae98743bd4d4a8a87dff1c1244211","8b9ae98743bd4d4a8a87dff1c1244211",22852678,31,0,1,846,227,227,0
"8b9ae98743bd4d4a8a87dff1c1244211","2ab1535aac1346ba8801535bf729ef37",22852678,1,3,0,877,227,229,2
"2ab1535aac1346ba8801535bf729ef37","f7906d6f59b9489a91d2ef40db5a474d",22852678,1,-7,0,878,229,223,-6
"f7906d6f59b9489a91d2ef40db5a474d","2ab1535aac1346ba8801535bf729ef37",22852678,1,7,0,879,223,229,6
"2ab1535aac1346ba8801535bf729ef37","a4f40fb48a8542c8949bae1f002cd9bc",22852678,1,2,0,880,229,231,2
"a4f40fb48a8542c8949bae1f002cd9bc","a4f40fb48a8542c8949bae1f002cd9bc",22852678,2,0,1,881,231,231,0
"a4f40fb48a8542c8949bae1f002cd9bc","8972c23e32044edb8a78fa1eed4e5947",22852678,1,1,0,883,231,232,1
"8972c23e32044edb8a78fa1eed4e5947","8972c23e32044edb8a78fa1eed4e5947",22852678,1,0,1,884,232,232,0
"8972c23e32044edb8a78fa1eed4e5947","92feb4a40f8344d38b6f722e42a53295",22852678,1,1,0,885,232,233,1
"92feb4a40f8344d38b6f722e42a53295","92feb4a40f8344d38b6f722e42a53295",22852678,2,0,1,886,233,233,0
"92feb4a40f8344d38b6f722e42a53295","5152833676bf4c6cb317060be10f68db",22852678,1,-5,0,888,233,228,-5
"5152833676bf4c6cb317060be10f68db","ca3e28f290354c08aefe5b0f769604e6",22852678,1,8,0,889,228,235,7
"ca3e28f290354c08aefe5b0f769604e6","ca3e28f290354c08aefe5b0f769604e6",22852678,4,0,1,890,235,235,0
"ca3e28f290354c08aefe5b0f769604e6","79a35eea833e4c2c9d22fc53c3c6445c",22852678,1,1,0,894,235,236,1
"79a35eea833e4c2c9d22fc53c3c6445c","79a35eea833e4c2c9d22fc53c3c6445c",22852678,4,0,1,895,236,236,0
"79a35eea833e4c2c9d22fc53c3c6445c","cab89fa5c3ed45a5aa550fc0352d6a42",22852678,1,2,0,899,236,238,2
"cab89fa5c3ed45a5aa550fc0352d6a42","66d4fad4f1cf4b46be0750a99ad7a35a",22852678,1,1,0,901,238,239,1
"66d4fad4f1cf4b46be0750a99ad7a35a","66d4fad4f1cf4b46be0750a99ad7a35a",22852678,1,0,1,902,239,239,0
"66d4fad4f1cf4b46be0750a99ad7a35a","0b04c8e2f86d48c7aeb7e225819cd32b",22852678,1,-5,0,903,239,234,-5
"0b04c8e2f86d48c7aeb7e225819cd32b","f53da5fd9bfe412da4b80d4742563b6c",22852678,1,8,0,904,234,241,7
"f53da5fd9bfe412da4b80d4742563b6c","f53da5fd9bfe412da4b80d4742563b6c",22852678,1,0,1,905,241,241,0
"f53da5fd9bfe412da4b80d4742563b6c","2ae94c0cea4d480a9d5dca8fb1d7b542",22852678,1,3,0,906,241,242,1
"2ae94c0cea4d480a9d5dca8fb1d7b542","1c6721b1f63f4d30ba7746ea8af02a52",22852678,1,-27,0,907,242,221,-21
"1c6721b1f63f4d30ba7746ea8af02a52","1ebf23f9d994469a85206e4c7b1bf5f5",22852678,1,30,0,908,221,245,24
"1ebf23f9d994469a85206e4c7b1bf5f5","0c7262dff33c4087bc660ccf40f92f9c",22852678,1,-100,0,909,245,169,-76
"1ebf23f9d994469a85206e4c7b1bf5f5","1ebf23f9d994469a85206e4c7b1bf5f5",22852678,23,0,1,913,245,245,0
"1ebf23f9d994469a85206e4c7b1bf5f5","85ae675b83e8422da842cfd25596af99",22852678,1,1,0,936,245,246,1
"85ae675b83e8422da842cfd25596af99","85ae675b83e8422da842cfd25596af99",22852678,1,0,1,937,246,246,0
"85ae675b83e8422da842cfd25596af99","fa235f0f364d47e4ae1c87f47bf8e6ba",22852678,1,8,0,938,246,252,6
"2ae94c0cea4d480a9d5dca8fb1d7b542","fa235f0f364d47e4ae1c87f47bf8e6ba",22852678,1,12,0,940,242,252,10
"fa235f0f364d47e4ae1c87f47bf8e6ba","fa235f0f364d47e4ae1c87f47bf8e6ba",22852678,1,0,1,941,252,252,0
"79f7845465cc4ed19d8e4f1429541be0","6e83e23f56544a19b94067c1c558d9c0",22852678,1,-8,0,945,254,247,-7
"00f61990949545828dd12f1303d47504","00f61990949545828dd12f1303d47504",22852678,1,0,1,947,256,256,0
"00f61990949545828dd12f1303d47504","ead7bb4b64e247d2ae632ab8a296b091",22852678,1,2,0,948,256,258,2
"ead7bb4b64e247d2ae632ab8a296b091","ead7bb4b64e247d2ae632ab8a296b091",22852678,2,0,1,949,258,258,0
"ead7bb4b64e247d2ae632ab8a296b091","41b0048dde734bb280bac6116baa8e27",22852678,1,1,0,951,258,259,1
"41b0048dde734bb280bac6116baa8e27","41b0048dde734bb280bac6116baa8e27",22852678,2,0,1,952,259,259,0
"41b0048dde734bb280bac6116baa8e27","b41c5a094a604ee0915327da5cc0beb7",22852678,1,1,0,954,259,260,1
"b41c5a094a604ee0915327da5cc0beb7","b41c5a094a604ee0915327da5cc0beb7",22852678,2,0,1,955,260,260,0
"b41c5a094a604ee0915327da5cc0beb7","d546341988904f069cfa86b21457d9d9",22852678,1,-10,0,957,260,251,-9
"d546341988904f069cfa86b21457d9d9","28c171777c52431ab6b925073bd63d46",22852678,1,15,0,958,251,264,13
"d989ebcfc12a4b669f0100dc1aa14f1e","c6fd49b485cc4874b0bbdd9c6171e09c",22852678,1,15,0,971,255,268,13
"c6fd49b485cc4874b0bbdd9c6171e09c","c6fd49b485cc4874b0bbdd9c6171e09c",22852678,3,0,1,972,268,268,0
"c6fd49b485cc4874b0bbdd9c6171e09c","44240778a97c4af0937817499b75707b",22852678,1,1,0,975,268,269,1
"44240778a97c4af0937817499b75707b","44240778a97c4af0937817499b75707b",22852678,2,0,1,976,269,269,0
"44240778a97c4af0937817499b75707b","7aa76d3e993840d8805f097cbdbcd44b",22852678,1,-9,0,978,269,261,-8
"7aa76d3e993840d8805f097cbdbcd44b","865a4d3b43374da7944dc7d397f566d9",22852678,1,12,0,979,261,271,10
"865a4d3b43374da7944dc7d397f566d9","865a4d3b43374da7944dc7d397f566d9",22852678,1,0,1,980,271,271,0
"865a4d3b43374da7944dc7d397f566d9","2ae94c0cea4d480a9d5dca8fb1d7b542",22852678,1,-35,0,981,271,242,-29
"2ae94c0cea4d480a9d5dca8fb1d7b542","0d987bed3ffa4ed0b9a2e62e97b7b30f",22852678,1,38,0,982,242,272,30
"0d987bed3ffa4ed0b9a2e62e97b7b30f","d7f13c8d63ec4e2aa673fbb9cf9c6933",22852678,1,-86,0,994,272,206,-66
"d7f13c8d63ec4e2aa673fbb9cf9c6933","ec341f459285443b8361f7f15638ff08",22852678,1,9,0,995,206,213,7
"ec341f459285443b8361f7f15638ff08","be502a7a43c44bf7b682698de79d9369",22852678,1,1,0,996,213,214,1
"363837c182e04711840d896ae1e0339c","be502a7a43c44bf7b682698de79d9369",22852678,3,-5,0,1000,218,214,-4
"be502a7a43c44bf7b682698de79d9369","01b2051f8941460d89945e3b02d1ce78",22852678,2,4,0,1001,214,217,3
"01b2051f8941460d89945e3b02d1ce78","f7fb1952f56b4189b86a9f8b7862d2b8",22852678,2,-3,0,1002,217,215,-2
"f7fb1952f56b4189b86a9f8b7862d2b8","ec341f459285443b8361f7f15638ff08",22852678,2,-2,0,1003,215,213,-2
"ec341f459285443b8361f7f15638ff08","363837c182e04711840d896ae1e0339c",22852678,5,6,0,1004,213,218,5
"f7fb1952f56b4189b86a9f8b7862d2b8","b860ee85d8bc4a2f97958cfb71be3533",22852678,2,1,0,1008,215,216,1
"b860ee85d8bc4a2f97958cfb71be3533","ec341f459285443b8361f7f15638ff08",22852678,3,-3,0,1009,216,213,-3
"be502a7a43c44bf7b682698de79d9369","f7fb1952f56b4189b86a9f8b7862d2b8",22852678,4,1,0,1012,214,215,1
"f7fb1952f56b4189b86a9f8b7862d2b8","01b2051f8941460d89945e3b02d1ce78",22852678,2,3,0,1013,215,217,2
"01b2051f8941460d89945e3b02d1ce78","b860ee85d8bc4a2f97958cfb71be3533",22852678,1,-2,0,1014,217,216,-1
"b860ee85d8bc4a2f97958cfb71be3533","b860ee85d8bc4a2f97958cfb71be3533",22852678,4,0,1,1015,216,216,0
"363837c182e04711840d896ae1e0339c","f7fb1952f56b4189b86a9f8b7862d2b8",22852678,1,-4,0,1019,218,215,-3
"01b2051f8941460d89945e3b02d1ce78","be502a7a43c44bf7b682698de79d9369",22852678,1,-4,0,1021,217,214,-3
"be502a7a43c44bf7b682698de79d9369","d7f13c8d63ec4e2aa673fbb9cf9c6933",22852678,1,-10,0,1022,214,206,-8
"d7f13c8d63ec4e2aa673fbb9cf9c6933","c8e371568a0c4391b25796ae4e91952e",22852678,2,-26,0,1023,206,186,-20
"c8e371568a0c4391b25796ae4e91952e","07b44a7a51e94c78b411c753fc39dab0",22852678,3,4,0,1024,186,189,3
"07b44a7a51e94c78b411c753fc39dab0","ab11d94c6c8948ea90b88f19d2cd502b",22852678,3,1,0,1025,189,190,1
"ab11d94c6c8948ea90b88f19d2cd502b","f992451ed6ad4e68bb9e68ad6be7c4be",22852678,3,2,0,1026,190,192,2
"f992451ed6ad4e68bb9e68ad6be7c4be","07b44a7a51e94c78b411c753fc39dab0",22852678,2,-3,0,1027,192,189,-3
"07b44a7a51e94c78b411c753fc39dab0","6cd2dcaac46847d4a0bc53f296d90375",22852678,2,6,0,1028,189,194,5
"6cd2dcaac46847d4a0bc53f296d90375","2d2580c9411c4972909db508d6956a58",22852678,2,2,0,1029,194,196,2
"2d2580c9411c4972909db508d6956a58","017d7ca8e0394b91aaadc9574df2202c",22852678,2,-3,0,1030,196,193,-3
"017d7ca8e0394b91aaadc9574df2202c","c8e371568a0c4391b25796ae4e91952e",22852678,4,-9,0,1031,193,186,-7
"c8e371568a0c4391b25796ae4e91952e","9afd71a5298d4333b6849dfce1b9422c",22852678,1,-236,0,1032,186,18,-168
"9afd71a5298d4333b6849dfce1b9422c","9afd71a5298d4333b6849dfce1b9422c",22852678,4,0,1,1033,18,18,0
"9afd71a5298d4333b6849dfce1b9422c","0d987bed3ffa4ed0b9a2e62e97b7b30f",22852678,1,348,0,1034,18,272,254
"0d987bed3ffa4ed0b9a2e62e97b7b30f","82ae07bc0c9b4570a41799290d1ef399",22852678,4,4,0,1035,272,275,3
"82ae07bc0c9b4570a41799290d1ef399","8959e6304a0348309a771e4d08d1b64a",22852678,1,-152,0,1036,275,163,-112
"8959e6304a0348309a771e4d08d1b64a","78adeee1fa2c4fe0bc73f7bca9fcee86",22852678,1,-4,0,1037,163,160,-3
"78adeee1fa2c4fe0bc73f7bca9fcee86","65202579580f4ad38d734b4ee39d22a8",22852678,4,5,0,1038,160,164,4
"65202579580f4ad38d734b4ee39d22a8","65202579580f4ad38d734b4ee39d22a8",22852678,74,0,1,1039,164,164,0
"65202579580f4ad38d734b4ee39d22a8","0d987bed3ffa4ed0b9a2e62e97b7b30f",22852678,1,147,0,1048,164,272,108
"0d987bed3ffa4ed0b9a2e62e97b7b30f","0d987bed3ffa4ed0b9a2e62e97b7b30f",22852678,3,0,1,1049,272,272,0
"82ae07bc0c9b4570a41799290d1ef399","0d987bed3ffa4ed0b9a2e62e97b7b30f",22852678,3,-4,0,1052,275,272,-3
"0d987bed3ffa4ed0b9a2e62e97b7b30f","bb5a47f5ea01454a8b79455422d3b9da",22852678,2,10,0,1057,272,280,8
"bb5a47f5ea01454a8b79455422d3b9da","bb5a47f5ea01454a8b79455422d3b9da",22852678,94,0,1,1058,280,280,0
"bb5a47f5ea01454a8b79455422d3b9da","82ae07bc0c9b4570a41799290d1ef399",22852678,3,-6,0,1060,280,275,-5
"82ae07bc0c9b4570a41799290d1ef399","bb5a47f5ea01454a8b79455422d3b9da",22852678,4,6,0,1061,275,280,5
"bb5a47f5ea01454a8b79455422d3b9da","bc5524e78a8544e2ae2fdc2f3462bbec",22852678,2,-1,0,1066,280,279,-1
"bc5524e78a8544e2ae2fdc2f3462bbec","82ae07bc0c9b4570a41799290d1ef399",22852678,1,-5,0,1067,279,275,-4
"bc5524e78a8544e2ae2fdc2f3462bbec","bb5a47f5ea01454a8b79455422d3b9da",22852678,2,1,0,1077,279,280,1
"bb5a47f5ea01454a8b79455422d3b9da","0d987bed3ffa4ed0b9a2e62e97b7b30f",22852678,2,-10,0,1113,280,272,-8
"0d987bed3ffa4ed0b9a2e62e97b7b30f","bc5524e78a8544e2ae2fdc2f3462bbec",22852678,1,9,0,1114,272,279,7
"bb5a47f5ea01454a8b79455422d3b9da","94cecc3f1e7d484b8e068e79241dfd73",22852678,1,3,0,1158,280,281,1
"94cecc3f1e7d484b8e068e79241dfd73","0d987bed3ffa4ed0b9a2e62e97b7b30f",22852678,1,-13,0,1159,281,272,-9
"0d987bed3ffa4ed0b9a2e62e97b7b30f","a37477c4e4c14169ad44b06b493007f6",22852678,1,15,0,1160,272,283,11
"a37477c4e4c14169ad44b06b493007f6","0c7262dff33c4087bc660ccf40f92f9c",22852678,2,-150,0,1161,283,169,-114
"0c7262dff33c4087bc660ccf40f92f9c","1c6721b1f63f4d30ba7746ea8af02a52",22852678,1,70,0,1162,169,221,52
"1c6721b1f63f4d30ba7746ea8af02a52","0b04c8e2f86d48c7aeb7e225819cd32b",22852678,1,16,0,1163,221,234,13
"0b04c8e2f86d48c7aeb7e225819cd32b","cab89fa5c3ed45a5aa550fc0352d6a42",22852678,1,4,0,1164,234,238,4
"cab89fa5c3ed45a5aa550fc0352d6a42","cab89fa5c3ed45a5aa550fc0352d6a42",22852678,2,0,1,1165,238,238,0
"cab89fa5c3ed45a5aa550fc0352d6a42","0b04c8e2f86d48c7aeb7e225819cd32b",22852678,1,-4,0,1166,238,234,-4
"0b04c8e2f86d48c7aeb7e225819cd32b","2ab1535aac1346ba8801535bf729ef37",22852678,1,-6,0,1167,234,229,-5
"2ab1535aac1346ba8801535bf729ef37","5152833676bf4c6cb317060be10f68db",22852678,1,-1,0,1168,229,228,-1
"5152833676bf4c6cb317060be10f68db","8f68228b1518449e9615cdafee41a2bd",22852678,1,10,0,1169,228,237,9
"8f68228b1518449e9615cdafee41a2bd","8f68228b1518449e9615cdafee41a2bd",22852678,1,0,1,1170,237,237,0
"8f68228b1518449e9615cdafee41a2bd","0b04c8e2f86d48c7aeb7e225819cd32b",22852678,1,-3,0,1171,237,234,-3
"0b04c8e2f86d48c7aeb7e225819cd32b","1c6721b1f63f4d30ba7746ea8af02a52",22852678,1,-16,0,1172,234,221,-13
"1c6721b1f63f4d30ba7746ea8af02a52","d546341988904f069cfa86b21457d9d9",22852678,1,38,0,1173,221,251,30
"d546341988904f069cfa86b21457d9d9","2ae94c0cea4d480a9d5dca8fb1d7b542",22852678,4,-11,0,1174,251,242,-9
"2ae94c0cea4d480a9d5dca8fb1d7b542","00f61990949545828dd12f1303d47504",22852678,4,17,0,1175,242,256,14
"00f61990949545828dd12f1303d47504","d546341988904f069cfa86b21457d9d9",22852678,3,-6,0,1176,256,251,-5
"d546341988904f069cfa86b21457d9d9","d989ebcfc12a4b669f0100dc1aa14f1e",22852678,1,5,0,1177,251,255,4
"d989ebcfc12a4b669f0100dc1aa14f1e","7aa76d3e993840d8805f097cbdbcd44b",22852678,2,7,0,1178,255,261,6
"7aa76d3e993840d8805f097cbdbcd44b","28c171777c52431ab6b925073bd63d46",22852678,1,3,0,1179,261,264,3
"28c171777c52431ab6b925073bd63d46","28c171777c52431ab6b925073bd63d46",22852678,11,0,1,1180,264,264,0
"28c171777c52431ab6b925073bd63d46","ac160db940cb49ae8579162b1d52bb5d",22852678,2,2,0,1184,264,266,2
"ac160db940cb49ae8579162b1d52bb5d","ac160db940cb49ae8579162b1d52bb5d",22852678,7,0,1,1185,266,266,0
"ac160db940cb49ae8579162b1d52bb5d","d989ebcfc12a4b669f0100dc1aa14f1e",22852678,2,-12,0,1189,266,255,-11
"7aa76d3e993840d8805f097cbdbcd44b","d989ebcfc12a4b669f0100dc1aa14f1e",22852678,1,-7,0,1191,261,255,-6
"d989ebcfc12a4b669f0100dc1aa14f1e","00f61990949545828dd12f1303d47504",22852678,1,1,0,1192,255,256,1
"00f61990949545828dd12f1303d47504","2ae94c0cea4d480a9d5dca8fb1d7b542",22852678,2,-17,0,1193,256,242,-14
"2ae94c0cea4d480a9d5dca8fb1d7b542","d546341988904f069cfa86b21457d9d9",22852678,1,11,0,1194,242,251,9
"d546341988904f069cfa86b21457d9d9","fa235f0f364d47e4ae1c87f47bf8e6ba",22852678,2,1,0,1198,251,252,1
"fa235f0f364d47e4ae1c87f47bf8e6ba","79f7845465cc4ed19d8e4f1429541be0",22852678,2,2,0,1199,252,254,2
"79f7845465cc4ed19d8e4f1429541be0","79f7845465cc4ed19d8e4f1429541be0",22852678,5,0,1,1200,254,254,0
"79f7845465cc4ed19d8e4f1429541be0","00f61990949545828dd12f1303d47504",22852678,1,3,0,1203,254,256,2
"00f61990949545828dd12f1303d47504","6e83e23f56544a19b94067c1c558d9c0",22852678,3,-11,0,1204,256,247,-9
"6e83e23f56544a19b94067c1c558d9c0","fa235f0f364d47e4ae1c87f47bf8e6ba",22852678,1,6,0,1205,247,252,5
"fa235f0f364d47e4ae1c87f47bf8e6ba","d546341988904f069cfa86b21457d9d9",22852678,3,-1,0,1206,252,251,-1
"d546341988904f069cfa86b21457d9d9","6e83e23f56544a19b94067c1c558d9c0",22852678,2,-5,0,1207,251,247,-4
"6e83e23f56544a19b94067c1c558d9c0","1ebf23f9d994469a85206e4c7b1bf5f5",22852678,1,-3,0,1208,247,245,-2
"1ebf23f9d994469a85206e4c7b1bf5f5","fa235f0f364d47e4ae1c87f47bf8e6ba",22852678,1,9,0,1209,245,252,7
"fa235f0f364d47e4ae1c87f47bf8e6ba","2ae94c0cea4d480a9d5dca8fb1d7b542",22852678,2,-12,0,1210,252,242,-10
"2ae94c0cea4d480a9d5dca8fb1d7b542","6e83e23f56544a19b94067c1c558d9c0",22852678,1,6,0,1211,242,247,5
"6e83e23f56544a19b94067c1c558d9c0","00f61990949545828dd12f1303d47504",22852678,4,11,0,1212,247,256,9
"00f61990949545828dd12f1303d47504","fa235f0f364d47e4ae1c87f47bf8e6ba",22852678,2,-5,0,1213,256,252,-4
"d546341988904f069cfa86b21457d9d9","00f61990949545828dd12f1303d47504",22852678,1,6,0,1215,251,256,5
"6e83e23f56544a19b94067c1c558d9c0","2ae94c0cea4d480a9d5dca8fb1d7b542",22852678,1,-6,0,1217,247,242,-5
"2ae94c0cea4d480a9d5dca8fb1d7b542","139b097acfca451689d80c9c6eebdf7b",22852678,1,-86,0,1218,242,178,-64
"139b097acfca451689d80c9c6eebdf7b","0c7262dff33c4087bc660ccf40f92f9c",22852678,8,-11,0,1219,178,169,-9
"0c7262dff33c4087bc660ccf40f92f9c","ea38cc0e6e6e41edbabf210220808bf9",22852678,3,12,0,1220,169,179,10
"ea38cc0e6e6e41edbabf210220808bf9","b87c552dd247427abe6ab5795b9c9d43",22852678,13,2,0,1221,179,181,2
"b87c552dd247427abe6ab5795b9c9d43","139b097acfca451689d80c9c6eebdf7b",22852678,11,-3,0,1222,181,178,-3
"139b097acfca451689d80c9c6eebdf7b","2024b4885bd14338a39b7b509acbbd02",22852678,5,5,0,1223,178,182,4
"2024b4885bd14338a39b7b509acbbd02","ea38cc0e6e6e41edbabf210220808bf9",22852678,3,-4,0,1224,182,179,-3
"b87c552dd247427abe6ab5795b9c9d43","0c7262dff33c4087bc660ccf40f92f9c",22852678,2,-14,0,1226,181,169,-12
"0c7262dff33c4087bc660ccf40f92f9c","d546341988904f069cfa86b21457d9d9",22852678,2,108,0,1227,169,251,82
"00f61990949545828dd12f1303d47504","0c7262dff33c4087bc660ccf40f92f9c",22852678,1,-114,0,1234,256,169,-87
"0c7262dff33c4087bc660ccf40f92f9c","07b44a7a51e94c78b411c753fc39dab0",22852678,1,27,0,1235,169,189,20
"07b44a7a51e94c78b411c753fc39dab0","c8e371568a0c4391b25796ae4e91952e",22852678,1,-4,0,1236,189,186,-3
"c8e371568a0c4391b25796ae4e91952e","ab11d94c6c8948ea90b88f19d2cd502b",22852678,2,5,0,1237,186,190,4
"f992451ed6ad4e68bb9e68ad6be7c4be","f992451ed6ad4e68bb9e68ad6be7c4be",22852678,2,0,1,1239,192,192,0
"f992451ed6ad4e68bb9e68ad6be7c4be","6cd2dcaac46847d4a0bc53f296d90375",22852678,1,3,0,1240,192,194,2
"6cd2dcaac46847d4a0bc53f296d90375","07b44a7a51e94c78b411c753fc39dab0",22852678,4,-6,0,1241,194,189,-5
"07b44a7a51e94c78b411c753fc39dab0","2d2580c9411c4972909db508d6956a58",22852678,1,8,0,1242,189,196,7
"2d2580c9411c4972909db508d6956a58","2d2580c9411c4972909db508d6956a58",22852678,4,0,1,1243,196,196,0
"017d7ca8e0394b91aaadc9574df2202c","6cd2dcaac46847d4a0bc53f296d90375",22852678,4,1,0,1246,193,194,1
"6cd2dcaac46847d4a0bc53f296d90375","f9170dd6bc6442b4acd832747609b09a",22852678,1,6,0,1247,194,199,5
"f9170dd6bc6442b4acd832747609b09a","c8e371568a0c4391b25796ae4e91952e",22852678,1,-16,0,1248,199,186,-13
"c8e371568a0c4391b25796ae4e91952e","fab84b4fab5940efb4ea868ef8d09396",22852678,1,130,0,1249,186,284,98
"fab84b4fab5940efb4ea868ef8d09396","fab84b4fab5940efb4ea868ef8d09396",22852678,2,0,1,1250,284,284,0
"fab84b4fab5940efb4ea868ef8d09396","4a29443515bb404cb8924e1c60a63b73",22852678,1,4,0,1252,284,285,1
"4a29443515bb404cb8924e1c60a63b73","208c9b2796c944db8dacaa96082520ea",22852678,2,3,0,1253,285,288,3
"208c9b2796c944db8dacaa96082520ea","4a29443515bb404cb8924e1c60a63b73",22852678,2,-3,0,1254,288,285,-3
"4a29443515bb404cb8924e1c60a63b73","a49d1bb4328949299686242fd0be5584",22852678,1,-364,0,1255,285,21,-264
"a49d1bb4328949299686242fd0be5584","b7719e26494940efa49512aedd0aac79",22852678,2,-2,0,1256,21,20,-1
"b7719e26494940efa49512aedd0aac79","d4f45188d3c84a02ba08454e6403a818",22852678,2,5,0,1257,20,24,4
"d4f45188d3c84a02ba08454e6403a818","a49d1bb4328949299686242fd0be5584",22852678,1,-3,0,1258,24,21,-3
"a49d1bb4328949299686242fd0be5584","d4c3b003e8274e429d2fa688d73fde6d",22852678,1,1,0,1259,21,22,1
"d4c3b003e8274e429d2fa688d73fde6d","b7719e26494940efa49512aedd0aac79",22852678,3,-3,0,1260,22,20,-2
"b7719e26494940efa49512aedd0aac79","139b097acfca451689d80c9c6eebdf7b",22852678,1,220,0,1261,20,178,158
"2024b4885bd14338a39b7b509acbbd02","2024b4885bd14338a39b7b509acbbd02",22852678,1,0,1,1267,182,182,0
"2024b4885bd14338a39b7b509acbbd02","cf4c280bad6a43e6b131d8385ef9ef3f",22852678,1,3,0,1268,182,184,2
"cf4c280bad6a43e6b131d8385ef9ef3f","ea38cc0e6e6e41edbabf210220808bf9",22852678,1,-7,0,1269,184,179,-5
"ea38cc0e6e6e41edbabf210220808bf9","b42cc17b7de840f181a704558d0bc845",22852678,1,-5,0,1270,179,175,-4
"b42cc17b7de840f181a704558d0bc845","b87c552dd247427abe6ab5795b9c9d43",22852678,1,7,0,1271,175,181,6
"139b097acfca451689d80c9c6eebdf7b","ea38cc0e6e6e41edbabf210220808bf9",22852678,6,1,0,1273,178,179,1
"b87c552dd247427abe6ab5795b9c9d43","362fcb0699a14845ab29b2340093e528",22852678,1,-8,0,1275,181,174,-7
"362fcb0699a14845ab29b2340093e528","139b097acfca451689d80c9c6eebdf7b",22852678,1,5,0,1276,174,178,4
"fa235f0f364d47e4ae1c87f47bf8e6ba","00f61990949545828dd12f1303d47504",22852678,1,5,0,1287,252,256,4
"6e83e23f56544a19b94067c1c558d9c0","0c7262dff33c4087bc660ccf40f92f9c",22852678,1,-103,0,1289,247,169,-78
"0c7262dff33c4087bc660ccf40f92f9c","4a29443515bb404cb8924e1c60a63b73",22852678,1,157,0,1290,169,285,116
"4a29443515bb404cb8924e1c60a63b73","4a29443515bb404cb8924e1c60a63b73",22852678,1,0,1,1291,285,285,0
"208c9b2796c944db8dacaa96082520ea","208c9b2796c944db8dacaa96082520ea",22852678,1,0,1,1293,288,288,0
"4a29443515bb404cb8924e1c60a63b73","7669a956527947d0add87455277e80b4",22852678,1,7,0,1295,285,291,6
"7669a956527947d0add87455277e80b4","7669a956527947d0add87455277e80b4",22852678,1,0,1,1296,291,291,0
"7669a956527947d0add87455277e80b4","6a9a3b5bde4a48daa896fe8c06eca56f",22852678,1,-2,0,1297,291,289,-2
"6a9a3b5bde4a48daa896fe8c06eca56f","869e967078f04da18dd0b0b9389a7424",22852678,1,5,0,1298,289,293,4
"869e967078f04da18dd0b0b9389a7424","869e967078f04da18dd0b0b9389a7424",22852678,2,0,1,1299,293,293,0
"869e967078f04da18dd0b0b9389a7424","51ab6291537748fab90d519aa09889d6",22852678,1,2,0,1301,293,295,2
"51ab6291537748fab90d519aa09889d6","51ab6291537748fab90d519aa09889d6",22852678,5,0,1,1302,295,295,0
"51ab6291537748fab90d519aa09889d6","34a6e49023fc4465bd5ca604330bbd1c",22852678,1,-3,0,1307,295,292,-3
"34a6e49023fc4465bd5ca604330bbd1c","ba0e59461bfb4a44b7b1c28a01f8d3b3",22852678,1,9,0,1308,292,299,7
"ba0e59461bfb4a44b7b1c28a01f8d3b3","21592f2a9e9c4b2f8c66ec5dbcbf6a2b",22852678,1,-4,0,1309,299,296,-3
"21592f2a9e9c4b2f8c66ec5dbcbf6a2b","ba0e59461bfb4a44b7b1c28a01f8d3b3",22852678,1,4,0,1310,296,299,3
"ba0e59461bfb4a44b7b1c28a01f8d3b3","0e0b36e731a645e7b1b8a88f5031ca38",22852678,1,2,0,1311,299,301,2
"0e0b36e731a645e7b1b8a88f5031ca38","0e0b36e731a645e7b1b8a88f5031ca38",22852678,8,0,1,1312,301,301,0
"0e0b36e731a645e7b1b8a88f5031ca38","a66a144637284c21afc6de17fea4bfb8",22852678,1,1,0,1320,301,302,1
"a66a144637284c21afc6de17fea4bfb8","a66a144637284c21afc6de17fea4bfb8",22852678,2,0,1,1321,302,302,0
"a66a144637284c21afc6de17fea4bfb8","7646a919d7e64fa990bca9b024ff089d",22852678,1,-4,0,1323,302,298,-4
"7646a919d7e64fa990bca9b024ff089d","e390b575229748ea8aac9364efe2bf00",22852678,1,7,0,1324,298,304,6
"e390b575229748ea8aac9364efe2bf00","e390b575229748ea8aac9364efe2bf00",22852678,1,0,1,1325,304,304,0
"e390b575229748ea8aac9364efe2bf00","3434c10e561d488a914e0f7d71907abd",22852678,1,3,0,1326,304,305,1
"3434c10e561d488a914e0f7d71907abd","4a29443515bb404cb8924e1c60a63b73",22852678,1,-27,0,1327,305,285,-20
"4a29443515bb404cb8924e1c60a63b73","53e7e900392747ccad52e711ab0f80d8",22852678,1,29,0,1328,285,307,22
"53e7e900392747ccad52e711ab0f80d8","53e7e900392747ccad52e711ab0f80d8",22852678,1,0,1,1329,307,307,0
"53e7e900392747ccad52e711ab0f80d8","3434c10e561d488a914e0f7d71907abd",22852678,4,-2,0,1330,307,305,-2
"3434c10e561d488a914e0f7d71907abd","130acc2aeb0448fdbb2de63bc5cebe5b",22852678,5,5,0,1331,305,309,4
"130acc2aeb0448fdbb2de63bc5cebe5b","9c062b3251034ebe90f5054e2a3b5120",22852678,1,2,0,1332,309,311,2
"9c062b3251034ebe90f5054e2a3b5120","9c062b3251034ebe90f5054e2a3b5120",22852678,5,0,1,1333,311,311,0
"9c062b3251034ebe90f5054e2a3b5120","ea859f8207e44537889daeaba13ac2e8",22852678,1,1,0,1338,311,312,1
"ea859f8207e44537889daeaba13ac2e8","ea859f8207e44537889daeaba13ac2e8",22852678,1,0,1,1339,312,312,0
"ea859f8207e44537889daeaba13ac2e8","56d94971a7a94257aa330183a8ebd0ea",22852678,1,1,0,1340,312,313,1
"56d94971a7a94257aa330183a8ebd0ea","56d94971a7a94257aa330183a8ebd0ea",22852678,1,0,1,1341,313,313,0
"56d94971a7a94257aa330183a8ebd0ea","141c0df6cd1946539aadd1c9b7068cd4",22852678,1,-5,0,1342,313,308,-5
"141c0df6cd1946539aadd1c9b7068cd4","13255e63e0aa4abf85e5211bf613d43e",22852678,1,10,0,1343,308,317,9
"13255e63e0aa4abf85e5211bf613d43e","13255e63e0aa4abf85e5211bf613d43e",22852678,1,0,1,1344,317,317,0
"13255e63e0aa4abf85e5211bf613d43e","86c27d40179e419c8e9d150fb6afa5d0",22852678,1,3,0,1345,317,319,2
"86c27d40179e419c8e9d150fb6afa5d0","0c787d16c9504873b1a4d903cec09948",22852678,1,-6,0,1346,319,314,-5
"0c787d16c9504873b1a4d903cec09948","86c27d40179e419c8e9d150fb6afa5d0",22852678,1,6,0,1347,314,319,5
"86c27d40179e419c8e9d150fb6afa5d0","8d7e0b55cf9849cda222a0f2440cec55",22852678,1,-1,0,1348,319,318,-1
"8d7e0b55cf9849cda222a0f2440cec55","24f1363179ad4aaa965484a78471912b",22852678,1,6,0,1349,318,323,5
"24f1363179ad4aaa965484a78471912b","47edbb64109243e6b0f8f64cdef90c6c",22852678,1,3,0,1350,323,326,3
"47edbb64109243e6b0f8f64cdef90c6c","24f1363179ad4aaa965484a78471912b",22852678,1,-3,0,1351,326,323,-3
"24f1363179ad4aaa965484a78471912b","3628bdce1dd2429ba924d2d4d09448d2",22852678,1,-1,0,1352,323,322,-1
"3628bdce1dd2429ba924d2d4d09448d2","56b3fd1a212a4764be39d979fde3326e",22852678,1,7,0,1353,322,328,6
"56b3fd1a212a4764be39d979fde3326e","56b3fd1a212a4764be39d979fde3326e",22852678,1,0,1,1354,328,328,0
"56b3fd1a212a4764be39d979fde3326e","3434c10e561d488a914e0f7d71907abd",22852678,1,-28,0,1355,328,305,-23
"3434c10e561d488a914e0f7d71907abd","0c4079457ede49e3aeb5e86ed84bdf35",22852678,1,31,0,1356,305,329,24
"0c4079457ede49e3aeb5e86ed84bdf35","38aea304b4fa46e1b29bb72f5cea4c93",22852678,3,2,0,1357,329,331,2
"38aea304b4fa46e1b29bb72f5cea4c93","38aea304b4fa46e1b29bb72f5cea4c93",22852678,1,0,1,1358,331,331,0
"38aea304b4fa46e1b29bb72f5cea4c93","e36d261332f14e79bb4b467aceaeb9b5",22852678,1,2,0,1359,331,333,2
"e36d261332f14e79bb4b467aceaeb9b5","e36d261332f14e79bb4b467aceaeb9b5",22852678,1,0,1,1360,333,333,0
"e36d261332f14e79bb4b467aceaeb9b5","c7e89b9d04744d2eab742fc24e3ef1ae",22852678,1,1,0,1361,333,334,1
"c7e89b9d04744d2eab742fc24e3ef1ae","c7e89b9d04744d2eab742fc24e3ef1ae",22852678,2,0,1,1362,334,334,0
"c7e89b9d04744d2eab742fc24e3ef1ae","fe49f8054b374a0ea4bb266ed135ff62",22852678,1,1,0,1364,334,335,1
"fe49f8054b374a0ea4bb266ed135ff62","fe49f8054b374a0ea4bb266ed135ff62",22852678,2,0,1,1365,335,335,0
"fe49f8054b374a0ea4bb266ed135ff62","d0a8f74af98642fe8360d22c42e45117",22852678,1,1,0,1367,335,336,1
"d0a8f74af98642fe8360d22c42e45117","d0a8f74af98642fe8360d22c42e45117",22852678,2,0,1,1368,336,336,0
"d0a8f74af98642fe8360d22c42e45117","0c4079457ede49e3aeb5e86ed84bdf35",22852678,1,-7,0,1370,336,329,-7
"0c4079457ede49e3aeb5e86ed84bdf35","a7c6339ca1da4368a18d471f0519f877",22852678,1,11,0,1371,329,339,10
"a7c6339ca1da4368a18d471f0519f877","a7c6339ca1da4368a18d471f0519f877",22852678,1,0,1,1372,339,339,0
"a7c6339ca1da4368a18d471f0519f877","b8b9418ab322418d9db9b40d96af873a",22852678,1,-2,0,1373,339,337,-2
"b8b9418ab322418d9db9b40d96af873a","bbc5139ca9024389a94db3a6f47dcff6",22852678,1,5,0,1374,337,341,4
"bbc5139ca9024389a94db3a6f47dcff6","bbc5139ca9024389a94db3a6f47dcff6",22852678,1,0,1,1375,341,341,0
"bbc5139ca9024389a94db3a6f47dcff6","4ee6ca9019ab4a1ab323f98094a9bd77",22852678,1,2,0,1376,341,343,2
"4ee6ca9019ab4a1ab323f98094a9bd77","4ee6ca9019ab4a1ab323f98094a9bd77",22852678,2,0,1,1377,343,343,0
"4ee6ca9019ab4a1ab323f98094a9bd77","b37947176785476f8b29d49a851366dc",22852678,1,1,0,1379,343,344,1
"b37947176785476f8b29d49a851366dc","b37947176785476f8b29d49a851366dc",22852678,2,0,1,1380,344,344,0
"b37947176785476f8b29d49a851366dc","fcea5b10d5a14a3b9324ffece8f6e1e5",22852678,1,1,0,1382,344,345,1
"fcea5b10d5a14a3b9324ffece8f6e1e5","fcea5b10d5a14a3b9324ffece8f6e1e5",22852678,2,0,1,1383,345,345,0
"fcea5b10d5a14a3b9324ffece8f6e1e5","c2490bc612d146edbe786556fab3651b",22852678,1,-5,0,1385,345,340,-5
"c2490bc612d146edbe786556fab3651b","6ac8bb048b854999a47edb35fe627f11",22852678,1,8,0,1386,340,347,7
"6ac8bb048b854999a47edb35fe627f11","6ac8bb048b854999a47edb35fe627f11",22852678,1,0,1,1387,347,347,0
"6ac8bb048b854999a47edb35fe627f11","30ead9794d4847abaf222ca966cc8630",22852678,1,3,0,1388,347,348,1
"30ead9794d4847abaf222ca966cc8630","0c4079457ede49e3aeb5e86ed84bdf35",22852678,1,-24,0,1389,348,329,-19
"0c4079457ede49e3aeb5e86ed84bdf35","897b7f51242c44aab2205c72fdcbf4cd",22852678,1,28,0,1390,329,352,23
"897b7f51242c44aab2205c72fdcbf4cd","c20993c944444fe085345591a8bd837e",22852678,4,-1,0,1391,352,351,-1
"c20993c944444fe085345591a8bd837e","eff0de7f2dbb42dfa1a2e686efab5b6d",22852678,2,3,0,1392,351,354,3
"eff0de7f2dbb42dfa1a2e686efab5b6d","09b9678ddc3d452ea4a3d46e15826065",22852678,2,-1,0,1393,354,353,-1
"09b9678ddc3d452ea4a3d46e15826065","4a29443515bb404cb8924e1c60a63b73",22852678,1,-87,0,1394,353,285,-68
"4a29443515bb404cb8924e1c60a63b73","30ead9794d4847abaf222ca966cc8630",22852678,1,82,0,1395,285,348,63
"30ead9794d4847abaf222ca966cc8630","30ead9794d4847abaf222ca966cc8630",22852678,1,0,1,1396,348,348,0
"30ead9794d4847abaf222ca966cc8630","09b9678ddc3d452ea4a3d46e15826065",22852678,1,5,0,1397,348,353,5
"09b9678ddc3d452ea4a3d46e15826065","eff0de7f2dbb42dfa1a2e686efab5b6d",22852678,3,1,0,1398,353,354,1
"eff0de7f2dbb42dfa1a2e686efab5b6d","897b7f51242c44aab2205c72fdcbf4cd",22852678,1,-2,0,1399,354,352,-2
"c20993c944444fe085345591a8bd837e","c20993c944444fe085345591a8bd837e",22852678,5,0,1,1401,351,351,0
"c20993c944444fe085345591a8bd837e","897b7f51242c44aab2205c72fdcbf4cd",22852678,2,1,0,1405,351,352,1
"897b7f51242c44aab2205c72fdcbf4cd","897b7f51242c44aab2205c72fdcbf4cd",22852678,4,0,1,1406,352,352,0
"897b7f51242c44aab2205c72fdcbf4cd","09b9678ddc3d452ea4a3d46e15826065",22852678,1,1,0,1409,352,353,1
"09b9678ddc3d452ea4a3d46e15826065","09b9678ddc3d452ea4a3d46e15826065",22852678,4,0,1,1410,353,353,0
"eff0de7f2dbb42dfa1a2e686efab5b6d","eff0de7f2dbb42dfa1a2e686efab5b6d",22852678,4,0,1,1414,354,354,0
"eff0de7f2dbb42dfa1a2e686efab5b6d","2fe14166dc9642c3bc666b86a57f943d",22852678,2,4,0,1417,354,357,3
"2fe14166dc9642c3bc666b86a57f943d","30ead9794d4847abaf222ca966cc8630",22852678,2,-10,0,1418,357,348,-9
"30ead9794d4847abaf222ca966cc8630","2fe14166dc9642c3bc666b86a57f943d",22852678,2,10,0,1419,348,357,9
"2fe14166dc9642c3bc666b86a57f943d","44421dd1e13a47a388c4a19834b744c7",22852678,1,2,0,1420,357,359,2
"44421dd1e13a47a388c4a19834b744c7","44421dd1e13a47a388c4a19834b744c7",22852678,2,0,1,1421,359,359,0
"44421dd1e13a47a388c4a19834b744c7","cb5fc7ef85d547c4be1a7439d0bf6052",22852678,1,1,0,1423,359,360,1
"cb5fc7ef85d547c4be1a7439d0bf6052","cb5fc7ef85d547c4be1a7439d0bf6052",22852678,5,0,1,1424,360,360,0
"cb5fc7ef85d547c4be1a7439d0bf6052","0a8f150a4cf747acbde62f4721823da3",22852678,1,1,0,1429,360,361,1
"0a8f150a4cf747acbde62f4721823da3","0a8f150a4cf747acbde62f4721823da3",22852678,2,0,1,1430,361,361,0
"0a8f150a4cf747acbde62f4721823da3","ab8fdad974ae471f9f24c3f9dd04462e",22852678,1,1,0,1432,361,362,1
"ab8fdad974ae471f9f24c3f9dd04462e","ab8fdad974ae471f9f24c3f9dd04462e",22852678,2,0,1,1433,362,362,0
"ab8fdad974ae471f9f24c3f9dd04462e","1ba8fef685d74a8194b9db252eb704fb",22852678,1,-7,0,1435,362,355,-7
"1ba8fef685d74a8194b9db252eb704fb","52580888dadb4fe3baa795683ea227bd",22852678,1,10,0,1436,355,364,9
"52580888dadb4fe3baa795683ea227bd","52580888dadb4fe3baa795683ea227bd",22852678,1,0,1,1437,364,364,0
"52580888dadb4fe3baa795683ea227bd","f00179e251a045b39c3f7a54f9aa4acc",22852678,1,-1,0,1438,364,363,-1
"f00179e251a045b39c3f7a54f9aa4acc","492a3bc6a1254f23a7998587961b22a4",22852678,1,4,0,1439,363,366,3
"492a3bc6a1254f23a7998587961b22a4","492a3bc6a1254f23a7998587961b22a4",22852678,1,0,1,1440,366,366,0
"492a3bc6a1254f23a7998587961b22a4","072a190fd302456290895f9f04d6940a",22852678,1,-1,0,1441,366,365,-1
"072a190fd302456290895f9f04d6940a","09b9678ddc3d452ea4a3d46e15826065",22852678,1,-15,0,1442,365,353,-12
"09b9678ddc3d452ea4a3d46e15826065","c76574d21bc14aeea7ecd0b027f39858",22852678,1,18,0,1443,353,367,14
"c76574d21bc14aeea7ecd0b027f39858","897b7f51242c44aab2205c72fdcbf4cd",22852678,1,-19,0,1444,367,352,-15
"30ead9794d4847abaf222ca966cc8630","1ba8fef685d74a8194b9db252eb704fb",22852678,1,8,0,1457,348,355,7
"1ba8fef685d74a8194b9db252eb704fb","cfa457d1743848e4bb5e4beced6448ed",22852678,1,17,0,1458,355,369,14
"cfa457d1743848e4bb5e4beced6448ed","cfa457d1743848e4bb5e4beced6448ed",22852678,1,0,1,1459,369,369,0
"cfa457d1743848e4bb5e4beced6448ed","30ead9794d4847abaf222ca966cc8630",22852678,1,-25,0,1460,369,348,-21
"30ead9794d4847abaf222ca966cc8630","b71bac264efb4abd97015447bd490db6",22852678,1,28,0,1461,348,370,22
"b71bac264efb4abd97015447bd490db6","4a29443515bb404cb8924e1c60a63b73",22852678,2,-110,0,1462,370,285,-85
"4a29443515bb404cb8924e1c60a63b73","1ba8fef685d74a8194b9db252eb704fb",22852678,1,90,0,1463,285,355,70
"1ba8fef685d74a8194b9db252eb704fb","30ead9794d4847abaf222ca966cc8630",22852678,1,-8,0,1464,355,348,-7
"2fe14166dc9642c3bc666b86a57f943d","4a29443515bb404cb8924e1c60a63b73",22852678,1,-92,0,1466,357,285,-72
"4a29443515bb404cb8924e1c60a63b73","1b4550d0dab04078b3bf08a655345bdc",22852678,1,114,0,1467,285,373,88
"1b4550d0dab04078b3bf08a655345bdc","b71bac264efb4abd97015447bd490db6",22852678,2,-4,0,1468,373,370,-3
"b71bac264efb4abd97015447bd490db6","8d448d625b024c82a5eb240bbd7431d6",22852678,4,5,0,1469,370,374,4
"8d448d625b024c82a5eb240bbd7431d6","8d448d625b024c82a5eb240bbd7431d6",22852678,82,0,1,1470,374,374,0
"8d448d625b024c82a5eb240bbd7431d6","4a29443515bb404cb8924e1c60a63b73",22852678,1,-115,0,1477,374,285,-89
"4a29443515bb404cb8924e1c60a63b73","0c4079457ede49e3aeb5e86ed84bdf35",22852678,1,58,0,1478,285,329,44
"0c4079457ede49e3aeb5e86ed84bdf35","0c4079457ede49e3aeb5e86ed84bdf35",22852678,1,0,1,1479,329,329,0
"38aea304b4fa46e1b29bb72f5cea4c93","4a29443515bb404cb8924e1c60a63b73",22852678,1,-60,0,1481,331,285,-46
"4a29443515bb404cb8924e1c60a63b73","b71bac264efb4abd97015447bd490db6",22852678,2,110,0,1482,285,370,85
"b71bac264efb4abd97015447bd490db6","1b4550d0dab04078b3bf08a655345bdc",22852678,1,4,0,1483,370,373,3
"1b4550d0dab04078b3bf08a655345bdc","8d448d625b024c82a5eb240bbd7431d6",22852678,1,1,0,1484,373,374,1
"8d448d625b024c82a5eb240bbd7431d6","0c4079457ede49e3aeb5e86ed84bdf35",22852678,1,-57,0,1492,374,329,-45
"38aea304b4fa46e1b29bb72f5cea4c93","b71bac264efb4abd97015447bd490db6",22852678,1,50,0,1494,331,370,39
"8d448d625b024c82a5eb240bbd7431d6","1b4550d0dab04078b3bf08a655345bdc",22852678,1,-1,0,1503,374,373,-1
"b71bac264efb4abd97015447bd490db6","b71bac264efb4abd97015447bd490db6",22852678,2,0,1,1507,370,370,0
"8d448d625b024c82a5eb240bbd7431d6","b71bac264efb4abd97015447bd490db6",22852678,1,-5,0,1564,374,370,-4
"b71bac264efb4abd97015447bd490db6","d6d02b6ef04e4f17805504500b8ce441",22852678,1,8,0,1565,370,375,5
"d6d02b6ef04e4f17805504500b8ce441","d6d02b6ef04e4f17805504500b8ce441",22852678,8,0,1,1566,375,375,0
"d6d02b6ef04e4f17805504500b8ce441","4a29443515bb404cb8924e1c60a63b73",22852678,1,-118,0,1567,375,285,-90
"4a29443515bb404cb8924e1c60a63b73","7646a919d7e64fa990bca9b024ff089d",22852678,1,17,0,1568,285,298,13
"7646a919d7e64fa990bca9b024ff089d","4a29443515bb404cb8924e1c60a63b73",22852678,2,-17,0,1569,298,285,-13
"4a29443515bb404cb8924e1c60a63b73","ba0e59461bfb4a44b7b1c28a01f8d3b3",22852678,1,18,0,1570,285,299,14
"ba0e59461bfb4a44b7b1c28a01f8d3b3","7646a919d7e64fa990bca9b024ff089d",22852678,1,-1,0,1571,299,298,-1
"4a29443515bb404cb8924e1c60a63b73","3434c10e561d488a914e0f7d71907abd",22852678,1,27,0,1573,285,305,20
"3434c10e561d488a914e0f7d71907abd","3434c10e561d488a914e0f7d71907abd",22852678,3,0,1,1574,305,305,0
"3434c10e561d488a914e0f7d71907abd","53e7e900392747ccad52e711ab0f80d8",22852678,2,2,0,1575,305,307,2
"53e7e900392747ccad52e711ab0f80d8","130acc2aeb0448fdbb2de63bc5cebe5b",22852678,1,3,0,1576,307,309,2
"130acc2aeb0448fdbb2de63bc5cebe5b","3434c10e561d488a914e0f7d71907abd",22852678,1,-5,0,1577,309,305,-4
"3434c10e561d488a914e0f7d71907abd","141c0df6cd1946539aadd1c9b7068cd4",22852678,4,4,0,1578,305,308,3
"141c0df6cd1946539aadd1c9b7068cd4","53e7e900392747ccad52e711ab0f80d8",22852678,1,-2,0,1579,308,307,-1
"130acc2aeb0448fdbb2de63bc5cebe5b","141c0df6cd1946539aadd1c9b7068cd4",22852678,8,-1,0,1582,309,308,-1
"141c0df6cd1946539aadd1c9b7068cd4","0c787d16c9504873b1a4d903cec09948",22852678,2,7,0,1583,308,314,6
"0c787d16c9504873b1a4d903cec09948","130acc2aeb0448fdbb2de63bc5cebe5b",22852678,1,-6,0,1584,314,309,-5
"141c0df6cd1946539aadd1c9b7068cd4","3434c10e561d488a914e0f7d71907abd",22852678,3,-4,0,1586,308,305,-3
"3434c10e561d488a914e0f7d71907abd","0c7262dff33c4087bc660ccf40f92f9c",22852678,1,-184,0,1587,305,169,-136
"0c7262dff33c4087bc660ccf40f92f9c","362fcb0699a14845ab29b2340093e528",22852678,2,6,0,1588,169,174,5
"362fcb0699a14845ab29b2340093e528","b42cc17b7de840f181a704558d0bc845",22852678,2,1,0,1589,174,175,1
"b42cc17b7de840f181a704558d0bc845","362fcb0699a14845ab29b2340093e528",22852678,3,-1,0,1590,175,174,-1
"362fcb0699a14845ab29b2340093e528","ea38cc0e6e6e41edbabf210220808bf9",22852678,3,6,0,1591,174,179,5
"b87c552dd247427abe6ab5795b9c9d43","2024b4885bd14338a39b7b509acbbd02",22852678,1,2,0,1596,181,182,1
"2024b4885bd14338a39b7b509acbbd02","139b097acfca451689d80c9c6eebdf7b",22852678,1,-5,0,1597,182,178,-4
"0c7262dff33c4087bc660ccf40f92f9c","2ae94c0cea4d480a9d5dca8fb1d7b542",22852678,2,97,0,1599,169,242,73
"2ae94c0cea4d480a9d5dca8fb1d7b542","2ae94c0cea4d480a9d5dca8fb1d7b542",22852678,2,0,1,1600,242,242,0
"2ae94c0cea4d480a9d5dca8fb1d7b542","1ebf23f9d994469a85206e4c7b1bf5f5",22852678,2,3,0,1601,242,245,3
"1ebf23f9d994469a85206e4c7b1bf5f5","2ae94c0cea4d480a9d5dca8fb1d7b542",22852678,1,-3,0,1602,245,242,-3
"2ae94c0cea4d480a9d5dca8fb1d7b542","30c9ba177afc49a695625d2bdec40207",22852678,1,9,0,1603,242,250,8
"30c9ba177afc49a695625d2bdec40207","30c9ba177afc49a695625d2bdec40207",22852678,2,0,1,1604,250,250,0
"30c9ba177afc49a695625d2bdec40207","6e83e23f56544a19b94067c1c558d9c0",22852678,1,-3,0,1606,250,247,-3
"2ae94c0cea4d480a9d5dca8fb1d7b542","c8e371568a0c4391b25796ae4e91952e",22852678,1,-74,0,1609,242,186,-56
"ab11d94c6c8948ea90b88f19d2cd502b","6cd2dcaac46847d4a0bc53f296d90375",22852678,3,5,0,1612,190,194,4
"07b44a7a51e94c78b411c753fc39dab0","017d7ca8e0394b91aaadc9574df2202c",22852678,3,5,0,1614,189,193,4
"017d7ca8e0394b91aaadc9574df2202c","0c7262dff33c4087bc660ccf40f92f9c",22852678,4,-32,0,1615,193,169,-24
"0c7262dff33c4087bc660ccf40f92f9c","3434c10e561d488a914e0f7d71907abd",22852678,2,184,0,1616,169,305,136
"141c0df6cd1946539aadd1c9b7068cd4","130acc2aeb0448fdbb2de63bc5cebe5b",22852678,4,1,0,1618,308,309,1
"3434c10e561d488a914e0f7d71907abd","94cecc3f1e7d484b8e068e79241dfd73",22852678,1,-36,0,1622,305,281,-24
"94cecc3f1e7d484b8e068e79241dfd73","94cecc3f1e7d484b8e068e79241dfd73",22852678,1,0,1,1623,281,281,0
"94cecc3f1e7d484b8e068e79241dfd73","a37477c4e4c14169ad44b06b493007f6",22852678,1,2,0,1624,281,283,2
"0c7262dff33c4087bc660ccf40f92f9c","139b097acfca451689d80c9c6eebdf7b",22852678,3,11,0,1626,169,178,9
"0c7262dff33c4087bc660ccf40f92f9c","d6d02b6ef04e4f17805504500b8ce441",22852678,1,275,0,1636,169,375,206
"d6d02b6ef04e4f17805504500b8ce441","3434c10e561d488a914e0f7d71907abd",22852678,1,-91,0,1641,375,305,-70
"130acc2aeb0448fdbb2de63bc5cebe5b","0c787d16c9504873b1a4d903cec09948",22852678,1,6,0,1648,309,314,5
"0c787d16c9504873b1a4d903cec09948","3434c10e561d488a914e0f7d71907abd",22852678,1,-11,0,1649,314,305,-9
"3434c10e561d488a914e0f7d71907abd","66baf19b6b904b70922329068c63746d",22852678,1,95,0,1650,305,376,71
"66baf19b6b904b70922329068c63746d","66baf19b6b904b70922329068c63746d",22852678,5,0,1,1651,376,376,0
"66baf19b6b904b70922329068c63746d","7f544639412e40a9ba27f43b415362ab",22852678,5,2,0,1652,376,378,2
"7f544639412e40a9ba27f43b415362ab","66baf19b6b904b70922329068c63746d",22852678,3,-2,0,1653,378,376,-2
"7f544639412e40a9ba27f43b415362ab","7f544639412e40a9ba27f43b415362ab",22852678,2,0,1,1656,378,378,0
"7f544639412e40a9ba27f43b415362ab","3434c10e561d488a914e0f7d71907abd",22852678,1,-97,0,1660,378,305,-73
"141c0df6cd1946539aadd1c9b7068cd4","4a29443515bb404cb8924e1c60a63b73",22852678,3,-31,0,1664,308,285,-23
"4a29443515bb404cb8924e1c60a63b73","66baf19b6b904b70922329068c63746d",22852678,1,122,0,1665,285,376,91
"7f544639412e40a9ba27f43b415362ab","d5ae8642e15b46b8bd298b02274d4e9c",22852678,1,2,0,1672,378,380,2
"d5ae8642e15b46b8bd298b02274d4e9c","d5ae8642e15b46b8bd298b02274d4e9c",22852678,1,0,1,1673,380,380,0
"d5ae8642e15b46b8bd298b02274d4e9c","a0d10309a2dd456289147f84be9d37f9",22852678,1,1,0,1674,380,381,1
"a0d10309a2dd456289147f84be9d37f9","a0d10309a2dd456289147f84be9d37f9",22852678,2,0,1,1675,381,381,0
"a0d10309a2dd456289147f84be9d37f9","0fcbc3ca07b144138b8d85da581f09a8",22852678,1,1,0,1677,381,382,1
"0fcbc3ca07b144138b8d85da581f09a8","0fcbc3ca07b144138b8d85da581f09a8",22852678,2,0,1,1678,382,382,0
"0fcbc3ca07b144138b8d85da581f09a8","66baf19b6b904b70922329068c63746d",22852678,1,-6,0,1680,382,376,-6
"66baf19b6b904b70922329068c63746d","c2fca3669923477ab966ded303dea31c",22852678,1,8,0,1681,376,383,7
"c2fca3669923477ab966ded303dea31c","4890121ce5d74576b4632b77cfc23398",22852678,1,6,0,1682,383,388,5
"4890121ce5d74576b4632b77cfc23398","4890121ce5d74576b4632b77cfc23398",22852678,1,0,1,1683,388,388,0
"4890121ce5d74576b4632b77cfc23398","18d3b836dd804224883cc9180b60a8e1",22852678,1,-1,0,1684,388,387,-1
"18d3b836dd804224883cc9180b60a8e1","96bb2b3e85a34d8b9544514e89f6fe97",22852678,1,4,0,1685,387,390,3
"96bb2b3e85a34d8b9544514e89f6fe97","96bb2b3e85a34d8b9544514e89f6fe97",22852678,2,0,1,1686,390,390,0
"96bb2b3e85a34d8b9544514e89f6fe97","ac4e9b54acfe4670b4634859c7263cb5",22852678,1,2,0,1688,390,392,2
"ac4e9b54acfe4670b4634859c7263cb5","ac4e9b54acfe4670b4634859c7263cb5",22852678,1,0,1,1689,392,392,0
"ac4e9b54acfe4670b4634859c7263cb5","6f8881a745ac4c358a68b92c3b4abe81",22852678,1,3,0,1690,392,394,2
"6f8881a745ac4c358a68b92c3b4abe81","17f95d18bab743888e1736033dc3384d",22852678,1,-6,0,1691,394,389,-5
"17f95d18bab743888e1736033dc3384d","6f8881a745ac4c358a68b92c3b4abe81",22852678,1,6,0,1692,389,394,5
"6f8881a745ac4c358a68b92c3b4abe81","f7002c8484354eceac57bc7bd62c76c1",22852678,1,-1,0,1693,394,393,-1
"f7002c8484354eceac57bc7bd62c76c1","44a277ea44dc4ae689fab4b82f0b4098",22852678,1,5,0,1694,393,397,4
"44a277ea44dc4ae689fab4b82f0b4098","44a277ea44dc4ae689fab4b82f0b4098",22852678,1,0,1,1695,397,397,0
"44a277ea44dc4ae689fab4b82f0b4098","0c12af0a4e7f4002852cf84b2537c161",22852678,1,-2,0,1696,397,395,-2
"0c12af0a4e7f4002852cf84b2537c161","859e0b8d71694b12befb69ee698138f9",22852678,1,5,0,1697,395,399,4
"859e0b8d71694b12befb69ee698138f9","859e0b8d71694b12befb69ee698138f9",22852678,1,0,1,1698,399,399,0
"859e0b8d71694b12befb69ee698138f9","66baf19b6b904b70922329068c63746d",22852678,1,-29,0,1699,399,376,-23
"66baf19b6b904b70922329068c63746d","2b09a08242b54983aec7063990fb3f66",22852678,1,32,0,1700,376,400,24
"2b09a08242b54983aec7063990fb3f66","2b09a08242b54983aec7063990fb3f66",22852678,5,0,1,1701,400,400,0
"2b09a08242b54983aec7063990fb3f66","1f471b7a883a4df48211e8c6a81b59a7",22852678,1,1,0,1704,400,401,1
"1f471b7a883a4df48211e8c6a81b59a7","1f471b7a883a4df48211e8c6a81b59a7",22852678,1,0,1,1705,401,401,0
"1f471b7a883a4df48211e8c6a81b59a7","2b09a08242b54983aec7063990fb3f66",22852678,1,-1,0,1706,401,400,-1
"2b09a08242b54983aec7063990fb3f66","9de0d567bfa84fe5b77cb76f4a76a5d1",22852678,1,5,0,1707,400,404,4
"9de0d567bfa84fe5b77cb76f4a76a5d1","9de0d567bfa84fe5b77cb76f4a76a5d1",22852678,1,0,1,1708,404,404,0
"9de0d567bfa84fe5b77cb76f4a76a5d1","1157bd665ec4472fb58b751dc5099355",22852678,1,-1,0,1709,404,403,-1
"1157bd665ec4472fb58b751dc5099355","58fc9094275e4c49be3f4ba6d4acc0a4",22852678,1,5,0,1710,403,406,3
"58fc9094275e4c49be3f4ba6d4acc0a4","3c8a22d2f9c146ea956609e3ed4f2559",22852678,1,-2,0,1711,406,405,-1
"3c8a22d2f9c146ea956609e3ed4f2559","58fc9094275e4c49be3f4ba6d4acc0a4",22852678,1,2,0,1712,405,406,1
"58fc9094275e4c49be3f4ba6d4acc0a4","58fc9094275e4c49be3f4ba6d4acc0a4",22852678,1,0,1,1713,406,406,0
"58fc9094275e4c49be3f4ba6d4acc0a4","c1c1be90b2b14c1ab4a5e1ee3c241902",22852678,1,1,0,1714,406,407,1
"c1c1be90b2b14c1ab4a5e1ee3c241902","c1c1be90b2b14c1ab4a5e1ee3c241902",22852678,5,0,1,1715,407,407,0
"c1c1be90b2b14c1ab4a5e1ee3c241902","58fc9094275e4c49be3f4ba6d4acc0a4",22852678,1,-1,0,1720,407,406,-1
"58fc9094275e4c49be3f4ba6d4acc0a4","02b3a1bead9244c1ba2f857c7da8f82a",22852678,1,3,0,1721,406,408,2
"02b3a1bead9244c1ba2f857c7da8f82a","02b3a1bead9244c1ba2f857c7da8f82a",22852678,1,0,1,1722,408,408,0
"02b3a1bead9244c1ba2f857c7da8f82a","6206fc6479014bb193084c32409dc1b9",22852678,1,1,0,1723,408,409,1
"6206fc6479014bb193084c32409dc1b9","6206fc6479014bb193084c32409dc1b9",22852678,4,0,1,1724,409,409,0
"6206fc6479014bb193084c32409dc1b9","6a5f020451db426dacba9e2ea3fcc62a",22852678,1,2,0,1728,409,410,1
"6a5f020451db426dacba9e2ea3fcc62a","02b3a1bead9244c1ba2f857c7da8f82a",22852678,1,-3,0,1729,410,408,-2
"02b3a1bead9244c1ba2f857c7da8f82a","6a5f020451db426dacba9e2ea3fcc62a",22852678,1,3,0,1730,408,410,2
"6a5f020451db426dacba9e2ea3fcc62a","2b09a08242b54983aec7063990fb3f66",22852678,1,-15,0,1731,410,400,-10
"2b09a08242b54983aec7063990fb3f66","6a5f020451db426dacba9e2ea3fcc62a",22852678,1,15,0,1734,400,410,10
"6a5f020451db426dacba9e2ea3fcc62a","6a5f020451db426dacba9e2ea3fcc62a",22852678,2,0,1,1735,410,410,0
"6a5f020451db426dacba9e2ea3fcc62a","33a9d248b2e44588a5b07fc1342b9bc2",22852678,1,2,0,1737,410,411,1
"33a9d248b2e44588a5b07fc1342b9bc2","33a9d248b2e44588a5b07fc1342b9bc2",22852678,1,0,1,1738,411,411,0
"33a9d248b2e44588a5b07fc1342b9bc2","c6f26bd420634f1cb7989e76fe6b16c0",22852678,1,1,0,1739,411,412,1
"c6f26bd420634f1cb7989e76fe6b16c0","c6f26bd420634f1cb7989e76fe6b16c0",22852678,5,0,1,1740,412,412,0
"c6f26bd420634f1cb7989e76fe6b16c0","2a65ee6e2ac64f6a8a55fbe5373ec763",22852678,1,1,0,1745,412,413,1
"2a65ee6e2ac64f6a8a55fbe5373ec763","2a65ee6e2ac64f6a8a55fbe5373ec763",22852678,2,0,1,1746,413,413,0
"2a65ee6e2ac64f6a8a55fbe5373ec763","33a9d248b2e44588a5b07fc1342b9bc2",22852678,1,-2,0,1748,413,411,-2
"33a9d248b2e44588a5b07fc1342b9bc2","1fd0f6dadbc14ebc965faf6122190b96",22852678,1,5,0,1749,411,415,4
"1fd0f6dadbc14ebc965faf6122190b96","1fd0f6dadbc14ebc965faf6122190b96",22852678,1,0,1,1750,415,415,0
"1fd0f6dadbc14ebc965faf6122190b96","687055dad9fc40c3982478fe33ec01bf",22852678,1,-1,0,1751,415,414,-1
"687055dad9fc40c3982478fe33ec01bf","2add1669f08d4101913db15f8c23b3b7",22852678,1,3,0,1752,414,416,2
"2add1669f08d4101913db15f8c23b3b7","2add1669f08d4101913db15f8c23b3b7",22852678,1,0,1,1753,416,416,0
"2add1669f08d4101913db15f8c23b3b7","a2b4bd40cee2481ebd3fc179d6a5cd62",22852678,1,3,0,1754,416,417,1
"a2b4bd40cee2481ebd3fc179d6a5cd62","2b09a08242b54983aec7063990fb3f66",22852678,1,-27,0,1755,417,400,-17
"2b09a08242b54983aec7063990fb3f66","66baf19b6b904b70922329068c63746d",22852678,1,-32,0,1756,400,376,-24
"66baf19b6b904b70922329068c63746d","1157bd665ec4472fb58b751dc5099355",22852678,1,36,0,1757,376,403,27
"1157bd665ec4472fb58b751dc5099355","2b09a08242b54983aec7063990fb3f66",22852678,3,-4,0,1758,403,400,-3
"2b09a08242b54983aec7063990fb3f66","1157bd665ec4472fb58b751dc5099355",22852678,3,4,0,1759,400,403,3
"1157bd665ec4472fb58b751dc5099355","3c8a22d2f9c146ea956609e3ed4f2559",22852678,1,3,0,1760,403,405,2
"3c8a22d2f9c146ea956609e3ed4f2559","2b09a08242b54983aec7063990fb3f66",22852678,1,-7,0,1761,405,400,-5
"2b09a08242b54983aec7063990fb3f66","a2b4bd40cee2481ebd3fc179d6a5cd62",22852678,1,27,0,1766,400,417,17
"a2b4bd40cee2481ebd3fc179d6a5cd62","a2b4bd40cee2481ebd3fc179d6a5cd62",22852678,1,0,1,1767,417,417,0
"a2b4bd40cee2481ebd3fc179d6a5cd62","e34e59dce2204f228f3a84b6725df60f",22852678,1,2,0,1768,417,419,2
"e34e59dce2204f228f3a84b6725df60f","e34e59dce2204f228f3a84b6725df60f",22852678,1,0,1,1769,419,419,0
"e34e59dce2204f228f3a84b6725df60f","a2b4bd40cee2481ebd3fc179d6a5cd62",22852678,1,-2,0,1770,419,417,-2
"a2b4bd40cee2481ebd3fc179d6a5cd62","bec48fc2e1294c7eb3d0aca780d731b8",22852678,1,4,0,1771,417,420,3
"bec48fc2e1294c7eb3d0aca780d731b8","bec48fc2e1294c7eb3d0aca780d731b8",22852678,3,0,1,1772,420,420,0
"bec48fc2e1294c7eb3d0aca780d731b8","a24600b0e49245f6bdba8c893cfeddb0",22852678,1,7,0,1775,420,425,5
"a24600b0e49245f6bdba8c893cfeddb0","dbde19fcce2a4c1abdc7f685c293a23f",22852678,1,-4,0,1776,425,422,-3
"dbde19fcce2a4c1abdc7f685c293a23f","a24600b0e49245f6bdba8c893cfeddb0",22852678,1,4,0,1777,422,425,3
"a24600b0e49245f6bdba8c893cfeddb0","a24600b0e49245f6bdba8c893cfeddb0",22852678,1,0,1,1778,425,425,0
"a24600b0e49245f6bdba8c893cfeddb0","24cf8786024543f19b89bc20034e60d7",22852678,1,7,0,1779,425,428,3
"24cf8786024543f19b89bc20034e60d7","a2b4bd40cee2481ebd3fc179d6a5cd62",22852678,1,-18,0,1780,428,417,-11
"a2b4bd40cee2481ebd3fc179d6a5cd62","f2a73be2f46840b182d7bd095378004e",22852678,1,19,0,1781,417,429,12
"f2a73be2f46840b182d7bd095378004e","24cf8786024543f19b89bc20034e60d7",22852678,1,-1,0,1782,429,428,-1
"24cf8786024543f19b89bc20034e60d7","f2a73be2f46840b182d7bd095378004e",22852678,2,1,0,1783,428,429,1
"f2a73be2f46840b182d7bd095378004e","0c7262dff33c4087bc660ccf40f92f9c",22852678,1,-357,0,1784,429,169,-260
"362fcb0699a14845ab29b2340093e528","b87c552dd247427abe6ab5795b9c9d43",22852678,1,8,0,1788,174,181,7
"b87c552dd247427abe6ab5795b9c9d43","ea38cc0e6e6e41edbabf210220808bf9",22852678,3,-2,0,1789,181,179,-2
"ea38cc0e6e6e41edbabf210220808bf9","139b097acfca451689d80c9c6eebdf7b",22852678,2,-1,0,1790,179,178,-1
"ea38cc0e6e6e41edbabf210220808bf9","2024b4885bd14338a39b7b509acbbd02",22852678,2,4,0,1792,179,182,3
"2024b4885bd14338a39b7b509acbbd02","b87c552dd247427abe6ab5795b9c9d43",22852678,2,-2,0,1793,182,181,-1
"0c7262dff33c4087bc660ccf40f92f9c","c8e371568a0c4391b25796ae4e91952e",22852678,3,23,0,1799,169,186,17
"c8e371568a0c4391b25796ae4e91952e","017d7ca8e0394b91aaadc9574df2202c",22852678,3,9,0,1807,186,193,7
"6cd2dcaac46847d4a0bc53f296d90375","017d7ca8e0394b91aaadc9574df2202c",22852678,4,-1,0,1809,194,193,-1
"c8e371568a0c4391b25796ae4e91952e","24cf8786024543f19b89bc20034e60d7",22852678,1,333,0,1811,186,428,242
"24cf8786024543f19b89bc20034e60d7","24cf8786024543f19b89bc20034e60d7",22852678,1,0,1,1812,428,428,0
"f2a73be2f46840b182d7bd095378004e","f2a73be2f46840b182d7bd095378004e",22852678,2,0,1,1814,429,429,0
"f2a73be2f46840b182d7bd095378004e","604551fd4266430cb860fef58fa7dd61",22852678,1,1,0,1816,429,430,1
"604551fd4266430cb860fef58fa7dd61","604551fd4266430cb860fef58fa7dd61",22852678,1,0,1,1817,430,430,0
"604551fd4266430cb860fef58fa7dd61","dce46f8904594a62a6377a3587aaa663",22852678,1,2,0,1818,430,431,1
"dce46f8904594a62a6377a3587aaa663","24cf8786024543f19b89bc20034e60d7",22852678,1,-4,0,1819,431,428,-3
"24cf8786024543f19b89bc20034e60d7","dce46f8904594a62a6377a3587aaa663",22852678,1,4,0,1820,428,431,3
"dce46f8904594a62a6377a3587aaa663","9b9d0a249052413c869753b99682b0ac",22852678,1,1,0,1821,431,432,1
"9b9d0a249052413c869753b99682b0ac","9b9d0a249052413c869753b99682b0ac",22852678,5,0,1,1822,432,432,0
"9b9d0a249052413c869753b99682b0ac","061c175cc90f45fbad883025394e78dd",22852678,1,1,0,1827,432,433,1
"061c175cc90f45fbad883025394e78dd","061c175cc90f45fbad883025394e78dd",22852678,1,0,1,1828,433,433,0
"061c175cc90f45fbad883025394e78dd","dce46f8904594a62a6377a3587aaa663",22852678,1,-2,0,1829,433,431,-2
"dce46f8904594a62a6377a3587aaa663","74a7f8712e5449c2bc0b43c6f90dafed",22852678,1,5,0,1830,431,435,4
"74a7f8712e5449c2bc0b43c6f90dafed","74a7f8712e5449c2bc0b43c6f90dafed",22852678,1,0,1,1831,435,435,0
"74a7f8712e5449c2bc0b43c6f90dafed","66ada10dde9f43018588f1ced9d477fc",22852678,1,-1,0,1832,435,434,-1
"66ada10dde9f43018588f1ced9d477fc","bf12c96466d840a69bed7020b3f18bb8",22852678,1,3,0,1833,434,436,2
"bf12c96466d840a69bed7020b3f18bb8","bf12c96466d840a69bed7020b3f18bb8",22852678,1,0,1,1834,436,436,0
"bf12c96466d840a69bed7020b3f18bb8","24cf8786024543f19b89bc20034e60d7",22852678,1,-11,0,1835,436,428,-8
"24cf8786024543f19b89bc20034e60d7","070600601c4c439288445d2f0724807d",22852678,1,14,0,1836,428,437,9
"070600601c4c439288445d2f0724807d","1823b6de7d334a7aaabc4570719af4d9",22852678,2,2,0,1837,437,439,2
"1823b6de7d334a7aaabc4570719af4d9","1823b6de7d334a7aaabc4570719af4d9",22852678,14,0,1,1838,439,439,0
"1823b6de7d334a7aaabc4570719af4d9","070600601c4c439288445d2f0724807d",22852678,1,-2,0,1852,439,437,-2
"070600601c4c439288445d2f0724807d","0380cd76a7d44bc3a4da1f15e4d68f89",22852678,1,4,0,1853,437,440,3
"0380cd76a7d44bc3a4da1f15e4d68f89","0380cd76a7d44bc3a4da1f15e4d68f89",22852678,1,0,1,1854,440,440,0
"0380cd76a7d44bc3a4da1f15e4d68f89","23b7673c8b5443108c2ef09382834a86",22852678,2,2,0,1855,440,441,1
"23b7673c8b5443108c2ef09382834a86","0380cd76a7d44bc3a4da1f15e4d68f89",22852678,1,-2,0,1856,441,440,-1
"23b7673c8b5443108c2ef09382834a86","23b7673c8b5443108c2ef09382834a86",22852678,1,0,1,1858,441,441,0
"23b7673c8b5443108c2ef09382834a86","901e92500aea43c79f19f1b279050668",22852678,1,2,0,1859,441,442,1
"901e92500aea43c79f19f1b279050668","901e92500aea43c79f19f1b279050668",22852678,2,0,1,1860,442,442,0
"901e92500aea43c79f19f1b279050668","001339db8ced4cf78829ebe8b145449d",22852678,1,1,0,1862,442,443,1
"001339db8ced4cf78829ebe8b145449d","001339db8ced4cf78829ebe8b145449d",22852678,11,0,1,1863,443,443,0
"001339db8ced4cf78829ebe8b145449d","452745e0366e42ae81561bfddebcc6c3",22852678,1,1,0,1874,443,444,1
"452745e0366e42ae81561bfddebcc6c3","452745e0366e42ae81561bfddebcc6c3",22852678,5,0,1,1875,444,444,0
"452745e0366e42ae81561bfddebcc6c3","4660ff2089114e8db82ceb26a4f329e3",22852678,1,2,0,1880,444,445,1
"4660ff2089114e8db82ceb26a4f329e3","901e92500aea43c79f19f1b279050668",22852678,1,-4,0,1881,445,442,-3
"901e92500aea43c79f19f1b279050668","4660ff2089114e8db82ceb26a4f329e3",22852678,1,4,0,1882,442,445,3
"4660ff2089114e8db82ceb26a4f329e3","7bd5586eb9d8484eb74a433ee7bfe499",22852678,2,2,0,1883,445,446,1
"7bd5586eb9d8484eb74a433ee7bfe499","4660ff2089114e8db82ceb26a4f329e3",22852678,2,-2,0,1884,446,445,-1
"4660ff2089114e8db82ceb26a4f329e3","070600601c4c439288445d2f0724807d",22852678,2,-12,0,1885,445,437,-8
"1823b6de7d334a7aaabc4570719af4d9","4660ff2089114e8db82ceb26a4f329e3",22852678,1,10,0,1887,439,445,6
"070600601c4c439288445d2f0724807d","7bd5586eb9d8484eb74a433ee7bfe499",22852678,1,14,0,1889,437,446,9
"7bd5586eb9d8484eb74a433ee7bfe499","7bd5586eb9d8484eb74a433ee7bfe499",22852678,10,0,1,1892,446,446,0
"7bd5586eb9d8484eb74a433ee7bfe499","8a7f26e690f34dda97be16904518ca99",22852678,1,2,0,1902,446,447,1
"8a7f26e690f34dda97be16904518ca99","8a7f26e690f34dda97be16904518ca99",22852678,1,0,1,1903,447,447,0
"8a7f26e690f34dda97be16904518ca99","070600601c4c439288445d2f0724807d",22852678,1,-16,0,1904,447,437,-10
"070600601c4c439288445d2f0724807d","b2f0d654738f48158edff28e8d3a546e",22852678,1,21,0,1905,437,449,12
"b2f0d654738f48158edff28e8d3a546e","f60ee41ec635499abd48168342d32c2f",22852678,2,5,0,1906,449,453,4
"f60ee41ec635499abd48168342d32c2f","f60ee41ec635499abd48168342d32c2f",22852678,51,0,1,1907,453,453,0
"f60ee41ec635499abd48168342d32c2f","b2f0d654738f48158edff28e8d3a546e",22852678,1,-5,0,1908,453,449,-4
"f60ee41ec635499abd48168342d32c2f","f67fbf45a5f146ed866965bc57c7c001",22852678,1,3,0,1960,453,454,1
"f67fbf45a5f146ed866965bc57c7c001","b2f0d654738f48158edff28e8d3a546e",22852678,1,-8,0,1961,454,449,-5
"b2f0d654738f48158edff28e8d3a546e","f67fbf45a5f146ed866965bc57c7c001",22852678,1,8,0,1962,449,454,5
"f67fbf45a5f146ed866965bc57c7c001","f67fbf45a5f146ed866965bc57c7c001",22852678,1,0,1,1963,454,454,0
"f67fbf45a5f146ed866965bc57c7c001","d937afe49bd24a07a550dda1c1155122",22852678,1,1,0,1964,454,455,1
"d937afe49bd24a07a550dda1c1155122","d937afe49bd24a07a550dda1c1155122",22852678,1,0,1,1965,455,455,0
"d937afe49bd24a07a550dda1c1155122","3628b3f7823443d0912a339096b69943",22852678,1,1,0,1966,455,456,1
"3628b3f7823443d0912a339096b69943","3628b3f7823443d0912a339096b69943",22852678,1,0,1,1967,456,456,0
"3628b3f7823443d0912a339096b69943","9e049ee647cf43ecbcb5ed792a8e7588",22852678,1,1,0,1968,456,457,1
"9e049ee647cf43ecbcb5ed792a8e7588","9e049ee647cf43ecbcb5ed792a8e7588",22852678,1,0,1,1969,457,457,0
"9e049ee647cf43ecbcb5ed792a8e7588","5256a214faaf410b93f76cea06428334",22852678,1,1,0,1970,457,458,1
"5256a214faaf410b93f76cea06428334","5256a214faaf410b93f76cea06428334",22852678,1,0,1,1971,458,458,0
"5256a214faaf410b93f76cea06428334","25c32b120fce40fa9b6c85133aeb4716",22852678,1,1,0,1972,458,459,1
"25c32b120fce40fa9b6c85133aeb4716","25c32b120fce40fa9b6c85133aeb4716",22852678,1,0,1,1973,459,459,0
"25c32b120fce40fa9b6c85133aeb4716","11bc14f2204949008b7d511b933363c1",22852678,1,1,0,1974,459,460,1
"11bc14f2204949008b7d511b933363c1","11bc14f2204949008b7d511b933363c1",22852678,1,0,1,1975,460,460,0
"11bc14f2204949008b7d511b933363c1","42de338840a34d15adb66e7b14fb9d2c",22852678,1,1,0,1976,460,461,1
"42de338840a34d15adb66e7b14fb9d2c","42de338840a34d15adb66e7b14fb9d2c",22852678,1,0,1,1977,461,461,0
"42de338840a34d15adb66e7b14fb9d2c","9da37c6210b1416b8079c274f70bf600",22852678,1,1,0,1978,461,462,1
"9da37c6210b1416b8079c274f70bf600","9da37c6210b1416b8079c274f70bf600",22852678,1,0,1,1979,462,462,0
"9da37c6210b1416b8079c274f70bf600","519119f1deac45ff9ab4f13529be5c6e",22852678,1,1,0,1980,462,463,1
"519119f1deac45ff9ab4f13529be5c6e","519119f1deac45ff9ab4f13529be5c6e",22852678,1,0,1,1981,463,463,0
"519119f1deac45ff9ab4f13529be5c6e","f67fbf45a5f146ed866965bc57c7c001",22852678,1,-9,0,1982,463,454,-9
"f67fbf45a5f146ed866965bc57c7c001","c5df9f40ec14463b9dcfdc73df3e9285",22852678,3,12,0,1983,454,464,10
"c5df9f40ec14463b9dcfdc73df3e9285","c5df9f40ec14463b9dcfdc73df3e9285",22852678,14,0,1,1984,464,464,0
"c5df9f40ec14463b9dcfdc73df3e9285","83d42d95cd844fc093fc09cee250edb8",22852678,6,3,0,1986,464,465,1
"83d42d95cd844fc093fc09cee250edb8","83d42d95cd844fc093fc09cee250edb8",22852678,3,0,1,1987,465,465,0
"83d42d95cd844fc093fc09cee250edb8","66baf19b6b904b70922329068c63746d",22852678,4,-135,0,1989,465,376,-89
"66baf19b6b904b70922329068c63746d","c5df9f40ec14463b9dcfdc73df3e9285",22852678,2,132,0,1990,376,464,88
"c5df9f40ec14463b9dcfdc73df3e9285","66baf19b6b904b70922329068c63746d",22852678,2,-132,0,1993,464,376,-88
"66baf19b6b904b70922329068c63746d","e2911e79efc2420eac45d9f671463d4b",22852678,1,-517,0,1994,376,2,-374
"e2911e79efc2420eac45d9f671463d4b","b613861cecf84ffcab01afb23f660475",22852678,2,-3,0,1996,2,1,-1
"b613861cecf84ffcab01afb23f660475","3f1c815879794b929260d224becaff7e",22852678,1,19,0,1997,1,14,13
"3f1c815879794b929260d224becaff7e","56586aa865414f538729c7f7735d2bc6",22852678,1,-4,0,1998,14,12,-2
"56586aa865414f538729c7f7735d2bc6","3f1c815879794b929260d224becaff7e",22852678,1,4,0,1999,12,14,2
"3f1c815879794b929260d224becaff7e","0c7262dff33c4087bc660ccf40f92f9c",22852678,1,222,0,2000,14,169,155
"2024b4885bd14338a39b7b509acbbd02","b42cc17b7de840f181a704558d0bc845",22852678,1,-9,0,2006,182,175,-7
"0c7262dff33c4087bc660ccf40f92f9c","c5df9f40ec14463b9dcfdc73df3e9285",22852678,1,411,0,2017,169,464,295
"83d42d95cd844fc093fc09cee250edb8","c5df9f40ec14463b9dcfdc73df3e9285",22852678,2,-3,0,2021,465,464,-1
"66baf19b6b904b70922329068c63746d","c8e371568a0c4391b25796ae4e91952e",22852678,1,-256,0,2024,376,186,-190
"017d7ca8e0394b91aaadc9574df2202c","f9170dd6bc6442b4acd832747609b09a",22852678,1,7,0,2028,193,199,6
"f9170dd6bc6442b4acd832747609b09a","ab11d94c6c8948ea90b88f19d2cd502b",22852678,1,-11,0,2029,199,190,-9
"c8e371568a0c4391b25796ae4e91952e","141c0df6cd1946539aadd1c9b7068cd4",22852678,1,165,0,2034,186,308,122
"0c787d16c9504873b1a4d903cec09948","53e7e900392747ccad52e711ab0f80d8",22852678,1,-9,0,2039,314,307,-7
"4a29443515bb404cb8924e1c60a63b73","0c7262dff33c4087bc660ccf40f92f9c",22852678,1,-157,0,2044,285,169,-116
"ea38cc0e6e6e41edbabf210220808bf9","ea38cc0e6e6e41edbabf210220808bf9",22852678,1,0,1,2049,179,179,0
"0c7262dff33c4087bc660ccf40f92f9c","017d7ca8e0394b91aaadc9574df2202c",22852678,1,32,0,2052,169,193,24
"c8e371568a0c4391b25796ae4e91952e","6cd2dcaac46847d4a0bc53f296d90375",22852678,1,10,0,2054,186,194,8
"6cd2dcaac46847d4a0bc53f296d90375","6cd2dcaac46847d4a0bc53f296d90375",22852678,3,0,1,2055,194,194,0
"130acc2aeb0448fdbb2de63bc5cebe5b","130acc2aeb0448fdbb2de63bc5cebe5b",22852678,2,0,1,2062,309,309,0
"4a29443515bb404cb8924e1c60a63b73","c5df9f40ec14463b9dcfdc73df3e9285",22852678,1,254,0,2066,285,464,179
"c5df9f40ec14463b9dcfdc73df3e9285","f67fbf45a5f146ed866965bc57c7c001",22852678,2,-12,0,2076,464,454,-10
"66baf19b6b904b70922329068c63746d","d6d02b6ef04e4f17805504500b8ce441",22852678,1,-4,0,2085,376,375,-1
"d6d02b6ef04e4f17805504500b8ce441","b71bac264efb4abd97015447bd490db6",22852678,1,-8,0,2089,375,370,-5
"8d448d625b024c82a5eb240bbd7431d6","c5df9f40ec14463b9dcfdc73df3e9285",22852678,1,139,0,2098,374,464,90
"66baf19b6b904b70922329068c63746d","c33c17be71ae4d588da7369472e5bb1b",22852678,1,-464,0,2102,376,34,-342
"c33c17be71ae4d588da7369472e5bb1b","c33c17be71ae4d588da7369472e5bb1b",22852678,2,0,1,2103,34,34,0
"c33c17be71ae4d588da7369472e5bb1b","93679be414554a11b1893002f2229a93",22852678,4,3,0,2104,34,35,1
"93679be414554a11b1893002f2229a93","c33c17be71ae4d588da7369472e5bb1b",22852678,2,-3,0,2105,35,34,-1
"93679be414554a11b1893002f2229a93","7040a13096d746ac84b8fac8d9752058",22852678,3,3,0,2107,35,36,1
"7040a13096d746ac84b8fac8d9752058","7040a13096d746ac84b8fac8d9752058",22852678,3,0,1,2108,36,36,0
"7040a13096d746ac84b8fac8d9752058","9a0dc646f934470daf08c4b56ccf73db",22852678,3,3,0,2109,36,37,1
"9a0dc646f934470daf08c4b56ccf73db","9a0dc646f934470daf08c4b56ccf73db",22852678,2,0,1,2110,37,37,0
"9a0dc646f934470daf08c4b56ccf73db","fc0e049d56024bc9a02c9a9c435c3df7",22852678,3,3,0,2111,37,38,1
"fc0e049d56024bc9a02c9a9c435c3df7","b613861cecf84ffcab01afb23f660475",22852678,1,-68,0,2112,38,1,-37
"b613861cecf84ffcab01afb23f660475","e2911e79efc2420eac45d9f671463d4b",22852678,4,3,0,2113,1,2,1
"e2911e79efc2420eac45d9f671463d4b","56586aa865414f538729c7f7735d2bc6",22852678,4,12,0,2115,2,12,10
"56586aa865414f538729c7f7735d2bc6","e2911e79efc2420eac45d9f671463d4b",22852678,1,-12,0,2116,12,2,-10
"56586aa865414f538729c7f7735d2bc6","56586aa865414f538729c7f7735d2bc6",22852678,5,0,1,2118,12,12,0
"56586aa865414f538729c7f7735d2bc6","b7f2b31585d94eb3bf86376714aa7070",22852678,4,2,0,2119,12,13,1
"b7f2b31585d94eb3bf86376714aa7070","b7f2b31585d94eb3bf86376714aa7070",22852678,3,0,1,2120,13,13,0
"b7f2b31585d94eb3bf86376714aa7070","3f1c815879794b929260d224becaff7e",22852678,3,2,0,2121,13,14,1
"3f1c815879794b929260d224becaff7e","5c5ceeee4562457ba6d41515aeebfbb1",22852678,1,6,0,2122,14,17,3
"5c5ceeee4562457ba6d41515aeebfbb1","81c864a886d54a6b8ff85f7d736f4f95",22852678,1,-4,0,2123,17,15,-2
"81c864a886d54a6b8ff85f7d736f4f95","9afd71a5298d4333b6849dfce1b9422c",22852678,1,7,0,2124,15,18,3
"9afd71a5298d4333b6849dfce1b9422c","56586aa865414f538729c7f7735d2bc6",22852678,1,-13,0,2125,18,12,-6
"56586aa865414f538729c7f7735d2bc6","b7719e26494940efa49512aedd0aac79",22852678,1,17,0,2126,12,20,8
"b7719e26494940efa49512aedd0aac79","9afd71a5298d4333b6849dfce1b9422c",22852678,2,-4,0,2127,20,18,-2
"9afd71a5298d4333b6849dfce1b9422c","d4c3b003e8274e429d2fa688d73fde6d",22852678,1,7,0,2128,18,22,4
"d4c3b003e8274e429d2fa688d73fde6d","d4f45188d3c84a02ba08454e6403a818",22852678,1,2,0,2129,22,24,2
"d4f45188d3c84a02ba08454e6403a818","b7719e26494940efa49512aedd0aac79",22852678,1,-5,0,2130,24,20,-4
"b7719e26494940efa49512aedd0aac79","afbf7250b99d47bea07172749483ca97",22852678,6,12,0,2131,20,28,8
"afbf7250b99d47bea07172749483ca97","b7719e26494940efa49512aedd0aac79",22852678,2,-12,0,2132,28,20,-8
"afbf7250b99d47bea07172749483ca97","4e51676dc72045d99c19b9fa7b22f8bc",22852678,4,3,0,2134,28,29,1
"4e51676dc72045d99c19b9fa7b22f8bc","4e51676dc72045d99c19b9fa7b22f8bc",22852678,2,0,1,2135,29,29,0
"4e51676dc72045d99c19b9fa7b22f8bc","b613861cecf84ffcab01afb23f660475",22852678,1,-47,0,2136,29,1,-28
"3f1c815879794b929260d224becaff7e","81c864a886d54a6b8ff85f7d736f4f95",22852678,2,2,0,2147,14,15,1
"81c864a886d54a6b8ff85f7d736f4f95","5c5ceeee4562457ba6d41515aeebfbb1",22852678,2,4,0,2148,15,17,2
"5c5ceeee4562457ba6d41515aeebfbb1","56586aa865414f538729c7f7735d2bc6",22852678,2,-10,0,2149,17,12,-5
"56586aa865414f538729c7f7735d2bc6","9afd71a5298d4333b6849dfce1b9422c",22852678,2,13,0,2150,12,18,6
"9afd71a5298d4333b6849dfce1b9422c","b7719e26494940efa49512aedd0aac79",22852678,2,4,0,2151,18,20,2
"9afd71a5298d4333b6849dfce1b9422c","d4f45188d3c84a02ba08454e6403a818",22852678,1,9,0,2153,18,24,6
"d4f45188d3c84a02ba08454e6403a818","d4c3b003e8274e429d2fa688d73fde6d",22852678,2,-2,0,2154,24,22,-2
"b7719e26494940efa49512aedd0aac79","b7719e26494940efa49512aedd0aac79",22852678,1,0,1,2156,20,20,0
"4e51676dc72045d99c19b9fa7b22f8bc","afbf7250b99d47bea07172749483ca97",22852678,1,-3,0,2159,29,28,-1
"4e51676dc72045d99c19b9fa7b22f8bc","51970cfa30e643e894e66ae85c8024cc",22852678,2,3,0,2161,29,31,2
"51970cfa30e643e894e66ae85c8024cc","4e51676dc72045d99c19b9fa7b22f8bc",22852678,1,-3,0,2162,31,29,-2
"4e51676dc72045d99c19b9fa7b22f8bc","c33c17be71ae4d588da7369472e5bb1b",22852678,1,9,0,2163,29,34,5
"93679be414554a11b1893002f2229a93","93679be414554a11b1893002f2229a93",22852678,1,0,1,2166,35,35,0
"fc0e049d56024bc9a02c9a9c435c3df7","fc0e049d56024bc9a02c9a9c435c3df7",22852678,1,0,1,2172,38,38,0
"fc0e049d56024bc9a02c9a9c435c3df7","67a089198fcb4e1c8f2385786c2b296f",22852678,1,4,0,2173,38,39,1
"67a089198fcb4e1c8f2385786c2b296f","64d48c6c9c7940639a932219a6c87198",22852678,2,1,0,2174,39,40,1
"b613861cecf84ffcab01afb23f660475","b613861cecf84ffcab01afb23f660475",22854917,1,0,1,1,1,1,0
"b613861cecf84ffcab01afb23f660475","e2911e79efc2420eac45d9f671463d4b",22854917,1,3,0,2,1,2,1
"e2911e79efc2420eac45d9f671463d4b","e2911e79efc2420eac45d9f671463d4b",22854917,2,0,1,3,2,2,0
"e2911e79efc2420eac45d9f671463d4b","519d1b8c59404d67b54e96c5c8a830b2",22854917,1,1,0,5,2,3,1
"519d1b8c59404d67b54e96c5c8a830b2","519d1b8c59404d67b54e96c5c8a830b2",22854917,1,0,1,6,3,3,0
"519d1b8c59404d67b54e96c5c8a830b2","531db53f81f646edb0cdcfe0085b03b7",22854917,1,1,0,7,3,4,1
"531db53f81f646edb0cdcfe0085b03b7","531db53f81f646edb0cdcfe0085b03b7",22854917,1,0,1,8,4,4,0
"531db53f81f646edb0cdcfe0085b03b7","4f5f94b2f95141e0a9d53a61da2276da",22854917,1,1,0,9,4,5,1
"4f5f94b2f95141e0a9d53a61da2276da","4f5f94b2f95141e0a9d53a61da2276da",22854917,1,0,1,10,5,5,0
"4f5f94b2f95141e0a9d53a61da2276da","6d541c89590949f99af293c4f2333f67",22854917,1,1,0,11,5,6,1
"6d541c89590949f99af293c4f2333f67","6d541c89590949f99af293c4f2333f67",22854917,2,0,1,12,6,6,0
"6d541c89590949f99af293c4f2333f67","4f5f94b2f95141e0a9d53a61da2276da",22854917,1,-1,0,14,6,5,-1
"4f5f94b2f95141e0a9d53a61da2276da","531db53f81f646edb0cdcfe0085b03b7",22854917,1,-1,0,15,5,4,-1
"531db53f81f646edb0cdcfe0085b03b7","dd5cf0b9fe4c4f1d8f5ff8e4c04879cb",22854917,1,3,0,16,4,7,3
"dd5cf0b9fe4c4f1d8f5ff8e4c04879cb","dd5cf0b9fe4c4f1d8f5ff8e4c04879cb",22854917,1,0,1,17,7,7,0
"dd5cf0b9fe4c4f1d8f5ff8e4c04879cb","f96261861edc426abe2248be4f0a709a",22854917,1,1,0,18,7,8,1
"f96261861edc426abe2248be4f0a709a","f96261861edc426abe2248be4f0a709a",22854917,1,0,1,19,8,8,0
"f96261861edc426abe2248be4f0a709a","66b5e16f4f75454fb5b8172079f0fa83",22854917,1,1,0,20,8,9,1
"66b5e16f4f75454fb5b8172079f0fa83","66b5e16f4f75454fb5b8172079f0fa83",22854917,1,0,1,21,9,9,0
"66b5e16f4f75454fb5b8172079f0fa83","0680571d4698477995e41842c36a54b2",22854917,1,1,0,22,9,10,1
"0680571d4698477995e41842c36a54b2","0680571d4698477995e41842c36a54b2",22854917,1,0,1,23,10,10,0
"0680571d4698477995e41842c36a54b2","9112f2bffece48e08c6d2287be204085",22854917,1,1,0,24,10,11,1
"9112f2bffece48e08c6d2287be204085","9112f2bffece48e08c6d2287be204085",22854917,1,0,1,25,11,11,0
"9112f2bffece48e08c6d2287be204085","56586aa865414f538729c7f7735d2bc6",22854917,1,3,0,26,11,12,1
"56586aa865414f538729c7f7735d2bc6","e2911e79efc2420eac45d9f671463d4b",22854917,3,-12,0,27,12,2,-10
"e2911e79efc2420eac45d9f671463d4b","56586aa865414f538729c7f7735d2bc6",22854917,3,12,0,28,2,12,10
"3f1c815879794b929260d224becaff7e","5c5ceeee4562457ba6d41515aeebfbb1",22854917,1,6,0,41,14,17,3
"5c5ceeee4562457ba6d41515aeebfbb1","81c864a886d54a6b8ff85f7d736f4f95",22854917,1,-4,0,42,17,15,-2
"81c864a886d54a6b8ff85f7d736f4f95","5c5ceeee4562457ba6d41515aeebfbb1",22854917,1,4,0,43,15,17,2
"5c5ceeee4562457ba6d41515aeebfbb1","5c5ceeee4562457ba6d41515aeebfbb1",22854917,3,0,1,44,17,17,0
"5c5ceeee4562457ba6d41515aeebfbb1","9afd71a5298d4333b6849dfce1b9422c",22854917,2,3,0,47,17,18,1
"56586aa865414f538729c7f7735d2bc6","9afd71a5298d4333b6849dfce1b9422c",22854917,1,13,0,49,12,18,6
"9afd71a5298d4333b6849dfce1b9422c","b7719e26494940efa49512aedd0aac79",22854917,1,4,0,51,18,20,2
"d4c3b003e8274e429d2fa688d73fde6d","d4c3b003e8274e429d2fa688d73fde6d",22854917,3,0,1,54,22,22,0
"d4c3b003e8274e429d2fa688d73fde6d","b613861cecf84ffcab01afb23f660475",22854917,1,-35,0,62,22,1,-21
"a49d1bb4328949299686242fd0be5584","a49d1bb4328949299686242fd0be5584",22854917,1,0,1,65,21,21,0
"afbf7250b99d47bea07172749483ca97","b7719e26494940efa49512aedd0aac79",22854917,1,-12,0,71,28,20,-8
"b7719e26494940efa49512aedd0aac79","4e51676dc72045d99c19b9fa7b22f8bc",22854917,1,15,0,72,20,29,9
"4e51676dc72045d99c19b9fa7b22f8bc","afbf7250b99d47bea07172749483ca97",22854917,1,-3,0,73,29,28,-1
"afbf7250b99d47bea07172749483ca97","4e51676dc72045d99c19b9fa7b22f8bc",22854917,1,3,0,74,28,29,1
"4e51676dc72045d99c19b9fa7b22f8bc","51970cfa30e643e894e66ae85c8024cc",22854917,1,3,0,75,29,31,2
"51970cfa30e643e894e66ae85c8024cc","c33c17be71ae4d588da7369472e5bb1b",22854917,1,6,0,76,31,34,3
"c33c17be71ae4d588da7369472e5bb1b","4e51676dc72045d99c19b9fa7b22f8bc",22854917,1,-9,0,77,34,29,-5
"4e51676dc72045d99c19b9fa7b22f8bc","93679be414554a11b1893002f2229a93",22854917,1,12,0,78,29,35,6
"93679be414554a11b1893002f2229a93","c33c17be71ae4d588da7369472e5bb1b",22854917,1,-3,0,79,35,34,-1
"c33c17be71ae4d588da7369472e5bb1b","93679be414554a11b1893002f2229a93",22854917,1,3,0,80,34,35,1
"93679be414554a11b1893002f2229a93","7040a13096d746ac84b8fac8d9752058",22854917,1,3,0,81,35,36,1
"7040a13096d746ac84b8fac8d9752058","7040a13096d746ac84b8fac8d9752058",22854917,1,0,1,82,36,36,0
"7040a13096d746ac84b8fac8d9752058","9a0dc646f934470daf08c4b56ccf73db",22854917,1,3,0,83,36,37,1
"9a0dc646f934470daf08c4b56ccf73db","fc0e049d56024bc9a02c9a9c435c3df7",22854917,2,3,0,84,37,38,1
"fc0e049d56024bc9a02c9a9c435c3df7","9a0dc646f934470daf08c4b56ccf73db",22854917,1,-3,0,85,38,37,-1
"fc0e049d56024bc9a02c9a9c435c3df7","67a089198fcb4e1c8f2385786c2b296f",22854917,1,4,0,87,38,39,1
"64d48c6c9c7940639a932219a6c87198","eb2a0eb537344a9e891c761662e400b6",22854917,1,-50,0,89,40,16,-24
"56586aa865414f538729c7f7735d2bc6","b613861cecf84ffcab01afb23f660475",22854917,1,-15,0,94,12,1,-11
"b613861cecf84ffcab01afb23f660475","56586aa865414f538729c7f7735d2bc6",22854917,1,15,0,95,1,12,11
"56586aa865414f538729c7f7735d2bc6","56586aa865414f538729c7f7735d2bc6",22854917,13,0,1,100,12,12,0
"56586aa865414f538729c7f7735d2bc6","b7f2b31585d94eb3bf86376714aa7070",22854917,2,2,0,105,12,13,1
"b7f2b31585d94eb3bf86376714aa7070","b7f2b31585d94eb3bf86376714aa7070",22854917,9,0,1,106,13,13,0
"b7f2b31585d94eb3bf86376714aa7070","3f1c815879794b929260d224becaff7e",22854917,2,2,0,113,13,14,1
"3f1c815879794b929260d224becaff7e","b613861cecf84ffcab01afb23f660475",22854917,1,-19,0,114,14,1,-13
"b613861cecf84ffcab01afb23f660475","b7719e26494940efa49512aedd0aac79",22854917,2,32,0,115,1,20,19
"b7719e26494940efa49512aedd0aac79","d4f45188d3c84a02ba08454e6403a818",22854917,4,5,0,116,20,24,4
"d4f45188d3c84a02ba08454e6403a818","d4c3b003e8274e429d2fa688d73fde6d",22854917,4,-2,0,117,24,22,-2
"d4c3b003e8274e429d2fa688d73fde6d","b7719e26494940efa49512aedd0aac79",22854917,2,-3,0,118,22,20,-2
"b7719e26494940efa49512aedd0aac79","9afd71a5298d4333b6849dfce1b9422c",22854917,1,-4,0,119,20,18,-2
"9afd71a5298d4333b6849dfce1b9422c","9afd71a5298d4333b6849dfce1b9422c",22854917,2,0,1,120,18,18,0
"9afd71a5298d4333b6849dfce1b9422c","56586aa865414f538729c7f7735d2bc6",22854917,3,-13,0,121,18,12,-6
"56586aa865414f538729c7f7735d2bc6","5c5ceeee4562457ba6d41515aeebfbb1",22854917,3,10,0,122,12,17,5
"5c5ceeee4562457ba6d41515aeebfbb1","eb2a0eb537344a9e891c761662e400b6",22854917,2,-2,0,123,17,16,-1
"eb2a0eb537344a9e891c761662e400b6","a49d1bb4328949299686242fd0be5584",22854917,1,11,0,124,16,21,5
"a49d1bb4328949299686242fd0be5584","b7719e26494940efa49512aedd0aac79",22854917,3,-2,0,125,21,20,-1
"b7719e26494940efa49512aedd0aac79","a49d1bb4328949299686242fd0be5584",22854917,2,2,0,126,20,21,1
"a49d1bb4328949299686242fd0be5584","d4f45188d3c84a02ba08454e6403a818",22854917,1,3,0,127,21,24,3
"d4c3b003e8274e429d2fa688d73fde6d","a49d1bb4328949299686242fd0be5584",22854917,2,-1,0,129,22,21,-1
"b7719e26494940efa49512aedd0aac79","d4c3b003e8274e429d2fa688d73fde6d",22854917,1,3,0,131,20,22,2
"d4c3b003e8274e429d2fa688d73fde6d","d4f45188d3c84a02ba08454e6403a818",22854917,2,2,0,132,22,24,2
"d4f45188d3c84a02ba08454e6403a818","a49d1bb4328949299686242fd0be5584",22854917,3,-3,0,133,24,21,-3
"a49d1bb4328949299686242fd0be5584","67a089198fcb4e1c8f2385786c2b296f",22854917,1,38,0,134,21,39,18
"67a089198fcb4e1c8f2385786c2b296f","67a089198fcb4e1c8f2385786c2b296f",22854917,3,0,1,135,39,39,0
"67a089198fcb4e1c8f2385786c2b296f","64d48c6c9c7940639a932219a6c87198",22854917,4,1,0,136,39,40,1
"64d48c6c9c7940639a932219a6c87198","64d48c6c9c7940639a932219a6c87198",22854917,9,0,1,137,40,40,0
"64d48c6c9c7940639a932219a6c87198","67a089198fcb4e1c8f2385786c2b296f",22854917,2,-1,0,140,40,39,-1
"67a089198fcb4e1c8f2385786c2b296f","56586aa865414f538729c7f7735d2bc6",22854917,1,-57,0,141,39,12,-27
"56586aa865414f538729c7f7735d2bc6","eb2a0eb537344a9e891c761662e400b6",22854917,1,8,0,142,12,16,4
"eb2a0eb537344a9e891c761662e400b6","56586aa865414f538729c7f7735d2bc6",22854917,3,-8,0,143,16,12,-4
"56586aa865414f538729c7f7735d2bc6","64d48c6c9c7940639a932219a6c87198",22854917,1,58,0,144,12,40,28
"67a089198fcb4e1c8f2385786c2b296f","b534b89233134e30a9b5645138bfa9ee",22854917,2,4,0,146,39,41,2
"b534b89233134e30a9b5645138bfa9ee","b534b89233134e30a9b5645138bfa9ee",22854917,2,0,1,147,41,41,0
"b534b89233134e30a9b5645138bfa9ee","67a089198fcb4e1c8f2385786c2b296f",22854917,3,-4,0,148,41,39,-2
"64d48c6c9c7940639a932219a6c87198","b534b89233134e30a9b5645138bfa9ee",22854917,2,3,0,156,40,41,1
"67a089198fcb4e1c8f2385786c2b296f","0e37b720d23b4e7f8b313e79313fd107",22854917,1,7,0,160,39,44,5
"0e37b720d23b4e7f8b313e79313fd107","0e37b720d23b4e7f8b313e79313fd107",22854917,1,0,1,161,44,44,0
"0e37b720d23b4e7f8b313e79313fd107","6875d67fdd5f48168b62719df449bebd",22854917,1,1,0,162,44,45,1
"6875d67fdd5f48168b62719df449bebd","6875d67fdd5f48168b62719df449bebd",22854917,1,0,1,163,45,45,0
"6875d67fdd5f48168b62719df449bebd","b534b89233134e30a9b5645138bfa9ee",22854917,1,-4,0,164,45,41,-4
"b534b89233134e30a9b5645138bfa9ee","6e13d61a7bdb44bca949c9f86fab3be5",22854917,2,7,0,165,41,47,6
"6e13d61a7bdb44bca949c9f86fab3be5","6e13d61a7bdb44bca949c9f86fab3be5",22854917,6,0,1,166,47,47,0
"6e13d61a7bdb44bca949c9f86fab3be5","195f78799f984cc2b06c48dfe36be751",22854917,1,2,0,172,47,49,2
"195f78799f984cc2b06c48dfe36be751","195f78799f984cc2b06c48dfe36be751",22854917,2,0,1,173,49,49,0
"195f78799f984cc2b06c48dfe36be751","d9c8d8c444a64dadbbb508652c721e17",22854917,1,-3,0,175,49,46,-3
"d9c8d8c444a64dadbbb508652c721e17","d0c74f735e024943943e40333d6d337f",22854917,3,6,0,176,46,51,5
"d0c74f735e024943943e40333d6d337f","d0c74f735e024943943e40333d6d337f",22854917,3,0,1,177,51,51,0
"d0c74f735e024943943e40333d6d337f","983f8ff320594b279a7f4a6fe132f9c5",22854917,1,2,0,180,51,53,2
"983f8ff320594b279a7f4a6fe132f9c5","983f8ff320594b279a7f4a6fe132f9c5",22854917,2,0,1,181,53,53,0
"983f8ff320594b279a7f4a6fe132f9c5","35adfa5d923046aebabfefd98f35ff05",22854917,1,1,0,183,53,54,1
"35adfa5d923046aebabfefd98f35ff05","35adfa5d923046aebabfefd98f35ff05",22854917,2,0,1,184,54,54,0
"35adfa5d923046aebabfefd98f35ff05","b6f8a98476224da1b40e555ececc7ed8",22854917,1,1,0,186,54,55,1
"b6f8a98476224da1b40e555ececc7ed8","b6f8a98476224da1b40e555ececc7ed8",22854917,2,0,1,187,55,55,0
"b6f8a98476224da1b40e555ececc7ed8","86e22cb5fe0e4b47a9489ecddf7ed78f",22854917,1,1,0,189,55,56,1
"86e22cb5fe0e4b47a9489ecddf7ed78f","86e22cb5fe0e4b47a9489ecddf7ed78f",22854917,2,0,1,190,56,56,0
"86e22cb5fe0e4b47a9489ecddf7ed78f","f924752d8a1149668870b1e7698486f7",22854917,1,-6,0,192,56,50,-6
"f924752d8a1149668870b1e7698486f7","a1f2f12debe5432fb7a70bcd12bacfb9",22854917,2,9,0,193,50,58,8
"a1f2f12debe5432fb7a70bcd12bacfb9","78f30e4dcac84e3cbea8b2cc6e0d62b3",22854917,3,1,0,194,58,59,1
"78f30e4dcac84e3cbea8b2cc6e0d62b3","a1f2f12debe5432fb7a70bcd12bacfb9",22854917,1,-1,0,195,59,58,-1
"a1f2f12debe5432fb7a70bcd12bacfb9","a1f2f12debe5432fb7a70bcd12bacfb9",22854917,10,0,1,196,58,58,0
"78f30e4dcac84e3cbea8b2cc6e0d62b3","78f30e4dcac84e3cbea8b2cc6e0d62b3",22854917,7,0,1,207,59,59,0
"78f30e4dcac84e3cbea8b2cc6e0d62b3","12aa6e1672ac4e7aa6449a7a8609cd72",22854917,1,-2,0,214,59,57,-2
"12aa6e1672ac4e7aa6449a7a8609cd72","bc42d26810654ea9a1df1efe1e58c7d5",22854917,2,7,0,215,57,63,6
"bc42d26810654ea9a1df1efe1e58c7d5","a0a418b8540d479fa6e0f653b701da8b",22854917,3,1,0,216,63,64,1
"a0a418b8540d479fa6e0f653b701da8b","67a089198fcb4e1c8f2385786c2b296f",22854917,1,-31,0,217,64,39,-25
"67a089198fcb4e1c8f2385786c2b296f","309ccf3cc4fe429d9bfbaef53d3fa479",22854917,1,27,0,218,39,60,21
"309ccf3cc4fe429d9bfbaef53d3fa479","b534b89233134e30a9b5645138bfa9ee",22854917,2,-23,0,219,60,41,-19
"b534b89233134e30a9b5645138bfa9ee","a0a418b8540d479fa6e0f653b701da8b",22854917,1,27,0,220,41,64,23
"a0a418b8540d479fa6e0f653b701da8b","bc42d26810654ea9a1df1efe1e58c7d5",22854917,1,-1,0,221,64,63,-1
"bc42d26810654ea9a1df1efe1e58c7d5","4c943503763e4e349906eea3ed3c8e86",22854917,1,-2,0,222,63,61,-2
"4c943503763e4e349906eea3ed3c8e86","4c943503763e4e349906eea3ed3c8e86",22854917,1,0,1,223,61,61,0
"4c943503763e4e349906eea3ed3c8e86","bc42d26810654ea9a1df1efe1e58c7d5",22854917,1,2,0,224,61,63,2
"bc42d26810654ea9a1df1efe1e58c7d5","bc42d26810654ea9a1df1efe1e58c7d5",22854917,5,0,1,225,63,63,0
"a0a418b8540d479fa6e0f653b701da8b","a0a418b8540d479fa6e0f653b701da8b",22854917,4,0,1,229,64,64,0
"a0a418b8540d479fa6e0f653b701da8b","309ccf3cc4fe429d9bfbaef53d3fa479",22854917,2,-4,0,232,64,60,-4
"309ccf3cc4fe429d9bfbaef53d3fa479","d646286c8051419bbc2e31dd1db55ca8",22854917,1,10,0,233,60,67,7
"d646286c8051419bbc2e31dd1db55ca8","b534b89233134e30a9b5645138bfa9ee",22854917,1,-33,0,234,67,41,-26
"b534b89233134e30a9b5645138bfa9ee","267f883678b24aed855fde42524975d9",22854917,1,37,0,235,41,71,30
"267f883678b24aed855fde42524975d9","267f883678b24aed855fde42524975d9",22854917,1,0,1,236,71,71,0
"267f883678b24aed855fde42524975d9","88fff56d0342490dbef9040750a20f6c",22854917,1,1,0,237,71,72,1
"88fff56d0342490dbef9040750a20f6c","88fff56d0342490dbef9040750a20f6c",22854917,1,0,1,238,72,72,0
"88fff56d0342490dbef9040750a20f6c","adb17b12b66c4a49a85fd34322f7df70",22854917,1,1,0,239,72,73,1
"adb17b12b66c4a49a85fd34322f7df70","adb17b12b66c4a49a85fd34322f7df70",22854917,1,0,1,240,73,73,0
"adb17b12b66c4a49a85fd34322f7df70","a2becd407db34b189200a32546d9d569",22854917,1,3,0,241,73,75,2
"a2becd407db34b189200a32546d9d569","d646286c8051419bbc2e31dd1db55ca8",22854917,2,-9,0,242,75,67,-8
"d646286c8051419bbc2e31dd1db55ca8","a2becd407db34b189200a32546d9d569",22854917,2,9,0,243,67,75,8
"a2becd407db34b189200a32546d9d569","a2becd407db34b189200a32546d9d569",22854917,15,0,1,244,75,75,0
"a2becd407db34b189200a32546d9d569","58c22b011d0f4c2ea6d13615edbb9eeb",22854917,1,2,0,259,75,77,2
"58c22b011d0f4c2ea6d13615edbb9eeb","58c22b011d0f4c2ea6d13615edbb9eeb",22854917,2,0,1,260,77,77,0
"58c22b011d0f4c2ea6d13615edbb9eeb","dd76e1861dc9461c830888729d091ee0",22854917,1,1,0,262,77,78,1
"dd76e1861dc9461c830888729d091ee0","dd76e1861dc9461c830888729d091ee0",22854917,5,0,1,263,78,78,0
"dd76e1861dc9461c830888729d091ee0","cd1d828f1a694b87913a7ea66c23803e",22854917,1,1,0,268,78,79,1
"cd1d828f1a694b87913a7ea66c23803e","cd1d828f1a694b87913a7ea66c23803e",22854917,2,0,1,269,79,79,0
"cd1d828f1a694b87913a7ea66c23803e","9176a3c2b4d2465fa8b0c67096c2a97e",22854917,1,1,0,271,79,80,1
"9176a3c2b4d2465fa8b0c67096c2a97e","9176a3c2b4d2465fa8b0c67096c2a97e",22854917,5,0,1,272,80,80,0
"9176a3c2b4d2465fa8b0c67096c2a97e","140d5b27b8574befad82c0a013b59dfa",22854917,1,-6,0,277,80,74,-6
"140d5b27b8574befad82c0a013b59dfa","d18a9ea32855445f8736581f5cb119ce",22854917,2,9,0,278,74,82,8
"d18a9ea32855445f8736581f5cb119ce","f564483cbd7a407681aa2fcca518cf5f",22854917,1,4,0,279,82,85,3
"f564483cbd7a407681aa2fcca518cf5f","f564483cbd7a407681aa2fcca518cf5f",22854917,1,0,1,280,85,85,0
"f564483cbd7a407681aa2fcca518cf5f","18fd01350bd5434ca636d59a599d768a",22854917,1,1,0,281,85,86,1
"18fd01350bd5434ca636d59a599d768a","18fd01350bd5434ca636d59a599d768a",22854917,9,0,1,282,86,86,0
"18fd01350bd5434ca636d59a599d768a","6a9f0ef185fb47f0937e29daa1c71ed5",22854917,1,5,0,291,86,90,4
"6a9f0ef185fb47f0937e29daa1c71ed5","ae5ac430ea254e708a6f5deaaf7464ae",22854917,2,-7,0,292,90,84,-6
"ae5ac430ea254e708a6f5deaaf7464ae","c681290961c94c4caf23b529d1ae6b9a",22854917,1,5,0,293,84,88,4
"c681290961c94c4caf23b529d1ae6b9a","c681290961c94c4caf23b529d1ae6b9a",22854917,1,0,1,294,88,88,0
"c681290961c94c4caf23b529d1ae6b9a","6a9f0ef185fb47f0937e29daa1c71ed5",22854917,1,2,0,295,88,90,2
"6a9f0ef185fb47f0937e29daa1c71ed5","6a9f0ef185fb47f0937e29daa1c71ed5",22854917,4,0,1,296,90,90,0
"6a9f0ef185fb47f0937e29daa1c71ed5","d646286c8051419bbc2e31dd1db55ca8",22854917,1,-27,0,299,90,67,-23
"d646286c8051419bbc2e31dd1db55ca8","e20db35ced8544ddac5bc3839145e463",22854917,1,30,0,300,67,91,24
"e20db35ced8544ddac5bc3839145e463","1febb706d7a34005ae8711ed49c76e64",22854917,1,3,0,301,91,94,3
"1febb706d7a34005ae8711ed49c76e64","1febb706d7a34005ae8711ed49c76e64",22854917,2,0,1,302,94,94,0
"1febb706d7a34005ae8711ed49c76e64","8f73ba6f5a0042f2850356ac38ac6f24",22854917,1,1,0,304,94,95,1
"8f73ba6f5a0042f2850356ac38ac6f24","8f73ba6f5a0042f2850356ac38ac6f24",22854917,5,0,1,305,95,95,0
"8f73ba6f5a0042f2850356ac38ac6f24","e2260b86653c46d7b14a41fb419dbf8c",22854917,1,1,0,310,95,96,1
"e2260b86653c46d7b14a41fb419dbf8c","e2260b86653c46d7b14a41fb419dbf8c",22854917,2,0,1,311,96,96,0
"e2260b86653c46d7b14a41fb419dbf8c","35eb641ad1d845bbba54915bce75a962",22854917,1,1,0,313,96,97,1
"35eb641ad1d845bbba54915bce75a962","35eb641ad1d845bbba54915bce75a962",22854917,2,0,1,314,97,97,0
"35eb641ad1d845bbba54915bce75a962","08be90ffbeea4795a138cd42ed8db56f",22854917,1,1,0,316,97,98,1
"08be90ffbeea4795a138cd42ed8db56f","08be90ffbeea4795a138cd42ed8db56f",22854917,5,0,1,317,98,98,0
"08be90ffbeea4795a138cd42ed8db56f","3007433c8f584dcbb5ac159c1c5f2be3",22854917,1,1,0,322,98,99,1
"3007433c8f584dcbb5ac159c1c5f2be3","3007433c8f584dcbb5ac159c1c5f2be3",22854917,2,0,1,323,99,99,0
"3007433c8f584dcbb5ac159c1c5f2be3","e20db35ced8544ddac5bc3839145e463",22854917,1,-8,0,325,99,91,-8
"e20db35ced8544ddac5bc3839145e463","d391c8b6e56a43a7b654e9dee02d904b",22854917,3,13,0,326,91,103,12
"d391c8b6e56a43a7b654e9dee02d904b","00ae5f0c51874a73a41ebea838d95682",22854917,4,-2,0,327,103,101,-2
"00ae5f0c51874a73a41ebea838d95682","00ae5f0c51874a73a41ebea838d95682",22854917,21,0,1,328,101,101,0
"00ae5f0c51874a73a41ebea838d95682","d391c8b6e56a43a7b654e9dee02d904b",22854917,2,2,0,349,101,103,2
"d391c8b6e56a43a7b654e9dee02d904b","d391c8b6e56a43a7b654e9dee02d904b",22854917,17,0,1,350,103,103,0
"d391c8b6e56a43a7b654e9dee02d904b","6111116566fc4fd9abba409322bea245",22854917,1,1,0,367,103,104,1
"6111116566fc4fd9abba409322bea245","6111116566fc4fd9abba409322bea245",22854917,2,0,1,368,104,104,0
"6111116566fc4fd9abba409322bea245","a81b2235cb9c499eb9ea8ee0a8dd9725",22854917,1,1,0,370,104,105,1
"a81b2235cb9c499eb9ea8ee0a8dd9725","a81b2235cb9c499eb9ea8ee0a8dd9725",22854917,2,0,1,371,105,105,0
"a81b2235cb9c499eb9ea8ee0a8dd9725","2d4e0ab0ef3b4d73b82c72d4621a7579",22854917,1,1,0,373,105,106,1
"2d4e0ab0ef3b4d73b82c72d4621a7579","2d4e0ab0ef3b4d73b82c72d4621a7579",22854917,2,0,1,374,106,106,0
"2d4e0ab0ef3b4d73b82c72d4621a7579","8bdebf492ebd4e62b0d522e8ab5e5197",22854917,1,1,0,376,106,107,1
"8bdebf492ebd4e62b0d522e8ab5e5197","8bdebf492ebd4e62b0d522e8ab5e5197",22854917,2,0,1,377,107,107,0
"8bdebf492ebd4e62b0d522e8ab5e5197","4280927ec4d643238aa49c32f9e06c6c",22854917,1,3,0,379,107,109,2
"4280927ec4d643238aa49c32f9e06c6c","73039f8c1eb9409cb4caee2cf968001e",22854917,1,-10,0,380,109,100,-9
"73039f8c1eb9409cb4caee2cf968001e","4280927ec4d643238aa49c32f9e06c6c",22854917,4,10,0,381,100,109,9
"4280927ec4d643238aa49c32f9e06c6c","4280927ec4d643238aa49c32f9e06c6c",22854917,7,0,1,382,109,109,0
"4280927ec4d643238aa49c32f9e06c6c","e20db35ced8544ddac5bc3839145e463",22854917,1,-20,0,389,109,91,-18
"00ae5f0c51874a73a41ebea838d95682","e20db35ced8544ddac5bc3839145e463",22854917,2,-11,0,392,101,91,-10
"e20db35ced8544ddac5bc3839145e463","73039f8c1eb9409cb4caee2cf968001e",22854917,2,10,0,393,91,100,9
"4280927ec4d643238aa49c32f9e06c6c","fc44e6a5f7654430af1227838224dceb",22854917,1,2,0,395,109,111,2
"fc44e6a5f7654430af1227838224dceb","fc44e6a5f7654430af1227838224dceb",22854917,2,0,1,396,111,111,0
"fc44e6a5f7654430af1227838224dceb","a9ae0a3c070d455bb4369a8996313336",22854917,1,4,0,398,111,114,3
"a9ae0a3c070d455bb4369a8996313336","08111f75e22d409998cf8b85bd431f0a",22854917,2,-7,0,399,114,108,-6
"08111f75e22d409998cf8b85bd431f0a","a9ae0a3c070d455bb4369a8996313336",22854917,1,7,0,400,108,114,6
"a9ae0a3c070d455bb4369a8996313336","71cec822bcff4f30a20e75dc63ef7b65",22854917,1,2,0,401,114,116,2
"71cec822bcff4f30a20e75dc63ef7b65","71cec822bcff4f30a20e75dc63ef7b65",22854917,1,0,1,402,116,116,0
"71cec822bcff4f30a20e75dc63ef7b65","62bff51286ef4f348717a3cf6fe2318f",22854917,1,5,0,403,116,120,4
"62bff51286ef4f348717a3cf6fe2318f","37319e88176d4aefa91d7a9980dbae91",22854917,2,-9,0,404,120,112,-8
"37319e88176d4aefa91d7a9980dbae91","e20db35ced8544ddac5bc3839145e463",22854917,1,-24,0,405,112,91,-21
"e20db35ced8544ddac5bc3839145e463","e20db35ced8544ddac5bc3839145e463",22854917,5,0,1,406,91,91,0
"e20db35ced8544ddac5bc3839145e463","00ae5f0c51874a73a41ebea838d95682",22854917,2,11,0,410,91,101,10
"d391c8b6e56a43a7b654e9dee02d904b","73039f8c1eb9409cb4caee2cf968001e",22854917,2,-3,0,412,103,100,-3
"4280927ec4d643238aa49c32f9e06c6c","08111f75e22d409998cf8b85bd431f0a",22854917,2,-1,0,414,109,108,-1
"08111f75e22d409998cf8b85bd431f0a","37319e88176d4aefa91d7a9980dbae91",22854917,1,5,0,415,108,112,4
"37319e88176d4aefa91d7a9980dbae91","62bff51286ef4f348717a3cf6fe2318f",22854917,1,9,0,416,112,120,8
"62bff51286ef4f348717a3cf6fe2318f","a9ae0a3c070d455bb4369a8996313336",22854917,2,-7,0,417,120,114,-6
"a9ae0a3c070d455bb4369a8996313336","779f9ddd1fd14d1e9e69f72219a1fdbd",22854917,1,10,0,418,114,121,7
"779f9ddd1fd14d1e9e69f72219a1fdbd","e20db35ced8544ddac5bc3839145e463",22854917,1,-36,0,419,121,91,-30
"e20db35ced8544ddac5bc3839145e463","779f9ddd1fd14d1e9e69f72219a1fdbd",22854917,2,36,0,421,91,121,30
"779f9ddd1fd14d1e9e69f72219a1fdbd","62bff51286ef4f348717a3cf6fe2318f",22854917,1,-3,0,422,121,120,-1
"a9ae0a3c070d455bb4369a8996313336","3ec3a3563847406fa73338f9e9999cf3",22854917,1,4,0,424,114,117,3
"3ec3a3563847406fa73338f9e9999cf3","37319e88176d4aefa91d7a9980dbae91",22854917,1,-6,0,425,117,112,-5
"37319e88176d4aefa91d7a9980dbae91","4280927ec4d643238aa49c32f9e06c6c",22854917,1,-4,0,426,112,109,-3
"4280927ec4d643238aa49c32f9e06c6c","d391c8b6e56a43a7b654e9dee02d904b",22854917,1,-7,0,427,109,103,-6
"00ae5f0c51874a73a41ebea838d95682","08111f75e22d409998cf8b85bd431f0a",22854917,1,8,0,429,101,108,7
"08111f75e22d409998cf8b85bd431f0a","73039f8c1eb9409cb4caee2cf968001e",22854917,1,-9,0,430,108,100,-8
"73039f8c1eb9409cb4caee2cf968001e","73039f8c1eb9409cb4caee2cf968001e",22854917,1,0,1,431,100,100,0
"73039f8c1eb9409cb4caee2cf968001e","e20db35ced8544ddac5bc3839145e463",22854917,2,-10,0,432,100,91,-9
"00ae5f0c51874a73a41ebea838d95682","a9ae0a3c070d455bb4369a8996313336",22854917,1,15,0,434,101,114,13
"a9ae0a3c070d455bb4369a8996313336","d391c8b6e56a43a7b654e9dee02d904b",22854917,1,-13,0,435,114,103,-11
"d391c8b6e56a43a7b654e9dee02d904b","4280927ec4d643238aa49c32f9e06c6c",22854917,1,7,0,436,103,109,6
"08111f75e22d409998cf8b85bd431f0a","62bff51286ef4f348717a3cf6fe2318f",22854917,1,14,0,438,108,120,12
"37319e88176d4aefa91d7a9980dbae91","b1cd0e7dc3ad4a8eb91a4bfdbeb025b0",22854917,1,7,0,440,112,118,6
"b1cd0e7dc3ad4a8eb91a4bfdbeb025b0","b1cd0e7dc3ad4a8eb91a4bfdbeb025b0",22854917,1,0,1,441,118,118,0
"b1cd0e7dc3ad4a8eb91a4bfdbeb025b0","62bff51286ef4f348717a3cf6fe2318f",22854917,1,2,0,442,118,120,2
"62bff51286ef4f348717a3cf6fe2318f","62bff51286ef4f348717a3cf6fe2318f",22854917,3,0,1,443,120,120,0
"62bff51286ef4f348717a3cf6fe2318f","e20db35ced8544ddac5bc3839145e463",22854917,1,-33,0,446,120,91,-29
"779f9ddd1fd14d1e9e69f72219a1fdbd","ae26e6cda8ad4a3f81bd347560d9579f",22854917,1,4,0,448,121,125,4
"ae26e6cda8ad4a3f81bd347560d9579f","ae26e6cda8ad4a3f81bd347560d9579f",22854917,3,0,1,449,125,125,0
"ae26e6cda8ad4a3f81bd347560d9579f","ee48df95832b4374aa273ceb27ec1315",22854917,1,1,0,452,125,126,1
"ee48df95832b4374aa273ceb27ec1315","ee48df95832b4374aa273ceb27ec1315",22854917,1,0,1,453,126,126,0
"ee48df95832b4374aa273ceb27ec1315","7a439da90b394756ad1777fc4c6dead5",22854917,1,1,0,454,126,127,1
"7a439da90b394756ad1777fc4c6dead5","7a439da90b394756ad1777fc4c6dead5",22854917,1,0,1,455,127,127,0
"7a439da90b394756ad1777fc4c6dead5","779f9ddd1fd14d1e9e69f72219a1fdbd",22854917,1,-6,0,456,127,121,-6
"779f9ddd1fd14d1e9e69f72219a1fdbd","a8dd5213034441ac92724b4e83eb0bb2",22854917,1,9,0,457,121,129,8
"a8dd5213034441ac92724b4e83eb0bb2","a8dd5213034441ac92724b4e83eb0bb2",22854917,10,0,1,458,129,129,0
"a8dd5213034441ac92724b4e83eb0bb2","8115eab6556b45f5b415c3b8c26a12e5",22854917,1,2,0,468,129,131,2
"8115eab6556b45f5b415c3b8c26a12e5","8115eab6556b45f5b415c3b8c26a12e5",22854917,5,0,1,469,131,131,0
"8115eab6556b45f5b415c3b8c26a12e5","ec34b06efd844b46a4c4818ecdb9b8f4",22854917,1,1,0,474,131,132,1
"ec34b06efd844b46a4c4818ecdb9b8f4","ec34b06efd844b46a4c4818ecdb9b8f4",22854917,2,0,1,475,132,132,0
"ec34b06efd844b46a4c4818ecdb9b8f4","c2e1c2b9eac64109b343a088584b576b",22854917,1,1,0,477,132,133,1
"c2e1c2b9eac64109b343a088584b576b","c2e1c2b9eac64109b343a088584b576b",22854917,2,0,1,478,133,133,0
"c2e1c2b9eac64109b343a088584b576b","579338175e0b4bbb8ef3b712b5d8b54e",22854917,1,-5,0,480,133,128,-5
"579338175e0b4bbb8ef3b712b5d8b54e","8bc5795d6a984a3eace4e2811e52dd4f",22854917,1,8,0,481,128,135,7
"8bc5795d6a984a3eace4e2811e52dd4f","8bc5795d6a984a3eace4e2811e52dd4f",22854917,1,0,1,482,135,135,0
"8bc5795d6a984a3eace4e2811e52dd4f","b416d47c56a742199b5d7c7f19d6503a",22854917,1,-1,0,483,135,134,-1
"b416d47c56a742199b5d7c7f19d6503a","cd4532ad48034873ba8bce2aac0c9808",22854917,1,4,0,484,134,137,3
"cd4532ad48034873ba8bce2aac0c9808","cd4532ad48034873ba8bce2aac0c9808",22854917,1,0,1,485,137,137,0
"cd4532ad48034873ba8bce2aac0c9808","779f9ddd1fd14d1e9e69f72219a1fdbd",22854917,1,-19,0,486,137,121,-16
"779f9ddd1fd14d1e9e69f72219a1fdbd","df1de691dafe4549a18a4398ee9dfaf9",22854917,1,23,0,487,121,139,18
"df1de691dafe4549a18a4398ee9dfaf9","6c5ad271a44743479bfaea29b1db8d02",22854917,1,4,0,488,139,143,4
"6c5ad271a44743479bfaea29b1db8d02","6c5ad271a44743479bfaea29b1db8d02",22854917,1,0,1,489,143,143,0
"6c5ad271a44743479bfaea29b1db8d02","83d311bed5374fee83d8d67a7d9d82dc",22854917,1,1,0,490,143,144,1
"83d311bed5374fee83d8d67a7d9d82dc","83d311bed5374fee83d8d67a7d9d82dc",22854917,1,0,1,491,144,144,0
"83d311bed5374fee83d8d67a7d9d82dc","402bba41861d43acb52a5abb89e8831e",22854917,1,1,0,492,144,145,1
"402bba41861d43acb52a5abb89e8831e","402bba41861d43acb52a5abb89e8831e",22854917,2,0,1,493,145,145,0
"402bba41861d43acb52a5abb89e8831e","df1de691dafe4549a18a4398ee9dfaf9",22854917,1,-6,0,495,145,139,-6
"df1de691dafe4549a18a4398ee9dfaf9","8aae34f5ddbb4052a709b12e6b0d40fa",22854917,1,9,0,496,139,147,8
"8aae34f5ddbb4052a709b12e6b0d40fa","8aae34f5ddbb4052a709b12e6b0d40fa",22854917,18,0,1,497,147,147,0
"8aae34f5ddbb4052a709b12e6b0d40fa","645b3f0249f64f76af2e19eb4d0e55b7",22854917,1,2,0,515,147,149,2
"645b3f0249f64f76af2e19eb4d0e55b7","645b3f0249f64f76af2e19eb4d0e55b7",22854917,2,0,1,516,149,149,0
"645b3f0249f64f76af2e19eb4d0e55b7","7e7b8db5064d4369805ab370aac5ddfb",22854917,1,1,0,518,149,150,1
"7e7b8db5064d4369805ab370aac5ddfb","7e7b8db5064d4369805ab370aac5ddfb",22854917,2,0,1,519,150,150,0
"7e7b8db5064d4369805ab370aac5ddfb","8956d210ae7f41968fada86d4c979d6a",22854917,1,1,0,521,150,151,1
"8956d210ae7f41968fada86d4c979d6a","8956d210ae7f41968fada86d4c979d6a",22854917,2,0,1,522,151,151,0
"8956d210ae7f41968fada86d4c979d6a","f902b0f41b544d4dbf79664fd233648d",22854917,1,-5,0,524,151,146,-5
"f902b0f41b544d4dbf79664fd233648d","ae781e8b775e4ccd93bc800dad5c8376",22854917,1,8,0,525,146,153,7
"ae781e8b775e4ccd93bc800dad5c8376","ae781e8b775e4ccd93bc800dad5c8376",22854917,2,0,1,526,153,153,0
"ae781e8b775e4ccd93bc800dad5c8376","06882a8492d9499aa31555567f575ecb",22854917,1,1,0,528,153,154,1
"06882a8492d9499aa31555567f575ecb","06882a8492d9499aa31555567f575ecb",22854917,1,0,1,529,154,154,0
"06882a8492d9499aa31555567f575ecb","f293c508f409466a8f27ddd7d1e40b20",22854917,1,1,0,530,154,155,1
"f293c508f409466a8f27ddd7d1e40b20","f293c508f409466a8f27ddd7d1e40b20",22854917,2,0,1,531,155,155,0
"f293c508f409466a8f27ddd7d1e40b20","cc4ddef5bbbe48ebb605141b347c4ed1",22854917,1,1,0,533,155,156,1
"cc4ddef5bbbe48ebb605141b347c4ed1","cc4ddef5bbbe48ebb605141b347c4ed1",22854917,1,0,1,534,156,156,0
"cc4ddef5bbbe48ebb605141b347c4ed1","d313cec988a84645bee413e8d4724a4b",22854917,1,3,0,535,156,158,2
"d313cec988a84645bee413e8d4724a4b","f03480cf4eba413194d7af52fc0e7f28",22854917,1,-7,0,536,158,152,-6
"f03480cf4eba413194d7af52fc0e7f28","d313cec988a84645bee413e8d4724a4b",22854917,1,7,0,537,152,158,6
"d313cec988a84645bee413e8d4724a4b","d313cec988a84645bee413e8d4724a4b",22854917,3,0,1,538,158,158,0
"d313cec988a84645bee413e8d4724a4b","dc60696c76a74368a60f72246e47700d",22854917,1,1,0,541,158,159,1
"dc60696c76a74368a60f72246e47700d","dc60696c76a74368a60f72246e47700d",22854917,1,0,1,542,159,159,0
"dc60696c76a74368a60f72246e47700d","df1de691dafe4549a18a4398ee9dfaf9",22854917,1,-23,0,543,159,139,-20
"df1de691dafe4549a18a4398ee9dfaf9","78adeee1fa2c4fe0bc73f7bca9fcee86",22854917,1,26,0,544,139,160,21
"78adeee1fa2c4fe0bc73f7bca9fcee86","78adeee1fa2c4fe0bc73f7bca9fcee86",22854917,1,0,1,545,160,160,0
"78adeee1fa2c4fe0bc73f7bca9fcee86","65202579580f4ad38d734b4ee39d22a8",22854917,3,5,0,546,160,164,4
"65202579580f4ad38d734b4ee39d22a8","65202579580f4ad38d734b4ee39d22a8",22854917,65,0,1,547,164,164,0
"65202579580f4ad38d734b4ee39d22a8","78adeee1fa2c4fe0bc73f7bca9fcee86",22854917,3,-5,0,548,164,160,-4
"78adeee1fa2c4fe0bc73f7bca9fcee86","3cbcea2be0984e7dbd5a48195af10ce7",22854917,1,8,0,617,160,165,5
"3cbcea2be0984e7dbd5a48195af10ce7","82e6285962b8400d9d6fc32436022a94",22854917,1,2,0,618,165,167,2
"82e6285962b8400d9d6fc32436022a94","3cbcea2be0984e7dbd5a48195af10ce7",22854917,1,-2,0,619,167,165,-2
"3cbcea2be0984e7dbd5a48195af10ce7","a9ac840f098c4bd0a2ee896214ce29cd",22854917,1,5,0,620,165,168,3
"a9ac840f098c4bd0a2ee896214ce29cd","e20db35ced8544ddac5bc3839145e463",22854917,1,-98,0,621,168,91,-77
"73039f8c1eb9409cb4caee2cf968001e","d391c8b6e56a43a7b654e9dee02d904b",22854917,1,3,0,623,100,103,3
"00ae5f0c51874a73a41ebea838d95682","73039f8c1eb9409cb4caee2cf968001e",22854917,1,-1,0,625,101,100,-1
"e20db35ced8544ddac5bc3839145e463","67a089198fcb4e1c8f2385786c2b296f",22854917,1,-67,0,627,91,39,-52
"6e13d61a7bdb44bca949c9f86fab3be5","d9c8d8c444a64dadbbb508652c721e17",22854917,1,-1,0,634,47,46,-1
"d0c74f735e024943943e40333d6d337f","6e13d61a7bdb44bca949c9f86fab3be5",22854917,1,-5,0,636,51,47,-4
"6e13d61a7bdb44bca949c9f86fab3be5","f924752d8a1149668870b1e7698486f7",22854917,1,4,0,637,47,50,3
"f924752d8a1149668870b1e7698486f7","d9c8d8c444a64dadbbb508652c721e17",22854917,1,-5,0,638,50,46,-4
"d0c74f735e024943943e40333d6d337f","f924752d8a1149668870b1e7698486f7",22854917,1,-1,0,640,51,50,-1
"78f30e4dcac84e3cbea8b2cc6e0d62b3","a0a418b8540d479fa6e0f653b701da8b",22854917,1,6,0,643,59,64,5
"a0a418b8540d479fa6e0f653b701da8b","12aa6e1672ac4e7aa6449a7a8609cd72",22854917,1,-8,0,644,64,57,-7
"b534b89233134e30a9b5645138bfa9ee","d646286c8051419bbc2e31dd1db55ca8",22854917,1,33,0,652,41,67,26
"d646286c8051419bbc2e31dd1db55ca8","140d5b27b8574befad82c0a013b59dfa",22854917,1,8,0,655,67,74,7
"d18a9ea32855445f8736581f5cb119ce","6a9f0ef185fb47f0937e29daa1c71ed5",22854917,1,10,0,657,82,90,8
"ae5ac430ea254e708a6f5deaaf7464ae","6a9f0ef185fb47f0937e29daa1c71ed5",22854917,1,7,0,660,84,90,6
"6a9f0ef185fb47f0937e29daa1c71ed5","e20db35ced8544ddac5bc3839145e463",22854917,1,3,0,661,90,91,1
"e20db35ced8544ddac5bc3839145e463","d646286c8051419bbc2e31dd1db55ca8",22854917,1,-30,0,662,91,67,-24
"d646286c8051419bbc2e31dd1db55ca8","00ae5f0c51874a73a41ebea838d95682",22854917,1,41,0,663,67,101,34
"4280927ec4d643238aa49c32f9e06c6c","a9ae0a3c070d455bb4369a8996313336",22854917,1,6,0,668,109,114,5
"08111f75e22d409998cf8b85bd431f0a","0c7262dff33c4087bc660ccf40f92f9c",22854917,1,83,0,670,108,169,61
"0c7262dff33c4087bc660ccf40f92f9c","0c7262dff33c4087bc660ccf40f92f9c",22854917,2,0,1,671,169,169,0
"0c7262dff33c4087bc660ccf40f92f9c","b2275c3fad834f8d90737a2d9a6927d6",22854917,3,3,0,672,169,172,3
"b2275c3fad834f8d90737a2d9a6927d6","b2275c3fad834f8d90737a2d9a6927d6",22854917,20,0,1,673,172,172,0
"b2275c3fad834f8d90737a2d9a6927d6","eb515a26030b41f8a82a1e6114420bad",22854917,1,1,0,693,172,173,1
"eb515a26030b41f8a82a1e6114420bad","eb515a26030b41f8a82a1e6114420bad",22854917,2,0,1,694,173,173,0
"eb515a26030b41f8a82a1e6114420bad","0c7262dff33c4087bc660ccf40f92f9c",22854917,1,-4,0,696,173,169,-4
"0c7262dff33c4087bc660ccf40f92f9c","b42cc17b7de840f181a704558d0bc845",22854917,2,7,0,697,169,175,6
"b42cc17b7de840f181a704558d0bc845","0c7262dff33c4087bc660ccf40f92f9c",22854917,1,-7,0,698,175,169,-6
"b2275c3fad834f8d90737a2d9a6927d6","eb2a0eb537344a9e891c761662e400b6",22854917,1,-221,0,700,172,16,-156
"eb2a0eb537344a9e891c761662e400b6","0c7262dff33c4087bc660ccf40f92f9c",22854917,1,218,0,704,16,169,153
"b2275c3fad834f8d90737a2d9a6927d6","0c7262dff33c4087bc660ccf40f92f9c",22854917,1,-3,0,707,172,169,-3
"b42cc17b7de840f181a704558d0bc845","b42cc17b7de840f181a704558d0bc845",22854917,15,0,1,709,175,175,0
"b42cc17b7de840f181a704558d0bc845","801f9e9135034f49bf5f8b4bdefedb41",22854917,1,2,0,724,175,177,2
"801f9e9135034f49bf5f8b4bdefedb41","801f9e9135034f49bf5f8b4bdefedb41",22854917,4,0,1,725,177,177,0
"801f9e9135034f49bf5f8b4bdefedb41","362fcb0699a14845ab29b2340093e528",22854917,1,-3,0,729,177,174,-3
"362fcb0699a14845ab29b2340093e528","b87c552dd247427abe6ab5795b9c9d43",22854917,1,8,0,730,174,181,7
"b87c552dd247427abe6ab5795b9c9d43","ea38cc0e6e6e41edbabf210220808bf9",22854917,1,-2,0,731,181,179,-2
"ea38cc0e6e6e41edbabf210220808bf9","ea38cc0e6e6e41edbabf210220808bf9",22854917,10,0,1,732,179,179,0
"ea38cc0e6e6e41edbabf210220808bf9","b87c552dd247427abe6ab5795b9c9d43",22854917,1,2,0,742,179,181,2
"b87c552dd247427abe6ab5795b9c9d43","b87c552dd247427abe6ab5795b9c9d43",22854917,7,0,1,743,181,181,0
"b87c552dd247427abe6ab5795b9c9d43","139b097acfca451689d80c9c6eebdf7b",22854917,1,-3,0,750,181,178,-3
"139b097acfca451689d80c9c6eebdf7b","30f660a1feb34582a739722532524f79",22854917,1,6,0,751,178,183,5
"30f660a1feb34582a739722532524f79","30f660a1feb34582a739722532524f79",22854917,1,0,1,752,183,183,0
"30f660a1feb34582a739722532524f79","2024b4885bd14338a39b7b509acbbd02",22854917,1,-1,0,753,183,182,-1
"2024b4885bd14338a39b7b509acbbd02","c3f63fe50d8e487c86bf8ef76c9cadd3",22854917,1,4,0,754,182,185,3
"c3f63fe50d8e487c86bf8ef76c9cadd3","c3f63fe50d8e487c86bf8ef76c9cadd3",22854917,1,0,1,755,185,185,0
"c3f63fe50d8e487c86bf8ef76c9cadd3","c8e371568a0c4391b25796ae4e91952e",22854917,1,3,0,756,185,186,1
"c8e371568a0c4391b25796ae4e91952e","0c7262dff33c4087bc660ccf40f92f9c",22854917,1,-23,0,757,186,169,-17
"0c7262dff33c4087bc660ccf40f92f9c","7d932b23e1c84326ae5aa4d3c0d813d1",22854917,1,25,0,758,169,188,19
"7d932b23e1c84326ae5aa4d3c0d813d1","7d932b23e1c84326ae5aa4d3c0d813d1",22854917,1,0,1,759,188,188,0
"7d932b23e1c84326ae5aa4d3c0d813d1","ab11d94c6c8948ea90b88f19d2cd502b",22854917,1,3,0,760,188,190,2
"ab11d94c6c8948ea90b88f19d2cd502b","c8e371568a0c4391b25796ae4e91952e",22854917,1,-5,0,761,190,186,-4
"c8e371568a0c4391b25796ae4e91952e","ab11d94c6c8948ea90b88f19d2cd502b",22854917,1,5,0,762,186,190,4
"ab11d94c6c8948ea90b88f19d2cd502b","ab11d94c6c8948ea90b88f19d2cd502b",22854917,24,0,1,763,190,190,0
"ab11d94c6c8948ea90b88f19d2cd502b","f992451ed6ad4e68bb9e68ad6be7c4be",22854917,1,2,0,787,190,192,2
"f992451ed6ad4e68bb9e68ad6be7c4be","f992451ed6ad4e68bb9e68ad6be7c4be",22854917,1,0,1,788,192,192,0
"f992451ed6ad4e68bb9e68ad6be7c4be","6cd2dcaac46847d4a0bc53f296d90375",22854917,1,3,0,789,192,194,2
"6cd2dcaac46847d4a0bc53f296d90375","07b44a7a51e94c78b411c753fc39dab0",22854917,1,-6,0,790,194,189,-5
"07b44a7a51e94c78b411c753fc39dab0","6cd2dcaac46847d4a0bc53f296d90375",22854917,1,6,0,791,189,194,5
"6cd2dcaac46847d4a0bc53f296d90375","6cd2dcaac46847d4a0bc53f296d90375",22854917,11,0,1,792,194,194,0
"6cd2dcaac46847d4a0bc53f296d90375","2d2580c9411c4972909db508d6956a58",22854917,1,2,0,803,194,196,2
"2d2580c9411c4972909db508d6956a58","2d2580c9411c4972909db508d6956a58",22854917,2,0,1,804,196,196,0
"2d2580c9411c4972909db508d6956a58","5bddb3d9ed264f3984702f048c7e5340",22854917,1,1,0,806,196,197,1
"5bddb3d9ed264f3984702f048c7e5340","5bddb3d9ed264f3984702f048c7e5340",22854917,2,0,1,807,197,197,0
"5bddb3d9ed264f3984702f048c7e5340","d5e8e2bd12a2466b9d6d90855f0eb079",22854917,1,1,0,809,197,198,1
"d5e8e2bd12a2466b9d6d90855f0eb079","d5e8e2bd12a2466b9d6d90855f0eb079",22854917,2,0,1,810,198,198,0
"d5e8e2bd12a2466b9d6d90855f0eb079","017d7ca8e0394b91aaadc9574df2202c",22854917,1,-5,0,812,198,193,-5
"017d7ca8e0394b91aaadc9574df2202c","54e8e9f0ea3e45c4bf3b8ac799ee31b1",22854917,1,8,0,813,193,200,7
"54e8e9f0ea3e45c4bf3b8ac799ee31b1","54e8e9f0ea3e45c4bf3b8ac799ee31b1",22854917,1,0,1,814,200,200,0
"54e8e9f0ea3e45c4bf3b8ac799ee31b1","c614a00911be4877a075f19315530fb0",22854917,1,1,0,815,200,201,1
"c614a00911be4877a075f19315530fb0","c614a00911be4877a075f19315530fb0",22854917,6,0,1,816,201,201,0
"c614a00911be4877a075f19315530fb0","a6c21bd8b95249c7972820a7a7d76aff",22854917,1,1,0,822,201,202,1
"a6c21bd8b95249c7972820a7a7d76aff","a6c21bd8b95249c7972820a7a7d76aff",22854917,1,0,1,823,202,202,0
"a6c21bd8b95249c7972820a7a7d76aff","bb329d880ab54120adaf203a693bb203",22854917,1,1,0,824,202,203,1
"bb329d880ab54120adaf203a693bb203","bb329d880ab54120adaf203a693bb203",22854917,1,0,1,825,203,203,0
"bb329d880ab54120adaf203a693bb203","f9170dd6bc6442b4acd832747609b09a",22854917,1,-4,0,826,203,199,-4
"f9170dd6bc6442b4acd832747609b09a","334c2344009840079b1d0e1b7ce3d5a7",22854917,1,7,0,827,199,205,6
"334c2344009840079b1d0e1b7ce3d5a7","334c2344009840079b1d0e1b7ce3d5a7",22854917,1,0,1,828,205,205,0
"334c2344009840079b1d0e1b7ce3d5a7","d7f13c8d63ec4e2aa673fbb9cf9c6933",22854917,1,3,0,829,205,206,1
"d7f13c8d63ec4e2aa673fbb9cf9c6933","c8e371568a0c4391b25796ae4e91952e",22854917,1,-26,0,830,206,186,-20
"c8e371568a0c4391b25796ae4e91952e","b9e80f77c3a44349863b19875725c384",22854917,1,27,0,831,186,207,21
"b9e80f77c3a44349863b19875725c384","7108f0e4c2584f1f9c471689ae4c885c",22854917,2,1,0,832,207,208,1
"7108f0e4c2584f1f9c471689ae4c885c","b9e80f77c3a44349863b19875725c384",22854917,1,-1,0,833,208,207,-1
"b9e80f77c3a44349863b19875725c384","b9e80f77c3a44349863b19875725c384",22854917,17,0,1,834,207,207,0
"7108f0e4c2584f1f9c471689ae4c885c","7108f0e4c2584f1f9c471689ae4c885c",22854917,11,0,1,852,208,208,0
"7108f0e4c2584f1f9c471689ae4c885c","d7f13c8d63ec4e2aa673fbb9cf9c6933",22854917,1,-2,0,863,208,206,-2
"d7f13c8d63ec4e2aa673fbb9cf9c6933","09400e101c5d4b439cf9a26b03aae558",22854917,1,5,0,864,206,210,4
"09400e101c5d4b439cf9a26b03aae558","09400e101c5d4b439cf9a26b03aae558",22854917,16,0,1,865,210,210,0
"09400e101c5d4b439cf9a26b03aae558","a88efa7e50ce47159810ab553afa6d3a",22854917,1,2,0,881,210,212,2
"a88efa7e50ce47159810ab553afa6d3a","a88efa7e50ce47159810ab553afa6d3a",22854917,5,0,1,882,212,212,0
"a88efa7e50ce47159810ab553afa6d3a","a875096404ef4a9984b62d74cda916f9",22854917,1,-3,0,887,212,209,-3
"a875096404ef4a9984b62d74cda916f9","be502a7a43c44bf7b682698de79d9369",22854917,1,6,0,888,209,214,5
"be502a7a43c44bf7b682698de79d9369","f7fb1952f56b4189b86a9f8b7862d2b8",22854917,2,1,0,889,214,215,1
"f7fb1952f56b4189b86a9f8b7862d2b8","be502a7a43c44bf7b682698de79d9369",22854917,1,-1,0,890,215,214,-1
"be502a7a43c44bf7b682698de79d9369","be502a7a43c44bf7b682698de79d9369",22854917,12,0,1,891,214,214,0
"f7fb1952f56b4189b86a9f8b7862d2b8","f7fb1952f56b4189b86a9f8b7862d2b8",22854917,15,0,1,904,215,215,0
"f7fb1952f56b4189b86a9f8b7862d2b8","b860ee85d8bc4a2f97958cfb71be3533",22854917,1,1,0,919,215,216,1
"b860ee85d8bc4a2f97958cfb71be3533","b860ee85d8bc4a2f97958cfb71be3533",22854917,2,0,1,920,216,216,0
"b860ee85d8bc4a2f97958cfb71be3533","363837c182e04711840d896ae1e0339c",22854917,1,3,0,922,216,218,2
"363837c182e04711840d896ae1e0339c","ec341f459285443b8361f7f15638ff08",22854917,1,-6,0,923,218,213,-5
"ec341f459285443b8361f7f15638ff08","363837c182e04711840d896ae1e0339c",22854917,1,6,0,924,213,218,5
"363837c182e04711840d896ae1e0339c","363837c182e04711840d896ae1e0339c",22854917,11,0,1,925,218,218,0
"363837c182e04711840d896ae1e0339c","01b2051f8941460d89945e3b02d1ce78",22854917,2,-1,0,936,218,217,-1
"01b2051f8941460d89945e3b02d1ce78","91125ca626c5470eb145501f8c37f8db",22854917,2,4,0,937,217,220,3
"91125ca626c5470eb145501f8c37f8db","be95c065e45447c1bd8215ea6f130c7a",22854917,1,-1,0,938,220,219,-1
"be95c065e45447c1bd8215ea6f130c7a","363837c182e04711840d896ae1e0339c",22854917,1,-2,0,939,219,218,-1
"91125ca626c5470eb145501f8c37f8db","91125ca626c5470eb145501f8c37f8db",22854917,1,0,1,942,220,220,0
"91125ca626c5470eb145501f8c37f8db","d7f13c8d63ec4e2aa673fbb9cf9c6933",22854917,1,-18,0,943,220,206,-14
"d7f13c8d63ec4e2aa673fbb9cf9c6933","1c6721b1f63f4d30ba7746ea8af02a52",22854917,1,21,0,944,206,221,15
"1c6721b1f63f4d30ba7746ea8af02a52","77ecef8eff6b4a2caea7707669bf7475",22854917,1,1,0,945,221,222,1
"77ecef8eff6b4a2caea7707669bf7475","77ecef8eff6b4a2caea7707669bf7475",22854917,12,0,1,946,222,222,0
"77ecef8eff6b4a2caea7707669bf7475","1c6721b1f63f4d30ba7746ea8af02a52",22854917,1,-1,0,958,222,221,-1
"1c6721b1f63f4d30ba7746ea8af02a52","d03cb855c70044cf8c35d9ec0de696e3",22854917,1,4,0,959,221,224,3
"d03cb855c70044cf8c35d9ec0de696e3","8b9ae98743bd4d4a8a87dff1c1244211",22854917,1,3,0,960,224,227,3
"8b9ae98743bd4d4a8a87dff1c1244211","d03cb855c70044cf8c35d9ec0de696e3",22854917,1,-3,0,961,227,224,-3
"d03cb855c70044cf8c35d9ec0de696e3","d03cb855c70044cf8c35d9ec0de696e3",22854917,10,0,1,962,224,224,0
"d03cb855c70044cf8c35d9ec0de696e3","a49a937d6896486d9a5396654abcf2e1",22854917,1,2,0,972,224,226,2
"a49a937d6896486d9a5396654abcf2e1","a49a937d6896486d9a5396654abcf2e1",22854917,1,0,1,973,226,226,0
"a49a937d6896486d9a5396654abcf2e1","8b9ae98743bd4d4a8a87dff1c1244211",22854917,1,1,0,974,226,227,1
"8b9ae98743bd4d4a8a87dff1c1244211","8b9ae98743bd4d4a8a87dff1c1244211",22854917,17,0,1,975,227,227,0
"f7906d6f59b9489a91d2ef40db5a474d","2ab1535aac1346ba8801535bf729ef37",22854917,1,7,0,994,223,229,6
"2ab1535aac1346ba8801535bf729ef37","a4f40fb48a8542c8949bae1f002cd9bc",22854917,1,2,0,995,229,231,2
"a4f40fb48a8542c8949bae1f002cd9bc","a4f40fb48a8542c8949bae1f002cd9bc",22854917,2,0,1,996,231,231,0
"a4f40fb48a8542c8949bae1f002cd9bc","8972c23e32044edb8a78fa1eed4e5947",22854917,1,1,0,998,231,232,1
"8972c23e32044edb8a78fa1eed4e5947","8972c23e32044edb8a78fa1eed4e5947",22854917,1,0,1,999,232,232,0
"8972c23e32044edb8a78fa1eed4e5947","92feb4a40f8344d38b6f722e42a53295",22854917,1,1,0,1000,232,233,1
"92feb4a40f8344d38b6f722e42a53295","92feb4a40f8344d38b6f722e42a53295",22854917,2,0,1,1001,233,233,0
"92feb4a40f8344d38b6f722e42a53295","2ab1535aac1346ba8801535bf729ef37",22854917,1,-4,0,1003,233,229,-4
"2ab1535aac1346ba8801535bf729ef37","2ab1535aac1346ba8801535bf729ef37",22854917,19,0,1,1004,229,229,0
"2ab1535aac1346ba8801535bf729ef37","5152833676bf4c6cb317060be10f68db",22854917,1,-1,0,1023,229,228,-1
"5152833676bf4c6cb317060be10f68db","ca3e28f290354c08aefe5b0f769604e6",22854917,1,8,0,1024,228,235,7
"ca3e28f290354c08aefe5b0f769604e6","ca3e28f290354c08aefe5b0f769604e6",22854917,9,0,1,1025,235,235,0
"ca3e28f290354c08aefe5b0f769604e6","79a35eea833e4c2c9d22fc53c3c6445c",22854917,1,1,0,1034,235,236,1
"79a35eea833e4c2c9d22fc53c3c6445c","79a35eea833e4c2c9d22fc53c3c6445c",22854917,9,0,1,1035,236,236,0
"79a35eea833e4c2c9d22fc53c3c6445c","8f68228b1518449e9615cdafee41a2bd",22854917,1,1,0,1044,236,237,1
"8f68228b1518449e9615cdafee41a2bd","8f68228b1518449e9615cdafee41a2bd",22854917,1,0,1,1045,237,237,0
"8f68228b1518449e9615cdafee41a2bd","cab89fa5c3ed45a5aa550fc0352d6a42",22854917,1,1,0,1046,237,238,1
"cab89fa5c3ed45a5aa550fc0352d6a42","cab89fa5c3ed45a5aa550fc0352d6a42",22854917,5,0,1,1047,238,238,0
"cab89fa5c3ed45a5aa550fc0352d6a42","0b04c8e2f86d48c7aeb7e225819cd32b",22854917,1,-4,0,1052,238,234,-4
"0b04c8e2f86d48c7aeb7e225819cd32b","2ab1535aac1346ba8801535bf729ef37",22854917,2,-6,0,1053,234,229,-5
"2ab1535aac1346ba8801535bf729ef37","d03cb855c70044cf8c35d9ec0de696e3",22854917,1,-6,0,1054,229,224,-5
"d03cb855c70044cf8c35d9ec0de696e3","5152833676bf4c6cb317060be10f68db",22854917,1,5,0,1055,224,228,4
"5152833676bf4c6cb317060be10f68db","8b9ae98743bd4d4a8a87dff1c1244211",22854917,1,-2,0,1056,228,227,-1
"8b9ae98743bd4d4a8a87dff1c1244211","2ab1535aac1346ba8801535bf729ef37",22854917,2,3,0,1057,227,229,2
"2ab1535aac1346ba8801535bf729ef37","f7906d6f59b9489a91d2ef40db5a474d",22854917,3,-7,0,1058,229,223,-6
"f7906d6f59b9489a91d2ef40db5a474d","5152833676bf4c6cb317060be10f68db",22854917,2,6,0,1059,223,228,5
"5152833676bf4c6cb317060be10f68db","0b04c8e2f86d48c7aeb7e225819cd32b",22854917,1,7,0,1060,228,234,6
"2ab1535aac1346ba8801535bf729ef37","8b9ae98743bd4d4a8a87dff1c1244211",22854917,1,-3,0,1062,229,227,-2
"8b9ae98743bd4d4a8a87dff1c1244211","5152833676bf4c6cb317060be10f68db",22854917,1,2,0,1063,227,228,1
"5152833676bf4c6cb317060be10f68db","d03cb855c70044cf8c35d9ec0de696e3",22854917,1,-5,0,1064,228,224,-4
"d03cb855c70044cf8c35d9ec0de696e3","2ab1535aac1346ba8801535bf729ef37",22854917,1,6,0,1065,224,229,5
"5152833676bf4c6cb317060be10f68db","66d4fad4f1cf4b46be0750a99ad7a35a",22854917,1,12,0,1068,228,239,11
"66d4fad4f1cf4b46be0750a99ad7a35a","66d4fad4f1cf4b46be0750a99ad7a35a",22854917,1,0,1,1069,239,239,0
"66d4fad4f1cf4b46be0750a99ad7a35a","0b04c8e2f86d48c7aeb7e225819cd32b",22854917,1,-5,0,1070,239,234,-5
"0b04c8e2f86d48c7aeb7e225819cd32b","d03cb855c70044cf8c35d9ec0de696e3",22854917,1,-12,0,1071,234,224,-10
"d03cb855c70044cf8c35d9ec0de696e3","64dbedb3ce544f6aae8e10e0cf10f16d",22854917,1,19,0,1072,224,240,16
"64dbedb3ce544f6aae8e10e0cf10f16d","8b9ae98743bd4d4a8a87dff1c1244211",22854917,1,-16,0,1073,240,227,-13
"8b9ae98743bd4d4a8a87dff1c1244211","f7906d6f59b9489a91d2ef40db5a474d",22854917,1,-4,0,1074,227,223,-4
"f7906d6f59b9489a91d2ef40db5a474d","f53da5fd9bfe412da4b80d4742563b6c",22854917,1,21,0,1075,223,241,18
"f53da5fd9bfe412da4b80d4742563b6c","f53da5fd9bfe412da4b80d4742563b6c",22854917,3,0,1,1076,241,241,0
"f53da5fd9bfe412da4b80d4742563b6c","2ae94c0cea4d480a9d5dca8fb1d7b542",22854917,1,3,0,1079,241,242,1
"2ae94c0cea4d480a9d5dca8fb1d7b542","1c6721b1f63f4d30ba7746ea8af02a52",22854917,1,-27,0,1080,242,221,-21
"1c6721b1f63f4d30ba7746ea8af02a52","1ebf23f9d994469a85206e4c7b1bf5f5",22854917,1,30,0,1081,221,245,24
"1ebf23f9d994469a85206e4c7b1bf5f5","1ebf23f9d994469a85206e4c7b1bf5f5",22854917,11,0,1,1082,245,245,0
"1ebf23f9d994469a85206e4c7b1bf5f5","85ae675b83e8422da842cfd25596af99",22854917,1,1,0,1093,245,246,1
"85ae675b83e8422da842cfd25596af99","85ae675b83e8422da842cfd25596af99",22854917,1,0,1,1094,246,246,0
"85ae675b83e8422da842cfd25596af99","fa235f0f364d47e4ae1c87f47bf8e6ba",22854917,1,8,0,1095,246,252,6
"fa235f0f364d47e4ae1c87f47bf8e6ba","2ae94c0cea4d480a9d5dca8fb1d7b542",22854917,1,-12,0,1096,252,242,-10
"2ae94c0cea4d480a9d5dca8fb1d7b542","fa235f0f364d47e4ae1c87f47bf8e6ba",22854917,1,12,0,1097,242,252,10
"fa235f0f364d47e4ae1c87f47bf8e6ba","fa235f0f364d47e4ae1c87f47bf8e6ba",22854917,18,0,1,1098,252,252,0
"fa235f0f364d47e4ae1c87f47bf8e6ba","79f7845465cc4ed19d8e4f1429541be0",22854917,1,2,0,1116,252,254,2
"79f7845465cc4ed19d8e4f1429541be0","79f7845465cc4ed19d8e4f1429541be0",22854917,2,0,1,1117,254,254,0
"79f7845465cc4ed19d8e4f1429541be0","00f61990949545828dd12f1303d47504",22854917,1,3,0,1119,254,256,2
"00f61990949545828dd12f1303d47504","6e83e23f56544a19b94067c1c558d9c0",22854917,1,-11,0,1120,256,247,-9
"6e83e23f56544a19b94067c1c558d9c0","00f61990949545828dd12f1303d47504",22854917,1,11,0,1121,247,256,9
"00f61990949545828dd12f1303d47504","00f61990949545828dd12f1303d47504",22854917,7,0,1,1122,256,256,0
"00f61990949545828dd12f1303d47504","ead7bb4b64e247d2ae632ab8a296b091",22854917,1,2,0,1129,256,258,2
"ead7bb4b64e247d2ae632ab8a296b091","ead7bb4b64e247d2ae632ab8a296b091",22854917,2,0,1,1130,258,258,0
"ead7bb4b64e247d2ae632ab8a296b091","41b0048dde734bb280bac6116baa8e27",22854917,1,1,0,1132,258,259,1
"41b0048dde734bb280bac6116baa8e27","41b0048dde734bb280bac6116baa8e27",22854917,2,0,1,1133,259,259,0
"41b0048dde734bb280bac6116baa8e27","b41c5a094a604ee0915327da5cc0beb7",22854917,1,1,0,1135,259,260,1
"b41c5a094a604ee0915327da5cc0beb7","b41c5a094a604ee0915327da5cc0beb7",22854917,2,0,1,1136,260,260,0
"b41c5a094a604ee0915327da5cc0beb7","d546341988904f069cfa86b21457d9d9",22854917,1,-10,0,1138,260,251,-9
"d546341988904f069cfa86b21457d9d9","28c171777c52431ab6b925073bd63d46",22854917,1,15,0,1139,251,264,13
"28c171777c52431ab6b925073bd63d46","28c171777c52431ab6b925073bd63d46",22854917,7,0,1,1140,264,264,0
"28c171777c52431ab6b925073bd63d46","ac160db940cb49ae8579162b1d52bb5d",22854917,1,2,0,1147,264,266,2
"ac160db940cb49ae8579162b1d52bb5d","ac160db940cb49ae8579162b1d52bb5d",22854917,3,0,1,1148,266,266,0
"ac160db940cb49ae8579162b1d52bb5d","d989ebcfc12a4b669f0100dc1aa14f1e",22854917,1,-12,0,1151,266,255,-11
"d989ebcfc12a4b669f0100dc1aa14f1e","c6fd49b485cc4874b0bbdd9c6171e09c",22854917,1,15,0,1152,255,268,13
"c6fd49b485cc4874b0bbdd9c6171e09c","c6fd49b485cc4874b0bbdd9c6171e09c",22854917,3,0,1,1153,268,268,0
"c6fd49b485cc4874b0bbdd9c6171e09c","44240778a97c4af0937817499b75707b",22854917,1,1,0,1156,268,269,1
"44240778a97c4af0937817499b75707b","44240778a97c4af0937817499b75707b",22854917,2,0,1,1157,269,269,0
"44240778a97c4af0937817499b75707b","7aa76d3e993840d8805f097cbdbcd44b",22854917,1,-9,0,1159,269,261,-8
"7aa76d3e993840d8805f097cbdbcd44b","7028800abe7d4e27b613d1d6cbe26bf7",22854917,1,7,0,1160,261,267,6
"7028800abe7d4e27b613d1d6cbe26bf7","7aa76d3e993840d8805f097cbdbcd44b",22854917,1,-7,0,1161,267,261,-6
"7aa76d3e993840d8805f097cbdbcd44b","865a4d3b43374da7944dc7d397f566d9",22854917,1,12,0,1162,261,271,10
"865a4d3b43374da7944dc7d397f566d9","865a4d3b43374da7944dc7d397f566d9",22854917,1,0,1,1163,271,271,0
"865a4d3b43374da7944dc7d397f566d9","2ae94c0cea4d480a9d5dca8fb1d7b542",22854917,1,-35,0,1164,271,242,-29
"2ae94c0cea4d480a9d5dca8fb1d7b542","0d987bed3ffa4ed0b9a2e62e97b7b30f",22854917,2,38,0,1165,242,272,30
"0d987bed3ffa4ed0b9a2e62e97b7b30f","0d987bed3ffa4ed0b9a2e62e97b7b30f",22854917,3,0,1,1166,272,272,0
"0d987bed3ffa4ed0b9a2e62e97b7b30f","bb5a47f5ea01454a8b79455422d3b9da",22854917,7,10,0,1168,272,280,8
"bb5a47f5ea01454a8b79455422d3b9da","82ae07bc0c9b4570a41799290d1ef399",22854917,5,-6,0,1169,280,275,-5
"82ae07bc0c9b4570a41799290d1ef399","bb5a47f5ea01454a8b79455422d3b9da",22854917,4,6,0,1170,275,280,5
"bb5a47f5ea01454a8b79455422d3b9da","bb5a47f5ea01454a8b79455422d3b9da",22854917,113,0,1,1171,280,280,0
"bb5a47f5ea01454a8b79455422d3b9da","b7719e26494940efa49512aedd0aac79",22854917,1,-354,0,1177,280,20,-260
"b7719e26494940efa49512aedd0aac79","b7719e26494940efa49512aedd0aac79",22854917,1,0,1,1178,20,20,0
"b7719e26494940efa49512aedd0aac79","afbf7250b99d47bea07172749483ca97",22854917,2,12,0,1179,20,28,8
"afbf7250b99d47bea07172749483ca97","c33c17be71ae4d588da7369472e5bb1b",22854917,1,12,0,1180,28,34,6
"c33c17be71ae4d588da7369472e5bb1b","c33c17be71ae4d588da7369472e5bb1b",22854917,1,0,1,1181,34,34,0
"c33c17be71ae4d588da7369472e5bb1b","0d987bed3ffa4ed0b9a2e62e97b7b30f",22854917,1,320,0,1182,34,272,238
"0d987bed3ffa4ed0b9a2e62e97b7b30f","bc5524e78a8544e2ae2fdc2f3462bbec",22854917,2,9,0,1183,272,279,7
"bc5524e78a8544e2ae2fdc2f3462bbec","bb5a47f5ea01454a8b79455422d3b9da",22854917,2,1,0,1184,279,280,1
"bb5a47f5ea01454a8b79455422d3b9da","bc5524e78a8544e2ae2fdc2f3462bbec",22854917,4,-1,0,1192,280,279,-1
"bc5524e78a8544e2ae2fdc2f3462bbec","0c7262dff33c4087bc660ccf40f92f9c",22854917,1,-144,0,1193,279,169,-110
"0c7262dff33c4087bc660ccf40f92f9c","2ae94c0cea4d480a9d5dca8fb1d7b542",22854917,1,97,0,1194,169,242,73
"2ae94c0cea4d480a9d5dca8fb1d7b542","d989ebcfc12a4b669f0100dc1aa14f1e",22854917,1,16,0,1195,242,255,13
"d989ebcfc12a4b669f0100dc1aa14f1e","00f61990949545828dd12f1303d47504",22854917,1,1,0,1196,255,256,1
"00f61990949545828dd12f1303d47504","d989ebcfc12a4b669f0100dc1aa14f1e",22854917,1,-1,0,1197,256,255,-1
"d989ebcfc12a4b669f0100dc1aa14f1e","d546341988904f069cfa86b21457d9d9",22854917,1,-5,0,1198,255,251,-4
"d546341988904f069cfa86b21457d9d9","0c7262dff33c4087bc660ccf40f92f9c",22854917,1,-108,0,1199,251,169,-82
"0c7262dff33c4087bc660ccf40f92f9c","bc5524e78a8544e2ae2fdc2f3462bbec",22854917,1,144,0,1200,169,279,110
"bc5524e78a8544e2ae2fdc2f3462bbec","0d987bed3ffa4ed0b9a2e62e97b7b30f",22854917,4,-9,0,1201,279,272,-7
"82ae07bc0c9b4570a41799290d1ef399","0d987bed3ffa4ed0b9a2e62e97b7b30f",22854917,3,-4,0,1222,275,272,-3
"0d987bed3ffa4ed0b9a2e62e97b7b30f","82ae07bc0c9b4570a41799290d1ef399",22854917,1,4,0,1223,272,275,3
"bc5524e78a8544e2ae2fdc2f3462bbec","82ae07bc0c9b4570a41799290d1ef399",22854917,1,-5,0,1235,279,275,-4
"0d987bed3ffa4ed0b9a2e62e97b7b30f","2ae94c0cea4d480a9d5dca8fb1d7b542",22854917,1,-38,0,1248,272,242,-30
"2ae94c0cea4d480a9d5dca8fb1d7b542","2ae94c0cea4d480a9d5dca8fb1d7b542",22854917,1,0,1,1249,242,242,0
"bb5a47f5ea01454a8b79455422d3b9da","0d987bed3ffa4ed0b9a2e62e97b7b30f",22854917,2,-10,0,1279,280,272,-8
"0d987bed3ffa4ed0b9a2e62e97b7b30f","94cecc3f1e7d484b8e068e79241dfd73",22854917,1,13,0,1290,272,281,9
"94cecc3f1e7d484b8e068e79241dfd73","a37477c4e4c14169ad44b06b493007f6",22854917,1,2,0,1291,281,283,2
"a37477c4e4c14169ad44b06b493007f6","fab84b4fab5940efb4ea868ef8d09396",22854917,1,3,0,1292,283,284,1
"fab84b4fab5940efb4ea868ef8d09396","fab84b4fab5940efb4ea868ef8d09396",22854917,3,0,1,1293,284,284,0
"fab84b4fab5940efb4ea868ef8d09396","a9ac840f098c4bd0a2ee896214ce29cd",22854917,1,-157,0,1294,284,168,-116
"a9ac840f098c4bd0a2ee896214ce29cd","fab84b4fab5940efb4ea868ef8d09396",22854917,1,157,0,1295,168,284,116
"fab84b4fab5940efb4ea868ef8d09396","4a29443515bb404cb8924e1c60a63b73",22854917,1,4,0,1297,284,285,1
"4a29443515bb404cb8924e1c60a63b73","208c9b2796c944db8dacaa96082520ea",22854917,2,3,0,1298,285,288,3
"208c9b2796c944db8dacaa96082520ea","208c9b2796c944db8dacaa96082520ea",22854917,6,0,1,1299,288,288,0
"208c9b2796c944db8dacaa96082520ea","4a29443515bb404cb8924e1c60a63b73",22854917,2,-3,0,1304,288,285,-3
"4a29443515bb404cb8924e1c60a63b73","7669a956527947d0add87455277e80b4",22854917,1,7,0,1305,285,291,6
"7669a956527947d0add87455277e80b4","7669a956527947d0add87455277e80b4",22854917,1,0,1,1306,291,291,0
"7669a956527947d0add87455277e80b4","6a9a3b5bde4a48daa896fe8c06eca56f",22854917,1,-2,0,1307,291,289,-2
"6a9a3b5bde4a48daa896fe8c06eca56f","869e967078f04da18dd0b0b9389a7424",22854917,2,5,0,1308,289,293,4
"869e967078f04da18dd0b0b9389a7424","869e967078f04da18dd0b0b9389a7424",22854917,4,0,1,1309,293,293,0
"869e967078f04da18dd0b0b9389a7424","51ab6291537748fab90d519aa09889d6",22854917,1,2,0,1312,293,295,2
"51ab6291537748fab90d519aa09889d6","51ab6291537748fab90d519aa09889d6",22854917,5,0,1,1313,295,295,0
"51ab6291537748fab90d519aa09889d6","34a6e49023fc4465bd5ca604330bbd1c",22854917,1,-3,0,1318,295,292,-3
"34a6e49023fc4465bd5ca604330bbd1c","21592f2a9e9c4b2f8c66ec5dbcbf6a2b",22854917,1,5,0,1319,292,296,4
"21592f2a9e9c4b2f8c66ec5dbcbf6a2b","ba0e59461bfb4a44b7b1c28a01f8d3b3",22854917,3,4,0,1320,296,299,3
"ba0e59461bfb4a44b7b1c28a01f8d3b3","ba0e59461bfb4a44b7b1c28a01f8d3b3",22854917,5,0,1,1321,299,299,0
"ba0e59461bfb4a44b7b1c28a01f8d3b3","7646a919d7e64fa990bca9b024ff089d",22854917,2,-1,0,1322,299,298,-1
"7646a919d7e64fa990bca9b024ff089d","21592f2a9e9c4b2f8c66ec5dbcbf6a2b",22854917,1,-3,0,1323,298,296,-2
"ba0e59461bfb4a44b7b1c28a01f8d3b3","0e0b36e731a645e7b1b8a88f5031ca38",22854917,1,2,0,1329,299,301,2
"0e0b36e731a645e7b1b8a88f5031ca38","0e0b36e731a645e7b1b8a88f5031ca38",22854917,8,0,1,1330,301,301,0
"0e0b36e731a645e7b1b8a88f5031ca38","a66a144637284c21afc6de17fea4bfb8",22854917,1,1,0,1338,301,302,1
"a66a144637284c21afc6de17fea4bfb8","a66a144637284c21afc6de17fea4bfb8",22854917,8,0,1,1339,302,302,0
"a66a144637284c21afc6de17fea4bfb8","7646a919d7e64fa990bca9b024ff089d",22854917,1,-4,0,1347,302,298,-4
"7646a919d7e64fa990bca9b024ff089d","b7719e26494940efa49512aedd0aac79",22854917,1,-383,0,1348,298,20,-278
"a49d1bb4328949299686242fd0be5584","d4c3b003e8274e429d2fa688d73fde6d",22854917,3,1,0,1351,21,22,1
"d4c3b003e8274e429d2fa688d73fde6d","5bc03c8f16354d04bd51f5bb93559ad3",22854917,1,4,0,1352,22,26,4
"5bc03c8f16354d04bd51f5bb93559ad3","2c5bb2cbd0014420ad8c95d40e38efd1",22854917,1,382,0,1353,26,303,277
"2c5bb2cbd0014420ad8c95d40e38efd1","4a29443515bb404cb8924e1c60a63b73",22854917,1,-23,0,1354,303,285,-18
"4a29443515bb404cb8924e1c60a63b73","e390b575229748ea8aac9364efe2bf00",22854917,1,24,0,1355,285,304,19
"e390b575229748ea8aac9364efe2bf00","e390b575229748ea8aac9364efe2bf00",22854917,1,0,1,1356,304,304,0
"e390b575229748ea8aac9364efe2bf00","3434c10e561d488a914e0f7d71907abd",22854917,1,3,0,1357,304,305,1
"3434c10e561d488a914e0f7d71907abd","4a29443515bb404cb8924e1c60a63b73",22854917,3,-27,0,1358,305,285,-20
"4a29443515bb404cb8924e1c60a63b73","53e7e900392747ccad52e711ab0f80d8",22854917,1,29,0,1359,285,307,22
"53e7e900392747ccad52e711ab0f80d8","b7719e26494940efa49512aedd0aac79",22854917,1,-395,0,1360,307,20,-287
"b7719e26494940efa49512aedd0aac79","4a29443515bb404cb8924e1c60a63b73",22854917,1,366,0,1361,20,285,265
"4a29443515bb404cb8924e1c60a63b73","4a29443515bb404cb8924e1c60a63b73",22854917,4,0,1,1362,285,285,0
"4a29443515bb404cb8924e1c60a63b73","3434c10e561d488a914e0f7d71907abd",22854917,4,27,0,1363,285,305,20
"3434c10e561d488a914e0f7d71907abd","3434c10e561d488a914e0f7d71907abd",22854917,1,0,1,1369,305,305,0
"3434c10e561d488a914e0f7d71907abd","9c062b3251034ebe90f5054e2a3b5120",22854917,1,7,0,1370,305,311,6
"9c062b3251034ebe90f5054e2a3b5120","9c062b3251034ebe90f5054e2a3b5120",22854917,2,0,1,1371,311,311,0
"9c062b3251034ebe90f5054e2a3b5120","56d94971a7a94257aa330183a8ebd0ea",22854917,1,2,0,1373,311,313,2
"56d94971a7a94257aa330183a8ebd0ea","56d94971a7a94257aa330183a8ebd0ea",22854917,1,0,1,1374,313,313,0
"56d94971a7a94257aa330183a8ebd0ea","141c0df6cd1946539aadd1c9b7068cd4",22854917,1,-5,0,1375,313,308,-5
"141c0df6cd1946539aadd1c9b7068cd4","13255e63e0aa4abf85e5211bf613d43e",22854917,1,10,0,1376,308,317,9
"13255e63e0aa4abf85e5211bf613d43e","13255e63e0aa4abf85e5211bf613d43e",22854917,1,0,1,1377,317,317,0
"13255e63e0aa4abf85e5211bf613d43e","0c787d16c9504873b1a4d903cec09948",22854917,1,-3,0,1378,317,314,-3
"0c787d16c9504873b1a4d903cec09948","47edbb64109243e6b0f8f64cdef90c6c",22854917,1,14,0,1379,314,326,12
"47edbb64109243e6b0f8f64cdef90c6c","8d7e0b55cf9849cda222a0f2440cec55",22854917,1,-9,0,1380,326,318,-8
"8d7e0b55cf9849cda222a0f2440cec55","3628bdce1dd2429ba924d2d4d09448d2",22854917,1,5,0,1381,318,322,4
"3628bdce1dd2429ba924d2d4d09448d2","56b3fd1a212a4764be39d979fde3326e",22854917,1,7,0,1382,322,328,6
"56b3fd1a212a4764be39d979fde3326e","56b3fd1a212a4764be39d979fde3326e",22854917,1,0,1,1383,328,328,0
"56b3fd1a212a4764be39d979fde3326e","3434c10e561d488a914e0f7d71907abd",22854917,1,-28,0,1384,328,305,-23
"3434c10e561d488a914e0f7d71907abd","0c4079457ede49e3aeb5e86ed84bdf35",22854917,2,31,0,1385,305,329,24
"0c4079457ede49e3aeb5e86ed84bdf35","0c4079457ede49e3aeb5e86ed84bdf35",22854917,3,0,1,1386,329,329,0
"0c4079457ede49e3aeb5e86ed84bdf35","fab84b4fab5940efb4ea868ef8d09396",22854917,1,-62,0,1388,329,284,-45
"fab84b4fab5940efb4ea868ef8d09396","0c4079457ede49e3aeb5e86ed84bdf35",22854917,1,62,0,1390,284,329,45
"0c4079457ede49e3aeb5e86ed84bdf35","e36d261332f14e79bb4b467aceaeb9b5",22854917,1,4,0,1391,329,333,4
"e36d261332f14e79bb4b467aceaeb9b5","e36d261332f14e79bb4b467aceaeb9b5",22854917,1,0,1,1392,333,333,0
"e36d261332f14e79bb4b467aceaeb9b5","c7e89b9d04744d2eab742fc24e3ef1ae",22854917,1,1,0,1393,333,334,1
"c7e89b9d04744d2eab742fc24e3ef1ae","c7e89b9d04744d2eab742fc24e3ef1ae",22854917,2,0,1,1394,334,334,0
"c7e89b9d04744d2eab742fc24e3ef1ae","fe49f8054b374a0ea4bb266ed135ff62",22854917,1,1,0,1396,334,335,1
"fe49f8054b374a0ea4bb266ed135ff62","fe49f8054b374a0ea4bb266ed135ff62",22854917,2,0,1,1397,335,335,0
"fe49f8054b374a0ea4bb266ed135ff62","d0a8f74af98642fe8360d22c42e45117",22854917,1,1,0,1399,335,336,1
"d0a8f74af98642fe8360d22c42e45117","d0a8f74af98642fe8360d22c42e45117",22854917,2,0,1,1400,336,336,0
"d0a8f74af98642fe8360d22c42e45117","0c4079457ede49e3aeb5e86ed84bdf35",22854917,1,-7,0,1402,336,329,-7
"0c4079457ede49e3aeb5e86ed84bdf35","a7c6339ca1da4368a18d471f0519f877",22854917,1,11,0,1403,329,339,10
"a7c6339ca1da4368a18d471f0519f877","a7c6339ca1da4368a18d471f0519f877",22854917,1,0,1,1404,339,339,0
"a7c6339ca1da4368a18d471f0519f877","b8b9418ab322418d9db9b40d96af873a",22854917,1,-2,0,1405,339,337,-2
"b8b9418ab322418d9db9b40d96af873a","4ee6ca9019ab4a1ab323f98094a9bd77",22854917,1,7,0,1406,337,343,6
"4ee6ca9019ab4a1ab323f98094a9bd77","4ee6ca9019ab4a1ab323f98094a9bd77",22854917,2,0,1,1407,343,343,0
"4ee6ca9019ab4a1ab323f98094a9bd77","b37947176785476f8b29d49a851366dc",22854917,1,1,0,1409,343,344,1
"b37947176785476f8b29d49a851366dc","b37947176785476f8b29d49a851366dc",22854917,2,0,1,1410,344,344,0
"b37947176785476f8b29d49a851366dc","fcea5b10d5a14a3b9324ffece8f6e1e5",22854917,1,1,0,1412,344,345,1
"fcea5b10d5a14a3b9324ffece8f6e1e5","fcea5b10d5a14a3b9324ffece8f6e1e5",22854917,2,0,1,1413,345,345,0
"fcea5b10d5a14a3b9324ffece8f6e1e5","c2490bc612d146edbe786556fab3651b",22854917,1,-5,0,1415,345,340,-5
"c2490bc612d146edbe786556fab3651b","6ac8bb048b854999a47edb35fe627f11",22854917,1,8,0,1416,340,347,7
"6ac8bb048b854999a47edb35fe627f11","6ac8bb048b854999a47edb35fe627f11",22854917,1,0,1,1417,347,347,0
"6ac8bb048b854999a47edb35fe627f11","0c4079457ede49e3aeb5e86ed84bdf35",22854917,1,-21,0,1418,347,329,-18
"0c4079457ede49e3aeb5e86ed84bdf35","30ead9794d4847abaf222ca966cc8630",22854917,1,24,0,1419,329,348,19
"30ead9794d4847abaf222ca966cc8630","c20993c944444fe085345591a8bd837e",22854917,2,3,0,1420,348,351,3
"c20993c944444fe085345591a8bd837e","897b7f51242c44aab2205c72fdcbf4cd",22854917,4,1,0,1421,351,352,1
"897b7f51242c44aab2205c72fdcbf4cd","eff0de7f2dbb42dfa1a2e686efab5b6d",22854917,3,2,0,1422,352,354,2
"eff0de7f2dbb42dfa1a2e686efab5b6d","09b9678ddc3d452ea4a3d46e15826065",22854917,3,-1,0,1423,354,353,-1
"09b9678ddc3d452ea4a3d46e15826065","30ead9794d4847abaf222ca966cc8630",22854917,1,-5,0,1424,353,348,-5
"09b9678ddc3d452ea4a3d46e15826065","c20993c944444fe085345591a8bd837e",22854917,1,-2,0,1429,353,351,-2
"c20993c944444fe085345591a8bd837e","c20993c944444fe085345591a8bd837e",22854917,4,0,1,1430,351,351,0
"897b7f51242c44aab2205c72fdcbf4cd","897b7f51242c44aab2205c72fdcbf4cd",22854917,4,0,1,1434,352,352,0
"897b7f51242c44aab2205c72fdcbf4cd","09b9678ddc3d452ea4a3d46e15826065",22854917,1,1,0,1437,352,353,1
"09b9678ddc3d452ea4a3d46e15826065","09b9678ddc3d452ea4a3d46e15826065",22854917,4,0,1,1438,353,353,0
"09b9678ddc3d452ea4a3d46e15826065","eff0de7f2dbb42dfa1a2e686efab5b6d",22854917,2,1,0,1441,353,354,1
"eff0de7f2dbb42dfa1a2e686efab5b6d","eff0de7f2dbb42dfa1a2e686efab5b6d",22854917,4,0,1,1442,354,354,0
"eff0de7f2dbb42dfa1a2e686efab5b6d","30ead9794d4847abaf222ca966cc8630",22854917,2,-6,0,1445,354,348,-6
"30ead9794d4847abaf222ca966cc8630","44421dd1e13a47a388c4a19834b744c7",22854917,1,12,0,1446,348,359,11
"44421dd1e13a47a388c4a19834b744c7","44421dd1e13a47a388c4a19834b744c7",22854917,2,0,1,1447,359,359,0
"44421dd1e13a47a388c4a19834b744c7","cb5fc7ef85d547c4be1a7439d0bf6052",22854917,1,1,0,1449,359,360,1
"cb5fc7ef85d547c4be1a7439d0bf6052","cb5fc7ef85d547c4be1a7439d0bf6052",22854917,2,0,1,1450,360,360,0
"cb5fc7ef85d547c4be1a7439d0bf6052","0a8f150a4cf747acbde62f4721823da3",22854917,1,1,0,1452,360,361,1
"0a8f150a4cf747acbde62f4721823da3","0a8f150a4cf747acbde62f4721823da3",22854917,2,0,1,1453,361,361,0
"0a8f150a4cf747acbde62f4721823da3","ab8fdad974ae471f9f24c3f9dd04462e",22854917,1,1,0,1455,361,362,1
"ab8fdad974ae471f9f24c3f9dd04462e","ab8fdad974ae471f9f24c3f9dd04462e",22854917,2,0,1,1456,362,362,0
"ab8fdad974ae471f9f24c3f9dd04462e","1ba8fef685d74a8194b9db252eb704fb",22854917,1,-7,0,1458,362,355,-7
"1ba8fef685d74a8194b9db252eb704fb","52580888dadb4fe3baa795683ea227bd",22854917,1,10,0,1459,355,364,9
"52580888dadb4fe3baa795683ea227bd","30ead9794d4847abaf222ca966cc8630",22854917,1,-18,0,1460,364,348,-16
"30ead9794d4847abaf222ca966cc8630","1ba8fef685d74a8194b9db252eb704fb",22854917,2,8,0,1461,348,355,7
"1ba8fef685d74a8194b9db252eb704fb","f00179e251a045b39c3f7a54f9aa4acc",22854917,2,9,0,1462,355,363,8
"f00179e251a045b39c3f7a54f9aa4acc","072a190fd302456290895f9f04d6940a",22854917,1,3,0,1463,363,365,2
"072a190fd302456290895f9f04d6940a","c76574d21bc14aeea7ecd0b027f39858",22854917,1,3,0,1464,365,367,2
"c76574d21bc14aeea7ecd0b027f39858","c20993c944444fe085345591a8bd837e",22854917,1,-20,0,1465,367,351,-16
"09b9678ddc3d452ea4a3d46e15826065","897b7f51242c44aab2205c72fdcbf4cd",22854917,1,-1,0,1469,353,352,-1
"897b7f51242c44aab2205c72fdcbf4cd","c20993c944444fe085345591a8bd837e",22854917,1,-1,0,1471,352,351,-1
"c20993c944444fe085345591a8bd837e","09b9678ddc3d452ea4a3d46e15826065",22854917,1,2,0,1473,351,353,2
"f00179e251a045b39c3f7a54f9aa4acc","cfa457d1743848e4bb5e4beced6448ed",22854917,1,8,0,1480,363,369,6
"cfa457d1743848e4bb5e4beced6448ed","cfa457d1743848e4bb5e4beced6448ed",22854917,1,0,1,1481,369,369,0
"cfa457d1743848e4bb5e4beced6448ed","30ead9794d4847abaf222ca966cc8630",22854917,1,-25,0,1482,369,348,-21
"30ead9794d4847abaf222ca966cc8630","b71bac264efb4abd97015447bd490db6",22854917,1,28,0,1483,348,370,22
"b71bac264efb4abd97015447bd490db6","b71bac264efb4abd97015447bd490db6",22854917,2,0,1,1484,370,370,0
"b71bac264efb4abd97015447bd490db6","8d448d625b024c82a5eb240bbd7431d6",22854917,8,5,0,1485,370,374,4
"8d448d625b024c82a5eb240bbd7431d6","8d448d625b024c82a5eb240bbd7431d6",22854917,96,0,1,1486,374,374,0
"8d448d625b024c82a5eb240bbd7431d6","1b4550d0dab04078b3bf08a655345bdc",22854917,2,-1,0,1493,374,373,-1
"1b4550d0dab04078b3bf08a655345bdc","1b4550d0dab04078b3bf08a655345bdc",22854917,1,0,1,1494,373,373,0
"1b4550d0dab04078b3bf08a655345bdc","b71bac264efb4abd97015447bd490db6",22854917,4,-4,0,1495,373,370,-3
"8d448d625b024c82a5eb240bbd7431d6","b71bac264efb4abd97015447bd490db6",22854917,4,-5,0,1513,374,370,-4
"b71bac264efb4abd97015447bd490db6","d6d02b6ef04e4f17805504500b8ce441",22854917,2,8,0,1514,370,375,5
"d6d02b6ef04e4f17805504500b8ce441","8d448d625b024c82a5eb240bbd7431d6",22854917,1,-3,0,1515,375,374,-1
"8d448d625b024c82a5eb240bbd7431d6","d6d02b6ef04e4f17805504500b8ce441",22854917,1,3,0,1516,374,375,1
"d6d02b6ef04e4f17805504500b8ce441","d6d02b6ef04e4f17805504500b8ce441",22854917,4,0,1,1517,375,375,0
"d6d02b6ef04e4f17805504500b8ce441","4a29443515bb404cb8924e1c60a63b73",22854917,1,-118,0,1518,375,285,-90
"4a29443515bb404cb8924e1c60a63b73","d6d02b6ef04e4f17805504500b8ce441",22854917,1,118,0,1519,285,375,90
"d6d02b6ef04e4f17805504500b8ce441","1b4550d0dab04078b3bf08a655345bdc",22854917,2,-4,0,1522,375,373,-2
"8d448d625b024c82a5eb240bbd7431d6","4a29443515bb404cb8924e1c60a63b73",22854917,1,-115,0,1532,374,285,-89
"4a29443515bb404cb8924e1c60a63b73","6a9a3b5bde4a48daa896fe8c06eca56f",22854917,1,5,0,1538,285,289,4
"869e967078f04da18dd0b0b9389a7424","34a6e49023fc4465bd5ca604330bbd1c",22854917,1,-1,0,1541,293,292,-1
"34a6e49023fc4465bd5ca604330bbd1c","ba0e59461bfb4a44b7b1c28a01f8d3b3",22854917,1,9,0,1542,292,299,7
"ba0e59461bfb4a44b7b1c28a01f8d3b3","21592f2a9e9c4b2f8c66ec5dbcbf6a2b",22854917,1,-4,0,1543,299,296,-3
"7646a919d7e64fa990bca9b024ff089d","4a29443515bb404cb8924e1c60a63b73",22854917,1,-17,0,1546,298,285,-13
"3434c10e561d488a914e0f7d71907abd","53e7e900392747ccad52e711ab0f80d8",22854917,1,2,0,1548,305,307,2
"53e7e900392747ccad52e711ab0f80d8","53e7e900392747ccad52e711ab0f80d8",22854917,1,0,1,1549,307,307,0
"53e7e900392747ccad52e711ab0f80d8","130acc2aeb0448fdbb2de63bc5cebe5b",22854917,1,3,0,1550,307,309,2
"130acc2aeb0448fdbb2de63bc5cebe5b","3434c10e561d488a914e0f7d71907abd",22854917,1,-5,0,1551,309,305,-4
"3434c10e561d488a914e0f7d71907abd","130acc2aeb0448fdbb2de63bc5cebe5b",22854917,1,5,0,1552,305,309,4
"130acc2aeb0448fdbb2de63bc5cebe5b","141c0df6cd1946539aadd1c9b7068cd4",22854917,1,-1,0,1553,309,308,-1
"141c0df6cd1946539aadd1c9b7068cd4","86c27d40179e419c8e9d150fb6afa5d0",22854917,1,13,0,1554,308,319,11
"86c27d40179e419c8e9d150fb6afa5d0","0c787d16c9504873b1a4d903cec09948",22854917,1,-6,0,1555,319,314,-5
"0c787d16c9504873b1a4d903cec09948","8d7e0b55cf9849cda222a0f2440cec55",22854917,1,5,0,1556,314,318,4
"8d7e0b55cf9849cda222a0f2440cec55","47edbb64109243e6b0f8f64cdef90c6c",22854917,1,9,0,1557,318,326,8
"47edbb64109243e6b0f8f64cdef90c6c","24f1363179ad4aaa965484a78471912b",22854917,1,-3,0,1558,326,323,-3
"24f1363179ad4aaa965484a78471912b","3628bdce1dd2429ba924d2d4d09448d2",22854917,1,-1,0,1559,323,322,-1
"3628bdce1dd2429ba924d2d4d09448d2","3434c10e561d488a914e0f7d71907abd",22854917,1,-21,0,1560,322,305,-17
"0c4079457ede49e3aeb5e86ed84bdf35","38aea304b4fa46e1b29bb72f5cea4c93",22854917,2,2,0,1562,329,331,2
"38aea304b4fa46e1b29bb72f5cea4c93","38aea304b4fa46e1b29bb72f5cea4c93",22854917,5,0,1,1563,331,331,0
"38aea304b4fa46e1b29bb72f5cea4c93","0c4079457ede49e3aeb5e86ed84bdf35",22854917,1,-2,0,1565,331,329,-2
"38aea304b4fa46e1b29bb72f5cea4c93","4a29443515bb404cb8924e1c60a63b73",22854917,1,-60,0,1571,331,285,-46
"4a29443515bb404cb8924e1c60a63b73","b71bac264efb4abd97015447bd490db6",22854917,1,110,0,1572,285,370,85
"8d448d625b024c82a5eb240bbd7431d6","bc5524e78a8544e2ae2fdc2f3462bbec",22854917,1,-128,0,1654,374,279,-95
"bb5a47f5ea01454a8b79455422d3b9da","66baf19b6b904b70922329068c63746d",22854917,1,134,0,1699,280,376,96
"66baf19b6b904b70922329068c63746d","66baf19b6b904b70922329068c63746d",22854917,1,0,1,1700,376,376,0
"66baf19b6b904b70922329068c63746d","7f544639412e40a9ba27f43b415362ab",22854917,1,2,0,1701,376,378,2
"7f544639412e40a9ba27f43b415362ab","7f544639412e40a9ba27f43b415362ab",22854917,13,0,1,1702,378,378,0
"7f544639412e40a9ba27f43b415362ab","d5ae8642e15b46b8bd298b02274d4e9c",22854917,1,2,0,1715,378,380,2
"d5ae8642e15b46b8bd298b02274d4e9c","d5ae8642e15b46b8bd298b02274d4e9c",22854917,1,0,1,1716,380,380,0
"d5ae8642e15b46b8bd298b02274d4e9c","a0d10309a2dd456289147f84be9d37f9",22854917,1,1,0,1717,380,381,1
"a0d10309a2dd456289147f84be9d37f9","a0d10309a2dd456289147f84be9d37f9",22854917,2,0,1,1718,381,381,0
"a0d10309a2dd456289147f84be9d37f9","0fcbc3ca07b144138b8d85da581f09a8",22854917,1,1,0,1720,381,382,1
"0fcbc3ca07b144138b8d85da581f09a8","0fcbc3ca07b144138b8d85da581f09a8",22854917,2,0,1,1721,382,382,0
"0fcbc3ca07b144138b8d85da581f09a8","66baf19b6b904b70922329068c63746d",22854917,1,-6,0,1723,382,376,-6
"66baf19b6b904b70922329068c63746d","c2fca3669923477ab966ded303dea31c",22854917,1,8,0,1724,376,383,7
"c2fca3669923477ab966ded303dea31c","4890121ce5d74576b4632b77cfc23398",22854917,1,6,0,1725,383,388,5
"4890121ce5d74576b4632b77cfc23398","4890121ce5d74576b4632b77cfc23398",22854917,2,0,1,1726,388,388,0
"4890121ce5d74576b4632b77cfc23398","18d3b836dd804224883cc9180b60a8e1",22854917,1,-1,0,1728,388,387,-1
"18d3b836dd804224883cc9180b60a8e1","96bb2b3e85a34d8b9544514e89f6fe97",22854917,1,4,0,1729,387,390,3
"96bb2b3e85a34d8b9544514e89f6fe97","96bb2b3e85a34d8b9544514e89f6fe97",22854917,1,0,1,1730,390,390,0
"96bb2b3e85a34d8b9544514e89f6fe97","ac4e9b54acfe4670b4634859c7263cb5",22854917,1,2,0,1731,390,392,2
"ac4e9b54acfe4670b4634859c7263cb5","ac4e9b54acfe4670b4634859c7263cb5",22854917,3,0,1,1732,392,392,0
"ac4e9b54acfe4670b4634859c7263cb5","17f95d18bab743888e1736033dc3384d",22854917,1,-3,0,1735,392,389,-3
"17f95d18bab743888e1736033dc3384d","6f8881a745ac4c358a68b92c3b4abe81",22854917,1,6,0,1736,389,394,5
"6f8881a745ac4c358a68b92c3b4abe81","6f8881a745ac4c358a68b92c3b4abe81",22854917,5,0,1,1737,394,394,0
"6f8881a745ac4c358a68b92c3b4abe81","f7002c8484354eceac57bc7bd62c76c1",22854917,1,-1,0,1742,394,393,-1
"f7002c8484354eceac57bc7bd62c76c1","44a277ea44dc4ae689fab4b82f0b4098",22854917,1,5,0,1743,393,397,4
"44a277ea44dc4ae689fab4b82f0b4098","44a277ea44dc4ae689fab4b82f0b4098",22854917,1,0,1,1744,397,397,0
"44a277ea44dc4ae689fab4b82f0b4098","0c12af0a4e7f4002852cf84b2537c161",22854917,1,-2,0,1745,397,395,-2
"0c12af0a4e7f4002852cf84b2537c161","859e0b8d71694b12befb69ee698138f9",22854917,1,5,0,1746,395,399,4
"859e0b8d71694b12befb69ee698138f9","859e0b8d71694b12befb69ee698138f9",22854917,7,0,1,1747,399,399,0
"859e0b8d71694b12befb69ee698138f9","2b09a08242b54983aec7063990fb3f66",22854917,1,3,0,1754,399,400,1
"2b09a08242b54983aec7063990fb3f66","66baf19b6b904b70922329068c63746d",22854917,1,-32,0,1755,400,376,-24
"66baf19b6b904b70922329068c63746d","2b09a08242b54983aec7063990fb3f66",22854917,1,32,0,1756,376,400,24
"2b09a08242b54983aec7063990fb3f66","2b09a08242b54983aec7063990fb3f66",22854917,12,0,1,1757,400,400,0
"2b09a08242b54983aec7063990fb3f66","1f471b7a883a4df48211e8c6a81b59a7",22854917,1,1,0,1769,400,401,1
"1f471b7a883a4df48211e8c6a81b59a7","1f471b7a883a4df48211e8c6a81b59a7",22854917,1,0,1,1770,401,401,0
"1f471b7a883a4df48211e8c6a81b59a7","2b09a08242b54983aec7063990fb3f66",22854917,1,-1,0,1771,401,400,-1
"2b09a08242b54983aec7063990fb3f66","9de0d567bfa84fe5b77cb76f4a76a5d1",22854917,1,5,0,1772,400,404,4
"9de0d567bfa84fe5b77cb76f4a76a5d1","9de0d567bfa84fe5b77cb76f4a76a5d1",22854917,1,0,1,1773,404,404,0
"9de0d567bfa84fe5b77cb76f4a76a5d1","1157bd665ec4472fb58b751dc5099355",22854917,1,-1,0,1774,404,403,-1
"1157bd665ec4472fb58b751dc5099355","58fc9094275e4c49be3f4ba6d4acc0a4",22854917,1,5,0,1775,403,406,3
"58fc9094275e4c49be3f4ba6d4acc0a4","3c8a22d2f9c146ea956609e3ed4f2559",22854917,1,-2,0,1776,406,405,-1
"3c8a22d2f9c146ea956609e3ed4f2559","58fc9094275e4c49be3f4ba6d4acc0a4",22854917,1,2,0,1777,405,406,1
"58fc9094275e4c49be3f4ba6d4acc0a4","58fc9094275e4c49be3f4ba6d4acc0a4",22854917,3,0,1,1778,406,406,0
"58fc9094275e4c49be3f4ba6d4acc0a4","c1c1be90b2b14c1ab4a5e1ee3c241902",22854917,1,1,0,1781,406,407,1
"c1c1be90b2b14c1ab4a5e1ee3c241902","c1c1be90b2b14c1ab4a5e1ee3c241902",22854917,5,0,1,1782,407,407,0
"c1c1be90b2b14c1ab4a5e1ee3c241902","02b3a1bead9244c1ba2f857c7da8f82a",22854917,1,2,0,1787,407,408,1
"02b3a1bead9244c1ba2f857c7da8f82a","58fc9094275e4c49be3f4ba6d4acc0a4",22854917,1,-3,0,1788,408,406,-2
"58fc9094275e4c49be3f4ba6d4acc0a4","02b3a1bead9244c1ba2f857c7da8f82a",22854917,1,3,0,1789,406,408,2
"02b3a1bead9244c1ba2f857c7da8f82a","02b3a1bead9244c1ba2f857c7da8f82a",22854917,1,0,1,1790,408,408,0
"02b3a1bead9244c1ba2f857c7da8f82a","6206fc6479014bb193084c32409dc1b9",22854917,1,1,0,1791,408,409,1
"6206fc6479014bb193084c32409dc1b9","6206fc6479014bb193084c32409dc1b9",22854917,1,0,1,1792,409,409,0
"6206fc6479014bb193084c32409dc1b9","02b3a1bead9244c1ba2f857c7da8f82a",22854917,1,-1,0,1793,409,408,-1
"02b3a1bead9244c1ba2f857c7da8f82a","6a5f020451db426dacba9e2ea3fcc62a",22854917,1,3,0,1794,408,410,2
"6a5f020451db426dacba9e2ea3fcc62a","6a5f020451db426dacba9e2ea3fcc62a",22854917,4,0,1,1795,410,410,0
"6a5f020451db426dacba9e2ea3fcc62a","33a9d248b2e44588a5b07fc1342b9bc2",22854917,2,2,0,1799,410,411,1
"33a9d248b2e44588a5b07fc1342b9bc2","6a5f020451db426dacba9e2ea3fcc62a",22854917,1,-2,0,1800,411,410,-1
"33a9d248b2e44588a5b07fc1342b9bc2","33a9d248b2e44588a5b07fc1342b9bc2",22854917,8,0,1,1802,411,411,0
"33a9d248b2e44588a5b07fc1342b9bc2","c6f26bd420634f1cb7989e76fe6b16c0",22854917,1,1,0,1810,411,412,1
"c6f26bd420634f1cb7989e76fe6b16c0","c6f26bd420634f1cb7989e76fe6b16c0",22854917,5,0,1,1811,412,412,0
"c6f26bd420634f1cb7989e76fe6b16c0","2a65ee6e2ac64f6a8a55fbe5373ec763",22854917,1,1,0,1816,412,413,1
"2a65ee6e2ac64f6a8a55fbe5373ec763","2a65ee6e2ac64f6a8a55fbe5373ec763",22854917,2,0,1,1817,413,413,0
"2a65ee6e2ac64f6a8a55fbe5373ec763","33a9d248b2e44588a5b07fc1342b9bc2",22854917,1,-2,0,1819,413,411,-2
"33a9d248b2e44588a5b07fc1342b9bc2","1fd0f6dadbc14ebc965faf6122190b96",22854917,1,5,0,1820,411,415,4
"1fd0f6dadbc14ebc965faf6122190b96","1fd0f6dadbc14ebc965faf6122190b96",22854917,1,0,1,1821,415,415,0
"1fd0f6dadbc14ebc965faf6122190b96","687055dad9fc40c3982478fe33ec01bf",22854917,1,-1,0,1822,415,414,-1
"687055dad9fc40c3982478fe33ec01bf","2add1669f08d4101913db15f8c23b3b7",22854917,1,3,0,1823,414,416,2
"2add1669f08d4101913db15f8c23b3b7","2add1669f08d4101913db15f8c23b3b7",22854917,3,0,1,1824,416,416,0
"2add1669f08d4101913db15f8c23b3b7","a2b4bd40cee2481ebd3fc179d6a5cd62",22854917,1,3,0,1827,416,417,1
"a2b4bd40cee2481ebd3fc179d6a5cd62","2b09a08242b54983aec7063990fb3f66",22854917,1,-27,0,1828,417,400,-17
"2b09a08242b54983aec7063990fb3f66","e34e59dce2204f228f3a84b6725df60f",22854917,1,29,0,1829,400,419,19
"e34e59dce2204f228f3a84b6725df60f","e34e59dce2204f228f3a84b6725df60f",22854917,1,0,1,1830,419,419,0
"e34e59dce2204f228f3a84b6725df60f","a2b4bd40cee2481ebd3fc179d6a5cd62",22854917,1,-2,0,1831,419,417,-2
"a2b4bd40cee2481ebd3fc179d6a5cd62","bec48fc2e1294c7eb3d0aca780d731b8",22854917,1,4,0,1832,417,420,3
"bec48fc2e1294c7eb3d0aca780d731b8","bec48fc2e1294c7eb3d0aca780d731b8",22854917,5,0,1,1833,420,420,0
"bec48fc2e1294c7eb3d0aca780d731b8","a24600b0e49245f6bdba8c893cfeddb0",22854917,1,7,0,1838,420,425,5
"a24600b0e49245f6bdba8c893cfeddb0","dbde19fcce2a4c1abdc7f685c293a23f",22854917,1,-4,0,1839,425,422,-3
"dbde19fcce2a4c1abdc7f685c293a23f","a24600b0e49245f6bdba8c893cfeddb0",22854917,1,4,0,1840,422,425,3
"a24600b0e49245f6bdba8c893cfeddb0","a24600b0e49245f6bdba8c893cfeddb0",22854917,11,0,1,1841,425,425,0
"a24600b0e49245f6bdba8c893cfeddb0","a2b4bd40cee2481ebd3fc179d6a5cd62",22854917,1,-11,0,1852,425,417,-8
"a2b4bd40cee2481ebd3fc179d6a5cd62","24cf8786024543f19b89bc20034e60d7",22854917,1,18,0,1853,417,428,11
"24cf8786024543f19b89bc20034e60d7","f2a73be2f46840b182d7bd095378004e",22854917,1,1,0,1854,428,429,1
"f2a73be2f46840b182d7bd095378004e","f2a73be2f46840b182d7bd095378004e",22854917,3,0,1,1855,429,429,0
"f2a73be2f46840b182d7bd095378004e","604551fd4266430cb860fef58fa7dd61",22854917,1,1,0,1858,429,430,1
"604551fd4266430cb860fef58fa7dd61","604551fd4266430cb860fef58fa7dd61",22854917,1,0,1,1859,430,430,0
"604551fd4266430cb860fef58fa7dd61","dce46f8904594a62a6377a3587aaa663",22854917,1,2,0,1860,430,431,1
"dce46f8904594a62a6377a3587aaa663","24cf8786024543f19b89bc20034e60d7",22854917,3,-4,0,1861,431,428,-3
"24cf8786024543f19b89bc20034e60d7","dce46f8904594a62a6377a3587aaa663",22854917,3,4,0,1862,428,431,3
"dce46f8904594a62a6377a3587aaa663","dce46f8904594a62a6377a3587aaa663",22854917,13,0,1,1863,431,431,0
"dce46f8904594a62a6377a3587aaa663","9b9d0a249052413c869753b99682b0ac",22854917,1,1,0,1874,431,432,1
"9b9d0a249052413c869753b99682b0ac","9b9d0a249052413c869753b99682b0ac",22854917,3,0,1,1875,432,432,0
"9b9d0a249052413c869753b99682b0ac","061c175cc90f45fbad883025394e78dd",22854917,1,1,0,1878,432,433,1
"061c175cc90f45fbad883025394e78dd","061c175cc90f45fbad883025394e78dd",22854917,5,0,1,1879,433,433,0
"061c175cc90f45fbad883025394e78dd","dce46f8904594a62a6377a3587aaa663",22854917,1,-2,0,1884,433,431,-2
"dce46f8904594a62a6377a3587aaa663","74a7f8712e5449c2bc0b43c6f90dafed",22854917,1,5,0,1885,431,435,4
"74a7f8712e5449c2bc0b43c6f90dafed","74a7f8712e5449c2bc0b43c6f90dafed",22854917,1,0,1,1886,435,435,0
"74a7f8712e5449c2bc0b43c6f90dafed","66ada10dde9f43018588f1ced9d477fc",22854917,1,-1,0,1887,435,434,-1
"66ada10dde9f43018588f1ced9d477fc","bf12c96466d840a69bed7020b3f18bb8",22854917,1,3,0,1888,434,436,2
"bf12c96466d840a69bed7020b3f18bb8","bf12c96466d840a69bed7020b3f18bb8",22854917,1,0,1,1889,436,436,0
"bf12c96466d840a69bed7020b3f18bb8","24cf8786024543f19b89bc20034e60d7",22854917,1,-11,0,1890,436,428,-8
"24cf8786024543f19b89bc20034e60d7","070600601c4c439288445d2f0724807d",22854917,1,14,0,1891,428,437,9
"070600601c4c439288445d2f0724807d","1823b6de7d334a7aaabc4570719af4d9",22854917,1,2,0,1892,437,439,2
"1823b6de7d334a7aaabc4570719af4d9","1823b6de7d334a7aaabc4570719af4d9",22854917,12,0,1,1893,439,439,0
"1823b6de7d334a7aaabc4570719af4d9","0380cd76a7d44bc3a4da1f15e4d68f89",22854917,1,2,0,1905,439,440,1
"0380cd76a7d44bc3a4da1f15e4d68f89","070600601c4c439288445d2f0724807d",22854917,1,-4,0,1906,440,437,-3
"070600601c4c439288445d2f0724807d","0380cd76a7d44bc3a4da1f15e4d68f89",22854917,1,4,0,1907,437,440,3
"0380cd76a7d44bc3a4da1f15e4d68f89","0380cd76a7d44bc3a4da1f15e4d68f89",22854917,4,0,1,1908,440,440,0
"0380cd76a7d44bc3a4da1f15e4d68f89","23b7673c8b5443108c2ef09382834a86",22854917,1,2,0,1912,440,441,1
"23b7673c8b5443108c2ef09382834a86","23b7673c8b5443108c2ef09382834a86",22854917,4,0,1,1913,441,441,0
"23b7673c8b5443108c2ef09382834a86","901e92500aea43c79f19f1b279050668",22854917,2,2,0,1917,441,442,1
"901e92500aea43c79f19f1b279050668","23b7673c8b5443108c2ef09382834a86",22854917,1,-2,0,1918,442,441,-1
"901e92500aea43c79f19f1b279050668","001339db8ced4cf78829ebe8b145449d",22854917,1,1,0,1920,442,443,1
"001339db8ced4cf78829ebe8b145449d","001339db8ced4cf78829ebe8b145449d",22854917,5,0,1,1921,443,443,0
"001339db8ced4cf78829ebe8b145449d","452745e0366e42ae81561bfddebcc6c3",22854917,1,1,0,1926,443,444,1
"452745e0366e42ae81561bfddebcc6c3","452745e0366e42ae81561bfddebcc6c3",22854917,2,0,1,1927,444,444,0
"452745e0366e42ae81561bfddebcc6c3","901e92500aea43c79f19f1b279050668",22854917,1,-2,0,1929,444,442,-2
"901e92500aea43c79f19f1b279050668","4660ff2089114e8db82ceb26a4f329e3",22854917,1,4,0,1930,442,445,3
"4660ff2089114e8db82ceb26a4f329e3","4660ff2089114e8db82ceb26a4f329e3",22854917,2,0,1,1931,445,445,0
"4660ff2089114e8db82ceb26a4f329e3","7bd5586eb9d8484eb74a433ee7bfe499",22854917,1,2,0,1933,445,446,1
"7bd5586eb9d8484eb74a433ee7bfe499","7bd5586eb9d8484eb74a433ee7bfe499",22854917,9,0,1,1934,446,446,0
"7bd5586eb9d8484eb74a433ee7bfe499","8a7f26e690f34dda97be16904518ca99",22854917,1,2,0,1943,446,447,1
"8a7f26e690f34dda97be16904518ca99","8a7f26e690f34dda97be16904518ca99",22854917,1,0,1,1944,447,447,0
"8a7f26e690f34dda97be16904518ca99","b2f0d654738f48158edff28e8d3a546e",22854917,1,5,0,1945,447,449,2
"b2f0d654738f48158edff28e8d3a546e","070600601c4c439288445d2f0724807d",22854917,1,-21,0,1946,449,437,-12
"070600601c4c439288445d2f0724807d","b2f0d654738f48158edff28e8d3a546e",22854917,1,21,0,1947,437,449,12
"b2f0d654738f48158edff28e8d3a546e","f60ee41ec635499abd48168342d32c2f",22854917,3,5,0,1948,449,453,4
"f60ee41ec635499abd48168342d32c2f","f60ee41ec635499abd48168342d32c2f",22854917,65,0,1,1949,453,453,0
"f60ee41ec635499abd48168342d32c2f","9428d8bd9c5a47b2a235b254e5e27ded",22854917,1,-1,0,1956,453,452,-1
"9428d8bd9c5a47b2a235b254e5e27ded","f60ee41ec635499abd48168342d32c2f",22854917,1,1,0,1957,452,453,1
"f60ee41ec635499abd48168342d32c2f","b2f0d654738f48158edff28e8d3a546e",22854917,2,-5,0,1962,453,449,-4
"b2f0d654738f48158edff28e8d3a546e","f67fbf45a5f146ed866965bc57c7c001",22854917,2,8,0,2010,449,454,5
"f67fbf45a5f146ed866965bc57c7c001","f67fbf45a5f146ed866965bc57c7c001",22854917,2,0,1,2011,454,454,0
"f67fbf45a5f146ed866965bc57c7c001","d937afe49bd24a07a550dda1c1155122",22854917,1,1,0,2013,454,455,1
"d937afe49bd24a07a550dda1c1155122","d937afe49bd24a07a550dda1c1155122",22854917,1,0,1,2014,455,455,0
"d937afe49bd24a07a550dda1c1155122","3628b3f7823443d0912a339096b69943",22854917,1,1,0,2015,455,456,1
"3628b3f7823443d0912a339096b69943","3628b3f7823443d0912a339096b69943",22854917,1,0,1,2016,456,456,0
"3628b3f7823443d0912a339096b69943","9e049ee647cf43ecbcb5ed792a8e7588",22854917,1,1,0,2017,456,457,1
"9e049ee647cf43ecbcb5ed792a8e7588","9e049ee647cf43ecbcb5ed792a8e7588",22854917,1,0,1,2018,457,457,0
"9e049ee647cf43ecbcb5ed792a8e7588","5256a214faaf410b93f76cea06428334",22854917,1,1,0,2019,457,458,1
"5256a214faaf410b93f76cea06428334","5256a214faaf410b93f76cea06428334",22854917,1,0,1,2020,458,458,0
"5256a214faaf410b93f76cea06428334","25c32b120fce40fa9b6c85133aeb4716",22854917,1,1,0,2021,458,459,1
"25c32b120fce40fa9b6c85133aeb4716","25c32b120fce40fa9b6c85133aeb4716",22854917,1,0,1,2022,459,459,0
"25c32b120fce40fa9b6c85133aeb4716","11bc14f2204949008b7d511b933363c1",22854917,1,1,0,2023,459,460,1
"11bc14f2204949008b7d511b933363c1","11bc14f2204949008b7d511b933363c1",22854917,1,0,1,2024,460,460,0
"11bc14f2204949008b7d511b933363c1","42de338840a34d15adb66e7b14fb9d2c",22854917,1,1,0,2025,460,461,1
"42de338840a34d15adb66e7b14fb9d2c","42de338840a34d15adb66e7b14fb9d2c",22854917,1,0,1,2026,461,461,0
"42de338840a34d15adb66e7b14fb9d2c","9da37c6210b1416b8079c274f70bf600",22854917,1,1,0,2027,461,462,1
"9da37c6210b1416b8079c274f70bf600","9da37c6210b1416b8079c274f70bf600",22854917,1,0,1,2028,462,462,0
"9da37c6210b1416b8079c274f70bf600","519119f1deac45ff9ab4f13529be5c6e",22854917,1,1,0,2029,462,463,1
"519119f1deac45ff9ab4f13529be5c6e","519119f1deac45ff9ab4f13529be5c6e",22854917,1,0,1,2030,463,463,0
"519119f1deac45ff9ab4f13529be5c6e","c5df9f40ec14463b9dcfdc73df3e9285",22854917,1,3,0,2031,463,464,1
"c5df9f40ec14463b9dcfdc73df3e9285","f67fbf45a5f146ed866965bc57c7c001",22854917,1,-12,0,2032,464,454,-10
"f67fbf45a5f146ed866965bc57c7c001","c5df9f40ec14463b9dcfdc73df3e9285",22854917,2,12,0,2033,454,464,10
"c5df9f40ec14463b9dcfdc73df3e9285","b2f0d654738f48158edff28e8d3a546e",22854917,1,-20,0,2034,464,449,-15
"f60ee41ec635499abd48168342d32c2f","f67fbf45a5f146ed866965bc57c7c001",22854917,1,3,0,2045,453,454,1
"f67fbf45a5f146ed866965bc57c7c001","b2f0d654738f48158edff28e8d3a546e",22854917,1,-8,0,2046,454,449,-5
"c5df9f40ec14463b9dcfdc73df3e9285","c5df9f40ec14463b9dcfdc73df3e9285",22854917,3,0,1,2049,464,464,0
"c5df9f40ec14463b9dcfdc73df3e9285","83d42d95cd844fc093fc09cee250edb8",22854917,3,3,0,2051,464,465,1
"83d42d95cd844fc093fc09cee250edb8","83d42d95cd844fc093fc09cee250edb8",22854917,5,0,1,2052,465,465,0
"83d42d95cd844fc093fc09cee250edb8","c5df9f40ec14463b9dcfdc73df3e9285",22854917,2,-3,0,2055,465,464,-1
"83d42d95cd844fc093fc09cee250edb8","fab84b4fab5940efb4ea868ef8d09396",22854917,1,-261,0,2062,465,284,-181
"fab84b4fab5940efb4ea868ef8d09396","dce46f8904594a62a6377a3587aaa663",22854917,1,207,0,2063,284,431,147
"b613861cecf84ffcab01afb23f660475","b613861cecf84ffcab01afb23f660475",22855791,5,0,1,1,1,1,0
"b613861cecf84ffcab01afb23f660475","e2911e79efc2420eac45d9f671463d4b",22855791,1,3,0,5,1,2,1
"e2911e79efc2420eac45d9f671463d4b","e2911e79efc2420eac45d9f671463d4b",22855791,2,0,1,6,2,2,0
"e2911e79efc2420eac45d9f671463d4b","519d1b8c59404d67b54e96c5c8a830b2",22855791,1,1,0,8,2,3,1
"519d1b8c59404d67b54e96c5c8a830b2","519d1b8c59404d67b54e96c5c8a830b2",22855791,1,0,1,9,3,3,0
"519d1b8c59404d67b54e96c5c8a830b2","531db53f81f646edb0cdcfe0085b03b7",22855791,1,1,0,10,3,4,1
"531db53f81f646edb0cdcfe0085b03b7","531db53f81f646edb0cdcfe0085b03b7",22855791,1,0,1,11,4,4,0
"531db53f81f646edb0cdcfe0085b03b7","4f5f94b2f95141e0a9d53a61da2276da",22855791,1,1,0,12,4,5,1
"4f5f94b2f95141e0a9d53a61da2276da","4f5f94b2f95141e0a9d53a61da2276da",22855791,1,0,1,13,5,5,0
"4f5f94b2f95141e0a9d53a61da2276da","6d541c89590949f99af293c4f2333f67",22855791,1,1,0,14,5,6,1
"6d541c89590949f99af293c4f2333f67","6d541c89590949f99af293c4f2333f67",22855791,1,0,1,15,6,6,0
"6d541c89590949f99af293c4f2333f67","dd5cf0b9fe4c4f1d8f5ff8e4c04879cb",22855791,1,1,0,16,6,7,1
"dd5cf0b9fe4c4f1d8f5ff8e4c04879cb","dd5cf0b9fe4c4f1d8f5ff8e4c04879cb",22855791,1,0,1,17,7,7,0
"dd5cf0b9fe4c4f1d8f5ff8e4c04879cb","f96261861edc426abe2248be4f0a709a",22855791,1,1,0,18,7,8,1
"f96261861edc426abe2248be4f0a709a","f96261861edc426abe2248be4f0a709a",22855791,1,0,1,19,8,8,0
"f96261861edc426abe2248be4f0a709a","66b5e16f4f75454fb5b8172079f0fa83",22855791,1,1,0,20,8,9,1
"66b5e16f4f75454fb5b8172079f0fa83","66b5e16f4f75454fb5b8172079f0fa83",22855791,1,0,1,21,9,9,0
"66b5e16f4f75454fb5b8172079f0fa83","0680571d4698477995e41842c36a54b2",22855791,1,1,0,22,9,10,1
"0680571d4698477995e41842c36a54b2","0680571d4698477995e41842c36a54b2",22855791,1,0,1,23,10,10,0
"0680571d4698477995e41842c36a54b2","9112f2bffece48e08c6d2287be204085",22855791,1,1,0,24,10,11,1
"9112f2bffece48e08c6d2287be204085","9112f2bffece48e08c6d2287be204085",22855791,1,0,1,25,11,11,0
"9112f2bffece48e08c6d2287be204085","e2911e79efc2420eac45d9f671463d4b",22855791,1,-9,0,26,11,2,-9
"e2911e79efc2420eac45d9f671463d4b","56586aa865414f538729c7f7735d2bc6",22855791,1,12,0,27,2,12,10
"56586aa865414f538729c7f7735d2bc6","56586aa865414f538729c7f7735d2bc6",22855791,6,0,1,28,12,12,0
"56586aa865414f538729c7f7735d2bc6","b7f2b31585d94eb3bf86376714aa7070",22855791,1,2,0,34,12,13,1
"b7f2b31585d94eb3bf86376714aa7070","b7f2b31585d94eb3bf86376714aa7070",22855791,4,0,1,35,13,13,0
"b7f2b31585d94eb3bf86376714aa7070","3f1c815879794b929260d224becaff7e",22855791,1,2,0,39,13,14,1
"3f1c815879794b929260d224becaff7e","81c864a886d54a6b8ff85f7d736f4f95",22855791,1,2,0,40,14,15,1
"81c864a886d54a6b8ff85f7d736f4f95","3f1c815879794b929260d224becaff7e",22855791,1,-2,0,41,15,14,-1
"3f1c815879794b929260d224becaff7e","5c5ceeee4562457ba6d41515aeebfbb1",22855791,1,6,0,42,14,17,3
"5c5ceeee4562457ba6d41515aeebfbb1","81c864a886d54a6b8ff85f7d736f4f95",22855791,1,-4,0,43,17,15,-2
"81c864a886d54a6b8ff85f7d736f4f95","5c5ceeee4562457ba6d41515aeebfbb1",22855791,1,4,0,44,15,17,2
"5c5ceeee4562457ba6d41515aeebfbb1","5c5ceeee4562457ba6d41515aeebfbb1",22855791,2,0,1,45,17,17,0
"5c5ceeee4562457ba6d41515aeebfbb1","56586aa865414f538729c7f7735d2bc6",22855791,1,-10,0,47,17,12,-5
"56586aa865414f538729c7f7735d2bc6","9afd71a5298d4333b6849dfce1b9422c",22855791,1,13,0,48,12,18,6
"9afd71a5298d4333b6849dfce1b9422c","9afd71a5298d4333b6849dfce1b9422c",22855791,4,0,1,49,18,18,0
"9afd71a5298d4333b6849dfce1b9422c","b7719e26494940efa49512aedd0aac79",22855791,2,4,0,52,18,20,2
"b7719e26494940efa49512aedd0aac79","9afd71a5298d4333b6849dfce1b9422c",22855791,2,-4,0,53,20,18,-2
"9afd71a5298d4333b6849dfce1b9422c","d4f45188d3c84a02ba08454e6403a818",22855791,1,9,0,54,18,24,6
"d4f45188d3c84a02ba08454e6403a818","d4c3b003e8274e429d2fa688d73fde6d",22855791,2,-2,0,55,24,22,-2
"d4c3b003e8274e429d2fa688d73fde6d","b7719e26494940efa49512aedd0aac79",22855791,2,-3,0,56,22,20,-2
"b7719e26494940efa49512aedd0aac79","d4f45188d3c84a02ba08454e6403a818",22855791,1,5,0,60,20,24,4
"d4c3b003e8274e429d2fa688d73fde6d","d4c3b003e8274e429d2fa688d73fde6d",22855791,1,0,1,62,22,22,0
"b7719e26494940efa49512aedd0aac79","a49d1bb4328949299686242fd0be5584",22855791,1,2,0,64,20,21,1
"a49d1bb4328949299686242fd0be5584","d4c3b003e8274e429d2fa688d73fde6d",22855791,1,1,0,65,21,22,1
"d4c3b003e8274e429d2fa688d73fde6d","d4f45188d3c84a02ba08454e6403a818",22855791,1,2,0,66,22,24,2
"d4f45188d3c84a02ba08454e6403a818","a49d1bb4328949299686242fd0be5584",22855791,1,-3,0,67,24,21,-3
"a49d1bb4328949299686242fd0be5584","b7719e26494940efa49512aedd0aac79",22855791,1,-2,0,68,21,20,-1
"b7719e26494940efa49512aedd0aac79","afbf7250b99d47bea07172749483ca97",22855791,2,12,0,69,20,28,8
"afbf7250b99d47bea07172749483ca97","b7719e26494940efa49512aedd0aac79",22855791,1,-12,0,70,28,20,-8
"afbf7250b99d47bea07172749483ca97","4e51676dc72045d99c19b9fa7b22f8bc",22855791,2,3,0,72,28,29,1
"4e51676dc72045d99c19b9fa7b22f8bc","4e51676dc72045d99c19b9fa7b22f8bc",22855791,2,0,1,73,29,29,0
"51970cfa30e643e894e66ae85c8024cc","c33c17be71ae4d588da7369472e5bb1b",22855791,1,6,0,75,31,34,3
"c33c17be71ae4d588da7369472e5bb1b","4e51676dc72045d99c19b9fa7b22f8bc",22855791,1,-9,0,76,34,29,-5
"4e51676dc72045d99c19b9fa7b22f8bc","93679be414554a11b1893002f2229a93",22855791,1,12,0,77,29,35,6
"93679be414554a11b1893002f2229a93","c33c17be71ae4d588da7369472e5bb1b",22855791,1,-3,0,78,35,34,-1
"c33c17be71ae4d588da7369472e5bb1b","93679be414554a11b1893002f2229a93",22855791,1,3,0,79,34,35,1
"93679be414554a11b1893002f2229a93","7040a13096d746ac84b8fac8d9752058",22855791,1,3,0,80,35,36,1
"7040a13096d746ac84b8fac8d9752058","7040a13096d746ac84b8fac8d9752058",22855791,1,0,1,81,36,36,0
"7040a13096d746ac84b8fac8d9752058","9a0dc646f934470daf08c4b56ccf73db",22855791,1,3,0,82,36,37,1
"9a0dc646f934470daf08c4b56ccf73db","fc0e049d56024bc9a02c9a9c435c3df7",22855791,2,3,0,83,37,38,1
"fc0e049d56024bc9a02c9a9c435c3df7","9a0dc646f934470daf08c4b56ccf73db",22855791,1,-3,0,84,38,37,-1
"fc0e049d56024bc9a02c9a9c435c3df7","b613861cecf84ffcab01afb23f660475",22855791,1,-68,0,86,38,1,-37
"b613861cecf84ffcab01afb23f660475","4e51676dc72045d99c19b9fa7b22f8bc",22855791,1,47,0,88,1,29,28
"4e51676dc72045d99c19b9fa7b22f8bc","c33c17be71ae4d588da7369472e5bb1b",22855791,1,9,0,90,29,34,5
"c33c17be71ae4d588da7369472e5bb1b","afbf7250b99d47bea07172749483ca97",22855791,1,-12,0,93,34,28,-6
"afbf7250b99d47bea07172749483ca97","afbf7250b99d47bea07172749483ca97",22855791,2,0,1,94,28,28,0
"51970cfa30e643e894e66ae85c8024cc","51970cfa30e643e894e66ae85c8024cc",22855791,1,0,1,98,31,31,0
"51970cfa30e643e894e66ae85c8024cc","4e51676dc72045d99c19b9fa7b22f8bc",22855791,1,-3,0,99,31,29,-2
"4e51676dc72045d99c19b9fa7b22f8bc","51970cfa30e643e894e66ae85c8024cc",22855791,3,3,0,100,29,31,2
"51970cfa30e643e894e66ae85c8024cc","67a089198fcb4e1c8f2385786c2b296f",22855791,1,22,0,101,31,39,8
"67a089198fcb4e1c8f2385786c2b296f","67a089198fcb4e1c8f2385786c2b296f",22855791,4,0,1,102,39,39,0
"67a089198fcb4e1c8f2385786c2b296f","64d48c6c9c7940639a932219a6c87198",22855791,3,1,0,103,39,40,1
"64d48c6c9c7940639a932219a6c87198","67a089198fcb4e1c8f2385786c2b296f",22855791,2,-1,0,104,40,39,-1
"64d48c6c9c7940639a932219a6c87198","64d48c6c9c7940639a932219a6c87198",22855791,3,0,1,111,40,40,0
"64d48c6c9c7940639a932219a6c87198","b534b89233134e30a9b5645138bfa9ee",22855791,1,3,0,114,40,41,1
"b534b89233134e30a9b5645138bfa9ee","67a089198fcb4e1c8f2385786c2b296f",22855791,1,-4,0,115,41,39,-2
"67a089198fcb4e1c8f2385786c2b296f","0e37b720d23b4e7f8b313e79313fd107",22855791,1,7,0,116,39,44,5
"0e37b720d23b4e7f8b313e79313fd107","0e37b720d23b4e7f8b313e79313fd107",22855791,1,0,1,117,44,44,0
"0e37b720d23b4e7f8b313e79313fd107","6875d67fdd5f48168b62719df449bebd",22855791,1,1,0,118,44,45,1
"6875d67fdd5f48168b62719df449bebd","6875d67fdd5f48168b62719df449bebd",22855791,1,0,1,119,45,45,0
"6875d67fdd5f48168b62719df449bebd","6e13d61a7bdb44bca949c9f86fab3be5",22855791,1,3,0,120,45,47,2
"6e13d61a7bdb44bca949c9f86fab3be5","b534b89233134e30a9b5645138bfa9ee",22855791,1,-7,0,121,47,41,-6
"b534b89233134e30a9b5645138bfa9ee","6e13d61a7bdb44bca949c9f86fab3be5",22855791,1,7,0,122,41,47,6
"6e13d61a7bdb44bca949c9f86fab3be5","6e13d61a7bdb44bca949c9f86fab3be5",22855791,5,0,1,123,47,47,0
"6e13d61a7bdb44bca949c9f86fab3be5","195f78799f984cc2b06c48dfe36be751",22855791,1,2,0,128,47,49,2
"195f78799f984cc2b06c48dfe36be751","195f78799f984cc2b06c48dfe36be751",22855791,2,0,1,129,49,49,0
"195f78799f984cc2b06c48dfe36be751","d0c74f735e024943943e40333d6d337f",22855791,1,3,0,131,49,51,2
"d0c74f735e024943943e40333d6d337f","d9c8d8c444a64dadbbb508652c721e17",22855791,1,-6,0,132,51,46,-5
"d9c8d8c444a64dadbbb508652c721e17","d0c74f735e024943943e40333d6d337f",22855791,1,6,0,133,46,51,5
"d0c74f735e024943943e40333d6d337f","d0c74f735e024943943e40333d6d337f",22855791,2,0,1,134,51,51,0
"d0c74f735e024943943e40333d6d337f","983f8ff320594b279a7f4a6fe132f9c5",22855791,1,2,0,136,51,53,2
"983f8ff320594b279a7f4a6fe132f9c5","983f8ff320594b279a7f4a6fe132f9c5",22855791,5,0,1,137,53,53,0
"983f8ff320594b279a7f4a6fe132f9c5","35adfa5d923046aebabfefd98f35ff05",22855791,1,1,0,142,53,54,1
"35adfa5d923046aebabfefd98f35ff05","35adfa5d923046aebabfefd98f35ff05",22855791,5,0,1,143,54,54,0
"35adfa5d923046aebabfefd98f35ff05","b6f8a98476224da1b40e555ececc7ed8",22855791,1,1,0,148,54,55,1
"b6f8a98476224da1b40e555ececc7ed8","b6f8a98476224da1b40e555ececc7ed8",22855791,2,0,1,149,55,55,0
"b6f8a98476224da1b40e555ececc7ed8","86e22cb5fe0e4b47a9489ecddf7ed78f",22855791,1,1,0,151,55,56,1
"86e22cb5fe0e4b47a9489ecddf7ed78f","86e22cb5fe0e4b47a9489ecddf7ed78f",22855791,2,0,1,152,56,56,0
"86e22cb5fe0e4b47a9489ecddf7ed78f","f924752d8a1149668870b1e7698486f7",22855791,1,-6,0,154,56,50,-6
"f924752d8a1149668870b1e7698486f7","a1f2f12debe5432fb7a70bcd12bacfb9",22855791,1,9,0,155,50,58,8
"a1f2f12debe5432fb7a70bcd12bacfb9","78f30e4dcac84e3cbea8b2cc6e0d62b3",22855791,2,1,0,156,58,59,1
"78f30e4dcac84e3cbea8b2cc6e0d62b3","a1f2f12debe5432fb7a70bcd12bacfb9",22855791,1,-1,0,157,59,58,-1
"a1f2f12debe5432fb7a70bcd12bacfb9","a1f2f12debe5432fb7a70bcd12bacfb9",22855791,10,0,1,158,58,58,0
"78f30e4dcac84e3cbea8b2cc6e0d62b3","78f30e4dcac84e3cbea8b2cc6e0d62b3",22855791,7,0,1,169,59,59,0
"78f30e4dcac84e3cbea8b2cc6e0d62b3","12aa6e1672ac4e7aa6449a7a8609cd72",22855791,1,-2,0,176,59,57,-2
"12aa6e1672ac4e7aa6449a7a8609cd72","bc42d26810654ea9a1df1efe1e58c7d5",22855791,1,7,0,177,57,63,6
"bc42d26810654ea9a1df1efe1e58c7d5","a0a418b8540d479fa6e0f653b701da8b",22855791,2,1,0,178,63,64,1
"a0a418b8540d479fa6e0f653b701da8b","4c943503763e4e349906eea3ed3c8e86",22855791,1,-3,0,179,64,61,-3
"4c943503763e4e349906eea3ed3c8e86","4c943503763e4e349906eea3ed3c8e86",22855791,1,0,1,180,61,61,0
"4c943503763e4e349906eea3ed3c8e86","bc42d26810654ea9a1df1efe1e58c7d5",22855791,1,2,0,181,61,63,2
"bc42d26810654ea9a1df1efe1e58c7d5","bc42d26810654ea9a1df1efe1e58c7d5",22855791,3,0,1,182,63,63,0
"a0a418b8540d479fa6e0f653b701da8b","a0a418b8540d479fa6e0f653b701da8b",22855791,3,0,1,186,64,64,0
"a0a418b8540d479fa6e0f653b701da8b","309ccf3cc4fe429d9bfbaef53d3fa479",22855791,1,-4,0,189,64,60,-4
"309ccf3cc4fe429d9bfbaef53d3fa479","d646286c8051419bbc2e31dd1db55ca8",22855791,1,10,0,190,60,67,7
"d646286c8051419bbc2e31dd1db55ca8","b534b89233134e30a9b5645138bfa9ee",22855791,1,-33,0,191,67,41,-26
"b534b89233134e30a9b5645138bfa9ee","267f883678b24aed855fde42524975d9",22855791,1,37,0,192,41,71,30
"267f883678b24aed855fde42524975d9","267f883678b24aed855fde42524975d9",22855791,1,0,1,193,71,71,0
"267f883678b24aed855fde42524975d9","88fff56d0342490dbef9040750a20f6c",22855791,1,1,0,194,71,72,1
"88fff56d0342490dbef9040750a20f6c","88fff56d0342490dbef9040750a20f6c",22855791,1,0,1,195,72,72,0
"88fff56d0342490dbef9040750a20f6c","adb17b12b66c4a49a85fd34322f7df70",22855791,1,1,0,196,72,73,1
"adb17b12b66c4a49a85fd34322f7df70","adb17b12b66c4a49a85fd34322f7df70",22855791,1,0,1,197,73,73,0
"adb17b12b66c4a49a85fd34322f7df70","d646286c8051419bbc2e31dd1db55ca8",22855791,1,-6,0,198,73,67,-6
"d646286c8051419bbc2e31dd1db55ca8","a2becd407db34b189200a32546d9d569",22855791,1,9,0,199,67,75,8
"a2becd407db34b189200a32546d9d569","a2becd407db34b189200a32546d9d569",22855791,3,0,1,200,75,75,0
"a2becd407db34b189200a32546d9d569","58c22b011d0f4c2ea6d13615edbb9eeb",22855791,1,2,0,203,75,77,2
"58c22b011d0f4c2ea6d13615edbb9eeb","58c22b011d0f4c2ea6d13615edbb9eeb",22855791,8,0,1,204,77,77,0
"58c22b011d0f4c2ea6d13615edbb9eeb","dd76e1861dc9461c830888729d091ee0",22855791,1,1,0,212,77,78,1
"dd76e1861dc9461c830888729d091ee0","dd76e1861dc9461c830888729d091ee0",22855791,5,0,1,213,78,78,0
"dd76e1861dc9461c830888729d091ee0","cd1d828f1a694b87913a7ea66c23803e",22855791,1,1,0,218,78,79,1
"cd1d828f1a694b87913a7ea66c23803e","cd1d828f1a694b87913a7ea66c23803e",22855791,2,0,1,219,79,79,0
"cd1d828f1a694b87913a7ea66c23803e","9176a3c2b4d2465fa8b0c67096c2a97e",22855791,1,1,0,221,79,80,1
"9176a3c2b4d2465fa8b0c67096c2a97e","9176a3c2b4d2465fa8b0c67096c2a97e",22855791,5,0,1,222,80,80,0
"9176a3c2b4d2465fa8b0c67096c2a97e","f8ec6445f7194e25b9101d4fbcb07a18",22855791,1,1,0,227,80,81,1
"f8ec6445f7194e25b9101d4fbcb07a18","f8ec6445f7194e25b9101d4fbcb07a18",22855791,6,0,1,228,81,81,0
"f8ec6445f7194e25b9101d4fbcb07a18","140d5b27b8574befad82c0a013b59dfa",22855791,1,-7,0,234,81,74,-7
"140d5b27b8574befad82c0a013b59dfa","d18a9ea32855445f8736581f5cb119ce",22855791,1,9,0,235,74,82,8
"d18a9ea32855445f8736581f5cb119ce","f564483cbd7a407681aa2fcca518cf5f",22855791,1,4,0,236,82,85,3
"f564483cbd7a407681aa2fcca518cf5f","f564483cbd7a407681aa2fcca518cf5f",22855791,1,0,1,237,85,85,0
"f564483cbd7a407681aa2fcca518cf5f","18fd01350bd5434ca636d59a599d768a",22855791,1,1,0,238,85,86,1
"18fd01350bd5434ca636d59a599d768a","18fd01350bd5434ca636d59a599d768a",22855791,5,0,1,239,86,86,0
"18fd01350bd5434ca636d59a599d768a","6a9f0ef185fb47f0937e29daa1c71ed5",22855791,1,5,0,244,86,90,4
"6a9f0ef185fb47f0937e29daa1c71ed5","ae5ac430ea254e708a6f5deaaf7464ae",22855791,1,-7,0,245,90,84,-6
"ae5ac430ea254e708a6f5deaaf7464ae","c681290961c94c4caf23b529d1ae6b9a",22855791,1,5,0,246,84,88,4
"c681290961c94c4caf23b529d1ae6b9a","c681290961c94c4caf23b529d1ae6b9a",22855791,1,0,1,247,88,88,0
"c681290961c94c4caf23b529d1ae6b9a","6a9f0ef185fb47f0937e29daa1c71ed5",22855791,1,2,0,248,88,90,2
"6a9f0ef185fb47f0937e29daa1c71ed5","6a9f0ef185fb47f0937e29daa1c71ed5",22855791,5,0,1,249,90,90,0
"6a9f0ef185fb47f0937e29daa1c71ed5","d646286c8051419bbc2e31dd1db55ca8",22855791,2,-27,0,252,90,67,-23
"d646286c8051419bbc2e31dd1db55ca8","e20db35ced8544ddac5bc3839145e463",22855791,2,30,0,253,67,91,24
"e20db35ced8544ddac5bc3839145e463","67a089198fcb4e1c8f2385786c2b296f",22855791,1,-67,0,254,91,39,-52
"67a089198fcb4e1c8f2385786c2b296f","e20db35ced8544ddac5bc3839145e463",22855791,2,67,0,255,39,91,52
"e20db35ced8544ddac5bc3839145e463","e20db35ced8544ddac5bc3839145e463",22855791,6,0,1,256,91,91,0
"e20db35ced8544ddac5bc3839145e463","d646286c8051419bbc2e31dd1db55ca8",22855791,1,-30,0,262,91,67,-24
"d646286c8051419bbc2e31dd1db55ca8","6a9f0ef185fb47f0937e29daa1c71ed5",22855791,1,27,0,263,67,90,23
"e20db35ced8544ddac5bc3839145e463","1febb706d7a34005ae8711ed49c76e64",22855791,1,3,0,268,91,94,3
"1febb706d7a34005ae8711ed49c76e64","1febb706d7a34005ae8711ed49c76e64",22855791,2,0,1,269,94,94,0
"1febb706d7a34005ae8711ed49c76e64","8f73ba6f5a0042f2850356ac38ac6f24",22855791,1,1,0,271,94,95,1
"8f73ba6f5a0042f2850356ac38ac6f24","8f73ba6f5a0042f2850356ac38ac6f24",22855791,6,0,1,272,95,95,0
"8f73ba6f5a0042f2850356ac38ac6f24","e2260b86653c46d7b14a41fb419dbf8c",22855791,1,1,0,278,95,96,1
"e2260b86653c46d7b14a41fb419dbf8c","e2260b86653c46d7b14a41fb419dbf8c",22855791,2,0,1,279,96,96,0
"e2260b86653c46d7b14a41fb419dbf8c","35eb641ad1d845bbba54915bce75a962",22855791,1,1,0,281,96,97,1
"35eb641ad1d845bbba54915bce75a962","35eb641ad1d845bbba54915bce75a962",22855791,6,0,1,282,97,97,0
"35eb641ad1d845bbba54915bce75a962","08be90ffbeea4795a138cd42ed8db56f",22855791,1,1,0,288,97,98,1
"08be90ffbeea4795a138cd42ed8db56f","08be90ffbeea4795a138cd42ed8db56f",22855791,6,0,1,289,98,98,0
"08be90ffbeea4795a138cd42ed8db56f","3007433c8f584dcbb5ac159c1c5f2be3",22855791,1,1,0,295,98,99,1
"3007433c8f584dcbb5ac159c1c5f2be3","3007433c8f584dcbb5ac159c1c5f2be3",22855791,6,0,1,296,99,99,0
"3007433c8f584dcbb5ac159c1c5f2be3","00ae5f0c51874a73a41ebea838d95682",22855791,1,3,0,302,99,101,2
"00ae5f0c51874a73a41ebea838d95682","e20db35ced8544ddac5bc3839145e463",22855791,1,-11,0,303,101,91,-10
"e20db35ced8544ddac5bc3839145e463","d391c8b6e56a43a7b654e9dee02d904b",22855791,1,13,0,304,91,103,12
"d391c8b6e56a43a7b654e9dee02d904b","00ae5f0c51874a73a41ebea838d95682",22855791,1,-2,0,305,103,101,-2
"00ae5f0c51874a73a41ebea838d95682","00ae5f0c51874a73a41ebea838d95682",22855791,3,0,1,306,101,101,0
"00ae5f0c51874a73a41ebea838d95682","d391c8b6e56a43a7b654e9dee02d904b",22855791,1,2,0,309,101,103,2
"d391c8b6e56a43a7b654e9dee02d904b","d391c8b6e56a43a7b654e9dee02d904b",22855791,15,0,1,310,103,103,0
"d391c8b6e56a43a7b654e9dee02d904b","6111116566fc4fd9abba409322bea245",22855791,1,1,0,325,103,104,1
"6111116566fc4fd9abba409322bea245","6111116566fc4fd9abba409322bea245",22855791,2,0,1,326,104,104,0
"6111116566fc4fd9abba409322bea245","a81b2235cb9c499eb9ea8ee0a8dd9725",22855791,1,1,0,328,104,105,1
"a81b2235cb9c499eb9ea8ee0a8dd9725","a81b2235cb9c499eb9ea8ee0a8dd9725",22855791,2,0,1,329,105,105,0
"a81b2235cb9c499eb9ea8ee0a8dd9725","2d4e0ab0ef3b4d73b82c72d4621a7579",22855791,1,1,0,331,105,106,1
"2d4e0ab0ef3b4d73b82c72d4621a7579","2d4e0ab0ef3b4d73b82c72d4621a7579",22855791,2,0,1,332,106,106,0
"2d4e0ab0ef3b4d73b82c72d4621a7579","8bdebf492ebd4e62b0d522e8ab5e5197",22855791,1,1,0,334,106,107,1
"8bdebf492ebd4e62b0d522e8ab5e5197","8bdebf492ebd4e62b0d522e8ab5e5197",22855791,2,0,1,335,107,107,0
"8bdebf492ebd4e62b0d522e8ab5e5197","4280927ec4d643238aa49c32f9e06c6c",22855791,1,3,0,337,107,109,2
"4280927ec4d643238aa49c32f9e06c6c","73039f8c1eb9409cb4caee2cf968001e",22855791,1,-10,0,338,109,100,-9
"73039f8c1eb9409cb4caee2cf968001e","4280927ec4d643238aa49c32f9e06c6c",22855791,1,10,0,339,100,109,9
"4280927ec4d643238aa49c32f9e06c6c","4280927ec4d643238aa49c32f9e06c6c",22855791,2,0,1,340,109,109,0
"4280927ec4d643238aa49c32f9e06c6c","fc44e6a5f7654430af1227838224dceb",22855791,1,2,0,342,109,111,2
"fc44e6a5f7654430af1227838224dceb","fc44e6a5f7654430af1227838224dceb",22855791,2,0,1,343,111,111,0
"fc44e6a5f7654430af1227838224dceb","a9ae0a3c070d455bb4369a8996313336",22855791,1,4,0,345,111,114,3
"a9ae0a3c070d455bb4369a8996313336","08111f75e22d409998cf8b85bd431f0a",22855791,2,-7,0,346,114,108,-6
"08111f75e22d409998cf8b85bd431f0a","a9ae0a3c070d455bb4369a8996313336",22855791,1,7,0,347,108,114,6
"a9ae0a3c070d455bb4369a8996313336","a9ae0a3c070d455bb4369a8996313336",22855791,3,0,1,348,114,114,0
"a9ae0a3c070d455bb4369a8996313336","4280927ec4d643238aa49c32f9e06c6c",22855791,1,-6,0,351,114,109,-5
"4280927ec4d643238aa49c32f9e06c6c","37319e88176d4aefa91d7a9980dbae91",22855791,1,4,0,352,109,112,3
"37319e88176d4aefa91d7a9980dbae91","a9ae0a3c070d455bb4369a8996313336",22855791,1,2,0,353,112,114,2
"08111f75e22d409998cf8b85bd431f0a","71cec822bcff4f30a20e75dc63ef7b65",22855791,1,9,0,355,108,116,8
"71cec822bcff4f30a20e75dc63ef7b65","71cec822bcff4f30a20e75dc63ef7b65",22855791,1,0,1,356,116,116,0
"71cec822bcff4f30a20e75dc63ef7b65","62bff51286ef4f348717a3cf6fe2318f",22855791,1,5,0,357,116,120,4
"62bff51286ef4f348717a3cf6fe2318f","37319e88176d4aefa91d7a9980dbae91",22855791,1,-9,0,358,120,112,-8
"37319e88176d4aefa91d7a9980dbae91","62bff51286ef4f348717a3cf6fe2318f",22855791,2,9,0,359,112,120,8
"62bff51286ef4f348717a3cf6fe2318f","62bff51286ef4f348717a3cf6fe2318f",22855791,7,0,1,360,120,120,0
"62bff51286ef4f348717a3cf6fe2318f","e20db35ced8544ddac5bc3839145e463",22855791,2,-33,0,363,120,91,-29
"e20db35ced8544ddac5bc3839145e463","779f9ddd1fd14d1e9e69f72219a1fdbd",22855791,2,36,0,364,91,121,30
"779f9ddd1fd14d1e9e69f72219a1fdbd","37319e88176d4aefa91d7a9980dbae91",22855791,1,-12,0,365,121,112,-9
"37319e88176d4aefa91d7a9980dbae91","e20db35ced8544ddac5bc3839145e463",22855791,2,-24,0,366,112,91,-21
"e20db35ced8544ddac5bc3839145e463","37319e88176d4aefa91d7a9980dbae91",22855791,1,24,0,367,91,112,21
"e20db35ced8544ddac5bc3839145e463","a9ae0a3c070d455bb4369a8996313336",22855791,1,26,0,369,91,114,23
"a9ae0a3c070d455bb4369a8996313336","37319e88176d4aefa91d7a9980dbae91",22855791,1,-2,0,370,114,112,-2
"779f9ddd1fd14d1e9e69f72219a1fdbd","ae26e6cda8ad4a3f81bd347560d9579f",22855791,1,4,0,376,121,125,4
"ae26e6cda8ad4a3f81bd347560d9579f","ae26e6cda8ad4a3f81bd347560d9579f",22855791,1,0,1,377,125,125,0
"ae26e6cda8ad4a3f81bd347560d9579f","ee48df95832b4374aa273ceb27ec1315",22855791,1,1,0,378,125,126,1
"ee48df95832b4374aa273ceb27ec1315","ee48df95832b4374aa273ceb27ec1315",22855791,1,0,1,379,126,126,0
"ee48df95832b4374aa273ceb27ec1315","7a439da90b394756ad1777fc4c6dead5",22855791,1,1,0,380,126,127,1
"7a439da90b394756ad1777fc4c6dead5","7a439da90b394756ad1777fc4c6dead5",22855791,1,0,1,381,127,127,0
"7a439da90b394756ad1777fc4c6dead5","779f9ddd1fd14d1e9e69f72219a1fdbd",22855791,1,-6,0,382,127,121,-6
"779f9ddd1fd14d1e9e69f72219a1fdbd","a8dd5213034441ac92724b4e83eb0bb2",22855791,1,9,0,383,121,129,8
"a8dd5213034441ac92724b4e83eb0bb2","a8dd5213034441ac92724b4e83eb0bb2",22855791,4,0,1,384,129,129,0
"a8dd5213034441ac92724b4e83eb0bb2","8115eab6556b45f5b415c3b8c26a12e5",22855791,1,2,0,388,129,131,2
"8115eab6556b45f5b415c3b8c26a12e5","8115eab6556b45f5b415c3b8c26a12e5",22855791,2,0,1,389,131,131,0
"8115eab6556b45f5b415c3b8c26a12e5","ec34b06efd844b46a4c4818ecdb9b8f4",22855791,1,1,0,391,131,132,1
"ec34b06efd844b46a4c4818ecdb9b8f4","ec34b06efd844b46a4c4818ecdb9b8f4",22855791,2,0,1,392,132,132,0
"ec34b06efd844b46a4c4818ecdb9b8f4","c2e1c2b9eac64109b343a088584b576b",22855791,1,1,0,394,132,133,1
"c2e1c2b9eac64109b343a088584b576b","c2e1c2b9eac64109b343a088584b576b",22855791,2,0,1,395,133,133,0
"c2e1c2b9eac64109b343a088584b576b","579338175e0b4bbb8ef3b712b5d8b54e",22855791,1,-5,0,397,133,128,-5
"579338175e0b4bbb8ef3b712b5d8b54e","8bc5795d6a984a3eace4e2811e52dd4f",22855791,1,8,0,398,128,135,7
"8bc5795d6a984a3eace4e2811e52dd4f","8bc5795d6a984a3eace4e2811e52dd4f",22855791,1,0,1,399,135,135,0
"8bc5795d6a984a3eace4e2811e52dd4f","b416d47c56a742199b5d7c7f19d6503a",22855791,1,-1,0,400,135,134,-1
"b416d47c56a742199b5d7c7f19d6503a","cd4532ad48034873ba8bce2aac0c9808",22855791,1,4,0,401,134,137,3
"cd4532ad48034873ba8bce2aac0c9808","cd4532ad48034873ba8bce2aac0c9808",22855791,1,0,1,402,137,137,0
"cd4532ad48034873ba8bce2aac0c9808","df1de691dafe4549a18a4398ee9dfaf9",22855791,1,4,0,403,137,139,2
"df1de691dafe4549a18a4398ee9dfaf9","779f9ddd1fd14d1e9e69f72219a1fdbd",22855791,1,-23,0,404,139,121,-18
"779f9ddd1fd14d1e9e69f72219a1fdbd","6c5ad271a44743479bfaea29b1db8d02",22855791,1,27,0,405,121,143,22
"6c5ad271a44743479bfaea29b1db8d02","67a089198fcb4e1c8f2385786c2b296f",22855791,1,-130,0,406,143,39,-104
"e20db35ced8544ddac5bc3839145e463","3ec3a3563847406fa73338f9e9999cf3",22855791,1,30,0,408,91,117,26
"3ec3a3563847406fa73338f9e9999cf3","62bff51286ef4f348717a3cf6fe2318f",22855791,1,3,0,409,117,120,3
"62bff51286ef4f348717a3cf6fe2318f","b1cd0e7dc3ad4a8eb91a4bfdbeb025b0",22855791,1,-2,0,412,120,118,-2
"b1cd0e7dc3ad4a8eb91a4bfdbeb025b0","b1cd0e7dc3ad4a8eb91a4bfdbeb025b0",22855791,1,0,1,413,118,118,0
"b1cd0e7dc3ad4a8eb91a4bfdbeb025b0","67a089198fcb4e1c8f2385786c2b296f",22855791,1,-98,0,414,118,39,-79
"67a089198fcb4e1c8f2385786c2b296f","df1de691dafe4549a18a4398ee9dfaf9",22855791,1,126,0,415,39,139,100
"df1de691dafe4549a18a4398ee9dfaf9","df1de691dafe4549a18a4398ee9dfaf9",22855791,1,0,1,416,139,139,0
"df1de691dafe4549a18a4398ee9dfaf9","6c5ad271a44743479bfaea29b1db8d02",22855791,1,4,0,417,139,143,4
"6c5ad271a44743479bfaea29b1db8d02","6c5ad271a44743479bfaea29b1db8d02",22855791,2,0,1,418,143,143,0
"6c5ad271a44743479bfaea29b1db8d02","83d311bed5374fee83d8d67a7d9d82dc",22855791,1,1,0,420,143,144,1
"83d311bed5374fee83d8d67a7d9d82dc","83d311bed5374fee83d8d67a7d9d82dc",22855791,1,0,1,421,144,144,0
"83d311bed5374fee83d8d67a7d9d82dc","402bba41861d43acb52a5abb89e8831e",22855791,1,1,0,422,144,145,1
"402bba41861d43acb52a5abb89e8831e","402bba41861d43acb52a5abb89e8831e",22855791,2,0,1,423,145,145,0
"402bba41861d43acb52a5abb89e8831e","8aae34f5ddbb4052a709b12e6b0d40fa",22855791,1,3,0,425,145,147,2
"8aae34f5ddbb4052a709b12e6b0d40fa","df1de691dafe4549a18a4398ee9dfaf9",22855791,1,-9,0,426,147,139,-8
"df1de691dafe4549a18a4398ee9dfaf9","8aae34f5ddbb4052a709b12e6b0d40fa",22855791,1,9,0,427,139,147,8
"8aae34f5ddbb4052a709b12e6b0d40fa","8aae34f5ddbb4052a709b12e6b0d40fa",22855791,1,0,1,428,147,147,0
"8aae34f5ddbb4052a709b12e6b0d40fa","645b3f0249f64f76af2e19eb4d0e55b7",22855791,1,2,0,429,147,149,2
"645b3f0249f64f76af2e19eb4d0e55b7","645b3f0249f64f76af2e19eb4d0e55b7",22855791,6,0,1,430,149,149,0
"645b3f0249f64f76af2e19eb4d0e55b7","7e7b8db5064d4369805ab370aac5ddfb",22855791,1,1,0,436,149,150,1
"7e7b8db5064d4369805ab370aac5ddfb","7e7b8db5064d4369805ab370aac5ddfb",22855791,2,0,1,437,150,150,0
"7e7b8db5064d4369805ab370aac5ddfb","8956d210ae7f41968fada86d4c979d6a",22855791,1,1,0,439,150,151,1
"8956d210ae7f41968fada86d4c979d6a","8956d210ae7f41968fada86d4c979d6a",22855791,2,0,1,440,151,151,0
"8956d210ae7f41968fada86d4c979d6a","f902b0f41b544d4dbf79664fd233648d",22855791,1,-5,0,442,151,146,-5
"f902b0f41b544d4dbf79664fd233648d","ae781e8b775e4ccd93bc800dad5c8376",22855791,1,8,0,443,146,153,7
"ae781e8b775e4ccd93bc800dad5c8376","ae781e8b775e4ccd93bc800dad5c8376",22855791,2,0,1,444,153,153,0
"ae781e8b775e4ccd93bc800dad5c8376","06882a8492d9499aa31555567f575ecb",22855791,1,1,0,446,153,154,1
"06882a8492d9499aa31555567f575ecb","06882a8492d9499aa31555567f575ecb",22855791,1,0,1,447,154,154,0
"06882a8492d9499aa31555567f575ecb","f293c508f409466a8f27ddd7d1e40b20",22855791,1,1,0,448,154,155,1
"f293c508f409466a8f27ddd7d1e40b20","f293c508f409466a8f27ddd7d1e40b20",22855791,2,0,1,449,155,155,0
"f293c508f409466a8f27ddd7d1e40b20","cc4ddef5bbbe48ebb605141b347c4ed1",22855791,1,1,0,451,155,156,1
"cc4ddef5bbbe48ebb605141b347c4ed1","cc4ddef5bbbe48ebb605141b347c4ed1",22855791,1,0,1,452,156,156,0
"cc4ddef5bbbe48ebb605141b347c4ed1","f03480cf4eba413194d7af52fc0e7f28",22855791,1,-4,0,453,156,152,-4
"f03480cf4eba413194d7af52fc0e7f28","d313cec988a84645bee413e8d4724a4b",22855791,1,7,0,454,152,158,6
"d313cec988a84645bee413e8d4724a4b","d313cec988a84645bee413e8d4724a4b",22855791,4,0,1,455,158,158,0
"d313cec988a84645bee413e8d4724a4b","dc60696c76a74368a60f72246e47700d",22855791,1,1,0,459,158,159,1
"dc60696c76a74368a60f72246e47700d","dc60696c76a74368a60f72246e47700d",22855791,1,0,1,460,159,159,0
"dc60696c76a74368a60f72246e47700d","78adeee1fa2c4fe0bc73f7bca9fcee86",22855791,1,3,0,461,159,160,1
"78adeee1fa2c4fe0bc73f7bca9fcee86","df1de691dafe4549a18a4398ee9dfaf9",22855791,1,-26,0,462,160,139,-21
"df1de691dafe4549a18a4398ee9dfaf9","65202579580f4ad38d734b4ee39d22a8",22855791,1,31,0,463,139,164,25
"65202579580f4ad38d734b4ee39d22a8","78adeee1fa2c4fe0bc73f7bca9fcee86",22855791,2,-5,0,464,164,160,-4
"78adeee1fa2c4fe0bc73f7bca9fcee86","65202579580f4ad38d734b4ee39d22a8",22855791,4,5,0,465,160,164,4
"65202579580f4ad38d734b4ee39d22a8","8959e6304a0348309a771e4d08d1b64a",22855791,1,-1,0,472,164,163,-1
"8959e6304a0348309a771e4d08d1b64a","f924752d8a1149668870b1e7698486f7",22855791,1,-141,0,473,163,50,-113
"f924752d8a1149668870b1e7698486f7","b534b89233134e30a9b5645138bfa9ee",22855791,1,-11,0,474,50,41,-9
"b534b89233134e30a9b5645138bfa9ee","d0c74f735e024943943e40333d6d337f",22855791,1,12,0,475,41,51,10
"d0c74f735e024943943e40333d6d337f","b534b89233134e30a9b5645138bfa9ee",22855791,1,-12,0,476,51,41,-10
"b534b89233134e30a9b5645138bfa9ee","78adeee1fa2c4fe0bc73f7bca9fcee86",22855791,1,148,0,477,41,160,119
"78adeee1fa2c4fe0bc73f7bca9fcee86","78adeee1fa2c4fe0bc73f7bca9fcee86",22855791,1,0,1,478,160,160,0
"65202579580f4ad38d734b4ee39d22a8","3cbcea2be0984e7dbd5a48195af10ce7",22855791,2,3,0,537,164,165,1
"3cbcea2be0984e7dbd5a48195af10ce7","78adeee1fa2c4fe0bc73f7bca9fcee86",22855791,2,-8,0,538,165,160,-5
"78adeee1fa2c4fe0bc73f7bca9fcee86","82e6285962b8400d9d6fc32436022a94",22855791,2,10,0,539,160,167,7
"82e6285962b8400d9d6fc32436022a94","a9ac840f098c4bd0a2ee896214ce29cd",22855791,1,3,0,540,167,168,1
"a9ac840f098c4bd0a2ee896214ce29cd","3cbcea2be0984e7dbd5a48195af10ce7",22855791,1,-5,0,541,168,165,-3
"3cbcea2be0984e7dbd5a48195af10ce7","a9ac840f098c4bd0a2ee896214ce29cd",22855791,1,5,0,542,165,168,3
"a9ac840f098c4bd0a2ee896214ce29cd","0c7262dff33c4087bc660ccf40f92f9c",22855791,1,4,0,543,168,169,1
"0c7262dff33c4087bc660ccf40f92f9c","b2275c3fad834f8d90737a2d9a6927d6",22855791,2,3,0,544,169,172,3
"b2275c3fad834f8d90737a2d9a6927d6","b2275c3fad834f8d90737a2d9a6927d6",22855791,21,0,1,545,172,172,0
"b2275c3fad834f8d90737a2d9a6927d6","0c7262dff33c4087bc660ccf40f92f9c",22855791,1,-3,0,546,172,169,-3
"0c7262dff33c4087bc660ccf40f92f9c","0c7262dff33c4087bc660ccf40f92f9c",22855791,3,0,1,547,169,169,0
"b2275c3fad834f8d90737a2d9a6927d6","eb515a26030b41f8a82a1e6114420bad",22855791,1,1,0,569,172,173,1
"eb515a26030b41f8a82a1e6114420bad","eb515a26030b41f8a82a1e6114420bad",22855791,2,0,1,570,173,173,0
"eb515a26030b41f8a82a1e6114420bad","b42cc17b7de840f181a704558d0bc845",22855791,1,3,0,572,173,175,2
"b42cc17b7de840f181a704558d0bc845","0c7262dff33c4087bc660ccf40f92f9c",22855791,1,-7,0,573,175,169,-6
"0c7262dff33c4087bc660ccf40f92f9c","b42cc17b7de840f181a704558d0bc845",22855791,1,7,0,574,169,175,6
"b42cc17b7de840f181a704558d0bc845","b42cc17b7de840f181a704558d0bc845",22855791,3,0,1,575,175,175,0
"b42cc17b7de840f181a704558d0bc845","801f9e9135034f49bf5f8b4bdefedb41",22855791,1,2,0,578,175,177,2
"801f9e9135034f49bf5f8b4bdefedb41","801f9e9135034f49bf5f8b4bdefedb41",22855791,4,0,1,579,177,177,0
"801f9e9135034f49bf5f8b4bdefedb41","362fcb0699a14845ab29b2340093e528",22855791,1,-3,0,583,177,174,-3
"362fcb0699a14845ab29b2340093e528","ea38cc0e6e6e41edbabf210220808bf9",22855791,1,6,0,584,174,179,5
"ea38cc0e6e6e41edbabf210220808bf9","b87c552dd247427abe6ab5795b9c9d43",22855791,2,2,0,585,179,181,2
"b87c552dd247427abe6ab5795b9c9d43","ea38cc0e6e6e41edbabf210220808bf9",22855791,1,-2,0,586,181,179,-2
"ea38cc0e6e6e41edbabf210220808bf9","ea38cc0e6e6e41edbabf210220808bf9",22855791,2,0,1,587,179,179,0
"b87c552dd247427abe6ab5795b9c9d43","b87c552dd247427abe6ab5795b9c9d43",22855791,7,0,1,590,181,181,0
"b87c552dd247427abe6ab5795b9c9d43","139b097acfca451689d80c9c6eebdf7b",22855791,1,-3,0,597,181,178,-3
"139b097acfca451689d80c9c6eebdf7b","30f660a1feb34582a739722532524f79",22855791,1,6,0,598,178,183,5
"30f660a1feb34582a739722532524f79","30f660a1feb34582a739722532524f79",22855791,5,0,1,599,183,183,0
"30f660a1feb34582a739722532524f79","2024b4885bd14338a39b7b509acbbd02",22855791,1,-1,0,604,183,182,-1
"2024b4885bd14338a39b7b509acbbd02","c3f63fe50d8e487c86bf8ef76c9cadd3",22855791,1,4,0,605,182,185,3
"c3f63fe50d8e487c86bf8ef76c9cadd3","c3f63fe50d8e487c86bf8ef76c9cadd3",22855791,1,0,1,606,185,185,0
"c3f63fe50d8e487c86bf8ef76c9cadd3","0c7262dff33c4087bc660ccf40f92f9c",22855791,1,-20,0,607,185,169,-16
"0c7262dff33c4087bc660ccf40f92f9c","c8e371568a0c4391b25796ae4e91952e",22855791,2,23,0,608,169,186,17
"c8e371568a0c4391b25796ae4e91952e","0c7262dff33c4087bc660ccf40f92f9c",22855791,1,-23,0,609,186,169,-17
"c8e371568a0c4391b25796ae4e91952e","c8e371568a0c4391b25796ae4e91952e",22855791,1,0,1,611,186,186,0
"c8e371568a0c4391b25796ae4e91952e","7d932b23e1c84326ae5aa4d3c0d813d1",22855791,1,2,0,612,186,188,2
"7d932b23e1c84326ae5aa4d3c0d813d1","7d932b23e1c84326ae5aa4d3c0d813d1",22855791,3,0,1,613,188,188,0
"7d932b23e1c84326ae5aa4d3c0d813d1","c8e371568a0c4391b25796ae4e91952e",22855791,1,-2,0,616,188,186,-2
"c8e371568a0c4391b25796ae4e91952e","ab11d94c6c8948ea90b88f19d2cd502b",22855791,1,5,0,617,186,190,4
"ab11d94c6c8948ea90b88f19d2cd502b","ab11d94c6c8948ea90b88f19d2cd502b",22855791,3,0,1,618,190,190,0
"ab11d94c6c8948ea90b88f19d2cd502b","f992451ed6ad4e68bb9e68ad6be7c4be",22855791,1,2,0,621,190,192,2
"f992451ed6ad4e68bb9e68ad6be7c4be","f992451ed6ad4e68bb9e68ad6be7c4be",22855791,1,0,1,622,192,192,0
"f992451ed6ad4e68bb9e68ad6be7c4be","07b44a7a51e94c78b411c753fc39dab0",22855791,1,-3,0,623,192,189,-3
"07b44a7a51e94c78b411c753fc39dab0","6cd2dcaac46847d4a0bc53f296d90375",22855791,1,6,0,624,189,194,5
"6cd2dcaac46847d4a0bc53f296d90375","6cd2dcaac46847d4a0bc53f296d90375",22855791,3,0,1,625,194,194,0
"6cd2dcaac46847d4a0bc53f296d90375","2d2580c9411c4972909db508d6956a58",22855791,1,2,0,628,194,196,2
"2d2580c9411c4972909db508d6956a58","2d2580c9411c4972909db508d6956a58",22855791,2,0,1,629,196,196,0
"2d2580c9411c4972909db508d6956a58","5bddb3d9ed264f3984702f048c7e5340",22855791,1,1,0,631,196,197,1
"5bddb3d9ed264f3984702f048c7e5340","5bddb3d9ed264f3984702f048c7e5340",22855791,2,0,1,632,197,197,0
"5bddb3d9ed264f3984702f048c7e5340","d5e8e2bd12a2466b9d6d90855f0eb079",22855791,1,1,0,634,197,198,1
"d5e8e2bd12a2466b9d6d90855f0eb079","d5e8e2bd12a2466b9d6d90855f0eb079",22855791,2,0,1,635,198,198,0
"d5e8e2bd12a2466b9d6d90855f0eb079","017d7ca8e0394b91aaadc9574df2202c",22855791,1,-5,0,637,198,193,-5
"017d7ca8e0394b91aaadc9574df2202c","54e8e9f0ea3e45c4bf3b8ac799ee31b1",22855791,1,8,0,638,193,200,7
"54e8e9f0ea3e45c4bf3b8ac799ee31b1","54e8e9f0ea3e45c4bf3b8ac799ee31b1",22855791,1,0,1,639,200,200,0
"54e8e9f0ea3e45c4bf3b8ac799ee31b1","c614a00911be4877a075f19315530fb0",22855791,1,1,0,640,200,201,1
"c614a00911be4877a075f19315530fb0","c614a00911be4877a075f19315530fb0",22855791,6,0,1,641,201,201,0
"c614a00911be4877a075f19315530fb0","a6c21bd8b95249c7972820a7a7d76aff",22855791,1,1,0,647,201,202,1
"a6c21bd8b95249c7972820a7a7d76aff","a6c21bd8b95249c7972820a7a7d76aff",22855791,1,0,1,648,202,202,0
"a6c21bd8b95249c7972820a7a7d76aff","bb329d880ab54120adaf203a693bb203",22855791,1,1,0,649,202,203,1
"bb329d880ab54120adaf203a693bb203","bb329d880ab54120adaf203a693bb203",22855791,1,0,1,650,203,203,0
"bb329d880ab54120adaf203a693bb203","f9170dd6bc6442b4acd832747609b09a",22855791,1,-4,0,651,203,199,-4
"f9170dd6bc6442b4acd832747609b09a","334c2344009840079b1d0e1b7ce3d5a7",22855791,1,7,0,652,199,205,6
"334c2344009840079b1d0e1b7ce3d5a7","334c2344009840079b1d0e1b7ce3d5a7",22855791,1,0,1,653,205,205,0
"334c2344009840079b1d0e1b7ce3d5a7","c8e371568a0c4391b25796ae4e91952e",22855791,1,-23,0,654,205,186,-19
"c8e371568a0c4391b25796ae4e91952e","d7f13c8d63ec4e2aa673fbb9cf9c6933",22855791,1,26,0,655,186,206,20
"d7f13c8d63ec4e2aa673fbb9cf9c6933","7108f0e4c2584f1f9c471689ae4c885c",22855791,1,2,0,656,206,208,2
"7108f0e4c2584f1f9c471689ae4c885c","b9e80f77c3a44349863b19875725c384",22855791,2,-1,0,657,208,207,-1
"b9e80f77c3a44349863b19875725c384","0c7262dff33c4087bc660ccf40f92f9c",22855791,1,-50,0,658,207,169,-38
"0c7262dff33c4087bc660ccf40f92f9c","d7f13c8d63ec4e2aa673fbb9cf9c6933",22855791,1,49,0,659,169,206,37
"d7f13c8d63ec4e2aa673fbb9cf9c6933","d7f13c8d63ec4e2aa673fbb9cf9c6933",22855791,1,0,1,660,206,206,0
"d7f13c8d63ec4e2aa673fbb9cf9c6933","b9e80f77c3a44349863b19875725c384",22855791,1,1,0,661,206,207,1
"b9e80f77c3a44349863b19875725c384","7108f0e4c2584f1f9c471689ae4c885c",22855791,2,1,0,662,207,208,1
"b9e80f77c3a44349863b19875725c384","b9e80f77c3a44349863b19875725c384",22855791,19,0,1,664,207,207,0
"7108f0e4c2584f1f9c471689ae4c885c","7108f0e4c2584f1f9c471689ae4c885c",22855791,13,0,1,684,208,208,0
"7108f0e4c2584f1f9c471689ae4c885c","d7f13c8d63ec4e2aa673fbb9cf9c6933",22855791,1,-2,0,697,208,206,-2
"d7f13c8d63ec4e2aa673fbb9cf9c6933","09400e101c5d4b439cf9a26b03aae558",22855791,1,5,0,698,206,210,4
"09400e101c5d4b439cf9a26b03aae558","09400e101c5d4b439cf9a26b03aae558",22855791,3,0,1,699,210,210,0
"09400e101c5d4b439cf9a26b03aae558","a88efa7e50ce47159810ab553afa6d3a",22855791,1,2,0,702,210,212,2
"a88efa7e50ce47159810ab553afa6d3a","a88efa7e50ce47159810ab553afa6d3a",22855791,5,0,1,703,212,212,0
"a88efa7e50ce47159810ab553afa6d3a","a875096404ef4a9984b62d74cda916f9",22855791,1,-3,0,708,212,209,-3
"a875096404ef4a9984b62d74cda916f9","be502a7a43c44bf7b682698de79d9369",22855791,1,6,0,709,209,214,5
"be502a7a43c44bf7b682698de79d9369","f7fb1952f56b4189b86a9f8b7862d2b8",22855791,2,1,0,710,214,215,1
"f7fb1952f56b4189b86a9f8b7862d2b8","be502a7a43c44bf7b682698de79d9369",22855791,1,-1,0,711,215,214,-1
"be502a7a43c44bf7b682698de79d9369","be502a7a43c44bf7b682698de79d9369",22855791,2,0,1,712,214,214,0
"f7fb1952f56b4189b86a9f8b7862d2b8","f7fb1952f56b4189b86a9f8b7862d2b8",22855791,11,0,1,715,215,215,0
"f7fb1952f56b4189b86a9f8b7862d2b8","b860ee85d8bc4a2f97958cfb71be3533",22855791,1,1,0,726,215,216,1
"b860ee85d8bc4a2f97958cfb71be3533","b860ee85d8bc4a2f97958cfb71be3533",22855791,2,0,1,727,216,216,0
"b860ee85d8bc4a2f97958cfb71be3533","363837c182e04711840d896ae1e0339c",22855791,1,3,0,729,216,218,2
"363837c182e04711840d896ae1e0339c","ec341f459285443b8361f7f15638ff08",22855791,1,-6,0,730,218,213,-5
"ec341f459285443b8361f7f15638ff08","363837c182e04711840d896ae1e0339c",22855791,1,6,0,731,213,218,5
"363837c182e04711840d896ae1e0339c","363837c182e04711840d896ae1e0339c",22855791,11,0,1,732,218,218,0
"363837c182e04711840d896ae1e0339c","01b2051f8941460d89945e3b02d1ce78",22855791,1,-1,0,743,218,217,-1
"01b2051f8941460d89945e3b02d1ce78","91125ca626c5470eb145501f8c37f8db",22855791,1,4,0,744,217,220,3
"91125ca626c5470eb145501f8c37f8db","91125ca626c5470eb145501f8c37f8db",22855791,1,0,1,745,220,220,0
"91125ca626c5470eb145501f8c37f8db","d7f13c8d63ec4e2aa673fbb9cf9c6933",22855791,1,-18,0,746,220,206,-14
"d7f13c8d63ec4e2aa673fbb9cf9c6933","1c6721b1f63f4d30ba7746ea8af02a52",22855791,1,21,0,747,206,221,15
"1c6721b1f63f4d30ba7746ea8af02a52","0c7262dff33c4087bc660ccf40f92f9c",22855791,1,-70,0,748,221,169,-52
"0c7262dff33c4087bc660ccf40f92f9c","77ecef8eff6b4a2caea7707669bf7475",22855791,1,71,0,749,169,222,53
"77ecef8eff6b4a2caea7707669bf7475","1c6721b1f63f4d30ba7746ea8af02a52",22855791,2,-1,0,750,222,221,-1
"1c6721b1f63f4d30ba7746ea8af02a52","1c6721b1f63f4d30ba7746ea8af02a52",22855791,1,0,1,751,221,221,0
"1c6721b1f63f4d30ba7746ea8af02a52","77ecef8eff6b4a2caea7707669bf7475",22855791,1,1,0,752,221,222,1
"77ecef8eff6b4a2caea7707669bf7475","77ecef8eff6b4a2caea7707669bf7475",22855791,12,0,1,753,222,222,0
"1c6721b1f63f4d30ba7746ea8af02a52","d03cb855c70044cf8c35d9ec0de696e3",22855791,1,4,0,766,221,224,3
"d03cb855c70044cf8c35d9ec0de696e3","8b9ae98743bd4d4a8a87dff1c1244211",22855791,1,3,0,767,224,227,3
"8b9ae98743bd4d4a8a87dff1c1244211","d03cb855c70044cf8c35d9ec0de696e3",22855791,1,-3,0,768,227,224,-3
"d03cb855c70044cf8c35d9ec0de696e3","d03cb855c70044cf8c35d9ec0de696e3",22855791,2,0,1,769,224,224,0
"d03cb855c70044cf8c35d9ec0de696e3","a49a937d6896486d9a5396654abcf2e1",22855791,1,2,0,771,224,226,2
"a49a937d6896486d9a5396654abcf2e1","a49a937d6896486d9a5396654abcf2e1",22855791,5,0,1,772,226,226,0
"a49a937d6896486d9a5396654abcf2e1","8b9ae98743bd4d4a8a87dff1c1244211",22855791,1,1,0,777,226,227,1
"8b9ae98743bd4d4a8a87dff1c1244211","8b9ae98743bd4d4a8a87dff1c1244211",22855791,16,0,1,778,227,227,0
"8b9ae98743bd4d4a8a87dff1c1244211","f7906d6f59b9489a91d2ef40db5a474d",22855791,1,-4,0,794,227,223,-4
"f7906d6f59b9489a91d2ef40db5a474d","2ab1535aac1346ba8801535bf729ef37",22855791,1,7,0,795,223,229,6
"2ab1535aac1346ba8801535bf729ef37","2ab1535aac1346ba8801535bf729ef37",22855791,3,0,1,796,229,229,0
"2ab1535aac1346ba8801535bf729ef37","a4f40fb48a8542c8949bae1f002cd9bc",22855791,1,2,0,799,229,231,2
"a4f40fb48a8542c8949bae1f002cd9bc","a4f40fb48a8542c8949bae1f002cd9bc",22855791,2,0,1,800,231,231,0
"a4f40fb48a8542c8949bae1f002cd9bc","8972c23e32044edb8a78fa1eed4e5947",22855791,1,1,0,802,231,232,1
"8972c23e32044edb8a78fa1eed4e5947","8972c23e32044edb8a78fa1eed4e5947",22855791,1,0,1,803,232,232,0
"8972c23e32044edb8a78fa1eed4e5947","92feb4a40f8344d38b6f722e42a53295",22855791,1,1,0,804,232,233,1
"92feb4a40f8344d38b6f722e42a53295","92feb4a40f8344d38b6f722e42a53295",22855791,2,0,1,805,233,233,0
"92feb4a40f8344d38b6f722e42a53295","5152833676bf4c6cb317060be10f68db",22855791,1,-5,0,807,233,228,-5
"5152833676bf4c6cb317060be10f68db","ca3e28f290354c08aefe5b0f769604e6",22855791,1,8,0,808,228,235,7
"ca3e28f290354c08aefe5b0f769604e6","ca3e28f290354c08aefe5b0f769604e6",22855791,4,0,1,809,235,235,0
"ca3e28f290354c08aefe5b0f769604e6","79a35eea833e4c2c9d22fc53c3c6445c",22855791,1,1,0,813,235,236,1
"79a35eea833e4c2c9d22fc53c3c6445c","79a35eea833e4c2c9d22fc53c3c6445c",22855791,4,0,1,814,236,236,0
"79a35eea833e4c2c9d22fc53c3c6445c","8f68228b1518449e9615cdafee41a2bd",22855791,1,1,0,818,236,237,1
"8f68228b1518449e9615cdafee41a2bd","8f68228b1518449e9615cdafee41a2bd",22855791,1,0,1,819,237,237,0
"8f68228b1518449e9615cdafee41a2bd","cab89fa5c3ed45a5aa550fc0352d6a42",22855791,1,1,0,820,237,238,1
"cab89fa5c3ed45a5aa550fc0352d6a42","cab89fa5c3ed45a5aa550fc0352d6a42",22855791,1,0,1,821,238,238,0
"cab89fa5c3ed45a5aa550fc0352d6a42","66d4fad4f1cf4b46be0750a99ad7a35a",22855791,1,1,0,822,238,239,1
"66d4fad4f1cf4b46be0750a99ad7a35a","66d4fad4f1cf4b46be0750a99ad7a35a",22855791,1,0,1,823,239,239,0
"66d4fad4f1cf4b46be0750a99ad7a35a","0b04c8e2f86d48c7aeb7e225819cd32b",22855791,1,-5,0,824,239,234,-5
"0b04c8e2f86d48c7aeb7e225819cd32b","f53da5fd9bfe412da4b80d4742563b6c",22855791,1,8,0,825,234,241,7
"f53da5fd9bfe412da4b80d4742563b6c","f53da5fd9bfe412da4b80d4742563b6c",22855791,1,0,1,826,241,241,0
"f53da5fd9bfe412da4b80d4742563b6c","2ae94c0cea4d480a9d5dca8fb1d7b542",22855791,1,3,0,827,241,242,1
"2ae94c0cea4d480a9d5dca8fb1d7b542","1c6721b1f63f4d30ba7746ea8af02a52",22855791,1,-27,0,828,242,221,-21
"1c6721b1f63f4d30ba7746ea8af02a52","1ebf23f9d994469a85206e4c7b1bf5f5",22855791,1,30,0,829,221,245,24
"1ebf23f9d994469a85206e4c7b1bf5f5","0c7262dff33c4087bc660ccf40f92f9c",22855791,1,-100,0,830,245,169,-76
"0c7262dff33c4087bc660ccf40f92f9c","2ae94c0cea4d480a9d5dca8fb1d7b542",22855791,1,97,0,832,169,242,73
"2ae94c0cea4d480a9d5dca8fb1d7b542","2ae94c0cea4d480a9d5dca8fb1d7b542",22855791,1,0,1,833,242,242,0
"2ae94c0cea4d480a9d5dca8fb1d7b542","1ebf23f9d994469a85206e4c7b1bf5f5",22855791,1,3,0,834,242,245,3
"1ebf23f9d994469a85206e4c7b1bf5f5","1ebf23f9d994469a85206e4c7b1bf5f5",22855791,10,0,1,835,245,245,0
"1ebf23f9d994469a85206e4c7b1bf5f5","85ae675b83e8422da842cfd25596af99",22855791,1,1,0,845,245,246,1
"85ae675b83e8422da842cfd25596af99","85ae675b83e8422da842cfd25596af99",22855791,1,0,1,846,246,246,0
"85ae675b83e8422da842cfd25596af99","2ae94c0cea4d480a9d5dca8fb1d7b542",22855791,1,-4,0,847,246,242,-4
"2ae94c0cea4d480a9d5dca8fb1d7b542","30c9ba177afc49a695625d2bdec40207",22855791,1,9,0,848,242,250,8
"30c9ba177afc49a695625d2bdec40207","30c9ba177afc49a695625d2bdec40207",22855791,2,0,1,849,250,250,0
"30c9ba177afc49a695625d2bdec40207","00f61990949545828dd12f1303d47504",22855791,1,8,0,851,250,256,6
"00f61990949545828dd12f1303d47504","6e83e23f56544a19b94067c1c558d9c0",22855791,1,-11,0,852,256,247,-9
"6e83e23f56544a19b94067c1c558d9c0","00f61990949545828dd12f1303d47504",22855791,1,11,0,853,247,256,9
"00f61990949545828dd12f1303d47504","00f61990949545828dd12f1303d47504",22855791,1,0,1,854,256,256,0
"00f61990949545828dd12f1303d47504","ead7bb4b64e247d2ae632ab8a296b091",22855791,1,2,0,855,256,258,2
"ead7bb4b64e247d2ae632ab8a296b091","ead7bb4b64e247d2ae632ab8a296b091",22855791,2,0,1,856,258,258,0
"ead7bb4b64e247d2ae632ab8a296b091","41b0048dde734bb280bac6116baa8e27",22855791,1,1,0,858,258,259,1
"41b0048dde734bb280bac6116baa8e27","41b0048dde734bb280bac6116baa8e27",22855791,2,0,1,859,259,259,0
"41b0048dde734bb280bac6116baa8e27","b41c5a094a604ee0915327da5cc0beb7",22855791,1,1,0,861,259,260,1
"b41c5a094a604ee0915327da5cc0beb7","b41c5a094a604ee0915327da5cc0beb7",22855791,2,0,1,862,260,260,0
"b41c5a094a604ee0915327da5cc0beb7","d546341988904f069cfa86b21457d9d9",22855791,1,-10,0,864,260,251,-9
"d546341988904f069cfa86b21457d9d9","28c171777c52431ab6b925073bd63d46",22855791,1,15,0,865,251,264,13
"28c171777c52431ab6b925073bd63d46","28c171777c52431ab6b925073bd63d46",22855791,3,0,1,866,264,264,0
"28c171777c52431ab6b925073bd63d46","ac160db940cb49ae8579162b1d52bb5d",22855791,1,2,0,869,264,266,2
"ac160db940cb49ae8579162b1d52bb5d","ac160db940cb49ae8579162b1d52bb5d",22855791,3,0,1,870,266,266,0
"ac160db940cb49ae8579162b1d52bb5d","d989ebcfc12a4b669f0100dc1aa14f1e",22855791,1,-12,0,873,266,255,-11
"d989ebcfc12a4b669f0100dc1aa14f1e","c6fd49b485cc4874b0bbdd9c6171e09c",22855791,1,15,0,874,255,268,13
"c6fd49b485cc4874b0bbdd9c6171e09c","c6fd49b485cc4874b0bbdd9c6171e09c",22855791,3,0,1,875,268,268,0
"c6fd49b485cc4874b0bbdd9c6171e09c","44240778a97c4af0937817499b75707b",22855791,1,1,0,878,268,269,1
"44240778a97c4af0937817499b75707b","44240778a97c4af0937817499b75707b",22855791,2,0,1,879,269,269,0
"44240778a97c4af0937817499b75707b","7aa76d3e993840d8805f097cbdbcd44b",22855791,1,-9,0,881,269,261,-8
"7aa76d3e993840d8805f097cbdbcd44b","865a4d3b43374da7944dc7d397f566d9",22855791,1,12,0,882,261,271,10
"865a4d3b43374da7944dc7d397f566d9","865a4d3b43374da7944dc7d397f566d9",22855791,1,0,1,883,271,271,0
"865a4d3b43374da7944dc7d397f566d9","2ae94c0cea4d480a9d5dca8fb1d7b542",22855791,1,-35,0,884,271,242,-29
"2ae94c0cea4d480a9d5dca8fb1d7b542","0d987bed3ffa4ed0b9a2e62e97b7b30f",22855791,1,38,0,885,242,272,30
"0d987bed3ffa4ed0b9a2e62e97b7b30f","0c7262dff33c4087bc660ccf40f92f9c",22855791,1,-135,0,886,272,169,-103
"0c7262dff33c4087bc660ccf40f92f9c","0d987bed3ffa4ed0b9a2e62e97b7b30f",22855791,1,135,0,888,169,272,103
"0d987bed3ffa4ed0b9a2e62e97b7b30f","0d987bed3ffa4ed0b9a2e62e97b7b30f",22855791,4,0,1,889,272,272,0
"0d987bed3ffa4ed0b9a2e62e97b7b30f","82ae07bc0c9b4570a41799290d1ef399",22855791,1,4,0,893,272,275,3
"82ae07bc0c9b4570a41799290d1ef399","bb5a47f5ea01454a8b79455422d3b9da",22855791,1,6,0,894,275,280,5
"bb5a47f5ea01454a8b79455422d3b9da","0d987bed3ffa4ed0b9a2e62e97b7b30f",22855791,1,-10,0,902,280,272,-8
"0d987bed3ffa4ed0b9a2e62e97b7b30f","bc5524e78a8544e2ae2fdc2f3462bbec",22855791,1,9,0,903,272,279,7
"bc5524e78a8544e2ae2fdc2f3462bbec","bb5a47f5ea01454a8b79455422d3b9da",22855791,1,1,0,904,279,280,1
"bb5a47f5ea01454a8b79455422d3b9da","94cecc3f1e7d484b8e068e79241dfd73",22855791,1,3,0,967,280,281,1
"94cecc3f1e7d484b8e068e79241dfd73","94cecc3f1e7d484b8e068e79241dfd73",22855791,1,0,1,968,281,281,0
"94cecc3f1e7d484b8e068e79241dfd73","a37477c4e4c14169ad44b06b493007f6",22855791,1,2,0,969,281,283,2
"a37477c4e4c14169ad44b06b493007f6","94cecc3f1e7d484b8e068e79241dfd73",22855791,1,-2,0,970,283,281,-2
"94cecc3f1e7d484b8e068e79241dfd73","fab84b4fab5940efb4ea868ef8d09396",22855791,1,5,0,971,281,284,3
"fab84b4fab5940efb4ea868ef8d09396","4a29443515bb404cb8924e1c60a63b73",22855791,1,4,0,972,284,285,1
"4a29443515bb404cb8924e1c60a63b73","fab84b4fab5940efb4ea868ef8d09396",22855791,1,-4,0,973,285,284,-1
"fab84b4fab5940efb4ea868ef8d09396","208c9b2796c944db8dacaa96082520ea",22855791,1,7,0,974,284,288,4
"4a29443515bb404cb8924e1c60a63b73","0d987bed3ffa4ed0b9a2e62e97b7b30f",22855791,1,-22,0,979,285,272,-13
"bb5a47f5ea01454a8b79455422d3b9da","78adeee1fa2c4fe0bc73f7bca9fcee86",22855791,1,-162,0,988,280,160,-120
"82e6285962b8400d9d6fc32436022a94","78adeee1fa2c4fe0bc73f7bca9fcee86",22855791,1,-10,0,1000,167,160,-7
"78adeee1fa2c4fe0bc73f7bca9fcee86","3cbcea2be0984e7dbd5a48195af10ce7",22855791,1,8,0,1001,160,165,5
"3cbcea2be0984e7dbd5a48195af10ce7","65202579580f4ad38d734b4ee39d22a8",22855791,1,-3,0,1002,165,164,-1
"65202579580f4ad38d734b4ee39d22a8","65202579580f4ad38d734b4ee39d22a8",22855791,75,0,1,1003,164,164,0
"65202579580f4ad38d734b4ee39d22a8","0d987bed3ffa4ed0b9a2e62e97b7b30f",22855791,1,147,0,1010,164,272,108
"0d987bed3ffa4ed0b9a2e62e97b7b30f","bb5a47f5ea01454a8b79455422d3b9da",22855791,2,10,0,1011,272,280,8
"bb5a47f5ea01454a8b79455422d3b9da","bb5a47f5ea01454a8b79455422d3b9da",22855791,83,0,1,1012,280,280,0
"bb5a47f5ea01454a8b79455422d3b9da","4a29443515bb404cb8924e1c60a63b73",22855791,1,12,0,1019,280,285,5
"4a29443515bb404cb8924e1c60a63b73","4a29443515bb404cb8924e1c60a63b73",22855791,3,0,1,1020,285,285,0
"4a29443515bb404cb8924e1c60a63b73","208c9b2796c944db8dacaa96082520ea",22855791,2,3,0,1021,285,288,3
"208c9b2796c944db8dacaa96082520ea","208c9b2796c944db8dacaa96082520ea",22855791,3,0,1,1022,288,288,0
"208c9b2796c944db8dacaa96082520ea","4a29443515bb404cb8924e1c60a63b73",22855791,3,-3,0,1025,288,285,-3
"4a29443515bb404cb8924e1c60a63b73","7669a956527947d0add87455277e80b4",22855791,1,7,0,1026,285,291,6
"7669a956527947d0add87455277e80b4","7669a956527947d0add87455277e80b4",22855791,1,0,1,1027,291,291,0
"7669a956527947d0add87455277e80b4","6a9a3b5bde4a48daa896fe8c06eca56f",22855791,1,-2,0,1028,291,289,-2
"6a9a3b5bde4a48daa896fe8c06eca56f","869e967078f04da18dd0b0b9389a7424",22855791,1,5,0,1029,289,293,4
"869e967078f04da18dd0b0b9389a7424","869e967078f04da18dd0b0b9389a7424",22855791,2,0,1,1030,293,293,0
"869e967078f04da18dd0b0b9389a7424","51ab6291537748fab90d519aa09889d6",22855791,1,2,0,1032,293,295,2
"51ab6291537748fab90d519aa09889d6","51ab6291537748fab90d519aa09889d6",22855791,5,0,1,1033,295,295,0
"51ab6291537748fab90d519aa09889d6","34a6e49023fc4465bd5ca604330bbd1c",22855791,1,-3,0,1038,295,292,-3
"34a6e49023fc4465bd5ca604330bbd1c","ba0e59461bfb4a44b7b1c28a01f8d3b3",22855791,1,9,0,1039,292,299,7
"ba0e59461bfb4a44b7b1c28a01f8d3b3","21592f2a9e9c4b2f8c66ec5dbcbf6a2b",22855791,1,-4,0,1040,299,296,-3
"21592f2a9e9c4b2f8c66ec5dbcbf6a2b","ba0e59461bfb4a44b7b1c28a01f8d3b3",22855791,1,4,0,1041,296,299,3
"ba0e59461bfb4a44b7b1c28a01f8d3b3","ba0e59461bfb4a44b7b1c28a01f8d3b3",22855791,1,0,1,1042,299,299,0
"ba0e59461bfb4a44b7b1c28a01f8d3b3","0e0b36e731a645e7b1b8a88f5031ca38",22855791,1,2,0,1043,299,301,2
"0e0b36e731a645e7b1b8a88f5031ca38","0e0b36e731a645e7b1b8a88f5031ca38",22855791,5,0,1,1044,301,301,0
"0e0b36e731a645e7b1b8a88f5031ca38","a66a144637284c21afc6de17fea4bfb8",22855791,1,1,0,1049,301,302,1
"a66a144637284c21afc6de17fea4bfb8","a66a144637284c21afc6de17fea4bfb8",22855791,2,0,1,1050,302,302,0
"a66a144637284c21afc6de17fea4bfb8","7646a919d7e64fa990bca9b024ff089d",22855791,1,-4,0,1052,302,298,-4
"7646a919d7e64fa990bca9b024ff089d","e390b575229748ea8aac9364efe2bf00",22855791,1,7,0,1053,298,304,6
"e390b575229748ea8aac9364efe2bf00","e390b575229748ea8aac9364efe2bf00",22855791,1,0,1,1054,304,304,0
"e390b575229748ea8aac9364efe2bf00","4a29443515bb404cb8924e1c60a63b73",22855791,1,-24,0,1055,304,285,-19
"4a29443515bb404cb8924e1c60a63b73","3434c10e561d488a914e0f7d71907abd",22855791,2,27,0,1056,285,305,20
"3434c10e561d488a914e0f7d71907abd","53e7e900392747ccad52e711ab0f80d8",22855791,2,2,0,1057,305,307,2
"53e7e900392747ccad52e711ab0f80d8","2c5bb2cbd0014420ad8c95d40e38efd1",22855791,1,-6,0,1058,307,303,-4
"2c5bb2cbd0014420ad8c95d40e38efd1","4a29443515bb404cb8924e1c60a63b73",22855791,1,-23,0,1059,303,285,-18
"53e7e900392747ccad52e711ab0f80d8","53e7e900392747ccad52e711ab0f80d8",22855791,3,0,1,1063,307,307,0
"53e7e900392747ccad52e711ab0f80d8","3434c10e561d488a914e0f7d71907abd",22855791,1,-2,0,1066,307,305,-2
"3434c10e561d488a914e0f7d71907abd","130acc2aeb0448fdbb2de63bc5cebe5b",22855791,1,5,0,1067,305,309,4
"130acc2aeb0448fdbb2de63bc5cebe5b","130acc2aeb0448fdbb2de63bc5cebe5b",22855791,2,0,1,1068,309,309,0
"130acc2aeb0448fdbb2de63bc5cebe5b","9c062b3251034ebe90f5054e2a3b5120",22855791,1,2,0,1070,309,311,2
"9c062b3251034ebe90f5054e2a3b5120","9c062b3251034ebe90f5054e2a3b5120",22855791,2,0,1,1071,311,311,0
"9c062b3251034ebe90f5054e2a3b5120","ea859f8207e44537889daeaba13ac2e8",22855791,1,1,0,1073,311,312,1
"ea859f8207e44537889daeaba13ac2e8","ea859f8207e44537889daeaba13ac2e8",22855791,4,0,1,1074,312,312,0
"ea859f8207e44537889daeaba13ac2e8","56d94971a7a94257aa330183a8ebd0ea",22855791,1,1,0,1078,312,313,1
"56d94971a7a94257aa330183a8ebd0ea","56d94971a7a94257aa330183a8ebd0ea",22855791,1,0,1,1079,313,313,0
"56d94971a7a94257aa330183a8ebd0ea","141c0df6cd1946539aadd1c9b7068cd4",22855791,1,-5,0,1080,313,308,-5
"141c0df6cd1946539aadd1c9b7068cd4","13255e63e0aa4abf85e5211bf613d43e",22855791,1,10,0,1081,308,317,9
"13255e63e0aa4abf85e5211bf613d43e","13255e63e0aa4abf85e5211bf613d43e",22855791,1,0,1,1082,317,317,0
"13255e63e0aa4abf85e5211bf613d43e","86c27d40179e419c8e9d150fb6afa5d0",22855791,1,3,0,1083,317,319,2
"86c27d40179e419c8e9d150fb6afa5d0","0c787d16c9504873b1a4d903cec09948",22855791,1,-6,0,1084,319,314,-5
"0c787d16c9504873b1a4d903cec09948","86c27d40179e419c8e9d150fb6afa5d0",22855791,1,6,0,1085,314,319,5
"86c27d40179e419c8e9d150fb6afa5d0","86c27d40179e419c8e9d150fb6afa5d0",22855791,2,0,1,1086,319,319,0
"86c27d40179e419c8e9d150fb6afa5d0","24f1363179ad4aaa965484a78471912b",22855791,1,5,0,1088,319,323,4
"24f1363179ad4aaa965484a78471912b","47edbb64109243e6b0f8f64cdef90c6c",22855791,1,3,0,1089,323,326,3
"47edbb64109243e6b0f8f64cdef90c6c","8d7e0b55cf9849cda222a0f2440cec55",22855791,1,-9,0,1090,326,318,-8
"8d7e0b55cf9849cda222a0f2440cec55","24f1363179ad4aaa965484a78471912b",22855791,1,6,0,1091,318,323,5
"24f1363179ad4aaa965484a78471912b","24f1363179ad4aaa965484a78471912b",22855791,1,0,1,1092,323,323,0
"24f1363179ad4aaa965484a78471912b","3628bdce1dd2429ba924d2d4d09448d2",22855791,1,-1,0,1093,323,322,-1
"3628bdce1dd2429ba924d2d4d09448d2","56b3fd1a212a4764be39d979fde3326e",22855791,1,7,0,1094,322,328,6
"56b3fd1a212a4764be39d979fde3326e","56b3fd1a212a4764be39d979fde3326e",22855791,1,0,1,1095,328,328,0
"56b3fd1a212a4764be39d979fde3326e","0c4079457ede49e3aeb5e86ed84bdf35",22855791,1,3,0,1096,328,329,1
"0c4079457ede49e3aeb5e86ed84bdf35","3434c10e561d488a914e0f7d71907abd",22855791,1,-31,0,1097,329,305,-24
"3434c10e561d488a914e0f7d71907abd","38aea304b4fa46e1b29bb72f5cea4c93",22855791,1,33,0,1098,305,331,26
"38aea304b4fa46e1b29bb72f5cea4c93","38aea304b4fa46e1b29bb72f5cea4c93",22855791,3,0,1,1099,331,331,0
"38aea304b4fa46e1b29bb72f5cea4c93","e36d261332f14e79bb4b467aceaeb9b5",22855791,1,2,0,1102,331,333,2
"e36d261332f14e79bb4b467aceaeb9b5","e36d261332f14e79bb4b467aceaeb9b5",22855791,1,0,1,1103,333,333,0
"e36d261332f14e79bb4b467aceaeb9b5","c7e89b9d04744d2eab742fc24e3ef1ae",22855791,1,1,0,1104,333,334,1
"c7e89b9d04744d2eab742fc24e3ef1ae","c7e89b9d04744d2eab742fc24e3ef1ae",22855791,2,0,1,1105,334,334,0
"c7e89b9d04744d2eab742fc24e3ef1ae","fe49f8054b374a0ea4bb266ed135ff62",22855791,1,1,0,1107,334,335,1
"fe49f8054b374a0ea4bb266ed135ff62","fe49f8054b374a0ea4bb266ed135ff62",22855791,2,0,1,1108,335,335,0
"fe49f8054b374a0ea4bb266ed135ff62","d0a8f74af98642fe8360d22c42e45117",22855791,1,1,0,1110,335,336,1
"d0a8f74af98642fe8360d22c42e45117","d0a8f74af98642fe8360d22c42e45117",22855791,2,0,1,1111,336,336,0
"d0a8f74af98642fe8360d22c42e45117","0c4079457ede49e3aeb5e86ed84bdf35",22855791,1,-7,0,1113,336,329,-7
"0c4079457ede49e3aeb5e86ed84bdf35","a7c6339ca1da4368a18d471f0519f877",22855791,1,11,0,1114,329,339,10
"a7c6339ca1da4368a18d471f0519f877","a7c6339ca1da4368a18d471f0519f877",22855791,1,0,1,1115,339,339,0
"a7c6339ca1da4368a18d471f0519f877","bbc5139ca9024389a94db3a6f47dcff6",22855791,1,3,0,1116,339,341,2
"bbc5139ca9024389a94db3a6f47dcff6","b8b9418ab322418d9db9b40d96af873a",22855791,1,-5,0,1117,341,337,-4
"b8b9418ab322418d9db9b40d96af873a","bbc5139ca9024389a94db3a6f47dcff6",22855791,1,5,0,1118,337,341,4
"bbc5139ca9024389a94db3a6f47dcff6","0c4079457ede49e3aeb5e86ed84bdf35",22855791,1,-14,0,1119,341,329,-12
"0c4079457ede49e3aeb5e86ed84bdf35","c2490bc612d146edbe786556fab3651b",22855791,1,13,0,1120,329,340,11
"c2490bc612d146edbe786556fab3651b","bbc5139ca9024389a94db3a6f47dcff6",22855791,1,1,0,1121,340,341,1
"bbc5139ca9024389a94db3a6f47dcff6","bbc5139ca9024389a94db3a6f47dcff6",22855791,1,0,1,1122,341,341,0
"bbc5139ca9024389a94db3a6f47dcff6","4ee6ca9019ab4a1ab323f98094a9bd77",22855791,1,2,0,1123,341,343,2
"4ee6ca9019ab4a1ab323f98094a9bd77","4ee6ca9019ab4a1ab323f98094a9bd77",22855791,2,0,1,1124,343,343,0
"4ee6ca9019ab4a1ab323f98094a9bd77","b37947176785476f8b29d49a851366dc",22855791,1,1,0,1126,343,344,1
"b37947176785476f8b29d49a851366dc","b37947176785476f8b29d49a851366dc",22855791,2,0,1,1127,344,344,0
"b37947176785476f8b29d49a851366dc","fcea5b10d5a14a3b9324ffece8f6e1e5",22855791,1,1,0,1129,344,345,1
"fcea5b10d5a14a3b9324ffece8f6e1e5","fcea5b10d5a14a3b9324ffece8f6e1e5",22855791,2,0,1,1130,345,345,0
"fcea5b10d5a14a3b9324ffece8f6e1e5","c2490bc612d146edbe786556fab3651b",22855791,1,-5,0,1132,345,340,-5
"c2490bc612d146edbe786556fab3651b","6ac8bb048b854999a47edb35fe627f11",22855791,1,8,0,1133,340,347,7
"6ac8bb048b854999a47edb35fe627f11","6ac8bb048b854999a47edb35fe627f11",22855791,1,0,1,1134,347,347,0
"6ac8bb048b854999a47edb35fe627f11","30ead9794d4847abaf222ca966cc8630",22855791,1,3,0,1135,347,348,1
"30ead9794d4847abaf222ca966cc8630","0c4079457ede49e3aeb5e86ed84bdf35",22855791,1,-24,0,1136,348,329,-19
"0c4079457ede49e3aeb5e86ed84bdf35","09b9678ddc3d452ea4a3d46e15826065",22855791,1,29,0,1137,329,353,24
"09b9678ddc3d452ea4a3d46e15826065","897b7f51242c44aab2205c72fdcbf4cd",22855791,1,-1,0,1138,353,352,-1
"897b7f51242c44aab2205c72fdcbf4cd","c20993c944444fe085345591a8bd837e",22855791,1,-1,0,1139,352,351,-1
"c20993c944444fe085345591a8bd837e","eff0de7f2dbb42dfa1a2e686efab5b6d",22855791,1,3,0,1140,351,354,3
"eff0de7f2dbb42dfa1a2e686efab5b6d","c20993c944444fe085345591a8bd837e",22855791,1,-3,0,1141,354,351,-3
"c20993c944444fe085345591a8bd837e","c20993c944444fe085345591a8bd837e",22855791,3,0,1,1142,351,351,0
"c20993c944444fe085345591a8bd837e","897b7f51242c44aab2205c72fdcbf4cd",22855791,1,1,0,1145,351,352,1
"897b7f51242c44aab2205c72fdcbf4cd","897b7f51242c44aab2205c72fdcbf4cd",22855791,3,0,1,1146,352,352,0
"897b7f51242c44aab2205c72fdcbf4cd","09b9678ddc3d452ea4a3d46e15826065",22855791,1,1,0,1149,352,353,1
"09b9678ddc3d452ea4a3d46e15826065","09b9678ddc3d452ea4a3d46e15826065",22855791,3,0,1,1150,353,353,0
"09b9678ddc3d452ea4a3d46e15826065","eff0de7f2dbb42dfa1a2e686efab5b6d",22855791,1,1,0,1153,353,354,1
"eff0de7f2dbb42dfa1a2e686efab5b6d","eff0de7f2dbb42dfa1a2e686efab5b6d",22855791,3,0,1,1154,354,354,0
"eff0de7f2dbb42dfa1a2e686efab5b6d","2fe14166dc9642c3bc666b86a57f943d",22855791,1,4,0,1157,354,357,3
"2fe14166dc9642c3bc666b86a57f943d","30ead9794d4847abaf222ca966cc8630",22855791,1,-10,0,1158,357,348,-9
"30ead9794d4847abaf222ca966cc8630","2fe14166dc9642c3bc666b86a57f943d",22855791,1,10,0,1159,348,357,9
"2fe14166dc9642c3bc666b86a57f943d","2fe14166dc9642c3bc666b86a57f943d",22855791,1,0,1,1160,357,357,0
"2fe14166dc9642c3bc666b86a57f943d","44421dd1e13a47a388c4a19834b744c7",22855791,1,2,0,1161,357,359,2
"44421dd1e13a47a388c4a19834b744c7","44421dd1e13a47a388c4a19834b744c7",22855791,2,0,1,1162,359,359,0
"44421dd1e13a47a388c4a19834b744c7","cb5fc7ef85d547c4be1a7439d0bf6052",22855791,1,1,0,1164,359,360,1
"cb5fc7ef85d547c4be1a7439d0bf6052","cb5fc7ef85d547c4be1a7439d0bf6052",22855791,2,0,1,1165,360,360,0
"cb5fc7ef85d547c4be1a7439d0bf6052","0a8f150a4cf747acbde62f4721823da3",22855791,1,1,0,1167,360,361,1
"0a8f150a4cf747acbde62f4721823da3","0a8f150a4cf747acbde62f4721823da3",22855791,2,0,1,1168,361,361,0
"0a8f150a4cf747acbde62f4721823da3","ab8fdad974ae471f9f24c3f9dd04462e",22855791,1,1,0,1170,361,362,1
"ab8fdad974ae471f9f24c3f9dd04462e","ab8fdad974ae471f9f24c3f9dd04462e",22855791,2,0,1,1171,362,362,0
"ab8fdad974ae471f9f24c3f9dd04462e","1ba8fef685d74a8194b9db252eb704fb",22855791,1,-7,0,1173,362,355,-7
"1ba8fef685d74a8194b9db252eb704fb","52580888dadb4fe3baa795683ea227bd",22855791,1,10,0,1174,355,364,9
"52580888dadb4fe3baa795683ea227bd","52580888dadb4fe3baa795683ea227bd",22855791,2,0,1,1175,364,364,0
"52580888dadb4fe3baa795683ea227bd","492a3bc6a1254f23a7998587961b22a4",22855791,1,3,0,1176,364,366,2
"492a3bc6a1254f23a7998587961b22a4","f00179e251a045b39c3f7a54f9aa4acc",22855791,1,-4,0,1177,366,363,-3
"f00179e251a045b39c3f7a54f9aa4acc","492a3bc6a1254f23a7998587961b22a4",22855791,1,4,0,1178,363,366,3
"492a3bc6a1254f23a7998587961b22a4","492a3bc6a1254f23a7998587961b22a4",22855791,1,0,1,1179,366,366,0
"492a3bc6a1254f23a7998587961b22a4","072a190fd302456290895f9f04d6940a",22855791,1,-1,0,1180,366,365,-1
"072a190fd302456290895f9f04d6940a","cfa457d1743848e4bb5e4beced6448ed",22855791,1,5,0,1181,365,369,4
"cfa457d1743848e4bb5e4beced6448ed","cfa457d1743848e4bb5e4beced6448ed",22855791,3,0,1,1182,369,369,0
"cfa457d1743848e4bb5e4beced6448ed","b71bac264efb4abd97015447bd490db6",22855791,1,3,0,1185,369,370,1
"b71bac264efb4abd97015447bd490db6","30ead9794d4847abaf222ca966cc8630",22855791,1,-28,0,1186,370,348,-22
"30ead9794d4847abaf222ca966cc8630","8d448d625b024c82a5eb240bbd7431d6",22855791,1,33,0,1187,348,374,26
"8d448d625b024c82a5eb240bbd7431d6","8d448d625b024c82a5eb240bbd7431d6",22855791,86,0,1,1188,374,374,0
"8d448d625b024c82a5eb240bbd7431d6","b71bac264efb4abd97015447bd490db6",22855791,4,-5,0,1191,374,370,-4
"b71bac264efb4abd97015447bd490db6","8d448d625b024c82a5eb240bbd7431d6",22855791,5,5,0,1192,370,374,4
"8d448d625b024c82a5eb240bbd7431d6","4a29443515bb404cb8924e1c60a63b73",22855791,2,-115,0,1196,374,285,-89
"4a29443515bb404cb8924e1c60a63b73","c33c17be71ae4d588da7369472e5bb1b",22855791,1,-342,0,1197,285,34,-251
"c33c17be71ae4d588da7369472e5bb1b","c33c17be71ae4d588da7369472e5bb1b",22855791,3,0,1,1198,34,34,0
"c33c17be71ae4d588da7369472e5bb1b","b71bac264efb4abd97015447bd490db6",22855791,1,452,0,1199,34,370,336
"b71bac264efb4abd97015447bd490db6","1b4550d0dab04078b3bf08a655345bdc",22855791,2,4,0,1200,370,373,3
"1b4550d0dab04078b3bf08a655345bdc","8d448d625b024c82a5eb240bbd7431d6",22855791,1,1,0,1201,373,374,1
"4a29443515bb404cb8924e1c60a63b73","30ead9794d4847abaf222ca966cc8630",22855791,1,82,0,1210,285,348,63
"30ead9794d4847abaf222ca966cc8630","f00179e251a045b39c3f7a54f9aa4acc",22855791,1,17,0,1211,348,363,15
"f00179e251a045b39c3f7a54f9aa4acc","52580888dadb4fe3baa795683ea227bd",22855791,1,1,0,1212,363,364,1
"52580888dadb4fe3baa795683ea227bd","4a29443515bb404cb8924e1c60a63b73",22855791,1,-100,0,1214,364,285,-79
"4a29443515bb404cb8924e1c60a63b73","1b4550d0dab04078b3bf08a655345bdc",22855791,1,114,0,1215,285,373,88
"1b4550d0dab04078b3bf08a655345bdc","b71bac264efb4abd97015447bd490db6",22855791,3,-4,0,1216,373,370,-3
"8d448d625b024c82a5eb240bbd7431d6","66baf19b6b904b70922329068c63746d",22855791,1,7,0,1225,374,376,2
"66baf19b6b904b70922329068c63746d","66baf19b6b904b70922329068c63746d",22855791,1,0,1,1226,376,376,0
"66baf19b6b904b70922329068c63746d","7f544639412e40a9ba27f43b415362ab",22855791,3,2,0,1227,376,378,2
"7f544639412e40a9ba27f43b415362ab","7f544639412e40a9ba27f43b415362ab",22855791,2,0,1,1228,378,378,0
"7f544639412e40a9ba27f43b415362ab","d5ae8642e15b46b8bd298b02274d4e9c",22855791,1,2,0,1230,378,380,2
"d5ae8642e15b46b8bd298b02274d4e9c","d5ae8642e15b46b8bd298b02274d4e9c",22855791,4,0,1,1231,380,380,0
"d5ae8642e15b46b8bd298b02274d4e9c","a0d10309a2dd456289147f84be9d37f9",22855791,1,1,0,1235,380,381,1
"a0d10309a2dd456289147f84be9d37f9","a0d10309a2dd456289147f84be9d37f9",22855791,2,0,1,1236,381,381,0
"a0d10309a2dd456289147f84be9d37f9","0fcbc3ca07b144138b8d85da581f09a8",22855791,1,1,0,1238,381,382,1
"0fcbc3ca07b144138b8d85da581f09a8","0fcbc3ca07b144138b8d85da581f09a8",22855791,2,0,1,1239,382,382,0
"0fcbc3ca07b144138b8d85da581f09a8","66baf19b6b904b70922329068c63746d",22855791,1,-6,0,1241,382,376,-6
"66baf19b6b904b70922329068c63746d","c2fca3669923477ab966ded303dea31c",22855791,1,8,0,1242,376,383,7
"c2fca3669923477ab966ded303dea31c","4890121ce5d74576b4632b77cfc23398",22855791,2,6,0,1243,383,388,5
"4890121ce5d74576b4632b77cfc23398","18d3b836dd804224883cc9180b60a8e1",22855791,2,-1,0,1244,388,387,-1
"18d3b836dd804224883cc9180b60a8e1","c2fca3669923477ab966ded303dea31c",22855791,1,-5,0,1245,387,383,-4
"4890121ce5d74576b4632b77cfc23398","4890121ce5d74576b4632b77cfc23398",22855791,2,0,1,1247,388,388,0
"18d3b836dd804224883cc9180b60a8e1","96bb2b3e85a34d8b9544514e89f6fe97",22855791,1,4,0,1250,387,390,3
"96bb2b3e85a34d8b9544514e89f6fe97","96bb2b3e85a34d8b9544514e89f6fe97",22855791,3,0,1,1251,390,390,0
"96bb2b3e85a34d8b9544514e89f6fe97","ac4e9b54acfe4670b4634859c7263cb5",22855791,1,2,0,1253,390,392,2
"ac4e9b54acfe4670b4634859c7263cb5","ac4e9b54acfe4670b4634859c7263cb5",22855791,1,0,1,1254,392,392,0
"ac4e9b54acfe4670b4634859c7263cb5","17f95d18bab743888e1736033dc3384d",22855791,1,-3,0,1255,392,389,-3
"17f95d18bab743888e1736033dc3384d","6f8881a745ac4c358a68b92c3b4abe81",22855791,2,6,0,1256,389,394,5
"6f8881a745ac4c358a68b92c3b4abe81","6f8881a745ac4c358a68b92c3b4abe81",22855791,3,0,1,1257,394,394,0
"6f8881a745ac4c358a68b92c3b4abe81","17f95d18bab743888e1736033dc3384d",22855791,1,-6,0,1258,394,389,-5
"17f95d18bab743888e1736033dc3384d","66baf19b6b904b70922329068c63746d",22855791,1,-16,0,1259,389,376,-13
"66baf19b6b904b70922329068c63746d","96bb2b3e85a34d8b9544514e89f6fe97",22855791,1,17,0,1260,376,390,14
"96bb2b3e85a34d8b9544514e89f6fe97","17f95d18bab743888e1736033dc3384d",22855791,1,-1,0,1262,390,389,-1
"6f8881a745ac4c358a68b92c3b4abe81","f7002c8484354eceac57bc7bd62c76c1",22855791,1,-1,0,1266,394,393,-1
"f7002c8484354eceac57bc7bd62c76c1","44a277ea44dc4ae689fab4b82f0b4098",22855791,1,5,0,1267,393,397,4
"44a277ea44dc4ae689fab4b82f0b4098","44a277ea44dc4ae689fab4b82f0b4098",22855791,1,0,1,1268,397,397,0
"44a277ea44dc4ae689fab4b82f0b4098","0c12af0a4e7f4002852cf84b2537c161",22855791,1,-2,0,1269,397,395,-2
"0c12af0a4e7f4002852cf84b2537c161","859e0b8d71694b12befb69ee698138f9",22855791,1,5,0,1270,395,399,4
"859e0b8d71694b12befb69ee698138f9","859e0b8d71694b12befb69ee698138f9",22855791,1,0,1,1271,399,399,0
"859e0b8d71694b12befb69ee698138f9","66baf19b6b904b70922329068c63746d",22855791,1,-29,0,1272,399,376,-23
"66baf19b6b904b70922329068c63746d","2b09a08242b54983aec7063990fb3f66",22855791,2,32,0,1273,376,400,24
"2b09a08242b54983aec7063990fb3f66","2b09a08242b54983aec7063990fb3f66",22855791,4,0,1,1274,400,400,0
"2b09a08242b54983aec7063990fb3f66","66baf19b6b904b70922329068c63746d",22855791,2,-32,0,1275,400,376,-24
"66baf19b6b904b70922329068c63746d","df8191ec5e584c838a899c378941a566",22855791,1,28,0,1276,376,398,22
"df8191ec5e584c838a899c378941a566","2b09a08242b54983aec7063990fb3f66",22855791,1,4,0,1277,398,400,2
"2b09a08242b54983aec7063990fb3f66","1f471b7a883a4df48211e8c6a81b59a7",22855791,1,1,0,1283,400,401,1
"1f471b7a883a4df48211e8c6a81b59a7","1f471b7a883a4df48211e8c6a81b59a7",22855791,1,0,1,1284,401,401,0
"1f471b7a883a4df48211e8c6a81b59a7","2b09a08242b54983aec7063990fb3f66",22855791,1,-1,0,1285,401,400,-1
"2b09a08242b54983aec7063990fb3f66","9de0d567bfa84fe5b77cb76f4a76a5d1",22855791,1,5,0,1286,400,404,4
"9de0d567bfa84fe5b77cb76f4a76a5d1","9de0d567bfa84fe5b77cb76f4a76a5d1",22855791,1,0,1,1287,404,404,0
"9de0d567bfa84fe5b77cb76f4a76a5d1","1157bd665ec4472fb58b751dc5099355",22855791,1,-1,0,1288,404,403,-1
"1157bd665ec4472fb58b751dc5099355","58fc9094275e4c49be3f4ba6d4acc0a4",22855791,1,5,0,1289,403,406,3
"58fc9094275e4c49be3f4ba6d4acc0a4","3c8a22d2f9c146ea956609e3ed4f2559",22855791,1,-2,0,1290,406,405,-1
"3c8a22d2f9c146ea956609e3ed4f2559","58fc9094275e4c49be3f4ba6d4acc0a4",22855791,1,2,0,1291,405,406,1
"58fc9094275e4c49be3f4ba6d4acc0a4","58fc9094275e4c49be3f4ba6d4acc0a4",22855791,1,0,1,1292,406,406,0
"58fc9094275e4c49be3f4ba6d4acc0a4","c1c1be90b2b14c1ab4a5e1ee3c241902",22855791,1,1,0,1293,406,407,1
"c1c1be90b2b14c1ab4a5e1ee3c241902","c1c1be90b2b14c1ab4a5e1ee3c241902",22855791,5,0,1,1294,407,407,0
"c1c1be90b2b14c1ab4a5e1ee3c241902","58fc9094275e4c49be3f4ba6d4acc0a4",22855791,1,-1,0,1299,407,406,-1
"58fc9094275e4c49be3f4ba6d4acc0a4","02b3a1bead9244c1ba2f857c7da8f82a",22855791,1,3,0,1300,406,408,2
"02b3a1bead9244c1ba2f857c7da8f82a","02b3a1bead9244c1ba2f857c7da8f82a",22855791,2,0,1,1301,408,408,0
"02b3a1bead9244c1ba2f857c7da8f82a","6206fc6479014bb193084c32409dc1b9",22855791,1,1,0,1303,408,409,1
"6206fc6479014bb193084c32409dc1b9","6206fc6479014bb193084c32409dc1b9",22855791,1,0,1,1304,409,409,0
"6206fc6479014bb193084c32409dc1b9","02b3a1bead9244c1ba2f857c7da8f82a",22855791,1,-1,0,1305,409,408,-1
"02b3a1bead9244c1ba2f857c7da8f82a","6a5f020451db426dacba9e2ea3fcc62a",22855791,1,3,0,1306,408,410,2
"6a5f020451db426dacba9e2ea3fcc62a","6a5f020451db426dacba9e2ea3fcc62a",22855791,2,0,1,1307,410,410,0
"6a5f020451db426dacba9e2ea3fcc62a","33a9d248b2e44588a5b07fc1342b9bc2",22855791,2,2,0,1309,410,411,1
"33a9d248b2e44588a5b07fc1342b9bc2","6a5f020451db426dacba9e2ea3fcc62a",22855791,1,-2,0,1310,411,410,-1
"33a9d248b2e44588a5b07fc1342b9bc2","33a9d248b2e44588a5b07fc1342b9bc2",22855791,3,0,1,1312,411,411,0
"33a9d248b2e44588a5b07fc1342b9bc2","c6f26bd420634f1cb7989e76fe6b16c0",22855791,1,1,0,1313,411,412,1
"c6f26bd420634f1cb7989e76fe6b16c0","c6f26bd420634f1cb7989e76fe6b16c0",22855791,5,0,1,1314,412,412,0
"c6f26bd420634f1cb7989e76fe6b16c0","2a65ee6e2ac64f6a8a55fbe5373ec763",22855791,1,1,0,1319,412,413,1
"2a65ee6e2ac64f6a8a55fbe5373ec763","2a65ee6e2ac64f6a8a55fbe5373ec763",22855791,2,0,1,1320,413,413,0
"2a65ee6e2ac64f6a8a55fbe5373ec763","33a9d248b2e44588a5b07fc1342b9bc2",22855791,1,-2,0,1322,413,411,-2
"33a9d248b2e44588a5b07fc1342b9bc2","2b09a08242b54983aec7063990fb3f66",22855791,1,-17,0,1324,411,400,-11
"2b09a08242b54983aec7063990fb3f66","33a9d248b2e44588a5b07fc1342b9bc2",22855791,1,17,0,1325,400,411,11
"33a9d248b2e44588a5b07fc1342b9bc2","1fd0f6dadbc14ebc965faf6122190b96",22855791,1,5,0,1327,411,415,4
"1fd0f6dadbc14ebc965faf6122190b96","1fd0f6dadbc14ebc965faf6122190b96",22855791,1,0,1,1328,415,415,0
"1fd0f6dadbc14ebc965faf6122190b96","687055dad9fc40c3982478fe33ec01bf",22855791,1,-1,0,1329,415,414,-1
"687055dad9fc40c3982478fe33ec01bf","2add1669f08d4101913db15f8c23b3b7",22855791,1,3,0,1330,414,416,2
"2add1669f08d4101913db15f8c23b3b7","2add1669f08d4101913db15f8c23b3b7",22855791,1,0,1,1331,416,416,0
"2add1669f08d4101913db15f8c23b3b7","2b09a08242b54983aec7063990fb3f66",22855791,1,-24,0,1332,416,400,-16
"2b09a08242b54983aec7063990fb3f66","a2b4bd40cee2481ebd3fc179d6a5cd62",22855791,1,27,0,1333,400,417,17
"a2b4bd40cee2481ebd3fc179d6a5cd62","a2b4bd40cee2481ebd3fc179d6a5cd62",22855791,4,0,1,1334,417,417,0
"a2b4bd40cee2481ebd3fc179d6a5cd62","e34e59dce2204f228f3a84b6725df60f",22855791,1,2,0,1336,417,419,2
"e34e59dce2204f228f3a84b6725df60f","e34e59dce2204f228f3a84b6725df60f",22855791,1,0,1,1337,419,419,0
"e34e59dce2204f228f3a84b6725df60f","bec48fc2e1294c7eb3d0aca780d731b8",22855791,1,2,0,1338,419,420,1
"bec48fc2e1294c7eb3d0aca780d731b8","a2b4bd40cee2481ebd3fc179d6a5cd62",22855791,1,-4,0,1339,420,417,-3
"a2b4bd40cee2481ebd3fc179d6a5cd62","bec48fc2e1294c7eb3d0aca780d731b8",22855791,2,4,0,1340,417,420,3
"bec48fc2e1294c7eb3d0aca780d731b8","1b4550d0dab04078b3bf08a655345bdc",22855791,1,-71,0,1341,420,373,-47
"b71bac264efb4abd97015447bd490db6","d6d02b6ef04e4f17805504500b8ce441",22855791,2,8,0,1399,370,375,5
"d6d02b6ef04e4f17805504500b8ce441","d6d02b6ef04e4f17805504500b8ce441",22855791,12,0,1,1400,375,375,0
"d6d02b6ef04e4f17805504500b8ce441","66baf19b6b904b70922329068c63746d",22855791,2,4,0,1402,375,376,1
"7f544639412e40a9ba27f43b415362ab","d6d02b6ef04e4f17805504500b8ce441",22855791,1,-6,0,1404,378,375,-3
"d6d02b6ef04e4f17805504500b8ce441","a2b4bd40cee2481ebd3fc179d6a5cd62",22855791,1,63,0,1408,375,417,42
"bec48fc2e1294c7eb3d0aca780d731b8","bec48fc2e1294c7eb3d0aca780d731b8",22855791,5,0,1,1412,420,420,0
"bec48fc2e1294c7eb3d0aca780d731b8","a24600b0e49245f6bdba8c893cfeddb0",22855791,1,7,0,1417,420,425,5
"a24600b0e49245f6bdba8c893cfeddb0","dbde19fcce2a4c1abdc7f685c293a23f",22855791,1,-4,0,1418,425,422,-3
"dbde19fcce2a4c1abdc7f685c293a23f","a24600b0e49245f6bdba8c893cfeddb0",22855791,1,4,0,1419,422,425,3
"a24600b0e49245f6bdba8c893cfeddb0","a24600b0e49245f6bdba8c893cfeddb0",22855791,2,0,1,1420,425,425,0
"a24600b0e49245f6bdba8c893cfeddb0","24cf8786024543f19b89bc20034e60d7",22855791,1,7,0,1422,425,428,3
"24cf8786024543f19b89bc20034e60d7","a2b4bd40cee2481ebd3fc179d6a5cd62",22855791,1,-18,0,1423,428,417,-11
"a2b4bd40cee2481ebd3fc179d6a5cd62","f2a73be2f46840b182d7bd095378004e",22855791,1,19,0,1424,417,429,12
"f2a73be2f46840b182d7bd095378004e","f2a73be2f46840b182d7bd095378004e",22855791,3,0,1,1425,429,429,0
"f2a73be2f46840b182d7bd095378004e","604551fd4266430cb860fef58fa7dd61",22855791,1,1,0,1428,429,430,1
"604551fd4266430cb860fef58fa7dd61","604551fd4266430cb860fef58fa7dd61",22855791,1,0,1,1429,430,430,0
"604551fd4266430cb860fef58fa7dd61","dce46f8904594a62a6377a3587aaa663",22855791,1,2,0,1430,430,431,1
"dce46f8904594a62a6377a3587aaa663","24cf8786024543f19b89bc20034e60d7",22855791,1,-4,0,1431,431,428,-3
"24cf8786024543f19b89bc20034e60d7","dce46f8904594a62a6377a3587aaa663",22855791,1,4,0,1432,428,431,3
"dce46f8904594a62a6377a3587aaa663","dce46f8904594a62a6377a3587aaa663",22855791,1,0,1,1433,431,431,0
"dce46f8904594a62a6377a3587aaa663","9b9d0a249052413c869753b99682b0ac",22855791,1,1,0,1434,431,432,1
"9b9d0a249052413c869753b99682b0ac","9b9d0a249052413c869753b99682b0ac",22855791,3,0,1,1435,432,432,0
"9b9d0a249052413c869753b99682b0ac","061c175cc90f45fbad883025394e78dd",22855791,1,1,0,1438,432,433,1
"061c175cc90f45fbad883025394e78dd","061c175cc90f45fbad883025394e78dd",22855791,1,0,1,1439,433,433,0
"061c175cc90f45fbad883025394e78dd","dce46f8904594a62a6377a3587aaa663",22855791,1,-2,0,1440,433,431,-2
"dce46f8904594a62a6377a3587aaa663","74a7f8712e5449c2bc0b43c6f90dafed",22855791,1,5,0,1441,431,435,4
"74a7f8712e5449c2bc0b43c6f90dafed","74a7f8712e5449c2bc0b43c6f90dafed",22855791,1,0,1,1442,435,435,0
"74a7f8712e5449c2bc0b43c6f90dafed","66ada10dde9f43018588f1ced9d477fc",22855791,1,-1,0,1443,435,434,-1
"66ada10dde9f43018588f1ced9d477fc","bf12c96466d840a69bed7020b3f18bb8",22855791,1,3,0,1444,434,436,2
"bf12c96466d840a69bed7020b3f18bb8","bf12c96466d840a69bed7020b3f18bb8",22855791,1,0,1,1445,436,436,0
"bf12c96466d840a69bed7020b3f18bb8","24cf8786024543f19b89bc20034e60d7",22855791,1,-11,0,1446,436,428,-8
"24cf8786024543f19b89bc20034e60d7","070600601c4c439288445d2f0724807d",22855791,1,14,0,1447,428,437,9
"070600601c4c439288445d2f0724807d","1823b6de7d334a7aaabc4570719af4d9",22855791,2,2,0,1448,437,439,2
"1823b6de7d334a7aaabc4570719af4d9","66baf19b6b904b70922329068c63746d",22855791,1,-93,0,1449,439,376,-63
"66baf19b6b904b70922329068c63746d","070600601c4c439288445d2f0724807d",22855791,1,91,0,1450,376,437,61
"070600601c4c439288445d2f0724807d","070600601c4c439288445d2f0724807d",22855791,1,0,1,1451,437,437,0
"1823b6de7d334a7aaabc4570719af4d9","1823b6de7d334a7aaabc4570719af4d9",22855791,10,0,1,1453,439,439,0
"1823b6de7d334a7aaabc4570719af4d9","0380cd76a7d44bc3a4da1f15e4d68f89",22855791,1,2,0,1463,439,440,1
"0380cd76a7d44bc3a4da1f15e4d68f89","070600601c4c439288445d2f0724807d",22855791,1,-4,0,1464,440,437,-3
"070600601c4c439288445d2f0724807d","0380cd76a7d44bc3a4da1f15e4d68f89",22855791,1,4,0,1465,437,440,3
"0380cd76a7d44bc3a4da1f15e4d68f89","0380cd76a7d44bc3a4da1f15e4d68f89",22855791,1,0,1,1466,440,440,0
"0380cd76a7d44bc3a4da1f15e4d68f89","23b7673c8b5443108c2ef09382834a86",22855791,2,2,0,1467,440,441,1
"23b7673c8b5443108c2ef09382834a86","0380cd76a7d44bc3a4da1f15e4d68f89",22855791,1,-2,0,1468,441,440,-1
"23b7673c8b5443108c2ef09382834a86","23b7673c8b5443108c2ef09382834a86",22855791,1,0,1,1470,441,441,0
"23b7673c8b5443108c2ef09382834a86","901e92500aea43c79f19f1b279050668",22855791,2,2,0,1471,441,442,1
"901e92500aea43c79f19f1b279050668","23b7673c8b5443108c2ef09382834a86",22855791,1,-2,0,1472,442,441,-1
"901e92500aea43c79f19f1b279050668","901e92500aea43c79f19f1b279050668",22855791,1,0,1,1474,442,442,0
"901e92500aea43c79f19f1b279050668","001339db8ced4cf78829ebe8b145449d",22855791,1,1,0,1475,442,443,1
"001339db8ced4cf78829ebe8b145449d","001339db8ced4cf78829ebe8b145449d",22855791,8,0,1,1476,443,443,0
"001339db8ced4cf78829ebe8b145449d","452745e0366e42ae81561bfddebcc6c3",22855791,1,1,0,1484,443,444,1
"452745e0366e42ae81561bfddebcc6c3","452745e0366e42ae81561bfddebcc6c3",22855791,2,0,1,1485,444,444,0
"452745e0366e42ae81561bfddebcc6c3","901e92500aea43c79f19f1b279050668",22855791,1,-2,0,1487,444,442,-2
"901e92500aea43c79f19f1b279050668","4660ff2089114e8db82ceb26a4f329e3",22855791,1,4,0,1488,442,445,3
"4660ff2089114e8db82ceb26a4f329e3","4660ff2089114e8db82ceb26a4f329e3",22855791,5,0,1,1489,445,445,0
"4660ff2089114e8db82ceb26a4f329e3","7bd5586eb9d8484eb74a433ee7bfe499",22855791,1,2,0,1494,445,446,1
"7bd5586eb9d8484eb74a433ee7bfe499","7bd5586eb9d8484eb74a433ee7bfe499",22855791,9,0,1,1495,446,446,0
"7bd5586eb9d8484eb74a433ee7bfe499","8a7f26e690f34dda97be16904518ca99",22855791,1,2,0,1504,446,447,1
"8a7f26e690f34dda97be16904518ca99","8a7f26e690f34dda97be16904518ca99",22855791,1,0,1,1505,447,447,0
"8a7f26e690f34dda97be16904518ca99","070600601c4c439288445d2f0724807d",22855791,1,-16,0,1506,447,437,-10
"070600601c4c439288445d2f0724807d","b2f0d654738f48158edff28e8d3a546e",22855791,1,21,0,1507,437,449,12
"b2f0d654738f48158edff28e8d3a546e","b2f0d654738f48158edff28e8d3a546e",22855791,2,0,1,1508,449,449,0
"b2f0d654738f48158edff28e8d3a546e","f60ee41ec635499abd48168342d32c2f",22855791,4,5,0,1509,449,453,4
"f60ee41ec635499abd48168342d32c2f","f60ee41ec635499abd48168342d32c2f",22855791,65,0,1,1510,453,453,0
"f60ee41ec635499abd48168342d32c2f","d6d02b6ef04e4f17805504500b8ce441",22855791,1,-121,0,1517,453,375,-78
"d6d02b6ef04e4f17805504500b8ce441","9428d8bd9c5a47b2a235b254e5e27ded",22855791,1,120,0,1523,375,452,77
"9428d8bd9c5a47b2a235b254e5e27ded","b2f0d654738f48158edff28e8d3a546e",22855791,1,-4,0,1524,452,449,-3
"f60ee41ec635499abd48168342d32c2f","b71bac264efb4abd97015447bd490db6",22855791,1,-129,0,1533,453,370,-83
"b71bac264efb4abd97015447bd490db6","b71bac264efb4abd97015447bd490db6",22855791,2,0,1,1543,370,370,0
"7f544639412e40a9ba27f43b415362ab","66baf19b6b904b70922329068c63746d",22855791,1,-2,0,1559,378,376,-2
"66baf19b6b904b70922329068c63746d","b2f0d654738f48158edff28e8d3a546e",22855791,1,112,0,1560,376,449,73
"f60ee41ec635499abd48168342d32c2f","b2f0d654738f48158edff28e8d3a546e",22855791,1,-5,0,1569,453,449,-4
"f60ee41ec635499abd48168342d32c2f","f67fbf45a5f146ed866965bc57c7c001",22855791,1,3,0,1616,453,454,1
"f67fbf45a5f146ed866965bc57c7c001","b2f0d654738f48158edff28e8d3a546e",22855791,1,-8,0,1617,454,449,-5
"b2f0d654738f48158edff28e8d3a546e","f67fbf45a5f146ed866965bc57c7c001",22855791,1,8,0,1618,449,454,5
"f67fbf45a5f146ed866965bc57c7c001","f67fbf45a5f146ed866965bc57c7c001",22855791,3,0,1,1619,454,454,0
"f67fbf45a5f146ed866965bc57c7c001","d937afe49bd24a07a550dda1c1155122",22855791,1,1,0,1622,454,455,1
"d937afe49bd24a07a550dda1c1155122","d937afe49bd24a07a550dda1c1155122",22855791,3,0,1,1623,455,455,0
"d937afe49bd24a07a550dda1c1155122","3628b3f7823443d0912a339096b69943",22855791,1,1,0,1626,455,456,1
"3628b3f7823443d0912a339096b69943","3628b3f7823443d0912a339096b69943",22855791,1,0,1,1627,456,456,0
"3628b3f7823443d0912a339096b69943","9e049ee647cf43ecbcb5ed792a8e7588",22855791,1,1,0,1628,456,457,1
"9e049ee647cf43ecbcb5ed792a8e7588","9e049ee647cf43ecbcb5ed792a8e7588",22855791,1,0,1,1629,457,457,0
"9e049ee647cf43ecbcb5ed792a8e7588","5256a214faaf410b93f76cea06428334",22855791,1,1,0,1630,457,458,1
"5256a214faaf410b93f76cea06428334","5256a214faaf410b93f76cea06428334",22855791,1,0,1,1631,458,458,0
"5256a214faaf410b93f76cea06428334","25c32b120fce40fa9b6c85133aeb4716",22855791,1,1,0,1632,458,459,1
"25c32b120fce40fa9b6c85133aeb4716","25c32b120fce40fa9b6c85133aeb4716",22855791,1,0,1,1633,459,459,0
"25c32b120fce40fa9b6c85133aeb4716","11bc14f2204949008b7d511b933363c1",22855791,1,1,0,1634,459,460,1
"11bc14f2204949008b7d511b933363c1","11bc14f2204949008b7d511b933363c1",22855791,5,0,1,1635,460,460,0
"11bc14f2204949008b7d511b933363c1","42de338840a34d15adb66e7b14fb9d2c",22855791,1,1,0,1640,460,461,1
"42de338840a34d15adb66e7b14fb9d2c","42de338840a34d15adb66e7b14fb9d2c",22855791,1,0,1,1641,461,461,0
"42de338840a34d15adb66e7b14fb9d2c","9da37c6210b1416b8079c274f70bf600",22855791,1,1,0,1642,461,462,1
"9da37c6210b1416b8079c274f70bf600","9da37c6210b1416b8079c274f70bf600",22855791,1,0,1,1643,462,462,0
"9da37c6210b1416b8079c274f70bf600","519119f1deac45ff9ab4f13529be5c6e",22855791,1,1,0,1644,462,463,1
"519119f1deac45ff9ab4f13529be5c6e","519119f1deac45ff9ab4f13529be5c6e",22855791,1,0,1,1645,463,463,0
"519119f1deac45ff9ab4f13529be5c6e","c5df9f40ec14463b9dcfdc73df3e9285",22855791,1,3,0,1646,463,464,1
"c5df9f40ec14463b9dcfdc73df3e9285","f67fbf45a5f146ed866965bc57c7c001",22855791,1,-12,0,1647,464,454,-10
"f67fbf45a5f146ed866965bc57c7c001","c5df9f40ec14463b9dcfdc73df3e9285",22855791,1,12,0,1648,454,464,10
"c5df9f40ec14463b9dcfdc73df3e9285","83d42d95cd844fc093fc09cee250edb8",22855791,2,3,0,1649,464,465,1
"83d42d95cd844fc093fc09cee250edb8","c5df9f40ec14463b9dcfdc73df3e9285",22855791,1,-3,0,1650,465,464,-1
"83d42d95cd844fc093fc09cee250edb8","83d42d95cd844fc093fc09cee250edb8",22855791,5,0,1,1652,465,465,0
"b613861cecf84ffcab01afb23f660475","b613861cecf84ffcab01afb23f660475",22856366,7,0,1,1,1,1,0
"e2911e79efc2420eac45d9f671463d4b","e2911e79efc2420eac45d9f671463d4b",22856366,3,0,1,10,2,2,0
"e2911e79efc2420eac45d9f671463d4b","519d1b8c59404d67b54e96c5c8a830b2",22856366,1,1,0,11,2,3,1
"519d1b8c59404d67b54e96c5c8a830b2","519d1b8c59404d67b54e96c5c8a830b2",22856366,1,0,1,12,3,3,0
"519d1b8c59404d67b54e96c5c8a830b2","531db53f81f646edb0cdcfe0085b03b7",22856366,1,1,0,13,3,4,1
"531db53f81f646edb0cdcfe0085b03b7","531db53f81f646edb0cdcfe0085b03b7",22856366,1,0,1,14,4,4,0
"531db53f81f646edb0cdcfe0085b03b7","4f5f94b2f95141e0a9d53a61da2276da",22856366,1,1,0,15,4,5,1
"4f5f94b2f95141e0a9d53a61da2276da","4f5f94b2f95141e0a9d53a61da2276da",22856366,1,0,1,16,5,5,0
"4f5f94b2f95141e0a9d53a61da2276da","6d541c89590949f99af293c4f2333f67",22856366,1,1,0,17,5,6,1
"6d541c89590949f99af293c4f2333f67","6d541c89590949f99af293c4f2333f67",22856366,1,0,1,18,6,6,0
"6d541c89590949f99af293c4f2333f67","dd5cf0b9fe4c4f1d8f5ff8e4c04879cb",22856366,1,1,0,19,6,7,1
"dd5cf0b9fe4c4f1d8f5ff8e4c04879cb","dd5cf0b9fe4c4f1d8f5ff8e4c04879cb",22856366,1,0,1,20,7,7,0
"dd5cf0b9fe4c4f1d8f5ff8e4c04879cb","f96261861edc426abe2248be4f0a709a",22856366,1,1,0,21,7,8,1
"f96261861edc426abe2248be4f0a709a","f96261861edc426abe2248be4f0a709a",22856366,1,0,1,22,8,8,0
"f96261861edc426abe2248be4f0a709a","66b5e16f4f75454fb5b8172079f0fa83",22856366,1,1,0,23,8,9,1
"66b5e16f4f75454fb5b8172079f0fa83","66b5e16f4f75454fb5b8172079f0fa83",22856366,1,0,1,24,9,9,0
"66b5e16f4f75454fb5b8172079f0fa83","0680571d4698477995e41842c36a54b2",22856366,1,1,0,25,9,10,1
"0680571d4698477995e41842c36a54b2","0680571d4698477995e41842c36a54b2",22856366,1,0,1,26,10,10,0
"0680571d4698477995e41842c36a54b2","9112f2bffece48e08c6d2287be204085",22856366,1,1,0,27,10,11,1
"9112f2bffece48e08c6d2287be204085","9112f2bffece48e08c6d2287be204085",22856366,1,0,1,28,11,11,0
"9112f2bffece48e08c6d2287be204085","e2911e79efc2420eac45d9f671463d4b",22856366,1,-9,0,29,11,2,-9
"3f1c815879794b929260d224becaff7e","5c5ceeee4562457ba6d41515aeebfbb1",22856366,1,6,0,38,14,17,3
"5c5ceeee4562457ba6d41515aeebfbb1","81c864a886d54a6b8ff85f7d736f4f95",22856366,1,-4,0,39,17,15,-2
"81c864a886d54a6b8ff85f7d736f4f95","56586aa865414f538729c7f7735d2bc6",22856366,1,-6,0,40,15,12,-3
"56586aa865414f538729c7f7735d2bc6","9afd71a5298d4333b6849dfce1b9422c",22856366,2,13,0,41,12,18,6
"9afd71a5298d4333b6849dfce1b9422c","56586aa865414f538729c7f7735d2bc6",22856366,1,-13,0,42,18,12,-6
"b7f2b31585d94eb3bf86376714aa7070","5c5ceeee4562457ba6d41515aeebfbb1",22856366,1,8,0,49,13,17,4
"5c5ceeee4562457ba6d41515aeebfbb1","5c5ceeee4562457ba6d41515aeebfbb1",22856366,1,0,1,50,17,17,0
"b7719e26494940efa49512aedd0aac79","d4f45188d3c84a02ba08454e6403a818",22856366,4,5,0,55,20,24,4
"d4c3b003e8274e429d2fa688d73fde6d","d4c3b003e8274e429d2fa688d73fde6d",22856366,5,0,1,57,22,22,0
"b7719e26494940efa49512aedd0aac79","4e51676dc72045d99c19b9fa7b22f8bc",22856366,1,15,0,65,20,29,9
"4e51676dc72045d99c19b9fa7b22f8bc","afbf7250b99d47bea07172749483ca97",22856366,1,-3,0,66,29,28,-1
"fc0e049d56024bc9a02c9a9c435c3df7","9a0dc646f934470daf08c4b56ccf73db",22856366,1,-3,0,78,38,37,-1
"9a0dc646f934470daf08c4b56ccf73db","b613861cecf84ffcab01afb23f660475",22856366,1,-65,0,79,37,1,-36
"b613861cecf84ffcab01afb23f660475","9afd71a5298d4333b6849dfce1b9422c",22856366,1,28,0,80,1,18,17
"d4c3b003e8274e429d2fa688d73fde6d","afbf7250b99d47bea07172749483ca97",22856366,1,9,0,85,22,28,6
"9a0dc646f934470daf08c4b56ccf73db","fc0e049d56024bc9a02c9a9c435c3df7",22856366,4,3,0,100,37,38,1
"fc0e049d56024bc9a02c9a9c435c3df7","fc0e049d56024bc9a02c9a9c435c3df7",22856366,2,0,1,101,38,38,0
"fc0e049d56024bc9a02c9a9c435c3df7","67a089198fcb4e1c8f2385786c2b296f",22856366,2,4,0,102,38,39,1
"67a089198fcb4e1c8f2385786c2b296f","64d48c6c9c7940639a932219a6c87198",22856366,3,1,0,103,39,40,1
"64d48c6c9c7940639a932219a6c87198","a49d1bb4328949299686242fd0be5584",22856366,1,-39,0,104,40,21,-19
"a49d1bb4328949299686242fd0be5584","b7719e26494940efa49512aedd0aac79",22856366,6,-2,0,105,21,20,-1
"b7719e26494940efa49512aedd0aac79","b7719e26494940efa49512aedd0aac79",22856366,7,0,1,106,20,20,0
"b7719e26494940efa49512aedd0aac79","afbf7250b99d47bea07172749483ca97",22856366,6,12,0,107,20,28,8
"afbf7250b99d47bea07172749483ca97","afbf7250b99d47bea07172749483ca97",22856366,7,0,1,108,28,28,0
"afbf7250b99d47bea07172749483ca97","b7719e26494940efa49512aedd0aac79",22856366,5,-12,0,109,28,20,-8
"d4f45188d3c84a02ba08454e6403a818","a49d1bb4328949299686242fd0be5584",22856366,4,-3,0,113,24,21,-3
"b7719e26494940efa49512aedd0aac79","d4c3b003e8274e429d2fa688d73fde6d",22856366,2,3,0,115,20,22,2
"a49d1bb4328949299686242fd0be5584","d4f45188d3c84a02ba08454e6403a818",22856366,3,3,0,124,21,24,3
"d4f45188d3c84a02ba08454e6403a818","d4c3b003e8274e429d2fa688d73fde6d",22856366,7,-2,0,125,24,22,-2
"d4c3b003e8274e429d2fa688d73fde6d","9afd71a5298d4333b6849dfce1b9422c",22856366,1,-7,0,126,22,18,-4
"9afd71a5298d4333b6849dfce1b9422c","b7719e26494940efa49512aedd0aac79",22856366,4,4,0,127,18,20,2
"b7719e26494940efa49512aedd0aac79","9afd71a5298d4333b6849dfce1b9422c",22856366,2,-4,0,129,20,18,-2
"9afd71a5298d4333b6849dfce1b9422c","d4c3b003e8274e429d2fa688d73fde6d",22856366,1,7,0,130,18,22,4
"d4f45188d3c84a02ba08454e6403a818","67a089198fcb4e1c8f2385786c2b296f",22856366,1,35,0,132,24,39,15
"64d48c6c9c7940639a932219a6c87198","64d48c6c9c7940639a932219a6c87198",22856366,4,0,1,134,40,40,0
"64d48c6c9c7940639a932219a6c87198","b534b89233134e30a9b5645138bfa9ee",22856366,2,3,0,138,40,41,1
"b534b89233134e30a9b5645138bfa9ee","67a089198fcb4e1c8f2385786c2b296f",22856366,3,-4,0,139,41,39,-2
"67a089198fcb4e1c8f2385786c2b296f","0e37b720d23b4e7f8b313e79313fd107",22856366,1,7,0,140,39,44,5
"0e37b720d23b4e7f8b313e79313fd107","0e37b720d23b4e7f8b313e79313fd107",22856366,2,0,1,141,44,44,0
"0e37b720d23b4e7f8b313e79313fd107","6875d67fdd5f48168b62719df449bebd",22856366,1,1,0,143,44,45,1
"6875d67fdd5f48168b62719df449bebd","6875d67fdd5f48168b62719df449bebd",22856366,2,0,1,144,45,45,0
"6875d67fdd5f48168b62719df449bebd","b534b89233134e30a9b5645138bfa9ee",22856366,1,-4,0,146,45,41,-4
"b534b89233134e30a9b5645138bfa9ee","6e13d61a7bdb44bca949c9f86fab3be5",22856366,1,7,0,147,41,47,6
"6e13d61a7bdb44bca949c9f86fab3be5","6e13d61a7bdb44bca949c9f86fab3be5",22856366,1,0,1,148,47,47,0
"6e13d61a7bdb44bca949c9f86fab3be5","195f78799f984cc2b06c48dfe36be751",22856366,1,2,0,149,47,49,2
"195f78799f984cc2b06c48dfe36be751","195f78799f984cc2b06c48dfe36be751",22856366,7,0,1,150,49,49,0
"195f78799f984cc2b06c48dfe36be751","d9c8d8c444a64dadbbb508652c721e17",22856366,1,-3,0,155,49,46,-3
"d9c8d8c444a64dadbbb508652c721e17","d0c74f735e024943943e40333d6d337f",22856366,1,6,0,156,46,51,5
"d0c74f735e024943943e40333d6d337f","d0c74f735e024943943e40333d6d337f",22856366,1,0,1,157,51,51,0
"d0c74f735e024943943e40333d6d337f","983f8ff320594b279a7f4a6fe132f9c5",22856366,1,2,0,158,51,53,2
"983f8ff320594b279a7f4a6fe132f9c5","983f8ff320594b279a7f4a6fe132f9c5",22856366,2,0,1,159,53,53,0
"983f8ff320594b279a7f4a6fe132f9c5","35adfa5d923046aebabfefd98f35ff05",22856366,1,1,0,161,53,54,1
"35adfa5d923046aebabfefd98f35ff05","35adfa5d923046aebabfefd98f35ff05",22856366,5,0,1,162,54,54,0
"35adfa5d923046aebabfefd98f35ff05","b6f8a98476224da1b40e555ececc7ed8",22856366,1,1,0,167,54,55,1
"b6f8a98476224da1b40e555ececc7ed8","b6f8a98476224da1b40e555ececc7ed8",22856366,2,0,1,168,55,55,0
"b6f8a98476224da1b40e555ececc7ed8","86e22cb5fe0e4b47a9489ecddf7ed78f",22856366,1,1,0,170,55,56,1
"86e22cb5fe0e4b47a9489ecddf7ed78f","86e22cb5fe0e4b47a9489ecddf7ed78f",22856366,3,0,1,171,56,56,0
"86e22cb5fe0e4b47a9489ecddf7ed78f","f924752d8a1149668870b1e7698486f7",22856366,1,-6,0,174,56,50,-6
"f924752d8a1149668870b1e7698486f7","a1f2f12debe5432fb7a70bcd12bacfb9",22856366,1,9,0,175,50,58,8
"a1f2f12debe5432fb7a70bcd12bacfb9","78f30e4dcac84e3cbea8b2cc6e0d62b3",22856366,2,1,0,176,58,59,1
"78f30e4dcac84e3cbea8b2cc6e0d62b3","a1f2f12debe5432fb7a70bcd12bacfb9",22856366,1,-1,0,177,59,58,-1
"a1f2f12debe5432fb7a70bcd12bacfb9","a1f2f12debe5432fb7a70bcd12bacfb9",22856366,25,0,1,178,58,58,0
"78f30e4dcac84e3cbea8b2cc6e0d62b3","78f30e4dcac84e3cbea8b2cc6e0d62b3",22856366,10,0,1,204,59,59,0
"78f30e4dcac84e3cbea8b2cc6e0d62b3","a0a418b8540d479fa6e0f653b701da8b",22856366,1,6,0,214,59,64,5
"a0a418b8540d479fa6e0f653b701da8b","bc42d26810654ea9a1df1efe1e58c7d5",22856366,1,-1,0,215,64,63,-1
"bc42d26810654ea9a1df1efe1e58c7d5","12aa6e1672ac4e7aa6449a7a8609cd72",22856366,1,-7,0,216,63,57,-6
"12aa6e1672ac4e7aa6449a7a8609cd72","4c943503763e4e349906eea3ed3c8e86",22856366,1,5,0,217,57,61,4
"4c943503763e4e349906eea3ed3c8e86","4c943503763e4e349906eea3ed3c8e86",22856366,1,0,1,218,61,61,0
"4c943503763e4e349906eea3ed3c8e86","bc42d26810654ea9a1df1efe1e58c7d5",22856366,1,2,0,219,61,63,2
"bc42d26810654ea9a1df1efe1e58c7d5","bc42d26810654ea9a1df1efe1e58c7d5",22856366,3,0,1,220,63,63,0
"bc42d26810654ea9a1df1efe1e58c7d5","a0a418b8540d479fa6e0f653b701da8b",22856366,1,1,0,223,63,64,1
"a0a418b8540d479fa6e0f653b701da8b","a0a418b8540d479fa6e0f653b701da8b",22856366,3,0,1,224,64,64,0
"a0a418b8540d479fa6e0f653b701da8b","309ccf3cc4fe429d9bfbaef53d3fa479",22856366,1,-4,0,227,64,60,-4
"309ccf3cc4fe429d9bfbaef53d3fa479","d646286c8051419bbc2e31dd1db55ca8",22856366,1,10,0,228,60,67,7
"d646286c8051419bbc2e31dd1db55ca8","b534b89233134e30a9b5645138bfa9ee",22856366,1,-33,0,229,67,41,-26
"67a089198fcb4e1c8f2385786c2b296f","d646286c8051419bbc2e31dd1db55ca8",22856366,1,37,0,231,39,67,28
"d646286c8051419bbc2e31dd1db55ca8","d646286c8051419bbc2e31dd1db55ca8",22856366,1,0,1,232,67,67,0
"d646286c8051419bbc2e31dd1db55ca8","267f883678b24aed855fde42524975d9",22856366,1,4,0,233,67,71,4
"267f883678b24aed855fde42524975d9","267f883678b24aed855fde42524975d9",22856366,2,0,1,234,71,71,0
"267f883678b24aed855fde42524975d9","88fff56d0342490dbef9040750a20f6c",22856366,1,1,0,236,71,72,1
"88fff56d0342490dbef9040750a20f6c","88fff56d0342490dbef9040750a20f6c",22856366,1,0,1,237,72,72,0
"88fff56d0342490dbef9040750a20f6c","adb17b12b66c4a49a85fd34322f7df70",22856366,1,1,0,238,72,73,1
"adb17b12b66c4a49a85fd34322f7df70","adb17b12b66c4a49a85fd34322f7df70",22856366,1,0,1,239,73,73,0
"adb17b12b66c4a49a85fd34322f7df70","a2becd407db34b189200a32546d9d569",22856366,1,3,0,240,73,75,2
"a2becd407db34b189200a32546d9d569","d646286c8051419bbc2e31dd1db55ca8",22856366,1,-9,0,241,75,67,-8
"d646286c8051419bbc2e31dd1db55ca8","a2becd407db34b189200a32546d9d569",22856366,1,9,0,242,67,75,8
"a2becd407db34b189200a32546d9d569","58c22b011d0f4c2ea6d13615edbb9eeb",22856366,1,2,0,243,75,77,2
"58c22b011d0f4c2ea6d13615edbb9eeb","58c22b011d0f4c2ea6d13615edbb9eeb",22856366,8,0,1,244,77,77,0
"58c22b011d0f4c2ea6d13615edbb9eeb","dd76e1861dc9461c830888729d091ee0",22856366,1,1,0,252,77,78,1
"dd76e1861dc9461c830888729d091ee0","dd76e1861dc9461c830888729d091ee0",22856366,5,0,1,253,78,78,0
"dd76e1861dc9461c830888729d091ee0","cd1d828f1a694b87913a7ea66c23803e",22856366,1,1,0,258,78,79,1
"cd1d828f1a694b87913a7ea66c23803e","cd1d828f1a694b87913a7ea66c23803e",22856366,2,0,1,259,79,79,0
"cd1d828f1a694b87913a7ea66c23803e","9176a3c2b4d2465fa8b0c67096c2a97e",22856366,1,1,0,261,79,80,1
"9176a3c2b4d2465fa8b0c67096c2a97e","9176a3c2b4d2465fa8b0c67096c2a97e",22856366,11,0,1,262,80,80,0
"9176a3c2b4d2465fa8b0c67096c2a97e","f8ec6445f7194e25b9101d4fbcb07a18",22856366,1,1,0,273,80,81,1
"f8ec6445f7194e25b9101d4fbcb07a18","f8ec6445f7194e25b9101d4fbcb07a18",22856366,2,0,1,274,81,81,0
"f8ec6445f7194e25b9101d4fbcb07a18","140d5b27b8574befad82c0a013b59dfa",22856366,1,-7,0,276,81,74,-7
"140d5b27b8574befad82c0a013b59dfa","67a089198fcb4e1c8f2385786c2b296f",22856366,1,-45,0,277,74,39,-35
"67a089198fcb4e1c8f2385786c2b296f","ae5ac430ea254e708a6f5deaaf7464ae",22856366,1,57,0,278,39,84,45
"ae5ac430ea254e708a6f5deaaf7464ae","d646286c8051419bbc2e31dd1db55ca8",22856366,1,-20,0,279,84,67,-17
"d646286c8051419bbc2e31dd1db55ca8","f564483cbd7a407681aa2fcca518cf5f",22856366,1,21,0,280,67,85,18
"f564483cbd7a407681aa2fcca518cf5f","f564483cbd7a407681aa2fcca518cf5f",22856366,1,0,1,281,85,85,0
"f564483cbd7a407681aa2fcca518cf5f","18fd01350bd5434ca636d59a599d768a",22856366,1,1,0,282,85,86,1
"18fd01350bd5434ca636d59a599d768a","18fd01350bd5434ca636d59a599d768a",22856366,9,0,1,283,86,86,0
"18fd01350bd5434ca636d59a599d768a","6a9f0ef185fb47f0937e29daa1c71ed5",22856366,1,5,0,292,86,90,4
"6a9f0ef185fb47f0937e29daa1c71ed5","ae5ac430ea254e708a6f5deaaf7464ae",22856366,1,-7,0,293,90,84,-6
"ae5ac430ea254e708a6f5deaaf7464ae","b7719e26494940efa49512aedd0aac79",22856366,1,-97,0,294,84,20,-64
"a49d1bb4328949299686242fd0be5584","42fb58708eaf4e5daa82bfca61b6f5fd",22856366,1,99,0,301,21,87,66
"42fb58708eaf4e5daa82bfca61b6f5fd","d646286c8051419bbc2e31dd1db55ca8",22856366,1,-24,0,302,87,67,-20
"d646286c8051419bbc2e31dd1db55ca8","6a9f0ef185fb47f0937e29daa1c71ed5",22856366,1,27,0,303,67,90,23
"6a9f0ef185fb47f0937e29daa1c71ed5","c681290961c94c4caf23b529d1ae6b9a",22856366,1,-2,0,304,90,88,-2
"c681290961c94c4caf23b529d1ae6b9a","c681290961c94c4caf23b529d1ae6b9a",22856366,2,0,1,305,88,88,0
"c681290961c94c4caf23b529d1ae6b9a","6a9f0ef185fb47f0937e29daa1c71ed5",22856366,1,2,0,307,88,90,2
"6a9f0ef185fb47f0937e29daa1c71ed5","6a9f0ef185fb47f0937e29daa1c71ed5",22856366,3,0,1,308,90,90,0
"6a9f0ef185fb47f0937e29daa1c71ed5","e20db35ced8544ddac5bc3839145e463",22856366,1,3,0,311,90,91,1
"e20db35ced8544ddac5bc3839145e463","d646286c8051419bbc2e31dd1db55ca8",22856366,1,-30,0,312,91,67,-24
"d646286c8051419bbc2e31dd1db55ca8","1febb706d7a34005ae8711ed49c76e64",22856366,1,33,0,313,67,94,27
"1febb706d7a34005ae8711ed49c76e64","1febb706d7a34005ae8711ed49c76e64",22856366,2,0,1,314,94,94,0
"1febb706d7a34005ae8711ed49c76e64","8f73ba6f5a0042f2850356ac38ac6f24",22856366,1,1,0,316,94,95,1
"8f73ba6f5a0042f2850356ac38ac6f24","8f73ba6f5a0042f2850356ac38ac6f24",22856366,5,0,1,317,95,95,0
"8f73ba6f5a0042f2850356ac38ac6f24","e2260b86653c46d7b14a41fb419dbf8c",22856366,1,1,0,322,95,96,1
"e2260b86653c46d7b14a41fb419dbf8c","e2260b86653c46d7b14a41fb419dbf8c",22856366,2,0,1,323,96,96,0
"e2260b86653c46d7b14a41fb419dbf8c","35eb641ad1d845bbba54915bce75a962",22856366,1,1,0,325,96,97,1
"35eb641ad1d845bbba54915bce75a962","35eb641ad1d845bbba54915bce75a962",22856366,2,0,1,326,97,97,0
"35eb641ad1d845bbba54915bce75a962","08be90ffbeea4795a138cd42ed8db56f",22856366,1,1,0,328,97,98,1
"08be90ffbeea4795a138cd42ed8db56f","08be90ffbeea4795a138cd42ed8db56f",22856366,6,0,1,329,98,98,0
"08be90ffbeea4795a138cd42ed8db56f","3007433c8f584dcbb5ac159c1c5f2be3",22856366,1,1,0,335,98,99,1
"3007433c8f584dcbb5ac159c1c5f2be3","3007433c8f584dcbb5ac159c1c5f2be3",22856366,2,0,1,336,99,99,0
"3007433c8f584dcbb5ac159c1c5f2be3","e20db35ced8544ddac5bc3839145e463",22856366,1,-8,0,338,99,91,-8
"e20db35ced8544ddac5bc3839145e463","00ae5f0c51874a73a41ebea838d95682",22856366,1,11,0,339,91,101,10
"00ae5f0c51874a73a41ebea838d95682","d391c8b6e56a43a7b654e9dee02d904b",22856366,3,2,0,340,101,103,2
"d391c8b6e56a43a7b654e9dee02d904b","00ae5f0c51874a73a41ebea838d95682",22856366,1,-2,0,341,103,101,-2
"d391c8b6e56a43a7b654e9dee02d904b","d391c8b6e56a43a7b654e9dee02d904b",22856366,23,0,1,343,103,103,0
"d391c8b6e56a43a7b654e9dee02d904b","6111116566fc4fd9abba409322bea245",22856366,1,1,0,366,103,104,1
"6111116566fc4fd9abba409322bea245","6111116566fc4fd9abba409322bea245",22856366,2,0,1,367,104,104,0
"6111116566fc4fd9abba409322bea245","a81b2235cb9c499eb9ea8ee0a8dd9725",22856366,1,1,0,369,104,105,1
"a81b2235cb9c499eb9ea8ee0a8dd9725","a81b2235cb9c499eb9ea8ee0a8dd9725",22856366,5,0,1,370,105,105,0
"a81b2235cb9c499eb9ea8ee0a8dd9725","2d4e0ab0ef3b4d73b82c72d4621a7579",22856366,1,1,0,375,105,106,1
"2d4e0ab0ef3b4d73b82c72d4621a7579","2d4e0ab0ef3b4d73b82c72d4621a7579",22856366,2,0,1,376,106,106,0
"2d4e0ab0ef3b4d73b82c72d4621a7579","8bdebf492ebd4e62b0d522e8ab5e5197",22856366,1,1,0,378,106,107,1
"8bdebf492ebd4e62b0d522e8ab5e5197","8bdebf492ebd4e62b0d522e8ab5e5197",22856366,2,0,1,379,107,107,0
"8bdebf492ebd4e62b0d522e8ab5e5197","73039f8c1eb9409cb4caee2cf968001e",22856366,1,-7,0,381,107,100,-7
"73039f8c1eb9409cb4caee2cf968001e","4280927ec4d643238aa49c32f9e06c6c",22856366,2,10,0,382,100,109,9
"4280927ec4d643238aa49c32f9e06c6c","4280927ec4d643238aa49c32f9e06c6c",22856366,1,0,1,383,109,109,0
"4280927ec4d643238aa49c32f9e06c6c","fc44e6a5f7654430af1227838224dceb",22856366,1,2,0,384,109,111,2
"fc44e6a5f7654430af1227838224dceb","fc44e6a5f7654430af1227838224dceb",22856366,5,0,1,385,111,111,0
"fc44e6a5f7654430af1227838224dceb","08111f75e22d409998cf8b85bd431f0a",22856366,1,-3,0,390,111,108,-3
"08111f75e22d409998cf8b85bd431f0a","a9ae0a3c070d455bb4369a8996313336",22856366,1,7,0,391,108,114,6
"a9ae0a3c070d455bb4369a8996313336","a9ae0a3c070d455bb4369a8996313336",22856366,1,0,1,392,114,114,0
"a9ae0a3c070d455bb4369a8996313336","37319e88176d4aefa91d7a9980dbae91",22856366,1,-2,0,393,114,112,-2
"37319e88176d4aefa91d7a9980dbae91","62bff51286ef4f348717a3cf6fe2318f",22856366,2,9,0,394,112,120,8
"62bff51286ef4f348717a3cf6fe2318f","3ec3a3563847406fa73338f9e9999cf3",22856366,1,-3,0,395,120,117,-3
"3ec3a3563847406fa73338f9e9999cf3","a9ae0a3c070d455bb4369a8996313336",22856366,1,-4,0,396,117,114,-3
"a9ae0a3c070d455bb4369a8996313336","71cec822bcff4f30a20e75dc63ef7b65",22856366,1,2,0,397,114,116,2
"71cec822bcff4f30a20e75dc63ef7b65","71cec822bcff4f30a20e75dc63ef7b65",22856366,1,0,1,398,116,116,0
"71cec822bcff4f30a20e75dc63ef7b65","37319e88176d4aefa91d7a9980dbae91",22856366,1,-4,0,399,116,112,-4
"62bff51286ef4f348717a3cf6fe2318f","a9ae0a3c070d455bb4369a8996313336",22856366,1,-7,0,401,120,114,-6
"a9ae0a3c070d455bb4369a8996313336","3ec3a3563847406fa73338f9e9999cf3",22856366,1,4,0,402,114,117,3
"3ec3a3563847406fa73338f9e9999cf3","62bff51286ef4f348717a3cf6fe2318f",22856366,1,3,0,403,117,120,3
"62bff51286ef4f348717a3cf6fe2318f","37319e88176d4aefa91d7a9980dbae91",22856366,1,-9,0,404,120,112,-8
"37319e88176d4aefa91d7a9980dbae91","b1cd0e7dc3ad4a8eb91a4bfdbeb025b0",22856366,1,7,0,405,112,118,6
"b1cd0e7dc3ad4a8eb91a4bfdbeb025b0","b1cd0e7dc3ad4a8eb91a4bfdbeb025b0",22856366,1,0,1,406,118,118,0
"b1cd0e7dc3ad4a8eb91a4bfdbeb025b0","62bff51286ef4f348717a3cf6fe2318f",22856366,1,2,0,407,118,120,2
"62bff51286ef4f348717a3cf6fe2318f","62bff51286ef4f348717a3cf6fe2318f",22856366,5,0,1,408,120,120,0
"62bff51286ef4f348717a3cf6fe2318f","e20db35ced8544ddac5bc3839145e463",22856366,1,-33,0,411,120,91,-29
"e20db35ced8544ddac5bc3839145e463","779f9ddd1fd14d1e9e69f72219a1fdbd",22856366,3,36,0,412,91,121,30
"779f9ddd1fd14d1e9e69f72219a1fdbd","67a089198fcb4e1c8f2385786c2b296f",22856366,1,-103,0,413,121,39,-82
"67a089198fcb4e1c8f2385786c2b296f","b534b89233134e30a9b5645138bfa9ee",22856366,1,4,0,414,39,41,2
"b534b89233134e30a9b5645138bfa9ee","d9c8d8c444a64dadbbb508652c721e17",22856366,1,6,0,415,41,46,5
"d9c8d8c444a64dadbbb508652c721e17","6e13d61a7bdb44bca949c9f86fab3be5",22856366,2,1,0,416,46,47,1
"6e13d61a7bdb44bca949c9f86fab3be5","d0c74f735e024943943e40333d6d337f",22856366,1,5,0,417,47,51,4
"d0c74f735e024943943e40333d6d337f","d9c8d8c444a64dadbbb508652c721e17",22856366,2,-6,0,418,51,46,-5
"6e13d61a7bdb44bca949c9f86fab3be5","f924752d8a1149668870b1e7698486f7",22856366,1,4,0,420,47,50,3
"f924752d8a1149668870b1e7698486f7","195f78799f984cc2b06c48dfe36be751",22856366,1,-2,0,421,50,49,-1
"195f78799f984cc2b06c48dfe36be751","d0c74f735e024943943e40333d6d337f",22856366,1,3,0,424,49,51,2
"d9c8d8c444a64dadbbb508652c721e17","67a089198fcb4e1c8f2385786c2b296f",22856366,1,-10,0,426,46,39,-7
"67a089198fcb4e1c8f2385786c2b296f","779f9ddd1fd14d1e9e69f72219a1fdbd",22856366,1,103,0,427,39,121,82
"779f9ddd1fd14d1e9e69f72219a1fdbd","779f9ddd1fd14d1e9e69f72219a1fdbd",22856366,3,0,1,428,121,121,0
"779f9ddd1fd14d1e9e69f72219a1fdbd","ae26e6cda8ad4a3f81bd347560d9579f",22856366,1,4,0,431,121,125,4
"ae26e6cda8ad4a3f81bd347560d9579f","ae26e6cda8ad4a3f81bd347560d9579f",22856366,1,0,1,432,125,125,0
"ae26e6cda8ad4a3f81bd347560d9579f","ee48df95832b4374aa273ceb27ec1315",22856366,1,1,0,433,125,126,1
"ee48df95832b4374aa273ceb27ec1315","ee48df95832b4374aa273ceb27ec1315",22856366,1,0,1,434,126,126,0
"ee48df95832b4374aa273ceb27ec1315","7a439da90b394756ad1777fc4c6dead5",22856366,1,1,0,435,126,127,1
"7a439da90b394756ad1777fc4c6dead5","7a439da90b394756ad1777fc4c6dead5",22856366,1,0,1,436,127,127,0
"7a439da90b394756ad1777fc4c6dead5","a8dd5213034441ac92724b4e83eb0bb2",22856366,1,3,0,437,127,129,2
"a8dd5213034441ac92724b4e83eb0bb2","779f9ddd1fd14d1e9e69f72219a1fdbd",22856366,1,-9,0,438,129,121,-8
"779f9ddd1fd14d1e9e69f72219a1fdbd","a8dd5213034441ac92724b4e83eb0bb2",22856366,2,9,0,439,121,129,8
"a8dd5213034441ac92724b4e83eb0bb2","a8dd5213034441ac92724b4e83eb0bb2",22856366,2,0,1,440,129,129,0
"a8dd5213034441ac92724b4e83eb0bb2","8115eab6556b45f5b415c3b8c26a12e5",22856366,1,2,0,442,129,131,2
"8115eab6556b45f5b415c3b8c26a12e5","8115eab6556b45f5b415c3b8c26a12e5",22856366,2,0,1,443,131,131,0
"8115eab6556b45f5b415c3b8c26a12e5","ec34b06efd844b46a4c4818ecdb9b8f4",22856366,1,1,0,445,131,132,1
"ec34b06efd844b46a4c4818ecdb9b8f4","ec34b06efd844b46a4c4818ecdb9b8f4",22856366,2,0,1,446,132,132,0
"ec34b06efd844b46a4c4818ecdb9b8f4","c2e1c2b9eac64109b343a088584b576b",22856366,1,1,0,448,132,133,1
"c2e1c2b9eac64109b343a088584b576b","c2e1c2b9eac64109b343a088584b576b",22856366,2,0,1,449,133,133,0
"c2e1c2b9eac64109b343a088584b576b","579338175e0b4bbb8ef3b712b5d8b54e",22856366,1,-5,0,451,133,128,-5
"579338175e0b4bbb8ef3b712b5d8b54e","8bc5795d6a984a3eace4e2811e52dd4f",22856366,1,8,0,452,128,135,7
"8bc5795d6a984a3eace4e2811e52dd4f","8bc5795d6a984a3eace4e2811e52dd4f",22856366,1,0,1,453,135,135,0
"8bc5795d6a984a3eace4e2811e52dd4f","b416d47c56a742199b5d7c7f19d6503a",22856366,1,-1,0,454,135,134,-1
"b416d47c56a742199b5d7c7f19d6503a","f661500307d74c908e9207d949ceb4aa",22856366,1,3,0,455,134,136,2
"f661500307d74c908e9207d949ceb4aa","a8dd5213034441ac92724b4e83eb0bb2",22856366,1,-9,0,456,136,129,-7
"a8dd5213034441ac92724b4e83eb0bb2","b416d47c56a742199b5d7c7f19d6503a",22856366,1,6,0,457,129,134,5
"b416d47c56a742199b5d7c7f19d6503a","579338175e0b4bbb8ef3b712b5d8b54e",22856366,1,-7,0,458,134,128,-6
"579338175e0b4bbb8ef3b712b5d8b54e","e20db35ced8544ddac5bc3839145e463",22856366,1,-44,0,459,128,91,-37
"779f9ddd1fd14d1e9e69f72219a1fdbd","62bff51286ef4f348717a3cf6fe2318f",22856366,1,-3,0,461,121,120,-1
"62bff51286ef4f348717a3cf6fe2318f","779f9ddd1fd14d1e9e69f72219a1fdbd",22856366,1,3,0,464,120,121,1
"779f9ddd1fd14d1e9e69f72219a1fdbd","e20db35ced8544ddac5bc3839145e463",22856366,1,-36,0,465,121,91,-30
"a8dd5213034441ac92724b4e83eb0bb2","579338175e0b4bbb8ef3b712b5d8b54e",22856366,1,-1,0,468,129,128,-1
"579338175e0b4bbb8ef3b712b5d8b54e","b416d47c56a742199b5d7c7f19d6503a",22856366,1,7,0,469,128,134,6
"b416d47c56a742199b5d7c7f19d6503a","cd4532ad48034873ba8bce2aac0c9808",22856366,1,4,0,470,134,137,3
"cd4532ad48034873ba8bce2aac0c9808","cd4532ad48034873ba8bce2aac0c9808",22856366,1,0,1,471,137,137,0
"cd4532ad48034873ba8bce2aac0c9808","779f9ddd1fd14d1e9e69f72219a1fdbd",22856366,1,-19,0,472,137,121,-16
"779f9ddd1fd14d1e9e69f72219a1fdbd","df1de691dafe4549a18a4398ee9dfaf9",22856366,1,23,0,473,121,139,18
"df1de691dafe4549a18a4398ee9dfaf9","6c5ad271a44743479bfaea29b1db8d02",22856366,2,4,0,474,139,143,4
"6c5ad271a44743479bfaea29b1db8d02","67a089198fcb4e1c8f2385786c2b296f",22856366,1,-130,0,475,143,39,-104
"67a089198fcb4e1c8f2385786c2b296f","df1de691dafe4549a18a4398ee9dfaf9",22856366,1,126,0,476,39,139,100
"df1de691dafe4549a18a4398ee9dfaf9","df1de691dafe4549a18a4398ee9dfaf9",22856366,1,0,1,477,139,139,0
"6c5ad271a44743479bfaea29b1db8d02","6c5ad271a44743479bfaea29b1db8d02",22856366,1,0,1,479,143,143,0
"6c5ad271a44743479bfaea29b1db8d02","83d311bed5374fee83d8d67a7d9d82dc",22856366,1,1,0,480,143,144,1
"83d311bed5374fee83d8d67a7d9d82dc","83d311bed5374fee83d8d67a7d9d82dc",22856366,1,0,1,481,144,144,0
"83d311bed5374fee83d8d67a7d9d82dc","402bba41861d43acb52a5abb89e8831e",22856366,1,1,0,482,144,145,1
"402bba41861d43acb52a5abb89e8831e","402bba41861d43acb52a5abb89e8831e",22856366,2,0,1,483,145,145,0
"402bba41861d43acb52a5abb89e8831e","df1de691dafe4549a18a4398ee9dfaf9",22856366,1,-6,0,485,145,139,-6
"df1de691dafe4549a18a4398ee9dfaf9","8aae34f5ddbb4052a709b12e6b0d40fa",22856366,1,9,0,486,139,147,8
"8aae34f5ddbb4052a709b12e6b0d40fa","8aae34f5ddbb4052a709b12e6b0d40fa",22856366,1,0,1,487,147,147,0
"8aae34f5ddbb4052a709b12e6b0d40fa","645b3f0249f64f76af2e19eb4d0e55b7",22856366,1,2,0,488,147,149,2
"645b3f0249f64f76af2e19eb4d0e55b7","645b3f0249f64f76af2e19eb4d0e55b7",22856366,2,0,1,489,149,149,0
"645b3f0249f64f76af2e19eb4d0e55b7","7e7b8db5064d4369805ab370aac5ddfb",22856366,1,1,0,491,149,150,1
"7e7b8db5064d4369805ab370aac5ddfb","7e7b8db5064d4369805ab370aac5ddfb",22856366,2,0,1,492,150,150,0
"7e7b8db5064d4369805ab370aac5ddfb","8956d210ae7f41968fada86d4c979d6a",22856366,1,1,0,494,150,151,1
"8956d210ae7f41968fada86d4c979d6a","8956d210ae7f41968fada86d4c979d6a",22856366,5,0,1,495,151,151,0
"8956d210ae7f41968fada86d4c979d6a","f902b0f41b544d4dbf79664fd233648d",22856366,1,-5,0,500,151,146,-5
"f902b0f41b544d4dbf79664fd233648d","ae781e8b775e4ccd93bc800dad5c8376",22856366,1,8,0,501,146,153,7
"ae781e8b775e4ccd93bc800dad5c8376","ae781e8b775e4ccd93bc800dad5c8376",22856366,2,0,1,502,153,153,0
"ae781e8b775e4ccd93bc800dad5c8376","06882a8492d9499aa31555567f575ecb",22856366,1,1,0,504,153,154,1
"06882a8492d9499aa31555567f575ecb","06882a8492d9499aa31555567f575ecb",22856366,1,0,1,505,154,154,0
"06882a8492d9499aa31555567f575ecb","f293c508f409466a8f27ddd7d1e40b20",22856366,1,1,0,506,154,155,1
"f293c508f409466a8f27ddd7d1e40b20","f293c508f409466a8f27ddd7d1e40b20",22856366,2,0,1,507,155,155,0
"f293c508f409466a8f27ddd7d1e40b20","cc4ddef5bbbe48ebb605141b347c4ed1",22856366,1,1,0,509,155,156,1
"cc4ddef5bbbe48ebb605141b347c4ed1","cc4ddef5bbbe48ebb605141b347c4ed1",22856366,3,0,1,510,156,156,0
"cc4ddef5bbbe48ebb605141b347c4ed1","f03480cf4eba413194d7af52fc0e7f28",22856366,1,-4,0,513,156,152,-4
"f03480cf4eba413194d7af52fc0e7f28","d313cec988a84645bee413e8d4724a4b",22856366,1,7,0,514,152,158,6
"d313cec988a84645bee413e8d4724a4b","d313cec988a84645bee413e8d4724a4b",22856366,4,0,1,515,158,158,0
"d313cec988a84645bee413e8d4724a4b","dc60696c76a74368a60f72246e47700d",22856366,1,1,0,519,158,159,1
"dc60696c76a74368a60f72246e47700d","dc60696c76a74368a60f72246e47700d",22856366,1,0,1,520,159,159,0
"dc60696c76a74368a60f72246e47700d","78adeee1fa2c4fe0bc73f7bca9fcee86",22856366,1,3,0,521,159,160,1
"78adeee1fa2c4fe0bc73f7bca9fcee86","df1de691dafe4549a18a4398ee9dfaf9",22856366,1,-26,0,522,160,139,-21
"df1de691dafe4549a18a4398ee9dfaf9","78adeee1fa2c4fe0bc73f7bca9fcee86",22856366,1,26,0,523,139,160,21
"78adeee1fa2c4fe0bc73f7bca9fcee86","78adeee1fa2c4fe0bc73f7bca9fcee86",22856366,2,0,1,524,160,160,0
"78adeee1fa2c4fe0bc73f7bca9fcee86","65202579580f4ad38d734b4ee39d22a8",22856366,2,5,0,526,160,164,4
"65202579580f4ad38d734b4ee39d22a8","65202579580f4ad38d734b4ee39d22a8",22856366,65,0,1,527,164,164,0
"65202579580f4ad38d734b4ee39d22a8","3cbcea2be0984e7dbd5a48195af10ce7",22856366,2,3,0,545,164,165,1
"3cbcea2be0984e7dbd5a48195af10ce7","78adeee1fa2c4fe0bc73f7bca9fcee86",22856366,2,-8,0,546,165,160,-5
"78adeee1fa2c4fe0bc73f7bca9fcee86","82e6285962b8400d9d6fc32436022a94",22856366,2,10,0,547,160,167,7
"82e6285962b8400d9d6fc32436022a94","3cbcea2be0984e7dbd5a48195af10ce7",22856366,1,-2,0,548,167,165,-2
"3cbcea2be0984e7dbd5a48195af10ce7","a9ac840f098c4bd0a2ee896214ce29cd",22856366,1,5,0,549,165,168,3
"a9ac840f098c4bd0a2ee896214ce29cd","a9ac840f098c4bd0a2ee896214ce29cd",22856366,1,0,1,550,168,168,0
"a9ac840f098c4bd0a2ee896214ce29cd","3cbcea2be0984e7dbd5a48195af10ce7",22856366,1,-5,0,551,168,165,-3
"3cbcea2be0984e7dbd5a48195af10ce7","3cbcea2be0984e7dbd5a48195af10ce7",22856366,1,0,1,552,165,165,0
"3cbcea2be0984e7dbd5a48195af10ce7","82e6285962b8400d9d6fc32436022a94",22856366,1,2,0,553,165,167,2
"82e6285962b8400d9d6fc32436022a94","78adeee1fa2c4fe0bc73f7bca9fcee86",22856366,1,-10,0,554,167,160,-7
"78adeee1fa2c4fe0bc73f7bca9fcee86","8959e6304a0348309a771e4d08d1b64a",22856366,1,4,0,555,160,163,3
"8959e6304a0348309a771e4d08d1b64a","65202579580f4ad38d734b4ee39d22a8",22856366,2,1,0,556,163,164,1
"65202579580f4ad38d734b4ee39d22a8","8959e6304a0348309a771e4d08d1b64a",22856366,1,-1,0,587,164,163,-1
"65202579580f4ad38d734b4ee39d22a8","78adeee1fa2c4fe0bc73f7bca9fcee86",22856366,1,-5,0,593,164,160,-4
"82e6285962b8400d9d6fc32436022a94","67a089198fcb4e1c8f2385786c2b296f",22856366,1,-162,0,611,167,39,-128
"67a089198fcb4e1c8f2385786c2b296f","a49d1bb4328949299686242fd0be5584",22856366,1,-38,0,612,39,21,-18
"d4c3b003e8274e429d2fa688d73fde6d","5bc03c8f16354d04bd51f5bb93559ad3",22856366,1,4,0,621,22,26,4
"5bc03c8f16354d04bd51f5bb93559ad3","e20db35ced8544ddac5bc3839145e463",22856366,1,100,0,622,26,91,65
"e20db35ced8544ddac5bc3839145e463","73039f8c1eb9409cb4caee2cf968001e",22856366,1,10,0,623,91,100,9
"73039f8c1eb9409cb4caee2cf968001e","00ae5f0c51874a73a41ebea838d95682",22856366,1,1,0,624,100,101,1
"d391c8b6e56a43a7b654e9dee02d904b","73039f8c1eb9409cb4caee2cf968001e",22856366,1,-3,0,626,103,100,-3
"4280927ec4d643238aa49c32f9e06c6c","b7719e26494940efa49512aedd0aac79",22856366,1,-127,0,628,109,20,-89
"d4c3b003e8274e429d2fa688d73fde6d","a49d1bb4328949299686242fd0be5584",22856366,1,-1,0,635,22,21,-1
"d4c3b003e8274e429d2fa688d73fde6d","0c7262dff33c4087bc660ccf40f92f9c",22856366,1,206,0,640,22,169,147
"0c7262dff33c4087bc660ccf40f92f9c","b2275c3fad834f8d90737a2d9a6927d6",22856366,1,3,0,641,169,172,3
"b2275c3fad834f8d90737a2d9a6927d6","b2275c3fad834f8d90737a2d9a6927d6",22856366,22,0,1,642,172,172,0
"b2275c3fad834f8d90737a2d9a6927d6","eb515a26030b41f8a82a1e6114420bad",22856366,1,1,0,664,172,173,1
"eb515a26030b41f8a82a1e6114420bad","eb515a26030b41f8a82a1e6114420bad",22856366,6,0,1,665,173,173,0
"eb515a26030b41f8a82a1e6114420bad","b42cc17b7de840f181a704558d0bc845",22856366,1,3,0,671,173,175,2
"b42cc17b7de840f181a704558d0bc845","0c7262dff33c4087bc660ccf40f92f9c",22856366,1,-7,0,672,175,169,-6
"0c7262dff33c4087bc660ccf40f92f9c","b42cc17b7de840f181a704558d0bc845",22856366,1,7,0,673,169,175,6
"b42cc17b7de840f181a704558d0bc845","b42cc17b7de840f181a704558d0bc845",22856366,2,0,1,674,175,175,0
"b42cc17b7de840f181a704558d0bc845","801f9e9135034f49bf5f8b4bdefedb41",22856366,1,2,0,676,175,177,2
"801f9e9135034f49bf5f8b4bdefedb41","801f9e9135034f49bf5f8b4bdefedb41",22856366,11,0,1,677,177,177,0
"801f9e9135034f49bf5f8b4bdefedb41","b87c552dd247427abe6ab5795b9c9d43",22856366,1,5,0,688,177,181,4
"b87c552dd247427abe6ab5795b9c9d43","ea38cc0e6e6e41edbabf210220808bf9",22856366,1,-2,0,689,181,179,-2
"ea38cc0e6e6e41edbabf210220808bf9","362fcb0699a14845ab29b2340093e528",22856366,1,-6,0,690,179,174,-5
"362fcb0699a14845ab29b2340093e528","ea38cc0e6e6e41edbabf210220808bf9",22856366,1,6,0,691,174,179,5
"ea38cc0e6e6e41edbabf210220808bf9","b87c552dd247427abe6ab5795b9c9d43",22856366,1,2,0,692,179,181,2
"b87c552dd247427abe6ab5795b9c9d43","b87c552dd247427abe6ab5795b9c9d43",22856366,9,0,1,693,181,181,0
"b87c552dd247427abe6ab5795b9c9d43","139b097acfca451689d80c9c6eebdf7b",22856366,1,-3,0,702,181,178,-3
"139b097acfca451689d80c9c6eebdf7b","30f660a1feb34582a739722532524f79",22856366,1,6,0,703,178,183,5
"30f660a1feb34582a739722532524f79","30f660a1feb34582a739722532524f79",22856366,3,0,1,704,183,183,0
"30f660a1feb34582a739722532524f79","2024b4885bd14338a39b7b509acbbd02",22856366,1,-1,0,707,183,182,-1
"2024b4885bd14338a39b7b509acbbd02","c3f63fe50d8e487c86bf8ef76c9cadd3",22856366,1,4,0,708,182,185,3
"c3f63fe50d8e487c86bf8ef76c9cadd3","c3f63fe50d8e487c86bf8ef76c9cadd3",22856366,1,0,1,709,185,185,0
"c3f63fe50d8e487c86bf8ef76c9cadd3","c8e371568a0c4391b25796ae4e91952e",22856366,1,3,0,710,185,186,1
"c8e371568a0c4391b25796ae4e91952e","0c7262dff33c4087bc660ccf40f92f9c",22856366,1,-23,0,711,186,169,-17
"0c7262dff33c4087bc660ccf40f92f9c","7d932b23e1c84326ae5aa4d3c0d813d1",22856366,1,25,0,712,169,188,19
"7d932b23e1c84326ae5aa4d3c0d813d1","7d932b23e1c84326ae5aa4d3c0d813d1",22856366,1,0,1,713,188,188,0
"7d932b23e1c84326ae5aa4d3c0d813d1","c8e371568a0c4391b25796ae4e91952e",22856366,1,-2,0,714,188,186,-2
"c8e371568a0c4391b25796ae4e91952e","ab11d94c6c8948ea90b88f19d2cd502b",22856366,1,5,0,715,186,190,4
"ab11d94c6c8948ea90b88f19d2cd502b","ab11d94c6c8948ea90b88f19d2cd502b",22856366,2,0,1,716,190,190,0
"ab11d94c6c8948ea90b88f19d2cd502b","f992451ed6ad4e68bb9e68ad6be7c4be",22856366,1,2,0,718,190,192,2
"f992451ed6ad4e68bb9e68ad6be7c4be","f992451ed6ad4e68bb9e68ad6be7c4be",22856366,3,0,1,719,192,192,0
"f992451ed6ad4e68bb9e68ad6be7c4be","6cd2dcaac46847d4a0bc53f296d90375",22856366,1,3,0,722,192,194,2
"6cd2dcaac46847d4a0bc53f296d90375","07b44a7a51e94c78b411c753fc39dab0",22856366,1,-6,0,723,194,189,-5
"07b44a7a51e94c78b411c753fc39dab0","6cd2dcaac46847d4a0bc53f296d90375",22856366,1,6,0,724,189,194,5
"6cd2dcaac46847d4a0bc53f296d90375","2d2580c9411c4972909db508d6956a58",22856366,1,2,0,725,194,196,2
"2d2580c9411c4972909db508d6956a58","2d2580c9411c4972909db508d6956a58",22856366,5,0,1,726,196,196,0
"2d2580c9411c4972909db508d6956a58","5bddb3d9ed264f3984702f048c7e5340",22856366,1,1,0,731,196,197,1
"5bddb3d9ed264f3984702f048c7e5340","5bddb3d9ed264f3984702f048c7e5340",22856366,2,0,1,732,197,197,0
"5bddb3d9ed264f3984702f048c7e5340","d5e8e2bd12a2466b9d6d90855f0eb079",22856366,1,1,0,734,197,198,1
"d5e8e2bd12a2466b9d6d90855f0eb079","d5e8e2bd12a2466b9d6d90855f0eb079",22856366,2,0,1,735,198,198,0
"d5e8e2bd12a2466b9d6d90855f0eb079","017d7ca8e0394b91aaadc9574df2202c",22856366,1,-5,0,737,198,193,-5
"017d7ca8e0394b91aaadc9574df2202c","54e8e9f0ea3e45c4bf3b8ac799ee31b1",22856366,1,8,0,738,193,200,7
"54e8e9f0ea3e45c4bf3b8ac799ee31b1","54e8e9f0ea3e45c4bf3b8ac799ee31b1",22856366,1,0,1,739,200,200,0
"54e8e9f0ea3e45c4bf3b8ac799ee31b1","c614a00911be4877a075f19315530fb0",22856366,1,1,0,740,200,201,1
"c614a00911be4877a075f19315530fb0","c614a00911be4877a075f19315530fb0",22856366,6,0,1,741,201,201,0
"c614a00911be4877a075f19315530fb0","a6c21bd8b95249c7972820a7a7d76aff",22856366,1,1,0,747,201,202,1
"a6c21bd8b95249c7972820a7a7d76aff","a6c21bd8b95249c7972820a7a7d76aff",22856366,1,0,1,748,202,202,0
"a6c21bd8b95249c7972820a7a7d76aff","bb329d880ab54120adaf203a693bb203",22856366,1,1,0,749,202,203,1
"bb329d880ab54120adaf203a693bb203","bb329d880ab54120adaf203a693bb203",22856366,1,0,1,750,203,203,0
"bb329d880ab54120adaf203a693bb203","f9170dd6bc6442b4acd832747609b09a",22856366,1,-4,0,751,203,199,-4
"f9170dd6bc6442b4acd832747609b09a","334c2344009840079b1d0e1b7ce3d5a7",22856366,1,7,0,752,199,205,6
"334c2344009840079b1d0e1b7ce3d5a7","334c2344009840079b1d0e1b7ce3d5a7",22856366,1,0,1,753,205,205,0
"334c2344009840079b1d0e1b7ce3d5a7","c8e371568a0c4391b25796ae4e91952e",22856366,1,-23,0,754,205,186,-19
"c8e371568a0c4391b25796ae4e91952e","d7f13c8d63ec4e2aa673fbb9cf9c6933",22856366,1,26,0,755,186,206,20
"d7f13c8d63ec4e2aa673fbb9cf9c6933","b9e80f77c3a44349863b19875725c384",22856366,2,1,0,756,206,207,1
"b9e80f77c3a44349863b19875725c384","7108f0e4c2584f1f9c471689ae4c885c",22856366,2,1,0,757,207,208,1
"7108f0e4c2584f1f9c471689ae4c885c","b9e80f77c3a44349863b19875725c384",22856366,1,-1,0,758,208,207,-1
"b9e80f77c3a44349863b19875725c384","b9e80f77c3a44349863b19875725c384",22856366,19,0,1,759,207,207,0
"7108f0e4c2584f1f9c471689ae4c885c","7108f0e4c2584f1f9c471689ae4c885c",22856366,10,0,1,779,208,208,0
"7108f0e4c2584f1f9c471689ae4c885c","09400e101c5d4b439cf9a26b03aae558",22856366,1,3,0,789,208,210,2
"09400e101c5d4b439cf9a26b03aae558","d7f13c8d63ec4e2aa673fbb9cf9c6933",22856366,1,-5,0,790,210,206,-4
"d7f13c8d63ec4e2aa673fbb9cf9c6933","0c7262dff33c4087bc660ccf40f92f9c",22856366,1,-49,0,791,206,169,-37
"0c7262dff33c4087bc660ccf40f92f9c","d7f13c8d63ec4e2aa673fbb9cf9c6933",22856366,1,49,0,792,169,206,37
"b9e80f77c3a44349863b19875725c384","1c6721b1f63f4d30ba7746ea8af02a52",22856366,1,20,0,794,207,221,14
"1c6721b1f63f4d30ba7746ea8af02a52","1c6721b1f63f4d30ba7746ea8af02a52",22856366,1,0,1,795,221,221,0
"1c6721b1f63f4d30ba7746ea8af02a52","77ecef8eff6b4a2caea7707669bf7475",22856366,2,1,0,796,221,222,1
"77ecef8eff6b4a2caea7707669bf7475","1c6721b1f63f4d30ba7746ea8af02a52",22856366,4,-1,0,797,222,221,-1
"1c6721b1f63f4d30ba7746ea8af02a52","d7f13c8d63ec4e2aa673fbb9cf9c6933",22856366,3,-21,0,798,221,206,-15
"d7f13c8d63ec4e2aa673fbb9cf9c6933","be95c065e45447c1bd8215ea6f130c7a",22856366,1,17,0,799,206,219,13
"be95c065e45447c1bd8215ea6f130c7a","09400e101c5d4b439cf9a26b03aae558",22856366,1,-12,0,800,219,210,-9
"09400e101c5d4b439cf9a26b03aae558","09400e101c5d4b439cf9a26b03aae558",22856366,2,0,1,801,210,210,0
"09400e101c5d4b439cf9a26b03aae558","a88efa7e50ce47159810ab553afa6d3a",22856366,1,2,0,802,210,212,2
"a88efa7e50ce47159810ab553afa6d3a","a88efa7e50ce47159810ab553afa6d3a",22856366,5,0,1,803,212,212,0
"a88efa7e50ce47159810ab553afa6d3a","a875096404ef4a9984b62d74cda916f9",22856366,1,-3,0,808,212,209,-3
"a875096404ef4a9984b62d74cda916f9","be502a7a43c44bf7b682698de79d9369",22856366,2,6,0,809,209,214,5
"be502a7a43c44bf7b682698de79d9369","f7fb1952f56b4189b86a9f8b7862d2b8",22856366,4,1,0,810,214,215,1
"f7fb1952f56b4189b86a9f8b7862d2b8","d7f13c8d63ec4e2aa673fbb9cf9c6933",22856366,1,-11,0,811,215,206,-9
"d7f13c8d63ec4e2aa673fbb9cf9c6933","ec341f459285443b8361f7f15638ff08",22856366,1,9,0,812,206,213,7
"ec341f459285443b8361f7f15638ff08","be502a7a43c44bf7b682698de79d9369",22856366,1,1,0,813,213,214,1
"f7fb1952f56b4189b86a9f8b7862d2b8","be502a7a43c44bf7b682698de79d9369",22856366,2,-1,0,815,215,214,-1
"be502a7a43c44bf7b682698de79d9369","be502a7a43c44bf7b682698de79d9369",22856366,2,0,1,816,214,214,0
"f7fb1952f56b4189b86a9f8b7862d2b8","f7fb1952f56b4189b86a9f8b7862d2b8",22856366,20,0,1,819,215,215,0
"f7fb1952f56b4189b86a9f8b7862d2b8","b860ee85d8bc4a2f97958cfb71be3533",22856366,1,1,0,839,215,216,1
"b860ee85d8bc4a2f97958cfb71be3533","b860ee85d8bc4a2f97958cfb71be3533",22856366,2,0,1,840,216,216,0
"b860ee85d8bc4a2f97958cfb71be3533","ec341f459285443b8361f7f15638ff08",22856366,1,-3,0,842,216,213,-3
"ec341f459285443b8361f7f15638ff08","363837c182e04711840d896ae1e0339c",22856366,2,6,0,843,213,218,5
"363837c182e04711840d896ae1e0339c","01b2051f8941460d89945e3b02d1ce78",22856366,2,-1,0,844,218,217,-1
"01b2051f8941460d89945e3b02d1ce78","09400e101c5d4b439cf9a26b03aae558",22856366,1,-9,0,845,217,210,-7
"09400e101c5d4b439cf9a26b03aae558","a875096404ef4a9984b62d74cda916f9",22856366,1,-1,0,847,210,209,-1
"be502a7a43c44bf7b682698de79d9369","ec341f459285443b8361f7f15638ff08",22856366,1,-1,0,851,214,213,-1
"363837c182e04711840d896ae1e0339c","363837c182e04711840d896ae1e0339c",22856366,15,0,1,853,218,218,0
"01b2051f8941460d89945e3b02d1ce78","91125ca626c5470eb145501f8c37f8db",22856366,1,4,0,869,217,220,3
"91125ca626c5470eb145501f8c37f8db","91125ca626c5470eb145501f8c37f8db",22856366,1,0,1,870,220,220,0
"91125ca626c5470eb145501f8c37f8db","1c6721b1f63f4d30ba7746ea8af02a52",22856366,1,3,0,871,220,221,1
"d7f13c8d63ec4e2aa673fbb9cf9c6933","77ecef8eff6b4a2caea7707669bf7475",22856366,1,22,0,873,206,222,16
"d7f13c8d63ec4e2aa673fbb9cf9c6933","d7f13c8d63ec4e2aa673fbb9cf9c6933",22856366,1,0,1,876,206,206,0
"d7f13c8d63ec4e2aa673fbb9cf9c6933","1c6721b1f63f4d30ba7746ea8af02a52",22856366,1,21,0,877,206,221,15
"77ecef8eff6b4a2caea7707669bf7475","77ecef8eff6b4a2caea7707669bf7475",22856366,12,0,1,879,222,222,0
"1c6721b1f63f4d30ba7746ea8af02a52","d03cb855c70044cf8c35d9ec0de696e3",22856366,1,4,0,892,221,224,3
"d03cb855c70044cf8c35d9ec0de696e3","8b9ae98743bd4d4a8a87dff1c1244211",22856366,2,3,0,893,224,227,3
"8b9ae98743bd4d4a8a87dff1c1244211","d03cb855c70044cf8c35d9ec0de696e3",22856366,2,-3,0,894,227,224,-3
"d03cb855c70044cf8c35d9ec0de696e3","d03cb855c70044cf8c35d9ec0de696e3",22856366,1,0,1,895,224,224,0
"d03cb855c70044cf8c35d9ec0de696e3","a49a937d6896486d9a5396654abcf2e1",22856366,1,2,0,896,224,226,2
"a49a937d6896486d9a5396654abcf2e1","a49a937d6896486d9a5396654abcf2e1",22856366,5,0,1,897,226,226,0
"a49a937d6896486d9a5396654abcf2e1","8b9ae98743bd4d4a8a87dff1c1244211",22856366,1,1,0,902,226,227,1
"8b9ae98743bd4d4a8a87dff1c1244211","8b9ae98743bd4d4a8a87dff1c1244211",22856366,32,0,1,903,227,227,0
"8b9ae98743bd4d4a8a87dff1c1244211","f7906d6f59b9489a91d2ef40db5a474d",22856366,1,-4,0,935,227,223,-4
"f7906d6f59b9489a91d2ef40db5a474d","2ab1535aac1346ba8801535bf729ef37",22856366,2,7,0,936,223,229,6
"2ab1535aac1346ba8801535bf729ef37","d03cb855c70044cf8c35d9ec0de696e3",22856366,1,-6,0,937,229,224,-5
"8b9ae98743bd4d4a8a87dff1c1244211","5152833676bf4c6cb317060be10f68db",22856366,1,2,0,939,227,228,1
"5152833676bf4c6cb317060be10f68db","d03cb855c70044cf8c35d9ec0de696e3",22856366,1,-5,0,940,228,224,-4
"d03cb855c70044cf8c35d9ec0de696e3","2ab1535aac1346ba8801535bf729ef37",22856366,1,6,0,941,224,229,5
"2ab1535aac1346ba8801535bf729ef37","f7906d6f59b9489a91d2ef40db5a474d",22856366,1,-7,0,942,229,223,-6
"2ab1535aac1346ba8801535bf729ef37","a4f40fb48a8542c8949bae1f002cd9bc",22856366,1,2,0,944,229,231,2
"a4f40fb48a8542c8949bae1f002cd9bc","a4f40fb48a8542c8949bae1f002cd9bc",22856366,5,0,1,945,231,231,0
"a4f40fb48a8542c8949bae1f002cd9bc","8972c23e32044edb8a78fa1eed4e5947",22856366,1,1,0,950,231,232,1
"8972c23e32044edb8a78fa1eed4e5947","8972c23e32044edb8a78fa1eed4e5947",22856366,3,0,1,951,232,232,0
"8972c23e32044edb8a78fa1eed4e5947","92feb4a40f8344d38b6f722e42a53295",22856366,1,1,0,954,232,233,1
"92feb4a40f8344d38b6f722e42a53295","92feb4a40f8344d38b6f722e42a53295",22856366,2,0,1,955,233,233,0
"92feb4a40f8344d38b6f722e42a53295","5152833676bf4c6cb317060be10f68db",22856366,1,-5,0,957,233,228,-5
"5152833676bf4c6cb317060be10f68db","ca3e28f290354c08aefe5b0f769604e6",22856366,1,8,0,958,228,235,7
"ca3e28f290354c08aefe5b0f769604e6","ca3e28f290354c08aefe5b0f769604e6",22856366,9,0,1,959,235,235,0
"ca3e28f290354c08aefe5b0f769604e6","79a35eea833e4c2c9d22fc53c3c6445c",22856366,1,1,0,968,235,236,1
"79a35eea833e4c2c9d22fc53c3c6445c","79a35eea833e4c2c9d22fc53c3c6445c",22856366,4,0,1,969,236,236,0
"79a35eea833e4c2c9d22fc53c3c6445c","8f68228b1518449e9615cdafee41a2bd",22856366,1,1,0,973,236,237,1
"8f68228b1518449e9615cdafee41a2bd","8f68228b1518449e9615cdafee41a2bd",22856366,1,0,1,974,237,237,0
"8f68228b1518449e9615cdafee41a2bd","cab89fa5c3ed45a5aa550fc0352d6a42",22856366,1,1,0,975,237,238,1
"cab89fa5c3ed45a5aa550fc0352d6a42","cab89fa5c3ed45a5aa550fc0352d6a42",22856366,3,0,1,976,238,238,0
"cab89fa5c3ed45a5aa550fc0352d6a42","2ab1535aac1346ba8801535bf729ef37",22856366,1,-10,0,979,238,229,-9
"2ab1535aac1346ba8801535bf729ef37","0b04c8e2f86d48c7aeb7e225819cd32b",22856366,1,6,0,980,229,234,5
"0b04c8e2f86d48c7aeb7e225819cd32b","5152833676bf4c6cb317060be10f68db",22856366,1,-7,0,981,234,228,-6
"5152833676bf4c6cb317060be10f68db","8b9ae98743bd4d4a8a87dff1c1244211",22856366,1,-2,0,982,228,227,-1
"d03cb855c70044cf8c35d9ec0de696e3","f7906d6f59b9489a91d2ef40db5a474d",22856366,1,-1,0,984,224,223,-1
"f7906d6f59b9489a91d2ef40db5a474d","77ecef8eff6b4a2caea7707669bf7475",22856366,1,-2,0,985,223,222,-1
"1c6721b1f63f4d30ba7746ea8af02a52","2ab1535aac1346ba8801535bf729ef37",22856366,1,10,0,987,221,229,8
"2ab1535aac1346ba8801535bf729ef37","5152833676bf4c6cb317060be10f68db",22856366,1,-1,0,988,229,228,-1
"5152833676bf4c6cb317060be10f68db","66d4fad4f1cf4b46be0750a99ad7a35a",22856366,1,12,0,989,228,239,11
"66d4fad4f1cf4b46be0750a99ad7a35a","66d4fad4f1cf4b46be0750a99ad7a35a",22856366,1,0,1,990,239,239,0
"66d4fad4f1cf4b46be0750a99ad7a35a","0b04c8e2f86d48c7aeb7e225819cd32b",22856366,1,-5,0,991,239,234,-5
"0b04c8e2f86d48c7aeb7e225819cd32b","f53da5fd9bfe412da4b80d4742563b6c",22856366,1,8,0,992,234,241,7
"f53da5fd9bfe412da4b80d4742563b6c","f53da5fd9bfe412da4b80d4742563b6c",22856366,1,0,1,993,241,241,0
"f53da5fd9bfe412da4b80d4742563b6c","1c6721b1f63f4d30ba7746ea8af02a52",22856366,1,-24,0,994,241,221,-20
"1c6721b1f63f4d30ba7746ea8af02a52","2ae94c0cea4d480a9d5dca8fb1d7b542",22856366,1,27,0,995,221,242,21
"1ebf23f9d994469a85206e4c7b1bf5f5","0c7262dff33c4087bc660ccf40f92f9c",22856366,1,-100,0,997,245,169,-76
"0c7262dff33c4087bc660ccf40f92f9c","2ae94c0cea4d480a9d5dca8fb1d7b542",22856366,1,97,0,998,169,242,73
"1ebf23f9d994469a85206e4c7b1bf5f5","1ebf23f9d994469a85206e4c7b1bf5f5",22856366,10,0,1,1000,245,245,0
"1ebf23f9d994469a85206e4c7b1bf5f5","85ae675b83e8422da842cfd25596af99",22856366,1,1,0,1010,245,246,1
"85ae675b83e8422da842cfd25596af99","85ae675b83e8422da842cfd25596af99",22856366,1,0,1,1011,246,246,0
"85ae675b83e8422da842cfd25596af99","fa235f0f364d47e4ae1c87f47bf8e6ba",22856366,1,8,0,1012,246,252,6
"fa235f0f364d47e4ae1c87f47bf8e6ba","2ae94c0cea4d480a9d5dca8fb1d7b542",22856366,1,-12,0,1013,252,242,-10
"2ae94c0cea4d480a9d5dca8fb1d7b542","fa235f0f364d47e4ae1c87f47bf8e6ba",22856366,2,12,0,1014,242,252,10
"fa235f0f364d47e4ae1c87f47bf8e6ba","79f7845465cc4ed19d8e4f1429541be0",22856366,1,2,0,1015,252,254,2
"79f7845465cc4ed19d8e4f1429541be0","79f7845465cc4ed19d8e4f1429541be0",22856366,5,0,1,1016,254,254,0
"79f7845465cc4ed19d8e4f1429541be0","00f61990949545828dd12f1303d47504",22856366,1,3,0,1021,254,256,2
"00f61990949545828dd12f1303d47504","6e83e23f56544a19b94067c1c558d9c0",22856366,3,-11,0,1022,256,247,-9
"6e83e23f56544a19b94067c1c558d9c0","d546341988904f069cfa86b21457d9d9",22856366,2,5,0,1023,247,251,4
"d546341988904f069cfa86b21457d9d9","fa235f0f364d47e4ae1c87f47bf8e6ba",22856366,1,1,0,1024,251,252,1
"fa235f0f364d47e4ae1c87f47bf8e6ba","fa235f0f364d47e4ae1c87f47bf8e6ba",22856366,1,0,1,1025,252,252,0
"fa235f0f364d47e4ae1c87f47bf8e6ba","00f61990949545828dd12f1303d47504",22856366,2,5,0,1026,252,256,4
"6e83e23f56544a19b94067c1c558d9c0","00f61990949545828dd12f1303d47504",22856366,1,11,0,1028,247,256,9
"00f61990949545828dd12f1303d47504","ead7bb4b64e247d2ae632ab8a296b091",22856366,1,2,0,1029,256,258,2
"ead7bb4b64e247d2ae632ab8a296b091","ead7bb4b64e247d2ae632ab8a296b091",22856366,2,0,1,1030,258,258,0
"ead7bb4b64e247d2ae632ab8a296b091","41b0048dde734bb280bac6116baa8e27",22856366,1,1,0,1032,258,259,1
"41b0048dde734bb280bac6116baa8e27","41b0048dde734bb280bac6116baa8e27",22856366,2,0,1,1033,259,259,0
"41b0048dde734bb280bac6116baa8e27","b41c5a094a604ee0915327da5cc0beb7",22856366,1,1,0,1035,259,260,1
"b41c5a094a604ee0915327da5cc0beb7","b41c5a094a604ee0915327da5cc0beb7",22856366,2,0,1,1036,260,260,0
"b41c5a094a604ee0915327da5cc0beb7","d546341988904f069cfa86b21457d9d9",22856366,1,-10,0,1038,260,251,-9
"d546341988904f069cfa86b21457d9d9","2ae94c0cea4d480a9d5dca8fb1d7b542",22856366,1,-11,0,1039,251,242,-9
"2ae94c0cea4d480a9d5dca8fb1d7b542","1ebf23f9d994469a85206e4c7b1bf5f5",22856366,3,3,0,1040,242,245,3
"1ebf23f9d994469a85206e4c7b1bf5f5","2ae94c0cea4d480a9d5dca8fb1d7b542",22856366,1,-3,0,1041,245,242,-3
"d546341988904f069cfa86b21457d9d9","28c171777c52431ab6b925073bd63d46",22856366,1,15,0,1046,251,264,13
"28c171777c52431ab6b925073bd63d46","28c171777c52431ab6b925073bd63d46",22856366,7,0,1,1047,264,264,0
"28c171777c52431ab6b925073bd63d46","ac160db940cb49ae8579162b1d52bb5d",22856366,1,2,0,1054,264,266,2
"ac160db940cb49ae8579162b1d52bb5d","ac160db940cb49ae8579162b1d52bb5d",22856366,3,0,1,1055,266,266,0
"ac160db940cb49ae8579162b1d52bb5d","d989ebcfc12a4b669f0100dc1aa14f1e",22856366,1,-12,0,1058,266,255,-11
"d989ebcfc12a4b669f0100dc1aa14f1e","c6fd49b485cc4874b0bbdd9c6171e09c",22856366,1,15,0,1059,255,268,13
"c6fd49b485cc4874b0bbdd9c6171e09c","c6fd49b485cc4874b0bbdd9c6171e09c",22856366,11,0,1,1060,268,268,0
"c6fd49b485cc4874b0bbdd9c6171e09c","44240778a97c4af0937817499b75707b",22856366,1,1,0,1071,268,269,1
"44240778a97c4af0937817499b75707b","44240778a97c4af0937817499b75707b",22856366,2,0,1,1072,269,269,0
"44240778a97c4af0937817499b75707b","7aa76d3e993840d8805f097cbdbcd44b",22856366,1,-9,0,1074,269,261,-8
"7aa76d3e993840d8805f097cbdbcd44b","865a4d3b43374da7944dc7d397f566d9",22856366,1,12,0,1075,261,271,10
"865a4d3b43374da7944dc7d397f566d9","865a4d3b43374da7944dc7d397f566d9",22856366,1,0,1,1076,271,271,0
"865a4d3b43374da7944dc7d397f566d9","0d987bed3ffa4ed0b9a2e62e97b7b30f",22856366,1,3,0,1077,271,272,1
"0d987bed3ffa4ed0b9a2e62e97b7b30f","2ae94c0cea4d480a9d5dca8fb1d7b542",22856366,1,-38,0,1078,272,242,-30
"2ae94c0cea4d480a9d5dca8fb1d7b542","0d987bed3ffa4ed0b9a2e62e97b7b30f",22856366,1,38,0,1079,242,272,30
"0d987bed3ffa4ed0b9a2e62e97b7b30f","bb5a47f5ea01454a8b79455422d3b9da",22856366,4,10,0,1080,272,280,8
"bb5a47f5ea01454a8b79455422d3b9da","bb5a47f5ea01454a8b79455422d3b9da",22856366,81,0,1,1081,280,280,0
"bb5a47f5ea01454a8b79455422d3b9da","82ae07bc0c9b4570a41799290d1ef399",22856366,3,-6,0,1083,280,275,-5
"82ae07bc0c9b4570a41799290d1ef399","bb5a47f5ea01454a8b79455422d3b9da",22856366,3,6,0,1084,275,280,5
"bb5a47f5ea01454a8b79455422d3b9da","b7719e26494940efa49512aedd0aac79",22856366,1,-354,0,1089,280,20,-260
"b7719e26494940efa49512aedd0aac79","a49d1bb4328949299686242fd0be5584",22856366,7,2,0,1090,20,21,1
"a49d1bb4328949299686242fd0be5584","d4c3b003e8274e429d2fa688d73fde6d",22856366,5,1,0,1091,21,22,1
"d4c3b003e8274e429d2fa688d73fde6d","d4f45188d3c84a02ba08454e6403a818",22856366,7,2,0,1092,22,24,2
"d4f45188d3c84a02ba08454e6403a818","5bc03c8f16354d04bd51f5bb93559ad3",22856366,3,2,0,1093,24,26,2
"5bc03c8f16354d04bd51f5bb93559ad3","bc5524e78a8544e2ae2fdc2f3462bbec",22856366,1,346,0,1094,26,279,253
"bc5524e78a8544e2ae2fdc2f3462bbec","0d987bed3ffa4ed0b9a2e62e97b7b30f",22856366,1,-9,0,1095,279,272,-7
"bb5a47f5ea01454a8b79455422d3b9da","94cecc3f1e7d484b8e068e79241dfd73",22856366,2,3,0,1104,280,281,1
"94cecc3f1e7d484b8e068e79241dfd73","94cecc3f1e7d484b8e068e79241dfd73",22856366,1,0,1,1105,281,281,0
"94cecc3f1e7d484b8e068e79241dfd73","a37477c4e4c14169ad44b06b493007f6",22856366,1,2,0,1106,281,283,2
"a37477c4e4c14169ad44b06b493007f6","9afd71a5298d4333b6849dfce1b9422c",22856366,1,-363,0,1107,283,18,-265
"9afd71a5298d4333b6849dfce1b9422c","9afd71a5298d4333b6849dfce1b9422c",22856366,5,0,1,1108,18,18,0
"9afd71a5298d4333b6849dfce1b9422c","0d987bed3ffa4ed0b9a2e62e97b7b30f",22856366,1,348,0,1110,18,272,254
"bb5a47f5ea01454a8b79455422d3b9da","bc5524e78a8544e2ae2fdc2f3462bbec",22856366,1,-1,0,1147,280,279,-1
"bc5524e78a8544e2ae2fdc2f3462bbec","bb5a47f5ea01454a8b79455422d3b9da",22856366,1,1,0,1148,279,280,1
"94cecc3f1e7d484b8e068e79241dfd73","0d987bed3ffa4ed0b9a2e62e97b7b30f",22856366,1,-13,0,1180,281,272,-9
"0d987bed3ffa4ed0b9a2e62e97b7b30f","a37477c4e4c14169ad44b06b493007f6",22856366,1,15,0,1181,272,283,11
"a37477c4e4c14169ad44b06b493007f6","eb2a0eb537344a9e891c761662e400b6",22856366,1,-368,0,1182,283,16,-267
"eb2a0eb537344a9e891c761662e400b6","56586aa865414f538729c7f7735d2bc6",22856366,1,-8,0,1183,16,12,-4
"56586aa865414f538729c7f7735d2bc6","5c5ceeee4562457ba6d41515aeebfbb1",22856366,2,10,0,1184,12,17,5
"5c5ceeee4562457ba6d41515aeebfbb1","eb2a0eb537344a9e891c761662e400b6",22856366,1,-2,0,1185,17,16,-1
"eb2a0eb537344a9e891c761662e400b6","0d987bed3ffa4ed0b9a2e62e97b7b30f",22856366,1,353,0,1186,16,272,256
"bb5a47f5ea01454a8b79455422d3b9da","4a29443515bb404cb8924e1c60a63b73",22856366,1,12,0,1195,280,285,5
"4a29443515bb404cb8924e1c60a63b73","208c9b2796c944db8dacaa96082520ea",22856366,2,3,0,1196,285,288,3
"208c9b2796c944db8dacaa96082520ea","208c9b2796c944db8dacaa96082520ea",22856366,1,0,1,1197,288,288,0
"208c9b2796c944db8dacaa96082520ea","4a29443515bb404cb8924e1c60a63b73",22856366,3,-3,0,1198,288,285,-3
"208c9b2796c944db8dacaa96082520ea","6a9a3b5bde4a48daa896fe8c06eca56f",22856366,1,2,0,1200,288,289,1
"6a9a3b5bde4a48daa896fe8c06eca56f","208c9b2796c944db8dacaa96082520ea",22856366,1,-2,0,1201,289,288,-1
"4a29443515bb404cb8924e1c60a63b73","7669a956527947d0add87455277e80b4",22856366,1,7,0,1203,285,291,6
"7669a956527947d0add87455277e80b4","7669a956527947d0add87455277e80b4",22856366,1,0,1,1204,291,291,0
"7669a956527947d0add87455277e80b4","869e967078f04da18dd0b0b9389a7424",22856366,1,3,0,1205,291,293,2
"869e967078f04da18dd0b0b9389a7424","6a9a3b5bde4a48daa896fe8c06eca56f",22856366,1,-5,0,1206,293,289,-4
"6a9a3b5bde4a48daa896fe8c06eca56f","869e967078f04da18dd0b0b9389a7424",22856366,2,5,0,1207,289,293,4
"869e967078f04da18dd0b0b9389a7424","51ab6291537748fab90d519aa09889d6",22856366,1,2,0,1208,293,295,2
"51ab6291537748fab90d519aa09889d6","51ab6291537748fab90d519aa09889d6",22856366,5,0,1,1209,295,295,0
"51ab6291537748fab90d519aa09889d6","34a6e49023fc4465bd5ca604330bbd1c",22856366,1,-3,0,1214,295,292,-3
"34a6e49023fc4465bd5ca604330bbd1c","21592f2a9e9c4b2f8c66ec5dbcbf6a2b",22856366,2,5,0,1215,292,296,4
"21592f2a9e9c4b2f8c66ec5dbcbf6a2b","ba0e59461bfb4a44b7b1c28a01f8d3b3",22856366,2,4,0,1216,296,299,3
"ba0e59461bfb4a44b7b1c28a01f8d3b3","ba0e59461bfb4a44b7b1c28a01f8d3b3",22856366,1,0,1,1217,299,299,0
"ba0e59461bfb4a44b7b1c28a01f8d3b3","0e0b36e731a645e7b1b8a88f5031ca38",22856366,1,2,0,1218,299,301,2
"0e0b36e731a645e7b1b8a88f5031ca38","0e0b36e731a645e7b1b8a88f5031ca38",22856366,2,0,1,1219,301,301,0
"0e0b36e731a645e7b1b8a88f5031ca38","a66a144637284c21afc6de17fea4bfb8",22856366,1,1,0,1221,301,302,1
"a66a144637284c21afc6de17fea4bfb8","a66a144637284c21afc6de17fea4bfb8",22856366,2,0,1,1222,302,302,0
"a66a144637284c21afc6de17fea4bfb8","7646a919d7e64fa990bca9b024ff089d",22856366,1,-4,0,1224,302,298,-4
"7646a919d7e64fa990bca9b024ff089d","ba0e59461bfb4a44b7b1c28a01f8d3b3",22856366,1,1,0,1225,298,299,1
"ba0e59461bfb4a44b7b1c28a01f8d3b3","2c5bb2cbd0014420ad8c95d40e38efd1",22856366,1,5,0,1226,299,303,4
"2c5bb2cbd0014420ad8c95d40e38efd1","4a29443515bb404cb8924e1c60a63b73",22856366,1,-23,0,1227,303,285,-18
"4a29443515bb404cb8924e1c60a63b73","ba0e59461bfb4a44b7b1c28a01f8d3b3",22856366,1,18,0,1228,285,299,14
"ba0e59461bfb4a44b7b1c28a01f8d3b3","7646a919d7e64fa990bca9b024ff089d",22856366,3,-1,0,1229,299,298,-1
"7646a919d7e64fa990bca9b024ff089d","e390b575229748ea8aac9364efe2bf00",22856366,1,7,0,1230,298,304,6
"e390b575229748ea8aac9364efe2bf00","e390b575229748ea8aac9364efe2bf00",22856366,1,0,1,1231,304,304,0
"e390b575229748ea8aac9364efe2bf00","3434c10e561d488a914e0f7d71907abd",22856366,1,3,0,1232,304,305,1
"3434c10e561d488a914e0f7d71907abd","4a29443515bb404cb8924e1c60a63b73",22856366,2,-27,0,1233,305,285,-20
"4a29443515bb404cb8924e1c60a63b73","53e7e900392747ccad52e711ab0f80d8",22856366,1,29,0,1234,285,307,22
"53e7e900392747ccad52e711ab0f80d8","53e7e900392747ccad52e711ab0f80d8",22856366,1,0,1,1235,307,307,0
"53e7e900392747ccad52e711ab0f80d8","3434c10e561d488a914e0f7d71907abd",22856366,2,-2,0,1236,307,305,-2
"3434c10e561d488a914e0f7d71907abd","130acc2aeb0448fdbb2de63bc5cebe5b",22856366,2,5,0,1237,305,309,4
"130acc2aeb0448fdbb2de63bc5cebe5b","141c0df6cd1946539aadd1c9b7068cd4",22856366,1,-1,0,1238,309,308,-1
"141c0df6cd1946539aadd1c9b7068cd4","53e7e900392747ccad52e711ab0f80d8",22856366,1,-2,0,1239,308,307,-1
"53e7e900392747ccad52e711ab0f80d8","4a29443515bb404cb8924e1c60a63b73",22856366,1,-29,0,1240,307,285,-22
"4a29443515bb404cb8924e1c60a63b73","3434c10e561d488a914e0f7d71907abd",22856366,2,27,0,1241,285,305,20
"4a29443515bb404cb8924e1c60a63b73","4a29443515bb404cb8924e1c60a63b73",22856366,1,0,1,1243,285,285,0
"4a29443515bb404cb8924e1c60a63b73","2c5bb2cbd0014420ad8c95d40e38efd1",22856366,1,23,0,1244,285,303,18
"2c5bb2cbd0014420ad8c95d40e38efd1","ba0e59461bfb4a44b7b1c28a01f8d3b3",22856366,1,-5,0,1245,303,299,-4
"7646a919d7e64fa990bca9b024ff089d","869e967078f04da18dd0b0b9389a7424",22856366,1,-7,0,1247,298,293,-5
"869e967078f04da18dd0b0b9389a7424","21592f2a9e9c4b2f8c66ec5dbcbf6a2b",22856366,1,4,0,1248,293,296,3
"21592f2a9e9c4b2f8c66ec5dbcbf6a2b","34a6e49023fc4465bd5ca604330bbd1c",22856366,1,-5,0,1249,296,292,-4
"34a6e49023fc4465bd5ca604330bbd1c","208c9b2796c944db8dacaa96082520ea",22856366,1,-6,0,1250,292,288,-4
"4a29443515bb404cb8924e1c60a63b73","6a9a3b5bde4a48daa896fe8c06eca56f",22856366,1,5,0,1252,285,289,4
"869e967078f04da18dd0b0b9389a7424","34a6e49023fc4465bd5ca604330bbd1c",22856366,1,-1,0,1254,293,292,-1
"7646a919d7e64fa990bca9b024ff089d","4a29443515bb404cb8924e1c60a63b73",22856366,1,-17,0,1258,298,285,-13
"3434c10e561d488a914e0f7d71907abd","53e7e900392747ccad52e711ab0f80d8",22856366,1,2,0,1260,305,307,2
"130acc2aeb0448fdbb2de63bc5cebe5b","130acc2aeb0448fdbb2de63bc5cebe5b",22856366,2,0,1,1263,309,309,0
"130acc2aeb0448fdbb2de63bc5cebe5b","9c062b3251034ebe90f5054e2a3b5120",22856366,1,2,0,1265,309,311,2
"9c062b3251034ebe90f5054e2a3b5120","9c062b3251034ebe90f5054e2a3b5120",22856366,2,0,1,1266,311,311,0
"9c062b3251034ebe90f5054e2a3b5120","ea859f8207e44537889daeaba13ac2e8",22856366,1,1,0,1268,311,312,1
"ea859f8207e44537889daeaba13ac2e8","ea859f8207e44537889daeaba13ac2e8",22856366,4,0,1,1269,312,312,0
"ea859f8207e44537889daeaba13ac2e8","56d94971a7a94257aa330183a8ebd0ea",22856366,1,1,0,1273,312,313,1
"56d94971a7a94257aa330183a8ebd0ea","56d94971a7a94257aa330183a8ebd0ea",22856366,1,0,1,1274,313,313,0
"56d94971a7a94257aa330183a8ebd0ea","141c0df6cd1946539aadd1c9b7068cd4",22856366,1,-5,0,1275,313,308,-5
"141c0df6cd1946539aadd1c9b7068cd4","4a29443515bb404cb8924e1c60a63b73",22856366,1,-31,0,1276,308,285,-23
"4a29443515bb404cb8924e1c60a63b73","0c787d16c9504873b1a4d903cec09948",22856366,1,38,0,1277,285,314,29
"0c787d16c9504873b1a4d903cec09948","3434c10e561d488a914e0f7d71907abd",22856366,1,-11,0,1278,314,305,-9
"3434c10e561d488a914e0f7d71907abd","13255e63e0aa4abf85e5211bf613d43e",22856366,1,14,0,1279,305,317,12
"13255e63e0aa4abf85e5211bf613d43e","13255e63e0aa4abf85e5211bf613d43e",22856366,1,0,1,1280,317,317,0
"13255e63e0aa4abf85e5211bf613d43e","0c787d16c9504873b1a4d903cec09948",22856366,1,-3,0,1281,317,314,-3
"0c787d16c9504873b1a4d903cec09948","86c27d40179e419c8e9d150fb6afa5d0",22856366,1,6,0,1282,314,319,5
"86c27d40179e419c8e9d150fb6afa5d0","86c27d40179e419c8e9d150fb6afa5d0",22856366,1,0,1,1283,319,319,0
"86c27d40179e419c8e9d150fb6afa5d0","8d7e0b55cf9849cda222a0f2440cec55",22856366,1,-1,0,1284,319,318,-1
"8d7e0b55cf9849cda222a0f2440cec55","47edbb64109243e6b0f8f64cdef90c6c",22856366,1,9,0,1285,318,326,8
"47edbb64109243e6b0f8f64cdef90c6c","24f1363179ad4aaa965484a78471912b",22856366,1,-3,0,1286,326,323,-3
"24f1363179ad4aaa965484a78471912b","24f1363179ad4aaa965484a78471912b",22856366,1,0,1,1287,323,323,0
"24f1363179ad4aaa965484a78471912b","b7719e26494940efa49512aedd0aac79",22856366,1,-415,0,1288,323,20,-303
"5bc03c8f16354d04bd51f5bb93559ad3","3434c10e561d488a914e0f7d71907abd",22856366,1,386,0,1293,26,305,279
"3434c10e561d488a914e0f7d71907abd","43ea1b823a4b4e51b7c694c10725db82",22856366,1,27,0,1294,305,327,22
"43ea1b823a4b4e51b7c694c10725db82","3434c10e561d488a914e0f7d71907abd",22856366,2,-27,0,1295,327,305,-22
"3434c10e561d488a914e0f7d71907abd","3434c10e561d488a914e0f7d71907abd",22856366,1,0,1,1296,305,305,0
"3434c10e561d488a914e0f7d71907abd","3628bdce1dd2429ba924d2d4d09448d2",22856366,1,21,0,1297,305,322,17
"3628bdce1dd2429ba924d2d4d09448d2","3434c10e561d488a914e0f7d71907abd",22856366,1,-21,0,1298,322,305,-17
"3434c10e561d488a914e0f7d71907abd","24f1363179ad4aaa965484a78471912b",22856366,1,22,0,1299,305,323,18
"24f1363179ad4aaa965484a78471912b","47edbb64109243e6b0f8f64cdef90c6c",22856366,1,3,0,1300,323,326,3
"47edbb64109243e6b0f8f64cdef90c6c","a49d1bb4328949299686242fd0be5584",22856366,1,-416,0,1301,326,21,-305
"5bc03c8f16354d04bd51f5bb93559ad3","43ea1b823a4b4e51b7c694c10725db82",22856366,1,413,0,1307,26,327,301
"3434c10e561d488a914e0f7d71907abd","56b3fd1a212a4764be39d979fde3326e",22856366,1,28,0,1309,305,328,23
"56b3fd1a212a4764be39d979fde3326e","56b3fd1a212a4764be39d979fde3326e",22856366,1,0,1,1310,328,328,0
"56b3fd1a212a4764be39d979fde3326e","3434c10e561d488a914e0f7d71907abd",22856366,1,-28,0,1311,328,305,-23
"3434c10e561d488a914e0f7d71907abd","0c4079457ede49e3aeb5e86ed84bdf35",22856366,1,31,0,1312,305,329,24
"0c4079457ede49e3aeb5e86ed84bdf35","38aea304b4fa46e1b29bb72f5cea4c93",22856366,1,2,0,1313,329,331,2
"38aea304b4fa46e1b29bb72f5cea4c93","38aea304b4fa46e1b29bb72f5cea4c93",22856366,2,0,1,1314,331,331,0
"38aea304b4fa46e1b29bb72f5cea4c93","e36d261332f14e79bb4b467aceaeb9b5",22856366,1,2,0,1316,331,333,2
"e36d261332f14e79bb4b467aceaeb9b5","e36d261332f14e79bb4b467aceaeb9b5",22856366,1,0,1,1317,333,333,0
"e36d261332f14e79bb4b467aceaeb9b5","c7e89b9d04744d2eab742fc24e3ef1ae",22856366,1,1,0,1318,333,334,1
"c7e89b9d04744d2eab742fc24e3ef1ae","c7e89b9d04744d2eab742fc24e3ef1ae",22856366,2,0,1,1319,334,334,0
"c7e89b9d04744d2eab742fc24e3ef1ae","fe49f8054b374a0ea4bb266ed135ff62",22856366,1,1,0,1321,334,335,1
"fe49f8054b374a0ea4bb266ed135ff62","fe49f8054b374a0ea4bb266ed135ff62",22856366,5,0,1,1322,335,335,0
"fe49f8054b374a0ea4bb266ed135ff62","d0a8f74af98642fe8360d22c42e45117",22856366,1,1,0,1327,335,336,1
"d0a8f74af98642fe8360d22c42e45117","d0a8f74af98642fe8360d22c42e45117",22856366,2,0,1,1328,336,336,0
"d0a8f74af98642fe8360d22c42e45117","0c4079457ede49e3aeb5e86ed84bdf35",22856366,1,-7,0,1330,336,329,-7
"0c4079457ede49e3aeb5e86ed84bdf35","a7c6339ca1da4368a18d471f0519f877",22856366,1,11,0,1331,329,339,10
"a7c6339ca1da4368a18d471f0519f877","a7c6339ca1da4368a18d471f0519f877",22856366,1,0,1,1332,339,339,0
"a7c6339ca1da4368a18d471f0519f877","b8b9418ab322418d9db9b40d96af873a",22856366,1,-2,0,1333,339,337,-2
"b8b9418ab322418d9db9b40d96af873a","bbc5139ca9024389a94db3a6f47dcff6",22856366,1,5,0,1334,337,341,4
"bbc5139ca9024389a94db3a6f47dcff6","bbc5139ca9024389a94db3a6f47dcff6",22856366,1,0,1,1335,341,341,0
"bbc5139ca9024389a94db3a6f47dcff6","4ee6ca9019ab4a1ab323f98094a9bd77",22856366,1,2,0,1336,341,343,2
"4ee6ca9019ab4a1ab323f98094a9bd77","4ee6ca9019ab4a1ab323f98094a9bd77",22856366,2,0,1,1337,343,343,0
"4ee6ca9019ab4a1ab323f98094a9bd77","b37947176785476f8b29d49a851366dc",22856366,1,1,0,1339,343,344,1
"b37947176785476f8b29d49a851366dc","b37947176785476f8b29d49a851366dc",22856366,2,0,1,1340,344,344,0
"b37947176785476f8b29d49a851366dc","fcea5b10d5a14a3b9324ffece8f6e1e5",22856366,1,1,0,1342,344,345,1
"fcea5b10d5a14a3b9324ffece8f6e1e5","fcea5b10d5a14a3b9324ffece8f6e1e5",22856366,2,0,1,1343,345,345,0
"fcea5b10d5a14a3b9324ffece8f6e1e5","c2490bc612d146edbe786556fab3651b",22856366,1,-5,0,1345,345,340,-5
"c2490bc612d146edbe786556fab3651b","6ac8bb048b854999a47edb35fe627f11",22856366,1,8,0,1346,340,347,7
"6ac8bb048b854999a47edb35fe627f11","6ac8bb048b854999a47edb35fe627f11",22856366,1,0,1,1347,347,347,0
"6ac8bb048b854999a47edb35fe627f11","30ead9794d4847abaf222ca966cc8630",22856366,1,3,0,1348,347,348,1
"30ead9794d4847abaf222ca966cc8630","0c4079457ede49e3aeb5e86ed84bdf35",22856366,1,-24,0,1349,348,329,-19
"0c4079457ede49e3aeb5e86ed84bdf35","897b7f51242c44aab2205c72fdcbf4cd",22856366,1,28,0,1350,329,352,23
"897b7f51242c44aab2205c72fdcbf4cd","09b9678ddc3d452ea4a3d46e15826065",22856366,2,1,0,1351,352,353,1
"09b9678ddc3d452ea4a3d46e15826065","c20993c944444fe085345591a8bd837e",22856366,1,-2,0,1352,353,351,-2
"c20993c944444fe085345591a8bd837e","eff0de7f2dbb42dfa1a2e686efab5b6d",22856366,1,3,0,1353,351,354,3
"eff0de7f2dbb42dfa1a2e686efab5b6d","c20993c944444fe085345591a8bd837e",22856366,1,-3,0,1354,354,351,-3
"c20993c944444fe085345591a8bd837e","c20993c944444fe085345591a8bd837e",22856366,3,0,1,1355,351,351,0
"c20993c944444fe085345591a8bd837e","897b7f51242c44aab2205c72fdcbf4cd",22856366,1,1,0,1358,351,352,1
"897b7f51242c44aab2205c72fdcbf4cd","897b7f51242c44aab2205c72fdcbf4cd",22856366,3,0,1,1359,352,352,0
"09b9678ddc3d452ea4a3d46e15826065","09b9678ddc3d452ea4a3d46e15826065",22856366,3,0,1,1363,353,353,0
"09b9678ddc3d452ea4a3d46e15826065","eff0de7f2dbb42dfa1a2e686efab5b6d",22856366,1,1,0,1366,353,354,1
"eff0de7f2dbb42dfa1a2e686efab5b6d","eff0de7f2dbb42dfa1a2e686efab5b6d",22856366,3,0,1,1367,354,354,0
"eff0de7f2dbb42dfa1a2e686efab5b6d","2fe14166dc9642c3bc666b86a57f943d",22856366,1,4,0,1370,354,357,3
"2fe14166dc9642c3bc666b86a57f943d","30ead9794d4847abaf222ca966cc8630",22856366,1,-10,0,1371,357,348,-9
"30ead9794d4847abaf222ca966cc8630","4a29443515bb404cb8924e1c60a63b73",22856366,1,-82,0,1372,348,285,-63
"4a29443515bb404cb8924e1c60a63b73","30ead9794d4847abaf222ca966cc8630",22856366,1,82,0,1373,285,348,63
"30ead9794d4847abaf222ca966cc8630","1ba8fef685d74a8194b9db252eb704fb",22856366,1,8,0,1374,348,355,7
"1ba8fef685d74a8194b9db252eb704fb","2fe14166dc9642c3bc666b86a57f943d",22856366,1,2,0,1375,355,357,2
"2fe14166dc9642c3bc666b86a57f943d","2fe14166dc9642c3bc666b86a57f943d",22856366,2,0,1,1376,357,357,0
"2fe14166dc9642c3bc666b86a57f943d","44421dd1e13a47a388c4a19834b744c7",22856366,1,2,0,1378,357,359,2
"44421dd1e13a47a388c4a19834b744c7","44421dd1e13a47a388c4a19834b744c7",22856366,2,0,1,1379,359,359,0
"44421dd1e13a47a388c4a19834b744c7","cb5fc7ef85d547c4be1a7439d0bf6052",22856366,1,1,0,1381,359,360,1
"cb5fc7ef85d547c4be1a7439d0bf6052","cb5fc7ef85d547c4be1a7439d0bf6052",22856366,5,0,1,1382,360,360,0
"cb5fc7ef85d547c4be1a7439d0bf6052","0a8f150a4cf747acbde62f4721823da3",22856366,1,1,0,1387,360,361,1
"0a8f150a4cf747acbde62f4721823da3","0a8f150a4cf747acbde62f4721823da3",22856366,5,0,1,1388,361,361,0
"0a8f150a4cf747acbde62f4721823da3","ab8fdad974ae471f9f24c3f9dd04462e",22856366,1,1,0,1393,361,362,1
"ab8fdad974ae471f9f24c3f9dd04462e","ab8fdad974ae471f9f24c3f9dd04462e",22856366,2,0,1,1394,362,362,0
"ab8fdad974ae471f9f24c3f9dd04462e","1ba8fef685d74a8194b9db252eb704fb",22856366,1,-7,0,1396,362,355,-7
"1ba8fef685d74a8194b9db252eb704fb","52580888dadb4fe3baa795683ea227bd",22856366,1,10,0,1397,355,364,9
"52580888dadb4fe3baa795683ea227bd","52580888dadb4fe3baa795683ea227bd",22856366,1,0,1,1398,364,364,0
"52580888dadb4fe3baa795683ea227bd","492a3bc6a1254f23a7998587961b22a4",22856366,1,3,0,1399,364,366,2
"492a3bc6a1254f23a7998587961b22a4","f00179e251a045b39c3f7a54f9aa4acc",22856366,1,-4,0,1400,366,363,-3
"f00179e251a045b39c3f7a54f9aa4acc","492a3bc6a1254f23a7998587961b22a4",22856366,1,4,0,1401,363,366,3
"492a3bc6a1254f23a7998587961b22a4","072a190fd302456290895f9f04d6940a",22856366,1,-1,0,1402,366,365,-1
"072a190fd302456290895f9f04d6940a","c76574d21bc14aeea7ecd0b027f39858",22856366,1,3,0,1403,365,367,2
"c76574d21bc14aeea7ecd0b027f39858","2fe14166dc9642c3bc666b86a57f943d",22856366,1,-13,0,1404,367,357,-10
"2fe14166dc9642c3bc666b86a57f943d","cb5fc7ef85d547c4be1a7439d0bf6052",22856366,1,3,0,1405,357,360,3
"cb5fc7ef85d547c4be1a7439d0bf6052","1ba8fef685d74a8194b9db252eb704fb",22856366,1,-5,0,1406,360,355,-5
"1ba8fef685d74a8194b9db252eb704fb","cfa457d1743848e4bb5e4beced6448ed",22856366,1,17,0,1407,355,369,14
"cfa457d1743848e4bb5e4beced6448ed","cfa457d1743848e4bb5e4beced6448ed",22856366,1,0,1,1408,369,369,0
"cfa457d1743848e4bb5e4beced6448ed","b71bac264efb4abd97015447bd490db6",22856366,1,3,0,1409,369,370,1
"b71bac264efb4abd97015447bd490db6","30ead9794d4847abaf222ca966cc8630",22856366,1,-28,0,1410,370,348,-22
"30ead9794d4847abaf222ca966cc8630","b71bac264efb4abd97015447bd490db6",22856366,1,28,0,1411,348,370,22
"b71bac264efb4abd97015447bd490db6","b71bac264efb4abd97015447bd490db6",22856366,1,0,1,1412,370,370,0
"b71bac264efb4abd97015447bd490db6","1b4550d0dab04078b3bf08a655345bdc",22856366,1,4,0,1413,370,373,3
"1b4550d0dab04078b3bf08a655345bdc","b71bac264efb4abd97015447bd490db6",22856366,1,-4,0,1414,373,370,-3
"b71bac264efb4abd97015447bd490db6","8d448d625b024c82a5eb240bbd7431d6",22856366,4,5,0,1415,370,374,4
"8d448d625b024c82a5eb240bbd7431d6","8d448d625b024c82a5eb240bbd7431d6",22856366,65,0,1,1416,374,374,0
"8d448d625b024c82a5eb240bbd7431d6","b71bac264efb4abd97015447bd490db6",22856366,2,-5,0,1436,374,370,-4
"8d448d625b024c82a5eb240bbd7431d6","d6d02b6ef04e4f17805504500b8ce441",22856366,1,3,0,1469,374,375,1
"d6d02b6ef04e4f17805504500b8ce441","b71bac264efb4abd97015447bd490db6",22856366,2,-8,0,1470,375,370,-5
"b71bac264efb4abd97015447bd490db6","d6d02b6ef04e4f17805504500b8ce441",22856366,1,8,0,1471,370,375,5
"d6d02b6ef04e4f17805504500b8ce441","d6d02b6ef04e4f17805504500b8ce441",22856366,2,0,1,1472,375,375,0
"8d448d625b024c82a5eb240bbd7431d6","66baf19b6b904b70922329068c63746d",22856366,1,7,0,1492,374,376,2
"66baf19b6b904b70922329068c63746d","66baf19b6b904b70922329068c63746d",22856366,1,0,1,1493,376,376,0
"66baf19b6b904b70922329068c63746d","7f544639412e40a9ba27f43b415362ab",22856366,1,2,0,1494,376,378,2
"7f544639412e40a9ba27f43b415362ab","7f544639412e40a9ba27f43b415362ab",22856366,1,0,1,1495,378,378,0
"7f544639412e40a9ba27f43b415362ab","d5ae8642e15b46b8bd298b02274d4e9c",22856366,1,2,0,1496,378,380,2
"d5ae8642e15b46b8bd298b02274d4e9c","d5ae8642e15b46b8bd298b02274d4e9c",22856366,4,0,1,1497,380,380,0
"d5ae8642e15b46b8bd298b02274d4e9c","a0d10309a2dd456289147f84be9d37f9",22856366,1,1,0,1501,380,381,1
"a0d10309a2dd456289147f84be9d37f9","a0d10309a2dd456289147f84be9d37f9",22856366,2,0,1,1502,381,381,0
"a0d10309a2dd456289147f84be9d37f9","0fcbc3ca07b144138b8d85da581f09a8",22856366,1,1,0,1504,381,382,1
"0fcbc3ca07b144138b8d85da581f09a8","0fcbc3ca07b144138b8d85da581f09a8",22856366,5,0,1,1505,382,382,0
"0fcbc3ca07b144138b8d85da581f09a8","66baf19b6b904b70922329068c63746d",22856366,1,-6,0,1510,382,376,-6
"66baf19b6b904b70922329068c63746d","4890121ce5d74576b4632b77cfc23398",22856366,1,14,0,1511,376,388,12
"4890121ce5d74576b4632b77cfc23398","c2fca3669923477ab966ded303dea31c",22856366,1,-6,0,1512,388,383,-5
"c2fca3669923477ab966ded303dea31c","4890121ce5d74576b4632b77cfc23398",22856366,1,6,0,1513,383,388,5
"4890121ce5d74576b4632b77cfc23398","18d3b836dd804224883cc9180b60a8e1",22856366,1,-1,0,1514,388,387,-1
"18d3b836dd804224883cc9180b60a8e1","96bb2b3e85a34d8b9544514e89f6fe97",22856366,1,4,0,1515,387,390,3
"96bb2b3e85a34d8b9544514e89f6fe97","96bb2b3e85a34d8b9544514e89f6fe97",22856366,1,0,1,1516,390,390,0
"96bb2b3e85a34d8b9544514e89f6fe97","ac4e9b54acfe4670b4634859c7263cb5",22856366,1,2,0,1517,390,392,2
"ac4e9b54acfe4670b4634859c7263cb5","ac4e9b54acfe4670b4634859c7263cb5",22856366,1,0,1,1518,392,392,0
"ac4e9b54acfe4670b4634859c7263cb5","17f95d18bab743888e1736033dc3384d",22856366,1,-3,0,1519,392,389,-3
"17f95d18bab743888e1736033dc3384d","6f8881a745ac4c358a68b92c3b4abe81",22856366,1,6,0,1520,389,394,5
"6f8881a745ac4c358a68b92c3b4abe81","6f8881a745ac4c358a68b92c3b4abe81",22856366,1,0,1,1521,394,394,0
"6f8881a745ac4c358a68b92c3b4abe81","f7002c8484354eceac57bc7bd62c76c1",22856366,1,-1,0,1522,394,393,-1
"f7002c8484354eceac57bc7bd62c76c1","44a277ea44dc4ae689fab4b82f0b4098",22856366,1,5,0,1523,393,397,4
"44a277ea44dc4ae689fab4b82f0b4098","44a277ea44dc4ae689fab4b82f0b4098",22856366,1,0,1,1524,397,397,0
"44a277ea44dc4ae689fab4b82f0b4098","0c12af0a4e7f4002852cf84b2537c161",22856366,1,-2,0,1525,397,395,-2
"0c12af0a4e7f4002852cf84b2537c161","859e0b8d71694b12befb69ee698138f9",22856366,1,5,0,1526,395,399,4
"859e0b8d71694b12befb69ee698138f9","859e0b8d71694b12befb69ee698138f9",22856366,1,0,1,1527,399,399,0
"859e0b8d71694b12befb69ee698138f9","2b09a08242b54983aec7063990fb3f66",22856366,1,3,0,1528,399,400,1
"2b09a08242b54983aec7063990fb3f66","66baf19b6b904b70922329068c63746d",22856366,1,-32,0,1529,400,376,-24
"66baf19b6b904b70922329068c63746d","2b09a08242b54983aec7063990fb3f66",22856366,2,32,0,1530,376,400,24
"2b09a08242b54983aec7063990fb3f66","2b09a08242b54983aec7063990fb3f66",22856366,2,0,1,1531,400,400,0
"2b09a08242b54983aec7063990fb3f66","1f471b7a883a4df48211e8c6a81b59a7",22856366,1,1,0,1533,400,401,1
"1f471b7a883a4df48211e8c6a81b59a7","1f471b7a883a4df48211e8c6a81b59a7",22856366,1,0,1,1534,401,401,0
"1f471b7a883a4df48211e8c6a81b59a7","2b09a08242b54983aec7063990fb3f66",22856366,1,-1,0,1535,401,400,-1
"2b09a08242b54983aec7063990fb3f66","9de0d567bfa84fe5b77cb76f4a76a5d1",22856366,1,5,0,1536,400,404,4
"9de0d567bfa84fe5b77cb76f4a76a5d1","9de0d567bfa84fe5b77cb76f4a76a5d1",22856366,1,0,1,1537,404,404,0
"9de0d567bfa84fe5b77cb76f4a76a5d1","1157bd665ec4472fb58b751dc5099355",22856366,1,-1,0,1538,404,403,-1
"1157bd665ec4472fb58b751dc5099355","58fc9094275e4c49be3f4ba6d4acc0a4",22856366,1,5,0,1539,403,406,3
"58fc9094275e4c49be3f4ba6d4acc0a4","3c8a22d2f9c146ea956609e3ed4f2559",22856366,1,-2,0,1540,406,405,-1
"3c8a22d2f9c146ea956609e3ed4f2559","58fc9094275e4c49be3f4ba6d4acc0a4",22856366,1,2,0,1541,405,406,1
"58fc9094275e4c49be3f4ba6d4acc0a4","c1c1be90b2b14c1ab4a5e1ee3c241902",22856366,1,1,0,1542,406,407,1
"c1c1be90b2b14c1ab4a5e1ee3c241902","c1c1be90b2b14c1ab4a5e1ee3c241902",22856366,5,0,1,1543,407,407,0
"c1c1be90b2b14c1ab4a5e1ee3c241902","02b3a1bead9244c1ba2f857c7da8f82a",22856366,1,2,0,1548,407,408,1
"02b3a1bead9244c1ba2f857c7da8f82a","58fc9094275e4c49be3f4ba6d4acc0a4",22856366,2,-3,0,1549,408,406,-2
"58fc9094275e4c49be3f4ba6d4acc0a4","66baf19b6b904b70922329068c63746d",22856366,1,-41,0,1550,406,376,-30
"2b09a08242b54983aec7063990fb3f66","02b3a1bead9244c1ba2f857c7da8f82a",22856366,1,12,0,1552,400,408,8
"02b3a1bead9244c1ba2f857c7da8f82a","02b3a1bead9244c1ba2f857c7da8f82a",22856366,3,0,1,1553,408,408,0
"58fc9094275e4c49be3f4ba6d4acc0a4","58fc9094275e4c49be3f4ba6d4acc0a4",22856366,1,0,1,1556,406,406,0
"58fc9094275e4c49be3f4ba6d4acc0a4","02b3a1bead9244c1ba2f857c7da8f82a",22856366,1,3,0,1557,406,408,2
"02b3a1bead9244c1ba2f857c7da8f82a","6206fc6479014bb193084c32409dc1b9",22856366,1,1,0,1559,408,409,1
"6206fc6479014bb193084c32409dc1b9","6206fc6479014bb193084c32409dc1b9",22856366,7,0,1,1560,409,409,0
"6206fc6479014bb193084c32409dc1b9","02b3a1bead9244c1ba2f857c7da8f82a",22856366,1,-1,0,1567,409,408,-1
"02b3a1bead9244c1ba2f857c7da8f82a","6a5f020451db426dacba9e2ea3fcc62a",22856366,1,3,0,1568,408,410,2
"6a5f020451db426dacba9e2ea3fcc62a","6a5f020451db426dacba9e2ea3fcc62a",22856366,1,0,1,1569,410,410,0
"6a5f020451db426dacba9e2ea3fcc62a","33a9d248b2e44588a5b07fc1342b9bc2",22856366,2,2,0,1570,410,411,1
"33a9d248b2e44588a5b07fc1342b9bc2","6a5f020451db426dacba9e2ea3fcc62a",22856366,1,-2,0,1571,411,410,-1
"33a9d248b2e44588a5b07fc1342b9bc2","66baf19b6b904b70922329068c63746d",22856366,1,-49,0,1573,411,376,-35
"66baf19b6b904b70922329068c63746d","c5df9f40ec14463b9dcfdc73df3e9285",22856366,1,132,0,1574,376,464,88
"c5df9f40ec14463b9dcfdc73df3e9285","c5df9f40ec14463b9dcfdc73df3e9285",22856366,3,0,1,1575,464,464,0
"c5df9f40ec14463b9dcfdc73df3e9285","2b09a08242b54983aec7063990fb3f66",22856366,1,-100,0,1577,464,400,-64
"2b09a08242b54983aec7063990fb3f66","33a9d248b2e44588a5b07fc1342b9bc2",22856366,1,17,0,1578,400,411,11
"33a9d248b2e44588a5b07fc1342b9bc2","33a9d248b2e44588a5b07fc1342b9bc2",22856366,2,0,1,1579,411,411,0
"33a9d248b2e44588a5b07fc1342b9bc2","c6f26bd420634f1cb7989e76fe6b16c0",22856366,1,1,0,1581,411,412,1
"c6f26bd420634f1cb7989e76fe6b16c0","c6f26bd420634f1cb7989e76fe6b16c0",22856366,5,0,1,1582,412,412,0
"c6f26bd420634f1cb7989e76fe6b16c0","2a65ee6e2ac64f6a8a55fbe5373ec763",22856366,1,1,0,1587,412,413,1
"2a65ee6e2ac64f6a8a55fbe5373ec763","2a65ee6e2ac64f6a8a55fbe5373ec763",22856366,2,0,1,1588,413,413,0
"2a65ee6e2ac64f6a8a55fbe5373ec763","33a9d248b2e44588a5b07fc1342b9bc2",22856366,1,-2,0,1590,413,411,-2
"33a9d248b2e44588a5b07fc1342b9bc2","1fd0f6dadbc14ebc965faf6122190b96",22856366,1,5,0,1591,411,415,4
"1fd0f6dadbc14ebc965faf6122190b96","1fd0f6dadbc14ebc965faf6122190b96",22856366,1,0,1,1592,415,415,0
"1fd0f6dadbc14ebc965faf6122190b96","687055dad9fc40c3982478fe33ec01bf",22856366,1,-1,0,1593,415,414,-1
"687055dad9fc40c3982478fe33ec01bf","2add1669f08d4101913db15f8c23b3b7",22856366,1,3,0,1594,414,416,2
"2add1669f08d4101913db15f8c23b3b7","2add1669f08d4101913db15f8c23b3b7",22856366,1,0,1,1595,416,416,0
"2add1669f08d4101913db15f8c23b3b7","2b09a08242b54983aec7063990fb3f66",22856366,1,-24,0,1596,416,400,-16
"2b09a08242b54983aec7063990fb3f66","a2b4bd40cee2481ebd3fc179d6a5cd62",22856366,1,27,0,1597,400,417,17
"a2b4bd40cee2481ebd3fc179d6a5cd62","e34e59dce2204f228f3a84b6725df60f",22856366,1,2,0,1598,417,419,2
"e34e59dce2204f228f3a84b6725df60f","e34e59dce2204f228f3a84b6725df60f",22856366,1,0,1,1599,419,419,0
"e34e59dce2204f228f3a84b6725df60f","a2b4bd40cee2481ebd3fc179d6a5cd62",22856366,1,-2,0,1600,419,417,-2
"a2b4bd40cee2481ebd3fc179d6a5cd62","bec48fc2e1294c7eb3d0aca780d731b8",22856366,2,4,0,1601,417,420,3
"bec48fc2e1294c7eb3d0aca780d731b8","a2b4bd40cee2481ebd3fc179d6a5cd62",22856366,1,-4,0,1602,420,417,-3
"bec48fc2e1294c7eb3d0aca780d731b8","bec48fc2e1294c7eb3d0aca780d731b8",22856366,3,0,1,1604,420,420,0
"bec48fc2e1294c7eb3d0aca780d731b8","a24600b0e49245f6bdba8c893cfeddb0",22856366,1,7,0,1607,420,425,5
"a24600b0e49245f6bdba8c893cfeddb0","dbde19fcce2a4c1abdc7f685c293a23f",22856366,1,-4,0,1608,425,422,-3
"dbde19fcce2a4c1abdc7f685c293a23f","a24600b0e49245f6bdba8c893cfeddb0",22856366,1,4,0,1609,422,425,3
"a24600b0e49245f6bdba8c893cfeddb0","a24600b0e49245f6bdba8c893cfeddb0",22856366,1,0,1,1610,425,425,0
"a24600b0e49245f6bdba8c893cfeddb0","a2b4bd40cee2481ebd3fc179d6a5cd62",22856366,1,-11,0,1611,425,417,-8
"a2b4bd40cee2481ebd3fc179d6a5cd62","24cf8786024543f19b89bc20034e60d7",22856366,1,18,0,1612,417,428,11
"24cf8786024543f19b89bc20034e60d7","f2a73be2f46840b182d7bd095378004e",22856366,1,1,0,1613,428,429,1
"f2a73be2f46840b182d7bd095378004e","f2a73be2f46840b182d7bd095378004e",22856366,1,0,1,1614,429,429,0
"f2a73be2f46840b182d7bd095378004e","604551fd4266430cb860fef58fa7dd61",22856366,1,1,0,1615,429,430,1
"604551fd4266430cb860fef58fa7dd61","604551fd4266430cb860fef58fa7dd61",22856366,1,0,1,1616,430,430,0
"604551fd4266430cb860fef58fa7dd61","dce46f8904594a62a6377a3587aaa663",22856366,1,2,0,1617,430,431,1
"dce46f8904594a62a6377a3587aaa663","24cf8786024543f19b89bc20034e60d7",22856366,1,-4,0,1618,431,428,-3
"24cf8786024543f19b89bc20034e60d7","dce46f8904594a62a6377a3587aaa663",22856366,1,4,0,1619,428,431,3
"dce46f8904594a62a6377a3587aaa663","dce46f8904594a62a6377a3587aaa663",22856366,2,0,1,1620,431,431,0
"dce46f8904594a62a6377a3587aaa663","9b9d0a249052413c869753b99682b0ac",22856366,1,1,0,1622,431,432,1
"9b9d0a249052413c869753b99682b0ac","9b9d0a249052413c869753b99682b0ac",22856366,3,0,1,1623,432,432,0
"9b9d0a249052413c869753b99682b0ac","061c175cc90f45fbad883025394e78dd",22856366,1,1,0,1626,432,433,1
"061c175cc90f45fbad883025394e78dd","061c175cc90f45fbad883025394e78dd",22856366,1,0,1,1627,433,433,0
"061c175cc90f45fbad883025394e78dd","dce46f8904594a62a6377a3587aaa663",22856366,1,-2,0,1628,433,431,-2
"dce46f8904594a62a6377a3587aaa663","66ada10dde9f43018588f1ced9d477fc",22856366,1,4,0,1629,431,434,3
"66ada10dde9f43018588f1ced9d477fc","24cf8786024543f19b89bc20034e60d7",22856366,2,-8,0,1630,434,428,-6
"24cf8786024543f19b89bc20034e60d7","070600601c4c439288445d2f0724807d",22856366,2,14,0,1631,428,437,9
"070600601c4c439288445d2f0724807d","1823b6de7d334a7aaabc4570719af4d9",22856366,2,2,0,1632,437,439,2
"1823b6de7d334a7aaabc4570719af4d9","070600601c4c439288445d2f0724807d",22856366,1,-2,0,1633,439,437,-2
"070600601c4c439288445d2f0724807d","24cf8786024543f19b89bc20034e60d7",22856366,1,-14,0,1634,437,428,-9
"24cf8786024543f19b89bc20034e60d7","bf12c96466d840a69bed7020b3f18bb8",22856366,1,11,0,1635,428,436,8
"bf12c96466d840a69bed7020b3f18bb8","74a7f8712e5449c2bc0b43c6f90dafed",22856366,1,-2,0,1636,436,435,-1
"74a7f8712e5449c2bc0b43c6f90dafed","74a7f8712e5449c2bc0b43c6f90dafed",22856366,1,0,1,1637,435,435,0
"74a7f8712e5449c2bc0b43c6f90dafed","66ada10dde9f43018588f1ced9d477fc",22856366,1,-1,0,1638,435,434,-1
"1823b6de7d334a7aaabc4570719af4d9","1823b6de7d334a7aaabc4570719af4d9",22856366,11,0,1,1642,439,439,0
"1823b6de7d334a7aaabc4570719af4d9","0380cd76a7d44bc3a4da1f15e4d68f89",22856366,1,2,0,1653,439,440,1
"0380cd76a7d44bc3a4da1f15e4d68f89","070600601c4c439288445d2f0724807d",22856366,1,-4,0,1654,440,437,-3
"070600601c4c439288445d2f0724807d","0380cd76a7d44bc3a4da1f15e4d68f89",22856366,1,4,0,1655,437,440,3
"0380cd76a7d44bc3a4da1f15e4d68f89","0380cd76a7d44bc3a4da1f15e4d68f89",22856366,1,0,1,1656,440,440,0
"0380cd76a7d44bc3a4da1f15e4d68f89","23b7673c8b5443108c2ef09382834a86",22856366,1,2,0,1657,440,441,1
"23b7673c8b5443108c2ef09382834a86","23b7673c8b5443108c2ef09382834a86",22856366,2,0,1,1658,441,441,0
"23b7673c8b5443108c2ef09382834a86","901e92500aea43c79f19f1b279050668",22856366,2,2,0,1660,441,442,1
"901e92500aea43c79f19f1b279050668","23b7673c8b5443108c2ef09382834a86",22856366,1,-2,0,1661,442,441,-1
"901e92500aea43c79f19f1b279050668","001339db8ced4cf78829ebe8b145449d",22856366,1,1,0,1663,442,443,1
"001339db8ced4cf78829ebe8b145449d","001339db8ced4cf78829ebe8b145449d",22856366,11,0,1,1664,443,443,0
"001339db8ced4cf78829ebe8b145449d","452745e0366e42ae81561bfddebcc6c3",22856366,1,1,0,1675,443,444,1
"452745e0366e42ae81561bfddebcc6c3","452745e0366e42ae81561bfddebcc6c3",22856366,2,0,1,1676,444,444,0
"452745e0366e42ae81561bfddebcc6c3","4660ff2089114e8db82ceb26a4f329e3",22856366,1,2,0,1678,444,445,1
"4660ff2089114e8db82ceb26a4f329e3","901e92500aea43c79f19f1b279050668",22856366,1,-4,0,1679,445,442,-3
"901e92500aea43c79f19f1b279050668","4660ff2089114e8db82ceb26a4f329e3",22856366,1,4,0,1680,442,445,3
"4660ff2089114e8db82ceb26a4f329e3","4660ff2089114e8db82ceb26a4f329e3",22856366,1,0,1,1681,445,445,0
"4660ff2089114e8db82ceb26a4f329e3","7bd5586eb9d8484eb74a433ee7bfe499",22856366,1,2,0,1682,445,446,1
"7bd5586eb9d8484eb74a433ee7bfe499","7bd5586eb9d8484eb74a433ee7bfe499",22856366,16,0,1,1683,446,446,0
"7bd5586eb9d8484eb74a433ee7bfe499","070600601c4c439288445d2f0724807d",22856366,1,-14,0,1699,446,437,-9
"070600601c4c439288445d2f0724807d","b2f0d654738f48158edff28e8d3a546e",22856366,1,21,0,1700,437,449,12
"b2f0d654738f48158edff28e8d3a546e","f60ee41ec635499abd48168342d32c2f",22856366,6,5,0,1701,449,453,4
"f60ee41ec635499abd48168342d32c2f","f60ee41ec635499abd48168342d32c2f",22856366,77,0,1,1702,453,453,0
"f60ee41ec635499abd48168342d32c2f","b2f0d654738f48158edff28e8d3a546e",22856366,7,-5,0,1705,453,449,-4
"b2f0d654738f48158edff28e8d3a546e","f67fbf45a5f146ed866965bc57c7c001",22856366,3,8,0,1711,449,454,5
"f67fbf45a5f146ed866965bc57c7c001","b2f0d654738f48158edff28e8d3a546e",22856366,1,-8,0,1712,454,449,-5
"b2f0d654738f48158edff28e8d3a546e","9428d8bd9c5a47b2a235b254e5e27ded",22856366,1,4,0,1713,449,452,3
"9428d8bd9c5a47b2a235b254e5e27ded","f60ee41ec635499abd48168342d32c2f",22856366,2,1,0,1714,452,453,1
"b2f0d654738f48158edff28e8d3a546e","b2f0d654738f48158edff28e8d3a546e",22856366,1,0,1,1723,449,449,0
"f60ee41ec635499abd48168342d32c2f","9428d8bd9c5a47b2a235b254e5e27ded",22856366,1,-1,0,1733,453,452,-1
"f67fbf45a5f146ed866965bc57c7c001","f67fbf45a5f146ed866965bc57c7c001",22856366,2,0,1,1788,454,454,0
"f67fbf45a5f146ed866965bc57c7c001","d937afe49bd24a07a550dda1c1155122",22856366,1,1,0,1790,454,455,1
"d937afe49bd24a07a550dda1c1155122","d937afe49bd24a07a550dda1c1155122",22856366,1,0,1,1791,455,455,0
"d937afe49bd24a07a550dda1c1155122","3628b3f7823443d0912a339096b69943",22856366,1,1,0,1792,455,456,1
"3628b3f7823443d0912a339096b69943","3628b3f7823443d0912a339096b69943",22856366,1,0,1,1793,456,456,0
"3628b3f7823443d0912a339096b69943","9e049ee647cf43ecbcb5ed792a8e7588",22856366,1,1,0,1794,456,457,1
"9e049ee647cf43ecbcb5ed792a8e7588","9e049ee647cf43ecbcb5ed792a8e7588",22856366,1,0,1,1795,457,457,0
"9e049ee647cf43ecbcb5ed792a8e7588","5256a214faaf410b93f76cea06428334",22856366,1,1,0,1796,457,458,1
"5256a214faaf410b93f76cea06428334","5256a214faaf410b93f76cea06428334",22856366,1,0,1,1797,458,458,0
"5256a214faaf410b93f76cea06428334","25c32b120fce40fa9b6c85133aeb4716",22856366,1,1,0,1798,458,459,1
"25c32b120fce40fa9b6c85133aeb4716","25c32b120fce40fa9b6c85133aeb4716",22856366,1,0,1,1799,459,459,0
"25c32b120fce40fa9b6c85133aeb4716","11bc14f2204949008b7d511b933363c1",22856366,1,1,0,1800,459,460,1
"11bc14f2204949008b7d511b933363c1","11bc14f2204949008b7d511b933363c1",22856366,1,0,1,1801,460,460,0
"11bc14f2204949008b7d511b933363c1","42de338840a34d15adb66e7b14fb9d2c",22856366,1,1,0,1802,460,461,1
"42de338840a34d15adb66e7b14fb9d2c","42de338840a34d15adb66e7b14fb9d2c",22856366,3,0,1,1803,461,461,0
"42de338840a34d15adb66e7b14fb9d2c","9da37c6210b1416b8079c274f70bf600",22856366,1,1,0,1806,461,462,1
"9da37c6210b1416b8079c274f70bf600","9da37c6210b1416b8079c274f70bf600",22856366,1,0,1,1807,462,462,0
"9da37c6210b1416b8079c274f70bf600","519119f1deac45ff9ab4f13529be5c6e",22856366,1,1,0,1808,462,463,1
"519119f1deac45ff9ab4f13529be5c6e","519119f1deac45ff9ab4f13529be5c6e",22856366,3,0,1,1809,463,463,0
"519119f1deac45ff9ab4f13529be5c6e","f67fbf45a5f146ed866965bc57c7c001",22856366,1,-9,0,1812,463,454,-9
"f67fbf45a5f146ed866965bc57c7c001","c5df9f40ec14463b9dcfdc73df3e9285",22856366,1,12,0,1813,454,464,10
"c5df9f40ec14463b9dcfdc73df3e9285","b2f0d654738f48158edff28e8d3a546e",22856366,1,-20,0,1815,464,449,-15
"f67fbf45a5f146ed866965bc57c7c001","9afd71a5298d4333b6849dfce1b9422c",22856366,1,-612,0,1828,454,18,-436
"9afd71a5298d4333b6849dfce1b9422c","d4f45188d3c84a02ba08454e6403a818",22856366,1,9,0,1832,18,24,6
"d4c3b003e8274e429d2fa688d73fde6d","b7719e26494940efa49512aedd0aac79",22856366,3,-3,0,1834,22,20,-2
"afbf7250b99d47bea07172749483ca97","4e51676dc72045d99c19b9fa7b22f8bc",22856366,4,3,0,1838,28,29,1
"4e51676dc72045d99c19b9fa7b22f8bc","4e51676dc72045d99c19b9fa7b22f8bc",22856366,3,0,1,1839,29,29,0
"4e51676dc72045d99c19b9fa7b22f8bc","51970cfa30e643e894e66ae85c8024cc",22856366,4,3,0,1840,29,31,2
"51970cfa30e643e894e66ae85c8024cc","c33c17be71ae4d588da7369472e5bb1b",22856366,3,6,0,1841,31,34,3
"c33c17be71ae4d588da7369472e5bb1b","4e51676dc72045d99c19b9fa7b22f8bc",22856366,3,-9,0,1842,34,29,-5
"4e51676dc72045d99c19b9fa7b22f8bc","c33c17be71ae4d588da7369472e5bb1b",22856366,4,9,0,1843,29,34,5
"c33c17be71ae4d588da7369472e5bb1b","93679be414554a11b1893002f2229a93",22856366,4,3,0,1844,34,35,1
"93679be414554a11b1893002f2229a93","93679be414554a11b1893002f2229a93",22856366,3,0,1,1845,35,35,0
"93679be414554a11b1893002f2229a93","7040a13096d746ac84b8fac8d9752058",22856366,4,3,0,1846,35,36,1
"7040a13096d746ac84b8fac8d9752058","7040a13096d746ac84b8fac8d9752058",22856366,3,0,1,1847,36,36,0
"7040a13096d746ac84b8fac8d9752058","9a0dc646f934470daf08c4b56ccf73db",22856366,4,3,0,1848,36,37,1
"9a0dc646f934470daf08c4b56ccf73db","9a0dc646f934470daf08c4b56ccf73db",22856366,2,0,1,1849,37,37,0
"fc0e049d56024bc9a02c9a9c435c3df7","b613861cecf84ffcab01afb23f660475",22856366,1,-68,0,1851,38,1,-37
"b613861cecf84ffcab01afb23f660475","5c5ceeee4562457ba6d41515aeebfbb1",22856366,1,25,0,1853,1,17,16
"5c5ceeee4562457ba6d41515aeebfbb1","56586aa865414f538729c7f7735d2bc6",22856366,3,-10,0,1854,17,12,-5
"56586aa865414f538729c7f7735d2bc6","56586aa865414f538729c7f7735d2bc6",22856366,8,0,1,1855,12,12,0
"56586aa865414f538729c7f7735d2bc6","b7f2b31585d94eb3bf86376714aa7070",22856366,5,2,0,1857,12,13,1
"b7f2b31585d94eb3bf86376714aa7070","b7f2b31585d94eb3bf86376714aa7070",22856366,4,0,1,1858,13,13,0
"b7f2b31585d94eb3bf86376714aa7070","56586aa865414f538729c7f7735d2bc6",22856366,2,-2,0,1859,13,12,-1
"56586aa865414f538729c7f7735d2bc6","e2911e79efc2420eac45d9f671463d4b",22856366,2,-12,0,1861,12,2,-10
"e2911e79efc2420eac45d9f671463d4b","b613861cecf84ffcab01afb23f660475",22856366,4,-3,0,1863,2,1,-1
"b613861cecf84ffcab01afb23f660475","afbf7250b99d47bea07172749483ca97",22856366,1,44,0,1864,1,28,27
"51970cfa30e643e894e66ae85c8024cc","4e51676dc72045d99c19b9fa7b22f8bc",22856366,1,-3,0,1870,31,29,-2
"c33c17be71ae4d588da7369472e5bb1b","c33c17be71ae4d588da7369472e5bb1b",22856366,1,0,1,1872,34,34,0
"7040a13096d746ac84b8fac8d9752058","93679be414554a11b1893002f2229a93",22856366,1,-3,0,1875,36,35,-1
"93679be414554a11b1893002f2229a93","9a0dc646f934470daf08c4b56ccf73db",22856366,1,6,0,1876,35,37,2
"9a0dc646f934470daf08c4b56ccf73db","7040a13096d746ac84b8fac8d9752058",22856366,1,-3,0,1877,37,36,-1
"67a089198fcb4e1c8f2385786c2b296f","e2911e79efc2420eac45d9f671463d4b",22856366,1,-69,0,1885,39,2,-37
"b613861cecf84ffcab01afb23f660475","e2911e79efc2420eac45d9f671463d4b",22856366,4,3,0,1890,1,2,1
"e2911e79efc2420eac45d9f671463d4b","56586aa865414f538729c7f7735d2bc6",22856366,3,12,0,1891,2,12,10
"b7f2b31585d94eb3bf86376714aa7070","3f1c815879794b929260d224becaff7e",22856366,2,2,0,1897,13,14,1
"b613861cecf84ffcab01afb23f660475","b613861cecf84ffcab01afb23f660475",22856227,3,0,1,1,1,1,0
"b613861cecf84ffcab01afb23f660475","e2911e79efc2420eac45d9f671463d4b",22856227,3,3,0,3,1,2,1
"e2911e79efc2420eac45d9f671463d4b","b613861cecf84ffcab01afb23f660475",22856227,3,-3,0,4,2,1,-1
"b613861cecf84ffcab01afb23f660475","67a089198fcb4e1c8f2385786c2b296f",22856227,1,72,0,10,1,39,38
"67a089198fcb4e1c8f2385786c2b296f","e2911e79efc2420eac45d9f671463d4b",22856227,1,-69,0,11,39,2,-37
"e2911e79efc2420eac45d9f671463d4b","e2911e79efc2420eac45d9f671463d4b",22856227,3,0,1,12,2,2,0
"e2911e79efc2420eac45d9f671463d4b","519d1b8c59404d67b54e96c5c8a830b2",22856227,1,1,0,15,2,3,1
"519d1b8c59404d67b54e96c5c8a830b2","519d1b8c59404d67b54e96c5c8a830b2",22856227,1,0,1,16,3,3,0
"519d1b8c59404d67b54e96c5c8a830b2","531db53f81f646edb0cdcfe0085b03b7",22856227,1,1,0,17,3,4,1
"531db53f81f646edb0cdcfe0085b03b7","531db53f81f646edb0cdcfe0085b03b7",22856227,1,0,1,18,4,4,0
"531db53f81f646edb0cdcfe0085b03b7","4f5f94b2f95141e0a9d53a61da2276da",22856227,1,1,0,19,4,5,1
"4f5f94b2f95141e0a9d53a61da2276da","4f5f94b2f95141e0a9d53a61da2276da",22856227,1,0,1,20,5,5,0
"4f5f94b2f95141e0a9d53a61da2276da","6d541c89590949f99af293c4f2333f67",22856227,1,1,0,21,5,6,1
"6d541c89590949f99af293c4f2333f67","6d541c89590949f99af293c4f2333f67",22856227,1,0,1,22,6,6,0
"6d541c89590949f99af293c4f2333f67","dd5cf0b9fe4c4f1d8f5ff8e4c04879cb",22856227,1,1,0,23,6,7,1
"dd5cf0b9fe4c4f1d8f5ff8e4c04879cb","dd5cf0b9fe4c4f1d8f5ff8e4c04879cb",22856227,2,0,1,24,7,7,0
"dd5cf0b9fe4c4f1d8f5ff8e4c04879cb","f96261861edc426abe2248be4f0a709a",22856227,1,1,0,26,7,8,1
"f96261861edc426abe2248be4f0a709a","f96261861edc426abe2248be4f0a709a",22856227,2,0,1,27,8,8,0
"f96261861edc426abe2248be4f0a709a","b613861cecf84ffcab01afb23f660475",22856227,1,-9,0,29,8,1,-7
"b613861cecf84ffcab01afb23f660475","f96261861edc426abe2248be4f0a709a",22856227,1,9,0,30,1,8,7
"f96261861edc426abe2248be4f0a709a","e2911e79efc2420eac45d9f671463d4b",22856227,1,-6,0,31,8,2,-6
"e2911e79efc2420eac45d9f671463d4b","f96261861edc426abe2248be4f0a709a",22856227,1,6,0,32,2,8,6
"f96261861edc426abe2248be4f0a709a","66b5e16f4f75454fb5b8172079f0fa83",22856227,1,1,0,33,8,9,1
"66b5e16f4f75454fb5b8172079f0fa83","66b5e16f4f75454fb5b8172079f0fa83",22856227,1,0,1,34,9,9,0
"66b5e16f4f75454fb5b8172079f0fa83","0680571d4698477995e41842c36a54b2",22856227,1,1,0,35,9,10,1
"0680571d4698477995e41842c36a54b2","0680571d4698477995e41842c36a54b2",22856227,1,0,1,36,10,10,0
"0680571d4698477995e41842c36a54b2","9112f2bffece48e08c6d2287be204085",22856227,1,1,0,37,10,11,1
"9112f2bffece48e08c6d2287be204085","9112f2bffece48e08c6d2287be204085",22856227,2,0,1,38,11,11,0
"9112f2bffece48e08c6d2287be204085","e2911e79efc2420eac45d9f671463d4b",22856227,1,-9,0,40,11,2,-9
"e2911e79efc2420eac45d9f671463d4b","56586aa865414f538729c7f7735d2bc6",22856227,1,12,0,41,2,12,10
"56586aa865414f538729c7f7735d2bc6","56586aa865414f538729c7f7735d2bc6",22856227,1,0,1,42,12,12,0
"56586aa865414f538729c7f7735d2bc6","67a089198fcb4e1c8f2385786c2b296f",22856227,1,57,0,43,12,39,27
"64d48c6c9c7940639a932219a6c87198","64d48c6c9c7940639a932219a6c87198",22856227,1,0,1,45,40,40,0
"64d48c6c9c7940639a932219a6c87198","b534b89233134e30a9b5645138bfa9ee",22856227,1,3,0,46,40,41,1
"b534b89233134e30a9b5645138bfa9ee","67a089198fcb4e1c8f2385786c2b296f",22856227,1,-4,0,47,41,39,-2
"67a089198fcb4e1c8f2385786c2b296f","0e37b720d23b4e7f8b313e79313fd107",22856227,1,7,0,48,39,44,5
"0e37b720d23b4e7f8b313e79313fd107","0e37b720d23b4e7f8b313e79313fd107",22856227,2,0,1,49,44,44,0
"0e37b720d23b4e7f8b313e79313fd107","6875d67fdd5f48168b62719df449bebd",22856227,1,1,0,51,44,45,1
"6875d67fdd5f48168b62719df449bebd","6875d67fdd5f48168b62719df449bebd",22856227,1,0,1,52,45,45,0
"6875d67fdd5f48168b62719df449bebd","6e13d61a7bdb44bca949c9f86fab3be5",22856227,1,3,0,53,45,47,2
"6e13d61a7bdb44bca949c9f86fab3be5","b534b89233134e30a9b5645138bfa9ee",22856227,1,-7,0,54,47,41,-6
"b534b89233134e30a9b5645138bfa9ee","6e13d61a7bdb44bca949c9f86fab3be5",22856227,1,7,0,55,41,47,6
"6e13d61a7bdb44bca949c9f86fab3be5","195f78799f984cc2b06c48dfe36be751",22856227,1,2,0,56,47,49,2
"195f78799f984cc2b06c48dfe36be751","195f78799f984cc2b06c48dfe36be751",22856227,2,0,1,57,49,49,0
"195f78799f984cc2b06c48dfe36be751","d9c8d8c444a64dadbbb508652c721e17",22856227,1,-3,0,59,49,46,-3
"d9c8d8c444a64dadbbb508652c721e17","d0c74f735e024943943e40333d6d337f",22856227,1,6,0,60,46,51,5
"d0c74f735e024943943e40333d6d337f","d0c74f735e024943943e40333d6d337f",22856227,1,0,1,61,51,51,0
"d0c74f735e024943943e40333d6d337f","983f8ff320594b279a7f4a6fe132f9c5",22856227,1,2,0,62,51,53,2
"983f8ff320594b279a7f4a6fe132f9c5","983f8ff320594b279a7f4a6fe132f9c5",22856227,2,0,1,63,53,53,0
"983f8ff320594b279a7f4a6fe132f9c5","35adfa5d923046aebabfefd98f35ff05",22856227,1,1,0,65,53,54,1
"35adfa5d923046aebabfefd98f35ff05","35adfa5d923046aebabfefd98f35ff05",22856227,2,0,1,66,54,54,0
"35adfa5d923046aebabfefd98f35ff05","b6f8a98476224da1b40e555ececc7ed8",22856227,1,1,0,68,54,55,1
"b6f8a98476224da1b40e555ececc7ed8","b6f8a98476224da1b40e555ececc7ed8",22856227,2,0,1,69,55,55,0
"b6f8a98476224da1b40e555ececc7ed8","86e22cb5fe0e4b47a9489ecddf7ed78f",22856227,1,1,0,71,55,56,1
"86e22cb5fe0e4b47a9489ecddf7ed78f","86e22cb5fe0e4b47a9489ecddf7ed78f",22856227,2,0,1,72,56,56,0
"86e22cb5fe0e4b47a9489ecddf7ed78f","78f30e4dcac84e3cbea8b2cc6e0d62b3",22856227,1,4,0,74,56,59,3
"78f30e4dcac84e3cbea8b2cc6e0d62b3","a1f2f12debe5432fb7a70bcd12bacfb9",22856227,1,-1,0,75,59,58,-1
"a1f2f12debe5432fb7a70bcd12bacfb9","f924752d8a1149668870b1e7698486f7",22856227,1,-9,0,76,58,50,-8
"f924752d8a1149668870b1e7698486f7","a1f2f12debe5432fb7a70bcd12bacfb9",22856227,1,9,0,77,50,58,8
"a1f2f12debe5432fb7a70bcd12bacfb9","a1f2f12debe5432fb7a70bcd12bacfb9",22856227,15,0,1,78,58,58,0
"a1f2f12debe5432fb7a70bcd12bacfb9","78f30e4dcac84e3cbea8b2cc6e0d62b3",22856227,1,1,0,93,58,59,1
"78f30e4dcac84e3cbea8b2cc6e0d62b3","78f30e4dcac84e3cbea8b2cc6e0d62b3",22856227,11,0,1,100,59,59,0
"78f30e4dcac84e3cbea8b2cc6e0d62b3","12aa6e1672ac4e7aa6449a7a8609cd72",22856227,1,-2,0,105,59,57,-2
"12aa6e1672ac4e7aa6449a7a8609cd72","bc42d26810654ea9a1df1efe1e58c7d5",22856227,1,7,0,106,57,63,6
"bc42d26810654ea9a1df1efe1e58c7d5","a0a418b8540d479fa6e0f653b701da8b",22856227,1,1,0,107,63,64,1
"a0a418b8540d479fa6e0f653b701da8b","4c943503763e4e349906eea3ed3c8e86",22856227,1,-3,0,108,64,61,-3
"4c943503763e4e349906eea3ed3c8e86","4c943503763e4e349906eea3ed3c8e86",22856227,1,0,1,109,61,61,0
"4c943503763e4e349906eea3ed3c8e86","a0a418b8540d479fa6e0f653b701da8b",22856227,1,3,0,110,61,64,3
"a0a418b8540d479fa6e0f653b701da8b","a0a418b8540d479fa6e0f653b701da8b",22856227,3,0,1,111,64,64,0
"a0a418b8540d479fa6e0f653b701da8b","309ccf3cc4fe429d9bfbaef53d3fa479",22856227,1,-4,0,114,64,60,-4
"309ccf3cc4fe429d9bfbaef53d3fa479","b534b89233134e30a9b5645138bfa9ee",22856227,1,-23,0,115,60,41,-19
"b534b89233134e30a9b5645138bfa9ee","d646286c8051419bbc2e31dd1db55ca8",22856227,1,33,0,116,41,67,26
"d646286c8051419bbc2e31dd1db55ca8","267f883678b24aed855fde42524975d9",22856227,1,4,0,117,67,71,4
"267f883678b24aed855fde42524975d9","267f883678b24aed855fde42524975d9",22856227,1,0,1,118,71,71,0
"267f883678b24aed855fde42524975d9","88fff56d0342490dbef9040750a20f6c",22856227,1,1,0,119,71,72,1
"88fff56d0342490dbef9040750a20f6c","88fff56d0342490dbef9040750a20f6c",22856227,1,0,1,120,72,72,0
"88fff56d0342490dbef9040750a20f6c","adb17b12b66c4a49a85fd34322f7df70",22856227,1,1,0,121,72,73,1
"adb17b12b66c4a49a85fd34322f7df70","adb17b12b66c4a49a85fd34322f7df70",22856227,1,0,1,122,73,73,0
"adb17b12b66c4a49a85fd34322f7df70","a2becd407db34b189200a32546d9d569",22856227,1,3,0,123,73,75,2
"a2becd407db34b189200a32546d9d569","d646286c8051419bbc2e31dd1db55ca8",22856227,1,-9,0,124,75,67,-8
"d646286c8051419bbc2e31dd1db55ca8","a2becd407db34b189200a32546d9d569",22856227,1,9,0,125,67,75,8
"a2becd407db34b189200a32546d9d569","58c22b011d0f4c2ea6d13615edbb9eeb",22856227,1,2,0,126,75,77,2
"58c22b011d0f4c2ea6d13615edbb9eeb","58c22b011d0f4c2ea6d13615edbb9eeb",22856227,2,0,1,127,77,77,0
"58c22b011d0f4c2ea6d13615edbb9eeb","dd76e1861dc9461c830888729d091ee0",22856227,1,1,0,129,77,78,1
"dd76e1861dc9461c830888729d091ee0","dd76e1861dc9461c830888729d091ee0",22856227,5,0,1,130,78,78,0
"dd76e1861dc9461c830888729d091ee0","cd1d828f1a694b87913a7ea66c23803e",22856227,1,1,0,135,78,79,1
"cd1d828f1a694b87913a7ea66c23803e","cd1d828f1a694b87913a7ea66c23803e",22856227,2,0,1,136,79,79,0
"cd1d828f1a694b87913a7ea66c23803e","9176a3c2b4d2465fa8b0c67096c2a97e",22856227,1,1,0,138,79,80,1
"9176a3c2b4d2465fa8b0c67096c2a97e","9176a3c2b4d2465fa8b0c67096c2a97e",22856227,5,0,1,139,80,80,0
"9176a3c2b4d2465fa8b0c67096c2a97e","f8ec6445f7194e25b9101d4fbcb07a18",22856227,1,1,0,144,80,81,1
"f8ec6445f7194e25b9101d4fbcb07a18","f8ec6445f7194e25b9101d4fbcb07a18",22856227,2,0,1,145,81,81,0
"f8ec6445f7194e25b9101d4fbcb07a18","140d5b27b8574befad82c0a013b59dfa",22856227,1,-7,0,147,81,74,-7
"140d5b27b8574befad82c0a013b59dfa","d18a9ea32855445f8736581f5cb119ce",22856227,1,9,0,148,74,82,8
"d18a9ea32855445f8736581f5cb119ce","f564483cbd7a407681aa2fcca518cf5f",22856227,1,4,0,149,82,85,3
"f564483cbd7a407681aa2fcca518cf5f","f564483cbd7a407681aa2fcca518cf5f",22856227,6,0,1,150,85,85,0
"f564483cbd7a407681aa2fcca518cf5f","18fd01350bd5434ca636d59a599d768a",22856227,1,1,0,156,85,86,1
"18fd01350bd5434ca636d59a599d768a","18fd01350bd5434ca636d59a599d768a",22856227,9,0,1,157,86,86,0
"18fd01350bd5434ca636d59a599d768a","6a9f0ef185fb47f0937e29daa1c71ed5",22856227,1,5,0,166,86,90,4
"6a9f0ef185fb47f0937e29daa1c71ed5","ae5ac430ea254e708a6f5deaaf7464ae",22856227,1,-7,0,167,90,84,-6
"ae5ac430ea254e708a6f5deaaf7464ae","c681290961c94c4caf23b529d1ae6b9a",22856227,1,5,0,168,84,88,4
"c681290961c94c4caf23b529d1ae6b9a","c681290961c94c4caf23b529d1ae6b9a",22856227,1,0,1,169,88,88,0
"c681290961c94c4caf23b529d1ae6b9a","6a9f0ef185fb47f0937e29daa1c71ed5",22856227,1,2,0,170,88,90,2
"6a9f0ef185fb47f0937e29daa1c71ed5","6a9f0ef185fb47f0937e29daa1c71ed5",22856227,3,0,1,171,90,90,0
"6a9f0ef185fb47f0937e29daa1c71ed5","e20db35ced8544ddac5bc3839145e463",22856227,1,3,0,174,90,91,1
"e20db35ced8544ddac5bc3839145e463","d646286c8051419bbc2e31dd1db55ca8",22856227,1,-30,0,175,91,67,-24
"d646286c8051419bbc2e31dd1db55ca8","1febb706d7a34005ae8711ed49c76e64",22856227,1,33,0,176,67,94,27
"1febb706d7a34005ae8711ed49c76e64","1febb706d7a34005ae8711ed49c76e64",22856227,5,0,1,177,94,94,0
"1febb706d7a34005ae8711ed49c76e64","8f73ba6f5a0042f2850356ac38ac6f24",22856227,1,1,0,182,94,95,1
"8f73ba6f5a0042f2850356ac38ac6f24","8f73ba6f5a0042f2850356ac38ac6f24",22856227,5,0,1,183,95,95,0
"8f73ba6f5a0042f2850356ac38ac6f24","e2260b86653c46d7b14a41fb419dbf8c",22856227,1,1,0,188,95,96,1
"e2260b86653c46d7b14a41fb419dbf8c","e2260b86653c46d7b14a41fb419dbf8c",22856227,2,0,1,189,96,96,0
"e2260b86653c46d7b14a41fb419dbf8c","35eb641ad1d845bbba54915bce75a962",22856227,1,1,0,191,96,97,1
"35eb641ad1d845bbba54915bce75a962","35eb641ad1d845bbba54915bce75a962",22856227,5,0,1,192,97,97,0
"35eb641ad1d845bbba54915bce75a962","08be90ffbeea4795a138cd42ed8db56f",22856227,1,1,0,197,97,98,1
"08be90ffbeea4795a138cd42ed8db56f","08be90ffbeea4795a138cd42ed8db56f",22856227,5,0,1,198,98,98,0
"08be90ffbeea4795a138cd42ed8db56f","3007433c8f584dcbb5ac159c1c5f2be3",22856227,1,1,0,203,98,99,1
"3007433c8f584dcbb5ac159c1c5f2be3","3007433c8f584dcbb5ac159c1c5f2be3",22856227,6,0,1,204,99,99,0
"3007433c8f584dcbb5ac159c1c5f2be3","d391c8b6e56a43a7b654e9dee02d904b",22856227,1,5,0,210,99,103,4
"d391c8b6e56a43a7b654e9dee02d904b","00ae5f0c51874a73a41ebea838d95682",22856227,1,-2,0,211,103,101,-2
"00ae5f0c51874a73a41ebea838d95682","e20db35ced8544ddac5bc3839145e463",22856227,1,-11,0,212,101,91,-10
"e20db35ced8544ddac5bc3839145e463","00ae5f0c51874a73a41ebea838d95682",22856227,1,11,0,213,91,101,10
"00ae5f0c51874a73a41ebea838d95682","d391c8b6e56a43a7b654e9dee02d904b",22856227,1,2,0,214,101,103,2
"d391c8b6e56a43a7b654e9dee02d904b","d391c8b6e56a43a7b654e9dee02d904b",22856227,15,0,1,215,103,103,0
"d391c8b6e56a43a7b654e9dee02d904b","6111116566fc4fd9abba409322bea245",22856227,1,1,0,230,103,104,1
"6111116566fc4fd9abba409322bea245","6111116566fc4fd9abba409322bea245",22856227,2,0,1,231,104,104,0
"6111116566fc4fd9abba409322bea245","a81b2235cb9c499eb9ea8ee0a8dd9725",22856227,1,1,0,233,104,105,1
"a81b2235cb9c499eb9ea8ee0a8dd9725","a81b2235cb9c499eb9ea8ee0a8dd9725",22856227,2,0,1,234,105,105,0
"a81b2235cb9c499eb9ea8ee0a8dd9725","2d4e0ab0ef3b4d73b82c72d4621a7579",22856227,1,1,0,236,105,106,1
"2d4e0ab0ef3b4d73b82c72d4621a7579","2d4e0ab0ef3b4d73b82c72d4621a7579",22856227,2,0,1,237,106,106,0
"2d4e0ab0ef3b4d73b82c72d4621a7579","8bdebf492ebd4e62b0d522e8ab5e5197",22856227,1,1,0,239,106,107,1
"8bdebf492ebd4e62b0d522e8ab5e5197","8bdebf492ebd4e62b0d522e8ab5e5197",22856227,2,0,1,240,107,107,0
"8bdebf492ebd4e62b0d522e8ab5e5197","73039f8c1eb9409cb4caee2cf968001e",22856227,1,-7,0,242,107,100,-7
"73039f8c1eb9409cb4caee2cf968001e","4280927ec4d643238aa49c32f9e06c6c",22856227,1,10,0,243,100,109,9
"4280927ec4d643238aa49c32f9e06c6c","4280927ec4d643238aa49c32f9e06c6c",22856227,1,0,1,244,109,109,0
"4280927ec4d643238aa49c32f9e06c6c","fc44e6a5f7654430af1227838224dceb",22856227,1,2,0,245,109,111,2
"fc44e6a5f7654430af1227838224dceb","fc44e6a5f7654430af1227838224dceb",22856227,2,0,1,246,111,111,0
"fc44e6a5f7654430af1227838224dceb","08111f75e22d409998cf8b85bd431f0a",22856227,1,-3,0,248,111,108,-3
"08111f75e22d409998cf8b85bd431f0a","a9ae0a3c070d455bb4369a8996313336",22856227,1,7,0,249,108,114,6
"a9ae0a3c070d455bb4369a8996313336","a9ae0a3c070d455bb4369a8996313336",22856227,1,0,1,250,114,114,0
"a9ae0a3c070d455bb4369a8996313336","71cec822bcff4f30a20e75dc63ef7b65",22856227,1,2,0,251,114,116,2
"71cec822bcff4f30a20e75dc63ef7b65","71cec822bcff4f30a20e75dc63ef7b65",22856227,5,0,1,252,116,116,0
"71cec822bcff4f30a20e75dc63ef7b65","62bff51286ef4f348717a3cf6fe2318f",22856227,1,5,0,257,116,120,4
"62bff51286ef4f348717a3cf6fe2318f","37319e88176d4aefa91d7a9980dbae91",22856227,1,-9,0,258,120,112,-8
"37319e88176d4aefa91d7a9980dbae91","b1cd0e7dc3ad4a8eb91a4bfdbeb025b0",22856227,1,7,0,259,112,118,6
"b1cd0e7dc3ad4a8eb91a4bfdbeb025b0","b1cd0e7dc3ad4a8eb91a4bfdbeb025b0",22856227,1,0,1,260,118,118,0
"b1cd0e7dc3ad4a8eb91a4bfdbeb025b0","62bff51286ef4f348717a3cf6fe2318f",22856227,1,2,0,261,118,120,2
"62bff51286ef4f348717a3cf6fe2318f","62bff51286ef4f348717a3cf6fe2318f",22856227,3,0,1,262,120,120,0
"62bff51286ef4f348717a3cf6fe2318f","e20db35ced8544ddac5bc3839145e463",22856227,1,-33,0,265,120,91,-29
"e20db35ced8544ddac5bc3839145e463","779f9ddd1fd14d1e9e69f72219a1fdbd",22856227,1,36,0,266,91,121,30
"779f9ddd1fd14d1e9e69f72219a1fdbd","ae26e6cda8ad4a3f81bd347560d9579f",22856227,1,4,0,267,121,125,4
"ae26e6cda8ad4a3f81bd347560d9579f","ae26e6cda8ad4a3f81bd347560d9579f",22856227,3,0,1,268,125,125,0
"ae26e6cda8ad4a3f81bd347560d9579f","ee48df95832b4374aa273ceb27ec1315",22856227,1,1,0,271,125,126,1
"ee48df95832b4374aa273ceb27ec1315","ee48df95832b4374aa273ceb27ec1315",22856227,1,0,1,272,126,126,0
"ee48df95832b4374aa273ceb27ec1315","7a439da90b394756ad1777fc4c6dead5",22856227,1,1,0,273,126,127,1
"7a439da90b394756ad1777fc4c6dead5","7a439da90b394756ad1777fc4c6dead5",22856227,1,0,1,274,127,127,0
"7a439da90b394756ad1777fc4c6dead5","779f9ddd1fd14d1e9e69f72219a1fdbd",22856227,1,-6,0,275,127,121,-6
"779f9ddd1fd14d1e9e69f72219a1fdbd","a8dd5213034441ac92724b4e83eb0bb2",22856227,1,9,0,276,121,129,8
"a8dd5213034441ac92724b4e83eb0bb2","a8dd5213034441ac92724b4e83eb0bb2",22856227,1,0,1,277,129,129,0
"a8dd5213034441ac92724b4e83eb0bb2","8115eab6556b45f5b415c3b8c26a12e5",22856227,1,2,0,278,129,131,2
"8115eab6556b45f5b415c3b8c26a12e5","8115eab6556b45f5b415c3b8c26a12e5",22856227,2,0,1,279,131,131,0
"8115eab6556b45f5b415c3b8c26a12e5","ec34b06efd844b46a4c4818ecdb9b8f4",22856227,1,1,0,281,131,132,1
"ec34b06efd844b46a4c4818ecdb9b8f4","ec34b06efd844b46a4c4818ecdb9b8f4",22856227,5,0,1,282,132,132,0
"ec34b06efd844b46a4c4818ecdb9b8f4","c2e1c2b9eac64109b343a088584b576b",22856227,1,1,0,287,132,133,1
"c2e1c2b9eac64109b343a088584b576b","c2e1c2b9eac64109b343a088584b576b",22856227,2,0,1,288,133,133,0
"c2e1c2b9eac64109b343a088584b576b","579338175e0b4bbb8ef3b712b5d8b54e",22856227,1,-5,0,290,133,128,-5
"579338175e0b4bbb8ef3b712b5d8b54e","8bc5795d6a984a3eace4e2811e52dd4f",22856227,1,8,0,291,128,135,7
"8bc5795d6a984a3eace4e2811e52dd4f","8bc5795d6a984a3eace4e2811e52dd4f",22856227,1,0,1,292,135,135,0
"8bc5795d6a984a3eace4e2811e52dd4f","b416d47c56a742199b5d7c7f19d6503a",22856227,1,-1,0,293,135,134,-1
"b416d47c56a742199b5d7c7f19d6503a","df1de691dafe4549a18a4398ee9dfaf9",22856227,1,8,0,294,134,139,5
"df1de691dafe4549a18a4398ee9dfaf9","779f9ddd1fd14d1e9e69f72219a1fdbd",22856227,2,-23,0,295,139,121,-18
"779f9ddd1fd14d1e9e69f72219a1fdbd","6c5ad271a44743479bfaea29b1db8d02",22856227,1,27,0,296,121,143,22
"6c5ad271a44743479bfaea29b1db8d02","df1de691dafe4549a18a4398ee9dfaf9",22856227,1,-4,0,297,143,139,-4
"779f9ddd1fd14d1e9e69f72219a1fdbd","cd4532ad48034873ba8bce2aac0c9808",22856227,1,19,0,299,121,137,16
"cd4532ad48034873ba8bce2aac0c9808","cd4532ad48034873ba8bce2aac0c9808",22856227,1,0,1,300,137,137,0
"cd4532ad48034873ba8bce2aac0c9808","779f9ddd1fd14d1e9e69f72219a1fdbd",22856227,1,-19,0,301,137,121,-16
"779f9ddd1fd14d1e9e69f72219a1fdbd","df1de691dafe4549a18a4398ee9dfaf9",22856227,1,23,0,302,121,139,18
"df1de691dafe4549a18a4398ee9dfaf9","6c5ad271a44743479bfaea29b1db8d02",22856227,1,4,0,303,139,143,4
"6c5ad271a44743479bfaea29b1db8d02","6c5ad271a44743479bfaea29b1db8d02",22856227,2,0,1,304,143,143,0
"6c5ad271a44743479bfaea29b1db8d02","83d311bed5374fee83d8d67a7d9d82dc",22856227,1,1,0,306,143,144,1
"83d311bed5374fee83d8d67a7d9d82dc","83d311bed5374fee83d8d67a7d9d82dc",22856227,1,0,1,307,144,144,0
"83d311bed5374fee83d8d67a7d9d82dc","402bba41861d43acb52a5abb89e8831e",22856227,1,1,0,308,144,145,1
"402bba41861d43acb52a5abb89e8831e","402bba41861d43acb52a5abb89e8831e",22856227,5,0,1,309,145,145,0
"402bba41861d43acb52a5abb89e8831e","8aae34f5ddbb4052a709b12e6b0d40fa",22856227,1,3,0,314,145,147,2
"8aae34f5ddbb4052a709b12e6b0d40fa","df1de691dafe4549a18a4398ee9dfaf9",22856227,1,-9,0,315,147,139,-8
"df1de691dafe4549a18a4398ee9dfaf9","8aae34f5ddbb4052a709b12e6b0d40fa",22856227,1,9,0,316,139,147,8
"8aae34f5ddbb4052a709b12e6b0d40fa","8aae34f5ddbb4052a709b12e6b0d40fa",22856227,1,0,1,317,147,147,0
"8aae34f5ddbb4052a709b12e6b0d40fa","645b3f0249f64f76af2e19eb4d0e55b7",22856227,1,2,0,318,147,149,2
"645b3f0249f64f76af2e19eb4d0e55b7","645b3f0249f64f76af2e19eb4d0e55b7",22856227,8,0,1,319,149,149,0
"645b3f0249f64f76af2e19eb4d0e55b7","7e7b8db5064d4369805ab370aac5ddfb",22856227,1,1,0,327,149,150,1
"7e7b8db5064d4369805ab370aac5ddfb","7e7b8db5064d4369805ab370aac5ddfb",22856227,2,0,1,328,150,150,0
"7e7b8db5064d4369805ab370aac5ddfb","8956d210ae7f41968fada86d4c979d6a",22856227,1,1,0,330,150,151,1
"8956d210ae7f41968fada86d4c979d6a","8956d210ae7f41968fada86d4c979d6a",22856227,2,0,1,331,151,151,0
"8956d210ae7f41968fada86d4c979d6a","f902b0f41b544d4dbf79664fd233648d",22856227,1,-5,0,333,151,146,-5
"f902b0f41b544d4dbf79664fd233648d","ae781e8b775e4ccd93bc800dad5c8376",22856227,1,8,0,334,146,153,7
"ae781e8b775e4ccd93bc800dad5c8376","ae781e8b775e4ccd93bc800dad5c8376",22856227,2,0,1,335,153,153,0
"ae781e8b775e4ccd93bc800dad5c8376","06882a8492d9499aa31555567f575ecb",22856227,1,1,0,337,153,154,1
"06882a8492d9499aa31555567f575ecb","06882a8492d9499aa31555567f575ecb",22856227,1,0,1,338,154,154,0
"06882a8492d9499aa31555567f575ecb","f293c508f409466a8f27ddd7d1e40b20",22856227,1,1,0,339,154,155,1
"f293c508f409466a8f27ddd7d1e40b20","f293c508f409466a8f27ddd7d1e40b20",22856227,9,0,1,340,155,155,0
"f293c508f409466a8f27ddd7d1e40b20","cc4ddef5bbbe48ebb605141b347c4ed1",22856227,1,1,0,349,155,156,1
"cc4ddef5bbbe48ebb605141b347c4ed1","cc4ddef5bbbe48ebb605141b347c4ed1",22856227,5,0,1,350,156,156,0
"cc4ddef5bbbe48ebb605141b347c4ed1","d313cec988a84645bee413e8d4724a4b",22856227,1,3,0,355,156,158,2
"d313cec988a84645bee413e8d4724a4b","f03480cf4eba413194d7af52fc0e7f28",22856227,1,-7,0,356,158,152,-6
"f03480cf4eba413194d7af52fc0e7f28","d313cec988a84645bee413e8d4724a4b",22856227,1,7,0,357,152,158,6
"d313cec988a84645bee413e8d4724a4b","d313cec988a84645bee413e8d4724a4b",22856227,3,0,1,358,158,158,0
"d313cec988a84645bee413e8d4724a4b","dc60696c76a74368a60f72246e47700d",22856227,1,1,0,361,158,159,1
"dc60696c76a74368a60f72246e47700d","dc60696c76a74368a60f72246e47700d",22856227,1,0,1,362,159,159,0
"dc60696c76a74368a60f72246e47700d","df1de691dafe4549a18a4398ee9dfaf9",22856227,1,-23,0,363,159,139,-20
"df1de691dafe4549a18a4398ee9dfaf9","78adeee1fa2c4fe0bc73f7bca9fcee86",22856227,1,26,0,364,139,160,21
"78adeee1fa2c4fe0bc73f7bca9fcee86","65202579580f4ad38d734b4ee39d22a8",22856227,4,5,0,365,160,164,4
"65202579580f4ad38d734b4ee39d22a8","65202579580f4ad38d734b4ee39d22a8",22856227,71,0,1,366,164,164,0
"65202579580f4ad38d734b4ee39d22a8","78adeee1fa2c4fe0bc73f7bca9fcee86",22856227,1,-5,0,368,164,160,-4
"65202579580f4ad38d734b4ee39d22a8","3cbcea2be0984e7dbd5a48195af10ce7",22856227,2,3,0,400,164,165,1
"3cbcea2be0984e7dbd5a48195af10ce7","78adeee1fa2c4fe0bc73f7bca9fcee86",22856227,2,-8,0,401,165,160,-5
"78adeee1fa2c4fe0bc73f7bca9fcee86","82e6285962b8400d9d6fc32436022a94",22856227,2,10,0,402,160,167,7
"82e6285962b8400d9d6fc32436022a94","67a089198fcb4e1c8f2385786c2b296f",22856227,1,-162,0,403,167,39,-128
"67a089198fcb4e1c8f2385786c2b296f","64d48c6c9c7940639a932219a6c87198",22856227,4,1,0,404,39,40,1
"64d48c6c9c7940639a932219a6c87198","78adeee1fa2c4fe0bc73f7bca9fcee86",22856227,1,151,0,405,40,160,120
"65202579580f4ad38d734b4ee39d22a8","0c7262dff33c4087bc660ccf40f92f9c",22856227,1,12,0,415,164,169,5
"0c7262dff33c4087bc660ccf40f92f9c","b2275c3fad834f8d90737a2d9a6927d6",22856227,5,3,0,416,169,172,3
"b2275c3fad834f8d90737a2d9a6927d6","b7719e26494940efa49512aedd0aac79",22856227,1,-212,0,417,172,20,-152
"b7719e26494940efa49512aedd0aac79","b7719e26494940efa49512aedd0aac79",22856227,2,0,1,418,20,20,0
"b7719e26494940efa49512aedd0aac79","afbf7250b99d47bea07172749483ca97",22856227,2,12,0,419,20,28,8
"afbf7250b99d47bea07172749483ca97","afbf7250b99d47bea07172749483ca97",22856227,1,0,1,420,28,28,0
"afbf7250b99d47bea07172749483ca97","4e51676dc72045d99c19b9fa7b22f8bc",22856227,1,3,0,421,28,29,1
"4e51676dc72045d99c19b9fa7b22f8bc","4e51676dc72045d99c19b9fa7b22f8bc",22856227,1,0,1,422,29,29,0
"4e51676dc72045d99c19b9fa7b22f8bc","51970cfa30e643e894e66ae85c8024cc",22856227,1,3,0,423,29,31,2
"51970cfa30e643e894e66ae85c8024cc","c33c17be71ae4d588da7369472e5bb1b",22856227,1,6,0,424,31,34,3
"c33c17be71ae4d588da7369472e5bb1b","4e51676dc72045d99c19b9fa7b22f8bc",22856227,1,-9,0,425,34,29,-5
"4e51676dc72045d99c19b9fa7b22f8bc","c33c17be71ae4d588da7369472e5bb1b",22856227,1,9,0,426,29,34,5
"c33c17be71ae4d588da7369472e5bb1b","93679be414554a11b1893002f2229a93",22856227,1,3,0,427,34,35,1
"93679be414554a11b1893002f2229a93","93679be414554a11b1893002f2229a93",22856227,2,0,1,428,35,35,0
"93679be414554a11b1893002f2229a93","7040a13096d746ac84b8fac8d9752058",22856227,2,3,0,429,35,36,1
"7040a13096d746ac84b8fac8d9752058","7040a13096d746ac84b8fac8d9752058",22856227,2,0,1,430,36,36,0
"7040a13096d746ac84b8fac8d9752058","93679be414554a11b1893002f2229a93",22856227,1,-3,0,431,36,35,-1
"7040a13096d746ac84b8fac8d9752058","9a0dc646f934470daf08c4b56ccf73db",22856227,1,3,0,435,36,37,1
"9a0dc646f934470daf08c4b56ccf73db","9a0dc646f934470daf08c4b56ccf73db",22856227,1,0,1,436,37,37,0
"9a0dc646f934470daf08c4b56ccf73db","fc0e049d56024bc9a02c9a9c435c3df7",22856227,1,3,0,437,37,38,1
"fc0e049d56024bc9a02c9a9c435c3df7","fc0e049d56024bc9a02c9a9c435c3df7",22856227,2,0,1,438,38,38,0
"fc0e049d56024bc9a02c9a9c435c3df7","67a089198fcb4e1c8f2385786c2b296f",22856227,2,4,0,440,38,39,1
"67a089198fcb4e1c8f2385786c2b296f","fc0e049d56024bc9a02c9a9c435c3df7",22856227,1,-4,0,441,39,38,-1
"67a089198fcb4e1c8f2385786c2b296f","67a089198fcb4e1c8f2385786c2b296f",22856227,1,0,1,443,39,39,0
"64d48c6c9c7940639a932219a6c87198","b7719e26494940efa49512aedd0aac79",22856227,1,-41,0,445,40,20,-20
"afbf7250b99d47bea07172749483ca97","67a089198fcb4e1c8f2385786c2b296f",22856227,1,28,0,448,28,39,11
"64d48c6c9c7940639a932219a6c87198","3cbcea2be0984e7dbd5a48195af10ce7",22856227,1,159,0,450,40,165,125
"3cbcea2be0984e7dbd5a48195af10ce7","82e6285962b8400d9d6fc32436022a94",22856227,1,2,0,451,165,167,2
"82e6285962b8400d9d6fc32436022a94","3cbcea2be0984e7dbd5a48195af10ce7",22856227,1,-2,0,452,167,165,-2
"3cbcea2be0984e7dbd5a48195af10ce7","a9ac840f098c4bd0a2ee896214ce29cd",22856227,2,5,0,453,165,168,3
"a9ac840f098c4bd0a2ee896214ce29cd","a9ac840f098c4bd0a2ee896214ce29cd",22856227,2,0,1,454,168,168,0
"a9ac840f098c4bd0a2ee896214ce29cd","0c7262dff33c4087bc660ccf40f92f9c",22856227,3,4,0,455,168,169,1
"b2275c3fad834f8d90737a2d9a6927d6","a9ac840f098c4bd0a2ee896214ce29cd",22856227,1,-7,0,457,172,168,-4
"b2275c3fad834f8d90737a2d9a6927d6","78adeee1fa2c4fe0bc73f7bca9fcee86",22856227,1,-20,0,461,172,160,-12
"82e6285962b8400d9d6fc32436022a94","a9ac840f098c4bd0a2ee896214ce29cd",22856227,1,3,0,497,167,168,1
"a9ac840f098c4bd0a2ee896214ce29cd","3cbcea2be0984e7dbd5a48195af10ce7",22856227,1,-5,0,498,168,165,-3
"b2275c3fad834f8d90737a2d9a6927d6","0c7262dff33c4087bc660ccf40f92f9c",22856227,1,-3,0,502,172,169,-3
"b2275c3fad834f8d90737a2d9a6927d6","b2275c3fad834f8d90737a2d9a6927d6",22856227,30,0,1,504,172,172,0
"b2275c3fad834f8d90737a2d9a6927d6","eb515a26030b41f8a82a1e6114420bad",22856227,1,1,0,534,172,173,1
"eb515a26030b41f8a82a1e6114420bad","eb515a26030b41f8a82a1e6114420bad",22856227,2,0,1,535,173,173,0
"eb515a26030b41f8a82a1e6114420bad","0c7262dff33c4087bc660ccf40f92f9c",22856227,1,-4,0,537,173,169,-4
"0c7262dff33c4087bc660ccf40f92f9c","b42cc17b7de840f181a704558d0bc845",22856227,1,7,0,538,169,175,6
"b42cc17b7de840f181a704558d0bc845","b42cc17b7de840f181a704558d0bc845",22856227,2,0,1,539,175,175,0
"b42cc17b7de840f181a704558d0bc845","ea38cc0e6e6e41edbabf210220808bf9",22856227,1,5,0,541,175,179,4
"ea38cc0e6e6e41edbabf210220808bf9","362fcb0699a14845ab29b2340093e528",22856227,1,-6,0,542,179,174,-5
"362fcb0699a14845ab29b2340093e528","b87c552dd247427abe6ab5795b9c9d43",22856227,1,8,0,543,174,181,7
"b87c552dd247427abe6ab5795b9c9d43","ea38cc0e6e6e41edbabf210220808bf9",22856227,1,-2,0,544,181,179,-2
"ea38cc0e6e6e41edbabf210220808bf9","ea38cc0e6e6e41edbabf210220808bf9",22856227,2,0,1,545,179,179,0
"ea38cc0e6e6e41edbabf210220808bf9","b87c552dd247427abe6ab5795b9c9d43",22856227,1,2,0,547,179,181,2
"b87c552dd247427abe6ab5795b9c9d43","b87c552dd247427abe6ab5795b9c9d43",22856227,25,0,1,548,181,181,0
"b87c552dd247427abe6ab5795b9c9d43","139b097acfca451689d80c9c6eebdf7b",22856227,1,-3,0,573,181,178,-3
"139b097acfca451689d80c9c6eebdf7b","30f660a1feb34582a739722532524f79",22856227,1,6,0,574,178,183,5
"30f660a1feb34582a739722532524f79","30f660a1feb34582a739722532524f79",22856227,6,0,1,575,183,183,0
"30f660a1feb34582a739722532524f79","2024b4885bd14338a39b7b509acbbd02",22856227,1,-1,0,581,183,182,-1
"2024b4885bd14338a39b7b509acbbd02","c3f63fe50d8e487c86bf8ef76c9cadd3",22856227,1,4,0,582,182,185,3
"c3f63fe50d8e487c86bf8ef76c9cadd3","c3f63fe50d8e487c86bf8ef76c9cadd3",22856227,1,0,1,583,185,185,0
"c3f63fe50d8e487c86bf8ef76c9cadd3","0c7262dff33c4087bc660ccf40f92f9c",22856227,1,-20,0,584,185,169,-16
"0c7262dff33c4087bc660ccf40f92f9c","c8e371568a0c4391b25796ae4e91952e",22856227,2,23,0,585,169,186,17
"c8e371568a0c4391b25796ae4e91952e","7d932b23e1c84326ae5aa4d3c0d813d1",22856227,2,2,0,586,186,188,2
"7d932b23e1c84326ae5aa4d3c0d813d1","7d932b23e1c84326ae5aa4d3c0d813d1",22856227,2,0,1,587,188,188,0
"7d932b23e1c84326ae5aa4d3c0d813d1","c8e371568a0c4391b25796ae4e91952e",22856227,2,-2,0,588,188,186,-2
"c8e371568a0c4391b25796ae4e91952e","ab11d94c6c8948ea90b88f19d2cd502b",22856227,2,5,0,589,186,190,4
"ab11d94c6c8948ea90b88f19d2cd502b","ab11d94c6c8948ea90b88f19d2cd502b",22856227,3,0,1,590,190,190,0
"ab11d94c6c8948ea90b88f19d2cd502b","f992451ed6ad4e68bb9e68ad6be7c4be",22856227,1,2,0,593,190,192,2
"f992451ed6ad4e68bb9e68ad6be7c4be","f992451ed6ad4e68bb9e68ad6be7c4be",22856227,4,0,1,594,192,192,0
"f992451ed6ad4e68bb9e68ad6be7c4be","6cd2dcaac46847d4a0bc53f296d90375",22856227,1,3,0,598,192,194,2
"6cd2dcaac46847d4a0bc53f296d90375","07b44a7a51e94c78b411c753fc39dab0",22856227,1,-6,0,599,194,189,-5
"07b44a7a51e94c78b411c753fc39dab0","6cd2dcaac46847d4a0bc53f296d90375",22856227,2,6,0,600,189,194,5
"6cd2dcaac46847d4a0bc53f296d90375","6cd2dcaac46847d4a0bc53f296d90375",22856227,1,0,1,601,194,194,0
"6cd2dcaac46847d4a0bc53f296d90375","2d2580c9411c4972909db508d6956a58",22856227,1,2,0,602,194,196,2
"2d2580c9411c4972909db508d6956a58","2d2580c9411c4972909db508d6956a58",22856227,5,0,1,603,196,196,0
"2d2580c9411c4972909db508d6956a58","5bddb3d9ed264f3984702f048c7e5340",22856227,1,1,0,608,196,197,1
"5bddb3d9ed264f3984702f048c7e5340","5bddb3d9ed264f3984702f048c7e5340",22856227,2,0,1,609,197,197,0
"5bddb3d9ed264f3984702f048c7e5340","d5e8e2bd12a2466b9d6d90855f0eb079",22856227,1,1,0,611,197,198,1
"d5e8e2bd12a2466b9d6d90855f0eb079","d5e8e2bd12a2466b9d6d90855f0eb079",22856227,4,0,1,612,198,198,0
"d5e8e2bd12a2466b9d6d90855f0eb079","017d7ca8e0394b91aaadc9574df2202c",22856227,2,-5,0,614,198,193,-5
"017d7ca8e0394b91aaadc9574df2202c","bb329d880ab54120adaf203a693bb203",22856227,2,11,0,615,193,203,10
"bb329d880ab54120adaf203a693bb203","bb329d880ab54120adaf203a693bb203",22856227,2,0,1,616,203,203,0
"bb329d880ab54120adaf203a693bb203","54e8e9f0ea3e45c4bf3b8ac799ee31b1",22856227,1,-3,0,617,203,200,-3
"54e8e9f0ea3e45c4bf3b8ac799ee31b1","54e8e9f0ea3e45c4bf3b8ac799ee31b1",22856227,1,0,1,618,200,200,0
"54e8e9f0ea3e45c4bf3b8ac799ee31b1","c614a00911be4877a075f19315530fb0",22856227,1,1,0,619,200,201,1
"c614a00911be4877a075f19315530fb0","c614a00911be4877a075f19315530fb0",22856227,6,0,1,620,201,201,0
"c614a00911be4877a075f19315530fb0","a6c21bd8b95249c7972820a7a7d76aff",22856227,1,1,0,626,201,202,1
"a6c21bd8b95249c7972820a7a7d76aff","a6c21bd8b95249c7972820a7a7d76aff",22856227,1,0,1,627,202,202,0
"a6c21bd8b95249c7972820a7a7d76aff","bb329d880ab54120adaf203a693bb203",22856227,1,1,0,628,202,203,1
"bb329d880ab54120adaf203a693bb203","0c7262dff33c4087bc660ccf40f92f9c",22856227,1,-43,0,629,203,169,-34
"ab11d94c6c8948ea90b88f19d2cd502b","07b44a7a51e94c78b411c753fc39dab0",22856227,1,-1,0,636,190,189,-1
"6cd2dcaac46847d4a0bc53f296d90375","017d7ca8e0394b91aaadc9574df2202c",22856227,1,-1,0,638,194,193,-1
"017d7ca8e0394b91aaadc9574df2202c","f9170dd6bc6442b4acd832747609b09a",22856227,1,7,0,639,193,199,6
"f9170dd6bc6442b4acd832747609b09a","6cd2dcaac46847d4a0bc53f296d90375",22856227,1,-6,0,640,199,194,-5
"6cd2dcaac46847d4a0bc53f296d90375","d5e8e2bd12a2466b9d6d90855f0eb079",22856227,1,4,0,641,194,198,4
"bb329d880ab54120adaf203a693bb203","f9170dd6bc6442b4acd832747609b09a",22856227,1,-4,0,647,203,199,-4
"f9170dd6bc6442b4acd832747609b09a","334c2344009840079b1d0e1b7ce3d5a7",22856227,2,7,0,648,199,205,6
"334c2344009840079b1d0e1b7ce3d5a7","334c2344009840079b1d0e1b7ce3d5a7",22856227,2,0,1,649,205,205,0
"334c2344009840079b1d0e1b7ce3d5a7","b54257a550b94ebc9538f3a90eee9d7e",22856227,1,-1,0,650,205,204,-1
"b54257a550b94ebc9538f3a90eee9d7e","f9170dd6bc6442b4acd832747609b09a",22856227,1,-6,0,651,204,199,-5
"334c2344009840079b1d0e1b7ce3d5a7","c8e371568a0c4391b25796ae4e91952e",22856227,1,-23,0,653,205,186,-19
"c8e371568a0c4391b25796ae4e91952e","334c2344009840079b1d0e1b7ce3d5a7",22856227,1,23,0,654,186,205,19
"334c2344009840079b1d0e1b7ce3d5a7","d7f13c8d63ec4e2aa673fbb9cf9c6933",22856227,1,3,0,656,205,206,1
"d7f13c8d63ec4e2aa673fbb9cf9c6933","c8e371568a0c4391b25796ae4e91952e",22856227,1,-26,0,657,206,186,-20
"c8e371568a0c4391b25796ae4e91952e","7108f0e4c2584f1f9c471689ae4c885c",22856227,1,28,0,658,186,208,22
"7108f0e4c2584f1f9c471689ae4c885c","b9e80f77c3a44349863b19875725c384",22856227,1,-1,0,659,208,207,-1
"b9e80f77c3a44349863b19875725c384","b9e80f77c3a44349863b19875725c384",22856227,34,0,1,660,207,207,0
"b9e80f77c3a44349863b19875725c384","7108f0e4c2584f1f9c471689ae4c885c",22856227,2,1,0,694,207,208,1
"7108f0e4c2584f1f9c471689ae4c885c","7108f0e4c2584f1f9c471689ae4c885c",22856227,44,0,1,695,208,208,0
"7108f0e4c2584f1f9c471689ae4c885c","09400e101c5d4b439cf9a26b03aae558",22856227,2,3,0,739,208,210,2
"09400e101c5d4b439cf9a26b03aae558","d7f13c8d63ec4e2aa673fbb9cf9c6933",22856227,2,-5,0,740,210,206,-4
"d7f13c8d63ec4e2aa673fbb9cf9c6933","a875096404ef4a9984b62d74cda916f9",22856227,1,4,0,741,206,209,3
"a875096404ef4a9984b62d74cda916f9","b9e80f77c3a44349863b19875725c384",22856227,1,-3,0,742,209,207,-2
"d7f13c8d63ec4e2aa673fbb9cf9c6933","09400e101c5d4b439cf9a26b03aae558",22856227,1,5,0,746,206,210,4
"09400e101c5d4b439cf9a26b03aae558","09400e101c5d4b439cf9a26b03aae558",22856227,4,0,1,747,210,210,0
"09400e101c5d4b439cf9a26b03aae558","a88efa7e50ce47159810ab553afa6d3a",22856227,1,2,0,751,210,212,2
"a88efa7e50ce47159810ab553afa6d3a","a88efa7e50ce47159810ab553afa6d3a",22856227,2,0,1,752,212,212,0
"a88efa7e50ce47159810ab553afa6d3a","a875096404ef4a9984b62d74cda916f9",22856227,1,-3,0,754,212,209,-3
"a875096404ef4a9984b62d74cda916f9","be502a7a43c44bf7b682698de79d9369",22856227,1,6,0,755,209,214,5
"be502a7a43c44bf7b682698de79d9369","f7fb1952f56b4189b86a9f8b7862d2b8",22856227,2,1,0,756,214,215,1
"f7fb1952f56b4189b86a9f8b7862d2b8","be502a7a43c44bf7b682698de79d9369",22856227,1,-1,0,757,215,214,-1
"be502a7a43c44bf7b682698de79d9369","be502a7a43c44bf7b682698de79d9369",22856227,1,0,1,758,214,214,0
"f7fb1952f56b4189b86a9f8b7862d2b8","f7fb1952f56b4189b86a9f8b7862d2b8",22856227,11,0,1,760,215,215,0
"f7fb1952f56b4189b86a9f8b7862d2b8","b860ee85d8bc4a2f97958cfb71be3533",22856227,1,1,0,771,215,216,1
"b860ee85d8bc4a2f97958cfb71be3533","b860ee85d8bc4a2f97958cfb71be3533",22856227,2,0,1,772,216,216,0
"b860ee85d8bc4a2f97958cfb71be3533","ec341f459285443b8361f7f15638ff08",22856227,1,-3,0,774,216,213,-3
"ec341f459285443b8361f7f15638ff08","363837c182e04711840d896ae1e0339c",22856227,1,6,0,775,213,218,5
"363837c182e04711840d896ae1e0339c","363837c182e04711840d896ae1e0339c",22856227,12,0,1,776,218,218,0
"363837c182e04711840d896ae1e0339c","01b2051f8941460d89945e3b02d1ce78",22856227,1,-1,0,788,218,217,-1
"01b2051f8941460d89945e3b02d1ce78","91125ca626c5470eb145501f8c37f8db",22856227,1,4,0,789,217,220,3
"91125ca626c5470eb145501f8c37f8db","91125ca626c5470eb145501f8c37f8db",22856227,1,0,1,790,220,220,0
"91125ca626c5470eb145501f8c37f8db","1c6721b1f63f4d30ba7746ea8af02a52",22856227,1,3,0,791,220,221,1
"1c6721b1f63f4d30ba7746ea8af02a52","d7f13c8d63ec4e2aa673fbb9cf9c6933",22856227,1,-21,0,792,221,206,-15
"d7f13c8d63ec4e2aa673fbb9cf9c6933","77ecef8eff6b4a2caea7707669bf7475",22856227,1,22,0,793,206,222,16
"77ecef8eff6b4a2caea7707669bf7475","77ecef8eff6b4a2caea7707669bf7475",22856227,14,0,1,794,222,222,0
"77ecef8eff6b4a2caea7707669bf7475","1c6721b1f63f4d30ba7746ea8af02a52",22856227,1,-1,0,808,222,221,-1
"1c6721b1f63f4d30ba7746ea8af02a52","d03cb855c70044cf8c35d9ec0de696e3",22856227,1,4,0,809,221,224,3
"d03cb855c70044cf8c35d9ec0de696e3","8b9ae98743bd4d4a8a87dff1c1244211",22856227,1,3,0,810,224,227,3
"8b9ae98743bd4d4a8a87dff1c1244211","d03cb855c70044cf8c35d9ec0de696e3",22856227,1,-3,0,811,227,224,-3
"d03cb855c70044cf8c35d9ec0de696e3","d03cb855c70044cf8c35d9ec0de696e3",22856227,3,0,1,812,224,224,0
"d03cb855c70044cf8c35d9ec0de696e3","a49a937d6896486d9a5396654abcf2e1",22856227,1,2,0,815,224,226,2
"a49a937d6896486d9a5396654abcf2e1","a49a937d6896486d9a5396654abcf2e1",22856227,3,0,1,816,226,226,0
"a49a937d6896486d9a5396654abcf2e1","8b9ae98743bd4d4a8a87dff1c1244211",22856227,1,1,0,819,226,227,1
"8b9ae98743bd4d4a8a87dff1c1244211","8b9ae98743bd4d4a8a87dff1c1244211",22856227,39,0,1,820,227,227,0
"8b9ae98743bd4d4a8a87dff1c1244211","f7906d6f59b9489a91d2ef40db5a474d",22856227,1,-4,0,859,227,223,-4
"f7906d6f59b9489a91d2ef40db5a474d","2ab1535aac1346ba8801535bf729ef37",22856227,1,7,0,860,223,229,6
"2ab1535aac1346ba8801535bf729ef37","2ab1535aac1346ba8801535bf729ef37",22856227,8,0,1,861,229,229,0
"2ab1535aac1346ba8801535bf729ef37","a4f40fb48a8542c8949bae1f002cd9bc",22856227,1,2,0,869,229,231,2
"a4f40fb48a8542c8949bae1f002cd9bc","a4f40fb48a8542c8949bae1f002cd9bc",22856227,2,0,1,870,231,231,0
"a4f40fb48a8542c8949bae1f002cd9bc","8972c23e32044edb8a78fa1eed4e5947",22856227,1,1,0,872,231,232,1
"8972c23e32044edb8a78fa1eed4e5947","8972c23e32044edb8a78fa1eed4e5947",22856227,3,0,1,873,232,232,0
"8972c23e32044edb8a78fa1eed4e5947","92feb4a40f8344d38b6f722e42a53295",22856227,1,1,0,876,232,233,1
"92feb4a40f8344d38b6f722e42a53295","92feb4a40f8344d38b6f722e42a53295",22856227,2,0,1,877,233,233,0
"92feb4a40f8344d38b6f722e42a53295","5152833676bf4c6cb317060be10f68db",22856227,1,-5,0,879,233,228,-5
"5152833676bf4c6cb317060be10f68db","ca3e28f290354c08aefe5b0f769604e6",22856227,1,8,0,880,228,235,7
"ca3e28f290354c08aefe5b0f769604e6","ca3e28f290354c08aefe5b0f769604e6",22856227,9,0,1,881,235,235,0
"ca3e28f290354c08aefe5b0f769604e6","79a35eea833e4c2c9d22fc53c3c6445c",22856227,1,1,0,890,235,236,1
"79a35eea833e4c2c9d22fc53c3c6445c","79a35eea833e4c2c9d22fc53c3c6445c",22856227,9,0,1,891,236,236,0
"79a35eea833e4c2c9d22fc53c3c6445c","cab89fa5c3ed45a5aa550fc0352d6a42",22856227,1,2,0,900,236,238,2
"cab89fa5c3ed45a5aa550fc0352d6a42","cab89fa5c3ed45a5aa550fc0352d6a42",22856227,3,0,1,901,238,238,0
"cab89fa5c3ed45a5aa550fc0352d6a42","8f68228b1518449e9615cdafee41a2bd",22856227,1,-1,0,904,238,237,-1
"8f68228b1518449e9615cdafee41a2bd","8f68228b1518449e9615cdafee41a2bd",22856227,1,0,1,905,237,237,0
"8f68228b1518449e9615cdafee41a2bd","66d4fad4f1cf4b46be0750a99ad7a35a",22856227,1,2,0,906,237,239,2
"66d4fad4f1cf4b46be0750a99ad7a35a","66d4fad4f1cf4b46be0750a99ad7a35a",22856227,1,0,1,907,239,239,0
"66d4fad4f1cf4b46be0750a99ad7a35a","0b04c8e2f86d48c7aeb7e225819cd32b",22856227,1,-5,0,908,239,234,-5
"0b04c8e2f86d48c7aeb7e225819cd32b","f53da5fd9bfe412da4b80d4742563b6c",22856227,1,8,0,909,234,241,7
"f53da5fd9bfe412da4b80d4742563b6c","f53da5fd9bfe412da4b80d4742563b6c",22856227,1,0,1,910,241,241,0
"f53da5fd9bfe412da4b80d4742563b6c","2ae94c0cea4d480a9d5dca8fb1d7b542",22856227,1,3,0,911,241,242,1
"2ae94c0cea4d480a9d5dca8fb1d7b542","1c6721b1f63f4d30ba7746ea8af02a52",22856227,1,-27,0,912,242,221,-21
"1c6721b1f63f4d30ba7746ea8af02a52","1ebf23f9d994469a85206e4c7b1bf5f5",22856227,1,30,0,913,221,245,24
"1ebf23f9d994469a85206e4c7b1bf5f5","1ebf23f9d994469a85206e4c7b1bf5f5",22856227,21,0,1,914,245,245,0
"1ebf23f9d994469a85206e4c7b1bf5f5","85ae675b83e8422da842cfd25596af99",22856227,1,1,0,935,245,246,1
"85ae675b83e8422da842cfd25596af99","85ae675b83e8422da842cfd25596af99",22856227,1,0,1,936,246,246,0
"85ae675b83e8422da842cfd25596af99","2ae94c0cea4d480a9d5dca8fb1d7b542",22856227,1,-4,0,937,246,242,-4
"2ae94c0cea4d480a9d5dca8fb1d7b542","fa235f0f364d47e4ae1c87f47bf8e6ba",22856227,1,12,0,938,242,252,10
"fa235f0f364d47e4ae1c87f47bf8e6ba","fa235f0f364d47e4ae1c87f47bf8e6ba",22856227,3,0,1,939,252,252,0
"fa235f0f364d47e4ae1c87f47bf8e6ba","79f7845465cc4ed19d8e4f1429541be0",22856227,1,2,0,942,252,254,2
"79f7845465cc4ed19d8e4f1429541be0","79f7845465cc4ed19d8e4f1429541be0",22856227,2,0,1,943,254,254,0
"79f7845465cc4ed19d8e4f1429541be0","6e83e23f56544a19b94067c1c558d9c0",22856227,1,-8,0,945,254,247,-7
"6e83e23f56544a19b94067c1c558d9c0","00f61990949545828dd12f1303d47504",22856227,1,11,0,946,247,256,9
"00f61990949545828dd12f1303d47504","00f61990949545828dd12f1303d47504",22856227,1,0,1,947,256,256,0
"00f61990949545828dd12f1303d47504","41b0048dde734bb280bac6116baa8e27",22856227,1,3,0,948,256,259,3
"41b0048dde734bb280bac6116baa8e27","41b0048dde734bb280bac6116baa8e27",22856227,2,0,1,949,259,259,0
"41b0048dde734bb280bac6116baa8e27","b41c5a094a604ee0915327da5cc0beb7",22856227,1,1,0,951,259,260,1
"b41c5a094a604ee0915327da5cc0beb7","b41c5a094a604ee0915327da5cc0beb7",22856227,5,0,1,952,260,260,0
"b41c5a094a604ee0915327da5cc0beb7","d546341988904f069cfa86b21457d9d9",22856227,1,-10,0,957,260,251,-9
"d546341988904f069cfa86b21457d9d9","28c171777c52431ab6b925073bd63d46",22856227,1,15,0,958,251,264,13
"28c171777c52431ab6b925073bd63d46","28c171777c52431ab6b925073bd63d46",22856227,7,0,1,959,264,264,0
"28c171777c52431ab6b925073bd63d46","ac160db940cb49ae8579162b1d52bb5d",22856227,1,2,0,966,264,266,2
"ac160db940cb49ae8579162b1d52bb5d","ac160db940cb49ae8579162b1d52bb5d",22856227,7,0,1,967,266,266,0
"ac160db940cb49ae8579162b1d52bb5d","d989ebcfc12a4b669f0100dc1aa14f1e",22856227,1,-12,0,974,266,255,-11
"d989ebcfc12a4b669f0100dc1aa14f1e","c6fd49b485cc4874b0bbdd9c6171e09c",22856227,1,15,0,975,255,268,13
"c6fd49b485cc4874b0bbdd9c6171e09c","c6fd49b485cc4874b0bbdd9c6171e09c",22856227,3,0,1,976,268,268,0
"c6fd49b485cc4874b0bbdd9c6171e09c","44240778a97c4af0937817499b75707b",22856227,1,1,0,979,268,269,1
"44240778a97c4af0937817499b75707b","44240778a97c4af0937817499b75707b",22856227,2,0,1,980,269,269,0
"44240778a97c4af0937817499b75707b","7aa76d3e993840d8805f097cbdbcd44b",22856227,1,-9,0,982,269,261,-8
"7aa76d3e993840d8805f097cbdbcd44b","7028800abe7d4e27b613d1d6cbe26bf7",22856227,1,7,0,983,261,267,6
"7aa76d3e993840d8805f097cbdbcd44b","865a4d3b43374da7944dc7d397f566d9",22856227,1,12,0,985,261,271,10
"865a4d3b43374da7944dc7d397f566d9","865a4d3b43374da7944dc7d397f566d9",22856227,1,0,1,986,271,271,0
"865a4d3b43374da7944dc7d397f566d9","2ae94c0cea4d480a9d5dca8fb1d7b542",22856227,1,-35,0,987,271,242,-29
"0d987bed3ffa4ed0b9a2e62e97b7b30f","2ae94c0cea4d480a9d5dca8fb1d7b542",22856227,2,-38,0,990,272,242,-30
"2ae94c0cea4d480a9d5dca8fb1d7b542","7028800abe7d4e27b613d1d6cbe26bf7",22856227,1,30,0,991,242,267,25
"0d987bed3ffa4ed0b9a2e62e97b7b30f","7028800abe7d4e27b613d1d6cbe26bf7",22856227,1,-8,0,999,272,267,-5
"7028800abe7d4e27b613d1d6cbe26bf7","7aa76d3e993840d8805f097cbdbcd44b",22856227,3,-7,0,1000,267,261,-6
"7aa76d3e993840d8805f097cbdbcd44b","d989ebcfc12a4b669f0100dc1aa14f1e",22856227,2,-7,0,1001,261,255,-6
"d989ebcfc12a4b669f0100dc1aa14f1e","7aa76d3e993840d8805f097cbdbcd44b",22856227,2,7,0,1002,255,261,6
"7aa76d3e993840d8805f097cbdbcd44b","2ae94c0cea4d480a9d5dca8fb1d7b542",22856227,2,-23,0,1003,261,242,-19
"2ae94c0cea4d480a9d5dca8fb1d7b542","0d987bed3ffa4ed0b9a2e62e97b7b30f",22856227,4,38,0,1004,242,272,30
"0d987bed3ffa4ed0b9a2e62e97b7b30f","0d987bed3ffa4ed0b9a2e62e97b7b30f",22856227,2,0,1,1005,272,272,0
"0d987bed3ffa4ed0b9a2e62e97b7b30f","bb5a47f5ea01454a8b79455422d3b9da",22856227,1,10,0,1006,272,280,8
"bb5a47f5ea01454a8b79455422d3b9da","bb5a47f5ea01454a8b79455422d3b9da",22856227,8,0,1,1007,280,280,0
"bb5a47f5ea01454a8b79455422d3b9da","82ae07bc0c9b4570a41799290d1ef399",22856227,1,-6,0,1011,280,275,-5
"82ae07bc0c9b4570a41799290d1ef399","bb5a47f5ea01454a8b79455422d3b9da",22856227,1,6,0,1012,275,280,5
"bb5a47f5ea01454a8b79455422d3b9da","fab84b4fab5940efb4ea868ef8d09396",22856227,1,8,0,1017,280,284,4
"fab84b4fab5940efb4ea868ef8d09396","4a29443515bb404cb8924e1c60a63b73",22856227,4,4,0,1018,284,285,1
"4a29443515bb404cb8924e1c60a63b73","fab84b4fab5940efb4ea868ef8d09396",22856227,1,-4,0,1019,285,284,-1
"fab84b4fab5940efb4ea868ef8d09396","208c9b2796c944db8dacaa96082520ea",22856227,1,7,0,1020,284,288,4
"208c9b2796c944db8dacaa96082520ea","208c9b2796c944db8dacaa96082520ea",22856227,1,0,1,1021,288,288,0
"208c9b2796c944db8dacaa96082520ea","4a29443515bb404cb8924e1c60a63b73",22856227,2,-3,0,1022,288,285,-3
"4a29443515bb404cb8924e1c60a63b73","7669a956527947d0add87455277e80b4",22856227,1,7,0,1023,285,291,6
"7669a956527947d0add87455277e80b4","7669a956527947d0add87455277e80b4",22856227,1,0,1,1024,291,291,0
"7669a956527947d0add87455277e80b4","869e967078f04da18dd0b0b9389a7424",22856227,1,3,0,1025,291,293,2
"869e967078f04da18dd0b0b9389a7424","6a9a3b5bde4a48daa896fe8c06eca56f",22856227,1,-5,0,1026,293,289,-4
"6a9a3b5bde4a48daa896fe8c06eca56f","869e967078f04da18dd0b0b9389a7424",22856227,2,5,0,1027,289,293,4
"869e967078f04da18dd0b0b9389a7424","869e967078f04da18dd0b0b9389a7424",22856227,2,0,1,1028,293,293,0
"869e967078f04da18dd0b0b9389a7424","51ab6291537748fab90d519aa09889d6",22856227,1,2,0,1029,293,295,2
"51ab6291537748fab90d519aa09889d6","51ab6291537748fab90d519aa09889d6",22856227,5,0,1,1030,295,295,0
"51ab6291537748fab90d519aa09889d6","fab84b4fab5940efb4ea868ef8d09396",22856227,1,-16,0,1035,295,284,-11
"fab84b4fab5940efb4ea868ef8d09396","fab84b4fab5940efb4ea868ef8d09396",22856227,3,0,1,1036,284,284,0
"4a29443515bb404cb8924e1c60a63b73","208c9b2796c944db8dacaa96082520ea",22856227,3,3,0,1038,285,288,3
"4a29443515bb404cb8924e1c60a63b73","6a9a3b5bde4a48daa896fe8c06eca56f",22856227,1,5,0,1040,285,289,4
"869e967078f04da18dd0b0b9389a7424","34a6e49023fc4465bd5ca604330bbd1c",22856227,1,-1,0,1043,293,292,-1
"34a6e49023fc4465bd5ca604330bbd1c","21592f2a9e9c4b2f8c66ec5dbcbf6a2b",22856227,1,5,0,1044,292,296,4
"21592f2a9e9c4b2f8c66ec5dbcbf6a2b","ba0e59461bfb4a44b7b1c28a01f8d3b3",22856227,1,4,0,1045,296,299,3
"ba0e59461bfb4a44b7b1c28a01f8d3b3","ba0e59461bfb4a44b7b1c28a01f8d3b3",22856227,3,0,1,1046,299,299,0
"ba0e59461bfb4a44b7b1c28a01f8d3b3","0e0b36e731a645e7b1b8a88f5031ca38",22856227,1,2,0,1049,299,301,2
"0e0b36e731a645e7b1b8a88f5031ca38","0e0b36e731a645e7b1b8a88f5031ca38",22856227,2,0,1,1050,301,301,0
"0e0b36e731a645e7b1b8a88f5031ca38","a66a144637284c21afc6de17fea4bfb8",22856227,1,1,0,1052,301,302,1
"a66a144637284c21afc6de17fea4bfb8","a66a144637284c21afc6de17fea4bfb8",22856227,2,0,1,1053,302,302,0
"a66a144637284c21afc6de17fea4bfb8","7646a919d7e64fa990bca9b024ff089d",22856227,1,-4,0,1055,302,298,-4
"7646a919d7e64fa990bca9b024ff089d","e390b575229748ea8aac9364efe2bf00",22856227,1,7,0,1056,298,304,6
"e390b575229748ea8aac9364efe2bf00","e390b575229748ea8aac9364efe2bf00",22856227,1,0,1,1057,304,304,0
"e390b575229748ea8aac9364efe2bf00","3434c10e561d488a914e0f7d71907abd",22856227,1,3,0,1058,304,305,1
"3434c10e561d488a914e0f7d71907abd","4a29443515bb404cb8924e1c60a63b73",22856227,1,-27,0,1059,305,285,-20
"4a29443515bb404cb8924e1c60a63b73","53e7e900392747ccad52e711ab0f80d8",22856227,1,29,0,1060,285,307,22
"53e7e900392747ccad52e711ab0f80d8","53e7e900392747ccad52e711ab0f80d8",22856227,3,0,1,1061,307,307,0
"53e7e900392747ccad52e711ab0f80d8","3434c10e561d488a914e0f7d71907abd",22856227,1,-2,0,1064,307,305,-2
"3434c10e561d488a914e0f7d71907abd","130acc2aeb0448fdbb2de63bc5cebe5b",22856227,1,5,0,1065,305,309,4
"130acc2aeb0448fdbb2de63bc5cebe5b","130acc2aeb0448fdbb2de63bc5cebe5b",22856227,2,0,1,1066,309,309,0
"130acc2aeb0448fdbb2de63bc5cebe5b","9c062b3251034ebe90f5054e2a3b5120",22856227,1,2,0,1068,309,311,2
"9c062b3251034ebe90f5054e2a3b5120","9c062b3251034ebe90f5054e2a3b5120",22856227,5,0,1,1069,311,311,0
"9c062b3251034ebe90f5054e2a3b5120","ea859f8207e44537889daeaba13ac2e8",22856227,1,1,0,1074,311,312,1
"ea859f8207e44537889daeaba13ac2e8","ea859f8207e44537889daeaba13ac2e8",22856227,4,0,1,1075,312,312,0
"ea859f8207e44537889daeaba13ac2e8","56d94971a7a94257aa330183a8ebd0ea",22856227,1,1,0,1079,312,313,1
"56d94971a7a94257aa330183a8ebd0ea","56d94971a7a94257aa330183a8ebd0ea",22856227,1,0,1,1080,313,313,0
"56d94971a7a94257aa330183a8ebd0ea","141c0df6cd1946539aadd1c9b7068cd4",22856227,1,-5,0,1081,313,308,-5
"141c0df6cd1946539aadd1c9b7068cd4","13255e63e0aa4abf85e5211bf613d43e",22856227,1,10,0,1082,308,317,9
"13255e63e0aa4abf85e5211bf613d43e","13255e63e0aa4abf85e5211bf613d43e",22856227,2,0,1,1083,317,317,0
"13255e63e0aa4abf85e5211bf613d43e","0c787d16c9504873b1a4d903cec09948",22856227,2,-3,0,1084,317,314,-3
"0c787d16c9504873b1a4d903cec09948","130acc2aeb0448fdbb2de63bc5cebe5b",22856227,1,-6,0,1085,314,309,-5
"130acc2aeb0448fdbb2de63bc5cebe5b","141c0df6cd1946539aadd1c9b7068cd4",22856227,1,-1,0,1086,309,308,-1
"141c0df6cd1946539aadd1c9b7068cd4","3434c10e561d488a914e0f7d71907abd",22856227,1,-4,0,1087,308,305,-3
"3434c10e561d488a914e0f7d71907abd","13255e63e0aa4abf85e5211bf613d43e",22856227,1,14,0,1088,305,317,12
"0c787d16c9504873b1a4d903cec09948","86c27d40179e419c8e9d150fb6afa5d0",22856227,1,6,0,1091,314,319,5
"86c27d40179e419c8e9d150fb6afa5d0","86c27d40179e419c8e9d150fb6afa5d0",22856227,2,0,1,1092,319,319,0
"86c27d40179e419c8e9d150fb6afa5d0","47edbb64109243e6b0f8f64cdef90c6c",22856227,1,8,0,1094,319,326,7
"47edbb64109243e6b0f8f64cdef90c6c","8d7e0b55cf9849cda222a0f2440cec55",22856227,1,-9,0,1095,326,318,-8
"8d7e0b55cf9849cda222a0f2440cec55","24f1363179ad4aaa965484a78471912b",22856227,1,6,0,1096,318,323,5
"24f1363179ad4aaa965484a78471912b","24f1363179ad4aaa965484a78471912b",22856227,3,0,1,1097,323,323,0
"24f1363179ad4aaa965484a78471912b","3628bdce1dd2429ba924d2d4d09448d2",22856227,1,-1,0,1100,323,322,-1
"3628bdce1dd2429ba924d2d4d09448d2","3434c10e561d488a914e0f7d71907abd",22856227,1,-21,0,1101,322,305,-17
"3434c10e561d488a914e0f7d71907abd","56b3fd1a212a4764be39d979fde3326e",22856227,1,28,0,1102,305,328,23
"56b3fd1a212a4764be39d979fde3326e","56b3fd1a212a4764be39d979fde3326e",22856227,1,0,1,1103,328,328,0
"56b3fd1a212a4764be39d979fde3326e","0c4079457ede49e3aeb5e86ed84bdf35",22856227,1,3,0,1104,328,329,1
"0c4079457ede49e3aeb5e86ed84bdf35","3434c10e561d488a914e0f7d71907abd",22856227,1,-31,0,1105,329,305,-24
"3434c10e561d488a914e0f7d71907abd","38aea304b4fa46e1b29bb72f5cea4c93",22856227,1,33,0,1106,305,331,26
"38aea304b4fa46e1b29bb72f5cea4c93","38aea304b4fa46e1b29bb72f5cea4c93",22856227,2,0,1,1107,331,331,0
"38aea304b4fa46e1b29bb72f5cea4c93","e36d261332f14e79bb4b467aceaeb9b5",22856227,1,2,0,1109,331,333,2
"e36d261332f14e79bb4b467aceaeb9b5","e36d261332f14e79bb4b467aceaeb9b5",22856227,1,0,1,1110,333,333,0
"e36d261332f14e79bb4b467aceaeb9b5","c7e89b9d04744d2eab742fc24e3ef1ae",22856227,1,1,0,1111,333,334,1
"c7e89b9d04744d2eab742fc24e3ef1ae","c7e89b9d04744d2eab742fc24e3ef1ae",22856227,5,0,1,1112,334,334,0
"c7e89b9d04744d2eab742fc24e3ef1ae","fe49f8054b374a0ea4bb266ed135ff62",22856227,1,1,0,1117,334,335,1
"fe49f8054b374a0ea4bb266ed135ff62","fe49f8054b374a0ea4bb266ed135ff62",22856227,2,0,1,1118,335,335,0
"fe49f8054b374a0ea4bb266ed135ff62","d0a8f74af98642fe8360d22c42e45117",22856227,1,1,0,1120,335,336,1
"d0a8f74af98642fe8360d22c42e45117","d0a8f74af98642fe8360d22c42e45117",22856227,2,0,1,1121,336,336,0
"d0a8f74af98642fe8360d22c42e45117","0c4079457ede49e3aeb5e86ed84bdf35",22856227,1,-7,0,1123,336,329,-7
"0c4079457ede49e3aeb5e86ed84bdf35","a7c6339ca1da4368a18d471f0519f877",22856227,1,11,0,1124,329,339,10
"a7c6339ca1da4368a18d471f0519f877","a7c6339ca1da4368a18d471f0519f877",22856227,1,0,1,1125,339,339,0
"a7c6339ca1da4368a18d471f0519f877","bbc5139ca9024389a94db3a6f47dcff6",22856227,1,3,0,1126,339,341,2
"bbc5139ca9024389a94db3a6f47dcff6","b8b9418ab322418d9db9b40d96af873a",22856227,1,-5,0,1127,341,337,-4
"b8b9418ab322418d9db9b40d96af873a","bbc5139ca9024389a94db3a6f47dcff6",22856227,1,5,0,1128,337,341,4
"bbc5139ca9024389a94db3a6f47dcff6","bbc5139ca9024389a94db3a6f47dcff6",22856227,1,0,1,1129,341,341,0
"bbc5139ca9024389a94db3a6f47dcff6","4ee6ca9019ab4a1ab323f98094a9bd77",22856227,1,2,0,1130,341,343,2
"4ee6ca9019ab4a1ab323f98094a9bd77","4ee6ca9019ab4a1ab323f98094a9bd77",22856227,2,0,1,1131,343,343,0
"4ee6ca9019ab4a1ab323f98094a9bd77","b37947176785476f8b29d49a851366dc",22856227,1,1,0,1133,343,344,1
"b37947176785476f8b29d49a851366dc","b37947176785476f8b29d49a851366dc",22856227,2,0,1,1134,344,344,0
"b37947176785476f8b29d49a851366dc","fcea5b10d5a14a3b9324ffece8f6e1e5",22856227,1,1,0,1136,344,345,1
"fcea5b10d5a14a3b9324ffece8f6e1e5","fcea5b10d5a14a3b9324ffece8f6e1e5",22856227,2,0,1,1137,345,345,0
"fcea5b10d5a14a3b9324ffece8f6e1e5","c2490bc612d146edbe786556fab3651b",22856227,1,-5,0,1139,345,340,-5
"c2490bc612d146edbe786556fab3651b","0c4079457ede49e3aeb5e86ed84bdf35",22856227,1,-13,0,1140,340,329,-11
"0c4079457ede49e3aeb5e86ed84bdf35","6ac8bb048b854999a47edb35fe627f11",22856227,1,21,0,1141,329,347,18
"6ac8bb048b854999a47edb35fe627f11","6ac8bb048b854999a47edb35fe627f11",22856227,1,0,1,1142,347,347,0
"6ac8bb048b854999a47edb35fe627f11","0c4079457ede49e3aeb5e86ed84bdf35",22856227,1,-21,0,1143,347,329,-18
"0c4079457ede49e3aeb5e86ed84bdf35","30ead9794d4847abaf222ca966cc8630",22856227,1,24,0,1144,329,348,19
"30ead9794d4847abaf222ca966cc8630","897b7f51242c44aab2205c72fdcbf4cd",22856227,1,4,0,1145,348,352,4
"897b7f51242c44aab2205c72fdcbf4cd","09b9678ddc3d452ea4a3d46e15826065",22856227,2,1,0,1146,352,353,1
"09b9678ddc3d452ea4a3d46e15826065","eff0de7f2dbb42dfa1a2e686efab5b6d",22856227,2,1,0,1147,353,354,1
"eff0de7f2dbb42dfa1a2e686efab5b6d","c20993c944444fe085345591a8bd837e",22856227,1,-3,0,1148,354,351,-3
"c20993c944444fe085345591a8bd837e","c20993c944444fe085345591a8bd837e",22856227,4,0,1,1149,351,351,0
"c20993c944444fe085345591a8bd837e","897b7f51242c44aab2205c72fdcbf4cd",22856227,1,1,0,1153,351,352,1
"897b7f51242c44aab2205c72fdcbf4cd","897b7f51242c44aab2205c72fdcbf4cd",22856227,3,0,1,1154,352,352,0
"09b9678ddc3d452ea4a3d46e15826065","09b9678ddc3d452ea4a3d46e15826065",22856227,3,0,1,1158,353,353,0
"eff0de7f2dbb42dfa1a2e686efab5b6d","eff0de7f2dbb42dfa1a2e686efab5b6d",22856227,3,0,1,1162,354,354,0
"eff0de7f2dbb42dfa1a2e686efab5b6d","2fe14166dc9642c3bc666b86a57f943d",22856227,1,4,0,1165,354,357,3
"2fe14166dc9642c3bc666b86a57f943d","30ead9794d4847abaf222ca966cc8630",22856227,1,-10,0,1166,357,348,-9
"30ead9794d4847abaf222ca966cc8630","2fe14166dc9642c3bc666b86a57f943d",22856227,1,10,0,1167,348,357,9
"2fe14166dc9642c3bc666b86a57f943d","2fe14166dc9642c3bc666b86a57f943d",22856227,1,0,1,1168,357,357,0
"2fe14166dc9642c3bc666b86a57f943d","44421dd1e13a47a388c4a19834b744c7",22856227,1,2,0,1169,357,359,2
"44421dd1e13a47a388c4a19834b744c7","44421dd1e13a47a388c4a19834b744c7",22856227,2,0,1,1170,359,359,0
"44421dd1e13a47a388c4a19834b744c7","cb5fc7ef85d547c4be1a7439d0bf6052",22856227,1,1,0,1172,359,360,1
"cb5fc7ef85d547c4be1a7439d0bf6052","cb5fc7ef85d547c4be1a7439d0bf6052",22856227,2,0,1,1173,360,360,0
"cb5fc7ef85d547c4be1a7439d0bf6052","0a8f150a4cf747acbde62f4721823da3",22856227,1,1,0,1175,360,361,1
"0a8f150a4cf747acbde62f4721823da3","0a8f150a4cf747acbde62f4721823da3",22856227,2,0,1,1176,361,361,0
"0a8f150a4cf747acbde62f4721823da3","ab8fdad974ae471f9f24c3f9dd04462e",22856227,1,1,0,1178,361,362,1
"ab8fdad974ae471f9f24c3f9dd04462e","ab8fdad974ae471f9f24c3f9dd04462e",22856227,2,0,1,1179,362,362,0
"ab8fdad974ae471f9f24c3f9dd04462e","52580888dadb4fe3baa795683ea227bd",22856227,1,3,0,1181,362,364,2
"52580888dadb4fe3baa795683ea227bd","1ba8fef685d74a8194b9db252eb704fb",22856227,1,-10,0,1182,364,355,-9
"1ba8fef685d74a8194b9db252eb704fb","52580888dadb4fe3baa795683ea227bd",22856227,1,10,0,1183,355,364,9
"52580888dadb4fe3baa795683ea227bd","52580888dadb4fe3baa795683ea227bd",22856227,1,0,1,1184,364,364,0
"52580888dadb4fe3baa795683ea227bd","f00179e251a045b39c3f7a54f9aa4acc",22856227,1,-1,0,1185,364,363,-1
"f00179e251a045b39c3f7a54f9aa4acc","492a3bc6a1254f23a7998587961b22a4",22856227,1,4,0,1186,363,366,3
"492a3bc6a1254f23a7998587961b22a4","492a3bc6a1254f23a7998587961b22a4",22856227,3,0,1,1187,366,366,0
"492a3bc6a1254f23a7998587961b22a4","072a190fd302456290895f9f04d6940a",22856227,1,-1,0,1190,366,365,-1
"072a190fd302456290895f9f04d6940a","cfa457d1743848e4bb5e4beced6448ed",22856227,1,5,0,1191,365,369,4
"cfa457d1743848e4bb5e4beced6448ed","cfa457d1743848e4bb5e4beced6448ed",22856227,1,0,1,1192,369,369,0
"cfa457d1743848e4bb5e4beced6448ed","30ead9794d4847abaf222ca966cc8630",22856227,2,-25,0,1193,369,348,-21
"30ead9794d4847abaf222ca966cc8630","b71bac264efb4abd97015447bd490db6",22856227,2,28,0,1194,348,370,22
"b71bac264efb4abd97015447bd490db6","b71bac264efb4abd97015447bd490db6",22856227,1,0,1,1195,370,370,0
"b71bac264efb4abd97015447bd490db6","30ead9794d4847abaf222ca966cc8630",22856227,1,-28,0,1196,370,348,-22
"30ead9794d4847abaf222ca966cc8630","cfa457d1743848e4bb5e4beced6448ed",22856227,1,25,0,1197,348,369,21
"b71bac264efb4abd97015447bd490db6","fab84b4fab5940efb4ea868ef8d09396",22856227,2,-114,0,1200,370,284,-86
"208c9b2796c944db8dacaa96082520ea","b71bac264efb4abd97015447bd490db6",22856227,2,107,0,1204,288,370,82
"b71bac264efb4abd97015447bd490db6","8d448d625b024c82a5eb240bbd7431d6",22856227,4,5,0,1210,370,374,4
"8d448d625b024c82a5eb240bbd7431d6","8d448d625b024c82a5eb240bbd7431d6",22856227,54,0,1,1211,374,374,0
"8d448d625b024c82a5eb240bbd7431d6","b71bac264efb4abd97015447bd490db6",22856227,1,-5,0,1213,374,370,-4
"8d448d625b024c82a5eb240bbd7431d6","fab84b4fab5940efb4ea868ef8d09396",22856227,1,-119,0,1219,374,284,-90
"fab84b4fab5940efb4ea868ef8d09396","b71bac264efb4abd97015447bd490db6",22856227,1,114,0,1220,284,370,86
"8d448d625b024c82a5eb240bbd7431d6","0c7262dff33c4087bc660ccf40f92f9c",22856227,1,-272,0,1249,374,169,-205
"0c7262dff33c4087bc660ccf40f92f9c","b71bac264efb4abd97015447bd490db6",22856227,1,267,0,1250,169,370,201
"8d448d625b024c82a5eb240bbd7431d6","0d987bed3ffa4ed0b9a2e62e97b7b30f",22856227,1,-137,0,1273,374,272,-102
"0d987bed3ffa4ed0b9a2e62e97b7b30f","82ae07bc0c9b4570a41799290d1ef399",22856227,1,4,0,1274,272,275,3
"82ae07bc0c9b4570a41799290d1ef399","0c7262dff33c4087bc660ccf40f92f9c",22856227,1,-139,0,1275,275,169,-106
"0c7262dff33c4087bc660ccf40f92f9c","0c7262dff33c4087bc660ccf40f92f9c",22856227,2,0,1,1276,169,169,0
"0c7262dff33c4087bc660ccf40f92f9c","66baf19b6b904b70922329068c63746d",22856227,1,279,0,1277,169,376,207
"66baf19b6b904b70922329068c63746d","7f544639412e40a9ba27f43b415362ab",22856227,1,2,0,1278,376,378,2
"7f544639412e40a9ba27f43b415362ab","d5ae8642e15b46b8bd298b02274d4e9c",22856227,1,2,0,1279,378,380,2
"d5ae8642e15b46b8bd298b02274d4e9c","d5ae8642e15b46b8bd298b02274d4e9c",22856227,7,0,1,1280,380,380,0
"d5ae8642e15b46b8bd298b02274d4e9c","a0d10309a2dd456289147f84be9d37f9",22856227,1,1,0,1287,380,381,1
"a0d10309a2dd456289147f84be9d37f9","a0d10309a2dd456289147f84be9d37f9",22856227,2,0,1,1288,381,381,0
"a0d10309a2dd456289147f84be9d37f9","0fcbc3ca07b144138b8d85da581f09a8",22856227,1,1,0,1290,381,382,1
"0fcbc3ca07b144138b8d85da581f09a8","0fcbc3ca07b144138b8d85da581f09a8",22856227,2,0,1,1291,382,382,0
"0fcbc3ca07b144138b8d85da581f09a8","66baf19b6b904b70922329068c63746d",22856227,1,-6,0,1293,382,376,-6
"66baf19b6b904b70922329068c63746d","c2fca3669923477ab966ded303dea31c",22856227,1,8,0,1294,376,383,7
"c2fca3669923477ab966ded303dea31c","4890121ce5d74576b4632b77cfc23398",22856227,1,6,0,1295,383,388,5
"4890121ce5d74576b4632b77cfc23398","18d3b836dd804224883cc9180b60a8e1",22856227,1,-1,0,1296,388,387,-1
"18d3b836dd804224883cc9180b60a8e1","96bb2b3e85a34d8b9544514e89f6fe97",22856227,1,4,0,1297,387,390,3
"96bb2b3e85a34d8b9544514e89f6fe97","4890121ce5d74576b4632b77cfc23398",22856227,1,-3,0,1298,390,388,-2
"4890121ce5d74576b4632b77cfc23398","17f95d18bab743888e1736033dc3384d",22856227,1,2,0,1299,388,389,1
"17f95d18bab743888e1736033dc3384d","96bb2b3e85a34d8b9544514e89f6fe97",22856227,1,1,0,1300,389,390,1
"96bb2b3e85a34d8b9544514e89f6fe97","18d3b836dd804224883cc9180b60a8e1",22856227,1,-4,0,1301,390,387,-3
"18d3b836dd804224883cc9180b60a8e1","ac4e9b54acfe4670b4634859c7263cb5",22856227,1,6,0,1302,387,392,5
"ac4e9b54acfe4670b4634859c7263cb5","ac4e9b54acfe4670b4634859c7263cb5",22856227,1,0,1,1303,392,392,0
"ac4e9b54acfe4670b4634859c7263cb5","17f95d18bab743888e1736033dc3384d",22856227,1,-3,0,1304,392,389,-3
"17f95d18bab743888e1736033dc3384d","6f8881a745ac4c358a68b92c3b4abe81",22856227,1,6,0,1305,389,394,5
"6f8881a745ac4c358a68b92c3b4abe81","f7002c8484354eceac57bc7bd62c76c1",22856227,3,-1,0,1306,394,393,-1
"f7002c8484354eceac57bc7bd62c76c1","0c12af0a4e7f4002852cf84b2537c161",22856227,1,3,0,1307,393,395,2
"0c12af0a4e7f4002852cf84b2537c161","6f8881a745ac4c358a68b92c3b4abe81",22856227,1,-2,0,1308,395,394,-1
"f7002c8484354eceac57bc7bd62c76c1","44a277ea44dc4ae689fab4b82f0b4098",22856227,2,5,0,1310,393,397,4
"44a277ea44dc4ae689fab4b82f0b4098","66baf19b6b904b70922329068c63746d",22856227,1,-26,0,1311,397,376,-21
"66baf19b6b904b70922329068c63746d","6f8881a745ac4c358a68b92c3b4abe81",22856227,1,22,0,1312,376,394,18
"44a277ea44dc4ae689fab4b82f0b4098","44a277ea44dc4ae689fab4b82f0b4098",22856227,1,0,1,1315,397,397,0
"44a277ea44dc4ae689fab4b82f0b4098","0c12af0a4e7f4002852cf84b2537c161",22856227,1,-2,0,1316,397,395,-2
"0c12af0a4e7f4002852cf84b2537c161","df8191ec5e584c838a899c378941a566",22856227,1,4,0,1317,395,398,3
"df8191ec5e584c838a899c378941a566","0c12af0a4e7f4002852cf84b2537c161",22856227,1,-4,0,1318,398,395,-3
"0c12af0a4e7f4002852cf84b2537c161","859e0b8d71694b12befb69ee698138f9",22856227,1,5,0,1319,395,399,4
"b613861cecf84ffcab01afb23f660475","b613861cecf84ffcab01afb23f660475",22856446,4,0,1,1,1,1,0
"b613861cecf84ffcab01afb23f660475","e2911e79efc2420eac45d9f671463d4b",22856446,1,3,0,5,1,2,1
"e2911e79efc2420eac45d9f671463d4b","519d1b8c59404d67b54e96c5c8a830b2",22856446,1,1,0,8,2,3,1
"519d1b8c59404d67b54e96c5c8a830b2","519d1b8c59404d67b54e96c5c8a830b2",22856446,2,0,1,10,3,3,0
"519d1b8c59404d67b54e96c5c8a830b2","531db53f81f646edb0cdcfe0085b03b7",22856446,1,1,0,11,3,4,1
"531db53f81f646edb0cdcfe0085b03b7","531db53f81f646edb0cdcfe0085b03b7",22856446,1,0,1,12,4,4,0
"531db53f81f646edb0cdcfe0085b03b7","4f5f94b2f95141e0a9d53a61da2276da",22856446,1,1,0,13,4,5,1
"4f5f94b2f95141e0a9d53a61da2276da","4f5f94b2f95141e0a9d53a61da2276da",22856446,1,0,1,14,5,5,0
"4f5f94b2f95141e0a9d53a61da2276da","6d541c89590949f99af293c4f2333f67",22856446,1,1,0,15,5,6,1
"6d541c89590949f99af293c4f2333f67","6d541c89590949f99af293c4f2333f67",22856446,1,0,1,16,6,6,0
"6d541c89590949f99af293c4f2333f67","dd5cf0b9fe4c4f1d8f5ff8e4c04879cb",22856446,1,1,0,17,6,7,1
"dd5cf0b9fe4c4f1d8f5ff8e4c04879cb","dd5cf0b9fe4c4f1d8f5ff8e4c04879cb",22856446,1,0,1,18,7,7,0
"dd5cf0b9fe4c4f1d8f5ff8e4c04879cb","f96261861edc426abe2248be4f0a709a",22856446,1,1,0,19,7,8,1
"f96261861edc426abe2248be4f0a709a","f96261861edc426abe2248be4f0a709a",22856446,1,0,1,20,8,8,0
"f96261861edc426abe2248be4f0a709a","66b5e16f4f75454fb5b8172079f0fa83",22856446,1,1,0,21,8,9,1
"66b5e16f4f75454fb5b8172079f0fa83","66b5e16f4f75454fb5b8172079f0fa83",22856446,4,0,1,22,9,9,0
"66b5e16f4f75454fb5b8172079f0fa83","0680571d4698477995e41842c36a54b2",22856446,1,1,0,26,9,10,1
"0680571d4698477995e41842c36a54b2","0680571d4698477995e41842c36a54b2",22856446,1,0,1,27,10,10,0
"0680571d4698477995e41842c36a54b2","9112f2bffece48e08c6d2287be204085",22856446,1,1,0,28,10,11,1
"9112f2bffece48e08c6d2287be204085","9112f2bffece48e08c6d2287be204085",22856446,1,0,1,29,11,11,0
"9112f2bffece48e08c6d2287be204085","e2911e79efc2420eac45d9f671463d4b",22856446,1,-9,0,30,11,2,-9
"e2911e79efc2420eac45d9f671463d4b","56586aa865414f538729c7f7735d2bc6",22856446,1,12,0,31,2,12,10
"56586aa865414f538729c7f7735d2bc6","56586aa865414f538729c7f7735d2bc6",22856446,3,0,1,32,12,12,0
"56586aa865414f538729c7f7735d2bc6","b7f2b31585d94eb3bf86376714aa7070",22856446,4,2,0,34,12,13,1
"b7f2b31585d94eb3bf86376714aa7070","56586aa865414f538729c7f7735d2bc6",22856446,2,-2,0,35,13,12,-1
"b7f2b31585d94eb3bf86376714aa7070","b7f2b31585d94eb3bf86376714aa7070",22856446,1,0,1,37,13,13,0
"b7f2b31585d94eb3bf86376714aa7070","3f1c815879794b929260d224becaff7e",22856446,2,2,0,38,13,14,1
"3f1c815879794b929260d224becaff7e","81c864a886d54a6b8ff85f7d736f4f95",22856446,2,2,0,39,14,15,1
"81c864a886d54a6b8ff85f7d736f4f95","5c5ceeee4562457ba6d41515aeebfbb1",22856446,2,4,0,40,15,17,2
"5c5ceeee4562457ba6d41515aeebfbb1","56586aa865414f538729c7f7735d2bc6",22856446,2,-10,0,41,17,12,-5
"5c5ceeee4562457ba6d41515aeebfbb1","5c5ceeee4562457ba6d41515aeebfbb1",22856446,1,0,1,51,17,17,0
"5c5ceeee4562457ba6d41515aeebfbb1","9afd71a5298d4333b6849dfce1b9422c",22856446,1,3,0,52,17,18,1
"9afd71a5298d4333b6849dfce1b9422c","56586aa865414f538729c7f7735d2bc6",22856446,1,-13,0,53,18,12,-6
"56586aa865414f538729c7f7735d2bc6","9afd71a5298d4333b6849dfce1b9422c",22856446,1,13,0,54,12,18,6
"9afd71a5298d4333b6849dfce1b9422c","9afd71a5298d4333b6849dfce1b9422c",22856446,2,0,1,55,18,18,0
"9afd71a5298d4333b6849dfce1b9422c","b7719e26494940efa49512aedd0aac79",22856446,1,4,0,57,18,20,2
"d4f45188d3c84a02ba08454e6403a818","d4c3b003e8274e429d2fa688d73fde6d",22856446,1,-2,0,59,24,22,-2
"b7719e26494940efa49512aedd0aac79","b7719e26494940efa49512aedd0aac79",22856446,1,0,1,62,20,20,0
"b7719e26494940efa49512aedd0aac79","afbf7250b99d47bea07172749483ca97",22856446,1,12,0,63,20,28,8
"afbf7250b99d47bea07172749483ca97","afbf7250b99d47bea07172749483ca97",22856446,1,0,1,64,28,28,0
"afbf7250b99d47bea07172749483ca97","4e51676dc72045d99c19b9fa7b22f8bc",22856446,1,3,0,65,28,29,1
"4e51676dc72045d99c19b9fa7b22f8bc","4e51676dc72045d99c19b9fa7b22f8bc",22856446,1,0,1,66,29,29,0
"4e51676dc72045d99c19b9fa7b22f8bc","51970cfa30e643e894e66ae85c8024cc",22856446,1,3,0,67,29,31,2
"51970cfa30e643e894e66ae85c8024cc","c33c17be71ae4d588da7369472e5bb1b",22856446,1,6,0,68,31,34,3
"c33c17be71ae4d588da7369472e5bb1b","4e51676dc72045d99c19b9fa7b22f8bc",22856446,3,-9,0,69,34,29,-5
"4e51676dc72045d99c19b9fa7b22f8bc","c33c17be71ae4d588da7369472e5bb1b",22856446,3,9,0,70,29,34,5
"c33c17be71ae4d588da7369472e5bb1b","93679be414554a11b1893002f2229a93",22856446,1,3,0,75,34,35,1
"93679be414554a11b1893002f2229a93","93679be414554a11b1893002f2229a93",22856446,1,0,1,76,35,35,0
"93679be414554a11b1893002f2229a93","7040a13096d746ac84b8fac8d9752058",22856446,1,3,0,77,35,36,1
"7040a13096d746ac84b8fac8d9752058","7040a13096d746ac84b8fac8d9752058",22856446,1,0,1,78,36,36,0
"7040a13096d746ac84b8fac8d9752058","9a0dc646f934470daf08c4b56ccf73db",22856446,1,3,0,79,36,37,1
"9a0dc646f934470daf08c4b56ccf73db","9a0dc646f934470daf08c4b56ccf73db",22856446,1,0,1,80,37,37,0
"9a0dc646f934470daf08c4b56ccf73db","fc0e049d56024bc9a02c9a9c435c3df7",22856446,1,3,0,81,37,38,1
"fc0e049d56024bc9a02c9a9c435c3df7","fc0e049d56024bc9a02c9a9c435c3df7",22856446,1,0,1,82,38,38,0
"fc0e049d56024bc9a02c9a9c435c3df7","67a089198fcb4e1c8f2385786c2b296f",22856446,1,4,0,83,38,39,1
"64d48c6c9c7940639a932219a6c87198","b534b89233134e30a9b5645138bfa9ee",22856446,1,3,0,86,40,41,1
"67a089198fcb4e1c8f2385786c2b296f","0e37b720d23b4e7f8b313e79313fd107",22856446,1,7,0,88,39,44,5
"0e37b720d23b4e7f8b313e79313fd107","0e37b720d23b4e7f8b313e79313fd107",22856446,1,0,1,89,44,44,0
"0e37b720d23b4e7f8b313e79313fd107","6875d67fdd5f48168b62719df449bebd",22856446,1,1,0,90,44,45,1
"6875d67fdd5f48168b62719df449bebd","6875d67fdd5f48168b62719df449bebd",22856446,1,0,1,91,45,45,0
"6875d67fdd5f48168b62719df449bebd","6e13d61a7bdb44bca949c9f86fab3be5",22856446,1,3,0,92,45,47,2
"6e13d61a7bdb44bca949c9f86fab3be5","6e13d61a7bdb44bca949c9f86fab3be5",22856446,7,0,1,100,47,47,0
"6e13d61a7bdb44bca949c9f86fab3be5","d0c74f735e024943943e40333d6d337f",22856446,2,5,0,105,47,51,4
"d0c74f735e024943943e40333d6d337f","d9c8d8c444a64dadbbb508652c721e17",22856446,2,-6,0,106,51,46,-5
"d9c8d8c444a64dadbbb508652c721e17","a1f2f12debe5432fb7a70bcd12bacfb9",22856446,4,14,0,107,46,58,12
"a1f2f12debe5432fb7a70bcd12bacfb9","78f30e4dcac84e3cbea8b2cc6e0d62b3",22856446,4,1,0,108,58,59,1
"78f30e4dcac84e3cbea8b2cc6e0d62b3","f924752d8a1149668870b1e7698486f7",22856446,1,-10,0,109,59,50,-9
"f924752d8a1149668870b1e7698486f7","d646286c8051419bbc2e31dd1db55ca8",22856446,1,22,0,110,50,67,17
"d646286c8051419bbc2e31dd1db55ca8","12aa6e1672ac4e7aa6449a7a8609cd72",22856446,1,-14,0,111,67,57,-10
"12aa6e1672ac4e7aa6449a7a8609cd72","309ccf3cc4fe429d9bfbaef53d3fa479",22856446,1,4,0,112,57,60,3
"309ccf3cc4fe429d9bfbaef53d3fa479","bc42d26810654ea9a1df1efe1e58c7d5",22856446,1,3,0,113,60,63,3
"bc42d26810654ea9a1df1efe1e58c7d5","b534b89233134e30a9b5645138bfa9ee",22856446,1,-26,0,114,63,41,-22
"b534b89233134e30a9b5645138bfa9ee","a0a418b8540d479fa6e0f653b701da8b",22856446,2,27,0,115,41,64,23
"a0a418b8540d479fa6e0f653b701da8b","d646286c8051419bbc2e31dd1db55ca8",22856446,1,6,0,116,64,67,3
"d646286c8051419bbc2e31dd1db55ca8","d646286c8051419bbc2e31dd1db55ca8",22856446,4,0,1,117,67,67,0
"d646286c8051419bbc2e31dd1db55ca8","b534b89233134e30a9b5645138bfa9ee",22856446,2,-33,0,118,67,41,-26
"b534b89233134e30a9b5645138bfa9ee","b534b89233134e30a9b5645138bfa9ee",22856446,4,0,1,119,41,41,0
"a0a418b8540d479fa6e0f653b701da8b","7af822066add4e7f8e007e4eee31a8bf",22856446,1,2,0,121,64,65,1
"7af822066add4e7f8e007e4eee31a8bf","bc42d26810654ea9a1df1efe1e58c7d5",22856446,1,-3,0,122,65,63,-2
"bc42d26810654ea9a1df1efe1e58c7d5","d9c8d8c444a64dadbbb508652c721e17",22856446,1,-20,0,123,63,46,-17
"78f30e4dcac84e3cbea8b2cc6e0d62b3","12aa6e1672ac4e7aa6449a7a8609cd72",22856446,1,-2,0,126,59,57,-2
"12aa6e1672ac4e7aa6449a7a8609cd72","6e13d61a7bdb44bca949c9f86fab3be5",22856446,2,-12,0,127,57,47,-10
"d0c74f735e024943943e40333d6d337f","309ccf3cc4fe429d9bfbaef53d3fa479",22856446,1,11,0,129,51,60,9
"309ccf3cc4fe429d9bfbaef53d3fa479","f924752d8a1149668870b1e7698486f7",22856446,1,-12,0,130,60,50,-10
"f924752d8a1149668870b1e7698486f7","67a089198fcb4e1c8f2385786c2b296f",22856446,1,-15,0,131,50,39,-11
"67a089198fcb4e1c8f2385786c2b296f","b534b89233134e30a9b5645138bfa9ee",22856446,1,4,0,132,39,41,2
"b534b89233134e30a9b5645138bfa9ee","67a089198fcb4e1c8f2385786c2b296f",22856446,3,-4,0,134,41,39,-2
"64d48c6c9c7940639a932219a6c87198","6e13d61a7bdb44bca949c9f86fab3be5",22856446,1,10,0,136,40,47,7
"6e13d61a7bdb44bca949c9f86fab3be5","b534b89233134e30a9b5645138bfa9ee",22856446,3,-7,0,137,47,41,-6
"b534b89233134e30a9b5645138bfa9ee","d0c74f735e024943943e40333d6d337f",22856446,1,12,0,138,41,51,10
"d9c8d8c444a64dadbbb508652c721e17","b534b89233134e30a9b5645138bfa9ee",22856446,1,-6,0,140,46,41,-5
"b534b89233134e30a9b5645138bfa9ee","6e13d61a7bdb44bca949c9f86fab3be5",22856446,4,7,0,142,41,47,6
"6e13d61a7bdb44bca949c9f86fab3be5","195f78799f984cc2b06c48dfe36be751",22856446,1,2,0,143,47,49,2
"195f78799f984cc2b06c48dfe36be751","195f78799f984cc2b06c48dfe36be751",22856446,2,0,1,144,49,49,0
"195f78799f984cc2b06c48dfe36be751","d9c8d8c444a64dadbbb508652c721e17",22856446,1,-3,0,146,49,46,-3
"d9c8d8c444a64dadbbb508652c721e17","d0c74f735e024943943e40333d6d337f",22856446,1,6,0,147,46,51,5
"d0c74f735e024943943e40333d6d337f","d0c74f735e024943943e40333d6d337f",22856446,4,0,1,148,51,51,0
"d0c74f735e024943943e40333d6d337f","983f8ff320594b279a7f4a6fe132f9c5",22856446,1,2,0,152,51,53,2
"983f8ff320594b279a7f4a6fe132f9c5","983f8ff320594b279a7f4a6fe132f9c5",22856446,2,0,1,153,53,53,0
"983f8ff320594b279a7f4a6fe132f9c5","35adfa5d923046aebabfefd98f35ff05",22856446,1,1,0,155,53,54,1
"35adfa5d923046aebabfefd98f35ff05","35adfa5d923046aebabfefd98f35ff05",22856446,5,0,1,156,54,54,0
"35adfa5d923046aebabfefd98f35ff05","b6f8a98476224da1b40e555ececc7ed8",22856446,1,1,0,161,54,55,1
"b6f8a98476224da1b40e555ececc7ed8","b6f8a98476224da1b40e555ececc7ed8",22856446,2,0,1,162,55,55,0
"b6f8a98476224da1b40e555ececc7ed8","86e22cb5fe0e4b47a9489ecddf7ed78f",22856446,1,1,0,164,55,56,1
"86e22cb5fe0e4b47a9489ecddf7ed78f","86e22cb5fe0e4b47a9489ecddf7ed78f",22856446,3,0,1,165,56,56,0
"86e22cb5fe0e4b47a9489ecddf7ed78f","f924752d8a1149668870b1e7698486f7",22856446,1,-6,0,168,56,50,-6
"f924752d8a1149668870b1e7698486f7","78f30e4dcac84e3cbea8b2cc6e0d62b3",22856446,1,10,0,169,50,59,9
"78f30e4dcac84e3cbea8b2cc6e0d62b3","a1f2f12debe5432fb7a70bcd12bacfb9",22856446,2,-1,0,170,59,58,-1
"a1f2f12debe5432fb7a70bcd12bacfb9","a1f2f12debe5432fb7a70bcd12bacfb9",22856446,25,0,1,171,58,58,0
"a1f2f12debe5432fb7a70bcd12bacfb9","12aa6e1672ac4e7aa6449a7a8609cd72",22856446,2,-1,0,179,58,57,-1
"12aa6e1672ac4e7aa6449a7a8609cd72","b534b89233134e30a9b5645138bfa9ee",22856446,1,-19,0,180,57,41,-16
"6e13d61a7bdb44bca949c9f86fab3be5","a1f2f12debe5432fb7a70bcd12bacfb9",22856446,1,13,0,182,47,58,11
"78f30e4dcac84e3cbea8b2cc6e0d62b3","d9c8d8c444a64dadbbb508652c721e17",22856446,2,-15,0,184,59,46,-13
"6e13d61a7bdb44bca949c9f86fab3be5","78f30e4dcac84e3cbea8b2cc6e0d62b3",22856446,1,14,0,195,47,59,12
"a1f2f12debe5432fb7a70bcd12bacfb9","6e13d61a7bdb44bca949c9f86fab3be5",22856446,1,-13,0,200,58,47,-11
"6e13d61a7bdb44bca949c9f86fab3be5","12aa6e1672ac4e7aa6449a7a8609cd72",22856446,1,12,0,201,47,57,10
"12aa6e1672ac4e7aa6449a7a8609cd72","d9c8d8c444a64dadbbb508652c721e17",22856446,1,-13,0,202,57,46,-11
"d9c8d8c444a64dadbbb508652c721e17","78f30e4dcac84e3cbea8b2cc6e0d62b3",22856446,1,15,0,203,46,59,13
"78f30e4dcac84e3cbea8b2cc6e0d62b3","78f30e4dcac84e3cbea8b2cc6e0d62b3",22856446,7,0,1,214,59,59,0
"78f30e4dcac84e3cbea8b2cc6e0d62b3","bc42d26810654ea9a1df1efe1e58c7d5",22856446,1,5,0,221,59,63,4
"bc42d26810654ea9a1df1efe1e58c7d5","a0a418b8540d479fa6e0f653b701da8b",22856446,1,1,0,222,63,64,1
"a0a418b8540d479fa6e0f653b701da8b","12aa6e1672ac4e7aa6449a7a8609cd72",22856446,1,-8,0,223,64,57,-7
"12aa6e1672ac4e7aa6449a7a8609cd72","4c943503763e4e349906eea3ed3c8e86",22856446,1,5,0,224,57,61,4
"4c943503763e4e349906eea3ed3c8e86","4c943503763e4e349906eea3ed3c8e86",22856446,1,0,1,225,61,61,0
"4c943503763e4e349906eea3ed3c8e86","309ccf3cc4fe429d9bfbaef53d3fa479",22856446,1,-1,0,226,61,60,-1
"309ccf3cc4fe429d9bfbaef53d3fa479","d646286c8051419bbc2e31dd1db55ca8",22856446,1,10,0,227,60,67,7
"67a089198fcb4e1c8f2385786c2b296f","d646286c8051419bbc2e31dd1db55ca8",22856446,1,37,0,230,39,67,28
"d646286c8051419bbc2e31dd1db55ca8","267f883678b24aed855fde42524975d9",22856446,1,4,0,232,67,71,4
"267f883678b24aed855fde42524975d9","267f883678b24aed855fde42524975d9",22856446,1,0,1,233,71,71,0
"267f883678b24aed855fde42524975d9","88fff56d0342490dbef9040750a20f6c",22856446,1,1,0,234,71,72,1
"88fff56d0342490dbef9040750a20f6c","88fff56d0342490dbef9040750a20f6c",22856446,1,0,1,235,72,72,0
"88fff56d0342490dbef9040750a20f6c","adb17b12b66c4a49a85fd34322f7df70",22856446,1,1,0,236,72,73,1
"adb17b12b66c4a49a85fd34322f7df70","adb17b12b66c4a49a85fd34322f7df70",22856446,1,0,1,237,73,73,0
"adb17b12b66c4a49a85fd34322f7df70","a2becd407db34b189200a32546d9d569",22856446,1,3,0,238,73,75,2
"a2becd407db34b189200a32546d9d569","d646286c8051419bbc2e31dd1db55ca8",22856446,1,-9,0,239,75,67,-8
"d646286c8051419bbc2e31dd1db55ca8","a2becd407db34b189200a32546d9d569",22856446,1,9,0,240,67,75,8
"a2becd407db34b189200a32546d9d569","58c22b011d0f4c2ea6d13615edbb9eeb",22856446,1,2,0,241,75,77,2
"58c22b011d0f4c2ea6d13615edbb9eeb","58c22b011d0f4c2ea6d13615edbb9eeb",22856446,2,0,1,242,77,77,0
"58c22b011d0f4c2ea6d13615edbb9eeb","dd76e1861dc9461c830888729d091ee0",22856446,1,1,0,244,77,78,1
"dd76e1861dc9461c830888729d091ee0","dd76e1861dc9461c830888729d091ee0",22856446,5,0,1,245,78,78,0
"dd76e1861dc9461c830888729d091ee0","cd1d828f1a694b87913a7ea66c23803e",22856446,1,1,0,250,78,79,1
"cd1d828f1a694b87913a7ea66c23803e","cd1d828f1a694b87913a7ea66c23803e",22856446,2,0,1,251,79,79,0
"cd1d828f1a694b87913a7ea66c23803e","9176a3c2b4d2465fa8b0c67096c2a97e",22856446,1,1,0,253,79,80,1
"9176a3c2b4d2465fa8b0c67096c2a97e","9176a3c2b4d2465fa8b0c67096c2a97e",22856446,5,0,1,254,80,80,0
"9176a3c2b4d2465fa8b0c67096c2a97e","f8ec6445f7194e25b9101d4fbcb07a18",22856446,1,1,0,259,80,81,1
"f8ec6445f7194e25b9101d4fbcb07a18","f8ec6445f7194e25b9101d4fbcb07a18",22856446,2,0,1,260,81,81,0
"f8ec6445f7194e25b9101d4fbcb07a18","140d5b27b8574befad82c0a013b59dfa",22856446,1,-7,0,262,81,74,-7
"140d5b27b8574befad82c0a013b59dfa","d18a9ea32855445f8736581f5cb119ce",22856446,1,9,0,263,74,82,8
"d18a9ea32855445f8736581f5cb119ce","f564483cbd7a407681aa2fcca518cf5f",22856446,2,4,0,264,82,85,3
"f564483cbd7a407681aa2fcca518cf5f","f564483cbd7a407681aa2fcca518cf5f",22856446,2,0,1,265,85,85,0
"f564483cbd7a407681aa2fcca518cf5f","18fd01350bd5434ca636d59a599d768a",22856446,1,1,0,266,85,86,1
"18fd01350bd5434ca636d59a599d768a","18fd01350bd5434ca636d59a599d768a",22856446,7,0,1,267,86,86,0
"18fd01350bd5434ca636d59a599d768a","ae5ac430ea254e708a6f5deaaf7464ae",22856446,2,-2,0,272,86,84,-2
"ae5ac430ea254e708a6f5deaaf7464ae","6a9f0ef185fb47f0937e29daa1c71ed5",22856446,3,7,0,273,84,90,6
"6a9f0ef185fb47f0937e29daa1c71ed5","c681290961c94c4caf23b529d1ae6b9a",22856446,1,-2,0,274,90,88,-2
"c681290961c94c4caf23b529d1ae6b9a","c681290961c94c4caf23b529d1ae6b9a",22856446,1,0,1,275,88,88,0
"c681290961c94c4caf23b529d1ae6b9a","6a9f0ef185fb47f0937e29daa1c71ed5",22856446,1,2,0,276,88,90,2
"6a9f0ef185fb47f0937e29daa1c71ed5","6a9f0ef185fb47f0937e29daa1c71ed5",22856446,11,0,1,277,90,90,0
"6a9f0ef185fb47f0937e29daa1c71ed5","e20db35ced8544ddac5bc3839145e463",22856446,1,3,0,280,90,91,1
"e20db35ced8544ddac5bc3839145e463","d646286c8051419bbc2e31dd1db55ca8",22856446,2,-30,0,281,91,67,-24
"d646286c8051419bbc2e31dd1db55ca8","67a089198fcb4e1c8f2385786c2b296f",22856446,1,-37,0,282,67,39,-28
"67a089198fcb4e1c8f2385786c2b296f","67a089198fcb4e1c8f2385786c2b296f",22856446,1,0,1,283,39,39,0
"64d48c6c9c7940639a932219a6c87198","67a089198fcb4e1c8f2385786c2b296f",22856446,4,-1,0,285,40,39,-1
"64d48c6c9c7940639a932219a6c87198","64d48c6c9c7940639a932219a6c87198",22856446,5,0,1,287,40,40,0
"67a089198fcb4e1c8f2385786c2b296f","231c15562ab8497daeb55e56acf3b35c",22856446,1,69,0,292,39,93,54
"231c15562ab8497daeb55e56acf3b35c","231c15562ab8497daeb55e56acf3b35c",22856446,1,0,1,293,93,93,0
"231c15562ab8497daeb55e56acf3b35c","e20db35ced8544ddac5bc3839145e463",22856446,3,-2,0,294,93,91,-2
"e20db35ced8544ddac5bc3839145e463","231c15562ab8497daeb55e56acf3b35c",22856446,2,2,0,295,91,93,2
"e20db35ced8544ddac5bc3839145e463","e20db35ced8544ddac5bc3839145e463",22856446,13,0,1,299,91,91,0
"e20db35ced8544ddac5bc3839145e463","1febb706d7a34005ae8711ed49c76e64",22856446,1,3,0,311,91,94,3
"1febb706d7a34005ae8711ed49c76e64","1febb706d7a34005ae8711ed49c76e64",22856446,2,0,1,312,94,94,0
"1febb706d7a34005ae8711ed49c76e64","8f73ba6f5a0042f2850356ac38ac6f24",22856446,1,1,0,314,94,95,1
"8f73ba6f5a0042f2850356ac38ac6f24","8f73ba6f5a0042f2850356ac38ac6f24",22856446,5,0,1,315,95,95,0
"8f73ba6f5a0042f2850356ac38ac6f24","e20db35ced8544ddac5bc3839145e463",22856446,1,-4,0,320,95,91,-4
"e20db35ced8544ddac5bc3839145e463","e2260b86653c46d7b14a41fb419dbf8c",22856446,1,5,0,322,91,96,5
"e2260b86653c46d7b14a41fb419dbf8c","e2260b86653c46d7b14a41fb419dbf8c",22856446,2,0,1,323,96,96,0
"e2260b86653c46d7b14a41fb419dbf8c","35eb641ad1d845bbba54915bce75a962",22856446,1,1,0,325,96,97,1
"35eb641ad1d845bbba54915bce75a962","35eb641ad1d845bbba54915bce75a962",22856446,2,0,1,326,97,97,0
"35eb641ad1d845bbba54915bce75a962","08be90ffbeea4795a138cd42ed8db56f",22856446,1,1,0,328,97,98,1
"08be90ffbeea4795a138cd42ed8db56f","08be90ffbeea4795a138cd42ed8db56f",22856446,5,0,1,329,98,98,0
"08be90ffbeea4795a138cd42ed8db56f","3007433c8f584dcbb5ac159c1c5f2be3",22856446,1,1,0,334,98,99,1
"3007433c8f584dcbb5ac159c1c5f2be3","3007433c8f584dcbb5ac159c1c5f2be3",22856446,5,0,1,335,99,99,0
"3007433c8f584dcbb5ac159c1c5f2be3","d391c8b6e56a43a7b654e9dee02d904b",22856446,1,5,0,340,99,103,4
"d391c8b6e56a43a7b654e9dee02d904b","e20db35ced8544ddac5bc3839145e463",22856446,1,-13,0,341,103,91,-12
"e20db35ced8544ddac5bc3839145e463","00ae5f0c51874a73a41ebea838d95682",22856446,1,11,0,342,91,101,10
"00ae5f0c51874a73a41ebea838d95682","00ae5f0c51874a73a41ebea838d95682",22856446,2,0,1,343,101,101,0
"00ae5f0c51874a73a41ebea838d95682","d391c8b6e56a43a7b654e9dee02d904b",22856446,1,2,0,345,101,103,2
"d391c8b6e56a43a7b654e9dee02d904b","d391c8b6e56a43a7b654e9dee02d904b",22856446,15,0,1,346,103,103,0
"d391c8b6e56a43a7b654e9dee02d904b","6111116566fc4fd9abba409322bea245",22856446,1,1,0,361,103,104,1
"6111116566fc4fd9abba409322bea245","6111116566fc4fd9abba409322bea245",22856446,2,0,1,362,104,104,0
"6111116566fc4fd9abba409322bea245","a81b2235cb9c499eb9ea8ee0a8dd9725",22856446,1,1,0,364,104,105,1
"a81b2235cb9c499eb9ea8ee0a8dd9725","a81b2235cb9c499eb9ea8ee0a8dd9725",22856446,5,0,1,365,105,105,0
"a81b2235cb9c499eb9ea8ee0a8dd9725","2d4e0ab0ef3b4d73b82c72d4621a7579",22856446,1,1,0,370,105,106,1
"2d4e0ab0ef3b4d73b82c72d4621a7579","2d4e0ab0ef3b4d73b82c72d4621a7579",22856446,2,0,1,371,106,106,0
"2d4e0ab0ef3b4d73b82c72d4621a7579","8bdebf492ebd4e62b0d522e8ab5e5197",22856446,1,1,0,373,106,107,1
"8bdebf492ebd4e62b0d522e8ab5e5197","8bdebf492ebd4e62b0d522e8ab5e5197",22856446,2,0,1,374,107,107,0
"8bdebf492ebd4e62b0d522e8ab5e5197","73039f8c1eb9409cb4caee2cf968001e",22856446,1,-7,0,376,107,100,-7
"73039f8c1eb9409cb4caee2cf968001e","4280927ec4d643238aa49c32f9e06c6c",22856446,3,10,0,377,100,109,9
"4280927ec4d643238aa49c32f9e06c6c","4280927ec4d643238aa49c32f9e06c6c",22856446,2,0,1,378,109,109,0
"4280927ec4d643238aa49c32f9e06c6c","fc44e6a5f7654430af1227838224dceb",22856446,1,2,0,380,109,111,2
"fc44e6a5f7654430af1227838224dceb","fc44e6a5f7654430af1227838224dceb",22856446,2,0,1,381,111,111,0
"fc44e6a5f7654430af1227838224dceb","a9ae0a3c070d455bb4369a8996313336",22856446,1,4,0,383,111,114,3
"a9ae0a3c070d455bb4369a8996313336","08111f75e22d409998cf8b85bd431f0a",22856446,3,-7,0,384,114,108,-6
"08111f75e22d409998cf8b85bd431f0a","a9ae0a3c070d455bb4369a8996313336",22856446,2,7,0,385,108,114,6
"a9ae0a3c070d455bb4369a8996313336","4280927ec4d643238aa49c32f9e06c6c",22856446,1,-6,0,386,114,109,-5
"4280927ec4d643238aa49c32f9e06c6c","37319e88176d4aefa91d7a9980dbae91",22856446,1,4,0,387,109,112,3
"37319e88176d4aefa91d7a9980dbae91","a9ae0a3c070d455bb4369a8996313336",22856446,2,2,0,388,112,114,2
"08111f75e22d409998cf8b85bd431f0a","71cec822bcff4f30a20e75dc63ef7b65",22856446,1,9,0,390,108,116,8
"71cec822bcff4f30a20e75dc63ef7b65","71cec822bcff4f30a20e75dc63ef7b65",22856446,1,0,1,391,116,116,0
"71cec822bcff4f30a20e75dc63ef7b65","37319e88176d4aefa91d7a9980dbae91",22856446,1,-4,0,392,116,112,-4
"37319e88176d4aefa91d7a9980dbae91","62bff51286ef4f348717a3cf6fe2318f",22856446,4,9,0,393,112,120,8
"62bff51286ef4f348717a3cf6fe2318f","3ec3a3563847406fa73338f9e9999cf3",22856446,2,-3,0,394,120,117,-3
"3ec3a3563847406fa73338f9e9999cf3","e20db35ced8544ddac5bc3839145e463",22856446,1,-30,0,395,117,91,-26
"e20db35ced8544ddac5bc3839145e463","a9ae0a3c070d455bb4369a8996313336",22856446,1,26,0,396,91,114,23
"a9ae0a3c070d455bb4369a8996313336","37319e88176d4aefa91d7a9980dbae91",22856446,1,-2,0,397,114,112,-2
"62bff51286ef4f348717a3cf6fe2318f","b1cd0e7dc3ad4a8eb91a4bfdbeb025b0",22856446,1,-2,0,399,120,118,-2
"b1cd0e7dc3ad4a8eb91a4bfdbeb025b0","b1cd0e7dc3ad4a8eb91a4bfdbeb025b0",22856446,4,0,1,400,118,118,0
"b1cd0e7dc3ad4a8eb91a4bfdbeb025b0","62bff51286ef4f348717a3cf6fe2318f",22856446,1,2,0,404,118,120,2
"62bff51286ef4f348717a3cf6fe2318f","62bff51286ef4f348717a3cf6fe2318f",22856446,8,0,1,405,120,120,0
"62bff51286ef4f348717a3cf6fe2318f","e20db35ced8544ddac5bc3839145e463",22856446,2,-33,0,408,120,91,-29
"e20db35ced8544ddac5bc3839145e463","779f9ddd1fd14d1e9e69f72219a1fdbd",22856446,2,36,0,409,91,121,30
"779f9ddd1fd14d1e9e69f72219a1fdbd","d646286c8051419bbc2e31dd1db55ca8",22856446,1,-66,0,410,121,67,-54
"d646286c8051419bbc2e31dd1db55ca8","ae5ac430ea254e708a6f5deaaf7464ae",22856446,3,20,0,411,67,84,17
"ae5ac430ea254e708a6f5deaaf7464ae","18fd01350bd5434ca636d59a599d768a",22856446,1,2,0,412,84,86,2
"6a9f0ef185fb47f0937e29daa1c71ed5","d646286c8051419bbc2e31dd1db55ca8",22856446,2,-27,0,419,90,67,-23
"d646286c8051419bbc2e31dd1db55ca8","e20db35ced8544ddac5bc3839145e463",22856446,3,30,0,420,67,91,24
"e20db35ced8544ddac5bc3839145e463","67a089198fcb4e1c8f2385786c2b296f",22856446,2,-67,0,421,91,39,-52
"67a089198fcb4e1c8f2385786c2b296f","ae5ac430ea254e708a6f5deaaf7464ae",22856446,1,57,0,422,39,84,45
"ae5ac430ea254e708a6f5deaaf7464ae","d646286c8051419bbc2e31dd1db55ca8",22856446,4,-20,0,423,84,67,-17
"ae5ac430ea254e708a6f5deaaf7464ae","ae5ac430ea254e708a6f5deaaf7464ae",22856446,1,0,1,426,84,84,0
"d646286c8051419bbc2e31dd1db55ca8","6a9f0ef185fb47f0937e29daa1c71ed5",22856446,1,27,0,428,67,90,23
"6a9f0ef185fb47f0937e29daa1c71ed5","ae5ac430ea254e708a6f5deaaf7464ae",22856446,2,-7,0,431,90,84,-6
"e20db35ced8544ddac5bc3839145e463","d391c8b6e56a43a7b654e9dee02d904b",22856446,2,13,0,434,91,103,12
"d391c8b6e56a43a7b654e9dee02d904b","00ae5f0c51874a73a41ebea838d95682",22856446,1,-2,0,435,103,101,-2
"00ae5f0c51874a73a41ebea838d95682","e20db35ced8544ddac5bc3839145e463",22856446,2,-11,0,436,101,91,-10
"e20db35ced8544ddac5bc3839145e463","73039f8c1eb9409cb4caee2cf968001e",22856446,1,10,0,437,91,100,9
"4280927ec4d643238aa49c32f9e06c6c","08111f75e22d409998cf8b85bd431f0a",22856446,1,-1,0,439,109,108,-1
"a9ae0a3c070d455bb4369a8996313336","62bff51286ef4f348717a3cf6fe2318f",22856446,1,7,0,441,114,120,6
"62bff51286ef4f348717a3cf6fe2318f","37319e88176d4aefa91d7a9980dbae91",22856446,1,-9,0,442,120,112,-8
"62bff51286ef4f348717a3cf6fe2318f","ae5ac430ea254e708a6f5deaaf7464ae",22856446,1,-43,0,445,120,84,-36
"ae5ac430ea254e708a6f5deaaf7464ae","f564483cbd7a407681aa2fcca518cf5f",22856446,1,1,0,449,84,85,1
"f564483cbd7a407681aa2fcca518cf5f","ae5ac430ea254e708a6f5deaaf7464ae",22856446,1,-1,0,451,85,84,-1
"67a089198fcb4e1c8f2385786c2b296f","779f9ddd1fd14d1e9e69f72219a1fdbd",22856446,2,103,0,458,39,121,82
"779f9ddd1fd14d1e9e69f72219a1fdbd","779f9ddd1fd14d1e9e69f72219a1fdbd",22856446,2,0,1,459,121,121,0
"779f9ddd1fd14d1e9e69f72219a1fdbd","ae26e6cda8ad4a3f81bd347560d9579f",22856446,1,4,0,460,121,125,4
"ae26e6cda8ad4a3f81bd347560d9579f","ae26e6cda8ad4a3f81bd347560d9579f",22856446,1,0,1,461,125,125,0
"ae26e6cda8ad4a3f81bd347560d9579f","ee48df95832b4374aa273ceb27ec1315",22856446,1,1,0,462,125,126,1
"ee48df95832b4374aa273ceb27ec1315","ee48df95832b4374aa273ceb27ec1315",22856446,1,0,1,463,126,126,0
"ee48df95832b4374aa273ceb27ec1315","7a439da90b394756ad1777fc4c6dead5",22856446,1,1,0,464,126,127,1
"7a439da90b394756ad1777fc4c6dead5","7a439da90b394756ad1777fc4c6dead5",22856446,1,0,1,465,127,127,0
"7a439da90b394756ad1777fc4c6dead5","779f9ddd1fd14d1e9e69f72219a1fdbd",22856446,1,-6,0,466,127,121,-6
"779f9ddd1fd14d1e9e69f72219a1fdbd","a8dd5213034441ac92724b4e83eb0bb2",22856446,2,9,0,467,121,129,8
"a8dd5213034441ac92724b4e83eb0bb2","a8dd5213034441ac92724b4e83eb0bb2",22856446,1,0,1,468,129,129,0
"a8dd5213034441ac92724b4e83eb0bb2","8115eab6556b45f5b415c3b8c26a12e5",22856446,1,2,0,469,129,131,2
"8115eab6556b45f5b415c3b8c26a12e5","8115eab6556b45f5b415c3b8c26a12e5",22856446,2,0,1,470,131,131,0
"8115eab6556b45f5b415c3b8c26a12e5","ec34b06efd844b46a4c4818ecdb9b8f4",22856446,1,1,0,472,131,132,1
"ec34b06efd844b46a4c4818ecdb9b8f4","ec34b06efd844b46a4c4818ecdb9b8f4",22856446,2,0,1,473,132,132,0
"ec34b06efd844b46a4c4818ecdb9b8f4","c2e1c2b9eac64109b343a088584b576b",22856446,1,1,0,475,132,133,1
"c2e1c2b9eac64109b343a088584b576b","c2e1c2b9eac64109b343a088584b576b",22856446,2,0,1,476,133,133,0
"c2e1c2b9eac64109b343a088584b576b","579338175e0b4bbb8ef3b712b5d8b54e",22856446,1,-5,0,478,133,128,-5
"579338175e0b4bbb8ef3b712b5d8b54e","8bc5795d6a984a3eace4e2811e52dd4f",22856446,1,8,0,479,128,135,7
"8bc5795d6a984a3eace4e2811e52dd4f","8bc5795d6a984a3eace4e2811e52dd4f",22856446,1,0,1,480,135,135,0
"8bc5795d6a984a3eace4e2811e52dd4f","b416d47c56a742199b5d7c7f19d6503a",22856446,1,-1,0,481,135,134,-1
"b416d47c56a742199b5d7c7f19d6503a","cd4532ad48034873ba8bce2aac0c9808",22856446,1,4,0,482,134,137,3
"cd4532ad48034873ba8bce2aac0c9808","cd4532ad48034873ba8bce2aac0c9808",22856446,1,0,1,483,137,137,0
"cd4532ad48034873ba8bce2aac0c9808","779f9ddd1fd14d1e9e69f72219a1fdbd",22856446,1,-19,0,484,137,121,-16
"779f9ddd1fd14d1e9e69f72219a1fdbd","df1de691dafe4549a18a4398ee9dfaf9",22856446,3,23,0,485,121,139,18
"df1de691dafe4549a18a4398ee9dfaf9","6c5ad271a44743479bfaea29b1db8d02",22856446,2,4,0,486,139,143,4
"6c5ad271a44743479bfaea29b1db8d02","e20db35ced8544ddac5bc3839145e463",22856446,1,-63,0,487,143,91,-52
"e20db35ced8544ddac5bc3839145e463","37319e88176d4aefa91d7a9980dbae91",22856446,1,24,0,488,91,112,21
"a9ae0a3c070d455bb4369a8996313336","67a089198fcb4e1c8f2385786c2b296f",22856446,2,-93,0,490,114,39,-75
"779f9ddd1fd14d1e9e69f72219a1fdbd","b416d47c56a742199b5d7c7f19d6503a",22856446,1,15,0,492,121,134,13
"b416d47c56a742199b5d7c7f19d6503a","b416d47c56a742199b5d7c7f19d6503a",22856446,1,0,1,493,134,134,0
"b416d47c56a742199b5d7c7f19d6503a","f661500307d74c908e9207d949ceb4aa",22856446,1,3,0,494,134,136,2
"f661500307d74c908e9207d949ceb4aa","a8dd5213034441ac92724b4e83eb0bb2",22856446,1,-9,0,495,136,129,-7
"a8dd5213034441ac92724b4e83eb0bb2","b416d47c56a742199b5d7c7f19d6503a",22856446,1,6,0,496,129,134,5
"b416d47c56a742199b5d7c7f19d6503a","579338175e0b4bbb8ef3b712b5d8b54e",22856446,1,-7,0,497,134,128,-6
"579338175e0b4bbb8ef3b712b5d8b54e","779f9ddd1fd14d1e9e69f72219a1fdbd",22856446,2,-8,0,498,128,121,-7
"779f9ddd1fd14d1e9e69f72219a1fdbd","e20db35ced8544ddac5bc3839145e463",22856446,1,-36,0,499,121,91,-30
"e20db35ced8544ddac5bc3839145e463","62bff51286ef4f348717a3cf6fe2318f",22856446,1,33,0,500,91,120,29
"3ec3a3563847406fa73338f9e9999cf3","a9ae0a3c070d455bb4369a8996313336",22856446,1,-4,0,504,117,114,-3
"67a089198fcb4e1c8f2385786c2b296f","d18a9ea32855445f8736581f5cb119ce",22856446,1,54,0,506,39,82,43
"d18a9ea32855445f8736581f5cb119ce","d646286c8051419bbc2e31dd1db55ca8",22856446,1,-17,0,507,82,67,-15
"d646286c8051419bbc2e31dd1db55ca8","d18a9ea32855445f8736581f5cb119ce",22856446,1,17,0,508,67,82,15
"f564483cbd7a407681aa2fcca518cf5f","6a9f0ef185fb47f0937e29daa1c71ed5",22856446,1,6,0,510,85,90,5
"ae5ac430ea254e708a6f5deaaf7464ae","e20db35ced8544ddac5bc3839145e463",22856446,1,10,0,514,84,91,7
"d646286c8051419bbc2e31dd1db55ca8","00ae5f0c51874a73a41ebea838d95682",22856446,1,41,0,516,67,101,34
"d391c8b6e56a43a7b654e9dee02d904b","73039f8c1eb9409cb4caee2cf968001e",22856446,1,-3,0,519,103,100,-3
"4280927ec4d643238aa49c32f9e06c6c","a9ae0a3c070d455bb4369a8996313336",22856446,1,6,0,521,109,114,5
"08111f75e22d409998cf8b85bd431f0a","37319e88176d4aefa91d7a9980dbae91",22856446,1,5,0,523,108,112,4
"a8dd5213034441ac92724b4e83eb0bb2","579338175e0b4bbb8ef3b712b5d8b54e",22856446,1,-1,0,531,129,128,-1
"df1de691dafe4549a18a4398ee9dfaf9","b416d47c56a742199b5d7c7f19d6503a",22856446,1,-8,0,534,139,134,-5
"b416d47c56a742199b5d7c7f19d6503a","779f9ddd1fd14d1e9e69f72219a1fdbd",22856446,1,-15,0,535,134,121,-13
"6c5ad271a44743479bfaea29b1db8d02","6c5ad271a44743479bfaea29b1db8d02",22856446,1,0,1,538,143,143,0
"6c5ad271a44743479bfaea29b1db8d02","83d311bed5374fee83d8d67a7d9d82dc",22856446,1,1,0,539,143,144,1
"83d311bed5374fee83d8d67a7d9d82dc","83d311bed5374fee83d8d67a7d9d82dc",22856446,1,0,1,540,144,144,0
"83d311bed5374fee83d8d67a7d9d82dc","402bba41861d43acb52a5abb89e8831e",22856446,1,1,0,541,144,145,1
"402bba41861d43acb52a5abb89e8831e","402bba41861d43acb52a5abb89e8831e",22856446,2,0,1,542,145,145,0
"402bba41861d43acb52a5abb89e8831e","8aae34f5ddbb4052a709b12e6b0d40fa",22856446,1,3,0,544,145,147,2
"8aae34f5ddbb4052a709b12e6b0d40fa","df1de691dafe4549a18a4398ee9dfaf9",22856446,1,-9,0,545,147,139,-8
"8aae34f5ddbb4052a709b12e6b0d40fa","645b3f0249f64f76af2e19eb4d0e55b7",22856446,1,2,0,553,147,149,2
"645b3f0249f64f76af2e19eb4d0e55b7","645b3f0249f64f76af2e19eb4d0e55b7",22856446,2,0,1,554,149,149,0
"645b3f0249f64f76af2e19eb4d0e55b7","7e7b8db5064d4369805ab370aac5ddfb",22856446,1,1,0,556,149,150,1
"7e7b8db5064d4369805ab370aac5ddfb","7e7b8db5064d4369805ab370aac5ddfb",22856446,2,0,1,557,150,150,0
"7e7b8db5064d4369805ab370aac5ddfb","8956d210ae7f41968fada86d4c979d6a",22856446,1,1,0,559,150,151,1
"8956d210ae7f41968fada86d4c979d6a","8956d210ae7f41968fada86d4c979d6a",22856446,2,0,1,560,151,151,0
"8956d210ae7f41968fada86d4c979d6a","f902b0f41b544d4dbf79664fd233648d",22856446,1,-5,0,562,151,146,-5
"f902b0f41b544d4dbf79664fd233648d","ae781e8b775e4ccd93bc800dad5c8376",22856446,1,8,0,566,146,153,7
"ae781e8b775e4ccd93bc800dad5c8376","ae781e8b775e4ccd93bc800dad5c8376",22856446,2,0,1,567,153,153,0
"ae781e8b775e4ccd93bc800dad5c8376","06882a8492d9499aa31555567f575ecb",22856446,1,1,0,569,153,154,1
"06882a8492d9499aa31555567f575ecb","06882a8492d9499aa31555567f575ecb",22856446,1,0,1,570,154,154,0
"06882a8492d9499aa31555567f575ecb","f293c508f409466a8f27ddd7d1e40b20",22856446,1,1,0,571,154,155,1
"f293c508f409466a8f27ddd7d1e40b20","f293c508f409466a8f27ddd7d1e40b20",22856446,2,0,1,572,155,155,0
"f293c508f409466a8f27ddd7d1e40b20","cc4ddef5bbbe48ebb605141b347c4ed1",22856446,1,1,0,574,155,156,1
"cc4ddef5bbbe48ebb605141b347c4ed1","cc4ddef5bbbe48ebb605141b347c4ed1",22856446,3,0,1,575,156,156,0
"cc4ddef5bbbe48ebb605141b347c4ed1","d313cec988a84645bee413e8d4724a4b",22856446,1,3,0,578,156,158,2
"d313cec988a84645bee413e8d4724a4b","f03480cf4eba413194d7af52fc0e7f28",22856446,1,-7,0,579,158,152,-6
"f03480cf4eba413194d7af52fc0e7f28","d313cec988a84645bee413e8d4724a4b",22856446,1,7,0,580,152,158,6
"d313cec988a84645bee413e8d4724a4b","d313cec988a84645bee413e8d4724a4b",22856446,3,0,1,581,158,158,0
"d313cec988a84645bee413e8d4724a4b","dc60696c76a74368a60f72246e47700d",22856446,1,1,0,584,158,159,1
"dc60696c76a74368a60f72246e47700d","dc60696c76a74368a60f72246e47700d",22856446,1,0,1,585,159,159,0
"dc60696c76a74368a60f72246e47700d","78adeee1fa2c4fe0bc73f7bca9fcee86",22856446,1,3,0,586,159,160,1
"78adeee1fa2c4fe0bc73f7bca9fcee86","df1de691dafe4549a18a4398ee9dfaf9",22856446,1,-26,0,587,160,139,-21
"df1de691dafe4549a18a4398ee9dfaf9","78adeee1fa2c4fe0bc73f7bca9fcee86",22856446,1,26,0,588,139,160,21
"78adeee1fa2c4fe0bc73f7bca9fcee86","78adeee1fa2c4fe0bc73f7bca9fcee86",22856446,1,0,1,589,160,160,0
"78adeee1fa2c4fe0bc73f7bca9fcee86","65202579580f4ad38d734b4ee39d22a8",22856446,5,5,0,590,160,164,4
"65202579580f4ad38d734b4ee39d22a8","65202579580f4ad38d734b4ee39d22a8",22856446,97,0,1,591,164,164,0
"65202579580f4ad38d734b4ee39d22a8","78adeee1fa2c4fe0bc73f7bca9fcee86",22856446,4,-5,0,592,164,160,-4
"65202579580f4ad38d734b4ee39d22a8","8959e6304a0348309a771e4d08d1b64a",22856446,2,-1,0,599,164,163,-1
"8959e6304a0348309a771e4d08d1b64a","78adeee1fa2c4fe0bc73f7bca9fcee86",22856446,1,-4,0,600,163,160,-3
"65202579580f4ad38d734b4ee39d22a8","67a089198fcb4e1c8f2385786c2b296f",22856446,1,-157,0,620,164,39,-125
"67a089198fcb4e1c8f2385786c2b296f","3cbcea2be0984e7dbd5a48195af10ce7",22856446,1,160,0,621,39,165,126
"3cbcea2be0984e7dbd5a48195af10ce7","3cbcea2be0984e7dbd5a48195af10ce7",22856446,1,0,1,622,165,165,0
"3cbcea2be0984e7dbd5a48195af10ce7","82e6285962b8400d9d6fc32436022a94",22856446,3,2,0,623,165,167,2
"82e6285962b8400d9d6fc32436022a94","67a089198fcb4e1c8f2385786c2b296f",22856446,2,-162,0,624,167,39,-128
"67a089198fcb4e1c8f2385786c2b296f","a9ac840f098c4bd0a2ee896214ce29cd",22856446,1,165,0,625,39,168,129
"a9ac840f098c4bd0a2ee896214ce29cd","a9ac840f098c4bd0a2ee896214ce29cd",22856446,3,0,1,626,168,168,0
"a9ac840f098c4bd0a2ee896214ce29cd","0c7262dff33c4087bc660ccf40f92f9c",22856446,3,4,0,628,168,169,1
"0c7262dff33c4087bc660ccf40f92f9c","b2275c3fad834f8d90737a2d9a6927d6",22856446,4,3,0,629,169,172,3
"b2275c3fad834f8d90737a2d9a6927d6","a9ac840f098c4bd0a2ee896214ce29cd",22856446,2,-7,0,630,172,168,-4
"0c7262dff33c4087bc660ccf40f92f9c","a9ac840f098c4bd0a2ee896214ce29cd",22856446,1,-4,0,632,169,168,-1
"a9ac840f098c4bd0a2ee896214ce29cd","67a089198fcb4e1c8f2385786c2b296f",22856446,1,-165,0,637,168,39,-129
"67a089198fcb4e1c8f2385786c2b296f","78adeee1fa2c4fe0bc73f7bca9fcee86",22856446,3,152,0,638,39,160,121
"78adeee1fa2c4fe0bc73f7bca9fcee86","8959e6304a0348309a771e4d08d1b64a",22856446,3,4,0,639,160,163,3
"8959e6304a0348309a771e4d08d1b64a","65202579580f4ad38d734b4ee39d22a8",22856446,4,1,0,640,163,164,1
"78adeee1fa2c4fe0bc73f7bca9fcee86","3cbcea2be0984e7dbd5a48195af10ce7",22856446,2,8,0,650,160,165,5
"82e6285962b8400d9d6fc32436022a94","78adeee1fa2c4fe0bc73f7bca9fcee86",22856446,1,-10,0,652,167,160,-7
"65202579580f4ad38d734b4ee39d22a8","3cbcea2be0984e7dbd5a48195af10ce7",22856446,1,3,0,662,164,165,1
"3cbcea2be0984e7dbd5a48195af10ce7","78adeee1fa2c4fe0bc73f7bca9fcee86",22856446,1,-8,0,663,165,160,-5
"78adeee1fa2c4fe0bc73f7bca9fcee86","82e6285962b8400d9d6fc32436022a94",22856446,1,10,0,664,160,167,7
"65202579580f4ad38d734b4ee39d22a8","0c7262dff33c4087bc660ccf40f92f9c",22856446,1,12,0,701,164,169,5
"b2275c3fad834f8d90737a2d9a6927d6","67a089198fcb4e1c8f2385786c2b296f",22856446,1,-172,0,703,172,39,-133
"82e6285962b8400d9d6fc32436022a94","0c7262dff33c4087bc660ccf40f92f9c",22856446,1,7,0,743,167,169,2
"b2275c3fad834f8d90737a2d9a6927d6","b2275c3fad834f8d90737a2d9a6927d6",22856446,28,0,1,746,172,172,0
"b2275c3fad834f8d90737a2d9a6927d6","eb515a26030b41f8a82a1e6114420bad",22856446,1,1,0,774,172,173,1
"eb515a26030b41f8a82a1e6114420bad","eb515a26030b41f8a82a1e6114420bad",22856446,2,0,1,775,173,173,0
"eb515a26030b41f8a82a1e6114420bad","b42cc17b7de840f181a704558d0bc845",22856446,1,3,0,777,173,175,2
"b42cc17b7de840f181a704558d0bc845","0c7262dff33c4087bc660ccf40f92f9c",22856446,1,-7,0,778,175,169,-6
"0c7262dff33c4087bc660ccf40f92f9c","b42cc17b7de840f181a704558d0bc845",22856446,1,7,0,779,169,175,6
"b42cc17b7de840f181a704558d0bc845","b42cc17b7de840f181a704558d0bc845",22856446,5,0,1,780,175,175,0
"b42cc17b7de840f181a704558d0bc845","801f9e9135034f49bf5f8b4bdefedb41",22856446,1,2,0,785,175,177,2
"801f9e9135034f49bf5f8b4bdefedb41","801f9e9135034f49bf5f8b4bdefedb41",22856446,4,0,1,786,177,177,0
"801f9e9135034f49bf5f8b4bdefedb41","b87c552dd247427abe6ab5795b9c9d43",22856446,1,5,0,790,177,181,4
"ea38cc0e6e6e41edbabf210220808bf9","362fcb0699a14845ab29b2340093e528",22856446,1,-6,0,792,179,174,-5
"362fcb0699a14845ab29b2340093e528","ea38cc0e6e6e41edbabf210220808bf9",22856446,1,6,0,793,174,179,5
"b87c552dd247427abe6ab5795b9c9d43","b87c552dd247427abe6ab5795b9c9d43",22856446,7,0,1,795,181,181,0
"b87c552dd247427abe6ab5795b9c9d43","139b097acfca451689d80c9c6eebdf7b",22856446,1,-3,0,802,181,178,-3
"139b097acfca451689d80c9c6eebdf7b","30f660a1feb34582a739722532524f79",22856446,1,6,0,803,178,183,5
"30f660a1feb34582a739722532524f79","30f660a1feb34582a739722532524f79",22856446,3,0,1,804,183,183,0
"30f660a1feb34582a739722532524f79","2024b4885bd14338a39b7b509acbbd02",22856446,1,-1,0,807,183,182,-1
"2024b4885bd14338a39b7b509acbbd02","c3f63fe50d8e487c86bf8ef76c9cadd3",22856446,1,4,0,808,182,185,3
"c3f63fe50d8e487c86bf8ef76c9cadd3","c3f63fe50d8e487c86bf8ef76c9cadd3",22856446,1,0,1,809,185,185,0
"c3f63fe50d8e487c86bf8ef76c9cadd3","0c7262dff33c4087bc660ccf40f92f9c",22856446,1,-20,0,810,185,169,-16
"0c7262dff33c4087bc660ccf40f92f9c","c8e371568a0c4391b25796ae4e91952e",22856446,2,23,0,811,169,186,17
"c8e371568a0c4391b25796ae4e91952e","7d932b23e1c84326ae5aa4d3c0d813d1",22856446,1,2,0,812,186,188,2
"7d932b23e1c84326ae5aa4d3c0d813d1","7d932b23e1c84326ae5aa4d3c0d813d1",22856446,1,0,1,813,188,188,0
"7d932b23e1c84326ae5aa4d3c0d813d1","c8e371568a0c4391b25796ae4e91952e",22856446,1,-2,0,814,188,186,-2
"c8e371568a0c4391b25796ae4e91952e","ab11d94c6c8948ea90b88f19d2cd502b",22856446,3,5,0,815,186,190,4
"ab11d94c6c8948ea90b88f19d2cd502b","07b44a7a51e94c78b411c753fc39dab0",22856446,1,-1,0,816,190,189,-1
"07b44a7a51e94c78b411c753fc39dab0","c8e371568a0c4391b25796ae4e91952e",22856446,1,-4,0,817,189,186,-3
"ab11d94c6c8948ea90b88f19d2cd502b","ab11d94c6c8948ea90b88f19d2cd502b",22856446,3,0,1,819,190,190,0
"ab11d94c6c8948ea90b88f19d2cd502b","f992451ed6ad4e68bb9e68ad6be7c4be",22856446,1,2,0,822,190,192,2
"f992451ed6ad4e68bb9e68ad6be7c4be","f992451ed6ad4e68bb9e68ad6be7c4be",22856446,1,0,1,823,192,192,0
"f992451ed6ad4e68bb9e68ad6be7c4be","6cd2dcaac46847d4a0bc53f296d90375",22856446,1,3,0,824,192,194,2
"6cd2dcaac46847d4a0bc53f296d90375","07b44a7a51e94c78b411c753fc39dab0",22856446,2,-6,0,825,194,189,-5
"07b44a7a51e94c78b411c753fc39dab0","6cd2dcaac46847d4a0bc53f296d90375",22856446,1,6,0,826,189,194,5
"6cd2dcaac46847d4a0bc53f296d90375","2d2580c9411c4972909db508d6956a58",22856446,1,2,0,827,194,196,2
"2d2580c9411c4972909db508d6956a58","2d2580c9411c4972909db508d6956a58",22856446,2,0,1,828,196,196,0
"2d2580c9411c4972909db508d6956a58","5bddb3d9ed264f3984702f048c7e5340",22856446,1,1,0,830,196,197,1
"5bddb3d9ed264f3984702f048c7e5340","5bddb3d9ed264f3984702f048c7e5340",22856446,2,0,1,831,197,197,0
"5bddb3d9ed264f3984702f048c7e5340","d5e8e2bd12a2466b9d6d90855f0eb079",22856446,1,1,0,833,197,198,1
"d5e8e2bd12a2466b9d6d90855f0eb079","d5e8e2bd12a2466b9d6d90855f0eb079",22856446,2,0,1,834,198,198,0
"d5e8e2bd12a2466b9d6d90855f0eb079","017d7ca8e0394b91aaadc9574df2202c",22856446,1,-5,0,836,198,193,-5
"017d7ca8e0394b91aaadc9574df2202c","54e8e9f0ea3e45c4bf3b8ac799ee31b1",22856446,1,8,0,837,193,200,7
"54e8e9f0ea3e45c4bf3b8ac799ee31b1","54e8e9f0ea3e45c4bf3b8ac799ee31b1",22856446,1,0,1,838,200,200,0
"54e8e9f0ea3e45c4bf3b8ac799ee31b1","c614a00911be4877a075f19315530fb0",22856446,1,1,0,839,200,201,1
"c614a00911be4877a075f19315530fb0","c614a00911be4877a075f19315530fb0",22856446,6,0,1,840,201,201,0
"c614a00911be4877a075f19315530fb0","a6c21bd8b95249c7972820a7a7d76aff",22856446,1,1,0,846,201,202,1
"a6c21bd8b95249c7972820a7a7d76aff","a6c21bd8b95249c7972820a7a7d76aff",22856446,1,0,1,847,202,202,0
"a6c21bd8b95249c7972820a7a7d76aff","bb329d880ab54120adaf203a693bb203",22856446,1,1,0,848,202,203,1
"bb329d880ab54120adaf203a693bb203","bb329d880ab54120adaf203a693bb203",22856446,1,0,1,849,203,203,0
"bb329d880ab54120adaf203a693bb203","f9170dd6bc6442b4acd832747609b09a",22856446,1,-4,0,850,203,199,-4
"f9170dd6bc6442b4acd832747609b09a","334c2344009840079b1d0e1b7ce3d5a7",22856446,1,7,0,851,199,205,6
"334c2344009840079b1d0e1b7ce3d5a7","334c2344009840079b1d0e1b7ce3d5a7",22856446,1,0,1,852,205,205,0
"334c2344009840079b1d0e1b7ce3d5a7","d7f13c8d63ec4e2aa673fbb9cf9c6933",22856446,1,3,0,853,205,206,1
"d7f13c8d63ec4e2aa673fbb9cf9c6933","c8e371568a0c4391b25796ae4e91952e",22856446,2,-26,0,854,206,186,-20
"c8e371568a0c4391b25796ae4e91952e","b9e80f77c3a44349863b19875725c384",22856446,1,27,0,855,186,207,21
"b9e80f77c3a44349863b19875725c384","7108f0e4c2584f1f9c471689ae4c885c",22856446,4,1,0,856,207,208,1
"7108f0e4c2584f1f9c471689ae4c885c","0c7262dff33c4087bc660ccf40f92f9c",22856446,2,-51,0,857,208,169,-39
"64d48c6c9c7940639a932219a6c87198","d7f13c8d63ec4e2aa673fbb9cf9c6933",22856446,1,217,0,860,40,206,166
"d7f13c8d63ec4e2aa673fbb9cf9c6933","d7f13c8d63ec4e2aa673fbb9cf9c6933",22856446,2,0,1,861,206,206,0
"d7f13c8d63ec4e2aa673fbb9cf9c6933","b9e80f77c3a44349863b19875725c384",22856446,2,1,0,862,206,207,1
"0c7262dff33c4087bc660ccf40f92f9c","d7f13c8d63ec4e2aa673fbb9cf9c6933",22856446,1,49,0,865,169,206,37
"7108f0e4c2584f1f9c471689ae4c885c","b9e80f77c3a44349863b19875725c384",22856446,2,-1,0,869,208,207,-1
"b9e80f77c3a44349863b19875725c384","b9e80f77c3a44349863b19875725c384",22856446,24,0,1,870,207,207,0
"7108f0e4c2584f1f9c471689ae4c885c","7108f0e4c2584f1f9c471689ae4c885c",22856446,13,0,1,895,208,208,0
"7108f0e4c2584f1f9c471689ae4c885c","d7f13c8d63ec4e2aa673fbb9cf9c6933",22856446,1,-2,0,908,208,206,-2
"d7f13c8d63ec4e2aa673fbb9cf9c6933","09400e101c5d4b439cf9a26b03aae558",22856446,2,5,0,909,206,210,4
"09400e101c5d4b439cf9a26b03aae558","09400e101c5d4b439cf9a26b03aae558",22856446,1,0,1,910,210,210,0
"09400e101c5d4b439cf9a26b03aae558","a88efa7e50ce47159810ab553afa6d3a",22856446,1,2,0,911,210,212,2
"a88efa7e50ce47159810ab553afa6d3a","a88efa7e50ce47159810ab553afa6d3a",22856446,5,0,1,912,212,212,0
"a88efa7e50ce47159810ab553afa6d3a","be502a7a43c44bf7b682698de79d9369",22856446,1,3,0,917,212,214,2
"be502a7a43c44bf7b682698de79d9369","a875096404ef4a9984b62d74cda916f9",22856446,1,-6,0,918,214,209,-5
"a875096404ef4a9984b62d74cda916f9","f7fb1952f56b4189b86a9f8b7862d2b8",22856446,1,7,0,919,209,215,6
"f7fb1952f56b4189b86a9f8b7862d2b8","be502a7a43c44bf7b682698de79d9369",22856446,2,-1,0,920,215,214,-1
"be502a7a43c44bf7b682698de79d9369","be502a7a43c44bf7b682698de79d9369",22856446,1,0,1,921,214,214,0
"be502a7a43c44bf7b682698de79d9369","f7fb1952f56b4189b86a9f8b7862d2b8",22856446,1,1,0,922,214,215,1
"f7fb1952f56b4189b86a9f8b7862d2b8","f7fb1952f56b4189b86a9f8b7862d2b8",22856446,13,0,1,923,215,215,0
"f7fb1952f56b4189b86a9f8b7862d2b8","b860ee85d8bc4a2f97958cfb71be3533",22856446,1,1,0,936,215,216,1
"b860ee85d8bc4a2f97958cfb71be3533","b860ee85d8bc4a2f97958cfb71be3533",22856446,2,0,1,937,216,216,0
"b860ee85d8bc4a2f97958cfb71be3533","363837c182e04711840d896ae1e0339c",22856446,1,3,0,939,216,218,2
"363837c182e04711840d896ae1e0339c","ec341f459285443b8361f7f15638ff08",22856446,1,-6,0,940,218,213,-5
"ec341f459285443b8361f7f15638ff08","363837c182e04711840d896ae1e0339c",22856446,1,6,0,941,213,218,5
"363837c182e04711840d896ae1e0339c","363837c182e04711840d896ae1e0339c",22856446,13,0,1,942,218,218,0
"363837c182e04711840d896ae1e0339c","01b2051f8941460d89945e3b02d1ce78",22856446,2,-1,0,955,218,217,-1
"01b2051f8941460d89945e3b02d1ce78","91125ca626c5470eb145501f8c37f8db",22856446,2,4,0,956,217,220,3
"91125ca626c5470eb145501f8c37f8db","1c6721b1f63f4d30ba7746ea8af02a52",22856446,1,3,0,957,220,221,1
"1c6721b1f63f4d30ba7746ea8af02a52","d7f13c8d63ec4e2aa673fbb9cf9c6933",22856446,1,-21,0,958,221,206,-15
"d7f13c8d63ec4e2aa673fbb9cf9c6933","77ecef8eff6b4a2caea7707669bf7475",22856446,1,22,0,959,206,222,16
"77ecef8eff6b4a2caea7707669bf7475","0c7262dff33c4087bc660ccf40f92f9c",22856446,1,-71,0,960,222,169,-53
"64d48c6c9c7940639a932219a6c87198","0c7262dff33c4087bc660ccf40f92f9c",22856446,1,168,0,963,40,169,129
"c8e371568a0c4391b25796ae4e91952e","c8e371568a0c4391b25796ae4e91952e",22856446,1,0,1,966,186,186,0
"ab11d94c6c8948ea90b88f19d2cd502b","6cd2dcaac46847d4a0bc53f296d90375",22856446,1,5,0,968,190,194,4
"07b44a7a51e94c78b411c753fc39dab0","017d7ca8e0394b91aaadc9574df2202c",22856446,1,5,0,970,189,193,4
"017d7ca8e0394b91aaadc9574df2202c","f9170dd6bc6442b4acd832747609b09a",22856446,1,7,0,971,193,199,6
"f9170dd6bc6442b4acd832747609b09a","d7f13c8d63ec4e2aa673fbb9cf9c6933",22856446,1,10,0,972,199,206,7
"c8e371568a0c4391b25796ae4e91952e","7108f0e4c2584f1f9c471689ae4c885c",22856446,1,28,0,974,186,208,22
"b9e80f77c3a44349863b19875725c384","d7f13c8d63ec4e2aa673fbb9cf9c6933",22856446,1,-1,0,976,207,206,-1
"09400e101c5d4b439cf9a26b03aae558","a875096404ef4a9984b62d74cda916f9",22856446,1,-1,0,978,210,209,-1
"a875096404ef4a9984b62d74cda916f9","ec341f459285443b8361f7f15638ff08",22856446,1,5,0,979,209,213,4
"ec341f459285443b8361f7f15638ff08","f7fb1952f56b4189b86a9f8b7862d2b8",22856446,1,2,0,980,213,215,2
"be502a7a43c44bf7b682698de79d9369","363837c182e04711840d896ae1e0339c",22856446,1,5,0,982,214,218,4
"91125ca626c5470eb145501f8c37f8db","91125ca626c5470eb145501f8c37f8db",22856446,1,0,1,985,220,220,0
"91125ca626c5470eb145501f8c37f8db","d7f13c8d63ec4e2aa673fbb9cf9c6933",22856446,1,-18,0,986,220,206,-14
"d7f13c8d63ec4e2aa673fbb9cf9c6933","1c6721b1f63f4d30ba7746ea8af02a52",22856446,1,21,0,987,206,221,15
"1c6721b1f63f4d30ba7746ea8af02a52","77ecef8eff6b4a2caea7707669bf7475",22856446,1,1,0,988,221,222,1
"77ecef8eff6b4a2caea7707669bf7475","77ecef8eff6b4a2caea7707669bf7475",22856446,12,0,1,1000,222,222,0
"77ecef8eff6b4a2caea7707669bf7475","d03cb855c70044cf8c35d9ec0de696e3",22856446,1,3,0,1001,222,224,2
"d03cb855c70044cf8c35d9ec0de696e3","1c6721b1f63f4d30ba7746ea8af02a52",22856446,1,-4,0,1002,224,221,-3
"1c6721b1f63f4d30ba7746ea8af02a52","8b9ae98743bd4d4a8a87dff1c1244211",22856446,1,7,0,1003,221,227,6
"8b9ae98743bd4d4a8a87dff1c1244211","d03cb855c70044cf8c35d9ec0de696e3",22856446,3,-3,0,1004,227,224,-3
"d03cb855c70044cf8c35d9ec0de696e3","a49a937d6896486d9a5396654abcf2e1",22856446,1,2,0,1005,224,226,2
"a49a937d6896486d9a5396654abcf2e1","a49a937d6896486d9a5396654abcf2e1",22856446,1,0,1,1006,226,226,0
"a49a937d6896486d9a5396654abcf2e1","8b9ae98743bd4d4a8a87dff1c1244211",22856446,1,1,0,1007,226,227,1
"8b9ae98743bd4d4a8a87dff1c1244211","8b9ae98743bd4d4a8a87dff1c1244211",22856446,13,0,1,1008,227,227,0
"8b9ae98743bd4d4a8a87dff1c1244211","f7906d6f59b9489a91d2ef40db5a474d",22856446,3,-4,0,1021,227,223,-4
"f7906d6f59b9489a91d2ef40db5a474d","2ab1535aac1346ba8801535bf729ef37",22856446,3,7,0,1022,223,229,6
"2ab1535aac1346ba8801535bf729ef37","d03cb855c70044cf8c35d9ec0de696e3",22856446,2,-6,0,1023,229,224,-5
"d03cb855c70044cf8c35d9ec0de696e3","5152833676bf4c6cb317060be10f68db",22856446,2,5,0,1024,224,228,4
"5152833676bf4c6cb317060be10f68db","8b9ae98743bd4d4a8a87dff1c1244211",22856446,2,-2,0,1025,228,227,-1
"2ab1535aac1346ba8801535bf729ef37","2ab1535aac1346ba8801535bf729ef37",22856446,3,0,1,1028,229,229,0
"2ab1535aac1346ba8801535bf729ef37","a4f40fb48a8542c8949bae1f002cd9bc",22856446,1,2,0,1031,229,231,2
"a4f40fb48a8542c8949bae1f002cd9bc","a4f40fb48a8542c8949bae1f002cd9bc",22856446,2,0,1,1032,231,231,0
"a4f40fb48a8542c8949bae1f002cd9bc","8972c23e32044edb8a78fa1eed4e5947",22856446,1,1,0,1034,231,232,1
"8972c23e32044edb8a78fa1eed4e5947","8972c23e32044edb8a78fa1eed4e5947",22856446,1,0,1,1035,232,232,0
"8972c23e32044edb8a78fa1eed4e5947","92feb4a40f8344d38b6f722e42a53295",22856446,1,1,0,1036,232,233,1
"92feb4a40f8344d38b6f722e42a53295","92feb4a40f8344d38b6f722e42a53295",22856446,2,0,1,1037,233,233,0
"92feb4a40f8344d38b6f722e42a53295","5152833676bf4c6cb317060be10f68db",22856446,1,-5,0,1039,233,228,-5
"5152833676bf4c6cb317060be10f68db","ca3e28f290354c08aefe5b0f769604e6",22856446,1,8,0,1040,228,235,7
"ca3e28f290354c08aefe5b0f769604e6","ca3e28f290354c08aefe5b0f769604e6",22856446,4,0,1,1041,235,235,0
"ca3e28f290354c08aefe5b0f769604e6","79a35eea833e4c2c9d22fc53c3c6445c",22856446,1,1,0,1045,235,236,1
"79a35eea833e4c2c9d22fc53c3c6445c","79a35eea833e4c2c9d22fc53c3c6445c",22856446,4,0,1,1046,236,236,0
"79a35eea833e4c2c9d22fc53c3c6445c","8f68228b1518449e9615cdafee41a2bd",22856446,1,1,0,1050,236,237,1
"8f68228b1518449e9615cdafee41a2bd","8f68228b1518449e9615cdafee41a2bd",22856446,1,0,1,1051,237,237,0
"8f68228b1518449e9615cdafee41a2bd","cab89fa5c3ed45a5aa550fc0352d6a42",22856446,1,1,0,1052,237,238,1
"cab89fa5c3ed45a5aa550fc0352d6a42","cab89fa5c3ed45a5aa550fc0352d6a42",22856446,1,0,1,1053,238,238,0
"cab89fa5c3ed45a5aa550fc0352d6a42","66d4fad4f1cf4b46be0750a99ad7a35a",22856446,1,1,0,1054,238,239,1
"66d4fad4f1cf4b46be0750a99ad7a35a","66d4fad4f1cf4b46be0750a99ad7a35a",22856446,1,0,1,1055,239,239,0
"66d4fad4f1cf4b46be0750a99ad7a35a","0b04c8e2f86d48c7aeb7e225819cd32b",22856446,1,-5,0,1056,239,234,-5
"0b04c8e2f86d48c7aeb7e225819cd32b","f53da5fd9bfe412da4b80d4742563b6c",22856446,1,8,0,1057,234,241,7
"f53da5fd9bfe412da4b80d4742563b6c","f53da5fd9bfe412da4b80d4742563b6c",22856446,1,0,1,1058,241,241,0
"f53da5fd9bfe412da4b80d4742563b6c","1c6721b1f63f4d30ba7746ea8af02a52",22856446,1,-24,0,1059,241,221,-20
"1c6721b1f63f4d30ba7746ea8af02a52","2ae94c0cea4d480a9d5dca8fb1d7b542",22856446,1,27,0,1060,221,242,21
"2ae94c0cea4d480a9d5dca8fb1d7b542","1ebf23f9d994469a85206e4c7b1bf5f5",22856446,1,3,0,1061,242,245,3
"1ebf23f9d994469a85206e4c7b1bf5f5","0c7262dff33c4087bc660ccf40f92f9c",22856446,1,-100,0,1062,245,169,-76
"0c7262dff33c4087bc660ccf40f92f9c","0d987bed3ffa4ed0b9a2e62e97b7b30f",22856446,2,135,0,1063,169,272,103
"0d987bed3ffa4ed0b9a2e62e97b7b30f","bc5524e78a8544e2ae2fdc2f3462bbec",22856446,1,9,0,1064,272,279,7
"bc5524e78a8544e2ae2fdc2f3462bbec","bb5a47f5ea01454a8b79455422d3b9da",22856446,2,1,0,1065,279,280,1
"bb5a47f5ea01454a8b79455422d3b9da","bb5a47f5ea01454a8b79455422d3b9da",22856446,90,0,1,1066,280,280,0
"bb5a47f5ea01454a8b79455422d3b9da","0c7262dff33c4087bc660ccf40f92f9c",22856446,1,-145,0,1073,280,169,-111
"0c7262dff33c4087bc660ccf40f92f9c","67a089198fcb4e1c8f2385786c2b296f",22856446,3,-169,0,1074,169,39,-130
"67a089198fcb4e1c8f2385786c2b296f","64d48c6c9c7940639a932219a6c87198",22856446,13,1,0,1075,39,40,1
"64d48c6c9c7940639a932219a6c87198","64dbedb3ce544f6aae8e10e0cf10f16d",22856446,1,261,0,1076,40,240,200
"64dbedb3ce544f6aae8e10e0cf10f16d","1c6721b1f63f4d30ba7746ea8af02a52",22856446,1,-23,0,1077,240,221,-19
"1c6721b1f63f4d30ba7746ea8af02a52","64dbedb3ce544f6aae8e10e0cf10f16d",22856446,1,23,0,1078,221,240,19
"64dbedb3ce544f6aae8e10e0cf10f16d","d03cb855c70044cf8c35d9ec0de696e3",22856446,1,-19,0,1079,240,224,-16
"d03cb855c70044cf8c35d9ec0de696e3","8b9ae98743bd4d4a8a87dff1c1244211",22856446,2,3,0,1080,224,227,3
"f7906d6f59b9489a91d2ef40db5a474d","2ae94c0cea4d480a9d5dca8fb1d7b542",22856446,1,24,0,1082,223,242,19
"2ae94c0cea4d480a9d5dca8fb1d7b542","1c6721b1f63f4d30ba7746ea8af02a52",22856446,1,-27,0,1083,242,221,-21
"1c6721b1f63f4d30ba7746ea8af02a52","1ebf23f9d994469a85206e4c7b1bf5f5",22856446,1,30,0,1084,221,245,24
"1ebf23f9d994469a85206e4c7b1bf5f5","1ebf23f9d994469a85206e4c7b1bf5f5",22856446,12,0,1,1085,245,245,0
"1ebf23f9d994469a85206e4c7b1bf5f5","85ae675b83e8422da842cfd25596af99",22856446,1,1,0,1097,245,246,1
"85ae675b83e8422da842cfd25596af99","85ae675b83e8422da842cfd25596af99",22856446,1,0,1,1098,246,246,0
"85ae675b83e8422da842cfd25596af99","2ae94c0cea4d480a9d5dca8fb1d7b542",22856446,1,-4,0,1099,246,242,-4
"2ae94c0cea4d480a9d5dca8fb1d7b542","fa235f0f364d47e4ae1c87f47bf8e6ba",22856446,1,12,0,1100,242,252,10
"fa235f0f364d47e4ae1c87f47bf8e6ba","fa235f0f364d47e4ae1c87f47bf8e6ba",22856446,3,0,1,1101,252,252,0
"fa235f0f364d47e4ae1c87f47bf8e6ba","79f7845465cc4ed19d8e4f1429541be0",22856446,1,2,0,1104,252,254,2
"79f7845465cc4ed19d8e4f1429541be0","79f7845465cc4ed19d8e4f1429541be0",22856446,2,0,1,1105,254,254,0
"79f7845465cc4ed19d8e4f1429541be0","00f61990949545828dd12f1303d47504",22856446,1,3,0,1107,254,256,2
"00f61990949545828dd12f1303d47504","6e83e23f56544a19b94067c1c558d9c0",22856446,1,-11,0,1108,256,247,-9
"6e83e23f56544a19b94067c1c558d9c0","00f61990949545828dd12f1303d47504",22856446,2,11,0,1109,247,256,9
"00f61990949545828dd12f1303d47504","00f61990949545828dd12f1303d47504",22856446,1,0,1,1110,256,256,0
"00f61990949545828dd12f1303d47504","ead7bb4b64e247d2ae632ab8a296b091",22856446,1,2,0,1111,256,258,2
"ead7bb4b64e247d2ae632ab8a296b091","ead7bb4b64e247d2ae632ab8a296b091",22856446,2,0,1,1112,258,258,0
"ead7bb4b64e247d2ae632ab8a296b091","41b0048dde734bb280bac6116baa8e27",22856446,1,1,0,1114,258,259,1
"41b0048dde734bb280bac6116baa8e27","41b0048dde734bb280bac6116baa8e27",22856446,2,0,1,1115,259,259,0
"41b0048dde734bb280bac6116baa8e27","b41c5a094a604ee0915327da5cc0beb7",22856446,1,1,0,1117,259,260,1
"b41c5a094a604ee0915327da5cc0beb7","b41c5a094a604ee0915327da5cc0beb7",22856446,2,0,1,1118,260,260,0
"b41c5a094a604ee0915327da5cc0beb7","d546341988904f069cfa86b21457d9d9",22856446,1,-10,0,1120,260,251,-9
"d546341988904f069cfa86b21457d9d9","28c171777c52431ab6b925073bd63d46",22856446,1,15,0,1121,251,264,13
"28c171777c52431ab6b925073bd63d46","28c171777c52431ab6b925073bd63d46",22856446,7,0,1,1122,264,264,0
"28c171777c52431ab6b925073bd63d46","ac160db940cb49ae8579162b1d52bb5d",22856446,1,2,0,1129,264,266,2
"ac160db940cb49ae8579162b1d52bb5d","ac160db940cb49ae8579162b1d52bb5d",22856446,3,0,1,1130,266,266,0
"ac160db940cb49ae8579162b1d52bb5d","d989ebcfc12a4b669f0100dc1aa14f1e",22856446,1,-12,0,1133,266,255,-11
"d989ebcfc12a4b669f0100dc1aa14f1e","c6fd49b485cc4874b0bbdd9c6171e09c",22856446,1,15,0,1134,255,268,13
"c6fd49b485cc4874b0bbdd9c6171e09c","c6fd49b485cc4874b0bbdd9c6171e09c",22856446,3,0,1,1135,268,268,0
"c6fd49b485cc4874b0bbdd9c6171e09c","44240778a97c4af0937817499b75707b",22856446,1,1,0,1138,268,269,1
"44240778a97c4af0937817499b75707b","44240778a97c4af0937817499b75707b",22856446,5,0,1,1139,269,269,0
"44240778a97c4af0937817499b75707b","7aa76d3e993840d8805f097cbdbcd44b",22856446,1,-9,0,1144,269,261,-8
"7aa76d3e993840d8805f097cbdbcd44b","7028800abe7d4e27b613d1d6cbe26bf7",22856446,1,7,0,1145,261,267,6
"7028800abe7d4e27b613d1d6cbe26bf7","7aa76d3e993840d8805f097cbdbcd44b",22856446,2,-7,0,1146,267,261,-6
"7aa76d3e993840d8805f097cbdbcd44b","865a4d3b43374da7944dc7d397f566d9",22856446,1,12,0,1147,261,271,10
"865a4d3b43374da7944dc7d397f566d9","865a4d3b43374da7944dc7d397f566d9",22856446,1,0,1,1148,271,271,0
"865a4d3b43374da7944dc7d397f566d9","0d987bed3ffa4ed0b9a2e62e97b7b30f",22856446,1,3,0,1149,271,272,1
"0d987bed3ffa4ed0b9a2e62e97b7b30f","2ae94c0cea4d480a9d5dca8fb1d7b542",22856446,3,-38,0,1150,272,242,-30
"2ae94c0cea4d480a9d5dca8fb1d7b542","2ae94c0cea4d480a9d5dca8fb1d7b542",22856446,1,0,1,1151,242,242,0
"2ae94c0cea4d480a9d5dca8fb1d7b542","0d987bed3ffa4ed0b9a2e62e97b7b30f",22856446,4,38,0,1152,242,272,30
"0d987bed3ffa4ed0b9a2e62e97b7b30f","7028800abe7d4e27b613d1d6cbe26bf7",22856446,1,-8,0,1153,272,267,-5
"7aa76d3e993840d8805f097cbdbcd44b","2ae94c0cea4d480a9d5dca8fb1d7b542",22856446,1,-23,0,1155,261,242,-19
"0d987bed3ffa4ed0b9a2e62e97b7b30f","0d987bed3ffa4ed0b9a2e62e97b7b30f",22856446,5,0,1,1157,272,272,0
"0d987bed3ffa4ed0b9a2e62e97b7b30f","82ae07bc0c9b4570a41799290d1ef399",22856446,4,4,0,1158,272,275,3
"82ae07bc0c9b4570a41799290d1ef399","0d987bed3ffa4ed0b9a2e62e97b7b30f",22856446,4,-4,0,1159,275,272,-3
"82ae07bc0c9b4570a41799290d1ef399","82ae07bc0c9b4570a41799290d1ef399",22856446,1,0,1,1161,275,275,0
"0d987bed3ffa4ed0b9a2e62e97b7b30f","bb5a47f5ea01454a8b79455422d3b9da",22856446,3,10,0,1173,272,280,8
"bb5a47f5ea01454a8b79455422d3b9da","82ae07bc0c9b4570a41799290d1ef399",22856446,3,-6,0,1178,280,275,-5
"82ae07bc0c9b4570a41799290d1ef399","bb5a47f5ea01454a8b79455422d3b9da",22856446,3,6,0,1179,275,280,5
"bb5a47f5ea01454a8b79455422d3b9da","bc5524e78a8544e2ae2fdc2f3462bbec",22856446,2,-1,0,1182,280,279,-1
"bc5524e78a8544e2ae2fdc2f3462bbec","67a089198fcb4e1c8f2385786c2b296f",22856446,1,-313,0,1183,279,39,-240
"64d48c6c9c7940639a932219a6c87198","94cecc3f1e7d484b8e068e79241dfd73",22856446,1,316,0,1185,40,281,241
"94cecc3f1e7d484b8e068e79241dfd73","94cecc3f1e7d484b8e068e79241dfd73",22856446,1,0,1,1186,281,281,0
"94cecc3f1e7d484b8e068e79241dfd73","a37477c4e4c14169ad44b06b493007f6",22856446,3,2,0,1187,281,283,2
"a37477c4e4c14169ad44b06b493007f6","fab84b4fab5940efb4ea868ef8d09396",22856446,1,3,0,1188,283,284,1
"fab84b4fab5940efb4ea868ef8d09396","fab84b4fab5940efb4ea868ef8d09396",22856446,1,0,1,1189,284,284,0
"fab84b4fab5940efb4ea868ef8d09396","4a29443515bb404cb8924e1c60a63b73",22856446,2,4,0,1190,284,285,1
"4a29443515bb404cb8924e1c60a63b73","fab84b4fab5940efb4ea868ef8d09396",22856446,1,-4,0,1191,285,284,-1
"fab84b4fab5940efb4ea868ef8d09396","208c9b2796c944db8dacaa96082520ea",22856446,1,7,0,1192,284,288,4
"208c9b2796c944db8dacaa96082520ea","e2911e79efc2420eac45d9f671463d4b",22856446,1,-398,0,1193,288,2,-286
"e2911e79efc2420eac45d9f671463d4b","e2911e79efc2420eac45d9f671463d4b",22856446,3,0,1,1194,2,2,0
"e2911e79efc2420eac45d9f671463d4b","eb2a0eb537344a9e891c761662e400b6",22856446,1,20,0,1195,2,16,14
"eb2a0eb537344a9e891c761662e400b6","56586aa865414f538729c7f7735d2bc6",22856446,1,-8,0,1196,16,12,-4
"56586aa865414f538729c7f7735d2bc6","5c5ceeee4562457ba6d41515aeebfbb1",22856446,2,10,0,1197,12,17,5
"5c5ceeee4562457ba6d41515aeebfbb1","b613861cecf84ffcab01afb23f660475",22856446,1,-25,0,1198,17,1,-16
"b613861cecf84ffcab01afb23f660475","56586aa865414f538729c7f7735d2bc6",22856446,1,15,0,1199,1,12,11
"56586aa865414f538729c7f7735d2bc6","eb2a0eb537344a9e891c761662e400b6",22856446,1,8,0,1200,12,16,4
"eb2a0eb537344a9e891c761662e400b6","5c5ceeee4562457ba6d41515aeebfbb1",22856446,1,2,0,1201,16,17,1
"5c5ceeee4562457ba6d41515aeebfbb1","eb2a0eb537344a9e891c761662e400b6",22856446,1,-2,0,1202,17,16,-1
"eb2a0eb537344a9e891c761662e400b6","4a29443515bb404cb8924e1c60a63b73",22856446,1,375,0,1203,16,285,269
"4a29443515bb404cb8924e1c60a63b73","4a29443515bb404cb8924e1c60a63b73",22856446,5,0,1,1204,285,285,0
"4a29443515bb404cb8924e1c60a63b73","208c9b2796c944db8dacaa96082520ea",22856446,2,3,0,1205,285,288,3
"208c9b2796c944db8dacaa96082520ea","4a29443515bb404cb8924e1c60a63b73",22856446,2,-3,0,1206,288,285,-3
"208c9b2796c944db8dacaa96082520ea","208c9b2796c944db8dacaa96082520ea",22856446,2,0,1,1210,288,288,0
"4a29443515bb404cb8924e1c60a63b73","6a9a3b5bde4a48daa896fe8c06eca56f",22856446,2,5,0,1215,285,289,4
"6a9a3b5bde4a48daa896fe8c06eca56f","7669a956527947d0add87455277e80b4",22856446,1,2,0,1216,289,291,2
"7669a956527947d0add87455277e80b4","7669a956527947d0add87455277e80b4",22856446,1,0,1,1217,291,291,0
"7669a956527947d0add87455277e80b4","6a9a3b5bde4a48daa896fe8c06eca56f",22856446,1,-2,0,1218,291,289,-2
"6a9a3b5bde4a48daa896fe8c06eca56f","869e967078f04da18dd0b0b9389a7424",22856446,2,5,0,1219,289,293,4
"869e967078f04da18dd0b0b9389a7424","869e967078f04da18dd0b0b9389a7424",22856446,4,0,1,1220,293,293,0
"869e967078f04da18dd0b0b9389a7424","34a6e49023fc4465bd5ca604330bbd1c",22856446,2,-1,0,1224,293,292,-1
"34a6e49023fc4465bd5ca604330bbd1c","21592f2a9e9c4b2f8c66ec5dbcbf6a2b",22856446,2,5,0,1225,292,296,4
"21592f2a9e9c4b2f8c66ec5dbcbf6a2b","869e967078f04da18dd0b0b9389a7424",22856446,1,-4,0,1226,296,293,-3
"869e967078f04da18dd0b0b9389a7424","51ab6291537748fab90d519aa09889d6",22856446,1,2,0,1227,293,295,2
"51ab6291537748fab90d519aa09889d6","51ab6291537748fab90d519aa09889d6",22856446,5,0,1,1228,295,295,0
"51ab6291537748fab90d519aa09889d6","34a6e49023fc4465bd5ca604330bbd1c",22856446,1,-3,0,1233,295,292,-3
"21592f2a9e9c4b2f8c66ec5dbcbf6a2b","ba0e59461bfb4a44b7b1c28a01f8d3b3",22856446,1,4,0,1235,296,299,3
"ba0e59461bfb4a44b7b1c28a01f8d3b3","ba0e59461bfb4a44b7b1c28a01f8d3b3",22856446,14,0,1,1236,299,299,0
"ba0e59461bfb4a44b7b1c28a01f8d3b3","0e0b36e731a645e7b1b8a88f5031ca38",22856446,1,2,0,1238,299,301,2
"0e0b36e731a645e7b1b8a88f5031ca38","0e0b36e731a645e7b1b8a88f5031ca38",22856446,2,0,1,1239,301,301,0
"0e0b36e731a645e7b1b8a88f5031ca38","a66a144637284c21afc6de17fea4bfb8",22856446,1,1,0,1241,301,302,1
"a66a144637284c21afc6de17fea4bfb8","a66a144637284c21afc6de17fea4bfb8",22856446,2,0,1,1242,302,302,0
"a66a144637284c21afc6de17fea4bfb8","7646a919d7e64fa990bca9b024ff089d",22856446,1,-4,0,1244,302,298,-4
"7646a919d7e64fa990bca9b024ff089d","e390b575229748ea8aac9364efe2bf00",22856446,1,7,0,1245,298,304,6
"e390b575229748ea8aac9364efe2bf00","e390b575229748ea8aac9364efe2bf00",22856446,1,0,1,1246,304,304,0
"e390b575229748ea8aac9364efe2bf00","4a29443515bb404cb8924e1c60a63b73",22856446,1,-24,0,1247,304,285,-19
"4a29443515bb404cb8924e1c60a63b73","3434c10e561d488a914e0f7d71907abd",22856446,2,27,0,1248,285,305,20
"3434c10e561d488a914e0f7d71907abd","53e7e900392747ccad52e711ab0f80d8",22856446,2,2,0,1249,305,307,2
"53e7e900392747ccad52e711ab0f80d8","53e7e900392747ccad52e711ab0f80d8",22856446,1,0,1,1250,307,307,0
"53e7e900392747ccad52e711ab0f80d8","3434c10e561d488a914e0f7d71907abd",22856446,2,-2,0,1251,307,305,-2
"3434c10e561d488a914e0f7d71907abd","130acc2aeb0448fdbb2de63bc5cebe5b",22856446,2,5,0,1252,305,309,4
"130acc2aeb0448fdbb2de63bc5cebe5b","130acc2aeb0448fdbb2de63bc5cebe5b",22856446,2,0,1,1253,309,309,0
"130acc2aeb0448fdbb2de63bc5cebe5b","9c062b3251034ebe90f5054e2a3b5120",22856446,1,2,0,1255,309,311,2
"9c062b3251034ebe90f5054e2a3b5120","9c062b3251034ebe90f5054e2a3b5120",22856446,2,0,1,1256,311,311,0
"9c062b3251034ebe90f5054e2a3b5120","ea859f8207e44537889daeaba13ac2e8",22856446,1,1,0,1258,311,312,1
"ea859f8207e44537889daeaba13ac2e8","ea859f8207e44537889daeaba13ac2e8",22856446,1,0,1,1259,312,312,0
"ea859f8207e44537889daeaba13ac2e8","4a29443515bb404cb8924e1c60a63b73",22856446,1,-35,0,1260,312,285,-27
"34a6e49023fc4465bd5ca604330bbd1c","ba0e59461bfb4a44b7b1c28a01f8d3b3",22856446,1,9,0,1264,292,299,7
"ba0e59461bfb4a44b7b1c28a01f8d3b3","7646a919d7e64fa990bca9b024ff089d",22856446,4,-1,0,1265,299,298,-1
"7646a919d7e64fa990bca9b024ff089d","4a29443515bb404cb8924e1c60a63b73",22856446,3,-17,0,1266,298,285,-13
"130acc2aeb0448fdbb2de63bc5cebe5b","56d94971a7a94257aa330183a8ebd0ea",22856446,1,4,0,1271,309,313,4
"56d94971a7a94257aa330183a8ebd0ea","56d94971a7a94257aa330183a8ebd0ea",22856446,1,0,1,1272,313,313,0
"56d94971a7a94257aa330183a8ebd0ea","141c0df6cd1946539aadd1c9b7068cd4",22856446,1,-5,0,1273,313,308,-5
"141c0df6cd1946539aadd1c9b7068cd4","13255e63e0aa4abf85e5211bf613d43e",22856446,1,10,0,1274,308,317,9
"13255e63e0aa4abf85e5211bf613d43e","13255e63e0aa4abf85e5211bf613d43e",22856446,1,0,1,1275,317,317,0
"13255e63e0aa4abf85e5211bf613d43e","86c27d40179e419c8e9d150fb6afa5d0",22856446,1,3,0,1276,317,319,2
"86c27d40179e419c8e9d150fb6afa5d0","0c787d16c9504873b1a4d903cec09948",22856446,1,-6,0,1277,319,314,-5
"0c787d16c9504873b1a4d903cec09948","86c27d40179e419c8e9d150fb6afa5d0",22856446,1,6,0,1278,314,319,5
"86c27d40179e419c8e9d150fb6afa5d0","86c27d40179e419c8e9d150fb6afa5d0",22856446,1,0,1,1279,319,319,0
"86c27d40179e419c8e9d150fb6afa5d0","47edbb64109243e6b0f8f64cdef90c6c",22856446,1,8,0,1280,319,326,7
"47edbb64109243e6b0f8f64cdef90c6c","8d7e0b55cf9849cda222a0f2440cec55",22856446,1,-9,0,1281,326,318,-8
"8d7e0b55cf9849cda222a0f2440cec55","24f1363179ad4aaa965484a78471912b",22856446,1,6,0,1282,318,323,5
"24f1363179ad4aaa965484a78471912b","24f1363179ad4aaa965484a78471912b",22856446,2,0,1,1283,323,323,0
"24f1363179ad4aaa965484a78471912b","3628bdce1dd2429ba924d2d4d09448d2",22856446,1,-1,0,1285,323,322,-1
"3628bdce1dd2429ba924d2d4d09448d2","56b3fd1a212a4764be39d979fde3326e",22856446,1,7,0,1286,322,328,6
"56b3fd1a212a4764be39d979fde3326e","56b3fd1a212a4764be39d979fde3326e",22856446,1,0,1,1287,328,328,0
"56b3fd1a212a4764be39d979fde3326e","3434c10e561d488a914e0f7d71907abd",22856446,1,-28,0,1288,328,305,-23
"3434c10e561d488a914e0f7d71907abd","0c4079457ede49e3aeb5e86ed84bdf35",22856446,1,31,0,1289,305,329,24
"0c4079457ede49e3aeb5e86ed84bdf35","38aea304b4fa46e1b29bb72f5cea4c93",22856446,1,2,0,1290,329,331,2
"38aea304b4fa46e1b29bb72f5cea4c93","38aea304b4fa46e1b29bb72f5cea4c93",22856446,1,0,1,1291,331,331,0
"38aea304b4fa46e1b29bb72f5cea4c93","e36d261332f14e79bb4b467aceaeb9b5",22856446,1,2,0,1292,331,333,2
"e36d261332f14e79bb4b467aceaeb9b5","e36d261332f14e79bb4b467aceaeb9b5",22856446,1,0,1,1293,333,333,0
"e36d261332f14e79bb4b467aceaeb9b5","c7e89b9d04744d2eab742fc24e3ef1ae",22856446,1,1,0,1294,333,334,1
"c7e89b9d04744d2eab742fc24e3ef1ae","c7e89b9d04744d2eab742fc24e3ef1ae",22856446,2,0,1,1295,334,334,0
"c7e89b9d04744d2eab742fc24e3ef1ae","fe49f8054b374a0ea4bb266ed135ff62",22856446,1,1,0,1297,334,335,1
"fe49f8054b374a0ea4bb266ed135ff62","fe49f8054b374a0ea4bb266ed135ff62",22856446,2,0,1,1298,335,335,0
"fe49f8054b374a0ea4bb266ed135ff62","d0a8f74af98642fe8360d22c42e45117",22856446,1,1,0,1300,335,336,1
"d0a8f74af98642fe8360d22c42e45117","d0a8f74af98642fe8360d22c42e45117",22856446,2,0,1,1301,336,336,0
"d0a8f74af98642fe8360d22c42e45117","0c4079457ede49e3aeb5e86ed84bdf35",22856446,1,-7,0,1303,336,329,-7
"0c4079457ede49e3aeb5e86ed84bdf35","a7c6339ca1da4368a18d471f0519f877",22856446,1,11,0,1304,329,339,10
"a7c6339ca1da4368a18d471f0519f877","a7c6339ca1da4368a18d471f0519f877",22856446,1,0,1,1305,339,339,0
"a7c6339ca1da4368a18d471f0519f877","b8b9418ab322418d9db9b40d96af873a",22856446,1,-2,0,1306,339,337,-2
"b8b9418ab322418d9db9b40d96af873a","bbc5139ca9024389a94db3a6f47dcff6",22856446,1,5,0,1307,337,341,4
"bbc5139ca9024389a94db3a6f47dcff6","bbc5139ca9024389a94db3a6f47dcff6",22856446,6,0,1,1308,341,341,0
"bbc5139ca9024389a94db3a6f47dcff6","4ee6ca9019ab4a1ab323f98094a9bd77",22856446,1,2,0,1312,341,343,2
"4ee6ca9019ab4a1ab323f98094a9bd77","4ee6ca9019ab4a1ab323f98094a9bd77",22856446,2,0,1,1313,343,343,0
"4ee6ca9019ab4a1ab323f98094a9bd77","b37947176785476f8b29d49a851366dc",22856446,1,1,0,1315,343,344,1
"b37947176785476f8b29d49a851366dc","b37947176785476f8b29d49a851366dc",22856446,2,0,1,1316,344,344,0
"b37947176785476f8b29d49a851366dc","fcea5b10d5a14a3b9324ffece8f6e1e5",22856446,1,1,0,1318,344,345,1
"fcea5b10d5a14a3b9324ffece8f6e1e5","fcea5b10d5a14a3b9324ffece8f6e1e5",22856446,2,0,1,1319,345,345,0
"fcea5b10d5a14a3b9324ffece8f6e1e5","c2490bc612d146edbe786556fab3651b",22856446,1,-5,0,1321,345,340,-5
"c2490bc612d146edbe786556fab3651b","4a92daef4d504e1792575a26502bb7b7",22856446,1,7,0,1322,340,346,6
"4a92daef4d504e1792575a26502bb7b7","bbc5139ca9024389a94db3a6f47dcff6",22856446,1,-6,0,1323,346,341,-5
"bbc5139ca9024389a94db3a6f47dcff6","c2490bc612d146edbe786556fab3651b",22856446,2,-1,0,1324,341,340,-1
"c2490bc612d146edbe786556fab3651b","6ac8bb048b854999a47edb35fe627f11",22856446,1,8,0,1325,340,347,7
"6ac8bb048b854999a47edb35fe627f11","6ac8bb048b854999a47edb35fe627f11",22856446,1,0,1,1326,347,347,0
"6ac8bb048b854999a47edb35fe627f11","0c4079457ede49e3aeb5e86ed84bdf35",22856446,1,-21,0,1327,347,329,-18
"0c4079457ede49e3aeb5e86ed84bdf35","30ead9794d4847abaf222ca966cc8630",22856446,1,24,0,1328,329,348,19
"30ead9794d4847abaf222ca966cc8630","897b7f51242c44aab2205c72fdcbf4cd",22856446,1,4,0,1329,348,352,4
"897b7f51242c44aab2205c72fdcbf4cd","c20993c944444fe085345591a8bd837e",22856446,1,-1,0,1330,352,351,-1
"c20993c944444fe085345591a8bd837e","eff0de7f2dbb42dfa1a2e686efab5b6d",22856446,1,3,0,1331,351,354,3
"eff0de7f2dbb42dfa1a2e686efab5b6d","09b9678ddc3d452ea4a3d46e15826065",22856446,1,-1,0,1332,354,353,-1
"09b9678ddc3d452ea4a3d46e15826065","c20993c944444fe085345591a8bd837e",22856446,1,-2,0,1333,353,351,-2
"c20993c944444fe085345591a8bd837e","c20993c944444fe085345591a8bd837e",22856446,3,0,1,1334,351,351,0
"c20993c944444fe085345591a8bd837e","897b7f51242c44aab2205c72fdcbf4cd",22856446,1,1,0,1337,351,352,1
"897b7f51242c44aab2205c72fdcbf4cd","897b7f51242c44aab2205c72fdcbf4cd",22856446,3,0,1,1338,352,352,0
"897b7f51242c44aab2205c72fdcbf4cd","09b9678ddc3d452ea4a3d46e15826065",22856446,1,1,0,1341,352,353,1
"09b9678ddc3d452ea4a3d46e15826065","09b9678ddc3d452ea4a3d46e15826065",22856446,3,0,1,1342,353,353,0
"09b9678ddc3d452ea4a3d46e15826065","eff0de7f2dbb42dfa1a2e686efab5b6d",22856446,1,1,0,1345,353,354,1
"eff0de7f2dbb42dfa1a2e686efab5b6d","eff0de7f2dbb42dfa1a2e686efab5b6d",22856446,3,0,1,1346,354,354,0
"eff0de7f2dbb42dfa1a2e686efab5b6d","2fe14166dc9642c3bc666b86a57f943d",22856446,1,4,0,1349,354,357,3
"2fe14166dc9642c3bc666b86a57f943d","30ead9794d4847abaf222ca966cc8630",22856446,1,-10,0,1350,357,348,-9
"30ead9794d4847abaf222ca966cc8630","2fe14166dc9642c3bc666b86a57f943d",22856446,1,10,0,1351,348,357,9
"2fe14166dc9642c3bc666b86a57f943d","44421dd1e13a47a388c4a19834b744c7",22856446,1,2,0,1352,357,359,2
"44421dd1e13a47a388c4a19834b744c7","44421dd1e13a47a388c4a19834b744c7",22856446,2,0,1,1353,359,359,0
"44421dd1e13a47a388c4a19834b744c7","cb5fc7ef85d547c4be1a7439d0bf6052",22856446,1,1,0,1355,359,360,1
"cb5fc7ef85d547c4be1a7439d0bf6052","cb5fc7ef85d547c4be1a7439d0bf6052",22856446,2,0,1,1356,360,360,0
"cb5fc7ef85d547c4be1a7439d0bf6052","0a8f150a4cf747acbde62f4721823da3",22856446,1,1,0,1358,360,361,1
"0a8f150a4cf747acbde62f4721823da3","0a8f150a4cf747acbde62f4721823da3",22856446,2,0,1,1359,361,361,0
"0a8f150a4cf747acbde62f4721823da3","ab8fdad974ae471f9f24c3f9dd04462e",22856446,1,1,0,1361,361,362,1
"ab8fdad974ae471f9f24c3f9dd04462e","ab8fdad974ae471f9f24c3f9dd04462e",22856446,2,0,1,1362,362,362,0
"ab8fdad974ae471f9f24c3f9dd04462e","1ba8fef685d74a8194b9db252eb704fb",22856446,1,-7,0,1364,362,355,-7
"1ba8fef685d74a8194b9db252eb704fb","52580888dadb4fe3baa795683ea227bd",22856446,1,10,0,1365,355,364,9
"52580888dadb4fe3baa795683ea227bd","52580888dadb4fe3baa795683ea227bd",22856446,1,0,1,1366,364,364,0
"52580888dadb4fe3baa795683ea227bd","f00179e251a045b39c3f7a54f9aa4acc",22856446,1,-1,0,1367,364,363,-1
"f00179e251a045b39c3f7a54f9aa4acc","492a3bc6a1254f23a7998587961b22a4",22856446,1,4,0,1368,363,366,3
"492a3bc6a1254f23a7998587961b22a4","492a3bc6a1254f23a7998587961b22a4",22856446,1,0,1,1369,366,366,0
"492a3bc6a1254f23a7998587961b22a4","072a190fd302456290895f9f04d6940a",22856446,1,-1,0,1370,366,365,-1
"072a190fd302456290895f9f04d6940a","cfa457d1743848e4bb5e4beced6448ed",22856446,1,5,0,1371,365,369,4
"cfa457d1743848e4bb5e4beced6448ed","cfa457d1743848e4bb5e4beced6448ed",22856446,1,0,1,1372,369,369,0
"cfa457d1743848e4bb5e4beced6448ed","b71bac264efb4abd97015447bd490db6",22856446,1,3,0,1373,369,370,1
"b71bac264efb4abd97015447bd490db6","30ead9794d4847abaf222ca966cc8630",22856446,2,-28,0,1374,370,348,-22
"30ead9794d4847abaf222ca966cc8630","8d448d625b024c82a5eb240bbd7431d6",22856446,1,33,0,1375,348,374,26
"8d448d625b024c82a5eb240bbd7431d6","8d448d625b024c82a5eb240bbd7431d6",22856446,78,0,1,1376,374,374,0
"8d448d625b024c82a5eb240bbd7431d6","b71bac264efb4abd97015447bd490db6",22856446,4,-5,0,1378,374,370,-4
"b71bac264efb4abd97015447bd490db6","8d448d625b024c82a5eb240bbd7431d6",22856446,3,5,0,1379,370,374,4
"8d448d625b024c82a5eb240bbd7431d6","1b4550d0dab04078b3bf08a655345bdc",22856446,2,-1,0,1384,374,373,-1
"1b4550d0dab04078b3bf08a655345bdc","8d448d625b024c82a5eb240bbd7431d6",22856446,2,1,0,1385,373,374,1
"b71bac264efb4abd97015447bd490db6","d6d02b6ef04e4f17805504500b8ce441",22856446,4,8,0,1438,370,375,5
"d6d02b6ef04e4f17805504500b8ce441","d6d02b6ef04e4f17805504500b8ce441",22856446,12,0,1,1439,375,375,0
"d6d02b6ef04e4f17805504500b8ce441","a49d1bb4328949299686242fd0be5584",22856446,1,-482,0,1440,375,21,-354
"a49d1bb4328949299686242fd0be5584","b7719e26494940efa49512aedd0aac79",22856446,1,-2,0,1441,21,20,-1
"b7719e26494940efa49512aedd0aac79","d4f45188d3c84a02ba08454e6403a818",22856446,2,5,0,1442,20,24,4
"d4f45188d3c84a02ba08454e6403a818","a49d1bb4328949299686242fd0be5584",22856446,1,-3,0,1443,24,21,-3
"a49d1bb4328949299686242fd0be5584","d4c3b003e8274e429d2fa688d73fde6d",22856446,1,1,0,1444,21,22,1
"d4c3b003e8274e429d2fa688d73fde6d","d4c3b003e8274e429d2fa688d73fde6d",22856446,3,0,1,1445,22,22,0
"d4c3b003e8274e429d2fa688d73fde6d","b7719e26494940efa49512aedd0aac79",22856446,2,-3,0,1447,22,20,-2
"b7719e26494940efa49512aedd0aac79","b613861cecf84ffcab01afb23f660475",22856446,1,-32,0,1448,20,1,-19
"b613861cecf84ffcab01afb23f660475","f902b0f41b544d4dbf79664fd233648d",22856446,1,206,0,1449,1,146,145
"f902b0f41b544d4dbf79664fd233648d","df1de691dafe4549a18a4398ee9dfaf9",22856446,1,-8,0,1450,146,139,-7
"df1de691dafe4549a18a4398ee9dfaf9","8aae34f5ddbb4052a709b12e6b0d40fa",22856446,2,9,0,1451,139,147,8
"8aae34f5ddbb4052a709b12e6b0d40fa","f902b0f41b544d4dbf79664fd233648d",22856446,3,-1,0,1452,147,146,-1
"f902b0f41b544d4dbf79664fd233648d","f03480cf4eba413194d7af52fc0e7f28",22856446,2,7,0,1453,146,152,6
"f03480cf4eba413194d7af52fc0e7f28","8aae34f5ddbb4052a709b12e6b0d40fa",22856446,2,-6,0,1454,152,147,-5
"8aae34f5ddbb4052a709b12e6b0d40fa","8aae34f5ddbb4052a709b12e6b0d40fa",22856446,10,0,1,1455,147,147,0
"f902b0f41b544d4dbf79664fd233648d","67a089198fcb4e1c8f2385786c2b296f",22856446,1,-134,0,1460,146,39,-107
"67a089198fcb4e1c8f2385786c2b296f","139b097acfca451689d80c9c6eebdf7b",22856446,1,180,0,1461,39,178,139
"139b097acfca451689d80c9c6eebdf7b","0c7262dff33c4087bc660ccf40f92f9c",22856446,2,-11,0,1462,178,169,-9
"0c7262dff33c4087bc660ccf40f92f9c","0c7262dff33c4087bc660ccf40f92f9c",22856446,3,0,1,1463,169,169,0
"0c7262dff33c4087bc660ccf40f92f9c","139b097acfca451689d80c9c6eebdf7b",22856446,1,11,0,1464,169,178,9
"139b097acfca451689d80c9c6eebdf7b","ea38cc0e6e6e41edbabf210220808bf9",22856446,1,1,0,1465,178,179,1
"ea38cc0e6e6e41edbabf210220808bf9","b87c552dd247427abe6ab5795b9c9d43",22856446,2,2,0,1466,179,181,2
"b87c552dd247427abe6ab5795b9c9d43","ea38cc0e6e6e41edbabf210220808bf9",22856446,2,-2,0,1467,181,179,-2
"ea38cc0e6e6e41edbabf210220808bf9","ea38cc0e6e6e41edbabf210220808bf9",22856446,1,0,1,1468,179,179,0
"ea38cc0e6e6e41edbabf210220808bf9","139b097acfca451689d80c9c6eebdf7b",22856446,1,-1,0,1469,179,178,-1
"0c7262dff33c4087bc660ccf40f92f9c","1c6721b1f63f4d30ba7746ea8af02a52",22856446,1,70,0,1471,169,221,52
"1c6721b1f63f4d30ba7746ea8af02a52","f7906d6f59b9489a91d2ef40db5a474d",22856446,1,3,0,1472,221,223,2
"f7906d6f59b9489a91d2ef40db5a474d","d03cb855c70044cf8c35d9ec0de696e3",22856446,1,1,0,1473,223,224,1
"d03cb855c70044cf8c35d9ec0de696e3","d03cb855c70044cf8c35d9ec0de696e3",22856446,2,0,1,1476,224,224,0
"d03cb855c70044cf8c35d9ec0de696e3","f7906d6f59b9489a91d2ef40db5a474d",22856446,1,-1,0,1477,224,223,-1
"d03cb855c70044cf8c35d9ec0de696e3","2ab1535aac1346ba8801535bf729ef37",22856446,1,6,0,1484,224,229,5
"2ab1535aac1346ba8801535bf729ef37","f7906d6f59b9489a91d2ef40db5a474d",22856446,1,-7,0,1485,229,223,-6
"f7906d6f59b9489a91d2ef40db5a474d","0c7262dff33c4087bc660ccf40f92f9c",22856446,1,-73,0,1486,223,169,-54
"0c7262dff33c4087bc660ccf40f92f9c","2ae94c0cea4d480a9d5dca8fb1d7b542",22856446,1,97,0,1487,169,242,73
"2ae94c0cea4d480a9d5dca8fb1d7b542","6e83e23f56544a19b94067c1c558d9c0",22856446,1,6,0,1488,242,247,5
"6e83e23f56544a19b94067c1c558d9c0","6e83e23f56544a19b94067c1c558d9c0",22856446,1,0,1,1489,247,247,0
"6e83e23f56544a19b94067c1c558d9c0","30c9ba177afc49a695625d2bdec40207",22856446,1,3,0,1490,247,250,3
"30c9ba177afc49a695625d2bdec40207","30c9ba177afc49a695625d2bdec40207",22856446,2,0,1,1491,250,250,0
"30c9ba177afc49a695625d2bdec40207","6e83e23f56544a19b94067c1c558d9c0",22856446,1,-3,0,1493,250,247,-3
"00f61990949545828dd12f1303d47504","0c7262dff33c4087bc660ccf40f92f9c",22856446,1,-114,0,1495,256,169,-87
"bb5a47f5ea01454a8b79455422d3b9da","0d987bed3ffa4ed0b9a2e62e97b7b30f",22856446,2,-10,0,1574,280,272,-8
"0d987bed3ffa4ed0b9a2e62e97b7b30f","94cecc3f1e7d484b8e068e79241dfd73",22856446,2,13,0,1575,272,281,9
"a37477c4e4c14169ad44b06b493007f6","94cecc3f1e7d484b8e068e79241dfd73",22856446,1,-2,0,1577,283,281,-2
"94cecc3f1e7d484b8e068e79241dfd73","fab84b4fab5940efb4ea868ef8d09396",22856446,1,5,0,1578,281,284,3
"4a29443515bb404cb8924e1c60a63b73","7646a919d7e64fa990bca9b024ff089d",22856446,1,17,0,1580,285,298,13
"7646a919d7e64fa990bca9b024ff089d","ba0e59461bfb4a44b7b1c28a01f8d3b3",22856446,1,1,0,1581,298,299,1
"7646a919d7e64fa990bca9b024ff089d","2c5bb2cbd0014420ad8c95d40e38efd1",22856446,1,6,0,1585,298,303,5
"2c5bb2cbd0014420ad8c95d40e38efd1","ba0e59461bfb4a44b7b1c28a01f8d3b3",22856446,1,-5,0,1586,303,299,-4
"7646a919d7e64fa990bca9b024ff089d","d6d02b6ef04e4f17805504500b8ce441",22856446,1,101,0,1593,298,375,77
"d6d02b6ef04e4f17805504500b8ce441","b71bac264efb4abd97015447bd490db6",22856446,3,-8,0,1597,375,370,-5
"8d448d625b024c82a5eb240bbd7431d6","d6d02b6ef04e4f17805504500b8ce441",22856446,1,3,0,1606,374,375,1
"d6d02b6ef04e4f17805504500b8ce441","8d448d625b024c82a5eb240bbd7431d6",22856446,1,-3,0,1611,375,374,-1
"1b4550d0dab04078b3bf08a655345bdc","b71bac264efb4abd97015447bd490db6",22856446,1,-4,0,1620,373,370,-3
"30ead9794d4847abaf222ca966cc8630","67a089198fcb4e1c8f2385786c2b296f",22856446,1,-408,0,1622,348,39,-309
"64d48c6c9c7940639a932219a6c87198","7646a919d7e64fa990bca9b024ff089d",22856446,1,342,0,1624,40,298,258
"4a29443515bb404cb8924e1c60a63b73","ba0e59461bfb4a44b7b1c28a01f8d3b3",22856446,1,18,0,1626,285,299,14
"4a29443515bb404cb8924e1c60a63b73","c2490bc612d146edbe786556fab3651b",22856446,1,71,0,1634,285,340,55
"c2490bc612d146edbe786556fab3651b","0c4079457ede49e3aeb5e86ed84bdf35",22856446,1,-13,0,1635,340,329,-11
"0c4079457ede49e3aeb5e86ed84bdf35","bbc5139ca9024389a94db3a6f47dcff6",22856446,1,14,0,1636,329,341,12
"c2490bc612d146edbe786556fab3651b","4a29443515bb404cb8924e1c60a63b73",22856446,1,-71,0,1640,340,285,-55
"4a29443515bb404cb8924e1c60a63b73","d6d02b6ef04e4f17805504500b8ce441",22856446,1,118,0,1641,285,375,90
"d6d02b6ef04e4f17805504500b8ce441","66baf19b6b904b70922329068c63746d",22856446,2,4,0,1645,375,376,1
"66baf19b6b904b70922329068c63746d","7f544639412e40a9ba27f43b415362ab",22856446,2,2,0,1646,376,378,2
"7f544639412e40a9ba27f43b415362ab","d6d02b6ef04e4f17805504500b8ce441",22856446,1,-6,0,1647,378,375,-3
"7f544639412e40a9ba27f43b415362ab","7f544639412e40a9ba27f43b415362ab",22856446,4,0,1,1654,378,378,0
"7f544639412e40a9ba27f43b415362ab","d5ae8642e15b46b8bd298b02274d4e9c",22856446,1,2,0,1658,378,380,2
"d5ae8642e15b46b8bd298b02274d4e9c","d5ae8642e15b46b8bd298b02274d4e9c",22856446,1,0,1,1659,380,380,0
"d5ae8642e15b46b8bd298b02274d4e9c","a0d10309a2dd456289147f84be9d37f9",22856446,1,1,0,1660,380,381,1
"a0d10309a2dd456289147f84be9d37f9","a0d10309a2dd456289147f84be9d37f9",22856446,2,0,1,1661,381,381,0
"a0d10309a2dd456289147f84be9d37f9","0fcbc3ca07b144138b8d85da581f09a8",22856446,1,1,0,1663,381,382,1
"0fcbc3ca07b144138b8d85da581f09a8","0fcbc3ca07b144138b8d85da581f09a8",22856446,2,0,1,1664,382,382,0
"0fcbc3ca07b144138b8d85da581f09a8","66baf19b6b904b70922329068c63746d",22856446,1,-6,0,1666,382,376,-6
"66baf19b6b904b70922329068c63746d","4890121ce5d74576b4632b77cfc23398",22856446,1,14,0,1667,376,388,12
"4890121ce5d74576b4632b77cfc23398","c2fca3669923477ab966ded303dea31c",22856446,1,-6,0,1668,388,383,-5
"c2fca3669923477ab966ded303dea31c","4890121ce5d74576b4632b77cfc23398",22856446,1,6,0,1669,383,388,5
"4890121ce5d74576b4632b77cfc23398","96bb2b3e85a34d8b9544514e89f6fe97",22856446,1,3,0,1670,388,390,2
"96bb2b3e85a34d8b9544514e89f6fe97","18d3b836dd804224883cc9180b60a8e1",22856446,1,-4,0,1671,390,387,-3
"18d3b836dd804224883cc9180b60a8e1","96bb2b3e85a34d8b9544514e89f6fe97",22856446,1,4,0,1672,387,390,3
"96bb2b3e85a34d8b9544514e89f6fe97","ac4e9b54acfe4670b4634859c7263cb5",22856446,1,2,0,1673,390,392,2
"ac4e9b54acfe4670b4634859c7263cb5","ac4e9b54acfe4670b4634859c7263cb5",22856446,1,0,1,1674,392,392,0
"ac4e9b54acfe4670b4634859c7263cb5","6f8881a745ac4c358a68b92c3b4abe81",22856446,1,3,0,1675,392,394,2
"6f8881a745ac4c358a68b92c3b4abe81","17f95d18bab743888e1736033dc3384d",22856446,1,-6,0,1676,394,389,-5
"17f95d18bab743888e1736033dc3384d","6f8881a745ac4c358a68b92c3b4abe81",22856446,1,6,0,1677,389,394,5
"6f8881a745ac4c358a68b92c3b4abe81","f7002c8484354eceac57bc7bd62c76c1",22856446,3,-1,0,1678,394,393,-1
"f7002c8484354eceac57bc7bd62c76c1","0c12af0a4e7f4002852cf84b2537c161",22856446,1,3,0,1679,393,395,2
"0c12af0a4e7f4002852cf84b2537c161","6f8881a745ac4c358a68b92c3b4abe81",22856446,1,-2,0,1680,395,394,-1
"6f8881a745ac4c358a68b92c3b4abe81","6f8881a745ac4c358a68b92c3b4abe81",22856446,4,0,1,1681,394,394,0
"f7002c8484354eceac57bc7bd62c76c1","44a277ea44dc4ae689fab4b82f0b4098",22856446,1,5,0,1684,393,397,4
"44a277ea44dc4ae689fab4b82f0b4098","44a277ea44dc4ae689fab4b82f0b4098",22856446,1,0,1,1685,397,397,0
"44a277ea44dc4ae689fab4b82f0b4098","0c12af0a4e7f4002852cf84b2537c161",22856446,1,-2,0,1686,397,395,-2
"0c12af0a4e7f4002852cf84b2537c161","859e0b8d71694b12befb69ee698138f9",22856446,1,5,0,1687,395,399,4
"859e0b8d71694b12befb69ee698138f9","859e0b8d71694b12befb69ee698138f9",22856446,1,0,1,1688,399,399,0
"859e0b8d71694b12befb69ee698138f9","2b09a08242b54983aec7063990fb3f66",22856446,1,3,0,1689,399,400,1
"2b09a08242b54983aec7063990fb3f66","66baf19b6b904b70922329068c63746d",22856446,2,-32,0,1690,400,376,-24
"66baf19b6b904b70922329068c63746d","2b09a08242b54983aec7063990fb3f66",22856446,2,32,0,1691,376,400,24
"66baf19b6b904b70922329068c63746d","f7002c8484354eceac57bc7bd62c76c1",22856446,1,21,0,1693,376,393,17
"f7002c8484354eceac57bc7bd62c76c1","66baf19b6b904b70922329068c63746d",22856446,2,-21,0,1694,393,376,-17
"66baf19b6b904b70922329068c63746d","6f8881a745ac4c358a68b92c3b4abe81",22856446,1,22,0,1695,376,394,18
"2b09a08242b54983aec7063990fb3f66","2b09a08242b54983aec7063990fb3f66",22856446,4,0,1,1701,400,400,0
"2b09a08242b54983aec7063990fb3f66","1f471b7a883a4df48211e8c6a81b59a7",22856446,1,1,0,1705,400,401,1
"1f471b7a883a4df48211e8c6a81b59a7","1f471b7a883a4df48211e8c6a81b59a7",22856446,1,0,1,1706,401,401,0
"1f471b7a883a4df48211e8c6a81b59a7","2b09a08242b54983aec7063990fb3f66",22856446,1,-1,0,1707,401,400,-1
"2b09a08242b54983aec7063990fb3f66","9de0d567bfa84fe5b77cb76f4a76a5d1",22856446,1,5,0,1708,400,404,4
"9de0d567bfa84fe5b77cb76f4a76a5d1","9de0d567bfa84fe5b77cb76f4a76a5d1",22856446,1,0,1,1709,404,404,0
"9de0d567bfa84fe5b77cb76f4a76a5d1","1157bd665ec4472fb58b751dc5099355",22856446,1,-1,0,1710,404,403,-1
"1157bd665ec4472fb58b751dc5099355","58fc9094275e4c49be3f4ba6d4acc0a4",22856446,1,5,0,1711,403,406,3
"58fc9094275e4c49be3f4ba6d4acc0a4","3c8a22d2f9c146ea956609e3ed4f2559",22856446,1,-2,0,1712,406,405,-1
"3c8a22d2f9c146ea956609e3ed4f2559","58fc9094275e4c49be3f4ba6d4acc0a4",22856446,1,2,0,1713,405,406,1
"58fc9094275e4c49be3f4ba6d4acc0a4","c1c1be90b2b14c1ab4a5e1ee3c241902",22856446,1,1,0,1714,406,407,1
"c1c1be90b2b14c1ab4a5e1ee3c241902","c1c1be90b2b14c1ab4a5e1ee3c241902",22856446,5,0,1,1715,407,407,0
"c1c1be90b2b14c1ab4a5e1ee3c241902","58fc9094275e4c49be3f4ba6d4acc0a4",22856446,1,-1,0,1720,407,406,-1
"58fc9094275e4c49be3f4ba6d4acc0a4","02b3a1bead9244c1ba2f857c7da8f82a",22856446,1,3,0,1721,406,408,2
"02b3a1bead9244c1ba2f857c7da8f82a","67a089198fcb4e1c8f2385786c2b296f",22856446,1,-492,0,1722,408,39,-369
"64d48c6c9c7940639a932219a6c87198","02b3a1bead9244c1ba2f857c7da8f82a",22856446,1,491,0,1724,40,408,368
"02b3a1bead9244c1ba2f857c7da8f82a","2b09a08242b54983aec7063990fb3f66",22856446,1,-12,0,1725,408,400,-8
"2b09a08242b54983aec7063990fb3f66","02b3a1bead9244c1ba2f857c7da8f82a",22856446,1,12,0,1726,400,408,8
"02b3a1bead9244c1ba2f857c7da8f82a","02b3a1bead9244c1ba2f857c7da8f82a",22856446,2,0,1,1727,408,408,0
"02b3a1bead9244c1ba2f857c7da8f82a","6206fc6479014bb193084c32409dc1b9",22856446,1,1,0,1729,408,409,1
"6206fc6479014bb193084c32409dc1b9","6206fc6479014bb193084c32409dc1b9",22856446,1,0,1,1730,409,409,0
"6206fc6479014bb193084c32409dc1b9","02b3a1bead9244c1ba2f857c7da8f82a",22856446,1,-1,0,1731,409,408,-1
"02b3a1bead9244c1ba2f857c7da8f82a","6a5f020451db426dacba9e2ea3fcc62a",22856446,1,3,0,1732,408,410,2
"6a5f020451db426dacba9e2ea3fcc62a","6a5f020451db426dacba9e2ea3fcc62a",22856446,2,0,1,1733,410,410,0
"6a5f020451db426dacba9e2ea3fcc62a","33a9d248b2e44588a5b07fc1342b9bc2",22856446,1,2,0,1735,410,411,1
"33a9d248b2e44588a5b07fc1342b9bc2","33a9d248b2e44588a5b07fc1342b9bc2",22856446,1,0,1,1736,411,411,0
"33a9d248b2e44588a5b07fc1342b9bc2","c6f26bd420634f1cb7989e76fe6b16c0",22856446,1,1,0,1737,411,412,1
"c6f26bd420634f1cb7989e76fe6b16c0","c6f26bd420634f1cb7989e76fe6b16c0",22856446,5,0,1,1738,412,412,0
"c6f26bd420634f1cb7989e76fe6b16c0","2a65ee6e2ac64f6a8a55fbe5373ec763",22856446,1,1,0,1743,412,413,1
"2a65ee6e2ac64f6a8a55fbe5373ec763","2a65ee6e2ac64f6a8a55fbe5373ec763",22856446,2,0,1,1744,413,413,0
"2a65ee6e2ac64f6a8a55fbe5373ec763","33a9d248b2e44588a5b07fc1342b9bc2",22856446,1,-2,0,1746,413,411,-2
"33a9d248b2e44588a5b07fc1342b9bc2","687055dad9fc40c3982478fe33ec01bf",22856446,1,4,0,1747,411,414,3
"687055dad9fc40c3982478fe33ec01bf","2add1669f08d4101913db15f8c23b3b7",22856446,2,3,0,1748,414,416,2
"2add1669f08d4101913db15f8c23b3b7","2add1669f08d4101913db15f8c23b3b7",22856446,1,0,1,1749,416,416,0
"2add1669f08d4101913db15f8c23b3b7","2b09a08242b54983aec7063990fb3f66",22856446,2,-24,0,1750,416,400,-16
"2b09a08242b54983aec7063990fb3f66","a2b4bd40cee2481ebd3fc179d6a5cd62",22856446,2,27,0,1751,400,417,17
"a2b4bd40cee2481ebd3fc179d6a5cd62","e34e59dce2204f228f3a84b6725df60f",22856446,1,2,0,1752,417,419,2
"e34e59dce2204f228f3a84b6725df60f","e34e59dce2204f228f3a84b6725df60f",22856446,1,0,1,1753,419,419,0
"e34e59dce2204f228f3a84b6725df60f","a2b4bd40cee2481ebd3fc179d6a5cd62",22856446,1,-2,0,1754,419,417,-2
"a2b4bd40cee2481ebd3fc179d6a5cd62","bec48fc2e1294c7eb3d0aca780d731b8",22856446,1,4,0,1755,417,420,3
"bec48fc2e1294c7eb3d0aca780d731b8","bec48fc2e1294c7eb3d0aca780d731b8",22856446,8,0,1,1756,420,420,0
"bec48fc2e1294c7eb3d0aca780d731b8","dbde19fcce2a4c1abdc7f685c293a23f",22856446,1,3,0,1759,420,422,2
"dbde19fcce2a4c1abdc7f685c293a23f","bec48fc2e1294c7eb3d0aca780d731b8",22856446,1,-3,0,1760,422,420,-2
"bec48fc2e1294c7eb3d0aca780d731b8","a24600b0e49245f6bdba8c893cfeddb0",22856446,1,7,0,1766,420,425,5
"a24600b0e49245f6bdba8c893cfeddb0","dbde19fcce2a4c1abdc7f685c293a23f",22856446,1,-4,0,1767,425,422,-3
"dbde19fcce2a4c1abdc7f685c293a23f","a24600b0e49245f6bdba8c893cfeddb0",22856446,1,4,0,1768,422,425,3
"a24600b0e49245f6bdba8c893cfeddb0","a24600b0e49245f6bdba8c893cfeddb0",22856446,1,0,1,1769,425,425,0
"a24600b0e49245f6bdba8c893cfeddb0","24cf8786024543f19b89bc20034e60d7",22856446,1,7,0,1770,425,428,3
"24cf8786024543f19b89bc20034e60d7","a2b4bd40cee2481ebd3fc179d6a5cd62",22856446,1,-18,0,1771,428,417,-11
"a2b4bd40cee2481ebd3fc179d6a5cd62","f2a73be2f46840b182d7bd095378004e",22856446,1,19,0,1772,417,429,12
"f2a73be2f46840b182d7bd095378004e","f2a73be2f46840b182d7bd095378004e",22856446,1,0,1,1773,429,429,0
"f2a73be2f46840b182d7bd095378004e","604551fd4266430cb860fef58fa7dd61",22856446,1,1,0,1774,429,430,1
"604551fd4266430cb860fef58fa7dd61","604551fd4266430cb860fef58fa7dd61",22856446,1,0,1,1775,430,430,0
"604551fd4266430cb860fef58fa7dd61","24cf8786024543f19b89bc20034e60d7",22856446,1,-2,0,1776,430,428,-2
"24cf8786024543f19b89bc20034e60d7","dce46f8904594a62a6377a3587aaa663",22856446,1,4,0,1777,428,431,3
"dce46f8904594a62a6377a3587aaa663","dce46f8904594a62a6377a3587aaa663",22856446,1,0,1,1778,431,431,0
"dce46f8904594a62a6377a3587aaa663","9b9d0a249052413c869753b99682b0ac",22856446,1,1,0,1779,431,432,1
"9b9d0a249052413c869753b99682b0ac","9b9d0a249052413c869753b99682b0ac",22856446,1,0,1,1780,432,432,0
"9b9d0a249052413c869753b99682b0ac","061c175cc90f45fbad883025394e78dd",22856446,1,1,0,1781,432,433,1
"061c175cc90f45fbad883025394e78dd","061c175cc90f45fbad883025394e78dd",22856446,1,0,1,1782,433,433,0
"061c175cc90f45fbad883025394e78dd","dce46f8904594a62a6377a3587aaa663",22856446,1,-2,0,1783,433,431,-2
"dce46f8904594a62a6377a3587aaa663","74a7f8712e5449c2bc0b43c6f90dafed",22856446,1,5,0,1784,431,435,4
"74a7f8712e5449c2bc0b43c6f90dafed","74a7f8712e5449c2bc0b43c6f90dafed",22856446,1,0,1,1785,435,435,0
"74a7f8712e5449c2bc0b43c6f90dafed","66ada10dde9f43018588f1ced9d477fc",22856446,1,-1,0,1786,435,434,-1
"66ada10dde9f43018588f1ced9d477fc","bf12c96466d840a69bed7020b3f18bb8",22856446,1,3,0,1787,434,436,2
"bf12c96466d840a69bed7020b3f18bb8","bf12c96466d840a69bed7020b3f18bb8",22856446,1,0,1,1788,436,436,0
"bf12c96466d840a69bed7020b3f18bb8","24cf8786024543f19b89bc20034e60d7",22856446,1,-11,0,1789,436,428,-8
"24cf8786024543f19b89bc20034e60d7","070600601c4c439288445d2f0724807d",22856446,1,14,0,1790,428,437,9
"070600601c4c439288445d2f0724807d","1823b6de7d334a7aaabc4570719af4d9",22856446,3,2,0,1791,437,439,2
"1823b6de7d334a7aaabc4570719af4d9","66baf19b6b904b70922329068c63746d",22856446,1,-93,0,1792,439,376,-63
"66baf19b6b904b70922329068c63746d","070600601c4c439288445d2f0724807d",22856446,1,91,0,1793,376,437,61
"070600601c4c439288445d2f0724807d","070600601c4c439288445d2f0724807d",22856446,4,0,1,1794,437,437,0
"1823b6de7d334a7aaabc4570719af4d9","1823b6de7d334a7aaabc4570719af4d9",22856446,18,0,1,1796,439,439,0
"1823b6de7d334a7aaabc4570719af4d9","070600601c4c439288445d2f0724807d",22856446,1,-2,0,1803,439,437,-2
"1823b6de7d334a7aaabc4570719af4d9","0380cd76a7d44bc3a4da1f15e4d68f89",22856446,1,2,0,1819,439,440,1
"0380cd76a7d44bc3a4da1f15e4d68f89","070600601c4c439288445d2f0724807d",22856446,1,-4,0,1820,440,437,-3
"070600601c4c439288445d2f0724807d","0380cd76a7d44bc3a4da1f15e4d68f89",22856446,1,4,0,1821,437,440,3
"0380cd76a7d44bc3a4da1f15e4d68f89","0380cd76a7d44bc3a4da1f15e4d68f89",22856446,1,0,1,1822,440,440,0
"0380cd76a7d44bc3a4da1f15e4d68f89","23b7673c8b5443108c2ef09382834a86",22856446,2,2,0,1823,440,441,1
"23b7673c8b5443108c2ef09382834a86","0380cd76a7d44bc3a4da1f15e4d68f89",22856446,1,-2,0,1824,441,440,-1
"23b7673c8b5443108c2ef09382834a86","23b7673c8b5443108c2ef09382834a86",22856446,1,0,1,1826,441,441,0
"23b7673c8b5443108c2ef09382834a86","901e92500aea43c79f19f1b279050668",22856446,1,2,0,1827,441,442,1
"901e92500aea43c79f19f1b279050668","901e92500aea43c79f19f1b279050668",22856446,6,0,1,1828,442,442,0
"901e92500aea43c79f19f1b279050668","001339db8ced4cf78829ebe8b145449d",22856446,1,1,0,1829,442,443,1
"001339db8ced4cf78829ebe8b145449d","001339db8ced4cf78829ebe8b145449d",22856446,5,0,1,1830,443,443,0
"001339db8ced4cf78829ebe8b145449d","452745e0366e42ae81561bfddebcc6c3",22856446,1,1,0,1835,443,444,1
"452745e0366e42ae81561bfddebcc6c3","452745e0366e42ae81561bfddebcc6c3",22856446,2,0,1,1836,444,444,0
"452745e0366e42ae81561bfddebcc6c3","4660ff2089114e8db82ceb26a4f329e3",22856446,1,2,0,1838,444,445,1
"4660ff2089114e8db82ceb26a4f329e3","901e92500aea43c79f19f1b279050668",22856446,2,-4,0,1839,445,442,-3
"901e92500aea43c79f19f1b279050668","4660ff2089114e8db82ceb26a4f329e3",22856446,2,4,0,1841,442,445,3
"4660ff2089114e8db82ceb26a4f329e3","4660ff2089114e8db82ceb26a4f329e3",22856446,2,0,1,1848,445,445,0
"4660ff2089114e8db82ceb26a4f329e3","7bd5586eb9d8484eb74a433ee7bfe499",22856446,1,2,0,1850,445,446,1
"7bd5586eb9d8484eb74a433ee7bfe499","7bd5586eb9d8484eb74a433ee7bfe499",22856446,9,0,1,1851,446,446,0
"7bd5586eb9d8484eb74a433ee7bfe499","8a7f26e690f34dda97be16904518ca99",22856446,1,2,0,1860,446,447,1
"8a7f26e690f34dda97be16904518ca99","8a7f26e690f34dda97be16904518ca99",22856446,1,0,1,1861,447,447,0
"8a7f26e690f34dda97be16904518ca99","070600601c4c439288445d2f0724807d",22856446,1,-16,0,1862,447,437,-10
"070600601c4c439288445d2f0724807d","b2f0d654738f48158edff28e8d3a546e",22856446,1,21,0,1863,437,449,12
"b2f0d654738f48158edff28e8d3a546e","b2f0d654738f48158edff28e8d3a546e",22856446,1,0,1,1864,449,449,0
"b2f0d654738f48158edff28e8d3a546e","f60ee41ec635499abd48168342d32c2f",22856446,2,5,0,1865,449,453,4
"f60ee41ec635499abd48168342d32c2f","f60ee41ec635499abd48168342d32c2f",22856446,68,0,1,1866,453,453,0
"f60ee41ec635499abd48168342d32c2f","b71bac264efb4abd97015447bd490db6",22856446,1,-129,0,1873,453,370,-83
"b71bac264efb4abd97015447bd490db6","1b4550d0dab04078b3bf08a655345bdc",22856446,1,4,0,1874,370,373,3
"d6d02b6ef04e4f17805504500b8ce441","4a29443515bb404cb8924e1c60a63b73",22856446,1,-118,0,1888,375,285,-90
"4a29443515bb404cb8924e1c60a63b73","67a089198fcb4e1c8f2385786c2b296f",22856446,1,-326,0,1889,285,39,-246
"64d48c6c9c7940639a932219a6c87198","9428d8bd9c5a47b2a235b254e5e27ded",22856446,1,563,0,1891,40,452,412
"9428d8bd9c5a47b2a235b254e5e27ded","b2f0d654738f48158edff28e8d3a546e",22856446,1,-4,0,1892,452,449,-3
"f60ee41ec635499abd48168342d32c2f","b2f0d654738f48158edff28e8d3a546e",22856446,1,-5,0,1946,453,449,-4
"b2f0d654738f48158edff28e8d3a546e","f67fbf45a5f146ed866965bc57c7c001",22856446,1,8,0,1947,449,454,5
"f67fbf45a5f146ed866965bc57c7c001","f67fbf45a5f146ed866965bc57c7c001",22856446,2,0,1,1948,454,454,0
"f67fbf45a5f146ed866965bc57c7c001","d937afe49bd24a07a550dda1c1155122",22856446,1,1,0,1950,454,455,1
"d937afe49bd24a07a550dda1c1155122","d937afe49bd24a07a550dda1c1155122",22856446,1,0,1,1951,455,455,0
"d937afe49bd24a07a550dda1c1155122","3628b3f7823443d0912a339096b69943",22856446,1,1,0,1952,455,456,1
"3628b3f7823443d0912a339096b69943","3628b3f7823443d0912a339096b69943",22856446,1,0,1,1953,456,456,0
"3628b3f7823443d0912a339096b69943","9e049ee647cf43ecbcb5ed792a8e7588",22856446,1,1,0,1954,456,457,1
"9e049ee647cf43ecbcb5ed792a8e7588","9e049ee647cf43ecbcb5ed792a8e7588",22856446,1,0,1,1955,457,457,0
"9e049ee647cf43ecbcb5ed792a8e7588","5256a214faaf410b93f76cea06428334",22856446,1,1,0,1956,457,458,1
"5256a214faaf410b93f76cea06428334","5256a214faaf410b93f76cea06428334",22856446,1,0,1,1957,458,458,0
"5256a214faaf410b93f76cea06428334","25c32b120fce40fa9b6c85133aeb4716",22856446,1,1,0,1958,458,459,1
"25c32b120fce40fa9b6c85133aeb4716","25c32b120fce40fa9b6c85133aeb4716",22856446,1,0,1,1959,459,459,0
"25c32b120fce40fa9b6c85133aeb4716","11bc14f2204949008b7d511b933363c1",22856446,1,1,0,1960,459,460,1
"11bc14f2204949008b7d511b933363c1","11bc14f2204949008b7d511b933363c1",22856446,1,0,1,1961,460,460,0
"11bc14f2204949008b7d511b933363c1","42de338840a34d15adb66e7b14fb9d2c",22856446,1,1,0,1962,460,461,1
"42de338840a34d15adb66e7b14fb9d2c","42de338840a34d15adb66e7b14fb9d2c",22856446,1,0,1,1963,461,461,0
"42de338840a34d15adb66e7b14fb9d2c","9da37c6210b1416b8079c274f70bf600",22856446,1,1,0,1964,461,462,1
"9da37c6210b1416b8079c274f70bf600","9da37c6210b1416b8079c274f70bf600",22856446,1,0,1,1965,462,462,0
"9da37c6210b1416b8079c274f70bf600","519119f1deac45ff9ab4f13529be5c6e",22856446,1,1,0,1966,462,463,1
"519119f1deac45ff9ab4f13529be5c6e","519119f1deac45ff9ab4f13529be5c6e",22856446,1,0,1,1967,463,463,0
"519119f1deac45ff9ab4f13529be5c6e","f67fbf45a5f146ed866965bc57c7c001",22856446,1,-9,0,1968,463,454,-9
"f67fbf45a5f146ed866965bc57c7c001","c5df9f40ec14463b9dcfdc73df3e9285",22856446,1,12,0,1969,454,464,10
"c5df9f40ec14463b9dcfdc73df3e9285","c5df9f40ec14463b9dcfdc73df3e9285",22856446,5,0,1,1970,464,464,0
"c5df9f40ec14463b9dcfdc73df3e9285","83d42d95cd844fc093fc09cee250edb8",22856446,2,3,0,1972,464,465,1
"83d42d95cd844fc093fc09cee250edb8","83d42d95cd844fc093fc09cee250edb8",22856446,6,0,1,1973,465,465,0
"83d42d95cd844fc093fc09cee250edb8","687055dad9fc40c3982478fe33ec01bf",22856446,1,-82,0,1974,465,414,-51
"687055dad9fc40c3982478fe33ec01bf","2b09a08242b54983aec7063990fb3f66",22856446,1,-21,0,1975,414,400,-14
"2b09a08242b54983aec7063990fb3f66","1fd0f6dadbc14ebc965faf6122190b96",22856446,1,22,0,1976,400,415,15
"1fd0f6dadbc14ebc965faf6122190b96","1fd0f6dadbc14ebc965faf6122190b96",22856446,1,0,1,1977,415,415,0
"1fd0f6dadbc14ebc965faf6122190b96","687055dad9fc40c3982478fe33ec01bf",22856446,1,-1,0,1978,415,414,-1
"a2b4bd40cee2481ebd3fc179d6a5cd62","2b09a08242b54983aec7063990fb3f66",22856446,1,-27,0,1982,417,400,-17
"2b09a08242b54983aec7063990fb3f66","bc5524e78a8544e2ae2fdc2f3462bbec",22856446,1,-167,0,1983,400,279,-121
"bc5524e78a8544e2ae2fdc2f3462bbec","0d987bed3ffa4ed0b9a2e62e97b7b30f",22856446,1,-9,0,1984,279,272,-7
"a37477c4e4c14169ad44b06b493007f6","c5df9f40ec14463b9dcfdc73df3e9285",22856446,1,261,0,1998,283,464,181
"83d42d95cd844fc093fc09cee250edb8","b2f0d654738f48158edff28e8d3a546e",22856446,1,-23,0,2008,465,449,-16
"b2f0d654738f48158edff28e8d3a546e","9428d8bd9c5a47b2a235b254e5e27ded",22856446,1,4,0,2009,449,452,3
"9428d8bd9c5a47b2a235b254e5e27ded","f60ee41ec635499abd48168342d32c2f",22856446,1,1,0,2010,452,453,1
"b613861cecf84ffcab01afb23f660475","b613861cecf84ffcab01afb23f660475",22853670,4,0,1,1,1,1,0
"b613861cecf84ffcab01afb23f660475","e2911e79efc2420eac45d9f671463d4b",22853670,1,3,0,5,1,2,1
"e2911e79efc2420eac45d9f671463d4b","e2911e79efc2420eac45d9f671463d4b",22853670,2,0,1,6,2,2,0
"e2911e79efc2420eac45d9f671463d4b","519d1b8c59404d67b54e96c5c8a830b2",22853670,1,1,0,8,2,3,1
"519d1b8c59404d67b54e96c5c8a830b2","519d1b8c59404d67b54e96c5c8a830b2",22853670,1,0,1,9,3,3,0
"519d1b8c59404d67b54e96c5c8a830b2","531db53f81f646edb0cdcfe0085b03b7",22853670,1,1,0,10,3,4,1
"531db53f81f646edb0cdcfe0085b03b7","531db53f81f646edb0cdcfe0085b03b7",22853670,1,0,1,11,4,4,0
"531db53f81f646edb0cdcfe0085b03b7","4f5f94b2f95141e0a9d53a61da2276da",22853670,1,1,0,12,4,5,1
"4f5f94b2f95141e0a9d53a61da2276da","4f5f94b2f95141e0a9d53a61da2276da",22853670,1,0,1,13,5,5,0
"4f5f94b2f95141e0a9d53a61da2276da","6d541c89590949f99af293c4f2333f67",22853670,1,1,0,14,5,6,1
"6d541c89590949f99af293c4f2333f67","6d541c89590949f99af293c4f2333f67",22853670,1,0,1,15,6,6,0
"6d541c89590949f99af293c4f2333f67","dd5cf0b9fe4c4f1d8f5ff8e4c04879cb",22853670,1,1,0,16,6,7,1
"dd5cf0b9fe4c4f1d8f5ff8e4c04879cb","dd5cf0b9fe4c4f1d8f5ff8e4c04879cb",22853670,2,0,1,17,7,7,0
"dd5cf0b9fe4c4f1d8f5ff8e4c04879cb","f96261861edc426abe2248be4f0a709a",22853670,1,1,0,19,7,8,1
"f96261861edc426abe2248be4f0a709a","f96261861edc426abe2248be4f0a709a",22853670,2,0,1,20,8,8,0
"f96261861edc426abe2248be4f0a709a","66b5e16f4f75454fb5b8172079f0fa83",22853670,1,1,0,22,8,9,1
"66b5e16f4f75454fb5b8172079f0fa83","66b5e16f4f75454fb5b8172079f0fa83",22853670,2,0,1,23,9,9,0
"66b5e16f4f75454fb5b8172079f0fa83","0680571d4698477995e41842c36a54b2",22853670,1,1,0,25,9,10,1
"0680571d4698477995e41842c36a54b2","0680571d4698477995e41842c36a54b2",22853670,1,0,1,26,10,10,0
"0680571d4698477995e41842c36a54b2","9112f2bffece48e08c6d2287be204085",22853670,1,1,0,27,10,11,1
"9112f2bffece48e08c6d2287be204085","9112f2bffece48e08c6d2287be204085",22853670,1,0,1,28,11,11,0
"9112f2bffece48e08c6d2287be204085","e2911e79efc2420eac45d9f671463d4b",22853670,1,-9,0,29,11,2,-9
"e2911e79efc2420eac45d9f671463d4b","56586aa865414f538729c7f7735d2bc6",22853670,1,12,0,30,2,12,10
"56586aa865414f538729c7f7735d2bc6","56586aa865414f538729c7f7735d2bc6",22853670,3,0,1,31,12,12,0
"56586aa865414f538729c7f7735d2bc6","b7f2b31585d94eb3bf86376714aa7070",22853670,1,2,0,34,12,13,1
"b7f2b31585d94eb3bf86376714aa7070","b7f2b31585d94eb3bf86376714aa7070",22853670,2,0,1,35,13,13,0
"b7f2b31585d94eb3bf86376714aa7070","3f1c815879794b929260d224becaff7e",22853670,1,2,0,37,13,14,1
"3f1c815879794b929260d224becaff7e","5c5ceeee4562457ba6d41515aeebfbb1",22853670,1,6,0,38,14,17,3
"5c5ceeee4562457ba6d41515aeebfbb1","81c864a886d54a6b8ff85f7d736f4f95",22853670,1,-4,0,39,17,15,-2
"81c864a886d54a6b8ff85f7d736f4f95","5c5ceeee4562457ba6d41515aeebfbb1",22853670,1,4,0,40,15,17,2
"5c5ceeee4562457ba6d41515aeebfbb1","56586aa865414f538729c7f7735d2bc6",22853670,1,-10,0,41,17,12,-5
"56586aa865414f538729c7f7735d2bc6","9afd71a5298d4333b6849dfce1b9422c",22853670,1,13,0,42,12,18,6
"9afd71a5298d4333b6849dfce1b9422c","b7719e26494940efa49512aedd0aac79",22853670,1,4,0,45,18,20,2
"d4c3b003e8274e429d2fa688d73fde6d","d4c3b003e8274e429d2fa688d73fde6d",22853670,1,0,1,48,22,22,0
"d4c3b003e8274e429d2fa688d73fde6d","b7719e26494940efa49512aedd0aac79",22853670,1,-3,0,49,22,20,-2
"b7719e26494940efa49512aedd0aac79","b7719e26494940efa49512aedd0aac79",22853670,1,0,1,50,20,20,0
"afbf7250b99d47bea07172749483ca97","4e51676dc72045d99c19b9fa7b22f8bc",22853670,2,3,0,52,28,29,1
"4e51676dc72045d99c19b9fa7b22f8bc","afbf7250b99d47bea07172749483ca97",22853670,1,-3,0,53,29,28,-1
"4e51676dc72045d99c19b9fa7b22f8bc","51970cfa30e643e894e66ae85c8024cc",22853670,1,3,0,55,29,31,2
"51970cfa30e643e894e66ae85c8024cc","4e51676dc72045d99c19b9fa7b22f8bc",22853670,1,-3,0,56,31,29,-2
"4e51676dc72045d99c19b9fa7b22f8bc","c33c17be71ae4d588da7369472e5bb1b",22853670,1,9,0,57,29,34,5
"c33c17be71ae4d588da7369472e5bb1b","c33c17be71ae4d588da7369472e5bb1b",22853670,2,0,1,58,34,34,0
"c33c17be71ae4d588da7369472e5bb1b","4e51676dc72045d99c19b9fa7b22f8bc",22853670,1,-9,0,59,34,29,-5
"4e51676dc72045d99c19b9fa7b22f8bc","93679be414554a11b1893002f2229a93",22853670,1,12,0,60,29,35,6
"93679be414554a11b1893002f2229a93","93679be414554a11b1893002f2229a93",22853670,1,0,1,61,35,35,0
"93679be414554a11b1893002f2229a93","c33c17be71ae4d588da7369472e5bb1b",22853670,1,-3,0,62,35,34,-1
"c33c17be71ae4d588da7369472e5bb1b","93679be414554a11b1893002f2229a93",22853670,1,3,0,64,34,35,1
"93679be414554a11b1893002f2229a93","7040a13096d746ac84b8fac8d9752058",22853670,2,3,0,65,35,36,1
"7040a13096d746ac84b8fac8d9752058","93679be414554a11b1893002f2229a93",22853670,1,-3,0,66,36,35,-1
"7040a13096d746ac84b8fac8d9752058","9a0dc646f934470daf08c4b56ccf73db",22853670,2,3,0,68,36,37,1
"9a0dc646f934470daf08c4b56ccf73db","7040a13096d746ac84b8fac8d9752058",22853670,1,-3,0,69,37,36,-1
"9a0dc646f934470daf08c4b56ccf73db","fc0e049d56024bc9a02c9a9c435c3df7",22853670,1,3,0,71,37,38,1
"fc0e049d56024bc9a02c9a9c435c3df7","fc0e049d56024bc9a02c9a9c435c3df7",22853670,1,0,1,72,38,38,0
"fc0e049d56024bc9a02c9a9c435c3df7","67a089198fcb4e1c8f2385786c2b296f",22853670,1,4,0,73,38,39,1
"67a089198fcb4e1c8f2385786c2b296f","64d48c6c9c7940639a932219a6c87198",22853670,1,1,0,74,39,40,1
"64d48c6c9c7940639a932219a6c87198","64d48c6c9c7940639a932219a6c87198",22853670,1,0,1,75,40,40,0
"64d48c6c9c7940639a932219a6c87198","b534b89233134e30a9b5645138bfa9ee",22853670,1,3,0,76,40,41,1
"b534b89233134e30a9b5645138bfa9ee","67a089198fcb4e1c8f2385786c2b296f",22853670,1,-4,0,77,41,39,-2
"67a089198fcb4e1c8f2385786c2b296f","0e37b720d23b4e7f8b313e79313fd107",22853670,1,7,0,78,39,44,5
"0e37b720d23b4e7f8b313e79313fd107","0e37b720d23b4e7f8b313e79313fd107",22853670,1,0,1,79,44,44,0
"0e37b720d23b4e7f8b313e79313fd107","6875d67fdd5f48168b62719df449bebd",22853670,1,1,0,80,44,45,1
"6875d67fdd5f48168b62719df449bebd","6875d67fdd5f48168b62719df449bebd",22853670,1,0,1,81,45,45,0
"6875d67fdd5f48168b62719df449bebd","b534b89233134e30a9b5645138bfa9ee",22853670,1,-4,0,82,45,41,-4
"6e13d61a7bdb44bca949c9f86fab3be5","6e13d61a7bdb44bca949c9f86fab3be5",22853670,1,0,1,84,47,47,0
"6e13d61a7bdb44bca949c9f86fab3be5","195f78799f984cc2b06c48dfe36be751",22853670,1,2,0,85,47,49,2
"195f78799f984cc2b06c48dfe36be751","195f78799f984cc2b06c48dfe36be751",22853670,2,0,1,86,49,49,0
"195f78799f984cc2b06c48dfe36be751","d9c8d8c444a64dadbbb508652c721e17",22853670,1,-3,0,88,49,46,-3
"d0c74f735e024943943e40333d6d337f","d0c74f735e024943943e40333d6d337f",22853670,1,0,1,90,51,51,0
"d0c74f735e024943943e40333d6d337f","983f8ff320594b279a7f4a6fe132f9c5",22853670,1,2,0,91,51,53,2
"983f8ff320594b279a7f4a6fe132f9c5","983f8ff320594b279a7f4a6fe132f9c5",22853670,2,0,1,92,53,53,0
"983f8ff320594b279a7f4a6fe132f9c5","35adfa5d923046aebabfefd98f35ff05",22853670,1,1,0,94,53,54,1
"35adfa5d923046aebabfefd98f35ff05","35adfa5d923046aebabfefd98f35ff05",22853670,5,0,1,95,54,54,0
"35adfa5d923046aebabfefd98f35ff05","b6f8a98476224da1b40e555ececc7ed8",22853670,1,1,0,100,54,55,1
"b6f8a98476224da1b40e555ececc7ed8","b6f8a98476224da1b40e555ececc7ed8",22853670,6,0,1,101,55,55,0
"b6f8a98476224da1b40e555ececc7ed8","86e22cb5fe0e4b47a9489ecddf7ed78f",22853670,1,1,0,107,55,56,1
"86e22cb5fe0e4b47a9489ecddf7ed78f","86e22cb5fe0e4b47a9489ecddf7ed78f",22853670,2,0,1,108,56,56,0
"86e22cb5fe0e4b47a9489ecddf7ed78f","f924752d8a1149668870b1e7698486f7",22853670,1,-6,0,110,56,50,-6
"f924752d8a1149668870b1e7698486f7","78f30e4dcac84e3cbea8b2cc6e0d62b3",22853670,1,10,0,111,50,59,9
"78f30e4dcac84e3cbea8b2cc6e0d62b3","a1f2f12debe5432fb7a70bcd12bacfb9",22853670,1,-1,0,112,59,58,-1
"a1f2f12debe5432fb7a70bcd12bacfb9","a1f2f12debe5432fb7a70bcd12bacfb9",22853670,17,0,1,113,58,58,0
"a1f2f12debe5432fb7a70bcd12bacfb9","78f30e4dcac84e3cbea8b2cc6e0d62b3",22853670,1,1,0,130,58,59,1
"78f30e4dcac84e3cbea8b2cc6e0d62b3","78f30e4dcac84e3cbea8b2cc6e0d62b3",22853670,15,0,1,131,59,59,0
"78f30e4dcac84e3cbea8b2cc6e0d62b3","bc42d26810654ea9a1df1efe1e58c7d5",22853670,1,5,0,146,59,63,4
"bc42d26810654ea9a1df1efe1e58c7d5","a0a418b8540d479fa6e0f653b701da8b",22853670,3,1,0,147,63,64,1
"a0a418b8540d479fa6e0f653b701da8b","12aa6e1672ac4e7aa6449a7a8609cd72",22853670,1,-8,0,148,64,57,-7
"12aa6e1672ac4e7aa6449a7a8609cd72","9afd71a5298d4333b6849dfce1b9422c",22853670,1,-67,0,149,57,18,-39
"9afd71a5298d4333b6849dfce1b9422c","309ccf3cc4fe429d9bfbaef53d3fa479",22853670,1,71,0,150,18,60,42
"309ccf3cc4fe429d9bfbaef53d3fa479","b534b89233134e30a9b5645138bfa9ee",22853670,1,-23,0,151,60,41,-19
"b534b89233134e30a9b5645138bfa9ee","bc42d26810654ea9a1df1efe1e58c7d5",22853670,1,26,0,152,41,63,22
"a0a418b8540d479fa6e0f653b701da8b","4c943503763e4e349906eea3ed3c8e86",22853670,1,-3,0,154,64,61,-3
"4c943503763e4e349906eea3ed3c8e86","4c943503763e4e349906eea3ed3c8e86",22853670,1,0,1,155,61,61,0
"4c943503763e4e349906eea3ed3c8e86","bc42d26810654ea9a1df1efe1e58c7d5",22853670,1,2,0,156,61,63,2
"bc42d26810654ea9a1df1efe1e58c7d5","bc42d26810654ea9a1df1efe1e58c7d5",22853670,3,0,1,157,63,63,0
"a0a418b8540d479fa6e0f653b701da8b","a0a418b8540d479fa6e0f653b701da8b",22853670,3,0,1,161,64,64,0
"a0a418b8540d479fa6e0f653b701da8b","309ccf3cc4fe429d9bfbaef53d3fa479",22853670,1,-4,0,164,64,60,-4
"309ccf3cc4fe429d9bfbaef53d3fa479","d646286c8051419bbc2e31dd1db55ca8",22853670,1,10,0,165,60,67,7
"d646286c8051419bbc2e31dd1db55ca8","b534b89233134e30a9b5645138bfa9ee",22853670,1,-33,0,166,67,41,-26
"b534b89233134e30a9b5645138bfa9ee","267f883678b24aed855fde42524975d9",22853670,1,37,0,167,41,71,30
"267f883678b24aed855fde42524975d9","267f883678b24aed855fde42524975d9",22853670,1,0,1,168,71,71,0
"267f883678b24aed855fde42524975d9","88fff56d0342490dbef9040750a20f6c",22853670,1,1,0,169,71,72,1
"88fff56d0342490dbef9040750a20f6c","88fff56d0342490dbef9040750a20f6c",22853670,1,0,1,170,72,72,0
"88fff56d0342490dbef9040750a20f6c","adb17b12b66c4a49a85fd34322f7df70",22853670,1,1,0,171,72,73,1
"adb17b12b66c4a49a85fd34322f7df70","adb17b12b66c4a49a85fd34322f7df70",22853670,1,0,1,172,73,73,0
"adb17b12b66c4a49a85fd34322f7df70","d646286c8051419bbc2e31dd1db55ca8",22853670,1,-6,0,173,73,67,-6
"d646286c8051419bbc2e31dd1db55ca8","a2becd407db34b189200a32546d9d569",22853670,2,9,0,174,67,75,8
"a2becd407db34b189200a32546d9d569","a2becd407db34b189200a32546d9d569",22853670,1,0,1,175,75,75,0
"a2becd407db34b189200a32546d9d569","58c22b011d0f4c2ea6d13615edbb9eeb",22853670,1,2,0,176,75,77,2
"58c22b011d0f4c2ea6d13615edbb9eeb","58c22b011d0f4c2ea6d13615edbb9eeb",22853670,5,0,1,177,77,77,0
"58c22b011d0f4c2ea6d13615edbb9eeb","dd76e1861dc9461c830888729d091ee0",22853670,1,1,0,182,77,78,1
"dd76e1861dc9461c830888729d091ee0","dd76e1861dc9461c830888729d091ee0",22853670,5,0,1,183,78,78,0
"dd76e1861dc9461c830888729d091ee0","cd1d828f1a694b87913a7ea66c23803e",22853670,1,1,0,188,78,79,1
"cd1d828f1a694b87913a7ea66c23803e","cd1d828f1a694b87913a7ea66c23803e",22853670,2,0,1,189,79,79,0
"cd1d828f1a694b87913a7ea66c23803e","9176a3c2b4d2465fa8b0c67096c2a97e",22853670,1,1,0,191,79,80,1
"9176a3c2b4d2465fa8b0c67096c2a97e","9176a3c2b4d2465fa8b0c67096c2a97e",22853670,10,0,1,192,80,80,0
"9176a3c2b4d2465fa8b0c67096c2a97e","f8ec6445f7194e25b9101d4fbcb07a18",22853670,1,1,0,197,80,81,1
"f8ec6445f7194e25b9101d4fbcb07a18","f8ec6445f7194e25b9101d4fbcb07a18",22853670,2,0,1,198,81,81,0
"f8ec6445f7194e25b9101d4fbcb07a18","140d5b27b8574befad82c0a013b59dfa",22853670,1,-7,0,200,81,74,-7
"140d5b27b8574befad82c0a013b59dfa","d18a9ea32855445f8736581f5cb119ce",22853670,2,9,0,201,74,82,8
"d18a9ea32855445f8736581f5cb119ce","f564483cbd7a407681aa2fcca518cf5f",22853670,1,4,0,202,82,85,3
"f564483cbd7a407681aa2fcca518cf5f","f564483cbd7a407681aa2fcca518cf5f",22853670,9,0,1,203,85,85,0
"f564483cbd7a407681aa2fcca518cf5f","18fd01350bd5434ca636d59a599d768a",22853670,1,1,0,212,85,86,1
"18fd01350bd5434ca636d59a599d768a","18fd01350bd5434ca636d59a599d768a",22853670,8,0,1,213,86,86,0
"18fd01350bd5434ca636d59a599d768a","ae5ac430ea254e708a6f5deaaf7464ae",22853670,1,-2,0,221,86,84,-2
"ae5ac430ea254e708a6f5deaaf7464ae","6a9f0ef185fb47f0937e29daa1c71ed5",22853670,2,7,0,222,84,90,6
"6a9f0ef185fb47f0937e29daa1c71ed5","c681290961c94c4caf23b529d1ae6b9a",22853670,1,-2,0,223,90,88,-2
"c681290961c94c4caf23b529d1ae6b9a","c681290961c94c4caf23b529d1ae6b9a",22853670,1,0,1,224,88,88,0
"c681290961c94c4caf23b529d1ae6b9a","6a9f0ef185fb47f0937e29daa1c71ed5",22853670,1,2,0,225,88,90,2
"6a9f0ef185fb47f0937e29daa1c71ed5","6a9f0ef185fb47f0937e29daa1c71ed5",22853670,4,0,1,226,90,90,0
"6a9f0ef185fb47f0937e29daa1c71ed5","d646286c8051419bbc2e31dd1db55ca8",22853670,2,-27,0,229,90,67,-23
"d646286c8051419bbc2e31dd1db55ca8","e20db35ced8544ddac5bc3839145e463",22853670,2,30,0,230,67,91,24
"e20db35ced8544ddac5bc3839145e463","1febb706d7a34005ae8711ed49c76e64",22853670,1,3,0,231,91,94,3
"1febb706d7a34005ae8711ed49c76e64","1febb706d7a34005ae8711ed49c76e64",22853670,2,0,1,232,94,94,0
"1febb706d7a34005ae8711ed49c76e64","8f73ba6f5a0042f2850356ac38ac6f24",22853670,1,1,0,234,94,95,1
"8f73ba6f5a0042f2850356ac38ac6f24","8f73ba6f5a0042f2850356ac38ac6f24",22853670,5,0,1,235,95,95,0
"8f73ba6f5a0042f2850356ac38ac6f24","e2260b86653c46d7b14a41fb419dbf8c",22853670,1,1,0,240,95,96,1
"e2260b86653c46d7b14a41fb419dbf8c","e2260b86653c46d7b14a41fb419dbf8c",22853670,2,0,1,241,96,96,0
"e2260b86653c46d7b14a41fb419dbf8c","35eb641ad1d845bbba54915bce75a962",22853670,1,1,0,243,96,97,1
"35eb641ad1d845bbba54915bce75a962","35eb641ad1d845bbba54915bce75a962",22853670,5,0,1,244,97,97,0
"35eb641ad1d845bbba54915bce75a962","08be90ffbeea4795a138cd42ed8db56f",22853670,1,1,0,249,97,98,1
"08be90ffbeea4795a138cd42ed8db56f","08be90ffbeea4795a138cd42ed8db56f",22853670,2,0,1,250,98,98,0
"08be90ffbeea4795a138cd42ed8db56f","3007433c8f584dcbb5ac159c1c5f2be3",22853670,1,1,0,252,98,99,1
"3007433c8f584dcbb5ac159c1c5f2be3","3007433c8f584dcbb5ac159c1c5f2be3",22853670,2,0,1,253,99,99,0
"3007433c8f584dcbb5ac159c1c5f2be3","00ae5f0c51874a73a41ebea838d95682",22853670,1,3,0,255,99,101,2
"00ae5f0c51874a73a41ebea838d95682","e20db35ced8544ddac5bc3839145e463",22853670,1,-11,0,256,101,91,-10
"e20db35ced8544ddac5bc3839145e463","d391c8b6e56a43a7b654e9dee02d904b",22853670,1,13,0,257,91,103,12
"d391c8b6e56a43a7b654e9dee02d904b","e20db35ced8544ddac5bc3839145e463",22853670,1,-13,0,258,103,91,-12
"e20db35ced8544ddac5bc3839145e463","73039f8c1eb9409cb4caee2cf968001e",22853670,1,10,0,259,91,100,9
"73039f8c1eb9409cb4caee2cf968001e","00ae5f0c51874a73a41ebea838d95682",22853670,1,1,0,260,100,101,1
"00ae5f0c51874a73a41ebea838d95682","d391c8b6e56a43a7b654e9dee02d904b",22853670,3,2,0,261,101,103,2
"d391c8b6e56a43a7b654e9dee02d904b","00ae5f0c51874a73a41ebea838d95682",22853670,1,-2,0,262,103,101,-2
"d391c8b6e56a43a7b654e9dee02d904b","d391c8b6e56a43a7b654e9dee02d904b",22853670,15,0,1,264,103,103,0
"d391c8b6e56a43a7b654e9dee02d904b","6111116566fc4fd9abba409322bea245",22853670,1,1,0,279,103,104,1
"6111116566fc4fd9abba409322bea245","6111116566fc4fd9abba409322bea245",22853670,2,0,1,280,104,104,0
"6111116566fc4fd9abba409322bea245","a81b2235cb9c499eb9ea8ee0a8dd9725",22853670,1,1,0,282,104,105,1
"a81b2235cb9c499eb9ea8ee0a8dd9725","a81b2235cb9c499eb9ea8ee0a8dd9725",22853670,2,0,1,283,105,105,0
"a81b2235cb9c499eb9ea8ee0a8dd9725","2d4e0ab0ef3b4d73b82c72d4621a7579",22853670,1,1,0,285,105,106,1
"2d4e0ab0ef3b4d73b82c72d4621a7579","2d4e0ab0ef3b4d73b82c72d4621a7579",22853670,2,0,1,286,106,106,0
"2d4e0ab0ef3b4d73b82c72d4621a7579","8bdebf492ebd4e62b0d522e8ab5e5197",22853670,1,1,0,288,106,107,1
"8bdebf492ebd4e62b0d522e8ab5e5197","8bdebf492ebd4e62b0d522e8ab5e5197",22853670,2,0,1,289,107,107,0
"8bdebf492ebd4e62b0d522e8ab5e5197","4280927ec4d643238aa49c32f9e06c6c",22853670,1,3,0,291,107,109,2
"4280927ec4d643238aa49c32f9e06c6c","73039f8c1eb9409cb4caee2cf968001e",22853670,1,-10,0,292,109,100,-9
"73039f8c1eb9409cb4caee2cf968001e","4280927ec4d643238aa49c32f9e06c6c",22853670,1,10,0,293,100,109,9
"4280927ec4d643238aa49c32f9e06c6c","fc44e6a5f7654430af1227838224dceb",22853670,1,2,0,294,109,111,2
"fc44e6a5f7654430af1227838224dceb","fc44e6a5f7654430af1227838224dceb",22853670,5,0,1,295,111,111,0
"fc44e6a5f7654430af1227838224dceb","08111f75e22d409998cf8b85bd431f0a",22853670,1,-3,0,300,111,108,-3
"08111f75e22d409998cf8b85bd431f0a","a9ae0a3c070d455bb4369a8996313336",22853670,1,7,0,301,108,114,6
"a9ae0a3c070d455bb4369a8996313336","a9ae0a3c070d455bb4369a8996313336",22853670,1,0,1,302,114,114,0
"a9ae0a3c070d455bb4369a8996313336","e20db35ced8544ddac5bc3839145e463",22853670,1,-26,0,303,114,91,-23
"e20db35ced8544ddac5bc3839145e463","00ae5f0c51874a73a41ebea838d95682",22853670,1,11,0,304,91,101,10
"d391c8b6e56a43a7b654e9dee02d904b","73039f8c1eb9409cb4caee2cf968001e",22853670,1,-3,0,306,103,100,-3
"73039f8c1eb9409cb4caee2cf968001e","a9ae0a3c070d455bb4369a8996313336",22853670,1,16,0,307,100,114,14
"a9ae0a3c070d455bb4369a8996313336","71cec822bcff4f30a20e75dc63ef7b65",22853670,1,2,0,308,114,116,2
"71cec822bcff4f30a20e75dc63ef7b65","71cec822bcff4f30a20e75dc63ef7b65",22853670,1,0,1,309,116,116,0
"71cec822bcff4f30a20e75dc63ef7b65","62bff51286ef4f348717a3cf6fe2318f",22853670,1,5,0,310,116,120,4
"62bff51286ef4f348717a3cf6fe2318f","37319e88176d4aefa91d7a9980dbae91",22853670,1,-9,0,311,120,112,-8
"37319e88176d4aefa91d7a9980dbae91","b1cd0e7dc3ad4a8eb91a4bfdbeb025b0",22853670,1,7,0,312,112,118,6
"b1cd0e7dc3ad4a8eb91a4bfdbeb025b0","b1cd0e7dc3ad4a8eb91a4bfdbeb025b0",22853670,1,0,1,313,118,118,0
"b1cd0e7dc3ad4a8eb91a4bfdbeb025b0","62bff51286ef4f348717a3cf6fe2318f",22853670,1,2,0,314,118,120,2
"62bff51286ef4f348717a3cf6fe2318f","62bff51286ef4f348717a3cf6fe2318f",22853670,3,0,1,315,120,120,0
"62bff51286ef4f348717a3cf6fe2318f","779f9ddd1fd14d1e9e69f72219a1fdbd",22853670,1,3,0,318,120,121,1
"779f9ddd1fd14d1e9e69f72219a1fdbd","e20db35ced8544ddac5bc3839145e463",22853670,1,-36,0,319,121,91,-30
"e20db35ced8544ddac5bc3839145e463","9afd71a5298d4333b6849dfce1b9422c",22853670,1,-111,0,320,91,18,-73
"9afd71a5298d4333b6849dfce1b9422c","779f9ddd1fd14d1e9e69f72219a1fdbd",22853670,1,147,0,321,18,121,103
"779f9ddd1fd14d1e9e69f72219a1fdbd","779f9ddd1fd14d1e9e69f72219a1fdbd",22853670,1,0,1,322,121,121,0
"779f9ddd1fd14d1e9e69f72219a1fdbd","ae26e6cda8ad4a3f81bd347560d9579f",22853670,1,4,0,323,121,125,4
"ae26e6cda8ad4a3f81bd347560d9579f","ae26e6cda8ad4a3f81bd347560d9579f",22853670,1,0,1,324,125,125,0
"ae26e6cda8ad4a3f81bd347560d9579f","ee48df95832b4374aa273ceb27ec1315",22853670,1,1,0,325,125,126,1
"ee48df95832b4374aa273ceb27ec1315","ee48df95832b4374aa273ceb27ec1315",22853670,1,0,1,326,126,126,0
"ee48df95832b4374aa273ceb27ec1315","7a439da90b394756ad1777fc4c6dead5",22853670,1,1,0,327,126,127,1
"7a439da90b394756ad1777fc4c6dead5","7a439da90b394756ad1777fc4c6dead5",22853670,1,0,1,328,127,127,0
"7a439da90b394756ad1777fc4c6dead5","779f9ddd1fd14d1e9e69f72219a1fdbd",22853670,1,-6,0,329,127,121,-6
"779f9ddd1fd14d1e9e69f72219a1fdbd","a8dd5213034441ac92724b4e83eb0bb2",22853670,1,9,0,330,121,129,8
"a8dd5213034441ac92724b4e83eb0bb2","a8dd5213034441ac92724b4e83eb0bb2",22853670,1,0,1,331,129,129,0
"a8dd5213034441ac92724b4e83eb0bb2","8115eab6556b45f5b415c3b8c26a12e5",22853670,1,2,0,332,129,131,2
"8115eab6556b45f5b415c3b8c26a12e5","8115eab6556b45f5b415c3b8c26a12e5",22853670,2,0,1,333,131,131,0
"8115eab6556b45f5b415c3b8c26a12e5","ec34b06efd844b46a4c4818ecdb9b8f4",22853670,1,1,0,335,131,132,1
"ec34b06efd844b46a4c4818ecdb9b8f4","ec34b06efd844b46a4c4818ecdb9b8f4",22853670,5,0,1,336,132,132,0
"ec34b06efd844b46a4c4818ecdb9b8f4","c2e1c2b9eac64109b343a088584b576b",22853670,1,1,0,341,132,133,1
"c2e1c2b9eac64109b343a088584b576b","c2e1c2b9eac64109b343a088584b576b",22853670,2,0,1,342,133,133,0
"c2e1c2b9eac64109b343a088584b576b","579338175e0b4bbb8ef3b712b5d8b54e",22853670,1,-5,0,344,133,128,-5
"579338175e0b4bbb8ef3b712b5d8b54e","8bc5795d6a984a3eace4e2811e52dd4f",22853670,1,8,0,345,128,135,7
"8bc5795d6a984a3eace4e2811e52dd4f","8bc5795d6a984a3eace4e2811e52dd4f",22853670,1,0,1,346,135,135,0
"8bc5795d6a984a3eace4e2811e52dd4f","b416d47c56a742199b5d7c7f19d6503a",22853670,1,-1,0,347,135,134,-1
"b416d47c56a742199b5d7c7f19d6503a","cd4532ad48034873ba8bce2aac0c9808",22853670,1,4,0,348,134,137,3
"cd4532ad48034873ba8bce2aac0c9808","cd4532ad48034873ba8bce2aac0c9808",22853670,1,0,1,349,137,137,0
"cd4532ad48034873ba8bce2aac0c9808","779f9ddd1fd14d1e9e69f72219a1fdbd",22853670,1,-19,0,350,137,121,-16
"779f9ddd1fd14d1e9e69f72219a1fdbd","df1de691dafe4549a18a4398ee9dfaf9",22853670,1,23,0,351,121,139,18
"df1de691dafe4549a18a4398ee9dfaf9","6c5ad271a44743479bfaea29b1db8d02",22853670,1,4,0,352,139,143,4
"6c5ad271a44743479bfaea29b1db8d02","6c5ad271a44743479bfaea29b1db8d02",22853670,1,0,1,353,143,143,0
"6c5ad271a44743479bfaea29b1db8d02","83d311bed5374fee83d8d67a7d9d82dc",22853670,1,1,0,354,143,144,1
"83d311bed5374fee83d8d67a7d9d82dc","83d311bed5374fee83d8d67a7d9d82dc",22853670,1,0,1,355,144,144,0
"83d311bed5374fee83d8d67a7d9d82dc","402bba41861d43acb52a5abb89e8831e",22853670,1,1,0,356,144,145,1
"402bba41861d43acb52a5abb89e8831e","402bba41861d43acb52a5abb89e8831e",22853670,2,0,1,357,145,145,0
"402bba41861d43acb52a5abb89e8831e","df1de691dafe4549a18a4398ee9dfaf9",22853670,1,-6,0,359,145,139,-6
"df1de691dafe4549a18a4398ee9dfaf9","8aae34f5ddbb4052a709b12e6b0d40fa",22853670,1,9,0,360,139,147,8
"8aae34f5ddbb4052a709b12e6b0d40fa","8aae34f5ddbb4052a709b12e6b0d40fa",22853670,1,0,1,361,147,147,0
"8aae34f5ddbb4052a709b12e6b0d40fa","645b3f0249f64f76af2e19eb4d0e55b7",22853670,1,2,0,362,147,149,2
"645b3f0249f64f76af2e19eb4d0e55b7","645b3f0249f64f76af2e19eb4d0e55b7",22853670,2,0,1,363,149,149,0
"645b3f0249f64f76af2e19eb4d0e55b7","7e7b8db5064d4369805ab370aac5ddfb",22853670,1,1,0,365,149,150,1
"7e7b8db5064d4369805ab370aac5ddfb","7e7b8db5064d4369805ab370aac5ddfb",22853670,2,0,1,366,150,150,0
"7e7b8db5064d4369805ab370aac5ddfb","8956d210ae7f41968fada86d4c979d6a",22853670,1,1,0,368,150,151,1
"8956d210ae7f41968fada86d4c979d6a","8956d210ae7f41968fada86d4c979d6a",22853670,2,0,1,369,151,151,0
"8956d210ae7f41968fada86d4c979d6a","f902b0f41b544d4dbf79664fd233648d",22853670,1,-5,0,371,151,146,-5
"f902b0f41b544d4dbf79664fd233648d","ae781e8b775e4ccd93bc800dad5c8376",22853670,1,8,0,372,146,153,7
"ae781e8b775e4ccd93bc800dad5c8376","ae781e8b775e4ccd93bc800dad5c8376",22853670,2,0,1,373,153,153,0
"ae781e8b775e4ccd93bc800dad5c8376","06882a8492d9499aa31555567f575ecb",22853670,1,1,0,375,153,154,1
"06882a8492d9499aa31555567f575ecb","06882a8492d9499aa31555567f575ecb",22853670,1,0,1,376,154,154,0
"06882a8492d9499aa31555567f575ecb","f293c508f409466a8f27ddd7d1e40b20",22853670,1,1,0,377,154,155,1
"f293c508f409466a8f27ddd7d1e40b20","f293c508f409466a8f27ddd7d1e40b20",22853670,2,0,1,378,155,155,0
"f293c508f409466a8f27ddd7d1e40b20","cc4ddef5bbbe48ebb605141b347c4ed1",22853670,1,1,0,380,155,156,1
"cc4ddef5bbbe48ebb605141b347c4ed1","cc4ddef5bbbe48ebb605141b347c4ed1",22853670,1,0,1,381,156,156,0
"cc4ddef5bbbe48ebb605141b347c4ed1","d313cec988a84645bee413e8d4724a4b",22853670,1,3,0,382,156,158,2
"d313cec988a84645bee413e8d4724a4b","f03480cf4eba413194d7af52fc0e7f28",22853670,1,-7,0,383,158,152,-6
"f03480cf4eba413194d7af52fc0e7f28","d313cec988a84645bee413e8d4724a4b",22853670,1,7,0,384,152,158,6
"d313cec988a84645bee413e8d4724a4b","d313cec988a84645bee413e8d4724a4b",22853670,3,0,1,385,158,158,0
"d313cec988a84645bee413e8d4724a4b","dc60696c76a74368a60f72246e47700d",22853670,1,1,0,388,158,159,1
"dc60696c76a74368a60f72246e47700d","dc60696c76a74368a60f72246e47700d",22853670,1,0,1,389,159,159,0
"dc60696c76a74368a60f72246e47700d","df1de691dafe4549a18a4398ee9dfaf9",22853670,1,-23,0,390,159,139,-20
"df1de691dafe4549a18a4398ee9dfaf9","78adeee1fa2c4fe0bc73f7bca9fcee86",22853670,1,26,0,391,139,160,21
"78adeee1fa2c4fe0bc73f7bca9fcee86","78adeee1fa2c4fe0bc73f7bca9fcee86",22853670,3,0,1,392,160,160,0
"78adeee1fa2c4fe0bc73f7bca9fcee86","65202579580f4ad38d734b4ee39d22a8",22853670,9,5,0,395,160,164,4
"65202579580f4ad38d734b4ee39d22a8","65202579580f4ad38d734b4ee39d22a8",22853670,124,0,1,396,164,164,0
"65202579580f4ad38d734b4ee39d22a8","78adeee1fa2c4fe0bc73f7bca9fcee86",22853670,5,-5,0,403,164,160,-4
"65202579580f4ad38d734b4ee39d22a8","d9c8d8c444a64dadbbb508652c721e17",22853670,1,-147,0,412,164,46,-118
"d9c8d8c444a64dadbbb508652c721e17","b534b89233134e30a9b5645138bfa9ee",22853670,1,-6,0,413,46,41,-5
"b534b89233134e30a9b5645138bfa9ee","6e13d61a7bdb44bca949c9f86fab3be5",22853670,2,7,0,414,41,47,6
"6e13d61a7bdb44bca949c9f86fab3be5","d9c8d8c444a64dadbbb508652c721e17",22853670,1,-1,0,415,47,46,-1
"d9c8d8c444a64dadbbb508652c721e17","d0c74f735e024943943e40333d6d337f",22853670,2,6,0,416,46,51,5
"d0c74f735e024943943e40333d6d337f","b534b89233134e30a9b5645138bfa9ee",22853670,1,-12,0,417,51,41,-10
"b534b89233134e30a9b5645138bfa9ee","78adeee1fa2c4fe0bc73f7bca9fcee86",22853670,1,148,0,418,41,160,119
"78adeee1fa2c4fe0bc73f7bca9fcee86","3cbcea2be0984e7dbd5a48195af10ce7",22853670,2,8,0,473,160,165,5
"3cbcea2be0984e7dbd5a48195af10ce7","82e6285962b8400d9d6fc32436022a94",22853670,2,2,0,474,165,167,2
"82e6285962b8400d9d6fc32436022a94","a9ac840f098c4bd0a2ee896214ce29cd",22853670,1,3,0,475,167,168,1
"a9ac840f098c4bd0a2ee896214ce29cd","3cbcea2be0984e7dbd5a48195af10ce7",22853670,1,-5,0,476,168,165,-3
"3cbcea2be0984e7dbd5a48195af10ce7","8959e6304a0348309a771e4d08d1b64a",22853670,1,-4,0,477,165,163,-2
"8959e6304a0348309a771e4d08d1b64a","78adeee1fa2c4fe0bc73f7bca9fcee86",22853670,3,-4,0,478,163,160,-3
"82e6285962b8400d9d6fc32436022a94","3cbcea2be0984e7dbd5a48195af10ce7",22853670,2,-2,0,490,167,165,-2
"3cbcea2be0984e7dbd5a48195af10ce7","a9ac840f098c4bd0a2ee896214ce29cd",22853670,2,5,0,491,165,168,3
"a9ac840f098c4bd0a2ee896214ce29cd","67a089198fcb4e1c8f2385786c2b296f",22853670,1,-165,0,492,168,39,-129
"67a089198fcb4e1c8f2385786c2b296f","8959e6304a0348309a771e4d08d1b64a",22853670,1,156,0,493,39,163,124
"65202579580f4ad38d734b4ee39d22a8","8959e6304a0348309a771e4d08d1b64a",22853670,1,-1,0,503,164,163,-1
"65202579580f4ad38d734b4ee39d22a8","9afd71a5298d4333b6849dfce1b9422c",22853670,2,-201,0,513,164,18,-146
"9afd71a5298d4333b6849dfce1b9422c","78adeee1fa2c4fe0bc73f7bca9fcee86",22853670,1,196,0,514,18,160,142
"78adeee1fa2c4fe0bc73f7bca9fcee86","8959e6304a0348309a771e4d08d1b64a",22853670,2,4,0,515,160,163,3
"8959e6304a0348309a771e4d08d1b64a","65202579580f4ad38d734b4ee39d22a8",22853670,2,1,0,516,163,164,1
"65202579580f4ad38d734b4ee39d22a8","0c7262dff33c4087bc660ccf40f92f9c",22853670,1,12,0,542,164,169,5
"b2275c3fad834f8d90737a2d9a6927d6","78adeee1fa2c4fe0bc73f7bca9fcee86",22853670,1,-20,0,544,172,160,-12
"65202579580f4ad38d734b4ee39d22a8","3cbcea2be0984e7dbd5a48195af10ce7",22853670,1,3,0,556,164,165,1
"3cbcea2be0984e7dbd5a48195af10ce7","78adeee1fa2c4fe0bc73f7bca9fcee86",22853670,1,-8,0,557,165,160,-5
"78adeee1fa2c4fe0bc73f7bca9fcee86","82e6285962b8400d9d6fc32436022a94",22853670,1,10,0,558,160,167,7
"a9ac840f098c4bd0a2ee896214ce29cd","a9ac840f098c4bd0a2ee896214ce29cd",22853670,1,0,1,561,168,168,0
"a9ac840f098c4bd0a2ee896214ce29cd","0c7262dff33c4087bc660ccf40f92f9c",22853670,1,4,0,562,168,169,1
"b2275c3fad834f8d90737a2d9a6927d6","b2275c3fad834f8d90737a2d9a6927d6",22853670,43,0,1,564,172,172,0
"b2275c3fad834f8d90737a2d9a6927d6","eb515a26030b41f8a82a1e6114420bad",22853670,1,1,0,584,172,173,1
"eb515a26030b41f8a82a1e6114420bad","eb515a26030b41f8a82a1e6114420bad",22853670,2,0,1,585,173,173,0
"eb515a26030b41f8a82a1e6114420bad","b2275c3fad834f8d90737a2d9a6927d6",22853670,1,-1,0,587,173,172,-1
"b2275c3fad834f8d90737a2d9a6927d6","0c7262dff33c4087bc660ccf40f92f9c",22853670,1,-3,0,611,172,169,-3
"0c7262dff33c4087bc660ccf40f92f9c","801f9e9135034f49bf5f8b4bdefedb41",22853670,1,9,0,612,169,177,8
"801f9e9135034f49bf5f8b4bdefedb41","801f9e9135034f49bf5f8b4bdefedb41",22853670,11,0,1,613,177,177,0
"801f9e9135034f49bf5f8b4bdefedb41","362fcb0699a14845ab29b2340093e528",22853670,1,-3,0,620,177,174,-3
"362fcb0699a14845ab29b2340093e528","b87c552dd247427abe6ab5795b9c9d43",22853670,2,8,0,621,174,181,7
"b87c552dd247427abe6ab5795b9c9d43","b87c552dd247427abe6ab5795b9c9d43",22853670,14,0,1,622,181,181,0
"b87c552dd247427abe6ab5795b9c9d43","139b097acfca451689d80c9c6eebdf7b",22853670,1,-3,0,636,181,178,-3
"139b097acfca451689d80c9c6eebdf7b","30f660a1feb34582a739722532524f79",22853670,1,6,0,637,178,183,5
"30f660a1feb34582a739722532524f79","30f660a1feb34582a739722532524f79",22853670,5,0,1,638,183,183,0
"30f660a1feb34582a739722532524f79","2024b4885bd14338a39b7b509acbbd02",22853670,1,-1,0,643,183,182,-1
"2024b4885bd14338a39b7b509acbbd02","cf4c280bad6a43e6b131d8385ef9ef3f",22853670,1,3,0,644,182,184,2
"cf4c280bad6a43e6b131d8385ef9ef3f","b87c552dd247427abe6ab5795b9c9d43",22853670,1,-5,0,645,184,181,-3
"b87c552dd247427abe6ab5795b9c9d43","78adeee1fa2c4fe0bc73f7bca9fcee86",22853670,1,-31,0,646,181,160,-21
"9afd71a5298d4333b6849dfce1b9422c","362fcb0699a14845ab29b2340093e528",22853670,1,219,0,656,18,174,156
"362fcb0699a14845ab29b2340093e528","0c7262dff33c4087bc660ccf40f92f9c",22853670,1,-6,0,657,174,169,-5
"0c7262dff33c4087bc660ccf40f92f9c","b42cc17b7de840f181a704558d0bc845",22853670,1,7,0,658,169,175,6
"b42cc17b7de840f181a704558d0bc845","801f9e9135034f49bf5f8b4bdefedb41",22853670,1,2,0,659,175,177,2
"801f9e9135034f49bf5f8b4bdefedb41","b87c552dd247427abe6ab5795b9c9d43",22853670,1,5,0,664,177,181,4
"b87c552dd247427abe6ab5795b9c9d43","ea38cc0e6e6e41edbabf210220808bf9",22853670,3,-2,0,665,181,179,-2
"ea38cc0e6e6e41edbabf210220808bf9","362fcb0699a14845ab29b2340093e528",22853670,1,-6,0,666,179,174,-5
"362fcb0699a14845ab29b2340093e528","139b097acfca451689d80c9c6eebdf7b",22853670,1,5,0,667,174,178,4
"139b097acfca451689d80c9c6eebdf7b","2024b4885bd14338a39b7b509acbbd02",22853670,2,5,0,668,178,182,4
"2024b4885bd14338a39b7b509acbbd02","ea38cc0e6e6e41edbabf210220808bf9",22853670,1,-4,0,669,182,179,-3
"ea38cc0e6e6e41edbabf210220808bf9","b87c552dd247427abe6ab5795b9c9d43",22853670,1,2,0,670,179,181,2
"ea38cc0e6e6e41edbabf210220808bf9","139b097acfca451689d80c9c6eebdf7b",22853670,2,-1,0,672,179,178,-1
"2024b4885bd14338a39b7b509acbbd02","b42cc17b7de840f181a704558d0bc845",22853670,1,-9,0,674,182,175,-7
"b42cc17b7de840f181a704558d0bc845","b42cc17b7de840f181a704558d0bc845",22853670,1,0,1,675,175,175,0
"b42cc17b7de840f181a704558d0bc845","362fcb0699a14845ab29b2340093e528",22853670,1,-1,0,676,175,174,-1
"139b097acfca451689d80c9c6eebdf7b","c3f63fe50d8e487c86bf8ef76c9cadd3",22853670,1,9,0,680,178,185,7
"c3f63fe50d8e487c86bf8ef76c9cadd3","c3f63fe50d8e487c86bf8ef76c9cadd3",22853670,1,0,1,681,185,185,0
"c3f63fe50d8e487c86bf8ef76c9cadd3","c8e371568a0c4391b25796ae4e91952e",22853670,1,3,0,682,185,186,1
"c8e371568a0c4391b25796ae4e91952e","0c7262dff33c4087bc660ccf40f92f9c",22853670,1,-23,0,683,186,169,-17
"0c7262dff33c4087bc660ccf40f92f9c","7d932b23e1c84326ae5aa4d3c0d813d1",22853670,1,25,0,684,169,188,19
"7d932b23e1c84326ae5aa4d3c0d813d1","7d932b23e1c84326ae5aa4d3c0d813d1",22853670,1,0,1,685,188,188,0
"7d932b23e1c84326ae5aa4d3c0d813d1","c8e371568a0c4391b25796ae4e91952e",22853670,1,-2,0,686,188,186,-2
"c8e371568a0c4391b25796ae4e91952e","ab11d94c6c8948ea90b88f19d2cd502b",22853670,1,5,0,687,186,190,4
"ab11d94c6c8948ea90b88f19d2cd502b","ab11d94c6c8948ea90b88f19d2cd502b",22853670,1,0,1,688,190,190,0
"ab11d94c6c8948ea90b88f19d2cd502b","f992451ed6ad4e68bb9e68ad6be7c4be",22853670,1,2,0,689,190,192,2
"f992451ed6ad4e68bb9e68ad6be7c4be","f992451ed6ad4e68bb9e68ad6be7c4be",22853670,1,0,1,690,192,192,0
"f992451ed6ad4e68bb9e68ad6be7c4be","07b44a7a51e94c78b411c753fc39dab0",22853670,1,-3,0,691,192,189,-3
"07b44a7a51e94c78b411c753fc39dab0","6cd2dcaac46847d4a0bc53f296d90375",22853670,1,6,0,692,189,194,5
"6cd2dcaac46847d4a0bc53f296d90375","6cd2dcaac46847d4a0bc53f296d90375",22853670,1,0,1,693,194,194,0
"6cd2dcaac46847d4a0bc53f296d90375","2d2580c9411c4972909db508d6956a58",22853670,1,2,0,694,194,196,2
"2d2580c9411c4972909db508d6956a58","2d2580c9411c4972909db508d6956a58",22853670,8,0,1,695,196,196,0
"2d2580c9411c4972909db508d6956a58","5bddb3d9ed264f3984702f048c7e5340",22853670,1,1,0,703,196,197,1
"5bddb3d9ed264f3984702f048c7e5340","5bddb3d9ed264f3984702f048c7e5340",22853670,2,0,1,704,197,197,0
"5bddb3d9ed264f3984702f048c7e5340","d5e8e2bd12a2466b9d6d90855f0eb079",22853670,1,1,0,706,197,198,1
"d5e8e2bd12a2466b9d6d90855f0eb079","d5e8e2bd12a2466b9d6d90855f0eb079",22853670,2,0,1,707,198,198,0
"d5e8e2bd12a2466b9d6d90855f0eb079","017d7ca8e0394b91aaadc9574df2202c",22853670,1,-5,0,709,198,193,-5
"017d7ca8e0394b91aaadc9574df2202c","54e8e9f0ea3e45c4bf3b8ac799ee31b1",22853670,1,8,0,710,193,200,7
"54e8e9f0ea3e45c4bf3b8ac799ee31b1","54e8e9f0ea3e45c4bf3b8ac799ee31b1",22853670,1,0,1,711,200,200,0
"54e8e9f0ea3e45c4bf3b8ac799ee31b1","c614a00911be4877a075f19315530fb0",22853670,1,1,0,712,200,201,1
"c614a00911be4877a075f19315530fb0","c614a00911be4877a075f19315530fb0",22853670,6,0,1,713,201,201,0
"c614a00911be4877a075f19315530fb0","a6c21bd8b95249c7972820a7a7d76aff",22853670,1,1,0,719,201,202,1
"a6c21bd8b95249c7972820a7a7d76aff","a6c21bd8b95249c7972820a7a7d76aff",22853670,1,0,1,720,202,202,0
"a6c21bd8b95249c7972820a7a7d76aff","bb329d880ab54120adaf203a693bb203",22853670,1,1,0,721,202,203,1
"bb329d880ab54120adaf203a693bb203","bb329d880ab54120adaf203a693bb203",22853670,1,0,1,722,203,203,0
"bb329d880ab54120adaf203a693bb203","f9170dd6bc6442b4acd832747609b09a",22853670,1,-4,0,723,203,199,-4
"f9170dd6bc6442b4acd832747609b09a","334c2344009840079b1d0e1b7ce3d5a7",22853670,1,7,0,724,199,205,6
"334c2344009840079b1d0e1b7ce3d5a7","334c2344009840079b1d0e1b7ce3d5a7",22853670,1,0,1,725,205,205,0
"334c2344009840079b1d0e1b7ce3d5a7","d7f13c8d63ec4e2aa673fbb9cf9c6933",22853670,1,3,0,726,205,206,1
"d7f13c8d63ec4e2aa673fbb9cf9c6933","c8e371568a0c4391b25796ae4e91952e",22853670,1,-26,0,727,206,186,-20
"c8e371568a0c4391b25796ae4e91952e","7108f0e4c2584f1f9c471689ae4c885c",22853670,1,28,0,728,186,208,22
"7108f0e4c2584f1f9c471689ae4c885c","b9e80f77c3a44349863b19875725c384",22853670,2,-1,0,729,208,207,-1
"b9e80f77c3a44349863b19875725c384","d7f13c8d63ec4e2aa673fbb9cf9c6933",22853670,1,-1,0,730,207,206,-1
"d7f13c8d63ec4e2aa673fbb9cf9c6933","d7f13c8d63ec4e2aa673fbb9cf9c6933",22853670,1,0,1,731,206,206,0
"d7f13c8d63ec4e2aa673fbb9cf9c6933","b9e80f77c3a44349863b19875725c384",22853670,1,1,0,732,206,207,1
"b9e80f77c3a44349863b19875725c384","7108f0e4c2584f1f9c471689ae4c885c",22853670,2,1,0,733,207,208,1
"b9e80f77c3a44349863b19875725c384","b9e80f77c3a44349863b19875725c384",22853670,17,0,1,735,207,207,0
"7108f0e4c2584f1f9c471689ae4c885c","7108f0e4c2584f1f9c471689ae4c885c",22853670,12,0,1,753,208,208,0
"7108f0e4c2584f1f9c471689ae4c885c","09400e101c5d4b439cf9a26b03aae558",22853670,1,3,0,765,208,210,2
"09400e101c5d4b439cf9a26b03aae558","d7f13c8d63ec4e2aa673fbb9cf9c6933",22853670,1,-5,0,766,210,206,-4
"d7f13c8d63ec4e2aa673fbb9cf9c6933","09400e101c5d4b439cf9a26b03aae558",22853670,1,5,0,767,206,210,4
"09400e101c5d4b439cf9a26b03aae558","09400e101c5d4b439cf9a26b03aae558",22853670,1,0,1,768,210,210,0
"09400e101c5d4b439cf9a26b03aae558","a88efa7e50ce47159810ab553afa6d3a",22853670,1,2,0,769,210,212,2
"a88efa7e50ce47159810ab553afa6d3a","a88efa7e50ce47159810ab553afa6d3a",22853670,5,0,1,770,212,212,0
"a88efa7e50ce47159810ab553afa6d3a","be502a7a43c44bf7b682698de79d9369",22853670,1,3,0,775,212,214,2
"be502a7a43c44bf7b682698de79d9369","f7fb1952f56b4189b86a9f8b7862d2b8",22853670,2,1,0,776,214,215,1
"f7fb1952f56b4189b86a9f8b7862d2b8","a875096404ef4a9984b62d74cda916f9",22853670,1,-7,0,777,215,209,-6
"a875096404ef4a9984b62d74cda916f9","be502a7a43c44bf7b682698de79d9369",22853670,1,6,0,778,209,214,5
"f7fb1952f56b4189b86a9f8b7862d2b8","f7fb1952f56b4189b86a9f8b7862d2b8",22853670,15,0,1,780,215,215,0
"f7fb1952f56b4189b86a9f8b7862d2b8","b860ee85d8bc4a2f97958cfb71be3533",22853670,1,1,0,795,215,216,1
"b860ee85d8bc4a2f97958cfb71be3533","b860ee85d8bc4a2f97958cfb71be3533",22853670,2,0,1,796,216,216,0
"b860ee85d8bc4a2f97958cfb71be3533","ec341f459285443b8361f7f15638ff08",22853670,1,-3,0,798,216,213,-3
"ec341f459285443b8361f7f15638ff08","363837c182e04711840d896ae1e0339c",22853670,1,6,0,799,213,218,5
"363837c182e04711840d896ae1e0339c","363837c182e04711840d896ae1e0339c",22853670,12,0,1,800,218,218,0
"363837c182e04711840d896ae1e0339c","01b2051f8941460d89945e3b02d1ce78",22853670,1,-1,0,812,218,217,-1
"01b2051f8941460d89945e3b02d1ce78","be95c065e45447c1bd8215ea6f130c7a",22853670,1,3,0,813,217,219,2
"be95c065e45447c1bd8215ea6f130c7a","d7f13c8d63ec4e2aa673fbb9cf9c6933",22853670,1,-17,0,814,219,206,-13
"d7f13c8d63ec4e2aa673fbb9cf9c6933","91125ca626c5470eb145501f8c37f8db",22853670,1,18,0,815,206,220,14
"91125ca626c5470eb145501f8c37f8db","91125ca626c5470eb145501f8c37f8db",22853670,1,0,1,816,220,220,0
"91125ca626c5470eb145501f8c37f8db","d7f13c8d63ec4e2aa673fbb9cf9c6933",22853670,1,-18,0,817,220,206,-14
"d7f13c8d63ec4e2aa673fbb9cf9c6933","1c6721b1f63f4d30ba7746ea8af02a52",22853670,1,21,0,818,206,221,15
"1c6721b1f63f4d30ba7746ea8af02a52","77ecef8eff6b4a2caea7707669bf7475",22853670,4,1,0,819,221,222,1
"77ecef8eff6b4a2caea7707669bf7475","1c6721b1f63f4d30ba7746ea8af02a52",22853670,4,-1,0,820,222,221,-1
"1c6721b1f63f4d30ba7746ea8af02a52","1c6721b1f63f4d30ba7746ea8af02a52",22853670,1,0,1,821,221,221,0
"77ecef8eff6b4a2caea7707669bf7475","77ecef8eff6b4a2caea7707669bf7475",22853670,12,0,1,823,222,222,0
"1c6721b1f63f4d30ba7746ea8af02a52","d03cb855c70044cf8c35d9ec0de696e3",22853670,1,4,0,836,221,224,3
"d03cb855c70044cf8c35d9ec0de696e3","8b9ae98743bd4d4a8a87dff1c1244211",22853670,1,3,0,837,224,227,3
"8b9ae98743bd4d4a8a87dff1c1244211","d03cb855c70044cf8c35d9ec0de696e3",22853670,1,-3,0,838,227,224,-3
"d03cb855c70044cf8c35d9ec0de696e3","a49a937d6896486d9a5396654abcf2e1",22853670,1,2,0,839,224,226,2
"a49a937d6896486d9a5396654abcf2e1","a49a937d6896486d9a5396654abcf2e1",22853670,1,0,1,840,226,226,0
"a49a937d6896486d9a5396654abcf2e1","8b9ae98743bd4d4a8a87dff1c1244211",22853670,1,1,0,841,226,227,1
"8b9ae98743bd4d4a8a87dff1c1244211","8b9ae98743bd4d4a8a87dff1c1244211",22853670,13,0,1,842,227,227,0
"8b9ae98743bd4d4a8a87dff1c1244211","f7906d6f59b9489a91d2ef40db5a474d",22853670,1,-4,0,855,227,223,-4
"f7906d6f59b9489a91d2ef40db5a474d","2ab1535aac1346ba8801535bf729ef37",22853670,1,7,0,856,223,229,6
"2ab1535aac1346ba8801535bf729ef37","2ab1535aac1346ba8801535bf729ef37",22853670,1,0,1,857,229,229,0
"2ab1535aac1346ba8801535bf729ef37","a4f40fb48a8542c8949bae1f002cd9bc",22853670,1,2,0,858,229,231,2
"a4f40fb48a8542c8949bae1f002cd9bc","a4f40fb48a8542c8949bae1f002cd9bc",22853670,2,0,1,859,231,231,0
"a4f40fb48a8542c8949bae1f002cd9bc","8972c23e32044edb8a78fa1eed4e5947",22853670,1,1,0,861,231,232,1
"8972c23e32044edb8a78fa1eed4e5947","8972c23e32044edb8a78fa1eed4e5947",22853670,1,0,1,862,232,232,0
"8972c23e32044edb8a78fa1eed4e5947","92feb4a40f8344d38b6f722e42a53295",22853670,1,1,0,863,232,233,1
"92feb4a40f8344d38b6f722e42a53295","92feb4a40f8344d38b6f722e42a53295",22853670,2,0,1,864,233,233,0
"92feb4a40f8344d38b6f722e42a53295","5152833676bf4c6cb317060be10f68db",22853670,1,-5,0,866,233,228,-5
"5152833676bf4c6cb317060be10f68db","ca3e28f290354c08aefe5b0f769604e6",22853670,1,8,0,867,228,235,7
"ca3e28f290354c08aefe5b0f769604e6","ca3e28f290354c08aefe5b0f769604e6",22853670,4,0,1,868,235,235,0
"ca3e28f290354c08aefe5b0f769604e6","79a35eea833e4c2c9d22fc53c3c6445c",22853670,1,1,0,872,235,236,1
"79a35eea833e4c2c9d22fc53c3c6445c","79a35eea833e4c2c9d22fc53c3c6445c",22853670,9,0,1,873,236,236,0
"79a35eea833e4c2c9d22fc53c3c6445c","1c6721b1f63f4d30ba7746ea8af02a52",22853670,1,-18,0,882,236,221,-15
"1c6721b1f63f4d30ba7746ea8af02a52","8f68228b1518449e9615cdafee41a2bd",22853670,1,19,0,885,221,237,16
"8f68228b1518449e9615cdafee41a2bd","8f68228b1518449e9615cdafee41a2bd",22853670,1,0,1,886,237,237,0
"8f68228b1518449e9615cdafee41a2bd","cab89fa5c3ed45a5aa550fc0352d6a42",22853670,1,1,0,887,237,238,1
"cab89fa5c3ed45a5aa550fc0352d6a42","cab89fa5c3ed45a5aa550fc0352d6a42",22853670,1,0,1,888,238,238,0
"cab89fa5c3ed45a5aa550fc0352d6a42","66d4fad4f1cf4b46be0750a99ad7a35a",22853670,1,1,0,889,238,239,1
"66d4fad4f1cf4b46be0750a99ad7a35a","66d4fad4f1cf4b46be0750a99ad7a35a",22853670,1,0,1,890,239,239,0
"66d4fad4f1cf4b46be0750a99ad7a35a","0b04c8e2f86d48c7aeb7e225819cd32b",22853670,1,-5,0,891,239,234,-5
"0b04c8e2f86d48c7aeb7e225819cd32b","1c6721b1f63f4d30ba7746ea8af02a52",22853670,1,-16,0,892,234,221,-13
"1c6721b1f63f4d30ba7746ea8af02a52","f53da5fd9bfe412da4b80d4742563b6c",22853670,1,24,0,895,221,241,20
"f53da5fd9bfe412da4b80d4742563b6c","f53da5fd9bfe412da4b80d4742563b6c",22853670,1,0,1,896,241,241,0
"f53da5fd9bfe412da4b80d4742563b6c","1c6721b1f63f4d30ba7746ea8af02a52",22853670,1,-24,0,897,241,221,-20
"1c6721b1f63f4d30ba7746ea8af02a52","2ae94c0cea4d480a9d5dca8fb1d7b542",22853670,1,27,0,898,221,242,21
"2ae94c0cea4d480a9d5dca8fb1d7b542","1ebf23f9d994469a85206e4c7b1bf5f5",22853670,5,3,0,899,242,245,3
"1ebf23f9d994469a85206e4c7b1bf5f5","d646286c8051419bbc2e31dd1db55ca8",22853670,1,-232,0,900,245,67,-178
"d646286c8051419bbc2e31dd1db55ca8","d646286c8051419bbc2e31dd1db55ca8",22853670,1,0,1,901,67,67,0
"a2becd407db34b189200a32546d9d569","d646286c8051419bbc2e31dd1db55ca8",22853670,1,-9,0,903,75,67,-8
"d646286c8051419bbc2e31dd1db55ca8","9176a3c2b4d2465fa8b0c67096c2a97e",22853670,1,14,0,904,67,80,13
"9176a3c2b4d2465fa8b0c67096c2a97e","140d5b27b8574befad82c0a013b59dfa",22853670,1,-6,0,910,80,74,-6
"d18a9ea32855445f8736581f5cb119ce","6a9f0ef185fb47f0937e29daa1c71ed5",22853670,1,10,0,912,82,90,8
"6a9f0ef185fb47f0937e29daa1c71ed5","ae5ac430ea254e708a6f5deaaf7464ae",22853670,1,-7,0,914,90,84,-6
"e20db35ced8544ddac5bc3839145e463","2ae94c0cea4d480a9d5dca8fb1d7b542",22853670,1,199,0,918,91,242,151
"2ae94c0cea4d480a9d5dca8fb1d7b542","2ae94c0cea4d480a9d5dca8fb1d7b542",22853670,2,0,1,919,242,242,0
"1ebf23f9d994469a85206e4c7b1bf5f5","2ae94c0cea4d480a9d5dca8fb1d7b542",22853670,3,-3,0,921,245,242,-3
"1ebf23f9d994469a85206e4c7b1bf5f5","1ebf23f9d994469a85206e4c7b1bf5f5",22853670,10,0,1,926,245,245,0
"1ebf23f9d994469a85206e4c7b1bf5f5","85ae675b83e8422da842cfd25596af99",22853670,1,1,0,936,245,246,1
"85ae675b83e8422da842cfd25596af99","85ae675b83e8422da842cfd25596af99",22853670,1,0,1,937,246,246,0
"85ae675b83e8422da842cfd25596af99","fa235f0f364d47e4ae1c87f47bf8e6ba",22853670,1,8,0,938,246,252,6
"fa235f0f364d47e4ae1c87f47bf8e6ba","2ae94c0cea4d480a9d5dca8fb1d7b542",22853670,1,-12,0,939,252,242,-10
"2ae94c0cea4d480a9d5dca8fb1d7b542","fa235f0f364d47e4ae1c87f47bf8e6ba",22853670,1,12,0,940,242,252,10
"fa235f0f364d47e4ae1c87f47bf8e6ba","79f7845465cc4ed19d8e4f1429541be0",22853670,1,2,0,941,252,254,2
"79f7845465cc4ed19d8e4f1429541be0","79f7845465cc4ed19d8e4f1429541be0",22853670,2,0,1,942,254,254,0
"79f7845465cc4ed19d8e4f1429541be0","6e83e23f56544a19b94067c1c558d9c0",22853670,1,-8,0,944,254,247,-7
"6e83e23f56544a19b94067c1c558d9c0","00f61990949545828dd12f1303d47504",22853670,1,11,0,945,247,256,9
"00f61990949545828dd12f1303d47504","00f61990949545828dd12f1303d47504",22853670,1,0,1,946,256,256,0
"00f61990949545828dd12f1303d47504","ead7bb4b64e247d2ae632ab8a296b091",22853670,1,2,0,947,256,258,2
"ead7bb4b64e247d2ae632ab8a296b091","ead7bb4b64e247d2ae632ab8a296b091",22853670,2,0,1,948,258,258,0
"ead7bb4b64e247d2ae632ab8a296b091","41b0048dde734bb280bac6116baa8e27",22853670,1,1,0,950,258,259,1
"41b0048dde734bb280bac6116baa8e27","41b0048dde734bb280bac6116baa8e27",22853670,2,0,1,951,259,259,0
"41b0048dde734bb280bac6116baa8e27","b41c5a094a604ee0915327da5cc0beb7",22853670,1,1,0,953,259,260,1
"b41c5a094a604ee0915327da5cc0beb7","b41c5a094a604ee0915327da5cc0beb7",22853670,2,0,1,954,260,260,0
"b41c5a094a604ee0915327da5cc0beb7","d546341988904f069cfa86b21457d9d9",22853670,1,-10,0,956,260,251,-9
"d546341988904f069cfa86b21457d9d9","28c171777c52431ab6b925073bd63d46",22853670,1,15,0,957,251,264,13
"28c171777c52431ab6b925073bd63d46","28c171777c52431ab6b925073bd63d46",22853670,3,0,1,958,264,264,0
"28c171777c52431ab6b925073bd63d46","ac160db940cb49ae8579162b1d52bb5d",22853670,1,2,0,961,264,266,2
"ac160db940cb49ae8579162b1d52bb5d","ac160db940cb49ae8579162b1d52bb5d",22853670,7,0,1,962,266,266,0
"ac160db940cb49ae8579162b1d52bb5d","d989ebcfc12a4b669f0100dc1aa14f1e",22853670,1,-12,0,969,266,255,-11
"d989ebcfc12a4b669f0100dc1aa14f1e","c6fd49b485cc4874b0bbdd9c6171e09c",22853670,1,15,0,970,255,268,13
"c6fd49b485cc4874b0bbdd9c6171e09c","c6fd49b485cc4874b0bbdd9c6171e09c",22853670,3,0,1,971,268,268,0
"c6fd49b485cc4874b0bbdd9c6171e09c","44240778a97c4af0937817499b75707b",22853670,1,1,0,974,268,269,1
"44240778a97c4af0937817499b75707b","44240778a97c4af0937817499b75707b",22853670,2,0,1,975,269,269,0
"44240778a97c4af0937817499b75707b","7aa76d3e993840d8805f097cbdbcd44b",22853670,1,-9,0,977,269,261,-8
"7aa76d3e993840d8805f097cbdbcd44b","0d987bed3ffa4ed0b9a2e62e97b7b30f",22853670,1,15,0,978,261,272,11
"0d987bed3ffa4ed0b9a2e62e97b7b30f","2ae94c0cea4d480a9d5dca8fb1d7b542",22853670,2,-38,0,979,272,242,-30
"2ae94c0cea4d480a9d5dca8fb1d7b542","0d987bed3ffa4ed0b9a2e62e97b7b30f",22853670,2,38,0,980,242,272,30
"0d987bed3ffa4ed0b9a2e62e97b7b30f","590fb7d4bca1466bacd357c1a234907c",22853670,1,-4,0,981,272,270,-2
"590fb7d4bca1466bacd357c1a234907c","2ae94c0cea4d480a9d5dca8fb1d7b542",22853670,1,-34,0,982,270,242,-28
"2ae94c0cea4d480a9d5dca8fb1d7b542","865a4d3b43374da7944dc7d397f566d9",22853670,1,35,0,985,242,271,29
"865a4d3b43374da7944dc7d397f566d9","865a4d3b43374da7944dc7d397f566d9",22853670,1,0,1,986,271,271,0
"865a4d3b43374da7944dc7d397f566d9","0d987bed3ffa4ed0b9a2e62e97b7b30f",22853670,1,3,0,987,271,272,1
"bb5a47f5ea01454a8b79455422d3b9da","82ae07bc0c9b4570a41799290d1ef399",22853670,1,-6,0,997,280,275,-5
"82ae07bc0c9b4570a41799290d1ef399","bb5a47f5ea01454a8b79455422d3b9da",22853670,1,6,0,998,275,280,5
"bb5a47f5ea01454a8b79455422d3b9da","bb5a47f5ea01454a8b79455422d3b9da",22853670,96,0,1,1000,280,280,0
"bb5a47f5ea01454a8b79455422d3b9da","0d987bed3ffa4ed0b9a2e62e97b7b30f",22853670,2,-10,0,1066,280,272,-8
"0d987bed3ffa4ed0b9a2e62e97b7b30f","94cecc3f1e7d484b8e068e79241dfd73",22853670,1,13,0,1067,272,281,9
"94cecc3f1e7d484b8e068e79241dfd73","a37477c4e4c14169ad44b06b493007f6",22853670,1,2,0,1068,281,283,2
"a37477c4e4c14169ad44b06b493007f6","94cecc3f1e7d484b8e068e79241dfd73",22853670,1,-2,0,1069,283,281,-2
"94cecc3f1e7d484b8e068e79241dfd73","4a29443515bb404cb8924e1c60a63b73",22853670,1,9,0,1070,281,285,4
"4a29443515bb404cb8924e1c60a63b73","208c9b2796c944db8dacaa96082520ea",22853670,3,3,0,1071,285,288,3
"208c9b2796c944db8dacaa96082520ea","0d987bed3ffa4ed0b9a2e62e97b7b30f",22853670,1,-25,0,1072,288,272,-16
"0d987bed3ffa4ed0b9a2e62e97b7b30f","bb5a47f5ea01454a8b79455422d3b9da",22853670,4,10,0,1073,272,280,8
"bb5a47f5ea01454a8b79455422d3b9da","bc5524e78a8544e2ae2fdc2f3462bbec",22853670,1,-1,0,1081,280,279,-1
"bc5524e78a8544e2ae2fdc2f3462bbec","0d987bed3ffa4ed0b9a2e62e97b7b30f",22853670,1,-9,0,1082,279,272,-7
"bb5a47f5ea01454a8b79455422d3b9da","b71bac264efb4abd97015447bd490db6",22853670,1,122,0,1102,280,370,90
"b71bac264efb4abd97015447bd490db6","6e83e23f56544a19b94067c1c558d9c0",22853670,1,-164,0,1103,370,247,-123
"6e83e23f56544a19b94067c1c558d9c0","2ae94c0cea4d480a9d5dca8fb1d7b542",22853670,1,-6,0,1104,247,242,-5
"2ae94c0cea4d480a9d5dca8fb1d7b542","30c9ba177afc49a695625d2bdec40207",22853670,1,9,0,1105,242,250,8
"30c9ba177afc49a695625d2bdec40207","30c9ba177afc49a695625d2bdec40207",22853670,2,0,1,1106,250,250,0
"30c9ba177afc49a695625d2bdec40207","00f61990949545828dd12f1303d47504",22853670,1,8,0,1108,250,256,6
"00f61990949545828dd12f1303d47504","6e83e23f56544a19b94067c1c558d9c0",22853670,1,-11,0,1109,256,247,-9
"6e83e23f56544a19b94067c1c558d9c0","fab84b4fab5940efb4ea868ef8d09396",22853670,1,50,0,1110,247,284,37
"fab84b4fab5940efb4ea868ef8d09396","fab84b4fab5940efb4ea868ef8d09396",22853670,2,0,1,1111,284,284,0
"fab84b4fab5940efb4ea868ef8d09396","4a29443515bb404cb8924e1c60a63b73",22853670,1,4,0,1113,284,285,1
"208c9b2796c944db8dacaa96082520ea","9afd71a5298d4333b6849dfce1b9422c",22853670,1,-373,0,1115,288,18,-270
"9afd71a5298d4333b6849dfce1b9422c","9afd71a5298d4333b6849dfce1b9422c",22853670,7,0,1,1116,18,18,0
"9afd71a5298d4333b6849dfce1b9422c","4a29443515bb404cb8924e1c60a63b73",22853670,1,370,0,1117,18,285,267
"4a29443515bb404cb8924e1c60a63b73","4a29443515bb404cb8924e1c60a63b73",22853670,1,0,1,1118,285,285,0
"208c9b2796c944db8dacaa96082520ea","208c9b2796c944db8dacaa96082520ea",22853670,1,0,1,1120,288,288,0
"208c9b2796c944db8dacaa96082520ea","4a29443515bb404cb8924e1c60a63b73",22853670,1,-3,0,1121,288,285,-3
"4a29443515bb404cb8924e1c60a63b73","7669a956527947d0add87455277e80b4",22853670,1,7,0,1122,285,291,6
"7669a956527947d0add87455277e80b4","7669a956527947d0add87455277e80b4",22853670,1,0,1,1123,291,291,0
"7669a956527947d0add87455277e80b4","6a9a3b5bde4a48daa896fe8c06eca56f",22853670,1,-2,0,1124,291,289,-2
"6a9a3b5bde4a48daa896fe8c06eca56f","869e967078f04da18dd0b0b9389a7424",22853670,1,5,0,1125,289,293,4
"869e967078f04da18dd0b0b9389a7424","869e967078f04da18dd0b0b9389a7424",22853670,1,0,1,1126,293,293,0
"869e967078f04da18dd0b0b9389a7424","51ab6291537748fab90d519aa09889d6",22853670,1,2,0,1127,293,295,2
"51ab6291537748fab90d519aa09889d6","51ab6291537748fab90d519aa09889d6",22853670,5,0,1,1128,295,295,0
"51ab6291537748fab90d519aa09889d6","34a6e49023fc4465bd5ca604330bbd1c",22853670,1,-3,0,1133,295,292,-3
"34a6e49023fc4465bd5ca604330bbd1c","ba0e59461bfb4a44b7b1c28a01f8d3b3",22853670,1,9,0,1134,292,299,7
"ba0e59461bfb4a44b7b1c28a01f8d3b3","21592f2a9e9c4b2f8c66ec5dbcbf6a2b",22853670,1,-4,0,1135,299,296,-3
"21592f2a9e9c4b2f8c66ec5dbcbf6a2b","ba0e59461bfb4a44b7b1c28a01f8d3b3",22853670,1,4,0,1136,296,299,3
"ba0e59461bfb4a44b7b1c28a01f8d3b3","0e0b36e731a645e7b1b8a88f5031ca38",22853670,1,2,0,1137,299,301,2
"0e0b36e731a645e7b1b8a88f5031ca38","0e0b36e731a645e7b1b8a88f5031ca38",22853670,5,0,1,1138,301,301,0
"0e0b36e731a645e7b1b8a88f5031ca38","a66a144637284c21afc6de17fea4bfb8",22853670,1,1,0,1143,301,302,1
"a66a144637284c21afc6de17fea4bfb8","a66a144637284c21afc6de17fea4bfb8",22853670,2,0,1,1144,302,302,0
"a66a144637284c21afc6de17fea4bfb8","7646a919d7e64fa990bca9b024ff089d",22853670,1,-4,0,1146,302,298,-4
"7646a919d7e64fa990bca9b024ff089d","e390b575229748ea8aac9364efe2bf00",22853670,1,7,0,1147,298,304,6
"e390b575229748ea8aac9364efe2bf00","e390b575229748ea8aac9364efe2bf00",22853670,1,0,1,1148,304,304,0
"e390b575229748ea8aac9364efe2bf00","4a29443515bb404cb8924e1c60a63b73",22853670,1,-24,0,1149,304,285,-19
"4a29443515bb404cb8924e1c60a63b73","3434c10e561d488a914e0f7d71907abd",22853670,1,27,0,1150,285,305,20
"3434c10e561d488a914e0f7d71907abd","53e7e900392747ccad52e711ab0f80d8",22853670,1,2,0,1151,305,307,2
"53e7e900392747ccad52e711ab0f80d8","53e7e900392747ccad52e711ab0f80d8",22853670,1,0,1,1152,307,307,0
"53e7e900392747ccad52e711ab0f80d8","3434c10e561d488a914e0f7d71907abd",22853670,1,-2,0,1153,307,305,-2
"3434c10e561d488a914e0f7d71907abd","130acc2aeb0448fdbb2de63bc5cebe5b",22853670,1,5,0,1154,305,309,4
"130acc2aeb0448fdbb2de63bc5cebe5b","130acc2aeb0448fdbb2de63bc5cebe5b",22853670,1,0,1,1155,309,309,0
"130acc2aeb0448fdbb2de63bc5cebe5b","9c062b3251034ebe90f5054e2a3b5120",22853670,1,2,0,1156,309,311,2
"9c062b3251034ebe90f5054e2a3b5120","9c062b3251034ebe90f5054e2a3b5120",22853670,2,0,1,1157,311,311,0
"9c062b3251034ebe90f5054e2a3b5120","ea859f8207e44537889daeaba13ac2e8",22853670,1,1,0,1159,311,312,1
"ea859f8207e44537889daeaba13ac2e8","ea859f8207e44537889daeaba13ac2e8",22853670,4,0,1,1160,312,312,0
"ea859f8207e44537889daeaba13ac2e8","56d94971a7a94257aa330183a8ebd0ea",22853670,1,1,0,1164,312,313,1
"56d94971a7a94257aa330183a8ebd0ea","56d94971a7a94257aa330183a8ebd0ea",22853670,1,0,1,1165,313,313,0
"56d94971a7a94257aa330183a8ebd0ea","141c0df6cd1946539aadd1c9b7068cd4",22853670,1,-5,0,1166,313,308,-5
"141c0df6cd1946539aadd1c9b7068cd4","13255e63e0aa4abf85e5211bf613d43e",22853670,1,10,0,1167,308,317,9
"13255e63e0aa4abf85e5211bf613d43e","13255e63e0aa4abf85e5211bf613d43e",22853670,1,0,1,1168,317,317,0
"13255e63e0aa4abf85e5211bf613d43e","86c27d40179e419c8e9d150fb6afa5d0",22853670,1,3,0,1169,317,319,2
"86c27d40179e419c8e9d150fb6afa5d0","0c787d16c9504873b1a4d903cec09948",22853670,1,-6,0,1170,319,314,-5
"0c787d16c9504873b1a4d903cec09948","86c27d40179e419c8e9d150fb6afa5d0",22853670,1,6,0,1171,314,319,5
"86c27d40179e419c8e9d150fb6afa5d0","47edbb64109243e6b0f8f64cdef90c6c",22853670,1,8,0,1172,319,326,7
"47edbb64109243e6b0f8f64cdef90c6c","24f1363179ad4aaa965484a78471912b",22853670,1,-3,0,1173,326,323,-3
"24f1363179ad4aaa965484a78471912b","8d7e0b55cf9849cda222a0f2440cec55",22853670,1,-6,0,1174,323,318,-5
"8d7e0b55cf9849cda222a0f2440cec55","24f1363179ad4aaa965484a78471912b",22853670,1,6,0,1175,318,323,5
"24f1363179ad4aaa965484a78471912b","3628bdce1dd2429ba924d2d4d09448d2",22853670,1,-1,0,1176,323,322,-1
"3628bdce1dd2429ba924d2d4d09448d2","86c27d40179e419c8e9d150fb6afa5d0",22853670,1,-4,0,1177,322,319,-3
"86c27d40179e419c8e9d150fb6afa5d0","43ea1b823a4b4e51b7c694c10725db82",22853670,1,10,0,1178,319,327,8
"43ea1b823a4b4e51b7c694c10725db82","8d7e0b55cf9849cda222a0f2440cec55",22853670,1,-11,0,1179,327,318,-9
"8d7e0b55cf9849cda222a0f2440cec55","0c787d16c9504873b1a4d903cec09948",22853670,1,-5,0,1180,318,314,-4
"0c787d16c9504873b1a4d903cec09948","56b3fd1a212a4764be39d979fde3326e",22853670,1,17,0,1181,314,328,14
"56b3fd1a212a4764be39d979fde3326e","56b3fd1a212a4764be39d979fde3326e",22853670,1,0,1,1182,328,328,0
"56b3fd1a212a4764be39d979fde3326e","0c4079457ede49e3aeb5e86ed84bdf35",22853670,1,3,0,1183,328,329,1
"0c4079457ede49e3aeb5e86ed84bdf35","3434c10e561d488a914e0f7d71907abd",22853670,1,-31,0,1184,329,305,-24
"3434c10e561d488a914e0f7d71907abd","38aea304b4fa46e1b29bb72f5cea4c93",22853670,1,33,0,1185,305,331,26
"38aea304b4fa46e1b29bb72f5cea4c93","9afd71a5298d4333b6849dfce1b9422c",22853670,1,-430,0,1186,331,18,-313
"9afd71a5298d4333b6849dfce1b9422c","0c4079457ede49e3aeb5e86ed84bdf35",22853670,1,428,0,1187,18,329,311
"0c4079457ede49e3aeb5e86ed84bdf35","0c4079457ede49e3aeb5e86ed84bdf35",22853670,2,0,1,1188,329,329,0
"0c4079457ede49e3aeb5e86ed84bdf35","38aea304b4fa46e1b29bb72f5cea4c93",22853670,2,2,0,1189,329,331,2
"38aea304b4fa46e1b29bb72f5cea4c93","38aea304b4fa46e1b29bb72f5cea4c93",22853670,1,0,1,1190,331,331,0
"38aea304b4fa46e1b29bb72f5cea4c93","e36d261332f14e79bb4b467aceaeb9b5",22853670,1,2,0,1191,331,333,2
"e36d261332f14e79bb4b467aceaeb9b5","e36d261332f14e79bb4b467aceaeb9b5",22853670,1,0,1,1192,333,333,0
"e36d261332f14e79bb4b467aceaeb9b5","c7e89b9d04744d2eab742fc24e3ef1ae",22853670,1,1,0,1193,333,334,1
"c7e89b9d04744d2eab742fc24e3ef1ae","c7e89b9d04744d2eab742fc24e3ef1ae",22853670,5,0,1,1194,334,334,0
"c7e89b9d04744d2eab742fc24e3ef1ae","fe49f8054b374a0ea4bb266ed135ff62",22853670,1,1,0,1199,334,335,1
"fe49f8054b374a0ea4bb266ed135ff62","fe49f8054b374a0ea4bb266ed135ff62",22853670,2,0,1,1200,335,335,0
"fe49f8054b374a0ea4bb266ed135ff62","d0a8f74af98642fe8360d22c42e45117",22853670,1,1,0,1202,335,336,1
"d0a8f74af98642fe8360d22c42e45117","d0a8f74af98642fe8360d22c42e45117",22853670,2,0,1,1203,336,336,0
"d0a8f74af98642fe8360d22c42e45117","0c4079457ede49e3aeb5e86ed84bdf35",22853670,1,-7,0,1205,336,329,-7
"38aea304b4fa46e1b29bb72f5cea4c93","0c4079457ede49e3aeb5e86ed84bdf35",22853670,1,-2,0,1208,331,329,-2
"0c4079457ede49e3aeb5e86ed84bdf35","a7c6339ca1da4368a18d471f0519f877",22853670,1,11,0,1209,329,339,10
"a7c6339ca1da4368a18d471f0519f877","a7c6339ca1da4368a18d471f0519f877",22853670,1,0,1,1210,339,339,0
"a7c6339ca1da4368a18d471f0519f877","bbc5139ca9024389a94db3a6f47dcff6",22853670,1,3,0,1211,339,341,2
"bbc5139ca9024389a94db3a6f47dcff6","b8b9418ab322418d9db9b40d96af873a",22853670,1,-5,0,1212,341,337,-4
"b8b9418ab322418d9db9b40d96af873a","bbc5139ca9024389a94db3a6f47dcff6",22853670,1,5,0,1213,337,341,4
"bbc5139ca9024389a94db3a6f47dcff6","4ee6ca9019ab4a1ab323f98094a9bd77",22853670,1,2,0,1214,341,343,2
"4ee6ca9019ab4a1ab323f98094a9bd77","4ee6ca9019ab4a1ab323f98094a9bd77",22853670,2,0,1,1215,343,343,0
"4ee6ca9019ab4a1ab323f98094a9bd77","b37947176785476f8b29d49a851366dc",22853670,1,1,0,1217,343,344,1
"b37947176785476f8b29d49a851366dc","b37947176785476f8b29d49a851366dc",22853670,2,0,1,1218,344,344,0
"b37947176785476f8b29d49a851366dc","fcea5b10d5a14a3b9324ffece8f6e1e5",22853670,1,1,0,1220,344,345,1
"fcea5b10d5a14a3b9324ffece8f6e1e5","fcea5b10d5a14a3b9324ffece8f6e1e5",22853670,2,0,1,1221,345,345,0
"fcea5b10d5a14a3b9324ffece8f6e1e5","c2490bc612d146edbe786556fab3651b",22853670,1,-5,0,1223,345,340,-5
"c2490bc612d146edbe786556fab3651b","6ac8bb048b854999a47edb35fe627f11",22853670,1,8,0,1224,340,347,7
"6ac8bb048b854999a47edb35fe627f11","6ac8bb048b854999a47edb35fe627f11",22853670,1,0,1,1225,347,347,0
"6ac8bb048b854999a47edb35fe627f11","30ead9794d4847abaf222ca966cc8630",22853670,1,3,0,1226,347,348,1
"30ead9794d4847abaf222ca966cc8630","0c4079457ede49e3aeb5e86ed84bdf35",22853670,1,-24,0,1227,348,329,-19
"0c4079457ede49e3aeb5e86ed84bdf35","897b7f51242c44aab2205c72fdcbf4cd",22853670,1,28,0,1228,329,352,23
"897b7f51242c44aab2205c72fdcbf4cd","c20993c944444fe085345591a8bd837e",22853670,2,-1,0,1229,352,351,-1
"c20993c944444fe085345591a8bd837e","09b9678ddc3d452ea4a3d46e15826065",22853670,1,2,0,1230,351,353,2
"09b9678ddc3d452ea4a3d46e15826065","eff0de7f2dbb42dfa1a2e686efab5b6d",22853670,2,1,0,1231,353,354,1
"eff0de7f2dbb42dfa1a2e686efab5b6d","c20993c944444fe085345591a8bd837e",22853670,2,-3,0,1232,354,351,-3
"c20993c944444fe085345591a8bd837e","c20993c944444fe085345591a8bd837e",22853670,4,0,1,1233,351,351,0
"c20993c944444fe085345591a8bd837e","897b7f51242c44aab2205c72fdcbf4cd",22853670,2,1,0,1236,351,352,1
"897b7f51242c44aab2205c72fdcbf4cd","897b7f51242c44aab2205c72fdcbf4cd",22853670,4,0,1,1237,352,352,0
"897b7f51242c44aab2205c72fdcbf4cd","09b9678ddc3d452ea4a3d46e15826065",22853670,1,1,0,1240,352,353,1
"09b9678ddc3d452ea4a3d46e15826065","09b9678ddc3d452ea4a3d46e15826065",22853670,5,0,1,1241,353,353,0
"eff0de7f2dbb42dfa1a2e686efab5b6d","eff0de7f2dbb42dfa1a2e686efab5b6d",22853670,4,0,1,1245,354,354,0
"eff0de7f2dbb42dfa1a2e686efab5b6d","30ead9794d4847abaf222ca966cc8630",22853670,1,-6,0,1248,354,348,-6
"30ead9794d4847abaf222ca966cc8630","2fe14166dc9642c3bc666b86a57f943d",22853670,1,10,0,1249,348,357,9
"2fe14166dc9642c3bc666b86a57f943d","2fe14166dc9642c3bc666b86a57f943d",22853670,1,0,1,1250,357,357,0
"2fe14166dc9642c3bc666b86a57f943d","44421dd1e13a47a388c4a19834b744c7",22853670,1,2,0,1251,357,359,2
"44421dd1e13a47a388c4a19834b744c7","44421dd1e13a47a388c4a19834b744c7",22853670,2,0,1,1252,359,359,0
"44421dd1e13a47a388c4a19834b744c7","cb5fc7ef85d547c4be1a7439d0bf6052",22853670,1,1,0,1254,359,360,1
"cb5fc7ef85d547c4be1a7439d0bf6052","cb5fc7ef85d547c4be1a7439d0bf6052",22853670,2,0,1,1255,360,360,0
"cb5fc7ef85d547c4be1a7439d0bf6052","0a8f150a4cf747acbde62f4721823da3",22853670,1,1,0,1257,360,361,1
"0a8f150a4cf747acbde62f4721823da3","0a8f150a4cf747acbde62f4721823da3",22853670,2,0,1,1258,361,361,0
"0a8f150a4cf747acbde62f4721823da3","ab8fdad974ae471f9f24c3f9dd04462e",22853670,1,1,0,1260,361,362,1
"ab8fdad974ae471f9f24c3f9dd04462e","ab8fdad974ae471f9f24c3f9dd04462e",22853670,2,0,1,1261,362,362,0
"ab8fdad974ae471f9f24c3f9dd04462e","52580888dadb4fe3baa795683ea227bd",22853670,1,3,0,1263,362,364,2
"52580888dadb4fe3baa795683ea227bd","1ba8fef685d74a8194b9db252eb704fb",22853670,1,-10,0,1264,364,355,-9
"1ba8fef685d74a8194b9db252eb704fb","52580888dadb4fe3baa795683ea227bd",22853670,1,10,0,1265,355,364,9
"52580888dadb4fe3baa795683ea227bd","f00179e251a045b39c3f7a54f9aa4acc",22853670,1,-1,0,1266,364,363,-1
"f00179e251a045b39c3f7a54f9aa4acc","492a3bc6a1254f23a7998587961b22a4",22853670,1,4,0,1267,363,366,3
"492a3bc6a1254f23a7998587961b22a4","492a3bc6a1254f23a7998587961b22a4",22853670,1,0,1,1268,366,366,0
"492a3bc6a1254f23a7998587961b22a4","072a190fd302456290895f9f04d6940a",22853670,1,-1,0,1269,366,365,-1
"072a190fd302456290895f9f04d6940a","30ead9794d4847abaf222ca966cc8630",22853670,1,-20,0,1270,365,348,-17
"30ead9794d4847abaf222ca966cc8630","897b7f51242c44aab2205c72fdcbf4cd",22853670,1,4,0,1271,348,352,4
"c20993c944444fe085345591a8bd837e","eff0de7f2dbb42dfa1a2e686efab5b6d",22853670,1,3,0,1273,351,354,3
"897b7f51242c44aab2205c72fdcbf4cd","eff0de7f2dbb42dfa1a2e686efab5b6d",22853670,1,2,0,1279,352,354,2
"eff0de7f2dbb42dfa1a2e686efab5b6d","09b9678ddc3d452ea4a3d46e15826065",22853670,1,-1,0,1280,354,353,-1
"09b9678ddc3d452ea4a3d46e15826065","30ead9794d4847abaf222ca966cc8630",22853670,1,-5,0,1283,353,348,-5
"30ead9794d4847abaf222ca966cc8630","cfa457d1743848e4bb5e4beced6448ed",22853670,1,25,0,1284,348,369,21
"cfa457d1743848e4bb5e4beced6448ed","cfa457d1743848e4bb5e4beced6448ed",22853670,1,0,1,1285,369,369,0
"cfa457d1743848e4bb5e4beced6448ed","b71bac264efb4abd97015447bd490db6",22853670,1,3,0,1286,369,370,1
"b71bac264efb4abd97015447bd490db6","30ead9794d4847abaf222ca966cc8630",22853670,1,-28,0,1287,370,348,-22
"30ead9794d4847abaf222ca966cc8630","8d448d625b024c82a5eb240bbd7431d6",22853670,1,33,0,1288,348,374,26
"8d448d625b024c82a5eb240bbd7431d6","8d448d625b024c82a5eb240bbd7431d6",22853670,80,0,1,1289,374,374,0
"8d448d625b024c82a5eb240bbd7431d6","b71bac264efb4abd97015447bd490db6",22853670,5,-5,0,1293,374,370,-4
"b71bac264efb4abd97015447bd490db6","8d448d625b024c82a5eb240bbd7431d6",22853670,5,5,0,1294,370,374,4
"b71bac264efb4abd97015447bd490db6","0c7262dff33c4087bc660ccf40f92f9c",22853670,1,-267,0,1298,370,169,-201
"0c7262dff33c4087bc660ccf40f92f9c","b2275c3fad834f8d90737a2d9a6927d6",22853670,3,3,0,1299,169,172,3
"b2275c3fad834f8d90737a2d9a6927d6","9afd71a5298d4333b6849dfce1b9422c",22853670,1,-216,0,1300,172,18,-154
"9afd71a5298d4333b6849dfce1b9422c","b71bac264efb4abd97015447bd490db6",22853670,1,480,0,1302,18,370,352
"b71bac264efb4abd97015447bd490db6","b71bac264efb4abd97015447bd490db6",22853670,1,0,1,1303,370,370,0
"b71bac264efb4abd97015447bd490db6","d6d02b6ef04e4f17805504500b8ce441",22853670,3,8,0,1359,370,375,5
"d6d02b6ef04e4f17805504500b8ce441","d6d02b6ef04e4f17805504500b8ce441",22853670,11,0,1,1360,375,375,0
"d6d02b6ef04e4f17805504500b8ce441","66baf19b6b904b70922329068c63746d",22853670,2,4,0,1362,375,376,1
"66baf19b6b904b70922329068c63746d","7f544639412e40a9ba27f43b415362ab",22853670,2,2,0,1363,376,378,2
"7f544639412e40a9ba27f43b415362ab","d6d02b6ef04e4f17805504500b8ce441",22853670,1,-6,0,1364,378,375,-3
"d6d02b6ef04e4f17805504500b8ce441","4a29443515bb404cb8924e1c60a63b73",22853670,1,-118,0,1367,375,285,-90
"4a29443515bb404cb8924e1c60a63b73","b71bac264efb4abd97015447bd490db6",22853670,1,110,0,1368,285,370,85
"b71bac264efb4abd97015447bd490db6","1b4550d0dab04078b3bf08a655345bdc",22853670,1,4,0,1369,370,373,3
"1b4550d0dab04078b3bf08a655345bdc","8d448d625b024c82a5eb240bbd7431d6",22853670,1,1,0,1370,373,374,1
"d6d02b6ef04e4f17805504500b8ce441","b71bac264efb4abd97015447bd490db6",22853670,3,-8,0,1382,375,370,-5
"8d448d625b024c82a5eb240bbd7431d6","d6d02b6ef04e4f17805504500b8ce441",22853670,1,3,0,1393,374,375,1
"8d448d625b024c82a5eb240bbd7431d6","9afd71a5298d4333b6849dfce1b9422c",22853670,1,-485,0,1405,374,18,-356
"9afd71a5298d4333b6849dfce1b9422c","d6d02b6ef04e4f17805504500b8ce441",22853670,2,488,0,1406,18,375,357
"66baf19b6b904b70922329068c63746d","66baf19b6b904b70922329068c63746d",22853670,1,0,1,1411,376,376,0
"7f544639412e40a9ba27f43b415362ab","7f544639412e40a9ba27f43b415362ab",22853670,2,0,1,1413,378,378,0
"7f544639412e40a9ba27f43b415362ab","d5ae8642e15b46b8bd298b02274d4e9c",22853670,1,2,0,1415,378,380,2
"d5ae8642e15b46b8bd298b02274d4e9c","d5ae8642e15b46b8bd298b02274d4e9c",22853670,1,0,1,1416,380,380,0
"d5ae8642e15b46b8bd298b02274d4e9c","a0d10309a2dd456289147f84be9d37f9",22853670,1,1,0,1417,380,381,1
"a0d10309a2dd456289147f84be9d37f9","a0d10309a2dd456289147f84be9d37f9",22853670,2,0,1,1418,381,381,0
"a0d10309a2dd456289147f84be9d37f9","0fcbc3ca07b144138b8d85da581f09a8",22853670,1,1,0,1420,381,382,1
"0fcbc3ca07b144138b8d85da581f09a8","0fcbc3ca07b144138b8d85da581f09a8",22853670,2,0,1,1421,382,382,0
"0fcbc3ca07b144138b8d85da581f09a8","66baf19b6b904b70922329068c63746d",22853670,1,-6,0,1423,382,376,-6
"66baf19b6b904b70922329068c63746d","c2fca3669923477ab966ded303dea31c",22853670,1,8,0,1424,376,383,7
"c2fca3669923477ab966ded303dea31c","4890121ce5d74576b4632b77cfc23398",22853670,1,6,0,1425,383,388,5
"4890121ce5d74576b4632b77cfc23398","4890121ce5d74576b4632b77cfc23398",22853670,1,0,1,1426,388,388,0
"4890121ce5d74576b4632b77cfc23398","18d3b836dd804224883cc9180b60a8e1",22853670,1,-1,0,1427,388,387,-1
"18d3b836dd804224883cc9180b60a8e1","96bb2b3e85a34d8b9544514e89f6fe97",22853670,1,4,0,1428,387,390,3
"96bb2b3e85a34d8b9544514e89f6fe97","96bb2b3e85a34d8b9544514e89f6fe97",22853670,1,0,1,1429,390,390,0
"96bb2b3e85a34d8b9544514e89f6fe97","ac4e9b54acfe4670b4634859c7263cb5",22853670,1,2,0,1430,390,392,2
"ac4e9b54acfe4670b4634859c7263cb5","ac4e9b54acfe4670b4634859c7263cb5",22853670,1,0,1,1431,392,392,0
"ac4e9b54acfe4670b4634859c7263cb5","6f8881a745ac4c358a68b92c3b4abe81",22853670,1,3,0,1432,392,394,2
"6f8881a745ac4c358a68b92c3b4abe81","17f95d18bab743888e1736033dc3384d",22853670,1,-6,0,1433,394,389,-5
"17f95d18bab743888e1736033dc3384d","6f8881a745ac4c358a68b92c3b4abe81",22853670,1,6,0,1434,389,394,5
"6f8881a745ac4c358a68b92c3b4abe81","f7002c8484354eceac57bc7bd62c76c1",22853670,1,-1,0,1435,394,393,-1
"f7002c8484354eceac57bc7bd62c76c1","44a277ea44dc4ae689fab4b82f0b4098",22853670,1,5,0,1436,393,397,4
"44a277ea44dc4ae689fab4b82f0b4098","44a277ea44dc4ae689fab4b82f0b4098",22853670,1,0,1,1437,397,397,0
"44a277ea44dc4ae689fab4b82f0b4098","0c12af0a4e7f4002852cf84b2537c161",22853670,1,-2,0,1438,397,395,-2
"0c12af0a4e7f4002852cf84b2537c161","859e0b8d71694b12befb69ee698138f9",22853670,1,5,0,1439,395,399,4
"859e0b8d71694b12befb69ee698138f9","859e0b8d71694b12befb69ee698138f9",22853670,1,0,1,1440,399,399,0
"859e0b8d71694b12befb69ee698138f9","2b09a08242b54983aec7063990fb3f66",22853670,1,3,0,1441,399,400,1
"2b09a08242b54983aec7063990fb3f66","66baf19b6b904b70922329068c63746d",22853670,1,-32,0,1442,400,376,-24
"66baf19b6b904b70922329068c63746d","2b09a08242b54983aec7063990fb3f66",22853670,1,32,0,1443,376,400,24
"2b09a08242b54983aec7063990fb3f66","2b09a08242b54983aec7063990fb3f66",22853670,1,0,1,1444,400,400,0
"2b09a08242b54983aec7063990fb3f66","1f471b7a883a4df48211e8c6a81b59a7",22853670,1,1,0,1445,400,401,1
"1f471b7a883a4df48211e8c6a81b59a7","1f471b7a883a4df48211e8c6a81b59a7",22853670,1,0,1,1446,401,401,0
"1f471b7a883a4df48211e8c6a81b59a7","2b09a08242b54983aec7063990fb3f66",22853670,1,-1,0,1447,401,400,-1
"2b09a08242b54983aec7063990fb3f66","9de0d567bfa84fe5b77cb76f4a76a5d1",22853670,1,5,0,1448,400,404,4
"9de0d567bfa84fe5b77cb76f4a76a5d1","9de0d567bfa84fe5b77cb76f4a76a5d1",22853670,1,0,1,1449,404,404,0
"9de0d567bfa84fe5b77cb76f4a76a5d1","1157bd665ec4472fb58b751dc5099355",22853670,1,-1,0,1450,404,403,-1
"1157bd665ec4472fb58b751dc5099355","58fc9094275e4c49be3f4ba6d4acc0a4",22853670,1,5,0,1451,403,406,3
"58fc9094275e4c49be3f4ba6d4acc0a4","3c8a22d2f9c146ea956609e3ed4f2559",22853670,1,-2,0,1452,406,405,-1
"3c8a22d2f9c146ea956609e3ed4f2559","58fc9094275e4c49be3f4ba6d4acc0a4",22853670,1,2,0,1453,405,406,1
"58fc9094275e4c49be3f4ba6d4acc0a4","02b3a1bead9244c1ba2f857c7da8f82a",22853670,3,3,0,1454,406,408,2
"02b3a1bead9244c1ba2f857c7da8f82a","58fc9094275e4c49be3f4ba6d4acc0a4",22853670,3,-3,0,1455,408,406,-2
"58fc9094275e4c49be3f4ba6d4acc0a4","c1c1be90b2b14c1ab4a5e1ee3c241902",22853670,1,1,0,1458,406,407,1
"c1c1be90b2b14c1ab4a5e1ee3c241902","c1c1be90b2b14c1ab4a5e1ee3c241902",22853670,5,0,1,1459,407,407,0
"c1c1be90b2b14c1ab4a5e1ee3c241902","02b3a1bead9244c1ba2f857c7da8f82a",22853670,1,2,0,1464,407,408,1
"02b3a1bead9244c1ba2f857c7da8f82a","6206fc6479014bb193084c32409dc1b9",22853670,1,1,0,1467,408,409,1
"6206fc6479014bb193084c32409dc1b9","6206fc6479014bb193084c32409dc1b9",22853670,1,0,1,1468,409,409,0
"6206fc6479014bb193084c32409dc1b9","02b3a1bead9244c1ba2f857c7da8f82a",22853670,1,-1,0,1469,409,408,-1
"02b3a1bead9244c1ba2f857c7da8f82a","6a5f020451db426dacba9e2ea3fcc62a",22853670,1,3,0,1470,408,410,2
"6a5f020451db426dacba9e2ea3fcc62a","6a5f020451db426dacba9e2ea3fcc62a",22853670,2,0,1,1471,410,410,0
"6a5f020451db426dacba9e2ea3fcc62a","33a9d248b2e44588a5b07fc1342b9bc2",22853670,1,2,0,1473,410,411,1
"33a9d248b2e44588a5b07fc1342b9bc2","33a9d248b2e44588a5b07fc1342b9bc2",22853670,1,0,1,1474,411,411,0
"33a9d248b2e44588a5b07fc1342b9bc2","c6f26bd420634f1cb7989e76fe6b16c0",22853670,1,1,0,1475,411,412,1
"c6f26bd420634f1cb7989e76fe6b16c0","c6f26bd420634f1cb7989e76fe6b16c0",22853670,5,0,1,1476,412,412,0
"c6f26bd420634f1cb7989e76fe6b16c0","2a65ee6e2ac64f6a8a55fbe5373ec763",22853670,1,1,0,1481,412,413,1
"2a65ee6e2ac64f6a8a55fbe5373ec763","2a65ee6e2ac64f6a8a55fbe5373ec763",22853670,2,0,1,1482,413,413,0
"2a65ee6e2ac64f6a8a55fbe5373ec763","33a9d248b2e44588a5b07fc1342b9bc2",22853670,1,-2,0,1484,413,411,-2
"33a9d248b2e44588a5b07fc1342b9bc2","687055dad9fc40c3982478fe33ec01bf",22853670,1,4,0,1485,411,414,3
"687055dad9fc40c3982478fe33ec01bf","2add1669f08d4101913db15f8c23b3b7",22853670,2,3,0,1486,414,416,2
"2add1669f08d4101913db15f8c23b3b7","9afd71a5298d4333b6849dfce1b9422c",22853670,1,-548,0,1487,416,18,-398
"d6d02b6ef04e4f17805504500b8ce441","687055dad9fc40c3982478fe33ec01bf",22853670,1,57,0,1494,375,414,39
"687055dad9fc40c3982478fe33ec01bf","2b09a08242b54983aec7063990fb3f66",22853670,1,-21,0,1495,414,400,-14
"2b09a08242b54983aec7063990fb3f66","1fd0f6dadbc14ebc965faf6122190b96",22853670,1,22,0,1496,400,415,15
"1fd0f6dadbc14ebc965faf6122190b96","1fd0f6dadbc14ebc965faf6122190b96",22853670,1,0,1,1497,415,415,0
"1fd0f6dadbc14ebc965faf6122190b96","687055dad9fc40c3982478fe33ec01bf",22853670,1,-1,0,1498,415,414,-1
"2add1669f08d4101913db15f8c23b3b7","2add1669f08d4101913db15f8c23b3b7",22853670,1,0,1,1500,416,416,0
"2add1669f08d4101913db15f8c23b3b7","a2b4bd40cee2481ebd3fc179d6a5cd62",22853670,1,3,0,1501,416,417,1
"a2b4bd40cee2481ebd3fc179d6a5cd62","2b09a08242b54983aec7063990fb3f66",22853670,1,-27,0,1502,417,400,-17
"2b09a08242b54983aec7063990fb3f66","e34e59dce2204f228f3a84b6725df60f",22853670,1,29,0,1503,400,419,19
"e34e59dce2204f228f3a84b6725df60f","e34e59dce2204f228f3a84b6725df60f",22853670,1,0,1,1504,419,419,0
"e34e59dce2204f228f3a84b6725df60f","a2b4bd40cee2481ebd3fc179d6a5cd62",22853670,1,-2,0,1505,419,417,-2
"a2b4bd40cee2481ebd3fc179d6a5cd62","bec48fc2e1294c7eb3d0aca780d731b8",22853670,1,4,0,1506,417,420,3
"bec48fc2e1294c7eb3d0aca780d731b8","bec48fc2e1294c7eb3d0aca780d731b8",22853670,2,0,1,1507,420,420,0
"bec48fc2e1294c7eb3d0aca780d731b8","dbde19fcce2a4c1abdc7f685c293a23f",22853670,1,3,0,1509,420,422,2
"dbde19fcce2a4c1abdc7f685c293a23f","a24600b0e49245f6bdba8c893cfeddb0",22853670,1,4,0,1510,422,425,3
"a24600b0e49245f6bdba8c893cfeddb0","a24600b0e49245f6bdba8c893cfeddb0",22853670,2,0,1,1511,425,425,0
"a24600b0e49245f6bdba8c893cfeddb0","a2b4bd40cee2481ebd3fc179d6a5cd62",22853670,1,-11,0,1513,425,417,-8
"a2b4bd40cee2481ebd3fc179d6a5cd62","24cf8786024543f19b89bc20034e60d7",22853670,1,18,0,1514,417,428,11
"24cf8786024543f19b89bc20034e60d7","f2a73be2f46840b182d7bd095378004e",22853670,1,1,0,1515,428,429,1
"f2a73be2f46840b182d7bd095378004e","f2a73be2f46840b182d7bd095378004e",22853670,1,0,1,1516,429,429,0
"f2a73be2f46840b182d7bd095378004e","604551fd4266430cb860fef58fa7dd61",22853670,1,1,0,1517,429,430,1
"604551fd4266430cb860fef58fa7dd61","604551fd4266430cb860fef58fa7dd61",22853670,1,0,1,1518,430,430,0
"604551fd4266430cb860fef58fa7dd61","24cf8786024543f19b89bc20034e60d7",22853670,1,-2,0,1519,430,428,-2
"24cf8786024543f19b89bc20034e60d7","dce46f8904594a62a6377a3587aaa663",22853670,1,4,0,1520,428,431,3
"dce46f8904594a62a6377a3587aaa663","dce46f8904594a62a6377a3587aaa663",22853670,1,0,1,1521,431,431,0
"dce46f8904594a62a6377a3587aaa663","9b9d0a249052413c869753b99682b0ac",22853670,1,1,0,1522,431,432,1
"9b9d0a249052413c869753b99682b0ac","9b9d0a249052413c869753b99682b0ac",22853670,6,0,1,1523,432,432,0
"9b9d0a249052413c869753b99682b0ac","061c175cc90f45fbad883025394e78dd",22853670,1,1,0,1529,432,433,1
"061c175cc90f45fbad883025394e78dd","061c175cc90f45fbad883025394e78dd",22853670,5,0,1,1530,433,433,0
"061c175cc90f45fbad883025394e78dd","dce46f8904594a62a6377a3587aaa663",22853670,1,-2,0,1535,433,431,-2
"dce46f8904594a62a6377a3587aaa663","66ada10dde9f43018588f1ced9d477fc",22853670,1,4,0,1536,431,434,3
"66ada10dde9f43018588f1ced9d477fc","24cf8786024543f19b89bc20034e60d7",22853670,2,-8,0,1537,434,428,-6
"24cf8786024543f19b89bc20034e60d7","070600601c4c439288445d2f0724807d",22853670,2,14,0,1538,428,437,9
"070600601c4c439288445d2f0724807d","1823b6de7d334a7aaabc4570719af4d9",22853670,2,2,0,1539,437,439,2
"1823b6de7d334a7aaabc4570719af4d9","9afd71a5298d4333b6849dfce1b9422c",22853670,1,-585,0,1540,439,18,-421
"9afd71a5298d4333b6849dfce1b9422c","66ada10dde9f43018588f1ced9d477fc",22853670,1,577,0,1541,18,434,416
"24cf8786024543f19b89bc20034e60d7","74a7f8712e5449c2bc0b43c6f90dafed",22853670,1,9,0,1543,428,435,7
"74a7f8712e5449c2bc0b43c6f90dafed","74a7f8712e5449c2bc0b43c6f90dafed",22853670,1,0,1,1544,435,435,0
"74a7f8712e5449c2bc0b43c6f90dafed","66ada10dde9f43018588f1ced9d477fc",22853670,1,-1,0,1545,435,434,-1
"66ada10dde9f43018588f1ced9d477fc","bf12c96466d840a69bed7020b3f18bb8",22853670,1,3,0,1546,434,436,2
"bf12c96466d840a69bed7020b3f18bb8","bf12c96466d840a69bed7020b3f18bb8",22853670,1,0,1,1547,436,436,0
"bf12c96466d840a69bed7020b3f18bb8","24cf8786024543f19b89bc20034e60d7",22853670,1,-11,0,1548,436,428,-8
"1823b6de7d334a7aaabc4570719af4d9","1823b6de7d334a7aaabc4570719af4d9",22853670,10,0,1,1551,439,439,0
"1823b6de7d334a7aaabc4570719af4d9","0380cd76a7d44bc3a4da1f15e4d68f89",22853670,1,2,0,1561,439,440,1
"0380cd76a7d44bc3a4da1f15e4d68f89","070600601c4c439288445d2f0724807d",22853670,1,-4,0,1562,440,437,-3
"070600601c4c439288445d2f0724807d","0380cd76a7d44bc3a4da1f15e4d68f89",22853670,1,4,0,1563,437,440,3
"0380cd76a7d44bc3a4da1f15e4d68f89","23b7673c8b5443108c2ef09382834a86",22853670,2,2,0,1564,440,441,1
"23b7673c8b5443108c2ef09382834a86","0380cd76a7d44bc3a4da1f15e4d68f89",22853670,1,-2,0,1565,441,440,-1
"23b7673c8b5443108c2ef09382834a86","23b7673c8b5443108c2ef09382834a86",22853670,1,0,1,1567,441,441,0
"23b7673c8b5443108c2ef09382834a86","901e92500aea43c79f19f1b279050668",22853670,1,2,0,1568,441,442,1
"901e92500aea43c79f19f1b279050668","901e92500aea43c79f19f1b279050668",22853670,1,0,1,1569,442,442,0
"901e92500aea43c79f19f1b279050668","001339db8ced4cf78829ebe8b145449d",22853670,1,1,0,1570,442,443,1
"001339db8ced4cf78829ebe8b145449d","001339db8ced4cf78829ebe8b145449d",22853670,2,0,1,1571,443,443,0
"001339db8ced4cf78829ebe8b145449d","452745e0366e42ae81561bfddebcc6c3",22853670,1,1,0,1573,443,444,1
"452745e0366e42ae81561bfddebcc6c3","452745e0366e42ae81561bfddebcc6c3",22853670,2,0,1,1574,444,444,0
"452745e0366e42ae81561bfddebcc6c3","901e92500aea43c79f19f1b279050668",22853670,1,-2,0,1576,444,442,-2
"901e92500aea43c79f19f1b279050668","4660ff2089114e8db82ceb26a4f329e3",22853670,1,4,0,1577,442,445,3
"4660ff2089114e8db82ceb26a4f329e3","4660ff2089114e8db82ceb26a4f329e3",22853670,2,0,1,1578,445,445,0
"4660ff2089114e8db82ceb26a4f329e3","7bd5586eb9d8484eb74a433ee7bfe499",22853670,1,2,0,1580,445,446,1
"7bd5586eb9d8484eb74a433ee7bfe499","7bd5586eb9d8484eb74a433ee7bfe499",22853670,9,0,1,1581,446,446,0
"7bd5586eb9d8484eb74a433ee7bfe499","8a7f26e690f34dda97be16904518ca99",22853670,1,2,0,1590,446,447,1
"8a7f26e690f34dda97be16904518ca99","8a7f26e690f34dda97be16904518ca99",22853670,1,0,1,1591,447,447,0
"8a7f26e690f34dda97be16904518ca99","b2f0d654738f48158edff28e8d3a546e",22853670,1,5,0,1592,447,449,2
"b2f0d654738f48158edff28e8d3a546e","070600601c4c439288445d2f0724807d",22853670,1,-21,0,1593,449,437,-12
"070600601c4c439288445d2f0724807d","f60ee41ec635499abd48168342d32c2f",22853670,1,26,0,1594,437,453,16
"f60ee41ec635499abd48168342d32c2f","f60ee41ec635499abd48168342d32c2f",22853670,102,0,1,1595,453,453,0
"f60ee41ec635499abd48168342d32c2f","b2f0d654738f48158edff28e8d3a546e",22853670,5,-5,0,1600,453,449,-4
"b2f0d654738f48158edff28e8d3a546e","f60ee41ec635499abd48168342d32c2f",22853670,8,5,0,1601,449,453,4
"f60ee41ec635499abd48168342d32c2f","4a29443515bb404cb8924e1c60a63b73",22853670,1,-239,0,1603,453,285,-168
"4a29443515bb404cb8924e1c60a63b73","9428d8bd9c5a47b2a235b254e5e27ded",22853670,1,238,0,1604,285,452,167
"9428d8bd9c5a47b2a235b254e5e27ded","b2f0d654738f48158edff28e8d3a546e",22853670,5,-4,0,1605,452,449,-3
"b2f0d654738f48158edff28e8d3a546e","f67fbf45a5f146ed866965bc57c7c001",22853670,1,8,0,1660,449,454,5
"f67fbf45a5f146ed866965bc57c7c001","f67fbf45a5f146ed866965bc57c7c001",22853670,2,0,1,1661,454,454,0
"f67fbf45a5f146ed866965bc57c7c001","d937afe49bd24a07a550dda1c1155122",22853670,1,1,0,1663,454,455,1
"d937afe49bd24a07a550dda1c1155122","d937afe49bd24a07a550dda1c1155122",22853670,1,0,1,1664,455,455,0
"d937afe49bd24a07a550dda1c1155122","3628b3f7823443d0912a339096b69943",22853670,1,1,0,1665,455,456,1
"3628b3f7823443d0912a339096b69943","3628b3f7823443d0912a339096b69943",22853670,1,0,1,1666,456,456,0
"3628b3f7823443d0912a339096b69943","9e049ee647cf43ecbcb5ed792a8e7588",22853670,1,1,0,1667,456,457,1
"9e049ee647cf43ecbcb5ed792a8e7588","9e049ee647cf43ecbcb5ed792a8e7588",22853670,1,0,1,1668,457,457,0
"9e049ee647cf43ecbcb5ed792a8e7588","5256a214faaf410b93f76cea06428334",22853670,1,1,0,1669,457,458,1
"5256a214faaf410b93f76cea06428334","5256a214faaf410b93f76cea06428334",22853670,1,0,1,1670,458,458,0
"5256a214faaf410b93f76cea06428334","25c32b120fce40fa9b6c85133aeb4716",22853670,1,1,0,1671,458,459,1
"25c32b120fce40fa9b6c85133aeb4716","25c32b120fce40fa9b6c85133aeb4716",22853670,1,0,1,1672,459,459,0
"25c32b120fce40fa9b6c85133aeb4716","11bc14f2204949008b7d511b933363c1",22853670,1,1,0,1673,459,460,1
"11bc14f2204949008b7d511b933363c1","11bc14f2204949008b7d511b933363c1",22853670,1,0,1,1674,460,460,0
"11bc14f2204949008b7d511b933363c1","42de338840a34d15adb66e7b14fb9d2c",22853670,1,1,0,1675,460,461,1
"42de338840a34d15adb66e7b14fb9d2c","42de338840a34d15adb66e7b14fb9d2c",22853670,1,0,1,1676,461,461,0
"42de338840a34d15adb66e7b14fb9d2c","9da37c6210b1416b8079c274f70bf600",22853670,1,1,0,1677,461,462,1
"9da37c6210b1416b8079c274f70bf600","9da37c6210b1416b8079c274f70bf600",22853670,1,0,1,1678,462,462,0
"9da37c6210b1416b8079c274f70bf600","519119f1deac45ff9ab4f13529be5c6e",22853670,1,1,0,1679,462,463,1
"519119f1deac45ff9ab4f13529be5c6e","519119f1deac45ff9ab4f13529be5c6e",22853670,1,0,1,1680,463,463,0
"519119f1deac45ff9ab4f13529be5c6e","f67fbf45a5f146ed866965bc57c7c001",22853670,1,-9,0,1681,463,454,-9
"f67fbf45a5f146ed866965bc57c7c001","c5df9f40ec14463b9dcfdc73df3e9285",22853670,1,12,0,1682,454,464,10
"c5df9f40ec14463b9dcfdc73df3e9285","c5df9f40ec14463b9dcfdc73df3e9285",22853670,1,0,1,1683,464,464,0
"c5df9f40ec14463b9dcfdc73df3e9285","83d42d95cd844fc093fc09cee250edb8",22853670,2,3,0,1684,464,465,1
"83d42d95cd844fc093fc09cee250edb8","c5df9f40ec14463b9dcfdc73df3e9285",22853670,1,-3,0,1685,465,464,-1
"83d42d95cd844fc093fc09cee250edb8","83d42d95cd844fc093fc09cee250edb8",22853670,2,0,1,1687,465,465,0
"83d42d95cd844fc093fc09cee250edb8","9428d8bd9c5a47b2a235b254e5e27ded",22853670,1,-19,0,1689,465,452,-13
"b2f0d654738f48158edff28e8d3a546e","9428d8bd9c5a47b2a235b254e5e27ded",22853670,1,4,0,1700,449,452,3
"b2f0d654738f48158edff28e8d3a546e","b2f0d654738f48158edff28e8d3a546e",22853670,1,0,1,1702,449,449,0
"f60ee41ec635499abd48168342d32c2f","9428d8bd9c5a47b2a235b254e5e27ded",22853670,2,-1,0,1713,453,452,-1
"f60ee41ec635499abd48168342d32c2f","b7719e26494940efa49512aedd0aac79",22853670,1,-605,0,1751,453,20,-433
"b7719e26494940efa49512aedd0aac79","d4f45188d3c84a02ba08454e6403a818",22853670,2,5,0,1752,20,24,4
"d4f45188d3c84a02ba08454e6403a818","d4c3b003e8274e429d2fa688d73fde6d",22853670,2,-2,0,1753,24,22,-2
"d4c3b003e8274e429d2fa688d73fde6d","a49d1bb4328949299686242fd0be5584",22853670,1,-1,0,1754,22,21,-1
"a49d1bb4328949299686242fd0be5584","b7719e26494940efa49512aedd0aac79",22853670,1,-2,0,1755,21,20,-1
"b7719e26494940efa49512aedd0aac79","afbf7250b99d47bea07172749483ca97",22853670,2,12,0,1756,20,28,8
"afbf7250b99d47bea07172749483ca97","b7719e26494940efa49512aedd0aac79",22853670,1,-12,0,1757,28,20,-8
"b7719e26494940efa49512aedd0aac79","fab84b4fab5940efb4ea868ef8d09396",22853670,1,362,0,1758,20,284,264
"67a089198fcb4e1c8f2385786c2b296f","e2911e79efc2420eac45d9f671463d4b",22857219,1,-69,0,1,39,2,-37
"e2911e79efc2420eac45d9f671463d4b","b613861cecf84ffcab01afb23f660475",22857219,1,-3,0,3,2,1,-1
"b613861cecf84ffcab01afb23f660475","b613861cecf84ffcab01afb23f660475",22857219,4,0,1,4,1,1,0
"b613861cecf84ffcab01afb23f660475","e2911e79efc2420eac45d9f671463d4b",22857219,1,3,0,8,1,2,1
"e2911e79efc2420eac45d9f671463d4b","e2911e79efc2420eac45d9f671463d4b",22857219,3,0,1,10,2,2,0
"e2911e79efc2420eac45d9f671463d4b","519d1b8c59404d67b54e96c5c8a830b2",22857219,1,1,0,11,2,3,1
"519d1b8c59404d67b54e96c5c8a830b2","519d1b8c59404d67b54e96c5c8a830b2",22857219,1,0,1,12,3,3,0
"519d1b8c59404d67b54e96c5c8a830b2","531db53f81f646edb0cdcfe0085b03b7",22857219,1,1,0,13,3,4,1
"531db53f81f646edb0cdcfe0085b03b7","531db53f81f646edb0cdcfe0085b03b7",22857219,1,0,1,14,4,4,0
"531db53f81f646edb0cdcfe0085b03b7","4f5f94b2f95141e0a9d53a61da2276da",22857219,1,1,0,15,4,5,1
"4f5f94b2f95141e0a9d53a61da2276da","4f5f94b2f95141e0a9d53a61da2276da",22857219,1,0,1,16,5,5,0
"4f5f94b2f95141e0a9d53a61da2276da","6d541c89590949f99af293c4f2333f67",22857219,1,1,0,17,5,6,1
"6d541c89590949f99af293c4f2333f67","6d541c89590949f99af293c4f2333f67",22857219,1,0,1,18,6,6,0
"6d541c89590949f99af293c4f2333f67","dd5cf0b9fe4c4f1d8f5ff8e4c04879cb",22857219,1,1,0,19,6,7,1
"dd5cf0b9fe4c4f1d8f5ff8e4c04879cb","dd5cf0b9fe4c4f1d8f5ff8e4c04879cb",22857219,1,0,1,20,7,7,0
"dd5cf0b9fe4c4f1d8f5ff8e4c04879cb","f96261861edc426abe2248be4f0a709a",22857219,1,1,0,21,7,8,1
"f96261861edc426abe2248be4f0a709a","f96261861edc426abe2248be4f0a709a",22857219,1,0,1,22,8,8,0
"f96261861edc426abe2248be4f0a709a","66b5e16f4f75454fb5b8172079f0fa83",22857219,1,1,0,23,8,9,1
"66b5e16f4f75454fb5b8172079f0fa83","66b5e16f4f75454fb5b8172079f0fa83",22857219,1,0,1,24,9,9,0
"66b5e16f4f75454fb5b8172079f0fa83","0680571d4698477995e41842c36a54b2",22857219,1,1,0,25,9,10,1
"0680571d4698477995e41842c36a54b2","0680571d4698477995e41842c36a54b2",22857219,1,0,1,26,10,10,0
"0680571d4698477995e41842c36a54b2","9112f2bffece48e08c6d2287be204085",22857219,1,1,0,27,10,11,1
"9112f2bffece48e08c6d2287be204085","9112f2bffece48e08c6d2287be204085",22857219,1,0,1,28,11,11,0
"9112f2bffece48e08c6d2287be204085","e2911e79efc2420eac45d9f671463d4b",22857219,1,-9,0,29,11,2,-9
"e2911e79efc2420eac45d9f671463d4b","56586aa865414f538729c7f7735d2bc6",22857219,1,12,0,30,2,12,10
"56586aa865414f538729c7f7735d2bc6","56586aa865414f538729c7f7735d2bc6",22857219,3,0,1,31,12,12,0
"56586aa865414f538729c7f7735d2bc6","b7f2b31585d94eb3bf86376714aa7070",22857219,1,2,0,34,12,13,1
"b7f2b31585d94eb3bf86376714aa7070","b7f2b31585d94eb3bf86376714aa7070",22857219,3,0,1,35,13,13,0
"b7f2b31585d94eb3bf86376714aa7070","3f1c815879794b929260d224becaff7e",22857219,1,2,0,38,13,14,1
"3f1c815879794b929260d224becaff7e","81c864a886d54a6b8ff85f7d736f4f95",22857219,1,2,0,39,14,15,1
"81c864a886d54a6b8ff85f7d736f4f95","5c5ceeee4562457ba6d41515aeebfbb1",22857219,1,4,0,40,15,17,2
"5c5ceeee4562457ba6d41515aeebfbb1","5c5ceeee4562457ba6d41515aeebfbb1",22857219,1,0,1,41,17,17,0
"5c5ceeee4562457ba6d41515aeebfbb1","9afd71a5298d4333b6849dfce1b9422c",22857219,1,3,0,42,17,18,1
"9afd71a5298d4333b6849dfce1b9422c","56586aa865414f538729c7f7735d2bc6",22857219,1,-13,0,43,18,12,-6
"56586aa865414f538729c7f7735d2bc6","9afd71a5298d4333b6849dfce1b9422c",22857219,1,13,0,44,12,18,6
"9afd71a5298d4333b6849dfce1b9422c","b7719e26494940efa49512aedd0aac79",22857219,1,4,0,45,18,20,2
"b7719e26494940efa49512aedd0aac79","9afd71a5298d4333b6849dfce1b9422c",22857219,1,-4,0,46,20,18,-2
"9afd71a5298d4333b6849dfce1b9422c","d4f45188d3c84a02ba08454e6403a818",22857219,1,9,0,47,18,24,6
"d4f45188d3c84a02ba08454e6403a818","d4c3b003e8274e429d2fa688d73fde6d",22857219,1,-2,0,48,24,22,-2
"d4c3b003e8274e429d2fa688d73fde6d","d4c3b003e8274e429d2fa688d73fde6d",22857219,1,0,1,49,22,22,0
"d4c3b003e8274e429d2fa688d73fde6d","b7719e26494940efa49512aedd0aac79",22857219,1,-3,0,50,22,20,-2
"b7719e26494940efa49512aedd0aac79","afbf7250b99d47bea07172749483ca97",22857219,2,12,0,51,20,28,8
"afbf7250b99d47bea07172749483ca97","b7719e26494940efa49512aedd0aac79",22857219,1,-12,0,52,28,20,-8
"afbf7250b99d47bea07172749483ca97","4e51676dc72045d99c19b9fa7b22f8bc",22857219,1,3,0,54,28,29,1
"4e51676dc72045d99c19b9fa7b22f8bc","4e51676dc72045d99c19b9fa7b22f8bc",22857219,1,0,1,55,29,29,0
"4e51676dc72045d99c19b9fa7b22f8bc","51970cfa30e643e894e66ae85c8024cc",22857219,1,3,0,56,29,31,2
"51970cfa30e643e894e66ae85c8024cc","c33c17be71ae4d588da7369472e5bb1b",22857219,1,6,0,57,31,34,3
"c33c17be71ae4d588da7369472e5bb1b","4e51676dc72045d99c19b9fa7b22f8bc",22857219,1,-9,0,58,34,29,-5
"4e51676dc72045d99c19b9fa7b22f8bc","c33c17be71ae4d588da7369472e5bb1b",22857219,1,9,0,59,29,34,5
"c33c17be71ae4d588da7369472e5bb1b","93679be414554a11b1893002f2229a93",22857219,1,3,0,60,34,35,1
"93679be414554a11b1893002f2229a93","7040a13096d746ac84b8fac8d9752058",22857219,2,3,0,61,35,36,1
"7040a13096d746ac84b8fac8d9752058","93679be414554a11b1893002f2229a93",22857219,1,-3,0,62,36,35,-1
"7040a13096d746ac84b8fac8d9752058","9a0dc646f934470daf08c4b56ccf73db",22857219,1,3,0,64,36,37,1
"9a0dc646f934470daf08c4b56ccf73db","9a0dc646f934470daf08c4b56ccf73db",22857219,1,0,1,65,37,37,0
"9a0dc646f934470daf08c4b56ccf73db","fc0e049d56024bc9a02c9a9c435c3df7",22857219,1,3,0,66,37,38,1
"fc0e049d56024bc9a02c9a9c435c3df7","67a089198fcb4e1c8f2385786c2b296f",22857219,1,4,0,67,38,39,1
"67a089198fcb4e1c8f2385786c2b296f","fc0e049d56024bc9a02c9a9c435c3df7",22857219,1,-4,0,68,39,38,-1
"fc0e049d56024bc9a02c9a9c435c3df7","64d48c6c9c7940639a932219a6c87198",22857219,1,5,0,69,38,40,2
"64d48c6c9c7940639a932219a6c87198","0c7262dff33c4087bc660ccf40f92f9c",22857219,1,168,0,70,40,169,129
"b2275c3fad834f8d90737a2d9a6927d6","67a089198fcb4e1c8f2385786c2b296f",22857219,1,-172,0,72,172,39,-133
"67a089198fcb4e1c8f2385786c2b296f","64d48c6c9c7940639a932219a6c87198",22857219,2,1,0,74,39,40,1
"64d48c6c9c7940639a932219a6c87198","64d48c6c9c7940639a932219a6c87198",22857219,2,0,1,75,40,40,0
"64d48c6c9c7940639a932219a6c87198","b534b89233134e30a9b5645138bfa9ee",22857219,2,3,0,76,40,41,1
"b534b89233134e30a9b5645138bfa9ee","67a089198fcb4e1c8f2385786c2b296f",22857219,3,-4,0,77,41,39,-2
"67a089198fcb4e1c8f2385786c2b296f","0e37b720d23b4e7f8b313e79313fd107",22857219,1,7,0,78,39,44,5
"0e37b720d23b4e7f8b313e79313fd107","0e37b720d23b4e7f8b313e79313fd107",22857219,1,0,1,79,44,44,0
"0e37b720d23b4e7f8b313e79313fd107","6875d67fdd5f48168b62719df449bebd",22857219,1,1,0,80,44,45,1
"6875d67fdd5f48168b62719df449bebd","6875d67fdd5f48168b62719df449bebd",22857219,1,0,1,81,45,45,0
"6875d67fdd5f48168b62719df449bebd","b534b89233134e30a9b5645138bfa9ee",22857219,1,-4,0,82,45,41,-4
"b534b89233134e30a9b5645138bfa9ee","6e13d61a7bdb44bca949c9f86fab3be5",22857219,2,7,0,83,41,47,6
"6e13d61a7bdb44bca949c9f86fab3be5","6e13d61a7bdb44bca949c9f86fab3be5",22857219,2,0,1,84,47,47,0
"6e13d61a7bdb44bca949c9f86fab3be5","d9c8d8c444a64dadbbb508652c721e17",22857219,1,-1,0,86,47,46,-1
"d9c8d8c444a64dadbbb508652c721e17","b534b89233134e30a9b5645138bfa9ee",22857219,1,-6,0,87,46,41,-5
"67a089198fcb4e1c8f2385786c2b296f","b534b89233134e30a9b5645138bfa9ee",22857219,1,4,0,93,39,41,2
"6e13d61a7bdb44bca949c9f86fab3be5","195f78799f984cc2b06c48dfe36be751",22857219,1,2,0,95,47,49,2
"195f78799f984cc2b06c48dfe36be751","195f78799f984cc2b06c48dfe36be751",22857219,2,0,1,96,49,49,0
"195f78799f984cc2b06c48dfe36be751","d9c8d8c444a64dadbbb508652c721e17",22857219,1,-3,0,98,49,46,-3
"d9c8d8c444a64dadbbb508652c721e17","d0c74f735e024943943e40333d6d337f",22857219,1,6,0,99,46,51,5
"d0c74f735e024943943e40333d6d337f","d0c74f735e024943943e40333d6d337f",22857219,2,0,1,100,51,51,0
"d0c74f735e024943943e40333d6d337f","983f8ff320594b279a7f4a6fe132f9c5",22857219,1,2,0,102,51,53,2
"983f8ff320594b279a7f4a6fe132f9c5","983f8ff320594b279a7f4a6fe132f9c5",22857219,2,0,1,103,53,53,0
"983f8ff320594b279a7f4a6fe132f9c5","35adfa5d923046aebabfefd98f35ff05",22857219,1,1,0,105,53,54,1
"35adfa5d923046aebabfefd98f35ff05","35adfa5d923046aebabfefd98f35ff05",22857219,2,0,1,106,54,54,0
"35adfa5d923046aebabfefd98f35ff05","b6f8a98476224da1b40e555ececc7ed8",22857219,1,1,0,108,54,55,1
"b6f8a98476224da1b40e555ececc7ed8","b6f8a98476224da1b40e555ececc7ed8",22857219,2,0,1,109,55,55,0
"b6f8a98476224da1b40e555ececc7ed8","86e22cb5fe0e4b47a9489ecddf7ed78f",22857219,1,1,0,111,55,56,1
"86e22cb5fe0e4b47a9489ecddf7ed78f","86e22cb5fe0e4b47a9489ecddf7ed78f",22857219,2,0,1,112,56,56,0
"86e22cb5fe0e4b47a9489ecddf7ed78f","a1f2f12debe5432fb7a70bcd12bacfb9",22857219,1,3,0,114,56,58,2
"a1f2f12debe5432fb7a70bcd12bacfb9","78f30e4dcac84e3cbea8b2cc6e0d62b3",22857219,2,1,0,115,58,59,1
"78f30e4dcac84e3cbea8b2cc6e0d62b3","f924752d8a1149668870b1e7698486f7",22857219,1,-10,0,116,59,50,-9
"f924752d8a1149668870b1e7698486f7","a1f2f12debe5432fb7a70bcd12bacfb9",22857219,1,9,0,117,50,58,8
"a1f2f12debe5432fb7a70bcd12bacfb9","a1f2f12debe5432fb7a70bcd12bacfb9",22857219,10,0,1,118,58,58,0
"78f30e4dcac84e3cbea8b2cc6e0d62b3","78f30e4dcac84e3cbea8b2cc6e0d62b3",22857219,7,0,1,129,59,59,0
"78f30e4dcac84e3cbea8b2cc6e0d62b3","a0a418b8540d479fa6e0f653b701da8b",22857219,1,6,0,136,59,64,5
"a0a418b8540d479fa6e0f653b701da8b","bc42d26810654ea9a1df1efe1e58c7d5",22857219,1,-1,0,137,64,63,-1
"bc42d26810654ea9a1df1efe1e58c7d5","12aa6e1672ac4e7aa6449a7a8609cd72",22857219,1,-7,0,138,63,57,-6
"12aa6e1672ac4e7aa6449a7a8609cd72","4c943503763e4e349906eea3ed3c8e86",22857219,1,5,0,139,57,61,4
"4c943503763e4e349906eea3ed3c8e86","4c943503763e4e349906eea3ed3c8e86",22857219,1,0,1,140,61,61,0
"4c943503763e4e349906eea3ed3c8e86","bc42d26810654ea9a1df1efe1e58c7d5",22857219,1,2,0,141,61,63,2
"bc42d26810654ea9a1df1efe1e58c7d5","bc42d26810654ea9a1df1efe1e58c7d5",22857219,3,0,1,142,63,63,0
"bc42d26810654ea9a1df1efe1e58c7d5","a0a418b8540d479fa6e0f653b701da8b",22857219,1,1,0,145,63,64,1
"a0a418b8540d479fa6e0f653b701da8b","a0a418b8540d479fa6e0f653b701da8b",22857219,3,0,1,146,64,64,0
"a0a418b8540d479fa6e0f653b701da8b","309ccf3cc4fe429d9bfbaef53d3fa479",22857219,1,-4,0,149,64,60,-4
"309ccf3cc4fe429d9bfbaef53d3fa479","d646286c8051419bbc2e31dd1db55ca8",22857219,1,10,0,150,60,67,7
"d646286c8051419bbc2e31dd1db55ca8","b534b89233134e30a9b5645138bfa9ee",22857219,1,-33,0,151,67,41,-26
"b534b89233134e30a9b5645138bfa9ee","267f883678b24aed855fde42524975d9",22857219,1,37,0,152,41,71,30
"267f883678b24aed855fde42524975d9","267f883678b24aed855fde42524975d9",22857219,1,0,1,153,71,71,0
"267f883678b24aed855fde42524975d9","88fff56d0342490dbef9040750a20f6c",22857219,1,1,0,154,71,72,1
"88fff56d0342490dbef9040750a20f6c","88fff56d0342490dbef9040750a20f6c",22857219,1,0,1,155,72,72,0
"88fff56d0342490dbef9040750a20f6c","adb17b12b66c4a49a85fd34322f7df70",22857219,1,1,0,156,72,73,1
"adb17b12b66c4a49a85fd34322f7df70","adb17b12b66c4a49a85fd34322f7df70",22857219,1,0,1,157,73,73,0
"adb17b12b66c4a49a85fd34322f7df70","d646286c8051419bbc2e31dd1db55ca8",22857219,1,-6,0,158,73,67,-6
"d646286c8051419bbc2e31dd1db55ca8","a2becd407db34b189200a32546d9d569",22857219,1,9,0,159,67,75,8
"a2becd407db34b189200a32546d9d569","a2becd407db34b189200a32546d9d569",22857219,2,0,1,160,75,75,0
"a2becd407db34b189200a32546d9d569","58c22b011d0f4c2ea6d13615edbb9eeb",22857219,1,2,0,162,75,77,2
"58c22b011d0f4c2ea6d13615edbb9eeb","58c22b011d0f4c2ea6d13615edbb9eeb",22857219,11,0,1,163,77,77,0
"58c22b011d0f4c2ea6d13615edbb9eeb","dd76e1861dc9461c830888729d091ee0",22857219,1,1,0,174,77,78,1
"dd76e1861dc9461c830888729d091ee0","dd76e1861dc9461c830888729d091ee0",22857219,5,0,1,175,78,78,0
"dd76e1861dc9461c830888729d091ee0","cd1d828f1a694b87913a7ea66c23803e",22857219,1,1,0,180,78,79,1
"cd1d828f1a694b87913a7ea66c23803e","cd1d828f1a694b87913a7ea66c23803e",22857219,2,0,1,181,79,79,0
"cd1d828f1a694b87913a7ea66c23803e","9176a3c2b4d2465fa8b0c67096c2a97e",22857219,1,1,0,183,79,80,1
"9176a3c2b4d2465fa8b0c67096c2a97e","9176a3c2b4d2465fa8b0c67096c2a97e",22857219,5,0,1,184,80,80,0
"9176a3c2b4d2465fa8b0c67096c2a97e","f8ec6445f7194e25b9101d4fbcb07a18",22857219,1,1,0,189,80,81,1
"f8ec6445f7194e25b9101d4fbcb07a18","f8ec6445f7194e25b9101d4fbcb07a18",22857219,2,0,1,190,81,81,0
"f8ec6445f7194e25b9101d4fbcb07a18","140d5b27b8574befad82c0a013b59dfa",22857219,1,-7,0,192,81,74,-7
"140d5b27b8574befad82c0a013b59dfa","d18a9ea32855445f8736581f5cb119ce",22857219,1,9,0,193,74,82,8
"d18a9ea32855445f8736581f5cb119ce","f564483cbd7a407681aa2fcca518cf5f",22857219,1,4,0,194,82,85,3
"f564483cbd7a407681aa2fcca518cf5f","f564483cbd7a407681aa2fcca518cf5f",22857219,4,0,1,195,85,85,0
"f564483cbd7a407681aa2fcca518cf5f","18fd01350bd5434ca636d59a599d768a",22857219,1,1,0,199,85,86,1
"18fd01350bd5434ca636d59a599d768a","18fd01350bd5434ca636d59a599d768a",22857219,9,0,1,200,86,86,0
"18fd01350bd5434ca636d59a599d768a","ae5ac430ea254e708a6f5deaaf7464ae",22857219,1,-2,0,209,86,84,-2
"ae5ac430ea254e708a6f5deaaf7464ae","6a9f0ef185fb47f0937e29daa1c71ed5",22857219,1,7,0,210,84,90,6
"6a9f0ef185fb47f0937e29daa1c71ed5","c681290961c94c4caf23b529d1ae6b9a",22857219,1,-2,0,211,90,88,-2
"c681290961c94c4caf23b529d1ae6b9a","c681290961c94c4caf23b529d1ae6b9a",22857219,1,0,1,212,88,88,0
"c681290961c94c4caf23b529d1ae6b9a","6a9f0ef185fb47f0937e29daa1c71ed5",22857219,1,2,0,213,88,90,2
"6a9f0ef185fb47f0937e29daa1c71ed5","d646286c8051419bbc2e31dd1db55ca8",22857219,1,-27,0,214,90,67,-23
"d646286c8051419bbc2e31dd1db55ca8","e20db35ced8544ddac5bc3839145e463",22857219,1,30,0,215,67,91,24
"e20db35ced8544ddac5bc3839145e463","e20db35ced8544ddac5bc3839145e463",22857219,1,0,1,216,91,91,0
"e20db35ced8544ddac5bc3839145e463","d646286c8051419bbc2e31dd1db55ca8",22857219,2,-30,0,217,91,67,-24
"d646286c8051419bbc2e31dd1db55ca8","6a9f0ef185fb47f0937e29daa1c71ed5",22857219,1,27,0,218,67,90,23
"6a9f0ef185fb47f0937e29daa1c71ed5","e20db35ced8544ddac5bc3839145e463",22857219,1,3,0,219,90,91,1
"d646286c8051419bbc2e31dd1db55ca8","1febb706d7a34005ae8711ed49c76e64",22857219,1,33,0,221,67,94,27
"1febb706d7a34005ae8711ed49c76e64","1febb706d7a34005ae8711ed49c76e64",22857219,2,0,1,222,94,94,0
"1febb706d7a34005ae8711ed49c76e64","8f73ba6f5a0042f2850356ac38ac6f24",22857219,1,1,0,224,94,95,1
"8f73ba6f5a0042f2850356ac38ac6f24","8f73ba6f5a0042f2850356ac38ac6f24",22857219,5,0,1,225,95,95,0
"8f73ba6f5a0042f2850356ac38ac6f24","e2260b86653c46d7b14a41fb419dbf8c",22857219,1,1,0,230,95,96,1
"e2260b86653c46d7b14a41fb419dbf8c","e2260b86653c46d7b14a41fb419dbf8c",22857219,2,0,1,231,96,96,0
"e2260b86653c46d7b14a41fb419dbf8c","35eb641ad1d845bbba54915bce75a962",22857219,1,1,0,233,96,97,1
"35eb641ad1d845bbba54915bce75a962","35eb641ad1d845bbba54915bce75a962",22857219,5,0,1,234,97,97,0
"35eb641ad1d845bbba54915bce75a962","08be90ffbeea4795a138cd42ed8db56f",22857219,1,1,0,239,97,98,1
"08be90ffbeea4795a138cd42ed8db56f","08be90ffbeea4795a138cd42ed8db56f",22857219,5,0,1,240,98,98,0
"08be90ffbeea4795a138cd42ed8db56f","3007433c8f584dcbb5ac159c1c5f2be3",22857219,1,1,0,245,98,99,1
"3007433c8f584dcbb5ac159c1c5f2be3","3007433c8f584dcbb5ac159c1c5f2be3",22857219,5,0,1,246,99,99,0
"3007433c8f584dcbb5ac159c1c5f2be3","d391c8b6e56a43a7b654e9dee02d904b",22857219,1,5,0,251,99,103,4
"d391c8b6e56a43a7b654e9dee02d904b","00ae5f0c51874a73a41ebea838d95682",22857219,1,-2,0,252,103,101,-2
"00ae5f0c51874a73a41ebea838d95682","e20db35ced8544ddac5bc3839145e463",22857219,1,-11,0,253,101,91,-10
"e20db35ced8544ddac5bc3839145e463","00ae5f0c51874a73a41ebea838d95682",22857219,1,11,0,254,91,101,10
"00ae5f0c51874a73a41ebea838d95682","00ae5f0c51874a73a41ebea838d95682",22857219,2,0,1,255,101,101,0
"00ae5f0c51874a73a41ebea838d95682","d391c8b6e56a43a7b654e9dee02d904b",22857219,1,2,0,257,101,103,2
"d391c8b6e56a43a7b654e9dee02d904b","d391c8b6e56a43a7b654e9dee02d904b",22857219,18,0,1,258,103,103,0
"d391c8b6e56a43a7b654e9dee02d904b","6111116566fc4fd9abba409322bea245",22857219,1,1,0,276,103,104,1
"6111116566fc4fd9abba409322bea245","6111116566fc4fd9abba409322bea245",22857219,2,0,1,277,104,104,0
"6111116566fc4fd9abba409322bea245","a81b2235cb9c499eb9ea8ee0a8dd9725",22857219,1,1,0,279,104,105,1
"a81b2235cb9c499eb9ea8ee0a8dd9725","a81b2235cb9c499eb9ea8ee0a8dd9725",22857219,5,0,1,280,105,105,0
"a81b2235cb9c499eb9ea8ee0a8dd9725","2d4e0ab0ef3b4d73b82c72d4621a7579",22857219,1,1,0,285,105,106,1
"2d4e0ab0ef3b4d73b82c72d4621a7579","2d4e0ab0ef3b4d73b82c72d4621a7579",22857219,2,0,1,286,106,106,0
"2d4e0ab0ef3b4d73b82c72d4621a7579","8bdebf492ebd4e62b0d522e8ab5e5197",22857219,1,1,0,288,106,107,1
"8bdebf492ebd4e62b0d522e8ab5e5197","8bdebf492ebd4e62b0d522e8ab5e5197",22857219,2,0,1,289,107,107,0
"8bdebf492ebd4e62b0d522e8ab5e5197","73039f8c1eb9409cb4caee2cf968001e",22857219,1,-7,0,291,107,100,-7
"73039f8c1eb9409cb4caee2cf968001e","4280927ec4d643238aa49c32f9e06c6c",22857219,1,10,0,292,100,109,9
"4280927ec4d643238aa49c32f9e06c6c","4280927ec4d643238aa49c32f9e06c6c",22857219,2,0,1,293,109,109,0
"4280927ec4d643238aa49c32f9e06c6c","fc44e6a5f7654430af1227838224dceb",22857219,1,2,0,295,109,111,2
"fc44e6a5f7654430af1227838224dceb","fc44e6a5f7654430af1227838224dceb",22857219,2,0,1,296,111,111,0
"fc44e6a5f7654430af1227838224dceb","08111f75e22d409998cf8b85bd431f0a",22857219,1,-3,0,298,111,108,-3
"08111f75e22d409998cf8b85bd431f0a","a9ae0a3c070d455bb4369a8996313336",22857219,2,7,0,299,108,114,6
"a9ae0a3c070d455bb4369a8996313336","a9ae0a3c070d455bb4369a8996313336",22857219,1,0,1,300,114,114,0
"a9ae0a3c070d455bb4369a8996313336","71cec822bcff4f30a20e75dc63ef7b65",22857219,1,2,0,301,114,116,2
"71cec822bcff4f30a20e75dc63ef7b65","71cec822bcff4f30a20e75dc63ef7b65",22857219,1,0,1,302,116,116,0
"71cec822bcff4f30a20e75dc63ef7b65","62bff51286ef4f348717a3cf6fe2318f",22857219,1,5,0,303,116,120,4
"62bff51286ef4f348717a3cf6fe2318f","37319e88176d4aefa91d7a9980dbae91",22857219,1,-9,0,304,120,112,-8
"37319e88176d4aefa91d7a9980dbae91","b1cd0e7dc3ad4a8eb91a4bfdbeb025b0",22857219,1,7,0,305,112,118,6
"b1cd0e7dc3ad4a8eb91a4bfdbeb025b0","b1cd0e7dc3ad4a8eb91a4bfdbeb025b0",22857219,1,0,1,306,118,118,0
"b1cd0e7dc3ad4a8eb91a4bfdbeb025b0","62bff51286ef4f348717a3cf6fe2318f",22857219,1,2,0,307,118,120,2
"62bff51286ef4f348717a3cf6fe2318f","62bff51286ef4f348717a3cf6fe2318f",22857219,3,0,1,308,120,120,0
"62bff51286ef4f348717a3cf6fe2318f","e20db35ced8544ddac5bc3839145e463",22857219,1,-33,0,311,120,91,-29
"e20db35ced8544ddac5bc3839145e463","779f9ddd1fd14d1e9e69f72219a1fdbd",22857219,1,36,0,312,91,121,30
"779f9ddd1fd14d1e9e69f72219a1fdbd","ae26e6cda8ad4a3f81bd347560d9579f",22857219,1,4,0,313,121,125,4
"ae26e6cda8ad4a3f81bd347560d9579f","ae26e6cda8ad4a3f81bd347560d9579f",22857219,1,0,1,314,125,125,0
"ae26e6cda8ad4a3f81bd347560d9579f","ee48df95832b4374aa273ceb27ec1315",22857219,1,1,0,315,125,126,1
"ee48df95832b4374aa273ceb27ec1315","ee48df95832b4374aa273ceb27ec1315",22857219,1,0,1,316,126,126,0
"ee48df95832b4374aa273ceb27ec1315","7a439da90b394756ad1777fc4c6dead5",22857219,1,1,0,317,126,127,1
"7a439da90b394756ad1777fc4c6dead5","7a439da90b394756ad1777fc4c6dead5",22857219,1,0,1,318,127,127,0
"7a439da90b394756ad1777fc4c6dead5","779f9ddd1fd14d1e9e69f72219a1fdbd",22857219,1,-6,0,319,127,121,-6
"779f9ddd1fd14d1e9e69f72219a1fdbd","a8dd5213034441ac92724b4e83eb0bb2",22857219,1,9,0,320,121,129,8
"a8dd5213034441ac92724b4e83eb0bb2","a8dd5213034441ac92724b4e83eb0bb2",22857219,2,0,1,321,129,129,0
"a8dd5213034441ac92724b4e83eb0bb2","8115eab6556b45f5b415c3b8c26a12e5",22857219,1,2,0,323,129,131,2
"8115eab6556b45f5b415c3b8c26a12e5","8115eab6556b45f5b415c3b8c26a12e5",22857219,2,0,1,324,131,131,0
"8115eab6556b45f5b415c3b8c26a12e5","ec34b06efd844b46a4c4818ecdb9b8f4",22857219,1,1,0,326,131,132,1
"ec34b06efd844b46a4c4818ecdb9b8f4","ec34b06efd844b46a4c4818ecdb9b8f4",22857219,5,0,1,327,132,132,0
"ec34b06efd844b46a4c4818ecdb9b8f4","c2e1c2b9eac64109b343a088584b576b",22857219,1,1,0,332,132,133,1
"c2e1c2b9eac64109b343a088584b576b","c2e1c2b9eac64109b343a088584b576b",22857219,2,0,1,333,133,133,0
"c2e1c2b9eac64109b343a088584b576b","579338175e0b4bbb8ef3b712b5d8b54e",22857219,1,-5,0,335,133,128,-5
"579338175e0b4bbb8ef3b712b5d8b54e","8bc5795d6a984a3eace4e2811e52dd4f",22857219,1,8,0,336,128,135,7
"8bc5795d6a984a3eace4e2811e52dd4f","8bc5795d6a984a3eace4e2811e52dd4f",22857219,3,0,1,337,135,135,0
"8bc5795d6a984a3eace4e2811e52dd4f","b416d47c56a742199b5d7c7f19d6503a",22857219,1,-1,0,340,135,134,-1
"b416d47c56a742199b5d7c7f19d6503a","cd4532ad48034873ba8bce2aac0c9808",22857219,1,4,0,341,134,137,3
"cd4532ad48034873ba8bce2aac0c9808","cd4532ad48034873ba8bce2aac0c9808",22857219,1,0,1,342,137,137,0
"cd4532ad48034873ba8bce2aac0c9808","779f9ddd1fd14d1e9e69f72219a1fdbd",22857219,1,-19,0,343,137,121,-16
"779f9ddd1fd14d1e9e69f72219a1fdbd","df1de691dafe4549a18a4398ee9dfaf9",22857219,1,23,0,344,121,139,18
"df1de691dafe4549a18a4398ee9dfaf9","6c5ad271a44743479bfaea29b1db8d02",22857219,1,4,0,345,139,143,4
"6c5ad271a44743479bfaea29b1db8d02","6c5ad271a44743479bfaea29b1db8d02",22857219,2,0,1,346,143,143,0
"6c5ad271a44743479bfaea29b1db8d02","83d311bed5374fee83d8d67a7d9d82dc",22857219,1,1,0,348,143,144,1
"83d311bed5374fee83d8d67a7d9d82dc","83d311bed5374fee83d8d67a7d9d82dc",22857219,1,0,1,349,144,144,0
"83d311bed5374fee83d8d67a7d9d82dc","402bba41861d43acb52a5abb89e8831e",22857219,1,1,0,350,144,145,1
"402bba41861d43acb52a5abb89e8831e","402bba41861d43acb52a5abb89e8831e",22857219,2,0,1,351,145,145,0
"402bba41861d43acb52a5abb89e8831e","df1de691dafe4549a18a4398ee9dfaf9",22857219,1,-6,0,353,145,139,-6
"df1de691dafe4549a18a4398ee9dfaf9","8aae34f5ddbb4052a709b12e6b0d40fa",22857219,1,9,0,354,139,147,8
"8aae34f5ddbb4052a709b12e6b0d40fa","8aae34f5ddbb4052a709b12e6b0d40fa",22857219,3,0,1,355,147,147,0
"8aae34f5ddbb4052a709b12e6b0d40fa","645b3f0249f64f76af2e19eb4d0e55b7",22857219,1,2,0,358,147,149,2
"645b3f0249f64f76af2e19eb4d0e55b7","645b3f0249f64f76af2e19eb4d0e55b7",22857219,2,0,1,359,149,149,0
"645b3f0249f64f76af2e19eb4d0e55b7","7e7b8db5064d4369805ab370aac5ddfb",22857219,1,1,0,361,149,150,1
"7e7b8db5064d4369805ab370aac5ddfb","7e7b8db5064d4369805ab370aac5ddfb",22857219,5,0,1,362,150,150,0
"7e7b8db5064d4369805ab370aac5ddfb","8956d210ae7f41968fada86d4c979d6a",22857219,1,1,0,367,150,151,1
"8956d210ae7f41968fada86d4c979d6a","8956d210ae7f41968fada86d4c979d6a",22857219,2,0,1,368,151,151,0
"8956d210ae7f41968fada86d4c979d6a","f902b0f41b544d4dbf79664fd233648d",22857219,1,-5,0,370,151,146,-5
"f902b0f41b544d4dbf79664fd233648d","ae781e8b775e4ccd93bc800dad5c8376",22857219,1,8,0,371,146,153,7
"ae781e8b775e4ccd93bc800dad5c8376","ae781e8b775e4ccd93bc800dad5c8376",22857219,2,0,1,372,153,153,0
"ae781e8b775e4ccd93bc800dad5c8376","06882a8492d9499aa31555567f575ecb",22857219,1,1,0,374,153,154,1
"06882a8492d9499aa31555567f575ecb","06882a8492d9499aa31555567f575ecb",22857219,1,0,1,375,154,154,0
"06882a8492d9499aa31555567f575ecb","f293c508f409466a8f27ddd7d1e40b20",22857219,1,1,0,376,154,155,1
"f293c508f409466a8f27ddd7d1e40b20","f293c508f409466a8f27ddd7d1e40b20",22857219,2,0,1,377,155,155,0
"f293c508f409466a8f27ddd7d1e40b20","cc4ddef5bbbe48ebb605141b347c4ed1",22857219,1,1,0,379,155,156,1
"cc4ddef5bbbe48ebb605141b347c4ed1","cc4ddef5bbbe48ebb605141b347c4ed1",22857219,1,0,1,380,156,156,0
"cc4ddef5bbbe48ebb605141b347c4ed1","f03480cf4eba413194d7af52fc0e7f28",22857219,1,-4,0,381,156,152,-4
"f03480cf4eba413194d7af52fc0e7f28","d313cec988a84645bee413e8d4724a4b",22857219,1,7,0,382,152,158,6
"d313cec988a84645bee413e8d4724a4b","d313cec988a84645bee413e8d4724a4b",22857219,4,0,1,383,158,158,0
"d313cec988a84645bee413e8d4724a4b","dc60696c76a74368a60f72246e47700d",22857219,1,1,0,387,158,159,1
"dc60696c76a74368a60f72246e47700d","dc60696c76a74368a60f72246e47700d",22857219,1,0,1,388,159,159,0
"dc60696c76a74368a60f72246e47700d","78adeee1fa2c4fe0bc73f7bca9fcee86",22857219,1,3,0,389,159,160,1
"78adeee1fa2c4fe0bc73f7bca9fcee86","df1de691dafe4549a18a4398ee9dfaf9",22857219,1,-26,0,390,160,139,-21
"df1de691dafe4549a18a4398ee9dfaf9","65202579580f4ad38d734b4ee39d22a8",22857219,1,31,0,391,139,164,25
"65202579580f4ad38d734b4ee39d22a8","78adeee1fa2c4fe0bc73f7bca9fcee86",22857219,2,-5,0,392,164,160,-4
"78adeee1fa2c4fe0bc73f7bca9fcee86","65202579580f4ad38d734b4ee39d22a8",22857219,2,5,0,393,160,164,4
"65202579580f4ad38d734b4ee39d22a8","65202579580f4ad38d734b4ee39d22a8",22857219,61,0,1,394,164,164,0
"65202579580f4ad38d734b4ee39d22a8","0c7262dff33c4087bc660ccf40f92f9c",22857219,1,12,0,413,164,169,5
"0c7262dff33c4087bc660ccf40f92f9c","b2275c3fad834f8d90737a2d9a6927d6",22857219,4,3,0,414,169,172,3
"b2275c3fad834f8d90737a2d9a6927d6","3cbcea2be0984e7dbd5a48195af10ce7",22857219,1,-12,0,415,172,165,-7
"3cbcea2be0984e7dbd5a48195af10ce7","3cbcea2be0984e7dbd5a48195af10ce7",22857219,1,0,1,416,165,165,0
"3cbcea2be0984e7dbd5a48195af10ce7","82e6285962b8400d9d6fc32436022a94",22857219,2,2,0,417,165,167,2
"82e6285962b8400d9d6fc32436022a94","3cbcea2be0984e7dbd5a48195af10ce7",22857219,1,-2,0,418,167,165,-2
"3cbcea2be0984e7dbd5a48195af10ce7","a9ac840f098c4bd0a2ee896214ce29cd",22857219,1,5,0,419,165,168,3
"a9ac840f098c4bd0a2ee896214ce29cd","a9ac840f098c4bd0a2ee896214ce29cd",22857219,1,0,1,420,168,168,0
"a9ac840f098c4bd0a2ee896214ce29cd","0c7262dff33c4087bc660ccf40f92f9c",22857219,1,4,0,421,168,169,1
"b2275c3fad834f8d90737a2d9a6927d6","8959e6304a0348309a771e4d08d1b64a",22857219,1,-16,0,423,172,163,-9
"8959e6304a0348309a771e4d08d1b64a","78adeee1fa2c4fe0bc73f7bca9fcee86",22857219,1,-4,0,424,163,160,-3
"78adeee1fa2c4fe0bc73f7bca9fcee86","3cbcea2be0984e7dbd5a48195af10ce7",22857219,1,8,0,469,160,165,5
"82e6285962b8400d9d6fc32436022a94","67a089198fcb4e1c8f2385786c2b296f",22857219,1,-162,0,471,167,39,-128
"67a089198fcb4e1c8f2385786c2b296f","67a089198fcb4e1c8f2385786c2b296f",22857219,2,0,1,472,39,39,0
"67a089198fcb4e1c8f2385786c2b296f","d646286c8051419bbc2e31dd1db55ca8",22857219,1,37,0,473,39,67,28
"d646286c8051419bbc2e31dd1db55ca8","140d5b27b8574befad82c0a013b59dfa",22857219,1,8,0,474,67,74,7
"140d5b27b8574befad82c0a013b59dfa","a2becd407db34b189200a32546d9d569",22857219,1,1,0,475,74,75,1
"a2becd407db34b189200a32546d9d569","140d5b27b8574befad82c0a013b59dfa",22857219,1,-1,0,476,75,74,-1
"140d5b27b8574befad82c0a013b59dfa","67a089198fcb4e1c8f2385786c2b296f",22857219,1,-45,0,477,74,39,-35
"67a089198fcb4e1c8f2385786c2b296f","08111f75e22d409998cf8b85bd431f0a",22857219,1,86,0,478,39,108,69
"08111f75e22d409998cf8b85bd431f0a","e20db35ced8544ddac5bc3839145e463",22857219,1,-19,0,479,108,91,-17
"e20db35ced8544ddac5bc3839145e463","4280927ec4d643238aa49c32f9e06c6c",22857219,2,20,0,480,91,109,18
"4280927ec4d643238aa49c32f9e06c6c","08111f75e22d409998cf8b85bd431f0a",22857219,1,-1,0,481,109,108,-1
"a9ae0a3c070d455bb4369a8996313336","e20db35ced8544ddac5bc3839145e463",22857219,1,-26,0,483,114,91,-23
"4280927ec4d643238aa49c32f9e06c6c","67a089198fcb4e1c8f2385786c2b296f",22857219,1,-87,0,485,109,39,-70
"67a089198fcb4e1c8f2385786c2b296f","0c7262dff33c4087bc660ccf40f92f9c",22857219,1,169,0,486,39,169,130
"0c7262dff33c4087bc660ccf40f92f9c","0c7262dff33c4087bc660ccf40f92f9c",22857219,1,0,1,487,169,169,0
"b2275c3fad834f8d90737a2d9a6927d6","b2275c3fad834f8d90737a2d9a6927d6",22857219,26,0,1,489,172,172,0
"b2275c3fad834f8d90737a2d9a6927d6","eb515a26030b41f8a82a1e6114420bad",22857219,1,1,0,515,172,173,1
"eb515a26030b41f8a82a1e6114420bad","eb515a26030b41f8a82a1e6114420bad",22857219,2,0,1,516,173,173,0
"eb515a26030b41f8a82a1e6114420bad","0c7262dff33c4087bc660ccf40f92f9c",22857219,1,-4,0,518,173,169,-4
"0c7262dff33c4087bc660ccf40f92f9c","b42cc17b7de840f181a704558d0bc845",22857219,1,7,0,519,169,175,6
"b42cc17b7de840f181a704558d0bc845","b42cc17b7de840f181a704558d0bc845",22857219,1,0,1,520,175,175,0
"b42cc17b7de840f181a704558d0bc845","801f9e9135034f49bf5f8b4bdefedb41",22857219,1,2,0,521,175,177,2
"801f9e9135034f49bf5f8b4bdefedb41","801f9e9135034f49bf5f8b4bdefedb41",22857219,11,0,1,522,177,177,0
"801f9e9135034f49bf5f8b4bdefedb41","b42cc17b7de840f181a704558d0bc845",22857219,1,-2,0,533,177,175,-2
"b42cc17b7de840f181a704558d0bc845","362fcb0699a14845ab29b2340093e528",22857219,1,-1,0,534,175,174,-1
"362fcb0699a14845ab29b2340093e528","b87c552dd247427abe6ab5795b9c9d43",22857219,1,8,0,535,174,181,7
"b87c552dd247427abe6ab5795b9c9d43","ea38cc0e6e6e41edbabf210220808bf9",22857219,1,-2,0,536,181,179,-2
"ea38cc0e6e6e41edbabf210220808bf9","ea38cc0e6e6e41edbabf210220808bf9",22857219,2,0,1,537,179,179,0
"ea38cc0e6e6e41edbabf210220808bf9","b87c552dd247427abe6ab5795b9c9d43",22857219,1,2,0,539,179,181,2
"b87c552dd247427abe6ab5795b9c9d43","b87c552dd247427abe6ab5795b9c9d43",22857219,7,0,1,540,181,181,0
"b87c552dd247427abe6ab5795b9c9d43","139b097acfca451689d80c9c6eebdf7b",22857219,1,-3,0,547,181,178,-3
"139b097acfca451689d80c9c6eebdf7b","30f660a1feb34582a739722532524f79",22857219,1,6,0,548,178,183,5
"30f660a1feb34582a739722532524f79","30f660a1feb34582a739722532524f79",22857219,6,0,1,549,183,183,0
"30f660a1feb34582a739722532524f79","2024b4885bd14338a39b7b509acbbd02",22857219,1,-1,0,555,183,182,-1
"2024b4885bd14338a39b7b509acbbd02","c3f63fe50d8e487c86bf8ef76c9cadd3",22857219,1,4,0,556,182,185,3
"c3f63fe50d8e487c86bf8ef76c9cadd3","c3f63fe50d8e487c86bf8ef76c9cadd3",22857219,1,0,1,557,185,185,0
"c3f63fe50d8e487c86bf8ef76c9cadd3","0c7262dff33c4087bc660ccf40f92f9c",22857219,1,-20,0,558,185,169,-16
"0c7262dff33c4087bc660ccf40f92f9c","c8e371568a0c4391b25796ae4e91952e",22857219,1,23,0,559,169,186,17
"c8e371568a0c4391b25796ae4e91952e","7d932b23e1c84326ae5aa4d3c0d813d1",22857219,1,2,0,560,186,188,2
"7d932b23e1c84326ae5aa4d3c0d813d1","7d932b23e1c84326ae5aa4d3c0d813d1",22857219,1,0,1,561,188,188,0
"7d932b23e1c84326ae5aa4d3c0d813d1","c8e371568a0c4391b25796ae4e91952e",22857219,1,-2,0,562,188,186,-2
"c8e371568a0c4391b25796ae4e91952e","ab11d94c6c8948ea90b88f19d2cd502b",22857219,1,5,0,563,186,190,4
"ab11d94c6c8948ea90b88f19d2cd502b","ab11d94c6c8948ea90b88f19d2cd502b",22857219,2,0,1,564,190,190,0
"ab11d94c6c8948ea90b88f19d2cd502b","f992451ed6ad4e68bb9e68ad6be7c4be",22857219,1,2,0,566,190,192,2
"f992451ed6ad4e68bb9e68ad6be7c4be","f992451ed6ad4e68bb9e68ad6be7c4be",22857219,1,0,1,567,192,192,0
"f992451ed6ad4e68bb9e68ad6be7c4be","07b44a7a51e94c78b411c753fc39dab0",22857219,1,-3,0,568,192,189,-3
"07b44a7a51e94c78b411c753fc39dab0","6cd2dcaac46847d4a0bc53f296d90375",22857219,1,6,0,569,189,194,5
"6cd2dcaac46847d4a0bc53f296d90375","6cd2dcaac46847d4a0bc53f296d90375",22857219,2,0,1,570,194,194,0
"6cd2dcaac46847d4a0bc53f296d90375","2d2580c9411c4972909db508d6956a58",22857219,1,2,0,572,194,196,2
"2d2580c9411c4972909db508d6956a58","2d2580c9411c4972909db508d6956a58",22857219,2,0,1,573,196,196,0
"2d2580c9411c4972909db508d6956a58","5bddb3d9ed264f3984702f048c7e5340",22857219,1,1,0,575,196,197,1
"5bddb3d9ed264f3984702f048c7e5340","5bddb3d9ed264f3984702f048c7e5340",22857219,2,0,1,576,197,197,0
"5bddb3d9ed264f3984702f048c7e5340","d5e8e2bd12a2466b9d6d90855f0eb079",22857219,1,1,0,578,197,198,1
"d5e8e2bd12a2466b9d6d90855f0eb079","d5e8e2bd12a2466b9d6d90855f0eb079",22857219,2,0,1,579,198,198,0
"d5e8e2bd12a2466b9d6d90855f0eb079","017d7ca8e0394b91aaadc9574df2202c",22857219,1,-5,0,581,198,193,-5
"017d7ca8e0394b91aaadc9574df2202c","54e8e9f0ea3e45c4bf3b8ac799ee31b1",22857219,1,8,0,582,193,200,7
"54e8e9f0ea3e45c4bf3b8ac799ee31b1","54e8e9f0ea3e45c4bf3b8ac799ee31b1",22857219,1,0,1,583,200,200,0
"54e8e9f0ea3e45c4bf3b8ac799ee31b1","c614a00911be4877a075f19315530fb0",22857219,1,1,0,584,200,201,1
"c614a00911be4877a075f19315530fb0","c614a00911be4877a075f19315530fb0",22857219,6,0,1,585,201,201,0
"c614a00911be4877a075f19315530fb0","a6c21bd8b95249c7972820a7a7d76aff",22857219,1,1,0,591,201,202,1
"a6c21bd8b95249c7972820a7a7d76aff","a6c21bd8b95249c7972820a7a7d76aff",22857219,1,0,1,592,202,202,0
"a6c21bd8b95249c7972820a7a7d76aff","bb329d880ab54120adaf203a693bb203",22857219,1,1,0,593,202,203,1
"bb329d880ab54120adaf203a693bb203","bb329d880ab54120adaf203a693bb203",22857219,1,0,1,594,203,203,0
"bb329d880ab54120adaf203a693bb203","f9170dd6bc6442b4acd832747609b09a",22857219,1,-4,0,595,203,199,-4
"f9170dd6bc6442b4acd832747609b09a","334c2344009840079b1d0e1b7ce3d5a7",22857219,1,7,0,596,199,205,6
"334c2344009840079b1d0e1b7ce3d5a7","334c2344009840079b1d0e1b7ce3d5a7",22857219,1,0,1,597,205,205,0
"334c2344009840079b1d0e1b7ce3d5a7","d7f13c8d63ec4e2aa673fbb9cf9c6933",22857219,1,3,0,598,205,206,1
"d7f13c8d63ec4e2aa673fbb9cf9c6933","c8e371568a0c4391b25796ae4e91952e",22857219,1,-26,0,599,206,186,-20
"c8e371568a0c4391b25796ae4e91952e","b9e80f77c3a44349863b19875725c384",22857219,1,27,0,600,186,207,21
"b9e80f77c3a44349863b19875725c384","7108f0e4c2584f1f9c471689ae4c885c",22857219,2,1,0,601,207,208,1
"7108f0e4c2584f1f9c471689ae4c885c","b9e80f77c3a44349863b19875725c384",22857219,1,-1,0,602,208,207,-1
"b9e80f77c3a44349863b19875725c384","b9e80f77c3a44349863b19875725c384",22857219,12,0,1,603,207,207,0
"7108f0e4c2584f1f9c471689ae4c885c","7108f0e4c2584f1f9c471689ae4c885c",22857219,13,0,1,616,208,208,0
"7108f0e4c2584f1f9c471689ae4c885c","09400e101c5d4b439cf9a26b03aae558",22857219,1,3,0,629,208,210,2
"09400e101c5d4b439cf9a26b03aae558","d7f13c8d63ec4e2aa673fbb9cf9c6933",22857219,1,-5,0,630,210,206,-4
"d7f13c8d63ec4e2aa673fbb9cf9c6933","09400e101c5d4b439cf9a26b03aae558",22857219,1,5,0,631,206,210,4
"09400e101c5d4b439cf9a26b03aae558","09400e101c5d4b439cf9a26b03aae558",22857219,1,0,1,632,210,210,0
"09400e101c5d4b439cf9a26b03aae558","a88efa7e50ce47159810ab553afa6d3a",22857219,1,2,0,633,210,212,2
"a88efa7e50ce47159810ab553afa6d3a","a88efa7e50ce47159810ab553afa6d3a",22857219,2,0,1,634,212,212,0
"a88efa7e50ce47159810ab553afa6d3a","a875096404ef4a9984b62d74cda916f9",22857219,1,-3,0,636,212,209,-3
"a875096404ef4a9984b62d74cda916f9","be502a7a43c44bf7b682698de79d9369",22857219,1,6,0,637,209,214,5
"be502a7a43c44bf7b682698de79d9369","f7fb1952f56b4189b86a9f8b7862d2b8",22857219,2,1,0,638,214,215,1
"f7fb1952f56b4189b86a9f8b7862d2b8","be502a7a43c44bf7b682698de79d9369",22857219,1,-1,0,639,215,214,-1
"be502a7a43c44bf7b682698de79d9369","be502a7a43c44bf7b682698de79d9369",22857219,1,0,1,640,214,214,0
"f7fb1952f56b4189b86a9f8b7862d2b8","f7fb1952f56b4189b86a9f8b7862d2b8",22857219,13,0,1,642,215,215,0
"f7fb1952f56b4189b86a9f8b7862d2b8","b860ee85d8bc4a2f97958cfb71be3533",22857219,1,1,0,655,215,216,1
"b860ee85d8bc4a2f97958cfb71be3533","b860ee85d8bc4a2f97958cfb71be3533",22857219,2,0,1,656,216,216,0
"b860ee85d8bc4a2f97958cfb71be3533","ec341f459285443b8361f7f15638ff08",22857219,1,-3,0,658,216,213,-3
"ec341f459285443b8361f7f15638ff08","363837c182e04711840d896ae1e0339c",22857219,1,6,0,659,213,218,5
"363837c182e04711840d896ae1e0339c","363837c182e04711840d896ae1e0339c",22857219,14,0,1,660,218,218,0
"363837c182e04711840d896ae1e0339c","01b2051f8941460d89945e3b02d1ce78",22857219,1,-1,0,674,218,217,-1
"01b2051f8941460d89945e3b02d1ce78","91125ca626c5470eb145501f8c37f8db",22857219,1,4,0,675,217,220,3
"91125ca626c5470eb145501f8c37f8db","91125ca626c5470eb145501f8c37f8db",22857219,1,0,1,676,220,220,0
"91125ca626c5470eb145501f8c37f8db","1c6721b1f63f4d30ba7746ea8af02a52",22857219,1,3,0,677,220,221,1
"1c6721b1f63f4d30ba7746ea8af02a52","d7f13c8d63ec4e2aa673fbb9cf9c6933",22857219,1,-21,0,678,221,206,-15
"d7f13c8d63ec4e2aa673fbb9cf9c6933","77ecef8eff6b4a2caea7707669bf7475",22857219,1,22,0,679,206,222,16
"77ecef8eff6b4a2caea7707669bf7475","77ecef8eff6b4a2caea7707669bf7475",22857219,12,0,1,680,222,222,0
"77ecef8eff6b4a2caea7707669bf7475","1c6721b1f63f4d30ba7746ea8af02a52",22857219,1,-1,0,692,222,221,-1
"1c6721b1f63f4d30ba7746ea8af02a52","8b9ae98743bd4d4a8a87dff1c1244211",22857219,1,7,0,693,221,227,6
"8b9ae98743bd4d4a8a87dff1c1244211","d03cb855c70044cf8c35d9ec0de696e3",22857219,1,-3,0,694,227,224,-3
"d03cb855c70044cf8c35d9ec0de696e3","d03cb855c70044cf8c35d9ec0de696e3",22857219,2,0,1,695,224,224,0
"d03cb855c70044cf8c35d9ec0de696e3","a49a937d6896486d9a5396654abcf2e1",22857219,1,2,0,697,224,226,2
"a49a937d6896486d9a5396654abcf2e1","a49a937d6896486d9a5396654abcf2e1",22857219,3,0,1,698,226,226,0
"a49a937d6896486d9a5396654abcf2e1","8b9ae98743bd4d4a8a87dff1c1244211",22857219,1,1,0,701,226,227,1
"8b9ae98743bd4d4a8a87dff1c1244211","8b9ae98743bd4d4a8a87dff1c1244211",22857219,19,0,1,702,227,227,0
"8b9ae98743bd4d4a8a87dff1c1244211","f7906d6f59b9489a91d2ef40db5a474d",22857219,1,-4,0,721,227,223,-4
"f7906d6f59b9489a91d2ef40db5a474d","2ab1535aac1346ba8801535bf729ef37",22857219,1,7,0,722,223,229,6
"2ab1535aac1346ba8801535bf729ef37","2ab1535aac1346ba8801535bf729ef37",22857219,2,0,1,723,229,229,0
"2ab1535aac1346ba8801535bf729ef37","a4f40fb48a8542c8949bae1f002cd9bc",22857219,1,2,0,725,229,231,2
"a4f40fb48a8542c8949bae1f002cd9bc","a4f40fb48a8542c8949bae1f002cd9bc",22857219,5,0,1,726,231,231,0
"a4f40fb48a8542c8949bae1f002cd9bc","8972c23e32044edb8a78fa1eed4e5947",22857219,1,1,0,731,231,232,1
"8972c23e32044edb8a78fa1eed4e5947","8972c23e32044edb8a78fa1eed4e5947",22857219,1,0,1,732,232,232,0
"8972c23e32044edb8a78fa1eed4e5947","92feb4a40f8344d38b6f722e42a53295",22857219,1,1,0,733,232,233,1
"92feb4a40f8344d38b6f722e42a53295","92feb4a40f8344d38b6f722e42a53295",22857219,2,0,1,734,233,233,0
"92feb4a40f8344d38b6f722e42a53295","5152833676bf4c6cb317060be10f68db",22857219,1,-5,0,736,233,228,-5
"5152833676bf4c6cb317060be10f68db","ca3e28f290354c08aefe5b0f769604e6",22857219,1,8,0,737,228,235,7
"ca3e28f290354c08aefe5b0f769604e6","ca3e28f290354c08aefe5b0f769604e6",22857219,9,0,1,738,235,235,0
"ca3e28f290354c08aefe5b0f769604e6","79a35eea833e4c2c9d22fc53c3c6445c",22857219,1,1,0,747,235,236,1
"79a35eea833e4c2c9d22fc53c3c6445c","79a35eea833e4c2c9d22fc53c3c6445c",22857219,4,0,1,748,236,236,0
"79a35eea833e4c2c9d22fc53c3c6445c","8f68228b1518449e9615cdafee41a2bd",22857219,1,1,0,752,236,237,1
"8f68228b1518449e9615cdafee41a2bd","8f68228b1518449e9615cdafee41a2bd",22857219,1,0,1,753,237,237,0
"8f68228b1518449e9615cdafee41a2bd","cab89fa5c3ed45a5aa550fc0352d6a42",22857219,1,1,0,754,237,238,1
"cab89fa5c3ed45a5aa550fc0352d6a42","cab89fa5c3ed45a5aa550fc0352d6a42",22857219,1,0,1,755,238,238,0
"cab89fa5c3ed45a5aa550fc0352d6a42","66d4fad4f1cf4b46be0750a99ad7a35a",22857219,1,1,0,756,238,239,1
"66d4fad4f1cf4b46be0750a99ad7a35a","66d4fad4f1cf4b46be0750a99ad7a35a",22857219,1,0,1,757,239,239,0
"66d4fad4f1cf4b46be0750a99ad7a35a","0b04c8e2f86d48c7aeb7e225819cd32b",22857219,1,-5,0,758,239,234,-5
"0b04c8e2f86d48c7aeb7e225819cd32b","f53da5fd9bfe412da4b80d4742563b6c",22857219,1,8,0,759,234,241,7
"f53da5fd9bfe412da4b80d4742563b6c","f53da5fd9bfe412da4b80d4742563b6c",22857219,1,0,1,760,241,241,0
"f53da5fd9bfe412da4b80d4742563b6c","1c6721b1f63f4d30ba7746ea8af02a52",22857219,1,-24,0,761,241,221,-20
"1c6721b1f63f4d30ba7746ea8af02a52","2ae94c0cea4d480a9d5dca8fb1d7b542",22857219,1,27,0,762,221,242,21
"2ae94c0cea4d480a9d5dca8fb1d7b542","1ebf23f9d994469a85206e4c7b1bf5f5",22857219,1,3,0,763,242,245,3
"1ebf23f9d994469a85206e4c7b1bf5f5","1ebf23f9d994469a85206e4c7b1bf5f5",22857219,11,0,1,764,245,245,0
"1ebf23f9d994469a85206e4c7b1bf5f5","85ae675b83e8422da842cfd25596af99",22857219,1,1,0,775,245,246,1
"85ae675b83e8422da842cfd25596af99","85ae675b83e8422da842cfd25596af99",22857219,1,0,1,776,246,246,0
"85ae675b83e8422da842cfd25596af99","2ae94c0cea4d480a9d5dca8fb1d7b542",22857219,1,-4,0,777,246,242,-4
"2ae94c0cea4d480a9d5dca8fb1d7b542","fa235f0f364d47e4ae1c87f47bf8e6ba",22857219,1,12,0,778,242,252,10
"fa235f0f364d47e4ae1c87f47bf8e6ba","fa235f0f364d47e4ae1c87f47bf8e6ba",22857219,2,0,1,779,252,252,0
"fa235f0f364d47e4ae1c87f47bf8e6ba","79f7845465cc4ed19d8e4f1429541be0",22857219,1,2,0,781,252,254,2
"79f7845465cc4ed19d8e4f1429541be0","79f7845465cc4ed19d8e4f1429541be0",22857219,2,0,1,782,254,254,0
"79f7845465cc4ed19d8e4f1429541be0","6e83e23f56544a19b94067c1c558d9c0",22857219,1,-8,0,784,254,247,-7
"6e83e23f56544a19b94067c1c558d9c0","00f61990949545828dd12f1303d47504",22857219,1,11,0,785,247,256,9
"00f61990949545828dd12f1303d47504","00f61990949545828dd12f1303d47504",22857219,2,0,1,786,256,256,0
"00f61990949545828dd12f1303d47504","ead7bb4b64e247d2ae632ab8a296b091",22857219,1,2,0,788,256,258,2
"ead7bb4b64e247d2ae632ab8a296b091","ead7bb4b64e247d2ae632ab8a296b091",22857219,2,0,1,789,258,258,0
"ead7bb4b64e247d2ae632ab8a296b091","41b0048dde734bb280bac6116baa8e27",22857219,1,1,0,791,258,259,1
"41b0048dde734bb280bac6116baa8e27","41b0048dde734bb280bac6116baa8e27",22857219,2,0,1,792,259,259,0
"41b0048dde734bb280bac6116baa8e27","b41c5a094a604ee0915327da5cc0beb7",22857219,1,1,0,794,259,260,1
"b41c5a094a604ee0915327da5cc0beb7","b41c5a094a604ee0915327da5cc0beb7",22857219,2,0,1,795,260,260,0
"b41c5a094a604ee0915327da5cc0beb7","d546341988904f069cfa86b21457d9d9",22857219,1,-10,0,797,260,251,-9
"d546341988904f069cfa86b21457d9d9","28c171777c52431ab6b925073bd63d46",22857219,1,15,0,798,251,264,13
"28c171777c52431ab6b925073bd63d46","28c171777c52431ab6b925073bd63d46",22857219,7,0,1,799,264,264,0
"28c171777c52431ab6b925073bd63d46","ac160db940cb49ae8579162b1d52bb5d",22857219,1,2,0,806,264,266,2
"ac160db940cb49ae8579162b1d52bb5d","ac160db940cb49ae8579162b1d52bb5d",22857219,7,0,1,807,266,266,0
"ac160db940cb49ae8579162b1d52bb5d","d989ebcfc12a4b669f0100dc1aa14f1e",22857219,1,-12,0,814,266,255,-11
"d989ebcfc12a4b669f0100dc1aa14f1e","c6fd49b485cc4874b0bbdd9c6171e09c",22857219,1,15,0,815,255,268,13
"c6fd49b485cc4874b0bbdd9c6171e09c","c6fd49b485cc4874b0bbdd9c6171e09c",22857219,3,0,1,816,268,268,0
"c6fd49b485cc4874b0bbdd9c6171e09c","44240778a97c4af0937817499b75707b",22857219,1,1,0,819,268,269,1
"44240778a97c4af0937817499b75707b","44240778a97c4af0937817499b75707b",22857219,2,0,1,820,269,269,0
"44240778a97c4af0937817499b75707b","7aa76d3e993840d8805f097cbdbcd44b",22857219,1,-9,0,822,269,261,-8
"7aa76d3e993840d8805f097cbdbcd44b","865a4d3b43374da7944dc7d397f566d9",22857219,1,12,0,823,261,271,10
"865a4d3b43374da7944dc7d397f566d9","865a4d3b43374da7944dc7d397f566d9",22857219,1,0,1,824,271,271,0
"865a4d3b43374da7944dc7d397f566d9","0d987bed3ffa4ed0b9a2e62e97b7b30f",22857219,1,3,0,825,271,272,1
"0d987bed3ffa4ed0b9a2e62e97b7b30f","2ae94c0cea4d480a9d5dca8fb1d7b542",22857219,1,-38,0,826,272,242,-30
"2ae94c0cea4d480a9d5dca8fb1d7b542","0d987bed3ffa4ed0b9a2e62e97b7b30f",22857219,1,38,0,827,242,272,30
"0d987bed3ffa4ed0b9a2e62e97b7b30f","82ae07bc0c9b4570a41799290d1ef399",22857219,1,4,0,828,272,275,3
"82ae07bc0c9b4570a41799290d1ef399","bb5a47f5ea01454a8b79455422d3b9da",22857219,4,6,0,829,275,280,5
"bb5a47f5ea01454a8b79455422d3b9da","bb5a47f5ea01454a8b79455422d3b9da",22857219,103,0,1,830,280,280,0
"bb5a47f5ea01454a8b79455422d3b9da","bc5524e78a8544e2ae2fdc2f3462bbec",22857219,3,-1,0,837,280,279,-1
"bc5524e78a8544e2ae2fdc2f3462bbec","bb5a47f5ea01454a8b79455422d3b9da",22857219,2,1,0,838,279,280,1
"bb5a47f5ea01454a8b79455422d3b9da","82ae07bc0c9b4570a41799290d1ef399",22857219,2,-6,0,841,280,275,-5
"bb5a47f5ea01454a8b79455422d3b9da","0d987bed3ffa4ed0b9a2e62e97b7b30f",22857219,2,-10,0,847,280,272,-8
"0d987bed3ffa4ed0b9a2e62e97b7b30f","bb5a47f5ea01454a8b79455422d3b9da",22857219,3,10,0,848,272,280,8
"bc5524e78a8544e2ae2fdc2f3462bbec","82ae07bc0c9b4570a41799290d1ef399",22857219,1,-5,0,873,279,275,-4
"bb5a47f5ea01454a8b79455422d3b9da","0c7262dff33c4087bc660ccf40f92f9c",22857219,1,-145,0,882,280,169,-111
"0c7262dff33c4087bc660ccf40f92f9c","bc5524e78a8544e2ae2fdc2f3462bbec",22857219,1,144,0,883,169,279,110
"bc5524e78a8544e2ae2fdc2f3462bbec","0d987bed3ffa4ed0b9a2e62e97b7b30f",22857219,1,-9,0,884,279,272,-7
"bb5a47f5ea01454a8b79455422d3b9da","94cecc3f1e7d484b8e068e79241dfd73",22857219,1,3,0,941,280,281,1
"94cecc3f1e7d484b8e068e79241dfd73","0d987bed3ffa4ed0b9a2e62e97b7b30f",22857219,1,-13,0,942,281,272,-9
"0d987bed3ffa4ed0b9a2e62e97b7b30f","a37477c4e4c14169ad44b06b493007f6",22857219,1,15,0,943,272,283,11
"a37477c4e4c14169ad44b06b493007f6","94cecc3f1e7d484b8e068e79241dfd73",22857219,2,-2,0,944,283,281,-2
"94cecc3f1e7d484b8e068e79241dfd73","fab84b4fab5940efb4ea868ef8d09396",22857219,2,5,0,945,281,284,3
"fab84b4fab5940efb4ea868ef8d09396","4a29443515bb404cb8924e1c60a63b73",22857219,2,4,0,946,284,285,1
"4a29443515bb404cb8924e1c60a63b73","fab84b4fab5940efb4ea868ef8d09396",22857219,1,-4,0,947,285,284,-1
"fab84b4fab5940efb4ea868ef8d09396","208c9b2796c944db8dacaa96082520ea",22857219,1,7,0,948,284,288,4
"208c9b2796c944db8dacaa96082520ea","0d987bed3ffa4ed0b9a2e62e97b7b30f",22857219,1,-25,0,949,288,272,-16
"0d987bed3ffa4ed0b9a2e62e97b7b30f","94cecc3f1e7d484b8e068e79241dfd73",22857219,1,13,0,961,272,281,9
"94cecc3f1e7d484b8e068e79241dfd73","a37477c4e4c14169ad44b06b493007f6",22857219,1,2,0,962,281,283,2
"fab84b4fab5940efb4ea868ef8d09396","fab84b4fab5940efb4ea868ef8d09396",22857219,1,0,1,965,284,284,0
"4a29443515bb404cb8924e1c60a63b73","208c9b2796c944db8dacaa96082520ea",22857219,1,3,0,967,285,288,3
"208c9b2796c944db8dacaa96082520ea","208c9b2796c944db8dacaa96082520ea",22857219,3,0,1,968,288,288,0
"208c9b2796c944db8dacaa96082520ea","4a29443515bb404cb8924e1c60a63b73",22857219,1,-3,0,971,288,285,-3
"4a29443515bb404cb8924e1c60a63b73","7669a956527947d0add87455277e80b4",22857219,1,7,0,972,285,291,6
"7669a956527947d0add87455277e80b4","7669a956527947d0add87455277e80b4",22857219,1,0,1,973,291,291,0
"7669a956527947d0add87455277e80b4","6a9a3b5bde4a48daa896fe8c06eca56f",22857219,1,-2,0,974,291,289,-2
"6a9a3b5bde4a48daa896fe8c06eca56f","869e967078f04da18dd0b0b9389a7424",22857219,1,5,0,975,289,293,4
"869e967078f04da18dd0b0b9389a7424","869e967078f04da18dd0b0b9389a7424",22857219,4,0,1,976,293,293,0
"869e967078f04da18dd0b0b9389a7424","51ab6291537748fab90d519aa09889d6",22857219,1,2,0,980,293,295,2
"51ab6291537748fab90d519aa09889d6","51ab6291537748fab90d519aa09889d6",22857219,5,0,1,981,295,295,0
"51ab6291537748fab90d519aa09889d6","34a6e49023fc4465bd5ca604330bbd1c",22857219,1,-3,0,986,295,292,-3
"34a6e49023fc4465bd5ca604330bbd1c","21592f2a9e9c4b2f8c66ec5dbcbf6a2b",22857219,1,5,0,987,292,296,4
"21592f2a9e9c4b2f8c66ec5dbcbf6a2b","ba0e59461bfb4a44b7b1c28a01f8d3b3",22857219,2,4,0,988,296,299,3
"ba0e59461bfb4a44b7b1c28a01f8d3b3","7646a919d7e64fa990bca9b024ff089d",22857219,1,-1,0,989,299,298,-1
"7646a919d7e64fa990bca9b024ff089d","21592f2a9e9c4b2f8c66ec5dbcbf6a2b",22857219,1,-3,0,990,298,296,-2
"ba0e59461bfb4a44b7b1c28a01f8d3b3","ba0e59461bfb4a44b7b1c28a01f8d3b3",22857219,1,0,1,992,299,299,0
"ba0e59461bfb4a44b7b1c28a01f8d3b3","0e0b36e731a645e7b1b8a88f5031ca38",22857219,1,2,0,993,299,301,2
"0e0b36e731a645e7b1b8a88f5031ca38","0e0b36e731a645e7b1b8a88f5031ca38",22857219,2,0,1,994,301,301,0
"0e0b36e731a645e7b1b8a88f5031ca38","a66a144637284c21afc6de17fea4bfb8",22857219,1,1,0,996,301,302,1
"a66a144637284c21afc6de17fea4bfb8","a66a144637284c21afc6de17fea4bfb8",22857219,2,0,1,997,302,302,0
"a66a144637284c21afc6de17fea4bfb8","7646a919d7e64fa990bca9b024ff089d",22857219,1,-4,0,999,302,298,-4
"7646a919d7e64fa990bca9b024ff089d","e390b575229748ea8aac9364efe2bf00",22857219,1,7,0,1000,298,304,6
"e390b575229748ea8aac9364efe2bf00","e390b575229748ea8aac9364efe2bf00",22857219,1,0,1,1001,304,304,0
"e390b575229748ea8aac9364efe2bf00","4a29443515bb404cb8924e1c60a63b73",22857219,1,-24,0,1002,304,285,-19
"4a29443515bb404cb8924e1c60a63b73","3434c10e561d488a914e0f7d71907abd",22857219,1,27,0,1003,285,305,20
"3434c10e561d488a914e0f7d71907abd","53e7e900392747ccad52e711ab0f80d8",22857219,1,2,0,1004,305,307,2
"53e7e900392747ccad52e711ab0f80d8","53e7e900392747ccad52e711ab0f80d8",22857219,3,0,1,1005,307,307,0
"53e7e900392747ccad52e711ab0f80d8","3434c10e561d488a914e0f7d71907abd",22857219,1,-2,0,1008,307,305,-2
"3434c10e561d488a914e0f7d71907abd","130acc2aeb0448fdbb2de63bc5cebe5b",22857219,1,5,0,1009,305,309,4
"130acc2aeb0448fdbb2de63bc5cebe5b","130acc2aeb0448fdbb2de63bc5cebe5b",22857219,5,0,1,1010,309,309,0
"130acc2aeb0448fdbb2de63bc5cebe5b","9c062b3251034ebe90f5054e2a3b5120",22857219,1,2,0,1015,309,311,2
"9c062b3251034ebe90f5054e2a3b5120","9c062b3251034ebe90f5054e2a3b5120",22857219,2,0,1,1016,311,311,0
"9c062b3251034ebe90f5054e2a3b5120","ea859f8207e44537889daeaba13ac2e8",22857219,1,1,0,1018,311,312,1
"ea859f8207e44537889daeaba13ac2e8","ea859f8207e44537889daeaba13ac2e8",22857219,1,0,1,1019,312,312,0
"ea859f8207e44537889daeaba13ac2e8","56d94971a7a94257aa330183a8ebd0ea",22857219,1,1,0,1020,312,313,1
"56d94971a7a94257aa330183a8ebd0ea","56d94971a7a94257aa330183a8ebd0ea",22857219,1,0,1,1021,313,313,0
"56d94971a7a94257aa330183a8ebd0ea","141c0df6cd1946539aadd1c9b7068cd4",22857219,1,-5,0,1022,313,308,-5
"141c0df6cd1946539aadd1c9b7068cd4","13255e63e0aa4abf85e5211bf613d43e",22857219,1,10,0,1023,308,317,9
"13255e63e0aa4abf85e5211bf613d43e","13255e63e0aa4abf85e5211bf613d43e",22857219,1,0,1,1024,317,317,0
"13255e63e0aa4abf85e5211bf613d43e","0c787d16c9504873b1a4d903cec09948",22857219,1,-3,0,1025,317,314,-3
"0c787d16c9504873b1a4d903cec09948","86c27d40179e419c8e9d150fb6afa5d0",22857219,1,6,0,1026,314,319,5
"86c27d40179e419c8e9d150fb6afa5d0","86c27d40179e419c8e9d150fb6afa5d0",22857219,2,0,1,1027,319,319,0
"86c27d40179e419c8e9d150fb6afa5d0","47edbb64109243e6b0f8f64cdef90c6c",22857219,1,8,0,1029,319,326,7
"47edbb64109243e6b0f8f64cdef90c6c","8d7e0b55cf9849cda222a0f2440cec55",22857219,1,-9,0,1030,326,318,-8
"8d7e0b55cf9849cda222a0f2440cec55","24f1363179ad4aaa965484a78471912b",22857219,1,6,0,1031,318,323,5
"24f1363179ad4aaa965484a78471912b","24f1363179ad4aaa965484a78471912b",22857219,4,0,1,1032,323,323,0
"24f1363179ad4aaa965484a78471912b","3628bdce1dd2429ba924d2d4d09448d2",22857219,1,-1,0,1036,323,322,-1
"3628bdce1dd2429ba924d2d4d09448d2","56b3fd1a212a4764be39d979fde3326e",22857219,1,7,0,1037,322,328,6
"56b3fd1a212a4764be39d979fde3326e","56b3fd1a212a4764be39d979fde3326e",22857219,1,0,1,1038,328,328,0
"56b3fd1a212a4764be39d979fde3326e","0c4079457ede49e3aeb5e86ed84bdf35",22857219,1,3,0,1039,328,329,1
"0c4079457ede49e3aeb5e86ed84bdf35","3434c10e561d488a914e0f7d71907abd",22857219,1,-31,0,1040,329,305,-24
"3434c10e561d488a914e0f7d71907abd","38aea304b4fa46e1b29bb72f5cea4c93",22857219,1,33,0,1041,305,331,26
"38aea304b4fa46e1b29bb72f5cea4c93","38aea304b4fa46e1b29bb72f5cea4c93",22857219,10,0,1,1042,331,331,0
"38aea304b4fa46e1b29bb72f5cea4c93","0c4079457ede49e3aeb5e86ed84bdf35",22857219,2,-2,0,1045,331,329,-2
"0c4079457ede49e3aeb5e86ed84bdf35","38aea304b4fa46e1b29bb72f5cea4c93",22857219,2,2,0,1046,329,331,2
"38aea304b4fa46e1b29bb72f5cea4c93","e36d261332f14e79bb4b467aceaeb9b5",22857219,1,2,0,1056,331,333,2
"e36d261332f14e79bb4b467aceaeb9b5","e36d261332f14e79bb4b467aceaeb9b5",22857219,1,0,1,1057,333,333,0
"e36d261332f14e79bb4b467aceaeb9b5","c7e89b9d04744d2eab742fc24e3ef1ae",22857219,1,1,0,1058,333,334,1
"c7e89b9d04744d2eab742fc24e3ef1ae","c7e89b9d04744d2eab742fc24e3ef1ae",22857219,2,0,1,1059,334,334,0
"c7e89b9d04744d2eab742fc24e3ef1ae","fe49f8054b374a0ea4bb266ed135ff62",22857219,1,1,0,1061,334,335,1
"fe49f8054b374a0ea4bb266ed135ff62","fe49f8054b374a0ea4bb266ed135ff62",22857219,2,0,1,1062,335,335,0
"fe49f8054b374a0ea4bb266ed135ff62","d0a8f74af98642fe8360d22c42e45117",22857219,1,1,0,1064,335,336,1
"d0a8f74af98642fe8360d22c42e45117","d0a8f74af98642fe8360d22c42e45117",22857219,2,0,1,1065,336,336,0
"d0a8f74af98642fe8360d22c42e45117","0c4079457ede49e3aeb5e86ed84bdf35",22857219,1,-7,0,1067,336,329,-7
"0c4079457ede49e3aeb5e86ed84bdf35","a7c6339ca1da4368a18d471f0519f877",22857219,1,11,0,1068,329,339,10
"a7c6339ca1da4368a18d471f0519f877","a7c6339ca1da4368a18d471f0519f877",22857219,1,0,1,1069,339,339,0
"a7c6339ca1da4368a18d471f0519f877","bbc5139ca9024389a94db3a6f47dcff6",22857219,1,3,0,1070,339,341,2
"bbc5139ca9024389a94db3a6f47dcff6","b8b9418ab322418d9db9b40d96af873a",22857219,1,-5,0,1071,341,337,-4
"b8b9418ab322418d9db9b40d96af873a","bbc5139ca9024389a94db3a6f47dcff6",22857219,1,5,0,1072,337,341,4
"bbc5139ca9024389a94db3a6f47dcff6","bbc5139ca9024389a94db3a6f47dcff6",22857219,4,0,1,1073,341,341,0
"bbc5139ca9024389a94db3a6f47dcff6","4ee6ca9019ab4a1ab323f98094a9bd77",22857219,1,2,0,1077,341,343,2
"4ee6ca9019ab4a1ab323f98094a9bd77","4ee6ca9019ab4a1ab323f98094a9bd77",22857219,2,0,1,1078,343,343,0
"4ee6ca9019ab4a1ab323f98094a9bd77","b37947176785476f8b29d49a851366dc",22857219,1,1,0,1080,343,344,1
"b37947176785476f8b29d49a851366dc","b37947176785476f8b29d49a851366dc",22857219,2,0,1,1081,344,344,0
"b37947176785476f8b29d49a851366dc","fcea5b10d5a14a3b9324ffece8f6e1e5",22857219,1,1,0,1083,344,345,1
"fcea5b10d5a14a3b9324ffece8f6e1e5","fcea5b10d5a14a3b9324ffece8f6e1e5",22857219,5,0,1,1084,345,345,0
"fcea5b10d5a14a3b9324ffece8f6e1e5","c2490bc612d146edbe786556fab3651b",22857219,1,-5,0,1089,345,340,-5
"c2490bc612d146edbe786556fab3651b","6ac8bb048b854999a47edb35fe627f11",22857219,1,8,0,1090,340,347,7
"6ac8bb048b854999a47edb35fe627f11","6ac8bb048b854999a47edb35fe627f11",22857219,1,0,1,1091,347,347,0
"6ac8bb048b854999a47edb35fe627f11","0c4079457ede49e3aeb5e86ed84bdf35",22857219,1,-21,0,1092,347,329,-18
"0c4079457ede49e3aeb5e86ed84bdf35","30ead9794d4847abaf222ca966cc8630",22857219,1,24,0,1093,329,348,19
"30ead9794d4847abaf222ca966cc8630","897b7f51242c44aab2205c72fdcbf4cd",22857219,1,4,0,1094,348,352,4
"897b7f51242c44aab2205c72fdcbf4cd","eff0de7f2dbb42dfa1a2e686efab5b6d",22857219,1,2,0,1095,352,354,2
"eff0de7f2dbb42dfa1a2e686efab5b6d","09b9678ddc3d452ea4a3d46e15826065",22857219,1,-1,0,1096,354,353,-1
"09b9678ddc3d452ea4a3d46e15826065","c20993c944444fe085345591a8bd837e",22857219,1,-2,0,1097,353,351,-2
"c20993c944444fe085345591a8bd837e","c20993c944444fe085345591a8bd837e",22857219,4,0,1,1098,351,351,0
"c20993c944444fe085345591a8bd837e","897b7f51242c44aab2205c72fdcbf4cd",22857219,1,1,0,1102,351,352,1
"897b7f51242c44aab2205c72fdcbf4cd","897b7f51242c44aab2205c72fdcbf4cd",22857219,3,0,1,1103,352,352,0
"897b7f51242c44aab2205c72fdcbf4cd","09b9678ddc3d452ea4a3d46e15826065",22857219,1,1,0,1106,352,353,1
"09b9678ddc3d452ea4a3d46e15826065","09b9678ddc3d452ea4a3d46e15826065",22857219,3,0,1,1107,353,353,0
"09b9678ddc3d452ea4a3d46e15826065","eff0de7f2dbb42dfa1a2e686efab5b6d",22857219,1,1,0,1110,353,354,1
"eff0de7f2dbb42dfa1a2e686efab5b6d","eff0de7f2dbb42dfa1a2e686efab5b6d",22857219,3,0,1,1111,354,354,0
"eff0de7f2dbb42dfa1a2e686efab5b6d","2fe14166dc9642c3bc666b86a57f943d",22857219,1,4,0,1114,354,357,3
"2fe14166dc9642c3bc666b86a57f943d","30ead9794d4847abaf222ca966cc8630",22857219,1,-10,0,1115,357,348,-9
"30ead9794d4847abaf222ca966cc8630","2fe14166dc9642c3bc666b86a57f943d",22857219,1,10,0,1116,348,357,9
"2fe14166dc9642c3bc666b86a57f943d","2fe14166dc9642c3bc666b86a57f943d",22857219,4,0,1,1117,357,357,0
"2fe14166dc9642c3bc666b86a57f943d","44421dd1e13a47a388c4a19834b744c7",22857219,1,2,0,1121,357,359,2
"44421dd1e13a47a388c4a19834b744c7","44421dd1e13a47a388c4a19834b744c7",22857219,2,0,1,1122,359,359,0
"44421dd1e13a47a388c4a19834b744c7","cb5fc7ef85d547c4be1a7439d0bf6052",22857219,1,1,0,1124,359,360,1
"cb5fc7ef85d547c4be1a7439d0bf6052","cb5fc7ef85d547c4be1a7439d0bf6052",22857219,2,0,1,1125,360,360,0
"cb5fc7ef85d547c4be1a7439d0bf6052","0a8f150a4cf747acbde62f4721823da3",22857219,1,1,0,1127,360,361,1
"0a8f150a4cf747acbde62f4721823da3","0a8f150a4cf747acbde62f4721823da3",22857219,2,0,1,1128,361,361,0
"0a8f150a4cf747acbde62f4721823da3","ab8fdad974ae471f9f24c3f9dd04462e",22857219,1,1,0,1130,361,362,1
"ab8fdad974ae471f9f24c3f9dd04462e","ab8fdad974ae471f9f24c3f9dd04462e",22857219,2,0,1,1131,362,362,0
"ab8fdad974ae471f9f24c3f9dd04462e","1ba8fef685d74a8194b9db252eb704fb",22857219,1,-7,0,1133,362,355,-7
"1ba8fef685d74a8194b9db252eb704fb","52580888dadb4fe3baa795683ea227bd",22857219,1,10,0,1134,355,364,9
"52580888dadb4fe3baa795683ea227bd","f00179e251a045b39c3f7a54f9aa4acc",22857219,2,-1,0,1135,364,363,-1
"f00179e251a045b39c3f7a54f9aa4acc","492a3bc6a1254f23a7998587961b22a4",22857219,2,4,0,1136,363,366,3
"492a3bc6a1254f23a7998587961b22a4","52580888dadb4fe3baa795683ea227bd",22857219,1,-3,0,1137,366,364,-2
"52580888dadb4fe3baa795683ea227bd","072a190fd302456290895f9f04d6940a",22857219,1,2,0,1138,364,365,1
"072a190fd302456290895f9f04d6940a","52580888dadb4fe3baa795683ea227bd",22857219,1,-2,0,1139,365,364,-1
"52580888dadb4fe3baa795683ea227bd","52580888dadb4fe3baa795683ea227bd",22857219,2,0,1,1140,364,364,0
"492a3bc6a1254f23a7998587961b22a4","492a3bc6a1254f23a7998587961b22a4",22857219,2,0,1,1144,366,366,0
"492a3bc6a1254f23a7998587961b22a4","072a190fd302456290895f9f04d6940a",22857219,1,-1,0,1146,366,365,-1
"072a190fd302456290895f9f04d6940a","cfa457d1743848e4bb5e4beced6448ed",22857219,1,5,0,1147,365,369,4
"cfa457d1743848e4bb5e4beced6448ed","cfa457d1743848e4bb5e4beced6448ed",22857219,1,0,1,1148,369,369,0
"cfa457d1743848e4bb5e4beced6448ed","b71bac264efb4abd97015447bd490db6",22857219,1,3,0,1149,369,370,1
"b71bac264efb4abd97015447bd490db6","30ead9794d4847abaf222ca966cc8630",22857219,1,-28,0,1150,370,348,-22
"30ead9794d4847abaf222ca966cc8630","b71bac264efb4abd97015447bd490db6",22857219,1,28,0,1151,348,370,22
"b71bac264efb4abd97015447bd490db6","8d448d625b024c82a5eb240bbd7431d6",22857219,3,5,0,1152,370,374,4
"8d448d625b024c82a5eb240bbd7431d6","8d448d625b024c82a5eb240bbd7431d6",22857219,58,0,1,1153,374,374,0
"8d448d625b024c82a5eb240bbd7431d6","b71bac264efb4abd97015447bd490db6",22857219,3,-5,0,1158,374,370,-4
"b71bac264efb4abd97015447bd490db6","d6d02b6ef04e4f17805504500b8ce441",22857219,1,8,0,1216,370,375,5
"d6d02b6ef04e4f17805504500b8ce441","d6d02b6ef04e4f17805504500b8ce441",22857219,2,0,1,1217,375,375,0
"d6d02b6ef04e4f17805504500b8ce441","66baf19b6b904b70922329068c63746d",22857219,1,4,0,1219,375,376,1
"66baf19b6b904b70922329068c63746d","7f544639412e40a9ba27f43b415362ab",22857219,1,2,0,1220,376,378,2
"7f544639412e40a9ba27f43b415362ab","7f544639412e40a9ba27f43b415362ab",22857219,4,0,1,1221,378,378,0
"7f544639412e40a9ba27f43b415362ab","d5ae8642e15b46b8bd298b02274d4e9c",22857219,1,2,0,1225,378,380,2
"d5ae8642e15b46b8bd298b02274d4e9c","d5ae8642e15b46b8bd298b02274d4e9c",22857219,1,0,1,1226,380,380,0
"d5ae8642e15b46b8bd298b02274d4e9c","a0d10309a2dd456289147f84be9d37f9",22857219,1,1,0,1227,380,381,1
"a0d10309a2dd456289147f84be9d37f9","a0d10309a2dd456289147f84be9d37f9",22857219,2,0,1,1228,381,381,0
"a0d10309a2dd456289147f84be9d37f9","0fcbc3ca07b144138b8d85da581f09a8",22857219,1,1,0,1230,381,382,1
"0fcbc3ca07b144138b8d85da581f09a8","0fcbc3ca07b144138b8d85da581f09a8",22857219,2,0,1,1231,382,382,0
"0fcbc3ca07b144138b8d85da581f09a8","66baf19b6b904b70922329068c63746d",22857219,1,-6,0,1233,382,376,-6
"66baf19b6b904b70922329068c63746d","c2fca3669923477ab966ded303dea31c",22857219,1,8,0,1234,376,383,7
"c2fca3669923477ab966ded303dea31c","4890121ce5d74576b4632b77cfc23398",22857219,1,6,0,1235,383,388,5
"4890121ce5d74576b4632b77cfc23398","4890121ce5d74576b4632b77cfc23398",22857219,6,0,1,1236,388,388,0
"4890121ce5d74576b4632b77cfc23398","96bb2b3e85a34d8b9544514e89f6fe97",22857219,1,3,0,1242,388,390,2
"96bb2b3e85a34d8b9544514e89f6fe97","18d3b836dd804224883cc9180b60a8e1",22857219,1,-4,0,1243,390,387,-3
"18d3b836dd804224883cc9180b60a8e1","96bb2b3e85a34d8b9544514e89f6fe97",22857219,1,4,0,1244,387,390,3
"96bb2b3e85a34d8b9544514e89f6fe97","96bb2b3e85a34d8b9544514e89f6fe97",22857219,3,0,1,1245,390,390,0
"96bb2b3e85a34d8b9544514e89f6fe97","ac4e9b54acfe4670b4634859c7263cb5",22857219,1,2,0,1248,390,392,2
"ac4e9b54acfe4670b4634859c7263cb5","ac4e9b54acfe4670b4634859c7263cb5",22857219,3,0,1,1249,392,392,0
"ac4e9b54acfe4670b4634859c7263cb5","17f95d18bab743888e1736033dc3384d",22857219,1,-3,0,1252,392,389,-3
"17f95d18bab743888e1736033dc3384d","6f8881a745ac4c358a68b92c3b4abe81",22857219,1,6,0,1253,389,394,5
"6f8881a745ac4c358a68b92c3b4abe81","6f8881a745ac4c358a68b92c3b4abe81",22857219,5,0,1,1254,394,394,0
"6f8881a745ac4c358a68b92c3b4abe81","f7002c8484354eceac57bc7bd62c76c1",22857219,1,-1,0,1259,394,393,-1
"f7002c8484354eceac57bc7bd62c76c1","44a277ea44dc4ae689fab4b82f0b4098",22857219,1,5,0,1260,393,397,4
"44a277ea44dc4ae689fab4b82f0b4098","44a277ea44dc4ae689fab4b82f0b4098",22857219,1,0,1,1261,397,397,0
"44a277ea44dc4ae689fab4b82f0b4098","0c12af0a4e7f4002852cf84b2537c161",22857219,1,-2,0,1262,397,395,-2
"0c12af0a4e7f4002852cf84b2537c161","859e0b8d71694b12befb69ee698138f9",22857219,1,5,0,1263,395,399,4
"859e0b8d71694b12befb69ee698138f9","859e0b8d71694b12befb69ee698138f9",22857219,1,0,1,1264,399,399,0
"859e0b8d71694b12befb69ee698138f9","66baf19b6b904b70922329068c63746d",22857219,1,-29,0,1265,399,376,-23
"66baf19b6b904b70922329068c63746d","2b09a08242b54983aec7063990fb3f66",22857219,1,32,0,1266,376,400,24
"2b09a08242b54983aec7063990fb3f66","2b09a08242b54983aec7063990fb3f66",22857219,7,0,1,1267,400,400,0
"2b09a08242b54983aec7063990fb3f66","1f471b7a883a4df48211e8c6a81b59a7",22857219,1,1,0,1274,400,401,1
"1f471b7a883a4df48211e8c6a81b59a7","1f471b7a883a4df48211e8c6a81b59a7",22857219,1,0,1,1275,401,401,0
"1f471b7a883a4df48211e8c6a81b59a7","2b09a08242b54983aec7063990fb3f66",22857219,1,-1,0,1276,401,400,-1
"2b09a08242b54983aec7063990fb3f66","9de0d567bfa84fe5b77cb76f4a76a5d1",22857219,1,5,0,1277,400,404,4
"9de0d567bfa84fe5b77cb76f4a76a5d1","9de0d567bfa84fe5b77cb76f4a76a5d1",22857219,1,0,1,1278,404,404,0
"9de0d567bfa84fe5b77cb76f4a76a5d1","1157bd665ec4472fb58b751dc5099355",22857219,1,-1,0,1279,404,403,-1
"1157bd665ec4472fb58b751dc5099355","58fc9094275e4c49be3f4ba6d4acc0a4",22857219,1,5,0,1280,403,406,3
"58fc9094275e4c49be3f4ba6d4acc0a4","3c8a22d2f9c146ea956609e3ed4f2559",22857219,2,-2,0,1281,406,405,-1
"3c8a22d2f9c146ea956609e3ed4f2559","58fc9094275e4c49be3f4ba6d4acc0a4",22857219,2,2,0,1282,405,406,1
"58fc9094275e4c49be3f4ba6d4acc0a4","58fc9094275e4c49be3f4ba6d4acc0a4",22857219,2,0,1,1285,406,406,0
"58fc9094275e4c49be3f4ba6d4acc0a4","c1c1be90b2b14c1ab4a5e1ee3c241902",22857219,1,1,0,1287,406,407,1
"c1c1be90b2b14c1ab4a5e1ee3c241902","c1c1be90b2b14c1ab4a5e1ee3c241902",22857219,5,0,1,1288,407,407,0
"c1c1be90b2b14c1ab4a5e1ee3c241902","58fc9094275e4c49be3f4ba6d4acc0a4",22857219,1,-1,0,1293,407,406,-1
"58fc9094275e4c49be3f4ba6d4acc0a4","02b3a1bead9244c1ba2f857c7da8f82a",22857219,1,3,0,1294,406,408,2
"02b3a1bead9244c1ba2f857c7da8f82a","02b3a1bead9244c1ba2f857c7da8f82a",22857219,3,0,1,1295,408,408,0
"02b3a1bead9244c1ba2f857c7da8f82a","6206fc6479014bb193084c32409dc1b9",22857219,1,1,0,1298,408,409,1
"6206fc6479014bb193084c32409dc1b9","6206fc6479014bb193084c32409dc1b9",22857219,1,0,1,1299,409,409,0
"6206fc6479014bb193084c32409dc1b9","02b3a1bead9244c1ba2f857c7da8f82a",22857219,1,-1,0,1300,409,408,-1
"02b3a1bead9244c1ba2f857c7da8f82a","6a5f020451db426dacba9e2ea3fcc62a",22857219,1,3,0,1301,408,410,2
"6a5f020451db426dacba9e2ea3fcc62a","6a5f020451db426dacba9e2ea3fcc62a",22857219,2,0,1,1302,410,410,0
"6a5f020451db426dacba9e2ea3fcc62a","33a9d248b2e44588a5b07fc1342b9bc2",22857219,2,2,0,1304,410,411,1
"33a9d248b2e44588a5b07fc1342b9bc2","6a5f020451db426dacba9e2ea3fcc62a",22857219,1,-2,0,1305,411,410,-1
"33a9d248b2e44588a5b07fc1342b9bc2","33a9d248b2e44588a5b07fc1342b9bc2",22857219,2,0,1,1307,411,411,0
"33a9d248b2e44588a5b07fc1342b9bc2","c6f26bd420634f1cb7989e76fe6b16c0",22857219,1,1,0,1309,411,412,1
"c6f26bd420634f1cb7989e76fe6b16c0","c6f26bd420634f1cb7989e76fe6b16c0",22857219,5,0,1,1310,412,412,0
"c6f26bd420634f1cb7989e76fe6b16c0","2a65ee6e2ac64f6a8a55fbe5373ec763",22857219,1,1,0,1315,412,413,1
"2a65ee6e2ac64f6a8a55fbe5373ec763","2a65ee6e2ac64f6a8a55fbe5373ec763",22857219,2,0,1,1316,413,413,0
"2a65ee6e2ac64f6a8a55fbe5373ec763","33a9d248b2e44588a5b07fc1342b9bc2",22857219,1,-2,0,1318,413,411,-2
"33a9d248b2e44588a5b07fc1342b9bc2","1fd0f6dadbc14ebc965faf6122190b96",22857219,1,5,0,1319,411,415,4
"1fd0f6dadbc14ebc965faf6122190b96","1fd0f6dadbc14ebc965faf6122190b96",22857219,1,0,1,1320,415,415,0
"1fd0f6dadbc14ebc965faf6122190b96","687055dad9fc40c3982478fe33ec01bf",22857219,1,-1,0,1321,415,414,-1
"687055dad9fc40c3982478fe33ec01bf","2add1669f08d4101913db15f8c23b3b7",22857219,1,3,0,1322,414,416,2
"2add1669f08d4101913db15f8c23b3b7","2add1669f08d4101913db15f8c23b3b7",22857219,1,0,1,1323,416,416,0
"2add1669f08d4101913db15f8c23b3b7","a2b4bd40cee2481ebd3fc179d6a5cd62",22857219,1,3,0,1324,416,417,1
"a2b4bd40cee2481ebd3fc179d6a5cd62","2b09a08242b54983aec7063990fb3f66",22857219,1,-27,0,1325,417,400,-17
"2b09a08242b54983aec7063990fb3f66","66baf19b6b904b70922329068c63746d",22857219,1,-32,0,1326,400,376,-24
"66baf19b6b904b70922329068c63746d","a2b4bd40cee2481ebd3fc179d6a5cd62",22857219,1,59,0,1327,376,417,41
"a2b4bd40cee2481ebd3fc179d6a5cd62","a2b4bd40cee2481ebd3fc179d6a5cd62",22857219,1,0,1,1328,417,417,0
"a2b4bd40cee2481ebd3fc179d6a5cd62","e34e59dce2204f228f3a84b6725df60f",22857219,1,2,0,1329,417,419,2
"e34e59dce2204f228f3a84b6725df60f","e34e59dce2204f228f3a84b6725df60f",22857219,1,0,1,1330,419,419,0
"e34e59dce2204f228f3a84b6725df60f","a2b4bd40cee2481ebd3fc179d6a5cd62",22857219,1,-2,0,1331,419,417,-2
"a2b4bd40cee2481ebd3fc179d6a5cd62","bec48fc2e1294c7eb3d0aca780d731b8",22857219,1,4,0,1332,417,420,3
"bec48fc2e1294c7eb3d0aca780d731b8","bec48fc2e1294c7eb3d0aca780d731b8",22857219,6,0,1,1333,420,420,0
"bec48fc2e1294c7eb3d0aca780d731b8","a24600b0e49245f6bdba8c893cfeddb0",22857219,1,7,0,1339,420,425,5
"a24600b0e49245f6bdba8c893cfeddb0","dbde19fcce2a4c1abdc7f685c293a23f",22857219,1,-4,0,1340,425,422,-3
"dbde19fcce2a4c1abdc7f685c293a23f","a24600b0e49245f6bdba8c893cfeddb0",22857219,1,4,0,1341,422,425,3
"a24600b0e49245f6bdba8c893cfeddb0","a24600b0e49245f6bdba8c893cfeddb0",22857219,3,0,1,1342,425,425,0
"a24600b0e49245f6bdba8c893cfeddb0","a2b4bd40cee2481ebd3fc179d6a5cd62",22857219,1,-11,0,1345,425,417,-8
"a2b4bd40cee2481ebd3fc179d6a5cd62","24cf8786024543f19b89bc20034e60d7",22857219,1,18,0,1346,417,428,11
"24cf8786024543f19b89bc20034e60d7","f2a73be2f46840b182d7bd095378004e",22857219,2,1,0,1347,428,429,1
"f2a73be2f46840b182d7bd095378004e","f2a73be2f46840b182d7bd095378004e",22857219,4,0,1,1348,429,429,0
"f2a73be2f46840b182d7bd095378004e","604551fd4266430cb860fef58fa7dd61",22857219,1,1,0,1352,429,430,1
"604551fd4266430cb860fef58fa7dd61","604551fd4266430cb860fef58fa7dd61",22857219,4,0,1,1353,430,430,0
"604551fd4266430cb860fef58fa7dd61","dce46f8904594a62a6377a3587aaa663",22857219,1,2,0,1357,430,431,1
"dce46f8904594a62a6377a3587aaa663","24cf8786024543f19b89bc20034e60d7",22857219,1,-4,0,1358,431,428,-3
"24cf8786024543f19b89bc20034e60d7","dce46f8904594a62a6377a3587aaa663",22857219,1,4,0,1359,428,431,3
"dce46f8904594a62a6377a3587aaa663","dce46f8904594a62a6377a3587aaa663",22857219,1,0,1,1360,431,431,0
"dce46f8904594a62a6377a3587aaa663","9b9d0a249052413c869753b99682b0ac",22857219,1,1,0,1361,431,432,1
"9b9d0a249052413c869753b99682b0ac","9b9d0a249052413c869753b99682b0ac",22857219,1,0,1,1362,432,432,0
"9b9d0a249052413c869753b99682b0ac","061c175cc90f45fbad883025394e78dd",22857219,1,1,0,1363,432,433,1
"061c175cc90f45fbad883025394e78dd","061c175cc90f45fbad883025394e78dd",22857219,4,0,1,1364,433,433,0
"061c175cc90f45fbad883025394e78dd","dce46f8904594a62a6377a3587aaa663",22857219,1,-2,0,1368,433,431,-2
"dce46f8904594a62a6377a3587aaa663","74a7f8712e5449c2bc0b43c6f90dafed",22857219,1,5,0,1369,431,435,4
"74a7f8712e5449c2bc0b43c6f90dafed","74a7f8712e5449c2bc0b43c6f90dafed",22857219,1,0,1,1370,435,435,0
"74a7f8712e5449c2bc0b43c6f90dafed","66ada10dde9f43018588f1ced9d477fc",22857219,1,-1,0,1371,435,434,-1
"66ada10dde9f43018588f1ced9d477fc","bf12c96466d840a69bed7020b3f18bb8",22857219,1,3,0,1372,434,436,2
"bf12c96466d840a69bed7020b3f18bb8","bf12c96466d840a69bed7020b3f18bb8",22857219,1,0,1,1373,436,436,0
"bf12c96466d840a69bed7020b3f18bb8","24cf8786024543f19b89bc20034e60d7",22857219,1,-11,0,1374,436,428,-8
"24cf8786024543f19b89bc20034e60d7","070600601c4c439288445d2f0724807d",22857219,1,14,0,1375,428,437,9
"070600601c4c439288445d2f0724807d","1823b6de7d334a7aaabc4570719af4d9",22857219,2,2,0,1376,437,439,2
"1823b6de7d334a7aaabc4570719af4d9","1823b6de7d334a7aaabc4570719af4d9",22857219,13,0,1,1377,439,439,0
"1823b6de7d334a7aaabc4570719af4d9","070600601c4c439288445d2f0724807d",22857219,1,-2,0,1390,439,437,-2
"070600601c4c439288445d2f0724807d","0380cd76a7d44bc3a4da1f15e4d68f89",22857219,1,4,0,1391,437,440,3
"0380cd76a7d44bc3a4da1f15e4d68f89","0380cd76a7d44bc3a4da1f15e4d68f89",22857219,2,0,1,1392,440,440,0
"0380cd76a7d44bc3a4da1f15e4d68f89","23b7673c8b5443108c2ef09382834a86",22857219,2,2,0,1394,440,441,1
"23b7673c8b5443108c2ef09382834a86","0380cd76a7d44bc3a4da1f15e4d68f89",22857219,1,-2,0,1395,441,440,-1
"23b7673c8b5443108c2ef09382834a86","23b7673c8b5443108c2ef09382834a86",22857219,3,0,1,1397,441,441,0
"23b7673c8b5443108c2ef09382834a86","901e92500aea43c79f19f1b279050668",22857219,1,2,0,1400,441,442,1
"901e92500aea43c79f19f1b279050668","901e92500aea43c79f19f1b279050668",22857219,2,0,1,1401,442,442,0
"901e92500aea43c79f19f1b279050668","001339db8ced4cf78829ebe8b145449d",22857219,1,1,0,1403,442,443,1
"001339db8ced4cf78829ebe8b145449d","001339db8ced4cf78829ebe8b145449d",22857219,5,0,1,1404,443,443,0
"001339db8ced4cf78829ebe8b145449d","452745e0366e42ae81561bfddebcc6c3",22857219,1,1,0,1409,443,444,1
"452745e0366e42ae81561bfddebcc6c3","452745e0366e42ae81561bfddebcc6c3",22857219,2,0,1,1410,444,444,0
"452745e0366e42ae81561bfddebcc6c3","901e92500aea43c79f19f1b279050668",22857219,1,-2,0,1412,444,442,-2
"901e92500aea43c79f19f1b279050668","4660ff2089114e8db82ceb26a4f329e3",22857219,1,4,0,1413,442,445,3
"4660ff2089114e8db82ceb26a4f329e3","4660ff2089114e8db82ceb26a4f329e3",22857219,2,0,1,1414,445,445,0
"4660ff2089114e8db82ceb26a4f329e3","24cf8786024543f19b89bc20034e60d7",22857219,1,-26,0,1416,445,428,-17
"f2a73be2f46840b182d7bd095378004e","070600601c4c439288445d2f0724807d",22857219,1,13,0,1418,429,437,8
"1823b6de7d334a7aaabc4570719af4d9","4660ff2089114e8db82ceb26a4f329e3",22857219,1,10,0,1420,439,445,6
"4660ff2089114e8db82ceb26a4f329e3","070600601c4c439288445d2f0724807d",22857219,1,-12,0,1421,445,437,-8
"070600601c4c439288445d2f0724807d","4660ff2089114e8db82ceb26a4f329e3",22857219,1,12,0,1422,437,445,8
"4660ff2089114e8db82ceb26a4f329e3","7bd5586eb9d8484eb74a433ee7bfe499",22857219,1,2,0,1423,445,446,1
"7bd5586eb9d8484eb74a433ee7bfe499","7bd5586eb9d8484eb74a433ee7bfe499",22857219,18,0,1,1424,446,446,0
"7bd5586eb9d8484eb74a433ee7bfe499","8a7f26e690f34dda97be16904518ca99",22857219,1,2,0,1442,446,447,1
"8a7f26e690f34dda97be16904518ca99","8a7f26e690f34dda97be16904518ca99",22857219,1,0,1,1443,447,447,0
"8a7f26e690f34dda97be16904518ca99","070600601c4c439288445d2f0724807d",22857219,1,-16,0,1444,447,437,-10
"070600601c4c439288445d2f0724807d","b2f0d654738f48158edff28e8d3a546e",22857219,1,21,0,1445,437,449,12
"b2f0d654738f48158edff28e8d3a546e","b2f0d654738f48158edff28e8d3a546e",22857219,1,0,1,1446,449,449,0
"b2f0d654738f48158edff28e8d3a546e","f60ee41ec635499abd48168342d32c2f",22857219,3,5,0,1447,449,453,4
"f60ee41ec635499abd48168342d32c2f","b2f0d654738f48158edff28e8d3a546e",22857219,3,-5,0,1448,453,449,-4
"f60ee41ec635499abd48168342d32c2f","f60ee41ec635499abd48168342d32c2f",22857219,58,0,1,1450,453,453,0
"b2f0d654738f48158edff28e8d3a546e","f67fbf45a5f146ed866965bc57c7c001",22857219,1,8,0,1511,449,454,5
"f67fbf45a5f146ed866965bc57c7c001","f67fbf45a5f146ed866965bc57c7c001",22857219,2,0,1,1512,454,454,0
"f67fbf45a5f146ed866965bc57c7c001","d937afe49bd24a07a550dda1c1155122",22857219,1,1,0,1514,454,455,1
"d937afe49bd24a07a550dda1c1155122","d937afe49bd24a07a550dda1c1155122",22857219,1,0,1,1515,455,455,0
"d937afe49bd24a07a550dda1c1155122","3628b3f7823443d0912a339096b69943",22857219,1,1,0,1516,455,456,1
"3628b3f7823443d0912a339096b69943","3628b3f7823443d0912a339096b69943",22857219,1,0,1,1517,456,456,0
"3628b3f7823443d0912a339096b69943","9e049ee647cf43ecbcb5ed792a8e7588",22857219,1,1,0,1518,456,457,1
"9e049ee647cf43ecbcb5ed792a8e7588","9e049ee647cf43ecbcb5ed792a8e7588",22857219,1,0,1,1519,457,457,0
"9e049ee647cf43ecbcb5ed792a8e7588","5256a214faaf410b93f76cea06428334",22857219,1,1,0,1520,457,458,1
"5256a214faaf410b93f76cea06428334","5256a214faaf410b93f76cea06428334",22857219,1,0,1,1521,458,458,0
"5256a214faaf410b93f76cea06428334","25c32b120fce40fa9b6c85133aeb4716",22857219,1,1,0,1522,458,459,1
"25c32b120fce40fa9b6c85133aeb4716","25c32b120fce40fa9b6c85133aeb4716",22857219,3,0,1,1523,459,459,0
"25c32b120fce40fa9b6c85133aeb4716","11bc14f2204949008b7d511b933363c1",22857219,1,1,0,1526,459,460,1
"11bc14f2204949008b7d511b933363c1","11bc14f2204949008b7d511b933363c1",22857219,1,0,1,1527,460,460,0
"11bc14f2204949008b7d511b933363c1","42de338840a34d15adb66e7b14fb9d2c",22857219,1,1,0,1528,460,461,1
"42de338840a34d15adb66e7b14fb9d2c","42de338840a34d15adb66e7b14fb9d2c",22857219,3,0,1,1529,461,461,0
"42de338840a34d15adb66e7b14fb9d2c","9da37c6210b1416b8079c274f70bf600",22857219,1,1,0,1532,461,462,1
"9da37c6210b1416b8079c274f70bf600","9da37c6210b1416b8079c274f70bf600",22857219,1,0,1,1533,462,462,0
"9da37c6210b1416b8079c274f70bf600","519119f1deac45ff9ab4f13529be5c6e",22857219,1,1,0,1534,462,463,1
"519119f1deac45ff9ab4f13529be5c6e","519119f1deac45ff9ab4f13529be5c6e",22857219,1,0,1,1535,463,463,0
"519119f1deac45ff9ab4f13529be5c6e","f67fbf45a5f146ed866965bc57c7c001",22857219,1,-9,0,1536,463,454,-9
"f67fbf45a5f146ed866965bc57c7c001","c5df9f40ec14463b9dcfdc73df3e9285",22857219,1,12,0,1537,454,464,10
"c5df9f40ec14463b9dcfdc73df3e9285","c5df9f40ec14463b9dcfdc73df3e9285",22857219,2,0,1,1538,464,464,0
"c5df9f40ec14463b9dcfdc73df3e9285","83d42d95cd844fc093fc09cee250edb8",22857219,1,3,0,1540,464,465,1
"83d42d95cd844fc093fc09cee250edb8","83d42d95cd844fc093fc09cee250edb8",22857219,5,0,1,1541,465,465,0
"b613861cecf84ffcab01afb23f660475","b613861cecf84ffcab01afb23f660475",22857661,5,0,1,1,1,1,0
"b613861cecf84ffcab01afb23f660475","e2911e79efc2420eac45d9f671463d4b",22857661,2,3,0,6,1,2,1
"e2911e79efc2420eac45d9f671463d4b","b613861cecf84ffcab01afb23f660475",22857661,1,-3,0,7,2,1,-1
"e2911e79efc2420eac45d9f671463d4b","e2911e79efc2420eac45d9f671463d4b",22857661,1,0,1,9,2,2,0
"e2911e79efc2420eac45d9f671463d4b","519d1b8c59404d67b54e96c5c8a830b2",22857661,1,1,0,10,2,3,1
"519d1b8c59404d67b54e96c5c8a830b2","519d1b8c59404d67b54e96c5c8a830b2",22857661,1,0,1,11,3,3,0
"519d1b8c59404d67b54e96c5c8a830b2","531db53f81f646edb0cdcfe0085b03b7",22857661,1,1,0,12,3,4,1
"531db53f81f646edb0cdcfe0085b03b7","531db53f81f646edb0cdcfe0085b03b7",22857661,1,0,1,13,4,4,0
"531db53f81f646edb0cdcfe0085b03b7","4f5f94b2f95141e0a9d53a61da2276da",22857661,1,1,0,14,4,5,1
"4f5f94b2f95141e0a9d53a61da2276da","4f5f94b2f95141e0a9d53a61da2276da",22857661,1,0,1,15,5,5,0
"4f5f94b2f95141e0a9d53a61da2276da","6d541c89590949f99af293c4f2333f67",22857661,1,1,0,16,5,6,1
"6d541c89590949f99af293c4f2333f67","6d541c89590949f99af293c4f2333f67",22857661,1,0,1,17,6,6,0
"6d541c89590949f99af293c4f2333f67","dd5cf0b9fe4c4f1d8f5ff8e4c04879cb",22857661,1,1,0,18,6,7,1
"dd5cf0b9fe4c4f1d8f5ff8e4c04879cb","dd5cf0b9fe4c4f1d8f5ff8e4c04879cb",22857661,1,0,1,19,7,7,0
"dd5cf0b9fe4c4f1d8f5ff8e4c04879cb","f96261861edc426abe2248be4f0a709a",22857661,1,1,0,20,7,8,1
"f96261861edc426abe2248be4f0a709a","f96261861edc426abe2248be4f0a709a",22857661,1,0,1,21,8,8,0
"f96261861edc426abe2248be4f0a709a","66b5e16f4f75454fb5b8172079f0fa83",22857661,1,1,0,22,8,9,1
"66b5e16f4f75454fb5b8172079f0fa83","66b5e16f4f75454fb5b8172079f0fa83",22857661,1,0,1,23,9,9,0
"66b5e16f4f75454fb5b8172079f0fa83","0680571d4698477995e41842c36a54b2",22857661,1,1,0,24,9,10,1
"0680571d4698477995e41842c36a54b2","0680571d4698477995e41842c36a54b2",22857661,1,0,1,25,10,10,0
"0680571d4698477995e41842c36a54b2","9112f2bffece48e08c6d2287be204085",22857661,1,1,0,26,10,11,1
"9112f2bffece48e08c6d2287be204085","9112f2bffece48e08c6d2287be204085",22857661,1,0,1,27,11,11,0
"9112f2bffece48e08c6d2287be204085","56586aa865414f538729c7f7735d2bc6",22857661,1,3,0,28,11,12,1
"56586aa865414f538729c7f7735d2bc6","e2911e79efc2420eac45d9f671463d4b",22857661,1,-12,0,29,12,2,-10
"e2911e79efc2420eac45d9f671463d4b","56586aa865414f538729c7f7735d2bc6",22857661,1,12,0,30,2,12,10
"56586aa865414f538729c7f7735d2bc6","56586aa865414f538729c7f7735d2bc6",22857661,1,0,1,31,12,12,0
"56586aa865414f538729c7f7735d2bc6","b7f2b31585d94eb3bf86376714aa7070",22857661,2,2,0,32,12,13,1
"b7f2b31585d94eb3bf86376714aa7070","56586aa865414f538729c7f7735d2bc6",22857661,1,-2,0,33,13,12,-1
"b7f2b31585d94eb3bf86376714aa7070","b7f2b31585d94eb3bf86376714aa7070",22857661,1,0,1,35,13,13,0
"b7f2b31585d94eb3bf86376714aa7070","3f1c815879794b929260d224becaff7e",22857661,1,2,0,36,13,14,1
"3f1c815879794b929260d224becaff7e","5c5ceeee4562457ba6d41515aeebfbb1",22857661,1,6,0,37,14,17,3
"5c5ceeee4562457ba6d41515aeebfbb1","81c864a886d54a6b8ff85f7d736f4f95",22857661,1,-4,0,38,17,15,-2
"81c864a886d54a6b8ff85f7d736f4f95","5c5ceeee4562457ba6d41515aeebfbb1",22857661,1,4,0,39,15,17,2
"5c5ceeee4562457ba6d41515aeebfbb1","9afd71a5298d4333b6849dfce1b9422c",22857661,1,3,0,40,17,18,1
"9afd71a5298d4333b6849dfce1b9422c","56586aa865414f538729c7f7735d2bc6",22857661,1,-13,0,41,18,12,-6
"56586aa865414f538729c7f7735d2bc6","b7719e26494940efa49512aedd0aac79",22857661,1,17,0,42,12,20,8
"b7719e26494940efa49512aedd0aac79","9afd71a5298d4333b6849dfce1b9422c",22857661,1,-4,0,43,20,18,-2
"9afd71a5298d4333b6849dfce1b9422c","d4f45188d3c84a02ba08454e6403a818",22857661,1,9,0,44,18,24,6
"d4f45188d3c84a02ba08454e6403a818","d4c3b003e8274e429d2fa688d73fde6d",22857661,1,-2,0,45,24,22,-2
"d4c3b003e8274e429d2fa688d73fde6d","d4c3b003e8274e429d2fa688d73fde6d",22857661,1,0,1,46,22,22,0
"d4c3b003e8274e429d2fa688d73fde6d","b7719e26494940efa49512aedd0aac79",22857661,1,-3,0,47,22,20,-2
"b7719e26494940efa49512aedd0aac79","afbf7250b99d47bea07172749483ca97",22857661,2,12,0,48,20,28,8
"afbf7250b99d47bea07172749483ca97","b7719e26494940efa49512aedd0aac79",22857661,1,-12,0,49,28,20,-8
"afbf7250b99d47bea07172749483ca97","4e51676dc72045d99c19b9fa7b22f8bc",22857661,1,3,0,51,28,29,1
"4e51676dc72045d99c19b9fa7b22f8bc","4e51676dc72045d99c19b9fa7b22f8bc",22857661,1,0,1,52,29,29,0
"4e51676dc72045d99c19b9fa7b22f8bc","51970cfa30e643e894e66ae85c8024cc",22857661,1,3,0,53,29,31,2
"51970cfa30e643e894e66ae85c8024cc","4e51676dc72045d99c19b9fa7b22f8bc",22857661,1,-3,0,54,31,29,-2
"4e51676dc72045d99c19b9fa7b22f8bc","c33c17be71ae4d588da7369472e5bb1b",22857661,1,9,0,55,29,34,5
"c33c17be71ae4d588da7369472e5bb1b","c33c17be71ae4d588da7369472e5bb1b",22857661,1,0,1,56,34,34,0
"c33c17be71ae4d588da7369472e5bb1b","93679be414554a11b1893002f2229a93",22857661,1,3,0,57,34,35,1
"93679be414554a11b1893002f2229a93","93679be414554a11b1893002f2229a93",22857661,1,0,1,58,35,35,0
"93679be414554a11b1893002f2229a93","7040a13096d746ac84b8fac8d9752058",22857661,1,3,0,59,35,36,1
"7040a13096d746ac84b8fac8d9752058","7040a13096d746ac84b8fac8d9752058",22857661,1,0,1,60,36,36,0
"7040a13096d746ac84b8fac8d9752058","9a0dc646f934470daf08c4b56ccf73db",22857661,1,3,0,61,36,37,1
"9a0dc646f934470daf08c4b56ccf73db","9a0dc646f934470daf08c4b56ccf73db",22857661,1,0,1,62,37,37,0
"9a0dc646f934470daf08c4b56ccf73db","fc0e049d56024bc9a02c9a9c435c3df7",22857661,1,3,0,63,37,38,1
"fc0e049d56024bc9a02c9a9c435c3df7","fc0e049d56024bc9a02c9a9c435c3df7",22857661,1,0,1,64,38,38,0
"fc0e049d56024bc9a02c9a9c435c3df7","67a089198fcb4e1c8f2385786c2b296f",22857661,1,4,0,65,38,39,1
"67a089198fcb4e1c8f2385786c2b296f","64d48c6c9c7940639a932219a6c87198",22857661,3,1,0,66,39,40,1
"64d48c6c9c7940639a932219a6c87198","64d48c6c9c7940639a932219a6c87198",22857661,2,0,1,67,40,40,0
"64d48c6c9c7940639a932219a6c87198","67a089198fcb4e1c8f2385786c2b296f",22857661,2,-1,0,68,40,39,-1
"64d48c6c9c7940639a932219a6c87198","b534b89233134e30a9b5645138bfa9ee",22857661,1,3,0,73,40,41,1
"b534b89233134e30a9b5645138bfa9ee","67a089198fcb4e1c8f2385786c2b296f",22857661,1,-4,0,74,41,39,-2
"67a089198fcb4e1c8f2385786c2b296f","0e37b720d23b4e7f8b313e79313fd107",22857661,1,7,0,75,39,44,5
"0e37b720d23b4e7f8b313e79313fd107","0e37b720d23b4e7f8b313e79313fd107",22857661,4,0,1,76,44,44,0
"0e37b720d23b4e7f8b313e79313fd107","6875d67fdd5f48168b62719df449bebd",22857661,1,1,0,80,44,45,1
"6875d67fdd5f48168b62719df449bebd","6875d67fdd5f48168b62719df449bebd",22857661,1,0,1,81,45,45,0
"6875d67fdd5f48168b62719df449bebd","6e13d61a7bdb44bca949c9f86fab3be5",22857661,1,3,0,82,45,47,2
"6e13d61a7bdb44bca949c9f86fab3be5","b534b89233134e30a9b5645138bfa9ee",22857661,1,-7,0,83,47,41,-6
"6e13d61a7bdb44bca949c9f86fab3be5","195f78799f984cc2b06c48dfe36be751",22857661,1,2,0,85,47,49,2
"195f78799f984cc2b06c48dfe36be751","195f78799f984cc2b06c48dfe36be751",22857661,2,0,1,86,49,49,0
"195f78799f984cc2b06c48dfe36be751","d9c8d8c444a64dadbbb508652c721e17",22857661,1,-3,0,88,49,46,-3
"d9c8d8c444a64dadbbb508652c721e17","d0c74f735e024943943e40333d6d337f",22857661,1,6,0,89,46,51,5
"d0c74f735e024943943e40333d6d337f","d0c74f735e024943943e40333d6d337f",22857661,1,0,1,90,51,51,0
"d0c74f735e024943943e40333d6d337f","983f8ff320594b279a7f4a6fe132f9c5",22857661,1,2,0,91,51,53,2
"983f8ff320594b279a7f4a6fe132f9c5","983f8ff320594b279a7f4a6fe132f9c5",22857661,2,0,1,92,53,53,0
"983f8ff320594b279a7f4a6fe132f9c5","35adfa5d923046aebabfefd98f35ff05",22857661,1,1,0,94,53,54,1
"35adfa5d923046aebabfefd98f35ff05","35adfa5d923046aebabfefd98f35ff05",22857661,5,0,1,95,54,54,0
"35adfa5d923046aebabfefd98f35ff05","b6f8a98476224da1b40e555ececc7ed8",22857661,1,1,0,100,54,55,1
"b6f8a98476224da1b40e555ececc7ed8","b6f8a98476224da1b40e555ececc7ed8",22857661,2,0,1,101,55,55,0
"b6f8a98476224da1b40e555ececc7ed8","86e22cb5fe0e4b47a9489ecddf7ed78f",22857661,1,1,0,103,55,56,1
"86e22cb5fe0e4b47a9489ecddf7ed78f","86e22cb5fe0e4b47a9489ecddf7ed78f",22857661,2,0,1,104,56,56,0
"86e22cb5fe0e4b47a9489ecddf7ed78f","f924752d8a1149668870b1e7698486f7",22857661,1,-6,0,106,56,50,-6
"f924752d8a1149668870b1e7698486f7","a1f2f12debe5432fb7a70bcd12bacfb9",22857661,1,9,0,107,50,58,8
"a1f2f12debe5432fb7a70bcd12bacfb9","78f30e4dcac84e3cbea8b2cc6e0d62b3",22857661,2,1,0,108,58,59,1
"78f30e4dcac84e3cbea8b2cc6e0d62b3","a1f2f12debe5432fb7a70bcd12bacfb9",22857661,2,-1,0,109,59,58,-1
"a1f2f12debe5432fb7a70bcd12bacfb9","b534b89233134e30a9b5645138bfa9ee",22857661,1,-20,0,110,58,41,-17
"b534b89233134e30a9b5645138bfa9ee","b534b89233134e30a9b5645138bfa9ee",22857661,1,0,1,111,41,41,0
"b534b89233134e30a9b5645138bfa9ee","6e13d61a7bdb44bca949c9f86fab3be5",22857661,2,7,0,112,41,47,6
"6e13d61a7bdb44bca949c9f86fab3be5","d0c74f735e024943943e40333d6d337f",22857661,1,5,0,113,47,51,4
"d0c74f735e024943943e40333d6d337f","d9c8d8c444a64dadbbb508652c721e17",22857661,1,-6,0,114,51,46,-5
"d9c8d8c444a64dadbbb508652c721e17","f924752d8a1149668870b1e7698486f7",22857661,1,5,0,115,46,50,4
"f924752d8a1149668870b1e7698486f7","78f30e4dcac84e3cbea8b2cc6e0d62b3",22857661,1,10,0,116,50,59,9
"a1f2f12debe5432fb7a70bcd12bacfb9","a1f2f12debe5432fb7a70bcd12bacfb9",22857661,24,0,1,118,58,58,0
"78f30e4dcac84e3cbea8b2cc6e0d62b3","78f30e4dcac84e3cbea8b2cc6e0d62b3",22857661,7,0,1,143,59,59,0
"78f30e4dcac84e3cbea8b2cc6e0d62b3","a0a418b8540d479fa6e0f653b701da8b",22857661,1,6,0,150,59,64,5
"a0a418b8540d479fa6e0f653b701da8b","bc42d26810654ea9a1df1efe1e58c7d5",22857661,1,-1,0,151,64,63,-1
"bc42d26810654ea9a1df1efe1e58c7d5","12aa6e1672ac4e7aa6449a7a8609cd72",22857661,1,-7,0,152,63,57,-6
"12aa6e1672ac4e7aa6449a7a8609cd72","4c943503763e4e349906eea3ed3c8e86",22857661,1,5,0,153,57,61,4
"4c943503763e4e349906eea3ed3c8e86","4c943503763e4e349906eea3ed3c8e86",22857661,1,0,1,154,61,61,0
"4c943503763e4e349906eea3ed3c8e86","bc42d26810654ea9a1df1efe1e58c7d5",22857661,1,2,0,155,61,63,2
"bc42d26810654ea9a1df1efe1e58c7d5","bc42d26810654ea9a1df1efe1e58c7d5",22857661,3,0,1,156,63,63,0
"bc42d26810654ea9a1df1efe1e58c7d5","a0a418b8540d479fa6e0f653b701da8b",22857661,1,1,0,159,63,64,1
"a0a418b8540d479fa6e0f653b701da8b","a0a418b8540d479fa6e0f653b701da8b",22857661,3,0,1,160,64,64,0
"a0a418b8540d479fa6e0f653b701da8b","309ccf3cc4fe429d9bfbaef53d3fa479",22857661,1,-4,0,163,64,60,-4
"309ccf3cc4fe429d9bfbaef53d3fa479","b534b89233134e30a9b5645138bfa9ee",22857661,1,-23,0,164,60,41,-19
"b534b89233134e30a9b5645138bfa9ee","d646286c8051419bbc2e31dd1db55ca8",22857661,1,33,0,165,41,67,26
"d646286c8051419bbc2e31dd1db55ca8","267f883678b24aed855fde42524975d9",22857661,1,4,0,166,67,71,4
"267f883678b24aed855fde42524975d9","267f883678b24aed855fde42524975d9",22857661,1,0,1,167,71,71,0
"267f883678b24aed855fde42524975d9","88fff56d0342490dbef9040750a20f6c",22857661,1,1,0,168,71,72,1
"88fff56d0342490dbef9040750a20f6c","88fff56d0342490dbef9040750a20f6c",22857661,1,0,1,169,72,72,0
"88fff56d0342490dbef9040750a20f6c","adb17b12b66c4a49a85fd34322f7df70",22857661,1,1,0,170,72,73,1
"adb17b12b66c4a49a85fd34322f7df70","adb17b12b66c4a49a85fd34322f7df70",22857661,1,0,1,171,73,73,0
"adb17b12b66c4a49a85fd34322f7df70","d646286c8051419bbc2e31dd1db55ca8",22857661,1,-6,0,172,73,67,-6
"d646286c8051419bbc2e31dd1db55ca8","a2becd407db34b189200a32546d9d569",22857661,3,9,0,173,67,75,8
"a2becd407db34b189200a32546d9d569","d646286c8051419bbc2e31dd1db55ca8",22857661,2,-9,0,174,75,67,-8
"a2becd407db34b189200a32546d9d569","58c22b011d0f4c2ea6d13615edbb9eeb",22857661,1,2,0,178,75,77,2
"58c22b011d0f4c2ea6d13615edbb9eeb","58c22b011d0f4c2ea6d13615edbb9eeb",22857661,8,0,1,179,77,77,0
"58c22b011d0f4c2ea6d13615edbb9eeb","dd76e1861dc9461c830888729d091ee0",22857661,1,1,0,187,77,78,1
"dd76e1861dc9461c830888729d091ee0","dd76e1861dc9461c830888729d091ee0",22857661,5,0,1,188,78,78,0
"dd76e1861dc9461c830888729d091ee0","cd1d828f1a694b87913a7ea66c23803e",22857661,1,1,0,193,78,79,1
"cd1d828f1a694b87913a7ea66c23803e","cd1d828f1a694b87913a7ea66c23803e",22857661,2,0,1,194,79,79,0
"cd1d828f1a694b87913a7ea66c23803e","9176a3c2b4d2465fa8b0c67096c2a97e",22857661,1,1,0,196,79,80,1
"9176a3c2b4d2465fa8b0c67096c2a97e","9176a3c2b4d2465fa8b0c67096c2a97e",22857661,5,0,1,197,80,80,0
"9176a3c2b4d2465fa8b0c67096c2a97e","f8ec6445f7194e25b9101d4fbcb07a18",22857661,1,1,0,202,80,81,1
"f8ec6445f7194e25b9101d4fbcb07a18","f8ec6445f7194e25b9101d4fbcb07a18",22857661,2,0,1,203,81,81,0
"f8ec6445f7194e25b9101d4fbcb07a18","140d5b27b8574befad82c0a013b59dfa",22857661,1,-7,0,205,81,74,-7
"140d5b27b8574befad82c0a013b59dfa","d18a9ea32855445f8736581f5cb119ce",22857661,1,9,0,206,74,82,8
"d18a9ea32855445f8736581f5cb119ce","f564483cbd7a407681aa2fcca518cf5f",22857661,1,4,0,207,82,85,3
"f564483cbd7a407681aa2fcca518cf5f","f564483cbd7a407681aa2fcca518cf5f",22857661,4,0,1,208,85,85,0
"f564483cbd7a407681aa2fcca518cf5f","18fd01350bd5434ca636d59a599d768a",22857661,1,1,0,212,85,86,1
"18fd01350bd5434ca636d59a599d768a","18fd01350bd5434ca636d59a599d768a",22857661,9,0,1,213,86,86,0
"18fd01350bd5434ca636d59a599d768a","6a9f0ef185fb47f0937e29daa1c71ed5",22857661,1,5,0,222,86,90,4
"6a9f0ef185fb47f0937e29daa1c71ed5","ae5ac430ea254e708a6f5deaaf7464ae",22857661,1,-7,0,223,90,84,-6
"ae5ac430ea254e708a6f5deaaf7464ae","c681290961c94c4caf23b529d1ae6b9a",22857661,1,5,0,224,84,88,4
"c681290961c94c4caf23b529d1ae6b9a","c681290961c94c4caf23b529d1ae6b9a",22857661,1,0,1,225,88,88,0
"c681290961c94c4caf23b529d1ae6b9a","6a9f0ef185fb47f0937e29daa1c71ed5",22857661,1,2,0,226,88,90,2
"6a9f0ef185fb47f0937e29daa1c71ed5","6a9f0ef185fb47f0937e29daa1c71ed5",22857661,3,0,1,227,90,90,0
"6a9f0ef185fb47f0937e29daa1c71ed5","e20db35ced8544ddac5bc3839145e463",22857661,1,3,0,230,90,91,1
"e20db35ced8544ddac5bc3839145e463","d646286c8051419bbc2e31dd1db55ca8",22857661,1,-30,0,231,91,67,-24
"d646286c8051419bbc2e31dd1db55ca8","1febb706d7a34005ae8711ed49c76e64",22857661,1,33,0,232,67,94,27
"1febb706d7a34005ae8711ed49c76e64","1febb706d7a34005ae8711ed49c76e64",22857661,5,0,1,233,94,94,0
"1febb706d7a34005ae8711ed49c76e64","8f73ba6f5a0042f2850356ac38ac6f24",22857661,1,1,0,238,94,95,1
"8f73ba6f5a0042f2850356ac38ac6f24","8f73ba6f5a0042f2850356ac38ac6f24",22857661,5,0,1,239,95,95,0
"8f73ba6f5a0042f2850356ac38ac6f24","e2260b86653c46d7b14a41fb419dbf8c",22857661,1,1,0,244,95,96,1
"e2260b86653c46d7b14a41fb419dbf8c","e2260b86653c46d7b14a41fb419dbf8c",22857661,2,0,1,245,96,96,0
"e2260b86653c46d7b14a41fb419dbf8c","35eb641ad1d845bbba54915bce75a962",22857661,1,1,0,247,96,97,1
"35eb641ad1d845bbba54915bce75a962","35eb641ad1d845bbba54915bce75a962",22857661,5,0,1,248,97,97,0
"35eb641ad1d845bbba54915bce75a962","08be90ffbeea4795a138cd42ed8db56f",22857661,1,1,0,253,97,98,1
"08be90ffbeea4795a138cd42ed8db56f","08be90ffbeea4795a138cd42ed8db56f",22857661,5,0,1,254,98,98,0
"08be90ffbeea4795a138cd42ed8db56f","3007433c8f584dcbb5ac159c1c5f2be3",22857661,1,1,0,259,98,99,1
"3007433c8f584dcbb5ac159c1c5f2be3","3007433c8f584dcbb5ac159c1c5f2be3",22857661,5,0,1,260,99,99,0
"3007433c8f584dcbb5ac159c1c5f2be3","d391c8b6e56a43a7b654e9dee02d904b",22857661,1,5,0,265,99,103,4
"d391c8b6e56a43a7b654e9dee02d904b","e20db35ced8544ddac5bc3839145e463",22857661,1,-13,0,266,103,91,-12
"e20db35ced8544ddac5bc3839145e463","00ae5f0c51874a73a41ebea838d95682",22857661,1,11,0,267,91,101,10
"00ae5f0c51874a73a41ebea838d95682","00ae5f0c51874a73a41ebea838d95682",22857661,2,0,1,268,101,101,0
"00ae5f0c51874a73a41ebea838d95682","d391c8b6e56a43a7b654e9dee02d904b",22857661,1,2,0,270,101,103,2
"d391c8b6e56a43a7b654e9dee02d904b","d391c8b6e56a43a7b654e9dee02d904b",22857661,17,0,1,271,103,103,0
"d391c8b6e56a43a7b654e9dee02d904b","6111116566fc4fd9abba409322bea245",22857661,1,1,0,288,103,104,1
"6111116566fc4fd9abba409322bea245","6111116566fc4fd9abba409322bea245",22857661,2,0,1,289,104,104,0
"6111116566fc4fd9abba409322bea245","a81b2235cb9c499eb9ea8ee0a8dd9725",22857661,1,1,0,291,104,105,1
"a81b2235cb9c499eb9ea8ee0a8dd9725","a81b2235cb9c499eb9ea8ee0a8dd9725",22857661,2,0,1,292,105,105,0
"a81b2235cb9c499eb9ea8ee0a8dd9725","2d4e0ab0ef3b4d73b82c72d4621a7579",22857661,1,1,0,294,105,106,1
"2d4e0ab0ef3b4d73b82c72d4621a7579","2d4e0ab0ef3b4d73b82c72d4621a7579",22857661,2,0,1,295,106,106,0
"2d4e0ab0ef3b4d73b82c72d4621a7579","8bdebf492ebd4e62b0d522e8ab5e5197",22857661,1,1,0,297,106,107,1
"8bdebf492ebd4e62b0d522e8ab5e5197","8bdebf492ebd4e62b0d522e8ab5e5197",22857661,2,0,1,298,107,107,0
"8bdebf492ebd4e62b0d522e8ab5e5197","73039f8c1eb9409cb4caee2cf968001e",22857661,1,-7,0,300,107,100,-7
"73039f8c1eb9409cb4caee2cf968001e","4280927ec4d643238aa49c32f9e06c6c",22857661,2,10,0,301,100,109,9
"4280927ec4d643238aa49c32f9e06c6c","4280927ec4d643238aa49c32f9e06c6c",22857661,1,0,1,302,109,109,0
"4280927ec4d643238aa49c32f9e06c6c","fc44e6a5f7654430af1227838224dceb",22857661,1,2,0,303,109,111,2
"fc44e6a5f7654430af1227838224dceb","fc44e6a5f7654430af1227838224dceb",22857661,2,0,1,304,111,111,0
"fc44e6a5f7654430af1227838224dceb","08111f75e22d409998cf8b85bd431f0a",22857661,1,-3,0,306,111,108,-3
"08111f75e22d409998cf8b85bd431f0a","a9ae0a3c070d455bb4369a8996313336",22857661,1,7,0,307,108,114,6
"a9ae0a3c070d455bb4369a8996313336","a9ae0a3c070d455bb4369a8996313336",22857661,1,0,1,308,114,114,0
"a9ae0a3c070d455bb4369a8996313336","e20db35ced8544ddac5bc3839145e463",22857661,1,-26,0,309,114,91,-23
"e20db35ced8544ddac5bc3839145e463","d391c8b6e56a43a7b654e9dee02d904b",22857661,1,13,0,310,91,103,12
"d391c8b6e56a43a7b654e9dee02d904b","00ae5f0c51874a73a41ebea838d95682",22857661,1,-2,0,311,103,101,-2
"00ae5f0c51874a73a41ebea838d95682","e20db35ced8544ddac5bc3839145e463",22857661,1,-11,0,312,101,91,-10
"e20db35ced8544ddac5bc3839145e463","73039f8c1eb9409cb4caee2cf968001e",22857661,1,10,0,313,91,100,9
"4280927ec4d643238aa49c32f9e06c6c","a9ae0a3c070d455bb4369a8996313336",22857661,1,6,0,315,109,114,5
"a9ae0a3c070d455bb4369a8996313336","08111f75e22d409998cf8b85bd431f0a",22857661,1,-7,0,316,114,108,-6
"08111f75e22d409998cf8b85bd431f0a","71cec822bcff4f30a20e75dc63ef7b65",22857661,1,9,0,317,108,116,8
"71cec822bcff4f30a20e75dc63ef7b65","71cec822bcff4f30a20e75dc63ef7b65",22857661,3,0,1,318,116,116,0
"71cec822bcff4f30a20e75dc63ef7b65","37319e88176d4aefa91d7a9980dbae91",22857661,1,-4,0,321,116,112,-4
"37319e88176d4aefa91d7a9980dbae91","62bff51286ef4f348717a3cf6fe2318f",22857661,1,9,0,322,112,120,8
"62bff51286ef4f348717a3cf6fe2318f","b1cd0e7dc3ad4a8eb91a4bfdbeb025b0",22857661,1,-2,0,323,120,118,-2
"b1cd0e7dc3ad4a8eb91a4bfdbeb025b0","b1cd0e7dc3ad4a8eb91a4bfdbeb025b0",22857661,3,0,1,324,118,118,0
"b1cd0e7dc3ad4a8eb91a4bfdbeb025b0","62bff51286ef4f348717a3cf6fe2318f",22857661,1,2,0,327,118,120,2
"62bff51286ef4f348717a3cf6fe2318f","62bff51286ef4f348717a3cf6fe2318f",22857661,3,0,1,328,120,120,0
"62bff51286ef4f348717a3cf6fe2318f","779f9ddd1fd14d1e9e69f72219a1fdbd",22857661,1,3,0,331,120,121,1
"779f9ddd1fd14d1e9e69f72219a1fdbd","e20db35ced8544ddac5bc3839145e463",22857661,1,-36,0,332,121,91,-30
"e20db35ced8544ddac5bc3839145e463","ae26e6cda8ad4a3f81bd347560d9579f",22857661,1,40,0,333,91,125,34
"ae26e6cda8ad4a3f81bd347560d9579f","ae26e6cda8ad4a3f81bd347560d9579f",22857661,1,0,1,334,125,125,0
"ae26e6cda8ad4a3f81bd347560d9579f","ee48df95832b4374aa273ceb27ec1315",22857661,1,1,0,335,125,126,1
"ee48df95832b4374aa273ceb27ec1315","ee48df95832b4374aa273ceb27ec1315",22857661,1,0,1,336,126,126,0
"ee48df95832b4374aa273ceb27ec1315","7a439da90b394756ad1777fc4c6dead5",22857661,1,1,0,337,126,127,1
"7a439da90b394756ad1777fc4c6dead5","7a439da90b394756ad1777fc4c6dead5",22857661,1,0,1,338,127,127,0
"7a439da90b394756ad1777fc4c6dead5","a8dd5213034441ac92724b4e83eb0bb2",22857661,1,3,0,339,127,129,2
"a8dd5213034441ac92724b4e83eb0bb2","779f9ddd1fd14d1e9e69f72219a1fdbd",22857661,1,-9,0,340,129,121,-8
"779f9ddd1fd14d1e9e69f72219a1fdbd","a8dd5213034441ac92724b4e83eb0bb2",22857661,1,9,0,341,121,129,8
"a8dd5213034441ac92724b4e83eb0bb2","8115eab6556b45f5b415c3b8c26a12e5",22857661,1,2,0,342,129,131,2
"8115eab6556b45f5b415c3b8c26a12e5","8115eab6556b45f5b415c3b8c26a12e5",22857661,2,0,1,343,131,131,0
"8115eab6556b45f5b415c3b8c26a12e5","ec34b06efd844b46a4c4818ecdb9b8f4",22857661,1,1,0,345,131,132,1
"ec34b06efd844b46a4c4818ecdb9b8f4","ec34b06efd844b46a4c4818ecdb9b8f4",22857661,2,0,1,346,132,132,0
"ec34b06efd844b46a4c4818ecdb9b8f4","c2e1c2b9eac64109b343a088584b576b",22857661,1,1,0,348,132,133,1
"c2e1c2b9eac64109b343a088584b576b","c2e1c2b9eac64109b343a088584b576b",22857661,2,0,1,349,133,133,0
"c2e1c2b9eac64109b343a088584b576b","579338175e0b4bbb8ef3b712b5d8b54e",22857661,1,-5,0,351,133,128,-5
"579338175e0b4bbb8ef3b712b5d8b54e","8bc5795d6a984a3eace4e2811e52dd4f",22857661,1,8,0,352,128,135,7
"8bc5795d6a984a3eace4e2811e52dd4f","8bc5795d6a984a3eace4e2811e52dd4f",22857661,3,0,1,353,135,135,0
"8bc5795d6a984a3eace4e2811e52dd4f","b416d47c56a742199b5d7c7f19d6503a",22857661,1,-1,0,356,135,134,-1
"b416d47c56a742199b5d7c7f19d6503a","cd4532ad48034873ba8bce2aac0c9808",22857661,1,4,0,357,134,137,3
"cd4532ad48034873ba8bce2aac0c9808","cd4532ad48034873ba8bce2aac0c9808",22857661,1,0,1,358,137,137,0
"cd4532ad48034873ba8bce2aac0c9808","779f9ddd1fd14d1e9e69f72219a1fdbd",22857661,1,-19,0,359,137,121,-16
"779f9ddd1fd14d1e9e69f72219a1fdbd","df1de691dafe4549a18a4398ee9dfaf9",22857661,1,23,0,360,121,139,18
"df1de691dafe4549a18a4398ee9dfaf9","6c5ad271a44743479bfaea29b1db8d02",22857661,2,4,0,361,139,143,4
"6c5ad271a44743479bfaea29b1db8d02","6c5ad271a44743479bfaea29b1db8d02",22857661,1,0,1,362,143,143,0
"6c5ad271a44743479bfaea29b1db8d02","83d311bed5374fee83d8d67a7d9d82dc",22857661,1,1,0,363,143,144,1
"83d311bed5374fee83d8d67a7d9d82dc","83d311bed5374fee83d8d67a7d9d82dc",22857661,1,0,1,364,144,144,0
"83d311bed5374fee83d8d67a7d9d82dc","402bba41861d43acb52a5abb89e8831e",22857661,1,1,0,365,144,145,1
"402bba41861d43acb52a5abb89e8831e","402bba41861d43acb52a5abb89e8831e",22857661,2,0,1,366,145,145,0
"402bba41861d43acb52a5abb89e8831e","df1de691dafe4549a18a4398ee9dfaf9",22857661,1,-6,0,368,145,139,-6
"df1de691dafe4549a18a4398ee9dfaf9","8aae34f5ddbb4052a709b12e6b0d40fa",22857661,1,9,0,369,139,147,8
"8aae34f5ddbb4052a709b12e6b0d40fa","df1de691dafe4549a18a4398ee9dfaf9",22857661,2,-9,0,370,147,139,-8
"6c5ad271a44743479bfaea29b1db8d02","8aae34f5ddbb4052a709b12e6b0d40fa",22857661,1,5,0,372,143,147,4
"df1de691dafe4549a18a4398ee9dfaf9","645b3f0249f64f76af2e19eb4d0e55b7",22857661,1,11,0,374,139,149,10
"645b3f0249f64f76af2e19eb4d0e55b7","645b3f0249f64f76af2e19eb4d0e55b7",22857661,5,0,1,375,149,149,0
"645b3f0249f64f76af2e19eb4d0e55b7","7e7b8db5064d4369805ab370aac5ddfb",22857661,1,1,0,380,149,150,1
"7e7b8db5064d4369805ab370aac5ddfb","7e7b8db5064d4369805ab370aac5ddfb",22857661,5,0,1,381,150,150,0
"7e7b8db5064d4369805ab370aac5ddfb","8956d210ae7f41968fada86d4c979d6a",22857661,1,1,0,386,150,151,1
"8956d210ae7f41968fada86d4c979d6a","8956d210ae7f41968fada86d4c979d6a",22857661,2,0,1,387,151,151,0
"8956d210ae7f41968fada86d4c979d6a","f902b0f41b544d4dbf79664fd233648d",22857661,1,-5,0,389,151,146,-5
"f902b0f41b544d4dbf79664fd233648d","ae781e8b775e4ccd93bc800dad5c8376",22857661,1,8,0,390,146,153,7
"ae781e8b775e4ccd93bc800dad5c8376","ae781e8b775e4ccd93bc800dad5c8376",22857661,2,0,1,391,153,153,0
"ae781e8b775e4ccd93bc800dad5c8376","06882a8492d9499aa31555567f575ecb",22857661,1,1,0,393,153,154,1
"06882a8492d9499aa31555567f575ecb","06882a8492d9499aa31555567f575ecb",22857661,1,0,1,394,154,154,0
"06882a8492d9499aa31555567f575ecb","f293c508f409466a8f27ddd7d1e40b20",22857661,1,1,0,395,154,155,1
"f293c508f409466a8f27ddd7d1e40b20","f293c508f409466a8f27ddd7d1e40b20",22857661,9,0,1,396,155,155,0
"f293c508f409466a8f27ddd7d1e40b20","cc4ddef5bbbe48ebb605141b347c4ed1",22857661,1,1,0,405,155,156,1
"cc4ddef5bbbe48ebb605141b347c4ed1","cc4ddef5bbbe48ebb605141b347c4ed1",22857661,5,0,1,406,156,156,0
"cc4ddef5bbbe48ebb605141b347c4ed1","f03480cf4eba413194d7af52fc0e7f28",22857661,1,-4,0,411,156,152,-4
"f03480cf4eba413194d7af52fc0e7f28","d313cec988a84645bee413e8d4724a4b",22857661,1,7,0,412,152,158,6
"d313cec988a84645bee413e8d4724a4b","d313cec988a84645bee413e8d4724a4b",22857661,4,0,1,413,158,158,0
"d313cec988a84645bee413e8d4724a4b","dc60696c76a74368a60f72246e47700d",22857661,1,1,0,417,158,159,1
"dc60696c76a74368a60f72246e47700d","dc60696c76a74368a60f72246e47700d",22857661,1,0,1,418,159,159,0
"dc60696c76a74368a60f72246e47700d","78adeee1fa2c4fe0bc73f7bca9fcee86",22857661,1,3,0,419,159,160,1
"78adeee1fa2c4fe0bc73f7bca9fcee86","df1de691dafe4549a18a4398ee9dfaf9",22857661,1,-26,0,420,160,139,-21
"df1de691dafe4549a18a4398ee9dfaf9","65202579580f4ad38d734b4ee39d22a8",22857661,1,31,0,421,139,164,25
"65202579580f4ad38d734b4ee39d22a8","65202579580f4ad38d734b4ee39d22a8",22857661,60,0,1,422,164,164,0
"65202579580f4ad38d734b4ee39d22a8","78adeee1fa2c4fe0bc73f7bca9fcee86",22857661,1,-5,0,424,164,160,-4
"78adeee1fa2c4fe0bc73f7bca9fcee86","65202579580f4ad38d734b4ee39d22a8",22857661,2,5,0,425,160,164,4
"65202579580f4ad38d734b4ee39d22a8","3cbcea2be0984e7dbd5a48195af10ce7",22857661,1,3,0,477,164,165,1
"3cbcea2be0984e7dbd5a48195af10ce7","78adeee1fa2c4fe0bc73f7bca9fcee86",22857661,1,-8,0,478,165,160,-5
"78adeee1fa2c4fe0bc73f7bca9fcee86","82e6285962b8400d9d6fc32436022a94",22857661,1,10,0,479,160,167,7
"82e6285962b8400d9d6fc32436022a94","3cbcea2be0984e7dbd5a48195af10ce7",22857661,2,-2,0,480,167,165,-2
"3cbcea2be0984e7dbd5a48195af10ce7","82e6285962b8400d9d6fc32436022a94",22857661,1,2,0,481,165,167,2
"3cbcea2be0984e7dbd5a48195af10ce7","a9ac840f098c4bd0a2ee896214ce29cd",22857661,1,5,0,483,165,168,3
"a9ac840f098c4bd0a2ee896214ce29cd","a9ac840f098c4bd0a2ee896214ce29cd",22857661,1,0,1,484,168,168,0
"a9ac840f098c4bd0a2ee896214ce29cd","0c7262dff33c4087bc660ccf40f92f9c",22857661,1,4,0,485,168,169,1
"0c7262dff33c4087bc660ccf40f92f9c","b2275c3fad834f8d90737a2d9a6927d6",22857661,5,3,0,486,169,172,3
"b2275c3fad834f8d90737a2d9a6927d6","3cbcea2be0984e7dbd5a48195af10ce7",22857661,1,-12,0,487,172,165,-7
"3cbcea2be0984e7dbd5a48195af10ce7","0c7262dff33c4087bc660ccf40f92f9c",22857661,1,9,0,488,165,169,4
"b2275c3fad834f8d90737a2d9a6927d6","0c7262dff33c4087bc660ccf40f92f9c",22857661,2,-3,0,490,172,169,-3
"b2275c3fad834f8d90737a2d9a6927d6","a9ac840f098c4bd0a2ee896214ce29cd",22857661,1,-7,0,492,172,168,-4
"a9ac840f098c4bd0a2ee896214ce29cd","78adeee1fa2c4fe0bc73f7bca9fcee86",22857661,1,-13,0,493,168,160,-8
"65202579580f4ad38d734b4ee39d22a8","0c7262dff33c4087bc660ccf40f92f9c",22857661,1,12,0,502,164,169,5
"b2275c3fad834f8d90737a2d9a6927d6","b2275c3fad834f8d90737a2d9a6927d6",22857661,28,0,1,506,172,172,0
"b2275c3fad834f8d90737a2d9a6927d6","eb515a26030b41f8a82a1e6114420bad",22857661,1,1,0,534,172,173,1
"eb515a26030b41f8a82a1e6114420bad","eb515a26030b41f8a82a1e6114420bad",22857661,2,0,1,535,173,173,0
"eb515a26030b41f8a82a1e6114420bad","b42cc17b7de840f181a704558d0bc845",22857661,1,3,0,537,173,175,2
"b42cc17b7de840f181a704558d0bc845","0c7262dff33c4087bc660ccf40f92f9c",22857661,1,-7,0,538,175,169,-6
"0c7262dff33c4087bc660ccf40f92f9c","b42cc17b7de840f181a704558d0bc845",22857661,1,7,0,539,169,175,6
"b42cc17b7de840f181a704558d0bc845","801f9e9135034f49bf5f8b4bdefedb41",22857661,1,2,0,540,175,177,2
"801f9e9135034f49bf5f8b4bdefedb41","801f9e9135034f49bf5f8b4bdefedb41",22857661,10,0,1,541,177,177,0
"801f9e9135034f49bf5f8b4bdefedb41","362fcb0699a14845ab29b2340093e528",22857661,1,-3,0,551,177,174,-3
"362fcb0699a14845ab29b2340093e528","ea38cc0e6e6e41edbabf210220808bf9",22857661,1,6,0,552,174,179,5
"ea38cc0e6e6e41edbabf210220808bf9","b87c552dd247427abe6ab5795b9c9d43",22857661,3,2,0,553,179,181,2
"b87c552dd247427abe6ab5795b9c9d43","0c7262dff33c4087bc660ccf40f92f9c",22857661,1,-14,0,554,181,169,-12
"0c7262dff33c4087bc660ccf40f92f9c","ea38cc0e6e6e41edbabf210220808bf9",22857661,1,12,0,555,169,179,10
"b87c552dd247427abe6ab5795b9c9d43","ea38cc0e6e6e41edbabf210220808bf9",22857661,1,-2,0,557,181,179,-2
"b87c552dd247427abe6ab5795b9c9d43","b87c552dd247427abe6ab5795b9c9d43",22857661,7,0,1,559,181,181,0
"b87c552dd247427abe6ab5795b9c9d43","139b097acfca451689d80c9c6eebdf7b",22857661,1,-3,0,566,181,178,-3
"139b097acfca451689d80c9c6eebdf7b","30f660a1feb34582a739722532524f79",22857661,1,6,0,567,178,183,5
"30f660a1feb34582a739722532524f79","30f660a1feb34582a739722532524f79",22857661,9,0,1,568,183,183,0
"30f660a1feb34582a739722532524f79","2024b4885bd14338a39b7b509acbbd02",22857661,1,-1,0,577,183,182,-1
"2024b4885bd14338a39b7b509acbbd02","c3f63fe50d8e487c86bf8ef76c9cadd3",22857661,1,4,0,578,182,185,3
"c3f63fe50d8e487c86bf8ef76c9cadd3","c3f63fe50d8e487c86bf8ef76c9cadd3",22857661,1,0,1,579,185,185,0
"c3f63fe50d8e487c86bf8ef76c9cadd3","0c7262dff33c4087bc660ccf40f92f9c",22857661,1,-20,0,580,185,169,-16
"0c7262dff33c4087bc660ccf40f92f9c","c8e371568a0c4391b25796ae4e91952e",22857661,1,23,0,581,169,186,17
"c8e371568a0c4391b25796ae4e91952e","7d932b23e1c84326ae5aa4d3c0d813d1",22857661,1,2,0,582,186,188,2
"7d932b23e1c84326ae5aa4d3c0d813d1","7d932b23e1c84326ae5aa4d3c0d813d1",22857661,1,0,1,583,188,188,0
"7d932b23e1c84326ae5aa4d3c0d813d1","c8e371568a0c4391b25796ae4e91952e",22857661,1,-2,0,584,188,186,-2
"c8e371568a0c4391b25796ae4e91952e","ab11d94c6c8948ea90b88f19d2cd502b",22857661,1,5,0,585,186,190,4
"ab11d94c6c8948ea90b88f19d2cd502b","ab11d94c6c8948ea90b88f19d2cd502b",22857661,3,0,1,586,190,190,0
"ab11d94c6c8948ea90b88f19d2cd502b","f992451ed6ad4e68bb9e68ad6be7c4be",22857661,1,2,0,589,190,192,2
"f992451ed6ad4e68bb9e68ad6be7c4be","f992451ed6ad4e68bb9e68ad6be7c4be",22857661,1,0,1,590,192,192,0
"f992451ed6ad4e68bb9e68ad6be7c4be","07b44a7a51e94c78b411c753fc39dab0",22857661,1,-3,0,591,192,189,-3
"07b44a7a51e94c78b411c753fc39dab0","6cd2dcaac46847d4a0bc53f296d90375",22857661,1,6,0,592,189,194,5
"6cd2dcaac46847d4a0bc53f296d90375","6cd2dcaac46847d4a0bc53f296d90375",22857661,1,0,1,593,194,194,0
"6cd2dcaac46847d4a0bc53f296d90375","2d2580c9411c4972909db508d6956a58",22857661,1,2,0,594,194,196,2
"2d2580c9411c4972909db508d6956a58","2d2580c9411c4972909db508d6956a58",22857661,5,0,1,595,196,196,0
"2d2580c9411c4972909db508d6956a58","5bddb3d9ed264f3984702f048c7e5340",22857661,1,1,0,600,196,197,1
"5bddb3d9ed264f3984702f048c7e5340","5bddb3d9ed264f3984702f048c7e5340",22857661,2,0,1,601,197,197,0
"5bddb3d9ed264f3984702f048c7e5340","d5e8e2bd12a2466b9d6d90855f0eb079",22857661,1,1,0,603,197,198,1
"d5e8e2bd12a2466b9d6d90855f0eb079","d5e8e2bd12a2466b9d6d90855f0eb079",22857661,2,0,1,604,198,198,0
"d5e8e2bd12a2466b9d6d90855f0eb079","017d7ca8e0394b91aaadc9574df2202c",22857661,1,-5,0,606,198,193,-5
"017d7ca8e0394b91aaadc9574df2202c","54e8e9f0ea3e45c4bf3b8ac799ee31b1",22857661,1,8,0,607,193,200,7
"54e8e9f0ea3e45c4bf3b8ac799ee31b1","54e8e9f0ea3e45c4bf3b8ac799ee31b1",22857661,1,0,1,608,200,200,0
"54e8e9f0ea3e45c4bf3b8ac799ee31b1","c614a00911be4877a075f19315530fb0",22857661,1,1,0,609,200,201,1
"c614a00911be4877a075f19315530fb0","c614a00911be4877a075f19315530fb0",22857661,6,0,1,610,201,201,0
"c614a00911be4877a075f19315530fb0","bb329d880ab54120adaf203a693bb203",22857661,1,2,0,616,201,203,2
"bb329d880ab54120adaf203a693bb203","bb329d880ab54120adaf203a693bb203",22857661,1,0,1,617,203,203,0
"bb329d880ab54120adaf203a693bb203","f9170dd6bc6442b4acd832747609b09a",22857661,1,-4,0,618,203,199,-4
"f9170dd6bc6442b4acd832747609b09a","334c2344009840079b1d0e1b7ce3d5a7",22857661,1,7,0,619,199,205,6
"334c2344009840079b1d0e1b7ce3d5a7","334c2344009840079b1d0e1b7ce3d5a7",22857661,1,0,1,620,205,205,0
"334c2344009840079b1d0e1b7ce3d5a7","d7f13c8d63ec4e2aa673fbb9cf9c6933",22857661,1,3,0,621,205,206,1
"d7f13c8d63ec4e2aa673fbb9cf9c6933","c8e371568a0c4391b25796ae4e91952e",22857661,1,-26,0,622,206,186,-20
"c8e371568a0c4391b25796ae4e91952e","7108f0e4c2584f1f9c471689ae4c885c",22857661,1,28,0,623,186,208,22
"7108f0e4c2584f1f9c471689ae4c885c","b9e80f77c3a44349863b19875725c384",22857661,1,-1,0,624,208,207,-1
"b9e80f77c3a44349863b19875725c384","b9e80f77c3a44349863b19875725c384",22857661,14,0,1,625,207,207,0
"b9e80f77c3a44349863b19875725c384","7108f0e4c2584f1f9c471689ae4c885c",22857661,1,1,0,639,207,208,1
"7108f0e4c2584f1f9c471689ae4c885c","7108f0e4c2584f1f9c471689ae4c885c",22857661,10,0,1,640,208,208,0
"7108f0e4c2584f1f9c471689ae4c885c","09400e101c5d4b439cf9a26b03aae558",22857661,1,3,0,650,208,210,2
"09400e101c5d4b439cf9a26b03aae558","d7f13c8d63ec4e2aa673fbb9cf9c6933",22857661,1,-5,0,651,210,206,-4
"d7f13c8d63ec4e2aa673fbb9cf9c6933","09400e101c5d4b439cf9a26b03aae558",22857661,1,5,0,652,206,210,4
"09400e101c5d4b439cf9a26b03aae558","a88efa7e50ce47159810ab553afa6d3a",22857661,1,2,0,653,210,212,2
"a88efa7e50ce47159810ab553afa6d3a","a88efa7e50ce47159810ab553afa6d3a",22857661,5,0,1,654,212,212,0
"a88efa7e50ce47159810ab553afa6d3a","a875096404ef4a9984b62d74cda916f9",22857661,1,-3,0,659,212,209,-3
"a875096404ef4a9984b62d74cda916f9","f7fb1952f56b4189b86a9f8b7862d2b8",22857661,1,7,0,660,209,215,6
"f7fb1952f56b4189b86a9f8b7862d2b8","be502a7a43c44bf7b682698de79d9369",22857661,1,-1,0,661,215,214,-1
"be502a7a43c44bf7b682698de79d9369","be502a7a43c44bf7b682698de79d9369",22857661,1,0,1,662,214,214,0
"be502a7a43c44bf7b682698de79d9369","f7fb1952f56b4189b86a9f8b7862d2b8",22857661,1,1,0,663,214,215,1
"f7fb1952f56b4189b86a9f8b7862d2b8","f7fb1952f56b4189b86a9f8b7862d2b8",22857661,13,0,1,664,215,215,0
"f7fb1952f56b4189b86a9f8b7862d2b8","b860ee85d8bc4a2f97958cfb71be3533",22857661,1,1,0,677,215,216,1
"b860ee85d8bc4a2f97958cfb71be3533","b860ee85d8bc4a2f97958cfb71be3533",22857661,2,0,1,678,216,216,0
"b860ee85d8bc4a2f97958cfb71be3533","363837c182e04711840d896ae1e0339c",22857661,1,3,0,680,216,218,2
"363837c182e04711840d896ae1e0339c","ec341f459285443b8361f7f15638ff08",22857661,1,-6,0,681,218,213,-5
"ec341f459285443b8361f7f15638ff08","363837c182e04711840d896ae1e0339c",22857661,1,6,0,682,213,218,5
"363837c182e04711840d896ae1e0339c","363837c182e04711840d896ae1e0339c",22857661,13,0,1,683,218,218,0
"363837c182e04711840d896ae1e0339c","01b2051f8941460d89945e3b02d1ce78",22857661,1,-1,0,696,218,217,-1
"01b2051f8941460d89945e3b02d1ce78","91125ca626c5470eb145501f8c37f8db",22857661,1,4,0,697,217,220,3
"91125ca626c5470eb145501f8c37f8db","91125ca626c5470eb145501f8c37f8db",22857661,1,0,1,698,220,220,0
"91125ca626c5470eb145501f8c37f8db","1c6721b1f63f4d30ba7746ea8af02a52",22857661,1,3,0,699,220,221,1
"1c6721b1f63f4d30ba7746ea8af02a52","d7f13c8d63ec4e2aa673fbb9cf9c6933",22857661,1,-21,0,700,221,206,-15
"d7f13c8d63ec4e2aa673fbb9cf9c6933","77ecef8eff6b4a2caea7707669bf7475",22857661,1,22,0,701,206,222,16
"77ecef8eff6b4a2caea7707669bf7475","77ecef8eff6b4a2caea7707669bf7475",22857661,12,0,1,702,222,222,0
"77ecef8eff6b4a2caea7707669bf7475","8b9ae98743bd4d4a8a87dff1c1244211",22857661,1,6,0,714,222,227,5
"8b9ae98743bd4d4a8a87dff1c1244211","d03cb855c70044cf8c35d9ec0de696e3",22857661,1,-3,0,715,227,224,-3
"d03cb855c70044cf8c35d9ec0de696e3","1c6721b1f63f4d30ba7746ea8af02a52",22857661,1,-4,0,716,224,221,-3
"1c6721b1f63f4d30ba7746ea8af02a52","d03cb855c70044cf8c35d9ec0de696e3",22857661,1,4,0,717,221,224,3
"d03cb855c70044cf8c35d9ec0de696e3","a49a937d6896486d9a5396654abcf2e1",22857661,1,2,0,718,224,226,2
"a49a937d6896486d9a5396654abcf2e1","a49a937d6896486d9a5396654abcf2e1",22857661,5,0,1,719,226,226,0
"a49a937d6896486d9a5396654abcf2e1","8b9ae98743bd4d4a8a87dff1c1244211",22857661,1,1,0,724,226,227,1
"8b9ae98743bd4d4a8a87dff1c1244211","8b9ae98743bd4d4a8a87dff1c1244211",22857661,15,0,1,725,227,227,0
"8b9ae98743bd4d4a8a87dff1c1244211","f7906d6f59b9489a91d2ef40db5a474d",22857661,1,-4,0,740,227,223,-4
"f7906d6f59b9489a91d2ef40db5a474d","2ab1535aac1346ba8801535bf729ef37",22857661,1,7,0,741,223,229,6
"2ab1535aac1346ba8801535bf729ef37","2ab1535aac1346ba8801535bf729ef37",22857661,1,0,1,742,229,229,0
"2ab1535aac1346ba8801535bf729ef37","a4f40fb48a8542c8949bae1f002cd9bc",22857661,1,2,0,743,229,231,2
"a4f40fb48a8542c8949bae1f002cd9bc","a4f40fb48a8542c8949bae1f002cd9bc",22857661,2,0,1,744,231,231,0
"a4f40fb48a8542c8949bae1f002cd9bc","8972c23e32044edb8a78fa1eed4e5947",22857661,1,1,0,746,231,232,1
"8972c23e32044edb8a78fa1eed4e5947","8972c23e32044edb8a78fa1eed4e5947",22857661,1,0,1,747,232,232,0
"8972c23e32044edb8a78fa1eed4e5947","92feb4a40f8344d38b6f722e42a53295",22857661,1,1,0,748,232,233,1
"92feb4a40f8344d38b6f722e42a53295","92feb4a40f8344d38b6f722e42a53295",22857661,2,0,1,749,233,233,0
"92feb4a40f8344d38b6f722e42a53295","5152833676bf4c6cb317060be10f68db",22857661,1,-5,0,751,233,228,-5
"5152833676bf4c6cb317060be10f68db","ca3e28f290354c08aefe5b0f769604e6",22857661,1,8,0,752,228,235,7
"ca3e28f290354c08aefe5b0f769604e6","ca3e28f290354c08aefe5b0f769604e6",22857661,4,0,1,753,235,235,0
"ca3e28f290354c08aefe5b0f769604e6","79a35eea833e4c2c9d22fc53c3c6445c",22857661,1,1,0,757,235,236,1
"79a35eea833e4c2c9d22fc53c3c6445c","79a35eea833e4c2c9d22fc53c3c6445c",22857661,4,0,1,758,236,236,0
"79a35eea833e4c2c9d22fc53c3c6445c","8f68228b1518449e9615cdafee41a2bd",22857661,1,1,0,762,236,237,1
"8f68228b1518449e9615cdafee41a2bd","8f68228b1518449e9615cdafee41a2bd",22857661,1,0,1,763,237,237,0
"8f68228b1518449e9615cdafee41a2bd","cab89fa5c3ed45a5aa550fc0352d6a42",22857661,1,1,0,764,237,238,1
"cab89fa5c3ed45a5aa550fc0352d6a42","cab89fa5c3ed45a5aa550fc0352d6a42",22857661,3,0,1,765,238,238,0
"cab89fa5c3ed45a5aa550fc0352d6a42","66d4fad4f1cf4b46be0750a99ad7a35a",22857661,1,1,0,768,238,239,1
"66d4fad4f1cf4b46be0750a99ad7a35a","66d4fad4f1cf4b46be0750a99ad7a35a",22857661,1,0,1,769,239,239,0
"66d4fad4f1cf4b46be0750a99ad7a35a","0b04c8e2f86d48c7aeb7e225819cd32b",22857661,1,-5,0,770,239,234,-5
"0b04c8e2f86d48c7aeb7e225819cd32b","f53da5fd9bfe412da4b80d4742563b6c",22857661,1,8,0,771,234,241,7
"f53da5fd9bfe412da4b80d4742563b6c","f53da5fd9bfe412da4b80d4742563b6c",22857661,1,0,1,772,241,241,0
"f53da5fd9bfe412da4b80d4742563b6c","1c6721b1f63f4d30ba7746ea8af02a52",22857661,1,-24,0,773,241,221,-20
"1c6721b1f63f4d30ba7746ea8af02a52","2ae94c0cea4d480a9d5dca8fb1d7b542",22857661,1,27,0,774,221,242,21
"2ae94c0cea4d480a9d5dca8fb1d7b542","1ebf23f9d994469a85206e4c7b1bf5f5",22857661,1,3,0,775,242,245,3
"1ebf23f9d994469a85206e4c7b1bf5f5","1ebf23f9d994469a85206e4c7b1bf5f5",22857661,12,0,1,776,245,245,0
"1ebf23f9d994469a85206e4c7b1bf5f5","85ae675b83e8422da842cfd25596af99",22857661,1,1,0,788,245,246,1
"85ae675b83e8422da842cfd25596af99","fa235f0f364d47e4ae1c87f47bf8e6ba",22857661,2,8,0,789,246,252,6
"fa235f0f364d47e4ae1c87f47bf8e6ba","2ae94c0cea4d480a9d5dca8fb1d7b542",22857661,1,-12,0,790,252,242,-10
"2ae94c0cea4d480a9d5dca8fb1d7b542","85ae675b83e8422da842cfd25596af99",22857661,1,4,0,791,242,246,4
"fa235f0f364d47e4ae1c87f47bf8e6ba","79f7845465cc4ed19d8e4f1429541be0",22857661,1,2,0,793,252,254,2
"79f7845465cc4ed19d8e4f1429541be0","79f7845465cc4ed19d8e4f1429541be0",22857661,2,0,1,794,254,254,0
"79f7845465cc4ed19d8e4f1429541be0","6e83e23f56544a19b94067c1c558d9c0",22857661,1,-8,0,796,254,247,-7
"6e83e23f56544a19b94067c1c558d9c0","00f61990949545828dd12f1303d47504",22857661,1,11,0,797,247,256,9
"00f61990949545828dd12f1303d47504","00f61990949545828dd12f1303d47504",22857661,1,0,1,798,256,256,0
"00f61990949545828dd12f1303d47504","ead7bb4b64e247d2ae632ab8a296b091",22857661,1,2,0,799,256,258,2
"ead7bb4b64e247d2ae632ab8a296b091","ead7bb4b64e247d2ae632ab8a296b091",22857661,2,0,1,800,258,258,0
"ead7bb4b64e247d2ae632ab8a296b091","41b0048dde734bb280bac6116baa8e27",22857661,1,1,0,802,258,259,1
"41b0048dde734bb280bac6116baa8e27","41b0048dde734bb280bac6116baa8e27",22857661,2,0,1,803,259,259,0
"41b0048dde734bb280bac6116baa8e27","b41c5a094a604ee0915327da5cc0beb7",22857661,1,1,0,805,259,260,1
"b41c5a094a604ee0915327da5cc0beb7","b41c5a094a604ee0915327da5cc0beb7",22857661,2,0,1,806,260,260,0
"b41c5a094a604ee0915327da5cc0beb7","d546341988904f069cfa86b21457d9d9",22857661,1,-10,0,808,260,251,-9
"d546341988904f069cfa86b21457d9d9","28c171777c52431ab6b925073bd63d46",22857661,1,15,0,809,251,264,13
"28c171777c52431ab6b925073bd63d46","28c171777c52431ab6b925073bd63d46",22857661,3,0,1,810,264,264,0
"28c171777c52431ab6b925073bd63d46","ac160db940cb49ae8579162b1d52bb5d",22857661,1,2,0,813,264,266,2
"ac160db940cb49ae8579162b1d52bb5d","ac160db940cb49ae8579162b1d52bb5d",22857661,3,0,1,814,266,266,0
"ac160db940cb49ae8579162b1d52bb5d","d989ebcfc12a4b669f0100dc1aa14f1e",22857661,1,-12,0,817,266,255,-11
"d989ebcfc12a4b669f0100dc1aa14f1e","c6fd49b485cc4874b0bbdd9c6171e09c",22857661,1,15,0,818,255,268,13
"c6fd49b485cc4874b0bbdd9c6171e09c","c6fd49b485cc4874b0bbdd9c6171e09c",22857661,3,0,1,819,268,268,0
"c6fd49b485cc4874b0bbdd9c6171e09c","44240778a97c4af0937817499b75707b",22857661,1,1,0,822,268,269,1
"44240778a97c4af0937817499b75707b","44240778a97c4af0937817499b75707b",22857661,2,0,1,823,269,269,0
"44240778a97c4af0937817499b75707b","7aa76d3e993840d8805f097cbdbcd44b",22857661,1,-9,0,825,269,261,-8
"7aa76d3e993840d8805f097cbdbcd44b","865a4d3b43374da7944dc7d397f566d9",22857661,1,12,0,826,261,271,10
"865a4d3b43374da7944dc7d397f566d9","865a4d3b43374da7944dc7d397f566d9",22857661,3,0,1,827,271,271,0
"865a4d3b43374da7944dc7d397f566d9","2ae94c0cea4d480a9d5dca8fb1d7b542",22857661,1,-35,0,830,271,242,-29
"2ae94c0cea4d480a9d5dca8fb1d7b542","0d987bed3ffa4ed0b9a2e62e97b7b30f",22857661,1,38,0,831,242,272,30
"0d987bed3ffa4ed0b9a2e62e97b7b30f","0d987bed3ffa4ed0b9a2e62e97b7b30f",22857661,6,0,1,832,272,272,0
"0d987bed3ffa4ed0b9a2e62e97b7b30f","bb5a47f5ea01454a8b79455422d3b9da",22857661,3,10,0,833,272,280,8
"bb5a47f5ea01454a8b79455422d3b9da","82ae07bc0c9b4570a41799290d1ef399",22857661,2,-6,0,834,280,275,-5
"82ae07bc0c9b4570a41799290d1ef399","bb5a47f5ea01454a8b79455422d3b9da",22857661,2,6,0,835,275,280,5
"bb5a47f5ea01454a8b79455422d3b9da","0c7262dff33c4087bc660ccf40f92f9c",22857661,2,-145,0,842,280,169,-111
"0c7262dff33c4087bc660ccf40f92f9c","0d987bed3ffa4ed0b9a2e62e97b7b30f",22857661,2,135,0,843,169,272,103
"bb5a47f5ea01454a8b79455422d3b9da","0d987bed3ffa4ed0b9a2e62e97b7b30f",22857661,1,-10,0,892,280,272,-8
"bb5a47f5ea01454a8b79455422d3b9da","94cecc3f1e7d484b8e068e79241dfd73",22857661,1,3,0,934,280,281,1
"94cecc3f1e7d484b8e068e79241dfd73","0d987bed3ffa4ed0b9a2e62e97b7b30f",22857661,1,-13,0,935,281,272,-9
"0d987bed3ffa4ed0b9a2e62e97b7b30f","a37477c4e4c14169ad44b06b493007f6",22857661,1,15,0,936,272,283,11
"a37477c4e4c14169ad44b06b493007f6","fab84b4fab5940efb4ea868ef8d09396",22857661,2,3,0,937,283,284,1
"fab84b4fab5940efb4ea868ef8d09396","94cecc3f1e7d484b8e068e79241dfd73",22857661,2,-5,0,938,284,281,-3
"94cecc3f1e7d484b8e068e79241dfd73","fab84b4fab5940efb4ea868ef8d09396",22857661,2,5,0,939,281,284,3
"fab84b4fab5940efb4ea868ef8d09396","4a29443515bb404cb8924e1c60a63b73",22857661,2,4,0,940,284,285,1
"4a29443515bb404cb8924e1c60a63b73","208c9b2796c944db8dacaa96082520ea",22857661,2,3,0,941,285,288,3
"208c9b2796c944db8dacaa96082520ea","94cecc3f1e7d484b8e068e79241dfd73",22857661,1,-12,0,942,288,281,-7
"94cecc3f1e7d484b8e068e79241dfd73","94cecc3f1e7d484b8e068e79241dfd73",22857661,1,0,1,943,281,281,0
"94cecc3f1e7d484b8e068e79241dfd73","a37477c4e4c14169ad44b06b493007f6",22857661,3,2,0,944,281,283,2
"a37477c4e4c14169ad44b06b493007f6","94cecc3f1e7d484b8e068e79241dfd73",22857661,2,-2,0,945,283,281,-2
"4a29443515bb404cb8924e1c60a63b73","4a29443515bb404cb8924e1c60a63b73",22857661,1,0,1,953,285,285,0
"208c9b2796c944db8dacaa96082520ea","208c9b2796c944db8dacaa96082520ea",22857661,1,0,1,955,288,288,0
"208c9b2796c944db8dacaa96082520ea","4a29443515bb404cb8924e1c60a63b73",22857661,1,-3,0,956,288,285,-3
"4a29443515bb404cb8924e1c60a63b73","7669a956527947d0add87455277e80b4",22857661,1,7,0,957,285,291,6
"7669a956527947d0add87455277e80b4","7669a956527947d0add87455277e80b4",22857661,1,0,1,958,291,291,0
"7669a956527947d0add87455277e80b4","869e967078f04da18dd0b0b9389a7424",22857661,1,3,0,959,291,293,2
"869e967078f04da18dd0b0b9389a7424","6a9a3b5bde4a48daa896fe8c06eca56f",22857661,1,-5,0,960,293,289,-4
"6a9a3b5bde4a48daa896fe8c06eca56f","869e967078f04da18dd0b0b9389a7424",22857661,1,5,0,961,289,293,4
"869e967078f04da18dd0b0b9389a7424","51ab6291537748fab90d519aa09889d6",22857661,1,2,0,962,293,295,2
"51ab6291537748fab90d519aa09889d6","51ab6291537748fab90d519aa09889d6",22857661,5,0,1,963,295,295,0
"51ab6291537748fab90d519aa09889d6","34a6e49023fc4465bd5ca604330bbd1c",22857661,1,-3,0,968,295,292,-3
"34a6e49023fc4465bd5ca604330bbd1c","ba0e59461bfb4a44b7b1c28a01f8d3b3",22857661,1,9,0,969,292,299,7
"ba0e59461bfb4a44b7b1c28a01f8d3b3","21592f2a9e9c4b2f8c66ec5dbcbf6a2b",22857661,1,-4,0,970,299,296,-3
"21592f2a9e9c4b2f8c66ec5dbcbf6a2b","ba0e59461bfb4a44b7b1c28a01f8d3b3",22857661,1,4,0,971,296,299,3
"ba0e59461bfb4a44b7b1c28a01f8d3b3","0e0b36e731a645e7b1b8a88f5031ca38",22857661,1,2,0,972,299,301,2
"0e0b36e731a645e7b1b8a88f5031ca38","0e0b36e731a645e7b1b8a88f5031ca38",22857661,8,0,1,973,301,301,0
"0e0b36e731a645e7b1b8a88f5031ca38","a66a144637284c21afc6de17fea4bfb8",22857661,1,1,0,981,301,302,1
"a66a144637284c21afc6de17fea4bfb8","a66a144637284c21afc6de17fea4bfb8",22857661,2,0,1,982,302,302,0
"a66a144637284c21afc6de17fea4bfb8","7646a919d7e64fa990bca9b024ff089d",22857661,1,-4,0,984,302,298,-4
"7646a919d7e64fa990bca9b024ff089d","e390b575229748ea8aac9364efe2bf00",22857661,1,7,0,985,298,304,6
"e390b575229748ea8aac9364efe2bf00","e390b575229748ea8aac9364efe2bf00",22857661,1,0,1,986,304,304,0
"e390b575229748ea8aac9364efe2bf00","3434c10e561d488a914e0f7d71907abd",22857661,1,3,0,987,304,305,1
"3434c10e561d488a914e0f7d71907abd","4a29443515bb404cb8924e1c60a63b73",22857661,1,-27,0,988,305,285,-20
"4a29443515bb404cb8924e1c60a63b73","53e7e900392747ccad52e711ab0f80d8",22857661,1,29,0,989,285,307,22
"53e7e900392747ccad52e711ab0f80d8","53e7e900392747ccad52e711ab0f80d8",22857661,1,0,1,990,307,307,0
"53e7e900392747ccad52e711ab0f80d8","130acc2aeb0448fdbb2de63bc5cebe5b",22857661,1,3,0,991,307,309,2
"130acc2aeb0448fdbb2de63bc5cebe5b","3434c10e561d488a914e0f7d71907abd",22857661,1,-5,0,992,309,305,-4
"3434c10e561d488a914e0f7d71907abd","130acc2aeb0448fdbb2de63bc5cebe5b",22857661,1,5,0,993,305,309,4
"130acc2aeb0448fdbb2de63bc5cebe5b","9c062b3251034ebe90f5054e2a3b5120",22857661,1,2,0,994,309,311,2
"9c062b3251034ebe90f5054e2a3b5120","9c062b3251034ebe90f5054e2a3b5120",22857661,2,0,1,995,311,311,0
"9c062b3251034ebe90f5054e2a3b5120","ea859f8207e44537889daeaba13ac2e8",22857661,1,1,0,997,311,312,1
"ea859f8207e44537889daeaba13ac2e8","ea859f8207e44537889daeaba13ac2e8",22857661,1,0,1,998,312,312,0
"ea859f8207e44537889daeaba13ac2e8","56d94971a7a94257aa330183a8ebd0ea",22857661,1,1,0,999,312,313,1
"56d94971a7a94257aa330183a8ebd0ea","56d94971a7a94257aa330183a8ebd0ea",22857661,1,0,1,1000,313,313,0
"56d94971a7a94257aa330183a8ebd0ea","141c0df6cd1946539aadd1c9b7068cd4",22857661,1,-5,0,1001,313,308,-5
"141c0df6cd1946539aadd1c9b7068cd4","13255e63e0aa4abf85e5211bf613d43e",22857661,1,10,0,1002,308,317,9
"13255e63e0aa4abf85e5211bf613d43e","13255e63e0aa4abf85e5211bf613d43e",22857661,1,0,1,1003,317,317,0
"13255e63e0aa4abf85e5211bf613d43e","86c27d40179e419c8e9d150fb6afa5d0",22857661,1,3,0,1004,317,319,2
"86c27d40179e419c8e9d150fb6afa5d0","0c787d16c9504873b1a4d903cec09948",22857661,1,-6,0,1005,319,314,-5
"0c787d16c9504873b1a4d903cec09948","86c27d40179e419c8e9d150fb6afa5d0",22857661,1,6,0,1006,314,319,5
"86c27d40179e419c8e9d150fb6afa5d0","47edbb64109243e6b0f8f64cdef90c6c",22857661,1,8,0,1007,319,326,7
"47edbb64109243e6b0f8f64cdef90c6c","8d7e0b55cf9849cda222a0f2440cec55",22857661,1,-9,0,1008,326,318,-8
"8d7e0b55cf9849cda222a0f2440cec55","24f1363179ad4aaa965484a78471912b",22857661,1,6,0,1009,318,323,5
"24f1363179ad4aaa965484a78471912b","24f1363179ad4aaa965484a78471912b",22857661,1,0,1,1010,323,323,0
"24f1363179ad4aaa965484a78471912b","3628bdce1dd2429ba924d2d4d09448d2",22857661,1,-1,0,1011,323,322,-1
"3628bdce1dd2429ba924d2d4d09448d2","56b3fd1a212a4764be39d979fde3326e",22857661,1,7,0,1012,322,328,6
"56b3fd1a212a4764be39d979fde3326e","56b3fd1a212a4764be39d979fde3326e",22857661,1,0,1,1013,328,328,0
"56b3fd1a212a4764be39d979fde3326e","0c4079457ede49e3aeb5e86ed84bdf35",22857661,1,3,0,1014,328,329,1
"0c4079457ede49e3aeb5e86ed84bdf35","3434c10e561d488a914e0f7d71907abd",22857661,1,-31,0,1015,329,305,-24
"3434c10e561d488a914e0f7d71907abd","38aea304b4fa46e1b29bb72f5cea4c93",22857661,1,33,0,1016,305,331,26
"38aea304b4fa46e1b29bb72f5cea4c93","38aea304b4fa46e1b29bb72f5cea4c93",22857661,1,0,1,1017,331,331,0
"38aea304b4fa46e1b29bb72f5cea4c93","e36d261332f14e79bb4b467aceaeb9b5",22857661,1,2,0,1018,331,333,2
"e36d261332f14e79bb4b467aceaeb9b5","e36d261332f14e79bb4b467aceaeb9b5",22857661,1,0,1,1019,333,333,0
"e36d261332f14e79bb4b467aceaeb9b5","c7e89b9d04744d2eab742fc24e3ef1ae",22857661,1,1,0,1020,333,334,1
"c7e89b9d04744d2eab742fc24e3ef1ae","c7e89b9d04744d2eab742fc24e3ef1ae",22857661,2,0,1,1021,334,334,0
"c7e89b9d04744d2eab742fc24e3ef1ae","fe49f8054b374a0ea4bb266ed135ff62",22857661,1,1,0,1023,334,335,1
"fe49f8054b374a0ea4bb266ed135ff62","fe49f8054b374a0ea4bb266ed135ff62",22857661,2,0,1,1024,335,335,0
"fe49f8054b374a0ea4bb266ed135ff62","d0a8f74af98642fe8360d22c42e45117",22857661,1,1,0,1026,335,336,1
"d0a8f74af98642fe8360d22c42e45117","d0a8f74af98642fe8360d22c42e45117",22857661,2,0,1,1027,336,336,0
"d0a8f74af98642fe8360d22c42e45117","0c4079457ede49e3aeb5e86ed84bdf35",22857661,1,-7,0,1029,336,329,-7
"0c4079457ede49e3aeb5e86ed84bdf35","a7c6339ca1da4368a18d471f0519f877",22857661,1,11,0,1030,329,339,10
"a7c6339ca1da4368a18d471f0519f877","a7c6339ca1da4368a18d471f0519f877",22857661,1,0,1,1031,339,339,0
"a7c6339ca1da4368a18d471f0519f877","bbc5139ca9024389a94db3a6f47dcff6",22857661,1,3,0,1032,339,341,2
"bbc5139ca9024389a94db3a6f47dcff6","b8b9418ab322418d9db9b40d96af873a",22857661,1,-5,0,1033,341,337,-4
"b8b9418ab322418d9db9b40d96af873a","bbc5139ca9024389a94db3a6f47dcff6",22857661,1,5,0,1034,337,341,4
"bbc5139ca9024389a94db3a6f47dcff6","4ee6ca9019ab4a1ab323f98094a9bd77",22857661,1,2,0,1035,341,343,2
"4ee6ca9019ab4a1ab323f98094a9bd77","4ee6ca9019ab4a1ab323f98094a9bd77",22857661,2,0,1,1036,343,343,0
"4ee6ca9019ab4a1ab323f98094a9bd77","b37947176785476f8b29d49a851366dc",22857661,1,1,0,1038,343,344,1
"b37947176785476f8b29d49a851366dc","b37947176785476f8b29d49a851366dc",22857661,2,0,1,1039,344,344,0
"b37947176785476f8b29d49a851366dc","fcea5b10d5a14a3b9324ffece8f6e1e5",22857661,1,1,0,1041,344,345,1
"fcea5b10d5a14a3b9324ffece8f6e1e5","fcea5b10d5a14a3b9324ffece8f6e1e5",22857661,2,0,1,1042,345,345,0
"fcea5b10d5a14a3b9324ffece8f6e1e5","c2490bc612d146edbe786556fab3651b",22857661,1,-5,0,1044,345,340,-5
"c2490bc612d146edbe786556fab3651b","6ac8bb048b854999a47edb35fe627f11",22857661,1,8,0,1045,340,347,7
"6ac8bb048b854999a47edb35fe627f11","6ac8bb048b854999a47edb35fe627f11",22857661,1,0,1,1046,347,347,0
"6ac8bb048b854999a47edb35fe627f11","30ead9794d4847abaf222ca966cc8630",22857661,1,3,0,1047,347,348,1
"30ead9794d4847abaf222ca966cc8630","0c4079457ede49e3aeb5e86ed84bdf35",22857661,1,-24,0,1048,348,329,-19
"0c4079457ede49e3aeb5e86ed84bdf35","eff0de7f2dbb42dfa1a2e686efab5b6d",22857661,1,30,0,1049,329,354,25
"eff0de7f2dbb42dfa1a2e686efab5b6d","09b9678ddc3d452ea4a3d46e15826065",22857661,1,-1,0,1050,354,353,-1
"09b9678ddc3d452ea4a3d46e15826065","897b7f51242c44aab2205c72fdcbf4cd",22857661,1,-1,0,1051,353,352,-1
"897b7f51242c44aab2205c72fdcbf4cd","c20993c944444fe085345591a8bd837e",22857661,1,-1,0,1052,352,351,-1
"c20993c944444fe085345591a8bd837e","c20993c944444fe085345591a8bd837e",22857661,4,0,1,1053,351,351,0
"c20993c944444fe085345591a8bd837e","897b7f51242c44aab2205c72fdcbf4cd",22857661,1,1,0,1057,351,352,1
"897b7f51242c44aab2205c72fdcbf4cd","897b7f51242c44aab2205c72fdcbf4cd",22857661,3,0,1,1058,352,352,0
"897b7f51242c44aab2205c72fdcbf4cd","09b9678ddc3d452ea4a3d46e15826065",22857661,1,1,0,1061,352,353,1
"09b9678ddc3d452ea4a3d46e15826065","09b9678ddc3d452ea4a3d46e15826065",22857661,3,0,1,1062,353,353,0
"09b9678ddc3d452ea4a3d46e15826065","eff0de7f2dbb42dfa1a2e686efab5b6d",22857661,1,1,0,1065,353,354,1
"eff0de7f2dbb42dfa1a2e686efab5b6d","eff0de7f2dbb42dfa1a2e686efab5b6d",22857661,3,0,1,1066,354,354,0
"eff0de7f2dbb42dfa1a2e686efab5b6d","2fe14166dc9642c3bc666b86a57f943d",22857661,1,4,0,1069,354,357,3
"2fe14166dc9642c3bc666b86a57f943d","30ead9794d4847abaf222ca966cc8630",22857661,1,-10,0,1070,357,348,-9
"30ead9794d4847abaf222ca966cc8630","2fe14166dc9642c3bc666b86a57f943d",22857661,1,10,0,1071,348,357,9
"2fe14166dc9642c3bc666b86a57f943d","44421dd1e13a47a388c4a19834b744c7",22857661,1,2,0,1072,357,359,2
"44421dd1e13a47a388c4a19834b744c7","44421dd1e13a47a388c4a19834b744c7",22857661,2,0,1,1073,359,359,0
"44421dd1e13a47a388c4a19834b744c7","cb5fc7ef85d547c4be1a7439d0bf6052",22857661,1,1,0,1075,359,360,1
"cb5fc7ef85d547c4be1a7439d0bf6052","cb5fc7ef85d547c4be1a7439d0bf6052",22857661,2,0,1,1076,360,360,0
"cb5fc7ef85d547c4be1a7439d0bf6052","0a8f150a4cf747acbde62f4721823da3",22857661,1,1,0,1078,360,361,1
"0a8f150a4cf747acbde62f4721823da3","0a8f150a4cf747acbde62f4721823da3",22857661,2,0,1,1079,361,361,0
"0a8f150a4cf747acbde62f4721823da3","ab8fdad974ae471f9f24c3f9dd04462e",22857661,1,1,0,1081,361,362,1
"ab8fdad974ae471f9f24c3f9dd04462e","ab8fdad974ae471f9f24c3f9dd04462e",22857661,2,0,1,1082,362,362,0
"ab8fdad974ae471f9f24c3f9dd04462e","1ba8fef685d74a8194b9db252eb704fb",22857661,1,-7,0,1084,362,355,-7
"1ba8fef685d74a8194b9db252eb704fb","52580888dadb4fe3baa795683ea227bd",22857661,1,10,0,1085,355,364,9
"52580888dadb4fe3baa795683ea227bd","52580888dadb4fe3baa795683ea227bd",22857661,1,0,1,1086,364,364,0
"52580888dadb4fe3baa795683ea227bd","f00179e251a045b39c3f7a54f9aa4acc",22857661,1,-1,0,1087,364,363,-1
"f00179e251a045b39c3f7a54f9aa4acc","492a3bc6a1254f23a7998587961b22a4",22857661,1,4,0,1088,363,366,3
"492a3bc6a1254f23a7998587961b22a4","492a3bc6a1254f23a7998587961b22a4",22857661,1,0,1,1089,366,366,0
"492a3bc6a1254f23a7998587961b22a4","072a190fd302456290895f9f04d6940a",22857661,1,-1,0,1090,366,365,-1
"072a190fd302456290895f9f04d6940a","cfa457d1743848e4bb5e4beced6448ed",22857661,1,5,0,1091,365,369,4
"cfa457d1743848e4bb5e4beced6448ed","cfa457d1743848e4bb5e4beced6448ed",22857661,1,0,1,1092,369,369,0
"cfa457d1743848e4bb5e4beced6448ed","b71bac264efb4abd97015447bd490db6",22857661,1,3,0,1093,369,370,1
"b71bac264efb4abd97015447bd490db6","30ead9794d4847abaf222ca966cc8630",22857661,1,-28,0,1094,370,348,-22
"30ead9794d4847abaf222ca966cc8630","0d987bed3ffa4ed0b9a2e62e97b7b30f",22857661,1,-104,0,1095,348,272,-76
"0d987bed3ffa4ed0b9a2e62e97b7b30f","bc5524e78a8544e2ae2fdc2f3462bbec",22857661,3,9,0,1096,272,279,7
"bc5524e78a8544e2ae2fdc2f3462bbec","bb5a47f5ea01454a8b79455422d3b9da",22857661,3,1,0,1097,279,280,1
"bb5a47f5ea01454a8b79455422d3b9da","bb5a47f5ea01454a8b79455422d3b9da",22857661,96,0,1,1098,280,280,0
"bb5a47f5ea01454a8b79455422d3b9da","fab84b4fab5940efb4ea868ef8d09396",22857661,2,8,0,1105,280,284,4
"fab84b4fab5940efb4ea868ef8d09396","b71bac264efb4abd97015447bd490db6",22857661,2,114,0,1106,284,370,86
"b71bac264efb4abd97015447bd490db6","b71bac264efb4abd97015447bd490db6",22857661,3,0,1,1107,370,370,0
"b71bac264efb4abd97015447bd490db6","fab84b4fab5940efb4ea868ef8d09396",22857661,1,-114,0,1108,370,284,-86
"b71bac264efb4abd97015447bd490db6","8d448d625b024c82a5eb240bbd7431d6",22857661,5,5,0,1111,370,374,4
"8d448d625b024c82a5eb240bbd7431d6","8d448d625b024c82a5eb240bbd7431d6",22857661,64,0,1,1112,374,374,0
"8d448d625b024c82a5eb240bbd7431d6","b71bac264efb4abd97015447bd490db6",22857661,3,-5,0,1115,374,370,-4
"b71bac264efb4abd97015447bd490db6","d6d02b6ef04e4f17805504500b8ce441",22857661,2,8,0,1164,370,375,5
"d6d02b6ef04e4f17805504500b8ce441","d6d02b6ef04e4f17805504500b8ce441",22857661,2,0,1,1165,375,375,0
"d6d02b6ef04e4f17805504500b8ce441","0d987bed3ffa4ed0b9a2e62e97b7b30f",22857661,1,-140,0,1167,375,272,-103
"fab84b4fab5940efb4ea868ef8d09396","1b4550d0dab04078b3bf08a655345bdc",22857661,1,118,0,1178,284,373,89
"1b4550d0dab04078b3bf08a655345bdc","b71bac264efb4abd97015447bd490db6",22857661,1,-4,0,1179,373,370,-3
"8d448d625b024c82a5eb240bbd7431d6","d6d02b6ef04e4f17805504500b8ce441",22857661,1,3,0,1190,374,375,1
"d6d02b6ef04e4f17805504500b8ce441","b71bac264efb4abd97015447bd490db6",22857661,1,-8,0,1191,375,370,-5
"d6d02b6ef04e4f17805504500b8ce441","66baf19b6b904b70922329068c63746d",22857661,1,4,0,1193,375,376,1
"66baf19b6b904b70922329068c63746d","66baf19b6b904b70922329068c63746d",22857661,1,0,1,1194,376,376,0
"66baf19b6b904b70922329068c63746d","7f544639412e40a9ba27f43b415362ab",22857661,1,2,0,1195,376,378,2
"7f544639412e40a9ba27f43b415362ab","7f544639412e40a9ba27f43b415362ab",22857661,1,0,1,1196,378,378,0
"7f544639412e40a9ba27f43b415362ab","d5ae8642e15b46b8bd298b02274d4e9c",22857661,1,2,0,1197,378,380,2
"d5ae8642e15b46b8bd298b02274d4e9c","d5ae8642e15b46b8bd298b02274d4e9c",22857661,1,0,1,1198,380,380,0
"d5ae8642e15b46b8bd298b02274d4e9c","a0d10309a2dd456289147f84be9d37f9",22857661,1,1,0,1199,380,381,1
"a0d10309a2dd456289147f84be9d37f9","a0d10309a2dd456289147f84be9d37f9",22857661,2,0,1,1200,381,381,0
"a0d10309a2dd456289147f84be9d37f9","0fcbc3ca07b144138b8d85da581f09a8",22857661,1,1,0,1202,381,382,1
"0fcbc3ca07b144138b8d85da581f09a8","0fcbc3ca07b144138b8d85da581f09a8",22857661,2,0,1,1203,382,382,0
"0fcbc3ca07b144138b8d85da581f09a8","66baf19b6b904b70922329068c63746d",22857661,1,-6,0,1205,382,376,-6
"66baf19b6b904b70922329068c63746d","c2fca3669923477ab966ded303dea31c",22857661,1,8,0,1206,376,383,7
"c2fca3669923477ab966ded303dea31c","4890121ce5d74576b4632b77cfc23398",22857661,1,6,0,1207,383,388,5
"4890121ce5d74576b4632b77cfc23398","4890121ce5d74576b4632b77cfc23398",22857661,1,0,1,1208,388,388,0
"4890121ce5d74576b4632b77cfc23398","18d3b836dd804224883cc9180b60a8e1",22857661,1,-1,0,1209,388,387,-1
"18d3b836dd804224883cc9180b60a8e1","96bb2b3e85a34d8b9544514e89f6fe97",22857661,1,4,0,1210,387,390,3
"96bb2b3e85a34d8b9544514e89f6fe97","96bb2b3e85a34d8b9544514e89f6fe97",22857661,1,0,1,1211,390,390,0
"96bb2b3e85a34d8b9544514e89f6fe97","ac4e9b54acfe4670b4634859c7263cb5",22857661,1,2,0,1212,390,392,2
"ac4e9b54acfe4670b4634859c7263cb5","ac4e9b54acfe4670b4634859c7263cb5",22857661,3,0,1,1213,392,392,0
"ac4e9b54acfe4670b4634859c7263cb5","17f95d18bab743888e1736033dc3384d",22857661,1,-3,0,1216,392,389,-3
"17f95d18bab743888e1736033dc3384d","6f8881a745ac4c358a68b92c3b4abe81",22857661,1,6,0,1217,389,394,5
"6f8881a745ac4c358a68b92c3b4abe81","6f8881a745ac4c358a68b92c3b4abe81",22857661,1,0,1,1218,394,394,0
"6f8881a745ac4c358a68b92c3b4abe81","f7002c8484354eceac57bc7bd62c76c1",22857661,1,-1,0,1219,394,393,-1
"f7002c8484354eceac57bc7bd62c76c1","44a277ea44dc4ae689fab4b82f0b4098",22857661,1,5,0,1220,393,397,4
"44a277ea44dc4ae689fab4b82f0b4098","44a277ea44dc4ae689fab4b82f0b4098",22857661,1,0,1,1221,397,397,0
"44a277ea44dc4ae689fab4b82f0b4098","0c12af0a4e7f4002852cf84b2537c161",22857661,1,-2,0,1222,397,395,-2
"0c12af0a4e7f4002852cf84b2537c161","859e0b8d71694b12befb69ee698138f9",22857661,1,5,0,1223,395,399,4
"859e0b8d71694b12befb69ee698138f9","859e0b8d71694b12befb69ee698138f9",22857661,1,0,1,1224,399,399,0
"859e0b8d71694b12befb69ee698138f9","66baf19b6b904b70922329068c63746d",22857661,1,-29,0,1225,399,376,-23
"66baf19b6b904b70922329068c63746d","2b09a08242b54983aec7063990fb3f66",22857661,1,32,0,1226,376,400,24
"2b09a08242b54983aec7063990fb3f66","2b09a08242b54983aec7063990fb3f66",22857661,2,0,1,1227,400,400,0
"2b09a08242b54983aec7063990fb3f66","1f471b7a883a4df48211e8c6a81b59a7",22857661,1,1,0,1229,400,401,1
"1f471b7a883a4df48211e8c6a81b59a7","1f471b7a883a4df48211e8c6a81b59a7",22857661,1,0,1,1230,401,401,0
"1f471b7a883a4df48211e8c6a81b59a7","2b09a08242b54983aec7063990fb3f66",22857661,1,-1,0,1231,401,400,-1
"2b09a08242b54983aec7063990fb3f66","9de0d567bfa84fe5b77cb76f4a76a5d1",22857661,1,5,0,1232,400,404,4
"9de0d567bfa84fe5b77cb76f4a76a5d1","9de0d567bfa84fe5b77cb76f4a76a5d1",22857661,1,0,1,1233,404,404,0
"9de0d567bfa84fe5b77cb76f4a76a5d1","1157bd665ec4472fb58b751dc5099355",22857661,1,-1,0,1234,404,403,-1
"1157bd665ec4472fb58b751dc5099355","58fc9094275e4c49be3f4ba6d4acc0a4",22857661,1,5,0,1235,403,406,3
"58fc9094275e4c49be3f4ba6d4acc0a4","3c8a22d2f9c146ea956609e3ed4f2559",22857661,1,-2,0,1236,406,405,-1
"3c8a22d2f9c146ea956609e3ed4f2559","58fc9094275e4c49be3f4ba6d4acc0a4",22857661,1,2,0,1237,405,406,1
"58fc9094275e4c49be3f4ba6d4acc0a4","c1c1be90b2b14c1ab4a5e1ee3c241902",22857661,1,1,0,1238,406,407,1
"c1c1be90b2b14c1ab4a5e1ee3c241902","c1c1be90b2b14c1ab4a5e1ee3c241902",22857661,5,0,1,1239,407,407,0
"c1c1be90b2b14c1ab4a5e1ee3c241902","02b3a1bead9244c1ba2f857c7da8f82a",22857661,1,2,0,1244,407,408,1
"02b3a1bead9244c1ba2f857c7da8f82a","58fc9094275e4c49be3f4ba6d4acc0a4",22857661,1,-3,0,1245,408,406,-2
"58fc9094275e4c49be3f4ba6d4acc0a4","02b3a1bead9244c1ba2f857c7da8f82a",22857661,1,3,0,1246,406,408,2
"02b3a1bead9244c1ba2f857c7da8f82a","6206fc6479014bb193084c32409dc1b9",22857661,1,1,0,1247,408,409,1
"6206fc6479014bb193084c32409dc1b9","6206fc6479014bb193084c32409dc1b9",22857661,1,0,1,1248,409,409,0
"6206fc6479014bb193084c32409dc1b9","02b3a1bead9244c1ba2f857c7da8f82a",22857661,1,-1,0,1249,409,408,-1
"02b3a1bead9244c1ba2f857c7da8f82a","6a5f020451db426dacba9e2ea3fcc62a",22857661,1,3,0,1250,408,410,2
"6a5f020451db426dacba9e2ea3fcc62a","6a5f020451db426dacba9e2ea3fcc62a",22857661,2,0,1,1251,410,410,0
"6a5f020451db426dacba9e2ea3fcc62a","33a9d248b2e44588a5b07fc1342b9bc2",22857661,1,2,0,1253,410,411,1
"33a9d248b2e44588a5b07fc1342b9bc2","33a9d248b2e44588a5b07fc1342b9bc2",22857661,1,0,1,1254,411,411,0
"33a9d248b2e44588a5b07fc1342b9bc2","c6f26bd420634f1cb7989e76fe6b16c0",22857661,1,1,0,1255,411,412,1
"c6f26bd420634f1cb7989e76fe6b16c0","c6f26bd420634f1cb7989e76fe6b16c0",22857661,5,0,1,1256,412,412,0
"c6f26bd420634f1cb7989e76fe6b16c0","2a65ee6e2ac64f6a8a55fbe5373ec763",22857661,1,1,0,1261,412,413,1
"2a65ee6e2ac64f6a8a55fbe5373ec763","2a65ee6e2ac64f6a8a55fbe5373ec763",22857661,2,0,1,1262,413,413,0
"2a65ee6e2ac64f6a8a55fbe5373ec763","33a9d248b2e44588a5b07fc1342b9bc2",22857661,1,-2,0,1264,413,411,-2
"33a9d248b2e44588a5b07fc1342b9bc2","1fd0f6dadbc14ebc965faf6122190b96",22857661,1,5,0,1265,411,415,4
"1fd0f6dadbc14ebc965faf6122190b96","1fd0f6dadbc14ebc965faf6122190b96",22857661,1,0,1,1266,415,415,0
"1fd0f6dadbc14ebc965faf6122190b96","687055dad9fc40c3982478fe33ec01bf",22857661,1,-1,0,1267,415,414,-1
"687055dad9fc40c3982478fe33ec01bf","2add1669f08d4101913db15f8c23b3b7",22857661,1,3,0,1268,414,416,2
"2add1669f08d4101913db15f8c23b3b7","2add1669f08d4101913db15f8c23b3b7",22857661,1,0,1,1269,416,416,0
"2add1669f08d4101913db15f8c23b3b7","a2b4bd40cee2481ebd3fc179d6a5cd62",22857661,1,3,0,1270,416,417,1
"a2b4bd40cee2481ebd3fc179d6a5cd62","2b09a08242b54983aec7063990fb3f66",22857661,1,-27,0,1271,417,400,-17
"2b09a08242b54983aec7063990fb3f66","e34e59dce2204f228f3a84b6725df60f",22857661,1,29,0,1272,400,419,19
"e34e59dce2204f228f3a84b6725df60f","e34e59dce2204f228f3a84b6725df60f",22857661,1,0,1,1273,419,419,0
"e34e59dce2204f228f3a84b6725df60f","a2b4bd40cee2481ebd3fc179d6a5cd62",22857661,1,-2,0,1274,419,417,-2
"a2b4bd40cee2481ebd3fc179d6a5cd62","bec48fc2e1294c7eb3d0aca780d731b8",22857661,1,4,0,1275,417,420,3
"bec48fc2e1294c7eb3d0aca780d731b8","bec48fc2e1294c7eb3d0aca780d731b8",22857661,2,0,1,1276,420,420,0
"bec48fc2e1294c7eb3d0aca780d731b8","a24600b0e49245f6bdba8c893cfeddb0",22857661,1,7,0,1278,420,425,5
"a24600b0e49245f6bdba8c893cfeddb0","dbde19fcce2a4c1abdc7f685c293a23f",22857661,1,-4,0,1279,425,422,-3
"dbde19fcce2a4c1abdc7f685c293a23f","a24600b0e49245f6bdba8c893cfeddb0",22857661,1,4,0,1280,422,425,3
"a24600b0e49245f6bdba8c893cfeddb0","a24600b0e49245f6bdba8c893cfeddb0",22857661,1,0,1,1281,425,425,0
"a24600b0e49245f6bdba8c893cfeddb0","a2b4bd40cee2481ebd3fc179d6a5cd62",22857661,1,-11,0,1282,425,417,-8
"a2b4bd40cee2481ebd3fc179d6a5cd62","24cf8786024543f19b89bc20034e60d7",22857661,1,18,0,1283,417,428,11
"24cf8786024543f19b89bc20034e60d7","f2a73be2f46840b182d7bd095378004e",22857661,1,1,0,1284,428,429,1
"f2a73be2f46840b182d7bd095378004e","f2a73be2f46840b182d7bd095378004e",22857661,1,0,1,1285,429,429,0
"f2a73be2f46840b182d7bd095378004e","604551fd4266430cb860fef58fa7dd61",22857661,1,1,0,1286,429,430,1
"604551fd4266430cb860fef58fa7dd61","604551fd4266430cb860fef58fa7dd61",22857661,8,0,1,1287,430,430,0
"604551fd4266430cb860fef58fa7dd61","24cf8786024543f19b89bc20034e60d7",22857661,1,-2,0,1295,430,428,-2
"24cf8786024543f19b89bc20034e60d7","dce46f8904594a62a6377a3587aaa663",22857661,2,4,0,1296,428,431,3
"dce46f8904594a62a6377a3587aaa663","dce46f8904594a62a6377a3587aaa663",22857661,1,0,1,1297,431,431,0
"dce46f8904594a62a6377a3587aaa663","9b9d0a249052413c869753b99682b0ac",22857661,1,1,0,1298,431,432,1
"9b9d0a249052413c869753b99682b0ac","9b9d0a249052413c869753b99682b0ac",22857661,5,0,1,1299,432,432,0
"9b9d0a249052413c869753b99682b0ac","061c175cc90f45fbad883025394e78dd",22857661,1,1,0,1304,432,433,1
"061c175cc90f45fbad883025394e78dd","061c175cc90f45fbad883025394e78dd",22857661,1,0,1,1305,433,433,0
"061c175cc90f45fbad883025394e78dd","dce46f8904594a62a6377a3587aaa663",22857661,1,-2,0,1306,433,431,-2
"dce46f8904594a62a6377a3587aaa663","a2b4bd40cee2481ebd3fc179d6a5cd62",22857661,1,-22,0,1307,431,417,-14
"a2b4bd40cee2481ebd3fc179d6a5cd62","5d290f75e44b4bdb8256c600debbb44d",22857661,1,13,0,1308,417,426,9
"5d290f75e44b4bdb8256c600debbb44d","24cf8786024543f19b89bc20034e60d7",22857661,1,5,0,1309,426,428,2
"24cf8786024543f19b89bc20034e60d7","a2b4bd40cee2481ebd3fc179d6a5cd62",22857661,1,-18,0,1310,428,417,-11
"a2b4bd40cee2481ebd3fc179d6a5cd62","f2a73be2f46840b182d7bd095378004e",22857661,1,19,0,1311,417,429,12
"f2a73be2f46840b182d7bd095378004e","dce46f8904594a62a6377a3587aaa663",22857661,1,3,0,1312,429,431,2
"dce46f8904594a62a6377a3587aaa663","24cf8786024543f19b89bc20034e60d7",22857661,1,-4,0,1313,431,428,-3
"dce46f8904594a62a6377a3587aaa663","74a7f8712e5449c2bc0b43c6f90dafed",22857661,1,5,0,1315,431,435,4
"74a7f8712e5449c2bc0b43c6f90dafed","74a7f8712e5449c2bc0b43c6f90dafed",22857661,1,0,1,1316,435,435,0
"74a7f8712e5449c2bc0b43c6f90dafed","66ada10dde9f43018588f1ced9d477fc",22857661,1,-1,0,1317,435,434,-1
"66ada10dde9f43018588f1ced9d477fc","bf12c96466d840a69bed7020b3f18bb8",22857661,1,3,0,1318,434,436,2
"bf12c96466d840a69bed7020b3f18bb8","bf12c96466d840a69bed7020b3f18bb8",22857661,1,0,1,1319,436,436,0
"bf12c96466d840a69bed7020b3f18bb8","070600601c4c439288445d2f0724807d",22857661,1,3,0,1320,436,437,1
"070600601c4c439288445d2f0724807d","24cf8786024543f19b89bc20034e60d7",22857661,1,-14,0,1321,437,428,-9
"24cf8786024543f19b89bc20034e60d7","1823b6de7d334a7aaabc4570719af4d9",22857661,1,16,0,1322,428,439,11
"1823b6de7d334a7aaabc4570719af4d9","1823b6de7d334a7aaabc4570719af4d9",22857661,14,0,1,1323,439,439,0
"1823b6de7d334a7aaabc4570719af4d9","070600601c4c439288445d2f0724807d",22857661,2,-2,0,1337,439,437,-2
"070600601c4c439288445d2f0724807d","0380cd76a7d44bc3a4da1f15e4d68f89",22857661,2,4,0,1338,437,440,3
"0380cd76a7d44bc3a4da1f15e4d68f89","0380cd76a7d44bc3a4da1f15e4d68f89",22857661,2,0,1,1339,440,440,0
"0380cd76a7d44bc3a4da1f15e4d68f89","23b7673c8b5443108c2ef09382834a86",22857661,3,2,0,1340,440,441,1
"23b7673c8b5443108c2ef09382834a86","0380cd76a7d44bc3a4da1f15e4d68f89",22857661,2,-2,0,1341,441,440,-1
"23b7673c8b5443108c2ef09382834a86","23b7673c8b5443108c2ef09382834a86",22857661,2,0,1,1343,441,441,0
"23b7673c8b5443108c2ef09382834a86","901e92500aea43c79f19f1b279050668",22857661,2,2,0,1344,441,442,1
"901e92500aea43c79f19f1b279050668","901e92500aea43c79f19f1b279050668",22857661,2,0,1,1345,442,442,0
"901e92500aea43c79f19f1b279050668","001339db8ced4cf78829ebe8b145449d",22857661,1,1,0,1346,442,443,1
"001339db8ced4cf78829ebe8b145449d","001339db8ced4cf78829ebe8b145449d",22857661,2,0,1,1347,443,443,0
"001339db8ced4cf78829ebe8b145449d","452745e0366e42ae81561bfddebcc6c3",22857661,1,1,0,1349,443,444,1
"452745e0366e42ae81561bfddebcc6c3","452745e0366e42ae81561bfddebcc6c3",22857661,2,0,1,1350,444,444,0
"452745e0366e42ae81561bfddebcc6c3","901e92500aea43c79f19f1b279050668",22857661,1,-2,0,1352,444,442,-2
"901e92500aea43c79f19f1b279050668","4660ff2089114e8db82ceb26a4f329e3",22857661,3,4,0,1353,442,445,3
"4660ff2089114e8db82ceb26a4f329e3","4660ff2089114e8db82ceb26a4f329e3",22857661,2,0,1,1354,445,445,0
"4660ff2089114e8db82ceb26a4f329e3","7bd5586eb9d8484eb74a433ee7bfe499",22857661,3,2,0,1355,445,446,1
"7bd5586eb9d8484eb74a433ee7bfe499","4660ff2089114e8db82ceb26a4f329e3",22857661,1,-2,0,1356,446,445,-1
"4660ff2089114e8db82ceb26a4f329e3","070600601c4c439288445d2f0724807d",22857661,1,-12,0,1357,445,437,-8
"070600601c4c439288445d2f0724807d","1823b6de7d334a7aaabc4570719af4d9",22857661,2,2,0,1358,437,439,2
"7bd5586eb9d8484eb74a433ee7bfe499","070600601c4c439288445d2f0724807d",22857661,1,-14,0,1369,446,437,-9
"1823b6de7d334a7aaabc4570719af4d9","0380cd76a7d44bc3a4da1f15e4d68f89",22857661,1,2,0,1371,439,440,1
"0380cd76a7d44bc3a4da1f15e4d68f89","070600601c4c439288445d2f0724807d",22857661,1,-4,0,1372,440,437,-3
"070600601c4c439288445d2f0724807d","23b7673c8b5443108c2ef09382834a86",22857661,1,6,0,1373,437,441,4
"0380cd76a7d44bc3a4da1f15e4d68f89","901e92500aea43c79f19f1b279050668",22857661,1,4,0,1375,440,442,2
"901e92500aea43c79f19f1b279050668","23b7673c8b5443108c2ef09382834a86",22857661,1,-2,0,1376,442,441,-1
"23b7673c8b5443108c2ef09382834a86","4660ff2089114e8db82ceb26a4f329e3",22857661,1,6,0,1377,441,445,4
"4660ff2089114e8db82ceb26a4f329e3","901e92500aea43c79f19f1b279050668",22857661,1,-4,0,1378,445,442,-3
"7bd5586eb9d8484eb74a433ee7bfe499","7bd5586eb9d8484eb74a433ee7bfe499",22857661,9,0,1,1381,446,446,0
"7bd5586eb9d8484eb74a433ee7bfe499","8a7f26e690f34dda97be16904518ca99",22857661,1,2,0,1390,446,447,1
"8a7f26e690f34dda97be16904518ca99","8a7f26e690f34dda97be16904518ca99",22857661,1,0,1,1391,447,447,0
"8a7f26e690f34dda97be16904518ca99","070600601c4c439288445d2f0724807d",22857661,1,-16,0,1392,447,437,-10
"070600601c4c439288445d2f0724807d","b2f0d654738f48158edff28e8d3a546e",22857661,1,21,0,1393,437,449,12
"b2f0d654738f48158edff28e8d3a546e","f60ee41ec635499abd48168342d32c2f",22857661,3,5,0,1394,449,453,4
"f60ee41ec635499abd48168342d32c2f","f60ee41ec635499abd48168342d32c2f",22857661,59,0,1,1395,453,453,0
"f60ee41ec635499abd48168342d32c2f","b2f0d654738f48158edff28e8d3a546e",22857661,1,-5,0,1396,453,449,-4
"f60ee41ec635499abd48168342d32c2f","f67fbf45a5f146ed866965bc57c7c001",22857661,1,3,0,1416,453,454,1
"f67fbf45a5f146ed866965bc57c7c001","f67fbf45a5f146ed866965bc57c7c001",22857661,5,0,1,1417,454,454,0
"f67fbf45a5f146ed866965bc57c7c001","b2f0d654738f48158edff28e8d3a546e",22857661,1,-8,0,1419,454,449,-5
"f60ee41ec635499abd48168342d32c2f","b71bac264efb4abd97015447bd490db6",22857661,1,-129,0,1461,453,370,-83
"8d448d625b024c82a5eb240bbd7431d6","f67fbf45a5f146ed866965bc57c7c001",22857661,1,127,0,1472,374,454,80
"f67fbf45a5f146ed866965bc57c7c001","d937afe49bd24a07a550dda1c1155122",22857661,1,1,0,1476,454,455,1
"d937afe49bd24a07a550dda1c1155122","d937afe49bd24a07a550dda1c1155122",22857661,1,0,1,1477,455,455,0
"d937afe49bd24a07a550dda1c1155122","3628b3f7823443d0912a339096b69943",22857661,1,1,0,1478,455,456,1
"3628b3f7823443d0912a339096b69943","3628b3f7823443d0912a339096b69943",22857661,1,0,1,1479,456,456,0
"3628b3f7823443d0912a339096b69943","9e049ee647cf43ecbcb5ed792a8e7588",22857661,1,1,0,1480,456,457,1
"9e049ee647cf43ecbcb5ed792a8e7588","9e049ee647cf43ecbcb5ed792a8e7588",22857661,1,0,1,1481,457,457,0
"9e049ee647cf43ecbcb5ed792a8e7588","5256a214faaf410b93f76cea06428334",22857661,1,1,0,1482,457,458,1
"5256a214faaf410b93f76cea06428334","5256a214faaf410b93f76cea06428334",22857661,1,0,1,1483,458,458,0
"5256a214faaf410b93f76cea06428334","25c32b120fce40fa9b6c85133aeb4716",22857661,1,1,0,1484,458,459,1
"25c32b120fce40fa9b6c85133aeb4716","25c32b120fce40fa9b6c85133aeb4716",22857661,1,0,1,1485,459,459,0
"25c32b120fce40fa9b6c85133aeb4716","11bc14f2204949008b7d511b933363c1",22857661,1,1,0,1486,459,460,1
"11bc14f2204949008b7d511b933363c1","11bc14f2204949008b7d511b933363c1",22857661,1,0,1,1487,460,460,0
"11bc14f2204949008b7d511b933363c1","42de338840a34d15adb66e7b14fb9d2c",22857661,1,1,0,1488,460,461,1
"42de338840a34d15adb66e7b14fb9d2c","42de338840a34d15adb66e7b14fb9d2c",22857661,1,0,1,1489,461,461,0
"42de338840a34d15adb66e7b14fb9d2c","9da37c6210b1416b8079c274f70bf600",22857661,1,1,0,1490,461,462,1
"9da37c6210b1416b8079c274f70bf600","9da37c6210b1416b8079c274f70bf600",22857661,3,0,1,1491,462,462,0
"9da37c6210b1416b8079c274f70bf600","519119f1deac45ff9ab4f13529be5c6e",22857661,1,1,0,1494,462,463,1
"519119f1deac45ff9ab4f13529be5c6e","519119f1deac45ff9ab4f13529be5c6e",22857661,1,0,1,1495,463,463,0
"519119f1deac45ff9ab4f13529be5c6e","f67fbf45a5f146ed866965bc57c7c001",22857661,1,-9,0,1496,463,454,-9
"f67fbf45a5f146ed866965bc57c7c001","c5df9f40ec14463b9dcfdc73df3e9285",22857661,1,12,0,1497,454,464,10
"c5df9f40ec14463b9dcfdc73df3e9285","c5df9f40ec14463b9dcfdc73df3e9285",22857661,1,0,1,1498,464,464,0
"c5df9f40ec14463b9dcfdc73df3e9285","83d42d95cd844fc093fc09cee250edb8",22857661,2,3,0,1499,464,465,1
"83d42d95cd844fc093fc09cee250edb8","c5df9f40ec14463b9dcfdc73df3e9285",22857661,1,-3,0,1500,465,464,-1
"83d42d95cd844fc093fc09cee250edb8","83d42d95cd844fc093fc09cee250edb8",22857661,2,0,1,1502,465,465,0
"b613861cecf84ffcab01afb23f660475","b613861cecf84ffcab01afb23f660475",22859250,10,0,1,1,1,1,0
"b613861cecf84ffcab01afb23f660475","e2911e79efc2420eac45d9f671463d4b",22859250,1,3,0,9,1,2,1
"e2911e79efc2420eac45d9f671463d4b","e2911e79efc2420eac45d9f671463d4b",22859250,4,0,1,10,2,2,0
"e2911e79efc2420eac45d9f671463d4b","531db53f81f646edb0cdcfe0085b03b7",22859250,1,2,0,12,2,4,2
"531db53f81f646edb0cdcfe0085b03b7","531db53f81f646edb0cdcfe0085b03b7",22859250,1,0,1,13,4,4,0
"531db53f81f646edb0cdcfe0085b03b7","519d1b8c59404d67b54e96c5c8a830b2",22859250,1,-1,0,14,4,3,-1
"519d1b8c59404d67b54e96c5c8a830b2","519d1b8c59404d67b54e96c5c8a830b2",22859250,1,0,1,15,3,3,0
"519d1b8c59404d67b54e96c5c8a830b2","6d541c89590949f99af293c4f2333f67",22859250,1,3,0,16,3,6,3
"6d541c89590949f99af293c4f2333f67","6d541c89590949f99af293c4f2333f67",22859250,1,0,1,17,6,6,0
"6d541c89590949f99af293c4f2333f67","dd5cf0b9fe4c4f1d8f5ff8e4c04879cb",22859250,1,1,0,18,6,7,1
"dd5cf0b9fe4c4f1d8f5ff8e4c04879cb","dd5cf0b9fe4c4f1d8f5ff8e4c04879cb",22859250,3,0,1,19,7,7,0
"dd5cf0b9fe4c4f1d8f5ff8e4c04879cb","9112f2bffece48e08c6d2287be204085",22859250,2,4,0,20,7,11,4
"9112f2bffece48e08c6d2287be204085","9112f2bffece48e08c6d2287be204085",22859250,3,0,1,21,11,11,0
"9112f2bffece48e08c6d2287be204085","f96261861edc426abe2248be4f0a709a",22859250,1,-3,0,22,11,8,-3
"f96261861edc426abe2248be4f0a709a","f96261861edc426abe2248be4f0a709a",22859250,6,0,1,23,8,8,0
"f96261861edc426abe2248be4f0a709a","4f5f94b2f95141e0a9d53a61da2276da",22859250,1,-3,0,24,8,5,-3
"4f5f94b2f95141e0a9d53a61da2276da","4f5f94b2f95141e0a9d53a61da2276da",22859250,1,0,1,25,5,5,0
"4f5f94b2f95141e0a9d53a61da2276da","66b5e16f4f75454fb5b8172079f0fa83",22859250,1,4,0,26,5,9,4
"66b5e16f4f75454fb5b8172079f0fa83","66b5e16f4f75454fb5b8172079f0fa83",22859250,1,0,1,27,9,9,0
"66b5e16f4f75454fb5b8172079f0fa83","f96261861edc426abe2248be4f0a709a",22859250,1,-1,0,28,9,8,-1
"f96261861edc426abe2248be4f0a709a","dd5cf0b9fe4c4f1d8f5ff8e4c04879cb",22859250,1,-1,0,34,8,7,-1
"9112f2bffece48e08c6d2287be204085","0680571d4698477995e41842c36a54b2",22859250,1,-1,0,40,11,10,-1
"0680571d4698477995e41842c36a54b2","0680571d4698477995e41842c36a54b2",22859250,4,0,1,41,10,10,0
"0680571d4698477995e41842c36a54b2","e2911e79efc2420eac45d9f671463d4b",22859250,1,-8,0,45,10,2,-8
"e2911e79efc2420eac45d9f671463d4b","56586aa865414f538729c7f7735d2bc6",22859250,2,12,0,46,2,12,10
"b7f2b31585d94eb3bf86376714aa7070","56586aa865414f538729c7f7735d2bc6",22859250,2,-2,0,50,13,12,-1
"81c864a886d54a6b8ff85f7d736f4f95","9afd71a5298d4333b6849dfce1b9422c",22859250,1,7,0,65,15,18,3
"b7719e26494940efa49512aedd0aac79","9afd71a5298d4333b6849dfce1b9422c",22859250,1,-4,0,70,20,18,-2
"9afd71a5298d4333b6849dfce1b9422c","d4f45188d3c84a02ba08454e6403a818",22859250,1,9,0,71,18,24,6
"d4c3b003e8274e429d2fa688d73fde6d","b7719e26494940efa49512aedd0aac79",22859250,2,-3,0,74,22,20,-2
"b7719e26494940efa49512aedd0aac79","d4f45188d3c84a02ba08454e6403a818",22859250,1,5,0,75,20,24,4
"4e51676dc72045d99c19b9fa7b22f8bc","4e51676dc72045d99c19b9fa7b22f8bc",22859250,1,0,1,82,29,29,0
"7040a13096d746ac84b8fac8d9752058","7040a13096d746ac84b8fac8d9752058",22859250,1,0,1,90,36,36,0
"64d48c6c9c7940639a932219a6c87198","64d48c6c9c7940639a932219a6c87198",22859250,1,0,1,97,40,40,0
"a49d1bb4328949299686242fd0be5584","b7719e26494940efa49512aedd0aac79",22859250,3,-2,0,100,21,20,-1
"b7719e26494940efa49512aedd0aac79","56586aa865414f538729c7f7735d2bc6",22859250,1,-17,0,101,20,12,-8
"56586aa865414f538729c7f7735d2bc6","5c5ceeee4562457ba6d41515aeebfbb1",22859250,5,10,0,102,12,17,5
"5c5ceeee4562457ba6d41515aeebfbb1","56586aa865414f538729c7f7735d2bc6",22859250,5,-10,0,103,17,12,-5
"56586aa865414f538729c7f7735d2bc6","56586aa865414f538729c7f7735d2bc6",22859250,15,0,1,104,12,12,0
"56586aa865414f538729c7f7735d2bc6","b7f2b31585d94eb3bf86376714aa7070",22859250,5,2,0,106,12,13,1
"b7f2b31585d94eb3bf86376714aa7070","b7f2b31585d94eb3bf86376714aa7070",22859250,2,0,1,107,13,13,0
"b7f2b31585d94eb3bf86376714aa7070","3f1c815879794b929260d224becaff7e",22859250,3,2,0,108,13,14,1
"3f1c815879794b929260d224becaff7e","5c5ceeee4562457ba6d41515aeebfbb1",22859250,3,6,0,109,14,17,3
"5c5ceeee4562457ba6d41515aeebfbb1","81c864a886d54a6b8ff85f7d736f4f95",22859250,3,-4,0,110,17,15,-2
"81c864a886d54a6b8ff85f7d736f4f95","56586aa865414f538729c7f7735d2bc6",22859250,2,-6,0,111,15,12,-3
"56586aa865414f538729c7f7735d2bc6","9afd71a5298d4333b6849dfce1b9422c",22859250,3,13,0,112,12,18,6
"9afd71a5298d4333b6849dfce1b9422c","b7719e26494940efa49512aedd0aac79",22859250,3,4,0,113,18,20,2
"b7719e26494940efa49512aedd0aac79","d4c3b003e8274e429d2fa688d73fde6d",22859250,3,3,0,114,20,22,2
"d4c3b003e8274e429d2fa688d73fde6d","d4f45188d3c84a02ba08454e6403a818",22859250,3,2,0,115,22,24,2
"d4f45188d3c84a02ba08454e6403a818","b613861cecf84ffcab01afb23f660475",22859250,1,-37,0,116,24,1,-23
"b613861cecf84ffcab01afb23f660475","5c5ceeee4562457ba6d41515aeebfbb1",22859250,1,25,0,117,1,17,16
"9afd71a5298d4333b6849dfce1b9422c","9afd71a5298d4333b6849dfce1b9422c",22859250,3,0,1,124,18,18,0
"d4f45188d3c84a02ba08454e6403a818","b7719e26494940efa49512aedd0aac79",22859250,2,-5,0,128,24,20,-4
"b7719e26494940efa49512aedd0aac79","b7719e26494940efa49512aedd0aac79",22859250,3,0,1,129,20,20,0
"b7719e26494940efa49512aedd0aac79","afbf7250b99d47bea07172749483ca97",22859250,3,12,0,130,20,28,8
"afbf7250b99d47bea07172749483ca97","afbf7250b99d47bea07172749483ca97",22859250,2,0,1,131,28,28,0
"afbf7250b99d47bea07172749483ca97","4e51676dc72045d99c19b9fa7b22f8bc",22859250,4,3,0,132,28,29,1
"4e51676dc72045d99c19b9fa7b22f8bc","afbf7250b99d47bea07172749483ca97",22859250,2,-3,0,133,29,28,-1
"4e51676dc72045d99c19b9fa7b22f8bc","51970cfa30e643e894e66ae85c8024cc",22859250,2,3,0,135,29,31,2
"51970cfa30e643e894e66ae85c8024cc","4e51676dc72045d99c19b9fa7b22f8bc",22859250,2,-3,0,136,31,29,-2
"4e51676dc72045d99c19b9fa7b22f8bc","c33c17be71ae4d588da7369472e5bb1b",22859250,3,9,0,137,29,34,5
"c33c17be71ae4d588da7369472e5bb1b","c33c17be71ae4d588da7369472e5bb1b",22859250,2,0,1,138,34,34,0
"c33c17be71ae4d588da7369472e5bb1b","93679be414554a11b1893002f2229a93",22859250,3,3,0,139,34,35,1
"93679be414554a11b1893002f2229a93","7040a13096d746ac84b8fac8d9752058",22859250,4,3,0,140,35,36,1
"7040a13096d746ac84b8fac8d9752058","93679be414554a11b1893002f2229a93",22859250,1,-3,0,141,36,35,-1
"7040a13096d746ac84b8fac8d9752058","9a0dc646f934470daf08c4b56ccf73db",22859250,3,3,0,143,36,37,1
"9a0dc646f934470daf08c4b56ccf73db","9a0dc646f934470daf08c4b56ccf73db",22859250,2,0,1,144,37,37,0
"9a0dc646f934470daf08c4b56ccf73db","fc0e049d56024bc9a02c9a9c435c3df7",22859250,2,3,0,145,37,38,1
"fc0e049d56024bc9a02c9a9c435c3df7","fc0e049d56024bc9a02c9a9c435c3df7",22859250,2,0,1,146,38,38,0
"fc0e049d56024bc9a02c9a9c435c3df7","67a089198fcb4e1c8f2385786c2b296f",22859250,2,4,0,147,38,39,1
"67a089198fcb4e1c8f2385786c2b296f","64d48c6c9c7940639a932219a6c87198",22859250,3,1,0,148,39,40,1
"64d48c6c9c7940639a932219a6c87198","b534b89233134e30a9b5645138bfa9ee",22859250,1,3,0,149,40,41,1
"b534b89233134e30a9b5645138bfa9ee","67a089198fcb4e1c8f2385786c2b296f",22859250,1,-4,0,150,41,39,-2
"67a089198fcb4e1c8f2385786c2b296f","0e37b720d23b4e7f8b313e79313fd107",22859250,1,7,0,151,39,44,5
"0e37b720d23b4e7f8b313e79313fd107","0e37b720d23b4e7f8b313e79313fd107",22859250,1,0,1,152,44,44,0
"0e37b720d23b4e7f8b313e79313fd107","6875d67fdd5f48168b62719df449bebd",22859250,1,1,0,153,44,45,1
"6875d67fdd5f48168b62719df449bebd","6875d67fdd5f48168b62719df449bebd",22859250,1,0,1,154,45,45,0
"6875d67fdd5f48168b62719df449bebd","6e13d61a7bdb44bca949c9f86fab3be5",22859250,1,3,0,155,45,47,2
"6e13d61a7bdb44bca949c9f86fab3be5","b534b89233134e30a9b5645138bfa9ee",22859250,3,-7,0,156,47,41,-6
"b534b89233134e30a9b5645138bfa9ee","b534b89233134e30a9b5645138bfa9ee",22859250,2,0,1,157,41,41,0
"b534b89233134e30a9b5645138bfa9ee","6e13d61a7bdb44bca949c9f86fab3be5",22859250,5,7,0,158,41,47,6
"6e13d61a7bdb44bca949c9f86fab3be5","195f78799f984cc2b06c48dfe36be751",22859250,1,2,0,161,47,49,2
"195f78799f984cc2b06c48dfe36be751","195f78799f984cc2b06c48dfe36be751",22859250,2,0,1,162,49,49,0
"195f78799f984cc2b06c48dfe36be751","d0c74f735e024943943e40333d6d337f",22859250,1,3,0,164,49,51,2
"d0c74f735e024943943e40333d6d337f","d9c8d8c444a64dadbbb508652c721e17",22859250,1,-6,0,165,51,46,-5
"d9c8d8c444a64dadbbb508652c721e17","d0c74f735e024943943e40333d6d337f",22859250,2,6,0,166,46,51,5
"d0c74f735e024943943e40333d6d337f","983f8ff320594b279a7f4a6fe132f9c5",22859250,1,2,0,167,51,53,2
"983f8ff320594b279a7f4a6fe132f9c5","983f8ff320594b279a7f4a6fe132f9c5",22859250,2,0,1,168,53,53,0
"983f8ff320594b279a7f4a6fe132f9c5","d0c74f735e024943943e40333d6d337f",22859250,1,-2,0,170,53,51,-2
"d0c74f735e024943943e40333d6d337f","d0c74f735e024943943e40333d6d337f",22859250,4,0,1,171,51,51,0
"d0c74f735e024943943e40333d6d337f","35adfa5d923046aebabfefd98f35ff05",22859250,1,3,0,174,51,54,3
"35adfa5d923046aebabfefd98f35ff05","35adfa5d923046aebabfefd98f35ff05",22859250,5,0,1,175,54,54,0
"35adfa5d923046aebabfefd98f35ff05","d0c74f735e024943943e40333d6d337f",22859250,1,-3,0,180,54,51,-3
"d0c74f735e024943943e40333d6d337f","b6f8a98476224da1b40e555ececc7ed8",22859250,1,4,0,181,51,55,4
"b6f8a98476224da1b40e555ececc7ed8","b6f8a98476224da1b40e555ececc7ed8",22859250,2,0,1,182,55,55,0
"b6f8a98476224da1b40e555ececc7ed8","86e22cb5fe0e4b47a9489ecddf7ed78f",22859250,1,1,0,184,55,56,1
"86e22cb5fe0e4b47a9489ecddf7ed78f","86e22cb5fe0e4b47a9489ecddf7ed78f",22859250,2,0,1,185,56,56,0
"86e22cb5fe0e4b47a9489ecddf7ed78f","f924752d8a1149668870b1e7698486f7",22859250,1,-6,0,187,56,50,-6
"f924752d8a1149668870b1e7698486f7","78f30e4dcac84e3cbea8b2cc6e0d62b3",22859250,2,10,0,188,50,59,9
"78f30e4dcac84e3cbea8b2cc6e0d62b3","a1f2f12debe5432fb7a70bcd12bacfb9",22859250,3,-1,0,189,59,58,-1
"a1f2f12debe5432fb7a70bcd12bacfb9","a1f2f12debe5432fb7a70bcd12bacfb9",22859250,17,0,1,190,58,58,0
"a1f2f12debe5432fb7a70bcd12bacfb9","12aa6e1672ac4e7aa6449a7a8609cd72",22859250,2,-1,0,196,58,57,-1
"12aa6e1672ac4e7aa6449a7a8609cd72","d0c74f735e024943943e40333d6d337f",22859250,1,-7,0,197,57,51,-6
"d0c74f735e024943943e40333d6d337f","6e13d61a7bdb44bca949c9f86fab3be5",22859250,1,-5,0,198,51,47,-4
"6e13d61a7bdb44bca949c9f86fab3be5","f924752d8a1149668870b1e7698486f7",22859250,1,4,0,199,47,50,3
"f924752d8a1149668870b1e7698486f7","d9c8d8c444a64dadbbb508652c721e17",22859250,1,-5,0,200,50,46,-4
"d9c8d8c444a64dadbbb508652c721e17","78f30e4dcac84e3cbea8b2cc6e0d62b3",22859250,1,15,0,201,46,59,13
"12aa6e1672ac4e7aa6449a7a8609cd72","6e13d61a7bdb44bca949c9f86fab3be5",22859250,1,-12,0,205,57,47,-10
"6e13d61a7bdb44bca949c9f86fab3be5","78f30e4dcac84e3cbea8b2cc6e0d62b3",22859250,1,14,0,206,47,59,12
"78f30e4dcac84e3cbea8b2cc6e0d62b3","d9c8d8c444a64dadbbb508652c721e17",22859250,1,-15,0,207,59,46,-13
"d9c8d8c444a64dadbbb508652c721e17","a1f2f12debe5432fb7a70bcd12bacfb9",22859250,1,14,0,208,46,58,12
"a1f2f12debe5432fb7a70bcd12bacfb9","78f30e4dcac84e3cbea8b2cc6e0d62b3",22859250,2,1,0,219,58,59,1
"78f30e4dcac84e3cbea8b2cc6e0d62b3","78f30e4dcac84e3cbea8b2cc6e0d62b3",22859250,11,0,1,220,59,59,0
"78f30e4dcac84e3cbea8b2cc6e0d62b3","bc42d26810654ea9a1df1efe1e58c7d5",22859250,2,5,0,231,59,63,4
"bc42d26810654ea9a1df1efe1e58c7d5","12aa6e1672ac4e7aa6449a7a8609cd72",22859250,2,-7,0,232,63,57,-6
"12aa6e1672ac4e7aa6449a7a8609cd72","a0a418b8540d479fa6e0f653b701da8b",22859250,2,8,0,233,57,64,7
"a0a418b8540d479fa6e0f653b701da8b","4c943503763e4e349906eea3ed3c8e86",22859250,1,-3,0,234,64,61,-3
"4c943503763e4e349906eea3ed3c8e86","4c943503763e4e349906eea3ed3c8e86",22859250,1,0,1,235,61,61,0
"4c943503763e4e349906eea3ed3c8e86","309ccf3cc4fe429d9bfbaef53d3fa479",22859250,1,-1,0,236,61,60,-1
"309ccf3cc4fe429d9bfbaef53d3fa479","d646286c8051419bbc2e31dd1db55ca8",22859250,1,10,0,237,60,67,7
"d646286c8051419bbc2e31dd1db55ca8","b534b89233134e30a9b5645138bfa9ee",22859250,1,-33,0,238,67,41,-26
"b534b89233134e30a9b5645138bfa9ee","267f883678b24aed855fde42524975d9",22859250,1,37,0,239,41,71,30
"267f883678b24aed855fde42524975d9","267f883678b24aed855fde42524975d9",22859250,1,0,1,240,71,71,0
"267f883678b24aed855fde42524975d9","88fff56d0342490dbef9040750a20f6c",22859250,1,1,0,241,71,72,1
"88fff56d0342490dbef9040750a20f6c","88fff56d0342490dbef9040750a20f6c",22859250,1,0,1,242,72,72,0
"88fff56d0342490dbef9040750a20f6c","adb17b12b66c4a49a85fd34322f7df70",22859250,1,1,0,243,72,73,1
"adb17b12b66c4a49a85fd34322f7df70","adb17b12b66c4a49a85fd34322f7df70",22859250,1,0,1,244,73,73,0
"adb17b12b66c4a49a85fd34322f7df70","d646286c8051419bbc2e31dd1db55ca8",22859250,1,-6,0,245,73,67,-6
"d646286c8051419bbc2e31dd1db55ca8","a2becd407db34b189200a32546d9d569",22859250,3,9,0,246,67,75,8
"a2becd407db34b189200a32546d9d569","dd76e1861dc9461c830888729d091ee0",22859250,1,3,0,247,75,78,3
"dd76e1861dc9461c830888729d091ee0","dd76e1861dc9461c830888729d091ee0",22859250,5,0,1,248,78,78,0
"dd76e1861dc9461c830888729d091ee0","cd1d828f1a694b87913a7ea66c23803e",22859250,1,1,0,253,78,79,1
"cd1d828f1a694b87913a7ea66c23803e","cd1d828f1a694b87913a7ea66c23803e",22859250,2,0,1,254,79,79,0
"cd1d828f1a694b87913a7ea66c23803e","9176a3c2b4d2465fa8b0c67096c2a97e",22859250,1,1,0,256,79,80,1
"9176a3c2b4d2465fa8b0c67096c2a97e","9176a3c2b4d2465fa8b0c67096c2a97e",22859250,11,0,1,257,80,80,0
"9176a3c2b4d2465fa8b0c67096c2a97e","f8ec6445f7194e25b9101d4fbcb07a18",22859250,1,1,0,268,80,81,1
"f8ec6445f7194e25b9101d4fbcb07a18","f8ec6445f7194e25b9101d4fbcb07a18",22859250,2,0,1,269,81,81,0
"f8ec6445f7194e25b9101d4fbcb07a18","140d5b27b8574befad82c0a013b59dfa",22859250,1,-7,0,271,81,74,-7
"140d5b27b8574befad82c0a013b59dfa","d18a9ea32855445f8736581f5cb119ce",22859250,2,9,0,272,74,82,8
"d18a9ea32855445f8736581f5cb119ce","ae5ac430ea254e708a6f5deaaf7464ae",22859250,1,3,0,273,82,84,2
"ae5ac430ea254e708a6f5deaaf7464ae","d18a9ea32855445f8736581f5cb119ce",22859250,1,-3,0,274,84,82,-2
"d18a9ea32855445f8736581f5cb119ce","f564483cbd7a407681aa2fcca518cf5f",22859250,1,4,0,275,82,85,3
"f564483cbd7a407681aa2fcca518cf5f","f564483cbd7a407681aa2fcca518cf5f",22859250,1,0,1,276,85,85,0
"f564483cbd7a407681aa2fcca518cf5f","18fd01350bd5434ca636d59a599d768a",22859250,1,1,0,277,85,86,1
"18fd01350bd5434ca636d59a599d768a","18fd01350bd5434ca636d59a599d768a",22859250,9,0,1,278,86,86,0
"18fd01350bd5434ca636d59a599d768a","6a9f0ef185fb47f0937e29daa1c71ed5",22859250,1,5,0,287,86,90,4
"6a9f0ef185fb47f0937e29daa1c71ed5","ae5ac430ea254e708a6f5deaaf7464ae",22859250,1,-7,0,288,90,84,-6
"ae5ac430ea254e708a6f5deaaf7464ae","c681290961c94c4caf23b529d1ae6b9a",22859250,1,5,0,289,84,88,4
"c681290961c94c4caf23b529d1ae6b9a","c681290961c94c4caf23b529d1ae6b9a",22859250,1,0,1,290,88,88,0
"c681290961c94c4caf23b529d1ae6b9a","6a9f0ef185fb47f0937e29daa1c71ed5",22859250,1,2,0,291,88,90,2
"6a9f0ef185fb47f0937e29daa1c71ed5","6a9f0ef185fb47f0937e29daa1c71ed5",22859250,3,0,1,292,90,90,0
"6a9f0ef185fb47f0937e29daa1c71ed5","e20db35ced8544ddac5bc3839145e463",22859250,1,3,0,295,90,91,1
"e20db35ced8544ddac5bc3839145e463","d646286c8051419bbc2e31dd1db55ca8",22859250,1,-30,0,296,91,67,-24
"d646286c8051419bbc2e31dd1db55ca8","67a089198fcb4e1c8f2385786c2b296f",22859250,2,-37,0,297,67,39,-28
"67a089198fcb4e1c8f2385786c2b296f","e20db35ced8544ddac5bc3839145e463",22859250,1,67,0,298,39,91,52
"e20db35ced8544ddac5bc3839145e463","1febb706d7a34005ae8711ed49c76e64",22859250,1,3,0,299,91,94,3
"1febb706d7a34005ae8711ed49c76e64","1febb706d7a34005ae8711ed49c76e64",22859250,2,0,1,300,94,94,0
"1febb706d7a34005ae8711ed49c76e64","8f73ba6f5a0042f2850356ac38ac6f24",22859250,1,1,0,302,94,95,1
"8f73ba6f5a0042f2850356ac38ac6f24","8f73ba6f5a0042f2850356ac38ac6f24",22859250,5,0,1,303,95,95,0
"8f73ba6f5a0042f2850356ac38ac6f24","e2260b86653c46d7b14a41fb419dbf8c",22859250,1,1,0,308,95,96,1
"e2260b86653c46d7b14a41fb419dbf8c","e2260b86653c46d7b14a41fb419dbf8c",22859250,2,0,1,309,96,96,0
"e2260b86653c46d7b14a41fb419dbf8c","35eb641ad1d845bbba54915bce75a962",22859250,1,1,0,311,96,97,1
"35eb641ad1d845bbba54915bce75a962","35eb641ad1d845bbba54915bce75a962",22859250,6,0,1,312,97,97,0
"35eb641ad1d845bbba54915bce75a962","08be90ffbeea4795a138cd42ed8db56f",22859250,1,1,0,318,97,98,1
"08be90ffbeea4795a138cd42ed8db56f","08be90ffbeea4795a138cd42ed8db56f",22859250,5,0,1,319,98,98,0
"08be90ffbeea4795a138cd42ed8db56f","3007433c8f584dcbb5ac159c1c5f2be3",22859250,1,1,0,324,98,99,1
"3007433c8f584dcbb5ac159c1c5f2be3","3007433c8f584dcbb5ac159c1c5f2be3",22859250,5,0,1,325,99,99,0
"3007433c8f584dcbb5ac159c1c5f2be3","00ae5f0c51874a73a41ebea838d95682",22859250,1,3,0,330,99,101,2
"00ae5f0c51874a73a41ebea838d95682","d391c8b6e56a43a7b654e9dee02d904b",22859250,2,2,0,331,101,103,2
"d391c8b6e56a43a7b654e9dee02d904b","e20db35ced8544ddac5bc3839145e463",22859250,1,-13,0,332,103,91,-12
"e20db35ced8544ddac5bc3839145e463","00ae5f0c51874a73a41ebea838d95682",22859250,1,11,0,333,91,101,10
"d391c8b6e56a43a7b654e9dee02d904b","d391c8b6e56a43a7b654e9dee02d904b",22859250,15,0,1,335,103,103,0
"d391c8b6e56a43a7b654e9dee02d904b","6111116566fc4fd9abba409322bea245",22859250,1,1,0,350,103,104,1
"6111116566fc4fd9abba409322bea245","6111116566fc4fd9abba409322bea245",22859250,2,0,1,351,104,104,0
"6111116566fc4fd9abba409322bea245","a81b2235cb9c499eb9ea8ee0a8dd9725",22859250,1,1,0,353,104,105,1
"a81b2235cb9c499eb9ea8ee0a8dd9725","a81b2235cb9c499eb9ea8ee0a8dd9725",22859250,2,0,1,354,105,105,0
"a81b2235cb9c499eb9ea8ee0a8dd9725","8bdebf492ebd4e62b0d522e8ab5e5197",22859250,1,2,0,356,105,107,2
"8bdebf492ebd4e62b0d522e8ab5e5197","8bdebf492ebd4e62b0d522e8ab5e5197",22859250,2,0,1,357,107,107,0
"8bdebf492ebd4e62b0d522e8ab5e5197","2d4e0ab0ef3b4d73b82c72d4621a7579",22859250,1,-1,0,359,107,106,-1
"2d4e0ab0ef3b4d73b82c72d4621a7579","2d4e0ab0ef3b4d73b82c72d4621a7579",22859250,2,0,1,360,106,106,0
"2d4e0ab0ef3b4d73b82c72d4621a7579","73039f8c1eb9409cb4caee2cf968001e",22859250,1,-6,0,362,106,100,-6
"73039f8c1eb9409cb4caee2cf968001e","4280927ec4d643238aa49c32f9e06c6c",22859250,1,10,0,363,100,109,9
"4280927ec4d643238aa49c32f9e06c6c","fc44e6a5f7654430af1227838224dceb",22859250,1,2,0,364,109,111,2
"fc44e6a5f7654430af1227838224dceb","fc44e6a5f7654430af1227838224dceb",22859250,2,0,1,365,111,111,0
"fc44e6a5f7654430af1227838224dceb","4280927ec4d643238aa49c32f9e06c6c",22859250,1,-2,0,367,111,109,-2
"4280927ec4d643238aa49c32f9e06c6c","08111f75e22d409998cf8b85bd431f0a",22859250,1,-1,0,368,109,108,-1
"08111f75e22d409998cf8b85bd431f0a","a9ae0a3c070d455bb4369a8996313336",22859250,1,7,0,369,108,114,6
"a9ae0a3c070d455bb4369a8996313336","a9ae0a3c070d455bb4369a8996313336",22859250,1,0,1,370,114,114,0
"a9ae0a3c070d455bb4369a8996313336","71cec822bcff4f30a20e75dc63ef7b65",22859250,1,2,0,371,114,116,2
"71cec822bcff4f30a20e75dc63ef7b65","71cec822bcff4f30a20e75dc63ef7b65",22859250,3,0,1,372,116,116,0
"71cec822bcff4f30a20e75dc63ef7b65","37319e88176d4aefa91d7a9980dbae91",22859250,1,-4,0,375,116,112,-4
"37319e88176d4aefa91d7a9980dbae91","62bff51286ef4f348717a3cf6fe2318f",22859250,1,9,0,376,112,120,8
"62bff51286ef4f348717a3cf6fe2318f","b1cd0e7dc3ad4a8eb91a4bfdbeb025b0",22859250,1,-2,0,377,120,118,-2
"b1cd0e7dc3ad4a8eb91a4bfdbeb025b0","b1cd0e7dc3ad4a8eb91a4bfdbeb025b0",22859250,1,0,1,378,118,118,0
"b1cd0e7dc3ad4a8eb91a4bfdbeb025b0","62bff51286ef4f348717a3cf6fe2318f",22859250,1,2,0,379,118,120,2
"62bff51286ef4f348717a3cf6fe2318f","62bff51286ef4f348717a3cf6fe2318f",22859250,3,0,1,380,120,120,0
"62bff51286ef4f348717a3cf6fe2318f","e20db35ced8544ddac5bc3839145e463",22859250,1,-33,0,383,120,91,-29
"e20db35ced8544ddac5bc3839145e463","779f9ddd1fd14d1e9e69f72219a1fdbd",22859250,1,36,0,384,91,121,30
"779f9ddd1fd14d1e9e69f72219a1fdbd","ae26e6cda8ad4a3f81bd347560d9579f",22859250,1,4,0,385,121,125,4
"ae26e6cda8ad4a3f81bd347560d9579f","ae26e6cda8ad4a3f81bd347560d9579f",22859250,1,0,1,386,125,125,0
"ae26e6cda8ad4a3f81bd347560d9579f","ee48df95832b4374aa273ceb27ec1315",22859250,1,1,0,387,125,126,1
"ee48df95832b4374aa273ceb27ec1315","ee48df95832b4374aa273ceb27ec1315",22859250,1,0,1,388,126,126,0
"ee48df95832b4374aa273ceb27ec1315","7a439da90b394756ad1777fc4c6dead5",22859250,1,1,0,389,126,127,1
"7a439da90b394756ad1777fc4c6dead5","7a439da90b394756ad1777fc4c6dead5",22859250,3,0,1,390,127,127,0
"7a439da90b394756ad1777fc4c6dead5","a8dd5213034441ac92724b4e83eb0bb2",22859250,1,3,0,393,127,129,2
"a8dd5213034441ac92724b4e83eb0bb2","779f9ddd1fd14d1e9e69f72219a1fdbd",22859250,1,-9,0,394,129,121,-8
"779f9ddd1fd14d1e9e69f72219a1fdbd","8115eab6556b45f5b415c3b8c26a12e5",22859250,1,11,0,395,121,131,10
"8115eab6556b45f5b415c3b8c26a12e5","8115eab6556b45f5b415c3b8c26a12e5",22859250,2,0,1,396,131,131,0
"8115eab6556b45f5b415c3b8c26a12e5","ec34b06efd844b46a4c4818ecdb9b8f4",22859250,1,1,0,398,131,132,1
"ec34b06efd844b46a4c4818ecdb9b8f4","ec34b06efd844b46a4c4818ecdb9b8f4",22859250,2,0,1,399,132,132,0
"ec34b06efd844b46a4c4818ecdb9b8f4","c2e1c2b9eac64109b343a088584b576b",22859250,1,1,0,401,132,133,1
"c2e1c2b9eac64109b343a088584b576b","c2e1c2b9eac64109b343a088584b576b",22859250,2,0,1,402,133,133,0
"c2e1c2b9eac64109b343a088584b576b","579338175e0b4bbb8ef3b712b5d8b54e",22859250,1,-5,0,404,133,128,-5
"579338175e0b4bbb8ef3b712b5d8b54e","8bc5795d6a984a3eace4e2811e52dd4f",22859250,1,8,0,405,128,135,7
"8bc5795d6a984a3eace4e2811e52dd4f","8bc5795d6a984a3eace4e2811e52dd4f",22859250,1,0,1,406,135,135,0
"8bc5795d6a984a3eace4e2811e52dd4f","b416d47c56a742199b5d7c7f19d6503a",22859250,1,-1,0,407,135,134,-1
"b416d47c56a742199b5d7c7f19d6503a","cd4532ad48034873ba8bce2aac0c9808",22859250,1,4,0,408,134,137,3
"cd4532ad48034873ba8bce2aac0c9808","cd4532ad48034873ba8bce2aac0c9808",22859250,1,0,1,409,137,137,0
"cd4532ad48034873ba8bce2aac0c9808","df1de691dafe4549a18a4398ee9dfaf9",22859250,1,4,0,410,137,139,2
"df1de691dafe4549a18a4398ee9dfaf9","779f9ddd1fd14d1e9e69f72219a1fdbd",22859250,1,-23,0,411,139,121,-18
"779f9ddd1fd14d1e9e69f72219a1fdbd","6c5ad271a44743479bfaea29b1db8d02",22859250,1,27,0,412,121,143,22
"6c5ad271a44743479bfaea29b1db8d02","67a089198fcb4e1c8f2385786c2b296f",22859250,1,-130,0,413,143,39,-104
"67a089198fcb4e1c8f2385786c2b296f","579338175e0b4bbb8ef3b712b5d8b54e",22859250,2,111,0,414,39,128,89
"579338175e0b4bbb8ef3b712b5d8b54e","779f9ddd1fd14d1e9e69f72219a1fdbd",22859250,3,-8,0,415,128,121,-7
"779f9ddd1fd14d1e9e69f72219a1fdbd","a8dd5213034441ac92724b4e83eb0bb2",22859250,3,9,0,416,121,129,8
"a8dd5213034441ac92724b4e83eb0bb2","67a089198fcb4e1c8f2385786c2b296f",22859250,1,-112,0,417,129,39,-90
"a8dd5213034441ac92724b4e83eb0bb2","b534b89233134e30a9b5645138bfa9ee",22859250,1,-108,0,421,129,41,-88
"b534b89233134e30a9b5645138bfa9ee","579338175e0b4bbb8ef3b712b5d8b54e",22859250,1,107,0,422,41,128,87
"a8dd5213034441ac92724b4e83eb0bb2","a8dd5213034441ac92724b4e83eb0bb2",22859250,1,0,1,425,129,129,0
"a8dd5213034441ac92724b4e83eb0bb2","579338175e0b4bbb8ef3b712b5d8b54e",22859250,1,-1,0,426,129,128,-1
"579338175e0b4bbb8ef3b712b5d8b54e","67a089198fcb4e1c8f2385786c2b296f",22859250,1,-111,0,427,128,39,-89
"67a089198fcb4e1c8f2385786c2b296f","f924752d8a1149668870b1e7698486f7",22859250,1,15,0,428,39,50,11
"f924752d8a1149668870b1e7698486f7","b534b89233134e30a9b5645138bfa9ee",22859250,1,-11,0,429,50,41,-9
"b534b89233134e30a9b5645138bfa9ee","d0c74f735e024943943e40333d6d337f",22859250,1,12,0,430,41,51,10
"d0c74f735e024943943e40333d6d337f","a1f2f12debe5432fb7a70bcd12bacfb9",22859250,2,8,0,432,51,58,7
"78f30e4dcac84e3cbea8b2cc6e0d62b3","f924752d8a1149668870b1e7698486f7",22859250,1,-10,0,434,59,50,-9
"f924752d8a1149668870b1e7698486f7","67a089198fcb4e1c8f2385786c2b296f",22859250,1,-15,0,435,50,39,-11
"67a089198fcb4e1c8f2385786c2b296f","140d5b27b8574befad82c0a013b59dfa",22859250,1,45,0,436,39,74,35
"140d5b27b8574befad82c0a013b59dfa","d646286c8051419bbc2e31dd1db55ca8",22859250,1,-8,0,437,74,67,-7
"a2becd407db34b189200a32546d9d569","a2becd407db34b189200a32546d9d569",22859250,1,0,1,439,75,75,0
"a2becd407db34b189200a32546d9d569","140d5b27b8574befad82c0a013b59dfa",22859250,2,-1,0,440,75,74,-1
"d18a9ea32855445f8736581f5cb119ce","a2becd407db34b189200a32546d9d569",22859250,1,-8,0,442,82,75,-7
"a2becd407db34b189200a32546d9d569","ae5ac430ea254e708a6f5deaaf7464ae",22859250,1,11,0,443,75,84,9
"ae5ac430ea254e708a6f5deaaf7464ae","58c22b011d0f4c2ea6d13615edbb9eeb",22859250,1,-9,0,444,84,77,-7
"58c22b011d0f4c2ea6d13615edbb9eeb","58c22b011d0f4c2ea6d13615edbb9eeb",22859250,2,0,1,445,77,77,0
"58c22b011d0f4c2ea6d13615edbb9eeb","140d5b27b8574befad82c0a013b59dfa",22859250,1,-3,0,447,77,74,-3
"140d5b27b8574befad82c0a013b59dfa","67a089198fcb4e1c8f2385786c2b296f",22859250,2,-45,0,448,74,39,-35
"67a089198fcb4e1c8f2385786c2b296f","5c5ceeee4562457ba6d41515aeebfbb1",22859250,1,-47,0,449,39,17,-22
"5c5ceeee4562457ba6d41515aeebfbb1","5c5ceeee4562457ba6d41515aeebfbb1",22859250,6,0,1,455,17,17,0
"5c5ceeee4562457ba6d41515aeebfbb1","9afd71a5298d4333b6849dfce1b9422c",22859250,1,3,0,461,17,18,1
"9afd71a5298d4333b6849dfce1b9422c","56586aa865414f538729c7f7735d2bc6",22859250,2,-13,0,462,18,12,-6
"56586aa865414f538729c7f7735d2bc6","b534b89233134e30a9b5645138bfa9ee",22859250,1,61,0,463,12,41,29
"6e13d61a7bdb44bca949c9f86fab3be5","d9c8d8c444a64dadbbb508652c721e17",22859250,1,-1,0,468,47,46,-1
"a1f2f12debe5432fb7a70bcd12bacfb9","f924752d8a1149668870b1e7698486f7",22859250,1,-9,0,471,58,50,-8
"a0a418b8540d479fa6e0f653b701da8b","309ccf3cc4fe429d9bfbaef53d3fa479",22859250,1,-4,0,476,64,60,-4
"309ccf3cc4fe429d9bfbaef53d3fa479","b534b89233134e30a9b5645138bfa9ee",22859250,1,-23,0,477,60,41,-19
"b534b89233134e30a9b5645138bfa9ee","d646286c8051419bbc2e31dd1db55ca8",22859250,1,33,0,478,41,67,26
"d646286c8051419bbc2e31dd1db55ca8","d646286c8051419bbc2e31dd1db55ca8",22859250,2,0,1,479,67,67,0
"67a089198fcb4e1c8f2385786c2b296f","d646286c8051419bbc2e31dd1db55ca8",22859250,1,37,0,483,39,67,28
"67a089198fcb4e1c8f2385786c2b296f","08111f75e22d409998cf8b85bd431f0a",22859250,1,86,0,486,39,108,69
"08111f75e22d409998cf8b85bd431f0a","e20db35ced8544ddac5bc3839145e463",22859250,1,-19,0,487,108,91,-17
"e20db35ced8544ddac5bc3839145e463","4280927ec4d643238aa49c32f9e06c6c",22859250,1,20,0,488,91,109,18
"4280927ec4d643238aa49c32f9e06c6c","4280927ec4d643238aa49c32f9e06c6c",22859250,2,0,1,489,109,109,0
"4280927ec4d643238aa49c32f9e06c6c","67a089198fcb4e1c8f2385786c2b296f",22859250,1,-87,0,491,109,39,-70
"67a089198fcb4e1c8f2385786c2b296f","e2911e79efc2420eac45d9f671463d4b",22859250,1,-69,0,492,39,2,-37
"e2911e79efc2420eac45d9f671463d4b","dd5cf0b9fe4c4f1d8f5ff8e4c04879cb",22859250,1,5,0,494,2,7,5
"dd5cf0b9fe4c4f1d8f5ff8e4c04879cb","f96261861edc426abe2248be4f0a709a",22859250,1,1,0,495,7,8,1
"f96261861edc426abe2248be4f0a709a","0680571d4698477995e41842c36a54b2",22859250,1,2,0,496,8,10,2
"0680571d4698477995e41842c36a54b2","9112f2bffece48e08c6d2287be204085",22859250,1,1,0,497,10,11,1
"9112f2bffece48e08c6d2287be204085","e2911e79efc2420eac45d9f671463d4b",22859250,1,-9,0,498,11,2,-9
"56586aa865414f538729c7f7735d2bc6","b613861cecf84ffcab01afb23f660475",22859250,1,-15,0,501,12,1,-11
"b613861cecf84ffcab01afb23f660475","9afd71a5298d4333b6849dfce1b9422c",22859250,1,28,0,502,1,18,17
"9afd71a5298d4333b6849dfce1b9422c","b613861cecf84ffcab01afb23f660475",22859250,1,-28,0,504,18,1,-17
"b613861cecf84ffcab01afb23f660475","56586aa865414f538729c7f7735d2bc6",22859250,1,15,0,506,1,12,11
"56586aa865414f538729c7f7735d2bc6","4e51676dc72045d99c19b9fa7b22f8bc",22859250,1,32,0,509,12,29,17
"4e51676dc72045d99c19b9fa7b22f8bc","c9c52446b6294aa5a9c2abaed536c37e",22859250,1,5,0,510,29,32,3
"c9c52446b6294aa5a9c2abaed536c37e","c33c17be71ae4d588da7369472e5bb1b",22859250,1,4,0,511,32,34,2
"c33c17be71ae4d588da7369472e5bb1b","4e51676dc72045d99c19b9fa7b22f8bc",22859250,1,-9,0,512,34,29,-5
"93679be414554a11b1893002f2229a93","93679be414554a11b1893002f2229a93",22859250,2,0,1,515,35,35,0
"9a0dc646f934470daf08c4b56ccf73db","7040a13096d746ac84b8fac8d9752058",22859250,1,-3,0,518,37,36,-1
"7040a13096d746ac84b8fac8d9752058","fc0e049d56024bc9a02c9a9c435c3df7",22859250,1,6,0,519,36,38,2
"fc0e049d56024bc9a02c9a9c435c3df7","9a0dc646f934470daf08c4b56ccf73db",22859250,1,-3,0,520,38,37,-1
"9a0dc646f934470daf08c4b56ccf73db","67a089198fcb4e1c8f2385786c2b296f",22859250,1,7,0,521,37,39,2
"67a089198fcb4e1c8f2385786c2b296f","fc0e049d56024bc9a02c9a9c435c3df7",22859250,1,-4,0,522,39,38,-1
"fc0e049d56024bc9a02c9a9c435c3df7","64d48c6c9c7940639a932219a6c87198",22859250,1,5,0,523,38,40,2
"64d48c6c9c7940639a932219a6c87198","e2911e79efc2420eac45d9f671463d4b",22859250,1,-70,0,524,40,2,-38
"e2911e79efc2420eac45d9f671463d4b","78adeee1fa2c4fe0bc73f7bca9fcee86",22859250,1,221,0,526,2,160,158
"78adeee1fa2c4fe0bc73f7bca9fcee86","78adeee1fa2c4fe0bc73f7bca9fcee86",22859250,3,0,1,527,160,160,0
"78adeee1fa2c4fe0bc73f7bca9fcee86","67a089198fcb4e1c8f2385786c2b296f",22859250,2,-152,0,528,160,39,-121
"64d48c6c9c7940639a932219a6c87198","b7719e26494940efa49512aedd0aac79",22859250,2,-41,0,530,40,20,-20
"b7719e26494940efa49512aedd0aac79","a49d1bb4328949299686242fd0be5584",22859250,4,2,0,532,20,21,1
"a49d1bb4328949299686242fd0be5584","d4f45188d3c84a02ba08454e6403a818",22859250,1,3,0,533,21,24,3
"d4f45188d3c84a02ba08454e6403a818","d4c3b003e8274e429d2fa688d73fde6d",22859250,3,-2,0,534,24,22,-2
"d4c3b003e8274e429d2fa688d73fde6d","d4c3b003e8274e429d2fa688d73fde6d",22859250,9,0,1,535,22,22,0
"d4c3b003e8274e429d2fa688d73fde6d","df1de691dafe4549a18a4398ee9dfaf9",22859250,1,163,0,537,22,139,117
"df1de691dafe4549a18a4398ee9dfaf9","df1de691dafe4549a18a4398ee9dfaf9",22859250,1,0,1,538,139,139,0
"df1de691dafe4549a18a4398ee9dfaf9","6c5ad271a44743479bfaea29b1db8d02",22859250,2,4,0,539,139,143,4
"6c5ad271a44743479bfaea29b1db8d02","6c5ad271a44743479bfaea29b1db8d02",22859250,1,0,1,540,143,143,0
"6c5ad271a44743479bfaea29b1db8d02","83d311bed5374fee83d8d67a7d9d82dc",22859250,1,1,0,541,143,144,1
"83d311bed5374fee83d8d67a7d9d82dc","83d311bed5374fee83d8d67a7d9d82dc",22859250,1,0,1,542,144,144,0
"83d311bed5374fee83d8d67a7d9d82dc","402bba41861d43acb52a5abb89e8831e",22859250,1,1,0,543,144,145,1
"402bba41861d43acb52a5abb89e8831e","402bba41861d43acb52a5abb89e8831e",22859250,2,0,1,544,145,145,0
"402bba41861d43acb52a5abb89e8831e","df1de691dafe4549a18a4398ee9dfaf9",22859250,1,-6,0,546,145,139,-6
"df1de691dafe4549a18a4398ee9dfaf9","8aae34f5ddbb4052a709b12e6b0d40fa",22859250,1,9,0,547,139,147,8
"8aae34f5ddbb4052a709b12e6b0d40fa","8aae34f5ddbb4052a709b12e6b0d40fa",22859250,6,0,1,548,147,147,0
"8aae34f5ddbb4052a709b12e6b0d40fa","645b3f0249f64f76af2e19eb4d0e55b7",22859250,1,2,0,549,147,149,2
"645b3f0249f64f76af2e19eb4d0e55b7","645b3f0249f64f76af2e19eb4d0e55b7",22859250,2,0,1,550,149,149,0
"645b3f0249f64f76af2e19eb4d0e55b7","7e7b8db5064d4369805ab370aac5ddfb",22859250,1,1,0,552,149,150,1
"7e7b8db5064d4369805ab370aac5ddfb","7e7b8db5064d4369805ab370aac5ddfb",22859250,5,0,1,553,150,150,0
"7e7b8db5064d4369805ab370aac5ddfb","8956d210ae7f41968fada86d4c979d6a",22859250,1,1,0,558,150,151,1
"8956d210ae7f41968fada86d4c979d6a","8956d210ae7f41968fada86d4c979d6a",22859250,2,0,1,559,151,151,0
"8956d210ae7f41968fada86d4c979d6a","f902b0f41b544d4dbf79664fd233648d",22859250,1,-5,0,561,151,146,-5
"f902b0f41b544d4dbf79664fd233648d","ae781e8b775e4ccd93bc800dad5c8376",22859250,1,8,0,562,146,153,7
"ae781e8b775e4ccd93bc800dad5c8376","ae781e8b775e4ccd93bc800dad5c8376",22859250,2,0,1,563,153,153,0
"ae781e8b775e4ccd93bc800dad5c8376","06882a8492d9499aa31555567f575ecb",22859250,1,1,0,565,153,154,1
"06882a8492d9499aa31555567f575ecb","06882a8492d9499aa31555567f575ecb",22859250,2,0,1,566,154,154,0
"06882a8492d9499aa31555567f575ecb","cc4ddef5bbbe48ebb605141b347c4ed1",22859250,1,2,0,568,154,156,2
"cc4ddef5bbbe48ebb605141b347c4ed1","cc4ddef5bbbe48ebb605141b347c4ed1",22859250,1,0,1,569,156,156,0
"cc4ddef5bbbe48ebb605141b347c4ed1","d313cec988a84645bee413e8d4724a4b",22859250,1,3,0,570,156,158,2
"d313cec988a84645bee413e8d4724a4b","f03480cf4eba413194d7af52fc0e7f28",22859250,2,-7,0,571,158,152,-6
"f03480cf4eba413194d7af52fc0e7f28","d313cec988a84645bee413e8d4724a4b",22859250,4,7,0,572,152,158,6
"d313cec988a84645bee413e8d4724a4b","d313cec988a84645bee413e8d4724a4b",22859250,8,0,1,573,158,158,0
"d313cec988a84645bee413e8d4724a4b","dc60696c76a74368a60f72246e47700d",22859250,1,1,0,576,158,159,1
"dc60696c76a74368a60f72246e47700d","dc60696c76a74368a60f72246e47700d",22859250,3,0,1,577,159,159,0
"dc60696c76a74368a60f72246e47700d","df1de691dafe4549a18a4398ee9dfaf9",22859250,1,-23,0,580,159,139,-20
"df1de691dafe4549a18a4398ee9dfaf9","78adeee1fa2c4fe0bc73f7bca9fcee86",22859250,3,26,0,581,139,160,21
"78adeee1fa2c4fe0bc73f7bca9fcee86","65202579580f4ad38d734b4ee39d22a8",22859250,6,5,0,582,160,164,4
"65202579580f4ad38d734b4ee39d22a8","65202579580f4ad38d734b4ee39d22a8",22859250,63,0,1,583,164,164,0
"65202579580f4ad38d734b4ee39d22a8","78adeee1fa2c4fe0bc73f7bca9fcee86",22859250,4,-5,0,587,164,160,-4
"65202579580f4ad38d734b4ee39d22a8","df1de691dafe4549a18a4398ee9dfaf9",22859250,1,-31,0,591,164,139,-25
"6c5ad271a44743479bfaea29b1db8d02","8aae34f5ddbb4052a709b12e6b0d40fa",22859250,1,5,0,593,143,147,4
"8aae34f5ddbb4052a709b12e6b0d40fa","df1de691dafe4549a18a4398ee9dfaf9",22859250,1,-9,0,594,147,139,-8
"df1de691dafe4549a18a4398ee9dfaf9","f902b0f41b544d4dbf79664fd233648d",22859250,2,8,0,595,139,146,7
"f902b0f41b544d4dbf79664fd233648d","f03480cf4eba413194d7af52fc0e7f28",22859250,2,7,0,596,146,152,6
"d313cec988a84645bee413e8d4724a4b","78adeee1fa2c4fe0bc73f7bca9fcee86",22859250,1,4,0,600,158,160,2
"78adeee1fa2c4fe0bc73f7bca9fcee86","df1de691dafe4549a18a4398ee9dfaf9",22859250,1,-26,0,601,160,139,-21
"78adeee1fa2c4fe0bc73f7bca9fcee86","3cbcea2be0984e7dbd5a48195af10ce7",22859250,2,8,0,603,160,165,5
"3cbcea2be0984e7dbd5a48195af10ce7","3cbcea2be0984e7dbd5a48195af10ce7",22859250,1,0,1,604,165,165,0
"3cbcea2be0984e7dbd5a48195af10ce7","82e6285962b8400d9d6fc32436022a94",22859250,2,2,0,605,165,167,2
"82e6285962b8400d9d6fc32436022a94","a9ac840f098c4bd0a2ee896214ce29cd",22859250,1,3,0,606,167,168,1
"a9ac840f098c4bd0a2ee896214ce29cd","3cbcea2be0984e7dbd5a48195af10ce7",22859250,1,-5,0,607,168,165,-3
"3cbcea2be0984e7dbd5a48195af10ce7","67a089198fcb4e1c8f2385786c2b296f",22859250,1,-160,0,608,165,39,-126
"67a089198fcb4e1c8f2385786c2b296f","b7719e26494940efa49512aedd0aac79",22859250,1,-40,0,609,39,20,-19
"afbf7250b99d47bea07172749483ca97","b613861cecf84ffcab01afb23f660475",22859250,1,-44,0,615,28,1,-27
"b613861cecf84ffcab01afb23f660475","a49d1bb4328949299686242fd0be5584",22859250,1,34,0,616,1,21,20
"a49d1bb4328949299686242fd0be5584","d4c3b003e8274e429d2fa688d73fde6d",22859250,1,1,0,619,21,22,1
"d4c3b003e8274e429d2fa688d73fde6d","5bc03c8f16354d04bd51f5bb93559ad3",22859250,1,4,0,629,22,26,4
"5bc03c8f16354d04bd51f5bb93559ad3","b7719e26494940efa49512aedd0aac79",22859250,1,-7,0,630,26,20,-6
"b7719e26494940efa49512aedd0aac79","b613861cecf84ffcab01afb23f660475",22859250,1,-32,0,631,20,1,-19
"b613861cecf84ffcab01afb23f660475","df1de691dafe4549a18a4398ee9dfaf9",22859250,1,198,0,633,1,139,138
"f902b0f41b544d4dbf79664fd233648d","8aae34f5ddbb4052a709b12e6b0d40fa",22859250,2,1,0,635,146,147,1
"8aae34f5ddbb4052a709b12e6b0d40fa","f902b0f41b544d4dbf79664fd233648d",22859250,3,-1,0,636,147,146,-1
"f03480cf4eba413194d7af52fc0e7f28","8aae34f5ddbb4052a709b12e6b0d40fa",22859250,1,-6,0,638,152,147,-5
"8aae34f5ddbb4052a709b12e6b0d40fa","f03480cf4eba413194d7af52fc0e7f28",22859250,1,6,0,646,147,152,5
"f03480cf4eba413194d7af52fc0e7f28","645b3f0249f64f76af2e19eb4d0e55b7",22859250,1,-4,0,647,152,149,-3
"645b3f0249f64f76af2e19eb4d0e55b7","f902b0f41b544d4dbf79664fd233648d",22859250,1,-3,0,648,149,146,-3
"f902b0f41b544d4dbf79664fd233648d","f293c508f409466a8f27ddd7d1e40b20",22859250,1,10,0,649,146,155,9
"f293c508f409466a8f27ddd7d1e40b20","f293c508f409466a8f27ddd7d1e40b20",22859250,2,0,1,650,155,155,0
"f293c508f409466a8f27ddd7d1e40b20","d313cec988a84645bee413e8d4724a4b",22859250,1,4,0,652,155,158,3
"d313cec988a84645bee413e8d4724a4b","8aae34f5ddbb4052a709b12e6b0d40fa",22859250,1,-13,0,656,158,147,-11
"8aae34f5ddbb4052a709b12e6b0d40fa","f4ce60b4a944484082ccb701b48b3da1",22859250,1,12,0,657,147,157,10
"f4ce60b4a944484082ccb701b48b3da1","8aae34f5ddbb4052a709b12e6b0d40fa",22859250,1,-12,0,658,157,147,-10
"f902b0f41b544d4dbf79664fd233648d","67a089198fcb4e1c8f2385786c2b296f",22859250,1,-134,0,660,146,39,-107
"67a089198fcb4e1c8f2385786c2b296f","78adeee1fa2c4fe0bc73f7bca9fcee86",22859250,1,152,0,661,39,160,121
"67a089198fcb4e1c8f2385786c2b296f","d9c8d8c444a64dadbbb508652c721e17",22859250,1,10,0,665,39,46,7
"d9c8d8c444a64dadbbb508652c721e17","b534b89233134e30a9b5645138bfa9ee",22859250,1,-6,0,666,46,41,-5
"6e13d61a7bdb44bca949c9f86fab3be5","6e13d61a7bdb44bca949c9f86fab3be5",22859250,3,0,1,668,47,47,0
"6e13d61a7bdb44bca949c9f86fab3be5","67a089198fcb4e1c8f2385786c2b296f",22859250,1,-11,0,671,47,39,-8
"67a089198fcb4e1c8f2385786c2b296f","f03480cf4eba413194d7af52fc0e7f28",22859250,1,141,0,672,39,152,113
"f03480cf4eba413194d7af52fc0e7f28","df1de691dafe4549a18a4398ee9dfaf9",22859250,1,-15,0,673,152,139,-13
"df1de691dafe4549a18a4398ee9dfaf9","f03480cf4eba413194d7af52fc0e7f28",22859250,1,15,0,674,139,152,13
"d313cec988a84645bee413e8d4724a4b","df1de691dafe4549a18a4398ee9dfaf9",22859250,1,-22,0,678,158,139,-19
"82e6285962b8400d9d6fc32436022a94","67a089198fcb4e1c8f2385786c2b296f",22859250,1,-162,0,738,167,39,-128
"67a089198fcb4e1c8f2385786c2b296f","67a089198fcb4e1c8f2385786c2b296f",22859250,2,0,1,739,39,39,0
"67a089198fcb4e1c8f2385786c2b296f","a9ac840f098c4bd0a2ee896214ce29cd",22859250,1,165,0,740,39,168,129
"a9ac840f098c4bd0a2ee896214ce29cd","a9ac840f098c4bd0a2ee896214ce29cd",22859250,3,0,1,741,168,168,0
"a9ac840f098c4bd0a2ee896214ce29cd","67a089198fcb4e1c8f2385786c2b296f",22859250,1,-165,0,744,168,39,-129
"67a089198fcb4e1c8f2385786c2b296f","362fcb0699a14845ab29b2340093e528",22859250,1,175,0,745,39,174,135
"362fcb0699a14845ab29b2340093e528","0c7262dff33c4087bc660ccf40f92f9c",22859250,1,-6,0,746,174,169,-5
"0c7262dff33c4087bc660ccf40f92f9c","0c7262dff33c4087bc660ccf40f92f9c",22859250,4,0,1,747,169,169,0
"b2275c3fad834f8d90737a2d9a6927d6","b2275c3fad834f8d90737a2d9a6927d6",22859250,29,0,1,750,172,172,0
"b2275c3fad834f8d90737a2d9a6927d6","eb515a26030b41f8a82a1e6114420bad",22859250,1,1,0,776,172,173,1
"eb515a26030b41f8a82a1e6114420bad","eb515a26030b41f8a82a1e6114420bad",22859250,2,0,1,777,173,173,0
"eb515a26030b41f8a82a1e6114420bad","b2275c3fad834f8d90737a2d9a6927d6",22859250,1,-1,0,779,173,172,-1
"b42cc17b7de840f181a704558d0bc845","b42cc17b7de840f181a704558d0bc845",22859250,2,0,1,785,175,175,0
"b42cc17b7de840f181a704558d0bc845","801f9e9135034f49bf5f8b4bdefedb41",22859250,1,2,0,787,175,177,2
"801f9e9135034f49bf5f8b4bdefedb41","801f9e9135034f49bf5f8b4bdefedb41",22859250,4,0,1,788,177,177,0
"801f9e9135034f49bf5f8b4bdefedb41","ea38cc0e6e6e41edbabf210220808bf9",22859250,1,3,0,792,177,179,2
"ea38cc0e6e6e41edbabf210220808bf9","362fcb0699a14845ab29b2340093e528",22859250,1,-6,0,793,179,174,-5
"362fcb0699a14845ab29b2340093e528","b87c552dd247427abe6ab5795b9c9d43",22859250,1,8,0,794,174,181,7
"b87c552dd247427abe6ab5795b9c9d43","ea38cc0e6e6e41edbabf210220808bf9",22859250,1,-2,0,795,181,179,-2
"ea38cc0e6e6e41edbabf210220808bf9","b87c552dd247427abe6ab5795b9c9d43",22859250,1,2,0,796,179,181,2
"b87c552dd247427abe6ab5795b9c9d43","b87c552dd247427abe6ab5795b9c9d43",22859250,7,0,1,797,181,181,0
"b87c552dd247427abe6ab5795b9c9d43","139b097acfca451689d80c9c6eebdf7b",22859250,1,-3,0,804,181,178,-3
"139b097acfca451689d80c9c6eebdf7b","30f660a1feb34582a739722532524f79",22859250,1,6,0,805,178,183,5
"30f660a1feb34582a739722532524f79","30f660a1feb34582a739722532524f79",22859250,3,0,1,806,183,183,0
"30f660a1feb34582a739722532524f79","2024b4885bd14338a39b7b509acbbd02",22859250,1,-1,0,809,183,182,-1
"2024b4885bd14338a39b7b509acbbd02","c3f63fe50d8e487c86bf8ef76c9cadd3",22859250,1,4,0,810,182,185,3
"c3f63fe50d8e487c86bf8ef76c9cadd3","c3f63fe50d8e487c86bf8ef76c9cadd3",22859250,1,0,1,811,185,185,0
"c3f63fe50d8e487c86bf8ef76c9cadd3","c8e371568a0c4391b25796ae4e91952e",22859250,1,3,0,812,185,186,1
"c8e371568a0c4391b25796ae4e91952e","0c7262dff33c4087bc660ccf40f92f9c",22859250,1,-23,0,813,186,169,-17
"0c7262dff33c4087bc660ccf40f92f9c","7d932b23e1c84326ae5aa4d3c0d813d1",22859250,1,25,0,814,169,188,19
"7d932b23e1c84326ae5aa4d3c0d813d1","7d932b23e1c84326ae5aa4d3c0d813d1",22859250,1,0,1,815,188,188,0
"7d932b23e1c84326ae5aa4d3c0d813d1","c8e371568a0c4391b25796ae4e91952e",22859250,1,-2,0,816,188,186,-2
"c8e371568a0c4391b25796ae4e91952e","ab11d94c6c8948ea90b88f19d2cd502b",22859250,3,5,0,817,186,190,4
"ab11d94c6c8948ea90b88f19d2cd502b","ab11d94c6c8948ea90b88f19d2cd502b",22859250,1,0,1,818,190,190,0
"ab11d94c6c8948ea90b88f19d2cd502b","f992451ed6ad4e68bb9e68ad6be7c4be",22859250,1,2,0,819,190,192,2
"f992451ed6ad4e68bb9e68ad6be7c4be","f992451ed6ad4e68bb9e68ad6be7c4be",22859250,1,0,1,820,192,192,0
"f992451ed6ad4e68bb9e68ad6be7c4be","c8e371568a0c4391b25796ae4e91952e",22859250,1,-7,0,821,192,186,-6
"ab11d94c6c8948ea90b88f19d2cd502b","6cd2dcaac46847d4a0bc53f296d90375",22859250,1,5,0,823,190,194,4
"6cd2dcaac46847d4a0bc53f296d90375","07b44a7a51e94c78b411c753fc39dab0",22859250,1,-6,0,824,194,189,-5
"07b44a7a51e94c78b411c753fc39dab0","6cd2dcaac46847d4a0bc53f296d90375",22859250,2,6,0,825,189,194,5
"6cd2dcaac46847d4a0bc53f296d90375","2d2580c9411c4972909db508d6956a58",22859250,2,2,0,826,194,196,2
"2d2580c9411c4972909db508d6956a58","2d2580c9411c4972909db508d6956a58",22859250,4,0,1,827,196,196,0
"2d2580c9411c4972909db508d6956a58","5bddb3d9ed264f3984702f048c7e5340",22859250,1,1,0,829,196,197,1
"5bddb3d9ed264f3984702f048c7e5340","5bddb3d9ed264f3984702f048c7e5340",22859250,2,0,1,830,197,197,0
"5bddb3d9ed264f3984702f048c7e5340","d5e8e2bd12a2466b9d6d90855f0eb079",22859250,1,1,0,832,197,198,1
"d5e8e2bd12a2466b9d6d90855f0eb079","d5e8e2bd12a2466b9d6d90855f0eb079",22859250,2,0,1,833,198,198,0
"d5e8e2bd12a2466b9d6d90855f0eb079","017d7ca8e0394b91aaadc9574df2202c",22859250,1,-5,0,835,198,193,-5
"017d7ca8e0394b91aaadc9574df2202c","f9170dd6bc6442b4acd832747609b09a",22859250,3,7,0,836,193,199,6
"f9170dd6bc6442b4acd832747609b09a","6cd2dcaac46847d4a0bc53f296d90375",22859250,1,-6,0,837,199,194,-5
"6cd2dcaac46847d4a0bc53f296d90375","6cd2dcaac46847d4a0bc53f296d90375",22859250,5,0,1,838,194,194,0
"6cd2dcaac46847d4a0bc53f296d90375","017d7ca8e0394b91aaadc9574df2202c",22859250,2,-1,0,841,194,193,-1
"017d7ca8e0394b91aaadc9574df2202c","54e8e9f0ea3e45c4bf3b8ac799ee31b1",22859250,1,8,0,842,193,200,7
"54e8e9f0ea3e45c4bf3b8ac799ee31b1","54e8e9f0ea3e45c4bf3b8ac799ee31b1",22859250,1,0,1,843,200,200,0
"54e8e9f0ea3e45c4bf3b8ac799ee31b1","c614a00911be4877a075f19315530fb0",22859250,1,1,0,844,200,201,1
"c614a00911be4877a075f19315530fb0","c614a00911be4877a075f19315530fb0",22859250,6,0,1,845,201,201,0
"c614a00911be4877a075f19315530fb0","78adeee1fa2c4fe0bc73f7bca9fcee86",22859250,1,-58,0,851,201,160,-41
"65202579580f4ad38d734b4ee39d22a8","67a089198fcb4e1c8f2385786c2b296f",22859250,1,-157,0,860,164,39,-125
"67a089198fcb4e1c8f2385786c2b296f","c8e371568a0c4391b25796ae4e91952e",22859250,1,192,0,862,39,186,147
"c8e371568a0c4391b25796ae4e91952e","a6c21bd8b95249c7972820a7a7d76aff",22859250,1,19,0,863,186,202,16
"a6c21bd8b95249c7972820a7a7d76aff","a6c21bd8b95249c7972820a7a7d76aff",22859250,1,0,1,864,202,202,0
"a6c21bd8b95249c7972820a7a7d76aff","bb329d880ab54120adaf203a693bb203",22859250,1,1,0,865,202,203,1
"bb329d880ab54120adaf203a693bb203","bb329d880ab54120adaf203a693bb203",22859250,1,0,1,866,203,203,0
"bb329d880ab54120adaf203a693bb203","f9170dd6bc6442b4acd832747609b09a",22859250,1,-4,0,867,203,199,-4
"f9170dd6bc6442b4acd832747609b09a","b54257a550b94ebc9538f3a90eee9d7e",22859250,1,6,0,868,199,204,5
"b54257a550b94ebc9538f3a90eee9d7e","6cd2dcaac46847d4a0bc53f296d90375",22859250,1,-12,0,869,204,194,-10
"f9170dd6bc6442b4acd832747609b09a","c8e371568a0c4391b25796ae4e91952e",22859250,1,-16,0,873,199,186,-13
"c8e371568a0c4391b25796ae4e91952e","d7f13c8d63ec4e2aa673fbb9cf9c6933",22859250,1,26,0,874,186,206,20
"d7f13c8d63ec4e2aa673fbb9cf9c6933","b9e80f77c3a44349863b19875725c384",22859250,1,1,0,875,206,207,1
"b9e80f77c3a44349863b19875725c384","7108f0e4c2584f1f9c471689ae4c885c",22859250,3,1,0,876,207,208,1
"7108f0e4c2584f1f9c471689ae4c885c","b9e80f77c3a44349863b19875725c384",22859250,2,-1,0,877,208,207,-1
"b9e80f77c3a44349863b19875725c384","b9e80f77c3a44349863b19875725c384",22859250,20,0,1,878,207,207,0
"7108f0e4c2584f1f9c471689ae4c885c","7108f0e4c2584f1f9c471689ae4c885c",22859250,17,0,1,881,208,208,0
"7108f0e4c2584f1f9c471689ae4c885c","0c7262dff33c4087bc660ccf40f92f9c",22859250,1,-51,0,884,208,169,-39
"0c7262dff33c4087bc660ccf40f92f9c","d7f13c8d63ec4e2aa673fbb9cf9c6933",22859250,1,49,0,885,169,206,37
"d7f13c8d63ec4e2aa673fbb9cf9c6933","09400e101c5d4b439cf9a26b03aae558",22859250,2,5,0,886,206,210,4
"09400e101c5d4b439cf9a26b03aae558","09400e101c5d4b439cf9a26b03aae558",22859250,1,0,1,887,210,210,0
"09400e101c5d4b439cf9a26b03aae558","a88efa7e50ce47159810ab553afa6d3a",22859250,1,2,0,888,210,212,2
"a88efa7e50ce47159810ab553afa6d3a","a88efa7e50ce47159810ab553afa6d3a",22859250,2,0,1,889,212,212,0
"a88efa7e50ce47159810ab553afa6d3a","a875096404ef4a9984b62d74cda916f9",22859250,1,-3,0,891,212,209,-3
"a875096404ef4a9984b62d74cda916f9","f7fb1952f56b4189b86a9f8b7862d2b8",22859250,2,7,0,892,209,215,6
"f7fb1952f56b4189b86a9f8b7862d2b8","be502a7a43c44bf7b682698de79d9369",22859250,3,-1,0,893,215,214,-1
"be502a7a43c44bf7b682698de79d9369","b54257a550b94ebc9538f3a90eee9d7e",22859250,1,-14,0,894,214,204,-10
"b54257a550b94ebc9538f3a90eee9d7e","c8e371568a0c4391b25796ae4e91952e",22859250,1,-22,0,895,204,186,-18
"ab11d94c6c8948ea90b88f19d2cd502b","b54257a550b94ebc9538f3a90eee9d7e",22859250,1,17,0,897,190,204,14
"b54257a550b94ebc9538f3a90eee9d7e","ab11d94c6c8948ea90b88f19d2cd502b",22859250,1,-17,0,898,204,190,-14
"ab11d94c6c8948ea90b88f19d2cd502b","07b44a7a51e94c78b411c753fc39dab0",22859250,1,-1,0,899,190,189,-1
"2d2580c9411c4972909db508d6956a58","017d7ca8e0394b91aaadc9574df2202c",22859250,1,-3,0,905,196,193,-3
"f9170dd6bc6442b4acd832747609b09a","334c2344009840079b1d0e1b7ce3d5a7",22859250,1,7,0,907,199,205,6
"334c2344009840079b1d0e1b7ce3d5a7","334c2344009840079b1d0e1b7ce3d5a7",22859250,1,0,1,908,205,205,0
"334c2344009840079b1d0e1b7ce3d5a7","d7f13c8d63ec4e2aa673fbb9cf9c6933",22859250,1,3,0,909,205,206,1
"d7f13c8d63ec4e2aa673fbb9cf9c6933","c8e371568a0c4391b25796ae4e91952e",22859250,1,-26,0,910,206,186,-20
"c8e371568a0c4391b25796ae4e91952e","7108f0e4c2584f1f9c471689ae4c885c",22859250,1,28,0,911,186,208,22
"7108f0e4c2584f1f9c471689ae4c885c","09400e101c5d4b439cf9a26b03aae558",22859250,1,3,0,946,208,210,2
"09400e101c5d4b439cf9a26b03aae558","d7f13c8d63ec4e2aa673fbb9cf9c6933",22859250,1,-5,0,947,210,206,-4
"09400e101c5d4b439cf9a26b03aae558","be502a7a43c44bf7b682698de79d9369",22859250,1,5,0,949,210,214,4
"be502a7a43c44bf7b682698de79d9369","a875096404ef4a9984b62d74cda916f9",22859250,1,-6,0,950,214,209,-5
"be502a7a43c44bf7b682698de79d9369","f7fb1952f56b4189b86a9f8b7862d2b8",22859250,1,1,0,953,214,215,1
"f7fb1952f56b4189b86a9f8b7862d2b8","f7fb1952f56b4189b86a9f8b7862d2b8",22859250,14,0,1,954,215,215,0
"f7fb1952f56b4189b86a9f8b7862d2b8","b860ee85d8bc4a2f97958cfb71be3533",22859250,1,1,0,968,215,216,1
"b860ee85d8bc4a2f97958cfb71be3533","b860ee85d8bc4a2f97958cfb71be3533",22859250,2,0,1,969,216,216,0
"b860ee85d8bc4a2f97958cfb71be3533","ec341f459285443b8361f7f15638ff08",22859250,1,-3,0,971,216,213,-3
"ec341f459285443b8361f7f15638ff08","363837c182e04711840d896ae1e0339c",22859250,1,6,0,972,213,218,5
"363837c182e04711840d896ae1e0339c","363837c182e04711840d896ae1e0339c",22859250,12,0,1,973,218,218,0
"363837c182e04711840d896ae1e0339c","01b2051f8941460d89945e3b02d1ce78",22859250,1,-1,0,985,218,217,-1
"01b2051f8941460d89945e3b02d1ce78","be502a7a43c44bf7b682698de79d9369",22859250,1,-4,0,986,217,214,-3
"be502a7a43c44bf7b682698de79d9369","be95c065e45447c1bd8215ea6f130c7a",22859250,1,7,0,987,214,219,5
"be95c065e45447c1bd8215ea6f130c7a","f7fb1952f56b4189b86a9f8b7862d2b8",22859250,1,-6,0,988,219,215,-4
"be502a7a43c44bf7b682698de79d9369","be502a7a43c44bf7b682698de79d9369",22859250,1,0,1,990,214,214,0
"be502a7a43c44bf7b682698de79d9369","ec341f459285443b8361f7f15638ff08",22859250,1,-1,0,991,214,213,-1
"ec341f459285443b8361f7f15638ff08","91125ca626c5470eb145501f8c37f8db",22859250,1,9,0,992,213,220,7
"91125ca626c5470eb145501f8c37f8db","91125ca626c5470eb145501f8c37f8db",22859250,1,0,1,993,220,220,0
"91125ca626c5470eb145501f8c37f8db","1c6721b1f63f4d30ba7746ea8af02a52",22859250,1,3,0,994,220,221,1
"1c6721b1f63f4d30ba7746ea8af02a52","d7f13c8d63ec4e2aa673fbb9cf9c6933",22859250,1,-21,0,995,221,206,-15
"d7f13c8d63ec4e2aa673fbb9cf9c6933","77ecef8eff6b4a2caea7707669bf7475",22859250,1,22,0,996,206,222,16
"77ecef8eff6b4a2caea7707669bf7475","0c7262dff33c4087bc660ccf40f92f9c",22859250,1,-71,0,997,222,169,-53
"0c7262dff33c4087bc660ccf40f92f9c","b2275c3fad834f8d90737a2d9a6927d6",22859250,2,3,0,1000,169,172,3
"b2275c3fad834f8d90737a2d9a6927d6","0c7262dff33c4087bc660ccf40f92f9c",22859250,2,-3,0,1001,172,169,-3
"0c7262dff33c4087bc660ccf40f92f9c","b42cc17b7de840f181a704558d0bc845",22859250,2,7,0,1002,169,175,6
"b42cc17b7de840f181a704558d0bc845","0c7262dff33c4087bc660ccf40f92f9c",22859250,1,-7,0,1003,175,169,-6
"0c7262dff33c4087bc660ccf40f92f9c","1c6721b1f63f4d30ba7746ea8af02a52",22859250,1,70,0,1004,169,221,52
"1c6721b1f63f4d30ba7746ea8af02a52","1c6721b1f63f4d30ba7746ea8af02a52",22859250,1,0,1,1005,221,221,0
"1c6721b1f63f4d30ba7746ea8af02a52","77ecef8eff6b4a2caea7707669bf7475",22859250,1,1,0,1006,221,222,1
"77ecef8eff6b4a2caea7707669bf7475","77ecef8eff6b4a2caea7707669bf7475",22859250,12,0,1,1007,222,222,0
"77ecef8eff6b4a2caea7707669bf7475","d03cb855c70044cf8c35d9ec0de696e3",22859250,1,3,0,1019,222,224,2
"d03cb855c70044cf8c35d9ec0de696e3","8b9ae98743bd4d4a8a87dff1c1244211",22859250,1,3,0,1020,224,227,3
"8b9ae98743bd4d4a8a87dff1c1244211","1c6721b1f63f4d30ba7746ea8af02a52",22859250,1,-7,0,1021,227,221,-6
"1c6721b1f63f4d30ba7746ea8af02a52","d03cb855c70044cf8c35d9ec0de696e3",22859250,1,4,0,1022,221,224,3
"d03cb855c70044cf8c35d9ec0de696e3","a49a937d6896486d9a5396654abcf2e1",22859250,1,2,0,1023,224,226,2
"a49a937d6896486d9a5396654abcf2e1","a49a937d6896486d9a5396654abcf2e1",22859250,3,0,1,1024,226,226,0
"a49a937d6896486d9a5396654abcf2e1","8b9ae98743bd4d4a8a87dff1c1244211",22859250,1,1,0,1027,226,227,1
"8b9ae98743bd4d4a8a87dff1c1244211","8b9ae98743bd4d4a8a87dff1c1244211",22859250,43,0,1,1028,227,227,0
"8b9ae98743bd4d4a8a87dff1c1244211","f7906d6f59b9489a91d2ef40db5a474d",22859250,1,-4,0,1071,227,223,-4
"f7906d6f59b9489a91d2ef40db5a474d","2ab1535aac1346ba8801535bf729ef37",22859250,2,7,0,1072,223,229,6
"2ab1535aac1346ba8801535bf729ef37","5152833676bf4c6cb317060be10f68db",22859250,2,-1,0,1073,229,228,-1
"5152833676bf4c6cb317060be10f68db","8b9ae98743bd4d4a8a87dff1c1244211",22859250,1,-2,0,1074,228,227,-1
"8b9ae98743bd4d4a8a87dff1c1244211","d03cb855c70044cf8c35d9ec0de696e3",22859250,3,-3,0,1075,227,224,-3
"d03cb855c70044cf8c35d9ec0de696e3","2ab1535aac1346ba8801535bf729ef37",22859250,2,6,0,1076,224,229,5
"2ab1535aac1346ba8801535bf729ef37","f7906d6f59b9489a91d2ef40db5a474d",22859250,2,-7,0,1077,229,223,-6
"f7906d6f59b9489a91d2ef40db5a474d","8b9ae98743bd4d4a8a87dff1c1244211",22859250,1,4,0,1078,223,227,4
"d03cb855c70044cf8c35d9ec0de696e3","5152833676bf4c6cb317060be10f68db",22859250,2,5,0,1080,224,228,4
"5152833676bf4c6cb317060be10f68db","d03cb855c70044cf8c35d9ec0de696e3",22859250,1,-5,0,1081,228,224,-4
"d03cb855c70044cf8c35d9ec0de696e3","d03cb855c70044cf8c35d9ec0de696e3",22859250,3,0,1,1082,224,224,0
"2ab1535aac1346ba8801535bf729ef37","a4f40fb48a8542c8949bae1f002cd9bc",22859250,1,2,0,1088,229,231,2
"a4f40fb48a8542c8949bae1f002cd9bc","a4f40fb48a8542c8949bae1f002cd9bc",22859250,2,0,1,1089,231,231,0
"a4f40fb48a8542c8949bae1f002cd9bc","8972c23e32044edb8a78fa1eed4e5947",22859250,1,1,0,1091,231,232,1
"8972c23e32044edb8a78fa1eed4e5947","8972c23e32044edb8a78fa1eed4e5947",22859250,1,0,1,1092,232,232,0
"8972c23e32044edb8a78fa1eed4e5947","92feb4a40f8344d38b6f722e42a53295",22859250,1,1,0,1093,232,233,1
"92feb4a40f8344d38b6f722e42a53295","92feb4a40f8344d38b6f722e42a53295",22859250,2,0,1,1094,233,233,0
"92feb4a40f8344d38b6f722e42a53295","2ab1535aac1346ba8801535bf729ef37",22859250,1,-4,0,1096,233,229,-4
"5152833676bf4c6cb317060be10f68db","ca3e28f290354c08aefe5b0f769604e6",22859250,1,8,0,1098,228,235,7
"ca3e28f290354c08aefe5b0f769604e6","ca3e28f290354c08aefe5b0f769604e6",22859250,4,0,1,1099,235,235,0
"ca3e28f290354c08aefe5b0f769604e6","79a35eea833e4c2c9d22fc53c3c6445c",22859250,1,1,0,1103,235,236,1
"79a35eea833e4c2c9d22fc53c3c6445c","79a35eea833e4c2c9d22fc53c3c6445c",22859250,4,0,1,1104,236,236,0
"79a35eea833e4c2c9d22fc53c3c6445c","cab89fa5c3ed45a5aa550fc0352d6a42",22859250,1,2,0,1108,236,238,2
"cab89fa5c3ed45a5aa550fc0352d6a42","cab89fa5c3ed45a5aa550fc0352d6a42",22859250,1,0,1,1109,238,238,0
"cab89fa5c3ed45a5aa550fc0352d6a42","8f68228b1518449e9615cdafee41a2bd",22859250,1,-1,0,1110,238,237,-1
"8f68228b1518449e9615cdafee41a2bd","8f68228b1518449e9615cdafee41a2bd",22859250,1,0,1,1111,237,237,0
"8f68228b1518449e9615cdafee41a2bd","2ab1535aac1346ba8801535bf729ef37",22859250,1,-9,0,1112,237,229,-8
"2ab1535aac1346ba8801535bf729ef37","0b04c8e2f86d48c7aeb7e225819cd32b",22859250,1,6,0,1113,229,234,5
"0b04c8e2f86d48c7aeb7e225819cd32b","8b9ae98743bd4d4a8a87dff1c1244211",22859250,1,-9,0,1114,234,227,-7
"5152833676bf4c6cb317060be10f68db","f7906d6f59b9489a91d2ef40db5a474d",22859250,1,-6,0,1117,228,223,-5
"f7906d6f59b9489a91d2ef40db5a474d","66d4fad4f1cf4b46be0750a99ad7a35a",22859250,1,18,0,1118,223,239,16
"66d4fad4f1cf4b46be0750a99ad7a35a","66d4fad4f1cf4b46be0750a99ad7a35a",22859250,1,0,1,1119,239,239,0
"66d4fad4f1cf4b46be0750a99ad7a35a","0b04c8e2f86d48c7aeb7e225819cd32b",22859250,1,-5,0,1120,239,234,-5
"0b04c8e2f86d48c7aeb7e225819cd32b","f53da5fd9bfe412da4b80d4742563b6c",22859250,1,8,0,1121,234,241,7
"f53da5fd9bfe412da4b80d4742563b6c","f53da5fd9bfe412da4b80d4742563b6c",22859250,1,0,1,1122,241,241,0
"f53da5fd9bfe412da4b80d4742563b6c","2ae94c0cea4d480a9d5dca8fb1d7b542",22859250,1,3,0,1123,241,242,1
"2ae94c0cea4d480a9d5dca8fb1d7b542","1c6721b1f63f4d30ba7746ea8af02a52",22859250,1,-27,0,1124,242,221,-21
"1c6721b1f63f4d30ba7746ea8af02a52","1ebf23f9d994469a85206e4c7b1bf5f5",22859250,1,30,0,1125,221,245,24
"1ebf23f9d994469a85206e4c7b1bf5f5","1ebf23f9d994469a85206e4c7b1bf5f5",22859250,10,0,1,1126,245,245,0
"1ebf23f9d994469a85206e4c7b1bf5f5","85ae675b83e8422da842cfd25596af99",22859250,1,1,0,1136,245,246,1
"85ae675b83e8422da842cfd25596af99","85ae675b83e8422da842cfd25596af99",22859250,1,0,1,1137,246,246,0
"85ae675b83e8422da842cfd25596af99","fa235f0f364d47e4ae1c87f47bf8e6ba",22859250,1,8,0,1138,246,252,6
"fa235f0f364d47e4ae1c87f47bf8e6ba","2ae94c0cea4d480a9d5dca8fb1d7b542",22859250,2,-12,0,1139,252,242,-10
"2ae94c0cea4d480a9d5dca8fb1d7b542","fa235f0f364d47e4ae1c87f47bf8e6ba",22859250,2,12,0,1140,242,252,10
"fa235f0f364d47e4ae1c87f47bf8e6ba","79f7845465cc4ed19d8e4f1429541be0",22859250,1,2,0,1141,252,254,2
"79f7845465cc4ed19d8e4f1429541be0","79f7845465cc4ed19d8e4f1429541be0",22859250,2,0,1,1142,254,254,0
"79f7845465cc4ed19d8e4f1429541be0","fa235f0f364d47e4ae1c87f47bf8e6ba",22859250,1,-2,0,1144,254,252,-2
"fa235f0f364d47e4ae1c87f47bf8e6ba","6e83e23f56544a19b94067c1c558d9c0",22859250,1,-6,0,1145,252,247,-5
"6e83e23f56544a19b94067c1c558d9c0","00f61990949545828dd12f1303d47504",22859250,1,11,0,1146,247,256,9
"00f61990949545828dd12f1303d47504","ead7bb4b64e247d2ae632ab8a296b091",22859250,1,2,0,1147,256,258,2
"ead7bb4b64e247d2ae632ab8a296b091","ead7bb4b64e247d2ae632ab8a296b091",22859250,2,0,1,1148,258,258,0
"ead7bb4b64e247d2ae632ab8a296b091","41b0048dde734bb280bac6116baa8e27",22859250,1,1,0,1150,258,259,1
"41b0048dde734bb280bac6116baa8e27","41b0048dde734bb280bac6116baa8e27",22859250,2,0,1,1151,259,259,0
"41b0048dde734bb280bac6116baa8e27","b41c5a094a604ee0915327da5cc0beb7",22859250,1,1,0,1153,259,260,1
"b41c5a094a604ee0915327da5cc0beb7","b41c5a094a604ee0915327da5cc0beb7",22859250,2,0,1,1154,260,260,0
"b41c5a094a604ee0915327da5cc0beb7","2ae94c0cea4d480a9d5dca8fb1d7b542",22859250,1,-21,0,1156,260,242,-18
"2ae94c0cea4d480a9d5dca8fb1d7b542","1ebf23f9d994469a85206e4c7b1bf5f5",22859250,1,3,0,1157,242,245,3
"1ebf23f9d994469a85206e4c7b1bf5f5","2ae94c0cea4d480a9d5dca8fb1d7b542",22859250,1,-3,0,1158,245,242,-3
"fa235f0f364d47e4ae1c87f47bf8e6ba","00f61990949545828dd12f1303d47504",22859250,1,5,0,1160,252,256,4
"00f61990949545828dd12f1303d47504","6e83e23f56544a19b94067c1c558d9c0",22859250,3,-11,0,1161,256,247,-9
"6e83e23f56544a19b94067c1c558d9c0","d546341988904f069cfa86b21457d9d9",22859250,3,5,0,1162,247,251,4
"d546341988904f069cfa86b21457d9d9","d989ebcfc12a4b669f0100dc1aa14f1e",22859250,2,5,0,1163,251,255,4
"d989ebcfc12a4b669f0100dc1aa14f1e","00f61990949545828dd12f1303d47504",22859250,1,1,0,1164,255,256,1
"00f61990949545828dd12f1303d47504","00f61990949545828dd12f1303d47504",22859250,1,0,1,1165,256,256,0
"00f61990949545828dd12f1303d47504","d546341988904f069cfa86b21457d9d9",22859250,1,-6,0,1166,256,251,-5
"d546341988904f069cfa86b21457d9d9","28c171777c52431ab6b925073bd63d46",22859250,1,15,0,1167,251,264,13
"28c171777c52431ab6b925073bd63d46","28c171777c52431ab6b925073bd63d46",22859250,7,0,1,1168,264,264,0
"28c171777c52431ab6b925073bd63d46","ac160db940cb49ae8579162b1d52bb5d",22859250,1,2,0,1175,264,266,2
"ac160db940cb49ae8579162b1d52bb5d","ac160db940cb49ae8579162b1d52bb5d",22859250,7,0,1,1176,266,266,0
"ac160db940cb49ae8579162b1d52bb5d","d989ebcfc12a4b669f0100dc1aa14f1e",22859250,1,-12,0,1183,266,255,-11
"d989ebcfc12a4b669f0100dc1aa14f1e","c6fd49b485cc4874b0bbdd9c6171e09c",22859250,2,15,0,1184,255,268,13
"c6fd49b485cc4874b0bbdd9c6171e09c","c6fd49b485cc4874b0bbdd9c6171e09c",22859250,6,0,1,1185,268,268,0
"c6fd49b485cc4874b0bbdd9c6171e09c","44240778a97c4af0937817499b75707b",22859250,1,1,0,1188,268,269,1
"44240778a97c4af0937817499b75707b","44240778a97c4af0937817499b75707b",22859250,2,0,1,1189,269,269,0
"44240778a97c4af0937817499b75707b","7aa76d3e993840d8805f097cbdbcd44b",22859250,1,-9,0,1191,269,261,-8
"7aa76d3e993840d8805f097cbdbcd44b","7028800abe7d4e27b613d1d6cbe26bf7",22859250,2,7,0,1192,261,267,6
"7028800abe7d4e27b613d1d6cbe26bf7","7aa76d3e993840d8805f097cbdbcd44b",22859250,1,-7,0,1193,267,261,-6
"7028800abe7d4e27b613d1d6cbe26bf7","fa235f0f364d47e4ae1c87f47bf8e6ba",22859250,1,-18,0,1195,267,252,-15
"fa235f0f364d47e4ae1c87f47bf8e6ba","7028800abe7d4e27b613d1d6cbe26bf7",22859250,1,18,0,1196,252,267,15
"7028800abe7d4e27b613d1d6cbe26bf7","00f61990949545828dd12f1303d47504",22859250,1,-13,0,1197,267,256,-11
"c6fd49b485cc4874b0bbdd9c6171e09c","7aa76d3e993840d8805f097cbdbcd44b",22859250,1,-8,0,1205,268,261,-7
"7aa76d3e993840d8805f097cbdbcd44b","2ae94c0cea4d480a9d5dca8fb1d7b542",22859250,1,-23,0,1206,261,242,-19
"2ae94c0cea4d480a9d5dca8fb1d7b542","0d987bed3ffa4ed0b9a2e62e97b7b30f",22859250,2,38,0,1207,242,272,30
"0d987bed3ffa4ed0b9a2e62e97b7b30f","0d987bed3ffa4ed0b9a2e62e97b7b30f",22859250,1,0,1,1208,272,272,0
"0d987bed3ffa4ed0b9a2e62e97b7b30f","bb5a47f5ea01454a8b79455422d3b9da",22859250,5,10,0,1209,272,280,8
"bb5a47f5ea01454a8b79455422d3b9da","bb5a47f5ea01454a8b79455422d3b9da",22859250,92,0,1,1210,280,280,0
"bb5a47f5ea01454a8b79455422d3b9da","82ae07bc0c9b4570a41799290d1ef399",22859250,5,-6,0,1216,280,275,-5
"82ae07bc0c9b4570a41799290d1ef399","bb5a47f5ea01454a8b79455422d3b9da",22859250,5,6,0,1217,275,280,5
"bb5a47f5ea01454a8b79455422d3b9da","0d987bed3ffa4ed0b9a2e62e97b7b30f",22859250,4,-10,0,1218,280,272,-8
"0d987bed3ffa4ed0b9a2e62e97b7b30f","94cecc3f1e7d484b8e068e79241dfd73",22859250,2,13,0,1219,272,281,9
"94cecc3f1e7d484b8e068e79241dfd73","a37477c4e4c14169ad44b06b493007f6",22859250,3,2,0,1220,281,283,2
"a37477c4e4c14169ad44b06b493007f6","fab84b4fab5940efb4ea868ef8d09396",22859250,3,3,0,1221,283,284,1
"fab84b4fab5940efb4ea868ef8d09396","94cecc3f1e7d484b8e068e79241dfd73",22859250,3,-5,0,1222,284,281,-3
"94cecc3f1e7d484b8e068e79241dfd73","0c7262dff33c4087bc660ccf40f92f9c",22859250,2,-148,0,1223,281,169,-112
"0c7262dff33c4087bc660ccf40f92f9c","2ae94c0cea4d480a9d5dca8fb1d7b542",22859250,1,97,0,1224,169,242,73
"2ae94c0cea4d480a9d5dca8fb1d7b542","7028800abe7d4e27b613d1d6cbe26bf7",22859250,1,30,0,1225,242,267,25
"7028800abe7d4e27b613d1d6cbe26bf7","7028800abe7d4e27b613d1d6cbe26bf7",22859250,1,0,1,1226,267,267,0
"7028800abe7d4e27b613d1d6cbe26bf7","1ebf23f9d994469a85206e4c7b1bf5f5",22859250,1,-27,0,1227,267,245,-22
"1ebf23f9d994469a85206e4c7b1bf5f5","fa235f0f364d47e4ae1c87f47bf8e6ba",22859250,1,9,0,1228,245,252,7
"2ae94c0cea4d480a9d5dca8fb1d7b542","00f61990949545828dd12f1303d47504",22859250,1,17,0,1230,242,256,14
"d546341988904f069cfa86b21457d9d9","7aa76d3e993840d8805f097cbdbcd44b",22859250,1,12,0,1233,251,261,10
"7aa76d3e993840d8805f097cbdbcd44b","865a4d3b43374da7944dc7d397f566d9",22859250,1,12,0,1234,261,271,10
"865a4d3b43374da7944dc7d397f566d9","865a4d3b43374da7944dc7d397f566d9",22859250,1,0,1,1235,271,271,0
"865a4d3b43374da7944dc7d397f566d9","2ae94c0cea4d480a9d5dca8fb1d7b542",22859250,1,-35,0,1236,271,242,-29
"0d987bed3ffa4ed0b9a2e62e97b7b30f","0c7262dff33c4087bc660ccf40f92f9c",22859250,1,-135,0,1238,272,169,-103
"0c7262dff33c4087bc660ccf40f92f9c","82ae07bc0c9b4570a41799290d1ef399",22859250,1,139,0,1239,169,275,106
"82ae07bc0c9b4570a41799290d1ef399","0d987bed3ffa4ed0b9a2e62e97b7b30f",22859250,1,-4,0,1240,275,272,-3
"bb5a47f5ea01454a8b79455422d3b9da","bc5524e78a8544e2ae2fdc2f3462bbec",22859250,1,-1,0,1260,280,279,-1
"bc5524e78a8544e2ae2fdc2f3462bbec","bb5a47f5ea01454a8b79455422d3b9da",22859250,1,1,0,1261,279,280,1
"94cecc3f1e7d484b8e068e79241dfd73","fab84b4fab5940efb4ea868ef8d09396",22859250,1,5,0,1340,281,284,3
"fab84b4fab5940efb4ea868ef8d09396","4a29443515bb404cb8924e1c60a63b73",22859250,1,4,0,1341,284,285,1
"4a29443515bb404cb8924e1c60a63b73","208c9b2796c944db8dacaa96082520ea",22859250,2,3,0,1342,285,288,3
"208c9b2796c944db8dacaa96082520ea","94cecc3f1e7d484b8e068e79241dfd73",22859250,1,-12,0,1343,288,281,-7
"94cecc3f1e7d484b8e068e79241dfd73","94cecc3f1e7d484b8e068e79241dfd73",22859250,1,0,1,1344,281,281,0
"0c7262dff33c4087bc660ccf40f92f9c","0d987bed3ffa4ed0b9a2e62e97b7b30f",22859250,1,135,0,1349,169,272,103
"bb5a47f5ea01454a8b79455422d3b9da","eb2a0eb537344a9e891c761662e400b6",22859250,1,-363,0,1358,280,16,-264
"eb2a0eb537344a9e891c761662e400b6","56586aa865414f538729c7f7735d2bc6",22859250,2,-8,0,1359,16,12,-4
"56586aa865414f538729c7f7735d2bc6","eb2a0eb537344a9e891c761662e400b6",22859250,1,8,0,1363,12,16,4
"eb2a0eb537344a9e891c761662e400b6","5c5ceeee4562457ba6d41515aeebfbb1",22859250,1,2,0,1364,16,17,1
"5c5ceeee4562457ba6d41515aeebfbb1","eb2a0eb537344a9e891c761662e400b6",22859250,2,-2,0,1365,17,16,-1
"eb2a0eb537344a9e891c761662e400b6","4a29443515bb404cb8924e1c60a63b73",22859250,1,375,0,1366,16,285,269
"4a29443515bb404cb8924e1c60a63b73","4a29443515bb404cb8924e1c60a63b73",22859250,1,0,1,1367,285,285,0
"208c9b2796c944db8dacaa96082520ea","208c9b2796c944db8dacaa96082520ea",22859250,1,0,1,1369,288,288,0
"208c9b2796c944db8dacaa96082520ea","4a29443515bb404cb8924e1c60a63b73",22859250,1,-3,0,1370,288,285,-3
"4a29443515bb404cb8924e1c60a63b73","7669a956527947d0add87455277e80b4",22859250,1,7,0,1371,285,291,6
"7669a956527947d0add87455277e80b4","7669a956527947d0add87455277e80b4",22859250,1,0,1,1372,291,291,0
"7669a956527947d0add87455277e80b4","869e967078f04da18dd0b0b9389a7424",22859250,1,3,0,1373,291,293,2
"869e967078f04da18dd0b0b9389a7424","6a9a3b5bde4a48daa896fe8c06eca56f",22859250,1,-5,0,1374,293,289,-4
"6a9a3b5bde4a48daa896fe8c06eca56f","869e967078f04da18dd0b0b9389a7424",22859250,1,5,0,1375,289,293,4
"869e967078f04da18dd0b0b9389a7424","51ab6291537748fab90d519aa09889d6",22859250,1,2,0,1376,293,295,2
"51ab6291537748fab90d519aa09889d6","51ab6291537748fab90d519aa09889d6",22859250,5,0,1,1377,295,295,0
"51ab6291537748fab90d519aa09889d6","34a6e49023fc4465bd5ca604330bbd1c",22859250,1,-3,0,1382,295,292,-3
"34a6e49023fc4465bd5ca604330bbd1c","21592f2a9e9c4b2f8c66ec5dbcbf6a2b",22859250,1,5,0,1383,292,296,4
"21592f2a9e9c4b2f8c66ec5dbcbf6a2b","ba0e59461bfb4a44b7b1c28a01f8d3b3",22859250,1,4,0,1384,296,299,3
"ba0e59461bfb4a44b7b1c28a01f8d3b3","ba0e59461bfb4a44b7b1c28a01f8d3b3",22859250,6,0,1,1385,299,299,0
"ba0e59461bfb4a44b7b1c28a01f8d3b3","0e0b36e731a645e7b1b8a88f5031ca38",22859250,2,2,0,1386,299,301,2
"0e0b36e731a645e7b1b8a88f5031ca38","0e0b36e731a645e7b1b8a88f5031ca38",22859250,2,0,1,1387,301,301,0
"0e0b36e731a645e7b1b8a88f5031ca38","a66a144637284c21afc6de17fea4bfb8",22859250,2,1,0,1389,301,302,1
"a66a144637284c21afc6de17fea4bfb8","a66a144637284c21afc6de17fea4bfb8",22859250,2,0,1,1390,302,302,0
"a66a144637284c21afc6de17fea4bfb8","7646a919d7e64fa990bca9b024ff089d",22859250,2,-4,0,1392,302,298,-4
"7646a919d7e64fa990bca9b024ff089d","2c5bb2cbd0014420ad8c95d40e38efd1",22859250,2,6,0,1393,298,303,5
"2c5bb2cbd0014420ad8c95d40e38efd1","ba0e59461bfb4a44b7b1c28a01f8d3b3",22859250,2,-5,0,1394,303,299,-4
"ba0e59461bfb4a44b7b1c28a01f8d3b3","7646a919d7e64fa990bca9b024ff089d",22859250,2,-1,0,1399,299,298,-1
"7646a919d7e64fa990bca9b024ff089d","e390b575229748ea8aac9364efe2bf00",22859250,1,7,0,1403,298,304,6
"e390b575229748ea8aac9364efe2bf00","e390b575229748ea8aac9364efe2bf00",22859250,1,0,1,1404,304,304,0
"e390b575229748ea8aac9364efe2bf00","4a29443515bb404cb8924e1c60a63b73",22859250,1,-24,0,1405,304,285,-19
"4a29443515bb404cb8924e1c60a63b73","3434c10e561d488a914e0f7d71907abd",22859250,2,27,0,1406,285,305,20
"3434c10e561d488a914e0f7d71907abd","53e7e900392747ccad52e711ab0f80d8",22859250,4,2,0,1407,305,307,2
"53e7e900392747ccad52e711ab0f80d8","53e7e900392747ccad52e711ab0f80d8",22859250,1,0,1,1408,307,307,0
"53e7e900392747ccad52e711ab0f80d8","130acc2aeb0448fdbb2de63bc5cebe5b",22859250,1,3,0,1409,307,309,2
"130acc2aeb0448fdbb2de63bc5cebe5b","3434c10e561d488a914e0f7d71907abd",22859250,1,-5,0,1410,309,305,-4
"3434c10e561d488a914e0f7d71907abd","130acc2aeb0448fdbb2de63bc5cebe5b",22859250,2,5,0,1411,305,309,4
"130acc2aeb0448fdbb2de63bc5cebe5b","9c062b3251034ebe90f5054e2a3b5120",22859250,1,2,0,1412,309,311,2
"9c062b3251034ebe90f5054e2a3b5120","9c062b3251034ebe90f5054e2a3b5120",22859250,2,0,1,1413,311,311,0
"9c062b3251034ebe90f5054e2a3b5120","ea859f8207e44537889daeaba13ac2e8",22859250,1,1,0,1415,311,312,1
"ea859f8207e44537889daeaba13ac2e8","ea859f8207e44537889daeaba13ac2e8",22859250,1,0,1,1416,312,312,0
"ea859f8207e44537889daeaba13ac2e8","56d94971a7a94257aa330183a8ebd0ea",22859250,1,1,0,1417,312,313,1
"56d94971a7a94257aa330183a8ebd0ea","56d94971a7a94257aa330183a8ebd0ea",22859250,1,0,1,1418,313,313,0
"56d94971a7a94257aa330183a8ebd0ea","141c0df6cd1946539aadd1c9b7068cd4",22859250,1,-5,0,1419,313,308,-5
"141c0df6cd1946539aadd1c9b7068cd4","3434c10e561d488a914e0f7d71907abd",22859250,1,-4,0,1420,308,305,-3
"3434c10e561d488a914e0f7d71907abd","3434c10e561d488a914e0f7d71907abd",22859250,3,0,1,1421,305,305,0
"53e7e900392747ccad52e711ab0f80d8","3434c10e561d488a914e0f7d71907abd",22859250,3,-2,0,1424,307,305,-2
"3434c10e561d488a914e0f7d71907abd","7646a919d7e64fa990bca9b024ff089d",22859250,1,-10,0,1425,305,298,-7
"7646a919d7e64fa990bca9b024ff089d","4a29443515bb404cb8924e1c60a63b73",22859250,2,-17,0,1426,298,285,-13
"4a29443515bb404cb8924e1c60a63b73","ba0e59461bfb4a44b7b1c28a01f8d3b3",22859250,1,18,0,1427,285,299,14
"3434c10e561d488a914e0f7d71907abd","13255e63e0aa4abf85e5211bf613d43e",22859250,1,14,0,1436,305,317,12
"13255e63e0aa4abf85e5211bf613d43e","13255e63e0aa4abf85e5211bf613d43e",22859250,1,0,1,1437,317,317,0
"13255e63e0aa4abf85e5211bf613d43e","0c787d16c9504873b1a4d903cec09948",22859250,1,-3,0,1438,317,314,-3
"0c787d16c9504873b1a4d903cec09948","86c27d40179e419c8e9d150fb6afa5d0",22859250,1,6,0,1439,314,319,5
"86c27d40179e419c8e9d150fb6afa5d0","86c27d40179e419c8e9d150fb6afa5d0",22859250,1,0,1,1440,319,319,0
"86c27d40179e419c8e9d150fb6afa5d0","8d7e0b55cf9849cda222a0f2440cec55",22859250,1,-1,0,1441,319,318,-1
"8d7e0b55cf9849cda222a0f2440cec55","47edbb64109243e6b0f8f64cdef90c6c",22859250,1,9,0,1442,318,326,8
"47edbb64109243e6b0f8f64cdef90c6c","24f1363179ad4aaa965484a78471912b",22859250,1,-3,0,1443,326,323,-3
"24f1363179ad4aaa965484a78471912b","24f1363179ad4aaa965484a78471912b",22859250,1,0,1,1444,323,323,0
"24f1363179ad4aaa965484a78471912b","3628bdce1dd2429ba924d2d4d09448d2",22859250,1,-1,0,1445,323,322,-1
"3628bdce1dd2429ba924d2d4d09448d2","56b3fd1a212a4764be39d979fde3326e",22859250,1,7,0,1446,322,328,6
"56b3fd1a212a4764be39d979fde3326e","56b3fd1a212a4764be39d979fde3326e",22859250,1,0,1,1447,328,328,0
"56b3fd1a212a4764be39d979fde3326e","3434c10e561d488a914e0f7d71907abd",22859250,1,-28,0,1448,328,305,-23
"3434c10e561d488a914e0f7d71907abd","0c4079457ede49e3aeb5e86ed84bdf35",22859250,1,31,0,1449,305,329,24
"0c4079457ede49e3aeb5e86ed84bdf35","38aea304b4fa46e1b29bb72f5cea4c93",22859250,5,2,0,1450,329,331,2
"38aea304b4fa46e1b29bb72f5cea4c93","4a29443515bb404cb8924e1c60a63b73",22859250,2,-60,0,1451,331,285,-46
"4a29443515bb404cb8924e1c60a63b73","b71bac264efb4abd97015447bd490db6",22859250,2,110,0,1452,285,370,85
"b71bac264efb4abd97015447bd490db6","b71bac264efb4abd97015447bd490db6",22859250,1,0,1,1453,370,370,0
"b71bac264efb4abd97015447bd490db6","4a29443515bb404cb8924e1c60a63b73",22859250,1,-110,0,1454,370,285,-85
"4a29443515bb404cb8924e1c60a63b73","0c4079457ede49e3aeb5e86ed84bdf35",22859250,2,58,0,1455,285,329,44
"0c4079457ede49e3aeb5e86ed84bdf35","0c4079457ede49e3aeb5e86ed84bdf35",22859250,6,0,1,1456,329,329,0
"38aea304b4fa46e1b29bb72f5cea4c93","38aea304b4fa46e1b29bb72f5cea4c93",22859250,1,0,1,1458,331,331,0
"38aea304b4fa46e1b29bb72f5cea4c93","e36d261332f14e79bb4b467aceaeb9b5",22859250,1,2,0,1459,331,333,2
"e36d261332f14e79bb4b467aceaeb9b5","e36d261332f14e79bb4b467aceaeb9b5",22859250,1,0,1,1460,333,333,0
"e36d261332f14e79bb4b467aceaeb9b5","c7e89b9d04744d2eab742fc24e3ef1ae",22859250,1,1,0,1461,333,334,1
"c7e89b9d04744d2eab742fc24e3ef1ae","c7e89b9d04744d2eab742fc24e3ef1ae",22859250,2,0,1,1462,334,334,0
"c7e89b9d04744d2eab742fc24e3ef1ae","fe49f8054b374a0ea4bb266ed135ff62",22859250,1,1,0,1464,334,335,1
"fe49f8054b374a0ea4bb266ed135ff62","fe49f8054b374a0ea4bb266ed135ff62",22859250,2,0,1,1465,335,335,0
"fe49f8054b374a0ea4bb266ed135ff62","d0a8f74af98642fe8360d22c42e45117",22859250,1,1,0,1467,335,336,1
"d0a8f74af98642fe8360d22c42e45117","d0a8f74af98642fe8360d22c42e45117",22859250,2,0,1,1468,336,336,0
"d0a8f74af98642fe8360d22c42e45117","0c4079457ede49e3aeb5e86ed84bdf35",22859250,1,-7,0,1470,336,329,-7
"0c4079457ede49e3aeb5e86ed84bdf35","a7c6339ca1da4368a18d471f0519f877",22859250,1,11,0,1471,329,339,10
"a7c6339ca1da4368a18d471f0519f877","a7c6339ca1da4368a18d471f0519f877",22859250,1,0,1,1472,339,339,0
"a7c6339ca1da4368a18d471f0519f877","bbc5139ca9024389a94db3a6f47dcff6",22859250,1,3,0,1473,339,341,2
"bbc5139ca9024389a94db3a6f47dcff6","b8b9418ab322418d9db9b40d96af873a",22859250,1,-5,0,1474,341,337,-4
"b8b9418ab322418d9db9b40d96af873a","bbc5139ca9024389a94db3a6f47dcff6",22859250,1,5,0,1475,337,341,4
"bbc5139ca9024389a94db3a6f47dcff6","bbc5139ca9024389a94db3a6f47dcff6",22859250,1,0,1,1476,341,341,0
"bbc5139ca9024389a94db3a6f47dcff6","4ee6ca9019ab4a1ab323f98094a9bd77",22859250,1,2,0,1477,341,343,2
"4ee6ca9019ab4a1ab323f98094a9bd77","4ee6ca9019ab4a1ab323f98094a9bd77",22859250,2,0,1,1478,343,343,0
"4ee6ca9019ab4a1ab323f98094a9bd77","b37947176785476f8b29d49a851366dc",22859250,1,1,0,1480,343,344,1
"b37947176785476f8b29d49a851366dc","b37947176785476f8b29d49a851366dc",22859250,2,0,1,1481,344,344,0
"b37947176785476f8b29d49a851366dc","fcea5b10d5a14a3b9324ffece8f6e1e5",22859250,1,1,0,1483,344,345,1
"fcea5b10d5a14a3b9324ffece8f6e1e5","fcea5b10d5a14a3b9324ffece8f6e1e5",22859250,2,0,1,1484,345,345,0
"fcea5b10d5a14a3b9324ffece8f6e1e5","c2490bc612d146edbe786556fab3651b",22859250,1,-5,0,1486,345,340,-5
"c2490bc612d146edbe786556fab3651b","bbc5139ca9024389a94db3a6f47dcff6",22859250,1,1,0,1487,340,341,1
"bbc5139ca9024389a94db3a6f47dcff6","4a92daef4d504e1792575a26502bb7b7",22859250,1,6,0,1488,341,346,5
"4a92daef4d504e1792575a26502bb7b7","0c4079457ede49e3aeb5e86ed84bdf35",22859250,2,-20,0,1489,346,329,-17
"0c4079457ede49e3aeb5e86ed84bdf35","4a92daef4d504e1792575a26502bb7b7",22859250,1,20,0,1490,329,346,17
"38aea304b4fa46e1b29bb72f5cea4c93","bbc5139ca9024389a94db3a6f47dcff6",22859250,1,12,0,1494,331,341,10
"bbc5139ca9024389a94db3a6f47dcff6","0c4079457ede49e3aeb5e86ed84bdf35",22859250,1,-14,0,1495,341,329,-12
"0c4079457ede49e3aeb5e86ed84bdf35","6ac8bb048b854999a47edb35fe627f11",22859250,1,21,0,1496,329,347,18
"6ac8bb048b854999a47edb35fe627f11","6ac8bb048b854999a47edb35fe627f11",22859250,1,0,1,1497,347,347,0
"6ac8bb048b854999a47edb35fe627f11","0c4079457ede49e3aeb5e86ed84bdf35",22859250,1,-21,0,1498,347,329,-18
"0c4079457ede49e3aeb5e86ed84bdf35","30ead9794d4847abaf222ca966cc8630",22859250,1,24,0,1499,329,348,19
"30ead9794d4847abaf222ca966cc8630","c20993c944444fe085345591a8bd837e",22859250,1,3,0,1500,348,351,3
"c20993c944444fe085345591a8bd837e","897b7f51242c44aab2205c72fdcbf4cd",22859250,2,1,0,1501,351,352,1
"897b7f51242c44aab2205c72fdcbf4cd","09b9678ddc3d452ea4a3d46e15826065",22859250,3,1,0,1502,352,353,1
"09b9678ddc3d452ea4a3d46e15826065","eff0de7f2dbb42dfa1a2e686efab5b6d",22859250,4,1,0,1503,353,354,1
"eff0de7f2dbb42dfa1a2e686efab5b6d","c20993c944444fe085345591a8bd837e",22859250,1,-3,0,1504,354,351,-3
"c20993c944444fe085345591a8bd837e","c20993c944444fe085345591a8bd837e",22859250,4,0,1,1505,351,351,0
"897b7f51242c44aab2205c72fdcbf4cd","897b7f51242c44aab2205c72fdcbf4cd",22859250,3,0,1,1509,352,352,0
"09b9678ddc3d452ea4a3d46e15826065","09b9678ddc3d452ea4a3d46e15826065",22859250,3,0,1,1513,353,353,0
"eff0de7f2dbb42dfa1a2e686efab5b6d","eff0de7f2dbb42dfa1a2e686efab5b6d",22859250,3,0,1,1517,354,354,0
"eff0de7f2dbb42dfa1a2e686efab5b6d","30ead9794d4847abaf222ca966cc8630",22859250,2,-6,0,1520,354,348,-6
"30ead9794d4847abaf222ca966cc8630","2fe14166dc9642c3bc666b86a57f943d",22859250,4,10,0,1521,348,357,9
"2fe14166dc9642c3bc666b86a57f943d","30ead9794d4847abaf222ca966cc8630",22859250,1,-10,0,1522,357,348,-9
"30ead9794d4847abaf222ca966cc8630","eff0de7f2dbb42dfa1a2e686efab5b6d",22859250,1,6,0,1523,348,354,6
"eff0de7f2dbb42dfa1a2e686efab5b6d","897b7f51242c44aab2205c72fdcbf4cd",22859250,2,-2,0,1524,354,352,-2
"09b9678ddc3d452ea4a3d46e15826065","897b7f51242c44aab2205c72fdcbf4cd",22859250,1,-1,0,1526,353,352,-1
"897b7f51242c44aab2205c72fdcbf4cd","c20993c944444fe085345591a8bd837e",22859250,2,-1,0,1527,352,351,-1
"c20993c944444fe085345591a8bd837e","09b9678ddc3d452ea4a3d46e15826065",22859250,2,2,0,1529,351,353,2
"2fe14166dc9642c3bc666b86a57f943d","2fe14166dc9642c3bc666b86a57f943d",22859250,1,0,1,1537,357,357,0
"2fe14166dc9642c3bc666b86a57f943d","44421dd1e13a47a388c4a19834b744c7",22859250,1,2,0,1538,357,359,2
"44421dd1e13a47a388c4a19834b744c7","44421dd1e13a47a388c4a19834b744c7",22859250,2,0,1,1539,359,359,0
"44421dd1e13a47a388c4a19834b744c7","cb5fc7ef85d547c4be1a7439d0bf6052",22859250,1,1,0,1541,359,360,1
"cb5fc7ef85d547c4be1a7439d0bf6052","cb5fc7ef85d547c4be1a7439d0bf6052",22859250,2,0,1,1542,360,360,0
"cb5fc7ef85d547c4be1a7439d0bf6052","0a8f150a4cf747acbde62f4721823da3",22859250,1,1,0,1544,360,361,1
"0a8f150a4cf747acbde62f4721823da3","0a8f150a4cf747acbde62f4721823da3",22859250,2,0,1,1545,361,361,0
"0a8f150a4cf747acbde62f4721823da3","ab8fdad974ae471f9f24c3f9dd04462e",22859250,1,1,0,1547,361,362,1
"ab8fdad974ae471f9f24c3f9dd04462e","ab8fdad974ae471f9f24c3f9dd04462e",22859250,2,0,1,1548,362,362,0
"ab8fdad974ae471f9f24c3f9dd04462e","1ba8fef685d74a8194b9db252eb704fb",22859250,1,-7,0,1550,362,355,-7
"1ba8fef685d74a8194b9db252eb704fb","52580888dadb4fe3baa795683ea227bd",22859250,1,10,0,1551,355,364,9
"52580888dadb4fe3baa795683ea227bd","52580888dadb4fe3baa795683ea227bd",22859250,1,0,1,1552,364,364,0
"52580888dadb4fe3baa795683ea227bd","f00179e251a045b39c3f7a54f9aa4acc",22859250,1,-1,0,1553,364,363,-1
"f00179e251a045b39c3f7a54f9aa4acc","492a3bc6a1254f23a7998587961b22a4",22859250,1,4,0,1554,363,366,3
"492a3bc6a1254f23a7998587961b22a4","072a190fd302456290895f9f04d6940a",22859250,2,-1,0,1555,366,365,-1
"072a190fd302456290895f9f04d6940a","2fe14166dc9642c3bc666b86a57f943d",22859250,1,-10,0,1556,365,357,-8
"2fe14166dc9642c3bc666b86a57f943d","4a29443515bb404cb8924e1c60a63b73",22859250,1,-92,0,1557,357,285,-72
"4a29443515bb404cb8924e1c60a63b73","6e83e23f56544a19b94067c1c558d9c0",22859250,1,-54,0,1564,285,247,-38
"6e83e23f56544a19b94067c1c558d9c0","2ae94c0cea4d480a9d5dca8fb1d7b542",22859250,1,-6,0,1565,247,242,-5
"2ae94c0cea4d480a9d5dca8fb1d7b542","0c7262dff33c4087bc660ccf40f92f9c",22859250,1,-97,0,1566,242,169,-73
"0c7262dff33c4087bc660ccf40f92f9c","072a190fd302456290895f9f04d6940a",22859250,1,259,0,1567,169,365,196
"072a190fd302456290895f9f04d6940a","30ead9794d4847abaf222ca966cc8630",22859250,1,-20,0,1568,365,348,-17
"30ead9794d4847abaf222ca966cc8630","492a3bc6a1254f23a7998587961b22a4",22859250,1,21,0,1569,348,366,18
"492a3bc6a1254f23a7998587961b22a4","492a3bc6a1254f23a7998587961b22a4",22859250,1,0,1,1570,366,366,0
"072a190fd302456290895f9f04d6940a","4a29443515bb404cb8924e1c60a63b73",22859250,1,-102,0,1572,365,285,-80
"4a29443515bb404cb8924e1c60a63b73","1ba8fef685d74a8194b9db252eb704fb",22859250,1,90,0,1573,285,355,70
"1ba8fef685d74a8194b9db252eb704fb","30ead9794d4847abaf222ca966cc8630",22859250,2,-8,0,1574,355,348,-7
"2fe14166dc9642c3bc666b86a57f943d","cfa457d1743848e4bb5e4beced6448ed",22859250,1,15,0,1576,357,369,12
"cfa457d1743848e4bb5e4beced6448ed","cfa457d1743848e4bb5e4beced6448ed",22859250,1,0,1,1577,369,369,0
"cfa457d1743848e4bb5e4beced6448ed","b71bac264efb4abd97015447bd490db6",22859250,1,3,0,1578,369,370,1
"b71bac264efb4abd97015447bd490db6","30ead9794d4847abaf222ca966cc8630",22859250,2,-28,0,1579,370,348,-22
"30ead9794d4847abaf222ca966cc8630","4a29443515bb404cb8924e1c60a63b73",22859250,1,-82,0,1580,348,285,-63
"4a29443515bb404cb8924e1c60a63b73","c76574d21bc14aeea7ecd0b027f39858",22859250,1,105,0,1581,285,367,82
"c76574d21bc14aeea7ecd0b027f39858","30ead9794d4847abaf222ca966cc8630",22859250,1,-23,0,1582,367,348,-19
"30ead9794d4847abaf222ca966cc8630","b71bac264efb4abd97015447bd490db6",22859250,1,28,0,1583,348,370,22
"30ead9794d4847abaf222ca966cc8630","8d448d625b024c82a5eb240bbd7431d6",22859250,1,33,0,1585,348,374,26
"8d448d625b024c82a5eb240bbd7431d6","8d448d625b024c82a5eb240bbd7431d6",22859250,59,0,1,1586,374,374,0
"8d448d625b024c82a5eb240bbd7431d6","b71bac264efb4abd97015447bd490db6",22859250,2,-5,0,1591,374,370,-4
"b71bac264efb4abd97015447bd490db6","8d448d625b024c82a5eb240bbd7431d6",22859250,2,5,0,1592,370,374,4
"8d448d625b024c82a5eb240bbd7431d6","0c4079457ede49e3aeb5e86ed84bdf35",22859250,1,-57,0,1594,374,329,-45
"38aea304b4fa46e1b29bb72f5cea4c93","8d448d625b024c82a5eb240bbd7431d6",22859250,1,55,0,1597,331,374,43
"b71bac264efb4abd97015447bd490db6","d6d02b6ef04e4f17805504500b8ce441",22859250,1,8,0,1645,370,375,5
"d6d02b6ef04e4f17805504500b8ce441","d6d02b6ef04e4f17805504500b8ce441",22859250,8,0,1,1646,375,375,0
"d6d02b6ef04e4f17805504500b8ce441","4a29443515bb404cb8924e1c60a63b73",22859250,2,-118,0,1647,375,285,-90
"4a29443515bb404cb8924e1c60a63b73","d6d02b6ef04e4f17805504500b8ce441",22859250,1,118,0,1648,285,375,90
"8d448d625b024c82a5eb240bbd7431d6","4a29443515bb404cb8924e1c60a63b73",22859250,1,-115,0,1666,374,285,-89
"4a29443515bb404cb8924e1c60a63b73","66baf19b6b904b70922329068c63746d",22859250,1,122,0,1667,285,376,91
"66baf19b6b904b70922329068c63746d","66baf19b6b904b70922329068c63746d",22859250,3,0,1,1668,376,376,0
"66baf19b6b904b70922329068c63746d","7f544639412e40a9ba27f43b415362ab",22859250,4,2,0,1669,376,378,2
"7f544639412e40a9ba27f43b415362ab","66baf19b6b904b70922329068c63746d",22859250,3,-2,0,1670,378,376,-2
"7f544639412e40a9ba27f43b415362ab","7f544639412e40a9ba27f43b415362ab",22859250,2,0,1,1676,378,378,0
"7f544639412e40a9ba27f43b415362ab","d5ae8642e15b46b8bd298b02274d4e9c",22859250,1,2,0,1678,378,380,2
"d5ae8642e15b46b8bd298b02274d4e9c","d5ae8642e15b46b8bd298b02274d4e9c",22859250,1,0,1,1679,380,380,0
"d5ae8642e15b46b8bd298b02274d4e9c","a0d10309a2dd456289147f84be9d37f9",22859250,1,1,0,1680,380,381,1
"a0d10309a2dd456289147f84be9d37f9","a0d10309a2dd456289147f84be9d37f9",22859250,2,0,1,1681,381,381,0
"a0d10309a2dd456289147f84be9d37f9","0fcbc3ca07b144138b8d85da581f09a8",22859250,1,1,0,1683,381,382,1
"0fcbc3ca07b144138b8d85da581f09a8","0fcbc3ca07b144138b8d85da581f09a8",22859250,2,0,1,1684,382,382,0
"0fcbc3ca07b144138b8d85da581f09a8","66baf19b6b904b70922329068c63746d",22859250,1,-6,0,1686,382,376,-6
"66baf19b6b904b70922329068c63746d","4890121ce5d74576b4632b77cfc23398",22859250,1,14,0,1687,376,388,12
"4890121ce5d74576b4632b77cfc23398","c2fca3669923477ab966ded303dea31c",22859250,1,-6,0,1688,388,383,-5
"c2fca3669923477ab966ded303dea31c","4890121ce5d74576b4632b77cfc23398",22859250,1,6,0,1689,383,388,5
"4890121ce5d74576b4632b77cfc23398","96bb2b3e85a34d8b9544514e89f6fe97",22859250,1,3,0,1690,388,390,2
"96bb2b3e85a34d8b9544514e89f6fe97","18d3b836dd804224883cc9180b60a8e1",22859250,1,-4,0,1691,390,387,-3
"18d3b836dd804224883cc9180b60a8e1","96bb2b3e85a34d8b9544514e89f6fe97",22859250,1,4,0,1692,387,390,3
"96bb2b3e85a34d8b9544514e89f6fe97","1ba8fef685d74a8194b9db252eb704fb",22859250,1,-49,0,1693,390,355,-35
"2fe14166dc9642c3bc666b86a57f943d","ac4e9b54acfe4670b4634859c7263cb5",22859250,1,49,0,1696,357,392,35
"ac4e9b54acfe4670b4634859c7263cb5","ac4e9b54acfe4670b4634859c7263cb5",22859250,1,0,1,1697,392,392,0
"ac4e9b54acfe4670b4634859c7263cb5","6f8881a745ac4c358a68b92c3b4abe81",22859250,1,3,0,1698,392,394,2
"6f8881a745ac4c358a68b92c3b4abe81","17f95d18bab743888e1736033dc3384d",22859250,1,-6,0,1699,394,389,-5
"17f95d18bab743888e1736033dc3384d","6f8881a745ac4c358a68b92c3b4abe81",22859250,1,6,0,1700,389,394,5
"6f8881a745ac4c358a68b92c3b4abe81","f7002c8484354eceac57bc7bd62c76c1",22859250,1,-1,0,1701,394,393,-1
"f7002c8484354eceac57bc7bd62c76c1","44a277ea44dc4ae689fab4b82f0b4098",22859250,1,5,0,1702,393,397,4
"44a277ea44dc4ae689fab4b82f0b4098","44a277ea44dc4ae689fab4b82f0b4098",22859250,1,0,1,1703,397,397,0
"44a277ea44dc4ae689fab4b82f0b4098","0c12af0a4e7f4002852cf84b2537c161",22859250,1,-2,0,1704,397,395,-2
"0c12af0a4e7f4002852cf84b2537c161","859e0b8d71694b12befb69ee698138f9",22859250,1,5,0,1705,395,399,4
"859e0b8d71694b12befb69ee698138f9","859e0b8d71694b12befb69ee698138f9",22859250,1,0,1,1706,399,399,0
"859e0b8d71694b12befb69ee698138f9","2b09a08242b54983aec7063990fb3f66",22859250,1,3,0,1707,399,400,1
"2b09a08242b54983aec7063990fb3f66","66baf19b6b904b70922329068c63746d",22859250,2,-32,0,1708,400,376,-24
"66baf19b6b904b70922329068c63746d","2b09a08242b54983aec7063990fb3f66",22859250,2,32,0,1709,376,400,24
"2b09a08242b54983aec7063990fb3f66","2b09a08242b54983aec7063990fb3f66",22859250,14,0,1,1710,400,400,0
"2b09a08242b54983aec7063990fb3f66","1f471b7a883a4df48211e8c6a81b59a7",22859250,1,1,0,1712,400,401,1
"1f471b7a883a4df48211e8c6a81b59a7","1f471b7a883a4df48211e8c6a81b59a7",22859250,3,0,1,1713,401,401,0
"1f471b7a883a4df48211e8c6a81b59a7","66baf19b6b904b70922329068c63746d",22859250,1,-33,0,1716,401,376,-25
"2b09a08242b54983aec7063990fb3f66","9de0d567bfa84fe5b77cb76f4a76a5d1",22859250,1,5,0,1730,400,404,4
"9de0d567bfa84fe5b77cb76f4a76a5d1","9de0d567bfa84fe5b77cb76f4a76a5d1",22859250,1,0,1,1731,404,404,0
"9de0d567bfa84fe5b77cb76f4a76a5d1","1157bd665ec4472fb58b751dc5099355",22859250,1,-1,0,1732,404,403,-1
"1157bd665ec4472fb58b751dc5099355","3c8a22d2f9c146ea956609e3ed4f2559",22859250,1,3,0,1733,403,405,2
"3c8a22d2f9c146ea956609e3ed4f2559","58fc9094275e4c49be3f4ba6d4acc0a4",22859250,1,2,0,1734,405,406,1
"58fc9094275e4c49be3f4ba6d4acc0a4","58fc9094275e4c49be3f4ba6d4acc0a4",22859250,1,0,1,1735,406,406,0
"58fc9094275e4c49be3f4ba6d4acc0a4","c1c1be90b2b14c1ab4a5e1ee3c241902",22859250,1,1,0,1736,406,407,1
"c1c1be90b2b14c1ab4a5e1ee3c241902","c1c1be90b2b14c1ab4a5e1ee3c241902",22859250,5,0,1,1737,407,407,0
"c1c1be90b2b14c1ab4a5e1ee3c241902","58fc9094275e4c49be3f4ba6d4acc0a4",22859250,1,-1,0,1742,407,406,-1
"58fc9094275e4c49be3f4ba6d4acc0a4","02b3a1bead9244c1ba2f857c7da8f82a",22859250,1,3,0,1743,406,408,2
"02b3a1bead9244c1ba2f857c7da8f82a","02b3a1bead9244c1ba2f857c7da8f82a",22859250,1,0,1,1744,408,408,0
"02b3a1bead9244c1ba2f857c7da8f82a","6206fc6479014bb193084c32409dc1b9",22859250,1,1,0,1745,408,409,1
"6206fc6479014bb193084c32409dc1b9","6206fc6479014bb193084c32409dc1b9",22859250,1,0,1,1746,409,409,0
"6206fc6479014bb193084c32409dc1b9","6a5f020451db426dacba9e2ea3fcc62a",22859250,1,2,0,1747,409,410,1
"6a5f020451db426dacba9e2ea3fcc62a","02b3a1bead9244c1ba2f857c7da8f82a",22859250,1,-3,0,1748,410,408,-2
"02b3a1bead9244c1ba2f857c7da8f82a","6a5f020451db426dacba9e2ea3fcc62a",22859250,1,3,0,1749,408,410,2
"6a5f020451db426dacba9e2ea3fcc62a","33a9d248b2e44588a5b07fc1342b9bc2",22859250,2,2,0,1750,410,411,1
"33a9d248b2e44588a5b07fc1342b9bc2","6a5f020451db426dacba9e2ea3fcc62a",22859250,1,-2,0,1751,411,410,-1
"33a9d248b2e44588a5b07fc1342b9bc2","c6f26bd420634f1cb7989e76fe6b16c0",22859250,1,1,0,1753,411,412,1
"c6f26bd420634f1cb7989e76fe6b16c0","c6f26bd420634f1cb7989e76fe6b16c0",22859250,5,0,1,1754,412,412,0
"c6f26bd420634f1cb7989e76fe6b16c0","2a65ee6e2ac64f6a8a55fbe5373ec763",22859250,1,1,0,1759,412,413,1
"2a65ee6e2ac64f6a8a55fbe5373ec763","2a65ee6e2ac64f6a8a55fbe5373ec763",22859250,2,0,1,1760,413,413,0
"2a65ee6e2ac64f6a8a55fbe5373ec763","33a9d248b2e44588a5b07fc1342b9bc2",22859250,1,-2,0,1762,413,411,-2
"33a9d248b2e44588a5b07fc1342b9bc2","2b09a08242b54983aec7063990fb3f66",22859250,1,-17,0,1763,411,400,-11
"2b09a08242b54983aec7063990fb3f66","33a9d248b2e44588a5b07fc1342b9bc2",22859250,1,17,0,1764,400,411,11
"33a9d248b2e44588a5b07fc1342b9bc2","33a9d248b2e44588a5b07fc1342b9bc2",22859250,1,0,1,1765,411,411,0
"33a9d248b2e44588a5b07fc1342b9bc2","1fd0f6dadbc14ebc965faf6122190b96",22859250,1,5,0,1766,411,415,4
"1fd0f6dadbc14ebc965faf6122190b96","1fd0f6dadbc14ebc965faf6122190b96",22859250,1,0,1,1767,415,415,0
"1fd0f6dadbc14ebc965faf6122190b96","687055dad9fc40c3982478fe33ec01bf",22859250,1,-1,0,1768,415,414,-1
"687055dad9fc40c3982478fe33ec01bf","2add1669f08d4101913db15f8c23b3b7",22859250,1,3,0,1769,414,416,2
"2add1669f08d4101913db15f8c23b3b7","2add1669f08d4101913db15f8c23b3b7",22859250,1,0,1,1770,416,416,0
"2add1669f08d4101913db15f8c23b3b7","2b09a08242b54983aec7063990fb3f66",22859250,1,-24,0,1771,416,400,-16
"2b09a08242b54983aec7063990fb3f66","a2b4bd40cee2481ebd3fc179d6a5cd62",22859250,1,27,0,1772,400,417,17
"a2b4bd40cee2481ebd3fc179d6a5cd62","e34e59dce2204f228f3a84b6725df60f",22859250,1,2,0,1773,417,419,2
"e34e59dce2204f228f3a84b6725df60f","e34e59dce2204f228f3a84b6725df60f",22859250,1,0,1,1774,419,419,0
"e34e59dce2204f228f3a84b6725df60f","a2b4bd40cee2481ebd3fc179d6a5cd62",22859250,1,-2,0,1775,419,417,-2
"a2b4bd40cee2481ebd3fc179d6a5cd62","bec48fc2e1294c7eb3d0aca780d731b8",22859250,1,4,0,1776,417,420,3
"bec48fc2e1294c7eb3d0aca780d731b8","bec48fc2e1294c7eb3d0aca780d731b8",22859250,2,0,1,1777,420,420,0
"bec48fc2e1294c7eb3d0aca780d731b8","a24600b0e49245f6bdba8c893cfeddb0",22859250,1,7,0,1779,420,425,5
"a24600b0e49245f6bdba8c893cfeddb0","dbde19fcce2a4c1abdc7f685c293a23f",22859250,2,-4,0,1780,425,422,-3
"dbde19fcce2a4c1abdc7f685c293a23f","2b09a08242b54983aec7063990fb3f66",22859250,1,-34,0,1781,422,400,-22
"66baf19b6b904b70922329068c63746d","a24600b0e49245f6bdba8c893cfeddb0",22859250,1,70,0,1785,376,425,49
"a24600b0e49245f6bdba8c893cfeddb0","a2b4bd40cee2481ebd3fc179d6a5cd62",22859250,2,-11,0,1786,425,417,-8
"a2b4bd40cee2481ebd3fc179d6a5cd62","a24600b0e49245f6bdba8c893cfeddb0",22859250,1,11,0,1787,417,425,8
"a24600b0e49245f6bdba8c893cfeddb0","a24600b0e49245f6bdba8c893cfeddb0",22859250,3,0,1,1788,425,425,0
"dbde19fcce2a4c1abdc7f685c293a23f","a24600b0e49245f6bdba8c893cfeddb0",22859250,1,4,0,1790,422,425,3
"a2b4bd40cee2481ebd3fc179d6a5cd62","24cf8786024543f19b89bc20034e60d7",22859250,1,18,0,1794,417,428,11
"24cf8786024543f19b89bc20034e60d7","f2a73be2f46840b182d7bd095378004e",22859250,1,1,0,1795,428,429,1
"f2a73be2f46840b182d7bd095378004e","f2a73be2f46840b182d7bd095378004e",22859250,3,0,1,1796,429,429,0
"f2a73be2f46840b182d7bd095378004e","604551fd4266430cb860fef58fa7dd61",22859250,1,1,0,1797,429,430,1
"604551fd4266430cb860fef58fa7dd61","604551fd4266430cb860fef58fa7dd61",22859250,1,0,1,1798,430,430,0
"604551fd4266430cb860fef58fa7dd61","dce46f8904594a62a6377a3587aaa663",22859250,1,2,0,1799,430,431,1
"dce46f8904594a62a6377a3587aaa663","24cf8786024543f19b89bc20034e60d7",22859250,1,-4,0,1800,431,428,-3
"24cf8786024543f19b89bc20034e60d7","dce46f8904594a62a6377a3587aaa663",22859250,2,4,0,1801,428,431,3
"dce46f8904594a62a6377a3587aaa663","061c175cc90f45fbad883025394e78dd",22859250,1,2,0,1802,431,433,2
"061c175cc90f45fbad883025394e78dd","061c175cc90f45fbad883025394e78dd",22859250,1,0,1,1803,433,433,0
"061c175cc90f45fbad883025394e78dd","9b9d0a249052413c869753b99682b0ac",22859250,1,-1,0,1804,433,432,-1
"9b9d0a249052413c869753b99682b0ac","9b9d0a249052413c869753b99682b0ac",22859250,1,0,1,1805,432,432,0
"9b9d0a249052413c869753b99682b0ac","dce46f8904594a62a6377a3587aaa663",22859250,1,-1,0,1806,432,431,-1
"dce46f8904594a62a6377a3587aaa663","f2a73be2f46840b182d7bd095378004e",22859250,1,-3,0,1807,431,429,-2
"f2a73be2f46840b182d7bd095378004e","66ada10dde9f43018588f1ced9d477fc",22859250,1,7,0,1808,429,434,5
"66ada10dde9f43018588f1ced9d477fc","f2a73be2f46840b182d7bd095378004e",22859250,1,-7,0,1809,434,429,-5
"f2a73be2f46840b182d7bd095378004e","24cf8786024543f19b89bc20034e60d7",22859250,1,-1,0,1812,429,428,-1
"dce46f8904594a62a6377a3587aaa663","dce46f8904594a62a6377a3587aaa663",22859250,3,0,1,1814,431,431,0
"dce46f8904594a62a6377a3587aaa663","66ada10dde9f43018588f1ced9d477fc",22859250,1,4,0,1815,431,434,3
"66ada10dde9f43018588f1ced9d477fc","dce46f8904594a62a6377a3587aaa663",22859250,1,-4,0,1816,434,431,-3
"dce46f8904594a62a6377a3587aaa663","74a7f8712e5449c2bc0b43c6f90dafed",22859250,1,5,0,1819,431,435,4
"74a7f8712e5449c2bc0b43c6f90dafed","74a7f8712e5449c2bc0b43c6f90dafed",22859250,1,0,1,1820,435,435,0
"74a7f8712e5449c2bc0b43c6f90dafed","66ada10dde9f43018588f1ced9d477fc",22859250,1,-1,0,1821,435,434,-1
"66ada10dde9f43018588f1ced9d477fc","bf12c96466d840a69bed7020b3f18bb8",22859250,1,3,0,1822,434,436,2
"bf12c96466d840a69bed7020b3f18bb8","bf12c96466d840a69bed7020b3f18bb8",22859250,1,0,1,1823,436,436,0
"bf12c96466d840a69bed7020b3f18bb8","070600601c4c439288445d2f0724807d",22859250,1,3,0,1824,436,437,1
"070600601c4c439288445d2f0724807d","24cf8786024543f19b89bc20034e60d7",22859250,1,-14,0,1825,437,428,-9
"24cf8786024543f19b89bc20034e60d7","1823b6de7d334a7aaabc4570719af4d9",22859250,1,16,0,1826,428,439,11
"1823b6de7d334a7aaabc4570719af4d9","1823b6de7d334a7aaabc4570719af4d9",22859250,14,0,1,1827,439,439,0
"1823b6de7d334a7aaabc4570719af4d9","0380cd76a7d44bc3a4da1f15e4d68f89",22859250,1,2,0,1841,439,440,1
"0380cd76a7d44bc3a4da1f15e4d68f89","070600601c4c439288445d2f0724807d",22859250,1,-4,0,1842,440,437,-3
"070600601c4c439288445d2f0724807d","0380cd76a7d44bc3a4da1f15e4d68f89",22859250,1,4,0,1843,437,440,3
"0380cd76a7d44bc3a4da1f15e4d68f89","23b7673c8b5443108c2ef09382834a86",22859250,2,2,0,1844,440,441,1
"23b7673c8b5443108c2ef09382834a86","0380cd76a7d44bc3a4da1f15e4d68f89",22859250,1,-2,0,1845,441,440,-1
"23b7673c8b5443108c2ef09382834a86","23b7673c8b5443108c2ef09382834a86",22859250,1,0,1,1847,441,441,0
"23b7673c8b5443108c2ef09382834a86","901e92500aea43c79f19f1b279050668",22859250,1,2,0,1848,441,442,1
"901e92500aea43c79f19f1b279050668","901e92500aea43c79f19f1b279050668",22859250,1,0,1,1849,442,442,0
"901e92500aea43c79f19f1b279050668","001339db8ced4cf78829ebe8b145449d",22859250,1,1,0,1850,442,443,1
"001339db8ced4cf78829ebe8b145449d","001339db8ced4cf78829ebe8b145449d",22859250,2,0,1,1851,443,443,0
"001339db8ced4cf78829ebe8b145449d","452745e0366e42ae81561bfddebcc6c3",22859250,1,1,0,1853,443,444,1
"452745e0366e42ae81561bfddebcc6c3","452745e0366e42ae81561bfddebcc6c3",22859250,2,0,1,1854,444,444,0
"452745e0366e42ae81561bfddebcc6c3","4660ff2089114e8db82ceb26a4f329e3",22859250,1,2,0,1856,444,445,1
"4660ff2089114e8db82ceb26a4f329e3","901e92500aea43c79f19f1b279050668",22859250,1,-4,0,1857,445,442,-3
"901e92500aea43c79f19f1b279050668","4660ff2089114e8db82ceb26a4f329e3",22859250,1,4,0,1858,442,445,3
"4660ff2089114e8db82ceb26a4f329e3","4660ff2089114e8db82ceb26a4f329e3",22859250,1,0,1,1859,445,445,0
"4660ff2089114e8db82ceb26a4f329e3","7bd5586eb9d8484eb74a433ee7bfe499",22859250,1,2,0,1860,445,446,1
"7bd5586eb9d8484eb74a433ee7bfe499","7bd5586eb9d8484eb74a433ee7bfe499",22859250,14,0,1,1861,446,446,0
"7bd5586eb9d8484eb74a433ee7bfe499","8a7f26e690f34dda97be16904518ca99",22859250,1,2,0,1875,446,447,1
"8a7f26e690f34dda97be16904518ca99","8a7f26e690f34dda97be16904518ca99",22859250,1,0,1,1876,447,447,0
"8a7f26e690f34dda97be16904518ca99","070600601c4c439288445d2f0724807d",22859250,1,-16,0,1877,447,437,-10
"070600601c4c439288445d2f0724807d","b2f0d654738f48158edff28e8d3a546e",22859250,1,21,0,1878,437,449,12
"b2f0d654738f48158edff28e8d3a546e","b2f0d654738f48158edff28e8d3a546e",22859250,2,0,1,1879,449,449,0
"b2f0d654738f48158edff28e8d3a546e","f60ee41ec635499abd48168342d32c2f",22859250,3,5,0,1881,449,453,4
"f60ee41ec635499abd48168342d32c2f","f60ee41ec635499abd48168342d32c2f",22859250,64,0,1,1882,453,453,0
"f60ee41ec635499abd48168342d32c2f","b2f0d654738f48158edff28e8d3a546e",22859250,3,-5,0,1932,453,449,-4
"b2f0d654738f48158edff28e8d3a546e","f67fbf45a5f146ed866965bc57c7c001",22859250,2,8,0,1933,449,454,5
"f67fbf45a5f146ed866965bc57c7c001","f67fbf45a5f146ed866965bc57c7c001",22859250,3,0,1,1934,454,454,0
"f67fbf45a5f146ed866965bc57c7c001","d937afe49bd24a07a550dda1c1155122",22859250,1,1,0,1936,454,455,1
"d937afe49bd24a07a550dda1c1155122","d937afe49bd24a07a550dda1c1155122",22859250,1,0,1,1937,455,455,0
"d937afe49bd24a07a550dda1c1155122","3628b3f7823443d0912a339096b69943",22859250,1,1,0,1938,455,456,1
"3628b3f7823443d0912a339096b69943","3628b3f7823443d0912a339096b69943",22859250,1,0,1,1939,456,456,0
"3628b3f7823443d0912a339096b69943","9e049ee647cf43ecbcb5ed792a8e7588",22859250,1,1,0,1940,456,457,1
"9e049ee647cf43ecbcb5ed792a8e7588","9e049ee647cf43ecbcb5ed792a8e7588",22859250,1,0,1,1941,457,457,0
"9e049ee647cf43ecbcb5ed792a8e7588","5256a214faaf410b93f76cea06428334",22859250,1,1,0,1942,457,458,1
"5256a214faaf410b93f76cea06428334","5256a214faaf410b93f76cea06428334",22859250,1,0,1,1943,458,458,0
"5256a214faaf410b93f76cea06428334","25c32b120fce40fa9b6c85133aeb4716",22859250,1,1,0,1944,458,459,1
"25c32b120fce40fa9b6c85133aeb4716","25c32b120fce40fa9b6c85133aeb4716",22859250,4,0,1,1945,459,459,0
"25c32b120fce40fa9b6c85133aeb4716","ae5ac430ea254e708a6f5deaaf7464ae",22859250,1,-516,0,1948,459,84,-375
"ae5ac430ea254e708a6f5deaaf7464ae","d646286c8051419bbc2e31dd1db55ca8",22859250,1,-20,0,1949,84,67,-17
"d646286c8051419bbc2e31dd1db55ca8","12aa6e1672ac4e7aa6449a7a8609cd72",22859250,1,-14,0,1950,67,57,-10
"12aa6e1672ac4e7aa6449a7a8609cd72","b534b89233134e30a9b5645138bfa9ee",22859250,1,-19,0,1951,57,41,-16
"b534b89233134e30a9b5645138bfa9ee","78f30e4dcac84e3cbea8b2cc6e0d62b3",22859250,1,21,0,1952,41,59,18
"a1f2f12debe5432fb7a70bcd12bacfb9","3434c10e561d488a914e0f7d71907abd",22859250,1,329,0,1954,58,305,247
"130acc2aeb0448fdbb2de63bc5cebe5b","25c32b120fce40fa9b6c85133aeb4716",22859250,1,215,0,1959,309,459,150
"25c32b120fce40fa9b6c85133aeb4716","11bc14f2204949008b7d511b933363c1",22859250,1,1,0,1961,459,460,1
"11bc14f2204949008b7d511b933363c1","11bc14f2204949008b7d511b933363c1",22859250,1,0,1,1962,460,460,0
"11bc14f2204949008b7d511b933363c1","42de338840a34d15adb66e7b14fb9d2c",22859250,1,1,0,1963,460,461,1
"42de338840a34d15adb66e7b14fb9d2c","42de338840a34d15adb66e7b14fb9d2c",22859250,3,0,1,1964,461,461,0
"42de338840a34d15adb66e7b14fb9d2c","9da37c6210b1416b8079c274f70bf600",22859250,1,1,0,1967,461,462,1
"9da37c6210b1416b8079c274f70bf600","9da37c6210b1416b8079c274f70bf600",22859250,3,0,1,1968,462,462,0
"9da37c6210b1416b8079c274f70bf600","519119f1deac45ff9ab4f13529be5c6e",22859250,1,1,0,1971,462,463,1
"519119f1deac45ff9ab4f13529be5c6e","519119f1deac45ff9ab4f13529be5c6e",22859250,1,0,1,1972,463,463,0
"519119f1deac45ff9ab4f13529be5c6e","f67fbf45a5f146ed866965bc57c7c001",22859250,1,-9,0,1973,463,454,-9
"f67fbf45a5f146ed866965bc57c7c001","c5df9f40ec14463b9dcfdc73df3e9285",22859250,2,12,0,1974,454,464,10
"c5df9f40ec14463b9dcfdc73df3e9285","c5df9f40ec14463b9dcfdc73df3e9285",22859250,2,0,1,1975,464,464,0
"c5df9f40ec14463b9dcfdc73df3e9285","83d42d95cd844fc093fc09cee250edb8",22859250,4,3,0,1976,464,465,1
"83d42d95cd844fc093fc09cee250edb8","c5df9f40ec14463b9dcfdc73df3e9285",22859250,2,-3,0,1977,465,464,-1
"83d42d95cd844fc093fc09cee250edb8","83d42d95cd844fc093fc09cee250edb8",22859250,3,0,1,1979,465,465,0
"83d42d95cd844fc093fc09cee250edb8","b2f0d654738f48158edff28e8d3a546e",22859250,1,-23,0,1981,465,449,-16
"83d42d95cd844fc093fc09cee250edb8","c9c52446b6294aa5a9c2abaed536c37e",22859250,1,-603,0,2008,465,32,-433
"c9c52446b6294aa5a9c2abaed536c37e","4e51676dc72045d99c19b9fa7b22f8bc",22859250,1,-5,0,2009,32,29,-3
"4e51676dc72045d99c19b9fa7b22f8bc","eb2a0eb537344a9e891c761662e400b6",22859250,1,-24,0,2010,29,16,-13
"b613861cecf84ffcab01afb23f660475","b613861cecf84ffcab01afb23f660475",22860165,3,0,1,1,1,1,0
"b613861cecf84ffcab01afb23f660475","e2911e79efc2420eac45d9f671463d4b",22860165,3,3,0,3,1,2,1
"e2911e79efc2420eac45d9f671463d4b","b613861cecf84ffcab01afb23f660475",22860165,2,-3,0,4,2,1,-1
"e2911e79efc2420eac45d9f671463d4b","e2911e79efc2420eac45d9f671463d4b",22860165,1,0,1,9,2,2,0
"e2911e79efc2420eac45d9f671463d4b","519d1b8c59404d67b54e96c5c8a830b2",22860165,1,1,0,10,2,3,1
"519d1b8c59404d67b54e96c5c8a830b2","519d1b8c59404d67b54e96c5c8a830b2",22860165,1,0,1,11,3,3,0
"519d1b8c59404d67b54e96c5c8a830b2","531db53f81f646edb0cdcfe0085b03b7",22860165,1,1,0,12,3,4,1
"531db53f81f646edb0cdcfe0085b03b7","531db53f81f646edb0cdcfe0085b03b7",22860165,1,0,1,13,4,4,0
"531db53f81f646edb0cdcfe0085b03b7","4f5f94b2f95141e0a9d53a61da2276da",22860165,1,1,0,14,4,5,1
"4f5f94b2f95141e0a9d53a61da2276da","4f5f94b2f95141e0a9d53a61da2276da",22860165,1,0,1,15,5,5,0
"4f5f94b2f95141e0a9d53a61da2276da","6d541c89590949f99af293c4f2333f67",22860165,1,1,0,16,5,6,1
"6d541c89590949f99af293c4f2333f67","6d541c89590949f99af293c4f2333f67",22860165,1,0,1,17,6,6,0
"6d541c89590949f99af293c4f2333f67","dd5cf0b9fe4c4f1d8f5ff8e4c04879cb",22860165,1,1,0,18,6,7,1
"dd5cf0b9fe4c4f1d8f5ff8e4c04879cb","dd5cf0b9fe4c4f1d8f5ff8e4c04879cb",22860165,1,0,1,19,7,7,0
"dd5cf0b9fe4c4f1d8f5ff8e4c04879cb","f96261861edc426abe2248be4f0a709a",22860165,1,1,0,20,7,8,1
"f96261861edc426abe2248be4f0a709a","f96261861edc426abe2248be4f0a709a",22860165,1,0,1,21,8,8,0
"f96261861edc426abe2248be4f0a709a","66b5e16f4f75454fb5b8172079f0fa83",22860165,1,1,0,22,8,9,1
"66b5e16f4f75454fb5b8172079f0fa83","66b5e16f4f75454fb5b8172079f0fa83",22860165,1,0,1,23,9,9,0
"66b5e16f4f75454fb5b8172079f0fa83","0680571d4698477995e41842c36a54b2",22860165,1,1,0,24,9,10,1
"0680571d4698477995e41842c36a54b2","0680571d4698477995e41842c36a54b2",22860165,1,0,1,25,10,10,0
"0680571d4698477995e41842c36a54b2","9112f2bffece48e08c6d2287be204085",22860165,1,1,0,26,10,11,1
"9112f2bffece48e08c6d2287be204085","9112f2bffece48e08c6d2287be204085",22860165,1,0,1,27,11,11,0
"9112f2bffece48e08c6d2287be204085","e2911e79efc2420eac45d9f671463d4b",22860165,1,-9,0,28,11,2,-9
"e2911e79efc2420eac45d9f671463d4b","56586aa865414f538729c7f7735d2bc6",22860165,1,12,0,29,2,12,10
"56586aa865414f538729c7f7735d2bc6","56586aa865414f538729c7f7735d2bc6",22860165,3,0,1,30,12,12,0
"56586aa865414f538729c7f7735d2bc6","b7f2b31585d94eb3bf86376714aa7070",22860165,1,2,0,33,12,13,1
"b7f2b31585d94eb3bf86376714aa7070","b7f2b31585d94eb3bf86376714aa7070",22860165,1,0,1,34,13,13,0
"b7f2b31585d94eb3bf86376714aa7070","3f1c815879794b929260d224becaff7e",22860165,1,2,0,35,13,14,1
"3f1c815879794b929260d224becaff7e","81c864a886d54a6b8ff85f7d736f4f95",22860165,1,2,0,36,14,15,1
"81c864a886d54a6b8ff85f7d736f4f95","5c5ceeee4562457ba6d41515aeebfbb1",22860165,1,4,0,37,15,17,2
"5c5ceeee4562457ba6d41515aeebfbb1","56586aa865414f538729c7f7735d2bc6",22860165,1,-10,0,38,17,12,-5
"56586aa865414f538729c7f7735d2bc6","9afd71a5298d4333b6849dfce1b9422c",22860165,1,13,0,39,12,18,6
"9afd71a5298d4333b6849dfce1b9422c","9afd71a5298d4333b6849dfce1b9422c",22860165,1,0,1,40,18,18,0
"9afd71a5298d4333b6849dfce1b9422c","b7719e26494940efa49512aedd0aac79",22860165,2,4,0,41,18,20,2
"b7719e26494940efa49512aedd0aac79","d4f45188d3c84a02ba08454e6403a818",22860165,1,5,0,42,20,24,4
"d4f45188d3c84a02ba08454e6403a818","d4c3b003e8274e429d2fa688d73fde6d",22860165,1,-2,0,43,24,22,-2
"d4c3b003e8274e429d2fa688d73fde6d","b7719e26494940efa49512aedd0aac79",22860165,1,-3,0,44,22,20,-2
"b7719e26494940efa49512aedd0aac79","9afd71a5298d4333b6849dfce1b9422c",22860165,1,-4,0,45,20,18,-2
"b7719e26494940efa49512aedd0aac79","b7719e26494940efa49512aedd0aac79",22860165,1,0,1,47,20,20,0
"b7719e26494940efa49512aedd0aac79","afbf7250b99d47bea07172749483ca97",22860165,1,12,0,48,20,28,8
"afbf7250b99d47bea07172749483ca97","afbf7250b99d47bea07172749483ca97",22860165,1,0,1,49,28,28,0
"afbf7250b99d47bea07172749483ca97","4e51676dc72045d99c19b9fa7b22f8bc",22860165,1,3,0,50,28,29,1
"4e51676dc72045d99c19b9fa7b22f8bc","4e51676dc72045d99c19b9fa7b22f8bc",22860165,1,0,1,51,29,29,0
"4e51676dc72045d99c19b9fa7b22f8bc","51970cfa30e643e894e66ae85c8024cc",22860165,1,3,0,52,29,31,2
"51970cfa30e643e894e66ae85c8024cc","4e51676dc72045d99c19b9fa7b22f8bc",22860165,1,-3,0,53,31,29,-2
"4e51676dc72045d99c19b9fa7b22f8bc","c33c17be71ae4d588da7369472e5bb1b",22860165,1,9,0,54,29,34,5
"c33c17be71ae4d588da7369472e5bb1b","c33c17be71ae4d588da7369472e5bb1b",22860165,1,0,1,55,34,34,0
"c33c17be71ae4d588da7369472e5bb1b","93679be414554a11b1893002f2229a93",22860165,1,3,0,56,34,35,1
"93679be414554a11b1893002f2229a93","93679be414554a11b1893002f2229a93",22860165,1,0,1,57,35,35,0
"93679be414554a11b1893002f2229a93","7040a13096d746ac84b8fac8d9752058",22860165,1,3,0,58,35,36,1
"7040a13096d746ac84b8fac8d9752058","7040a13096d746ac84b8fac8d9752058",22860165,1,0,1,59,36,36,0
"7040a13096d746ac84b8fac8d9752058","9a0dc646f934470daf08c4b56ccf73db",22860165,1,3,0,60,36,37,1
"9a0dc646f934470daf08c4b56ccf73db","9a0dc646f934470daf08c4b56ccf73db",22860165,1,0,1,61,37,37,0
"9a0dc646f934470daf08c4b56ccf73db","fc0e049d56024bc9a02c9a9c435c3df7",22860165,1,3,0,62,37,38,1
"fc0e049d56024bc9a02c9a9c435c3df7","67a089198fcb4e1c8f2385786c2b296f",22860165,1,4,0,63,38,39,1
"67a089198fcb4e1c8f2385786c2b296f","64d48c6c9c7940639a932219a6c87198",22860165,1,1,0,64,39,40,1
"64d48c6c9c7940639a932219a6c87198","67a089198fcb4e1c8f2385786c2b296f",22860165,1,-1,0,65,40,39,-1
"67a089198fcb4e1c8f2385786c2b296f","b534b89233134e30a9b5645138bfa9ee",22860165,1,4,0,66,39,41,2
"b534b89233134e30a9b5645138bfa9ee","67a089198fcb4e1c8f2385786c2b296f",22860165,1,-4,0,67,41,39,-2
"67a089198fcb4e1c8f2385786c2b296f","0e37b720d23b4e7f8b313e79313fd107",22860165,1,7,0,68,39,44,5
"0e37b720d23b4e7f8b313e79313fd107","0e37b720d23b4e7f8b313e79313fd107",22860165,1,0,1,69,44,44,0
"0e37b720d23b4e7f8b313e79313fd107","6875d67fdd5f48168b62719df449bebd",22860165,1,1,0,70,44,45,1
"6875d67fdd5f48168b62719df449bebd","6875d67fdd5f48168b62719df449bebd",22860165,1,0,1,71,45,45,0
"6875d67fdd5f48168b62719df449bebd","b534b89233134e30a9b5645138bfa9ee",22860165,1,-4,0,72,45,41,-4
"b534b89233134e30a9b5645138bfa9ee","6e13d61a7bdb44bca949c9f86fab3be5",22860165,1,7,0,73,41,47,6
"6e13d61a7bdb44bca949c9f86fab3be5","195f78799f984cc2b06c48dfe36be751",22860165,1,2,0,74,47,49,2
"195f78799f984cc2b06c48dfe36be751","195f78799f984cc2b06c48dfe36be751",22860165,2,0,1,75,49,49,0
"195f78799f984cc2b06c48dfe36be751","d9c8d8c444a64dadbbb508652c721e17",22860165,1,-3,0,77,49,46,-3
"d9c8d8c444a64dadbbb508652c721e17","d0c74f735e024943943e40333d6d337f",22860165,1,6,0,78,46,51,5
"d0c74f735e024943943e40333d6d337f","983f8ff320594b279a7f4a6fe132f9c5",22860165,1,2,0,79,51,53,2
"983f8ff320594b279a7f4a6fe132f9c5","983f8ff320594b279a7f4a6fe132f9c5",22860165,2,0,1,80,53,53,0
"983f8ff320594b279a7f4a6fe132f9c5","35adfa5d923046aebabfefd98f35ff05",22860165,1,1,0,82,53,54,1
"35adfa5d923046aebabfefd98f35ff05","35adfa5d923046aebabfefd98f35ff05",22860165,2,0,1,83,54,54,0
"35adfa5d923046aebabfefd98f35ff05","b6f8a98476224da1b40e555ececc7ed8",22860165,1,1,0,85,54,55,1
"b6f8a98476224da1b40e555ececc7ed8","b6f8a98476224da1b40e555ececc7ed8",22860165,5,0,1,86,55,55,0
"b6f8a98476224da1b40e555ececc7ed8","86e22cb5fe0e4b47a9489ecddf7ed78f",22860165,1,1,0,91,55,56,1
"86e22cb5fe0e4b47a9489ecddf7ed78f","86e22cb5fe0e4b47a9489ecddf7ed78f",22860165,2,0,1,92,56,56,0
"86e22cb5fe0e4b47a9489ecddf7ed78f","f924752d8a1149668870b1e7698486f7",22860165,1,-6,0,94,56,50,-6
"f924752d8a1149668870b1e7698486f7","a1f2f12debe5432fb7a70bcd12bacfb9",22860165,1,9,0,95,50,58,8
"78f30e4dcac84e3cbea8b2cc6e0d62b3","a1f2f12debe5432fb7a70bcd12bacfb9",22860165,1,-1,0,97,59,58,-1
"a1f2f12debe5432fb7a70bcd12bacfb9","a1f2f12debe5432fb7a70bcd12bacfb9",22860165,50,0,1,100,58,58,0
"a1f2f12debe5432fb7a70bcd12bacfb9","78f30e4dcac84e3cbea8b2cc6e0d62b3",22860165,2,1,0,148,58,59,1
"78f30e4dcac84e3cbea8b2cc6e0d62b3","78f30e4dcac84e3cbea8b2cc6e0d62b3",22860165,9,0,1,149,59,59,0
"78f30e4dcac84e3cbea8b2cc6e0d62b3","a0a418b8540d479fa6e0f653b701da8b",22860165,1,6,0,158,59,64,5
"a0a418b8540d479fa6e0f653b701da8b","bc42d26810654ea9a1df1efe1e58c7d5",22860165,1,-1,0,159,64,63,-1
"bc42d26810654ea9a1df1efe1e58c7d5","12aa6e1672ac4e7aa6449a7a8609cd72",22860165,1,-7,0,160,63,57,-6
"12aa6e1672ac4e7aa6449a7a8609cd72","4c943503763e4e349906eea3ed3c8e86",22860165,1,5,0,161,57,61,4
"4c943503763e4e349906eea3ed3c8e86","4c943503763e4e349906eea3ed3c8e86",22860165,1,0,1,162,61,61,0
"4c943503763e4e349906eea3ed3c8e86","309ccf3cc4fe429d9bfbaef53d3fa479",22860165,1,-1,0,163,61,60,-1
"309ccf3cc4fe429d9bfbaef53d3fa479","b534b89233134e30a9b5645138bfa9ee",22860165,1,-23,0,164,60,41,-19
"b534b89233134e30a9b5645138bfa9ee","d646286c8051419bbc2e31dd1db55ca8",22860165,1,33,0,165,41,67,26
"d646286c8051419bbc2e31dd1db55ca8","267f883678b24aed855fde42524975d9",22860165,1,4,0,166,67,71,4
"267f883678b24aed855fde42524975d9","267f883678b24aed855fde42524975d9",22860165,1,0,1,167,71,71,0
"267f883678b24aed855fde42524975d9","88fff56d0342490dbef9040750a20f6c",22860165,1,1,0,168,71,72,1
"88fff56d0342490dbef9040750a20f6c","88fff56d0342490dbef9040750a20f6c",22860165,1,0,1,169,72,72,0
"88fff56d0342490dbef9040750a20f6c","adb17b12b66c4a49a85fd34322f7df70",22860165,1,1,0,170,72,73,1
"adb17b12b66c4a49a85fd34322f7df70","adb17b12b66c4a49a85fd34322f7df70",22860165,1,0,1,171,73,73,0
"adb17b12b66c4a49a85fd34322f7df70","d646286c8051419bbc2e31dd1db55ca8",22860165,1,-6,0,172,73,67,-6
"d646286c8051419bbc2e31dd1db55ca8","a2becd407db34b189200a32546d9d569",22860165,1,9,0,173,67,75,8
"a2becd407db34b189200a32546d9d569","58c22b011d0f4c2ea6d13615edbb9eeb",22860165,1,2,0,174,75,77,2
"58c22b011d0f4c2ea6d13615edbb9eeb","58c22b011d0f4c2ea6d13615edbb9eeb",22860165,2,0,1,175,77,77,0
"58c22b011d0f4c2ea6d13615edbb9eeb","dd76e1861dc9461c830888729d091ee0",22860165,1,1,0,177,77,78,1
"dd76e1861dc9461c830888729d091ee0","dd76e1861dc9461c830888729d091ee0",22860165,8,0,1,178,78,78,0
"dd76e1861dc9461c830888729d091ee0","cd1d828f1a694b87913a7ea66c23803e",22860165,1,1,0,186,78,79,1
"cd1d828f1a694b87913a7ea66c23803e","cd1d828f1a694b87913a7ea66c23803e",22860165,2,0,1,187,79,79,0
"cd1d828f1a694b87913a7ea66c23803e","9176a3c2b4d2465fa8b0c67096c2a97e",22860165,1,1,0,189,79,80,1
"9176a3c2b4d2465fa8b0c67096c2a97e","9176a3c2b4d2465fa8b0c67096c2a97e",22860165,5,0,1,190,80,80,0
"9176a3c2b4d2465fa8b0c67096c2a97e","f8ec6445f7194e25b9101d4fbcb07a18",22860165,1,1,0,195,80,81,1
"f8ec6445f7194e25b9101d4fbcb07a18","f8ec6445f7194e25b9101d4fbcb07a18",22860165,2,0,1,196,81,81,0
"f8ec6445f7194e25b9101d4fbcb07a18","140d5b27b8574befad82c0a013b59dfa",22860165,1,-7,0,198,81,74,-7
"140d5b27b8574befad82c0a013b59dfa","d18a9ea32855445f8736581f5cb119ce",22860165,1,9,0,199,74,82,8
"d18a9ea32855445f8736581f5cb119ce","f564483cbd7a407681aa2fcca518cf5f",22860165,1,4,0,200,82,85,3
"f564483cbd7a407681aa2fcca518cf5f","f564483cbd7a407681aa2fcca518cf5f",22860165,1,0,1,201,85,85,0
"f564483cbd7a407681aa2fcca518cf5f","18fd01350bd5434ca636d59a599d768a",22860165,1,1,0,202,85,86,1
"18fd01350bd5434ca636d59a599d768a","18fd01350bd5434ca636d59a599d768a",22860165,9,0,1,203,86,86,0
"18fd01350bd5434ca636d59a599d768a","ae5ac430ea254e708a6f5deaaf7464ae",22860165,1,-2,0,212,86,84,-2
"ae5ac430ea254e708a6f5deaaf7464ae","6a9f0ef185fb47f0937e29daa1c71ed5",22860165,1,7,0,213,84,90,6
"6a9f0ef185fb47f0937e29daa1c71ed5","c681290961c94c4caf23b529d1ae6b9a",22860165,1,-2,0,214,90,88,-2
"c681290961c94c4caf23b529d1ae6b9a","c681290961c94c4caf23b529d1ae6b9a",22860165,5,0,1,215,88,88,0
"c681290961c94c4caf23b529d1ae6b9a","6a9f0ef185fb47f0937e29daa1c71ed5",22860165,1,2,0,220,88,90,2
"6a9f0ef185fb47f0937e29daa1c71ed5","6a9f0ef185fb47f0937e29daa1c71ed5",22860165,3,0,1,221,90,90,0
"6a9f0ef185fb47f0937e29daa1c71ed5","d646286c8051419bbc2e31dd1db55ca8",22860165,1,-27,0,224,90,67,-23
"d646286c8051419bbc2e31dd1db55ca8","e20db35ced8544ddac5bc3839145e463",22860165,1,30,0,225,67,91,24
"e20db35ced8544ddac5bc3839145e463","1febb706d7a34005ae8711ed49c76e64",22860165,1,3,0,226,91,94,3
"1febb706d7a34005ae8711ed49c76e64","1febb706d7a34005ae8711ed49c76e64",22860165,2,0,1,227,94,94,0
"1febb706d7a34005ae8711ed49c76e64","8f73ba6f5a0042f2850356ac38ac6f24",22860165,1,1,0,229,94,95,1
"8f73ba6f5a0042f2850356ac38ac6f24","8f73ba6f5a0042f2850356ac38ac6f24",22860165,5,0,1,230,95,95,0
"8f73ba6f5a0042f2850356ac38ac6f24","e2260b86653c46d7b14a41fb419dbf8c",22860165,1,1,0,235,95,96,1
"e2260b86653c46d7b14a41fb419dbf8c","e2260b86653c46d7b14a41fb419dbf8c",22860165,2,0,1,236,96,96,0
"e2260b86653c46d7b14a41fb419dbf8c","35eb641ad1d845bbba54915bce75a962",22860165,1,1,0,238,96,97,1
"35eb641ad1d845bbba54915bce75a962","35eb641ad1d845bbba54915bce75a962",22860165,2,0,1,239,97,97,0
"35eb641ad1d845bbba54915bce75a962","08be90ffbeea4795a138cd42ed8db56f",22860165,1,1,0,241,97,98,1
"08be90ffbeea4795a138cd42ed8db56f","08be90ffbeea4795a138cd42ed8db56f",22860165,5,0,1,242,98,98,0
"08be90ffbeea4795a138cd42ed8db56f","3007433c8f584dcbb5ac159c1c5f2be3",22860165,1,1,0,247,98,99,1
"3007433c8f584dcbb5ac159c1c5f2be3","3007433c8f584dcbb5ac159c1c5f2be3",22860165,2,0,1,248,99,99,0
"3007433c8f584dcbb5ac159c1c5f2be3","e20db35ced8544ddac5bc3839145e463",22860165,1,-8,0,250,99,91,-8
"e20db35ced8544ddac5bc3839145e463","00ae5f0c51874a73a41ebea838d95682",22860165,1,11,0,251,91,101,10
"00ae5f0c51874a73a41ebea838d95682","d391c8b6e56a43a7b654e9dee02d904b",22860165,1,2,0,252,101,103,2
"d391c8b6e56a43a7b654e9dee02d904b","d391c8b6e56a43a7b654e9dee02d904b",22860165,16,0,1,253,103,103,0
"d391c8b6e56a43a7b654e9dee02d904b","6111116566fc4fd9abba409322bea245",22860165,1,1,0,269,103,104,1
"6111116566fc4fd9abba409322bea245","6111116566fc4fd9abba409322bea245",22860165,2,0,1,270,104,104,0
"6111116566fc4fd9abba409322bea245","a81b2235cb9c499eb9ea8ee0a8dd9725",22860165,1,1,0,272,104,105,1
"a81b2235cb9c499eb9ea8ee0a8dd9725","a81b2235cb9c499eb9ea8ee0a8dd9725",22860165,5,0,1,273,105,105,0
"a81b2235cb9c499eb9ea8ee0a8dd9725","2d4e0ab0ef3b4d73b82c72d4621a7579",22860165,1,1,0,278,105,106,1
"2d4e0ab0ef3b4d73b82c72d4621a7579","2d4e0ab0ef3b4d73b82c72d4621a7579",22860165,2,0,1,279,106,106,0
"2d4e0ab0ef3b4d73b82c72d4621a7579","8bdebf492ebd4e62b0d522e8ab5e5197",22860165,1,1,0,281,106,107,1
"8bdebf492ebd4e62b0d522e8ab5e5197","8bdebf492ebd4e62b0d522e8ab5e5197",22860165,2,0,1,282,107,107,0
"8bdebf492ebd4e62b0d522e8ab5e5197","73039f8c1eb9409cb4caee2cf968001e",22860165,1,-7,0,284,107,100,-7
"73039f8c1eb9409cb4caee2cf968001e","4280927ec4d643238aa49c32f9e06c6c",22860165,1,10,0,285,100,109,9
"4280927ec4d643238aa49c32f9e06c6c","6e1c7c431db64442b1a7ca15b87a61bd",22860165,1,1,0,286,109,110,1
"6e1c7c431db64442b1a7ca15b87a61bd","6e1c7c431db64442b1a7ca15b87a61bd",22860165,1,0,1,287,110,110,0
"6e1c7c431db64442b1a7ca15b87a61bd","e20db35ced8544ddac5bc3839145e463",22860165,1,-21,0,288,110,91,-19
"e20db35ced8544ddac5bc3839145e463","4280927ec4d643238aa49c32f9e06c6c",22860165,1,20,0,289,91,109,18
"4280927ec4d643238aa49c32f9e06c6c","fc44e6a5f7654430af1227838224dceb",22860165,1,2,0,290,109,111,2
"fc44e6a5f7654430af1227838224dceb","fc44e6a5f7654430af1227838224dceb",22860165,2,0,1,291,111,111,0
"fc44e6a5f7654430af1227838224dceb","08111f75e22d409998cf8b85bd431f0a",22860165,1,-3,0,293,111,108,-3
"08111f75e22d409998cf8b85bd431f0a","a9ae0a3c070d455bb4369a8996313336",22860165,1,7,0,294,108,114,6
"a9ae0a3c070d455bb4369a8996313336","71cec822bcff4f30a20e75dc63ef7b65",22860165,1,2,0,295,114,116,2
"71cec822bcff4f30a20e75dc63ef7b65","71cec822bcff4f30a20e75dc63ef7b65",22860165,3,0,1,296,116,116,0
"71cec822bcff4f30a20e75dc63ef7b65","37319e88176d4aefa91d7a9980dbae91",22860165,1,-4,0,299,116,112,-4
"37319e88176d4aefa91d7a9980dbae91","62bff51286ef4f348717a3cf6fe2318f",22860165,1,9,0,300,112,120,8
"62bff51286ef4f348717a3cf6fe2318f","b1cd0e7dc3ad4a8eb91a4bfdbeb025b0",22860165,1,-2,0,301,120,118,-2
"b1cd0e7dc3ad4a8eb91a4bfdbeb025b0","b1cd0e7dc3ad4a8eb91a4bfdbeb025b0",22860165,3,0,1,302,118,118,0
"b1cd0e7dc3ad4a8eb91a4bfdbeb025b0","62bff51286ef4f348717a3cf6fe2318f",22860165,1,2,0,305,118,120,2
"62bff51286ef4f348717a3cf6fe2318f","62bff51286ef4f348717a3cf6fe2318f",22860165,3,0,1,306,120,120,0
"62bff51286ef4f348717a3cf6fe2318f","e20db35ced8544ddac5bc3839145e463",22860165,1,-33,0,309,120,91,-29
"e20db35ced8544ddac5bc3839145e463","779f9ddd1fd14d1e9e69f72219a1fdbd",22860165,1,36,0,310,91,121,30
"779f9ddd1fd14d1e9e69f72219a1fdbd","ae26e6cda8ad4a3f81bd347560d9579f",22860165,1,4,0,311,121,125,4
"ae26e6cda8ad4a3f81bd347560d9579f","ae26e6cda8ad4a3f81bd347560d9579f",22860165,1,0,1,312,125,125,0
"ae26e6cda8ad4a3f81bd347560d9579f","ee48df95832b4374aa273ceb27ec1315",22860165,1,1,0,313,125,126,1
"ee48df95832b4374aa273ceb27ec1315","ee48df95832b4374aa273ceb27ec1315",22860165,1,0,1,314,126,126,0
"ee48df95832b4374aa273ceb27ec1315","7a439da90b394756ad1777fc4c6dead5",22860165,1,1,0,315,126,127,1
"7a439da90b394756ad1777fc4c6dead5","7a439da90b394756ad1777fc4c6dead5",22860165,1,0,1,316,127,127,0
"7a439da90b394756ad1777fc4c6dead5","779f9ddd1fd14d1e9e69f72219a1fdbd",22860165,1,-6,0,317,127,121,-6
"779f9ddd1fd14d1e9e69f72219a1fdbd","a8dd5213034441ac92724b4e83eb0bb2",22860165,1,9,0,318,121,129,8
"a8dd5213034441ac92724b4e83eb0bb2","8115eab6556b45f5b415c3b8c26a12e5",22860165,1,2,0,319,129,131,2
"8115eab6556b45f5b415c3b8c26a12e5","8115eab6556b45f5b415c3b8c26a12e5",22860165,2,0,1,320,131,131,0
"8115eab6556b45f5b415c3b8c26a12e5","ec34b06efd844b46a4c4818ecdb9b8f4",22860165,1,1,0,322,131,132,1
"ec34b06efd844b46a4c4818ecdb9b8f4","ec34b06efd844b46a4c4818ecdb9b8f4",22860165,5,0,1,323,132,132,0
"ec34b06efd844b46a4c4818ecdb9b8f4","c2e1c2b9eac64109b343a088584b576b",22860165,1,1,0,328,132,133,1
"c2e1c2b9eac64109b343a088584b576b","c2e1c2b9eac64109b343a088584b576b",22860165,2,0,1,329,133,133,0
"c2e1c2b9eac64109b343a088584b576b","579338175e0b4bbb8ef3b712b5d8b54e",22860165,1,-5,0,331,133,128,-5
"579338175e0b4bbb8ef3b712b5d8b54e","8bc5795d6a984a3eace4e2811e52dd4f",22860165,1,8,0,332,128,135,7
"8bc5795d6a984a3eace4e2811e52dd4f","8bc5795d6a984a3eace4e2811e52dd4f",22860165,1,0,1,333,135,135,0
"8bc5795d6a984a3eace4e2811e52dd4f","b416d47c56a742199b5d7c7f19d6503a",22860165,1,-1,0,334,135,134,-1
"b416d47c56a742199b5d7c7f19d6503a","cd4532ad48034873ba8bce2aac0c9808",22860165,1,4,0,335,134,137,3
"cd4532ad48034873ba8bce2aac0c9808","cd4532ad48034873ba8bce2aac0c9808",22860165,5,0,1,336,137,137,0
"cd4532ad48034873ba8bce2aac0c9808","779f9ddd1fd14d1e9e69f72219a1fdbd",22860165,1,-19,0,341,137,121,-16
"779f9ddd1fd14d1e9e69f72219a1fdbd","df1de691dafe4549a18a4398ee9dfaf9",22860165,1,23,0,342,121,139,18
"df1de691dafe4549a18a4398ee9dfaf9","6c5ad271a44743479bfaea29b1db8d02",22860165,1,4,0,343,139,143,4
"6c5ad271a44743479bfaea29b1db8d02","83d311bed5374fee83d8d67a7d9d82dc",22860165,1,1,0,344,143,144,1
"83d311bed5374fee83d8d67a7d9d82dc","83d311bed5374fee83d8d67a7d9d82dc",22860165,1,0,1,345,144,144,0
"83d311bed5374fee83d8d67a7d9d82dc","402bba41861d43acb52a5abb89e8831e",22860165,1,1,0,346,144,145,1
"402bba41861d43acb52a5abb89e8831e","402bba41861d43acb52a5abb89e8831e",22860165,2,0,1,347,145,145,0
"402bba41861d43acb52a5abb89e8831e","df1de691dafe4549a18a4398ee9dfaf9",22860165,1,-6,0,349,145,139,-6
"df1de691dafe4549a18a4398ee9dfaf9","8aae34f5ddbb4052a709b12e6b0d40fa",22860165,1,9,0,350,139,147,8
"8aae34f5ddbb4052a709b12e6b0d40fa","645b3f0249f64f76af2e19eb4d0e55b7",22860165,1,2,0,351,147,149,2
"645b3f0249f64f76af2e19eb4d0e55b7","645b3f0249f64f76af2e19eb4d0e55b7",22860165,5,0,1,352,149,149,0
"645b3f0249f64f76af2e19eb4d0e55b7","7e7b8db5064d4369805ab370aac5ddfb",22860165,1,1,0,357,149,150,1
"7e7b8db5064d4369805ab370aac5ddfb","7e7b8db5064d4369805ab370aac5ddfb",22860165,2,0,1,358,150,150,0
"7e7b8db5064d4369805ab370aac5ddfb","8956d210ae7f41968fada86d4c979d6a",22860165,1,1,0,360,150,151,1
"8956d210ae7f41968fada86d4c979d6a","8956d210ae7f41968fada86d4c979d6a",22860165,2,0,1,361,151,151,0
"8956d210ae7f41968fada86d4c979d6a","f902b0f41b544d4dbf79664fd233648d",22860165,1,-5,0,363,151,146,-5
"f902b0f41b544d4dbf79664fd233648d","ae781e8b775e4ccd93bc800dad5c8376",22860165,1,8,0,364,146,153,7
"ae781e8b775e4ccd93bc800dad5c8376","ae781e8b775e4ccd93bc800dad5c8376",22860165,2,0,1,365,153,153,0
"ae781e8b775e4ccd93bc800dad5c8376","06882a8492d9499aa31555567f575ecb",22860165,1,1,0,367,153,154,1
"06882a8492d9499aa31555567f575ecb","06882a8492d9499aa31555567f575ecb",22860165,1,0,1,368,154,154,0
"06882a8492d9499aa31555567f575ecb","f293c508f409466a8f27ddd7d1e40b20",22860165,1,1,0,369,154,155,1
"f293c508f409466a8f27ddd7d1e40b20","f293c508f409466a8f27ddd7d1e40b20",22860165,2,0,1,370,155,155,0
"f293c508f409466a8f27ddd7d1e40b20","cc4ddef5bbbe48ebb605141b347c4ed1",22860165,1,1,0,372,155,156,1
"cc4ddef5bbbe48ebb605141b347c4ed1","cc4ddef5bbbe48ebb605141b347c4ed1",22860165,1,0,1,373,156,156,0
"cc4ddef5bbbe48ebb605141b347c4ed1","f03480cf4eba413194d7af52fc0e7f28",22860165,1,-4,0,374,156,152,-4
"f03480cf4eba413194d7af52fc0e7f28","d313cec988a84645bee413e8d4724a4b",22860165,1,7,0,375,152,158,6
"d313cec988a84645bee413e8d4724a4b","d313cec988a84645bee413e8d4724a4b",22860165,4,0,1,376,158,158,0
"d313cec988a84645bee413e8d4724a4b","dc60696c76a74368a60f72246e47700d",22860165,1,1,0,380,158,159,1
"dc60696c76a74368a60f72246e47700d","dc60696c76a74368a60f72246e47700d",22860165,1,0,1,381,159,159,0
"dc60696c76a74368a60f72246e47700d","df1de691dafe4549a18a4398ee9dfaf9",22860165,1,-23,0,382,159,139,-20
"df1de691dafe4549a18a4398ee9dfaf9","78adeee1fa2c4fe0bc73f7bca9fcee86",22860165,1,26,0,383,139,160,21
"65202579580f4ad38d734b4ee39d22a8","0c7262dff33c4087bc660ccf40f92f9c",22860165,2,12,0,393,164,169,5
"78adeee1fa2c4fe0bc73f7bca9fcee86","0c7262dff33c4087bc660ccf40f92f9c",22860165,1,17,0,396,160,169,9
"b2275c3fad834f8d90737a2d9a6927d6","0c7262dff33c4087bc660ccf40f92f9c",22860165,2,-3,0,398,172,169,-3
"65202579580f4ad38d734b4ee39d22a8","3cbcea2be0984e7dbd5a48195af10ce7",22860165,1,3,0,411,164,165,1
"3cbcea2be0984e7dbd5a48195af10ce7","78adeee1fa2c4fe0bc73f7bca9fcee86",22860165,1,-8,0,412,165,160,-5
"78adeee1fa2c4fe0bc73f7bca9fcee86","82e6285962b8400d9d6fc32436022a94",22860165,1,10,0,413,160,167,7
"82e6285962b8400d9d6fc32436022a94","78adeee1fa2c4fe0bc73f7bca9fcee86",22860165,1,-10,0,416,167,160,-7
"b2275c3fad834f8d90737a2d9a6927d6","b2275c3fad834f8d90737a2d9a6927d6",22860165,20,0,1,427,172,172,0
"b2275c3fad834f8d90737a2d9a6927d6","eb515a26030b41f8a82a1e6114420bad",22860165,1,1,0,447,172,173,1
"eb515a26030b41f8a82a1e6114420bad","eb515a26030b41f8a82a1e6114420bad",22860165,2,0,1,448,173,173,0
"eb515a26030b41f8a82a1e6114420bad","b42cc17b7de840f181a704558d0bc845",22860165,1,3,0,450,173,175,2
"b42cc17b7de840f181a704558d0bc845","0c7262dff33c4087bc660ccf40f92f9c",22860165,1,-7,0,451,175,169,-6
"0c7262dff33c4087bc660ccf40f92f9c","801f9e9135034f49bf5f8b4bdefedb41",22860165,1,9,0,452,169,177,8
"801f9e9135034f49bf5f8b4bdefedb41","801f9e9135034f49bf5f8b4bdefedb41",22860165,7,0,1,453,177,177,0
"801f9e9135034f49bf5f8b4bdefedb41","ea38cc0e6e6e41edbabf210220808bf9",22860165,1,3,0,460,177,179,2
"ea38cc0e6e6e41edbabf210220808bf9","362fcb0699a14845ab29b2340093e528",22860165,1,-6,0,461,179,174,-5
"362fcb0699a14845ab29b2340093e528","b87c552dd247427abe6ab5795b9c9d43",22860165,2,8,0,462,174,181,7
"b87c552dd247427abe6ab5795b9c9d43","b87c552dd247427abe6ab5795b9c9d43",22860165,10,0,1,463,181,181,0
"b87c552dd247427abe6ab5795b9c9d43","139b097acfca451689d80c9c6eebdf7b",22860165,3,-3,0,473,181,178,-3
"139b097acfca451689d80c9c6eebdf7b","30f660a1feb34582a739722532524f79",22860165,3,6,0,474,178,183,5
"30f660a1feb34582a739722532524f79","30f660a1feb34582a739722532524f79",22860165,8,0,1,475,183,183,0
"30f660a1feb34582a739722532524f79","2024b4885bd14338a39b7b509acbbd02",22860165,2,-1,0,476,183,182,-1
"2024b4885bd14338a39b7b509acbbd02","ea38cc0e6e6e41edbabf210220808bf9",22860165,1,-4,0,477,182,179,-3
"ea38cc0e6e6e41edbabf210220808bf9","b87c552dd247427abe6ab5795b9c9d43",22860165,2,2,0,478,179,181,2
"b87c552dd247427abe6ab5795b9c9d43","b42cc17b7de840f181a704558d0bc845",22860165,1,-7,0,479,181,175,-6
"b42cc17b7de840f181a704558d0bc845","139b097acfca451689d80c9c6eebdf7b",22860165,1,4,0,480,175,178,3
"139b097acfca451689d80c9c6eebdf7b","362fcb0699a14845ab29b2340093e528",22860165,1,-5,0,481,178,174,-4
"b87c552dd247427abe6ab5795b9c9d43","ea38cc0e6e6e41edbabf210220808bf9",22860165,1,-2,0,483,181,179,-2
"ea38cc0e6e6e41edbabf210220808bf9","139b097acfca451689d80c9c6eebdf7b",22860165,1,-1,0,484,179,178,-1
"30f660a1feb34582a739722532524f79","ea38cc0e6e6e41edbabf210220808bf9",22860165,1,-5,0,491,183,179,-4
"ea38cc0e6e6e41edbabf210220808bf9","2024b4885bd14338a39b7b509acbbd02",22860165,1,4,0,492,179,182,3
"2024b4885bd14338a39b7b509acbbd02","b87c552dd247427abe6ab5795b9c9d43",22860165,1,-2,0,493,182,181,-1
"139b097acfca451689d80c9c6eebdf7b","b42cc17b7de840f181a704558d0bc845",22860165,1,-4,0,495,178,175,-3
"b42cc17b7de840f181a704558d0bc845","362fcb0699a14845ab29b2340093e528",22860165,1,-1,0,496,175,174,-1
"362fcb0699a14845ab29b2340093e528","ea38cc0e6e6e41edbabf210220808bf9",22860165,1,6,0,497,174,179,5
"2024b4885bd14338a39b7b509acbbd02","c3f63fe50d8e487c86bf8ef76c9cadd3",22860165,1,4,0,504,182,185,3
"c3f63fe50d8e487c86bf8ef76c9cadd3","c3f63fe50d8e487c86bf8ef76c9cadd3",22860165,1,0,1,505,185,185,0
"c3f63fe50d8e487c86bf8ef76c9cadd3","c8e371568a0c4391b25796ae4e91952e",22860165,1,3,0,506,185,186,1
"c8e371568a0c4391b25796ae4e91952e","0c7262dff33c4087bc660ccf40f92f9c",22860165,1,-23,0,507,186,169,-17
"0c7262dff33c4087bc660ccf40f92f9c","7d932b23e1c84326ae5aa4d3c0d813d1",22860165,1,25,0,508,169,188,19
"7d932b23e1c84326ae5aa4d3c0d813d1","7d932b23e1c84326ae5aa4d3c0d813d1",22860165,1,0,1,509,188,188,0
"7d932b23e1c84326ae5aa4d3c0d813d1","c8e371568a0c4391b25796ae4e91952e",22860165,1,-2,0,510,188,186,-2
"c8e371568a0c4391b25796ae4e91952e","ab11d94c6c8948ea90b88f19d2cd502b",22860165,1,5,0,511,186,190,4
"ab11d94c6c8948ea90b88f19d2cd502b","f992451ed6ad4e68bb9e68ad6be7c4be",22860165,1,2,0,512,190,192,2
"f992451ed6ad4e68bb9e68ad6be7c4be","f992451ed6ad4e68bb9e68ad6be7c4be",22860165,3,0,1,513,192,192,0
"f992451ed6ad4e68bb9e68ad6be7c4be","07b44a7a51e94c78b411c753fc39dab0",22860165,1,-3,0,516,192,189,-3
"07b44a7a51e94c78b411c753fc39dab0","6cd2dcaac46847d4a0bc53f296d90375",22860165,1,6,0,517,189,194,5
"6cd2dcaac46847d4a0bc53f296d90375","2d2580c9411c4972909db508d6956a58",22860165,1,2,0,518,194,196,2
"2d2580c9411c4972909db508d6956a58","2d2580c9411c4972909db508d6956a58",22860165,5,0,1,519,196,196,0
"2d2580c9411c4972909db508d6956a58","5bddb3d9ed264f3984702f048c7e5340",22860165,1,1,0,524,196,197,1
"5bddb3d9ed264f3984702f048c7e5340","5bddb3d9ed264f3984702f048c7e5340",22860165,2,0,1,525,197,197,0
"5bddb3d9ed264f3984702f048c7e5340","d5e8e2bd12a2466b9d6d90855f0eb079",22860165,1,1,0,527,197,198,1
"d5e8e2bd12a2466b9d6d90855f0eb079","d5e8e2bd12a2466b9d6d90855f0eb079",22860165,2,0,1,528,198,198,0
"d5e8e2bd12a2466b9d6d90855f0eb079","017d7ca8e0394b91aaadc9574df2202c",22860165,1,-5,0,530,198,193,-5
"017d7ca8e0394b91aaadc9574df2202c","54e8e9f0ea3e45c4bf3b8ac799ee31b1",22860165,1,8,0,531,193,200,7
"54e8e9f0ea3e45c4bf3b8ac799ee31b1","54e8e9f0ea3e45c4bf3b8ac799ee31b1",22860165,1,0,1,532,200,200,0
"54e8e9f0ea3e45c4bf3b8ac799ee31b1","c614a00911be4877a075f19315530fb0",22860165,1,1,0,533,200,201,1
"c614a00911be4877a075f19315530fb0","c614a00911be4877a075f19315530fb0",22860165,6,0,1,534,201,201,0
"c614a00911be4877a075f19315530fb0","a6c21bd8b95249c7972820a7a7d76aff",22860165,1,1,0,540,201,202,1
"a6c21bd8b95249c7972820a7a7d76aff","a6c21bd8b95249c7972820a7a7d76aff",22860165,1,0,1,541,202,202,0
"a6c21bd8b95249c7972820a7a7d76aff","bb329d880ab54120adaf203a693bb203",22860165,1,1,0,542,202,203,1
"bb329d880ab54120adaf203a693bb203","bb329d880ab54120adaf203a693bb203",22860165,1,0,1,543,203,203,0
"bb329d880ab54120adaf203a693bb203","f9170dd6bc6442b4acd832747609b09a",22860165,1,-4,0,544,203,199,-4
"f9170dd6bc6442b4acd832747609b09a","b54257a550b94ebc9538f3a90eee9d7e",22860165,1,6,0,545,199,204,5
"b54257a550b94ebc9538f3a90eee9d7e","f9170dd6bc6442b4acd832747609b09a",22860165,1,-6,0,546,204,199,-5
"f9170dd6bc6442b4acd832747609b09a","334c2344009840079b1d0e1b7ce3d5a7",22860165,1,7,0,547,199,205,6
"334c2344009840079b1d0e1b7ce3d5a7","334c2344009840079b1d0e1b7ce3d5a7",22860165,2,0,1,548,205,205,0
"334c2344009840079b1d0e1b7ce3d5a7","c8e371568a0c4391b25796ae4e91952e",22860165,2,-23,0,549,205,186,-19
"c8e371568a0c4391b25796ae4e91952e","d7f13c8d63ec4e2aa673fbb9cf9c6933",22860165,3,26,0,550,186,206,20
"d7f13c8d63ec4e2aa673fbb9cf9c6933","b9e80f77c3a44349863b19875725c384",22860165,1,1,0,551,206,207,1
"b9e80f77c3a44349863b19875725c384","7108f0e4c2584f1f9c471689ae4c885c",22860165,2,1,0,552,207,208,1
"7108f0e4c2584f1f9c471689ae4c885c","b9e80f77c3a44349863b19875725c384",22860165,3,-1,0,553,208,207,-1
"b9e80f77c3a44349863b19875725c384","b9e80f77c3a44349863b19875725c384",22860165,23,0,1,554,207,207,0
"7108f0e4c2584f1f9c471689ae4c885c","7108f0e4c2584f1f9c471689ae4c885c",22860165,16,0,1,578,208,208,0
"7108f0e4c2584f1f9c471689ae4c885c","09400e101c5d4b439cf9a26b03aae558",22860165,1,3,0,594,208,210,2
"09400e101c5d4b439cf9a26b03aae558","d7f13c8d63ec4e2aa673fbb9cf9c6933",22860165,1,-5,0,595,210,206,-4
"d7f13c8d63ec4e2aa673fbb9cf9c6933","a875096404ef4a9984b62d74cda916f9",22860165,1,4,0,596,206,209,3
"a875096404ef4a9984b62d74cda916f9","7108f0e4c2584f1f9c471689ae4c885c",22860165,1,-2,0,597,209,208,-1
"b9e80f77c3a44349863b19875725c384","c8e371568a0c4391b25796ae4e91952e",22860165,1,-27,0,599,207,186,-21
"d7f13c8d63ec4e2aa673fbb9cf9c6933","334c2344009840079b1d0e1b7ce3d5a7",22860165,1,-3,0,601,206,205,-1
"d7f13c8d63ec4e2aa673fbb9cf9c6933","7108f0e4c2584f1f9c471689ae4c885c",22860165,1,2,0,605,206,208,2
"b9e80f77c3a44349863b19875725c384","d7f13c8d63ec4e2aa673fbb9cf9c6933",22860165,1,-1,0,607,207,206,-1
"d7f13c8d63ec4e2aa673fbb9cf9c6933","09400e101c5d4b439cf9a26b03aae558",22860165,1,5,0,608,206,210,4
"09400e101c5d4b439cf9a26b03aae558","a88efa7e50ce47159810ab553afa6d3a",22860165,1,2,0,609,210,212,2
"a88efa7e50ce47159810ab553afa6d3a","a88efa7e50ce47159810ab553afa6d3a",22860165,5,0,1,610,212,212,0
"a88efa7e50ce47159810ab553afa6d3a","f7fb1952f56b4189b86a9f8b7862d2b8",22860165,1,4,0,615,212,215,3
"f7fb1952f56b4189b86a9f8b7862d2b8","be502a7a43c44bf7b682698de79d9369",22860165,1,-1,0,616,215,214,-1
"be502a7a43c44bf7b682698de79d9369","a875096404ef4a9984b62d74cda916f9",22860165,1,-6,0,617,214,209,-5
"a875096404ef4a9984b62d74cda916f9","f7fb1952f56b4189b86a9f8b7862d2b8",22860165,1,7,0,618,209,215,6
"f7fb1952f56b4189b86a9f8b7862d2b8","f7fb1952f56b4189b86a9f8b7862d2b8",22860165,37,0,1,619,215,215,0
"f7fb1952f56b4189b86a9f8b7862d2b8","b860ee85d8bc4a2f97958cfb71be3533",22860165,1,1,0,656,215,216,1
"b860ee85d8bc4a2f97958cfb71be3533","b860ee85d8bc4a2f97958cfb71be3533",22860165,2,0,1,657,216,216,0
"b860ee85d8bc4a2f97958cfb71be3533","ec341f459285443b8361f7f15638ff08",22860165,1,-3,0,659,216,213,-3
"ec341f459285443b8361f7f15638ff08","363837c182e04711840d896ae1e0339c",22860165,1,6,0,660,213,218,5
"363837c182e04711840d896ae1e0339c","363837c182e04711840d896ae1e0339c",22860165,12,0,1,661,218,218,0
"363837c182e04711840d896ae1e0339c","01b2051f8941460d89945e3b02d1ce78",22860165,1,-1,0,673,218,217,-1
"01b2051f8941460d89945e3b02d1ce78","91125ca626c5470eb145501f8c37f8db",22860165,1,4,0,674,217,220,3
"91125ca626c5470eb145501f8c37f8db","91125ca626c5470eb145501f8c37f8db",22860165,1,0,1,675,220,220,0
"91125ca626c5470eb145501f8c37f8db","1c6721b1f63f4d30ba7746ea8af02a52",22860165,1,3,0,676,220,221,1
"1c6721b1f63f4d30ba7746ea8af02a52","d7f13c8d63ec4e2aa673fbb9cf9c6933",22860165,1,-21,0,677,221,206,-15
"d7f13c8d63ec4e2aa673fbb9cf9c6933","77ecef8eff6b4a2caea7707669bf7475",22860165,1,22,0,678,206,222,16
"77ecef8eff6b4a2caea7707669bf7475","77ecef8eff6b4a2caea7707669bf7475",22860165,13,0,1,679,222,222,0
"77ecef8eff6b4a2caea7707669bf7475","d03cb855c70044cf8c35d9ec0de696e3",22860165,1,3,0,692,222,224,2
"d03cb855c70044cf8c35d9ec0de696e3","1c6721b1f63f4d30ba7746ea8af02a52",22860165,1,-4,0,693,224,221,-3
"1c6721b1f63f4d30ba7746ea8af02a52","8b9ae98743bd4d4a8a87dff1c1244211",22860165,1,7,0,694,221,227,6
"8b9ae98743bd4d4a8a87dff1c1244211","a49a937d6896486d9a5396654abcf2e1",22860165,1,-1,0,695,227,226,-1
"a49a937d6896486d9a5396654abcf2e1","a49a937d6896486d9a5396654abcf2e1",22860165,1,0,1,696,226,226,0
"a49a937d6896486d9a5396654abcf2e1","8b9ae98743bd4d4a8a87dff1c1244211",22860165,1,1,0,697,226,227,1
"8b9ae98743bd4d4a8a87dff1c1244211","8b9ae98743bd4d4a8a87dff1c1244211",22860165,35,0,1,698,227,227,0
"8b9ae98743bd4d4a8a87dff1c1244211","2ab1535aac1346ba8801535bf729ef37",22860165,1,3,0,733,227,229,2
"2ab1535aac1346ba8801535bf729ef37","f7906d6f59b9489a91d2ef40db5a474d",22860165,1,-7,0,734,229,223,-6
"f7906d6f59b9489a91d2ef40db5a474d","a4f40fb48a8542c8949bae1f002cd9bc",22860165,1,9,0,735,223,231,8
"a4f40fb48a8542c8949bae1f002cd9bc","a4f40fb48a8542c8949bae1f002cd9bc",22860165,2,0,1,736,231,231,0
"a4f40fb48a8542c8949bae1f002cd9bc","8972c23e32044edb8a78fa1eed4e5947",22860165,1,1,0,738,231,232,1
"8972c23e32044edb8a78fa1eed4e5947","8972c23e32044edb8a78fa1eed4e5947",22860165,3,0,1,739,232,232,0
"8972c23e32044edb8a78fa1eed4e5947","92feb4a40f8344d38b6f722e42a53295",22860165,1,1,0,742,232,233,1
"92feb4a40f8344d38b6f722e42a53295","92feb4a40f8344d38b6f722e42a53295",22860165,2,0,1,743,233,233,0
"92feb4a40f8344d38b6f722e42a53295","5152833676bf4c6cb317060be10f68db",22860165,1,-5,0,745,233,228,-5
"5152833676bf4c6cb317060be10f68db","ca3e28f290354c08aefe5b0f769604e6",22860165,1,8,0,746,228,235,7
"ca3e28f290354c08aefe5b0f769604e6","ca3e28f290354c08aefe5b0f769604e6",22860165,4,0,1,747,235,235,0
"ca3e28f290354c08aefe5b0f769604e6","79a35eea833e4c2c9d22fc53c3c6445c",22860165,1,1,0,751,235,236,1
"79a35eea833e4c2c9d22fc53c3c6445c","79a35eea833e4c2c9d22fc53c3c6445c",22860165,4,0,1,752,236,236,0
"79a35eea833e4c2c9d22fc53c3c6445c","8f68228b1518449e9615cdafee41a2bd",22860165,1,1,0,756,236,237,1
"8f68228b1518449e9615cdafee41a2bd","8f68228b1518449e9615cdafee41a2bd",22860165,1,0,1,757,237,237,0
"8f68228b1518449e9615cdafee41a2bd","cab89fa5c3ed45a5aa550fc0352d6a42",22860165,1,1,0,758,237,238,1
"cab89fa5c3ed45a5aa550fc0352d6a42","cab89fa5c3ed45a5aa550fc0352d6a42",22860165,5,0,1,759,238,238,0
"cab89fa5c3ed45a5aa550fc0352d6a42","0b04c8e2f86d48c7aeb7e225819cd32b",22860165,1,-4,0,764,238,234,-4
"0b04c8e2f86d48c7aeb7e225819cd32b","f53da5fd9bfe412da4b80d4742563b6c",22860165,1,8,0,765,234,241,7
"f53da5fd9bfe412da4b80d4742563b6c","2ae94c0cea4d480a9d5dca8fb1d7b542",22860165,2,3,0,766,241,242,1
"2ae94c0cea4d480a9d5dca8fb1d7b542","1c6721b1f63f4d30ba7746ea8af02a52",22860165,4,-27,0,767,242,221,-21
"1c6721b1f63f4d30ba7746ea8af02a52","1ebf23f9d994469a85206e4c7b1bf5f5",22860165,3,30,0,768,221,245,24
"1ebf23f9d994469a85206e4c7b1bf5f5","1c6721b1f63f4d30ba7746ea8af02a52",22860165,1,-30,0,769,245,221,-24
"1c6721b1f63f4d30ba7746ea8af02a52","2ae94c0cea4d480a9d5dca8fb1d7b542",22860165,1,27,0,770,221,242,21
"2ae94c0cea4d480a9d5dca8fb1d7b542","64dbedb3ce544f6aae8e10e0cf10f16d",22860165,1,-4,0,771,242,240,-2
"64dbedb3ce544f6aae8e10e0cf10f16d","66d4fad4f1cf4b46be0750a99ad7a35a",22860165,1,-2,0,772,240,239,-1
"66d4fad4f1cf4b46be0750a99ad7a35a","66d4fad4f1cf4b46be0750a99ad7a35a",22860165,1,0,1,773,239,239,0
"66d4fad4f1cf4b46be0750a99ad7a35a","0b04c8e2f86d48c7aeb7e225819cd32b",22860165,1,-5,0,774,239,234,-5
"0b04c8e2f86d48c7aeb7e225819cd32b","2ae94c0cea4d480a9d5dca8fb1d7b542",22860165,1,11,0,775,234,242,8
"1ebf23f9d994469a85206e4c7b1bf5f5","2ae94c0cea4d480a9d5dca8fb1d7b542",22860165,1,-3,0,778,245,242,-3
"1c6721b1f63f4d30ba7746ea8af02a52","f53da5fd9bfe412da4b80d4742563b6c",22860165,1,24,0,780,221,241,20
"f53da5fd9bfe412da4b80d4742563b6c","f53da5fd9bfe412da4b80d4742563b6c",22860165,1,0,1,781,241,241,0
"1ebf23f9d994469a85206e4c7b1bf5f5","1ebf23f9d994469a85206e4c7b1bf5f5",22860165,11,0,1,785,245,245,0
"1ebf23f9d994469a85206e4c7b1bf5f5","85ae675b83e8422da842cfd25596af99",22860165,1,1,0,796,245,246,1
"85ae675b83e8422da842cfd25596af99","85ae675b83e8422da842cfd25596af99",22860165,1,0,1,797,246,246,0
"85ae675b83e8422da842cfd25596af99","2ae94c0cea4d480a9d5dca8fb1d7b542",22860165,1,-4,0,798,246,242,-4
"2ae94c0cea4d480a9d5dca8fb1d7b542","fa235f0f364d47e4ae1c87f47bf8e6ba",22860165,1,12,0,799,242,252,10
"fa235f0f364d47e4ae1c87f47bf8e6ba","79f7845465cc4ed19d8e4f1429541be0",22860165,1,2,0,800,252,254,2
"79f7845465cc4ed19d8e4f1429541be0","79f7845465cc4ed19d8e4f1429541be0",22860165,2,0,1,801,254,254,0
"79f7845465cc4ed19d8e4f1429541be0","6e83e23f56544a19b94067c1c558d9c0",22860165,1,-8,0,803,254,247,-7
"6e83e23f56544a19b94067c1c558d9c0","00f61990949545828dd12f1303d47504",22860165,1,11,0,804,247,256,9
"00f61990949545828dd12f1303d47504","ead7bb4b64e247d2ae632ab8a296b091",22860165,1,2,0,805,256,258,2
"ead7bb4b64e247d2ae632ab8a296b091","ead7bb4b64e247d2ae632ab8a296b091",22860165,2,0,1,806,258,258,0
"ead7bb4b64e247d2ae632ab8a296b091","41b0048dde734bb280bac6116baa8e27",22860165,1,1,0,808,258,259,1
"41b0048dde734bb280bac6116baa8e27","41b0048dde734bb280bac6116baa8e27",22860165,2,0,1,809,259,259,0
"41b0048dde734bb280bac6116baa8e27","b41c5a094a604ee0915327da5cc0beb7",22860165,1,1,0,811,259,260,1
"b41c5a094a604ee0915327da5cc0beb7","b41c5a094a604ee0915327da5cc0beb7",22860165,8,0,1,812,260,260,0
"b41c5a094a604ee0915327da5cc0beb7","d546341988904f069cfa86b21457d9d9",22860165,1,-10,0,820,260,251,-9
"d546341988904f069cfa86b21457d9d9","28c171777c52431ab6b925073bd63d46",22860165,1,15,0,821,251,264,13
"28c171777c52431ab6b925073bd63d46","28c171777c52431ab6b925073bd63d46",22860165,3,0,1,822,264,264,0
"28c171777c52431ab6b925073bd63d46","ac160db940cb49ae8579162b1d52bb5d",22860165,1,2,0,825,264,266,2
"ac160db940cb49ae8579162b1d52bb5d","ac160db940cb49ae8579162b1d52bb5d",22860165,3,0,1,826,266,266,0
"ac160db940cb49ae8579162b1d52bb5d","d989ebcfc12a4b669f0100dc1aa14f1e",22860165,1,-12,0,829,266,255,-11
"d989ebcfc12a4b669f0100dc1aa14f1e","c6fd49b485cc4874b0bbdd9c6171e09c",22860165,1,15,0,830,255,268,13
"c6fd49b485cc4874b0bbdd9c6171e09c","c6fd49b485cc4874b0bbdd9c6171e09c",22860165,3,0,1,831,268,268,0
"c6fd49b485cc4874b0bbdd9c6171e09c","44240778a97c4af0937817499b75707b",22860165,1,1,0,834,268,269,1
"44240778a97c4af0937817499b75707b","44240778a97c4af0937817499b75707b",22860165,2,0,1,835,269,269,0
"44240778a97c4af0937817499b75707b","7aa76d3e993840d8805f097cbdbcd44b",22860165,1,-9,0,837,269,261,-8
"7aa76d3e993840d8805f097cbdbcd44b","865a4d3b43374da7944dc7d397f566d9",22860165,1,12,0,838,261,271,10
"865a4d3b43374da7944dc7d397f566d9","865a4d3b43374da7944dc7d397f566d9",22860165,1,0,1,839,271,271,0
"865a4d3b43374da7944dc7d397f566d9","2ae94c0cea4d480a9d5dca8fb1d7b542",22860165,1,-35,0,840,271,242,-29
"2ae94c0cea4d480a9d5dca8fb1d7b542","0d987bed3ffa4ed0b9a2e62e97b7b30f",22860165,5,38,0,841,242,272,30
"0d987bed3ffa4ed0b9a2e62e97b7b30f","0d987bed3ffa4ed0b9a2e62e97b7b30f",22860165,5,0,1,842,272,272,0
"0d987bed3ffa4ed0b9a2e62e97b7b30f","0c7262dff33c4087bc660ccf40f92f9c",22860165,1,-135,0,844,272,169,-103
"0c7262dff33c4087bc660ccf40f92f9c","0d987bed3ffa4ed0b9a2e62e97b7b30f",22860165,1,135,0,845,169,272,103
"bb5a47f5ea01454a8b79455422d3b9da","82ae07bc0c9b4570a41799290d1ef399",22860165,7,-6,0,851,280,275,-5
"82ae07bc0c9b4570a41799290d1ef399","bb5a47f5ea01454a8b79455422d3b9da",22860165,6,6,0,852,275,280,5
"bb5a47f5ea01454a8b79455422d3b9da","bc5524e78a8544e2ae2fdc2f3462bbec",22860165,5,-1,0,856,280,279,-1
"bc5524e78a8544e2ae2fdc2f3462bbec","0d987bed3ffa4ed0b9a2e62e97b7b30f",22860165,1,-9,0,857,279,272,-7
"0d987bed3ffa4ed0b9a2e62e97b7b30f","fab84b4fab5940efb4ea868ef8d09396",22860165,1,18,0,858,272,284,12
"4a29443515bb404cb8924e1c60a63b73","208c9b2796c944db8dacaa96082520ea",22860165,1,3,0,862,285,288,3
"208c9b2796c944db8dacaa96082520ea","0d987bed3ffa4ed0b9a2e62e97b7b30f",22860165,1,-25,0,863,288,272,-16
"a37477c4e4c14169ad44b06b493007f6","0d987bed3ffa4ed0b9a2e62e97b7b30f",22860165,1,-15,0,877,283,272,-11
"94cecc3f1e7d484b8e068e79241dfd73","bb5a47f5ea01454a8b79455422d3b9da",22860165,1,-3,0,879,281,280,-1
"bc5524e78a8544e2ae2fdc2f3462bbec","82ae07bc0c9b4570a41799290d1ef399",22860165,2,-5,0,888,279,275,-4
"82ae07bc0c9b4570a41799290d1ef399","0d987bed3ffa4ed0b9a2e62e97b7b30f",22860165,1,-4,0,889,275,272,-3
"82ae07bc0c9b4570a41799290d1ef399","2ae94c0cea4d480a9d5dca8fb1d7b542",22860165,2,-42,0,901,275,242,-33
"0d987bed3ffa4ed0b9a2e62e97b7b30f","7028800abe7d4e27b613d1d6cbe26bf7",22860165,2,-8,0,903,272,267,-5
"7028800abe7d4e27b613d1d6cbe26bf7","7aa76d3e993840d8805f097cbdbcd44b",22860165,2,-7,0,904,267,261,-6
"7aa76d3e993840d8805f097cbdbcd44b","d989ebcfc12a4b669f0100dc1aa14f1e",22860165,4,-7,0,905,261,255,-6
"d989ebcfc12a4b669f0100dc1aa14f1e","7aa76d3e993840d8805f097cbdbcd44b",22860165,4,7,0,906,255,261,6
"7aa76d3e993840d8805f097cbdbcd44b","0d987bed3ffa4ed0b9a2e62e97b7b30f",22860165,1,15,0,909,261,272,11
"0d987bed3ffa4ed0b9a2e62e97b7b30f","2ae94c0cea4d480a9d5dca8fb1d7b542",22860165,1,-38,0,910,272,242,-30
"0d987bed3ffa4ed0b9a2e62e97b7b30f","82ae07bc0c9b4570a41799290d1ef399",22860165,1,4,0,912,272,275,3
"7aa76d3e993840d8805f097cbdbcd44b","2ae94c0cea4d480a9d5dca8fb1d7b542",22860165,1,-23,0,921,261,242,-19
"82ae07bc0c9b4570a41799290d1ef399","bc5524e78a8544e2ae2fdc2f3462bbec",22860165,1,5,0,933,275,279,4
"bc5524e78a8544e2ae2fdc2f3462bbec","bb5a47f5ea01454a8b79455422d3b9da",22860165,3,1,0,934,279,280,1
"bb5a47f5ea01454a8b79455422d3b9da","bb5a47f5ea01454a8b79455422d3b9da",22860165,109,0,1,1000,280,280,0
"bb5a47f5ea01454a8b79455422d3b9da","94cecc3f1e7d484b8e068e79241dfd73",22860165,1,3,0,1013,280,281,1
"94cecc3f1e7d484b8e068e79241dfd73","0d987bed3ffa4ed0b9a2e62e97b7b30f",22860165,1,-13,0,1014,281,272,-9
"0d987bed3ffa4ed0b9a2e62e97b7b30f","a37477c4e4c14169ad44b06b493007f6",22860165,1,15,0,1015,272,283,11
"a37477c4e4c14169ad44b06b493007f6","d546341988904f069cfa86b21457d9d9",22860165,1,-42,0,1016,283,251,-32
"d546341988904f069cfa86b21457d9d9","2ae94c0cea4d480a9d5dca8fb1d7b542",22860165,1,-11,0,1017,251,242,-9
"2ae94c0cea4d480a9d5dca8fb1d7b542","00f61990949545828dd12f1303d47504",22860165,1,17,0,1018,242,256,14
"00f61990949545828dd12f1303d47504","78adeee1fa2c4fe0bc73f7bca9fcee86",22860165,1,-131,0,1019,256,160,-96
"78adeee1fa2c4fe0bc73f7bca9fcee86","65202579580f4ad38d734b4ee39d22a8",22860165,17,5,0,1020,160,164,4
"65202579580f4ad38d734b4ee39d22a8","65202579580f4ad38d734b4ee39d22a8",22860165,163,0,1,1021,164,164,0
"65202579580f4ad38d734b4ee39d22a8","0d987bed3ffa4ed0b9a2e62e97b7b30f",22860165,1,147,0,1028,164,272,108
"0d987bed3ffa4ed0b9a2e62e97b7b30f","bb5a47f5ea01454a8b79455422d3b9da",22860165,5,10,0,1029,272,280,8
"bb5a47f5ea01454a8b79455422d3b9da","0d987bed3ffa4ed0b9a2e62e97b7b30f",22860165,2,-10,0,1039,280,272,-8
"0d987bed3ffa4ed0b9a2e62e97b7b30f","94cecc3f1e7d484b8e068e79241dfd73",22860165,3,13,0,1040,272,281,9
"94cecc3f1e7d484b8e068e79241dfd73","a37477c4e4c14169ad44b06b493007f6",22860165,2,2,0,1041,281,283,2
"a37477c4e4c14169ad44b06b493007f6","94cecc3f1e7d484b8e068e79241dfd73",22860165,1,-2,0,1042,283,281,-2
"94cecc3f1e7d484b8e068e79241dfd73","fab84b4fab5940efb4ea868ef8d09396",22860165,1,5,0,1043,281,284,3
"fab84b4fab5940efb4ea868ef8d09396","fab84b4fab5940efb4ea868ef8d09396",22860165,3,0,1,1044,284,284,0
"fab84b4fab5940efb4ea868ef8d09396","4a29443515bb404cb8924e1c60a63b73",22860165,2,4,0,1045,284,285,1
"4a29443515bb404cb8924e1c60a63b73","fab84b4fab5940efb4ea868ef8d09396",22860165,1,-4,0,1046,285,284,-1
"fab84b4fab5940efb4ea868ef8d09396","208c9b2796c944db8dacaa96082520ea",22860165,1,7,0,1047,284,288,4
"208c9b2796c944db8dacaa96082520ea","4a29443515bb404cb8924e1c60a63b73",22860165,1,-3,0,1048,288,285,-3
"4a29443515bb404cb8924e1c60a63b73","7669a956527947d0add87455277e80b4",22860165,1,7,0,1049,285,291,6
"7669a956527947d0add87455277e80b4","7669a956527947d0add87455277e80b4",22860165,1,0,1,1050,291,291,0
"7669a956527947d0add87455277e80b4","6a9a3b5bde4a48daa896fe8c06eca56f",22860165,1,-2,0,1051,291,289,-2
"6a9a3b5bde4a48daa896fe8c06eca56f","869e967078f04da18dd0b0b9389a7424",22860165,1,5,0,1052,289,293,4
"869e967078f04da18dd0b0b9389a7424","51ab6291537748fab90d519aa09889d6",22860165,1,2,0,1053,293,295,2
"51ab6291537748fab90d519aa09889d6","51ab6291537748fab90d519aa09889d6",22860165,5,0,1,1054,295,295,0
"51ab6291537748fab90d519aa09889d6","34a6e49023fc4465bd5ca604330bbd1c",22860165,1,-3,0,1059,295,292,-3
"34a6e49023fc4465bd5ca604330bbd1c","ba0e59461bfb4a44b7b1c28a01f8d3b3",22860165,1,9,0,1060,292,299,7
"ba0e59461bfb4a44b7b1c28a01f8d3b3","21592f2a9e9c4b2f8c66ec5dbcbf6a2b",22860165,1,-4,0,1061,299,296,-3
"21592f2a9e9c4b2f8c66ec5dbcbf6a2b","0e0b36e731a645e7b1b8a88f5031ca38",22860165,1,6,0,1062,296,301,5
"0e0b36e731a645e7b1b8a88f5031ca38","0e0b36e731a645e7b1b8a88f5031ca38",22860165,2,0,1,1063,301,301,0
"0e0b36e731a645e7b1b8a88f5031ca38","a66a144637284c21afc6de17fea4bfb8",22860165,1,1,0,1065,301,302,1
"a66a144637284c21afc6de17fea4bfb8","a66a144637284c21afc6de17fea4bfb8",22860165,2,0,1,1066,302,302,0
"a66a144637284c21afc6de17fea4bfb8","7646a919d7e64fa990bca9b024ff089d",22860165,1,-4,0,1068,302,298,-4
"7646a919d7e64fa990bca9b024ff089d","4a29443515bb404cb8924e1c60a63b73",22860165,2,-17,0,1069,298,285,-13
"4a29443515bb404cb8924e1c60a63b73","3434c10e561d488a914e0f7d71907abd",22860165,4,27,0,1070,285,305,20
"3434c10e561d488a914e0f7d71907abd","53e7e900392747ccad52e711ab0f80d8",22860165,2,2,0,1071,305,307,2
"53e7e900392747ccad52e711ab0f80d8","3434c10e561d488a914e0f7d71907abd",22860165,3,-2,0,1072,307,305,-2
"3434c10e561d488a914e0f7d71907abd","4a29443515bb404cb8924e1c60a63b73",22860165,1,-27,0,1073,305,285,-20
"4a29443515bb404cb8924e1c60a63b73","e390b575229748ea8aac9364efe2bf00",22860165,1,24,0,1074,285,304,19
"e390b575229748ea8aac9364efe2bf00","e390b575229748ea8aac9364efe2bf00",22860165,1,0,1,1075,304,304,0
"e390b575229748ea8aac9364efe2bf00","4a29443515bb404cb8924e1c60a63b73",22860165,1,-24,0,1076,304,285,-19
"3434c10e561d488a914e0f7d71907abd","130acc2aeb0448fdbb2de63bc5cebe5b",22860165,2,5,0,1080,305,309,4
"130acc2aeb0448fdbb2de63bc5cebe5b","9c062b3251034ebe90f5054e2a3b5120",22860165,1,2,0,1081,309,311,2
"9c062b3251034ebe90f5054e2a3b5120","9c062b3251034ebe90f5054e2a3b5120",22860165,2,0,1,1082,311,311,0
"9c062b3251034ebe90f5054e2a3b5120","ea859f8207e44537889daeaba13ac2e8",22860165,1,1,0,1084,311,312,1
"ea859f8207e44537889daeaba13ac2e8","ea859f8207e44537889daeaba13ac2e8",22860165,1,0,1,1085,312,312,0
"ea859f8207e44537889daeaba13ac2e8","56d94971a7a94257aa330183a8ebd0ea",22860165,1,1,0,1086,312,313,1
"56d94971a7a94257aa330183a8ebd0ea","56d94971a7a94257aa330183a8ebd0ea",22860165,1,0,1,1087,313,313,0
"56d94971a7a94257aa330183a8ebd0ea","141c0df6cd1946539aadd1c9b7068cd4",22860165,1,-5,0,1088,313,308,-5
"141c0df6cd1946539aadd1c9b7068cd4","13255e63e0aa4abf85e5211bf613d43e",22860165,2,10,0,1089,308,317,9
"13255e63e0aa4abf85e5211bf613d43e","13255e63e0aa4abf85e5211bf613d43e",22860165,2,0,1,1090,317,317,0
"13255e63e0aa4abf85e5211bf613d43e","0c787d16c9504873b1a4d903cec09948",22860165,2,-3,0,1091,317,314,-3
"0c787d16c9504873b1a4d903cec09948","86c27d40179e419c8e9d150fb6afa5d0",22860165,1,6,0,1092,314,319,5
"86c27d40179e419c8e9d150fb6afa5d0","8d7e0b55cf9849cda222a0f2440cec55",22860165,3,-1,0,1093,319,318,-1
"8d7e0b55cf9849cda222a0f2440cec55","130acc2aeb0448fdbb2de63bc5cebe5b",22860165,1,-11,0,1094,318,309,-9
"130acc2aeb0448fdbb2de63bc5cebe5b","0c787d16c9504873b1a4d903cec09948",22860165,3,6,0,1095,309,314,5
"0c787d16c9504873b1a4d903cec09948","141c0df6cd1946539aadd1c9b7068cd4",22860165,4,-7,0,1096,314,308,-6
"141c0df6cd1946539aadd1c9b7068cd4","86c27d40179e419c8e9d150fb6afa5d0",22860165,4,13,0,1097,308,319,11
"86c27d40179e419c8e9d150fb6afa5d0","0c787d16c9504873b1a4d903cec09948",22860165,6,-6,0,1098,319,314,-5
"0c787d16c9504873b1a4d903cec09948","8d7e0b55cf9849cda222a0f2440cec55",22860165,6,5,0,1099,314,318,4
"8d7e0b55cf9849cda222a0f2440cec55","86c27d40179e419c8e9d150fb6afa5d0",22860165,3,1,0,1100,318,319,1
"8d7e0b55cf9849cda222a0f2440cec55","47edbb64109243e6b0f8f64cdef90c6c",22860165,5,9,0,1103,318,326,8
"47edbb64109243e6b0f8f64cdef90c6c","24f1363179ad4aaa965484a78471912b",22860165,5,-3,0,1104,326,323,-3
"24f1363179ad4aaa965484a78471912b","3628bdce1dd2429ba924d2d4d09448d2",22860165,1,-1,0,1105,323,322,-1
"3628bdce1dd2429ba924d2d4d09448d2","86c27d40179e419c8e9d150fb6afa5d0",22860165,3,-4,0,1106,322,319,-3
"24f1363179ad4aaa965484a78471912b","8d7e0b55cf9849cda222a0f2440cec55",22860165,3,-6,0,1113,323,318,-5
"8d7e0b55cf9849cda222a0f2440cec55","3628bdce1dd2429ba924d2d4d09448d2",22860165,2,5,0,1114,318,322,4
"86c27d40179e419c8e9d150fb6afa5d0","130acc2aeb0448fdbb2de63bc5cebe5b",22860165,1,-12,0,1116,319,309,-10
"141c0df6cd1946539aadd1c9b7068cd4","53e7e900392747ccad52e711ab0f80d8",22860165,1,-2,0,1119,308,307,-1
"130acc2aeb0448fdbb2de63bc5cebe5b","141c0df6cd1946539aadd1c9b7068cd4",22860165,2,-1,0,1122,309,308,-1
"86c27d40179e419c8e9d150fb6afa5d0","3628bdce1dd2429ba924d2d4d09448d2",22860165,1,4,0,1130,319,322,3
"3628bdce1dd2429ba924d2d4d09448d2","13255e63e0aa4abf85e5211bf613d43e",22860165,1,-7,0,1131,322,317,-5
"13255e63e0aa4abf85e5211bf613d43e","130acc2aeb0448fdbb2de63bc5cebe5b",22860165,1,-9,0,1132,317,309,-8
"8d7e0b55cf9849cda222a0f2440cec55","24f1363179ad4aaa965484a78471912b",22860165,1,6,0,1138,318,323,5
"24f1363179ad4aaa965484a78471912b","47edbb64109243e6b0f8f64cdef90c6c",22860165,1,3,0,1139,323,326,3
"47edbb64109243e6b0f8f64cdef90c6c","3628bdce1dd2429ba924d2d4d09448d2",22860165,2,-4,0,1140,326,322,-4
"3628bdce1dd2429ba924d2d4d09448d2","3434c10e561d488a914e0f7d71907abd",22860165,2,-21,0,1141,322,305,-17
"3434c10e561d488a914e0f7d71907abd","3434c10e561d488a914e0f7d71907abd",22860165,5,0,1,1142,305,305,0
"3434c10e561d488a914e0f7d71907abd","0c4079457ede49e3aeb5e86ed84bdf35",22860165,4,31,0,1143,305,329,24
"0c4079457ede49e3aeb5e86ed84bdf35","0c4079457ede49e3aeb5e86ed84bdf35",22860165,3,0,1,1144,329,329,0
"0c4079457ede49e3aeb5e86ed84bdf35","38aea304b4fa46e1b29bb72f5cea4c93",22860165,2,2,0,1145,329,331,2
"38aea304b4fa46e1b29bb72f5cea4c93","e36d261332f14e79bb4b467aceaeb9b5",22860165,1,2,0,1146,331,333,2
"e36d261332f14e79bb4b467aceaeb9b5","e36d261332f14e79bb4b467aceaeb9b5",22860165,1,0,1,1147,333,333,0
"e36d261332f14e79bb4b467aceaeb9b5","c7e89b9d04744d2eab742fc24e3ef1ae",22860165,1,1,0,1148,333,334,1
"c7e89b9d04744d2eab742fc24e3ef1ae","c7e89b9d04744d2eab742fc24e3ef1ae",22860165,5,0,1,1149,334,334,0
"c7e89b9d04744d2eab742fc24e3ef1ae","fe49f8054b374a0ea4bb266ed135ff62",22860165,1,1,0,1154,334,335,1
"fe49f8054b374a0ea4bb266ed135ff62","fe49f8054b374a0ea4bb266ed135ff62",22860165,2,0,1,1155,335,335,0
"fe49f8054b374a0ea4bb266ed135ff62","d0a8f74af98642fe8360d22c42e45117",22860165,1,1,0,1157,335,336,1
"d0a8f74af98642fe8360d22c42e45117","d0a8f74af98642fe8360d22c42e45117",22860165,2,0,1,1158,336,336,0
"d0a8f74af98642fe8360d22c42e45117","0c4079457ede49e3aeb5e86ed84bdf35",22860165,1,-7,0,1160,336,329,-7
"0c4079457ede49e3aeb5e86ed84bdf35","a7c6339ca1da4368a18d471f0519f877",22860165,1,11,0,1161,329,339,10
"a7c6339ca1da4368a18d471f0519f877","a7c6339ca1da4368a18d471f0519f877",22860165,2,0,1,1162,339,339,0
"a7c6339ca1da4368a18d471f0519f877","bbc5139ca9024389a94db3a6f47dcff6",22860165,1,3,0,1164,339,341,2
"bbc5139ca9024389a94db3a6f47dcff6","b8b9418ab322418d9db9b40d96af873a",22860165,1,-5,0,1165,341,337,-4
"b8b9418ab322418d9db9b40d96af873a","a7c6339ca1da4368a18d471f0519f877",22860165,1,2,0,1166,337,339,2
"a7c6339ca1da4368a18d471f0519f877","4ee6ca9019ab4a1ab323f98094a9bd77",22860165,1,5,0,1167,339,343,4
"4ee6ca9019ab4a1ab323f98094a9bd77","4ee6ca9019ab4a1ab323f98094a9bd77",22860165,1,0,1,1168,343,343,0
"4ee6ca9019ab4a1ab323f98094a9bd77","b37947176785476f8b29d49a851366dc",22860165,2,1,0,1169,343,344,1
"b37947176785476f8b29d49a851366dc","4ee6ca9019ab4a1ab323f98094a9bd77",22860165,1,-1,0,1170,344,343,-1
"b37947176785476f8b29d49a851366dc","b37947176785476f8b29d49a851366dc",22860165,1,0,1,1172,344,344,0
"b37947176785476f8b29d49a851366dc","fcea5b10d5a14a3b9324ffece8f6e1e5",22860165,1,1,0,1173,344,345,1
"fcea5b10d5a14a3b9324ffece8f6e1e5","fcea5b10d5a14a3b9324ffece8f6e1e5",22860165,2,0,1,1174,345,345,0
"fcea5b10d5a14a3b9324ffece8f6e1e5","c2490bc612d146edbe786556fab3651b",22860165,1,-5,0,1176,345,340,-5
"c2490bc612d146edbe786556fab3651b","bbc5139ca9024389a94db3a6f47dcff6",22860165,1,1,0,1177,340,341,1
"bbc5139ca9024389a94db3a6f47dcff6","4a92daef4d504e1792575a26502bb7b7",22860165,1,6,0,1178,341,346,5
"4a92daef4d504e1792575a26502bb7b7","c2490bc612d146edbe786556fab3651b",22860165,1,-7,0,1179,346,340,-6
"c2490bc612d146edbe786556fab3651b","b8b9418ab322418d9db9b40d96af873a",22860165,1,-4,0,1180,340,337,-3
"b8b9418ab322418d9db9b40d96af873a","38aea304b4fa46e1b29bb72f5cea4c93",22860165,1,-7,0,1181,337,331,-6
"38aea304b4fa46e1b29bb72f5cea4c93","bbc5139ca9024389a94db3a6f47dcff6",22860165,1,12,0,1182,331,341,10
"bbc5139ca9024389a94db3a6f47dcff6","0c4079457ede49e3aeb5e86ed84bdf35",22860165,1,-14,0,1183,341,329,-12
"0c4079457ede49e3aeb5e86ed84bdf35","30ead9794d4847abaf222ca966cc8630",22860165,1,24,0,1185,329,348,19
"30ead9794d4847abaf222ca966cc8630","0c4079457ede49e3aeb5e86ed84bdf35",22860165,3,-24,0,1186,348,329,-19
"0c4079457ede49e3aeb5e86ed84bdf35","b8b9418ab322418d9db9b40d96af873a",22860165,3,9,0,1187,329,337,8
"b8b9418ab322418d9db9b40d96af873a","c2490bc612d146edbe786556fab3651b",22860165,2,4,0,1188,337,340,3
"c2490bc612d146edbe786556fab3651b","30ead9794d4847abaf222ca966cc8630",22860165,1,11,0,1189,340,348,8
"30ead9794d4847abaf222ca966cc8630","897b7f51242c44aab2205c72fdcbf4cd",22860165,1,4,0,1190,348,352,4
"897b7f51242c44aab2205c72fdcbf4cd","c20993c944444fe085345591a8bd837e",22860165,2,-1,0,1191,352,351,-1
"c20993c944444fe085345591a8bd837e","09b9678ddc3d452ea4a3d46e15826065",22860165,4,2,0,1192,351,353,2
"09b9678ddc3d452ea4a3d46e15826065","eff0de7f2dbb42dfa1a2e686efab5b6d",22860165,2,1,0,1193,353,354,1
"eff0de7f2dbb42dfa1a2e686efab5b6d","c20993c944444fe085345591a8bd837e",22860165,3,-3,0,1194,354,351,-3
"c20993c944444fe085345591a8bd837e","c20993c944444fe085345591a8bd837e",22860165,5,0,1,1195,351,351,0
"09b9678ddc3d452ea4a3d46e15826065","09b9678ddc3d452ea4a3d46e15826065",22860165,4,0,1,1199,353,353,0
"09b9678ddc3d452ea4a3d46e15826065","897b7f51242c44aab2205c72fdcbf4cd",22860165,4,-1,0,1200,353,352,-1
"897b7f51242c44aab2205c72fdcbf4cd","897b7f51242c44aab2205c72fdcbf4cd",22860165,5,0,1,1201,352,352,0
"897b7f51242c44aab2205c72fdcbf4cd","09b9678ddc3d452ea4a3d46e15826065",22860165,1,1,0,1202,352,353,1
"897b7f51242c44aab2205c72fdcbf4cd","eff0de7f2dbb42dfa1a2e686efab5b6d",22860165,2,2,0,1206,352,354,2
"eff0de7f2dbb42dfa1a2e686efab5b6d","eff0de7f2dbb42dfa1a2e686efab5b6d",22860165,5,0,1,1207,354,354,0
"eff0de7f2dbb42dfa1a2e686efab5b6d","30ead9794d4847abaf222ca966cc8630",22860165,2,-6,0,1210,354,348,-6
"30ead9794d4847abaf222ca966cc8630","2fe14166dc9642c3bc666b86a57f943d",22860165,1,10,0,1211,348,357,9
"2fe14166dc9642c3bc666b86a57f943d","44421dd1e13a47a388c4a19834b744c7",22860165,1,2,0,1212,357,359,2
"44421dd1e13a47a388c4a19834b744c7","44421dd1e13a47a388c4a19834b744c7",22860165,2,0,1,1213,359,359,0
"44421dd1e13a47a388c4a19834b744c7","cb5fc7ef85d547c4be1a7439d0bf6052",22860165,1,1,0,1215,359,360,1
"cb5fc7ef85d547c4be1a7439d0bf6052","cb5fc7ef85d547c4be1a7439d0bf6052",22860165,2,0,1,1216,360,360,0
"cb5fc7ef85d547c4be1a7439d0bf6052","0a8f150a4cf747acbde62f4721823da3",22860165,1,1,0,1218,360,361,1
"0a8f150a4cf747acbde62f4721823da3","0a8f150a4cf747acbde62f4721823da3",22860165,2,0,1,1219,361,361,0
"0a8f150a4cf747acbde62f4721823da3","ab8fdad974ae471f9f24c3f9dd04462e",22860165,1,1,0,1221,361,362,1
"ab8fdad974ae471f9f24c3f9dd04462e","ab8fdad974ae471f9f24c3f9dd04462e",22860165,2,0,1,1222,362,362,0
"ab8fdad974ae471f9f24c3f9dd04462e","1ba8fef685d74a8194b9db252eb704fb",22860165,1,-7,0,1224,362,355,-7
"1ba8fef685d74a8194b9db252eb704fb","52580888dadb4fe3baa795683ea227bd",22860165,1,10,0,1225,355,364,9
"52580888dadb4fe3baa795683ea227bd","f00179e251a045b39c3f7a54f9aa4acc",22860165,1,-1,0,1226,364,363,-1
"f00179e251a045b39c3f7a54f9aa4acc","492a3bc6a1254f23a7998587961b22a4",22860165,1,4,0,1227,363,366,3
"492a3bc6a1254f23a7998587961b22a4","072a190fd302456290895f9f04d6940a",22860165,1,-1,0,1228,366,365,-1
"072a190fd302456290895f9f04d6940a","30ead9794d4847abaf222ca966cc8630",22860165,1,-20,0,1229,365,348,-17
"30ead9794d4847abaf222ca966cc8630","492a3bc6a1254f23a7998587961b22a4",22860165,1,21,0,1230,348,366,18
"492a3bc6a1254f23a7998587961b22a4","c76574d21bc14aeea7ecd0b027f39858",22860165,1,2,0,1231,366,367,1
"c76574d21bc14aeea7ecd0b027f39858","072a190fd302456290895f9f04d6940a",22860165,2,-3,0,1232,367,365,-2
"072a190fd302456290895f9f04d6940a","52580888dadb4fe3baa795683ea227bd",22860165,1,-2,0,1233,365,364,-1
"52580888dadb4fe3baa795683ea227bd","2fe14166dc9642c3bc666b86a57f943d",22860165,1,-8,0,1234,364,357,-7
"2fe14166dc9642c3bc666b86a57f943d","f00179e251a045b39c3f7a54f9aa4acc",22860165,1,7,0,1235,357,363,6
"f00179e251a045b39c3f7a54f9aa4acc","eff0de7f2dbb42dfa1a2e686efab5b6d",22860165,1,-11,0,1236,363,354,-9
"eff0de7f2dbb42dfa1a2e686efab5b6d","1ba8fef685d74a8194b9db252eb704fb",22860165,1,2,0,1238,354,355,1
"1ba8fef685d74a8194b9db252eb704fb","09b9678ddc3d452ea4a3d46e15826065",22860165,1,-3,0,1239,355,353,-2
"09b9678ddc3d452ea4a3d46e15826065","c20993c944444fe085345591a8bd837e",22860165,1,-2,0,1245,353,351,-2
"c20993c944444fe085345591a8bd837e","897b7f51242c44aab2205c72fdcbf4cd",22860165,1,1,0,1247,351,352,1
"897b7f51242c44aab2205c72fdcbf4cd","30ead9794d4847abaf222ca966cc8630",22860165,1,-4,0,1249,352,348,-4
"0c4079457ede49e3aeb5e86ed84bdf35","4a92daef4d504e1792575a26502bb7b7",22860165,1,20,0,1251,329,346,17
"4a92daef4d504e1792575a26502bb7b7","bbc5139ca9024389a94db3a6f47dcff6",22860165,1,-6,0,1252,346,341,-5
"bbc5139ca9024389a94db3a6f47dcff6","c2490bc612d146edbe786556fab3651b",22860165,2,-1,0,1253,341,340,-1
"c2490bc612d146edbe786556fab3651b","38aea304b4fa46e1b29bb72f5cea4c93",22860165,1,-11,0,1254,340,331,-9
"38aea304b4fa46e1b29bb72f5cea4c93","b8b9418ab322418d9db9b40d96af873a",22860165,1,7,0,1255,331,337,6
"b8b9418ab322418d9db9b40d96af873a","0c4079457ede49e3aeb5e86ed84bdf35",22860165,1,-9,0,1256,337,329,-8
"0c4079457ede49e3aeb5e86ed84bdf35","3434c10e561d488a914e0f7d71907abd",22860165,3,-31,0,1257,329,305,-24
"3434c10e561d488a914e0f7d71907abd","47edbb64109243e6b0f8f64cdef90c6c",22860165,1,25,0,1258,305,326,21
"24f1363179ad4aaa965484a78471912b","43ea1b823a4b4e51b7c694c10725db82",22860165,2,5,0,1260,323,327,4
"43ea1b823a4b4e51b7c694c10725db82","3628bdce1dd2429ba924d2d4d09448d2",22860165,3,-6,0,1261,327,322,-5
"3628bdce1dd2429ba924d2d4d09448d2","56b3fd1a212a4764be39d979fde3326e",22860165,1,7,0,1262,322,328,6
"56b3fd1a212a4764be39d979fde3326e","56b3fd1a212a4764be39d979fde3326e",22860165,1,0,1,1263,328,328,0
"56b3fd1a212a4764be39d979fde3326e","47edbb64109243e6b0f8f64cdef90c6c",22860165,1,-3,0,1264,328,326,-2
"8d7e0b55cf9849cda222a0f2440cec55","0c787d16c9504873b1a4d903cec09948",22860165,1,-5,0,1270,318,314,-4
"0c787d16c9504873b1a4d903cec09948","130acc2aeb0448fdbb2de63bc5cebe5b",22860165,1,-6,0,1271,314,309,-5
"0c787d16c9504873b1a4d903cec09948","24f1363179ad4aaa965484a78471912b",22860165,1,11,0,1275,314,323,9
"38aea304b4fa46e1b29bb72f5cea4c93","0c4079457ede49e3aeb5e86ed84bdf35",22860165,2,-2,0,1282,331,329,-2
"b8b9418ab322418d9db9b40d96af873a","bbc5139ca9024389a94db3a6f47dcff6",22860165,1,5,0,1284,337,341,4
"c2490bc612d146edbe786556fab3651b","0d987bed3ffa4ed0b9a2e62e97b7b30f",22860165,1,-93,0,1286,340,272,-68
"0d987bed3ffa4ed0b9a2e62e97b7b30f","3434c10e561d488a914e0f7d71907abd",22860165,1,49,0,1287,272,305,33
"0c4079457ede49e3aeb5e86ed84bdf35","47edbb64109243e6b0f8f64cdef90c6c",22860165,1,-6,0,1292,329,326,-3
"47edbb64109243e6b0f8f64cdef90c6c","43ea1b823a4b4e51b7c694c10725db82",22860165,1,2,0,1293,326,327,1
"3628bdce1dd2429ba924d2d4d09448d2","141c0df6cd1946539aadd1c9b7068cd4",22860165,1,-17,0,1295,322,308,-14
"141c0df6cd1946539aadd1c9b7068cd4","141c0df6cd1946539aadd1c9b7068cd4",22860165,1,0,1,1296,308,308,0
"141c0df6cd1946539aadd1c9b7068cd4","4a29443515bb404cb8924e1c60a63b73",22860165,1,-31,0,1297,308,285,-23
"3434c10e561d488a914e0f7d71907abd","2c5bb2cbd0014420ad8c95d40e38efd1",22860165,1,-4,0,1299,305,303,-2
"2c5bb2cbd0014420ad8c95d40e38efd1","7646a919d7e64fa990bca9b024ff089d",22860165,1,-6,0,1300,303,298,-5
"7646a919d7e64fa990bca9b024ff089d","21592f2a9e9c4b2f8c66ec5dbcbf6a2b",22860165,1,-3,0,1301,298,296,-2
"21592f2a9e9c4b2f8c66ec5dbcbf6a2b","34a6e49023fc4465bd5ca604330bbd1c",22860165,1,-5,0,1302,296,292,-4
"34a6e49023fc4465bd5ca604330bbd1c","6a9a3b5bde4a48daa896fe8c06eca56f",22860165,1,-4,0,1303,292,289,-3
"6a9a3b5bde4a48daa896fe8c06eca56f","4a29443515bb404cb8924e1c60a63b73",22860165,1,-5,0,1304,289,285,-4
"4a29443515bb404cb8924e1c60a63b73","6a9a3b5bde4a48daa896fe8c06eca56f",22860165,1,5,0,1305,285,289,4
"6a9a3b5bde4a48daa896fe8c06eca56f","34a6e49023fc4465bd5ca604330bbd1c",22860165,1,4,0,1306,289,292,3
"34a6e49023fc4465bd5ca604330bbd1c","34a6e49023fc4465bd5ca604330bbd1c",22860165,1,0,1,1307,292,292,0
"34a6e49023fc4465bd5ca604330bbd1c","21592f2a9e9c4b2f8c66ec5dbcbf6a2b",22860165,1,5,0,1308,292,296,4
"21592f2a9e9c4b2f8c66ec5dbcbf6a2b","7646a919d7e64fa990bca9b024ff089d",22860165,1,3,0,1309,296,298,2
"3434c10e561d488a914e0f7d71907abd","141c0df6cd1946539aadd1c9b7068cd4",22860165,2,4,0,1313,305,308,3
"47edbb64109243e6b0f8f64cdef90c6c","3434c10e561d488a914e0f7d71907abd",22860165,1,-25,0,1319,326,305,-21
"141c0df6cd1946539aadd1c9b7068cd4","0c787d16c9504873b1a4d903cec09948",22860165,1,7,0,1322,308,314,6
"0c787d16c9504873b1a4d903cec09948","47edbb64109243e6b0f8f64cdef90c6c",22860165,1,14,0,1323,314,326,12
"47edbb64109243e6b0f8f64cdef90c6c","8d7e0b55cf9849cda222a0f2440cec55",22860165,2,-9,0,1324,326,318,-8
"8d7e0b55cf9849cda222a0f2440cec55","3434c10e561d488a914e0f7d71907abd",22860165,1,-16,0,1325,318,305,-13
"3434c10e561d488a914e0f7d71907abd","0c787d16c9504873b1a4d903cec09948",22860165,1,11,0,1327,305,314,9
"141c0df6cd1946539aadd1c9b7068cd4","47edbb64109243e6b0f8f64cdef90c6c",22860165,1,21,0,1329,308,326,18
"3628bdce1dd2429ba924d2d4d09448d2","0c4079457ede49e3aeb5e86ed84bdf35",22860165,1,10,0,1332,322,329,7
"3434c10e561d488a914e0f7d71907abd","38aea304b4fa46e1b29bb72f5cea4c93",22860165,1,33,0,1334,305,331,26
"38aea304b4fa46e1b29bb72f5cea4c93","38aea304b4fa46e1b29bb72f5cea4c93",22860165,1,0,1,1335,331,331,0
"c2490bc612d146edbe786556fab3651b","6ac8bb048b854999a47edb35fe627f11",22860165,1,8,0,1340,340,347,7
"6ac8bb048b854999a47edb35fe627f11","6ac8bb048b854999a47edb35fe627f11",22860165,1,0,1,1341,347,347,0
"6ac8bb048b854999a47edb35fe627f11","30ead9794d4847abaf222ca966cc8630",22860165,1,3,0,1342,347,348,1
"0c4079457ede49e3aeb5e86ed84bdf35","09b9678ddc3d452ea4a3d46e15826065",22860165,1,29,0,1344,329,353,24
"c20993c944444fe085345591a8bd837e","eff0de7f2dbb42dfa1a2e686efab5b6d",22860165,1,3,0,1354,351,354,3
"30ead9794d4847abaf222ca966cc8630","1ba8fef685d74a8194b9db252eb704fb",22860165,1,8,0,1357,348,355,7
"1ba8fef685d74a8194b9db252eb704fb","f00179e251a045b39c3f7a54f9aa4acc",22860165,2,9,0,1358,355,363,8
"f00179e251a045b39c3f7a54f9aa4acc","072a190fd302456290895f9f04d6940a",22860165,2,3,0,1359,363,365,2
"072a190fd302456290895f9f04d6940a","c76574d21bc14aeea7ecd0b027f39858",22860165,1,3,0,1360,365,367,2
"072a190fd302456290895f9f04d6940a","f00179e251a045b39c3f7a54f9aa4acc",22860165,1,-3,0,1362,365,363,-2
"f00179e251a045b39c3f7a54f9aa4acc","1ba8fef685d74a8194b9db252eb704fb",22860165,1,-9,0,1363,363,355,-8
"072a190fd302456290895f9f04d6940a","cfa457d1743848e4bb5e4beced6448ed",22860165,1,5,0,1366,365,369,4
"cfa457d1743848e4bb5e4beced6448ed","cfa457d1743848e4bb5e4beced6448ed",22860165,1,0,1,1367,369,369,0
"cfa457d1743848e4bb5e4beced6448ed","30ead9794d4847abaf222ca966cc8630",22860165,1,-25,0,1368,369,348,-21
"30ead9794d4847abaf222ca966cc8630","b71bac264efb4abd97015447bd490db6",22860165,2,28,0,1369,348,370,22
"b71bac264efb4abd97015447bd490db6","b71bac264efb4abd97015447bd490db6",22860165,3,0,1,1370,370,370,0
"b71bac264efb4abd97015447bd490db6","8d448d625b024c82a5eb240bbd7431d6",22860165,6,5,0,1371,370,374,4
"8d448d625b024c82a5eb240bbd7431d6","8d448d625b024c82a5eb240bbd7431d6",22860165,87,0,1,1372,374,374,0
"8d448d625b024c82a5eb240bbd7431d6","1b4550d0dab04078b3bf08a655345bdc",22860165,2,-1,0,1379,374,373,-1
"1b4550d0dab04078b3bf08a655345bdc","b71bac264efb4abd97015447bd490db6",22860165,3,-4,0,1380,373,370,-3
"8d448d625b024c82a5eb240bbd7431d6","b71bac264efb4abd97015447bd490db6",22860165,3,-5,0,1389,374,370,-4
"b71bac264efb4abd97015447bd490db6","30ead9794d4847abaf222ca966cc8630",22860165,2,-28,0,1444,370,348,-22
"30ead9794d4847abaf222ca966cc8630","1b4550d0dab04078b3bf08a655345bdc",22860165,1,32,0,1445,348,373,25
"b71bac264efb4abd97015447bd490db6","d6d02b6ef04e4f17805504500b8ce441",22860165,2,8,0,1468,370,375,5
"d6d02b6ef04e4f17805504500b8ce441","d6d02b6ef04e4f17805504500b8ce441",22860165,6,0,1,1469,375,375,0
"d6d02b6ef04e4f17805504500b8ce441","66baf19b6b904b70922329068c63746d",22860165,2,4,0,1471,375,376,1
"66baf19b6b904b70922329068c63746d","b71bac264efb4abd97015447bd490db6",22860165,1,-12,0,1472,376,370,-6
"8d448d625b024c82a5eb240bbd7431d6","d6d02b6ef04e4f17805504500b8ce441",22860165,1,3,0,1483,374,375,1
"d6d02b6ef04e4f17805504500b8ce441","b71bac264efb4abd97015447bd490db6",22860165,1,-8,0,1484,375,370,-5
"66baf19b6b904b70922329068c63746d","7f544639412e40a9ba27f43b415362ab",22860165,1,2,0,1491,376,378,2
"7f544639412e40a9ba27f43b415362ab","7f544639412e40a9ba27f43b415362ab",22860165,1,0,1,1492,378,378,0
"7f544639412e40a9ba27f43b415362ab","d5ae8642e15b46b8bd298b02274d4e9c",22860165,1,2,0,1493,378,380,2
"d5ae8642e15b46b8bd298b02274d4e9c","d5ae8642e15b46b8bd298b02274d4e9c",22860165,1,0,1,1494,380,380,0
"d5ae8642e15b46b8bd298b02274d4e9c","a0d10309a2dd456289147f84be9d37f9",22860165,1,1,0,1495,380,381,1
"a0d10309a2dd456289147f84be9d37f9","a0d10309a2dd456289147f84be9d37f9",22860165,2,0,1,1496,381,381,0
"a0d10309a2dd456289147f84be9d37f9","0fcbc3ca07b144138b8d85da581f09a8",22860165,1,1,0,1498,381,382,1
"0fcbc3ca07b144138b8d85da581f09a8","0fcbc3ca07b144138b8d85da581f09a8",22860165,2,0,1,1499,382,382,0
"0fcbc3ca07b144138b8d85da581f09a8","66baf19b6b904b70922329068c63746d",22860165,1,-6,0,1501,382,376,-6
"66baf19b6b904b70922329068c63746d","4890121ce5d74576b4632b77cfc23398",22860165,1,14,0,1502,376,388,12
"4890121ce5d74576b4632b77cfc23398","c2fca3669923477ab966ded303dea31c",22860165,1,-6,0,1503,388,383,-5
"c2fca3669923477ab966ded303dea31c","4890121ce5d74576b4632b77cfc23398",22860165,1,6,0,1504,383,388,5
"4890121ce5d74576b4632b77cfc23398","18d3b836dd804224883cc9180b60a8e1",22860165,1,-1,0,1505,388,387,-1
"18d3b836dd804224883cc9180b60a8e1","96bb2b3e85a34d8b9544514e89f6fe97",22860165,1,4,0,1506,387,390,3
"96bb2b3e85a34d8b9544514e89f6fe97","96bb2b3e85a34d8b9544514e89f6fe97",22860165,1,0,1,1507,390,390,0
"96bb2b3e85a34d8b9544514e89f6fe97","ac4e9b54acfe4670b4634859c7263cb5",22860165,1,2,0,1508,390,392,2
"ac4e9b54acfe4670b4634859c7263cb5","ac4e9b54acfe4670b4634859c7263cb5",22860165,1,0,1,1509,392,392,0
"ac4e9b54acfe4670b4634859c7263cb5","6f8881a745ac4c358a68b92c3b4abe81",22860165,1,3,0,1510,392,394,2
"6f8881a745ac4c358a68b92c3b4abe81","17f95d18bab743888e1736033dc3384d",22860165,1,-6,0,1511,394,389,-5
"17f95d18bab743888e1736033dc3384d","6f8881a745ac4c358a68b92c3b4abe81",22860165,1,6,0,1512,389,394,5
"6f8881a745ac4c358a68b92c3b4abe81","f7002c8484354eceac57bc7bd62c76c1",22860165,1,-1,0,1513,394,393,-1
"f7002c8484354eceac57bc7bd62c76c1","0c12af0a4e7f4002852cf84b2537c161",22860165,1,3,0,1514,393,395,2
"0c12af0a4e7f4002852cf84b2537c161","df8191ec5e584c838a899c378941a566",22860165,2,4,0,1515,395,398,3
"df8191ec5e584c838a899c378941a566","0c12af0a4e7f4002852cf84b2537c161",22860165,2,-4,0,1516,398,395,-3
"0c12af0a4e7f4002852cf84b2537c161","2b09a08242b54983aec7063990fb3f66",22860165,1,8,0,1519,395,400,5
"2b09a08242b54983aec7063990fb3f66","66baf19b6b904b70922329068c63746d",22860165,4,-32,0,1520,400,376,-24
"66baf19b6b904b70922329068c63746d","2b09a08242b54983aec7063990fb3f66",22860165,4,32,0,1521,376,400,24
"2b09a08242b54983aec7063990fb3f66","2b09a08242b54983aec7063990fb3f66",22860165,11,0,1,1522,400,400,0
"66baf19b6b904b70922329068c63746d","df8191ec5e584c838a899c378941a566",22860165,1,28,0,1524,376,398,22
"df8191ec5e584c838a899c378941a566","44a277ea44dc4ae689fab4b82f0b4098",22860165,1,-2,0,1525,398,397,-1
"44a277ea44dc4ae689fab4b82f0b4098","44a277ea44dc4ae689fab4b82f0b4098",22860165,1,0,1,1526,397,397,0
"44a277ea44dc4ae689fab4b82f0b4098","0c12af0a4e7f4002852cf84b2537c161",22860165,1,-2,0,1527,397,395,-2
"0c12af0a4e7f4002852cf84b2537c161","859e0b8d71694b12befb69ee698138f9",22860165,1,5,0,1528,395,399,4
"859e0b8d71694b12befb69ee698138f9","859e0b8d71694b12befb69ee698138f9",22860165,1,0,1,1529,399,399,0
"859e0b8d71694b12befb69ee698138f9","2b09a08242b54983aec7063990fb3f66",22860165,1,3,0,1530,399,400,1
"2b09a08242b54983aec7063990fb3f66","1f471b7a883a4df48211e8c6a81b59a7",22860165,1,1,0,1534,400,401,1
"1f471b7a883a4df48211e8c6a81b59a7","1f471b7a883a4df48211e8c6a81b59a7",22860165,1,0,1,1535,401,401,0
"1f471b7a883a4df48211e8c6a81b59a7","2b09a08242b54983aec7063990fb3f66",22860165,1,-1,0,1536,401,400,-1
"2b09a08242b54983aec7063990fb3f66","9de0d567bfa84fe5b77cb76f4a76a5d1",22860165,1,5,0,1537,400,404,4
"9de0d567bfa84fe5b77cb76f4a76a5d1","9de0d567bfa84fe5b77cb76f4a76a5d1",22860165,1,0,1,1538,404,404,0
"9de0d567bfa84fe5b77cb76f4a76a5d1","1157bd665ec4472fb58b751dc5099355",22860165,1,-1,0,1539,404,403,-1
"1157bd665ec4472fb58b751dc5099355","58fc9094275e4c49be3f4ba6d4acc0a4",22860165,1,5,0,1540,403,406,3
"58fc9094275e4c49be3f4ba6d4acc0a4","3c8a22d2f9c146ea956609e3ed4f2559",22860165,1,-2,0,1541,406,405,-1
"3c8a22d2f9c146ea956609e3ed4f2559","58fc9094275e4c49be3f4ba6d4acc0a4",22860165,6,2,0,1542,405,406,1
"58fc9094275e4c49be3f4ba6d4acc0a4","66baf19b6b904b70922329068c63746d",22860165,1,-41,0,1543,406,376,-30
"66baf19b6b904b70922329068c63746d","66baf19b6b904b70922329068c63746d",22860165,2,0,1,1544,376,376,0
"2b09a08242b54983aec7063990fb3f66","1157bd665ec4472fb58b751dc5099355",22860165,6,4,0,1550,400,403,3
"1157bd665ec4472fb58b751dc5099355","3c8a22d2f9c146ea956609e3ed4f2559",22860165,6,3,0,1551,403,405,2
"3c8a22d2f9c146ea956609e3ed4f2559","c1c1be90b2b14c1ab4a5e1ee3c241902",22860165,1,3,0,1552,405,407,2
"c1c1be90b2b14c1ab4a5e1ee3c241902","c1c1be90b2b14c1ab4a5e1ee3c241902",22860165,5,0,1,1553,407,407,0
"c1c1be90b2b14c1ab4a5e1ee3c241902","58fc9094275e4c49be3f4ba6d4acc0a4",22860165,1,-1,0,1558,407,406,-1
"58fc9094275e4c49be3f4ba6d4acc0a4","02b3a1bead9244c1ba2f857c7da8f82a",22860165,5,3,0,1559,406,408,2
"02b3a1bead9244c1ba2f857c7da8f82a","2b09a08242b54983aec7063990fb3f66",22860165,1,-12,0,1560,408,400,-8
"58fc9094275e4c49be3f4ba6d4acc0a4","6206fc6479014bb193084c32409dc1b9",22860165,1,4,0,1565,406,409,3
"6206fc6479014bb193084c32409dc1b9","6206fc6479014bb193084c32409dc1b9",22860165,1,0,1,1566,409,409,0
"6206fc6479014bb193084c32409dc1b9","02b3a1bead9244c1ba2f857c7da8f82a",22860165,1,-1,0,1567,409,408,-1
"02b3a1bead9244c1ba2f857c7da8f82a","6a5f020451db426dacba9e2ea3fcc62a",22860165,5,3,0,1568,408,410,2
"6a5f020451db426dacba9e2ea3fcc62a","c6f26bd420634f1cb7989e76fe6b16c0",22860165,1,3,0,1569,410,412,2
"c6f26bd420634f1cb7989e76fe6b16c0","c6f26bd420634f1cb7989e76fe6b16c0",22860165,5,0,1,1570,412,412,0
"c6f26bd420634f1cb7989e76fe6b16c0","2a65ee6e2ac64f6a8a55fbe5373ec763",22860165,1,1,0,1575,412,413,1
"2a65ee6e2ac64f6a8a55fbe5373ec763","2a65ee6e2ac64f6a8a55fbe5373ec763",22860165,2,0,1,1576,413,413,0
"2a65ee6e2ac64f6a8a55fbe5373ec763","33a9d248b2e44588a5b07fc1342b9bc2",22860165,1,-2,0,1578,413,411,-2
"33a9d248b2e44588a5b07fc1342b9bc2","2b09a08242b54983aec7063990fb3f66",22860165,4,-17,0,1579,411,400,-11
"6a5f020451db426dacba9e2ea3fcc62a","33a9d248b2e44588a5b07fc1342b9bc2",22860165,6,2,0,1586,410,411,1
"33a9d248b2e44588a5b07fc1342b9bc2","687055dad9fc40c3982478fe33ec01bf",22860165,3,4,0,1587,411,414,3
"687055dad9fc40c3982478fe33ec01bf","33a9d248b2e44588a5b07fc1342b9bc2",22860165,3,-4,0,1588,414,411,-3
"2b09a08242b54983aec7063990fb3f66","687055dad9fc40c3982478fe33ec01bf",22860165,1,21,0,1609,400,414,14
"33a9d248b2e44588a5b07fc1342b9bc2","33a9d248b2e44588a5b07fc1342b9bc2",22860165,2,0,1,1611,411,411,0
"33a9d248b2e44588a5b07fc1342b9bc2","1fd0f6dadbc14ebc965faf6122190b96",22860165,1,5,0,1612,411,415,4
"1fd0f6dadbc14ebc965faf6122190b96","1fd0f6dadbc14ebc965faf6122190b96",22860165,1,0,1,1613,415,415,0
"1fd0f6dadbc14ebc965faf6122190b96","687055dad9fc40c3982478fe33ec01bf",22860165,1,-1,0,1614,415,414,-1
"687055dad9fc40c3982478fe33ec01bf","2add1669f08d4101913db15f8c23b3b7",22860165,1,3,0,1615,414,416,2
"2add1669f08d4101913db15f8c23b3b7","687055dad9fc40c3982478fe33ec01bf",22860165,1,-3,0,1616,416,414,-2
"33a9d248b2e44588a5b07fc1342b9bc2","6a5f020451db426dacba9e2ea3fcc62a",22860165,2,-2,0,1619,411,410,-1
"687055dad9fc40c3982478fe33ec01bf","a2b4bd40cee2481ebd3fc179d6a5cd62",22860165,2,6,0,1624,414,417,3
"a2b4bd40cee2481ebd3fc179d6a5cd62","2b09a08242b54983aec7063990fb3f66",22860165,4,-27,0,1625,417,400,-17
"2b09a08242b54983aec7063990fb3f66","a2b4bd40cee2481ebd3fc179d6a5cd62",22860165,2,27,0,1626,400,417,17
"2b09a08242b54983aec7063990fb3f66","2add1669f08d4101913db15f8c23b3b7",22860165,1,24,0,1628,400,416,16
"2add1669f08d4101913db15f8c23b3b7","2add1669f08d4101913db15f8c23b3b7",22860165,1,0,1,1629,416,416,0
"2add1669f08d4101913db15f8c23b3b7","a2b4bd40cee2481ebd3fc179d6a5cd62",22860165,1,3,0,1630,416,417,1
"2b09a08242b54983aec7063990fb3f66","e34e59dce2204f228f3a84b6725df60f",22860165,1,29,0,1632,400,419,19
"e34e59dce2204f228f3a84b6725df60f","e34e59dce2204f228f3a84b6725df60f",22860165,1,0,1,1633,419,419,0
"e34e59dce2204f228f3a84b6725df60f","a2b4bd40cee2481ebd3fc179d6a5cd62",22860165,1,-2,0,1634,419,417,-2
"a2b4bd40cee2481ebd3fc179d6a5cd62","bec48fc2e1294c7eb3d0aca780d731b8",22860165,2,4,0,1635,417,420,3
"bec48fc2e1294c7eb3d0aca780d731b8","bec48fc2e1294c7eb3d0aca780d731b8",22860165,1,0,1,1636,420,420,0
"bec48fc2e1294c7eb3d0aca780d731b8","a24600b0e49245f6bdba8c893cfeddb0",22860165,1,7,0,1637,420,425,5
"a24600b0e49245f6bdba8c893cfeddb0","dbde19fcce2a4c1abdc7f685c293a23f",22860165,1,-4,0,1638,425,422,-3
"dbde19fcce2a4c1abdc7f685c293a23f","a24600b0e49245f6bdba8c893cfeddb0",22860165,2,4,0,1639,422,425,3
"a24600b0e49245f6bdba8c893cfeddb0","a2b4bd40cee2481ebd3fc179d6a5cd62",22860165,1,-11,0,1640,425,417,-8
"a2b4bd40cee2481ebd3fc179d6a5cd62","24cf8786024543f19b89bc20034e60d7",22860165,2,18,0,1641,417,428,11
"24cf8786024543f19b89bc20034e60d7","f2a73be2f46840b182d7bd095378004e",22860165,1,1,0,1642,428,429,1
"f2a73be2f46840b182d7bd095378004e","604551fd4266430cb860fef58fa7dd61",22860165,1,1,0,1643,429,430,1
"604551fd4266430cb860fef58fa7dd61","604551fd4266430cb860fef58fa7dd61",22860165,1,0,1,1644,430,430,0
"604551fd4266430cb860fef58fa7dd61","24cf8786024543f19b89bc20034e60d7",22860165,1,-2,0,1645,430,428,-2
"24cf8786024543f19b89bc20034e60d7","dce46f8904594a62a6377a3587aaa663",22860165,2,4,0,1646,428,431,3
"dce46f8904594a62a6377a3587aaa663","9b9d0a249052413c869753b99682b0ac",22860165,1,1,0,1647,431,432,1
"9b9d0a249052413c869753b99682b0ac","9b9d0a249052413c869753b99682b0ac",22860165,6,0,1,1648,432,432,0
"9b9d0a249052413c869753b99682b0ac","061c175cc90f45fbad883025394e78dd",22860165,1,1,0,1654,432,433,1
"061c175cc90f45fbad883025394e78dd","061c175cc90f45fbad883025394e78dd",22860165,4,0,1,1655,433,433,0
"061c175cc90f45fbad883025394e78dd","dce46f8904594a62a6377a3587aaa663",22860165,1,-2,0,1659,433,431,-2
"dce46f8904594a62a6377a3587aaa663","74a7f8712e5449c2bc0b43c6f90dafed",22860165,1,5,0,1660,431,435,4
"74a7f8712e5449c2bc0b43c6f90dafed","74a7f8712e5449c2bc0b43c6f90dafed",22860165,1,0,1,1661,435,435,0
"74a7f8712e5449c2bc0b43c6f90dafed","66ada10dde9f43018588f1ced9d477fc",22860165,1,-1,0,1662,435,434,-1
"66ada10dde9f43018588f1ced9d477fc","24cf8786024543f19b89bc20034e60d7",22860165,2,-8,0,1663,434,428,-6
"24cf8786024543f19b89bc20034e60d7","070600601c4c439288445d2f0724807d",22860165,4,14,0,1664,428,437,9
"070600601c4c439288445d2f0724807d","1823b6de7d334a7aaabc4570719af4d9",22860165,3,2,0,1665,437,439,2
"1823b6de7d334a7aaabc4570719af4d9","24cf8786024543f19b89bc20034e60d7",22860165,1,-16,0,1666,439,428,-11
"070600601c4c439288445d2f0724807d","bf12c96466d840a69bed7020b3f18bb8",22860165,1,-3,0,1668,437,436,-1
"bf12c96466d840a69bed7020b3f18bb8","bf12c96466d840a69bed7020b3f18bb8",22860165,1,0,1,1669,436,436,0
"bf12c96466d840a69bed7020b3f18bb8","24cf8786024543f19b89bc20034e60d7",22860165,1,-11,0,1670,436,428,-8
"1823b6de7d334a7aaabc4570719af4d9","1823b6de7d334a7aaabc4570719af4d9",22860165,11,0,1,1673,439,439,0
"1823b6de7d334a7aaabc4570719af4d9","0380cd76a7d44bc3a4da1f15e4d68f89",22860165,1,2,0,1684,439,440,1
"0380cd76a7d44bc3a4da1f15e4d68f89","070600601c4c439288445d2f0724807d",22860165,1,-4,0,1685,440,437,-3
"070600601c4c439288445d2f0724807d","0380cd76a7d44bc3a4da1f15e4d68f89",22860165,2,4,0,1686,437,440,3
"0380cd76a7d44bc3a4da1f15e4d68f89","23b7673c8b5443108c2ef09382834a86",22860165,2,2,0,1687,440,441,1
"23b7673c8b5443108c2ef09382834a86","901e92500aea43c79f19f1b279050668",22860165,2,2,0,1688,441,442,1
"901e92500aea43c79f19f1b279050668","23b7673c8b5443108c2ef09382834a86",22860165,1,-2,0,1689,442,441,-1
"23b7673c8b5443108c2ef09382834a86","001339db8ced4cf78829ebe8b145449d",22860165,1,3,0,1690,441,443,2
"001339db8ced4cf78829ebe8b145449d","001339db8ced4cf78829ebe8b145449d",22860165,8,0,1,1691,443,443,0
"001339db8ced4cf78829ebe8b145449d","452745e0366e42ae81561bfddebcc6c3",22860165,1,1,0,1699,443,444,1
"452745e0366e42ae81561bfddebcc6c3","452745e0366e42ae81561bfddebcc6c3",22860165,2,0,1,1700,444,444,0
"452745e0366e42ae81561bfddebcc6c3","901e92500aea43c79f19f1b279050668",22860165,1,-2,0,1702,444,442,-2
"901e92500aea43c79f19f1b279050668","4660ff2089114e8db82ceb26a4f329e3",22860165,2,4,0,1703,442,445,3
"4660ff2089114e8db82ceb26a4f329e3","4660ff2089114e8db82ceb26a4f329e3",22860165,1,0,1,1704,445,445,0
"4660ff2089114e8db82ceb26a4f329e3","7bd5586eb9d8484eb74a433ee7bfe499",22860165,2,2,0,1705,445,446,1
"7bd5586eb9d8484eb74a433ee7bfe499","7bd5586eb9d8484eb74a433ee7bfe499",22860165,10,0,1,1706,446,446,0
"7bd5586eb9d8484eb74a433ee7bfe499","8a7f26e690f34dda97be16904518ca99",22860165,1,2,0,1715,446,447,1
"8a7f26e690f34dda97be16904518ca99","8a7f26e690f34dda97be16904518ca99",22860165,1,0,1,1716,447,447,0
"8a7f26e690f34dda97be16904518ca99","070600601c4c439288445d2f0724807d",22860165,1,-16,0,1717,447,437,-10
"070600601c4c439288445d2f0724807d","b2f0d654738f48158edff28e8d3a546e",22860165,2,21,0,1718,437,449,12
"b2f0d654738f48158edff28e8d3a546e","b2f0d654738f48158edff28e8d3a546e",22860165,2,0,1,1719,449,449,0
"b2f0d654738f48158edff28e8d3a546e","f60ee41ec635499abd48168342d32c2f",22860165,6,5,0,1720,449,453,4
"f60ee41ec635499abd48168342d32c2f","f60ee41ec635499abd48168342d32c2f",22860165,89,0,1,1721,453,453,0
"f60ee41ec635499abd48168342d32c2f","b2f0d654738f48158edff28e8d3a546e",22860165,3,-5,0,1728,453,449,-4
"f60ee41ec635499abd48168342d32c2f","9428d8bd9c5a47b2a235b254e5e27ded",22860165,1,-1,0,1737,453,452,-1
"9428d8bd9c5a47b2a235b254e5e27ded","b2f0d654738f48158edff28e8d3a546e",22860165,1,-4,0,1738,452,449,-3
"b2f0d654738f48158edff28e8d3a546e","f67fbf45a5f146ed866965bc57c7c001",22860165,2,8,0,1767,449,454,5
"f67fbf45a5f146ed866965bc57c7c001","f60ee41ec635499abd48168342d32c2f",22860165,1,-3,0,1768,454,453,-1
"f60ee41ec635499abd48168342d32c2f","f67fbf45a5f146ed866965bc57c7c001",22860165,2,3,0,1775,453,454,1
"f67fbf45a5f146ed866965bc57c7c001","b2f0d654738f48158edff28e8d3a546e",22860165,2,-8,0,1776,454,449,-5
"f67fbf45a5f146ed866965bc57c7c001","f67fbf45a5f146ed866965bc57c7c001",22860165,2,0,1,1809,454,454,0
"f67fbf45a5f146ed866965bc57c7c001","d937afe49bd24a07a550dda1c1155122",22860165,1,1,0,1811,454,455,1
"d937afe49bd24a07a550dda1c1155122","d937afe49bd24a07a550dda1c1155122",22860165,3,0,1,1812,455,455,0
"d937afe49bd24a07a550dda1c1155122","2b09a08242b54983aec7063990fb3f66",22860165,1,-89,0,1815,455,400,-55
"bec48fc2e1294c7eb3d0aca780d731b8","dbde19fcce2a4c1abdc7f685c293a23f",22860165,1,3,0,1828,420,422,2
"a24600b0e49245f6bdba8c893cfeddb0","24cf8786024543f19b89bc20034e60d7",22860165,1,7,0,1830,425,428,3
"24cf8786024543f19b89bc20034e60d7","a2b4bd40cee2481ebd3fc179d6a5cd62",22860165,1,-18,0,1831,428,417,-11
"dce46f8904594a62a6377a3587aaa663","66ada10dde9f43018588f1ced9d477fc",22860165,1,4,0,1834,431,434,3
"1823b6de7d334a7aaabc4570719af4d9","070600601c4c439288445d2f0724807d",22860165,1,-2,0,1838,439,437,-2
"7bd5586eb9d8484eb74a433ee7bfe499","070600601c4c439288445d2f0724807d",22860165,1,-14,0,1845,446,437,-9
"b2f0d654738f48158edff28e8d3a546e","3628b3f7823443d0912a339096b69943",22860165,1,10,0,1858,449,456,7
"3628b3f7823443d0912a339096b69943","3628b3f7823443d0912a339096b69943",22860165,1,0,1,1859,456,456,0
"3628b3f7823443d0912a339096b69943","9e049ee647cf43ecbcb5ed792a8e7588",22860165,1,1,0,1860,456,457,1
"9e049ee647cf43ecbcb5ed792a8e7588","9e049ee647cf43ecbcb5ed792a8e7588",22860165,1,0,1,1861,457,457,0
"9e049ee647cf43ecbcb5ed792a8e7588","5256a214faaf410b93f76cea06428334",22860165,1,1,0,1862,457,458,1
"5256a214faaf410b93f76cea06428334","5256a214faaf410b93f76cea06428334",22860165,1,0,1,1863,458,458,0
"5256a214faaf410b93f76cea06428334","25c32b120fce40fa9b6c85133aeb4716",22860165,1,1,0,1864,458,459,1
"25c32b120fce40fa9b6c85133aeb4716","25c32b120fce40fa9b6c85133aeb4716",22860165,1,0,1,1865,459,459,0
"25c32b120fce40fa9b6c85133aeb4716","11bc14f2204949008b7d511b933363c1",22860165,1,1,0,1866,459,460,1
"11bc14f2204949008b7d511b933363c1","11bc14f2204949008b7d511b933363c1",22860165,1,0,1,1867,460,460,0
"11bc14f2204949008b7d511b933363c1","42de338840a34d15adb66e7b14fb9d2c",22860165,1,1,0,1868,460,461,1
"42de338840a34d15adb66e7b14fb9d2c","42de338840a34d15adb66e7b14fb9d2c",22860165,1,0,1,1869,461,461,0
"42de338840a34d15adb66e7b14fb9d2c","9da37c6210b1416b8079c274f70bf600",22860165,1,1,0,1870,461,462,1
"9da37c6210b1416b8079c274f70bf600","9da37c6210b1416b8079c274f70bf600",22860165,3,0,1,1871,462,462,0
"9da37c6210b1416b8079c274f70bf600","519119f1deac45ff9ab4f13529be5c6e",22860165,1,1,0,1874,462,463,1
"519119f1deac45ff9ab4f13529be5c6e","519119f1deac45ff9ab4f13529be5c6e",22860165,1,0,1,1875,463,463,0
"519119f1deac45ff9ab4f13529be5c6e","f67fbf45a5f146ed866965bc57c7c001",22860165,1,-9,0,1876,463,454,-9
"f67fbf45a5f146ed866965bc57c7c001","c5df9f40ec14463b9dcfdc73df3e9285",22860165,1,12,0,1877,454,464,10
"c5df9f40ec14463b9dcfdc73df3e9285","c5df9f40ec14463b9dcfdc73df3e9285",22860165,2,0,1,1878,464,464,0
"c5df9f40ec14463b9dcfdc73df3e9285","83d42d95cd844fc093fc09cee250edb8",22860165,1,3,0,1880,464,465,1
"83d42d95cd844fc093fc09cee250edb8","83d42d95cd844fc093fc09cee250edb8",22860165,1,0,1,1881,465,465,0
"83d42d95cd844fc093fc09cee250edb8","78adeee1fa2c4fe0bc73f7bca9fcee86",22860165,1,-431,0,1882,465,160,-305
"65202579580f4ad38d734b4ee39d22a8","8959e6304a0348309a771e4d08d1b64a",22860165,5,-1,0,1891,164,163,-1
"8959e6304a0348309a771e4d08d1b64a","78adeee1fa2c4fe0bc73f7bca9fcee86",22860165,3,-4,0,1892,163,160,-3
"78adeee1fa2c4fe0bc73f7bca9fcee86","78adeee1fa2c4fe0bc73f7bca9fcee86",22860165,2,0,1,1893,160,160,0
"65202579580f4ad38d734b4ee39d22a8","78adeee1fa2c4fe0bc73f7bca9fcee86",22860165,7,-5,0,1922,164,160,-4
"8959e6304a0348309a771e4d08d1b64a","65202579580f4ad38d734b4ee39d22a8",22860165,1,1,0,1932,163,164,1
"8959e6304a0348309a771e4d08d1b64a","b2f0d654738f48158edff28e8d3a546e",22860165,1,404,0,1942,163,449,286
"f60ee41ec635499abd48168342d32c2f","78adeee1fa2c4fe0bc73f7bca9fcee86",22860165,1,-413,0,1951,453,160,-293
"78adeee1fa2c4fe0bc73f7bca9fcee86","3cbcea2be0984e7dbd5a48195af10ce7",22860165,1,8,0,2013,160,165,5
"3cbcea2be0984e7dbd5a48195af10ce7","82e6285962b8400d9d6fc32436022a94",22860165,2,2,0,2014,165,167,2
"82e6285962b8400d9d6fc32436022a94","3cbcea2be0984e7dbd5a48195af10ce7",22860165,2,-2,0,2015,167,165,-2
"3cbcea2be0984e7dbd5a48195af10ce7","a9ac840f098c4bd0a2ee896214ce29cd",22860165,1,5,0,2016,165,168,3
"a9ac840f098c4bd0a2ee896214ce29cd","a9ac840f098c4bd0a2ee896214ce29cd",22860165,2,0,1,2017,168,168,0
"a9ac840f098c4bd0a2ee896214ce29cd","0c7262dff33c4087bc660ccf40f92f9c",22860165,2,4,0,2018,168,169,1
"0c7262dff33c4087bc660ccf40f92f9c","b2275c3fad834f8d90737a2d9a6927d6",22860165,7,3,0,2019,169,172,3
"b2275c3fad834f8d90737a2d9a6927d6","78adeee1fa2c4fe0bc73f7bca9fcee86",22860165,4,-20,0,2020,172,160,-12
"65202579580f4ad38d734b4ee39d22a8","a9ac840f098c4bd0a2ee896214ce29cd",22860165,1,8,0,2056,164,168,4
"b613861cecf84ffcab01afb23f660475","b613861cecf84ffcab01afb23f660475",22856027,8,0,1,1,1,1,0
"b613861cecf84ffcab01afb23f660475","e2911e79efc2420eac45d9f671463d4b",22856027,2,3,0,11,1,2,1
"e2911e79efc2420eac45d9f671463d4b","e2911e79efc2420eac45d9f671463d4b",22856027,3,0,1,12,2,2,0
"e2911e79efc2420eac45d9f671463d4b","519d1b8c59404d67b54e96c5c8a830b2",22856027,1,1,0,14,2,3,1
"519d1b8c59404d67b54e96c5c8a830b2","519d1b8c59404d67b54e96c5c8a830b2",22856027,1,0,1,15,3,3,0
"519d1b8c59404d67b54e96c5c8a830b2","531db53f81f646edb0cdcfe0085b03b7",22856027,1,1,0,16,3,4,1
"531db53f81f646edb0cdcfe0085b03b7","531db53f81f646edb0cdcfe0085b03b7",22856027,1,0,1,17,4,4,0
"531db53f81f646edb0cdcfe0085b03b7","4f5f94b2f95141e0a9d53a61da2276da",22856027,2,1,0,18,4,5,1
"4f5f94b2f95141e0a9d53a61da2276da","4f5f94b2f95141e0a9d53a61da2276da",22856027,1,0,1,19,5,5,0
"4f5f94b2f95141e0a9d53a61da2276da","6d541c89590949f99af293c4f2333f67",22856027,1,1,0,20,5,6,1
"6d541c89590949f99af293c4f2333f67","6d541c89590949f99af293c4f2333f67",22856027,1,0,1,21,6,6,0
"6d541c89590949f99af293c4f2333f67","dd5cf0b9fe4c4f1d8f5ff8e4c04879cb",22856027,1,1,0,22,6,7,1
"dd5cf0b9fe4c4f1d8f5ff8e4c04879cb","dd5cf0b9fe4c4f1d8f5ff8e4c04879cb",22856027,1,0,1,23,7,7,0
"dd5cf0b9fe4c4f1d8f5ff8e4c04879cb","f96261861edc426abe2248be4f0a709a",22856027,1,1,0,24,7,8,1
"f96261861edc426abe2248be4f0a709a","f96261861edc426abe2248be4f0a709a",22856027,1,0,1,25,8,8,0
"f96261861edc426abe2248be4f0a709a","66b5e16f4f75454fb5b8172079f0fa83",22856027,1,1,0,26,8,9,1
"66b5e16f4f75454fb5b8172079f0fa83","66b5e16f4f75454fb5b8172079f0fa83",22856027,1,0,1,27,9,9,0
"66b5e16f4f75454fb5b8172079f0fa83","0680571d4698477995e41842c36a54b2",22856027,1,1,0,28,9,10,1
"0680571d4698477995e41842c36a54b2","0680571d4698477995e41842c36a54b2",22856027,1,0,1,29,10,10,0
"0680571d4698477995e41842c36a54b2","9112f2bffece48e08c6d2287be204085",22856027,1,1,0,30,10,11,1
"9112f2bffece48e08c6d2287be204085","9112f2bffece48e08c6d2287be204085",22856027,1,0,1,31,11,11,0
"9112f2bffece48e08c6d2287be204085","56586aa865414f538729c7f7735d2bc6",22856027,1,3,0,32,11,12,1
"56586aa865414f538729c7f7735d2bc6","e2911e79efc2420eac45d9f671463d4b",22856027,2,-12,0,33,12,2,-10
"e2911e79efc2420eac45d9f671463d4b","56586aa865414f538729c7f7735d2bc6",22856027,1,12,0,34,2,12,10
"e2911e79efc2420eac45d9f671463d4b","531db53f81f646edb0cdcfe0085b03b7",22856027,1,2,0,37,2,4,2
"4f5f94b2f95141e0a9d53a61da2276da","9112f2bffece48e08c6d2287be204085",22856027,1,6,0,39,5,11,6
"9112f2bffece48e08c6d2287be204085","e2911e79efc2420eac45d9f671463d4b",22856027,2,-9,0,40,11,2,-9
"e2911e79efc2420eac45d9f671463d4b","9112f2bffece48e08c6d2287be204085",22856027,1,9,0,41,2,11,9
"e2911e79efc2420eac45d9f671463d4b","b613861cecf84ffcab01afb23f660475",22856027,2,-3,0,43,2,1,-1
"b613861cecf84ffcab01afb23f660475","56586aa865414f538729c7f7735d2bc6",22856027,1,15,0,44,1,12,11
"56586aa865414f538729c7f7735d2bc6","56586aa865414f538729c7f7735d2bc6",22856027,4,0,1,45,12,12,0
"56586aa865414f538729c7f7735d2bc6","b7f2b31585d94eb3bf86376714aa7070",22856027,1,2,0,49,12,13,1
"b7f2b31585d94eb3bf86376714aa7070","b7f2b31585d94eb3bf86376714aa7070",22856027,2,0,1,50,13,13,0
"b7f2b31585d94eb3bf86376714aa7070","3f1c815879794b929260d224becaff7e",22856027,1,2,0,52,13,14,1
"3f1c815879794b929260d224becaff7e","81c864a886d54a6b8ff85f7d736f4f95",22856027,1,2,0,53,14,15,1
"81c864a886d54a6b8ff85f7d736f4f95","5c5ceeee4562457ba6d41515aeebfbb1",22856027,1,4,0,54,15,17,2
"5c5ceeee4562457ba6d41515aeebfbb1","5c5ceeee4562457ba6d41515aeebfbb1",22856027,1,0,1,55,17,17,0
"5c5ceeee4562457ba6d41515aeebfbb1","9afd71a5298d4333b6849dfce1b9422c",22856027,1,3,0,56,17,18,1
"9afd71a5298d4333b6849dfce1b9422c","56586aa865414f538729c7f7735d2bc6",22856027,1,-13,0,57,18,12,-6
"56586aa865414f538729c7f7735d2bc6","9afd71a5298d4333b6849dfce1b9422c",22856027,1,13,0,58,12,18,6
"9afd71a5298d4333b6849dfce1b9422c","b7719e26494940efa49512aedd0aac79",22856027,1,4,0,59,18,20,2
"b7719e26494940efa49512aedd0aac79","9afd71a5298d4333b6849dfce1b9422c",22856027,1,-4,0,60,20,18,-2
"9afd71a5298d4333b6849dfce1b9422c","d4c3b003e8274e429d2fa688d73fde6d",22856027,1,7,0,61,18,22,4
"d4c3b003e8274e429d2fa688d73fde6d","d4f45188d3c84a02ba08454e6403a818",22856027,1,2,0,62,22,24,2
"d4f45188d3c84a02ba08454e6403a818","d4c3b003e8274e429d2fa688d73fde6d",22856027,1,-2,0,63,24,22,-2
"d4c3b003e8274e429d2fa688d73fde6d","b7719e26494940efa49512aedd0aac79",22856027,1,-3,0,64,22,20,-2
"b7719e26494940efa49512aedd0aac79","b7719e26494940efa49512aedd0aac79",22856027,1,0,1,65,20,20,0
"b7719e26494940efa49512aedd0aac79","afbf7250b99d47bea07172749483ca97",22856027,1,12,0,66,20,28,8
"afbf7250b99d47bea07172749483ca97","4e51676dc72045d99c19b9fa7b22f8bc",22856027,2,3,0,67,28,29,1
"4e51676dc72045d99c19b9fa7b22f8bc","afbf7250b99d47bea07172749483ca97",22856027,1,-3,0,68,29,28,-1
"4e51676dc72045d99c19b9fa7b22f8bc","51970cfa30e643e894e66ae85c8024cc",22856027,1,3,0,70,29,31,2
"51970cfa30e643e894e66ae85c8024cc","4e51676dc72045d99c19b9fa7b22f8bc",22856027,1,-3,0,71,31,29,-2
"4e51676dc72045d99c19b9fa7b22f8bc","c33c17be71ae4d588da7369472e5bb1b",22856027,1,9,0,72,29,34,5
"c33c17be71ae4d588da7369472e5bb1b","93679be414554a11b1893002f2229a93",22856027,1,3,0,73,34,35,1
"93679be414554a11b1893002f2229a93","c33c17be71ae4d588da7369472e5bb1b",22856027,1,-3,0,74,35,34,-1
"c33c17be71ae4d588da7369472e5bb1b","7040a13096d746ac84b8fac8d9752058",22856027,1,6,0,75,34,36,2
"7040a13096d746ac84b8fac8d9752058","93679be414554a11b1893002f2229a93",22856027,1,-3,0,76,36,35,-1
"93679be414554a11b1893002f2229a93","9a0dc646f934470daf08c4b56ccf73db",22856027,1,6,0,77,35,37,2
"9a0dc646f934470daf08c4b56ccf73db","7040a13096d746ac84b8fac8d9752058",22856027,1,-3,0,78,37,36,-1
"7040a13096d746ac84b8fac8d9752058","fc0e049d56024bc9a02c9a9c435c3df7",22856027,1,6,0,79,36,38,2
"fc0e049d56024bc9a02c9a9c435c3df7","9a0dc646f934470daf08c4b56ccf73db",22856027,1,-3,0,80,38,37,-1
"9a0dc646f934470daf08c4b56ccf73db","fc0e049d56024bc9a02c9a9c435c3df7",22856027,1,3,0,81,37,38,1
"fc0e049d56024bc9a02c9a9c435c3df7","fc0e049d56024bc9a02c9a9c435c3df7",22856027,6,0,1,82,38,38,0
"fc0e049d56024bc9a02c9a9c435c3df7","67a089198fcb4e1c8f2385786c2b296f",22856027,1,4,0,88,38,39,1
"67a089198fcb4e1c8f2385786c2b296f","64d48c6c9c7940639a932219a6c87198",22856027,1,1,0,89,39,40,1
"64d48c6c9c7940639a932219a6c87198","64d48c6c9c7940639a932219a6c87198",22856027,1,0,1,90,40,40,0
"64d48c6c9c7940639a932219a6c87198","67a089198fcb4e1c8f2385786c2b296f",22856027,1,-1,0,91,40,39,-1
"67a089198fcb4e1c8f2385786c2b296f","b534b89233134e30a9b5645138bfa9ee",22856027,1,4,0,92,39,41,2
"b534b89233134e30a9b5645138bfa9ee","0e37b720d23b4e7f8b313e79313fd107",22856027,1,3,0,93,41,44,3
"0e37b720d23b4e7f8b313e79313fd107","0e37b720d23b4e7f8b313e79313fd107",22856027,1,0,1,94,44,44,0
"0e37b720d23b4e7f8b313e79313fd107","6875d67fdd5f48168b62719df449bebd",22856027,1,1,0,95,44,45,1
"6875d67fdd5f48168b62719df449bebd","6875d67fdd5f48168b62719df449bebd",22856027,1,0,1,96,45,45,0
"6875d67fdd5f48168b62719df449bebd","b534b89233134e30a9b5645138bfa9ee",22856027,1,-4,0,97,45,41,-4
"b534b89233134e30a9b5645138bfa9ee","6e13d61a7bdb44bca949c9f86fab3be5",22856027,1,7,0,98,41,47,6
"6e13d61a7bdb44bca949c9f86fab3be5","6e13d61a7bdb44bca949c9f86fab3be5",22856027,2,0,1,100,47,47,0
"6e13d61a7bdb44bca949c9f86fab3be5","195f78799f984cc2b06c48dfe36be751",22856027,1,2,0,101,47,49,2
"195f78799f984cc2b06c48dfe36be751","195f78799f984cc2b06c48dfe36be751",22856027,2,0,1,102,49,49,0
"195f78799f984cc2b06c48dfe36be751","d9c8d8c444a64dadbbb508652c721e17",22856027,1,-3,0,104,49,46,-3
"d9c8d8c444a64dadbbb508652c721e17","d0c74f735e024943943e40333d6d337f",22856027,1,6,0,105,46,51,5
"d0c74f735e024943943e40333d6d337f","d0c74f735e024943943e40333d6d337f",22856027,1,0,1,106,51,51,0
"d0c74f735e024943943e40333d6d337f","983f8ff320594b279a7f4a6fe132f9c5",22856027,1,2,0,107,51,53,2
"983f8ff320594b279a7f4a6fe132f9c5","983f8ff320594b279a7f4a6fe132f9c5",22856027,2,0,1,108,53,53,0
"983f8ff320594b279a7f4a6fe132f9c5","35adfa5d923046aebabfefd98f35ff05",22856027,1,1,0,110,53,54,1
"35adfa5d923046aebabfefd98f35ff05","35adfa5d923046aebabfefd98f35ff05",22856027,2,0,1,111,54,54,0
"35adfa5d923046aebabfefd98f35ff05","b6f8a98476224da1b40e555ececc7ed8",22856027,1,1,0,113,54,55,1
"b6f8a98476224da1b40e555ececc7ed8","b6f8a98476224da1b40e555ececc7ed8",22856027,2,0,1,114,55,55,0
"b6f8a98476224da1b40e555ececc7ed8","86e22cb5fe0e4b47a9489ecddf7ed78f",22856027,1,1,0,116,55,56,1
"86e22cb5fe0e4b47a9489ecddf7ed78f","86e22cb5fe0e4b47a9489ecddf7ed78f",22856027,2,0,1,117,56,56,0
"86e22cb5fe0e4b47a9489ecddf7ed78f","f924752d8a1149668870b1e7698486f7",22856027,1,-6,0,119,56,50,-6
"f924752d8a1149668870b1e7698486f7","78f30e4dcac84e3cbea8b2cc6e0d62b3",22856027,1,10,0,120,50,59,9
"78f30e4dcac84e3cbea8b2cc6e0d62b3","a1f2f12debe5432fb7a70bcd12bacfb9",22856027,1,-1,0,121,59,58,-1
"a1f2f12debe5432fb7a70bcd12bacfb9","a1f2f12debe5432fb7a70bcd12bacfb9",22856027,15,0,1,122,58,58,0
"a1f2f12debe5432fb7a70bcd12bacfb9","78f30e4dcac84e3cbea8b2cc6e0d62b3",22856027,1,1,0,137,58,59,1
"78f30e4dcac84e3cbea8b2cc6e0d62b3","78f30e4dcac84e3cbea8b2cc6e0d62b3",22856027,21,0,1,138,59,59,0
"78f30e4dcac84e3cbea8b2cc6e0d62b3","a0a418b8540d479fa6e0f653b701da8b",22856027,1,6,0,159,59,64,5
"a0a418b8540d479fa6e0f653b701da8b","12aa6e1672ac4e7aa6449a7a8609cd72",22856027,1,-8,0,160,64,57,-7
"12aa6e1672ac4e7aa6449a7a8609cd72","bc42d26810654ea9a1df1efe1e58c7d5",22856027,1,7,0,161,57,63,6
"bc42d26810654ea9a1df1efe1e58c7d5","4c943503763e4e349906eea3ed3c8e86",22856027,1,-2,0,162,63,61,-2
"4c943503763e4e349906eea3ed3c8e86","4c943503763e4e349906eea3ed3c8e86",22856027,1,0,1,163,61,61,0
"4c943503763e4e349906eea3ed3c8e86","bc42d26810654ea9a1df1efe1e58c7d5",22856027,1,2,0,164,61,63,2
"bc42d26810654ea9a1df1efe1e58c7d5","bc42d26810654ea9a1df1efe1e58c7d5",22856027,3,0,1,165,63,63,0
"bc42d26810654ea9a1df1efe1e58c7d5","a0a418b8540d479fa6e0f653b701da8b",22856027,1,1,0,168,63,64,1
"a0a418b8540d479fa6e0f653b701da8b","a0a418b8540d479fa6e0f653b701da8b",22856027,3,0,1,169,64,64,0
"a0a418b8540d479fa6e0f653b701da8b","309ccf3cc4fe429d9bfbaef53d3fa479",22856027,1,-4,0,172,64,60,-4
"309ccf3cc4fe429d9bfbaef53d3fa479","d646286c8051419bbc2e31dd1db55ca8",22856027,1,10,0,173,60,67,7
"d646286c8051419bbc2e31dd1db55ca8","b534b89233134e30a9b5645138bfa9ee",22856027,1,-33,0,174,67,41,-26
"b534b89233134e30a9b5645138bfa9ee","267f883678b24aed855fde42524975d9",22856027,1,37,0,175,41,71,30
"267f883678b24aed855fde42524975d9","267f883678b24aed855fde42524975d9",22856027,3,0,1,176,71,71,0
"267f883678b24aed855fde42524975d9","88fff56d0342490dbef9040750a20f6c",22856027,1,1,0,179,71,72,1
"88fff56d0342490dbef9040750a20f6c","88fff56d0342490dbef9040750a20f6c",22856027,1,0,1,180,72,72,0
"88fff56d0342490dbef9040750a20f6c","adb17b12b66c4a49a85fd34322f7df70",22856027,1,1,0,181,72,73,1
"adb17b12b66c4a49a85fd34322f7df70","adb17b12b66c4a49a85fd34322f7df70",22856027,3,0,1,182,73,73,0
"adb17b12b66c4a49a85fd34322f7df70","d646286c8051419bbc2e31dd1db55ca8",22856027,1,-6,0,185,73,67,-6
"d646286c8051419bbc2e31dd1db55ca8","a2becd407db34b189200a32546d9d569",22856027,1,9,0,186,67,75,8
"a2becd407db34b189200a32546d9d569","a2becd407db34b189200a32546d9d569",22856027,6,0,1,187,75,75,0
"a2becd407db34b189200a32546d9d569","58c22b011d0f4c2ea6d13615edbb9eeb",22856027,1,2,0,190,75,77,2
"58c22b011d0f4c2ea6d13615edbb9eeb","58c22b011d0f4c2ea6d13615edbb9eeb",22856027,2,0,1,191,77,77,0
"58c22b011d0f4c2ea6d13615edbb9eeb","dd76e1861dc9461c830888729d091ee0",22856027,1,1,0,193,77,78,1
"dd76e1861dc9461c830888729d091ee0","dd76e1861dc9461c830888729d091ee0",22856027,8,0,1,194,78,78,0
"dd76e1861dc9461c830888729d091ee0","a2becd407db34b189200a32546d9d569",22856027,1,-3,0,202,78,75,-3
"a2becd407db34b189200a32546d9d569","cd1d828f1a694b87913a7ea66c23803e",22856027,1,4,0,206,75,79,4
"cd1d828f1a694b87913a7ea66c23803e","cd1d828f1a694b87913a7ea66c23803e",22856027,5,0,1,207,79,79,0
"cd1d828f1a694b87913a7ea66c23803e","9176a3c2b4d2465fa8b0c67096c2a97e",22856027,1,1,0,212,79,80,1
"9176a3c2b4d2465fa8b0c67096c2a97e","9176a3c2b4d2465fa8b0c67096c2a97e",22856027,5,0,1,213,80,80,0
"9176a3c2b4d2465fa8b0c67096c2a97e","f8ec6445f7194e25b9101d4fbcb07a18",22856027,1,1,0,218,80,81,1
"f8ec6445f7194e25b9101d4fbcb07a18","f8ec6445f7194e25b9101d4fbcb07a18",22856027,2,0,1,219,81,81,0
"f8ec6445f7194e25b9101d4fbcb07a18","140d5b27b8574befad82c0a013b59dfa",22856027,1,-7,0,221,81,74,-7
"140d5b27b8574befad82c0a013b59dfa","d18a9ea32855445f8736581f5cb119ce",22856027,1,9,0,222,74,82,8
"d18a9ea32855445f8736581f5cb119ce","ae5ac430ea254e708a6f5deaaf7464ae",22856027,2,3,0,223,82,84,2
"ae5ac430ea254e708a6f5deaaf7464ae","d18a9ea32855445f8736581f5cb119ce",22856027,2,-3,0,224,84,82,-2
"d18a9ea32855445f8736581f5cb119ce","f564483cbd7a407681aa2fcca518cf5f",22856027,1,4,0,227,82,85,3
"f564483cbd7a407681aa2fcca518cf5f","f564483cbd7a407681aa2fcca518cf5f",22856027,8,0,1,228,85,85,0
"f564483cbd7a407681aa2fcca518cf5f","18fd01350bd5434ca636d59a599d768a",22856027,1,1,0,236,85,86,1
"18fd01350bd5434ca636d59a599d768a","18fd01350bd5434ca636d59a599d768a",22856027,9,0,1,237,86,86,0
"18fd01350bd5434ca636d59a599d768a","ae5ac430ea254e708a6f5deaaf7464ae",22856027,1,-2,0,246,86,84,-2
"ae5ac430ea254e708a6f5deaaf7464ae","6a9f0ef185fb47f0937e29daa1c71ed5",22856027,1,7,0,247,84,90,6
"6a9f0ef185fb47f0937e29daa1c71ed5","c681290961c94c4caf23b529d1ae6b9a",22856027,1,-2,0,248,90,88,-2
"c681290961c94c4caf23b529d1ae6b9a","c681290961c94c4caf23b529d1ae6b9a",22856027,1,0,1,249,88,88,0
"c681290961c94c4caf23b529d1ae6b9a","6a9f0ef185fb47f0937e29daa1c71ed5",22856027,1,2,0,250,88,90,2
"6a9f0ef185fb47f0937e29daa1c71ed5","6a9f0ef185fb47f0937e29daa1c71ed5",22856027,3,0,1,251,90,90,0
"6a9f0ef185fb47f0937e29daa1c71ed5","e20db35ced8544ddac5bc3839145e463",22856027,1,3,0,254,90,91,1
"e20db35ced8544ddac5bc3839145e463","d646286c8051419bbc2e31dd1db55ca8",22856027,1,-30,0,255,91,67,-24
"d646286c8051419bbc2e31dd1db55ca8","1febb706d7a34005ae8711ed49c76e64",22856027,1,33,0,256,67,94,27
"1febb706d7a34005ae8711ed49c76e64","1febb706d7a34005ae8711ed49c76e64",22856027,2,0,1,257,94,94,0
"1febb706d7a34005ae8711ed49c76e64","8f73ba6f5a0042f2850356ac38ac6f24",22856027,1,1,0,259,94,95,1
"8f73ba6f5a0042f2850356ac38ac6f24","8f73ba6f5a0042f2850356ac38ac6f24",22856027,5,0,1,260,95,95,0
"8f73ba6f5a0042f2850356ac38ac6f24","e2260b86653c46d7b14a41fb419dbf8c",22856027,1,1,0,265,95,96,1
"e2260b86653c46d7b14a41fb419dbf8c","e2260b86653c46d7b14a41fb419dbf8c",22856027,2,0,1,266,96,96,0
"e2260b86653c46d7b14a41fb419dbf8c","35eb641ad1d845bbba54915bce75a962",22856027,1,1,0,268,96,97,1
"35eb641ad1d845bbba54915bce75a962","35eb641ad1d845bbba54915bce75a962",22856027,5,0,1,269,97,97,0
"35eb641ad1d845bbba54915bce75a962","08be90ffbeea4795a138cd42ed8db56f",22856027,1,1,0,274,97,98,1
"08be90ffbeea4795a138cd42ed8db56f","08be90ffbeea4795a138cd42ed8db56f",22856027,5,0,1,275,98,98,0
"08be90ffbeea4795a138cd42ed8db56f","3007433c8f584dcbb5ac159c1c5f2be3",22856027,1,1,0,280,98,99,1
"3007433c8f584dcbb5ac159c1c5f2be3","3007433c8f584dcbb5ac159c1c5f2be3",22856027,5,0,1,281,99,99,0
"3007433c8f584dcbb5ac159c1c5f2be3","d391c8b6e56a43a7b654e9dee02d904b",22856027,1,5,0,286,99,103,4
"d391c8b6e56a43a7b654e9dee02d904b","00ae5f0c51874a73a41ebea838d95682",22856027,1,-2,0,287,103,101,-2
"00ae5f0c51874a73a41ebea838d95682","e20db35ced8544ddac5bc3839145e463",22856027,1,-11,0,288,101,91,-10
"e20db35ced8544ddac5bc3839145e463","00ae5f0c51874a73a41ebea838d95682",22856027,2,11,0,289,91,101,10
"00ae5f0c51874a73a41ebea838d95682","d391c8b6e56a43a7b654e9dee02d904b",22856027,1,2,0,290,101,103,2
"d391c8b6e56a43a7b654e9dee02d904b","d391c8b6e56a43a7b654e9dee02d904b",22856027,15,0,1,291,103,103,0
"d391c8b6e56a43a7b654e9dee02d904b","6111116566fc4fd9abba409322bea245",22856027,1,1,0,306,103,104,1
"6111116566fc4fd9abba409322bea245","6111116566fc4fd9abba409322bea245",22856027,5,0,1,307,104,104,0
"6111116566fc4fd9abba409322bea245","a81b2235cb9c499eb9ea8ee0a8dd9725",22856027,1,1,0,312,104,105,1
"a81b2235cb9c499eb9ea8ee0a8dd9725","a81b2235cb9c499eb9ea8ee0a8dd9725",22856027,5,0,1,313,105,105,0
"a81b2235cb9c499eb9ea8ee0a8dd9725","2d4e0ab0ef3b4d73b82c72d4621a7579",22856027,1,1,0,318,105,106,1
"2d4e0ab0ef3b4d73b82c72d4621a7579","2d4e0ab0ef3b4d73b82c72d4621a7579",22856027,2,0,1,319,106,106,0
"2d4e0ab0ef3b4d73b82c72d4621a7579","8bdebf492ebd4e62b0d522e8ab5e5197",22856027,1,1,0,321,106,107,1
"8bdebf492ebd4e62b0d522e8ab5e5197","8bdebf492ebd4e62b0d522e8ab5e5197",22856027,2,0,1,322,107,107,0
"8bdebf492ebd4e62b0d522e8ab5e5197","73039f8c1eb9409cb4caee2cf968001e",22856027,1,-7,0,324,107,100,-7
"73039f8c1eb9409cb4caee2cf968001e","4280927ec4d643238aa49c32f9e06c6c",22856027,1,10,0,325,100,109,9
"4280927ec4d643238aa49c32f9e06c6c","4280927ec4d643238aa49c32f9e06c6c",22856027,1,0,1,326,109,109,0
"4280927ec4d643238aa49c32f9e06c6c","fc44e6a5f7654430af1227838224dceb",22856027,1,2,0,327,109,111,2
"fc44e6a5f7654430af1227838224dceb","fc44e6a5f7654430af1227838224dceb",22856027,4,0,1,328,111,111,0
"fc44e6a5f7654430af1227838224dceb","08111f75e22d409998cf8b85bd431f0a",22856027,2,-3,0,330,111,108,-3
"08111f75e22d409998cf8b85bd431f0a","a9ae0a3c070d455bb4369a8996313336",22856027,2,7,0,331,108,114,6
"a9ae0a3c070d455bb4369a8996313336","a9ae0a3c070d455bb4369a8996313336",22856027,1,0,1,332,114,114,0
"a9ae0a3c070d455bb4369a8996313336","e20db35ced8544ddac5bc3839145e463",22856027,1,-26,0,333,114,91,-23
"e20db35ced8544ddac5bc3839145e463","e20db35ced8544ddac5bc3839145e463",22856027,1,0,1,334,91,91,0
"00ae5f0c51874a73a41ebea838d95682","4280927ec4d643238aa49c32f9e06c6c",22856027,1,9,0,336,101,109,8
"4280927ec4d643238aa49c32f9e06c6c","73039f8c1eb9409cb4caee2cf968001e",22856027,1,-10,0,337,109,100,-9
"73039f8c1eb9409cb4caee2cf968001e","d391c8b6e56a43a7b654e9dee02d904b",22856027,1,3,0,338,100,103,3
"d391c8b6e56a43a7b654e9dee02d904b","fc44e6a5f7654430af1227838224dceb",22856027,1,9,0,339,103,111,8
"a9ae0a3c070d455bb4369a8996313336","71cec822bcff4f30a20e75dc63ef7b65",22856027,1,2,0,344,114,116,2
"71cec822bcff4f30a20e75dc63ef7b65","71cec822bcff4f30a20e75dc63ef7b65",22856027,1,0,1,345,116,116,0
"71cec822bcff4f30a20e75dc63ef7b65","62bff51286ef4f348717a3cf6fe2318f",22856027,1,5,0,346,116,120,4
"62bff51286ef4f348717a3cf6fe2318f","37319e88176d4aefa91d7a9980dbae91",22856027,1,-9,0,347,120,112,-8
"37319e88176d4aefa91d7a9980dbae91","b1cd0e7dc3ad4a8eb91a4bfdbeb025b0",22856027,1,7,0,348,112,118,6
"b1cd0e7dc3ad4a8eb91a4bfdbeb025b0","b1cd0e7dc3ad4a8eb91a4bfdbeb025b0",22856027,1,0,1,349,118,118,0
"b1cd0e7dc3ad4a8eb91a4bfdbeb025b0","62bff51286ef4f348717a3cf6fe2318f",22856027,1,2,0,350,118,120,2
"62bff51286ef4f348717a3cf6fe2318f","62bff51286ef4f348717a3cf6fe2318f",22856027,3,0,1,351,120,120,0
"62bff51286ef4f348717a3cf6fe2318f","e20db35ced8544ddac5bc3839145e463",22856027,1,-33,0,354,120,91,-29
"e20db35ced8544ddac5bc3839145e463","779f9ddd1fd14d1e9e69f72219a1fdbd",22856027,1,36,0,355,91,121,30
"779f9ddd1fd14d1e9e69f72219a1fdbd","ae26e6cda8ad4a3f81bd347560d9579f",22856027,1,4,0,356,121,125,4
"ae26e6cda8ad4a3f81bd347560d9579f","ae26e6cda8ad4a3f81bd347560d9579f",22856027,1,0,1,357,125,125,0
"ae26e6cda8ad4a3f81bd347560d9579f","ee48df95832b4374aa273ceb27ec1315",22856027,1,1,0,358,125,126,1
"ee48df95832b4374aa273ceb27ec1315","ee48df95832b4374aa273ceb27ec1315",22856027,1,0,1,359,126,126,0
"ee48df95832b4374aa273ceb27ec1315","7a439da90b394756ad1777fc4c6dead5",22856027,1,1,0,360,126,127,1
"7a439da90b394756ad1777fc4c6dead5","7a439da90b394756ad1777fc4c6dead5",22856027,1,0,1,361,127,127,0
"7a439da90b394756ad1777fc4c6dead5","779f9ddd1fd14d1e9e69f72219a1fdbd",22856027,1,-6,0,362,127,121,-6
"779f9ddd1fd14d1e9e69f72219a1fdbd","a8dd5213034441ac92724b4e83eb0bb2",22856027,1,9,0,363,121,129,8
"a8dd5213034441ac92724b4e83eb0bb2","a8dd5213034441ac92724b4e83eb0bb2",22856027,1,0,1,364,129,129,0
"a8dd5213034441ac92724b4e83eb0bb2","8115eab6556b45f5b415c3b8c26a12e5",22856027,1,2,0,365,129,131,2
"8115eab6556b45f5b415c3b8c26a12e5","8115eab6556b45f5b415c3b8c26a12e5",22856027,2,0,1,366,131,131,0
"8115eab6556b45f5b415c3b8c26a12e5","ec34b06efd844b46a4c4818ecdb9b8f4",22856027,1,1,0,368,131,132,1
"ec34b06efd844b46a4c4818ecdb9b8f4","ec34b06efd844b46a4c4818ecdb9b8f4",22856027,2,0,1,369,132,132,0
"ec34b06efd844b46a4c4818ecdb9b8f4","c2e1c2b9eac64109b343a088584b576b",22856027,1,1,0,371,132,133,1
"c2e1c2b9eac64109b343a088584b576b","c2e1c2b9eac64109b343a088584b576b",22856027,2,0,1,372,133,133,0
"c2e1c2b9eac64109b343a088584b576b","579338175e0b4bbb8ef3b712b5d8b54e",22856027,1,-5,0,374,133,128,-5
"579338175e0b4bbb8ef3b712b5d8b54e","8bc5795d6a984a3eace4e2811e52dd4f",22856027,1,8,0,375,128,135,7
"8bc5795d6a984a3eace4e2811e52dd4f","8bc5795d6a984a3eace4e2811e52dd4f",22856027,3,0,1,376,135,135,0
"8bc5795d6a984a3eace4e2811e52dd4f","b416d47c56a742199b5d7c7f19d6503a",22856027,1,-1,0,379,135,134,-1
"b416d47c56a742199b5d7c7f19d6503a","cd4532ad48034873ba8bce2aac0c9808",22856027,1,4,0,380,134,137,3
"cd4532ad48034873ba8bce2aac0c9808","cd4532ad48034873ba8bce2aac0c9808",22856027,1,0,1,381,137,137,0
"cd4532ad48034873ba8bce2aac0c9808","779f9ddd1fd14d1e9e69f72219a1fdbd",22856027,1,-19,0,382,137,121,-16
"779f9ddd1fd14d1e9e69f72219a1fdbd","df1de691dafe4549a18a4398ee9dfaf9",22856027,1,23,0,383,121,139,18
"df1de691dafe4549a18a4398ee9dfaf9","6c5ad271a44743479bfaea29b1db8d02",22856027,1,4,0,384,139,143,4
"6c5ad271a44743479bfaea29b1db8d02","6c5ad271a44743479bfaea29b1db8d02",22856027,2,0,1,385,143,143,0
"6c5ad271a44743479bfaea29b1db8d02","83d311bed5374fee83d8d67a7d9d82dc",22856027,1,1,0,387,143,144,1
"83d311bed5374fee83d8d67a7d9d82dc","83d311bed5374fee83d8d67a7d9d82dc",22856027,1,0,1,388,144,144,0
"83d311bed5374fee83d8d67a7d9d82dc","402bba41861d43acb52a5abb89e8831e",22856027,1,1,0,389,144,145,1
"402bba41861d43acb52a5abb89e8831e","402bba41861d43acb52a5abb89e8831e",22856027,5,0,1,390,145,145,0
"402bba41861d43acb52a5abb89e8831e","df1de691dafe4549a18a4398ee9dfaf9",22856027,1,-6,0,395,145,139,-6
"df1de691dafe4549a18a4398ee9dfaf9","8aae34f5ddbb4052a709b12e6b0d40fa",22856027,1,9,0,396,139,147,8
"8aae34f5ddbb4052a709b12e6b0d40fa","645b3f0249f64f76af2e19eb4d0e55b7",22856027,1,2,0,397,147,149,2
"645b3f0249f64f76af2e19eb4d0e55b7","645b3f0249f64f76af2e19eb4d0e55b7",22856027,2,0,1,398,149,149,0
"645b3f0249f64f76af2e19eb4d0e55b7","7e7b8db5064d4369805ab370aac5ddfb",22856027,1,1,0,400,149,150,1
"7e7b8db5064d4369805ab370aac5ddfb","7e7b8db5064d4369805ab370aac5ddfb",22856027,2,0,1,401,150,150,0
"7e7b8db5064d4369805ab370aac5ddfb","8956d210ae7f41968fada86d4c979d6a",22856027,1,1,0,403,150,151,1
"8956d210ae7f41968fada86d4c979d6a","8956d210ae7f41968fada86d4c979d6a",22856027,2,0,1,404,151,151,0
"8956d210ae7f41968fada86d4c979d6a","f902b0f41b544d4dbf79664fd233648d",22856027,1,-5,0,406,151,146,-5
"f902b0f41b544d4dbf79664fd233648d","ae781e8b775e4ccd93bc800dad5c8376",22856027,1,8,0,407,146,153,7
"ae781e8b775e4ccd93bc800dad5c8376","ae781e8b775e4ccd93bc800dad5c8376",22856027,5,0,1,408,153,153,0
"ae781e8b775e4ccd93bc800dad5c8376","06882a8492d9499aa31555567f575ecb",22856027,1,1,0,413,153,154,1
"06882a8492d9499aa31555567f575ecb","06882a8492d9499aa31555567f575ecb",22856027,1,0,1,414,154,154,0
"06882a8492d9499aa31555567f575ecb","f293c508f409466a8f27ddd7d1e40b20",22856027,1,1,0,415,154,155,1
"f293c508f409466a8f27ddd7d1e40b20","f293c508f409466a8f27ddd7d1e40b20",22856027,8,0,1,416,155,155,0
"f293c508f409466a8f27ddd7d1e40b20","cc4ddef5bbbe48ebb605141b347c4ed1",22856027,1,1,0,424,155,156,1
"cc4ddef5bbbe48ebb605141b347c4ed1","cc4ddef5bbbe48ebb605141b347c4ed1",22856027,3,0,1,425,156,156,0
"cc4ddef5bbbe48ebb605141b347c4ed1","d313cec988a84645bee413e8d4724a4b",22856027,1,3,0,428,156,158,2
"d313cec988a84645bee413e8d4724a4b","f03480cf4eba413194d7af52fc0e7f28",22856027,1,-7,0,429,158,152,-6
"f03480cf4eba413194d7af52fc0e7f28","d313cec988a84645bee413e8d4724a4b",22856027,1,7,0,430,152,158,6
"d313cec988a84645bee413e8d4724a4b","d313cec988a84645bee413e8d4724a4b",22856027,3,0,1,431,158,158,0
"d313cec988a84645bee413e8d4724a4b","dc60696c76a74368a60f72246e47700d",22856027,1,1,0,434,158,159,1
"dc60696c76a74368a60f72246e47700d","dc60696c76a74368a60f72246e47700d",22856027,1,0,1,435,159,159,0
"dc60696c76a74368a60f72246e47700d","78adeee1fa2c4fe0bc73f7bca9fcee86",22856027,1,3,0,436,159,160,1
"78adeee1fa2c4fe0bc73f7bca9fcee86","df1de691dafe4549a18a4398ee9dfaf9",22856027,1,-26,0,437,160,139,-21
"df1de691dafe4549a18a4398ee9dfaf9","78adeee1fa2c4fe0bc73f7bca9fcee86",22856027,1,26,0,438,139,160,21
"78adeee1fa2c4fe0bc73f7bca9fcee86","65202579580f4ad38d734b4ee39d22a8",22856027,3,5,0,439,160,164,4
"65202579580f4ad38d734b4ee39d22a8","65202579580f4ad38d734b4ee39d22a8",22856027,58,0,1,440,164,164,0
"65202579580f4ad38d734b4ee39d22a8","78adeee1fa2c4fe0bc73f7bca9fcee86",22856027,3,-5,0,447,164,160,-4
"78adeee1fa2c4fe0bc73f7bca9fcee86","3cbcea2be0984e7dbd5a48195af10ce7",22856027,1,8,0,503,160,165,5
"3cbcea2be0984e7dbd5a48195af10ce7","82e6285962b8400d9d6fc32436022a94",22856027,5,2,0,504,165,167,2
"82e6285962b8400d9d6fc32436022a94","3cbcea2be0984e7dbd5a48195af10ce7",22856027,4,-2,0,505,167,165,-2
"3cbcea2be0984e7dbd5a48195af10ce7","3cbcea2be0984e7dbd5a48195af10ce7",22856027,1,0,1,508,165,165,0
"3cbcea2be0984e7dbd5a48195af10ce7","a9ac840f098c4bd0a2ee896214ce29cd",22856027,1,5,0,513,165,168,3
"a9ac840f098c4bd0a2ee896214ce29cd","0c7262dff33c4087bc660ccf40f92f9c",22856027,1,4,0,514,168,169,1
"0c7262dff33c4087bc660ccf40f92f9c","a9ac840f098c4bd0a2ee896214ce29cd",22856027,1,-4,0,515,169,168,-1
"a9ac840f098c4bd0a2ee896214ce29cd","b2275c3fad834f8d90737a2d9a6927d6",22856027,1,7,0,516,168,172,4
"b2275c3fad834f8d90737a2d9a6927d6","b2275c3fad834f8d90737a2d9a6927d6",22856027,32,0,1,517,172,172,0
"b2275c3fad834f8d90737a2d9a6927d6","eb515a26030b41f8a82a1e6114420bad",22856027,1,1,0,549,172,173,1
"eb515a26030b41f8a82a1e6114420bad","eb515a26030b41f8a82a1e6114420bad",22856027,8,0,1,550,173,173,0
"eb515a26030b41f8a82a1e6114420bad","b42cc17b7de840f181a704558d0bc845",22856027,1,3,0,558,173,175,2
"b42cc17b7de840f181a704558d0bc845","0c7262dff33c4087bc660ccf40f92f9c",22856027,1,-7,0,559,175,169,-6
"0c7262dff33c4087bc660ccf40f92f9c","b42cc17b7de840f181a704558d0bc845",22856027,1,7,0,560,169,175,6
"b42cc17b7de840f181a704558d0bc845","801f9e9135034f49bf5f8b4bdefedb41",22856027,1,2,0,561,175,177,2
"801f9e9135034f49bf5f8b4bdefedb41","801f9e9135034f49bf5f8b4bdefedb41",22856027,7,0,1,562,177,177,0
"801f9e9135034f49bf5f8b4bdefedb41","ea38cc0e6e6e41edbabf210220808bf9",22856027,1,3,0,569,177,179,2
"ea38cc0e6e6e41edbabf210220808bf9","362fcb0699a14845ab29b2340093e528",22856027,1,-6,0,570,179,174,-5
"362fcb0699a14845ab29b2340093e528","b87c552dd247427abe6ab5795b9c9d43",22856027,1,8,0,571,174,181,7
"b87c552dd247427abe6ab5795b9c9d43","ea38cc0e6e6e41edbabf210220808bf9",22856027,1,-2,0,572,181,179,-2
"ea38cc0e6e6e41edbabf210220808bf9","b87c552dd247427abe6ab5795b9c9d43",22856027,1,2,0,573,179,181,2
"b87c552dd247427abe6ab5795b9c9d43","b87c552dd247427abe6ab5795b9c9d43",22856027,9,0,1,574,181,181,0
"b87c552dd247427abe6ab5795b9c9d43","139b097acfca451689d80c9c6eebdf7b",22856027,1,-3,0,583,181,178,-3
"139b097acfca451689d80c9c6eebdf7b","30f660a1feb34582a739722532524f79",22856027,1,6,0,584,178,183,5
"30f660a1feb34582a739722532524f79","30f660a1feb34582a739722532524f79",22856027,4,0,1,585,183,183,0
"30f660a1feb34582a739722532524f79","2024b4885bd14338a39b7b509acbbd02",22856027,1,-1,0,589,183,182,-1
"2024b4885bd14338a39b7b509acbbd02","c3f63fe50d8e487c86bf8ef76c9cadd3",22856027,1,4,0,590,182,185,3
"c3f63fe50d8e487c86bf8ef76c9cadd3","c3f63fe50d8e487c86bf8ef76c9cadd3",22856027,1,0,1,591,185,185,0
"c3f63fe50d8e487c86bf8ef76c9cadd3","0c7262dff33c4087bc660ccf40f92f9c",22856027,1,-20,0,592,185,169,-16
"0c7262dff33c4087bc660ccf40f92f9c","c8e371568a0c4391b25796ae4e91952e",22856027,1,23,0,593,169,186,17
"c8e371568a0c4391b25796ae4e91952e","7d932b23e1c84326ae5aa4d3c0d813d1",22856027,1,2,0,594,186,188,2
"7d932b23e1c84326ae5aa4d3c0d813d1","7d932b23e1c84326ae5aa4d3c0d813d1",22856027,1,0,1,595,188,188,0
"7d932b23e1c84326ae5aa4d3c0d813d1","c8e371568a0c4391b25796ae4e91952e",22856027,1,-2,0,596,188,186,-2
"c8e371568a0c4391b25796ae4e91952e","ab11d94c6c8948ea90b88f19d2cd502b",22856027,1,5,0,597,186,190,4
"ab11d94c6c8948ea90b88f19d2cd502b","ab11d94c6c8948ea90b88f19d2cd502b",22856027,2,0,1,598,190,190,0
"ab11d94c6c8948ea90b88f19d2cd502b","f992451ed6ad4e68bb9e68ad6be7c4be",22856027,1,2,0,600,190,192,2
"f992451ed6ad4e68bb9e68ad6be7c4be","f992451ed6ad4e68bb9e68ad6be7c4be",22856027,1,0,1,601,192,192,0
"f992451ed6ad4e68bb9e68ad6be7c4be","07b44a7a51e94c78b411c753fc39dab0",22856027,1,-3,0,602,192,189,-3
"07b44a7a51e94c78b411c753fc39dab0","6cd2dcaac46847d4a0bc53f296d90375",22856027,1,6,0,603,189,194,5
"6cd2dcaac46847d4a0bc53f296d90375","6cd2dcaac46847d4a0bc53f296d90375",22856027,1,0,1,604,194,194,0
"6cd2dcaac46847d4a0bc53f296d90375","2d2580c9411c4972909db508d6956a58",22856027,1,2,0,605,194,196,2
"2d2580c9411c4972909db508d6956a58","2d2580c9411c4972909db508d6956a58",22856027,8,0,1,606,196,196,0
"2d2580c9411c4972909db508d6956a58","5bddb3d9ed264f3984702f048c7e5340",22856027,1,1,0,614,196,197,1
"5bddb3d9ed264f3984702f048c7e5340","5bddb3d9ed264f3984702f048c7e5340",22856027,2,0,1,615,197,197,0
"5bddb3d9ed264f3984702f048c7e5340","d5e8e2bd12a2466b9d6d90855f0eb079",22856027,1,1,0,617,197,198,1
"d5e8e2bd12a2466b9d6d90855f0eb079","d5e8e2bd12a2466b9d6d90855f0eb079",22856027,2,0,1,618,198,198,0
"d5e8e2bd12a2466b9d6d90855f0eb079","017d7ca8e0394b91aaadc9574df2202c",22856027,1,-5,0,620,198,193,-5
"017d7ca8e0394b91aaadc9574df2202c","54e8e9f0ea3e45c4bf3b8ac799ee31b1",22856027,1,8,0,621,193,200,7
"54e8e9f0ea3e45c4bf3b8ac799ee31b1","54e8e9f0ea3e45c4bf3b8ac799ee31b1",22856027,1,0,1,622,200,200,0
"54e8e9f0ea3e45c4bf3b8ac799ee31b1","c614a00911be4877a075f19315530fb0",22856027,1,1,0,623,200,201,1
"c614a00911be4877a075f19315530fb0","c614a00911be4877a075f19315530fb0",22856027,6,0,1,624,201,201,0
"c614a00911be4877a075f19315530fb0","a6c21bd8b95249c7972820a7a7d76aff",22856027,1,1,0,630,201,202,1
"a6c21bd8b95249c7972820a7a7d76aff","a6c21bd8b95249c7972820a7a7d76aff",22856027,1,0,1,631,202,202,0
"a6c21bd8b95249c7972820a7a7d76aff","bb329d880ab54120adaf203a693bb203",22856027,1,1,0,632,202,203,1
"bb329d880ab54120adaf203a693bb203","bb329d880ab54120adaf203a693bb203",22856027,1,0,1,633,203,203,0
"bb329d880ab54120adaf203a693bb203","f9170dd6bc6442b4acd832747609b09a",22856027,1,-4,0,634,203,199,-4
"f9170dd6bc6442b4acd832747609b09a","334c2344009840079b1d0e1b7ce3d5a7",22856027,1,7,0,635,199,205,6
"334c2344009840079b1d0e1b7ce3d5a7","334c2344009840079b1d0e1b7ce3d5a7",22856027,1,0,1,636,205,205,0
"334c2344009840079b1d0e1b7ce3d5a7","d7f13c8d63ec4e2aa673fbb9cf9c6933",22856027,1,3,0,637,205,206,1
"d7f13c8d63ec4e2aa673fbb9cf9c6933","c8e371568a0c4391b25796ae4e91952e",22856027,1,-26,0,638,206,186,-20
"c8e371568a0c4391b25796ae4e91952e","b9e80f77c3a44349863b19875725c384",22856027,1,27,0,639,186,207,21
"b9e80f77c3a44349863b19875725c384","7108f0e4c2584f1f9c471689ae4c885c",22856027,2,1,0,640,207,208,1
"7108f0e4c2584f1f9c471689ae4c885c","b9e80f77c3a44349863b19875725c384",22856027,2,-1,0,641,208,207,-1
"b9e80f77c3a44349863b19875725c384","b9e80f77c3a44349863b19875725c384",22856027,17,0,1,642,207,207,0
"7108f0e4c2584f1f9c471689ae4c885c","7108f0e4c2584f1f9c471689ae4c885c",22856027,15,0,1,660,208,208,0
"7108f0e4c2584f1f9c471689ae4c885c","d7f13c8d63ec4e2aa673fbb9cf9c6933",22856027,1,-2,0,675,208,206,-2
"d7f13c8d63ec4e2aa673fbb9cf9c6933","09400e101c5d4b439cf9a26b03aae558",22856027,1,5,0,676,206,210,4
"09400e101c5d4b439cf9a26b03aae558","09400e101c5d4b439cf9a26b03aae558",22856027,1,0,1,677,210,210,0
"09400e101c5d4b439cf9a26b03aae558","a88efa7e50ce47159810ab553afa6d3a",22856027,1,2,0,678,210,212,2
"a88efa7e50ce47159810ab553afa6d3a","a88efa7e50ce47159810ab553afa6d3a",22856027,11,0,1,679,212,212,0
"a88efa7e50ce47159810ab553afa6d3a","a875096404ef4a9984b62d74cda916f9",22856027,1,-3,0,690,212,209,-3
"a875096404ef4a9984b62d74cda916f9","be502a7a43c44bf7b682698de79d9369",22856027,2,6,0,691,209,214,5
"be502a7a43c44bf7b682698de79d9369","f7fb1952f56b4189b86a9f8b7862d2b8",22856027,3,1,0,692,214,215,1
"f7fb1952f56b4189b86a9f8b7862d2b8","be502a7a43c44bf7b682698de79d9369",22856027,1,-1,0,693,215,214,-1
"be502a7a43c44bf7b682698de79d9369","be502a7a43c44bf7b682698de79d9369",22856027,1,0,1,694,214,214,0
"f7fb1952f56b4189b86a9f8b7862d2b8","f7fb1952f56b4189b86a9f8b7862d2b8",22856027,20,0,1,696,215,215,0
"f7fb1952f56b4189b86a9f8b7862d2b8","b860ee85d8bc4a2f97958cfb71be3533",22856027,1,1,0,716,215,216,1
"b860ee85d8bc4a2f97958cfb71be3533","b860ee85d8bc4a2f97958cfb71be3533",22856027,11,0,1,717,216,216,0
"b860ee85d8bc4a2f97958cfb71be3533","ec341f459285443b8361f7f15638ff08",22856027,1,-3,0,728,216,213,-3
"ec341f459285443b8361f7f15638ff08","363837c182e04711840d896ae1e0339c",22856027,1,6,0,729,213,218,5
"363837c182e04711840d896ae1e0339c","363837c182e04711840d896ae1e0339c",22856027,18,0,1,730,218,218,0
"363837c182e04711840d896ae1e0339c","01b2051f8941460d89945e3b02d1ce78",22856027,1,-1,0,748,218,217,-1
"01b2051f8941460d89945e3b02d1ce78","91125ca626c5470eb145501f8c37f8db",22856027,1,4,0,749,217,220,3
"91125ca626c5470eb145501f8c37f8db","91125ca626c5470eb145501f8c37f8db",22856027,1,0,1,750,220,220,0
"91125ca626c5470eb145501f8c37f8db","1c6721b1f63f4d30ba7746ea8af02a52",22856027,1,3,0,751,220,221,1
"1c6721b1f63f4d30ba7746ea8af02a52","d7f13c8d63ec4e2aa673fbb9cf9c6933",22856027,2,-21,0,752,221,206,-15
"d7f13c8d63ec4e2aa673fbb9cf9c6933","77ecef8eff6b4a2caea7707669bf7475",22856027,2,22,0,753,206,222,16
"77ecef8eff6b4a2caea7707669bf7475","77ecef8eff6b4a2caea7707669bf7475",22856027,16,0,1,754,222,222,0
"77ecef8eff6b4a2caea7707669bf7475","1c6721b1f63f4d30ba7746ea8af02a52",22856027,2,-1,0,770,222,221,-1
"1c6721b1f63f4d30ba7746ea8af02a52","d03cb855c70044cf8c35d9ec0de696e3",22856027,1,4,0,771,221,224,3
"d03cb855c70044cf8c35d9ec0de696e3","8b9ae98743bd4d4a8a87dff1c1244211",22856027,1,3,0,772,224,227,3
"8b9ae98743bd4d4a8a87dff1c1244211","d03cb855c70044cf8c35d9ec0de696e3",22856027,2,-3,0,773,227,224,-3
"d03cb855c70044cf8c35d9ec0de696e3","a49a937d6896486d9a5396654abcf2e1",22856027,1,2,0,774,224,226,2
"a49a937d6896486d9a5396654abcf2e1","a49a937d6896486d9a5396654abcf2e1",22856027,1,0,1,775,226,226,0
"a49a937d6896486d9a5396654abcf2e1","8b9ae98743bd4d4a8a87dff1c1244211",22856027,1,1,0,776,226,227,1
"8b9ae98743bd4d4a8a87dff1c1244211","8b9ae98743bd4d4a8a87dff1c1244211",22856027,18,0,1,777,227,227,0
"8b9ae98743bd4d4a8a87dff1c1244211","d7f13c8d63ec4e2aa673fbb9cf9c6933",22856027,1,-28,0,795,227,206,-21
"d7f13c8d63ec4e2aa673fbb9cf9c6933","7108f0e4c2584f1f9c471689ae4c885c",22856027,1,2,0,796,206,208,2
"b9e80f77c3a44349863b19875725c384","09400e101c5d4b439cf9a26b03aae558",22856027,1,4,0,798,207,210,3
"09400e101c5d4b439cf9a26b03aae558","d7f13c8d63ec4e2aa673fbb9cf9c6933",22856027,1,-5,0,799,210,206,-4
"d7f13c8d63ec4e2aa673fbb9cf9c6933","a875096404ef4a9984b62d74cda916f9",22856027,1,4,0,800,206,209,3
"f7fb1952f56b4189b86a9f8b7862d2b8","363837c182e04711840d896ae1e0339c",22856027,1,4,0,803,215,218,3
"363837c182e04711840d896ae1e0339c","ec341f459285443b8361f7f15638ff08",22856027,1,-6,0,804,218,213,-5
"ec341f459285443b8361f7f15638ff08","01b2051f8941460d89945e3b02d1ce78",22856027,1,5,0,805,213,217,4
"01b2051f8941460d89945e3b02d1ce78","1c6721b1f63f4d30ba7746ea8af02a52",22856027,1,7,0,806,217,221,4
"1c6721b1f63f4d30ba7746ea8af02a52","8b9ae98743bd4d4a8a87dff1c1244211",22856027,1,7,0,810,221,227,6
"d03cb855c70044cf8c35d9ec0de696e3","f7906d6f59b9489a91d2ef40db5a474d",22856027,1,-1,0,812,224,223,-1
"f7906d6f59b9489a91d2ef40db5a474d","2ab1535aac1346ba8801535bf729ef37",22856027,1,7,0,813,223,229,6
"2ab1535aac1346ba8801535bf729ef37","a4f40fb48a8542c8949bae1f002cd9bc",22856027,1,2,0,814,229,231,2
"a4f40fb48a8542c8949bae1f002cd9bc","a4f40fb48a8542c8949bae1f002cd9bc",22856027,5,0,1,815,231,231,0
"a4f40fb48a8542c8949bae1f002cd9bc","8972c23e32044edb8a78fa1eed4e5947",22856027,1,1,0,820,231,232,1
"8972c23e32044edb8a78fa1eed4e5947","8972c23e32044edb8a78fa1eed4e5947",22856027,5,0,1,821,232,232,0
"8972c23e32044edb8a78fa1eed4e5947","92feb4a40f8344d38b6f722e42a53295",22856027,1,1,0,826,232,233,1
"92feb4a40f8344d38b6f722e42a53295","92feb4a40f8344d38b6f722e42a53295",22856027,2,0,1,827,233,233,0
"92feb4a40f8344d38b6f722e42a53295","5152833676bf4c6cb317060be10f68db",22856027,1,-5,0,829,233,228,-5
"5152833676bf4c6cb317060be10f68db","ca3e28f290354c08aefe5b0f769604e6",22856027,1,8,0,830,228,235,7
"ca3e28f290354c08aefe5b0f769604e6","ca3e28f290354c08aefe5b0f769604e6",22856027,9,0,1,831,235,235,0
"ca3e28f290354c08aefe5b0f769604e6","79a35eea833e4c2c9d22fc53c3c6445c",22856027,1,1,0,840,235,236,1
"79a35eea833e4c2c9d22fc53c3c6445c","79a35eea833e4c2c9d22fc53c3c6445c",22856027,4,0,1,841,236,236,0
"79a35eea833e4c2c9d22fc53c3c6445c","8f68228b1518449e9615cdafee41a2bd",22856027,1,1,0,845,236,237,1
"8f68228b1518449e9615cdafee41a2bd","8f68228b1518449e9615cdafee41a2bd",22856027,1,0,1,846,237,237,0
"8f68228b1518449e9615cdafee41a2bd","cab89fa5c3ed45a5aa550fc0352d6a42",22856027,1,1,0,847,237,238,1
"cab89fa5c3ed45a5aa550fc0352d6a42","cab89fa5c3ed45a5aa550fc0352d6a42",22856027,3,0,1,848,238,238,0
"cab89fa5c3ed45a5aa550fc0352d6a42","66d4fad4f1cf4b46be0750a99ad7a35a",22856027,1,1,0,851,238,239,1
"66d4fad4f1cf4b46be0750a99ad7a35a","66d4fad4f1cf4b46be0750a99ad7a35a",22856027,1,0,1,852,239,239,0
"66d4fad4f1cf4b46be0750a99ad7a35a","0b04c8e2f86d48c7aeb7e225819cd32b",22856027,1,-5,0,853,239,234,-5
"0b04c8e2f86d48c7aeb7e225819cd32b","f53da5fd9bfe412da4b80d4742563b6c",22856027,1,8,0,854,234,241,7
"f53da5fd9bfe412da4b80d4742563b6c","f53da5fd9bfe412da4b80d4742563b6c",22856027,1,0,1,855,241,241,0
"f53da5fd9bfe412da4b80d4742563b6c","1c6721b1f63f4d30ba7746ea8af02a52",22856027,1,-24,0,856,241,221,-20
"1c6721b1f63f4d30ba7746ea8af02a52","2ae94c0cea4d480a9d5dca8fb1d7b542",22856027,1,27,0,857,221,242,21
"2ae94c0cea4d480a9d5dca8fb1d7b542","1ebf23f9d994469a85206e4c7b1bf5f5",22856027,1,3,0,858,242,245,3
"1ebf23f9d994469a85206e4c7b1bf5f5","1ebf23f9d994469a85206e4c7b1bf5f5",22856027,12,0,1,859,245,245,0
"1ebf23f9d994469a85206e4c7b1bf5f5","85ae675b83e8422da842cfd25596af99",22856027,1,1,0,871,245,246,1
"85ae675b83e8422da842cfd25596af99","85ae675b83e8422da842cfd25596af99",22856027,1,0,1,872,246,246,0
"85ae675b83e8422da842cfd25596af99","fa235f0f364d47e4ae1c87f47bf8e6ba",22856027,1,8,0,873,246,252,6
"fa235f0f364d47e4ae1c87f47bf8e6ba","2ae94c0cea4d480a9d5dca8fb1d7b542",22856027,1,-12,0,874,252,242,-10
"2ae94c0cea4d480a9d5dca8fb1d7b542","fa235f0f364d47e4ae1c87f47bf8e6ba",22856027,1,12,0,875,242,252,10
"fa235f0f364d47e4ae1c87f47bf8e6ba","79f7845465cc4ed19d8e4f1429541be0",22856027,1,2,0,876,252,254,2
"79f7845465cc4ed19d8e4f1429541be0","79f7845465cc4ed19d8e4f1429541be0",22856027,2,0,1,877,254,254,0
"79f7845465cc4ed19d8e4f1429541be0","00f61990949545828dd12f1303d47504",22856027,1,3,0,879,254,256,2
"00f61990949545828dd12f1303d47504","6e83e23f56544a19b94067c1c558d9c0",22856027,1,-11,0,880,256,247,-9
"6e83e23f56544a19b94067c1c558d9c0","00f61990949545828dd12f1303d47504",22856027,1,11,0,881,247,256,9
"00f61990949545828dd12f1303d47504","ead7bb4b64e247d2ae632ab8a296b091",22856027,1,2,0,882,256,258,2
"ead7bb4b64e247d2ae632ab8a296b091","ead7bb4b64e247d2ae632ab8a296b091",22856027,2,0,1,883,258,258,0
"ead7bb4b64e247d2ae632ab8a296b091","41b0048dde734bb280bac6116baa8e27",22856027,1,1,0,885,258,259,1
"41b0048dde734bb280bac6116baa8e27","41b0048dde734bb280bac6116baa8e27",22856027,8,0,1,886,259,259,0
"41b0048dde734bb280bac6116baa8e27","b41c5a094a604ee0915327da5cc0beb7",22856027,1,1,0,894,259,260,1
"b41c5a094a604ee0915327da5cc0beb7","b41c5a094a604ee0915327da5cc0beb7",22856027,2,0,1,895,260,260,0
"b41c5a094a604ee0915327da5cc0beb7","d546341988904f069cfa86b21457d9d9",22856027,1,-10,0,897,260,251,-9
"d546341988904f069cfa86b21457d9d9","28c171777c52431ab6b925073bd63d46",22856027,1,15,0,898,251,264,13
"28c171777c52431ab6b925073bd63d46","28c171777c52431ab6b925073bd63d46",22856027,7,0,1,899,264,264,0
"28c171777c52431ab6b925073bd63d46","ac160db940cb49ae8579162b1d52bb5d",22856027,1,2,0,906,264,266,2
"ac160db940cb49ae8579162b1d52bb5d","ac160db940cb49ae8579162b1d52bb5d",22856027,11,0,1,907,266,266,0
"ac160db940cb49ae8579162b1d52bb5d","d989ebcfc12a4b669f0100dc1aa14f1e",22856027,1,-12,0,918,266,255,-11
"d989ebcfc12a4b669f0100dc1aa14f1e","c6fd49b485cc4874b0bbdd9c6171e09c",22856027,1,15,0,919,255,268,13
"c6fd49b485cc4874b0bbdd9c6171e09c","c6fd49b485cc4874b0bbdd9c6171e09c",22856027,7,0,1,920,268,268,0
"c6fd49b485cc4874b0bbdd9c6171e09c","44240778a97c4af0937817499b75707b",22856027,1,1,0,927,268,269,1
"44240778a97c4af0937817499b75707b","44240778a97c4af0937817499b75707b",22856027,2,0,1,928,269,269,0
"44240778a97c4af0937817499b75707b","7aa76d3e993840d8805f097cbdbcd44b",22856027,1,-9,0,930,269,261,-8
"7aa76d3e993840d8805f097cbdbcd44b","865a4d3b43374da7944dc7d397f566d9",22856027,1,12,0,931,261,271,10
"865a4d3b43374da7944dc7d397f566d9","865a4d3b43374da7944dc7d397f566d9",22856027,1,0,1,932,271,271,0
"865a4d3b43374da7944dc7d397f566d9","2ae94c0cea4d480a9d5dca8fb1d7b542",22856027,1,-35,0,933,271,242,-29
"2ae94c0cea4d480a9d5dca8fb1d7b542","0d987bed3ffa4ed0b9a2e62e97b7b30f",22856027,1,38,0,934,242,272,30
"0d987bed3ffa4ed0b9a2e62e97b7b30f","0d987bed3ffa4ed0b9a2e62e97b7b30f",22856027,1,0,1,935,272,272,0
"bb5a47f5ea01454a8b79455422d3b9da","82ae07bc0c9b4570a41799290d1ef399",22856027,3,-6,0,942,280,275,-5
"82ae07bc0c9b4570a41799290d1ef399","bb5a47f5ea01454a8b79455422d3b9da",22856027,3,6,0,943,275,280,5
"bc5524e78a8544e2ae2fdc2f3462bbec","3cbcea2be0984e7dbd5a48195af10ce7",22856027,1,-153,0,956,279,165,-114
"82e6285962b8400d9d6fc32436022a94","94cecc3f1e7d484b8e068e79241dfd73",22856027,1,155,0,958,167,281,114
"a37477c4e4c14169ad44b06b493007f6","bb5a47f5ea01454a8b79455422d3b9da",22856027,1,-5,0,960,283,280,-3
"a37477c4e4c14169ad44b06b493007f6","94cecc3f1e7d484b8e068e79241dfd73",22856027,1,-2,0,981,283,281,-2
"bb5a47f5ea01454a8b79455422d3b9da","bb5a47f5ea01454a8b79455422d3b9da",22856027,113,0,1,1000,280,280,0
"bb5a47f5ea01454a8b79455422d3b9da","0d987bed3ffa4ed0b9a2e62e97b7b30f",22856027,3,-10,0,1044,280,272,-8
"0d987bed3ffa4ed0b9a2e62e97b7b30f","94cecc3f1e7d484b8e068e79241dfd73",22856027,1,13,0,1045,272,281,9
"94cecc3f1e7d484b8e068e79241dfd73","a37477c4e4c14169ad44b06b493007f6",22856027,2,2,0,1046,281,283,2
"a37477c4e4c14169ad44b06b493007f6","0d987bed3ffa4ed0b9a2e62e97b7b30f",22856027,1,-15,0,1047,283,272,-11
"0d987bed3ffa4ed0b9a2e62e97b7b30f","bb5a47f5ea01454a8b79455422d3b9da",22856027,6,10,0,1048,272,280,8
"bb5a47f5ea01454a8b79455422d3b9da","94cecc3f1e7d484b8e068e79241dfd73",22856027,2,3,0,1056,280,281,1
"94cecc3f1e7d484b8e068e79241dfd73","0d987bed3ffa4ed0b9a2e62e97b7b30f",22856027,3,-13,0,1057,281,272,-9
"0d987bed3ffa4ed0b9a2e62e97b7b30f","a37477c4e4c14169ad44b06b493007f6",22856027,2,15,0,1058,272,283,11
"a37477c4e4c14169ad44b06b493007f6","bc5524e78a8544e2ae2fdc2f3462bbec",22856027,1,-6,0,1059,283,279,-4
"bc5524e78a8544e2ae2fdc2f3462bbec","bc5524e78a8544e2ae2fdc2f3462bbec",22856027,1,0,1,1060,279,279,0
"bc5524e78a8544e2ae2fdc2f3462bbec","0d987bed3ffa4ed0b9a2e62e97b7b30f",22856027,2,-9,0,1061,279,272,-7
"bb5a47f5ea01454a8b79455422d3b9da","bc5524e78a8544e2ae2fdc2f3462bbec",22856027,3,-1,0,1079,280,279,-1
"0d987bed3ffa4ed0b9a2e62e97b7b30f","bc5524e78a8544e2ae2fdc2f3462bbec",22856027,1,9,0,1081,272,279,7
"bc5524e78a8544e2ae2fdc2f3462bbec","bb5a47f5ea01454a8b79455422d3b9da",22856027,2,1,0,1082,279,280,1
"bb5a47f5ea01454a8b79455422d3b9da","4a29443515bb404cb8924e1c60a63b73",22856027,1,12,0,1090,280,285,5
"4a29443515bb404cb8924e1c60a63b73","4a29443515bb404cb8924e1c60a63b73",22856027,1,0,1,1091,285,285,0
"4a29443515bb404cb8924e1c60a63b73","7669a956527947d0add87455277e80b4",22856027,1,7,0,1092,285,291,6
"7669a956527947d0add87455277e80b4","7669a956527947d0add87455277e80b4",22856027,1,0,1,1093,291,291,0
"7669a956527947d0add87455277e80b4","6a9a3b5bde4a48daa896fe8c06eca56f",22856027,1,-2,0,1094,291,289,-2
"6a9a3b5bde4a48daa896fe8c06eca56f","869e967078f04da18dd0b0b9389a7424",22856027,1,5,0,1095,289,293,4
"869e967078f04da18dd0b0b9389a7424","51ab6291537748fab90d519aa09889d6",22856027,1,2,0,1096,293,295,2
"51ab6291537748fab90d519aa09889d6","51ab6291537748fab90d519aa09889d6",22856027,11,0,1,1097,295,295,0
"51ab6291537748fab90d519aa09889d6","34a6e49023fc4465bd5ca604330bbd1c",22856027,1,-3,0,1108,295,292,-3
"34a6e49023fc4465bd5ca604330bbd1c","21592f2a9e9c4b2f8c66ec5dbcbf6a2b",22856027,2,5,0,1109,292,296,4
"21592f2a9e9c4b2f8c66ec5dbcbf6a2b","ba0e59461bfb4a44b7b1c28a01f8d3b3",22856027,2,4,0,1110,296,299,3
"ba0e59461bfb4a44b7b1c28a01f8d3b3","0e0b36e731a645e7b1b8a88f5031ca38",22856027,1,2,0,1111,299,301,2
"0e0b36e731a645e7b1b8a88f5031ca38","0e0b36e731a645e7b1b8a88f5031ca38",22856027,9,0,1,1112,301,301,0
"0e0b36e731a645e7b1b8a88f5031ca38","a66a144637284c21afc6de17fea4bfb8",22856027,1,1,0,1121,301,302,1
"a66a144637284c21afc6de17fea4bfb8","a66a144637284c21afc6de17fea4bfb8",22856027,2,0,1,1122,302,302,0
"a66a144637284c21afc6de17fea4bfb8","7646a919d7e64fa990bca9b024ff089d",22856027,1,-4,0,1124,302,298,-4
"7646a919d7e64fa990bca9b024ff089d","e390b575229748ea8aac9364efe2bf00",22856027,1,7,0,1125,298,304,6
"e390b575229748ea8aac9364efe2bf00","e390b575229748ea8aac9364efe2bf00",22856027,1,0,1,1126,304,304,0
"e390b575229748ea8aac9364efe2bf00","4a29443515bb404cb8924e1c60a63b73",22856027,1,-24,0,1127,304,285,-19
"4a29443515bb404cb8924e1c60a63b73","3434c10e561d488a914e0f7d71907abd",22856027,2,27,0,1128,285,305,20
"3434c10e561d488a914e0f7d71907abd","53e7e900392747ccad52e711ab0f80d8",22856027,3,2,0,1129,305,307,2
"53e7e900392747ccad52e711ab0f80d8","3434c10e561d488a914e0f7d71907abd",22856027,3,-2,0,1130,307,305,-2
"3434c10e561d488a914e0f7d71907abd","130acc2aeb0448fdbb2de63bc5cebe5b",22856027,3,5,0,1131,305,309,4
"130acc2aeb0448fdbb2de63bc5cebe5b","9c062b3251034ebe90f5054e2a3b5120",22856027,1,2,0,1132,309,311,2
"9c062b3251034ebe90f5054e2a3b5120","9c062b3251034ebe90f5054e2a3b5120",22856027,2,0,1,1133,311,311,0
"9c062b3251034ebe90f5054e2a3b5120","ea859f8207e44537889daeaba13ac2e8",22856027,1,1,0,1135,311,312,1
"ea859f8207e44537889daeaba13ac2e8","ea859f8207e44537889daeaba13ac2e8",22856027,9,0,1,1136,312,312,0
"ea859f8207e44537889daeaba13ac2e8","56d94971a7a94257aa330183a8ebd0ea",22856027,2,1,0,1145,312,313,1
"56d94971a7a94257aa330183a8ebd0ea","56d94971a7a94257aa330183a8ebd0ea",22856027,8,0,1,1146,313,313,0
"56d94971a7a94257aa330183a8ebd0ea","141c0df6cd1946539aadd1c9b7068cd4",22856027,1,-5,0,1154,313,308,-5
"141c0df6cd1946539aadd1c9b7068cd4","3434c10e561d488a914e0f7d71907abd",22856027,1,-4,0,1155,308,305,-3
"130acc2aeb0448fdbb2de63bc5cebe5b","141c0df6cd1946539aadd1c9b7068cd4",22856027,1,-1,0,1159,309,308,-1
"141c0df6cd1946539aadd1c9b7068cd4","13255e63e0aa4abf85e5211bf613d43e",22856027,1,10,0,1160,308,317,9
"13255e63e0aa4abf85e5211bf613d43e","13255e63e0aa4abf85e5211bf613d43e",22856027,1,0,1,1161,317,317,0
"13255e63e0aa4abf85e5211bf613d43e","86c27d40179e419c8e9d150fb6afa5d0",22856027,1,3,0,1162,317,319,2
"86c27d40179e419c8e9d150fb6afa5d0","0c787d16c9504873b1a4d903cec09948",22856027,2,-6,0,1163,319,314,-5
"0c787d16c9504873b1a4d903cec09948","86c27d40179e419c8e9d150fb6afa5d0",22856027,1,6,0,1164,314,319,5
"86c27d40179e419c8e9d150fb6afa5d0","8d7e0b55cf9849cda222a0f2440cec55",22856027,1,-1,0,1165,319,318,-1
"8d7e0b55cf9849cda222a0f2440cec55","24f1363179ad4aaa965484a78471912b",22856027,2,6,0,1166,318,323,5
"24f1363179ad4aaa965484a78471912b","47edbb64109243e6b0f8f64cdef90c6c",22856027,2,3,0,1167,323,326,3
"47edbb64109243e6b0f8f64cdef90c6c","3628bdce1dd2429ba924d2d4d09448d2",22856027,2,-4,0,1168,326,322,-4
"3628bdce1dd2429ba924d2d4d09448d2","56b3fd1a212a4764be39d979fde3326e",22856027,1,7,0,1169,322,328,6
"56b3fd1a212a4764be39d979fde3326e","56b3fd1a212a4764be39d979fde3326e",22856027,1,0,1,1170,328,328,0
"56b3fd1a212a4764be39d979fde3326e","0c4079457ede49e3aeb5e86ed84bdf35",22856027,1,3,0,1171,328,329,1
"0c4079457ede49e3aeb5e86ed84bdf35","3434c10e561d488a914e0f7d71907abd",22856027,1,-31,0,1172,329,305,-24
"3434c10e561d488a914e0f7d71907abd","38aea304b4fa46e1b29bb72f5cea4c93",22856027,1,33,0,1173,305,331,26
"38aea304b4fa46e1b29bb72f5cea4c93","e36d261332f14e79bb4b467aceaeb9b5",22856027,1,2,0,1174,331,333,2
"e36d261332f14e79bb4b467aceaeb9b5","e36d261332f14e79bb4b467aceaeb9b5",22856027,4,0,1,1175,333,333,0
"e36d261332f14e79bb4b467aceaeb9b5","c7e89b9d04744d2eab742fc24e3ef1ae",22856027,2,1,0,1177,333,334,1
"c7e89b9d04744d2eab742fc24e3ef1ae","e36d261332f14e79bb4b467aceaeb9b5",22856027,1,-1,0,1178,334,333,-1
"c7e89b9d04744d2eab742fc24e3ef1ae","c7e89b9d04744d2eab742fc24e3ef1ae",22856027,5,0,1,1182,334,334,0
"c7e89b9d04744d2eab742fc24e3ef1ae","fe49f8054b374a0ea4bb266ed135ff62",22856027,1,1,0,1187,334,335,1
"fe49f8054b374a0ea4bb266ed135ff62","fe49f8054b374a0ea4bb266ed135ff62",22856027,5,0,1,1188,335,335,0
"fe49f8054b374a0ea4bb266ed135ff62","d0a8f74af98642fe8360d22c42e45117",22856027,1,1,0,1193,335,336,1
"d0a8f74af98642fe8360d22c42e45117","d0a8f74af98642fe8360d22c42e45117",22856027,5,0,1,1194,336,336,0
"d0a8f74af98642fe8360d22c42e45117","0c4079457ede49e3aeb5e86ed84bdf35",22856027,1,-7,0,1199,336,329,-7
"0c4079457ede49e3aeb5e86ed84bdf35","a7c6339ca1da4368a18d471f0519f877",22856027,1,11,0,1200,329,339,10
"a7c6339ca1da4368a18d471f0519f877","a7c6339ca1da4368a18d471f0519f877",22856027,1,0,1,1201,339,339,0
"a7c6339ca1da4368a18d471f0519f877","bbc5139ca9024389a94db3a6f47dcff6",22856027,1,3,0,1202,339,341,2
"bbc5139ca9024389a94db3a6f47dcff6","b8b9418ab322418d9db9b40d96af873a",22856027,2,-5,0,1203,341,337,-4
"b8b9418ab322418d9db9b40d96af873a","4ee6ca9019ab4a1ab323f98094a9bd77",22856027,1,7,0,1204,337,343,6
"4ee6ca9019ab4a1ab323f98094a9bd77","4ee6ca9019ab4a1ab323f98094a9bd77",22856027,5,0,1,1205,343,343,0
"4ee6ca9019ab4a1ab323f98094a9bd77","b37947176785476f8b29d49a851366dc",22856027,1,1,0,1210,343,344,1
"b37947176785476f8b29d49a851366dc","b37947176785476f8b29d49a851366dc",22856027,8,0,1,1211,344,344,0
"b37947176785476f8b29d49a851366dc","fcea5b10d5a14a3b9324ffece8f6e1e5",22856027,1,1,0,1219,344,345,1
"fcea5b10d5a14a3b9324ffece8f6e1e5","fcea5b10d5a14a3b9324ffece8f6e1e5",22856027,5,0,1,1220,345,345,0
"fcea5b10d5a14a3b9324ffece8f6e1e5","c2490bc612d146edbe786556fab3651b",22856027,1,-5,0,1225,345,340,-5
"c2490bc612d146edbe786556fab3651b","4a29443515bb404cb8924e1c60a63b73",22856027,1,-71,0,1226,340,285,-55
"4a29443515bb404cb8924e1c60a63b73","30ead9794d4847abaf222ca966cc8630",22856027,2,82,0,1227,285,348,63
"30ead9794d4847abaf222ca966cc8630","c20993c944444fe085345591a8bd837e",22856027,3,3,0,1228,348,351,3
"c20993c944444fe085345591a8bd837e","897b7f51242c44aab2205c72fdcbf4cd",22856027,6,1,0,1229,351,352,1
"897b7f51242c44aab2205c72fdcbf4cd","09b9678ddc3d452ea4a3d46e15826065",22856027,4,1,0,1230,352,353,1
"09b9678ddc3d452ea4a3d46e15826065","eff0de7f2dbb42dfa1a2e686efab5b6d",22856027,4,1,0,1231,353,354,1
"eff0de7f2dbb42dfa1a2e686efab5b6d","30ead9794d4847abaf222ca966cc8630",22856027,3,-6,0,1232,354,348,-6
"30ead9794d4847abaf222ca966cc8630","0c4079457ede49e3aeb5e86ed84bdf35",22856027,1,-24,0,1233,348,329,-19
"0c4079457ede49e3aeb5e86ed84bdf35","4a92daef4d504e1792575a26502bb7b7",22856027,2,20,0,1234,329,346,17
"4a92daef4d504e1792575a26502bb7b7","bbc5139ca9024389a94db3a6f47dcff6",22856027,1,-6,0,1235,346,341,-5
"bbc5139ca9024389a94db3a6f47dcff6","c2490bc612d146edbe786556fab3651b",22856027,2,-1,0,1236,341,340,-1
"c2490bc612d146edbe786556fab3651b","6ac8bb048b854999a47edb35fe627f11",22856027,1,8,0,1237,340,347,7
"6ac8bb048b854999a47edb35fe627f11","6ac8bb048b854999a47edb35fe627f11",22856027,1,0,1,1238,347,347,0
"6ac8bb048b854999a47edb35fe627f11","0c4079457ede49e3aeb5e86ed84bdf35",22856027,1,-21,0,1239,347,329,-18
"0c4079457ede49e3aeb5e86ed84bdf35","30ead9794d4847abaf222ca966cc8630",22856027,3,24,0,1240,329,348,19
"eff0de7f2dbb42dfa1a2e686efab5b6d","c20993c944444fe085345591a8bd837e",22856027,5,-3,0,1245,354,351,-3
"c20993c944444fe085345591a8bd837e","c20993c944444fe085345591a8bd837e",22856027,6,0,1,1246,351,351,0
"897b7f51242c44aab2205c72fdcbf4cd","897b7f51242c44aab2205c72fdcbf4cd",22856027,7,0,1,1250,352,352,0
"09b9678ddc3d452ea4a3d46e15826065","09b9678ddc3d452ea4a3d46e15826065",22856027,8,0,1,1254,353,353,0
"eff0de7f2dbb42dfa1a2e686efab5b6d","eff0de7f2dbb42dfa1a2e686efab5b6d",22856027,6,0,1,1258,354,354,0
"30ead9794d4847abaf222ca966cc8630","2fe14166dc9642c3bc666b86a57f943d",22856027,4,10,0,1262,348,357,9
"2fe14166dc9642c3bc666b86a57f943d","44421dd1e13a47a388c4a19834b744c7",22856027,1,2,0,1263,357,359,2
"44421dd1e13a47a388c4a19834b744c7","44421dd1e13a47a388c4a19834b744c7",22856027,8,0,1,1264,359,359,0
"44421dd1e13a47a388c4a19834b744c7","cb5fc7ef85d547c4be1a7439d0bf6052",22856027,1,1,0,1272,359,360,1
"cb5fc7ef85d547c4be1a7439d0bf6052","cb5fc7ef85d547c4be1a7439d0bf6052",22856027,5,0,1,1273,360,360,0
"cb5fc7ef85d547c4be1a7439d0bf6052","0a8f150a4cf747acbde62f4721823da3",22856027,1,1,0,1278,360,361,1
"0a8f150a4cf747acbde62f4721823da3","0a8f150a4cf747acbde62f4721823da3",22856027,2,0,1,1279,361,361,0
"0a8f150a4cf747acbde62f4721823da3","ab8fdad974ae471f9f24c3f9dd04462e",22856027,1,1,0,1281,361,362,1
"ab8fdad974ae471f9f24c3f9dd04462e","ab8fdad974ae471f9f24c3f9dd04462e",22856027,5,0,1,1282,362,362,0
"ab8fdad974ae471f9f24c3f9dd04462e","52580888dadb4fe3baa795683ea227bd",22856027,1,3,0,1287,362,364,2
"52580888dadb4fe3baa795683ea227bd","1ba8fef685d74a8194b9db252eb704fb",22856027,2,-10,0,1288,364,355,-9
"1ba8fef685d74a8194b9db252eb704fb","492a3bc6a1254f23a7998587961b22a4",22856027,2,13,0,1289,355,366,11
"492a3bc6a1254f23a7998587961b22a4","f00179e251a045b39c3f7a54f9aa4acc",22856027,3,-4,0,1290,366,363,-3
"f00179e251a045b39c3f7a54f9aa4acc","072a190fd302456290895f9f04d6940a",22856027,3,3,0,1291,363,365,2
"072a190fd302456290895f9f04d6940a","cfa457d1743848e4bb5e4beced6448ed",22856027,1,5,0,1292,365,369,4
"cfa457d1743848e4bb5e4beced6448ed","cfa457d1743848e4bb5e4beced6448ed",22856027,1,0,1,1293,369,369,0
"cfa457d1743848e4bb5e4beced6448ed","b71bac264efb4abd97015447bd490db6",22856027,1,3,0,1294,369,370,1
"b71bac264efb4abd97015447bd490db6","30ead9794d4847abaf222ca966cc8630",22856027,2,-28,0,1295,370,348,-22
"30ead9794d4847abaf222ca966cc8630","8d448d625b024c82a5eb240bbd7431d6",22856027,1,33,0,1296,348,374,26
"8d448d625b024c82a5eb240bbd7431d6","8d448d625b024c82a5eb240bbd7431d6",22856027,134,0,1,1297,374,374,0
"8d448d625b024c82a5eb240bbd7431d6","b71bac264efb4abd97015447bd490db6",22856027,10,-5,0,1300,374,370,-4
"b71bac264efb4abd97015447bd490db6","8d448d625b024c82a5eb240bbd7431d6",22856027,14,5,0,1301,370,374,4
"8d448d625b024c82a5eb240bbd7431d6","d6d02b6ef04e4f17805504500b8ce441",22856027,1,3,0,1305,374,375,1
"d6d02b6ef04e4f17805504500b8ce441","b71bac264efb4abd97015447bd490db6",22856027,3,-8,0,1306,375,370,-5
"b71bac264efb4abd97015447bd490db6","d6d02b6ef04e4f17805504500b8ce441",22856027,3,8,0,1307,370,375,5
"d6d02b6ef04e4f17805504500b8ce441","8d448d625b024c82a5eb240bbd7431d6",22856027,1,-3,0,1310,375,374,-1
"b71bac264efb4abd97015447bd490db6","d5ae8642e15b46b8bd298b02274d4e9c",22856027,1,16,0,1364,370,380,10
"d5ae8642e15b46b8bd298b02274d4e9c","d5ae8642e15b46b8bd298b02274d4e9c",22856027,7,0,1,1365,380,380,0
"d5ae8642e15b46b8bd298b02274d4e9c","a0d10309a2dd456289147f84be9d37f9",22856027,1,1,0,1372,380,381,1
"a0d10309a2dd456289147f84be9d37f9","a0d10309a2dd456289147f84be9d37f9",22856027,3,0,1,1373,381,381,0
"a0d10309a2dd456289147f84be9d37f9","0fcbc3ca07b144138b8d85da581f09a8",22856027,1,1,0,1376,381,382,1
"0fcbc3ca07b144138b8d85da581f09a8","0fcbc3ca07b144138b8d85da581f09a8",22856027,5,0,1,1377,382,382,0
"0fcbc3ca07b144138b8d85da581f09a8","66baf19b6b904b70922329068c63746d",22856027,1,-6,0,1382,382,376,-6
"66baf19b6b904b70922329068c63746d","96bb2b3e85a34d8b9544514e89f6fe97",22856027,1,17,0,1383,376,390,14
"96bb2b3e85a34d8b9544514e89f6fe97","96bb2b3e85a34d8b9544514e89f6fe97",22856027,3,0,1,1384,390,390,0
"96bb2b3e85a34d8b9544514e89f6fe97","ac4e9b54acfe4670b4634859c7263cb5",22856027,1,2,0,1387,390,392,2
"ac4e9b54acfe4670b4634859c7263cb5","ac4e9b54acfe4670b4634859c7263cb5",22856027,3,0,1,1388,392,392,0
"ac4e9b54acfe4670b4634859c7263cb5","17f95d18bab743888e1736033dc3384d",22856027,1,-3,0,1391,392,389,-3
"17f95d18bab743888e1736033dc3384d","6f8881a745ac4c358a68b92c3b4abe81",22856027,1,6,0,1392,389,394,5
"6f8881a745ac4c358a68b92c3b4abe81","f7002c8484354eceac57bc7bd62c76c1",22856027,1,-1,0,1393,394,393,-1
"f7002c8484354eceac57bc7bd62c76c1","44a277ea44dc4ae689fab4b82f0b4098",22856027,1,5,0,1394,393,397,4
"44a277ea44dc4ae689fab4b82f0b4098","44a277ea44dc4ae689fab4b82f0b4098",22856027,1,0,1,1395,397,397,0
"44a277ea44dc4ae689fab4b82f0b4098","0c12af0a4e7f4002852cf84b2537c161",22856027,1,-2,0,1396,397,395,-2
"0c12af0a4e7f4002852cf84b2537c161","859e0b8d71694b12befb69ee698138f9",22856027,1,5,0,1397,395,399,4
"859e0b8d71694b12befb69ee698138f9","859e0b8d71694b12befb69ee698138f9",22856027,1,0,1,1398,399,399,0
"859e0b8d71694b12befb69ee698138f9","2b09a08242b54983aec7063990fb3f66",22856027,1,3,0,1399,399,400,1
"2b09a08242b54983aec7063990fb3f66","66baf19b6b904b70922329068c63746d",22856027,3,-32,0,1400,400,376,-24
"66baf19b6b904b70922329068c63746d","2b09a08242b54983aec7063990fb3f66",22856027,2,32,0,1401,376,400,24
"2b09a08242b54983aec7063990fb3f66","2b09a08242b54983aec7063990fb3f66",22856027,9,0,1,1402,400,400,0
"66baf19b6b904b70922329068c63746d","0c12af0a4e7f4002852cf84b2537c161",22856027,1,24,0,1412,376,395,19
"0c12af0a4e7f4002852cf84b2537c161","2b09a08242b54983aec7063990fb3f66",22856027,1,8,0,1413,395,400,5
"2b09a08242b54983aec7063990fb3f66","1f471b7a883a4df48211e8c6a81b59a7",22856027,1,1,0,1416,400,401,1
"1f471b7a883a4df48211e8c6a81b59a7","1f471b7a883a4df48211e8c6a81b59a7",22856027,3,0,1,1417,401,401,0
"1f471b7a883a4df48211e8c6a81b59a7","2b09a08242b54983aec7063990fb3f66",22856027,1,-1,0,1420,401,400,-1
"2b09a08242b54983aec7063990fb3f66","9de0d567bfa84fe5b77cb76f4a76a5d1",22856027,1,5,0,1421,400,404,4
"9de0d567bfa84fe5b77cb76f4a76a5d1","9de0d567bfa84fe5b77cb76f4a76a5d1",22856027,1,0,1,1422,404,404,0
"9de0d567bfa84fe5b77cb76f4a76a5d1","1157bd665ec4472fb58b751dc5099355",22856027,1,-1,0,1423,404,403,-1
"1157bd665ec4472fb58b751dc5099355","3c8a22d2f9c146ea956609e3ed4f2559",22856027,1,3,0,1424,403,405,2
"3c8a22d2f9c146ea956609e3ed4f2559","58fc9094275e4c49be3f4ba6d4acc0a4",22856027,1,2,0,1425,405,406,1
"58fc9094275e4c49be3f4ba6d4acc0a4","c1c1be90b2b14c1ab4a5e1ee3c241902",22856027,1,1,0,1426,406,407,1
"c1c1be90b2b14c1ab4a5e1ee3c241902","c1c1be90b2b14c1ab4a5e1ee3c241902",22856027,5,0,1,1427,407,407,0
"c1c1be90b2b14c1ab4a5e1ee3c241902","58fc9094275e4c49be3f4ba6d4acc0a4",22856027,1,-1,0,1432,407,406,-1
"58fc9094275e4c49be3f4ba6d4acc0a4","02b3a1bead9244c1ba2f857c7da8f82a",22856027,1,3,0,1433,406,408,2
"02b3a1bead9244c1ba2f857c7da8f82a","6206fc6479014bb193084c32409dc1b9",22856027,1,1,0,1434,408,409,1
"6206fc6479014bb193084c32409dc1b9","6206fc6479014bb193084c32409dc1b9",22856027,1,0,1,1435,409,409,0
"6206fc6479014bb193084c32409dc1b9","02b3a1bead9244c1ba2f857c7da8f82a",22856027,1,-1,0,1436,409,408,-1
"02b3a1bead9244c1ba2f857c7da8f82a","6a5f020451db426dacba9e2ea3fcc62a",22856027,1,3,0,1437,408,410,2
"6a5f020451db426dacba9e2ea3fcc62a","6a5f020451db426dacba9e2ea3fcc62a",22856027,1,0,1,1438,410,410,0
"6a5f020451db426dacba9e2ea3fcc62a","33a9d248b2e44588a5b07fc1342b9bc2",22856027,1,2,0,1439,410,411,1
"33a9d248b2e44588a5b07fc1342b9bc2","c6f26bd420634f1cb7989e76fe6b16c0",22856027,1,1,0,1440,411,412,1
"c6f26bd420634f1cb7989e76fe6b16c0","c6f26bd420634f1cb7989e76fe6b16c0",22856027,5,0,1,1441,412,412,0
"c6f26bd420634f1cb7989e76fe6b16c0","2a65ee6e2ac64f6a8a55fbe5373ec763",22856027,1,1,0,1446,412,413,1
"2a65ee6e2ac64f6a8a55fbe5373ec763","2a65ee6e2ac64f6a8a55fbe5373ec763",22856027,2,0,1,1447,413,413,0
"2a65ee6e2ac64f6a8a55fbe5373ec763","33a9d248b2e44588a5b07fc1342b9bc2",22856027,1,-2,0,1449,413,411,-2
"33a9d248b2e44588a5b07fc1342b9bc2","1fd0f6dadbc14ebc965faf6122190b96",22856027,1,5,0,1450,411,415,4
"1fd0f6dadbc14ebc965faf6122190b96","1fd0f6dadbc14ebc965faf6122190b96",22856027,1,0,1,1451,415,415,0
"1fd0f6dadbc14ebc965faf6122190b96","687055dad9fc40c3982478fe33ec01bf",22856027,1,-1,0,1452,415,414,-1
"687055dad9fc40c3982478fe33ec01bf","2add1669f08d4101913db15f8c23b3b7",22856027,1,3,0,1453,414,416,2
"2add1669f08d4101913db15f8c23b3b7","2add1669f08d4101913db15f8c23b3b7",22856027,1,0,1,1454,416,416,0
"2add1669f08d4101913db15f8c23b3b7","a2b4bd40cee2481ebd3fc179d6a5cd62",22856027,1,3,0,1455,416,417,1
"a2b4bd40cee2481ebd3fc179d6a5cd62","2b09a08242b54983aec7063990fb3f66",22856027,1,-27,0,1456,417,400,-17
"2b09a08242b54983aec7063990fb3f66","e34e59dce2204f228f3a84b6725df60f",22856027,1,29,0,1457,400,419,19
"e34e59dce2204f228f3a84b6725df60f","e34e59dce2204f228f3a84b6725df60f",22856027,1,0,1,1458,419,419,0
"e34e59dce2204f228f3a84b6725df60f","bec48fc2e1294c7eb3d0aca780d731b8",22856027,1,2,0,1459,419,420,1
"bec48fc2e1294c7eb3d0aca780d731b8","a2b4bd40cee2481ebd3fc179d6a5cd62",22856027,1,-4,0,1460,420,417,-3
"a2b4bd40cee2481ebd3fc179d6a5cd62","bec48fc2e1294c7eb3d0aca780d731b8",22856027,1,4,0,1461,417,420,3
"bec48fc2e1294c7eb3d0aca780d731b8","a24600b0e49245f6bdba8c893cfeddb0",22856027,1,7,0,1462,420,425,5
"a24600b0e49245f6bdba8c893cfeddb0","dbde19fcce2a4c1abdc7f685c293a23f",22856027,1,-4,0,1463,425,422,-3
"dbde19fcce2a4c1abdc7f685c293a23f","a24600b0e49245f6bdba8c893cfeddb0",22856027,1,4,0,1464,422,425,3
"a24600b0e49245f6bdba8c893cfeddb0","24cf8786024543f19b89bc20034e60d7",22856027,1,7,0,1465,425,428,3
"24cf8786024543f19b89bc20034e60d7","a2b4bd40cee2481ebd3fc179d6a5cd62",22856027,1,-18,0,1466,428,417,-11
"a2b4bd40cee2481ebd3fc179d6a5cd62","f2a73be2f46840b182d7bd095378004e",22856027,1,19,0,1467,417,429,12
"f2a73be2f46840b182d7bd095378004e","604551fd4266430cb860fef58fa7dd61",22856027,1,1,0,1468,429,430,1
"604551fd4266430cb860fef58fa7dd61","604551fd4266430cb860fef58fa7dd61",22856027,1,0,1,1469,430,430,0
"604551fd4266430cb860fef58fa7dd61","24cf8786024543f19b89bc20034e60d7",22856027,1,-2,0,1470,430,428,-2
"24cf8786024543f19b89bc20034e60d7","dce46f8904594a62a6377a3587aaa663",22856027,1,4,0,1471,428,431,3
"dce46f8904594a62a6377a3587aaa663","9b9d0a249052413c869753b99682b0ac",22856027,1,1,0,1472,431,432,1
"9b9d0a249052413c869753b99682b0ac","9b9d0a249052413c869753b99682b0ac",22856027,9,0,1,1473,432,432,0
"9b9d0a249052413c869753b99682b0ac","061c175cc90f45fbad883025394e78dd",22856027,1,1,0,1482,432,433,1
"061c175cc90f45fbad883025394e78dd","061c175cc90f45fbad883025394e78dd",22856027,4,0,1,1483,433,433,0
"061c175cc90f45fbad883025394e78dd","dce46f8904594a62a6377a3587aaa663",22856027,1,-2,0,1487,433,431,-2
"dce46f8904594a62a6377a3587aaa663","74a7f8712e5449c2bc0b43c6f90dafed",22856027,1,5,0,1488,431,435,4
"74a7f8712e5449c2bc0b43c6f90dafed","74a7f8712e5449c2bc0b43c6f90dafed",22856027,1,0,1,1489,435,435,0
"74a7f8712e5449c2bc0b43c6f90dafed","66ada10dde9f43018588f1ced9d477fc",22856027,1,-1,0,1490,435,434,-1
"66ada10dde9f43018588f1ced9d477fc","bf12c96466d840a69bed7020b3f18bb8",22856027,1,3,0,1491,434,436,2
"bf12c96466d840a69bed7020b3f18bb8","bf12c96466d840a69bed7020b3f18bb8",22856027,1,0,1,1492,436,436,0
"bf12c96466d840a69bed7020b3f18bb8","070600601c4c439288445d2f0724807d",22856027,1,3,0,1493,436,437,1
"070600601c4c439288445d2f0724807d","24cf8786024543f19b89bc20034e60d7",22856027,1,-14,0,1494,437,428,-9
"24cf8786024543f19b89bc20034e60d7","1823b6de7d334a7aaabc4570719af4d9",22856027,1,16,0,1495,428,439,11
"1823b6de7d334a7aaabc4570719af4d9","1823b6de7d334a7aaabc4570719af4d9",22856027,14,0,1,1496,439,439,0
"1823b6de7d334a7aaabc4570719af4d9","070600601c4c439288445d2f0724807d",22856027,3,-2,0,1497,439,437,-2
"070600601c4c439288445d2f0724807d","1823b6de7d334a7aaabc4570719af4d9",22856027,2,2,0,1498,437,439,2
"070600601c4c439288445d2f0724807d","0380cd76a7d44bc3a4da1f15e4d68f89",22856027,1,4,0,1515,437,440,3
"0380cd76a7d44bc3a4da1f15e4d68f89","0380cd76a7d44bc3a4da1f15e4d68f89",22856027,1,0,1,1516,440,440,0
"0380cd76a7d44bc3a4da1f15e4d68f89","23b7673c8b5443108c2ef09382834a86",22856027,1,2,0,1517,440,441,1
"23b7673c8b5443108c2ef09382834a86","23b7673c8b5443108c2ef09382834a86",22856027,1,0,1,1518,441,441,0
"23b7673c8b5443108c2ef09382834a86","901e92500aea43c79f19f1b279050668",22856027,1,2,0,1519,441,442,1
"901e92500aea43c79f19f1b279050668","901e92500aea43c79f19f1b279050668",22856027,1,0,1,1520,442,442,0
"901e92500aea43c79f19f1b279050668","001339db8ced4cf78829ebe8b145449d",22856027,1,1,0,1521,442,443,1
"001339db8ced4cf78829ebe8b145449d","001339db8ced4cf78829ebe8b145449d",22856027,5,0,1,1522,443,443,0
"001339db8ced4cf78829ebe8b145449d","452745e0366e42ae81561bfddebcc6c3",22856027,1,1,0,1527,443,444,1
"452745e0366e42ae81561bfddebcc6c3","452745e0366e42ae81561bfddebcc6c3",22856027,5,0,1,1528,444,444,0
"452745e0366e42ae81561bfddebcc6c3","901e92500aea43c79f19f1b279050668",22856027,1,-2,0,1533,444,442,-2
"901e92500aea43c79f19f1b279050668","4660ff2089114e8db82ceb26a4f329e3",22856027,1,4,0,1534,442,445,3
"4660ff2089114e8db82ceb26a4f329e3","4660ff2089114e8db82ceb26a4f329e3",22856027,1,0,1,1535,445,445,0
"4660ff2089114e8db82ceb26a4f329e3","7bd5586eb9d8484eb74a433ee7bfe499",22856027,2,2,0,1536,445,446,1
"7bd5586eb9d8484eb74a433ee7bfe499","4660ff2089114e8db82ceb26a4f329e3",22856027,1,-2,0,1537,446,445,-1
"7bd5586eb9d8484eb74a433ee7bfe499","7bd5586eb9d8484eb74a433ee7bfe499",22856027,17,0,1,1539,446,446,0
"7bd5586eb9d8484eb74a433ee7bfe499","8a7f26e690f34dda97be16904518ca99",22856027,1,2,0,1556,446,447,1
"8a7f26e690f34dda97be16904518ca99","8a7f26e690f34dda97be16904518ca99",22856027,1,0,1,1557,447,447,0
"8a7f26e690f34dda97be16904518ca99","b2f0d654738f48158edff28e8d3a546e",22856027,1,5,0,1558,447,449,2
"b2f0d654738f48158edff28e8d3a546e","070600601c4c439288445d2f0724807d",22856027,1,-21,0,1559,449,437,-12
"070600601c4c439288445d2f0724807d","f60ee41ec635499abd48168342d32c2f",22856027,1,26,0,1560,437,453,16
"f60ee41ec635499abd48168342d32c2f","b2f0d654738f48158edff28e8d3a546e",22856027,4,-5,0,1561,453,449,-4
"b2f0d654738f48158edff28e8d3a546e","f60ee41ec635499abd48168342d32c2f",22856027,6,5,0,1562,449,453,4
"f60ee41ec635499abd48168342d32c2f","f60ee41ec635499abd48168342d32c2f",22856027,85,0,1,1563,453,453,0
"f60ee41ec635499abd48168342d32c2f","f67fbf45a5f146ed866965bc57c7c001",22856027,1,3,0,1569,453,454,1
"f67fbf45a5f146ed866965bc57c7c001","b2f0d654738f48158edff28e8d3a546e",22856027,1,-8,0,1570,454,449,-5
"b2f0d654738f48158edff28e8d3a546e","519119f1deac45ff9ab4f13529be5c6e",22856027,1,17,0,1571,449,463,14
"519119f1deac45ff9ab4f13529be5c6e","519119f1deac45ff9ab4f13529be5c6e",22856027,1,0,1,1572,463,463,0
"519119f1deac45ff9ab4f13529be5c6e","3628b3f7823443d0912a339096b69943",22856027,1,-7,0,1573,463,456,-7
"3628b3f7823443d0912a339096b69943","3628b3f7823443d0912a339096b69943",22856027,1,0,1,1574,456,456,0
"3628b3f7823443d0912a339096b69943","d937afe49bd24a07a550dda1c1155122",22856027,1,-1,0,1575,456,455,-1
"d937afe49bd24a07a550dda1c1155122","d937afe49bd24a07a550dda1c1155122",22856027,5,0,1,1576,455,455,0
"d937afe49bd24a07a550dda1c1155122","f67fbf45a5f146ed866965bc57c7c001",22856027,1,-1,0,1581,455,454,-1
"f67fbf45a5f146ed866965bc57c7c001","f67fbf45a5f146ed866965bc57c7c001",22856027,2,0,1,1582,454,454,0
"f67fbf45a5f146ed866965bc57c7c001","9e049ee647cf43ecbcb5ed792a8e7588",22856027,1,3,0,1583,454,457,3
"9e049ee647cf43ecbcb5ed792a8e7588","9e049ee647cf43ecbcb5ed792a8e7588",22856027,1,0,1,1584,457,457,0
"9e049ee647cf43ecbcb5ed792a8e7588","5256a214faaf410b93f76cea06428334",22856027,1,1,0,1585,457,458,1
"5256a214faaf410b93f76cea06428334","5256a214faaf410b93f76cea06428334",22856027,1,0,1,1586,458,458,0
"5256a214faaf410b93f76cea06428334","25c32b120fce40fa9b6c85133aeb4716",22856027,1,1,0,1587,458,459,1
"25c32b120fce40fa9b6c85133aeb4716","25c32b120fce40fa9b6c85133aeb4716",22856027,5,0,1,1588,459,459,0
"25c32b120fce40fa9b6c85133aeb4716","11bc14f2204949008b7d511b933363c1",22856027,1,1,0,1591,459,460,1
"11bc14f2204949008b7d511b933363c1","11bc14f2204949008b7d511b933363c1",22856027,6,0,1,1592,460,460,0
"11bc14f2204949008b7d511b933363c1","f67fbf45a5f146ed866965bc57c7c001",22856027,1,-6,0,1598,460,454,-6
"f67fbf45a5f146ed866965bc57c7c001","66baf19b6b904b70922329068c63746d",22856027,1,-120,0,1599,454,376,-78
"66baf19b6b904b70922329068c63746d","4a29443515bb404cb8924e1c60a63b73",22856027,1,-122,0,1600,376,285,-91
"4a29443515bb404cb8924e1c60a63b73","869e967078f04da18dd0b0b9389a7424",22856027,1,10,0,1601,285,293,8
"869e967078f04da18dd0b0b9389a7424","6a9a3b5bde4a48daa896fe8c06eca56f",22856027,1,-5,0,1602,293,289,-4
"6a9a3b5bde4a48daa896fe8c06eca56f","34a6e49023fc4465bd5ca604330bbd1c",22856027,1,4,0,1603,289,292,3
"ba0e59461bfb4a44b7b1c28a01f8d3b3","7646a919d7e64fa990bca9b024ff089d",22856027,1,-1,0,1606,299,298,-1
"7646a919d7e64fa990bca9b024ff089d","4a29443515bb404cb8924e1c60a63b73",22856027,1,-17,0,1607,298,285,-13
"130acc2aeb0448fdbb2de63bc5cebe5b","ea859f8207e44537889daeaba13ac2e8",22856027,1,3,0,1612,309,312,3
"56d94971a7a94257aa330183a8ebd0ea","25c32b120fce40fa9b6c85133aeb4716",22856027,1,211,0,1614,313,459,146
"25c32b120fce40fa9b6c85133aeb4716","141c0df6cd1946539aadd1c9b7068cd4",22856027,1,-216,0,1617,459,308,-151
"141c0df6cd1946539aadd1c9b7068cd4","86c27d40179e419c8e9d150fb6afa5d0",22856027,1,13,0,1618,308,319,11
"0c787d16c9504873b1a4d903cec09948","8d7e0b55cf9849cda222a0f2440cec55",22856027,1,5,0,1620,314,318,4
"3628bdce1dd2429ba924d2d4d09448d2","3434c10e561d488a914e0f7d71907abd",22856027,1,-21,0,1624,322,305,-17
"3434c10e561d488a914e0f7d71907abd","0c4079457ede49e3aeb5e86ed84bdf35",22856027,1,31,0,1625,305,329,24
"0c4079457ede49e3aeb5e86ed84bdf35","38aea304b4fa46e1b29bb72f5cea4c93",22856027,2,2,0,1626,329,331,2
"38aea304b4fa46e1b29bb72f5cea4c93","42de338840a34d15adb66e7b14fb9d2c",22856027,1,189,0,1627,331,461,130
"42de338840a34d15adb66e7b14fb9d2c","42de338840a34d15adb66e7b14fb9d2c",22856027,1,0,1,1628,461,461,0
"42de338840a34d15adb66e7b14fb9d2c","0c4079457ede49e3aeb5e86ed84bdf35",22856027,1,-191,0,1629,461,329,-132
"0c4079457ede49e3aeb5e86ed84bdf35","b8b9418ab322418d9db9b40d96af873a",22856027,1,9,0,1630,329,337,8
"b8b9418ab322418d9db9b40d96af873a","bbc5139ca9024389a94db3a6f47dcff6",22856027,1,5,0,1631,337,341,4
"c2490bc612d146edbe786556fab3651b","0c4079457ede49e3aeb5e86ed84bdf35",22856027,2,-13,0,1633,340,329,-11
"897b7f51242c44aab2205c72fdcbf4cd","eff0de7f2dbb42dfa1a2e686efab5b6d",22856027,4,2,0,1638,352,354,2
"c20993c944444fe085345591a8bd837e","eff0de7f2dbb42dfa1a2e686efab5b6d",22856027,2,3,0,1640,351,354,3
"eff0de7f2dbb42dfa1a2e686efab5b6d","09b9678ddc3d452ea4a3d46e15826065",22856027,2,-1,0,1641,354,353,-1
"09b9678ddc3d452ea4a3d46e15826065","c20993c944444fe085345591a8bd837e",22856027,2,-2,0,1643,353,351,-2
"09b9678ddc3d452ea4a3d46e15826065","2fe14166dc9642c3bc666b86a57f943d",22856027,1,5,0,1647,353,357,4
"2fe14166dc9642c3bc666b86a57f943d","30ead9794d4847abaf222ca966cc8630",22856027,2,-10,0,1648,357,348,-9
"30ead9794d4847abaf222ca966cc8630","52580888dadb4fe3baa795683ea227bd",22856027,1,18,0,1649,348,364,16
"072a190fd302456290895f9f04d6940a","30ead9794d4847abaf222ca966cc8630",22856027,2,-20,0,1654,365,348,-17
"30ead9794d4847abaf222ca966cc8630","b71bac264efb4abd97015447bd490db6",22856027,2,28,0,1655,348,370,22
"8d448d625b024c82a5eb240bbd7431d6","1b4550d0dab04078b3bf08a655345bdc",22856027,1,-1,0,1665,374,373,-1
"1b4550d0dab04078b3bf08a655345bdc","4a29443515bb404cb8924e1c60a63b73",22856027,1,-114,0,1666,373,285,-88
"30ead9794d4847abaf222ca966cc8630","30ead9794d4847abaf222ca966cc8630",22856027,1,0,1,1668,348,348,0
"30ead9794d4847abaf222ca966cc8630","eff0de7f2dbb42dfa1a2e686efab5b6d",22856027,1,6,0,1669,348,354,6
"c20993c944444fe085345591a8bd837e","09b9678ddc3d452ea4a3d46e15826065",22856027,2,2,0,1672,351,353,2
"eff0de7f2dbb42dfa1a2e686efab5b6d","897b7f51242c44aab2205c72fdcbf4cd",22856027,2,-2,0,1677,354,352,-2
"897b7f51242c44aab2205c72fdcbf4cd","c20993c944444fe085345591a8bd837e",22856027,2,-1,0,1678,352,351,-1
"897b7f51242c44aab2205c72fdcbf4cd","30ead9794d4847abaf222ca966cc8630",22856027,1,-4,0,1681,352,348,-4
"2fe14166dc9642c3bc666b86a57f943d","1ba8fef685d74a8194b9db252eb704fb",22856027,2,-2,0,1683,357,355,-2
"1ba8fef685d74a8194b9db252eb704fb","52580888dadb4fe3baa795683ea227bd",22856027,2,10,0,1684,355,364,9
"52580888dadb4fe3baa795683ea227bd","492a3bc6a1254f23a7998587961b22a4",22856027,1,3,0,1685,364,366,2
"b71bac264efb4abd97015447bd490db6","b71bac264efb4abd97015447bd490db6",22856027,2,0,1,1690,370,370,0
"8d448d625b024c82a5eb240bbd7431d6","4a29443515bb404cb8924e1c60a63b73",22856027,1,-115,0,1699,374,285,-89
"4a29443515bb404cb8924e1c60a63b73","0c4079457ede49e3aeb5e86ed84bdf35",22856027,1,58,0,1700,285,329,44
"0c4079457ede49e3aeb5e86ed84bdf35","0c4079457ede49e3aeb5e86ed84bdf35",22856027,1,0,1,1701,329,329,0
"38aea304b4fa46e1b29bb72f5cea4c93","0c4079457ede49e3aeb5e86ed84bdf35",22856027,1,-2,0,1703,331,329,-2
"0c4079457ede49e3aeb5e86ed84bdf35","bbc5139ca9024389a94db3a6f47dcff6",22856027,1,14,0,1704,329,341,12
"b8b9418ab322418d9db9b40d96af873a","c2490bc612d146edbe786556fab3651b",22856027,1,4,0,1706,337,340,3
"30ead9794d4847abaf222ca966cc8630","09b9678ddc3d452ea4a3d46e15826065",22856027,2,5,0,1709,348,353,5
"09b9678ddc3d452ea4a3d46e15826065","897b7f51242c44aab2205c72fdcbf4cd",22856027,3,-1,0,1710,353,352,-1
"52580888dadb4fe3baa795683ea227bd","f00179e251a045b39c3f7a54f9aa4acc",22856027,1,-1,0,1725,364,363,-1
"f00179e251a045b39c3f7a54f9aa4acc","492a3bc6a1254f23a7998587961b22a4",22856027,1,4,0,1726,363,366,3
"492a3bc6a1254f23a7998587961b22a4","072a190fd302456290895f9f04d6940a",22856027,1,-1,0,1727,366,365,-1
"072a190fd302456290895f9f04d6940a","b71bac264efb4abd97015447bd490db6",22856027,1,8,0,1728,365,370,5
"30ead9794d4847abaf222ca966cc8630","4a29443515bb404cb8924e1c60a63b73",22856027,1,-82,0,1730,348,285,-63
"4a29443515bb404cb8924e1c60a63b73","9da37c6210b1416b8079c274f70bf600",22856027,1,250,0,1731,285,462,177
"9da37c6210b1416b8079c274f70bf600","9da37c6210b1416b8079c274f70bf600",22856027,1,0,1,1732,462,462,0
"9da37c6210b1416b8079c274f70bf600","f67fbf45a5f146ed866965bc57c7c001",22856027,1,-8,0,1733,462,454,-8
"f67fbf45a5f146ed866965bc57c7c001","c5df9f40ec14463b9dcfdc73df3e9285",22856027,3,12,0,1734,454,464,10
"c5df9f40ec14463b9dcfdc73df3e9285","c5df9f40ec14463b9dcfdc73df3e9285",22856027,3,0,1,1735,464,464,0
"c5df9f40ec14463b9dcfdc73df3e9285","83d42d95cd844fc093fc09cee250edb8",22856027,5,3,0,1737,464,465,1
"83d42d95cd844fc093fc09cee250edb8","83d42d95cd844fc093fc09cee250edb8",22856027,4,0,1,1738,465,465,0
"83d42d95cd844fc093fc09cee250edb8","b2f0d654738f48158edff28e8d3a546e",22856027,2,-23,0,1740,465,449,-16
"f60ee41ec635499abd48168342d32c2f","2b09a08242b54983aec7063990fb3f66",22856027,1,-85,0,1749,453,400,-53
"2b09a08242b54983aec7063990fb3f66","b71bac264efb4abd97015447bd490db6",22856027,1,-44,0,1750,400,370,-30
"8d448d625b024c82a5eb240bbd7431d6","c5df9f40ec14463b9dcfdc73df3e9285",22856027,1,139,0,1753,374,464,90
"83d42d95cd844fc093fc09cee250edb8","c5df9f40ec14463b9dcfdc73df3e9285",22856027,2,-3,0,1756,465,464,-1
"83d42d95cd844fc093fc09cee250edb8","b71bac264efb4abd97015447bd490db6",22856027,1,-147,0,1759,465,370,-95
"8d448d625b024c82a5eb240bbd7431d6","0c4079457ede49e3aeb5e86ed84bdf35",22856027,1,-57,0,1778,374,329,-45
"4a92daef4d504e1792575a26502bb7b7","38aea304b4fa46e1b29bb72f5cea4c93",22856027,1,-18,0,1780,346,331,-15
"38aea304b4fa46e1b29bb72f5cea4c93","38aea304b4fa46e1b29bb72f5cea4c93",22856027,1,0,1,1781,331,331,0
"38aea304b4fa46e1b29bb72f5cea4c93","8d448d625b024c82a5eb240bbd7431d6",22856027,1,55,0,1782,331,374,43
"d6d02b6ef04e4f17805504500b8ce441","d6d02b6ef04e4f17805504500b8ce441",22856027,1,0,1,1829,375,375,0
"8d448d625b024c82a5eb240bbd7431d6","b2f0d654738f48158edff28e8d3a546e",22856027,1,119,0,1839,374,449,75
"f60ee41ec635499abd48168342d32c2f","30ead9794d4847abaf222ca966cc8630",22856027,1,-157,0,1848,453,348,-105
"c20993c944444fe085345591a8bd837e","c76574d21bc14aeea7ecd0b027f39858",22856027,1,20,0,1851,351,367,16
"c76574d21bc14aeea7ecd0b027f39858","eff0de7f2dbb42dfa1a2e686efab5b6d",22856027,1,-17,0,1852,367,354,-13
"c20993c944444fe085345591a8bd837e","2fe14166dc9642c3bc666b86a57f943d",22856027,1,7,0,1862,351,357,6
"2fe14166dc9642c3bc666b86a57f943d","2fe14166dc9642c3bc666b86a57f943d",22856027,11,0,1,1865,357,357,0
"2fe14166dc9642c3bc666b86a57f943d","f60ee41ec635499abd48168342d32c2f",22856027,1,147,0,1876,357,453,96
"b2f0d654738f48158edff28e8d3a546e","f67fbf45a5f146ed866965bc57c7c001",22856027,1,8,0,1922,449,454,5
"c5df9f40ec14463b9dcfdc73df3e9285","f67fbf45a5f146ed866965bc57c7c001",22856027,1,-12,0,1925,464,454,-10
"f60ee41ec635499abd48168342d32c2f","b71bac264efb4abd97015447bd490db6",22856027,1,-129,0,1958,453,370,-83
"b613861cecf84ffcab01afb23f660475","b613861cecf84ffcab01afb23f660475",22877758,4,0,1,1,1,1,0
"b613861cecf84ffcab01afb23f660475","e2911e79efc2420eac45d9f671463d4b",22877758,3,3,0,4,1,2,1
"e2911e79efc2420eac45d9f671463d4b","b613861cecf84ffcab01afb23f660475",22877758,2,-3,0,5,2,1,-1
"e2911e79efc2420eac45d9f671463d4b","e2911e79efc2420eac45d9f671463d4b",22877758,1,0,1,10,2,2,0
"e2911e79efc2420eac45d9f671463d4b","519d1b8c59404d67b54e96c5c8a830b2",22877758,1,1,0,11,2,3,1
"519d1b8c59404d67b54e96c5c8a830b2","519d1b8c59404d67b54e96c5c8a830b2",22877758,1,0,1,12,3,3,0
"519d1b8c59404d67b54e96c5c8a830b2","531db53f81f646edb0cdcfe0085b03b7",22877758,1,1,0,13,3,4,1
"531db53f81f646edb0cdcfe0085b03b7","531db53f81f646edb0cdcfe0085b03b7",22877758,1,0,1,14,4,4,0
"531db53f81f646edb0cdcfe0085b03b7","4f5f94b2f95141e0a9d53a61da2276da",22877758,1,1,0,15,4,5,1
"4f5f94b2f95141e0a9d53a61da2276da","4f5f94b2f95141e0a9d53a61da2276da",22877758,1,0,1,16,5,5,0
"4f5f94b2f95141e0a9d53a61da2276da","6d541c89590949f99af293c4f2333f67",22877758,1,1,0,17,5,6,1
"6d541c89590949f99af293c4f2333f67","6d541c89590949f99af293c4f2333f67",22877758,1,0,1,18,6,6,0
"6d541c89590949f99af293c4f2333f67","dd5cf0b9fe4c4f1d8f5ff8e4c04879cb",22877758,1,1,0,19,6,7,1
"dd5cf0b9fe4c4f1d8f5ff8e4c04879cb","dd5cf0b9fe4c4f1d8f5ff8e4c04879cb",22877758,1,0,1,20,7,7,0
"dd5cf0b9fe4c4f1d8f5ff8e4c04879cb","f96261861edc426abe2248be4f0a709a",22877758,1,1,0,21,7,8,1
"f96261861edc426abe2248be4f0a709a","f96261861edc426abe2248be4f0a709a",22877758,1,0,1,22,8,8,0
"f96261861edc426abe2248be4f0a709a","66b5e16f4f75454fb5b8172079f0fa83",22877758,1,1,0,23,8,9,1
"66b5e16f4f75454fb5b8172079f0fa83","66b5e16f4f75454fb5b8172079f0fa83",22877758,1,0,1,24,9,9,0
"66b5e16f4f75454fb5b8172079f0fa83","0680571d4698477995e41842c36a54b2",22877758,1,1,0,25,9,10,1
"0680571d4698477995e41842c36a54b2","0680571d4698477995e41842c36a54b2",22877758,1,0,1,26,10,10,0
"0680571d4698477995e41842c36a54b2","9112f2bffece48e08c6d2287be204085",22877758,1,1,0,27,10,11,1
"9112f2bffece48e08c6d2287be204085","9112f2bffece48e08c6d2287be204085",22877758,1,0,1,28,11,11,0
"9112f2bffece48e08c6d2287be204085","56586aa865414f538729c7f7735d2bc6",22877758,1,3,0,29,11,12,1
"56586aa865414f538729c7f7735d2bc6","e2911e79efc2420eac45d9f671463d4b",22877758,1,-12,0,30,12,2,-10
"e2911e79efc2420eac45d9f671463d4b","56586aa865414f538729c7f7735d2bc6",22877758,1,12,0,31,2,12,10
"56586aa865414f538729c7f7735d2bc6","56586aa865414f538729c7f7735d2bc6",22877758,2,0,1,32,12,12,0
"56586aa865414f538729c7f7735d2bc6","b7f2b31585d94eb3bf86376714aa7070",22877758,1,2,0,34,12,13,1
"b7f2b31585d94eb3bf86376714aa7070","b7f2b31585d94eb3bf86376714aa7070",22877758,3,0,1,35,13,13,0
"b7f2b31585d94eb3bf86376714aa7070","3f1c815879794b929260d224becaff7e",22877758,2,2,0,36,13,14,1
"3f1c815879794b929260d224becaff7e","b7f2b31585d94eb3bf86376714aa7070",22877758,1,-2,0,37,14,13,-1
"3f1c815879794b929260d224becaff7e","81c864a886d54a6b8ff85f7d736f4f95",22877758,1,2,0,41,14,15,1
"81c864a886d54a6b8ff85f7d736f4f95","5c5ceeee4562457ba6d41515aeebfbb1",22877758,1,4,0,42,15,17,2
"5c5ceeee4562457ba6d41515aeebfbb1","5c5ceeee4562457ba6d41515aeebfbb1",22877758,1,0,1,43,17,17,0
"5c5ceeee4562457ba6d41515aeebfbb1","9afd71a5298d4333b6849dfce1b9422c",22877758,1,3,0,44,17,18,1
"9afd71a5298d4333b6849dfce1b9422c","56586aa865414f538729c7f7735d2bc6",22877758,1,-13,0,45,18,12,-6
"56586aa865414f538729c7f7735d2bc6","b7719e26494940efa49512aedd0aac79",22877758,1,17,0,46,12,20,8
"b7719e26494940efa49512aedd0aac79","9afd71a5298d4333b6849dfce1b9422c",22877758,1,-4,0,47,20,18,-2
"9afd71a5298d4333b6849dfce1b9422c","d4f45188d3c84a02ba08454e6403a818",22877758,1,9,0,48,18,24,6
"d4f45188d3c84a02ba08454e6403a818","d4c3b003e8274e429d2fa688d73fde6d",22877758,1,-2,0,49,24,22,-2
"d4c3b003e8274e429d2fa688d73fde6d","b7719e26494940efa49512aedd0aac79",22877758,1,-3,0,50,22,20,-2
"b7719e26494940efa49512aedd0aac79","d4c3b003e8274e429d2fa688d73fde6d",22877758,1,3,0,51,20,22,2
"d4c3b003e8274e429d2fa688d73fde6d","67a089198fcb4e1c8f2385786c2b296f",22877758,1,37,0,52,22,39,17
"64d48c6c9c7940639a932219a6c87198","64d48c6c9c7940639a932219a6c87198",22877758,2,0,1,54,40,40,0
"64d48c6c9c7940639a932219a6c87198","67a089198fcb4e1c8f2385786c2b296f",22877758,2,-1,0,55,40,39,-1
"64d48c6c9c7940639a932219a6c87198","b534b89233134e30a9b5645138bfa9ee",22877758,1,3,0,60,40,41,1
"b534b89233134e30a9b5645138bfa9ee","67a089198fcb4e1c8f2385786c2b296f",22877758,1,-4,0,61,41,39,-2
"67a089198fcb4e1c8f2385786c2b296f","0e37b720d23b4e7f8b313e79313fd107",22877758,1,7,0,62,39,44,5
"0e37b720d23b4e7f8b313e79313fd107","0e37b720d23b4e7f8b313e79313fd107",22877758,1,0,1,63,44,44,0
"0e37b720d23b4e7f8b313e79313fd107","6875d67fdd5f48168b62719df449bebd",22877758,1,1,0,64,44,45,1
"6875d67fdd5f48168b62719df449bebd","6875d67fdd5f48168b62719df449bebd",22877758,1,0,1,65,45,45,0
"6875d67fdd5f48168b62719df449bebd","b534b89233134e30a9b5645138bfa9ee",22877758,1,-4,0,66,45,41,-4
"b534b89233134e30a9b5645138bfa9ee","6e13d61a7bdb44bca949c9f86fab3be5",22877758,1,7,0,67,41,47,6
"6e13d61a7bdb44bca949c9f86fab3be5","6e13d61a7bdb44bca949c9f86fab3be5",22877758,1,0,1,68,47,47,0
"6e13d61a7bdb44bca949c9f86fab3be5","195f78799f984cc2b06c48dfe36be751",22877758,1,2,0,69,47,49,2
"195f78799f984cc2b06c48dfe36be751","195f78799f984cc2b06c48dfe36be751",22877758,5,0,1,70,49,49,0
"195f78799f984cc2b06c48dfe36be751","d0c74f735e024943943e40333d6d337f",22877758,1,3,0,75,49,51,2
"d0c74f735e024943943e40333d6d337f","d9c8d8c444a64dadbbb508652c721e17",22877758,1,-6,0,76,51,46,-5
"d9c8d8c444a64dadbbb508652c721e17","d0c74f735e024943943e40333d6d337f",22877758,1,6,0,77,46,51,5
"d0c74f735e024943943e40333d6d337f","983f8ff320594b279a7f4a6fe132f9c5",22877758,1,2,0,78,51,53,2
"983f8ff320594b279a7f4a6fe132f9c5","983f8ff320594b279a7f4a6fe132f9c5",22877758,2,0,1,79,53,53,0
"983f8ff320594b279a7f4a6fe132f9c5","35adfa5d923046aebabfefd98f35ff05",22877758,1,1,0,81,53,54,1
"35adfa5d923046aebabfefd98f35ff05","35adfa5d923046aebabfefd98f35ff05",22877758,2,0,1,82,54,54,0
"35adfa5d923046aebabfefd98f35ff05","b6f8a98476224da1b40e555ececc7ed8",22877758,1,1,0,84,54,55,1
"b6f8a98476224da1b40e555ececc7ed8","b6f8a98476224da1b40e555ececc7ed8",22877758,5,0,1,85,55,55,0
"b6f8a98476224da1b40e555ececc7ed8","86e22cb5fe0e4b47a9489ecddf7ed78f",22877758,1,1,0,90,55,56,1
"86e22cb5fe0e4b47a9489ecddf7ed78f","86e22cb5fe0e4b47a9489ecddf7ed78f",22877758,2,0,1,91,56,56,0
"86e22cb5fe0e4b47a9489ecddf7ed78f","f924752d8a1149668870b1e7698486f7",22877758,1,-6,0,93,56,50,-6
"f924752d8a1149668870b1e7698486f7","a1f2f12debe5432fb7a70bcd12bacfb9",22877758,1,9,0,94,50,58,8
"78f30e4dcac84e3cbea8b2cc6e0d62b3","12aa6e1672ac4e7aa6449a7a8609cd72",22877758,1,-2,0,96,59,57,-2
"12aa6e1672ac4e7aa6449a7a8609cd72","bc42d26810654ea9a1df1efe1e58c7d5",22877758,1,7,0,97,57,63,6
"bc42d26810654ea9a1df1efe1e58c7d5","a0a418b8540d479fa6e0f653b701da8b",22877758,1,1,0,98,63,64,1
"a0a418b8540d479fa6e0f653b701da8b","bc42d26810654ea9a1df1efe1e58c7d5",22877758,1,-1,0,99,64,63,-1
"bc42d26810654ea9a1df1efe1e58c7d5","bc42d26810654ea9a1df1efe1e58c7d5",22877758,5,0,1,100,63,63,0
"bc42d26810654ea9a1df1efe1e58c7d5","309ccf3cc4fe429d9bfbaef53d3fa479",22877758,1,-3,0,103,63,60,-3
"309ccf3cc4fe429d9bfbaef53d3fa479","b534b89233134e30a9b5645138bfa9ee",22877758,2,-23,0,104,60,41,-19
"b534b89233134e30a9b5645138bfa9ee","d646286c8051419bbc2e31dd1db55ca8",22877758,2,33,0,105,41,67,26
"d646286c8051419bbc2e31dd1db55ca8","267f883678b24aed855fde42524975d9",22877758,1,4,0,106,67,71,4
"267f883678b24aed855fde42524975d9","267f883678b24aed855fde42524975d9",22877758,1,0,1,107,71,71,0
"267f883678b24aed855fde42524975d9","88fff56d0342490dbef9040750a20f6c",22877758,1,1,0,108,71,72,1
"88fff56d0342490dbef9040750a20f6c","88fff56d0342490dbef9040750a20f6c",22877758,1,0,1,109,72,72,0
"88fff56d0342490dbef9040750a20f6c","adb17b12b66c4a49a85fd34322f7df70",22877758,1,1,0,110,72,73,1
"adb17b12b66c4a49a85fd34322f7df70","adb17b12b66c4a49a85fd34322f7df70",22877758,1,0,1,111,73,73,0
"adb17b12b66c4a49a85fd34322f7df70","d646286c8051419bbc2e31dd1db55ca8",22877758,1,-6,0,112,73,67,-6
"d646286c8051419bbc2e31dd1db55ca8","a2becd407db34b189200a32546d9d569",22877758,2,9,0,113,67,75,8
"a2becd407db34b189200a32546d9d569","a2becd407db34b189200a32546d9d569",22877758,2,0,1,114,75,75,0
"a2becd407db34b189200a32546d9d569","dd76e1861dc9461c830888729d091ee0",22877758,1,3,0,115,75,78,3
"dd76e1861dc9461c830888729d091ee0","dd76e1861dc9461c830888729d091ee0",22877758,8,0,1,116,78,78,0
"dd76e1861dc9461c830888729d091ee0","cd1d828f1a694b87913a7ea66c23803e",22877758,1,1,0,124,78,79,1
"cd1d828f1a694b87913a7ea66c23803e","cd1d828f1a694b87913a7ea66c23803e",22877758,2,0,1,125,79,79,0
"cd1d828f1a694b87913a7ea66c23803e","9176a3c2b4d2465fa8b0c67096c2a97e",22877758,1,1,0,127,79,80,1
"9176a3c2b4d2465fa8b0c67096c2a97e","9176a3c2b4d2465fa8b0c67096c2a97e",22877758,5,0,1,128,80,80,0
"9176a3c2b4d2465fa8b0c67096c2a97e","f8ec6445f7194e25b9101d4fbcb07a18",22877758,1,1,0,133,80,81,1
"f8ec6445f7194e25b9101d4fbcb07a18","f8ec6445f7194e25b9101d4fbcb07a18",22877758,2,0,1,134,81,81,0
"f8ec6445f7194e25b9101d4fbcb07a18","58c22b011d0f4c2ea6d13615edbb9eeb",22877758,1,-4,0,136,81,77,-4
"58c22b011d0f4c2ea6d13615edbb9eeb","58c22b011d0f4c2ea6d13615edbb9eeb",22877758,2,0,1,137,77,77,0
"58c22b011d0f4c2ea6d13615edbb9eeb","140d5b27b8574befad82c0a013b59dfa",22877758,1,-3,0,139,77,74,-3
"140d5b27b8574befad82c0a013b59dfa","d18a9ea32855445f8736581f5cb119ce",22877758,2,9,0,140,74,82,8
"d18a9ea32855445f8736581f5cb119ce","f564483cbd7a407681aa2fcca518cf5f",22877758,1,4,0,141,82,85,3
"f564483cbd7a407681aa2fcca518cf5f","f564483cbd7a407681aa2fcca518cf5f",22877758,11,0,1,142,85,85,0
"f564483cbd7a407681aa2fcca518cf5f","18fd01350bd5434ca636d59a599d768a",22877758,1,1,0,153,85,86,1
"18fd01350bd5434ca636d59a599d768a","18fd01350bd5434ca636d59a599d768a",22877758,7,0,1,154,86,86,0
"18fd01350bd5434ca636d59a599d768a","d646286c8051419bbc2e31dd1db55ca8",22877758,1,-22,0,159,86,67,-19
"d646286c8051419bbc2e31dd1db55ca8","d646286c8051419bbc2e31dd1db55ca8",22877758,4,0,1,160,67,67,0
"a2becd407db34b189200a32546d9d569","140d5b27b8574befad82c0a013b59dfa",22877758,1,-1,0,163,75,74,-1
"d18a9ea32855445f8736581f5cb119ce","18fd01350bd5434ca636d59a599d768a",22877758,1,5,0,165,82,86,4
"18fd01350bd5434ca636d59a599d768a","ae5ac430ea254e708a6f5deaaf7464ae",22877758,1,-2,0,168,86,84,-2
"ae5ac430ea254e708a6f5deaaf7464ae","6a9f0ef185fb47f0937e29daa1c71ed5",22877758,1,7,0,169,84,90,6
"6a9f0ef185fb47f0937e29daa1c71ed5","c681290961c94c4caf23b529d1ae6b9a",22877758,1,-2,0,170,90,88,-2
"c681290961c94c4caf23b529d1ae6b9a","c681290961c94c4caf23b529d1ae6b9a",22877758,1,0,1,171,88,88,0
"c681290961c94c4caf23b529d1ae6b9a","6a9f0ef185fb47f0937e29daa1c71ed5",22877758,1,2,0,172,88,90,2
"6a9f0ef185fb47f0937e29daa1c71ed5","6a9f0ef185fb47f0937e29daa1c71ed5",22877758,7,0,1,173,90,90,0
"6a9f0ef185fb47f0937e29daa1c71ed5","d646286c8051419bbc2e31dd1db55ca8",22877758,2,-27,0,176,90,67,-23
"d646286c8051419bbc2e31dd1db55ca8","e20db35ced8544ddac5bc3839145e463",22877758,2,30,0,177,67,91,24
"e20db35ced8544ddac5bc3839145e463","1febb706d7a34005ae8711ed49c76e64",22877758,1,3,0,178,91,94,3
"1febb706d7a34005ae8711ed49c76e64","1febb706d7a34005ae8711ed49c76e64",22877758,2,0,1,179,94,94,0
"1febb706d7a34005ae8711ed49c76e64","8f73ba6f5a0042f2850356ac38ac6f24",22877758,1,1,0,181,94,95,1
"8f73ba6f5a0042f2850356ac38ac6f24","8f73ba6f5a0042f2850356ac38ac6f24",22877758,5,0,1,182,95,95,0
"8f73ba6f5a0042f2850356ac38ac6f24","e2260b86653c46d7b14a41fb419dbf8c",22877758,1,1,0,187,95,96,1
"e2260b86653c46d7b14a41fb419dbf8c","e2260b86653c46d7b14a41fb419dbf8c",22877758,2,0,1,188,96,96,0
"e2260b86653c46d7b14a41fb419dbf8c","35eb641ad1d845bbba54915bce75a962",22877758,1,1,0,190,96,97,1
"35eb641ad1d845bbba54915bce75a962","35eb641ad1d845bbba54915bce75a962",22877758,5,0,1,191,97,97,0
"35eb641ad1d845bbba54915bce75a962","08be90ffbeea4795a138cd42ed8db56f",22877758,1,1,0,196,97,98,1
"08be90ffbeea4795a138cd42ed8db56f","08be90ffbeea4795a138cd42ed8db56f",22877758,5,0,1,197,98,98,0
"08be90ffbeea4795a138cd42ed8db56f","3007433c8f584dcbb5ac159c1c5f2be3",22877758,1,1,0,202,98,99,1
"3007433c8f584dcbb5ac159c1c5f2be3","3007433c8f584dcbb5ac159c1c5f2be3",22877758,2,0,1,203,99,99,0
"3007433c8f584dcbb5ac159c1c5f2be3","00ae5f0c51874a73a41ebea838d95682",22877758,1,3,0,205,99,101,2
"00ae5f0c51874a73a41ebea838d95682","e20db35ced8544ddac5bc3839145e463",22877758,1,-11,0,206,101,91,-10
"e20db35ced8544ddac5bc3839145e463","d391c8b6e56a43a7b654e9dee02d904b",22877758,1,13,0,207,91,103,12
"d391c8b6e56a43a7b654e9dee02d904b","00ae5f0c51874a73a41ebea838d95682",22877758,1,-2,0,208,103,101,-2
"00ae5f0c51874a73a41ebea838d95682","d391c8b6e56a43a7b654e9dee02d904b",22877758,1,2,0,209,101,103,2
"d391c8b6e56a43a7b654e9dee02d904b","d391c8b6e56a43a7b654e9dee02d904b",22877758,15,0,1,210,103,103,0
"d391c8b6e56a43a7b654e9dee02d904b","6111116566fc4fd9abba409322bea245",22877758,1,1,0,225,103,104,1
"6111116566fc4fd9abba409322bea245","6111116566fc4fd9abba409322bea245",22877758,2,0,1,226,104,104,0
"6111116566fc4fd9abba409322bea245","a81b2235cb9c499eb9ea8ee0a8dd9725",22877758,1,1,0,228,104,105,1
"a81b2235cb9c499eb9ea8ee0a8dd9725","a81b2235cb9c499eb9ea8ee0a8dd9725",22877758,5,0,1,229,105,105,0
"a81b2235cb9c499eb9ea8ee0a8dd9725","2d4e0ab0ef3b4d73b82c72d4621a7579",22877758,1,1,0,234,105,106,1
"2d4e0ab0ef3b4d73b82c72d4621a7579","2d4e0ab0ef3b4d73b82c72d4621a7579",22877758,2,0,1,235,106,106,0
"2d4e0ab0ef3b4d73b82c72d4621a7579","8bdebf492ebd4e62b0d522e8ab5e5197",22877758,1,1,0,237,106,107,1
"8bdebf492ebd4e62b0d522e8ab5e5197","8bdebf492ebd4e62b0d522e8ab5e5197",22877758,2,0,1,238,107,107,0
"8bdebf492ebd4e62b0d522e8ab5e5197","4280927ec4d643238aa49c32f9e06c6c",22877758,1,3,0,240,107,109,2
"4280927ec4d643238aa49c32f9e06c6c","73039f8c1eb9409cb4caee2cf968001e",22877758,1,-10,0,241,109,100,-9
"73039f8c1eb9409cb4caee2cf968001e","4280927ec4d643238aa49c32f9e06c6c",22877758,1,10,0,242,100,109,9
"4280927ec4d643238aa49c32f9e06c6c","fc44e6a5f7654430af1227838224dceb",22877758,1,2,0,243,109,111,2
"fc44e6a5f7654430af1227838224dceb","fc44e6a5f7654430af1227838224dceb",22877758,2,0,1,244,111,111,0
"fc44e6a5f7654430af1227838224dceb","08111f75e22d409998cf8b85bd431f0a",22877758,1,-3,0,246,111,108,-3
"08111f75e22d409998cf8b85bd431f0a","a9ae0a3c070d455bb4369a8996313336",22877758,1,7,0,247,108,114,6
"a9ae0a3c070d455bb4369a8996313336","a9ae0a3c070d455bb4369a8996313336",22877758,1,0,1,248,114,114,0
"a9ae0a3c070d455bb4369a8996313336","4280927ec4d643238aa49c32f9e06c6c",22877758,1,-6,0,249,114,109,-5
"4280927ec4d643238aa49c32f9e06c6c","37319e88176d4aefa91d7a9980dbae91",22877758,1,4,0,250,109,112,3
"37319e88176d4aefa91d7a9980dbae91","08111f75e22d409998cf8b85bd431f0a",22877758,1,-5,0,251,112,108,-4
"08111f75e22d409998cf8b85bd431f0a","e20db35ced8544ddac5bc3839145e463",22877758,1,-19,0,252,108,91,-17
"e20db35ced8544ddac5bc3839145e463","73039f8c1eb9409cb4caee2cf968001e",22877758,1,10,0,253,91,100,9
"73039f8c1eb9409cb4caee2cf968001e","00ae5f0c51874a73a41ebea838d95682",22877758,1,1,0,254,100,101,1
"00ae5f0c51874a73a41ebea838d95682","d646286c8051419bbc2e31dd1db55ca8",22877758,1,-41,0,255,101,67,-34
"d646286c8051419bbc2e31dd1db55ca8","6a9f0ef185fb47f0937e29daa1c71ed5",22877758,2,27,0,258,67,90,23
"6a9f0ef185fb47f0937e29daa1c71ed5","b534b89233134e30a9b5645138bfa9ee",22877758,1,-60,0,261,90,41,-49
"b534b89233134e30a9b5645138bfa9ee","a1f2f12debe5432fb7a70bcd12bacfb9",22877758,1,20,0,262,41,58,17
"a1f2f12debe5432fb7a70bcd12bacfb9","78f30e4dcac84e3cbea8b2cc6e0d62b3",22877758,3,1,0,263,58,59,1
"78f30e4dcac84e3cbea8b2cc6e0d62b3","a1f2f12debe5432fb7a70bcd12bacfb9",22877758,1,-1,0,264,59,58,-1
"a1f2f12debe5432fb7a70bcd12bacfb9","a1f2f12debe5432fb7a70bcd12bacfb9",22877758,17,0,1,265,58,58,0
"78f30e4dcac84e3cbea8b2cc6e0d62b3","78f30e4dcac84e3cbea8b2cc6e0d62b3",22877758,15,0,1,283,59,59,0
"78f30e4dcac84e3cbea8b2cc6e0d62b3","bc42d26810654ea9a1df1efe1e58c7d5",22877758,1,5,0,298,59,63,4
"bc42d26810654ea9a1df1efe1e58c7d5","12aa6e1672ac4e7aa6449a7a8609cd72",22877758,1,-7,0,301,63,57,-6
"12aa6e1672ac4e7aa6449a7a8609cd72","a0a418b8540d479fa6e0f653b701da8b",22877758,1,8,0,302,57,64,7
"a0a418b8540d479fa6e0f653b701da8b","4c943503763e4e349906eea3ed3c8e86",22877758,1,-3,0,303,64,61,-3
"4c943503763e4e349906eea3ed3c8e86","4c943503763e4e349906eea3ed3c8e86",22877758,4,0,1,304,61,61,0
"4c943503763e4e349906eea3ed3c8e86","a0a418b8540d479fa6e0f653b701da8b",22877758,1,3,0,308,61,64,3
"a0a418b8540d479fa6e0f653b701da8b","a0a418b8540d479fa6e0f653b701da8b",22877758,3,0,1,309,64,64,0
"a0a418b8540d479fa6e0f653b701da8b","309ccf3cc4fe429d9bfbaef53d3fa479",22877758,1,-4,0,312,64,60,-4
"e20db35ced8544ddac5bc3839145e463","e20db35ced8544ddac5bc3839145e463",22877758,1,0,1,321,91,91,0
"e20db35ced8544ddac5bc3839145e463","a9ae0a3c070d455bb4369a8996313336",22877758,1,26,0,322,91,114,23
"a9ae0a3c070d455bb4369a8996313336","71cec822bcff4f30a20e75dc63ef7b65",22877758,1,2,0,323,114,116,2
"71cec822bcff4f30a20e75dc63ef7b65","71cec822bcff4f30a20e75dc63ef7b65",22877758,1,0,1,324,116,116,0
"71cec822bcff4f30a20e75dc63ef7b65","37319e88176d4aefa91d7a9980dbae91",22877758,1,-4,0,325,116,112,-4
"37319e88176d4aefa91d7a9980dbae91","62bff51286ef4f348717a3cf6fe2318f",22877758,1,9,0,326,112,120,8
"62bff51286ef4f348717a3cf6fe2318f","62bff51286ef4f348717a3cf6fe2318f",22877758,4,0,1,327,120,120,0
"62bff51286ef4f348717a3cf6fe2318f","b1cd0e7dc3ad4a8eb91a4bfdbeb025b0",22877758,1,-2,0,331,120,118,-2
"b1cd0e7dc3ad4a8eb91a4bfdbeb025b0","b1cd0e7dc3ad4a8eb91a4bfdbeb025b0",22877758,1,0,1,332,118,118,0
"b1cd0e7dc3ad4a8eb91a4bfdbeb025b0","e20db35ced8544ddac5bc3839145e463",22877758,1,-31,0,333,118,91,-27
"e20db35ced8544ddac5bc3839145e463","779f9ddd1fd14d1e9e69f72219a1fdbd",22877758,1,36,0,334,91,121,30
"779f9ddd1fd14d1e9e69f72219a1fdbd","ae26e6cda8ad4a3f81bd347560d9579f",22877758,1,4,0,335,121,125,4
"ae26e6cda8ad4a3f81bd347560d9579f","ae26e6cda8ad4a3f81bd347560d9579f",22877758,1,0,1,336,125,125,0
"ae26e6cda8ad4a3f81bd347560d9579f","ee48df95832b4374aa273ceb27ec1315",22877758,1,1,0,337,125,126,1
"ee48df95832b4374aa273ceb27ec1315","ee48df95832b4374aa273ceb27ec1315",22877758,1,0,1,338,126,126,0
"ee48df95832b4374aa273ceb27ec1315","7a439da90b394756ad1777fc4c6dead5",22877758,1,1,0,339,126,127,1
"7a439da90b394756ad1777fc4c6dead5","7a439da90b394756ad1777fc4c6dead5",22877758,1,0,1,340,127,127,0
"7a439da90b394756ad1777fc4c6dead5","779f9ddd1fd14d1e9e69f72219a1fdbd",22877758,1,-6,0,341,127,121,-6
"779f9ddd1fd14d1e9e69f72219a1fdbd","a8dd5213034441ac92724b4e83eb0bb2",22877758,1,9,0,342,121,129,8
"a8dd5213034441ac92724b4e83eb0bb2","a8dd5213034441ac92724b4e83eb0bb2",22877758,1,0,1,343,129,129,0
"a8dd5213034441ac92724b4e83eb0bb2","8115eab6556b45f5b415c3b8c26a12e5",22877758,1,2,0,344,129,131,2
"8115eab6556b45f5b415c3b8c26a12e5","8115eab6556b45f5b415c3b8c26a12e5",22877758,2,0,1,345,131,131,0
"8115eab6556b45f5b415c3b8c26a12e5","ec34b06efd844b46a4c4818ecdb9b8f4",22877758,1,1,0,347,131,132,1
"ec34b06efd844b46a4c4818ecdb9b8f4","ec34b06efd844b46a4c4818ecdb9b8f4",22877758,2,0,1,348,132,132,0
"ec34b06efd844b46a4c4818ecdb9b8f4","c2e1c2b9eac64109b343a088584b576b",22877758,1,1,0,350,132,133,1
"c2e1c2b9eac64109b343a088584b576b","c2e1c2b9eac64109b343a088584b576b",22877758,2,0,1,351,133,133,0
"c2e1c2b9eac64109b343a088584b576b","579338175e0b4bbb8ef3b712b5d8b54e",22877758,1,-5,0,353,133,128,-5
"579338175e0b4bbb8ef3b712b5d8b54e","8bc5795d6a984a3eace4e2811e52dd4f",22877758,1,8,0,354,128,135,7
"8bc5795d6a984a3eace4e2811e52dd4f","8bc5795d6a984a3eace4e2811e52dd4f",22877758,1,0,1,355,135,135,0
"8bc5795d6a984a3eace4e2811e52dd4f","b416d47c56a742199b5d7c7f19d6503a",22877758,1,-1,0,356,135,134,-1
"b416d47c56a742199b5d7c7f19d6503a","cd4532ad48034873ba8bce2aac0c9808",22877758,1,4,0,357,134,137,3
"cd4532ad48034873ba8bce2aac0c9808","cd4532ad48034873ba8bce2aac0c9808",22877758,1,0,1,358,137,137,0
"cd4532ad48034873ba8bce2aac0c9808","779f9ddd1fd14d1e9e69f72219a1fdbd",22877758,1,-19,0,359,137,121,-16
"779f9ddd1fd14d1e9e69f72219a1fdbd","df1de691dafe4549a18a4398ee9dfaf9",22877758,1,23,0,360,121,139,18
"6c5ad271a44743479bfaea29b1db8d02","83d311bed5374fee83d8d67a7d9d82dc",22877758,1,1,0,362,143,144,1
"83d311bed5374fee83d8d67a7d9d82dc","83d311bed5374fee83d8d67a7d9d82dc",22877758,1,0,1,363,144,144,0
"83d311bed5374fee83d8d67a7d9d82dc","402bba41861d43acb52a5abb89e8831e",22877758,1,1,0,364,144,145,1
"402bba41861d43acb52a5abb89e8831e","402bba41861d43acb52a5abb89e8831e",22877758,2,0,1,365,145,145,0
"402bba41861d43acb52a5abb89e8831e","df1de691dafe4549a18a4398ee9dfaf9",22877758,1,-6,0,367,145,139,-6
"df1de691dafe4549a18a4398ee9dfaf9","8aae34f5ddbb4052a709b12e6b0d40fa",22877758,3,9,0,368,139,147,8
"8aae34f5ddbb4052a709b12e6b0d40fa","645b3f0249f64f76af2e19eb4d0e55b7",22877758,1,2,0,369,147,149,2
"645b3f0249f64f76af2e19eb4d0e55b7","645b3f0249f64f76af2e19eb4d0e55b7",22877758,5,0,1,370,149,149,0
"645b3f0249f64f76af2e19eb4d0e55b7","7e7b8db5064d4369805ab370aac5ddfb",22877758,1,1,0,375,149,150,1
"7e7b8db5064d4369805ab370aac5ddfb","7e7b8db5064d4369805ab370aac5ddfb",22877758,2,0,1,376,150,150,0
"7e7b8db5064d4369805ab370aac5ddfb","8956d210ae7f41968fada86d4c979d6a",22877758,1,1,0,378,150,151,1
"8956d210ae7f41968fada86d4c979d6a","8956d210ae7f41968fada86d4c979d6a",22877758,2,0,1,379,151,151,0
"8956d210ae7f41968fada86d4c979d6a","f902b0f41b544d4dbf79664fd233648d",22877758,1,-5,0,381,151,146,-5
"f902b0f41b544d4dbf79664fd233648d","ae781e8b775e4ccd93bc800dad5c8376",22877758,1,8,0,382,146,153,7
"ae781e8b775e4ccd93bc800dad5c8376","ae781e8b775e4ccd93bc800dad5c8376",22877758,5,0,1,383,153,153,0
"ae781e8b775e4ccd93bc800dad5c8376","06882a8492d9499aa31555567f575ecb",22877758,1,1,0,388,153,154,1
"06882a8492d9499aa31555567f575ecb","06882a8492d9499aa31555567f575ecb",22877758,1,0,1,389,154,154,0
"06882a8492d9499aa31555567f575ecb","f293c508f409466a8f27ddd7d1e40b20",22877758,1,1,0,390,154,155,1
"f293c508f409466a8f27ddd7d1e40b20","f293c508f409466a8f27ddd7d1e40b20",22877758,2,0,1,391,155,155,0
"f293c508f409466a8f27ddd7d1e40b20","df1de691dafe4549a18a4398ee9dfaf9",22877758,1,-18,0,393,155,139,-16
"6c5ad271a44743479bfaea29b1db8d02","df1de691dafe4549a18a4398ee9dfaf9",22877758,2,-4,0,395,143,139,-4
"8aae34f5ddbb4052a709b12e6b0d40fa","8aae34f5ddbb4052a709b12e6b0d40fa",22877758,1,0,1,397,147,147,0
"8aae34f5ddbb4052a709b12e6b0d40fa","f902b0f41b544d4dbf79664fd233648d",22877758,2,-1,0,398,147,146,-1
"f902b0f41b544d4dbf79664fd233648d","cc4ddef5bbbe48ebb605141b347c4ed1",22877758,1,11,0,399,146,156,10
"cc4ddef5bbbe48ebb605141b347c4ed1","cc4ddef5bbbe48ebb605141b347c4ed1",22877758,3,0,1,400,156,156,0
"cc4ddef5bbbe48ebb605141b347c4ed1","f03480cf4eba413194d7af52fc0e7f28",22877758,1,-4,0,403,156,152,-4
"f03480cf4eba413194d7af52fc0e7f28","d313cec988a84645bee413e8d4724a4b",22877758,2,7,0,404,152,158,6
"d313cec988a84645bee413e8d4724a4b","d313cec988a84645bee413e8d4724a4b",22877758,5,0,1,405,158,158,0
"d313cec988a84645bee413e8d4724a4b","dc60696c76a74368a60f72246e47700d",22877758,1,1,0,409,158,159,1
"dc60696c76a74368a60f72246e47700d","dc60696c76a74368a60f72246e47700d",22877758,3,0,1,410,159,159,0
"dc60696c76a74368a60f72246e47700d","df1de691dafe4549a18a4398ee9dfaf9",22877758,1,-23,0,413,159,139,-20
"df1de691dafe4549a18a4398ee9dfaf9","78adeee1fa2c4fe0bc73f7bca9fcee86",22877758,1,26,0,414,139,160,21
"78adeee1fa2c4fe0bc73f7bca9fcee86","78adeee1fa2c4fe0bc73f7bca9fcee86",22877758,6,0,1,415,160,160,0
"65202579580f4ad38d734b4ee39d22a8","78adeee1fa2c4fe0bc73f7bca9fcee86",22877758,5,-5,0,422,164,160,-4
"78adeee1fa2c4fe0bc73f7bca9fcee86","0c7262dff33c4087bc660ccf40f92f9c",22877758,1,17,0,430,160,169,9
"0c7262dff33c4087bc660ccf40f92f9c","b2275c3fad834f8d90737a2d9a6927d6",22877758,2,3,0,431,169,172,3
"b2275c3fad834f8d90737a2d9a6927d6","b2275c3fad834f8d90737a2d9a6927d6",22877758,30,0,1,432,172,172,0
"b2275c3fad834f8d90737a2d9a6927d6","eb515a26030b41f8a82a1e6114420bad",22877758,1,1,0,462,172,173,1
"eb515a26030b41f8a82a1e6114420bad","eb515a26030b41f8a82a1e6114420bad",22877758,2,0,1,463,173,173,0
"eb515a26030b41f8a82a1e6114420bad","0c7262dff33c4087bc660ccf40f92f9c",22877758,1,-4,0,465,173,169,-4
"0c7262dff33c4087bc660ccf40f92f9c","b42cc17b7de840f181a704558d0bc845",22877758,3,7,0,466,169,175,6
"b42cc17b7de840f181a704558d0bc845","801f9e9135034f49bf5f8b4bdefedb41",22877758,1,2,0,467,175,177,2
"801f9e9135034f49bf5f8b4bdefedb41","801f9e9135034f49bf5f8b4bdefedb41",22877758,7,0,1,468,177,177,0
"801f9e9135034f49bf5f8b4bdefedb41","362fcb0699a14845ab29b2340093e528",22877758,1,-3,0,475,177,174,-3
"362fcb0699a14845ab29b2340093e528","ea38cc0e6e6e41edbabf210220808bf9",22877758,3,6,0,476,174,179,5
"ea38cc0e6e6e41edbabf210220808bf9","b87c552dd247427abe6ab5795b9c9d43",22877758,3,2,0,477,179,181,2
"b87c552dd247427abe6ab5795b9c9d43","b87c552dd247427abe6ab5795b9c9d43",22877758,8,0,1,478,181,181,0
"b87c552dd247427abe6ab5795b9c9d43","139b097acfca451689d80c9c6eebdf7b",22877758,3,-3,0,486,181,178,-3
"139b097acfca451689d80c9c6eebdf7b","30f660a1feb34582a739722532524f79",22877758,1,6,0,487,178,183,5
"30f660a1feb34582a739722532524f79","30f660a1feb34582a739722532524f79",22877758,5,0,1,488,183,183,0
"30f660a1feb34582a739722532524f79","2024b4885bd14338a39b7b509acbbd02",22877758,1,-1,0,493,183,182,-1
"2024b4885bd14338a39b7b509acbbd02","c3f63fe50d8e487c86bf8ef76c9cadd3",22877758,1,4,0,494,182,185,3
"c3f63fe50d8e487c86bf8ef76c9cadd3","c3f63fe50d8e487c86bf8ef76c9cadd3",22877758,1,0,1,495,185,185,0
"c3f63fe50d8e487c86bf8ef76c9cadd3","0c7262dff33c4087bc660ccf40f92f9c",22877758,1,-20,0,496,185,169,-16
"c8e371568a0c4391b25796ae4e91952e","7d932b23e1c84326ae5aa4d3c0d813d1",22877758,1,2,0,498,186,188,2
"7d932b23e1c84326ae5aa4d3c0d813d1","7d932b23e1c84326ae5aa4d3c0d813d1",22877758,1,0,1,499,188,188,0
"7d932b23e1c84326ae5aa4d3c0d813d1","c8e371568a0c4391b25796ae4e91952e",22877758,1,-2,0,500,188,186,-2
"c8e371568a0c4391b25796ae4e91952e","ab11d94c6c8948ea90b88f19d2cd502b",22877758,4,5,0,501,186,190,4
"ab11d94c6c8948ea90b88f19d2cd502b","f992451ed6ad4e68bb9e68ad6be7c4be",22877758,1,2,0,502,190,192,2
"f992451ed6ad4e68bb9e68ad6be7c4be","f992451ed6ad4e68bb9e68ad6be7c4be",22877758,5,0,1,503,192,192,0
"f992451ed6ad4e68bb9e68ad6be7c4be","6cd2dcaac46847d4a0bc53f296d90375",22877758,1,3,0,508,192,194,2
"6cd2dcaac46847d4a0bc53f296d90375","07b44a7a51e94c78b411c753fc39dab0",22877758,3,-6,0,509,194,189,-5
"07b44a7a51e94c78b411c753fc39dab0","2d2580c9411c4972909db508d6956a58",22877758,1,8,0,510,189,196,7
"2d2580c9411c4972909db508d6956a58","2d2580c9411c4972909db508d6956a58",22877758,5,0,1,511,196,196,0
"2d2580c9411c4972909db508d6956a58","5bddb3d9ed264f3984702f048c7e5340",22877758,1,1,0,516,196,197,1
"5bddb3d9ed264f3984702f048c7e5340","5bddb3d9ed264f3984702f048c7e5340",22877758,2,0,1,517,197,197,0
"5bddb3d9ed264f3984702f048c7e5340","d5e8e2bd12a2466b9d6d90855f0eb079",22877758,1,1,0,519,197,198,1
"d5e8e2bd12a2466b9d6d90855f0eb079","d5e8e2bd12a2466b9d6d90855f0eb079",22877758,2,0,1,520,198,198,0
"d5e8e2bd12a2466b9d6d90855f0eb079","017d7ca8e0394b91aaadc9574df2202c",22877758,1,-5,0,522,198,193,-5
"017d7ca8e0394b91aaadc9574df2202c","54e8e9f0ea3e45c4bf3b8ac799ee31b1",22877758,1,8,0,523,193,200,7
"54e8e9f0ea3e45c4bf3b8ac799ee31b1","54e8e9f0ea3e45c4bf3b8ac799ee31b1",22877758,1,0,1,524,200,200,0
"54e8e9f0ea3e45c4bf3b8ac799ee31b1","0c7262dff33c4087bc660ccf40f92f9c",22877758,1,-40,0,525,200,169,-31
"ab11d94c6c8948ea90b88f19d2cd502b","c8e371568a0c4391b25796ae4e91952e",22877758,4,-5,0,529,190,186,-4
"c8e371568a0c4391b25796ae4e91952e","6cd2dcaac46847d4a0bc53f296d90375",22877758,2,10,0,530,186,194,8
"07b44a7a51e94c78b411c753fc39dab0","017d7ca8e0394b91aaadc9574df2202c",22877758,2,5,0,532,189,193,4
"017d7ca8e0394b91aaadc9574df2202c","c614a00911be4877a075f19315530fb0",22877758,1,9,0,533,193,201,8
"c614a00911be4877a075f19315530fb0","c614a00911be4877a075f19315530fb0",22877758,6,0,1,534,201,201,0
"c614a00911be4877a075f19315530fb0","a6c21bd8b95249c7972820a7a7d76aff",22877758,1,1,0,540,201,202,1
"a6c21bd8b95249c7972820a7a7d76aff","a6c21bd8b95249c7972820a7a7d76aff",22877758,1,0,1,541,202,202,0
"a6c21bd8b95249c7972820a7a7d76aff","bb329d880ab54120adaf203a693bb203",22877758,1,1,0,542,202,203,1
"bb329d880ab54120adaf203a693bb203","bb329d880ab54120adaf203a693bb203",22877758,1,0,1,543,203,203,0
"bb329d880ab54120adaf203a693bb203","f9170dd6bc6442b4acd832747609b09a",22877758,1,-4,0,544,203,199,-4
"f9170dd6bc6442b4acd832747609b09a","334c2344009840079b1d0e1b7ce3d5a7",22877758,1,7,0,545,199,205,6
"334c2344009840079b1d0e1b7ce3d5a7","334c2344009840079b1d0e1b7ce3d5a7",22877758,1,0,1,546,205,205,0
"334c2344009840079b1d0e1b7ce3d5a7","d7f13c8d63ec4e2aa673fbb9cf9c6933",22877758,1,3,0,547,205,206,1
"d7f13c8d63ec4e2aa673fbb9cf9c6933","c8e371568a0c4391b25796ae4e91952e",22877758,2,-26,0,548,206,186,-20
"c8e371568a0c4391b25796ae4e91952e","b9e80f77c3a44349863b19875725c384",22877758,2,27,0,549,186,207,21
"7108f0e4c2584f1f9c471689ae4c885c","b9e80f77c3a44349863b19875725c384",22877758,3,-1,0,551,208,207,-1
"b9e80f77c3a44349863b19875725c384","b9e80f77c3a44349863b19875725c384",22877758,17,0,1,552,207,207,0
"b9e80f77c3a44349863b19875725c384","78adeee1fa2c4fe0bc73f7bca9fcee86",22877758,1,-67,0,569,207,160,-47
"78adeee1fa2c4fe0bc73f7bca9fcee86","c8e371568a0c4391b25796ae4e91952e",22877758,1,40,0,570,160,186,26
"7108f0e4c2584f1f9c471689ae4c885c","7108f0e4c2584f1f9c471689ae4c885c",22877758,15,0,1,574,208,208,0
"7108f0e4c2584f1f9c471689ae4c885c","09400e101c5d4b439cf9a26b03aae558",22877758,3,3,0,589,208,210,2
"09400e101c5d4b439cf9a26b03aae558","d7f13c8d63ec4e2aa673fbb9cf9c6933",22877758,4,-5,0,590,210,206,-4
"d7f13c8d63ec4e2aa673fbb9cf9c6933","a88efa7e50ce47159810ab553afa6d3a",22877758,1,7,0,591,206,212,6
"a88efa7e50ce47159810ab553afa6d3a","a88efa7e50ce47159810ab553afa6d3a",22877758,2,0,1,592,212,212,0
"a88efa7e50ce47159810ab553afa6d3a","be502a7a43c44bf7b682698de79d9369",22877758,1,3,0,594,212,214,2
"be502a7a43c44bf7b682698de79d9369","a875096404ef4a9984b62d74cda916f9",22877758,2,-6,0,595,214,209,-5
"a875096404ef4a9984b62d74cda916f9","f7fb1952f56b4189b86a9f8b7862d2b8",22877758,3,7,0,596,209,215,6
"f7fb1952f56b4189b86a9f8b7862d2b8","0c7262dff33c4087bc660ccf40f92f9c",22877758,1,-60,0,597,215,169,-46
"df1de691dafe4549a18a4398ee9dfaf9","df1de691dafe4549a18a4398ee9dfaf9",22877758,1,0,1,599,139,139,0
"f902b0f41b544d4dbf79664fd233648d","d313cec988a84645bee413e8d4724a4b",22877758,1,14,0,604,146,158,12
"d313cec988a84645bee413e8d4724a4b","f03480cf4eba413194d7af52fc0e7f28",22877758,1,-7,0,605,158,152,-6
"d313cec988a84645bee413e8d4724a4b","78adeee1fa2c4fe0bc73f7bca9fcee86",22877758,1,4,0,608,158,160,2
"78adeee1fa2c4fe0bc73f7bca9fcee86","df1de691dafe4549a18a4398ee9dfaf9",22877758,1,-26,0,609,160,139,-21
"df1de691dafe4549a18a4398ee9dfaf9","d7f13c8d63ec4e2aa673fbb9cf9c6933",22877758,1,92,0,610,139,206,67
"7108f0e4c2584f1f9c471689ae4c885c","78adeee1fa2c4fe0bc73f7bca9fcee86",22877758,1,-68,0,613,208,160,-48
"65202579580f4ad38d734b4ee39d22a8","3cbcea2be0984e7dbd5a48195af10ce7",22877758,1,3,0,667,164,165,1
"3cbcea2be0984e7dbd5a48195af10ce7","78adeee1fa2c4fe0bc73f7bca9fcee86",22877758,1,-8,0,668,165,160,-5
"78adeee1fa2c4fe0bc73f7bca9fcee86","82e6285962b8400d9d6fc32436022a94",22877758,1,10,0,669,160,167,7
"82e6285962b8400d9d6fc32436022a94","3cbcea2be0984e7dbd5a48195af10ce7",22877758,1,-2,0,670,167,165,-2
"3cbcea2be0984e7dbd5a48195af10ce7","a9ac840f098c4bd0a2ee896214ce29cd",22877758,1,5,0,671,165,168,3
"a9ac840f098c4bd0a2ee896214ce29cd","a9ac840f098c4bd0a2ee896214ce29cd",22877758,1,0,1,672,168,168,0
"a9ac840f098c4bd0a2ee896214ce29cd","0c7262dff33c4087bc660ccf40f92f9c",22877758,1,4,0,673,168,169,1
"b2275c3fad834f8d90737a2d9a6927d6","0c7262dff33c4087bc660ccf40f92f9c",22877758,2,-3,0,675,172,169,-3
"b42cc17b7de840f181a704558d0bc845","362fcb0699a14845ab29b2340093e528",22877758,2,-1,0,677,175,174,-1
"139b097acfca451689d80c9c6eebdf7b","2024b4885bd14338a39b7b509acbbd02",22877758,2,5,0,681,178,182,4
"2024b4885bd14338a39b7b509acbbd02","0c7262dff33c4087bc660ccf40f92f9c",22877758,1,-16,0,682,182,169,-13
"c8e371568a0c4391b25796ae4e91952e","07b44a7a51e94c78b411c753fc39dab0",22877758,2,4,0,686,186,189,3
"07b44a7a51e94c78b411c753fc39dab0","6cd2dcaac46847d4a0bc53f296d90375",22877758,2,6,0,687,189,194,5
"6cd2dcaac46847d4a0bc53f296d90375","017d7ca8e0394b91aaadc9574df2202c",22877758,2,-1,0,688,194,193,-1
"017d7ca8e0394b91aaadc9574df2202c","f9170dd6bc6442b4acd832747609b09a",22877758,3,7,0,689,193,199,6
"f9170dd6bc6442b4acd832747609b09a","d7f13c8d63ec4e2aa673fbb9cf9c6933",22877758,1,10,0,690,199,206,7
"d7f13c8d63ec4e2aa673fbb9cf9c6933","be502a7a43c44bf7b682698de79d9369",22877758,1,10,0,696,206,214,8
"f7fb1952f56b4189b86a9f8b7862d2b8","be502a7a43c44bf7b682698de79d9369",22877758,3,-1,0,699,215,214,-1
"be502a7a43c44bf7b682698de79d9369","f7fb1952f56b4189b86a9f8b7862d2b8",22877758,1,1,0,700,214,215,1
"f7fb1952f56b4189b86a9f8b7862d2b8","f7fb1952f56b4189b86a9f8b7862d2b8",22877758,19,0,1,701,215,215,0
"f7fb1952f56b4189b86a9f8b7862d2b8","b860ee85d8bc4a2f97958cfb71be3533",22877758,1,1,0,720,215,216,1
"b860ee85d8bc4a2f97958cfb71be3533","b860ee85d8bc4a2f97958cfb71be3533",22877758,2,0,1,721,216,216,0
"b860ee85d8bc4a2f97958cfb71be3533","ec341f459285443b8361f7f15638ff08",22877758,1,-3,0,723,216,213,-3
"ec341f459285443b8361f7f15638ff08","363837c182e04711840d896ae1e0339c",22877758,2,6,0,724,213,218,5
"363837c182e04711840d896ae1e0339c","363837c182e04711840d896ae1e0339c",22877758,15,0,1,725,218,218,0
"363837c182e04711840d896ae1e0339c","01b2051f8941460d89945e3b02d1ce78",22877758,4,-1,0,740,218,217,-1
"01b2051f8941460d89945e3b02d1ce78","91125ca626c5470eb145501f8c37f8db",22877758,1,4,0,741,217,220,3
"91125ca626c5470eb145501f8c37f8db","91125ca626c5470eb145501f8c37f8db",22877758,3,0,1,742,220,220,0
"91125ca626c5470eb145501f8c37f8db","be95c065e45447c1bd8215ea6f130c7a",22877758,1,-1,0,744,220,219,-1
"be95c065e45447c1bd8215ea6f130c7a","363837c182e04711840d896ae1e0339c",22877758,1,-2,0,745,219,218,-1
"01b2051f8941460d89945e3b02d1ce78","d7f13c8d63ec4e2aa673fbb9cf9c6933",22877758,3,-14,0,747,217,206,-11
"d7f13c8d63ec4e2aa673fbb9cf9c6933","a875096404ef4a9984b62d74cda916f9",22877758,2,4,0,752,206,209,3
"a875096404ef4a9984b62d74cda916f9","ec341f459285443b8361f7f15638ff08",22877758,1,5,0,753,209,213,4
"ec341f459285443b8361f7f15638ff08","f7fb1952f56b4189b86a9f8b7862d2b8",22877758,1,2,0,754,213,215,2
"be502a7a43c44bf7b682698de79d9369","363837c182e04711840d896ae1e0339c",22877758,1,5,0,756,214,218,4
"1c6721b1f63f4d30ba7746ea8af02a52","d7f13c8d63ec4e2aa673fbb9cf9c6933",22877758,2,-21,0,761,221,206,-15
"d7f13c8d63ec4e2aa673fbb9cf9c6933","77ecef8eff6b4a2caea7707669bf7475",22877758,1,22,0,762,206,222,16
"d7f13c8d63ec4e2aa673fbb9cf9c6933","91125ca626c5470eb145501f8c37f8db",22877758,1,18,0,765,206,220,14
"91125ca626c5470eb145501f8c37f8db","d7f13c8d63ec4e2aa673fbb9cf9c6933",22877758,1,-18,0,767,220,206,-14
"77ecef8eff6b4a2caea7707669bf7475","78adeee1fa2c4fe0bc73f7bca9fcee86",22877758,1,-88,0,770,222,160,-62
"78adeee1fa2c4fe0bc73f7bca9fcee86","3cbcea2be0984e7dbd5a48195af10ce7",22877758,1,8,0,781,160,165,5
"3cbcea2be0984e7dbd5a48195af10ce7","82e6285962b8400d9d6fc32436022a94",22877758,1,2,0,782,165,167,2
"82e6285962b8400d9d6fc32436022a94","a9ac840f098c4bd0a2ee896214ce29cd",22877758,1,3,0,783,167,168,1
"a9ac840f098c4bd0a2ee896214ce29cd","3cbcea2be0984e7dbd5a48195af10ce7",22877758,1,-5,0,784,168,165,-3
"3cbcea2be0984e7dbd5a48195af10ce7","0c7262dff33c4087bc660ccf40f92f9c",22877758,1,9,0,785,165,169,4
"0c7262dff33c4087bc660ccf40f92f9c","a9ac840f098c4bd0a2ee896214ce29cd",22877758,1,-4,0,786,169,168,-1
"a9ac840f098c4bd0a2ee896214ce29cd","b2275c3fad834f8d90737a2d9a6927d6",22877758,1,7,0,787,168,172,4
"2024b4885bd14338a39b7b509acbbd02","c8e371568a0c4391b25796ae4e91952e",22877758,1,7,0,795,182,186,4
"c8e371568a0c4391b25796ae4e91952e","0c7262dff33c4087bc660ccf40f92f9c",22877758,1,-23,0,796,186,169,-17
"0c7262dff33c4087bc660ccf40f92f9c","ab11d94c6c8948ea90b88f19d2cd502b",22877758,1,28,0,797,169,190,21
"f9170dd6bc6442b4acd832747609b09a","c8e371568a0c4391b25796ae4e91952e",22877758,2,-16,0,803,199,186,-13
"d7f13c8d63ec4e2aa673fbb9cf9c6933","7108f0e4c2584f1f9c471689ae4c885c",22877758,2,2,0,805,206,208,2
"b9e80f77c3a44349863b19875725c384","09400e101c5d4b439cf9a26b03aae558",22877758,1,4,0,807,207,210,3
"be502a7a43c44bf7b682698de79d9369","ec341f459285443b8361f7f15638ff08",22877758,1,-1,0,812,214,213,-1
"77ecef8eff6b4a2caea7707669bf7475","77ecef8eff6b4a2caea7707669bf7475",22877758,12,0,1,818,222,222,0
"1c6721b1f63f4d30ba7746ea8af02a52","8b9ae98743bd4d4a8a87dff1c1244211",22877758,1,7,0,831,221,227,6
"8b9ae98743bd4d4a8a87dff1c1244211","d03cb855c70044cf8c35d9ec0de696e3",22877758,1,-3,0,832,227,224,-3
"d03cb855c70044cf8c35d9ec0de696e3","a49a937d6896486d9a5396654abcf2e1",22877758,1,2,0,833,224,226,2
"a49a937d6896486d9a5396654abcf2e1","a49a937d6896486d9a5396654abcf2e1",22877758,3,0,1,834,226,226,0
"a49a937d6896486d9a5396654abcf2e1","8b9ae98743bd4d4a8a87dff1c1244211",22877758,1,1,0,837,226,227,1
"8b9ae98743bd4d4a8a87dff1c1244211","8b9ae98743bd4d4a8a87dff1c1244211",22877758,15,0,1,838,227,227,0
"2ab1535aac1346ba8801535bf729ef37","a4f40fb48a8542c8949bae1f002cd9bc",22877758,1,2,0,855,229,231,2
"a4f40fb48a8542c8949bae1f002cd9bc","a4f40fb48a8542c8949bae1f002cd9bc",22877758,2,0,1,856,231,231,0
"a4f40fb48a8542c8949bae1f002cd9bc","8972c23e32044edb8a78fa1eed4e5947",22877758,1,1,0,858,231,232,1
"8972c23e32044edb8a78fa1eed4e5947","8972c23e32044edb8a78fa1eed4e5947",22877758,3,0,1,859,232,232,0
"8972c23e32044edb8a78fa1eed4e5947","92feb4a40f8344d38b6f722e42a53295",22877758,1,1,0,862,232,233,1
"92feb4a40f8344d38b6f722e42a53295","92feb4a40f8344d38b6f722e42a53295",22877758,2,0,1,863,233,233,0
"92feb4a40f8344d38b6f722e42a53295","5152833676bf4c6cb317060be10f68db",22877758,1,-5,0,865,233,228,-5
"5152833676bf4c6cb317060be10f68db","ca3e28f290354c08aefe5b0f769604e6",22877758,1,8,0,866,228,235,7
"ca3e28f290354c08aefe5b0f769604e6","ca3e28f290354c08aefe5b0f769604e6",22877758,14,0,1,867,235,235,0
"ca3e28f290354c08aefe5b0f769604e6","79a35eea833e4c2c9d22fc53c3c6445c",22877758,1,1,0,881,235,236,1
"79a35eea833e4c2c9d22fc53c3c6445c","79a35eea833e4c2c9d22fc53c3c6445c",22877758,4,0,1,882,236,236,0
"79a35eea833e4c2c9d22fc53c3c6445c","8f68228b1518449e9615cdafee41a2bd",22877758,1,1,0,886,236,237,1
"8f68228b1518449e9615cdafee41a2bd","8f68228b1518449e9615cdafee41a2bd",22877758,1,0,1,887,237,237,0
"8f68228b1518449e9615cdafee41a2bd","cab89fa5c3ed45a5aa550fc0352d6a42",22877758,1,1,0,888,237,238,1
"cab89fa5c3ed45a5aa550fc0352d6a42","cab89fa5c3ed45a5aa550fc0352d6a42",22877758,1,0,1,889,238,238,0
"cab89fa5c3ed45a5aa550fc0352d6a42","66d4fad4f1cf4b46be0750a99ad7a35a",22877758,1,1,0,890,238,239,1
"66d4fad4f1cf4b46be0750a99ad7a35a","66d4fad4f1cf4b46be0750a99ad7a35a",22877758,1,0,1,891,239,239,0
"66d4fad4f1cf4b46be0750a99ad7a35a","0b04c8e2f86d48c7aeb7e225819cd32b",22877758,1,-5,0,892,239,234,-5
"0b04c8e2f86d48c7aeb7e225819cd32b","0c7262dff33c4087bc660ccf40f92f9c",22877758,1,-86,0,893,234,169,-65
"b9e80f77c3a44349863b19875725c384","d7f13c8d63ec4e2aa673fbb9cf9c6933",22877758,1,-1,0,906,207,206,-1
"1c6721b1f63f4d30ba7746ea8af02a52","f53da5fd9bfe412da4b80d4742563b6c",22877758,1,24,0,916,221,241,20
"f53da5fd9bfe412da4b80d4742563b6c","f53da5fd9bfe412da4b80d4742563b6c",22877758,1,0,1,917,241,241,0
"f53da5fd9bfe412da4b80d4742563b6c","1c6721b1f63f4d30ba7746ea8af02a52",22877758,1,-24,0,918,241,221,-20
"1ebf23f9d994469a85206e4c7b1bf5f5","1ebf23f9d994469a85206e4c7b1bf5f5",22877758,10,0,1,921,245,245,0
"1ebf23f9d994469a85206e4c7b1bf5f5","85ae675b83e8422da842cfd25596af99",22877758,1,1,0,931,245,246,1
"85ae675b83e8422da842cfd25596af99","85ae675b83e8422da842cfd25596af99",22877758,3,0,1,932,246,246,0
"85ae675b83e8422da842cfd25596af99","2ae94c0cea4d480a9d5dca8fb1d7b542",22877758,1,-4,0,935,246,242,-4
"2ae94c0cea4d480a9d5dca8fb1d7b542","fa235f0f364d47e4ae1c87f47bf8e6ba",22877758,1,12,0,936,242,252,10
"fa235f0f364d47e4ae1c87f47bf8e6ba","79f7845465cc4ed19d8e4f1429541be0",22877758,1,2,0,937,252,254,2
"79f7845465cc4ed19d8e4f1429541be0","79f7845465cc4ed19d8e4f1429541be0",22877758,2,0,1,938,254,254,0
"79f7845465cc4ed19d8e4f1429541be0","00f61990949545828dd12f1303d47504",22877758,1,3,0,940,254,256,2
"00f61990949545828dd12f1303d47504","6e83e23f56544a19b94067c1c558d9c0",22877758,1,-11,0,941,256,247,-9
"6e83e23f56544a19b94067c1c558d9c0","ead7bb4b64e247d2ae632ab8a296b091",22877758,1,13,0,942,247,258,11
"ead7bb4b64e247d2ae632ab8a296b091","ead7bb4b64e247d2ae632ab8a296b091",22877758,2,0,1,943,258,258,0
"ead7bb4b64e247d2ae632ab8a296b091","41b0048dde734bb280bac6116baa8e27",22877758,1,1,0,945,258,259,1
"41b0048dde734bb280bac6116baa8e27","41b0048dde734bb280bac6116baa8e27",22877758,2,0,1,946,259,259,0
"41b0048dde734bb280bac6116baa8e27","b41c5a094a604ee0915327da5cc0beb7",22877758,1,1,0,948,259,260,1
"b41c5a094a604ee0915327da5cc0beb7","b41c5a094a604ee0915327da5cc0beb7",22877758,2,0,1,949,260,260,0
"b41c5a094a604ee0915327da5cc0beb7","d546341988904f069cfa86b21457d9d9",22877758,1,-10,0,951,260,251,-9
"d546341988904f069cfa86b21457d9d9","28c171777c52431ab6b925073bd63d46",22877758,1,15,0,952,251,264,13
"28c171777c52431ab6b925073bd63d46","28c171777c52431ab6b925073bd63d46",22877758,7,0,1,953,264,264,0
"28c171777c52431ab6b925073bd63d46","ac160db940cb49ae8579162b1d52bb5d",22877758,1,2,0,960,264,266,2
"ac160db940cb49ae8579162b1d52bb5d","ac160db940cb49ae8579162b1d52bb5d",22877758,7,0,1,961,266,266,0
"ac160db940cb49ae8579162b1d52bb5d","d989ebcfc12a4b669f0100dc1aa14f1e",22877758,1,-12,0,968,266,255,-11
"d989ebcfc12a4b669f0100dc1aa14f1e","c6fd49b485cc4874b0bbdd9c6171e09c",22877758,1,15,0,969,255,268,13
"c6fd49b485cc4874b0bbdd9c6171e09c","c6fd49b485cc4874b0bbdd9c6171e09c",22877758,7,0,1,970,268,268,0
"c6fd49b485cc4874b0bbdd9c6171e09c","44240778a97c4af0937817499b75707b",22877758,1,1,0,977,268,269,1
"44240778a97c4af0937817499b75707b","44240778a97c4af0937817499b75707b",22877758,2,0,1,978,269,269,0
"44240778a97c4af0937817499b75707b","7aa76d3e993840d8805f097cbdbcd44b",22877758,1,-9,0,980,269,261,-8
"7aa76d3e993840d8805f097cbdbcd44b","865a4d3b43374da7944dc7d397f566d9",22877758,1,12,0,981,261,271,10
"865a4d3b43374da7944dc7d397f566d9","865a4d3b43374da7944dc7d397f566d9",22877758,1,0,1,982,271,271,0
"865a4d3b43374da7944dc7d397f566d9","2ae94c0cea4d480a9d5dca8fb1d7b542",22877758,1,-35,0,983,271,242,-29
"bb5a47f5ea01454a8b79455422d3b9da","4a29443515bb404cb8924e1c60a63b73",22877758,1,12,0,995,280,285,5
"4a29443515bb404cb8924e1c60a63b73","1c6721b1f63f4d30ba7746ea8af02a52",22877758,1,-87,0,1000,285,221,-64
"1c6721b1f63f4d30ba7746ea8af02a52","77ecef8eff6b4a2caea7707669bf7475",22877758,5,1,0,1001,221,222,1
"77ecef8eff6b4a2caea7707669bf7475","1c6721b1f63f4d30ba7746ea8af02a52",22877758,5,-1,0,1002,222,221,-1
"1c6721b1f63f4d30ba7746ea8af02a52","d03cb855c70044cf8c35d9ec0de696e3",22877758,1,4,0,1003,221,224,3
"d03cb855c70044cf8c35d9ec0de696e3","8b9ae98743bd4d4a8a87dff1c1244211",22877758,1,3,0,1004,224,227,3
"8b9ae98743bd4d4a8a87dff1c1244211","f7906d6f59b9489a91d2ef40db5a474d",22877758,2,-4,0,1005,227,223,-4
"f7906d6f59b9489a91d2ef40db5a474d","2ab1535aac1346ba8801535bf729ef37",22877758,2,7,0,1006,223,229,6
"2ab1535aac1346ba8801535bf729ef37","5152833676bf4c6cb317060be10f68db",22877758,1,-1,0,1007,229,228,-1
"5152833676bf4c6cb317060be10f68db","0b04c8e2f86d48c7aeb7e225819cd32b",22877758,1,7,0,1008,228,234,6
"0b04c8e2f86d48c7aeb7e225819cd32b","2ae94c0cea4d480a9d5dca8fb1d7b542",22877758,1,11,0,1009,234,242,8
"2ae94c0cea4d480a9d5dca8fb1d7b542","1c6721b1f63f4d30ba7746ea8af02a52",22877758,3,-27,0,1010,242,221,-21
"1c6721b1f63f4d30ba7746ea8af02a52","1ebf23f9d994469a85206e4c7b1bf5f5",22877758,2,30,0,1011,221,245,24
"1ebf23f9d994469a85206e4c7b1bf5f5","6e83e23f56544a19b94067c1c558d9c0",22877758,1,3,0,1012,245,247,2
"6e83e23f56544a19b94067c1c558d9c0","2ae94c0cea4d480a9d5dca8fb1d7b542",22877758,1,-6,0,1013,247,242,-5
"2ae94c0cea4d480a9d5dca8fb1d7b542","00f61990949545828dd12f1303d47504",22877758,1,17,0,1014,242,256,14
"00f61990949545828dd12f1303d47504","d546341988904f069cfa86b21457d9d9",22877758,1,-6,0,1015,256,251,-5
"d546341988904f069cfa86b21457d9d9","d989ebcfc12a4b669f0100dc1aa14f1e",22877758,1,5,0,1016,251,255,4
"d989ebcfc12a4b669f0100dc1aa14f1e","7aa76d3e993840d8805f097cbdbcd44b",22877758,1,7,0,1017,255,261,6
"7aa76d3e993840d8805f097cbdbcd44b","7028800abe7d4e27b613d1d6cbe26bf7",22877758,1,7,0,1018,261,267,6
"7028800abe7d4e27b613d1d6cbe26bf7","7aa76d3e993840d8805f097cbdbcd44b",22877758,1,-7,0,1019,267,261,-6
"7aa76d3e993840d8805f097cbdbcd44b","0d987bed3ffa4ed0b9a2e62e97b7b30f",22877758,1,15,0,1020,261,272,11
"0d987bed3ffa4ed0b9a2e62e97b7b30f","2ae94c0cea4d480a9d5dca8fb1d7b542",22877758,1,-38,0,1021,272,242,-30
"2ae94c0cea4d480a9d5dca8fb1d7b542","0d987bed3ffa4ed0b9a2e62e97b7b30f",22877758,3,38,0,1022,242,272,30
"0d987bed3ffa4ed0b9a2e62e97b7b30f","bb5a47f5ea01454a8b79455422d3b9da",22877758,3,10,0,1023,272,280,8
"bb5a47f5ea01454a8b79455422d3b9da","bb5a47f5ea01454a8b79455422d3b9da",22877758,88,0,1,1024,280,280,0
"bb5a47f5ea01454a8b79455422d3b9da","82ae07bc0c9b4570a41799290d1ef399",22877758,1,-6,0,1030,280,275,-5
"82ae07bc0c9b4570a41799290d1ef399","bb5a47f5ea01454a8b79455422d3b9da",22877758,3,6,0,1031,275,280,5
"bb5a47f5ea01454a8b79455422d3b9da","0d987bed3ffa4ed0b9a2e62e97b7b30f",22877758,2,-10,0,1032,280,272,-8
"0d987bed3ffa4ed0b9a2e62e97b7b30f","94cecc3f1e7d484b8e068e79241dfd73",22877758,2,13,0,1033,272,281,9
"94cecc3f1e7d484b8e068e79241dfd73","a37477c4e4c14169ad44b06b493007f6",22877758,2,2,0,1034,281,283,2
"a37477c4e4c14169ad44b06b493007f6","94cecc3f1e7d484b8e068e79241dfd73",22877758,2,-2,0,1035,283,281,-2
"94cecc3f1e7d484b8e068e79241dfd73","fab84b4fab5940efb4ea868ef8d09396",22877758,2,5,0,1036,281,284,3
"fab84b4fab5940efb4ea868ef8d09396","fab84b4fab5940efb4ea868ef8d09396",22877758,2,0,1,1037,284,284,0
"fab84b4fab5940efb4ea868ef8d09396","4a29443515bb404cb8924e1c60a63b73",22877758,2,4,0,1038,284,285,1
"4a29443515bb404cb8924e1c60a63b73","208c9b2796c944db8dacaa96082520ea",22877758,3,3,0,1039,285,288,3
"208c9b2796c944db8dacaa96082520ea","4a29443515bb404cb8924e1c60a63b73",22877758,3,-3,0,1040,288,285,-3
"4a29443515bb404cb8924e1c60a63b73","7669a956527947d0add87455277e80b4",22877758,1,7,0,1041,285,291,6
"7669a956527947d0add87455277e80b4","7669a956527947d0add87455277e80b4",22877758,1,0,1,1042,291,291,0
"7669a956527947d0add87455277e80b4","6a9a3b5bde4a48daa896fe8c06eca56f",22877758,1,-2,0,1043,291,289,-2
"6a9a3b5bde4a48daa896fe8c06eca56f","869e967078f04da18dd0b0b9389a7424",22877758,1,5,0,1044,289,293,4
"869e967078f04da18dd0b0b9389a7424","51ab6291537748fab90d519aa09889d6",22877758,1,2,0,1045,293,295,2
"51ab6291537748fab90d519aa09889d6","51ab6291537748fab90d519aa09889d6",22877758,12,0,1,1046,295,295,0
"51ab6291537748fab90d519aa09889d6","34a6e49023fc4465bd5ca604330bbd1c",22877758,1,-3,0,1058,295,292,-3
"34a6e49023fc4465bd5ca604330bbd1c","21592f2a9e9c4b2f8c66ec5dbcbf6a2b",22877758,1,5,0,1059,292,296,4
"21592f2a9e9c4b2f8c66ec5dbcbf6a2b","ba0e59461bfb4a44b7b1c28a01f8d3b3",22877758,1,4,0,1060,296,299,3
"ba0e59461bfb4a44b7b1c28a01f8d3b3","0e0b36e731a645e7b1b8a88f5031ca38",22877758,1,2,0,1061,299,301,2
"0e0b36e731a645e7b1b8a88f5031ca38","0e0b36e731a645e7b1b8a88f5031ca38",22877758,6,0,1,1062,301,301,0
"0e0b36e731a645e7b1b8a88f5031ca38","a66a144637284c21afc6de17fea4bfb8",22877758,1,1,0,1068,301,302,1
"a66a144637284c21afc6de17fea4bfb8","a66a144637284c21afc6de17fea4bfb8",22877758,2,0,1,1069,302,302,0
"a66a144637284c21afc6de17fea4bfb8","7646a919d7e64fa990bca9b024ff089d",22877758,1,-4,0,1071,302,298,-4
"7646a919d7e64fa990bca9b024ff089d","e390b575229748ea8aac9364efe2bf00",22877758,1,7,0,1072,298,304,6
"e390b575229748ea8aac9364efe2bf00","e390b575229748ea8aac9364efe2bf00",22877758,1,0,1,1073,304,304,0
"e390b575229748ea8aac9364efe2bf00","4a29443515bb404cb8924e1c60a63b73",22877758,1,-24,0,1074,304,285,-19
"4a29443515bb404cb8924e1c60a63b73","3434c10e561d488a914e0f7d71907abd",22877758,2,27,0,1075,285,305,20
"3434c10e561d488a914e0f7d71907abd","53e7e900392747ccad52e711ab0f80d8",22877758,2,2,0,1076,305,307,2
"53e7e900392747ccad52e711ab0f80d8","3434c10e561d488a914e0f7d71907abd",22877758,2,-2,0,1077,307,305,-2
"3434c10e561d488a914e0f7d71907abd","130acc2aeb0448fdbb2de63bc5cebe5b",22877758,2,5,0,1078,305,309,4
"130acc2aeb0448fdbb2de63bc5cebe5b","9c062b3251034ebe90f5054e2a3b5120",22877758,1,2,0,1079,309,311,2
"9c062b3251034ebe90f5054e2a3b5120","9c062b3251034ebe90f5054e2a3b5120",22877758,2,0,1,1080,311,311,0
"9c062b3251034ebe90f5054e2a3b5120","ea859f8207e44537889daeaba13ac2e8",22877758,1,1,0,1082,311,312,1
"ea859f8207e44537889daeaba13ac2e8","ea859f8207e44537889daeaba13ac2e8",22877758,7,0,1,1083,312,312,0
"ea859f8207e44537889daeaba13ac2e8","56d94971a7a94257aa330183a8ebd0ea",22877758,1,1,0,1090,312,313,1
"56d94971a7a94257aa330183a8ebd0ea","56d94971a7a94257aa330183a8ebd0ea",22877758,4,0,1,1091,313,313,0
"56d94971a7a94257aa330183a8ebd0ea","141c0df6cd1946539aadd1c9b7068cd4",22877758,1,-5,0,1095,313,308,-5
"141c0df6cd1946539aadd1c9b7068cd4","13255e63e0aa4abf85e5211bf613d43e",22877758,1,10,0,1096,308,317,9
"13255e63e0aa4abf85e5211bf613d43e","13255e63e0aa4abf85e5211bf613d43e",22877758,3,0,1,1097,317,317,0
"13255e63e0aa4abf85e5211bf613d43e","86c27d40179e419c8e9d150fb6afa5d0",22877758,1,3,0,1100,317,319,2
"86c27d40179e419c8e9d150fb6afa5d0","0c787d16c9504873b1a4d903cec09948",22877758,2,-6,0,1101,319,314,-5
"0c787d16c9504873b1a4d903cec09948","8d7e0b55cf9849cda222a0f2440cec55",22877758,2,5,0,1102,314,318,4
"8d7e0b55cf9849cda222a0f2440cec55","24f1363179ad4aaa965484a78471912b",22877758,2,6,0,1103,318,323,5
"24f1363179ad4aaa965484a78471912b","47edbb64109243e6b0f8f64cdef90c6c",22877758,1,3,0,1104,323,326,3
"47edbb64109243e6b0f8f64cdef90c6c","3628bdce1dd2429ba924d2d4d09448d2",22877758,1,-4,0,1105,326,322,-4
"3628bdce1dd2429ba924d2d4d09448d2","56b3fd1a212a4764be39d979fde3326e",22877758,1,7,0,1106,322,328,6
"56b3fd1a212a4764be39d979fde3326e","56b3fd1a212a4764be39d979fde3326e",22877758,1,0,1,1107,328,328,0
"56b3fd1a212a4764be39d979fde3326e","0c4079457ede49e3aeb5e86ed84bdf35",22877758,1,3,0,1108,328,329,1
"0c4079457ede49e3aeb5e86ed84bdf35","3434c10e561d488a914e0f7d71907abd",22877758,3,-31,0,1109,329,305,-24
"3434c10e561d488a914e0f7d71907abd","38aea304b4fa46e1b29bb72f5cea4c93",22877758,3,33,0,1110,305,331,26
"38aea304b4fa46e1b29bb72f5cea4c93","e36d261332f14e79bb4b467aceaeb9b5",22877758,1,2,0,1111,331,333,2
"e36d261332f14e79bb4b467aceaeb9b5","e36d261332f14e79bb4b467aceaeb9b5",22877758,2,0,1,1112,333,333,0
"e36d261332f14e79bb4b467aceaeb9b5","c7e89b9d04744d2eab742fc24e3ef1ae",22877758,1,1,0,1114,333,334,1
"c7e89b9d04744d2eab742fc24e3ef1ae","c7e89b9d04744d2eab742fc24e3ef1ae",22877758,3,0,1,1115,334,334,0
"c7e89b9d04744d2eab742fc24e3ef1ae","fe49f8054b374a0ea4bb266ed135ff62",22877758,1,1,0,1118,334,335,1
"fe49f8054b374a0ea4bb266ed135ff62","fe49f8054b374a0ea4bb266ed135ff62",22877758,2,0,1,1119,335,335,0
"fe49f8054b374a0ea4bb266ed135ff62","d0a8f74af98642fe8360d22c42e45117",22877758,1,1,0,1121,335,336,1
"d0a8f74af98642fe8360d22c42e45117","d0a8f74af98642fe8360d22c42e45117",22877758,2,0,1,1122,336,336,0
"d0a8f74af98642fe8360d22c42e45117","0c4079457ede49e3aeb5e86ed84bdf35",22877758,1,-7,0,1124,336,329,-7
"0c4079457ede49e3aeb5e86ed84bdf35","a7c6339ca1da4368a18d471f0519f877",22877758,1,11,0,1125,329,339,10
"a7c6339ca1da4368a18d471f0519f877","a7c6339ca1da4368a18d471f0519f877",22877758,1,0,1,1126,339,339,0
"a7c6339ca1da4368a18d471f0519f877","b8b9418ab322418d9db9b40d96af873a",22877758,1,-2,0,1127,339,337,-2
"b8b9418ab322418d9db9b40d96af873a","bbc5139ca9024389a94db3a6f47dcff6",22877758,1,5,0,1128,337,341,4
"bbc5139ca9024389a94db3a6f47dcff6","4ee6ca9019ab4a1ab323f98094a9bd77",22877758,1,2,0,1129,341,343,2
"4ee6ca9019ab4a1ab323f98094a9bd77","4ee6ca9019ab4a1ab323f98094a9bd77",22877758,5,0,1,1130,343,343,0
"4ee6ca9019ab4a1ab323f98094a9bd77","b37947176785476f8b29d49a851366dc",22877758,1,1,0,1135,343,344,1
"b37947176785476f8b29d49a851366dc","b37947176785476f8b29d49a851366dc",22877758,2,0,1,1136,344,344,0
"b37947176785476f8b29d49a851366dc","fcea5b10d5a14a3b9324ffece8f6e1e5",22877758,1,1,0,1138,344,345,1
"fcea5b10d5a14a3b9324ffece8f6e1e5","fcea5b10d5a14a3b9324ffece8f6e1e5",22877758,2,0,1,1139,345,345,0
"fcea5b10d5a14a3b9324ffece8f6e1e5","c2490bc612d146edbe786556fab3651b",22877758,1,-5,0,1141,345,340,-5
"c2490bc612d146edbe786556fab3651b","6ac8bb048b854999a47edb35fe627f11",22877758,1,8,0,1142,340,347,7
"6ac8bb048b854999a47edb35fe627f11","6ac8bb048b854999a47edb35fe627f11",22877758,1,0,1,1143,347,347,0
"6ac8bb048b854999a47edb35fe627f11","0c4079457ede49e3aeb5e86ed84bdf35",22877758,1,-21,0,1144,347,329,-18
"0c4079457ede49e3aeb5e86ed84bdf35","30ead9794d4847abaf222ca966cc8630",22877758,2,24,0,1145,329,348,19
"30ead9794d4847abaf222ca966cc8630","897b7f51242c44aab2205c72fdcbf4cd",22877758,1,4,0,1146,348,352,4
"897b7f51242c44aab2205c72fdcbf4cd","eff0de7f2dbb42dfa1a2e686efab5b6d",22877758,3,2,0,1147,352,354,2
"eff0de7f2dbb42dfa1a2e686efab5b6d","09b9678ddc3d452ea4a3d46e15826065",22877758,2,-1,0,1148,354,353,-1
"09b9678ddc3d452ea4a3d46e15826065","c20993c944444fe085345591a8bd837e",22877758,1,-2,0,1149,353,351,-2
"c20993c944444fe085345591a8bd837e","c20993c944444fe085345591a8bd837e",22877758,7,0,1,1150,351,351,0
"c20993c944444fe085345591a8bd837e","897b7f51242c44aab2205c72fdcbf4cd",22877758,3,1,0,1154,351,352,1
"897b7f51242c44aab2205c72fdcbf4cd","897b7f51242c44aab2205c72fdcbf4cd",22877758,5,0,1,1155,352,352,0
"897b7f51242c44aab2205c72fdcbf4cd","09b9678ddc3d452ea4a3d46e15826065",22877758,1,1,0,1158,352,353,1
"09b9678ddc3d452ea4a3d46e15826065","09b9678ddc3d452ea4a3d46e15826065",22877758,5,0,1,1159,353,353,0
"09b9678ddc3d452ea4a3d46e15826065","eff0de7f2dbb42dfa1a2e686efab5b6d",22877758,3,1,0,1162,353,354,1
"eff0de7f2dbb42dfa1a2e686efab5b6d","eff0de7f2dbb42dfa1a2e686efab5b6d",22877758,5,0,1,1163,354,354,0
"eff0de7f2dbb42dfa1a2e686efab5b6d","30ead9794d4847abaf222ca966cc8630",22877758,1,-6,0,1166,354,348,-6
"30ead9794d4847abaf222ca966cc8630","2fe14166dc9642c3bc666b86a57f943d",22877758,2,10,0,1167,348,357,9
"2fe14166dc9642c3bc666b86a57f943d","44421dd1e13a47a388c4a19834b744c7",22877758,1,2,0,1168,357,359,2
"44421dd1e13a47a388c4a19834b744c7","44421dd1e13a47a388c4a19834b744c7",22877758,3,0,1,1169,359,359,0
"44421dd1e13a47a388c4a19834b744c7","09b9678ddc3d452ea4a3d46e15826065",22877758,1,-7,0,1172,359,353,-6
"eff0de7f2dbb42dfa1a2e686efab5b6d","1ba8fef685d74a8194b9db252eb704fb",22877758,1,2,0,1174,354,355,1
"1ba8fef685d74a8194b9db252eb704fb","c20993c944444fe085345591a8bd837e",22877758,1,-5,0,1175,355,351,-4
"09b9678ddc3d452ea4a3d46e15826065","30ead9794d4847abaf222ca966cc8630",22877758,1,-5,0,1181,353,348,-5
"30ead9794d4847abaf222ca966cc8630","c20993c944444fe085345591a8bd837e",22877758,1,3,0,1182,348,351,3
"897b7f51242c44aab2205c72fdcbf4cd","0c4079457ede49e3aeb5e86ed84bdf35",22877758,1,-28,0,1186,352,329,-23
"0c4079457ede49e3aeb5e86ed84bdf35","bbc5139ca9024389a94db3a6f47dcff6",22877758,1,14,0,1187,329,341,12
"bbc5139ca9024389a94db3a6f47dcff6","4a92daef4d504e1792575a26502bb7b7",22877758,1,6,0,1188,341,346,5
"4a92daef4d504e1792575a26502bb7b7","c2490bc612d146edbe786556fab3651b",22877758,1,-7,0,1189,346,340,-6
"c2490bc612d146edbe786556fab3651b","b8b9418ab322418d9db9b40d96af873a",22877758,1,-4,0,1190,340,337,-3
"b8b9418ab322418d9db9b40d96af873a","38aea304b4fa46e1b29bb72f5cea4c93",22877758,1,-7,0,1191,337,331,-6
"38aea304b4fa46e1b29bb72f5cea4c93","3434c10e561d488a914e0f7d71907abd",22877758,1,-33,0,1192,331,305,-26
"3434c10e561d488a914e0f7d71907abd","0c4079457ede49e3aeb5e86ed84bdf35",22877758,1,31,0,1193,305,329,24
"0c4079457ede49e3aeb5e86ed84bdf35","0d987bed3ffa4ed0b9a2e62e97b7b30f",22877758,1,-80,0,1194,329,272,-57
"0d987bed3ffa4ed0b9a2e62e97b7b30f","0c7262dff33c4087bc660ccf40f92f9c",22877758,1,-135,0,1195,272,169,-103
"0c7262dff33c4087bc660ccf40f92f9c","0c7262dff33c4087bc660ccf40f92f9c",22877758,3,0,1,1196,169,169,0
"0c7262dff33c4087bc660ccf40f92f9c","c8e371568a0c4391b25796ae4e91952e",22877758,5,23,0,1197,169,186,17
"c8e371568a0c4391b25796ae4e91952e","c8e371568a0c4391b25796ae4e91952e",22877758,2,0,1,1198,186,186,0
"c8e371568a0c4391b25796ae4e91952e","d7f13c8d63ec4e2aa673fbb9cf9c6933",22877758,4,26,0,1200,186,206,20
"d7f13c8d63ec4e2aa673fbb9cf9c6933","b9e80f77c3a44349863b19875725c384",22877758,4,1,0,1201,206,207,1
"b9e80f77c3a44349863b19875725c384","7108f0e4c2584f1f9c471689ae4c885c",22877758,6,1,0,1202,207,208,1
"7108f0e4c2584f1f9c471689ae4c885c","d7f13c8d63ec4e2aa673fbb9cf9c6933",22877758,1,-2,0,1203,208,206,-2
"d7f13c8d63ec4e2aa673fbb9cf9c6933","d7f13c8d63ec4e2aa673fbb9cf9c6933",22877758,2,0,1,1204,206,206,0
"d7f13c8d63ec4e2aa673fbb9cf9c6933","1c6721b1f63f4d30ba7746ea8af02a52",22877758,5,21,0,1205,206,221,15
"1c6721b1f63f4d30ba7746ea8af02a52","1c6721b1f63f4d30ba7746ea8af02a52",22877758,2,0,1,1208,221,221,0
"1c6721b1f63f4d30ba7746ea8af02a52","2ae94c0cea4d480a9d5dca8fb1d7b542",22877758,3,27,0,1209,221,242,21
"2ae94c0cea4d480a9d5dca8fb1d7b542","1ebf23f9d994469a85206e4c7b1bf5f5",22877758,2,3,0,1210,242,245,3
"1ebf23f9d994469a85206e4c7b1bf5f5","2ae94c0cea4d480a9d5dca8fb1d7b542",22877758,2,-3,0,1211,245,242,-3
"2ae94c0cea4d480a9d5dca8fb1d7b542","2ae94c0cea4d480a9d5dca8fb1d7b542",22877758,1,0,1,1212,242,242,0
"0d987bed3ffa4ed0b9a2e62e97b7b30f","0d987bed3ffa4ed0b9a2e62e97b7b30f",22877758,2,0,1,1214,272,272,0
"0d987bed3ffa4ed0b9a2e62e97b7b30f","82ae07bc0c9b4570a41799290d1ef399",22877758,2,4,0,1215,272,275,3
"4a29443515bb404cb8924e1c60a63b73","4a29443515bb404cb8924e1c60a63b73",22877758,3,0,1,1287,285,285,0
"130acc2aeb0448fdbb2de63bc5cebe5b","141c0df6cd1946539aadd1c9b7068cd4",22877758,1,-1,0,1292,309,308,-1
"141c0df6cd1946539aadd1c9b7068cd4","86c27d40179e419c8e9d150fb6afa5d0",22877758,1,13,0,1293,308,319,11
"8d7e0b55cf9849cda222a0f2440cec55","47edbb64109243e6b0f8f64cdef90c6c",22877758,1,9,0,1296,318,326,8
"47edbb64109243e6b0f8f64cdef90c6c","24f1363179ad4aaa965484a78471912b",22877758,1,-3,0,1297,326,323,-3
"24f1363179ad4aaa965484a78471912b","3628bdce1dd2429ba924d2d4d09448d2",22877758,2,-1,0,1298,323,322,-1
"3628bdce1dd2429ba924d2d4d09448d2","0c4079457ede49e3aeb5e86ed84bdf35",22877758,2,10,0,1299,322,329,7
"38aea304b4fa46e1b29bb72f5cea4c93","0c4079457ede49e3aeb5e86ed84bdf35",22877758,1,-2,0,1302,331,329,-2
"0c4079457ede49e3aeb5e86ed84bdf35","0c4079457ede49e3aeb5e86ed84bdf35",22877758,1,0,1,1303,329,329,0
"30ead9794d4847abaf222ca966cc8630","09b9678ddc3d452ea4a3d46e15826065",22877758,1,5,0,1305,348,353,5
"09b9678ddc3d452ea4a3d46e15826065","897b7f51242c44aab2205c72fdcbf4cd",22877758,1,-1,0,1306,353,352,-1
"eff0de7f2dbb42dfa1a2e686efab5b6d","c20993c944444fe085345591a8bd837e",22877758,1,-3,0,1308,354,351,-3
"c20993c944444fe085345591a8bd837e","09b9678ddc3d452ea4a3d46e15826065",22877758,1,2,0,1311,351,353,2
"eff0de7f2dbb42dfa1a2e686efab5b6d","897b7f51242c44aab2205c72fdcbf4cd",22877758,1,-2,0,1315,354,352,-2
"897b7f51242c44aab2205c72fdcbf4cd","30ead9794d4847abaf222ca966cc8630",22877758,1,-4,0,1317,352,348,-4
"2fe14166dc9642c3bc666b86a57f943d","cb5fc7ef85d547c4be1a7439d0bf6052",22877758,1,3,0,1319,357,360,3
"cb5fc7ef85d547c4be1a7439d0bf6052","cb5fc7ef85d547c4be1a7439d0bf6052",22877758,2,0,1,1320,360,360,0
"cb5fc7ef85d547c4be1a7439d0bf6052","0a8f150a4cf747acbde62f4721823da3",22877758,1,1,0,1322,360,361,1
"0a8f150a4cf747acbde62f4721823da3","0a8f150a4cf747acbde62f4721823da3",22877758,5,0,1,1323,361,361,0
"0a8f150a4cf747acbde62f4721823da3","ab8fdad974ae471f9f24c3f9dd04462e",22877758,1,1,0,1328,361,362,1
"ab8fdad974ae471f9f24c3f9dd04462e","ab8fdad974ae471f9f24c3f9dd04462e",22877758,2,0,1,1329,362,362,0
"ab8fdad974ae471f9f24c3f9dd04462e","1ba8fef685d74a8194b9db252eb704fb",22877758,1,-7,0,1331,362,355,-7
"1ba8fef685d74a8194b9db252eb704fb","52580888dadb4fe3baa795683ea227bd",22877758,1,10,0,1332,355,364,9
"52580888dadb4fe3baa795683ea227bd","492a3bc6a1254f23a7998587961b22a4",22877758,1,3,0,1333,364,366,2
"492a3bc6a1254f23a7998587961b22a4","f00179e251a045b39c3f7a54f9aa4acc",22877758,2,-4,0,1334,366,363,-3
"f00179e251a045b39c3f7a54f9aa4acc","072a190fd302456290895f9f04d6940a",22877758,2,3,0,1335,363,365,2
"072a190fd302456290895f9f04d6940a","492a3bc6a1254f23a7998587961b22a4",22877758,1,1,0,1336,365,366,1
"492a3bc6a1254f23a7998587961b22a4","c76574d21bc14aeea7ecd0b027f39858",22877758,1,2,0,1337,366,367,1
"c76574d21bc14aeea7ecd0b027f39858","52580888dadb4fe3baa795683ea227bd",22877758,1,-5,0,1338,367,364,-3
"52580888dadb4fe3baa795683ea227bd","072a190fd302456290895f9f04d6940a",22877758,1,2,0,1339,364,365,1
"072a190fd302456290895f9f04d6940a","2fe14166dc9642c3bc666b86a57f943d",22877758,1,-10,0,1340,365,357,-8
"2fe14166dc9642c3bc666b86a57f943d","f00179e251a045b39c3f7a54f9aa4acc",22877758,1,7,0,1341,357,363,6
"f00179e251a045b39c3f7a54f9aa4acc","52580888dadb4fe3baa795683ea227bd",22877758,1,1,0,1342,363,364,1
"52580888dadb4fe3baa795683ea227bd","1ba8fef685d74a8194b9db252eb704fb",22877758,1,-10,0,1343,364,355,-9
"1ba8fef685d74a8194b9db252eb704fb","492a3bc6a1254f23a7998587961b22a4",22877758,1,13,0,1344,355,366,11
"072a190fd302456290895f9f04d6940a","cfa457d1743848e4bb5e4beced6448ed",22877758,1,5,0,1347,365,369,4
"cfa457d1743848e4bb5e4beced6448ed","cfa457d1743848e4bb5e4beced6448ed",22877758,2,0,1,1348,369,369,0
"cfa457d1743848e4bb5e4beced6448ed","b71bac264efb4abd97015447bd490db6",22877758,1,3,0,1350,369,370,1
"b71bac264efb4abd97015447bd490db6","30ead9794d4847abaf222ca966cc8630",22877758,1,-28,0,1351,370,348,-22
"30ead9794d4847abaf222ca966cc8630","b71bac264efb4abd97015447bd490db6",22877758,1,28,0,1352,348,370,22
"b71bac264efb4abd97015447bd490db6","8d448d625b024c82a5eb240bbd7431d6",22877758,8,5,0,1353,370,374,4
"8d448d625b024c82a5eb240bbd7431d6","8d448d625b024c82a5eb240bbd7431d6",22877758,87,0,1,1354,374,374,0
"8d448d625b024c82a5eb240bbd7431d6","fab84b4fab5940efb4ea868ef8d09396",22877758,1,-119,0,1361,374,284,-90
"fab84b4fab5940efb4ea868ef8d09396","0c7262dff33c4087bc660ccf40f92f9c",22877758,1,-153,0,1362,284,169,-115
"0c7262dff33c4087bc660ccf40f92f9c","df1de691dafe4549a18a4398ee9dfaf9",22877758,2,-43,0,1363,169,139,-30
"df1de691dafe4549a18a4398ee9dfaf9","6c5ad271a44743479bfaea29b1db8d02",22877758,4,4,0,1364,139,143,4
"6c5ad271a44743479bfaea29b1db8d02","402bba41861d43acb52a5abb89e8831e",22877758,1,2,0,1365,143,145,2
"402bba41861d43acb52a5abb89e8831e","8aae34f5ddbb4052a709b12e6b0d40fa",22877758,1,3,0,1366,145,147,2
"8aae34f5ddbb4052a709b12e6b0d40fa","df1de691dafe4549a18a4398ee9dfaf9",22877758,1,-9,0,1367,147,139,-8
"df1de691dafe4549a18a4398ee9dfaf9","f902b0f41b544d4dbf79664fd233648d",22877758,1,8,0,1368,139,146,7
"f902b0f41b544d4dbf79664fd233648d","b71bac264efb4abd97015447bd490db6",22877758,1,302,0,1369,146,370,224
"8d448d625b024c82a5eb240bbd7431d6","b71bac264efb4abd97015447bd490db6",22877758,4,-5,0,1373,374,370,-4
"8d448d625b024c82a5eb240bbd7431d6","1b4550d0dab04078b3bf08a655345bdc",22877758,1,-1,0,1379,374,373,-1
"1b4550d0dab04078b3bf08a655345bdc","b71bac264efb4abd97015447bd490db6",22877758,3,-4,0,1380,373,370,-3
"8d448d625b024c82a5eb240bbd7431d6","67a089198fcb4e1c8f2385786c2b296f",22877758,1,-441,0,1389,374,39,-335
"67a089198fcb4e1c8f2385786c2b296f","64d48c6c9c7940639a932219a6c87198",22877758,5,1,0,1390,39,40,1
"64d48c6c9c7940639a932219a6c87198","1b4550d0dab04078b3bf08a655345bdc",22877758,1,439,0,1391,40,373,333
"b71bac264efb4abd97015447bd490db6","b71bac264efb4abd97015447bd490db6",22877758,1,0,1,1402,370,370,0
"b71bac264efb4abd97015447bd490db6","d6d02b6ef04e4f17805504500b8ce441",22877758,1,8,0,1460,370,375,5
"d6d02b6ef04e4f17805504500b8ce441","d6d02b6ef04e4f17805504500b8ce441",22877758,2,0,1,1461,375,375,0
"d6d02b6ef04e4f17805504500b8ce441","66baf19b6b904b70922329068c63746d",22877758,1,4,0,1463,375,376,1
"66baf19b6b904b70922329068c63746d","7f544639412e40a9ba27f43b415362ab",22877758,3,2,0,1464,376,378,2
"7f544639412e40a9ba27f43b415362ab","d5ae8642e15b46b8bd298b02274d4e9c",22877758,1,2,0,1465,378,380,2
"d5ae8642e15b46b8bd298b02274d4e9c","d5ae8642e15b46b8bd298b02274d4e9c",22877758,1,0,1,1466,380,380,0
"d5ae8642e15b46b8bd298b02274d4e9c","a0d10309a2dd456289147f84be9d37f9",22877758,1,1,0,1467,380,381,1
"a0d10309a2dd456289147f84be9d37f9","a0d10309a2dd456289147f84be9d37f9",22877758,2,0,1,1468,381,381,0
"a0d10309a2dd456289147f84be9d37f9","0fcbc3ca07b144138b8d85da581f09a8",22877758,1,1,0,1470,381,382,1
"0fcbc3ca07b144138b8d85da581f09a8","0fcbc3ca07b144138b8d85da581f09a8",22877758,2,0,1,1471,382,382,0
"0fcbc3ca07b144138b8d85da581f09a8","66baf19b6b904b70922329068c63746d",22877758,1,-6,0,1473,382,376,-6
"66baf19b6b904b70922329068c63746d","4890121ce5d74576b4632b77cfc23398",22877758,1,14,0,1474,376,388,12
"4890121ce5d74576b4632b77cfc23398","c2fca3669923477ab966ded303dea31c",22877758,1,-6,0,1475,388,383,-5
"c2fca3669923477ab966ded303dea31c","66baf19b6b904b70922329068c63746d",22877758,1,-8,0,1476,383,376,-7
"7f544639412e40a9ba27f43b415362ab","66baf19b6b904b70922329068c63746d",22877758,2,-2,0,1478,378,376,-2
"66baf19b6b904b70922329068c63746d","c2fca3669923477ab966ded303dea31c",22877758,2,8,0,1479,376,383,7
"c2fca3669923477ab966ded303dea31c","4890121ce5d74576b4632b77cfc23398",22877758,2,6,0,1480,383,388,5
"4890121ce5d74576b4632b77cfc23398","18d3b836dd804224883cc9180b60a8e1",22877758,2,-1,0,1481,388,387,-1
"18d3b836dd804224883cc9180b60a8e1","96bb2b3e85a34d8b9544514e89f6fe97",22877758,2,4,0,1482,387,390,3
"96bb2b3e85a34d8b9544514e89f6fe97","ac4e9b54acfe4670b4634859c7263cb5",22877758,1,2,0,1483,390,392,2
"ac4e9b54acfe4670b4634859c7263cb5","ac4e9b54acfe4670b4634859c7263cb5",22877758,1,0,1,1484,392,392,0
"ac4e9b54acfe4670b4634859c7263cb5","17f95d18bab743888e1736033dc3384d",22877758,1,-3,0,1485,392,389,-3
"17f95d18bab743888e1736033dc3384d","6f8881a745ac4c358a68b92c3b4abe81",22877758,2,6,0,1486,389,394,5
"6f8881a745ac4c358a68b92c3b4abe81","f7002c8484354eceac57bc7bd62c76c1",22877758,2,-1,0,1487,394,393,-1
"f7002c8484354eceac57bc7bd62c76c1","0c12af0a4e7f4002852cf84b2537c161",22877758,2,3,0,1488,393,395,2
"0c12af0a4e7f4002852cf84b2537c161","df8191ec5e584c838a899c378941a566",22877758,1,4,0,1489,395,398,3
"df8191ec5e584c838a899c378941a566","6f8881a745ac4c358a68b92c3b4abe81",22877758,1,-6,0,1490,398,394,-4
"6f8881a745ac4c358a68b92c3b4abe81","0c12af0a4e7f4002852cf84b2537c161",22877758,1,2,0,1491,394,395,1
"0c12af0a4e7f4002852cf84b2537c161","f7002c8484354eceac57bc7bd62c76c1",22877758,1,-3,0,1492,395,393,-2
"0c12af0a4e7f4002852cf84b2537c161","66baf19b6b904b70922329068c63746d",22877758,1,-24,0,1494,395,376,-19
"66baf19b6b904b70922329068c63746d","2b09a08242b54983aec7063990fb3f66",22877758,2,32,0,1495,376,400,24
"2b09a08242b54983aec7063990fb3f66","2b09a08242b54983aec7063990fb3f66",22877758,2,0,1,1496,400,400,0
"2b09a08242b54983aec7063990fb3f66","1f471b7a883a4df48211e8c6a81b59a7",22877758,1,1,0,1497,400,401,1
"1f471b7a883a4df48211e8c6a81b59a7","1f471b7a883a4df48211e8c6a81b59a7",22877758,1,0,1,1498,401,401,0
"1f471b7a883a4df48211e8c6a81b59a7","2b09a08242b54983aec7063990fb3f66",22877758,1,-1,0,1499,401,400,-1
"2b09a08242b54983aec7063990fb3f66","1157bd665ec4472fb58b751dc5099355",22877758,1,4,0,1500,400,403,3
"1157bd665ec4472fb58b751dc5099355","58fc9094275e4c49be3f4ba6d4acc0a4",22877758,1,5,0,1501,403,406,3
"58fc9094275e4c49be3f4ba6d4acc0a4","3c8a22d2f9c146ea956609e3ed4f2559",22877758,1,-2,0,1502,406,405,-1
"3c8a22d2f9c146ea956609e3ed4f2559","c1c1be90b2b14c1ab4a5e1ee3c241902",22877758,1,3,0,1503,405,407,2
"c1c1be90b2b14c1ab4a5e1ee3c241902","c1c1be90b2b14c1ab4a5e1ee3c241902",22877758,5,0,1,1504,407,407,0
"c1c1be90b2b14c1ab4a5e1ee3c241902","58fc9094275e4c49be3f4ba6d4acc0a4",22877758,1,-1,0,1509,407,406,-1
"58fc9094275e4c49be3f4ba6d4acc0a4","02b3a1bead9244c1ba2f857c7da8f82a",22877758,2,3,0,1510,406,408,2
"02b3a1bead9244c1ba2f857c7da8f82a","6206fc6479014bb193084c32409dc1b9",22877758,1,1,0,1511,408,409,1
"6206fc6479014bb193084c32409dc1b9","6206fc6479014bb193084c32409dc1b9",22877758,4,0,1,1512,409,409,0
"6206fc6479014bb193084c32409dc1b9","02b3a1bead9244c1ba2f857c7da8f82a",22877758,1,-1,0,1516,409,408,-1
"02b3a1bead9244c1ba2f857c7da8f82a","6a5f020451db426dacba9e2ea3fcc62a",22877758,1,3,0,1517,408,410,2
"6a5f020451db426dacba9e2ea3fcc62a","6a5f020451db426dacba9e2ea3fcc62a",22877758,1,0,1,1518,410,410,0
"6a5f020451db426dacba9e2ea3fcc62a","33a9d248b2e44588a5b07fc1342b9bc2",22877758,2,2,0,1519,410,411,1
"33a9d248b2e44588a5b07fc1342b9bc2","c6f26bd420634f1cb7989e76fe6b16c0",22877758,1,1,0,1520,411,412,1
"c6f26bd420634f1cb7989e76fe6b16c0","c6f26bd420634f1cb7989e76fe6b16c0",22877758,5,0,1,1521,412,412,0
"c6f26bd420634f1cb7989e76fe6b16c0","2a65ee6e2ac64f6a8a55fbe5373ec763",22877758,1,1,0,1526,412,413,1
"2a65ee6e2ac64f6a8a55fbe5373ec763","2a65ee6e2ac64f6a8a55fbe5373ec763",22877758,2,0,1,1527,413,413,0
"2a65ee6e2ac64f6a8a55fbe5373ec763","33a9d248b2e44588a5b07fc1342b9bc2",22877758,1,-2,0,1529,413,411,-2
"33a9d248b2e44588a5b07fc1342b9bc2","1fd0f6dadbc14ebc965faf6122190b96",22877758,2,5,0,1530,411,415,4
"1fd0f6dadbc14ebc965faf6122190b96","b71bac264efb4abd97015447bd490db6",22877758,1,-66,0,1531,415,370,-45
"b71bac264efb4abd97015447bd490db6","0d987bed3ffa4ed0b9a2e62e97b7b30f",22877758,1,-132,0,1532,370,272,-98
"0d987bed3ffa4ed0b9a2e62e97b7b30f","66baf19b6b904b70922329068c63746d",22877758,1,144,0,1533,272,376,104
"66baf19b6b904b70922329068c63746d","66baf19b6b904b70922329068c63746d",22877758,1,0,1,1534,376,376,0
"96bb2b3e85a34d8b9544514e89f6fe97","17f95d18bab743888e1736033dc3384d",22877758,1,-1,0,1541,390,389,-1
"f7002c8484354eceac57bc7bd62c76c1","44a277ea44dc4ae689fab4b82f0b4098",22877758,1,5,0,1544,393,397,4
"44a277ea44dc4ae689fab4b82f0b4098","44a277ea44dc4ae689fab4b82f0b4098",22877758,1,0,1,1545,397,397,0
"44a277ea44dc4ae689fab4b82f0b4098","0c12af0a4e7f4002852cf84b2537c161",22877758,1,-2,0,1546,397,395,-2
"0c12af0a4e7f4002852cf84b2537c161","859e0b8d71694b12befb69ee698138f9",22877758,1,5,0,1547,395,399,4
"859e0b8d71694b12befb69ee698138f9","859e0b8d71694b12befb69ee698138f9",22877758,1,0,1,1548,399,399,0
"859e0b8d71694b12befb69ee698138f9","2b09a08242b54983aec7063990fb3f66",22877758,1,3,0,1549,399,400,1
"2b09a08242b54983aec7063990fb3f66","66baf19b6b904b70922329068c63746d",22877758,1,-32,0,1550,400,376,-24
"2b09a08242b54983aec7063990fb3f66","9de0d567bfa84fe5b77cb76f4a76a5d1",22877758,1,5,0,1553,400,404,4
"9de0d567bfa84fe5b77cb76f4a76a5d1","9de0d567bfa84fe5b77cb76f4a76a5d1",22877758,1,0,1,1554,404,404,0
"9de0d567bfa84fe5b77cb76f4a76a5d1","1157bd665ec4472fb58b751dc5099355",22877758,1,-1,0,1555,404,403,-1
"1157bd665ec4472fb58b751dc5099355","3c8a22d2f9c146ea956609e3ed4f2559",22877758,1,3,0,1556,403,405,2
"3c8a22d2f9c146ea956609e3ed4f2559","58fc9094275e4c49be3f4ba6d4acc0a4",22877758,1,2,0,1557,405,406,1
"02b3a1bead9244c1ba2f857c7da8f82a","58fc9094275e4c49be3f4ba6d4acc0a4",22877758,1,-3,0,1559,408,406,-2
"58fc9094275e4c49be3f4ba6d4acc0a4","6a5f020451db426dacba9e2ea3fcc62a",22877758,1,6,0,1560,406,410,4
"6a5f020451db426dacba9e2ea3fcc62a","02b3a1bead9244c1ba2f857c7da8f82a",22877758,1,-3,0,1561,410,408,-2
"02b3a1bead9244c1ba2f857c7da8f82a","33a9d248b2e44588a5b07fc1342b9bc2",22877758,1,5,0,1562,408,411,3
"33a9d248b2e44588a5b07fc1342b9bc2","6a5f020451db426dacba9e2ea3fcc62a",22877758,1,-2,0,1563,411,410,-1
"1fd0f6dadbc14ebc965faf6122190b96","1fd0f6dadbc14ebc965faf6122190b96",22877758,1,0,1,1566,415,415,0
"1fd0f6dadbc14ebc965faf6122190b96","687055dad9fc40c3982478fe33ec01bf",22877758,1,-1,0,1567,415,414,-1
"687055dad9fc40c3982478fe33ec01bf","2add1669f08d4101913db15f8c23b3b7",22877758,1,3,0,1568,414,416,2
"2add1669f08d4101913db15f8c23b3b7","2add1669f08d4101913db15f8c23b3b7",22877758,1,0,1,1569,416,416,0
"2add1669f08d4101913db15f8c23b3b7","2b09a08242b54983aec7063990fb3f66",22877758,1,-24,0,1570,416,400,-16
"2b09a08242b54983aec7063990fb3f66","a2b4bd40cee2481ebd3fc179d6a5cd62",22877758,1,27,0,1571,400,417,17
"a2b4bd40cee2481ebd3fc179d6a5cd62","e34e59dce2204f228f3a84b6725df60f",22877758,1,2,0,1572,417,419,2
"e34e59dce2204f228f3a84b6725df60f","e34e59dce2204f228f3a84b6725df60f",22877758,1,0,1,1573,419,419,0
"e34e59dce2204f228f3a84b6725df60f","a2b4bd40cee2481ebd3fc179d6a5cd62",22877758,1,-2,0,1574,419,417,-2
"a2b4bd40cee2481ebd3fc179d6a5cd62","bec48fc2e1294c7eb3d0aca780d731b8",22877758,1,4,0,1575,417,420,3
"bec48fc2e1294c7eb3d0aca780d731b8","bec48fc2e1294c7eb3d0aca780d731b8",22877758,1,0,1,1576,420,420,0
"bec48fc2e1294c7eb3d0aca780d731b8","dbde19fcce2a4c1abdc7f685c293a23f",22877758,1,3,0,1577,420,422,2
"dbde19fcce2a4c1abdc7f685c293a23f","a2b4bd40cee2481ebd3fc179d6a5cd62",22877758,1,-7,0,1578,422,417,-5
"a2b4bd40cee2481ebd3fc179d6a5cd62","24cf8786024543f19b89bc20034e60d7",22877758,1,18,0,1579,417,428,11
"24cf8786024543f19b89bc20034e60d7","f2a73be2f46840b182d7bd095378004e",22877758,2,1,0,1580,428,429,1
"f2a73be2f46840b182d7bd095378004e","604551fd4266430cb860fef58fa7dd61",22877758,1,1,0,1581,429,430,1
"604551fd4266430cb860fef58fa7dd61","604551fd4266430cb860fef58fa7dd61",22877758,8,0,1,1582,430,430,0
"604551fd4266430cb860fef58fa7dd61","24cf8786024543f19b89bc20034e60d7",22877758,1,-2,0,1590,430,428,-2
"24cf8786024543f19b89bc20034e60d7","dce46f8904594a62a6377a3587aaa663",22877758,2,4,0,1591,428,431,3
"dce46f8904594a62a6377a3587aaa663","9b9d0a249052413c869753b99682b0ac",22877758,1,1,0,1592,431,432,1
"9b9d0a249052413c869753b99682b0ac","9b9d0a249052413c869753b99682b0ac",22877758,7,0,1,1593,432,432,0
"9b9d0a249052413c869753b99682b0ac","061c175cc90f45fbad883025394e78dd",22877758,1,1,0,1600,432,433,1
"061c175cc90f45fbad883025394e78dd","061c175cc90f45fbad883025394e78dd",22877758,6,0,1,1601,433,433,0
"061c175cc90f45fbad883025394e78dd","dce46f8904594a62a6377a3587aaa663",22877758,1,-2,0,1607,433,431,-2
"dce46f8904594a62a6377a3587aaa663","24cf8786024543f19b89bc20034e60d7",22877758,1,-4,0,1608,431,428,-3
"f2a73be2f46840b182d7bd095378004e","24cf8786024543f19b89bc20034e60d7",22877758,1,-1,0,1610,429,428,-1
"dce46f8904594a62a6377a3587aaa663","dce46f8904594a62a6377a3587aaa663",22877758,1,0,1,1612,431,431,0
"dce46f8904594a62a6377a3587aaa663","74a7f8712e5449c2bc0b43c6f90dafed",22877758,1,5,0,1613,431,435,4
"74a7f8712e5449c2bc0b43c6f90dafed","74a7f8712e5449c2bc0b43c6f90dafed",22877758,1,0,1,1614,435,435,0
"74a7f8712e5449c2bc0b43c6f90dafed","66ada10dde9f43018588f1ced9d477fc",22877758,1,-1,0,1615,435,434,-1
"66ada10dde9f43018588f1ced9d477fc","bf12c96466d840a69bed7020b3f18bb8",22877758,1,3,0,1616,434,436,2
"bf12c96466d840a69bed7020b3f18bb8","bf12c96466d840a69bed7020b3f18bb8",22877758,1,0,1,1617,436,436,0
"bf12c96466d840a69bed7020b3f18bb8","24cf8786024543f19b89bc20034e60d7",22877758,1,-11,0,1618,436,428,-8
"24cf8786024543f19b89bc20034e60d7","070600601c4c439288445d2f0724807d",22877758,1,14,0,1619,428,437,9
"070600601c4c439288445d2f0724807d","1823b6de7d334a7aaabc4570719af4d9",22877758,2,2,0,1620,437,439,2
"1823b6de7d334a7aaabc4570719af4d9","1823b6de7d334a7aaabc4570719af4d9",22877758,37,0,1,1621,439,439,0
"1823b6de7d334a7aaabc4570719af4d9","070600601c4c439288445d2f0724807d",22877758,2,-2,0,1658,439,437,-2
"070600601c4c439288445d2f0724807d","0380cd76a7d44bc3a4da1f15e4d68f89",22877758,3,4,0,1659,437,440,3
"0380cd76a7d44bc3a4da1f15e4d68f89","23b7673c8b5443108c2ef09382834a86",22877758,4,2,0,1660,440,441,1
"23b7673c8b5443108c2ef09382834a86","0380cd76a7d44bc3a4da1f15e4d68f89",22877758,1,-2,0,1661,441,440,-1
"23b7673c8b5443108c2ef09382834a86","901e92500aea43c79f19f1b279050668",22877758,3,2,0,1663,441,442,1
"901e92500aea43c79f19f1b279050668","452745e0366e42ae81561bfddebcc6c3",22877758,1,2,0,1664,442,444,2
"452745e0366e42ae81561bfddebcc6c3","452745e0366e42ae81561bfddebcc6c3",22877758,9,0,1,1665,444,444,0
"452745e0366e42ae81561bfddebcc6c3","901e92500aea43c79f19f1b279050668",22877758,1,-2,0,1674,444,442,-2
"901e92500aea43c79f19f1b279050668","4660ff2089114e8db82ceb26a4f329e3",22877758,4,4,0,1675,442,445,3
"4660ff2089114e8db82ceb26a4f329e3","4660ff2089114e8db82ceb26a4f329e3",22877758,1,0,1,1676,445,445,0
"4660ff2089114e8db82ceb26a4f329e3","7bd5586eb9d8484eb74a433ee7bfe499",22877758,3,2,0,1677,445,446,1
"7bd5586eb9d8484eb74a433ee7bfe499","070600601c4c439288445d2f0724807d",22877758,2,-14,0,1678,446,437,-9
"070600601c4c439288445d2f0724807d","070600601c4c439288445d2f0724807d",22877758,1,0,1,1679,437,437,0
"0380cd76a7d44bc3a4da1f15e4d68f89","0380cd76a7d44bc3a4da1f15e4d68f89",22877758,1,0,1,1683,440,440,0
"23b7673c8b5443108c2ef09382834a86","23b7673c8b5443108c2ef09382834a86",22877758,2,0,1,1685,441,441,0
"901e92500aea43c79f19f1b279050668","001339db8ced4cf78829ebe8b145449d",22877758,1,1,0,1687,442,443,1
"001339db8ced4cf78829ebe8b145449d","001339db8ced4cf78829ebe8b145449d",22877758,12,0,1,1688,443,443,0
"001339db8ced4cf78829ebe8b145449d","4660ff2089114e8db82ceb26a4f329e3",22877758,1,3,0,1700,443,445,2
"4660ff2089114e8db82ceb26a4f329e3","901e92500aea43c79f19f1b279050668",22877758,2,-4,0,1701,445,442,-3
"7bd5586eb9d8484eb74a433ee7bfe499","7bd5586eb9d8484eb74a433ee7bfe499",22877758,10,0,1,1704,446,446,0
"7bd5586eb9d8484eb74a433ee7bfe499","8a7f26e690f34dda97be16904518ca99",22877758,1,2,0,1713,446,447,1
"8a7f26e690f34dda97be16904518ca99","8a7f26e690f34dda97be16904518ca99",22877758,1,0,1,1714,447,447,0
"8a7f26e690f34dda97be16904518ca99","070600601c4c439288445d2f0724807d",22877758,1,-16,0,1715,447,437,-10
"070600601c4c439288445d2f0724807d","b2f0d654738f48158edff28e8d3a546e",22877758,2,21,0,1716,437,449,12
"b2f0d654738f48158edff28e8d3a546e","b2f0d654738f48158edff28e8d3a546e",22877758,7,0,1,1717,449,449,0
"b2f0d654738f48158edff28e8d3a546e","f60ee41ec635499abd48168342d32c2f",22877758,11,5,0,1718,449,453,4
"f60ee41ec635499abd48168342d32c2f","f60ee41ec635499abd48168342d32c2f",22877758,122,0,1,1719,453,453,0
"f60ee41ec635499abd48168342d32c2f","b2f0d654738f48158edff28e8d3a546e",22877758,6,-5,0,1726,453,449,-4
"b2f0d654738f48158edff28e8d3a546e","f67fbf45a5f146ed866965bc57c7c001",22877758,3,8,0,1727,449,454,5
"f67fbf45a5f146ed866965bc57c7c001","f67fbf45a5f146ed866965bc57c7c001",22877758,4,0,1,1728,454,454,0
"f67fbf45a5f146ed866965bc57c7c001","d937afe49bd24a07a550dda1c1155122",22877758,1,1,0,1730,454,455,1
"d937afe49bd24a07a550dda1c1155122","d937afe49bd24a07a550dda1c1155122",22877758,1,0,1,1731,455,455,0
"d937afe49bd24a07a550dda1c1155122","3628b3f7823443d0912a339096b69943",22877758,1,1,0,1732,455,456,1
"3628b3f7823443d0912a339096b69943","3628b3f7823443d0912a339096b69943",22877758,1,0,1,1733,456,456,0
"3628b3f7823443d0912a339096b69943","9e049ee647cf43ecbcb5ed792a8e7588",22877758,1,1,0,1734,456,457,1
"9e049ee647cf43ecbcb5ed792a8e7588","9e049ee647cf43ecbcb5ed792a8e7588",22877758,1,0,1,1735,457,457,0
"9e049ee647cf43ecbcb5ed792a8e7588","5256a214faaf410b93f76cea06428334",22877758,1,1,0,1736,457,458,1
"5256a214faaf410b93f76cea06428334","5256a214faaf410b93f76cea06428334",22877758,1,0,1,1737,458,458,0
"5256a214faaf410b93f76cea06428334","25c32b120fce40fa9b6c85133aeb4716",22877758,1,1,0,1738,458,459,1
"25c32b120fce40fa9b6c85133aeb4716","25c32b120fce40fa9b6c85133aeb4716",22877758,5,0,1,1739,459,459,0
"25c32b120fce40fa9b6c85133aeb4716","11bc14f2204949008b7d511b933363c1",22877758,2,1,0,1744,459,460,1
"11bc14f2204949008b7d511b933363c1","11bc14f2204949008b7d511b933363c1",22877758,4,0,1,1745,460,460,0
"11bc14f2204949008b7d511b933363c1","42de338840a34d15adb66e7b14fb9d2c",22877758,1,1,0,1746,460,461,1
"42de338840a34d15adb66e7b14fb9d2c","42de338840a34d15adb66e7b14fb9d2c",22877758,1,0,1,1747,461,461,0
"42de338840a34d15adb66e7b14fb9d2c","9da37c6210b1416b8079c274f70bf600",22877758,1,1,0,1748,461,462,1
"9da37c6210b1416b8079c274f70bf600","9da37c6210b1416b8079c274f70bf600",22877758,1,0,1,1749,462,462,0
"9da37c6210b1416b8079c274f70bf600","519119f1deac45ff9ab4f13529be5c6e",22877758,1,1,0,1750,462,463,1
"519119f1deac45ff9ab4f13529be5c6e","519119f1deac45ff9ab4f13529be5c6e",22877758,1,0,1,1751,463,463,0
"519119f1deac45ff9ab4f13529be5c6e","25c32b120fce40fa9b6c85133aeb4716",22877758,1,-4,0,1752,463,459,-4
"11bc14f2204949008b7d511b933363c1","f67fbf45a5f146ed866965bc57c7c001",22877758,1,-6,0,1757,460,454,-6
"f67fbf45a5f146ed866965bc57c7c001","c5df9f40ec14463b9dcfdc73df3e9285",22877758,3,12,0,1758,454,464,10
"c5df9f40ec14463b9dcfdc73df3e9285","c5df9f40ec14463b9dcfdc73df3e9285",22877758,4,0,1,1759,464,464,0
"c5df9f40ec14463b9dcfdc73df3e9285","83d42d95cd844fc093fc09cee250edb8",22877758,2,3,0,1761,464,465,1
"83d42d95cd844fc093fc09cee250edb8","83d42d95cd844fc093fc09cee250edb8",22877758,7,0,1,1762,465,465,0
"83d42d95cd844fc093fc09cee250edb8","b2f0d654738f48158edff28e8d3a546e",22877758,1,-23,0,1768,465,449,-16
"b2f0d654738f48158edff28e8d3a546e","8959e6304a0348309a771e4d08d1b64a",22877758,1,-404,0,1770,449,163,-286
"8959e6304a0348309a771e4d08d1b64a","78adeee1fa2c4fe0bc73f7bca9fcee86",22877758,1,-4,0,1771,163,160,-3
"78adeee1fa2c4fe0bc73f7bca9fcee86","65202579580f4ad38d734b4ee39d22a8",22877758,8,5,0,1772,160,164,4
"65202579580f4ad38d734b4ee39d22a8","65202579580f4ad38d734b4ee39d22a8",22877758,75,0,1,1773,164,164,0
"65202579580f4ad38d734b4ee39d22a8","bc5524e78a8544e2ae2fdc2f3462bbec",22877758,1,156,0,1780,164,279,115
"bc5524e78a8544e2ae2fdc2f3462bbec","0d987bed3ffa4ed0b9a2e62e97b7b30f",22877758,1,-9,0,1781,279,272,-7
"bb5a47f5ea01454a8b79455422d3b9da","1b4550d0dab04078b3bf08a655345bdc",22877758,1,126,0,1790,280,373,93
"8d448d625b024c82a5eb240bbd7431d6","66ada10dde9f43018588f1ced9d477fc",22877758,1,92,0,1800,374,434,60
"66ada10dde9f43018588f1ced9d477fc","24cf8786024543f19b89bc20034e60d7",22877758,1,-8,0,1801,434,428,-6
"24cf8786024543f19b89bc20034e60d7","66ada10dde9f43018588f1ced9d477fc",22877758,1,8,0,1802,428,434,6
"66ada10dde9f43018588f1ced9d477fc","070600601c4c439288445d2f0724807d",22877758,1,6,0,1803,434,437,3
"070600601c4c439288445d2f0724807d","24cf8786024543f19b89bc20034e60d7",22877758,1,-14,0,1804,437,428,-9
"24cf8786024543f19b89bc20034e60d7","1823b6de7d334a7aaabc4570719af4d9",22877758,1,16,0,1805,428,439,11
"1823b6de7d334a7aaabc4570719af4d9","0380cd76a7d44bc3a4da1f15e4d68f89",22877758,1,2,0,1806,439,440,1
"0380cd76a7d44bc3a4da1f15e4d68f89","070600601c4c439288445d2f0724807d",22877758,1,-4,0,1807,440,437,-3
"f60ee41ec635499abd48168342d32c2f","070600601c4c439288445d2f0724807d",22877758,1,-26,0,1828,453,437,-16
"070600601c4c439288445d2f0724807d","afbf7250b99d47bea07172749483ca97",22877758,1,-567,0,1829,437,28,-409
"afbf7250b99d47bea07172749483ca97","4e51676dc72045d99c19b9fa7b22f8bc",22877758,2,3,0,1830,28,29,1
"4e51676dc72045d99c19b9fa7b22f8bc","afbf7250b99d47bea07172749483ca97",22877758,1,-3,0,1831,29,28,-1
"4e51676dc72045d99c19b9fa7b22f8bc","51970cfa30e643e894e66ae85c8024cc",22877758,1,3,0,1833,29,31,2
"51970cfa30e643e894e66ae85c8024cc","4e51676dc72045d99c19b9fa7b22f8bc",22877758,1,-3,0,1834,31,29,-2
"4e51676dc72045d99c19b9fa7b22f8bc","c33c17be71ae4d588da7369472e5bb1b",22877758,1,9,0,1835,29,34,5
"c33c17be71ae4d588da7369472e5bb1b","c33c17be71ae4d588da7369472e5bb1b",22877758,1,0,1,1836,34,34,0
"c33c17be71ae4d588da7369472e5bb1b","93679be414554a11b1893002f2229a93",22877758,1,3,0,1837,34,35,1
"93679be414554a11b1893002f2229a93","93679be414554a11b1893002f2229a93",22877758,1,0,1,1838,35,35,0
"93679be414554a11b1893002f2229a93","7040a13096d746ac84b8fac8d9752058",22877758,1,3,0,1839,35,36,1
"7040a13096d746ac84b8fac8d9752058","9a0dc646f934470daf08c4b56ccf73db",22877758,3,3,0,1840,36,37,1
"9a0dc646f934470daf08c4b56ccf73db","7040a13096d746ac84b8fac8d9752058",22877758,1,-3,0,1841,37,36,-1
"9a0dc646f934470daf08c4b56ccf73db","fc0e049d56024bc9a02c9a9c435c3df7",22877758,2,3,0,1843,37,38,1
"fc0e049d56024bc9a02c9a9c435c3df7","fc0e049d56024bc9a02c9a9c435c3df7",22877758,1,0,1,1844,38,38,0
"fc0e049d56024bc9a02c9a9c435c3df7","67a089198fcb4e1c8f2385786c2b296f",22877758,1,4,0,1845,38,39,1
"64d48c6c9c7940639a932219a6c87198","7040a13096d746ac84b8fac8d9752058",22877758,1,-11,0,1847,40,36,-4
"7040a13096d746ac84b8fac8d9752058","7040a13096d746ac84b8fac8d9752058",22877758,2,0,1,1848,36,36,0
"9a0dc646f934470daf08c4b56ccf73db","9a0dc646f934470daf08c4b56ccf73db",22877758,1,0,1,1851,37,37,0
"fc0e049d56024bc9a02c9a9c435c3df7","30ead9794d4847abaf222ca966cc8630",22877758,1,412,0,1853,38,348,310
"30ead9794d4847abaf222ca966cc8630","52580888dadb4fe3baa795683ea227bd",22877758,2,18,0,1854,348,364,16
"52580888dadb4fe3baa795683ea227bd","52580888dadb4fe3baa795683ea227bd",22877758,2,0,1,1855,364,364,0
"52580888dadb4fe3baa795683ea227bd","b2f0d654738f48158edff28e8d3a546e",22877758,1,134,0,1856,364,449,85
"f60ee41ec635499abd48168342d32c2f","f67fbf45a5f146ed866965bc57c7c001",22877758,2,3,0,1911,453,454,1
"f67fbf45a5f146ed866965bc57c7c001","b2f0d654738f48158edff28e8d3a546e",22877758,2,-8,0,1912,454,449,-5
"b2f0d654738f48158edff28e8d3a546e","c5df9f40ec14463b9dcfdc73df3e9285",22877758,1,20,0,1913,449,464,15
"c5df9f40ec14463b9dcfdc73df3e9285","f67fbf45a5f146ed866965bc57c7c001",22877758,1,-12,0,1914,464,454,-10
"83d42d95cd844fc093fc09cee250edb8","52580888dadb4fe3baa795683ea227bd",22877758,1,-157,0,1919,465,364,-101
"52580888dadb4fe3baa795683ea227bd","30ead9794d4847abaf222ca966cc8630",22877758,1,-18,0,1921,364,348,-16
"52580888dadb4fe3baa795683ea227bd","9428d8bd9c5a47b2a235b254e5e27ded",22877758,1,138,0,1923,364,452,88
"9428d8bd9c5a47b2a235b254e5e27ded","b2f0d654738f48158edff28e8d3a546e",22877758,4,-4,0,1924,452,449,-3
"f67fbf45a5f146ed866965bc57c7c001","9428d8bd9c5a47b2a235b254e5e27ded",22877758,1,-4,0,1937,454,452,-2
"f60ee41ec635499abd48168342d32c2f","9428d8bd9c5a47b2a235b254e5e27ded",22877758,1,-1,0,1947,453,452,-1
"c5df9f40ec14463b9dcfdc73df3e9285","3434c10e561d488a914e0f7d71907abd",22877758,1,-227,0,1964,464,305,-159
"3434c10e561d488a914e0f7d71907abd","86c27d40179e419c8e9d150fb6afa5d0",22877758,1,17,0,1965,305,319,14
"86c27d40179e419c8e9d150fb6afa5d0","86c27d40179e419c8e9d150fb6afa5d0",22877758,1,0,1,1966,319,319,0
"86c27d40179e419c8e9d150fb6afa5d0","47edbb64109243e6b0f8f64cdef90c6c",22877758,1,8,0,1967,319,326,7
"47edbb64109243e6b0f8f64cdef90c6c","8d7e0b55cf9849cda222a0f2440cec55",22877758,1,-9,0,1968,326,318,-8
"24f1363179ad4aaa965484a78471912b","24f1363179ad4aaa965484a78471912b",22877758,1,0,1,1970,323,323,0
"38aea304b4fa46e1b29bb72f5cea4c93","9428d8bd9c5a47b2a235b254e5e27ded",22877758,1,178,0,1975,331,452,121
"f60ee41ec635499abd48168342d32c2f","78adeee1fa2c4fe0bc73f7bca9fcee86",22877758,1,-413,0,1994,453,160,-293
"65202579580f4ad38d734b4ee39d22a8","0d987bed3ffa4ed0b9a2e62e97b7b30f",22877758,1,147,0,2003,164,272,108
"bb5a47f5ea01454a8b79455422d3b9da","b2f0d654738f48158edff28e8d3a546e",22877758,1,246,0,2012,280,449,169
"b613861cecf84ffcab01afb23f660475","b613861cecf84ffcab01afb23f660475",22878634,4,0,1,1,1,1,0
"b613861cecf84ffcab01afb23f660475","e2911e79efc2420eac45d9f671463d4b",22878634,1,3,0,5,1,2,1
"e2911e79efc2420eac45d9f671463d4b","e2911e79efc2420eac45d9f671463d4b",22878634,3,0,1,6,2,2,0
"e2911e79efc2420eac45d9f671463d4b","519d1b8c59404d67b54e96c5c8a830b2",22878634,1,1,0,9,2,3,1
"519d1b8c59404d67b54e96c5c8a830b2","519d1b8c59404d67b54e96c5c8a830b2",22878634,1,0,1,10,3,3,0
"519d1b8c59404d67b54e96c5c8a830b2","531db53f81f646edb0cdcfe0085b03b7",22878634,1,1,0,11,3,4,1
"531db53f81f646edb0cdcfe0085b03b7","531db53f81f646edb0cdcfe0085b03b7",22878634,1,0,1,12,4,4,0
"531db53f81f646edb0cdcfe0085b03b7","4f5f94b2f95141e0a9d53a61da2276da",22878634,1,1,0,13,4,5,1
"4f5f94b2f95141e0a9d53a61da2276da","4f5f94b2f95141e0a9d53a61da2276da",22878634,1,0,1,14,5,5,0
"4f5f94b2f95141e0a9d53a61da2276da","6d541c89590949f99af293c4f2333f67",22878634,1,1,0,15,5,6,1
"6d541c89590949f99af293c4f2333f67","6d541c89590949f99af293c4f2333f67",22878634,1,0,1,16,6,6,0
"6d541c89590949f99af293c4f2333f67","dd5cf0b9fe4c4f1d8f5ff8e4c04879cb",22878634,1,1,0,17,6,7,1
"dd5cf0b9fe4c4f1d8f5ff8e4c04879cb","dd5cf0b9fe4c4f1d8f5ff8e4c04879cb",22878634,1,0,1,18,7,7,0
"dd5cf0b9fe4c4f1d8f5ff8e4c04879cb","f96261861edc426abe2248be4f0a709a",22878634,1,1,0,19,7,8,1
"f96261861edc426abe2248be4f0a709a","f96261861edc426abe2248be4f0a709a",22878634,1,0,1,20,8,8,0
"f96261861edc426abe2248be4f0a709a","66b5e16f4f75454fb5b8172079f0fa83",22878634,1,1,0,21,8,9,1
"66b5e16f4f75454fb5b8172079f0fa83","66b5e16f4f75454fb5b8172079f0fa83",22878634,1,0,1,22,9,9,0
"66b5e16f4f75454fb5b8172079f0fa83","0680571d4698477995e41842c36a54b2",22878634,1,1,0,23,9,10,1
"0680571d4698477995e41842c36a54b2","0680571d4698477995e41842c36a54b2",22878634,1,0,1,24,10,10,0
"0680571d4698477995e41842c36a54b2","9112f2bffece48e08c6d2287be204085",22878634,1,1,0,25,10,11,1
"9112f2bffece48e08c6d2287be204085","9112f2bffece48e08c6d2287be204085",22878634,1,0,1,26,11,11,0
"9112f2bffece48e08c6d2287be204085","e2911e79efc2420eac45d9f671463d4b",22878634,1,-9,0,27,11,2,-9
"e2911e79efc2420eac45d9f671463d4b","56586aa865414f538729c7f7735d2bc6",22878634,1,12,0,28,2,12,10
"56586aa865414f538729c7f7735d2bc6","56586aa865414f538729c7f7735d2bc6",22878634,3,0,1,29,12,12,0
"56586aa865414f538729c7f7735d2bc6","b7f2b31585d94eb3bf86376714aa7070",22878634,1,2,0,32,12,13,1
"b7f2b31585d94eb3bf86376714aa7070","b7f2b31585d94eb3bf86376714aa7070",22878634,2,0,1,33,13,13,0
"b7f2b31585d94eb3bf86376714aa7070","3f1c815879794b929260d224becaff7e",22878634,1,2,0,35,13,14,1
"3f1c815879794b929260d224becaff7e","81c864a886d54a6b8ff85f7d736f4f95",22878634,1,2,0,36,14,15,1
"81c864a886d54a6b8ff85f7d736f4f95","5c5ceeee4562457ba6d41515aeebfbb1",22878634,1,4,0,37,15,17,2
"5c5ceeee4562457ba6d41515aeebfbb1","5c5ceeee4562457ba6d41515aeebfbb1",22878634,1,0,1,38,17,17,0
"5c5ceeee4562457ba6d41515aeebfbb1","56586aa865414f538729c7f7735d2bc6",22878634,1,-10,0,39,17,12,-5
"56586aa865414f538729c7f7735d2bc6","9afd71a5298d4333b6849dfce1b9422c",22878634,1,13,0,40,12,18,6
"9afd71a5298d4333b6849dfce1b9422c","9afd71a5298d4333b6849dfce1b9422c",22878634,1,0,1,41,18,18,0
"9afd71a5298d4333b6849dfce1b9422c","b7719e26494940efa49512aedd0aac79",22878634,1,4,0,42,18,20,2
"b7719e26494940efa49512aedd0aac79","d4c3b003e8274e429d2fa688d73fde6d",22878634,1,3,0,43,20,22,2
"d4c3b003e8274e429d2fa688d73fde6d","d4f45188d3c84a02ba08454e6403a818",22878634,1,2,0,44,22,24,2
"d4f45188d3c84a02ba08454e6403a818","d4c3b003e8274e429d2fa688d73fde6d",22878634,1,-2,0,45,24,22,-2
"d4c3b003e8274e429d2fa688d73fde6d","b7719e26494940efa49512aedd0aac79",22878634,1,-3,0,46,22,20,-2
"b7719e26494940efa49512aedd0aac79","b7719e26494940efa49512aedd0aac79",22878634,2,0,1,47,20,20,0
"b7719e26494940efa49512aedd0aac79","afbf7250b99d47bea07172749483ca97",22878634,2,12,0,48,20,28,8
"afbf7250b99d47bea07172749483ca97","4e51676dc72045d99c19b9fa7b22f8bc",22878634,2,3,0,49,28,29,1
"4e51676dc72045d99c19b9fa7b22f8bc","afbf7250b99d47bea07172749483ca97",22878634,1,-3,0,50,29,28,-1
"4e51676dc72045d99c19b9fa7b22f8bc","51970cfa30e643e894e66ae85c8024cc",22878634,1,3,0,52,29,31,2
"51970cfa30e643e894e66ae85c8024cc","4e51676dc72045d99c19b9fa7b22f8bc",22878634,1,-3,0,53,31,29,-2
"4e51676dc72045d99c19b9fa7b22f8bc","c33c17be71ae4d588da7369472e5bb1b",22878634,1,9,0,54,29,34,5
"c33c17be71ae4d588da7369472e5bb1b","c33c17be71ae4d588da7369472e5bb1b",22878634,1,0,1,55,34,34,0
"c33c17be71ae4d588da7369472e5bb1b","93679be414554a11b1893002f2229a93",22878634,1,3,0,56,34,35,1
"93679be414554a11b1893002f2229a93","93679be414554a11b1893002f2229a93",22878634,1,0,1,57,35,35,0
"93679be414554a11b1893002f2229a93","7040a13096d746ac84b8fac8d9752058",22878634,1,3,0,58,35,36,1
"7040a13096d746ac84b8fac8d9752058","9a0dc646f934470daf08c4b56ccf73db",22878634,1,3,0,59,36,37,1
"9a0dc646f934470daf08c4b56ccf73db","7040a13096d746ac84b8fac8d9752058",22878634,1,-3,0,60,37,36,-1
"7040a13096d746ac84b8fac8d9752058","fc0e049d56024bc9a02c9a9c435c3df7",22878634,1,6,0,61,36,38,2
"fc0e049d56024bc9a02c9a9c435c3df7","9a0dc646f934470daf08c4b56ccf73db",22878634,1,-3,0,62,38,37,-1
"9a0dc646f934470daf08c4b56ccf73db","fc0e049d56024bc9a02c9a9c435c3df7",22878634,1,3,0,63,37,38,1
"fc0e049d56024bc9a02c9a9c435c3df7","67a089198fcb4e1c8f2385786c2b296f",22878634,1,4,0,64,38,39,1
"67a089198fcb4e1c8f2385786c2b296f","64d48c6c9c7940639a932219a6c87198",22878634,2,1,0,65,39,40,1
"64d48c6c9c7940639a932219a6c87198","b7719e26494940efa49512aedd0aac79",22878634,1,-41,0,66,40,20,-20
"afbf7250b99d47bea07172749483ca97","67a089198fcb4e1c8f2385786c2b296f",22878634,1,28,0,69,28,39,11
"67a089198fcb4e1c8f2385786c2b296f","67a089198fcb4e1c8f2385786c2b296f",22878634,1,0,1,70,39,39,0
"64d48c6c9c7940639a932219a6c87198","64d48c6c9c7940639a932219a6c87198",22878634,4,0,1,72,40,40,0
"64d48c6c9c7940639a932219a6c87198","67a089198fcb4e1c8f2385786c2b296f",22878634,1,-1,0,76,40,39,-1
"67a089198fcb4e1c8f2385786c2b296f","b534b89233134e30a9b5645138bfa9ee",22878634,1,4,0,77,39,41,2
"b534b89233134e30a9b5645138bfa9ee","0e37b720d23b4e7f8b313e79313fd107",22878634,1,3,0,78,41,44,3
"0e37b720d23b4e7f8b313e79313fd107","0e37b720d23b4e7f8b313e79313fd107",22878634,3,0,1,79,44,44,0
"0e37b720d23b4e7f8b313e79313fd107","6875d67fdd5f48168b62719df449bebd",22878634,1,1,0,82,44,45,1
"6875d67fdd5f48168b62719df449bebd","6875d67fdd5f48168b62719df449bebd",22878634,1,0,1,83,45,45,0
"6875d67fdd5f48168b62719df449bebd","6e13d61a7bdb44bca949c9f86fab3be5",22878634,1,3,0,84,45,47,2
"6e13d61a7bdb44bca949c9f86fab3be5","b534b89233134e30a9b5645138bfa9ee",22878634,1,-7,0,85,47,41,-6
"b534b89233134e30a9b5645138bfa9ee","6e13d61a7bdb44bca949c9f86fab3be5",22878634,1,7,0,86,41,47,6
"6e13d61a7bdb44bca949c9f86fab3be5","6e13d61a7bdb44bca949c9f86fab3be5",22878634,2,0,1,87,47,47,0
"6e13d61a7bdb44bca949c9f86fab3be5","195f78799f984cc2b06c48dfe36be751",22878634,1,2,0,89,47,49,2
"195f78799f984cc2b06c48dfe36be751","195f78799f984cc2b06c48dfe36be751",22878634,2,0,1,90,49,49,0
"195f78799f984cc2b06c48dfe36be751","d9c8d8c444a64dadbbb508652c721e17",22878634,1,-3,0,92,49,46,-3
"d9c8d8c444a64dadbbb508652c721e17","d0c74f735e024943943e40333d6d337f",22878634,1,6,0,93,46,51,5
"d0c74f735e024943943e40333d6d337f","d0c74f735e024943943e40333d6d337f",22878634,1,0,1,94,51,51,0
"d0c74f735e024943943e40333d6d337f","983f8ff320594b279a7f4a6fe132f9c5",22878634,1,2,0,95,51,53,2
"983f8ff320594b279a7f4a6fe132f9c5","983f8ff320594b279a7f4a6fe132f9c5",22878634,2,0,1,96,53,53,0
"983f8ff320594b279a7f4a6fe132f9c5","35adfa5d923046aebabfefd98f35ff05",22878634,1,1,0,98,53,54,1
"35adfa5d923046aebabfefd98f35ff05","35adfa5d923046aebabfefd98f35ff05",22878634,2,0,1,100,54,54,0
"35adfa5d923046aebabfefd98f35ff05","b6f8a98476224da1b40e555ececc7ed8",22878634,1,1,0,101,54,55,1
"b6f8a98476224da1b40e555ececc7ed8","b6f8a98476224da1b40e555ececc7ed8",22878634,2,0,1,102,55,55,0
"b6f8a98476224da1b40e555ececc7ed8","86e22cb5fe0e4b47a9489ecddf7ed78f",22878634,1,1,0,104,55,56,1
"86e22cb5fe0e4b47a9489ecddf7ed78f","86e22cb5fe0e4b47a9489ecddf7ed78f",22878634,2,0,1,105,56,56,0
"86e22cb5fe0e4b47a9489ecddf7ed78f","f924752d8a1149668870b1e7698486f7",22878634,1,-6,0,107,56,50,-6
"f924752d8a1149668870b1e7698486f7","78f30e4dcac84e3cbea8b2cc6e0d62b3",22878634,1,10,0,108,50,59,9
"78f30e4dcac84e3cbea8b2cc6e0d62b3","a1f2f12debe5432fb7a70bcd12bacfb9",22878634,1,-1,0,109,59,58,-1
"a1f2f12debe5432fb7a70bcd12bacfb9","a1f2f12debe5432fb7a70bcd12bacfb9",22878634,14,0,1,110,58,58,0
"a1f2f12debe5432fb7a70bcd12bacfb9","78f30e4dcac84e3cbea8b2cc6e0d62b3",22878634,1,1,0,124,58,59,1
"78f30e4dcac84e3cbea8b2cc6e0d62b3","78f30e4dcac84e3cbea8b2cc6e0d62b3",22878634,7,0,1,125,59,59,0
"78f30e4dcac84e3cbea8b2cc6e0d62b3","a0a418b8540d479fa6e0f653b701da8b",22878634,1,6,0,132,59,64,5
"a0a418b8540d479fa6e0f653b701da8b","bc42d26810654ea9a1df1efe1e58c7d5",22878634,1,-1,0,133,64,63,-1
"bc42d26810654ea9a1df1efe1e58c7d5","12aa6e1672ac4e7aa6449a7a8609cd72",22878634,1,-7,0,134,63,57,-6
"12aa6e1672ac4e7aa6449a7a8609cd72","bc42d26810654ea9a1df1efe1e58c7d5",22878634,1,7,0,135,57,63,6
"bc42d26810654ea9a1df1efe1e58c7d5","bc42d26810654ea9a1df1efe1e58c7d5",22878634,3,0,1,136,63,63,0
"bc42d26810654ea9a1df1efe1e58c7d5","a0a418b8540d479fa6e0f653b701da8b",22878634,1,1,0,139,63,64,1
"a0a418b8540d479fa6e0f653b701da8b","a0a418b8540d479fa6e0f653b701da8b",22878634,3,0,1,140,64,64,0
"a0a418b8540d479fa6e0f653b701da8b","4c943503763e4e349906eea3ed3c8e86",22878634,1,-3,0,143,64,61,-3
"4c943503763e4e349906eea3ed3c8e86","4c943503763e4e349906eea3ed3c8e86",22878634,1,0,1,144,61,61,0
"4c943503763e4e349906eea3ed3c8e86","309ccf3cc4fe429d9bfbaef53d3fa479",22878634,1,-1,0,145,61,60,-1
"309ccf3cc4fe429d9bfbaef53d3fa479","d646286c8051419bbc2e31dd1db55ca8",22878634,1,10,0,146,60,67,7
"d646286c8051419bbc2e31dd1db55ca8","b534b89233134e30a9b5645138bfa9ee",22878634,1,-33,0,147,67,41,-26
"b534b89233134e30a9b5645138bfa9ee","267f883678b24aed855fde42524975d9",22878634,1,37,0,148,41,71,30
"267f883678b24aed855fde42524975d9","267f883678b24aed855fde42524975d9",22878634,1,0,1,149,71,71,0
"267f883678b24aed855fde42524975d9","88fff56d0342490dbef9040750a20f6c",22878634,1,1,0,150,71,72,1
"88fff56d0342490dbef9040750a20f6c","88fff56d0342490dbef9040750a20f6c",22878634,1,0,1,151,72,72,0
"88fff56d0342490dbef9040750a20f6c","adb17b12b66c4a49a85fd34322f7df70",22878634,1,1,0,152,72,73,1
"adb17b12b66c4a49a85fd34322f7df70","adb17b12b66c4a49a85fd34322f7df70",22878634,1,0,1,153,73,73,0
"adb17b12b66c4a49a85fd34322f7df70","d646286c8051419bbc2e31dd1db55ca8",22878634,1,-6,0,154,73,67,-6
"d646286c8051419bbc2e31dd1db55ca8","a2becd407db34b189200a32546d9d569",22878634,1,9,0,155,67,75,8
"a2becd407db34b189200a32546d9d569","a2becd407db34b189200a32546d9d569",22878634,3,0,1,156,75,75,0
"a2becd407db34b189200a32546d9d569","58c22b011d0f4c2ea6d13615edbb9eeb",22878634,1,2,0,159,75,77,2
"58c22b011d0f4c2ea6d13615edbb9eeb","58c22b011d0f4c2ea6d13615edbb9eeb",22878634,2,0,1,160,77,77,0
"58c22b011d0f4c2ea6d13615edbb9eeb","dd76e1861dc9461c830888729d091ee0",22878634,1,1,0,162,77,78,1
"dd76e1861dc9461c830888729d091ee0","dd76e1861dc9461c830888729d091ee0",22878634,5,0,1,163,78,78,0
"dd76e1861dc9461c830888729d091ee0","cd1d828f1a694b87913a7ea66c23803e",22878634,1,1,0,168,78,79,1
"cd1d828f1a694b87913a7ea66c23803e","cd1d828f1a694b87913a7ea66c23803e",22878634,2,0,1,169,79,79,0
"cd1d828f1a694b87913a7ea66c23803e","9176a3c2b4d2465fa8b0c67096c2a97e",22878634,1,1,0,171,79,80,1
"9176a3c2b4d2465fa8b0c67096c2a97e","9176a3c2b4d2465fa8b0c67096c2a97e",22878634,5,0,1,172,80,80,0
"9176a3c2b4d2465fa8b0c67096c2a97e","f8ec6445f7194e25b9101d4fbcb07a18",22878634,1,1,0,177,80,81,1
"f8ec6445f7194e25b9101d4fbcb07a18","f8ec6445f7194e25b9101d4fbcb07a18",22878634,2,0,1,178,81,81,0
"f8ec6445f7194e25b9101d4fbcb07a18","140d5b27b8574befad82c0a013b59dfa",22878634,1,-7,0,180,81,74,-7
"140d5b27b8574befad82c0a013b59dfa","d18a9ea32855445f8736581f5cb119ce",22878634,1,9,0,181,74,82,8
"d18a9ea32855445f8736581f5cb119ce","f564483cbd7a407681aa2fcca518cf5f",22878634,1,4,0,182,82,85,3
"f564483cbd7a407681aa2fcca518cf5f","f564483cbd7a407681aa2fcca518cf5f",22878634,1,0,1,183,85,85,0
"f564483cbd7a407681aa2fcca518cf5f","18fd01350bd5434ca636d59a599d768a",22878634,1,1,0,184,85,86,1
"18fd01350bd5434ca636d59a599d768a","18fd01350bd5434ca636d59a599d768a",22878634,9,0,1,185,86,86,0
"18fd01350bd5434ca636d59a599d768a","6a9f0ef185fb47f0937e29daa1c71ed5",22878634,1,5,0,194,86,90,4
"6a9f0ef185fb47f0937e29daa1c71ed5","ae5ac430ea254e708a6f5deaaf7464ae",22878634,1,-7,0,195,90,84,-6
"ae5ac430ea254e708a6f5deaaf7464ae","c681290961c94c4caf23b529d1ae6b9a",22878634,1,5,0,196,84,88,4
"c681290961c94c4caf23b529d1ae6b9a","c681290961c94c4caf23b529d1ae6b9a",22878634,1,0,1,197,88,88,0
"c681290961c94c4caf23b529d1ae6b9a","6a9f0ef185fb47f0937e29daa1c71ed5",22878634,1,2,0,198,88,90,2
"6a9f0ef185fb47f0937e29daa1c71ed5","6a9f0ef185fb47f0937e29daa1c71ed5",22878634,3,0,1,199,90,90,0
"6a9f0ef185fb47f0937e29daa1c71ed5","e20db35ced8544ddac5bc3839145e463",22878634,1,3,0,202,90,91,1
"e20db35ced8544ddac5bc3839145e463","d646286c8051419bbc2e31dd1db55ca8",22878634,1,-30,0,203,91,67,-24
"d646286c8051419bbc2e31dd1db55ca8","1febb706d7a34005ae8711ed49c76e64",22878634,1,33,0,204,67,94,27
"1febb706d7a34005ae8711ed49c76e64","1febb706d7a34005ae8711ed49c76e64",22878634,5,0,1,205,94,94,0
"1febb706d7a34005ae8711ed49c76e64","8f73ba6f5a0042f2850356ac38ac6f24",22878634,1,1,0,210,94,95,1
"8f73ba6f5a0042f2850356ac38ac6f24","8f73ba6f5a0042f2850356ac38ac6f24",22878634,5,0,1,211,95,95,0
"8f73ba6f5a0042f2850356ac38ac6f24","e2260b86653c46d7b14a41fb419dbf8c",22878634,1,1,0,216,95,96,1
"e2260b86653c46d7b14a41fb419dbf8c","e2260b86653c46d7b14a41fb419dbf8c",22878634,2,0,1,217,96,96,0
"e2260b86653c46d7b14a41fb419dbf8c","35eb641ad1d845bbba54915bce75a962",22878634,1,1,0,219,96,97,1
"35eb641ad1d845bbba54915bce75a962","35eb641ad1d845bbba54915bce75a962",22878634,5,0,1,220,97,97,0
"35eb641ad1d845bbba54915bce75a962","08be90ffbeea4795a138cd42ed8db56f",22878634,1,1,0,225,97,98,1
"08be90ffbeea4795a138cd42ed8db56f","08be90ffbeea4795a138cd42ed8db56f",22878634,5,0,1,226,98,98,0
"08be90ffbeea4795a138cd42ed8db56f","3007433c8f584dcbb5ac159c1c5f2be3",22878634,1,1,0,231,98,99,1
"3007433c8f584dcbb5ac159c1c5f2be3","3007433c8f584dcbb5ac159c1c5f2be3",22878634,5,0,1,232,99,99,0
"3007433c8f584dcbb5ac159c1c5f2be3","e20db35ced8544ddac5bc3839145e463",22878634,1,-8,0,237,99,91,-8
"e20db35ced8544ddac5bc3839145e463","00ae5f0c51874a73a41ebea838d95682",22878634,1,11,0,238,91,101,10
"00ae5f0c51874a73a41ebea838d95682","d391c8b6e56a43a7b654e9dee02d904b",22878634,2,2,0,239,101,103,2
"d391c8b6e56a43a7b654e9dee02d904b","00ae5f0c51874a73a41ebea838d95682",22878634,2,-2,0,240,103,101,-2
"00ae5f0c51874a73a41ebea838d95682","00ae5f0c51874a73a41ebea838d95682",22878634,4,0,1,241,101,101,0
"d391c8b6e56a43a7b654e9dee02d904b","d391c8b6e56a43a7b654e9dee02d904b",22878634,15,0,1,246,103,103,0
"d391c8b6e56a43a7b654e9dee02d904b","6111116566fc4fd9abba409322bea245",22878634,1,1,0,261,103,104,1
"6111116566fc4fd9abba409322bea245","6111116566fc4fd9abba409322bea245",22878634,5,0,1,262,104,104,0
"6111116566fc4fd9abba409322bea245","a81b2235cb9c499eb9ea8ee0a8dd9725",22878634,1,1,0,267,104,105,1
"a81b2235cb9c499eb9ea8ee0a8dd9725","a81b2235cb9c499eb9ea8ee0a8dd9725",22878634,2,0,1,268,105,105,0
"a81b2235cb9c499eb9ea8ee0a8dd9725","2d4e0ab0ef3b4d73b82c72d4621a7579",22878634,1,1,0,270,105,106,1
"2d4e0ab0ef3b4d73b82c72d4621a7579","2d4e0ab0ef3b4d73b82c72d4621a7579",22878634,2,0,1,271,106,106,0
"2d4e0ab0ef3b4d73b82c72d4621a7579","8bdebf492ebd4e62b0d522e8ab5e5197",22878634,1,1,0,273,106,107,1
"8bdebf492ebd4e62b0d522e8ab5e5197","8bdebf492ebd4e62b0d522e8ab5e5197",22878634,2,0,1,274,107,107,0
"8bdebf492ebd4e62b0d522e8ab5e5197","73039f8c1eb9409cb4caee2cf968001e",22878634,1,-7,0,276,107,100,-7
"73039f8c1eb9409cb4caee2cf968001e","4280927ec4d643238aa49c32f9e06c6c",22878634,1,10,0,277,100,109,9
"4280927ec4d643238aa49c32f9e06c6c","4280927ec4d643238aa49c32f9e06c6c",22878634,1,0,1,278,109,109,0
"4280927ec4d643238aa49c32f9e06c6c","fc44e6a5f7654430af1227838224dceb",22878634,1,2,0,279,109,111,2
"fc44e6a5f7654430af1227838224dceb","fc44e6a5f7654430af1227838224dceb",22878634,2,0,1,280,111,111,0
"fc44e6a5f7654430af1227838224dceb","08111f75e22d409998cf8b85bd431f0a",22878634,1,-3,0,282,111,108,-3
"08111f75e22d409998cf8b85bd431f0a","a9ae0a3c070d455bb4369a8996313336",22878634,1,7,0,283,108,114,6
"a9ae0a3c070d455bb4369a8996313336","a9ae0a3c070d455bb4369a8996313336",22878634,2,0,1,284,114,114,0
"a9ae0a3c070d455bb4369a8996313336","37319e88176d4aefa91d7a9980dbae91",22878634,1,-2,0,286,114,112,-2
"37319e88176d4aefa91d7a9980dbae91","e20db35ced8544ddac5bc3839145e463",22878634,1,-24,0,287,112,91,-21
"e20db35ced8544ddac5bc3839145e463","d391c8b6e56a43a7b654e9dee02d904b",22878634,1,13,0,288,91,103,12
"00ae5f0c51874a73a41ebea838d95682","e20db35ced8544ddac5bc3839145e463",22878634,1,-11,0,290,101,91,-10
"e20db35ced8544ddac5bc3839145e463","4280927ec4d643238aa49c32f9e06c6c",22878634,1,20,0,291,91,109,18
"4280927ec4d643238aa49c32f9e06c6c","73039f8c1eb9409cb4caee2cf968001e",22878634,1,-10,0,292,109,100,-9
"73039f8c1eb9409cb4caee2cf968001e","a9ae0a3c070d455bb4369a8996313336",22878634,1,16,0,293,100,114,14
"a9ae0a3c070d455bb4369a8996313336","08111f75e22d409998cf8b85bd431f0a",22878634,1,-7,0,294,114,108,-6
"08111f75e22d409998cf8b85bd431f0a","71cec822bcff4f30a20e75dc63ef7b65",22878634,1,9,0,295,108,116,8
"71cec822bcff4f30a20e75dc63ef7b65","71cec822bcff4f30a20e75dc63ef7b65",22878634,1,0,1,296,116,116,0
"71cec822bcff4f30a20e75dc63ef7b65","62bff51286ef4f348717a3cf6fe2318f",22878634,1,5,0,297,116,120,4
"62bff51286ef4f348717a3cf6fe2318f","37319e88176d4aefa91d7a9980dbae91",22878634,1,-9,0,298,120,112,-8
"37319e88176d4aefa91d7a9980dbae91","b1cd0e7dc3ad4a8eb91a4bfdbeb025b0",22878634,1,7,0,299,112,118,6
"b1cd0e7dc3ad4a8eb91a4bfdbeb025b0","b1cd0e7dc3ad4a8eb91a4bfdbeb025b0",22878634,1,0,1,300,118,118,0
"b1cd0e7dc3ad4a8eb91a4bfdbeb025b0","62bff51286ef4f348717a3cf6fe2318f",22878634,1,2,0,301,118,120,2
"62bff51286ef4f348717a3cf6fe2318f","62bff51286ef4f348717a3cf6fe2318f",22878634,3,0,1,302,120,120,0
"62bff51286ef4f348717a3cf6fe2318f","779f9ddd1fd14d1e9e69f72219a1fdbd",22878634,1,3,0,305,120,121,1
"779f9ddd1fd14d1e9e69f72219a1fdbd","e20db35ced8544ddac5bc3839145e463",22878634,1,-36,0,306,121,91,-30
"e20db35ced8544ddac5bc3839145e463","ae26e6cda8ad4a3f81bd347560d9579f",22878634,1,40,0,307,91,125,34
"ae26e6cda8ad4a3f81bd347560d9579f","ae26e6cda8ad4a3f81bd347560d9579f",22878634,1,0,1,308,125,125,0
"ae26e6cda8ad4a3f81bd347560d9579f","ee48df95832b4374aa273ceb27ec1315",22878634,1,1,0,309,125,126,1
"ee48df95832b4374aa273ceb27ec1315","ee48df95832b4374aa273ceb27ec1315",22878634,1,0,1,310,126,126,0
"ee48df95832b4374aa273ceb27ec1315","7a439da90b394756ad1777fc4c6dead5",22878634,1,1,0,311,126,127,1
"7a439da90b394756ad1777fc4c6dead5","7a439da90b394756ad1777fc4c6dead5",22878634,1,0,1,312,127,127,0
"7a439da90b394756ad1777fc4c6dead5","779f9ddd1fd14d1e9e69f72219a1fdbd",22878634,1,-6,0,313,127,121,-6
"779f9ddd1fd14d1e9e69f72219a1fdbd","a8dd5213034441ac92724b4e83eb0bb2",22878634,2,9,0,314,121,129,8
"a8dd5213034441ac92724b4e83eb0bb2","579338175e0b4bbb8ef3b712b5d8b54e",22878634,1,-1,0,315,129,128,-1
"579338175e0b4bbb8ef3b712b5d8b54e","779f9ddd1fd14d1e9e69f72219a1fdbd",22878634,1,-8,0,316,128,121,-7
"a8dd5213034441ac92724b4e83eb0bb2","a8dd5213034441ac92724b4e83eb0bb2",22878634,1,0,1,318,129,129,0
"a8dd5213034441ac92724b4e83eb0bb2","8115eab6556b45f5b415c3b8c26a12e5",22878634,1,2,0,319,129,131,2
"8115eab6556b45f5b415c3b8c26a12e5","8115eab6556b45f5b415c3b8c26a12e5",22878634,2,0,1,320,131,131,0
"8115eab6556b45f5b415c3b8c26a12e5","ec34b06efd844b46a4c4818ecdb9b8f4",22878634,1,1,0,322,131,132,1
"ec34b06efd844b46a4c4818ecdb9b8f4","ec34b06efd844b46a4c4818ecdb9b8f4",22878634,2,0,1,323,132,132,0
"ec34b06efd844b46a4c4818ecdb9b8f4","c2e1c2b9eac64109b343a088584b576b",22878634,1,1,0,325,132,133,1
"c2e1c2b9eac64109b343a088584b576b","c2e1c2b9eac64109b343a088584b576b",22878634,2,0,1,326,133,133,0
"c2e1c2b9eac64109b343a088584b576b","579338175e0b4bbb8ef3b712b5d8b54e",22878634,1,-5,0,328,133,128,-5
"579338175e0b4bbb8ef3b712b5d8b54e","8bc5795d6a984a3eace4e2811e52dd4f",22878634,1,8,0,329,128,135,7
"8bc5795d6a984a3eace4e2811e52dd4f","8bc5795d6a984a3eace4e2811e52dd4f",22878634,1,0,1,330,135,135,0
"8bc5795d6a984a3eace4e2811e52dd4f","b416d47c56a742199b5d7c7f19d6503a",22878634,1,-1,0,331,135,134,-1
"b416d47c56a742199b5d7c7f19d6503a","cd4532ad48034873ba8bce2aac0c9808",22878634,1,4,0,332,134,137,3
"cd4532ad48034873ba8bce2aac0c9808","cd4532ad48034873ba8bce2aac0c9808",22878634,1,0,1,333,137,137,0
"cd4532ad48034873ba8bce2aac0c9808","779f9ddd1fd14d1e9e69f72219a1fdbd",22878634,1,-19,0,334,137,121,-16
"779f9ddd1fd14d1e9e69f72219a1fdbd","df1de691dafe4549a18a4398ee9dfaf9",22878634,1,23,0,335,121,139,18
"df1de691dafe4549a18a4398ee9dfaf9","6c5ad271a44743479bfaea29b1db8d02",22878634,2,4,0,336,139,143,4
"6c5ad271a44743479bfaea29b1db8d02","6c5ad271a44743479bfaea29b1db8d02",22878634,1,0,1,337,143,143,0
"6c5ad271a44743479bfaea29b1db8d02","df1de691dafe4549a18a4398ee9dfaf9",22878634,1,-4,0,338,143,139,-4
"6c5ad271a44743479bfaea29b1db8d02","83d311bed5374fee83d8d67a7d9d82dc",22878634,1,1,0,340,143,144,1
"83d311bed5374fee83d8d67a7d9d82dc","83d311bed5374fee83d8d67a7d9d82dc",22878634,1,0,1,341,144,144,0
"83d311bed5374fee83d8d67a7d9d82dc","402bba41861d43acb52a5abb89e8831e",22878634,1,1,0,342,144,145,1
"402bba41861d43acb52a5abb89e8831e","402bba41861d43acb52a5abb89e8831e",22878634,2,0,1,343,145,145,0
"402bba41861d43acb52a5abb89e8831e","8aae34f5ddbb4052a709b12e6b0d40fa",22878634,1,3,0,345,145,147,2
"8aae34f5ddbb4052a709b12e6b0d40fa","df1de691dafe4549a18a4398ee9dfaf9",22878634,1,-9,0,346,147,139,-8
"df1de691dafe4549a18a4398ee9dfaf9","8aae34f5ddbb4052a709b12e6b0d40fa",22878634,1,9,0,347,139,147,8
"8aae34f5ddbb4052a709b12e6b0d40fa","645b3f0249f64f76af2e19eb4d0e55b7",22878634,1,2,0,348,147,149,2
"645b3f0249f64f76af2e19eb4d0e55b7","645b3f0249f64f76af2e19eb4d0e55b7",22878634,4,0,1,349,149,149,0
"645b3f0249f64f76af2e19eb4d0e55b7","7e7b8db5064d4369805ab370aac5ddfb",22878634,1,1,0,351,149,150,1
"7e7b8db5064d4369805ab370aac5ddfb","7e7b8db5064d4369805ab370aac5ddfb",22878634,2,0,1,352,150,150,0
"7e7b8db5064d4369805ab370aac5ddfb","8956d210ae7f41968fada86d4c979d6a",22878634,1,1,0,354,150,151,1
"8956d210ae7f41968fada86d4c979d6a","8956d210ae7f41968fada86d4c979d6a",22878634,2,0,1,355,151,151,0
"8956d210ae7f41968fada86d4c979d6a","645b3f0249f64f76af2e19eb4d0e55b7",22878634,1,-2,0,357,151,149,-2
"645b3f0249f64f76af2e19eb4d0e55b7","f902b0f41b544d4dbf79664fd233648d",22878634,1,-3,0,360,149,146,-3
"f902b0f41b544d4dbf79664fd233648d","ae781e8b775e4ccd93bc800dad5c8376",22878634,1,8,0,361,146,153,7
"ae781e8b775e4ccd93bc800dad5c8376","ae781e8b775e4ccd93bc800dad5c8376",22878634,2,0,1,362,153,153,0
"ae781e8b775e4ccd93bc800dad5c8376","f293c508f409466a8f27ddd7d1e40b20",22878634,1,2,0,364,153,155,2
"f293c508f409466a8f27ddd7d1e40b20","f293c508f409466a8f27ddd7d1e40b20",22878634,2,0,1,365,155,155,0
"f293c508f409466a8f27ddd7d1e40b20","cc4ddef5bbbe48ebb605141b347c4ed1",22878634,1,1,0,367,155,156,1
"cc4ddef5bbbe48ebb605141b347c4ed1","cc4ddef5bbbe48ebb605141b347c4ed1",22878634,3,0,1,368,156,156,0
"cc4ddef5bbbe48ebb605141b347c4ed1","06882a8492d9499aa31555567f575ecb",22878634,1,-2,0,371,156,154,-2
"06882a8492d9499aa31555567f575ecb","06882a8492d9499aa31555567f575ecb",22878634,1,0,1,372,154,154,0
"06882a8492d9499aa31555567f575ecb","f03480cf4eba413194d7af52fc0e7f28",22878634,1,-2,0,373,154,152,-2
"f03480cf4eba413194d7af52fc0e7f28","d313cec988a84645bee413e8d4724a4b",22878634,1,7,0,374,152,158,6
"d313cec988a84645bee413e8d4724a4b","d313cec988a84645bee413e8d4724a4b",22878634,4,0,1,375,158,158,0
"d313cec988a84645bee413e8d4724a4b","dc60696c76a74368a60f72246e47700d",22878634,1,1,0,379,158,159,1
"dc60696c76a74368a60f72246e47700d","dc60696c76a74368a60f72246e47700d",22878634,1,0,1,380,159,159,0
"dc60696c76a74368a60f72246e47700d","78adeee1fa2c4fe0bc73f7bca9fcee86",22878634,1,3,0,381,159,160,1
"78adeee1fa2c4fe0bc73f7bca9fcee86","df1de691dafe4549a18a4398ee9dfaf9",22878634,1,-26,0,382,160,139,-21
"df1de691dafe4549a18a4398ee9dfaf9","78adeee1fa2c4fe0bc73f7bca9fcee86",22878634,1,26,0,383,139,160,21
"78adeee1fa2c4fe0bc73f7bca9fcee86","78adeee1fa2c4fe0bc73f7bca9fcee86",22878634,1,0,1,384,160,160,0
"78adeee1fa2c4fe0bc73f7bca9fcee86","65202579580f4ad38d734b4ee39d22a8",22878634,5,5,0,385,160,164,4
"65202579580f4ad38d734b4ee39d22a8","65202579580f4ad38d734b4ee39d22a8",22878634,68,0,1,386,164,164,0
"65202579580f4ad38d734b4ee39d22a8","78adeee1fa2c4fe0bc73f7bca9fcee86",22878634,3,-5,0,393,164,160,-4
"65202579580f4ad38d734b4ee39d22a8","a9ac840f098c4bd0a2ee896214ce29cd",22878634,1,8,0,417,164,168,4
"a9ac840f098c4bd0a2ee896214ce29cd","78adeee1fa2c4fe0bc73f7bca9fcee86",22878634,1,-13,0,418,168,160,-8
"65202579580f4ad38d734b4ee39d22a8","3cbcea2be0984e7dbd5a48195af10ce7",22878634,1,3,0,463,164,165,1
"3cbcea2be0984e7dbd5a48195af10ce7","78adeee1fa2c4fe0bc73f7bca9fcee86",22878634,1,-8,0,464,165,160,-5
"78adeee1fa2c4fe0bc73f7bca9fcee86","82e6285962b8400d9d6fc32436022a94",22878634,1,10,0,465,160,167,7
"82e6285962b8400d9d6fc32436022a94","a9ac840f098c4bd0a2ee896214ce29cd",22878634,1,3,0,466,167,168,1
"a9ac840f098c4bd0a2ee896214ce29cd","3cbcea2be0984e7dbd5a48195af10ce7",22878634,1,-5,0,467,168,165,-3
"3cbcea2be0984e7dbd5a48195af10ce7","a9ac840f098c4bd0a2ee896214ce29cd",22878634,1,5,0,468,165,168,3
"a9ac840f098c4bd0a2ee896214ce29cd","a9ac840f098c4bd0a2ee896214ce29cd",22878634,1,0,1,469,168,168,0
"a9ac840f098c4bd0a2ee896214ce29cd","e20db35ced8544ddac5bc3839145e463",22878634,1,-98,0,470,168,91,-77
"e20db35ced8544ddac5bc3839145e463","a9ac840f098c4bd0a2ee896214ce29cd",22878634,1,98,0,471,91,168,77
"a9ac840f098c4bd0a2ee896214ce29cd","0c7262dff33c4087bc660ccf40f92f9c",22878634,1,4,0,472,168,169,1
"0c7262dff33c4087bc660ccf40f92f9c","b2275c3fad834f8d90737a2d9a6927d6",22878634,1,3,0,473,169,172,3
"b2275c3fad834f8d90737a2d9a6927d6","b2275c3fad834f8d90737a2d9a6927d6",22878634,46,0,1,474,172,172,0
"b2275c3fad834f8d90737a2d9a6927d6","eb515a26030b41f8a82a1e6114420bad",22878634,1,1,0,520,172,173,1
"eb515a26030b41f8a82a1e6114420bad","eb515a26030b41f8a82a1e6114420bad",22878634,2,0,1,521,173,173,0
"eb515a26030b41f8a82a1e6114420bad","b42cc17b7de840f181a704558d0bc845",22878634,1,3,0,523,173,175,2
"b42cc17b7de840f181a704558d0bc845","0c7262dff33c4087bc660ccf40f92f9c",22878634,1,-7,0,524,175,169,-6
"0c7262dff33c4087bc660ccf40f92f9c","b42cc17b7de840f181a704558d0bc845",22878634,1,7,0,525,169,175,6
"b42cc17b7de840f181a704558d0bc845","b42cc17b7de840f181a704558d0bc845",22878634,6,0,1,526,175,175,0
"b42cc17b7de840f181a704558d0bc845","801f9e9135034f49bf5f8b4bdefedb41",22878634,1,2,0,532,175,177,2
"801f9e9135034f49bf5f8b4bdefedb41","801f9e9135034f49bf5f8b4bdefedb41",22878634,4,0,1,533,177,177,0
"801f9e9135034f49bf5f8b4bdefedb41","362fcb0699a14845ab29b2340093e528",22878634,1,-3,0,537,177,174,-3
"362fcb0699a14845ab29b2340093e528","ea38cc0e6e6e41edbabf210220808bf9",22878634,1,6,0,538,174,179,5
"ea38cc0e6e6e41edbabf210220808bf9","b87c552dd247427abe6ab5795b9c9d43",22878634,2,2,0,539,179,181,2
"b87c552dd247427abe6ab5795b9c9d43","ea38cc0e6e6e41edbabf210220808bf9",22878634,1,-2,0,540,181,179,-2
"ea38cc0e6e6e41edbabf210220808bf9","ea38cc0e6e6e41edbabf210220808bf9",22878634,1,0,1,541,179,179,0
"b87c552dd247427abe6ab5795b9c9d43","b87c552dd247427abe6ab5795b9c9d43",22878634,7,0,1,543,181,181,0
"b87c552dd247427abe6ab5795b9c9d43","139b097acfca451689d80c9c6eebdf7b",22878634,1,-3,0,550,181,178,-3
"139b097acfca451689d80c9c6eebdf7b","30f660a1feb34582a739722532524f79",22878634,1,6,0,551,178,183,5
"30f660a1feb34582a739722532524f79","30f660a1feb34582a739722532524f79",22878634,5,0,1,552,183,183,0
"30f660a1feb34582a739722532524f79","2024b4885bd14338a39b7b509acbbd02",22878634,1,-1,0,557,183,182,-1
"2024b4885bd14338a39b7b509acbbd02","c3f63fe50d8e487c86bf8ef76c9cadd3",22878634,1,4,0,558,182,185,3
"c3f63fe50d8e487c86bf8ef76c9cadd3","c3f63fe50d8e487c86bf8ef76c9cadd3",22878634,1,0,1,559,185,185,0
"c3f63fe50d8e487c86bf8ef76c9cadd3","0c7262dff33c4087bc660ccf40f92f9c",22878634,1,-20,0,560,185,169,-16
"0c7262dff33c4087bc660ccf40f92f9c","c8e371568a0c4391b25796ae4e91952e",22878634,1,23,0,561,169,186,17
"c8e371568a0c4391b25796ae4e91952e","7d932b23e1c84326ae5aa4d3c0d813d1",22878634,1,2,0,562,186,188,2
"7d932b23e1c84326ae5aa4d3c0d813d1","7d932b23e1c84326ae5aa4d3c0d813d1",22878634,1,0,1,563,188,188,0
"7d932b23e1c84326ae5aa4d3c0d813d1","c8e371568a0c4391b25796ae4e91952e",22878634,1,-2,0,564,188,186,-2
"c8e371568a0c4391b25796ae4e91952e","ab11d94c6c8948ea90b88f19d2cd502b",22878634,1,5,0,565,186,190,4
"ab11d94c6c8948ea90b88f19d2cd502b","ab11d94c6c8948ea90b88f19d2cd502b",22878634,5,0,1,566,190,190,0
"ab11d94c6c8948ea90b88f19d2cd502b","f992451ed6ad4e68bb9e68ad6be7c4be",22878634,1,2,0,571,190,192,2
"f992451ed6ad4e68bb9e68ad6be7c4be","f992451ed6ad4e68bb9e68ad6be7c4be",22878634,1,0,1,572,192,192,0
"f992451ed6ad4e68bb9e68ad6be7c4be","07b44a7a51e94c78b411c753fc39dab0",22878634,1,-3,0,573,192,189,-3
"07b44a7a51e94c78b411c753fc39dab0","6cd2dcaac46847d4a0bc53f296d90375",22878634,1,6,0,574,189,194,5
"6cd2dcaac46847d4a0bc53f296d90375","6cd2dcaac46847d4a0bc53f296d90375",22878634,5,0,1,575,194,194,0
"6cd2dcaac46847d4a0bc53f296d90375","2d2580c9411c4972909db508d6956a58",22878634,1,2,0,580,194,196,2
"2d2580c9411c4972909db508d6956a58","2d2580c9411c4972909db508d6956a58",22878634,2,0,1,581,196,196,0
"2d2580c9411c4972909db508d6956a58","5bddb3d9ed264f3984702f048c7e5340",22878634,1,1,0,583,196,197,1
"5bddb3d9ed264f3984702f048c7e5340","5bddb3d9ed264f3984702f048c7e5340",22878634,2,0,1,584,197,197,0
"5bddb3d9ed264f3984702f048c7e5340","d5e8e2bd12a2466b9d6d90855f0eb079",22878634,1,1,0,586,197,198,1
"d5e8e2bd12a2466b9d6d90855f0eb079","d5e8e2bd12a2466b9d6d90855f0eb079",22878634,2,0,1,587,198,198,0
"d5e8e2bd12a2466b9d6d90855f0eb079","017d7ca8e0394b91aaadc9574df2202c",22878634,1,-5,0,589,198,193,-5
"017d7ca8e0394b91aaadc9574df2202c","c8e371568a0c4391b25796ae4e91952e",22878634,1,-9,0,590,193,186,-7
"c8e371568a0c4391b25796ae4e91952e","07b44a7a51e94c78b411c753fc39dab0",22878634,1,4,0,591,186,189,3
"07b44a7a51e94c78b411c753fc39dab0","ab11d94c6c8948ea90b88f19d2cd502b",22878634,1,1,0,592,189,190,1
"ab11d94c6c8948ea90b88f19d2cd502b","6cd2dcaac46847d4a0bc53f296d90375",22878634,1,5,0,593,190,194,4
"6cd2dcaac46847d4a0bc53f296d90375","07b44a7a51e94c78b411c753fc39dab0",22878634,1,-6,0,594,194,189,-5
"07b44a7a51e94c78b411c753fc39dab0","017d7ca8e0394b91aaadc9574df2202c",22878634,1,5,0,595,189,193,4
"017d7ca8e0394b91aaadc9574df2202c","54e8e9f0ea3e45c4bf3b8ac799ee31b1",22878634,1,8,0,596,193,200,7
"54e8e9f0ea3e45c4bf3b8ac799ee31b1","54e8e9f0ea3e45c4bf3b8ac799ee31b1",22878634,1,0,1,597,200,200,0
"54e8e9f0ea3e45c4bf3b8ac799ee31b1","c614a00911be4877a075f19315530fb0",22878634,1,1,0,598,200,201,1
"c614a00911be4877a075f19315530fb0","c614a00911be4877a075f19315530fb0",22878634,6,0,1,599,201,201,0
"c614a00911be4877a075f19315530fb0","a6c21bd8b95249c7972820a7a7d76aff",22878634,1,1,0,605,201,202,1
"a6c21bd8b95249c7972820a7a7d76aff","a6c21bd8b95249c7972820a7a7d76aff",22878634,1,0,1,606,202,202,0
"a6c21bd8b95249c7972820a7a7d76aff","bb329d880ab54120adaf203a693bb203",22878634,1,1,0,607,202,203,1
"bb329d880ab54120adaf203a693bb203","bb329d880ab54120adaf203a693bb203",22878634,3,0,1,608,203,203,0
"bb329d880ab54120adaf203a693bb203","f9170dd6bc6442b4acd832747609b09a",22878634,1,-4,0,611,203,199,-4
"f9170dd6bc6442b4acd832747609b09a","334c2344009840079b1d0e1b7ce3d5a7",22878634,1,7,0,612,199,205,6
"334c2344009840079b1d0e1b7ce3d5a7","334c2344009840079b1d0e1b7ce3d5a7",22878634,1,0,1,613,205,205,0
"334c2344009840079b1d0e1b7ce3d5a7","d7f13c8d63ec4e2aa673fbb9cf9c6933",22878634,1,3,0,614,205,206,1
"d7f13c8d63ec4e2aa673fbb9cf9c6933","c8e371568a0c4391b25796ae4e91952e",22878634,1,-26,0,615,206,186,-20
"c8e371568a0c4391b25796ae4e91952e","b9e80f77c3a44349863b19875725c384",22878634,1,27,0,616,186,207,21
"b9e80f77c3a44349863b19875725c384","7108f0e4c2584f1f9c471689ae4c885c",22878634,2,1,0,617,207,208,1
"7108f0e4c2584f1f9c471689ae4c885c","b9e80f77c3a44349863b19875725c384",22878634,1,-1,0,618,208,207,-1
"b9e80f77c3a44349863b19875725c384","b9e80f77c3a44349863b19875725c384",22878634,13,0,1,619,207,207,0
"7108f0e4c2584f1f9c471689ae4c885c","7108f0e4c2584f1f9c471689ae4c885c",22878634,10,0,1,633,208,208,0
"7108f0e4c2584f1f9c471689ae4c885c","d7f13c8d63ec4e2aa673fbb9cf9c6933",22878634,1,-2,0,643,208,206,-2
"d7f13c8d63ec4e2aa673fbb9cf9c6933","09400e101c5d4b439cf9a26b03aae558",22878634,1,5,0,644,206,210,4
"09400e101c5d4b439cf9a26b03aae558","09400e101c5d4b439cf9a26b03aae558",22878634,5,0,1,645,210,210,0
"09400e101c5d4b439cf9a26b03aae558","a88efa7e50ce47159810ab553afa6d3a",22878634,1,2,0,650,210,212,2
"a88efa7e50ce47159810ab553afa6d3a","a88efa7e50ce47159810ab553afa6d3a",22878634,5,0,1,651,212,212,0
"a88efa7e50ce47159810ab553afa6d3a","be502a7a43c44bf7b682698de79d9369",22878634,1,3,0,656,212,214,2
"be502a7a43c44bf7b682698de79d9369","a875096404ef4a9984b62d74cda916f9",22878634,1,-6,0,657,214,209,-5
"a875096404ef4a9984b62d74cda916f9","f7fb1952f56b4189b86a9f8b7862d2b8",22878634,1,7,0,658,209,215,6
"f7fb1952f56b4189b86a9f8b7862d2b8","be502a7a43c44bf7b682698de79d9369",22878634,1,-1,0,659,215,214,-1
"be502a7a43c44bf7b682698de79d9369","be502a7a43c44bf7b682698de79d9369",22878634,4,0,1,660,214,214,0
"be502a7a43c44bf7b682698de79d9369","f7fb1952f56b4189b86a9f8b7862d2b8",22878634,1,1,0,664,214,215,1
"f7fb1952f56b4189b86a9f8b7862d2b8","f7fb1952f56b4189b86a9f8b7862d2b8",22878634,11,0,1,665,215,215,0
"f7fb1952f56b4189b86a9f8b7862d2b8","b860ee85d8bc4a2f97958cfb71be3533",22878634,1,1,0,676,215,216,1
"b860ee85d8bc4a2f97958cfb71be3533","b860ee85d8bc4a2f97958cfb71be3533",22878634,2,0,1,677,216,216,0
"b860ee85d8bc4a2f97958cfb71be3533","ec341f459285443b8361f7f15638ff08",22878634,1,-3,0,679,216,213,-3
"ec341f459285443b8361f7f15638ff08","363837c182e04711840d896ae1e0339c",22878634,1,6,0,680,213,218,5
"363837c182e04711840d896ae1e0339c","363837c182e04711840d896ae1e0339c",22878634,12,0,1,681,218,218,0
"363837c182e04711840d896ae1e0339c","01b2051f8941460d89945e3b02d1ce78",22878634,1,-1,0,693,218,217,-1
"01b2051f8941460d89945e3b02d1ce78","91125ca626c5470eb145501f8c37f8db",22878634,1,4,0,694,217,220,3
"91125ca626c5470eb145501f8c37f8db","91125ca626c5470eb145501f8c37f8db",22878634,1,0,1,695,220,220,0
"91125ca626c5470eb145501f8c37f8db","d7f13c8d63ec4e2aa673fbb9cf9c6933",22878634,1,-18,0,696,220,206,-14
"d7f13c8d63ec4e2aa673fbb9cf9c6933","1c6721b1f63f4d30ba7746ea8af02a52",22878634,1,21,0,697,206,221,15
"1c6721b1f63f4d30ba7746ea8af02a52","77ecef8eff6b4a2caea7707669bf7475",22878634,1,1,0,698,221,222,1
"77ecef8eff6b4a2caea7707669bf7475","77ecef8eff6b4a2caea7707669bf7475",22878634,13,0,1,699,222,222,0
"77ecef8eff6b4a2caea7707669bf7475","d03cb855c70044cf8c35d9ec0de696e3",22878634,1,3,0,712,222,224,2
"d03cb855c70044cf8c35d9ec0de696e3","1c6721b1f63f4d30ba7746ea8af02a52",22878634,1,-4,0,713,224,221,-3
"1c6721b1f63f4d30ba7746ea8af02a52","8b9ae98743bd4d4a8a87dff1c1244211",22878634,1,7,0,714,221,227,6
"8b9ae98743bd4d4a8a87dff1c1244211","1c6721b1f63f4d30ba7746ea8af02a52",22878634,1,-7,0,715,227,221,-6
"1c6721b1f63f4d30ba7746ea8af02a52","d03cb855c70044cf8c35d9ec0de696e3",22878634,1,4,0,716,221,224,3
"d03cb855c70044cf8c35d9ec0de696e3","8b9ae98743bd4d4a8a87dff1c1244211",22878634,1,3,0,717,224,227,3
"8b9ae98743bd4d4a8a87dff1c1244211","d03cb855c70044cf8c35d9ec0de696e3",22878634,1,-3,0,718,227,224,-3
"d03cb855c70044cf8c35d9ec0de696e3","d03cb855c70044cf8c35d9ec0de696e3",22878634,6,0,1,719,224,224,0
"d03cb855c70044cf8c35d9ec0de696e3","a49a937d6896486d9a5396654abcf2e1",22878634,1,2,0,725,224,226,2
"a49a937d6896486d9a5396654abcf2e1","a49a937d6896486d9a5396654abcf2e1",22878634,3,0,1,726,226,226,0
"a49a937d6896486d9a5396654abcf2e1","8b9ae98743bd4d4a8a87dff1c1244211",22878634,1,1,0,729,226,227,1
"8b9ae98743bd4d4a8a87dff1c1244211","8b9ae98743bd4d4a8a87dff1c1244211",22878634,18,0,1,730,227,227,0
"8b9ae98743bd4d4a8a87dff1c1244211","f7906d6f59b9489a91d2ef40db5a474d",22878634,1,-4,0,748,227,223,-4
"f7906d6f59b9489a91d2ef40db5a474d","2ab1535aac1346ba8801535bf729ef37",22878634,1,7,0,749,223,229,6
"2ab1535aac1346ba8801535bf729ef37","2ab1535aac1346ba8801535bf729ef37",22878634,6,0,1,750,229,229,0
"2ab1535aac1346ba8801535bf729ef37","a4f40fb48a8542c8949bae1f002cd9bc",22878634,1,2,0,756,229,231,2
"a4f40fb48a8542c8949bae1f002cd9bc","a4f40fb48a8542c8949bae1f002cd9bc",22878634,2,0,1,757,231,231,0
"a4f40fb48a8542c8949bae1f002cd9bc","8972c23e32044edb8a78fa1eed4e5947",22878634,1,1,0,759,231,232,1
"8972c23e32044edb8a78fa1eed4e5947","8972c23e32044edb8a78fa1eed4e5947",22878634,1,0,1,760,232,232,0
"8972c23e32044edb8a78fa1eed4e5947","92feb4a40f8344d38b6f722e42a53295",22878634,1,1,0,761,232,233,1
"92feb4a40f8344d38b6f722e42a53295","92feb4a40f8344d38b6f722e42a53295",22878634,2,0,1,762,233,233,0
"92feb4a40f8344d38b6f722e42a53295","5152833676bf4c6cb317060be10f68db",22878634,1,-5,0,764,233,228,-5
"5152833676bf4c6cb317060be10f68db","ca3e28f290354c08aefe5b0f769604e6",22878634,1,8,0,765,228,235,7
"ca3e28f290354c08aefe5b0f769604e6","ca3e28f290354c08aefe5b0f769604e6",22878634,9,0,1,766,235,235,0
"ca3e28f290354c08aefe5b0f769604e6","79a35eea833e4c2c9d22fc53c3c6445c",22878634,1,1,0,775,235,236,1
"79a35eea833e4c2c9d22fc53c3c6445c","79a35eea833e4c2c9d22fc53c3c6445c",22878634,4,0,1,776,236,236,0
"79a35eea833e4c2c9d22fc53c3c6445c","8f68228b1518449e9615cdafee41a2bd",22878634,1,1,0,780,236,237,1
"8f68228b1518449e9615cdafee41a2bd","8f68228b1518449e9615cdafee41a2bd",22878634,1,0,1,781,237,237,0
"8f68228b1518449e9615cdafee41a2bd","cab89fa5c3ed45a5aa550fc0352d6a42",22878634,1,1,0,782,237,238,1
"cab89fa5c3ed45a5aa550fc0352d6a42","cab89fa5c3ed45a5aa550fc0352d6a42",22878634,1,0,1,783,238,238,0
"cab89fa5c3ed45a5aa550fc0352d6a42","66d4fad4f1cf4b46be0750a99ad7a35a",22878634,1,1,0,784,238,239,1
"66d4fad4f1cf4b46be0750a99ad7a35a","66d4fad4f1cf4b46be0750a99ad7a35a",22878634,1,0,1,785,239,239,0
"66d4fad4f1cf4b46be0750a99ad7a35a","0b04c8e2f86d48c7aeb7e225819cd32b",22878634,1,-5,0,786,239,234,-5
"0b04c8e2f86d48c7aeb7e225819cd32b","f53da5fd9bfe412da4b80d4742563b6c",22878634,1,8,0,787,234,241,7
"f53da5fd9bfe412da4b80d4742563b6c","f53da5fd9bfe412da4b80d4742563b6c",22878634,1,0,1,788,241,241,0
"f53da5fd9bfe412da4b80d4742563b6c","2ae94c0cea4d480a9d5dca8fb1d7b542",22878634,1,3,0,789,241,242,1
"2ae94c0cea4d480a9d5dca8fb1d7b542","1c6721b1f63f4d30ba7746ea8af02a52",22878634,1,-27,0,790,242,221,-21
"1c6721b1f63f4d30ba7746ea8af02a52","1ebf23f9d994469a85206e4c7b1bf5f5",22878634,1,30,0,791,221,245,24
"1ebf23f9d994469a85206e4c7b1bf5f5","1ebf23f9d994469a85206e4c7b1bf5f5",22878634,10,0,1,792,245,245,0
"1ebf23f9d994469a85206e4c7b1bf5f5","85ae675b83e8422da842cfd25596af99",22878634,1,1,0,802,245,246,1
"85ae675b83e8422da842cfd25596af99","85ae675b83e8422da842cfd25596af99",22878634,1,0,1,803,246,246,0
"85ae675b83e8422da842cfd25596af99","fa235f0f364d47e4ae1c87f47bf8e6ba",22878634,1,8,0,804,246,252,6
"fa235f0f364d47e4ae1c87f47bf8e6ba","2ae94c0cea4d480a9d5dca8fb1d7b542",22878634,1,-12,0,805,252,242,-10
"2ae94c0cea4d480a9d5dca8fb1d7b542","fa235f0f364d47e4ae1c87f47bf8e6ba",22878634,1,12,0,806,242,252,10
"fa235f0f364d47e4ae1c87f47bf8e6ba","79f7845465cc4ed19d8e4f1429541be0",22878634,1,2,0,807,252,254,2
"79f7845465cc4ed19d8e4f1429541be0","79f7845465cc4ed19d8e4f1429541be0",22878634,2,0,1,808,254,254,0
"79f7845465cc4ed19d8e4f1429541be0","00f61990949545828dd12f1303d47504",22878634,1,3,0,810,254,256,2
"00f61990949545828dd12f1303d47504","6e83e23f56544a19b94067c1c558d9c0",22878634,1,-11,0,811,256,247,-9
"6e83e23f56544a19b94067c1c558d9c0","00f61990949545828dd12f1303d47504",22878634,1,11,0,812,247,256,9
"00f61990949545828dd12f1303d47504","00f61990949545828dd12f1303d47504",22878634,1,0,1,813,256,256,0
"00f61990949545828dd12f1303d47504","ead7bb4b64e247d2ae632ab8a296b091",22878634,1,2,0,814,256,258,2
"ead7bb4b64e247d2ae632ab8a296b091","ead7bb4b64e247d2ae632ab8a296b091",22878634,2,0,1,815,258,258,0
"ead7bb4b64e247d2ae632ab8a296b091","41b0048dde734bb280bac6116baa8e27",22878634,1,1,0,817,258,259,1
"41b0048dde734bb280bac6116baa8e27","41b0048dde734bb280bac6116baa8e27",22878634,2,0,1,818,259,259,0
"41b0048dde734bb280bac6116baa8e27","b41c5a094a604ee0915327da5cc0beb7",22878634,1,1,0,820,259,260,1
"b41c5a094a604ee0915327da5cc0beb7","b41c5a094a604ee0915327da5cc0beb7",22878634,2,0,1,821,260,260,0
"b41c5a094a604ee0915327da5cc0beb7","d546341988904f069cfa86b21457d9d9",22878634,1,-10,0,823,260,251,-9
"d546341988904f069cfa86b21457d9d9","28c171777c52431ab6b925073bd63d46",22878634,1,15,0,824,251,264,13
"28c171777c52431ab6b925073bd63d46","28c171777c52431ab6b925073bd63d46",22878634,3,0,1,825,264,264,0
"28c171777c52431ab6b925073bd63d46","ac160db940cb49ae8579162b1d52bb5d",22878634,1,2,0,828,264,266,2
"ac160db940cb49ae8579162b1d52bb5d","ac160db940cb49ae8579162b1d52bb5d",22878634,3,0,1,829,266,266,0
"ac160db940cb49ae8579162b1d52bb5d","d989ebcfc12a4b669f0100dc1aa14f1e",22878634,1,-12,0,832,266,255,-11
"d989ebcfc12a4b669f0100dc1aa14f1e","c6fd49b485cc4874b0bbdd9c6171e09c",22878634,1,15,0,833,255,268,13
"c6fd49b485cc4874b0bbdd9c6171e09c","c6fd49b485cc4874b0bbdd9c6171e09c",22878634,7,0,1,834,268,268,0
"c6fd49b485cc4874b0bbdd9c6171e09c","44240778a97c4af0937817499b75707b",22878634,1,1,0,841,268,269,1
"44240778a97c4af0937817499b75707b","44240778a97c4af0937817499b75707b",22878634,2,0,1,842,269,269,0
"44240778a97c4af0937817499b75707b","7aa76d3e993840d8805f097cbdbcd44b",22878634,1,-9,0,844,269,261,-8
"7aa76d3e993840d8805f097cbdbcd44b","865a4d3b43374da7944dc7d397f566d9",22878634,1,12,0,845,261,271,10
"865a4d3b43374da7944dc7d397f566d9","865a4d3b43374da7944dc7d397f566d9",22878634,1,0,1,846,271,271,0
"865a4d3b43374da7944dc7d397f566d9","0d987bed3ffa4ed0b9a2e62e97b7b30f",22878634,1,3,0,847,271,272,1
"0d987bed3ffa4ed0b9a2e62e97b7b30f","2ae94c0cea4d480a9d5dca8fb1d7b542",22878634,1,-38,0,848,272,242,-30
"2ae94c0cea4d480a9d5dca8fb1d7b542","0d987bed3ffa4ed0b9a2e62e97b7b30f",22878634,1,38,0,849,242,272,30
"0d987bed3ffa4ed0b9a2e62e97b7b30f","94cecc3f1e7d484b8e068e79241dfd73",22878634,1,13,0,860,272,281,9
"94cecc3f1e7d484b8e068e79241dfd73","a37477c4e4c14169ad44b06b493007f6",22878634,1,2,0,861,281,283,2
"a37477c4e4c14169ad44b06b493007f6","94cecc3f1e7d484b8e068e79241dfd73",22878634,1,-2,0,862,283,281,-2
"94cecc3f1e7d484b8e068e79241dfd73","fab84b4fab5940efb4ea868ef8d09396",22878634,1,5,0,863,281,284,3
"fab84b4fab5940efb4ea868ef8d09396","4a29443515bb404cb8924e1c60a63b73",22878634,1,4,0,864,284,285,1
"4a29443515bb404cb8924e1c60a63b73","fab84b4fab5940efb4ea868ef8d09396",22878634,1,-4,0,865,285,284,-1
"fab84b4fab5940efb4ea868ef8d09396","208c9b2796c944db8dacaa96082520ea",22878634,1,7,0,866,284,288,4
"208c9b2796c944db8dacaa96082520ea","208c9b2796c944db8dacaa96082520ea",22878634,2,0,1,867,288,288,0
"208c9b2796c944db8dacaa96082520ea","4a29443515bb404cb8924e1c60a63b73",22878634,1,-3,0,869,288,285,-3
"4a29443515bb404cb8924e1c60a63b73","6a9a3b5bde4a48daa896fe8c06eca56f",22878634,1,5,0,870,285,289,4
"6a9a3b5bde4a48daa896fe8c06eca56f","4a29443515bb404cb8924e1c60a63b73",22878634,1,-5,0,871,289,285,-4
"4a29443515bb404cb8924e1c60a63b73","7669a956527947d0add87455277e80b4",22878634,1,7,0,872,285,291,6
"7669a956527947d0add87455277e80b4","7669a956527947d0add87455277e80b4",22878634,1,0,1,873,291,291,0
"7669a956527947d0add87455277e80b4","869e967078f04da18dd0b0b9389a7424",22878634,1,3,0,874,291,293,2
"869e967078f04da18dd0b0b9389a7424","6a9a3b5bde4a48daa896fe8c06eca56f",22878634,1,-5,0,875,293,289,-4
"6a9a3b5bde4a48daa896fe8c06eca56f","869e967078f04da18dd0b0b9389a7424",22878634,1,5,0,876,289,293,4
"869e967078f04da18dd0b0b9389a7424","869e967078f04da18dd0b0b9389a7424",22878634,2,0,1,877,293,293,0
"869e967078f04da18dd0b0b9389a7424","51ab6291537748fab90d519aa09889d6",22878634,1,2,0,879,293,295,2
"51ab6291537748fab90d519aa09889d6","51ab6291537748fab90d519aa09889d6",22878634,5,0,1,880,295,295,0
"51ab6291537748fab90d519aa09889d6","34a6e49023fc4465bd5ca604330bbd1c",22878634,1,-3,0,885,295,292,-3
"34a6e49023fc4465bd5ca604330bbd1c","ba0e59461bfb4a44b7b1c28a01f8d3b3",22878634,1,9,0,886,292,299,7
"ba0e59461bfb4a44b7b1c28a01f8d3b3","21592f2a9e9c4b2f8c66ec5dbcbf6a2b",22878634,1,-4,0,887,299,296,-3
"21592f2a9e9c4b2f8c66ec5dbcbf6a2b","ba0e59461bfb4a44b7b1c28a01f8d3b3",22878634,1,4,0,888,296,299,3
"ba0e59461bfb4a44b7b1c28a01f8d3b3","ba0e59461bfb4a44b7b1c28a01f8d3b3",22878634,4,0,1,889,299,299,0
"ba0e59461bfb4a44b7b1c28a01f8d3b3","0e0b36e731a645e7b1b8a88f5031ca38",22878634,1,2,0,893,299,301,2
"0e0b36e731a645e7b1b8a88f5031ca38","0e0b36e731a645e7b1b8a88f5031ca38",22878634,2,0,1,894,301,301,0
"0e0b36e731a645e7b1b8a88f5031ca38","a66a144637284c21afc6de17fea4bfb8",22878634,1,1,0,896,301,302,1
"a66a144637284c21afc6de17fea4bfb8","a66a144637284c21afc6de17fea4bfb8",22878634,2,0,1,897,302,302,0
"a66a144637284c21afc6de17fea4bfb8","7646a919d7e64fa990bca9b024ff089d",22878634,1,-4,0,899,302,298,-4
"7646a919d7e64fa990bca9b024ff089d","ba0e59461bfb4a44b7b1c28a01f8d3b3",22878634,1,1,0,900,298,299,1
"ba0e59461bfb4a44b7b1c28a01f8d3b3","2c5bb2cbd0014420ad8c95d40e38efd1",22878634,1,5,0,901,299,303,4
"2c5bb2cbd0014420ad8c95d40e38efd1","7646a919d7e64fa990bca9b024ff089d",22878634,1,-6,0,902,303,298,-5
"7646a919d7e64fa990bca9b024ff089d","e390b575229748ea8aac9364efe2bf00",22878634,1,7,0,903,298,304,6
"e390b575229748ea8aac9364efe2bf00","e390b575229748ea8aac9364efe2bf00",22878634,1,0,1,904,304,304,0
"e390b575229748ea8aac9364efe2bf00","3434c10e561d488a914e0f7d71907abd",22878634,1,3,0,905,304,305,1
"3434c10e561d488a914e0f7d71907abd","4a29443515bb404cb8924e1c60a63b73",22878634,1,-27,0,906,305,285,-20
"4a29443515bb404cb8924e1c60a63b73","53e7e900392747ccad52e711ab0f80d8",22878634,1,29,0,907,285,307,22
"53e7e900392747ccad52e711ab0f80d8","53e7e900392747ccad52e711ab0f80d8",22878634,5,0,1,908,307,307,0
"53e7e900392747ccad52e711ab0f80d8","130acc2aeb0448fdbb2de63bc5cebe5b",22878634,1,3,0,913,307,309,2
"130acc2aeb0448fdbb2de63bc5cebe5b","3434c10e561d488a914e0f7d71907abd",22878634,1,-5,0,914,309,305,-4
"3434c10e561d488a914e0f7d71907abd","130acc2aeb0448fdbb2de63bc5cebe5b",22878634,1,5,0,915,305,309,4
"130acc2aeb0448fdbb2de63bc5cebe5b","130acc2aeb0448fdbb2de63bc5cebe5b",22878634,1,0,1,916,309,309,0
"130acc2aeb0448fdbb2de63bc5cebe5b","9c062b3251034ebe90f5054e2a3b5120",22878634,1,2,0,917,309,311,2
"9c062b3251034ebe90f5054e2a3b5120","9c062b3251034ebe90f5054e2a3b5120",22878634,2,0,1,918,311,311,0
"9c062b3251034ebe90f5054e2a3b5120","ea859f8207e44537889daeaba13ac2e8",22878634,1,1,0,920,311,312,1
"ea859f8207e44537889daeaba13ac2e8","ea859f8207e44537889daeaba13ac2e8",22878634,1,0,1,921,312,312,0
"ea859f8207e44537889daeaba13ac2e8","56d94971a7a94257aa330183a8ebd0ea",22878634,1,1,0,922,312,313,1
"56d94971a7a94257aa330183a8ebd0ea","56d94971a7a94257aa330183a8ebd0ea",22878634,1,0,1,923,313,313,0
"56d94971a7a94257aa330183a8ebd0ea","141c0df6cd1946539aadd1c9b7068cd4",22878634,1,-5,0,924,313,308,-5
"141c0df6cd1946539aadd1c9b7068cd4","13255e63e0aa4abf85e5211bf613d43e",22878634,1,10,0,925,308,317,9
"13255e63e0aa4abf85e5211bf613d43e","13255e63e0aa4abf85e5211bf613d43e",22878634,1,0,1,926,317,317,0
"13255e63e0aa4abf85e5211bf613d43e","0c787d16c9504873b1a4d903cec09948",22878634,1,-3,0,927,317,314,-3
"0c787d16c9504873b1a4d903cec09948","86c27d40179e419c8e9d150fb6afa5d0",22878634,1,6,0,928,314,319,5
"86c27d40179e419c8e9d150fb6afa5d0","86c27d40179e419c8e9d150fb6afa5d0",22878634,2,0,1,929,319,319,0
"86c27d40179e419c8e9d150fb6afa5d0","8d7e0b55cf9849cda222a0f2440cec55",22878634,2,-1,0,931,319,318,-1
"8d7e0b55cf9849cda222a0f2440cec55","47edbb64109243e6b0f8f64cdef90c6c",22878634,2,9,0,932,318,326,8
"47edbb64109243e6b0f8f64cdef90c6c","24f1363179ad4aaa965484a78471912b",22878634,2,-3,0,933,326,323,-3
"24f1363179ad4aaa965484a78471912b","24f1363179ad4aaa965484a78471912b",22878634,1,0,1,934,323,323,0
"24f1363179ad4aaa965484a78471912b","3628bdce1dd2429ba924d2d4d09448d2",22878634,2,-1,0,935,323,322,-1
"3628bdce1dd2429ba924d2d4d09448d2","3434c10e561d488a914e0f7d71907abd",22878634,1,-21,0,936,322,305,-17
"3434c10e561d488a914e0f7d71907abd","8d7e0b55cf9849cda222a0f2440cec55",22878634,1,16,0,937,305,318,13
"8d7e0b55cf9849cda222a0f2440cec55","86c27d40179e419c8e9d150fb6afa5d0",22878634,1,1,0,938,318,319,1
"3628bdce1dd2429ba924d2d4d09448d2","56b3fd1a212a4764be39d979fde3326e",22878634,1,7,0,943,322,328,6
"56b3fd1a212a4764be39d979fde3326e","56b3fd1a212a4764be39d979fde3326e",22878634,1,0,1,944,328,328,0
"56b3fd1a212a4764be39d979fde3326e","0c4079457ede49e3aeb5e86ed84bdf35",22878634,1,3,0,945,328,329,1
"38aea304b4fa46e1b29bb72f5cea4c93","38aea304b4fa46e1b29bb72f5cea4c93",22878634,5,0,1,948,331,331,0
"38aea304b4fa46e1b29bb72f5cea4c93","e36d261332f14e79bb4b467aceaeb9b5",22878634,1,2,0,953,331,333,2
"e36d261332f14e79bb4b467aceaeb9b5","e36d261332f14e79bb4b467aceaeb9b5",22878634,1,0,1,954,333,333,0
"e36d261332f14e79bb4b467aceaeb9b5","c7e89b9d04744d2eab742fc24e3ef1ae",22878634,1,1,0,955,333,334,1
"c7e89b9d04744d2eab742fc24e3ef1ae","c7e89b9d04744d2eab742fc24e3ef1ae",22878634,2,0,1,956,334,334,0
"c7e89b9d04744d2eab742fc24e3ef1ae","fe49f8054b374a0ea4bb266ed135ff62",22878634,1,1,0,958,334,335,1
"fe49f8054b374a0ea4bb266ed135ff62","fe49f8054b374a0ea4bb266ed135ff62",22878634,2,0,1,959,335,335,0
"fe49f8054b374a0ea4bb266ed135ff62","d0a8f74af98642fe8360d22c42e45117",22878634,1,1,0,961,335,336,1
"d0a8f74af98642fe8360d22c42e45117","d0a8f74af98642fe8360d22c42e45117",22878634,2,0,1,962,336,336,0
"d0a8f74af98642fe8360d22c42e45117","0c4079457ede49e3aeb5e86ed84bdf35",22878634,1,-7,0,964,336,329,-7
"0c4079457ede49e3aeb5e86ed84bdf35","a7c6339ca1da4368a18d471f0519f877",22878634,1,11,0,965,329,339,10
"a7c6339ca1da4368a18d471f0519f877","a7c6339ca1da4368a18d471f0519f877",22878634,1,0,1,966,339,339,0
"a7c6339ca1da4368a18d471f0519f877","bbc5139ca9024389a94db3a6f47dcff6",22878634,1,3,0,967,339,341,2
"b8b9418ab322418d9db9b40d96af873a","bbc5139ca9024389a94db3a6f47dcff6",22878634,1,5,0,969,337,341,4
"bbc5139ca9024389a94db3a6f47dcff6","bbc5139ca9024389a94db3a6f47dcff6",22878634,6,0,1,970,341,341,0
"bbc5139ca9024389a94db3a6f47dcff6","4ee6ca9019ab4a1ab323f98094a9bd77",22878634,1,2,0,976,341,343,2
"4ee6ca9019ab4a1ab323f98094a9bd77","4ee6ca9019ab4a1ab323f98094a9bd77",22878634,2,0,1,977,343,343,0
"4ee6ca9019ab4a1ab323f98094a9bd77","b37947176785476f8b29d49a851366dc",22878634,1,1,0,979,343,344,1
"b37947176785476f8b29d49a851366dc","b37947176785476f8b29d49a851366dc",22878634,2,0,1,980,344,344,0
"b37947176785476f8b29d49a851366dc","fcea5b10d5a14a3b9324ffece8f6e1e5",22878634,1,1,0,982,344,345,1
"fcea5b10d5a14a3b9324ffece8f6e1e5","fcea5b10d5a14a3b9324ffece8f6e1e5",22878634,2,0,1,983,345,345,0
"fcea5b10d5a14a3b9324ffece8f6e1e5","c2490bc612d146edbe786556fab3651b",22878634,1,-5,0,985,345,340,-5
"c2490bc612d146edbe786556fab3651b","6ac8bb048b854999a47edb35fe627f11",22878634,1,8,0,986,340,347,7
"6ac8bb048b854999a47edb35fe627f11","6ac8bb048b854999a47edb35fe627f11",22878634,1,0,1,987,347,347,0
"6ac8bb048b854999a47edb35fe627f11","0c4079457ede49e3aeb5e86ed84bdf35",22878634,1,-21,0,988,347,329,-18
"30ead9794d4847abaf222ca966cc8630","c20993c944444fe085345591a8bd837e",22878634,1,3,0,990,348,351,3
"897b7f51242c44aab2205c72fdcbf4cd","897b7f51242c44aab2205c72fdcbf4cd",22878634,5,0,1,1000,352,352,0
"897b7f51242c44aab2205c72fdcbf4cd","09b9678ddc3d452ea4a3d46e15826065",22878634,2,1,0,1002,352,353,1
"09b9678ddc3d452ea4a3d46e15826065","09b9678ddc3d452ea4a3d46e15826065",22878634,5,0,1,1003,353,353,0
"09b9678ddc3d452ea4a3d46e15826065","eff0de7f2dbb42dfa1a2e686efab5b6d",22878634,2,1,0,1006,353,354,1
"eff0de7f2dbb42dfa1a2e686efab5b6d","eff0de7f2dbb42dfa1a2e686efab5b6d",22878634,5,0,1,1007,354,354,0
"eff0de7f2dbb42dfa1a2e686efab5b6d","30ead9794d4847abaf222ca966cc8630",22878634,2,-6,0,1010,354,348,-6
"30ead9794d4847abaf222ca966cc8630","2fe14166dc9642c3bc666b86a57f943d",22878634,1,10,0,1011,348,357,9
"2fe14166dc9642c3bc666b86a57f943d","2fe14166dc9642c3bc666b86a57f943d",22878634,1,0,1,1012,357,357,0
"2fe14166dc9642c3bc666b86a57f943d","44421dd1e13a47a388c4a19834b744c7",22878634,1,2,0,1013,357,359,2
"44421dd1e13a47a388c4a19834b744c7","44421dd1e13a47a388c4a19834b744c7",22878634,2,0,1,1014,359,359,0
"44421dd1e13a47a388c4a19834b744c7","cb5fc7ef85d547c4be1a7439d0bf6052",22878634,1,1,0,1016,359,360,1
"cb5fc7ef85d547c4be1a7439d0bf6052","cb5fc7ef85d547c4be1a7439d0bf6052",22878634,6,0,1,1017,360,360,0
"cb5fc7ef85d547c4be1a7439d0bf6052","0a8f150a4cf747acbde62f4721823da3",22878634,1,1,0,1023,360,361,1
"0a8f150a4cf747acbde62f4721823da3","0a8f150a4cf747acbde62f4721823da3",22878634,2,0,1,1024,361,361,0
"0a8f150a4cf747acbde62f4721823da3","ab8fdad974ae471f9f24c3f9dd04462e",22878634,1,1,0,1026,361,362,1
"ab8fdad974ae471f9f24c3f9dd04462e","ab8fdad974ae471f9f24c3f9dd04462e",22878634,2,0,1,1027,362,362,0
"ab8fdad974ae471f9f24c3f9dd04462e","1ba8fef685d74a8194b9db252eb704fb",22878634,1,-7,0,1029,362,355,-7
"1ba8fef685d74a8194b9db252eb704fb","52580888dadb4fe3baa795683ea227bd",22878634,1,10,0,1030,355,364,9
"52580888dadb4fe3baa795683ea227bd","52580888dadb4fe3baa795683ea227bd",22878634,2,0,1,1031,364,364,0
"52580888dadb4fe3baa795683ea227bd","492a3bc6a1254f23a7998587961b22a4",22878634,1,3,0,1033,364,366,2
"492a3bc6a1254f23a7998587961b22a4","f00179e251a045b39c3f7a54f9aa4acc",22878634,1,-4,0,1034,366,363,-3
"f00179e251a045b39c3f7a54f9aa4acc","492a3bc6a1254f23a7998587961b22a4",22878634,1,4,0,1035,363,366,3
"492a3bc6a1254f23a7998587961b22a4","492a3bc6a1254f23a7998587961b22a4",22878634,1,0,1,1036,366,366,0
"492a3bc6a1254f23a7998587961b22a4","072a190fd302456290895f9f04d6940a",22878634,1,-1,0,1037,366,365,-1
"072a190fd302456290895f9f04d6940a","cfa457d1743848e4bb5e4beced6448ed",22878634,1,5,0,1038,365,369,4
"cfa457d1743848e4bb5e4beced6448ed","cfa457d1743848e4bb5e4beced6448ed",22878634,1,0,1,1039,369,369,0
"cfa457d1743848e4bb5e4beced6448ed","b71bac264efb4abd97015447bd490db6",22878634,1,3,0,1040,369,370,1
"b71bac264efb4abd97015447bd490db6","30ead9794d4847abaf222ca966cc8630",22878634,1,-28,0,1041,370,348,-22
"30ead9794d4847abaf222ca966cc8630","8d448d625b024c82a5eb240bbd7431d6",22878634,1,33,0,1042,348,374,26
"8d448d625b024c82a5eb240bbd7431d6","8d448d625b024c82a5eb240bbd7431d6",22878634,58,0,1,1043,374,374,0
"8d448d625b024c82a5eb240bbd7431d6","b71bac264efb4abd97015447bd490db6",22878634,2,-5,0,1049,374,370,-4
"b71bac264efb4abd97015447bd490db6","8d448d625b024c82a5eb240bbd7431d6",22878634,2,5,0,1050,370,374,4
"8d448d625b024c82a5eb240bbd7431d6","1b4550d0dab04078b3bf08a655345bdc",22878634,1,-1,0,1051,374,373,-1
"1b4550d0dab04078b3bf08a655345bdc","3434c10e561d488a914e0f7d71907abd",22878634,1,-87,0,1052,373,305,-68
"3434c10e561d488a914e0f7d71907abd","43ea1b823a4b4e51b7c694c10725db82",22878634,2,27,0,1053,305,327,22
"43ea1b823a4b4e51b7c694c10725db82","0c4079457ede49e3aeb5e86ed84bdf35",22878634,1,4,0,1054,327,329,2
"0c4079457ede49e3aeb5e86ed84bdf35","3434c10e561d488a914e0f7d71907abd",22878634,3,-31,0,1055,329,305,-24
"3434c10e561d488a914e0f7d71907abd","38aea304b4fa46e1b29bb72f5cea4c93",22878634,2,33,0,1056,305,331,26
"38aea304b4fa46e1b29bb72f5cea4c93","0c4079457ede49e3aeb5e86ed84bdf35",22878634,2,-2,0,1057,331,329,-2
"0c4079457ede49e3aeb5e86ed84bdf35","0c4079457ede49e3aeb5e86ed84bdf35",22878634,1,0,1,1058,329,329,0
"0c4079457ede49e3aeb5e86ed84bdf35","30ead9794d4847abaf222ca966cc8630",22878634,3,24,0,1059,329,348,19
"30ead9794d4847abaf222ca966cc8630","897b7f51242c44aab2205c72fdcbf4cd",22878634,1,4,0,1060,348,352,4
"eff0de7f2dbb42dfa1a2e686efab5b6d","09b9678ddc3d452ea4a3d46e15826065",22878634,4,-1,0,1065,354,353,-1
"09b9678ddc3d452ea4a3d46e15826065","c20993c944444fe085345591a8bd837e",22878634,3,-2,0,1066,353,351,-2
"c20993c944444fe085345591a8bd837e","c20993c944444fe085345591a8bd837e",22878634,6,0,1,1067,351,351,0
"c20993c944444fe085345591a8bd837e","897b7f51242c44aab2205c72fdcbf4cd",22878634,5,1,0,1069,351,352,1
"897b7f51242c44aab2205c72fdcbf4cd","eff0de7f2dbb42dfa1a2e686efab5b6d",22878634,3,2,0,1071,352,354,2
"30ead9794d4847abaf222ca966cc8630","c76574d21bc14aeea7ecd0b027f39858",22878634,1,23,0,1073,348,367,19
"c76574d21bc14aeea7ecd0b027f39858","2fe14166dc9642c3bc666b86a57f943d",22878634,1,-13,0,1074,367,357,-10
"2fe14166dc9642c3bc666b86a57f943d","eff0de7f2dbb42dfa1a2e686efab5b6d",22878634,1,-4,0,1075,357,354,-3
"09b9678ddc3d452ea4a3d46e15826065","1ba8fef685d74a8194b9db252eb704fb",22878634,1,3,0,1084,353,355,2
"1ba8fef685d74a8194b9db252eb704fb","c20993c944444fe085345591a8bd837e",22878634,1,-5,0,1085,355,351,-4
"897b7f51242c44aab2205c72fdcbf4cd","0c4079457ede49e3aeb5e86ed84bdf35",22878634,1,-28,0,1088,352,329,-23
"30ead9794d4847abaf222ca966cc8630","4a92daef4d504e1792575a26502bb7b7",22878634,1,-4,0,1090,348,346,-2
"4a92daef4d504e1792575a26502bb7b7","38aea304b4fa46e1b29bb72f5cea4c93",22878634,1,-18,0,1091,346,331,-15
"38aea304b4fa46e1b29bb72f5cea4c93","b8b9418ab322418d9db9b40d96af873a",22878634,1,7,0,1092,331,337,6
"b8b9418ab322418d9db9b40d96af873a","0c4079457ede49e3aeb5e86ed84bdf35",22878634,1,-9,0,1093,337,329,-8
"43ea1b823a4b4e51b7c694c10725db82","0c787d16c9504873b1a4d903cec09948",22878634,1,-16,0,1096,327,314,-13
"0c787d16c9504873b1a4d903cec09948","3434c10e561d488a914e0f7d71907abd",22878634,1,-11,0,1097,314,305,-9
"3434c10e561d488a914e0f7d71907abd","0c4079457ede49e3aeb5e86ed84bdf35",22878634,1,31,0,1098,305,329,24
"0c4079457ede49e3aeb5e86ed84bdf35","38aea304b4fa46e1b29bb72f5cea4c93",22878634,1,2,0,1099,329,331,2
"0c4079457ede49e3aeb5e86ed84bdf35","bbc5139ca9024389a94db3a6f47dcff6",22878634,1,14,0,1101,329,341,12
"bbc5139ca9024389a94db3a6f47dcff6","b8b9418ab322418d9db9b40d96af873a",22878634,2,-5,0,1102,341,337,-4
"b8b9418ab322418d9db9b40d96af873a","c2490bc612d146edbe786556fab3651b",22878634,1,4,0,1103,337,340,3
"c2490bc612d146edbe786556fab3651b","8d448d625b024c82a5eb240bbd7431d6",22878634,1,44,0,1104,340,374,34
"8d448d625b024c82a5eb240bbd7431d6","d6d02b6ef04e4f17805504500b8ce441",22878634,2,3,0,1158,374,375,1
"d6d02b6ef04e4f17805504500b8ce441","d6d02b6ef04e4f17805504500b8ce441",22878634,6,0,1,1159,375,375,0
"d6d02b6ef04e4f17805504500b8ce441","66baf19b6b904b70922329068c63746d",22878634,1,4,0,1165,375,376,1
"66baf19b6b904b70922329068c63746d","7f544639412e40a9ba27f43b415362ab",22878634,1,2,0,1166,376,378,2
"7f544639412e40a9ba27f43b415362ab","8d448d625b024c82a5eb240bbd7431d6",22878634,1,-9,0,1167,378,374,-4
"d6d02b6ef04e4f17805504500b8ce441","b71bac264efb4abd97015447bd490db6",22878634,1,-8,0,1170,375,370,-5
"b71bac264efb4abd97015447bd490db6","d6d02b6ef04e4f17805504500b8ce441",22878634,1,8,0,1171,370,375,5
"d6d02b6ef04e4f17805504500b8ce441","7f544639412e40a9ba27f43b415362ab",22878634,1,6,0,1172,375,378,3
"7f544639412e40a9ba27f43b415362ab","d5ae8642e15b46b8bd298b02274d4e9c",22878634,1,2,0,1173,378,380,2
"d5ae8642e15b46b8bd298b02274d4e9c","d5ae8642e15b46b8bd298b02274d4e9c",22878634,1,0,1,1174,380,380,0
"d5ae8642e15b46b8bd298b02274d4e9c","a0d10309a2dd456289147f84be9d37f9",22878634,1,1,0,1175,380,381,1
"a0d10309a2dd456289147f84be9d37f9","a0d10309a2dd456289147f84be9d37f9",22878634,2,0,1,1176,381,381,0
"a0d10309a2dd456289147f84be9d37f9","0fcbc3ca07b144138b8d85da581f09a8",22878634,1,1,0,1178,381,382,1
"0fcbc3ca07b144138b8d85da581f09a8","0fcbc3ca07b144138b8d85da581f09a8",22878634,2,0,1,1179,382,382,0
"0fcbc3ca07b144138b8d85da581f09a8","66baf19b6b904b70922329068c63746d",22878634,1,-6,0,1181,382,376,-6
"66baf19b6b904b70922329068c63746d","4890121ce5d74576b4632b77cfc23398",22878634,1,14,0,1182,376,388,12
"4890121ce5d74576b4632b77cfc23398","c2fca3669923477ab966ded303dea31c",22878634,1,-6,0,1183,388,383,-5
"c2fca3669923477ab966ded303dea31c","4890121ce5d74576b4632b77cfc23398",22878634,1,6,0,1184,383,388,5
"4890121ce5d74576b4632b77cfc23398","96bb2b3e85a34d8b9544514e89f6fe97",22878634,1,3,0,1185,388,390,2
"96bb2b3e85a34d8b9544514e89f6fe97","18d3b836dd804224883cc9180b60a8e1",22878634,1,-4,0,1186,390,387,-3
"18d3b836dd804224883cc9180b60a8e1","66baf19b6b904b70922329068c63746d",22878634,1,-13,0,1187,387,376,-11
"66baf19b6b904b70922329068c63746d","96bb2b3e85a34d8b9544514e89f6fe97",22878634,1,17,0,1188,376,390,14
"96bb2b3e85a34d8b9544514e89f6fe97","96bb2b3e85a34d8b9544514e89f6fe97",22878634,2,0,1,1189,390,390,0
"96bb2b3e85a34d8b9544514e89f6fe97","ac4e9b54acfe4670b4634859c7263cb5",22878634,1,2,0,1191,390,392,2
"ac4e9b54acfe4670b4634859c7263cb5","ac4e9b54acfe4670b4634859c7263cb5",22878634,1,0,1,1192,392,392,0
"ac4e9b54acfe4670b4634859c7263cb5","17f95d18bab743888e1736033dc3384d",22878634,1,-3,0,1193,392,389,-3
"17f95d18bab743888e1736033dc3384d","6f8881a745ac4c358a68b92c3b4abe81",22878634,1,6,0,1194,389,394,5
"6f8881a745ac4c358a68b92c3b4abe81","6f8881a745ac4c358a68b92c3b4abe81",22878634,2,0,1,1195,394,394,0
"6f8881a745ac4c358a68b92c3b4abe81","f7002c8484354eceac57bc7bd62c76c1",22878634,1,-1,0,1197,394,393,-1
"f7002c8484354eceac57bc7bd62c76c1","44a277ea44dc4ae689fab4b82f0b4098",22878634,1,5,0,1198,393,397,4
"44a277ea44dc4ae689fab4b82f0b4098","44a277ea44dc4ae689fab4b82f0b4098",22878634,1,0,1,1199,397,397,0
"44a277ea44dc4ae689fab4b82f0b4098","0c12af0a4e7f4002852cf84b2537c161",22878634,1,-2,0,1200,397,395,-2
"0c12af0a4e7f4002852cf84b2537c161","859e0b8d71694b12befb69ee698138f9",22878634,1,5,0,1201,395,399,4
"859e0b8d71694b12befb69ee698138f9","859e0b8d71694b12befb69ee698138f9",22878634,1,0,1,1202,399,399,0
"859e0b8d71694b12befb69ee698138f9","2b09a08242b54983aec7063990fb3f66",22878634,1,3,0,1203,399,400,1
"2b09a08242b54983aec7063990fb3f66","66baf19b6b904b70922329068c63746d",22878634,1,-32,0,1204,400,376,-24
"66baf19b6b904b70922329068c63746d","2b09a08242b54983aec7063990fb3f66",22878634,1,32,0,1205,376,400,24
"2b09a08242b54983aec7063990fb3f66","2b09a08242b54983aec7063990fb3f66",22878634,6,0,1,1206,400,400,0
"2b09a08242b54983aec7063990fb3f66","1f471b7a883a4df48211e8c6a81b59a7",22878634,1,1,0,1212,400,401,1
"1f471b7a883a4df48211e8c6a81b59a7","1f471b7a883a4df48211e8c6a81b59a7",22878634,1,0,1,1213,401,401,0
"1f471b7a883a4df48211e8c6a81b59a7","2b09a08242b54983aec7063990fb3f66",22878634,1,-1,0,1214,401,400,-1
"2b09a08242b54983aec7063990fb3f66","0c4079457ede49e3aeb5e86ed84bdf35",22878634,1,-96,0,1215,400,329,-71
"0c4079457ede49e3aeb5e86ed84bdf35","9de0d567bfa84fe5b77cb76f4a76a5d1",22878634,1,101,0,1216,329,404,75
"9de0d567bfa84fe5b77cb76f4a76a5d1","9de0d567bfa84fe5b77cb76f4a76a5d1",22878634,1,0,1,1217,404,404,0
"9de0d567bfa84fe5b77cb76f4a76a5d1","1157bd665ec4472fb58b751dc5099355",22878634,1,-1,0,1218,404,403,-1
"1157bd665ec4472fb58b751dc5099355","3c8a22d2f9c146ea956609e3ed4f2559",22878634,1,3,0,1219,403,405,2
"3c8a22d2f9c146ea956609e3ed4f2559","58fc9094275e4c49be3f4ba6d4acc0a4",22878634,1,2,0,1220,405,406,1
"58fc9094275e4c49be3f4ba6d4acc0a4","58fc9094275e4c49be3f4ba6d4acc0a4",22878634,3,0,1,1221,406,406,0
"58fc9094275e4c49be3f4ba6d4acc0a4","c1c1be90b2b14c1ab4a5e1ee3c241902",22878634,1,1,0,1224,406,407,1
"c1c1be90b2b14c1ab4a5e1ee3c241902","c1c1be90b2b14c1ab4a5e1ee3c241902",22878634,5,0,1,1225,407,407,0
"c1c1be90b2b14c1ab4a5e1ee3c241902","58fc9094275e4c49be3f4ba6d4acc0a4",22878634,1,-1,0,1230,407,406,-1
"58fc9094275e4c49be3f4ba6d4acc0a4","02b3a1bead9244c1ba2f857c7da8f82a",22878634,1,3,0,1231,406,408,2
"02b3a1bead9244c1ba2f857c7da8f82a","02b3a1bead9244c1ba2f857c7da8f82a",22878634,3,0,1,1232,408,408,0
"02b3a1bead9244c1ba2f857c7da8f82a","6206fc6479014bb193084c32409dc1b9",22878634,1,1,0,1235,408,409,1
"6206fc6479014bb193084c32409dc1b9","6206fc6479014bb193084c32409dc1b9",22878634,1,0,1,1236,409,409,0
"6206fc6479014bb193084c32409dc1b9","6a5f020451db426dacba9e2ea3fcc62a",22878634,1,2,0,1237,409,410,1
"6a5f020451db426dacba9e2ea3fcc62a","02b3a1bead9244c1ba2f857c7da8f82a",22878634,1,-3,0,1238,410,408,-2
"02b3a1bead9244c1ba2f857c7da8f82a","6a5f020451db426dacba9e2ea3fcc62a",22878634,1,3,0,1239,408,410,2
"6a5f020451db426dacba9e2ea3fcc62a","6a5f020451db426dacba9e2ea3fcc62a",22878634,1,0,1,1240,410,410,0
"6a5f020451db426dacba9e2ea3fcc62a","33a9d248b2e44588a5b07fc1342b9bc2",22878634,2,2,0,1241,410,411,1
"33a9d248b2e44588a5b07fc1342b9bc2","6a5f020451db426dacba9e2ea3fcc62a",22878634,1,-2,0,1242,411,410,-1
"33a9d248b2e44588a5b07fc1342b9bc2","33a9d248b2e44588a5b07fc1342b9bc2",22878634,6,0,1,1244,411,411,0
"33a9d248b2e44588a5b07fc1342b9bc2","c6f26bd420634f1cb7989e76fe6b16c0",22878634,1,1,0,1250,411,412,1
"c6f26bd420634f1cb7989e76fe6b16c0","c6f26bd420634f1cb7989e76fe6b16c0",22878634,5,0,1,1251,412,412,0
"c6f26bd420634f1cb7989e76fe6b16c0","2a65ee6e2ac64f6a8a55fbe5373ec763",22878634,1,1,0,1256,412,413,1
"2a65ee6e2ac64f6a8a55fbe5373ec763","2a65ee6e2ac64f6a8a55fbe5373ec763",22878634,2,0,1,1257,413,413,0
"2a65ee6e2ac64f6a8a55fbe5373ec763","33a9d248b2e44588a5b07fc1342b9bc2",22878634,1,-2,0,1259,413,411,-2
"33a9d248b2e44588a5b07fc1342b9bc2","687055dad9fc40c3982478fe33ec01bf",22878634,1,4,0,1260,411,414,3
"687055dad9fc40c3982478fe33ec01bf","2add1669f08d4101913db15f8c23b3b7",22878634,2,3,0,1261,414,416,2
"2add1669f08d4101913db15f8c23b3b7","1fd0f6dadbc14ebc965faf6122190b96",22878634,1,-2,0,1262,416,415,-1
"1fd0f6dadbc14ebc965faf6122190b96","1fd0f6dadbc14ebc965faf6122190b96",22878634,1,0,1,1263,415,415,0
"1fd0f6dadbc14ebc965faf6122190b96","687055dad9fc40c3982478fe33ec01bf",22878634,1,-1,0,1264,415,414,-1
"2add1669f08d4101913db15f8c23b3b7","2add1669f08d4101913db15f8c23b3b7",22878634,1,0,1,1266,416,416,0
"2add1669f08d4101913db15f8c23b3b7","a2b4bd40cee2481ebd3fc179d6a5cd62",22878634,1,3,0,1267,416,417,1
"a2b4bd40cee2481ebd3fc179d6a5cd62","2b09a08242b54983aec7063990fb3f66",22878634,1,-27,0,1268,417,400,-17
"2b09a08242b54983aec7063990fb3f66","a2b4bd40cee2481ebd3fc179d6a5cd62",22878634,1,27,0,1269,400,417,17
"a2b4bd40cee2481ebd3fc179d6a5cd62","e34e59dce2204f228f3a84b6725df60f",22878634,1,2,0,1270,417,419,2
"e34e59dce2204f228f3a84b6725df60f","e34e59dce2204f228f3a84b6725df60f",22878634,1,0,1,1271,419,419,0
"e34e59dce2204f228f3a84b6725df60f","bec48fc2e1294c7eb3d0aca780d731b8",22878634,1,2,0,1272,419,420,1
"bec48fc2e1294c7eb3d0aca780d731b8","a2b4bd40cee2481ebd3fc179d6a5cd62",22878634,1,-4,0,1273,420,417,-3
"a2b4bd40cee2481ebd3fc179d6a5cd62","bec48fc2e1294c7eb3d0aca780d731b8",22878634,1,4,0,1274,417,420,3
"bec48fc2e1294c7eb3d0aca780d731b8","bec48fc2e1294c7eb3d0aca780d731b8",22878634,5,0,1,1275,420,420,0
"bec48fc2e1294c7eb3d0aca780d731b8","dbde19fcce2a4c1abdc7f685c293a23f",22878634,1,3,0,1280,420,422,2
"dbde19fcce2a4c1abdc7f685c293a23f","a24600b0e49245f6bdba8c893cfeddb0",22878634,1,4,0,1281,422,425,3
"a24600b0e49245f6bdba8c893cfeddb0","a24600b0e49245f6bdba8c893cfeddb0",22878634,3,0,1,1282,425,425,0
"a24600b0e49245f6bdba8c893cfeddb0","a2b4bd40cee2481ebd3fc179d6a5cd62",22878634,1,-11,0,1285,425,417,-8
"a2b4bd40cee2481ebd3fc179d6a5cd62","24cf8786024543f19b89bc20034e60d7",22878634,1,18,0,1286,417,428,11
"24cf8786024543f19b89bc20034e60d7","f2a73be2f46840b182d7bd095378004e",22878634,1,1,0,1287,428,429,1
"f2a73be2f46840b182d7bd095378004e","f2a73be2f46840b182d7bd095378004e",22878634,3,0,1,1288,429,429,0
"f2a73be2f46840b182d7bd095378004e","604551fd4266430cb860fef58fa7dd61",22878634,1,1,0,1291,429,430,1
"604551fd4266430cb860fef58fa7dd61","604551fd4266430cb860fef58fa7dd61",22878634,4,0,1,1292,430,430,0
"604551fd4266430cb860fef58fa7dd61","24cf8786024543f19b89bc20034e60d7",22878634,1,-2,0,1296,430,428,-2
"24cf8786024543f19b89bc20034e60d7","dce46f8904594a62a6377a3587aaa663",22878634,1,4,0,1297,428,431,3
"dce46f8904594a62a6377a3587aaa663","dce46f8904594a62a6377a3587aaa663",22878634,11,0,1,1298,431,431,0
"dce46f8904594a62a6377a3587aaa663","9b9d0a249052413c869753b99682b0ac",22878634,1,1,0,1309,431,432,1
"9b9d0a249052413c869753b99682b0ac","9b9d0a249052413c869753b99682b0ac",22878634,3,0,1,1310,432,432,0
"9b9d0a249052413c869753b99682b0ac","061c175cc90f45fbad883025394e78dd",22878634,1,1,0,1313,432,433,1
"061c175cc90f45fbad883025394e78dd","061c175cc90f45fbad883025394e78dd",22878634,5,0,1,1314,433,433,0
"061c175cc90f45fbad883025394e78dd","dce46f8904594a62a6377a3587aaa663",22878634,1,-2,0,1319,433,431,-2
"dce46f8904594a62a6377a3587aaa663","74a7f8712e5449c2bc0b43c6f90dafed",22878634,1,5,0,1320,431,435,4
"74a7f8712e5449c2bc0b43c6f90dafed","74a7f8712e5449c2bc0b43c6f90dafed",22878634,1,0,1,1321,435,435,0
"74a7f8712e5449c2bc0b43c6f90dafed","66ada10dde9f43018588f1ced9d477fc",22878634,1,-1,0,1322,435,434,-1
"66ada10dde9f43018588f1ced9d477fc","bf12c96466d840a69bed7020b3f18bb8",22878634,1,3,0,1323,434,436,2
"bf12c96466d840a69bed7020b3f18bb8","bf12c96466d840a69bed7020b3f18bb8",22878634,1,0,1,1324,436,436,0
"bf12c96466d840a69bed7020b3f18bb8","24cf8786024543f19b89bc20034e60d7",22878634,1,-11,0,1325,436,428,-8
"24cf8786024543f19b89bc20034e60d7","070600601c4c439288445d2f0724807d",22878634,1,14,0,1326,428,437,9
"070600601c4c439288445d2f0724807d","1823b6de7d334a7aaabc4570719af4d9",22878634,1,2,0,1327,437,439,2
"1823b6de7d334a7aaabc4570719af4d9","1823b6de7d334a7aaabc4570719af4d9",22878634,11,0,1,1328,439,439,0
"1823b6de7d334a7aaabc4570719af4d9","070600601c4c439288445d2f0724807d",22878634,1,-2,0,1339,439,437,-2
"070600601c4c439288445d2f0724807d","0380cd76a7d44bc3a4da1f15e4d68f89",22878634,1,4,0,1340,437,440,3
"0380cd76a7d44bc3a4da1f15e4d68f89","0380cd76a7d44bc3a4da1f15e4d68f89",22878634,2,0,1,1341,440,440,0
"0380cd76a7d44bc3a4da1f15e4d68f89","23b7673c8b5443108c2ef09382834a86",22878634,2,2,0,1343,440,441,1
"23b7673c8b5443108c2ef09382834a86","0380cd76a7d44bc3a4da1f15e4d68f89",22878634,1,-2,0,1344,441,440,-1
"23b7673c8b5443108c2ef09382834a86","901e92500aea43c79f19f1b279050668",22878634,2,2,0,1346,441,442,1
"901e92500aea43c79f19f1b279050668","23b7673c8b5443108c2ef09382834a86",22878634,1,-2,0,1347,442,441,-1
"901e92500aea43c79f19f1b279050668","901e92500aea43c79f19f1b279050668",22878634,1,0,1,1349,442,442,0
"901e92500aea43c79f19f1b279050668","001339db8ced4cf78829ebe8b145449d",22878634,1,1,0,1350,442,443,1
"001339db8ced4cf78829ebe8b145449d","001339db8ced4cf78829ebe8b145449d",22878634,5,0,1,1351,443,443,0
"001339db8ced4cf78829ebe8b145449d","452745e0366e42ae81561bfddebcc6c3",22878634,1,1,0,1356,443,444,1
"452745e0366e42ae81561bfddebcc6c3","452745e0366e42ae81561bfddebcc6c3",22878634,2,0,1,1357,444,444,0
"452745e0366e42ae81561bfddebcc6c3","4660ff2089114e8db82ceb26a4f329e3",22878634,1,2,0,1359,444,445,1
"4660ff2089114e8db82ceb26a4f329e3","901e92500aea43c79f19f1b279050668",22878634,1,-4,0,1360,445,442,-3
"901e92500aea43c79f19f1b279050668","4660ff2089114e8db82ceb26a4f329e3",22878634,1,4,0,1361,442,445,3
"4660ff2089114e8db82ceb26a4f329e3","4660ff2089114e8db82ceb26a4f329e3",22878634,1,0,1,1362,445,445,0
"4660ff2089114e8db82ceb26a4f329e3","7bd5586eb9d8484eb74a433ee7bfe499",22878634,1,2,0,1363,445,446,1
"7bd5586eb9d8484eb74a433ee7bfe499","7bd5586eb9d8484eb74a433ee7bfe499",22878634,12,0,1,1364,446,446,0
"7bd5586eb9d8484eb74a433ee7bfe499","8a7f26e690f34dda97be16904518ca99",22878634,3,2,0,1374,446,447,1
"8a7f26e690f34dda97be16904518ca99","070600601c4c439288445d2f0724807d",22878634,1,-16,0,1375,447,437,-10
"070600601c4c439288445d2f0724807d","7bd5586eb9d8484eb74a433ee7bfe499",22878634,1,14,0,1376,437,446,9
"8a7f26e690f34dda97be16904518ca99","7bd5586eb9d8484eb74a433ee7bfe499",22878634,1,-2,0,1379,447,446,-1
"8a7f26e690f34dda97be16904518ca99","8a7f26e690f34dda97be16904518ca99",22878634,1,0,1,1382,447,447,0
"8a7f26e690f34dda97be16904518ca99","b2f0d654738f48158edff28e8d3a546e",22878634,1,5,0,1383,447,449,2
"b2f0d654738f48158edff28e8d3a546e","070600601c4c439288445d2f0724807d",22878634,1,-21,0,1384,449,437,-12
"070600601c4c439288445d2f0724807d","bc5524e78a8544e2ae2fdc2f3462bbec",22878634,1,-226,0,1385,437,279,-158
"bc5524e78a8544e2ae2fdc2f3462bbec","0d987bed3ffa4ed0b9a2e62e97b7b30f",22878634,3,-9,0,1386,279,272,-7
"0d987bed3ffa4ed0b9a2e62e97b7b30f","bb5a47f5ea01454a8b79455422d3b9da",22878634,8,10,0,1387,272,280,8
"bb5a47f5ea01454a8b79455422d3b9da","bb5a47f5ea01454a8b79455422d3b9da",22878634,128,0,1,1388,280,280,0
"bb5a47f5ea01454a8b79455422d3b9da","b2f0d654738f48158edff28e8d3a546e",22878634,3,246,0,1395,280,449,169
"b2f0d654738f48158edff28e8d3a546e","bc5524e78a8544e2ae2fdc2f3462bbec",22878634,2,-247,0,1396,449,279,-170
"bc5524e78a8544e2ae2fdc2f3462bbec","82ae07bc0c9b4570a41799290d1ef399",22878634,2,-5,0,1397,279,275,-4
"82ae07bc0c9b4570a41799290d1ef399","0d987bed3ffa4ed0b9a2e62e97b7b30f",22878634,1,-4,0,1398,275,272,-3
"bb5a47f5ea01454a8b79455422d3b9da","82ae07bc0c9b4570a41799290d1ef399",22878634,1,-6,0,1402,280,275,-5
"82ae07bc0c9b4570a41799290d1ef399","bb5a47f5ea01454a8b79455422d3b9da",22878634,4,6,0,1403,275,280,5
"bb5a47f5ea01454a8b79455422d3b9da","bc5524e78a8544e2ae2fdc2f3462bbec",22878634,2,-1,0,1424,280,279,-1
"0d987bed3ffa4ed0b9a2e62e97b7b30f","82ae07bc0c9b4570a41799290d1ef399",22878634,2,4,0,1426,272,275,3
"bb5a47f5ea01454a8b79455422d3b9da","0d987bed3ffa4ed0b9a2e62e97b7b30f",22878634,5,-10,0,1490,280,272,-8
"b2f0d654738f48158edff28e8d3a546e","f60ee41ec635499abd48168342d32c2f",22878634,6,5,0,1500,449,453,4
"f60ee41ec635499abd48168342d32c2f","b2f0d654738f48158edff28e8d3a546e",22878634,3,-5,0,1501,453,449,-4
"f60ee41ec635499abd48168342d32c2f","f60ee41ec635499abd48168342d32c2f",22878634,81,0,1,1503,453,453,0
"f60ee41ec635499abd48168342d32c2f","0d987bed3ffa4ed0b9a2e62e97b7b30f",22878634,1,-261,0,1509,453,272,-181
"bb5a47f5ea01454a8b79455422d3b9da","9428d8bd9c5a47b2a235b254e5e27ded",22878634,1,250,0,1547,280,452,172
"9428d8bd9c5a47b2a235b254e5e27ded","b2f0d654738f48158edff28e8d3a546e",22878634,2,-4,0,1548,452,449,-3
"f60ee41ec635499abd48168342d32c2f","9428d8bd9c5a47b2a235b254e5e27ded",22878634,1,-1,0,1557,453,452,-1
"9428d8bd9c5a47b2a235b254e5e27ded","9428d8bd9c5a47b2a235b254e5e27ded",22878634,1,0,1,1558,452,452,0
"f60ee41ec635499abd48168342d32c2f","f67fbf45a5f146ed866965bc57c7c001",22878634,1,3,0,1633,453,454,1
"f67fbf45a5f146ed866965bc57c7c001","b2f0d654738f48158edff28e8d3a546e",22878634,1,-8,0,1634,454,449,-5
"b2f0d654738f48158edff28e8d3a546e","f67fbf45a5f146ed866965bc57c7c001",22878634,1,8,0,1635,449,454,5
"f67fbf45a5f146ed866965bc57c7c001","f67fbf45a5f146ed866965bc57c7c001",22878634,1,0,1,1636,454,454,0
"f67fbf45a5f146ed866965bc57c7c001","d937afe49bd24a07a550dda1c1155122",22878634,1,1,0,1637,454,455,1
"d937afe49bd24a07a550dda1c1155122","d937afe49bd24a07a550dda1c1155122",22878634,1,0,1,1638,455,455,0
"d937afe49bd24a07a550dda1c1155122","3628b3f7823443d0912a339096b69943",22878634,1,1,0,1639,455,456,1
"3628b3f7823443d0912a339096b69943","3628b3f7823443d0912a339096b69943",22878634,1,0,1,1640,456,456,0
"3628b3f7823443d0912a339096b69943","9e049ee647cf43ecbcb5ed792a8e7588",22878634,1,1,0,1641,456,457,1
"9e049ee647cf43ecbcb5ed792a8e7588","9e049ee647cf43ecbcb5ed792a8e7588",22878634,1,0,1,1642,457,457,0
"9e049ee647cf43ecbcb5ed792a8e7588","5256a214faaf410b93f76cea06428334",22878634,1,1,0,1643,457,458,1
"5256a214faaf410b93f76cea06428334","5256a214faaf410b93f76cea06428334",22878634,1,0,1,1644,458,458,0
"5256a214faaf410b93f76cea06428334","25c32b120fce40fa9b6c85133aeb4716",22878634,1,1,0,1645,458,459,1
"25c32b120fce40fa9b6c85133aeb4716","25c32b120fce40fa9b6c85133aeb4716",22878634,1,0,1,1646,459,459,0
"25c32b120fce40fa9b6c85133aeb4716","11bc14f2204949008b7d511b933363c1",22878634,1,1,0,1647,459,460,1
"11bc14f2204949008b7d511b933363c1","11bc14f2204949008b7d511b933363c1",22878634,1,0,1,1648,460,460,0
"11bc14f2204949008b7d511b933363c1","42de338840a34d15adb66e7b14fb9d2c",22878634,1,1,0,1649,460,461,1
"42de338840a34d15adb66e7b14fb9d2c","42de338840a34d15adb66e7b14fb9d2c",22878634,3,0,1,1650,461,461,0
"42de338840a34d15adb66e7b14fb9d2c","9da37c6210b1416b8079c274f70bf600",22878634,1,1,0,1653,461,462,1
"9da37c6210b1416b8079c274f70bf600","9da37c6210b1416b8079c274f70bf600",22878634,1,0,1,1654,462,462,0
"9da37c6210b1416b8079c274f70bf600","519119f1deac45ff9ab4f13529be5c6e",22878634,1,1,0,1655,462,463,1
"519119f1deac45ff9ab4f13529be5c6e","519119f1deac45ff9ab4f13529be5c6e",22878634,1,0,1,1656,463,463,0
"519119f1deac45ff9ab4f13529be5c6e","f67fbf45a5f146ed866965bc57c7c001",22878634,1,-9,0,1657,463,454,-9
"f67fbf45a5f146ed866965bc57c7c001","c5df9f40ec14463b9dcfdc73df3e9285",22878634,1,12,0,1658,454,464,10
"c5df9f40ec14463b9dcfdc73df3e9285","c5df9f40ec14463b9dcfdc73df3e9285",22878634,2,0,1,1659,464,464,0
"c5df9f40ec14463b9dcfdc73df3e9285","83d42d95cd844fc093fc09cee250edb8",22878634,1,3,0,1661,464,465,1
"83d42d95cd844fc093fc09cee250edb8","83d42d95cd844fc093fc09cee250edb8",22878634,5,0,1,1662,465,465,0
"b613861cecf84ffcab01afb23f660475","b613861cecf84ffcab01afb23f660475",22889675,5,0,1,1,1,1,0
"b613861cecf84ffcab01afb23f660475","e2911e79efc2420eac45d9f671463d4b",22889675,1,3,0,6,1,2,1
"e2911e79efc2420eac45d9f671463d4b","e2911e79efc2420eac45d9f671463d4b",22889675,2,0,1,7,2,2,0
"e2911e79efc2420eac45d9f671463d4b","519d1b8c59404d67b54e96c5c8a830b2",22889675,1,1,0,9,2,3,1
"519d1b8c59404d67b54e96c5c8a830b2","519d1b8c59404d67b54e96c5c8a830b2",22889675,1,0,1,10,3,3,0
"519d1b8c59404d67b54e96c5c8a830b2","531db53f81f646edb0cdcfe0085b03b7",22889675,1,1,0,11,3,4,1
"531db53f81f646edb0cdcfe0085b03b7","531db53f81f646edb0cdcfe0085b03b7",22889675,1,0,1,12,4,4,0
"531db53f81f646edb0cdcfe0085b03b7","4f5f94b2f95141e0a9d53a61da2276da",22889675,1,1,0,13,4,5,1
"4f5f94b2f95141e0a9d53a61da2276da","4f5f94b2f95141e0a9d53a61da2276da",22889675,1,0,1,14,5,5,0
"4f5f94b2f95141e0a9d53a61da2276da","6d541c89590949f99af293c4f2333f67",22889675,1,1,0,15,5,6,1
"6d541c89590949f99af293c4f2333f67","6d541c89590949f99af293c4f2333f67",22889675,1,0,1,16,6,6,0
"6d541c89590949f99af293c4f2333f67","dd5cf0b9fe4c4f1d8f5ff8e4c04879cb",22889675,1,1,0,17,6,7,1
"dd5cf0b9fe4c4f1d8f5ff8e4c04879cb","dd5cf0b9fe4c4f1d8f5ff8e4c04879cb",22889675,1,0,1,18,7,7,0
"dd5cf0b9fe4c4f1d8f5ff8e4c04879cb","f96261861edc426abe2248be4f0a709a",22889675,1,1,0,19,7,8,1
"f96261861edc426abe2248be4f0a709a","f96261861edc426abe2248be4f0a709a",22889675,1,0,1,20,8,8,0
"f96261861edc426abe2248be4f0a709a","66b5e16f4f75454fb5b8172079f0fa83",22889675,1,1,0,21,8,9,1
"66b5e16f4f75454fb5b8172079f0fa83","66b5e16f4f75454fb5b8172079f0fa83",22889675,1,0,1,22,9,9,0
"66b5e16f4f75454fb5b8172079f0fa83","0680571d4698477995e41842c36a54b2",22889675,1,1,0,23,9,10,1
"0680571d4698477995e41842c36a54b2","0680571d4698477995e41842c36a54b2",22889675,1,0,1,24,10,10,0
"0680571d4698477995e41842c36a54b2","9112f2bffece48e08c6d2287be204085",22889675,1,1,0,25,10,11,1
"9112f2bffece48e08c6d2287be204085","9112f2bffece48e08c6d2287be204085",22889675,1,0,1,26,11,11,0
"9112f2bffece48e08c6d2287be204085","e2911e79efc2420eac45d9f671463d4b",22889675,1,-9,0,27,11,2,-9
"e2911e79efc2420eac45d9f671463d4b","56586aa865414f538729c7f7735d2bc6",22889675,3,12,0,28,2,12,10
"56586aa865414f538729c7f7735d2bc6","56586aa865414f538729c7f7735d2bc6",22889675,9,0,1,29,12,12,0
"56586aa865414f538729c7f7735d2bc6","e2911e79efc2420eac45d9f671463d4b",22889675,2,-12,0,30,12,2,-10
"56586aa865414f538729c7f7735d2bc6","b7f2b31585d94eb3bf86376714aa7070",22889675,2,2,0,42,12,13,1
"b7f2b31585d94eb3bf86376714aa7070","56586aa865414f538729c7f7735d2bc6",22889675,1,-2,0,43,13,12,-1
"b7f2b31585d94eb3bf86376714aa7070","b7f2b31585d94eb3bf86376714aa7070",22889675,1,0,1,45,13,13,0
"b7f2b31585d94eb3bf86376714aa7070","3f1c815879794b929260d224becaff7e",22889675,1,2,0,46,13,14,1
"3f1c815879794b929260d224becaff7e","81c864a886d54a6b8ff85f7d736f4f95",22889675,1,2,0,47,14,15,1
"81c864a886d54a6b8ff85f7d736f4f95","5c5ceeee4562457ba6d41515aeebfbb1",22889675,2,4,0,48,15,17,2
"5c5ceeee4562457ba6d41515aeebfbb1","5c5ceeee4562457ba6d41515aeebfbb1",22889675,1,0,1,49,17,17,0
"5c5ceeee4562457ba6d41515aeebfbb1","eb2a0eb537344a9e891c761662e400b6",22889675,1,-2,0,50,17,16,-1
"eb2a0eb537344a9e891c761662e400b6","81c864a886d54a6b8ff85f7d736f4f95",22889675,1,-2,0,51,16,15,-1
"5c5ceeee4562457ba6d41515aeebfbb1","56586aa865414f538729c7f7735d2bc6",22889675,1,-10,0,53,17,12,-5
"56586aa865414f538729c7f7735d2bc6","9afd71a5298d4333b6849dfce1b9422c",22889675,1,13,0,54,12,18,6
"9afd71a5298d4333b6849dfce1b9422c","b7719e26494940efa49512aedd0aac79",22889675,1,4,0,56,18,20,2
"b7719e26494940efa49512aedd0aac79","d4f45188d3c84a02ba08454e6403a818",22889675,1,5,0,57,20,24,4
"d4f45188d3c84a02ba08454e6403a818","d4c3b003e8274e429d2fa688d73fde6d",22889675,1,-2,0,58,24,22,-2
"d4c3b003e8274e429d2fa688d73fde6d","d4c3b003e8274e429d2fa688d73fde6d",22889675,3,0,1,59,22,22,0
"d4c3b003e8274e429d2fa688d73fde6d","b7719e26494940efa49512aedd0aac79",22889675,1,-3,0,62,22,20,-2
"afbf7250b99d47bea07172749483ca97","b7719e26494940efa49512aedd0aac79",22889675,1,-12,0,64,28,20,-8
"4e51676dc72045d99c19b9fa7b22f8bc","4e51676dc72045d99c19b9fa7b22f8bc",22889675,1,0,1,67,29,29,0
"4e51676dc72045d99c19b9fa7b22f8bc","51970cfa30e643e894e66ae85c8024cc",22889675,2,3,0,68,29,31,2
"51970cfa30e643e894e66ae85c8024cc","4e51676dc72045d99c19b9fa7b22f8bc",22889675,2,-3,0,69,31,29,-2
"4e51676dc72045d99c19b9fa7b22f8bc","c33c17be71ae4d588da7369472e5bb1b",22889675,1,9,0,72,29,34,5
"c33c17be71ae4d588da7369472e5bb1b","c33c17be71ae4d588da7369472e5bb1b",22889675,1,0,1,73,34,34,0
"c33c17be71ae4d588da7369472e5bb1b","93679be414554a11b1893002f2229a93",22889675,1,3,0,74,34,35,1
"93679be414554a11b1893002f2229a93","93679be414554a11b1893002f2229a93",22889675,1,0,1,75,35,35,0
"93679be414554a11b1893002f2229a93","7040a13096d746ac84b8fac8d9752058",22889675,1,3,0,76,35,36,1
"7040a13096d746ac84b8fac8d9752058","7040a13096d746ac84b8fac8d9752058",22889675,1,0,1,77,36,36,0
"7040a13096d746ac84b8fac8d9752058","9a0dc646f934470daf08c4b56ccf73db",22889675,1,3,0,78,36,37,1
"9a0dc646f934470daf08c4b56ccf73db","fc0e049d56024bc9a02c9a9c435c3df7",22889675,2,3,0,79,37,38,1
"fc0e049d56024bc9a02c9a9c435c3df7","9a0dc646f934470daf08c4b56ccf73db",22889675,1,-3,0,80,38,37,-1
"fc0e049d56024bc9a02c9a9c435c3df7","67a089198fcb4e1c8f2385786c2b296f",22889675,1,4,0,82,38,39,1
"64d48c6c9c7940639a932219a6c87198","64d48c6c9c7940639a932219a6c87198",22889675,5,0,1,84,40,40,0
"64d48c6c9c7940639a932219a6c87198","b534b89233134e30a9b5645138bfa9ee",22889675,1,3,0,89,40,41,1
"b534b89233134e30a9b5645138bfa9ee","67a089198fcb4e1c8f2385786c2b296f",22889675,1,-4,0,90,41,39,-2
"67a089198fcb4e1c8f2385786c2b296f","0e37b720d23b4e7f8b313e79313fd107",22889675,1,7,0,91,39,44,5
"0e37b720d23b4e7f8b313e79313fd107","0e37b720d23b4e7f8b313e79313fd107",22889675,1,0,1,92,44,44,0
"0e37b720d23b4e7f8b313e79313fd107","6875d67fdd5f48168b62719df449bebd",22889675,1,1,0,93,44,45,1
"6875d67fdd5f48168b62719df449bebd","6875d67fdd5f48168b62719df449bebd",22889675,1,0,1,94,45,45,0
"6875d67fdd5f48168b62719df449bebd","6e13d61a7bdb44bca949c9f86fab3be5",22889675,1,3,0,95,45,47,2
"6e13d61a7bdb44bca949c9f86fab3be5","b534b89233134e30a9b5645138bfa9ee",22889675,1,-7,0,96,47,41,-6
"6e13d61a7bdb44bca949c9f86fab3be5","195f78799f984cc2b06c48dfe36be751",22889675,1,2,0,98,47,49,2
"195f78799f984cc2b06c48dfe36be751","195f78799f984cc2b06c48dfe36be751",22889675,2,0,1,100,49,49,0
"195f78799f984cc2b06c48dfe36be751","d9c8d8c444a64dadbbb508652c721e17",22889675,1,-3,0,101,49,46,-3
"d9c8d8c444a64dadbbb508652c721e17","b534b89233134e30a9b5645138bfa9ee",22889675,1,-6,0,102,46,41,-5
"b534b89233134e30a9b5645138bfa9ee","6e13d61a7bdb44bca949c9f86fab3be5",22889675,3,7,0,103,41,47,6
"6e13d61a7bdb44bca949c9f86fab3be5","d9c8d8c444a64dadbbb508652c721e17",22889675,3,-1,0,104,47,46,-1
"d9c8d8c444a64dadbbb508652c721e17","d0c74f735e024943943e40333d6d337f",22889675,2,6,0,105,46,51,5
"d0c74f735e024943943e40333d6d337f","6e13d61a7bdb44bca949c9f86fab3be5",22889675,1,-5,0,106,51,47,-4
"6e13d61a7bdb44bca949c9f86fab3be5","f924752d8a1149668870b1e7698486f7",22889675,1,4,0,107,47,50,3
"f924752d8a1149668870b1e7698486f7","6e13d61a7bdb44bca949c9f86fab3be5",22889675,2,-4,0,108,50,47,-3
"6e13d61a7bdb44bca949c9f86fab3be5","6e13d61a7bdb44bca949c9f86fab3be5",22889675,15,0,1,109,47,47,0
"d0c74f735e024943943e40333d6d337f","d0c74f735e024943943e40333d6d337f",22889675,3,0,1,112,51,51,0
"d0c74f735e024943943e40333d6d337f","983f8ff320594b279a7f4a6fe132f9c5",22889675,1,2,0,115,51,53,2
"983f8ff320594b279a7f4a6fe132f9c5","983f8ff320594b279a7f4a6fe132f9c5",22889675,2,0,1,116,53,53,0
"983f8ff320594b279a7f4a6fe132f9c5","35adfa5d923046aebabfefd98f35ff05",22889675,1,1,0,118,53,54,1
"35adfa5d923046aebabfefd98f35ff05","35adfa5d923046aebabfefd98f35ff05",22889675,2,0,1,119,54,54,0
"35adfa5d923046aebabfefd98f35ff05","b6f8a98476224da1b40e555ececc7ed8",22889675,1,1,0,121,54,55,1
"b6f8a98476224da1b40e555ececc7ed8","b6f8a98476224da1b40e555ececc7ed8",22889675,2,0,1,122,55,55,0
"b6f8a98476224da1b40e555ececc7ed8","86e22cb5fe0e4b47a9489ecddf7ed78f",22889675,1,1,0,124,55,56,1
"86e22cb5fe0e4b47a9489ecddf7ed78f","86e22cb5fe0e4b47a9489ecddf7ed78f",22889675,2,0,1,125,56,56,0
"86e22cb5fe0e4b47a9489ecddf7ed78f","f924752d8a1149668870b1e7698486f7",22889675,1,-6,0,127,56,50,-6
"f924752d8a1149668870b1e7698486f7","a1f2f12debe5432fb7a70bcd12bacfb9",22889675,1,9,0,128,50,58,8
"a1f2f12debe5432fb7a70bcd12bacfb9","78f30e4dcac84e3cbea8b2cc6e0d62b3",22889675,3,1,0,129,58,59,1
"78f30e4dcac84e3cbea8b2cc6e0d62b3","a1f2f12debe5432fb7a70bcd12bacfb9",22889675,2,-1,0,130,59,58,-1
"a1f2f12debe5432fb7a70bcd12bacfb9","a1f2f12debe5432fb7a70bcd12bacfb9",22889675,15,0,1,131,58,58,0
"78f30e4dcac84e3cbea8b2cc6e0d62b3","78f30e4dcac84e3cbea8b2cc6e0d62b3",22889675,10,0,1,138,59,59,0
"78f30e4dcac84e3cbea8b2cc6e0d62b3","12aa6e1672ac4e7aa6449a7a8609cd72",22889675,1,-2,0,159,59,57,-2
"12aa6e1672ac4e7aa6449a7a8609cd72","bc42d26810654ea9a1df1efe1e58c7d5",22889675,1,7,0,160,57,63,6
"bc42d26810654ea9a1df1efe1e58c7d5","a0a418b8540d479fa6e0f653b701da8b",22889675,2,1,0,161,63,64,1
"a0a418b8540d479fa6e0f653b701da8b","309ccf3cc4fe429d9bfbaef53d3fa479",22889675,1,-4,0,162,64,60,-4
"309ccf3cc4fe429d9bfbaef53d3fa479","b534b89233134e30a9b5645138bfa9ee",22889675,3,-23,0,163,60,41,-19
"b534b89233134e30a9b5645138bfa9ee","d646286c8051419bbc2e31dd1db55ca8",22889675,1,33,0,164,41,67,26
"d646286c8051419bbc2e31dd1db55ca8","267f883678b24aed855fde42524975d9",22889675,1,4,0,165,67,71,4
"267f883678b24aed855fde42524975d9","267f883678b24aed855fde42524975d9",22889675,1,0,1,166,71,71,0
"267f883678b24aed855fde42524975d9","88fff56d0342490dbef9040750a20f6c",22889675,1,1,0,167,71,72,1
"88fff56d0342490dbef9040750a20f6c","88fff56d0342490dbef9040750a20f6c",22889675,1,0,1,168,72,72,0
"88fff56d0342490dbef9040750a20f6c","adb17b12b66c4a49a85fd34322f7df70",22889675,1,1,0,169,72,73,1
"adb17b12b66c4a49a85fd34322f7df70","adb17b12b66c4a49a85fd34322f7df70",22889675,1,0,1,170,73,73,0
"adb17b12b66c4a49a85fd34322f7df70","a2becd407db34b189200a32546d9d569",22889675,1,3,0,171,73,75,2
"a2becd407db34b189200a32546d9d569","d646286c8051419bbc2e31dd1db55ca8",22889675,1,-9,0,172,75,67,-8
"d646286c8051419bbc2e31dd1db55ca8","a2becd407db34b189200a32546d9d569",22889675,1,9,0,173,67,75,8
"a2becd407db34b189200a32546d9d569","58c22b011d0f4c2ea6d13615edbb9eeb",22889675,1,2,0,174,75,77,2
"58c22b011d0f4c2ea6d13615edbb9eeb","58c22b011d0f4c2ea6d13615edbb9eeb",22889675,8,0,1,175,77,77,0
"58c22b011d0f4c2ea6d13615edbb9eeb","dd76e1861dc9461c830888729d091ee0",22889675,1,1,0,183,77,78,1
"dd76e1861dc9461c830888729d091ee0","dd76e1861dc9461c830888729d091ee0",22889675,8,0,1,184,78,78,0
"dd76e1861dc9461c830888729d091ee0","cd1d828f1a694b87913a7ea66c23803e",22889675,1,1,0,192,78,79,1
"cd1d828f1a694b87913a7ea66c23803e","cd1d828f1a694b87913a7ea66c23803e",22889675,2,0,1,193,79,79,0
"cd1d828f1a694b87913a7ea66c23803e","9176a3c2b4d2465fa8b0c67096c2a97e",22889675,1,1,0,195,79,80,1
"9176a3c2b4d2465fa8b0c67096c2a97e","9176a3c2b4d2465fa8b0c67096c2a97e",22889675,5,0,1,196,80,80,0
"9176a3c2b4d2465fa8b0c67096c2a97e","f8ec6445f7194e25b9101d4fbcb07a18",22889675,1,1,0,201,80,81,1
"f8ec6445f7194e25b9101d4fbcb07a18","f8ec6445f7194e25b9101d4fbcb07a18",22889675,2,0,1,202,81,81,0
"f8ec6445f7194e25b9101d4fbcb07a18","140d5b27b8574befad82c0a013b59dfa",22889675,1,-7,0,204,81,74,-7
"140d5b27b8574befad82c0a013b59dfa","d18a9ea32855445f8736581f5cb119ce",22889675,2,9,0,205,74,82,8
"d18a9ea32855445f8736581f5cb119ce","ae5ac430ea254e708a6f5deaaf7464ae",22889675,1,3,0,206,82,84,2
"ae5ac430ea254e708a6f5deaaf7464ae","a2becd407db34b189200a32546d9d569",22889675,2,-11,0,207,84,75,-9
"a2becd407db34b189200a32546d9d569","d18a9ea32855445f8736581f5cb119ce",22889675,1,8,0,208,75,82,7
"d18a9ea32855445f8736581f5cb119ce","140d5b27b8574befad82c0a013b59dfa",22889675,1,-9,0,209,82,74,-8
"140d5b27b8574befad82c0a013b59dfa","309ccf3cc4fe429d9bfbaef53d3fa479",22889675,1,-18,0,210,74,60,-14
"b534b89233134e30a9b5645138bfa9ee","bc42d26810654ea9a1df1efe1e58c7d5",22889675,1,26,0,212,41,63,22
"a0a418b8540d479fa6e0f653b701da8b","67a089198fcb4e1c8f2385786c2b296f",22889675,1,-31,0,214,64,39,-25
"67a089198fcb4e1c8f2385786c2b296f","67a089198fcb4e1c8f2385786c2b296f",22889675,2,0,1,215,39,39,0
"67a089198fcb4e1c8f2385786c2b296f","64d48c6c9c7940639a932219a6c87198",22889675,2,1,0,216,39,40,1
"64d48c6c9c7940639a932219a6c87198","67a089198fcb4e1c8f2385786c2b296f",22889675,1,-1,0,217,40,39,-1
"67a089198fcb4e1c8f2385786c2b296f","b534b89233134e30a9b5645138bfa9ee",22889675,1,4,0,218,39,41,2
"b534b89233134e30a9b5645138bfa9ee","b534b89233134e30a9b5645138bfa9ee",22889675,1,0,1,219,41,41,0
"b534b89233134e30a9b5645138bfa9ee","d9c8d8c444a64dadbbb508652c721e17",22889675,1,6,0,220,41,46,5
"d9c8d8c444a64dadbbb508652c721e17","6e13d61a7bdb44bca949c9f86fab3be5",22889675,1,1,0,221,46,47,1
"6e13d61a7bdb44bca949c9f86fab3be5","4c943503763e4e349906eea3ed3c8e86",22889675,1,17,0,223,47,61,14
"4c943503763e4e349906eea3ed3c8e86","309ccf3cc4fe429d9bfbaef53d3fa479",22889675,2,-1,0,224,61,60,-1
"309ccf3cc4fe429d9bfbaef53d3fa479","6e13d61a7bdb44bca949c9f86fab3be5",22889675,1,-16,0,225,60,47,-13
"6e13d61a7bdb44bca949c9f86fab3be5","7af822066add4e7f8e007e4eee31a8bf",22889675,1,22,0,226,47,65,18
"7af822066add4e7f8e007e4eee31a8bf","6e13d61a7bdb44bca949c9f86fab3be5",22889675,1,-22,0,227,65,47,-18
"d9c8d8c444a64dadbbb508652c721e17","a0a418b8540d479fa6e0f653b701da8b",22889675,1,21,0,229,46,64,18
"a0a418b8540d479fa6e0f653b701da8b","f924752d8a1149668870b1e7698486f7",22889675,1,-16,0,230,64,50,-14
"f924752d8a1149668870b1e7698486f7","bc42d26810654ea9a1df1efe1e58c7d5",22889675,1,15,0,231,50,63,13
"bc42d26810654ea9a1df1efe1e58c7d5","a1f2f12debe5432fb7a70bcd12bacfb9",22889675,1,-6,0,232,63,58,-5
"a1f2f12debe5432fb7a70bcd12bacfb9","12aa6e1672ac4e7aa6449a7a8609cd72",22889675,1,-1,0,233,58,57,-1
"12aa6e1672ac4e7aa6449a7a8609cd72","d0c74f735e024943943e40333d6d337f",22889675,1,-7,0,234,57,51,-6
"d0c74f735e024943943e40333d6d337f","78f30e4dcac84e3cbea8b2cc6e0d62b3",22889675,1,9,0,235,51,59,8
"78f30e4dcac84e3cbea8b2cc6e0d62b3","309ccf3cc4fe429d9bfbaef53d3fa479",22889675,1,2,0,236,59,60,1
"309ccf3cc4fe429d9bfbaef53d3fa479","d646286c8051419bbc2e31dd1db55ca8",22889675,2,10,0,237,60,67,7
"d646286c8051419bbc2e31dd1db55ca8","b534b89233134e30a9b5645138bfa9ee",22889675,1,-33,0,238,67,41,-26
"b534b89233134e30a9b5645138bfa9ee","ae5ac430ea254e708a6f5deaaf7464ae",22889675,1,53,0,239,41,84,43
"ae5ac430ea254e708a6f5deaaf7464ae","d646286c8051419bbc2e31dd1db55ca8",22889675,1,-20,0,240,84,67,-17
"d646286c8051419bbc2e31dd1db55ca8","ae5ac430ea254e708a6f5deaaf7464ae",22889675,1,20,0,241,67,84,17
"ae5ac430ea254e708a6f5deaaf7464ae","d18a9ea32855445f8736581f5cb119ce",22889675,1,-3,0,242,84,82,-2
"d18a9ea32855445f8736581f5cb119ce","a2becd407db34b189200a32546d9d569",22889675,1,-8,0,243,82,75,-7
"a2becd407db34b189200a32546d9d569","140d5b27b8574befad82c0a013b59dfa",22889675,1,-1,0,244,75,74,-1
"d18a9ea32855445f8736581f5cb119ce","f564483cbd7a407681aa2fcca518cf5f",22889675,1,4,0,246,82,85,3
"f564483cbd7a407681aa2fcca518cf5f","f564483cbd7a407681aa2fcca518cf5f",22889675,4,0,1,247,85,85,0
"f564483cbd7a407681aa2fcca518cf5f","18fd01350bd5434ca636d59a599d768a",22889675,1,1,0,251,85,86,1
"18fd01350bd5434ca636d59a599d768a","18fd01350bd5434ca636d59a599d768a",22889675,8,0,1,252,86,86,0
"18fd01350bd5434ca636d59a599d768a","6a9f0ef185fb47f0937e29daa1c71ed5",22889675,1,5,0,260,86,90,4
"a2becd407db34b189200a32546d9d569","42fb58708eaf4e5daa82bfca61b6f5fd",22889675,1,15,0,263,75,87,12
"42fb58708eaf4e5daa82bfca61b6f5fd","a2becd407db34b189200a32546d9d569",22889675,1,-15,0,264,87,75,-12
"a2becd407db34b189200a32546d9d569","a2becd407db34b189200a32546d9d569",22889675,4,0,1,265,75,75,0
"a2becd407db34b189200a32546d9d569","6a9f0ef185fb47f0937e29daa1c71ed5",22889675,1,18,0,269,75,90,15
"6a9f0ef185fb47f0937e29daa1c71ed5","140d5b27b8574befad82c0a013b59dfa",22889675,1,-19,0,270,90,74,-16
"140d5b27b8574befad82c0a013b59dfa","c681290961c94c4caf23b529d1ae6b9a",22889675,1,17,0,271,74,88,14
"c681290961c94c4caf23b529d1ae6b9a","e20db35ced8544ddac5bc3839145e463",22889675,1,5,0,272,88,91,3
"d646286c8051419bbc2e31dd1db55ca8","1febb706d7a34005ae8711ed49c76e64",22889675,1,33,0,274,67,94,27
"1febb706d7a34005ae8711ed49c76e64","1febb706d7a34005ae8711ed49c76e64",22889675,5,0,1,275,94,94,0
"1febb706d7a34005ae8711ed49c76e64","8f73ba6f5a0042f2850356ac38ac6f24",22889675,1,1,0,280,94,95,1
"8f73ba6f5a0042f2850356ac38ac6f24","8f73ba6f5a0042f2850356ac38ac6f24",22889675,5,0,1,281,95,95,0
"8f73ba6f5a0042f2850356ac38ac6f24","e2260b86653c46d7b14a41fb419dbf8c",22889675,1,1,0,286,95,96,1
"e2260b86653c46d7b14a41fb419dbf8c","e2260b86653c46d7b14a41fb419dbf8c",22889675,2,0,1,287,96,96,0
"e2260b86653c46d7b14a41fb419dbf8c","35eb641ad1d845bbba54915bce75a962",22889675,1,1,0,289,96,97,1
"35eb641ad1d845bbba54915bce75a962","35eb641ad1d845bbba54915bce75a962",22889675,2,0,1,290,97,97,0
"35eb641ad1d845bbba54915bce75a962","08be90ffbeea4795a138cd42ed8db56f",22889675,1,1,0,292,97,98,1
"08be90ffbeea4795a138cd42ed8db56f","08be90ffbeea4795a138cd42ed8db56f",22889675,5,0,1,293,98,98,0
"08be90ffbeea4795a138cd42ed8db56f","3007433c8f584dcbb5ac159c1c5f2be3",22889675,1,1,0,298,98,99,1
"3007433c8f584dcbb5ac159c1c5f2be3","3007433c8f584dcbb5ac159c1c5f2be3",22889675,5,0,1,299,99,99,0
"3007433c8f584dcbb5ac159c1c5f2be3","e20db35ced8544ddac5bc3839145e463",22889675,1,-8,0,304,99,91,-8
"d391c8b6e56a43a7b654e9dee02d904b","00ae5f0c51874a73a41ebea838d95682",22889675,7,-2,0,307,103,101,-2
"d391c8b6e56a43a7b654e9dee02d904b","d391c8b6e56a43a7b654e9dee02d904b",22889675,16,0,1,309,103,103,0
"d391c8b6e56a43a7b654e9dee02d904b","6111116566fc4fd9abba409322bea245",22889675,1,1,0,325,103,104,1
"6111116566fc4fd9abba409322bea245","6111116566fc4fd9abba409322bea245",22889675,2,0,1,326,104,104,0
"6111116566fc4fd9abba409322bea245","a81b2235cb9c499eb9ea8ee0a8dd9725",22889675,1,1,0,328,104,105,1
"a81b2235cb9c499eb9ea8ee0a8dd9725","a81b2235cb9c499eb9ea8ee0a8dd9725",22889675,5,0,1,329,105,105,0
"a81b2235cb9c499eb9ea8ee0a8dd9725","2d4e0ab0ef3b4d73b82c72d4621a7579",22889675,1,1,0,334,105,106,1
"2d4e0ab0ef3b4d73b82c72d4621a7579","2d4e0ab0ef3b4d73b82c72d4621a7579",22889675,2,0,1,335,106,106,0
"2d4e0ab0ef3b4d73b82c72d4621a7579","8bdebf492ebd4e62b0d522e8ab5e5197",22889675,1,1,0,337,106,107,1
"8bdebf492ebd4e62b0d522e8ab5e5197","8bdebf492ebd4e62b0d522e8ab5e5197",22889675,2,0,1,338,107,107,0
"8bdebf492ebd4e62b0d522e8ab5e5197","73039f8c1eb9409cb4caee2cf968001e",22889675,1,-7,0,340,107,100,-7
"73039f8c1eb9409cb4caee2cf968001e","4280927ec4d643238aa49c32f9e06c6c",22889675,3,10,0,341,100,109,9
"4280927ec4d643238aa49c32f9e06c6c","4280927ec4d643238aa49c32f9e06c6c",22889675,5,0,1,342,109,109,0
"4280927ec4d643238aa49c32f9e06c6c","fc44e6a5f7654430af1227838224dceb",22889675,1,2,0,347,109,111,2
"fc44e6a5f7654430af1227838224dceb","fc44e6a5f7654430af1227838224dceb",22889675,2,0,1,348,111,111,0
"fc44e6a5f7654430af1227838224dceb","a9ae0a3c070d455bb4369a8996313336",22889675,1,4,0,350,111,114,3
"a9ae0a3c070d455bb4369a8996313336","08111f75e22d409998cf8b85bd431f0a",22889675,1,-7,0,351,114,108,-6
"08111f75e22d409998cf8b85bd431f0a","a9ae0a3c070d455bb4369a8996313336",22889675,2,7,0,352,108,114,6
"a9ae0a3c070d455bb4369a8996313336","a9ae0a3c070d455bb4369a8996313336",22889675,1,0,1,353,114,114,0
"a9ae0a3c070d455bb4369a8996313336","e20db35ced8544ddac5bc3839145e463",22889675,2,-26,0,354,114,91,-23
"d391c8b6e56a43a7b654e9dee02d904b","73039f8c1eb9409cb4caee2cf968001e",22889675,2,-3,0,358,103,100,-3
"73039f8c1eb9409cb4caee2cf968001e","a9ae0a3c070d455bb4369a8996313336",22889675,1,16,0,359,100,114,14
"e20db35ced8544ddac5bc3839145e463","71cec822bcff4f30a20e75dc63ef7b65",22889675,1,28,0,361,91,116,25
"71cec822bcff4f30a20e75dc63ef7b65","71cec822bcff4f30a20e75dc63ef7b65",22889675,1,0,1,362,116,116,0
"71cec822bcff4f30a20e75dc63ef7b65","37319e88176d4aefa91d7a9980dbae91",22889675,1,-4,0,363,116,112,-4
"37319e88176d4aefa91d7a9980dbae91","62bff51286ef4f348717a3cf6fe2318f",22889675,2,9,0,364,112,120,8
"62bff51286ef4f348717a3cf6fe2318f","3ec3a3563847406fa73338f9e9999cf3",22889675,1,-3,0,365,120,117,-3
"3ec3a3563847406fa73338f9e9999cf3","00ae5f0c51874a73a41ebea838d95682",22889675,2,-19,0,366,117,101,-16
"00ae5f0c51874a73a41ebea838d95682","e20db35ced8544ddac5bc3839145e463",22889675,4,-11,0,367,101,91,-10
"e20db35ced8544ddac5bc3839145e463","d391c8b6e56a43a7b654e9dee02d904b",22889675,3,13,0,368,91,103,12
"4280927ec4d643238aa49c32f9e06c6c","62bff51286ef4f348717a3cf6fe2318f",22889675,1,13,0,371,109,120,11
"62bff51286ef4f348717a3cf6fe2318f","08111f75e22d409998cf8b85bd431f0a",22889675,1,-14,0,372,120,108,-12
"08111f75e22d409998cf8b85bd431f0a","67a089198fcb4e1c8f2385786c2b296f",22889675,1,-86,0,373,108,39,-69
"67a089198fcb4e1c8f2385786c2b296f","e20db35ced8544ddac5bc3839145e463",22889675,1,67,0,374,39,91,52
"00ae5f0c51874a73a41ebea838d95682","00ae5f0c51874a73a41ebea838d95682",22889675,21,0,1,380,101,101,0
"00ae5f0c51874a73a41ebea838d95682","62bff51286ef4f348717a3cf6fe2318f",22889675,2,22,0,388,101,120,19
"62bff51286ef4f348717a3cf6fe2318f","73039f8c1eb9409cb4caee2cf968001e",22889675,2,-23,0,389,120,100,-20
"73039f8c1eb9409cb4caee2cf968001e","309ccf3cc4fe429d9bfbaef53d3fa479",22889675,1,-50,0,390,100,60,-40
"b534b89233134e30a9b5645138bfa9ee","a0a418b8540d479fa6e0f653b701da8b",22889675,1,27,0,392,41,64,23
"a0a418b8540d479fa6e0f653b701da8b","bc42d26810654ea9a1df1efe1e58c7d5",22889675,1,-1,0,393,64,63,-1
"bc42d26810654ea9a1df1efe1e58c7d5","4c943503763e4e349906eea3ed3c8e86",22889675,1,-2,0,394,63,61,-2
"4c943503763e4e349906eea3ed3c8e86","4c943503763e4e349906eea3ed3c8e86",22889675,1,0,1,395,61,61,0
"d646286c8051419bbc2e31dd1db55ca8","6a9f0ef185fb47f0937e29daa1c71ed5",22889675,1,27,0,398,67,90,23
"6a9f0ef185fb47f0937e29daa1c71ed5","c681290961c94c4caf23b529d1ae6b9a",22889675,1,-2,0,399,90,88,-2
"c681290961c94c4caf23b529d1ae6b9a","c681290961c94c4caf23b529d1ae6b9a",22889675,1,0,1,400,88,88,0
"c681290961c94c4caf23b529d1ae6b9a","6a9f0ef185fb47f0937e29daa1c71ed5",22889675,1,2,0,401,88,90,2
"d646286c8051419bbc2e31dd1db55ca8","62bff51286ef4f348717a3cf6fe2318f",22889675,1,63,0,407,67,120,53
"62bff51286ef4f348717a3cf6fe2318f","e20db35ced8544ddac5bc3839145e463",22889675,2,-33,0,408,120,91,-29
"e20db35ced8544ddac5bc3839145e463","3ec3a3563847406fa73338f9e9999cf3",22889675,1,30,0,409,91,117,26
"3ec3a3563847406fa73338f9e9999cf3","d391c8b6e56a43a7b654e9dee02d904b",22889675,2,-17,0,410,117,103,-14
"00ae5f0c51874a73a41ebea838d95682","73039f8c1eb9409cb4caee2cf968001e",22889675,4,-1,0,414,101,100,-1
"73039f8c1eb9409cb4caee2cf968001e","62bff51286ef4f348717a3cf6fe2318f",22889675,1,23,0,415,100,120,20
"62bff51286ef4f348717a3cf6fe2318f","d391c8b6e56a43a7b654e9dee02d904b",22889675,1,-20,0,416,120,103,-17
"00ae5f0c51874a73a41ebea838d95682","3ec3a3563847406fa73338f9e9999cf3",22889675,2,19,0,418,101,117,16
"73039f8c1eb9409cb4caee2cf968001e","08be90ffbeea4795a138cd42ed8db56f",22889675,1,-3,0,423,100,98,-2
"08be90ffbeea4795a138cd42ed8db56f","00ae5f0c51874a73a41ebea838d95682",22889675,1,4,0,424,98,101,3
"73039f8c1eb9409cb4caee2cf968001e","e20db35ced8544ddac5bc3839145e463",22889675,1,-10,0,429,100,91,-9
"d391c8b6e56a43a7b654e9dee02d904b","4280927ec4d643238aa49c32f9e06c6c",22889675,1,7,0,432,103,109,6
"4280927ec4d643238aa49c32f9e06c6c","73039f8c1eb9409cb4caee2cf968001e",22889675,1,-10,0,433,109,100,-9
"73039f8c1eb9409cb4caee2cf968001e","08111f75e22d409998cf8b85bd431f0a",22889675,1,9,0,434,100,108,8
"08111f75e22d409998cf8b85bd431f0a","e20db35ced8544ddac5bc3839145e463",22889675,1,-19,0,435,108,91,-17
"73039f8c1eb9409cb4caee2cf968001e","b1cd0e7dc3ad4a8eb91a4bfdbeb025b0",22889675,1,21,0,441,100,118,18
"b1cd0e7dc3ad4a8eb91a4bfdbeb025b0","62bff51286ef4f348717a3cf6fe2318f",22889675,1,2,0,442,118,120,2
"62bff51286ef4f348717a3cf6fe2318f","62bff51286ef4f348717a3cf6fe2318f",22889675,11,0,1,443,120,120,0
"62bff51286ef4f348717a3cf6fe2318f","779f9ddd1fd14d1e9e69f72219a1fdbd",22889675,2,3,0,446,120,121,1
"779f9ddd1fd14d1e9e69f72219a1fdbd","e20db35ced8544ddac5bc3839145e463",22889675,3,-36,0,447,121,91,-30
"e20db35ced8544ddac5bc3839145e463","ae26e6cda8ad4a3f81bd347560d9579f",22889675,1,40,0,448,91,125,34
"ae26e6cda8ad4a3f81bd347560d9579f","ae26e6cda8ad4a3f81bd347560d9579f",22889675,3,0,1,449,125,125,0
"ae26e6cda8ad4a3f81bd347560d9579f","ee48df95832b4374aa273ceb27ec1315",22889675,1,1,0,452,125,126,1
"ee48df95832b4374aa273ceb27ec1315","ee48df95832b4374aa273ceb27ec1315",22889675,1,0,1,453,126,126,0
"ee48df95832b4374aa273ceb27ec1315","7a439da90b394756ad1777fc4c6dead5",22889675,1,1,0,454,126,127,1
"7a439da90b394756ad1777fc4c6dead5","7a439da90b394756ad1777fc4c6dead5",22889675,1,0,1,455,127,127,0
"7a439da90b394756ad1777fc4c6dead5","a8dd5213034441ac92724b4e83eb0bb2",22889675,1,3,0,456,127,129,2
"a8dd5213034441ac92724b4e83eb0bb2","779f9ddd1fd14d1e9e69f72219a1fdbd",22889675,2,-9,0,457,129,121,-8
"779f9ddd1fd14d1e9e69f72219a1fdbd","a8dd5213034441ac92724b4e83eb0bb2",22889675,2,9,0,458,121,129,8
"779f9ddd1fd14d1e9e69f72219a1fdbd","779f9ddd1fd14d1e9e69f72219a1fdbd",22889675,3,0,1,460,121,121,0
"a8dd5213034441ac92724b4e83eb0bb2","a8dd5213034441ac92724b4e83eb0bb2",22889675,1,0,1,462,129,129,0
"a8dd5213034441ac92724b4e83eb0bb2","8115eab6556b45f5b415c3b8c26a12e5",22889675,1,2,0,463,129,131,2
"8115eab6556b45f5b415c3b8c26a12e5","8115eab6556b45f5b415c3b8c26a12e5",22889675,2,0,1,464,131,131,0
"8115eab6556b45f5b415c3b8c26a12e5","ec34b06efd844b46a4c4818ecdb9b8f4",22889675,1,1,0,466,131,132,1
"ec34b06efd844b46a4c4818ecdb9b8f4","ec34b06efd844b46a4c4818ecdb9b8f4",22889675,2,0,1,467,132,132,0
"ec34b06efd844b46a4c4818ecdb9b8f4","c2e1c2b9eac64109b343a088584b576b",22889675,1,1,0,469,132,133,1
"c2e1c2b9eac64109b343a088584b576b","c2e1c2b9eac64109b343a088584b576b",22889675,2,0,1,470,133,133,0
"c2e1c2b9eac64109b343a088584b576b","579338175e0b4bbb8ef3b712b5d8b54e",22889675,1,-5,0,472,133,128,-5
"579338175e0b4bbb8ef3b712b5d8b54e","8bc5795d6a984a3eace4e2811e52dd4f",22889675,1,8,0,473,128,135,7
"8bc5795d6a984a3eace4e2811e52dd4f","8bc5795d6a984a3eace4e2811e52dd4f",22889675,1,0,1,474,135,135,0
"8bc5795d6a984a3eace4e2811e52dd4f","b416d47c56a742199b5d7c7f19d6503a",22889675,1,-1,0,475,135,134,-1
"b416d47c56a742199b5d7c7f19d6503a","df1de691dafe4549a18a4398ee9dfaf9",22889675,1,8,0,476,134,139,5
"df1de691dafe4549a18a4398ee9dfaf9","779f9ddd1fd14d1e9e69f72219a1fdbd",22889675,2,-23,0,477,139,121,-18
"779f9ddd1fd14d1e9e69f72219a1fdbd","6c5ad271a44743479bfaea29b1db8d02",22889675,2,27,0,478,121,143,22
"6c5ad271a44743479bfaea29b1db8d02","6c5ad271a44743479bfaea29b1db8d02",22889675,1,0,1,479,143,143,0
"6c5ad271a44743479bfaea29b1db8d02","83d311bed5374fee83d8d67a7d9d82dc",22889675,1,1,0,480,143,144,1
"83d311bed5374fee83d8d67a7d9d82dc","83d311bed5374fee83d8d67a7d9d82dc",22889675,1,0,1,481,144,144,0
"83d311bed5374fee83d8d67a7d9d82dc","402bba41861d43acb52a5abb89e8831e",22889675,1,1,0,482,144,145,1
"402bba41861d43acb52a5abb89e8831e","402bba41861d43acb52a5abb89e8831e",22889675,2,0,1,483,145,145,0
"402bba41861d43acb52a5abb89e8831e","df1de691dafe4549a18a4398ee9dfaf9",22889675,1,-6,0,485,145,139,-6
"df1de691dafe4549a18a4398ee9dfaf9","8aae34f5ddbb4052a709b12e6b0d40fa",22889675,1,9,0,486,139,147,8
"8aae34f5ddbb4052a709b12e6b0d40fa","8aae34f5ddbb4052a709b12e6b0d40fa",22889675,1,0,1,487,147,147,0
"8aae34f5ddbb4052a709b12e6b0d40fa","645b3f0249f64f76af2e19eb4d0e55b7",22889675,1,2,0,488,147,149,2
"645b3f0249f64f76af2e19eb4d0e55b7","645b3f0249f64f76af2e19eb4d0e55b7",22889675,2,0,1,489,149,149,0
"645b3f0249f64f76af2e19eb4d0e55b7","7e7b8db5064d4369805ab370aac5ddfb",22889675,1,1,0,491,149,150,1
"7e7b8db5064d4369805ab370aac5ddfb","7e7b8db5064d4369805ab370aac5ddfb",22889675,2,0,1,492,150,150,0
"7e7b8db5064d4369805ab370aac5ddfb","8956d210ae7f41968fada86d4c979d6a",22889675,1,1,0,494,150,151,1
"8956d210ae7f41968fada86d4c979d6a","8956d210ae7f41968fada86d4c979d6a",22889675,2,0,1,495,151,151,0
"8956d210ae7f41968fada86d4c979d6a","f902b0f41b544d4dbf79664fd233648d",22889675,1,-5,0,497,151,146,-5
"f902b0f41b544d4dbf79664fd233648d","ae781e8b775e4ccd93bc800dad5c8376",22889675,1,8,0,498,146,153,7
"ae781e8b775e4ccd93bc800dad5c8376","ae781e8b775e4ccd93bc800dad5c8376",22889675,2,0,1,499,153,153,0
"ae781e8b775e4ccd93bc800dad5c8376","06882a8492d9499aa31555567f575ecb",22889675,1,1,0,501,153,154,1
"06882a8492d9499aa31555567f575ecb","06882a8492d9499aa31555567f575ecb",22889675,1,0,1,502,154,154,0
"06882a8492d9499aa31555567f575ecb","f293c508f409466a8f27ddd7d1e40b20",22889675,1,1,0,503,154,155,1
"f293c508f409466a8f27ddd7d1e40b20","f293c508f409466a8f27ddd7d1e40b20",22889675,2,0,1,504,155,155,0
"f293c508f409466a8f27ddd7d1e40b20","cc4ddef5bbbe48ebb605141b347c4ed1",22889675,1,1,0,506,155,156,1
"cc4ddef5bbbe48ebb605141b347c4ed1","cc4ddef5bbbe48ebb605141b347c4ed1",22889675,1,0,1,507,156,156,0
"cc4ddef5bbbe48ebb605141b347c4ed1","d313cec988a84645bee413e8d4724a4b",22889675,1,3,0,508,156,158,2
"d313cec988a84645bee413e8d4724a4b","f03480cf4eba413194d7af52fc0e7f28",22889675,1,-7,0,509,158,152,-6
"f03480cf4eba413194d7af52fc0e7f28","d313cec988a84645bee413e8d4724a4b",22889675,1,7,0,510,152,158,6
"d313cec988a84645bee413e8d4724a4b","d313cec988a84645bee413e8d4724a4b",22889675,7,0,1,511,158,158,0
"d313cec988a84645bee413e8d4724a4b","78adeee1fa2c4fe0bc73f7bca9fcee86",22889675,1,4,0,514,158,160,2
"78adeee1fa2c4fe0bc73f7bca9fcee86","df1de691dafe4549a18a4398ee9dfaf9",22889675,1,-26,0,515,160,139,-21
"df1de691dafe4549a18a4398ee9dfaf9","65202579580f4ad38d734b4ee39d22a8",22889675,1,31,0,516,139,164,25
"65202579580f4ad38d734b4ee39d22a8","65202579580f4ad38d734b4ee39d22a8",22889675,89,0,1,517,164,164,0
"65202579580f4ad38d734b4ee39d22a8","78adeee1fa2c4fe0bc73f7bca9fcee86",22889675,4,-5,0,523,164,160,-4
"78adeee1fa2c4fe0bc73f7bca9fcee86","65202579580f4ad38d734b4ee39d22a8",22889675,5,5,0,524,160,164,4
"65202579580f4ad38d734b4ee39d22a8","8959e6304a0348309a771e4d08d1b64a",22889675,2,-1,0,525,164,163,-1
"8959e6304a0348309a771e4d08d1b64a","df1de691dafe4549a18a4398ee9dfaf9",22889675,1,-30,0,526,163,139,-24
"df1de691dafe4549a18a4398ee9dfaf9","78adeee1fa2c4fe0bc73f7bca9fcee86",22889675,2,26,0,527,139,160,21
"78adeee1fa2c4fe0bc73f7bca9fcee86","d313cec988a84645bee413e8d4724a4b",22889675,1,-4,0,528,160,158,-2
"d313cec988a84645bee413e8d4724a4b","67a089198fcb4e1c8f2385786c2b296f",22889675,1,-148,0,531,158,39,-119
"67a089198fcb4e1c8f2385786c2b296f","3cbcea2be0984e7dbd5a48195af10ce7",22889675,1,160,0,532,39,165,126
"3cbcea2be0984e7dbd5a48195af10ce7","3cbcea2be0984e7dbd5a48195af10ce7",22889675,1,0,1,533,165,165,0
"3cbcea2be0984e7dbd5a48195af10ce7","82e6285962b8400d9d6fc32436022a94",22889675,1,2,0,534,165,167,2
"82e6285962b8400d9d6fc32436022a94","67a089198fcb4e1c8f2385786c2b296f",22889675,1,-162,0,535,167,39,-128
"67a089198fcb4e1c8f2385786c2b296f","9afd71a5298d4333b6849dfce1b9422c",22889675,1,-44,0,537,39,18,-21
"9afd71a5298d4333b6849dfce1b9422c","9afd71a5298d4333b6849dfce1b9422c",22889675,2,0,1,538,18,18,0
"9afd71a5298d4333b6849dfce1b9422c","78adeee1fa2c4fe0bc73f7bca9fcee86",22889675,1,196,0,539,18,160,142
"78adeee1fa2c4fe0bc73f7bca9fcee86","78adeee1fa2c4fe0bc73f7bca9fcee86",22889675,1,0,1,540,160,160,0
"78adeee1fa2c4fe0bc73f7bca9fcee86","a49d1bb4328949299686242fd0be5584",22889675,1,-190,0,541,160,21,-139
"a49d1bb4328949299686242fd0be5584","b7719e26494940efa49512aedd0aac79",22889675,2,-2,0,542,21,20,-1
"b7719e26494940efa49512aedd0aac79","b7719e26494940efa49512aedd0aac79",22889675,1,0,1,543,20,20,0
"b7719e26494940efa49512aedd0aac79","afbf7250b99d47bea07172749483ca97",22889675,3,12,0,544,20,28,8
"afbf7250b99d47bea07172749483ca97","afbf7250b99d47bea07172749483ca97",22889675,1,0,1,545,28,28,0
"afbf7250b99d47bea07172749483ca97","4e51676dc72045d99c19b9fa7b22f8bc",22889675,2,3,0,546,28,29,1
"4e51676dc72045d99c19b9fa7b22f8bc","a49d1bb4328949299686242fd0be5584",22889675,1,-13,0,547,29,21,-8
"b7719e26494940efa49512aedd0aac79","3ec3a3563847406fa73338f9e9999cf3",22889675,1,137,0,549,20,117,97
"3ec3a3563847406fa73338f9e9999cf3","e20db35ced8544ddac5bc3839145e463",22889675,1,-30,0,550,117,91,-26
"e20db35ced8544ddac5bc3839145e463","62bff51286ef4f348717a3cf6fe2318f",22889675,3,33,0,551,91,120,29
"e20db35ced8544ddac5bc3839145e463","779f9ddd1fd14d1e9e69f72219a1fdbd",22889675,2,36,0,555,91,121,30
"62bff51286ef4f348717a3cf6fe2318f","00ae5f0c51874a73a41ebea838d95682",22889675,1,-22,0,561,120,101,-19
"4280927ec4d643238aa49c32f9e06c6c","08111f75e22d409998cf8b85bd431f0a",22889675,1,-1,0,578,109,108,-1
"a9ae0a3c070d455bb4369a8996313336","37319e88176d4aefa91d7a9980dbae91",22889675,1,-2,0,580,114,112,-2
"62bff51286ef4f348717a3cf6fe2318f","b1cd0e7dc3ad4a8eb91a4bfdbeb025b0",22889675,1,-2,0,589,120,118,-2
"b1cd0e7dc3ad4a8eb91a4bfdbeb025b0","b1cd0e7dc3ad4a8eb91a4bfdbeb025b0",22889675,1,0,1,590,118,118,0
"b1cd0e7dc3ad4a8eb91a4bfdbeb025b0","e20db35ced8544ddac5bc3839145e463",22889675,1,-31,0,591,118,91,-27
"779f9ddd1fd14d1e9e69f72219a1fdbd","cd4532ad48034873ba8bce2aac0c9808",22889675,1,19,0,594,121,137,16
"cd4532ad48034873ba8bce2aac0c9808","cd4532ad48034873ba8bce2aac0c9808",22889675,1,0,1,595,137,137,0
"cd4532ad48034873ba8bce2aac0c9808","df1de691dafe4549a18a4398ee9dfaf9",22889675,1,4,0,596,137,139,2
"6c5ad271a44743479bfaea29b1db8d02","df1de691dafe4549a18a4398ee9dfaf9",22889675,1,-4,0,599,143,139,-4
"df1de691dafe4549a18a4398ee9dfaf9","d313cec988a84645bee413e8d4724a4b",22889675,1,22,0,600,139,158,19
"d313cec988a84645bee413e8d4724a4b","dc60696c76a74368a60f72246e47700d",22889675,1,1,0,603,158,159,1
"dc60696c76a74368a60f72246e47700d","dc60696c76a74368a60f72246e47700d",22889675,1,0,1,604,159,159,0
"dc60696c76a74368a60f72246e47700d","df1de691dafe4549a18a4398ee9dfaf9",22889675,1,-23,0,605,159,139,-20
"78adeee1fa2c4fe0bc73f7bca9fcee86","b534b89233134e30a9b5645138bfa9ee",22889675,1,-148,0,607,160,41,-119
"6e13d61a7bdb44bca949c9f86fab3be5","d0c74f735e024943943e40333d6d337f",22889675,1,5,0,619,47,51,4
"d0c74f735e024943943e40333d6d337f","f924752d8a1149668870b1e7698486f7",22889675,1,-1,0,620,51,50,-1
"6e13d61a7bdb44bca949c9f86fab3be5","8959e6304a0348309a771e4d08d1b64a",22889675,1,145,0,625,47,163,116
"8959e6304a0348309a771e4d08d1b64a","78adeee1fa2c4fe0bc73f7bca9fcee86",22889675,1,-4,0,626,163,160,-3
"8959e6304a0348309a771e4d08d1b64a","65202579580f4ad38d734b4ee39d22a8",22889675,1,1,0,636,163,164,1
"65202579580f4ad38d734b4ee39d22a8","3cbcea2be0984e7dbd5a48195af10ce7",22889675,1,3,0,719,164,165,1
"3cbcea2be0984e7dbd5a48195af10ce7","78adeee1fa2c4fe0bc73f7bca9fcee86",22889675,1,-8,0,720,165,160,-5
"78adeee1fa2c4fe0bc73f7bca9fcee86","82e6285962b8400d9d6fc32436022a94",22889675,1,10,0,721,160,167,7
"82e6285962b8400d9d6fc32436022a94","3cbcea2be0984e7dbd5a48195af10ce7",22889675,1,-2,0,722,167,165,-2
"3cbcea2be0984e7dbd5a48195af10ce7","a9ac840f098c4bd0a2ee896214ce29cd",22889675,1,5,0,723,165,168,3
"a9ac840f098c4bd0a2ee896214ce29cd","0c7262dff33c4087bc660ccf40f92f9c",22889675,1,4,0,724,168,169,1
"0c7262dff33c4087bc660ccf40f92f9c","a9ac840f098c4bd0a2ee896214ce29cd",22889675,1,-4,0,725,169,168,-1
"a9ac840f098c4bd0a2ee896214ce29cd","b2275c3fad834f8d90737a2d9a6927d6",22889675,1,7,0,726,168,172,4
"b2275c3fad834f8d90737a2d9a6927d6","b2275c3fad834f8d90737a2d9a6927d6",22889675,42,0,1,727,172,172,0
"b2275c3fad834f8d90737a2d9a6927d6","eb515a26030b41f8a82a1e6114420bad",22889675,1,1,0,769,172,173,1
"eb515a26030b41f8a82a1e6114420bad","eb515a26030b41f8a82a1e6114420bad",22889675,2,0,1,770,173,173,0
"eb515a26030b41f8a82a1e6114420bad","0c7262dff33c4087bc660ccf40f92f9c",22889675,1,-4,0,772,173,169,-4
"0c7262dff33c4087bc660ccf40f92f9c","b42cc17b7de840f181a704558d0bc845",22889675,1,7,0,773,169,175,6
"b42cc17b7de840f181a704558d0bc845","b42cc17b7de840f181a704558d0bc845",22889675,1,0,1,774,175,175,0
"b42cc17b7de840f181a704558d0bc845","801f9e9135034f49bf5f8b4bdefedb41",22889675,1,2,0,775,175,177,2
"801f9e9135034f49bf5f8b4bdefedb41","801f9e9135034f49bf5f8b4bdefedb41",22889675,4,0,1,776,177,177,0
"801f9e9135034f49bf5f8b4bdefedb41","362fcb0699a14845ab29b2340093e528",22889675,1,-3,0,780,177,174,-3
"362fcb0699a14845ab29b2340093e528","ea38cc0e6e6e41edbabf210220808bf9",22889675,1,6,0,781,174,179,5
"ea38cc0e6e6e41edbabf210220808bf9","b87c552dd247427abe6ab5795b9c9d43",22889675,2,2,0,782,179,181,2
"b87c552dd247427abe6ab5795b9c9d43","ea38cc0e6e6e41edbabf210220808bf9",22889675,1,-2,0,783,181,179,-2
"b87c552dd247427abe6ab5795b9c9d43","b87c552dd247427abe6ab5795b9c9d43",22889675,8,0,1,785,181,181,0
"b87c552dd247427abe6ab5795b9c9d43","139b097acfca451689d80c9c6eebdf7b",22889675,1,-3,0,793,181,178,-3
"139b097acfca451689d80c9c6eebdf7b","30f660a1feb34582a739722532524f79",22889675,1,6,0,794,178,183,5
"30f660a1feb34582a739722532524f79","30f660a1feb34582a739722532524f79",22889675,6,0,1,795,183,183,0
"30f660a1feb34582a739722532524f79","2024b4885bd14338a39b7b509acbbd02",22889675,1,-1,0,801,183,182,-1
"2024b4885bd14338a39b7b509acbbd02","0c7262dff33c4087bc660ccf40f92f9c",22889675,1,-16,0,802,182,169,-13
"c8e371568a0c4391b25796ae4e91952e","ab11d94c6c8948ea90b88f19d2cd502b",22889675,2,5,0,806,186,190,4
"ab11d94c6c8948ea90b88f19d2cd502b","07b44a7a51e94c78b411c753fc39dab0",22889675,2,-1,0,807,190,189,-1
"07b44a7a51e94c78b411c753fc39dab0","7d932b23e1c84326ae5aa4d3c0d813d1",22889675,1,-2,0,808,189,188,-1
"7d932b23e1c84326ae5aa4d3c0d813d1","7d932b23e1c84326ae5aa4d3c0d813d1",22889675,1,0,1,809,188,188,0
"7d932b23e1c84326ae5aa4d3c0d813d1","c8e371568a0c4391b25796ae4e91952e",22889675,1,-2,0,810,188,186,-2
"ab11d94c6c8948ea90b88f19d2cd502b","f992451ed6ad4e68bb9e68ad6be7c4be",22889675,1,2,0,812,190,192,2
"f992451ed6ad4e68bb9e68ad6be7c4be","f992451ed6ad4e68bb9e68ad6be7c4be",22889675,1,0,1,813,192,192,0
"f992451ed6ad4e68bb9e68ad6be7c4be","ab11d94c6c8948ea90b88f19d2cd502b",22889675,1,-2,0,814,192,190,-2
"07b44a7a51e94c78b411c753fc39dab0","6cd2dcaac46847d4a0bc53f296d90375",22889675,1,6,0,816,189,194,5
"6cd2dcaac46847d4a0bc53f296d90375","2d2580c9411c4972909db508d6956a58",22889675,1,2,0,818,194,196,2
"2d2580c9411c4972909db508d6956a58","2d2580c9411c4972909db508d6956a58",22889675,2,0,1,819,196,196,0
"2d2580c9411c4972909db508d6956a58","5bddb3d9ed264f3984702f048c7e5340",22889675,1,1,0,821,196,197,1
"5bddb3d9ed264f3984702f048c7e5340","5bddb3d9ed264f3984702f048c7e5340",22889675,2,0,1,822,197,197,0
"5bddb3d9ed264f3984702f048c7e5340","d5e8e2bd12a2466b9d6d90855f0eb079",22889675,1,1,0,824,197,198,1
"d5e8e2bd12a2466b9d6d90855f0eb079","d5e8e2bd12a2466b9d6d90855f0eb079",22889675,2,0,1,825,198,198,0
"d5e8e2bd12a2466b9d6d90855f0eb079","017d7ca8e0394b91aaadc9574df2202c",22889675,1,-5,0,827,198,193,-5
"017d7ca8e0394b91aaadc9574df2202c","54e8e9f0ea3e45c4bf3b8ac799ee31b1",22889675,1,8,0,828,193,200,7
"54e8e9f0ea3e45c4bf3b8ac799ee31b1","54e8e9f0ea3e45c4bf3b8ac799ee31b1",22889675,1,0,1,829,200,200,0
"54e8e9f0ea3e45c4bf3b8ac799ee31b1","c614a00911be4877a075f19315530fb0",22889675,1,1,0,830,200,201,1
"c614a00911be4877a075f19315530fb0","c614a00911be4877a075f19315530fb0",22889675,6,0,1,831,201,201,0
"c614a00911be4877a075f19315530fb0","f9170dd6bc6442b4acd832747609b09a",22889675,1,-2,0,837,201,199,-2
"f9170dd6bc6442b4acd832747609b09a","d7f13c8d63ec4e2aa673fbb9cf9c6933",22889675,1,10,0,838,199,206,7
"7108f0e4c2584f1f9c471689ae4c885c","b9e80f77c3a44349863b19875725c384",22889675,2,-1,0,842,208,207,-1
"b9e80f77c3a44349863b19875725c384","b9e80f77c3a44349863b19875725c384",22889675,24,0,1,843,207,207,0
"7108f0e4c2584f1f9c471689ae4c885c","7108f0e4c2584f1f9c471689ae4c885c",22889675,15,0,1,857,208,208,0
"b9e80f77c3a44349863b19875725c384","d7f13c8d63ec4e2aa673fbb9cf9c6933",22889675,1,-1,0,884,207,206,-1
"09400e101c5d4b439cf9a26b03aae558","a88efa7e50ce47159810ab553afa6d3a",22889675,1,2,0,889,210,212,2
"a88efa7e50ce47159810ab553afa6d3a","a88efa7e50ce47159810ab553afa6d3a",22889675,2,0,1,890,212,212,0
"a88efa7e50ce47159810ab553afa6d3a","be502a7a43c44bf7b682698de79d9369",22889675,1,3,0,892,212,214,2
"be502a7a43c44bf7b682698de79d9369","f7fb1952f56b4189b86a9f8b7862d2b8",22889675,1,1,0,899,214,215,1
"f7fb1952f56b4189b86a9f8b7862d2b8","f7fb1952f56b4189b86a9f8b7862d2b8",22889675,14,0,1,900,215,215,0
"f7fb1952f56b4189b86a9f8b7862d2b8","b860ee85d8bc4a2f97958cfb71be3533",22889675,1,1,0,914,215,216,1
"b860ee85d8bc4a2f97958cfb71be3533","b860ee85d8bc4a2f97958cfb71be3533",22889675,2,0,1,915,216,216,0
"b860ee85d8bc4a2f97958cfb71be3533","ec341f459285443b8361f7f15638ff08",22889675,1,-3,0,917,216,213,-3
"ec341f459285443b8361f7f15638ff08","363837c182e04711840d896ae1e0339c",22889675,1,6,0,918,213,218,5
"363837c182e04711840d896ae1e0339c","363837c182e04711840d896ae1e0339c",22889675,14,0,1,919,218,218,0
"363837c182e04711840d896ae1e0339c","01b2051f8941460d89945e3b02d1ce78",22889675,1,-1,0,933,218,217,-1
"01b2051f8941460d89945e3b02d1ce78","1c6721b1f63f4d30ba7746ea8af02a52",22889675,1,7,0,934,217,221,4
"77ecef8eff6b4a2caea7707669bf7475","77ecef8eff6b4a2caea7707669bf7475",22889675,12,0,1,937,222,222,0
"1c6721b1f63f4d30ba7746ea8af02a52","d03cb855c70044cf8c35d9ec0de696e3",22889675,1,4,0,950,221,224,3
"d03cb855c70044cf8c35d9ec0de696e3","8b9ae98743bd4d4a8a87dff1c1244211",22889675,1,3,0,951,224,227,3
"8b9ae98743bd4d4a8a87dff1c1244211","d03cb855c70044cf8c35d9ec0de696e3",22889675,1,-3,0,952,227,224,-3
"d03cb855c70044cf8c35d9ec0de696e3","d03cb855c70044cf8c35d9ec0de696e3",22889675,1,0,1,953,224,224,0
"d03cb855c70044cf8c35d9ec0de696e3","a49a937d6896486d9a5396654abcf2e1",22889675,1,2,0,954,224,226,2
"a49a937d6896486d9a5396654abcf2e1","a49a937d6896486d9a5396654abcf2e1",22889675,3,0,1,955,226,226,0
"a49a937d6896486d9a5396654abcf2e1","8b9ae98743bd4d4a8a87dff1c1244211",22889675,1,1,0,958,226,227,1
"8b9ae98743bd4d4a8a87dff1c1244211","8b9ae98743bd4d4a8a87dff1c1244211",22889675,18,0,1,959,227,227,0
"8b9ae98743bd4d4a8a87dff1c1244211","2ab1535aac1346ba8801535bf729ef37",22889675,1,3,0,977,227,229,2
"2ab1535aac1346ba8801535bf729ef37","f7906d6f59b9489a91d2ef40db5a474d",22889675,1,-7,0,978,229,223,-6
"f7906d6f59b9489a91d2ef40db5a474d","2ab1535aac1346ba8801535bf729ef37",22889675,1,7,0,979,223,229,6
"2ab1535aac1346ba8801535bf729ef37","a4f40fb48a8542c8949bae1f002cd9bc",22889675,1,2,0,980,229,231,2
"a4f40fb48a8542c8949bae1f002cd9bc","a4f40fb48a8542c8949bae1f002cd9bc",22889675,5,0,1,981,231,231,0
"a4f40fb48a8542c8949bae1f002cd9bc","8972c23e32044edb8a78fa1eed4e5947",22889675,1,1,0,986,231,232,1
"8972c23e32044edb8a78fa1eed4e5947","8972c23e32044edb8a78fa1eed4e5947",22889675,1,0,1,987,232,232,0
"8972c23e32044edb8a78fa1eed4e5947","92feb4a40f8344d38b6f722e42a53295",22889675,1,1,0,988,232,233,1
"92feb4a40f8344d38b6f722e42a53295","92feb4a40f8344d38b6f722e42a53295",22889675,2,0,1,989,233,233,0
"92feb4a40f8344d38b6f722e42a53295","5152833676bf4c6cb317060be10f68db",22889675,1,-5,0,991,233,228,-5
"5152833676bf4c6cb317060be10f68db","ca3e28f290354c08aefe5b0f769604e6",22889675,1,8,0,992,228,235,7
"ca3e28f290354c08aefe5b0f769604e6","ca3e28f290354c08aefe5b0f769604e6",22889675,4,0,1,993,235,235,0
"ca3e28f290354c08aefe5b0f769604e6","79a35eea833e4c2c9d22fc53c3c6445c",22889675,1,1,0,997,235,236,1
"79a35eea833e4c2c9d22fc53c3c6445c","79a35eea833e4c2c9d22fc53c3c6445c",22889675,4,0,1,1000,236,236,0
"79a35eea833e4c2c9d22fc53c3c6445c","8f68228b1518449e9615cdafee41a2bd",22889675,1,1,0,1002,236,237,1
"8f68228b1518449e9615cdafee41a2bd","8f68228b1518449e9615cdafee41a2bd",22889675,1,0,1,1003,237,237,0
"8f68228b1518449e9615cdafee41a2bd","cab89fa5c3ed45a5aa550fc0352d6a42",22889675,1,1,0,1004,237,238,1
"cab89fa5c3ed45a5aa550fc0352d6a42","cab89fa5c3ed45a5aa550fc0352d6a42",22889675,1,0,1,1005,238,238,0
"cab89fa5c3ed45a5aa550fc0352d6a42","66d4fad4f1cf4b46be0750a99ad7a35a",22889675,1,1,0,1006,238,239,1
"66d4fad4f1cf4b46be0750a99ad7a35a","66d4fad4f1cf4b46be0750a99ad7a35a",22889675,1,0,1,1007,239,239,0
"66d4fad4f1cf4b46be0750a99ad7a35a","0b04c8e2f86d48c7aeb7e225819cd32b",22889675,1,-5,0,1008,239,234,-5
"0b04c8e2f86d48c7aeb7e225819cd32b","1c6721b1f63f4d30ba7746ea8af02a52",22889675,1,-16,0,1009,234,221,-13
"1c6721b1f63f4d30ba7746ea8af02a52","2ae94c0cea4d480a9d5dca8fb1d7b542",22889675,1,27,0,1010,221,242,21
"2ae94c0cea4d480a9d5dca8fb1d7b542","1ebf23f9d994469a85206e4c7b1bf5f5",22889675,1,3,0,1011,242,245,3
"1ebf23f9d994469a85206e4c7b1bf5f5","1ebf23f9d994469a85206e4c7b1bf5f5",22889675,13,0,1,1012,245,245,0
"1ebf23f9d994469a85206e4c7b1bf5f5","85ae675b83e8422da842cfd25596af99",22889675,1,1,0,1025,245,246,1
"85ae675b83e8422da842cfd25596af99","85ae675b83e8422da842cfd25596af99",22889675,1,0,1,1026,246,246,0
"85ae675b83e8422da842cfd25596af99","2ae94c0cea4d480a9d5dca8fb1d7b542",22889675,1,-4,0,1027,246,242,-4
"2ae94c0cea4d480a9d5dca8fb1d7b542","fa235f0f364d47e4ae1c87f47bf8e6ba",22889675,2,12,0,1028,242,252,10
"fa235f0f364d47e4ae1c87f47bf8e6ba","fa235f0f364d47e4ae1c87f47bf8e6ba",22889675,13,0,1,1029,252,252,0
"fa235f0f364d47e4ae1c87f47bf8e6ba","79f7845465cc4ed19d8e4f1429541be0",22889675,1,2,0,1030,252,254,2
"79f7845465cc4ed19d8e4f1429541be0","79f7845465cc4ed19d8e4f1429541be0",22889675,2,0,1,1031,254,254,0
"79f7845465cc4ed19d8e4f1429541be0","00f61990949545828dd12f1303d47504",22889675,1,3,0,1033,254,256,2
"00f61990949545828dd12f1303d47504","6e83e23f56544a19b94067c1c558d9c0",22889675,1,-11,0,1034,256,247,-9
"6e83e23f56544a19b94067c1c558d9c0","00f61990949545828dd12f1303d47504",22889675,1,11,0,1035,247,256,9
"00f61990949545828dd12f1303d47504","00f61990949545828dd12f1303d47504",22889675,11,0,1,1036,256,256,0
"00f61990949545828dd12f1303d47504","ead7bb4b64e247d2ae632ab8a296b091",22889675,1,2,0,1046,256,258,2
"ead7bb4b64e247d2ae632ab8a296b091","ead7bb4b64e247d2ae632ab8a296b091",22889675,2,0,1,1047,258,258,0
"ead7bb4b64e247d2ae632ab8a296b091","41b0048dde734bb280bac6116baa8e27",22889675,1,1,0,1049,258,259,1
"41b0048dde734bb280bac6116baa8e27","41b0048dde734bb280bac6116baa8e27",22889675,2,0,1,1050,259,259,0
"41b0048dde734bb280bac6116baa8e27","b41c5a094a604ee0915327da5cc0beb7",22889675,1,1,0,1052,259,260,1
"b41c5a094a604ee0915327da5cc0beb7","b41c5a094a604ee0915327da5cc0beb7",22889675,2,0,1,1053,260,260,0
"b41c5a094a604ee0915327da5cc0beb7","d546341988904f069cfa86b21457d9d9",22889675,1,-10,0,1055,260,251,-9
"d546341988904f069cfa86b21457d9d9","28c171777c52431ab6b925073bd63d46",22889675,1,15,0,1056,251,264,13
"28c171777c52431ab6b925073bd63d46","28c171777c52431ab6b925073bd63d46",22889675,11,0,1,1057,264,264,0
"28c171777c52431ab6b925073bd63d46","ac160db940cb49ae8579162b1d52bb5d",22889675,1,2,0,1068,264,266,2
"ac160db940cb49ae8579162b1d52bb5d","ac160db940cb49ae8579162b1d52bb5d",22889675,3,0,1,1069,266,266,0
"ac160db940cb49ae8579162b1d52bb5d","d989ebcfc12a4b669f0100dc1aa14f1e",22889675,1,-12,0,1072,266,255,-11
"d989ebcfc12a4b669f0100dc1aa14f1e","c6fd49b485cc4874b0bbdd9c6171e09c",22889675,1,15,0,1073,255,268,13
"c6fd49b485cc4874b0bbdd9c6171e09c","c6fd49b485cc4874b0bbdd9c6171e09c",22889675,3,0,1,1074,268,268,0
"c6fd49b485cc4874b0bbdd9c6171e09c","44240778a97c4af0937817499b75707b",22889675,1,1,0,1077,268,269,1
"44240778a97c4af0937817499b75707b","44240778a97c4af0937817499b75707b",22889675,2,0,1,1078,269,269,0
"44240778a97c4af0937817499b75707b","7aa76d3e993840d8805f097cbdbcd44b",22889675,1,-9,0,1080,269,261,-8
"7aa76d3e993840d8805f097cbdbcd44b","2ae94c0cea4d480a9d5dca8fb1d7b542",22889675,1,-23,0,1081,261,242,-19
"2ae94c0cea4d480a9d5dca8fb1d7b542","0d987bed3ffa4ed0b9a2e62e97b7b30f",22889675,3,38,0,1082,242,272,30
"0d987bed3ffa4ed0b9a2e62e97b7b30f","0d987bed3ffa4ed0b9a2e62e97b7b30f",22889675,3,0,1,1083,272,272,0
"0d987bed3ffa4ed0b9a2e62e97b7b30f","82ae07bc0c9b4570a41799290d1ef399",22889675,2,4,0,1084,272,275,3
"82ae07bc0c9b4570a41799290d1ef399","bb5a47f5ea01454a8b79455422d3b9da",22889675,7,6,0,1085,275,280,5
"bb5a47f5ea01454a8b79455422d3b9da","bb5a47f5ea01454a8b79455422d3b9da",22889675,157,0,1,1086,280,280,0
"bb5a47f5ea01454a8b79455422d3b9da","0d987bed3ffa4ed0b9a2e62e97b7b30f",22889675,4,-10,0,1093,280,272,-8
"0d987bed3ffa4ed0b9a2e62e97b7b30f","94cecc3f1e7d484b8e068e79241dfd73",22889675,2,13,0,1094,272,281,9
"94cecc3f1e7d484b8e068e79241dfd73","a37477c4e4c14169ad44b06b493007f6",22889675,3,2,0,1095,281,283,2
"a37477c4e4c14169ad44b06b493007f6","0c7262dff33c4087bc660ccf40f92f9c",22889675,1,-150,0,1096,283,169,-114
"0c7262dff33c4087bc660ccf40f92f9c","0c7262dff33c4087bc660ccf40f92f9c",22889675,1,0,1,1097,169,169,0
"0c7262dff33c4087bc660ccf40f92f9c","c3f63fe50d8e487c86bf8ef76c9cadd3",22889675,1,20,0,1098,169,185,16
"c3f63fe50d8e487c86bf8ef76c9cadd3","c3f63fe50d8e487c86bf8ef76c9cadd3",22889675,3,0,1,1099,185,185,0
"c3f63fe50d8e487c86bf8ef76c9cadd3","0c7262dff33c4087bc660ccf40f92f9c",22889675,1,-20,0,1102,185,169,-16
"0c7262dff33c4087bc660ccf40f92f9c","c8e371568a0c4391b25796ae4e91952e",22889675,2,23,0,1103,169,186,17
"c8e371568a0c4391b25796ae4e91952e","c8e371568a0c4391b25796ae4e91952e",22889675,3,0,1,1104,186,186,0
"c8e371568a0c4391b25796ae4e91952e","a6c21bd8b95249c7972820a7a7d76aff",22889675,1,19,0,1105,186,202,16
"a6c21bd8b95249c7972820a7a7d76aff","a6c21bd8b95249c7972820a7a7d76aff",22889675,1,0,1,1106,202,202,0
"a6c21bd8b95249c7972820a7a7d76aff","bb329d880ab54120adaf203a693bb203",22889675,1,1,0,1107,202,203,1
"bb329d880ab54120adaf203a693bb203","bb329d880ab54120adaf203a693bb203",22889675,1,0,1,1108,203,203,0
"bb329d880ab54120adaf203a693bb203","f9170dd6bc6442b4acd832747609b09a",22889675,1,-4,0,1109,203,199,-4
"f9170dd6bc6442b4acd832747609b09a","2ae94c0cea4d480a9d5dca8fb1d7b542",22889675,1,58,0,1110,199,242,43
"2ae94c0cea4d480a9d5dca8fb1d7b542","7028800abe7d4e27b613d1d6cbe26bf7",22889675,3,30,0,1111,242,267,25
"7028800abe7d4e27b613d1d6cbe26bf7","7aa76d3e993840d8805f097cbdbcd44b",22889675,2,-7,0,1112,267,261,-6
"7aa76d3e993840d8805f097cbdbcd44b","00f61990949545828dd12f1303d47504",22889675,1,-6,0,1113,261,256,-5
"00f61990949545828dd12f1303d47504","d989ebcfc12a4b669f0100dc1aa14f1e",22889675,1,-1,0,1114,256,255,-1
"d989ebcfc12a4b669f0100dc1aa14f1e","00f61990949545828dd12f1303d47504",22889675,1,1,0,1115,255,256,1
"00f61990949545828dd12f1303d47504","d546341988904f069cfa86b21457d9d9",22889675,1,-6,0,1117,256,251,-5
"d546341988904f069cfa86b21457d9d9","865a4d3b43374da7944dc7d397f566d9",22889675,1,24,0,1118,251,271,20
"865a4d3b43374da7944dc7d397f566d9","865a4d3b43374da7944dc7d397f566d9",22889675,1,0,1,1119,271,271,0
"865a4d3b43374da7944dc7d397f566d9","0d987bed3ffa4ed0b9a2e62e97b7b30f",22889675,1,3,0,1120,271,272,1
"0d987bed3ffa4ed0b9a2e62e97b7b30f","2ae94c0cea4d480a9d5dca8fb1d7b542",22889675,5,-38,0,1121,272,242,-30
"2ae94c0cea4d480a9d5dca8fb1d7b542","b54257a550b94ebc9538f3a90eee9d7e",22889675,1,-52,0,1122,242,204,-38
"b54257a550b94ebc9538f3a90eee9d7e","c8e371568a0c4391b25796ae4e91952e",22889675,1,-22,0,1123,204,186,-18
"c8e371568a0c4391b25796ae4e91952e","b54257a550b94ebc9538f3a90eee9d7e",22889675,1,22,0,1124,186,204,18
"b54257a550b94ebc9538f3a90eee9d7e","6cd2dcaac46847d4a0bc53f296d90375",22889675,1,-12,0,1125,204,194,-10
"6cd2dcaac46847d4a0bc53f296d90375","6cd2dcaac46847d4a0bc53f296d90375",22889675,4,0,1,1126,194,194,0
"6cd2dcaac46847d4a0bc53f296d90375","017d7ca8e0394b91aaadc9574df2202c",22889675,1,-1,0,1129,194,193,-1
"017d7ca8e0394b91aaadc9574df2202c","334c2344009840079b1d0e1b7ce3d5a7",22889675,1,14,0,1130,193,205,12
"334c2344009840079b1d0e1b7ce3d5a7","334c2344009840079b1d0e1b7ce3d5a7",22889675,1,0,1,1131,205,205,0
"334c2344009840079b1d0e1b7ce3d5a7","d7f13c8d63ec4e2aa673fbb9cf9c6933",22889675,1,3,0,1132,205,206,1
"d7f13c8d63ec4e2aa673fbb9cf9c6933","c8e371568a0c4391b25796ae4e91952e",22889675,2,-26,0,1133,206,186,-20
"c8e371568a0c4391b25796ae4e91952e","b9e80f77c3a44349863b19875725c384",22889675,2,27,0,1134,186,207,21
"b9e80f77c3a44349863b19875725c384","7108f0e4c2584f1f9c471689ae4c885c",22889675,3,1,0,1135,207,208,1
"7108f0e4c2584f1f9c471689ae4c885c","d7f13c8d63ec4e2aa673fbb9cf9c6933",22889675,1,-2,0,1136,208,206,-2
"d7f13c8d63ec4e2aa673fbb9cf9c6933","91125ca626c5470eb145501f8c37f8db",22889675,1,18,0,1137,206,220,14
"91125ca626c5470eb145501f8c37f8db","91125ca626c5470eb145501f8c37f8db",22889675,1,0,1,1138,220,220,0
"91125ca626c5470eb145501f8c37f8db","1c6721b1f63f4d30ba7746ea8af02a52",22889675,1,3,0,1139,220,221,1
"1c6721b1f63f4d30ba7746ea8af02a52","d7f13c8d63ec4e2aa673fbb9cf9c6933",22889675,2,-21,0,1140,221,206,-15
"d7f13c8d63ec4e2aa673fbb9cf9c6933","77ecef8eff6b4a2caea7707669bf7475",22889675,2,22,0,1141,206,222,16
"77ecef8eff6b4a2caea7707669bf7475","1c6721b1f63f4d30ba7746ea8af02a52",22889675,2,-1,0,1142,222,221,-1
"1c6721b1f63f4d30ba7746ea8af02a52","f53da5fd9bfe412da4b80d4742563b6c",22889675,1,24,0,1143,221,241,20
"f53da5fd9bfe412da4b80d4742563b6c","f53da5fd9bfe412da4b80d4742563b6c",22889675,1,0,1,1144,241,241,0
"f53da5fd9bfe412da4b80d4742563b6c","2ae94c0cea4d480a9d5dca8fb1d7b542",22889675,1,3,0,1145,241,242,1
"2ae94c0cea4d480a9d5dca8fb1d7b542","1c6721b1f63f4d30ba7746ea8af02a52",22889675,1,-27,0,1146,242,221,-21
"1c6721b1f63f4d30ba7746ea8af02a52","1ebf23f9d994469a85206e4c7b1bf5f5",22889675,1,30,0,1147,221,245,24
"1ebf23f9d994469a85206e4c7b1bf5f5","2ae94c0cea4d480a9d5dca8fb1d7b542",22889675,1,-3,0,1148,245,242,-3
"fa235f0f364d47e4ae1c87f47bf8e6ba","0d987bed3ffa4ed0b9a2e62e97b7b30f",22889675,1,26,0,1150,252,272,20
"0d987bed3ffa4ed0b9a2e62e97b7b30f","bc5524e78a8544e2ae2fdc2f3462bbec",22889675,1,9,0,1151,272,279,7
"bc5524e78a8544e2ae2fdc2f3462bbec","bb5a47f5ea01454a8b79455422d3b9da",22889675,3,1,0,1152,279,280,1
"bb5a47f5ea01454a8b79455422d3b9da","bc5524e78a8544e2ae2fdc2f3462bbec",22889675,6,-1,0,1160,280,279,-1
"bb5a47f5ea01454a8b79455422d3b9da","82ae07bc0c9b4570a41799290d1ef399",22889675,4,-6,0,1168,280,275,-5
"bc5524e78a8544e2ae2fdc2f3462bbec","0d987bed3ffa4ed0b9a2e62e97b7b30f",22889675,1,-9,0,1173,279,272,-7
"0d987bed3ffa4ed0b9a2e62e97b7b30f","bb5a47f5ea01454a8b79455422d3b9da",22889675,5,10,0,1174,272,280,8
"bc5524e78a8544e2ae2fdc2f3462bbec","82ae07bc0c9b4570a41799290d1ef399",22889675,3,-5,0,1183,279,275,-4
"82ae07bc0c9b4570a41799290d1ef399","0d987bed3ffa4ed0b9a2e62e97b7b30f",22889675,2,-4,0,1195,275,272,-3
"2ae94c0cea4d480a9d5dca8fb1d7b542","2ae94c0cea4d480a9d5dca8fb1d7b542",22889675,1,0,1,1197,242,242,0
"7028800abe7d4e27b613d1d6cbe26bf7","fa235f0f364d47e4ae1c87f47bf8e6ba",22889675,1,-18,0,1202,267,252,-15
"fa235f0f364d47e4ae1c87f47bf8e6ba","a875096404ef4a9984b62d74cda916f9",22889675,1,-56,0,1215,252,209,-43
"a875096404ef4a9984b62d74cda916f9","d7f13c8d63ec4e2aa673fbb9cf9c6933",22889675,1,-4,0,1216,209,206,-3
"d7f13c8d63ec4e2aa673fbb9cf9c6933","09400e101c5d4b439cf9a26b03aae558",22889675,2,5,0,1217,206,210,4
"09400e101c5d4b439cf9a26b03aae558","09400e101c5d4b439cf9a26b03aae558",22889675,6,0,1,1218,210,210,0
"09400e101c5d4b439cf9a26b03aae558","be502a7a43c44bf7b682698de79d9369",22889675,1,5,0,1221,210,214,4
"be502a7a43c44bf7b682698de79d9369","a875096404ef4a9984b62d74cda916f9",22889675,2,-6,0,1222,214,209,-5
"a875096404ef4a9984b62d74cda916f9","f7fb1952f56b4189b86a9f8b7862d2b8",22889675,2,7,0,1223,209,215,6
"f7fb1952f56b4189b86a9f8b7862d2b8","be502a7a43c44bf7b682698de79d9369",22889675,2,-1,0,1224,215,214,-1
"be502a7a43c44bf7b682698de79d9369","be502a7a43c44bf7b682698de79d9369",22889675,4,0,1,1225,214,214,0
"be502a7a43c44bf7b682698de79d9369","0d987bed3ffa4ed0b9a2e62e97b7b30f",22889675,1,76,0,1226,214,272,58
"82ae07bc0c9b4570a41799290d1ef399","82ae07bc0c9b4570a41799290d1ef399",22889675,1,0,1,1228,275,275,0
"7aa76d3e993840d8805f097cbdbcd44b","d989ebcfc12a4b669f0100dc1aa14f1e",22889675,1,-7,0,1233,261,255,-6
"d989ebcfc12a4b669f0100dc1aa14f1e","7aa76d3e993840d8805f097cbdbcd44b",22889675,1,7,0,1234,255,261,6
"7aa76d3e993840d8805f097cbdbcd44b","0d987bed3ffa4ed0b9a2e62e97b7b30f",22889675,1,15,0,1235,261,272,11
"a37477c4e4c14169ad44b06b493007f6","94cecc3f1e7d484b8e068e79241dfd73",22889675,1,-2,0,1369,283,281,-2
"94cecc3f1e7d484b8e068e79241dfd73","fab84b4fab5940efb4ea868ef8d09396",22889675,1,5,0,1370,281,284,3
"fab84b4fab5940efb4ea868ef8d09396","fab84b4fab5940efb4ea868ef8d09396",22889675,1,0,1,1371,284,284,0
"fab84b4fab5940efb4ea868ef8d09396","94cecc3f1e7d484b8e068e79241dfd73",22889675,1,-5,0,1372,284,281,-3
"a37477c4e4c14169ad44b06b493007f6","4a29443515bb404cb8924e1c60a63b73",22889675,1,7,0,1374,283,285,2
"4a29443515bb404cb8924e1c60a63b73","4a29443515bb404cb8924e1c60a63b73",22889675,2,0,1,1375,285,285,0
"4a29443515bb404cb8924e1c60a63b73","208c9b2796c944db8dacaa96082520ea",22889675,3,3,0,1376,285,288,3
"208c9b2796c944db8dacaa96082520ea","4a29443515bb404cb8924e1c60a63b73",22889675,3,-3,0,1377,288,285,-3
"4a29443515bb404cb8924e1c60a63b73","869e967078f04da18dd0b0b9389a7424",22889675,2,10,0,1380,285,293,8
"869e967078f04da18dd0b0b9389a7424","6a9a3b5bde4a48daa896fe8c06eca56f",22889675,3,-5,0,1381,293,289,-4
"6a9a3b5bde4a48daa896fe8c06eca56f","34a6e49023fc4465bd5ca604330bbd1c",22889675,2,4,0,1382,289,292,3
"34a6e49023fc4465bd5ca604330bbd1c","7669a956527947d0add87455277e80b4",22889675,1,-2,0,1383,292,291,-1
"7669a956527947d0add87455277e80b4","7669a956527947d0add87455277e80b4",22889675,1,0,1,1384,291,291,0
"7669a956527947d0add87455277e80b4","869e967078f04da18dd0b0b9389a7424",22889675,1,3,0,1385,291,293,2
"6a9a3b5bde4a48daa896fe8c06eca56f","869e967078f04da18dd0b0b9389a7424",22889675,1,5,0,1387,289,293,4
"869e967078f04da18dd0b0b9389a7424","869e967078f04da18dd0b0b9389a7424",22889675,4,0,1,1388,293,293,0
"869e967078f04da18dd0b0b9389a7424","51ab6291537748fab90d519aa09889d6",22889675,1,2,0,1392,293,295,2
"51ab6291537748fab90d519aa09889d6","51ab6291537748fab90d519aa09889d6",22889675,5,0,1,1393,295,295,0
"51ab6291537748fab90d519aa09889d6","34a6e49023fc4465bd5ca604330bbd1c",22889675,1,-3,0,1398,295,292,-3
"34a6e49023fc4465bd5ca604330bbd1c","ba0e59461bfb4a44b7b1c28a01f8d3b3",22889675,1,9,0,1399,292,299,7
"ba0e59461bfb4a44b7b1c28a01f8d3b3","21592f2a9e9c4b2f8c66ec5dbcbf6a2b",22889675,1,-4,0,1400,299,296,-3
"21592f2a9e9c4b2f8c66ec5dbcbf6a2b","ba0e59461bfb4a44b7b1c28a01f8d3b3",22889675,2,4,0,1401,296,299,3
"ba0e59461bfb4a44b7b1c28a01f8d3b3","0e0b36e731a645e7b1b8a88f5031ca38",22889675,2,2,0,1402,299,301,2
"0e0b36e731a645e7b1b8a88f5031ca38","0e0b36e731a645e7b1b8a88f5031ca38",22889675,4,0,1,1403,301,301,0
"0e0b36e731a645e7b1b8a88f5031ca38","a66a144637284c21afc6de17fea4bfb8",22889675,1,1,0,1405,301,302,1
"a66a144637284c21afc6de17fea4bfb8","a66a144637284c21afc6de17fea4bfb8",22889675,2,0,1,1406,302,302,0
"a66a144637284c21afc6de17fea4bfb8","7646a919d7e64fa990bca9b024ff089d",22889675,1,-4,0,1408,302,298,-4
"7646a919d7e64fa990bca9b024ff089d","e390b575229748ea8aac9364efe2bf00",22889675,1,7,0,1409,298,304,6
"e390b575229748ea8aac9364efe2bf00","e390b575229748ea8aac9364efe2bf00",22889675,1,0,1,1410,304,304,0
"e390b575229748ea8aac9364efe2bf00","3434c10e561d488a914e0f7d71907abd",22889675,1,3,0,1411,304,305,1
"3434c10e561d488a914e0f7d71907abd","4a29443515bb404cb8924e1c60a63b73",22889675,4,-27,0,1412,305,285,-20
"4a29443515bb404cb8924e1c60a63b73","53e7e900392747ccad52e711ab0f80d8",22889675,2,29,0,1413,285,307,22
"53e7e900392747ccad52e711ab0f80d8","53e7e900392747ccad52e711ab0f80d8",22889675,1,0,1,1414,307,307,0
"53e7e900392747ccad52e711ab0f80d8","130acc2aeb0448fdbb2de63bc5cebe5b",22889675,1,3,0,1415,307,309,2
"130acc2aeb0448fdbb2de63bc5cebe5b","3434c10e561d488a914e0f7d71907abd",22889675,1,-5,0,1416,309,305,-4
"3434c10e561d488a914e0f7d71907abd","130acc2aeb0448fdbb2de63bc5cebe5b",22889675,2,5,0,1417,305,309,4
"130acc2aeb0448fdbb2de63bc5cebe5b","130acc2aeb0448fdbb2de63bc5cebe5b",22889675,2,0,1,1418,309,309,0
"130acc2aeb0448fdbb2de63bc5cebe5b","9c062b3251034ebe90f5054e2a3b5120",22889675,1,2,0,1420,309,311,2
"9c062b3251034ebe90f5054e2a3b5120","9c062b3251034ebe90f5054e2a3b5120",22889675,2,0,1,1421,311,311,0
"9c062b3251034ebe90f5054e2a3b5120","ea859f8207e44537889daeaba13ac2e8",22889675,1,1,0,1423,311,312,1
"ea859f8207e44537889daeaba13ac2e8","ea859f8207e44537889daeaba13ac2e8",22889675,1,0,1,1424,312,312,0
"ea859f8207e44537889daeaba13ac2e8","56d94971a7a94257aa330183a8ebd0ea",22889675,1,1,0,1425,312,313,1
"56d94971a7a94257aa330183a8ebd0ea","56d94971a7a94257aa330183a8ebd0ea",22889675,1,0,1,1426,313,313,0
"56d94971a7a94257aa330183a8ebd0ea","141c0df6cd1946539aadd1c9b7068cd4",22889675,1,-5,0,1427,313,308,-5
"141c0df6cd1946539aadd1c9b7068cd4","13255e63e0aa4abf85e5211bf613d43e",22889675,1,10,0,1428,308,317,9
"13255e63e0aa4abf85e5211bf613d43e","13255e63e0aa4abf85e5211bf613d43e",22889675,1,0,1,1429,317,317,0
"13255e63e0aa4abf85e5211bf613d43e","0c787d16c9504873b1a4d903cec09948",22889675,1,-3,0,1430,317,314,-3
"0c787d16c9504873b1a4d903cec09948","86c27d40179e419c8e9d150fb6afa5d0",22889675,1,6,0,1431,314,319,5
"86c27d40179e419c8e9d150fb6afa5d0","86c27d40179e419c8e9d150fb6afa5d0",22889675,1,0,1,1432,319,319,0
"86c27d40179e419c8e9d150fb6afa5d0","47edbb64109243e6b0f8f64cdef90c6c",22889675,2,8,0,1433,319,326,7
"47edbb64109243e6b0f8f64cdef90c6c","24f1363179ad4aaa965484a78471912b",22889675,4,-3,0,1434,326,323,-3
"24f1363179ad4aaa965484a78471912b","8d7e0b55cf9849cda222a0f2440cec55",22889675,3,-6,0,1435,323,318,-5
"8d7e0b55cf9849cda222a0f2440cec55","3628bdce1dd2429ba924d2d4d09448d2",22889675,2,5,0,1436,318,322,4
"3628bdce1dd2429ba924d2d4d09448d2","86c27d40179e419c8e9d150fb6afa5d0",22889675,1,-4,0,1437,322,319,-3
"8d7e0b55cf9849cda222a0f2440cec55","3434c10e561d488a914e0f7d71907abd",22889675,1,-16,0,1441,318,305,-13
"4a29443515bb404cb8924e1c60a63b73","7646a919d7e64fa990bca9b024ff089d",22889675,1,17,0,1443,285,298,13
"7646a919d7e64fa990bca9b024ff089d","ba0e59461bfb4a44b7b1c28a01f8d3b3",22889675,1,1,0,1444,298,299,1
"0e0b36e731a645e7b1b8a88f5031ca38","7646a919d7e64fa990bca9b024ff089d",22889675,1,-3,0,1448,301,298,-3
"7646a919d7e64fa990bca9b024ff089d","3628bdce1dd2429ba924d2d4d09448d2",22889675,1,31,0,1449,298,322,24
"3628bdce1dd2429ba924d2d4d09448d2","3434c10e561d488a914e0f7d71907abd",22889675,3,-21,0,1450,322,305,-17
"3434c10e561d488a914e0f7d71907abd","24f1363179ad4aaa965484a78471912b",22889675,1,22,0,1451,305,323,18
"24f1363179ad4aaa965484a78471912b","47edbb64109243e6b0f8f64cdef90c6c",22889675,1,3,0,1452,323,326,3
"24f1363179ad4aaa965484a78471912b","3628bdce1dd2429ba924d2d4d09448d2",22889675,1,-1,0,1454,323,322,-1
"3434c10e561d488a914e0f7d71907abd","0c4079457ede49e3aeb5e86ed84bdf35",22889675,5,31,0,1456,305,329,24
"0c4079457ede49e3aeb5e86ed84bdf35","38aea304b4fa46e1b29bb72f5cea4c93",22889675,5,2,0,1457,329,331,2
"38aea304b4fa46e1b29bb72f5cea4c93","3434c10e561d488a914e0f7d71907abd",22889675,1,-33,0,1458,331,305,-26
"3434c10e561d488a914e0f7d71907abd","3434c10e561d488a914e0f7d71907abd",22889675,1,0,1,1459,305,305,0
"38aea304b4fa46e1b29bb72f5cea4c93","38aea304b4fa46e1b29bb72f5cea4c93",22889675,14,0,1,1462,331,331,0
"38aea304b4fa46e1b29bb72f5cea4c93","0c4079457ede49e3aeb5e86ed84bdf35",22889675,6,-2,0,1465,331,329,-2
"38aea304b4fa46e1b29bb72f5cea4c93","e36d261332f14e79bb4b467aceaeb9b5",22889675,1,2,0,1467,331,333,2
"e36d261332f14e79bb4b467aceaeb9b5","e36d261332f14e79bb4b467aceaeb9b5",22889675,1,0,1,1468,333,333,0
"e36d261332f14e79bb4b467aceaeb9b5","c7e89b9d04744d2eab742fc24e3ef1ae",22889675,1,1,0,1469,333,334,1
"c7e89b9d04744d2eab742fc24e3ef1ae","c7e89b9d04744d2eab742fc24e3ef1ae",22889675,5,0,1,1470,334,334,0
"c7e89b9d04744d2eab742fc24e3ef1ae","fe49f8054b374a0ea4bb266ed135ff62",22889675,1,1,0,1475,334,335,1
"fe49f8054b374a0ea4bb266ed135ff62","fe49f8054b374a0ea4bb266ed135ff62",22889675,2,0,1,1476,335,335,0
"fe49f8054b374a0ea4bb266ed135ff62","d0a8f74af98642fe8360d22c42e45117",22889675,1,1,0,1478,335,336,1
"d0a8f74af98642fe8360d22c42e45117","d0a8f74af98642fe8360d22c42e45117",22889675,2,0,1,1479,336,336,0
"d0a8f74af98642fe8360d22c42e45117","0c4079457ede49e3aeb5e86ed84bdf35",22889675,1,-7,0,1481,336,329,-7
"0c4079457ede49e3aeb5e86ed84bdf35","0d987bed3ffa4ed0b9a2e62e97b7b30f",22889675,1,-80,0,1482,329,272,-57
"bb5a47f5ea01454a8b79455422d3b9da","3434c10e561d488a914e0f7d71907abd",22889675,1,39,0,1493,280,305,25
"3434c10e561d488a914e0f7d71907abd","56b3fd1a212a4764be39d979fde3326e",22889675,1,28,0,1494,305,328,23
"56b3fd1a212a4764be39d979fde3326e","56b3fd1a212a4764be39d979fde3326e",22889675,1,0,1,1495,328,328,0
"56b3fd1a212a4764be39d979fde3326e","3434c10e561d488a914e0f7d71907abd",22889675,1,-28,0,1496,328,305,-23
"0c4079457ede49e3aeb5e86ed84bdf35","3434c10e561d488a914e0f7d71907abd",22889675,2,-31,0,1498,329,305,-24
"3434c10e561d488a914e0f7d71907abd","38aea304b4fa46e1b29bb72f5cea4c93",22889675,1,33,0,1501,305,331,26
"0c4079457ede49e3aeb5e86ed84bdf35","a7c6339ca1da4368a18d471f0519f877",22889675,1,11,0,1503,329,339,10
"a7c6339ca1da4368a18d471f0519f877","a7c6339ca1da4368a18d471f0519f877",22889675,1,0,1,1504,339,339,0
"a7c6339ca1da4368a18d471f0519f877","bbc5139ca9024389a94db3a6f47dcff6",22889675,1,3,0,1505,339,341,2
"bbc5139ca9024389a94db3a6f47dcff6","b8b9418ab322418d9db9b40d96af873a",22889675,3,-5,0,1506,341,337,-4
"b8b9418ab322418d9db9b40d96af873a","bbc5139ca9024389a94db3a6f47dcff6",22889675,1,5,0,1507,337,341,4
"bbc5139ca9024389a94db3a6f47dcff6","4ee6ca9019ab4a1ab323f98094a9bd77",22889675,1,2,0,1508,341,343,2
"4ee6ca9019ab4a1ab323f98094a9bd77","4ee6ca9019ab4a1ab323f98094a9bd77",22889675,2,0,1,1509,343,343,0
"4ee6ca9019ab4a1ab323f98094a9bd77","b37947176785476f8b29d49a851366dc",22889675,1,1,0,1511,343,344,1
"b37947176785476f8b29d49a851366dc","b37947176785476f8b29d49a851366dc",22889675,2,0,1,1512,344,344,0
"b37947176785476f8b29d49a851366dc","fcea5b10d5a14a3b9324ffece8f6e1e5",22889675,1,1,0,1514,344,345,1
"fcea5b10d5a14a3b9324ffece8f6e1e5","fcea5b10d5a14a3b9324ffece8f6e1e5",22889675,2,0,1,1515,345,345,0
"fcea5b10d5a14a3b9324ffece8f6e1e5","c2490bc612d146edbe786556fab3651b",22889675,1,-5,0,1517,345,340,-5
"c2490bc612d146edbe786556fab3651b","0c4079457ede49e3aeb5e86ed84bdf35",22889675,2,-13,0,1518,340,329,-11
"0c4079457ede49e3aeb5e86ed84bdf35","4a92daef4d504e1792575a26502bb7b7",22889675,1,20,0,1519,329,346,17
"4a92daef4d504e1792575a26502bb7b7","bbc5139ca9024389a94db3a6f47dcff6",22889675,1,-6,0,1520,346,341,-5
"bbc5139ca9024389a94db3a6f47dcff6","bbc5139ca9024389a94db3a6f47dcff6",22889675,4,0,1,1521,341,341,0
"bbc5139ca9024389a94db3a6f47dcff6","c2490bc612d146edbe786556fab3651b",22889675,1,-1,0,1525,341,340,-1
"c2490bc612d146edbe786556fab3651b","38aea304b4fa46e1b29bb72f5cea4c93",22889675,2,-11,0,1526,340,331,-9
"0c4079457ede49e3aeb5e86ed84bdf35","6ac8bb048b854999a47edb35fe627f11",22889675,1,21,0,1533,329,347,18
"6ac8bb048b854999a47edb35fe627f11","6ac8bb048b854999a47edb35fe627f11",22889675,1,0,1,1534,347,347,0
"6ac8bb048b854999a47edb35fe627f11","0c4079457ede49e3aeb5e86ed84bdf35",22889675,1,-21,0,1535,347,329,-18
"0c4079457ede49e3aeb5e86ed84bdf35","30ead9794d4847abaf222ca966cc8630",22889675,2,24,0,1536,329,348,19
"30ead9794d4847abaf222ca966cc8630","897b7f51242c44aab2205c72fdcbf4cd",22889675,2,4,0,1537,348,352,4
"897b7f51242c44aab2205c72fdcbf4cd","eff0de7f2dbb42dfa1a2e686efab5b6d",22889675,3,2,0,1538,352,354,2
"eff0de7f2dbb42dfa1a2e686efab5b6d","09b9678ddc3d452ea4a3d46e15826065",22889675,4,-1,0,1539,354,353,-1
"09b9678ddc3d452ea4a3d46e15826065","c20993c944444fe085345591a8bd837e",22889675,3,-2,0,1540,353,351,-2
"c20993c944444fe085345591a8bd837e","eff0de7f2dbb42dfa1a2e686efab5b6d",22889675,4,3,0,1541,351,354,3
"eff0de7f2dbb42dfa1a2e686efab5b6d","eff0de7f2dbb42dfa1a2e686efab5b6d",22889675,6,0,1,1542,354,354,0
"09b9678ddc3d452ea4a3d46e15826065","09b9678ddc3d452ea4a3d46e15826065",22889675,7,0,1,1546,353,353,0
"09b9678ddc3d452ea4a3d46e15826065","897b7f51242c44aab2205c72fdcbf4cd",22889675,2,-1,0,1549,353,352,-1
"897b7f51242c44aab2205c72fdcbf4cd","897b7f51242c44aab2205c72fdcbf4cd",22889675,7,0,1,1550,352,352,0
"897b7f51242c44aab2205c72fdcbf4cd","c20993c944444fe085345591a8bd837e",22889675,3,-1,0,1553,352,351,-1
"c20993c944444fe085345591a8bd837e","c20993c944444fe085345591a8bd837e",22889675,5,0,1,1554,351,351,0
"c20993c944444fe085345591a8bd837e","30ead9794d4847abaf222ca966cc8630",22889675,2,-3,0,1557,351,348,-3
"30ead9794d4847abaf222ca966cc8630","2fe14166dc9642c3bc666b86a57f943d",22889675,2,10,0,1558,348,357,9
"2fe14166dc9642c3bc666b86a57f943d","2fe14166dc9642c3bc666b86a57f943d",22889675,9,0,1,1559,357,357,0
"2fe14166dc9642c3bc666b86a57f943d","cb5fc7ef85d547c4be1a7439d0bf6052",22889675,1,3,0,1560,357,360,3
"cb5fc7ef85d547c4be1a7439d0bf6052","cb5fc7ef85d547c4be1a7439d0bf6052",22889675,2,0,1,1561,360,360,0
"cb5fc7ef85d547c4be1a7439d0bf6052","44421dd1e13a47a388c4a19834b744c7",22889675,1,-1,0,1563,360,359,-1
"44421dd1e13a47a388c4a19834b744c7","44421dd1e13a47a388c4a19834b744c7",22889675,2,0,1,1564,359,359,0
"44421dd1e13a47a388c4a19834b744c7","0a8f150a4cf747acbde62f4721823da3",22889675,1,2,0,1566,359,361,2
"0a8f150a4cf747acbde62f4721823da3","0a8f150a4cf747acbde62f4721823da3",22889675,2,0,1,1567,361,361,0
"0a8f150a4cf747acbde62f4721823da3","ab8fdad974ae471f9f24c3f9dd04462e",22889675,1,1,0,1569,361,362,1
"ab8fdad974ae471f9f24c3f9dd04462e","ab8fdad974ae471f9f24c3f9dd04462e",22889675,2,0,1,1570,362,362,0
"ab8fdad974ae471f9f24c3f9dd04462e","52580888dadb4fe3baa795683ea227bd",22889675,1,3,0,1572,362,364,2
"52580888dadb4fe3baa795683ea227bd","1ba8fef685d74a8194b9db252eb704fb",22889675,1,-10,0,1573,364,355,-9
"1ba8fef685d74a8194b9db252eb704fb","52580888dadb4fe3baa795683ea227bd",22889675,1,10,0,1574,355,364,9
"52580888dadb4fe3baa795683ea227bd","52580888dadb4fe3baa795683ea227bd",22889675,8,0,1,1575,364,364,0
"52580888dadb4fe3baa795683ea227bd","f00179e251a045b39c3f7a54f9aa4acc",22889675,2,-1,0,1583,364,363,-1
"f00179e251a045b39c3f7a54f9aa4acc","492a3bc6a1254f23a7998587961b22a4",22889675,1,4,0,1584,363,366,3
"492a3bc6a1254f23a7998587961b22a4","072a190fd302456290895f9f04d6940a",22889675,2,-1,0,1585,366,365,-1
"072a190fd302456290895f9f04d6940a","52580888dadb4fe3baa795683ea227bd",22889675,1,-2,0,1586,365,364,-1
"f00179e251a045b39c3f7a54f9aa4acc","2fe14166dc9642c3bc666b86a57f943d",22889675,1,-7,0,1588,363,357,-6
"2fe14166dc9642c3bc666b86a57f943d","1ba8fef685d74a8194b9db252eb704fb",22889675,2,-2,0,1591,357,355,-2
"1ba8fef685d74a8194b9db252eb704fb","492a3bc6a1254f23a7998587961b22a4",22889675,1,13,0,1592,355,366,11
"492a3bc6a1254f23a7998587961b22a4","492a3bc6a1254f23a7998587961b22a4",22889675,7,0,1,1593,366,366,0
"072a190fd302456290895f9f04d6940a","b71bac264efb4abd97015447bd490db6",22889675,1,8,0,1601,365,370,5
"b71bac264efb4abd97015447bd490db6","30ead9794d4847abaf222ca966cc8630",22889675,1,-28,0,1602,370,348,-22
"30ead9794d4847abaf222ca966cc8630","30ead9794d4847abaf222ca966cc8630",22889675,2,0,1,1603,348,348,0
"30ead9794d4847abaf222ca966cc8630","b71bac264efb4abd97015447bd490db6",22889675,1,28,0,1604,348,370,22
"b71bac264efb4abd97015447bd490db6","cfa457d1743848e4bb5e4beced6448ed",22889675,1,-3,0,1605,370,369,-1
"cfa457d1743848e4bb5e4beced6448ed","c76574d21bc14aeea7ecd0b027f39858",22889675,1,-2,0,1606,369,367,-2
"c76574d21bc14aeea7ecd0b027f39858","2fe14166dc9642c3bc666b86a57f943d",22889675,2,-13,0,1607,367,357,-10
"1ba8fef685d74a8194b9db252eb704fb","cfa457d1743848e4bb5e4beced6448ed",22889675,1,17,0,1615,355,369,14
"cfa457d1743848e4bb5e4beced6448ed","cfa457d1743848e4bb5e4beced6448ed",22889675,1,0,1,1616,369,369,0
"cfa457d1743848e4bb5e4beced6448ed","30ead9794d4847abaf222ca966cc8630",22889675,1,-25,0,1617,369,348,-21
"30ead9794d4847abaf222ca966cc8630","09b9678ddc3d452ea4a3d46e15826065",22889675,1,5,0,1619,348,353,5
"eff0de7f2dbb42dfa1a2e686efab5b6d","c20993c944444fe085345591a8bd837e",22889675,3,-3,0,1627,354,351,-3
"c20993c944444fe085345591a8bd837e","897b7f51242c44aab2205c72fdcbf4cd",22889675,2,1,0,1628,351,352,1
"c20993c944444fe085345591a8bd837e","52580888dadb4fe3baa795683ea227bd",22889675,1,15,0,1631,351,364,13
"52580888dadb4fe3baa795683ea227bd","30ead9794d4847abaf222ca966cc8630",22889675,1,-18,0,1632,364,348,-16
"2fe14166dc9642c3bc666b86a57f943d","f00179e251a045b39c3f7a54f9aa4acc",22889675,1,7,0,1634,357,363,6
"f00179e251a045b39c3f7a54f9aa4acc","897b7f51242c44aab2205c72fdcbf4cd",22889675,1,-13,0,1635,363,352,-11
"eff0de7f2dbb42dfa1a2e686efab5b6d","1ba8fef685d74a8194b9db252eb704fb",22889675,1,2,0,1640,354,355,1
"1ba8fef685d74a8194b9db252eb704fb","09b9678ddc3d452ea4a3d46e15826065",22889675,1,-3,0,1641,355,353,-2
"30ead9794d4847abaf222ca966cc8630","0c4079457ede49e3aeb5e86ed84bdf35",22889675,1,-24,0,1649,348,329,-19
"0c4079457ede49e3aeb5e86ed84bdf35","bbc5139ca9024389a94db3a6f47dcff6",22889675,3,14,0,1650,329,341,12
"bbc5139ca9024389a94db3a6f47dcff6","4a92daef4d504e1792575a26502bb7b7",22889675,1,6,0,1651,341,346,5
"4a92daef4d504e1792575a26502bb7b7","c2490bc612d146edbe786556fab3651b",22889675,1,-7,0,1652,346,340,-6
"38aea304b4fa46e1b29bb72f5cea4c93","b8b9418ab322418d9db9b40d96af873a",22889675,1,7,0,1654,331,337,6
"b8b9418ab322418d9db9b40d96af873a","38aea304b4fa46e1b29bb72f5cea4c93",22889675,1,-7,0,1655,337,331,-6
"0c4079457ede49e3aeb5e86ed84bdf35","c2490bc612d146edbe786556fab3651b",22889675,1,13,0,1663,329,340,11
"c2490bc612d146edbe786556fab3651b","bbc5139ca9024389a94db3a6f47dcff6",22889675,1,1,0,1664,340,341,1
"bbc5139ca9024389a94db3a6f47dcff6","4a29443515bb404cb8924e1c60a63b73",22889675,1,-72,0,1665,341,285,-56
"4a29443515bb404cb8924e1c60a63b73","0c4079457ede49e3aeb5e86ed84bdf35",22889675,2,58,0,1666,285,329,44
"0c4079457ede49e3aeb5e86ed84bdf35","0c4079457ede49e3aeb5e86ed84bdf35",22889675,1,0,1,1667,329,329,0
"b8b9418ab322418d9db9b40d96af873a","0c4079457ede49e3aeb5e86ed84bdf35",22889675,1,-9,0,1672,337,329,-8
"b8b9418ab322418d9db9b40d96af873a","c2490bc612d146edbe786556fab3651b",22889675,1,4,0,1675,337,340,3
"897b7f51242c44aab2205c72fdcbf4cd","09b9678ddc3d452ea4a3d46e15826065",22889675,1,1,0,1679,352,353,1
"09b9678ddc3d452ea4a3d46e15826065","eff0de7f2dbb42dfa1a2e686efab5b6d",22889675,1,1,0,1680,353,354,1
"09b9678ddc3d452ea4a3d46e15826065","30ead9794d4847abaf222ca966cc8630",22889675,1,-5,0,1690,353,348,-5
"30ead9794d4847abaf222ca966cc8630","52580888dadb4fe3baa795683ea227bd",22889675,1,18,0,1691,348,364,16
"52580888dadb4fe3baa795683ea227bd","492a3bc6a1254f23a7998587961b22a4",22889675,1,3,0,1692,364,366,2
"492a3bc6a1254f23a7998587961b22a4","f00179e251a045b39c3f7a54f9aa4acc",22889675,1,-4,0,1693,366,363,-3
"f00179e251a045b39c3f7a54f9aa4acc","072a190fd302456290895f9f04d6940a",22889675,1,3,0,1694,363,365,2
"072a190fd302456290895f9f04d6940a","2fe14166dc9642c3bc666b86a57f943d",22889675,1,-10,0,1695,365,357,-8
"2fe14166dc9642c3bc666b86a57f943d","c76574d21bc14aeea7ecd0b027f39858",22889675,1,13,0,1696,357,367,10
"2fe14166dc9642c3bc666b86a57f943d","b71bac264efb4abd97015447bd490db6",22889675,1,18,0,1698,357,370,13
"b71bac264efb4abd97015447bd490db6","b71bac264efb4abd97015447bd490db6",22889675,1,0,1,1699,370,370,0
"b71bac264efb4abd97015447bd490db6","8d448d625b024c82a5eb240bbd7431d6",22889675,3,5,0,1700,370,374,4
"8d448d625b024c82a5eb240bbd7431d6","8d448d625b024c82a5eb240bbd7431d6",22889675,68,0,1,1701,374,374,0
"8d448d625b024c82a5eb240bbd7431d6","b71bac264efb4abd97015447bd490db6",22889675,1,-5,0,1707,374,370,-4
"8d448d625b024c82a5eb240bbd7431d6","d6d02b6ef04e4f17805504500b8ce441",22889675,2,3,0,1722,374,375,1
"d6d02b6ef04e4f17805504500b8ce441","d6d02b6ef04e4f17805504500b8ce441",22889675,3,0,1,1723,375,375,0
"d6d02b6ef04e4f17805504500b8ce441","4a29443515bb404cb8924e1c60a63b73",22889675,1,-118,0,1726,375,285,-90
"4a29443515bb404cb8924e1c60a63b73","b71bac264efb4abd97015447bd490db6",22889675,1,110,0,1727,285,370,85
"b71bac264efb4abd97015447bd490db6","1b4550d0dab04078b3bf08a655345bdc",22889675,1,4,0,1728,370,373,3
"1b4550d0dab04078b3bf08a655345bdc","8d448d625b024c82a5eb240bbd7431d6",22889675,1,1,0,1729,373,374,1
"d6d02b6ef04e4f17805504500b8ce441","b71bac264efb4abd97015447bd490db6",22889675,1,-8,0,1771,375,370,-5
"b71bac264efb4abd97015447bd490db6","d6d02b6ef04e4f17805504500b8ce441",22889675,1,8,0,1772,370,375,5
"d6d02b6ef04e4f17805504500b8ce441","66baf19b6b904b70922329068c63746d",22889675,1,4,0,1773,375,376,1
"66baf19b6b904b70922329068c63746d","66baf19b6b904b70922329068c63746d",22889675,1,0,1,1774,376,376,0
"66baf19b6b904b70922329068c63746d","7f544639412e40a9ba27f43b415362ab",22889675,2,2,0,1775,376,378,2
"7f544639412e40a9ba27f43b415362ab","7f544639412e40a9ba27f43b415362ab",22889675,5,0,1,1776,378,378,0
"7f544639412e40a9ba27f43b415362ab","d5ae8642e15b46b8bd298b02274d4e9c",22889675,1,2,0,1777,378,380,2
"d5ae8642e15b46b8bd298b02274d4e9c","d5ae8642e15b46b8bd298b02274d4e9c",22889675,1,0,1,1778,380,380,0
"d5ae8642e15b46b8bd298b02274d4e9c","a0d10309a2dd456289147f84be9d37f9",22889675,1,1,0,1779,380,381,1
"a0d10309a2dd456289147f84be9d37f9","a0d10309a2dd456289147f84be9d37f9",22889675,2,0,1,1780,381,381,0
"a0d10309a2dd456289147f84be9d37f9","0fcbc3ca07b144138b8d85da581f09a8",22889675,1,1,0,1782,381,382,1
"0fcbc3ca07b144138b8d85da581f09a8","0fcbc3ca07b144138b8d85da581f09a8",22889675,2,0,1,1783,382,382,0
"0fcbc3ca07b144138b8d85da581f09a8","66baf19b6b904b70922329068c63746d",22889675,1,-6,0,1785,382,376,-6
"66baf19b6b904b70922329068c63746d","c2fca3669923477ab966ded303dea31c",22889675,1,8,0,1786,376,383,7
"c2fca3669923477ab966ded303dea31c","4890121ce5d74576b4632b77cfc23398",22889675,1,6,0,1787,383,388,5
"4890121ce5d74576b4632b77cfc23398","4890121ce5d74576b4632b77cfc23398",22889675,9,0,1,1788,388,388,0
"4890121ce5d74576b4632b77cfc23398","66baf19b6b904b70922329068c63746d",22889675,1,-14,0,1789,388,376,-12
"7f544639412e40a9ba27f43b415362ab","66baf19b6b904b70922329068c63746d",22889675,3,-2,0,1791,378,376,-2
"66baf19b6b904b70922329068c63746d","96bb2b3e85a34d8b9544514e89f6fe97",22889675,3,17,0,1792,376,390,14
"96bb2b3e85a34d8b9544514e89f6fe97","96bb2b3e85a34d8b9544514e89f6fe97",22889675,2,0,1,1793,390,390,0
"96bb2b3e85a34d8b9544514e89f6fe97","ac4e9b54acfe4670b4634859c7263cb5",22889675,3,2,0,1795,390,392,2
"ac4e9b54acfe4670b4634859c7263cb5","ac4e9b54acfe4670b4634859c7263cb5",22889675,2,0,1,1796,392,392,0
"ac4e9b54acfe4670b4634859c7263cb5","4890121ce5d74576b4632b77cfc23398",22889675,1,-5,0,1797,392,388,-4
"4890121ce5d74576b4632b77cfc23398","17f95d18bab743888e1736033dc3384d",22889675,1,2,0,1798,388,389,1
"17f95d18bab743888e1736033dc3384d","4890121ce5d74576b4632b77cfc23398",22889675,1,-2,0,1799,389,388,-1
"4890121ce5d74576b4632b77cfc23398","18d3b836dd804224883cc9180b60a8e1",22889675,1,-1,0,1808,388,387,-1
"18d3b836dd804224883cc9180b60a8e1","7f544639412e40a9ba27f43b415362ab",22889675,1,-11,0,1809,387,378,-9
"ac4e9b54acfe4670b4634859c7263cb5","7f544639412e40a9ba27f43b415362ab",22889675,1,-17,0,1817,392,378,-14
"7f544639412e40a9ba27f43b415362ab","17f95d18bab743888e1736033dc3384d",22889675,1,14,0,1818,378,389,11
"17f95d18bab743888e1736033dc3384d","7f544639412e40a9ba27f43b415362ab",22889675,1,-14,0,1819,389,378,-11
"ac4e9b54acfe4670b4634859c7263cb5","6f8881a745ac4c358a68b92c3b4abe81",22889675,1,3,0,1824,392,394,2
"6f8881a745ac4c358a68b92c3b4abe81","17f95d18bab743888e1736033dc3384d",22889675,1,-6,0,1825,394,389,-5
"17f95d18bab743888e1736033dc3384d","6f8881a745ac4c358a68b92c3b4abe81",22889675,1,6,0,1826,389,394,5
"6f8881a745ac4c358a68b92c3b4abe81","f7002c8484354eceac57bc7bd62c76c1",22889675,2,-1,0,1827,394,393,-1
"f7002c8484354eceac57bc7bd62c76c1","0c12af0a4e7f4002852cf84b2537c161",22889675,1,3,0,1828,393,395,2
"0c12af0a4e7f4002852cf84b2537c161","66baf19b6b904b70922329068c63746d",22889675,2,-24,0,1829,395,376,-19
"66baf19b6b904b70922329068c63746d","2b09a08242b54983aec7063990fb3f66",22889675,3,32,0,1830,376,400,24
"2b09a08242b54983aec7063990fb3f66","2b09a08242b54983aec7063990fb3f66",22889675,31,0,1,1831,400,400,0
"2b09a08242b54983aec7063990fb3f66","1f471b7a883a4df48211e8c6a81b59a7",22889675,1,1,0,1838,400,401,1
"1f471b7a883a4df48211e8c6a81b59a7","1f471b7a883a4df48211e8c6a81b59a7",22889675,1,0,1,1839,401,401,0
"1f471b7a883a4df48211e8c6a81b59a7","2b09a08242b54983aec7063990fb3f66",22889675,1,-1,0,1840,401,400,-1
"2b09a08242b54983aec7063990fb3f66","1157bd665ec4472fb58b751dc5099355",22889675,3,4,0,1841,400,403,3
"1157bd665ec4472fb58b751dc5099355","3c8a22d2f9c146ea956609e3ed4f2559",22889675,2,3,0,1842,403,405,2
"3c8a22d2f9c146ea956609e3ed4f2559","3c8a22d2f9c146ea956609e3ed4f2559",22889675,2,0,1,1843,405,405,0
"3c8a22d2f9c146ea956609e3ed4f2559","2b09a08242b54983aec7063990fb3f66",22889675,1,-7,0,1845,405,400,-5
"2b09a08242b54983aec7063990fb3f66","58fc9094275e4c49be3f4ba6d4acc0a4",22889675,1,9,0,1846,400,406,6
"58fc9094275e4c49be3f4ba6d4acc0a4","3c8a22d2f9c146ea956609e3ed4f2559",22889675,2,-2,0,1847,406,405,-1
"3c8a22d2f9c146ea956609e3ed4f2559","58fc9094275e4c49be3f4ba6d4acc0a4",22889675,2,2,0,1848,405,406,1
"58fc9094275e4c49be3f4ba6d4acc0a4","c1c1be90b2b14c1ab4a5e1ee3c241902",22889675,1,1,0,1849,406,407,1
"c1c1be90b2b14c1ab4a5e1ee3c241902","c1c1be90b2b14c1ab4a5e1ee3c241902",22889675,5,0,1,1850,407,407,0
"c1c1be90b2b14c1ab4a5e1ee3c241902","58fc9094275e4c49be3f4ba6d4acc0a4",22889675,1,-1,0,1855,407,406,-1
"58fc9094275e4c49be3f4ba6d4acc0a4","02b3a1bead9244c1ba2f857c7da8f82a",22889675,3,3,0,1856,406,408,2
"02b3a1bead9244c1ba2f857c7da8f82a","02b3a1bead9244c1ba2f857c7da8f82a",22889675,21,0,1,1857,408,408,0
"02b3a1bead9244c1ba2f857c7da8f82a","6206fc6479014bb193084c32409dc1b9",22889675,1,1,0,1858,408,409,1
"6206fc6479014bb193084c32409dc1b9","6206fc6479014bb193084c32409dc1b9",22889675,1,0,1,1859,409,409,0
"6206fc6479014bb193084c32409dc1b9","02b3a1bead9244c1ba2f857c7da8f82a",22889675,1,-1,0,1860,409,408,-1
"02b3a1bead9244c1ba2f857c7da8f82a","6a5f020451db426dacba9e2ea3fcc62a",22889675,3,3,0,1861,408,410,2
"6a5f020451db426dacba9e2ea3fcc62a","6a5f020451db426dacba9e2ea3fcc62a",22889675,19,0,1,1862,410,410,0
"6a5f020451db426dacba9e2ea3fcc62a","33a9d248b2e44588a5b07fc1342b9bc2",22889675,1,2,0,1864,410,411,1
"33a9d248b2e44588a5b07fc1342b9bc2","33a9d248b2e44588a5b07fc1342b9bc2",22889675,5,0,1,1865,411,411,0
"33a9d248b2e44588a5b07fc1342b9bc2","c6f26bd420634f1cb7989e76fe6b16c0",22889675,1,1,0,1869,411,412,1
"c6f26bd420634f1cb7989e76fe6b16c0","c6f26bd420634f1cb7989e76fe6b16c0",22889675,5,0,1,1870,412,412,0
"c6f26bd420634f1cb7989e76fe6b16c0","2a65ee6e2ac64f6a8a55fbe5373ec763",22889675,1,1,0,1875,412,413,1
"2a65ee6e2ac64f6a8a55fbe5373ec763","2a65ee6e2ac64f6a8a55fbe5373ec763",22889675,2,0,1,1876,413,413,0
"2a65ee6e2ac64f6a8a55fbe5373ec763","33a9d248b2e44588a5b07fc1342b9bc2",22889675,1,-2,0,1878,413,411,-2
"33a9d248b2e44588a5b07fc1342b9bc2","687055dad9fc40c3982478fe33ec01bf",22889675,2,4,0,1879,411,414,3
"687055dad9fc40c3982478fe33ec01bf","2b09a08242b54983aec7063990fb3f66",22889675,2,-21,0,1880,414,400,-14
"2b09a08242b54983aec7063990fb3f66","a2b4bd40cee2481ebd3fc179d6a5cd62",22889675,2,27,0,1881,400,417,17
"a2b4bd40cee2481ebd3fc179d6a5cd62","a2b4bd40cee2481ebd3fc179d6a5cd62",22889675,1,0,1,1882,417,417,0
"a2b4bd40cee2481ebd3fc179d6a5cd62","bec48fc2e1294c7eb3d0aca780d731b8",22889675,6,4,0,1883,417,420,3
"bec48fc2e1294c7eb3d0aca780d731b8","0c12af0a4e7f4002852cf84b2537c161",22889675,1,-39,0,1884,420,395,-25
"66baf19b6b904b70922329068c63746d","44a277ea44dc4ae689fab4b82f0b4098",22889675,1,26,0,1886,376,397,21
"44a277ea44dc4ae689fab4b82f0b4098","44a277ea44dc4ae689fab4b82f0b4098",22889675,1,0,1,1887,397,397,0
"44a277ea44dc4ae689fab4b82f0b4098","0c12af0a4e7f4002852cf84b2537c161",22889675,1,-2,0,1888,397,395,-2
"0c12af0a4e7f4002852cf84b2537c161","df8191ec5e584c838a899c378941a566",22889675,1,4,0,1889,395,398,3
"df8191ec5e584c838a899c378941a566","c2fca3669923477ab966ded303dea31c",22889675,1,-20,0,1890,398,383,-15
"c2fca3669923477ab966ded303dea31c","6f8881a745ac4c358a68b92c3b4abe81",22889675,1,14,0,1891,383,394,11
"6f8881a745ac4c358a68b92c3b4abe81","6f8881a745ac4c358a68b92c3b4abe81",22889675,10,0,1,1892,394,394,0
"f7002c8484354eceac57bc7bd62c76c1","859e0b8d71694b12befb69ee698138f9",22889675,1,8,0,1899,393,399,6
"859e0b8d71694b12befb69ee698138f9","859e0b8d71694b12befb69ee698138f9",22889675,1,0,1,1900,399,399,0
"859e0b8d71694b12befb69ee698138f9","66baf19b6b904b70922329068c63746d",22889675,1,-29,0,1901,399,376,-23
"2b09a08242b54983aec7063990fb3f66","4a29443515bb404cb8924e1c60a63b73",22889675,1,-154,0,1905,400,285,-115
"34a6e49023fc4465bd5ca604330bbd1c","21592f2a9e9c4b2f8c66ec5dbcbf6a2b",22889675,1,5,0,1912,292,296,4
"ba0e59461bfb4a44b7b1c28a01f8d3b3","7646a919d7e64fa990bca9b024ff089d",22889675,1,-1,0,1914,299,298,-1
"7646a919d7e64fa990bca9b024ff089d","3434c10e561d488a914e0f7d71907abd",22889675,1,10,0,1915,298,305,7
"53e7e900392747ccad52e711ab0f80d8","3434c10e561d488a914e0f7d71907abd",22889675,1,-2,0,1918,307,305,-2
"130acc2aeb0448fdbb2de63bc5cebe5b","141c0df6cd1946539aadd1c9b7068cd4",22889675,1,-1,0,1920,309,308,-1
"141c0df6cd1946539aadd1c9b7068cd4","86c27d40179e419c8e9d150fb6afa5d0",22889675,1,13,0,1921,308,319,11
"86c27d40179e419c8e9d150fb6afa5d0","0c787d16c9504873b1a4d903cec09948",22889675,1,-6,0,1922,319,314,-5
"0c787d16c9504873b1a4d903cec09948","47edbb64109243e6b0f8f64cdef90c6c",22889675,1,14,0,1923,314,326,12
"0c4079457ede49e3aeb5e86ed84bdf35","1157bd665ec4472fb58b751dc5099355",22889675,1,100,0,1931,329,403,74
"1157bd665ec4472fb58b751dc5099355","2b09a08242b54983aec7063990fb3f66",22889675,3,-4,0,1932,403,400,-3
"1157bd665ec4472fb58b751dc5099355","58fc9094275e4c49be3f4ba6d4acc0a4",22889675,2,5,0,1934,403,406,3
"58fc9094275e4c49be3f4ba6d4acc0a4","58fc9094275e4c49be3f4ba6d4acc0a4",22889675,9,0,1,1935,406,406,0
"58fc9094275e4c49be3f4ba6d4acc0a4","687055dad9fc40c3982478fe33ec01bf",22889675,1,12,0,1936,406,414,8
"687055dad9fc40c3982478fe33ec01bf","33a9d248b2e44588a5b07fc1342b9bc2",22889675,1,-4,0,1937,414,411,-3
"687055dad9fc40c3982478fe33ec01bf","58fc9094275e4c49be3f4ba6d4acc0a4",22889675,1,-12,0,1940,414,406,-8
"6a5f020451db426dacba9e2ea3fcc62a","02b3a1bead9244c1ba2f857c7da8f82a",22889675,1,-3,0,1953,410,408,-2
"6a5f020451db426dacba9e2ea3fcc62a","3c8a22d2f9c146ea956609e3ed4f2559",22889675,1,-8,0,1964,410,405,-5
"3c8a22d2f9c146ea956609e3ed4f2559","1157bd665ec4472fb58b751dc5099355",22889675,1,-3,0,1965,405,403,-2
"2b09a08242b54983aec7063990fb3f66","02b3a1bead9244c1ba2f857c7da8f82a",22889675,3,12,0,1971,400,408,8
"02b3a1bead9244c1ba2f857c7da8f82a","1fd0f6dadbc14ebc965faf6122190b96",22889675,1,10,0,1985,408,415,7
"1fd0f6dadbc14ebc965faf6122190b96","1fd0f6dadbc14ebc965faf6122190b96",22889675,1,0,1,1986,415,415,0
"1fd0f6dadbc14ebc965faf6122190b96","687055dad9fc40c3982478fe33ec01bf",22889675,1,-1,0,1987,415,414,-1
"bec48fc2e1294c7eb3d0aca780d731b8","a2b4bd40cee2481ebd3fc179d6a5cd62",22889675,5,-4,0,1991,420,417,-3
"bec48fc2e1294c7eb3d0aca780d731b8","bec48fc2e1294c7eb3d0aca780d731b8",22889675,14,0,1,1993,420,420,0
"bec48fc2e1294c7eb3d0aca780d731b8","dbde19fcce2a4c1abdc7f685c293a23f",22889675,1,3,0,1995,420,422,2
"dbde19fcce2a4c1abdc7f685c293a23f","a24600b0e49245f6bdba8c893cfeddb0",22889675,1,4,0,1996,422,425,3
"a24600b0e49245f6bdba8c893cfeddb0","a24600b0e49245f6bdba8c893cfeddb0",22889675,8,0,1,1997,425,425,0
"a24600b0e49245f6bdba8c893cfeddb0","dbde19fcce2a4c1abdc7f685c293a23f",22889675,1,-4,0,1999,425,422,-3
"dbde19fcce2a4c1abdc7f685c293a23f","a2b4bd40cee2481ebd3fc179d6a5cd62",22889675,1,-7,0,2000,422,417,-5
"a2b4bd40cee2481ebd3fc179d6a5cd62","24cf8786024543f19b89bc20034e60d7",22889675,3,18,0,2001,417,428,11
"24cf8786024543f19b89bc20034e60d7","f2a73be2f46840b182d7bd095378004e",22889675,4,1,0,2002,428,429,1
"f2a73be2f46840b182d7bd095378004e","24cf8786024543f19b89bc20034e60d7",22889675,2,-1,0,2003,429,428,-1
"24cf8786024543f19b89bc20034e60d7","a2b4bd40cee2481ebd3fc179d6a5cd62",22889675,3,-18,0,2004,428,417,-11
"a2b4bd40cee2481ebd3fc179d6a5cd62","66baf19b6b904b70922329068c63746d",22889675,1,-59,0,2005,417,376,-41
"66baf19b6b904b70922329068c63746d","2add1669f08d4101913db15f8c23b3b7",22889675,1,56,0,2006,376,416,40
"2add1669f08d4101913db15f8c23b3b7","2b09a08242b54983aec7063990fb3f66",22889675,1,-24,0,2007,416,400,-16
"2b09a08242b54983aec7063990fb3f66","2add1669f08d4101913db15f8c23b3b7",22889675,1,24,0,2008,400,416,16
"2add1669f08d4101913db15f8c23b3b7","3c8a22d2f9c146ea956609e3ed4f2559",22889675,1,-17,0,2009,416,405,-11
"3c8a22d2f9c146ea956609e3ed4f2559","2add1669f08d4101913db15f8c23b3b7",22889675,1,17,0,2010,405,416,11
"2add1669f08d4101913db15f8c23b3b7","2add1669f08d4101913db15f8c23b3b7",22889675,2,0,1,2011,416,416,0
"2add1669f08d4101913db15f8c23b3b7","0c787d16c9504873b1a4d903cec09948",22889675,1,-140,0,2013,416,314,-102
"0c787d16c9504873b1a4d903cec09948","3434c10e561d488a914e0f7d71907abd",22889675,1,-11,0,2014,314,305,-9
"4a29443515bb404cb8924e1c60a63b73","6a9a3b5bde4a48daa896fe8c06eca56f",22889675,1,5,0,2016,285,289,4
"6a9a3b5bde4a48daa896fe8c06eca56f","4a29443515bb404cb8924e1c60a63b73",22889675,1,-5,0,2017,289,285,-4
"0c4079457ede49e3aeb5e86ed84bdf35","b8b9418ab322418d9db9b40d96af873a",22889675,1,9,0,2019,329,337,8
"b8b9418ab322418d9db9b40d96af873a","4a29443515bb404cb8924e1c60a63b73",22889675,1,-67,0,2020,337,285,-52
"4a29443515bb404cb8924e1c60a63b73","1157bd665ec4472fb58b751dc5099355",22889675,1,158,0,2021,285,403,118
"2b09a08242b54983aec7063990fb3f66","9de0d567bfa84fe5b77cb76f4a76a5d1",22889675,1,5,0,2023,400,404,4
"9de0d567bfa84fe5b77cb76f4a76a5d1","9de0d567bfa84fe5b77cb76f4a76a5d1",22889675,1,0,1,2024,404,404,0
"9de0d567bfa84fe5b77cb76f4a76a5d1","1157bd665ec4472fb58b751dc5099355",22889675,1,-1,0,2025,404,403,-1
"02b3a1bead9244c1ba2f857c7da8f82a","24cf8786024543f19b89bc20034e60d7",22889675,1,33,0,2030,408,428,20
"24cf8786024543f19b89bc20034e60d7","24cf8786024543f19b89bc20034e60d7",22889675,2,0,1,2031,428,428,0
"f2a73be2f46840b182d7bd095378004e","f2a73be2f46840b182d7bd095378004e",22889675,3,0,1,2033,429,429,0
"f2a73be2f46840b182d7bd095378004e","604551fd4266430cb860fef58fa7dd61",22889675,1,1,0,2036,429,430,1
"604551fd4266430cb860fef58fa7dd61","604551fd4266430cb860fef58fa7dd61",22889675,1,0,1,2037,430,430,0
"604551fd4266430cb860fef58fa7dd61","24cf8786024543f19b89bc20034e60d7",22889675,1,-2,0,2038,430,428,-2
"24cf8786024543f19b89bc20034e60d7","dce46f8904594a62a6377a3587aaa663",22889675,2,4,0,2039,428,431,3
"dce46f8904594a62a6377a3587aaa663","dce46f8904594a62a6377a3587aaa663",22889675,9,0,1,2040,431,431,0
"dce46f8904594a62a6377a3587aaa663","9b9d0a249052413c869753b99682b0ac",22889675,1,1,0,2041,431,432,1
"9b9d0a249052413c869753b99682b0ac","9b9d0a249052413c869753b99682b0ac",22889675,1,0,1,2042,432,432,0
"9b9d0a249052413c869753b99682b0ac","061c175cc90f45fbad883025394e78dd",22889675,1,1,0,2043,432,433,1
"061c175cc90f45fbad883025394e78dd","061c175cc90f45fbad883025394e78dd",22889675,1,0,1,2044,433,433,0
"061c175cc90f45fbad883025394e78dd","dce46f8904594a62a6377a3587aaa663",22889675,1,-2,0,2045,433,431,-2
"dce46f8904594a62a6377a3587aaa663","74a7f8712e5449c2bc0b43c6f90dafed",22889675,1,5,0,2046,431,435,4
"74a7f8712e5449c2bc0b43c6f90dafed","74a7f8712e5449c2bc0b43c6f90dafed",22889675,1,0,1,2047,435,435,0
"74a7f8712e5449c2bc0b43c6f90dafed","66ada10dde9f43018588f1ced9d477fc",22889675,1,-1,0,2048,435,434,-1
"66ada10dde9f43018588f1ced9d477fc","bf12c96466d840a69bed7020b3f18bb8",22889675,1,3,0,2049,434,436,2
"bf12c96466d840a69bed7020b3f18bb8","bf12c96466d840a69bed7020b3f18bb8",22889675,1,0,1,2050,436,436,0
"bf12c96466d840a69bed7020b3f18bb8","24cf8786024543f19b89bc20034e60d7",22889675,1,-11,0,2051,436,428,-8
"24cf8786024543f19b89bc20034e60d7","070600601c4c439288445d2f0724807d",22889675,1,14,0,2052,428,437,9
"070600601c4c439288445d2f0724807d","1823b6de7d334a7aaabc4570719af4d9",22889675,1,2,0,2053,437,439,2
"1823b6de7d334a7aaabc4570719af4d9","1823b6de7d334a7aaabc4570719af4d9",22889675,15,0,1,2054,439,439,0
"1823b6de7d334a7aaabc4570719af4d9","070600601c4c439288445d2f0724807d",22889675,1,-2,0,2069,439,437,-2
"070600601c4c439288445d2f0724807d","0380cd76a7d44bc3a4da1f15e4d68f89",22889675,1,4,0,2070,437,440,3
"0380cd76a7d44bc3a4da1f15e4d68f89","0380cd76a7d44bc3a4da1f15e4d68f89",22889675,2,0,1,2071,440,440,0
"0380cd76a7d44bc3a4da1f15e4d68f89","23b7673c8b5443108c2ef09382834a86",22889675,2,2,0,2073,440,441,1
"23b7673c8b5443108c2ef09382834a86","0380cd76a7d44bc3a4da1f15e4d68f89",22889675,1,-2,0,2074,441,440,-1
"23b7673c8b5443108c2ef09382834a86","23b7673c8b5443108c2ef09382834a86",22889675,1,0,1,2076,441,441,0
"23b7673c8b5443108c2ef09382834a86","901e92500aea43c79f19f1b279050668",22889675,2,2,0,2077,441,442,1
"901e92500aea43c79f19f1b279050668","23b7673c8b5443108c2ef09382834a86",22889675,1,-2,0,2078,442,441,-1
"901e92500aea43c79f19f1b279050668","001339db8ced4cf78829ebe8b145449d",22889675,1,1,0,2080,442,443,1
"001339db8ced4cf78829ebe8b145449d","001339db8ced4cf78829ebe8b145449d",22889675,2,0,1,2081,443,443,0
"001339db8ced4cf78829ebe8b145449d","452745e0366e42ae81561bfddebcc6c3",22889675,1,1,0,2083,443,444,1
"452745e0366e42ae81561bfddebcc6c3","452745e0366e42ae81561bfddebcc6c3",22889675,2,0,1,2084,444,444,0
"452745e0366e42ae81561bfddebcc6c3","901e92500aea43c79f19f1b279050668",22889675,1,-2,0,2086,444,442,-2
"901e92500aea43c79f19f1b279050668","4660ff2089114e8db82ceb26a4f329e3",22889675,1,4,0,2087,442,445,3
"4660ff2089114e8db82ceb26a4f329e3","4660ff2089114e8db82ceb26a4f329e3",22889675,7,0,1,2088,445,445,0
"4660ff2089114e8db82ceb26a4f329e3","7bd5586eb9d8484eb74a433ee7bfe499",22889675,2,2,0,2090,445,446,1
"7bd5586eb9d8484eb74a433ee7bfe499","4660ff2089114e8db82ceb26a4f329e3",22889675,1,-2,0,2091,446,445,-1
"7bd5586eb9d8484eb74a433ee7bfe499","7bd5586eb9d8484eb74a433ee7bfe499",22889675,10,0,1,2093,446,446,0
"7bd5586eb9d8484eb74a433ee7bfe499","070600601c4c439288445d2f0724807d",22889675,3,-14,0,2101,446,437,-9
"070600601c4c439288445d2f0724807d","b2f0d654738f48158edff28e8d3a546e",22889675,3,21,0,2102,437,449,12
"b2f0d654738f48158edff28e8d3a546e","070600601c4c439288445d2f0724807d",22889675,4,-21,0,2103,449,437,-12
"b2f0d654738f48158edff28e8d3a546e","7bd5586eb9d8484eb74a433ee7bfe499",22889675,1,-7,0,2105,449,446,-3
"7bd5586eb9d8484eb74a433ee7bfe499","8a7f26e690f34dda97be16904518ca99",22889675,2,2,0,2106,446,447,1
"8a7f26e690f34dda97be16904518ca99","7bd5586eb9d8484eb74a433ee7bfe499",22889675,1,-2,0,2107,447,446,-1
"8a7f26e690f34dda97be16904518ca99","8a7f26e690f34dda97be16904518ca99",22889675,1,0,1,2109,447,447,0
"8a7f26e690f34dda97be16904518ca99","b2f0d654738f48158edff28e8d3a546e",22889675,1,5,0,2110,447,449,2
"070600601c4c439288445d2f0724807d","f60ee41ec635499abd48168342d32c2f",22889675,3,26,0,2112,437,453,16
"f60ee41ec635499abd48168342d32c2f","f60ee41ec635499abd48168342d32c2f",22889675,73,0,1,2113,453,453,0
"f60ee41ec635499abd48168342d32c2f","b2f0d654738f48158edff28e8d3a546e",22889675,4,-5,0,2120,453,449,-4
"b2f0d654738f48158edff28e8d3a546e","b2f0d654738f48158edff28e8d3a546e",22889675,2,0,1,2121,449,449,0
"b2f0d654738f48158edff28e8d3a546e","f67fbf45a5f146ed866965bc57c7c001",22889675,2,8,0,2122,449,454,5
"f67fbf45a5f146ed866965bc57c7c001","f67fbf45a5f146ed866965bc57c7c001",22889675,2,0,1,2123,454,454,0
"f67fbf45a5f146ed866965bc57c7c001","d937afe49bd24a07a550dda1c1155122",22889675,1,1,0,2125,454,455,1
"d937afe49bd24a07a550dda1c1155122","d937afe49bd24a07a550dda1c1155122",22889675,3,0,1,2126,455,455,0
"d937afe49bd24a07a550dda1c1155122","3628b3f7823443d0912a339096b69943",22889675,1,1,0,2129,455,456,1
"3628b3f7823443d0912a339096b69943","3628b3f7823443d0912a339096b69943",22889675,1,0,1,2130,456,456,0
"3628b3f7823443d0912a339096b69943","9e049ee647cf43ecbcb5ed792a8e7588",22889675,1,1,0,2131,456,457,1
"9e049ee647cf43ecbcb5ed792a8e7588","9e049ee647cf43ecbcb5ed792a8e7588",22889675,1,0,1,2132,457,457,0
"9e049ee647cf43ecbcb5ed792a8e7588","5256a214faaf410b93f76cea06428334",22889675,1,1,0,2133,457,458,1
"5256a214faaf410b93f76cea06428334","5256a214faaf410b93f76cea06428334",22889675,1,0,1,2134,458,458,0
"5256a214faaf410b93f76cea06428334","25c32b120fce40fa9b6c85133aeb4716",22889675,1,1,0,2135,458,459,1
"25c32b120fce40fa9b6c85133aeb4716","25c32b120fce40fa9b6c85133aeb4716",22889675,1,0,1,2136,459,459,0
"25c32b120fce40fa9b6c85133aeb4716","11bc14f2204949008b7d511b933363c1",22889675,1,1,0,2137,459,460,1
"11bc14f2204949008b7d511b933363c1","11bc14f2204949008b7d511b933363c1",22889675,1,0,1,2138,460,460,0
"11bc14f2204949008b7d511b933363c1","42de338840a34d15adb66e7b14fb9d2c",22889675,1,1,0,2139,460,461,1
"42de338840a34d15adb66e7b14fb9d2c","42de338840a34d15adb66e7b14fb9d2c",22889675,1,0,1,2140,461,461,0
"42de338840a34d15adb66e7b14fb9d2c","9da37c6210b1416b8079c274f70bf600",22889675,1,1,0,2141,461,462,1
"9da37c6210b1416b8079c274f70bf600","9da37c6210b1416b8079c274f70bf600",22889675,1,0,1,2142,462,462,0
"9da37c6210b1416b8079c274f70bf600","519119f1deac45ff9ab4f13529be5c6e",22889675,1,1,0,2143,462,463,1
"519119f1deac45ff9ab4f13529be5c6e","519119f1deac45ff9ab4f13529be5c6e",22889675,1,0,1,2144,463,463,0
"519119f1deac45ff9ab4f13529be5c6e","f67fbf45a5f146ed866965bc57c7c001",22889675,1,-9,0,2145,463,454,-9
"f67fbf45a5f146ed866965bc57c7c001","c5df9f40ec14463b9dcfdc73df3e9285",22889675,4,12,0,2146,454,464,10
"c5df9f40ec14463b9dcfdc73df3e9285","c5df9f40ec14463b9dcfdc73df3e9285",22889675,3,0,1,2147,464,464,0
"c5df9f40ec14463b9dcfdc73df3e9285","83d42d95cd844fc093fc09cee250edb8",22889675,4,3,0,2149,464,465,1
"83d42d95cd844fc093fc09cee250edb8","83d42d95cd844fc093fc09cee250edb8",22889675,9,0,1,2150,465,465,0
"83d42d95cd844fc093fc09cee250edb8","b71bac264efb4abd97015447bd490db6",22889675,1,-147,0,2153,465,370,-95
"8d448d625b024c82a5eb240bbd7431d6","7bd5586eb9d8484eb74a433ee7bfe499",22889675,1,112,0,2164,374,446,72
"070600601c4c439288445d2f0724807d","7bd5586eb9d8484eb74a433ee7bfe499",22889675,2,14,0,2166,437,446,9
"7bd5586eb9d8484eb74a433ee7bfe499","b2f0d654738f48158edff28e8d3a546e",22889675,2,7,0,2168,446,449,3
"b2f0d654738f48158edff28e8d3a546e","f60ee41ec635499abd48168342d32c2f",22889675,3,5,0,2178,449,453,4
"c5df9f40ec14463b9dcfdc73df3e9285","f67fbf45a5f146ed866965bc57c7c001",22889675,2,-12,0,2182,464,454,-10
"83d42d95cd844fc093fc09cee250edb8","a2b4bd40cee2481ebd3fc179d6a5cd62",22889675,1,-76,0,2188,465,417,-48
"a2b4bd40cee2481ebd3fc179d6a5cd62","f2a73be2f46840b182d7bd095378004e",22889675,1,19,0,2191,417,429,12
"a2b4bd40cee2481ebd3fc179d6a5cd62","5d290f75e44b4bdb8256c600debbb44d",22889675,1,13,0,2194,417,426,9
"5d290f75e44b4bdb8256c600debbb44d","a24600b0e49245f6bdba8c893cfeddb0",22889675,1,-2,0,2195,426,425,-1
"a24600b0e49245f6bdba8c893cfeddb0","a2b4bd40cee2481ebd3fc179d6a5cd62",22889675,1,-11,0,2196,425,417,-8
"a2b4bd40cee2481ebd3fc179d6a5cd62","a24600b0e49245f6bdba8c893cfeddb0",22889675,2,11,0,2197,417,425,8
"a24600b0e49245f6bdba8c893cfeddb0","e34e59dce2204f228f3a84b6725df60f",22889675,1,-9,0,2199,425,419,-6
"e34e59dce2204f228f3a84b6725df60f","e34e59dce2204f228f3a84b6725df60f",22889675,1,0,1,2200,419,419,0
"e34e59dce2204f228f3a84b6725df60f","a2b4bd40cee2481ebd3fc179d6a5cd62",22889675,1,-2,0,2201,419,417,-2
"f2a73be2f46840b182d7bd095378004e","7bd5586eb9d8484eb74a433ee7bfe499",22889675,1,27,0,2209,429,446,17
"f60ee41ec635499abd48168342d32c2f","9428d8bd9c5a47b2a235b254e5e27ded",22889675,1,-1,0,2224,453,452,-1
"9428d8bd9c5a47b2a235b254e5e27ded","070600601c4c439288445d2f0724807d",22889675,1,-25,0,2225,452,437,-15
"b2f0d654738f48158edff28e8d3a546e","66baf19b6b904b70922329068c63746d",22889675,2,-112,0,2227,449,376,-73
"66baf19b6b904b70922329068c63746d","f7002c8484354eceac57bc7bd62c76c1",22889675,1,21,0,2228,376,393,17
"f7002c8484354eceac57bc7bd62c76c1","66baf19b6b904b70922329068c63746d",22889675,1,-21,0,2229,393,376,-17
"66baf19b6b904b70922329068c63746d","6f8881a745ac4c358a68b92c3b4abe81",22889675,1,22,0,2230,376,394,18
"6f8881a745ac4c358a68b92c3b4abe81","2b09a08242b54983aec7063990fb3f66",22889675,1,10,0,2235,394,400,6
"02b3a1bead9244c1ba2f857c7da8f82a","66baf19b6b904b70922329068c63746d",22889675,1,-44,0,2240,408,376,-32
"3c8a22d2f9c146ea956609e3ed4f2559","6a5f020451db426dacba9e2ea3fcc62a",22889675,1,8,0,2262,405,410,5
"6a5f020451db426dacba9e2ea3fcc62a","2b09a08242b54983aec7063990fb3f66",22889675,1,-15,0,2263,410,400,-10
"2b09a08242b54983aec7063990fb3f66","6a5f020451db426dacba9e2ea3fcc62a",22889675,1,15,0,2264,400,410,10
"6a5f020451db426dacba9e2ea3fcc62a","66baf19b6b904b70922329068c63746d",22889675,1,-47,0,2273,410,376,-34
"66baf19b6b904b70922329068c63746d","02b3a1bead9244c1ba2f857c7da8f82a",22889675,1,44,0,2274,376,408,32
"02b3a1bead9244c1ba2f857c7da8f82a","2b09a08242b54983aec7063990fb3f66",22889675,1,-12,0,2275,408,400,-8
"02b3a1bead9244c1ba2f857c7da8f82a","bec48fc2e1294c7eb3d0aca780d731b8",22889675,1,19,0,2279,408,420,12
"a24600b0e49245f6bdba8c893cfeddb0","66baf19b6b904b70922329068c63746d",22889675,1,-70,0,2300,425,376,-49
"66baf19b6b904b70922329068c63746d","24cf8786024543f19b89bc20034e60d7",22889675,2,77,0,2301,376,428,52
"f2a73be2f46840b182d7bd095378004e","66baf19b6b904b70922329068c63746d",22889675,1,-78,0,2304,429,376,-53
"dce46f8904594a62a6377a3587aaa663","66baf19b6b904b70922329068c63746d",22889675,1,-81,0,2315,431,376,-55
"66baf19b6b904b70922329068c63746d","4660ff2089114e8db82ceb26a4f329e3",22889675,1,103,0,2316,376,445,69
"4660ff2089114e8db82ceb26a4f329e3","070600601c4c439288445d2f0724807d",22889675,1,-12,0,2317,445,437,-8
"070600601c4c439288445d2f0724807d","4660ff2089114e8db82ceb26a4f329e3",22889675,2,12,0,2318,437,445,8
"4660ff2089114e8db82ceb26a4f329e3","66baf19b6b904b70922329068c63746d",22889675,2,-103,0,2320,445,376,-69
"66baf19b6b904b70922329068c63746d","b2f0d654738f48158edff28e8d3a546e",22889675,1,112,0,2321,376,449,73
"66baf19b6b904b70922329068c63746d","83d42d95cd844fc093fc09cee250edb8",22889675,1,135,0,2324,376,465,89
"83d42d95cd844fc093fc09cee250edb8","66baf19b6b904b70922329068c63746d",22889675,1,-135,0,2328,465,376,-89
"66baf19b6b904b70922329068c63746d","070600601c4c439288445d2f0724807d",22889675,1,91,0,2329,376,437,61
"66baf19b6b904b70922329068c63746d","9428d8bd9c5a47b2a235b254e5e27ded",22889675,1,116,0,2336,376,452,76
"9428d8bd9c5a47b2a235b254e5e27ded","b2f0d654738f48158edff28e8d3a546e",22889675,1,-4,0,2337,452,449,-3
"f60ee41ec635499abd48168342d32c2f","f67fbf45a5f146ed866965bc57c7c001",22889675,1,3,0,2393,453,454,1
"f67fbf45a5f146ed866965bc57c7c001","b2f0d654738f48158edff28e8d3a546e",22889675,1,-8,0,2394,454,449,-5
"b2f0d654738f48158edff28e8d3a546e","c5df9f40ec14463b9dcfdc73df3e9285",22889675,1,20,0,2395,449,464,15
"83d42d95cd844fc093fc09cee250edb8","c5df9f40ec14463b9dcfdc73df3e9285",22889675,1,-3,0,2399,465,464,-1
"83d42d95cd844fc093fc09cee250edb8","d18a9ea32855445f8736581f5cb119ce",22889675,1,-529,0,2402,465,82,-383
"d18a9ea32855445f8736581f5cb119ce","d646286c8051419bbc2e31dd1db55ca8",22889675,1,-17,0,2403,82,67,-15
"d646286c8051419bbc2e31dd1db55ca8","d18a9ea32855445f8736581f5cb119ce",22889675,1,17,0,2404,67,82,15
"d18a9ea32855445f8736581f5cb119ce","6a9f0ef185fb47f0937e29daa1c71ed5",22889675,1,10,0,2405,82,90,8
"6a9f0ef185fb47f0937e29daa1c71ed5","ae5ac430ea254e708a6f5deaaf7464ae",22889675,2,-7,0,2406,90,84,-6
"ae5ac430ea254e708a6f5deaaf7464ae","6a9f0ef185fb47f0937e29daa1c71ed5",22889675,1,7,0,2407,84,90,6
"6a9f0ef185fb47f0937e29daa1c71ed5","6a9f0ef185fb47f0937e29daa1c71ed5",22889675,4,0,1,2408,90,90,0
"6a9f0ef185fb47f0937e29daa1c71ed5","e20db35ced8544ddac5bc3839145e463",22889675,2,3,0,2409,90,91,1
"e20db35ced8544ddac5bc3839145e463","d646286c8051419bbc2e31dd1db55ca8",22889675,3,-30,0,2410,91,67,-24
"d646286c8051419bbc2e31dd1db55ca8","d646286c8051419bbc2e31dd1db55ca8",22889675,1,0,1,2411,67,67,0
"d646286c8051419bbc2e31dd1db55ca8","e20db35ced8544ddac5bc3839145e463",22889675,1,30,0,2412,67,91,24
"e20db35ced8544ddac5bc3839145e463","e20db35ced8544ddac5bc3839145e463",22889675,3,0,1,2413,91,91,0
"e20db35ced8544ddac5bc3839145e463","00ae5f0c51874a73a41ebea838d95682",22889675,7,11,0,2414,91,101,10
"00ae5f0c51874a73a41ebea838d95682","d391c8b6e56a43a7b654e9dee02d904b",22889675,6,2,0,2415,101,103,2
"b613861cecf84ffcab01afb23f660475","b613861cecf84ffcab01afb23f660475",22899445,9,0,1,1,1,1,0
"e2911e79efc2420eac45d9f671463d4b","e2911e79efc2420eac45d9f671463d4b",22899445,15,0,1,10,2,2,0
"e2911e79efc2420eac45d9f671463d4b","519d1b8c59404d67b54e96c5c8a830b2",22899445,1,1,0,11,2,3,1
"519d1b8c59404d67b54e96c5c8a830b2","519d1b8c59404d67b54e96c5c8a830b2",22899445,2,0,1,12,3,3,0
"519d1b8c59404d67b54e96c5c8a830b2","e2911e79efc2420eac45d9f671463d4b",22899445,1,-1,0,14,3,2,-1
"e2911e79efc2420eac45d9f671463d4b","531db53f81f646edb0cdcfe0085b03b7",22899445,1,2,0,15,2,4,2
"531db53f81f646edb0cdcfe0085b03b7","531db53f81f646edb0cdcfe0085b03b7",22899445,1,0,1,16,4,4,0
"531db53f81f646edb0cdcfe0085b03b7","4f5f94b2f95141e0a9d53a61da2276da",22899445,1,1,0,17,4,5,1
"4f5f94b2f95141e0a9d53a61da2276da","4f5f94b2f95141e0a9d53a61da2276da",22899445,1,0,1,18,5,5,0
"4f5f94b2f95141e0a9d53a61da2276da","6d541c89590949f99af293c4f2333f67",22899445,1,1,0,19,5,6,1
"6d541c89590949f99af293c4f2333f67","6d541c89590949f99af293c4f2333f67",22899445,1,0,1,20,6,6,0
"6d541c89590949f99af293c4f2333f67","dd5cf0b9fe4c4f1d8f5ff8e4c04879cb",22899445,1,1,0,21,6,7,1
"dd5cf0b9fe4c4f1d8f5ff8e4c04879cb","dd5cf0b9fe4c4f1d8f5ff8e4c04879cb",22899445,1,0,1,22,7,7,0
"dd5cf0b9fe4c4f1d8f5ff8e4c04879cb","f96261861edc426abe2248be4f0a709a",22899445,1,1,0,23,7,8,1
"f96261861edc426abe2248be4f0a709a","f96261861edc426abe2248be4f0a709a",22899445,2,0,1,24,8,8,0
"f96261861edc426abe2248be4f0a709a","66b5e16f4f75454fb5b8172079f0fa83",22899445,1,1,0,26,8,9,1
"66b5e16f4f75454fb5b8172079f0fa83","66b5e16f4f75454fb5b8172079f0fa83",22899445,2,0,1,27,9,9,0
"66b5e16f4f75454fb5b8172079f0fa83","0680571d4698477995e41842c36a54b2",22899445,1,1,0,29,9,10,1
"0680571d4698477995e41842c36a54b2","0680571d4698477995e41842c36a54b2",22899445,2,0,1,30,10,10,0
"0680571d4698477995e41842c36a54b2","9112f2bffece48e08c6d2287be204085",22899445,1,1,0,32,10,11,1
"9112f2bffece48e08c6d2287be204085","9112f2bffece48e08c6d2287be204085",22899445,1,0,1,33,11,11,0
"9112f2bffece48e08c6d2287be204085","e2911e79efc2420eac45d9f671463d4b",22899445,1,-9,0,34,11,2,-9
"56586aa865414f538729c7f7735d2bc6","b613861cecf84ffcab01afb23f660475",22899445,1,-15,0,37,12,1,-11
"5c5ceeee4562457ba6d41515aeebfbb1","56586aa865414f538729c7f7735d2bc6",22899445,2,-10,0,48,17,12,-5
"9afd71a5298d4333b6849dfce1b9422c","9afd71a5298d4333b6849dfce1b9422c",22899445,2,0,1,60,18,18,0
"afbf7250b99d47bea07172749483ca97","b7719e26494940efa49512aedd0aac79",22899445,3,-12,0,66,28,20,-8
"afbf7250b99d47bea07172749483ca97","4e51676dc72045d99c19b9fa7b22f8bc",22899445,2,3,0,68,28,29,1
"4e51676dc72045d99c19b9fa7b22f8bc","51970cfa30e643e894e66ae85c8024cc",22899445,2,3,0,70,29,31,2
"51970cfa30e643e894e66ae85c8024cc","4e51676dc72045d99c19b9fa7b22f8bc",22899445,2,-3,0,71,31,29,-2
"7040a13096d746ac84b8fac8d9752058","7040a13096d746ac84b8fac8d9752058",22899445,1,0,1,77,36,36,0
"9a0dc646f934470daf08c4b56ccf73db","9a0dc646f934470daf08c4b56ccf73db",22899445,1,0,1,79,37,37,0
"64d48c6c9c7940639a932219a6c87198","b534b89233134e30a9b5645138bfa9ee",22899445,2,3,0,100,40,41,1
"b534b89233134e30a9b5645138bfa9ee","67a089198fcb4e1c8f2385786c2b296f",22899445,4,-4,0,101,41,39,-2
"67a089198fcb4e1c8f2385786c2b296f","0e37b720d23b4e7f8b313e79313fd107",22899445,1,7,0,102,39,44,5
"0e37b720d23b4e7f8b313e79313fd107","0e37b720d23b4e7f8b313e79313fd107",22899445,4,0,1,103,44,44,0
"0e37b720d23b4e7f8b313e79313fd107","6875d67fdd5f48168b62719df449bebd",22899445,2,1,0,106,44,45,1
"6875d67fdd5f48168b62719df449bebd","6875d67fdd5f48168b62719df449bebd",22899445,3,0,1,107,45,45,0
"6875d67fdd5f48168b62719df449bebd","b534b89233134e30a9b5645138bfa9ee",22899445,1,-4,0,109,45,41,-4
"b534b89233134e30a9b5645138bfa9ee","6e13d61a7bdb44bca949c9f86fab3be5",22899445,5,7,0,110,41,47,6
"6e13d61a7bdb44bca949c9f86fab3be5","6e13d61a7bdb44bca949c9f86fab3be5",22899445,15,0,1,111,47,47,0
"6e13d61a7bdb44bca949c9f86fab3be5","67a089198fcb4e1c8f2385786c2b296f",22899445,1,-11,0,112,47,39,-8
"67a089198fcb4e1c8f2385786c2b296f","64d48c6c9c7940639a932219a6c87198",22899445,8,1,0,113,39,40,1
"64d48c6c9c7940639a932219a6c87198","67a089198fcb4e1c8f2385786c2b296f",22899445,4,-1,0,114,40,39,-1
"67a089198fcb4e1c8f2385786c2b296f","b534b89233134e30a9b5645138bfa9ee",22899445,5,4,0,115,39,41,2
"b534b89233134e30a9b5645138bfa9ee","0e37b720d23b4e7f8b313e79313fd107",22899445,1,3,0,116,41,44,3
"6875d67fdd5f48168b62719df449bebd","6e13d61a7bdb44bca949c9f86fab3be5",22899445,1,3,0,120,45,47,2
"6e13d61a7bdb44bca949c9f86fab3be5","b534b89233134e30a9b5645138bfa9ee",22899445,2,-7,0,121,47,41,-6
"6e13d61a7bdb44bca949c9f86fab3be5","195f78799f984cc2b06c48dfe36be751",22899445,1,2,0,124,47,49,2
"195f78799f984cc2b06c48dfe36be751","195f78799f984cc2b06c48dfe36be751",22899445,5,0,1,125,49,49,0
"195f78799f984cc2b06c48dfe36be751","d0c74f735e024943943e40333d6d337f",22899445,1,3,0,130,49,51,2
"d0c74f735e024943943e40333d6d337f","d9c8d8c444a64dadbbb508652c721e17",22899445,2,-6,0,131,51,46,-5
"d9c8d8c444a64dadbbb508652c721e17","d0c74f735e024943943e40333d6d337f",22899445,2,6,0,132,46,51,5
"d0c74f735e024943943e40333d6d337f","67a089198fcb4e1c8f2385786c2b296f",22899445,1,-16,0,133,51,39,-12
"6e13d61a7bdb44bca949c9f86fab3be5","d9c8d8c444a64dadbbb508652c721e17",22899445,1,-1,0,138,47,46,-1
"d9c8d8c444a64dadbbb508652c721e17","b534b89233134e30a9b5645138bfa9ee",22899445,1,-6,0,139,46,41,-5
"35adfa5d923046aebabfefd98f35ff05","b6f8a98476224da1b40e555ececc7ed8",22899445,1,1,0,155,54,55,1
"b6f8a98476224da1b40e555ececc7ed8","b6f8a98476224da1b40e555ececc7ed8",22899445,9,0,1,156,55,55,0
"b6f8a98476224da1b40e555ececc7ed8","86e22cb5fe0e4b47a9489ecddf7ed78f",22899445,1,1,0,165,55,56,1
"78f30e4dcac84e3cbea8b2cc6e0d62b3","a1f2f12debe5432fb7a70bcd12bacfb9",22899445,2,-1,0,172,59,58,-1
"a1f2f12debe5432fb7a70bcd12bacfb9","a1f2f12debe5432fb7a70bcd12bacfb9",22899445,37,0,1,173,58,58,0
"a1f2f12debe5432fb7a70bcd12bacfb9","b534b89233134e30a9b5645138bfa9ee",22899445,1,-20,0,203,58,41,-17
"b534b89233134e30a9b5645138bfa9ee","f924752d8a1149668870b1e7698486f7",22899445,2,11,0,204,41,50,9
"f924752d8a1149668870b1e7698486f7","b534b89233134e30a9b5645138bfa9ee",22899445,1,-11,0,205,50,41,-9
"d0c74f735e024943943e40333d6d337f","f924752d8a1149668870b1e7698486f7",22899445,1,-1,0,207,51,50,-1
"f924752d8a1149668870b1e7698486f7","a1f2f12debe5432fb7a70bcd12bacfb9",22899445,2,9,0,208,50,58,8
"a1f2f12debe5432fb7a70bcd12bacfb9","78f30e4dcac84e3cbea8b2cc6e0d62b3",22899445,2,1,0,209,58,59,1
"78f30e4dcac84e3cbea8b2cc6e0d62b3","78f30e4dcac84e3cbea8b2cc6e0d62b3",22899445,14,0,1,219,59,59,0
"78f30e4dcac84e3cbea8b2cc6e0d62b3","12aa6e1672ac4e7aa6449a7a8609cd72",22899445,1,-2,0,233,59,57,-2
"12aa6e1672ac4e7aa6449a7a8609cd72","a0a418b8540d479fa6e0f653b701da8b",22899445,1,8,0,234,57,64,7
"bc42d26810654ea9a1df1efe1e58c7d5","67a089198fcb4e1c8f2385786c2b296f",22899445,1,-30,0,236,63,39,-24
"64d48c6c9c7940639a932219a6c87198","309ccf3cc4fe429d9bfbaef53d3fa479",22899445,1,26,0,238,40,60,20
"b534b89233134e30a9b5645138bfa9ee","bc42d26810654ea9a1df1efe1e58c7d5",22899445,2,26,0,240,41,63,22
"bc42d26810654ea9a1df1efe1e58c7d5","a0a418b8540d479fa6e0f653b701da8b",22899445,2,1,0,241,63,64,1
"a0a418b8540d479fa6e0f653b701da8b","309ccf3cc4fe429d9bfbaef53d3fa479",22899445,1,-4,0,242,64,60,-4
"309ccf3cc4fe429d9bfbaef53d3fa479","309ccf3cc4fe429d9bfbaef53d3fa479",22899445,1,0,1,243,60,60,0
"a0a418b8540d479fa6e0f653b701da8b","4c943503763e4e349906eea3ed3c8e86",22899445,1,-3,0,247,64,61,-3
"4c943503763e4e349906eea3ed3c8e86","4c943503763e4e349906eea3ed3c8e86",22899445,4,0,1,248,61,61,0
"4c943503763e4e349906eea3ed3c8e86","309ccf3cc4fe429d9bfbaef53d3fa479",22899445,1,-1,0,252,61,60,-1
"309ccf3cc4fe429d9bfbaef53d3fa479","d646286c8051419bbc2e31dd1db55ca8",22899445,2,10,0,253,60,67,7
"d646286c8051419bbc2e31dd1db55ca8","b534b89233134e30a9b5645138bfa9ee",22899445,2,-33,0,255,67,41,-26
"b534b89233134e30a9b5645138bfa9ee","b534b89233134e30a9b5645138bfa9ee",22899445,1,0,1,256,41,41,0
"b534b89233134e30a9b5645138bfa9ee","267f883678b24aed855fde42524975d9",22899445,1,37,0,257,41,71,30
"267f883678b24aed855fde42524975d9","267f883678b24aed855fde42524975d9",22899445,4,0,1,258,71,71,0
"267f883678b24aed855fde42524975d9","88fff56d0342490dbef9040750a20f6c",22899445,1,1,0,262,71,72,1
"88fff56d0342490dbef9040750a20f6c","88fff56d0342490dbef9040750a20f6c",22899445,2,0,1,263,72,72,0
"88fff56d0342490dbef9040750a20f6c","adb17b12b66c4a49a85fd34322f7df70",22899445,1,1,0,265,72,73,1
"adb17b12b66c4a49a85fd34322f7df70","adb17b12b66c4a49a85fd34322f7df70",22899445,2,0,1,266,73,73,0
"adb17b12b66c4a49a85fd34322f7df70","a2becd407db34b189200a32546d9d569",22899445,1,3,0,268,73,75,2
"58c22b011d0f4c2ea6d13615edbb9eeb","dd76e1861dc9461c830888729d091ee0",22899445,1,1,0,277,77,78,1
"dd76e1861dc9461c830888729d091ee0","dd76e1861dc9461c830888729d091ee0",22899445,11,0,1,278,78,78,0
"dd76e1861dc9461c830888729d091ee0","cd1d828f1a694b87913a7ea66c23803e",22899445,1,1,0,289,78,79,1
"cd1d828f1a694b87913a7ea66c23803e","9176a3c2b4d2465fa8b0c67096c2a97e",22899445,1,1,0,293,79,80,1
"9176a3c2b4d2465fa8b0c67096c2a97e","f8ec6445f7194e25b9101d4fbcb07a18",22899445,1,1,0,306,80,81,1
"d18a9ea32855445f8736581f5cb119ce","f564483cbd7a407681aa2fcca518cf5f",22899445,1,4,0,312,82,85,3
"f564483cbd7a407681aa2fcca518cf5f","f564483cbd7a407681aa2fcca518cf5f",22899445,7,0,1,313,85,85,0
"f564483cbd7a407681aa2fcca518cf5f","18fd01350bd5434ca636d59a599d768a",22899445,1,1,0,320,85,86,1
"18fd01350bd5434ca636d59a599d768a","18fd01350bd5434ca636d59a599d768a",22899445,9,0,1,321,86,86,0
"18fd01350bd5434ca636d59a599d768a","ae5ac430ea254e708a6f5deaaf7464ae",22899445,1,-2,0,330,86,84,-2
"6a9f0ef185fb47f0937e29daa1c71ed5","c681290961c94c4caf23b529d1ae6b9a",22899445,1,-2,0,332,90,88,-2
"c681290961c94c4caf23b529d1ae6b9a","c681290961c94c4caf23b529d1ae6b9a",22899445,1,0,1,333,88,88,0
"c681290961c94c4caf23b529d1ae6b9a","6a9f0ef185fb47f0937e29daa1c71ed5",22899445,1,2,0,334,88,90,2
"6a9f0ef185fb47f0937e29daa1c71ed5","e20db35ced8544ddac5bc3839145e463",22899445,2,3,0,338,90,91,1
"e20db35ced8544ddac5bc3839145e463","e20db35ced8544ddac5bc3839145e463",22899445,4,0,1,339,91,91,0
"d646286c8051419bbc2e31dd1db55ca8","1febb706d7a34005ae8711ed49c76e64",22899445,1,33,0,342,67,94,27
"1febb706d7a34005ae8711ed49c76e64","8f73ba6f5a0042f2850356ac38ac6f24",22899445,1,1,0,346,94,95,1
"8f73ba6f5a0042f2850356ac38ac6f24","8f73ba6f5a0042f2850356ac38ac6f24",22899445,5,0,1,347,95,95,0
"8f73ba6f5a0042f2850356ac38ac6f24","e2260b86653c46d7b14a41fb419dbf8c",22899445,1,1,0,352,95,96,1
"e2260b86653c46d7b14a41fb419dbf8c","35eb641ad1d845bbba54915bce75a962",22899445,1,1,0,356,96,97,1
"35eb641ad1d845bbba54915bce75a962","35eb641ad1d845bbba54915bce75a962",22899445,7,0,1,357,97,97,0
"35eb641ad1d845bbba54915bce75a962","08be90ffbeea4795a138cd42ed8db56f",22899445,1,1,0,364,97,98,1
"08be90ffbeea4795a138cd42ed8db56f","08be90ffbeea4795a138cd42ed8db56f",22899445,5,0,1,365,98,98,0
"08be90ffbeea4795a138cd42ed8db56f","3007433c8f584dcbb5ac159c1c5f2be3",22899445,1,1,0,370,98,99,1
"e20db35ced8544ddac5bc3839145e463","00ae5f0c51874a73a41ebea838d95682",22899445,1,11,0,375,91,101,10
"00ae5f0c51874a73a41ebea838d95682","d391c8b6e56a43a7b654e9dee02d904b",22899445,5,2,0,376,101,103,2
"d391c8b6e56a43a7b654e9dee02d904b","b534b89233134e30a9b5645138bfa9ee",22899445,1,-76,0,377,103,41,-62
"d646286c8051419bbc2e31dd1db55ca8","3007433c8f584dcbb5ac159c1c5f2be3",22899445,1,38,0,379,67,99,32
"e20db35ced8544ddac5bc3839145e463","73039f8c1eb9409cb4caee2cf968001e",22899445,3,10,0,382,91,100,9
"73039f8c1eb9409cb4caee2cf968001e","e20db35ced8544ddac5bc3839145e463",22899445,2,-10,0,383,100,91,-9
"73039f8c1eb9409cb4caee2cf968001e","00ae5f0c51874a73a41ebea838d95682",22899445,2,1,0,385,100,101,1
"d391c8b6e56a43a7b654e9dee02d904b","e20db35ced8544ddac5bc3839145e463",22899445,1,-13,0,387,103,91,-12
"73039f8c1eb9409cb4caee2cf968001e","73039f8c1eb9409cb4caee2cf968001e",22899445,1,0,1,389,100,100,0
"d391c8b6e56a43a7b654e9dee02d904b","00ae5f0c51874a73a41ebea838d95682",22899445,2,-2,0,392,103,101,-2
"d391c8b6e56a43a7b654e9dee02d904b","d391c8b6e56a43a7b654e9dee02d904b",22899445,28,0,1,394,103,103,0
"00ae5f0c51874a73a41ebea838d95682","00ae5f0c51874a73a41ebea838d95682",22899445,1,0,1,423,101,101,0
"00ae5f0c51874a73a41ebea838d95682","6111116566fc4fd9abba409322bea245",22899445,1,3,0,424,101,104,3
"6111116566fc4fd9abba409322bea245","6111116566fc4fd9abba409322bea245",22899445,4,0,1,425,104,104,0
"6111116566fc4fd9abba409322bea245","a81b2235cb9c499eb9ea8ee0a8dd9725",22899445,1,1,0,429,104,105,1
"a81b2235cb9c499eb9ea8ee0a8dd9725","a81b2235cb9c499eb9ea8ee0a8dd9725",22899445,3,0,1,430,105,105,0
"a81b2235cb9c499eb9ea8ee0a8dd9725","2d4e0ab0ef3b4d73b82c72d4621a7579",22899445,1,1,0,433,105,106,1
"2d4e0ab0ef3b4d73b82c72d4621a7579","2d4e0ab0ef3b4d73b82c72d4621a7579",22899445,3,0,1,434,106,106,0
"2d4e0ab0ef3b4d73b82c72d4621a7579","8bdebf492ebd4e62b0d522e8ab5e5197",22899445,1,1,0,437,106,107,1
"8bdebf492ebd4e62b0d522e8ab5e5197","8bdebf492ebd4e62b0d522e8ab5e5197",22899445,3,0,1,438,107,107,0
"8bdebf492ebd4e62b0d522e8ab5e5197","73039f8c1eb9409cb4caee2cf968001e",22899445,1,-7,0,441,107,100,-7
"73039f8c1eb9409cb4caee2cf968001e","4280927ec4d643238aa49c32f9e06c6c",22899445,1,10,0,442,100,109,9
"4280927ec4d643238aa49c32f9e06c6c","4280927ec4d643238aa49c32f9e06c6c",22899445,1,0,1,443,109,109,0
"4280927ec4d643238aa49c32f9e06c6c","fc44e6a5f7654430af1227838224dceb",22899445,1,2,0,444,109,111,2
"fc44e6a5f7654430af1227838224dceb","fc44e6a5f7654430af1227838224dceb",22899445,3,0,1,445,111,111,0
"fc44e6a5f7654430af1227838224dceb","08111f75e22d409998cf8b85bd431f0a",22899445,1,-3,0,448,111,108,-3
"08111f75e22d409998cf8b85bd431f0a","a9ae0a3c070d455bb4369a8996313336",22899445,1,7,0,449,108,114,6
"a9ae0a3c070d455bb4369a8996313336","a9ae0a3c070d455bb4369a8996313336",22899445,1,0,1,450,114,114,0
"a9ae0a3c070d455bb4369a8996313336","71cec822bcff4f30a20e75dc63ef7b65",22899445,1,2,0,451,114,116,2
"71cec822bcff4f30a20e75dc63ef7b65","71cec822bcff4f30a20e75dc63ef7b65",22899445,7,0,1,452,116,116,0
"71cec822bcff4f30a20e75dc63ef7b65","37319e88176d4aefa91d7a9980dbae91",22899445,1,-4,0,459,116,112,-4
"37319e88176d4aefa91d7a9980dbae91","62bff51286ef4f348717a3cf6fe2318f",22899445,2,9,0,460,112,120,8
"62bff51286ef4f348717a3cf6fe2318f","3ec3a3563847406fa73338f9e9999cf3",22899445,1,-3,0,461,120,117,-3
"3ec3a3563847406fa73338f9e9999cf3","a9ae0a3c070d455bb4369a8996313336",22899445,1,-4,0,462,117,114,-3
"a9ae0a3c070d455bb4369a8996313336","37319e88176d4aefa91d7a9980dbae91",22899445,1,-2,0,463,114,112,-2
"37319e88176d4aefa91d7a9980dbae91","4280927ec4d643238aa49c32f9e06c6c",22899445,1,-4,0,464,112,109,-3
"4280927ec4d643238aa49c32f9e06c6c","d391c8b6e56a43a7b654e9dee02d904b",22899445,1,-7,0,465,109,103,-6
"d391c8b6e56a43a7b654e9dee02d904b","08111f75e22d409998cf8b85bd431f0a",22899445,1,6,0,466,103,108,5
"08111f75e22d409998cf8b85bd431f0a","00ae5f0c51874a73a41ebea838d95682",22899445,1,-8,0,467,108,101,-7
"00ae5f0c51874a73a41ebea838d95682","73039f8c1eb9409cb4caee2cf968001e",22899445,1,-1,0,468,101,100,-1
"e20db35ced8544ddac5bc3839145e463","b38af1a65bd14ea886d608e701505bcf",22899445,1,12,0,475,91,102,11
"b38af1a65bd14ea886d608e701505bcf","b38af1a65bd14ea886d608e701505bcf",22899445,1,0,1,476,102,102,0
"b38af1a65bd14ea886d608e701505bcf","00ae5f0c51874a73a41ebea838d95682",22899445,1,-1,0,477,102,101,-1
"d391c8b6e56a43a7b654e9dee02d904b","4280927ec4d643238aa49c32f9e06c6c",22899445,1,7,0,479,103,109,6
"4280927ec4d643238aa49c32f9e06c6c","73039f8c1eb9409cb4caee2cf968001e",22899445,1,-10,0,480,109,100,-9
"73039f8c1eb9409cb4caee2cf968001e","a9ae0a3c070d455bb4369a8996313336",22899445,1,16,0,481,100,114,14
"a9ae0a3c070d455bb4369a8996313336","08111f75e22d409998cf8b85bd431f0a",22899445,1,-7,0,482,114,108,-6
"08111f75e22d409998cf8b85bd431f0a","37319e88176d4aefa91d7a9980dbae91",22899445,1,5,0,483,108,112,4
"62bff51286ef4f348717a3cf6fe2318f","b1cd0e7dc3ad4a8eb91a4bfdbeb025b0",22899445,1,-2,0,485,120,118,-2
"b1cd0e7dc3ad4a8eb91a4bfdbeb025b0","b1cd0e7dc3ad4a8eb91a4bfdbeb025b0",22899445,2,0,1,486,118,118,0
"b1cd0e7dc3ad4a8eb91a4bfdbeb025b0","62bff51286ef4f348717a3cf6fe2318f",22899445,1,2,0,488,118,120,2
"62bff51286ef4f348717a3cf6fe2318f","62bff51286ef4f348717a3cf6fe2318f",22899445,3,0,1,489,120,120,0
"62bff51286ef4f348717a3cf6fe2318f","e20db35ced8544ddac5bc3839145e463",22899445,1,-33,0,492,120,91,-29
"e20db35ced8544ddac5bc3839145e463","779f9ddd1fd14d1e9e69f72219a1fdbd",22899445,1,36,0,493,91,121,30
"779f9ddd1fd14d1e9e69f72219a1fdbd","bd7c391260c74863ad031cabd6ae5cbb",22899445,1,2,0,494,121,123,2
"bd7c391260c74863ad031cabd6ae5cbb","bd7c391260c74863ad031cabd6ae5cbb",22899445,3,0,1,495,123,123,0
"bd7c391260c74863ad031cabd6ae5cbb","779f9ddd1fd14d1e9e69f72219a1fdbd",22899445,1,-2,0,498,123,121,-2
"779f9ddd1fd14d1e9e69f72219a1fdbd","779f9ddd1fd14d1e9e69f72219a1fdbd",22899445,2,0,1,499,121,121,0
"779f9ddd1fd14d1e9e69f72219a1fdbd","ae26e6cda8ad4a3f81bd347560d9579f",22899445,1,4,0,501,121,125,4
"ae26e6cda8ad4a3f81bd347560d9579f","ae26e6cda8ad4a3f81bd347560d9579f",22899445,2,0,1,502,125,125,0
"ae26e6cda8ad4a3f81bd347560d9579f","ee48df95832b4374aa273ceb27ec1315",22899445,1,1,0,504,125,126,1
"ee48df95832b4374aa273ceb27ec1315","ee48df95832b4374aa273ceb27ec1315",22899445,2,0,1,505,126,126,0
"ee48df95832b4374aa273ceb27ec1315","7a439da90b394756ad1777fc4c6dead5",22899445,1,1,0,507,126,127,1
"7a439da90b394756ad1777fc4c6dead5","7a439da90b394756ad1777fc4c6dead5",22899445,2,0,1,508,127,127,0
"7a439da90b394756ad1777fc4c6dead5","779f9ddd1fd14d1e9e69f72219a1fdbd",22899445,1,-6,0,510,127,121,-6
"779f9ddd1fd14d1e9e69f72219a1fdbd","a8dd5213034441ac92724b4e83eb0bb2",22899445,1,9,0,511,121,129,8
"a8dd5213034441ac92724b4e83eb0bb2","a8dd5213034441ac92724b4e83eb0bb2",22899445,1,0,1,512,129,129,0
"a8dd5213034441ac92724b4e83eb0bb2","8115eab6556b45f5b415c3b8c26a12e5",22899445,1,2,0,513,129,131,2
"8115eab6556b45f5b415c3b8c26a12e5","8115eab6556b45f5b415c3b8c26a12e5",22899445,3,0,1,514,131,131,0
"8115eab6556b45f5b415c3b8c26a12e5","ec34b06efd844b46a4c4818ecdb9b8f4",22899445,1,1,0,517,131,132,1
"ec34b06efd844b46a4c4818ecdb9b8f4","ec34b06efd844b46a4c4818ecdb9b8f4",22899445,3,0,1,518,132,132,0
"ec34b06efd844b46a4c4818ecdb9b8f4","779f9ddd1fd14d1e9e69f72219a1fdbd",22899445,2,-12,0,519,132,121,-11
"779f9ddd1fd14d1e9e69f72219a1fdbd","ec34b06efd844b46a4c4818ecdb9b8f4",22899445,2,12,0,520,121,132,11
"ec34b06efd844b46a4c4818ecdb9b8f4","a8dd5213034441ac92724b4e83eb0bb2",22899445,2,-3,0,525,132,129,-3
"a8dd5213034441ac92724b4e83eb0bb2","ec34b06efd844b46a4c4818ecdb9b8f4",22899445,1,3,0,526,129,132,3
"a8dd5213034441ac92724b4e83eb0bb2","c2e1c2b9eac64109b343a088584b576b",22899445,1,4,0,528,129,133,4
"c2e1c2b9eac64109b343a088584b576b","c2e1c2b9eac64109b343a088584b576b",22899445,3,0,1,529,133,133,0
"c2e1c2b9eac64109b343a088584b576b","579338175e0b4bbb8ef3b712b5d8b54e",22899445,1,-5,0,532,133,128,-5
"579338175e0b4bbb8ef3b712b5d8b54e","8bc5795d6a984a3eace4e2811e52dd4f",22899445,1,8,0,533,128,135,7
"8bc5795d6a984a3eace4e2811e52dd4f","8bc5795d6a984a3eace4e2811e52dd4f",22899445,6,0,1,534,135,135,0
"8bc5795d6a984a3eace4e2811e52dd4f","b416d47c56a742199b5d7c7f19d6503a",22899445,1,-1,0,540,135,134,-1
"b416d47c56a742199b5d7c7f19d6503a","cd4532ad48034873ba8bce2aac0c9808",22899445,1,4,0,541,134,137,3
"cd4532ad48034873ba8bce2aac0c9808","cd4532ad48034873ba8bce2aac0c9808",22899445,4,0,1,542,137,137,0
"cd4532ad48034873ba8bce2aac0c9808","df1de691dafe4549a18a4398ee9dfaf9",22899445,2,4,0,545,137,139,2
"df1de691dafe4549a18a4398ee9dfaf9","779f9ddd1fd14d1e9e69f72219a1fdbd",22899445,2,-23,0,546,139,121,-18
"779f9ddd1fd14d1e9e69f72219a1fdbd","6c5ad271a44743479bfaea29b1db8d02",22899445,2,27,0,547,121,143,22
"6c5ad271a44743479bfaea29b1db8d02","df1de691dafe4549a18a4398ee9dfaf9",22899445,1,-4,0,548,143,139,-4
"df1de691dafe4549a18a4398ee9dfaf9","df1de691dafe4549a18a4398ee9dfaf9",22899445,1,0,1,549,139,139,0
"df1de691dafe4549a18a4398ee9dfaf9","6c5ad271a44743479bfaea29b1db8d02",22899445,1,4,0,550,139,143,4
"6c5ad271a44743479bfaea29b1db8d02","6c5ad271a44743479bfaea29b1db8d02",22899445,3,0,1,551,143,143,0
"6c5ad271a44743479bfaea29b1db8d02","83d311bed5374fee83d8d67a7d9d82dc",22899445,1,1,0,554,143,144,1
"83d311bed5374fee83d8d67a7d9d82dc","83d311bed5374fee83d8d67a7d9d82dc",22899445,2,0,1,555,144,144,0
"83d311bed5374fee83d8d67a7d9d82dc","402bba41861d43acb52a5abb89e8831e",22899445,1,1,0,557,144,145,1
"402bba41861d43acb52a5abb89e8831e","402bba41861d43acb52a5abb89e8831e",22899445,5,0,1,558,145,145,0
"402bba41861d43acb52a5abb89e8831e","df1de691dafe4549a18a4398ee9dfaf9",22899445,2,-6,0,561,145,139,-6
"df1de691dafe4549a18a4398ee9dfaf9","8aae34f5ddbb4052a709b12e6b0d40fa",22899445,2,9,0,562,139,147,8
"8aae34f5ddbb4052a709b12e6b0d40fa","8aae34f5ddbb4052a709b12e6b0d40fa",22899445,2,0,1,563,147,147,0
"8aae34f5ddbb4052a709b12e6b0d40fa","645b3f0249f64f76af2e19eb4d0e55b7",22899445,1,2,0,565,147,149,2
"645b3f0249f64f76af2e19eb4d0e55b7","645b3f0249f64f76af2e19eb4d0e55b7",22899445,10,0,1,566,149,149,0
"645b3f0249f64f76af2e19eb4d0e55b7","7e7b8db5064d4369805ab370aac5ddfb",22899445,1,1,0,576,149,150,1
"7e7b8db5064d4369805ab370aac5ddfb","7e7b8db5064d4369805ab370aac5ddfb",22899445,3,0,1,577,150,150,0
"7e7b8db5064d4369805ab370aac5ddfb","8956d210ae7f41968fada86d4c979d6a",22899445,1,1,0,580,150,151,1
"8956d210ae7f41968fada86d4c979d6a","8956d210ae7f41968fada86d4c979d6a",22899445,5,0,1,581,151,151,0
"8956d210ae7f41968fada86d4c979d6a","f902b0f41b544d4dbf79664fd233648d",22899445,1,-5,0,586,151,146,-5
"f902b0f41b544d4dbf79664fd233648d","ae781e8b775e4ccd93bc800dad5c8376",22899445,1,8,0,587,146,153,7
"ae781e8b775e4ccd93bc800dad5c8376","ae781e8b775e4ccd93bc800dad5c8376",22899445,3,0,1,588,153,153,0
"ae781e8b775e4ccd93bc800dad5c8376","06882a8492d9499aa31555567f575ecb",22899445,1,1,0,591,153,154,1
"06882a8492d9499aa31555567f575ecb","06882a8492d9499aa31555567f575ecb",22899445,2,0,1,592,154,154,0
"06882a8492d9499aa31555567f575ecb","f293c508f409466a8f27ddd7d1e40b20",22899445,1,1,0,594,154,155,1
"f293c508f409466a8f27ddd7d1e40b20","f293c508f409466a8f27ddd7d1e40b20",22899445,3,0,1,595,155,155,0
"f293c508f409466a8f27ddd7d1e40b20","cc4ddef5bbbe48ebb605141b347c4ed1",22899445,1,1,0,598,155,156,1
"cc4ddef5bbbe48ebb605141b347c4ed1","cc4ddef5bbbe48ebb605141b347c4ed1",22899445,6,0,1,599,156,156,0
"cc4ddef5bbbe48ebb605141b347c4ed1","d313cec988a84645bee413e8d4724a4b",22899445,1,3,0,605,156,158,2
"d313cec988a84645bee413e8d4724a4b","f03480cf4eba413194d7af52fc0e7f28",22899445,1,-7,0,606,158,152,-6
"f03480cf4eba413194d7af52fc0e7f28","dc60696c76a74368a60f72246e47700d",22899445,1,8,0,607,152,159,7
"dc60696c76a74368a60f72246e47700d","dc60696c76a74368a60f72246e47700d",22899445,2,0,1,608,159,159,0
"dc60696c76a74368a60f72246e47700d","df1de691dafe4549a18a4398ee9dfaf9",22899445,1,-23,0,610,159,139,-20
"df1de691dafe4549a18a4398ee9dfaf9","78adeee1fa2c4fe0bc73f7bca9fcee86",22899445,2,26,0,611,139,160,21
"78adeee1fa2c4fe0bc73f7bca9fcee86","df1de691dafe4549a18a4398ee9dfaf9",22899445,1,-26,0,612,160,139,-21
"78adeee1fa2c4fe0bc73f7bca9fcee86","65202579580f4ad38d734b4ee39d22a8",22899445,20,5,0,614,160,164,4
"65202579580f4ad38d734b4ee39d22a8","65202579580f4ad38d734b4ee39d22a8",22899445,185,0,1,615,164,164,0
"65202579580f4ad38d734b4ee39d22a8","78adeee1fa2c4fe0bc73f7bca9fcee86",22899445,11,-5,0,619,164,160,-4
"65202579580f4ad38d734b4ee39d22a8","df1de691dafe4549a18a4398ee9dfaf9",22899445,1,-31,0,623,164,139,-25
"df1de691dafe4549a18a4398ee9dfaf9","3cbcea2be0984e7dbd5a48195af10ce7",22899445,1,34,0,624,139,165,26
"3cbcea2be0984e7dbd5a48195af10ce7","3cbcea2be0984e7dbd5a48195af10ce7",22899445,4,0,1,625,165,165,0
"82e6285962b8400d9d6fc32436022a94","67a089198fcb4e1c8f2385786c2b296f",22899445,5,-162,0,627,167,39,-128
"67a089198fcb4e1c8f2385786c2b296f","78adeee1fa2c4fe0bc73f7bca9fcee86",22899445,2,152,0,629,39,160,121
"78adeee1fa2c4fe0bc73f7bca9fcee86","78adeee1fa2c4fe0bc73f7bca9fcee86",22899445,8,0,1,630,160,160,0
"65202579580f4ad38d734b4ee39d22a8","3cbcea2be0984e7dbd5a48195af10ce7",22899445,9,3,0,664,164,165,1
"3cbcea2be0984e7dbd5a48195af10ce7","26836bccf4174cc5af819c2e237f9300",22899445,1,1,0,665,165,166,1
"26836bccf4174cc5af819c2e237f9300","26836bccf4174cc5af819c2e237f9300",22899445,5,0,1,666,166,166,0
"26836bccf4174cc5af819c2e237f9300","82e6285962b8400d9d6fc32436022a94",22899445,1,1,0,669,166,167,1
"82e6285962b8400d9d6fc32436022a94","26836bccf4174cc5af819c2e237f9300",22899445,1,-1,0,670,167,166,-1
"26836bccf4174cc5af819c2e237f9300","3cbcea2be0984e7dbd5a48195af10ce7",22899445,2,-1,0,672,166,165,-1
"78adeee1fa2c4fe0bc73f7bca9fcee86","3cbcea2be0984e7dbd5a48195af10ce7",22899445,6,8,0,689,160,165,5
"67a089198fcb4e1c8f2385786c2b296f","56586aa865414f538729c7f7735d2bc6",22899445,1,-57,0,692,39,12,-27
"3f1c815879794b929260d224becaff7e","5c5ceeee4562457ba6d41515aeebfbb1",22899445,1,6,0,700,14,17,3
"5c5ceeee4562457ba6d41515aeebfbb1","81c864a886d54a6b8ff85f7d736f4f95",22899445,1,-4,0,701,17,15,-2
"81c864a886d54a6b8ff85f7d736f4f95","56586aa865414f538729c7f7735d2bc6",22899445,1,-6,0,702,15,12,-3
"b7719e26494940efa49512aedd0aac79","b7719e26494940efa49512aedd0aac79",22899445,1,0,1,709,20,20,0
"afbf7250b99d47bea07172749483ca97","afbf7250b99d47bea07172749483ca97",22899445,1,0,1,711,28,28,0
"b7719e26494940efa49512aedd0aac79","26836bccf4174cc5af819c2e237f9300",22899445,1,201,0,713,20,166,146
"67a089198fcb4e1c8f2385786c2b296f","f661500307d74c908e9207d949ceb4aa",22899445,1,121,0,718,39,136,97
"f661500307d74c908e9207d949ceb4aa","779f9ddd1fd14d1e9e69f72219a1fdbd",22899445,1,-18,0,719,136,121,-15
"779f9ddd1fd14d1e9e69f72219a1fdbd","f661500307d74c908e9207d949ceb4aa",22899445,1,18,0,720,121,136,15
"f661500307d74c908e9207d949ceb4aa","cd4532ad48034873ba8bce2aac0c9808",22899445,1,1,0,721,136,137,1
"6c5ad271a44743479bfaea29b1db8d02","402bba41861d43acb52a5abb89e8831e",22899445,1,2,0,726,143,145,2
"8aae34f5ddbb4052a709b12e6b0d40fa","78adeee1fa2c4fe0bc73f7bca9fcee86",22899445,1,17,0,731,147,160,13
"3cbcea2be0984e7dbd5a48195af10ce7","78adeee1fa2c4fe0bc73f7bca9fcee86",22899445,9,-8,0,744,165,160,-5
"78adeee1fa2c4fe0bc73f7bca9fcee86","82e6285962b8400d9d6fc32436022a94",22899445,8,10,0,745,160,167,7
"82e6285962b8400d9d6fc32436022a94","3cbcea2be0984e7dbd5a48195af10ce7",22899445,3,-2,0,746,167,165,-2
"64d48c6c9c7940639a932219a6c87198","78adeee1fa2c4fe0bc73f7bca9fcee86",22899445,1,151,0,753,40,160,120
"82e6285962b8400d9d6fc32436022a94","78adeee1fa2c4fe0bc73f7bca9fcee86",22899445,7,-10,0,766,167,160,-7
"65202579580f4ad38d734b4ee39d22a8","a9ac840f098c4bd0a2ee896214ce29cd",22899445,1,8,0,776,164,168,4
"a9ac840f098c4bd0a2ee896214ce29cd","a9ac840f098c4bd0a2ee896214ce29cd",22899445,5,0,1,777,168,168,0
"a9ac840f098c4bd0a2ee896214ce29cd","0c7262dff33c4087bc660ccf40f92f9c",22899445,3,4,0,780,168,169,1
"0c7262dff33c4087bc660ccf40f92f9c","a9ac840f098c4bd0a2ee896214ce29cd",22899445,2,-4,0,781,169,168,-1
"a9ac840f098c4bd0a2ee896214ce29cd","b2275c3fad834f8d90737a2d9a6927d6",22899445,1,7,0,782,168,172,4
"b2275c3fad834f8d90737a2d9a6927d6","a9ac840f098c4bd0a2ee896214ce29cd",22899445,1,-7,0,783,172,168,-4
"a9ac840f098c4bd0a2ee896214ce29cd","67a089198fcb4e1c8f2385786c2b296f",22899445,2,-165,0,785,168,39,-129
"67a089198fcb4e1c8f2385786c2b296f","8959e6304a0348309a771e4d08d1b64a",22899445,1,156,0,786,39,163,124
"8959e6304a0348309a771e4d08d1b64a","78adeee1fa2c4fe0bc73f7bca9fcee86",22899445,1,-4,0,787,163,160,-3
"78adeee1fa2c4fe0bc73f7bca9fcee86","8959e6304a0348309a771e4d08d1b64a",22899445,1,4,0,788,160,163,3
"8959e6304a0348309a771e4d08d1b64a","65202579580f4ad38d734b4ee39d22a8",22899445,1,1,0,789,163,164,1
"82e6285962b8400d9d6fc32436022a94","a9ac840f098c4bd0a2ee896214ce29cd",22899445,1,3,0,801,167,168,1
"a9ac840f098c4bd0a2ee896214ce29cd","78adeee1fa2c4fe0bc73f7bca9fcee86",22899445,1,-13,0,804,168,160,-8
"78adeee1fa2c4fe0bc73f7bca9fcee86","b534b89233134e30a9b5645138bfa9ee",22899445,1,-148,0,828,160,41,-119
"f924752d8a1149668870b1e7698486f7","d0c74f735e024943943e40333d6d337f",22899445,1,1,0,830,50,51,1
"d0c74f735e024943943e40333d6d337f","78adeee1fa2c4fe0bc73f7bca9fcee86",22899445,1,136,0,831,51,160,109
"3cbcea2be0984e7dbd5a48195af10ce7","65202579580f4ad38d734b4ee39d22a8",22899445,1,-3,0,848,165,164,-1
"3cbcea2be0984e7dbd5a48195af10ce7","a9ac840f098c4bd0a2ee896214ce29cd",22899445,2,5,0,913,165,168,3
"67a089198fcb4e1c8f2385786c2b296f","a49d1bb4328949299686242fd0be5584",22899445,1,-38,0,915,39,21,-18
"a49d1bb4328949299686242fd0be5584","a49d1bb4328949299686242fd0be5584",22899445,1,0,1,916,21,21,0
"b7719e26494940efa49512aedd0aac79","4e51676dc72045d99c19b9fa7b22f8bc",22899445,1,15,0,920,20,29,9
"4e51676dc72045d99c19b9fa7b22f8bc","afbf7250b99d47bea07172749483ca97",22899445,1,-3,0,921,29,28,-1
"c33c17be71ae4d588da7369472e5bb1b","c33c17be71ae4d588da7369472e5bb1b",22899445,1,0,1,926,34,34,0
"93679be414554a11b1893002f2229a93","93679be414554a11b1893002f2229a93",22899445,1,0,1,928,35,35,0
"7040a13096d746ac84b8fac8d9752058","78adeee1fa2c4fe0bc73f7bca9fcee86",22899445,1,162,0,930,36,160,124
"b2275c3fad834f8d90737a2d9a6927d6","e2911e79efc2420eac45d9f671463d4b",22899445,1,-241,0,997,172,2,-170
"e2911e79efc2420eac45d9f671463d4b","b613861cecf84ffcab01afb23f660475",22899445,3,-3,0,1001,2,1,-1
"b613861cecf84ffcab01afb23f660475","e2911e79efc2420eac45d9f671463d4b",22899445,3,3,0,1002,1,2,1
"b613861cecf84ffcab01afb23f660475","56586aa865414f538729c7f7735d2bc6",22899445,2,15,0,1004,1,12,11
"56586aa865414f538729c7f7735d2bc6","e2911e79efc2420eac45d9f671463d4b",22899445,5,-12,0,1005,12,2,-10
"e2911e79efc2420eac45d9f671463d4b","56586aa865414f538729c7f7735d2bc6",22899445,7,12,0,1006,2,12,10
"56586aa865414f538729c7f7735d2bc6","b7f2b31585d94eb3bf86376714aa7070",22899445,14,2,0,1009,12,13,1
"b7f2b31585d94eb3bf86376714aa7070","56586aa865414f538729c7f7735d2bc6",22899445,7,-2,0,1010,13,12,-1
"b7f2b31585d94eb3bf86376714aa7070","3f1c815879794b929260d224becaff7e",22899445,7,2,0,1012,13,14,1
"3f1c815879794b929260d224becaff7e","81c864a886d54a6b8ff85f7d736f4f95",22899445,4,2,0,1013,14,15,1
"81c864a886d54a6b8ff85f7d736f4f95","5c5ceeee4562457ba6d41515aeebfbb1",22899445,4,4,0,1014,15,17,2
"5c5ceeee4562457ba6d41515aeebfbb1","e2911e79efc2420eac45d9f671463d4b",22899445,1,-22,0,1015,17,2,-15
"3f1c815879794b929260d224becaff7e","b613861cecf84ffcab01afb23f660475",22899445,1,-19,0,1027,14,1,-13
"b613861cecf84ffcab01afb23f660475","140d5b27b8574befad82c0a013b59dfa",22899445,1,117,0,1029,1,74,73
"140d5b27b8574befad82c0a013b59dfa","d646286c8051419bbc2e31dd1db55ca8",22899445,2,-8,0,1030,74,67,-7
"d646286c8051419bbc2e31dd1db55ca8","a2becd407db34b189200a32546d9d569",22899445,4,9,0,1031,67,75,8
"a2becd407db34b189200a32546d9d569","a2becd407db34b189200a32546d9d569",22899445,3,0,1,1032,75,75,0
"a2becd407db34b189200a32546d9d569","58c22b011d0f4c2ea6d13615edbb9eeb",22899445,2,2,0,1033,75,77,2
"58c22b011d0f4c2ea6d13615edbb9eeb","58c22b011d0f4c2ea6d13615edbb9eeb",22899445,12,0,1,1034,77,77,0
"58c22b011d0f4c2ea6d13615edbb9eeb","cd1d828f1a694b87913a7ea66c23803e",22899445,1,2,0,1041,77,79,2
"cd1d828f1a694b87913a7ea66c23803e","cd1d828f1a694b87913a7ea66c23803e",22899445,8,0,1,1042,79,79,0
"cd1d828f1a694b87913a7ea66c23803e","f8ec6445f7194e25b9101d4fbcb07a18",22899445,1,2,0,1045,79,81,2
"f8ec6445f7194e25b9101d4fbcb07a18","f8ec6445f7194e25b9101d4fbcb07a18",22899445,8,0,1,1046,81,81,0
"f8ec6445f7194e25b9101d4fbcb07a18","140d5b27b8574befad82c0a013b59dfa",22899445,2,-7,0,1049,81,74,-7
"a2becd407db34b189200a32546d9d569","d646286c8051419bbc2e31dd1db55ca8",22899445,2,-9,0,1052,75,67,-8
"a2becd407db34b189200a32546d9d569","b534b89233134e30a9b5645138bfa9ee",22899445,1,-42,0,1054,75,41,-34
"b534b89233134e30a9b5645138bfa9ee","d0c74f735e024943943e40333d6d337f",22899445,3,12,0,1055,41,51,10
"d0c74f735e024943943e40333d6d337f","d0c74f735e024943943e40333d6d337f",22899445,17,0,1,1056,51,51,0
"d0c74f735e024943943e40333d6d337f","983f8ff320594b279a7f4a6fe132f9c5",22899445,2,2,0,1057,51,53,2
"983f8ff320594b279a7f4a6fe132f9c5","983f8ff320594b279a7f4a6fe132f9c5",22899445,9,0,1,1058,53,53,0
"983f8ff320594b279a7f4a6fe132f9c5","35adfa5d923046aebabfefd98f35ff05",22899445,2,1,0,1064,53,54,1
"35adfa5d923046aebabfefd98f35ff05","35adfa5d923046aebabfefd98f35ff05",22899445,9,0,1,1065,54,54,0
"35adfa5d923046aebabfefd98f35ff05","86e22cb5fe0e4b47a9489ecddf7ed78f",22899445,1,2,0,1067,54,56,2
"86e22cb5fe0e4b47a9489ecddf7ed78f","86e22cb5fe0e4b47a9489ecddf7ed78f",22899445,10,0,1,1068,56,56,0
"86e22cb5fe0e4b47a9489ecddf7ed78f","a1f2f12debe5432fb7a70bcd12bacfb9",22899445,2,3,0,1075,56,58,2
"a1f2f12debe5432fb7a70bcd12bacfb9","f924752d8a1149668870b1e7698486f7",22899445,2,-9,0,1076,58,50,-8
"f924752d8a1149668870b1e7698486f7","78f30e4dcac84e3cbea8b2cc6e0d62b3",22899445,2,10,0,1077,50,59,9
"78f30e4dcac84e3cbea8b2cc6e0d62b3","a0a418b8540d479fa6e0f653b701da8b",22899445,1,6,0,1078,59,64,5
"a0a418b8540d479fa6e0f653b701da8b","bc42d26810654ea9a1df1efe1e58c7d5",22899445,3,-1,0,1079,64,63,-1
"bc42d26810654ea9a1df1efe1e58c7d5","12aa6e1672ac4e7aa6449a7a8609cd72",22899445,2,-7,0,1080,63,57,-6
"12aa6e1672ac4e7aa6449a7a8609cd72","309ccf3cc4fe429d9bfbaef53d3fa479",22899445,2,4,0,1081,57,60,3
"309ccf3cc4fe429d9bfbaef53d3fa479","b534b89233134e30a9b5645138bfa9ee",22899445,3,-23,0,1082,60,41,-19
"b534b89233134e30a9b5645138bfa9ee","d646286c8051419bbc2e31dd1db55ca8",22899445,3,33,0,1083,41,67,26
"d646286c8051419bbc2e31dd1db55ca8","d646286c8051419bbc2e31dd1db55ca8",22899445,3,0,1,1084,67,67,0
"d646286c8051419bbc2e31dd1db55ca8","140d5b27b8574befad82c0a013b59dfa",22899445,2,8,0,1085,67,74,7
"140d5b27b8574befad82c0a013b59dfa","a2becd407db34b189200a32546d9d569",22899445,2,1,0,1086,74,75,1
"a2becd407db34b189200a32546d9d569","f8ec6445f7194e25b9101d4fbcb07a18",22899445,1,6,0,1087,75,81,6
"f8ec6445f7194e25b9101d4fbcb07a18","9176a3c2b4d2465fa8b0c67096c2a97e",22899445,1,-1,0,1090,81,80,-1
"9176a3c2b4d2465fa8b0c67096c2a97e","9176a3c2b4d2465fa8b0c67096c2a97e",22899445,23,0,1,1091,80,80,0
"9176a3c2b4d2465fa8b0c67096c2a97e","cd1d828f1a694b87913a7ea66c23803e",22899445,1,-1,0,1102,80,79,-1
"cd1d828f1a694b87913a7ea66c23803e","58c22b011d0f4c2ea6d13615edbb9eeb",22899445,1,-2,0,1105,79,77,-2
"58c22b011d0f4c2ea6d13615edbb9eeb","140d5b27b8574befad82c0a013b59dfa",22899445,1,-3,0,1108,77,74,-3
"140d5b27b8574befad82c0a013b59dfa","d18a9ea32855445f8736581f5cb119ce",22899445,2,9,0,1109,74,82,8
"d18a9ea32855445f8736581f5cb119ce","ae5ac430ea254e708a6f5deaaf7464ae",22899445,1,3,0,1110,82,84,2
"ae5ac430ea254e708a6f5deaaf7464ae","6a9f0ef185fb47f0937e29daa1c71ed5",22899445,2,7,0,1111,84,90,6
"6a9f0ef185fb47f0937e29daa1c71ed5","6a9f0ef185fb47f0937e29daa1c71ed5",22899445,9,0,1,1112,90,90,0
"6a9f0ef185fb47f0937e29daa1c71ed5","d646286c8051419bbc2e31dd1db55ca8",22899445,1,-27,0,1114,90,67,-23
"d646286c8051419bbc2e31dd1db55ca8","e20db35ced8544ddac5bc3839145e463",22899445,1,30,0,1115,67,91,24
"e20db35ced8544ddac5bc3839145e463","1febb706d7a34005ae8711ed49c76e64",22899445,1,3,0,1116,91,94,3
"1febb706d7a34005ae8711ed49c76e64","1febb706d7a34005ae8711ed49c76e64",22899445,5,0,1,1117,94,94,0
"1febb706d7a34005ae8711ed49c76e64","e2260b86653c46d7b14a41fb419dbf8c",22899445,1,2,0,1119,94,96,2
"e2260b86653c46d7b14a41fb419dbf8c","e2260b86653c46d7b14a41fb419dbf8c",22899445,5,0,1,1120,96,96,0
"e2260b86653c46d7b14a41fb419dbf8c","3007433c8f584dcbb5ac159c1c5f2be3",22899445,1,3,0,1122,96,99,3
"3007433c8f584dcbb5ac159c1c5f2be3","3007433c8f584dcbb5ac159c1c5f2be3",22899445,6,0,1,1123,99,99,0
"3007433c8f584dcbb5ac159c1c5f2be3","e20db35ced8544ddac5bc3839145e463",22899445,3,-8,0,1125,99,91,-8
"e20db35ced8544ddac5bc3839145e463","d646286c8051419bbc2e31dd1db55ca8",22899445,3,-30,0,1126,91,67,-24
"d646286c8051419bbc2e31dd1db55ca8","6a9f0ef185fb47f0937e29daa1c71ed5",22899445,2,27,0,1127,67,90,23
"6a9f0ef185fb47f0937e29daa1c71ed5","56586aa865414f538729c7f7735d2bc6",22899445,1,-121,0,1130,90,12,-78
"56586aa865414f538729c7f7735d2bc6","56586aa865414f538729c7f7735d2bc6",22899445,32,0,1,1131,12,12,0
"5c5ceeee4562457ba6d41515aeebfbb1","9afd71a5298d4333b6849dfce1b9422c",22899445,1,3,0,1139,17,18,1
"9afd71a5298d4333b6849dfce1b9422c","56586aa865414f538729c7f7735d2bc6",22899445,2,-13,0,1140,18,12,-6
"56586aa865414f538729c7f7735d2bc6","9afd71a5298d4333b6849dfce1b9422c",22899445,4,13,0,1141,12,18,6
"9afd71a5298d4333b6849dfce1b9422c","b7719e26494940efa49512aedd0aac79",22899445,4,4,0,1142,18,20,2
"b7719e26494940efa49512aedd0aac79","d4f45188d3c84a02ba08454e6403a818",22899445,4,5,0,1143,20,24,4
"d4f45188d3c84a02ba08454e6403a818","d4c3b003e8274e429d2fa688d73fde6d",22899445,4,-2,0,1144,24,22,-2
"d4c3b003e8274e429d2fa688d73fde6d","b7719e26494940efa49512aedd0aac79",22899445,3,-3,0,1145,22,20,-2
"d4c3b003e8274e429d2fa688d73fde6d","9afd71a5298d4333b6849dfce1b9422c",22899445,1,-7,0,1148,22,18,-4
"b7719e26494940efa49512aedd0aac79","b3323dfcc2d246d599e1c43b6be7751c",22899445,2,4,0,1150,20,23,3
"b3323dfcc2d246d599e1c43b6be7751c","b3323dfcc2d246d599e1c43b6be7751c",22899445,2,0,1,1151,23,23,0
"b3323dfcc2d246d599e1c43b6be7751c","0c7262dff33c4087bc660ccf40f92f9c",22899445,1,205,0,1152,23,169,146
"0c7262dff33c4087bc660ccf40f92f9c","b2275c3fad834f8d90737a2d9a6927d6",22899445,5,3,0,1153,169,172,3
"b2275c3fad834f8d90737a2d9a6927d6","b7719e26494940efa49512aedd0aac79",22899445,1,-212,0,1154,172,20,-152
"b3323dfcc2d246d599e1c43b6be7751c","b7719e26494940efa49512aedd0aac79",22899445,1,-4,0,1157,23,20,-3
"b7719e26494940efa49512aedd0aac79","afbf7250b99d47bea07172749483ca97",22899445,5,12,0,1158,20,28,8
"afbf7250b99d47bea07172749483ca97","0c7262dff33c4087bc660ccf40f92f9c",22899445,1,197,0,1159,28,169,141
"b2275c3fad834f8d90737a2d9a6927d6","0c7262dff33c4087bc660ccf40f92f9c",22899445,2,-3,0,1161,172,169,-3
"0c7262dff33c4087bc660ccf40f92f9c","78adeee1fa2c4fe0bc73f7bca9fcee86",22899445,1,-17,0,1162,169,160,-9
"78adeee1fa2c4fe0bc73f7bca9fcee86","b2275c3fad834f8d90737a2d9a6927d6",22899445,1,20,0,1163,160,172,12
"b2275c3fad834f8d90737a2d9a6927d6","b2275c3fad834f8d90737a2d9a6927d6",22899445,20,0,1,1164,172,172,0
"b2275c3fad834f8d90737a2d9a6927d6","eb515a26030b41f8a82a1e6114420bad",22899445,2,1,0,1184,172,173,1
"eb515a26030b41f8a82a1e6114420bad","eb515a26030b41f8a82a1e6114420bad",22899445,10,0,1,1185,173,173,0
"eb515a26030b41f8a82a1e6114420bad","0c7262dff33c4087bc660ccf40f92f9c",22899445,3,-4,0,1190,173,169,-4
"0c7262dff33c4087bc660ccf40f92f9c","b42cc17b7de840f181a704558d0bc845",22899445,2,7,0,1196,169,175,6
"b42cc17b7de840f181a704558d0bc845","b42cc17b7de840f181a704558d0bc845",22899445,11,0,1,1197,175,175,0
"b42cc17b7de840f181a704558d0bc845","801f9e9135034f49bf5f8b4bdefedb41",22899445,2,2,0,1208,175,177,2
"801f9e9135034f49bf5f8b4bdefedb41","801f9e9135034f49bf5f8b4bdefedb41",22899445,15,0,1,1209,177,177,0
"801f9e9135034f49bf5f8b4bdefedb41","362fcb0699a14845ab29b2340093e528",22899445,1,-3,0,1224,177,174,-3
"362fcb0699a14845ab29b2340093e528","ea38cc0e6e6e41edbabf210220808bf9",22899445,1,6,0,1225,174,179,5
"ea38cc0e6e6e41edbabf210220808bf9","b87c552dd247427abe6ab5795b9c9d43",22899445,3,2,0,1226,179,181,2
"b87c552dd247427abe6ab5795b9c9d43","ea38cc0e6e6e41edbabf210220808bf9",22899445,2,-2,0,1227,181,179,-2
"ea38cc0e6e6e41edbabf210220808bf9","ea38cc0e6e6e41edbabf210220808bf9",22899445,9,0,1,1228,179,179,0
"b87c552dd247427abe6ab5795b9c9d43","b87c552dd247427abe6ab5795b9c9d43",22899445,19,0,1,1232,181,181,0
"b87c552dd247427abe6ab5795b9c9d43","139b097acfca451689d80c9c6eebdf7b",22899445,1,-3,0,1251,181,178,-3
"139b097acfca451689d80c9c6eebdf7b","2024b4885bd14338a39b7b509acbbd02",22899445,1,5,0,1252,178,182,4
"2024b4885bd14338a39b7b509acbbd02","ea38cc0e6e6e41edbabf210220808bf9",22899445,1,-4,0,1253,182,179,-3
"ea38cc0e6e6e41edbabf210220808bf9","139b097acfca451689d80c9c6eebdf7b",22899445,1,-1,0,1262,179,178,-1
"139b097acfca451689d80c9c6eebdf7b","30f660a1feb34582a739722532524f79",22899445,1,6,0,1263,178,183,5
"30f660a1feb34582a739722532524f79","30f660a1feb34582a739722532524f79",22899445,10,0,1,1264,183,183,0
"30f660a1feb34582a739722532524f79","2024b4885bd14338a39b7b509acbbd02",22899445,1,-1,0,1274,183,182,-1
"2024b4885bd14338a39b7b509acbbd02","c3f63fe50d8e487c86bf8ef76c9cadd3",22899445,1,4,0,1275,182,185,3
"c3f63fe50d8e487c86bf8ef76c9cadd3","c3f63fe50d8e487c86bf8ef76c9cadd3",22899445,6,0,1,1276,185,185,0
"c3f63fe50d8e487c86bf8ef76c9cadd3","0c7262dff33c4087bc660ccf40f92f9c",22899445,1,-20,0,1282,185,169,-16
"0c7262dff33c4087bc660ccf40f92f9c","c8e371568a0c4391b25796ae4e91952e",22899445,4,23,0,1283,169,186,17
"c8e371568a0c4391b25796ae4e91952e","7d932b23e1c84326ae5aa4d3c0d813d1",22899445,1,2,0,1284,186,188,2
"7d932b23e1c84326ae5aa4d3c0d813d1","7d932b23e1c84326ae5aa4d3c0d813d1",22899445,12,0,1,1285,188,188,0
"7d932b23e1c84326ae5aa4d3c0d813d1","c8e371568a0c4391b25796ae4e91952e",22899445,1,-2,0,1297,188,186,-2
"c8e371568a0c4391b25796ae4e91952e","ab11d94c6c8948ea90b88f19d2cd502b",22899445,3,5,0,1298,186,190,4
"ab11d94c6c8948ea90b88f19d2cd502b","ab11d94c6c8948ea90b88f19d2cd502b",22899445,4,0,1,1299,190,190,0
"ab11d94c6c8948ea90b88f19d2cd502b","f992451ed6ad4e68bb9e68ad6be7c4be",22899445,1,2,0,1303,190,192,2
"f992451ed6ad4e68bb9e68ad6be7c4be","f992451ed6ad4e68bb9e68ad6be7c4be",22899445,5,0,1,1304,192,192,0
"f992451ed6ad4e68bb9e68ad6be7c4be","07b44a7a51e94c78b411c753fc39dab0",22899445,1,-3,0,1309,192,189,-3
"07b44a7a51e94c78b411c753fc39dab0","6cd2dcaac46847d4a0bc53f296d90375",22899445,1,6,0,1310,189,194,5
"6cd2dcaac46847d4a0bc53f296d90375","6cd2dcaac46847d4a0bc53f296d90375",22899445,4,0,1,1311,194,194,0
"6cd2dcaac46847d4a0bc53f296d90375","2d2580c9411c4972909db508d6956a58",22899445,1,2,0,1315,194,196,2
"2d2580c9411c4972909db508d6956a58","2d2580c9411c4972909db508d6956a58",22899445,9,0,1,1316,196,196,0
"2d2580c9411c4972909db508d6956a58","5bddb3d9ed264f3984702f048c7e5340",22899445,1,1,0,1325,196,197,1
"5bddb3d9ed264f3984702f048c7e5340","5bddb3d9ed264f3984702f048c7e5340",22899445,9,0,1,1326,197,197,0
"5bddb3d9ed264f3984702f048c7e5340","d5e8e2bd12a2466b9d6d90855f0eb079",22899445,1,1,0,1335,197,198,1
"d5e8e2bd12a2466b9d6d90855f0eb079","d5e8e2bd12a2466b9d6d90855f0eb079",22899445,12,0,1,1336,198,198,0
"d5e8e2bd12a2466b9d6d90855f0eb079","017d7ca8e0394b91aaadc9574df2202c",22899445,1,-5,0,1348,198,193,-5
"017d7ca8e0394b91aaadc9574df2202c","54e8e9f0ea3e45c4bf3b8ac799ee31b1",22899445,1,8,0,1349,193,200,7
"54e8e9f0ea3e45c4bf3b8ac799ee31b1","54e8e9f0ea3e45c4bf3b8ac799ee31b1",22899445,6,0,1,1350,200,200,0
"54e8e9f0ea3e45c4bf3b8ac799ee31b1","c614a00911be4877a075f19315530fb0",22899445,1,1,0,1356,200,201,1
"c614a00911be4877a075f19315530fb0","c614a00911be4877a075f19315530fb0",22899445,117,0,1,1357,201,201,0
"c614a00911be4877a075f19315530fb0","a6c21bd8b95249c7972820a7a7d76aff",22899445,1,1,0,1419,201,202,1
"a6c21bd8b95249c7972820a7a7d76aff","a6c21bd8b95249c7972820a7a7d76aff",22899445,2,0,1,1420,202,202,0
"a6c21bd8b95249c7972820a7a7d76aff","bb329d880ab54120adaf203a693bb203",22899445,1,1,0,1421,202,203,1
"bb329d880ab54120adaf203a693bb203","bb329d880ab54120adaf203a693bb203",22899445,4,0,1,1422,203,203,0
"bb329d880ab54120adaf203a693bb203","a6c21bd8b95249c7972820a7a7d76aff",22899445,1,-1,0,1426,203,202,-1
"a6c21bd8b95249c7972820a7a7d76aff","f9170dd6bc6442b4acd832747609b09a",22899445,1,-3,0,1428,202,199,-3
"f9170dd6bc6442b4acd832747609b09a","334c2344009840079b1d0e1b7ce3d5a7",22899445,1,7,0,1429,199,205,6
"334c2344009840079b1d0e1b7ce3d5a7","334c2344009840079b1d0e1b7ce3d5a7",22899445,4,0,1,1430,205,205,0
"334c2344009840079b1d0e1b7ce3d5a7","d7f13c8d63ec4e2aa673fbb9cf9c6933",22899445,1,3,0,1434,205,206,1
"d7f13c8d63ec4e2aa673fbb9cf9c6933","c8e371568a0c4391b25796ae4e91952e",22899445,1,-26,0,1435,206,186,-20
"c8e371568a0c4391b25796ae4e91952e","b9e80f77c3a44349863b19875725c384",22899445,1,27,0,1436,186,207,21
"b9e80f77c3a44349863b19875725c384","7108f0e4c2584f1f9c471689ae4c885c",22899445,4,1,0,1437,207,208,1
"7108f0e4c2584f1f9c471689ae4c885c","b9e80f77c3a44349863b19875725c384",22899445,1,-1,0,1438,208,207,-1
"b9e80f77c3a44349863b19875725c384","b9e80f77c3a44349863b19875725c384",22899445,24,0,1,1439,207,207,0
"7108f0e4c2584f1f9c471689ae4c885c","7108f0e4c2584f1f9c471689ae4c885c",22899445,17,0,1,1464,208,208,0
"7108f0e4c2584f1f9c471689ae4c885c","d7f13c8d63ec4e2aa673fbb9cf9c6933",22899445,2,-2,0,1481,208,206,-2
"d7f13c8d63ec4e2aa673fbb9cf9c6933","09400e101c5d4b439cf9a26b03aae558",22899445,2,5,0,1482,206,210,4
"09400e101c5d4b439cf9a26b03aae558","eb515a26030b41f8a82a1e6114420bad",22899445,1,-50,0,1483,210,173,-37
"0c7262dff33c4087bc660ccf40f92f9c","0c7262dff33c4087bc660ccf40f92f9c",22899445,7,0,1,1488,169,169,0
"ab11d94c6c8948ea90b88f19d2cd502b","c8e371568a0c4391b25796ae4e91952e",22899445,2,-5,0,1491,190,186,-4
"c8e371568a0c4391b25796ae4e91952e","0c7262dff33c4087bc660ccf40f92f9c",22899445,1,-23,0,1492,186,169,-17
"801f9e9135034f49bf5f8b4bdefedb41","0c7262dff33c4087bc660ccf40f92f9c",22899445,1,-9,0,1500,177,169,-8
"0c7262dff33c4087bc660ccf40f92f9c","cf4c280bad6a43e6b131d8385ef9ef3f",22899445,1,19,0,1501,169,184,15
"cf4c280bad6a43e6b131d8385ef9ef3f","0c7262dff33c4087bc660ccf40f92f9c",22899445,1,-19,0,1502,184,169,-15
"c8e371568a0c4391b25796ae4e91952e","6cd2dcaac46847d4a0bc53f296d90375",22899445,1,10,0,1507,186,194,8
"6cd2dcaac46847d4a0bc53f296d90375","07b44a7a51e94c78b411c753fc39dab0",22899445,1,-6,0,1508,194,189,-5
"07b44a7a51e94c78b411c753fc39dab0","017d7ca8e0394b91aaadc9574df2202c",22899445,1,5,0,1509,189,193,4
"017d7ca8e0394b91aaadc9574df2202c","c614a00911be4877a075f19315530fb0",22899445,1,9,0,1510,193,201,8
"c614a00911be4877a075f19315530fb0","f9170dd6bc6442b4acd832747609b09a",22899445,1,-2,0,1566,201,199,-2
"f9170dd6bc6442b4acd832747609b09a","c8e371568a0c4391b25796ae4e91952e",22899445,1,-16,0,1567,199,186,-13
"c8e371568a0c4391b25796ae4e91952e","d7f13c8d63ec4e2aa673fbb9cf9c6933",22899445,1,26,0,1568,186,206,20
"d7f13c8d63ec4e2aa673fbb9cf9c6933","b9e80f77c3a44349863b19875725c384",22899445,2,1,0,1569,206,207,1
"7108f0e4c2584f1f9c471689ae4c885c","09400e101c5d4b439cf9a26b03aae558",22899445,1,3,0,1574,208,210,2
"09400e101c5d4b439cf9a26b03aae558","d7f13c8d63ec4e2aa673fbb9cf9c6933",22899445,1,-5,0,1575,210,206,-4
"d7f13c8d63ec4e2aa673fbb9cf9c6933","d7f13c8d63ec4e2aa673fbb9cf9c6933",22899445,4,0,1,1576,206,206,0
"09400e101c5d4b439cf9a26b03aae558","09400e101c5d4b439cf9a26b03aae558",22899445,6,0,1,1579,210,210,0
"09400e101c5d4b439cf9a26b03aae558","a88efa7e50ce47159810ab553afa6d3a",22899445,1,2,0,1585,210,212,2
"a88efa7e50ce47159810ab553afa6d3a","a88efa7e50ce47159810ab553afa6d3a",22899445,21,0,1,1586,212,212,0
"a88efa7e50ce47159810ab553afa6d3a","a875096404ef4a9984b62d74cda916f9",22899445,1,-3,0,1607,212,209,-3
"a875096404ef4a9984b62d74cda916f9","be502a7a43c44bf7b682698de79d9369",22899445,1,6,0,1608,209,214,5
"be502a7a43c44bf7b682698de79d9369","f7fb1952f56b4189b86a9f8b7862d2b8",22899445,4,1,0,1609,214,215,1
"f7fb1952f56b4189b86a9f8b7862d2b8","be502a7a43c44bf7b682698de79d9369",22899445,2,-1,0,1610,215,214,-1
"be502a7a43c44bf7b682698de79d9369","d7f13c8d63ec4e2aa673fbb9cf9c6933",22899445,1,-10,0,1611,214,206,-8
"d7f13c8d63ec4e2aa673fbb9cf9c6933","be502a7a43c44bf7b682698de79d9369",22899445,2,10,0,1613,206,214,8
"f7fb1952f56b4189b86a9f8b7862d2b8","d7f13c8d63ec4e2aa673fbb9cf9c6933",22899445,1,-11,0,1615,215,206,-9
"be502a7a43c44bf7b682698de79d9369","be502a7a43c44bf7b682698de79d9369",22899445,6,0,1,1619,214,214,0
"f7fb1952f56b4189b86a9f8b7862d2b8","f7fb1952f56b4189b86a9f8b7862d2b8",22899445,11,0,1,1626,215,215,0
"f7fb1952f56b4189b86a9f8b7862d2b8","b860ee85d8bc4a2f97958cfb71be3533",22899445,1,1,0,1637,215,216,1
"b860ee85d8bc4a2f97958cfb71be3533","b860ee85d8bc4a2f97958cfb71be3533",22899445,12,0,1,1638,216,216,0
"b860ee85d8bc4a2f97958cfb71be3533","ec341f459285443b8361f7f15638ff08",22899445,1,-3,0,1650,216,213,-3
"ec341f459285443b8361f7f15638ff08","363837c182e04711840d896ae1e0339c",22899445,1,6,0,1651,213,218,5
"363837c182e04711840d896ae1e0339c","363837c182e04711840d896ae1e0339c",22899445,16,0,1,1652,218,218,0
"363837c182e04711840d896ae1e0339c","01b2051f8941460d89945e3b02d1ce78",22899445,1,-1,0,1668,218,217,-1
"01b2051f8941460d89945e3b02d1ce78","91125ca626c5470eb145501f8c37f8db",22899445,1,4,0,1669,217,220,3
"91125ca626c5470eb145501f8c37f8db","91125ca626c5470eb145501f8c37f8db",22899445,5,0,1,1670,220,220,0
"91125ca626c5470eb145501f8c37f8db","1c6721b1f63f4d30ba7746ea8af02a52",22899445,1,3,0,1675,220,221,1
"1c6721b1f63f4d30ba7746ea8af02a52","d7f13c8d63ec4e2aa673fbb9cf9c6933",22899445,2,-21,0,1676,221,206,-15
"d7f13c8d63ec4e2aa673fbb9cf9c6933","77ecef8eff6b4a2caea7707669bf7475",22899445,1,22,0,1677,206,222,16
"77ecef8eff6b4a2caea7707669bf7475","77ecef8eff6b4a2caea7707669bf7475",22899445,12,0,1,1678,222,222,0
"77ecef8eff6b4a2caea7707669bf7475","d03cb855c70044cf8c35d9ec0de696e3",22899445,2,3,0,1690,222,224,2
"d03cb855c70044cf8c35d9ec0de696e3","1c6721b1f63f4d30ba7746ea8af02a52",22899445,2,-4,0,1691,224,221,-3
"1c6721b1f63f4d30ba7746ea8af02a52","8b9ae98743bd4d4a8a87dff1c1244211",22899445,2,7,0,1692,221,227,6
"8b9ae98743bd4d4a8a87dff1c1244211","d03cb855c70044cf8c35d9ec0de696e3",22899445,1,-3,0,1693,227,224,-3
"d03cb855c70044cf8c35d9ec0de696e3","d03cb855c70044cf8c35d9ec0de696e3",22899445,5,0,1,1694,224,224,0
"d03cb855c70044cf8c35d9ec0de696e3","a49a937d6896486d9a5396654abcf2e1",22899445,2,2,0,1699,224,226,2
"a49a937d6896486d9a5396654abcf2e1","a49a937d6896486d9a5396654abcf2e1",22899445,6,0,1,1700,226,226,0
"a49a937d6896486d9a5396654abcf2e1","d03cb855c70044cf8c35d9ec0de696e3",22899445,1,-2,0,1701,226,224,-2
"a49a937d6896486d9a5396654abcf2e1","8b9ae98743bd4d4a8a87dff1c1244211",22899445,1,1,0,1708,226,227,1
"8b9ae98743bd4d4a8a87dff1c1244211","8b9ae98743bd4d4a8a87dff1c1244211",22899445,22,0,1,1709,227,227,0
"8b9ae98743bd4d4a8a87dff1c1244211","f7906d6f59b9489a91d2ef40db5a474d",22899445,1,-4,0,1731,227,223,-4
"f7906d6f59b9489a91d2ef40db5a474d","2ab1535aac1346ba8801535bf729ef37",22899445,2,7,0,1732,223,229,6
"2ab1535aac1346ba8801535bf729ef37","1c6721b1f63f4d30ba7746ea8af02a52",22899445,1,-10,0,1733,229,221,-8
"d7f13c8d63ec4e2aa673fbb9cf9c6933","1c6721b1f63f4d30ba7746ea8af02a52",22899445,1,21,0,1736,206,221,15
"1c6721b1f63f4d30ba7746ea8af02a52","1c6721b1f63f4d30ba7746ea8af02a52",22899445,2,0,1,1737,221,221,0
"1c6721b1f63f4d30ba7746ea8af02a52","77ecef8eff6b4a2caea7707669bf7475",22899445,1,1,0,1739,221,222,1
"8b9ae98743bd4d4a8a87dff1c1244211","2ab1535aac1346ba8801535bf729ef37",22899445,1,3,0,1743,227,229,2
"2ab1535aac1346ba8801535bf729ef37","f7906d6f59b9489a91d2ef40db5a474d",22899445,1,-7,0,1744,229,223,-6
"2ab1535aac1346ba8801535bf729ef37","2ab1535aac1346ba8801535bf729ef37",22899445,15,0,1,1746,229,229,0
"2ab1535aac1346ba8801535bf729ef37","a4f40fb48a8542c8949bae1f002cd9bc",22899445,1,2,0,1752,229,231,2
"a4f40fb48a8542c8949bae1f002cd9bc","a4f40fb48a8542c8949bae1f002cd9bc",22899445,8,0,1,1753,231,231,0
"a4f40fb48a8542c8949bae1f002cd9bc","2ab1535aac1346ba8801535bf729ef37",22899445,1,-2,0,1761,231,229,-2
"2ab1535aac1346ba8801535bf729ef37","8972c23e32044edb8a78fa1eed4e5947",22899445,1,3,0,1765,229,232,3
"8972c23e32044edb8a78fa1eed4e5947","8972c23e32044edb8a78fa1eed4e5947",22899445,5,0,1,1766,232,232,0
"8972c23e32044edb8a78fa1eed4e5947","92feb4a40f8344d38b6f722e42a53295",22899445,1,1,0,1771,232,233,1
"92feb4a40f8344d38b6f722e42a53295","92feb4a40f8344d38b6f722e42a53295",22899445,8,0,1,1772,233,233,0
"92feb4a40f8344d38b6f722e42a53295","2ab1535aac1346ba8801535bf729ef37",22899445,1,-4,0,1780,233,229,-4
"2ab1535aac1346ba8801535bf729ef37","5152833676bf4c6cb317060be10f68db",22899445,1,-1,0,1787,229,228,-1
"5152833676bf4c6cb317060be10f68db","ca3e28f290354c08aefe5b0f769604e6",22899445,1,8,0,1788,228,235,7
"ca3e28f290354c08aefe5b0f769604e6","ca3e28f290354c08aefe5b0f769604e6",22899445,14,0,1,1789,235,235,0
"ca3e28f290354c08aefe5b0f769604e6","79a35eea833e4c2c9d22fc53c3c6445c",22899445,1,1,0,1803,235,236,1
"79a35eea833e4c2c9d22fc53c3c6445c","79a35eea833e4c2c9d22fc53c3c6445c",22899445,14,0,1,1804,236,236,0
"79a35eea833e4c2c9d22fc53c3c6445c","8f68228b1518449e9615cdafee41a2bd",22899445,1,1,0,1818,236,237,1
"8f68228b1518449e9615cdafee41a2bd","8f68228b1518449e9615cdafee41a2bd",22899445,9,0,1,1819,237,237,0
"8f68228b1518449e9615cdafee41a2bd","cab89fa5c3ed45a5aa550fc0352d6a42",22899445,1,1,0,1828,237,238,1
"cab89fa5c3ed45a5aa550fc0352d6a42","cab89fa5c3ed45a5aa550fc0352d6a42",22899445,5,0,1,1829,238,238,0
"cab89fa5c3ed45a5aa550fc0352d6a42","66d4fad4f1cf4b46be0750a99ad7a35a",22899445,1,1,0,1834,238,239,1
"66d4fad4f1cf4b46be0750a99ad7a35a","66d4fad4f1cf4b46be0750a99ad7a35a",22899445,11,0,1,1835,239,239,0
"66d4fad4f1cf4b46be0750a99ad7a35a","0b04c8e2f86d48c7aeb7e225819cd32b",22899445,1,-5,0,1846,239,234,-5
"0b04c8e2f86d48c7aeb7e225819cd32b","f53da5fd9bfe412da4b80d4742563b6c",22899445,1,8,0,1847,234,241,7
"f53da5fd9bfe412da4b80d4742563b6c","f53da5fd9bfe412da4b80d4742563b6c",22899445,4,0,1,1848,241,241,0
"f53da5fd9bfe412da4b80d4742563b6c","2ae94c0cea4d480a9d5dca8fb1d7b542",22899445,1,3,0,1852,241,242,1
"2ae94c0cea4d480a9d5dca8fb1d7b542","1c6721b1f63f4d30ba7746ea8af02a52",22899445,1,-27,0,1853,242,221,-21
"1c6721b1f63f4d30ba7746ea8af02a52","1ebf23f9d994469a85206e4c7b1bf5f5",22899445,1,30,0,1854,221,245,24
"1ebf23f9d994469a85206e4c7b1bf5f5","0c7262dff33c4087bc660ccf40f92f9c",22899445,1,-100,0,1855,245,169,-76
"c8e371568a0c4391b25796ae4e91952e","c8e371568a0c4391b25796ae4e91952e",22899445,2,0,1,1859,186,186,0
"c8e371568a0c4391b25796ae4e91952e","2ae94c0cea4d480a9d5dca8fb1d7b542",22899445,1,74,0,1861,186,242,56
"2ae94c0cea4d480a9d5dca8fb1d7b542","2ae94c0cea4d480a9d5dca8fb1d7b542",22899445,1,0,1,1862,242,242,0
"2ae94c0cea4d480a9d5dca8fb1d7b542","1ebf23f9d994469a85206e4c7b1bf5f5",22899445,1,3,0,1863,242,245,3
"1ebf23f9d994469a85206e4c7b1bf5f5","1ebf23f9d994469a85206e4c7b1bf5f5",22899445,17,0,1,1864,245,245,0
"1ebf23f9d994469a85206e4c7b1bf5f5","85ae675b83e8422da842cfd25596af99",22899445,1,1,0,1881,245,246,1
"85ae675b83e8422da842cfd25596af99","85ae675b83e8422da842cfd25596af99",22899445,6,0,1,1882,246,246,0
"85ae675b83e8422da842cfd25596af99","fa235f0f364d47e4ae1c87f47bf8e6ba",22899445,1,8,0,1888,246,252,6
"fa235f0f364d47e4ae1c87f47bf8e6ba","2ae94c0cea4d480a9d5dca8fb1d7b542",22899445,1,-12,0,1889,252,242,-10
"2ae94c0cea4d480a9d5dca8fb1d7b542","fa235f0f364d47e4ae1c87f47bf8e6ba",22899445,1,12,0,1890,242,252,10
"fa235f0f364d47e4ae1c87f47bf8e6ba","fa235f0f364d47e4ae1c87f47bf8e6ba",22899445,3,0,1,1891,252,252,0
"fa235f0f364d47e4ae1c87f47bf8e6ba","79f7845465cc4ed19d8e4f1429541be0",22899445,1,2,0,1892,252,254,2
"79f7845465cc4ed19d8e4f1429541be0","79f7845465cc4ed19d8e4f1429541be0",22899445,8,0,1,1893,254,254,0
"79f7845465cc4ed19d8e4f1429541be0","fa235f0f364d47e4ae1c87f47bf8e6ba",22899445,1,-2,0,1901,254,252,-2
"fa235f0f364d47e4ae1c87f47bf8e6ba","6e83e23f56544a19b94067c1c558d9c0",22899445,1,-6,0,1904,252,247,-5
"6e83e23f56544a19b94067c1c558d9c0","00f61990949545828dd12f1303d47504",22899445,1,11,0,1905,247,256,9
"00f61990949545828dd12f1303d47504","00f61990949545828dd12f1303d47504",22899445,6,0,1,1906,256,256,0
"00f61990949545828dd12f1303d47504","ead7bb4b64e247d2ae632ab8a296b091",22899445,1,2,0,1912,256,258,2
"ead7bb4b64e247d2ae632ab8a296b091","ead7bb4b64e247d2ae632ab8a296b091",22899445,11,0,1,1913,258,258,0
"ead7bb4b64e247d2ae632ab8a296b091","41b0048dde734bb280bac6116baa8e27",22899445,1,1,0,1924,258,259,1
"41b0048dde734bb280bac6116baa8e27","41b0048dde734bb280bac6116baa8e27",22899445,8,0,1,1925,259,259,0
"41b0048dde734bb280bac6116baa8e27","b41c5a094a604ee0915327da5cc0beb7",22899445,1,1,0,1933,259,260,1
"b41c5a094a604ee0915327da5cc0beb7","b41c5a094a604ee0915327da5cc0beb7",22899445,8,0,1,1934,260,260,0
"b41c5a094a604ee0915327da5cc0beb7","d546341988904f069cfa86b21457d9d9",22899445,1,-10,0,1942,260,251,-9
"d546341988904f069cfa86b21457d9d9","28c171777c52431ab6b925073bd63d46",22899445,1,15,0,1943,251,264,13
"28c171777c52431ab6b925073bd63d46","28c171777c52431ab6b925073bd63d46",22899445,11,0,1,1944,264,264,0
"28c171777c52431ab6b925073bd63d46","ac160db940cb49ae8579162b1d52bb5d",22899445,1,2,0,1955,264,266,2
"ac160db940cb49ae8579162b1d52bb5d","ac160db940cb49ae8579162b1d52bb5d",22899445,15,0,1,1956,266,266,0
"ac160db940cb49ae8579162b1d52bb5d","d989ebcfc12a4b669f0100dc1aa14f1e",22899445,1,-12,0,1971,266,255,-11
"d989ebcfc12a4b669f0100dc1aa14f1e","c6fd49b485cc4874b0bbdd9c6171e09c",22899445,1,15,0,1972,255,268,13
"c6fd49b485cc4874b0bbdd9c6171e09c","c6fd49b485cc4874b0bbdd9c6171e09c",22899445,11,0,1,1973,268,268,0
"c6fd49b485cc4874b0bbdd9c6171e09c","44240778a97c4af0937817499b75707b",22899445,1,1,0,1984,268,269,1
"44240778a97c4af0937817499b75707b","44240778a97c4af0937817499b75707b",22899445,8,0,1,1985,269,269,0
"44240778a97c4af0937817499b75707b","7aa76d3e993840d8805f097cbdbcd44b",22899445,1,-9,0,1993,269,261,-8
"7aa76d3e993840d8805f097cbdbcd44b","865a4d3b43374da7944dc7d397f566d9",22899445,1,12,0,1994,261,271,10
"865a4d3b43374da7944dc7d397f566d9","865a4d3b43374da7944dc7d397f566d9",22899445,5,0,1,1995,271,271,0
"865a4d3b43374da7944dc7d397f566d9","2ae94c0cea4d480a9d5dca8fb1d7b542",22899445,1,-35,0,2000,271,242,-29
"2ae94c0cea4d480a9d5dca8fb1d7b542","0d987bed3ffa4ed0b9a2e62e97b7b30f",22899445,1,38,0,2001,242,272,30
"0d987bed3ffa4ed0b9a2e62e97b7b30f","0d987bed3ffa4ed0b9a2e62e97b7b30f",22899445,1,0,1,2002,272,272,0
"0d987bed3ffa4ed0b9a2e62e97b7b30f","bb5a47f5ea01454a8b79455422d3b9da",22899445,6,10,0,2003,272,280,8
"bb5a47f5ea01454a8b79455422d3b9da","bb5a47f5ea01454a8b79455422d3b9da",22899445,137,0,1,2004,280,280,0
"bb5a47f5ea01454a8b79455422d3b9da","82ae07bc0c9b4570a41799290d1ef399",22899445,2,-6,0,2006,280,275,-5
"82ae07bc0c9b4570a41799290d1ef399","bc5524e78a8544e2ae2fdc2f3462bbec",22899445,1,5,0,2007,275,279,4
"bc5524e78a8544e2ae2fdc2f3462bbec","bb5a47f5ea01454a8b79455422d3b9da",22899445,4,1,0,2008,279,280,1
"82ae07bc0c9b4570a41799290d1ef399","bb5a47f5ea01454a8b79455422d3b9da",22899445,1,6,0,2020,275,280,5
"bb5a47f5ea01454a8b79455422d3b9da","bc5524e78a8544e2ae2fdc2f3462bbec",22899445,3,-1,0,2022,280,279,-1
"bc5524e78a8544e2ae2fdc2f3462bbec","bc5524e78a8544e2ae2fdc2f3462bbec",22899445,6,0,1,2023,279,279,0
"bc5524e78a8544e2ae2fdc2f3462bbec","0d987bed3ffa4ed0b9a2e62e97b7b30f",22899445,3,-9,0,2025,279,272,-7
"0d987bed3ffa4ed0b9a2e62e97b7b30f","bc5524e78a8544e2ae2fdc2f3462bbec",22899445,3,9,0,2026,272,279,7
"bb5a47f5ea01454a8b79455422d3b9da","0d987bed3ffa4ed0b9a2e62e97b7b30f",22899445,5,-10,0,2090,280,272,-8
"0d987bed3ffa4ed0b9a2e62e97b7b30f","94cecc3f1e7d484b8e068e79241dfd73",22899445,3,13,0,2111,272,281,9
"94cecc3f1e7d484b8e068e79241dfd73","a37477c4e4c14169ad44b06b493007f6",22899445,5,2,0,2112,281,283,2
"a37477c4e4c14169ad44b06b493007f6","0d987bed3ffa4ed0b9a2e62e97b7b30f",22899445,3,-15,0,2113,283,272,-11
"a37477c4e4c14169ad44b06b493007f6","94cecc3f1e7d484b8e068e79241dfd73",22899445,2,-2,0,2126,283,281,-2
"94cecc3f1e7d484b8e068e79241dfd73","94cecc3f1e7d484b8e068e79241dfd73",22899445,3,0,1,2127,281,281,0
"bb5a47f5ea01454a8b79455422d3b9da","94cecc3f1e7d484b8e068e79241dfd73",22899445,1,3,0,2187,280,281,1
"94cecc3f1e7d484b8e068e79241dfd73","0d987bed3ffa4ed0b9a2e62e97b7b30f",22899445,1,-13,0,2188,281,272,-9
"0d987bed3ffa4ed0b9a2e62e97b7b30f","a37477c4e4c14169ad44b06b493007f6",22899445,1,15,0,2189,272,283,11
"a37477c4e4c14169ad44b06b493007f6","fab84b4fab5940efb4ea868ef8d09396",22899445,1,3,0,2193,283,284,1
"fab84b4fab5940efb4ea868ef8d09396","94cecc3f1e7d484b8e068e79241dfd73",22899445,1,-5,0,2194,284,281,-3
"94cecc3f1e7d484b8e068e79241dfd73","4a29443515bb404cb8924e1c60a63b73",22899445,1,9,0,2195,281,285,4
"4a29443515bb404cb8924e1c60a63b73","fab84b4fab5940efb4ea868ef8d09396",22899445,2,-4,0,2196,285,284,-1
"fab84b4fab5940efb4ea868ef8d09396","4a29443515bb404cb8924e1c60a63b73",22899445,1,4,0,2197,284,285,1
"fab84b4fab5940efb4ea868ef8d09396","208c9b2796c944db8dacaa96082520ea",22899445,1,7,0,2199,284,288,4
"208c9b2796c944db8dacaa96082520ea","4a29443515bb404cb8924e1c60a63b73",22899445,2,-3,0,2200,288,285,-3
"4a29443515bb404cb8924e1c60a63b73","4a29443515bb404cb8924e1c60a63b73",22899445,2,0,1,2201,285,285,0
"4a29443515bb404cb8924e1c60a63b73","208c9b2796c944db8dacaa96082520ea",22899445,1,3,0,2202,285,288,3
"208c9b2796c944db8dacaa96082520ea","208c9b2796c944db8dacaa96082520ea",22899445,2,0,1,2203,288,288,0
"4a29443515bb404cb8924e1c60a63b73","7669a956527947d0add87455277e80b4",22899445,1,7,0,2206,285,291,6
"7669a956527947d0add87455277e80b4","7669a956527947d0add87455277e80b4",22899445,4,0,1,2207,291,291,0
"7669a956527947d0add87455277e80b4","6a9a3b5bde4a48daa896fe8c06eca56f",22899445,1,-2,0,2211,291,289,-2
"6a9a3b5bde4a48daa896fe8c06eca56f","869e967078f04da18dd0b0b9389a7424",22899445,1,5,0,2212,289,293,4
"869e967078f04da18dd0b0b9389a7424","869e967078f04da18dd0b0b9389a7424",22899445,2,0,1,2213,293,293,0
"869e967078f04da18dd0b0b9389a7424","51ab6291537748fab90d519aa09889d6",22899445,1,2,0,2215,293,295,2
"51ab6291537748fab90d519aa09889d6","51ab6291537748fab90d519aa09889d6",22899445,17,0,1,2216,295,295,0
"51ab6291537748fab90d519aa09889d6","34a6e49023fc4465bd5ca604330bbd1c",22899445,1,-3,0,2233,295,292,-3
"34a6e49023fc4465bd5ca604330bbd1c","21592f2a9e9c4b2f8c66ec5dbcbf6a2b",22899445,1,5,0,2234,292,296,4
"21592f2a9e9c4b2f8c66ec5dbcbf6a2b","ba0e59461bfb4a44b7b1c28a01f8d3b3",22899445,2,4,0,2235,296,299,3
"ba0e59461bfb4a44b7b1c28a01f8d3b3","21592f2a9e9c4b2f8c66ec5dbcbf6a2b",22899445,1,-4,0,2236,299,296,-3
"21592f2a9e9c4b2f8c66ec5dbcbf6a2b","21592f2a9e9c4b2f8c66ec5dbcbf6a2b",22899445,1,0,1,2237,296,296,0
"21592f2a9e9c4b2f8c66ec5dbcbf6a2b","4a29443515bb404cb8924e1c60a63b73",22899445,1,-14,0,2238,296,285,-11
"4a29443515bb404cb8924e1c60a63b73","21592f2a9e9c4b2f8c66ec5dbcbf6a2b",22899445,1,14,0,2239,285,296,11
"ba0e59461bfb4a44b7b1c28a01f8d3b3","4a29443515bb404cb8924e1c60a63b73",22899445,1,-18,0,2241,299,285,-14
"4a29443515bb404cb8924e1c60a63b73","7646a919d7e64fa990bca9b024ff089d",22899445,1,17,0,2242,285,298,13
"7646a919d7e64fa990bca9b024ff089d","ba0e59461bfb4a44b7b1c28a01f8d3b3",22899445,1,1,0,2243,298,299,1
"ba0e59461bfb4a44b7b1c28a01f8d3b3","ba0e59461bfb4a44b7b1c28a01f8d3b3",22899445,1,0,1,2244,299,299,0
"ba0e59461bfb4a44b7b1c28a01f8d3b3","0e0b36e731a645e7b1b8a88f5031ca38",22899445,1,2,0,2245,299,301,2
"0e0b36e731a645e7b1b8a88f5031ca38","0e0b36e731a645e7b1b8a88f5031ca38",22899445,9,0,1,2246,301,301,0
"0e0b36e731a645e7b1b8a88f5031ca38","a66a144637284c21afc6de17fea4bfb8",22899445,1,1,0,2255,301,302,1
"a66a144637284c21afc6de17fea4bfb8","a66a144637284c21afc6de17fea4bfb8",22899445,8,0,1,2256,302,302,0
"a66a144637284c21afc6de17fea4bfb8","4a29443515bb404cb8924e1c60a63b73",22899445,3,-21,0,2257,302,285,-17
"4a29443515bb404cb8924e1c60a63b73","ba0e59461bfb4a44b7b1c28a01f8d3b3",22899445,1,18,0,2258,285,299,14
"ba0e59461bfb4a44b7b1c28a01f8d3b3","a66a144637284c21afc6de17fea4bfb8",22899445,2,3,0,2259,299,302,3
"4a29443515bb404cb8924e1c60a63b73","a66a144637284c21afc6de17fea4bfb8",22899445,2,21,0,2261,285,302,17
"a66a144637284c21afc6de17fea4bfb8","ba0e59461bfb4a44b7b1c28a01f8d3b3",22899445,2,-3,0,2264,302,299,-3
"a66a144637284c21afc6de17fea4bfb8","7646a919d7e64fa990bca9b024ff089d",22899445,1,-4,0,2271,302,298,-4
"7646a919d7e64fa990bca9b024ff089d","e390b575229748ea8aac9364efe2bf00",22899445,1,7,0,2272,298,304,6
"e390b575229748ea8aac9364efe2bf00","e390b575229748ea8aac9364efe2bf00",22899445,3,0,1,2273,304,304,0
"e390b575229748ea8aac9364efe2bf00","3434c10e561d488a914e0f7d71907abd",22899445,1,3,0,2276,304,305,1
"3434c10e561d488a914e0f7d71907abd","4a29443515bb404cb8924e1c60a63b73",22899445,1,-27,0,2277,305,285,-20
"4a29443515bb404cb8924e1c60a63b73","53e7e900392747ccad52e711ab0f80d8",22899445,1,29,0,2278,285,307,22
"53e7e900392747ccad52e711ab0f80d8","53e7e900392747ccad52e711ab0f80d8",22899445,3,0,1,2279,307,307,0
"53e7e900392747ccad52e711ab0f80d8","3434c10e561d488a914e0f7d71907abd",22899445,1,-2,0,2282,307,305,-2
"3434c10e561d488a914e0f7d71907abd","130acc2aeb0448fdbb2de63bc5cebe5b",22899445,2,5,0,2283,305,309,4
"130acc2aeb0448fdbb2de63bc5cebe5b","9c062b3251034ebe90f5054e2a3b5120",22899445,1,2,0,2284,309,311,2
"9c062b3251034ebe90f5054e2a3b5120","9c062b3251034ebe90f5054e2a3b5120",22899445,8,0,1,2285,311,311,0
"9c062b3251034ebe90f5054e2a3b5120","ea859f8207e44537889daeaba13ac2e8",22899445,1,1,0,2293,311,312,1
"ea859f8207e44537889daeaba13ac2e8","ea859f8207e44537889daeaba13ac2e8",22899445,5,0,1,2294,312,312,0
"ea859f8207e44537889daeaba13ac2e8","56d94971a7a94257aa330183a8ebd0ea",22899445,1,1,0,2299,312,313,1
"56d94971a7a94257aa330183a8ebd0ea","56d94971a7a94257aa330183a8ebd0ea",22899445,5,0,1,2300,313,313,0
"56d94971a7a94257aa330183a8ebd0ea","141c0df6cd1946539aadd1c9b7068cd4",22899445,1,-5,0,2305,313,308,-5
"141c0df6cd1946539aadd1c9b7068cd4","13255e63e0aa4abf85e5211bf613d43e",22899445,1,10,0,2306,308,317,9
"13255e63e0aa4abf85e5211bf613d43e","13255e63e0aa4abf85e5211bf613d43e",22899445,3,0,1,2307,317,317,0
"13255e63e0aa4abf85e5211bf613d43e","0c787d16c9504873b1a4d903cec09948",22899445,1,-3,0,2310,317,314,-3
"0c787d16c9504873b1a4d903cec09948","86c27d40179e419c8e9d150fb6afa5d0",22899445,1,6,0,2311,314,319,5
"86c27d40179e419c8e9d150fb6afa5d0","86c27d40179e419c8e9d150fb6afa5d0",22899445,7,0,1,2312,319,319,0
"86c27d40179e419c8e9d150fb6afa5d0","24f1363179ad4aaa965484a78471912b",22899445,2,5,0,2319,319,323,4
"24f1363179ad4aaa965484a78471912b","47edbb64109243e6b0f8f64cdef90c6c",22899445,3,3,0,2320,323,326,3
"47edbb64109243e6b0f8f64cdef90c6c","8d7e0b55cf9849cda222a0f2440cec55",22899445,2,-9,0,2321,326,318,-8
"8d7e0b55cf9849cda222a0f2440cec55","4a29443515bb404cb8924e1c60a63b73",22899445,1,-43,0,2322,318,285,-33
"4a29443515bb404cb8924e1c60a63b73","8d7e0b55cf9849cda222a0f2440cec55",22899445,1,43,0,2323,285,318,33
"8d7e0b55cf9849cda222a0f2440cec55","3434c10e561d488a914e0f7d71907abd",22899445,1,-16,0,2324,318,305,-13
"3434c10e561d488a914e0f7d71907abd","86c27d40179e419c8e9d150fb6afa5d0",22899445,2,17,0,2325,305,319,14
"8d7e0b55cf9849cda222a0f2440cec55","24f1363179ad4aaa965484a78471912b",22899445,2,6,0,2329,318,323,5
"24f1363179ad4aaa965484a78471912b","3434c10e561d488a914e0f7d71907abd",22899445,1,-22,0,2330,323,305,-18
"86c27d40179e419c8e9d150fb6afa5d0","8d7e0b55cf9849cda222a0f2440cec55",22899445,1,-1,0,2332,319,318,-1
"47edbb64109243e6b0f8f64cdef90c6c","3628bdce1dd2429ba924d2d4d09448d2",22899445,1,-4,0,2335,326,322,-4
"3628bdce1dd2429ba924d2d4d09448d2","56b3fd1a212a4764be39d979fde3326e",22899445,1,7,0,2336,322,328,6
"56b3fd1a212a4764be39d979fde3326e","56b3fd1a212a4764be39d979fde3326e",22899445,3,0,1,2337,328,328,0
"56b3fd1a212a4764be39d979fde3326e","3434c10e561d488a914e0f7d71907abd",22899445,1,-28,0,2340,328,305,-23
"3434c10e561d488a914e0f7d71907abd","0c4079457ede49e3aeb5e86ed84bdf35",22899445,1,31,0,2341,305,329,24
"0c4079457ede49e3aeb5e86ed84bdf35","38aea304b4fa46e1b29bb72f5cea4c93",22899445,6,2,0,2342,329,331,2
"38aea304b4fa46e1b29bb72f5cea4c93","38aea304b4fa46e1b29bb72f5cea4c93",22899445,18,0,1,2343,331,331,0
"38aea304b4fa46e1b29bb72f5cea4c93","0c4079457ede49e3aeb5e86ed84bdf35",22899445,3,-2,0,2344,331,329,-2
"38aea304b4fa46e1b29bb72f5cea4c93","a66a144637284c21afc6de17fea4bfb8",22899445,1,-39,0,2347,331,302,-29
"ba0e59461bfb4a44b7b1c28a01f8d3b3","a49d1bb4328949299686242fd0be5584",22899445,1,-382,0,2351,299,21,-278
"a49d1bb4328949299686242fd0be5584","b7719e26494940efa49512aedd0aac79",22899445,2,-2,0,2352,21,20,-1
"b7719e26494940efa49512aedd0aac79","141c0df6cd1946539aadd1c9b7068cd4",22899445,1,397,0,2353,20,308,288
"141c0df6cd1946539aadd1c9b7068cd4","3434c10e561d488a914e0f7d71907abd",22899445,1,-4,0,2354,308,305,-3
"130acc2aeb0448fdbb2de63bc5cebe5b","e3d8dd3e10e64c87b04e410b519c4680",22899445,1,27,0,2356,309,330,21
"e3d8dd3e10e64c87b04e410b519c4680","e3d8dd3e10e64c87b04e410b519c4680",22899445,1,0,1,2357,330,330,0
"e3d8dd3e10e64c87b04e410b519c4680","0c4079457ede49e3aeb5e86ed84bdf35",22899445,1,-1,0,2358,330,329,-1
"38aea304b4fa46e1b29bb72f5cea4c93","e36d261332f14e79bb4b467aceaeb9b5",22899445,1,2,0,2362,331,333,2
"e36d261332f14e79bb4b467aceaeb9b5","e36d261332f14e79bb4b467aceaeb9b5",22899445,5,0,1,2363,333,333,0
"e36d261332f14e79bb4b467aceaeb9b5","38aea304b4fa46e1b29bb72f5cea4c93",22899445,1,-2,0,2368,333,331,-2
"38aea304b4fa46e1b29bb72f5cea4c93","c7e89b9d04744d2eab742fc24e3ef1ae",22899445,1,3,0,2373,331,334,3
"c7e89b9d04744d2eab742fc24e3ef1ae","c7e89b9d04744d2eab742fc24e3ef1ae",22899445,8,0,1,2374,334,334,0
"c7e89b9d04744d2eab742fc24e3ef1ae","fe49f8054b374a0ea4bb266ed135ff62",22899445,1,1,0,2382,334,335,1
"fe49f8054b374a0ea4bb266ed135ff62","fe49f8054b374a0ea4bb266ed135ff62",22899445,8,0,1,2383,335,335,0
"fe49f8054b374a0ea4bb266ed135ff62","d0a8f74af98642fe8360d22c42e45117",22899445,1,1,0,2391,335,336,1
"d0a8f74af98642fe8360d22c42e45117","d0a8f74af98642fe8360d22c42e45117",22899445,5,0,1,2392,336,336,0
"d0a8f74af98642fe8360d22c42e45117","0c4079457ede49e3aeb5e86ed84bdf35",22899445,1,-7,0,2397,336,329,-7
"0c4079457ede49e3aeb5e86ed84bdf35","c1d727a16f6d4e499496009622516e42",22899445,1,10,0,2398,329,338,9
"c1d727a16f6d4e499496009622516e42","c1d727a16f6d4e499496009622516e42",22899445,3,0,1,2399,338,338,0
"c1d727a16f6d4e499496009622516e42","0c4079457ede49e3aeb5e86ed84bdf35",22899445,1,-10,0,2402,338,329,-9
"0c4079457ede49e3aeb5e86ed84bdf35","0c4079457ede49e3aeb5e86ed84bdf35",22899445,6,0,1,2403,329,329,0
"0c4079457ede49e3aeb5e86ed84bdf35","a7c6339ca1da4368a18d471f0519f877",22899445,1,11,0,2412,329,339,10
"a7c6339ca1da4368a18d471f0519f877","a7c6339ca1da4368a18d471f0519f877",22899445,3,0,1,2413,339,339,0
"a7c6339ca1da4368a18d471f0519f877","b8b9418ab322418d9db9b40d96af873a",22899445,1,-2,0,2416,339,337,-2
"b8b9418ab322418d9db9b40d96af873a","bbc5139ca9024389a94db3a6f47dcff6",22899445,1,5,0,2417,337,341,4
"bbc5139ca9024389a94db3a6f47dcff6","bbc5139ca9024389a94db3a6f47dcff6",22899445,11,0,1,2418,341,341,0
"bbc5139ca9024389a94db3a6f47dcff6","4ee6ca9019ab4a1ab323f98094a9bd77",22899445,1,2,0,2422,341,343,2
"4ee6ca9019ab4a1ab323f98094a9bd77","4ee6ca9019ab4a1ab323f98094a9bd77",22899445,8,0,1,2423,343,343,0
"4ee6ca9019ab4a1ab323f98094a9bd77","b37947176785476f8b29d49a851366dc",22899445,1,1,0,2431,343,344,1
"b37947176785476f8b29d49a851366dc","b37947176785476f8b29d49a851366dc",22899445,8,0,1,2432,344,344,0
"b37947176785476f8b29d49a851366dc","bbc5139ca9024389a94db3a6f47dcff6",22899445,1,-3,0,2440,344,341,-3
"bbc5139ca9024389a94db3a6f47dcff6","fcea5b10d5a14a3b9324ffece8f6e1e5",22899445,1,4,0,2443,341,345,4
"fcea5b10d5a14a3b9324ffece8f6e1e5","fcea5b10d5a14a3b9324ffece8f6e1e5",22899445,8,0,1,2444,345,345,0
"fcea5b10d5a14a3b9324ffece8f6e1e5","c2490bc612d146edbe786556fab3651b",22899445,1,-5,0,2452,345,340,-5
"c2490bc612d146edbe786556fab3651b","6ac8bb048b854999a47edb35fe627f11",22899445,1,8,0,2453,340,347,7
"6ac8bb048b854999a47edb35fe627f11","6ac8bb048b854999a47edb35fe627f11",22899445,8,0,1,2454,347,347,0
"6ac8bb048b854999a47edb35fe627f11","30ead9794d4847abaf222ca966cc8630",22899445,1,3,0,2462,347,348,1
"30ead9794d4847abaf222ca966cc8630","0c4079457ede49e3aeb5e86ed84bdf35",22899445,1,-24,0,2463,348,329,-19
"0c4079457ede49e3aeb5e86ed84bdf35","c20993c944444fe085345591a8bd837e",22899445,1,27,0,2464,329,351,22
"c20993c944444fe085345591a8bd837e","897b7f51242c44aab2205c72fdcbf4cd",22899445,2,1,0,2465,351,352,1
"897b7f51242c44aab2205c72fdcbf4cd","09b9678ddc3d452ea4a3d46e15826065",22899445,2,1,0,2466,352,353,1
"09b9678ddc3d452ea4a3d46e15826065","eff0de7f2dbb42dfa1a2e686efab5b6d",22899445,3,1,0,2467,353,354,1
"eff0de7f2dbb42dfa1a2e686efab5b6d","c20993c944444fe085345591a8bd837e",22899445,1,-3,0,2468,354,351,-3
"c20993c944444fe085345591a8bd837e","c20993c944444fe085345591a8bd837e",22899445,5,0,1,2469,351,351,0
"897b7f51242c44aab2205c72fdcbf4cd","897b7f51242c44aab2205c72fdcbf4cd",22899445,4,0,1,2473,352,352,0
"09b9678ddc3d452ea4a3d46e15826065","09b9678ddc3d452ea4a3d46e15826065",22899445,5,0,1,2477,353,353,0
"eff0de7f2dbb42dfa1a2e686efab5b6d","eff0de7f2dbb42dfa1a2e686efab5b6d",22899445,4,0,1,2481,354,354,0
"eff0de7f2dbb42dfa1a2e686efab5b6d","2fe14166dc9642c3bc666b86a57f943d",22899445,1,4,0,2484,354,357,3
"2fe14166dc9642c3bc666b86a57f943d","30ead9794d4847abaf222ca966cc8630",22899445,1,-10,0,2485,357,348,-9
"30ead9794d4847abaf222ca966cc8630","2fe14166dc9642c3bc666b86a57f943d",22899445,4,10,0,2486,348,357,9
"2fe14166dc9642c3bc666b86a57f943d","2fe14166dc9642c3bc666b86a57f943d",22899445,22,0,1,2487,357,357,0
"2fe14166dc9642c3bc666b86a57f943d","44421dd1e13a47a388c4a19834b744c7",22899445,2,2,0,2488,357,359,2
"44421dd1e13a47a388c4a19834b744c7","44421dd1e13a47a388c4a19834b744c7",22899445,7,0,1,2489,359,359,0
"44421dd1e13a47a388c4a19834b744c7","2fe14166dc9642c3bc666b86a57f943d",22899445,1,-2,0,2491,359,357,-2
"44421dd1e13a47a388c4a19834b744c7","cb5fc7ef85d547c4be1a7439d0bf6052",22899445,1,1,0,2498,359,360,1
"cb5fc7ef85d547c4be1a7439d0bf6052","cb5fc7ef85d547c4be1a7439d0bf6052",22899445,5,0,1,2499,360,360,0
"cb5fc7ef85d547c4be1a7439d0bf6052","0a8f150a4cf747acbde62f4721823da3",22899445,1,1,0,2504,360,361,1
"0a8f150a4cf747acbde62f4721823da3","0a8f150a4cf747acbde62f4721823da3",22899445,5,0,1,2505,361,361,0
"0a8f150a4cf747acbde62f4721823da3","ab8fdad974ae471f9f24c3f9dd04462e",22899445,1,1,0,2510,361,362,1
"ab8fdad974ae471f9f24c3f9dd04462e","ab8fdad974ae471f9f24c3f9dd04462e",22899445,5,0,1,2511,362,362,0
"ab8fdad974ae471f9f24c3f9dd04462e","1ba8fef685d74a8194b9db252eb704fb",22899445,1,-7,0,2516,362,355,-7
"1ba8fef685d74a8194b9db252eb704fb","52580888dadb4fe3baa795683ea227bd",22899445,3,10,0,2517,355,364,9
"52580888dadb4fe3baa795683ea227bd","0c4079457ede49e3aeb5e86ed84bdf35",22899445,1,-42,0,2518,364,329,-35
"0c4079457ede49e3aeb5e86ed84bdf35","f00179e251a045b39c3f7a54f9aa4acc",22899445,1,41,0,2527,329,363,34
"f00179e251a045b39c3f7a54f9aa4acc","30ead9794d4847abaf222ca966cc8630",22899445,1,-17,0,2528,363,348,-15
"30ead9794d4847abaf222ca966cc8630","52580888dadb4fe3baa795683ea227bd",22899445,2,18,0,2529,348,364,16
"52580888dadb4fe3baa795683ea227bd","2fe14166dc9642c3bc666b86a57f943d",22899445,1,-8,0,2530,364,357,-7
"2fe14166dc9642c3bc666b86a57f943d","f00179e251a045b39c3f7a54f9aa4acc",22899445,1,7,0,2531,357,363,6
"f00179e251a045b39c3f7a54f9aa4acc","1ba8fef685d74a8194b9db252eb704fb",22899445,1,-9,0,2532,363,355,-8
"52580888dadb4fe3baa795683ea227bd","f00179e251a045b39c3f7a54f9aa4acc",22899445,3,-1,0,2534,364,363,-1
"f00179e251a045b39c3f7a54f9aa4acc","52580888dadb4fe3baa795683ea227bd",22899445,1,1,0,2535,363,364,1
"52580888dadb4fe3baa795683ea227bd","52580888dadb4fe3baa795683ea227bd",22899445,18,0,1,2536,364,364,0
"f00179e251a045b39c3f7a54f9aa4acc","492a3bc6a1254f23a7998587961b22a4",22899445,3,4,0,2542,363,366,3
"492a3bc6a1254f23a7998587961b22a4","492a3bc6a1254f23a7998587961b22a4",22899445,12,0,1,2543,366,366,0
"492a3bc6a1254f23a7998587961b22a4","072a190fd302456290895f9f04d6940a",22899445,4,-1,0,2548,366,365,-1
"072a190fd302456290895f9f04d6940a","cfa457d1743848e4bb5e4beced6448ed",22899445,1,5,0,2549,365,369,4
"cfa457d1743848e4bb5e4beced6448ed","cfa457d1743848e4bb5e4beced6448ed",22899445,6,0,1,2550,369,369,0
"cfa457d1743848e4bb5e4beced6448ed","30ead9794d4847abaf222ca966cc8630",22899445,1,-25,0,2556,369,348,-21
"30ead9794d4847abaf222ca966cc8630","b71bac264efb4abd97015447bd490db6",22899445,4,28,0,2557,348,370,22
"b71bac264efb4abd97015447bd490db6","30ead9794d4847abaf222ca966cc8630",22899445,2,-28,0,2558,370,348,-22
"b71bac264efb4abd97015447bd490db6","8d448d625b024c82a5eb240bbd7431d6",22899445,10,5,0,2560,370,374,4
"8d448d625b024c82a5eb240bbd7431d6","8d448d625b024c82a5eb240bbd7431d6",22899445,127,0,1,2561,374,374,0
"8d448d625b024c82a5eb240bbd7431d6","b71bac264efb4abd97015447bd490db6",22899445,4,-5,0,2568,374,370,-4
"492a3bc6a1254f23a7998587961b22a4","b71bac264efb4abd97015447bd490db6",22899445,2,7,0,2573,366,370,4
"b71bac264efb4abd97015447bd490db6","b71bac264efb4abd97015447bd490db6",22899445,6,0,1,2574,370,370,0
"8d448d625b024c82a5eb240bbd7431d6","0c4079457ede49e3aeb5e86ed84bdf35",22899445,1,-57,0,2583,374,329,-45
"0c4079457ede49e3aeb5e86ed84bdf35","1ba8fef685d74a8194b9db252eb704fb",22899445,1,32,0,2587,329,355,26
"1ba8fef685d74a8194b9db252eb704fb","1ba8fef685d74a8194b9db252eb704fb",22899445,2,0,1,2588,355,355,0
"1ba8fef685d74a8194b9db252eb704fb","30ead9794d4847abaf222ca966cc8630",22899445,2,-8,0,2589,355,348,-7
"2fe14166dc9642c3bc666b86a57f943d","52580888dadb4fe3baa795683ea227bd",22899445,2,8,0,2605,357,364,7
"52580888dadb4fe3baa795683ea227bd","1ba8fef685d74a8194b9db252eb704fb",22899445,2,-10,0,2606,364,355,-9
"52580888dadb4fe3baa795683ea227bd","492a3bc6a1254f23a7998587961b22a4",22899445,1,3,0,2621,364,366,2
"492a3bc6a1254f23a7998587961b22a4","f00179e251a045b39c3f7a54f9aa4acc",22899445,1,-4,0,2622,366,363,-3
"072a190fd302456290895f9f04d6940a","30ead9794d4847abaf222ca966cc8630",22899445,5,-20,0,2632,365,348,-17
"8d448d625b024c82a5eb240bbd7431d6","fab84b4fab5940efb4ea868ef8d09396",22899445,1,-119,0,2673,374,284,-90
"fab84b4fab5940efb4ea868ef8d09396","fab84b4fab5940efb4ea868ef8d09396",22899445,3,0,1,2674,284,284,0
"fab84b4fab5940efb4ea868ef8d09396","b71bac264efb4abd97015447bd490db6",22899445,2,114,0,2676,284,370,86
"8d448d625b024c82a5eb240bbd7431d6","c2490bc612d146edbe786556fab3651b",22899445,1,-44,0,2686,374,340,-34
"c2490bc612d146edbe786556fab3651b","0c4079457ede49e3aeb5e86ed84bdf35",22899445,2,-13,0,2687,340,329,-11
"0c4079457ede49e3aeb5e86ed84bdf35","bbc5139ca9024389a94db3a6f47dcff6",22899445,1,14,0,2688,329,341,12
"bbc5139ca9024389a94db3a6f47dcff6","c2490bc612d146edbe786556fab3651b",22899445,1,-1,0,2694,341,340,-1
"0c4079457ede49e3aeb5e86ed84bdf35","30ead9794d4847abaf222ca966cc8630",22899445,1,24,0,2696,329,348,19
"30ead9794d4847abaf222ca966cc8630","897b7f51242c44aab2205c72fdcbf4cd",22899445,1,4,0,2697,348,352,4
"897b7f51242c44aab2205c72fdcbf4cd","c20993c944444fe085345591a8bd837e",22899445,1,-1,0,2698,352,351,-1
"c20993c944444fe085345591a8bd837e","09b9678ddc3d452ea4a3d46e15826065",22899445,1,2,0,2701,351,353,2
"eff0de7f2dbb42dfa1a2e686efab5b6d","897b7f51242c44aab2205c72fdcbf4cd",22899445,1,-2,0,2706,354,352,-2
"897b7f51242c44aab2205c72fdcbf4cd","eff0de7f2dbb42dfa1a2e686efab5b6d",22899445,1,2,0,2708,352,354,2
"eff0de7f2dbb42dfa1a2e686efab5b6d","30ead9794d4847abaf222ca966cc8630",22899445,1,-6,0,2709,354,348,-6
"2fe14166dc9642c3bc666b86a57f943d","072a190fd302456290895f9f04d6940a",22899445,1,10,0,2711,357,365,8
"072a190fd302456290895f9f04d6940a","072a190fd302456290895f9f04d6940a",22899445,3,0,1,2712,365,365,0
"30ead9794d4847abaf222ca966cc8630","072a190fd302456290895f9f04d6940a",22899445,2,20,0,2715,348,365,17
"072a190fd302456290895f9f04d6940a","492a3bc6a1254f23a7998587961b22a4",22899445,2,1,0,2716,365,366,1
"8d448d625b024c82a5eb240bbd7431d6","4a29443515bb404cb8924e1c60a63b73",22899445,2,-115,0,2730,374,285,-89
"4a29443515bb404cb8924e1c60a63b73","1ba8fef685d74a8194b9db252eb704fb",22899445,1,90,0,2731,285,355,70
"1ba8fef685d74a8194b9db252eb704fb","072a190fd302456290895f9f04d6940a",22899445,1,12,0,2744,355,365,10
"30ead9794d4847abaf222ca966cc8630","492a3bc6a1254f23a7998587961b22a4",22899445,1,21,0,2747,348,366,18
"4a29443515bb404cb8924e1c60a63b73","0c787d16c9504873b1a4d903cec09948",22899445,1,38,0,2765,285,314,29
"0c787d16c9504873b1a4d903cec09948","3434c10e561d488a914e0f7d71907abd",22899445,1,-11,0,2766,314,305,-9
"3434c10e561d488a914e0f7d71907abd","b71bac264efb4abd97015447bd490db6",22899445,1,83,0,2767,305,370,65
"b71bac264efb4abd97015447bd490db6","d6d02b6ef04e4f17805504500b8ce441",22899445,3,8,0,2813,370,375,5
"d6d02b6ef04e4f17805504500b8ce441","d6d02b6ef04e4f17805504500b8ce441",22899445,9,0,1,2814,375,375,0
"d6d02b6ef04e4f17805504500b8ce441","b71bac264efb4abd97015447bd490db6",22899445,2,-8,0,2816,375,370,-5
"d6d02b6ef04e4f17805504500b8ce441","8d448d625b024c82a5eb240bbd7431d6",22899445,1,-3,0,2818,375,374,-1
"8d448d625b024c82a5eb240bbd7431d6","d6d02b6ef04e4f17805504500b8ce441",22899445,1,3,0,2826,374,375,1
"d6d02b6ef04e4f17805504500b8ce441","fab84b4fab5940efb4ea868ef8d09396",22899445,1,-122,0,2831,375,284,-91
"8d448d625b024c82a5eb240bbd7431d6","3cbcea2be0984e7dbd5a48195af10ce7",22899445,1,-281,0,2842,374,165,-209
"3cbcea2be0984e7dbd5a48195af10ce7","82e6285962b8400d9d6fc32436022a94",22899445,9,2,0,2843,165,167,2
"82e6285962b8400d9d6fc32436022a94","d6d02b6ef04e4f17805504500b8ce441",22899445,1,282,0,2844,167,375,208
"d6d02b6ef04e4f17805504500b8ce441","66baf19b6b904b70922329068c63746d",22899445,1,4,0,2851,375,376,1
"66baf19b6b904b70922329068c63746d","7f544639412e40a9ba27f43b415362ab",22899445,4,2,0,2852,376,378,2
"7f544639412e40a9ba27f43b415362ab","7f544639412e40a9ba27f43b415362ab",22899445,4,0,1,2853,378,378,0
"7f544639412e40a9ba27f43b415362ab","d5ae8642e15b46b8bd298b02274d4e9c",22899445,1,2,0,2857,378,380,2
"d5ae8642e15b46b8bd298b02274d4e9c","d5ae8642e15b46b8bd298b02274d4e9c",22899445,8,0,1,2858,380,380,0
"d5ae8642e15b46b8bd298b02274d4e9c","a0d10309a2dd456289147f84be9d37f9",22899445,2,1,0,2859,380,381,1
"a0d10309a2dd456289147f84be9d37f9","a0d10309a2dd456289147f84be9d37f9",22899445,7,0,1,2860,381,381,0
"a0d10309a2dd456289147f84be9d37f9","d5ae8642e15b46b8bd298b02274d4e9c",22899445,1,-1,0,2862,381,380,-1
"a0d10309a2dd456289147f84be9d37f9","0fcbc3ca07b144138b8d85da581f09a8",22899445,1,1,0,2876,381,382,1
"0fcbc3ca07b144138b8d85da581f09a8","0fcbc3ca07b144138b8d85da581f09a8",22899445,8,0,1,2877,382,382,0
"0fcbc3ca07b144138b8d85da581f09a8","66baf19b6b904b70922329068c63746d",22899445,1,-6,0,2885,382,376,-6
"66baf19b6b904b70922329068c63746d","c2fca3669923477ab966ded303dea31c",22899445,1,8,0,2886,376,383,7
"c2fca3669923477ab966ded303dea31c","4890121ce5d74576b4632b77cfc23398",22899445,1,6,0,2887,383,388,5
"4890121ce5d74576b4632b77cfc23398","4890121ce5d74576b4632b77cfc23398",22899445,2,0,1,2888,388,388,0
"4890121ce5d74576b4632b77cfc23398","18d3b836dd804224883cc9180b60a8e1",22899445,2,-1,0,2890,388,387,-1
"18d3b836dd804224883cc9180b60a8e1","96bb2b3e85a34d8b9544514e89f6fe97",22899445,2,4,0,2891,387,390,3
"96bb2b3e85a34d8b9544514e89f6fe97","96bb2b3e85a34d8b9544514e89f6fe97",22899445,3,0,1,2892,390,390,0
"96bb2b3e85a34d8b9544514e89f6fe97","ac4e9b54acfe4670b4634859c7263cb5",22899445,1,2,0,2895,390,392,2
"ac4e9b54acfe4670b4634859c7263cb5","ac4e9b54acfe4670b4634859c7263cb5",22899445,3,0,1,2896,392,392,0
"ac4e9b54acfe4670b4634859c7263cb5","6f8881a745ac4c358a68b92c3b4abe81",22899445,1,3,0,2899,392,394,2
"6f8881a745ac4c358a68b92c3b4abe81","17f95d18bab743888e1736033dc3384d",22899445,2,-6,0,2900,394,389,-5
"17f95d18bab743888e1736033dc3384d","6f8881a745ac4c358a68b92c3b4abe81",22899445,1,6,0,2901,389,394,5
"6f8881a745ac4c358a68b92c3b4abe81","6f8881a745ac4c358a68b92c3b4abe81",22899445,4,0,1,2902,394,394,0
"6f8881a745ac4c358a68b92c3b4abe81","f7002c8484354eceac57bc7bd62c76c1",22899445,2,-1,0,2903,394,393,-1
"f7002c8484354eceac57bc7bd62c76c1","6f8881a745ac4c358a68b92c3b4abe81",22899445,1,1,0,2904,393,394,1
"6f8881a745ac4c358a68b92c3b4abe81","0c12af0a4e7f4002852cf84b2537c161",22899445,1,2,0,2905,394,395,1
"0c12af0a4e7f4002852cf84b2537c161","6f8881a745ac4c358a68b92c3b4abe81",22899445,1,-2,0,2906,395,394,-1
"f7002c8484354eceac57bc7bd62c76c1","44a277ea44dc4ae689fab4b82f0b4098",22899445,2,5,0,2911,393,397,4
"44a277ea44dc4ae689fab4b82f0b4098","44a277ea44dc4ae689fab4b82f0b4098",22899445,5,0,1,2912,397,397,0
"44a277ea44dc4ae689fab4b82f0b4098","66baf19b6b904b70922329068c63746d",22899445,1,-26,0,2914,397,376,-21
"7f544639412e40a9ba27f43b415362ab","66baf19b6b904b70922329068c63746d",22899445,1,-2,0,2916,378,376,-2
"66baf19b6b904b70922329068c63746d","4890121ce5d74576b4632b77cfc23398",22899445,1,14,0,2917,376,388,12
"96bb2b3e85a34d8b9544514e89f6fe97","c2fca3669923477ab966ded303dea31c",22899445,1,-9,0,2920,390,383,-7
"c2fca3669923477ab966ded303dea31c","6f8881a745ac4c358a68b92c3b4abe81",22899445,1,14,0,2921,383,394,11
"17f95d18bab743888e1736033dc3384d","f7002c8484354eceac57bc7bd62c76c1",22899445,1,5,0,2923,389,393,4
"44a277ea44dc4ae689fab4b82f0b4098","0c12af0a4e7f4002852cf84b2537c161",22899445,1,-2,0,2928,397,395,-2
"0c12af0a4e7f4002852cf84b2537c161","859e0b8d71694b12befb69ee698138f9",22899445,1,5,0,2929,395,399,4
"859e0b8d71694b12befb69ee698138f9","859e0b8d71694b12befb69ee698138f9",22899445,3,0,1,2930,399,399,0
"859e0b8d71694b12befb69ee698138f9","2b09a08242b54983aec7063990fb3f66",22899445,1,3,0,2933,399,400,1
"2b09a08242b54983aec7063990fb3f66","66baf19b6b904b70922329068c63746d",22899445,1,-32,0,2934,400,376,-24
"66baf19b6b904b70922329068c63746d","2b09a08242b54983aec7063990fb3f66",22899445,1,32,0,2935,376,400,24
"2b09a08242b54983aec7063990fb3f66","2b09a08242b54983aec7063990fb3f66",22899445,5,0,1,2936,400,400,0
"2b09a08242b54983aec7063990fb3f66","1f471b7a883a4df48211e8c6a81b59a7",22899445,1,1,0,2941,400,401,1
"1f471b7a883a4df48211e8c6a81b59a7","1f471b7a883a4df48211e8c6a81b59a7",22899445,3,0,1,2942,401,401,0
"1f471b7a883a4df48211e8c6a81b59a7","2b09a08242b54983aec7063990fb3f66",22899445,1,-1,0,2945,401,400,-1
"2b09a08242b54983aec7063990fb3f66","9de0d567bfa84fe5b77cb76f4a76a5d1",22899445,1,5,0,2946,400,404,4
"9de0d567bfa84fe5b77cb76f4a76a5d1","9de0d567bfa84fe5b77cb76f4a76a5d1",22899445,3,0,1,2947,404,404,0
"9de0d567bfa84fe5b77cb76f4a76a5d1","1157bd665ec4472fb58b751dc5099355",22899445,1,-1,0,2950,404,403,-1
"1157bd665ec4472fb58b751dc5099355","58fc9094275e4c49be3f4ba6d4acc0a4",22899445,1,5,0,2951,403,406,3
"58fc9094275e4c49be3f4ba6d4acc0a4","3c8a22d2f9c146ea956609e3ed4f2559",22899445,1,-2,0,2952,406,405,-1
"3c8a22d2f9c146ea956609e3ed4f2559","58fc9094275e4c49be3f4ba6d4acc0a4",22899445,1,2,0,2953,405,406,1
"58fc9094275e4c49be3f4ba6d4acc0a4","02b3a1bead9244c1ba2f857c7da8f82a",22899445,1,3,0,2954,406,408,2
"02b3a1bead9244c1ba2f857c7da8f82a","02b3a1bead9244c1ba2f857c7da8f82a",22899445,2,0,1,2955,408,408,0
"02b3a1bead9244c1ba2f857c7da8f82a","6206fc6479014bb193084c32409dc1b9",22899445,1,1,0,2957,408,409,1
"6206fc6479014bb193084c32409dc1b9","6206fc6479014bb193084c32409dc1b9",22899445,5,0,1,2958,409,409,0
"6206fc6479014bb193084c32409dc1b9","02b3a1bead9244c1ba2f857c7da8f82a",22899445,1,-1,0,2963,409,408,-1
"02b3a1bead9244c1ba2f857c7da8f82a","6a5f020451db426dacba9e2ea3fcc62a",22899445,1,3,0,2964,408,410,2
"6a5f020451db426dacba9e2ea3fcc62a","6a5f020451db426dacba9e2ea3fcc62a",22899445,2,0,1,2965,410,410,0
"6a5f020451db426dacba9e2ea3fcc62a","33a9d248b2e44588a5b07fc1342b9bc2",22899445,1,2,0,2967,410,411,1
"33a9d248b2e44588a5b07fc1342b9bc2","33a9d248b2e44588a5b07fc1342b9bc2",22899445,9,0,1,2968,411,411,0
"33a9d248b2e44588a5b07fc1342b9bc2","c6f26bd420634f1cb7989e76fe6b16c0",22899445,1,1,0,2970,411,412,1
"c6f26bd420634f1cb7989e76fe6b16c0","c6f26bd420634f1cb7989e76fe6b16c0",22899445,17,0,1,2971,412,412,0
"c6f26bd420634f1cb7989e76fe6b16c0","2a65ee6e2ac64f6a8a55fbe5373ec763",22899445,1,1,0,2988,412,413,1
"2a65ee6e2ac64f6a8a55fbe5373ec763","2a65ee6e2ac64f6a8a55fbe5373ec763",22899445,8,0,1,2989,413,413,0
"2a65ee6e2ac64f6a8a55fbe5373ec763","33a9d248b2e44588a5b07fc1342b9bc2",22899445,1,-2,0,2997,413,411,-2
"33a9d248b2e44588a5b07fc1342b9bc2","687055dad9fc40c3982478fe33ec01bf",22899445,1,4,0,2998,411,414,3
"687055dad9fc40c3982478fe33ec01bf","33a9d248b2e44588a5b07fc1342b9bc2",22899445,1,-4,0,2999,414,411,-3
"33a9d248b2e44588a5b07fc1342b9bc2","1fd0f6dadbc14ebc965faf6122190b96",22899445,1,5,0,3007,411,415,4
"1fd0f6dadbc14ebc965faf6122190b96","1fd0f6dadbc14ebc965faf6122190b96",22899445,3,0,1,3008,415,415,0
"1fd0f6dadbc14ebc965faf6122190b96","687055dad9fc40c3982478fe33ec01bf",22899445,1,-1,0,3011,415,414,-1
"687055dad9fc40c3982478fe33ec01bf","2add1669f08d4101913db15f8c23b3b7",22899445,1,3,0,3012,414,416,2
"2add1669f08d4101913db15f8c23b3b7","2add1669f08d4101913db15f8c23b3b7",22899445,3,0,1,3013,416,416,0
"2add1669f08d4101913db15f8c23b3b7","2b09a08242b54983aec7063990fb3f66",22899445,1,-24,0,3016,416,400,-16
"2b09a08242b54983aec7063990fb3f66","a2b4bd40cee2481ebd3fc179d6a5cd62",22899445,1,27,0,3017,400,417,17
"a2b4bd40cee2481ebd3fc179d6a5cd62","e34e59dce2204f228f3a84b6725df60f",22899445,1,2,0,3018,417,419,2
"e34e59dce2204f228f3a84b6725df60f","e34e59dce2204f228f3a84b6725df60f",22899445,4,0,1,3019,419,419,0
"e34e59dce2204f228f3a84b6725df60f","a2b4bd40cee2481ebd3fc179d6a5cd62",22899445,1,-2,0,3023,419,417,-2
"a2b4bd40cee2481ebd3fc179d6a5cd62","bec48fc2e1294c7eb3d0aca780d731b8",22899445,2,4,0,3024,417,420,3
"bec48fc2e1294c7eb3d0aca780d731b8","bec48fc2e1294c7eb3d0aca780d731b8",22899445,6,0,1,3025,420,420,0
"bec48fc2e1294c7eb3d0aca780d731b8","dbde19fcce2a4c1abdc7f685c293a23f",22899445,2,3,0,3030,420,422,2
"dbde19fcce2a4c1abdc7f685c293a23f","a24600b0e49245f6bdba8c893cfeddb0",22899445,2,4,0,3031,422,425,3
"a24600b0e49245f6bdba8c893cfeddb0","a24600b0e49245f6bdba8c893cfeddb0",22899445,4,0,1,3032,425,425,0
"a24600b0e49245f6bdba8c893cfeddb0","24cf8786024543f19b89bc20034e60d7",22899445,1,7,0,3035,425,428,3
"24cf8786024543f19b89bc20034e60d7","a2b4bd40cee2481ebd3fc179d6a5cd62",22899445,1,-18,0,3036,428,417,-11
"a2b4bd40cee2481ebd3fc179d6a5cd62","f2a73be2f46840b182d7bd095378004e",22899445,1,19,0,3037,417,429,12
"f2a73be2f46840b182d7bd095378004e","24cf8786024543f19b89bc20034e60d7",22899445,4,-1,0,3038,429,428,-1
"24cf8786024543f19b89bc20034e60d7","24cf8786024543f19b89bc20034e60d7",22899445,3,0,1,3039,428,428,0
"24cf8786024543f19b89bc20034e60d7","f2a73be2f46840b182d7bd095378004e",22899445,4,1,0,3041,428,429,1
"f2a73be2f46840b182d7bd095378004e","f2a73be2f46840b182d7bd095378004e",22899445,4,0,1,3044,429,429,0
"f2a73be2f46840b182d7bd095378004e","604551fd4266430cb860fef58fa7dd61",22899445,1,1,0,3051,429,430,1
"604551fd4266430cb860fef58fa7dd61","604551fd4266430cb860fef58fa7dd61",22899445,6,0,1,3052,430,430,0
"604551fd4266430cb860fef58fa7dd61","dce46f8904594a62a6377a3587aaa663",22899445,1,2,0,3058,430,431,1
"dce46f8904594a62a6377a3587aaa663","24cf8786024543f19b89bc20034e60d7",22899445,1,-4,0,3059,431,428,-3
"24cf8786024543f19b89bc20034e60d7","dce46f8904594a62a6377a3587aaa663",22899445,2,4,0,3060,428,431,3
"dce46f8904594a62a6377a3587aaa663","dce46f8904594a62a6377a3587aaa663",22899445,7,0,1,3061,431,431,0
"dce46f8904594a62a6377a3587aaa663","9b9d0a249052413c869753b99682b0ac",22899445,1,1,0,3067,431,432,1
"9b9d0a249052413c869753b99682b0ac","9b9d0a249052413c869753b99682b0ac",22899445,5,0,1,3068,432,432,0
"9b9d0a249052413c869753b99682b0ac","061c175cc90f45fbad883025394e78dd",22899445,1,1,0,3073,432,433,1
"061c175cc90f45fbad883025394e78dd","061c175cc90f45fbad883025394e78dd",22899445,5,0,1,3074,433,433,0
"061c175cc90f45fbad883025394e78dd","dce46f8904594a62a6377a3587aaa663",22899445,1,-2,0,3079,433,431,-2
"dce46f8904594a62a6377a3587aaa663","74a7f8712e5449c2bc0b43c6f90dafed",22899445,1,5,0,3080,431,435,4
"74a7f8712e5449c2bc0b43c6f90dafed","74a7f8712e5449c2bc0b43c6f90dafed",22899445,10,0,1,3081,435,435,0
"74a7f8712e5449c2bc0b43c6f90dafed","66ada10dde9f43018588f1ced9d477fc",22899445,1,-1,0,3091,435,434,-1
"66ada10dde9f43018588f1ced9d477fc","bf12c96466d840a69bed7020b3f18bb8",22899445,1,3,0,3092,434,436,2
"bf12c96466d840a69bed7020b3f18bb8","bf12c96466d840a69bed7020b3f18bb8",22899445,3,0,1,3093,436,436,0
"bf12c96466d840a69bed7020b3f18bb8","070600601c4c439288445d2f0724807d",22899445,1,3,0,3096,436,437,1
"070600601c4c439288445d2f0724807d","24cf8786024543f19b89bc20034e60d7",22899445,2,-14,0,3097,437,428,-9
"24cf8786024543f19b89bc20034e60d7","1823b6de7d334a7aaabc4570719af4d9",22899445,2,16,0,3098,428,439,11
"1823b6de7d334a7aaabc4570719af4d9","070600601c4c439288445d2f0724807d",22899445,2,-2,0,3099,439,437,-2
"070600601c4c439288445d2f0724807d","1823b6de7d334a7aaabc4570719af4d9",22899445,2,2,0,3100,437,439,2
"1823b6de7d334a7aaabc4570719af4d9","1823b6de7d334a7aaabc4570719af4d9",22899445,21,0,1,3101,439,439,0
"070600601c4c439288445d2f0724807d","0380cd76a7d44bc3a4da1f15e4d68f89",22899445,3,4,0,3123,437,440,3
"0380cd76a7d44bc3a4da1f15e4d68f89","0380cd76a7d44bc3a4da1f15e4d68f89",22899445,3,0,1,3124,440,440,0
"0380cd76a7d44bc3a4da1f15e4d68f89","070600601c4c439288445d2f0724807d",22899445,2,-4,0,3125,440,437,-3
"0380cd76a7d44bc3a4da1f15e4d68f89","23b7673c8b5443108c2ef09382834a86",22899445,2,2,0,3129,440,441,1
"23b7673c8b5443108c2ef09382834a86","23b7673c8b5443108c2ef09382834a86",22899445,7,0,1,3130,441,441,0
"23b7673c8b5443108c2ef09382834a86","56586aa865414f538729c7f7735d2bc6",22899445,1,-602,0,3133,441,12,-429
"b7f2b31585d94eb3bf86376714aa7070","b7f2b31585d94eb3bf86376714aa7070",22899445,13,0,1,3139,13,13,0
"3f1c815879794b929260d224becaff7e","c9c52446b6294aa5a9c2abaed536c37e",22899445,1,33,0,3173,14,32,18
"c9c52446b6294aa5a9c2abaed536c37e","4e51676dc72045d99c19b9fa7b22f8bc",22899445,1,-5,0,3174,32,29,-3
"4e51676dc72045d99c19b9fa7b22f8bc","4e51676dc72045d99c19b9fa7b22f8bc",22899445,2,0,1,3175,29,29,0
"4e51676dc72045d99c19b9fa7b22f8bc","c33c17be71ae4d588da7369472e5bb1b",22899445,4,9,0,3176,29,34,5
"c33c17be71ae4d588da7369472e5bb1b","4e51676dc72045d99c19b9fa7b22f8bc",22899445,1,-9,0,3177,34,29,-5
"c33c17be71ae4d588da7369472e5bb1b","93679be414554a11b1893002f2229a93",22899445,6,3,0,3179,34,35,1
"93679be414554a11b1893002f2229a93","c33c17be71ae4d588da7369472e5bb1b",22899445,3,-3,0,3180,35,34,-1
"93679be414554a11b1893002f2229a93","7040a13096d746ac84b8fac8d9752058",22899445,3,3,0,3184,35,36,1
"7040a13096d746ac84b8fac8d9752058","9a0dc646f934470daf08c4b56ccf73db",22899445,3,3,0,3185,36,37,1
"9a0dc646f934470daf08c4b56ccf73db","7040a13096d746ac84b8fac8d9752058",22899445,1,-3,0,3186,37,36,-1
"9a0dc646f934470daf08c4b56ccf73db","fc0e049d56024bc9a02c9a9c435c3df7",22899445,2,3,0,3188,37,38,1
"fc0e049d56024bc9a02c9a9c435c3df7","67a089198fcb4e1c8f2385786c2b296f",22899445,2,4,0,3189,38,39,1
"67a089198fcb4e1c8f2385786c2b296f","fc0e049d56024bc9a02c9a9c435c3df7",22899445,2,-4,0,3190,39,38,-1
"fc0e049d56024bc9a02c9a9c435c3df7","64d48c6c9c7940639a932219a6c87198",22899445,2,5,0,3191,38,40,2
"64d48c6c9c7940639a932219a6c87198","070600601c4c439288445d2f0724807d",22899445,1,538,0,3192,40,437,397
"070600601c4c439288445d2f0724807d","23b7673c8b5443108c2ef09382834a86",22899445,1,6,0,3193,437,441,4
"23b7673c8b5443108c2ef09382834a86","901e92500aea43c79f19f1b279050668",22899445,3,2,0,3198,441,442,1
"901e92500aea43c79f19f1b279050668","901e92500aea43c79f19f1b279050668",22899445,6,0,1,3199,442,442,0
"901e92500aea43c79f19f1b279050668","23b7673c8b5443108c2ef09382834a86",22899445,2,-2,0,3200,442,441,-1
"901e92500aea43c79f19f1b279050668","001339db8ced4cf78829ebe8b145449d",22899445,2,1,0,3203,442,443,1
"001339db8ced4cf78829ebe8b145449d","001339db8ced4cf78829ebe8b145449d",22899445,10,0,1,3204,443,443,0
"001339db8ced4cf78829ebe8b145449d","901e92500aea43c79f19f1b279050668",22899445,1,-1,0,3209,443,442,-1
"001339db8ced4cf78829ebe8b145449d","452745e0366e42ae81561bfddebcc6c3",22899445,1,1,0,3216,443,444,1
"452745e0366e42ae81561bfddebcc6c3","452745e0366e42ae81561bfddebcc6c3",22899445,8,0,1,3217,444,444,0
"452745e0366e42ae81561bfddebcc6c3","901e92500aea43c79f19f1b279050668",22899445,1,-2,0,3225,444,442,-2
"901e92500aea43c79f19f1b279050668","4660ff2089114e8db82ceb26a4f329e3",22899445,1,4,0,3226,442,445,3
"4660ff2089114e8db82ceb26a4f329e3","4660ff2089114e8db82ceb26a4f329e3",22899445,4,0,1,3227,445,445,0
"4660ff2089114e8db82ceb26a4f329e3","7bd5586eb9d8484eb74a433ee7bfe499",22899445,1,2,0,3231,445,446,1
"7bd5586eb9d8484eb74a433ee7bfe499","7bd5586eb9d8484eb74a433ee7bfe499",22899445,13,0,1,3232,446,446,0
"7bd5586eb9d8484eb74a433ee7bfe499","67a089198fcb4e1c8f2385786c2b296f",22899445,1,-553,0,3245,446,39,-407
"64d48c6c9c7940639a932219a6c87198","fc0e049d56024bc9a02c9a9c435c3df7",22899445,1,-5,0,3247,40,38,-2
"fc0e049d56024bc9a02c9a9c435c3df7","fc0e049d56024bc9a02c9a9c435c3df7",22899445,1,0,1,3248,38,38,0
"fc0e049d56024bc9a02c9a9c435c3df7","9a0dc646f934470daf08c4b56ccf73db",22899445,1,-3,0,3249,38,37,-1
"9a0dc646f934470daf08c4b56ccf73db","070600601c4c439288445d2f0724807d",22899445,1,546,0,3250,37,437,400
"070600601c4c439288445d2f0724807d","070600601c4c439288445d2f0724807d",22899445,3,0,1,3251,437,437,0
"070600601c4c439288445d2f0724807d","8a7f26e690f34dda97be16904518ca99",22899445,1,16,0,3252,437,447,10
"8a7f26e690f34dda97be16904518ca99","8a7f26e690f34dda97be16904518ca99",22899445,3,0,1,3253,447,447,0
"8a7f26e690f34dda97be16904518ca99","070600601c4c439288445d2f0724807d",22899445,1,-16,0,3256,447,437,-10
"070600601c4c439288445d2f0724807d","b2f0d654738f48158edff28e8d3a546e",22899445,1,21,0,3257,437,449,12
"b2f0d654738f48158edff28e8d3a546e","24cf8786024543f19b89bc20034e60d7",22899445,1,-35,0,3258,449,428,-21
"24cf8786024543f19b89bc20034e60d7","bec48fc2e1294c7eb3d0aca780d731b8",22899445,1,-14,0,3259,428,420,-8
"bec48fc2e1294c7eb3d0aca780d731b8","a2b4bd40cee2481ebd3fc179d6a5cd62",22899445,1,-4,0,3260,420,417,-3
"a24600b0e49245f6bdba8c893cfeddb0","a2b4bd40cee2481ebd3fc179d6a5cd62",22899445,1,-11,0,3266,425,417,-8
"a2b4bd40cee2481ebd3fc179d6a5cd62","24cf8786024543f19b89bc20034e60d7",22899445,1,18,0,3267,417,428,11
"dce46f8904594a62a6377a3587aaa663","66ada10dde9f43018588f1ced9d477fc",22899445,1,4,0,3272,431,434,3
"66ada10dde9f43018588f1ced9d477fc","24cf8786024543f19b89bc20034e60d7",22899445,1,-8,0,3273,434,428,-6
"24cf8786024543f19b89bc20034e60d7","070600601c4c439288445d2f0724807d",22899445,1,14,0,3274,428,437,9
"1823b6de7d334a7aaabc4570719af4d9","0380cd76a7d44bc3a4da1f15e4d68f89",22899445,1,2,0,3278,439,440,1
"23b7673c8b5443108c2ef09382834a86","070600601c4c439288445d2f0724807d",22899445,1,-6,0,3284,441,437,-4
"1823b6de7d334a7aaabc4570719af4d9","b2f0d654738f48158edff28e8d3a546e",22899445,1,19,0,3287,439,449,10
"b2f0d654738f48158edff28e8d3a546e","512364d4619742bb9e4e531f07ceaed7",22899445,1,2,0,3288,449,451,2
"512364d4619742bb9e4e531f07ceaed7","512364d4619742bb9e4e531f07ceaed7",22899445,3,0,1,3289,451,451,0
"512364d4619742bb9e4e531f07ceaed7","0c4079457ede49e3aeb5e86ed84bdf35",22899445,1,-178,0,3292,451,329,-122
"38aea304b4fa46e1b29bb72f5cea4c93","0c7262dff33c4087bc660ccf40f92f9c",22899445,1,-217,0,3294,331,169,-162
"0c7262dff33c4087bc660ccf40f92f9c","b2f0d654738f48158edff28e8d3a546e",22899445,1,391,0,3295,169,449,280
"b2f0d654738f48158edff28e8d3a546e","b2f0d654738f48158edff28e8d3a546e",22899445,5,0,1,3296,449,449,0
"b2f0d654738f48158edff28e8d3a546e","f60ee41ec635499abd48168342d32c2f",22899445,7,5,0,3297,449,453,4
"f60ee41ec635499abd48168342d32c2f","f60ee41ec635499abd48168342d32c2f",22899445,61,0,1,3298,453,453,0
"f60ee41ec635499abd48168342d32c2f","b2f0d654738f48158edff28e8d3a546e",22899445,6,-5,0,3300,453,449,-4
"f60ee41ec635499abd48168342d32c2f","f67fbf45a5f146ed866965bc57c7c001",22899445,1,3,0,3361,453,454,1
"f67fbf45a5f146ed866965bc57c7c001","b2f0d654738f48158edff28e8d3a546e",22899445,2,-8,0,3362,454,449,-5
"b2f0d654738f48158edff28e8d3a546e","f67fbf45a5f146ed866965bc57c7c001",22899445,1,8,0,3377,449,454,5
"b2f0d654738f48158edff28e8d3a546e","0c7262dff33c4087bc660ccf40f92f9c",22899445,1,-391,0,3379,449,169,-280
"0c7262dff33c4087bc660ccf40f92f9c","66baf19b6b904b70922329068c63746d",22899445,1,279,0,3380,169,376,207
"7f544639412e40a9ba27f43b415362ab","f67fbf45a5f146ed866965bc57c7c001",22899445,1,118,0,3382,378,454,76
"f67fbf45a5f146ed866965bc57c7c001","f67fbf45a5f146ed866965bc57c7c001",22899445,12,0,1,3383,454,454,0
"f67fbf45a5f146ed866965bc57c7c001","c5df9f40ec14463b9dcfdc73df3e9285",22899445,3,12,0,3384,454,464,10
"c5df9f40ec14463b9dcfdc73df3e9285","c5df9f40ec14463b9dcfdc73df3e9285",22899445,5,0,1,3385,464,464,0
"c5df9f40ec14463b9dcfdc73df3e9285","67a089198fcb4e1c8f2385786c2b296f",22899445,1,-580,0,3386,464,39,-425
"67a089198fcb4e1c8f2385786c2b296f","67a089198fcb4e1c8f2385786c2b296f",22899445,8,0,1,3387,39,39,0
"64d48c6c9c7940639a932219a6c87198","64d48c6c9c7940639a932219a6c87198",22899445,8,0,1,3389,40,40,0
"6e13d61a7bdb44bca949c9f86fab3be5","d0c74f735e024943943e40333d6d337f",22899445,1,5,0,3412,47,51,4
"d0c74f735e024943943e40333d6d337f","78f30e4dcac84e3cbea8b2cc6e0d62b3",22899445,1,9,0,3429,51,59,8
"78f30e4dcac84e3cbea8b2cc6e0d62b3","f924752d8a1149668870b1e7698486f7",22899445,1,-10,0,3430,59,50,-9
"a1f2f12debe5432fb7a70bcd12bacfb9","a0a418b8540d479fa6e0f653b701da8b",22899445,1,7,0,3432,58,64,6
"a2becd407db34b189200a32546d9d569","d18a9ea32855445f8736581f5cb119ce",22899445,1,8,0,3441,75,82,7
"d18a9ea32855445f8736581f5cb119ce","e20db35ced8544ddac5bc3839145e463",22899445,1,13,0,3442,82,91,9
"e20db35ced8544ddac5bc3839145e463","e2911e79efc2420eac45d9f671463d4b",22899445,1,-136,0,3446,91,2,-89
"e2911e79efc2420eac45d9f671463d4b","f67fbf45a5f146ed866965bc57c7c001",22899445,1,637,0,3460,2,454,452
"f67fbf45a5f146ed866965bc57c7c001","d937afe49bd24a07a550dda1c1155122",22899445,1,1,0,3472,454,455,1
"d937afe49bd24a07a550dda1c1155122","d937afe49bd24a07a550dda1c1155122",22899445,5,0,1,3473,455,455,0
"d937afe49bd24a07a550dda1c1155122","3628b3f7823443d0912a339096b69943",22899445,1,1,0,3478,455,456,1
"3628b3f7823443d0912a339096b69943","3628b3f7823443d0912a339096b69943",22899445,3,0,1,3479,456,456,0
"3628b3f7823443d0912a339096b69943","9e049ee647cf43ecbcb5ed792a8e7588",22899445,1,1,0,3482,456,457,1
"9e049ee647cf43ecbcb5ed792a8e7588","9e049ee647cf43ecbcb5ed792a8e7588",22899445,5,0,1,3483,457,457,0
"9e049ee647cf43ecbcb5ed792a8e7588","5256a214faaf410b93f76cea06428334",22899445,1,1,0,3488,457,458,1
"5256a214faaf410b93f76cea06428334","5256a214faaf410b93f76cea06428334",22899445,5,0,1,3489,458,458,0
"5256a214faaf410b93f76cea06428334","25c32b120fce40fa9b6c85133aeb4716",22899445,1,1,0,3494,458,459,1
"25c32b120fce40fa9b6c85133aeb4716","25c32b120fce40fa9b6c85133aeb4716",22899445,5,0,1,3495,459,459,0
"25c32b120fce40fa9b6c85133aeb4716","11bc14f2204949008b7d511b933363c1",22899445,1,1,0,3500,459,460,1
"11bc14f2204949008b7d511b933363c1","11bc14f2204949008b7d511b933363c1",22899445,5,0,1,3501,460,460,0
"11bc14f2204949008b7d511b933363c1","42de338840a34d15adb66e7b14fb9d2c",22899445,1,1,0,3506,460,461,1
"42de338840a34d15adb66e7b14fb9d2c","42de338840a34d15adb66e7b14fb9d2c",22899445,19,0,1,3507,461,461,0
"42de338840a34d15adb66e7b14fb9d2c","f67fbf45a5f146ed866965bc57c7c001",22899445,1,-7,0,3526,461,454,-7
"c5df9f40ec14463b9dcfdc73df3e9285","f67fbf45a5f146ed866965bc57c7c001",22899445,2,-12,0,3529,464,454,-10
"f67fbf45a5f146ed866965bc57c7c001","9da37c6210b1416b8079c274f70bf600",22899445,1,8,0,3530,454,462,8
"9da37c6210b1416b8079c274f70bf600","9da37c6210b1416b8079c274f70bf600",22899445,9,0,1,3531,462,462,0
"9da37c6210b1416b8079c274f70bf600","519119f1deac45ff9ab4f13529be5c6e",22899445,1,1,0,3540,462,463,1
"519119f1deac45ff9ab4f13529be5c6e","519119f1deac45ff9ab4f13529be5c6e",22899445,5,0,1,3541,463,463,0
"519119f1deac45ff9ab4f13529be5c6e","c5df9f40ec14463b9dcfdc73df3e9285",22899445,1,3,0,3546,463,464,1
"c5df9f40ec14463b9dcfdc73df3e9285","83d42d95cd844fc093fc09cee250edb8",22899445,1,3,0,3549,464,465,1
"83d42d95cd844fc093fc09cee250edb8","83d42d95cd844fc093fc09cee250edb8",22899445,28,0,1,3550,465,465,0
"83d42d95cd844fc093fc09cee250edb8","c5df9f40ec14463b9dcfdc73df3e9285",22899445,1,-3,0,3569,465,464,-1
"c5df9f40ec14463b9dcfdc73df3e9285","66baf19b6b904b70922329068c63746d",22899445,1,-132,0,3573,464,376,-88
"66baf19b6b904b70922329068c63746d","66baf19b6b904b70922329068c63746d",22899445,1,0,1,3574,376,376,0
"66baf19b6b904b70922329068c63746d","901e92500aea43c79f19f1b279050668",22899445,1,99,0,3575,376,442,66
"901e92500aea43c79f19f1b279050668","070600601c4c439288445d2f0724807d",22899445,1,-8,0,3576,442,437,-5
"070600601c4c439288445d2f0724807d","901e92500aea43c79f19f1b279050668",22899445,1,8,0,3577,437,442,5
"901e92500aea43c79f19f1b279050668","66baf19b6b904b70922329068c63746d",22899445,1,-99,0,3582,442,376,-66
"7f544639412e40a9ba27f43b415362ab","0c7262dff33c4087bc660ccf40f92f9c",22899445,1,-281,0,3584,378,169,-209
"0c7262dff33c4087bc660ccf40f92f9c","83d42d95cd844fc093fc09cee250edb8",22899445,1,414,0,3585,169,465,296
"b613861cecf84ffcab01afb23f660475","b613861cecf84ffcab01afb23f660475",22901783,4,0,1,1,1,1,0
"b613861cecf84ffcab01afb23f660475","e2911e79efc2420eac45d9f671463d4b",22901783,1,3,0,5,1,2,1
"e2911e79efc2420eac45d9f671463d4b","519d1b8c59404d67b54e96c5c8a830b2",22901783,1,1,0,8,2,3,1
"519d1b8c59404d67b54e96c5c8a830b2","519d1b8c59404d67b54e96c5c8a830b2",22901783,1,0,1,9,3,3,0
"519d1b8c59404d67b54e96c5c8a830b2","531db53f81f646edb0cdcfe0085b03b7",22901783,1,1,0,10,3,4,1
"531db53f81f646edb0cdcfe0085b03b7","531db53f81f646edb0cdcfe0085b03b7",22901783,1,0,1,11,4,4,0
"531db53f81f646edb0cdcfe0085b03b7","4f5f94b2f95141e0a9d53a61da2276da",22901783,1,1,0,12,4,5,1
"4f5f94b2f95141e0a9d53a61da2276da","4f5f94b2f95141e0a9d53a61da2276da",22901783,1,0,1,13,5,5,0
"4f5f94b2f95141e0a9d53a61da2276da","6d541c89590949f99af293c4f2333f67",22901783,1,1,0,14,5,6,1
"6d541c89590949f99af293c4f2333f67","6d541c89590949f99af293c4f2333f67",22901783,1,0,1,15,6,6,0
"6d541c89590949f99af293c4f2333f67","dd5cf0b9fe4c4f1d8f5ff8e4c04879cb",22901783,1,1,0,16,6,7,1
"dd5cf0b9fe4c4f1d8f5ff8e4c04879cb","dd5cf0b9fe4c4f1d8f5ff8e4c04879cb",22901783,2,0,1,17,7,7,0
"dd5cf0b9fe4c4f1d8f5ff8e4c04879cb","f96261861edc426abe2248be4f0a709a",22901783,1,1,0,19,7,8,1
"f96261861edc426abe2248be4f0a709a","f96261861edc426abe2248be4f0a709a",22901783,2,0,1,20,8,8,0
"f96261861edc426abe2248be4f0a709a","66b5e16f4f75454fb5b8172079f0fa83",22901783,1,1,0,22,8,9,1
"66b5e16f4f75454fb5b8172079f0fa83","66b5e16f4f75454fb5b8172079f0fa83",22901783,2,0,1,23,9,9,0
"66b5e16f4f75454fb5b8172079f0fa83","0680571d4698477995e41842c36a54b2",22901783,1,1,0,25,9,10,1
"0680571d4698477995e41842c36a54b2","0680571d4698477995e41842c36a54b2",22901783,2,0,1,26,10,10,0
"0680571d4698477995e41842c36a54b2","9112f2bffece48e08c6d2287be204085",22901783,1,1,0,28,10,11,1
"9112f2bffece48e08c6d2287be204085","9112f2bffece48e08c6d2287be204085",22901783,2,0,1,29,11,11,0
"9112f2bffece48e08c6d2287be204085","6d541c89590949f99af293c4f2333f67",22901783,1,-5,0,31,11,6,-5
"6d541c89590949f99af293c4f2333f67","4f5f94b2f95141e0a9d53a61da2276da",22901783,1,-1,0,32,6,5,-1
"4f5f94b2f95141e0a9d53a61da2276da","531db53f81f646edb0cdcfe0085b03b7",22901783,1,-1,0,33,5,4,-1
"531db53f81f646edb0cdcfe0085b03b7","519d1b8c59404d67b54e96c5c8a830b2",22901783,1,-1,0,34,4,3,-1
"519d1b8c59404d67b54e96c5c8a830b2","e2911e79efc2420eac45d9f671463d4b",22901783,1,-1,0,35,3,2,-1
"e2911e79efc2420eac45d9f671463d4b","e2911e79efc2420eac45d9f671463d4b",22901783,3,0,1,36,2,2,0
"e2911e79efc2420eac45d9f671463d4b","56586aa865414f538729c7f7735d2bc6",22901783,1,12,0,37,2,12,10
"56586aa865414f538729c7f7735d2bc6","56586aa865414f538729c7f7735d2bc6",22901783,7,0,1,38,12,12,0
"56586aa865414f538729c7f7735d2bc6","b7f2b31585d94eb3bf86376714aa7070",22901783,1,2,0,42,12,13,1
"b7f2b31585d94eb3bf86376714aa7070","b7f2b31585d94eb3bf86376714aa7070",22901783,1,0,1,43,13,13,0
"b7f2b31585d94eb3bf86376714aa7070","3cbcea2be0984e7dbd5a48195af10ce7",22901783,1,215,0,44,13,165,152
"3cbcea2be0984e7dbd5a48195af10ce7","3cbcea2be0984e7dbd5a48195af10ce7",22901783,1,0,1,45,165,165,0
"3cbcea2be0984e7dbd5a48195af10ce7","82e6285962b8400d9d6fc32436022a94",22901783,2,2,0,46,165,167,2
"82e6285962b8400d9d6fc32436022a94","67a089198fcb4e1c8f2385786c2b296f",22901783,1,-162,0,47,167,39,-128
"67a089198fcb4e1c8f2385786c2b296f","3cbcea2be0984e7dbd5a48195af10ce7",22901783,1,160,0,48,39,165,126
"82e6285962b8400d9d6fc32436022a94","3cbcea2be0984e7dbd5a48195af10ce7",22901783,1,-2,0,50,167,165,-2
"3cbcea2be0984e7dbd5a48195af10ce7","a9ac840f098c4bd0a2ee896214ce29cd",22901783,1,5,0,51,165,168,3
"67a089198fcb4e1c8f2385786c2b296f","67a089198fcb4e1c8f2385786c2b296f",22901783,2,0,1,53,39,39,0
"67a089198fcb4e1c8f2385786c2b296f","64d48c6c9c7940639a932219a6c87198",22901783,2,1,0,55,39,40,1
"64d48c6c9c7940639a932219a6c87198","67a089198fcb4e1c8f2385786c2b296f",22901783,1,-1,0,56,40,39,-1
"67a089198fcb4e1c8f2385786c2b296f","fc0e049d56024bc9a02c9a9c435c3df7",22901783,1,-4,0,57,39,38,-1
"fc0e049d56024bc9a02c9a9c435c3df7","78adeee1fa2c4fe0bc73f7bca9fcee86",22901783,1,156,0,58,38,160,122
"65202579580f4ad38d734b4ee39d22a8","b7719e26494940efa49512aedd0aac79",22901783,1,-197,0,69,164,20,-144
"b7719e26494940efa49512aedd0aac79","b7719e26494940efa49512aedd0aac79",22901783,1,0,1,70,20,20,0
"b7719e26494940efa49512aedd0aac79","afbf7250b99d47bea07172749483ca97",22901783,1,12,0,71,20,28,8
"afbf7250b99d47bea07172749483ca97","4e51676dc72045d99c19b9fa7b22f8bc",22901783,4,3,0,72,28,29,1
"4e51676dc72045d99c19b9fa7b22f8bc","afbf7250b99d47bea07172749483ca97",22901783,2,-3,0,73,29,28,-1
"4e51676dc72045d99c19b9fa7b22f8bc","51970cfa30e643e894e66ae85c8024cc",22901783,2,3,0,75,29,31,2
"51970cfa30e643e894e66ae85c8024cc","4e51676dc72045d99c19b9fa7b22f8bc",22901783,2,-3,0,76,31,29,-2
"4e51676dc72045d99c19b9fa7b22f8bc","c33c17be71ae4d588da7369472e5bb1b",22901783,2,9,0,77,29,34,5
"7040a13096d746ac84b8fac8d9752058","7040a13096d746ac84b8fac8d9752058",22901783,1,0,1,82,36,36,0
"7040a13096d746ac84b8fac8d9752058","9a0dc646f934470daf08c4b56ccf73db",22901783,1,3,0,83,36,37,1
"9a0dc646f934470daf08c4b56ccf73db","fc0e049d56024bc9a02c9a9c435c3df7",22901783,2,3,0,84,37,38,1
"fc0e049d56024bc9a02c9a9c435c3df7","9a0dc646f934470daf08c4b56ccf73db",22901783,1,-3,0,85,38,37,-1
"fc0e049d56024bc9a02c9a9c435c3df7","67a089198fcb4e1c8f2385786c2b296f",22901783,1,4,0,87,38,39,1
"64d48c6c9c7940639a932219a6c87198","9afd71a5298d4333b6849dfce1b9422c",22901783,1,-45,0,89,40,18,-22
"9afd71a5298d4333b6849dfce1b9422c","9afd71a5298d4333b6849dfce1b9422c",22901783,1,0,1,90,18,18,0
"9afd71a5298d4333b6849dfce1b9422c","afbf7250b99d47bea07172749483ca97",22901783,1,16,0,91,18,28,10
"afbf7250b99d47bea07172749483ca97","afbf7250b99d47bea07172749483ca97",22901783,1,0,1,92,28,28,0
"c33c17be71ae4d588da7369472e5bb1b","c33c17be71ae4d588da7369472e5bb1b",22901783,1,0,1,99,34,34,0
"c33c17be71ae4d588da7369472e5bb1b","93679be414554a11b1893002f2229a93",22901783,5,3,0,100,34,35,1
"93679be414554a11b1893002f2229a93","c33c17be71ae4d588da7369472e5bb1b",22901783,3,-3,0,101,35,34,-1
"93679be414554a11b1893002f2229a93","93679be414554a11b1893002f2229a93",22901783,1,0,1,105,35,35,0
"93679be414554a11b1893002f2229a93","7040a13096d746ac84b8fac8d9752058",22901783,2,3,0,106,35,36,1
"7040a13096d746ac84b8fac8d9752058","b534b89233134e30a9b5645138bfa9ee",22901783,1,14,0,107,36,41,5
"b534b89233134e30a9b5645138bfa9ee","0e37b720d23b4e7f8b313e79313fd107",22901783,1,3,0,108,41,44,3
"0e37b720d23b4e7f8b313e79313fd107","0e37b720d23b4e7f8b313e79313fd107",22901783,1,0,1,109,44,44,0
"0e37b720d23b4e7f8b313e79313fd107","6875d67fdd5f48168b62719df449bebd",22901783,1,1,0,110,44,45,1
"6875d67fdd5f48168b62719df449bebd","6875d67fdd5f48168b62719df449bebd",22901783,1,0,1,111,45,45,0
"6875d67fdd5f48168b62719df449bebd","b534b89233134e30a9b5645138bfa9ee",22901783,1,-4,0,112,45,41,-4
"b534b89233134e30a9b5645138bfa9ee","6e13d61a7bdb44bca949c9f86fab3be5",22901783,1,7,0,113,41,47,6
"6e13d61a7bdb44bca949c9f86fab3be5","195f78799f984cc2b06c48dfe36be751",22901783,1,2,0,114,47,49,2
"195f78799f984cc2b06c48dfe36be751","195f78799f984cc2b06c48dfe36be751",22901783,2,0,1,115,49,49,0
"195f78799f984cc2b06c48dfe36be751","d9c8d8c444a64dadbbb508652c721e17",22901783,1,-3,0,117,49,46,-3
"d9c8d8c444a64dadbbb508652c721e17","d0c74f735e024943943e40333d6d337f",22901783,1,6,0,118,46,51,5
"d0c74f735e024943943e40333d6d337f","983f8ff320594b279a7f4a6fe132f9c5",22901783,1,2,0,119,51,53,2
"983f8ff320594b279a7f4a6fe132f9c5","983f8ff320594b279a7f4a6fe132f9c5",22901783,2,0,1,120,53,53,0
"983f8ff320594b279a7f4a6fe132f9c5","35adfa5d923046aebabfefd98f35ff05",22901783,1,1,0,122,53,54,1
"35adfa5d923046aebabfefd98f35ff05","35adfa5d923046aebabfefd98f35ff05",22901783,3,0,1,123,54,54,0
"35adfa5d923046aebabfefd98f35ff05","b6f8a98476224da1b40e555ececc7ed8",22901783,1,1,0,126,54,55,1
"b6f8a98476224da1b40e555ececc7ed8","b6f8a98476224da1b40e555ececc7ed8",22901783,5,0,1,127,55,55,0
"b6f8a98476224da1b40e555ececc7ed8","86e22cb5fe0e4b47a9489ecddf7ed78f",22901783,1,1,0,132,55,56,1
"86e22cb5fe0e4b47a9489ecddf7ed78f","86e22cb5fe0e4b47a9489ecddf7ed78f",22901783,2,0,1,133,56,56,0
"86e22cb5fe0e4b47a9489ecddf7ed78f","f924752d8a1149668870b1e7698486f7",22901783,1,-6,0,135,56,50,-6
"f924752d8a1149668870b1e7698486f7","a1f2f12debe5432fb7a70bcd12bacfb9",22901783,1,9,0,136,50,58,8
"a1f2f12debe5432fb7a70bcd12bacfb9","78f30e4dcac84e3cbea8b2cc6e0d62b3",22901783,2,1,0,137,58,59,1
"78f30e4dcac84e3cbea8b2cc6e0d62b3","a1f2f12debe5432fb7a70bcd12bacfb9",22901783,1,-1,0,138,59,58,-1
"a1f2f12debe5432fb7a70bcd12bacfb9","a1f2f12debe5432fb7a70bcd12bacfb9",22901783,29,0,1,139,58,58,0
"78f30e4dcac84e3cbea8b2cc6e0d62b3","78f30e4dcac84e3cbea8b2cc6e0d62b3",22901783,7,0,1,169,59,59,0
"78f30e4dcac84e3cbea8b2cc6e0d62b3","a0a418b8540d479fa6e0f653b701da8b",22901783,1,6,0,176,59,64,5
"a0a418b8540d479fa6e0f653b701da8b","bc42d26810654ea9a1df1efe1e58c7d5",22901783,1,-1,0,177,64,63,-1
"bc42d26810654ea9a1df1efe1e58c7d5","12aa6e1672ac4e7aa6449a7a8609cd72",22901783,1,-7,0,178,63,57,-6
"12aa6e1672ac4e7aa6449a7a8609cd72","4c943503763e4e349906eea3ed3c8e86",22901783,1,5,0,179,57,61,4
"4c943503763e4e349906eea3ed3c8e86","4c943503763e4e349906eea3ed3c8e86",22901783,1,0,1,180,61,61,0
"4c943503763e4e349906eea3ed3c8e86","bc42d26810654ea9a1df1efe1e58c7d5",22901783,1,2,0,181,61,63,2
"bc42d26810654ea9a1df1efe1e58c7d5","bc42d26810654ea9a1df1efe1e58c7d5",22901783,3,0,1,182,63,63,0
"bc42d26810654ea9a1df1efe1e58c7d5","a0a418b8540d479fa6e0f653b701da8b",22901783,1,1,0,185,63,64,1
"a0a418b8540d479fa6e0f653b701da8b","a0a418b8540d479fa6e0f653b701da8b",22901783,3,0,1,186,64,64,0
"a0a418b8540d479fa6e0f653b701da8b","309ccf3cc4fe429d9bfbaef53d3fa479",22901783,1,-4,0,189,64,60,-4
"309ccf3cc4fe429d9bfbaef53d3fa479","b534b89233134e30a9b5645138bfa9ee",22901783,1,-23,0,190,60,41,-19
"b534b89233134e30a9b5645138bfa9ee","d646286c8051419bbc2e31dd1db55ca8",22901783,1,33,0,191,41,67,26
"d646286c8051419bbc2e31dd1db55ca8","267f883678b24aed855fde42524975d9",22901783,1,4,0,192,67,71,4
"267f883678b24aed855fde42524975d9","267f883678b24aed855fde42524975d9",22901783,1,0,1,193,71,71,0
"267f883678b24aed855fde42524975d9","88fff56d0342490dbef9040750a20f6c",22901783,1,1,0,194,71,72,1
"88fff56d0342490dbef9040750a20f6c","88fff56d0342490dbef9040750a20f6c",22901783,1,0,1,195,72,72,0
"88fff56d0342490dbef9040750a20f6c","adb17b12b66c4a49a85fd34322f7df70",22901783,1,1,0,196,72,73,1
"adb17b12b66c4a49a85fd34322f7df70","adb17b12b66c4a49a85fd34322f7df70",22901783,1,0,1,197,73,73,0
"adb17b12b66c4a49a85fd34322f7df70","d646286c8051419bbc2e31dd1db55ca8",22901783,1,-6,0,198,73,67,-6
"d646286c8051419bbc2e31dd1db55ca8","a2becd407db34b189200a32546d9d569",22901783,1,9,0,199,67,75,8
"a2becd407db34b189200a32546d9d569","58c22b011d0f4c2ea6d13615edbb9eeb",22901783,1,2,0,200,75,77,2
"58c22b011d0f4c2ea6d13615edbb9eeb","58c22b011d0f4c2ea6d13615edbb9eeb",22901783,8,0,1,201,77,77,0
"58c22b011d0f4c2ea6d13615edbb9eeb","dd76e1861dc9461c830888729d091ee0",22901783,1,1,0,209,77,78,1
"dd76e1861dc9461c830888729d091ee0","dd76e1861dc9461c830888729d091ee0",22901783,5,0,1,210,78,78,0
"dd76e1861dc9461c830888729d091ee0","cd1d828f1a694b87913a7ea66c23803e",22901783,1,1,0,215,78,79,1
"cd1d828f1a694b87913a7ea66c23803e","cd1d828f1a694b87913a7ea66c23803e",22901783,2,0,1,216,79,79,0
"cd1d828f1a694b87913a7ea66c23803e","9176a3c2b4d2465fa8b0c67096c2a97e",22901783,1,1,0,218,79,80,1
"9176a3c2b4d2465fa8b0c67096c2a97e","9176a3c2b4d2465fa8b0c67096c2a97e",22901783,5,0,1,219,80,80,0
"9176a3c2b4d2465fa8b0c67096c2a97e","f8ec6445f7194e25b9101d4fbcb07a18",22901783,1,1,0,224,80,81,1
"f8ec6445f7194e25b9101d4fbcb07a18","f8ec6445f7194e25b9101d4fbcb07a18",22901783,2,0,1,225,81,81,0
"f8ec6445f7194e25b9101d4fbcb07a18","140d5b27b8574befad82c0a013b59dfa",22901783,1,-7,0,227,81,74,-7
"140d5b27b8574befad82c0a013b59dfa","d18a9ea32855445f8736581f5cb119ce",22901783,1,9,0,228,74,82,8
"d18a9ea32855445f8736581f5cb119ce","f564483cbd7a407681aa2fcca518cf5f",22901783,1,4,0,229,82,85,3
"f564483cbd7a407681aa2fcca518cf5f","f564483cbd7a407681aa2fcca518cf5f",22901783,6,0,1,230,85,85,0
"f564483cbd7a407681aa2fcca518cf5f","18fd01350bd5434ca636d59a599d768a",22901783,1,1,0,236,85,86,1
"18fd01350bd5434ca636d59a599d768a","18fd01350bd5434ca636d59a599d768a",22901783,8,0,1,237,86,86,0
"18fd01350bd5434ca636d59a599d768a","ae5ac430ea254e708a6f5deaaf7464ae",22901783,1,-2,0,245,86,84,-2
"ae5ac430ea254e708a6f5deaaf7464ae","6a9f0ef185fb47f0937e29daa1c71ed5",22901783,1,7,0,246,84,90,6
"6a9f0ef185fb47f0937e29daa1c71ed5","c681290961c94c4caf23b529d1ae6b9a",22901783,1,-2,0,247,90,88,-2
"c681290961c94c4caf23b529d1ae6b9a","c681290961c94c4caf23b529d1ae6b9a",22901783,1,0,1,248,88,88,0
"c681290961c94c4caf23b529d1ae6b9a","6a9f0ef185fb47f0937e29daa1c71ed5",22901783,1,2,0,249,88,90,2
"6a9f0ef185fb47f0937e29daa1c71ed5","6a9f0ef185fb47f0937e29daa1c71ed5",22901783,3,0,1,250,90,90,0
"6a9f0ef185fb47f0937e29daa1c71ed5","d646286c8051419bbc2e31dd1db55ca8",22901783,1,-27,0,253,90,67,-23
"d646286c8051419bbc2e31dd1db55ca8","e20db35ced8544ddac5bc3839145e463",22901783,1,30,0,254,67,91,24
"e20db35ced8544ddac5bc3839145e463","1febb706d7a34005ae8711ed49c76e64",22901783,1,3,0,255,91,94,3
"1febb706d7a34005ae8711ed49c76e64","1febb706d7a34005ae8711ed49c76e64",22901783,2,0,1,256,94,94,0
"1febb706d7a34005ae8711ed49c76e64","8f73ba6f5a0042f2850356ac38ac6f24",22901783,1,1,0,258,94,95,1
"8f73ba6f5a0042f2850356ac38ac6f24","8f73ba6f5a0042f2850356ac38ac6f24",22901783,5,0,1,259,95,95,0
"8f73ba6f5a0042f2850356ac38ac6f24","e2260b86653c46d7b14a41fb419dbf8c",22901783,1,1,0,264,95,96,1
"e2260b86653c46d7b14a41fb419dbf8c","e2260b86653c46d7b14a41fb419dbf8c",22901783,2,0,1,265,96,96,0
"e2260b86653c46d7b14a41fb419dbf8c","35eb641ad1d845bbba54915bce75a962",22901783,1,1,0,267,96,97,1
"35eb641ad1d845bbba54915bce75a962","35eb641ad1d845bbba54915bce75a962",22901783,5,0,1,268,97,97,0
"35eb641ad1d845bbba54915bce75a962","08be90ffbeea4795a138cd42ed8db56f",22901783,1,1,0,273,97,98,1
"08be90ffbeea4795a138cd42ed8db56f","08be90ffbeea4795a138cd42ed8db56f",22901783,5,0,1,274,98,98,0
"08be90ffbeea4795a138cd42ed8db56f","3007433c8f584dcbb5ac159c1c5f2be3",22901783,1,1,0,279,98,99,1
"3007433c8f584dcbb5ac159c1c5f2be3","3007433c8f584dcbb5ac159c1c5f2be3",22901783,2,0,1,280,99,99,0
"3007433c8f584dcbb5ac159c1c5f2be3","e20db35ced8544ddac5bc3839145e463",22901783,1,-8,0,282,99,91,-8
"e20db35ced8544ddac5bc3839145e463","d391c8b6e56a43a7b654e9dee02d904b",22901783,1,13,0,283,91,103,12
"d391c8b6e56a43a7b654e9dee02d904b","00ae5f0c51874a73a41ebea838d95682",22901783,1,-2,0,284,103,101,-2
"00ae5f0c51874a73a41ebea838d95682","d391c8b6e56a43a7b654e9dee02d904b",22901783,1,2,0,285,101,103,2
"d391c8b6e56a43a7b654e9dee02d904b","d391c8b6e56a43a7b654e9dee02d904b",22901783,15,0,1,286,103,103,0
"d391c8b6e56a43a7b654e9dee02d904b","6111116566fc4fd9abba409322bea245",22901783,1,1,0,301,103,104,1
"6111116566fc4fd9abba409322bea245","6111116566fc4fd9abba409322bea245",22901783,2,0,1,302,104,104,0
"6111116566fc4fd9abba409322bea245","a81b2235cb9c499eb9ea8ee0a8dd9725",22901783,1,1,0,304,104,105,1
"a81b2235cb9c499eb9ea8ee0a8dd9725","a81b2235cb9c499eb9ea8ee0a8dd9725",22901783,5,0,1,305,105,105,0
"a81b2235cb9c499eb9ea8ee0a8dd9725","2d4e0ab0ef3b4d73b82c72d4621a7579",22901783,1,1,0,310,105,106,1
"2d4e0ab0ef3b4d73b82c72d4621a7579","2d4e0ab0ef3b4d73b82c72d4621a7579",22901783,2,0,1,311,106,106,0
"2d4e0ab0ef3b4d73b82c72d4621a7579","8bdebf492ebd4e62b0d522e8ab5e5197",22901783,1,1,0,313,106,107,1
"8bdebf492ebd4e62b0d522e8ab5e5197","8bdebf492ebd4e62b0d522e8ab5e5197",22901783,2,0,1,314,107,107,0
"8bdebf492ebd4e62b0d522e8ab5e5197","73039f8c1eb9409cb4caee2cf968001e",22901783,1,-7,0,316,107,100,-7
"73039f8c1eb9409cb4caee2cf968001e","4280927ec4d643238aa49c32f9e06c6c",22901783,1,10,0,317,100,109,9
"4280927ec4d643238aa49c32f9e06c6c","fc44e6a5f7654430af1227838224dceb",22901783,1,2,0,318,109,111,2
"fc44e6a5f7654430af1227838224dceb","fc44e6a5f7654430af1227838224dceb",22901783,5,0,1,319,111,111,0
"fc44e6a5f7654430af1227838224dceb","08111f75e22d409998cf8b85bd431f0a",22901783,1,-3,0,324,111,108,-3
"08111f75e22d409998cf8b85bd431f0a","a9ae0a3c070d455bb4369a8996313336",22901783,1,7,0,325,108,114,6
"a9ae0a3c070d455bb4369a8996313336","71cec822bcff4f30a20e75dc63ef7b65",22901783,1,2,0,326,114,116,2
"71cec822bcff4f30a20e75dc63ef7b65","71cec822bcff4f30a20e75dc63ef7b65",22901783,1,0,1,327,116,116,0
"71cec822bcff4f30a20e75dc63ef7b65","62bff51286ef4f348717a3cf6fe2318f",22901783,1,5,0,328,116,120,4
"62bff51286ef4f348717a3cf6fe2318f","37319e88176d4aefa91d7a9980dbae91",22901783,1,-9,0,329,120,112,-8
"37319e88176d4aefa91d7a9980dbae91","b1cd0e7dc3ad4a8eb91a4bfdbeb025b0",22901783,1,7,0,330,112,118,6
"b1cd0e7dc3ad4a8eb91a4bfdbeb025b0","b1cd0e7dc3ad4a8eb91a4bfdbeb025b0",22901783,1,0,1,331,118,118,0
"b1cd0e7dc3ad4a8eb91a4bfdbeb025b0","62bff51286ef4f348717a3cf6fe2318f",22901783,1,2,0,332,118,120,2
"62bff51286ef4f348717a3cf6fe2318f","62bff51286ef4f348717a3cf6fe2318f",22901783,3,0,1,333,120,120,0
"62bff51286ef4f348717a3cf6fe2318f","e20db35ced8544ddac5bc3839145e463",22901783,1,-33,0,336,120,91,-29
"e20db35ced8544ddac5bc3839145e463","779f9ddd1fd14d1e9e69f72219a1fdbd",22901783,1,36,0,337,91,121,30
"779f9ddd1fd14d1e9e69f72219a1fdbd","ae26e6cda8ad4a3f81bd347560d9579f",22901783,1,4,0,338,121,125,4
"ae26e6cda8ad4a3f81bd347560d9579f","ae26e6cda8ad4a3f81bd347560d9579f",22901783,1,0,1,339,125,125,0
"ae26e6cda8ad4a3f81bd347560d9579f","ee48df95832b4374aa273ceb27ec1315",22901783,1,1,0,340,125,126,1
"ee48df95832b4374aa273ceb27ec1315","ee48df95832b4374aa273ceb27ec1315",22901783,1,0,1,341,126,126,0
"ee48df95832b4374aa273ceb27ec1315","7a439da90b394756ad1777fc4c6dead5",22901783,1,1,0,342,126,127,1
"7a439da90b394756ad1777fc4c6dead5","7a439da90b394756ad1777fc4c6dead5",22901783,1,0,1,343,127,127,0
"7a439da90b394756ad1777fc4c6dead5","a8dd5213034441ac92724b4e83eb0bb2",22901783,1,3,0,344,127,129,2
"a8dd5213034441ac92724b4e83eb0bb2","779f9ddd1fd14d1e9e69f72219a1fdbd",22901783,1,-9,0,345,129,121,-8
"779f9ddd1fd14d1e9e69f72219a1fdbd","8115eab6556b45f5b415c3b8c26a12e5",22901783,1,11,0,346,121,131,10
"8115eab6556b45f5b415c3b8c26a12e5","8115eab6556b45f5b415c3b8c26a12e5",22901783,2,0,1,347,131,131,0
"8115eab6556b45f5b415c3b8c26a12e5","ec34b06efd844b46a4c4818ecdb9b8f4",22901783,1,1,0,349,131,132,1
"ec34b06efd844b46a4c4818ecdb9b8f4","ec34b06efd844b46a4c4818ecdb9b8f4",22901783,2,0,1,350,132,132,0
"ec34b06efd844b46a4c4818ecdb9b8f4","c2e1c2b9eac64109b343a088584b576b",22901783,1,1,0,352,132,133,1
"c2e1c2b9eac64109b343a088584b576b","c2e1c2b9eac64109b343a088584b576b",22901783,2,0,1,353,133,133,0
"c2e1c2b9eac64109b343a088584b576b","579338175e0b4bbb8ef3b712b5d8b54e",22901783,1,-5,0,355,133,128,-5
"579338175e0b4bbb8ef3b712b5d8b54e","8bc5795d6a984a3eace4e2811e52dd4f",22901783,1,8,0,356,128,135,7
"8bc5795d6a984a3eace4e2811e52dd4f","8bc5795d6a984a3eace4e2811e52dd4f",22901783,1,0,1,357,135,135,0
"8bc5795d6a984a3eace4e2811e52dd4f","b416d47c56a742199b5d7c7f19d6503a",22901783,1,-1,0,358,135,134,-1
"b416d47c56a742199b5d7c7f19d6503a","cd4532ad48034873ba8bce2aac0c9808",22901783,1,4,0,359,134,137,3
"cd4532ad48034873ba8bce2aac0c9808","cd4532ad48034873ba8bce2aac0c9808",22901783,1,0,1,360,137,137,0
"cd4532ad48034873ba8bce2aac0c9808","df1de691dafe4549a18a4398ee9dfaf9",22901783,1,4,0,361,137,139,2
"df1de691dafe4549a18a4398ee9dfaf9","779f9ddd1fd14d1e9e69f72219a1fdbd",22901783,1,-23,0,362,139,121,-18
"779f9ddd1fd14d1e9e69f72219a1fdbd","6c5ad271a44743479bfaea29b1db8d02",22901783,1,27,0,363,121,143,22
"6c5ad271a44743479bfaea29b1db8d02","83d311bed5374fee83d8d67a7d9d82dc",22901783,1,1,0,364,143,144,1
"83d311bed5374fee83d8d67a7d9d82dc","83d311bed5374fee83d8d67a7d9d82dc",22901783,1,0,1,365,144,144,0
"83d311bed5374fee83d8d67a7d9d82dc","402bba41861d43acb52a5abb89e8831e",22901783,1,1,0,366,144,145,1
"402bba41861d43acb52a5abb89e8831e","402bba41861d43acb52a5abb89e8831e",22901783,2,0,1,367,145,145,0
"402bba41861d43acb52a5abb89e8831e","df1de691dafe4549a18a4398ee9dfaf9",22901783,1,-6,0,369,145,139,-6
"df1de691dafe4549a18a4398ee9dfaf9","8aae34f5ddbb4052a709b12e6b0d40fa",22901783,1,9,0,370,139,147,8
"8aae34f5ddbb4052a709b12e6b0d40fa","645b3f0249f64f76af2e19eb4d0e55b7",22901783,1,2,0,371,147,149,2
"645b3f0249f64f76af2e19eb4d0e55b7","645b3f0249f64f76af2e19eb4d0e55b7",22901783,8,0,1,372,149,149,0
"645b3f0249f64f76af2e19eb4d0e55b7","7e7b8db5064d4369805ab370aac5ddfb",22901783,1,1,0,380,149,150,1
"7e7b8db5064d4369805ab370aac5ddfb","7e7b8db5064d4369805ab370aac5ddfb",22901783,2,0,1,381,150,150,0
"7e7b8db5064d4369805ab370aac5ddfb","8956d210ae7f41968fada86d4c979d6a",22901783,1,1,0,383,150,151,1
"8956d210ae7f41968fada86d4c979d6a","8956d210ae7f41968fada86d4c979d6a",22901783,2,0,1,384,151,151,0
"8956d210ae7f41968fada86d4c979d6a","f902b0f41b544d4dbf79664fd233648d",22901783,1,-5,0,386,151,146,-5
"f902b0f41b544d4dbf79664fd233648d","ae781e8b775e4ccd93bc800dad5c8376",22901783,1,8,0,387,146,153,7
"ae781e8b775e4ccd93bc800dad5c8376","ae781e8b775e4ccd93bc800dad5c8376",22901783,2,0,1,388,153,153,0
"ae781e8b775e4ccd93bc800dad5c8376","06882a8492d9499aa31555567f575ecb",22901783,1,1,0,390,153,154,1
"06882a8492d9499aa31555567f575ecb","06882a8492d9499aa31555567f575ecb",22901783,1,0,1,391,154,154,0
"06882a8492d9499aa31555567f575ecb","f293c508f409466a8f27ddd7d1e40b20",22901783,1,1,0,392,154,155,1
"f293c508f409466a8f27ddd7d1e40b20","f293c508f409466a8f27ddd7d1e40b20",22901783,2,0,1,393,155,155,0
"f293c508f409466a8f27ddd7d1e40b20","cc4ddef5bbbe48ebb605141b347c4ed1",22901783,1,1,0,395,155,156,1
"cc4ddef5bbbe48ebb605141b347c4ed1","cc4ddef5bbbe48ebb605141b347c4ed1",22901783,5,0,1,396,156,156,0
"cc4ddef5bbbe48ebb605141b347c4ed1","d313cec988a84645bee413e8d4724a4b",22901783,1,3,0,401,156,158,2
"d313cec988a84645bee413e8d4724a4b","f03480cf4eba413194d7af52fc0e7f28",22901783,1,-7,0,402,158,152,-6
"f03480cf4eba413194d7af52fc0e7f28","d313cec988a84645bee413e8d4724a4b",22901783,2,7,0,403,152,158,6
"d313cec988a84645bee413e8d4724a4b","d313cec988a84645bee413e8d4724a4b",22901783,7,0,1,404,158,158,0
"d313cec988a84645bee413e8d4724a4b","dc60696c76a74368a60f72246e47700d",22901783,1,1,0,407,158,159,1
"dc60696c76a74368a60f72246e47700d","dc60696c76a74368a60f72246e47700d",22901783,1,0,1,408,159,159,0
"dc60696c76a74368a60f72246e47700d","78adeee1fa2c4fe0bc73f7bca9fcee86",22901783,1,3,0,409,159,160,1
"78adeee1fa2c4fe0bc73f7bca9fcee86","df1de691dafe4549a18a4398ee9dfaf9",22901783,2,-26,0,410,160,139,-21
"df1de691dafe4549a18a4398ee9dfaf9","65202579580f4ad38d734b4ee39d22a8",22901783,1,31,0,411,139,164,25
"65202579580f4ad38d734b4ee39d22a8","78adeee1fa2c4fe0bc73f7bca9fcee86",22901783,4,-5,0,416,164,160,-4
"65202579580f4ad38d734b4ee39d22a8","3cbcea2be0984e7dbd5a48195af10ce7",22901783,1,3,0,420,164,165,1
"3cbcea2be0984e7dbd5a48195af10ce7","78adeee1fa2c4fe0bc73f7bca9fcee86",22901783,1,-8,0,421,165,160,-5
"78adeee1fa2c4fe0bc73f7bca9fcee86","82e6285962b8400d9d6fc32436022a94",22901783,1,10,0,422,160,167,7
"82e6285962b8400d9d6fc32436022a94","df1de691dafe4549a18a4398ee9dfaf9",22901783,1,-36,0,423,167,139,-28
"df1de691dafe4549a18a4398ee9dfaf9","d313cec988a84645bee413e8d4724a4b",22901783,1,22,0,424,139,158,19
"d313cec988a84645bee413e8d4724a4b","f4ce60b4a944484082ccb701b48b3da1",22901783,1,-1,0,427,158,157,-1
"f4ce60b4a944484082ccb701b48b3da1","67a089198fcb4e1c8f2385786c2b296f",22901783,1,-147,0,428,157,39,-118
"67a089198fcb4e1c8f2385786c2b296f","78adeee1fa2c4fe0bc73f7bca9fcee86",22901783,1,152,0,429,39,160,121
"78adeee1fa2c4fe0bc73f7bca9fcee86","78adeee1fa2c4fe0bc73f7bca9fcee86",22901783,4,0,1,430,160,160,0
"df1de691dafe4549a18a4398ee9dfaf9","f03480cf4eba413194d7af52fc0e7f28",22901783,1,15,0,457,139,152,13
"d313cec988a84645bee413e8d4724a4b","8aae34f5ddbb4052a709b12e6b0d40fa",22901783,1,-13,0,461,158,147,-11
"8aae34f5ddbb4052a709b12e6b0d40fa","f4ce60b4a944484082ccb701b48b3da1",22901783,1,12,0,462,147,157,10
"f4ce60b4a944484082ccb701b48b3da1","df1de691dafe4549a18a4398ee9dfaf9",22901783,1,-21,0,463,157,139,-18
"df1de691dafe4549a18a4398ee9dfaf9","a9ac840f098c4bd0a2ee896214ce29cd",22901783,1,39,0,464,139,168,29
"a9ac840f098c4bd0a2ee896214ce29cd","a9ac840f098c4bd0a2ee896214ce29cd",22901783,1,0,1,465,168,168,0
"a9ac840f098c4bd0a2ee896214ce29cd","67a089198fcb4e1c8f2385786c2b296f",22901783,2,-165,0,466,168,39,-129
"67a089198fcb4e1c8f2385786c2b296f","8959e6304a0348309a771e4d08d1b64a",22901783,1,156,0,467,39,163,124
"8959e6304a0348309a771e4d08d1b64a","78adeee1fa2c4fe0bc73f7bca9fcee86",22901783,1,-4,0,468,163,160,-3
"65202579580f4ad38d734b4ee39d22a8","67a089198fcb4e1c8f2385786c2b296f",22901783,1,-157,0,512,164,39,-125
"67a089198fcb4e1c8f2385786c2b296f","56586aa865414f538729c7f7735d2bc6",22901783,1,-57,0,513,39,12,-27
"56586aa865414f538729c7f7735d2bc6","5c5ceeee4562457ba6d41515aeebfbb1",22901783,3,10,0,514,12,17,5
"5c5ceeee4562457ba6d41515aeebfbb1","56586aa865414f538729c7f7735d2bc6",22901783,2,-10,0,515,17,12,-5
"56586aa865414f538729c7f7735d2bc6","3f1c815879794b929260d224becaff7e",22901783,1,4,0,521,12,14,2
"3f1c815879794b929260d224becaff7e","5c5ceeee4562457ba6d41515aeebfbb1",22901783,1,6,0,522,14,17,3
"5c5ceeee4562457ba6d41515aeebfbb1","81c864a886d54a6b8ff85f7d736f4f95",22901783,1,-4,0,523,17,15,-2
"81c864a886d54a6b8ff85f7d736f4f95","56586aa865414f538729c7f7735d2bc6",22901783,1,-6,0,524,15,12,-3
"5c5ceeee4562457ba6d41515aeebfbb1","0c7262dff33c4087bc660ccf40f92f9c",22901783,1,216,0,526,17,169,152
"0c7262dff33c4087bc660ccf40f92f9c","b2275c3fad834f8d90737a2d9a6927d6",22901783,1,3,0,527,169,172,3
"b2275c3fad834f8d90737a2d9a6927d6","b2275c3fad834f8d90737a2d9a6927d6",22901783,24,0,1,528,172,172,0
"b2275c3fad834f8d90737a2d9a6927d6","eb515a26030b41f8a82a1e6114420bad",22901783,1,1,0,552,172,173,1
"eb515a26030b41f8a82a1e6114420bad","eb515a26030b41f8a82a1e6114420bad",22901783,2,0,1,553,173,173,0
"eb515a26030b41f8a82a1e6114420bad","b42cc17b7de840f181a704558d0bc845",22901783,1,3,0,555,173,175,2
"b42cc17b7de840f181a704558d0bc845","0c7262dff33c4087bc660ccf40f92f9c",22901783,1,-7,0,556,175,169,-6
"0c7262dff33c4087bc660ccf40f92f9c","b42cc17b7de840f181a704558d0bc845",22901783,2,7,0,557,169,175,6
"b42cc17b7de840f181a704558d0bc845","801f9e9135034f49bf5f8b4bdefedb41",22901783,1,2,0,558,175,177,2
"801f9e9135034f49bf5f8b4bdefedb41","801f9e9135034f49bf5f8b4bdefedb41",22901783,7,0,1,559,177,177,0
"801f9e9135034f49bf5f8b4bdefedb41","0c7262dff33c4087bc660ccf40f92f9c",22901783,1,-9,0,566,177,169,-8
"b42cc17b7de840f181a704558d0bc845","ea38cc0e6e6e41edbabf210220808bf9",22901783,1,5,0,568,175,179,4
"ea38cc0e6e6e41edbabf210220808bf9","362fcb0699a14845ab29b2340093e528",22901783,1,-6,0,569,179,174,-5
"362fcb0699a14845ab29b2340093e528","b87c552dd247427abe6ab5795b9c9d43",22901783,1,8,0,570,174,181,7
"b87c552dd247427abe6ab5795b9c9d43","ea38cc0e6e6e41edbabf210220808bf9",22901783,1,-2,0,571,181,179,-2
"ea38cc0e6e6e41edbabf210220808bf9","b87c552dd247427abe6ab5795b9c9d43",22901783,1,2,0,572,179,181,2
"b87c552dd247427abe6ab5795b9c9d43","b87c552dd247427abe6ab5795b9c9d43",22901783,11,0,1,573,181,181,0
"b87c552dd247427abe6ab5795b9c9d43","139b097acfca451689d80c9c6eebdf7b",22901783,1,-3,0,584,181,178,-3
"139b097acfca451689d80c9c6eebdf7b","30f660a1feb34582a739722532524f79",22901783,1,6,0,585,178,183,5
"30f660a1feb34582a739722532524f79","30f660a1feb34582a739722532524f79",22901783,5,0,1,586,183,183,0
"30f660a1feb34582a739722532524f79","2024b4885bd14338a39b7b509acbbd02",22901783,1,-1,0,591,183,182,-1
"2024b4885bd14338a39b7b509acbbd02","c3f63fe50d8e487c86bf8ef76c9cadd3",22901783,1,4,0,592,182,185,3
"c3f63fe50d8e487c86bf8ef76c9cadd3","c3f63fe50d8e487c86bf8ef76c9cadd3",22901783,1,0,1,593,185,185,0
"c3f63fe50d8e487c86bf8ef76c9cadd3","0c7262dff33c4087bc660ccf40f92f9c",22901783,1,-20,0,594,185,169,-16
"0c7262dff33c4087bc660ccf40f92f9c","c8e371568a0c4391b25796ae4e91952e",22901783,1,23,0,595,169,186,17
"c8e371568a0c4391b25796ae4e91952e","7d932b23e1c84326ae5aa4d3c0d813d1",22901783,1,2,0,596,186,188,2
"7d932b23e1c84326ae5aa4d3c0d813d1","7d932b23e1c84326ae5aa4d3c0d813d1",22901783,1,0,1,597,188,188,0
"7d932b23e1c84326ae5aa4d3c0d813d1","c8e371568a0c4391b25796ae4e91952e",22901783,1,-2,0,598,188,186,-2
"c8e371568a0c4391b25796ae4e91952e","ab11d94c6c8948ea90b88f19d2cd502b",22901783,1,5,0,599,186,190,4
"ab11d94c6c8948ea90b88f19d2cd502b","f992451ed6ad4e68bb9e68ad6be7c4be",22901783,1,2,0,600,190,192,2
"f992451ed6ad4e68bb9e68ad6be7c4be","f992451ed6ad4e68bb9e68ad6be7c4be",22901783,1,0,1,601,192,192,0
"f992451ed6ad4e68bb9e68ad6be7c4be","ab11d94c6c8948ea90b88f19d2cd502b",22901783,1,-2,0,602,192,190,-2
"ab11d94c6c8948ea90b88f19d2cd502b","6cd2dcaac46847d4a0bc53f296d90375",22901783,1,5,0,603,190,194,4
"6cd2dcaac46847d4a0bc53f296d90375","07b44a7a51e94c78b411c753fc39dab0",22901783,1,-6,0,604,194,189,-5
"07b44a7a51e94c78b411c753fc39dab0","2d2580c9411c4972909db508d6956a58",22901783,1,8,0,605,189,196,7
"2d2580c9411c4972909db508d6956a58","2d2580c9411c4972909db508d6956a58",22901783,8,0,1,606,196,196,0
"2d2580c9411c4972909db508d6956a58","5bddb3d9ed264f3984702f048c7e5340",22901783,1,1,0,614,196,197,1
"5bddb3d9ed264f3984702f048c7e5340","5bddb3d9ed264f3984702f048c7e5340",22901783,2,0,1,615,197,197,0
"5bddb3d9ed264f3984702f048c7e5340","d5e8e2bd12a2466b9d6d90855f0eb079",22901783,1,1,0,617,197,198,1
"d5e8e2bd12a2466b9d6d90855f0eb079","d5e8e2bd12a2466b9d6d90855f0eb079",22901783,2,0,1,618,198,198,0
"d5e8e2bd12a2466b9d6d90855f0eb079","017d7ca8e0394b91aaadc9574df2202c",22901783,1,-5,0,620,198,193,-5
"017d7ca8e0394b91aaadc9574df2202c","54e8e9f0ea3e45c4bf3b8ac799ee31b1",22901783,1,8,0,621,193,200,7
"54e8e9f0ea3e45c4bf3b8ac799ee31b1","54e8e9f0ea3e45c4bf3b8ac799ee31b1",22901783,1,0,1,622,200,200,0
"54e8e9f0ea3e45c4bf3b8ac799ee31b1","c614a00911be4877a075f19315530fb0",22901783,1,1,0,623,200,201,1
"c614a00911be4877a075f19315530fb0","c614a00911be4877a075f19315530fb0",22901783,6,0,1,624,201,201,0
"c614a00911be4877a075f19315530fb0","a6c21bd8b95249c7972820a7a7d76aff",22901783,1,1,0,630,201,202,1
"a6c21bd8b95249c7972820a7a7d76aff","a6c21bd8b95249c7972820a7a7d76aff",22901783,2,0,1,631,202,202,0
"a6c21bd8b95249c7972820a7a7d76aff","c8e371568a0c4391b25796ae4e91952e",22901783,1,-19,0,633,202,186,-16
"c8e371568a0c4391b25796ae4e91952e","bb329d880ab54120adaf203a693bb203",22901783,1,20,0,634,186,203,17
"bb329d880ab54120adaf203a693bb203","bb329d880ab54120adaf203a693bb203",22901783,1,0,1,635,203,203,0
"bb329d880ab54120adaf203a693bb203","f9170dd6bc6442b4acd832747609b09a",22901783,1,-4,0,636,203,199,-4
"f9170dd6bc6442b4acd832747609b09a","334c2344009840079b1d0e1b7ce3d5a7",22901783,1,7,0,637,199,205,6
"334c2344009840079b1d0e1b7ce3d5a7","334c2344009840079b1d0e1b7ce3d5a7",22901783,1,0,1,638,205,205,0
"334c2344009840079b1d0e1b7ce3d5a7","d7f13c8d63ec4e2aa673fbb9cf9c6933",22901783,1,3,0,639,205,206,1
"d7f13c8d63ec4e2aa673fbb9cf9c6933","c8e371568a0c4391b25796ae4e91952e",22901783,1,-26,0,640,206,186,-20
"c8e371568a0c4391b25796ae4e91952e","b9e80f77c3a44349863b19875725c384",22901783,1,27,0,641,186,207,21
"b9e80f77c3a44349863b19875725c384","7108f0e4c2584f1f9c471689ae4c885c",22901783,2,1,0,642,207,208,1
"7108f0e4c2584f1f9c471689ae4c885c","b9e80f77c3a44349863b19875725c384",22901783,1,-1,0,643,208,207,-1
"b9e80f77c3a44349863b19875725c384","b9e80f77c3a44349863b19875725c384",22901783,24,0,1,644,207,207,0
"7108f0e4c2584f1f9c471689ae4c885c","7108f0e4c2584f1f9c471689ae4c885c",22901783,12,0,1,669,208,208,0
"7108f0e4c2584f1f9c471689ae4c885c","09400e101c5d4b439cf9a26b03aae558",22901783,1,3,0,681,208,210,2
"09400e101c5d4b439cf9a26b03aae558","d7f13c8d63ec4e2aa673fbb9cf9c6933",22901783,1,-5,0,682,210,206,-4
"d7f13c8d63ec4e2aa673fbb9cf9c6933","09400e101c5d4b439cf9a26b03aae558",22901783,1,5,0,683,206,210,4
"09400e101c5d4b439cf9a26b03aae558","a88efa7e50ce47159810ab553afa6d3a",22901783,1,2,0,684,210,212,2
"a88efa7e50ce47159810ab553afa6d3a","a88efa7e50ce47159810ab553afa6d3a",22901783,2,0,1,685,212,212,0
"a88efa7e50ce47159810ab553afa6d3a","a875096404ef4a9984b62d74cda916f9",22901783,1,-3,0,687,212,209,-3
"a875096404ef4a9984b62d74cda916f9","f7fb1952f56b4189b86a9f8b7862d2b8",22901783,1,7,0,688,209,215,6
"f7fb1952f56b4189b86a9f8b7862d2b8","be502a7a43c44bf7b682698de79d9369",22901783,1,-1,0,689,215,214,-1
"be502a7a43c44bf7b682698de79d9369","f7fb1952f56b4189b86a9f8b7862d2b8",22901783,1,1,0,690,214,215,1
"f7fb1952f56b4189b86a9f8b7862d2b8","f7fb1952f56b4189b86a9f8b7862d2b8",22901783,11,0,1,691,215,215,0
"f7fb1952f56b4189b86a9f8b7862d2b8","b860ee85d8bc4a2f97958cfb71be3533",22901783,1,1,0,702,215,216,1
"b860ee85d8bc4a2f97958cfb71be3533","b860ee85d8bc4a2f97958cfb71be3533",22901783,2,0,1,703,216,216,0
"b860ee85d8bc4a2f97958cfb71be3533","ec341f459285443b8361f7f15638ff08",22901783,1,-3,0,705,216,213,-3
"ec341f459285443b8361f7f15638ff08","363837c182e04711840d896ae1e0339c",22901783,1,6,0,706,213,218,5
"363837c182e04711840d896ae1e0339c","363837c182e04711840d896ae1e0339c",22901783,14,0,1,707,218,218,0
"363837c182e04711840d896ae1e0339c","01b2051f8941460d89945e3b02d1ce78",22901783,1,-1,0,721,218,217,-1
"01b2051f8941460d89945e3b02d1ce78","91125ca626c5470eb145501f8c37f8db",22901783,1,4,0,722,217,220,3
"91125ca626c5470eb145501f8c37f8db","91125ca626c5470eb145501f8c37f8db",22901783,1,0,1,723,220,220,0
"91125ca626c5470eb145501f8c37f8db","d7f13c8d63ec4e2aa673fbb9cf9c6933",22901783,1,-18,0,724,220,206,-14
"d7f13c8d63ec4e2aa673fbb9cf9c6933","1c6721b1f63f4d30ba7746ea8af02a52",22901783,1,21,0,725,206,221,15
"1c6721b1f63f4d30ba7746ea8af02a52","77ecef8eff6b4a2caea7707669bf7475",22901783,1,1,0,726,221,222,1
"77ecef8eff6b4a2caea7707669bf7475","77ecef8eff6b4a2caea7707669bf7475",22901783,13,0,1,727,222,222,0
"77ecef8eff6b4a2caea7707669bf7475","1c6721b1f63f4d30ba7746ea8af02a52",22901783,1,-1,0,740,222,221,-1
"1c6721b1f63f4d30ba7746ea8af02a52","8b9ae98743bd4d4a8a87dff1c1244211",22901783,1,7,0,741,221,227,6
"8b9ae98743bd4d4a8a87dff1c1244211","d03cb855c70044cf8c35d9ec0de696e3",22901783,2,-3,0,742,227,224,-3
"d03cb855c70044cf8c35d9ec0de696e3","a49a937d6896486d9a5396654abcf2e1",22901783,1,2,0,743,224,226,2
"a49a937d6896486d9a5396654abcf2e1","a49a937d6896486d9a5396654abcf2e1",22901783,3,0,1,744,226,226,0
"a49a937d6896486d9a5396654abcf2e1","8b9ae98743bd4d4a8a87dff1c1244211",22901783,1,1,0,747,226,227,1
"8b9ae98743bd4d4a8a87dff1c1244211","8b9ae98743bd4d4a8a87dff1c1244211",22901783,37,0,1,748,227,227,0
"d03cb855c70044cf8c35d9ec0de696e3","d03cb855c70044cf8c35d9ec0de696e3",22901783,1,0,1,786,224,224,0
"d03cb855c70044cf8c35d9ec0de696e3","f7906d6f59b9489a91d2ef40db5a474d",22901783,1,-1,0,787,224,223,-1
"f7906d6f59b9489a91d2ef40db5a474d","2ab1535aac1346ba8801535bf729ef37",22901783,1,7,0,788,223,229,6
"2ab1535aac1346ba8801535bf729ef37","a4f40fb48a8542c8949bae1f002cd9bc",22901783,1,2,0,789,229,231,2
"a4f40fb48a8542c8949bae1f002cd9bc","a4f40fb48a8542c8949bae1f002cd9bc",22901783,2,0,1,790,231,231,0
"a4f40fb48a8542c8949bae1f002cd9bc","8972c23e32044edb8a78fa1eed4e5947",22901783,1,1,0,792,231,232,1
"8972c23e32044edb8a78fa1eed4e5947","8972c23e32044edb8a78fa1eed4e5947",22901783,3,0,1,793,232,232,0
"8972c23e32044edb8a78fa1eed4e5947","92feb4a40f8344d38b6f722e42a53295",22901783,1,1,0,796,232,233,1
"92feb4a40f8344d38b6f722e42a53295","92feb4a40f8344d38b6f722e42a53295",22901783,2,0,1,797,233,233,0
"92feb4a40f8344d38b6f722e42a53295","5152833676bf4c6cb317060be10f68db",22901783,1,-5,0,799,233,228,-5
"5152833676bf4c6cb317060be10f68db","ca3e28f290354c08aefe5b0f769604e6",22901783,1,8,0,800,228,235,7
"ca3e28f290354c08aefe5b0f769604e6","ca3e28f290354c08aefe5b0f769604e6",22901783,9,0,1,801,235,235,0
"ca3e28f290354c08aefe5b0f769604e6","79a35eea833e4c2c9d22fc53c3c6445c",22901783,1,1,0,810,235,236,1
"79a35eea833e4c2c9d22fc53c3c6445c","79a35eea833e4c2c9d22fc53c3c6445c",22901783,9,0,1,811,236,236,0
"79a35eea833e4c2c9d22fc53c3c6445c","8f68228b1518449e9615cdafee41a2bd",22901783,1,1,0,820,236,237,1
"8f68228b1518449e9615cdafee41a2bd","8f68228b1518449e9615cdafee41a2bd",22901783,1,0,1,821,237,237,0
"8f68228b1518449e9615cdafee41a2bd","cab89fa5c3ed45a5aa550fc0352d6a42",22901783,1,1,0,822,237,238,1
"cab89fa5c3ed45a5aa550fc0352d6a42","cab89fa5c3ed45a5aa550fc0352d6a42",22901783,5,0,1,823,238,238,0
"cab89fa5c3ed45a5aa550fc0352d6a42","66d4fad4f1cf4b46be0750a99ad7a35a",22901783,1,1,0,828,238,239,1
"66d4fad4f1cf4b46be0750a99ad7a35a","66d4fad4f1cf4b46be0750a99ad7a35a",22901783,1,0,1,829,239,239,0
"66d4fad4f1cf4b46be0750a99ad7a35a","0b04c8e2f86d48c7aeb7e225819cd32b",22901783,1,-5,0,830,239,234,-5
"0b04c8e2f86d48c7aeb7e225819cd32b","f53da5fd9bfe412da4b80d4742563b6c",22901783,1,8,0,831,234,241,7
"f53da5fd9bfe412da4b80d4742563b6c","f53da5fd9bfe412da4b80d4742563b6c",22901783,1,0,1,832,241,241,0
"f53da5fd9bfe412da4b80d4742563b6c","1c6721b1f63f4d30ba7746ea8af02a52",22901783,1,-24,0,833,241,221,-20
"1c6721b1f63f4d30ba7746ea8af02a52","2ae94c0cea4d480a9d5dca8fb1d7b542",22901783,1,27,0,834,221,242,21
"2ae94c0cea4d480a9d5dca8fb1d7b542","1ebf23f9d994469a85206e4c7b1bf5f5",22901783,1,3,0,835,242,245,3
"1ebf23f9d994469a85206e4c7b1bf5f5","1ebf23f9d994469a85206e4c7b1bf5f5",22901783,12,0,1,836,245,245,0
"1ebf23f9d994469a85206e4c7b1bf5f5","85ae675b83e8422da842cfd25596af99",22901783,1,1,0,848,245,246,1
"85ae675b83e8422da842cfd25596af99","85ae675b83e8422da842cfd25596af99",22901783,1,0,1,849,246,246,0
"85ae675b83e8422da842cfd25596af99","2ae94c0cea4d480a9d5dca8fb1d7b542",22901783,1,-4,0,850,246,242,-4
"2ae94c0cea4d480a9d5dca8fb1d7b542","30c9ba177afc49a695625d2bdec40207",22901783,1,9,0,851,242,250,8
"30c9ba177afc49a695625d2bdec40207","30c9ba177afc49a695625d2bdec40207",22901783,2,0,1,852,250,250,0
"30c9ba177afc49a695625d2bdec40207","6e83e23f56544a19b94067c1c558d9c0",22901783,1,-3,0,854,250,247,-3
"6e83e23f56544a19b94067c1c558d9c0","00f61990949545828dd12f1303d47504",22901783,1,11,0,855,247,256,9
"00f61990949545828dd12f1303d47504","ead7bb4b64e247d2ae632ab8a296b091",22901783,1,2,0,856,256,258,2
"ead7bb4b64e247d2ae632ab8a296b091","ead7bb4b64e247d2ae632ab8a296b091",22901783,2,0,1,857,258,258,0
"ead7bb4b64e247d2ae632ab8a296b091","41b0048dde734bb280bac6116baa8e27",22901783,1,1,0,859,258,259,1
"41b0048dde734bb280bac6116baa8e27","41b0048dde734bb280bac6116baa8e27",22901783,5,0,1,860,259,259,0
"41b0048dde734bb280bac6116baa8e27","b41c5a094a604ee0915327da5cc0beb7",22901783,1,1,0,865,259,260,1
"b41c5a094a604ee0915327da5cc0beb7","b41c5a094a604ee0915327da5cc0beb7",22901783,5,0,1,866,260,260,0
"b41c5a094a604ee0915327da5cc0beb7","d546341988904f069cfa86b21457d9d9",22901783,1,-10,0,871,260,251,-9
"d546341988904f069cfa86b21457d9d9","28c171777c52431ab6b925073bd63d46",22901783,1,15,0,872,251,264,13
"28c171777c52431ab6b925073bd63d46","28c171777c52431ab6b925073bd63d46",22901783,7,0,1,873,264,264,0
"28c171777c52431ab6b925073bd63d46","ac160db940cb49ae8579162b1d52bb5d",22901783,1,2,0,880,264,266,2
"ac160db940cb49ae8579162b1d52bb5d","ac160db940cb49ae8579162b1d52bb5d",22901783,7,0,1,881,266,266,0
"ac160db940cb49ae8579162b1d52bb5d","d989ebcfc12a4b669f0100dc1aa14f1e",22901783,1,-12,0,888,266,255,-11
"d989ebcfc12a4b669f0100dc1aa14f1e","c6fd49b485cc4874b0bbdd9c6171e09c",22901783,1,15,0,889,255,268,13
"c6fd49b485cc4874b0bbdd9c6171e09c","c6fd49b485cc4874b0bbdd9c6171e09c",22901783,7,0,1,890,268,268,0
"c6fd49b485cc4874b0bbdd9c6171e09c","44240778a97c4af0937817499b75707b",22901783,1,1,0,897,268,269,1
"44240778a97c4af0937817499b75707b","44240778a97c4af0937817499b75707b",22901783,2,0,1,898,269,269,0
"44240778a97c4af0937817499b75707b","7aa76d3e993840d8805f097cbdbcd44b",22901783,1,-9,0,900,269,261,-8
"7aa76d3e993840d8805f097cbdbcd44b","865a4d3b43374da7944dc7d397f566d9",22901783,1,12,0,901,261,271,10
"865a4d3b43374da7944dc7d397f566d9","865a4d3b43374da7944dc7d397f566d9",22901783,1,0,1,902,271,271,0
"865a4d3b43374da7944dc7d397f566d9","0d987bed3ffa4ed0b9a2e62e97b7b30f",22901783,1,3,0,903,271,272,1
"0d987bed3ffa4ed0b9a2e62e97b7b30f","2ae94c0cea4d480a9d5dca8fb1d7b542",22901783,2,-38,0,904,272,242,-30
"2ae94c0cea4d480a9d5dca8fb1d7b542","0d987bed3ffa4ed0b9a2e62e97b7b30f",22901783,2,38,0,905,242,272,30
"0d987bed3ffa4ed0b9a2e62e97b7b30f","0d987bed3ffa4ed0b9a2e62e97b7b30f",22901783,4,0,1,906,272,272,0
"2ae94c0cea4d480a9d5dca8fb1d7b542","7028800abe7d4e27b613d1d6cbe26bf7",22901783,1,30,0,910,242,267,25
"7028800abe7d4e27b613d1d6cbe26bf7","2ae94c0cea4d480a9d5dca8fb1d7b542",22901783,1,-30,0,911,267,242,-25
"2ae94c0cea4d480a9d5dca8fb1d7b542","2ae94c0cea4d480a9d5dca8fb1d7b542",22901783,1,0,1,912,242,242,0
"2ae94c0cea4d480a9d5dca8fb1d7b542","7aa76d3e993840d8805f097cbdbcd44b",22901783,1,23,0,913,242,261,19
"7aa76d3e993840d8805f097cbdbcd44b","2ae94c0cea4d480a9d5dca8fb1d7b542",22901783,1,-23,0,914,261,242,-19
"bb5a47f5ea01454a8b79455422d3b9da","82ae07bc0c9b4570a41799290d1ef399",22901783,1,-6,0,923,280,275,-5
"82ae07bc0c9b4570a41799290d1ef399","bb5a47f5ea01454a8b79455422d3b9da",22901783,1,6,0,924,275,280,5
"bb5a47f5ea01454a8b79455422d3b9da","0d987bed3ffa4ed0b9a2e62e97b7b30f",22901783,1,-10,0,976,280,272,-8
"0d987bed3ffa4ed0b9a2e62e97b7b30f","94cecc3f1e7d484b8e068e79241dfd73",22901783,1,13,0,977,272,281,9
"94cecc3f1e7d484b8e068e79241dfd73","a37477c4e4c14169ad44b06b493007f6",22901783,1,2,0,978,281,283,2
"a37477c4e4c14169ad44b06b493007f6","94cecc3f1e7d484b8e068e79241dfd73",22901783,1,-2,0,979,283,281,-2
"94cecc3f1e7d484b8e068e79241dfd73","fab84b4fab5940efb4ea868ef8d09396",22901783,1,5,0,980,281,284,3
"fab84b4fab5940efb4ea868ef8d09396","fab84b4fab5940efb4ea868ef8d09396",22901783,1,0,1,981,284,284,0
"fab84b4fab5940efb4ea868ef8d09396","4a29443515bb404cb8924e1c60a63b73",22901783,1,4,0,982,284,285,1
"4a29443515bb404cb8924e1c60a63b73","208c9b2796c944db8dacaa96082520ea",22901783,1,3,0,983,285,288,3
"208c9b2796c944db8dacaa96082520ea","4a29443515bb404cb8924e1c60a63b73",22901783,1,-3,0,984,288,285,-3
"4a29443515bb404cb8924e1c60a63b73","7669a956527947d0add87455277e80b4",22901783,1,7,0,985,285,291,6
"7669a956527947d0add87455277e80b4","7669a956527947d0add87455277e80b4",22901783,1,0,1,986,291,291,0
"7669a956527947d0add87455277e80b4","6a9a3b5bde4a48daa896fe8c06eca56f",22901783,1,-2,0,987,291,289,-2
"6a9a3b5bde4a48daa896fe8c06eca56f","869e967078f04da18dd0b0b9389a7424",22901783,1,5,0,988,289,293,4
"869e967078f04da18dd0b0b9389a7424","51ab6291537748fab90d519aa09889d6",22901783,1,2,0,989,293,295,2
"51ab6291537748fab90d519aa09889d6","51ab6291537748fab90d519aa09889d6",22901783,11,0,1,1000,295,295,0
"51ab6291537748fab90d519aa09889d6","34a6e49023fc4465bd5ca604330bbd1c",22901783,1,-3,0,1001,295,292,-3
"34a6e49023fc4465bd5ca604330bbd1c","21592f2a9e9c4b2f8c66ec5dbcbf6a2b",22901783,1,5,0,1002,292,296,4
"21592f2a9e9c4b2f8c66ec5dbcbf6a2b","ba0e59461bfb4a44b7b1c28a01f8d3b3",22901783,1,4,0,1003,296,299,3
"ba0e59461bfb4a44b7b1c28a01f8d3b3","0e0b36e731a645e7b1b8a88f5031ca38",22901783,1,2,0,1004,299,301,2
"0e0b36e731a645e7b1b8a88f5031ca38","0e0b36e731a645e7b1b8a88f5031ca38",22901783,5,0,1,1005,301,301,0
"0e0b36e731a645e7b1b8a88f5031ca38","a66a144637284c21afc6de17fea4bfb8",22901783,1,1,0,1010,301,302,1
"a66a144637284c21afc6de17fea4bfb8","a66a144637284c21afc6de17fea4bfb8",22901783,2,0,1,1011,302,302,0
"a66a144637284c21afc6de17fea4bfb8","7646a919d7e64fa990bca9b024ff089d",22901783,1,-4,0,1013,302,298,-4
"7646a919d7e64fa990bca9b024ff089d","e390b575229748ea8aac9364efe2bf00",22901783,1,7,0,1014,298,304,6
"e390b575229748ea8aac9364efe2bf00","e390b575229748ea8aac9364efe2bf00",22901783,1,0,1,1015,304,304,0
"e390b575229748ea8aac9364efe2bf00","4a29443515bb404cb8924e1c60a63b73",22901783,1,-24,0,1016,304,285,-19
"4a29443515bb404cb8924e1c60a63b73","3434c10e561d488a914e0f7d71907abd",22901783,1,27,0,1017,285,305,20
"3434c10e561d488a914e0f7d71907abd","53e7e900392747ccad52e711ab0f80d8",22901783,3,2,0,1018,305,307,2
"53e7e900392747ccad52e711ab0f80d8","3434c10e561d488a914e0f7d71907abd",22901783,3,-2,0,1019,307,305,-2
"3434c10e561d488a914e0f7d71907abd","130acc2aeb0448fdbb2de63bc5cebe5b",22901783,1,5,0,1024,305,309,4
"130acc2aeb0448fdbb2de63bc5cebe5b","9c062b3251034ebe90f5054e2a3b5120",22901783,1,2,0,1025,309,311,2
"9c062b3251034ebe90f5054e2a3b5120","9c062b3251034ebe90f5054e2a3b5120",22901783,2,0,1,1026,311,311,0
"9c062b3251034ebe90f5054e2a3b5120","ea859f8207e44537889daeaba13ac2e8",22901783,1,1,0,1028,311,312,1
"ea859f8207e44537889daeaba13ac2e8","ea859f8207e44537889daeaba13ac2e8",22901783,4,0,1,1029,312,312,0
"ea859f8207e44537889daeaba13ac2e8","56d94971a7a94257aa330183a8ebd0ea",22901783,1,1,0,1033,312,313,1
"56d94971a7a94257aa330183a8ebd0ea","56d94971a7a94257aa330183a8ebd0ea",22901783,1,0,1,1034,313,313,0
"56d94971a7a94257aa330183a8ebd0ea","141c0df6cd1946539aadd1c9b7068cd4",22901783,1,-5,0,1035,313,308,-5
"141c0df6cd1946539aadd1c9b7068cd4","13255e63e0aa4abf85e5211bf613d43e",22901783,1,10,0,1036,308,317,9
"13255e63e0aa4abf85e5211bf613d43e","13255e63e0aa4abf85e5211bf613d43e",22901783,1,0,1,1037,317,317,0
"13255e63e0aa4abf85e5211bf613d43e","0c787d16c9504873b1a4d903cec09948",22901783,1,-3,0,1038,317,314,-3
"0c787d16c9504873b1a4d903cec09948","86c27d40179e419c8e9d150fb6afa5d0",22901783,1,6,0,1039,314,319,5
"86c27d40179e419c8e9d150fb6afa5d0","47edbb64109243e6b0f8f64cdef90c6c",22901783,1,8,0,1040,319,326,7
"47edbb64109243e6b0f8f64cdef90c6c","8d7e0b55cf9849cda222a0f2440cec55",22901783,1,-9,0,1041,326,318,-8
"8d7e0b55cf9849cda222a0f2440cec55","24f1363179ad4aaa965484a78471912b",22901783,1,6,0,1042,318,323,5
"24f1363179ad4aaa965484a78471912b","3628bdce1dd2429ba924d2d4d09448d2",22901783,1,-1,0,1043,323,322,-1
"3628bdce1dd2429ba924d2d4d09448d2","56b3fd1a212a4764be39d979fde3326e",22901783,1,7,0,1044,322,328,6
"56b3fd1a212a4764be39d979fde3326e","56b3fd1a212a4764be39d979fde3326e",22901783,1,0,1,1045,328,328,0
"56b3fd1a212a4764be39d979fde3326e","0c4079457ede49e3aeb5e86ed84bdf35",22901783,1,3,0,1046,328,329,1
"0c4079457ede49e3aeb5e86ed84bdf35","3434c10e561d488a914e0f7d71907abd",22901783,1,-31,0,1047,329,305,-24
"3434c10e561d488a914e0f7d71907abd","38aea304b4fa46e1b29bb72f5cea4c93",22901783,1,33,0,1048,305,331,26
"38aea304b4fa46e1b29bb72f5cea4c93","e36d261332f14e79bb4b467aceaeb9b5",22901783,1,2,0,1049,331,333,2
"e36d261332f14e79bb4b467aceaeb9b5","e36d261332f14e79bb4b467aceaeb9b5",22901783,1,0,1,1050,333,333,0
"e36d261332f14e79bb4b467aceaeb9b5","c7e89b9d04744d2eab742fc24e3ef1ae",22901783,1,1,0,1051,333,334,1
"c7e89b9d04744d2eab742fc24e3ef1ae","c7e89b9d04744d2eab742fc24e3ef1ae",22901783,2,0,1,1052,334,334,0
"c7e89b9d04744d2eab742fc24e3ef1ae","fe49f8054b374a0ea4bb266ed135ff62",22901783,1,1,0,1054,334,335,1
"fe49f8054b374a0ea4bb266ed135ff62","fe49f8054b374a0ea4bb266ed135ff62",22901783,2,0,1,1055,335,335,0
"fe49f8054b374a0ea4bb266ed135ff62","d0a8f74af98642fe8360d22c42e45117",22901783,1,1,0,1057,335,336,1
"d0a8f74af98642fe8360d22c42e45117","d0a8f74af98642fe8360d22c42e45117",22901783,2,0,1,1058,336,336,0
"d0a8f74af98642fe8360d22c42e45117","0c4079457ede49e3aeb5e86ed84bdf35",22901783,1,-7,0,1060,336,329,-7
"0c4079457ede49e3aeb5e86ed84bdf35","a7c6339ca1da4368a18d471f0519f877",22901783,1,11,0,1061,329,339,10
"a7c6339ca1da4368a18d471f0519f877","a7c6339ca1da4368a18d471f0519f877",22901783,1,0,1,1062,339,339,0
"a7c6339ca1da4368a18d471f0519f877","bbc5139ca9024389a94db3a6f47dcff6",22901783,1,3,0,1063,339,341,2
"bbc5139ca9024389a94db3a6f47dcff6","b8b9418ab322418d9db9b40d96af873a",22901783,1,-5,0,1064,341,337,-4
"b8b9418ab322418d9db9b40d96af873a","4ee6ca9019ab4a1ab323f98094a9bd77",22901783,1,7,0,1065,337,343,6
"4ee6ca9019ab4a1ab323f98094a9bd77","4ee6ca9019ab4a1ab323f98094a9bd77",22901783,2,0,1,1066,343,343,0
"4ee6ca9019ab4a1ab323f98094a9bd77","b37947176785476f8b29d49a851366dc",22901783,1,1,0,1068,343,344,1
"b37947176785476f8b29d49a851366dc","b37947176785476f8b29d49a851366dc",22901783,2,0,1,1069,344,344,0
"b37947176785476f8b29d49a851366dc","fcea5b10d5a14a3b9324ffece8f6e1e5",22901783,1,1,0,1071,344,345,1
"fcea5b10d5a14a3b9324ffece8f6e1e5","fcea5b10d5a14a3b9324ffece8f6e1e5",22901783,2,0,1,1072,345,345,0
"fcea5b10d5a14a3b9324ffece8f6e1e5","c2490bc612d146edbe786556fab3651b",22901783,1,-5,0,1074,345,340,-5
"c2490bc612d146edbe786556fab3651b","6ac8bb048b854999a47edb35fe627f11",22901783,1,8,0,1075,340,347,7
"6ac8bb048b854999a47edb35fe627f11","6ac8bb048b854999a47edb35fe627f11",22901783,1,0,1,1076,347,347,0
"6ac8bb048b854999a47edb35fe627f11","0c4079457ede49e3aeb5e86ed84bdf35",22901783,1,-21,0,1077,347,329,-18
"0c4079457ede49e3aeb5e86ed84bdf35","30ead9794d4847abaf222ca966cc8630",22901783,1,24,0,1078,329,348,19
"30ead9794d4847abaf222ca966cc8630","897b7f51242c44aab2205c72fdcbf4cd",22901783,1,4,0,1079,348,352,4
"897b7f51242c44aab2205c72fdcbf4cd","09b9678ddc3d452ea4a3d46e15826065",22901783,2,1,0,1080,352,353,1
"09b9678ddc3d452ea4a3d46e15826065","eff0de7f2dbb42dfa1a2e686efab5b6d",22901783,2,1,0,1081,353,354,1
"eff0de7f2dbb42dfa1a2e686efab5b6d","c20993c944444fe085345591a8bd837e",22901783,1,-3,0,1082,354,351,-3
"c20993c944444fe085345591a8bd837e","c20993c944444fe085345591a8bd837e",22901783,4,0,1,1083,351,351,0
"c20993c944444fe085345591a8bd837e","897b7f51242c44aab2205c72fdcbf4cd",22901783,1,1,0,1087,351,352,1
"897b7f51242c44aab2205c72fdcbf4cd","897b7f51242c44aab2205c72fdcbf4cd",22901783,3,0,1,1088,352,352,0
"09b9678ddc3d452ea4a3d46e15826065","09b9678ddc3d452ea4a3d46e15826065",22901783,3,0,1,1092,353,353,0
"eff0de7f2dbb42dfa1a2e686efab5b6d","eff0de7f2dbb42dfa1a2e686efab5b6d",22901783,3,0,1,1096,354,354,0
"eff0de7f2dbb42dfa1a2e686efab5b6d","30ead9794d4847abaf222ca966cc8630",22901783,1,-6,0,1099,354,348,-6
"30ead9794d4847abaf222ca966cc8630","2fe14166dc9642c3bc666b86a57f943d",22901783,1,10,0,1100,348,357,9
"2fe14166dc9642c3bc666b86a57f943d","44421dd1e13a47a388c4a19834b744c7",22901783,1,2,0,1101,357,359,2
"44421dd1e13a47a388c4a19834b744c7","44421dd1e13a47a388c4a19834b744c7",22901783,2,0,1,1102,359,359,0
"44421dd1e13a47a388c4a19834b744c7","cb5fc7ef85d547c4be1a7439d0bf6052",22901783,1,1,0,1104,359,360,1
"cb5fc7ef85d547c4be1a7439d0bf6052","cb5fc7ef85d547c4be1a7439d0bf6052",22901783,5,0,1,1105,360,360,0
"cb5fc7ef85d547c4be1a7439d0bf6052","0a8f150a4cf747acbde62f4721823da3",22901783,1,1,0,1110,360,361,1
"0a8f150a4cf747acbde62f4721823da3","0a8f150a4cf747acbde62f4721823da3",22901783,2,0,1,1111,361,361,0
"0a8f150a4cf747acbde62f4721823da3","ab8fdad974ae471f9f24c3f9dd04462e",22901783,1,1,0,1113,361,362,1
"ab8fdad974ae471f9f24c3f9dd04462e","ab8fdad974ae471f9f24c3f9dd04462e",22901783,2,0,1,1114,362,362,0
"ab8fdad974ae471f9f24c3f9dd04462e","1ba8fef685d74a8194b9db252eb704fb",22901783,1,-7,0,1116,362,355,-7
"1ba8fef685d74a8194b9db252eb704fb","52580888dadb4fe3baa795683ea227bd",22901783,1,10,0,1117,355,364,9
"52580888dadb4fe3baa795683ea227bd","492a3bc6a1254f23a7998587961b22a4",22901783,1,3,0,1118,364,366,2
"492a3bc6a1254f23a7998587961b22a4","f00179e251a045b39c3f7a54f9aa4acc",22901783,1,-4,0,1119,366,363,-3
"f00179e251a045b39c3f7a54f9aa4acc","072a190fd302456290895f9f04d6940a",22901783,1,3,0,1120,363,365,2
"072a190fd302456290895f9f04d6940a","cfa457d1743848e4bb5e4beced6448ed",22901783,1,5,0,1121,365,369,4
"cfa457d1743848e4bb5e4beced6448ed","cfa457d1743848e4bb5e4beced6448ed",22901783,1,0,1,1122,369,369,0
"cfa457d1743848e4bb5e4beced6448ed","b71bac264efb4abd97015447bd490db6",22901783,1,3,0,1123,369,370,1
"b71bac264efb4abd97015447bd490db6","30ead9794d4847abaf222ca966cc8630",22901783,1,-28,0,1124,370,348,-22
"30ead9794d4847abaf222ca966cc8630","b71bac264efb4abd97015447bd490db6",22901783,1,28,0,1125,348,370,22
"b71bac264efb4abd97015447bd490db6","8d448d625b024c82a5eb240bbd7431d6",22901783,2,5,0,1126,370,374,4
"8d448d625b024c82a5eb240bbd7431d6","8d448d625b024c82a5eb240bbd7431d6",22901783,61,0,1,1127,374,374,0
"8d448d625b024c82a5eb240bbd7431d6","78adeee1fa2c4fe0bc73f7bca9fcee86",22901783,1,-289,0,1179,374,160,-214
"78adeee1fa2c4fe0bc73f7bca9fcee86","65202579580f4ad38d734b4ee39d22a8",22901783,7,5,0,1180,160,164,4
"65202579580f4ad38d734b4ee39d22a8","65202579580f4ad38d734b4ee39d22a8",22901783,80,0,1,1181,164,164,0
"65202579580f4ad38d734b4ee39d22a8","0d987bed3ffa4ed0b9a2e62e97b7b30f",22901783,1,147,0,1188,164,272,108
"0d987bed3ffa4ed0b9a2e62e97b7b30f","bb5a47f5ea01454a8b79455422d3b9da",22901783,2,10,0,1189,272,280,8
"bb5a47f5ea01454a8b79455422d3b9da","bb5a47f5ea01454a8b79455422d3b9da",22901783,65,0,1,1190,280,280,0
"bb5a47f5ea01454a8b79455422d3b9da","66baf19b6b904b70922329068c63746d",22901783,1,134,0,1199,280,376,96
"66baf19b6b904b70922329068c63746d","7f544639412e40a9ba27f43b415362ab",22901783,2,2,0,1200,376,378,2
"7f544639412e40a9ba27f43b415362ab","b71bac264efb4abd97015447bd490db6",22901783,1,-14,0,1201,378,370,-8
"8d448d625b024c82a5eb240bbd7431d6","d6d02b6ef04e4f17805504500b8ce441",22901783,1,3,0,1212,374,375,1
"d6d02b6ef04e4f17805504500b8ce441","b71bac264efb4abd97015447bd490db6",22901783,1,-8,0,1213,375,370,-5
"b71bac264efb4abd97015447bd490db6","d6d02b6ef04e4f17805504500b8ce441",22901783,1,8,0,1214,370,375,5
"d6d02b6ef04e4f17805504500b8ce441","66baf19b6b904b70922329068c63746d",22901783,1,4,0,1215,375,376,1
"7f544639412e40a9ba27f43b415362ab","d5ae8642e15b46b8bd298b02274d4e9c",22901783,1,2,0,1217,378,380,2
"d5ae8642e15b46b8bd298b02274d4e9c","d5ae8642e15b46b8bd298b02274d4e9c",22901783,1,0,1,1218,380,380,0
"d5ae8642e15b46b8bd298b02274d4e9c","a0d10309a2dd456289147f84be9d37f9",22901783,1,1,0,1219,380,381,1
"a0d10309a2dd456289147f84be9d37f9","a0d10309a2dd456289147f84be9d37f9",22901783,2,0,1,1220,381,381,0
"a0d10309a2dd456289147f84be9d37f9","0fcbc3ca07b144138b8d85da581f09a8",22901783,1,1,0,1222,381,382,1
"0fcbc3ca07b144138b8d85da581f09a8","0fcbc3ca07b144138b8d85da581f09a8",22901783,2,0,1,1223,382,382,0
"0fcbc3ca07b144138b8d85da581f09a8","66baf19b6b904b70922329068c63746d",22901783,1,-6,0,1225,382,376,-6
"66baf19b6b904b70922329068c63746d","4890121ce5d74576b4632b77cfc23398",22901783,1,14,0,1226,376,388,12
"4890121ce5d74576b4632b77cfc23398","c2fca3669923477ab966ded303dea31c",22901783,1,-6,0,1227,388,383,-5
"c2fca3669923477ab966ded303dea31c","96bb2b3e85a34d8b9544514e89f6fe97",22901783,1,9,0,1228,383,390,7
"96bb2b3e85a34d8b9544514e89f6fe97","18d3b836dd804224883cc9180b60a8e1",22901783,1,-4,0,1229,390,387,-3
"18d3b836dd804224883cc9180b60a8e1","ac4e9b54acfe4670b4634859c7263cb5",22901783,1,6,0,1230,387,392,5
"ac4e9b54acfe4670b4634859c7263cb5","ac4e9b54acfe4670b4634859c7263cb5",22901783,1,0,1,1231,392,392,0
"ac4e9b54acfe4670b4634859c7263cb5","6f8881a745ac4c358a68b92c3b4abe81",22901783,1,3,0,1232,392,394,2
"6f8881a745ac4c358a68b92c3b4abe81","17f95d18bab743888e1736033dc3384d",22901783,1,-6,0,1233,394,389,-5
"17f95d18bab743888e1736033dc3384d","f7002c8484354eceac57bc7bd62c76c1",22901783,1,5,0,1234,389,393,4
"f7002c8484354eceac57bc7bd62c76c1","44a277ea44dc4ae689fab4b82f0b4098",22901783,1,5,0,1235,393,397,4
"44a277ea44dc4ae689fab4b82f0b4098","44a277ea44dc4ae689fab4b82f0b4098",22901783,1,0,1,1236,397,397,0
"44a277ea44dc4ae689fab4b82f0b4098","0c12af0a4e7f4002852cf84b2537c161",22901783,1,-2,0,1237,397,395,-2
"0c12af0a4e7f4002852cf84b2537c161","859e0b8d71694b12befb69ee698138f9",22901783,1,5,0,1238,395,399,4
"859e0b8d71694b12befb69ee698138f9","859e0b8d71694b12befb69ee698138f9",22901783,1,0,1,1239,399,399,0
"859e0b8d71694b12befb69ee698138f9","2b09a08242b54983aec7063990fb3f66",22901783,1,3,0,1240,399,400,1
"2b09a08242b54983aec7063990fb3f66","66baf19b6b904b70922329068c63746d",22901783,1,-32,0,1241,400,376,-24
"66baf19b6b904b70922329068c63746d","2b09a08242b54983aec7063990fb3f66",22901783,1,32,0,1242,376,400,24
"2b09a08242b54983aec7063990fb3f66","1f471b7a883a4df48211e8c6a81b59a7",22901783,1,1,0,1243,400,401,1
"1f471b7a883a4df48211e8c6a81b59a7","1f471b7a883a4df48211e8c6a81b59a7",22901783,1,0,1,1244,401,401,0
"1f471b7a883a4df48211e8c6a81b59a7","2b09a08242b54983aec7063990fb3f66",22901783,1,-1,0,1245,401,400,-1
"2b09a08242b54983aec7063990fb3f66","9de0d567bfa84fe5b77cb76f4a76a5d1",22901783,1,5,0,1246,400,404,4
"9de0d567bfa84fe5b77cb76f4a76a5d1","9de0d567bfa84fe5b77cb76f4a76a5d1",22901783,1,0,1,1247,404,404,0
"9de0d567bfa84fe5b77cb76f4a76a5d1","1157bd665ec4472fb58b751dc5099355",22901783,1,-1,0,1248,404,403,-1
"1157bd665ec4472fb58b751dc5099355","58fc9094275e4c49be3f4ba6d4acc0a4",22901783,1,5,0,1249,403,406,3
"58fc9094275e4c49be3f4ba6d4acc0a4","3c8a22d2f9c146ea956609e3ed4f2559",22901783,1,-2,0,1250,406,405,-1
"3c8a22d2f9c146ea956609e3ed4f2559","c1c1be90b2b14c1ab4a5e1ee3c241902",22901783,1,3,0,1251,405,407,2
"c1c1be90b2b14c1ab4a5e1ee3c241902","c1c1be90b2b14c1ab4a5e1ee3c241902",22901783,5,0,1,1252,407,407,0
"c1c1be90b2b14c1ab4a5e1ee3c241902","02b3a1bead9244c1ba2f857c7da8f82a",22901783,1,2,0,1257,407,408,1
"02b3a1bead9244c1ba2f857c7da8f82a","58fc9094275e4c49be3f4ba6d4acc0a4",22901783,1,-3,0,1258,408,406,-2
"58fc9094275e4c49be3f4ba6d4acc0a4","6206fc6479014bb193084c32409dc1b9",22901783,1,4,0,1259,406,409,3
"6206fc6479014bb193084c32409dc1b9","6206fc6479014bb193084c32409dc1b9",22901783,4,0,1,1260,409,409,0
"6206fc6479014bb193084c32409dc1b9","6a5f020451db426dacba9e2ea3fcc62a",22901783,1,2,0,1264,409,410,1
"6a5f020451db426dacba9e2ea3fcc62a","02b3a1bead9244c1ba2f857c7da8f82a",22901783,1,-3,0,1265,410,408,-2
"02b3a1bead9244c1ba2f857c7da8f82a","33a9d248b2e44588a5b07fc1342b9bc2",22901783,1,5,0,1266,408,411,3
"33a9d248b2e44588a5b07fc1342b9bc2","6a5f020451db426dacba9e2ea3fcc62a",22901783,1,-2,0,1267,411,410,-1
"6a5f020451db426dacba9e2ea3fcc62a","c6f26bd420634f1cb7989e76fe6b16c0",22901783,1,3,0,1268,410,412,2
"c6f26bd420634f1cb7989e76fe6b16c0","c6f26bd420634f1cb7989e76fe6b16c0",22901783,5,0,1,1269,412,412,0
"c6f26bd420634f1cb7989e76fe6b16c0","2a65ee6e2ac64f6a8a55fbe5373ec763",22901783,1,1,0,1274,412,413,1
"2a65ee6e2ac64f6a8a55fbe5373ec763","2a65ee6e2ac64f6a8a55fbe5373ec763",22901783,2,0,1,1275,413,413,0
"2a65ee6e2ac64f6a8a55fbe5373ec763","33a9d248b2e44588a5b07fc1342b9bc2",22901783,1,-2,0,1277,413,411,-2
"33a9d248b2e44588a5b07fc1342b9bc2","1fd0f6dadbc14ebc965faf6122190b96",22901783,1,5,0,1278,411,415,4
"1fd0f6dadbc14ebc965faf6122190b96","1fd0f6dadbc14ebc965faf6122190b96",22901783,1,0,1,1279,415,415,0
"1fd0f6dadbc14ebc965faf6122190b96","687055dad9fc40c3982478fe33ec01bf",22901783,1,-1,0,1280,415,414,-1
"687055dad9fc40c3982478fe33ec01bf","2add1669f08d4101913db15f8c23b3b7",22901783,1,3,0,1281,414,416,2
"2add1669f08d4101913db15f8c23b3b7","2add1669f08d4101913db15f8c23b3b7",22901783,1,0,1,1282,416,416,0
"2add1669f08d4101913db15f8c23b3b7","a2b4bd40cee2481ebd3fc179d6a5cd62",22901783,1,3,0,1283,416,417,1
"a2b4bd40cee2481ebd3fc179d6a5cd62","2b09a08242b54983aec7063990fb3f66",22901783,1,-27,0,1284,417,400,-17
"2b09a08242b54983aec7063990fb3f66","e34e59dce2204f228f3a84b6725df60f",22901783,1,29,0,1285,400,419,19
"e34e59dce2204f228f3a84b6725df60f","e34e59dce2204f228f3a84b6725df60f",22901783,1,0,1,1286,419,419,0
"e34e59dce2204f228f3a84b6725df60f","bec48fc2e1294c7eb3d0aca780d731b8",22901783,1,2,0,1287,419,420,1
"bec48fc2e1294c7eb3d0aca780d731b8","a2b4bd40cee2481ebd3fc179d6a5cd62",22901783,1,-4,0,1288,420,417,-3
"a2b4bd40cee2481ebd3fc179d6a5cd62","bec48fc2e1294c7eb3d0aca780d731b8",22901783,1,4,0,1289,417,420,3
"bec48fc2e1294c7eb3d0aca780d731b8","a24600b0e49245f6bdba8c893cfeddb0",22901783,1,7,0,1290,420,425,5
"a24600b0e49245f6bdba8c893cfeddb0","dbde19fcce2a4c1abdc7f685c293a23f",22901783,2,-4,0,1291,425,422,-3
"dbde19fcce2a4c1abdc7f685c293a23f","a24600b0e49245f6bdba8c893cfeddb0",22901783,2,4,0,1292,422,425,3
"a24600b0e49245f6bdba8c893cfeddb0","a24600b0e49245f6bdba8c893cfeddb0",22901783,1,0,1,1295,425,425,0
"a24600b0e49245f6bdba8c893cfeddb0","24cf8786024543f19b89bc20034e60d7",22901783,1,7,0,1296,425,428,3
"24cf8786024543f19b89bc20034e60d7","a2b4bd40cee2481ebd3fc179d6a5cd62",22901783,1,-18,0,1297,428,417,-11
"a2b4bd40cee2481ebd3fc179d6a5cd62","f2a73be2f46840b182d7bd095378004e",22901783,1,19,0,1298,417,429,12
"f2a73be2f46840b182d7bd095378004e","604551fd4266430cb860fef58fa7dd61",22901783,1,1,0,1299,429,430,1
"604551fd4266430cb860fef58fa7dd61","604551fd4266430cb860fef58fa7dd61",22901783,9,0,1,1300,430,430,0
"604551fd4266430cb860fef58fa7dd61","24cf8786024543f19b89bc20034e60d7",22901783,1,-2,0,1309,430,428,-2
"24cf8786024543f19b89bc20034e60d7","dce46f8904594a62a6377a3587aaa663",22901783,1,4,0,1310,428,431,3
"dce46f8904594a62a6377a3587aaa663","9b9d0a249052413c869753b99682b0ac",22901783,1,1,0,1311,431,432,1
"9b9d0a249052413c869753b99682b0ac","9b9d0a249052413c869753b99682b0ac",22901783,7,0,1,1312,432,432,0
"9b9d0a249052413c869753b99682b0ac","061c175cc90f45fbad883025394e78dd",22901783,1,1,0,1319,432,433,1
"061c175cc90f45fbad883025394e78dd","061c175cc90f45fbad883025394e78dd",22901783,6,0,1,1320,433,433,0
"061c175cc90f45fbad883025394e78dd","dce46f8904594a62a6377a3587aaa663",22901783,1,-2,0,1326,433,431,-2
"dce46f8904594a62a6377a3587aaa663","dce46f8904594a62a6377a3587aaa663",22901783,1,0,1,1327,431,431,0
"dce46f8904594a62a6377a3587aaa663","66ada10dde9f43018588f1ced9d477fc",22901783,1,4,0,1328,431,434,3
"66ada10dde9f43018588f1ced9d477fc","dce46f8904594a62a6377a3587aaa663",22901783,1,-4,0,1329,434,431,-3
"dce46f8904594a62a6377a3587aaa663","74a7f8712e5449c2bc0b43c6f90dafed",22901783,1,5,0,1330,431,435,4
"74a7f8712e5449c2bc0b43c6f90dafed","74a7f8712e5449c2bc0b43c6f90dafed",22901783,1,0,1,1331,435,435,0
"74a7f8712e5449c2bc0b43c6f90dafed","66ada10dde9f43018588f1ced9d477fc",22901783,1,-1,0,1332,435,434,-1
"66ada10dde9f43018588f1ced9d477fc","bf12c96466d840a69bed7020b3f18bb8",22901783,1,3,0,1333,434,436,2
"bf12c96466d840a69bed7020b3f18bb8","bf12c96466d840a69bed7020b3f18bb8",22901783,1,0,1,1334,436,436,0
"bf12c96466d840a69bed7020b3f18bb8","070600601c4c439288445d2f0724807d",22901783,1,3,0,1335,436,437,1
"070600601c4c439288445d2f0724807d","24cf8786024543f19b89bc20034e60d7",22901783,1,-14,0,1336,437,428,-9
"24cf8786024543f19b89bc20034e60d7","1823b6de7d334a7aaabc4570719af4d9",22901783,1,16,0,1337,428,439,11
"1823b6de7d334a7aaabc4570719af4d9","1823b6de7d334a7aaabc4570719af4d9",22901783,17,0,1,1338,439,439,0
"1823b6de7d334a7aaabc4570719af4d9","070600601c4c439288445d2f0724807d",22901783,1,-2,0,1355,439,437,-2
"070600601c4c439288445d2f0724807d","0380cd76a7d44bc3a4da1f15e4d68f89",22901783,1,4,0,1356,437,440,3
"0380cd76a7d44bc3a4da1f15e4d68f89","23b7673c8b5443108c2ef09382834a86",22901783,2,2,0,1357,440,441,1
"23b7673c8b5443108c2ef09382834a86","0380cd76a7d44bc3a4da1f15e4d68f89",22901783,1,-2,0,1358,441,440,-1
"23b7673c8b5443108c2ef09382834a86","901e92500aea43c79f19f1b279050668",22901783,1,2,0,1360,441,442,1
"901e92500aea43c79f19f1b279050668","001339db8ced4cf78829ebe8b145449d",22901783,1,1,0,1361,442,443,1
"001339db8ced4cf78829ebe8b145449d","001339db8ced4cf78829ebe8b145449d",22901783,5,0,1,1362,443,443,0
"001339db8ced4cf78829ebe8b145449d","452745e0366e42ae81561bfddebcc6c3",22901783,1,1,0,1367,443,444,1
"452745e0366e42ae81561bfddebcc6c3","452745e0366e42ae81561bfddebcc6c3",22901783,2,0,1,1368,444,444,0
"452745e0366e42ae81561bfddebcc6c3","901e92500aea43c79f19f1b279050668",22901783,1,-2,0,1370,444,442,-2
"901e92500aea43c79f19f1b279050668","4660ff2089114e8db82ceb26a4f329e3",22901783,1,4,0,1371,442,445,3
"4660ff2089114e8db82ceb26a4f329e3","7bd5586eb9d8484eb74a433ee7bfe499",22901783,2,2,0,1372,445,446,1
"7bd5586eb9d8484eb74a433ee7bfe499","4660ff2089114e8db82ceb26a4f329e3",22901783,1,-2,0,1373,446,445,-1
"7bd5586eb9d8484eb74a433ee7bfe499","7bd5586eb9d8484eb74a433ee7bfe499",22901783,20,0,1,1375,446,446,0
"7bd5586eb9d8484eb74a433ee7bfe499","8a7f26e690f34dda97be16904518ca99",22901783,1,2,0,1395,446,447,1
"8a7f26e690f34dda97be16904518ca99","8a7f26e690f34dda97be16904518ca99",22901783,1,0,1,1396,447,447,0
"8a7f26e690f34dda97be16904518ca99","b2f0d654738f48158edff28e8d3a546e",22901783,1,5,0,1397,447,449,2
"b2f0d654738f48158edff28e8d3a546e","070600601c4c439288445d2f0724807d",22901783,1,-21,0,1398,449,437,-12
"070600601c4c439288445d2f0724807d","f67fbf45a5f146ed866965bc57c7c001",22901783,1,29,0,1399,437,454,17
"f67fbf45a5f146ed866965bc57c7c001","f67fbf45a5f146ed866965bc57c7c001",22901783,4,0,1,1400,454,454,0
"f67fbf45a5f146ed866965bc57c7c001","d937afe49bd24a07a550dda1c1155122",22901783,1,1,0,1404,454,455,1
"d937afe49bd24a07a550dda1c1155122","d937afe49bd24a07a550dda1c1155122",22901783,1,0,1,1405,455,455,0
"d937afe49bd24a07a550dda1c1155122","3628b3f7823443d0912a339096b69943",22901783,1,1,0,1406,455,456,1
"3628b3f7823443d0912a339096b69943","3628b3f7823443d0912a339096b69943",22901783,1,0,1,1407,456,456,0
"3628b3f7823443d0912a339096b69943","9e049ee647cf43ecbcb5ed792a8e7588",22901783,1,1,0,1408,456,457,1
"9e049ee647cf43ecbcb5ed792a8e7588","9e049ee647cf43ecbcb5ed792a8e7588",22901783,1,0,1,1409,457,457,0
"9e049ee647cf43ecbcb5ed792a8e7588","5256a214faaf410b93f76cea06428334",22901783,1,1,0,1410,457,458,1
"5256a214faaf410b93f76cea06428334","5256a214faaf410b93f76cea06428334",22901783,1,0,1,1411,458,458,0
"5256a214faaf410b93f76cea06428334","25c32b120fce40fa9b6c85133aeb4716",22901783,1,1,0,1412,458,459,1
"25c32b120fce40fa9b6c85133aeb4716","25c32b120fce40fa9b6c85133aeb4716",22901783,1,0,1,1413,459,459,0
"25c32b120fce40fa9b6c85133aeb4716","11bc14f2204949008b7d511b933363c1",22901783,1,1,0,1414,459,460,1
"11bc14f2204949008b7d511b933363c1","11bc14f2204949008b7d511b933363c1",22901783,1,0,1,1415,460,460,0
"11bc14f2204949008b7d511b933363c1","42de338840a34d15adb66e7b14fb9d2c",22901783,1,1,0,1416,460,461,1
"42de338840a34d15adb66e7b14fb9d2c","42de338840a34d15adb66e7b14fb9d2c",22901783,3,0,1,1417,461,461,0
"42de338840a34d15adb66e7b14fb9d2c","9da37c6210b1416b8079c274f70bf600",22901783,1,1,0,1420,461,462,1
"9da37c6210b1416b8079c274f70bf600","9da37c6210b1416b8079c274f70bf600",22901783,3,0,1,1421,462,462,0
"9da37c6210b1416b8079c274f70bf600","519119f1deac45ff9ab4f13529be5c6e",22901783,1,1,0,1424,462,463,1
"519119f1deac45ff9ab4f13529be5c6e","519119f1deac45ff9ab4f13529be5c6e",22901783,1,0,1,1425,463,463,0
"519119f1deac45ff9ab4f13529be5c6e","c5df9f40ec14463b9dcfdc73df3e9285",22901783,1,3,0,1426,463,464,1
"c5df9f40ec14463b9dcfdc73df3e9285","f67fbf45a5f146ed866965bc57c7c001",22901783,1,-12,0,1427,464,454,-10
"f67fbf45a5f146ed866965bc57c7c001","c5df9f40ec14463b9dcfdc73df3e9285",22901783,1,12,0,1428,454,464,10
"c5df9f40ec14463b9dcfdc73df3e9285","b2f0d654738f48158edff28e8d3a546e",22901783,1,-20,0,1429,464,449,-15
"b2f0d654738f48158edff28e8d3a546e","f60ee41ec635499abd48168342d32c2f",22901783,2,5,0,1430,449,453,4
"f60ee41ec635499abd48168342d32c2f","f60ee41ec635499abd48168342d32c2f",22901783,51,0,1,1431,453,453,0
"f60ee41ec635499abd48168342d32c2f","b2f0d654738f48158edff28e8d3a546e",22901783,1,-5,0,1433,453,449,-4
"f60ee41ec635499abd48168342d32c2f","83d42d95cd844fc093fc09cee250edb8",22901783,1,18,0,1484,453,465,12
"83d42d95cd844fc093fc09cee250edb8","83d42d95cd844fc093fc09cee250edb8",22901783,2,0,1,1485,465,465,0
"e2911e79efc2420eac45d9f671463d4b","e2911e79efc2420eac45d9f671463d4b",22900468,2,0,1,1,2,2,0
"e2911e79efc2420eac45d9f671463d4b","b613861cecf84ffcab01afb23f660475",22900468,2,-3,0,2,2,1,-1
"b613861cecf84ffcab01afb23f660475","b613861cecf84ffcab01afb23f660475",22900468,3,0,1,3,1,1,0
"b613861cecf84ffcab01afb23f660475","e2911e79efc2420eac45d9f671463d4b",22900468,2,3,0,6,1,2,1
"e2911e79efc2420eac45d9f671463d4b","519d1b8c59404d67b54e96c5c8a830b2",22900468,1,1,0,10,2,3,1
"519d1b8c59404d67b54e96c5c8a830b2","519d1b8c59404d67b54e96c5c8a830b2",22900468,1,0,1,11,3,3,0
"519d1b8c59404d67b54e96c5c8a830b2","531db53f81f646edb0cdcfe0085b03b7",22900468,1,1,0,12,3,4,1
"531db53f81f646edb0cdcfe0085b03b7","531db53f81f646edb0cdcfe0085b03b7",22900468,1,0,1,13,4,4,0
"531db53f81f646edb0cdcfe0085b03b7","4f5f94b2f95141e0a9d53a61da2276da",22900468,1,1,0,14,4,5,1
"4f5f94b2f95141e0a9d53a61da2276da","4f5f94b2f95141e0a9d53a61da2276da",22900468,1,0,1,15,5,5,0
"4f5f94b2f95141e0a9d53a61da2276da","6d541c89590949f99af293c4f2333f67",22900468,1,1,0,16,5,6,1
"6d541c89590949f99af293c4f2333f67","6d541c89590949f99af293c4f2333f67",22900468,1,0,1,17,6,6,0
"6d541c89590949f99af293c4f2333f67","dd5cf0b9fe4c4f1d8f5ff8e4c04879cb",22900468,1,1,0,18,6,7,1
"dd5cf0b9fe4c4f1d8f5ff8e4c04879cb","dd5cf0b9fe4c4f1d8f5ff8e4c04879cb",22900468,1,0,1,19,7,7,0
"dd5cf0b9fe4c4f1d8f5ff8e4c04879cb","f96261861edc426abe2248be4f0a709a",22900468,1,1,0,20,7,8,1
"f96261861edc426abe2248be4f0a709a","f96261861edc426abe2248be4f0a709a",22900468,1,0,1,21,8,8,0
"f96261861edc426abe2248be4f0a709a","66b5e16f4f75454fb5b8172079f0fa83",22900468,1,1,0,22,8,9,1
"66b5e16f4f75454fb5b8172079f0fa83","66b5e16f4f75454fb5b8172079f0fa83",22900468,1,0,1,23,9,9,0
"66b5e16f4f75454fb5b8172079f0fa83","0680571d4698477995e41842c36a54b2",22900468,1,1,0,24,9,10,1
"0680571d4698477995e41842c36a54b2","0680571d4698477995e41842c36a54b2",22900468,1,0,1,25,10,10,0
"0680571d4698477995e41842c36a54b2","9112f2bffece48e08c6d2287be204085",22900468,1,1,0,26,10,11,1
"9112f2bffece48e08c6d2287be204085","9112f2bffece48e08c6d2287be204085",22900468,1,0,1,27,11,11,0
"9112f2bffece48e08c6d2287be204085","56586aa865414f538729c7f7735d2bc6",22900468,1,3,0,28,11,12,1
"56586aa865414f538729c7f7735d2bc6","e2911e79efc2420eac45d9f671463d4b",22900468,1,-12,0,29,12,2,-10
"e2911e79efc2420eac45d9f671463d4b","56586aa865414f538729c7f7735d2bc6",22900468,1,12,0,30,2,12,10
"56586aa865414f538729c7f7735d2bc6","56586aa865414f538729c7f7735d2bc6",22900468,2,0,1,31,12,12,0
"56586aa865414f538729c7f7735d2bc6","b7f2b31585d94eb3bf86376714aa7070",22900468,1,2,0,33,12,13,1
"b7f2b31585d94eb3bf86376714aa7070","b7f2b31585d94eb3bf86376714aa7070",22900468,2,0,1,34,13,13,0
"b7f2b31585d94eb3bf86376714aa7070","3f1c815879794b929260d224becaff7e",22900468,1,2,0,36,13,14,1
"3f1c815879794b929260d224becaff7e","5c5ceeee4562457ba6d41515aeebfbb1",22900468,1,6,0,37,14,17,3
"5c5ceeee4562457ba6d41515aeebfbb1","81c864a886d54a6b8ff85f7d736f4f95",22900468,1,-4,0,38,17,15,-2
"81c864a886d54a6b8ff85f7d736f4f95","5c5ceeee4562457ba6d41515aeebfbb1",22900468,1,4,0,39,15,17,2
"5c5ceeee4562457ba6d41515aeebfbb1","56586aa865414f538729c7f7735d2bc6",22900468,1,-10,0,40,17,12,-5
"56586aa865414f538729c7f7735d2bc6","9afd71a5298d4333b6849dfce1b9422c",22900468,1,13,0,41,12,18,6
"9afd71a5298d4333b6849dfce1b9422c","b7719e26494940efa49512aedd0aac79",22900468,1,4,0,45,18,20,2
"b7719e26494940efa49512aedd0aac79","d4f45188d3c84a02ba08454e6403a818",22900468,1,5,0,46,20,24,4
"d4f45188d3c84a02ba08454e6403a818","d4c3b003e8274e429d2fa688d73fde6d",22900468,2,-2,0,47,24,22,-2
"d4c3b003e8274e429d2fa688d73fde6d","d4c3b003e8274e429d2fa688d73fde6d",22900468,2,0,1,48,22,22,0
"d4c3b003e8274e429d2fa688d73fde6d","b7719e26494940efa49512aedd0aac79",22900468,2,-3,0,50,22,20,-2
"b7719e26494940efa49512aedd0aac79","a49d1bb4328949299686242fd0be5584",22900468,1,2,0,51,20,21,1
"a49d1bb4328949299686242fd0be5584","d4f45188d3c84a02ba08454e6403a818",22900468,1,3,0,52,21,24,3
"b7719e26494940efa49512aedd0aac79","b7719e26494940efa49512aedd0aac79",22900468,2,0,1,55,20,20,0
"b7719e26494940efa49512aedd0aac79","afbf7250b99d47bea07172749483ca97",22900468,1,12,0,57,20,28,8
"afbf7250b99d47bea07172749483ca97","afbf7250b99d47bea07172749483ca97",22900468,1,0,1,58,28,28,0
"afbf7250b99d47bea07172749483ca97","4e51676dc72045d99c19b9fa7b22f8bc",22900468,1,3,0,59,28,29,1
"4e51676dc72045d99c19b9fa7b22f8bc","4e51676dc72045d99c19b9fa7b22f8bc",22900468,1,0,1,60,29,29,0
"4e51676dc72045d99c19b9fa7b22f8bc","51970cfa30e643e894e66ae85c8024cc",22900468,1,3,0,61,29,31,2
"51970cfa30e643e894e66ae85c8024cc","c33c17be71ae4d588da7369472e5bb1b",22900468,1,6,0,62,31,34,3
"c33c17be71ae4d588da7369472e5bb1b","4e51676dc72045d99c19b9fa7b22f8bc",22900468,1,-9,0,63,34,29,-5
"4e51676dc72045d99c19b9fa7b22f8bc","c33c17be71ae4d588da7369472e5bb1b",22900468,1,9,0,64,29,34,5
"c33c17be71ae4d588da7369472e5bb1b","93679be414554a11b1893002f2229a93",22900468,1,3,0,65,34,35,1
"93679be414554a11b1893002f2229a93","7040a13096d746ac84b8fac8d9752058",22900468,2,3,0,66,35,36,1
"7040a13096d746ac84b8fac8d9752058","93679be414554a11b1893002f2229a93",22900468,1,-3,0,67,36,35,-1
"7040a13096d746ac84b8fac8d9752058","9a0dc646f934470daf08c4b56ccf73db",22900468,1,3,0,69,36,37,1
"9a0dc646f934470daf08c4b56ccf73db","fc0e049d56024bc9a02c9a9c435c3df7",22900468,1,3,0,70,37,38,1
"fc0e049d56024bc9a02c9a9c435c3df7","9a0dc646f934470daf08c4b56ccf73db",22900468,1,-3,0,71,38,37,-1
"9a0dc646f934470daf08c4b56ccf73db","67a089198fcb4e1c8f2385786c2b296f",22900468,1,7,0,72,37,39,2
"67a089198fcb4e1c8f2385786c2b296f","fc0e049d56024bc9a02c9a9c435c3df7",22900468,1,-4,0,73,39,38,-1
"fc0e049d56024bc9a02c9a9c435c3df7","64d48c6c9c7940639a932219a6c87198",22900468,1,5,0,74,38,40,2
"64d48c6c9c7940639a932219a6c87198","67a089198fcb4e1c8f2385786c2b296f",22900468,2,-1,0,75,40,39,-1
"67a089198fcb4e1c8f2385786c2b296f","b534b89233134e30a9b5645138bfa9ee",22900468,1,4,0,81,39,41,2
"b534b89233134e30a9b5645138bfa9ee","6875d67fdd5f48168b62719df449bebd",22900468,1,4,0,82,41,45,4
"6875d67fdd5f48168b62719df449bebd","6875d67fdd5f48168b62719df449bebd",22900468,1,0,1,83,45,45,0
"6875d67fdd5f48168b62719df449bebd","0e37b720d23b4e7f8b313e79313fd107",22900468,1,-1,0,84,45,44,-1
"0e37b720d23b4e7f8b313e79313fd107","0e37b720d23b4e7f8b313e79313fd107",22900468,1,0,1,85,44,44,0
"0e37b720d23b4e7f8b313e79313fd107","b534b89233134e30a9b5645138bfa9ee",22900468,1,-3,0,86,44,41,-3
"b534b89233134e30a9b5645138bfa9ee","6e13d61a7bdb44bca949c9f86fab3be5",22900468,1,7,0,87,41,47,6
"6e13d61a7bdb44bca949c9f86fab3be5","6e13d61a7bdb44bca949c9f86fab3be5",22900468,1,0,1,88,47,47,0
"6e13d61a7bdb44bca949c9f86fab3be5","195f78799f984cc2b06c48dfe36be751",22900468,1,2,0,89,47,49,2
"195f78799f984cc2b06c48dfe36be751","195f78799f984cc2b06c48dfe36be751",22900468,2,0,1,90,49,49,0
"195f78799f984cc2b06c48dfe36be751","d9c8d8c444a64dadbbb508652c721e17",22900468,1,-3,0,92,49,46,-3
"d9c8d8c444a64dadbbb508652c721e17","d0c74f735e024943943e40333d6d337f",22900468,1,6,0,93,46,51,5
"d0c74f735e024943943e40333d6d337f","0c7262dff33c4087bc660ccf40f92f9c",22900468,1,153,0,94,51,169,118
"b2275c3fad834f8d90737a2d9a6927d6","f924752d8a1149668870b1e7698486f7",22900468,1,-157,0,96,172,50,-122
"f924752d8a1149668870b1e7698486f7","b534b89233134e30a9b5645138bfa9ee",22900468,1,-11,0,97,50,41,-9
"d0c74f735e024943943e40333d6d337f","d0c74f735e024943943e40333d6d337f",22900468,1,0,1,99,51,51,0
"d0c74f735e024943943e40333d6d337f","983f8ff320594b279a7f4a6fe132f9c5",22900468,1,2,0,100,51,53,2
"983f8ff320594b279a7f4a6fe132f9c5","983f8ff320594b279a7f4a6fe132f9c5",22900468,2,0,1,101,53,53,0
"983f8ff320594b279a7f4a6fe132f9c5","35adfa5d923046aebabfefd98f35ff05",22900468,1,1,0,103,53,54,1
"35adfa5d923046aebabfefd98f35ff05","35adfa5d923046aebabfefd98f35ff05",22900468,5,0,1,104,54,54,0
"35adfa5d923046aebabfefd98f35ff05","b6f8a98476224da1b40e555ececc7ed8",22900468,1,1,0,109,54,55,1
"b6f8a98476224da1b40e555ececc7ed8","b6f8a98476224da1b40e555ececc7ed8",22900468,2,0,1,110,55,55,0
"b6f8a98476224da1b40e555ececc7ed8","86e22cb5fe0e4b47a9489ecddf7ed78f",22900468,1,1,0,112,55,56,1
"86e22cb5fe0e4b47a9489ecddf7ed78f","86e22cb5fe0e4b47a9489ecddf7ed78f",22900468,2,0,1,113,56,56,0
"86e22cb5fe0e4b47a9489ecddf7ed78f","f924752d8a1149668870b1e7698486f7",22900468,1,-6,0,115,56,50,-6
"78f30e4dcac84e3cbea8b2cc6e0d62b3","a1f2f12debe5432fb7a70bcd12bacfb9",22900468,1,-1,0,118,59,58,-1
"a1f2f12debe5432fb7a70bcd12bacfb9","a1f2f12debe5432fb7a70bcd12bacfb9",22900468,15,0,1,119,58,58,0
"78f30e4dcac84e3cbea8b2cc6e0d62b3","78f30e4dcac84e3cbea8b2cc6e0d62b3",22900468,7,0,1,135,59,59,0
"78f30e4dcac84e3cbea8b2cc6e0d62b3","a0a418b8540d479fa6e0f653b701da8b",22900468,1,6,0,142,59,64,5
"a0a418b8540d479fa6e0f653b701da8b","12aa6e1672ac4e7aa6449a7a8609cd72",22900468,1,-8,0,143,64,57,-7
"12aa6e1672ac4e7aa6449a7a8609cd72","bc42d26810654ea9a1df1efe1e58c7d5",22900468,1,7,0,144,57,63,6
"bc42d26810654ea9a1df1efe1e58c7d5","4c943503763e4e349906eea3ed3c8e86",22900468,1,-2,0,145,63,61,-2
"4c943503763e4e349906eea3ed3c8e86","4c943503763e4e349906eea3ed3c8e86",22900468,1,0,1,146,61,61,0
"4c943503763e4e349906eea3ed3c8e86","bc42d26810654ea9a1df1efe1e58c7d5",22900468,1,2,0,147,61,63,2
"309ccf3cc4fe429d9bfbaef53d3fa479","b534b89233134e30a9b5645138bfa9ee",22900468,1,-23,0,156,60,41,-19
"d646286c8051419bbc2e31dd1db55ca8","267f883678b24aed855fde42524975d9",22900468,1,4,0,158,67,71,4
"267f883678b24aed855fde42524975d9","267f883678b24aed855fde42524975d9",22900468,1,0,1,159,71,71,0
"267f883678b24aed855fde42524975d9","88fff56d0342490dbef9040750a20f6c",22900468,1,1,0,160,71,72,1
"88fff56d0342490dbef9040750a20f6c","88fff56d0342490dbef9040750a20f6c",22900468,1,0,1,161,72,72,0
"88fff56d0342490dbef9040750a20f6c","adb17b12b66c4a49a85fd34322f7df70",22900468,1,1,0,162,72,73,1
"adb17b12b66c4a49a85fd34322f7df70","adb17b12b66c4a49a85fd34322f7df70",22900468,1,0,1,163,73,73,0
"adb17b12b66c4a49a85fd34322f7df70","d646286c8051419bbc2e31dd1db55ca8",22900468,1,-6,0,164,73,67,-6
"a2becd407db34b189200a32546d9d569","58c22b011d0f4c2ea6d13615edbb9eeb",22900468,1,2,0,167,75,77,2
"58c22b011d0f4c2ea6d13615edbb9eeb","58c22b011d0f4c2ea6d13615edbb9eeb",22900468,5,0,1,168,77,77,0
"58c22b011d0f4c2ea6d13615edbb9eeb","dd76e1861dc9461c830888729d091ee0",22900468,1,1,0,173,77,78,1
"dd76e1861dc9461c830888729d091ee0","dd76e1861dc9461c830888729d091ee0",22900468,8,0,1,174,78,78,0
"dd76e1861dc9461c830888729d091ee0","cd1d828f1a694b87913a7ea66c23803e",22900468,1,1,0,182,78,79,1
"cd1d828f1a694b87913a7ea66c23803e","cd1d828f1a694b87913a7ea66c23803e",22900468,2,0,1,183,79,79,0
"cd1d828f1a694b87913a7ea66c23803e","9176a3c2b4d2465fa8b0c67096c2a97e",22900468,1,1,0,185,79,80,1
"9176a3c2b4d2465fa8b0c67096c2a97e","9176a3c2b4d2465fa8b0c67096c2a97e",22900468,11,0,1,186,80,80,0
"9176a3c2b4d2465fa8b0c67096c2a97e","f8ec6445f7194e25b9101d4fbcb07a18",22900468,1,1,0,197,80,81,1
"f8ec6445f7194e25b9101d4fbcb07a18","f8ec6445f7194e25b9101d4fbcb07a18",22900468,2,0,1,198,81,81,0
"f8ec6445f7194e25b9101d4fbcb07a18","140d5b27b8574befad82c0a013b59dfa",22900468,1,-7,0,200,81,74,-7
"d18a9ea32855445f8736581f5cb119ce","f564483cbd7a407681aa2fcca518cf5f",22900468,1,4,0,202,82,85,3
"f564483cbd7a407681aa2fcca518cf5f","f564483cbd7a407681aa2fcca518cf5f",22900468,1,0,1,203,85,85,0
"f564483cbd7a407681aa2fcca518cf5f","18fd01350bd5434ca636d59a599d768a",22900468,1,1,0,204,85,86,1
"18fd01350bd5434ca636d59a599d768a","18fd01350bd5434ca636d59a599d768a",22900468,8,0,1,205,86,86,0
"18fd01350bd5434ca636d59a599d768a","ae5ac430ea254e708a6f5deaaf7464ae",22900468,1,-2,0,213,86,84,-2
"6a9f0ef185fb47f0937e29daa1c71ed5","42fb58708eaf4e5daa82bfca61b6f5fd",22900468,1,-3,0,215,90,87,-3
"42fb58708eaf4e5daa82bfca61b6f5fd","ae5ac430ea254e708a6f5deaaf7464ae",22900468,1,-4,0,216,87,84,-3
"ae5ac430ea254e708a6f5deaaf7464ae","d18a9ea32855445f8736581f5cb119ce",22900468,1,-3,0,217,84,82,-2
"6a9f0ef185fb47f0937e29daa1c71ed5","c681290961c94c4caf23b529d1ae6b9a",22900468,1,-2,0,220,90,88,-2
"c681290961c94c4caf23b529d1ae6b9a","c681290961c94c4caf23b529d1ae6b9a",22900468,1,0,1,221,88,88,0
"c681290961c94c4caf23b529d1ae6b9a","6a9f0ef185fb47f0937e29daa1c71ed5",22900468,1,2,0,222,88,90,2
"6a9f0ef185fb47f0937e29daa1c71ed5","d646286c8051419bbc2e31dd1db55ca8",22900468,1,-27,0,226,90,67,-23
"d646286c8051419bbc2e31dd1db55ca8","e20db35ced8544ddac5bc3839145e463",22900468,1,30,0,227,67,91,24
"e20db35ced8544ddac5bc3839145e463","1febb706d7a34005ae8711ed49c76e64",22900468,1,3,0,228,91,94,3
"1febb706d7a34005ae8711ed49c76e64","1febb706d7a34005ae8711ed49c76e64",22900468,2,0,1,229,94,94,0
"1febb706d7a34005ae8711ed49c76e64","8f73ba6f5a0042f2850356ac38ac6f24",22900468,1,1,0,231,94,95,1
"8f73ba6f5a0042f2850356ac38ac6f24","8f73ba6f5a0042f2850356ac38ac6f24",22900468,5,0,1,232,95,95,0
"8f73ba6f5a0042f2850356ac38ac6f24","e2260b86653c46d7b14a41fb419dbf8c",22900468,1,1,0,237,95,96,1
"e2260b86653c46d7b14a41fb419dbf8c","e2260b86653c46d7b14a41fb419dbf8c",22900468,2,0,1,238,96,96,0
"e2260b86653c46d7b14a41fb419dbf8c","35eb641ad1d845bbba54915bce75a962",22900468,1,1,0,240,96,97,1
"35eb641ad1d845bbba54915bce75a962","35eb641ad1d845bbba54915bce75a962",22900468,2,0,1,241,97,97,0
"35eb641ad1d845bbba54915bce75a962","08be90ffbeea4795a138cd42ed8db56f",22900468,1,1,0,243,97,98,1
"08be90ffbeea4795a138cd42ed8db56f","08be90ffbeea4795a138cd42ed8db56f",22900468,2,0,1,244,98,98,0
"08be90ffbeea4795a138cd42ed8db56f","3007433c8f584dcbb5ac159c1c5f2be3",22900468,1,1,0,246,98,99,1
"3007433c8f584dcbb5ac159c1c5f2be3","3007433c8f584dcbb5ac159c1c5f2be3",22900468,2,0,1,247,99,99,0
"3007433c8f584dcbb5ac159c1c5f2be3","d391c8b6e56a43a7b654e9dee02d904b",22900468,1,5,0,249,99,103,4
"d391c8b6e56a43a7b654e9dee02d904b","e20db35ced8544ddac5bc3839145e463",22900468,1,-13,0,250,103,91,-12
"e20db35ced8544ddac5bc3839145e463","00ae5f0c51874a73a41ebea838d95682",22900468,2,11,0,251,91,101,10
"00ae5f0c51874a73a41ebea838d95682","73039f8c1eb9409cb4caee2cf968001e",22900468,1,-1,0,252,101,100,-1
"73039f8c1eb9409cb4caee2cf968001e","e20db35ced8544ddac5bc3839145e463",22900468,1,-10,0,253,100,91,-9
"00ae5f0c51874a73a41ebea838d95682","d391c8b6e56a43a7b654e9dee02d904b",22900468,2,2,0,255,101,103,2
"d391c8b6e56a43a7b654e9dee02d904b","00ae5f0c51874a73a41ebea838d95682",22900468,1,-2,0,256,103,101,-2
"d391c8b6e56a43a7b654e9dee02d904b","d391c8b6e56a43a7b654e9dee02d904b",22900468,15,0,1,258,103,103,0
"d391c8b6e56a43a7b654e9dee02d904b","6111116566fc4fd9abba409322bea245",22900468,1,1,0,273,103,104,1
"6111116566fc4fd9abba409322bea245","6111116566fc4fd9abba409322bea245",22900468,2,0,1,274,104,104,0
"6111116566fc4fd9abba409322bea245","a81b2235cb9c499eb9ea8ee0a8dd9725",22900468,1,1,0,276,104,105,1
"a81b2235cb9c499eb9ea8ee0a8dd9725","a81b2235cb9c499eb9ea8ee0a8dd9725",22900468,5,0,1,277,105,105,0
"a81b2235cb9c499eb9ea8ee0a8dd9725","2d4e0ab0ef3b4d73b82c72d4621a7579",22900468,1,1,0,282,105,106,1
"2d4e0ab0ef3b4d73b82c72d4621a7579","2d4e0ab0ef3b4d73b82c72d4621a7579",22900468,2,0,1,283,106,106,0
"2d4e0ab0ef3b4d73b82c72d4621a7579","8bdebf492ebd4e62b0d522e8ab5e5197",22900468,1,1,0,285,106,107,1
"8bdebf492ebd4e62b0d522e8ab5e5197","8bdebf492ebd4e62b0d522e8ab5e5197",22900468,2,0,1,286,107,107,0
"8bdebf492ebd4e62b0d522e8ab5e5197","73039f8c1eb9409cb4caee2cf968001e",22900468,1,-7,0,288,107,100,-7
"73039f8c1eb9409cb4caee2cf968001e","4280927ec4d643238aa49c32f9e06c6c",22900468,1,10,0,289,100,109,9
"4280927ec4d643238aa49c32f9e06c6c","4280927ec4d643238aa49c32f9e06c6c",22900468,1,0,1,290,109,109,0
"4280927ec4d643238aa49c32f9e06c6c","fc44e6a5f7654430af1227838224dceb",22900468,1,2,0,291,109,111,2
"fc44e6a5f7654430af1227838224dceb","fc44e6a5f7654430af1227838224dceb",22900468,2,0,1,292,111,111,0
"fc44e6a5f7654430af1227838224dceb","08111f75e22d409998cf8b85bd431f0a",22900468,1,-3,0,294,111,108,-3
"a9ae0a3c070d455bb4369a8996313336","a9ae0a3c070d455bb4369a8996313336",22900468,1,0,1,296,114,114,0
"a9ae0a3c070d455bb4369a8996313336","71cec822bcff4f30a20e75dc63ef7b65",22900468,1,2,0,297,114,116,2
"71cec822bcff4f30a20e75dc63ef7b65","71cec822bcff4f30a20e75dc63ef7b65",22900468,3,0,1,298,116,116,0
"71cec822bcff4f30a20e75dc63ef7b65","37319e88176d4aefa91d7a9980dbae91",22900468,1,-4,0,301,116,112,-4
"e20db35ced8544ddac5bc3839145e463","e20db35ced8544ddac5bc3839145e463",22900468,4,0,1,304,91,91,0
"e20db35ced8544ddac5bc3839145e463","37319e88176d4aefa91d7a9980dbae91",22900468,1,24,0,308,91,112,21
"37319e88176d4aefa91d7a9980dbae91","a9ae0a3c070d455bb4369a8996313336",22900468,1,2,0,309,112,114,2
"a9ae0a3c070d455bb4369a8996313336","62bff51286ef4f348717a3cf6fe2318f",22900468,1,7,0,310,114,120,6
"62bff51286ef4f348717a3cf6fe2318f","37319e88176d4aefa91d7a9980dbae91",22900468,1,-9,0,311,120,112,-8
"37319e88176d4aefa91d7a9980dbae91","b1cd0e7dc3ad4a8eb91a4bfdbeb025b0",22900468,1,7,0,312,112,118,6
"b1cd0e7dc3ad4a8eb91a4bfdbeb025b0","b1cd0e7dc3ad4a8eb91a4bfdbeb025b0",22900468,1,0,1,313,118,118,0
"b1cd0e7dc3ad4a8eb91a4bfdbeb025b0","62bff51286ef4f348717a3cf6fe2318f",22900468,1,2,0,314,118,120,2
"62bff51286ef4f348717a3cf6fe2318f","779f9ddd1fd14d1e9e69f72219a1fdbd",22900468,1,3,0,318,120,121,1
"779f9ddd1fd14d1e9e69f72219a1fdbd","e20db35ced8544ddac5bc3839145e463",22900468,1,-36,0,319,121,91,-30
"779f9ddd1fd14d1e9e69f72219a1fdbd","ae26e6cda8ad4a3f81bd347560d9579f",22900468,1,4,0,321,121,125,4
"ae26e6cda8ad4a3f81bd347560d9579f","ae26e6cda8ad4a3f81bd347560d9579f",22900468,3,0,1,322,125,125,0
"ae26e6cda8ad4a3f81bd347560d9579f","ee48df95832b4374aa273ceb27ec1315",22900468,1,1,0,325,125,126,1
"ee48df95832b4374aa273ceb27ec1315","ee48df95832b4374aa273ceb27ec1315",22900468,1,0,1,326,126,126,0
"ee48df95832b4374aa273ceb27ec1315","7a439da90b394756ad1777fc4c6dead5",22900468,1,1,0,327,126,127,1
"7a439da90b394756ad1777fc4c6dead5","7a439da90b394756ad1777fc4c6dead5",22900468,1,0,1,328,127,127,0
"7a439da90b394756ad1777fc4c6dead5","779f9ddd1fd14d1e9e69f72219a1fdbd",22900468,1,-6,0,329,127,121,-6
"a8dd5213034441ac92724b4e83eb0bb2","a8dd5213034441ac92724b4e83eb0bb2",22900468,1,0,1,331,129,129,0
"a8dd5213034441ac92724b4e83eb0bb2","8115eab6556b45f5b415c3b8c26a12e5",22900468,1,2,0,332,129,131,2
"8115eab6556b45f5b415c3b8c26a12e5","8115eab6556b45f5b415c3b8c26a12e5",22900468,11,0,1,333,131,131,0
"8115eab6556b45f5b415c3b8c26a12e5","ec34b06efd844b46a4c4818ecdb9b8f4",22900468,1,1,0,344,131,132,1
"ec34b06efd844b46a4c4818ecdb9b8f4","ec34b06efd844b46a4c4818ecdb9b8f4",22900468,2,0,1,345,132,132,0
"ec34b06efd844b46a4c4818ecdb9b8f4","c2e1c2b9eac64109b343a088584b576b",22900468,1,1,0,347,132,133,1
"c2e1c2b9eac64109b343a088584b576b","c2e1c2b9eac64109b343a088584b576b",22900468,2,0,1,348,133,133,0
"c2e1c2b9eac64109b343a088584b576b","579338175e0b4bbb8ef3b712b5d8b54e",22900468,1,-5,0,350,133,128,-5
"579338175e0b4bbb8ef3b712b5d8b54e","8bc5795d6a984a3eace4e2811e52dd4f",22900468,1,8,0,351,128,135,7
"8bc5795d6a984a3eace4e2811e52dd4f","8bc5795d6a984a3eace4e2811e52dd4f",22900468,1,0,1,352,135,135,0
"8bc5795d6a984a3eace4e2811e52dd4f","b416d47c56a742199b5d7c7f19d6503a",22900468,1,-1,0,353,135,134,-1
"b416d47c56a742199b5d7c7f19d6503a","cd4532ad48034873ba8bce2aac0c9808",22900468,1,4,0,354,134,137,3
"cd4532ad48034873ba8bce2aac0c9808","cd4532ad48034873ba8bce2aac0c9808",22900468,1,0,1,355,137,137,0
"cd4532ad48034873ba8bce2aac0c9808","df1de691dafe4549a18a4398ee9dfaf9",22900468,1,4,0,356,137,139,2
"6c5ad271a44743479bfaea29b1db8d02","6c5ad271a44743479bfaea29b1db8d02",22900468,2,0,1,359,143,143,0
"6c5ad271a44743479bfaea29b1db8d02","83d311bed5374fee83d8d67a7d9d82dc",22900468,1,1,0,361,143,144,1
"83d311bed5374fee83d8d67a7d9d82dc","83d311bed5374fee83d8d67a7d9d82dc",22900468,1,0,1,362,144,144,0
"83d311bed5374fee83d8d67a7d9d82dc","402bba41861d43acb52a5abb89e8831e",22900468,1,1,0,363,144,145,1
"402bba41861d43acb52a5abb89e8831e","402bba41861d43acb52a5abb89e8831e",22900468,2,0,1,364,145,145,0
"402bba41861d43acb52a5abb89e8831e","df1de691dafe4549a18a4398ee9dfaf9",22900468,1,-6,0,366,145,139,-6
"df1de691dafe4549a18a4398ee9dfaf9","8aae34f5ddbb4052a709b12e6b0d40fa",22900468,1,9,0,367,139,147,8
"8aae34f5ddbb4052a709b12e6b0d40fa","8aae34f5ddbb4052a709b12e6b0d40fa",22900468,1,0,1,368,147,147,0
"8aae34f5ddbb4052a709b12e6b0d40fa","645b3f0249f64f76af2e19eb4d0e55b7",22900468,1,2,0,369,147,149,2
"645b3f0249f64f76af2e19eb4d0e55b7","645b3f0249f64f76af2e19eb4d0e55b7",22900468,8,0,1,370,149,149,0
"645b3f0249f64f76af2e19eb4d0e55b7","7e7b8db5064d4369805ab370aac5ddfb",22900468,1,1,0,378,149,150,1
"7e7b8db5064d4369805ab370aac5ddfb","7e7b8db5064d4369805ab370aac5ddfb",22900468,5,0,1,379,150,150,0
"7e7b8db5064d4369805ab370aac5ddfb","8956d210ae7f41968fada86d4c979d6a",22900468,1,1,0,384,150,151,1
"8956d210ae7f41968fada86d4c979d6a","8956d210ae7f41968fada86d4c979d6a",22900468,2,0,1,385,151,151,0
"8956d210ae7f41968fada86d4c979d6a","f902b0f41b544d4dbf79664fd233648d",22900468,1,-5,0,387,151,146,-5
"f902b0f41b544d4dbf79664fd233648d","ae781e8b775e4ccd93bc800dad5c8376",22900468,1,8,0,388,146,153,7
"ae781e8b775e4ccd93bc800dad5c8376","ae781e8b775e4ccd93bc800dad5c8376",22900468,2,0,1,389,153,153,0
"ae781e8b775e4ccd93bc800dad5c8376","06882a8492d9499aa31555567f575ecb",22900468,1,1,0,391,153,154,1
"06882a8492d9499aa31555567f575ecb","06882a8492d9499aa31555567f575ecb",22900468,1,0,1,392,154,154,0
"06882a8492d9499aa31555567f575ecb","f293c508f409466a8f27ddd7d1e40b20",22900468,1,1,0,393,154,155,1
"f293c508f409466a8f27ddd7d1e40b20","f293c508f409466a8f27ddd7d1e40b20",22900468,2,0,1,394,155,155,0
"f293c508f409466a8f27ddd7d1e40b20","cc4ddef5bbbe48ebb605141b347c4ed1",22900468,1,1,0,396,155,156,1
"cc4ddef5bbbe48ebb605141b347c4ed1","cc4ddef5bbbe48ebb605141b347c4ed1",22900468,5,0,1,397,156,156,0
"cc4ddef5bbbe48ebb605141b347c4ed1","f03480cf4eba413194d7af52fc0e7f28",22900468,1,-4,0,402,156,152,-4
"d313cec988a84645bee413e8d4724a4b","dc60696c76a74368a60f72246e47700d",22900468,1,1,0,408,158,159,1
"dc60696c76a74368a60f72246e47700d","dc60696c76a74368a60f72246e47700d",22900468,1,0,1,409,159,159,0
"dc60696c76a74368a60f72246e47700d","df1de691dafe4549a18a4398ee9dfaf9",22900468,1,-23,0,410,159,139,-20
"78adeee1fa2c4fe0bc73f7bca9fcee86","0c7262dff33c4087bc660ccf40f92f9c",22900468,1,17,0,412,160,169,9
"0c7262dff33c4087bc660ccf40f92f9c","0c7262dff33c4087bc660ccf40f92f9c",22900468,1,0,1,413,169,169,0
"0c7262dff33c4087bc660ccf40f92f9c","b2275c3fad834f8d90737a2d9a6927d6",22900468,2,3,0,414,169,172,3
"b2275c3fad834f8d90737a2d9a6927d6","b2275c3fad834f8d90737a2d9a6927d6",22900468,20,0,1,415,172,172,0
"b2275c3fad834f8d90737a2d9a6927d6","eb515a26030b41f8a82a1e6114420bad",22900468,1,1,0,435,172,173,1
"eb515a26030b41f8a82a1e6114420bad","eb515a26030b41f8a82a1e6114420bad",22900468,2,0,1,436,173,173,0
"eb515a26030b41f8a82a1e6114420bad","0c7262dff33c4087bc660ccf40f92f9c",22900468,1,-4,0,438,173,169,-4
"0c7262dff33c4087bc660ccf40f92f9c","b42cc17b7de840f181a704558d0bc845",22900468,1,7,0,439,169,175,6
"b42cc17b7de840f181a704558d0bc845","b42cc17b7de840f181a704558d0bc845",22900468,1,0,1,440,175,175,0
"b42cc17b7de840f181a704558d0bc845","801f9e9135034f49bf5f8b4bdefedb41",22900468,1,2,0,441,175,177,2
"801f9e9135034f49bf5f8b4bdefedb41","801f9e9135034f49bf5f8b4bdefedb41",22900468,4,0,1,442,177,177,0
"801f9e9135034f49bf5f8b4bdefedb41","362fcb0699a14845ab29b2340093e528",22900468,1,-3,0,446,177,174,-3
"362fcb0699a14845ab29b2340093e528","ea38cc0e6e6e41edbabf210220808bf9",22900468,1,6,0,447,174,179,5
"ea38cc0e6e6e41edbabf210220808bf9","b87c552dd247427abe6ab5795b9c9d43",22900468,2,2,0,448,179,181,2
"b87c552dd247427abe6ab5795b9c9d43","ea38cc0e6e6e41edbabf210220808bf9",22900468,1,-2,0,449,181,179,-2
"b87c552dd247427abe6ab5795b9c9d43","b87c552dd247427abe6ab5795b9c9d43",22900468,6,0,1,451,181,181,0
"b87c552dd247427abe6ab5795b9c9d43","139b097acfca451689d80c9c6eebdf7b",22900468,1,-3,0,457,181,178,-3
"139b097acfca451689d80c9c6eebdf7b","b87c552dd247427abe6ab5795b9c9d43",22900468,1,3,0,458,178,181,3
"b87c552dd247427abe6ab5795b9c9d43","30f660a1feb34582a739722532524f79",22900468,1,3,0,459,181,183,2
"30f660a1feb34582a739722532524f79","30f660a1feb34582a739722532524f79",22900468,9,0,1,460,183,183,0
"30f660a1feb34582a739722532524f79","2024b4885bd14338a39b7b509acbbd02",22900468,1,-1,0,469,183,182,-1
"2024b4885bd14338a39b7b509acbbd02","c3f63fe50d8e487c86bf8ef76c9cadd3",22900468,1,4,0,470,182,185,3
"c3f63fe50d8e487c86bf8ef76c9cadd3","c3f63fe50d8e487c86bf8ef76c9cadd3",22900468,1,0,1,471,185,185,0
"c3f63fe50d8e487c86bf8ef76c9cadd3","c8e371568a0c4391b25796ae4e91952e",22900468,1,3,0,472,185,186,1
"c8e371568a0c4391b25796ae4e91952e","0c7262dff33c4087bc660ccf40f92f9c",22900468,1,-23,0,473,186,169,-17
"0c7262dff33c4087bc660ccf40f92f9c","7d932b23e1c84326ae5aa4d3c0d813d1",22900468,1,25,0,474,169,188,19
"7d932b23e1c84326ae5aa4d3c0d813d1","7d932b23e1c84326ae5aa4d3c0d813d1",22900468,1,0,1,475,188,188,0
"7d932b23e1c84326ae5aa4d3c0d813d1","ab11d94c6c8948ea90b88f19d2cd502b",22900468,1,3,0,476,188,190,2
"ab11d94c6c8948ea90b88f19d2cd502b","c8e371568a0c4391b25796ae4e91952e",22900468,1,-5,0,477,190,186,-4
"c8e371568a0c4391b25796ae4e91952e","c8e371568a0c4391b25796ae4e91952e",22900468,1,0,1,478,186,186,0
"c8e371568a0c4391b25796ae4e91952e","ab11d94c6c8948ea90b88f19d2cd502b",22900468,1,5,0,479,186,190,4
"ab11d94c6c8948ea90b88f19d2cd502b","ab11d94c6c8948ea90b88f19d2cd502b",22900468,1,0,1,480,190,190,0
"ab11d94c6c8948ea90b88f19d2cd502b","f992451ed6ad4e68bb9e68ad6be7c4be",22900468,1,2,0,481,190,192,2
"f992451ed6ad4e68bb9e68ad6be7c4be","f992451ed6ad4e68bb9e68ad6be7c4be",22900468,1,0,1,482,192,192,0
"f992451ed6ad4e68bb9e68ad6be7c4be","6cd2dcaac46847d4a0bc53f296d90375",22900468,1,3,0,483,192,194,2
"6cd2dcaac46847d4a0bc53f296d90375","07b44a7a51e94c78b411c753fc39dab0",22900468,1,-6,0,484,194,189,-5
"07b44a7a51e94c78b411c753fc39dab0","6cd2dcaac46847d4a0bc53f296d90375",22900468,1,6,0,485,189,194,5
"6cd2dcaac46847d4a0bc53f296d90375","2d2580c9411c4972909db508d6956a58",22900468,1,2,0,486,194,196,2
"2d2580c9411c4972909db508d6956a58","2d2580c9411c4972909db508d6956a58",22900468,8,0,1,487,196,196,0
"2d2580c9411c4972909db508d6956a58","5bddb3d9ed264f3984702f048c7e5340",22900468,1,1,0,495,196,197,1
"5bddb3d9ed264f3984702f048c7e5340","5bddb3d9ed264f3984702f048c7e5340",22900468,2,0,1,496,197,197,0
"5bddb3d9ed264f3984702f048c7e5340","d5e8e2bd12a2466b9d6d90855f0eb079",22900468,1,1,0,498,197,198,1
"d5e8e2bd12a2466b9d6d90855f0eb079","d5e8e2bd12a2466b9d6d90855f0eb079",22900468,2,0,1,499,198,198,0
"d5e8e2bd12a2466b9d6d90855f0eb079","017d7ca8e0394b91aaadc9574df2202c",22900468,1,-5,0,501,198,193,-5
"017d7ca8e0394b91aaadc9574df2202c","54e8e9f0ea3e45c4bf3b8ac799ee31b1",22900468,1,8,0,502,193,200,7
"54e8e9f0ea3e45c4bf3b8ac799ee31b1","54e8e9f0ea3e45c4bf3b8ac799ee31b1",22900468,1,0,1,503,200,200,0
"54e8e9f0ea3e45c4bf3b8ac799ee31b1","c614a00911be4877a075f19315530fb0",22900468,1,1,0,504,200,201,1
"c614a00911be4877a075f19315530fb0","c614a00911be4877a075f19315530fb0",22900468,6,0,1,505,201,201,0
"c614a00911be4877a075f19315530fb0","a6c21bd8b95249c7972820a7a7d76aff",22900468,1,1,0,511,201,202,1
"a6c21bd8b95249c7972820a7a7d76aff","a6c21bd8b95249c7972820a7a7d76aff",22900468,1,0,1,512,202,202,0
"a6c21bd8b95249c7972820a7a7d76aff","bb329d880ab54120adaf203a693bb203",22900468,1,1,0,513,202,203,1
"bb329d880ab54120adaf203a693bb203","bb329d880ab54120adaf203a693bb203",22900468,1,0,1,514,203,203,0
"bb329d880ab54120adaf203a693bb203","f9170dd6bc6442b4acd832747609b09a",22900468,1,-4,0,515,203,199,-4
"f9170dd6bc6442b4acd832747609b09a","334c2344009840079b1d0e1b7ce3d5a7",22900468,1,7,0,516,199,205,6
"334c2344009840079b1d0e1b7ce3d5a7","334c2344009840079b1d0e1b7ce3d5a7",22900468,1,0,1,517,205,205,0
"334c2344009840079b1d0e1b7ce3d5a7","c8e371568a0c4391b25796ae4e91952e",22900468,1,-23,0,518,205,186,-19
"c8e371568a0c4391b25796ae4e91952e","d7f13c8d63ec4e2aa673fbb9cf9c6933",22900468,1,26,0,519,186,206,20
"d7f13c8d63ec4e2aa673fbb9cf9c6933","7108f0e4c2584f1f9c471689ae4c885c",22900468,1,2,0,520,206,208,2
"7108f0e4c2584f1f9c471689ae4c885c","b9e80f77c3a44349863b19875725c384",22900468,1,-1,0,521,208,207,-1
"b9e80f77c3a44349863b19875725c384","b9e80f77c3a44349863b19875725c384",22900468,14,0,1,522,207,207,0
"b9e80f77c3a44349863b19875725c384","7108f0e4c2584f1f9c471689ae4c885c",22900468,1,1,0,536,207,208,1
"7108f0e4c2584f1f9c471689ae4c885c","7108f0e4c2584f1f9c471689ae4c885c",22900468,10,0,1,537,208,208,0
"7108f0e4c2584f1f9c471689ae4c885c","09400e101c5d4b439cf9a26b03aae558",22900468,1,3,0,547,208,210,2
"09400e101c5d4b439cf9a26b03aae558","d7f13c8d63ec4e2aa673fbb9cf9c6933",22900468,1,-5,0,548,210,206,-4
"d7f13c8d63ec4e2aa673fbb9cf9c6933","09400e101c5d4b439cf9a26b03aae558",22900468,1,5,0,549,206,210,4
"09400e101c5d4b439cf9a26b03aae558","a88efa7e50ce47159810ab553afa6d3a",22900468,1,2,0,550,210,212,2
"a88efa7e50ce47159810ab553afa6d3a","a88efa7e50ce47159810ab553afa6d3a",22900468,8,0,1,551,212,212,0
"a88efa7e50ce47159810ab553afa6d3a","a875096404ef4a9984b62d74cda916f9",22900468,1,-3,0,559,212,209,-3
"a875096404ef4a9984b62d74cda916f9","f7fb1952f56b4189b86a9f8b7862d2b8",22900468,1,7,0,560,209,215,6
"f7fb1952f56b4189b86a9f8b7862d2b8","be502a7a43c44bf7b682698de79d9369",22900468,1,-1,0,561,215,214,-1
"be502a7a43c44bf7b682698de79d9369","be502a7a43c44bf7b682698de79d9369",22900468,1,0,1,562,214,214,0
"be502a7a43c44bf7b682698de79d9369","f7fb1952f56b4189b86a9f8b7862d2b8",22900468,1,1,0,563,214,215,1
"f7fb1952f56b4189b86a9f8b7862d2b8","f7fb1952f56b4189b86a9f8b7862d2b8",22900468,13,0,1,564,215,215,0
"f7fb1952f56b4189b86a9f8b7862d2b8","b860ee85d8bc4a2f97958cfb71be3533",22900468,1,1,0,577,215,216,1
"b860ee85d8bc4a2f97958cfb71be3533","b860ee85d8bc4a2f97958cfb71be3533",22900468,2,0,1,578,216,216,0
"b860ee85d8bc4a2f97958cfb71be3533","ec341f459285443b8361f7f15638ff08",22900468,1,-3,0,580,216,213,-3
"ec341f459285443b8361f7f15638ff08","363837c182e04711840d896ae1e0339c",22900468,1,6,0,581,213,218,5
"363837c182e04711840d896ae1e0339c","363837c182e04711840d896ae1e0339c",22900468,12,0,1,582,218,218,0
"363837c182e04711840d896ae1e0339c","01b2051f8941460d89945e3b02d1ce78",22900468,1,-1,0,594,218,217,-1
"01b2051f8941460d89945e3b02d1ce78","1c6721b1f63f4d30ba7746ea8af02a52",22900468,1,7,0,595,217,221,4
"1c6721b1f63f4d30ba7746ea8af02a52","d7f13c8d63ec4e2aa673fbb9cf9c6933",22900468,1,-21,0,596,221,206,-15
"d7f13c8d63ec4e2aa673fbb9cf9c6933","77ecef8eff6b4a2caea7707669bf7475",22900468,1,22,0,597,206,222,16
"77ecef8eff6b4a2caea7707669bf7475","d7f13c8d63ec4e2aa673fbb9cf9c6933",22900468,1,-22,0,598,222,206,-16
"d7f13c8d63ec4e2aa673fbb9cf9c6933","1c6721b1f63f4d30ba7746ea8af02a52",22900468,2,21,0,599,206,221,15
"1c6721b1f63f4d30ba7746ea8af02a52","91125ca626c5470eb145501f8c37f8db",22900468,1,-3,0,600,221,220,-1
"91125ca626c5470eb145501f8c37f8db","91125ca626c5470eb145501f8c37f8db",22900468,1,0,1,601,220,220,0
"91125ca626c5470eb145501f8c37f8db","d7f13c8d63ec4e2aa673fbb9cf9c6933",22900468,1,-18,0,602,220,206,-14
"1c6721b1f63f4d30ba7746ea8af02a52","77ecef8eff6b4a2caea7707669bf7475",22900468,1,1,0,604,221,222,1
"77ecef8eff6b4a2caea7707669bf7475","77ecef8eff6b4a2caea7707669bf7475",22900468,12,0,1,605,222,222,0
"77ecef8eff6b4a2caea7707669bf7475","1c6721b1f63f4d30ba7746ea8af02a52",22900468,1,-1,0,617,222,221,-1
"1c6721b1f63f4d30ba7746ea8af02a52","8b9ae98743bd4d4a8a87dff1c1244211",22900468,3,7,0,618,221,227,6
"8b9ae98743bd4d4a8a87dff1c1244211","d03cb855c70044cf8c35d9ec0de696e3",22900468,2,-3,0,619,227,224,-3
"d03cb855c70044cf8c35d9ec0de696e3","0c7262dff33c4087bc660ccf40f92f9c",22900468,1,-74,0,620,224,169,-55
"0c7262dff33c4087bc660ccf40f92f9c","1c6721b1f63f4d30ba7746ea8af02a52",22900468,1,70,0,621,169,221,52
"1c6721b1f63f4d30ba7746ea8af02a52","d03cb855c70044cf8c35d9ec0de696e3",22900468,2,4,0,622,221,224,3
"d03cb855c70044cf8c35d9ec0de696e3","8b9ae98743bd4d4a8a87dff1c1244211",22900468,2,3,0,623,224,227,3
"8b9ae98743bd4d4a8a87dff1c1244211","f7906d6f59b9489a91d2ef40db5a474d",22900468,3,-4,0,624,227,223,-4
"f7906d6f59b9489a91d2ef40db5a474d","77ecef8eff6b4a2caea7707669bf7475",22900468,1,-2,0,625,223,222,-1
"77ecef8eff6b4a2caea7707669bf7475","d03cb855c70044cf8c35d9ec0de696e3",22900468,1,3,0,626,222,224,2
"d03cb855c70044cf8c35d9ec0de696e3","1c6721b1f63f4d30ba7746ea8af02a52",22900468,1,-4,0,627,224,221,-3
"d03cb855c70044cf8c35d9ec0de696e3","d03cb855c70044cf8c35d9ec0de696e3",22900468,1,0,1,630,224,224,0
"d03cb855c70044cf8c35d9ec0de696e3","a49a937d6896486d9a5396654abcf2e1",22900468,1,2,0,631,224,226,2
"a49a937d6896486d9a5396654abcf2e1","a49a937d6896486d9a5396654abcf2e1",22900468,3,0,1,632,226,226,0
"a49a937d6896486d9a5396654abcf2e1","8b9ae98743bd4d4a8a87dff1c1244211",22900468,1,1,0,635,226,227,1
"8b9ae98743bd4d4a8a87dff1c1244211","8b9ae98743bd4d4a8a87dff1c1244211",22900468,54,0,1,636,227,227,0
"f7906d6f59b9489a91d2ef40db5a474d","2ab1535aac1346ba8801535bf729ef37",22900468,1,7,0,691,223,229,6
"2ab1535aac1346ba8801535bf729ef37","2ab1535aac1346ba8801535bf729ef37",22900468,1,0,1,692,229,229,0
"2ab1535aac1346ba8801535bf729ef37","a4f40fb48a8542c8949bae1f002cd9bc",22900468,1,2,0,693,229,231,2
"a4f40fb48a8542c8949bae1f002cd9bc","a4f40fb48a8542c8949bae1f002cd9bc",22900468,5,0,1,694,231,231,0
"a4f40fb48a8542c8949bae1f002cd9bc","8972c23e32044edb8a78fa1eed4e5947",22900468,1,1,0,699,231,232,1
"8972c23e32044edb8a78fa1eed4e5947","8972c23e32044edb8a78fa1eed4e5947",22900468,1,0,1,700,232,232,0
"8972c23e32044edb8a78fa1eed4e5947","92feb4a40f8344d38b6f722e42a53295",22900468,1,1,0,701,232,233,1
"92feb4a40f8344d38b6f722e42a53295","92feb4a40f8344d38b6f722e42a53295",22900468,2,0,1,702,233,233,0
"92feb4a40f8344d38b6f722e42a53295","5152833676bf4c6cb317060be10f68db",22900468,1,-5,0,704,233,228,-5
"5152833676bf4c6cb317060be10f68db","ca3e28f290354c08aefe5b0f769604e6",22900468,1,8,0,705,228,235,7
"ca3e28f290354c08aefe5b0f769604e6","ca3e28f290354c08aefe5b0f769604e6",22900468,4,0,1,706,235,235,0
"ca3e28f290354c08aefe5b0f769604e6","79a35eea833e4c2c9d22fc53c3c6445c",22900468,1,1,0,710,235,236,1
"79a35eea833e4c2c9d22fc53c3c6445c","79a35eea833e4c2c9d22fc53c3c6445c",22900468,9,0,1,711,236,236,0
"79a35eea833e4c2c9d22fc53c3c6445c","8f68228b1518449e9615cdafee41a2bd",22900468,1,1,0,720,236,237,1
"8f68228b1518449e9615cdafee41a2bd","8f68228b1518449e9615cdafee41a2bd",22900468,1,0,1,721,237,237,0
"8f68228b1518449e9615cdafee41a2bd","cab89fa5c3ed45a5aa550fc0352d6a42",22900468,1,1,0,722,237,238,1
"cab89fa5c3ed45a5aa550fc0352d6a42","cab89fa5c3ed45a5aa550fc0352d6a42",22900468,2,0,1,723,238,238,0
"cab89fa5c3ed45a5aa550fc0352d6a42","1c6721b1f63f4d30ba7746ea8af02a52",22900468,1,-20,0,725,238,221,-17
"8b9ae98743bd4d4a8a87dff1c1244211","0b04c8e2f86d48c7aeb7e225819cd32b",22900468,1,9,0,727,227,234,7
"0b04c8e2f86d48c7aeb7e225819cd32b","d03cb855c70044cf8c35d9ec0de696e3",22900468,1,-12,0,728,234,224,-10
"d03cb855c70044cf8c35d9ec0de696e3","77ecef8eff6b4a2caea7707669bf7475",22900468,1,-3,0,729,224,222,-2
"77ecef8eff6b4a2caea7707669bf7475","f7906d6f59b9489a91d2ef40db5a474d",22900468,1,2,0,730,222,223,1
"f7906d6f59b9489a91d2ef40db5a474d","1c6721b1f63f4d30ba7746ea8af02a52",22900468,1,-3,0,731,223,221,-2
"f7906d6f59b9489a91d2ef40db5a474d","66d4fad4f1cf4b46be0750a99ad7a35a",22900468,1,18,0,735,223,239,16
"66d4fad4f1cf4b46be0750a99ad7a35a","66d4fad4f1cf4b46be0750a99ad7a35a",22900468,1,0,1,736,239,239,0
"66d4fad4f1cf4b46be0750a99ad7a35a","0b04c8e2f86d48c7aeb7e225819cd32b",22900468,1,-5,0,737,239,234,-5
"0b04c8e2f86d48c7aeb7e225819cd32b","f53da5fd9bfe412da4b80d4742563b6c",22900468,1,8,0,738,234,241,7
"f53da5fd9bfe412da4b80d4742563b6c","f53da5fd9bfe412da4b80d4742563b6c",22900468,1,0,1,739,241,241,0
"f53da5fd9bfe412da4b80d4742563b6c","2ae94c0cea4d480a9d5dca8fb1d7b542",22900468,1,3,0,740,241,242,1
"2ae94c0cea4d480a9d5dca8fb1d7b542","1c6721b1f63f4d30ba7746ea8af02a52",22900468,1,-27,0,741,242,221,-21
"1c6721b1f63f4d30ba7746ea8af02a52","1ebf23f9d994469a85206e4c7b1bf5f5",22900468,1,30,0,742,221,245,24
"1ebf23f9d994469a85206e4c7b1bf5f5","0c7262dff33c4087bc660ccf40f92f9c",22900468,1,-100,0,743,245,169,-76
"0c7262dff33c4087bc660ccf40f92f9c","2ae94c0cea4d480a9d5dca8fb1d7b542",22900468,1,97,0,744,169,242,73
"2ae94c0cea4d480a9d5dca8fb1d7b542","2ae94c0cea4d480a9d5dca8fb1d7b542",22900468,1,0,1,745,242,242,0
"2ae94c0cea4d480a9d5dca8fb1d7b542","1ebf23f9d994469a85206e4c7b1bf5f5",22900468,2,3,0,746,242,245,3
"1ebf23f9d994469a85206e4c7b1bf5f5","1ebf23f9d994469a85206e4c7b1bf5f5",22900468,10,0,1,747,245,245,0
"1ebf23f9d994469a85206e4c7b1bf5f5","85ae675b83e8422da842cfd25596af99",22900468,1,1,0,757,245,246,1
"85ae675b83e8422da842cfd25596af99","85ae675b83e8422da842cfd25596af99",22900468,3,0,1,758,246,246,0
"85ae675b83e8422da842cfd25596af99","2ae94c0cea4d480a9d5dca8fb1d7b542",22900468,1,-4,0,761,246,242,-4
"2ae94c0cea4d480a9d5dca8fb1d7b542","fa235f0f364d47e4ae1c87f47bf8e6ba",22900468,1,12,0,762,242,252,10
"fa235f0f364d47e4ae1c87f47bf8e6ba","fa235f0f364d47e4ae1c87f47bf8e6ba",22900468,9,0,1,763,252,252,0
"fa235f0f364d47e4ae1c87f47bf8e6ba","79f7845465cc4ed19d8e4f1429541be0",22900468,1,2,0,764,252,254,2
"79f7845465cc4ed19d8e4f1429541be0","79f7845465cc4ed19d8e4f1429541be0",22900468,2,0,1,765,254,254,0
"79f7845465cc4ed19d8e4f1429541be0","00f61990949545828dd12f1303d47504",22900468,1,3,0,767,254,256,2
"00f61990949545828dd12f1303d47504","6e83e23f56544a19b94067c1c558d9c0",22900468,2,-11,0,768,256,247,-9
"6e83e23f56544a19b94067c1c558d9c0","00f61990949545828dd12f1303d47504",22900468,2,11,0,769,247,256,9
"00f61990949545828dd12f1303d47504","fa235f0f364d47e4ae1c87f47bf8e6ba",22900468,1,-5,0,770,256,252,-4
"fa235f0f364d47e4ae1c87f47bf8e6ba","d546341988904f069cfa86b21457d9d9",22900468,1,-1,0,771,252,251,-1
"d546341988904f069cfa86b21457d9d9","fa235f0f364d47e4ae1c87f47bf8e6ba",22900468,1,1,0,772,251,252,1
"fa235f0f364d47e4ae1c87f47bf8e6ba","00f61990949545828dd12f1303d47504",22900468,1,5,0,781,252,256,4
"00f61990949545828dd12f1303d47504","ead7bb4b64e247d2ae632ab8a296b091",22900468,1,2,0,784,256,258,2
"ead7bb4b64e247d2ae632ab8a296b091","ead7bb4b64e247d2ae632ab8a296b091",22900468,2,0,1,785,258,258,0
"ead7bb4b64e247d2ae632ab8a296b091","41b0048dde734bb280bac6116baa8e27",22900468,1,1,0,787,258,259,1
"41b0048dde734bb280bac6116baa8e27","41b0048dde734bb280bac6116baa8e27",22900468,5,0,1,788,259,259,0
"41b0048dde734bb280bac6116baa8e27","b41c5a094a604ee0915327da5cc0beb7",22900468,1,1,0,793,259,260,1
"b41c5a094a604ee0915327da5cc0beb7","b41c5a094a604ee0915327da5cc0beb7",22900468,2,0,1,794,260,260,0
"b41c5a094a604ee0915327da5cc0beb7","d546341988904f069cfa86b21457d9d9",22900468,1,-10,0,796,260,251,-9
"d546341988904f069cfa86b21457d9d9","28c171777c52431ab6b925073bd63d46",22900468,1,15,0,797,251,264,13
"28c171777c52431ab6b925073bd63d46","28c171777c52431ab6b925073bd63d46",22900468,7,0,1,798,264,264,0
"28c171777c52431ab6b925073bd63d46","ac160db940cb49ae8579162b1d52bb5d",22900468,1,2,0,805,264,266,2
"ac160db940cb49ae8579162b1d52bb5d","ac160db940cb49ae8579162b1d52bb5d",22900468,7,0,1,806,266,266,0
"ac160db940cb49ae8579162b1d52bb5d","d989ebcfc12a4b669f0100dc1aa14f1e",22900468,1,-12,0,813,266,255,-11
"d989ebcfc12a4b669f0100dc1aa14f1e","c6fd49b485cc4874b0bbdd9c6171e09c",22900468,1,15,0,814,255,268,13
"c6fd49b485cc4874b0bbdd9c6171e09c","c6fd49b485cc4874b0bbdd9c6171e09c",22900468,7,0,1,815,268,268,0
"c6fd49b485cc4874b0bbdd9c6171e09c","44240778a97c4af0937817499b75707b",22900468,1,1,0,822,268,269,1
"44240778a97c4af0937817499b75707b","44240778a97c4af0937817499b75707b",22900468,2,0,1,823,269,269,0
"44240778a97c4af0937817499b75707b","7aa76d3e993840d8805f097cbdbcd44b",22900468,1,-9,0,825,269,261,-8
"7aa76d3e993840d8805f097cbdbcd44b","865a4d3b43374da7944dc7d397f566d9",22900468,1,12,0,826,261,271,10
"865a4d3b43374da7944dc7d397f566d9","865a4d3b43374da7944dc7d397f566d9",22900468,1,0,1,827,271,271,0
"865a4d3b43374da7944dc7d397f566d9","0d987bed3ffa4ed0b9a2e62e97b7b30f",22900468,1,3,0,828,271,272,1
"0d987bed3ffa4ed0b9a2e62e97b7b30f","2ae94c0cea4d480a9d5dca8fb1d7b542",22900468,1,-38,0,829,272,242,-30
"2ae94c0cea4d480a9d5dca8fb1d7b542","0d987bed3ffa4ed0b9a2e62e97b7b30f",22900468,1,38,0,830,242,272,30
"0d987bed3ffa4ed0b9a2e62e97b7b30f","bb5a47f5ea01454a8b79455422d3b9da",22900468,4,10,0,831,272,280,8
"bb5a47f5ea01454a8b79455422d3b9da","bb5a47f5ea01454a8b79455422d3b9da",22900468,57,0,1,832,280,280,0
"bb5a47f5ea01454a8b79455422d3b9da","82ae07bc0c9b4570a41799290d1ef399",22900468,2,-6,0,834,280,275,-5
"82ae07bc0c9b4570a41799290d1ef399","bb5a47f5ea01454a8b79455422d3b9da",22900468,2,6,0,835,275,280,5
"bb5a47f5ea01454a8b79455422d3b9da","bc5524e78a8544e2ae2fdc2f3462bbec",22900468,3,-1,0,840,280,279,-1
"bc5524e78a8544e2ae2fdc2f3462bbec","82ae07bc0c9b4570a41799290d1ef399",22900468,1,-5,0,841,279,275,-4
"82ae07bc0c9b4570a41799290d1ef399","0d987bed3ffa4ed0b9a2e62e97b7b30f",22900468,1,-4,0,842,275,272,-3
"bb5a47f5ea01454a8b79455422d3b9da","0c7262dff33c4087bc660ccf40f92f9c",22900468,1,-145,0,881,280,169,-111
"0c7262dff33c4087bc660ccf40f92f9c","94cecc3f1e7d484b8e068e79241dfd73",22900468,1,148,0,882,169,281,112
"94cecc3f1e7d484b8e068e79241dfd73","94cecc3f1e7d484b8e068e79241dfd73",22900468,2,0,1,883,281,281,0
"94cecc3f1e7d484b8e068e79241dfd73","a37477c4e4c14169ad44b06b493007f6",22900468,4,2,0,884,281,283,2
"a37477c4e4c14169ad44b06b493007f6","0d987bed3ffa4ed0b9a2e62e97b7b30f",22900468,1,-15,0,885,283,272,-11
"bc5524e78a8544e2ae2fdc2f3462bbec","0d987bed3ffa4ed0b9a2e62e97b7b30f",22900468,2,-9,0,896,279,272,-7
"0d987bed3ffa4ed0b9a2e62e97b7b30f","94cecc3f1e7d484b8e068e79241dfd73",22900468,2,13,0,897,272,281,9
"a37477c4e4c14169ad44b06b493007f6","94cecc3f1e7d484b8e068e79241dfd73",22900468,2,-2,0,899,283,281,-2
"94cecc3f1e7d484b8e068e79241dfd73","0d987bed3ffa4ed0b9a2e62e97b7b30f",22900468,1,-13,0,903,281,272,-9
"a37477c4e4c14169ad44b06b493007f6","fab84b4fab5940efb4ea868ef8d09396",22900468,1,3,0,917,283,284,1
"fab84b4fab5940efb4ea868ef8d09396","94cecc3f1e7d484b8e068e79241dfd73",22900468,1,-5,0,918,284,281,-3
"94cecc3f1e7d484b8e068e79241dfd73","fab84b4fab5940efb4ea868ef8d09396",22900468,1,5,0,919,281,284,3
"fab84b4fab5940efb4ea868ef8d09396","4a29443515bb404cb8924e1c60a63b73",22900468,1,4,0,920,284,285,1
"4a29443515bb404cb8924e1c60a63b73","208c9b2796c944db8dacaa96082520ea",22900468,2,3,0,921,285,288,3
"208c9b2796c944db8dacaa96082520ea","4a29443515bb404cb8924e1c60a63b73",22900468,2,-3,0,922,288,285,-3
"208c9b2796c944db8dacaa96082520ea","208c9b2796c944db8dacaa96082520ea",22900468,1,0,1,924,288,288,0
"4a29443515bb404cb8924e1c60a63b73","7669a956527947d0add87455277e80b4",22900468,1,7,0,926,285,291,6
"7669a956527947d0add87455277e80b4","7669a956527947d0add87455277e80b4",22900468,1,0,1,927,291,291,0
"7669a956527947d0add87455277e80b4","869e967078f04da18dd0b0b9389a7424",22900468,1,3,0,928,291,293,2
"869e967078f04da18dd0b0b9389a7424","6a9a3b5bde4a48daa896fe8c06eca56f",22900468,1,-5,0,929,293,289,-4
"6a9a3b5bde4a48daa896fe8c06eca56f","869e967078f04da18dd0b0b9389a7424",22900468,1,5,0,930,289,293,4
"869e967078f04da18dd0b0b9389a7424","869e967078f04da18dd0b0b9389a7424",22900468,1,0,1,931,293,293,0
"869e967078f04da18dd0b0b9389a7424","51ab6291537748fab90d519aa09889d6",22900468,1,2,0,932,293,295,2
"51ab6291537748fab90d519aa09889d6","51ab6291537748fab90d519aa09889d6",22900468,5,0,1,933,295,295,0
"51ab6291537748fab90d519aa09889d6","34a6e49023fc4465bd5ca604330bbd1c",22900468,1,-3,0,938,295,292,-3
"34a6e49023fc4465bd5ca604330bbd1c","ba0e59461bfb4a44b7b1c28a01f8d3b3",22900468,1,9,0,939,292,299,7
"ba0e59461bfb4a44b7b1c28a01f8d3b3","21592f2a9e9c4b2f8c66ec5dbcbf6a2b",22900468,1,-4,0,940,299,296,-3
"21592f2a9e9c4b2f8c66ec5dbcbf6a2b","ba0e59461bfb4a44b7b1c28a01f8d3b3",22900468,1,4,0,941,296,299,3
"ba0e59461bfb4a44b7b1c28a01f8d3b3","ba0e59461bfb4a44b7b1c28a01f8d3b3",22900468,4,0,1,942,299,299,0
"ba0e59461bfb4a44b7b1c28a01f8d3b3","0e0b36e731a645e7b1b8a88f5031ca38",22900468,1,2,0,946,299,301,2
"0e0b36e731a645e7b1b8a88f5031ca38","0e0b36e731a645e7b1b8a88f5031ca38",22900468,2,0,1,947,301,301,0
"0e0b36e731a645e7b1b8a88f5031ca38","a66a144637284c21afc6de17fea4bfb8",22900468,1,1,0,949,301,302,1
"a66a144637284c21afc6de17fea4bfb8","a66a144637284c21afc6de17fea4bfb8",22900468,2,0,1,950,302,302,0
"a66a144637284c21afc6de17fea4bfb8","7646a919d7e64fa990bca9b024ff089d",22900468,1,-4,0,952,302,298,-4
"7646a919d7e64fa990bca9b024ff089d","e390b575229748ea8aac9364efe2bf00",22900468,1,7,0,953,298,304,6
"e390b575229748ea8aac9364efe2bf00","e390b575229748ea8aac9364efe2bf00",22900468,1,0,1,954,304,304,0
"e390b575229748ea8aac9364efe2bf00","3434c10e561d488a914e0f7d71907abd",22900468,1,3,0,955,304,305,1
"3434c10e561d488a914e0f7d71907abd","4a29443515bb404cb8924e1c60a63b73",22900468,1,-27,0,956,305,285,-20
"4a29443515bb404cb8924e1c60a63b73","53e7e900392747ccad52e711ab0f80d8",22900468,1,29,0,957,285,307,22
"53e7e900392747ccad52e711ab0f80d8","53e7e900392747ccad52e711ab0f80d8",22900468,1,0,1,958,307,307,0
"53e7e900392747ccad52e711ab0f80d8","3434c10e561d488a914e0f7d71907abd",22900468,1,-2,0,959,307,305,-2
"3434c10e561d488a914e0f7d71907abd","130acc2aeb0448fdbb2de63bc5cebe5b",22900468,1,5,0,960,305,309,4
"130acc2aeb0448fdbb2de63bc5cebe5b","130acc2aeb0448fdbb2de63bc5cebe5b",22900468,1,0,1,961,309,309,0
"130acc2aeb0448fdbb2de63bc5cebe5b","9c062b3251034ebe90f5054e2a3b5120",22900468,1,2,0,962,309,311,2
"9c062b3251034ebe90f5054e2a3b5120","9c062b3251034ebe90f5054e2a3b5120",22900468,2,0,1,963,311,311,0
"9c062b3251034ebe90f5054e2a3b5120","ea859f8207e44537889daeaba13ac2e8",22900468,1,1,0,965,311,312,1
"ea859f8207e44537889daeaba13ac2e8","ea859f8207e44537889daeaba13ac2e8",22900468,1,0,1,966,312,312,0
"ea859f8207e44537889daeaba13ac2e8","56d94971a7a94257aa330183a8ebd0ea",22900468,1,1,0,967,312,313,1
"56d94971a7a94257aa330183a8ebd0ea","56d94971a7a94257aa330183a8ebd0ea",22900468,1,0,1,968,313,313,0
"56d94971a7a94257aa330183a8ebd0ea","141c0df6cd1946539aadd1c9b7068cd4",22900468,1,-5,0,969,313,308,-5
"141c0df6cd1946539aadd1c9b7068cd4","13255e63e0aa4abf85e5211bf613d43e",22900468,1,10,0,970,308,317,9
"13255e63e0aa4abf85e5211bf613d43e","13255e63e0aa4abf85e5211bf613d43e",22900468,1,0,1,971,317,317,0
"13255e63e0aa4abf85e5211bf613d43e","86c27d40179e419c8e9d150fb6afa5d0",22900468,1,3,0,972,317,319,2
"86c27d40179e419c8e9d150fb6afa5d0","0c787d16c9504873b1a4d903cec09948",22900468,1,-6,0,973,319,314,-5
"0c787d16c9504873b1a4d903cec09948","86c27d40179e419c8e9d150fb6afa5d0",22900468,1,6,0,974,314,319,5
"86c27d40179e419c8e9d150fb6afa5d0","8d7e0b55cf9849cda222a0f2440cec55",22900468,1,-1,0,975,319,318,-1
"8d7e0b55cf9849cda222a0f2440cec55","24f1363179ad4aaa965484a78471912b",22900468,1,6,0,976,318,323,5
"24f1363179ad4aaa965484a78471912b","47edbb64109243e6b0f8f64cdef90c6c",22900468,1,3,0,977,323,326,3
"47edbb64109243e6b0f8f64cdef90c6c","1c6721b1f63f4d30ba7746ea8af02a52",22900468,1,-139,0,978,326,221,-105
"1c6721b1f63f4d30ba7746ea8af02a52","0b04c8e2f86d48c7aeb7e225819cd32b",22900468,1,16,0,979,221,234,13
"0b04c8e2f86d48c7aeb7e225819cd32b","1c6721b1f63f4d30ba7746ea8af02a52",22900468,1,-16,0,980,234,221,-13
"1c6721b1f63f4d30ba7746ea8af02a52","2ae94c0cea4d480a9d5dca8fb1d7b542",22900468,1,27,0,981,221,242,21
"1ebf23f9d994469a85206e4c7b1bf5f5","30ead9794d4847abaf222ca966cc8630",22900468,1,139,0,983,245,348,103
"30ead9794d4847abaf222ca966cc8630","30ead9794d4847abaf222ca966cc8630",22900468,1,0,1,984,348,348,0
"30ead9794d4847abaf222ca966cc8630","eff0de7f2dbb42dfa1a2e686efab5b6d",22900468,1,6,0,985,348,354,6
"09b9678ddc3d452ea4a3d46e15826065","4a29443515bb404cb8924e1c60a63b73",22900468,1,-87,0,989,353,285,-68
"4a29443515bb404cb8924e1c60a63b73","3434c10e561d488a914e0f7d71907abd",22900468,1,27,0,990,285,305,20
"3434c10e561d488a914e0f7d71907abd","3628bdce1dd2429ba924d2d4d09448d2",22900468,1,21,0,991,305,322,17
"3628bdce1dd2429ba924d2d4d09448d2","47edbb64109243e6b0f8f64cdef90c6c",22900468,1,4,0,992,322,326,4
"47edbb64109243e6b0f8f64cdef90c6c","24f1363179ad4aaa965484a78471912b",22900468,1,-3,0,993,326,323,-3
"24f1363179ad4aaa965484a78471912b","24f1363179ad4aaa965484a78471912b",22900468,1,0,1,994,323,323,0
"24f1363179ad4aaa965484a78471912b","3628bdce1dd2429ba924d2d4d09448d2",22900468,1,-1,0,995,323,322,-1
"3628bdce1dd2429ba924d2d4d09448d2","56b3fd1a212a4764be39d979fde3326e",22900468,1,7,0,996,322,328,6
"56b3fd1a212a4764be39d979fde3326e","56b3fd1a212a4764be39d979fde3326e",22900468,1,0,1,997,328,328,0
"56b3fd1a212a4764be39d979fde3326e","0c4079457ede49e3aeb5e86ed84bdf35",22900468,1,3,0,998,328,329,1
"0c4079457ede49e3aeb5e86ed84bdf35","3434c10e561d488a914e0f7d71907abd",22900468,1,-31,0,999,329,305,-24
"3434c10e561d488a914e0f7d71907abd","38aea304b4fa46e1b29bb72f5cea4c93",22900468,1,33,0,1000,305,331,26
"38aea304b4fa46e1b29bb72f5cea4c93","38aea304b4fa46e1b29bb72f5cea4c93",22900468,1,0,1,1001,331,331,0
"38aea304b4fa46e1b29bb72f5cea4c93","e36d261332f14e79bb4b467aceaeb9b5",22900468,1,2,0,1002,331,333,2
"e36d261332f14e79bb4b467aceaeb9b5","e36d261332f14e79bb4b467aceaeb9b5",22900468,1,0,1,1003,333,333,0
"e36d261332f14e79bb4b467aceaeb9b5","c7e89b9d04744d2eab742fc24e3ef1ae",22900468,1,1,0,1004,333,334,1
"c7e89b9d04744d2eab742fc24e3ef1ae","c7e89b9d04744d2eab742fc24e3ef1ae",22900468,2,0,1,1005,334,334,0
"c7e89b9d04744d2eab742fc24e3ef1ae","fe49f8054b374a0ea4bb266ed135ff62",22900468,1,1,0,1007,334,335,1
"fe49f8054b374a0ea4bb266ed135ff62","fe49f8054b374a0ea4bb266ed135ff62",22900468,2,0,1,1008,335,335,0
"fe49f8054b374a0ea4bb266ed135ff62","d0a8f74af98642fe8360d22c42e45117",22900468,1,1,0,1010,335,336,1
"d0a8f74af98642fe8360d22c42e45117","d0a8f74af98642fe8360d22c42e45117",22900468,2,0,1,1011,336,336,0
"d0a8f74af98642fe8360d22c42e45117","0c4079457ede49e3aeb5e86ed84bdf35",22900468,1,-7,0,1013,336,329,-7
"0c4079457ede49e3aeb5e86ed84bdf35","a7c6339ca1da4368a18d471f0519f877",22900468,1,11,0,1014,329,339,10
"a7c6339ca1da4368a18d471f0519f877","a7c6339ca1da4368a18d471f0519f877",22900468,1,0,1,1015,339,339,0
"a7c6339ca1da4368a18d471f0519f877","bbc5139ca9024389a94db3a6f47dcff6",22900468,1,3,0,1016,339,341,2
"bbc5139ca9024389a94db3a6f47dcff6","b8b9418ab322418d9db9b40d96af873a",22900468,1,-5,0,1017,341,337,-4
"b8b9418ab322418d9db9b40d96af873a","bbc5139ca9024389a94db3a6f47dcff6",22900468,1,5,0,1018,337,341,4
"bbc5139ca9024389a94db3a6f47dcff6","bbc5139ca9024389a94db3a6f47dcff6",22900468,1,0,1,1019,341,341,0
"bbc5139ca9024389a94db3a6f47dcff6","4ee6ca9019ab4a1ab323f98094a9bd77",22900468,1,2,0,1020,341,343,2
"4ee6ca9019ab4a1ab323f98094a9bd77","4ee6ca9019ab4a1ab323f98094a9bd77",22900468,2,0,1,1021,343,343,0
"4ee6ca9019ab4a1ab323f98094a9bd77","b37947176785476f8b29d49a851366dc",22900468,1,1,0,1023,343,344,1
"b37947176785476f8b29d49a851366dc","b37947176785476f8b29d49a851366dc",22900468,2,0,1,1024,344,344,0
"b37947176785476f8b29d49a851366dc","fcea5b10d5a14a3b9324ffece8f6e1e5",22900468,1,1,0,1026,344,345,1
"fcea5b10d5a14a3b9324ffece8f6e1e5","fcea5b10d5a14a3b9324ffece8f6e1e5",22900468,2,0,1,1027,345,345,0
"fcea5b10d5a14a3b9324ffece8f6e1e5","c2490bc612d146edbe786556fab3651b",22900468,1,-5,0,1029,345,340,-5
"c2490bc612d146edbe786556fab3651b","6ac8bb048b854999a47edb35fe627f11",22900468,1,8,0,1030,340,347,7
"6ac8bb048b854999a47edb35fe627f11","6ac8bb048b854999a47edb35fe627f11",22900468,1,0,1,1031,347,347,0
"6ac8bb048b854999a47edb35fe627f11","0c4079457ede49e3aeb5e86ed84bdf35",22900468,1,-21,0,1032,347,329,-18
"0c4079457ede49e3aeb5e86ed84bdf35","30ead9794d4847abaf222ca966cc8630",22900468,1,24,0,1033,329,348,19
"30ead9794d4847abaf222ca966cc8630","897b7f51242c44aab2205c72fdcbf4cd",22900468,1,4,0,1034,348,352,4
"897b7f51242c44aab2205c72fdcbf4cd","09b9678ddc3d452ea4a3d46e15826065",22900468,3,1,0,1035,352,353,1
"09b9678ddc3d452ea4a3d46e15826065","c20993c944444fe085345591a8bd837e",22900468,1,-2,0,1036,353,351,-2
"c20993c944444fe085345591a8bd837e","eff0de7f2dbb42dfa1a2e686efab5b6d",22900468,1,3,0,1037,351,354,3
"eff0de7f2dbb42dfa1a2e686efab5b6d","c20993c944444fe085345591a8bd837e",22900468,2,-3,0,1038,354,351,-3
"c20993c944444fe085345591a8bd837e","c20993c944444fe085345591a8bd837e",22900468,3,0,1,1039,351,351,0
"c20993c944444fe085345591a8bd837e","897b7f51242c44aab2205c72fdcbf4cd",22900468,2,1,0,1042,351,352,1
"897b7f51242c44aab2205c72fdcbf4cd","897b7f51242c44aab2205c72fdcbf4cd",22900468,3,0,1,1043,352,352,0
"09b9678ddc3d452ea4a3d46e15826065","09b9678ddc3d452ea4a3d46e15826065",22900468,3,0,1,1047,353,353,0
"09b9678ddc3d452ea4a3d46e15826065","eff0de7f2dbb42dfa1a2e686efab5b6d",22900468,1,1,0,1050,353,354,1
"eff0de7f2dbb42dfa1a2e686efab5b6d","eff0de7f2dbb42dfa1a2e686efab5b6d",22900468,3,0,1,1051,354,354,0
"eff0de7f2dbb42dfa1a2e686efab5b6d","30ead9794d4847abaf222ca966cc8630",22900468,1,-6,0,1054,354,348,-6
"30ead9794d4847abaf222ca966cc8630","2fe14166dc9642c3bc666b86a57f943d",22900468,2,10,0,1055,348,357,9
"2fe14166dc9642c3bc666b86a57f943d","2fe14166dc9642c3bc666b86a57f943d",22900468,2,0,1,1056,357,357,0
"2fe14166dc9642c3bc666b86a57f943d","44421dd1e13a47a388c4a19834b744c7",22900468,1,2,0,1057,357,359,2
"44421dd1e13a47a388c4a19834b744c7","44421dd1e13a47a388c4a19834b744c7",22900468,2,0,1,1058,359,359,0
"44421dd1e13a47a388c4a19834b744c7","cb5fc7ef85d547c4be1a7439d0bf6052",22900468,1,1,0,1060,359,360,1
"cb5fc7ef85d547c4be1a7439d0bf6052","cb5fc7ef85d547c4be1a7439d0bf6052",22900468,2,0,1,1061,360,360,0
"cb5fc7ef85d547c4be1a7439d0bf6052","0a8f150a4cf747acbde62f4721823da3",22900468,1,1,0,1063,360,361,1
"0a8f150a4cf747acbde62f4721823da3","0a8f150a4cf747acbde62f4721823da3",22900468,2,0,1,1064,361,361,0
"0a8f150a4cf747acbde62f4721823da3","ab8fdad974ae471f9f24c3f9dd04462e",22900468,1,1,0,1066,361,362,1
"ab8fdad974ae471f9f24c3f9dd04462e","ab8fdad974ae471f9f24c3f9dd04462e",22900468,2,0,1,1067,362,362,0
"ab8fdad974ae471f9f24c3f9dd04462e","1ba8fef685d74a8194b9db252eb704fb",22900468,1,-7,0,1069,362,355,-7
"1ba8fef685d74a8194b9db252eb704fb","52580888dadb4fe3baa795683ea227bd",22900468,2,10,0,1070,355,364,9
"52580888dadb4fe3baa795683ea227bd","52580888dadb4fe3baa795683ea227bd",22900468,1,0,1,1071,364,364,0
"52580888dadb4fe3baa795683ea227bd","f00179e251a045b39c3f7a54f9aa4acc",22900468,2,-1,0,1072,364,363,-1
"f00179e251a045b39c3f7a54f9aa4acc","492a3bc6a1254f23a7998587961b22a4",22900468,1,4,0,1073,363,366,3
"492a3bc6a1254f23a7998587961b22a4","492a3bc6a1254f23a7998587961b22a4",22900468,1,0,1,1074,366,366,0
"492a3bc6a1254f23a7998587961b22a4","072a190fd302456290895f9f04d6940a",22900468,2,-1,0,1075,366,365,-1
"072a190fd302456290895f9f04d6940a","c76574d21bc14aeea7ecd0b027f39858",22900468,1,3,0,1076,365,367,2
"c76574d21bc14aeea7ecd0b027f39858","492a3bc6a1254f23a7998587961b22a4",22900468,1,-2,0,1077,367,366,-1
"072a190fd302456290895f9f04d6940a","52580888dadb4fe3baa795683ea227bd",22900468,1,-2,0,1079,365,364,-1
"f00179e251a045b39c3f7a54f9aa4acc","2fe14166dc9642c3bc666b86a57f943d",22900468,1,-7,0,1081,363,357,-6
"2fe14166dc9642c3bc666b86a57f943d","1ba8fef685d74a8194b9db252eb704fb",22900468,1,-2,0,1082,357,355,-2
"52580888dadb4fe3baa795683ea227bd","492a3bc6a1254f23a7998587961b22a4",22900468,1,3,0,1084,364,366,2
"492a3bc6a1254f23a7998587961b22a4","f00179e251a045b39c3f7a54f9aa4acc",22900468,1,-4,0,1085,366,363,-3
"f00179e251a045b39c3f7a54f9aa4acc","072a190fd302456290895f9f04d6940a",22900468,1,3,0,1086,363,365,2
"072a190fd302456290895f9f04d6940a","cfa457d1743848e4bb5e4beced6448ed",22900468,1,5,0,1087,365,369,4
"cfa457d1743848e4bb5e4beced6448ed","cfa457d1743848e4bb5e4beced6448ed",22900468,1,0,1,1088,369,369,0
"cfa457d1743848e4bb5e4beced6448ed","30ead9794d4847abaf222ca966cc8630",22900468,1,-25,0,1089,369,348,-21
"30ead9794d4847abaf222ca966cc8630","b71bac264efb4abd97015447bd490db6",22900468,1,28,0,1090,348,370,22
"b71bac264efb4abd97015447bd490db6","8d448d625b024c82a5eb240bbd7431d6",22900468,6,5,0,1091,370,374,4
"8d448d625b024c82a5eb240bbd7431d6","8d448d625b024c82a5eb240bbd7431d6",22900468,71,0,1,1092,374,374,0
"8d448d625b024c82a5eb240bbd7431d6","b71bac264efb4abd97015447bd490db6",22900468,3,-5,0,1098,374,370,-4
"8d448d625b024c82a5eb240bbd7431d6","1b4550d0dab04078b3bf08a655345bdc",22900468,1,-1,0,1100,374,373,-1
"1b4550d0dab04078b3bf08a655345bdc","b71bac264efb4abd97015447bd490db6",22900468,3,-4,0,1101,373,370,-3
"b71bac264efb4abd97015447bd490db6","d6d02b6ef04e4f17805504500b8ce441",22900468,2,8,0,1102,370,375,5
"d6d02b6ef04e4f17805504500b8ce441","d6d02b6ef04e4f17805504500b8ce441",22900468,3,0,1,1103,375,375,0
"d6d02b6ef04e4f17805504500b8ce441","4a29443515bb404cb8924e1c60a63b73",22900468,1,-118,0,1104,375,285,-90
"4a29443515bb404cb8924e1c60a63b73","9afd71a5298d4333b6849dfce1b9422c",22900468,1,-370,0,1105,285,18,-267
"9afd71a5298d4333b6849dfce1b9422c","9afd71a5298d4333b6849dfce1b9422c",22900468,5,0,1,1106,18,18,0
"9afd71a5298d4333b6849dfce1b9422c","67a089198fcb4e1c8f2385786c2b296f",22900468,1,44,0,1108,18,39,21
"67a089198fcb4e1c8f2385786c2b296f","67a089198fcb4e1c8f2385786c2b296f",22900468,3,0,1,1109,39,39,0
"67a089198fcb4e1c8f2385786c2b296f","64d48c6c9c7940639a932219a6c87198",22900468,2,1,0,1110,39,40,1
"64d48c6c9c7940639a932219a6c87198","64d48c6c9c7940639a932219a6c87198",22900468,2,0,1,1111,40,40,0
"64d48c6c9c7940639a932219a6c87198","b534b89233134e30a9b5645138bfa9ee",22900468,1,3,0,1112,40,41,1
"b534b89233134e30a9b5645138bfa9ee","67a089198fcb4e1c8f2385786c2b296f",22900468,1,-4,0,1113,41,39,-2
"67a089198fcb4e1c8f2385786c2b296f","6e13d61a7bdb44bca949c9f86fab3be5",22900468,1,11,0,1114,39,47,8
"6e13d61a7bdb44bca949c9f86fab3be5","b534b89233134e30a9b5645138bfa9ee",22900468,1,-7,0,1115,47,41,-6
"b534b89233134e30a9b5645138bfa9ee","d0c74f735e024943943e40333d6d337f",22900468,2,12,0,1116,41,51,10
"d0c74f735e024943943e40333d6d337f","d9c8d8c444a64dadbbb508652c721e17",22900468,1,-6,0,1117,51,46,-5
"d9c8d8c444a64dadbbb508652c721e17","f924752d8a1149668870b1e7698486f7",22900468,1,5,0,1118,46,50,4
"f924752d8a1149668870b1e7698486f7","a1f2f12debe5432fb7a70bcd12bacfb9",22900468,2,9,0,1119,50,58,8
"a1f2f12debe5432fb7a70bcd12bacfb9","78f30e4dcac84e3cbea8b2cc6e0d62b3",22900468,3,1,0,1120,58,59,1
"78f30e4dcac84e3cbea8b2cc6e0d62b3","12aa6e1672ac4e7aa6449a7a8609cd72",22900468,1,-2,0,1121,59,57,-2
"12aa6e1672ac4e7aa6449a7a8609cd72","a0a418b8540d479fa6e0f653b701da8b",22900468,1,8,0,1122,57,64,7
"a0a418b8540d479fa6e0f653b701da8b","bc42d26810654ea9a1df1efe1e58c7d5",22900468,1,-1,0,1123,64,63,-1
"bc42d26810654ea9a1df1efe1e58c7d5","bc42d26810654ea9a1df1efe1e58c7d5",22900468,5,0,1,1124,63,63,0
"bc42d26810654ea9a1df1efe1e58c7d5","a0a418b8540d479fa6e0f653b701da8b",22900468,2,1,0,1126,63,64,1
"a0a418b8540d479fa6e0f653b701da8b","a0a418b8540d479fa6e0f653b701da8b",22900468,4,0,1,1127,64,64,0
"a0a418b8540d479fa6e0f653b701da8b","309ccf3cc4fe429d9bfbaef53d3fa479",22900468,2,-4,0,1128,64,60,-4
"309ccf3cc4fe429d9bfbaef53d3fa479","d646286c8051419bbc2e31dd1db55ca8",22900468,1,10,0,1129,60,67,7
"d646286c8051419bbc2e31dd1db55ca8","b534b89233134e30a9b5645138bfa9ee",22900468,1,-33,0,1130,67,41,-26
"b534b89233134e30a9b5645138bfa9ee","d646286c8051419bbc2e31dd1db55ca8",22900468,2,33,0,1131,41,67,26
"d646286c8051419bbc2e31dd1db55ca8","a2becd407db34b189200a32546d9d569",22900468,2,9,0,1132,67,75,8
"a2becd407db34b189200a32546d9d569","140d5b27b8574befad82c0a013b59dfa",22900468,1,-1,0,1133,75,74,-1
"140d5b27b8574befad82c0a013b59dfa","d18a9ea32855445f8736581f5cb119ce",22900468,2,9,0,1134,74,82,8
"d18a9ea32855445f8736581f5cb119ce","ae5ac430ea254e708a6f5deaaf7464ae",22900468,2,3,0,1135,82,84,2
"ae5ac430ea254e708a6f5deaaf7464ae","6a9f0ef185fb47f0937e29daa1c71ed5",22900468,3,7,0,1136,84,90,6
"6a9f0ef185fb47f0937e29daa1c71ed5","6a9f0ef185fb47f0937e29daa1c71ed5",22900468,5,0,1,1137,90,90,0
"6a9f0ef185fb47f0937e29daa1c71ed5","e20db35ced8544ddac5bc3839145e463",22900468,1,3,0,1139,90,91,1
"e20db35ced8544ddac5bc3839145e463","d646286c8051419bbc2e31dd1db55ca8",22900468,1,-30,0,1140,91,67,-24
"d646286c8051419bbc2e31dd1db55ca8","00ae5f0c51874a73a41ebea838d95682",22900468,1,41,0,1141,67,101,34
"00ae5f0c51874a73a41ebea838d95682","e20db35ced8544ddac5bc3839145e463",22900468,1,-11,0,1142,101,91,-10
"e20db35ced8544ddac5bc3839145e463","d391c8b6e56a43a7b654e9dee02d904b",22900468,1,13,0,1143,91,103,12
"d391c8b6e56a43a7b654e9dee02d904b","4280927ec4d643238aa49c32f9e06c6c",22900468,1,7,0,1144,103,109,6
"4280927ec4d643238aa49c32f9e06c6c","73039f8c1eb9409cb4caee2cf968001e",22900468,1,-10,0,1145,109,100,-9
"73039f8c1eb9409cb4caee2cf968001e","08111f75e22d409998cf8b85bd431f0a",22900468,1,9,0,1146,100,108,8
"08111f75e22d409998cf8b85bd431f0a","a9ae0a3c070d455bb4369a8996313336",22900468,2,7,0,1147,108,114,6
"a9ae0a3c070d455bb4369a8996313336","37319e88176d4aefa91d7a9980dbae91",22900468,1,-2,0,1148,114,112,-2
"37319e88176d4aefa91d7a9980dbae91","62bff51286ef4f348717a3cf6fe2318f",22900468,2,9,0,1149,112,120,8
"62bff51286ef4f348717a3cf6fe2318f","62bff51286ef4f348717a3cf6fe2318f",22900468,5,0,1,1150,120,120,0
"62bff51286ef4f348717a3cf6fe2318f","e20db35ced8544ddac5bc3839145e463",22900468,2,-33,0,1152,120,91,-29
"e20db35ced8544ddac5bc3839145e463","779f9ddd1fd14d1e9e69f72219a1fdbd",22900468,2,36,0,1153,91,121,30
"779f9ddd1fd14d1e9e69f72219a1fdbd","779f9ddd1fd14d1e9e69f72219a1fdbd",22900468,1,0,1,1154,121,121,0
"779f9ddd1fd14d1e9e69f72219a1fdbd","a8dd5213034441ac92724b4e83eb0bb2",22900468,2,9,0,1155,121,129,8
"a8dd5213034441ac92724b4e83eb0bb2","579338175e0b4bbb8ef3b712b5d8b54e",22900468,1,-1,0,1156,129,128,-1
"579338175e0b4bbb8ef3b712b5d8b54e","b416d47c56a742199b5d7c7f19d6503a",22900468,1,7,0,1157,128,134,6
"b416d47c56a742199b5d7c7f19d6503a","df1de691dafe4549a18a4398ee9dfaf9",22900468,1,8,0,1158,134,139,5
"df1de691dafe4549a18a4398ee9dfaf9","779f9ddd1fd14d1e9e69f72219a1fdbd",22900468,2,-23,0,1159,139,121,-18
"779f9ddd1fd14d1e9e69f72219a1fdbd","6c5ad271a44743479bfaea29b1db8d02",22900468,2,27,0,1160,121,143,22
"6c5ad271a44743479bfaea29b1db8d02","8aae34f5ddbb4052a709b12e6b0d40fa",22900468,1,5,0,1161,143,147,4
"8aae34f5ddbb4052a709b12e6b0d40fa","df1de691dafe4549a18a4398ee9dfaf9",22900468,1,-9,0,1162,147,139,-8
"df1de691dafe4549a18a4398ee9dfaf9","f902b0f41b544d4dbf79664fd233648d",22900468,1,8,0,1163,139,146,7
"f902b0f41b544d4dbf79664fd233648d","f03480cf4eba413194d7af52fc0e7f28",22900468,1,7,0,1164,146,152,6
"f03480cf4eba413194d7af52fc0e7f28","d313cec988a84645bee413e8d4724a4b",22900468,2,7,0,1165,152,158,6
"d313cec988a84645bee413e8d4724a4b","d313cec988a84645bee413e8d4724a4b",22900468,8,0,1,1166,158,158,0
"d313cec988a84645bee413e8d4724a4b","df1de691dafe4549a18a4398ee9dfaf9",22900468,2,-22,0,1168,158,139,-19
"df1de691dafe4549a18a4398ee9dfaf9","78adeee1fa2c4fe0bc73f7bca9fcee86",22900468,3,26,0,1169,139,160,21
"78adeee1fa2c4fe0bc73f7bca9fcee86","65202579580f4ad38d734b4ee39d22a8",22900468,5,5,0,1170,160,164,4
"65202579580f4ad38d734b4ee39d22a8","65202579580f4ad38d734b4ee39d22a8",22900468,72,0,1,1171,164,164,0
"65202579580f4ad38d734b4ee39d22a8","78adeee1fa2c4fe0bc73f7bca9fcee86",22900468,2,-5,0,1172,164,160,-4
"78adeee1fa2c4fe0bc73f7bca9fcee86","3cbcea2be0984e7dbd5a48195af10ce7",22900468,1,8,0,1180,160,165,5
"3cbcea2be0984e7dbd5a48195af10ce7","82e6285962b8400d9d6fc32436022a94",22900468,6,2,0,1181,165,167,2
"82e6285962b8400d9d6fc32436022a94","3cbcea2be0984e7dbd5a48195af10ce7",22900468,1,-2,0,1182,167,165,-2
"82e6285962b8400d9d6fc32436022a94","1b4550d0dab04078b3bf08a655345bdc",22900468,1,278,0,1184,167,373,206
"8d448d625b024c82a5eb240bbd7431d6","1ba8fef685d74a8194b9db252eb704fb",22900468,1,-25,0,1194,374,355,-19
"1ba8fef685d74a8194b9db252eb704fb","30ead9794d4847abaf222ca966cc8630",22900468,1,-8,0,1195,355,348,-7
"2fe14166dc9642c3bc666b86a57f943d","4a29443515bb404cb8924e1c60a63b73",22900468,1,-92,0,1198,357,285,-72
"4a29443515bb404cb8924e1c60a63b73","b71bac264efb4abd97015447bd490db6",22900468,1,110,0,1199,285,370,85
"b71bac264efb4abd97015447bd490db6","b71bac264efb4abd97015447bd490db6",22900468,1,0,1,1200,370,370,0
"d6d02b6ef04e4f17805504500b8ce441","66baf19b6b904b70922329068c63746d",22900468,1,4,0,1259,375,376,1
"66baf19b6b904b70922329068c63746d","7f544639412e40a9ba27f43b415362ab",22900468,2,2,0,1260,376,378,2
"7f544639412e40a9ba27f43b415362ab","66baf19b6b904b70922329068c63746d",22900468,2,-2,0,1261,378,376,-2
"66baf19b6b904b70922329068c63746d","66baf19b6b904b70922329068c63746d",22900468,3,0,1,1262,376,376,0
"7f544639412e40a9ba27f43b415362ab","7f544639412e40a9ba27f43b415362ab",22900468,1,0,1,1264,378,378,0
"7f544639412e40a9ba27f43b415362ab","d5ae8642e15b46b8bd298b02274d4e9c",22900468,1,2,0,1265,378,380,2
"d5ae8642e15b46b8bd298b02274d4e9c","d5ae8642e15b46b8bd298b02274d4e9c",22900468,1,0,1,1266,380,380,0
"d5ae8642e15b46b8bd298b02274d4e9c","a0d10309a2dd456289147f84be9d37f9",22900468,1,1,0,1267,380,381,1
"a0d10309a2dd456289147f84be9d37f9","a0d10309a2dd456289147f84be9d37f9",22900468,2,0,1,1268,381,381,0
"a0d10309a2dd456289147f84be9d37f9","0fcbc3ca07b144138b8d85da581f09a8",22900468,1,1,0,1270,381,382,1
"0fcbc3ca07b144138b8d85da581f09a8","0fcbc3ca07b144138b8d85da581f09a8",22900468,2,0,1,1271,382,382,0
"0fcbc3ca07b144138b8d85da581f09a8","66baf19b6b904b70922329068c63746d",22900468,1,-6,0,1273,382,376,-6
"66baf19b6b904b70922329068c63746d","4890121ce5d74576b4632b77cfc23398",22900468,1,14,0,1274,376,388,12
"4890121ce5d74576b4632b77cfc23398","c2fca3669923477ab966ded303dea31c",22900468,1,-6,0,1275,388,383,-5
"c2fca3669923477ab966ded303dea31c","4890121ce5d74576b4632b77cfc23398",22900468,1,6,0,1276,383,388,5
"4890121ce5d74576b4632b77cfc23398","18d3b836dd804224883cc9180b60a8e1",22900468,1,-1,0,1277,388,387,-1
"18d3b836dd804224883cc9180b60a8e1","96bb2b3e85a34d8b9544514e89f6fe97",22900468,1,4,0,1278,387,390,3
"96bb2b3e85a34d8b9544514e89f6fe97","96bb2b3e85a34d8b9544514e89f6fe97",22900468,1,0,1,1279,390,390,0
"96bb2b3e85a34d8b9544514e89f6fe97","ac4e9b54acfe4670b4634859c7263cb5",22900468,1,2,0,1280,390,392,2
"ac4e9b54acfe4670b4634859c7263cb5","ac4e9b54acfe4670b4634859c7263cb5",22900468,3,0,1,1281,392,392,0
"ac4e9b54acfe4670b4634859c7263cb5","6f8881a745ac4c358a68b92c3b4abe81",22900468,1,3,0,1284,392,394,2
"6f8881a745ac4c358a68b92c3b4abe81","17f95d18bab743888e1736033dc3384d",22900468,1,-6,0,1285,394,389,-5
"17f95d18bab743888e1736033dc3384d","6f8881a745ac4c358a68b92c3b4abe81",22900468,1,6,0,1286,389,394,5
"6f8881a745ac4c358a68b92c3b4abe81","f7002c8484354eceac57bc7bd62c76c1",22900468,2,-1,0,1287,394,393,-1
"f7002c8484354eceac57bc7bd62c76c1","3cbcea2be0984e7dbd5a48195af10ce7",22900468,1,-309,0,1288,393,165,-228
"82e6285962b8400d9d6fc32436022a94","8959e6304a0348309a771e4d08d1b64a",22900468,1,-6,0,1290,167,163,-4
"8959e6304a0348309a771e4d08d1b64a","78adeee1fa2c4fe0bc73f7bca9fcee86",22900468,4,-4,0,1291,163,160,-3
"65202579580f4ad38d734b4ee39d22a8","67a089198fcb4e1c8f2385786c2b296f",22900468,1,-157,0,1300,164,39,-125
"67a089198fcb4e1c8f2385786c2b296f","8959e6304a0348309a771e4d08d1b64a",22900468,1,156,0,1301,39,163,124
"65202579580f4ad38d734b4ee39d22a8","8959e6304a0348309a771e4d08d1b64a",22900468,1,-1,0,1311,164,163,-1
"78adeee1fa2c4fe0bc73f7bca9fcee86","df1de691dafe4549a18a4398ee9dfaf9",22900468,2,-26,0,1313,160,139,-21
"df1de691dafe4549a18a4398ee9dfaf9","d313cec988a84645bee413e8d4724a4b",22900468,2,22,0,1314,139,158,19
"78adeee1fa2c4fe0bc73f7bca9fcee86","78adeee1fa2c4fe0bc73f7bca9fcee86",22900468,1,0,1,1319,160,160,0
"d313cec988a84645bee413e8d4724a4b","67a089198fcb4e1c8f2385786c2b296f",22900468,1,-148,0,1322,158,39,-119
"67a089198fcb4e1c8f2385786c2b296f","d646286c8051419bbc2e31dd1db55ca8",22900468,1,37,0,1323,39,67,28
"d646286c8051419bbc2e31dd1db55ca8","140d5b27b8574befad82c0a013b59dfa",22900468,1,8,0,1324,67,74,7
"140d5b27b8574befad82c0a013b59dfa","a2becd407db34b189200a32546d9d569",22900468,1,1,0,1325,74,75,1
"a2becd407db34b189200a32546d9d569","a2becd407db34b189200a32546d9d569",22900468,2,0,1,1326,75,75,0
"a2becd407db34b189200a32546d9d569","8959e6304a0348309a771e4d08d1b64a",22900468,1,110,0,1327,75,163,88
"65202579580f4ad38d734b4ee39d22a8","3cbcea2be0984e7dbd5a48195af10ce7",22900468,1,3,0,1382,164,165,1
"3cbcea2be0984e7dbd5a48195af10ce7","78adeee1fa2c4fe0bc73f7bca9fcee86",22900468,1,-8,0,1383,165,160,-5
"78adeee1fa2c4fe0bc73f7bca9fcee86","82e6285962b8400d9d6fc32436022a94",22900468,1,10,0,1384,160,167,7
"82e6285962b8400d9d6fc32436022a94","67a089198fcb4e1c8f2385786c2b296f",22900468,2,-162,0,1385,167,39,-128
"67a089198fcb4e1c8f2385786c2b296f","0d987bed3ffa4ed0b9a2e62e97b7b30f",22900468,1,304,0,1386,39,272,233
"0d987bed3ffa4ed0b9a2e62e97b7b30f","0d987bed3ffa4ed0b9a2e62e97b7b30f",22900468,1,0,1,1387,272,272,0
"0d987bed3ffa4ed0b9a2e62e97b7b30f","0c7262dff33c4087bc660ccf40f92f9c",22900468,1,-135,0,1388,272,169,-103
"0c7262dff33c4087bc660ccf40f92f9c","1b4550d0dab04078b3bf08a655345bdc",22900468,1,271,0,1389,169,373,204
"8d448d625b024c82a5eb240bbd7431d6","4a29443515bb404cb8924e1c60a63b73",22900468,1,-115,0,1399,374,285,-89
"4a29443515bb404cb8924e1c60a63b73","f7002c8484354eceac57bc7bd62c76c1",22900468,1,143,0,1400,285,393,108
"f7002c8484354eceac57bc7bd62c76c1","66baf19b6b904b70922329068c63746d",22900468,1,-21,0,1401,393,376,-17
"66baf19b6b904b70922329068c63746d","6f8881a745ac4c358a68b92c3b4abe81",22900468,1,22,0,1402,376,394,18
"6f8881a745ac4c358a68b92c3b4abe81","6f8881a745ac4c358a68b92c3b4abe81",22900468,1,0,1,1403,394,394,0
"f7002c8484354eceac57bc7bd62c76c1","44a277ea44dc4ae689fab4b82f0b4098",22900468,1,5,0,1405,393,397,4
"44a277ea44dc4ae689fab4b82f0b4098","44a277ea44dc4ae689fab4b82f0b4098",22900468,1,0,1,1406,397,397,0
"44a277ea44dc4ae689fab4b82f0b4098","0c12af0a4e7f4002852cf84b2537c161",22900468,1,-2,0,1407,397,395,-2
"0c12af0a4e7f4002852cf84b2537c161","df8191ec5e584c838a899c378941a566",22900468,1,4,0,1408,395,398,3
"df8191ec5e584c838a899c378941a566","7f544639412e40a9ba27f43b415362ab",22900468,1,-26,0,1409,398,378,-20
"66baf19b6b904b70922329068c63746d","859e0b8d71694b12befb69ee698138f9",22900468,1,29,0,1411,376,399,23
"859e0b8d71694b12befb69ee698138f9","859e0b8d71694b12befb69ee698138f9",22900468,1,0,1,1412,399,399,0
"859e0b8d71694b12befb69ee698138f9","66baf19b6b904b70922329068c63746d",22900468,1,-29,0,1413,399,376,-23
"66baf19b6b904b70922329068c63746d","2b09a08242b54983aec7063990fb3f66",22900468,1,32,0,1414,376,400,24
"2b09a08242b54983aec7063990fb3f66","2b09a08242b54983aec7063990fb3f66",22900468,2,0,1,1415,400,400,0
"2b09a08242b54983aec7063990fb3f66","1f471b7a883a4df48211e8c6a81b59a7",22900468,1,1,0,1417,400,401,1
"1f471b7a883a4df48211e8c6a81b59a7","1f471b7a883a4df48211e8c6a81b59a7",22900468,1,0,1,1418,401,401,0
"1f471b7a883a4df48211e8c6a81b59a7","2b09a08242b54983aec7063990fb3f66",22900468,1,-1,0,1419,401,400,-1
"2b09a08242b54983aec7063990fb3f66","d989ebcfc12a4b669f0100dc1aa14f1e",22900468,1,-198,0,1420,400,255,-145
"d989ebcfc12a4b669f0100dc1aa14f1e","2ae94c0cea4d480a9d5dca8fb1d7b542",22900468,1,-16,0,1421,255,242,-13
"2ae94c0cea4d480a9d5dca8fb1d7b542","1157bd665ec4472fb58b751dc5099355",22900468,1,218,0,1422,242,403,161
"1157bd665ec4472fb58b751dc5099355","2b09a08242b54983aec7063990fb3f66",22900468,1,-4,0,1423,403,400,-3
"2b09a08242b54983aec7063990fb3f66","9de0d567bfa84fe5b77cb76f4a76a5d1",22900468,1,5,0,1424,400,404,4
"9de0d567bfa84fe5b77cb76f4a76a5d1","9de0d567bfa84fe5b77cb76f4a76a5d1",22900468,1,0,1,1425,404,404,0
"9de0d567bfa84fe5b77cb76f4a76a5d1","1157bd665ec4472fb58b751dc5099355",22900468,1,-1,0,1426,404,403,-1
"1157bd665ec4472fb58b751dc5099355","58fc9094275e4c49be3f4ba6d4acc0a4",22900468,1,5,0,1427,403,406,3
"58fc9094275e4c49be3f4ba6d4acc0a4","3c8a22d2f9c146ea956609e3ed4f2559",22900468,1,-2,0,1428,406,405,-1
"3c8a22d2f9c146ea956609e3ed4f2559","58fc9094275e4c49be3f4ba6d4acc0a4",22900468,1,2,0,1429,405,406,1
"58fc9094275e4c49be3f4ba6d4acc0a4","c1c1be90b2b14c1ab4a5e1ee3c241902",22900468,1,1,0,1430,406,407,1
"c1c1be90b2b14c1ab4a5e1ee3c241902","c1c1be90b2b14c1ab4a5e1ee3c241902",22900468,5,0,1,1431,407,407,0
"c1c1be90b2b14c1ab4a5e1ee3c241902","58fc9094275e4c49be3f4ba6d4acc0a4",22900468,1,-1,0,1436,407,406,-1
"58fc9094275e4c49be3f4ba6d4acc0a4","02b3a1bead9244c1ba2f857c7da8f82a",22900468,1,3,0,1437,406,408,2
"02b3a1bead9244c1ba2f857c7da8f82a","66baf19b6b904b70922329068c63746d",22900468,1,-44,0,1438,408,376,-32
"66baf19b6b904b70922329068c63746d","3cbcea2be0984e7dbd5a48195af10ce7",22900468,2,-288,0,1440,376,165,-211
"67a089198fcb4e1c8f2385786c2b296f","2b09a08242b54983aec7063990fb3f66",22900468,1,480,0,1443,39,400,361
"2b09a08242b54983aec7063990fb3f66","02b3a1bead9244c1ba2f857c7da8f82a",22900468,1,12,0,1444,400,408,8
"02b3a1bead9244c1ba2f857c7da8f82a","02b3a1bead9244c1ba2f857c7da8f82a",22900468,2,0,1,1445,408,408,0
"02b3a1bead9244c1ba2f857c7da8f82a","6206fc6479014bb193084c32409dc1b9",22900468,1,1,0,1447,408,409,1
"6206fc6479014bb193084c32409dc1b9","6206fc6479014bb193084c32409dc1b9",22900468,1,0,1,1448,409,409,0
"6206fc6479014bb193084c32409dc1b9","6a5f020451db426dacba9e2ea3fcc62a",22900468,1,2,0,1449,409,410,1
"6a5f020451db426dacba9e2ea3fcc62a","02b3a1bead9244c1ba2f857c7da8f82a",22900468,1,-3,0,1450,410,408,-2
"02b3a1bead9244c1ba2f857c7da8f82a","6a5f020451db426dacba9e2ea3fcc62a",22900468,1,3,0,1451,408,410,2
"6a5f020451db426dacba9e2ea3fcc62a","6a5f020451db426dacba9e2ea3fcc62a",22900468,1,0,1,1452,410,410,0
"6a5f020451db426dacba9e2ea3fcc62a","33a9d248b2e44588a5b07fc1342b9bc2",22900468,2,2,0,1453,410,411,1
"33a9d248b2e44588a5b07fc1342b9bc2","6a5f020451db426dacba9e2ea3fcc62a",22900468,1,-2,0,1454,411,410,-1
"33a9d248b2e44588a5b07fc1342b9bc2","c6f26bd420634f1cb7989e76fe6b16c0",22900468,1,1,0,1456,411,412,1
"c6f26bd420634f1cb7989e76fe6b16c0","c6f26bd420634f1cb7989e76fe6b16c0",22900468,5,0,1,1457,412,412,0
"c6f26bd420634f1cb7989e76fe6b16c0","2a65ee6e2ac64f6a8a55fbe5373ec763",22900468,1,1,0,1462,412,413,1
"2a65ee6e2ac64f6a8a55fbe5373ec763","2a65ee6e2ac64f6a8a55fbe5373ec763",22900468,2,0,1,1463,413,413,0
"2a65ee6e2ac64f6a8a55fbe5373ec763","33a9d248b2e44588a5b07fc1342b9bc2",22900468,1,-2,0,1465,413,411,-2
"33a9d248b2e44588a5b07fc1342b9bc2","1fd0f6dadbc14ebc965faf6122190b96",22900468,1,5,0,1466,411,415,4
"1fd0f6dadbc14ebc965faf6122190b96","1fd0f6dadbc14ebc965faf6122190b96",22900468,1,0,1,1467,415,415,0
"1fd0f6dadbc14ebc965faf6122190b96","687055dad9fc40c3982478fe33ec01bf",22900468,1,-1,0,1468,415,414,-1
"687055dad9fc40c3982478fe33ec01bf","2add1669f08d4101913db15f8c23b3b7",22900468,1,3,0,1469,414,416,2
"2add1669f08d4101913db15f8c23b3b7","2add1669f08d4101913db15f8c23b3b7",22900468,1,0,1,1470,416,416,0
"2add1669f08d4101913db15f8c23b3b7","a2b4bd40cee2481ebd3fc179d6a5cd62",22900468,1,3,0,1471,416,417,1
"a2b4bd40cee2481ebd3fc179d6a5cd62","2b09a08242b54983aec7063990fb3f66",22900468,1,-27,0,1472,417,400,-17
"2b09a08242b54983aec7063990fb3f66","e34e59dce2204f228f3a84b6725df60f",22900468,1,29,0,1473,400,419,19
"e34e59dce2204f228f3a84b6725df60f","e34e59dce2204f228f3a84b6725df60f",22900468,1,0,1,1474,419,419,0
"e34e59dce2204f228f3a84b6725df60f","bec48fc2e1294c7eb3d0aca780d731b8",22900468,1,2,0,1475,419,420,1
"bec48fc2e1294c7eb3d0aca780d731b8","a2b4bd40cee2481ebd3fc179d6a5cd62",22900468,1,-4,0,1476,420,417,-3
"a2b4bd40cee2481ebd3fc179d6a5cd62","bec48fc2e1294c7eb3d0aca780d731b8",22900468,1,4,0,1477,417,420,3
"bec48fc2e1294c7eb3d0aca780d731b8","bec48fc2e1294c7eb3d0aca780d731b8",22900468,1,0,1,1478,420,420,0
"bec48fc2e1294c7eb3d0aca780d731b8","dbde19fcce2a4c1abdc7f685c293a23f",22900468,1,3,0,1479,420,422,2
"dbde19fcce2a4c1abdc7f685c293a23f","a24600b0e49245f6bdba8c893cfeddb0",22900468,2,4,0,1480,422,425,3
"a24600b0e49245f6bdba8c893cfeddb0","a24600b0e49245f6bdba8c893cfeddb0",22900468,5,0,1,1481,425,425,0
"a24600b0e49245f6bdba8c893cfeddb0","dbde19fcce2a4c1abdc7f685c293a23f",22900468,1,-4,0,1484,425,422,-3
"a24600b0e49245f6bdba8c893cfeddb0","24cf8786024543f19b89bc20034e60d7",22900468,1,7,0,1488,425,428,3
"24cf8786024543f19b89bc20034e60d7","a2b4bd40cee2481ebd3fc179d6a5cd62",22900468,2,-18,0,1489,428,417,-11
"a2b4bd40cee2481ebd3fc179d6a5cd62","f2a73be2f46840b182d7bd095378004e",22900468,1,19,0,1490,417,429,12
"f2a73be2f46840b182d7bd095378004e","f2a73be2f46840b182d7bd095378004e",22900468,1,0,1,1491,429,429,0
"f2a73be2f46840b182d7bd095378004e","604551fd4266430cb860fef58fa7dd61",22900468,1,1,0,1492,429,430,1
"604551fd4266430cb860fef58fa7dd61","604551fd4266430cb860fef58fa7dd61",22900468,7,0,1,1493,430,430,0
"604551fd4266430cb860fef58fa7dd61","dce46f8904594a62a6377a3587aaa663",22900468,1,2,0,1500,430,431,1
"dce46f8904594a62a6377a3587aaa663","24cf8786024543f19b89bc20034e60d7",22900468,2,-4,0,1501,431,428,-3
"24cf8786024543f19b89bc20034e60d7","dce46f8904594a62a6377a3587aaa663",22900468,3,4,0,1502,428,431,3
"dce46f8904594a62a6377a3587aaa663","9b9d0a249052413c869753b99682b0ac",22900468,1,1,0,1503,431,432,1
"9b9d0a249052413c869753b99682b0ac","9b9d0a249052413c869753b99682b0ac",22900468,1,0,1,1504,432,432,0
"9b9d0a249052413c869753b99682b0ac","061c175cc90f45fbad883025394e78dd",22900468,1,1,0,1505,432,433,1
"061c175cc90f45fbad883025394e78dd","061c175cc90f45fbad883025394e78dd",22900468,5,0,1,1506,433,433,0
"061c175cc90f45fbad883025394e78dd","dce46f8904594a62a6377a3587aaa663",22900468,1,-2,0,1511,433,431,-2
"dce46f8904594a62a6377a3587aaa663","66baf19b6b904b70922329068c63746d",22900468,1,-81,0,1512,431,376,-55
"82e6285962b8400d9d6fc32436022a94","dce46f8904594a62a6377a3587aaa663",22900468,1,367,0,1516,167,431,264
"dce46f8904594a62a6377a3587aaa663","dce46f8904594a62a6377a3587aaa663",22900468,2,0,1,1519,431,431,0
"dce46f8904594a62a6377a3587aaa663","f2a73be2f46840b182d7bd095378004e",22900468,1,-3,0,1520,431,429,-2
"f2a73be2f46840b182d7bd095378004e","66ada10dde9f43018588f1ced9d477fc",22900468,1,7,0,1521,429,434,5
"66ada10dde9f43018588f1ced9d477fc","24cf8786024543f19b89bc20034e60d7",22900468,1,-8,0,1522,434,428,-6
"a2b4bd40cee2481ebd3fc179d6a5cd62","a2b4bd40cee2481ebd3fc179d6a5cd62",22900468,1,0,1,1524,417,417,0
"a2b4bd40cee2481ebd3fc179d6a5cd62","24cf8786024543f19b89bc20034e60d7",22900468,1,18,0,1525,417,428,11
"24cf8786024543f19b89bc20034e60d7","f2a73be2f46840b182d7bd095378004e",22900468,1,1,0,1526,428,429,1
"f2a73be2f46840b182d7bd095378004e","24cf8786024543f19b89bc20034e60d7",22900468,1,-1,0,1527,429,428,-1
"dce46f8904594a62a6377a3587aaa663","74a7f8712e5449c2bc0b43c6f90dafed",22900468,1,5,0,1530,431,435,4
"74a7f8712e5449c2bc0b43c6f90dafed","74a7f8712e5449c2bc0b43c6f90dafed",22900468,1,0,1,1531,435,435,0
"74a7f8712e5449c2bc0b43c6f90dafed","66ada10dde9f43018588f1ced9d477fc",22900468,1,-1,0,1532,435,434,-1
"66ada10dde9f43018588f1ced9d477fc","bf12c96466d840a69bed7020b3f18bb8",22900468,1,3,0,1533,434,436,2
"bf12c96466d840a69bed7020b3f18bb8","bf12c96466d840a69bed7020b3f18bb8",22900468,1,0,1,1534,436,436,0
"bf12c96466d840a69bed7020b3f18bb8","24cf8786024543f19b89bc20034e60d7",22900468,1,-11,0,1535,436,428,-8
"24cf8786024543f19b89bc20034e60d7","070600601c4c439288445d2f0724807d",22900468,1,14,0,1536,428,437,9
"070600601c4c439288445d2f0724807d","1823b6de7d334a7aaabc4570719af4d9",22900468,1,2,0,1537,437,439,2
"1823b6de7d334a7aaabc4570719af4d9","1823b6de7d334a7aaabc4570719af4d9",22900468,14,0,1,1538,439,439,0
"1823b6de7d334a7aaabc4570719af4d9","070600601c4c439288445d2f0724807d",22900468,1,-2,0,1552,439,437,-2
"070600601c4c439288445d2f0724807d","0380cd76a7d44bc3a4da1f15e4d68f89",22900468,1,4,0,1553,437,440,3
"0380cd76a7d44bc3a4da1f15e4d68f89","0380cd76a7d44bc3a4da1f15e4d68f89",22900468,3,0,1,1554,440,440,0
"0380cd76a7d44bc3a4da1f15e4d68f89","23b7673c8b5443108c2ef09382834a86",22900468,1,2,0,1557,440,441,1
"23b7673c8b5443108c2ef09382834a86","23b7673c8b5443108c2ef09382834a86",22900468,3,0,1,1558,441,441,0
"23b7673c8b5443108c2ef09382834a86","901e92500aea43c79f19f1b279050668",22900468,1,2,0,1561,441,442,1
"901e92500aea43c79f19f1b279050668","901e92500aea43c79f19f1b279050668",22900468,1,0,1,1562,442,442,0
"901e92500aea43c79f19f1b279050668","001339db8ced4cf78829ebe8b145449d",22900468,1,1,0,1563,442,443,1
"001339db8ced4cf78829ebe8b145449d","001339db8ced4cf78829ebe8b145449d",22900468,2,0,1,1564,443,443,0
"001339db8ced4cf78829ebe8b145449d","452745e0366e42ae81561bfddebcc6c3",22900468,1,1,0,1566,443,444,1
"452745e0366e42ae81561bfddebcc6c3","452745e0366e42ae81561bfddebcc6c3",22900468,2,0,1,1567,444,444,0
"452745e0366e42ae81561bfddebcc6c3","901e92500aea43c79f19f1b279050668",22900468,1,-2,0,1569,444,442,-2
"901e92500aea43c79f19f1b279050668","4660ff2089114e8db82ceb26a4f329e3",22900468,1,4,0,1570,442,445,3
"4660ff2089114e8db82ceb26a4f329e3","4660ff2089114e8db82ceb26a4f329e3",22900468,1,0,1,1571,445,445,0
"4660ff2089114e8db82ceb26a4f329e3","7bd5586eb9d8484eb74a433ee7bfe499",22900468,2,2,0,1572,445,446,1
"7bd5586eb9d8484eb74a433ee7bfe499","4660ff2089114e8db82ceb26a4f329e3",22900468,1,-2,0,1573,446,445,-1
"7bd5586eb9d8484eb74a433ee7bfe499","7bd5586eb9d8484eb74a433ee7bfe499",22900468,10,0,1,1575,446,446,0
"7bd5586eb9d8484eb74a433ee7bfe499","8a7f26e690f34dda97be16904518ca99",22900468,1,2,0,1585,446,447,1
"8a7f26e690f34dda97be16904518ca99","8a7f26e690f34dda97be16904518ca99",22900468,1,0,1,1586,447,447,0
"8a7f26e690f34dda97be16904518ca99","070600601c4c439288445d2f0724807d",22900468,1,-16,0,1587,447,437,-10
"070600601c4c439288445d2f0724807d","b2f0d654738f48158edff28e8d3a546e",22900468,1,21,0,1588,437,449,12
"b2f0d654738f48158edff28e8d3a546e","f60ee41ec635499abd48168342d32c2f",22900468,2,5,0,1589,449,453,4
"f60ee41ec635499abd48168342d32c2f","f60ee41ec635499abd48168342d32c2f",22900468,53,0,1,1590,453,453,0
"f60ee41ec635499abd48168342d32c2f","b2f0d654738f48158edff28e8d3a546e",22900468,2,-5,0,1596,453,449,-4
"b2f0d654738f48158edff28e8d3a546e","f67fbf45a5f146ed866965bc57c7c001",22900468,1,8,0,1646,449,454,5
"f67fbf45a5f146ed866965bc57c7c001","f67fbf45a5f146ed866965bc57c7c001",22900468,2,0,1,1647,454,454,0
"f67fbf45a5f146ed866965bc57c7c001","d937afe49bd24a07a550dda1c1155122",22900468,1,1,0,1649,454,455,1
"d937afe49bd24a07a550dda1c1155122","d937afe49bd24a07a550dda1c1155122",22900468,5,0,1,1650,455,455,0
"d937afe49bd24a07a550dda1c1155122","3628b3f7823443d0912a339096b69943",22900468,1,1,0,1655,455,456,1
"3628b3f7823443d0912a339096b69943","3628b3f7823443d0912a339096b69943",22900468,1,0,1,1656,456,456,0
"3628b3f7823443d0912a339096b69943","9e049ee647cf43ecbcb5ed792a8e7588",22900468,1,1,0,1657,456,457,1
"9e049ee647cf43ecbcb5ed792a8e7588","9e049ee647cf43ecbcb5ed792a8e7588",22900468,1,0,1,1658,457,457,0
"9e049ee647cf43ecbcb5ed792a8e7588","5256a214faaf410b93f76cea06428334",22900468,1,1,0,1659,457,458,1
"5256a214faaf410b93f76cea06428334","5256a214faaf410b93f76cea06428334",22900468,1,0,1,1660,458,458,0
"5256a214faaf410b93f76cea06428334","25c32b120fce40fa9b6c85133aeb4716",22900468,1,1,0,1661,458,459,1
"25c32b120fce40fa9b6c85133aeb4716","25c32b120fce40fa9b6c85133aeb4716",22900468,1,0,1,1662,459,459,0
"25c32b120fce40fa9b6c85133aeb4716","11bc14f2204949008b7d511b933363c1",22900468,1,1,0,1663,459,460,1
"11bc14f2204949008b7d511b933363c1","11bc14f2204949008b7d511b933363c1",22900468,1,0,1,1664,460,460,0
"11bc14f2204949008b7d511b933363c1","42de338840a34d15adb66e7b14fb9d2c",22900468,1,1,0,1665,460,461,1
"42de338840a34d15adb66e7b14fb9d2c","42de338840a34d15adb66e7b14fb9d2c",22900468,1,0,1,1666,461,461,0
"42de338840a34d15adb66e7b14fb9d2c","9da37c6210b1416b8079c274f70bf600",22900468,1,1,0,1667,461,462,1
"9da37c6210b1416b8079c274f70bf600","9da37c6210b1416b8079c274f70bf600",22900468,1,0,1,1668,462,462,0
"9da37c6210b1416b8079c274f70bf600","519119f1deac45ff9ab4f13529be5c6e",22900468,1,1,0,1669,462,463,1
"519119f1deac45ff9ab4f13529be5c6e","519119f1deac45ff9ab4f13529be5c6e",22900468,1,0,1,1670,463,463,0
"519119f1deac45ff9ab4f13529be5c6e","f67fbf45a5f146ed866965bc57c7c001",22900468,1,-9,0,1671,463,454,-9
"f67fbf45a5f146ed866965bc57c7c001","c5df9f40ec14463b9dcfdc73df3e9285",22900468,1,12,0,1672,454,464,10
"c5df9f40ec14463b9dcfdc73df3e9285","c5df9f40ec14463b9dcfdc73df3e9285",22900468,2,0,1,1673,464,464,0
"c5df9f40ec14463b9dcfdc73df3e9285","83d42d95cd844fc093fc09cee250edb8",22900468,1,3,0,1675,464,465,1
"83d42d95cd844fc093fc09cee250edb8","83d42d95cd844fc093fc09cee250edb8",22900468,5,0,1,1676,465,465,0
"83d42d95cd844fc093fc09cee250edb8","66baf19b6b904b70922329068c63746d",22900468,1,-135,0,1677,465,376,-89
"66baf19b6b904b70922329068c63746d","83d42d95cd844fc093fc09cee250edb8",22900468,1,135,0,1678,376,465,89
"83d42d95cd844fc093fc09cee250edb8","3cbcea2be0984e7dbd5a48195af10ce7",22900468,1,-423,0,1683,465,165,-300
"b613861cecf84ffcab01afb23f660475","b613861cecf84ffcab01afb23f660475",22905304,7,0,1,1,1,1,0
"e2911e79efc2420eac45d9f671463d4b","b613861cecf84ffcab01afb23f660475",22905304,1,-3,0,4,2,1,-1
"b613861cecf84ffcab01afb23f660475","e2911e79efc2420eac45d9f671463d4b",22905304,2,3,0,10,1,2,1
"e2911e79efc2420eac45d9f671463d4b","e2911e79efc2420eac45d9f671463d4b",22905304,2,0,1,11,2,2,0
"e2911e79efc2420eac45d9f671463d4b","519d1b8c59404d67b54e96c5c8a830b2",22905304,1,1,0,13,2,3,1
"519d1b8c59404d67b54e96c5c8a830b2","519d1b8c59404d67b54e96c5c8a830b2",22905304,1,0,1,14,3,3,0
"519d1b8c59404d67b54e96c5c8a830b2","531db53f81f646edb0cdcfe0085b03b7",22905304,1,1,0,15,3,4,1
"531db53f81f646edb0cdcfe0085b03b7","531db53f81f646edb0cdcfe0085b03b7",22905304,1,0,1,16,4,4,0
"531db53f81f646edb0cdcfe0085b03b7","4f5f94b2f95141e0a9d53a61da2276da",22905304,1,1,0,17,4,5,1
"4f5f94b2f95141e0a9d53a61da2276da","4f5f94b2f95141e0a9d53a61da2276da",22905304,2,0,1,18,5,5,0
"4f5f94b2f95141e0a9d53a61da2276da","6d541c89590949f99af293c4f2333f67",22905304,1,1,0,20,5,6,1
"6d541c89590949f99af293c4f2333f67","6d541c89590949f99af293c4f2333f67",22905304,1,0,1,21,6,6,0
"6d541c89590949f99af293c4f2333f67","dd5cf0b9fe4c4f1d8f5ff8e4c04879cb",22905304,1,1,0,22,6,7,1
"dd5cf0b9fe4c4f1d8f5ff8e4c04879cb","dd5cf0b9fe4c4f1d8f5ff8e4c04879cb",22905304,1,0,1,23,7,7,0
"dd5cf0b9fe4c4f1d8f5ff8e4c04879cb","f96261861edc426abe2248be4f0a709a",22905304,1,1,0,24,7,8,1
"f96261861edc426abe2248be4f0a709a","f96261861edc426abe2248be4f0a709a",22905304,1,0,1,25,8,8,0
"f96261861edc426abe2248be4f0a709a","66b5e16f4f75454fb5b8172079f0fa83",22905304,1,1,0,26,8,9,1
"66b5e16f4f75454fb5b8172079f0fa83","66b5e16f4f75454fb5b8172079f0fa83",22905304,1,0,1,27,9,9,0
"66b5e16f4f75454fb5b8172079f0fa83","0680571d4698477995e41842c36a54b2",22905304,1,1,0,28,9,10,1
"0680571d4698477995e41842c36a54b2","0680571d4698477995e41842c36a54b2",22905304,1,0,1,29,10,10,0
"0680571d4698477995e41842c36a54b2","9112f2bffece48e08c6d2287be204085",22905304,1,1,0,30,10,11,1
"9112f2bffece48e08c6d2287be204085","9112f2bffece48e08c6d2287be204085",22905304,1,0,1,31,11,11,0
"9112f2bffece48e08c6d2287be204085","e2911e79efc2420eac45d9f671463d4b",22905304,1,-9,0,32,11,2,-9
"e2911e79efc2420eac45d9f671463d4b","56586aa865414f538729c7f7735d2bc6",22905304,1,12,0,33,2,12,10
"56586aa865414f538729c7f7735d2bc6","56586aa865414f538729c7f7735d2bc6",22905304,8,0,1,34,12,12,0
"56586aa865414f538729c7f7735d2bc6","b7f2b31585d94eb3bf86376714aa7070",22905304,1,2,0,37,12,13,1
"b7f2b31585d94eb3bf86376714aa7070","b7f2b31585d94eb3bf86376714aa7070",22905304,2,0,1,38,13,13,0
"b7f2b31585d94eb3bf86376714aa7070","3f1c815879794b929260d224becaff7e",22905304,1,2,0,40,13,14,1
"3f1c815879794b929260d224becaff7e","56586aa865414f538729c7f7735d2bc6",22905304,1,-4,0,41,14,12,-2
"56586aa865414f538729c7f7735d2bc6","81c864a886d54a6b8ff85f7d736f4f95",22905304,1,6,0,44,12,15,3
"81c864a886d54a6b8ff85f7d736f4f95","5c5ceeee4562457ba6d41515aeebfbb1",22905304,1,4,0,45,15,17,2
"5c5ceeee4562457ba6d41515aeebfbb1","5c5ceeee4562457ba6d41515aeebfbb1",22905304,2,0,1,46,17,17,0
"5c5ceeee4562457ba6d41515aeebfbb1","56586aa865414f538729c7f7735d2bc6",22905304,2,-10,0,48,17,12,-5
"56586aa865414f538729c7f7735d2bc6","9afd71a5298d4333b6849dfce1b9422c",22905304,1,13,0,49,12,18,6
"9afd71a5298d4333b6849dfce1b9422c","9afd71a5298d4333b6849dfce1b9422c",22905304,1,0,1,50,18,18,0
"b7719e26494940efa49512aedd0aac79","a49d1bb4328949299686242fd0be5584",22905304,2,2,0,55,20,21,1
"a49d1bb4328949299686242fd0be5584","d4f45188d3c84a02ba08454e6403a818",22905304,2,3,0,56,21,24,3
"afbf7250b99d47bea07172749483ca97","b7719e26494940efa49512aedd0aac79",22905304,5,-12,0,63,28,20,-8
"7040a13096d746ac84b8fac8d9752058","7040a13096d746ac84b8fac8d9752058",22905304,1,0,1,80,36,36,0
"9a0dc646f934470daf08c4b56ccf73db","9a0dc646f934470daf08c4b56ccf73db",22905304,1,0,1,82,37,37,0
"d4c3b003e8274e429d2fa688d73fde6d","67a089198fcb4e1c8f2385786c2b296f",22905304,1,37,0,100,22,39,17
"67a089198fcb4e1c8f2385786c2b296f","64d48c6c9c7940639a932219a6c87198",22905304,5,1,0,101,39,40,1
"64d48c6c9c7940639a932219a6c87198","a49d1bb4328949299686242fd0be5584",22905304,2,-39,0,102,40,21,-19
"a49d1bb4328949299686242fd0be5584","b7719e26494940efa49512aedd0aac79",22905304,2,-2,0,103,21,20,-1
"b7719e26494940efa49512aedd0aac79","d4f45188d3c84a02ba08454e6403a818",22905304,2,5,0,104,20,24,4
"d4f45188d3c84a02ba08454e6403a818","a49d1bb4328949299686242fd0be5584",22905304,1,-3,0,105,24,21,-3
"a49d1bb4328949299686242fd0be5584","d4c3b003e8274e429d2fa688d73fde6d",22905304,1,1,0,106,21,22,1
"d4c3b003e8274e429d2fa688d73fde6d","b7719e26494940efa49512aedd0aac79",22905304,3,-3,0,107,22,20,-2
"b7719e26494940efa49512aedd0aac79","9afd71a5298d4333b6849dfce1b9422c",22905304,2,-4,0,108,20,18,-2
"9afd71a5298d4333b6849dfce1b9422c","b7719e26494940efa49512aedd0aac79",22905304,2,4,0,109,18,20,2
"9afd71a5298d4333b6849dfce1b9422c","d4f45188d3c84a02ba08454e6403a818",22905304,1,9,0,111,18,24,6
"d4f45188d3c84a02ba08454e6403a818","d4c3b003e8274e429d2fa688d73fde6d",22905304,4,-2,0,112,24,22,-2
"d4c3b003e8274e429d2fa688d73fde6d","d4c3b003e8274e429d2fa688d73fde6d",22905304,4,0,1,113,22,22,0
"d4c3b003e8274e429d2fa688d73fde6d","5bc03c8f16354d04bd51f5bb93559ad3",22905304,1,4,0,117,22,26,4
"5bc03c8f16354d04bd51f5bb93559ad3","b7719e26494940efa49512aedd0aac79",22905304,1,-7,0,118,26,20,-6
"b7719e26494940efa49512aedd0aac79","b7719e26494940efa49512aedd0aac79",22905304,3,0,1,119,20,20,0
"b7719e26494940efa49512aedd0aac79","afbf7250b99d47bea07172749483ca97",22905304,7,12,0,120,20,28,8
"afbf7250b99d47bea07172749483ca97","afbf7250b99d47bea07172749483ca97",22905304,4,0,1,121,28,28,0
"afbf7250b99d47bea07172749483ca97","4e51676dc72045d99c19b9fa7b22f8bc",22905304,2,3,0,122,28,29,1
"4e51676dc72045d99c19b9fa7b22f8bc","4e51676dc72045d99c19b9fa7b22f8bc",22905304,2,0,1,123,29,29,0
"4e51676dc72045d99c19b9fa7b22f8bc","51970cfa30e643e894e66ae85c8024cc",22905304,2,3,0,124,29,31,2
"51970cfa30e643e894e66ae85c8024cc","4e51676dc72045d99c19b9fa7b22f8bc",22905304,2,-3,0,125,31,29,-2
"4e51676dc72045d99c19b9fa7b22f8bc","c33c17be71ae4d588da7369472e5bb1b",22905304,2,9,0,126,29,34,5
"c33c17be71ae4d588da7369472e5bb1b","c33c17be71ae4d588da7369472e5bb1b",22905304,4,0,1,127,34,34,0
"c33c17be71ae4d588da7369472e5bb1b","93679be414554a11b1893002f2229a93",22905304,3,3,0,128,34,35,1
"93679be414554a11b1893002f2229a93","7040a13096d746ac84b8fac8d9752058",22905304,2,3,0,129,35,36,1
"7040a13096d746ac84b8fac8d9752058","93679be414554a11b1893002f2229a93",22905304,1,-3,0,130,36,35,-1
"93679be414554a11b1893002f2229a93","9a0dc646f934470daf08c4b56ccf73db",22905304,1,6,0,131,35,37,2
"9a0dc646f934470daf08c4b56ccf73db","7040a13096d746ac84b8fac8d9752058",22905304,1,-3,0,132,37,36,-1
"7040a13096d746ac84b8fac8d9752058","9a0dc646f934470daf08c4b56ccf73db",22905304,2,3,0,133,36,37,1
"9a0dc646f934470daf08c4b56ccf73db","fc0e049d56024bc9a02c9a9c435c3df7",22905304,2,3,0,134,37,38,1
"fc0e049d56024bc9a02c9a9c435c3df7","fc0e049d56024bc9a02c9a9c435c3df7",22905304,2,0,1,135,38,38,0
"fc0e049d56024bc9a02c9a9c435c3df7","67a089198fcb4e1c8f2385786c2b296f",22905304,2,4,0,136,38,39,1
"64d48c6c9c7940639a932219a6c87198","64d48c6c9c7940639a932219a6c87198",22905304,4,0,1,138,40,40,0
"64d48c6c9c7940639a932219a6c87198","67a089198fcb4e1c8f2385786c2b296f",22905304,3,-1,0,142,40,39,-1
"67a089198fcb4e1c8f2385786c2b296f","b534b89233134e30a9b5645138bfa9ee",22905304,1,4,0,143,39,41,2
"b534b89233134e30a9b5645138bfa9ee","0e37b720d23b4e7f8b313e79313fd107",22905304,1,3,0,144,41,44,3
"0e37b720d23b4e7f8b313e79313fd107","0e37b720d23b4e7f8b313e79313fd107",22905304,1,0,1,145,44,44,0
"0e37b720d23b4e7f8b313e79313fd107","6875d67fdd5f48168b62719df449bebd",22905304,1,1,0,146,44,45,1
"6875d67fdd5f48168b62719df449bebd","6875d67fdd5f48168b62719df449bebd",22905304,1,0,1,147,45,45,0
"6875d67fdd5f48168b62719df449bebd","6e13d61a7bdb44bca949c9f86fab3be5",22905304,1,3,0,148,45,47,2
"6e13d61a7bdb44bca949c9f86fab3be5","b534b89233134e30a9b5645138bfa9ee",22905304,1,-7,0,149,47,41,-6
"b534b89233134e30a9b5645138bfa9ee","6e13d61a7bdb44bca949c9f86fab3be5",22905304,1,7,0,150,41,47,6
"6e13d61a7bdb44bca949c9f86fab3be5","6e13d61a7bdb44bca949c9f86fab3be5",22905304,7,0,1,151,47,47,0
"6e13d61a7bdb44bca949c9f86fab3be5","d9c8d8c444a64dadbbb508652c721e17",22905304,1,-1,0,153,47,46,-1
"d9c8d8c444a64dadbbb508652c721e17","d0c74f735e024943943e40333d6d337f",22905304,2,6,0,154,46,51,5
"d0c74f735e024943943e40333d6d337f","f924752d8a1149668870b1e7698486f7",22905304,1,-1,0,155,51,50,-1
"f924752d8a1149668870b1e7698486f7","6e13d61a7bdb44bca949c9f86fab3be5",22905304,1,-4,0,156,50,47,-3
"6e13d61a7bdb44bca949c9f86fab3be5","195f78799f984cc2b06c48dfe36be751",22905304,1,2,0,157,47,49,2
"195f78799f984cc2b06c48dfe36be751","195f78799f984cc2b06c48dfe36be751",22905304,2,0,1,158,49,49,0
"195f78799f984cc2b06c48dfe36be751","d9c8d8c444a64dadbbb508652c721e17",22905304,1,-3,0,160,49,46,-3
"d0c74f735e024943943e40333d6d337f","d0c74f735e024943943e40333d6d337f",22905304,1,0,1,162,51,51,0
"d0c74f735e024943943e40333d6d337f","983f8ff320594b279a7f4a6fe132f9c5",22905304,1,2,0,163,51,53,2
"983f8ff320594b279a7f4a6fe132f9c5","983f8ff320594b279a7f4a6fe132f9c5",22905304,2,0,1,164,53,53,0
"983f8ff320594b279a7f4a6fe132f9c5","35adfa5d923046aebabfefd98f35ff05",22905304,1,1,0,166,53,54,1
"35adfa5d923046aebabfefd98f35ff05","35adfa5d923046aebabfefd98f35ff05",22905304,2,0,1,167,54,54,0
"35adfa5d923046aebabfefd98f35ff05","b6f8a98476224da1b40e555ececc7ed8",22905304,1,1,0,169,54,55,1
"b6f8a98476224da1b40e555ececc7ed8","b6f8a98476224da1b40e555ececc7ed8",22905304,2,0,1,170,55,55,0
"b6f8a98476224da1b40e555ececc7ed8","86e22cb5fe0e4b47a9489ecddf7ed78f",22905304,1,1,0,172,55,56,1
"86e22cb5fe0e4b47a9489ecddf7ed78f","86e22cb5fe0e4b47a9489ecddf7ed78f",22905304,2,0,1,173,56,56,0
"86e22cb5fe0e4b47a9489ecddf7ed78f","f924752d8a1149668870b1e7698486f7",22905304,1,-6,0,175,56,50,-6
"f924752d8a1149668870b1e7698486f7","a1f2f12debe5432fb7a70bcd12bacfb9",22905304,1,9,0,176,50,58,8
"a1f2f12debe5432fb7a70bcd12bacfb9","78f30e4dcac84e3cbea8b2cc6e0d62b3",22905304,2,1,0,177,58,59,1
"78f30e4dcac84e3cbea8b2cc6e0d62b3","12aa6e1672ac4e7aa6449a7a8609cd72",22905304,2,-2,0,178,59,57,-2
"12aa6e1672ac4e7aa6449a7a8609cd72","6e13d61a7bdb44bca949c9f86fab3be5",22905304,1,-12,0,179,57,47,-10
"6e13d61a7bdb44bca949c9f86fab3be5","d0c74f735e024943943e40333d6d337f",22905304,1,5,0,185,47,51,4
"d0c74f735e024943943e40333d6d337f","d9c8d8c444a64dadbbb508652c721e17",22905304,1,-6,0,186,51,46,-5
"d9c8d8c444a64dadbbb508652c721e17","a1f2f12debe5432fb7a70bcd12bacfb9",22905304,1,14,0,187,46,58,12
"a1f2f12debe5432fb7a70bcd12bacfb9","f924752d8a1149668870b1e7698486f7",22905304,1,-9,0,188,58,50,-8
"f924752d8a1149668870b1e7698486f7","78f30e4dcac84e3cbea8b2cc6e0d62b3",22905304,1,10,0,189,50,59,9
"78f30e4dcac84e3cbea8b2cc6e0d62b3","a1f2f12debe5432fb7a70bcd12bacfb9",22905304,1,-1,0,190,59,58,-1
"a1f2f12debe5432fb7a70bcd12bacfb9","a1f2f12debe5432fb7a70bcd12bacfb9",22905304,11,0,1,191,58,58,0
"78f30e4dcac84e3cbea8b2cc6e0d62b3","78f30e4dcac84e3cbea8b2cc6e0d62b3",22905304,7,0,1,203,59,59,0
"12aa6e1672ac4e7aa6449a7a8609cd72","bc42d26810654ea9a1df1efe1e58c7d5",22905304,1,7,0,211,57,63,6
"bc42d26810654ea9a1df1efe1e58c7d5","a0a418b8540d479fa6e0f653b701da8b",22905304,4,1,0,212,63,64,1
"a0a418b8540d479fa6e0f653b701da8b","309ccf3cc4fe429d9bfbaef53d3fa479",22905304,3,-4,0,213,64,60,-4
"309ccf3cc4fe429d9bfbaef53d3fa479","b534b89233134e30a9b5645138bfa9ee",22905304,1,-23,0,214,60,41,-19
"b534b89233134e30a9b5645138bfa9ee","a0a418b8540d479fa6e0f653b701da8b",22905304,1,27,0,215,41,64,23
"a0a418b8540d479fa6e0f653b701da8b","bc42d26810654ea9a1df1efe1e58c7d5",22905304,2,-1,0,216,64,63,-1
"bc42d26810654ea9a1df1efe1e58c7d5","4c943503763e4e349906eea3ed3c8e86",22905304,1,-2,0,217,63,61,-2
"4c943503763e4e349906eea3ed3c8e86","4c943503763e4e349906eea3ed3c8e86",22905304,1,0,1,218,61,61,0
"4c943503763e4e349906eea3ed3c8e86","bc42d26810654ea9a1df1efe1e58c7d5",22905304,1,2,0,219,61,63,2
"bc42d26810654ea9a1df1efe1e58c7d5","bc42d26810654ea9a1df1efe1e58c7d5",22905304,4,0,1,220,63,63,0
"a0a418b8540d479fa6e0f653b701da8b","a0a418b8540d479fa6e0f653b701da8b",22905304,4,0,1,224,64,64,0
"309ccf3cc4fe429d9bfbaef53d3fa479","7af822066add4e7f8e007e4eee31a8bf",22905304,1,6,0,228,60,65,5
"7af822066add4e7f8e007e4eee31a8bf","bc42d26810654ea9a1df1efe1e58c7d5",22905304,1,-3,0,229,65,63,-2
"309ccf3cc4fe429d9bfbaef53d3fa479","d646286c8051419bbc2e31dd1db55ca8",22905304,1,10,0,236,60,67,7
"d646286c8051419bbc2e31dd1db55ca8","b534b89233134e30a9b5645138bfa9ee",22905304,1,-33,0,237,67,41,-26
"b534b89233134e30a9b5645138bfa9ee","267f883678b24aed855fde42524975d9",22905304,1,37,0,238,41,71,30
"267f883678b24aed855fde42524975d9","267f883678b24aed855fde42524975d9",22905304,1,0,1,239,71,71,0
"267f883678b24aed855fde42524975d9","88fff56d0342490dbef9040750a20f6c",22905304,1,1,0,240,71,72,1
"88fff56d0342490dbef9040750a20f6c","88fff56d0342490dbef9040750a20f6c",22905304,1,0,1,241,72,72,0
"88fff56d0342490dbef9040750a20f6c","adb17b12b66c4a49a85fd34322f7df70",22905304,1,1,0,242,72,73,1
"adb17b12b66c4a49a85fd34322f7df70","adb17b12b66c4a49a85fd34322f7df70",22905304,1,0,1,243,73,73,0
"adb17b12b66c4a49a85fd34322f7df70","d646286c8051419bbc2e31dd1db55ca8",22905304,1,-6,0,244,73,67,-6
"d646286c8051419bbc2e31dd1db55ca8","a2becd407db34b189200a32546d9d569",22905304,1,9,0,245,67,75,8
"a2becd407db34b189200a32546d9d569","a2becd407db34b189200a32546d9d569",22905304,5,0,1,246,75,75,0
"a2becd407db34b189200a32546d9d569","58c22b011d0f4c2ea6d13615edbb9eeb",22905304,1,2,0,250,75,77,2
"58c22b011d0f4c2ea6d13615edbb9eeb","58c22b011d0f4c2ea6d13615edbb9eeb",22905304,5,0,1,251,77,77,0
"58c22b011d0f4c2ea6d13615edbb9eeb","dd76e1861dc9461c830888729d091ee0",22905304,1,1,0,256,77,78,1
"dd76e1861dc9461c830888729d091ee0","dd76e1861dc9461c830888729d091ee0",22905304,8,0,1,257,78,78,0
"dd76e1861dc9461c830888729d091ee0","cd1d828f1a694b87913a7ea66c23803e",22905304,1,1,0,265,78,79,1
"cd1d828f1a694b87913a7ea66c23803e","cd1d828f1a694b87913a7ea66c23803e",22905304,2,0,1,266,79,79,0
"cd1d828f1a694b87913a7ea66c23803e","9176a3c2b4d2465fa8b0c67096c2a97e",22905304,1,1,0,268,79,80,1
"9176a3c2b4d2465fa8b0c67096c2a97e","9176a3c2b4d2465fa8b0c67096c2a97e",22905304,5,0,1,269,80,80,0
"9176a3c2b4d2465fa8b0c67096c2a97e","f8ec6445f7194e25b9101d4fbcb07a18",22905304,1,1,0,274,80,81,1
"f8ec6445f7194e25b9101d4fbcb07a18","f8ec6445f7194e25b9101d4fbcb07a18",22905304,2,0,1,275,81,81,0
"f8ec6445f7194e25b9101d4fbcb07a18","140d5b27b8574befad82c0a013b59dfa",22905304,1,-7,0,277,81,74,-7
"140d5b27b8574befad82c0a013b59dfa","d18a9ea32855445f8736581f5cb119ce",22905304,2,9,0,278,74,82,8
"d18a9ea32855445f8736581f5cb119ce","ae5ac430ea254e708a6f5deaaf7464ae",22905304,1,3,0,279,82,84,2
"ae5ac430ea254e708a6f5deaaf7464ae","d18a9ea32855445f8736581f5cb119ce",22905304,1,-3,0,280,84,82,-2
"d18a9ea32855445f8736581f5cb119ce","a2becd407db34b189200a32546d9d569",22905304,1,-8,0,281,82,75,-7
"a2becd407db34b189200a32546d9d569","140d5b27b8574befad82c0a013b59dfa",22905304,1,-1,0,283,75,74,-1
"d18a9ea32855445f8736581f5cb119ce","f564483cbd7a407681aa2fcca518cf5f",22905304,1,4,0,285,82,85,3
"f564483cbd7a407681aa2fcca518cf5f","f564483cbd7a407681aa2fcca518cf5f",22905304,1,0,1,286,85,85,0
"f564483cbd7a407681aa2fcca518cf5f","18fd01350bd5434ca636d59a599d768a",22905304,1,1,0,287,85,86,1
"18fd01350bd5434ca636d59a599d768a","18fd01350bd5434ca636d59a599d768a",22905304,8,0,1,288,86,86,0
"18fd01350bd5434ca636d59a599d768a","6a9f0ef185fb47f0937e29daa1c71ed5",22905304,1,5,0,296,86,90,4
"6a9f0ef185fb47f0937e29daa1c71ed5","ae5ac430ea254e708a6f5deaaf7464ae",22905304,1,-7,0,297,90,84,-6
"ae5ac430ea254e708a6f5deaaf7464ae","c681290961c94c4caf23b529d1ae6b9a",22905304,1,5,0,298,84,88,4
"c681290961c94c4caf23b529d1ae6b9a","c681290961c94c4caf23b529d1ae6b9a",22905304,1,0,1,299,88,88,0
"c681290961c94c4caf23b529d1ae6b9a","6a9f0ef185fb47f0937e29daa1c71ed5",22905304,1,2,0,300,88,90,2
"6a9f0ef185fb47f0937e29daa1c71ed5","6a9f0ef185fb47f0937e29daa1c71ed5",22905304,3,0,1,301,90,90,0
"6a9f0ef185fb47f0937e29daa1c71ed5","e20db35ced8544ddac5bc3839145e463",22905304,1,3,0,304,90,91,1
"e20db35ced8544ddac5bc3839145e463","d646286c8051419bbc2e31dd1db55ca8",22905304,1,-30,0,305,91,67,-24
"d646286c8051419bbc2e31dd1db55ca8","e20db35ced8544ddac5bc3839145e463",22905304,1,30,0,306,67,91,24
"e20db35ced8544ddac5bc3839145e463","1febb706d7a34005ae8711ed49c76e64",22905304,1,3,0,307,91,94,3
"1febb706d7a34005ae8711ed49c76e64","1febb706d7a34005ae8711ed49c76e64",22905304,2,0,1,308,94,94,0
"1febb706d7a34005ae8711ed49c76e64","8f73ba6f5a0042f2850356ac38ac6f24",22905304,1,1,0,310,94,95,1
"8f73ba6f5a0042f2850356ac38ac6f24","8f73ba6f5a0042f2850356ac38ac6f24",22905304,5,0,1,311,95,95,0
"8f73ba6f5a0042f2850356ac38ac6f24","e2260b86653c46d7b14a41fb419dbf8c",22905304,1,1,0,316,95,96,1
"e2260b86653c46d7b14a41fb419dbf8c","e2260b86653c46d7b14a41fb419dbf8c",22905304,2,0,1,317,96,96,0
"e2260b86653c46d7b14a41fb419dbf8c","35eb641ad1d845bbba54915bce75a962",22905304,1,1,0,319,96,97,1
"35eb641ad1d845bbba54915bce75a962","35eb641ad1d845bbba54915bce75a962",22905304,2,0,1,320,97,97,0
"35eb641ad1d845bbba54915bce75a962","08be90ffbeea4795a138cd42ed8db56f",22905304,1,1,0,322,97,98,1
"08be90ffbeea4795a138cd42ed8db56f","08be90ffbeea4795a138cd42ed8db56f",22905304,5,0,1,323,98,98,0
"08be90ffbeea4795a138cd42ed8db56f","3007433c8f584dcbb5ac159c1c5f2be3",22905304,1,1,0,328,98,99,1
"3007433c8f584dcbb5ac159c1c5f2be3","3007433c8f584dcbb5ac159c1c5f2be3",22905304,5,0,1,329,99,99,0
"3007433c8f584dcbb5ac159c1c5f2be3","e20db35ced8544ddac5bc3839145e463",22905304,1,-8,0,334,99,91,-8
"e20db35ced8544ddac5bc3839145e463","00ae5f0c51874a73a41ebea838d95682",22905304,2,11,0,335,91,101,10
"00ae5f0c51874a73a41ebea838d95682","d391c8b6e56a43a7b654e9dee02d904b",22905304,3,2,0,336,101,103,2
"d391c8b6e56a43a7b654e9dee02d904b","00ae5f0c51874a73a41ebea838d95682",22905304,1,-2,0,337,103,101,-2
"00ae5f0c51874a73a41ebea838d95682","00ae5f0c51874a73a41ebea838d95682",22905304,3,0,1,338,101,101,0
"00ae5f0c51874a73a41ebea838d95682","73039f8c1eb9409cb4caee2cf968001e",22905304,1,-1,0,341,101,100,-1
"73039f8c1eb9409cb4caee2cf968001e","00ae5f0c51874a73a41ebea838d95682",22905304,1,1,0,342,100,101,1
"d391c8b6e56a43a7b654e9dee02d904b","e20db35ced8544ddac5bc3839145e463",22905304,1,-13,0,344,103,91,-12
"d391c8b6e56a43a7b654e9dee02d904b","d391c8b6e56a43a7b654e9dee02d904b",22905304,15,0,1,347,103,103,0
"d391c8b6e56a43a7b654e9dee02d904b","6111116566fc4fd9abba409322bea245",22905304,1,1,0,362,103,104,1
"6111116566fc4fd9abba409322bea245","6111116566fc4fd9abba409322bea245",22905304,2,0,1,363,104,104,0
"6111116566fc4fd9abba409322bea245","a81b2235cb9c499eb9ea8ee0a8dd9725",22905304,1,1,0,365,104,105,1
"a81b2235cb9c499eb9ea8ee0a8dd9725","a81b2235cb9c499eb9ea8ee0a8dd9725",22905304,5,0,1,366,105,105,0
"a81b2235cb9c499eb9ea8ee0a8dd9725","2d4e0ab0ef3b4d73b82c72d4621a7579",22905304,1,1,0,371,105,106,1
"2d4e0ab0ef3b4d73b82c72d4621a7579","2d4e0ab0ef3b4d73b82c72d4621a7579",22905304,2,0,1,372,106,106,0
"2d4e0ab0ef3b4d73b82c72d4621a7579","8bdebf492ebd4e62b0d522e8ab5e5197",22905304,1,1,0,374,106,107,1
"8bdebf492ebd4e62b0d522e8ab5e5197","8bdebf492ebd4e62b0d522e8ab5e5197",22905304,2,0,1,375,107,107,0
"8bdebf492ebd4e62b0d522e8ab5e5197","73039f8c1eb9409cb4caee2cf968001e",22905304,1,-7,0,377,107,100,-7
"73039f8c1eb9409cb4caee2cf968001e","4280927ec4d643238aa49c32f9e06c6c",22905304,1,10,0,378,100,109,9
"4280927ec4d643238aa49c32f9e06c6c","4280927ec4d643238aa49c32f9e06c6c",22905304,1,0,1,379,109,109,0
"4280927ec4d643238aa49c32f9e06c6c","fc44e6a5f7654430af1227838224dceb",22905304,2,2,0,380,109,111,2
"fc44e6a5f7654430af1227838224dceb","fc44e6a5f7654430af1227838224dceb",22905304,4,0,1,381,111,111,0
"fc44e6a5f7654430af1227838224dceb","08111f75e22d409998cf8b85bd431f0a",22905304,2,-3,0,383,111,108,-3
"08111f75e22d409998cf8b85bd431f0a","a9ae0a3c070d455bb4369a8996313336",22905304,3,7,0,384,108,114,6
"a9ae0a3c070d455bb4369a8996313336","a9ae0a3c070d455bb4369a8996313336",22905304,1,0,1,385,114,114,0
"a9ae0a3c070d455bb4369a8996313336","71cec822bcff4f30a20e75dc63ef7b65",22905304,1,2,0,386,114,116,2
"71cec822bcff4f30a20e75dc63ef7b65","71cec822bcff4f30a20e75dc63ef7b65",22905304,1,0,1,387,116,116,0
"71cec822bcff4f30a20e75dc63ef7b65","62bff51286ef4f348717a3cf6fe2318f",22905304,1,5,0,388,116,120,4
"62bff51286ef4f348717a3cf6fe2318f","37319e88176d4aefa91d7a9980dbae91",22905304,1,-9,0,389,120,112,-8
"37319e88176d4aefa91d7a9980dbae91","62bff51286ef4f348717a3cf6fe2318f",22905304,2,9,0,390,112,120,8
"62bff51286ef4f348717a3cf6fe2318f","62bff51286ef4f348717a3cf6fe2318f",22905304,5,0,1,391,120,120,0
"62bff51286ef4f348717a3cf6fe2318f","b1cd0e7dc3ad4a8eb91a4bfdbeb025b0",22905304,1,-2,0,394,120,118,-2
"b1cd0e7dc3ad4a8eb91a4bfdbeb025b0","b1cd0e7dc3ad4a8eb91a4bfdbeb025b0",22905304,1,0,1,395,118,118,0
"b1cd0e7dc3ad4a8eb91a4bfdbeb025b0","e20db35ced8544ddac5bc3839145e463",22905304,1,-31,0,396,118,91,-27
"e20db35ced8544ddac5bc3839145e463","779f9ddd1fd14d1e9e69f72219a1fdbd",22905304,1,36,0,397,91,121,30
"779f9ddd1fd14d1e9e69f72219a1fdbd","779f9ddd1fd14d1e9e69f72219a1fdbd",22905304,1,0,1,398,121,121,0
"779f9ddd1fd14d1e9e69f72219a1fdbd","ae26e6cda8ad4a3f81bd347560d9579f",22905304,1,4,0,399,121,125,4
"ae26e6cda8ad4a3f81bd347560d9579f","ae26e6cda8ad4a3f81bd347560d9579f",22905304,1,0,1,400,125,125,0
"ae26e6cda8ad4a3f81bd347560d9579f","ee48df95832b4374aa273ceb27ec1315",22905304,1,1,0,401,125,126,1
"ee48df95832b4374aa273ceb27ec1315","ee48df95832b4374aa273ceb27ec1315",22905304,1,0,1,402,126,126,0
"ee48df95832b4374aa273ceb27ec1315","7a439da90b394756ad1777fc4c6dead5",22905304,1,1,0,403,126,127,1
"7a439da90b394756ad1777fc4c6dead5","7a439da90b394756ad1777fc4c6dead5",22905304,5,0,1,404,127,127,0
"7a439da90b394756ad1777fc4c6dead5","779f9ddd1fd14d1e9e69f72219a1fdbd",22905304,1,-6,0,409,127,121,-6
"779f9ddd1fd14d1e9e69f72219a1fdbd","a8dd5213034441ac92724b4e83eb0bb2",22905304,1,9,0,410,121,129,8
"a8dd5213034441ac92724b4e83eb0bb2","a8dd5213034441ac92724b4e83eb0bb2",22905304,3,0,1,411,129,129,0
"a8dd5213034441ac92724b4e83eb0bb2","8115eab6556b45f5b415c3b8c26a12e5",22905304,1,2,0,414,129,131,2
"8115eab6556b45f5b415c3b8c26a12e5","8115eab6556b45f5b415c3b8c26a12e5",22905304,2,0,1,415,131,131,0
"8115eab6556b45f5b415c3b8c26a12e5","ec34b06efd844b46a4c4818ecdb9b8f4",22905304,1,1,0,417,131,132,1
"ec34b06efd844b46a4c4818ecdb9b8f4","ec34b06efd844b46a4c4818ecdb9b8f4",22905304,2,0,1,418,132,132,0
"ec34b06efd844b46a4c4818ecdb9b8f4","c2e1c2b9eac64109b343a088584b576b",22905304,1,1,0,420,132,133,1
"c2e1c2b9eac64109b343a088584b576b","c2e1c2b9eac64109b343a088584b576b",22905304,2,0,1,421,133,133,0
"c2e1c2b9eac64109b343a088584b576b","579338175e0b4bbb8ef3b712b5d8b54e",22905304,1,-5,0,423,133,128,-5
"579338175e0b4bbb8ef3b712b5d8b54e","8bc5795d6a984a3eace4e2811e52dd4f",22905304,1,8,0,424,128,135,7
"8bc5795d6a984a3eace4e2811e52dd4f","8bc5795d6a984a3eace4e2811e52dd4f",22905304,1,0,1,425,135,135,0
"8bc5795d6a984a3eace4e2811e52dd4f","b416d47c56a742199b5d7c7f19d6503a",22905304,1,-1,0,426,135,134,-1
"b416d47c56a742199b5d7c7f19d6503a","cd4532ad48034873ba8bce2aac0c9808",22905304,1,4,0,427,134,137,3
"cd4532ad48034873ba8bce2aac0c9808","cd4532ad48034873ba8bce2aac0c9808",22905304,1,0,1,428,137,137,0
"cd4532ad48034873ba8bce2aac0c9808","779f9ddd1fd14d1e9e69f72219a1fdbd",22905304,1,-19,0,429,137,121,-16
"779f9ddd1fd14d1e9e69f72219a1fdbd","df1de691dafe4549a18a4398ee9dfaf9",22905304,1,23,0,430,121,139,18
"df1de691dafe4549a18a4398ee9dfaf9","6c5ad271a44743479bfaea29b1db8d02",22905304,3,4,0,431,139,143,4
"6c5ad271a44743479bfaea29b1db8d02","e20db35ced8544ddac5bc3839145e463",22905304,1,-63,0,432,143,91,-52
"e20db35ced8544ddac5bc3839145e463","08111f75e22d409998cf8b85bd431f0a",22905304,1,19,0,433,91,108,17
"08111f75e22d409998cf8b85bd431f0a","4280927ec4d643238aa49c32f9e06c6c",22905304,1,1,0,434,108,109,1
"4280927ec4d643238aa49c32f9e06c6c","08111f75e22d409998cf8b85bd431f0a",22905304,1,-1,0,435,109,108,-1
"a9ae0a3c070d455bb4369a8996313336","df1de691dafe4549a18a4398ee9dfaf9",22905304,1,33,0,437,114,139,25
"df1de691dafe4549a18a4398ee9dfaf9","df1de691dafe4549a18a4398ee9dfaf9",22905304,1,0,1,438,139,139,0
"6c5ad271a44743479bfaea29b1db8d02","df1de691dafe4549a18a4398ee9dfaf9",22905304,1,-4,0,440,143,139,-4
"6c5ad271a44743479bfaea29b1db8d02","6c5ad271a44743479bfaea29b1db8d02",22905304,1,0,1,442,143,143,0
"6c5ad271a44743479bfaea29b1db8d02","83d311bed5374fee83d8d67a7d9d82dc",22905304,1,1,0,443,143,144,1
"83d311bed5374fee83d8d67a7d9d82dc","83d311bed5374fee83d8d67a7d9d82dc",22905304,1,0,1,444,144,144,0
"83d311bed5374fee83d8d67a7d9d82dc","402bba41861d43acb52a5abb89e8831e",22905304,1,1,0,445,144,145,1
"402bba41861d43acb52a5abb89e8831e","402bba41861d43acb52a5abb89e8831e",22905304,2,0,1,446,145,145,0
"402bba41861d43acb52a5abb89e8831e","8aae34f5ddbb4052a709b12e6b0d40fa",22905304,1,3,0,448,145,147,2
"8aae34f5ddbb4052a709b12e6b0d40fa","df1de691dafe4549a18a4398ee9dfaf9",22905304,1,-9,0,449,147,139,-8
"df1de691dafe4549a18a4398ee9dfaf9","8aae34f5ddbb4052a709b12e6b0d40fa",22905304,1,9,0,450,139,147,8
"8aae34f5ddbb4052a709b12e6b0d40fa","645b3f0249f64f76af2e19eb4d0e55b7",22905304,1,2,0,451,147,149,2
"645b3f0249f64f76af2e19eb4d0e55b7","645b3f0249f64f76af2e19eb4d0e55b7",22905304,2,0,1,452,149,149,0
"645b3f0249f64f76af2e19eb4d0e55b7","7e7b8db5064d4369805ab370aac5ddfb",22905304,1,1,0,454,149,150,1
"7e7b8db5064d4369805ab370aac5ddfb","7e7b8db5064d4369805ab370aac5ddfb",22905304,2,0,1,455,150,150,0
"7e7b8db5064d4369805ab370aac5ddfb","8956d210ae7f41968fada86d4c979d6a",22905304,1,1,0,457,150,151,1
"8956d210ae7f41968fada86d4c979d6a","8956d210ae7f41968fada86d4c979d6a",22905304,2,0,1,458,151,151,0
"8956d210ae7f41968fada86d4c979d6a","f902b0f41b544d4dbf79664fd233648d",22905304,1,-5,0,460,151,146,-5
"f902b0f41b544d4dbf79664fd233648d","ae781e8b775e4ccd93bc800dad5c8376",22905304,1,8,0,461,146,153,7
"ae781e8b775e4ccd93bc800dad5c8376","ae781e8b775e4ccd93bc800dad5c8376",22905304,2,0,1,462,153,153,0
"ae781e8b775e4ccd93bc800dad5c8376","06882a8492d9499aa31555567f575ecb",22905304,1,1,0,464,153,154,1
"06882a8492d9499aa31555567f575ecb","06882a8492d9499aa31555567f575ecb",22905304,1,0,1,465,154,154,0
"06882a8492d9499aa31555567f575ecb","f293c508f409466a8f27ddd7d1e40b20",22905304,1,1,0,466,154,155,1
"f293c508f409466a8f27ddd7d1e40b20","f293c508f409466a8f27ddd7d1e40b20",22905304,5,0,1,467,155,155,0
"f293c508f409466a8f27ddd7d1e40b20","cc4ddef5bbbe48ebb605141b347c4ed1",22905304,1,1,0,472,155,156,1
"cc4ddef5bbbe48ebb605141b347c4ed1","cc4ddef5bbbe48ebb605141b347c4ed1",22905304,1,0,1,473,156,156,0
"cc4ddef5bbbe48ebb605141b347c4ed1","f03480cf4eba413194d7af52fc0e7f28",22905304,1,-4,0,474,156,152,-4
"f03480cf4eba413194d7af52fc0e7f28","d313cec988a84645bee413e8d4724a4b",22905304,1,7,0,475,152,158,6
"d313cec988a84645bee413e8d4724a4b","d313cec988a84645bee413e8d4724a4b",22905304,4,0,1,476,158,158,0
"d313cec988a84645bee413e8d4724a4b","dc60696c76a74368a60f72246e47700d",22905304,1,1,0,480,158,159,1
"dc60696c76a74368a60f72246e47700d","dc60696c76a74368a60f72246e47700d",22905304,1,0,1,481,159,159,0
"dc60696c76a74368a60f72246e47700d","df1de691dafe4549a18a4398ee9dfaf9",22905304,1,-23,0,482,159,139,-20
"df1de691dafe4549a18a4398ee9dfaf9","78adeee1fa2c4fe0bc73f7bca9fcee86",22905304,1,26,0,483,139,160,21
"78adeee1fa2c4fe0bc73f7bca9fcee86","78adeee1fa2c4fe0bc73f7bca9fcee86",22905304,1,0,1,484,160,160,0
"78adeee1fa2c4fe0bc73f7bca9fcee86","65202579580f4ad38d734b4ee39d22a8",22905304,3,5,0,485,160,164,4
"65202579580f4ad38d734b4ee39d22a8","65202579580f4ad38d734b4ee39d22a8",22905304,75,0,1,486,164,164,0
"65202579580f4ad38d734b4ee39d22a8","08111f75e22d409998cf8b85bd431f0a",22905304,1,-71,0,493,164,108,-56
"08111f75e22d409998cf8b85bd431f0a","e20db35ced8544ddac5bc3839145e463",22905304,1,-19,0,494,108,91,-17
"e20db35ced8544ddac5bc3839145e463","4280927ec4d643238aa49c32f9e06c6c",22905304,1,20,0,495,91,109,18
"a9ae0a3c070d455bb4369a8996313336","37319e88176d4aefa91d7a9980dbae91",22905304,1,-2,0,501,114,112,-2
"62bff51286ef4f348717a3cf6fe2318f","779f9ddd1fd14d1e9e69f72219a1fdbd",22905304,1,3,0,505,120,121,1
"779f9ddd1fd14d1e9e69f72219a1fdbd","e20db35ced8544ddac5bc3839145e463",22905304,1,-36,0,506,121,91,-30
"e20db35ced8544ddac5bc3839145e463","78adeee1fa2c4fe0bc73f7bca9fcee86",22905304,1,85,0,507,91,160,69
"65202579580f4ad38d734b4ee39d22a8","78adeee1fa2c4fe0bc73f7bca9fcee86",22905304,1,-5,0,529,164,160,-4
"78adeee1fa2c4fe0bc73f7bca9fcee86","3cbcea2be0984e7dbd5a48195af10ce7",22905304,3,8,0,530,160,165,5
"3cbcea2be0984e7dbd5a48195af10ce7","82e6285962b8400d9d6fc32436022a94",22905304,4,2,0,531,165,167,2
"82e6285962b8400d9d6fc32436022a94","3cbcea2be0984e7dbd5a48195af10ce7",22905304,3,-2,0,532,167,165,-2
"3cbcea2be0984e7dbd5a48195af10ce7","a9ac840f098c4bd0a2ee896214ce29cd",22905304,3,5,0,533,165,168,3
"a9ac840f098c4bd0a2ee896214ce29cd","a9ac840f098c4bd0a2ee896214ce29cd",22905304,5,0,1,534,168,168,0
"a9ac840f098c4bd0a2ee896214ce29cd","3cbcea2be0984e7dbd5a48195af10ce7",22905304,4,-5,0,537,168,165,-3
"82e6285962b8400d9d6fc32436022a94","78adeee1fa2c4fe0bc73f7bca9fcee86",22905304,1,-10,0,539,167,160,-7
"3cbcea2be0984e7dbd5a48195af10ce7","78adeee1fa2c4fe0bc73f7bca9fcee86",22905304,3,-8,0,541,165,160,-5
"3cbcea2be0984e7dbd5a48195af10ce7","65202579580f4ad38d734b4ee39d22a8",22905304,1,-3,0,543,165,164,-1
"65202579580f4ad38d734b4ee39d22a8","a9ac840f098c4bd0a2ee896214ce29cd",22905304,1,8,0,552,164,168,4
"65202579580f4ad38d734b4ee39d22a8","3cbcea2be0984e7dbd5a48195af10ce7",22905304,1,3,0,599,164,165,1
"78adeee1fa2c4fe0bc73f7bca9fcee86","82e6285962b8400d9d6fc32436022a94",22905304,1,10,0,601,160,167,7
"82e6285962b8400d9d6fc32436022a94","a9ac840f098c4bd0a2ee896214ce29cd",22905304,1,3,0,602,167,168,1
"a9ac840f098c4bd0a2ee896214ce29cd","0c7262dff33c4087bc660ccf40f92f9c",22905304,1,4,0,610,168,169,1
"0c7262dff33c4087bc660ccf40f92f9c","b2275c3fad834f8d90737a2d9a6927d6",22905304,3,3,0,611,169,172,3
"b2275c3fad834f8d90737a2d9a6927d6","5c5ceeee4562457ba6d41515aeebfbb1",22905304,1,-219,0,612,172,17,-155
"56586aa865414f538729c7f7735d2bc6","c33c17be71ae4d588da7369472e5bb1b",22905304,1,41,0,617,12,34,22
"93679be414554a11b1893002f2229a93","93679be414554a11b1893002f2229a93",22905304,2,0,1,621,35,35,0
"93679be414554a11b1893002f2229a93","c33c17be71ae4d588da7369472e5bb1b",22905304,1,-3,0,622,35,34,-1
"c33c17be71ae4d588da7369472e5bb1b","0c7262dff33c4087bc660ccf40f92f9c",22905304,1,185,0,623,34,169,135
"0c7262dff33c4087bc660ccf40f92f9c","0c7262dff33c4087bc660ccf40f92f9c",22905304,5,0,1,624,169,169,0
"b2275c3fad834f8d90737a2d9a6927d6","0c7262dff33c4087bc660ccf40f92f9c",22905304,1,-3,0,626,172,169,-3
"b2275c3fad834f8d90737a2d9a6927d6","b2275c3fad834f8d90737a2d9a6927d6",22905304,24,0,1,630,172,172,0
"b2275c3fad834f8d90737a2d9a6927d6","eb515a26030b41f8a82a1e6114420bad",22905304,1,1,0,654,172,173,1
"eb515a26030b41f8a82a1e6114420bad","eb515a26030b41f8a82a1e6114420bad",22905304,2,0,1,655,173,173,0
"eb515a26030b41f8a82a1e6114420bad","0c7262dff33c4087bc660ccf40f92f9c",22905304,1,-4,0,657,173,169,-4
"0c7262dff33c4087bc660ccf40f92f9c","b42cc17b7de840f181a704558d0bc845",22905304,1,7,0,658,169,175,6
"b42cc17b7de840f181a704558d0bc845","b42cc17b7de840f181a704558d0bc845",22905304,7,0,1,659,175,175,0
"b42cc17b7de840f181a704558d0bc845","801f9e9135034f49bf5f8b4bdefedb41",22905304,1,2,0,666,175,177,2
"801f9e9135034f49bf5f8b4bdefedb41","801f9e9135034f49bf5f8b4bdefedb41",22905304,4,0,1,667,177,177,0
"801f9e9135034f49bf5f8b4bdefedb41","362fcb0699a14845ab29b2340093e528",22905304,1,-3,0,671,177,174,-3
"362fcb0699a14845ab29b2340093e528","ea38cc0e6e6e41edbabf210220808bf9",22905304,1,6,0,672,174,179,5
"ea38cc0e6e6e41edbabf210220808bf9","b87c552dd247427abe6ab5795b9c9d43",22905304,2,2,0,673,179,181,2
"b87c552dd247427abe6ab5795b9c9d43","ea38cc0e6e6e41edbabf210220808bf9",22905304,1,-2,0,674,181,179,-2
"ea38cc0e6e6e41edbabf210220808bf9","ea38cc0e6e6e41edbabf210220808bf9",22905304,4,0,1,675,179,179,0
"b87c552dd247427abe6ab5795b9c9d43","b87c552dd247427abe6ab5795b9c9d43",22905304,7,0,1,680,181,181,0
"b87c552dd247427abe6ab5795b9c9d43","139b097acfca451689d80c9c6eebdf7b",22905304,1,-3,0,687,181,178,-3
"139b097acfca451689d80c9c6eebdf7b","30f660a1feb34582a739722532524f79",22905304,1,6,0,688,178,183,5
"30f660a1feb34582a739722532524f79","30f660a1feb34582a739722532524f79",22905304,5,0,1,689,183,183,0
"30f660a1feb34582a739722532524f79","2024b4885bd14338a39b7b509acbbd02",22905304,1,-1,0,694,183,182,-1
"2024b4885bd14338a39b7b509acbbd02","c3f63fe50d8e487c86bf8ef76c9cadd3",22905304,1,4,0,695,182,185,3
"c3f63fe50d8e487c86bf8ef76c9cadd3","c3f63fe50d8e487c86bf8ef76c9cadd3",22905304,1,0,1,696,185,185,0
"c3f63fe50d8e487c86bf8ef76c9cadd3","c8e371568a0c4391b25796ae4e91952e",22905304,1,3,0,697,185,186,1
"c8e371568a0c4391b25796ae4e91952e","0c7262dff33c4087bc660ccf40f92f9c",22905304,3,-23,0,698,186,169,-17
"0c7262dff33c4087bc660ccf40f92f9c","c8e371568a0c4391b25796ae4e91952e",22905304,3,23,0,699,169,186,17
"c8e371568a0c4391b25796ae4e91952e","07b44a7a51e94c78b411c753fc39dab0",22905304,1,4,0,700,186,189,3
"07b44a7a51e94c78b411c753fc39dab0","ab11d94c6c8948ea90b88f19d2cd502b",22905304,1,1,0,701,189,190,1
"ab11d94c6c8948ea90b88f19d2cd502b","07b44a7a51e94c78b411c753fc39dab0",22905304,1,-1,0,702,190,189,-1
"07b44a7a51e94c78b411c753fc39dab0","c8e371568a0c4391b25796ae4e91952e",22905304,1,-4,0,703,189,186,-3
"c8e371568a0c4391b25796ae4e91952e","c8e371568a0c4391b25796ae4e91952e",22905304,1,0,1,707,186,186,0
"c8e371568a0c4391b25796ae4e91952e","7d932b23e1c84326ae5aa4d3c0d813d1",22905304,1,2,0,711,186,188,2
"7d932b23e1c84326ae5aa4d3c0d813d1","7d932b23e1c84326ae5aa4d3c0d813d1",22905304,1,0,1,712,188,188,0
"7d932b23e1c84326ae5aa4d3c0d813d1","c8e371568a0c4391b25796ae4e91952e",22905304,1,-2,0,713,188,186,-2
"c8e371568a0c4391b25796ae4e91952e","ab11d94c6c8948ea90b88f19d2cd502b",22905304,1,5,0,714,186,190,4
"ab11d94c6c8948ea90b88f19d2cd502b","ab11d94c6c8948ea90b88f19d2cd502b",22905304,1,0,1,715,190,190,0
"ab11d94c6c8948ea90b88f19d2cd502b","f992451ed6ad4e68bb9e68ad6be7c4be",22905304,1,2,0,716,190,192,2
"f992451ed6ad4e68bb9e68ad6be7c4be","f992451ed6ad4e68bb9e68ad6be7c4be",22905304,1,0,1,717,192,192,0
"f992451ed6ad4e68bb9e68ad6be7c4be","6cd2dcaac46847d4a0bc53f296d90375",22905304,1,3,0,718,192,194,2
"6cd2dcaac46847d4a0bc53f296d90375","07b44a7a51e94c78b411c753fc39dab0",22905304,1,-6,0,719,194,189,-5
"07b44a7a51e94c78b411c753fc39dab0","6cd2dcaac46847d4a0bc53f296d90375",22905304,1,6,0,720,189,194,5
"6cd2dcaac46847d4a0bc53f296d90375","6cd2dcaac46847d4a0bc53f296d90375",22905304,2,0,1,721,194,194,0
"6cd2dcaac46847d4a0bc53f296d90375","2d2580c9411c4972909db508d6956a58",22905304,1,2,0,723,194,196,2
"2d2580c9411c4972909db508d6956a58","2d2580c9411c4972909db508d6956a58",22905304,2,0,1,724,196,196,0
"2d2580c9411c4972909db508d6956a58","5bddb3d9ed264f3984702f048c7e5340",22905304,1,1,0,726,196,197,1
"5bddb3d9ed264f3984702f048c7e5340","5bddb3d9ed264f3984702f048c7e5340",22905304,2,0,1,727,197,197,0
"5bddb3d9ed264f3984702f048c7e5340","d5e8e2bd12a2466b9d6d90855f0eb079",22905304,1,1,0,729,197,198,1
"d5e8e2bd12a2466b9d6d90855f0eb079","d5e8e2bd12a2466b9d6d90855f0eb079",22905304,2,0,1,730,198,198,0
"d5e8e2bd12a2466b9d6d90855f0eb079","017d7ca8e0394b91aaadc9574df2202c",22905304,1,-5,0,732,198,193,-5
"017d7ca8e0394b91aaadc9574df2202c","54e8e9f0ea3e45c4bf3b8ac799ee31b1",22905304,1,8,0,733,193,200,7
"54e8e9f0ea3e45c4bf3b8ac799ee31b1","54e8e9f0ea3e45c4bf3b8ac799ee31b1",22905304,1,0,1,734,200,200,0
"54e8e9f0ea3e45c4bf3b8ac799ee31b1","c614a00911be4877a075f19315530fb0",22905304,1,1,0,735,200,201,1
"c614a00911be4877a075f19315530fb0","c614a00911be4877a075f19315530fb0",22905304,6,0,1,736,201,201,0
"c614a00911be4877a075f19315530fb0","bb329d880ab54120adaf203a693bb203",22905304,1,2,0,742,201,203,2
"bb329d880ab54120adaf203a693bb203","bb329d880ab54120adaf203a693bb203",22905304,1,0,1,743,203,203,0
"bb329d880ab54120adaf203a693bb203","a6c21bd8b95249c7972820a7a7d76aff",22905304,1,-1,0,744,203,202,-1
"a6c21bd8b95249c7972820a7a7d76aff","a6c21bd8b95249c7972820a7a7d76aff",22905304,1,0,1,745,202,202,0
"a6c21bd8b95249c7972820a7a7d76aff","f9170dd6bc6442b4acd832747609b09a",22905304,1,-3,0,746,202,199,-3
"f9170dd6bc6442b4acd832747609b09a","334c2344009840079b1d0e1b7ce3d5a7",22905304,1,7,0,747,199,205,6
"334c2344009840079b1d0e1b7ce3d5a7","334c2344009840079b1d0e1b7ce3d5a7",22905304,1,0,1,748,205,205,0
"334c2344009840079b1d0e1b7ce3d5a7","c8e371568a0c4391b25796ae4e91952e",22905304,1,-23,0,749,205,186,-19
"c8e371568a0c4391b25796ae4e91952e","d7f13c8d63ec4e2aa673fbb9cf9c6933",22905304,1,26,0,750,186,206,20
"d7f13c8d63ec4e2aa673fbb9cf9c6933","b9e80f77c3a44349863b19875725c384",22905304,1,1,0,751,206,207,1
"b9e80f77c3a44349863b19875725c384","7108f0e4c2584f1f9c471689ae4c885c",22905304,2,1,0,752,207,208,1
"7108f0e4c2584f1f9c471689ae4c885c","d7f13c8d63ec4e2aa673fbb9cf9c6933",22905304,2,-2,0,753,208,206,-2
"d7f13c8d63ec4e2aa673fbb9cf9c6933","d7f13c8d63ec4e2aa673fbb9cf9c6933",22905304,1,0,1,754,206,206,0
"d7f13c8d63ec4e2aa673fbb9cf9c6933","7108f0e4c2584f1f9c471689ae4c885c",22905304,1,2,0,755,206,208,2
"7108f0e4c2584f1f9c471689ae4c885c","b9e80f77c3a44349863b19875725c384",22905304,1,-1,0,756,208,207,-1
"b9e80f77c3a44349863b19875725c384","b9e80f77c3a44349863b19875725c384",22905304,15,0,1,757,207,207,0
"7108f0e4c2584f1f9c471689ae4c885c","7108f0e4c2584f1f9c471689ae4c885c",22905304,9,0,1,773,208,208,0
"d7f13c8d63ec4e2aa673fbb9cf9c6933","09400e101c5d4b439cf9a26b03aae558",22905304,1,5,0,783,206,210,4
"09400e101c5d4b439cf9a26b03aae558","09400e101c5d4b439cf9a26b03aae558",22905304,3,0,1,784,210,210,0
"09400e101c5d4b439cf9a26b03aae558","a88efa7e50ce47159810ab553afa6d3a",22905304,1,2,0,787,210,212,2
"a88efa7e50ce47159810ab553afa6d3a","a88efa7e50ce47159810ab553afa6d3a",22905304,2,0,1,788,212,212,0
"a88efa7e50ce47159810ab553afa6d3a","a875096404ef4a9984b62d74cda916f9",22905304,1,-3,0,790,212,209,-3
"a875096404ef4a9984b62d74cda916f9","f7fb1952f56b4189b86a9f8b7862d2b8",22905304,1,7,0,791,209,215,6
"f7fb1952f56b4189b86a9f8b7862d2b8","be502a7a43c44bf7b682698de79d9369",22905304,2,-1,0,792,215,214,-1
"be502a7a43c44bf7b682698de79d9369","be502a7a43c44bf7b682698de79d9369",22905304,8,0,1,793,214,214,0
"be502a7a43c44bf7b682698de79d9369","f7fb1952f56b4189b86a9f8b7862d2b8",22905304,1,1,0,796,214,215,1
"f7fb1952f56b4189b86a9f8b7862d2b8","f7fb1952f56b4189b86a9f8b7862d2b8",22905304,14,0,1,797,215,215,0
"be502a7a43c44bf7b682698de79d9369","b860ee85d8bc4a2f97958cfb71be3533",22905304,1,2,0,817,214,216,2
"b860ee85d8bc4a2f97958cfb71be3533","b860ee85d8bc4a2f97958cfb71be3533",22905304,2,0,1,818,216,216,0
"b860ee85d8bc4a2f97958cfb71be3533","ec341f459285443b8361f7f15638ff08",22905304,1,-3,0,820,216,213,-3
"ec341f459285443b8361f7f15638ff08","363837c182e04711840d896ae1e0339c",22905304,1,6,0,821,213,218,5
"363837c182e04711840d896ae1e0339c","363837c182e04711840d896ae1e0339c",22905304,14,0,1,822,218,218,0
"363837c182e04711840d896ae1e0339c","01b2051f8941460d89945e3b02d1ce78",22905304,1,-1,0,836,218,217,-1
"01b2051f8941460d89945e3b02d1ce78","91125ca626c5470eb145501f8c37f8db",22905304,1,4,0,837,217,220,3
"91125ca626c5470eb145501f8c37f8db","91125ca626c5470eb145501f8c37f8db",22905304,1,0,1,838,220,220,0
"91125ca626c5470eb145501f8c37f8db","1c6721b1f63f4d30ba7746ea8af02a52",22905304,1,3,0,839,220,221,1
"1c6721b1f63f4d30ba7746ea8af02a52","d7f13c8d63ec4e2aa673fbb9cf9c6933",22905304,1,-21,0,840,221,206,-15
"d7f13c8d63ec4e2aa673fbb9cf9c6933","77ecef8eff6b4a2caea7707669bf7475",22905304,1,22,0,841,206,222,16
"77ecef8eff6b4a2caea7707669bf7475","77ecef8eff6b4a2caea7707669bf7475",22905304,12,0,1,842,222,222,0
"77ecef8eff6b4a2caea7707669bf7475","1c6721b1f63f4d30ba7746ea8af02a52",22905304,1,-1,0,854,222,221,-1
"1c6721b1f63f4d30ba7746ea8af02a52","8b9ae98743bd4d4a8a87dff1c1244211",22905304,1,7,0,855,221,227,6
"8b9ae98743bd4d4a8a87dff1c1244211","d03cb855c70044cf8c35d9ec0de696e3",22905304,1,-3,0,856,227,224,-3
"d03cb855c70044cf8c35d9ec0de696e3","d03cb855c70044cf8c35d9ec0de696e3",22905304,3,0,1,857,224,224,0
"d03cb855c70044cf8c35d9ec0de696e3","a49a937d6896486d9a5396654abcf2e1",22905304,1,2,0,860,224,226,2
"a49a937d6896486d9a5396654abcf2e1","a49a937d6896486d9a5396654abcf2e1",22905304,3,0,1,861,226,226,0
"a49a937d6896486d9a5396654abcf2e1","8b9ae98743bd4d4a8a87dff1c1244211",22905304,1,1,0,864,226,227,1
"8b9ae98743bd4d4a8a87dff1c1244211","8b9ae98743bd4d4a8a87dff1c1244211",22905304,22,0,1,865,227,227,0
"8b9ae98743bd4d4a8a87dff1c1244211","f7906d6f59b9489a91d2ef40db5a474d",22905304,1,-4,0,887,227,223,-4
"f7906d6f59b9489a91d2ef40db5a474d","2ab1535aac1346ba8801535bf729ef37",22905304,1,7,0,888,223,229,6
"2ab1535aac1346ba8801535bf729ef37","2ab1535aac1346ba8801535bf729ef37",22905304,2,0,1,889,229,229,0
"2ab1535aac1346ba8801535bf729ef37","a4f40fb48a8542c8949bae1f002cd9bc",22905304,1,2,0,891,229,231,2
"a4f40fb48a8542c8949bae1f002cd9bc","a4f40fb48a8542c8949bae1f002cd9bc",22905304,2,0,1,892,231,231,0
"a4f40fb48a8542c8949bae1f002cd9bc","8972c23e32044edb8a78fa1eed4e5947",22905304,1,1,0,894,231,232,1
"8972c23e32044edb8a78fa1eed4e5947","8972c23e32044edb8a78fa1eed4e5947",22905304,3,0,1,895,232,232,0
"8972c23e32044edb8a78fa1eed4e5947","92feb4a40f8344d38b6f722e42a53295",22905304,1,1,0,898,232,233,1
"92feb4a40f8344d38b6f722e42a53295","92feb4a40f8344d38b6f722e42a53295",22905304,2,0,1,899,233,233,0
"92feb4a40f8344d38b6f722e42a53295","5152833676bf4c6cb317060be10f68db",22905304,1,-5,0,901,233,228,-5
"5152833676bf4c6cb317060be10f68db","ca3e28f290354c08aefe5b0f769604e6",22905304,1,8,0,902,228,235,7
"ca3e28f290354c08aefe5b0f769604e6","ca3e28f290354c08aefe5b0f769604e6",22905304,9,0,1,903,235,235,0
"ca3e28f290354c08aefe5b0f769604e6","79a35eea833e4c2c9d22fc53c3c6445c",22905304,1,1,0,912,235,236,1
"79a35eea833e4c2c9d22fc53c3c6445c","79a35eea833e4c2c9d22fc53c3c6445c",22905304,4,0,1,913,236,236,0
"79a35eea833e4c2c9d22fc53c3c6445c","8f68228b1518449e9615cdafee41a2bd",22905304,1,1,0,917,236,237,1
"8f68228b1518449e9615cdafee41a2bd","8f68228b1518449e9615cdafee41a2bd",22905304,1,0,1,918,237,237,0
"8f68228b1518449e9615cdafee41a2bd","cab89fa5c3ed45a5aa550fc0352d6a42",22905304,1,1,0,919,237,238,1
"cab89fa5c3ed45a5aa550fc0352d6a42","cab89fa5c3ed45a5aa550fc0352d6a42",22905304,5,0,1,920,238,238,0
"cab89fa5c3ed45a5aa550fc0352d6a42","66d4fad4f1cf4b46be0750a99ad7a35a",22905304,1,1,0,925,238,239,1
"66d4fad4f1cf4b46be0750a99ad7a35a","66d4fad4f1cf4b46be0750a99ad7a35a",22905304,1,0,1,926,239,239,0
"66d4fad4f1cf4b46be0750a99ad7a35a","0b04c8e2f86d48c7aeb7e225819cd32b",22905304,1,-5,0,927,239,234,-5
"0b04c8e2f86d48c7aeb7e225819cd32b","f53da5fd9bfe412da4b80d4742563b6c",22905304,1,8,0,928,234,241,7
"f53da5fd9bfe412da4b80d4742563b6c","f53da5fd9bfe412da4b80d4742563b6c",22905304,1,0,1,929,241,241,0
"f53da5fd9bfe412da4b80d4742563b6c","1c6721b1f63f4d30ba7746ea8af02a52",22905304,1,-24,0,930,241,221,-20
"1c6721b1f63f4d30ba7746ea8af02a52","2ae94c0cea4d480a9d5dca8fb1d7b542",22905304,1,27,0,931,221,242,21
"2ae94c0cea4d480a9d5dca8fb1d7b542","1ebf23f9d994469a85206e4c7b1bf5f5",22905304,2,3,0,932,242,245,3
"1ebf23f9d994469a85206e4c7b1bf5f5","2ae94c0cea4d480a9d5dca8fb1d7b542",22905304,1,-3,0,933,245,242,-3
"1ebf23f9d994469a85206e4c7b1bf5f5","1ebf23f9d994469a85206e4c7b1bf5f5",22905304,10,0,1,935,245,245,0
"1ebf23f9d994469a85206e4c7b1bf5f5","85ae675b83e8422da842cfd25596af99",22905304,1,1,0,945,245,246,1
"85ae675b83e8422da842cfd25596af99","85ae675b83e8422da842cfd25596af99",22905304,3,0,1,946,246,246,0
"85ae675b83e8422da842cfd25596af99","2ae94c0cea4d480a9d5dca8fb1d7b542",22905304,1,-4,0,949,246,242,-4
"2ae94c0cea4d480a9d5dca8fb1d7b542","fa235f0f364d47e4ae1c87f47bf8e6ba",22905304,1,12,0,950,242,252,10
"fa235f0f364d47e4ae1c87f47bf8e6ba","fa235f0f364d47e4ae1c87f47bf8e6ba",22905304,5,0,1,951,252,252,0
"fa235f0f364d47e4ae1c87f47bf8e6ba","79f7845465cc4ed19d8e4f1429541be0",22905304,1,2,0,956,252,254,2
"79f7845465cc4ed19d8e4f1429541be0","79f7845465cc4ed19d8e4f1429541be0",22905304,2,0,1,957,254,254,0
"79f7845465cc4ed19d8e4f1429541be0","6e83e23f56544a19b94067c1c558d9c0",22905304,1,-8,0,959,254,247,-7
"6e83e23f56544a19b94067c1c558d9c0","00f61990949545828dd12f1303d47504",22905304,1,11,0,960,247,256,9
"00f61990949545828dd12f1303d47504","00f61990949545828dd12f1303d47504",22905304,4,0,1,961,256,256,0
"00f61990949545828dd12f1303d47504","ead7bb4b64e247d2ae632ab8a296b091",22905304,1,2,0,965,256,258,2
"ead7bb4b64e247d2ae632ab8a296b091","ead7bb4b64e247d2ae632ab8a296b091",22905304,2,0,1,966,258,258,0
"ead7bb4b64e247d2ae632ab8a296b091","41b0048dde734bb280bac6116baa8e27",22905304,1,1,0,968,258,259,1
"41b0048dde734bb280bac6116baa8e27","41b0048dde734bb280bac6116baa8e27",22905304,2,0,1,969,259,259,0
"41b0048dde734bb280bac6116baa8e27","b41c5a094a604ee0915327da5cc0beb7",22905304,1,1,0,971,259,260,1
"b41c5a094a604ee0915327da5cc0beb7","b41c5a094a604ee0915327da5cc0beb7",22905304,2,0,1,972,260,260,0
"b41c5a094a604ee0915327da5cc0beb7","d546341988904f069cfa86b21457d9d9",22905304,1,-10,0,974,260,251,-9
"d546341988904f069cfa86b21457d9d9","28c171777c52431ab6b925073bd63d46",22905304,1,15,0,975,251,264,13
"28c171777c52431ab6b925073bd63d46","28c171777c52431ab6b925073bd63d46",22905304,3,0,1,976,264,264,0
"28c171777c52431ab6b925073bd63d46","ac160db940cb49ae8579162b1d52bb5d",22905304,1,2,0,979,264,266,2
"ac160db940cb49ae8579162b1d52bb5d","ac160db940cb49ae8579162b1d52bb5d",22905304,3,0,1,980,266,266,0
"ac160db940cb49ae8579162b1d52bb5d","d989ebcfc12a4b669f0100dc1aa14f1e",22905304,1,-12,0,983,266,255,-11
"d989ebcfc12a4b669f0100dc1aa14f1e","c6fd49b485cc4874b0bbdd9c6171e09c",22905304,1,15,0,984,255,268,13
"c6fd49b485cc4874b0bbdd9c6171e09c","c6fd49b485cc4874b0bbdd9c6171e09c",22905304,3,0,1,985,268,268,0
"c6fd49b485cc4874b0bbdd9c6171e09c","44240778a97c4af0937817499b75707b",22905304,1,1,0,988,268,269,1
"44240778a97c4af0937817499b75707b","44240778a97c4af0937817499b75707b",22905304,2,0,1,989,269,269,0
"44240778a97c4af0937817499b75707b","7aa76d3e993840d8805f097cbdbcd44b",22905304,1,-9,0,991,269,261,-8
"7aa76d3e993840d8805f097cbdbcd44b","865a4d3b43374da7944dc7d397f566d9",22905304,1,12,0,992,261,271,10
"865a4d3b43374da7944dc7d397f566d9","865a4d3b43374da7944dc7d397f566d9",22905304,3,0,1,993,271,271,0
"865a4d3b43374da7944dc7d397f566d9","0d987bed3ffa4ed0b9a2e62e97b7b30f",22905304,1,3,0,996,271,272,1
"0d987bed3ffa4ed0b9a2e62e97b7b30f","2ae94c0cea4d480a9d5dca8fb1d7b542",22905304,1,-38,0,997,272,242,-30
"2ae94c0cea4d480a9d5dca8fb1d7b542","0d987bed3ffa4ed0b9a2e62e97b7b30f",22905304,1,38,0,998,242,272,30
"82ae07bc0c9b4570a41799290d1ef399","0d987bed3ffa4ed0b9a2e62e97b7b30f",22905304,1,-4,0,1000,275,272,-3
"0d987bed3ffa4ed0b9a2e62e97b7b30f","0d987bed3ffa4ed0b9a2e62e97b7b30f",22905304,1,0,1,1001,272,272,0
"0d987bed3ffa4ed0b9a2e62e97b7b30f","82ae07bc0c9b4570a41799290d1ef399",22905304,2,4,0,1002,272,275,3
"82ae07bc0c9b4570a41799290d1ef399","bb5a47f5ea01454a8b79455422d3b9da",22905304,1,6,0,1003,275,280,5
"bb5a47f5ea01454a8b79455422d3b9da","bb5a47f5ea01454a8b79455422d3b9da",22905304,85,0,1,1004,280,280,0
"bb5a47f5ea01454a8b79455422d3b9da","0d987bed3ffa4ed0b9a2e62e97b7b30f",22905304,3,-10,0,1011,280,272,-8
"0d987bed3ffa4ed0b9a2e62e97b7b30f","bb5a47f5ea01454a8b79455422d3b9da",22905304,2,10,0,1012,272,280,8
"0d987bed3ffa4ed0b9a2e62e97b7b30f","94cecc3f1e7d484b8e068e79241dfd73",22905304,1,13,0,1087,272,281,9
"94cecc3f1e7d484b8e068e79241dfd73","a37477c4e4c14169ad44b06b493007f6",22905304,1,2,0,1088,281,283,2
"a37477c4e4c14169ad44b06b493007f6","94cecc3f1e7d484b8e068e79241dfd73",22905304,1,-2,0,1089,283,281,-2
"94cecc3f1e7d484b8e068e79241dfd73","fab84b4fab5940efb4ea868ef8d09396",22905304,1,5,0,1090,281,284,3
"fab84b4fab5940efb4ea868ef8d09396","4a29443515bb404cb8924e1c60a63b73",22905304,1,4,0,1091,284,285,1
"4a29443515bb404cb8924e1c60a63b73","fab84b4fab5940efb4ea868ef8d09396",22905304,1,-4,0,1092,285,284,-1
"fab84b4fab5940efb4ea868ef8d09396","208c9b2796c944db8dacaa96082520ea",22905304,1,7,0,1093,284,288,4
"208c9b2796c944db8dacaa96082520ea","0d987bed3ffa4ed0b9a2e62e97b7b30f",22905304,1,-25,0,1094,288,272,-16
"0d987bed3ffa4ed0b9a2e62e97b7b30f","bc5524e78a8544e2ae2fdc2f3462bbec",22905304,1,9,0,1095,272,279,7
"bc5524e78a8544e2ae2fdc2f3462bbec","bb5a47f5ea01454a8b79455422d3b9da",22905304,1,1,0,1096,279,280,1
"bb5a47f5ea01454a8b79455422d3b9da","4a29443515bb404cb8924e1c60a63b73",22905304,1,12,0,1104,280,285,5
"4a29443515bb404cb8924e1c60a63b73","4a29443515bb404cb8924e1c60a63b73",22905304,1,0,1,1105,285,285,0
"4a29443515bb404cb8924e1c60a63b73","208c9b2796c944db8dacaa96082520ea",22905304,1,3,0,1106,285,288,3
"208c9b2796c944db8dacaa96082520ea","208c9b2796c944db8dacaa96082520ea",22905304,2,0,1,1107,288,288,0
"208c9b2796c944db8dacaa96082520ea","4a29443515bb404cb8924e1c60a63b73",22905304,1,-3,0,1109,288,285,-3
"4a29443515bb404cb8924e1c60a63b73","7669a956527947d0add87455277e80b4",22905304,1,7,0,1110,285,291,6
"7669a956527947d0add87455277e80b4","7669a956527947d0add87455277e80b4",22905304,1,0,1,1111,291,291,0
"7669a956527947d0add87455277e80b4","6a9a3b5bde4a48daa896fe8c06eca56f",22905304,1,-2,0,1112,291,289,-2
"6a9a3b5bde4a48daa896fe8c06eca56f","869e967078f04da18dd0b0b9389a7424",22905304,1,5,0,1113,289,293,4
"869e967078f04da18dd0b0b9389a7424","869e967078f04da18dd0b0b9389a7424",22905304,3,0,1,1114,293,293,0
"869e967078f04da18dd0b0b9389a7424","51ab6291537748fab90d519aa09889d6",22905304,1,2,0,1117,293,295,2
"51ab6291537748fab90d519aa09889d6","51ab6291537748fab90d519aa09889d6",22905304,5,0,1,1118,295,295,0
"51ab6291537748fab90d519aa09889d6","34a6e49023fc4465bd5ca604330bbd1c",22905304,1,-3,0,1123,295,292,-3
"34a6e49023fc4465bd5ca604330bbd1c","21592f2a9e9c4b2f8c66ec5dbcbf6a2b",22905304,1,5,0,1124,292,296,4
"21592f2a9e9c4b2f8c66ec5dbcbf6a2b","ba0e59461bfb4a44b7b1c28a01f8d3b3",22905304,1,4,0,1125,296,299,3
"ba0e59461bfb4a44b7b1c28a01f8d3b3","ba0e59461bfb4a44b7b1c28a01f8d3b3",22905304,2,0,1,1126,299,299,0
"ba0e59461bfb4a44b7b1c28a01f8d3b3","0e0b36e731a645e7b1b8a88f5031ca38",22905304,1,2,0,1128,299,301,2
"0e0b36e731a645e7b1b8a88f5031ca38","0e0b36e731a645e7b1b8a88f5031ca38",22905304,2,0,1,1129,301,301,0
"0e0b36e731a645e7b1b8a88f5031ca38","a66a144637284c21afc6de17fea4bfb8",22905304,1,1,0,1131,301,302,1
"a66a144637284c21afc6de17fea4bfb8","a66a144637284c21afc6de17fea4bfb8",22905304,2,0,1,1132,302,302,0
"a66a144637284c21afc6de17fea4bfb8","7646a919d7e64fa990bca9b024ff089d",22905304,1,-4,0,1134,302,298,-4
"7646a919d7e64fa990bca9b024ff089d","e390b575229748ea8aac9364efe2bf00",22905304,1,7,0,1135,298,304,6
"e390b575229748ea8aac9364efe2bf00","e390b575229748ea8aac9364efe2bf00",22905304,1,0,1,1136,304,304,0
"e390b575229748ea8aac9364efe2bf00","4a29443515bb404cb8924e1c60a63b73",22905304,1,-24,0,1137,304,285,-19
"4a29443515bb404cb8924e1c60a63b73","3434c10e561d488a914e0f7d71907abd",22905304,2,27,0,1138,285,305,20
"3434c10e561d488a914e0f7d71907abd","53e7e900392747ccad52e711ab0f80d8",22905304,2,2,0,1139,305,307,2
"53e7e900392747ccad52e711ab0f80d8","4a29443515bb404cb8924e1c60a63b73",22905304,1,-29,0,1140,307,285,-22
"3434c10e561d488a914e0f7d71907abd","3434c10e561d488a914e0f7d71907abd",22905304,2,0,1,1142,305,305,0
"53e7e900392747ccad52e711ab0f80d8","53e7e900392747ccad52e711ab0f80d8",22905304,2,0,1,1145,307,307,0
"53e7e900392747ccad52e711ab0f80d8","3434c10e561d488a914e0f7d71907abd",22905304,1,-2,0,1147,307,305,-2
"3434c10e561d488a914e0f7d71907abd","130acc2aeb0448fdbb2de63bc5cebe5b",22905304,1,5,0,1148,305,309,4
"130acc2aeb0448fdbb2de63bc5cebe5b","130acc2aeb0448fdbb2de63bc5cebe5b",22905304,2,0,1,1149,309,309,0
"130acc2aeb0448fdbb2de63bc5cebe5b","9c062b3251034ebe90f5054e2a3b5120",22905304,1,2,0,1151,309,311,2
"9c062b3251034ebe90f5054e2a3b5120","9c062b3251034ebe90f5054e2a3b5120",22905304,2,0,1,1152,311,311,0
"9c062b3251034ebe90f5054e2a3b5120","ea859f8207e44537889daeaba13ac2e8",22905304,1,1,0,1154,311,312,1
"ea859f8207e44537889daeaba13ac2e8","ea859f8207e44537889daeaba13ac2e8",22905304,1,0,1,1155,312,312,0
"ea859f8207e44537889daeaba13ac2e8","56d94971a7a94257aa330183a8ebd0ea",22905304,1,1,0,1156,312,313,1
"56d94971a7a94257aa330183a8ebd0ea","56d94971a7a94257aa330183a8ebd0ea",22905304,1,0,1,1157,313,313,0
"56d94971a7a94257aa330183a8ebd0ea","141c0df6cd1946539aadd1c9b7068cd4",22905304,1,-5,0,1158,313,308,-5
"141c0df6cd1946539aadd1c9b7068cd4","13255e63e0aa4abf85e5211bf613d43e",22905304,1,10,0,1159,308,317,9
"13255e63e0aa4abf85e5211bf613d43e","13255e63e0aa4abf85e5211bf613d43e",22905304,1,0,1,1160,317,317,0
"13255e63e0aa4abf85e5211bf613d43e","0c787d16c9504873b1a4d903cec09948",22905304,1,-3,0,1161,317,314,-3
"0c787d16c9504873b1a4d903cec09948","86c27d40179e419c8e9d150fb6afa5d0",22905304,1,6,0,1162,314,319,5
"86c27d40179e419c8e9d150fb6afa5d0","86c27d40179e419c8e9d150fb6afa5d0",22905304,1,0,1,1163,319,319,0
"86c27d40179e419c8e9d150fb6afa5d0","8d7e0b55cf9849cda222a0f2440cec55",22905304,1,-1,0,1164,319,318,-1
"8d7e0b55cf9849cda222a0f2440cec55","47edbb64109243e6b0f8f64cdef90c6c",22905304,1,9,0,1165,318,326,8
"47edbb64109243e6b0f8f64cdef90c6c","24f1363179ad4aaa965484a78471912b",22905304,2,-3,0,1166,326,323,-3
"24f1363179ad4aaa965484a78471912b","86c27d40179e419c8e9d150fb6afa5d0",22905304,1,-5,0,1167,323,319,-4
"86c27d40179e419c8e9d150fb6afa5d0","3628bdce1dd2429ba924d2d4d09448d2",22905304,1,4,0,1168,319,322,3
"3628bdce1dd2429ba924d2d4d09448d2","8d7e0b55cf9849cda222a0f2440cec55",22905304,1,-5,0,1169,322,318,-4
"8d7e0b55cf9849cda222a0f2440cec55","24f1363179ad4aaa965484a78471912b",22905304,1,6,0,1170,318,323,5
"24f1363179ad4aaa965484a78471912b","47edbb64109243e6b0f8f64cdef90c6c",22905304,1,3,0,1171,323,326,3
"24f1363179ad4aaa965484a78471912b","24f1363179ad4aaa965484a78471912b",22905304,2,0,1,1173,323,323,0
"24f1363179ad4aaa965484a78471912b","3628bdce1dd2429ba924d2d4d09448d2",22905304,1,-1,0,1175,323,322,-1
"3628bdce1dd2429ba924d2d4d09448d2","56b3fd1a212a4764be39d979fde3326e",22905304,1,7,0,1176,322,328,6
"56b3fd1a212a4764be39d979fde3326e","56b3fd1a212a4764be39d979fde3326e",22905304,1,0,1,1177,328,328,0
"56b3fd1a212a4764be39d979fde3326e","3434c10e561d488a914e0f7d71907abd",22905304,1,-28,0,1178,328,305,-23
"3434c10e561d488a914e0f7d71907abd","0c4079457ede49e3aeb5e86ed84bdf35",22905304,1,31,0,1179,305,329,24
"0c4079457ede49e3aeb5e86ed84bdf35","38aea304b4fa46e1b29bb72f5cea4c93",22905304,3,2,0,1180,329,331,2
"38aea304b4fa46e1b29bb72f5cea4c93","0c4079457ede49e3aeb5e86ed84bdf35",22905304,1,-2,0,1181,331,329,-2
"38aea304b4fa46e1b29bb72f5cea4c93","38aea304b4fa46e1b29bb72f5cea4c93",22905304,18,0,1,1183,331,331,0
"38aea304b4fa46e1b29bb72f5cea4c93","e36d261332f14e79bb4b467aceaeb9b5",22905304,1,2,0,1189,331,333,2
"e36d261332f14e79bb4b467aceaeb9b5","e36d261332f14e79bb4b467aceaeb9b5",22905304,1,0,1,1190,333,333,0
"e36d261332f14e79bb4b467aceaeb9b5","c7e89b9d04744d2eab742fc24e3ef1ae",22905304,1,1,0,1191,333,334,1
"c7e89b9d04744d2eab742fc24e3ef1ae","c7e89b9d04744d2eab742fc24e3ef1ae",22905304,2,0,1,1192,334,334,0
"c7e89b9d04744d2eab742fc24e3ef1ae","fe49f8054b374a0ea4bb266ed135ff62",22905304,1,1,0,1194,334,335,1
"fe49f8054b374a0ea4bb266ed135ff62","fe49f8054b374a0ea4bb266ed135ff62",22905304,2,0,1,1195,335,335,0
"fe49f8054b374a0ea4bb266ed135ff62","d0a8f74af98642fe8360d22c42e45117",22905304,1,1,0,1197,335,336,1
"d0a8f74af98642fe8360d22c42e45117","d0a8f74af98642fe8360d22c42e45117",22905304,2,0,1,1198,336,336,0
"d0a8f74af98642fe8360d22c42e45117","0c4079457ede49e3aeb5e86ed84bdf35",22905304,1,-7,0,1200,336,329,-7
"0c4079457ede49e3aeb5e86ed84bdf35","a7c6339ca1da4368a18d471f0519f877",22905304,1,11,0,1201,329,339,10
"a7c6339ca1da4368a18d471f0519f877","a7c6339ca1da4368a18d471f0519f877",22905304,1,0,1,1202,339,339,0
"a7c6339ca1da4368a18d471f0519f877","b8b9418ab322418d9db9b40d96af873a",22905304,1,-2,0,1203,339,337,-2
"b8b9418ab322418d9db9b40d96af873a","bbc5139ca9024389a94db3a6f47dcff6",22905304,1,5,0,1204,337,341,4
"bbc5139ca9024389a94db3a6f47dcff6","bbc5139ca9024389a94db3a6f47dcff6",22905304,3,0,1,1205,341,341,0
"bbc5139ca9024389a94db3a6f47dcff6","4ee6ca9019ab4a1ab323f98094a9bd77",22905304,1,2,0,1208,341,343,2
"4ee6ca9019ab4a1ab323f98094a9bd77","4ee6ca9019ab4a1ab323f98094a9bd77",22905304,2,0,1,1209,343,343,0
"4ee6ca9019ab4a1ab323f98094a9bd77","b37947176785476f8b29d49a851366dc",22905304,1,1,0,1211,343,344,1
"b37947176785476f8b29d49a851366dc","b37947176785476f8b29d49a851366dc",22905304,2,0,1,1212,344,344,0
"b37947176785476f8b29d49a851366dc","fcea5b10d5a14a3b9324ffece8f6e1e5",22905304,1,1,0,1214,344,345,1
"fcea5b10d5a14a3b9324ffece8f6e1e5","fcea5b10d5a14a3b9324ffece8f6e1e5",22905304,8,0,1,1215,345,345,0
"fcea5b10d5a14a3b9324ffece8f6e1e5","c2490bc612d146edbe786556fab3651b",22905304,1,-5,0,1223,345,340,-5
"c2490bc612d146edbe786556fab3651b","bbc5139ca9024389a94db3a6f47dcff6",22905304,1,1,0,1224,340,341,1
"bbc5139ca9024389a94db3a6f47dcff6","4a92daef4d504e1792575a26502bb7b7",22905304,1,6,0,1225,341,346,5
"4a92daef4d504e1792575a26502bb7b7","c2490bc612d146edbe786556fab3651b",22905304,1,-7,0,1226,346,340,-6
"c2490bc612d146edbe786556fab3651b","38aea304b4fa46e1b29bb72f5cea4c93",22905304,1,-11,0,1227,340,331,-9
"38aea304b4fa46e1b29bb72f5cea4c93","b8b9418ab322418d9db9b40d96af873a",22905304,1,7,0,1228,331,337,6
"b8b9418ab322418d9db9b40d96af873a","38aea304b4fa46e1b29bb72f5cea4c93",22905304,1,-7,0,1229,337,331,-6
"38aea304b4fa46e1b29bb72f5cea4c93","bbc5139ca9024389a94db3a6f47dcff6",22905304,1,12,0,1232,331,341,10
"bbc5139ca9024389a94db3a6f47dcff6","0c4079457ede49e3aeb5e86ed84bdf35",22905304,1,-14,0,1233,341,329,-12
"0c4079457ede49e3aeb5e86ed84bdf35","b8b9418ab322418d9db9b40d96af873a",22905304,1,9,0,1234,329,337,8
"b8b9418ab322418d9db9b40d96af873a","c2490bc612d146edbe786556fab3651b",22905304,1,4,0,1235,337,340,3
"c2490bc612d146edbe786556fab3651b","6ac8bb048b854999a47edb35fe627f11",22905304,1,8,0,1236,340,347,7
"6ac8bb048b854999a47edb35fe627f11","6ac8bb048b854999a47edb35fe627f11",22905304,1,0,1,1237,347,347,0
"6ac8bb048b854999a47edb35fe627f11","30ead9794d4847abaf222ca966cc8630",22905304,1,3,0,1238,347,348,1
"30ead9794d4847abaf222ca966cc8630","0c4079457ede49e3aeb5e86ed84bdf35",22905304,2,-24,0,1239,348,329,-19
"0c4079457ede49e3aeb5e86ed84bdf35","09b9678ddc3d452ea4a3d46e15826065",22905304,1,29,0,1240,329,353,24
"09b9678ddc3d452ea4a3d46e15826065","897b7f51242c44aab2205c72fdcbf4cd",22905304,2,-1,0,1241,353,352,-1
"897b7f51242c44aab2205c72fdcbf4cd","c20993c944444fe085345591a8bd837e",22905304,1,-1,0,1242,352,351,-1
"c20993c944444fe085345591a8bd837e","eff0de7f2dbb42dfa1a2e686efab5b6d",22905304,1,3,0,1243,351,354,3
"eff0de7f2dbb42dfa1a2e686efab5b6d","0c4079457ede49e3aeb5e86ed84bdf35",22905304,1,-30,0,1244,354,329,-25
"0c4079457ede49e3aeb5e86ed84bdf35","30ead9794d4847abaf222ca966cc8630",22905304,1,24,0,1245,329,348,19
"0c4079457ede49e3aeb5e86ed84bdf35","c20993c944444fe085345591a8bd837e",22905304,1,27,0,1247,329,351,22
"c20993c944444fe085345591a8bd837e","09b9678ddc3d452ea4a3d46e15826065",22905304,1,2,0,1248,351,353,2
"897b7f51242c44aab2205c72fdcbf4cd","eff0de7f2dbb42dfa1a2e686efab5b6d",22905304,1,2,0,1250,352,354,2
"eff0de7f2dbb42dfa1a2e686efab5b6d","c20993c944444fe085345591a8bd837e",22905304,1,-3,0,1251,354,351,-3
"c20993c944444fe085345591a8bd837e","c20993c944444fe085345591a8bd837e",22905304,3,0,1,1252,351,351,0
"c20993c944444fe085345591a8bd837e","897b7f51242c44aab2205c72fdcbf4cd",22905304,1,1,0,1255,351,352,1
"897b7f51242c44aab2205c72fdcbf4cd","897b7f51242c44aab2205c72fdcbf4cd",22905304,3,0,1,1256,352,352,0
"897b7f51242c44aab2205c72fdcbf4cd","09b9678ddc3d452ea4a3d46e15826065",22905304,1,1,0,1259,352,353,1
"09b9678ddc3d452ea4a3d46e15826065","09b9678ddc3d452ea4a3d46e15826065",22905304,3,0,1,1260,353,353,0
"09b9678ddc3d452ea4a3d46e15826065","eff0de7f2dbb42dfa1a2e686efab5b6d",22905304,1,1,0,1263,353,354,1
"eff0de7f2dbb42dfa1a2e686efab5b6d","eff0de7f2dbb42dfa1a2e686efab5b6d",22905304,3,0,1,1264,354,354,0
"eff0de7f2dbb42dfa1a2e686efab5b6d","30ead9794d4847abaf222ca966cc8630",22905304,1,-6,0,1267,354,348,-6
"30ead9794d4847abaf222ca966cc8630","2fe14166dc9642c3bc666b86a57f943d",22905304,1,10,0,1268,348,357,9
"2fe14166dc9642c3bc666b86a57f943d","2fe14166dc9642c3bc666b86a57f943d",22905304,6,0,1,1269,357,357,0
"2fe14166dc9642c3bc666b86a57f943d","44421dd1e13a47a388c4a19834b744c7",22905304,1,2,0,1275,357,359,2
"44421dd1e13a47a388c4a19834b744c7","44421dd1e13a47a388c4a19834b744c7",22905304,2,0,1,1276,359,359,0
"44421dd1e13a47a388c4a19834b744c7","cb5fc7ef85d547c4be1a7439d0bf6052",22905304,1,1,0,1278,359,360,1
"cb5fc7ef85d547c4be1a7439d0bf6052","cb5fc7ef85d547c4be1a7439d0bf6052",22905304,2,0,1,1279,360,360,0
"cb5fc7ef85d547c4be1a7439d0bf6052","0a8f150a4cf747acbde62f4721823da3",22905304,1,1,0,1281,360,361,1
"0a8f150a4cf747acbde62f4721823da3","0a8f150a4cf747acbde62f4721823da3",22905304,2,0,1,1282,361,361,0
"0a8f150a4cf747acbde62f4721823da3","ab8fdad974ae471f9f24c3f9dd04462e",22905304,1,1,0,1284,361,362,1
"ab8fdad974ae471f9f24c3f9dd04462e","ab8fdad974ae471f9f24c3f9dd04462e",22905304,2,0,1,1285,362,362,0
"ab8fdad974ae471f9f24c3f9dd04462e","1ba8fef685d74a8194b9db252eb704fb",22905304,1,-7,0,1287,362,355,-7
"1ba8fef685d74a8194b9db252eb704fb","52580888dadb4fe3baa795683ea227bd",22905304,1,10,0,1288,355,364,9
"52580888dadb4fe3baa795683ea227bd","52580888dadb4fe3baa795683ea227bd",22905304,2,0,1,1289,364,364,0
"52580888dadb4fe3baa795683ea227bd","f00179e251a045b39c3f7a54f9aa4acc",22905304,1,-1,0,1291,364,363,-1
"f00179e251a045b39c3f7a54f9aa4acc","492a3bc6a1254f23a7998587961b22a4",22905304,1,4,0,1292,363,366,3
"492a3bc6a1254f23a7998587961b22a4","492a3bc6a1254f23a7998587961b22a4",22905304,1,0,1,1293,366,366,0
"492a3bc6a1254f23a7998587961b22a4","072a190fd302456290895f9f04d6940a",22905304,1,-1,0,1294,366,365,-1
"072a190fd302456290895f9f04d6940a","30ead9794d4847abaf222ca966cc8630",22905304,1,-20,0,1295,365,348,-17
"30ead9794d4847abaf222ca966cc8630","b71bac264efb4abd97015447bd490db6",22905304,3,28,0,1296,348,370,22
"b71bac264efb4abd97015447bd490db6","cfa457d1743848e4bb5e4beced6448ed",22905304,1,-3,0,1297,370,369,-1
"cfa457d1743848e4bb5e4beced6448ed","b71bac264efb4abd97015447bd490db6",22905304,1,3,0,1298,369,370,1
"b71bac264efb4abd97015447bd490db6","30ead9794d4847abaf222ca966cc8630",22905304,2,-28,0,1299,370,348,-22
"30ead9794d4847abaf222ca966cc8630","8d448d625b024c82a5eb240bbd7431d6",22905304,1,33,0,1302,348,374,26
"8d448d625b024c82a5eb240bbd7431d6","b71bac264efb4abd97015447bd490db6",22905304,4,-5,0,1303,374,370,-4
"b71bac264efb4abd97015447bd490db6","8d448d625b024c82a5eb240bbd7431d6",22905304,6,5,0,1304,370,374,4
"8d448d625b024c82a5eb240bbd7431d6","8d448d625b024c82a5eb240bbd7431d6",22905304,77,0,1,1305,374,374,0
"8d448d625b024c82a5eb240bbd7431d6","1b4550d0dab04078b3bf08a655345bdc",22905304,2,-1,0,1311,374,373,-1
"1b4550d0dab04078b3bf08a655345bdc","8d448d625b024c82a5eb240bbd7431d6",22905304,1,1,0,1312,373,374,1
"1b4550d0dab04078b3bf08a655345bdc","30ead9794d4847abaf222ca966cc8630",22905304,1,-32,0,1322,373,348,-25
"b71bac264efb4abd97015447bd490db6","0c4079457ede49e3aeb5e86ed84bdf35",22905304,1,-52,0,1324,370,329,-41
"0c4079457ede49e3aeb5e86ed84bdf35","0c4079457ede49e3aeb5e86ed84bdf35",22905304,1,0,1,1325,329,329,0
"38aea304b4fa46e1b29bb72f5cea4c93","b71bac264efb4abd97015447bd490db6",22905304,1,50,0,1337,331,370,39
"b71bac264efb4abd97015447bd490db6","d6d02b6ef04e4f17805504500b8ce441",22905304,1,8,0,1393,370,375,5
"d6d02b6ef04e4f17805504500b8ce441","d6d02b6ef04e4f17805504500b8ce441",22905304,7,0,1,1394,375,375,0
"d6d02b6ef04e4f17805504500b8ce441","66baf19b6b904b70922329068c63746d",22905304,1,4,0,1401,375,376,1
"66baf19b6b904b70922329068c63746d","7f544639412e40a9ba27f43b415362ab",22905304,2,2,0,1402,376,378,2
"7f544639412e40a9ba27f43b415362ab","b71bac264efb4abd97015447bd490db6",22905304,1,-14,0,1403,378,370,-8
"8d448d625b024c82a5eb240bbd7431d6","4a29443515bb404cb8924e1c60a63b73",22905304,1,-115,0,1412,374,285,-89
"4a29443515bb404cb8924e1c60a63b73","66baf19b6b904b70922329068c63746d",22905304,1,122,0,1413,285,376,91
"66baf19b6b904b70922329068c63746d","66baf19b6b904b70922329068c63746d",22905304,2,0,1,1414,376,376,0
"7f544639412e40a9ba27f43b415362ab","7f544639412e40a9ba27f43b415362ab",22905304,8,0,1,1416,378,378,0
"7f544639412e40a9ba27f43b415362ab","d5ae8642e15b46b8bd298b02274d4e9c",22905304,1,2,0,1420,378,380,2
"d5ae8642e15b46b8bd298b02274d4e9c","d5ae8642e15b46b8bd298b02274d4e9c",22905304,2,0,1,1421,380,380,0
"d5ae8642e15b46b8bd298b02274d4e9c","a0d10309a2dd456289147f84be9d37f9",22905304,1,1,0,1423,380,381,1
"a0d10309a2dd456289147f84be9d37f9","a0d10309a2dd456289147f84be9d37f9",22905304,2,0,1,1424,381,381,0
"a0d10309a2dd456289147f84be9d37f9","0fcbc3ca07b144138b8d85da581f09a8",22905304,1,1,0,1426,381,382,1
"0fcbc3ca07b144138b8d85da581f09a8","0fcbc3ca07b144138b8d85da581f09a8",22905304,2,0,1,1427,382,382,0
"0fcbc3ca07b144138b8d85da581f09a8","66baf19b6b904b70922329068c63746d",22905304,1,-6,0,1429,382,376,-6
"66baf19b6b904b70922329068c63746d","c2fca3669923477ab966ded303dea31c",22905304,2,8,0,1431,376,383,7
"c2fca3669923477ab966ded303dea31c","66baf19b6b904b70922329068c63746d",22905304,1,-8,0,1432,383,376,-7
"c2fca3669923477ab966ded303dea31c","4890121ce5d74576b4632b77cfc23398",22905304,1,6,0,1434,383,388,5
"4890121ce5d74576b4632b77cfc23398","4890121ce5d74576b4632b77cfc23398",22905304,2,0,1,1435,388,388,0
"4890121ce5d74576b4632b77cfc23398","96bb2b3e85a34d8b9544514e89f6fe97",22905304,1,3,0,1437,388,390,2
"96bb2b3e85a34d8b9544514e89f6fe97","18d3b836dd804224883cc9180b60a8e1",22905304,1,-4,0,1438,390,387,-3
"18d3b836dd804224883cc9180b60a8e1","96bb2b3e85a34d8b9544514e89f6fe97",22905304,1,4,0,1439,387,390,3
"96bb2b3e85a34d8b9544514e89f6fe97","96bb2b3e85a34d8b9544514e89f6fe97",22905304,2,0,1,1440,390,390,0
"96bb2b3e85a34d8b9544514e89f6fe97","ac4e9b54acfe4670b4634859c7263cb5",22905304,1,2,0,1442,390,392,2
"ac4e9b54acfe4670b4634859c7263cb5","ac4e9b54acfe4670b4634859c7263cb5",22905304,1,0,1,1443,392,392,0
"ac4e9b54acfe4670b4634859c7263cb5","6f8881a745ac4c358a68b92c3b4abe81",22905304,1,3,0,1444,392,394,2
"6f8881a745ac4c358a68b92c3b4abe81","17f95d18bab743888e1736033dc3384d",22905304,1,-6,0,1445,394,389,-5
"17f95d18bab743888e1736033dc3384d","6f8881a745ac4c358a68b92c3b4abe81",22905304,1,6,0,1446,389,394,5
"6f8881a745ac4c358a68b92c3b4abe81","f7002c8484354eceac57bc7bd62c76c1",22905304,2,-1,0,1447,394,393,-1
"f7002c8484354eceac57bc7bd62c76c1","6f8881a745ac4c358a68b92c3b4abe81",22905304,1,1,0,1448,393,394,1
"6f8881a745ac4c358a68b92c3b4abe81","0c12af0a4e7f4002852cf84b2537c161",22905304,1,2,0,1449,394,395,1
"0c12af0a4e7f4002852cf84b2537c161","6f8881a745ac4c358a68b92c3b4abe81",22905304,1,-2,0,1450,395,394,-1
"6f8881a745ac4c358a68b92c3b4abe81","6f8881a745ac4c358a68b92c3b4abe81",22905304,2,0,1,1451,394,394,0
"f7002c8484354eceac57bc7bd62c76c1","44a277ea44dc4ae689fab4b82f0b4098",22905304,1,5,0,1454,393,397,4
"44a277ea44dc4ae689fab4b82f0b4098","44a277ea44dc4ae689fab4b82f0b4098",22905304,1,0,1,1455,397,397,0
"44a277ea44dc4ae689fab4b82f0b4098","0c12af0a4e7f4002852cf84b2537c161",22905304,1,-2,0,1456,397,395,-2
"0c12af0a4e7f4002852cf84b2537c161","df8191ec5e584c838a899c378941a566",22905304,2,4,0,1457,395,398,3
"df8191ec5e584c838a899c378941a566","0c12af0a4e7f4002852cf84b2537c161",22905304,1,-4,0,1458,398,395,-3
"df8191ec5e584c838a899c378941a566","7f544639412e40a9ba27f43b415362ab",22905304,2,-26,0,1460,398,378,-20
"7f544639412e40a9ba27f43b415362ab","66baf19b6b904b70922329068c63746d",22905304,2,-2,0,1462,378,376,-2
"66baf19b6b904b70922329068c63746d","df8191ec5e584c838a899c378941a566",22905304,1,28,0,1463,376,398,22
"66baf19b6b904b70922329068c63746d","859e0b8d71694b12befb69ee698138f9",22905304,1,29,0,1469,376,399,23
"859e0b8d71694b12befb69ee698138f9","859e0b8d71694b12befb69ee698138f9",22905304,1,0,1,1470,399,399,0
"859e0b8d71694b12befb69ee698138f9","66baf19b6b904b70922329068c63746d",22905304,1,-29,0,1471,399,376,-23
"66baf19b6b904b70922329068c63746d","2b09a08242b54983aec7063990fb3f66",22905304,1,32,0,1472,376,400,24
"2b09a08242b54983aec7063990fb3f66","2b09a08242b54983aec7063990fb3f66",22905304,4,0,1,1473,400,400,0
"2b09a08242b54983aec7063990fb3f66","1f471b7a883a4df48211e8c6a81b59a7",22905304,1,1,0,1477,400,401,1
"1f471b7a883a4df48211e8c6a81b59a7","1f471b7a883a4df48211e8c6a81b59a7",22905304,1,0,1,1478,401,401,0
"1f471b7a883a4df48211e8c6a81b59a7","2b09a08242b54983aec7063990fb3f66",22905304,1,-1,0,1479,401,400,-1
"2b09a08242b54983aec7063990fb3f66","9de0d567bfa84fe5b77cb76f4a76a5d1",22905304,1,5,0,1480,400,404,4
"9de0d567bfa84fe5b77cb76f4a76a5d1","9de0d567bfa84fe5b77cb76f4a76a5d1",22905304,1,0,1,1481,404,404,0
"9de0d567bfa84fe5b77cb76f4a76a5d1","1157bd665ec4472fb58b751dc5099355",22905304,1,-1,0,1482,404,403,-1
"1157bd665ec4472fb58b751dc5099355","3c8a22d2f9c146ea956609e3ed4f2559",22905304,1,3,0,1483,403,405,2
"3c8a22d2f9c146ea956609e3ed4f2559","58fc9094275e4c49be3f4ba6d4acc0a4",22905304,1,2,0,1484,405,406,1
"58fc9094275e4c49be3f4ba6d4acc0a4","58fc9094275e4c49be3f4ba6d4acc0a4",22905304,2,0,1,1485,406,406,0
"58fc9094275e4c49be3f4ba6d4acc0a4","c1c1be90b2b14c1ab4a5e1ee3c241902",22905304,1,1,0,1487,406,407,1
"c1c1be90b2b14c1ab4a5e1ee3c241902","c1c1be90b2b14c1ab4a5e1ee3c241902",22905304,5,0,1,1488,407,407,0
"c1c1be90b2b14c1ab4a5e1ee3c241902","58fc9094275e4c49be3f4ba6d4acc0a4",22905304,1,-1,0,1493,407,406,-1
"58fc9094275e4c49be3f4ba6d4acc0a4","02b3a1bead9244c1ba2f857c7da8f82a",22905304,1,3,0,1494,406,408,2
"02b3a1bead9244c1ba2f857c7da8f82a","02b3a1bead9244c1ba2f857c7da8f82a",22905304,4,0,1,1495,408,408,0
"02b3a1bead9244c1ba2f857c7da8f82a","6206fc6479014bb193084c32409dc1b9",22905304,1,1,0,1499,408,409,1
"6206fc6479014bb193084c32409dc1b9","6206fc6479014bb193084c32409dc1b9",22905304,1,0,1,1500,409,409,0
"6206fc6479014bb193084c32409dc1b9","6a5f020451db426dacba9e2ea3fcc62a",22905304,1,2,0,1501,409,410,1
"6a5f020451db426dacba9e2ea3fcc62a","02b3a1bead9244c1ba2f857c7da8f82a",22905304,1,-3,0,1502,410,408,-2
"02b3a1bead9244c1ba2f857c7da8f82a","6a5f020451db426dacba9e2ea3fcc62a",22905304,1,3,0,1503,408,410,2
"6a5f020451db426dacba9e2ea3fcc62a","6a5f020451db426dacba9e2ea3fcc62a",22905304,3,0,1,1504,410,410,0
"6a5f020451db426dacba9e2ea3fcc62a","33a9d248b2e44588a5b07fc1342b9bc2",22905304,1,2,0,1507,410,411,1
"33a9d248b2e44588a5b07fc1342b9bc2","33a9d248b2e44588a5b07fc1342b9bc2",22905304,2,0,1,1508,411,411,0
"33a9d248b2e44588a5b07fc1342b9bc2","c6f26bd420634f1cb7989e76fe6b16c0",22905304,1,1,0,1509,411,412,1
"c6f26bd420634f1cb7989e76fe6b16c0","c6f26bd420634f1cb7989e76fe6b16c0",22905304,5,0,1,1510,412,412,0
"c6f26bd420634f1cb7989e76fe6b16c0","2a65ee6e2ac64f6a8a55fbe5373ec763",22905304,1,1,0,1515,412,413,1
"2a65ee6e2ac64f6a8a55fbe5373ec763","2a65ee6e2ac64f6a8a55fbe5373ec763",22905304,2,0,1,1516,413,413,0
"2a65ee6e2ac64f6a8a55fbe5373ec763","33a9d248b2e44588a5b07fc1342b9bc2",22905304,1,-2,0,1518,413,411,-2
"33a9d248b2e44588a5b07fc1342b9bc2","687055dad9fc40c3982478fe33ec01bf",22905304,1,4,0,1519,411,414,3
"687055dad9fc40c3982478fe33ec01bf","2add1669f08d4101913db15f8c23b3b7",22905304,2,3,0,1520,414,416,2
"2add1669f08d4101913db15f8c23b3b7","33a9d248b2e44588a5b07fc1342b9bc2",22905304,1,-7,0,1521,416,411,-5
"33a9d248b2e44588a5b07fc1342b9bc2","2b09a08242b54983aec7063990fb3f66",22905304,1,-17,0,1522,411,400,-11
"2b09a08242b54983aec7063990fb3f66","33a9d248b2e44588a5b07fc1342b9bc2",22905304,1,17,0,1523,400,411,11
"33a9d248b2e44588a5b07fc1342b9bc2","1fd0f6dadbc14ebc965faf6122190b96",22905304,1,5,0,1525,411,415,4
"1fd0f6dadbc14ebc965faf6122190b96","1fd0f6dadbc14ebc965faf6122190b96",22905304,1,0,1,1526,415,415,0
"1fd0f6dadbc14ebc965faf6122190b96","687055dad9fc40c3982478fe33ec01bf",22905304,1,-1,0,1527,415,414,-1
"2add1669f08d4101913db15f8c23b3b7","2add1669f08d4101913db15f8c23b3b7",22905304,1,0,1,1529,416,416,0
"2add1669f08d4101913db15f8c23b3b7","2b09a08242b54983aec7063990fb3f66",22905304,1,-24,0,1530,416,400,-16
"2b09a08242b54983aec7063990fb3f66","a2b4bd40cee2481ebd3fc179d6a5cd62",22905304,1,27,0,1531,400,417,17
"a2b4bd40cee2481ebd3fc179d6a5cd62","a2b4bd40cee2481ebd3fc179d6a5cd62",22905304,2,0,1,1532,417,417,0
"a2b4bd40cee2481ebd3fc179d6a5cd62","e34e59dce2204f228f3a84b6725df60f",22905304,1,2,0,1534,417,419,2
"e34e59dce2204f228f3a84b6725df60f","e34e59dce2204f228f3a84b6725df60f",22905304,1,0,1,1535,419,419,0
"e34e59dce2204f228f3a84b6725df60f","a2b4bd40cee2481ebd3fc179d6a5cd62",22905304,1,-2,0,1536,419,417,-2
"a2b4bd40cee2481ebd3fc179d6a5cd62","bec48fc2e1294c7eb3d0aca780d731b8",22905304,1,4,0,1537,417,420,3
"bec48fc2e1294c7eb3d0aca780d731b8","bec48fc2e1294c7eb3d0aca780d731b8",22905304,3,0,1,1538,420,420,0
"bec48fc2e1294c7eb3d0aca780d731b8","a24600b0e49245f6bdba8c893cfeddb0",22905304,1,7,0,1541,420,425,5
"a24600b0e49245f6bdba8c893cfeddb0","dbde19fcce2a4c1abdc7f685c293a23f",22905304,1,-4,0,1542,425,422,-3
"dbde19fcce2a4c1abdc7f685c293a23f","a24600b0e49245f6bdba8c893cfeddb0",22905304,1,4,0,1543,422,425,3
"a24600b0e49245f6bdba8c893cfeddb0","a24600b0e49245f6bdba8c893cfeddb0",22905304,3,0,1,1544,425,425,0
"a24600b0e49245f6bdba8c893cfeddb0","a2b4bd40cee2481ebd3fc179d6a5cd62",22905304,1,-11,0,1547,425,417,-8
"a2b4bd40cee2481ebd3fc179d6a5cd62","24cf8786024543f19b89bc20034e60d7",22905304,1,18,0,1548,417,428,11
"24cf8786024543f19b89bc20034e60d7","f2a73be2f46840b182d7bd095378004e",22905304,2,1,0,1549,428,429,1
"f2a73be2f46840b182d7bd095378004e","24cf8786024543f19b89bc20034e60d7",22905304,1,-1,0,1550,429,428,-1
"24cf8786024543f19b89bc20034e60d7","24cf8786024543f19b89bc20034e60d7",22905304,1,0,1,1551,428,428,0
"f2a73be2f46840b182d7bd095378004e","f2a73be2f46840b182d7bd095378004e",22905304,2,0,1,1553,429,429,0
"f2a73be2f46840b182d7bd095378004e","604551fd4266430cb860fef58fa7dd61",22905304,1,1,0,1555,429,430,1
"604551fd4266430cb860fef58fa7dd61","604551fd4266430cb860fef58fa7dd61",22905304,7,0,1,1556,430,430,0
"604551fd4266430cb860fef58fa7dd61","24cf8786024543f19b89bc20034e60d7",22905304,1,-2,0,1563,430,428,-2
"24cf8786024543f19b89bc20034e60d7","dce46f8904594a62a6377a3587aaa663",22905304,2,4,0,1564,428,431,3
"dce46f8904594a62a6377a3587aaa663","dce46f8904594a62a6377a3587aaa663",22905304,7,0,1,1565,431,431,0
"dce46f8904594a62a6377a3587aaa663","9b9d0a249052413c869753b99682b0ac",22905304,1,1,0,1567,431,432,1
"9b9d0a249052413c869753b99682b0ac","9b9d0a249052413c869753b99682b0ac",22905304,5,0,1,1568,432,432,0
"9b9d0a249052413c869753b99682b0ac","061c175cc90f45fbad883025394e78dd",22905304,1,1,0,1573,432,433,1
"061c175cc90f45fbad883025394e78dd","061c175cc90f45fbad883025394e78dd",22905304,5,0,1,1574,433,433,0
"061c175cc90f45fbad883025394e78dd","dce46f8904594a62a6377a3587aaa663",22905304,1,-2,0,1579,433,431,-2
"dce46f8904594a62a6377a3587aaa663","24cf8786024543f19b89bc20034e60d7",22905304,2,-4,0,1580,431,428,-3
"dce46f8904594a62a6377a3587aaa663","66ada10dde9f43018588f1ced9d477fc",22905304,1,4,0,1583,431,434,3
"66ada10dde9f43018588f1ced9d477fc","bf12c96466d840a69bed7020b3f18bb8",22905304,3,3,0,1584,434,436,2
"bf12c96466d840a69bed7020b3f18bb8","66ada10dde9f43018588f1ced9d477fc",22905304,2,-3,0,1585,436,434,-2
"66ada10dde9f43018588f1ced9d477fc","dce46f8904594a62a6377a3587aaa663",22905304,1,-4,0,1586,434,431,-3
"24cf8786024543f19b89bc20034e60d7","74a7f8712e5449c2bc0b43c6f90dafed",22905304,1,9,0,1592,428,435,7
"74a7f8712e5449c2bc0b43c6f90dafed","74a7f8712e5449c2bc0b43c6f90dafed",22905304,1,0,1,1593,435,435,0
"74a7f8712e5449c2bc0b43c6f90dafed","66ada10dde9f43018588f1ced9d477fc",22905304,1,-1,0,1594,435,434,-1
"bf12c96466d840a69bed7020b3f18bb8","bf12c96466d840a69bed7020b3f18bb8",22905304,1,0,1,1598,436,436,0
"bf12c96466d840a69bed7020b3f18bb8","070600601c4c439288445d2f0724807d",22905304,1,3,0,1599,436,437,1
"070600601c4c439288445d2f0724807d","24cf8786024543f19b89bc20034e60d7",22905304,1,-14,0,1600,437,428,-9
"24cf8786024543f19b89bc20034e60d7","1823b6de7d334a7aaabc4570719af4d9",22905304,1,16,0,1601,428,439,11
"1823b6de7d334a7aaabc4570719af4d9","b2f0d654738f48158edff28e8d3a546e",22905304,1,19,0,1602,439,449,10
"b2f0d654738f48158edff28e8d3a546e","f60ee41ec635499abd48168342d32c2f",22905304,5,5,0,1603,449,453,4
"f60ee41ec635499abd48168342d32c2f","b2f0d654738f48158edff28e8d3a546e",22905304,2,-5,0,1604,453,449,-4
"f60ee41ec635499abd48168342d32c2f","f60ee41ec635499abd48168342d32c2f",22905304,70,0,1,1606,453,453,0
"f60ee41ec635499abd48168342d32c2f","070600601c4c439288445d2f0724807d",22905304,1,-26,0,1612,453,437,-16
"070600601c4c439288445d2f0724807d","070600601c4c439288445d2f0724807d",22905304,2,0,1,1613,437,437,0
"070600601c4c439288445d2f0724807d","1823b6de7d334a7aaabc4570719af4d9",22905304,2,2,0,1614,437,439,2
"1823b6de7d334a7aaabc4570719af4d9","070600601c4c439288445d2f0724807d",22905304,3,-2,0,1615,439,437,-2
"1823b6de7d334a7aaabc4570719af4d9","1823b6de7d334a7aaabc4570719af4d9",22905304,11,0,1,1617,439,439,0
"070600601c4c439288445d2f0724807d","0380cd76a7d44bc3a4da1f15e4d68f89",22905304,1,4,0,1629,437,440,3
"0380cd76a7d44bc3a4da1f15e4d68f89","0380cd76a7d44bc3a4da1f15e4d68f89",22905304,2,0,1,1630,440,440,0
"0380cd76a7d44bc3a4da1f15e4d68f89","23b7673c8b5443108c2ef09382834a86",22905304,1,2,0,1632,440,441,1
"23b7673c8b5443108c2ef09382834a86","23b7673c8b5443108c2ef09382834a86",22905304,3,0,1,1633,441,441,0
"23b7673c8b5443108c2ef09382834a86","901e92500aea43c79f19f1b279050668",22905304,1,2,0,1636,441,442,1
"901e92500aea43c79f19f1b279050668","901e92500aea43c79f19f1b279050668",22905304,2,0,1,1637,442,442,0
"901e92500aea43c79f19f1b279050668","001339db8ced4cf78829ebe8b145449d",22905304,1,1,0,1639,442,443,1
"001339db8ced4cf78829ebe8b145449d","001339db8ced4cf78829ebe8b145449d",22905304,5,0,1,1640,443,443,0
"001339db8ced4cf78829ebe8b145449d","452745e0366e42ae81561bfddebcc6c3",22905304,1,1,0,1645,443,444,1
"452745e0366e42ae81561bfddebcc6c3","452745e0366e42ae81561bfddebcc6c3",22905304,2,0,1,1646,444,444,0
"452745e0366e42ae81561bfddebcc6c3","901e92500aea43c79f19f1b279050668",22905304,1,-2,0,1648,444,442,-2
"901e92500aea43c79f19f1b279050668","4660ff2089114e8db82ceb26a4f329e3",22905304,1,4,0,1649,442,445,3
"4660ff2089114e8db82ceb26a4f329e3","4660ff2089114e8db82ceb26a4f329e3",22905304,7,0,1,1650,445,445,0
"4660ff2089114e8db82ceb26a4f329e3","7bd5586eb9d8484eb74a433ee7bfe499",22905304,1,2,0,1657,445,446,1
"7bd5586eb9d8484eb74a433ee7bfe499","7bd5586eb9d8484eb74a433ee7bfe499",22905304,10,0,1,1658,446,446,0
"7bd5586eb9d8484eb74a433ee7bfe499","8a7f26e690f34dda97be16904518ca99",22905304,1,2,0,1668,446,447,1
"8a7f26e690f34dda97be16904518ca99","1823b6de7d334a7aaabc4570719af4d9",22905304,1,-14,0,1669,447,439,-8
"070600601c4c439288445d2f0724807d","8a7f26e690f34dda97be16904518ca99",22905304,1,16,0,1671,437,447,10
"8a7f26e690f34dda97be16904518ca99","8a7f26e690f34dda97be16904518ca99",22905304,1,0,1,1672,447,447,0
"8a7f26e690f34dda97be16904518ca99","b2f0d654738f48158edff28e8d3a546e",22905304,1,5,0,1673,447,449,2
"b2f0d654738f48158edff28e8d3a546e","070600601c4c439288445d2f0724807d",22905304,1,-21,0,1674,449,437,-12
"070600601c4c439288445d2f0724807d","b2f0d654738f48158edff28e8d3a546e",22905304,2,21,0,1675,437,449,12
"b2f0d654738f48158edff28e8d3a546e","b2f0d654738f48158edff28e8d3a546e",22905304,3,0,1,1676,449,449,0
"f60ee41ec635499abd48168342d32c2f","f67fbf45a5f146ed866965bc57c7c001",22905304,2,3,0,1738,453,454,1
"f67fbf45a5f146ed866965bc57c7c001","b2f0d654738f48158edff28e8d3a546e",22905304,2,-8,0,1739,454,449,-5
"b2f0d654738f48158edff28e8d3a546e","1b4550d0dab04078b3bf08a655345bdc",22905304,1,-120,0,1740,449,373,-76
"1b4550d0dab04078b3bf08a655345bdc","b71bac264efb4abd97015447bd490db6",22905304,1,-4,0,1741,373,370,-3
"8d448d625b024c82a5eb240bbd7431d6","070600601c4c439288445d2f0724807d",22905304,1,98,0,1750,374,437,63
"b2f0d654738f48158edff28e8d3a546e","f67fbf45a5f146ed866965bc57c7c001",22905304,1,8,0,1764,449,454,5
"f67fbf45a5f146ed866965bc57c7c001","f67fbf45a5f146ed866965bc57c7c001",22905304,1,0,1,1765,454,454,0
"f67fbf45a5f146ed866965bc57c7c001","d937afe49bd24a07a550dda1c1155122",22905304,1,1,0,1766,454,455,1
"d937afe49bd24a07a550dda1c1155122","d937afe49bd24a07a550dda1c1155122",22905304,3,0,1,1767,455,455,0
"d937afe49bd24a07a550dda1c1155122","3628b3f7823443d0912a339096b69943",22905304,1,1,0,1770,455,456,1
"3628b3f7823443d0912a339096b69943","3628b3f7823443d0912a339096b69943",22905304,1,0,1,1771,456,456,0
"3628b3f7823443d0912a339096b69943","9e049ee647cf43ecbcb5ed792a8e7588",22905304,1,1,0,1772,456,457,1
"9e049ee647cf43ecbcb5ed792a8e7588","9e049ee647cf43ecbcb5ed792a8e7588",22905304,1,0,1,1773,457,457,0
"9e049ee647cf43ecbcb5ed792a8e7588","5256a214faaf410b93f76cea06428334",22905304,1,1,0,1774,457,458,1
"5256a214faaf410b93f76cea06428334","5256a214faaf410b93f76cea06428334",22905304,1,0,1,1775,458,458,0
"5256a214faaf410b93f76cea06428334","25c32b120fce40fa9b6c85133aeb4716",22905304,1,1,0,1776,458,459,1
"25c32b120fce40fa9b6c85133aeb4716","25c32b120fce40fa9b6c85133aeb4716",22905304,3,0,1,1777,459,459,0
"25c32b120fce40fa9b6c85133aeb4716","11bc14f2204949008b7d511b933363c1",22905304,1,1,0,1780,459,460,1
"11bc14f2204949008b7d511b933363c1","11bc14f2204949008b7d511b933363c1",22905304,1,0,1,1781,460,460,0
"11bc14f2204949008b7d511b933363c1","42de338840a34d15adb66e7b14fb9d2c",22905304,1,1,0,1782,460,461,1
"42de338840a34d15adb66e7b14fb9d2c","42de338840a34d15adb66e7b14fb9d2c",22905304,3,0,1,1783,461,461,0
"42de338840a34d15adb66e7b14fb9d2c","9da37c6210b1416b8079c274f70bf600",22905304,1,1,0,1786,461,462,1
"9da37c6210b1416b8079c274f70bf600","9da37c6210b1416b8079c274f70bf600",22905304,7,0,1,1787,462,462,0
"9da37c6210b1416b8079c274f70bf600","519119f1deac45ff9ab4f13529be5c6e",22905304,1,1,0,1794,462,463,1
"519119f1deac45ff9ab4f13529be5c6e","519119f1deac45ff9ab4f13529be5c6e",22905304,1,0,1,1795,463,463,0
"519119f1deac45ff9ab4f13529be5c6e","c5df9f40ec14463b9dcfdc73df3e9285",22905304,1,3,0,1796,463,464,1
"c5df9f40ec14463b9dcfdc73df3e9285","f67fbf45a5f146ed866965bc57c7c001",22905304,1,-12,0,1797,464,454,-10
"f67fbf45a5f146ed866965bc57c7c001","c5df9f40ec14463b9dcfdc73df3e9285",22905304,1,12,0,1798,454,464,10
"c5df9f40ec14463b9dcfdc73df3e9285","83d42d95cd844fc093fc09cee250edb8",22905304,3,3,0,1799,464,465,1
"83d42d95cd844fc093fc09cee250edb8","c5df9f40ec14463b9dcfdc73df3e9285",22905304,1,-3,0,1800,465,464,-1
"83d42d95cd844fc093fc09cee250edb8","83d42d95cd844fc093fc09cee250edb8",22905304,7,0,1,1802,465,465,0
"83d42d95cd844fc093fc09cee250edb8","c33c17be71ae4d588da7369472e5bb1b",22905304,1,-599,0,1805,465,34,-431
"c33c17be71ae4d588da7369472e5bb1b","c5df9f40ec14463b9dcfdc73df3e9285",22905304,1,596,0,1806,34,464,430
"c5df9f40ec14463b9dcfdc73df3e9285","c5df9f40ec14463b9dcfdc73df3e9285",22905304,2,0,1,1807,464,464,0
"67a089198fcb4e1c8f2385786c2b296f","67a089198fcb4e1c8f2385786c2b296f",22928179,1,0,1,1,39,39,0
"67a089198fcb4e1c8f2385786c2b296f","b613861cecf84ffcab01afb23f660475",22928179,1,-72,0,2,39,1,-38
"e2911e79efc2420eac45d9f671463d4b","b613861cecf84ffcab01afb23f660475",22928179,3,-3,0,10,2,1,-1
"b613861cecf84ffcab01afb23f660475","b613861cecf84ffcab01afb23f660475",22928179,9,0,1,11,1,1,0
"e2911e79efc2420eac45d9f671463d4b","519d1b8c59404d67b54e96c5c8a830b2",22928179,2,1,0,16,2,3,1
"519d1b8c59404d67b54e96c5c8a830b2","519d1b8c59404d67b54e96c5c8a830b2",22928179,2,0,1,17,3,3,0
"519d1b8c59404d67b54e96c5c8a830b2","531db53f81f646edb0cdcfe0085b03b7",22928179,2,1,0,18,3,4,1
"531db53f81f646edb0cdcfe0085b03b7","531db53f81f646edb0cdcfe0085b03b7",22928179,2,0,1,19,4,4,0
"531db53f81f646edb0cdcfe0085b03b7","4f5f94b2f95141e0a9d53a61da2276da",22928179,2,1,0,20,4,5,1
"4f5f94b2f95141e0a9d53a61da2276da","4f5f94b2f95141e0a9d53a61da2276da",22928179,2,0,1,21,5,5,0
"4f5f94b2f95141e0a9d53a61da2276da","6d541c89590949f99af293c4f2333f67",22928179,2,1,0,22,5,6,1
"6d541c89590949f99af293c4f2333f67","6d541c89590949f99af293c4f2333f67",22928179,2,0,1,23,6,6,0
"6d541c89590949f99af293c4f2333f67","dd5cf0b9fe4c4f1d8f5ff8e4c04879cb",22928179,2,1,0,24,6,7,1
"dd5cf0b9fe4c4f1d8f5ff8e4c04879cb","dd5cf0b9fe4c4f1d8f5ff8e4c04879cb",22928179,2,0,1,25,7,7,0
"dd5cf0b9fe4c4f1d8f5ff8e4c04879cb","f96261861edc426abe2248be4f0a709a",22928179,2,1,0,26,7,8,1
"f96261861edc426abe2248be4f0a709a","f96261861edc426abe2248be4f0a709a",22928179,2,0,1,27,8,8,0
"f96261861edc426abe2248be4f0a709a","66b5e16f4f75454fb5b8172079f0fa83",22928179,2,1,0,28,8,9,1
"66b5e16f4f75454fb5b8172079f0fa83","66b5e16f4f75454fb5b8172079f0fa83",22928179,2,0,1,29,9,9,0
"66b5e16f4f75454fb5b8172079f0fa83","0680571d4698477995e41842c36a54b2",22928179,2,1,0,30,9,10,1
"0680571d4698477995e41842c36a54b2","0680571d4698477995e41842c36a54b2",22928179,2,0,1,31,10,10,0
"0680571d4698477995e41842c36a54b2","9112f2bffece48e08c6d2287be204085",22928179,1,1,0,32,10,11,1
"9112f2bffece48e08c6d2287be204085","9112f2bffece48e08c6d2287be204085",22928179,2,0,1,33,11,11,0
"9112f2bffece48e08c6d2287be204085","e2911e79efc2420eac45d9f671463d4b",22928179,2,-9,0,34,11,2,-9
"e2911e79efc2420eac45d9f671463d4b","9112f2bffece48e08c6d2287be204085",22928179,1,9,0,35,2,11,9
"0680571d4698477995e41842c36a54b2","e2911e79efc2420eac45d9f671463d4b",22928179,1,-8,0,55,10,2,-8
"3f1c815879794b929260d224becaff7e","56586aa865414f538729c7f7735d2bc6",22928179,1,-4,0,64,14,12,-2
"56586aa865414f538729c7f7735d2bc6","3f1c815879794b929260d224becaff7e",22928179,1,4,0,67,12,14,2
"3f1c815879794b929260d224becaff7e","b613861cecf84ffcab01afb23f660475",22928179,1,-19,0,68,14,1,-13
"b613861cecf84ffcab01afb23f660475","eb2a0eb537344a9e891c761662e400b6",22928179,1,23,0,69,1,16,15
"eb2a0eb537344a9e891c761662e400b6","56586aa865414f538729c7f7735d2bc6",22928179,1,-8,0,70,16,12,-4
"56586aa865414f538729c7f7735d2bc6","5c5ceeee4562457ba6d41515aeebfbb1",22928179,2,10,0,71,12,17,5
"5c5ceeee4562457ba6d41515aeebfbb1","eb2a0eb537344a9e891c761662e400b6",22928179,1,-2,0,72,17,16,-1
"eb2a0eb537344a9e891c761662e400b6","3f1c815879794b929260d224becaff7e",22928179,1,-4,0,73,16,14,-2
"3f1c815879794b929260d224becaff7e","81c864a886d54a6b8ff85f7d736f4f95",22928179,1,2,0,74,14,15,1
"81c864a886d54a6b8ff85f7d736f4f95","5c5ceeee4562457ba6d41515aeebfbb1",22928179,1,4,0,75,15,17,2
"5c5ceeee4562457ba6d41515aeebfbb1","56586aa865414f538729c7f7735d2bc6",22928179,2,-10,0,76,17,12,-5
"5c5ceeee4562457ba6d41515aeebfbb1","5c5ceeee4562457ba6d41515aeebfbb1",22928179,1,0,1,78,17,17,0
"56586aa865414f538729c7f7735d2bc6","9afd71a5298d4333b6849dfce1b9422c",22928179,1,13,0,80,12,18,6
"9afd71a5298d4333b6849dfce1b9422c","9afd71a5298d4333b6849dfce1b9422c",22928179,2,0,1,81,18,18,0
"9afd71a5298d4333b6849dfce1b9422c","b7719e26494940efa49512aedd0aac79",22928179,1,4,0,83,18,20,2
"b7719e26494940efa49512aedd0aac79","d4f45188d3c84a02ba08454e6403a818",22928179,1,5,0,84,20,24,4
"d4f45188d3c84a02ba08454e6403a818","d4c3b003e8274e429d2fa688d73fde6d",22928179,1,-2,0,85,24,22,-2
"d4c3b003e8274e429d2fa688d73fde6d","d4c3b003e8274e429d2fa688d73fde6d",22928179,2,0,1,86,22,22,0
"d4c3b003e8274e429d2fa688d73fde6d","5bc03c8f16354d04bd51f5bb93559ad3",22928179,1,4,0,88,22,26,4
"5bc03c8f16354d04bd51f5bb93559ad3","b7719e26494940efa49512aedd0aac79",22928179,1,-7,0,89,26,20,-6
"b7719e26494940efa49512aedd0aac79","b7719e26494940efa49512aedd0aac79",22928179,1,0,1,90,20,20,0
"b7719e26494940efa49512aedd0aac79","afbf7250b99d47bea07172749483ca97",22928179,1,12,0,91,20,28,8
"afbf7250b99d47bea07172749483ca97","afbf7250b99d47bea07172749483ca97",22928179,1,0,1,92,28,28,0
"afbf7250b99d47bea07172749483ca97","4e51676dc72045d99c19b9fa7b22f8bc",22928179,1,3,0,93,28,29,1
"4e51676dc72045d99c19b9fa7b22f8bc","4e51676dc72045d99c19b9fa7b22f8bc",22928179,4,0,1,94,29,29,0
"4e51676dc72045d99c19b9fa7b22f8bc","51970cfa30e643e894e66ae85c8024cc",22928179,1,3,0,98,29,31,2
"51970cfa30e643e894e66ae85c8024cc","c33c17be71ae4d588da7369472e5bb1b",22928179,1,6,0,99,31,34,3
"c33c17be71ae4d588da7369472e5bb1b","4e51676dc72045d99c19b9fa7b22f8bc",22928179,1,-9,0,100,34,29,-5
"4e51676dc72045d99c19b9fa7b22f8bc","c33c17be71ae4d588da7369472e5bb1b",22928179,1,9,0,101,29,34,5
"c33c17be71ae4d588da7369472e5bb1b","93679be414554a11b1893002f2229a93",22928179,1,3,0,102,34,35,1
"93679be414554a11b1893002f2229a93","93679be414554a11b1893002f2229a93",22928179,1,0,1,103,35,35,0
"93679be414554a11b1893002f2229a93","7040a13096d746ac84b8fac8d9752058",22928179,1,3,0,104,35,36,1
"7040a13096d746ac84b8fac8d9752058","7040a13096d746ac84b8fac8d9752058",22928179,1,0,1,105,36,36,0
"7040a13096d746ac84b8fac8d9752058","9a0dc646f934470daf08c4b56ccf73db",22928179,1,3,0,106,36,37,1
"9a0dc646f934470daf08c4b56ccf73db","9a0dc646f934470daf08c4b56ccf73db",22928179,1,0,1,107,37,37,0
"9a0dc646f934470daf08c4b56ccf73db","fc0e049d56024bc9a02c9a9c435c3df7",22928179,1,3,0,108,37,38,1
"fc0e049d56024bc9a02c9a9c435c3df7","67a089198fcb4e1c8f2385786c2b296f",22928179,1,4,0,109,38,39,1
"67a089198fcb4e1c8f2385786c2b296f","fc0e049d56024bc9a02c9a9c435c3df7",22928179,1,-4,0,110,39,38,-1
"fc0e049d56024bc9a02c9a9c435c3df7","64d48c6c9c7940639a932219a6c87198",22928179,1,5,0,111,38,40,2
"64d48c6c9c7940639a932219a6c87198","67a089198fcb4e1c8f2385786c2b296f",22928179,2,-1,0,112,40,39,-1
"67a089198fcb4e1c8f2385786c2b296f","64d48c6c9c7940639a932219a6c87198",22928179,2,1,0,113,39,40,1
"64d48c6c9c7940639a932219a6c87198","64d48c6c9c7940639a932219a6c87198",22928179,3,0,1,114,40,40,0
"67a089198fcb4e1c8f2385786c2b296f","b534b89233134e30a9b5645138bfa9ee",22928179,2,4,0,118,39,41,2
"b534b89233134e30a9b5645138bfa9ee","56586aa865414f538729c7f7735d2bc6",22928179,1,-61,0,119,41,12,-29
"56586aa865414f538729c7f7735d2bc6","b534b89233134e30a9b5645138bfa9ee",22928179,1,61,0,120,12,41,29
"b534b89233134e30a9b5645138bfa9ee","67a089198fcb4e1c8f2385786c2b296f",22928179,1,-4,0,121,41,39,-2
"b534b89233134e30a9b5645138bfa9ee","0e37b720d23b4e7f8b313e79313fd107",22928179,1,3,0,123,41,44,3
"0e37b720d23b4e7f8b313e79313fd107","0e37b720d23b4e7f8b313e79313fd107",22928179,1,0,1,124,44,44,0
"0e37b720d23b4e7f8b313e79313fd107","6875d67fdd5f48168b62719df449bebd",22928179,1,1,0,125,44,45,1
"6875d67fdd5f48168b62719df449bebd","6875d67fdd5f48168b62719df449bebd",22928179,1,0,1,126,45,45,0
"6875d67fdd5f48168b62719df449bebd","b534b89233134e30a9b5645138bfa9ee",22928179,1,-4,0,127,45,41,-4
"b534b89233134e30a9b5645138bfa9ee","6e13d61a7bdb44bca949c9f86fab3be5",22928179,3,7,0,128,41,47,6
"6e13d61a7bdb44bca949c9f86fab3be5","6e13d61a7bdb44bca949c9f86fab3be5",22928179,1,0,1,129,47,47,0
"6e13d61a7bdb44bca949c9f86fab3be5","195f78799f984cc2b06c48dfe36be751",22928179,1,2,0,130,47,49,2
"195f78799f984cc2b06c48dfe36be751","195f78799f984cc2b06c48dfe36be751",22928179,2,0,1,131,49,49,0
"195f78799f984cc2b06c48dfe36be751","d0c74f735e024943943e40333d6d337f",22928179,1,3,0,133,49,51,2
"d0c74f735e024943943e40333d6d337f","d9c8d8c444a64dadbbb508652c721e17",22928179,2,-6,0,134,51,46,-5
"d9c8d8c444a64dadbbb508652c721e17","d0c74f735e024943943e40333d6d337f",22928179,1,6,0,135,46,51,5
"d0c74f735e024943943e40333d6d337f","d0c74f735e024943943e40333d6d337f",22928179,1,0,1,136,51,51,0
"d0c74f735e024943943e40333d6d337f","983f8ff320594b279a7f4a6fe132f9c5",22928179,1,2,0,137,51,53,2
"983f8ff320594b279a7f4a6fe132f9c5","983f8ff320594b279a7f4a6fe132f9c5",22928179,2,0,1,138,53,53,0
"983f8ff320594b279a7f4a6fe132f9c5","35adfa5d923046aebabfefd98f35ff05",22928179,1,1,0,140,53,54,1
"35adfa5d923046aebabfefd98f35ff05","35adfa5d923046aebabfefd98f35ff05",22928179,2,0,1,141,54,54,0
"35adfa5d923046aebabfefd98f35ff05","b6f8a98476224da1b40e555ececc7ed8",22928179,1,1,0,143,54,55,1
"b6f8a98476224da1b40e555ececc7ed8","b6f8a98476224da1b40e555ececc7ed8",22928179,2,0,1,144,55,55,0
"b6f8a98476224da1b40e555ececc7ed8","86e22cb5fe0e4b47a9489ecddf7ed78f",22928179,1,1,0,146,55,56,1
"86e22cb5fe0e4b47a9489ecddf7ed78f","86e22cb5fe0e4b47a9489ecddf7ed78f",22928179,2,0,1,147,56,56,0
"86e22cb5fe0e4b47a9489ecddf7ed78f","a1f2f12debe5432fb7a70bcd12bacfb9",22928179,1,3,0,149,56,58,2
"a1f2f12debe5432fb7a70bcd12bacfb9","f924752d8a1149668870b1e7698486f7",22928179,1,-9,0,150,58,50,-8
"f924752d8a1149668870b1e7698486f7","78f30e4dcac84e3cbea8b2cc6e0d62b3",22928179,1,10,0,151,50,59,9
"78f30e4dcac84e3cbea8b2cc6e0d62b3","a1f2f12debe5432fb7a70bcd12bacfb9",22928179,1,-1,0,152,59,58,-1
"a1f2f12debe5432fb7a70bcd12bacfb9","a1f2f12debe5432fb7a70bcd12bacfb9",22928179,13,0,1,153,58,58,0
"a1f2f12debe5432fb7a70bcd12bacfb9","78f30e4dcac84e3cbea8b2cc6e0d62b3",22928179,1,1,0,166,58,59,1
"78f30e4dcac84e3cbea8b2cc6e0d62b3","78f30e4dcac84e3cbea8b2cc6e0d62b3",22928179,7,0,1,167,59,59,0
"78f30e4dcac84e3cbea8b2cc6e0d62b3","a0a418b8540d479fa6e0f653b701da8b",22928179,1,6,0,174,59,64,5
"a0a418b8540d479fa6e0f653b701da8b","bc42d26810654ea9a1df1efe1e58c7d5",22928179,1,-1,0,175,64,63,-1
"bc42d26810654ea9a1df1efe1e58c7d5","12aa6e1672ac4e7aa6449a7a8609cd72",22928179,1,-7,0,176,63,57,-6
"12aa6e1672ac4e7aa6449a7a8609cd72","4c943503763e4e349906eea3ed3c8e86",22928179,1,5,0,177,57,61,4
"4c943503763e4e349906eea3ed3c8e86","4c943503763e4e349906eea3ed3c8e86",22928179,1,0,1,178,61,61,0
"4c943503763e4e349906eea3ed3c8e86","bc42d26810654ea9a1df1efe1e58c7d5",22928179,1,2,0,179,61,63,2
"bc42d26810654ea9a1df1efe1e58c7d5","bc42d26810654ea9a1df1efe1e58c7d5",22928179,3,0,1,180,63,63,0
"bc42d26810654ea9a1df1efe1e58c7d5","a0a418b8540d479fa6e0f653b701da8b",22928179,1,1,0,183,63,64,1
"a0a418b8540d479fa6e0f653b701da8b","a0a418b8540d479fa6e0f653b701da8b",22928179,3,0,1,184,64,64,0
"a0a418b8540d479fa6e0f653b701da8b","309ccf3cc4fe429d9bfbaef53d3fa479",22928179,1,-4,0,187,64,60,-4
"309ccf3cc4fe429d9bfbaef53d3fa479","b534b89233134e30a9b5645138bfa9ee",22928179,1,-23,0,188,60,41,-19
"d646286c8051419bbc2e31dd1db55ca8","b534b89233134e30a9b5645138bfa9ee",22928179,1,-33,0,190,67,41,-26
"b534b89233134e30a9b5645138bfa9ee","b534b89233134e30a9b5645138bfa9ee",22928179,1,0,1,191,41,41,0
"6e13d61a7bdb44bca949c9f86fab3be5","d0c74f735e024943943e40333d6d337f",22928179,1,5,0,195,47,51,4
"d9c8d8c444a64dadbbb508652c721e17","67a089198fcb4e1c8f2385786c2b296f",22928179,1,-10,0,197,46,39,-7
"67a089198fcb4e1c8f2385786c2b296f","f924752d8a1149668870b1e7698486f7",22928179,1,15,0,198,39,50,11
"f924752d8a1149668870b1e7698486f7","b534b89233134e30a9b5645138bfa9ee",22928179,2,-11,0,199,50,41,-9
"b534b89233134e30a9b5645138bfa9ee","d0c74f735e024943943e40333d6d337f",22928179,2,12,0,200,41,51,10
"d0c74f735e024943943e40333d6d337f","f924752d8a1149668870b1e7698486f7",22928179,1,-1,0,201,51,50,-1
"f924752d8a1149668870b1e7698486f7","f924752d8a1149668870b1e7698486f7",22928179,1,0,1,202,50,50,0
"d0c74f735e024943943e40333d6d337f","67a089198fcb4e1c8f2385786c2b296f",22928179,1,-16,0,205,51,39,-12
"67a089198fcb4e1c8f2385786c2b296f","d646286c8051419bbc2e31dd1db55ca8",22928179,1,37,0,206,39,67,28
"d646286c8051419bbc2e31dd1db55ca8","d646286c8051419bbc2e31dd1db55ca8",22928179,2,0,1,207,67,67,0
"d646286c8051419bbc2e31dd1db55ca8","267f883678b24aed855fde42524975d9",22928179,1,4,0,208,67,71,4
"267f883678b24aed855fde42524975d9","267f883678b24aed855fde42524975d9",22928179,1,0,1,209,71,71,0
"267f883678b24aed855fde42524975d9","88fff56d0342490dbef9040750a20f6c",22928179,1,1,0,210,71,72,1
"88fff56d0342490dbef9040750a20f6c","88fff56d0342490dbef9040750a20f6c",22928179,1,0,1,211,72,72,0
"88fff56d0342490dbef9040750a20f6c","adb17b12b66c4a49a85fd34322f7df70",22928179,1,1,0,212,72,73,1
"adb17b12b66c4a49a85fd34322f7df70","adb17b12b66c4a49a85fd34322f7df70",22928179,1,0,1,213,73,73,0
"adb17b12b66c4a49a85fd34322f7df70","d646286c8051419bbc2e31dd1db55ca8",22928179,1,-6,0,214,73,67,-6
"d646286c8051419bbc2e31dd1db55ca8","a2becd407db34b189200a32546d9d569",22928179,1,9,0,215,67,75,8
"a2becd407db34b189200a32546d9d569","a2becd407db34b189200a32546d9d569",22928179,1,0,1,216,75,75,0
"a2becd407db34b189200a32546d9d569","58c22b011d0f4c2ea6d13615edbb9eeb",22928179,1,2,0,217,75,77,2
"58c22b011d0f4c2ea6d13615edbb9eeb","58c22b011d0f4c2ea6d13615edbb9eeb",22928179,11,0,1,218,77,77,0
"58c22b011d0f4c2ea6d13615edbb9eeb","dd76e1861dc9461c830888729d091ee0",22928179,1,1,0,229,77,78,1
"dd76e1861dc9461c830888729d091ee0","dd76e1861dc9461c830888729d091ee0",22928179,9,0,1,230,78,78,0
"dd76e1861dc9461c830888729d091ee0","cd1d828f1a694b87913a7ea66c23803e",22928179,1,1,0,239,78,79,1
"cd1d828f1a694b87913a7ea66c23803e","cd1d828f1a694b87913a7ea66c23803e",22928179,2,0,1,240,79,79,0
"cd1d828f1a694b87913a7ea66c23803e","9176a3c2b4d2465fa8b0c67096c2a97e",22928179,1,1,0,242,79,80,1
"9176a3c2b4d2465fa8b0c67096c2a97e","9176a3c2b4d2465fa8b0c67096c2a97e",22928179,5,0,1,243,80,80,0
"9176a3c2b4d2465fa8b0c67096c2a97e","f8ec6445f7194e25b9101d4fbcb07a18",22928179,1,1,0,248,80,81,1
"f8ec6445f7194e25b9101d4fbcb07a18","f8ec6445f7194e25b9101d4fbcb07a18",22928179,5,0,1,249,81,81,0
"f8ec6445f7194e25b9101d4fbcb07a18","140d5b27b8574befad82c0a013b59dfa",22928179,1,-7,0,254,81,74,-7
"140d5b27b8574befad82c0a013b59dfa","d646286c8051419bbc2e31dd1db55ca8",22928179,1,-8,0,255,74,67,-7
"d646286c8051419bbc2e31dd1db55ca8","ae5ac430ea254e708a6f5deaaf7464ae",22928179,1,20,0,257,67,84,17
"ae5ac430ea254e708a6f5deaaf7464ae","ae5ac430ea254e708a6f5deaaf7464ae",22928179,1,0,1,258,84,84,0
"ae5ac430ea254e708a6f5deaaf7464ae","67a089198fcb4e1c8f2385786c2b296f",22928179,1,-57,0,259,84,39,-45
"67a089198fcb4e1c8f2385786c2b296f","d18a9ea32855445f8736581f5cb119ce",22928179,1,54,0,260,39,82,43
"d18a9ea32855445f8736581f5cb119ce","d646286c8051419bbc2e31dd1db55ca8",22928179,1,-17,0,261,82,67,-15
"d18a9ea32855445f8736581f5cb119ce","f564483cbd7a407681aa2fcca518cf5f",22928179,1,4,0,263,82,85,3
"f564483cbd7a407681aa2fcca518cf5f","f564483cbd7a407681aa2fcca518cf5f",22928179,4,0,1,264,85,85,0
"f564483cbd7a407681aa2fcca518cf5f","18fd01350bd5434ca636d59a599d768a",22928179,1,1,0,268,85,86,1
"18fd01350bd5434ca636d59a599d768a","18fd01350bd5434ca636d59a599d768a",22928179,8,0,1,269,86,86,0
"18fd01350bd5434ca636d59a599d768a","ae5ac430ea254e708a6f5deaaf7464ae",22928179,1,-2,0,277,86,84,-2
"6a9f0ef185fb47f0937e29daa1c71ed5","42fb58708eaf4e5daa82bfca61b6f5fd",22928179,1,-3,0,279,90,87,-3
"42fb58708eaf4e5daa82bfca61b6f5fd","ae5ac430ea254e708a6f5deaaf7464ae",22928179,1,-4,0,280,87,84,-3
"6a9f0ef185fb47f0937e29daa1c71ed5","d18a9ea32855445f8736581f5cb119ce",22928179,1,-10,0,282,90,82,-8
"d18a9ea32855445f8736581f5cb119ce","42fb58708eaf4e5daa82bfca61b6f5fd",22928179,1,7,0,283,82,87,5
"42fb58708eaf4e5daa82bfca61b6f5fd","d18a9ea32855445f8736581f5cb119ce",22928179,1,-7,0,284,87,82,-5
"d18a9ea32855445f8736581f5cb119ce","6a9f0ef185fb47f0937e29daa1c71ed5",22928179,1,10,0,285,82,90,8
"6a9f0ef185fb47f0937e29daa1c71ed5","c681290961c94c4caf23b529d1ae6b9a",22928179,1,-2,0,286,90,88,-2
"c681290961c94c4caf23b529d1ae6b9a","c681290961c94c4caf23b529d1ae6b9a",22928179,1,0,1,287,88,88,0
"c681290961c94c4caf23b529d1ae6b9a","6a9f0ef185fb47f0937e29daa1c71ed5",22928179,1,2,0,288,88,90,2
"e20db35ced8544ddac5bc3839145e463","67a089198fcb4e1c8f2385786c2b296f",22928179,2,-67,0,294,91,39,-52
"67a089198fcb4e1c8f2385786c2b296f","e20db35ced8544ddac5bc3839145e463",22928179,1,67,0,295,39,91,52
"e20db35ced8544ddac5bc3839145e463","1febb706d7a34005ae8711ed49c76e64",22928179,1,3,0,297,91,94,3
"1febb706d7a34005ae8711ed49c76e64","1febb706d7a34005ae8711ed49c76e64",22928179,2,0,1,298,94,94,0
"1febb706d7a34005ae8711ed49c76e64","8f73ba6f5a0042f2850356ac38ac6f24",22928179,1,1,0,300,94,95,1
"8f73ba6f5a0042f2850356ac38ac6f24","8f73ba6f5a0042f2850356ac38ac6f24",22928179,5,0,1,301,95,95,0
"8f73ba6f5a0042f2850356ac38ac6f24","e2260b86653c46d7b14a41fb419dbf8c",22928179,1,1,0,306,95,96,1
"e2260b86653c46d7b14a41fb419dbf8c","e2260b86653c46d7b14a41fb419dbf8c",22928179,2,0,1,307,96,96,0
"e2260b86653c46d7b14a41fb419dbf8c","8f73ba6f5a0042f2850356ac38ac6f24",22928179,1,-1,0,309,96,95,-1
"8f73ba6f5a0042f2850356ac38ac6f24","35eb641ad1d845bbba54915bce75a962",22928179,1,2,0,310,95,97,2
"35eb641ad1d845bbba54915bce75a962","35eb641ad1d845bbba54915bce75a962",22928179,6,0,1,311,97,97,0
"35eb641ad1d845bbba54915bce75a962","08be90ffbeea4795a138cd42ed8db56f",22928179,1,1,0,317,97,98,1
"08be90ffbeea4795a138cd42ed8db56f","08be90ffbeea4795a138cd42ed8db56f",22928179,6,0,1,318,98,98,0
"08be90ffbeea4795a138cd42ed8db56f","3007433c8f584dcbb5ac159c1c5f2be3",22928179,1,1,0,324,98,99,1
"3007433c8f584dcbb5ac159c1c5f2be3","3007433c8f584dcbb5ac159c1c5f2be3",22928179,6,0,1,325,99,99,0
"3007433c8f584dcbb5ac159c1c5f2be3","00ae5f0c51874a73a41ebea838d95682",22928179,1,3,0,331,99,101,2
"00ae5f0c51874a73a41ebea838d95682","e20db35ced8544ddac5bc3839145e463",22928179,1,-11,0,332,101,91,-10
"d391c8b6e56a43a7b654e9dee02d904b","d391c8b6e56a43a7b654e9dee02d904b",22928179,15,0,1,336,103,103,0
"d391c8b6e56a43a7b654e9dee02d904b","6111116566fc4fd9abba409322bea245",22928179,1,1,0,351,103,104,1
"6111116566fc4fd9abba409322bea245","6111116566fc4fd9abba409322bea245",22928179,2,0,1,352,104,104,0
"6111116566fc4fd9abba409322bea245","a81b2235cb9c499eb9ea8ee0a8dd9725",22928179,1,1,0,354,104,105,1
"a81b2235cb9c499eb9ea8ee0a8dd9725","a81b2235cb9c499eb9ea8ee0a8dd9725",22928179,2,0,1,355,105,105,0
"a81b2235cb9c499eb9ea8ee0a8dd9725","2d4e0ab0ef3b4d73b82c72d4621a7579",22928179,1,1,0,357,105,106,1
"2d4e0ab0ef3b4d73b82c72d4621a7579","2d4e0ab0ef3b4d73b82c72d4621a7579",22928179,2,0,1,358,106,106,0
"2d4e0ab0ef3b4d73b82c72d4621a7579","8bdebf492ebd4e62b0d522e8ab5e5197",22928179,1,1,0,360,106,107,1
"8bdebf492ebd4e62b0d522e8ab5e5197","8bdebf492ebd4e62b0d522e8ab5e5197",22928179,2,0,1,361,107,107,0
"8bdebf492ebd4e62b0d522e8ab5e5197","73039f8c1eb9409cb4caee2cf968001e",22928179,1,-7,0,363,107,100,-7
"4280927ec4d643238aa49c32f9e06c6c","4280927ec4d643238aa49c32f9e06c6c",22928179,1,0,1,365,109,109,0
"4280927ec4d643238aa49c32f9e06c6c","fc44e6a5f7654430af1227838224dceb",22928179,1,2,0,366,109,111,2
"fc44e6a5f7654430af1227838224dceb","fc44e6a5f7654430af1227838224dceb",22928179,6,0,1,367,111,111,0
"fc44e6a5f7654430af1227838224dceb","08111f75e22d409998cf8b85bd431f0a",22928179,1,-3,0,373,111,108,-3
"62bff51286ef4f348717a3cf6fe2318f","3ec3a3563847406fa73338f9e9999cf3",22928179,1,-3,0,377,120,117,-3
"3ec3a3563847406fa73338f9e9999cf3","a9ae0a3c070d455bb4369a8996313336",22928179,1,-4,0,378,117,114,-3
"a9ae0a3c070d455bb4369a8996313336","a9ae0a3c070d455bb4369a8996313336",22928179,1,0,1,379,114,114,0
"a9ae0a3c070d455bb4369a8996313336","e20db35ced8544ddac5bc3839145e463",22928179,1,-26,0,380,114,91,-23
"e20db35ced8544ddac5bc3839145e463","a9ae0a3c070d455bb4369a8996313336",22928179,1,26,0,382,91,114,23
"a9ae0a3c070d455bb4369a8996313336","71cec822bcff4f30a20e75dc63ef7b65",22928179,1,2,0,383,114,116,2
"71cec822bcff4f30a20e75dc63ef7b65","71cec822bcff4f30a20e75dc63ef7b65",22928179,2,0,1,384,116,116,0
"71cec822bcff4f30a20e75dc63ef7b65","62bff51286ef4f348717a3cf6fe2318f",22928179,1,5,0,386,116,120,4
"62bff51286ef4f348717a3cf6fe2318f","37319e88176d4aefa91d7a9980dbae91",22928179,1,-9,0,387,120,112,-8
"37319e88176d4aefa91d7a9980dbae91","b1cd0e7dc3ad4a8eb91a4bfdbeb025b0",22928179,1,7,0,388,112,118,6
"b1cd0e7dc3ad4a8eb91a4bfdbeb025b0","b1cd0e7dc3ad4a8eb91a4bfdbeb025b0",22928179,1,0,1,389,118,118,0
"b1cd0e7dc3ad4a8eb91a4bfdbeb025b0","62bff51286ef4f348717a3cf6fe2318f",22928179,1,2,0,390,118,120,2
"67a089198fcb4e1c8f2385786c2b296f","779f9ddd1fd14d1e9e69f72219a1fdbd",22928179,1,103,0,397,39,121,82
"779f9ddd1fd14d1e9e69f72219a1fdbd","779f9ddd1fd14d1e9e69f72219a1fdbd",22928179,1,0,1,398,121,121,0
"779f9ddd1fd14d1e9e69f72219a1fdbd","67a089198fcb4e1c8f2385786c2b296f",22928179,1,-103,0,399,121,39,-82
"64d48c6c9c7940639a932219a6c87198","779f9ddd1fd14d1e9e69f72219a1fdbd",22928179,1,102,0,401,40,121,81
"779f9ddd1fd14d1e9e69f72219a1fdbd","ae26e6cda8ad4a3f81bd347560d9579f",22928179,1,4,0,402,121,125,4
"ae26e6cda8ad4a3f81bd347560d9579f","ae26e6cda8ad4a3f81bd347560d9579f",22928179,3,0,1,403,125,125,0
"ae26e6cda8ad4a3f81bd347560d9579f","ee48df95832b4374aa273ceb27ec1315",22928179,1,1,0,406,125,126,1
"ee48df95832b4374aa273ceb27ec1315","ee48df95832b4374aa273ceb27ec1315",22928179,1,0,1,407,126,126,0
"ee48df95832b4374aa273ceb27ec1315","7a439da90b394756ad1777fc4c6dead5",22928179,1,1,0,408,126,127,1
"7a439da90b394756ad1777fc4c6dead5","7a439da90b394756ad1777fc4c6dead5",22928179,1,0,1,409,127,127,0
"7a439da90b394756ad1777fc4c6dead5","a8dd5213034441ac92724b4e83eb0bb2",22928179,1,3,0,410,127,129,2
"a8dd5213034441ac92724b4e83eb0bb2","779f9ddd1fd14d1e9e69f72219a1fdbd",22928179,1,-9,0,411,129,121,-8
"a8dd5213034441ac92724b4e83eb0bb2","8115eab6556b45f5b415c3b8c26a12e5",22928179,1,2,0,413,129,131,2
"8115eab6556b45f5b415c3b8c26a12e5","8115eab6556b45f5b415c3b8c26a12e5",22928179,11,0,1,414,131,131,0
"8115eab6556b45f5b415c3b8c26a12e5","ec34b06efd844b46a4c4818ecdb9b8f4",22928179,1,1,0,425,131,132,1
"ec34b06efd844b46a4c4818ecdb9b8f4","ec34b06efd844b46a4c4818ecdb9b8f4",22928179,2,0,1,426,132,132,0
"ec34b06efd844b46a4c4818ecdb9b8f4","c2e1c2b9eac64109b343a088584b576b",22928179,1,1,0,428,132,133,1
"c2e1c2b9eac64109b343a088584b576b","c2e1c2b9eac64109b343a088584b576b",22928179,2,0,1,429,133,133,0
"c2e1c2b9eac64109b343a088584b576b","579338175e0b4bbb8ef3b712b5d8b54e",22928179,1,-5,0,431,133,128,-5
"579338175e0b4bbb8ef3b712b5d8b54e","8bc5795d6a984a3eace4e2811e52dd4f",22928179,1,8,0,432,128,135,7
"8bc5795d6a984a3eace4e2811e52dd4f","8bc5795d6a984a3eace4e2811e52dd4f",22928179,1,0,1,433,135,135,0
"8bc5795d6a984a3eace4e2811e52dd4f","b416d47c56a742199b5d7c7f19d6503a",22928179,1,-1,0,434,135,134,-1
"b416d47c56a742199b5d7c7f19d6503a","cd4532ad48034873ba8bce2aac0c9808",22928179,1,4,0,435,134,137,3
"cd4532ad48034873ba8bce2aac0c9808","cd4532ad48034873ba8bce2aac0c9808",22928179,1,0,1,436,137,137,0
"cd4532ad48034873ba8bce2aac0c9808","df1de691dafe4549a18a4398ee9dfaf9",22928179,1,4,0,437,137,139,2
"df1de691dafe4549a18a4398ee9dfaf9","779f9ddd1fd14d1e9e69f72219a1fdbd",22928179,1,-23,0,438,139,121,-18
"779f9ddd1fd14d1e9e69f72219a1fdbd","6c5ad271a44743479bfaea29b1db8d02",22928179,1,27,0,439,121,143,22
"6c5ad271a44743479bfaea29b1db8d02","6c5ad271a44743479bfaea29b1db8d02",22928179,1,0,1,440,143,143,0
"6c5ad271a44743479bfaea29b1db8d02","83d311bed5374fee83d8d67a7d9d82dc",22928179,1,1,0,441,143,144,1
"83d311bed5374fee83d8d67a7d9d82dc","83d311bed5374fee83d8d67a7d9d82dc",22928179,3,0,1,442,144,144,0
"83d311bed5374fee83d8d67a7d9d82dc","402bba41861d43acb52a5abb89e8831e",22928179,1,1,0,445,144,145,1
"402bba41861d43acb52a5abb89e8831e","402bba41861d43acb52a5abb89e8831e",22928179,2,0,1,446,145,145,0
"402bba41861d43acb52a5abb89e8831e","df1de691dafe4549a18a4398ee9dfaf9",22928179,1,-6,0,448,145,139,-6
"df1de691dafe4549a18a4398ee9dfaf9","8aae34f5ddbb4052a709b12e6b0d40fa",22928179,1,9,0,449,139,147,8
"8aae34f5ddbb4052a709b12e6b0d40fa","8aae34f5ddbb4052a709b12e6b0d40fa",22928179,1,0,1,450,147,147,0
"8aae34f5ddbb4052a709b12e6b0d40fa","645b3f0249f64f76af2e19eb4d0e55b7",22928179,1,2,0,451,147,149,2
"645b3f0249f64f76af2e19eb4d0e55b7","645b3f0249f64f76af2e19eb4d0e55b7",22928179,2,0,1,452,149,149,0
"645b3f0249f64f76af2e19eb4d0e55b7","7e7b8db5064d4369805ab370aac5ddfb",22928179,1,1,0,454,149,150,1
"7e7b8db5064d4369805ab370aac5ddfb","7e7b8db5064d4369805ab370aac5ddfb",22928179,2,0,1,455,150,150,0
"7e7b8db5064d4369805ab370aac5ddfb","8956d210ae7f41968fada86d4c979d6a",22928179,1,1,0,457,150,151,1
"8956d210ae7f41968fada86d4c979d6a","8956d210ae7f41968fada86d4c979d6a",22928179,5,0,1,458,151,151,0
"8956d210ae7f41968fada86d4c979d6a","f902b0f41b544d4dbf79664fd233648d",22928179,1,-5,0,463,151,146,-5
"f902b0f41b544d4dbf79664fd233648d","ae781e8b775e4ccd93bc800dad5c8376",22928179,1,8,0,464,146,153,7
"ae781e8b775e4ccd93bc800dad5c8376","ae781e8b775e4ccd93bc800dad5c8376",22928179,2,0,1,465,153,153,0
"ae781e8b775e4ccd93bc800dad5c8376","06882a8492d9499aa31555567f575ecb",22928179,1,1,0,467,153,154,1
"06882a8492d9499aa31555567f575ecb","06882a8492d9499aa31555567f575ecb",22928179,1,0,1,468,154,154,0
"06882a8492d9499aa31555567f575ecb","f293c508f409466a8f27ddd7d1e40b20",22928179,1,1,0,469,154,155,1
"f293c508f409466a8f27ddd7d1e40b20","f293c508f409466a8f27ddd7d1e40b20",22928179,3,0,1,470,155,155,0
"f293c508f409466a8f27ddd7d1e40b20","cc4ddef5bbbe48ebb605141b347c4ed1",22928179,1,1,0,473,155,156,1
"cc4ddef5bbbe48ebb605141b347c4ed1","cc4ddef5bbbe48ebb605141b347c4ed1",22928179,1,0,1,474,156,156,0
"cc4ddef5bbbe48ebb605141b347c4ed1","d313cec988a84645bee413e8d4724a4b",22928179,1,3,0,475,156,158,2
"d313cec988a84645bee413e8d4724a4b","f03480cf4eba413194d7af52fc0e7f28",22928179,1,-7,0,476,158,152,-6
"f03480cf4eba413194d7af52fc0e7f28","d313cec988a84645bee413e8d4724a4b",22928179,1,7,0,477,152,158,6
"d313cec988a84645bee413e8d4724a4b","d313cec988a84645bee413e8d4724a4b",22928179,5,0,1,478,158,158,0
"d313cec988a84645bee413e8d4724a4b","dc60696c76a74368a60f72246e47700d",22928179,1,1,0,481,158,159,1
"dc60696c76a74368a60f72246e47700d","dc60696c76a74368a60f72246e47700d",22928179,1,0,1,482,159,159,0
"dc60696c76a74368a60f72246e47700d","df1de691dafe4549a18a4398ee9dfaf9",22928179,1,-23,0,483,159,139,-20
"df1de691dafe4549a18a4398ee9dfaf9","78adeee1fa2c4fe0bc73f7bca9fcee86",22928179,1,26,0,484,139,160,21
"78adeee1fa2c4fe0bc73f7bca9fcee86","67a089198fcb4e1c8f2385786c2b296f",22928179,2,-152,0,485,160,39,-121
"67a089198fcb4e1c8f2385786c2b296f","3cbcea2be0984e7dbd5a48195af10ce7",22928179,2,160,0,489,39,165,126
"3cbcea2be0984e7dbd5a48195af10ce7","3cbcea2be0984e7dbd5a48195af10ce7",22928179,2,0,1,490,165,165,0
"3cbcea2be0984e7dbd5a48195af10ce7","82e6285962b8400d9d6fc32436022a94",22928179,4,2,0,491,165,167,2
"82e6285962b8400d9d6fc32436022a94","67a089198fcb4e1c8f2385786c2b296f",22928179,2,-162,0,492,167,39,-128
"78adeee1fa2c4fe0bc73f7bca9fcee86","3cbcea2be0984e7dbd5a48195af10ce7",22928179,1,8,0,498,160,165,5
"82e6285962b8400d9d6fc32436022a94","78adeee1fa2c4fe0bc73f7bca9fcee86",22928179,1,-10,0,501,167,160,-7
"78adeee1fa2c4fe0bc73f7bca9fcee86","df1de691dafe4549a18a4398ee9dfaf9",22928179,1,-26,0,503,160,139,-21
"df1de691dafe4549a18a4398ee9dfaf9","d313cec988a84645bee413e8d4724a4b",22928179,1,22,0,504,139,158,19
"d313cec988a84645bee413e8d4724a4b","67a089198fcb4e1c8f2385786c2b296f",22928179,1,-148,0,507,158,39,-119
"65202579580f4ad38d734b4ee39d22a8","3cbcea2be0984e7dbd5a48195af10ce7",22928179,1,3,0,519,164,165,1
"3cbcea2be0984e7dbd5a48195af10ce7","78adeee1fa2c4fe0bc73f7bca9fcee86",22928179,1,-8,0,520,165,160,-5
"78adeee1fa2c4fe0bc73f7bca9fcee86","82e6285962b8400d9d6fc32436022a94",22928179,1,10,0,521,160,167,7
"82e6285962b8400d9d6fc32436022a94","a9ac840f098c4bd0a2ee896214ce29cd",22928179,1,3,0,522,167,168,1
"a9ac840f098c4bd0a2ee896214ce29cd","3cbcea2be0984e7dbd5a48195af10ce7",22928179,1,-5,0,523,168,165,-3
"3cbcea2be0984e7dbd5a48195af10ce7","a9ac840f098c4bd0a2ee896214ce29cd",22928179,1,5,0,524,165,168,3
"a9ac840f098c4bd0a2ee896214ce29cd","0c7262dff33c4087bc660ccf40f92f9c",22928179,2,4,0,525,168,169,1
"0c7262dff33c4087bc660ccf40f92f9c","b2275c3fad834f8d90737a2d9a6927d6",22928179,7,3,0,526,169,172,3
"b2275c3fad834f8d90737a2d9a6927d6","a9ac840f098c4bd0a2ee896214ce29cd",22928179,1,-7,0,527,172,168,-4
"a9ac840f098c4bd0a2ee896214ce29cd","a9ac840f098c4bd0a2ee896214ce29cd",22928179,1,0,1,528,168,168,0
"b2275c3fad834f8d90737a2d9a6927d6","0c7262dff33c4087bc660ccf40f92f9c",22928179,3,-3,0,531,172,169,-3
"0c7262dff33c4087bc660ccf40f92f9c","67a089198fcb4e1c8f2385786c2b296f",22928179,1,-169,0,532,169,39,-130
"67a089198fcb4e1c8f2385786c2b296f","0c7262dff33c4087bc660ccf40f92f9c",22928179,1,169,0,533,39,169,130
"b2275c3fad834f8d90737a2d9a6927d6","b2275c3fad834f8d90737a2d9a6927d6",22928179,41,0,1,536,172,172,0
"b2275c3fad834f8d90737a2d9a6927d6","3cbcea2be0984e7dbd5a48195af10ce7",22928179,1,-12,0,556,172,165,-7
"82e6285962b8400d9d6fc32436022a94","0c7262dff33c4087bc660ccf40f92f9c",22928179,1,7,0,558,167,169,2
"b2275c3fad834f8d90737a2d9a6927d6","eb515a26030b41f8a82a1e6114420bad",22928179,1,1,0,584,172,173,1
"eb515a26030b41f8a82a1e6114420bad","eb515a26030b41f8a82a1e6114420bad",22928179,5,0,1,585,173,173,0
"eb515a26030b41f8a82a1e6114420bad","0c7262dff33c4087bc660ccf40f92f9c",22928179,1,-4,0,590,173,169,-4
"0c7262dff33c4087bc660ccf40f92f9c","b42cc17b7de840f181a704558d0bc845",22928179,1,7,0,591,169,175,6
"b42cc17b7de840f181a704558d0bc845","b42cc17b7de840f181a704558d0bc845",22928179,1,0,1,592,175,175,0
"b42cc17b7de840f181a704558d0bc845","801f9e9135034f49bf5f8b4bdefedb41",22928179,1,2,0,593,175,177,2
"801f9e9135034f49bf5f8b4bdefedb41","801f9e9135034f49bf5f8b4bdefedb41",22928179,7,0,1,594,177,177,0
"801f9e9135034f49bf5f8b4bdefedb41","ea38cc0e6e6e41edbabf210220808bf9",22928179,1,3,0,597,177,179,2
"ea38cc0e6e6e41edbabf210220808bf9","362fcb0699a14845ab29b2340093e528",22928179,1,-6,0,598,179,174,-5
"362fcb0699a14845ab29b2340093e528","b87c552dd247427abe6ab5795b9c9d43",22928179,1,8,0,599,174,181,7
"b87c552dd247427abe6ab5795b9c9d43","b42cc17b7de840f181a704558d0bc845",22928179,1,-7,0,600,181,175,-6
"b42cc17b7de840f181a704558d0bc845","139b097acfca451689d80c9c6eebdf7b",22928179,1,4,0,601,175,178,3
"139b097acfca451689d80c9c6eebdf7b","801f9e9135034f49bf5f8b4bdefedb41",22928179,1,-2,0,602,178,177,-1
"801f9e9135034f49bf5f8b4bdefedb41","362fcb0699a14845ab29b2340093e528",22928179,1,-3,0,607,177,174,-3
"362fcb0699a14845ab29b2340093e528","ea38cc0e6e6e41edbabf210220808bf9",22928179,1,6,0,608,174,179,5
"ea38cc0e6e6e41edbabf210220808bf9","b87c552dd247427abe6ab5795b9c9d43",22928179,4,2,0,609,179,181,2
"b87c552dd247427abe6ab5795b9c9d43","0c7262dff33c4087bc660ccf40f92f9c",22928179,1,-14,0,610,181,169,-12
"0c7262dff33c4087bc660ccf40f92f9c","ea38cc0e6e6e41edbabf210220808bf9",22928179,2,12,0,613,169,179,10
"b87c552dd247427abe6ab5795b9c9d43","78adeee1fa2c4fe0bc73f7bca9fcee86",22928179,1,-31,0,615,181,160,-21
"78adeee1fa2c4fe0bc73f7bca9fcee86","139b097acfca451689d80c9c6eebdf7b",22928179,1,28,0,627,160,178,18
"139b097acfca451689d80c9c6eebdf7b","0c7262dff33c4087bc660ccf40f92f9c",22928179,1,-11,0,628,178,169,-9
"b87c552dd247427abe6ab5795b9c9d43","ea38cc0e6e6e41edbabf210220808bf9",22928179,1,-2,0,631,181,179,-2
"ea38cc0e6e6e41edbabf210220808bf9","ea38cc0e6e6e41edbabf210220808bf9",22928179,2,0,1,632,179,179,0
"b87c552dd247427abe6ab5795b9c9d43","b87c552dd247427abe6ab5795b9c9d43",22928179,13,0,1,635,181,181,0
"b87c552dd247427abe6ab5795b9c9d43","139b097acfca451689d80c9c6eebdf7b",22928179,1,-3,0,648,181,178,-3
"139b097acfca451689d80c9c6eebdf7b","30f660a1feb34582a739722532524f79",22928179,1,6,0,649,178,183,5
"30f660a1feb34582a739722532524f79","30f660a1feb34582a739722532524f79",22928179,5,0,1,650,183,183,0
"30f660a1feb34582a739722532524f79","2024b4885bd14338a39b7b509acbbd02",22928179,1,-1,0,655,183,182,-1
"2024b4885bd14338a39b7b509acbbd02","c3f63fe50d8e487c86bf8ef76c9cadd3",22928179,1,4,0,656,182,185,3
"c3f63fe50d8e487c86bf8ef76c9cadd3","c3f63fe50d8e487c86bf8ef76c9cadd3",22928179,1,0,1,657,185,185,0
"c3f63fe50d8e487c86bf8ef76c9cadd3","0c7262dff33c4087bc660ccf40f92f9c",22928179,1,-20,0,658,185,169,-16
"0c7262dff33c4087bc660ccf40f92f9c","c8e371568a0c4391b25796ae4e91952e",22928179,3,23,0,659,169,186,17
"c8e371568a0c4391b25796ae4e91952e","0c7262dff33c4087bc660ccf40f92f9c",22928179,2,-23,0,660,186,169,-17
"0c7262dff33c4087bc660ccf40f92f9c","0d987bed3ffa4ed0b9a2e62e97b7b30f",22928179,2,135,0,663,169,272,103
"0d987bed3ffa4ed0b9a2e62e97b7b30f","0d987bed3ffa4ed0b9a2e62e97b7b30f",22928179,1,0,1,664,272,272,0
"0d987bed3ffa4ed0b9a2e62e97b7b30f","0c7262dff33c4087bc660ccf40f92f9c",22928179,2,-135,0,665,272,169,-103
"c8e371568a0c4391b25796ae4e91952e","c8e371568a0c4391b25796ae4e91952e",22928179,1,0,1,669,186,186,0
"c8e371568a0c4391b25796ae4e91952e","7d932b23e1c84326ae5aa4d3c0d813d1",22928179,1,2,0,670,186,188,2
"7d932b23e1c84326ae5aa4d3c0d813d1","7d932b23e1c84326ae5aa4d3c0d813d1",22928179,3,0,1,671,188,188,0
"7d932b23e1c84326ae5aa4d3c0d813d1","c8e371568a0c4391b25796ae4e91952e",22928179,1,-2,0,674,188,186,-2
"c8e371568a0c4391b25796ae4e91952e","ab11d94c6c8948ea90b88f19d2cd502b",22928179,1,5,0,675,186,190,4
"ab11d94c6c8948ea90b88f19d2cd502b","ab11d94c6c8948ea90b88f19d2cd502b",22928179,3,0,1,676,190,190,0
"ab11d94c6c8948ea90b88f19d2cd502b","f992451ed6ad4e68bb9e68ad6be7c4be",22928179,1,2,0,679,190,192,2
"f992451ed6ad4e68bb9e68ad6be7c4be","f992451ed6ad4e68bb9e68ad6be7c4be",22928179,1,0,1,680,192,192,0
"f992451ed6ad4e68bb9e68ad6be7c4be","6cd2dcaac46847d4a0bc53f296d90375",22928179,1,3,0,681,192,194,2
"6cd2dcaac46847d4a0bc53f296d90375","07b44a7a51e94c78b411c753fc39dab0",22928179,1,-6,0,682,194,189,-5
"07b44a7a51e94c78b411c753fc39dab0","6cd2dcaac46847d4a0bc53f296d90375",22928179,1,6,0,683,189,194,5
"6cd2dcaac46847d4a0bc53f296d90375","2d2580c9411c4972909db508d6956a58",22928179,1,2,0,684,194,196,2
"2d2580c9411c4972909db508d6956a58","2d2580c9411c4972909db508d6956a58",22928179,8,0,1,685,196,196,0
"2d2580c9411c4972909db508d6956a58","5bddb3d9ed264f3984702f048c7e5340",22928179,1,1,0,693,196,197,1
"5bddb3d9ed264f3984702f048c7e5340","5bddb3d9ed264f3984702f048c7e5340",22928179,2,0,1,694,197,197,0
"5bddb3d9ed264f3984702f048c7e5340","d5e8e2bd12a2466b9d6d90855f0eb079",22928179,1,1,0,696,197,198,1
"d5e8e2bd12a2466b9d6d90855f0eb079","d5e8e2bd12a2466b9d6d90855f0eb079",22928179,2,0,1,697,198,198,0
"d5e8e2bd12a2466b9d6d90855f0eb079","017d7ca8e0394b91aaadc9574df2202c",22928179,1,-5,0,699,198,193,-5
"017d7ca8e0394b91aaadc9574df2202c","54e8e9f0ea3e45c4bf3b8ac799ee31b1",22928179,1,8,0,700,193,200,7
"54e8e9f0ea3e45c4bf3b8ac799ee31b1","54e8e9f0ea3e45c4bf3b8ac799ee31b1",22928179,1,0,1,701,200,200,0
"54e8e9f0ea3e45c4bf3b8ac799ee31b1","c614a00911be4877a075f19315530fb0",22928179,1,1,0,702,200,201,1
"c614a00911be4877a075f19315530fb0","c614a00911be4877a075f19315530fb0",22928179,6,0,1,703,201,201,0
"c614a00911be4877a075f19315530fb0","a6c21bd8b95249c7972820a7a7d76aff",22928179,1,1,0,709,201,202,1
"a6c21bd8b95249c7972820a7a7d76aff","a6c21bd8b95249c7972820a7a7d76aff",22928179,1,0,1,710,202,202,0
"a6c21bd8b95249c7972820a7a7d76aff","bb329d880ab54120adaf203a693bb203",22928179,1,1,0,711,202,203,1
"bb329d880ab54120adaf203a693bb203","bb329d880ab54120adaf203a693bb203",22928179,1,0,1,712,203,203,0
"bb329d880ab54120adaf203a693bb203","f9170dd6bc6442b4acd832747609b09a",22928179,1,-4,0,713,203,199,-4
"f9170dd6bc6442b4acd832747609b09a","334c2344009840079b1d0e1b7ce3d5a7",22928179,1,7,0,714,199,205,6
"334c2344009840079b1d0e1b7ce3d5a7","334c2344009840079b1d0e1b7ce3d5a7",22928179,1,0,1,715,205,205,0
"334c2344009840079b1d0e1b7ce3d5a7","c8e371568a0c4391b25796ae4e91952e",22928179,1,-23,0,716,205,186,-19
"c8e371568a0c4391b25796ae4e91952e","d7f13c8d63ec4e2aa673fbb9cf9c6933",22928179,1,26,0,717,186,206,20
"d7f13c8d63ec4e2aa673fbb9cf9c6933","7108f0e4c2584f1f9c471689ae4c885c",22928179,2,2,0,718,206,208,2
"7108f0e4c2584f1f9c471689ae4c885c","b9e80f77c3a44349863b19875725c384",22928179,3,-1,0,719,208,207,-1
"b9e80f77c3a44349863b19875725c384","d7f13c8d63ec4e2aa673fbb9cf9c6933",22928179,2,-1,0,720,207,206,-1
"d7f13c8d63ec4e2aa673fbb9cf9c6933","b9e80f77c3a44349863b19875725c384",22928179,2,1,0,721,206,207,1
"b9e80f77c3a44349863b19875725c384","7108f0e4c2584f1f9c471689ae4c885c",22928179,3,1,0,722,207,208,1
"7108f0e4c2584f1f9c471689ae4c885c","0c7262dff33c4087bc660ccf40f92f9c",22928179,1,-51,0,723,208,169,-39
"0c7262dff33c4087bc660ccf40f92f9c","d7f13c8d63ec4e2aa673fbb9cf9c6933",22928179,2,49,0,724,169,206,37
"d7f13c8d63ec4e2aa673fbb9cf9c6933","d7f13c8d63ec4e2aa673fbb9cf9c6933",22928179,1,0,1,725,206,206,0
"b9e80f77c3a44349863b19875725c384","b9e80f77c3a44349863b19875725c384",22928179,28,0,1,729,207,207,0
"7108f0e4c2584f1f9c471689ae4c885c","7108f0e4c2584f1f9c471689ae4c885c",22928179,12,0,1,761,208,208,0
"7108f0e4c2584f1f9c471689ae4c885c","09400e101c5d4b439cf9a26b03aae558",22928179,1,3,0,773,208,210,2
"09400e101c5d4b439cf9a26b03aae558","d7f13c8d63ec4e2aa673fbb9cf9c6933",22928179,1,-5,0,774,210,206,-4
"d7f13c8d63ec4e2aa673fbb9cf9c6933","09400e101c5d4b439cf9a26b03aae558",22928179,1,5,0,775,206,210,4
"09400e101c5d4b439cf9a26b03aae558","09400e101c5d4b439cf9a26b03aae558",22928179,7,0,1,776,210,210,0
"09400e101c5d4b439cf9a26b03aae558","a88efa7e50ce47159810ab553afa6d3a",22928179,1,2,0,783,210,212,2
"a88efa7e50ce47159810ab553afa6d3a","a88efa7e50ce47159810ab553afa6d3a",22928179,14,0,1,784,212,212,0
"a88efa7e50ce47159810ab553afa6d3a","a875096404ef4a9984b62d74cda916f9",22928179,1,-3,0,798,212,209,-3
"a875096404ef4a9984b62d74cda916f9","be502a7a43c44bf7b682698de79d9369",22928179,1,6,0,799,209,214,5
"be502a7a43c44bf7b682698de79d9369","f7fb1952f56b4189b86a9f8b7862d2b8",22928179,2,1,0,800,214,215,1
"f7fb1952f56b4189b86a9f8b7862d2b8","be502a7a43c44bf7b682698de79d9369",22928179,1,-1,0,801,215,214,-1
"be502a7a43c44bf7b682698de79d9369","be502a7a43c44bf7b682698de79d9369",22928179,6,0,1,802,214,214,0
"f7fb1952f56b4189b86a9f8b7862d2b8","f7fb1952f56b4189b86a9f8b7862d2b8",22928179,13,0,1,809,215,215,0
"f7fb1952f56b4189b86a9f8b7862d2b8","b860ee85d8bc4a2f97958cfb71be3533",22928179,1,1,0,822,215,216,1
"b860ee85d8bc4a2f97958cfb71be3533","b860ee85d8bc4a2f97958cfb71be3533",22928179,2,0,1,823,216,216,0
"b860ee85d8bc4a2f97958cfb71be3533","ec341f459285443b8361f7f15638ff08",22928179,1,-3,0,825,216,213,-3
"ec341f459285443b8361f7f15638ff08","363837c182e04711840d896ae1e0339c",22928179,1,6,0,826,213,218,5
"363837c182e04711840d896ae1e0339c","363837c182e04711840d896ae1e0339c",22928179,21,0,1,827,218,218,0
"363837c182e04711840d896ae1e0339c","01b2051f8941460d89945e3b02d1ce78",22928179,1,-1,0,848,218,217,-1
"01b2051f8941460d89945e3b02d1ce78","91125ca626c5470eb145501f8c37f8db",22928179,1,4,0,849,217,220,3
"91125ca626c5470eb145501f8c37f8db","91125ca626c5470eb145501f8c37f8db",22928179,1,0,1,850,220,220,0
"91125ca626c5470eb145501f8c37f8db","1c6721b1f63f4d30ba7746ea8af02a52",22928179,1,3,0,851,220,221,1
"1c6721b1f63f4d30ba7746ea8af02a52","d7f13c8d63ec4e2aa673fbb9cf9c6933",22928179,1,-21,0,852,221,206,-15
"d7f13c8d63ec4e2aa673fbb9cf9c6933","77ecef8eff6b4a2caea7707669bf7475",22928179,1,22,0,853,206,222,16
"77ecef8eff6b4a2caea7707669bf7475","0c7262dff33c4087bc660ccf40f92f9c",22928179,2,-71,0,854,222,169,-53
"0c7262dff33c4087bc660ccf40f92f9c","1c6721b1f63f4d30ba7746ea8af02a52",22928179,1,70,0,855,169,221,52
"1c6721b1f63f4d30ba7746ea8af02a52","1c6721b1f63f4d30ba7746ea8af02a52",22928179,2,0,1,856,221,221,0
"1c6721b1f63f4d30ba7746ea8af02a52","77ecef8eff6b4a2caea7707669bf7475",22928179,2,1,0,857,221,222,1
"b2275c3fad834f8d90737a2d9a6927d6","1c6721b1f63f4d30ba7746ea8af02a52",22928179,1,67,0,861,172,221,49
"77ecef8eff6b4a2caea7707669bf7475","77ecef8eff6b4a2caea7707669bf7475",22928179,12,0,1,864,222,222,0
"77ecef8eff6b4a2caea7707669bf7475","1c6721b1f63f4d30ba7746ea8af02a52",22928179,1,-1,0,876,222,221,-1
"1c6721b1f63f4d30ba7746ea8af02a52","d03cb855c70044cf8c35d9ec0de696e3",22928179,1,4,0,877,221,224,3
"d03cb855c70044cf8c35d9ec0de696e3","8b9ae98743bd4d4a8a87dff1c1244211",22928179,1,3,0,878,224,227,3
"8b9ae98743bd4d4a8a87dff1c1244211","d03cb855c70044cf8c35d9ec0de696e3",22928179,1,-3,0,879,227,224,-3
"d03cb855c70044cf8c35d9ec0de696e3","a49a937d6896486d9a5396654abcf2e1",22928179,1,2,0,880,224,226,2
"a49a937d6896486d9a5396654abcf2e1","a49a937d6896486d9a5396654abcf2e1",22928179,3,0,1,881,226,226,0
"a49a937d6896486d9a5396654abcf2e1","8b9ae98743bd4d4a8a87dff1c1244211",22928179,1,1,0,884,226,227,1
"8b9ae98743bd4d4a8a87dff1c1244211","8b9ae98743bd4d4a8a87dff1c1244211",22928179,17,0,1,885,227,227,0
"8b9ae98743bd4d4a8a87dff1c1244211","2ab1535aac1346ba8801535bf729ef37",22928179,1,3,0,902,227,229,2
"2ab1535aac1346ba8801535bf729ef37","f7906d6f59b9489a91d2ef40db5a474d",22928179,1,-7,0,903,229,223,-6
"f7906d6f59b9489a91d2ef40db5a474d","2ab1535aac1346ba8801535bf729ef37",22928179,1,7,0,904,223,229,6
"2ab1535aac1346ba8801535bf729ef37","2ab1535aac1346ba8801535bf729ef37",22928179,2,0,1,905,229,229,0
"2ab1535aac1346ba8801535bf729ef37","a4f40fb48a8542c8949bae1f002cd9bc",22928179,1,2,0,907,229,231,2
"a4f40fb48a8542c8949bae1f002cd9bc","a4f40fb48a8542c8949bae1f002cd9bc",22928179,2,0,1,908,231,231,0
"a4f40fb48a8542c8949bae1f002cd9bc","8972c23e32044edb8a78fa1eed4e5947",22928179,1,1,0,910,231,232,1
"8972c23e32044edb8a78fa1eed4e5947","8972c23e32044edb8a78fa1eed4e5947",22928179,3,0,1,911,232,232,0
"8972c23e32044edb8a78fa1eed4e5947","92feb4a40f8344d38b6f722e42a53295",22928179,1,1,0,914,232,233,1
"92feb4a40f8344d38b6f722e42a53295","92feb4a40f8344d38b6f722e42a53295",22928179,2,0,1,915,233,233,0
"92feb4a40f8344d38b6f722e42a53295","5152833676bf4c6cb317060be10f68db",22928179,1,-5,0,917,233,228,-5
"5152833676bf4c6cb317060be10f68db","ca3e28f290354c08aefe5b0f769604e6",22928179,1,8,0,918,228,235,7
"ca3e28f290354c08aefe5b0f769604e6","ca3e28f290354c08aefe5b0f769604e6",22928179,9,0,1,919,235,235,0
"ca3e28f290354c08aefe5b0f769604e6","79a35eea833e4c2c9d22fc53c3c6445c",22928179,1,1,0,928,235,236,1
"79a35eea833e4c2c9d22fc53c3c6445c","79a35eea833e4c2c9d22fc53c3c6445c",22928179,9,0,1,929,236,236,0
"79a35eea833e4c2c9d22fc53c3c6445c","8f68228b1518449e9615cdafee41a2bd",22928179,1,1,0,938,236,237,1
"8f68228b1518449e9615cdafee41a2bd","8f68228b1518449e9615cdafee41a2bd",22928179,1,0,1,939,237,237,0
"8f68228b1518449e9615cdafee41a2bd","cab89fa5c3ed45a5aa550fc0352d6a42",22928179,1,1,0,940,237,238,1
"cab89fa5c3ed45a5aa550fc0352d6a42","cab89fa5c3ed45a5aa550fc0352d6a42",22928179,6,0,1,941,238,238,0
"cab89fa5c3ed45a5aa550fc0352d6a42","66d4fad4f1cf4b46be0750a99ad7a35a",22928179,1,1,0,947,238,239,1
"66d4fad4f1cf4b46be0750a99ad7a35a","66d4fad4f1cf4b46be0750a99ad7a35a",22928179,1,0,1,948,239,239,0
"66d4fad4f1cf4b46be0750a99ad7a35a","0b04c8e2f86d48c7aeb7e225819cd32b",22928179,1,-5,0,949,239,234,-5
"0b04c8e2f86d48c7aeb7e225819cd32b","f53da5fd9bfe412da4b80d4742563b6c",22928179,1,8,0,950,234,241,7
"f53da5fd9bfe412da4b80d4742563b6c","f53da5fd9bfe412da4b80d4742563b6c",22928179,1,0,1,951,241,241,0
"f53da5fd9bfe412da4b80d4742563b6c","1c6721b1f63f4d30ba7746ea8af02a52",22928179,1,-24,0,952,241,221,-20
"1c6721b1f63f4d30ba7746ea8af02a52","2ae94c0cea4d480a9d5dca8fb1d7b542",22928179,1,27,0,953,221,242,21
"1ebf23f9d994469a85206e4c7b1bf5f5","0c7262dff33c4087bc660ccf40f92f9c",22928179,1,-100,0,959,245,169,-76
"d7f13c8d63ec4e2aa673fbb9cf9c6933","01b2051f8941460d89945e3b02d1ce78",22928179,1,14,0,961,206,217,11
"01b2051f8941460d89945e3b02d1ce78","363837c182e04711840d896ae1e0339c",22928179,1,1,0,962,217,218,1
"363837c182e04711840d896ae1e0339c","0c7262dff33c4087bc660ccf40f92f9c",22928179,1,-64,0,963,218,169,-49
"0c7262dff33c4087bc660ccf40f92f9c","2ae94c0cea4d480a9d5dca8fb1d7b542",22928179,1,97,0,964,169,242,73
"1ebf23f9d994469a85206e4c7b1bf5f5","1ebf23f9d994469a85206e4c7b1bf5f5",22928179,10,0,1,967,245,245,0
"1ebf23f9d994469a85206e4c7b1bf5f5","85ae675b83e8422da842cfd25596af99",22928179,1,1,0,977,245,246,1
"85ae675b83e8422da842cfd25596af99","85ae675b83e8422da842cfd25596af99",22928179,1,0,1,978,246,246,0
"85ae675b83e8422da842cfd25596af99","fa235f0f364d47e4ae1c87f47bf8e6ba",22928179,1,8,0,979,246,252,6
"fa235f0f364d47e4ae1c87f47bf8e6ba","2ae94c0cea4d480a9d5dca8fb1d7b542",22928179,1,-12,0,980,252,242,-10
"fa235f0f364d47e4ae1c87f47bf8e6ba","fa235f0f364d47e4ae1c87f47bf8e6ba",22928179,1,0,1,982,252,252,0
"00f61990949545828dd12f1303d47504","00f61990949545828dd12f1303d47504",22928179,1,0,1,988,256,256,0
"00f61990949545828dd12f1303d47504","ead7bb4b64e247d2ae632ab8a296b091",22928179,1,2,0,989,256,258,2
"ead7bb4b64e247d2ae632ab8a296b091","ead7bb4b64e247d2ae632ab8a296b091",22928179,2,0,1,990,258,258,0
"ead7bb4b64e247d2ae632ab8a296b091","41b0048dde734bb280bac6116baa8e27",22928179,1,1,0,992,258,259,1
"41b0048dde734bb280bac6116baa8e27","41b0048dde734bb280bac6116baa8e27",22928179,2,0,1,993,259,259,0
"41b0048dde734bb280bac6116baa8e27","b41c5a094a604ee0915327da5cc0beb7",22928179,1,1,0,995,259,260,1
"b41c5a094a604ee0915327da5cc0beb7","b41c5a094a604ee0915327da5cc0beb7",22928179,5,0,1,1000,260,260,0
"b41c5a094a604ee0915327da5cc0beb7","d546341988904f069cfa86b21457d9d9",22928179,1,-10,0,1001,260,251,-9
"d546341988904f069cfa86b21457d9d9","28c171777c52431ab6b925073bd63d46",22928179,1,15,0,1002,251,264,13
"28c171777c52431ab6b925073bd63d46","28c171777c52431ab6b925073bd63d46",22928179,7,0,1,1003,264,264,0
"28c171777c52431ab6b925073bd63d46","ac160db940cb49ae8579162b1d52bb5d",22928179,1,2,0,1010,264,266,2
"ac160db940cb49ae8579162b1d52bb5d","ac160db940cb49ae8579162b1d52bb5d",22928179,3,0,1,1011,266,266,0
"ac160db940cb49ae8579162b1d52bb5d","d989ebcfc12a4b669f0100dc1aa14f1e",22928179,1,-12,0,1014,266,255,-11
"d989ebcfc12a4b669f0100dc1aa14f1e","c6fd49b485cc4874b0bbdd9c6171e09c",22928179,1,15,0,1015,255,268,13
"c6fd49b485cc4874b0bbdd9c6171e09c","c6fd49b485cc4874b0bbdd9c6171e09c",22928179,3,0,1,1016,268,268,0
"c6fd49b485cc4874b0bbdd9c6171e09c","44240778a97c4af0937817499b75707b",22928179,1,1,0,1019,268,269,1
"44240778a97c4af0937817499b75707b","44240778a97c4af0937817499b75707b",22928179,2,0,1,1020,269,269,0
"44240778a97c4af0937817499b75707b","7aa76d3e993840d8805f097cbdbcd44b",22928179,1,-9,0,1022,269,261,-8
"7aa76d3e993840d8805f097cbdbcd44b","865a4d3b43374da7944dc7d397f566d9",22928179,1,12,0,1023,261,271,10
"865a4d3b43374da7944dc7d397f566d9","865a4d3b43374da7944dc7d397f566d9",22928179,3,0,1,1024,271,271,0
"865a4d3b43374da7944dc7d397f566d9","0d987bed3ffa4ed0b9a2e62e97b7b30f",22928179,1,3,0,1027,271,272,1
"0d987bed3ffa4ed0b9a2e62e97b7b30f","2ae94c0cea4d480a9d5dca8fb1d7b542",22928179,2,-38,0,1028,272,242,-30
"2ae94c0cea4d480a9d5dca8fb1d7b542","0c7262dff33c4087bc660ccf40f92f9c",22928179,1,-97,0,1029,242,169,-73
"0c7262dff33c4087bc660ccf40f92f9c","0c7262dff33c4087bc660ccf40f92f9c",22928179,4,0,1,1030,169,169,0
"0c7262dff33c4087bc660ccf40f92f9c","d546341988904f069cfa86b21457d9d9",22928179,1,108,0,1031,169,251,82
"d546341988904f069cfa86b21457d9d9","2ae94c0cea4d480a9d5dca8fb1d7b542",22928179,2,-11,0,1032,251,242,-9
"2ae94c0cea4d480a9d5dca8fb1d7b542","00f61990949545828dd12f1303d47504",22928179,2,17,0,1033,242,256,14
"00f61990949545828dd12f1303d47504","d546341988904f069cfa86b21457d9d9",22928179,3,-6,0,1034,256,251,-5
"d546341988904f069cfa86b21457d9d9","fa235f0f364d47e4ae1c87f47bf8e6ba",22928179,2,1,0,1035,251,252,1
"fa235f0f364d47e4ae1c87f47bf8e6ba","6e83e23f56544a19b94067c1c558d9c0",22928179,2,-6,0,1036,252,247,-5
"6e83e23f56544a19b94067c1c558d9c0","00f61990949545828dd12f1303d47504",22928179,4,11,0,1037,247,256,9
"d546341988904f069cfa86b21457d9d9","d989ebcfc12a4b669f0100dc1aa14f1e",22928179,1,5,0,1039,251,255,4
"d989ebcfc12a4b669f0100dc1aa14f1e","1ebf23f9d994469a85206e4c7b1bf5f5",22928179,1,-13,0,1040,255,245,-10
"1ebf23f9d994469a85206e4c7b1bf5f5","2ae94c0cea4d480a9d5dca8fb1d7b542",22928179,4,-3,0,1041,245,242,-3
"2ae94c0cea4d480a9d5dca8fb1d7b542","fa235f0f364d47e4ae1c87f47bf8e6ba",22928179,3,12,0,1042,242,252,10
"00f61990949545828dd12f1303d47504","2ae94c0cea4d480a9d5dca8fb1d7b542",22928179,1,-17,0,1045,256,242,-14
"2ae94c0cea4d480a9d5dca8fb1d7b542","d989ebcfc12a4b669f0100dc1aa14f1e",22928179,1,16,0,1046,242,255,13
"d989ebcfc12a4b669f0100dc1aa14f1e","fa235f0f364d47e4ae1c87f47bf8e6ba",22928179,1,-4,0,1047,255,252,-3
"fa235f0f364d47e4ae1c87f47bf8e6ba","79f7845465cc4ed19d8e4f1429541be0",22928179,3,2,0,1048,252,254,2
"79f7845465cc4ed19d8e4f1429541be0","00f61990949545828dd12f1303d47504",22928179,1,3,0,1049,254,256,2
"00f61990949545828dd12f1303d47504","6e83e23f56544a19b94067c1c558d9c0",22928179,2,-11,0,1050,256,247,-9
"6e83e23f56544a19b94067c1c558d9c0","d546341988904f069cfa86b21457d9d9",22928179,1,5,0,1051,247,251,4
"79f7845465cc4ed19d8e4f1429541be0","79f7845465cc4ed19d8e4f1429541be0",22928179,4,0,1,1054,254,254,0
"79f7845465cc4ed19d8e4f1429541be0","6e83e23f56544a19b94067c1c558d9c0",22928179,2,-8,0,1056,254,247,-7
"d546341988904f069cfa86b21457d9d9","7aa76d3e993840d8805f097cbdbcd44b",22928179,1,12,0,1059,251,261,10
"7aa76d3e993840d8805f097cbdbcd44b","2ae94c0cea4d480a9d5dca8fb1d7b542",22928179,1,-23,0,1060,261,242,-19
"2ae94c0cea4d480a9d5dca8fb1d7b542","0d987bed3ffa4ed0b9a2e62e97b7b30f",22928179,1,38,0,1061,242,272,30
"2ae94c0cea4d480a9d5dca8fb1d7b542","1ebf23f9d994469a85206e4c7b1bf5f5",22928179,8,3,0,1063,242,245,3
"1ebf23f9d994469a85206e4c7b1bf5f5","0d987bed3ffa4ed0b9a2e62e97b7b30f",22928179,1,35,0,1064,245,272,27
"0d987bed3ffa4ed0b9a2e62e97b7b30f","d989ebcfc12a4b669f0100dc1aa14f1e",22928179,1,-22,0,1065,272,255,-17
"d989ebcfc12a4b669f0100dc1aa14f1e","2ae94c0cea4d480a9d5dca8fb1d7b542",22928179,1,-16,0,1066,255,242,-13
"2ae94c0cea4d480a9d5dca8fb1d7b542","d546341988904f069cfa86b21457d9d9",22928179,1,11,0,1067,242,251,9
"00f61990949545828dd12f1303d47504","0d987bed3ffa4ed0b9a2e62e97b7b30f",22928179,1,21,0,1070,256,272,16
"0d987bed3ffa4ed0b9a2e62e97b7b30f","82ae07bc0c9b4570a41799290d1ef399",22928179,1,4,0,1071,272,275,3
"82ae07bc0c9b4570a41799290d1ef399","0d987bed3ffa4ed0b9a2e62e97b7b30f",22928179,1,-4,0,1072,275,272,-3
"0d987bed3ffa4ed0b9a2e62e97b7b30f","bb5a47f5ea01454a8b79455422d3b9da",22928179,1,10,0,1073,272,280,8
"bb5a47f5ea01454a8b79455422d3b9da","bb5a47f5ea01454a8b79455422d3b9da",22928179,62,0,1,1074,280,280,0
"bb5a47f5ea01454a8b79455422d3b9da","82ae07bc0c9b4570a41799290d1ef399",22928179,2,-6,0,1081,280,275,-5
"82ae07bc0c9b4570a41799290d1ef399","bb5a47f5ea01454a8b79455422d3b9da",22928179,2,6,0,1082,275,280,5
"bb5a47f5ea01454a8b79455422d3b9da","bc5524e78a8544e2ae2fdc2f3462bbec",22928179,1,-1,0,1084,280,279,-1
"bc5524e78a8544e2ae2fdc2f3462bbec","bb5a47f5ea01454a8b79455422d3b9da",22928179,1,1,0,1085,279,280,1
"bb5a47f5ea01454a8b79455422d3b9da","94cecc3f1e7d484b8e068e79241dfd73",22928179,1,3,0,1142,280,281,1
"94cecc3f1e7d484b8e068e79241dfd73","0d987bed3ffa4ed0b9a2e62e97b7b30f",22928179,1,-13,0,1143,281,272,-9
"0d987bed3ffa4ed0b9a2e62e97b7b30f","a37477c4e4c14169ad44b06b493007f6",22928179,1,15,0,1144,272,283,11
"a37477c4e4c14169ad44b06b493007f6","fab84b4fab5940efb4ea868ef8d09396",22928179,1,3,0,1145,283,284,1
"fab84b4fab5940efb4ea868ef8d09396","94cecc3f1e7d484b8e068e79241dfd73",22928179,1,-5,0,1146,284,281,-3
"94cecc3f1e7d484b8e068e79241dfd73","fab84b4fab5940efb4ea868ef8d09396",22928179,1,5,0,1147,281,284,3
"fab84b4fab5940efb4ea868ef8d09396","4a29443515bb404cb8924e1c60a63b73",22928179,1,4,0,1148,284,285,1
"4a29443515bb404cb8924e1c60a63b73","208c9b2796c944db8dacaa96082520ea",22928179,2,3,0,1149,285,288,3
"208c9b2796c944db8dacaa96082520ea","2ae94c0cea4d480a9d5dca8fb1d7b542",22928179,1,-63,0,1150,288,242,-46
"2ae94c0cea4d480a9d5dca8fb1d7b542","2ae94c0cea4d480a9d5dca8fb1d7b542",22928179,2,0,1,1151,242,242,0
"fa235f0f364d47e4ae1c87f47bf8e6ba","00f61990949545828dd12f1303d47504",22928179,1,5,0,1155,252,256,4
"6e83e23f56544a19b94067c1c558d9c0","78adeee1fa2c4fe0bc73f7bca9fcee86",22928179,1,-120,0,1157,247,160,-87
"78adeee1fa2c4fe0bc73f7bca9fcee86","78adeee1fa2c4fe0bc73f7bca9fcee86",22928179,9,0,1,1158,160,160,0
"78adeee1fa2c4fe0bc73f7bca9fcee86","e2911e79efc2420eac45d9f671463d4b",22928179,1,-221,0,1159,160,2,-158
"e2911e79efc2420eac45d9f671463d4b","e2911e79efc2420eac45d9f671463d4b",22928179,4,0,1,1160,2,2,0
"b613861cecf84ffcab01afb23f660475","e2911e79efc2420eac45d9f671463d4b",22928179,3,3,0,1163,1,2,1
"b613861cecf84ffcab01afb23f660475","56586aa865414f538729c7f7735d2bc6",22928179,1,15,0,1165,1,12,11
"56586aa865414f538729c7f7735d2bc6","e2911e79efc2420eac45d9f671463d4b",22928179,1,-12,0,1166,12,2,-10
"e2911e79efc2420eac45d9f671463d4b","56586aa865414f538729c7f7735d2bc6",22928179,2,12,0,1167,2,12,10
"56586aa865414f538729c7f7735d2bc6","56586aa865414f538729c7f7735d2bc6",22928179,6,0,1,1168,12,12,0
"56586aa865414f538729c7f7735d2bc6","b7f2b31585d94eb3bf86376714aa7070",22928179,2,2,0,1169,12,13,1
"b7f2b31585d94eb3bf86376714aa7070","b7f2b31585d94eb3bf86376714aa7070",22928179,3,0,1,1170,13,13,0
"b7f2b31585d94eb3bf86376714aa7070","3f1c815879794b929260d224becaff7e",22928179,2,2,0,1171,13,14,1
"3f1c815879794b929260d224becaff7e","78adeee1fa2c4fe0bc73f7bca9fcee86",22928179,1,205,0,1172,14,160,146
"78adeee1fa2c4fe0bc73f7bca9fcee86","b534b89233134e30a9b5645138bfa9ee",22928179,1,-148,0,1174,160,41,-119
"b534b89233134e30a9b5645138bfa9ee","d9c8d8c444a64dadbbb508652c721e17",22928179,1,6,0,1175,41,46,5
"d9c8d8c444a64dadbbb508652c721e17","6e13d61a7bdb44bca949c9f86fab3be5",22928179,1,1,0,1176,46,47,1
"6e13d61a7bdb44bca949c9f86fab3be5","b534b89233134e30a9b5645138bfa9ee",22928179,2,-7,0,1177,47,41,-6
"b534b89233134e30a9b5645138bfa9ee","d646286c8051419bbc2e31dd1db55ca8",22928179,2,33,0,1178,41,67,26
"d646286c8051419bbc2e31dd1db55ca8","d18a9ea32855445f8736581f5cb119ce",22928179,2,17,0,1179,67,82,15
"d18a9ea32855445f8736581f5cb119ce","d18a9ea32855445f8736581f5cb119ce",22928179,1,0,1,1180,82,82,0
"d18a9ea32855445f8736581f5cb119ce","ae5ac430ea254e708a6f5deaaf7464ae",22928179,1,3,0,1181,82,84,2
"ae5ac430ea254e708a6f5deaaf7464ae","6a9f0ef185fb47f0937e29daa1c71ed5",22928179,3,7,0,1182,84,90,6
"6a9f0ef185fb47f0937e29daa1c71ed5","6a9f0ef185fb47f0937e29daa1c71ed5",22928179,5,0,1,1183,90,90,0
"6a9f0ef185fb47f0937e29daa1c71ed5","d646286c8051419bbc2e31dd1db55ca8",22928179,2,-27,0,1185,90,67,-23
"d646286c8051419bbc2e31dd1db55ca8","e20db35ced8544ddac5bc3839145e463",22928179,2,30,0,1186,67,91,24
"e20db35ced8544ddac5bc3839145e463","e20db35ced8544ddac5bc3839145e463",22928179,3,0,1,1187,91,91,0
"e20db35ced8544ddac5bc3839145e463","00ae5f0c51874a73a41ebea838d95682",22928179,1,11,0,1188,91,101,10
"00ae5f0c51874a73a41ebea838d95682","d391c8b6e56a43a7b654e9dee02d904b",22928179,2,2,0,1189,101,103,2
"d391c8b6e56a43a7b654e9dee02d904b","73039f8c1eb9409cb4caee2cf968001e",22928179,1,-3,0,1190,103,100,-3
"73039f8c1eb9409cb4caee2cf968001e","4280927ec4d643238aa49c32f9e06c6c",22928179,2,10,0,1191,100,109,9
"4280927ec4d643238aa49c32f9e06c6c","08111f75e22d409998cf8b85bd431f0a",22928179,1,-1,0,1192,109,108,-1
"08111f75e22d409998cf8b85bd431f0a","a9ae0a3c070d455bb4369a8996313336",22928179,2,7,0,1193,108,114,6
"a9ae0a3c070d455bb4369a8996313336","37319e88176d4aefa91d7a9980dbae91",22928179,2,-2,0,1194,114,112,-2
"37319e88176d4aefa91d7a9980dbae91","62bff51286ef4f348717a3cf6fe2318f",22928179,2,9,0,1195,112,120,8
"62bff51286ef4f348717a3cf6fe2318f","62bff51286ef4f348717a3cf6fe2318f",22928179,5,0,1,1196,120,120,0
"62bff51286ef4f348717a3cf6fe2318f","779f9ddd1fd14d1e9e69f72219a1fdbd",22928179,2,3,0,1198,120,121,1
"779f9ddd1fd14d1e9e69f72219a1fdbd","e20db35ced8544ddac5bc3839145e463",22928179,2,-36,0,1199,121,91,-30
"e20db35ced8544ddac5bc3839145e463","779f9ddd1fd14d1e9e69f72219a1fdbd",22928179,1,36,0,1200,91,121,30
"779f9ddd1fd14d1e9e69f72219a1fdbd","a8dd5213034441ac92724b4e83eb0bb2",22928179,2,9,0,1201,121,129,8
"a8dd5213034441ac92724b4e83eb0bb2","579338175e0b4bbb8ef3b712b5d8b54e",22928179,1,-1,0,1202,129,128,-1
"579338175e0b4bbb8ef3b712b5d8b54e","b416d47c56a742199b5d7c7f19d6503a",22928179,1,7,0,1203,128,134,6
"b416d47c56a742199b5d7c7f19d6503a","67a089198fcb4e1c8f2385786c2b296f",22928179,1,-118,0,1204,134,39,-95
"67a089198fcb4e1c8f2385786c2b296f","73039f8c1eb9409cb4caee2cf968001e",22928179,1,77,0,1205,39,100,61
"73039f8c1eb9409cb4caee2cf968001e","e20db35ced8544ddac5bc3839145e463",22928179,1,-10,0,1206,100,91,-9
"e20db35ced8544ddac5bc3839145e463","d391c8b6e56a43a7b654e9dee02d904b",22928179,2,13,0,1207,91,103,12
"d391c8b6e56a43a7b654e9dee02d904b","00ae5f0c51874a73a41ebea838d95682",22928179,2,-2,0,1208,103,101,-2
"00ae5f0c51874a73a41ebea838d95682","67a089198fcb4e1c8f2385786c2b296f",22928179,1,-78,0,1209,101,39,-62
"67a089198fcb4e1c8f2385786c2b296f","78adeee1fa2c4fe0bc73f7bca9fcee86",22928179,4,152,0,1210,39,160,121
"78adeee1fa2c4fe0bc73f7bca9fcee86","65202579580f4ad38d734b4ee39d22a8",22928179,6,5,0,1212,160,164,4
"65202579580f4ad38d734b4ee39d22a8","65202579580f4ad38d734b4ee39d22a8",22928179,73,0,1,1213,164,164,0
"65202579580f4ad38d734b4ee39d22a8","78adeee1fa2c4fe0bc73f7bca9fcee86",22928179,3,-5,0,1214,164,160,-4
"65202579580f4ad38d734b4ee39d22a8","2ae94c0cea4d480a9d5dca8fb1d7b542",22928179,1,109,0,1266,164,242,78
"1ebf23f9d994469a85206e4c7b1bf5f5","78adeee1fa2c4fe0bc73f7bca9fcee86",22928179,1,-117,0,1268,245,160,-85
"65202579580f4ad38d734b4ee39d22a8","67a089198fcb4e1c8f2385786c2b296f",22928179,1,-157,0,1279,164,39,-125
"67a089198fcb4e1c8f2385786c2b296f","4a29443515bb404cb8924e1c60a63b73",22928179,1,326,0,1280,39,285,246
"4a29443515bb404cb8924e1c60a63b73","4a29443515bb404cb8924e1c60a63b73",22928179,3,0,1,1281,285,285,0
"208c9b2796c944db8dacaa96082520ea","208c9b2796c944db8dacaa96082520ea",22928179,1,0,1,1283,288,288,0
"208c9b2796c944db8dacaa96082520ea","4a29443515bb404cb8924e1c60a63b73",22928179,1,-3,0,1284,288,285,-3
"4a29443515bb404cb8924e1c60a63b73","7669a956527947d0add87455277e80b4",22928179,1,7,0,1285,285,291,6
"7669a956527947d0add87455277e80b4","7669a956527947d0add87455277e80b4",22928179,1,0,1,1286,291,291,0
"7669a956527947d0add87455277e80b4","6a9a3b5bde4a48daa896fe8c06eca56f",22928179,1,-2,0,1287,291,289,-2
"6a9a3b5bde4a48daa896fe8c06eca56f","869e967078f04da18dd0b0b9389a7424",22928179,2,5,0,1288,289,293,4
"869e967078f04da18dd0b0b9389a7424","869e967078f04da18dd0b0b9389a7424",22928179,9,0,1,1289,293,293,0
"869e967078f04da18dd0b0b9389a7424","51ab6291537748fab90d519aa09889d6",22928179,1,2,0,1295,293,295,2
"51ab6291537748fab90d519aa09889d6","51ab6291537748fab90d519aa09889d6",22928179,5,0,1,1296,295,295,0
"51ab6291537748fab90d519aa09889d6","34a6e49023fc4465bd5ca604330bbd1c",22928179,1,-3,0,1301,295,292,-3
"34a6e49023fc4465bd5ca604330bbd1c","ba0e59461bfb4a44b7b1c28a01f8d3b3",22928179,2,9,0,1302,292,299,7
"ba0e59461bfb4a44b7b1c28a01f8d3b3","21592f2a9e9c4b2f8c66ec5dbcbf6a2b",22928179,2,-4,0,1303,299,296,-3
"21592f2a9e9c4b2f8c66ec5dbcbf6a2b","ba0e59461bfb4a44b7b1c28a01f8d3b3",22928179,1,4,0,1304,296,299,3
"ba0e59461bfb4a44b7b1c28a01f8d3b3","0e0b36e731a645e7b1b8a88f5031ca38",22928179,1,2,0,1305,299,301,2
"0e0b36e731a645e7b1b8a88f5031ca38","0e0b36e731a645e7b1b8a88f5031ca38",22928179,5,0,1,1306,301,301,0
"0e0b36e731a645e7b1b8a88f5031ca38","a66a144637284c21afc6de17fea4bfb8",22928179,1,1,0,1311,301,302,1
"a66a144637284c21afc6de17fea4bfb8","a66a144637284c21afc6de17fea4bfb8",22928179,2,0,1,1312,302,302,0
"a66a144637284c21afc6de17fea4bfb8","7646a919d7e64fa990bca9b024ff089d",22928179,1,-4,0,1314,302,298,-4
"7646a919d7e64fa990bca9b024ff089d","e390b575229748ea8aac9364efe2bf00",22928179,1,7,0,1315,298,304,6
"e390b575229748ea8aac9364efe2bf00","e390b575229748ea8aac9364efe2bf00",22928179,1,0,1,1316,304,304,0
"e390b575229748ea8aac9364efe2bf00","3434c10e561d488a914e0f7d71907abd",22928179,1,3,0,1317,304,305,1
"3434c10e561d488a914e0f7d71907abd","4a29443515bb404cb8924e1c60a63b73",22928179,1,-27,0,1318,305,285,-20
"4a29443515bb404cb8924e1c60a63b73","53e7e900392747ccad52e711ab0f80d8",22928179,1,29,0,1319,285,307,22
"53e7e900392747ccad52e711ab0f80d8","4a29443515bb404cb8924e1c60a63b73",22928179,1,-29,0,1320,307,285,-22
"4a29443515bb404cb8924e1c60a63b73","2c5bb2cbd0014420ad8c95d40e38efd1",22928179,1,23,0,1322,285,303,18
"2c5bb2cbd0014420ad8c95d40e38efd1","869e967078f04da18dd0b0b9389a7424",22928179,1,-13,0,1323,303,293,-10
"869e967078f04da18dd0b0b9389a7424","34a6e49023fc4465bd5ca604330bbd1c",22928179,2,-1,0,1324,293,292,-1
"21592f2a9e9c4b2f8c66ec5dbcbf6a2b","7646a919d7e64fa990bca9b024ff089d",22928179,1,3,0,1327,296,298,2
"7646a919d7e64fa990bca9b024ff089d","4a29443515bb404cb8924e1c60a63b73",22928179,1,-17,0,1328,298,285,-13
"4a29443515bb404cb8924e1c60a63b73","3434c10e561d488a914e0f7d71907abd",22928179,2,27,0,1329,285,305,20
"3434c10e561d488a914e0f7d71907abd","53e7e900392747ccad52e711ab0f80d8",22928179,4,2,0,1330,305,307,2
"53e7e900392747ccad52e711ab0f80d8","3434c10e561d488a914e0f7d71907abd",22928179,2,-2,0,1331,307,305,-2
"53e7e900392747ccad52e711ab0f80d8","2ae94c0cea4d480a9d5dca8fb1d7b542",22928179,1,-89,0,1333,307,242,-65
"1ebf23f9d994469a85206e4c7b1bf5f5","6a9a3b5bde4a48daa896fe8c06eca56f",22928179,1,62,0,1335,245,289,44
"6a9a3b5bde4a48daa896fe8c06eca56f","4a29443515bb404cb8924e1c60a63b73",22928179,1,-5,0,1336,289,285,-4
"4a29443515bb404cb8924e1c60a63b73","6a9a3b5bde4a48daa896fe8c06eca56f",22928179,1,5,0,1337,285,289,4
"34a6e49023fc4465bd5ca604330bbd1c","4a29443515bb404cb8924e1c60a63b73",22928179,1,-9,0,1343,292,285,-7
"3434c10e561d488a914e0f7d71907abd","3434c10e561d488a914e0f7d71907abd",22928179,2,0,1,1345,305,305,0
"53e7e900392747ccad52e711ab0f80d8","53e7e900392747ccad52e711ab0f80d8",22928179,2,0,1,1347,307,307,0
"3434c10e561d488a914e0f7d71907abd","130acc2aeb0448fdbb2de63bc5cebe5b",22928179,1,5,0,1350,305,309,4
"130acc2aeb0448fdbb2de63bc5cebe5b","130acc2aeb0448fdbb2de63bc5cebe5b",22928179,1,0,1,1351,309,309,0
"130acc2aeb0448fdbb2de63bc5cebe5b","9c062b3251034ebe90f5054e2a3b5120",22928179,1,2,0,1352,309,311,2
"9c062b3251034ebe90f5054e2a3b5120","9c062b3251034ebe90f5054e2a3b5120",22928179,2,0,1,1353,311,311,0
"9c062b3251034ebe90f5054e2a3b5120","ea859f8207e44537889daeaba13ac2e8",22928179,1,1,0,1355,311,312,1
"ea859f8207e44537889daeaba13ac2e8","ea859f8207e44537889daeaba13ac2e8",22928179,1,0,1,1356,312,312,0
"ea859f8207e44537889daeaba13ac2e8","56d94971a7a94257aa330183a8ebd0ea",22928179,1,1,0,1357,312,313,1
"56d94971a7a94257aa330183a8ebd0ea","56d94971a7a94257aa330183a8ebd0ea",22928179,1,0,1,1358,313,313,0
"56d94971a7a94257aa330183a8ebd0ea","141c0df6cd1946539aadd1c9b7068cd4",22928179,1,-5,0,1359,313,308,-5
"141c0df6cd1946539aadd1c9b7068cd4","13255e63e0aa4abf85e5211bf613d43e",22928179,1,10,0,1360,308,317,9
"13255e63e0aa4abf85e5211bf613d43e","13255e63e0aa4abf85e5211bf613d43e",22928179,1,0,1,1361,317,317,0
"13255e63e0aa4abf85e5211bf613d43e","86c27d40179e419c8e9d150fb6afa5d0",22928179,1,3,0,1362,317,319,2
"86c27d40179e419c8e9d150fb6afa5d0","0c787d16c9504873b1a4d903cec09948",22928179,1,-6,0,1363,319,314,-5
"0c787d16c9504873b1a4d903cec09948","86c27d40179e419c8e9d150fb6afa5d0",22928179,1,6,0,1364,314,319,5
"86c27d40179e419c8e9d150fb6afa5d0","3434c10e561d488a914e0f7d71907abd",22928179,3,-17,0,1365,319,305,-14
"53e7e900392747ccad52e711ab0f80d8","86c27d40179e419c8e9d150fb6afa5d0",22928179,1,15,0,1367,307,319,12
"3434c10e561d488a914e0f7d71907abd","86c27d40179e419c8e9d150fb6afa5d0",22928179,2,17,0,1370,305,319,14
"86c27d40179e419c8e9d150fb6afa5d0","8d7e0b55cf9849cda222a0f2440cec55",22928179,1,-1,0,1373,319,318,-1
"8d7e0b55cf9849cda222a0f2440cec55","24f1363179ad4aaa965484a78471912b",22928179,2,6,0,1374,318,323,5
"24f1363179ad4aaa965484a78471912b","47edbb64109243e6b0f8f64cdef90c6c",22928179,2,3,0,1375,323,326,3
"47edbb64109243e6b0f8f64cdef90c6c","24f1363179ad4aaa965484a78471912b",22928179,1,-3,0,1376,326,323,-3
"24f1363179ad4aaa965484a78471912b","86c27d40179e419c8e9d150fb6afa5d0",22928179,1,-5,0,1377,323,319,-4
"86c27d40179e419c8e9d150fb6afa5d0","3628bdce1dd2429ba924d2d4d09448d2",22928179,1,4,0,1378,319,322,3
"3628bdce1dd2429ba924d2d4d09448d2","8d7e0b55cf9849cda222a0f2440cec55",22928179,1,-5,0,1379,322,318,-4
"47edbb64109243e6b0f8f64cdef90c6c","3628bdce1dd2429ba924d2d4d09448d2",22928179,1,-4,0,1382,326,322,-4
"3628bdce1dd2429ba924d2d4d09448d2","56b3fd1a212a4764be39d979fde3326e",22928179,1,7,0,1383,322,328,6
"56b3fd1a212a4764be39d979fde3326e","56b3fd1a212a4764be39d979fde3326e",22928179,1,0,1,1384,328,328,0
"56b3fd1a212a4764be39d979fde3326e","0c4079457ede49e3aeb5e86ed84bdf35",22928179,1,3,0,1385,328,329,1
"0c4079457ede49e3aeb5e86ed84bdf35","3434c10e561d488a914e0f7d71907abd",22928179,1,-31,0,1386,329,305,-24
"3434c10e561d488a914e0f7d71907abd","38aea304b4fa46e1b29bb72f5cea4c93",22928179,1,33,0,1387,305,331,26
"38aea304b4fa46e1b29bb72f5cea4c93","4a29443515bb404cb8924e1c60a63b73",22928179,1,-60,0,1388,331,285,-46
"4a29443515bb404cb8924e1c60a63b73","0c4079457ede49e3aeb5e86ed84bdf35",22928179,1,58,0,1389,285,329,44
"0c4079457ede49e3aeb5e86ed84bdf35","38aea304b4fa46e1b29bb72f5cea4c93",22928179,1,2,0,1390,329,331,2
"38aea304b4fa46e1b29bb72f5cea4c93","38aea304b4fa46e1b29bb72f5cea4c93",22928179,1,0,1,1391,331,331,0
"38aea304b4fa46e1b29bb72f5cea4c93","e36d261332f14e79bb4b467aceaeb9b5",22928179,1,2,0,1392,331,333,2
"e36d261332f14e79bb4b467aceaeb9b5","e36d261332f14e79bb4b467aceaeb9b5",22928179,1,0,1,1393,333,333,0
"e36d261332f14e79bb4b467aceaeb9b5","c7e89b9d04744d2eab742fc24e3ef1ae",22928179,1,1,0,1394,333,334,1
"c7e89b9d04744d2eab742fc24e3ef1ae","c7e89b9d04744d2eab742fc24e3ef1ae",22928179,6,0,1,1395,334,334,0
"c7e89b9d04744d2eab742fc24e3ef1ae","fe49f8054b374a0ea4bb266ed135ff62",22928179,1,1,0,1401,334,335,1
"fe49f8054b374a0ea4bb266ed135ff62","fe49f8054b374a0ea4bb266ed135ff62",22928179,2,0,1,1402,335,335,0
"fe49f8054b374a0ea4bb266ed135ff62","d0a8f74af98642fe8360d22c42e45117",22928179,1,1,0,1404,335,336,1
"d0a8f74af98642fe8360d22c42e45117","d0a8f74af98642fe8360d22c42e45117",22928179,2,0,1,1405,336,336,0
"d0a8f74af98642fe8360d22c42e45117","0c4079457ede49e3aeb5e86ed84bdf35",22928179,1,-7,0,1407,336,329,-7
"0c4079457ede49e3aeb5e86ed84bdf35","a7c6339ca1da4368a18d471f0519f877",22928179,1,11,0,1408,329,339,10
"a7c6339ca1da4368a18d471f0519f877","a7c6339ca1da4368a18d471f0519f877",22928179,1,0,1,1409,339,339,0
"a7c6339ca1da4368a18d471f0519f877","b8b9418ab322418d9db9b40d96af873a",22928179,1,-2,0,1410,339,337,-2
"b8b9418ab322418d9db9b40d96af873a","bbc5139ca9024389a94db3a6f47dcff6",22928179,1,5,0,1411,337,341,4
"bbc5139ca9024389a94db3a6f47dcff6","bbc5139ca9024389a94db3a6f47dcff6",22928179,1,0,1,1412,341,341,0
"bbc5139ca9024389a94db3a6f47dcff6","4ee6ca9019ab4a1ab323f98094a9bd77",22928179,1,2,0,1413,341,343,2
"4ee6ca9019ab4a1ab323f98094a9bd77","4ee6ca9019ab4a1ab323f98094a9bd77",22928179,2,0,1,1414,343,343,0
"4ee6ca9019ab4a1ab323f98094a9bd77","b37947176785476f8b29d49a851366dc",22928179,1,1,0,1416,343,344,1
"b37947176785476f8b29d49a851366dc","b37947176785476f8b29d49a851366dc",22928179,2,0,1,1417,344,344,0
"b37947176785476f8b29d49a851366dc","fcea5b10d5a14a3b9324ffece8f6e1e5",22928179,1,1,0,1419,344,345,1
"fcea5b10d5a14a3b9324ffece8f6e1e5","fcea5b10d5a14a3b9324ffece8f6e1e5",22928179,2,0,1,1420,345,345,0
"fcea5b10d5a14a3b9324ffece8f6e1e5","c2490bc612d146edbe786556fab3651b",22928179,1,-5,0,1422,345,340,-5
"c2490bc612d146edbe786556fab3651b","bbc5139ca9024389a94db3a6f47dcff6",22928179,1,1,0,1423,340,341,1
"bbc5139ca9024389a94db3a6f47dcff6","4a92daef4d504e1792575a26502bb7b7",22928179,1,6,0,1424,341,346,5
"4a92daef4d504e1792575a26502bb7b7","c2490bc612d146edbe786556fab3651b",22928179,1,-7,0,1425,346,340,-6
"c2490bc612d146edbe786556fab3651b","4a92daef4d504e1792575a26502bb7b7",22928179,1,7,0,1426,340,346,6
"4a92daef4d504e1792575a26502bb7b7","38aea304b4fa46e1b29bb72f5cea4c93",22928179,1,-18,0,1427,346,331,-15
"38aea304b4fa46e1b29bb72f5cea4c93","0c4079457ede49e3aeb5e86ed84bdf35",22928179,1,-2,0,1428,331,329,-2
"0c4079457ede49e3aeb5e86ed84bdf35","6ac8bb048b854999a47edb35fe627f11",22928179,1,21,0,1429,329,347,18
"6ac8bb048b854999a47edb35fe627f11","6ac8bb048b854999a47edb35fe627f11",22928179,1,0,1,1430,347,347,0
"6ac8bb048b854999a47edb35fe627f11","30ead9794d4847abaf222ca966cc8630",22928179,1,3,0,1431,347,348,1
"30ead9794d4847abaf222ca966cc8630","0c4079457ede49e3aeb5e86ed84bdf35",22928179,1,-24,0,1432,348,329,-19
"0c4079457ede49e3aeb5e86ed84bdf35","c20993c944444fe085345591a8bd837e",22928179,1,27,0,1433,329,351,22
"c20993c944444fe085345591a8bd837e","eff0de7f2dbb42dfa1a2e686efab5b6d",22928179,1,3,0,1434,351,354,3
"eff0de7f2dbb42dfa1a2e686efab5b6d","09b9678ddc3d452ea4a3d46e15826065",22928179,3,-1,0,1435,354,353,-1
"09b9678ddc3d452ea4a3d46e15826065","897b7f51242c44aab2205c72fdcbf4cd",22928179,2,-1,0,1436,353,352,-1
"897b7f51242c44aab2205c72fdcbf4cd","4a29443515bb404cb8924e1c60a63b73",22928179,1,-86,0,1437,352,285,-67
"4a29443515bb404cb8924e1c60a63b73","30ead9794d4847abaf222ca966cc8630",22928179,1,82,0,1438,285,348,63
"30ead9794d4847abaf222ca966cc8630","eff0de7f2dbb42dfa1a2e686efab5b6d",22928179,1,6,0,1439,348,354,6
"897b7f51242c44aab2205c72fdcbf4cd","c20993c944444fe085345591a8bd837e",22928179,1,-1,0,1442,352,351,-1
"c20993c944444fe085345591a8bd837e","c20993c944444fe085345591a8bd837e",22928179,5,0,1,1443,351,351,0
"c20993c944444fe085345591a8bd837e","897b7f51242c44aab2205c72fdcbf4cd",22928179,1,1,0,1447,351,352,1
"897b7f51242c44aab2205c72fdcbf4cd","897b7f51242c44aab2205c72fdcbf4cd",22928179,5,0,1,1448,352,352,0
"897b7f51242c44aab2205c72fdcbf4cd","09b9678ddc3d452ea4a3d46e15826065",22928179,1,1,0,1451,352,353,1
"09b9678ddc3d452ea4a3d46e15826065","09b9678ddc3d452ea4a3d46e15826065",22928179,4,0,1,1452,353,353,0
"09b9678ddc3d452ea4a3d46e15826065","eff0de7f2dbb42dfa1a2e686efab5b6d",22928179,1,1,0,1455,353,354,1
"eff0de7f2dbb42dfa1a2e686efab5b6d","eff0de7f2dbb42dfa1a2e686efab5b6d",22928179,4,0,1,1456,354,354,0
"eff0de7f2dbb42dfa1a2e686efab5b6d","30ead9794d4847abaf222ca966cc8630",22928179,1,-6,0,1459,354,348,-6
"30ead9794d4847abaf222ca966cc8630","2fe14166dc9642c3bc666b86a57f943d",22928179,1,10,0,1460,348,357,9
"2fe14166dc9642c3bc666b86a57f943d","2fe14166dc9642c3bc666b86a57f943d",22928179,1,0,1,1461,357,357,0
"2fe14166dc9642c3bc666b86a57f943d","44421dd1e13a47a388c4a19834b744c7",22928179,1,2,0,1462,357,359,2
"44421dd1e13a47a388c4a19834b744c7","44421dd1e13a47a388c4a19834b744c7",22928179,2,0,1,1463,359,359,0
"44421dd1e13a47a388c4a19834b744c7","cb5fc7ef85d547c4be1a7439d0bf6052",22928179,1,1,0,1465,359,360,1
"cb5fc7ef85d547c4be1a7439d0bf6052","cb5fc7ef85d547c4be1a7439d0bf6052",22928179,2,0,1,1466,360,360,0
"cb5fc7ef85d547c4be1a7439d0bf6052","0a8f150a4cf747acbde62f4721823da3",22928179,1,1,0,1468,360,361,1
"0a8f150a4cf747acbde62f4721823da3","0a8f150a4cf747acbde62f4721823da3",22928179,2,0,1,1469,361,361,0
"0a8f150a4cf747acbde62f4721823da3","ab8fdad974ae471f9f24c3f9dd04462e",22928179,1,1,0,1471,361,362,1
"ab8fdad974ae471f9f24c3f9dd04462e","ab8fdad974ae471f9f24c3f9dd04462e",22928179,2,0,1,1472,362,362,0
"ab8fdad974ae471f9f24c3f9dd04462e","1ba8fef685d74a8194b9db252eb704fb",22928179,1,-7,0,1474,362,355,-7
"1ba8fef685d74a8194b9db252eb704fb","52580888dadb4fe3baa795683ea227bd",22928179,1,10,0,1475,355,364,9
"52580888dadb4fe3baa795683ea227bd","52580888dadb4fe3baa795683ea227bd",22928179,1,0,1,1476,364,364,0
"52580888dadb4fe3baa795683ea227bd","f00179e251a045b39c3f7a54f9aa4acc",22928179,1,-1,0,1477,364,363,-1
"f00179e251a045b39c3f7a54f9aa4acc","492a3bc6a1254f23a7998587961b22a4",22928179,1,4,0,1478,363,366,3
"492a3bc6a1254f23a7998587961b22a4","492a3bc6a1254f23a7998587961b22a4",22928179,1,0,1,1479,366,366,0
"492a3bc6a1254f23a7998587961b22a4","072a190fd302456290895f9f04d6940a",22928179,1,-1,0,1480,366,365,-1
"072a190fd302456290895f9f04d6940a","eff0de7f2dbb42dfa1a2e686efab5b6d",22928179,1,-14,0,1481,365,354,-11
"09b9678ddc3d452ea4a3d46e15826065","c20993c944444fe085345591a8bd837e",22928179,1,-2,0,1484,353,351,-2
"c20993c944444fe085345591a8bd837e","09b9678ddc3d452ea4a3d46e15826065",22928179,1,2,0,1486,351,353,2
"09b9678ddc3d452ea4a3d46e15826065","c76574d21bc14aeea7ecd0b027f39858",22928179,1,18,0,1488,353,367,14
"c76574d21bc14aeea7ecd0b027f39858","897b7f51242c44aab2205c72fdcbf4cd",22928179,1,-19,0,1489,367,352,-15
"897b7f51242c44aab2205c72fdcbf4cd","eff0de7f2dbb42dfa1a2e686efab5b6d",22928179,1,2,0,1492,352,354,2
"eff0de7f2dbb42dfa1a2e686efab5b6d","c20993c944444fe085345591a8bd837e",22928179,1,-3,0,1493,354,351,-3
"c20993c944444fe085345591a8bd837e","30ead9794d4847abaf222ca966cc8630",22928179,1,-3,0,1494,351,348,-3
"30ead9794d4847abaf222ca966cc8630","cfa457d1743848e4bb5e4beced6448ed",22928179,1,25,0,1495,348,369,21
"cfa457d1743848e4bb5e4beced6448ed","cfa457d1743848e4bb5e4beced6448ed",22928179,1,0,1,1496,369,369,0
"cfa457d1743848e4bb5e4beced6448ed","b71bac264efb4abd97015447bd490db6",22928179,1,3,0,1497,369,370,1
"b71bac264efb4abd97015447bd490db6","30ead9794d4847abaf222ca966cc8630",22928179,1,-28,0,1498,370,348,-22
"30ead9794d4847abaf222ca966cc8630","b71bac264efb4abd97015447bd490db6",22928179,1,28,0,1499,348,370,22
"b71bac264efb4abd97015447bd490db6","b71bac264efb4abd97015447bd490db6",22928179,1,0,1,1500,370,370,0
"b71bac264efb4abd97015447bd490db6","8d448d625b024c82a5eb240bbd7431d6",22928179,7,5,0,1501,370,374,4
"8d448d625b024c82a5eb240bbd7431d6","8d448d625b024c82a5eb240bbd7431d6",22928179,80,0,1,1502,374,374,0
"8d448d625b024c82a5eb240bbd7431d6","b71bac264efb4abd97015447bd490db6",22928179,4,-5,0,1508,374,370,-4
"8d448d625b024c82a5eb240bbd7431d6","1b4550d0dab04078b3bf08a655345bdc",22928179,1,-1,0,1510,374,373,-1
"1b4550d0dab04078b3bf08a655345bdc","b71bac264efb4abd97015447bd490db6",22928179,1,-4,0,1511,373,370,-3
"8d448d625b024c82a5eb240bbd7431d6","d6d02b6ef04e4f17805504500b8ce441",22928179,2,3,0,1538,374,375,1
"d6d02b6ef04e4f17805504500b8ce441","8d448d625b024c82a5eb240bbd7431d6",22928179,1,-3,0,1539,375,374,-1
"d6d02b6ef04e4f17805504500b8ce441","d6d02b6ef04e4f17805504500b8ce441",22928179,8,0,1,1547,375,375,0
"d6d02b6ef04e4f17805504500b8ce441","b71bac264efb4abd97015447bd490db6",22928179,2,-8,0,1548,375,370,-5
"b71bac264efb4abd97015447bd490db6","4a29443515bb404cb8924e1c60a63b73",22928179,1,-110,0,1549,370,285,-85
"4a29443515bb404cb8924e1c60a63b73","b71bac264efb4abd97015447bd490db6",22928179,2,110,0,1551,285,370,85
"b71bac264efb4abd97015447bd490db6","d6d02b6ef04e4f17805504500b8ce441",22928179,2,8,0,1583,370,375,5
"d6d02b6ef04e4f17805504500b8ce441","66baf19b6b904b70922329068c63746d",22928179,1,4,0,1586,375,376,1
"66baf19b6b904b70922329068c63746d","7f544639412e40a9ba27f43b415362ab",22928179,2,2,0,1587,376,378,2
"7f544639412e40a9ba27f43b415362ab","66baf19b6b904b70922329068c63746d",22928179,1,-2,0,1588,378,376,-2
"66baf19b6b904b70922329068c63746d","d6d02b6ef04e4f17805504500b8ce441",22928179,1,-4,0,1589,376,375,-1
"d6d02b6ef04e4f17805504500b8ce441","4a29443515bb404cb8924e1c60a63b73",22928179,1,-118,0,1593,375,285,-90
"8d448d625b024c82a5eb240bbd7431d6","4a29443515bb404cb8924e1c60a63b73",22928179,1,-115,0,1618,374,285,-89
"4a29443515bb404cb8924e1c60a63b73","66baf19b6b904b70922329068c63746d",22928179,1,122,0,1619,285,376,91
"7f544639412e40a9ba27f43b415362ab","7f544639412e40a9ba27f43b415362ab",22928179,1,0,1,1621,378,378,0
"7f544639412e40a9ba27f43b415362ab","d5ae8642e15b46b8bd298b02274d4e9c",22928179,1,2,0,1622,378,380,2
"d5ae8642e15b46b8bd298b02274d4e9c","d5ae8642e15b46b8bd298b02274d4e9c",22928179,1,0,1,1623,380,380,0
"d5ae8642e15b46b8bd298b02274d4e9c","a0d10309a2dd456289147f84be9d37f9",22928179,1,1,0,1624,380,381,1
"a0d10309a2dd456289147f84be9d37f9","a0d10309a2dd456289147f84be9d37f9",22928179,2,0,1,1625,381,381,0
"a0d10309a2dd456289147f84be9d37f9","0fcbc3ca07b144138b8d85da581f09a8",22928179,1,1,0,1627,381,382,1
"0fcbc3ca07b144138b8d85da581f09a8","0fcbc3ca07b144138b8d85da581f09a8",22928179,2,0,1,1628,382,382,0
"0fcbc3ca07b144138b8d85da581f09a8","66baf19b6b904b70922329068c63746d",22928179,1,-6,0,1630,382,376,-6
"66baf19b6b904b70922329068c63746d","c2fca3669923477ab966ded303dea31c",22928179,1,8,0,1631,376,383,7
"c2fca3669923477ab966ded303dea31c","4890121ce5d74576b4632b77cfc23398",22928179,1,6,0,1632,383,388,5
"4890121ce5d74576b4632b77cfc23398","4890121ce5d74576b4632b77cfc23398",22928179,1,0,1,1633,388,388,0
"4890121ce5d74576b4632b77cfc23398","18d3b836dd804224883cc9180b60a8e1",22928179,1,-1,0,1634,388,387,-1
"18d3b836dd804224883cc9180b60a8e1","96bb2b3e85a34d8b9544514e89f6fe97",22928179,1,4,0,1635,387,390,3
"96bb2b3e85a34d8b9544514e89f6fe97","96bb2b3e85a34d8b9544514e89f6fe97",22928179,1,0,1,1636,390,390,0
"96bb2b3e85a34d8b9544514e89f6fe97","ac4e9b54acfe4670b4634859c7263cb5",22928179,1,2,0,1637,390,392,2
"ac4e9b54acfe4670b4634859c7263cb5","ac4e9b54acfe4670b4634859c7263cb5",22928179,1,0,1,1638,392,392,0
"ac4e9b54acfe4670b4634859c7263cb5","17f95d18bab743888e1736033dc3384d",22928179,1,-3,0,1639,392,389,-3
"17f95d18bab743888e1736033dc3384d","6f8881a745ac4c358a68b92c3b4abe81",22928179,1,6,0,1640,389,394,5
"6f8881a745ac4c358a68b92c3b4abe81","6f8881a745ac4c358a68b92c3b4abe81",22928179,1,0,1,1641,394,394,0
"6f8881a745ac4c358a68b92c3b4abe81","f7002c8484354eceac57bc7bd62c76c1",22928179,1,-1,0,1642,394,393,-1
"f7002c8484354eceac57bc7bd62c76c1","44a277ea44dc4ae689fab4b82f0b4098",22928179,1,5,0,1643,393,397,4
"44a277ea44dc4ae689fab4b82f0b4098","44a277ea44dc4ae689fab4b82f0b4098",22928179,1,0,1,1644,397,397,0
"44a277ea44dc4ae689fab4b82f0b4098","0c12af0a4e7f4002852cf84b2537c161",22928179,1,-2,0,1645,397,395,-2
"0c12af0a4e7f4002852cf84b2537c161","859e0b8d71694b12befb69ee698138f9",22928179,1,5,0,1646,395,399,4
"859e0b8d71694b12befb69ee698138f9","859e0b8d71694b12befb69ee698138f9",22928179,1,0,1,1647,399,399,0
"859e0b8d71694b12befb69ee698138f9","66baf19b6b904b70922329068c63746d",22928179,1,-29,0,1648,399,376,-23
"66baf19b6b904b70922329068c63746d","2b09a08242b54983aec7063990fb3f66",22928179,3,32,0,1649,376,400,24
"2b09a08242b54983aec7063990fb3f66","2b09a08242b54983aec7063990fb3f66",22928179,2,0,1,1650,400,400,0
"2b09a08242b54983aec7063990fb3f66","66baf19b6b904b70922329068c63746d",22928179,3,-32,0,1651,400,376,-24
"66baf19b6b904b70922329068c63746d","66baf19b6b904b70922329068c63746d",22928179,2,0,1,1652,376,376,0
"2b09a08242b54983aec7063990fb3f66","1f471b7a883a4df48211e8c6a81b59a7",22928179,1,1,0,1658,400,401,1
"1f471b7a883a4df48211e8c6a81b59a7","1f471b7a883a4df48211e8c6a81b59a7",22928179,1,0,1,1659,401,401,0
"1f471b7a883a4df48211e8c6a81b59a7","2b09a08242b54983aec7063990fb3f66",22928179,1,-1,0,1660,401,400,-1
"2b09a08242b54983aec7063990fb3f66","9de0d567bfa84fe5b77cb76f4a76a5d1",22928179,1,5,0,1661,400,404,4
"9de0d567bfa84fe5b77cb76f4a76a5d1","9de0d567bfa84fe5b77cb76f4a76a5d1",22928179,1,0,1,1662,404,404,0
"9de0d567bfa84fe5b77cb76f4a76a5d1","1157bd665ec4472fb58b751dc5099355",22928179,1,-1,0,1663,404,403,-1
"1157bd665ec4472fb58b751dc5099355","58fc9094275e4c49be3f4ba6d4acc0a4",22928179,1,5,0,1664,403,406,3
"58fc9094275e4c49be3f4ba6d4acc0a4","3c8a22d2f9c146ea956609e3ed4f2559",22928179,1,-2,0,1665,406,405,-1
"3c8a22d2f9c146ea956609e3ed4f2559","58fc9094275e4c49be3f4ba6d4acc0a4",22928179,1,2,0,1666,405,406,1
"58fc9094275e4c49be3f4ba6d4acc0a4","c1c1be90b2b14c1ab4a5e1ee3c241902",22928179,1,1,0,1667,406,407,1
"c1c1be90b2b14c1ab4a5e1ee3c241902","c1c1be90b2b14c1ab4a5e1ee3c241902",22928179,5,0,1,1668,407,407,0
"c1c1be90b2b14c1ab4a5e1ee3c241902","58fc9094275e4c49be3f4ba6d4acc0a4",22928179,1,-1,0,1673,407,406,-1
"58fc9094275e4c49be3f4ba6d4acc0a4","02b3a1bead9244c1ba2f857c7da8f82a",22928179,1,3,0,1674,406,408,2
"02b3a1bead9244c1ba2f857c7da8f82a","02b3a1bead9244c1ba2f857c7da8f82a",22928179,1,0,1,1675,408,408,0
"02b3a1bead9244c1ba2f857c7da8f82a","6206fc6479014bb193084c32409dc1b9",22928179,1,1,0,1676,408,409,1
"6206fc6479014bb193084c32409dc1b9","6206fc6479014bb193084c32409dc1b9",22928179,1,0,1,1677,409,409,0
"6206fc6479014bb193084c32409dc1b9","02b3a1bead9244c1ba2f857c7da8f82a",22928179,1,-1,0,1678,409,408,-1
"02b3a1bead9244c1ba2f857c7da8f82a","6a5f020451db426dacba9e2ea3fcc62a",22928179,1,3,0,1679,408,410,2
"6a5f020451db426dacba9e2ea3fcc62a","6a5f020451db426dacba9e2ea3fcc62a",22928179,5,0,1,1680,410,410,0
"6a5f020451db426dacba9e2ea3fcc62a","2b09a08242b54983aec7063990fb3f66",22928179,1,-15,0,1682,410,400,-10
"2b09a08242b54983aec7063990fb3f66","6a5f020451db426dacba9e2ea3fcc62a",22928179,1,15,0,1683,400,410,10
"6a5f020451db426dacba9e2ea3fcc62a","33a9d248b2e44588a5b07fc1342b9bc2",22928179,1,2,0,1687,410,411,1
"33a9d248b2e44588a5b07fc1342b9bc2","33a9d248b2e44588a5b07fc1342b9bc2",22928179,2,0,1,1688,411,411,0
"33a9d248b2e44588a5b07fc1342b9bc2","c6f26bd420634f1cb7989e76fe6b16c0",22928179,1,1,0,1690,411,412,1
"c6f26bd420634f1cb7989e76fe6b16c0","c6f26bd420634f1cb7989e76fe6b16c0",22928179,5,0,1,1691,412,412,0
"c6f26bd420634f1cb7989e76fe6b16c0","2a65ee6e2ac64f6a8a55fbe5373ec763",22928179,1,1,0,1696,412,413,1
"2a65ee6e2ac64f6a8a55fbe5373ec763","2a65ee6e2ac64f6a8a55fbe5373ec763",22928179,2,0,1,1697,413,413,0
"2a65ee6e2ac64f6a8a55fbe5373ec763","33a9d248b2e44588a5b07fc1342b9bc2",22928179,1,-2,0,1699,413,411,-2
"33a9d248b2e44588a5b07fc1342b9bc2","1fd0f6dadbc14ebc965faf6122190b96",22928179,1,5,0,1700,411,415,4
"1fd0f6dadbc14ebc965faf6122190b96","1fd0f6dadbc14ebc965faf6122190b96",22928179,1,0,1,1701,415,415,0
"1fd0f6dadbc14ebc965faf6122190b96","687055dad9fc40c3982478fe33ec01bf",22928179,1,-1,0,1702,415,414,-1
"687055dad9fc40c3982478fe33ec01bf","2b09a08242b54983aec7063990fb3f66",22928179,1,-21,0,1703,414,400,-14
"2b09a08242b54983aec7063990fb3f66","2add1669f08d4101913db15f8c23b3b7",22928179,1,24,0,1704,400,416,16
"2add1669f08d4101913db15f8c23b3b7","2add1669f08d4101913db15f8c23b3b7",22928179,1,0,1,1705,416,416,0
"2add1669f08d4101913db15f8c23b3b7","a2b4bd40cee2481ebd3fc179d6a5cd62",22928179,1,3,0,1706,416,417,1
"a2b4bd40cee2481ebd3fc179d6a5cd62","2b09a08242b54983aec7063990fb3f66",22928179,1,-27,0,1707,417,400,-17
"66baf19b6b904b70922329068c63746d","a2b4bd40cee2481ebd3fc179d6a5cd62",22928179,1,59,0,1709,376,417,41
"a2b4bd40cee2481ebd3fc179d6a5cd62","a2b4bd40cee2481ebd3fc179d6a5cd62",22928179,1,0,1,1710,417,417,0
"a2b4bd40cee2481ebd3fc179d6a5cd62","e34e59dce2204f228f3a84b6725df60f",22928179,1,2,0,1711,417,419,2
"e34e59dce2204f228f3a84b6725df60f","e34e59dce2204f228f3a84b6725df60f",22928179,1,0,1,1712,419,419,0
"e34e59dce2204f228f3a84b6725df60f","bec48fc2e1294c7eb3d0aca780d731b8",22928179,1,2,0,1713,419,420,1
"bec48fc2e1294c7eb3d0aca780d731b8","a2b4bd40cee2481ebd3fc179d6a5cd62",22928179,1,-4,0,1714,420,417,-3
"a2b4bd40cee2481ebd3fc179d6a5cd62","bec48fc2e1294c7eb3d0aca780d731b8",22928179,1,4,0,1715,417,420,3
"bec48fc2e1294c7eb3d0aca780d731b8","bec48fc2e1294c7eb3d0aca780d731b8",22928179,1,0,1,1716,420,420,0
"bec48fc2e1294c7eb3d0aca780d731b8","dbde19fcce2a4c1abdc7f685c293a23f",22928179,1,3,0,1717,420,422,2
"dbde19fcce2a4c1abdc7f685c293a23f","a24600b0e49245f6bdba8c893cfeddb0",22928179,2,4,0,1718,422,425,3
"a24600b0e49245f6bdba8c893cfeddb0","a24600b0e49245f6bdba8c893cfeddb0",22928179,4,0,1,1719,425,425,0
"a24600b0e49245f6bdba8c893cfeddb0","dbde19fcce2a4c1abdc7f685c293a23f",22928179,1,-4,0,1721,425,422,-3
"a24600b0e49245f6bdba8c893cfeddb0","a2b4bd40cee2481ebd3fc179d6a5cd62",22928179,1,-11,0,1725,425,417,-8
"a2b4bd40cee2481ebd3fc179d6a5cd62","24cf8786024543f19b89bc20034e60d7",22928179,1,18,0,1726,417,428,11
"24cf8786024543f19b89bc20034e60d7","f2a73be2f46840b182d7bd095378004e",22928179,2,1,0,1727,428,429,1
"f2a73be2f46840b182d7bd095378004e","66baf19b6b904b70922329068c63746d",22928179,1,-78,0,1728,429,376,-53
"66baf19b6b904b70922329068c63746d","24cf8786024543f19b89bc20034e60d7",22928179,1,77,0,1729,376,428,52
"f2a73be2f46840b182d7bd095378004e","f2a73be2f46840b182d7bd095378004e",22928179,2,0,1,1731,429,429,0
"f2a73be2f46840b182d7bd095378004e","604551fd4266430cb860fef58fa7dd61",22928179,1,1,0,1733,429,430,1
"604551fd4266430cb860fef58fa7dd61","604551fd4266430cb860fef58fa7dd61",22928179,1,0,1,1734,430,430,0
"604551fd4266430cb860fef58fa7dd61","dce46f8904594a62a6377a3587aaa663",22928179,1,2,0,1735,430,431,1
"dce46f8904594a62a6377a3587aaa663","24cf8786024543f19b89bc20034e60d7",22928179,1,-4,0,1736,431,428,-3
"24cf8786024543f19b89bc20034e60d7","dce46f8904594a62a6377a3587aaa663",22928179,1,4,0,1737,428,431,3
"dce46f8904594a62a6377a3587aaa663","dce46f8904594a62a6377a3587aaa663",22928179,10,0,1,1738,431,431,0
"dce46f8904594a62a6377a3587aaa663","9b9d0a249052413c869753b99682b0ac",22928179,1,1,0,1748,431,432,1
"9b9d0a249052413c869753b99682b0ac","9b9d0a249052413c869753b99682b0ac",22928179,3,0,1,1749,432,432,0
"9b9d0a249052413c869753b99682b0ac","061c175cc90f45fbad883025394e78dd",22928179,1,1,0,1752,432,433,1
"061c175cc90f45fbad883025394e78dd","061c175cc90f45fbad883025394e78dd",22928179,6,0,1,1753,433,433,0
"061c175cc90f45fbad883025394e78dd","dce46f8904594a62a6377a3587aaa663",22928179,1,-2,0,1759,433,431,-2
"dce46f8904594a62a6377a3587aaa663","74a7f8712e5449c2bc0b43c6f90dafed",22928179,1,5,0,1760,431,435,4
"74a7f8712e5449c2bc0b43c6f90dafed","74a7f8712e5449c2bc0b43c6f90dafed",22928179,1,0,1,1761,435,435,0
"74a7f8712e5449c2bc0b43c6f90dafed","66ada10dde9f43018588f1ced9d477fc",22928179,1,-1,0,1762,435,434,-1
"66ada10dde9f43018588f1ced9d477fc","bf12c96466d840a69bed7020b3f18bb8",22928179,1,3,0,1763,434,436,2
"bf12c96466d840a69bed7020b3f18bb8","bf12c96466d840a69bed7020b3f18bb8",22928179,1,0,1,1764,436,436,0
"bf12c96466d840a69bed7020b3f18bb8","070600601c4c439288445d2f0724807d",22928179,1,3,0,1765,436,437,1
"070600601c4c439288445d2f0724807d","24cf8786024543f19b89bc20034e60d7",22928179,1,-14,0,1766,437,428,-9
"24cf8786024543f19b89bc20034e60d7","1823b6de7d334a7aaabc4570719af4d9",22928179,1,16,0,1767,428,439,11
"1823b6de7d334a7aaabc4570719af4d9","070600601c4c439288445d2f0724807d",22928179,2,-2,0,1768,439,437,-2
"070600601c4c439288445d2f0724807d","1823b6de7d334a7aaabc4570719af4d9",22928179,1,2,0,1769,437,439,2
"1823b6de7d334a7aaabc4570719af4d9","1823b6de7d334a7aaabc4570719af4d9",22928179,11,0,1,1770,439,439,0
"070600601c4c439288445d2f0724807d","0380cd76a7d44bc3a4da1f15e4d68f89",22928179,1,4,0,1782,437,440,3
"0380cd76a7d44bc3a4da1f15e4d68f89","0380cd76a7d44bc3a4da1f15e4d68f89",22928179,3,0,1,1783,440,440,0
"0380cd76a7d44bc3a4da1f15e4d68f89","23b7673c8b5443108c2ef09382834a86",22928179,1,2,0,1786,440,441,1
"23b7673c8b5443108c2ef09382834a86","23b7673c8b5443108c2ef09382834a86",22928179,2,0,1,1787,441,441,0
"23b7673c8b5443108c2ef09382834a86","901e92500aea43c79f19f1b279050668",22928179,1,2,0,1789,441,442,1
"901e92500aea43c79f19f1b279050668","901e92500aea43c79f19f1b279050668",22928179,1,0,1,1790,442,442,0
"901e92500aea43c79f19f1b279050668","001339db8ced4cf78829ebe8b145449d",22928179,1,1,0,1791,442,443,1
"001339db8ced4cf78829ebe8b145449d","001339db8ced4cf78829ebe8b145449d",22928179,2,0,1,1792,443,443,0
"001339db8ced4cf78829ebe8b145449d","452745e0366e42ae81561bfddebcc6c3",22928179,1,1,0,1794,443,444,1
"452745e0366e42ae81561bfddebcc6c3","452745e0366e42ae81561bfddebcc6c3",22928179,2,0,1,1795,444,444,0
"452745e0366e42ae81561bfddebcc6c3","4660ff2089114e8db82ceb26a4f329e3",22928179,1,2,0,1797,444,445,1
"4660ff2089114e8db82ceb26a4f329e3","901e92500aea43c79f19f1b279050668",22928179,1,-4,0,1798,445,442,-3
"901e92500aea43c79f19f1b279050668","4660ff2089114e8db82ceb26a4f329e3",22928179,1,4,0,1799,442,445,3
"4660ff2089114e8db82ceb26a4f329e3","4660ff2089114e8db82ceb26a4f329e3",22928179,8,0,1,1800,445,445,0
"4660ff2089114e8db82ceb26a4f329e3","7bd5586eb9d8484eb74a433ee7bfe499",22928179,1,2,0,1808,445,446,1
"7bd5586eb9d8484eb74a433ee7bfe499","7bd5586eb9d8484eb74a433ee7bfe499",22928179,9,0,1,1809,446,446,0
"7bd5586eb9d8484eb74a433ee7bfe499","8a7f26e690f34dda97be16904518ca99",22928179,1,2,0,1818,446,447,1
"8a7f26e690f34dda97be16904518ca99","8a7f26e690f34dda97be16904518ca99",22928179,1,0,1,1819,447,447,0
"8a7f26e690f34dda97be16904518ca99","070600601c4c439288445d2f0724807d",22928179,1,-16,0,1820,447,437,-10
"070600601c4c439288445d2f0724807d","b2f0d654738f48158edff28e8d3a546e",22928179,1,21,0,1821,437,449,12
"b2f0d654738f48158edff28e8d3a546e","b2f0d654738f48158edff28e8d3a546e",22928179,1,0,1,1822,449,449,0
"b2f0d654738f48158edff28e8d3a546e","f60ee41ec635499abd48168342d32c2f",22928179,3,5,0,1823,449,453,4
"f60ee41ec635499abd48168342d32c2f","f60ee41ec635499abd48168342d32c2f",22928179,60,0,1,1824,453,453,0
"f60ee41ec635499abd48168342d32c2f","b2f0d654738f48158edff28e8d3a546e",22928179,3,-5,0,1830,453,449,-4
"b2f0d654738f48158edff28e8d3a546e","f67fbf45a5f146ed866965bc57c7c001",22928179,2,8,0,1878,449,454,5
"f67fbf45a5f146ed866965bc57c7c001","f67fbf45a5f146ed866965bc57c7c001",22928179,3,0,1,1879,454,454,0
"f67fbf45a5f146ed866965bc57c7c001","d937afe49bd24a07a550dda1c1155122",22928179,1,1,0,1881,454,455,1
"d937afe49bd24a07a550dda1c1155122","d937afe49bd24a07a550dda1c1155122",22928179,3,0,1,1882,455,455,0
"d937afe49bd24a07a550dda1c1155122","3628b3f7823443d0912a339096b69943",22928179,1,1,0,1885,455,456,1
"3628b3f7823443d0912a339096b69943","3628b3f7823443d0912a339096b69943",22928179,1,0,1,1886,456,456,0
"3628b3f7823443d0912a339096b69943","9e049ee647cf43ecbcb5ed792a8e7588",22928179,1,1,0,1887,456,457,1
"9e049ee647cf43ecbcb5ed792a8e7588","9e049ee647cf43ecbcb5ed792a8e7588",22928179,1,0,1,1888,457,457,0
"9e049ee647cf43ecbcb5ed792a8e7588","5256a214faaf410b93f76cea06428334",22928179,1,1,0,1889,457,458,1
"5256a214faaf410b93f76cea06428334","5256a214faaf410b93f76cea06428334",22928179,1,0,1,1890,458,458,0
"5256a214faaf410b93f76cea06428334","25c32b120fce40fa9b6c85133aeb4716",22928179,1,1,0,1891,458,459,1
"25c32b120fce40fa9b6c85133aeb4716","25c32b120fce40fa9b6c85133aeb4716",22928179,1,0,1,1892,459,459,0
"25c32b120fce40fa9b6c85133aeb4716","11bc14f2204949008b7d511b933363c1",22928179,1,1,0,1893,459,460,1
"11bc14f2204949008b7d511b933363c1","11bc14f2204949008b7d511b933363c1",22928179,1,0,1,1894,460,460,0
"11bc14f2204949008b7d511b933363c1","42de338840a34d15adb66e7b14fb9d2c",22928179,1,1,0,1895,460,461,1
"42de338840a34d15adb66e7b14fb9d2c","42de338840a34d15adb66e7b14fb9d2c",22928179,1,0,1,1896,461,461,0
"42de338840a34d15adb66e7b14fb9d2c","9da37c6210b1416b8079c274f70bf600",22928179,1,1,0,1897,461,462,1
"9da37c6210b1416b8079c274f70bf600","9da37c6210b1416b8079c274f70bf600",22928179,1,0,1,1898,462,462,0
"9da37c6210b1416b8079c274f70bf600","519119f1deac45ff9ab4f13529be5c6e",22928179,1,1,0,1899,462,463,1
"519119f1deac45ff9ab4f13529be5c6e","519119f1deac45ff9ab4f13529be5c6e",22928179,3,0,1,1900,463,463,0
"519119f1deac45ff9ab4f13529be5c6e","c5df9f40ec14463b9dcfdc73df3e9285",22928179,1,3,0,1903,463,464,1
"c5df9f40ec14463b9dcfdc73df3e9285","f67fbf45a5f146ed866965bc57c7c001",22928179,2,-12,0,1904,464,454,-10
"f67fbf45a5f146ed866965bc57c7c001","c5df9f40ec14463b9dcfdc73df3e9285",22928179,2,12,0,1905,454,464,10
"f67fbf45a5f146ed866965bc57c7c001","66baf19b6b904b70922329068c63746d",22928179,1,-120,0,1907,454,376,-78
"66baf19b6b904b70922329068c63746d","c5df9f40ec14463b9dcfdc73df3e9285",22928179,1,132,0,1908,376,464,88
"c5df9f40ec14463b9dcfdc73df3e9285","c5df9f40ec14463b9dcfdc73df3e9285",22928179,9,0,1,1909,464,464,0
"c5df9f40ec14463b9dcfdc73df3e9285","83d42d95cd844fc093fc09cee250edb8",22928179,3,3,0,1914,464,465,1
"83d42d95cd844fc093fc09cee250edb8","83d42d95cd844fc093fc09cee250edb8",22928179,8,0,1,1915,465,465,0
"83d42d95cd844fc093fc09cee250edb8","c5df9f40ec14463b9dcfdc73df3e9285",22928179,1,-3,0,1916,465,464,-1
"83d42d95cd844fc093fc09cee250edb8","66baf19b6b904b70922329068c63746d",22928179,1,-135,0,1923,465,376,-89
"66baf19b6b904b70922329068c63746d","b2f0d654738f48158edff28e8d3a546e",22928179,1,112,0,1924,376,449,73
