"from","to","user_id","weight","dis","sl","seq_min","ordF","ordT","disRevised"
"b613861cecf84ffcab01afb23f660475","b613861cecf84ffcab01afb23f660475",17456436,3,0,1,1,1,1,0
"b613861cecf84ffcab01afb23f660475","e2911e79efc2420eac45d9f671463d4b",17456436,1,3,0,4,1,2,1
"e2911e79efc2420eac45d9f671463d4b","519d1b8c59404d67b54e96c5c8a830b2",17456436,1,1,0,7,2,3,1
"519d1b8c59404d67b54e96c5c8a830b2","519d1b8c59404d67b54e96c5c8a830b2",17456436,1,0,1,8,3,3,0
"519d1b8c59404d67b54e96c5c8a830b2","531db53f81f646edb0cdcfe0085b03b7",17456436,1,1,0,9,3,4,1
"531db53f81f646edb0cdcfe0085b03b7","531db53f81f646edb0cdcfe0085b03b7",17456436,1,0,1,10,4,4,0
"531db53f81f646edb0cdcfe0085b03b7","4f5f94b2f95141e0a9d53a61da2276da",17456436,1,1,0,11,4,5,1
"4f5f94b2f95141e0a9d53a61da2276da","4f5f94b2f95141e0a9d53a61da2276da",17456436,1,0,1,12,5,5,0
"4f5f94b2f95141e0a9d53a61da2276da","6d541c89590949f99af293c4f2333f67",17456436,1,1,0,13,5,6,1
"6d541c89590949f99af293c4f2333f67","6d541c89590949f99af293c4f2333f67",17456436,1,0,1,14,6,6,0
"6d541c89590949f99af293c4f2333f67","dd5cf0b9fe4c4f1d8f5ff8e4c04879cb",17456436,1,1,0,15,6,7,1
"dd5cf0b9fe4c4f1d8f5ff8e4c04879cb","dd5cf0b9fe4c4f1d8f5ff8e4c04879cb",17456436,1,0,1,16,7,7,0
"dd5cf0b9fe4c4f1d8f5ff8e4c04879cb","f96261861edc426abe2248be4f0a709a",17456436,1,1,0,17,7,8,1
"f96261861edc426abe2248be4f0a709a","f96261861edc426abe2248be4f0a709a",17456436,1,0,1,18,8,8,0
"f96261861edc426abe2248be4f0a709a","66b5e16f4f75454fb5b8172079f0fa83",17456436,1,1,0,19,8,9,1
"66b5e16f4f75454fb5b8172079f0fa83","66b5e16f4f75454fb5b8172079f0fa83",17456436,1,0,1,20,9,9,0
"66b5e16f4f75454fb5b8172079f0fa83","0680571d4698477995e41842c36a54b2",17456436,1,1,0,21,9,10,1
"0680571d4698477995e41842c36a54b2","0680571d4698477995e41842c36a54b2",17456436,1,0,1,22,10,10,0
"0680571d4698477995e41842c36a54b2","56586aa865414f538729c7f7735d2bc6",17456436,1,4,0,23,10,12,2
"56586aa865414f538729c7f7735d2bc6","e2911e79efc2420eac45d9f671463d4b",17456436,2,-12,0,24,12,2,-10
"e2911e79efc2420eac45d9f671463d4b","e2911e79efc2420eac45d9f671463d4b",17456436,3,0,1,25,2,2,0
"e2911e79efc2420eac45d9f671463d4b","9112f2bffece48e08c6d2287be204085",17456436,1,9,0,26,2,11,9
"9112f2bffece48e08c6d2287be204085","9112f2bffece48e08c6d2287be204085",17456436,1,0,1,27,11,11,0
"9112f2bffece48e08c6d2287be204085","56586aa865414f538729c7f7735d2bc6",17456436,1,3,0,28,11,12,1
"e2911e79efc2420eac45d9f671463d4b","56586aa865414f538729c7f7735d2bc6",17456436,1,12,0,30,2,12,10
"56586aa865414f538729c7f7735d2bc6","56586aa865414f538729c7f7735d2bc6",17456436,4,0,1,31,12,12,0
"56586aa865414f538729c7f7735d2bc6","b7f2b31585d94eb3bf86376714aa7070",17456436,1,2,0,35,12,13,1
"b7f2b31585d94eb3bf86376714aa7070","b7f2b31585d94eb3bf86376714aa7070",17456436,2,0,1,36,13,13,0
"b7f2b31585d94eb3bf86376714aa7070","3f1c815879794b929260d224becaff7e",17456436,1,2,0,38,13,14,1
"3f1c815879794b929260d224becaff7e","5c5ceeee4562457ba6d41515aeebfbb1",17456436,1,6,0,39,14,17,3
"5c5ceeee4562457ba6d41515aeebfbb1","81c864a886d54a6b8ff85f7d736f4f95",17456436,1,-4,0,40,17,15,-2
"81c864a886d54a6b8ff85f7d736f4f95","5c5ceeee4562457ba6d41515aeebfbb1",17456436,1,4,0,41,15,17,2
"5c5ceeee4562457ba6d41515aeebfbb1","56586aa865414f538729c7f7735d2bc6",17456436,1,-10,0,42,17,12,-5
"56586aa865414f538729c7f7735d2bc6","9afd71a5298d4333b6849dfce1b9422c",17456436,1,13,0,43,12,18,6
"9afd71a5298d4333b6849dfce1b9422c","9afd71a5298d4333b6849dfce1b9422c",17456436,1,0,1,44,18,18,0
"9afd71a5298d4333b6849dfce1b9422c","b7719e26494940efa49512aedd0aac79",17456436,2,4,0,45,18,20,2
"b7719e26494940efa49512aedd0aac79","9afd71a5298d4333b6849dfce1b9422c",17456436,2,-4,0,46,20,18,-2
"9afd71a5298d4333b6849dfce1b9422c","d4c3b003e8274e429d2fa688d73fde6d",17456436,1,7,0,47,18,22,4
"d4c3b003e8274e429d2fa688d73fde6d","d4f45188d3c84a02ba08454e6403a818",17456436,2,2,0,48,22,24,2
"d4f45188d3c84a02ba08454e6403a818","d4c3b003e8274e429d2fa688d73fde6d",17456436,2,-2,0,49,24,22,-2
"d4c3b003e8274e429d2fa688d73fde6d","d4c3b003e8274e429d2fa688d73fde6d",17456436,2,0,1,50,22,22,0
"d4c3b003e8274e429d2fa688d73fde6d","b7719e26494940efa49512aedd0aac79",17456436,1,-3,0,52,22,20,-2
"b7719e26494940efa49512aedd0aac79","afbf7250b99d47bea07172749483ca97",17456436,2,12,0,53,20,28,8
"afbf7250b99d47bea07172749483ca97","b7719e26494940efa49512aedd0aac79",17456436,1,-12,0,54,28,20,-8
"b7719e26494940efa49512aedd0aac79","b7719e26494940efa49512aedd0aac79",17456436,2,0,1,55,20,20,0
"b7719e26494940efa49512aedd0aac79","a49d1bb4328949299686242fd0be5584",17456436,2,2,0,56,20,21,1
"a49d1bb4328949299686242fd0be5584","d4c3b003e8274e429d2fa688d73fde6d",17456436,2,1,0,57,21,22,1
"d4f45188d3c84a02ba08454e6403a818","b7719e26494940efa49512aedd0aac79",17456436,1,-5,0,59,24,20,-4
"afbf7250b99d47bea07172749483ca97","afbf7250b99d47bea07172749483ca97",17456436,1,0,1,62,28,28,0
"afbf7250b99d47bea07172749483ca97","4e51676dc72045d99c19b9fa7b22f8bc",17456436,1,3,0,63,28,29,1
"4e51676dc72045d99c19b9fa7b22f8bc","4e51676dc72045d99c19b9fa7b22f8bc",17456436,1,0,1,64,29,29,0
"4e51676dc72045d99c19b9fa7b22f8bc","51970cfa30e643e894e66ae85c8024cc",17456436,1,3,0,65,29,31,2
"51970cfa30e643e894e66ae85c8024cc","c33c17be71ae4d588da7369472e5bb1b",17456436,1,6,0,66,31,34,3
"c33c17be71ae4d588da7369472e5bb1b","4e51676dc72045d99c19b9fa7b22f8bc",17456436,1,-9,0,67,34,29,-5
"4e51676dc72045d99c19b9fa7b22f8bc","c33c17be71ae4d588da7369472e5bb1b",17456436,1,9,0,68,29,34,5
"c33c17be71ae4d588da7369472e5bb1b","93679be414554a11b1893002f2229a93",17456436,1,3,0,69,34,35,1
"93679be414554a11b1893002f2229a93","93679be414554a11b1893002f2229a93",17456436,1,0,1,70,35,35,0
"93679be414554a11b1893002f2229a93","7040a13096d746ac84b8fac8d9752058",17456436,1,3,0,71,35,36,1
"7040a13096d746ac84b8fac8d9752058","7040a13096d746ac84b8fac8d9752058",17456436,1,0,1,72,36,36,0
"7040a13096d746ac84b8fac8d9752058","9a0dc646f934470daf08c4b56ccf73db",17456436,1,3,0,73,36,37,1
"9a0dc646f934470daf08c4b56ccf73db","9a0dc646f934470daf08c4b56ccf73db",17456436,3,0,1,74,37,37,0
"9a0dc646f934470daf08c4b56ccf73db","fc0e049d56024bc9a02c9a9c435c3df7",17456436,2,3,0,75,37,38,1
"fc0e049d56024bc9a02c9a9c435c3df7","9a0dc646f934470daf08c4b56ccf73db",17456436,1,-3,0,76,38,37,-1
"fc0e049d56024bc9a02c9a9c435c3df7","a49d1bb4328949299686242fd0be5584",17456436,1,-34,0,80,38,21,-17
"a49d1bb4328949299686242fd0be5584","b7719e26494940efa49512aedd0aac79",17456436,1,-2,0,81,21,20,-1
"b7719e26494940efa49512aedd0aac79","d4f45188d3c84a02ba08454e6403a818",17456436,1,5,0,82,20,24,4
"d4f45188d3c84a02ba08454e6403a818","a49d1bb4328949299686242fd0be5584",17456436,1,-3,0,83,24,21,-3
"d4c3b003e8274e429d2fa688d73fde6d","fc0e049d56024bc9a02c9a9c435c3df7",17456436,1,33,0,85,22,38,16
"fc0e049d56024bc9a02c9a9c435c3df7","b613861cecf84ffcab01afb23f660475",17456436,1,-68,0,86,38,1,-37
"b613861cecf84ffcab01afb23f660475","b7719e26494940efa49512aedd0aac79",17456436,1,32,0,87,1,20,19
"a49d1bb4328949299686242fd0be5584","a49d1bb4328949299686242fd0be5584",17456436,1,0,1,89,21,21,0
"a49d1bb4328949299686242fd0be5584","d4f45188d3c84a02ba08454e6403a818",17456436,1,3,0,90,21,24,3
"d4c3b003e8274e429d2fa688d73fde6d","9afd71a5298d4333b6849dfce1b9422c",17456436,1,-7,0,92,22,18,-4
"9afd71a5298d4333b6849dfce1b9422c","56586aa865414f538729c7f7735d2bc6",17456436,1,-13,0,95,18,12,-6
"56586aa865414f538729c7f7735d2bc6","5c5ceeee4562457ba6d41515aeebfbb1",17456436,2,10,0,96,12,17,5
"eb2a0eb537344a9e891c761662e400b6","56586aa865414f538729c7f7735d2bc6",17456436,1,-8,0,98,16,12,-4
"5c5ceeee4562457ba6d41515aeebfbb1","eb2a0eb537344a9e891c761662e400b6",17456436,2,-2,0,100,17,16,-1
"eb2a0eb537344a9e891c761662e400b6","fc0e049d56024bc9a02c9a9c435c3df7",17456436,1,45,0,101,16,38,22
"fc0e049d56024bc9a02c9a9c435c3df7","fc0e049d56024bc9a02c9a9c435c3df7",17456436,1,0,1,102,38,38,0
"fc0e049d56024bc9a02c9a9c435c3df7","67a089198fcb4e1c8f2385786c2b296f",17456436,1,4,0,103,38,39,1
"67a089198fcb4e1c8f2385786c2b296f","64d48c6c9c7940639a932219a6c87198",17456436,1,1,0,104,39,40,1
"64d48c6c9c7940639a932219a6c87198","64d48c6c9c7940639a932219a6c87198",17456436,2,0,1,105,40,40,0
"64d48c6c9c7940639a932219a6c87198","67a089198fcb4e1c8f2385786c2b296f",17456436,1,-1,0,107,40,39,-1
"67a089198fcb4e1c8f2385786c2b296f","b534b89233134e30a9b5645138bfa9ee",17456436,1,4,0,108,39,41,2
"b534b89233134e30a9b5645138bfa9ee","0e37b720d23b4e7f8b313e79313fd107",17456436,1,3,0,109,41,44,3
"0e37b720d23b4e7f8b313e79313fd107","0e37b720d23b4e7f8b313e79313fd107",17456436,1,0,1,110,44,44,0
"0e37b720d23b4e7f8b313e79313fd107","6875d67fdd5f48168b62719df449bebd",17456436,1,1,0,111,44,45,1
"6875d67fdd5f48168b62719df449bebd","6875d67fdd5f48168b62719df449bebd",17456436,1,0,1,112,45,45,0
"6875d67fdd5f48168b62719df449bebd","6e13d61a7bdb44bca949c9f86fab3be5",17456436,1,3,0,113,45,47,2
"6e13d61a7bdb44bca949c9f86fab3be5","b534b89233134e30a9b5645138bfa9ee",17456436,1,-7,0,114,47,41,-6
"b534b89233134e30a9b5645138bfa9ee","6e13d61a7bdb44bca949c9f86fab3be5",17456436,1,7,0,115,41,47,6
"6e13d61a7bdb44bca949c9f86fab3be5","195f78799f984cc2b06c48dfe36be751",17456436,1,2,0,116,47,49,2
"195f78799f984cc2b06c48dfe36be751","195f78799f984cc2b06c48dfe36be751",17456436,2,0,1,117,49,49,0
"195f78799f984cc2b06c48dfe36be751","d9c8d8c444a64dadbbb508652c721e17",17456436,1,-3,0,119,49,46,-3
"d9c8d8c444a64dadbbb508652c721e17","d0c74f735e024943943e40333d6d337f",17456436,1,6,0,120,46,51,5
"d0c74f735e024943943e40333d6d337f","d0c74f735e024943943e40333d6d337f",17456436,1,0,1,121,51,51,0
"d0c74f735e024943943e40333d6d337f","983f8ff320594b279a7f4a6fe132f9c5",17456436,1,2,0,122,51,53,2
"983f8ff320594b279a7f4a6fe132f9c5","983f8ff320594b279a7f4a6fe132f9c5",17456436,5,0,1,123,53,53,0
"983f8ff320594b279a7f4a6fe132f9c5","35adfa5d923046aebabfefd98f35ff05",17456436,1,1,0,128,53,54,1
"35adfa5d923046aebabfefd98f35ff05","35adfa5d923046aebabfefd98f35ff05",17456436,5,0,1,129,54,54,0
"35adfa5d923046aebabfefd98f35ff05","b6f8a98476224da1b40e555ececc7ed8",17456436,1,1,0,134,54,55,1
"b6f8a98476224da1b40e555ececc7ed8","b6f8a98476224da1b40e555ececc7ed8",17456436,2,0,1,135,55,55,0
"b6f8a98476224da1b40e555ececc7ed8","86e22cb5fe0e4b47a9489ecddf7ed78f",17456436,1,1,0,137,55,56,1
"86e22cb5fe0e4b47a9489ecddf7ed78f","86e22cb5fe0e4b47a9489ecddf7ed78f",17456436,2,0,1,138,56,56,0
"86e22cb5fe0e4b47a9489ecddf7ed78f","f924752d8a1149668870b1e7698486f7",17456436,1,-6,0,140,56,50,-6
"f924752d8a1149668870b1e7698486f7","78f30e4dcac84e3cbea8b2cc6e0d62b3",17456436,1,10,0,141,50,59,9
"78f30e4dcac84e3cbea8b2cc6e0d62b3","a1f2f12debe5432fb7a70bcd12bacfb9",17456436,1,-1,0,142,59,58,-1
"a1f2f12debe5432fb7a70bcd12bacfb9","a1f2f12debe5432fb7a70bcd12bacfb9",17456436,22,0,1,143,58,58,0
"a1f2f12debe5432fb7a70bcd12bacfb9","78f30e4dcac84e3cbea8b2cc6e0d62b3",17456436,1,1,0,165,58,59,1
"78f30e4dcac84e3cbea8b2cc6e0d62b3","78f30e4dcac84e3cbea8b2cc6e0d62b3",17456436,8,0,1,166,59,59,0
"78f30e4dcac84e3cbea8b2cc6e0d62b3","12aa6e1672ac4e7aa6449a7a8609cd72",17456436,1,-2,0,174,59,57,-2
"12aa6e1672ac4e7aa6449a7a8609cd72","bc42d26810654ea9a1df1efe1e58c7d5",17456436,1,7,0,175,57,63,6
"bc42d26810654ea9a1df1efe1e58c7d5","a0a418b8540d479fa6e0f653b701da8b",17456436,2,1,0,176,63,64,1
"a0a418b8540d479fa6e0f653b701da8b","4c943503763e4e349906eea3ed3c8e86",17456436,1,-3,0,177,64,61,-3
"4c943503763e4e349906eea3ed3c8e86","4c943503763e4e349906eea3ed3c8e86",17456436,1,0,1,178,61,61,0
"4c943503763e4e349906eea3ed3c8e86","bc42d26810654ea9a1df1efe1e58c7d5",17456436,1,2,0,179,61,63,2
"bc42d26810654ea9a1df1efe1e58c7d5","bc42d26810654ea9a1df1efe1e58c7d5",17456436,3,0,1,180,63,63,0
"a0a418b8540d479fa6e0f653b701da8b","a0a418b8540d479fa6e0f653b701da8b",17456436,3,0,1,184,64,64,0
"a0a418b8540d479fa6e0f653b701da8b","309ccf3cc4fe429d9bfbaef53d3fa479",17456436,1,-4,0,187,64,60,-4
"309ccf3cc4fe429d9bfbaef53d3fa479","b534b89233134e30a9b5645138bfa9ee",17456436,1,-23,0,188,60,41,-19
"b534b89233134e30a9b5645138bfa9ee","d646286c8051419bbc2e31dd1db55ca8",17456436,1,33,0,189,41,67,26
"d646286c8051419bbc2e31dd1db55ca8","267f883678b24aed855fde42524975d9",17456436,1,4,0,190,67,71,4
"267f883678b24aed855fde42524975d9","267f883678b24aed855fde42524975d9",17456436,2,0,1,191,71,71,0
"267f883678b24aed855fde42524975d9","88fff56d0342490dbef9040750a20f6c",17456436,1,1,0,193,71,72,1
"88fff56d0342490dbef9040750a20f6c","88fff56d0342490dbef9040750a20f6c",17456436,1,0,1,194,72,72,0
"88fff56d0342490dbef9040750a20f6c","adb17b12b66c4a49a85fd34322f7df70",17456436,1,1,0,195,72,73,1
"adb17b12b66c4a49a85fd34322f7df70","adb17b12b66c4a49a85fd34322f7df70",17456436,1,0,1,196,73,73,0
"adb17b12b66c4a49a85fd34322f7df70","a2becd407db34b189200a32546d9d569",17456436,1,3,0,197,73,75,2
"a2becd407db34b189200a32546d9d569","d646286c8051419bbc2e31dd1db55ca8",17456436,1,-9,0,198,75,67,-8
"d646286c8051419bbc2e31dd1db55ca8","a2becd407db34b189200a32546d9d569",17456436,1,9,0,199,67,75,8
"a2becd407db34b189200a32546d9d569","a2becd407db34b189200a32546d9d569",17456436,1,0,1,200,75,75,0
"a2becd407db34b189200a32546d9d569","58c22b011d0f4c2ea6d13615edbb9eeb",17456436,1,2,0,201,75,77,2
"58c22b011d0f4c2ea6d13615edbb9eeb","58c22b011d0f4c2ea6d13615edbb9eeb",17456436,3,0,1,202,77,77,0
"58c22b011d0f4c2ea6d13615edbb9eeb","dd76e1861dc9461c830888729d091ee0",17456436,1,1,0,205,77,78,1
"dd76e1861dc9461c830888729d091ee0","dd76e1861dc9461c830888729d091ee0",17456436,5,0,1,206,78,78,0
"dd76e1861dc9461c830888729d091ee0","cd1d828f1a694b87913a7ea66c23803e",17456436,1,1,0,211,78,79,1
"cd1d828f1a694b87913a7ea66c23803e","cd1d828f1a694b87913a7ea66c23803e",17456436,2,0,1,212,79,79,0
"cd1d828f1a694b87913a7ea66c23803e","9176a3c2b4d2465fa8b0c67096c2a97e",17456436,1,1,0,214,79,80,1
"9176a3c2b4d2465fa8b0c67096c2a97e","9176a3c2b4d2465fa8b0c67096c2a97e",17456436,5,0,1,215,80,80,0
"9176a3c2b4d2465fa8b0c67096c2a97e","f8ec6445f7194e25b9101d4fbcb07a18",17456436,1,1,0,220,80,81,1
"f8ec6445f7194e25b9101d4fbcb07a18","f8ec6445f7194e25b9101d4fbcb07a18",17456436,2,0,1,221,81,81,0
"f8ec6445f7194e25b9101d4fbcb07a18","140d5b27b8574befad82c0a013b59dfa",17456436,1,-7,0,223,81,74,-7
"140d5b27b8574befad82c0a013b59dfa","d18a9ea32855445f8736581f5cb119ce",17456436,1,9,0,224,74,82,8
"d18a9ea32855445f8736581f5cb119ce","f564483cbd7a407681aa2fcca518cf5f",17456436,1,4,0,225,82,85,3
"f564483cbd7a407681aa2fcca518cf5f","f564483cbd7a407681aa2fcca518cf5f",17456436,2,0,1,226,85,85,0
"f564483cbd7a407681aa2fcca518cf5f","18fd01350bd5434ca636d59a599d768a",17456436,1,1,0,228,85,86,1
"18fd01350bd5434ca636d59a599d768a","18fd01350bd5434ca636d59a599d768a",17456436,10,0,1,229,86,86,0
"18fd01350bd5434ca636d59a599d768a","ae5ac430ea254e708a6f5deaaf7464ae",17456436,1,-2,0,239,86,84,-2
"ae5ac430ea254e708a6f5deaaf7464ae","6a9f0ef185fb47f0937e29daa1c71ed5",17456436,1,7,0,240,84,90,6
"6a9f0ef185fb47f0937e29daa1c71ed5","c681290961c94c4caf23b529d1ae6b9a",17456436,1,-2,0,241,90,88,-2
"c681290961c94c4caf23b529d1ae6b9a","c681290961c94c4caf23b529d1ae6b9a",17456436,1,0,1,242,88,88,0
"c681290961c94c4caf23b529d1ae6b9a","6a9f0ef185fb47f0937e29daa1c71ed5",17456436,1,2,0,243,88,90,2
"6a9f0ef185fb47f0937e29daa1c71ed5","6a9f0ef185fb47f0937e29daa1c71ed5",17456436,5,0,1,244,90,90,0
"6a9f0ef185fb47f0937e29daa1c71ed5","e20db35ced8544ddac5bc3839145e463",17456436,1,3,0,247,90,91,1
"e20db35ced8544ddac5bc3839145e463","d646286c8051419bbc2e31dd1db55ca8",17456436,2,-30,0,248,91,67,-24
"d646286c8051419bbc2e31dd1db55ca8","e20db35ced8544ddac5bc3839145e463",17456436,3,30,0,249,67,91,24
"e20db35ced8544ddac5bc3839145e463","6a9f0ef185fb47f0937e29daa1c71ed5",17456436,1,-3,0,252,91,90,-1
"6a9f0ef185fb47f0937e29daa1c71ed5","d646286c8051419bbc2e31dd1db55ca8",17456436,1,-27,0,255,90,67,-23
"e20db35ced8544ddac5bc3839145e463","1febb706d7a34005ae8711ed49c76e64",17456436,1,3,0,257,91,94,3
"1febb706d7a34005ae8711ed49c76e64","1febb706d7a34005ae8711ed49c76e64",17456436,2,0,1,258,94,94,0
"1febb706d7a34005ae8711ed49c76e64","8f73ba6f5a0042f2850356ac38ac6f24",17456436,1,1,0,260,94,95,1
"8f73ba6f5a0042f2850356ac38ac6f24","8f73ba6f5a0042f2850356ac38ac6f24",17456436,5,0,1,261,95,95,0
"8f73ba6f5a0042f2850356ac38ac6f24","e2260b86653c46d7b14a41fb419dbf8c",17456436,1,1,0,266,95,96,1
"e2260b86653c46d7b14a41fb419dbf8c","e2260b86653c46d7b14a41fb419dbf8c",17456436,2,0,1,267,96,96,0
"e2260b86653c46d7b14a41fb419dbf8c","35eb641ad1d845bbba54915bce75a962",17456436,1,1,0,269,96,97,1
"35eb641ad1d845bbba54915bce75a962","35eb641ad1d845bbba54915bce75a962",17456436,2,0,1,270,97,97,0
"35eb641ad1d845bbba54915bce75a962","08be90ffbeea4795a138cd42ed8db56f",17456436,1,1,0,272,97,98,1
"08be90ffbeea4795a138cd42ed8db56f","08be90ffbeea4795a138cd42ed8db56f",17456436,5,0,1,273,98,98,0
"08be90ffbeea4795a138cd42ed8db56f","3007433c8f584dcbb5ac159c1c5f2be3",17456436,1,1,0,278,98,99,1
"3007433c8f584dcbb5ac159c1c5f2be3","3007433c8f584dcbb5ac159c1c5f2be3",17456436,5,0,1,279,99,99,0
"3007433c8f584dcbb5ac159c1c5f2be3","00ae5f0c51874a73a41ebea838d95682",17456436,1,3,0,284,99,101,2
"00ae5f0c51874a73a41ebea838d95682","e20db35ced8544ddac5bc3839145e463",17456436,2,-11,0,285,101,91,-10
"e20db35ced8544ddac5bc3839145e463","d391c8b6e56a43a7b654e9dee02d904b",17456436,2,13,0,286,91,103,12
"d391c8b6e56a43a7b654e9dee02d904b","00ae5f0c51874a73a41ebea838d95682",17456436,1,-2,0,287,103,101,-2
"00ae5f0c51874a73a41ebea838d95682","d391c8b6e56a43a7b654e9dee02d904b",17456436,1,2,0,288,101,103,2
"d391c8b6e56a43a7b654e9dee02d904b","d391c8b6e56a43a7b654e9dee02d904b",17456436,15,0,1,289,103,103,0
"d391c8b6e56a43a7b654e9dee02d904b","6111116566fc4fd9abba409322bea245",17456436,1,1,0,304,103,104,1
"6111116566fc4fd9abba409322bea245","6111116566fc4fd9abba409322bea245",17456436,2,0,1,305,104,104,0
"6111116566fc4fd9abba409322bea245","a81b2235cb9c499eb9ea8ee0a8dd9725",17456436,1,1,0,307,104,105,1
"a81b2235cb9c499eb9ea8ee0a8dd9725","a81b2235cb9c499eb9ea8ee0a8dd9725",17456436,2,0,1,308,105,105,0
"a81b2235cb9c499eb9ea8ee0a8dd9725","2d4e0ab0ef3b4d73b82c72d4621a7579",17456436,1,1,0,310,105,106,1
"2d4e0ab0ef3b4d73b82c72d4621a7579","2d4e0ab0ef3b4d73b82c72d4621a7579",17456436,2,0,1,311,106,106,0
"2d4e0ab0ef3b4d73b82c72d4621a7579","8bdebf492ebd4e62b0d522e8ab5e5197",17456436,1,1,0,313,106,107,1
"8bdebf492ebd4e62b0d522e8ab5e5197","8bdebf492ebd4e62b0d522e8ab5e5197",17456436,2,0,1,314,107,107,0
"8bdebf492ebd4e62b0d522e8ab5e5197","73039f8c1eb9409cb4caee2cf968001e",17456436,1,-7,0,316,107,100,-7
"73039f8c1eb9409cb4caee2cf968001e","4280927ec4d643238aa49c32f9e06c6c",17456436,2,10,0,317,100,109,9
"4280927ec4d643238aa49c32f9e06c6c","4280927ec4d643238aa49c32f9e06c6c",17456436,4,0,1,318,109,109,0
"4280927ec4d643238aa49c32f9e06c6c","fc44e6a5f7654430af1227838224dceb",17456436,1,2,0,322,109,111,2
"fc44e6a5f7654430af1227838224dceb","fc44e6a5f7654430af1227838224dceb",17456436,2,0,1,323,111,111,0
"fc44e6a5f7654430af1227838224dceb","08111f75e22d409998cf8b85bd431f0a",17456436,1,-3,0,325,111,108,-3
"08111f75e22d409998cf8b85bd431f0a","a9ae0a3c070d455bb4369a8996313336",17456436,2,7,0,326,108,114,6
"a9ae0a3c070d455bb4369a8996313336","a9ae0a3c070d455bb4369a8996313336",17456436,4,0,1,327,114,114,0
"a9ae0a3c070d455bb4369a8996313336","e20db35ced8544ddac5bc3839145e463",17456436,1,-26,0,331,114,91,-23
"e20db35ced8544ddac5bc3839145e463","00ae5f0c51874a73a41ebea838d95682",17456436,1,11,0,332,91,101,10
"d391c8b6e56a43a7b654e9dee02d904b","73039f8c1eb9409cb4caee2cf968001e",17456436,1,-3,0,335,103,100,-3
"4280927ec4d643238aa49c32f9e06c6c","08111f75e22d409998cf8b85bd431f0a",17456436,1,-1,0,337,109,108,-1
"a9ae0a3c070d455bb4369a8996313336","71cec822bcff4f30a20e75dc63ef7b65",17456436,1,2,0,339,114,116,2
"71cec822bcff4f30a20e75dc63ef7b65","71cec822bcff4f30a20e75dc63ef7b65",17456436,1,0,1,340,116,116,0
"71cec822bcff4f30a20e75dc63ef7b65","37319e88176d4aefa91d7a9980dbae91",17456436,1,-4,0,341,116,112,-4
"37319e88176d4aefa91d7a9980dbae91","62bff51286ef4f348717a3cf6fe2318f",17456436,1,9,0,342,112,120,8
"62bff51286ef4f348717a3cf6fe2318f","b1cd0e7dc3ad4a8eb91a4bfdbeb025b0",17456436,1,-2,0,343,120,118,-2
"b1cd0e7dc3ad4a8eb91a4bfdbeb025b0","b1cd0e7dc3ad4a8eb91a4bfdbeb025b0",17456436,2,0,1,344,118,118,0
"b1cd0e7dc3ad4a8eb91a4bfdbeb025b0","62bff51286ef4f348717a3cf6fe2318f",17456436,1,2,0,346,118,120,2
"62bff51286ef4f348717a3cf6fe2318f","62bff51286ef4f348717a3cf6fe2318f",17456436,3,0,1,347,120,120,0
"62bff51286ef4f348717a3cf6fe2318f","e20db35ced8544ddac5bc3839145e463",17456436,1,-33,0,350,120,91,-29
"e20db35ced8544ddac5bc3839145e463","779f9ddd1fd14d1e9e69f72219a1fdbd",17456436,1,36,0,351,91,121,30
"779f9ddd1fd14d1e9e69f72219a1fdbd","ae26e6cda8ad4a3f81bd347560d9579f",17456436,1,4,0,352,121,125,4
"ae26e6cda8ad4a3f81bd347560d9579f","ae26e6cda8ad4a3f81bd347560d9579f",17456436,1,0,1,353,125,125,0
"ae26e6cda8ad4a3f81bd347560d9579f","ee48df95832b4374aa273ceb27ec1315",17456436,1,1,0,354,125,126,1
"ee48df95832b4374aa273ceb27ec1315","ee48df95832b4374aa273ceb27ec1315",17456436,1,0,1,355,126,126,0
"ee48df95832b4374aa273ceb27ec1315","7a439da90b394756ad1777fc4c6dead5",17456436,1,1,0,356,126,127,1
"7a439da90b394756ad1777fc4c6dead5","7a439da90b394756ad1777fc4c6dead5",17456436,1,0,1,357,127,127,0
"7a439da90b394756ad1777fc4c6dead5","a8dd5213034441ac92724b4e83eb0bb2",17456436,1,3,0,358,127,129,2
"a8dd5213034441ac92724b4e83eb0bb2","779f9ddd1fd14d1e9e69f72219a1fdbd",17456436,1,-9,0,359,129,121,-8
"779f9ddd1fd14d1e9e69f72219a1fdbd","a8dd5213034441ac92724b4e83eb0bb2",17456436,1,9,0,360,121,129,8
"a8dd5213034441ac92724b4e83eb0bb2","a8dd5213034441ac92724b4e83eb0bb2",17456436,1,0,1,361,129,129,0
"a8dd5213034441ac92724b4e83eb0bb2","8115eab6556b45f5b415c3b8c26a12e5",17456436,1,2,0,362,129,131,2
"8115eab6556b45f5b415c3b8c26a12e5","8115eab6556b45f5b415c3b8c26a12e5",17456436,2,0,1,363,131,131,0
"8115eab6556b45f5b415c3b8c26a12e5","ec34b06efd844b46a4c4818ecdb9b8f4",17456436,1,1,0,365,131,132,1
"ec34b06efd844b46a4c4818ecdb9b8f4","ec34b06efd844b46a4c4818ecdb9b8f4",17456436,2,0,1,366,132,132,0
"ec34b06efd844b46a4c4818ecdb9b8f4","c2e1c2b9eac64109b343a088584b576b",17456436,1,1,0,368,132,133,1
"c2e1c2b9eac64109b343a088584b576b","c2e1c2b9eac64109b343a088584b576b",17456436,2,0,1,369,133,133,0
"c2e1c2b9eac64109b343a088584b576b","579338175e0b4bbb8ef3b712b5d8b54e",17456436,1,-5,0,371,133,128,-5
"579338175e0b4bbb8ef3b712b5d8b54e","8bc5795d6a984a3eace4e2811e52dd4f",17456436,1,8,0,372,128,135,7
"8bc5795d6a984a3eace4e2811e52dd4f","8bc5795d6a984a3eace4e2811e52dd4f",17456436,1,0,1,373,135,135,0
"8bc5795d6a984a3eace4e2811e52dd4f","b416d47c56a742199b5d7c7f19d6503a",17456436,1,-1,0,374,135,134,-1
"b416d47c56a742199b5d7c7f19d6503a","cd4532ad48034873ba8bce2aac0c9808",17456436,1,4,0,375,134,137,3
"cd4532ad48034873ba8bce2aac0c9808","cd4532ad48034873ba8bce2aac0c9808",17456436,1,0,1,376,137,137,0
"cd4532ad48034873ba8bce2aac0c9808","779f9ddd1fd14d1e9e69f72219a1fdbd",17456436,1,-19,0,377,137,121,-16
"779f9ddd1fd14d1e9e69f72219a1fdbd","df1de691dafe4549a18a4398ee9dfaf9",17456436,1,23,0,378,121,139,18
"df1de691dafe4549a18a4398ee9dfaf9","6c5ad271a44743479bfaea29b1db8d02",17456436,1,4,0,379,139,143,4
"6c5ad271a44743479bfaea29b1db8d02","6c5ad271a44743479bfaea29b1db8d02",17456436,1,0,1,380,143,143,0
"6c5ad271a44743479bfaea29b1db8d02","83d311bed5374fee83d8d67a7d9d82dc",17456436,1,1,0,381,143,144,1
"83d311bed5374fee83d8d67a7d9d82dc","83d311bed5374fee83d8d67a7d9d82dc",17456436,1,0,1,382,144,144,0
"83d311bed5374fee83d8d67a7d9d82dc","402bba41861d43acb52a5abb89e8831e",17456436,1,1,0,383,144,145,1
"402bba41861d43acb52a5abb89e8831e","402bba41861d43acb52a5abb89e8831e",17456436,2,0,1,384,145,145,0
"402bba41861d43acb52a5abb89e8831e","8aae34f5ddbb4052a709b12e6b0d40fa",17456436,1,3,0,386,145,147,2
"8aae34f5ddbb4052a709b12e6b0d40fa","df1de691dafe4549a18a4398ee9dfaf9",17456436,1,-9,0,387,147,139,-8
"df1de691dafe4549a18a4398ee9dfaf9","8aae34f5ddbb4052a709b12e6b0d40fa",17456436,1,9,0,388,139,147,8
"8aae34f5ddbb4052a709b12e6b0d40fa","645b3f0249f64f76af2e19eb4d0e55b7",17456436,1,2,0,389,147,149,2
"645b3f0249f64f76af2e19eb4d0e55b7","645b3f0249f64f76af2e19eb4d0e55b7",17456436,2,0,1,390,149,149,0
"645b3f0249f64f76af2e19eb4d0e55b7","7e7b8db5064d4369805ab370aac5ddfb",17456436,1,1,0,392,149,150,1
"7e7b8db5064d4369805ab370aac5ddfb","7e7b8db5064d4369805ab370aac5ddfb",17456436,2,0,1,393,150,150,0
"7e7b8db5064d4369805ab370aac5ddfb","8956d210ae7f41968fada86d4c979d6a",17456436,1,1,0,395,150,151,1
"8956d210ae7f41968fada86d4c979d6a","8956d210ae7f41968fada86d4c979d6a",17456436,2,0,1,396,151,151,0
"8956d210ae7f41968fada86d4c979d6a","f902b0f41b544d4dbf79664fd233648d",17456436,1,-5,0,398,151,146,-5
"f902b0f41b544d4dbf79664fd233648d","ae781e8b775e4ccd93bc800dad5c8376",17456436,1,8,0,399,146,153,7
"ae781e8b775e4ccd93bc800dad5c8376","ae781e8b775e4ccd93bc800dad5c8376",17456436,2,0,1,400,153,153,0
"ae781e8b775e4ccd93bc800dad5c8376","06882a8492d9499aa31555567f575ecb",17456436,1,1,0,402,153,154,1
"06882a8492d9499aa31555567f575ecb","06882a8492d9499aa31555567f575ecb",17456436,1,0,1,403,154,154,0
"06882a8492d9499aa31555567f575ecb","f293c508f409466a8f27ddd7d1e40b20",17456436,1,1,0,404,154,155,1
"f293c508f409466a8f27ddd7d1e40b20","f293c508f409466a8f27ddd7d1e40b20",17456436,2,0,1,405,155,155,0
"f293c508f409466a8f27ddd7d1e40b20","cc4ddef5bbbe48ebb605141b347c4ed1",17456436,1,1,0,407,155,156,1
"cc4ddef5bbbe48ebb605141b347c4ed1","cc4ddef5bbbe48ebb605141b347c4ed1",17456436,1,0,1,408,156,156,0
"cc4ddef5bbbe48ebb605141b347c4ed1","d313cec988a84645bee413e8d4724a4b",17456436,1,3,0,409,156,158,2
"d313cec988a84645bee413e8d4724a4b","f03480cf4eba413194d7af52fc0e7f28",17456436,1,-7,0,410,158,152,-6
"f03480cf4eba413194d7af52fc0e7f28","d313cec988a84645bee413e8d4724a4b",17456436,1,7,0,411,152,158,6
"d313cec988a84645bee413e8d4724a4b","d313cec988a84645bee413e8d4724a4b",17456436,3,0,1,412,158,158,0
"d313cec988a84645bee413e8d4724a4b","dc60696c76a74368a60f72246e47700d",17456436,1,1,0,415,158,159,1
"dc60696c76a74368a60f72246e47700d","dc60696c76a74368a60f72246e47700d",17456436,1,0,1,416,159,159,0
"dc60696c76a74368a60f72246e47700d","df1de691dafe4549a18a4398ee9dfaf9",17456436,1,-23,0,417,159,139,-20
"df1de691dafe4549a18a4398ee9dfaf9","78adeee1fa2c4fe0bc73f7bca9fcee86",17456436,1,26,0,418,139,160,21
"78adeee1fa2c4fe0bc73f7bca9fcee86","78adeee1fa2c4fe0bc73f7bca9fcee86",17456436,1,0,1,419,160,160,0
"78adeee1fa2c4fe0bc73f7bca9fcee86","b534b89233134e30a9b5645138bfa9ee",17456436,1,-148,0,420,160,41,-119
"b534b89233134e30a9b5645138bfa9ee","d9c8d8c444a64dadbbb508652c721e17",17456436,1,6,0,421,41,46,5
"d9c8d8c444a64dadbbb508652c721e17","6e13d61a7bdb44bca949c9f86fab3be5",17456436,1,1,0,422,46,47,1
"6e13d61a7bdb44bca949c9f86fab3be5","78adeee1fa2c4fe0bc73f7bca9fcee86",17456436,1,141,0,423,47,160,113
"78adeee1fa2c4fe0bc73f7bca9fcee86","65202579580f4ad38d734b4ee39d22a8",17456436,2,5,0,424,160,164,4
"65202579580f4ad38d734b4ee39d22a8","65202579580f4ad38d734b4ee39d22a8",17456436,61,0,1,425,164,164,0
"65202579580f4ad38d734b4ee39d22a8","78adeee1fa2c4fe0bc73f7bca9fcee86",17456436,1,-5,0,477,164,160,-4
"65202579580f4ad38d734b4ee39d22a8","3cbcea2be0984e7dbd5a48195af10ce7",17456436,1,3,0,488,164,165,1
"3cbcea2be0984e7dbd5a48195af10ce7","78adeee1fa2c4fe0bc73f7bca9fcee86",17456436,1,-8,0,489,165,160,-5
"78adeee1fa2c4fe0bc73f7bca9fcee86","82e6285962b8400d9d6fc32436022a94",17456436,1,10,0,490,160,167,7
"82e6285962b8400d9d6fc32436022a94","3cbcea2be0984e7dbd5a48195af10ce7",17456436,2,-2,0,491,167,165,-2
"3cbcea2be0984e7dbd5a48195af10ce7","82e6285962b8400d9d6fc32436022a94",17456436,1,2,0,492,165,167,2
"3cbcea2be0984e7dbd5a48195af10ce7","a9ac840f098c4bd0a2ee896214ce29cd",17456436,1,5,0,494,165,168,3
"a9ac840f098c4bd0a2ee896214ce29cd","a9ac840f098c4bd0a2ee896214ce29cd",17456436,1,0,1,495,168,168,0
"a9ac840f098c4bd0a2ee896214ce29cd","0c7262dff33c4087bc660ccf40f92f9c",17456436,1,4,0,496,168,169,1
"0c7262dff33c4087bc660ccf40f92f9c","b2275c3fad834f8d90737a2d9a6927d6",17456436,2,3,0,497,169,172,3
"b2275c3fad834f8d90737a2d9a6927d6","b2275c3fad834f8d90737a2d9a6927d6",17456436,30,0,1,498,172,172,0
"b2275c3fad834f8d90737a2d9a6927d6","eb515a26030b41f8a82a1e6114420bad",17456436,1,1,0,528,172,173,1
"eb515a26030b41f8a82a1e6114420bad","eb515a26030b41f8a82a1e6114420bad",17456436,6,0,1,529,173,173,0
"eb515a26030b41f8a82a1e6114420bad","b42cc17b7de840f181a704558d0bc845",17456436,1,3,0,535,173,175,2
"b42cc17b7de840f181a704558d0bc845","0c7262dff33c4087bc660ccf40f92f9c",17456436,2,-7,0,536,175,169,-6
"0c7262dff33c4087bc660ccf40f92f9c","0c7262dff33c4087bc660ccf40f92f9c",17456436,1,0,1,537,169,169,0
"b2275c3fad834f8d90737a2d9a6927d6","b42cc17b7de840f181a704558d0bc845",17456436,1,4,0,539,172,175,3
"0c7262dff33c4087bc660ccf40f92f9c","b42cc17b7de840f181a704558d0bc845",17456436,1,7,0,541,169,175,6
"b42cc17b7de840f181a704558d0bc845","b42cc17b7de840f181a704558d0bc845",17456436,1,0,1,542,175,175,0
"b42cc17b7de840f181a704558d0bc845","801f9e9135034f49bf5f8b4bdefedb41",17456436,1,2,0,543,175,177,2
"801f9e9135034f49bf5f8b4bdefedb41","801f9e9135034f49bf5f8b4bdefedb41",17456436,8,0,1,544,177,177,0
"801f9e9135034f49bf5f8b4bdefedb41","362fcb0699a14845ab29b2340093e528",17456436,1,-3,0,552,177,174,-3
"362fcb0699a14845ab29b2340093e528","b87c552dd247427abe6ab5795b9c9d43",17456436,1,8,0,553,174,181,7
"b87c552dd247427abe6ab5795b9c9d43","ea38cc0e6e6e41edbabf210220808bf9",17456436,1,-2,0,554,181,179,-2
"ea38cc0e6e6e41edbabf210220808bf9","ea38cc0e6e6e41edbabf210220808bf9",17456436,1,0,1,555,179,179,0
"ea38cc0e6e6e41edbabf210220808bf9","b87c552dd247427abe6ab5795b9c9d43",17456436,1,2,0,556,179,181,2
"b87c552dd247427abe6ab5795b9c9d43","b87c552dd247427abe6ab5795b9c9d43",17456436,7,0,1,557,181,181,0
"b87c552dd247427abe6ab5795b9c9d43","139b097acfca451689d80c9c6eebdf7b",17456436,1,-3,0,564,181,178,-3
"139b097acfca451689d80c9c6eebdf7b","30f660a1feb34582a739722532524f79",17456436,1,6,0,565,178,183,5
"30f660a1feb34582a739722532524f79","30f660a1feb34582a739722532524f79",17456436,6,0,1,566,183,183,0
"30f660a1feb34582a739722532524f79","2024b4885bd14338a39b7b509acbbd02",17456436,1,-1,0,572,183,182,-1
"2024b4885bd14338a39b7b509acbbd02","c3f63fe50d8e487c86bf8ef76c9cadd3",17456436,1,4,0,573,182,185,3
"c3f63fe50d8e487c86bf8ef76c9cadd3","c3f63fe50d8e487c86bf8ef76c9cadd3",17456436,1,0,1,574,185,185,0
"c3f63fe50d8e487c86bf8ef76c9cadd3","c8e371568a0c4391b25796ae4e91952e",17456436,1,3,0,575,185,186,1
"c8e371568a0c4391b25796ae4e91952e","0c7262dff33c4087bc660ccf40f92f9c",17456436,1,-23,0,576,186,169,-17
"0c7262dff33c4087bc660ccf40f92f9c","7d932b23e1c84326ae5aa4d3c0d813d1",17456436,1,25,0,577,169,188,19
"7d932b23e1c84326ae5aa4d3c0d813d1","7d932b23e1c84326ae5aa4d3c0d813d1",17456436,2,0,1,578,188,188,0
"7d932b23e1c84326ae5aa4d3c0d813d1","ab11d94c6c8948ea90b88f19d2cd502b",17456436,1,3,0,580,188,190,2
"ab11d94c6c8948ea90b88f19d2cd502b","c8e371568a0c4391b25796ae4e91952e",17456436,1,-5,0,581,190,186,-4
"c8e371568a0c4391b25796ae4e91952e","ab11d94c6c8948ea90b88f19d2cd502b",17456436,1,5,0,582,186,190,4
"ab11d94c6c8948ea90b88f19d2cd502b","ab11d94c6c8948ea90b88f19d2cd502b",17456436,1,0,1,583,190,190,0
"ab11d94c6c8948ea90b88f19d2cd502b","f992451ed6ad4e68bb9e68ad6be7c4be",17456436,1,2,0,584,190,192,2
"f992451ed6ad4e68bb9e68ad6be7c4be","f992451ed6ad4e68bb9e68ad6be7c4be",17456436,1,0,1,585,192,192,0
"f992451ed6ad4e68bb9e68ad6be7c4be","6cd2dcaac46847d4a0bc53f296d90375",17456436,1,3,0,586,192,194,2
"6cd2dcaac46847d4a0bc53f296d90375","07b44a7a51e94c78b411c753fc39dab0",17456436,1,-6,0,587,194,189,-5
"07b44a7a51e94c78b411c753fc39dab0","6cd2dcaac46847d4a0bc53f296d90375",17456436,1,6,0,588,189,194,5
"6cd2dcaac46847d4a0bc53f296d90375","2d2580c9411c4972909db508d6956a58",17456436,1,2,0,589,194,196,2
"2d2580c9411c4972909db508d6956a58","2d2580c9411c4972909db508d6956a58",17456436,2,0,1,590,196,196,0
"2d2580c9411c4972909db508d6956a58","5bddb3d9ed264f3984702f048c7e5340",17456436,1,1,0,592,196,197,1
"5bddb3d9ed264f3984702f048c7e5340","5bddb3d9ed264f3984702f048c7e5340",17456436,2,0,1,593,197,197,0
"5bddb3d9ed264f3984702f048c7e5340","d5e8e2bd12a2466b9d6d90855f0eb079",17456436,1,1,0,595,197,198,1
"d5e8e2bd12a2466b9d6d90855f0eb079","d5e8e2bd12a2466b9d6d90855f0eb079",17456436,2,0,1,596,198,198,0
"d5e8e2bd12a2466b9d6d90855f0eb079","017d7ca8e0394b91aaadc9574df2202c",17456436,1,-5,0,598,198,193,-5
"017d7ca8e0394b91aaadc9574df2202c","54e8e9f0ea3e45c4bf3b8ac799ee31b1",17456436,1,8,0,599,193,200,7
"54e8e9f0ea3e45c4bf3b8ac799ee31b1","54e8e9f0ea3e45c4bf3b8ac799ee31b1",17456436,1,0,1,600,200,200,0
"54e8e9f0ea3e45c4bf3b8ac799ee31b1","c614a00911be4877a075f19315530fb0",17456436,1,1,0,601,200,201,1
"c614a00911be4877a075f19315530fb0","c614a00911be4877a075f19315530fb0",17456436,6,0,1,602,201,201,0
"c614a00911be4877a075f19315530fb0","a6c21bd8b95249c7972820a7a7d76aff",17456436,1,1,0,608,201,202,1
"a6c21bd8b95249c7972820a7a7d76aff","a6c21bd8b95249c7972820a7a7d76aff",17456436,1,0,1,609,202,202,0
"a6c21bd8b95249c7972820a7a7d76aff","bb329d880ab54120adaf203a693bb203",17456436,1,1,0,610,202,203,1
"bb329d880ab54120adaf203a693bb203","bb329d880ab54120adaf203a693bb203",17456436,1,0,1,611,203,203,0
"bb329d880ab54120adaf203a693bb203","f9170dd6bc6442b4acd832747609b09a",17456436,1,-4,0,612,203,199,-4
"f9170dd6bc6442b4acd832747609b09a","334c2344009840079b1d0e1b7ce3d5a7",17456436,1,7,0,613,199,205,6
"334c2344009840079b1d0e1b7ce3d5a7","334c2344009840079b1d0e1b7ce3d5a7",17456436,1,0,1,614,205,205,0
"334c2344009840079b1d0e1b7ce3d5a7","c8e371568a0c4391b25796ae4e91952e",17456436,1,-23,0,615,205,186,-19
"c8e371568a0c4391b25796ae4e91952e","d7f13c8d63ec4e2aa673fbb9cf9c6933",17456436,1,26,0,616,186,206,20
"d7f13c8d63ec4e2aa673fbb9cf9c6933","b9e80f77c3a44349863b19875725c384",17456436,1,1,0,617,206,207,1
"b9e80f77c3a44349863b19875725c384","7108f0e4c2584f1f9c471689ae4c885c",17456436,2,1,0,618,207,208,1
"7108f0e4c2584f1f9c471689ae4c885c","b9e80f77c3a44349863b19875725c384",17456436,1,-1,0,619,208,207,-1
"b9e80f77c3a44349863b19875725c384","b9e80f77c3a44349863b19875725c384",17456436,13,0,1,620,207,207,0
"7108f0e4c2584f1f9c471689ae4c885c","7108f0e4c2584f1f9c471689ae4c885c",17456436,10,0,1,634,208,208,0
"7108f0e4c2584f1f9c471689ae4c885c","09400e101c5d4b439cf9a26b03aae558",17456436,1,3,0,644,208,210,2
"09400e101c5d4b439cf9a26b03aae558","d7f13c8d63ec4e2aa673fbb9cf9c6933",17456436,1,-5,0,645,210,206,-4
"d7f13c8d63ec4e2aa673fbb9cf9c6933","09400e101c5d4b439cf9a26b03aae558",17456436,1,5,0,646,206,210,4
"09400e101c5d4b439cf9a26b03aae558","a88efa7e50ce47159810ab553afa6d3a",17456436,1,2,0,647,210,212,2
"a88efa7e50ce47159810ab553afa6d3a","a88efa7e50ce47159810ab553afa6d3a",17456436,8,0,1,648,212,212,0
"a88efa7e50ce47159810ab553afa6d3a","be502a7a43c44bf7b682698de79d9369",17456436,1,3,0,656,212,214,2
"be502a7a43c44bf7b682698de79d9369","a875096404ef4a9984b62d74cda916f9",17456436,1,-6,0,657,214,209,-5
"a875096404ef4a9984b62d74cda916f9","f7fb1952f56b4189b86a9f8b7862d2b8",17456436,1,7,0,658,209,215,6
"f7fb1952f56b4189b86a9f8b7862d2b8","be502a7a43c44bf7b682698de79d9369",17456436,1,-1,0,659,215,214,-1
"be502a7a43c44bf7b682698de79d9369","be502a7a43c44bf7b682698de79d9369",17456436,1,0,1,660,214,214,0
"be502a7a43c44bf7b682698de79d9369","f7fb1952f56b4189b86a9f8b7862d2b8",17456436,1,1,0,661,214,215,1
"f7fb1952f56b4189b86a9f8b7862d2b8","f7fb1952f56b4189b86a9f8b7862d2b8",17456436,13,0,1,662,215,215,0
"f7fb1952f56b4189b86a9f8b7862d2b8","b860ee85d8bc4a2f97958cfb71be3533",17456436,1,1,0,675,215,216,1
"b860ee85d8bc4a2f97958cfb71be3533","b860ee85d8bc4a2f97958cfb71be3533",17456436,2,0,1,676,216,216,0
"b860ee85d8bc4a2f97958cfb71be3533","ec341f459285443b8361f7f15638ff08",17456436,1,-3,0,678,216,213,-3
"ec341f459285443b8361f7f15638ff08","363837c182e04711840d896ae1e0339c",17456436,1,6,0,679,213,218,5
"363837c182e04711840d896ae1e0339c","363837c182e04711840d896ae1e0339c",17456436,12,0,1,680,218,218,0
"363837c182e04711840d896ae1e0339c","01b2051f8941460d89945e3b02d1ce78",17456436,1,-1,0,692,218,217,-1
"01b2051f8941460d89945e3b02d1ce78","91125ca626c5470eb145501f8c37f8db",17456436,1,4,0,693,217,220,3
"91125ca626c5470eb145501f8c37f8db","91125ca626c5470eb145501f8c37f8db",17456436,1,0,1,694,220,220,0
"91125ca626c5470eb145501f8c37f8db","d7f13c8d63ec4e2aa673fbb9cf9c6933",17456436,1,-18,0,695,220,206,-14
"d7f13c8d63ec4e2aa673fbb9cf9c6933","1c6721b1f63f4d30ba7746ea8af02a52",17456436,2,21,0,696,206,221,15
"1c6721b1f63f4d30ba7746ea8af02a52","77ecef8eff6b4a2caea7707669bf7475",17456436,2,1,0,697,221,222,1
"77ecef8eff6b4a2caea7707669bf7475","d7f13c8d63ec4e2aa673fbb9cf9c6933",17456436,1,-22,0,698,222,206,-16
"d7f13c8d63ec4e2aa673fbb9cf9c6933","d7f13c8d63ec4e2aa673fbb9cf9c6933",17456436,1,0,1,699,206,206,0
"77ecef8eff6b4a2caea7707669bf7475","77ecef8eff6b4a2caea7707669bf7475",17456436,12,0,1,702,222,222,0
"77ecef8eff6b4a2caea7707669bf7475","d03cb855c70044cf8c35d9ec0de696e3",17456436,1,3,0,714,222,224,2
"d03cb855c70044cf8c35d9ec0de696e3","1c6721b1f63f4d30ba7746ea8af02a52",17456436,1,-4,0,715,224,221,-3
"1c6721b1f63f4d30ba7746ea8af02a52","8b9ae98743bd4d4a8a87dff1c1244211",17456436,1,7,0,716,221,227,6
"8b9ae98743bd4d4a8a87dff1c1244211","d03cb855c70044cf8c35d9ec0de696e3",17456436,1,-3,0,717,227,224,-3
"d03cb855c70044cf8c35d9ec0de696e3","a49a937d6896486d9a5396654abcf2e1",17456436,1,2,0,718,224,226,2
"a49a937d6896486d9a5396654abcf2e1","a49a937d6896486d9a5396654abcf2e1",17456436,3,0,1,719,226,226,0
"a49a937d6896486d9a5396654abcf2e1","8b9ae98743bd4d4a8a87dff1c1244211",17456436,1,1,0,722,226,227,1
"8b9ae98743bd4d4a8a87dff1c1244211","8b9ae98743bd4d4a8a87dff1c1244211",17456436,15,0,1,723,227,227,0
"8b9ae98743bd4d4a8a87dff1c1244211","2ab1535aac1346ba8801535bf729ef37",17456436,1,3,0,738,227,229,2
"2ab1535aac1346ba8801535bf729ef37","f7906d6f59b9489a91d2ef40db5a474d",17456436,1,-7,0,739,229,223,-6
"f7906d6f59b9489a91d2ef40db5a474d","2ab1535aac1346ba8801535bf729ef37",17456436,1,7,0,740,223,229,6
"2ab1535aac1346ba8801535bf729ef37","a4f40fb48a8542c8949bae1f002cd9bc",17456436,1,2,0,741,229,231,2
"a4f40fb48a8542c8949bae1f002cd9bc","a4f40fb48a8542c8949bae1f002cd9bc",17456436,2,0,1,742,231,231,0
"a4f40fb48a8542c8949bae1f002cd9bc","8972c23e32044edb8a78fa1eed4e5947",17456436,1,1,0,744,231,232,1
"8972c23e32044edb8a78fa1eed4e5947","8972c23e32044edb8a78fa1eed4e5947",17456436,1,0,1,745,232,232,0
"8972c23e32044edb8a78fa1eed4e5947","92feb4a40f8344d38b6f722e42a53295",17456436,1,1,0,746,232,233,1
"92feb4a40f8344d38b6f722e42a53295","92feb4a40f8344d38b6f722e42a53295",17456436,2,0,1,747,233,233,0
"92feb4a40f8344d38b6f722e42a53295","5152833676bf4c6cb317060be10f68db",17456436,1,-5,0,749,233,228,-5
"5152833676bf4c6cb317060be10f68db","ca3e28f290354c08aefe5b0f769604e6",17456436,1,8,0,750,228,235,7
"ca3e28f290354c08aefe5b0f769604e6","ca3e28f290354c08aefe5b0f769604e6",17456436,4,0,1,751,235,235,0
"ca3e28f290354c08aefe5b0f769604e6","79a35eea833e4c2c9d22fc53c3c6445c",17456436,1,1,0,755,235,236,1
"79a35eea833e4c2c9d22fc53c3c6445c","79a35eea833e4c2c9d22fc53c3c6445c",17456436,9,0,1,756,236,236,0
"79a35eea833e4c2c9d22fc53c3c6445c","8f68228b1518449e9615cdafee41a2bd",17456436,1,1,0,765,236,237,1
"8f68228b1518449e9615cdafee41a2bd","8f68228b1518449e9615cdafee41a2bd",17456436,1,0,1,766,237,237,0
"8f68228b1518449e9615cdafee41a2bd","cab89fa5c3ed45a5aa550fc0352d6a42",17456436,1,1,0,767,237,238,1
"cab89fa5c3ed45a5aa550fc0352d6a42","cab89fa5c3ed45a5aa550fc0352d6a42",17456436,1,0,1,768,238,238,0
"cab89fa5c3ed45a5aa550fc0352d6a42","66d4fad4f1cf4b46be0750a99ad7a35a",17456436,1,1,0,769,238,239,1
"66d4fad4f1cf4b46be0750a99ad7a35a","66d4fad4f1cf4b46be0750a99ad7a35a",17456436,1,0,1,770,239,239,0
"66d4fad4f1cf4b46be0750a99ad7a35a","0b04c8e2f86d48c7aeb7e225819cd32b",17456436,1,-5,0,771,239,234,-5
"0b04c8e2f86d48c7aeb7e225819cd32b","f53da5fd9bfe412da4b80d4742563b6c",17456436,1,8,0,772,234,241,7
"f53da5fd9bfe412da4b80d4742563b6c","f53da5fd9bfe412da4b80d4742563b6c",17456436,1,0,1,773,241,241,0
"f53da5fd9bfe412da4b80d4742563b6c","1c6721b1f63f4d30ba7746ea8af02a52",17456436,1,-24,0,774,241,221,-20
"1c6721b1f63f4d30ba7746ea8af02a52","2ae94c0cea4d480a9d5dca8fb1d7b542",17456436,1,27,0,775,221,242,21
"2ae94c0cea4d480a9d5dca8fb1d7b542","1ebf23f9d994469a85206e4c7b1bf5f5",17456436,1,3,0,776,242,245,3
"1ebf23f9d994469a85206e4c7b1bf5f5","1ebf23f9d994469a85206e4c7b1bf5f5",17456436,10,0,1,777,245,245,0
"1ebf23f9d994469a85206e4c7b1bf5f5","85ae675b83e8422da842cfd25596af99",17456436,1,1,0,787,245,246,1
"85ae675b83e8422da842cfd25596af99","85ae675b83e8422da842cfd25596af99",17456436,1,0,1,788,246,246,0
"85ae675b83e8422da842cfd25596af99","fa235f0f364d47e4ae1c87f47bf8e6ba",17456436,1,8,0,789,246,252,6
"fa235f0f364d47e4ae1c87f47bf8e6ba","2ae94c0cea4d480a9d5dca8fb1d7b542",17456436,1,-12,0,790,252,242,-10
"2ae94c0cea4d480a9d5dca8fb1d7b542","fa235f0f364d47e4ae1c87f47bf8e6ba",17456436,1,12,0,791,242,252,10
"fa235f0f364d47e4ae1c87f47bf8e6ba","79f7845465cc4ed19d8e4f1429541be0",17456436,1,2,0,792,252,254,2
"79f7845465cc4ed19d8e4f1429541be0","79f7845465cc4ed19d8e4f1429541be0",17456436,2,0,1,793,254,254,0
"79f7845465cc4ed19d8e4f1429541be0","00f61990949545828dd12f1303d47504",17456436,1,3,0,795,254,256,2
"00f61990949545828dd12f1303d47504","6e83e23f56544a19b94067c1c558d9c0",17456436,1,-11,0,796,256,247,-9
"6e83e23f56544a19b94067c1c558d9c0","00f61990949545828dd12f1303d47504",17456436,1,11,0,797,247,256,9
"00f61990949545828dd12f1303d47504","ead7bb4b64e247d2ae632ab8a296b091",17456436,1,2,0,798,256,258,2
"ead7bb4b64e247d2ae632ab8a296b091","ead7bb4b64e247d2ae632ab8a296b091",17456436,2,0,1,799,258,258,0
"ead7bb4b64e247d2ae632ab8a296b091","41b0048dde734bb280bac6116baa8e27",17456436,1,1,0,801,258,259,1
"41b0048dde734bb280bac6116baa8e27","41b0048dde734bb280bac6116baa8e27",17456436,2,0,1,802,259,259,0
"41b0048dde734bb280bac6116baa8e27","b41c5a094a604ee0915327da5cc0beb7",17456436,1,1,0,804,259,260,1
"b41c5a094a604ee0915327da5cc0beb7","b41c5a094a604ee0915327da5cc0beb7",17456436,2,0,1,805,260,260,0
"b41c5a094a604ee0915327da5cc0beb7","d546341988904f069cfa86b21457d9d9",17456436,1,-10,0,807,260,251,-9
"d546341988904f069cfa86b21457d9d9","28c171777c52431ab6b925073bd63d46",17456436,1,15,0,808,251,264,13
"28c171777c52431ab6b925073bd63d46","28c171777c52431ab6b925073bd63d46",17456436,3,0,1,809,264,264,0
"28c171777c52431ab6b925073bd63d46","ac160db940cb49ae8579162b1d52bb5d",17456436,1,2,0,812,264,266,2
"ac160db940cb49ae8579162b1d52bb5d","ac160db940cb49ae8579162b1d52bb5d",17456436,3,0,1,813,266,266,0
"ac160db940cb49ae8579162b1d52bb5d","d989ebcfc12a4b669f0100dc1aa14f1e",17456436,1,-12,0,816,266,255,-11
"d989ebcfc12a4b669f0100dc1aa14f1e","c6fd49b485cc4874b0bbdd9c6171e09c",17456436,1,15,0,817,255,268,13
"c6fd49b485cc4874b0bbdd9c6171e09c","c6fd49b485cc4874b0bbdd9c6171e09c",17456436,3,0,1,818,268,268,0
"c6fd49b485cc4874b0bbdd9c6171e09c","44240778a97c4af0937817499b75707b",17456436,1,1,0,821,268,269,1
"44240778a97c4af0937817499b75707b","44240778a97c4af0937817499b75707b",17456436,2,0,1,822,269,269,0
"44240778a97c4af0937817499b75707b","7aa76d3e993840d8805f097cbdbcd44b",17456436,1,-9,0,824,269,261,-8
"7aa76d3e993840d8805f097cbdbcd44b","865a4d3b43374da7944dc7d397f566d9",17456436,1,12,0,825,261,271,10
"865a4d3b43374da7944dc7d397f566d9","865a4d3b43374da7944dc7d397f566d9",17456436,1,0,1,826,271,271,0
"865a4d3b43374da7944dc7d397f566d9","0d987bed3ffa4ed0b9a2e62e97b7b30f",17456436,1,3,0,827,271,272,1
"0d987bed3ffa4ed0b9a2e62e97b7b30f","2ae94c0cea4d480a9d5dca8fb1d7b542",17456436,1,-38,0,828,272,242,-30
"2ae94c0cea4d480a9d5dca8fb1d7b542","0d987bed3ffa4ed0b9a2e62e97b7b30f",17456436,1,38,0,829,242,272,30
"0d987bed3ffa4ed0b9a2e62e97b7b30f","bb5a47f5ea01454a8b79455422d3b9da",17456436,6,10,0,830,272,280,8
"bb5a47f5ea01454a8b79455422d3b9da","82ae07bc0c9b4570a41799290d1ef399",17456436,2,-6,0,831,280,275,-5
"82ae07bc0c9b4570a41799290d1ef399","bb5a47f5ea01454a8b79455422d3b9da",17456436,2,6,0,832,275,280,5
"bb5a47f5ea01454a8b79455422d3b9da","bb5a47f5ea01454a8b79455422d3b9da",17456436,92,0,1,833,280,280,0
"bb5a47f5ea01454a8b79455422d3b9da","0d987bed3ffa4ed0b9a2e62e97b7b30f",17456436,3,-10,0,839,280,272,-8
"bb5a47f5ea01454a8b79455422d3b9da","bc5524e78a8544e2ae2fdc2f3462bbec",17456436,2,-1,0,848,280,279,-1
"bc5524e78a8544e2ae2fdc2f3462bbec","0d987bed3ffa4ed0b9a2e62e97b7b30f",17456436,1,-9,0,849,279,272,-7
"bc5524e78a8544e2ae2fdc2f3462bbec","82ae07bc0c9b4570a41799290d1ef399",17456436,1,-5,0,859,279,275,-4
"82ae07bc0c9b4570a41799290d1ef399","0d987bed3ffa4ed0b9a2e62e97b7b30f",17456436,3,-4,0,860,275,272,-3
"0d987bed3ffa4ed0b9a2e62e97b7b30f","82ae07bc0c9b4570a41799290d1ef399",17456436,2,4,0,861,272,275,3
"bb5a47f5ea01454a8b79455422d3b9da","94cecc3f1e7d484b8e068e79241dfd73",17456436,1,3,0,933,280,281,1
"94cecc3f1e7d484b8e068e79241dfd73","0d987bed3ffa4ed0b9a2e62e97b7b30f",17456436,1,-13,0,934,281,272,-9
"0d987bed3ffa4ed0b9a2e62e97b7b30f","a37477c4e4c14169ad44b06b493007f6",17456436,1,15,0,935,272,283,11
"a37477c4e4c14169ad44b06b493007f6","94cecc3f1e7d484b8e068e79241dfd73",17456436,1,-2,0,936,283,281,-2
"94cecc3f1e7d484b8e068e79241dfd73","fab84b4fab5940efb4ea868ef8d09396",17456436,2,5,0,937,281,284,3
"fab84b4fab5940efb4ea868ef8d09396","4a29443515bb404cb8924e1c60a63b73",17456436,2,4,0,938,284,285,1
"4a29443515bb404cb8924e1c60a63b73","fab84b4fab5940efb4ea868ef8d09396",17456436,1,-4,0,939,285,284,-1
"fab84b4fab5940efb4ea868ef8d09396","208c9b2796c944db8dacaa96082520ea",17456436,1,7,0,940,284,288,4
"208c9b2796c944db8dacaa96082520ea","0d987bed3ffa4ed0b9a2e62e97b7b30f",17456436,1,-25,0,941,288,272,-16
"0d987bed3ffa4ed0b9a2e62e97b7b30f","94cecc3f1e7d484b8e068e79241dfd73",17456436,1,13,0,953,272,281,9
"94cecc3f1e7d484b8e068e79241dfd73","a37477c4e4c14169ad44b06b493007f6",17456436,1,2,0,954,281,283,2
"a37477c4e4c14169ad44b06b493007f6","fab84b4fab5940efb4ea868ef8d09396",17456436,1,3,0,955,283,284,1
"fab84b4fab5940efb4ea868ef8d09396","94cecc3f1e7d484b8e068e79241dfd73",17456436,1,-5,0,956,284,281,-3
"4a29443515bb404cb8924e1c60a63b73","208c9b2796c944db8dacaa96082520ea",17456436,1,3,0,959,285,288,3
"208c9b2796c944db8dacaa96082520ea","208c9b2796c944db8dacaa96082520ea",17456436,4,0,1,960,288,288,0
"208c9b2796c944db8dacaa96082520ea","4a29443515bb404cb8924e1c60a63b73",17456436,1,-3,0,964,288,285,-3
"4a29443515bb404cb8924e1c60a63b73","7669a956527947d0add87455277e80b4",17456436,1,7,0,965,285,291,6
"7669a956527947d0add87455277e80b4","7669a956527947d0add87455277e80b4",17456436,1,0,1,966,291,291,0
"7669a956527947d0add87455277e80b4","869e967078f04da18dd0b0b9389a7424",17456436,1,3,0,967,291,293,2
"869e967078f04da18dd0b0b9389a7424","6a9a3b5bde4a48daa896fe8c06eca56f",17456436,1,-5,0,968,293,289,-4
"6a9a3b5bde4a48daa896fe8c06eca56f","869e967078f04da18dd0b0b9389a7424",17456436,1,5,0,969,289,293,4
"869e967078f04da18dd0b0b9389a7424","51ab6291537748fab90d519aa09889d6",17456436,1,2,0,970,293,295,2
"51ab6291537748fab90d519aa09889d6","51ab6291537748fab90d519aa09889d6",17456436,5,0,1,971,295,295,0
"51ab6291537748fab90d519aa09889d6","34a6e49023fc4465bd5ca604330bbd1c",17456436,1,-3,0,976,295,292,-3
"34a6e49023fc4465bd5ca604330bbd1c","ba0e59461bfb4a44b7b1c28a01f8d3b3",17456436,1,9,0,977,292,299,7
"ba0e59461bfb4a44b7b1c28a01f8d3b3","21592f2a9e9c4b2f8c66ec5dbcbf6a2b",17456436,1,-4,0,978,299,296,-3
"21592f2a9e9c4b2f8c66ec5dbcbf6a2b","ba0e59461bfb4a44b7b1c28a01f8d3b3",17456436,1,4,0,979,296,299,3
"ba0e59461bfb4a44b7b1c28a01f8d3b3","ba0e59461bfb4a44b7b1c28a01f8d3b3",17456436,1,0,1,980,299,299,0
"ba0e59461bfb4a44b7b1c28a01f8d3b3","0e0b36e731a645e7b1b8a88f5031ca38",17456436,1,2,0,981,299,301,2
"0e0b36e731a645e7b1b8a88f5031ca38","0e0b36e731a645e7b1b8a88f5031ca38",17456436,5,0,1,982,301,301,0
"0e0b36e731a645e7b1b8a88f5031ca38","a66a144637284c21afc6de17fea4bfb8",17456436,1,1,0,987,301,302,1
"a66a144637284c21afc6de17fea4bfb8","a66a144637284c21afc6de17fea4bfb8",17456436,2,0,1,988,302,302,0
"a66a144637284c21afc6de17fea4bfb8","7646a919d7e64fa990bca9b024ff089d",17456436,1,-4,0,990,302,298,-4
"7646a919d7e64fa990bca9b024ff089d","e390b575229748ea8aac9364efe2bf00",17456436,1,7,0,991,298,304,6
"e390b575229748ea8aac9364efe2bf00","e390b575229748ea8aac9364efe2bf00",17456436,1,0,1,992,304,304,0
"e390b575229748ea8aac9364efe2bf00","4a29443515bb404cb8924e1c60a63b73",17456436,1,-24,0,993,304,285,-19
"4a29443515bb404cb8924e1c60a63b73","3434c10e561d488a914e0f7d71907abd",17456436,1,27,0,994,285,305,20
"53e7e900392747ccad52e711ab0f80d8","7646a919d7e64fa990bca9b024ff089d",17456436,1,-12,0,996,307,298,-9
"7646a919d7e64fa990bca9b024ff089d","4a29443515bb404cb8924e1c60a63b73",17456436,1,-17,0,997,298,285,-13
"4a29443515bb404cb8924e1c60a63b73","ba0e59461bfb4a44b7b1c28a01f8d3b3",17456436,1,18,0,998,285,299,14
"ba0e59461bfb4a44b7b1c28a01f8d3b3","3434c10e561d488a914e0f7d71907abd",17456436,1,9,0,999,299,305,6
"3434c10e561d488a914e0f7d71907abd","53e7e900392747ccad52e711ab0f80d8",17456436,3,2,0,1000,305,307,2
"53e7e900392747ccad52e711ab0f80d8","53e7e900392747ccad52e711ab0f80d8",17456436,1,0,1,1001,307,307,0
"53e7e900392747ccad52e711ab0f80d8","3434c10e561d488a914e0f7d71907abd",17456436,1,-2,0,1002,307,305,-2
"3434c10e561d488a914e0f7d71907abd","130acc2aeb0448fdbb2de63bc5cebe5b",17456436,1,5,0,1003,305,309,4
"130acc2aeb0448fdbb2de63bc5cebe5b","130acc2aeb0448fdbb2de63bc5cebe5b",17456436,1,0,1,1004,309,309,0
"130acc2aeb0448fdbb2de63bc5cebe5b","9c062b3251034ebe90f5054e2a3b5120",17456436,1,2,0,1005,309,311,2
"9c062b3251034ebe90f5054e2a3b5120","9c062b3251034ebe90f5054e2a3b5120",17456436,2,0,1,1006,311,311,0
"9c062b3251034ebe90f5054e2a3b5120","ea859f8207e44537889daeaba13ac2e8",17456436,1,1,0,1008,311,312,1
"ea859f8207e44537889daeaba13ac2e8","ea859f8207e44537889daeaba13ac2e8",17456436,1,0,1,1009,312,312,0
"ea859f8207e44537889daeaba13ac2e8","56d94971a7a94257aa330183a8ebd0ea",17456436,1,1,0,1010,312,313,1
"56d94971a7a94257aa330183a8ebd0ea","56d94971a7a94257aa330183a8ebd0ea",17456436,1,0,1,1011,313,313,0
"56d94971a7a94257aa330183a8ebd0ea","141c0df6cd1946539aadd1c9b7068cd4",17456436,1,-5,0,1012,313,308,-5
"141c0df6cd1946539aadd1c9b7068cd4","13255e63e0aa4abf85e5211bf613d43e",17456436,1,10,0,1013,308,317,9
"13255e63e0aa4abf85e5211bf613d43e","13255e63e0aa4abf85e5211bf613d43e",17456436,1,0,1,1014,317,317,0
"13255e63e0aa4abf85e5211bf613d43e","0c787d16c9504873b1a4d903cec09948",17456436,1,-3,0,1015,317,314,-3
"0c787d16c9504873b1a4d903cec09948","86c27d40179e419c8e9d150fb6afa5d0",17456436,2,6,0,1016,314,319,5
"86c27d40179e419c8e9d150fb6afa5d0","86c27d40179e419c8e9d150fb6afa5d0",17456436,1,0,1,1017,319,319,0
"86c27d40179e419c8e9d150fb6afa5d0","3434c10e561d488a914e0f7d71907abd",17456436,1,-17,0,1018,319,305,-14
"53e7e900392747ccad52e711ab0f80d8","130acc2aeb0448fdbb2de63bc5cebe5b",17456436,1,3,0,1020,307,309,2
"130acc2aeb0448fdbb2de63bc5cebe5b","3434c10e561d488a914e0f7d71907abd",17456436,1,-5,0,1021,309,305,-4
"3434c10e561d488a914e0f7d71907abd","141c0df6cd1946539aadd1c9b7068cd4",17456436,1,4,0,1022,305,308,3
"141c0df6cd1946539aadd1c9b7068cd4","0c787d16c9504873b1a4d903cec09948",17456436,1,7,0,1023,308,314,6
"86c27d40179e419c8e9d150fb6afa5d0","47edbb64109243e6b0f8f64cdef90c6c",17456436,1,8,0,1025,319,326,7
"47edbb64109243e6b0f8f64cdef90c6c","8d7e0b55cf9849cda222a0f2440cec55",17456436,1,-9,0,1026,326,318,-8
"8d7e0b55cf9849cda222a0f2440cec55","24f1363179ad4aaa965484a78471912b",17456436,1,6,0,1027,318,323,5
"24f1363179ad4aaa965484a78471912b","24f1363179ad4aaa965484a78471912b",17456436,8,0,1,1028,323,323,0
"24f1363179ad4aaa965484a78471912b","3628bdce1dd2429ba924d2d4d09448d2",17456436,1,-1,0,1036,323,322,-1
"3628bdce1dd2429ba924d2d4d09448d2","56b3fd1a212a4764be39d979fde3326e",17456436,1,7,0,1037,322,328,6
"56b3fd1a212a4764be39d979fde3326e","56b3fd1a212a4764be39d979fde3326e",17456436,1,0,1,1038,328,328,0
"56b3fd1a212a4764be39d979fde3326e","3434c10e561d488a914e0f7d71907abd",17456436,1,-28,0,1039,328,305,-23
"3434c10e561d488a914e0f7d71907abd","0c4079457ede49e3aeb5e86ed84bdf35",17456436,1,31,0,1040,305,329,24
"0c4079457ede49e3aeb5e86ed84bdf35","38aea304b4fa46e1b29bb72f5cea4c93",17456436,1,2,0,1041,329,331,2
"38aea304b4fa46e1b29bb72f5cea4c93","38aea304b4fa46e1b29bb72f5cea4c93",17456436,15,0,1,1042,331,331,0
"38aea304b4fa46e1b29bb72f5cea4c93","e36d261332f14e79bb4b467aceaeb9b5",17456436,1,2,0,1057,331,333,2
"e36d261332f14e79bb4b467aceaeb9b5","e36d261332f14e79bb4b467aceaeb9b5",17456436,1,0,1,1058,333,333,0
"e36d261332f14e79bb4b467aceaeb9b5","c7e89b9d04744d2eab742fc24e3ef1ae",17456436,1,1,0,1059,333,334,1
"c7e89b9d04744d2eab742fc24e3ef1ae","c7e89b9d04744d2eab742fc24e3ef1ae",17456436,2,0,1,1060,334,334,0
"c7e89b9d04744d2eab742fc24e3ef1ae","fe49f8054b374a0ea4bb266ed135ff62",17456436,1,1,0,1062,334,335,1
"fe49f8054b374a0ea4bb266ed135ff62","fe49f8054b374a0ea4bb266ed135ff62",17456436,2,0,1,1063,335,335,0
"fe49f8054b374a0ea4bb266ed135ff62","d0a8f74af98642fe8360d22c42e45117",17456436,1,1,0,1065,335,336,1
"d0a8f74af98642fe8360d22c42e45117","d0a8f74af98642fe8360d22c42e45117",17456436,2,0,1,1066,336,336,0
"d0a8f74af98642fe8360d22c42e45117","0c4079457ede49e3aeb5e86ed84bdf35",17456436,1,-7,0,1068,336,329,-7
"0c4079457ede49e3aeb5e86ed84bdf35","a7c6339ca1da4368a18d471f0519f877",17456436,1,11,0,1069,329,339,10
"a7c6339ca1da4368a18d471f0519f877","a7c6339ca1da4368a18d471f0519f877",17456436,1,0,1,1070,339,339,0
"a7c6339ca1da4368a18d471f0519f877","bbc5139ca9024389a94db3a6f47dcff6",17456436,1,3,0,1071,339,341,2
"bbc5139ca9024389a94db3a6f47dcff6","b8b9418ab322418d9db9b40d96af873a",17456436,1,-5,0,1072,341,337,-4
"b8b9418ab322418d9db9b40d96af873a","bbc5139ca9024389a94db3a6f47dcff6",17456436,1,5,0,1073,337,341,4
"bbc5139ca9024389a94db3a6f47dcff6","4ee6ca9019ab4a1ab323f98094a9bd77",17456436,1,2,0,1074,341,343,2
"4ee6ca9019ab4a1ab323f98094a9bd77","4ee6ca9019ab4a1ab323f98094a9bd77",17456436,2,0,1,1075,343,343,0
"4ee6ca9019ab4a1ab323f98094a9bd77","b37947176785476f8b29d49a851366dc",17456436,1,1,0,1077,343,344,1
"b37947176785476f8b29d49a851366dc","b37947176785476f8b29d49a851366dc",17456436,2,0,1,1078,344,344,0
"b37947176785476f8b29d49a851366dc","fcea5b10d5a14a3b9324ffece8f6e1e5",17456436,1,1,0,1080,344,345,1
"fcea5b10d5a14a3b9324ffece8f6e1e5","fcea5b10d5a14a3b9324ffece8f6e1e5",17456436,2,0,1,1081,345,345,0
"fcea5b10d5a14a3b9324ffece8f6e1e5","c2490bc612d146edbe786556fab3651b",17456436,1,-5,0,1083,345,340,-5
"c2490bc612d146edbe786556fab3651b","6ac8bb048b854999a47edb35fe627f11",17456436,1,8,0,1084,340,347,7
"6ac8bb048b854999a47edb35fe627f11","6ac8bb048b854999a47edb35fe627f11",17456436,1,0,1,1085,347,347,0
"6ac8bb048b854999a47edb35fe627f11","0c4079457ede49e3aeb5e86ed84bdf35",17456436,1,-21,0,1086,347,329,-18
"0c4079457ede49e3aeb5e86ed84bdf35","30ead9794d4847abaf222ca966cc8630",17456436,1,24,0,1087,329,348,19
"30ead9794d4847abaf222ca966cc8630","09b9678ddc3d452ea4a3d46e15826065",17456436,1,5,0,1088,348,353,5
"09b9678ddc3d452ea4a3d46e15826065","897b7f51242c44aab2205c72fdcbf4cd",17456436,1,-1,0,1089,353,352,-1
"897b7f51242c44aab2205c72fdcbf4cd","eff0de7f2dbb42dfa1a2e686efab5b6d",17456436,1,2,0,1090,352,354,2
"eff0de7f2dbb42dfa1a2e686efab5b6d","c20993c944444fe085345591a8bd837e",17456436,1,-3,0,1091,354,351,-3
"c20993c944444fe085345591a8bd837e","c20993c944444fe085345591a8bd837e",17456436,4,0,1,1092,351,351,0
"c20993c944444fe085345591a8bd837e","897b7f51242c44aab2205c72fdcbf4cd",17456436,1,1,0,1096,351,352,1
"897b7f51242c44aab2205c72fdcbf4cd","897b7f51242c44aab2205c72fdcbf4cd",17456436,3,0,1,1097,352,352,0
"897b7f51242c44aab2205c72fdcbf4cd","09b9678ddc3d452ea4a3d46e15826065",17456436,1,1,0,1100,352,353,1
"09b9678ddc3d452ea4a3d46e15826065","09b9678ddc3d452ea4a3d46e15826065",17456436,3,0,1,1101,353,353,0
"09b9678ddc3d452ea4a3d46e15826065","eff0de7f2dbb42dfa1a2e686efab5b6d",17456436,1,1,0,1104,353,354,1
"eff0de7f2dbb42dfa1a2e686efab5b6d","eff0de7f2dbb42dfa1a2e686efab5b6d",17456436,3,0,1,1105,354,354,0
"eff0de7f2dbb42dfa1a2e686efab5b6d","30ead9794d4847abaf222ca966cc8630",17456436,1,-6,0,1108,354,348,-6
"30ead9794d4847abaf222ca966cc8630","2fe14166dc9642c3bc666b86a57f943d",17456436,2,10,0,1109,348,357,9
"2fe14166dc9642c3bc666b86a57f943d","2fe14166dc9642c3bc666b86a57f943d",17456436,1,0,1,1110,357,357,0
"2fe14166dc9642c3bc666b86a57f943d","44421dd1e13a47a388c4a19834b744c7",17456436,1,2,0,1111,357,359,2
"44421dd1e13a47a388c4a19834b744c7","44421dd1e13a47a388c4a19834b744c7",17456436,2,0,1,1112,359,359,0
"44421dd1e13a47a388c4a19834b744c7","cb5fc7ef85d547c4be1a7439d0bf6052",17456436,1,1,0,1114,359,360,1
"cb5fc7ef85d547c4be1a7439d0bf6052","cb5fc7ef85d547c4be1a7439d0bf6052",17456436,6,0,1,1115,360,360,0
"cb5fc7ef85d547c4be1a7439d0bf6052","0a8f150a4cf747acbde62f4721823da3",17456436,1,1,0,1121,360,361,1
"0a8f150a4cf747acbde62f4721823da3","0a8f150a4cf747acbde62f4721823da3",17456436,2,0,1,1122,361,361,0
"0a8f150a4cf747acbde62f4721823da3","ab8fdad974ae471f9f24c3f9dd04462e",17456436,1,1,0,1124,361,362,1
"ab8fdad974ae471f9f24c3f9dd04462e","ab8fdad974ae471f9f24c3f9dd04462e",17456436,2,0,1,1125,362,362,0
"ab8fdad974ae471f9f24c3f9dd04462e","1ba8fef685d74a8194b9db252eb704fb",17456436,1,-7,0,1127,362,355,-7
"1ba8fef685d74a8194b9db252eb704fb","52580888dadb4fe3baa795683ea227bd",17456436,1,10,0,1128,355,364,9
"52580888dadb4fe3baa795683ea227bd","52580888dadb4fe3baa795683ea227bd",17456436,2,0,1,1129,364,364,0
"52580888dadb4fe3baa795683ea227bd","f00179e251a045b39c3f7a54f9aa4acc",17456436,1,-1,0,1131,364,363,-1
"f00179e251a045b39c3f7a54f9aa4acc","492a3bc6a1254f23a7998587961b22a4",17456436,1,4,0,1132,363,366,3
"492a3bc6a1254f23a7998587961b22a4","492a3bc6a1254f23a7998587961b22a4",17456436,1,0,1,1133,366,366,0
"492a3bc6a1254f23a7998587961b22a4","072a190fd302456290895f9f04d6940a",17456436,1,-1,0,1134,366,365,-1
"072a190fd302456290895f9f04d6940a","30ead9794d4847abaf222ca966cc8630",17456436,1,-20,0,1135,365,348,-17
"2fe14166dc9642c3bc666b86a57f943d","cfa457d1743848e4bb5e4beced6448ed",17456436,1,15,0,1137,357,369,12
"cfa457d1743848e4bb5e4beced6448ed","cfa457d1743848e4bb5e4beced6448ed",17456436,1,0,1,1138,369,369,0
"cfa457d1743848e4bb5e4beced6448ed","b71bac264efb4abd97015447bd490db6",17456436,1,3,0,1139,369,370,1
"b71bac264efb4abd97015447bd490db6","30ead9794d4847abaf222ca966cc8630",17456436,1,-28,0,1140,370,348,-22
"30ead9794d4847abaf222ca966cc8630","b71bac264efb4abd97015447bd490db6",17456436,1,28,0,1141,348,370,22
"b71bac264efb4abd97015447bd490db6","8d448d625b024c82a5eb240bbd7431d6",17456436,4,5,0,1142,370,374,4
"8d448d625b024c82a5eb240bbd7431d6","8d448d625b024c82a5eb240bbd7431d6",17456436,63,0,1,1143,374,374,0
"8d448d625b024c82a5eb240bbd7431d6","b71bac264efb4abd97015447bd490db6",17456436,4,-5,0,1146,374,370,-4
"b71bac264efb4abd97015447bd490db6","d6d02b6ef04e4f17805504500b8ce441",17456436,2,8,0,1195,370,375,5
"d6d02b6ef04e4f17805504500b8ce441","d6d02b6ef04e4f17805504500b8ce441",17456436,3,0,1,1196,375,375,0
"d6d02b6ef04e4f17805504500b8ce441","b71bac264efb4abd97015447bd490db6",17456436,1,-8,0,1197,375,370,-5
"d6d02b6ef04e4f17805504500b8ce441","66baf19b6b904b70922329068c63746d",17456436,1,4,0,1219,375,376,1
"66baf19b6b904b70922329068c63746d","7f544639412e40a9ba27f43b415362ab",17456436,2,2,0,1220,376,378,2
"7f544639412e40a9ba27f43b415362ab","7f544639412e40a9ba27f43b415362ab",17456436,4,0,1,1221,378,378,0
"7f544639412e40a9ba27f43b415362ab","d5ae8642e15b46b8bd298b02274d4e9c",17456436,1,2,0,1224,378,380,2
"d5ae8642e15b46b8bd298b02274d4e9c","d5ae8642e15b46b8bd298b02274d4e9c",17456436,2,0,1,1225,380,380,0
"d5ae8642e15b46b8bd298b02274d4e9c","a0d10309a2dd456289147f84be9d37f9",17456436,1,1,0,1227,380,381,1
"a0d10309a2dd456289147f84be9d37f9","a0d10309a2dd456289147f84be9d37f9",17456436,2,0,1,1228,381,381,0
"a0d10309a2dd456289147f84be9d37f9","0fcbc3ca07b144138b8d85da581f09a8",17456436,1,1,0,1230,381,382,1
"0fcbc3ca07b144138b8d85da581f09a8","0fcbc3ca07b144138b8d85da581f09a8",17456436,2,0,1,1231,382,382,0
"0fcbc3ca07b144138b8d85da581f09a8","66baf19b6b904b70922329068c63746d",17456436,1,-6,0,1233,382,376,-6
"66baf19b6b904b70922329068c63746d","c2fca3669923477ab966ded303dea31c",17456436,1,8,0,1234,376,383,7
"c2fca3669923477ab966ded303dea31c","4890121ce5d74576b4632b77cfc23398",17456436,2,6,0,1235,383,388,5
"4890121ce5d74576b4632b77cfc23398","4890121ce5d74576b4632b77cfc23398",17456436,3,0,1,1236,388,388,0
"4890121ce5d74576b4632b77cfc23398","18d3b836dd804224883cc9180b60a8e1",17456436,1,-1,0,1237,388,387,-1
"18d3b836dd804224883cc9180b60a8e1","96bb2b3e85a34d8b9544514e89f6fe97",17456436,2,4,0,1238,387,390,3
"96bb2b3e85a34d8b9544514e89f6fe97","96bb2b3e85a34d8b9544514e89f6fe97",17456436,2,0,1,1239,390,390,0
"96bb2b3e85a34d8b9544514e89f6fe97","ac4e9b54acfe4670b4634859c7263cb5",17456436,1,2,0,1240,390,392,2
"ac4e9b54acfe4670b4634859c7263cb5","ac4e9b54acfe4670b4634859c7263cb5",17456436,1,0,1,1241,392,392,0
"ac4e9b54acfe4670b4634859c7263cb5","17f95d18bab743888e1736033dc3384d",17456436,1,-3,0,1242,392,389,-3
"17f95d18bab743888e1736033dc3384d","6f8881a745ac4c358a68b92c3b4abe81",17456436,2,6,0,1243,389,394,5
"6f8881a745ac4c358a68b92c3b4abe81","6f8881a745ac4c358a68b92c3b4abe81",17456436,5,0,1,1244,394,394,0
"6f8881a745ac4c358a68b92c3b4abe81","f7002c8484354eceac57bc7bd62c76c1",17456436,2,-1,0,1245,394,393,-1
"f7002c8484354eceac57bc7bd62c76c1","44a277ea44dc4ae689fab4b82f0b4098",17456436,1,5,0,1246,393,397,4
"44a277ea44dc4ae689fab4b82f0b4098","44a277ea44dc4ae689fab4b82f0b4098",17456436,1,0,1,1247,397,397,0
"44a277ea44dc4ae689fab4b82f0b4098","0c12af0a4e7f4002852cf84b2537c161",17456436,1,-2,0,1248,397,395,-2
"0c12af0a4e7f4002852cf84b2537c161","859e0b8d71694b12befb69ee698138f9",17456436,1,5,0,1249,395,399,4
"859e0b8d71694b12befb69ee698138f9","859e0b8d71694b12befb69ee698138f9",17456436,1,0,1,1250,399,399,0
"859e0b8d71694b12befb69ee698138f9","2b09a08242b54983aec7063990fb3f66",17456436,1,3,0,1251,399,400,1
"2b09a08242b54983aec7063990fb3f66","66baf19b6b904b70922329068c63746d",17456436,1,-32,0,1252,400,376,-24
"66baf19b6b904b70922329068c63746d","2b09a08242b54983aec7063990fb3f66",17456436,2,32,0,1253,376,400,24
"2b09a08242b54983aec7063990fb3f66","2b09a08242b54983aec7063990fb3f66",17456436,5,0,1,1254,400,400,0
"2b09a08242b54983aec7063990fb3f66","1f471b7a883a4df48211e8c6a81b59a7",17456436,1,1,0,1255,400,401,1
"1f471b7a883a4df48211e8c6a81b59a7","1f471b7a883a4df48211e8c6a81b59a7",17456436,1,0,1,1256,401,401,0
"1f471b7a883a4df48211e8c6a81b59a7","2b09a08242b54983aec7063990fb3f66",17456436,1,-1,0,1257,401,400,-1
"2b09a08242b54983aec7063990fb3f66","9de0d567bfa84fe5b77cb76f4a76a5d1",17456436,1,5,0,1258,400,404,4
"9de0d567bfa84fe5b77cb76f4a76a5d1","9de0d567bfa84fe5b77cb76f4a76a5d1",17456436,1,0,1,1259,404,404,0
"9de0d567bfa84fe5b77cb76f4a76a5d1","1157bd665ec4472fb58b751dc5099355",17456436,1,-1,0,1260,404,403,-1
"1157bd665ec4472fb58b751dc5099355","3c8a22d2f9c146ea956609e3ed4f2559",17456436,2,3,0,1261,403,405,2
"3c8a22d2f9c146ea956609e3ed4f2559","58fc9094275e4c49be3f4ba6d4acc0a4",17456436,2,2,0,1262,405,406,1
"58fc9094275e4c49be3f4ba6d4acc0a4","58fc9094275e4c49be3f4ba6d4acc0a4",17456436,3,0,1,1263,406,406,0
"58fc9094275e4c49be3f4ba6d4acc0a4","c1c1be90b2b14c1ab4a5e1ee3c241902",17456436,1,1,0,1264,406,407,1
"c1c1be90b2b14c1ab4a5e1ee3c241902","c1c1be90b2b14c1ab4a5e1ee3c241902",17456436,5,0,1,1265,407,407,0
"c1c1be90b2b14c1ab4a5e1ee3c241902","58fc9094275e4c49be3f4ba6d4acc0a4",17456436,1,-1,0,1270,407,406,-1
"58fc9094275e4c49be3f4ba6d4acc0a4","02b3a1bead9244c1ba2f857c7da8f82a",17456436,2,3,0,1271,406,408,2
"02b3a1bead9244c1ba2f857c7da8f82a","02b3a1bead9244c1ba2f857c7da8f82a",17456436,5,0,1,1272,408,408,0
"02b3a1bead9244c1ba2f857c7da8f82a","6206fc6479014bb193084c32409dc1b9",17456436,1,1,0,1274,408,409,1
"6206fc6479014bb193084c32409dc1b9","6206fc6479014bb193084c32409dc1b9",17456436,7,0,1,1275,409,409,0
"6206fc6479014bb193084c32409dc1b9","6a5f020451db426dacba9e2ea3fcc62a",17456436,1,2,0,1282,409,410,1
"6a5f020451db426dacba9e2ea3fcc62a","02b3a1bead9244c1ba2f857c7da8f82a",17456436,1,-3,0,1283,410,408,-2
"02b3a1bead9244c1ba2f857c7da8f82a","6a5f020451db426dacba9e2ea3fcc62a",17456436,2,3,0,1284,408,410,2
"6a5f020451db426dacba9e2ea3fcc62a","6a5f020451db426dacba9e2ea3fcc62a",17456436,3,0,1,1285,410,410,0
"6a5f020451db426dacba9e2ea3fcc62a","33a9d248b2e44588a5b07fc1342b9bc2",17456436,2,2,0,1286,410,411,1
"33a9d248b2e44588a5b07fc1342b9bc2","33a9d248b2e44588a5b07fc1342b9bc2",17456436,3,0,1,1287,411,411,0
"33a9d248b2e44588a5b07fc1342b9bc2","c6f26bd420634f1cb7989e76fe6b16c0",17456436,1,1,0,1289,411,412,1
"c6f26bd420634f1cb7989e76fe6b16c0","c6f26bd420634f1cb7989e76fe6b16c0",17456436,5,0,1,1290,412,412,0
"c6f26bd420634f1cb7989e76fe6b16c0","2a65ee6e2ac64f6a8a55fbe5373ec763",17456436,1,1,0,1295,412,413,1
"2a65ee6e2ac64f6a8a55fbe5373ec763","2a65ee6e2ac64f6a8a55fbe5373ec763",17456436,2,0,1,1296,413,413,0
"2a65ee6e2ac64f6a8a55fbe5373ec763","33a9d248b2e44588a5b07fc1342b9bc2",17456436,1,-2,0,1298,413,411,-2
"33a9d248b2e44588a5b07fc1342b9bc2","1fd0f6dadbc14ebc965faf6122190b96",17456436,1,5,0,1299,411,415,4
"1fd0f6dadbc14ebc965faf6122190b96","1fd0f6dadbc14ebc965faf6122190b96",17456436,1,0,1,1300,415,415,0
"1fd0f6dadbc14ebc965faf6122190b96","687055dad9fc40c3982478fe33ec01bf",17456436,1,-1,0,1301,415,414,-1
"687055dad9fc40c3982478fe33ec01bf","2add1669f08d4101913db15f8c23b3b7",17456436,1,3,0,1302,414,416,2
"2add1669f08d4101913db15f8c23b3b7","2add1669f08d4101913db15f8c23b3b7",17456436,1,0,1,1303,416,416,0
"2add1669f08d4101913db15f8c23b3b7","a2b4bd40cee2481ebd3fc179d6a5cd62",17456436,1,3,0,1304,416,417,1
"a2b4bd40cee2481ebd3fc179d6a5cd62","2b09a08242b54983aec7063990fb3f66",17456436,1,-27,0,1305,417,400,-17
"2b09a08242b54983aec7063990fb3f66","e34e59dce2204f228f3a84b6725df60f",17456436,1,29,0,1306,400,419,19
"e34e59dce2204f228f3a84b6725df60f","e34e59dce2204f228f3a84b6725df60f",17456436,1,0,1,1307,419,419,0
"e34e59dce2204f228f3a84b6725df60f","bec48fc2e1294c7eb3d0aca780d731b8",17456436,1,2,0,1308,419,420,1
"bec48fc2e1294c7eb3d0aca780d731b8","a2b4bd40cee2481ebd3fc179d6a5cd62",17456436,2,-4,0,1309,420,417,-3
"a2b4bd40cee2481ebd3fc179d6a5cd62","bec48fc2e1294c7eb3d0aca780d731b8",17456436,3,4,0,1310,417,420,3
"bec48fc2e1294c7eb3d0aca780d731b8","bec48fc2e1294c7eb3d0aca780d731b8",17456436,2,0,1,1311,420,420,0
"bec48fc2e1294c7eb3d0aca780d731b8","dbde19fcce2a4c1abdc7f685c293a23f",17456436,2,3,0,1313,420,422,2
"dbde19fcce2a4c1abdc7f685c293a23f","a24600b0e49245f6bdba8c893cfeddb0",17456436,2,4,0,1314,422,425,3
"a24600b0e49245f6bdba8c893cfeddb0","a24600b0e49245f6bdba8c893cfeddb0",17456436,3,0,1,1315,425,425,0
"a24600b0e49245f6bdba8c893cfeddb0","24cf8786024543f19b89bc20034e60d7",17456436,2,7,0,1317,425,428,3
"24cf8786024543f19b89bc20034e60d7","a2b4bd40cee2481ebd3fc179d6a5cd62",17456436,2,-18,0,1318,428,417,-11
"a2b4bd40cee2481ebd3fc179d6a5cd62","f2a73be2f46840b182d7bd095378004e",17456436,2,19,0,1319,417,429,12
"f2a73be2f46840b182d7bd095378004e","f2a73be2f46840b182d7bd095378004e",17456436,1,0,1,1320,429,429,0
"f2a73be2f46840b182d7bd095378004e","604551fd4266430cb860fef58fa7dd61",17456436,1,1,0,1321,429,430,1
"604551fd4266430cb860fef58fa7dd61","604551fd4266430cb860fef58fa7dd61",17456436,1,0,1,1322,430,430,0
"604551fd4266430cb860fef58fa7dd61","24cf8786024543f19b89bc20034e60d7",17456436,1,-2,0,1323,430,428,-2
"24cf8786024543f19b89bc20034e60d7","dce46f8904594a62a6377a3587aaa663",17456436,3,4,0,1324,428,431,3
"dce46f8904594a62a6377a3587aaa663","dce46f8904594a62a6377a3587aaa663",17456436,6,0,1,1325,431,431,0
"dce46f8904594a62a6377a3587aaa663","9b9d0a249052413c869753b99682b0ac",17456436,1,1,0,1328,431,432,1
"9b9d0a249052413c869753b99682b0ac","9b9d0a249052413c869753b99682b0ac",17456436,4,0,1,1329,432,432,0
"9b9d0a249052413c869753b99682b0ac","061c175cc90f45fbad883025394e78dd",17456436,1,1,0,1333,432,433,1
"061c175cc90f45fbad883025394e78dd","061c175cc90f45fbad883025394e78dd",17456436,4,0,1,1334,433,433,0
"061c175cc90f45fbad883025394e78dd","dce46f8904594a62a6377a3587aaa663",17456436,1,-2,0,1338,433,431,-2
"dce46f8904594a62a6377a3587aaa663","24cf8786024543f19b89bc20034e60d7",17456436,1,-4,0,1339,431,428,-3
"dce46f8904594a62a6377a3587aaa663","74a7f8712e5449c2bc0b43c6f90dafed",17456436,1,5,0,1341,431,435,4
"74a7f8712e5449c2bc0b43c6f90dafed","74a7f8712e5449c2bc0b43c6f90dafed",17456436,1,0,1,1342,435,435,0
"74a7f8712e5449c2bc0b43c6f90dafed","66ada10dde9f43018588f1ced9d477fc",17456436,1,-1,0,1343,435,434,-1
"66ada10dde9f43018588f1ced9d477fc","bf12c96466d840a69bed7020b3f18bb8",17456436,1,3,0,1344,434,436,2
"bf12c96466d840a69bed7020b3f18bb8","bf12c96466d840a69bed7020b3f18bb8",17456436,1,0,1,1345,436,436,0
"bf12c96466d840a69bed7020b3f18bb8","070600601c4c439288445d2f0724807d",17456436,1,3,0,1346,436,437,1
"070600601c4c439288445d2f0724807d","24cf8786024543f19b89bc20034e60d7",17456436,1,-14,0,1347,437,428,-9
"24cf8786024543f19b89bc20034e60d7","1823b6de7d334a7aaabc4570719af4d9",17456436,1,16,0,1348,428,439,11
"1823b6de7d334a7aaabc4570719af4d9","1823b6de7d334a7aaabc4570719af4d9",17456436,11,0,1,1349,439,439,0
"1823b6de7d334a7aaabc4570719af4d9","0380cd76a7d44bc3a4da1f15e4d68f89",17456436,1,2,0,1360,439,440,1
"0380cd76a7d44bc3a4da1f15e4d68f89","070600601c4c439288445d2f0724807d",17456436,1,-4,0,1361,440,437,-3
"070600601c4c439288445d2f0724807d","0380cd76a7d44bc3a4da1f15e4d68f89",17456436,2,4,0,1362,437,440,3
"0380cd76a7d44bc3a4da1f15e4d68f89","0380cd76a7d44bc3a4da1f15e4d68f89",17456436,1,0,1,1363,440,440,0
"0380cd76a7d44bc3a4da1f15e4d68f89","23b7673c8b5443108c2ef09382834a86",17456436,3,2,0,1364,440,441,1
"23b7673c8b5443108c2ef09382834a86","23b7673c8b5443108c2ef09382834a86",17456436,5,0,1,1365,441,441,0
"23b7673c8b5443108c2ef09382834a86","901e92500aea43c79f19f1b279050668",17456436,2,2,0,1368,441,442,1
"901e92500aea43c79f19f1b279050668","901e92500aea43c79f19f1b279050668",17456436,1,0,1,1369,442,442,0
"901e92500aea43c79f19f1b279050668","001339db8ced4cf78829ebe8b145449d",17456436,1,1,0,1370,442,443,1
"001339db8ced4cf78829ebe8b145449d","001339db8ced4cf78829ebe8b145449d",17456436,2,0,1,1371,443,443,0
"001339db8ced4cf78829ebe8b145449d","452745e0366e42ae81561bfddebcc6c3",17456436,1,1,0,1373,443,444,1
"452745e0366e42ae81561bfddebcc6c3","452745e0366e42ae81561bfddebcc6c3",17456436,2,0,1,1374,444,444,0
"452745e0366e42ae81561bfddebcc6c3","4660ff2089114e8db82ceb26a4f329e3",17456436,1,2,0,1376,444,445,1
"4660ff2089114e8db82ceb26a4f329e3","901e92500aea43c79f19f1b279050668",17456436,2,-4,0,1377,445,442,-3
"901e92500aea43c79f19f1b279050668","4660ff2089114e8db82ceb26a4f329e3",17456436,2,4,0,1378,442,445,3
"4660ff2089114e8db82ceb26a4f329e3","4660ff2089114e8db82ceb26a4f329e3",17456436,3,0,1,1379,445,445,0
"4660ff2089114e8db82ceb26a4f329e3","7bd5586eb9d8484eb74a433ee7bfe499",17456436,3,2,0,1380,445,446,1
"7bd5586eb9d8484eb74a433ee7bfe499","7bd5586eb9d8484eb74a433ee7bfe499",17456436,14,0,1,1381,446,446,0
"7bd5586eb9d8484eb74a433ee7bfe499","8a7f26e690f34dda97be16904518ca99",17456436,1,2,0,1394,446,447,1
"8a7f26e690f34dda97be16904518ca99","8a7f26e690f34dda97be16904518ca99",17456436,1,0,1,1395,447,447,0
"8a7f26e690f34dda97be16904518ca99","070600601c4c439288445d2f0724807d",17456436,1,-16,0,1396,447,437,-10
"070600601c4c439288445d2f0724807d","b2f0d654738f48158edff28e8d3a546e",17456436,2,21,0,1397,437,449,12
"b2f0d654738f48158edff28e8d3a546e","66baf19b6b904b70922329068c63746d",17456436,2,-112,0,1398,449,376,-73
"66baf19b6b904b70922329068c63746d","b2f0d654738f48158edff28e8d3a546e",17456436,1,112,0,1399,376,449,73
"7f544639412e40a9ba27f43b415362ab","66baf19b6b904b70922329068c63746d",17456436,1,-2,0,1403,378,376,-2
"66baf19b6b904b70922329068c63746d","4890121ce5d74576b4632b77cfc23398",17456436,1,14,0,1404,376,388,12
"4890121ce5d74576b4632b77cfc23398","c2fca3669923477ab966ded303dea31c",17456436,1,-6,0,1405,388,383,-5
"4890121ce5d74576b4632b77cfc23398","96bb2b3e85a34d8b9544514e89f6fe97",17456436,1,3,0,1409,388,390,2
"96bb2b3e85a34d8b9544514e89f6fe97","18d3b836dd804224883cc9180b60a8e1",17456436,1,-4,0,1410,390,387,-3
"96bb2b3e85a34d8b9544514e89f6fe97","17f95d18bab743888e1736033dc3384d",17456436,1,-1,0,1413,390,389,-1
"f7002c8484354eceac57bc7bd62c76c1","0c12af0a4e7f4002852cf84b2537c161",17456436,1,3,0,1420,393,395,2
"0c12af0a4e7f4002852cf84b2537c161","66baf19b6b904b70922329068c63746d",17456436,1,-24,0,1421,395,376,-19
"2b09a08242b54983aec7063990fb3f66","1157bd665ec4472fb58b751dc5099355",17456436,1,4,0,1427,400,403,3
"33a9d248b2e44588a5b07fc1342b9bc2","a2b4bd40cee2481ebd3fc179d6a5cd62",17456436,1,10,0,1441,411,417,6
"a2b4bd40cee2481ebd3fc179d6a5cd62","a2b4bd40cee2481ebd3fc179d6a5cd62",17456436,1,0,1,1442,417,417,0
"f2a73be2f46840b182d7bd095378004e","24cf8786024543f19b89bc20034e60d7",17456436,1,-1,0,1452,429,428,-1
"dce46f8904594a62a6377a3587aaa663","66ada10dde9f43018588f1ced9d477fc",17456436,1,4,0,1457,431,434,3
"66ada10dde9f43018588f1ced9d477fc","24cf8786024543f19b89bc20034e60d7",17456436,1,-8,0,1458,434,428,-6
"24cf8786024543f19b89bc20034e60d7","070600601c4c439288445d2f0724807d",17456436,1,14,0,1459,428,437,9
"070600601c4c439288445d2f0724807d","1823b6de7d334a7aaabc4570719af4d9",17456436,1,2,0,1460,437,439,2
"1823b6de7d334a7aaabc4570719af4d9","070600601c4c439288445d2f0724807d",17456436,1,-2,0,1461,439,437,-2
"23b7673c8b5443108c2ef09382834a86","0380cd76a7d44bc3a4da1f15e4d68f89",17456436,1,-2,0,1464,441,440,-1
"901e92500aea43c79f19f1b279050668","23b7673c8b5443108c2ef09382834a86",17456436,1,-2,0,1469,442,441,-1
"23b7673c8b5443108c2ef09382834a86","4660ff2089114e8db82ceb26a4f329e3",17456436,1,6,0,1470,441,445,4
"7bd5586eb9d8484eb74a433ee7bfe499","4660ff2089114e8db82ceb26a4f329e3",17456436,1,-2,0,1476,446,445,-1
"7bd5586eb9d8484eb74a433ee7bfe499","b2f0d654738f48158edff28e8d3a546e",17456436,2,7,0,1478,446,449,3
"b2f0d654738f48158edff28e8d3a546e","070600601c4c439288445d2f0724807d",17456436,2,-21,0,1479,449,437,-12
"070600601c4c439288445d2f0724807d","070600601c4c439288445d2f0724807d",17456436,1,0,1,1480,437,437,0
"070600601c4c439288445d2f0724807d","901e92500aea43c79f19f1b279050668",17456436,1,8,0,1481,437,442,5
"901e92500aea43c79f19f1b279050668","7bd5586eb9d8484eb74a433ee7bfe499",17456436,1,6,0,1482,442,446,4
"7bd5586eb9d8484eb74a433ee7bfe499","070600601c4c439288445d2f0724807d",17456436,1,-14,0,1483,446,437,-9
"070600601c4c439288445d2f0724807d","7bd5586eb9d8484eb74a433ee7bfe499",17456436,1,14,0,1484,437,446,9
"b2f0d654738f48158edff28e8d3a546e","f60ee41ec635499abd48168342d32c2f",17456436,3,5,0,1489,449,453,4
"f60ee41ec635499abd48168342d32c2f","f60ee41ec635499abd48168342d32c2f",17456436,60,0,1,1490,453,453,0
"f60ee41ec635499abd48168342d32c2f","b2f0d654738f48158edff28e8d3a546e",17456436,3,-5,0,1510,453,449,-4
"b2f0d654738f48158edff28e8d3a546e","b2f0d654738f48158edff28e8d3a546e",17456436,1,0,1,1511,449,449,0
"b2f0d654738f48158edff28e8d3a546e","f67fbf45a5f146ed866965bc57c7c001",17456436,1,8,0,1556,449,454,5
"f67fbf45a5f146ed866965bc57c7c001","f67fbf45a5f146ed866965bc57c7c001",17456436,2,0,1,1557,454,454,0
"f67fbf45a5f146ed866965bc57c7c001","e20db35ced8544ddac5bc3839145e463",17456436,1,-501,0,1559,454,91,-363
"e20db35ced8544ddac5bc3839145e463","e20db35ced8544ddac5bc3839145e463",17456436,1,0,1,1560,91,91,0
"e20db35ced8544ddac5bc3839145e463","d937afe49bd24a07a550dda1c1155122",17456436,1,502,0,1561,91,455,364
"d937afe49bd24a07a550dda1c1155122","d937afe49bd24a07a550dda1c1155122",17456436,1,0,1,1562,455,455,0
"d937afe49bd24a07a550dda1c1155122","3628b3f7823443d0912a339096b69943",17456436,1,1,0,1563,455,456,1
"3628b3f7823443d0912a339096b69943","3628b3f7823443d0912a339096b69943",17456436,1,0,1,1564,456,456,0
"3628b3f7823443d0912a339096b69943","9e049ee647cf43ecbcb5ed792a8e7588",17456436,1,1,0,1565,456,457,1
"9e049ee647cf43ecbcb5ed792a8e7588","9e049ee647cf43ecbcb5ed792a8e7588",17456436,1,0,1,1566,457,457,0
"9e049ee647cf43ecbcb5ed792a8e7588","5256a214faaf410b93f76cea06428334",17456436,1,1,0,1567,457,458,1
"5256a214faaf410b93f76cea06428334","5256a214faaf410b93f76cea06428334",17456436,1,0,1,1568,458,458,0
"5256a214faaf410b93f76cea06428334","25c32b120fce40fa9b6c85133aeb4716",17456436,1,1,0,1569,458,459,1
"25c32b120fce40fa9b6c85133aeb4716","25c32b120fce40fa9b6c85133aeb4716",17456436,3,0,1,1570,459,459,0
"25c32b120fce40fa9b6c85133aeb4716","11bc14f2204949008b7d511b933363c1",17456436,1,1,0,1573,459,460,1
"11bc14f2204949008b7d511b933363c1","11bc14f2204949008b7d511b933363c1",17456436,1,0,1,1574,460,460,0
"11bc14f2204949008b7d511b933363c1","42de338840a34d15adb66e7b14fb9d2c",17456436,1,1,0,1575,460,461,1
"42de338840a34d15adb66e7b14fb9d2c","42de338840a34d15adb66e7b14fb9d2c",17456436,3,0,1,1576,461,461,0
"42de338840a34d15adb66e7b14fb9d2c","9da37c6210b1416b8079c274f70bf600",17456436,1,1,0,1579,461,462,1
"9da37c6210b1416b8079c274f70bf600","9da37c6210b1416b8079c274f70bf600",17456436,1,0,1,1580,462,462,0
"9da37c6210b1416b8079c274f70bf600","519119f1deac45ff9ab4f13529be5c6e",17456436,1,1,0,1581,462,463,1
"519119f1deac45ff9ab4f13529be5c6e","f67fbf45a5f146ed866965bc57c7c001",17456436,1,-9,0,1582,463,454,-9
"f67fbf45a5f146ed866965bc57c7c001","519119f1deac45ff9ab4f13529be5c6e",17456436,1,9,0,1583,454,463,9
"519119f1deac45ff9ab4f13529be5c6e","c5df9f40ec14463b9dcfdc73df3e9285",17456436,1,3,0,1584,463,464,1
"c5df9f40ec14463b9dcfdc73df3e9285","c5df9f40ec14463b9dcfdc73df3e9285",17456436,2,0,1,1585,464,464,0
"c5df9f40ec14463b9dcfdc73df3e9285","83d42d95cd844fc093fc09cee250edb8",17456436,1,3,0,1587,464,465,1
"83d42d95cd844fc093fc09cee250edb8","83d42d95cd844fc093fc09cee250edb8",17456436,6,0,1,1588,465,465,0
"b613861cecf84ffcab01afb23f660475","b613861cecf84ffcab01afb23f660475",11405163,2,0,1,1,1,1,0
"b613861cecf84ffcab01afb23f660475","e2911e79efc2420eac45d9f671463d4b",11405163,2,3,0,3,1,2,1
"e2911e79efc2420eac45d9f671463d4b","b613861cecf84ffcab01afb23f660475",11405163,1,-3,0,4,2,1,-1
"e2911e79efc2420eac45d9f671463d4b","e2911e79efc2420eac45d9f671463d4b",11405163,1,0,1,6,2,2,0
"e2911e79efc2420eac45d9f671463d4b","519d1b8c59404d67b54e96c5c8a830b2",11405163,1,1,0,7,2,3,1
"519d1b8c59404d67b54e96c5c8a830b2","519d1b8c59404d67b54e96c5c8a830b2",11405163,1,0,1,8,3,3,0
"519d1b8c59404d67b54e96c5c8a830b2","531db53f81f646edb0cdcfe0085b03b7",11405163,1,1,0,9,3,4,1
"531db53f81f646edb0cdcfe0085b03b7","531db53f81f646edb0cdcfe0085b03b7",11405163,1,0,1,10,4,4,0
"531db53f81f646edb0cdcfe0085b03b7","4f5f94b2f95141e0a9d53a61da2276da",11405163,1,1,0,11,4,5,1
"4f5f94b2f95141e0a9d53a61da2276da","4f5f94b2f95141e0a9d53a61da2276da",11405163,1,0,1,12,5,5,0
"4f5f94b2f95141e0a9d53a61da2276da","6d541c89590949f99af293c4f2333f67",11405163,1,1,0,13,5,6,1
"6d541c89590949f99af293c4f2333f67","6d541c89590949f99af293c4f2333f67",11405163,1,0,1,14,6,6,0
"6d541c89590949f99af293c4f2333f67","dd5cf0b9fe4c4f1d8f5ff8e4c04879cb",11405163,1,1,0,15,6,7,1
"dd5cf0b9fe4c4f1d8f5ff8e4c04879cb","dd5cf0b9fe4c4f1d8f5ff8e4c04879cb",11405163,1,0,1,16,7,7,0
"dd5cf0b9fe4c4f1d8f5ff8e4c04879cb","f96261861edc426abe2248be4f0a709a",11405163,1,1,0,17,7,8,1
"f96261861edc426abe2248be4f0a709a","f96261861edc426abe2248be4f0a709a",11405163,1,0,1,18,8,8,0
"f96261861edc426abe2248be4f0a709a","66b5e16f4f75454fb5b8172079f0fa83",11405163,1,1,0,19,8,9,1
"66b5e16f4f75454fb5b8172079f0fa83","66b5e16f4f75454fb5b8172079f0fa83",11405163,1,0,1,20,9,9,0
"66b5e16f4f75454fb5b8172079f0fa83","0680571d4698477995e41842c36a54b2",11405163,1,1,0,21,9,10,1
"0680571d4698477995e41842c36a54b2","0680571d4698477995e41842c36a54b2",11405163,1,0,1,22,10,10,0
"0680571d4698477995e41842c36a54b2","9112f2bffece48e08c6d2287be204085",11405163,1,1,0,23,10,11,1
"9112f2bffece48e08c6d2287be204085","9112f2bffece48e08c6d2287be204085",11405163,1,0,1,24,11,11,0
"9112f2bffece48e08c6d2287be204085","e2911e79efc2420eac45d9f671463d4b",11405163,1,-9,0,25,11,2,-9
"e2911e79efc2420eac45d9f671463d4b","56586aa865414f538729c7f7735d2bc6",11405163,1,12,0,26,2,12,10
"56586aa865414f538729c7f7735d2bc6","56586aa865414f538729c7f7735d2bc6",11405163,2,0,1,27,12,12,0
"56586aa865414f538729c7f7735d2bc6","b7f2b31585d94eb3bf86376714aa7070",11405163,2,2,0,29,12,13,1
"b7f2b31585d94eb3bf86376714aa7070","56586aa865414f538729c7f7735d2bc6",11405163,1,-2,0,30,13,12,-1
"b7f2b31585d94eb3bf86376714aa7070","b7f2b31585d94eb3bf86376714aa7070",11405163,1,0,1,32,13,13,0
"b7f2b31585d94eb3bf86376714aa7070","3f1c815879794b929260d224becaff7e",11405163,1,2,0,33,13,14,1
"3f1c815879794b929260d224becaff7e","81c864a886d54a6b8ff85f7d736f4f95",11405163,1,2,0,34,14,15,1
"81c864a886d54a6b8ff85f7d736f4f95","5c5ceeee4562457ba6d41515aeebfbb1",11405163,1,4,0,35,15,17,2
"5c5ceeee4562457ba6d41515aeebfbb1","5c5ceeee4562457ba6d41515aeebfbb1",11405163,1,0,1,36,17,17,0
"5c5ceeee4562457ba6d41515aeebfbb1","9afd71a5298d4333b6849dfce1b9422c",11405163,1,3,0,37,17,18,1
"9afd71a5298d4333b6849dfce1b9422c","56586aa865414f538729c7f7735d2bc6",11405163,1,-13,0,38,18,12,-6
"56586aa865414f538729c7f7735d2bc6","9afd71a5298d4333b6849dfce1b9422c",11405163,1,13,0,39,12,18,6
"9afd71a5298d4333b6849dfce1b9422c","b7719e26494940efa49512aedd0aac79",11405163,1,4,0,40,18,20,2
"b7719e26494940efa49512aedd0aac79","9afd71a5298d4333b6849dfce1b9422c",11405163,1,-4,0,41,20,18,-2
"9afd71a5298d4333b6849dfce1b9422c","d4f45188d3c84a02ba08454e6403a818",11405163,1,9,0,42,18,24,6
"d4f45188d3c84a02ba08454e6403a818","d4c3b003e8274e429d2fa688d73fde6d",11405163,2,-2,0,43,24,22,-2
"d4c3b003e8274e429d2fa688d73fde6d","d4c3b003e8274e429d2fa688d73fde6d",11405163,1,0,1,44,22,22,0
"d4c3b003e8274e429d2fa688d73fde6d","b7719e26494940efa49512aedd0aac79",11405163,1,-3,0,45,22,20,-2
"b7719e26494940efa49512aedd0aac79","afbf7250b99d47bea07172749483ca97",11405163,1,12,0,46,20,28,8
"afbf7250b99d47bea07172749483ca97","b7719e26494940efa49512aedd0aac79",11405163,1,-12,0,47,28,20,-8
"b7719e26494940efa49512aedd0aac79","4e51676dc72045d99c19b9fa7b22f8bc",11405163,1,15,0,48,20,29,9
"4e51676dc72045d99c19b9fa7b22f8bc","afbf7250b99d47bea07172749483ca97",11405163,1,-3,0,49,29,28,-1
"afbf7250b99d47bea07172749483ca97","4e51676dc72045d99c19b9fa7b22f8bc",11405163,1,3,0,50,28,29,1
"4e51676dc72045d99c19b9fa7b22f8bc","51970cfa30e643e894e66ae85c8024cc",11405163,1,3,0,51,29,31,2
"51970cfa30e643e894e66ae85c8024cc","c33c17be71ae4d588da7369472e5bb1b",11405163,1,6,0,52,31,34,3
"c33c17be71ae4d588da7369472e5bb1b","4e51676dc72045d99c19b9fa7b22f8bc",11405163,1,-9,0,53,34,29,-5
"4e51676dc72045d99c19b9fa7b22f8bc","93679be414554a11b1893002f2229a93",11405163,1,12,0,54,29,35,6
"93679be414554a11b1893002f2229a93","c33c17be71ae4d588da7369472e5bb1b",11405163,1,-3,0,55,35,34,-1
"c33c17be71ae4d588da7369472e5bb1b","7040a13096d746ac84b8fac8d9752058",11405163,1,6,0,56,34,36,2
"7040a13096d746ac84b8fac8d9752058","93679be414554a11b1893002f2229a93",11405163,1,-3,0,57,36,35,-1
"93679be414554a11b1893002f2229a93","9a0dc646f934470daf08c4b56ccf73db",11405163,1,6,0,58,35,37,2
"9a0dc646f934470daf08c4b56ccf73db","7040a13096d746ac84b8fac8d9752058",11405163,1,-3,0,59,37,36,-1
"7040a13096d746ac84b8fac8d9752058","7040a13096d746ac84b8fac8d9752058",11405163,1,0,1,60,36,36,0
"7040a13096d746ac84b8fac8d9752058","fc0e049d56024bc9a02c9a9c435c3df7",11405163,1,6,0,61,36,38,2
"fc0e049d56024bc9a02c9a9c435c3df7","9a0dc646f934470daf08c4b56ccf73db",11405163,1,-3,0,62,38,37,-1
"9a0dc646f934470daf08c4b56ccf73db","67a089198fcb4e1c8f2385786c2b296f",11405163,1,7,0,63,37,39,2
"67a089198fcb4e1c8f2385786c2b296f","fc0e049d56024bc9a02c9a9c435c3df7",11405163,1,-4,0,64,39,38,-1
"fc0e049d56024bc9a02c9a9c435c3df7","64d48c6c9c7940639a932219a6c87198",11405163,1,5,0,65,38,40,2
"64d48c6c9c7940639a932219a6c87198","67a089198fcb4e1c8f2385786c2b296f",11405163,2,-1,0,66,40,39,-1
"67a089198fcb4e1c8f2385786c2b296f","64d48c6c9c7940639a932219a6c87198",11405163,2,1,0,67,39,40,1
"64d48c6c9c7940639a932219a6c87198","b7719e26494940efa49512aedd0aac79",11405163,1,-41,0,68,40,20,-20
"b7719e26494940efa49512aedd0aac79","b7719e26494940efa49512aedd0aac79",11405163,2,0,1,69,20,20,0
"b7719e26494940efa49512aedd0aac79","a49d1bb4328949299686242fd0be5584",11405163,1,2,0,71,20,21,1
"a49d1bb4328949299686242fd0be5584","a49d1bb4328949299686242fd0be5584",11405163,1,0,1,72,21,21,0
"a49d1bb4328949299686242fd0be5584","d4f45188d3c84a02ba08454e6403a818",11405163,1,3,0,73,21,24,3
"d4c3b003e8274e429d2fa688d73fde6d","64d48c6c9c7940639a932219a6c87198",11405163,1,38,0,75,22,40,18
"64d48c6c9c7940639a932219a6c87198","64d48c6c9c7940639a932219a6c87198",11405163,6,0,1,76,40,40,0
"64d48c6c9c7940639a932219a6c87198","b534b89233134e30a9b5645138bfa9ee",11405163,1,3,0,84,40,41,1
"b534b89233134e30a9b5645138bfa9ee","67a089198fcb4e1c8f2385786c2b296f",11405163,1,-4,0,85,41,39,-2
"67a089198fcb4e1c8f2385786c2b296f","0e37b720d23b4e7f8b313e79313fd107",11405163,1,7,0,86,39,44,5
"0e37b720d23b4e7f8b313e79313fd107","0e37b720d23b4e7f8b313e79313fd107",11405163,1,0,1,87,44,44,0
"0e37b720d23b4e7f8b313e79313fd107","6875d67fdd5f48168b62719df449bebd",11405163,1,1,0,88,44,45,1
"6875d67fdd5f48168b62719df449bebd","6875d67fdd5f48168b62719df449bebd",11405163,1,0,1,89,45,45,0
"6875d67fdd5f48168b62719df449bebd","b534b89233134e30a9b5645138bfa9ee",11405163,1,-4,0,90,45,41,-4
"b534b89233134e30a9b5645138bfa9ee","6e13d61a7bdb44bca949c9f86fab3be5",11405163,1,7,0,91,41,47,6
"6e13d61a7bdb44bca949c9f86fab3be5","6e13d61a7bdb44bca949c9f86fab3be5",11405163,1,0,1,92,47,47,0
"6e13d61a7bdb44bca949c9f86fab3be5","195f78799f984cc2b06c48dfe36be751",11405163,1,2,0,93,47,49,2
"195f78799f984cc2b06c48dfe36be751","195f78799f984cc2b06c48dfe36be751",11405163,2,0,1,94,49,49,0
"195f78799f984cc2b06c48dfe36be751","d0c74f735e024943943e40333d6d337f",11405163,1,3,0,96,49,51,2
"d0c74f735e024943943e40333d6d337f","d9c8d8c444a64dadbbb508652c721e17",11405163,1,-6,0,97,51,46,-5
"d9c8d8c444a64dadbbb508652c721e17","d0c74f735e024943943e40333d6d337f",11405163,1,6,0,98,46,51,5
"d0c74f735e024943943e40333d6d337f","983f8ff320594b279a7f4a6fe132f9c5",11405163,1,2,0,99,51,53,2
"983f8ff320594b279a7f4a6fe132f9c5","983f8ff320594b279a7f4a6fe132f9c5",11405163,8,0,1,100,53,53,0
"983f8ff320594b279a7f4a6fe132f9c5","35adfa5d923046aebabfefd98f35ff05",11405163,1,1,0,108,53,54,1
"35adfa5d923046aebabfefd98f35ff05","35adfa5d923046aebabfefd98f35ff05",11405163,2,0,1,109,54,54,0
"35adfa5d923046aebabfefd98f35ff05","b6f8a98476224da1b40e555ececc7ed8",11405163,1,1,0,111,54,55,1
"b6f8a98476224da1b40e555ececc7ed8","b6f8a98476224da1b40e555ececc7ed8",11405163,2,0,1,112,55,55,0
"b6f8a98476224da1b40e555ececc7ed8","86e22cb5fe0e4b47a9489ecddf7ed78f",11405163,1,1,0,114,55,56,1
"86e22cb5fe0e4b47a9489ecddf7ed78f","86e22cb5fe0e4b47a9489ecddf7ed78f",11405163,2,0,1,115,56,56,0
"86e22cb5fe0e4b47a9489ecddf7ed78f","f924752d8a1149668870b1e7698486f7",11405163,1,-6,0,117,56,50,-6
"f924752d8a1149668870b1e7698486f7","78f30e4dcac84e3cbea8b2cc6e0d62b3",11405163,1,10,0,118,50,59,9
"78f30e4dcac84e3cbea8b2cc6e0d62b3","a1f2f12debe5432fb7a70bcd12bacfb9",11405163,1,-1,0,119,59,58,-1
"a1f2f12debe5432fb7a70bcd12bacfb9","a1f2f12debe5432fb7a70bcd12bacfb9",11405163,16,0,1,120,58,58,0
"a1f2f12debe5432fb7a70bcd12bacfb9","78f30e4dcac84e3cbea8b2cc6e0d62b3",11405163,1,1,0,136,58,59,1
"78f30e4dcac84e3cbea8b2cc6e0d62b3","78f30e4dcac84e3cbea8b2cc6e0d62b3",11405163,19,0,1,137,59,59,0
"78f30e4dcac84e3cbea8b2cc6e0d62b3","bc42d26810654ea9a1df1efe1e58c7d5",11405163,1,5,0,156,59,63,4
"bc42d26810654ea9a1df1efe1e58c7d5","a0a418b8540d479fa6e0f653b701da8b",11405163,1,1,0,157,63,64,1
"a0a418b8540d479fa6e0f653b701da8b","12aa6e1672ac4e7aa6449a7a8609cd72",11405163,1,-8,0,158,64,57,-7
"12aa6e1672ac4e7aa6449a7a8609cd72","4c943503763e4e349906eea3ed3c8e86",11405163,1,5,0,159,57,61,4
"4c943503763e4e349906eea3ed3c8e86","4c943503763e4e349906eea3ed3c8e86",11405163,1,0,1,160,61,61,0
"4c943503763e4e349906eea3ed3c8e86","bc42d26810654ea9a1df1efe1e58c7d5",11405163,1,2,0,161,61,63,2
"bc42d26810654ea9a1df1efe1e58c7d5","bc42d26810654ea9a1df1efe1e58c7d5",11405163,3,0,1,162,63,63,0
"bc42d26810654ea9a1df1efe1e58c7d5","309ccf3cc4fe429d9bfbaef53d3fa479",11405163,1,-3,0,165,63,60,-3
"309ccf3cc4fe429d9bfbaef53d3fa479","d646286c8051419bbc2e31dd1db55ca8",11405163,1,10,0,166,60,67,7
"d646286c8051419bbc2e31dd1db55ca8","b534b89233134e30a9b5645138bfa9ee",11405163,1,-33,0,167,67,41,-26
"b534b89233134e30a9b5645138bfa9ee","267f883678b24aed855fde42524975d9",11405163,1,37,0,168,41,71,30
"267f883678b24aed855fde42524975d9","267f883678b24aed855fde42524975d9",11405163,1,0,1,169,71,71,0
"267f883678b24aed855fde42524975d9","88fff56d0342490dbef9040750a20f6c",11405163,1,1,0,170,71,72,1
"88fff56d0342490dbef9040750a20f6c","88fff56d0342490dbef9040750a20f6c",11405163,1,0,1,171,72,72,0
"88fff56d0342490dbef9040750a20f6c","adb17b12b66c4a49a85fd34322f7df70",11405163,1,1,0,172,72,73,1
"adb17b12b66c4a49a85fd34322f7df70","adb17b12b66c4a49a85fd34322f7df70",11405163,1,0,1,173,73,73,0
"adb17b12b66c4a49a85fd34322f7df70","a2becd407db34b189200a32546d9d569",11405163,1,3,0,174,73,75,2
"a2becd407db34b189200a32546d9d569","d646286c8051419bbc2e31dd1db55ca8",11405163,2,-9,0,175,75,67,-8
"d646286c8051419bbc2e31dd1db55ca8","a2becd407db34b189200a32546d9d569",11405163,3,9,0,176,67,75,8
"a2becd407db34b189200a32546d9d569","58c22b011d0f4c2ea6d13615edbb9eeb",11405163,1,2,0,177,75,77,2
"58c22b011d0f4c2ea6d13615edbb9eeb","58c22b011d0f4c2ea6d13615edbb9eeb",11405163,12,0,1,178,77,77,0
"58c22b011d0f4c2ea6d13615edbb9eeb","dd76e1861dc9461c830888729d091ee0",11405163,1,1,0,190,77,78,1
"dd76e1861dc9461c830888729d091ee0","dd76e1861dc9461c830888729d091ee0",11405163,8,0,1,191,78,78,0
"dd76e1861dc9461c830888729d091ee0","cd1d828f1a694b87913a7ea66c23803e",11405163,1,1,0,199,78,79,1
"cd1d828f1a694b87913a7ea66c23803e","cd1d828f1a694b87913a7ea66c23803e",11405163,2,0,1,200,79,79,0
"cd1d828f1a694b87913a7ea66c23803e","9176a3c2b4d2465fa8b0c67096c2a97e",11405163,1,1,0,202,79,80,1
"9176a3c2b4d2465fa8b0c67096c2a97e","9176a3c2b4d2465fa8b0c67096c2a97e",11405163,6,0,1,203,80,80,0
"9176a3c2b4d2465fa8b0c67096c2a97e","f8ec6445f7194e25b9101d4fbcb07a18",11405163,1,1,0,209,80,81,1
"f8ec6445f7194e25b9101d4fbcb07a18","f8ec6445f7194e25b9101d4fbcb07a18",11405163,2,0,1,210,81,81,0
"f8ec6445f7194e25b9101d4fbcb07a18","140d5b27b8574befad82c0a013b59dfa",11405163,1,-7,0,212,81,74,-7
"140d5b27b8574befad82c0a013b59dfa","d18a9ea32855445f8736581f5cb119ce",11405163,2,9,0,213,74,82,8
"d18a9ea32855445f8736581f5cb119ce","f564483cbd7a407681aa2fcca518cf5f",11405163,1,4,0,214,82,85,3
"f564483cbd7a407681aa2fcca518cf5f","f564483cbd7a407681aa2fcca518cf5f",11405163,1,0,1,215,85,85,0
"f564483cbd7a407681aa2fcca518cf5f","18fd01350bd5434ca636d59a599d768a",11405163,1,1,0,216,85,86,1
"18fd01350bd5434ca636d59a599d768a","18fd01350bd5434ca636d59a599d768a",11405163,9,0,1,217,86,86,0
"18fd01350bd5434ca636d59a599d768a","ae5ac430ea254e708a6f5deaaf7464ae",11405163,1,-2,0,226,86,84,-2
"ae5ac430ea254e708a6f5deaaf7464ae","6a9f0ef185fb47f0937e29daa1c71ed5",11405163,1,7,0,227,84,90,6
"6a9f0ef185fb47f0937e29daa1c71ed5","c681290961c94c4caf23b529d1ae6b9a",11405163,1,-2,0,228,90,88,-2
"c681290961c94c4caf23b529d1ae6b9a","c681290961c94c4caf23b529d1ae6b9a",11405163,1,0,1,229,88,88,0
"c681290961c94c4caf23b529d1ae6b9a","6a9f0ef185fb47f0937e29daa1c71ed5",11405163,1,2,0,230,88,90,2
"6a9f0ef185fb47f0937e29daa1c71ed5","6a9f0ef185fb47f0937e29daa1c71ed5",11405163,5,0,1,231,90,90,0
"6a9f0ef185fb47f0937e29daa1c71ed5","d646286c8051419bbc2e31dd1db55ca8",11405163,1,-27,0,234,90,67,-23
"d646286c8051419bbc2e31dd1db55ca8","e20db35ced8544ddac5bc3839145e463",11405163,1,30,0,235,67,91,24
"e20db35ced8544ddac5bc3839145e463","1febb706d7a34005ae8711ed49c76e64",11405163,1,3,0,236,91,94,3
"1febb706d7a34005ae8711ed49c76e64","1febb706d7a34005ae8711ed49c76e64",11405163,2,0,1,237,94,94,0
"1febb706d7a34005ae8711ed49c76e64","8f73ba6f5a0042f2850356ac38ac6f24",11405163,1,1,0,239,94,95,1
"8f73ba6f5a0042f2850356ac38ac6f24","8f73ba6f5a0042f2850356ac38ac6f24",11405163,5,0,1,240,95,95,0
"8f73ba6f5a0042f2850356ac38ac6f24","e2260b86653c46d7b14a41fb419dbf8c",11405163,1,1,0,245,95,96,1
"e2260b86653c46d7b14a41fb419dbf8c","e2260b86653c46d7b14a41fb419dbf8c",11405163,2,0,1,246,96,96,0
"e2260b86653c46d7b14a41fb419dbf8c","35eb641ad1d845bbba54915bce75a962",11405163,1,1,0,248,96,97,1
"35eb641ad1d845bbba54915bce75a962","35eb641ad1d845bbba54915bce75a962",11405163,5,0,1,249,97,97,0
"35eb641ad1d845bbba54915bce75a962","08be90ffbeea4795a138cd42ed8db56f",11405163,1,1,0,254,97,98,1
"08be90ffbeea4795a138cd42ed8db56f","08be90ffbeea4795a138cd42ed8db56f",11405163,5,0,1,255,98,98,0
"08be90ffbeea4795a138cd42ed8db56f","3007433c8f584dcbb5ac159c1c5f2be3",11405163,1,1,0,260,98,99,1
"3007433c8f584dcbb5ac159c1c5f2be3","3007433c8f584dcbb5ac159c1c5f2be3",11405163,5,0,1,261,99,99,0
"3007433c8f584dcbb5ac159c1c5f2be3","d391c8b6e56a43a7b654e9dee02d904b",11405163,1,5,0,266,99,103,4
"d391c8b6e56a43a7b654e9dee02d904b","00ae5f0c51874a73a41ebea838d95682",11405163,2,-2,0,267,103,101,-2
"00ae5f0c51874a73a41ebea838d95682","e20db35ced8544ddac5bc3839145e463",11405163,2,-11,0,268,101,91,-10
"e20db35ced8544ddac5bc3839145e463","00ae5f0c51874a73a41ebea838d95682",11405163,1,11,0,269,91,101,10
"00ae5f0c51874a73a41ebea838d95682","00ae5f0c51874a73a41ebea838d95682",11405163,1,0,1,270,101,101,0
"00ae5f0c51874a73a41ebea838d95682","d646286c8051419bbc2e31dd1db55ca8",11405163,1,-41,0,271,101,67,-34
"a2becd407db34b189200a32546d9d569","a2becd407db34b189200a32546d9d569",11405163,4,0,1,275,75,75,0
"a2becd407db34b189200a32546d9d569","140d5b27b8574befad82c0a013b59dfa",11405163,1,-1,0,279,75,74,-1
"d18a9ea32855445f8736581f5cb119ce","e20db35ced8544ddac5bc3839145e463",11405163,1,13,0,281,82,91,9
"e20db35ced8544ddac5bc3839145e463","d646286c8051419bbc2e31dd1db55ca8",11405163,2,-30,0,282,91,67,-24
"d646286c8051419bbc2e31dd1db55ca8","6a9f0ef185fb47f0937e29daa1c71ed5",11405163,1,27,0,283,67,90,23
"6a9f0ef185fb47f0937e29daa1c71ed5","ae5ac430ea254e708a6f5deaaf7464ae",11405163,1,-7,0,286,90,84,-6
"ae5ac430ea254e708a6f5deaaf7464ae","e20db35ced8544ddac5bc3839145e463",11405163,1,10,0,287,84,91,7
"d646286c8051419bbc2e31dd1db55ca8","00ae5f0c51874a73a41ebea838d95682",11405163,1,41,0,289,67,101,34
"e20db35ced8544ddac5bc3839145e463","d391c8b6e56a43a7b654e9dee02d904b",11405163,1,13,0,291,91,103,12
"00ae5f0c51874a73a41ebea838d95682","d391c8b6e56a43a7b654e9dee02d904b",11405163,1,2,0,293,101,103,2
"d391c8b6e56a43a7b654e9dee02d904b","d391c8b6e56a43a7b654e9dee02d904b",11405163,15,0,1,294,103,103,0
"d391c8b6e56a43a7b654e9dee02d904b","6111116566fc4fd9abba409322bea245",11405163,1,1,0,309,103,104,1
"6111116566fc4fd9abba409322bea245","6111116566fc4fd9abba409322bea245",11405163,2,0,1,310,104,104,0
"6111116566fc4fd9abba409322bea245","a81b2235cb9c499eb9ea8ee0a8dd9725",11405163,1,1,0,312,104,105,1
"a81b2235cb9c499eb9ea8ee0a8dd9725","a81b2235cb9c499eb9ea8ee0a8dd9725",11405163,5,0,1,313,105,105,0
"a81b2235cb9c499eb9ea8ee0a8dd9725","2d4e0ab0ef3b4d73b82c72d4621a7579",11405163,1,1,0,318,105,106,1
"2d4e0ab0ef3b4d73b82c72d4621a7579","2d4e0ab0ef3b4d73b82c72d4621a7579",11405163,2,0,1,319,106,106,0
"2d4e0ab0ef3b4d73b82c72d4621a7579","8bdebf492ebd4e62b0d522e8ab5e5197",11405163,1,1,0,321,106,107,1
"8bdebf492ebd4e62b0d522e8ab5e5197","8bdebf492ebd4e62b0d522e8ab5e5197",11405163,2,0,1,322,107,107,0
"8bdebf492ebd4e62b0d522e8ab5e5197","4280927ec4d643238aa49c32f9e06c6c",11405163,1,3,0,324,107,109,2
"4280927ec4d643238aa49c32f9e06c6c","73039f8c1eb9409cb4caee2cf968001e",11405163,1,-10,0,325,109,100,-9
"73039f8c1eb9409cb4caee2cf968001e","4280927ec4d643238aa49c32f9e06c6c",11405163,1,10,0,326,100,109,9
"4280927ec4d643238aa49c32f9e06c6c","fc44e6a5f7654430af1227838224dceb",11405163,1,2,0,327,109,111,2
"fc44e6a5f7654430af1227838224dceb","fc44e6a5f7654430af1227838224dceb",11405163,5,0,1,328,111,111,0
"fc44e6a5f7654430af1227838224dceb","08111f75e22d409998cf8b85bd431f0a",11405163,1,-3,0,333,111,108,-3
"08111f75e22d409998cf8b85bd431f0a","a9ae0a3c070d455bb4369a8996313336",11405163,1,7,0,334,108,114,6
"a9ae0a3c070d455bb4369a8996313336","a9ae0a3c070d455bb4369a8996313336",11405163,1,0,1,335,114,114,0
"a9ae0a3c070d455bb4369a8996313336","e20db35ced8544ddac5bc3839145e463",11405163,1,-26,0,336,114,91,-23
"e20db35ced8544ddac5bc3839145e463","e20db35ced8544ddac5bc3839145e463",11405163,1,0,1,337,91,91,0
"e20db35ced8544ddac5bc3839145e463","a9ae0a3c070d455bb4369a8996313336",11405163,1,26,0,338,91,114,23
"a9ae0a3c070d455bb4369a8996313336","71cec822bcff4f30a20e75dc63ef7b65",11405163,1,2,0,339,114,116,2
"71cec822bcff4f30a20e75dc63ef7b65","71cec822bcff4f30a20e75dc63ef7b65",11405163,3,0,1,340,116,116,0
"71cec822bcff4f30a20e75dc63ef7b65","37319e88176d4aefa91d7a9980dbae91",11405163,1,-4,0,343,116,112,-4
"37319e88176d4aefa91d7a9980dbae91","62bff51286ef4f348717a3cf6fe2318f",11405163,1,9,0,344,112,120,8
"62bff51286ef4f348717a3cf6fe2318f","b1cd0e7dc3ad4a8eb91a4bfdbeb025b0",11405163,1,-2,0,345,120,118,-2
"b1cd0e7dc3ad4a8eb91a4bfdbeb025b0","b1cd0e7dc3ad4a8eb91a4bfdbeb025b0",11405163,1,0,1,346,118,118,0
"b1cd0e7dc3ad4a8eb91a4bfdbeb025b0","62bff51286ef4f348717a3cf6fe2318f",11405163,1,2,0,347,118,120,2
"62bff51286ef4f348717a3cf6fe2318f","62bff51286ef4f348717a3cf6fe2318f",11405163,3,0,1,348,120,120,0
"62bff51286ef4f348717a3cf6fe2318f","779f9ddd1fd14d1e9e69f72219a1fdbd",11405163,1,3,0,351,120,121,1
"779f9ddd1fd14d1e9e69f72219a1fdbd","e20db35ced8544ddac5bc3839145e463",11405163,1,-36,0,352,121,91,-30
"e20db35ced8544ddac5bc3839145e463","ae26e6cda8ad4a3f81bd347560d9579f",11405163,1,40,0,353,91,125,34
"ae26e6cda8ad4a3f81bd347560d9579f","ae26e6cda8ad4a3f81bd347560d9579f",11405163,3,0,1,354,125,125,0
"ae26e6cda8ad4a3f81bd347560d9579f","ee48df95832b4374aa273ceb27ec1315",11405163,1,1,0,357,125,126,1
"ee48df95832b4374aa273ceb27ec1315","ee48df95832b4374aa273ceb27ec1315",11405163,1,0,1,358,126,126,0
"ee48df95832b4374aa273ceb27ec1315","7a439da90b394756ad1777fc4c6dead5",11405163,1,1,0,359,126,127,1
"7a439da90b394756ad1777fc4c6dead5","7a439da90b394756ad1777fc4c6dead5",11405163,1,0,1,360,127,127,0
"7a439da90b394756ad1777fc4c6dead5","779f9ddd1fd14d1e9e69f72219a1fdbd",11405163,1,-6,0,361,127,121,-6
"779f9ddd1fd14d1e9e69f72219a1fdbd","a8dd5213034441ac92724b4e83eb0bb2",11405163,1,9,0,362,121,129,8
"a8dd5213034441ac92724b4e83eb0bb2","a8dd5213034441ac92724b4e83eb0bb2",11405163,1,0,1,363,129,129,0
"a8dd5213034441ac92724b4e83eb0bb2","8115eab6556b45f5b415c3b8c26a12e5",11405163,1,2,0,364,129,131,2
"8115eab6556b45f5b415c3b8c26a12e5","8115eab6556b45f5b415c3b8c26a12e5",11405163,12,0,1,365,131,131,0
"8115eab6556b45f5b415c3b8c26a12e5","ec34b06efd844b46a4c4818ecdb9b8f4",11405163,1,1,0,377,131,132,1
"ec34b06efd844b46a4c4818ecdb9b8f4","ec34b06efd844b46a4c4818ecdb9b8f4",11405163,2,0,1,378,132,132,0
"ec34b06efd844b46a4c4818ecdb9b8f4","c2e1c2b9eac64109b343a088584b576b",11405163,1,1,0,380,132,133,1
"c2e1c2b9eac64109b343a088584b576b","c2e1c2b9eac64109b343a088584b576b",11405163,2,0,1,381,133,133,0
"c2e1c2b9eac64109b343a088584b576b","579338175e0b4bbb8ef3b712b5d8b54e",11405163,1,-5,0,383,133,128,-5
"579338175e0b4bbb8ef3b712b5d8b54e","8bc5795d6a984a3eace4e2811e52dd4f",11405163,1,8,0,384,128,135,7
"8bc5795d6a984a3eace4e2811e52dd4f","8bc5795d6a984a3eace4e2811e52dd4f",11405163,1,0,1,385,135,135,0
"8bc5795d6a984a3eace4e2811e52dd4f","b416d47c56a742199b5d7c7f19d6503a",11405163,1,-1,0,386,135,134,-1
"b416d47c56a742199b5d7c7f19d6503a","cd4532ad48034873ba8bce2aac0c9808",11405163,1,4,0,387,134,137,3
"cd4532ad48034873ba8bce2aac0c9808","cd4532ad48034873ba8bce2aac0c9808",11405163,1,0,1,388,137,137,0
"cd4532ad48034873ba8bce2aac0c9808","779f9ddd1fd14d1e9e69f72219a1fdbd",11405163,1,-19,0,389,137,121,-16
"779f9ddd1fd14d1e9e69f72219a1fdbd","df1de691dafe4549a18a4398ee9dfaf9",11405163,1,23,0,390,121,139,18
"df1de691dafe4549a18a4398ee9dfaf9","6c5ad271a44743479bfaea29b1db8d02",11405163,1,4,0,391,139,143,4
"6c5ad271a44743479bfaea29b1db8d02","6c5ad271a44743479bfaea29b1db8d02",11405163,2,0,1,392,143,143,0
"6c5ad271a44743479bfaea29b1db8d02","83d311bed5374fee83d8d67a7d9d82dc",11405163,1,1,0,394,143,144,1
"83d311bed5374fee83d8d67a7d9d82dc","83d311bed5374fee83d8d67a7d9d82dc",11405163,1,0,1,395,144,144,0
"83d311bed5374fee83d8d67a7d9d82dc","402bba41861d43acb52a5abb89e8831e",11405163,1,1,0,396,144,145,1
"402bba41861d43acb52a5abb89e8831e","402bba41861d43acb52a5abb89e8831e",11405163,2,0,1,397,145,145,0
"402bba41861d43acb52a5abb89e8831e","df1de691dafe4549a18a4398ee9dfaf9",11405163,1,-6,0,399,145,139,-6
"df1de691dafe4549a18a4398ee9dfaf9","8aae34f5ddbb4052a709b12e6b0d40fa",11405163,1,9,0,400,139,147,8
"8aae34f5ddbb4052a709b12e6b0d40fa","8aae34f5ddbb4052a709b12e6b0d40fa",11405163,1,0,1,401,147,147,0
"8aae34f5ddbb4052a709b12e6b0d40fa","645b3f0249f64f76af2e19eb4d0e55b7",11405163,1,2,0,402,147,149,2
"645b3f0249f64f76af2e19eb4d0e55b7","645b3f0249f64f76af2e19eb4d0e55b7",11405163,5,0,1,403,149,149,0
"645b3f0249f64f76af2e19eb4d0e55b7","7e7b8db5064d4369805ab370aac5ddfb",11405163,1,1,0,408,149,150,1
"7e7b8db5064d4369805ab370aac5ddfb","7e7b8db5064d4369805ab370aac5ddfb",11405163,5,0,1,409,150,150,0
"7e7b8db5064d4369805ab370aac5ddfb","8956d210ae7f41968fada86d4c979d6a",11405163,1,1,0,414,150,151,1
"8956d210ae7f41968fada86d4c979d6a","8956d210ae7f41968fada86d4c979d6a",11405163,2,0,1,415,151,151,0
"8956d210ae7f41968fada86d4c979d6a","f902b0f41b544d4dbf79664fd233648d",11405163,1,-5,0,417,151,146,-5
"f902b0f41b544d4dbf79664fd233648d","ae781e8b775e4ccd93bc800dad5c8376",11405163,1,8,0,418,146,153,7
"ae781e8b775e4ccd93bc800dad5c8376","ae781e8b775e4ccd93bc800dad5c8376",11405163,2,0,1,419,153,153,0
"ae781e8b775e4ccd93bc800dad5c8376","06882a8492d9499aa31555567f575ecb",11405163,1,1,0,421,153,154,1
"06882a8492d9499aa31555567f575ecb","06882a8492d9499aa31555567f575ecb",11405163,1,0,1,422,154,154,0
"06882a8492d9499aa31555567f575ecb","f293c508f409466a8f27ddd7d1e40b20",11405163,1,1,0,423,154,155,1
"f293c508f409466a8f27ddd7d1e40b20","f293c508f409466a8f27ddd7d1e40b20",11405163,2,0,1,424,155,155,0
"f293c508f409466a8f27ddd7d1e40b20","cc4ddef5bbbe48ebb605141b347c4ed1",11405163,1,1,0,426,155,156,1
"cc4ddef5bbbe48ebb605141b347c4ed1","cc4ddef5bbbe48ebb605141b347c4ed1",11405163,1,0,1,427,156,156,0
"cc4ddef5bbbe48ebb605141b347c4ed1","f03480cf4eba413194d7af52fc0e7f28",11405163,1,-4,0,428,156,152,-4
"f03480cf4eba413194d7af52fc0e7f28","d313cec988a84645bee413e8d4724a4b",11405163,1,7,0,429,152,158,6
"d313cec988a84645bee413e8d4724a4b","d313cec988a84645bee413e8d4724a4b",11405163,4,0,1,430,158,158,0
"d313cec988a84645bee413e8d4724a4b","dc60696c76a74368a60f72246e47700d",11405163,1,1,0,434,158,159,1
"dc60696c76a74368a60f72246e47700d","dc60696c76a74368a60f72246e47700d",11405163,1,0,1,435,159,159,0
"dc60696c76a74368a60f72246e47700d","df1de691dafe4549a18a4398ee9dfaf9",11405163,1,-23,0,436,159,139,-20
"df1de691dafe4549a18a4398ee9dfaf9","78adeee1fa2c4fe0bc73f7bca9fcee86",11405163,1,26,0,437,139,160,21
"78adeee1fa2c4fe0bc73f7bca9fcee86","78adeee1fa2c4fe0bc73f7bca9fcee86",11405163,1,0,1,438,160,160,0
"78adeee1fa2c4fe0bc73f7bca9fcee86","65202579580f4ad38d734b4ee39d22a8",11405163,8,5,0,439,160,164,4
"65202579580f4ad38d734b4ee39d22a8","65202579580f4ad38d734b4ee39d22a8",11405163,95,0,1,440,164,164,0
"65202579580f4ad38d734b4ee39d22a8","78adeee1fa2c4fe0bc73f7bca9fcee86",11405163,6,-5,0,444,164,160,-4
"65202579580f4ad38d734b4ee39d22a8","3cbcea2be0984e7dbd5a48195af10ce7",11405163,1,3,0,457,164,165,1
"3cbcea2be0984e7dbd5a48195af10ce7","78adeee1fa2c4fe0bc73f7bca9fcee86",11405163,2,-8,0,458,165,160,-5
"78adeee1fa2c4fe0bc73f7bca9fcee86","82e6285962b8400d9d6fc32436022a94",11405163,1,10,0,459,160,167,7
"82e6285962b8400d9d6fc32436022a94","3cbcea2be0984e7dbd5a48195af10ce7",11405163,2,-2,0,460,167,165,-2
"3cbcea2be0984e7dbd5a48195af10ce7","a9ac840f098c4bd0a2ee896214ce29cd",11405163,2,5,0,461,165,168,3
"a9ac840f098c4bd0a2ee896214ce29cd","78adeee1fa2c4fe0bc73f7bca9fcee86",11405163,1,-13,0,462,168,160,-8
"78adeee1fa2c4fe0bc73f7bca9fcee86","3cbcea2be0984e7dbd5a48195af10ce7",11405163,2,8,0,472,160,165,5
"3cbcea2be0984e7dbd5a48195af10ce7","82e6285962b8400d9d6fc32436022a94",11405163,3,2,0,473,165,167,2
"82e6285962b8400d9d6fc32436022a94","a9ac840f098c4bd0a2ee896214ce29cd",11405163,1,3,0,474,167,168,1
"a9ac840f098c4bd0a2ee896214ce29cd","3cbcea2be0984e7dbd5a48195af10ce7",11405163,2,-5,0,475,168,165,-3
"a9ac840f098c4bd0a2ee896214ce29cd","0c7262dff33c4087bc660ccf40f92f9c",11405163,1,4,0,477,168,169,1
"0c7262dff33c4087bc660ccf40f92f9c","b2275c3fad834f8d90737a2d9a6927d6",11405163,2,3,0,478,169,172,3
"b2275c3fad834f8d90737a2d9a6927d6","0c7262dff33c4087bc660ccf40f92f9c",11405163,1,-3,0,479,172,169,-3
"0c7262dff33c4087bc660ccf40f92f9c","a9ac840f098c4bd0a2ee896214ce29cd",11405163,1,-4,0,480,169,168,-1
"a9ac840f098c4bd0a2ee896214ce29cd","a9ac840f098c4bd0a2ee896214ce29cd",11405163,1,0,1,481,168,168,0
"82e6285962b8400d9d6fc32436022a94","0c7262dff33c4087bc660ccf40f92f9c",11405163,1,7,0,560,167,169,2
"0c7262dff33c4087bc660ccf40f92f9c","0c7262dff33c4087bc660ccf40f92f9c",11405163,1,0,1,561,169,169,0
"b2275c3fad834f8d90737a2d9a6927d6","b2275c3fad834f8d90737a2d9a6927d6",11405163,20,0,1,563,172,172,0
"b2275c3fad834f8d90737a2d9a6927d6","eb515a26030b41f8a82a1e6114420bad",11405163,1,1,0,583,172,173,1
"eb515a26030b41f8a82a1e6114420bad","eb515a26030b41f8a82a1e6114420bad",11405163,2,0,1,584,173,173,0
"eb515a26030b41f8a82a1e6114420bad","0c7262dff33c4087bc660ccf40f92f9c",11405163,1,-4,0,586,173,169,-4
"0c7262dff33c4087bc660ccf40f92f9c","b42cc17b7de840f181a704558d0bc845",11405163,1,7,0,587,169,175,6
"b42cc17b7de840f181a704558d0bc845","801f9e9135034f49bf5f8b4bdefedb41",11405163,1,2,0,588,175,177,2
"801f9e9135034f49bf5f8b4bdefedb41","801f9e9135034f49bf5f8b4bdefedb41",11405163,7,0,1,589,177,177,0
"801f9e9135034f49bf5f8b4bdefedb41","b42cc17b7de840f181a704558d0bc845",11405163,1,-2,0,596,177,175,-2
"b42cc17b7de840f181a704558d0bc845","ea38cc0e6e6e41edbabf210220808bf9",11405163,1,5,0,597,175,179,4
"ea38cc0e6e6e41edbabf210220808bf9","362fcb0699a14845ab29b2340093e528",11405163,1,-6,0,598,179,174,-5
"362fcb0699a14845ab29b2340093e528","b87c552dd247427abe6ab5795b9c9d43",11405163,1,8,0,599,174,181,7
"b87c552dd247427abe6ab5795b9c9d43","ea38cc0e6e6e41edbabf210220808bf9",11405163,1,-2,0,600,181,179,-2
"ea38cc0e6e6e41edbabf210220808bf9","b87c552dd247427abe6ab5795b9c9d43",11405163,1,2,0,601,179,181,2
"b87c552dd247427abe6ab5795b9c9d43","b87c552dd247427abe6ab5795b9c9d43",11405163,7,0,1,602,181,181,0
"b87c552dd247427abe6ab5795b9c9d43","139b097acfca451689d80c9c6eebdf7b",11405163,1,-3,0,609,181,178,-3
"139b097acfca451689d80c9c6eebdf7b","30f660a1feb34582a739722532524f79",11405163,1,6,0,610,178,183,5
"30f660a1feb34582a739722532524f79","30f660a1feb34582a739722532524f79",11405163,3,0,1,611,183,183,0
"30f660a1feb34582a739722532524f79","2024b4885bd14338a39b7b509acbbd02",11405163,1,-1,0,614,183,182,-1
"2024b4885bd14338a39b7b509acbbd02","c3f63fe50d8e487c86bf8ef76c9cadd3",11405163,1,4,0,615,182,185,3
"c3f63fe50d8e487c86bf8ef76c9cadd3","c3f63fe50d8e487c86bf8ef76c9cadd3",11405163,1,0,1,616,185,185,0
"c3f63fe50d8e487c86bf8ef76c9cadd3","0c7262dff33c4087bc660ccf40f92f9c",11405163,1,-20,0,617,185,169,-16
"0c7262dff33c4087bc660ccf40f92f9c","c8e371568a0c4391b25796ae4e91952e",11405163,1,23,0,618,169,186,17
"c8e371568a0c4391b25796ae4e91952e","7d932b23e1c84326ae5aa4d3c0d813d1",11405163,1,2,0,619,186,188,2
"7d932b23e1c84326ae5aa4d3c0d813d1","7d932b23e1c84326ae5aa4d3c0d813d1",11405163,1,0,1,620,188,188,0
"7d932b23e1c84326ae5aa4d3c0d813d1","c8e371568a0c4391b25796ae4e91952e",11405163,1,-2,0,621,188,186,-2
"c8e371568a0c4391b25796ae4e91952e","ab11d94c6c8948ea90b88f19d2cd502b",11405163,1,5,0,622,186,190,4
"ab11d94c6c8948ea90b88f19d2cd502b","ab11d94c6c8948ea90b88f19d2cd502b",11405163,1,0,1,623,190,190,0
"ab11d94c6c8948ea90b88f19d2cd502b","f992451ed6ad4e68bb9e68ad6be7c4be",11405163,1,2,0,624,190,192,2
"f992451ed6ad4e68bb9e68ad6be7c4be","f992451ed6ad4e68bb9e68ad6be7c4be",11405163,1,0,1,625,192,192,0
"f992451ed6ad4e68bb9e68ad6be7c4be","07b44a7a51e94c78b411c753fc39dab0",11405163,1,-3,0,626,192,189,-3
"07b44a7a51e94c78b411c753fc39dab0","6cd2dcaac46847d4a0bc53f296d90375",11405163,1,6,0,627,189,194,5
"6cd2dcaac46847d4a0bc53f296d90375","6cd2dcaac46847d4a0bc53f296d90375",11405163,2,0,1,628,194,194,0
"6cd2dcaac46847d4a0bc53f296d90375","2d2580c9411c4972909db508d6956a58",11405163,1,2,0,630,194,196,2
"2d2580c9411c4972909db508d6956a58","2d2580c9411c4972909db508d6956a58",11405163,5,0,1,631,196,196,0
"2d2580c9411c4972909db508d6956a58","5bddb3d9ed264f3984702f048c7e5340",11405163,1,1,0,636,196,197,1
"5bddb3d9ed264f3984702f048c7e5340","5bddb3d9ed264f3984702f048c7e5340",11405163,2,0,1,637,197,197,0
"5bddb3d9ed264f3984702f048c7e5340","d5e8e2bd12a2466b9d6d90855f0eb079",11405163,1,1,0,639,197,198,1
"d5e8e2bd12a2466b9d6d90855f0eb079","d5e8e2bd12a2466b9d6d90855f0eb079",11405163,2,0,1,640,198,198,0
"d5e8e2bd12a2466b9d6d90855f0eb079","017d7ca8e0394b91aaadc9574df2202c",11405163,1,-5,0,642,198,193,-5
"017d7ca8e0394b91aaadc9574df2202c","54e8e9f0ea3e45c4bf3b8ac799ee31b1",11405163,1,8,0,643,193,200,7
"54e8e9f0ea3e45c4bf3b8ac799ee31b1","54e8e9f0ea3e45c4bf3b8ac799ee31b1",11405163,1,0,1,644,200,200,0
"54e8e9f0ea3e45c4bf3b8ac799ee31b1","c614a00911be4877a075f19315530fb0",11405163,1,1,0,645,200,201,1
"c614a00911be4877a075f19315530fb0","c614a00911be4877a075f19315530fb0",11405163,6,0,1,646,201,201,0
"c614a00911be4877a075f19315530fb0","a6c21bd8b95249c7972820a7a7d76aff",11405163,1,1,0,652,201,202,1
"a6c21bd8b95249c7972820a7a7d76aff","a6c21bd8b95249c7972820a7a7d76aff",11405163,1,0,1,653,202,202,0
"a6c21bd8b95249c7972820a7a7d76aff","bb329d880ab54120adaf203a693bb203",11405163,1,1,0,654,202,203,1
"bb329d880ab54120adaf203a693bb203","bb329d880ab54120adaf203a693bb203",11405163,1,0,1,655,203,203,0
"bb329d880ab54120adaf203a693bb203","f9170dd6bc6442b4acd832747609b09a",11405163,1,-4,0,656,203,199,-4
"f9170dd6bc6442b4acd832747609b09a","334c2344009840079b1d0e1b7ce3d5a7",11405163,1,7,0,657,199,205,6
"334c2344009840079b1d0e1b7ce3d5a7","334c2344009840079b1d0e1b7ce3d5a7",11405163,1,0,1,658,205,205,0
"334c2344009840079b1d0e1b7ce3d5a7","c8e371568a0c4391b25796ae4e91952e",11405163,1,-23,0,659,205,186,-19
"c8e371568a0c4391b25796ae4e91952e","d7f13c8d63ec4e2aa673fbb9cf9c6933",11405163,1,26,0,660,186,206,20
"d7f13c8d63ec4e2aa673fbb9cf9c6933","b9e80f77c3a44349863b19875725c384",11405163,2,1,0,661,206,207,1
"b9e80f77c3a44349863b19875725c384","7108f0e4c2584f1f9c471689ae4c885c",11405163,3,1,0,662,207,208,1
"7108f0e4c2584f1f9c471689ae4c885c","d7f13c8d63ec4e2aa673fbb9cf9c6933",11405163,2,-2,0,663,208,206,-2
"7108f0e4c2584f1f9c471689ae4c885c","78adeee1fa2c4fe0bc73f7bca9fcee86",11405163,1,-68,0,666,208,160,-48
"65202579580f4ad38d734b4ee39d22a8","b9e80f77c3a44349863b19875725c384",11405163,1,62,0,677,164,207,43
"b9e80f77c3a44349863b19875725c384","b9e80f77c3a44349863b19875725c384",11405163,21,0,1,678,207,207,0
"7108f0e4c2584f1f9c471689ae4c885c","7108f0e4c2584f1f9c471689ae4c885c",11405163,10,0,1,700,208,208,0
"d7f13c8d63ec4e2aa673fbb9cf9c6933","09400e101c5d4b439cf9a26b03aae558",11405163,1,5,0,711,206,210,4
"09400e101c5d4b439cf9a26b03aae558","09400e101c5d4b439cf9a26b03aae558",11405163,1,0,1,712,210,210,0
"09400e101c5d4b439cf9a26b03aae558","a88efa7e50ce47159810ab553afa6d3a",11405163,1,2,0,713,210,212,2
"a88efa7e50ce47159810ab553afa6d3a","a88efa7e50ce47159810ab553afa6d3a",11405163,2,0,1,714,212,212,0
"a88efa7e50ce47159810ab553afa6d3a","a875096404ef4a9984b62d74cda916f9",11405163,1,-3,0,716,212,209,-3
"a875096404ef4a9984b62d74cda916f9","be502a7a43c44bf7b682698de79d9369",11405163,1,6,0,717,209,214,5
"be502a7a43c44bf7b682698de79d9369","f7fb1952f56b4189b86a9f8b7862d2b8",11405163,2,1,0,718,214,215,1
"f7fb1952f56b4189b86a9f8b7862d2b8","be502a7a43c44bf7b682698de79d9369",11405163,1,-1,0,719,215,214,-1
"f7fb1952f56b4189b86a9f8b7862d2b8","f7fb1952f56b4189b86a9f8b7862d2b8",11405163,11,0,1,721,215,215,0
"f7fb1952f56b4189b86a9f8b7862d2b8","b860ee85d8bc4a2f97958cfb71be3533",11405163,1,1,0,732,215,216,1
"b860ee85d8bc4a2f97958cfb71be3533","b860ee85d8bc4a2f97958cfb71be3533",11405163,2,0,1,733,216,216,0
"b860ee85d8bc4a2f97958cfb71be3533","ec341f459285443b8361f7f15638ff08",11405163,1,-3,0,735,216,213,-3
"ec341f459285443b8361f7f15638ff08","363837c182e04711840d896ae1e0339c",11405163,1,6,0,736,213,218,5
"363837c182e04711840d896ae1e0339c","363837c182e04711840d896ae1e0339c",11405163,12,0,1,737,218,218,0
"363837c182e04711840d896ae1e0339c","01b2051f8941460d89945e3b02d1ce78",11405163,1,-1,0,749,218,217,-1
"01b2051f8941460d89945e3b02d1ce78","91125ca626c5470eb145501f8c37f8db",11405163,1,4,0,750,217,220,3
"91125ca626c5470eb145501f8c37f8db","91125ca626c5470eb145501f8c37f8db",11405163,1,0,1,751,220,220,0
"91125ca626c5470eb145501f8c37f8db","d7f13c8d63ec4e2aa673fbb9cf9c6933",11405163,1,-18,0,752,220,206,-14
"d7f13c8d63ec4e2aa673fbb9cf9c6933","1c6721b1f63f4d30ba7746ea8af02a52",11405163,1,21,0,753,206,221,15
"1c6721b1f63f4d30ba7746ea8af02a52","77ecef8eff6b4a2caea7707669bf7475",11405163,1,1,0,754,221,222,1
"77ecef8eff6b4a2caea7707669bf7475","77ecef8eff6b4a2caea7707669bf7475",11405163,12,0,1,755,222,222,0
"77ecef8eff6b4a2caea7707669bf7475","d03cb855c70044cf8c35d9ec0de696e3",11405163,1,3,0,767,222,224,2
"d03cb855c70044cf8c35d9ec0de696e3","1c6721b1f63f4d30ba7746ea8af02a52",11405163,1,-4,0,768,224,221,-3
"1c6721b1f63f4d30ba7746ea8af02a52","8b9ae98743bd4d4a8a87dff1c1244211",11405163,1,7,0,769,221,227,6
"8b9ae98743bd4d4a8a87dff1c1244211","d03cb855c70044cf8c35d9ec0de696e3",11405163,1,-3,0,770,227,224,-3
"d03cb855c70044cf8c35d9ec0de696e3","a49a937d6896486d9a5396654abcf2e1",11405163,1,2,0,771,224,226,2
"a49a937d6896486d9a5396654abcf2e1","a49a937d6896486d9a5396654abcf2e1",11405163,1,0,1,772,226,226,0
"a49a937d6896486d9a5396654abcf2e1","8b9ae98743bd4d4a8a87dff1c1244211",11405163,1,1,0,773,226,227,1
"8b9ae98743bd4d4a8a87dff1c1244211","8b9ae98743bd4d4a8a87dff1c1244211",11405163,27,0,1,774,227,227,0
"8b9ae98743bd4d4a8a87dff1c1244211","f7906d6f59b9489a91d2ef40db5a474d",11405163,1,-4,0,801,227,223,-4
"f7906d6f59b9489a91d2ef40db5a474d","2ab1535aac1346ba8801535bf729ef37",11405163,1,7,0,802,223,229,6
"2ab1535aac1346ba8801535bf729ef37","2ab1535aac1346ba8801535bf729ef37",11405163,2,0,1,803,229,229,0
"2ab1535aac1346ba8801535bf729ef37","a4f40fb48a8542c8949bae1f002cd9bc",11405163,1,2,0,805,229,231,2
"a4f40fb48a8542c8949bae1f002cd9bc","a4f40fb48a8542c8949bae1f002cd9bc",11405163,2,0,1,806,231,231,0
"a4f40fb48a8542c8949bae1f002cd9bc","8972c23e32044edb8a78fa1eed4e5947",11405163,1,1,0,808,231,232,1
"8972c23e32044edb8a78fa1eed4e5947","8972c23e32044edb8a78fa1eed4e5947",11405163,1,0,1,809,232,232,0
"8972c23e32044edb8a78fa1eed4e5947","92feb4a40f8344d38b6f722e42a53295",11405163,1,1,0,810,232,233,1
"92feb4a40f8344d38b6f722e42a53295","92feb4a40f8344d38b6f722e42a53295",11405163,2,0,1,811,233,233,0
"92feb4a40f8344d38b6f722e42a53295","5152833676bf4c6cb317060be10f68db",11405163,1,-5,0,813,233,228,-5
"5152833676bf4c6cb317060be10f68db","ca3e28f290354c08aefe5b0f769604e6",11405163,1,8,0,814,228,235,7
"ca3e28f290354c08aefe5b0f769604e6","ca3e28f290354c08aefe5b0f769604e6",11405163,12,0,1,815,235,235,0
"ca3e28f290354c08aefe5b0f769604e6","79a35eea833e4c2c9d22fc53c3c6445c",11405163,1,1,0,827,235,236,1
"79a35eea833e4c2c9d22fc53c3c6445c","79a35eea833e4c2c9d22fc53c3c6445c",11405163,9,0,1,828,236,236,0
"79a35eea833e4c2c9d22fc53c3c6445c","8f68228b1518449e9615cdafee41a2bd",11405163,1,1,0,837,236,237,1
"8f68228b1518449e9615cdafee41a2bd","8f68228b1518449e9615cdafee41a2bd",11405163,1,0,1,838,237,237,0
"8f68228b1518449e9615cdafee41a2bd","cab89fa5c3ed45a5aa550fc0352d6a42",11405163,1,1,0,839,237,238,1
"cab89fa5c3ed45a5aa550fc0352d6a42","cab89fa5c3ed45a5aa550fc0352d6a42",11405163,1,0,1,840,238,238,0
"cab89fa5c3ed45a5aa550fc0352d6a42","66d4fad4f1cf4b46be0750a99ad7a35a",11405163,1,1,0,841,238,239,1
"66d4fad4f1cf4b46be0750a99ad7a35a","66d4fad4f1cf4b46be0750a99ad7a35a",11405163,1,0,1,842,239,239,0
"66d4fad4f1cf4b46be0750a99ad7a35a","0b04c8e2f86d48c7aeb7e225819cd32b",11405163,1,-5,0,843,239,234,-5
"0b04c8e2f86d48c7aeb7e225819cd32b","f53da5fd9bfe412da4b80d4742563b6c",11405163,1,8,0,844,234,241,7
"f53da5fd9bfe412da4b80d4742563b6c","f53da5fd9bfe412da4b80d4742563b6c",11405163,1,0,1,845,241,241,0
"f53da5fd9bfe412da4b80d4742563b6c","1c6721b1f63f4d30ba7746ea8af02a52",11405163,1,-24,0,846,241,221,-20
"1c6721b1f63f4d30ba7746ea8af02a52","2ae94c0cea4d480a9d5dca8fb1d7b542",11405163,1,27,0,847,221,242,21
"2ae94c0cea4d480a9d5dca8fb1d7b542","1ebf23f9d994469a85206e4c7b1bf5f5",11405163,1,3,0,848,242,245,3
"1ebf23f9d994469a85206e4c7b1bf5f5","1ebf23f9d994469a85206e4c7b1bf5f5",11405163,12,0,1,849,245,245,0
"1ebf23f9d994469a85206e4c7b1bf5f5","85ae675b83e8422da842cfd25596af99",11405163,1,1,0,861,245,246,1
"85ae675b83e8422da842cfd25596af99","fa235f0f364d47e4ae1c87f47bf8e6ba",11405163,1,8,0,862,246,252,6
"fa235f0f364d47e4ae1c87f47bf8e6ba","85ae675b83e8422da842cfd25596af99",11405163,1,-8,0,863,252,246,-6
"85ae675b83e8422da842cfd25596af99","2ae94c0cea4d480a9d5dca8fb1d7b542",11405163,1,-4,0,864,246,242,-4
"2ae94c0cea4d480a9d5dca8fb1d7b542","fa235f0f364d47e4ae1c87f47bf8e6ba",11405163,1,12,0,865,242,252,10
"fa235f0f364d47e4ae1c87f47bf8e6ba","79f7845465cc4ed19d8e4f1429541be0",11405163,1,2,0,866,252,254,2
"79f7845465cc4ed19d8e4f1429541be0","79f7845465cc4ed19d8e4f1429541be0",11405163,2,0,1,867,254,254,0
"79f7845465cc4ed19d8e4f1429541be0","00f61990949545828dd12f1303d47504",11405163,1,3,0,869,254,256,2
"00f61990949545828dd12f1303d47504","6e83e23f56544a19b94067c1c558d9c0",11405163,1,-11,0,870,256,247,-9
"6e83e23f56544a19b94067c1c558d9c0","00f61990949545828dd12f1303d47504",11405163,1,11,0,871,247,256,9
"00f61990949545828dd12f1303d47504","2ae94c0cea4d480a9d5dca8fb1d7b542",11405163,1,-17,0,872,256,242,-14
"2ae94c0cea4d480a9d5dca8fb1d7b542","ead7bb4b64e247d2ae632ab8a296b091",11405163,1,19,0,873,242,258,16
"ead7bb4b64e247d2ae632ab8a296b091","ead7bb4b64e247d2ae632ab8a296b091",11405163,2,0,1,874,258,258,0
"ead7bb4b64e247d2ae632ab8a296b091","41b0048dde734bb280bac6116baa8e27",11405163,1,1,0,876,258,259,1
"41b0048dde734bb280bac6116baa8e27","41b0048dde734bb280bac6116baa8e27",11405163,2,0,1,877,259,259,0
"41b0048dde734bb280bac6116baa8e27","b41c5a094a604ee0915327da5cc0beb7",11405163,1,1,0,879,259,260,1
"b41c5a094a604ee0915327da5cc0beb7","b41c5a094a604ee0915327da5cc0beb7",11405163,5,0,1,880,260,260,0
"b41c5a094a604ee0915327da5cc0beb7","d546341988904f069cfa86b21457d9d9",11405163,1,-10,0,885,260,251,-9
"d546341988904f069cfa86b21457d9d9","28c171777c52431ab6b925073bd63d46",11405163,1,15,0,886,251,264,13
"28c171777c52431ab6b925073bd63d46","28c171777c52431ab6b925073bd63d46",11405163,7,0,1,887,264,264,0
"28c171777c52431ab6b925073bd63d46","ac160db940cb49ae8579162b1d52bb5d",11405163,1,2,0,894,264,266,2
"ac160db940cb49ae8579162b1d52bb5d","ac160db940cb49ae8579162b1d52bb5d",11405163,3,0,1,895,266,266,0
"ac160db940cb49ae8579162b1d52bb5d","d989ebcfc12a4b669f0100dc1aa14f1e",11405163,1,-12,0,898,266,255,-11
"d989ebcfc12a4b669f0100dc1aa14f1e","c6fd49b485cc4874b0bbdd9c6171e09c",11405163,1,15,0,899,255,268,13
"c6fd49b485cc4874b0bbdd9c6171e09c","c6fd49b485cc4874b0bbdd9c6171e09c",11405163,3,0,1,900,268,268,0
"c6fd49b485cc4874b0bbdd9c6171e09c","44240778a97c4af0937817499b75707b",11405163,1,1,0,903,268,269,1
"44240778a97c4af0937817499b75707b","44240778a97c4af0937817499b75707b",11405163,2,0,1,904,269,269,0
"44240778a97c4af0937817499b75707b","7aa76d3e993840d8805f097cbdbcd44b",11405163,1,-9,0,906,269,261,-8
"7aa76d3e993840d8805f097cbdbcd44b","865a4d3b43374da7944dc7d397f566d9",11405163,1,12,0,907,261,271,10
"865a4d3b43374da7944dc7d397f566d9","865a4d3b43374da7944dc7d397f566d9",11405163,1,0,1,908,271,271,0
"865a4d3b43374da7944dc7d397f566d9","0d987bed3ffa4ed0b9a2e62e97b7b30f",11405163,1,3,0,909,271,272,1
"0d987bed3ffa4ed0b9a2e62e97b7b30f","2ae94c0cea4d480a9d5dca8fb1d7b542",11405163,1,-38,0,910,272,242,-30
"2ae94c0cea4d480a9d5dca8fb1d7b542","0d987bed3ffa4ed0b9a2e62e97b7b30f",11405163,1,38,0,911,242,272,30
"bb5a47f5ea01454a8b79455422d3b9da","82ae07bc0c9b4570a41799290d1ef399",11405163,2,-6,0,918,280,275,-5
"82ae07bc0c9b4570a41799290d1ef399","bb5a47f5ea01454a8b79455422d3b9da",11405163,3,6,0,919,275,280,5
"0d987bed3ffa4ed0b9a2e62e97b7b30f","0d987bed3ffa4ed0b9a2e62e97b7b30f",11405163,3,0,1,922,272,272,0
"bc5524e78a8544e2ae2fdc2f3462bbec","0d987bed3ffa4ed0b9a2e62e97b7b30f",11405163,1,-9,0,933,279,272,-7
"0d987bed3ffa4ed0b9a2e62e97b7b30f","a39da0ce33404aa7aeef29af014da204",11405163,1,5,0,935,272,276,4
"a39da0ce33404aa7aeef29af014da204","a39da0ce33404aa7aeef29af014da204",11405163,1,0,1,936,276,276,0
"a39da0ce33404aa7aeef29af014da204","0d987bed3ffa4ed0b9a2e62e97b7b30f",11405163,1,-5,0,937,276,272,-4
"bc5524e78a8544e2ae2fdc2f3462bbec","82ae07bc0c9b4570a41799290d1ef399",11405163,1,-5,0,948,279,275,-4
"bb5a47f5ea01454a8b79455422d3b9da","bb5a47f5ea01454a8b79455422d3b9da",11405163,107,0,1,1000,280,280,0
"bb5a47f5ea01454a8b79455422d3b9da","94cecc3f1e7d484b8e068e79241dfd73",11405163,1,3,0,1007,280,281,1
"94cecc3f1e7d484b8e068e79241dfd73","0d987bed3ffa4ed0b9a2e62e97b7b30f",11405163,2,-13,0,1008,281,272,-9
"0d987bed3ffa4ed0b9a2e62e97b7b30f","a37477c4e4c14169ad44b06b493007f6",11405163,1,15,0,1009,272,283,11
"a37477c4e4c14169ad44b06b493007f6","0d987bed3ffa4ed0b9a2e62e97b7b30f",11405163,1,-15,0,1010,283,272,-11
"0d987bed3ffa4ed0b9a2e62e97b7b30f","94cecc3f1e7d484b8e068e79241dfd73",11405163,2,13,0,1011,272,281,9
"94cecc3f1e7d484b8e068e79241dfd73","bb5a47f5ea01454a8b79455422d3b9da",11405163,1,-3,0,1012,281,280,-1
"bb5a47f5ea01454a8b79455422d3b9da","bc5524e78a8544e2ae2fdc2f3462bbec",11405163,3,-1,0,1028,280,279,-1
"bc5524e78a8544e2ae2fdc2f3462bbec","94cecc3f1e7d484b8e068e79241dfd73",11405163,1,4,0,1029,279,281,2
"94cecc3f1e7d484b8e068e79241dfd73","a37477c4e4c14169ad44b06b493007f6",11405163,2,2,0,1030,281,283,2
"a37477c4e4c14169ad44b06b493007f6","94cecc3f1e7d484b8e068e79241dfd73",11405163,2,-2,0,1031,283,281,-2
"0d987bed3ffa4ed0b9a2e62e97b7b30f","bb5a47f5ea01454a8b79455422d3b9da",11405163,5,10,0,1033,272,280,8
"bb5a47f5ea01454a8b79455422d3b9da","0d987bed3ffa4ed0b9a2e62e97b7b30f",11405163,2,-10,0,1041,280,272,-8
"94cecc3f1e7d484b8e068e79241dfd73","fab84b4fab5940efb4ea868ef8d09396",11405163,1,5,0,1045,281,284,3
"fab84b4fab5940efb4ea868ef8d09396","4a29443515bb404cb8924e1c60a63b73",11405163,1,4,0,1046,284,285,1
"4a29443515bb404cb8924e1c60a63b73","4a29443515bb404cb8924e1c60a63b73",11405163,1,0,1,1047,285,285,0
"4a29443515bb404cb8924e1c60a63b73","208c9b2796c944db8dacaa96082520ea",11405163,1,3,0,1048,285,288,3
"208c9b2796c944db8dacaa96082520ea","208c9b2796c944db8dacaa96082520ea",11405163,1,0,1,1049,288,288,0
"208c9b2796c944db8dacaa96082520ea","4a29443515bb404cb8924e1c60a63b73",11405163,1,-3,0,1050,288,285,-3
"4a29443515bb404cb8924e1c60a63b73","7669a956527947d0add87455277e80b4",11405163,1,7,0,1051,285,291,6
"7669a956527947d0add87455277e80b4","7669a956527947d0add87455277e80b4",11405163,1,0,1,1052,291,291,0
"7669a956527947d0add87455277e80b4","869e967078f04da18dd0b0b9389a7424",11405163,1,3,0,1053,291,293,2
"869e967078f04da18dd0b0b9389a7424","6a9a3b5bde4a48daa896fe8c06eca56f",11405163,1,-5,0,1054,293,289,-4
"6a9a3b5bde4a48daa896fe8c06eca56f","869e967078f04da18dd0b0b9389a7424",11405163,1,5,0,1055,289,293,4
"869e967078f04da18dd0b0b9389a7424","51ab6291537748fab90d519aa09889d6",11405163,1,2,0,1056,293,295,2
"51ab6291537748fab90d519aa09889d6","51ab6291537748fab90d519aa09889d6",11405163,5,0,1,1057,295,295,0
"51ab6291537748fab90d519aa09889d6","34a6e49023fc4465bd5ca604330bbd1c",11405163,1,-3,0,1062,295,292,-3
"34a6e49023fc4465bd5ca604330bbd1c","ba0e59461bfb4a44b7b1c28a01f8d3b3",11405163,1,9,0,1063,292,299,7
"ba0e59461bfb4a44b7b1c28a01f8d3b3","21592f2a9e9c4b2f8c66ec5dbcbf6a2b",11405163,1,-4,0,1064,299,296,-3
"21592f2a9e9c4b2f8c66ec5dbcbf6a2b","ba0e59461bfb4a44b7b1c28a01f8d3b3",11405163,1,4,0,1065,296,299,3
"ba0e59461bfb4a44b7b1c28a01f8d3b3","0e0b36e731a645e7b1b8a88f5031ca38",11405163,1,2,0,1066,299,301,2
"0e0b36e731a645e7b1b8a88f5031ca38","0e0b36e731a645e7b1b8a88f5031ca38",11405163,2,0,1,1067,301,301,0
"0e0b36e731a645e7b1b8a88f5031ca38","a66a144637284c21afc6de17fea4bfb8",11405163,1,1,0,1069,301,302,1
"a66a144637284c21afc6de17fea4bfb8","a66a144637284c21afc6de17fea4bfb8",11405163,5,0,1,1070,302,302,0
"a66a144637284c21afc6de17fea4bfb8","7646a919d7e64fa990bca9b024ff089d",11405163,1,-4,0,1075,302,298,-4
"7646a919d7e64fa990bca9b024ff089d","e390b575229748ea8aac9364efe2bf00",11405163,1,7,0,1076,298,304,6
"e390b575229748ea8aac9364efe2bf00","e390b575229748ea8aac9364efe2bf00",11405163,1,0,1,1077,304,304,0
"e390b575229748ea8aac9364efe2bf00","3434c10e561d488a914e0f7d71907abd",11405163,1,3,0,1078,304,305,1
"3434c10e561d488a914e0f7d71907abd","4a29443515bb404cb8924e1c60a63b73",11405163,3,-27,0,1079,305,285,-20
"4a29443515bb404cb8924e1c60a63b73","53e7e900392747ccad52e711ab0f80d8",11405163,2,29,0,1080,285,307,22
"53e7e900392747ccad52e711ab0f80d8","0d987bed3ffa4ed0b9a2e62e97b7b30f",11405163,1,-51,0,1081,307,272,-35
"bb5a47f5ea01454a8b79455422d3b9da","b2f0d654738f48158edff28e8d3a546e",11405163,1,246,0,1092,280,449,169
"b2f0d654738f48158edff28e8d3a546e","3434c10e561d488a914e0f7d71907abd",11405163,1,-207,0,1093,449,305,-144
"3434c10e561d488a914e0f7d71907abd","53e7e900392747ccad52e711ab0f80d8",11405163,1,2,0,1094,305,307,2
"53e7e900392747ccad52e711ab0f80d8","3434c10e561d488a914e0f7d71907abd",11405163,1,-2,0,1095,307,305,-2
"4a29443515bb404cb8924e1c60a63b73","3434c10e561d488a914e0f7d71907abd",11405163,1,27,0,1097,285,305,20
"53e7e900392747ccad52e711ab0f80d8","53e7e900392747ccad52e711ab0f80d8",11405163,1,0,1,1100,307,307,0
"53e7e900392747ccad52e711ab0f80d8","130acc2aeb0448fdbb2de63bc5cebe5b",11405163,1,3,0,1101,307,309,2
"130acc2aeb0448fdbb2de63bc5cebe5b","3434c10e561d488a914e0f7d71907abd",11405163,1,-5,0,1102,309,305,-4
"3434c10e561d488a914e0f7d71907abd","130acc2aeb0448fdbb2de63bc5cebe5b",11405163,1,5,0,1103,305,309,4
"130acc2aeb0448fdbb2de63bc5cebe5b","9c062b3251034ebe90f5054e2a3b5120",11405163,1,2,0,1104,309,311,2
"9c062b3251034ebe90f5054e2a3b5120","9c062b3251034ebe90f5054e2a3b5120",11405163,2,0,1,1105,311,311,0
"9c062b3251034ebe90f5054e2a3b5120","ea859f8207e44537889daeaba13ac2e8",11405163,1,1,0,1107,311,312,1
"ea859f8207e44537889daeaba13ac2e8","ea859f8207e44537889daeaba13ac2e8",11405163,1,0,1,1108,312,312,0
"ea859f8207e44537889daeaba13ac2e8","56d94971a7a94257aa330183a8ebd0ea",11405163,1,1,0,1109,312,313,1
"56d94971a7a94257aa330183a8ebd0ea","56d94971a7a94257aa330183a8ebd0ea",11405163,9,0,1,1110,313,313,0
"56d94971a7a94257aa330183a8ebd0ea","141c0df6cd1946539aadd1c9b7068cd4",11405163,1,-5,0,1119,313,308,-5
"141c0df6cd1946539aadd1c9b7068cd4","13255e63e0aa4abf85e5211bf613d43e",11405163,1,10,0,1120,308,317,9
"13255e63e0aa4abf85e5211bf613d43e","13255e63e0aa4abf85e5211bf613d43e",11405163,1,0,1,1121,317,317,0
"13255e63e0aa4abf85e5211bf613d43e","86c27d40179e419c8e9d150fb6afa5d0",11405163,1,3,0,1122,317,319,2
"86c27d40179e419c8e9d150fb6afa5d0","0c787d16c9504873b1a4d903cec09948",11405163,1,-6,0,1123,319,314,-5
"0c787d16c9504873b1a4d903cec09948","86c27d40179e419c8e9d150fb6afa5d0",11405163,1,6,0,1124,314,319,5
"86c27d40179e419c8e9d150fb6afa5d0","24f1363179ad4aaa965484a78471912b",11405163,1,5,0,1125,319,323,4
"24f1363179ad4aaa965484a78471912b","47edbb64109243e6b0f8f64cdef90c6c",11405163,3,3,0,1126,323,326,3
"47edbb64109243e6b0f8f64cdef90c6c","8d7e0b55cf9849cda222a0f2440cec55",11405163,1,-9,0,1127,326,318,-8
"8d7e0b55cf9849cda222a0f2440cec55","24f1363179ad4aaa965484a78471912b",11405163,1,6,0,1128,318,323,5
"24f1363179ad4aaa965484a78471912b","3628bdce1dd2429ba924d2d4d09448d2",11405163,1,-1,0,1129,323,322,-1
"3628bdce1dd2429ba924d2d4d09448d2","56b3fd1a212a4764be39d979fde3326e",11405163,1,7,0,1130,322,328,6
"56b3fd1a212a4764be39d979fde3326e","56b3fd1a212a4764be39d979fde3326e",11405163,1,0,1,1131,328,328,0
"56b3fd1a212a4764be39d979fde3326e","3434c10e561d488a914e0f7d71907abd",11405163,1,-28,0,1132,328,305,-23
"3434c10e561d488a914e0f7d71907abd","0c4079457ede49e3aeb5e86ed84bdf35",11405163,2,31,0,1133,305,329,24
"0c4079457ede49e3aeb5e86ed84bdf35","38aea304b4fa46e1b29bb72f5cea4c93",11405163,2,2,0,1134,329,331,2
"38aea304b4fa46e1b29bb72f5cea4c93","0c4079457ede49e3aeb5e86ed84bdf35",11405163,1,-2,0,1135,331,329,-2
"0c4079457ede49e3aeb5e86ed84bdf35","3434c10e561d488a914e0f7d71907abd",11405163,1,-31,0,1136,329,305,-24
"3434c10e561d488a914e0f7d71907abd","24f1363179ad4aaa965484a78471912b",11405163,2,22,0,1137,305,323,18
"47edbb64109243e6b0f8f64cdef90c6c","43ea1b823a4b4e51b7c694c10725db82",11405163,1,2,0,1139,326,327,1
"43ea1b823a4b4e51b7c694c10725db82","3628bdce1dd2429ba924d2d4d09448d2",11405163,1,-6,0,1140,327,322,-5
"3628bdce1dd2429ba924d2d4d09448d2","3434c10e561d488a914e0f7d71907abd",11405163,1,-21,0,1141,322,305,-17
"38aea304b4fa46e1b29bb72f5cea4c93","38aea304b4fa46e1b29bb72f5cea4c93",11405163,3,0,1,1144,331,331,0
"38aea304b4fa46e1b29bb72f5cea4c93","e36d261332f14e79bb4b467aceaeb9b5",11405163,1,2,0,1147,331,333,2
"e36d261332f14e79bb4b467aceaeb9b5","e36d261332f14e79bb4b467aceaeb9b5",11405163,1,0,1,1148,333,333,0
"e36d261332f14e79bb4b467aceaeb9b5","c7e89b9d04744d2eab742fc24e3ef1ae",11405163,1,1,0,1149,333,334,1
"c7e89b9d04744d2eab742fc24e3ef1ae","c7e89b9d04744d2eab742fc24e3ef1ae",11405163,2,0,1,1150,334,334,0
"c7e89b9d04744d2eab742fc24e3ef1ae","fe49f8054b374a0ea4bb266ed135ff62",11405163,1,1,0,1152,334,335,1
"fe49f8054b374a0ea4bb266ed135ff62","fe49f8054b374a0ea4bb266ed135ff62",11405163,2,0,1,1153,335,335,0
"fe49f8054b374a0ea4bb266ed135ff62","d0a8f74af98642fe8360d22c42e45117",11405163,1,1,0,1155,335,336,1
"d0a8f74af98642fe8360d22c42e45117","d0a8f74af98642fe8360d22c42e45117",11405163,5,0,1,1156,336,336,0
"d0a8f74af98642fe8360d22c42e45117","0c4079457ede49e3aeb5e86ed84bdf35",11405163,1,-7,0,1161,336,329,-7
"0c4079457ede49e3aeb5e86ed84bdf35","a7c6339ca1da4368a18d471f0519f877",11405163,1,11,0,1162,329,339,10
"a7c6339ca1da4368a18d471f0519f877","a7c6339ca1da4368a18d471f0519f877",11405163,1,0,1,1163,339,339,0
"a7c6339ca1da4368a18d471f0519f877","b8b9418ab322418d9db9b40d96af873a",11405163,1,-2,0,1164,339,337,-2
"b8b9418ab322418d9db9b40d96af873a","bbc5139ca9024389a94db3a6f47dcff6",11405163,1,5,0,1165,337,341,4
"bbc5139ca9024389a94db3a6f47dcff6","bbc5139ca9024389a94db3a6f47dcff6",11405163,2,0,1,1166,341,341,0
"bbc5139ca9024389a94db3a6f47dcff6","4ee6ca9019ab4a1ab323f98094a9bd77",11405163,1,2,0,1168,341,343,2
"4ee6ca9019ab4a1ab323f98094a9bd77","4ee6ca9019ab4a1ab323f98094a9bd77",11405163,2,0,1,1169,343,343,0
"4ee6ca9019ab4a1ab323f98094a9bd77","b37947176785476f8b29d49a851366dc",11405163,1,1,0,1171,343,344,1
"b37947176785476f8b29d49a851366dc","b37947176785476f8b29d49a851366dc",11405163,2,0,1,1172,344,344,0
"b37947176785476f8b29d49a851366dc","fcea5b10d5a14a3b9324ffece8f6e1e5",11405163,1,1,0,1174,344,345,1
"fcea5b10d5a14a3b9324ffece8f6e1e5","fcea5b10d5a14a3b9324ffece8f6e1e5",11405163,8,0,1,1175,345,345,0
"fcea5b10d5a14a3b9324ffece8f6e1e5","c2490bc612d146edbe786556fab3651b",11405163,1,-5,0,1183,345,340,-5
"c2490bc612d146edbe786556fab3651b","6ac8bb048b854999a47edb35fe627f11",11405163,1,8,0,1184,340,347,7
"6ac8bb048b854999a47edb35fe627f11","6ac8bb048b854999a47edb35fe627f11",11405163,1,0,1,1185,347,347,0
"6ac8bb048b854999a47edb35fe627f11","0c4079457ede49e3aeb5e86ed84bdf35",11405163,1,-21,0,1186,347,329,-18
"0c4079457ede49e3aeb5e86ed84bdf35","30ead9794d4847abaf222ca966cc8630",11405163,1,24,0,1187,329,348,19
"30ead9794d4847abaf222ca966cc8630","c20993c944444fe085345591a8bd837e",11405163,1,3,0,1188,348,351,3
"c20993c944444fe085345591a8bd837e","09b9678ddc3d452ea4a3d46e15826065",11405163,1,2,0,1189,351,353,2
"09b9678ddc3d452ea4a3d46e15826065","897b7f51242c44aab2205c72fdcbf4cd",11405163,1,-1,0,1190,353,352,-1
"897b7f51242c44aab2205c72fdcbf4cd","eff0de7f2dbb42dfa1a2e686efab5b6d",11405163,1,2,0,1191,352,354,2
"eff0de7f2dbb42dfa1a2e686efab5b6d","c20993c944444fe085345591a8bd837e",11405163,1,-3,0,1192,354,351,-3
"c20993c944444fe085345591a8bd837e","c20993c944444fe085345591a8bd837e",11405163,3,0,1,1193,351,351,0
"c20993c944444fe085345591a8bd837e","897b7f51242c44aab2205c72fdcbf4cd",11405163,1,1,0,1196,351,352,1
"897b7f51242c44aab2205c72fdcbf4cd","897b7f51242c44aab2205c72fdcbf4cd",11405163,3,0,1,1197,352,352,0
"897b7f51242c44aab2205c72fdcbf4cd","09b9678ddc3d452ea4a3d46e15826065",11405163,1,1,0,1200,352,353,1
"09b9678ddc3d452ea4a3d46e15826065","09b9678ddc3d452ea4a3d46e15826065",11405163,3,0,1,1201,353,353,0
"09b9678ddc3d452ea4a3d46e15826065","eff0de7f2dbb42dfa1a2e686efab5b6d",11405163,1,1,0,1204,353,354,1
"eff0de7f2dbb42dfa1a2e686efab5b6d","eff0de7f2dbb42dfa1a2e686efab5b6d",11405163,3,0,1,1205,354,354,0
"eff0de7f2dbb42dfa1a2e686efab5b6d","30ead9794d4847abaf222ca966cc8630",11405163,1,-6,0,1208,354,348,-6
"30ead9794d4847abaf222ca966cc8630","2fe14166dc9642c3bc666b86a57f943d",11405163,1,10,0,1209,348,357,9
"2fe14166dc9642c3bc666b86a57f943d","2fe14166dc9642c3bc666b86a57f943d",11405163,1,0,1,1210,357,357,0
"2fe14166dc9642c3bc666b86a57f943d","44421dd1e13a47a388c4a19834b744c7",11405163,1,2,0,1211,357,359,2
"44421dd1e13a47a388c4a19834b744c7","44421dd1e13a47a388c4a19834b744c7",11405163,5,0,1,1212,359,359,0
"44421dd1e13a47a388c4a19834b744c7","cb5fc7ef85d547c4be1a7439d0bf6052",11405163,1,1,0,1217,359,360,1
"cb5fc7ef85d547c4be1a7439d0bf6052","cb5fc7ef85d547c4be1a7439d0bf6052",11405163,2,0,1,1218,360,360,0
"cb5fc7ef85d547c4be1a7439d0bf6052","0a8f150a4cf747acbde62f4721823da3",11405163,1,1,0,1220,360,361,1
"0a8f150a4cf747acbde62f4721823da3","0a8f150a4cf747acbde62f4721823da3",11405163,2,0,1,1221,361,361,0
"0a8f150a4cf747acbde62f4721823da3","ab8fdad974ae471f9f24c3f9dd04462e",11405163,1,1,0,1223,361,362,1
"ab8fdad974ae471f9f24c3f9dd04462e","ab8fdad974ae471f9f24c3f9dd04462e",11405163,2,0,1,1224,362,362,0
"ab8fdad974ae471f9f24c3f9dd04462e","1ba8fef685d74a8194b9db252eb704fb",11405163,1,-7,0,1226,362,355,-7
"1ba8fef685d74a8194b9db252eb704fb","52580888dadb4fe3baa795683ea227bd",11405163,1,10,0,1227,355,364,9
"52580888dadb4fe3baa795683ea227bd","52580888dadb4fe3baa795683ea227bd",11405163,4,0,1,1228,364,364,0
"52580888dadb4fe3baa795683ea227bd","492a3bc6a1254f23a7998587961b22a4",11405163,1,3,0,1232,364,366,2
"492a3bc6a1254f23a7998587961b22a4","f00179e251a045b39c3f7a54f9aa4acc",11405163,1,-4,0,1233,366,363,-3
"f00179e251a045b39c3f7a54f9aa4acc","492a3bc6a1254f23a7998587961b22a4",11405163,1,4,0,1234,363,366,3
"492a3bc6a1254f23a7998587961b22a4","072a190fd302456290895f9f04d6940a",11405163,1,-1,0,1235,366,365,-1
"072a190fd302456290895f9f04d6940a","cfa457d1743848e4bb5e4beced6448ed",11405163,1,5,0,1236,365,369,4
"cfa457d1743848e4bb5e4beced6448ed","cfa457d1743848e4bb5e4beced6448ed",11405163,1,0,1,1237,369,369,0
"cfa457d1743848e4bb5e4beced6448ed","30ead9794d4847abaf222ca966cc8630",11405163,1,-25,0,1238,369,348,-21
"30ead9794d4847abaf222ca966cc8630","b71bac264efb4abd97015447bd490db6",11405163,1,28,0,1239,348,370,22
"b71bac264efb4abd97015447bd490db6","b71bac264efb4abd97015447bd490db6",11405163,2,0,1,1240,370,370,0
"b71bac264efb4abd97015447bd490db6","8d448d625b024c82a5eb240bbd7431d6",11405163,2,5,0,1242,370,374,4
"8d448d625b024c82a5eb240bbd7431d6","8d448d625b024c82a5eb240bbd7431d6",11405163,64,0,1,1243,374,374,0
"8d448d625b024c82a5eb240bbd7431d6","b71bac264efb4abd97015447bd490db6",11405163,2,-5,0,1250,374,370,-4
"b71bac264efb4abd97015447bd490db6","d6d02b6ef04e4f17805504500b8ce441",11405163,4,8,0,1251,370,375,5
"d6d02b6ef04e4f17805504500b8ce441","d6d02b6ef04e4f17805504500b8ce441",11405163,5,0,1,1252,375,375,0
"d6d02b6ef04e4f17805504500b8ce441","f60ee41ec635499abd48168342d32c2f",11405163,1,121,0,1253,375,453,78
"f60ee41ec635499abd48168342d32c2f","f60ee41ec635499abd48168342d32c2f",11405163,71,0,1,1254,453,453,0
"f60ee41ec635499abd48168342d32c2f","f67fbf45a5f146ed866965bc57c7c001",11405163,2,3,0,1261,453,454,1
"f67fbf45a5f146ed866965bc57c7c001","66baf19b6b904b70922329068c63746d",11405163,1,-120,0,1262,454,376,-78
"66baf19b6b904b70922329068c63746d","66baf19b6b904b70922329068c63746d",11405163,3,0,1,1263,376,376,0
"66baf19b6b904b70922329068c63746d","7f544639412e40a9ba27f43b415362ab",11405163,6,2,0,1265,376,378,2
"7f544639412e40a9ba27f43b415362ab","66baf19b6b904b70922329068c63746d",11405163,2,-2,0,1266,378,376,-2
"66baf19b6b904b70922329068c63746d","d6d02b6ef04e4f17805504500b8ce441",11405163,1,-4,0,1269,376,375,-1
"d6d02b6ef04e4f17805504500b8ce441","b71bac264efb4abd97015447bd490db6",11405163,2,-8,0,1271,375,370,-5
"d6d02b6ef04e4f17805504500b8ce441","8d448d625b024c82a5eb240bbd7431d6",11405163,1,-3,0,1273,375,374,-1
"8d448d625b024c82a5eb240bbd7431d6","d6d02b6ef04e4f17805504500b8ce441",11405163,1,3,0,1324,374,375,1
"d6d02b6ef04e4f17805504500b8ce441","66baf19b6b904b70922329068c63746d",11405163,2,4,0,1328,375,376,1
"7f544639412e40a9ba27f43b415362ab","b71bac264efb4abd97015447bd490db6",11405163,1,-14,0,1330,378,370,-8
"7f544639412e40a9ba27f43b415362ab","30ead9794d4847abaf222ca966cc8630",11405163,1,-42,0,1345,378,348,-30
"30ead9794d4847abaf222ca966cc8630","52580888dadb4fe3baa795683ea227bd",11405163,1,18,0,1346,348,364,16
"52580888dadb4fe3baa795683ea227bd","66baf19b6b904b70922329068c63746d",11405163,1,22,0,1347,364,376,12
"7f544639412e40a9ba27f43b415362ab","7f544639412e40a9ba27f43b415362ab",11405163,2,0,1,1350,378,378,0
"7f544639412e40a9ba27f43b415362ab","d5ae8642e15b46b8bd298b02274d4e9c",11405163,1,2,0,1352,378,380,2
"d5ae8642e15b46b8bd298b02274d4e9c","d5ae8642e15b46b8bd298b02274d4e9c",11405163,1,0,1,1353,380,380,0
"d5ae8642e15b46b8bd298b02274d4e9c","a0d10309a2dd456289147f84be9d37f9",11405163,1,1,0,1354,380,381,1
"a0d10309a2dd456289147f84be9d37f9","a0d10309a2dd456289147f84be9d37f9",11405163,2,0,1,1355,381,381,0
"a0d10309a2dd456289147f84be9d37f9","0fcbc3ca07b144138b8d85da581f09a8",11405163,1,1,0,1357,381,382,1
"0fcbc3ca07b144138b8d85da581f09a8","0fcbc3ca07b144138b8d85da581f09a8",11405163,5,0,1,1358,382,382,0
"0fcbc3ca07b144138b8d85da581f09a8","66baf19b6b904b70922329068c63746d",11405163,1,-6,0,1363,382,376,-6
"66baf19b6b904b70922329068c63746d","c2fca3669923477ab966ded303dea31c",11405163,1,8,0,1364,376,383,7
"c2fca3669923477ab966ded303dea31c","4890121ce5d74576b4632b77cfc23398",11405163,2,6,0,1365,383,388,5
"4890121ce5d74576b4632b77cfc23398","18d3b836dd804224883cc9180b60a8e1",11405163,1,-1,0,1366,388,387,-1
"18d3b836dd804224883cc9180b60a8e1","4890121ce5d74576b4632b77cfc23398",11405163,1,1,0,1367,387,388,1
"4890121ce5d74576b4632b77cfc23398","c2fca3669923477ab966ded303dea31c",11405163,1,-6,0,1368,388,383,-5
"4890121ce5d74576b4632b77cfc23398","96bb2b3e85a34d8b9544514e89f6fe97",11405163,1,3,0,1370,388,390,2
"96bb2b3e85a34d8b9544514e89f6fe97","18d3b836dd804224883cc9180b60a8e1",11405163,1,-4,0,1371,390,387,-3
"18d3b836dd804224883cc9180b60a8e1","96bb2b3e85a34d8b9544514e89f6fe97",11405163,1,4,0,1372,387,390,3
"96bb2b3e85a34d8b9544514e89f6fe97","ac4e9b54acfe4670b4634859c7263cb5",11405163,1,2,0,1373,390,392,2
"ac4e9b54acfe4670b4634859c7263cb5","ac4e9b54acfe4670b4634859c7263cb5",11405163,1,0,1,1374,392,392,0
"ac4e9b54acfe4670b4634859c7263cb5","6f8881a745ac4c358a68b92c3b4abe81",11405163,1,3,0,1375,392,394,2
"6f8881a745ac4c358a68b92c3b4abe81","17f95d18bab743888e1736033dc3384d",11405163,1,-6,0,1376,394,389,-5
"17f95d18bab743888e1736033dc3384d","6f8881a745ac4c358a68b92c3b4abe81",11405163,1,6,0,1377,389,394,5
"6f8881a745ac4c358a68b92c3b4abe81","f7002c8484354eceac57bc7bd62c76c1",11405163,1,-1,0,1378,394,393,-1
"f7002c8484354eceac57bc7bd62c76c1","44a277ea44dc4ae689fab4b82f0b4098",11405163,1,5,0,1379,393,397,4
"44a277ea44dc4ae689fab4b82f0b4098","44a277ea44dc4ae689fab4b82f0b4098",11405163,1,0,1,1380,397,397,0
"44a277ea44dc4ae689fab4b82f0b4098","0c12af0a4e7f4002852cf84b2537c161",11405163,1,-2,0,1381,397,395,-2
"0c12af0a4e7f4002852cf84b2537c161","859e0b8d71694b12befb69ee698138f9",11405163,1,5,0,1382,395,399,4
"859e0b8d71694b12befb69ee698138f9","859e0b8d71694b12befb69ee698138f9",11405163,1,0,1,1383,399,399,0
"859e0b8d71694b12befb69ee698138f9","66baf19b6b904b70922329068c63746d",11405163,1,-29,0,1384,399,376,-23
"66baf19b6b904b70922329068c63746d","2b09a08242b54983aec7063990fb3f66",11405163,1,32,0,1385,376,400,24
"2b09a08242b54983aec7063990fb3f66","2b09a08242b54983aec7063990fb3f66",11405163,2,0,1,1386,400,400,0
"2b09a08242b54983aec7063990fb3f66","1f471b7a883a4df48211e8c6a81b59a7",11405163,1,1,0,1388,400,401,1
"1f471b7a883a4df48211e8c6a81b59a7","1f471b7a883a4df48211e8c6a81b59a7",11405163,1,0,1,1389,401,401,0
"1f471b7a883a4df48211e8c6a81b59a7","2b09a08242b54983aec7063990fb3f66",11405163,1,-1,0,1390,401,400,-1
"2b09a08242b54983aec7063990fb3f66","9de0d567bfa84fe5b77cb76f4a76a5d1",11405163,1,5,0,1391,400,404,4
"9de0d567bfa84fe5b77cb76f4a76a5d1","9de0d567bfa84fe5b77cb76f4a76a5d1",11405163,1,0,1,1392,404,404,0
"9de0d567bfa84fe5b77cb76f4a76a5d1","1157bd665ec4472fb58b751dc5099355",11405163,1,-1,0,1393,404,403,-1
"1157bd665ec4472fb58b751dc5099355","58fc9094275e4c49be3f4ba6d4acc0a4",11405163,1,5,0,1394,403,406,3
"58fc9094275e4c49be3f4ba6d4acc0a4","3c8a22d2f9c146ea956609e3ed4f2559",11405163,1,-2,0,1395,406,405,-1
"3c8a22d2f9c146ea956609e3ed4f2559","58fc9094275e4c49be3f4ba6d4acc0a4",11405163,1,2,0,1396,405,406,1
"58fc9094275e4c49be3f4ba6d4acc0a4","2b09a08242b54983aec7063990fb3f66",11405163,2,-9,0,1397,406,400,-6
"2b09a08242b54983aec7063990fb3f66","58fc9094275e4c49be3f4ba6d4acc0a4",11405163,2,9,0,1398,400,406,6
"58fc9094275e4c49be3f4ba6d4acc0a4","3434c10e561d488a914e0f7d71907abd",11405163,1,-136,0,1401,406,305,-101
"47edbb64109243e6b0f8f64cdef90c6c","66baf19b6b904b70922329068c63746d",11405163,1,70,0,1404,326,376,50
"7f544639412e40a9ba27f43b415362ab","58fc9094275e4c49be3f4ba6d4acc0a4",11405163,1,39,0,1406,378,406,28
"58fc9094275e4c49be3f4ba6d4acc0a4","58fc9094275e4c49be3f4ba6d4acc0a4",11405163,2,0,1,1407,406,406,0
"58fc9094275e4c49be3f4ba6d4acc0a4","c1c1be90b2b14c1ab4a5e1ee3c241902",11405163,1,1,0,1409,406,407,1
"c1c1be90b2b14c1ab4a5e1ee3c241902","c1c1be90b2b14c1ab4a5e1ee3c241902",11405163,5,0,1,1410,407,407,0
"c1c1be90b2b14c1ab4a5e1ee3c241902","02b3a1bead9244c1ba2f857c7da8f82a",11405163,1,2,0,1415,407,408,1
"02b3a1bead9244c1ba2f857c7da8f82a","58fc9094275e4c49be3f4ba6d4acc0a4",11405163,1,-3,0,1416,408,406,-2
"58fc9094275e4c49be3f4ba6d4acc0a4","02b3a1bead9244c1ba2f857c7da8f82a",11405163,1,3,0,1417,406,408,2
"02b3a1bead9244c1ba2f857c7da8f82a","6206fc6479014bb193084c32409dc1b9",11405163,1,1,0,1418,408,409,1
"6206fc6479014bb193084c32409dc1b9","6206fc6479014bb193084c32409dc1b9",11405163,1,0,1,1419,409,409,0
"6206fc6479014bb193084c32409dc1b9","6a5f020451db426dacba9e2ea3fcc62a",11405163,1,2,0,1420,409,410,1
"6a5f020451db426dacba9e2ea3fcc62a","02b3a1bead9244c1ba2f857c7da8f82a",11405163,1,-3,0,1421,410,408,-2
"02b3a1bead9244c1ba2f857c7da8f82a","6a5f020451db426dacba9e2ea3fcc62a",11405163,1,3,0,1422,408,410,2
"6a5f020451db426dacba9e2ea3fcc62a","33a9d248b2e44588a5b07fc1342b9bc2",11405163,2,2,0,1423,410,411,1
"33a9d248b2e44588a5b07fc1342b9bc2","6a5f020451db426dacba9e2ea3fcc62a",11405163,1,-2,0,1424,411,410,-1
"33a9d248b2e44588a5b07fc1342b9bc2","c6f26bd420634f1cb7989e76fe6b16c0",11405163,1,1,0,1426,411,412,1
"c6f26bd420634f1cb7989e76fe6b16c0","c6f26bd420634f1cb7989e76fe6b16c0",11405163,5,0,1,1427,412,412,0
"c6f26bd420634f1cb7989e76fe6b16c0","2a65ee6e2ac64f6a8a55fbe5373ec763",11405163,1,1,0,1432,412,413,1
"2a65ee6e2ac64f6a8a55fbe5373ec763","2a65ee6e2ac64f6a8a55fbe5373ec763",11405163,2,0,1,1433,413,413,0
"2a65ee6e2ac64f6a8a55fbe5373ec763","33a9d248b2e44588a5b07fc1342b9bc2",11405163,1,-2,0,1435,413,411,-2
"33a9d248b2e44588a5b07fc1342b9bc2","1fd0f6dadbc14ebc965faf6122190b96",11405163,1,5,0,1436,411,415,4
"1fd0f6dadbc14ebc965faf6122190b96","1fd0f6dadbc14ebc965faf6122190b96",11405163,1,0,1,1437,415,415,0
"1fd0f6dadbc14ebc965faf6122190b96","687055dad9fc40c3982478fe33ec01bf",11405163,1,-1,0,1438,415,414,-1
"687055dad9fc40c3982478fe33ec01bf","2add1669f08d4101913db15f8c23b3b7",11405163,1,3,0,1439,414,416,2
"2add1669f08d4101913db15f8c23b3b7","2add1669f08d4101913db15f8c23b3b7",11405163,1,0,1,1440,416,416,0
"2add1669f08d4101913db15f8c23b3b7","2b09a08242b54983aec7063990fb3f66",11405163,1,-24,0,1441,416,400,-16
"2b09a08242b54983aec7063990fb3f66","a2b4bd40cee2481ebd3fc179d6a5cd62",11405163,1,27,0,1442,400,417,17
"a2b4bd40cee2481ebd3fc179d6a5cd62","e34e59dce2204f228f3a84b6725df60f",11405163,1,2,0,1443,417,419,2
"e34e59dce2204f228f3a84b6725df60f","e34e59dce2204f228f3a84b6725df60f",11405163,1,0,1,1444,419,419,0
"e34e59dce2204f228f3a84b6725df60f","a2b4bd40cee2481ebd3fc179d6a5cd62",11405163,1,-2,0,1445,419,417,-2
"a2b4bd40cee2481ebd3fc179d6a5cd62","bec48fc2e1294c7eb3d0aca780d731b8",11405163,1,4,0,1446,417,420,3
"bec48fc2e1294c7eb3d0aca780d731b8","bec48fc2e1294c7eb3d0aca780d731b8",11405163,2,0,1,1447,420,420,0
"bec48fc2e1294c7eb3d0aca780d731b8","dbde19fcce2a4c1abdc7f685c293a23f",11405163,1,3,0,1449,420,422,2
"dbde19fcce2a4c1abdc7f685c293a23f","a24600b0e49245f6bdba8c893cfeddb0",11405163,1,4,0,1450,422,425,3
"a24600b0e49245f6bdba8c893cfeddb0","a24600b0e49245f6bdba8c893cfeddb0",11405163,2,0,1,1451,425,425,0
"a24600b0e49245f6bdba8c893cfeddb0","24cf8786024543f19b89bc20034e60d7",11405163,1,7,0,1453,425,428,3
"24cf8786024543f19b89bc20034e60d7","a2b4bd40cee2481ebd3fc179d6a5cd62",11405163,1,-18,0,1454,428,417,-11
"a2b4bd40cee2481ebd3fc179d6a5cd62","f2a73be2f46840b182d7bd095378004e",11405163,1,19,0,1455,417,429,12
"f2a73be2f46840b182d7bd095378004e","f2a73be2f46840b182d7bd095378004e",11405163,1,0,1,1456,429,429,0
"f2a73be2f46840b182d7bd095378004e","b2f0d654738f48158edff28e8d3a546e",11405163,1,34,0,1457,429,449,20
"b2f0d654738f48158edff28e8d3a546e","b2f0d654738f48158edff28e8d3a546e",11405163,1,0,1,1458,449,449,0
"b2f0d654738f48158edff28e8d3a546e","f60ee41ec635499abd48168342d32c2f",11405163,5,5,0,1459,449,453,4
"f60ee41ec635499abd48168342d32c2f","b2f0d654738f48158edff28e8d3a546e",11405163,3,-5,0,1462,453,449,-4
"f67fbf45a5f146ed866965bc57c7c001","b2f0d654738f48158edff28e8d3a546e",11405163,1,-8,0,1469,454,449,-5
"b2f0d654738f48158edff28e8d3a546e","f67fbf45a5f146ed866965bc57c7c001",11405163,2,8,0,1470,449,454,5
"f67fbf45a5f146ed866965bc57c7c001","f67fbf45a5f146ed866965bc57c7c001",11405163,2,0,1,1471,454,454,0
"f67fbf45a5f146ed866965bc57c7c001","d937afe49bd24a07a550dda1c1155122",11405163,1,1,0,1472,454,455,1
"d937afe49bd24a07a550dda1c1155122","d937afe49bd24a07a550dda1c1155122",11405163,1,0,1,1473,455,455,0
"d937afe49bd24a07a550dda1c1155122","604551fd4266430cb860fef58fa7dd61",11405163,1,-42,0,1474,455,430,-25
"604551fd4266430cb860fef58fa7dd61","604551fd4266430cb860fef58fa7dd61",11405163,1,0,1,1475,430,430,0
"604551fd4266430cb860fef58fa7dd61","3628b3f7823443d0912a339096b69943",11405163,1,43,0,1476,430,456,26
"3628b3f7823443d0912a339096b69943","3628b3f7823443d0912a339096b69943",11405163,1,0,1,1477,456,456,0
"3628b3f7823443d0912a339096b69943","9e049ee647cf43ecbcb5ed792a8e7588",11405163,1,1,0,1478,456,457,1
"9e049ee647cf43ecbcb5ed792a8e7588","9e049ee647cf43ecbcb5ed792a8e7588",11405163,1,0,1,1479,457,457,0
"9e049ee647cf43ecbcb5ed792a8e7588","5256a214faaf410b93f76cea06428334",11405163,1,1,0,1480,457,458,1
"5256a214faaf410b93f76cea06428334","5256a214faaf410b93f76cea06428334",11405163,1,0,1,1481,458,458,0
"5256a214faaf410b93f76cea06428334","25c32b120fce40fa9b6c85133aeb4716",11405163,1,1,0,1482,458,459,1
"25c32b120fce40fa9b6c85133aeb4716","25c32b120fce40fa9b6c85133aeb4716",11405163,1,0,1,1483,459,459,0
"25c32b120fce40fa9b6c85133aeb4716","11bc14f2204949008b7d511b933363c1",11405163,1,1,0,1484,459,460,1
"11bc14f2204949008b7d511b933363c1","11bc14f2204949008b7d511b933363c1",11405163,3,0,1,1485,460,460,0
"11bc14f2204949008b7d511b933363c1","42de338840a34d15adb66e7b14fb9d2c",11405163,1,1,0,1488,460,461,1
"42de338840a34d15adb66e7b14fb9d2c","42de338840a34d15adb66e7b14fb9d2c",11405163,1,0,1,1489,461,461,0
"42de338840a34d15adb66e7b14fb9d2c","9da37c6210b1416b8079c274f70bf600",11405163,1,1,0,1490,461,462,1
"9da37c6210b1416b8079c274f70bf600","9da37c6210b1416b8079c274f70bf600",11405163,3,0,1,1491,462,462,0
"9da37c6210b1416b8079c274f70bf600","519119f1deac45ff9ab4f13529be5c6e",11405163,1,1,0,1494,462,463,1
"519119f1deac45ff9ab4f13529be5c6e","519119f1deac45ff9ab4f13529be5c6e",11405163,1,0,1,1495,463,463,0
"519119f1deac45ff9ab4f13529be5c6e","c5df9f40ec14463b9dcfdc73df3e9285",11405163,1,3,0,1496,463,464,1
"c5df9f40ec14463b9dcfdc73df3e9285","f67fbf45a5f146ed866965bc57c7c001",11405163,1,-12,0,1497,464,454,-10
"f67fbf45a5f146ed866965bc57c7c001","c5df9f40ec14463b9dcfdc73df3e9285",11405163,2,12,0,1498,454,464,10
"c5df9f40ec14463b9dcfdc73df3e9285","24cf8786024543f19b89bc20034e60d7",11405163,1,-55,0,1499,464,428,-36
"24cf8786024543f19b89bc20034e60d7","dce46f8904594a62a6377a3587aaa663",11405163,1,4,0,1500,428,431,3
"dce46f8904594a62a6377a3587aaa663","c5df9f40ec14463b9dcfdc73df3e9285",11405163,1,51,0,1501,431,464,33
"c5df9f40ec14463b9dcfdc73df3e9285","83d42d95cd844fc093fc09cee250edb8",11405163,3,3,0,1502,464,465,1
"83d42d95cd844fc093fc09cee250edb8","83d42d95cd844fc093fc09cee250edb8",11405163,3,0,1,1503,465,465,0
"83d42d95cd844fc093fc09cee250edb8","dce46f8904594a62a6377a3587aaa663",11405163,1,-54,0,1504,465,431,-34
"dce46f8904594a62a6377a3587aaa663","9b9d0a249052413c869753b99682b0ac",11405163,1,1,0,1505,431,432,1
"9b9d0a249052413c869753b99682b0ac","9b9d0a249052413c869753b99682b0ac",11405163,1,0,1,1506,432,432,0
"9b9d0a249052413c869753b99682b0ac","061c175cc90f45fbad883025394e78dd",11405163,1,1,0,1507,432,433,1
"061c175cc90f45fbad883025394e78dd","061c175cc90f45fbad883025394e78dd",11405163,1,0,1,1508,433,433,0
"061c175cc90f45fbad883025394e78dd","dce46f8904594a62a6377a3587aaa663",11405163,1,-2,0,1509,433,431,-2
"dce46f8904594a62a6377a3587aaa663","74a7f8712e5449c2bc0b43c6f90dafed",11405163,1,5,0,1510,431,435,4
"74a7f8712e5449c2bc0b43c6f90dafed","74a7f8712e5449c2bc0b43c6f90dafed",11405163,1,0,1,1511,435,435,0
"74a7f8712e5449c2bc0b43c6f90dafed","66ada10dde9f43018588f1ced9d477fc",11405163,1,-1,0,1512,435,434,-1
"66ada10dde9f43018588f1ced9d477fc","bf12c96466d840a69bed7020b3f18bb8",11405163,1,3,0,1513,434,436,2
"bf12c96466d840a69bed7020b3f18bb8","bf12c96466d840a69bed7020b3f18bb8",11405163,1,0,1,1514,436,436,0
"bf12c96466d840a69bed7020b3f18bb8","24cf8786024543f19b89bc20034e60d7",11405163,1,-11,0,1515,436,428,-8
"24cf8786024543f19b89bc20034e60d7","070600601c4c439288445d2f0724807d",11405163,1,14,0,1516,428,437,9
"070600601c4c439288445d2f0724807d","1823b6de7d334a7aaabc4570719af4d9",11405163,1,2,0,1517,437,439,2
"1823b6de7d334a7aaabc4570719af4d9","1823b6de7d334a7aaabc4570719af4d9",11405163,16,0,1,1518,439,439,0
"1823b6de7d334a7aaabc4570719af4d9","0380cd76a7d44bc3a4da1f15e4d68f89",11405163,1,2,0,1534,439,440,1
"0380cd76a7d44bc3a4da1f15e4d68f89","070600601c4c439288445d2f0724807d",11405163,1,-4,0,1535,440,437,-3
"070600601c4c439288445d2f0724807d","0380cd76a7d44bc3a4da1f15e4d68f89",11405163,2,4,0,1536,437,440,3
"0380cd76a7d44bc3a4da1f15e4d68f89","0380cd76a7d44bc3a4da1f15e4d68f89",11405163,4,0,1,1537,440,440,0
"0380cd76a7d44bc3a4da1f15e4d68f89","23b7673c8b5443108c2ef09382834a86",11405163,3,2,0,1539,440,441,1
"23b7673c8b5443108c2ef09382834a86","23b7673c8b5443108c2ef09382834a86",11405163,2,0,1,1540,441,441,0
"23b7673c8b5443108c2ef09382834a86","66baf19b6b904b70922329068c63746d",11405163,1,-97,0,1541,441,376,-65
"66baf19b6b904b70922329068c63746d","070600601c4c439288445d2f0724807d",11405163,1,91,0,1542,376,437,61
"23b7673c8b5443108c2ef09382834a86","0380cd76a7d44bc3a4da1f15e4d68f89",11405163,1,-2,0,1547,441,440,-1
"23b7673c8b5443108c2ef09382834a86","901e92500aea43c79f19f1b279050668",11405163,1,2,0,1550,441,442,1
"901e92500aea43c79f19f1b279050668","901e92500aea43c79f19f1b279050668",11405163,1,0,1,1551,442,442,0
"901e92500aea43c79f19f1b279050668","001339db8ced4cf78829ebe8b145449d",11405163,1,1,0,1552,442,443,1
"001339db8ced4cf78829ebe8b145449d","001339db8ced4cf78829ebe8b145449d",11405163,11,0,1,1553,443,443,0
"001339db8ced4cf78829ebe8b145449d","452745e0366e42ae81561bfddebcc6c3",11405163,1,1,0,1564,443,444,1
"452745e0366e42ae81561bfddebcc6c3","452745e0366e42ae81561bfddebcc6c3",11405163,2,0,1,1565,444,444,0
"452745e0366e42ae81561bfddebcc6c3","901e92500aea43c79f19f1b279050668",11405163,1,-2,0,1567,444,442,-2
"901e92500aea43c79f19f1b279050668","4660ff2089114e8db82ceb26a4f329e3",11405163,1,4,0,1568,442,445,3
"4660ff2089114e8db82ceb26a4f329e3","4660ff2089114e8db82ceb26a4f329e3",11405163,2,0,1,1569,445,445,0
"4660ff2089114e8db82ceb26a4f329e3","7bd5586eb9d8484eb74a433ee7bfe499",11405163,1,2,0,1571,445,446,1
"7bd5586eb9d8484eb74a433ee7bfe499","7bd5586eb9d8484eb74a433ee7bfe499",11405163,22,0,1,1572,446,446,0
"7bd5586eb9d8484eb74a433ee7bfe499","8a7f26e690f34dda97be16904518ca99",11405163,1,2,0,1594,446,447,1
"8a7f26e690f34dda97be16904518ca99","8a7f26e690f34dda97be16904518ca99",11405163,1,0,1,1595,447,447,0
"8a7f26e690f34dda97be16904518ca99","070600601c4c439288445d2f0724807d",11405163,1,-16,0,1596,447,437,-10
"070600601c4c439288445d2f0724807d","b2f0d654738f48158edff28e8d3a546e",11405163,1,21,0,1597,437,449,12
"c5df9f40ec14463b9dcfdc73df3e9285","c5df9f40ec14463b9dcfdc73df3e9285",11405163,1,0,1,1656,464,464,0
"83d42d95cd844fc093fc09cee250edb8","c5df9f40ec14463b9dcfdc73df3e9285",11405163,1,-3,0,1658,465,464,-1
"83d42d95cd844fc093fc09cee250edb8","b2f0d654738f48158edff28e8d3a546e",11405163,1,-23,0,1661,465,449,-16
"f60ee41ec635499abd48168342d32c2f","83d42d95cd844fc093fc09cee250edb8",11405163,1,18,0,1670,453,465,12
"83d42d95cd844fc093fc09cee250edb8","66baf19b6b904b70922329068c63746d",11405163,1,-135,0,1672,465,376,-89
"66baf19b6b904b70922329068c63746d","83d42d95cd844fc093fc09cee250edb8",11405163,1,135,0,1673,376,465,89
"83d42d95cd844fc093fc09cee250edb8","7f544639412e40a9ba27f43b415362ab",11405163,1,-133,0,1674,465,378,-87
"b613861cecf84ffcab01afb23f660475","b613861cecf84ffcab01afb23f660475",4396150,6,0,1,1,1,1,0
"b613861cecf84ffcab01afb23f660475","e2911e79efc2420eac45d9f671463d4b",4396150,1,3,0,7,1,2,1
"e2911e79efc2420eac45d9f671463d4b","e2911e79efc2420eac45d9f671463d4b",4396150,2,0,1,8,2,2,0
"e2911e79efc2420eac45d9f671463d4b","519d1b8c59404d67b54e96c5c8a830b2",4396150,1,1,0,10,2,3,1
"519d1b8c59404d67b54e96c5c8a830b2","519d1b8c59404d67b54e96c5c8a830b2",4396150,1,0,1,11,3,3,0
"519d1b8c59404d67b54e96c5c8a830b2","531db53f81f646edb0cdcfe0085b03b7",4396150,1,1,0,12,3,4,1
"531db53f81f646edb0cdcfe0085b03b7","531db53f81f646edb0cdcfe0085b03b7",4396150,1,0,1,13,4,4,0
"531db53f81f646edb0cdcfe0085b03b7","4f5f94b2f95141e0a9d53a61da2276da",4396150,1,1,0,14,4,5,1
"4f5f94b2f95141e0a9d53a61da2276da","4f5f94b2f95141e0a9d53a61da2276da",4396150,1,0,1,15,5,5,0
"4f5f94b2f95141e0a9d53a61da2276da","6d541c89590949f99af293c4f2333f67",4396150,1,1,0,16,5,6,1
"6d541c89590949f99af293c4f2333f67","6d541c89590949f99af293c4f2333f67",4396150,1,0,1,17,6,6,0
"6d541c89590949f99af293c4f2333f67","dd5cf0b9fe4c4f1d8f5ff8e4c04879cb",4396150,1,1,0,18,6,7,1
"dd5cf0b9fe4c4f1d8f5ff8e4c04879cb","dd5cf0b9fe4c4f1d8f5ff8e4c04879cb",4396150,1,0,1,19,7,7,0
"dd5cf0b9fe4c4f1d8f5ff8e4c04879cb","f96261861edc426abe2248be4f0a709a",4396150,1,1,0,20,7,8,1
"f96261861edc426abe2248be4f0a709a","f96261861edc426abe2248be4f0a709a",4396150,1,0,1,21,8,8,0
"f96261861edc426abe2248be4f0a709a","66b5e16f4f75454fb5b8172079f0fa83",4396150,1,1,0,22,8,9,1
"66b5e16f4f75454fb5b8172079f0fa83","66b5e16f4f75454fb5b8172079f0fa83",4396150,1,0,1,23,9,9,0
"66b5e16f4f75454fb5b8172079f0fa83","0680571d4698477995e41842c36a54b2",4396150,1,1,0,24,9,10,1
"0680571d4698477995e41842c36a54b2","0680571d4698477995e41842c36a54b2",4396150,1,0,1,25,10,10,0
"0680571d4698477995e41842c36a54b2","9112f2bffece48e08c6d2287be204085",4396150,1,1,0,26,10,11,1
"9112f2bffece48e08c6d2287be204085","9112f2bffece48e08c6d2287be204085",4396150,1,0,1,27,11,11,0
"9112f2bffece48e08c6d2287be204085","e2911e79efc2420eac45d9f671463d4b",4396150,1,-9,0,28,11,2,-9
"e2911e79efc2420eac45d9f671463d4b","56586aa865414f538729c7f7735d2bc6",4396150,1,12,0,29,2,12,10
"56586aa865414f538729c7f7735d2bc6","56586aa865414f538729c7f7735d2bc6",4396150,3,0,1,30,12,12,0
"56586aa865414f538729c7f7735d2bc6","b7f2b31585d94eb3bf86376714aa7070",4396150,1,2,0,33,12,13,1
"b7f2b31585d94eb3bf86376714aa7070","56586aa865414f538729c7f7735d2bc6",4396150,1,-2,0,34,13,12,-1
"56586aa865414f538729c7f7735d2bc6","b7719e26494940efa49512aedd0aac79",4396150,1,17,0,35,12,20,8
"b7719e26494940efa49512aedd0aac79","a49d1bb4328949299686242fd0be5584",4396150,4,2,0,36,20,21,1
"a49d1bb4328949299686242fd0be5584","b7719e26494940efa49512aedd0aac79",4396150,4,-2,0,37,21,20,-1
"b7719e26494940efa49512aedd0aac79","b7719e26494940efa49512aedd0aac79",4396150,5,0,1,38,20,20,0
"b7719e26494940efa49512aedd0aac79","a23ae40d7a9e4ee4828cc06415a3218c",4396150,1,9,0,39,20,27,7
"a23ae40d7a9e4ee4828cc06415a3218c","d4f45188d3c84a02ba08454e6403a818",4396150,1,-4,0,40,27,24,-3
"d4f45188d3c84a02ba08454e6403a818","d4c3b003e8274e429d2fa688d73fde6d",4396150,1,-2,0,41,24,22,-2
"d4c3b003e8274e429d2fa688d73fde6d","d4c3b003e8274e429d2fa688d73fde6d",4396150,1,0,1,42,22,22,0
"d4c3b003e8274e429d2fa688d73fde6d","b613861cecf84ffcab01afb23f660475",4396150,1,-35,0,43,22,1,-21
"b613861cecf84ffcab01afb23f660475","b7719e26494940efa49512aedd0aac79",4396150,1,32,0,44,1,20,19
"b7719e26494940efa49512aedd0aac79","9afd71a5298d4333b6849dfce1b9422c",4396150,2,-4,0,50,20,18,-2
"9afd71a5298d4333b6849dfce1b9422c","b7719e26494940efa49512aedd0aac79",4396150,1,4,0,51,18,20,2
"9afd71a5298d4333b6849dfce1b9422c","9afd71a5298d4333b6849dfce1b9422c",4396150,1,0,1,53,18,18,0
"9afd71a5298d4333b6849dfce1b9422c","afbf7250b99d47bea07172749483ca97",4396150,1,16,0,54,18,28,10
"afbf7250b99d47bea07172749483ca97","4e51676dc72045d99c19b9fa7b22f8bc",4396150,1,3,0,55,28,29,1
"4e51676dc72045d99c19b9fa7b22f8bc","afbf7250b99d47bea07172749483ca97",4396150,1,-3,0,56,29,28,-1
"afbf7250b99d47bea07172749483ca97","7040a13096d746ac84b8fac8d9752058",4396150,1,18,0,57,28,36,8
"7040a13096d746ac84b8fac8d9752058","9a0dc646f934470daf08c4b56ccf73db",4396150,3,3,0,58,36,37,1
"9a0dc646f934470daf08c4b56ccf73db","7040a13096d746ac84b8fac8d9752058",4396150,1,-3,0,59,37,36,-1
"7040a13096d746ac84b8fac8d9752058","fc0e049d56024bc9a02c9a9c435c3df7",4396150,1,6,0,60,36,38,2
"fc0e049d56024bc9a02c9a9c435c3df7","9a0dc646f934470daf08c4b56ccf73db",4396150,1,-3,0,61,38,37,-1
"9a0dc646f934470daf08c4b56ccf73db","4e51676dc72045d99c19b9fa7b22f8bc",4396150,1,-18,0,62,37,29,-8
"4e51676dc72045d99c19b9fa7b22f8bc","4e51676dc72045d99c19b9fa7b22f8bc",4396150,2,0,1,63,29,29,0
"4e51676dc72045d99c19b9fa7b22f8bc","51970cfa30e643e894e66ae85c8024cc",4396150,1,3,0,65,29,31,2
"51970cfa30e643e894e66ae85c8024cc","c33c17be71ae4d588da7369472e5bb1b",4396150,1,6,0,66,31,34,3
"c33c17be71ae4d588da7369472e5bb1b","4e51676dc72045d99c19b9fa7b22f8bc",4396150,1,-9,0,67,34,29,-5
"4e51676dc72045d99c19b9fa7b22f8bc","b613861cecf84ffcab01afb23f660475",4396150,1,-47,0,68,29,1,-28
"b613861cecf84ffcab01afb23f660475","4e51676dc72045d99c19b9fa7b22f8bc",4396150,1,47,0,69,1,29,28
"4e51676dc72045d99c19b9fa7b22f8bc","c9c52446b6294aa5a9c2abaed536c37e",4396150,1,5,0,70,29,32,3
"c9c52446b6294aa5a9c2abaed536c37e","4e51676dc72045d99c19b9fa7b22f8bc",4396150,1,-5,0,71,32,29,-3
"4e51676dc72045d99c19b9fa7b22f8bc","c33c17be71ae4d588da7369472e5bb1b",4396150,1,9,0,72,29,34,5
"c33c17be71ae4d588da7369472e5bb1b","93679be414554a11b1893002f2229a93",4396150,1,3,0,73,34,35,1
"93679be414554a11b1893002f2229a93","7040a13096d746ac84b8fac8d9752058",4396150,2,3,0,76,35,36,1
"7040a13096d746ac84b8fac8d9752058","7040a13096d746ac84b8fac8d9752058",4396150,2,0,1,77,36,36,0
"9a0dc646f934470daf08c4b56ccf73db","9a0dc646f934470daf08c4b56ccf73db",4396150,2,0,1,79,37,37,0
"9a0dc646f934470daf08c4b56ccf73db","fc0e049d56024bc9a02c9a9c435c3df7",4396150,2,3,0,80,37,38,1
"fc0e049d56024bc9a02c9a9c435c3df7","93679be414554a11b1893002f2229a93",4396150,1,-9,0,81,38,35,-3
"fc0e049d56024bc9a02c9a9c435c3df7","b613861cecf84ffcab01afb23f660475",4396150,1,-68,0,93,38,1,-37
"b613861cecf84ffcab01afb23f660475","a49d1bb4328949299686242fd0be5584",4396150,1,34,0,94,1,21,20
"a49d1bb4328949299686242fd0be5584","d4c3b003e8274e429d2fa688d73fde6d",4396150,1,1,0,97,21,22,1
"d4c3b003e8274e429d2fa688d73fde6d","d4f45188d3c84a02ba08454e6403a818",4396150,1,2,0,98,22,24,2
"d4f45188d3c84a02ba08454e6403a818","d4f45188d3c84a02ba08454e6403a818",4396150,1,0,1,99,24,24,0
"d4f45188d3c84a02ba08454e6403a818","93679be414554a11b1893002f2229a93",4396150,1,22,0,100,24,35,11
"93679be414554a11b1893002f2229a93","b613861cecf84ffcab01afb23f660475",4396150,1,-59,0,101,35,1,-34
"b613861cecf84ffcab01afb23f660475","93679be414554a11b1893002f2229a93",4396150,1,59,0,102,1,35,34
"93679be414554a11b1893002f2229a93","93679be414554a11b1893002f2229a93",4396150,10,0,1,103,35,35,0
"93679be414554a11b1893002f2229a93","67a089198fcb4e1c8f2385786c2b296f",4396150,1,13,0,105,35,39,4
"67a089198fcb4e1c8f2385786c2b296f","64d48c6c9c7940639a932219a6c87198",4396150,3,1,0,106,39,40,1
"64d48c6c9c7940639a932219a6c87198","67a089198fcb4e1c8f2385786c2b296f",4396150,2,-1,0,107,40,39,-1
"67a089198fcb4e1c8f2385786c2b296f","67a089198fcb4e1c8f2385786c2b296f",4396150,2,0,1,108,39,39,0
"64d48c6c9c7940639a932219a6c87198","64d48c6c9c7940639a932219a6c87198",4396150,6,0,1,111,40,40,0
"64d48c6c9c7940639a932219a6c87198","b534b89233134e30a9b5645138bfa9ee",4396150,1,3,0,117,40,41,1
"b534b89233134e30a9b5645138bfa9ee","b534b89233134e30a9b5645138bfa9ee",4396150,2,0,1,118,41,41,0
"b534b89233134e30a9b5645138bfa9ee","0e37b720d23b4e7f8b313e79313fd107",4396150,1,3,0,119,41,44,3
"0e37b720d23b4e7f8b313e79313fd107","0e37b720d23b4e7f8b313e79313fd107",4396150,1,0,1,120,44,44,0
"0e37b720d23b4e7f8b313e79313fd107","6875d67fdd5f48168b62719df449bebd",4396150,1,1,0,121,44,45,1
"6875d67fdd5f48168b62719df449bebd","6875d67fdd5f48168b62719df449bebd",4396150,1,0,1,122,45,45,0
"6875d67fdd5f48168b62719df449bebd","6e13d61a7bdb44bca949c9f86fab3be5",4396150,1,3,0,123,45,47,2
"6e13d61a7bdb44bca949c9f86fab3be5","b534b89233134e30a9b5645138bfa9ee",4396150,2,-7,0,124,47,41,-6
"b534b89233134e30a9b5645138bfa9ee","6e13d61a7bdb44bca949c9f86fab3be5",4396150,2,7,0,125,41,47,6
"6e13d61a7bdb44bca949c9f86fab3be5","195f78799f984cc2b06c48dfe36be751",4396150,1,2,0,126,47,49,2
"195f78799f984cc2b06c48dfe36be751","195f78799f984cc2b06c48dfe36be751",4396150,2,0,1,127,49,49,0
"195f78799f984cc2b06c48dfe36be751","d0c74f735e024943943e40333d6d337f",4396150,1,3,0,129,49,51,2
"d0c74f735e024943943e40333d6d337f","d9c8d8c444a64dadbbb508652c721e17",4396150,2,-6,0,130,51,46,-5
"d9c8d8c444a64dadbbb508652c721e17","d0c74f735e024943943e40333d6d337f",4396150,2,6,0,131,46,51,5
"d0c74f735e024943943e40333d6d337f","983f8ff320594b279a7f4a6fe132f9c5",4396150,2,2,0,132,51,53,2
"983f8ff320594b279a7f4a6fe132f9c5","983f8ff320594b279a7f4a6fe132f9c5",4396150,4,0,1,133,53,53,0
"983f8ff320594b279a7f4a6fe132f9c5","35adfa5d923046aebabfefd98f35ff05",4396150,2,1,0,135,53,54,1
"35adfa5d923046aebabfefd98f35ff05","35adfa5d923046aebabfefd98f35ff05",4396150,7,0,1,136,54,54,0
"35adfa5d923046aebabfefd98f35ff05","b6f8a98476224da1b40e555ececc7ed8",4396150,2,1,0,138,54,55,1
"b6f8a98476224da1b40e555ececc7ed8","b6f8a98476224da1b40e555ececc7ed8",4396150,4,0,1,139,55,55,0
"b6f8a98476224da1b40e555ececc7ed8","86e22cb5fe0e4b47a9489ecddf7ed78f",4396150,2,1,0,141,55,56,1
"86e22cb5fe0e4b47a9489ecddf7ed78f","86e22cb5fe0e4b47a9489ecddf7ed78f",4396150,4,0,1,142,56,56,0
"86e22cb5fe0e4b47a9489ecddf7ed78f","f924752d8a1149668870b1e7698486f7",4396150,2,-6,0,144,56,50,-6
"f924752d8a1149668870b1e7698486f7","78f30e4dcac84e3cbea8b2cc6e0d62b3",4396150,3,10,0,145,50,59,9
"78f30e4dcac84e3cbea8b2cc6e0d62b3","a1f2f12debe5432fb7a70bcd12bacfb9",4396150,4,-1,0,146,59,58,-1
"a1f2f12debe5432fb7a70bcd12bacfb9","a1f2f12debe5432fb7a70bcd12bacfb9",4396150,22,0,1,147,58,58,0
"a1f2f12debe5432fb7a70bcd12bacfb9","78f30e4dcac84e3cbea8b2cc6e0d62b3",4396150,2,1,0,169,58,59,1
"78f30e4dcac84e3cbea8b2cc6e0d62b3","78f30e4dcac84e3cbea8b2cc6e0d62b3",4396150,21,0,1,170,59,59,0
"78f30e4dcac84e3cbea8b2cc6e0d62b3","12aa6e1672ac4e7aa6449a7a8609cd72",4396150,2,-2,0,181,59,57,-2
"bc42d26810654ea9a1df1efe1e58c7d5","4c943503763e4e349906eea3ed3c8e86",4396150,2,-2,0,184,63,61,-2
"4c943503763e4e349906eea3ed3c8e86","4c943503763e4e349906eea3ed3c8e86",4396150,2,0,1,185,61,61,0
"4c943503763e4e349906eea3ed3c8e86","309ccf3cc4fe429d9bfbaef53d3fa479",4396150,1,-1,0,186,61,60,-1
"d646286c8051419bbc2e31dd1db55ca8","f924752d8a1149668870b1e7698486f7",4396150,1,-22,0,189,67,50,-17
"f924752d8a1149668870b1e7698486f7","b534b89233134e30a9b5645138bfa9ee",4396150,2,-11,0,190,50,41,-9
"b534b89233134e30a9b5645138bfa9ee","f924752d8a1149668870b1e7698486f7",4396150,1,11,0,191,41,50,9
"b534b89233134e30a9b5645138bfa9ee","d0c74f735e024943943e40333d6d337f",4396150,3,12,0,193,41,51,10
"d0c74f735e024943943e40333d6d337f","d0c74f735e024943943e40333d6d337f",4396150,2,0,1,194,51,51,0
"a0a418b8540d479fa6e0f653b701da8b","12aa6e1672ac4e7aa6449a7a8609cd72",4396150,1,-8,0,215,64,57,-7
"12aa6e1672ac4e7aa6449a7a8609cd72","309ccf3cc4fe429d9bfbaef53d3fa479",4396150,1,4,0,216,57,60,3
"d646286c8051419bbc2e31dd1db55ca8","67a089198fcb4e1c8f2385786c2b296f",4396150,1,-37,0,219,67,39,-28
"67a089198fcb4e1c8f2385786c2b296f","0c7262dff33c4087bc660ccf40f92f9c",4396150,1,169,0,222,39,169,130
"b2275c3fad834f8d90737a2d9a6927d6","c8e371568a0c4391b25796ae4e91952e",4396150,1,20,0,224,172,186,14
"c8e371568a0c4391b25796ae4e91952e","c8e371568a0c4391b25796ae4e91952e",4396150,1,0,1,225,186,186,0
"c8e371568a0c4391b25796ae4e91952e","0c7262dff33c4087bc660ccf40f92f9c",4396150,2,-23,0,226,186,169,-17
"0c7262dff33c4087bc660ccf40f92f9c","c8e371568a0c4391b25796ae4e91952e",4396150,5,23,0,227,169,186,17
"c8e371568a0c4391b25796ae4e91952e","c3f63fe50d8e487c86bf8ef76c9cadd3",4396150,1,-3,0,228,186,185,-1
"c3f63fe50d8e487c86bf8ef76c9cadd3","c3f63fe50d8e487c86bf8ef76c9cadd3",4396150,1,0,1,229,185,185,0
"c3f63fe50d8e487c86bf8ef76c9cadd3","0c7262dff33c4087bc660ccf40f92f9c",4396150,1,-20,0,230,185,169,-16
"c8e371568a0c4391b25796ae4e91952e","b534b89233134e30a9b5645138bfa9ee",4396150,1,-188,0,232,186,41,-145
"d0c74f735e024943943e40333d6d337f","b534b89233134e30a9b5645138bfa9ee",4396150,1,-12,0,235,51,41,-10
"d0c74f735e024943943e40333d6d337f","f924752d8a1149668870b1e7698486f7",4396150,1,-1,0,238,51,50,-1
"a1f2f12debe5432fb7a70bcd12bacfb9","0c7262dff33c4087bc660ccf40f92f9c",4396150,1,145,0,241,58,169,111
"0c7262dff33c4087bc660ccf40f92f9c","b534b89233134e30a9b5645138bfa9ee",4396150,2,-165,0,244,169,41,-128
"b534b89233134e30a9b5645138bfa9ee","a1f2f12debe5432fb7a70bcd12bacfb9",4396150,1,20,0,245,41,58,17
"4c943503763e4e349906eea3ed3c8e86","bc42d26810654ea9a1df1efe1e58c7d5",4396150,1,2,0,262,61,63,2
"d646286c8051419bbc2e31dd1db55ca8","267f883678b24aed855fde42524975d9",4396150,1,4,0,273,67,71,4
"267f883678b24aed855fde42524975d9","267f883678b24aed855fde42524975d9",4396150,1,0,1,274,71,71,0
"267f883678b24aed855fde42524975d9","88fff56d0342490dbef9040750a20f6c",4396150,1,1,0,275,71,72,1
"88fff56d0342490dbef9040750a20f6c","88fff56d0342490dbef9040750a20f6c",4396150,1,0,1,276,72,72,0
"88fff56d0342490dbef9040750a20f6c","adb17b12b66c4a49a85fd34322f7df70",4396150,1,1,0,277,72,73,1
"adb17b12b66c4a49a85fd34322f7df70","adb17b12b66c4a49a85fd34322f7df70",4396150,1,0,1,278,73,73,0
"adb17b12b66c4a49a85fd34322f7df70","a2becd407db34b189200a32546d9d569",4396150,1,3,0,279,73,75,2
"a2becd407db34b189200a32546d9d569","a2becd407db34b189200a32546d9d569",4396150,3,0,1,282,75,75,0
"a2becd407db34b189200a32546d9d569","58c22b011d0f4c2ea6d13615edbb9eeb",4396150,1,2,0,285,75,77,2
"58c22b011d0f4c2ea6d13615edbb9eeb","58c22b011d0f4c2ea6d13615edbb9eeb",4396150,5,0,1,286,77,77,0
"58c22b011d0f4c2ea6d13615edbb9eeb","dd76e1861dc9461c830888729d091ee0",4396150,1,1,0,291,77,78,1
"dd76e1861dc9461c830888729d091ee0","dd76e1861dc9461c830888729d091ee0",4396150,5,0,1,292,78,78,0
"dd76e1861dc9461c830888729d091ee0","cd1d828f1a694b87913a7ea66c23803e",4396150,1,1,0,297,78,79,1
"cd1d828f1a694b87913a7ea66c23803e","cd1d828f1a694b87913a7ea66c23803e",4396150,2,0,1,298,79,79,0
"cd1d828f1a694b87913a7ea66c23803e","9176a3c2b4d2465fa8b0c67096c2a97e",4396150,1,1,0,300,79,80,1
"9176a3c2b4d2465fa8b0c67096c2a97e","9176a3c2b4d2465fa8b0c67096c2a97e",4396150,11,0,1,301,80,80,0
"9176a3c2b4d2465fa8b0c67096c2a97e","f8ec6445f7194e25b9101d4fbcb07a18",4396150,1,1,0,312,80,81,1
"f8ec6445f7194e25b9101d4fbcb07a18","f8ec6445f7194e25b9101d4fbcb07a18",4396150,2,0,1,313,81,81,0
"f8ec6445f7194e25b9101d4fbcb07a18","140d5b27b8574befad82c0a013b59dfa",4396150,1,-7,0,315,81,74,-7
"d18a9ea32855445f8736581f5cb119ce","f564483cbd7a407681aa2fcca518cf5f",4396150,1,4,0,317,82,85,3
"f564483cbd7a407681aa2fcca518cf5f","f564483cbd7a407681aa2fcca518cf5f",4396150,7,0,1,318,85,85,0
"f564483cbd7a407681aa2fcca518cf5f","18fd01350bd5434ca636d59a599d768a",4396150,1,1,0,325,85,86,1
"18fd01350bd5434ca636d59a599d768a","18fd01350bd5434ca636d59a599d768a",4396150,2,0,1,326,86,86,0
"18fd01350bd5434ca636d59a599d768a","6a9f0ef185fb47f0937e29daa1c71ed5",4396150,1,5,0,328,86,90,4
"6a9f0ef185fb47f0937e29daa1c71ed5","ae5ac430ea254e708a6f5deaaf7464ae",4396150,1,-7,0,329,90,84,-6
"ae5ac430ea254e708a6f5deaaf7464ae","c681290961c94c4caf23b529d1ae6b9a",4396150,1,5,0,330,84,88,4
"c681290961c94c4caf23b529d1ae6b9a","c681290961c94c4caf23b529d1ae6b9a",4396150,1,0,1,331,88,88,0
"c681290961c94c4caf23b529d1ae6b9a","6a9f0ef185fb47f0937e29daa1c71ed5",4396150,1,2,0,332,88,90,2
"6a9f0ef185fb47f0937e29daa1c71ed5","6a9f0ef185fb47f0937e29daa1c71ed5",4396150,5,0,1,333,90,90,0
"6a9f0ef185fb47f0937e29daa1c71ed5","d646286c8051419bbc2e31dd1db55ca8",4396150,2,-27,0,336,90,67,-23
"d646286c8051419bbc2e31dd1db55ca8","e20db35ced8544ddac5bc3839145e463",4396150,2,30,0,337,67,91,24
"e20db35ced8544ddac5bc3839145e463","1febb706d7a34005ae8711ed49c76e64",4396150,1,3,0,338,91,94,3
"1febb706d7a34005ae8711ed49c76e64","1febb706d7a34005ae8711ed49c76e64",4396150,2,0,1,339,94,94,0
"1febb706d7a34005ae8711ed49c76e64","8f73ba6f5a0042f2850356ac38ac6f24",4396150,1,1,0,341,94,95,1
"8f73ba6f5a0042f2850356ac38ac6f24","8f73ba6f5a0042f2850356ac38ac6f24",4396150,5,0,1,342,95,95,0
"8f73ba6f5a0042f2850356ac38ac6f24","e2260b86653c46d7b14a41fb419dbf8c",4396150,1,1,0,347,95,96,1
"e2260b86653c46d7b14a41fb419dbf8c","e2260b86653c46d7b14a41fb419dbf8c",4396150,2,0,1,348,96,96,0
"e2260b86653c46d7b14a41fb419dbf8c","35eb641ad1d845bbba54915bce75a962",4396150,1,1,0,350,96,97,1
"35eb641ad1d845bbba54915bce75a962","35eb641ad1d845bbba54915bce75a962",4396150,2,0,1,351,97,97,0
"35eb641ad1d845bbba54915bce75a962","08be90ffbeea4795a138cd42ed8db56f",4396150,1,1,0,353,97,98,1
"08be90ffbeea4795a138cd42ed8db56f","08be90ffbeea4795a138cd42ed8db56f",4396150,5,0,1,354,98,98,0
"08be90ffbeea4795a138cd42ed8db56f","3007433c8f584dcbb5ac159c1c5f2be3",4396150,1,1,0,359,98,99,1
"3007433c8f584dcbb5ac159c1c5f2be3","3007433c8f584dcbb5ac159c1c5f2be3",4396150,5,0,1,360,99,99,0
"3007433c8f584dcbb5ac159c1c5f2be3","00ae5f0c51874a73a41ebea838d95682",4396150,1,3,0,365,99,101,2
"00ae5f0c51874a73a41ebea838d95682","e20db35ced8544ddac5bc3839145e463",4396150,1,-11,0,366,101,91,-10
"e20db35ced8544ddac5bc3839145e463","d391c8b6e56a43a7b654e9dee02d904b",4396150,1,13,0,367,91,103,12
"d391c8b6e56a43a7b654e9dee02d904b","00ae5f0c51874a73a41ebea838d95682",4396150,1,-2,0,368,103,101,-2
"00ae5f0c51874a73a41ebea838d95682","00ae5f0c51874a73a41ebea838d95682",4396150,2,0,1,369,101,101,0
"00ae5f0c51874a73a41ebea838d95682","d391c8b6e56a43a7b654e9dee02d904b",4396150,2,2,0,371,101,103,2
"d391c8b6e56a43a7b654e9dee02d904b","d391c8b6e56a43a7b654e9dee02d904b",4396150,20,0,1,372,103,103,0
"d391c8b6e56a43a7b654e9dee02d904b","6111116566fc4fd9abba409322bea245",4396150,1,1,0,392,103,104,1
"6111116566fc4fd9abba409322bea245","6111116566fc4fd9abba409322bea245",4396150,5,0,1,393,104,104,0
"6111116566fc4fd9abba409322bea245","a81b2235cb9c499eb9ea8ee0a8dd9725",4396150,1,1,0,398,104,105,1
"a81b2235cb9c499eb9ea8ee0a8dd9725","a81b2235cb9c499eb9ea8ee0a8dd9725",4396150,8,0,1,399,105,105,0
"a81b2235cb9c499eb9ea8ee0a8dd9725","2d4e0ab0ef3b4d73b82c72d4621a7579",4396150,1,1,0,407,105,106,1
"2d4e0ab0ef3b4d73b82c72d4621a7579","2d4e0ab0ef3b4d73b82c72d4621a7579",4396150,2,0,1,408,106,106,0
"2d4e0ab0ef3b4d73b82c72d4621a7579","8bdebf492ebd4e62b0d522e8ab5e5197",4396150,1,1,0,410,106,107,1
"8bdebf492ebd4e62b0d522e8ab5e5197","8bdebf492ebd4e62b0d522e8ab5e5197",4396150,2,0,1,411,107,107,0
"8bdebf492ebd4e62b0d522e8ab5e5197","73039f8c1eb9409cb4caee2cf968001e",4396150,1,-7,0,413,107,100,-7
"73039f8c1eb9409cb4caee2cf968001e","4280927ec4d643238aa49c32f9e06c6c",4396150,2,10,0,414,100,109,9
"4280927ec4d643238aa49c32f9e06c6c","4280927ec4d643238aa49c32f9e06c6c",4396150,1,0,1,415,109,109,0
"4280927ec4d643238aa49c32f9e06c6c","fc44e6a5f7654430af1227838224dceb",4396150,1,2,0,416,109,111,2
"fc44e6a5f7654430af1227838224dceb","fc44e6a5f7654430af1227838224dceb",4396150,2,0,1,417,111,111,0
"fc44e6a5f7654430af1227838224dceb","08111f75e22d409998cf8b85bd431f0a",4396150,1,-3,0,419,111,108,-3
"08111f75e22d409998cf8b85bd431f0a","a9ae0a3c070d455bb4369a8996313336",4396150,1,7,0,420,108,114,6
"a9ae0a3c070d455bb4369a8996313336","a9ae0a3c070d455bb4369a8996313336",4396150,11,0,1,421,114,114,0
"a9ae0a3c070d455bb4369a8996313336","71cec822bcff4f30a20e75dc63ef7b65",4396150,1,2,0,432,114,116,2
"71cec822bcff4f30a20e75dc63ef7b65","71cec822bcff4f30a20e75dc63ef7b65",4396150,3,0,1,433,116,116,0
"71cec822bcff4f30a20e75dc63ef7b65","37319e88176d4aefa91d7a9980dbae91",4396150,1,-4,0,436,116,112,-4
"37319e88176d4aefa91d7a9980dbae91","62bff51286ef4f348717a3cf6fe2318f",4396150,1,9,0,437,112,120,8
"62bff51286ef4f348717a3cf6fe2318f","b1cd0e7dc3ad4a8eb91a4bfdbeb025b0",4396150,1,-2,0,438,120,118,-2
"b1cd0e7dc3ad4a8eb91a4bfdbeb025b0","b1cd0e7dc3ad4a8eb91a4bfdbeb025b0",4396150,1,0,1,439,118,118,0
"b1cd0e7dc3ad4a8eb91a4bfdbeb025b0","62bff51286ef4f348717a3cf6fe2318f",4396150,1,2,0,440,118,120,2
"62bff51286ef4f348717a3cf6fe2318f","62bff51286ef4f348717a3cf6fe2318f",4396150,5,0,1,441,120,120,0
"62bff51286ef4f348717a3cf6fe2318f","e20db35ced8544ddac5bc3839145e463",4396150,1,-33,0,444,120,91,-29
"e20db35ced8544ddac5bc3839145e463","779f9ddd1fd14d1e9e69f72219a1fdbd",4396150,2,36,0,445,91,121,30
"779f9ddd1fd14d1e9e69f72219a1fdbd","b37e701092c444e8a0009767edc5f622",4396150,2,1,0,446,121,122,1
"b37e701092c444e8a0009767edc5f622","779f9ddd1fd14d1e9e69f72219a1fdbd",4396150,1,-1,0,447,122,121,-1
"b37e701092c444e8a0009767edc5f622","ae26e6cda8ad4a3f81bd347560d9579f",4396150,1,3,0,449,122,125,3
"ae26e6cda8ad4a3f81bd347560d9579f","ae26e6cda8ad4a3f81bd347560d9579f",4396150,5,0,1,450,125,125,0
"ae26e6cda8ad4a3f81bd347560d9579f","ee48df95832b4374aa273ceb27ec1315",4396150,1,1,0,455,125,126,1
"ee48df95832b4374aa273ceb27ec1315","ee48df95832b4374aa273ceb27ec1315",4396150,1,0,1,456,126,126,0
"ee48df95832b4374aa273ceb27ec1315","7a439da90b394756ad1777fc4c6dead5",4396150,1,1,0,457,126,127,1
"7a439da90b394756ad1777fc4c6dead5","7a439da90b394756ad1777fc4c6dead5",4396150,3,0,1,458,127,127,0
"7a439da90b394756ad1777fc4c6dead5","a8dd5213034441ac92724b4e83eb0bb2",4396150,1,3,0,461,127,129,2
"a8dd5213034441ac92724b4e83eb0bb2","779f9ddd1fd14d1e9e69f72219a1fdbd",4396150,1,-9,0,462,129,121,-8
"779f9ddd1fd14d1e9e69f72219a1fdbd","a8dd5213034441ac92724b4e83eb0bb2",4396150,3,9,0,463,121,129,8
"a8dd5213034441ac92724b4e83eb0bb2","8115eab6556b45f5b415c3b8c26a12e5",4396150,1,2,0,464,129,131,2
"8115eab6556b45f5b415c3b8c26a12e5","8115eab6556b45f5b415c3b8c26a12e5",4396150,2,0,1,465,131,131,0
"8115eab6556b45f5b415c3b8c26a12e5","ec34b06efd844b46a4c4818ecdb9b8f4",4396150,1,1,0,467,131,132,1
"ec34b06efd844b46a4c4818ecdb9b8f4","ec34b06efd844b46a4c4818ecdb9b8f4",4396150,2,0,1,468,132,132,0
"ec34b06efd844b46a4c4818ecdb9b8f4","c2e1c2b9eac64109b343a088584b576b",4396150,1,1,0,470,132,133,1
"c2e1c2b9eac64109b343a088584b576b","c2e1c2b9eac64109b343a088584b576b",4396150,4,0,1,471,133,133,0
"c2e1c2b9eac64109b343a088584b576b","579338175e0b4bbb8ef3b712b5d8b54e",4396150,2,-5,0,473,133,128,-5
"579338175e0b4bbb8ef3b712b5d8b54e","8bc5795d6a984a3eace4e2811e52dd4f",4396150,1,8,0,474,128,135,7
"8bc5795d6a984a3eace4e2811e52dd4f","8bc5795d6a984a3eace4e2811e52dd4f",4396150,5,0,1,475,135,135,0
"8bc5795d6a984a3eace4e2811e52dd4f","b416d47c56a742199b5d7c7f19d6503a",4396150,1,-1,0,480,135,134,-1
"b416d47c56a742199b5d7c7f19d6503a","779f9ddd1fd14d1e9e69f72219a1fdbd",4396150,2,-15,0,481,134,121,-13
"779f9ddd1fd14d1e9e69f72219a1fdbd","cd4532ad48034873ba8bce2aac0c9808",4396150,1,19,0,482,121,137,16
"cd4532ad48034873ba8bce2aac0c9808","cd4532ad48034873ba8bce2aac0c9808",4396150,1,0,1,483,137,137,0
"cd4532ad48034873ba8bce2aac0c9808","779f9ddd1fd14d1e9e69f72219a1fdbd",4396150,1,-19,0,484,137,121,-16
"779f9ddd1fd14d1e9e69f72219a1fdbd","df1de691dafe4549a18a4398ee9dfaf9",4396150,2,23,0,485,121,139,18
"df1de691dafe4549a18a4398ee9dfaf9","6c5ad271a44743479bfaea29b1db8d02",4396150,2,4,0,486,139,143,4
"6c5ad271a44743479bfaea29b1db8d02","579338175e0b4bbb8ef3b712b5d8b54e",4396150,1,-19,0,487,143,128,-15
"579338175e0b4bbb8ef3b712b5d8b54e","779f9ddd1fd14d1e9e69f72219a1fdbd",4396150,1,-8,0,488,128,121,-7
"a8dd5213034441ac92724b4e83eb0bb2","a8dd5213034441ac92724b4e83eb0bb2",4396150,2,0,1,490,129,129,0
"a8dd5213034441ac92724b4e83eb0bb2","c2e1c2b9eac64109b343a088584b576b",4396150,1,4,0,491,129,133,4
"579338175e0b4bbb8ef3b712b5d8b54e","b416d47c56a742199b5d7c7f19d6503a",4396150,2,7,0,495,128,134,6
"6c5ad271a44743479bfaea29b1db8d02","67a089198fcb4e1c8f2385786c2b296f",4396150,1,-130,0,499,143,39,-104
"67a089198fcb4e1c8f2385786c2b296f","7570bc806234456aa66b290fb5c10af2",4396150,1,128,0,500,39,141,102
"7570bc806234456aa66b290fb5c10af2","df1de691dafe4549a18a4398ee9dfaf9",4396150,1,-2,0,501,141,139,-2
"df1de691dafe4549a18a4398ee9dfaf9","7570bc806234456aa66b290fb5c10af2",4396150,1,2,0,502,139,141,2
"7570bc806234456aa66b290fb5c10af2","6c5ad271a44743479bfaea29b1db8d02",4396150,1,2,0,503,141,143,2
"6c5ad271a44743479bfaea29b1db8d02","6c5ad271a44743479bfaea29b1db8d02",4396150,1,0,1,504,143,143,0
"6c5ad271a44743479bfaea29b1db8d02","83d311bed5374fee83d8d67a7d9d82dc",4396150,1,1,0,505,143,144,1
"83d311bed5374fee83d8d67a7d9d82dc","83d311bed5374fee83d8d67a7d9d82dc",4396150,1,0,1,506,144,144,0
"83d311bed5374fee83d8d67a7d9d82dc","402bba41861d43acb52a5abb89e8831e",4396150,1,1,0,507,144,145,1
"402bba41861d43acb52a5abb89e8831e","402bba41861d43acb52a5abb89e8831e",4396150,5,0,1,508,145,145,0
"402bba41861d43acb52a5abb89e8831e","8aae34f5ddbb4052a709b12e6b0d40fa",4396150,1,3,0,513,145,147,2
"8aae34f5ddbb4052a709b12e6b0d40fa","df1de691dafe4549a18a4398ee9dfaf9",4396150,2,-9,0,514,147,139,-8
"df1de691dafe4549a18a4398ee9dfaf9","78adeee1fa2c4fe0bc73f7bca9fcee86",4396150,2,26,0,515,139,160,21
"78adeee1fa2c4fe0bc73f7bca9fcee86","67a089198fcb4e1c8f2385786c2b296f",4396150,1,-152,0,516,160,39,-121
"67a089198fcb4e1c8f2385786c2b296f","3cbcea2be0984e7dbd5a48195af10ce7",4396150,1,160,0,517,39,165,126
"3cbcea2be0984e7dbd5a48195af10ce7","3cbcea2be0984e7dbd5a48195af10ce7",4396150,1,0,1,518,165,165,0
"3cbcea2be0984e7dbd5a48195af10ce7","82e6285962b8400d9d6fc32436022a94",4396150,2,2,0,519,165,167,2
"82e6285962b8400d9d6fc32436022a94","0c7262dff33c4087bc660ccf40f92f9c",4396150,1,7,0,520,167,169,2
"0c7262dff33c4087bc660ccf40f92f9c","0c7262dff33c4087bc660ccf40f92f9c",4396150,2,0,1,521,169,169,0
"c8e371568a0c4391b25796ae4e91952e","7d932b23e1c84326ae5aa4d3c0d813d1",4396150,1,2,0,523,186,188,2
"7d932b23e1c84326ae5aa4d3c0d813d1","7d932b23e1c84326ae5aa4d3c0d813d1",4396150,5,0,1,524,188,188,0
"7d932b23e1c84326ae5aa4d3c0d813d1","c8e371568a0c4391b25796ae4e91952e",4396150,1,-2,0,529,188,186,-2
"c8e371568a0c4391b25796ae4e91952e","ab11d94c6c8948ea90b88f19d2cd502b",4396150,3,5,0,530,186,190,4
"ab11d94c6c8948ea90b88f19d2cd502b","ab11d94c6c8948ea90b88f19d2cd502b",4396150,2,0,1,531,190,190,0
"ab11d94c6c8948ea90b88f19d2cd502b","f992451ed6ad4e68bb9e68ad6be7c4be",4396150,1,2,0,533,190,192,2
"f992451ed6ad4e68bb9e68ad6be7c4be","f992451ed6ad4e68bb9e68ad6be7c4be",4396150,5,0,1,534,192,192,0
"f992451ed6ad4e68bb9e68ad6be7c4be","07b44a7a51e94c78b411c753fc39dab0",4396150,1,-3,0,539,192,189,-3
"07b44a7a51e94c78b411c753fc39dab0","6cd2dcaac46847d4a0bc53f296d90375",4396150,2,6,0,540,189,194,5
"6cd2dcaac46847d4a0bc53f296d90375","6cd2dcaac46847d4a0bc53f296d90375",4396150,3,0,1,541,194,194,0
"6cd2dcaac46847d4a0bc53f296d90375","2d2580c9411c4972909db508d6956a58",4396150,1,2,0,544,194,196,2
"2d2580c9411c4972909db508d6956a58","2d2580c9411c4972909db508d6956a58",4396150,2,0,1,545,196,196,0
"2d2580c9411c4972909db508d6956a58","5bddb3d9ed264f3984702f048c7e5340",4396150,1,1,0,547,196,197,1
"5bddb3d9ed264f3984702f048c7e5340","5bddb3d9ed264f3984702f048c7e5340",4396150,2,0,1,548,197,197,0
"5bddb3d9ed264f3984702f048c7e5340","d5e8e2bd12a2466b9d6d90855f0eb079",4396150,1,1,0,550,197,198,1
"d5e8e2bd12a2466b9d6d90855f0eb079","d5e8e2bd12a2466b9d6d90855f0eb079",4396150,2,0,1,551,198,198,0
"d5e8e2bd12a2466b9d6d90855f0eb079","017d7ca8e0394b91aaadc9574df2202c",4396150,1,-5,0,553,198,193,-5
"017d7ca8e0394b91aaadc9574df2202c","54e8e9f0ea3e45c4bf3b8ac799ee31b1",4396150,1,8,0,554,193,200,7
"54e8e9f0ea3e45c4bf3b8ac799ee31b1","54e8e9f0ea3e45c4bf3b8ac799ee31b1",4396150,1,0,1,555,200,200,0
"54e8e9f0ea3e45c4bf3b8ac799ee31b1","c614a00911be4877a075f19315530fb0",4396150,1,1,0,556,200,201,1
"c614a00911be4877a075f19315530fb0","c614a00911be4877a075f19315530fb0",4396150,6,0,1,557,201,201,0
"c614a00911be4877a075f19315530fb0","a6c21bd8b95249c7972820a7a7d76aff",4396150,1,1,0,563,201,202,1
"a6c21bd8b95249c7972820a7a7d76aff","a6c21bd8b95249c7972820a7a7d76aff",4396150,1,0,1,564,202,202,0
"a6c21bd8b95249c7972820a7a7d76aff","bb329d880ab54120adaf203a693bb203",4396150,1,1,0,565,202,203,1
"bb329d880ab54120adaf203a693bb203","bb329d880ab54120adaf203a693bb203",4396150,3,0,1,566,203,203,0
"bb329d880ab54120adaf203a693bb203","f9170dd6bc6442b4acd832747609b09a",4396150,2,-4,0,568,203,199,-4
"f9170dd6bc6442b4acd832747609b09a","334c2344009840079b1d0e1b7ce3d5a7",4396150,1,7,0,569,199,205,6
"334c2344009840079b1d0e1b7ce3d5a7","334c2344009840079b1d0e1b7ce3d5a7",4396150,1,0,1,570,205,205,0
"334c2344009840079b1d0e1b7ce3d5a7","c8e371568a0c4391b25796ae4e91952e",4396150,1,-23,0,571,205,186,-19
"c8e371568a0c4391b25796ae4e91952e","d7f13c8d63ec4e2aa673fbb9cf9c6933",4396150,2,26,0,572,186,206,20
"d7f13c8d63ec4e2aa673fbb9cf9c6933","b9e80f77c3a44349863b19875725c384",4396150,2,1,0,573,206,207,1
"b9e80f77c3a44349863b19875725c384","7108f0e4c2584f1f9c471689ae4c885c",4396150,3,1,0,574,207,208,1
"7108f0e4c2584f1f9c471689ae4c885c","b9e80f77c3a44349863b19875725c384",4396150,1,-1,0,575,208,207,-1
"b9e80f77c3a44349863b19875725c384","b9e80f77c3a44349863b19875725c384",4396150,28,0,1,576,207,207,0
"7108f0e4c2584f1f9c471689ae4c885c","7108f0e4c2584f1f9c471689ae4c885c",4396150,10,0,1,605,208,208,0
"7108f0e4c2584f1f9c471689ae4c885c","d7f13c8d63ec4e2aa673fbb9cf9c6933",4396150,1,-2,0,615,208,206,-2
"d7f13c8d63ec4e2aa673fbb9cf9c6933","09400e101c5d4b439cf9a26b03aae558",4396150,3,5,0,616,206,210,4
"09400e101c5d4b439cf9a26b03aae558","09400e101c5d4b439cf9a26b03aae558",4396150,2,0,1,617,210,210,0
"09400e101c5d4b439cf9a26b03aae558","a88efa7e50ce47159810ab553afa6d3a",4396150,1,2,0,618,210,212,2
"a88efa7e50ce47159810ab553afa6d3a","a88efa7e50ce47159810ab553afa6d3a",4396150,5,0,1,619,212,212,0
"a88efa7e50ce47159810ab553afa6d3a","a875096404ef4a9984b62d74cda916f9",4396150,1,-3,0,624,212,209,-3
"a875096404ef4a9984b62d74cda916f9","be502a7a43c44bf7b682698de79d9369",4396150,2,6,0,625,209,214,5
"be502a7a43c44bf7b682698de79d9369","f7fb1952f56b4189b86a9f8b7862d2b8",4396150,3,1,0,626,214,215,1
"f7fb1952f56b4189b86a9f8b7862d2b8","be502a7a43c44bf7b682698de79d9369",4396150,1,-1,0,627,215,214,-1
"f7fb1952f56b4189b86a9f8b7862d2b8","f7fb1952f56b4189b86a9f8b7862d2b8",4396150,11,0,1,629,215,215,0
"f7fb1952f56b4189b86a9f8b7862d2b8","a9ac840f098c4bd0a2ee896214ce29cd",4396150,1,-64,0,640,215,168,-47
"b2275c3fad834f8d90737a2d9a6927d6","b7719e26494940efa49512aedd0aac79",4396150,1,-212,0,644,172,20,-152
"b7719e26494940efa49512aedd0aac79","afbf7250b99d47bea07172749483ca97",4396150,1,12,0,648,20,28,8
"afbf7250b99d47bea07172749483ca97","b7719e26494940efa49512aedd0aac79",4396150,1,-12,0,649,28,20,-8
"b7719e26494940efa49512aedd0aac79","b613861cecf84ffcab01afb23f660475",4396150,1,-32,0,650,20,1,-19
"b613861cecf84ffcab01afb23f660475","a9ac840f098c4bd0a2ee896214ce29cd",4396150,1,237,0,651,1,168,167
"b42cc17b7de840f181a704558d0bc845","b42cc17b7de840f181a704558d0bc845",4396150,3,0,1,672,175,175,0
"b42cc17b7de840f181a704558d0bc845","df1de691dafe4549a18a4398ee9dfaf9",4396150,1,-50,0,674,175,139,-36
"df1de691dafe4549a18a4398ee9dfaf9","8aae34f5ddbb4052a709b12e6b0d40fa",4396150,2,9,0,675,139,147,8
"8aae34f5ddbb4052a709b12e6b0d40fa","645b3f0249f64f76af2e19eb4d0e55b7",4396150,1,2,0,676,147,149,2
"645b3f0249f64f76af2e19eb4d0e55b7","645b3f0249f64f76af2e19eb4d0e55b7",4396150,8,0,1,677,149,149,0
"645b3f0249f64f76af2e19eb4d0e55b7","7e7b8db5064d4369805ab370aac5ddfb",4396150,1,1,0,685,149,150,1
"7e7b8db5064d4369805ab370aac5ddfb","7e7b8db5064d4369805ab370aac5ddfb",4396150,8,0,1,686,150,150,0
"7e7b8db5064d4369805ab370aac5ddfb","8956d210ae7f41968fada86d4c979d6a",4396150,1,1,0,694,150,151,1
"8956d210ae7f41968fada86d4c979d6a","8956d210ae7f41968fada86d4c979d6a",4396150,2,0,1,695,151,151,0
"8956d210ae7f41968fada86d4c979d6a","f902b0f41b544d4dbf79664fd233648d",4396150,1,-5,0,697,151,146,-5
"f902b0f41b544d4dbf79664fd233648d","ae781e8b775e4ccd93bc800dad5c8376",4396150,1,8,0,698,146,153,7
"ae781e8b775e4ccd93bc800dad5c8376","ae781e8b775e4ccd93bc800dad5c8376",4396150,2,0,1,699,153,153,0
"ae781e8b775e4ccd93bc800dad5c8376","06882a8492d9499aa31555567f575ecb",4396150,1,1,0,701,153,154,1
"06882a8492d9499aa31555567f575ecb","06882a8492d9499aa31555567f575ecb",4396150,1,0,1,702,154,154,0
"06882a8492d9499aa31555567f575ecb","f293c508f409466a8f27ddd7d1e40b20",4396150,1,1,0,703,154,155,1
"f293c508f409466a8f27ddd7d1e40b20","f293c508f409466a8f27ddd7d1e40b20",4396150,8,0,1,704,155,155,0
"f293c508f409466a8f27ddd7d1e40b20","cc4ddef5bbbe48ebb605141b347c4ed1",4396150,1,1,0,712,155,156,1
"cc4ddef5bbbe48ebb605141b347c4ed1","cc4ddef5bbbe48ebb605141b347c4ed1",4396150,5,0,1,713,156,156,0
"cc4ddef5bbbe48ebb605141b347c4ed1","f03480cf4eba413194d7af52fc0e7f28",4396150,1,-4,0,718,156,152,-4
"f03480cf4eba413194d7af52fc0e7f28","d313cec988a84645bee413e8d4724a4b",4396150,1,7,0,719,152,158,6
"d313cec988a84645bee413e8d4724a4b","dc60696c76a74368a60f72246e47700d",4396150,1,1,0,724,158,159,1
"dc60696c76a74368a60f72246e47700d","dc60696c76a74368a60f72246e47700d",4396150,3,0,1,725,159,159,0
"dc60696c76a74368a60f72246e47700d","df1de691dafe4549a18a4398ee9dfaf9",4396150,1,-23,0,728,159,139,-20
"65202579580f4ad38d734b4ee39d22a8","78adeee1fa2c4fe0bc73f7bca9fcee86",4396150,3,-5,0,734,164,160,-4
"65202579580f4ad38d734b4ee39d22a8","3cbcea2be0984e7dbd5a48195af10ce7",4396150,1,3,0,739,164,165,1
"3cbcea2be0984e7dbd5a48195af10ce7","78adeee1fa2c4fe0bc73f7bca9fcee86",4396150,1,-8,0,740,165,160,-5
"78adeee1fa2c4fe0bc73f7bca9fcee86","82e6285962b8400d9d6fc32436022a94",4396150,1,10,0,741,160,167,7
"82e6285962b8400d9d6fc32436022a94","be502a7a43c44bf7b682698de79d9369",4396150,1,66,0,742,167,214,47
"be502a7a43c44bf7b682698de79d9369","0c7262dff33c4087bc660ccf40f92f9c",4396150,1,-59,0,743,214,169,-45
"b42cc17b7de840f181a704558d0bc845","b534b89233134e30a9b5645138bfa9ee",4396150,1,-172,0,745,175,41,-134
"d646286c8051419bbc2e31dd1db55ca8","b534b89233134e30a9b5645138bfa9ee",4396150,2,-33,0,747,67,41,-26
"a2becd407db34b189200a32546d9d569","140d5b27b8574befad82c0a013b59dfa",4396150,1,-1,0,750,75,74,-1
"d18a9ea32855445f8736581f5cb119ce","ae5ac430ea254e708a6f5deaaf7464ae",4396150,1,3,0,752,82,84,2
"ae5ac430ea254e708a6f5deaaf7464ae","6a9f0ef185fb47f0937e29daa1c71ed5",4396150,1,7,0,753,84,90,6
"e20db35ced8544ddac5bc3839145e463","e20db35ced8544ddac5bc3839145e463",4396150,1,0,1,758,91,91,0
"e20db35ced8544ddac5bc3839145e463","00ae5f0c51874a73a41ebea838d95682",4396150,1,11,0,759,91,101,10
"d391c8b6e56a43a7b654e9dee02d904b","73039f8c1eb9409cb4caee2cf968001e",4396150,1,-3,0,761,103,100,-3
"4280927ec4d643238aa49c32f9e06c6c","08111f75e22d409998cf8b85bd431f0a",4396150,1,-1,0,763,109,108,-1
"08111f75e22d409998cf8b85bd431f0a","37319e88176d4aefa91d7a9980dbae91",4396150,1,5,0,764,108,112,4
"37319e88176d4aefa91d7a9980dbae91","a9ae0a3c070d455bb4369a8996313336",4396150,1,2,0,765,112,114,2
"a9ae0a3c070d455bb4369a8996313336","62bff51286ef4f348717a3cf6fe2318f",4396150,1,7,0,766,114,120,6
"62bff51286ef4f348717a3cf6fe2318f","779f9ddd1fd14d1e9e69f72219a1fdbd",4396150,1,3,0,769,120,121,1
"779f9ddd1fd14d1e9e69f72219a1fdbd","e20db35ced8544ddac5bc3839145e463",4396150,1,-36,0,770,121,91,-30
"a8dd5213034441ac92724b4e83eb0bb2","579338175e0b4bbb8ef3b712b5d8b54e",4396150,1,-1,0,774,129,128,-1
"b416d47c56a742199b5d7c7f19d6503a","df1de691dafe4549a18a4398ee9dfaf9",4396150,1,8,0,776,134,139,5
"df1de691dafe4549a18a4398ee9dfaf9","779f9ddd1fd14d1e9e69f72219a1fdbd",4396150,1,-23,0,777,139,121,-18
"779f9ddd1fd14d1e9e69f72219a1fdbd","6c5ad271a44743479bfaea29b1db8d02",4396150,1,27,0,778,121,143,22
"6c5ad271a44743479bfaea29b1db8d02","8aae34f5ddbb4052a709b12e6b0d40fa",4396150,1,5,0,779,143,147,4
"8aae34f5ddbb4052a709b12e6b0d40fa","f902b0f41b544d4dbf79664fd233648d",4396150,1,-1,0,782,147,146,-1
"f902b0f41b544d4dbf79664fd233648d","d313cec988a84645bee413e8d4724a4b",4396150,1,14,0,783,146,158,12
"d313cec988a84645bee413e8d4724a4b","f03480cf4eba413194d7af52fc0e7f28",4396150,1,-7,0,786,158,152,-6
"f03480cf4eba413194d7af52fc0e7f28","78adeee1fa2c4fe0bc73f7bca9fcee86",4396150,1,11,0,787,152,160,8
"78adeee1fa2c4fe0bc73f7bca9fcee86","df1de691dafe4549a18a4398ee9dfaf9",4396150,1,-26,0,788,160,139,-21
"df1de691dafe4549a18a4398ee9dfaf9","65202579580f4ad38d734b4ee39d22a8",4396150,1,31,0,789,139,164,25
"78adeee1fa2c4fe0bc73f7bca9fcee86","3cbcea2be0984e7dbd5a48195af10ce7",4396150,1,8,0,799,160,165,5
"82e6285962b8400d9d6fc32436022a94","3cbcea2be0984e7dbd5a48195af10ce7",4396150,1,-2,0,801,167,165,-2
"3cbcea2be0984e7dbd5a48195af10ce7","a9ac840f098c4bd0a2ee896214ce29cd",4396150,1,5,0,802,165,168,3
"b2275c3fad834f8d90737a2d9a6927d6","362fcb0699a14845ab29b2340093e528",4396150,1,3,0,806,172,174,2
"362fcb0699a14845ab29b2340093e528","0c7262dff33c4087bc660ccf40f92f9c",4396150,1,-6,0,807,174,169,-5
"b42cc17b7de840f181a704558d0bc845","801f9e9135034f49bf5f8b4bdefedb41",4396150,1,2,0,810,175,177,2
"801f9e9135034f49bf5f8b4bdefedb41","801f9e9135034f49bf5f8b4bdefedb41",4396150,12,0,1,811,177,177,0
"801f9e9135034f49bf5f8b4bdefedb41","ea38cc0e6e6e41edbabf210220808bf9",4396150,1,3,0,823,177,179,2
"ea38cc0e6e6e41edbabf210220808bf9","362fcb0699a14845ab29b2340093e528",4396150,1,-6,0,824,179,174,-5
"362fcb0699a14845ab29b2340093e528","b87c552dd247427abe6ab5795b9c9d43",4396150,1,8,0,825,174,181,7
"b87c552dd247427abe6ab5795b9c9d43","ea38cc0e6e6e41edbabf210220808bf9",4396150,1,-2,0,826,181,179,-2
"ea38cc0e6e6e41edbabf210220808bf9","b87c552dd247427abe6ab5795b9c9d43",4396150,1,2,0,827,179,181,2
"b87c552dd247427abe6ab5795b9c9d43","b87c552dd247427abe6ab5795b9c9d43",4396150,11,0,1,828,181,181,0
"b87c552dd247427abe6ab5795b9c9d43","139b097acfca451689d80c9c6eebdf7b",4396150,1,-3,0,839,181,178,-3
"139b097acfca451689d80c9c6eebdf7b","30f660a1feb34582a739722532524f79",4396150,1,6,0,840,178,183,5
"30f660a1feb34582a739722532524f79","30f660a1feb34582a739722532524f79",4396150,9,0,1,841,183,183,0
"30f660a1feb34582a739722532524f79","2024b4885bd14338a39b7b509acbbd02",4396150,1,-1,0,850,183,182,-1
"2024b4885bd14338a39b7b509acbbd02","0c7262dff33c4087bc660ccf40f92f9c",4396150,1,-16,0,851,182,169,-13
"ab11d94c6c8948ea90b88f19d2cd502b","c8e371568a0c4391b25796ae4e91952e",4396150,1,-5,0,854,190,186,-4
"ab11d94c6c8948ea90b88f19d2cd502b","07b44a7a51e94c78b411c753fc39dab0",4396150,1,-1,0,856,190,189,-1
"6cd2dcaac46847d4a0bc53f296d90375","017d7ca8e0394b91aaadc9574df2202c",4396150,1,-1,0,858,194,193,-1
"017d7ca8e0394b91aaadc9574df2202c","bb329d880ab54120adaf203a693bb203",4396150,1,11,0,859,193,203,10
"f9170dd6bc6442b4acd832747609b09a","c8e371568a0c4391b25796ae4e91952e",4396150,1,-16,0,862,199,186,-13
"7108f0e4c2584f1f9c471689ae4c885c","09400e101c5d4b439cf9a26b03aae558",4396150,1,3,0,866,208,210,2
"09400e101c5d4b439cf9a26b03aae558","d7f13c8d63ec4e2aa673fbb9cf9c6933",4396150,1,-5,0,867,210,206,-4
"09400e101c5d4b439cf9a26b03aae558","be502a7a43c44bf7b682698de79d9369",4396150,1,5,0,869,210,214,4
"be502a7a43c44bf7b682698de79d9369","a875096404ef4a9984b62d74cda916f9",4396150,1,-6,0,870,214,209,-5
"a875096404ef4a9984b62d74cda916f9","f7fb1952f56b4189b86a9f8b7862d2b8",4396150,1,7,0,871,209,215,6
"f7fb1952f56b4189b86a9f8b7862d2b8","ec341f459285443b8361f7f15638ff08",4396150,1,-2,0,872,215,213,-2
"ec341f459285443b8361f7f15638ff08","363837c182e04711840d896ae1e0339c",4396150,2,6,0,873,213,218,5
"363837c182e04711840d896ae1e0339c","01b2051f8941460d89945e3b02d1ce78",4396150,2,-1,0,874,218,217,-1
"01b2051f8941460d89945e3b02d1ce78","1c6721b1f63f4d30ba7746ea8af02a52",4396150,1,7,0,875,217,221,4
"1c6721b1f63f4d30ba7746ea8af02a52","d7f13c8d63ec4e2aa673fbb9cf9c6933",4396150,1,-21,0,876,221,206,-15
"d7f13c8d63ec4e2aa673fbb9cf9c6933","77ecef8eff6b4a2caea7707669bf7475",4396150,1,22,0,877,206,222,16
"77ecef8eff6b4a2caea7707669bf7475","0c7262dff33c4087bc660ccf40f92f9c",4396150,1,-71,0,878,222,169,-53
"7af822066add4e7f8e007e4eee31a8bf","b534b89233134e30a9b5645138bfa9ee",4396150,1,-29,0,882,65,41,-24
"6e13d61a7bdb44bca949c9f86fab3be5","d0c74f735e024943943e40333d6d337f",4396150,1,5,0,884,47,51,4
"d9c8d8c444a64dadbbb508652c721e17","78f30e4dcac84e3cbea8b2cc6e0d62b3",4396150,1,15,0,886,46,59,13
"a1f2f12debe5432fb7a70bcd12bacfb9","f924752d8a1149668870b1e7698486f7",4396150,1,-9,0,888,58,50,-8
"f924752d8a1149668870b1e7698486f7","12aa6e1672ac4e7aa6449a7a8609cd72",4396150,1,8,0,889,50,57,7
"bc42d26810654ea9a1df1efe1e58c7d5","309ccf3cc4fe429d9bfbaef53d3fa479",4396150,1,-3,0,896,63,60,-3
"309ccf3cc4fe429d9bfbaef53d3fa479","d646286c8051419bbc2e31dd1db55ca8",4396150,1,10,0,897,60,67,7
"b534b89233134e30a9b5645138bfa9ee","a875096404ef4a9984b62d74cda916f9",4396150,1,218,0,899,41,209,168
"a875096404ef4a9984b62d74cda916f9","d7f13c8d63ec4e2aa673fbb9cf9c6933",4396150,1,-4,0,900,209,206,-3
"09400e101c5d4b439cf9a26b03aae558","a875096404ef4a9984b62d74cda916f9",4396150,1,-1,0,903,210,209,-1
"f7fb1952f56b4189b86a9f8b7862d2b8","b860ee85d8bc4a2f97958cfb71be3533",4396150,1,1,0,906,215,216,1
"b860ee85d8bc4a2f97958cfb71be3533","b860ee85d8bc4a2f97958cfb71be3533",4396150,5,0,1,907,216,216,0
"b860ee85d8bc4a2f97958cfb71be3533","ec341f459285443b8361f7f15638ff08",4396150,1,-3,0,912,216,213,-3
"363837c182e04711840d896ae1e0339c","363837c182e04711840d896ae1e0339c",4396150,28,0,1,914,218,218,0
"01b2051f8941460d89945e3b02d1ce78","91125ca626c5470eb145501f8c37f8db",4396150,1,4,0,943,217,220,3
"91125ca626c5470eb145501f8c37f8db","91125ca626c5470eb145501f8c37f8db",4396150,2,0,1,944,220,220,0
"91125ca626c5470eb145501f8c37f8db","d7f13c8d63ec4e2aa673fbb9cf9c6933",4396150,1,-18,0,946,220,206,-14
"77ecef8eff6b4a2caea7707669bf7475","77ecef8eff6b4a2caea7707669bf7475",4396150,13,0,1,949,222,222,0
"77ecef8eff6b4a2caea7707669bf7475","8b9ae98743bd4d4a8a87dff1c1244211",4396150,1,6,0,962,222,227,5
"8b9ae98743bd4d4a8a87dff1c1244211","d03cb855c70044cf8c35d9ec0de696e3",4396150,1,-3,0,963,227,224,-3
"d03cb855c70044cf8c35d9ec0de696e3","1c6721b1f63f4d30ba7746ea8af02a52",4396150,1,-4,0,964,224,221,-3
"d03cb855c70044cf8c35d9ec0de696e3","a49a937d6896486d9a5396654abcf2e1",4396150,1,2,0,966,224,226,2
"a49a937d6896486d9a5396654abcf2e1","a49a937d6896486d9a5396654abcf2e1",4396150,5,0,1,967,226,226,0
"a49a937d6896486d9a5396654abcf2e1","8b9ae98743bd4d4a8a87dff1c1244211",4396150,1,1,0,972,226,227,1
"2ab1535aac1346ba8801535bf729ef37","a4f40fb48a8542c8949bae1f002cd9bc",4396150,1,2,0,993,229,231,2
"a4f40fb48a8542c8949bae1f002cd9bc","a4f40fb48a8542c8949bae1f002cd9bc",4396150,5,0,1,994,231,231,0
"a4f40fb48a8542c8949bae1f002cd9bc","8972c23e32044edb8a78fa1eed4e5947",4396150,1,1,0,999,231,232,1
"8972c23e32044edb8a78fa1eed4e5947","8972c23e32044edb8a78fa1eed4e5947",4396150,3,0,1,1000,232,232,0
"8972c23e32044edb8a78fa1eed4e5947","92feb4a40f8344d38b6f722e42a53295",4396150,1,1,0,1003,232,233,1
"92feb4a40f8344d38b6f722e42a53295","92feb4a40f8344d38b6f722e42a53295",4396150,2,0,1,1004,233,233,0
"92feb4a40f8344d38b6f722e42a53295","5152833676bf4c6cb317060be10f68db",4396150,1,-5,0,1006,233,228,-5
"5152833676bf4c6cb317060be10f68db","ca3e28f290354c08aefe5b0f769604e6",4396150,1,8,0,1007,228,235,7
"ca3e28f290354c08aefe5b0f769604e6","ca3e28f290354c08aefe5b0f769604e6",4396150,14,0,1,1008,235,235,0
"ca3e28f290354c08aefe5b0f769604e6","79a35eea833e4c2c9d22fc53c3c6445c",4396150,1,1,0,1022,235,236,1
"79a35eea833e4c2c9d22fc53c3c6445c","79a35eea833e4c2c9d22fc53c3c6445c",4396150,9,0,1,1023,236,236,0
"79a35eea833e4c2c9d22fc53c3c6445c","cab89fa5c3ed45a5aa550fc0352d6a42",4396150,1,2,0,1032,236,238,2
"cab89fa5c3ed45a5aa550fc0352d6a42","cab89fa5c3ed45a5aa550fc0352d6a42",4396150,3,0,1,1033,238,238,0
"cab89fa5c3ed45a5aa550fc0352d6a42","66d4fad4f1cf4b46be0750a99ad7a35a",4396150,1,1,0,1036,238,239,1
"66d4fad4f1cf4b46be0750a99ad7a35a","66d4fad4f1cf4b46be0750a99ad7a35a",4396150,1,0,1,1037,239,239,0
"66d4fad4f1cf4b46be0750a99ad7a35a","0b04c8e2f86d48c7aeb7e225819cd32b",4396150,1,-5,0,1038,239,234,-5
"0b04c8e2f86d48c7aeb7e225819cd32b","2ae94c0cea4d480a9d5dca8fb1d7b542",4396150,1,11,0,1039,234,242,8
"2ae94c0cea4d480a9d5dca8fb1d7b542","1c6721b1f63f4d30ba7746ea8af02a52",4396150,1,-27,0,1040,242,221,-21
"1c6721b1f63f4d30ba7746ea8af02a52","1ebf23f9d994469a85206e4c7b1bf5f5",4396150,1,30,0,1041,221,245,24
"1ebf23f9d994469a85206e4c7b1bf5f5","1ebf23f9d994469a85206e4c7b1bf5f5",4396150,13,0,1,1042,245,245,0
"1ebf23f9d994469a85206e4c7b1bf5f5","85ae675b83e8422da842cfd25596af99",4396150,1,1,0,1055,245,246,1
"85ae675b83e8422da842cfd25596af99","85ae675b83e8422da842cfd25596af99",4396150,3,0,1,1056,246,246,0
"85ae675b83e8422da842cfd25596af99","2ae94c0cea4d480a9d5dca8fb1d7b542",4396150,1,-4,0,1059,246,242,-4
"2ae94c0cea4d480a9d5dca8fb1d7b542","30c9ba177afc49a695625d2bdec40207",4396150,1,9,0,1060,242,250,8
"30c9ba177afc49a695625d2bdec40207","30c9ba177afc49a695625d2bdec40207",4396150,2,0,1,1061,250,250,0
"30c9ba177afc49a695625d2bdec40207","00f61990949545828dd12f1303d47504",4396150,1,8,0,1063,250,256,6
"00f61990949545828dd12f1303d47504","6e83e23f56544a19b94067c1c558d9c0",4396150,1,-11,0,1064,256,247,-9
"6e83e23f56544a19b94067c1c558d9c0","00f61990949545828dd12f1303d47504",4396150,1,11,0,1065,247,256,9
"00f61990949545828dd12f1303d47504","ead7bb4b64e247d2ae632ab8a296b091",4396150,1,2,0,1066,256,258,2
"ead7bb4b64e247d2ae632ab8a296b091","ead7bb4b64e247d2ae632ab8a296b091",4396150,2,0,1,1067,258,258,0
"ead7bb4b64e247d2ae632ab8a296b091","41b0048dde734bb280bac6116baa8e27",4396150,1,1,0,1069,258,259,1
"41b0048dde734bb280bac6116baa8e27","41b0048dde734bb280bac6116baa8e27",4396150,2,0,1,1070,259,259,0
"41b0048dde734bb280bac6116baa8e27","b41c5a094a604ee0915327da5cc0beb7",4396150,1,1,0,1072,259,260,1
"b41c5a094a604ee0915327da5cc0beb7","b41c5a094a604ee0915327da5cc0beb7",4396150,2,0,1,1073,260,260,0
"b41c5a094a604ee0915327da5cc0beb7","d546341988904f069cfa86b21457d9d9",4396150,1,-10,0,1075,260,251,-9
"d546341988904f069cfa86b21457d9d9","28c171777c52431ab6b925073bd63d46",4396150,1,15,0,1076,251,264,13
"28c171777c52431ab6b925073bd63d46","28c171777c52431ab6b925073bd63d46",4396150,7,0,1,1077,264,264,0
"28c171777c52431ab6b925073bd63d46","ac160db940cb49ae8579162b1d52bb5d",4396150,1,2,0,1084,264,266,2
"ac160db940cb49ae8579162b1d52bb5d","ac160db940cb49ae8579162b1d52bb5d",4396150,7,0,1,1085,266,266,0
"ac160db940cb49ae8579162b1d52bb5d","d989ebcfc12a4b669f0100dc1aa14f1e",4396150,1,-12,0,1092,266,255,-11
"d989ebcfc12a4b669f0100dc1aa14f1e","c6fd49b485cc4874b0bbdd9c6171e09c",4396150,1,15,0,1093,255,268,13
"c6fd49b485cc4874b0bbdd9c6171e09c","c6fd49b485cc4874b0bbdd9c6171e09c",4396150,10,0,1,1094,268,268,0
"c6fd49b485cc4874b0bbdd9c6171e09c","44240778a97c4af0937817499b75707b",4396150,2,1,0,1101,268,269,1
"44240778a97c4af0937817499b75707b","44240778a97c4af0937817499b75707b",4396150,4,0,1,1102,269,269,0
"44240778a97c4af0937817499b75707b","c6fd49b485cc4874b0bbdd9c6171e09c",4396150,1,-1,0,1104,269,268,-1
"44240778a97c4af0937817499b75707b","7aa76d3e993840d8805f097cbdbcd44b",4396150,1,-9,0,1111,269,261,-8
"7aa76d3e993840d8805f097cbdbcd44b","865a4d3b43374da7944dc7d397f566d9",4396150,1,12,0,1112,261,271,10
"865a4d3b43374da7944dc7d397f566d9","865a4d3b43374da7944dc7d397f566d9",4396150,1,0,1,1113,271,271,0
"865a4d3b43374da7944dc7d397f566d9","2ae94c0cea4d480a9d5dca8fb1d7b542",4396150,1,-35,0,1114,271,242,-29
"2ae94c0cea4d480a9d5dca8fb1d7b542","0d987bed3ffa4ed0b9a2e62e97b7b30f",4396150,1,38,0,1115,242,272,30
"0d987bed3ffa4ed0b9a2e62e97b7b30f","0d987bed3ffa4ed0b9a2e62e97b7b30f",4396150,1,0,1,1116,272,272,0
"0d987bed3ffa4ed0b9a2e62e97b7b30f","82ae07bc0c9b4570a41799290d1ef399",4396150,1,4,0,1117,272,275,3
"82ae07bc0c9b4570a41799290d1ef399","bb5a47f5ea01454a8b79455422d3b9da",4396150,1,6,0,1118,275,280,5
"bb5a47f5ea01454a8b79455422d3b9da","bb5a47f5ea01454a8b79455422d3b9da",4396150,7,0,1,1119,280,280,0
"bb5a47f5ea01454a8b79455422d3b9da","0d987bed3ffa4ed0b9a2e62e97b7b30f",4396150,1,-10,0,1126,280,272,-8
"0d987bed3ffa4ed0b9a2e62e97b7b30f","94cecc3f1e7d484b8e068e79241dfd73",4396150,1,13,0,1127,272,281,9
"94cecc3f1e7d484b8e068e79241dfd73","a37477c4e4c14169ad44b06b493007f6",4396150,1,2,0,1128,281,283,2
"a37477c4e4c14169ad44b06b493007f6","4a29443515bb404cb8924e1c60a63b73",4396150,1,7,0,1129,283,285,2
"4a29443515bb404cb8924e1c60a63b73","208c9b2796c944db8dacaa96082520ea",4396150,2,3,0,1130,285,288,3
"208c9b2796c944db8dacaa96082520ea","208c9b2796c944db8dacaa96082520ea",4396150,2,0,1,1131,288,288,0
"208c9b2796c944db8dacaa96082520ea","4a29443515bb404cb8924e1c60a63b73",4396150,3,-3,0,1132,288,285,-3
"4a29443515bb404cb8924e1c60a63b73","df1de691dafe4549a18a4398ee9dfaf9",4396150,1,-200,0,1133,285,139,-146
"df1de691dafe4549a18a4398ee9dfaf9","d313cec988a84645bee413e8d4724a4b",4396150,2,22,0,1134,139,158,19
"d313cec988a84645bee413e8d4724a4b","d313cec988a84645bee413e8d4724a4b",4396150,10,0,1,1135,158,158,0
"d313cec988a84645bee413e8d4724a4b","4a29443515bb404cb8924e1c60a63b73",4396150,1,178,0,1137,158,285,127
"4a29443515bb404cb8924e1c60a63b73","4a29443515bb404cb8924e1c60a63b73",4396150,2,0,1,1138,285,285,0
"4a29443515bb404cb8924e1c60a63b73","7669a956527947d0add87455277e80b4",4396150,2,7,0,1142,285,291,6
"7669a956527947d0add87455277e80b4","7669a956527947d0add87455277e80b4",4396150,1,0,1,1143,291,291,0
"7669a956527947d0add87455277e80b4","6a9a3b5bde4a48daa896fe8c06eca56f",4396150,1,-2,0,1144,291,289,-2
"6a9a3b5bde4a48daa896fe8c06eca56f","208c9b2796c944db8dacaa96082520ea",4396150,1,-2,0,1145,289,288,-1
"7669a956527947d0add87455277e80b4","869e967078f04da18dd0b0b9389a7424",4396150,1,3,0,1148,291,293,2
"869e967078f04da18dd0b0b9389a7424","6a9a3b5bde4a48daa896fe8c06eca56f",4396150,1,-5,0,1149,293,289,-4
"6a9a3b5bde4a48daa896fe8c06eca56f","869e967078f04da18dd0b0b9389a7424",4396150,1,5,0,1150,289,293,4
"869e967078f04da18dd0b0b9389a7424","869e967078f04da18dd0b0b9389a7424",4396150,4,0,1,1151,293,293,0
"869e967078f04da18dd0b0b9389a7424","51ab6291537748fab90d519aa09889d6",4396150,1,2,0,1155,293,295,2
"51ab6291537748fab90d519aa09889d6","51ab6291537748fab90d519aa09889d6",4396150,11,0,1,1156,295,295,0
"51ab6291537748fab90d519aa09889d6","34a6e49023fc4465bd5ca604330bbd1c",4396150,1,-3,0,1167,295,292,-3
"34a6e49023fc4465bd5ca604330bbd1c","ba0e59461bfb4a44b7b1c28a01f8d3b3",4396150,1,9,0,1168,292,299,7
"ba0e59461bfb4a44b7b1c28a01f8d3b3","21592f2a9e9c4b2f8c66ec5dbcbf6a2b",4396150,1,-4,0,1169,299,296,-3
"21592f2a9e9c4b2f8c66ec5dbcbf6a2b","ba0e59461bfb4a44b7b1c28a01f8d3b3",4396150,1,4,0,1170,296,299,3
"ba0e59461bfb4a44b7b1c28a01f8d3b3","ba0e59461bfb4a44b7b1c28a01f8d3b3",4396150,1,0,1,1171,299,299,0
"ba0e59461bfb4a44b7b1c28a01f8d3b3","0e0b36e731a645e7b1b8a88f5031ca38",4396150,1,2,0,1172,299,301,2
"0e0b36e731a645e7b1b8a88f5031ca38","0e0b36e731a645e7b1b8a88f5031ca38",4396150,5,0,1,1173,301,301,0
"0e0b36e731a645e7b1b8a88f5031ca38","a66a144637284c21afc6de17fea4bfb8",4396150,1,1,0,1178,301,302,1
"a66a144637284c21afc6de17fea4bfb8","a66a144637284c21afc6de17fea4bfb8",4396150,2,0,1,1179,302,302,0
"a66a144637284c21afc6de17fea4bfb8","7646a919d7e64fa990bca9b024ff089d",4396150,1,-4,0,1181,302,298,-4
"7646a919d7e64fa990bca9b024ff089d","df1de691dafe4549a18a4398ee9dfaf9",4396150,1,-217,0,1182,298,139,-159
"d313cec988a84645bee413e8d4724a4b","3434c10e561d488a914e0f7d71907abd",4396150,1,205,0,1186,158,305,147
"3434c10e561d488a914e0f7d71907abd","3434c10e561d488a914e0f7d71907abd",4396150,1,0,1,1187,305,305,0
"3434c10e561d488a914e0f7d71907abd","53e7e900392747ccad52e711ab0f80d8",4396150,4,2,0,1188,305,307,2
"53e7e900392747ccad52e711ab0f80d8","53e7e900392747ccad52e711ab0f80d8",4396150,3,0,1,1189,307,307,0
"53e7e900392747ccad52e711ab0f80d8","130acc2aeb0448fdbb2de63bc5cebe5b",4396150,1,3,0,1192,307,309,2
"130acc2aeb0448fdbb2de63bc5cebe5b","3434c10e561d488a914e0f7d71907abd",4396150,1,-5,0,1193,309,305,-4
"3434c10e561d488a914e0f7d71907abd","130acc2aeb0448fdbb2de63bc5cebe5b",4396150,4,5,0,1194,305,309,4
"130acc2aeb0448fdbb2de63bc5cebe5b","130acc2aeb0448fdbb2de63bc5cebe5b",4396150,3,0,1,1195,309,309,0
"130acc2aeb0448fdbb2de63bc5cebe5b","9c062b3251034ebe90f5054e2a3b5120",4396150,1,2,0,1198,309,311,2
"9c062b3251034ebe90f5054e2a3b5120","9c062b3251034ebe90f5054e2a3b5120",4396150,2,0,1,1199,311,311,0
"9c062b3251034ebe90f5054e2a3b5120","ea859f8207e44537889daeaba13ac2e8",4396150,1,1,0,1201,311,312,1
"ea859f8207e44537889daeaba13ac2e8","ea859f8207e44537889daeaba13ac2e8",4396150,1,0,1,1202,312,312,0
"ea859f8207e44537889daeaba13ac2e8","56d94971a7a94257aa330183a8ebd0ea",4396150,1,1,0,1203,312,313,1
"56d94971a7a94257aa330183a8ebd0ea","56d94971a7a94257aa330183a8ebd0ea",4396150,4,0,1,1204,313,313,0
"56d94971a7a94257aa330183a8ebd0ea","141c0df6cd1946539aadd1c9b7068cd4",4396150,1,-5,0,1208,313,308,-5
"141c0df6cd1946539aadd1c9b7068cd4","13255e63e0aa4abf85e5211bf613d43e",4396150,1,10,0,1209,308,317,9
"13255e63e0aa4abf85e5211bf613d43e","13255e63e0aa4abf85e5211bf613d43e",4396150,1,0,1,1210,317,317,0
"13255e63e0aa4abf85e5211bf613d43e","0c787d16c9504873b1a4d903cec09948",4396150,1,-3,0,1211,317,314,-3
"0c787d16c9504873b1a4d903cec09948","86c27d40179e419c8e9d150fb6afa5d0",4396150,2,6,0,1212,314,319,5
"86c27d40179e419c8e9d150fb6afa5d0","3434c10e561d488a914e0f7d71907abd",4396150,1,-17,0,1213,319,305,-14
"3434c10e561d488a914e0f7d71907abd","86c27d40179e419c8e9d150fb6afa5d0",4396150,1,17,0,1214,305,319,14
"86c27d40179e419c8e9d150fb6afa5d0","86c27d40179e419c8e9d150fb6afa5d0",4396150,3,0,1,1215,319,319,0
"86c27d40179e419c8e9d150fb6afa5d0","24f1363179ad4aaa965484a78471912b",4396150,1,5,0,1217,319,323,4
"24f1363179ad4aaa965484a78471912b","47edbb64109243e6b0f8f64cdef90c6c",4396150,3,3,0,1218,323,326,3
"47edbb64109243e6b0f8f64cdef90c6c","8d7e0b55cf9849cda222a0f2440cec55",4396150,3,-9,0,1219,326,318,-8
"8d7e0b55cf9849cda222a0f2440cec55","24f1363179ad4aaa965484a78471912b",4396150,3,6,0,1220,318,323,5
"24f1363179ad4aaa965484a78471912b","3628bdce1dd2429ba924d2d4d09448d2",4396150,3,-1,0,1221,323,322,-1
"3628bdce1dd2429ba924d2d4d09448d2","47edbb64109243e6b0f8f64cdef90c6c",4396150,1,4,0,1222,322,326,4
"47edbb64109243e6b0f8f64cdef90c6c","43ea1b823a4b4e51b7c694c10725db82",4396150,1,2,0,1223,326,327,1
"43ea1b823a4b4e51b7c694c10725db82","24f1363179ad4aaa965484a78471912b",4396150,1,-5,0,1224,327,323,-4
"3628bdce1dd2429ba924d2d4d09448d2","3434c10e561d488a914e0f7d71907abd",4396150,2,-21,0,1226,322,305,-17
"3434c10e561d488a914e0f7d71907abd","0c4079457ede49e3aeb5e86ed84bdf35",4396150,3,31,0,1227,305,329,24
"0c4079457ede49e3aeb5e86ed84bdf35","0c4079457ede49e3aeb5e86ed84bdf35",4396150,1,0,1,1228,329,329,0
"0c4079457ede49e3aeb5e86ed84bdf35","3434c10e561d488a914e0f7d71907abd",4396150,2,-31,0,1229,329,305,-24
"3434c10e561d488a914e0f7d71907abd","38aea304b4fa46e1b29bb72f5cea4c93",4396150,2,33,0,1230,305,331,26
"38aea304b4fa46e1b29bb72f5cea4c93","4a29443515bb404cb8924e1c60a63b73",4396150,1,-60,0,1231,331,285,-46
"4a29443515bb404cb8924e1c60a63b73","e390b575229748ea8aac9364efe2bf00",4396150,1,24,0,1232,285,304,19
"e390b575229748ea8aac9364efe2bf00","e390b575229748ea8aac9364efe2bf00",4396150,1,0,1,1233,304,304,0
"e390b575229748ea8aac9364efe2bf00","4a29443515bb404cb8924e1c60a63b73",4396150,1,-24,0,1234,304,285,-19
"4a29443515bb404cb8924e1c60a63b73","3434c10e561d488a914e0f7d71907abd",4396150,4,27,0,1235,285,305,20
"53e7e900392747ccad52e711ab0f80d8","4a29443515bb404cb8924e1c60a63b73",4396150,2,-29,0,1237,307,285,-22
"3434c10e561d488a914e0f7d71907abd","4a29443515bb404cb8924e1c60a63b73",4396150,2,-27,0,1239,305,285,-20
"4a29443515bb404cb8924e1c60a63b73","53e7e900392747ccad52e711ab0f80d8",4396150,2,29,0,1240,285,307,22
"53e7e900392747ccad52e711ab0f80d8","3434c10e561d488a914e0f7d71907abd",4396150,3,-2,0,1241,307,305,-2
"130acc2aeb0448fdbb2de63bc5cebe5b","141c0df6cd1946539aadd1c9b7068cd4",4396150,4,-1,0,1243,309,308,-1
"141c0df6cd1946539aadd1c9b7068cd4","86c27d40179e419c8e9d150fb6afa5d0",4396150,3,13,0,1244,308,319,11
"86c27d40179e419c8e9d150fb6afa5d0","0c787d16c9504873b1a4d903cec09948",4396150,3,-6,0,1245,319,314,-5
"0c787d16c9504873b1a4d903cec09948","47edbb64109243e6b0f8f64cdef90c6c",4396150,1,14,0,1246,314,326,12
"3628bdce1dd2429ba924d2d4d09448d2","56b3fd1a212a4764be39d979fde3326e",4396150,1,7,0,1250,322,328,6
"56b3fd1a212a4764be39d979fde3326e","56b3fd1a212a4764be39d979fde3326e",4396150,1,0,1,1251,328,328,0
"56b3fd1a212a4764be39d979fde3326e","3434c10e561d488a914e0f7d71907abd",4396150,1,-28,0,1252,328,305,-23
"0c4079457ede49e3aeb5e86ed84bdf35","38aea304b4fa46e1b29bb72f5cea4c93",4396150,2,2,0,1254,329,331,2
"38aea304b4fa46e1b29bb72f5cea4c93","38aea304b4fa46e1b29bb72f5cea4c93",4396150,2,0,1,1255,331,331,0
"38aea304b4fa46e1b29bb72f5cea4c93","e36d261332f14e79bb4b467aceaeb9b5",4396150,1,2,0,1256,331,333,2
"e36d261332f14e79bb4b467aceaeb9b5","e36d261332f14e79bb4b467aceaeb9b5",4396150,1,0,1,1257,333,333,0
"e36d261332f14e79bb4b467aceaeb9b5","c7e89b9d04744d2eab742fc24e3ef1ae",4396150,1,1,0,1258,333,334,1
"c7e89b9d04744d2eab742fc24e3ef1ae","c7e89b9d04744d2eab742fc24e3ef1ae",4396150,5,0,1,1259,334,334,0
"c7e89b9d04744d2eab742fc24e3ef1ae","fe49f8054b374a0ea4bb266ed135ff62",4396150,1,1,0,1264,334,335,1
"fe49f8054b374a0ea4bb266ed135ff62","fe49f8054b374a0ea4bb266ed135ff62",4396150,2,0,1,1265,335,335,0
"fe49f8054b374a0ea4bb266ed135ff62","d0a8f74af98642fe8360d22c42e45117",4396150,1,1,0,1267,335,336,1
"d0a8f74af98642fe8360d22c42e45117","d0a8f74af98642fe8360d22c42e45117",4396150,2,0,1,1268,336,336,0
"d0a8f74af98642fe8360d22c42e45117","0c4079457ede49e3aeb5e86ed84bdf35",4396150,1,-7,0,1270,336,329,-7
"0c4079457ede49e3aeb5e86ed84bdf35","a7c6339ca1da4368a18d471f0519f877",4396150,1,11,0,1271,329,339,10
"a7c6339ca1da4368a18d471f0519f877","a7c6339ca1da4368a18d471f0519f877",4396150,1,0,1,1272,339,339,0
"a7c6339ca1da4368a18d471f0519f877","bbc5139ca9024389a94db3a6f47dcff6",4396150,1,3,0,1273,339,341,2
"bbc5139ca9024389a94db3a6f47dcff6","b8b9418ab322418d9db9b40d96af873a",4396150,1,-5,0,1274,341,337,-4
"b8b9418ab322418d9db9b40d96af873a","0c4079457ede49e3aeb5e86ed84bdf35",4396150,1,-9,0,1275,337,329,-8
"0c4079457ede49e3aeb5e86ed84bdf35","bbc5139ca9024389a94db3a6f47dcff6",4396150,1,14,0,1276,329,341,12
"bbc5139ca9024389a94db3a6f47dcff6","bbc5139ca9024389a94db3a6f47dcff6",4396150,1,0,1,1277,341,341,0
"bbc5139ca9024389a94db3a6f47dcff6","3434c10e561d488a914e0f7d71907abd",4396150,1,-45,0,1278,341,305,-36
"141c0df6cd1946539aadd1c9b7068cd4","0c787d16c9504873b1a4d903cec09948",4396150,1,7,0,1287,308,314,6
"86c27d40179e419c8e9d150fb6afa5d0","8d7e0b55cf9849cda222a0f2440cec55",4396150,1,-1,0,1290,319,318,-1
"47edbb64109243e6b0f8f64cdef90c6c","3628bdce1dd2429ba924d2d4d09448d2",4396150,2,-4,0,1293,326,322,-4
"38aea304b4fa46e1b29bb72f5cea4c93","0c4079457ede49e3aeb5e86ed84bdf35",4396150,2,-2,0,1298,331,329,-2
"0c4079457ede49e3aeb5e86ed84bdf35","b8b9418ab322418d9db9b40d96af873a",4396150,2,9,0,1299,329,337,8
"b8b9418ab322418d9db9b40d96af873a","bbc5139ca9024389a94db3a6f47dcff6",4396150,2,5,0,1300,337,341,4
"bbc5139ca9024389a94db3a6f47dcff6","4ee6ca9019ab4a1ab323f98094a9bd77",4396150,1,2,0,1301,341,343,2
"4ee6ca9019ab4a1ab323f98094a9bd77","4ee6ca9019ab4a1ab323f98094a9bd77",4396150,2,0,1,1302,343,343,0
"4ee6ca9019ab4a1ab323f98094a9bd77","b37947176785476f8b29d49a851366dc",4396150,1,1,0,1304,343,344,1
"b37947176785476f8b29d49a851366dc","b37947176785476f8b29d49a851366dc",4396150,2,0,1,1305,344,344,0
"b37947176785476f8b29d49a851366dc","fcea5b10d5a14a3b9324ffece8f6e1e5",4396150,1,1,0,1307,344,345,1
"fcea5b10d5a14a3b9324ffece8f6e1e5","fcea5b10d5a14a3b9324ffece8f6e1e5",4396150,2,0,1,1308,345,345,0
"fcea5b10d5a14a3b9324ffece8f6e1e5","c2490bc612d146edbe786556fab3651b",4396150,2,-5,0,1310,345,340,-5
"c2490bc612d146edbe786556fab3651b","6ac8bb048b854999a47edb35fe627f11",4396150,1,8,0,1311,340,347,7
"6ac8bb048b854999a47edb35fe627f11","6ac8bb048b854999a47edb35fe627f11",4396150,1,0,1,1312,347,347,0
"6ac8bb048b854999a47edb35fe627f11","30ead9794d4847abaf222ca966cc8630",4396150,1,3,0,1313,347,348,1
"30ead9794d4847abaf222ca966cc8630","0c4079457ede49e3aeb5e86ed84bdf35",4396150,1,-24,0,1314,348,329,-19
"0c4079457ede49e3aeb5e86ed84bdf35","09b9678ddc3d452ea4a3d46e15826065",4396150,1,29,0,1315,329,353,24
"09b9678ddc3d452ea4a3d46e15826065","eff0de7f2dbb42dfa1a2e686efab5b6d",4396150,2,1,0,1316,353,354,1
"eff0de7f2dbb42dfa1a2e686efab5b6d","897b7f51242c44aab2205c72fdcbf4cd",4396150,2,-2,0,1317,354,352,-2
"897b7f51242c44aab2205c72fdcbf4cd","c20993c944444fe085345591a8bd837e",4396150,1,-1,0,1318,352,351,-1
"c20993c944444fe085345591a8bd837e","c20993c944444fe085345591a8bd837e",4396150,5,0,1,1319,351,351,0
"c20993c944444fe085345591a8bd837e","897b7f51242c44aab2205c72fdcbf4cd",4396150,3,1,0,1323,351,352,1
"897b7f51242c44aab2205c72fdcbf4cd","897b7f51242c44aab2205c72fdcbf4cd",4396150,5,0,1,1324,352,352,0
"897b7f51242c44aab2205c72fdcbf4cd","09b9678ddc3d452ea4a3d46e15826065",4396150,2,1,0,1327,352,353,1
"09b9678ddc3d452ea4a3d46e15826065","09b9678ddc3d452ea4a3d46e15826065",4396150,4,0,1,1328,353,353,0
"eff0de7f2dbb42dfa1a2e686efab5b6d","eff0de7f2dbb42dfa1a2e686efab5b6d",4396150,4,0,1,1332,354,354,0
"eff0de7f2dbb42dfa1a2e686efab5b6d","30ead9794d4847abaf222ca966cc8630",4396150,2,-6,0,1335,354,348,-6
"30ead9794d4847abaf222ca966cc8630","2fe14166dc9642c3bc666b86a57f943d",4396150,2,10,0,1336,348,357,9
"2fe14166dc9642c3bc666b86a57f943d","2fe14166dc9642c3bc666b86a57f943d",4396150,2,0,1,1337,357,357,0
"2fe14166dc9642c3bc666b86a57f943d","44421dd1e13a47a388c4a19834b744c7",4396150,1,2,0,1338,357,359,2
"44421dd1e13a47a388c4a19834b744c7","44421dd1e13a47a388c4a19834b744c7",4396150,2,0,1,1339,359,359,0
"44421dd1e13a47a388c4a19834b744c7","cb5fc7ef85d547c4be1a7439d0bf6052",4396150,1,1,0,1341,359,360,1
"cb5fc7ef85d547c4be1a7439d0bf6052","cb5fc7ef85d547c4be1a7439d0bf6052",4396150,4,0,1,1342,360,360,0
"cb5fc7ef85d547c4be1a7439d0bf6052","2fe14166dc9642c3bc666b86a57f943d",4396150,1,-3,0,1344,360,357,-3
"2fe14166dc9642c3bc666b86a57f943d","cb5fc7ef85d547c4be1a7439d0bf6052",4396150,1,3,0,1345,357,360,3
"cb5fc7ef85d547c4be1a7439d0bf6052","0a8f150a4cf747acbde62f4721823da3",4396150,1,1,0,1348,360,361,1
"0a8f150a4cf747acbde62f4721823da3","0a8f150a4cf747acbde62f4721823da3",4396150,5,0,1,1349,361,361,0
"0a8f150a4cf747acbde62f4721823da3","ab8fdad974ae471f9f24c3f9dd04462e",4396150,1,1,0,1354,361,362,1
"ab8fdad974ae471f9f24c3f9dd04462e","ab8fdad974ae471f9f24c3f9dd04462e",4396150,2,0,1,1355,362,362,0
"ab8fdad974ae471f9f24c3f9dd04462e","52580888dadb4fe3baa795683ea227bd",4396150,1,3,0,1357,362,364,2
"52580888dadb4fe3baa795683ea227bd","1ba8fef685d74a8194b9db252eb704fb",4396150,1,-10,0,1358,364,355,-9
"1ba8fef685d74a8194b9db252eb704fb","3434c10e561d488a914e0f7d71907abd",4396150,1,-63,0,1359,355,305,-50
"3434c10e561d488a914e0f7d71907abd","43ea1b823a4b4e51b7c694c10725db82",4396150,1,27,0,1360,305,327,22
"43ea1b823a4b4e51b7c694c10725db82","130acc2aeb0448fdbb2de63bc5cebe5b",4396150,1,-22,0,1361,327,309,-18
"0c787d16c9504873b1a4d903cec09948","24f1363179ad4aaa965484a78471912b",4396150,2,11,0,1365,314,323,9
"24f1363179ad4aaa965484a78471912b","8d7e0b55cf9849cda222a0f2440cec55",4396150,1,-6,0,1366,323,318,-5
"8d7e0b55cf9849cda222a0f2440cec55","47edbb64109243e6b0f8f64cdef90c6c",4396150,1,9,0,1367,318,326,8
"3628bdce1dd2429ba924d2d4d09448d2","0c4079457ede49e3aeb5e86ed84bdf35",4396150,1,10,0,1369,322,329,7
"bbc5139ca9024389a94db3a6f47dcff6","fcea5b10d5a14a3b9324ffece8f6e1e5",4396150,1,4,0,1375,341,345,4
"c2490bc612d146edbe786556fab3651b","0c4079457ede49e3aeb5e86ed84bdf35",4396150,1,-13,0,1377,340,329,-11
"0c4079457ede49e3aeb5e86ed84bdf35","30ead9794d4847abaf222ca966cc8630",4396150,1,24,0,1378,329,348,19
"30ead9794d4847abaf222ca966cc8630","09b9678ddc3d452ea4a3d46e15826065",4396150,1,5,0,1379,348,353,5
"09b9678ddc3d452ea4a3d46e15826065","c20993c944444fe085345591a8bd837e",4396150,3,-2,0,1380,353,351,-2
"897b7f51242c44aab2205c72fdcbf4cd","eff0de7f2dbb42dfa1a2e686efab5b6d",4396150,3,2,0,1382,352,354,2
"c20993c944444fe085345591a8bd837e","eff0de7f2dbb42dfa1a2e686efab5b6d",4396150,2,3,0,1386,351,354,3
"eff0de7f2dbb42dfa1a2e686efab5b6d","c20993c944444fe085345591a8bd837e",4396150,1,-3,0,1387,354,351,-3
"eff0de7f2dbb42dfa1a2e686efab5b6d","09b9678ddc3d452ea4a3d46e15826065",4396150,2,-1,0,1390,354,353,-1
"09b9678ddc3d452ea4a3d46e15826065","2fe14166dc9642c3bc666b86a57f943d",4396150,1,5,0,1391,353,357,4
"2fe14166dc9642c3bc666b86a57f943d","30ead9794d4847abaf222ca966cc8630",4396150,1,-10,0,1392,357,348,-9
"30ead9794d4847abaf222ca966cc8630","1ba8fef685d74a8194b9db252eb704fb",4396150,1,8,0,1393,348,355,7
"1ba8fef685d74a8194b9db252eb704fb","52580888dadb4fe3baa795683ea227bd",4396150,1,10,0,1394,355,364,9
"52580888dadb4fe3baa795683ea227bd","52580888dadb4fe3baa795683ea227bd",4396150,1,0,1,1395,364,364,0
"52580888dadb4fe3baa795683ea227bd","492a3bc6a1254f23a7998587961b22a4",4396150,1,3,0,1396,364,366,2
"492a3bc6a1254f23a7998587961b22a4","f00179e251a045b39c3f7a54f9aa4acc",4396150,1,-4,0,1397,366,363,-3
"f00179e251a045b39c3f7a54f9aa4acc","492a3bc6a1254f23a7998587961b22a4",4396150,1,4,0,1398,363,366,3
"492a3bc6a1254f23a7998587961b22a4","492a3bc6a1254f23a7998587961b22a4",4396150,2,0,1,1399,366,366,0
"492a3bc6a1254f23a7998587961b22a4","072a190fd302456290895f9f04d6940a",4396150,2,-1,0,1400,366,365,-1
"072a190fd302456290895f9f04d6940a","c76574d21bc14aeea7ecd0b027f39858",4396150,1,3,0,1401,365,367,2
"c76574d21bc14aeea7ecd0b027f39858","492a3bc6a1254f23a7998587961b22a4",4396150,1,-2,0,1402,367,366,-1
"072a190fd302456290895f9f04d6940a","b71bac264efb4abd97015447bd490db6",4396150,1,8,0,1405,365,370,5
"b71bac264efb4abd97015447bd490db6","30ead9794d4847abaf222ca966cc8630",4396150,1,-28,0,1406,370,348,-22
"30ead9794d4847abaf222ca966cc8630","78adeee1fa2c4fe0bc73f7bca9fcee86",4396150,1,-256,0,1407,348,160,-188
"78adeee1fa2c4fe0bc73f7bca9fcee86","65202579580f4ad38d734b4ee39d22a8",4396150,4,5,0,1408,160,164,4
"65202579580f4ad38d734b4ee39d22a8","65202579580f4ad38d734b4ee39d22a8",4396150,19,0,1,1409,164,164,0
"65202579580f4ad38d734b4ee39d22a8","67a089198fcb4e1c8f2385786c2b296f",4396150,1,-157,0,1416,164,39,-125
"67a089198fcb4e1c8f2385786c2b296f","b534b89233134e30a9b5645138bfa9ee",4396150,1,4,0,1417,39,41,2
"b534b89233134e30a9b5645138bfa9ee","7af822066add4e7f8e007e4eee31a8bf",4396150,2,29,0,1418,41,65,24
"7af822066add4e7f8e007e4eee31a8bf","6e13d61a7bdb44bca949c9f86fab3be5",4396150,1,-22,0,1419,65,47,-18
"b534b89233134e30a9b5645138bfa9ee","d9c8d8c444a64dadbbb508652c721e17",4396150,1,6,0,1421,41,46,5
"d0c74f735e024943943e40333d6d337f","78f30e4dcac84e3cbea8b2cc6e0d62b3",4396150,1,9,0,1423,51,59,8
"78f30e4dcac84e3cbea8b2cc6e0d62b3","f924752d8a1149668870b1e7698486f7",4396150,1,-10,0,1424,59,50,-9
"f924752d8a1149668870b1e7698486f7","a1f2f12debe5432fb7a70bcd12bacfb9",4396150,1,9,0,1425,50,58,8
"a1f2f12debe5432fb7a70bcd12bacfb9","bc42d26810654ea9a1df1efe1e58c7d5",4396150,2,6,0,1426,58,63,5
"bc42d26810654ea9a1df1efe1e58c7d5","12aa6e1672ac4e7aa6449a7a8609cd72",4396150,1,-7,0,1427,63,57,-6
"12aa6e1672ac4e7aa6449a7a8609cd72","a0a418b8540d479fa6e0f653b701da8b",4396150,4,8,0,1428,57,64,7
"a0a418b8540d479fa6e0f653b701da8b","bc42d26810654ea9a1df1efe1e58c7d5",4396150,4,-1,0,1429,64,63,-1
"bc42d26810654ea9a1df1efe1e58c7d5","bc42d26810654ea9a1df1efe1e58c7d5",4396150,6,0,1,1430,63,63,0
"bc42d26810654ea9a1df1efe1e58c7d5","a0a418b8540d479fa6e0f653b701da8b",4396150,3,1,0,1431,63,64,1
"a0a418b8540d479fa6e0f653b701da8b","a0a418b8540d479fa6e0f653b701da8b",4396150,6,0,1,1432,64,64,0
"a0a418b8540d479fa6e0f653b701da8b","309ccf3cc4fe429d9bfbaef53d3fa479",4396150,2,-4,0,1433,64,60,-4
"309ccf3cc4fe429d9bfbaef53d3fa479","b534b89233134e30a9b5645138bfa9ee",4396150,4,-23,0,1434,60,41,-19
"b534b89233134e30a9b5645138bfa9ee","d646286c8051419bbc2e31dd1db55ca8",4396150,6,33,0,1435,41,67,26
"d646286c8051419bbc2e31dd1db55ca8","a2becd407db34b189200a32546d9d569",4396150,3,9,0,1436,67,75,8
"a2becd407db34b189200a32546d9d569","d646286c8051419bbc2e31dd1db55ca8",4396150,2,-9,0,1437,75,67,-8
"d646286c8051419bbc2e31dd1db55ca8","140d5b27b8574befad82c0a013b59dfa",4396150,1,8,0,1438,67,74,7
"140d5b27b8574befad82c0a013b59dfa","d18a9ea32855445f8736581f5cb119ce",4396150,3,9,0,1439,74,82,8
"d18a9ea32855445f8736581f5cb119ce","1b4550d0dab04078b3bf08a655345bdc",4396150,1,386,0,1440,82,373,291
"1b4550d0dab04078b3bf08a655345bdc","b71bac264efb4abd97015447bd490db6",4396150,1,-4,0,1441,373,370,-3
"b71bac264efb4abd97015447bd490db6","8d448d625b024c82a5eb240bbd7431d6",4396150,4,5,0,1442,370,374,4
"8d448d625b024c82a5eb240bbd7431d6","8d448d625b024c82a5eb240bbd7431d6",4396150,62,0,1,1443,374,374,0
"8d448d625b024c82a5eb240bbd7431d6","30ead9794d4847abaf222ca966cc8630",4396150,1,-33,0,1450,374,348,-26
"30ead9794d4847abaf222ca966cc8630","30ead9794d4847abaf222ca966cc8630",4396150,1,0,1,1451,348,348,0
"30ead9794d4847abaf222ca966cc8630","cfa457d1743848e4bb5e4beced6448ed",4396150,1,25,0,1452,348,369,21
"cfa457d1743848e4bb5e4beced6448ed","cfa457d1743848e4bb5e4beced6448ed",4396150,1,0,1,1453,369,369,0
"cfa457d1743848e4bb5e4beced6448ed","30ead9794d4847abaf222ca966cc8630",4396150,1,-25,0,1454,369,348,-21
"30ead9794d4847abaf222ca966cc8630","b71bac264efb4abd97015447bd490db6",4396150,1,28,0,1455,348,370,22
"8d448d625b024c82a5eb240bbd7431d6","b71bac264efb4abd97015447bd490db6",4396150,3,-5,0,1457,374,370,-4
"b71bac264efb4abd97015447bd490db6","d6d02b6ef04e4f17805504500b8ce441",4396150,2,8,0,1466,370,375,5
"d6d02b6ef04e4f17805504500b8ce441","d6d02b6ef04e4f17805504500b8ce441",4396150,1,0,1,1467,375,375,0
"d6d02b6ef04e4f17805504500b8ce441","d7f13c8d63ec4e2aa673fbb9cf9c6933",4396150,1,-226,0,1468,375,206,-169
"d7f13c8d63ec4e2aa673fbb9cf9c6933","d7f13c8d63ec4e2aa673fbb9cf9c6933",4396150,1,0,1,1469,206,206,0
"d7f13c8d63ec4e2aa673fbb9cf9c6933","1c6721b1f63f4d30ba7746ea8af02a52",4396150,2,21,0,1470,206,221,15
"1c6721b1f63f4d30ba7746ea8af02a52","77ecef8eff6b4a2caea7707669bf7475",4396150,3,1,0,1471,221,222,1
"77ecef8eff6b4a2caea7707669bf7475","1c6721b1f63f4d30ba7746ea8af02a52",4396150,1,-1,0,1472,222,221,-1
"1c6721b1f63f4d30ba7746ea8af02a52","d03cb855c70044cf8c35d9ec0de696e3",4396150,2,4,0,1473,221,224,3
"d03cb855c70044cf8c35d9ec0de696e3","8b9ae98743bd4d4a8a87dff1c1244211",4396150,1,3,0,1474,224,227,3
"8b9ae98743bd4d4a8a87dff1c1244211","8b9ae98743bd4d4a8a87dff1c1244211",4396150,51,0,1,1475,227,227,0
"8b9ae98743bd4d4a8a87dff1c1244211","f7906d6f59b9489a91d2ef40db5a474d",4396150,2,-4,0,1508,227,223,-4
"f7906d6f59b9489a91d2ef40db5a474d","2ab1535aac1346ba8801535bf729ef37",4396150,2,7,0,1509,223,229,6
"2ab1535aac1346ba8801535bf729ef37","5152833676bf4c6cb317060be10f68db",4396150,1,-1,0,1510,229,228,-1
"5152833676bf4c6cb317060be10f68db","8f68228b1518449e9615cdafee41a2bd",4396150,1,10,0,1511,228,237,9
"8f68228b1518449e9615cdafee41a2bd","8f68228b1518449e9615cdafee41a2bd",4396150,1,0,1,1512,237,237,0
"8f68228b1518449e9615cdafee41a2bd","0b04c8e2f86d48c7aeb7e225819cd32b",4396150,1,-3,0,1513,237,234,-3
"0b04c8e2f86d48c7aeb7e225819cd32b","4a29443515bb404cb8924e1c60a63b73",4396150,1,71,0,1514,234,285,51
"8d7e0b55cf9849cda222a0f2440cec55","1c6721b1f63f4d30ba7746ea8af02a52",4396150,1,-130,0,1526,318,221,-97
"77ecef8eff6b4a2caea7707669bf7475","b534b89233134e30a9b5645138bfa9ee",4396150,1,-236,0,1528,222,41,-181
"b534b89233134e30a9b5645138bfa9ee","66baf19b6b904b70922329068c63746d",4396150,1,444,0,1529,41,376,335
"66baf19b6b904b70922329068c63746d","66baf19b6b904b70922329068c63746d",4396150,2,0,1,1530,376,376,0
"66baf19b6b904b70922329068c63746d","7f544639412e40a9ba27f43b415362ab",4396150,1,2,0,1531,376,378,2
"7f544639412e40a9ba27f43b415362ab","7f544639412e40a9ba27f43b415362ab",4396150,5,0,1,1532,378,378,0
"7f544639412e40a9ba27f43b415362ab","d5ae8642e15b46b8bd298b02274d4e9c",4396150,1,2,0,1535,378,380,2
"d5ae8642e15b46b8bd298b02274d4e9c","d5ae8642e15b46b8bd298b02274d4e9c",4396150,2,0,1,1536,380,380,0
"d5ae8642e15b46b8bd298b02274d4e9c","a0d10309a2dd456289147f84be9d37f9",4396150,1,1,0,1537,380,381,1
"a0d10309a2dd456289147f84be9d37f9","a0d10309a2dd456289147f84be9d37f9",4396150,2,0,1,1538,381,381,0
"a0d10309a2dd456289147f84be9d37f9","d5ae8642e15b46b8bd298b02274d4e9c",4396150,1,-1,0,1540,381,380,-1
"d5ae8642e15b46b8bd298b02274d4e9c","0fcbc3ca07b144138b8d85da581f09a8",4396150,1,2,0,1542,380,382,2
"0fcbc3ca07b144138b8d85da581f09a8","0fcbc3ca07b144138b8d85da581f09a8",4396150,2,0,1,1543,382,382,0
"0fcbc3ca07b144138b8d85da581f09a8","66baf19b6b904b70922329068c63746d",4396150,1,-6,0,1545,382,376,-6
"66baf19b6b904b70922329068c63746d","c2fca3669923477ab966ded303dea31c",4396150,1,8,0,1546,376,383,7
"c2fca3669923477ab966ded303dea31c","4890121ce5d74576b4632b77cfc23398",4396150,2,6,0,1547,383,388,5
"4890121ce5d74576b4632b77cfc23398","4890121ce5d74576b4632b77cfc23398",4396150,1,0,1,1548,388,388,0
"4890121ce5d74576b4632b77cfc23398","18d3b836dd804224883cc9180b60a8e1",4396150,1,-1,0,1549,388,387,-1
"18d3b836dd804224883cc9180b60a8e1","96bb2b3e85a34d8b9544514e89f6fe97",4396150,1,4,0,1550,387,390,3
"96bb2b3e85a34d8b9544514e89f6fe97","66baf19b6b904b70922329068c63746d",4396150,2,-17,0,1551,390,376,-14
"66baf19b6b904b70922329068c63746d","17f95d18bab743888e1736033dc3384d",4396150,1,16,0,1552,376,389,13
"17f95d18bab743888e1736033dc3384d","96bb2b3e85a34d8b9544514e89f6fe97",4396150,2,1,0,1553,389,390,1
"96bb2b3e85a34d8b9544514e89f6fe97","96bb2b3e85a34d8b9544514e89f6fe97",4396150,2,0,1,1554,390,390,0
"66baf19b6b904b70922329068c63746d","30ead9794d4847abaf222ca966cc8630",4396150,1,-40,0,1557,376,348,-28
"30ead9794d4847abaf222ca966cc8630","c76574d21bc14aeea7ecd0b027f39858",4396150,1,23,0,1558,348,367,19
"c76574d21bc14aeea7ecd0b027f39858","c20993c944444fe085345591a8bd837e",4396150,1,-20,0,1559,367,351,-16
"c20993c944444fe085345591a8bd837e","09b9678ddc3d452ea4a3d46e15826065",4396150,1,2,0,1561,351,353,2
"09b9678ddc3d452ea4a3d46e15826065","897b7f51242c44aab2205c72fdcbf4cd",4396150,1,-1,0,1563,353,352,-1
"2fe14166dc9642c3bc666b86a57f943d","66baf19b6b904b70922329068c63746d",4396150,1,30,0,1574,357,376,19
"66baf19b6b904b70922329068c63746d","96bb2b3e85a34d8b9544514e89f6fe97",4396150,2,17,0,1575,376,390,14
"96bb2b3e85a34d8b9544514e89f6fe97","17f95d18bab743888e1736033dc3384d",4396150,1,-1,0,1576,390,389,-1
"17f95d18bab743888e1736033dc3384d","7f544639412e40a9ba27f43b415362ab",4396150,1,-14,0,1577,389,378,-11
"7f544639412e40a9ba27f43b415362ab","66baf19b6b904b70922329068c63746d",4396150,1,-2,0,1580,378,376,-2
"66baf19b6b904b70922329068c63746d","4890121ce5d74576b4632b77cfc23398",4396150,3,14,0,1581,376,388,12
"4890121ce5d74576b4632b77cfc23398","c2fca3669923477ab966ded303dea31c",4396150,1,-6,0,1582,388,383,-5
"4890121ce5d74576b4632b77cfc23398","96bb2b3e85a34d8b9544514e89f6fe97",4396150,4,3,0,1584,388,390,2
"96bb2b3e85a34d8b9544514e89f6fe97","18d3b836dd804224883cc9180b60a8e1",4396150,4,-4,0,1585,390,387,-3
"18d3b836dd804224883cc9180b60a8e1","17f95d18bab743888e1736033dc3384d",4396150,1,3,0,1586,387,389,2
"17f95d18bab743888e1736033dc3384d","66baf19b6b904b70922329068c63746d",4396150,1,-16,0,1587,389,376,-13
"96bb2b3e85a34d8b9544514e89f6fe97","ac4e9b54acfe4670b4634859c7263cb5",4396150,1,2,0,1590,390,392,2
"ac4e9b54acfe4670b4634859c7263cb5","ac4e9b54acfe4670b4634859c7263cb5",4396150,2,0,1,1591,392,392,0
"ac4e9b54acfe4670b4634859c7263cb5","17f95d18bab743888e1736033dc3384d",4396150,2,-3,0,1592,392,389,-3
"17f95d18bab743888e1736033dc3384d","17f95d18bab743888e1736033dc3384d",4396150,1,0,1,1593,389,389,0
"17f95d18bab743888e1736033dc3384d","4890121ce5d74576b4632b77cfc23398",4396150,1,-2,0,1594,389,388,-1
"18d3b836dd804224883cc9180b60a8e1","6f8881a745ac4c358a68b92c3b4abe81",4396150,2,9,0,1597,387,394,7
"6f8881a745ac4c358a68b92c3b4abe81","17f95d18bab743888e1736033dc3384d",4396150,3,-6,0,1598,394,389,-5
"96bb2b3e85a34d8b9544514e89f6fe97","f7002c8484354eceac57bc7bd62c76c1",4396150,1,4,0,1600,390,393,3
"f7002c8484354eceac57bc7bd62c76c1","18d3b836dd804224883cc9180b60a8e1",4396150,1,-8,0,1601,393,387,-6
"18d3b836dd804224883cc9180b60a8e1","66baf19b6b904b70922329068c63746d",4396150,1,-13,0,1602,387,376,-11
"18d3b836dd804224883cc9180b60a8e1","ac4e9b54acfe4670b4634859c7263cb5",4396150,1,6,0,1606,387,392,5
"17f95d18bab743888e1736033dc3384d","6f8881a745ac4c358a68b92c3b4abe81",4396150,1,6,0,1609,389,394,5
"6f8881a745ac4c358a68b92c3b4abe81","6f8881a745ac4c358a68b92c3b4abe81",4396150,4,0,1,1610,394,394,0
"6f8881a745ac4c358a68b92c3b4abe81","f7002c8484354eceac57bc7bd62c76c1",4396150,1,-1,0,1614,394,393,-1
"f7002c8484354eceac57bc7bd62c76c1","6f8881a745ac4c358a68b92c3b4abe81",4396150,1,1,0,1615,393,394,1
"6f8881a745ac4c358a68b92c3b4abe81","0c12af0a4e7f4002852cf84b2537c161",4396150,1,2,0,1616,394,395,1
"0c12af0a4e7f4002852cf84b2537c161","f7002c8484354eceac57bc7bd62c76c1",4396150,1,-3,0,1617,395,393,-2
"f7002c8484354eceac57bc7bd62c76c1","0c12af0a4e7f4002852cf84b2537c161",4396150,2,3,0,1618,393,395,2
"0c12af0a4e7f4002852cf84b2537c161","96bb2b3e85a34d8b9544514e89f6fe97",4396150,1,-7,0,1619,395,390,-5
"96bb2b3e85a34d8b9544514e89f6fe97","6f8881a745ac4c358a68b92c3b4abe81",4396150,1,5,0,1620,390,394,4
"17f95d18bab743888e1736033dc3384d","f7002c8484354eceac57bc7bd62c76c1",4396150,2,5,0,1622,389,393,4
"0c12af0a4e7f4002852cf84b2537c161","66baf19b6b904b70922329068c63746d",4396150,1,-24,0,1624,395,376,-19
"f7002c8484354eceac57bc7bd62c76c1","44a277ea44dc4ae689fab4b82f0b4098",4396150,1,5,0,1631,393,397,4
"44a277ea44dc4ae689fab4b82f0b4098","44a277ea44dc4ae689fab4b82f0b4098",4396150,1,0,1,1632,397,397,0
"44a277ea44dc4ae689fab4b82f0b4098","0c12af0a4e7f4002852cf84b2537c161",4396150,1,-2,0,1633,397,395,-2
"0c12af0a4e7f4002852cf84b2537c161","859e0b8d71694b12befb69ee698138f9",4396150,1,5,0,1634,395,399,4
"859e0b8d71694b12befb69ee698138f9","859e0b8d71694b12befb69ee698138f9",4396150,1,0,1,1635,399,399,0
"859e0b8d71694b12befb69ee698138f9","66baf19b6b904b70922329068c63746d",4396150,1,-29,0,1636,399,376,-23
"66baf19b6b904b70922329068c63746d","2b09a08242b54983aec7063990fb3f66",4396150,1,32,0,1637,376,400,24
"2b09a08242b54983aec7063990fb3f66","2b09a08242b54983aec7063990fb3f66",4396150,8,0,1,1638,400,400,0
"2b09a08242b54983aec7063990fb3f66","1f471b7a883a4df48211e8c6a81b59a7",4396150,1,1,0,1646,400,401,1
"1f471b7a883a4df48211e8c6a81b59a7","1f471b7a883a4df48211e8c6a81b59a7",4396150,1,0,1,1647,401,401,0
"1f471b7a883a4df48211e8c6a81b59a7","2b09a08242b54983aec7063990fb3f66",4396150,1,-1,0,1648,401,400,-1
"2b09a08242b54983aec7063990fb3f66","9de0d567bfa84fe5b77cb76f4a76a5d1",4396150,1,5,0,1649,400,404,4
"9de0d567bfa84fe5b77cb76f4a76a5d1","9de0d567bfa84fe5b77cb76f4a76a5d1",4396150,1,0,1,1650,404,404,0
"9de0d567bfa84fe5b77cb76f4a76a5d1","1157bd665ec4472fb58b751dc5099355",4396150,1,-1,0,1651,404,403,-1
"1157bd665ec4472fb58b751dc5099355","58fc9094275e4c49be3f4ba6d4acc0a4",4396150,1,5,0,1652,403,406,3
"58fc9094275e4c49be3f4ba6d4acc0a4","3c8a22d2f9c146ea956609e3ed4f2559",4396150,1,-2,0,1653,406,405,-1
"3c8a22d2f9c146ea956609e3ed4f2559","58fc9094275e4c49be3f4ba6d4acc0a4",4396150,1,2,0,1654,405,406,1
"58fc9094275e4c49be3f4ba6d4acc0a4","58fc9094275e4c49be3f4ba6d4acc0a4",4396150,3,0,1,1655,406,406,0
"58fc9094275e4c49be3f4ba6d4acc0a4","c1c1be90b2b14c1ab4a5e1ee3c241902",4396150,1,1,0,1658,406,407,1
"c1c1be90b2b14c1ab4a5e1ee3c241902","c1c1be90b2b14c1ab4a5e1ee3c241902",4396150,5,0,1,1659,407,407,0
"c1c1be90b2b14c1ab4a5e1ee3c241902","58fc9094275e4c49be3f4ba6d4acc0a4",4396150,1,-1,0,1664,407,406,-1
"58fc9094275e4c49be3f4ba6d4acc0a4","02b3a1bead9244c1ba2f857c7da8f82a",4396150,1,3,0,1665,406,408,2
"02b3a1bead9244c1ba2f857c7da8f82a","02b3a1bead9244c1ba2f857c7da8f82a",4396150,1,0,1,1666,408,408,0
"02b3a1bead9244c1ba2f857c7da8f82a","6206fc6479014bb193084c32409dc1b9",4396150,1,1,0,1667,408,409,1
"6206fc6479014bb193084c32409dc1b9","6206fc6479014bb193084c32409dc1b9",4396150,8,0,1,1668,409,409,0
"6206fc6479014bb193084c32409dc1b9","6a5f020451db426dacba9e2ea3fcc62a",4396150,1,2,0,1676,409,410,1
"6a5f020451db426dacba9e2ea3fcc62a","02b3a1bead9244c1ba2f857c7da8f82a",4396150,1,-3,0,1677,410,408,-2
"02b3a1bead9244c1ba2f857c7da8f82a","6a5f020451db426dacba9e2ea3fcc62a",4396150,2,3,0,1678,408,410,2
"6a5f020451db426dacba9e2ea3fcc62a","33a9d248b2e44588a5b07fc1342b9bc2",4396150,2,2,0,1679,410,411,1
"33a9d248b2e44588a5b07fc1342b9bc2","33a9d248b2e44588a5b07fc1342b9bc2",4396150,4,0,1,1680,411,411,0
"33a9d248b2e44588a5b07fc1342b9bc2","02b3a1bead9244c1ba2f857c7da8f82a",4396150,1,-5,0,1681,411,408,-3
"02b3a1bead9244c1ba2f857c7da8f82a","33a9d248b2e44588a5b07fc1342b9bc2",4396150,1,5,0,1682,408,411,3
"33a9d248b2e44588a5b07fc1342b9bc2","6206fc6479014bb193084c32409dc1b9",4396150,1,-4,0,1683,411,409,-2
"6206fc6479014bb193084c32409dc1b9","02b3a1bead9244c1ba2f857c7da8f82a",4396150,1,-1,0,1684,409,408,-1
"6a5f020451db426dacba9e2ea3fcc62a","6a5f020451db426dacba9e2ea3fcc62a",4396150,2,0,1,1686,410,410,0
"33a9d248b2e44588a5b07fc1342b9bc2","c6f26bd420634f1cb7989e76fe6b16c0",4396150,1,1,0,1691,411,412,1
"c6f26bd420634f1cb7989e76fe6b16c0","c6f26bd420634f1cb7989e76fe6b16c0",4396150,5,0,1,1692,412,412,0
"c6f26bd420634f1cb7989e76fe6b16c0","2a65ee6e2ac64f6a8a55fbe5373ec763",4396150,1,1,0,1697,412,413,1
"2a65ee6e2ac64f6a8a55fbe5373ec763","2a65ee6e2ac64f6a8a55fbe5373ec763",4396150,2,0,1,1698,413,413,0
"2a65ee6e2ac64f6a8a55fbe5373ec763","33a9d248b2e44588a5b07fc1342b9bc2",4396150,1,-2,0,1700,413,411,-2
"33a9d248b2e44588a5b07fc1342b9bc2","687055dad9fc40c3982478fe33ec01bf",4396150,1,4,0,1702,411,414,3
"687055dad9fc40c3982478fe33ec01bf","2b09a08242b54983aec7063990fb3f66",4396150,1,-21,0,1703,414,400,-14
"2b09a08242b54983aec7063990fb3f66","1fd0f6dadbc14ebc965faf6122190b96",4396150,1,22,0,1704,400,415,15
"1fd0f6dadbc14ebc965faf6122190b96","1fd0f6dadbc14ebc965faf6122190b96",4396150,1,0,1,1705,415,415,0
"1fd0f6dadbc14ebc965faf6122190b96","687055dad9fc40c3982478fe33ec01bf",4396150,1,-1,0,1706,415,414,-1
"687055dad9fc40c3982478fe33ec01bf","2add1669f08d4101913db15f8c23b3b7",4396150,1,3,0,1707,414,416,2
"2add1669f08d4101913db15f8c23b3b7","2add1669f08d4101913db15f8c23b3b7",4396150,1,0,1,1708,416,416,0
"2add1669f08d4101913db15f8c23b3b7","2b09a08242b54983aec7063990fb3f66",4396150,1,-24,0,1709,416,400,-16
"2b09a08242b54983aec7063990fb3f66","a2b4bd40cee2481ebd3fc179d6a5cd62",4396150,1,27,0,1710,400,417,17
"a2b4bd40cee2481ebd3fc179d6a5cd62","e34e59dce2204f228f3a84b6725df60f",4396150,1,2,0,1711,417,419,2
"e34e59dce2204f228f3a84b6725df60f","e34e59dce2204f228f3a84b6725df60f",4396150,1,0,1,1712,419,419,0
"e34e59dce2204f228f3a84b6725df60f","bec48fc2e1294c7eb3d0aca780d731b8",4396150,1,2,0,1713,419,420,1
"bec48fc2e1294c7eb3d0aca780d731b8","a2b4bd40cee2481ebd3fc179d6a5cd62",4396150,2,-4,0,1714,420,417,-3
"a2b4bd40cee2481ebd3fc179d6a5cd62","24cf8786024543f19b89bc20034e60d7",4396150,2,18,0,1715,417,428,11
"24cf8786024543f19b89bc20034e60d7","f2a73be2f46840b182d7bd095378004e",4396150,2,1,0,1716,428,429,1
"f2a73be2f46840b182d7bd095378004e","f2a73be2f46840b182d7bd095378004e",4396150,1,0,1,1717,429,429,0
"f2a73be2f46840b182d7bd095378004e","604551fd4266430cb860fef58fa7dd61",4396150,1,1,0,1718,429,430,1
"604551fd4266430cb860fef58fa7dd61","604551fd4266430cb860fef58fa7dd61",4396150,9,0,1,1719,430,430,0
"604551fd4266430cb860fef58fa7dd61","dce46f8904594a62a6377a3587aaa663",4396150,1,2,0,1728,430,431,1
"dce46f8904594a62a6377a3587aaa663","24cf8786024543f19b89bc20034e60d7",4396150,1,-4,0,1729,431,428,-3
"24cf8786024543f19b89bc20034e60d7","9b9d0a249052413c869753b99682b0ac",4396150,1,5,0,1730,428,432,4
"9b9d0a249052413c869753b99682b0ac","9b9d0a249052413c869753b99682b0ac",4396150,5,0,1,1731,432,432,0
"9b9d0a249052413c869753b99682b0ac","061c175cc90f45fbad883025394e78dd",4396150,1,1,0,1736,432,433,1
"061c175cc90f45fbad883025394e78dd","061c175cc90f45fbad883025394e78dd",4396150,5,0,1,1737,433,433,0
"061c175cc90f45fbad883025394e78dd","dce46f8904594a62a6377a3587aaa663",4396150,1,-2,0,1742,433,431,-2
"dce46f8904594a62a6377a3587aaa663","74a7f8712e5449c2bc0b43c6f90dafed",4396150,1,5,0,1743,431,435,4
"74a7f8712e5449c2bc0b43c6f90dafed","74a7f8712e5449c2bc0b43c6f90dafed",4396150,1,0,1,1744,435,435,0
"74a7f8712e5449c2bc0b43c6f90dafed","66ada10dde9f43018588f1ced9d477fc",4396150,1,-1,0,1745,435,434,-1
"66ada10dde9f43018588f1ced9d477fc","bf12c96466d840a69bed7020b3f18bb8",4396150,1,3,0,1746,434,436,2
"bf12c96466d840a69bed7020b3f18bb8","bf12c96466d840a69bed7020b3f18bb8",4396150,1,0,1,1747,436,436,0
"bf12c96466d840a69bed7020b3f18bb8","070600601c4c439288445d2f0724807d",4396150,1,3,0,1748,436,437,1
"070600601c4c439288445d2f0724807d","24cf8786024543f19b89bc20034e60d7",4396150,1,-14,0,1749,437,428,-9
"24cf8786024543f19b89bc20034e60d7","1823b6de7d334a7aaabc4570719af4d9",4396150,1,16,0,1750,428,439,11
"1823b6de7d334a7aaabc4570719af4d9","1823b6de7d334a7aaabc4570719af4d9",4396150,20,0,1,1751,439,439,0
"1823b6de7d334a7aaabc4570719af4d9","0380cd76a7d44bc3a4da1f15e4d68f89",4396150,2,2,0,1762,439,440,1
"0380cd76a7d44bc3a4da1f15e4d68f89","1823b6de7d334a7aaabc4570719af4d9",4396150,1,-2,0,1763,440,439,-1
"1823b6de7d334a7aaabc4570719af4d9","070600601c4c439288445d2f0724807d",4396150,2,-2,0,1764,439,437,-2
"070600601c4c439288445d2f0724807d","0380cd76a7d44bc3a4da1f15e4d68f89",4396150,4,4,0,1765,437,440,3
"0380cd76a7d44bc3a4da1f15e4d68f89","bec48fc2e1294c7eb3d0aca780d731b8",4396150,1,-32,0,1766,440,420,-20
"a2b4bd40cee2481ebd3fc179d6a5cd62","bec48fc2e1294c7eb3d0aca780d731b8",4396150,1,4,0,1768,417,420,3
"bec48fc2e1294c7eb3d0aca780d731b8","bec48fc2e1294c7eb3d0aca780d731b8",4396150,5,0,1,1769,420,420,0
"bec48fc2e1294c7eb3d0aca780d731b8","dbde19fcce2a4c1abdc7f685c293a23f",4396150,1,3,0,1774,420,422,2
"dbde19fcce2a4c1abdc7f685c293a23f","a24600b0e49245f6bdba8c893cfeddb0",4396150,1,4,0,1775,422,425,3
"a24600b0e49245f6bdba8c893cfeddb0","a24600b0e49245f6bdba8c893cfeddb0",4396150,4,0,1,1776,425,425,0
"a24600b0e49245f6bdba8c893cfeddb0","a2b4bd40cee2481ebd3fc179d6a5cd62",4396150,1,-11,0,1780,425,417,-8
"f2a73be2f46840b182d7bd095378004e","f67fbf45a5f146ed866965bc57c7c001",4396150,1,42,0,1783,429,454,25
"f67fbf45a5f146ed866965bc57c7c001","f67fbf45a5f146ed866965bc57c7c001",4396150,3,0,1,1784,454,454,0
"f67fbf45a5f146ed866965bc57c7c001","d937afe49bd24a07a550dda1c1155122",4396150,1,1,0,1787,454,455,1
"d937afe49bd24a07a550dda1c1155122","d937afe49bd24a07a550dda1c1155122",4396150,3,0,1,1788,455,455,0
"d937afe49bd24a07a550dda1c1155122","3628b3f7823443d0912a339096b69943",4396150,1,1,0,1791,455,456,1
"3628b3f7823443d0912a339096b69943","3628b3f7823443d0912a339096b69943",4396150,1,0,1,1792,456,456,0
"3628b3f7823443d0912a339096b69943","9e049ee647cf43ecbcb5ed792a8e7588",4396150,1,1,0,1793,456,457,1
"9e049ee647cf43ecbcb5ed792a8e7588","9e049ee647cf43ecbcb5ed792a8e7588",4396150,1,0,1,1794,457,457,0
"9e049ee647cf43ecbcb5ed792a8e7588","5256a214faaf410b93f76cea06428334",4396150,1,1,0,1795,457,458,1
"5256a214faaf410b93f76cea06428334","5256a214faaf410b93f76cea06428334",4396150,1,0,1,1796,458,458,0
"5256a214faaf410b93f76cea06428334","25c32b120fce40fa9b6c85133aeb4716",4396150,1,1,0,1797,458,459,1
"25c32b120fce40fa9b6c85133aeb4716","25c32b120fce40fa9b6c85133aeb4716",4396150,1,0,1,1798,459,459,0
"25c32b120fce40fa9b6c85133aeb4716","11bc14f2204949008b7d511b933363c1",4396150,1,1,0,1799,459,460,1
"11bc14f2204949008b7d511b933363c1","11bc14f2204949008b7d511b933363c1",4396150,3,0,1,1800,460,460,0
"11bc14f2204949008b7d511b933363c1","42de338840a34d15adb66e7b14fb9d2c",4396150,1,1,0,1803,460,461,1
"42de338840a34d15adb66e7b14fb9d2c","42de338840a34d15adb66e7b14fb9d2c",4396150,1,0,1,1804,461,461,0
"42de338840a34d15adb66e7b14fb9d2c","9da37c6210b1416b8079c274f70bf600",4396150,1,1,0,1805,461,462,1
"9da37c6210b1416b8079c274f70bf600","9da37c6210b1416b8079c274f70bf600",4396150,3,0,1,1806,462,462,0
"9da37c6210b1416b8079c274f70bf600","519119f1deac45ff9ab4f13529be5c6e",4396150,1,1,0,1809,462,463,1
"519119f1deac45ff9ab4f13529be5c6e","519119f1deac45ff9ab4f13529be5c6e",4396150,5,0,1,1810,463,463,0
"519119f1deac45ff9ab4f13529be5c6e","c5df9f40ec14463b9dcfdc73df3e9285",4396150,1,3,0,1815,463,464,1
"c5df9f40ec14463b9dcfdc73df3e9285","f67fbf45a5f146ed866965bc57c7c001",4396150,1,-12,0,1816,464,454,-10
"f67fbf45a5f146ed866965bc57c7c001","c5df9f40ec14463b9dcfdc73df3e9285",4396150,2,12,0,1817,454,464,10
"c5df9f40ec14463b9dcfdc73df3e9285","070600601c4c439288445d2f0724807d",4396150,2,-41,0,1818,464,437,-27
"0380cd76a7d44bc3a4da1f15e4d68f89","23b7673c8b5443108c2ef09382834a86",4396150,4,2,0,1820,440,441,1
"23b7673c8b5443108c2ef09382834a86","0380cd76a7d44bc3a4da1f15e4d68f89",4396150,1,-2,0,1821,441,440,-1
"23b7673c8b5443108c2ef09382834a86","901e92500aea43c79f19f1b279050668",4396150,4,2,0,1823,441,442,1
"901e92500aea43c79f19f1b279050668","901e92500aea43c79f19f1b279050668",4396150,1,0,1,1824,442,442,0
"901e92500aea43c79f19f1b279050668","001339db8ced4cf78829ebe8b145449d",4396150,1,1,0,1825,442,443,1
"001339db8ced4cf78829ebe8b145449d","001339db8ced4cf78829ebe8b145449d",4396150,12,0,1,1826,443,443,0
"001339db8ced4cf78829ebe8b145449d","452745e0366e42ae81561bfddebcc6c3",4396150,1,1,0,1838,443,444,1
"452745e0366e42ae81561bfddebcc6c3","452745e0366e42ae81561bfddebcc6c3",4396150,2,0,1,1839,444,444,0
"452745e0366e42ae81561bfddebcc6c3","901e92500aea43c79f19f1b279050668",4396150,1,-2,0,1841,444,442,-2
"901e92500aea43c79f19f1b279050668","4660ff2089114e8db82ceb26a4f329e3",4396150,3,4,0,1842,442,445,3
"4660ff2089114e8db82ceb26a4f329e3","7bd5586eb9d8484eb74a433ee7bfe499",4396150,4,2,0,1843,445,446,1
"7bd5586eb9d8484eb74a433ee7bfe499","4660ff2089114e8db82ceb26a4f329e3",4396150,1,-2,0,1844,446,445,-1
"7bd5586eb9d8484eb74a433ee7bfe499","7bd5586eb9d8484eb74a433ee7bfe499",4396150,18,0,1,1846,446,446,0
"7bd5586eb9d8484eb74a433ee7bfe499","8a7f26e690f34dda97be16904518ca99",4396150,1,2,0,1862,446,447,1
"8a7f26e690f34dda97be16904518ca99","8a7f26e690f34dda97be16904518ca99",4396150,1,0,1,1863,447,447,0
"8a7f26e690f34dda97be16904518ca99","070600601c4c439288445d2f0724807d",4396150,1,-16,0,1864,447,437,-10
"070600601c4c439288445d2f0724807d","b2f0d654738f48158edff28e8d3a546e",4396150,3,21,0,1865,437,449,12
"b2f0d654738f48158edff28e8d3a546e","070600601c4c439288445d2f0724807d",4396150,1,-21,0,1866,449,437,-12
"070600601c4c439288445d2f0724807d","070600601c4c439288445d2f0724807d",4396150,3,0,1,1867,437,437,0
"070600601c4c439288445d2f0724807d","1823b6de7d334a7aaabc4570719af4d9",4396150,3,2,0,1868,437,439,2
"0380cd76a7d44bc3a4da1f15e4d68f89","0380cd76a7d44bc3a4da1f15e4d68f89",4396150,1,0,1,1878,440,440,0
"23b7673c8b5443108c2ef09382834a86","23b7673c8b5443108c2ef09382834a86",4396150,2,0,1,1880,441,441,0
"901e92500aea43c79f19f1b279050668","23b7673c8b5443108c2ef09382834a86",4396150,2,-2,0,1883,442,441,-1
"4660ff2089114e8db82ceb26a4f329e3","4660ff2089114e8db82ceb26a4f329e3",4396150,4,0,1,1886,445,445,0
"7bd5586eb9d8484eb74a433ee7bfe499","070600601c4c439288445d2f0724807d",4396150,2,-14,0,1889,446,437,-9
"b2f0d654738f48158edff28e8d3a546e","f60ee41ec635499abd48168342d32c2f",4396150,4,5,0,1891,449,453,4
"f60ee41ec635499abd48168342d32c2f","b2f0d654738f48158edff28e8d3a546e",4396150,2,-5,0,1892,453,449,-4
"f60ee41ec635499abd48168342d32c2f","f60ee41ec635499abd48168342d32c2f",4396150,46,0,1,1894,453,453,0
"f60ee41ec635499abd48168342d32c2f","070600601c4c439288445d2f0724807d",4396150,1,-26,0,1922,453,437,-16
"0380cd76a7d44bc3a4da1f15e4d68f89","070600601c4c439288445d2f0724807d",4396150,1,-4,0,1928,440,437,-3
"23b7673c8b5443108c2ef09382834a86","4660ff2089114e8db82ceb26a4f329e3",4396150,1,6,0,1933,441,445,4
"4660ff2089114e8db82ceb26a4f329e3","901e92500aea43c79f19f1b279050668",4396150,1,-4,0,1934,445,442,-3
"f60ee41ec635499abd48168342d32c2f","f67fbf45a5f146ed866965bc57c7c001",4396150,1,3,0,1964,453,454,1
"f67fbf45a5f146ed866965bc57c7c001","b2f0d654738f48158edff28e8d3a546e",4396150,1,-8,0,1965,454,449,-5
"b2f0d654738f48158edff28e8d3a546e","f67fbf45a5f146ed866965bc57c7c001",4396150,1,8,0,1966,449,454,5
"c5df9f40ec14463b9dcfdc73df3e9285","c5df9f40ec14463b9dcfdc73df3e9285",4396150,6,0,1,1968,464,464,0
"c5df9f40ec14463b9dcfdc73df3e9285","83d42d95cd844fc093fc09cee250edb8",4396150,1,3,0,1970,464,465,1
"83d42d95cd844fc093fc09cee250edb8","83d42d95cd844fc093fc09cee250edb8",4396150,6,0,1,1971,465,465,0
"83d42d95cd844fc093fc09cee250edb8","c5df9f40ec14463b9dcfdc73df3e9285",4396150,1,-3,0,1977,465,464,-1
"c5df9f40ec14463b9dcfdc73df3e9285","b71bac264efb4abd97015447bd490db6",4396150,1,-144,0,1980,464,370,-94
"b71bac264efb4abd97015447bd490db6","1b4550d0dab04078b3bf08a655345bdc",4396150,1,4,0,1981,370,373,3
"1b4550d0dab04078b3bf08a655345bdc","8d448d625b024c82a5eb240bbd7431d6",4396150,1,1,0,1982,373,374,1
"8d448d625b024c82a5eb240bbd7431d6","d6d02b6ef04e4f17805504500b8ce441",4396150,1,3,0,2034,374,375,1
"d6d02b6ef04e4f17805504500b8ce441","b71bac264efb4abd97015447bd490db6",4396150,1,-8,0,2035,375,370,-5
"d6d02b6ef04e4f17805504500b8ce441","a9ac840f098c4bd0a2ee896214ce29cd",4396150,1,-279,0,2037,375,168,-207
"a9ac840f098c4bd0a2ee896214ce29cd","a9ac840f098c4bd0a2ee896214ce29cd",4396150,7,0,1,2038,168,168,0
"a9ac840f098c4bd0a2ee896214ce29cd","0c7262dff33c4087bc660ccf40f92f9c",4396150,4,4,0,2040,168,169,1
"0c7262dff33c4087bc660ccf40f92f9c","b2275c3fad834f8d90737a2d9a6927d6",4396150,5,3,0,2041,169,172,3
"b2275c3fad834f8d90737a2d9a6927d6","b2275c3fad834f8d90737a2d9a6927d6",4396150,28,0,1,2042,172,172,0
"b2275c3fad834f8d90737a2d9a6927d6","eb515a26030b41f8a82a1e6114420bad",4396150,2,1,0,2060,172,173,1
"eb515a26030b41f8a82a1e6114420bad","eb515a26030b41f8a82a1e6114420bad",4396150,4,0,1,2061,173,173,0
"eb515a26030b41f8a82a1e6114420bad","0c7262dff33c4087bc660ccf40f92f9c",4396150,2,-4,0,2063,173,169,-4
"0c7262dff33c4087bc660ccf40f92f9c","b42cc17b7de840f181a704558d0bc845",4396150,4,7,0,2064,169,175,6
"b42cc17b7de840f181a704558d0bc845","c5df9f40ec14463b9dcfdc73df3e9285",4396150,1,404,0,2065,175,464,289
"b613861cecf84ffcab01afb23f660475","b613861cecf84ffcab01afb23f660475",16010095,4,0,1,1,1,1,0
"b613861cecf84ffcab01afb23f660475","e2911e79efc2420eac45d9f671463d4b",16010095,2,3,0,5,1,2,1
"e2911e79efc2420eac45d9f671463d4b","b613861cecf84ffcab01afb23f660475",16010095,1,-3,0,8,2,1,-1
"e2911e79efc2420eac45d9f671463d4b","e2911e79efc2420eac45d9f671463d4b",16010095,4,0,1,10,2,2,0
"e2911e79efc2420eac45d9f671463d4b","519d1b8c59404d67b54e96c5c8a830b2",16010095,1,1,0,12,2,3,1
"519d1b8c59404d67b54e96c5c8a830b2","519d1b8c59404d67b54e96c5c8a830b2",16010095,1,0,1,13,3,3,0
"519d1b8c59404d67b54e96c5c8a830b2","531db53f81f646edb0cdcfe0085b03b7",16010095,1,1,0,14,3,4,1
"531db53f81f646edb0cdcfe0085b03b7","531db53f81f646edb0cdcfe0085b03b7",16010095,1,0,1,15,4,4,0
"531db53f81f646edb0cdcfe0085b03b7","4f5f94b2f95141e0a9d53a61da2276da",16010095,1,1,0,16,4,5,1
"4f5f94b2f95141e0a9d53a61da2276da","4f5f94b2f95141e0a9d53a61da2276da",16010095,1,0,1,17,5,5,0
"4f5f94b2f95141e0a9d53a61da2276da","6d541c89590949f99af293c4f2333f67",16010095,1,1,0,18,5,6,1
"6d541c89590949f99af293c4f2333f67","6d541c89590949f99af293c4f2333f67",16010095,1,0,1,19,6,6,0
"6d541c89590949f99af293c4f2333f67","dd5cf0b9fe4c4f1d8f5ff8e4c04879cb",16010095,1,1,0,20,6,7,1
"dd5cf0b9fe4c4f1d8f5ff8e4c04879cb","dd5cf0b9fe4c4f1d8f5ff8e4c04879cb",16010095,1,0,1,21,7,7,0
"dd5cf0b9fe4c4f1d8f5ff8e4c04879cb","f96261861edc426abe2248be4f0a709a",16010095,1,1,0,22,7,8,1
"f96261861edc426abe2248be4f0a709a","f96261861edc426abe2248be4f0a709a",16010095,1,0,1,23,8,8,0
"f96261861edc426abe2248be4f0a709a","66b5e16f4f75454fb5b8172079f0fa83",16010095,1,1,0,24,8,9,1
"66b5e16f4f75454fb5b8172079f0fa83","66b5e16f4f75454fb5b8172079f0fa83",16010095,1,0,1,25,9,9,0
"66b5e16f4f75454fb5b8172079f0fa83","0680571d4698477995e41842c36a54b2",16010095,1,1,0,26,9,10,1
"0680571d4698477995e41842c36a54b2","0680571d4698477995e41842c36a54b2",16010095,1,0,1,27,10,10,0
"0680571d4698477995e41842c36a54b2","9112f2bffece48e08c6d2287be204085",16010095,1,1,0,28,10,11,1
"9112f2bffece48e08c6d2287be204085","9112f2bffece48e08c6d2287be204085",16010095,1,0,1,29,11,11,0
"9112f2bffece48e08c6d2287be204085","e2911e79efc2420eac45d9f671463d4b",16010095,1,-9,0,30,11,2,-9
"e2911e79efc2420eac45d9f671463d4b","56586aa865414f538729c7f7735d2bc6",16010095,1,12,0,31,2,12,10
"56586aa865414f538729c7f7735d2bc6","56586aa865414f538729c7f7735d2bc6",16010095,11,0,1,32,12,12,0
"56586aa865414f538729c7f7735d2bc6","b7f2b31585d94eb3bf86376714aa7070",16010095,1,2,0,40,12,13,1
"b7f2b31585d94eb3bf86376714aa7070","b7f2b31585d94eb3bf86376714aa7070",16010095,5,0,1,41,13,13,0
"b7f2b31585d94eb3bf86376714aa7070","3f1c815879794b929260d224becaff7e",16010095,1,2,0,46,13,14,1
"3f1c815879794b929260d224becaff7e","81c864a886d54a6b8ff85f7d736f4f95",16010095,1,2,0,47,14,15,1
"81c864a886d54a6b8ff85f7d736f4f95","5c5ceeee4562457ba6d41515aeebfbb1",16010095,1,4,0,48,15,17,2
"5c5ceeee4562457ba6d41515aeebfbb1","5c5ceeee4562457ba6d41515aeebfbb1",16010095,3,0,1,49,17,17,0
"5c5ceeee4562457ba6d41515aeebfbb1","b613861cecf84ffcab01afb23f660475",16010095,1,-25,0,50,17,1,-16
"b613861cecf84ffcab01afb23f660475","5c5ceeee4562457ba6d41515aeebfbb1",16010095,1,25,0,51,1,17,16
"5c5ceeee4562457ba6d41515aeebfbb1","56586aa865414f538729c7f7735d2bc6",16010095,2,-10,0,53,17,12,-5
"56586aa865414f538729c7f7735d2bc6","5c5ceeee4562457ba6d41515aeebfbb1",16010095,1,10,0,57,12,17,5
"56586aa865414f538729c7f7735d2bc6","9afd71a5298d4333b6849dfce1b9422c",16010095,1,13,0,60,12,18,6
"9afd71a5298d4333b6849dfce1b9422c","9afd71a5298d4333b6849dfce1b9422c",16010095,1,0,1,61,18,18,0
"9afd71a5298d4333b6849dfce1b9422c","b7719e26494940efa49512aedd0aac79",16010095,1,4,0,62,18,20,2
"b7719e26494940efa49512aedd0aac79","d4f45188d3c84a02ba08454e6403a818",16010095,1,5,0,63,20,24,4
"d4f45188d3c84a02ba08454e6403a818","d4c3b003e8274e429d2fa688d73fde6d",16010095,1,-2,0,64,24,22,-2
"d4c3b003e8274e429d2fa688d73fde6d","a49d1bb4328949299686242fd0be5584",16010095,1,-1,0,65,22,21,-1
"a49d1bb4328949299686242fd0be5584","b7719e26494940efa49512aedd0aac79",16010095,1,-2,0,66,21,20,-1
"b7719e26494940efa49512aedd0aac79","b7719e26494940efa49512aedd0aac79",16010095,1,0,1,67,20,20,0
"b7719e26494940efa49512aedd0aac79","afbf7250b99d47bea07172749483ca97",16010095,1,12,0,68,20,28,8
"afbf7250b99d47bea07172749483ca97","afbf7250b99d47bea07172749483ca97",16010095,1,0,1,69,28,28,0
"afbf7250b99d47bea07172749483ca97","4e51676dc72045d99c19b9fa7b22f8bc",16010095,1,3,0,70,28,29,1
"4e51676dc72045d99c19b9fa7b22f8bc","4e51676dc72045d99c19b9fa7b22f8bc",16010095,1,0,1,71,29,29,0
"4e51676dc72045d99c19b9fa7b22f8bc","51970cfa30e643e894e66ae85c8024cc",16010095,1,3,0,72,29,31,2
"51970cfa30e643e894e66ae85c8024cc","4e51676dc72045d99c19b9fa7b22f8bc",16010095,1,-3,0,73,31,29,-2
"4e51676dc72045d99c19b9fa7b22f8bc","c33c17be71ae4d588da7369472e5bb1b",16010095,1,9,0,74,29,34,5
"c33c17be71ae4d588da7369472e5bb1b","c33c17be71ae4d588da7369472e5bb1b",16010095,1,0,1,75,34,34,0
"c33c17be71ae4d588da7369472e5bb1b","93679be414554a11b1893002f2229a93",16010095,1,3,0,76,34,35,1
"93679be414554a11b1893002f2229a93","7040a13096d746ac84b8fac8d9752058",16010095,2,3,0,77,35,36,1
"7040a13096d746ac84b8fac8d9752058","93679be414554a11b1893002f2229a93",16010095,1,-3,0,78,36,35,-1
"93679be414554a11b1893002f2229a93","9a0dc646f934470daf08c4b56ccf73db",16010095,1,6,0,79,35,37,2
"9a0dc646f934470daf08c4b56ccf73db","7040a13096d746ac84b8fac8d9752058",16010095,1,-3,0,80,37,36,-1
"7040a13096d746ac84b8fac8d9752058","fc0e049d56024bc9a02c9a9c435c3df7",16010095,1,6,0,81,36,38,2
"fc0e049d56024bc9a02c9a9c435c3df7","9a0dc646f934470daf08c4b56ccf73db",16010095,1,-3,0,82,38,37,-1
"9a0dc646f934470daf08c4b56ccf73db","fc0e049d56024bc9a02c9a9c435c3df7",16010095,2,3,0,83,37,38,1
"fc0e049d56024bc9a02c9a9c435c3df7","67a089198fcb4e1c8f2385786c2b296f",16010095,3,4,0,84,38,39,1
"64d48c6c9c7940639a932219a6c87198","64d48c6c9c7940639a932219a6c87198",16010095,2,0,1,86,40,40,0
"64d48c6c9c7940639a932219a6c87198","b534b89233134e30a9b5645138bfa9ee",16010095,1,3,0,88,40,41,1
"b534b89233134e30a9b5645138bfa9ee","67a089198fcb4e1c8f2385786c2b296f",16010095,1,-4,0,89,41,39,-2
"67a089198fcb4e1c8f2385786c2b296f","0e37b720d23b4e7f8b313e79313fd107",16010095,1,7,0,90,39,44,5
"0e37b720d23b4e7f8b313e79313fd107","0e37b720d23b4e7f8b313e79313fd107",16010095,3,0,1,91,44,44,0
"0e37b720d23b4e7f8b313e79313fd107","6875d67fdd5f48168b62719df449bebd",16010095,1,1,0,94,44,45,1
"6875d67fdd5f48168b62719df449bebd","6875d67fdd5f48168b62719df449bebd",16010095,1,0,1,95,45,45,0
"6875d67fdd5f48168b62719df449bebd","b534b89233134e30a9b5645138bfa9ee",16010095,1,-4,0,96,45,41,-4
"6e13d61a7bdb44bca949c9f86fab3be5","6e13d61a7bdb44bca949c9f86fab3be5",16010095,2,0,1,98,47,47,0
"6e13d61a7bdb44bca949c9f86fab3be5","195f78799f984cc2b06c48dfe36be751",16010095,1,2,0,100,47,49,2
"195f78799f984cc2b06c48dfe36be751","195f78799f984cc2b06c48dfe36be751",16010095,2,0,1,101,49,49,0
"195f78799f984cc2b06c48dfe36be751","d9c8d8c444a64dadbbb508652c721e17",16010095,1,-3,0,103,49,46,-3
"d9c8d8c444a64dadbbb508652c721e17","d0c74f735e024943943e40333d6d337f",16010095,1,6,0,104,46,51,5
"d0c74f735e024943943e40333d6d337f","d0c74f735e024943943e40333d6d337f",16010095,2,0,1,105,51,51,0
"d0c74f735e024943943e40333d6d337f","983f8ff320594b279a7f4a6fe132f9c5",16010095,1,2,0,107,51,53,2
"983f8ff320594b279a7f4a6fe132f9c5","983f8ff320594b279a7f4a6fe132f9c5",16010095,2,0,1,108,53,53,0
"983f8ff320594b279a7f4a6fe132f9c5","35adfa5d923046aebabfefd98f35ff05",16010095,1,1,0,110,53,54,1
"35adfa5d923046aebabfefd98f35ff05","35adfa5d923046aebabfefd98f35ff05",16010095,8,0,1,111,54,54,0
"35adfa5d923046aebabfefd98f35ff05","b6f8a98476224da1b40e555ececc7ed8",16010095,1,1,0,119,54,55,1
"b6f8a98476224da1b40e555ececc7ed8","b6f8a98476224da1b40e555ececc7ed8",16010095,2,0,1,120,55,55,0
"b6f8a98476224da1b40e555ececc7ed8","86e22cb5fe0e4b47a9489ecddf7ed78f",16010095,1,1,0,122,55,56,1
"86e22cb5fe0e4b47a9489ecddf7ed78f","86e22cb5fe0e4b47a9489ecddf7ed78f",16010095,2,0,1,123,56,56,0
"86e22cb5fe0e4b47a9489ecddf7ed78f","f924752d8a1149668870b1e7698486f7",16010095,1,-6,0,125,56,50,-6
"f924752d8a1149668870b1e7698486f7","a1f2f12debe5432fb7a70bcd12bacfb9",16010095,1,9,0,126,50,58,8
"a1f2f12debe5432fb7a70bcd12bacfb9","78f30e4dcac84e3cbea8b2cc6e0d62b3",16010095,2,1,0,127,58,59,1
"78f30e4dcac84e3cbea8b2cc6e0d62b3","a1f2f12debe5432fb7a70bcd12bacfb9",16010095,1,-1,0,128,59,58,-1
"a1f2f12debe5432fb7a70bcd12bacfb9","a1f2f12debe5432fb7a70bcd12bacfb9",16010095,17,0,1,129,58,58,0
"78f30e4dcac84e3cbea8b2cc6e0d62b3","78f30e4dcac84e3cbea8b2cc6e0d62b3",16010095,7,0,1,147,59,59,0
"78f30e4dcac84e3cbea8b2cc6e0d62b3","12aa6e1672ac4e7aa6449a7a8609cd72",16010095,1,-2,0,154,59,57,-2
"12aa6e1672ac4e7aa6449a7a8609cd72","bc42d26810654ea9a1df1efe1e58c7d5",16010095,1,7,0,155,57,63,6
"bc42d26810654ea9a1df1efe1e58c7d5","a0a418b8540d479fa6e0f653b701da8b",16010095,2,1,0,156,63,64,1
"a0a418b8540d479fa6e0f653b701da8b","4c943503763e4e349906eea3ed3c8e86",16010095,1,-3,0,157,64,61,-3
"4c943503763e4e349906eea3ed3c8e86","4c943503763e4e349906eea3ed3c8e86",16010095,1,0,1,158,61,61,0
"4c943503763e4e349906eea3ed3c8e86","bc42d26810654ea9a1df1efe1e58c7d5",16010095,1,2,0,159,61,63,2
"bc42d26810654ea9a1df1efe1e58c7d5","bc42d26810654ea9a1df1efe1e58c7d5",16010095,3,0,1,160,63,63,0
"a0a418b8540d479fa6e0f653b701da8b","a0a418b8540d479fa6e0f653b701da8b",16010095,3,0,1,164,64,64,0
"a0a418b8540d479fa6e0f653b701da8b","309ccf3cc4fe429d9bfbaef53d3fa479",16010095,1,-4,0,167,64,60,-4
"309ccf3cc4fe429d9bfbaef53d3fa479","d646286c8051419bbc2e31dd1db55ca8",16010095,1,10,0,168,60,67,7
"d646286c8051419bbc2e31dd1db55ca8","b534b89233134e30a9b5645138bfa9ee",16010095,1,-33,0,169,67,41,-26
"b534b89233134e30a9b5645138bfa9ee","d646286c8051419bbc2e31dd1db55ca8",16010095,1,33,0,170,41,67,26
"d646286c8051419bbc2e31dd1db55ca8","d646286c8051419bbc2e31dd1db55ca8",16010095,2,0,1,171,67,67,0
"d646286c8051419bbc2e31dd1db55ca8","267f883678b24aed855fde42524975d9",16010095,1,4,0,172,67,71,4
"267f883678b24aed855fde42524975d9","267f883678b24aed855fde42524975d9",16010095,1,0,1,173,71,71,0
"267f883678b24aed855fde42524975d9","88fff56d0342490dbef9040750a20f6c",16010095,1,1,0,174,71,72,1
"88fff56d0342490dbef9040750a20f6c","88fff56d0342490dbef9040750a20f6c",16010095,1,0,1,175,72,72,0
"88fff56d0342490dbef9040750a20f6c","adb17b12b66c4a49a85fd34322f7df70",16010095,1,1,0,176,72,73,1
"adb17b12b66c4a49a85fd34322f7df70","adb17b12b66c4a49a85fd34322f7df70",16010095,1,0,1,177,73,73,0
"adb17b12b66c4a49a85fd34322f7df70","d646286c8051419bbc2e31dd1db55ca8",16010095,1,-6,0,178,73,67,-6
"d646286c8051419bbc2e31dd1db55ca8","a2becd407db34b189200a32546d9d569",16010095,1,9,0,179,67,75,8
"a2becd407db34b189200a32546d9d569","140d5b27b8574befad82c0a013b59dfa",16010095,1,-1,0,180,75,74,-1
"140d5b27b8574befad82c0a013b59dfa","d646286c8051419bbc2e31dd1db55ca8",16010095,1,-8,0,181,74,67,-7
"d646286c8051419bbc2e31dd1db55ca8","140d5b27b8574befad82c0a013b59dfa",16010095,1,8,0,183,67,74,7
"140d5b27b8574befad82c0a013b59dfa","a2becd407db34b189200a32546d9d569",16010095,1,1,0,184,74,75,1
"a2becd407db34b189200a32546d9d569","a2becd407db34b189200a32546d9d569",16010095,1,0,1,185,75,75,0
"a2becd407db34b189200a32546d9d569","58c22b011d0f4c2ea6d13615edbb9eeb",16010095,1,2,0,186,75,77,2
"58c22b011d0f4c2ea6d13615edbb9eeb","58c22b011d0f4c2ea6d13615edbb9eeb",16010095,2,0,1,187,77,77,0
"58c22b011d0f4c2ea6d13615edbb9eeb","dd76e1861dc9461c830888729d091ee0",16010095,1,1,0,189,77,78,1
"dd76e1861dc9461c830888729d091ee0","dd76e1861dc9461c830888729d091ee0",16010095,5,0,1,190,78,78,0
"dd76e1861dc9461c830888729d091ee0","cd1d828f1a694b87913a7ea66c23803e",16010095,1,1,0,195,78,79,1
"cd1d828f1a694b87913a7ea66c23803e","cd1d828f1a694b87913a7ea66c23803e",16010095,2,0,1,196,79,79,0
"cd1d828f1a694b87913a7ea66c23803e","9176a3c2b4d2465fa8b0c67096c2a97e",16010095,1,1,0,198,79,80,1
"9176a3c2b4d2465fa8b0c67096c2a97e","9176a3c2b4d2465fa8b0c67096c2a97e",16010095,17,0,1,199,80,80,0
"9176a3c2b4d2465fa8b0c67096c2a97e","f8ec6445f7194e25b9101d4fbcb07a18",16010095,1,1,0,216,80,81,1
"f8ec6445f7194e25b9101d4fbcb07a18","f8ec6445f7194e25b9101d4fbcb07a18",16010095,2,0,1,217,81,81,0
"f8ec6445f7194e25b9101d4fbcb07a18","140d5b27b8574befad82c0a013b59dfa",16010095,1,-7,0,219,81,74,-7
"140d5b27b8574befad82c0a013b59dfa","d18a9ea32855445f8736581f5cb119ce",16010095,1,9,0,220,74,82,8
"d18a9ea32855445f8736581f5cb119ce","f564483cbd7a407681aa2fcca518cf5f",16010095,1,4,0,221,82,85,3
"f564483cbd7a407681aa2fcca518cf5f","f564483cbd7a407681aa2fcca518cf5f",16010095,1,0,1,222,85,85,0
"f564483cbd7a407681aa2fcca518cf5f","18fd01350bd5434ca636d59a599d768a",16010095,1,1,0,223,85,86,1
"18fd01350bd5434ca636d59a599d768a","18fd01350bd5434ca636d59a599d768a",16010095,9,0,1,224,86,86,0
"18fd01350bd5434ca636d59a599d768a","ae5ac430ea254e708a6f5deaaf7464ae",16010095,1,-2,0,233,86,84,-2
"ae5ac430ea254e708a6f5deaaf7464ae","6a9f0ef185fb47f0937e29daa1c71ed5",16010095,1,7,0,234,84,90,6
"6a9f0ef185fb47f0937e29daa1c71ed5","c681290961c94c4caf23b529d1ae6b9a",16010095,1,-2,0,235,90,88,-2
"c681290961c94c4caf23b529d1ae6b9a","c681290961c94c4caf23b529d1ae6b9a",16010095,4,0,1,236,88,88,0
"c681290961c94c4caf23b529d1ae6b9a","6a9f0ef185fb47f0937e29daa1c71ed5",16010095,1,2,0,240,88,90,2
"6a9f0ef185fb47f0937e29daa1c71ed5","6a9f0ef185fb47f0937e29daa1c71ed5",16010095,5,0,1,241,90,90,0
"6a9f0ef185fb47f0937e29daa1c71ed5","d646286c8051419bbc2e31dd1db55ca8",16010095,1,-27,0,244,90,67,-23
"d646286c8051419bbc2e31dd1db55ca8","e20db35ced8544ddac5bc3839145e463",16010095,2,30,0,245,67,91,24
"e20db35ced8544ddac5bc3839145e463","d646286c8051419bbc2e31dd1db55ca8",16010095,1,-30,0,246,91,67,-24
"e20db35ced8544ddac5bc3839145e463","1febb706d7a34005ae8711ed49c76e64",16010095,1,3,0,248,91,94,3
"1febb706d7a34005ae8711ed49c76e64","1febb706d7a34005ae8711ed49c76e64",16010095,2,0,1,249,94,94,0
"1febb706d7a34005ae8711ed49c76e64","8f73ba6f5a0042f2850356ac38ac6f24",16010095,1,1,0,251,94,95,1
"8f73ba6f5a0042f2850356ac38ac6f24","8f73ba6f5a0042f2850356ac38ac6f24",16010095,2,0,1,252,95,95,0
"8f73ba6f5a0042f2850356ac38ac6f24","e2260b86653c46d7b14a41fb419dbf8c",16010095,1,1,0,254,95,96,1
"e2260b86653c46d7b14a41fb419dbf8c","e2260b86653c46d7b14a41fb419dbf8c",16010095,2,0,1,255,96,96,0
"e2260b86653c46d7b14a41fb419dbf8c","35eb641ad1d845bbba54915bce75a962",16010095,1,1,0,257,96,97,1
"35eb641ad1d845bbba54915bce75a962","35eb641ad1d845bbba54915bce75a962",16010095,2,0,1,258,97,97,0
"35eb641ad1d845bbba54915bce75a962","08be90ffbeea4795a138cd42ed8db56f",16010095,1,1,0,260,97,98,1
"08be90ffbeea4795a138cd42ed8db56f","08be90ffbeea4795a138cd42ed8db56f",16010095,5,0,1,261,98,98,0
"08be90ffbeea4795a138cd42ed8db56f","3007433c8f584dcbb5ac159c1c5f2be3",16010095,1,1,0,266,98,99,1
"3007433c8f584dcbb5ac159c1c5f2be3","3007433c8f584dcbb5ac159c1c5f2be3",16010095,2,0,1,267,99,99,0
"3007433c8f584dcbb5ac159c1c5f2be3","e20db35ced8544ddac5bc3839145e463",16010095,1,-8,0,269,99,91,-8
"e20db35ced8544ddac5bc3839145e463","00ae5f0c51874a73a41ebea838d95682",16010095,1,11,0,270,91,101,10
"00ae5f0c51874a73a41ebea838d95682","d391c8b6e56a43a7b654e9dee02d904b",16010095,2,2,0,271,101,103,2
"d391c8b6e56a43a7b654e9dee02d904b","00ae5f0c51874a73a41ebea838d95682",16010095,1,-2,0,272,103,101,-2
"d391c8b6e56a43a7b654e9dee02d904b","d391c8b6e56a43a7b654e9dee02d904b",16010095,15,0,1,274,103,103,0
"d391c8b6e56a43a7b654e9dee02d904b","6111116566fc4fd9abba409322bea245",16010095,1,1,0,289,103,104,1
"6111116566fc4fd9abba409322bea245","6111116566fc4fd9abba409322bea245",16010095,2,0,1,290,104,104,0
"6111116566fc4fd9abba409322bea245","a81b2235cb9c499eb9ea8ee0a8dd9725",16010095,1,1,0,292,104,105,1
"a81b2235cb9c499eb9ea8ee0a8dd9725","a81b2235cb9c499eb9ea8ee0a8dd9725",16010095,2,0,1,293,105,105,0
"a81b2235cb9c499eb9ea8ee0a8dd9725","2d4e0ab0ef3b4d73b82c72d4621a7579",16010095,1,1,0,295,105,106,1
"2d4e0ab0ef3b4d73b82c72d4621a7579","2d4e0ab0ef3b4d73b82c72d4621a7579",16010095,2,0,1,296,106,106,0
"2d4e0ab0ef3b4d73b82c72d4621a7579","8bdebf492ebd4e62b0d522e8ab5e5197",16010095,1,1,0,298,106,107,1
"8bdebf492ebd4e62b0d522e8ab5e5197","8bdebf492ebd4e62b0d522e8ab5e5197",16010095,2,0,1,299,107,107,0
"8bdebf492ebd4e62b0d522e8ab5e5197","73039f8c1eb9409cb4caee2cf968001e",16010095,1,-7,0,301,107,100,-7
"73039f8c1eb9409cb4caee2cf968001e","4280927ec4d643238aa49c32f9e06c6c",16010095,1,10,0,302,100,109,9
"4280927ec4d643238aa49c32f9e06c6c","fc44e6a5f7654430af1227838224dceb",16010095,1,2,0,303,109,111,2
"fc44e6a5f7654430af1227838224dceb","fc44e6a5f7654430af1227838224dceb",16010095,2,0,1,304,111,111,0
"fc44e6a5f7654430af1227838224dceb","4280927ec4d643238aa49c32f9e06c6c",16010095,1,-2,0,306,111,109,-2
"4280927ec4d643238aa49c32f9e06c6c","08111f75e22d409998cf8b85bd431f0a",16010095,1,-1,0,307,109,108,-1
"08111f75e22d409998cf8b85bd431f0a","a9ae0a3c070d455bb4369a8996313336",16010095,1,7,0,308,108,114,6
"a9ae0a3c070d455bb4369a8996313336","a9ae0a3c070d455bb4369a8996313336",16010095,1,0,1,309,114,114,0
"a9ae0a3c070d455bb4369a8996313336","71cec822bcff4f30a20e75dc63ef7b65",16010095,1,2,0,310,114,116,2
"71cec822bcff4f30a20e75dc63ef7b65","71cec822bcff4f30a20e75dc63ef7b65",16010095,1,0,1,311,116,116,0
"71cec822bcff4f30a20e75dc63ef7b65","37319e88176d4aefa91d7a9980dbae91",16010095,1,-4,0,312,116,112,-4
"37319e88176d4aefa91d7a9980dbae91","62bff51286ef4f348717a3cf6fe2318f",16010095,1,9,0,313,112,120,8
"62bff51286ef4f348717a3cf6fe2318f","b1cd0e7dc3ad4a8eb91a4bfdbeb025b0",16010095,1,-2,0,314,120,118,-2
"b1cd0e7dc3ad4a8eb91a4bfdbeb025b0","b1cd0e7dc3ad4a8eb91a4bfdbeb025b0",16010095,1,0,1,315,118,118,0
"b1cd0e7dc3ad4a8eb91a4bfdbeb025b0","62bff51286ef4f348717a3cf6fe2318f",16010095,1,2,0,316,118,120,2
"62bff51286ef4f348717a3cf6fe2318f","62bff51286ef4f348717a3cf6fe2318f",16010095,3,0,1,317,120,120,0
"62bff51286ef4f348717a3cf6fe2318f","e20db35ced8544ddac5bc3839145e463",16010095,1,-33,0,320,120,91,-29
"e20db35ced8544ddac5bc3839145e463","779f9ddd1fd14d1e9e69f72219a1fdbd",16010095,1,36,0,321,91,121,30
"779f9ddd1fd14d1e9e69f72219a1fdbd","67a089198fcb4e1c8f2385786c2b296f",16010095,1,-103,0,322,121,39,-82
"67a089198fcb4e1c8f2385786c2b296f","779f9ddd1fd14d1e9e69f72219a1fdbd",16010095,1,103,0,323,39,121,82
"779f9ddd1fd14d1e9e69f72219a1fdbd","779f9ddd1fd14d1e9e69f72219a1fdbd",16010095,1,0,1,324,121,121,0
"779f9ddd1fd14d1e9e69f72219a1fdbd","ae26e6cda8ad4a3f81bd347560d9579f",16010095,1,4,0,325,121,125,4
"ae26e6cda8ad4a3f81bd347560d9579f","ae26e6cda8ad4a3f81bd347560d9579f",16010095,1,0,1,326,125,125,0
"ae26e6cda8ad4a3f81bd347560d9579f","ee48df95832b4374aa273ceb27ec1315",16010095,1,1,0,327,125,126,1
"ee48df95832b4374aa273ceb27ec1315","ee48df95832b4374aa273ceb27ec1315",16010095,1,0,1,328,126,126,0
"ee48df95832b4374aa273ceb27ec1315","7a439da90b394756ad1777fc4c6dead5",16010095,1,1,0,329,126,127,1
"7a439da90b394756ad1777fc4c6dead5","7a439da90b394756ad1777fc4c6dead5",16010095,1,0,1,330,127,127,0
"7a439da90b394756ad1777fc4c6dead5","779f9ddd1fd14d1e9e69f72219a1fdbd",16010095,1,-6,0,331,127,121,-6
"779f9ddd1fd14d1e9e69f72219a1fdbd","a8dd5213034441ac92724b4e83eb0bb2",16010095,1,9,0,332,121,129,8
"a8dd5213034441ac92724b4e83eb0bb2","a8dd5213034441ac92724b4e83eb0bb2",16010095,1,0,1,333,129,129,0
"a8dd5213034441ac92724b4e83eb0bb2","8115eab6556b45f5b415c3b8c26a12e5",16010095,1,2,0,334,129,131,2
"8115eab6556b45f5b415c3b8c26a12e5","8115eab6556b45f5b415c3b8c26a12e5",16010095,5,0,1,335,131,131,0
"8115eab6556b45f5b415c3b8c26a12e5","ec34b06efd844b46a4c4818ecdb9b8f4",16010095,1,1,0,340,131,132,1
"ec34b06efd844b46a4c4818ecdb9b8f4","ec34b06efd844b46a4c4818ecdb9b8f4",16010095,2,0,1,341,132,132,0
"ec34b06efd844b46a4c4818ecdb9b8f4","c2e1c2b9eac64109b343a088584b576b",16010095,1,1,0,343,132,133,1
"c2e1c2b9eac64109b343a088584b576b","c2e1c2b9eac64109b343a088584b576b",16010095,2,0,1,344,133,133,0
"c2e1c2b9eac64109b343a088584b576b","579338175e0b4bbb8ef3b712b5d8b54e",16010095,1,-5,0,346,133,128,-5
"579338175e0b4bbb8ef3b712b5d8b54e","8bc5795d6a984a3eace4e2811e52dd4f",16010095,1,8,0,347,128,135,7
"8bc5795d6a984a3eace4e2811e52dd4f","8bc5795d6a984a3eace4e2811e52dd4f",16010095,1,0,1,348,135,135,0
"8bc5795d6a984a3eace4e2811e52dd4f","b416d47c56a742199b5d7c7f19d6503a",16010095,1,-1,0,349,135,134,-1
"b416d47c56a742199b5d7c7f19d6503a","cd4532ad48034873ba8bce2aac0c9808",16010095,1,4,0,350,134,137,3
"cd4532ad48034873ba8bce2aac0c9808","cd4532ad48034873ba8bce2aac0c9808",16010095,1,0,1,351,137,137,0
"cd4532ad48034873ba8bce2aac0c9808","df1de691dafe4549a18a4398ee9dfaf9",16010095,1,4,0,352,137,139,2
"df1de691dafe4549a18a4398ee9dfaf9","779f9ddd1fd14d1e9e69f72219a1fdbd",16010095,1,-23,0,353,139,121,-18
"779f9ddd1fd14d1e9e69f72219a1fdbd","6c5ad271a44743479bfaea29b1db8d02",16010095,1,27,0,354,121,143,22
"6c5ad271a44743479bfaea29b1db8d02","67a089198fcb4e1c8f2385786c2b296f",16010095,1,-130,0,355,143,39,-104
"67a089198fcb4e1c8f2385786c2b296f","df1de691dafe4549a18a4398ee9dfaf9",16010095,2,126,0,356,39,139,100
"df1de691dafe4549a18a4398ee9dfaf9","6c5ad271a44743479bfaea29b1db8d02",16010095,1,4,0,357,139,143,4
"6c5ad271a44743479bfaea29b1db8d02","6c5ad271a44743479bfaea29b1db8d02",16010095,1,0,1,358,143,143,0
"6c5ad271a44743479bfaea29b1db8d02","83d311bed5374fee83d8d67a7d9d82dc",16010095,1,1,0,359,143,144,1
"83d311bed5374fee83d8d67a7d9d82dc","83d311bed5374fee83d8d67a7d9d82dc",16010095,1,0,1,360,144,144,0
"83d311bed5374fee83d8d67a7d9d82dc","402bba41861d43acb52a5abb89e8831e",16010095,1,1,0,361,144,145,1
"402bba41861d43acb52a5abb89e8831e","402bba41861d43acb52a5abb89e8831e",16010095,5,0,1,362,145,145,0
"402bba41861d43acb52a5abb89e8831e","8aae34f5ddbb4052a709b12e6b0d40fa",16010095,1,3,0,367,145,147,2
"8aae34f5ddbb4052a709b12e6b0d40fa","df1de691dafe4549a18a4398ee9dfaf9",16010095,1,-9,0,368,147,139,-8
"df1de691dafe4549a18a4398ee9dfaf9","8aae34f5ddbb4052a709b12e6b0d40fa",16010095,3,9,0,369,139,147,8
"8aae34f5ddbb4052a709b12e6b0d40fa","645b3f0249f64f76af2e19eb4d0e55b7",16010095,1,2,0,370,147,149,2
"645b3f0249f64f76af2e19eb4d0e55b7","645b3f0249f64f76af2e19eb4d0e55b7",16010095,8,0,1,371,149,149,0
"645b3f0249f64f76af2e19eb4d0e55b7","7e7b8db5064d4369805ab370aac5ddfb",16010095,1,1,0,379,149,150,1
"7e7b8db5064d4369805ab370aac5ddfb","7e7b8db5064d4369805ab370aac5ddfb",16010095,5,0,1,380,150,150,0
"7e7b8db5064d4369805ab370aac5ddfb","8956d210ae7f41968fada86d4c979d6a",16010095,1,1,0,385,150,151,1
"8956d210ae7f41968fada86d4c979d6a","8956d210ae7f41968fada86d4c979d6a",16010095,2,0,1,386,151,151,0
"8956d210ae7f41968fada86d4c979d6a","f902b0f41b544d4dbf79664fd233648d",16010095,1,-5,0,388,151,146,-5
"f902b0f41b544d4dbf79664fd233648d","ae781e8b775e4ccd93bc800dad5c8376",16010095,1,8,0,389,146,153,7
"ae781e8b775e4ccd93bc800dad5c8376","ae781e8b775e4ccd93bc800dad5c8376",16010095,2,0,1,390,153,153,0
"ae781e8b775e4ccd93bc800dad5c8376","06882a8492d9499aa31555567f575ecb",16010095,1,1,0,392,153,154,1
"06882a8492d9499aa31555567f575ecb","06882a8492d9499aa31555567f575ecb",16010095,1,0,1,393,154,154,0
"06882a8492d9499aa31555567f575ecb","f293c508f409466a8f27ddd7d1e40b20",16010095,1,1,0,394,154,155,1
"f293c508f409466a8f27ddd7d1e40b20","f293c508f409466a8f27ddd7d1e40b20",16010095,2,0,1,395,155,155,0
"f293c508f409466a8f27ddd7d1e40b20","cc4ddef5bbbe48ebb605141b347c4ed1",16010095,1,1,0,397,155,156,1
"cc4ddef5bbbe48ebb605141b347c4ed1","cc4ddef5bbbe48ebb605141b347c4ed1",16010095,1,0,1,398,156,156,0
"cc4ddef5bbbe48ebb605141b347c4ed1","f03480cf4eba413194d7af52fc0e7f28",16010095,1,-4,0,399,156,152,-4
"f03480cf4eba413194d7af52fc0e7f28","d313cec988a84645bee413e8d4724a4b",16010095,1,7,0,400,152,158,6
"d313cec988a84645bee413e8d4724a4b","d313cec988a84645bee413e8d4724a4b",16010095,4,0,1,401,158,158,0
"d313cec988a84645bee413e8d4724a4b","dc60696c76a74368a60f72246e47700d",16010095,1,1,0,405,158,159,1
"dc60696c76a74368a60f72246e47700d","dc60696c76a74368a60f72246e47700d",16010095,3,0,1,406,159,159,0
"dc60696c76a74368a60f72246e47700d","78adeee1fa2c4fe0bc73f7bca9fcee86",16010095,1,3,0,409,159,160,1
"78adeee1fa2c4fe0bc73f7bca9fcee86","df1de691dafe4549a18a4398ee9dfaf9",16010095,1,-26,0,410,160,139,-21
"df1de691dafe4549a18a4398ee9dfaf9","df1de691dafe4549a18a4398ee9dfaf9",16010095,1,0,1,411,139,139,0
"df1de691dafe4549a18a4398ee9dfaf9","78adeee1fa2c4fe0bc73f7bca9fcee86",16010095,1,26,0,412,139,160,21
"82e6285962b8400d9d6fc32436022a94","a9ac840f098c4bd0a2ee896214ce29cd",16010095,1,3,0,424,167,168,1
"a9ac840f098c4bd0a2ee896214ce29cd","3cbcea2be0984e7dbd5a48195af10ce7",16010095,1,-5,0,425,168,165,-3
"3cbcea2be0984e7dbd5a48195af10ce7","67a089198fcb4e1c8f2385786c2b296f",16010095,1,-160,0,426,165,39,-126
"67a089198fcb4e1c8f2385786c2b296f","8959e6304a0348309a771e4d08d1b64a",16010095,1,156,0,427,39,163,124
"65202579580f4ad38d734b4ee39d22a8","8959e6304a0348309a771e4d08d1b64a",16010095,1,-1,0,437,164,163,-1
"3cbcea2be0984e7dbd5a48195af10ce7","78adeee1fa2c4fe0bc73f7bca9fcee86",16010095,1,-8,0,449,165,160,-5
"82e6285962b8400d9d6fc32436022a94","0c7262dff33c4087bc660ccf40f92f9c",16010095,1,7,0,452,167,169,2
"0c7262dff33c4087bc660ccf40f92f9c","b2275c3fad834f8d90737a2d9a6927d6",16010095,4,3,0,453,169,172,3
"b2275c3fad834f8d90737a2d9a6927d6","67a089198fcb4e1c8f2385786c2b296f",16010095,1,-172,0,454,172,39,-133
"67a089198fcb4e1c8f2385786c2b296f","64d48c6c9c7940639a932219a6c87198",16010095,2,1,0,455,39,40,1
"64d48c6c9c7940639a932219a6c87198","0d987bed3ffa4ed0b9a2e62e97b7b30f",16010095,1,303,0,456,40,272,232
"bb5a47f5ea01454a8b79455422d3b9da","0c7262dff33c4087bc660ccf40f92f9c",16010095,1,-145,0,468,280,169,-111
"0c7262dff33c4087bc660ccf40f92f9c","f902b0f41b544d4dbf79664fd233648d",16010095,1,-35,0,469,169,146,-23
"f902b0f41b544d4dbf79664fd233648d","df1de691dafe4549a18a4398ee9dfaf9",16010095,1,-8,0,470,146,139,-7
"8aae34f5ddbb4052a709b12e6b0d40fa","0d987bed3ffa4ed0b9a2e62e97b7b30f",16010095,1,169,0,472,147,272,125
"0d987bed3ffa4ed0b9a2e62e97b7b30f","0c7262dff33c4087bc660ccf40f92f9c",16010095,2,-135,0,474,272,169,-103
"0c7262dff33c4087bc660ccf40f92f9c","0c7262dff33c4087bc660ccf40f92f9c",16010095,2,0,1,475,169,169,0
"b2275c3fad834f8d90737a2d9a6927d6","0c7262dff33c4087bc660ccf40f92f9c",16010095,1,-3,0,477,172,169,-3
"0c7262dff33c4087bc660ccf40f92f9c","df1de691dafe4549a18a4398ee9dfaf9",16010095,1,-43,0,478,169,139,-30
"df1de691dafe4549a18a4398ee9dfaf9","f902b0f41b544d4dbf79664fd233648d",16010095,1,8,0,479,139,146,7
"f902b0f41b544d4dbf79664fd233648d","8aae34f5ddbb4052a709b12e6b0d40fa",16010095,1,1,0,480,146,147,1
"8aae34f5ddbb4052a709b12e6b0d40fa","8aae34f5ddbb4052a709b12e6b0d40fa",16010095,1,0,1,481,147,147,0
"8aae34f5ddbb4052a709b12e6b0d40fa","f902b0f41b544d4dbf79664fd233648d",16010095,1,-1,0,482,147,146,-1
"f902b0f41b544d4dbf79664fd233648d","67a089198fcb4e1c8f2385786c2b296f",16010095,1,-134,0,483,146,39,-107
"8aae34f5ddbb4052a709b12e6b0d40fa","0c7262dff33c4087bc660ccf40f92f9c",16010095,1,34,0,486,147,169,22
"b2275c3fad834f8d90737a2d9a6927d6","b2275c3fad834f8d90737a2d9a6927d6",16010095,39,0,1,488,172,172,0
"b2275c3fad834f8d90737a2d9a6927d6","eb515a26030b41f8a82a1e6114420bad",16010095,1,1,0,527,172,173,1
"eb515a26030b41f8a82a1e6114420bad","eb515a26030b41f8a82a1e6114420bad",16010095,5,0,1,528,173,173,0
"eb515a26030b41f8a82a1e6114420bad","0c7262dff33c4087bc660ccf40f92f9c",16010095,1,-4,0,533,173,169,-4
"0c7262dff33c4087bc660ccf40f92f9c","b42cc17b7de840f181a704558d0bc845",16010095,1,7,0,534,169,175,6
"b42cc17b7de840f181a704558d0bc845","b42cc17b7de840f181a704558d0bc845",16010095,1,0,1,535,175,175,0
"b42cc17b7de840f181a704558d0bc845","801f9e9135034f49bf5f8b4bdefedb41",16010095,1,2,0,536,175,177,2
"801f9e9135034f49bf5f8b4bdefedb41","801f9e9135034f49bf5f8b4bdefedb41",16010095,4,0,1,537,177,177,0
"801f9e9135034f49bf5f8b4bdefedb41","362fcb0699a14845ab29b2340093e528",16010095,1,-3,0,541,177,174,-3
"362fcb0699a14845ab29b2340093e528","ea38cc0e6e6e41edbabf210220808bf9",16010095,1,6,0,542,174,179,5
"ea38cc0e6e6e41edbabf210220808bf9","b87c552dd247427abe6ab5795b9c9d43",16010095,2,2,0,543,179,181,2
"b87c552dd247427abe6ab5795b9c9d43","ea38cc0e6e6e41edbabf210220808bf9",16010095,1,-2,0,544,181,179,-2
"b87c552dd247427abe6ab5795b9c9d43","b87c552dd247427abe6ab5795b9c9d43",16010095,7,0,1,546,181,181,0
"b87c552dd247427abe6ab5795b9c9d43","139b097acfca451689d80c9c6eebdf7b",16010095,1,-3,0,553,181,178,-3
"139b097acfca451689d80c9c6eebdf7b","30f660a1feb34582a739722532524f79",16010095,1,6,0,554,178,183,5
"30f660a1feb34582a739722532524f79","30f660a1feb34582a739722532524f79",16010095,5,0,1,555,183,183,0
"30f660a1feb34582a739722532524f79","2024b4885bd14338a39b7b509acbbd02",16010095,1,-1,0,560,183,182,-1
"2024b4885bd14338a39b7b509acbbd02","c3f63fe50d8e487c86bf8ef76c9cadd3",16010095,1,4,0,561,182,185,3
"c3f63fe50d8e487c86bf8ef76c9cadd3","c3f63fe50d8e487c86bf8ef76c9cadd3",16010095,1,0,1,562,185,185,0
"c3f63fe50d8e487c86bf8ef76c9cadd3","c8e371568a0c4391b25796ae4e91952e",16010095,1,3,0,563,185,186,1
"c8e371568a0c4391b25796ae4e91952e","0c7262dff33c4087bc660ccf40f92f9c",16010095,1,-23,0,564,186,169,-17
"0c7262dff33c4087bc660ccf40f92f9c","7d932b23e1c84326ae5aa4d3c0d813d1",16010095,1,25,0,565,169,188,19
"7d932b23e1c84326ae5aa4d3c0d813d1","7d932b23e1c84326ae5aa4d3c0d813d1",16010095,4,0,1,566,188,188,0
"7d932b23e1c84326ae5aa4d3c0d813d1","c8e371568a0c4391b25796ae4e91952e",16010095,2,-2,0,569,188,186,-2
"c8e371568a0c4391b25796ae4e91952e","ab11d94c6c8948ea90b88f19d2cd502b",16010095,2,5,0,570,186,190,4
"ab11d94c6c8948ea90b88f19d2cd502b","ab11d94c6c8948ea90b88f19d2cd502b",16010095,1,0,1,571,190,190,0
"ab11d94c6c8948ea90b88f19d2cd502b","f992451ed6ad4e68bb9e68ad6be7c4be",16010095,1,2,0,572,190,192,2
"f992451ed6ad4e68bb9e68ad6be7c4be","f992451ed6ad4e68bb9e68ad6be7c4be",16010095,3,0,1,573,192,192,0
"f992451ed6ad4e68bb9e68ad6be7c4be","07b44a7a51e94c78b411c753fc39dab0",16010095,1,-3,0,576,192,189,-3
"07b44a7a51e94c78b411c753fc39dab0","6cd2dcaac46847d4a0bc53f296d90375",16010095,2,6,0,577,189,194,5
"6cd2dcaac46847d4a0bc53f296d90375","c8e371568a0c4391b25796ae4e91952e",16010095,1,-10,0,578,194,186,-8
"c8e371568a0c4391b25796ae4e91952e","7d932b23e1c84326ae5aa4d3c0d813d1",16010095,1,2,0,579,186,188,2
"ab11d94c6c8948ea90b88f19d2cd502b","07b44a7a51e94c78b411c753fc39dab0",16010095,1,-1,0,583,190,189,-1
"6cd2dcaac46847d4a0bc53f296d90375","6cd2dcaac46847d4a0bc53f296d90375",16010095,1,0,1,585,194,194,0
"6cd2dcaac46847d4a0bc53f296d90375","2d2580c9411c4972909db508d6956a58",16010095,1,2,0,586,194,196,2
"2d2580c9411c4972909db508d6956a58","2d2580c9411c4972909db508d6956a58",16010095,2,0,1,587,196,196,0
"2d2580c9411c4972909db508d6956a58","5bddb3d9ed264f3984702f048c7e5340",16010095,1,1,0,589,196,197,1
"5bddb3d9ed264f3984702f048c7e5340","5bddb3d9ed264f3984702f048c7e5340",16010095,2,0,1,590,197,197,0
"5bddb3d9ed264f3984702f048c7e5340","d5e8e2bd12a2466b9d6d90855f0eb079",16010095,1,1,0,592,197,198,1
"d5e8e2bd12a2466b9d6d90855f0eb079","d5e8e2bd12a2466b9d6d90855f0eb079",16010095,2,0,1,593,198,198,0
"d5e8e2bd12a2466b9d6d90855f0eb079","017d7ca8e0394b91aaadc9574df2202c",16010095,1,-5,0,595,198,193,-5
"017d7ca8e0394b91aaadc9574df2202c","54e8e9f0ea3e45c4bf3b8ac799ee31b1",16010095,1,8,0,596,193,200,7
"54e8e9f0ea3e45c4bf3b8ac799ee31b1","54e8e9f0ea3e45c4bf3b8ac799ee31b1",16010095,1,0,1,597,200,200,0
"54e8e9f0ea3e45c4bf3b8ac799ee31b1","c614a00911be4877a075f19315530fb0",16010095,1,1,0,598,200,201,1
"c614a00911be4877a075f19315530fb0","c614a00911be4877a075f19315530fb0",16010095,6,0,1,599,201,201,0
"c614a00911be4877a075f19315530fb0","a6c21bd8b95249c7972820a7a7d76aff",16010095,1,1,0,605,201,202,1
"a6c21bd8b95249c7972820a7a7d76aff","a6c21bd8b95249c7972820a7a7d76aff",16010095,1,0,1,606,202,202,0
"a6c21bd8b95249c7972820a7a7d76aff","bb329d880ab54120adaf203a693bb203",16010095,1,1,0,607,202,203,1
"bb329d880ab54120adaf203a693bb203","bb329d880ab54120adaf203a693bb203",16010095,1,0,1,608,203,203,0
"bb329d880ab54120adaf203a693bb203","f9170dd6bc6442b4acd832747609b09a",16010095,1,-4,0,609,203,199,-4
"f9170dd6bc6442b4acd832747609b09a","334c2344009840079b1d0e1b7ce3d5a7",16010095,1,7,0,610,199,205,6
"334c2344009840079b1d0e1b7ce3d5a7","334c2344009840079b1d0e1b7ce3d5a7",16010095,1,0,1,611,205,205,0
"334c2344009840079b1d0e1b7ce3d5a7","c8e371568a0c4391b25796ae4e91952e",16010095,1,-23,0,612,205,186,-19
"c8e371568a0c4391b25796ae4e91952e","d7f13c8d63ec4e2aa673fbb9cf9c6933",16010095,1,26,0,613,186,206,20
"d7f13c8d63ec4e2aa673fbb9cf9c6933","b9e80f77c3a44349863b19875725c384",16010095,1,1,0,614,206,207,1
"b9e80f77c3a44349863b19875725c384","7108f0e4c2584f1f9c471689ae4c885c",16010095,2,1,0,615,207,208,1
"7108f0e4c2584f1f9c471689ae4c885c","b9e80f77c3a44349863b19875725c384",16010095,1,-1,0,616,208,207,-1
"b9e80f77c3a44349863b19875725c384","b9e80f77c3a44349863b19875725c384",16010095,22,0,1,617,207,207,0
"7108f0e4c2584f1f9c471689ae4c885c","7108f0e4c2584f1f9c471689ae4c885c",16010095,10,0,1,640,208,208,0
"7108f0e4c2584f1f9c471689ae4c885c","09400e101c5d4b439cf9a26b03aae558",16010095,1,3,0,650,208,210,2
"09400e101c5d4b439cf9a26b03aae558","d7f13c8d63ec4e2aa673fbb9cf9c6933",16010095,1,-5,0,651,210,206,-4
"d7f13c8d63ec4e2aa673fbb9cf9c6933","09400e101c5d4b439cf9a26b03aae558",16010095,2,5,0,652,206,210,4
"09400e101c5d4b439cf9a26b03aae558","a88efa7e50ce47159810ab553afa6d3a",16010095,1,2,0,653,210,212,2
"a88efa7e50ce47159810ab553afa6d3a","a88efa7e50ce47159810ab553afa6d3a",16010095,2,0,1,654,212,212,0
"a88efa7e50ce47159810ab553afa6d3a","a875096404ef4a9984b62d74cda916f9",16010095,1,-3,0,656,212,209,-3
"a875096404ef4a9984b62d74cda916f9","f7fb1952f56b4189b86a9f8b7862d2b8",16010095,1,7,0,657,209,215,6
"f7fb1952f56b4189b86a9f8b7862d2b8","be502a7a43c44bf7b682698de79d9369",16010095,2,-1,0,658,215,214,-1
"be502a7a43c44bf7b682698de79d9369","be502a7a43c44bf7b682698de79d9369",16010095,1,0,1,659,214,214,0
"be502a7a43c44bf7b682698de79d9369","f7fb1952f56b4189b86a9f8b7862d2b8",16010095,2,1,0,660,214,215,1
"f7fb1952f56b4189b86a9f8b7862d2b8","f7fb1952f56b4189b86a9f8b7862d2b8",16010095,14,0,1,661,215,215,0
"f7fb1952f56b4189b86a9f8b7862d2b8","b860ee85d8bc4a2f97958cfb71be3533",16010095,1,1,0,675,215,216,1
"b860ee85d8bc4a2f97958cfb71be3533","b860ee85d8bc4a2f97958cfb71be3533",16010095,2,0,1,676,216,216,0
"b860ee85d8bc4a2f97958cfb71be3533","ec341f459285443b8361f7f15638ff08",16010095,1,-3,0,678,216,213,-3
"ec341f459285443b8361f7f15638ff08","363837c182e04711840d896ae1e0339c",16010095,1,6,0,679,213,218,5
"363837c182e04711840d896ae1e0339c","363837c182e04711840d896ae1e0339c",16010095,13,0,1,680,218,218,0
"363837c182e04711840d896ae1e0339c","01b2051f8941460d89945e3b02d1ce78",16010095,1,-1,0,693,218,217,-1
"01b2051f8941460d89945e3b02d1ce78","91125ca626c5470eb145501f8c37f8db",16010095,1,4,0,694,217,220,3
"91125ca626c5470eb145501f8c37f8db","91125ca626c5470eb145501f8c37f8db",16010095,1,0,1,695,220,220,0
"91125ca626c5470eb145501f8c37f8db","d7f13c8d63ec4e2aa673fbb9cf9c6933",16010095,1,-18,0,696,220,206,-14
"d7f13c8d63ec4e2aa673fbb9cf9c6933","1c6721b1f63f4d30ba7746ea8af02a52",16010095,1,21,0,697,206,221,15
"1c6721b1f63f4d30ba7746ea8af02a52","77ecef8eff6b4a2caea7707669bf7475",16010095,1,1,0,698,221,222,1
"77ecef8eff6b4a2caea7707669bf7475","77ecef8eff6b4a2caea7707669bf7475",16010095,12,0,1,699,222,222,0
"77ecef8eff6b4a2caea7707669bf7475","1c6721b1f63f4d30ba7746ea8af02a52",16010095,1,-1,0,711,222,221,-1
"1c6721b1f63f4d30ba7746ea8af02a52","d03cb855c70044cf8c35d9ec0de696e3",16010095,1,4,0,712,221,224,3
"d03cb855c70044cf8c35d9ec0de696e3","8b9ae98743bd4d4a8a87dff1c1244211",16010095,1,3,0,713,224,227,3
"8b9ae98743bd4d4a8a87dff1c1244211","d03cb855c70044cf8c35d9ec0de696e3",16010095,1,-3,0,714,227,224,-3
"d03cb855c70044cf8c35d9ec0de696e3","a49a937d6896486d9a5396654abcf2e1",16010095,1,2,0,715,224,226,2
"a49a937d6896486d9a5396654abcf2e1","a49a937d6896486d9a5396654abcf2e1",16010095,1,0,1,716,226,226,0
"a49a937d6896486d9a5396654abcf2e1","8b9ae98743bd4d4a8a87dff1c1244211",16010095,1,1,0,717,226,227,1
"8b9ae98743bd4d4a8a87dff1c1244211","8b9ae98743bd4d4a8a87dff1c1244211",16010095,20,0,1,718,227,227,0
"8b9ae98743bd4d4a8a87dff1c1244211","f7906d6f59b9489a91d2ef40db5a474d",16010095,1,-4,0,738,227,223,-4
"f7906d6f59b9489a91d2ef40db5a474d","2ab1535aac1346ba8801535bf729ef37",16010095,1,7,0,739,223,229,6
"2ab1535aac1346ba8801535bf729ef37","2ab1535aac1346ba8801535bf729ef37",16010095,1,0,1,740,229,229,0
"2ab1535aac1346ba8801535bf729ef37","a4f40fb48a8542c8949bae1f002cd9bc",16010095,1,2,0,741,229,231,2
"a4f40fb48a8542c8949bae1f002cd9bc","a4f40fb48a8542c8949bae1f002cd9bc",16010095,2,0,1,742,231,231,0
"a4f40fb48a8542c8949bae1f002cd9bc","8972c23e32044edb8a78fa1eed4e5947",16010095,1,1,0,744,231,232,1
"8972c23e32044edb8a78fa1eed4e5947","8972c23e32044edb8a78fa1eed4e5947",16010095,5,0,1,745,232,232,0
"8972c23e32044edb8a78fa1eed4e5947","92feb4a40f8344d38b6f722e42a53295",16010095,1,1,0,750,232,233,1
"92feb4a40f8344d38b6f722e42a53295","92feb4a40f8344d38b6f722e42a53295",16010095,2,0,1,751,233,233,0
"92feb4a40f8344d38b6f722e42a53295","5152833676bf4c6cb317060be10f68db",16010095,1,-5,0,753,233,228,-5
"5152833676bf4c6cb317060be10f68db","ca3e28f290354c08aefe5b0f769604e6",16010095,1,8,0,754,228,235,7
"ca3e28f290354c08aefe5b0f769604e6","ca3e28f290354c08aefe5b0f769604e6",16010095,9,0,1,755,235,235,0
"ca3e28f290354c08aefe5b0f769604e6","79a35eea833e4c2c9d22fc53c3c6445c",16010095,1,1,0,764,235,236,1
"79a35eea833e4c2c9d22fc53c3c6445c","79a35eea833e4c2c9d22fc53c3c6445c",16010095,4,0,1,765,236,236,0
"79a35eea833e4c2c9d22fc53c3c6445c","8f68228b1518449e9615cdafee41a2bd",16010095,1,1,0,769,236,237,1
"8f68228b1518449e9615cdafee41a2bd","8f68228b1518449e9615cdafee41a2bd",16010095,1,0,1,770,237,237,0
"8f68228b1518449e9615cdafee41a2bd","cab89fa5c3ed45a5aa550fc0352d6a42",16010095,1,1,0,771,237,238,1
"cab89fa5c3ed45a5aa550fc0352d6a42","cab89fa5c3ed45a5aa550fc0352d6a42",16010095,3,0,1,772,238,238,0
"cab89fa5c3ed45a5aa550fc0352d6a42","66d4fad4f1cf4b46be0750a99ad7a35a",16010095,1,1,0,775,238,239,1
"66d4fad4f1cf4b46be0750a99ad7a35a","66d4fad4f1cf4b46be0750a99ad7a35a",16010095,1,0,1,776,239,239,0
"66d4fad4f1cf4b46be0750a99ad7a35a","0b04c8e2f86d48c7aeb7e225819cd32b",16010095,1,-5,0,777,239,234,-5
"0b04c8e2f86d48c7aeb7e225819cd32b","f53da5fd9bfe412da4b80d4742563b6c",16010095,1,8,0,778,234,241,7
"f53da5fd9bfe412da4b80d4742563b6c","f53da5fd9bfe412da4b80d4742563b6c",16010095,1,0,1,779,241,241,0
"f53da5fd9bfe412da4b80d4742563b6c","1c6721b1f63f4d30ba7746ea8af02a52",16010095,1,-24,0,780,241,221,-20
"1c6721b1f63f4d30ba7746ea8af02a52","2ae94c0cea4d480a9d5dca8fb1d7b542",16010095,1,27,0,781,221,242,21
"2ae94c0cea4d480a9d5dca8fb1d7b542","1ebf23f9d994469a85206e4c7b1bf5f5",16010095,1,3,0,782,242,245,3
"1ebf23f9d994469a85206e4c7b1bf5f5","1ebf23f9d994469a85206e4c7b1bf5f5",16010095,18,0,1,783,245,245,0
"1ebf23f9d994469a85206e4c7b1bf5f5","85ae675b83e8422da842cfd25596af99",16010095,1,1,0,801,245,246,1
"85ae675b83e8422da842cfd25596af99","85ae675b83e8422da842cfd25596af99",16010095,1,0,1,802,246,246,0
"85ae675b83e8422da842cfd25596af99","2ae94c0cea4d480a9d5dca8fb1d7b542",16010095,1,-4,0,803,246,242,-4
"2ae94c0cea4d480a9d5dca8fb1d7b542","30c9ba177afc49a695625d2bdec40207",16010095,1,9,0,804,242,250,8
"30c9ba177afc49a695625d2bdec40207","30c9ba177afc49a695625d2bdec40207",16010095,2,0,1,805,250,250,0
"30c9ba177afc49a695625d2bdec40207","6e83e23f56544a19b94067c1c558d9c0",16010095,1,-3,0,807,250,247,-3
"6e83e23f56544a19b94067c1c558d9c0","00f61990949545828dd12f1303d47504",16010095,1,11,0,808,247,256,9
"00f61990949545828dd12f1303d47504","00f61990949545828dd12f1303d47504",16010095,2,0,1,809,256,256,0
"00f61990949545828dd12f1303d47504","ead7bb4b64e247d2ae632ab8a296b091",16010095,1,2,0,811,256,258,2
"ead7bb4b64e247d2ae632ab8a296b091","ead7bb4b64e247d2ae632ab8a296b091",16010095,2,0,1,812,258,258,0
"ead7bb4b64e247d2ae632ab8a296b091","41b0048dde734bb280bac6116baa8e27",16010095,1,1,0,814,258,259,1
"41b0048dde734bb280bac6116baa8e27","41b0048dde734bb280bac6116baa8e27",16010095,2,0,1,815,259,259,0
"41b0048dde734bb280bac6116baa8e27","b41c5a094a604ee0915327da5cc0beb7",16010095,1,1,0,817,259,260,1
"b41c5a094a604ee0915327da5cc0beb7","b41c5a094a604ee0915327da5cc0beb7",16010095,2,0,1,818,260,260,0
"b41c5a094a604ee0915327da5cc0beb7","d546341988904f069cfa86b21457d9d9",16010095,1,-10,0,820,260,251,-9
"d546341988904f069cfa86b21457d9d9","28c171777c52431ab6b925073bd63d46",16010095,1,15,0,821,251,264,13
"28c171777c52431ab6b925073bd63d46","28c171777c52431ab6b925073bd63d46",16010095,11,0,1,822,264,264,0
"28c171777c52431ab6b925073bd63d46","ac160db940cb49ae8579162b1d52bb5d",16010095,1,2,0,833,264,266,2
"ac160db940cb49ae8579162b1d52bb5d","ac160db940cb49ae8579162b1d52bb5d",16010095,3,0,1,834,266,266,0
"ac160db940cb49ae8579162b1d52bb5d","d989ebcfc12a4b669f0100dc1aa14f1e",16010095,1,-12,0,837,266,255,-11
"d989ebcfc12a4b669f0100dc1aa14f1e","44240778a97c4af0937817499b75707b",16010095,1,16,0,838,255,269,14
"44240778a97c4af0937817499b75707b","44240778a97c4af0937817499b75707b",16010095,2,0,1,839,269,269,0
"44240778a97c4af0937817499b75707b","7aa76d3e993840d8805f097cbdbcd44b",16010095,1,-9,0,841,269,261,-8
"7aa76d3e993840d8805f097cbdbcd44b","865a4d3b43374da7944dc7d397f566d9",16010095,1,12,0,842,261,271,10
"865a4d3b43374da7944dc7d397f566d9","865a4d3b43374da7944dc7d397f566d9",16010095,3,0,1,843,271,271,0
"865a4d3b43374da7944dc7d397f566d9","0d987bed3ffa4ed0b9a2e62e97b7b30f",16010095,1,3,0,846,271,272,1
"0d987bed3ffa4ed0b9a2e62e97b7b30f","2ae94c0cea4d480a9d5dca8fb1d7b542",16010095,1,-38,0,847,272,242,-30
"2ae94c0cea4d480a9d5dca8fb1d7b542","7028800abe7d4e27b613d1d6cbe26bf7",16010095,1,30,0,848,242,267,25
"7028800abe7d4e27b613d1d6cbe26bf7","2ae94c0cea4d480a9d5dca8fb1d7b542",16010095,2,-30,0,849,267,242,-25
"2ae94c0cea4d480a9d5dca8fb1d7b542","0d987bed3ffa4ed0b9a2e62e97b7b30f",16010095,2,38,0,850,242,272,30
"0d987bed3ffa4ed0b9a2e62e97b7b30f","94cecc3f1e7d484b8e068e79241dfd73",16010095,1,13,0,861,272,281,9
"94cecc3f1e7d484b8e068e79241dfd73","a37477c4e4c14169ad44b06b493007f6",16010095,1,2,0,862,281,283,2
"a37477c4e4c14169ad44b06b493007f6","94cecc3f1e7d484b8e068e79241dfd73",16010095,1,-2,0,863,283,281,-2
"94cecc3f1e7d484b8e068e79241dfd73","fab84b4fab5940efb4ea868ef8d09396",16010095,1,5,0,864,281,284,3
"fab84b4fab5940efb4ea868ef8d09396","a9ac840f098c4bd0a2ee896214ce29cd",16010095,1,-157,0,865,284,168,-116
"a9ac840f098c4bd0a2ee896214ce29cd","a9ac840f098c4bd0a2ee896214ce29cd",16010095,2,0,1,866,168,168,0
"a9ac840f098c4bd0a2ee896214ce29cd","0c7262dff33c4087bc660ccf40f92f9c",16010095,1,4,0,868,168,169,1
"b2275c3fad834f8d90737a2d9a6927d6","7028800abe7d4e27b613d1d6cbe26bf7",16010095,1,124,0,870,172,267,95
"2ae94c0cea4d480a9d5dca8fb1d7b542","2ae94c0cea4d480a9d5dca8fb1d7b542",16010095,1,0,1,872,242,242,0
"0c7262dff33c4087bc660ccf40f92f9c","fab84b4fab5940efb4ea868ef8d09396",16010095,1,153,0,875,169,284,115
"fab84b4fab5940efb4ea868ef8d09396","fab84b4fab5940efb4ea868ef8d09396",16010095,1,0,1,876,284,284,0
"208c9b2796c944db8dacaa96082520ea","208c9b2796c944db8dacaa96082520ea",16010095,1,0,1,879,288,288,0
"208c9b2796c944db8dacaa96082520ea","4a29443515bb404cb8924e1c60a63b73",16010095,1,-3,0,880,288,285,-3
"4a29443515bb404cb8924e1c60a63b73","7669a956527947d0add87455277e80b4",16010095,1,7,0,881,285,291,6
"7669a956527947d0add87455277e80b4","7669a956527947d0add87455277e80b4",16010095,3,0,1,882,291,291,0
"7669a956527947d0add87455277e80b4","869e967078f04da18dd0b0b9389a7424",16010095,1,3,0,885,291,293,2
"869e967078f04da18dd0b0b9389a7424","6a9a3b5bde4a48daa896fe8c06eca56f",16010095,1,-5,0,886,293,289,-4
"6a9a3b5bde4a48daa896fe8c06eca56f","869e967078f04da18dd0b0b9389a7424",16010095,1,5,0,887,289,293,4
"869e967078f04da18dd0b0b9389a7424","51ab6291537748fab90d519aa09889d6",16010095,1,2,0,888,293,295,2
"51ab6291537748fab90d519aa09889d6","51ab6291537748fab90d519aa09889d6",16010095,5,0,1,889,295,295,0
"51ab6291537748fab90d519aa09889d6","34a6e49023fc4465bd5ca604330bbd1c",16010095,1,-3,0,894,295,292,-3
"34a6e49023fc4465bd5ca604330bbd1c","ba0e59461bfb4a44b7b1c28a01f8d3b3",16010095,1,9,0,895,292,299,7
"ba0e59461bfb4a44b7b1c28a01f8d3b3","21592f2a9e9c4b2f8c66ec5dbcbf6a2b",16010095,1,-4,0,896,299,296,-3
"21592f2a9e9c4b2f8c66ec5dbcbf6a2b","ba0e59461bfb4a44b7b1c28a01f8d3b3",16010095,1,4,0,897,296,299,3
"ba0e59461bfb4a44b7b1c28a01f8d3b3","ba0e59461bfb4a44b7b1c28a01f8d3b3",16010095,1,0,1,898,299,299,0
"ba0e59461bfb4a44b7b1c28a01f8d3b3","0e0b36e731a645e7b1b8a88f5031ca38",16010095,1,2,0,899,299,301,2
"0e0b36e731a645e7b1b8a88f5031ca38","0e0b36e731a645e7b1b8a88f5031ca38",16010095,2,0,1,900,301,301,0
"0e0b36e731a645e7b1b8a88f5031ca38","a66a144637284c21afc6de17fea4bfb8",16010095,1,1,0,902,301,302,1
"a66a144637284c21afc6de17fea4bfb8","a66a144637284c21afc6de17fea4bfb8",16010095,2,0,1,903,302,302,0
"a66a144637284c21afc6de17fea4bfb8","4a29443515bb404cb8924e1c60a63b73",16010095,1,-21,0,905,302,285,-17
"4a29443515bb404cb8924e1c60a63b73","b2f0d654738f48158edff28e8d3a546e",16010095,1,234,0,906,285,449,164
"f60ee41ec635499abd48168342d32c2f","93679be414554a11b1893002f2229a93",16010095,1,-578,0,917,453,35,-418
"93679be414554a11b1893002f2229a93","93679be414554a11b1893002f2229a93",16010095,3,0,1,918,35,35,0
"7040a13096d746ac84b8fac8d9752058","7040a13096d746ac84b8fac8d9752058",16010095,1,0,1,922,36,36,0
"7040a13096d746ac84b8fac8d9752058","9a0dc646f934470daf08c4b56ccf73db",16010095,1,3,0,923,36,37,1
"fc0e049d56024bc9a02c9a9c435c3df7","fc0e049d56024bc9a02c9a9c435c3df7",16010095,1,0,1,925,38,38,0
"67a089198fcb4e1c8f2385786c2b296f","fc0e049d56024bc9a02c9a9c435c3df7",16010095,2,-4,0,927,39,38,-1
"fc0e049d56024bc9a02c9a9c435c3df7","64d48c6c9c7940639a932219a6c87198",16010095,1,5,0,930,38,40,2
"64d48c6c9c7940639a932219a6c87198","a875096404ef4a9984b62d74cda916f9",16010095,1,221,0,931,40,209,169
"a875096404ef4a9984b62d74cda916f9","d7f13c8d63ec4e2aa673fbb9cf9c6933",16010095,1,-4,0,932,209,206,-3
"d7f13c8d63ec4e2aa673fbb9cf9c6933","d7f13c8d63ec4e2aa673fbb9cf9c6933",16010095,1,0,1,933,206,206,0
"09400e101c5d4b439cf9a26b03aae558","09400e101c5d4b439cf9a26b03aae558",16010095,1,0,1,935,210,210,0
"09400e101c5d4b439cf9a26b03aae558","a875096404ef4a9984b62d74cda916f9",16010095,1,-1,0,936,210,209,-1
"a875096404ef4a9984b62d74cda916f9","be502a7a43c44bf7b682698de79d9369",16010095,1,6,0,937,209,214,5
"be502a7a43c44bf7b682698de79d9369","0c7262dff33c4087bc660ccf40f92f9c",16010095,1,-59,0,940,214,169,-45
"0c7262dff33c4087bc660ccf40f92f9c","2c5bb2cbd0014420ad8c95d40e38efd1",16010095,1,180,0,942,169,303,134
"2c5bb2cbd0014420ad8c95d40e38efd1","4a29443515bb404cb8924e1c60a63b73",16010095,1,-23,0,943,303,285,-18
"4a29443515bb404cb8924e1c60a63b73","e390b575229748ea8aac9364efe2bf00",16010095,1,24,0,944,285,304,19
"e390b575229748ea8aac9364efe2bf00","e390b575229748ea8aac9364efe2bf00",16010095,1,0,1,945,304,304,0
"e390b575229748ea8aac9364efe2bf00","4a29443515bb404cb8924e1c60a63b73",16010095,1,-24,0,946,304,285,-19
"4a29443515bb404cb8924e1c60a63b73","3434c10e561d488a914e0f7d71907abd",16010095,1,27,0,947,285,305,20
"3434c10e561d488a914e0f7d71907abd","53e7e900392747ccad52e711ab0f80d8",16010095,1,2,0,948,305,307,2
"53e7e900392747ccad52e711ab0f80d8","53e7e900392747ccad52e711ab0f80d8",16010095,1,0,1,949,307,307,0
"53e7e900392747ccad52e711ab0f80d8","3434c10e561d488a914e0f7d71907abd",16010095,1,-2,0,950,307,305,-2
"3434c10e561d488a914e0f7d71907abd","130acc2aeb0448fdbb2de63bc5cebe5b",16010095,1,5,0,951,305,309,4
"130acc2aeb0448fdbb2de63bc5cebe5b","130acc2aeb0448fdbb2de63bc5cebe5b",16010095,1,0,1,952,309,309,0
"130acc2aeb0448fdbb2de63bc5cebe5b","9c062b3251034ebe90f5054e2a3b5120",16010095,1,2,0,953,309,311,2
"9c062b3251034ebe90f5054e2a3b5120","9c062b3251034ebe90f5054e2a3b5120",16010095,2,0,1,954,311,311,0
"9c062b3251034ebe90f5054e2a3b5120","ea859f8207e44537889daeaba13ac2e8",16010095,1,1,0,956,311,312,1
"ea859f8207e44537889daeaba13ac2e8","ea859f8207e44537889daeaba13ac2e8",16010095,1,0,1,957,312,312,0
"ea859f8207e44537889daeaba13ac2e8","56d94971a7a94257aa330183a8ebd0ea",16010095,1,1,0,958,312,313,1
"56d94971a7a94257aa330183a8ebd0ea","56d94971a7a94257aa330183a8ebd0ea",16010095,9,0,1,959,313,313,0
"56d94971a7a94257aa330183a8ebd0ea","141c0df6cd1946539aadd1c9b7068cd4",16010095,1,-5,0,968,313,308,-5
"141c0df6cd1946539aadd1c9b7068cd4","13255e63e0aa4abf85e5211bf613d43e",16010095,1,10,0,969,308,317,9
"13255e63e0aa4abf85e5211bf613d43e","13255e63e0aa4abf85e5211bf613d43e",16010095,1,0,1,970,317,317,0
"13255e63e0aa4abf85e5211bf613d43e","0c787d16c9504873b1a4d903cec09948",16010095,1,-3,0,971,317,314,-3
"0c787d16c9504873b1a4d903cec09948","86c27d40179e419c8e9d150fb6afa5d0",16010095,1,6,0,972,314,319,5
"86c27d40179e419c8e9d150fb6afa5d0","86c27d40179e419c8e9d150fb6afa5d0",16010095,1,0,1,973,319,319,0
"86c27d40179e419c8e9d150fb6afa5d0","8d7e0b55cf9849cda222a0f2440cec55",16010095,1,-1,0,974,319,318,-1
"8d7e0b55cf9849cda222a0f2440cec55","24f1363179ad4aaa965484a78471912b",16010095,1,6,0,975,318,323,5
"24f1363179ad4aaa965484a78471912b","47edbb64109243e6b0f8f64cdef90c6c",16010095,1,3,0,976,323,326,3
"47edbb64109243e6b0f8f64cdef90c6c","24f1363179ad4aaa965484a78471912b",16010095,2,-3,0,977,326,323,-3
"24f1363179ad4aaa965484a78471912b","3434c10e561d488a914e0f7d71907abd",16010095,1,-22,0,978,323,305,-18
"3434c10e561d488a914e0f7d71907abd","47edbb64109243e6b0f8f64cdef90c6c",16010095,1,25,0,979,305,326,21
"24f1363179ad4aaa965484a78471912b","24f1363179ad4aaa965484a78471912b",16010095,1,0,1,981,323,323,0
"24f1363179ad4aaa965484a78471912b","3628bdce1dd2429ba924d2d4d09448d2",16010095,1,-1,0,982,323,322,-1
"3628bdce1dd2429ba924d2d4d09448d2","56b3fd1a212a4764be39d979fde3326e",16010095,1,7,0,983,322,328,6
"56b3fd1a212a4764be39d979fde3326e","56b3fd1a212a4764be39d979fde3326e",16010095,1,0,1,984,328,328,0
"56b3fd1a212a4764be39d979fde3326e","3434c10e561d488a914e0f7d71907abd",16010095,1,-28,0,985,328,305,-23
"3434c10e561d488a914e0f7d71907abd","0c4079457ede49e3aeb5e86ed84bdf35",16010095,1,31,0,986,305,329,24
"38aea304b4fa46e1b29bb72f5cea4c93","38aea304b4fa46e1b29bb72f5cea4c93",16010095,2,0,1,988,331,331,0
"38aea304b4fa46e1b29bb72f5cea4c93","d646286c8051419bbc2e31dd1db55ca8",16010095,1,-349,0,990,331,67,-264
"d646286c8051419bbc2e31dd1db55ca8","6a9f0ef185fb47f0937e29daa1c71ed5",16010095,1,27,0,991,67,90,23
"6a9f0ef185fb47f0937e29daa1c71ed5","e36d261332f14e79bb4b467aceaeb9b5",16010095,1,324,0,994,90,333,243
"e36d261332f14e79bb4b467aceaeb9b5","e36d261332f14e79bb4b467aceaeb9b5",16010095,7,0,1,1000,333,333,0
"e36d261332f14e79bb4b467aceaeb9b5","c7e89b9d04744d2eab742fc24e3ef1ae",16010095,1,1,0,1002,333,334,1
"c7e89b9d04744d2eab742fc24e3ef1ae","c7e89b9d04744d2eab742fc24e3ef1ae",16010095,5,0,1,1003,334,334,0
"c7e89b9d04744d2eab742fc24e3ef1ae","fe49f8054b374a0ea4bb266ed135ff62",16010095,1,1,0,1008,334,335,1
"fe49f8054b374a0ea4bb266ed135ff62","fe49f8054b374a0ea4bb266ed135ff62",16010095,2,0,1,1009,335,335,0
"fe49f8054b374a0ea4bb266ed135ff62","d0a8f74af98642fe8360d22c42e45117",16010095,1,1,0,1011,335,336,1
"d0a8f74af98642fe8360d22c42e45117","d0a8f74af98642fe8360d22c42e45117",16010095,2,0,1,1012,336,336,0
"d0a8f74af98642fe8360d22c42e45117","0c4079457ede49e3aeb5e86ed84bdf35",16010095,1,-7,0,1014,336,329,-7
"0c4079457ede49e3aeb5e86ed84bdf35","a7c6339ca1da4368a18d471f0519f877",16010095,1,11,0,1015,329,339,10
"a7c6339ca1da4368a18d471f0519f877","a7c6339ca1da4368a18d471f0519f877",16010095,1,0,1,1016,339,339,0
"a7c6339ca1da4368a18d471f0519f877","b8b9418ab322418d9db9b40d96af873a",16010095,1,-2,0,1017,339,337,-2
"b8b9418ab322418d9db9b40d96af873a","bbc5139ca9024389a94db3a6f47dcff6",16010095,1,5,0,1018,337,341,4
"bbc5139ca9024389a94db3a6f47dcff6","bbc5139ca9024389a94db3a6f47dcff6",16010095,2,0,1,1019,341,341,0
"bbc5139ca9024389a94db3a6f47dcff6","4ee6ca9019ab4a1ab323f98094a9bd77",16010095,1,2,0,1021,341,343,2
"4ee6ca9019ab4a1ab323f98094a9bd77","4ee6ca9019ab4a1ab323f98094a9bd77",16010095,2,0,1,1022,343,343,0
"4ee6ca9019ab4a1ab323f98094a9bd77","b37947176785476f8b29d49a851366dc",16010095,1,1,0,1024,343,344,1
"b37947176785476f8b29d49a851366dc","b37947176785476f8b29d49a851366dc",16010095,2,0,1,1025,344,344,0
"b37947176785476f8b29d49a851366dc","fcea5b10d5a14a3b9324ffece8f6e1e5",16010095,1,1,0,1027,344,345,1
"fcea5b10d5a14a3b9324ffece8f6e1e5","fcea5b10d5a14a3b9324ffece8f6e1e5",16010095,2,0,1,1028,345,345,0
"fcea5b10d5a14a3b9324ffece8f6e1e5","c2490bc612d146edbe786556fab3651b",16010095,1,-5,0,1030,345,340,-5
"c2490bc612d146edbe786556fab3651b","6ac8bb048b854999a47edb35fe627f11",16010095,1,8,0,1031,340,347,7
"6ac8bb048b854999a47edb35fe627f11","6ac8bb048b854999a47edb35fe627f11",16010095,3,0,1,1032,347,347,0
"6ac8bb048b854999a47edb35fe627f11","30ead9794d4847abaf222ca966cc8630",16010095,1,3,0,1035,347,348,1
"30ead9794d4847abaf222ca966cc8630","0c4079457ede49e3aeb5e86ed84bdf35",16010095,1,-24,0,1036,348,329,-19
"0c4079457ede49e3aeb5e86ed84bdf35","eff0de7f2dbb42dfa1a2e686efab5b6d",16010095,1,30,0,1037,329,354,25
"eff0de7f2dbb42dfa1a2e686efab5b6d","897b7f51242c44aab2205c72fdcbf4cd",16010095,1,-2,0,1038,354,352,-2
"897b7f51242c44aab2205c72fdcbf4cd","c20993c944444fe085345591a8bd837e",16010095,2,-1,0,1039,352,351,-1
"c20993c944444fe085345591a8bd837e","09b9678ddc3d452ea4a3d46e15826065",16010095,1,2,0,1040,351,353,2
"09b9678ddc3d452ea4a3d46e15826065","2fe14166dc9642c3bc666b86a57f943d",16010095,1,5,0,1041,353,357,4
"2fe14166dc9642c3bc666b86a57f943d","30ead9794d4847abaf222ca966cc8630",16010095,2,-10,0,1042,357,348,-9
"30ead9794d4847abaf222ca966cc8630","2fe14166dc9642c3bc666b86a57f943d",16010095,2,10,0,1043,348,357,9
"2fe14166dc9642c3bc666b86a57f943d","2fe14166dc9642c3bc666b86a57f943d",16010095,5,0,1,1044,357,357,0
"30ead9794d4847abaf222ca966cc8630","30ead9794d4847abaf222ca966cc8630",16010095,2,0,1,1049,348,348,0
"30ead9794d4847abaf222ca966cc8630","c20993c944444fe085345591a8bd837e",16010095,1,3,0,1050,348,351,3
"c20993c944444fe085345591a8bd837e","897b7f51242c44aab2205c72fdcbf4cd",16010095,2,1,0,1051,351,352,1
"897b7f51242c44aab2205c72fdcbf4cd","eff0de7f2dbb42dfa1a2e686efab5b6d",16010095,1,2,0,1052,352,354,2
"eff0de7f2dbb42dfa1a2e686efab5b6d","09b9678ddc3d452ea4a3d46e15826065",16010095,2,-1,0,1053,354,353,-1
"09b9678ddc3d452ea4a3d46e15826065","c20993c944444fe085345591a8bd837e",16010095,1,-2,0,1054,353,351,-2
"c20993c944444fe085345591a8bd837e","c20993c944444fe085345591a8bd837e",16010095,4,0,1,1055,351,351,0
"897b7f51242c44aab2205c72fdcbf4cd","897b7f51242c44aab2205c72fdcbf4cd",16010095,4,0,1,1059,352,352,0
"897b7f51242c44aab2205c72fdcbf4cd","09b9678ddc3d452ea4a3d46e15826065",16010095,1,1,0,1062,352,353,1
"09b9678ddc3d452ea4a3d46e15826065","09b9678ddc3d452ea4a3d46e15826065",16010095,4,0,1,1063,353,353,0
"09b9678ddc3d452ea4a3d46e15826065","eff0de7f2dbb42dfa1a2e686efab5b6d",16010095,1,1,0,1066,353,354,1
"eff0de7f2dbb42dfa1a2e686efab5b6d","eff0de7f2dbb42dfa1a2e686efab5b6d",16010095,4,0,1,1067,354,354,0
"eff0de7f2dbb42dfa1a2e686efab5b6d","30ead9794d4847abaf222ca966cc8630",16010095,1,-6,0,1070,354,348,-6
"2fe14166dc9642c3bc666b86a57f943d","44421dd1e13a47a388c4a19834b744c7",16010095,1,2,0,1073,357,359,2
"44421dd1e13a47a388c4a19834b744c7","44421dd1e13a47a388c4a19834b744c7",16010095,2,0,1,1074,359,359,0
"44421dd1e13a47a388c4a19834b744c7","cb5fc7ef85d547c4be1a7439d0bf6052",16010095,1,1,0,1076,359,360,1
"cb5fc7ef85d547c4be1a7439d0bf6052","cb5fc7ef85d547c4be1a7439d0bf6052",16010095,5,0,1,1077,360,360,0
"cb5fc7ef85d547c4be1a7439d0bf6052","0a8f150a4cf747acbde62f4721823da3",16010095,1,1,0,1082,360,361,1
"0a8f150a4cf747acbde62f4721823da3","0a8f150a4cf747acbde62f4721823da3",16010095,5,0,1,1083,361,361,0
"0a8f150a4cf747acbde62f4721823da3","ab8fdad974ae471f9f24c3f9dd04462e",16010095,1,1,0,1088,361,362,1
"ab8fdad974ae471f9f24c3f9dd04462e","ab8fdad974ae471f9f24c3f9dd04462e",16010095,2,0,1,1089,362,362,0
"ab8fdad974ae471f9f24c3f9dd04462e","1ba8fef685d74a8194b9db252eb704fb",16010095,1,-7,0,1091,362,355,-7
"1ba8fef685d74a8194b9db252eb704fb","52580888dadb4fe3baa795683ea227bd",16010095,1,10,0,1092,355,364,9
"52580888dadb4fe3baa795683ea227bd","52580888dadb4fe3baa795683ea227bd",16010095,1,0,1,1093,364,364,0
"52580888dadb4fe3baa795683ea227bd","f00179e251a045b39c3f7a54f9aa4acc",16010095,2,-1,0,1094,364,363,-1
"f00179e251a045b39c3f7a54f9aa4acc","492a3bc6a1254f23a7998587961b22a4",16010095,1,4,0,1095,363,366,3
"492a3bc6a1254f23a7998587961b22a4","492a3bc6a1254f23a7998587961b22a4",16010095,4,0,1,1096,366,366,0
"492a3bc6a1254f23a7998587961b22a4","072a190fd302456290895f9f04d6940a",16010095,1,-1,0,1100,366,365,-1
"072a190fd302456290895f9f04d6940a","c76574d21bc14aeea7ecd0b027f39858",16010095,1,3,0,1101,365,367,2
"c76574d21bc14aeea7ecd0b027f39858","52580888dadb4fe3baa795683ea227bd",16010095,1,-5,0,1102,367,364,-3
"f00179e251a045b39c3f7a54f9aa4acc","2fe14166dc9642c3bc666b86a57f943d",16010095,1,-7,0,1104,363,357,-6
"2fe14166dc9642c3bc666b86a57f943d","1ba8fef685d74a8194b9db252eb704fb",16010095,1,-2,0,1105,357,355,-2
"1ba8fef685d74a8194b9db252eb704fb","cfa457d1743848e4bb5e4beced6448ed",16010095,1,17,0,1106,355,369,14
"cfa457d1743848e4bb5e4beced6448ed","cfa457d1743848e4bb5e4beced6448ed",16010095,1,0,1,1107,369,369,0
"cfa457d1743848e4bb5e4beced6448ed","30ead9794d4847abaf222ca966cc8630",16010095,1,-25,0,1108,369,348,-21
"30ead9794d4847abaf222ca966cc8630","b71bac264efb4abd97015447bd490db6",16010095,1,28,0,1109,348,370,22
"b71bac264efb4abd97015447bd490db6","b71bac264efb4abd97015447bd490db6",16010095,7,0,1,1110,370,370,0
"b71bac264efb4abd97015447bd490db6","8d448d625b024c82a5eb240bbd7431d6",16010095,4,5,0,1111,370,374,4
"8d448d625b024c82a5eb240bbd7431d6","8d448d625b024c82a5eb240bbd7431d6",16010095,65,0,1,1112,374,374,0
"8d448d625b024c82a5eb240bbd7431d6","4a29443515bb404cb8924e1c60a63b73",16010095,1,-115,0,1119,374,285,-89
"4a29443515bb404cb8924e1c60a63b73","d6d02b6ef04e4f17805504500b8ce441",16010095,1,118,0,1120,285,375,90
"d6d02b6ef04e4f17805504500b8ce441","d6d02b6ef04e4f17805504500b8ce441",16010095,4,0,1,1121,375,375,0
"d6d02b6ef04e4f17805504500b8ce441","66baf19b6b904b70922329068c63746d",16010095,2,4,0,1123,375,376,1
"66baf19b6b904b70922329068c63746d","7f544639412e40a9ba27f43b415362ab",16010095,3,2,0,1124,376,378,2
"7f544639412e40a9ba27f43b415362ab","66baf19b6b904b70922329068c63746d",16010095,2,-2,0,1125,378,376,-2
"66baf19b6b904b70922329068c63746d","66baf19b6b904b70922329068c63746d",16010095,1,0,1,1126,376,376,0
"7f544639412e40a9ba27f43b415362ab","b2f0d654738f48158edff28e8d3a546e",16010095,1,110,0,1128,378,449,71
"b2f0d654738f48158edff28e8d3a546e","b2f0d654738f48158edff28e8d3a546e",16010095,4,0,1,1129,449,449,0
"b2f0d654738f48158edff28e8d3a546e","f60ee41ec635499abd48168342d32c2f",16010095,6,5,0,1132,449,453,4
"f60ee41ec635499abd48168342d32c2f","b2f0d654738f48158edff28e8d3a546e",16010095,3,-5,0,1133,453,449,-4
"f60ee41ec635499abd48168342d32c2f","f60ee41ec635499abd48168342d32c2f",16010095,31,0,1,1135,453,453,0
"f60ee41ec635499abd48168342d32c2f","bc5524e78a8544e2ae2fdc2f3462bbec",16010095,1,-252,0,1141,453,279,-174
"bc5524e78a8544e2ae2fdc2f3462bbec","0d987bed3ffa4ed0b9a2e62e97b7b30f",16010095,1,-9,0,1142,279,272,-7
"0d987bed3ffa4ed0b9a2e62e97b7b30f","bb5a47f5ea01454a8b79455422d3b9da",16010095,4,10,0,1143,272,280,8
"bb5a47f5ea01454a8b79455422d3b9da","bb5a47f5ea01454a8b79455422d3b9da",16010095,103,0,1,1144,280,280,0
"bb5a47f5ea01454a8b79455422d3b9da","7f544639412e40a9ba27f43b415362ab",16010095,1,136,0,1151,280,378,98
"7f544639412e40a9ba27f43b415362ab","d5ae8642e15b46b8bd298b02274d4e9c",16010095,1,2,0,1152,378,380,2
"d5ae8642e15b46b8bd298b02274d4e9c","d5ae8642e15b46b8bd298b02274d4e9c",16010095,1,0,1,1153,380,380,0
"d5ae8642e15b46b8bd298b02274d4e9c","a0d10309a2dd456289147f84be9d37f9",16010095,1,1,0,1154,380,381,1
"a0d10309a2dd456289147f84be9d37f9","a0d10309a2dd456289147f84be9d37f9",16010095,2,0,1,1155,381,381,0
"a0d10309a2dd456289147f84be9d37f9","0fcbc3ca07b144138b8d85da581f09a8",16010095,1,1,0,1157,381,382,1
"0fcbc3ca07b144138b8d85da581f09a8","0fcbc3ca07b144138b8d85da581f09a8",16010095,2,0,1,1158,382,382,0
"0fcbc3ca07b144138b8d85da581f09a8","66baf19b6b904b70922329068c63746d",16010095,1,-6,0,1160,382,376,-6
"66baf19b6b904b70922329068c63746d","4890121ce5d74576b4632b77cfc23398",16010095,1,14,0,1161,376,388,12
"4890121ce5d74576b4632b77cfc23398","c2fca3669923477ab966ded303dea31c",16010095,1,-6,0,1162,388,383,-5
"c2fca3669923477ab966ded303dea31c","4890121ce5d74576b4632b77cfc23398",16010095,1,6,0,1163,383,388,5
"4890121ce5d74576b4632b77cfc23398","4890121ce5d74576b4632b77cfc23398",16010095,1,0,1,1164,388,388,0
"4890121ce5d74576b4632b77cfc23398","18d3b836dd804224883cc9180b60a8e1",16010095,1,-1,0,1165,388,387,-1
"18d3b836dd804224883cc9180b60a8e1","96bb2b3e85a34d8b9544514e89f6fe97",16010095,1,4,0,1166,387,390,3
"96bb2b3e85a34d8b9544514e89f6fe97","96bb2b3e85a34d8b9544514e89f6fe97",16010095,1,0,1,1167,390,390,0
"96bb2b3e85a34d8b9544514e89f6fe97","ac4e9b54acfe4670b4634859c7263cb5",16010095,1,2,0,1168,390,392,2
"ac4e9b54acfe4670b4634859c7263cb5","ac4e9b54acfe4670b4634859c7263cb5",16010095,3,0,1,1169,392,392,0
"ac4e9b54acfe4670b4634859c7263cb5","17f95d18bab743888e1736033dc3384d",16010095,1,-3,0,1172,392,389,-3
"17f95d18bab743888e1736033dc3384d","6f8881a745ac4c358a68b92c3b4abe81",16010095,1,6,0,1173,389,394,5
"6f8881a745ac4c358a68b92c3b4abe81","6f8881a745ac4c358a68b92c3b4abe81",16010095,1,0,1,1174,394,394,0
"6f8881a745ac4c358a68b92c3b4abe81","f7002c8484354eceac57bc7bd62c76c1",16010095,1,-1,0,1175,394,393,-1
"f7002c8484354eceac57bc7bd62c76c1","44a277ea44dc4ae689fab4b82f0b4098",16010095,1,5,0,1176,393,397,4
"44a277ea44dc4ae689fab4b82f0b4098","44a277ea44dc4ae689fab4b82f0b4098",16010095,1,0,1,1177,397,397,0
"44a277ea44dc4ae689fab4b82f0b4098","0c12af0a4e7f4002852cf84b2537c161",16010095,1,-2,0,1178,397,395,-2
"0c12af0a4e7f4002852cf84b2537c161","859e0b8d71694b12befb69ee698138f9",16010095,1,5,0,1179,395,399,4
"859e0b8d71694b12befb69ee698138f9","859e0b8d71694b12befb69ee698138f9",16010095,1,0,1,1180,399,399,0
"859e0b8d71694b12befb69ee698138f9","2b09a08242b54983aec7063990fb3f66",16010095,1,3,0,1181,399,400,1
"2b09a08242b54983aec7063990fb3f66","66baf19b6b904b70922329068c63746d",16010095,2,-32,0,1182,400,376,-24
"66baf19b6b904b70922329068c63746d","2b09a08242b54983aec7063990fb3f66",16010095,2,32,0,1183,376,400,24
"2b09a08242b54983aec7063990fb3f66","2b09a08242b54983aec7063990fb3f66",16010095,3,0,1,1184,400,400,0
"2b09a08242b54983aec7063990fb3f66","1f471b7a883a4df48211e8c6a81b59a7",16010095,1,1,0,1185,400,401,1
"1f471b7a883a4df48211e8c6a81b59a7","1f471b7a883a4df48211e8c6a81b59a7",16010095,1,0,1,1186,401,401,0
"1f471b7a883a4df48211e8c6a81b59a7","2b09a08242b54983aec7063990fb3f66",16010095,1,-1,0,1187,401,400,-1
"2b09a08242b54983aec7063990fb3f66","9de0d567bfa84fe5b77cb76f4a76a5d1",16010095,1,5,0,1188,400,404,4
"9de0d567bfa84fe5b77cb76f4a76a5d1","9de0d567bfa84fe5b77cb76f4a76a5d1",16010095,1,0,1,1189,404,404,0
"9de0d567bfa84fe5b77cb76f4a76a5d1","1157bd665ec4472fb58b751dc5099355",16010095,1,-1,0,1190,404,403,-1
"1157bd665ec4472fb58b751dc5099355","3c8a22d2f9c146ea956609e3ed4f2559",16010095,1,3,0,1191,403,405,2
"3c8a22d2f9c146ea956609e3ed4f2559","58fc9094275e4c49be3f4ba6d4acc0a4",16010095,1,2,0,1192,405,406,1
"58fc9094275e4c49be3f4ba6d4acc0a4","58fc9094275e4c49be3f4ba6d4acc0a4",16010095,2,0,1,1193,406,406,0
"58fc9094275e4c49be3f4ba6d4acc0a4","c1c1be90b2b14c1ab4a5e1ee3c241902",16010095,1,1,0,1194,406,407,1
"c1c1be90b2b14c1ab4a5e1ee3c241902","c1c1be90b2b14c1ab4a5e1ee3c241902",16010095,5,0,1,1195,407,407,0
"c1c1be90b2b14c1ab4a5e1ee3c241902","58fc9094275e4c49be3f4ba6d4acc0a4",16010095,1,-1,0,1200,407,406,-1
"58fc9094275e4c49be3f4ba6d4acc0a4","02b3a1bead9244c1ba2f857c7da8f82a",16010095,1,3,0,1202,406,408,2
"02b3a1bead9244c1ba2f857c7da8f82a","02b3a1bead9244c1ba2f857c7da8f82a",16010095,1,0,1,1203,408,408,0
"02b3a1bead9244c1ba2f857c7da8f82a","2b09a08242b54983aec7063990fb3f66",16010095,2,-12,0,1204,408,400,-8
"2b09a08242b54983aec7063990fb3f66","78adeee1fa2c4fe0bc73f7bca9fcee86",16010095,1,-328,0,1207,400,160,-240
"78adeee1fa2c4fe0bc73f7bca9fcee86","65202579580f4ad38d734b4ee39d22a8",16010095,7,5,0,1208,160,164,4
"65202579580f4ad38d734b4ee39d22a8","65202579580f4ad38d734b4ee39d22a8",16010095,91,0,1,1209,164,164,0
"65202579580f4ad38d734b4ee39d22a8","d9c8d8c444a64dadbbb508652c721e17",16010095,1,-147,0,1216,164,46,-118
"d9c8d8c444a64dadbbb508652c721e17","b534b89233134e30a9b5645138bfa9ee",16010095,1,-6,0,1217,46,41,-5
"b534b89233134e30a9b5645138bfa9ee","6e13d61a7bdb44bca949c9f86fab3be5",16010095,2,7,0,1218,41,47,6
"6e13d61a7bdb44bca949c9f86fab3be5","65202579580f4ad38d734b4ee39d22a8",16010095,1,146,0,1219,47,164,117
"65202579580f4ad38d734b4ee39d22a8","78adeee1fa2c4fe0bc73f7bca9fcee86",16010095,5,-5,0,1225,164,160,-4
"78adeee1fa2c4fe0bc73f7bca9fcee86","78adeee1fa2c4fe0bc73f7bca9fcee86",16010095,2,0,1,1226,160,160,0
"78adeee1fa2c4fe0bc73f7bca9fcee86","3cbcea2be0984e7dbd5a48195af10ce7",16010095,4,8,0,1282,160,165,5
"3cbcea2be0984e7dbd5a48195af10ce7","82e6285962b8400d9d6fc32436022a94",16010095,3,2,0,1283,165,167,2
"82e6285962b8400d9d6fc32436022a94","0d987bed3ffa4ed0b9a2e62e97b7b30f",16010095,1,142,0,1284,167,272,105
"bb5a47f5ea01454a8b79455422d3b9da","bc5524e78a8544e2ae2fdc2f3462bbec",16010095,3,-1,0,1293,280,279,-1
"bc5524e78a8544e2ae2fdc2f3462bbec","82ae07bc0c9b4570a41799290d1ef399",16010095,2,-5,0,1294,279,275,-4
"82ae07bc0c9b4570a41799290d1ef399","0d987bed3ffa4ed0b9a2e62e97b7b30f",16010095,1,-4,0,1295,275,272,-3
"0d987bed3ffa4ed0b9a2e62e97b7b30f","82ae07bc0c9b4570a41799290d1ef399",16010095,2,4,0,1296,272,275,3
"82ae07bc0c9b4570a41799290d1ef399","bb5a47f5ea01454a8b79455422d3b9da",16010095,6,6,0,1297,275,280,5
"bb5a47f5ea01454a8b79455422d3b9da","0d987bed3ffa4ed0b9a2e62e97b7b30f",16010095,2,-10,0,1305,280,272,-8
"0d987bed3ffa4ed0b9a2e62e97b7b30f","0d987bed3ffa4ed0b9a2e62e97b7b30f",16010095,4,0,1,1306,272,272,0
"bb5a47f5ea01454a8b79455422d3b9da","82ae07bc0c9b4570a41799290d1ef399",16010095,3,-6,0,1309,280,275,-5
"bc5524e78a8544e2ae2fdc2f3462bbec","78adeee1fa2c4fe0bc73f7bca9fcee86",16010095,1,-161,0,1329,279,160,-119
"78adeee1fa2c4fe0bc73f7bca9fcee86","8959e6304a0348309a771e4d08d1b64a",16010095,1,4,0,1330,160,163,3
"8959e6304a0348309a771e4d08d1b64a","78adeee1fa2c4fe0bc73f7bca9fcee86",16010095,3,-4,0,1331,163,160,-3
"65202579580f4ad38d734b4ee39d22a8","bb5a47f5ea01454a8b79455422d3b9da",16010095,1,157,0,1341,164,280,116
"bb5a47f5ea01454a8b79455422d3b9da","94cecc3f1e7d484b8e068e79241dfd73",16010095,1,3,0,1398,280,281,1
"94cecc3f1e7d484b8e068e79241dfd73","0d987bed3ffa4ed0b9a2e62e97b7b30f",16010095,1,-13,0,1399,281,272,-9
"0d987bed3ffa4ed0b9a2e62e97b7b30f","a37477c4e4c14169ad44b06b493007f6",16010095,1,15,0,1400,272,283,11
"a37477c4e4c14169ad44b06b493007f6","b71bac264efb4abd97015447bd490db6",16010095,1,117,0,1401,283,370,87
"8d448d625b024c82a5eb240bbd7431d6","b71bac264efb4abd97015447bd490db6",16010095,2,-5,0,1408,374,370,-4
"8d448d625b024c82a5eb240bbd7431d6","d6d02b6ef04e4f17805504500b8ce441",16010095,1,3,0,1458,374,375,1
"d6d02b6ef04e4f17805504500b8ce441","b71bac264efb4abd97015447bd490db6",16010095,2,-8,0,1459,375,370,-5
"b71bac264efb4abd97015447bd490db6","d6d02b6ef04e4f17805504500b8ce441",16010095,2,8,0,1460,370,375,5
"66baf19b6b904b70922329068c63746d","96bb2b3e85a34d8b9544514e89f6fe97",16010095,1,17,0,1481,376,390,14
"96bb2b3e85a34d8b9544514e89f6fe97","c2fca3669923477ab966ded303dea31c",16010095,1,-9,0,1482,390,383,-7
"c2fca3669923477ab966ded303dea31c","6f8881a745ac4c358a68b92c3b4abe81",16010095,1,14,0,1483,383,394,11
"6f8881a745ac4c358a68b92c3b4abe81","17f95d18bab743888e1736033dc3384d",16010095,1,-6,0,1484,394,389,-5
"17f95d18bab743888e1736033dc3384d","f7002c8484354eceac57bc7bd62c76c1",16010095,1,5,0,1485,389,393,4
"f7002c8484354eceac57bc7bd62c76c1","0c12af0a4e7f4002852cf84b2537c161",16010095,1,3,0,1486,393,395,2
"0c12af0a4e7f4002852cf84b2537c161","2b09a08242b54983aec7063990fb3f66",16010095,1,8,0,1487,395,400,5
"2b09a08242b54983aec7063990fb3f66","02b3a1bead9244c1ba2f857c7da8f82a",16010095,2,12,0,1490,400,408,8
"02b3a1bead9244c1ba2f857c7da8f82a","6206fc6479014bb193084c32409dc1b9",16010095,1,1,0,1493,408,409,1
"6206fc6479014bb193084c32409dc1b9","6206fc6479014bb193084c32409dc1b9",16010095,1,0,1,1494,409,409,0
"6206fc6479014bb193084c32409dc1b9","02b3a1bead9244c1ba2f857c7da8f82a",16010095,1,-1,0,1495,409,408,-1
"02b3a1bead9244c1ba2f857c7da8f82a","6a5f020451db426dacba9e2ea3fcc62a",16010095,1,3,0,1496,408,410,2
"6a5f020451db426dacba9e2ea3fcc62a","6a5f020451db426dacba9e2ea3fcc62a",16010095,2,0,1,1497,410,410,0
"6a5f020451db426dacba9e2ea3fcc62a","33a9d248b2e44588a5b07fc1342b9bc2",16010095,1,2,0,1499,410,411,1
"33a9d248b2e44588a5b07fc1342b9bc2","33a9d248b2e44588a5b07fc1342b9bc2",16010095,1,0,1,1500,411,411,0
"33a9d248b2e44588a5b07fc1342b9bc2","c6f26bd420634f1cb7989e76fe6b16c0",16010095,1,1,0,1501,411,412,1
"c6f26bd420634f1cb7989e76fe6b16c0","c6f26bd420634f1cb7989e76fe6b16c0",16010095,5,0,1,1502,412,412,0
"c6f26bd420634f1cb7989e76fe6b16c0","2a65ee6e2ac64f6a8a55fbe5373ec763",16010095,1,1,0,1507,412,413,1
"2a65ee6e2ac64f6a8a55fbe5373ec763","2a65ee6e2ac64f6a8a55fbe5373ec763",16010095,2,0,1,1508,413,413,0
"2a65ee6e2ac64f6a8a55fbe5373ec763","33a9d248b2e44588a5b07fc1342b9bc2",16010095,1,-2,0,1510,413,411,-2
"33a9d248b2e44588a5b07fc1342b9bc2","1fd0f6dadbc14ebc965faf6122190b96",16010095,1,5,0,1511,411,415,4
"1fd0f6dadbc14ebc965faf6122190b96","1fd0f6dadbc14ebc965faf6122190b96",16010095,1,0,1,1512,415,415,0
"1fd0f6dadbc14ebc965faf6122190b96","687055dad9fc40c3982478fe33ec01bf",16010095,1,-1,0,1513,415,414,-1
"687055dad9fc40c3982478fe33ec01bf","2add1669f08d4101913db15f8c23b3b7",16010095,1,3,0,1514,414,416,2
"2add1669f08d4101913db15f8c23b3b7","2add1669f08d4101913db15f8c23b3b7",16010095,1,0,1,1515,416,416,0
"2add1669f08d4101913db15f8c23b3b7","2b09a08242b54983aec7063990fb3f66",16010095,1,-24,0,1516,416,400,-16
"2b09a08242b54983aec7063990fb3f66","a2b4bd40cee2481ebd3fc179d6a5cd62",16010095,1,27,0,1517,400,417,17
"a2b4bd40cee2481ebd3fc179d6a5cd62","e34e59dce2204f228f3a84b6725df60f",16010095,1,2,0,1518,417,419,2
"e34e59dce2204f228f3a84b6725df60f","e34e59dce2204f228f3a84b6725df60f",16010095,1,0,1,1519,419,419,0
"e34e59dce2204f228f3a84b6725df60f","a2b4bd40cee2481ebd3fc179d6a5cd62",16010095,1,-2,0,1520,419,417,-2
"a2b4bd40cee2481ebd3fc179d6a5cd62","bec48fc2e1294c7eb3d0aca780d731b8",16010095,1,4,0,1521,417,420,3
"bec48fc2e1294c7eb3d0aca780d731b8","bec48fc2e1294c7eb3d0aca780d731b8",16010095,2,0,1,1522,420,420,0
"bec48fc2e1294c7eb3d0aca780d731b8","a24600b0e49245f6bdba8c893cfeddb0",16010095,1,7,0,1524,420,425,5
"a24600b0e49245f6bdba8c893cfeddb0","dbde19fcce2a4c1abdc7f685c293a23f",16010095,1,-4,0,1525,425,422,-3
"dbde19fcce2a4c1abdc7f685c293a23f","a24600b0e49245f6bdba8c893cfeddb0",16010095,1,4,0,1526,422,425,3
"a24600b0e49245f6bdba8c893cfeddb0","a24600b0e49245f6bdba8c893cfeddb0",16010095,1,0,1,1527,425,425,0
"a24600b0e49245f6bdba8c893cfeddb0","a2b4bd40cee2481ebd3fc179d6a5cd62",16010095,1,-11,0,1528,425,417,-8
"a2b4bd40cee2481ebd3fc179d6a5cd62","24cf8786024543f19b89bc20034e60d7",16010095,2,18,0,1529,417,428,11
"24cf8786024543f19b89bc20034e60d7","a2b4bd40cee2481ebd3fc179d6a5cd62",16010095,1,-18,0,1530,428,417,-11
"24cf8786024543f19b89bc20034e60d7","f2a73be2f46840b182d7bd095378004e",16010095,1,1,0,1532,428,429,1
"f2a73be2f46840b182d7bd095378004e","f2a73be2f46840b182d7bd095378004e",16010095,3,0,1,1533,429,429,0
"f2a73be2f46840b182d7bd095378004e","604551fd4266430cb860fef58fa7dd61",16010095,1,1,0,1536,429,430,1
"604551fd4266430cb860fef58fa7dd61","604551fd4266430cb860fef58fa7dd61",16010095,1,0,1,1537,430,430,0
"604551fd4266430cb860fef58fa7dd61","24cf8786024543f19b89bc20034e60d7",16010095,1,-2,0,1538,430,428,-2
"24cf8786024543f19b89bc20034e60d7","dce46f8904594a62a6377a3587aaa663",16010095,1,4,0,1539,428,431,3
"dce46f8904594a62a6377a3587aaa663","dce46f8904594a62a6377a3587aaa663",16010095,2,0,1,1540,431,431,0
"dce46f8904594a62a6377a3587aaa663","9b9d0a249052413c869753b99682b0ac",16010095,1,1,0,1542,431,432,1
"9b9d0a249052413c869753b99682b0ac","9b9d0a249052413c869753b99682b0ac",16010095,3,0,1,1543,432,432,0
"9b9d0a249052413c869753b99682b0ac","061c175cc90f45fbad883025394e78dd",16010095,1,1,0,1546,432,433,1
"061c175cc90f45fbad883025394e78dd","061c175cc90f45fbad883025394e78dd",16010095,1,0,1,1547,433,433,0
"061c175cc90f45fbad883025394e78dd","dce46f8904594a62a6377a3587aaa663",16010095,1,-2,0,1548,433,431,-2
"dce46f8904594a62a6377a3587aaa663","74a7f8712e5449c2bc0b43c6f90dafed",16010095,1,5,0,1549,431,435,4
"74a7f8712e5449c2bc0b43c6f90dafed","74a7f8712e5449c2bc0b43c6f90dafed",16010095,1,0,1,1550,435,435,0
"74a7f8712e5449c2bc0b43c6f90dafed","66ada10dde9f43018588f1ced9d477fc",16010095,1,-1,0,1551,435,434,-1
"66ada10dde9f43018588f1ced9d477fc","bf12c96466d840a69bed7020b3f18bb8",16010095,1,3,0,1552,434,436,2
"bf12c96466d840a69bed7020b3f18bb8","bf12c96466d840a69bed7020b3f18bb8",16010095,1,0,1,1553,436,436,0
"bf12c96466d840a69bed7020b3f18bb8","24cf8786024543f19b89bc20034e60d7",16010095,1,-11,0,1554,436,428,-8
"24cf8786024543f19b89bc20034e60d7","070600601c4c439288445d2f0724807d",16010095,1,14,0,1555,428,437,9
"070600601c4c439288445d2f0724807d","1823b6de7d334a7aaabc4570719af4d9",16010095,1,2,0,1556,437,439,2
"1823b6de7d334a7aaabc4570719af4d9","1823b6de7d334a7aaabc4570719af4d9",16010095,10,0,1,1557,439,439,0
"1823b6de7d334a7aaabc4570719af4d9","070600601c4c439288445d2f0724807d",16010095,1,-2,0,1567,439,437,-2
"070600601c4c439288445d2f0724807d","0380cd76a7d44bc3a4da1f15e4d68f89",16010095,1,4,0,1568,437,440,3
"0380cd76a7d44bc3a4da1f15e4d68f89","0380cd76a7d44bc3a4da1f15e4d68f89",16010095,3,0,1,1569,440,440,0
"0380cd76a7d44bc3a4da1f15e4d68f89","23b7673c8b5443108c2ef09382834a86",16010095,1,2,0,1572,440,441,1
"23b7673c8b5443108c2ef09382834a86","23b7673c8b5443108c2ef09382834a86",16010095,2,0,1,1573,441,441,0
"23b7673c8b5443108c2ef09382834a86","901e92500aea43c79f19f1b279050668",16010095,2,2,0,1575,441,442,1
"901e92500aea43c79f19f1b279050668","23b7673c8b5443108c2ef09382834a86",16010095,1,-2,0,1576,442,441,-1
"901e92500aea43c79f19f1b279050668","001339db8ced4cf78829ebe8b145449d",16010095,1,1,0,1578,442,443,1
"001339db8ced4cf78829ebe8b145449d","001339db8ced4cf78829ebe8b145449d",16010095,5,0,1,1579,443,443,0
"001339db8ced4cf78829ebe8b145449d","452745e0366e42ae81561bfddebcc6c3",16010095,1,1,0,1584,443,444,1
"452745e0366e42ae81561bfddebcc6c3","452745e0366e42ae81561bfddebcc6c3",16010095,2,0,1,1585,444,444,0
"452745e0366e42ae81561bfddebcc6c3","901e92500aea43c79f19f1b279050668",16010095,1,-2,0,1587,444,442,-2
"901e92500aea43c79f19f1b279050668","4660ff2089114e8db82ceb26a4f329e3",16010095,1,4,0,1588,442,445,3
"4660ff2089114e8db82ceb26a4f329e3","4660ff2089114e8db82ceb26a4f329e3",16010095,3,0,1,1589,445,445,0
"4660ff2089114e8db82ceb26a4f329e3","7bd5586eb9d8484eb74a433ee7bfe499",16010095,1,2,0,1592,445,446,1
"7bd5586eb9d8484eb74a433ee7bfe499","7bd5586eb9d8484eb74a433ee7bfe499",16010095,10,0,1,1593,446,446,0
"7bd5586eb9d8484eb74a433ee7bfe499","8a7f26e690f34dda97be16904518ca99",16010095,1,2,0,1603,446,447,1
"8a7f26e690f34dda97be16904518ca99","8a7f26e690f34dda97be16904518ca99",16010095,5,0,1,1604,447,447,0
"8a7f26e690f34dda97be16904518ca99","070600601c4c439288445d2f0724807d",16010095,1,-16,0,1609,447,437,-10
"070600601c4c439288445d2f0724807d","b2f0d654738f48158edff28e8d3a546e",16010095,1,21,0,1610,437,449,12
"f60ee41ec635499abd48168342d32c2f","30ead9794d4847abaf222ca966cc8630",16010095,1,-157,0,1633,453,348,-105
"30ead9794d4847abaf222ca966cc8630","c76574d21bc14aeea7ecd0b027f39858",16010095,1,23,0,1634,348,367,19
"c76574d21bc14aeea7ecd0b027f39858","2fe14166dc9642c3bc666b86a57f943d",16010095,1,-13,0,1635,367,357,-10
"2fe14166dc9642c3bc666b86a57f943d","4a29443515bb404cb8924e1c60a63b73",16010095,1,-92,0,1636,357,285,-72
"4a29443515bb404cb8924e1c60a63b73","0c4079457ede49e3aeb5e86ed84bdf35",16010095,1,58,0,1637,285,329,44
"0c4079457ede49e3aeb5e86ed84bdf35","38aea304b4fa46e1b29bb72f5cea4c93",16010095,2,2,0,1638,329,331,2
"38aea304b4fa46e1b29bb72f5cea4c93","30ead9794d4847abaf222ca966cc8630",16010095,1,22,0,1639,331,348,17
"30ead9794d4847abaf222ca966cc8630","09b9678ddc3d452ea4a3d46e15826065",16010095,1,5,0,1641,348,353,5
"09b9678ddc3d452ea4a3d46e15826065","897b7f51242c44aab2205c72fdcbf4cd",16010095,2,-1,0,1642,353,352,-1
"c20993c944444fe085345591a8bd837e","eff0de7f2dbb42dfa1a2e686efab5b6d",16010095,2,3,0,1644,351,354,3
"eff0de7f2dbb42dfa1a2e686efab5b6d","c20993c944444fe085345591a8bd837e",16010095,1,-3,0,1645,354,351,-3
"897b7f51242c44aab2205c72fdcbf4cd","4a29443515bb404cb8924e1c60a63b73",16010095,1,-86,0,1653,352,285,-67
"4a29443515bb404cb8924e1c60a63b73","4a29443515bb404cb8924e1c60a63b73",16010095,2,0,1,1654,285,285,0
"4a29443515bb404cb8924e1c60a63b73","208c9b2796c944db8dacaa96082520ea",16010095,2,3,0,1656,285,288,3
"208c9b2796c944db8dacaa96082520ea","fab84b4fab5940efb4ea868ef8d09396",16010095,1,-7,0,1657,288,284,-4
"fab84b4fab5940efb4ea868ef8d09396","4a29443515bb404cb8924e1c60a63b73",16010095,2,4,0,1658,284,285,1
"4a29443515bb404cb8924e1c60a63b73","0c7262dff33c4087bc660ccf40f92f9c",16010095,1,-157,0,1659,285,169,-116
"0c7262dff33c4087bc660ccf40f92f9c","a2b4bd40cee2481ebd3fc179d6a5cd62",16010095,1,338,0,1660,169,417,248
"67a089198fcb4e1c8f2385786c2b296f","b613861cecf84ffcab01afb23f660475",3198738,1,-72,0,1,39,1,-38
"b613861cecf84ffcab01afb23f660475","b613861cecf84ffcab01afb23f660475",3198738,5,0,1,2,1,1,0
"b613861cecf84ffcab01afb23f660475","e2911e79efc2420eac45d9f671463d4b",3198738,1,3,0,7,1,2,1
"e2911e79efc2420eac45d9f671463d4b","e2911e79efc2420eac45d9f671463d4b",3198738,3,0,1,10,2,2,0
"e2911e79efc2420eac45d9f671463d4b","519d1b8c59404d67b54e96c5c8a830b2",3198738,1,1,0,11,2,3,1
"519d1b8c59404d67b54e96c5c8a830b2","519d1b8c59404d67b54e96c5c8a830b2",3198738,3,0,1,12,3,3,0
"519d1b8c59404d67b54e96c5c8a830b2","531db53f81f646edb0cdcfe0085b03b7",3198738,1,1,0,15,3,4,1
"531db53f81f646edb0cdcfe0085b03b7","531db53f81f646edb0cdcfe0085b03b7",3198738,1,0,1,16,4,4,0
"531db53f81f646edb0cdcfe0085b03b7","4f5f94b2f95141e0a9d53a61da2276da",3198738,1,1,0,17,4,5,1
"4f5f94b2f95141e0a9d53a61da2276da","4f5f94b2f95141e0a9d53a61da2276da",3198738,1,0,1,18,5,5,0
"4f5f94b2f95141e0a9d53a61da2276da","6d541c89590949f99af293c4f2333f67",3198738,1,1,0,19,5,6,1
"6d541c89590949f99af293c4f2333f67","6d541c89590949f99af293c4f2333f67",3198738,1,0,1,20,6,6,0
"6d541c89590949f99af293c4f2333f67","dd5cf0b9fe4c4f1d8f5ff8e4c04879cb",3198738,1,1,0,21,6,7,1
"dd5cf0b9fe4c4f1d8f5ff8e4c04879cb","dd5cf0b9fe4c4f1d8f5ff8e4c04879cb",3198738,5,0,1,22,7,7,0
"dd5cf0b9fe4c4f1d8f5ff8e4c04879cb","f96261861edc426abe2248be4f0a709a",3198738,1,1,0,27,7,8,1
"f96261861edc426abe2248be4f0a709a","f96261861edc426abe2248be4f0a709a",3198738,2,0,1,28,8,8,0
"f96261861edc426abe2248be4f0a709a","66b5e16f4f75454fb5b8172079f0fa83",3198738,1,1,0,30,8,9,1
"66b5e16f4f75454fb5b8172079f0fa83","66b5e16f4f75454fb5b8172079f0fa83",3198738,2,0,1,31,9,9,0
"66b5e16f4f75454fb5b8172079f0fa83","0680571d4698477995e41842c36a54b2",3198738,1,1,0,33,9,10,1
"0680571d4698477995e41842c36a54b2","0680571d4698477995e41842c36a54b2",3198738,2,0,1,34,10,10,0
"0680571d4698477995e41842c36a54b2","9112f2bffece48e08c6d2287be204085",3198738,1,1,0,36,10,11,1
"9112f2bffece48e08c6d2287be204085","9112f2bffece48e08c6d2287be204085",3198738,2,0,1,37,11,11,0
"9112f2bffece48e08c6d2287be204085","e2911e79efc2420eac45d9f671463d4b",3198738,1,-9,0,39,11,2,-9
"e2911e79efc2420eac45d9f671463d4b","56586aa865414f538729c7f7735d2bc6",3198738,1,12,0,40,2,12,10
"56586aa865414f538729c7f7735d2bc6","56586aa865414f538729c7f7735d2bc6",3198738,6,0,1,41,12,12,0
"56586aa865414f538729c7f7735d2bc6","b7f2b31585d94eb3bf86376714aa7070",3198738,4,2,0,43,12,13,1
"b7f2b31585d94eb3bf86376714aa7070","b7f2b31585d94eb3bf86376714aa7070",3198738,4,0,1,44,13,13,0
"b7f2b31585d94eb3bf86376714aa7070","56586aa865414f538729c7f7735d2bc6",3198738,2,-2,0,45,13,12,-1
"b7f2b31585d94eb3bf86376714aa7070","3f1c815879794b929260d224becaff7e",3198738,3,2,0,51,13,14,1
"3f1c815879794b929260d224becaff7e","b7f2b31585d94eb3bf86376714aa7070",3198738,1,-2,0,52,14,13,-1
"3f1c815879794b929260d224becaff7e","56586aa865414f538729c7f7735d2bc6",3198738,2,-4,0,56,14,12,-2
"3f1c815879794b929260d224becaff7e","5c5ceeee4562457ba6d41515aeebfbb1",3198738,1,6,0,62,14,17,3
"5c5ceeee4562457ba6d41515aeebfbb1","81c864a886d54a6b8ff85f7d736f4f95",3198738,1,-4,0,63,17,15,-2
"81c864a886d54a6b8ff85f7d736f4f95","5c5ceeee4562457ba6d41515aeebfbb1",3198738,1,4,0,64,15,17,2
"5c5ceeee4562457ba6d41515aeebfbb1","9afd71a5298d4333b6849dfce1b9422c",3198738,1,3,0,65,17,18,1
"9afd71a5298d4333b6849dfce1b9422c","56586aa865414f538729c7f7735d2bc6",3198738,1,-13,0,66,18,12,-6
"56586aa865414f538729c7f7735d2bc6","9afd71a5298d4333b6849dfce1b9422c",3198738,1,13,0,67,12,18,6
"9afd71a5298d4333b6849dfce1b9422c","9afd71a5298d4333b6849dfce1b9422c",3198738,1,0,1,68,18,18,0
"9afd71a5298d4333b6849dfce1b9422c","b7719e26494940efa49512aedd0aac79",3198738,1,4,0,69,18,20,2
"d4f45188d3c84a02ba08454e6403a818","d4c3b003e8274e429d2fa688d73fde6d",3198738,1,-2,0,71,24,22,-2
"b7719e26494940efa49512aedd0aac79","b7719e26494940efa49512aedd0aac79",3198738,2,0,1,73,20,20,0
"b7719e26494940efa49512aedd0aac79","afbf7250b99d47bea07172749483ca97",3198738,4,12,0,74,20,28,8
"afbf7250b99d47bea07172749483ca97","afbf7250b99d47bea07172749483ca97",3198738,2,0,1,75,28,28,0
"afbf7250b99d47bea07172749483ca97","b7719e26494940efa49512aedd0aac79",3198738,3,-12,0,76,28,20,-8
"afbf7250b99d47bea07172749483ca97","4e51676dc72045d99c19b9fa7b22f8bc",3198738,1,3,0,84,28,29,1
"4e51676dc72045d99c19b9fa7b22f8bc","4e51676dc72045d99c19b9fa7b22f8bc",3198738,1,0,1,85,29,29,0
"4e51676dc72045d99c19b9fa7b22f8bc","51970cfa30e643e894e66ae85c8024cc",3198738,2,3,0,86,29,31,2
"51970cfa30e643e894e66ae85c8024cc","c9c52446b6294aa5a9c2abaed536c37e",3198738,1,2,0,87,31,32,1
"c9c52446b6294aa5a9c2abaed536c37e","4e51676dc72045d99c19b9fa7b22f8bc",3198738,1,-5,0,88,32,29,-3
"51970cfa30e643e894e66ae85c8024cc","4e51676dc72045d99c19b9fa7b22f8bc",3198738,1,-3,0,90,31,29,-2
"4e51676dc72045d99c19b9fa7b22f8bc","c33c17be71ae4d588da7369472e5bb1b",3198738,1,9,0,91,29,34,5
"c33c17be71ae4d588da7369472e5bb1b","c33c17be71ae4d588da7369472e5bb1b",3198738,1,0,1,92,34,34,0
"c33c17be71ae4d588da7369472e5bb1b","93679be414554a11b1893002f2229a93",3198738,1,3,0,93,34,35,1
"93679be414554a11b1893002f2229a93","93679be414554a11b1893002f2229a93",3198738,1,0,1,94,35,35,0
"93679be414554a11b1893002f2229a93","7040a13096d746ac84b8fac8d9752058",3198738,1,3,0,95,35,36,1
"7040a13096d746ac84b8fac8d9752058","7040a13096d746ac84b8fac8d9752058",3198738,1,0,1,96,36,36,0
"7040a13096d746ac84b8fac8d9752058","9a0dc646f934470daf08c4b56ccf73db",3198738,1,3,0,97,36,37,1
"9a0dc646f934470daf08c4b56ccf73db","9a0dc646f934470daf08c4b56ccf73db",3198738,1,0,1,98,37,37,0
"9a0dc646f934470daf08c4b56ccf73db","fc0e049d56024bc9a02c9a9c435c3df7",3198738,1,3,0,99,37,38,1
"fc0e049d56024bc9a02c9a9c435c3df7","fc0e049d56024bc9a02c9a9c435c3df7",3198738,1,0,1,100,38,38,0
"fc0e049d56024bc9a02c9a9c435c3df7","67a089198fcb4e1c8f2385786c2b296f",3198738,1,4,0,101,38,39,1
"67a089198fcb4e1c8f2385786c2b296f","64d48c6c9c7940639a932219a6c87198",3198738,3,1,0,102,39,40,1
"64d48c6c9c7940639a932219a6c87198","b7719e26494940efa49512aedd0aac79",3198738,1,-41,0,103,40,20,-20
"b7719e26494940efa49512aedd0aac79","d4f45188d3c84a02ba08454e6403a818",3198738,2,5,0,104,20,24,4
"d4f45188d3c84a02ba08454e6403a818","a49d1bb4328949299686242fd0be5584",3198738,1,-3,0,105,24,21,-3
"a49d1bb4328949299686242fd0be5584","d4c3b003e8274e429d2fa688d73fde6d",3198738,1,1,0,106,21,22,1
"d4c3b003e8274e429d2fa688d73fde6d","d4c3b003e8274e429d2fa688d73fde6d",3198738,2,0,1,107,22,22,0
"d4c3b003e8274e429d2fa688d73fde6d","b7719e26494940efa49512aedd0aac79",3198738,2,-3,0,109,22,20,-2
"b7719e26494940efa49512aedd0aac79","67a089198fcb4e1c8f2385786c2b296f",3198738,1,40,0,110,20,39,19
"67a089198fcb4e1c8f2385786c2b296f","67a089198fcb4e1c8f2385786c2b296f",3198738,2,0,1,111,39,39,0
"64d48c6c9c7940639a932219a6c87198","64d48c6c9c7940639a932219a6c87198",3198738,11,0,1,113,40,40,0
"64d48c6c9c7940639a932219a6c87198","67a089198fcb4e1c8f2385786c2b296f",3198738,2,-1,0,121,40,39,-1
"67a089198fcb4e1c8f2385786c2b296f","b534b89233134e30a9b5645138bfa9ee",3198738,1,4,0,128,39,41,2
"b534b89233134e30a9b5645138bfa9ee","0e37b720d23b4e7f8b313e79313fd107",3198738,1,3,0,129,41,44,3
"0e37b720d23b4e7f8b313e79313fd107","0e37b720d23b4e7f8b313e79313fd107",3198738,2,0,1,130,44,44,0
"0e37b720d23b4e7f8b313e79313fd107","6875d67fdd5f48168b62719df449bebd",3198738,1,1,0,132,44,45,1
"6875d67fdd5f48168b62719df449bebd","6875d67fdd5f48168b62719df449bebd",3198738,2,0,1,133,45,45,0
"6875d67fdd5f48168b62719df449bebd","b534b89233134e30a9b5645138bfa9ee",3198738,1,-4,0,135,45,41,-4
"b534b89233134e30a9b5645138bfa9ee","6e13d61a7bdb44bca949c9f86fab3be5",3198738,2,7,0,136,41,47,6
"6e13d61a7bdb44bca949c9f86fab3be5","6e13d61a7bdb44bca949c9f86fab3be5",3198738,2,0,1,137,47,47,0
"6e13d61a7bdb44bca949c9f86fab3be5","d9c8d8c444a64dadbbb508652c721e17",3198738,1,-1,0,139,47,46,-1
"d9c8d8c444a64dadbbb508652c721e17","d0c74f735e024943943e40333d6d337f",3198738,2,6,0,140,46,51,5
"d0c74f735e024943943e40333d6d337f","d0c74f735e024943943e40333d6d337f",3198738,1,0,1,141,51,51,0
"d0c74f735e024943943e40333d6d337f","f924752d8a1149668870b1e7698486f7",3198738,1,-1,0,142,51,50,-1
"f924752d8a1149668870b1e7698486f7","a1f2f12debe5432fb7a70bcd12bacfb9",3198738,2,9,0,143,50,58,8
"a1f2f12debe5432fb7a70bcd12bacfb9","78f30e4dcac84e3cbea8b2cc6e0d62b3",3198738,3,1,0,144,58,59,1
"78f30e4dcac84e3cbea8b2cc6e0d62b3","a1f2f12debe5432fb7a70bcd12bacfb9",3198738,1,-1,0,145,59,58,-1
"a1f2f12debe5432fb7a70bcd12bacfb9","a1f2f12debe5432fb7a70bcd12bacfb9",3198738,18,0,1,146,58,58,0
"a1f2f12debe5432fb7a70bcd12bacfb9","b534b89233134e30a9b5645138bfa9ee",3198738,1,-20,0,157,58,41,-17
"b534b89233134e30a9b5645138bfa9ee","b534b89233134e30a9b5645138bfa9ee",3198738,1,0,1,158,41,41,0
"b534b89233134e30a9b5645138bfa9ee","a1f2f12debe5432fb7a70bcd12bacfb9",3198738,1,20,0,159,41,58,17
"78f30e4dcac84e3cbea8b2cc6e0d62b3","78f30e4dcac84e3cbea8b2cc6e0d62b3",3198738,11,0,1,168,59,59,0
"78f30e4dcac84e3cbea8b2cc6e0d62b3","a0a418b8540d479fa6e0f653b701da8b",3198738,1,6,0,179,59,64,5
"a0a418b8540d479fa6e0f653b701da8b","bc42d26810654ea9a1df1efe1e58c7d5",3198738,1,-1,0,180,64,63,-1
"bc42d26810654ea9a1df1efe1e58c7d5","12aa6e1672ac4e7aa6449a7a8609cd72",3198738,1,-7,0,181,63,57,-6
"12aa6e1672ac4e7aa6449a7a8609cd72","4c943503763e4e349906eea3ed3c8e86",3198738,1,5,0,182,57,61,4
"4c943503763e4e349906eea3ed3c8e86","4c943503763e4e349906eea3ed3c8e86",3198738,2,0,1,183,61,61,0
"4c943503763e4e349906eea3ed3c8e86","bc42d26810654ea9a1df1efe1e58c7d5",3198738,1,2,0,185,61,63,2
"bc42d26810654ea9a1df1efe1e58c7d5","bc42d26810654ea9a1df1efe1e58c7d5",3198738,3,0,1,186,63,63,0
"bc42d26810654ea9a1df1efe1e58c7d5","a0a418b8540d479fa6e0f653b701da8b",3198738,1,1,0,189,63,64,1
"a0a418b8540d479fa6e0f653b701da8b","a0a418b8540d479fa6e0f653b701da8b",3198738,3,0,1,190,64,64,0
"a0a418b8540d479fa6e0f653b701da8b","309ccf3cc4fe429d9bfbaef53d3fa479",3198738,1,-4,0,193,64,60,-4
"309ccf3cc4fe429d9bfbaef53d3fa479","b534b89233134e30a9b5645138bfa9ee",3198738,1,-23,0,194,60,41,-19
"b534b89233134e30a9b5645138bfa9ee","d646286c8051419bbc2e31dd1db55ca8",3198738,1,33,0,195,41,67,26
"d646286c8051419bbc2e31dd1db55ca8","67a089198fcb4e1c8f2385786c2b296f",3198738,2,-37,0,196,67,39,-28
"67a089198fcb4e1c8f2385786c2b296f","267f883678b24aed855fde42524975d9",3198738,1,41,0,197,39,71,32
"267f883678b24aed855fde42524975d9","267f883678b24aed855fde42524975d9",3198738,2,0,1,198,71,71,0
"267f883678b24aed855fde42524975d9","88fff56d0342490dbef9040750a20f6c",3198738,1,1,0,200,71,72,1
"88fff56d0342490dbef9040750a20f6c","88fff56d0342490dbef9040750a20f6c",3198738,1,0,1,201,72,72,0
"88fff56d0342490dbef9040750a20f6c","adb17b12b66c4a49a85fd34322f7df70",3198738,1,1,0,202,72,73,1
"adb17b12b66c4a49a85fd34322f7df70","adb17b12b66c4a49a85fd34322f7df70",3198738,1,0,1,203,73,73,0
"adb17b12b66c4a49a85fd34322f7df70","d646286c8051419bbc2e31dd1db55ca8",3198738,1,-6,0,204,73,67,-6
"d646286c8051419bbc2e31dd1db55ca8","a2becd407db34b189200a32546d9d569",3198738,1,9,0,205,67,75,8
"a2becd407db34b189200a32546d9d569","a2becd407db34b189200a32546d9d569",3198738,1,0,1,206,75,75,0
"a2becd407db34b189200a32546d9d569","58c22b011d0f4c2ea6d13615edbb9eeb",3198738,1,2,0,207,75,77,2
"58c22b011d0f4c2ea6d13615edbb9eeb","58c22b011d0f4c2ea6d13615edbb9eeb",3198738,8,0,1,208,77,77,0
"58c22b011d0f4c2ea6d13615edbb9eeb","dd76e1861dc9461c830888729d091ee0",3198738,1,1,0,216,77,78,1
"dd76e1861dc9461c830888729d091ee0","dd76e1861dc9461c830888729d091ee0",3198738,8,0,1,217,78,78,0
"dd76e1861dc9461c830888729d091ee0","cd1d828f1a694b87913a7ea66c23803e",3198738,1,1,0,225,78,79,1
"cd1d828f1a694b87913a7ea66c23803e","cd1d828f1a694b87913a7ea66c23803e",3198738,8,0,1,226,79,79,0
"cd1d828f1a694b87913a7ea66c23803e","9176a3c2b4d2465fa8b0c67096c2a97e",3198738,1,1,0,234,79,80,1
"9176a3c2b4d2465fa8b0c67096c2a97e","9176a3c2b4d2465fa8b0c67096c2a97e",3198738,5,0,1,235,80,80,0
"9176a3c2b4d2465fa8b0c67096c2a97e","f8ec6445f7194e25b9101d4fbcb07a18",3198738,1,1,0,240,80,81,1
"f8ec6445f7194e25b9101d4fbcb07a18","f8ec6445f7194e25b9101d4fbcb07a18",3198738,2,0,1,241,81,81,0
"f8ec6445f7194e25b9101d4fbcb07a18","140d5b27b8574befad82c0a013b59dfa",3198738,1,-7,0,243,81,74,-7
"140d5b27b8574befad82c0a013b59dfa","d18a9ea32855445f8736581f5cb119ce",3198738,1,9,0,244,74,82,8
"d18a9ea32855445f8736581f5cb119ce","d646286c8051419bbc2e31dd1db55ca8",3198738,1,-17,0,245,82,67,-15
"d646286c8051419bbc2e31dd1db55ca8","f564483cbd7a407681aa2fcca518cf5f",3198738,1,21,0,246,67,85,18
"f564483cbd7a407681aa2fcca518cf5f","f564483cbd7a407681aa2fcca518cf5f",3198738,4,0,1,247,85,85,0
"f564483cbd7a407681aa2fcca518cf5f","18fd01350bd5434ca636d59a599d768a",3198738,1,1,0,251,85,86,1
"18fd01350bd5434ca636d59a599d768a","18fd01350bd5434ca636d59a599d768a",3198738,9,0,1,252,86,86,0
"18fd01350bd5434ca636d59a599d768a","ae5ac430ea254e708a6f5deaaf7464ae",3198738,1,-2,0,261,86,84,-2
"ae5ac430ea254e708a6f5deaaf7464ae","6a9f0ef185fb47f0937e29daa1c71ed5",3198738,1,7,0,262,84,90,6
"6a9f0ef185fb47f0937e29daa1c71ed5","c681290961c94c4caf23b529d1ae6b9a",3198738,1,-2,0,263,90,88,-2
"c681290961c94c4caf23b529d1ae6b9a","c681290961c94c4caf23b529d1ae6b9a",3198738,1,0,1,264,88,88,0
"c681290961c94c4caf23b529d1ae6b9a","6a9f0ef185fb47f0937e29daa1c71ed5",3198738,1,2,0,265,88,90,2
"6a9f0ef185fb47f0937e29daa1c71ed5","6a9f0ef185fb47f0937e29daa1c71ed5",3198738,3,0,1,266,90,90,0
"6a9f0ef185fb47f0937e29daa1c71ed5","e20db35ced8544ddac5bc3839145e463",3198738,1,3,0,269,90,91,1
"e20db35ced8544ddac5bc3839145e463","d646286c8051419bbc2e31dd1db55ca8",3198738,1,-30,0,270,91,67,-24
"67a089198fcb4e1c8f2385786c2b296f","d9c8d8c444a64dadbbb508652c721e17",3198738,1,10,0,272,39,46,7
"d9c8d8c444a64dadbbb508652c721e17","b534b89233134e30a9b5645138bfa9ee",3198738,1,-6,0,273,46,41,-5
"6e13d61a7bdb44bca949c9f86fab3be5","195f78799f984cc2b06c48dfe36be751",3198738,1,2,0,275,47,49,2
"195f78799f984cc2b06c48dfe36be751","195f78799f984cc2b06c48dfe36be751",3198738,2,0,1,276,49,49,0
"195f78799f984cc2b06c48dfe36be751","d9c8d8c444a64dadbbb508652c721e17",3198738,1,-3,0,278,49,46,-3
"d0c74f735e024943943e40333d6d337f","983f8ff320594b279a7f4a6fe132f9c5",3198738,1,2,0,280,51,53,2
"983f8ff320594b279a7f4a6fe132f9c5","983f8ff320594b279a7f4a6fe132f9c5",3198738,2,0,1,281,53,53,0
"983f8ff320594b279a7f4a6fe132f9c5","35adfa5d923046aebabfefd98f35ff05",3198738,1,1,0,283,53,54,1
"35adfa5d923046aebabfefd98f35ff05","35adfa5d923046aebabfefd98f35ff05",3198738,2,0,1,284,54,54,0
"35adfa5d923046aebabfefd98f35ff05","b6f8a98476224da1b40e555ececc7ed8",3198738,1,1,0,286,54,55,1
"b6f8a98476224da1b40e555ececc7ed8","b6f8a98476224da1b40e555ececc7ed8",3198738,2,0,1,287,55,55,0
"b6f8a98476224da1b40e555ececc7ed8","86e22cb5fe0e4b47a9489ecddf7ed78f",3198738,1,1,0,289,55,56,1
"86e22cb5fe0e4b47a9489ecddf7ed78f","86e22cb5fe0e4b47a9489ecddf7ed78f",3198738,2,0,1,290,56,56,0
"86e22cb5fe0e4b47a9489ecddf7ed78f","f924752d8a1149668870b1e7698486f7",3198738,1,-6,0,292,56,50,-6
"78f30e4dcac84e3cbea8b2cc6e0d62b3","67a089198fcb4e1c8f2385786c2b296f",3198738,1,-25,0,295,59,39,-20
"67a089198fcb4e1c8f2385786c2b296f","1febb706d7a34005ae8711ed49c76e64",3198738,1,70,0,296,39,94,55
"1febb706d7a34005ae8711ed49c76e64","1febb706d7a34005ae8711ed49c76e64",3198738,2,0,1,297,94,94,0
"1febb706d7a34005ae8711ed49c76e64","8f73ba6f5a0042f2850356ac38ac6f24",3198738,1,1,0,299,94,95,1
"8f73ba6f5a0042f2850356ac38ac6f24","8f73ba6f5a0042f2850356ac38ac6f24",3198738,5,0,1,300,95,95,0
"8f73ba6f5a0042f2850356ac38ac6f24","e2260b86653c46d7b14a41fb419dbf8c",3198738,1,1,0,305,95,96,1
"e2260b86653c46d7b14a41fb419dbf8c","e2260b86653c46d7b14a41fb419dbf8c",3198738,2,0,1,306,96,96,0
"e2260b86653c46d7b14a41fb419dbf8c","35eb641ad1d845bbba54915bce75a962",3198738,1,1,0,308,96,97,1
"35eb641ad1d845bbba54915bce75a962","35eb641ad1d845bbba54915bce75a962",3198738,5,0,1,309,97,97,0
"35eb641ad1d845bbba54915bce75a962","08be90ffbeea4795a138cd42ed8db56f",3198738,1,1,0,314,97,98,1
"08be90ffbeea4795a138cd42ed8db56f","08be90ffbeea4795a138cd42ed8db56f",3198738,2,0,1,315,98,98,0
"08be90ffbeea4795a138cd42ed8db56f","3007433c8f584dcbb5ac159c1c5f2be3",3198738,1,1,0,317,98,99,1
"3007433c8f584dcbb5ac159c1c5f2be3","3007433c8f584dcbb5ac159c1c5f2be3",3198738,2,0,1,318,99,99,0
"3007433c8f584dcbb5ac159c1c5f2be3","e20db35ced8544ddac5bc3839145e463",3198738,1,-8,0,320,99,91,-8
"e20db35ced8544ddac5bc3839145e463","00ae5f0c51874a73a41ebea838d95682",3198738,1,11,0,321,91,101,10
"00ae5f0c51874a73a41ebea838d95682","d391c8b6e56a43a7b654e9dee02d904b",3198738,2,2,0,322,101,103,2
"d391c8b6e56a43a7b654e9dee02d904b","00ae5f0c51874a73a41ebea838d95682",3198738,1,-2,0,323,103,101,-2
"d391c8b6e56a43a7b654e9dee02d904b","d391c8b6e56a43a7b654e9dee02d904b",3198738,18,0,1,325,103,103,0
"d391c8b6e56a43a7b654e9dee02d904b","6111116566fc4fd9abba409322bea245",3198738,1,1,0,343,103,104,1
"6111116566fc4fd9abba409322bea245","6111116566fc4fd9abba409322bea245",3198738,2,0,1,344,104,104,0
"6111116566fc4fd9abba409322bea245","a81b2235cb9c499eb9ea8ee0a8dd9725",3198738,1,1,0,346,104,105,1
"a81b2235cb9c499eb9ea8ee0a8dd9725","a81b2235cb9c499eb9ea8ee0a8dd9725",3198738,2,0,1,347,105,105,0
"a81b2235cb9c499eb9ea8ee0a8dd9725","2d4e0ab0ef3b4d73b82c72d4621a7579",3198738,1,1,0,349,105,106,1
"2d4e0ab0ef3b4d73b82c72d4621a7579","2d4e0ab0ef3b4d73b82c72d4621a7579",3198738,2,0,1,350,106,106,0
"2d4e0ab0ef3b4d73b82c72d4621a7579","8bdebf492ebd4e62b0d522e8ab5e5197",3198738,1,1,0,352,106,107,1
"8bdebf492ebd4e62b0d522e8ab5e5197","8bdebf492ebd4e62b0d522e8ab5e5197",3198738,3,0,1,353,107,107,0
"8bdebf492ebd4e62b0d522e8ab5e5197","4280927ec4d643238aa49c32f9e06c6c",3198738,1,3,0,356,107,109,2
"4280927ec4d643238aa49c32f9e06c6c","73039f8c1eb9409cb4caee2cf968001e",3198738,1,-10,0,357,109,100,-9
"73039f8c1eb9409cb4caee2cf968001e","4280927ec4d643238aa49c32f9e06c6c",3198738,1,10,0,358,100,109,9
"4280927ec4d643238aa49c32f9e06c6c","4280927ec4d643238aa49c32f9e06c6c",3198738,3,0,1,359,109,109,0
"4280927ec4d643238aa49c32f9e06c6c","fc44e6a5f7654430af1227838224dceb",3198738,1,2,0,362,109,111,2
"fc44e6a5f7654430af1227838224dceb","fc44e6a5f7654430af1227838224dceb",3198738,5,0,1,363,111,111,0
"fc44e6a5f7654430af1227838224dceb","08111f75e22d409998cf8b85bd431f0a",3198738,1,-3,0,368,111,108,-3
"08111f75e22d409998cf8b85bd431f0a","a9ae0a3c070d455bb4369a8996313336",3198738,1,7,0,369,108,114,6
"a9ae0a3c070d455bb4369a8996313336","78adeee1fa2c4fe0bc73f7bca9fcee86",3198738,1,59,0,370,114,160,46
"78adeee1fa2c4fe0bc73f7bca9fcee86","65202579580f4ad38d734b4ee39d22a8",3198738,7,5,0,371,160,164,4
"65202579580f4ad38d734b4ee39d22a8","78adeee1fa2c4fe0bc73f7bca9fcee86",3198738,3,-5,0,372,164,160,-4
"65202579580f4ad38d734b4ee39d22a8","65202579580f4ad38d734b4ee39d22a8",3198738,80,0,1,374,164,164,0
"65202579580f4ad38d734b4ee39d22a8","8959e6304a0348309a771e4d08d1b64a",3198738,1,-1,0,380,164,163,-1
"8959e6304a0348309a771e4d08d1b64a","78adeee1fa2c4fe0bc73f7bca9fcee86",3198738,1,-4,0,381,163,160,-3
"65202579580f4ad38d734b4ee39d22a8","37319e88176d4aefa91d7a9980dbae91",3198738,1,-66,0,390,164,112,-52
"37319e88176d4aefa91d7a9980dbae91","e20db35ced8544ddac5bc3839145e463",3198738,1,-24,0,391,112,91,-21
"e20db35ced8544ddac5bc3839145e463","a9ae0a3c070d455bb4369a8996313336",3198738,1,26,0,392,91,114,23
"a9ae0a3c070d455bb4369a8996313336","a9ae0a3c070d455bb4369a8996313336",3198738,2,0,1,393,114,114,0
"a9ae0a3c070d455bb4369a8996313336","71cec822bcff4f30a20e75dc63ef7b65",3198738,1,2,0,395,114,116,2
"71cec822bcff4f30a20e75dc63ef7b65","71cec822bcff4f30a20e75dc63ef7b65",3198738,3,0,1,396,116,116,0
"71cec822bcff4f30a20e75dc63ef7b65","62bff51286ef4f348717a3cf6fe2318f",3198738,1,5,0,399,116,120,4
"62bff51286ef4f348717a3cf6fe2318f","37319e88176d4aefa91d7a9980dbae91",3198738,1,-9,0,400,120,112,-8
"37319e88176d4aefa91d7a9980dbae91","62bff51286ef4f348717a3cf6fe2318f",3198738,1,9,0,401,112,120,8
"62bff51286ef4f348717a3cf6fe2318f","62bff51286ef4f348717a3cf6fe2318f",3198738,5,0,1,402,120,120,0
"62bff51286ef4f348717a3cf6fe2318f","b1cd0e7dc3ad4a8eb91a4bfdbeb025b0",3198738,1,-2,0,405,120,118,-2
"b1cd0e7dc3ad4a8eb91a4bfdbeb025b0","b1cd0e7dc3ad4a8eb91a4bfdbeb025b0",3198738,1,0,1,406,118,118,0
"b1cd0e7dc3ad4a8eb91a4bfdbeb025b0","e20db35ced8544ddac5bc3839145e463",3198738,1,-31,0,407,118,91,-27
"e20db35ced8544ddac5bc3839145e463","779f9ddd1fd14d1e9e69f72219a1fdbd",3198738,1,36,0,408,91,121,30
"779f9ddd1fd14d1e9e69f72219a1fdbd","ae26e6cda8ad4a3f81bd347560d9579f",3198738,1,4,0,409,121,125,4
"ae26e6cda8ad4a3f81bd347560d9579f","ae26e6cda8ad4a3f81bd347560d9579f",3198738,1,0,1,410,125,125,0
"ae26e6cda8ad4a3f81bd347560d9579f","ee48df95832b4374aa273ceb27ec1315",3198738,1,1,0,411,125,126,1
"ee48df95832b4374aa273ceb27ec1315","ee48df95832b4374aa273ceb27ec1315",3198738,1,0,1,412,126,126,0
"ee48df95832b4374aa273ceb27ec1315","7a439da90b394756ad1777fc4c6dead5",3198738,1,1,0,413,126,127,1
"7a439da90b394756ad1777fc4c6dead5","7a439da90b394756ad1777fc4c6dead5",3198738,1,0,1,414,127,127,0
"7a439da90b394756ad1777fc4c6dead5","a8dd5213034441ac92724b4e83eb0bb2",3198738,1,3,0,415,127,129,2
"a8dd5213034441ac92724b4e83eb0bb2","779f9ddd1fd14d1e9e69f72219a1fdbd",3198738,1,-9,0,416,129,121,-8
"779f9ddd1fd14d1e9e69f72219a1fdbd","a8dd5213034441ac92724b4e83eb0bb2",3198738,1,9,0,417,121,129,8
"a8dd5213034441ac92724b4e83eb0bb2","8115eab6556b45f5b415c3b8c26a12e5",3198738,1,2,0,418,129,131,2
"8115eab6556b45f5b415c3b8c26a12e5","8115eab6556b45f5b415c3b8c26a12e5",3198738,2,0,1,419,131,131,0
"8115eab6556b45f5b415c3b8c26a12e5","ec34b06efd844b46a4c4818ecdb9b8f4",3198738,1,1,0,421,131,132,1
"ec34b06efd844b46a4c4818ecdb9b8f4","ec34b06efd844b46a4c4818ecdb9b8f4",3198738,2,0,1,422,132,132,0
"ec34b06efd844b46a4c4818ecdb9b8f4","c2e1c2b9eac64109b343a088584b576b",3198738,1,1,0,424,132,133,1
"c2e1c2b9eac64109b343a088584b576b","c2e1c2b9eac64109b343a088584b576b",3198738,2,0,1,425,133,133,0
"c2e1c2b9eac64109b343a088584b576b","579338175e0b4bbb8ef3b712b5d8b54e",3198738,1,-5,0,427,133,128,-5
"579338175e0b4bbb8ef3b712b5d8b54e","8bc5795d6a984a3eace4e2811e52dd4f",3198738,1,8,0,428,128,135,7
"8bc5795d6a984a3eace4e2811e52dd4f","8bc5795d6a984a3eace4e2811e52dd4f",3198738,1,0,1,429,135,135,0
"8bc5795d6a984a3eace4e2811e52dd4f","b416d47c56a742199b5d7c7f19d6503a",3198738,1,-1,0,430,135,134,-1
"b416d47c56a742199b5d7c7f19d6503a","cd4532ad48034873ba8bce2aac0c9808",3198738,1,4,0,431,134,137,3
"cd4532ad48034873ba8bce2aac0c9808","cd4532ad48034873ba8bce2aac0c9808",3198738,1,0,1,432,137,137,0
"cd4532ad48034873ba8bce2aac0c9808","779f9ddd1fd14d1e9e69f72219a1fdbd",3198738,1,-19,0,433,137,121,-16
"779f9ddd1fd14d1e9e69f72219a1fdbd","df1de691dafe4549a18a4398ee9dfaf9",3198738,1,23,0,434,121,139,18
"df1de691dafe4549a18a4398ee9dfaf9","6c5ad271a44743479bfaea29b1db8d02",3198738,1,4,0,435,139,143,4
"6c5ad271a44743479bfaea29b1db8d02","6c5ad271a44743479bfaea29b1db8d02",3198738,2,0,1,436,143,143,0
"6c5ad271a44743479bfaea29b1db8d02","83d311bed5374fee83d8d67a7d9d82dc",3198738,1,1,0,438,143,144,1
"83d311bed5374fee83d8d67a7d9d82dc","83d311bed5374fee83d8d67a7d9d82dc",3198738,3,0,1,439,144,144,0
"83d311bed5374fee83d8d67a7d9d82dc","402bba41861d43acb52a5abb89e8831e",3198738,1,1,0,442,144,145,1
"402bba41861d43acb52a5abb89e8831e","402bba41861d43acb52a5abb89e8831e",3198738,2,0,1,443,145,145,0
"402bba41861d43acb52a5abb89e8831e","df1de691dafe4549a18a4398ee9dfaf9",3198738,1,-6,0,445,145,139,-6
"df1de691dafe4549a18a4398ee9dfaf9","8aae34f5ddbb4052a709b12e6b0d40fa",3198738,2,9,0,446,139,147,8
"8aae34f5ddbb4052a709b12e6b0d40fa","8aae34f5ddbb4052a709b12e6b0d40fa",3198738,1,0,1,447,147,147,0
"8aae34f5ddbb4052a709b12e6b0d40fa","645b3f0249f64f76af2e19eb4d0e55b7",3198738,1,2,0,448,147,149,2
"645b3f0249f64f76af2e19eb4d0e55b7","645b3f0249f64f76af2e19eb4d0e55b7",3198738,2,0,1,449,149,149,0
"645b3f0249f64f76af2e19eb4d0e55b7","7e7b8db5064d4369805ab370aac5ddfb",3198738,1,1,0,451,149,150,1
"7e7b8db5064d4369805ab370aac5ddfb","7e7b8db5064d4369805ab370aac5ddfb",3198738,2,0,1,452,150,150,0
"7e7b8db5064d4369805ab370aac5ddfb","8956d210ae7f41968fada86d4c979d6a",3198738,1,1,0,454,150,151,1
"8956d210ae7f41968fada86d4c979d6a","8956d210ae7f41968fada86d4c979d6a",3198738,2,0,1,455,151,151,0
"8956d210ae7f41968fada86d4c979d6a","f902b0f41b544d4dbf79664fd233648d",3198738,1,-5,0,457,151,146,-5
"f902b0f41b544d4dbf79664fd233648d","ae781e8b775e4ccd93bc800dad5c8376",3198738,1,8,0,458,146,153,7
"ae781e8b775e4ccd93bc800dad5c8376","ae781e8b775e4ccd93bc800dad5c8376",3198738,2,0,1,459,153,153,0
"ae781e8b775e4ccd93bc800dad5c8376","06882a8492d9499aa31555567f575ecb",3198738,1,1,0,461,153,154,1
"06882a8492d9499aa31555567f575ecb","06882a8492d9499aa31555567f575ecb",3198738,2,0,1,462,154,154,0
"06882a8492d9499aa31555567f575ecb","f293c508f409466a8f27ddd7d1e40b20",3198738,1,1,0,464,154,155,1
"f293c508f409466a8f27ddd7d1e40b20","f293c508f409466a8f27ddd7d1e40b20",3198738,10,0,1,465,155,155,0
"f293c508f409466a8f27ddd7d1e40b20","cc4ddef5bbbe48ebb605141b347c4ed1",3198738,1,1,0,475,155,156,1
"cc4ddef5bbbe48ebb605141b347c4ed1","cc4ddef5bbbe48ebb605141b347c4ed1",3198738,3,0,1,476,156,156,0
"cc4ddef5bbbe48ebb605141b347c4ed1","f03480cf4eba413194d7af52fc0e7f28",3198738,1,-4,0,479,156,152,-4
"f03480cf4eba413194d7af52fc0e7f28","d313cec988a84645bee413e8d4724a4b",3198738,1,7,0,480,152,158,6
"d313cec988a84645bee413e8d4724a4b","d313cec988a84645bee413e8d4724a4b",3198738,6,0,1,481,158,158,0
"d313cec988a84645bee413e8d4724a4b","dc60696c76a74368a60f72246e47700d",3198738,1,1,0,485,158,159,1
"dc60696c76a74368a60f72246e47700d","dc60696c76a74368a60f72246e47700d",3198738,1,0,1,486,159,159,0
"dc60696c76a74368a60f72246e47700d","df1de691dafe4549a18a4398ee9dfaf9",3198738,1,-23,0,487,159,139,-20
"df1de691dafe4549a18a4398ee9dfaf9","78adeee1fa2c4fe0bc73f7bca9fcee86",3198738,2,26,0,488,139,160,21
"78adeee1fa2c4fe0bc73f7bca9fcee86","78adeee1fa2c4fe0bc73f7bca9fcee86",3198738,1,0,1,489,160,160,0
"65202579580f4ad38d734b4ee39d22a8","df1de691dafe4549a18a4398ee9dfaf9",3198738,1,-31,0,498,164,139,-25
"df1de691dafe4549a18a4398ee9dfaf9","d313cec988a84645bee413e8d4724a4b",3198738,1,22,0,499,139,158,19
"d313cec988a84645bee413e8d4724a4b","df1de691dafe4549a18a4398ee9dfaf9",3198738,1,-22,0,502,158,139,-19
"65202579580f4ad38d734b4ee39d22a8","3cbcea2be0984e7dbd5a48195af10ce7",3198738,1,3,0,558,164,165,1
"3cbcea2be0984e7dbd5a48195af10ce7","78adeee1fa2c4fe0bc73f7bca9fcee86",3198738,1,-8,0,559,165,160,-5
"78adeee1fa2c4fe0bc73f7bca9fcee86","82e6285962b8400d9d6fc32436022a94",3198738,1,10,0,560,160,167,7
"82e6285962b8400d9d6fc32436022a94","3cbcea2be0984e7dbd5a48195af10ce7",3198738,1,-2,0,561,167,165,-2
"3cbcea2be0984e7dbd5a48195af10ce7","a9ac840f098c4bd0a2ee896214ce29cd",3198738,1,5,0,562,165,168,3
"a9ac840f098c4bd0a2ee896214ce29cd","78adeee1fa2c4fe0bc73f7bca9fcee86",3198738,1,-13,0,563,168,160,-8
"78adeee1fa2c4fe0bc73f7bca9fcee86","3cbcea2be0984e7dbd5a48195af10ce7",3198738,1,8,0,575,160,165,5
"3cbcea2be0984e7dbd5a48195af10ce7","82e6285962b8400d9d6fc32436022a94",3198738,1,2,0,576,165,167,2
"82e6285962b8400d9d6fc32436022a94","a9ac840f098c4bd0a2ee896214ce29cd",3198738,1,3,0,577,167,168,1
"a9ac840f098c4bd0a2ee896214ce29cd","3cbcea2be0984e7dbd5a48195af10ce7",3198738,1,-5,0,578,168,165,-3
"3cbcea2be0984e7dbd5a48195af10ce7","df1de691dafe4549a18a4398ee9dfaf9",3198738,1,-34,0,579,165,139,-26
"8aae34f5ddbb4052a709b12e6b0d40fa","f902b0f41b544d4dbf79664fd233648d",3198738,1,-1,0,581,147,146,-1
"f902b0f41b544d4dbf79664fd233648d","df1de691dafe4549a18a4398ee9dfaf9",3198738,1,-8,0,582,146,139,-7
"df1de691dafe4549a18a4398ee9dfaf9","779f9ddd1fd14d1e9e69f72219a1fdbd",3198738,1,-23,0,583,139,121,-18
"779f9ddd1fd14d1e9e69f72219a1fdbd","f661500307d74c908e9207d949ceb4aa",3198738,1,18,0,584,121,136,15
"f661500307d74c908e9207d949ceb4aa","a8dd5213034441ac92724b4e83eb0bb2",3198738,1,-9,0,585,136,129,-7
"a8dd5213034441ac92724b4e83eb0bb2","b416d47c56a742199b5d7c7f19d6503a",3198738,1,6,0,586,129,134,5
"b416d47c56a742199b5d7c7f19d6503a","579338175e0b4bbb8ef3b712b5d8b54e",3198738,1,-7,0,587,134,128,-6
"579338175e0b4bbb8ef3b712b5d8b54e","779f9ddd1fd14d1e9e69f72219a1fdbd",3198738,1,-8,0,588,128,121,-7
"779f9ddd1fd14d1e9e69f72219a1fdbd","e20db35ced8544ddac5bc3839145e463",3198738,1,-36,0,589,121,91,-30
"e20db35ced8544ddac5bc3839145e463","62bff51286ef4f348717a3cf6fe2318f",3198738,1,33,0,590,91,120,29
"62bff51286ef4f348717a3cf6fe2318f","3ec3a3563847406fa73338f9e9999cf3",3198738,1,-3,0,593,120,117,-3
"3ec3a3563847406fa73338f9e9999cf3","37319e88176d4aefa91d7a9980dbae91",3198738,1,-6,0,594,117,112,-5
"37319e88176d4aefa91d7a9980dbae91","4280927ec4d643238aa49c32f9e06c6c",3198738,1,-4,0,595,112,109,-3
"4280927ec4d643238aa49c32f9e06c6c","00ae5f0c51874a73a41ebea838d95682",3198738,1,-9,0,596,109,101,-8
"00ae5f0c51874a73a41ebea838d95682","08111f75e22d409998cf8b85bd431f0a",3198738,1,8,0,597,101,108,7
"08111f75e22d409998cf8b85bd431f0a","d391c8b6e56a43a7b654e9dee02d904b",3198738,1,-6,0,598,108,103,-5
"d391c8b6e56a43a7b654e9dee02d904b","73039f8c1eb9409cb4caee2cf968001e",3198738,1,-3,0,599,103,100,-3
"73039f8c1eb9409cb4caee2cf968001e","a9ac840f098c4bd0a2ee896214ce29cd",3198738,1,88,0,600,100,168,68
"a9ac840f098c4bd0a2ee896214ce29cd","0c7262dff33c4087bc660ccf40f92f9c",3198738,1,4,0,601,168,169,1
"0c7262dff33c4087bc660ccf40f92f9c","b2275c3fad834f8d90737a2d9a6927d6",3198738,7,3,0,602,169,172,3
"b2275c3fad834f8d90737a2d9a6927d6","416cdfda278442dd9bcb1046bd1bf0ec",3198738,1,-1,0,603,172,171,-1
"416cdfda278442dd9bcb1046bd1bf0ec","416cdfda278442dd9bcb1046bd1bf0ec",3198738,1,0,1,604,171,171,0
"416cdfda278442dd9bcb1046bd1bf0ec","0c7262dff33c4087bc660ccf40f92f9c",3198738,1,-2,0,605,171,169,-2
"b2275c3fad834f8d90737a2d9a6927d6","0c7262dff33c4087bc660ccf40f92f9c",3198738,5,-3,0,607,172,169,-3
"0c7262dff33c4087bc660ccf40f92f9c","0c7262dff33c4087bc660ccf40f92f9c",3198738,3,0,1,608,169,169,0
"b2275c3fad834f8d90737a2d9a6927d6","b2275c3fad834f8d90737a2d9a6927d6",3198738,32,0,1,611,172,172,0
"b2275c3fad834f8d90737a2d9a6927d6","eb515a26030b41f8a82a1e6114420bad",3198738,1,1,0,645,172,173,1
"eb515a26030b41f8a82a1e6114420bad","eb515a26030b41f8a82a1e6114420bad",3198738,2,0,1,646,173,173,0
"eb515a26030b41f8a82a1e6114420bad","0c7262dff33c4087bc660ccf40f92f9c",3198738,1,-4,0,648,173,169,-4
"0c7262dff33c4087bc660ccf40f92f9c","b42cc17b7de840f181a704558d0bc845",3198738,1,7,0,649,169,175,6
"b42cc17b7de840f181a704558d0bc845","b42cc17b7de840f181a704558d0bc845",3198738,5,0,1,650,175,175,0
"b42cc17b7de840f181a704558d0bc845","801f9e9135034f49bf5f8b4bdefedb41",3198738,1,2,0,655,175,177,2
"801f9e9135034f49bf5f8b4bdefedb41","801f9e9135034f49bf5f8b4bdefedb41",3198738,7,0,1,656,177,177,0
"801f9e9135034f49bf5f8b4bdefedb41","362fcb0699a14845ab29b2340093e528",3198738,1,-3,0,663,177,174,-3
"362fcb0699a14845ab29b2340093e528","ea38cc0e6e6e41edbabf210220808bf9",3198738,1,6,0,664,174,179,5
"ea38cc0e6e6e41edbabf210220808bf9","b87c552dd247427abe6ab5795b9c9d43",3198738,4,2,0,665,179,181,2
"b87c552dd247427abe6ab5795b9c9d43","ea38cc0e6e6e41edbabf210220808bf9",3198738,3,-2,0,666,181,179,-2
"b87c552dd247427abe6ab5795b9c9d43","b87c552dd247427abe6ab5795b9c9d43",3198738,7,0,1,668,181,181,0
"b87c552dd247427abe6ab5795b9c9d43","139b097acfca451689d80c9c6eebdf7b",3198738,1,-3,0,675,181,178,-3
"139b097acfca451689d80c9c6eebdf7b","2024b4885bd14338a39b7b509acbbd02",3198738,1,5,0,676,178,182,4
"2024b4885bd14338a39b7b509acbbd02","ea38cc0e6e6e41edbabf210220808bf9",3198738,1,-4,0,677,182,179,-3
"ea38cc0e6e6e41edbabf210220808bf9","ea38cc0e6e6e41edbabf210220808bf9",3198738,1,0,1,680,179,179,0
"ea38cc0e6e6e41edbabf210220808bf9","139b097acfca451689d80c9c6eebdf7b",3198738,2,-1,0,681,179,178,-1
"139b097acfca451689d80c9c6eebdf7b","30f660a1feb34582a739722532524f79",3198738,2,6,0,682,178,183,5
"30f660a1feb34582a739722532524f79","30f660a1feb34582a739722532524f79",3198738,5,0,1,683,183,183,0
"30f660a1feb34582a739722532524f79","2024b4885bd14338a39b7b509acbbd02",3198738,2,-1,0,688,183,182,-1
"2024b4885bd14338a39b7b509acbbd02","139b097acfca451689d80c9c6eebdf7b",3198738,1,-5,0,689,182,178,-4
"139b097acfca451689d80c9c6eebdf7b","0c7262dff33c4087bc660ccf40f92f9c",3198738,1,-11,0,690,178,169,-9
"0c7262dff33c4087bc660ccf40f92f9c","ea38cc0e6e6e41edbabf210220808bf9",3198738,1,12,0,691,169,179,10
"2024b4885bd14338a39b7b509acbbd02","c3f63fe50d8e487c86bf8ef76c9cadd3",3198738,1,4,0,697,182,185,3
"c3f63fe50d8e487c86bf8ef76c9cadd3","c3f63fe50d8e487c86bf8ef76c9cadd3",3198738,2,0,1,698,185,185,0
"c3f63fe50d8e487c86bf8ef76c9cadd3","0c7262dff33c4087bc660ccf40f92f9c",3198738,1,-20,0,700,185,169,-16
"0c7262dff33c4087bc660ccf40f92f9c","c8e371568a0c4391b25796ae4e91952e",3198738,1,23,0,701,169,186,17
"c8e371568a0c4391b25796ae4e91952e","7d932b23e1c84326ae5aa4d3c0d813d1",3198738,1,2,0,702,186,188,2
"7d932b23e1c84326ae5aa4d3c0d813d1","7d932b23e1c84326ae5aa4d3c0d813d1",3198738,3,0,1,703,188,188,0
"7d932b23e1c84326ae5aa4d3c0d813d1","ab11d94c6c8948ea90b88f19d2cd502b",3198738,1,3,0,706,188,190,2
"ab11d94c6c8948ea90b88f19d2cd502b","c8e371568a0c4391b25796ae4e91952e",3198738,1,-5,0,707,190,186,-4
"c8e371568a0c4391b25796ae4e91952e","ab11d94c6c8948ea90b88f19d2cd502b",3198738,1,5,0,708,186,190,4
"ab11d94c6c8948ea90b88f19d2cd502b","ab11d94c6c8948ea90b88f19d2cd502b",3198738,1,0,1,709,190,190,0
"ab11d94c6c8948ea90b88f19d2cd502b","f992451ed6ad4e68bb9e68ad6be7c4be",3198738,1,2,0,710,190,192,2
"f992451ed6ad4e68bb9e68ad6be7c4be","f992451ed6ad4e68bb9e68ad6be7c4be",3198738,2,0,1,711,192,192,0
"f992451ed6ad4e68bb9e68ad6be7c4be","07b44a7a51e94c78b411c753fc39dab0",3198738,1,-3,0,713,192,189,-3
"07b44a7a51e94c78b411c753fc39dab0","6cd2dcaac46847d4a0bc53f296d90375",3198738,1,6,0,714,189,194,5
"6cd2dcaac46847d4a0bc53f296d90375","6cd2dcaac46847d4a0bc53f296d90375",3198738,3,0,1,715,194,194,0
"6cd2dcaac46847d4a0bc53f296d90375","2d2580c9411c4972909db508d6956a58",3198738,1,2,0,718,194,196,2
"2d2580c9411c4972909db508d6956a58","2d2580c9411c4972909db508d6956a58",3198738,2,0,1,719,196,196,0
"2d2580c9411c4972909db508d6956a58","5bddb3d9ed264f3984702f048c7e5340",3198738,1,1,0,721,196,197,1
"5bddb3d9ed264f3984702f048c7e5340","5bddb3d9ed264f3984702f048c7e5340",3198738,2,0,1,722,197,197,0
"5bddb3d9ed264f3984702f048c7e5340","d5e8e2bd12a2466b9d6d90855f0eb079",3198738,1,1,0,724,197,198,1
"d5e8e2bd12a2466b9d6d90855f0eb079","d5e8e2bd12a2466b9d6d90855f0eb079",3198738,2,0,1,725,198,198,0
"d5e8e2bd12a2466b9d6d90855f0eb079","017d7ca8e0394b91aaadc9574df2202c",3198738,1,-5,0,727,198,193,-5
"017d7ca8e0394b91aaadc9574df2202c","54e8e9f0ea3e45c4bf3b8ac799ee31b1",3198738,1,8,0,728,193,200,7
"54e8e9f0ea3e45c4bf3b8ac799ee31b1","54e8e9f0ea3e45c4bf3b8ac799ee31b1",3198738,1,0,1,729,200,200,0
"54e8e9f0ea3e45c4bf3b8ac799ee31b1","c614a00911be4877a075f19315530fb0",3198738,1,1,0,730,200,201,1
"c614a00911be4877a075f19315530fb0","c614a00911be4877a075f19315530fb0",3198738,6,0,1,731,201,201,0
"c614a00911be4877a075f19315530fb0","a6c21bd8b95249c7972820a7a7d76aff",3198738,1,1,0,737,201,202,1
"a6c21bd8b95249c7972820a7a7d76aff","a6c21bd8b95249c7972820a7a7d76aff",3198738,1,0,1,738,202,202,0
"a6c21bd8b95249c7972820a7a7d76aff","bb329d880ab54120adaf203a693bb203",3198738,1,1,0,739,202,203,1
"bb329d880ab54120adaf203a693bb203","bb329d880ab54120adaf203a693bb203",3198738,1,0,1,740,203,203,0
"bb329d880ab54120adaf203a693bb203","f9170dd6bc6442b4acd832747609b09a",3198738,1,-4,0,741,203,199,-4
"f9170dd6bc6442b4acd832747609b09a","334c2344009840079b1d0e1b7ce3d5a7",3198738,1,7,0,742,199,205,6
"334c2344009840079b1d0e1b7ce3d5a7","334c2344009840079b1d0e1b7ce3d5a7",3198738,1,0,1,743,205,205,0
"334c2344009840079b1d0e1b7ce3d5a7","c8e371568a0c4391b25796ae4e91952e",3198738,1,-23,0,744,205,186,-19
"c8e371568a0c4391b25796ae4e91952e","d7f13c8d63ec4e2aa673fbb9cf9c6933",3198738,1,26,0,745,186,206,20
"d7f13c8d63ec4e2aa673fbb9cf9c6933","b9e80f77c3a44349863b19875725c384",3198738,1,1,0,746,206,207,1
"b9e80f77c3a44349863b19875725c384","7108f0e4c2584f1f9c471689ae4c885c",3198738,2,1,0,747,207,208,1
"7108f0e4c2584f1f9c471689ae4c885c","b9e80f77c3a44349863b19875725c384",3198738,1,-1,0,748,208,207,-1
"b9e80f77c3a44349863b19875725c384","b9e80f77c3a44349863b19875725c384",3198738,18,0,1,749,207,207,0
"7108f0e4c2584f1f9c471689ae4c885c","7108f0e4c2584f1f9c471689ae4c885c",3198738,12,0,1,768,208,208,0
"7108f0e4c2584f1f9c471689ae4c885c","d7f13c8d63ec4e2aa673fbb9cf9c6933",3198738,1,-2,0,780,208,206,-2
"d7f13c8d63ec4e2aa673fbb9cf9c6933","09400e101c5d4b439cf9a26b03aae558",3198738,1,5,0,781,206,210,4
"09400e101c5d4b439cf9a26b03aae558","09400e101c5d4b439cf9a26b03aae558",3198738,4,0,1,782,210,210,0
"09400e101c5d4b439cf9a26b03aae558","a88efa7e50ce47159810ab553afa6d3a",3198738,1,2,0,786,210,212,2
"a88efa7e50ce47159810ab553afa6d3a","a88efa7e50ce47159810ab553afa6d3a",3198738,8,0,1,787,212,212,0
"a88efa7e50ce47159810ab553afa6d3a","a875096404ef4a9984b62d74cda916f9",3198738,1,-3,0,795,212,209,-3
"a875096404ef4a9984b62d74cda916f9","be502a7a43c44bf7b682698de79d9369",3198738,1,6,0,796,209,214,5
"be502a7a43c44bf7b682698de79d9369","f7fb1952f56b4189b86a9f8b7862d2b8",3198738,5,1,0,797,214,215,1
"f7fb1952f56b4189b86a9f8b7862d2b8","0c7262dff33c4087bc660ccf40f92f9c",3198738,1,-60,0,798,215,169,-46
"0c7262dff33c4087bc660ccf40f92f9c","d7f13c8d63ec4e2aa673fbb9cf9c6933",3198738,1,49,0,806,169,206,37
"d7f13c8d63ec4e2aa673fbb9cf9c6933","be502a7a43c44bf7b682698de79d9369",3198738,3,10,0,807,206,214,8
"f7fb1952f56b4189b86a9f8b7862d2b8","be502a7a43c44bf7b682698de79d9369",3198738,3,-1,0,809,215,214,-1
"be502a7a43c44bf7b682698de79d9369","be502a7a43c44bf7b682698de79d9369",3198738,12,0,1,810,214,214,0
"be502a7a43c44bf7b682698de79d9369","d7f13c8d63ec4e2aa673fbb9cf9c6933",3198738,2,-10,0,817,214,206,-8
"f7fb1952f56b4189b86a9f8b7862d2b8","f7fb1952f56b4189b86a9f8b7862d2b8",3198738,21,0,1,831,215,215,0
"f7fb1952f56b4189b86a9f8b7862d2b8","b860ee85d8bc4a2f97958cfb71be3533",3198738,1,1,0,852,215,216,1
"b860ee85d8bc4a2f97958cfb71be3533","b860ee85d8bc4a2f97958cfb71be3533",3198738,2,0,1,853,216,216,0
"b860ee85d8bc4a2f97958cfb71be3533","ec341f459285443b8361f7f15638ff08",3198738,1,-3,0,855,216,213,-3
"ec341f459285443b8361f7f15638ff08","363837c182e04711840d896ae1e0339c",3198738,1,6,0,856,213,218,5
"363837c182e04711840d896ae1e0339c","363837c182e04711840d896ae1e0339c",3198738,12,0,1,857,218,218,0
"363837c182e04711840d896ae1e0339c","01b2051f8941460d89945e3b02d1ce78",3198738,2,-1,0,869,218,217,-1
"01b2051f8941460d89945e3b02d1ce78","91125ca626c5470eb145501f8c37f8db",3198738,2,4,0,870,217,220,3
"91125ca626c5470eb145501f8c37f8db","be95c065e45447c1bd8215ea6f130c7a",3198738,1,-1,0,871,220,219,-1
"be95c065e45447c1bd8215ea6f130c7a","363837c182e04711840d896ae1e0339c",3198738,1,-2,0,872,219,218,-1
"91125ca626c5470eb145501f8c37f8db","91125ca626c5470eb145501f8c37f8db",3198738,1,0,1,875,220,220,0
"91125ca626c5470eb145501f8c37f8db","1c6721b1f63f4d30ba7746ea8af02a52",3198738,1,3,0,876,220,221,1
"1c6721b1f63f4d30ba7746ea8af02a52","d7f13c8d63ec4e2aa673fbb9cf9c6933",3198738,1,-21,0,877,221,206,-15
"d7f13c8d63ec4e2aa673fbb9cf9c6933","77ecef8eff6b4a2caea7707669bf7475",3198738,1,22,0,878,206,222,16
"77ecef8eff6b4a2caea7707669bf7475","3f1c815879794b929260d224becaff7e",3198738,1,-293,0,879,222,14,-208
"56586aa865414f538729c7f7735d2bc6","77ecef8eff6b4a2caea7707669bf7475",3198738,1,297,0,881,12,222,210
"77ecef8eff6b4a2caea7707669bf7475","77ecef8eff6b4a2caea7707669bf7475",3198738,11,0,1,882,222,222,0
"77ecef8eff6b4a2caea7707669bf7475","1c6721b1f63f4d30ba7746ea8af02a52",3198738,1,-1,0,893,222,221,-1
"1c6721b1f63f4d30ba7746ea8af02a52","d03cb855c70044cf8c35d9ec0de696e3",3198738,2,4,0,894,221,224,3
"d03cb855c70044cf8c35d9ec0de696e3","8b9ae98743bd4d4a8a87dff1c1244211",3198738,4,3,0,895,224,227,3
"8b9ae98743bd4d4a8a87dff1c1244211","d03cb855c70044cf8c35d9ec0de696e3",3198738,5,-3,0,896,227,224,-3
"d03cb855c70044cf8c35d9ec0de696e3","f7906d6f59b9489a91d2ef40db5a474d",3198738,2,-1,0,897,224,223,-1
"f7906d6f59b9489a91d2ef40db5a474d","77ecef8eff6b4a2caea7707669bf7475",3198738,1,-2,0,898,223,222,-1
"77ecef8eff6b4a2caea7707669bf7475","8b9ae98743bd4d4a8a87dff1c1244211",3198738,1,6,0,899,222,227,5
"d03cb855c70044cf8c35d9ec0de696e3","1c6721b1f63f4d30ba7746ea8af02a52",3198738,1,-4,0,901,224,221,-3
"1c6721b1f63f4d30ba7746ea8af02a52","a49a937d6896486d9a5396654abcf2e1",3198738,1,6,0,902,221,226,5
"a49a937d6896486d9a5396654abcf2e1","a49a937d6896486d9a5396654abcf2e1",3198738,3,0,1,903,226,226,0
"a49a937d6896486d9a5396654abcf2e1","8b9ae98743bd4d4a8a87dff1c1244211",3198738,1,1,0,904,226,227,1
"8b9ae98743bd4d4a8a87dff1c1244211","8b9ae98743bd4d4a8a87dff1c1244211",3198738,17,0,1,905,227,227,0
"8b9ae98743bd4d4a8a87dff1c1244211","f7906d6f59b9489a91d2ef40db5a474d",3198738,1,-4,0,922,227,223,-4
"f7906d6f59b9489a91d2ef40db5a474d","2ab1535aac1346ba8801535bf729ef37",3198738,2,7,0,923,223,229,6
"2ab1535aac1346ba8801535bf729ef37","5152833676bf4c6cb317060be10f68db",3198738,1,-1,0,924,229,228,-1
"5152833676bf4c6cb317060be10f68db","d03cb855c70044cf8c35d9ec0de696e3",3198738,1,-5,0,925,228,224,-4
"2ab1535aac1346ba8801535bf729ef37","2ab1535aac1346ba8801535bf729ef37",3198738,3,0,1,930,229,229,0
"2ab1535aac1346ba8801535bf729ef37","a4f40fb48a8542c8949bae1f002cd9bc",3198738,1,2,0,933,229,231,2
"a4f40fb48a8542c8949bae1f002cd9bc","a4f40fb48a8542c8949bae1f002cd9bc",3198738,2,0,1,934,231,231,0
"a4f40fb48a8542c8949bae1f002cd9bc","8972c23e32044edb8a78fa1eed4e5947",3198738,1,1,0,936,231,232,1
"8972c23e32044edb8a78fa1eed4e5947","8972c23e32044edb8a78fa1eed4e5947",3198738,1,0,1,937,232,232,0
"8972c23e32044edb8a78fa1eed4e5947","92feb4a40f8344d38b6f722e42a53295",3198738,1,1,0,938,232,233,1
"92feb4a40f8344d38b6f722e42a53295","92feb4a40f8344d38b6f722e42a53295",3198738,2,0,1,939,233,233,0
"92feb4a40f8344d38b6f722e42a53295","5152833676bf4c6cb317060be10f68db",3198738,1,-5,0,941,233,228,-5
"5152833676bf4c6cb317060be10f68db","0b04c8e2f86d48c7aeb7e225819cd32b",3198738,1,7,0,942,228,234,6
"0b04c8e2f86d48c7aeb7e225819cd32b","d03cb855c70044cf8c35d9ec0de696e3",3198738,1,-12,0,943,234,224,-10
"d03cb855c70044cf8c35d9ec0de696e3","a49a937d6896486d9a5396654abcf2e1",3198738,2,2,0,946,224,226,2
"a49a937d6896486d9a5396654abcf2e1","2ab1535aac1346ba8801535bf729ef37",3198738,2,4,0,948,226,229,3
"2ab1535aac1346ba8801535bf729ef37","f7906d6f59b9489a91d2ef40db5a474d",3198738,2,-7,0,949,229,223,-6
"f7906d6f59b9489a91d2ef40db5a474d","5152833676bf4c6cb317060be10f68db",3198738,1,6,0,950,223,228,5
"5152833676bf4c6cb317060be10f68db","ca3e28f290354c08aefe5b0f769604e6",3198738,1,8,0,951,228,235,7
"ca3e28f290354c08aefe5b0f769604e6","ca3e28f290354c08aefe5b0f769604e6",3198738,9,0,1,952,235,235,0
"ca3e28f290354c08aefe5b0f769604e6","79a35eea833e4c2c9d22fc53c3c6445c",3198738,1,1,0,961,235,236,1
"79a35eea833e4c2c9d22fc53c3c6445c","79a35eea833e4c2c9d22fc53c3c6445c",3198738,14,0,1,962,236,236,0
"79a35eea833e4c2c9d22fc53c3c6445c","8f68228b1518449e9615cdafee41a2bd",3198738,1,1,0,976,236,237,1
"8f68228b1518449e9615cdafee41a2bd","8f68228b1518449e9615cdafee41a2bd",3198738,1,0,1,977,237,237,0
"8f68228b1518449e9615cdafee41a2bd","1c6721b1f63f4d30ba7746ea8af02a52",3198738,1,-19,0,978,237,221,-16
"1c6721b1f63f4d30ba7746ea8af02a52","cab89fa5c3ed45a5aa550fc0352d6a42",3198738,1,20,0,979,221,238,17
"cab89fa5c3ed45a5aa550fc0352d6a42","cab89fa5c3ed45a5aa550fc0352d6a42",3198738,1,0,1,980,238,238,0
"cab89fa5c3ed45a5aa550fc0352d6a42","66d4fad4f1cf4b46be0750a99ad7a35a",3198738,1,1,0,981,238,239,1
"66d4fad4f1cf4b46be0750a99ad7a35a","66d4fad4f1cf4b46be0750a99ad7a35a",3198738,1,0,1,982,239,239,0
"66d4fad4f1cf4b46be0750a99ad7a35a","0b04c8e2f86d48c7aeb7e225819cd32b",3198738,1,-5,0,983,239,234,-5
"0b04c8e2f86d48c7aeb7e225819cd32b","f53da5fd9bfe412da4b80d4742563b6c",3198738,1,8,0,984,234,241,7
"f53da5fd9bfe412da4b80d4742563b6c","f53da5fd9bfe412da4b80d4742563b6c",3198738,1,0,1,985,241,241,0
"f53da5fd9bfe412da4b80d4742563b6c","1c6721b1f63f4d30ba7746ea8af02a52",3198738,1,-24,0,986,241,221,-20
"1c6721b1f63f4d30ba7746ea8af02a52","2ae94c0cea4d480a9d5dca8fb1d7b542",3198738,1,27,0,987,221,242,21
"2ae94c0cea4d480a9d5dca8fb1d7b542","1ebf23f9d994469a85206e4c7b1bf5f5",3198738,1,3,0,988,242,245,3
"1ebf23f9d994469a85206e4c7b1bf5f5","1c6721b1f63f4d30ba7746ea8af02a52",3198738,1,-30,0,989,245,221,-24
"f7906d6f59b9489a91d2ef40db5a474d","1ebf23f9d994469a85206e4c7b1bf5f5",3198738,1,27,0,997,223,245,22
"1ebf23f9d994469a85206e4c7b1bf5f5","1ebf23f9d994469a85206e4c7b1bf5f5",3198738,9,0,1,1000,245,245,0
"1ebf23f9d994469a85206e4c7b1bf5f5","85ae675b83e8422da842cfd25596af99",3198738,1,1,0,1007,245,246,1
"85ae675b83e8422da842cfd25596af99","85ae675b83e8422da842cfd25596af99",3198738,1,0,1,1008,246,246,0
"85ae675b83e8422da842cfd25596af99","fa235f0f364d47e4ae1c87f47bf8e6ba",3198738,1,8,0,1009,246,252,6
"fa235f0f364d47e4ae1c87f47bf8e6ba","2ae94c0cea4d480a9d5dca8fb1d7b542",3198738,1,-12,0,1010,252,242,-10
"2ae94c0cea4d480a9d5dca8fb1d7b542","fa235f0f364d47e4ae1c87f47bf8e6ba",3198738,1,12,0,1011,242,252,10
"fa235f0f364d47e4ae1c87f47bf8e6ba","fa235f0f364d47e4ae1c87f47bf8e6ba",3198738,3,0,1,1012,252,252,0
"fa235f0f364d47e4ae1c87f47bf8e6ba","79f7845465cc4ed19d8e4f1429541be0",3198738,1,2,0,1015,252,254,2
"79f7845465cc4ed19d8e4f1429541be0","79f7845465cc4ed19d8e4f1429541be0",3198738,2,0,1,1016,254,254,0
"79f7845465cc4ed19d8e4f1429541be0","6e83e23f56544a19b94067c1c558d9c0",3198738,1,-8,0,1018,254,247,-7
"6e83e23f56544a19b94067c1c558d9c0","00f61990949545828dd12f1303d47504",3198738,1,11,0,1019,247,256,9
"00f61990949545828dd12f1303d47504","00f61990949545828dd12f1303d47504",3198738,1,0,1,1020,256,256,0
"00f61990949545828dd12f1303d47504","ead7bb4b64e247d2ae632ab8a296b091",3198738,1,2,0,1021,256,258,2
"ead7bb4b64e247d2ae632ab8a296b091","ead7bb4b64e247d2ae632ab8a296b091",3198738,2,0,1,1022,258,258,0
"ead7bb4b64e247d2ae632ab8a296b091","41b0048dde734bb280bac6116baa8e27",3198738,1,1,0,1024,258,259,1
"41b0048dde734bb280bac6116baa8e27","41b0048dde734bb280bac6116baa8e27",3198738,2,0,1,1025,259,259,0
"41b0048dde734bb280bac6116baa8e27","b41c5a094a604ee0915327da5cc0beb7",3198738,1,1,0,1027,259,260,1
"b41c5a094a604ee0915327da5cc0beb7","b41c5a094a604ee0915327da5cc0beb7",3198738,2,0,1,1028,260,260,0
"b41c5a094a604ee0915327da5cc0beb7","d546341988904f069cfa86b21457d9d9",3198738,1,-10,0,1030,260,251,-9
"d546341988904f069cfa86b21457d9d9","28c171777c52431ab6b925073bd63d46",3198738,1,15,0,1031,251,264,13
"28c171777c52431ab6b925073bd63d46","28c171777c52431ab6b925073bd63d46",3198738,7,0,1,1032,264,264,0
"28c171777c52431ab6b925073bd63d46","ac160db940cb49ae8579162b1d52bb5d",3198738,1,2,0,1039,264,266,2
"ac160db940cb49ae8579162b1d52bb5d","ac160db940cb49ae8579162b1d52bb5d",3198738,3,0,1,1040,266,266,0
"ac160db940cb49ae8579162b1d52bb5d","d989ebcfc12a4b669f0100dc1aa14f1e",3198738,1,-12,0,1043,266,255,-11
"d989ebcfc12a4b669f0100dc1aa14f1e","c6fd49b485cc4874b0bbdd9c6171e09c",3198738,1,15,0,1044,255,268,13
"c6fd49b485cc4874b0bbdd9c6171e09c","c6fd49b485cc4874b0bbdd9c6171e09c",3198738,3,0,1,1045,268,268,0
"c6fd49b485cc4874b0bbdd9c6171e09c","44240778a97c4af0937817499b75707b",3198738,1,1,0,1048,268,269,1
"44240778a97c4af0937817499b75707b","44240778a97c4af0937817499b75707b",3198738,2,0,1,1049,269,269,0
"44240778a97c4af0937817499b75707b","7aa76d3e993840d8805f097cbdbcd44b",3198738,1,-9,0,1051,269,261,-8
"7aa76d3e993840d8805f097cbdbcd44b","865a4d3b43374da7944dc7d397f566d9",3198738,1,12,0,1052,261,271,10
"865a4d3b43374da7944dc7d397f566d9","865a4d3b43374da7944dc7d397f566d9",3198738,1,0,1,1053,271,271,0
"865a4d3b43374da7944dc7d397f566d9","2ae94c0cea4d480a9d5dca8fb1d7b542",3198738,1,-35,0,1054,271,242,-29
"2ae94c0cea4d480a9d5dca8fb1d7b542","0d987bed3ffa4ed0b9a2e62e97b7b30f",3198738,1,38,0,1055,242,272,30
"0d987bed3ffa4ed0b9a2e62e97b7b30f","0d987bed3ffa4ed0b9a2e62e97b7b30f",3198738,1,0,1,1056,272,272,0
"0d987bed3ffa4ed0b9a2e62e97b7b30f","bb5a47f5ea01454a8b79455422d3b9da",3198738,5,10,0,1057,272,280,8
"bb5a47f5ea01454a8b79455422d3b9da","bb5a47f5ea01454a8b79455422d3b9da",3198738,101,0,1,1058,280,280,0
"bb5a47f5ea01454a8b79455422d3b9da","82ae07bc0c9b4570a41799290d1ef399",3198738,3,-6,0,1061,280,275,-5
"82ae07bc0c9b4570a41799290d1ef399","bb5a47f5ea01454a8b79455422d3b9da",3198738,5,6,0,1062,275,280,5
"bb5a47f5ea01454a8b79455422d3b9da","0d987bed3ffa4ed0b9a2e62e97b7b30f",3198738,5,-10,0,1066,280,272,-8
"0d987bed3ffa4ed0b9a2e62e97b7b30f","94cecc3f1e7d484b8e068e79241dfd73",3198738,2,13,0,1067,272,281,9
"94cecc3f1e7d484b8e068e79241dfd73","a37477c4e4c14169ad44b06b493007f6",3198738,2,2,0,1068,281,283,2
"a37477c4e4c14169ad44b06b493007f6","94cecc3f1e7d484b8e068e79241dfd73",3198738,1,-2,0,1069,283,281,-2
"94cecc3f1e7d484b8e068e79241dfd73","fab84b4fab5940efb4ea868ef8d09396",3198738,1,5,0,1070,281,284,3
"fab84b4fab5940efb4ea868ef8d09396","4a29443515bb404cb8924e1c60a63b73",3198738,1,4,0,1071,284,285,1
"4a29443515bb404cb8924e1c60a63b73","fab84b4fab5940efb4ea868ef8d09396",3198738,1,-4,0,1072,285,284,-1
"fab84b4fab5940efb4ea868ef8d09396","208c9b2796c944db8dacaa96082520ea",3198738,1,7,0,1073,284,288,4
"208c9b2796c944db8dacaa96082520ea","0d987bed3ffa4ed0b9a2e62e97b7b30f",3198738,1,-25,0,1074,288,272,-16
"bb5a47f5ea01454a8b79455422d3b9da","4a29443515bb404cb8924e1c60a63b73",3198738,1,12,0,1083,280,285,5
"4a29443515bb404cb8924e1c60a63b73","4a29443515bb404cb8924e1c60a63b73",3198738,4,0,1,1084,285,285,0
"4a29443515bb404cb8924e1c60a63b73","208c9b2796c944db8dacaa96082520ea",3198738,3,3,0,1085,285,288,3
"208c9b2796c944db8dacaa96082520ea","4a29443515bb404cb8924e1c60a63b73",3198738,3,-3,0,1086,288,285,-3
"208c9b2796c944db8dacaa96082520ea","208c9b2796c944db8dacaa96082520ea",3198738,2,0,1,1090,288,288,0
"4a29443515bb404cb8924e1c60a63b73","7669a956527947d0add87455277e80b4",3198738,3,7,0,1092,285,291,6
"7669a956527947d0add87455277e80b4","6a9a3b5bde4a48daa896fe8c06eca56f",3198738,2,-2,0,1093,291,289,-2
"6a9a3b5bde4a48daa896fe8c06eca56f","4a29443515bb404cb8924e1c60a63b73",3198738,3,-5,0,1094,289,285,-4
"7669a956527947d0add87455277e80b4","7669a956527947d0add87455277e80b4",3198738,2,0,1,1099,291,291,0
"7669a956527947d0add87455277e80b4","869e967078f04da18dd0b0b9389a7424",3198738,1,3,0,1101,291,293,2
"869e967078f04da18dd0b0b9389a7424","6a9a3b5bde4a48daa896fe8c06eca56f",3198738,1,-5,0,1102,293,289,-4
"4a29443515bb404cb8924e1c60a63b73","6a9a3b5bde4a48daa896fe8c06eca56f",3198738,1,5,0,1108,285,289,4
"6a9a3b5bde4a48daa896fe8c06eca56f","869e967078f04da18dd0b0b9389a7424",3198738,1,5,0,1109,289,293,4
"869e967078f04da18dd0b0b9389a7424","869e967078f04da18dd0b0b9389a7424",3198738,1,0,1,1110,293,293,0
"869e967078f04da18dd0b0b9389a7424","51ab6291537748fab90d519aa09889d6",3198738,1,2,0,1111,293,295,2
"51ab6291537748fab90d519aa09889d6","51ab6291537748fab90d519aa09889d6",3198738,5,0,1,1112,295,295,0
"51ab6291537748fab90d519aa09889d6","34a6e49023fc4465bd5ca604330bbd1c",3198738,1,-3,0,1117,295,292,-3
"34a6e49023fc4465bd5ca604330bbd1c","ba0e59461bfb4a44b7b1c28a01f8d3b3",3198738,1,9,0,1118,292,299,7
"ba0e59461bfb4a44b7b1c28a01f8d3b3","21592f2a9e9c4b2f8c66ec5dbcbf6a2b",3198738,1,-4,0,1119,299,296,-3
"21592f2a9e9c4b2f8c66ec5dbcbf6a2b","ba0e59461bfb4a44b7b1c28a01f8d3b3",3198738,1,4,0,1120,296,299,3
"ba0e59461bfb4a44b7b1c28a01f8d3b3","0e0b36e731a645e7b1b8a88f5031ca38",3198738,1,2,0,1121,299,301,2
"0e0b36e731a645e7b1b8a88f5031ca38","0e0b36e731a645e7b1b8a88f5031ca38",3198738,2,0,1,1122,301,301,0
"0e0b36e731a645e7b1b8a88f5031ca38","a66a144637284c21afc6de17fea4bfb8",3198738,1,1,0,1124,301,302,1
"a66a144637284c21afc6de17fea4bfb8","a66a144637284c21afc6de17fea4bfb8",3198738,2,0,1,1125,302,302,0
"a66a144637284c21afc6de17fea4bfb8","7646a919d7e64fa990bca9b024ff089d",3198738,1,-4,0,1127,302,298,-4
"7646a919d7e64fa990bca9b024ff089d","e390b575229748ea8aac9364efe2bf00",3198738,1,7,0,1128,298,304,6
"e390b575229748ea8aac9364efe2bf00","e390b575229748ea8aac9364efe2bf00",3198738,1,0,1,1129,304,304,0
"e390b575229748ea8aac9364efe2bf00","4a29443515bb404cb8924e1c60a63b73",3198738,1,-24,0,1130,304,285,-19
"4a29443515bb404cb8924e1c60a63b73","3434c10e561d488a914e0f7d71907abd",3198738,2,27,0,1131,285,305,20
"3434c10e561d488a914e0f7d71907abd","53e7e900392747ccad52e711ab0f80d8",3198738,1,2,0,1132,305,307,2
"53e7e900392747ccad52e711ab0f80d8","53e7e900392747ccad52e711ab0f80d8",3198738,2,0,1,1133,307,307,0
"53e7e900392747ccad52e711ab0f80d8","130acc2aeb0448fdbb2de63bc5cebe5b",3198738,1,3,0,1135,307,309,2
"130acc2aeb0448fdbb2de63bc5cebe5b","3434c10e561d488a914e0f7d71907abd",3198738,1,-5,0,1136,309,305,-4
"3434c10e561d488a914e0f7d71907abd","130acc2aeb0448fdbb2de63bc5cebe5b",3198738,1,5,0,1137,305,309,4
"130acc2aeb0448fdbb2de63bc5cebe5b","9c062b3251034ebe90f5054e2a3b5120",3198738,1,2,0,1138,309,311,2
"9c062b3251034ebe90f5054e2a3b5120","9c062b3251034ebe90f5054e2a3b5120",3198738,2,0,1,1139,311,311,0
"9c062b3251034ebe90f5054e2a3b5120","ea859f8207e44537889daeaba13ac2e8",3198738,1,1,0,1141,311,312,1
"ea859f8207e44537889daeaba13ac2e8","ea859f8207e44537889daeaba13ac2e8",3198738,1,0,1,1142,312,312,0
"ea859f8207e44537889daeaba13ac2e8","56d94971a7a94257aa330183a8ebd0ea",3198738,1,1,0,1143,312,313,1
"56d94971a7a94257aa330183a8ebd0ea","56d94971a7a94257aa330183a8ebd0ea",3198738,1,0,1,1144,313,313,0
"56d94971a7a94257aa330183a8ebd0ea","141c0df6cd1946539aadd1c9b7068cd4",3198738,1,-5,0,1145,313,308,-5
"141c0df6cd1946539aadd1c9b7068cd4","13255e63e0aa4abf85e5211bf613d43e",3198738,1,10,0,1146,308,317,9
"13255e63e0aa4abf85e5211bf613d43e","13255e63e0aa4abf85e5211bf613d43e",3198738,1,0,1,1147,317,317,0
"13255e63e0aa4abf85e5211bf613d43e","0c787d16c9504873b1a4d903cec09948",3198738,1,-3,0,1148,317,314,-3
"0c787d16c9504873b1a4d903cec09948","86c27d40179e419c8e9d150fb6afa5d0",3198738,1,6,0,1149,314,319,5
"86c27d40179e419c8e9d150fb6afa5d0","86c27d40179e419c8e9d150fb6afa5d0",3198738,1,0,1,1150,319,319,0
"86c27d40179e419c8e9d150fb6afa5d0","8d7e0b55cf9849cda222a0f2440cec55",3198738,1,-1,0,1151,319,318,-1
"8d7e0b55cf9849cda222a0f2440cec55","24f1363179ad4aaa965484a78471912b",3198738,1,6,0,1152,318,323,5
"24f1363179ad4aaa965484a78471912b","47edbb64109243e6b0f8f64cdef90c6c",3198738,1,3,0,1153,323,326,3
"47edbb64109243e6b0f8f64cdef90c6c","24f1363179ad4aaa965484a78471912b",3198738,1,-3,0,1154,326,323,-3
"24f1363179ad4aaa965484a78471912b","3628bdce1dd2429ba924d2d4d09448d2",3198738,1,-1,0,1155,323,322,-1
"3628bdce1dd2429ba924d2d4d09448d2","56b3fd1a212a4764be39d979fde3326e",3198738,1,7,0,1156,322,328,6
"56b3fd1a212a4764be39d979fde3326e","56b3fd1a212a4764be39d979fde3326e",3198738,1,0,1,1157,328,328,0
"56b3fd1a212a4764be39d979fde3326e","3434c10e561d488a914e0f7d71907abd",3198738,1,-28,0,1158,328,305,-23
"3434c10e561d488a914e0f7d71907abd","0c4079457ede49e3aeb5e86ed84bdf35",3198738,2,31,0,1159,305,329,24
"0c4079457ede49e3aeb5e86ed84bdf35","38aea304b4fa46e1b29bb72f5cea4c93",3198738,4,2,0,1160,329,331,2
"38aea304b4fa46e1b29bb72f5cea4c93","0c4079457ede49e3aeb5e86ed84bdf35",3198738,3,-2,0,1161,331,329,-2
"38aea304b4fa46e1b29bb72f5cea4c93","38aea304b4fa46e1b29bb72f5cea4c93",3198738,6,0,1,1163,331,331,0
"38aea304b4fa46e1b29bb72f5cea4c93","e36d261332f14e79bb4b467aceaeb9b5",3198738,2,2,0,1169,331,333,2
"e36d261332f14e79bb4b467aceaeb9b5","e36d261332f14e79bb4b467aceaeb9b5",3198738,1,0,1,1170,333,333,0
"e36d261332f14e79bb4b467aceaeb9b5","c7e89b9d04744d2eab742fc24e3ef1ae",3198738,1,1,0,1171,333,334,1
"c7e89b9d04744d2eab742fc24e3ef1ae","c7e89b9d04744d2eab742fc24e3ef1ae",3198738,2,0,1,1172,334,334,0
"c7e89b9d04744d2eab742fc24e3ef1ae","fe49f8054b374a0ea4bb266ed135ff62",3198738,1,1,0,1174,334,335,1
"fe49f8054b374a0ea4bb266ed135ff62","fe49f8054b374a0ea4bb266ed135ff62",3198738,2,0,1,1175,335,335,0
"fe49f8054b374a0ea4bb266ed135ff62","d0a8f74af98642fe8360d22c42e45117",3198738,1,1,0,1177,335,336,1
"d0a8f74af98642fe8360d22c42e45117","d0a8f74af98642fe8360d22c42e45117",3198738,2,0,1,1178,336,336,0
"d0a8f74af98642fe8360d22c42e45117","0c4079457ede49e3aeb5e86ed84bdf35",3198738,1,-7,0,1180,336,329,-7
"0c4079457ede49e3aeb5e86ed84bdf35","a7c6339ca1da4368a18d471f0519f877",3198738,1,11,0,1181,329,339,10
"a7c6339ca1da4368a18d471f0519f877","a7c6339ca1da4368a18d471f0519f877",3198738,1,0,1,1182,339,339,0
"a7c6339ca1da4368a18d471f0519f877","b8b9418ab322418d9db9b40d96af873a",3198738,1,-2,0,1183,339,337,-2
"b8b9418ab322418d9db9b40d96af873a","bbc5139ca9024389a94db3a6f47dcff6",3198738,1,5,0,1184,337,341,4
"bbc5139ca9024389a94db3a6f47dcff6","bbc5139ca9024389a94db3a6f47dcff6",3198738,4,0,1,1185,341,341,0
"bbc5139ca9024389a94db3a6f47dcff6","4ee6ca9019ab4a1ab323f98094a9bd77",3198738,1,2,0,1189,341,343,2
"4ee6ca9019ab4a1ab323f98094a9bd77","4ee6ca9019ab4a1ab323f98094a9bd77",3198738,2,0,1,1190,343,343,0
"4ee6ca9019ab4a1ab323f98094a9bd77","b37947176785476f8b29d49a851366dc",3198738,1,1,0,1192,343,344,1
"b37947176785476f8b29d49a851366dc","b37947176785476f8b29d49a851366dc",3198738,2,0,1,1193,344,344,0
"b37947176785476f8b29d49a851366dc","fcea5b10d5a14a3b9324ffece8f6e1e5",3198738,1,1,0,1195,344,345,1
"fcea5b10d5a14a3b9324ffece8f6e1e5","fcea5b10d5a14a3b9324ffece8f6e1e5",3198738,2,0,1,1196,345,345,0
"fcea5b10d5a14a3b9324ffece8f6e1e5","c2490bc612d146edbe786556fab3651b",3198738,1,-5,0,1198,345,340,-5
"c2490bc612d146edbe786556fab3651b","38aea304b4fa46e1b29bb72f5cea4c93",3198738,1,-11,0,1199,340,331,-9
"38aea304b4fa46e1b29bb72f5cea4c93","4a92daef4d504e1792575a26502bb7b7",3198738,2,18,0,1200,331,346,15
"4a92daef4d504e1792575a26502bb7b7","0c4079457ede49e3aeb5e86ed84bdf35",3198738,1,-20,0,1201,346,329,-17
"0c4079457ede49e3aeb5e86ed84bdf35","6ac8bb048b854999a47edb35fe627f11",3198738,1,21,0,1202,329,347,18
"6ac8bb048b854999a47edb35fe627f11","38aea304b4fa46e1b29bb72f5cea4c93",3198738,1,-19,0,1203,347,331,-16
"4a92daef4d504e1792575a26502bb7b7","38aea304b4fa46e1b29bb72f5cea4c93",3198738,1,-18,0,1205,346,331,-15
"0c4079457ede49e3aeb5e86ed84bdf35","4a92daef4d504e1792575a26502bb7b7",3198738,1,20,0,1207,329,346,17
"4a92daef4d504e1792575a26502bb7b7","6ac8bb048b854999a47edb35fe627f11",3198738,1,1,0,1208,346,347,1
"6ac8bb048b854999a47edb35fe627f11","6ac8bb048b854999a47edb35fe627f11",3198738,2,0,1,1209,347,347,0
"6ac8bb048b854999a47edb35fe627f11","30ead9794d4847abaf222ca966cc8630",3198738,1,3,0,1211,347,348,1
"30ead9794d4847abaf222ca966cc8630","0c4079457ede49e3aeb5e86ed84bdf35",3198738,1,-24,0,1212,348,329,-19
"0c4079457ede49e3aeb5e86ed84bdf35","c20993c944444fe085345591a8bd837e",3198738,1,27,0,1213,329,351,22
"c20993c944444fe085345591a8bd837e","09b9678ddc3d452ea4a3d46e15826065",3198738,1,2,0,1214,351,353,2
"09b9678ddc3d452ea4a3d46e15826065","897b7f51242c44aab2205c72fdcbf4cd",3198738,1,-1,0,1215,353,352,-1
"897b7f51242c44aab2205c72fdcbf4cd","eff0de7f2dbb42dfa1a2e686efab5b6d",3198738,1,2,0,1216,352,354,2
"eff0de7f2dbb42dfa1a2e686efab5b6d","c20993c944444fe085345591a8bd837e",3198738,1,-3,0,1217,354,351,-3
"c20993c944444fe085345591a8bd837e","c20993c944444fe085345591a8bd837e",3198738,3,0,1,1218,351,351,0
"c20993c944444fe085345591a8bd837e","897b7f51242c44aab2205c72fdcbf4cd",3198738,1,1,0,1221,351,352,1
"897b7f51242c44aab2205c72fdcbf4cd","897b7f51242c44aab2205c72fdcbf4cd",3198738,3,0,1,1222,352,352,0
"897b7f51242c44aab2205c72fdcbf4cd","09b9678ddc3d452ea4a3d46e15826065",3198738,1,1,0,1225,352,353,1
"09b9678ddc3d452ea4a3d46e15826065","09b9678ddc3d452ea4a3d46e15826065",3198738,3,0,1,1226,353,353,0
"09b9678ddc3d452ea4a3d46e15826065","eff0de7f2dbb42dfa1a2e686efab5b6d",3198738,1,1,0,1229,353,354,1
"eff0de7f2dbb42dfa1a2e686efab5b6d","eff0de7f2dbb42dfa1a2e686efab5b6d",3198738,3,0,1,1230,354,354,0
"eff0de7f2dbb42dfa1a2e686efab5b6d","30ead9794d4847abaf222ca966cc8630",3198738,1,-6,0,1233,354,348,-6
"30ead9794d4847abaf222ca966cc8630","2fe14166dc9642c3bc666b86a57f943d",3198738,2,10,0,1234,348,357,9
"2fe14166dc9642c3bc666b86a57f943d","1ba8fef685d74a8194b9db252eb704fb",3198738,2,-2,0,1235,357,355,-2
"1ba8fef685d74a8194b9db252eb704fb","52580888dadb4fe3baa795683ea227bd",3198738,3,10,0,1236,355,364,9
"52580888dadb4fe3baa795683ea227bd","f00179e251a045b39c3f7a54f9aa4acc",3198738,2,-1,0,1237,364,363,-1
"f00179e251a045b39c3f7a54f9aa4acc","492a3bc6a1254f23a7998587961b22a4",3198738,3,4,0,1238,363,366,3
"492a3bc6a1254f23a7998587961b22a4","072a190fd302456290895f9f04d6940a",3198738,3,-1,0,1239,366,365,-1
"072a190fd302456290895f9f04d6940a","2fe14166dc9642c3bc666b86a57f943d",3198738,2,-10,0,1240,365,357,-8
"2fe14166dc9642c3bc666b86a57f943d","c76574d21bc14aeea7ecd0b027f39858",3198738,2,13,0,1241,357,367,10
"c76574d21bc14aeea7ecd0b027f39858","2fe14166dc9642c3bc666b86a57f943d",3198738,1,-13,0,1242,367,357,-10
"2fe14166dc9642c3bc666b86a57f943d","44421dd1e13a47a388c4a19834b744c7",3198738,1,2,0,1243,357,359,2
"44421dd1e13a47a388c4a19834b744c7","44421dd1e13a47a388c4a19834b744c7",3198738,2,0,1,1244,359,359,0
"44421dd1e13a47a388c4a19834b744c7","cb5fc7ef85d547c4be1a7439d0bf6052",3198738,1,1,0,1246,359,360,1
"cb5fc7ef85d547c4be1a7439d0bf6052","cb5fc7ef85d547c4be1a7439d0bf6052",3198738,2,0,1,1247,360,360,0
"cb5fc7ef85d547c4be1a7439d0bf6052","0a8f150a4cf747acbde62f4721823da3",3198738,1,1,0,1249,360,361,1
"0a8f150a4cf747acbde62f4721823da3","0a8f150a4cf747acbde62f4721823da3",3198738,2,0,1,1250,361,361,0
"0a8f150a4cf747acbde62f4721823da3","ab8fdad974ae471f9f24c3f9dd04462e",3198738,1,1,0,1252,361,362,1
"ab8fdad974ae471f9f24c3f9dd04462e","ab8fdad974ae471f9f24c3f9dd04462e",3198738,2,0,1,1253,362,362,0
"ab8fdad974ae471f9f24c3f9dd04462e","1ba8fef685d74a8194b9db252eb704fb",3198738,1,-7,0,1255,362,355,-7
"52580888dadb4fe3baa795683ea227bd","492a3bc6a1254f23a7998587961b22a4",3198738,2,3,0,1257,364,366,2
"492a3bc6a1254f23a7998587961b22a4","f00179e251a045b39c3f7a54f9aa4acc",3198738,2,-4,0,1258,366,363,-3
"f00179e251a045b39c3f7a54f9aa4acc","072a190fd302456290895f9f04d6940a",3198738,1,3,0,1259,363,365,2
"072a190fd302456290895f9f04d6940a","c76574d21bc14aeea7ecd0b027f39858",3198738,1,3,0,1260,365,367,2
"c76574d21bc14aeea7ecd0b027f39858","52580888dadb4fe3baa795683ea227bd",3198738,1,-5,0,1261,367,364,-3
"52580888dadb4fe3baa795683ea227bd","52580888dadb4fe3baa795683ea227bd",3198738,4,0,1,1262,364,364,0
"072a190fd302456290895f9f04d6940a","52580888dadb4fe3baa795683ea227bd",3198738,1,-2,0,1267,365,364,-1
"52580888dadb4fe3baa795683ea227bd","30ead9794d4847abaf222ca966cc8630",3198738,1,-18,0,1268,364,348,-16
"2fe14166dc9642c3bc666b86a57f943d","2fe14166dc9642c3bc666b86a57f943d",3198738,1,0,1,1270,357,357,0
"492a3bc6a1254f23a7998587961b22a4","492a3bc6a1254f23a7998587961b22a4",3198738,1,0,1,1278,366,366,0
"c76574d21bc14aeea7ecd0b027f39858","1ba8fef685d74a8194b9db252eb704fb",3198738,1,-15,0,1282,367,355,-12
"1ba8fef685d74a8194b9db252eb704fb","cfa457d1743848e4bb5e4beced6448ed",3198738,1,17,0,1283,355,369,14
"cfa457d1743848e4bb5e4beced6448ed","cfa457d1743848e4bb5e4beced6448ed",3198738,1,0,1,1284,369,369,0
"cfa457d1743848e4bb5e4beced6448ed","30ead9794d4847abaf222ca966cc8630",3198738,1,-25,0,1285,369,348,-21
"30ead9794d4847abaf222ca966cc8630","b71bac264efb4abd97015447bd490db6",3198738,3,28,0,1286,348,370,22
"b71bac264efb4abd97015447bd490db6","30ead9794d4847abaf222ca966cc8630",3198738,2,-28,0,1287,370,348,-22
"b71bac264efb4abd97015447bd490db6","b71bac264efb4abd97015447bd490db6",3198738,3,0,1,1291,370,370,0
"b71bac264efb4abd97015447bd490db6","8d448d625b024c82a5eb240bbd7431d6",3198738,5,5,0,1292,370,374,4
"8d448d625b024c82a5eb240bbd7431d6","8d448d625b024c82a5eb240bbd7431d6",3198738,80,0,1,1293,374,374,0
"8d448d625b024c82a5eb240bbd7431d6","b71bac264efb4abd97015447bd490db6",3198738,2,-5,0,1300,374,370,-4
"b71bac264efb4abd97015447bd490db6","d6d02b6ef04e4f17805504500b8ce441",3198738,2,8,0,1301,370,375,5
"d6d02b6ef04e4f17805504500b8ce441","d6d02b6ef04e4f17805504500b8ce441",3198738,9,0,1,1302,375,375,0
"d6d02b6ef04e4f17805504500b8ce441","2ae94c0cea4d480a9d5dca8fb1d7b542",3198738,1,-178,0,1304,375,242,-133
"2ae94c0cea4d480a9d5dca8fb1d7b542","30c9ba177afc49a695625d2bdec40207",3198738,1,9,0,1305,242,250,8
"30c9ba177afc49a695625d2bdec40207","30c9ba177afc49a695625d2bdec40207",3198738,2,0,1,1306,250,250,0
"30c9ba177afc49a695625d2bdec40207","00f61990949545828dd12f1303d47504",3198738,1,8,0,1308,250,256,6
"00f61990949545828dd12f1303d47504","6e83e23f56544a19b94067c1c558d9c0",3198738,1,-11,0,1309,256,247,-9
"6e83e23f56544a19b94067c1c558d9c0","d6d02b6ef04e4f17805504500b8ce441",3198738,1,172,0,1310,247,375,128
"d6d02b6ef04e4f17805504500b8ce441","4a29443515bb404cb8924e1c60a63b73",3198738,2,-118,0,1317,375,285,-90
"4a29443515bb404cb8924e1c60a63b73","66baf19b6b904b70922329068c63746d",3198738,1,122,0,1318,285,376,91
"66baf19b6b904b70922329068c63746d","7f544639412e40a9ba27f43b415362ab",3198738,1,2,0,1319,376,378,2
"7f544639412e40a9ba27f43b415362ab","7f544639412e40a9ba27f43b415362ab",3198738,1,0,1,1320,378,378,0
"7f544639412e40a9ba27f43b415362ab","d5ae8642e15b46b8bd298b02274d4e9c",3198738,1,2,0,1321,378,380,2
"d5ae8642e15b46b8bd298b02274d4e9c","d5ae8642e15b46b8bd298b02274d4e9c",3198738,1,0,1,1322,380,380,0
"d5ae8642e15b46b8bd298b02274d4e9c","a0d10309a2dd456289147f84be9d37f9",3198738,1,1,0,1323,380,381,1
"a0d10309a2dd456289147f84be9d37f9","a0d10309a2dd456289147f84be9d37f9",3198738,2,0,1,1324,381,381,0
"a0d10309a2dd456289147f84be9d37f9","0fcbc3ca07b144138b8d85da581f09a8",3198738,1,1,0,1326,381,382,1
"0fcbc3ca07b144138b8d85da581f09a8","0fcbc3ca07b144138b8d85da581f09a8",3198738,5,0,1,1327,382,382,0
"0fcbc3ca07b144138b8d85da581f09a8","66baf19b6b904b70922329068c63746d",3198738,1,-6,0,1332,382,376,-6
"66baf19b6b904b70922329068c63746d","4890121ce5d74576b4632b77cfc23398",3198738,1,14,0,1333,376,388,12
"4890121ce5d74576b4632b77cfc23398","c2fca3669923477ab966ded303dea31c",3198738,1,-6,0,1334,388,383,-5
"c2fca3669923477ab966ded303dea31c","4890121ce5d74576b4632b77cfc23398",3198738,1,6,0,1335,383,388,5
"4890121ce5d74576b4632b77cfc23398","18d3b836dd804224883cc9180b60a8e1",3198738,1,-1,0,1336,388,387,-1
"18d3b836dd804224883cc9180b60a8e1","96bb2b3e85a34d8b9544514e89f6fe97",3198738,1,4,0,1337,387,390,3
"96bb2b3e85a34d8b9544514e89f6fe97","96bb2b3e85a34d8b9544514e89f6fe97",3198738,3,0,1,1338,390,390,0
"96bb2b3e85a34d8b9544514e89f6fe97","ac4e9b54acfe4670b4634859c7263cb5",3198738,1,2,0,1341,390,392,2
"ac4e9b54acfe4670b4634859c7263cb5","ac4e9b54acfe4670b4634859c7263cb5",3198738,3,0,1,1342,392,392,0
"ac4e9b54acfe4670b4634859c7263cb5","17f95d18bab743888e1736033dc3384d",3198738,1,-3,0,1345,392,389,-3
"17f95d18bab743888e1736033dc3384d","6f8881a745ac4c358a68b92c3b4abe81",3198738,2,6,0,1346,389,394,5
"6f8881a745ac4c358a68b92c3b4abe81","f7002c8484354eceac57bc7bd62c76c1",3198738,3,-1,0,1347,394,393,-1
"f7002c8484354eceac57bc7bd62c76c1","0c12af0a4e7f4002852cf84b2537c161",3198738,1,3,0,1348,393,395,2
"0c12af0a4e7f4002852cf84b2537c161","df8191ec5e584c838a899c378941a566",3198738,1,4,0,1349,395,398,3
"df8191ec5e584c838a899c378941a566","0c12af0a4e7f4002852cf84b2537c161",3198738,1,-4,0,1350,398,395,-3
"0c12af0a4e7f4002852cf84b2537c161","6f8881a745ac4c358a68b92c3b4abe81",3198738,1,-2,0,1351,395,394,-1
"6f8881a745ac4c358a68b92c3b4abe81","66baf19b6b904b70922329068c63746d",3198738,1,-22,0,1352,394,376,-18
"66baf19b6b904b70922329068c63746d","df8191ec5e584c838a899c378941a566",3198738,1,28,0,1353,376,398,22
"df8191ec5e584c838a899c378941a566","96bb2b3e85a34d8b9544514e89f6fe97",3198738,1,-11,0,1354,398,390,-8
"96bb2b3e85a34d8b9544514e89f6fe97","17f95d18bab743888e1736033dc3384d",3198738,1,-1,0,1355,390,389,-1
"6f8881a745ac4c358a68b92c3b4abe81","6f8881a745ac4c358a68b92c3b4abe81",3198738,6,0,1,1357,394,394,0
"f7002c8484354eceac57bc7bd62c76c1","66baf19b6b904b70922329068c63746d",3198738,1,-21,0,1364,393,376,-17
"66baf19b6b904b70922329068c63746d","6f8881a745ac4c358a68b92c3b4abe81",3198738,1,22,0,1365,376,394,18
"f7002c8484354eceac57bc7bd62c76c1","44a277ea44dc4ae689fab4b82f0b4098",3198738,1,5,0,1367,393,397,4
"44a277ea44dc4ae689fab4b82f0b4098","44a277ea44dc4ae689fab4b82f0b4098",3198738,2,0,1,1368,397,397,0
"44a277ea44dc4ae689fab4b82f0b4098","0c12af0a4e7f4002852cf84b2537c161",3198738,1,-2,0,1370,397,395,-2
"0c12af0a4e7f4002852cf84b2537c161","859e0b8d71694b12befb69ee698138f9",3198738,1,5,0,1371,395,399,4
"859e0b8d71694b12befb69ee698138f9","859e0b8d71694b12befb69ee698138f9",3198738,2,0,1,1372,399,399,0
"859e0b8d71694b12befb69ee698138f9","2b09a08242b54983aec7063990fb3f66",3198738,1,3,0,1374,399,400,1
"2b09a08242b54983aec7063990fb3f66","66baf19b6b904b70922329068c63746d",3198738,1,-32,0,1375,400,376,-24
"66baf19b6b904b70922329068c63746d","2b09a08242b54983aec7063990fb3f66",3198738,1,32,0,1376,376,400,24
"2b09a08242b54983aec7063990fb3f66","2b09a08242b54983aec7063990fb3f66",3198738,1,0,1,1377,400,400,0
"2b09a08242b54983aec7063990fb3f66","1f471b7a883a4df48211e8c6a81b59a7",3198738,1,1,0,1378,400,401,1
"1f471b7a883a4df48211e8c6a81b59a7","1f471b7a883a4df48211e8c6a81b59a7",3198738,1,0,1,1379,401,401,0
"1f471b7a883a4df48211e8c6a81b59a7","2b09a08242b54983aec7063990fb3f66",3198738,1,-1,0,1380,401,400,-1
"2b09a08242b54983aec7063990fb3f66","4a29443515bb404cb8924e1c60a63b73",3198738,1,-154,0,1381,400,285,-115
"0c4079457ede49e3aeb5e86ed84bdf35","9de0d567bfa84fe5b77cb76f4a76a5d1",3198738,1,101,0,1384,329,404,75
"9de0d567bfa84fe5b77cb76f4a76a5d1","9de0d567bfa84fe5b77cb76f4a76a5d1",3198738,2,0,1,1385,404,404,0
"9de0d567bfa84fe5b77cb76f4a76a5d1","1157bd665ec4472fb58b751dc5099355",3198738,1,-1,0,1387,404,403,-1
"1157bd665ec4472fb58b751dc5099355","58fc9094275e4c49be3f4ba6d4acc0a4",3198738,1,5,0,1388,403,406,3
"58fc9094275e4c49be3f4ba6d4acc0a4","3c8a22d2f9c146ea956609e3ed4f2559",3198738,1,-2,0,1389,406,405,-1
"3c8a22d2f9c146ea956609e3ed4f2559","58fc9094275e4c49be3f4ba6d4acc0a4",3198738,1,2,0,1390,405,406,1
"58fc9094275e4c49be3f4ba6d4acc0a4","58fc9094275e4c49be3f4ba6d4acc0a4",3198738,14,0,1,1391,406,406,0
"58fc9094275e4c49be3f4ba6d4acc0a4","2b09a08242b54983aec7063990fb3f66",3198738,1,-9,0,1403,406,400,-6
"2b09a08242b54983aec7063990fb3f66","58fc9094275e4c49be3f4ba6d4acc0a4",3198738,1,9,0,1404,400,406,6
"58fc9094275e4c49be3f4ba6d4acc0a4","c1c1be90b2b14c1ab4a5e1ee3c241902",3198738,1,1,0,1407,406,407,1
"c1c1be90b2b14c1ab4a5e1ee3c241902","c1c1be90b2b14c1ab4a5e1ee3c241902",3198738,5,0,1,1408,407,407,0
"c1c1be90b2b14c1ab4a5e1ee3c241902","58fc9094275e4c49be3f4ba6d4acc0a4",3198738,1,-1,0,1413,407,406,-1
"58fc9094275e4c49be3f4ba6d4acc0a4","02b3a1bead9244c1ba2f857c7da8f82a",3198738,1,3,0,1414,406,408,2
"02b3a1bead9244c1ba2f857c7da8f82a","02b3a1bead9244c1ba2f857c7da8f82a",3198738,1,0,1,1415,408,408,0
"02b3a1bead9244c1ba2f857c7da8f82a","6206fc6479014bb193084c32409dc1b9",3198738,1,1,0,1416,408,409,1
"6206fc6479014bb193084c32409dc1b9","6206fc6479014bb193084c32409dc1b9",3198738,1,0,1,1417,409,409,0
"6206fc6479014bb193084c32409dc1b9","02b3a1bead9244c1ba2f857c7da8f82a",3198738,1,-1,0,1418,409,408,-1
"02b3a1bead9244c1ba2f857c7da8f82a","6a5f020451db426dacba9e2ea3fcc62a",3198738,1,3,0,1419,408,410,2
"6a5f020451db426dacba9e2ea3fcc62a","6a5f020451db426dacba9e2ea3fcc62a",3198738,2,0,1,1420,410,410,0
"6a5f020451db426dacba9e2ea3fcc62a","33a9d248b2e44588a5b07fc1342b9bc2",3198738,1,2,0,1422,410,411,1
"33a9d248b2e44588a5b07fc1342b9bc2","33a9d248b2e44588a5b07fc1342b9bc2",3198738,1,0,1,1423,411,411,0
"33a9d248b2e44588a5b07fc1342b9bc2","c6f26bd420634f1cb7989e76fe6b16c0",3198738,1,1,0,1424,411,412,1
"c6f26bd420634f1cb7989e76fe6b16c0","c6f26bd420634f1cb7989e76fe6b16c0",3198738,5,0,1,1425,412,412,0
"c6f26bd420634f1cb7989e76fe6b16c0","2a65ee6e2ac64f6a8a55fbe5373ec763",3198738,1,1,0,1430,412,413,1
"2a65ee6e2ac64f6a8a55fbe5373ec763","2a65ee6e2ac64f6a8a55fbe5373ec763",3198738,2,0,1,1431,413,413,0
"2a65ee6e2ac64f6a8a55fbe5373ec763","33a9d248b2e44588a5b07fc1342b9bc2",3198738,1,-2,0,1433,413,411,-2
"33a9d248b2e44588a5b07fc1342b9bc2","1fd0f6dadbc14ebc965faf6122190b96",3198738,1,5,0,1434,411,415,4
"1fd0f6dadbc14ebc965faf6122190b96","1fd0f6dadbc14ebc965faf6122190b96",3198738,1,0,1,1435,415,415,0
"1fd0f6dadbc14ebc965faf6122190b96","687055dad9fc40c3982478fe33ec01bf",3198738,1,-1,0,1436,415,414,-1
"687055dad9fc40c3982478fe33ec01bf","a2b4bd40cee2481ebd3fc179d6a5cd62",3198738,1,6,0,1437,414,417,3
"a2b4bd40cee2481ebd3fc179d6a5cd62","2b09a08242b54983aec7063990fb3f66",3198738,2,-27,0,1438,417,400,-17
"2b09a08242b54983aec7063990fb3f66","a2b4bd40cee2481ebd3fc179d6a5cd62",3198738,2,27,0,1439,400,417,17
"2b09a08242b54983aec7063990fb3f66","2add1669f08d4101913db15f8c23b3b7",3198738,1,24,0,1441,400,416,16
"2add1669f08d4101913db15f8c23b3b7","2add1669f08d4101913db15f8c23b3b7",3198738,1,0,1,1442,416,416,0
"2add1669f08d4101913db15f8c23b3b7","2b09a08242b54983aec7063990fb3f66",3198738,1,-24,0,1443,416,400,-16
"a2b4bd40cee2481ebd3fc179d6a5cd62","e34e59dce2204f228f3a84b6725df60f",3198738,1,2,0,1445,417,419,2
"e34e59dce2204f228f3a84b6725df60f","e34e59dce2204f228f3a84b6725df60f",3198738,1,0,1,1446,419,419,0
"e34e59dce2204f228f3a84b6725df60f","a2b4bd40cee2481ebd3fc179d6a5cd62",3198738,1,-2,0,1447,419,417,-2
"a2b4bd40cee2481ebd3fc179d6a5cd62","bec48fc2e1294c7eb3d0aca780d731b8",3198738,1,4,0,1448,417,420,3
"bec48fc2e1294c7eb3d0aca780d731b8","bec48fc2e1294c7eb3d0aca780d731b8",3198738,2,0,1,1449,420,420,0
"bec48fc2e1294c7eb3d0aca780d731b8","dbde19fcce2a4c1abdc7f685c293a23f",3198738,1,3,0,1451,420,422,2
"dbde19fcce2a4c1abdc7f685c293a23f","a24600b0e49245f6bdba8c893cfeddb0",3198738,1,4,0,1452,422,425,3
"a24600b0e49245f6bdba8c893cfeddb0","a24600b0e49245f6bdba8c893cfeddb0",3198738,2,0,1,1453,425,425,0
"a24600b0e49245f6bdba8c893cfeddb0","24cf8786024543f19b89bc20034e60d7",3198738,1,7,0,1455,425,428,3
"24cf8786024543f19b89bc20034e60d7","a2b4bd40cee2481ebd3fc179d6a5cd62",3198738,1,-18,0,1456,428,417,-11
"a2b4bd40cee2481ebd3fc179d6a5cd62","f2a73be2f46840b182d7bd095378004e",3198738,1,19,0,1457,417,429,12
"f2a73be2f46840b182d7bd095378004e","f2a73be2f46840b182d7bd095378004e",3198738,1,0,1,1458,429,429,0
"f2a73be2f46840b182d7bd095378004e","604551fd4266430cb860fef58fa7dd61",3198738,1,1,0,1459,429,430,1
"604551fd4266430cb860fef58fa7dd61","604551fd4266430cb860fef58fa7dd61",3198738,9,0,1,1460,430,430,0
"604551fd4266430cb860fef58fa7dd61","24cf8786024543f19b89bc20034e60d7",3198738,1,-2,0,1469,430,428,-2
"24cf8786024543f19b89bc20034e60d7","dce46f8904594a62a6377a3587aaa663",3198738,1,4,0,1470,428,431,3
"dce46f8904594a62a6377a3587aaa663","dce46f8904594a62a6377a3587aaa663",3198738,1,0,1,1471,431,431,0
"dce46f8904594a62a6377a3587aaa663","9b9d0a249052413c869753b99682b0ac",3198738,1,1,0,1472,431,432,1
"9b9d0a249052413c869753b99682b0ac","9b9d0a249052413c869753b99682b0ac",3198738,3,0,1,1473,432,432,0
"9b9d0a249052413c869753b99682b0ac","061c175cc90f45fbad883025394e78dd",3198738,1,1,0,1476,432,433,1
"061c175cc90f45fbad883025394e78dd","061c175cc90f45fbad883025394e78dd",3198738,1,0,1,1477,433,433,0
"061c175cc90f45fbad883025394e78dd","dce46f8904594a62a6377a3587aaa663",3198738,1,-2,0,1478,433,431,-2
"dce46f8904594a62a6377a3587aaa663","74a7f8712e5449c2bc0b43c6f90dafed",3198738,1,5,0,1479,431,435,4
"74a7f8712e5449c2bc0b43c6f90dafed","74a7f8712e5449c2bc0b43c6f90dafed",3198738,2,0,1,1480,435,435,0
"74a7f8712e5449c2bc0b43c6f90dafed","66ada10dde9f43018588f1ced9d477fc",3198738,1,-1,0,1482,435,434,-1
"66ada10dde9f43018588f1ced9d477fc","bf12c96466d840a69bed7020b3f18bb8",3198738,1,3,0,1483,434,436,2
"bf12c96466d840a69bed7020b3f18bb8","bf12c96466d840a69bed7020b3f18bb8",3198738,2,0,1,1484,436,436,0
"bf12c96466d840a69bed7020b3f18bb8","070600601c4c439288445d2f0724807d",3198738,1,3,0,1486,436,437,1
"070600601c4c439288445d2f0724807d","24cf8786024543f19b89bc20034e60d7",3198738,1,-14,0,1487,437,428,-9
"24cf8786024543f19b89bc20034e60d7","1823b6de7d334a7aaabc4570719af4d9",3198738,1,16,0,1488,428,439,11
"1823b6de7d334a7aaabc4570719af4d9","1823b6de7d334a7aaabc4570719af4d9",3198738,12,0,1,1489,439,439,0
"1823b6de7d334a7aaabc4570719af4d9","0380cd76a7d44bc3a4da1f15e4d68f89",3198738,1,2,0,1501,439,440,1
"0380cd76a7d44bc3a4da1f15e4d68f89","070600601c4c439288445d2f0724807d",3198738,1,-4,0,1502,440,437,-3
"070600601c4c439288445d2f0724807d","0380cd76a7d44bc3a4da1f15e4d68f89",3198738,1,4,0,1503,437,440,3
"0380cd76a7d44bc3a4da1f15e4d68f89","0380cd76a7d44bc3a4da1f15e4d68f89",3198738,1,0,1,1504,440,440,0
"0380cd76a7d44bc3a4da1f15e4d68f89","23b7673c8b5443108c2ef09382834a86",3198738,1,2,0,1505,440,441,1
"23b7673c8b5443108c2ef09382834a86","23b7673c8b5443108c2ef09382834a86",3198738,2,0,1,1506,441,441,0
"23b7673c8b5443108c2ef09382834a86","901e92500aea43c79f19f1b279050668",3198738,1,2,0,1508,441,442,1
"901e92500aea43c79f19f1b279050668","901e92500aea43c79f19f1b279050668",3198738,2,0,1,1509,442,442,0
"901e92500aea43c79f19f1b279050668","001339db8ced4cf78829ebe8b145449d",3198738,2,1,0,1510,442,443,1
"001339db8ced4cf78829ebe8b145449d","001339db8ced4cf78829ebe8b145449d",3198738,8,0,1,1511,443,443,0
"001339db8ced4cf78829ebe8b145449d","452745e0366e42ae81561bfddebcc6c3",3198738,2,1,0,1519,443,444,1
"452745e0366e42ae81561bfddebcc6c3","452745e0366e42ae81561bfddebcc6c3",3198738,2,0,1,1520,444,444,0
"452745e0366e42ae81561bfddebcc6c3","4660ff2089114e8db82ceb26a4f329e3",3198738,1,2,0,1522,444,445,1
"4660ff2089114e8db82ceb26a4f329e3","901e92500aea43c79f19f1b279050668",3198738,3,-4,0,1523,445,442,-3
"901e92500aea43c79f19f1b279050668","4660ff2089114e8db82ceb26a4f329e3",3198738,3,4,0,1524,442,445,3
"4660ff2089114e8db82ceb26a4f329e3","4660ff2089114e8db82ceb26a4f329e3",3198738,2,0,1,1525,445,445,0
"4660ff2089114e8db82ceb26a4f329e3","7bd5586eb9d8484eb74a433ee7bfe499",3198738,1,2,0,1526,445,446,1
"7bd5586eb9d8484eb74a433ee7bfe499","7bd5586eb9d8484eb74a433ee7bfe499",3198738,9,0,1,1527,446,446,0
"7bd5586eb9d8484eb74a433ee7bfe499","8a7f26e690f34dda97be16904518ca99",3198738,1,2,0,1536,446,447,1
"8a7f26e690f34dda97be16904518ca99","8a7f26e690f34dda97be16904518ca99",3198738,1,0,1,1537,447,447,0
"8a7f26e690f34dda97be16904518ca99","b2f0d654738f48158edff28e8d3a546e",3198738,1,5,0,1538,447,449,2
"b2f0d654738f48158edff28e8d3a546e","070600601c4c439288445d2f0724807d",3198738,1,-21,0,1539,449,437,-12
"070600601c4c439288445d2f0724807d","070600601c4c439288445d2f0724807d",3198738,1,0,1,1540,437,437,0
"070600601c4c439288445d2f0724807d","901e92500aea43c79f19f1b279050668",3198738,3,8,0,1541,437,442,5
"901e92500aea43c79f19f1b279050668","452745e0366e42ae81561bfddebcc6c3",3198738,1,2,0,1542,442,444,2
"452745e0366e42ae81561bfddebcc6c3","901e92500aea43c79f19f1b279050668",3198738,1,-2,0,1543,444,442,-2
"452745e0366e42ae81561bfddebcc6c3","070600601c4c439288445d2f0724807d",3198738,1,-10,0,1550,444,437,-7
"901e92500aea43c79f19f1b279050668","b71bac264efb4abd97015447bd490db6",3198738,1,-111,0,1554,442,370,-72
"8d448d625b024c82a5eb240bbd7431d6","1b4550d0dab04078b3bf08a655345bdc",3198738,1,-1,0,1563,374,373,-1
"1b4550d0dab04078b3bf08a655345bdc","b2f0d654738f48158edff28e8d3a546e",3198738,1,120,0,1564,373,449,76
"b2f0d654738f48158edff28e8d3a546e","66baf19b6b904b70922329068c63746d",3198738,1,-112,0,1565,449,376,-73
"66baf19b6b904b70922329068c63746d","070600601c4c439288445d2f0724807d",3198738,1,91,0,1566,376,437,61
"901e92500aea43c79f19f1b279050668","66baf19b6b904b70922329068c63746d",3198738,1,-99,0,1568,442,376,-66
"66baf19b6b904b70922329068c63746d","c5df9f40ec14463b9dcfdc73df3e9285",3198738,1,132,0,1569,376,464,88
"c5df9f40ec14463b9dcfdc73df3e9285","c5df9f40ec14463b9dcfdc73df3e9285",3198738,4,0,1,1570,464,464,0
"c5df9f40ec14463b9dcfdc73df3e9285","66baf19b6b904b70922329068c63746d",3198738,1,-132,0,1572,464,376,-88
"66baf19b6b904b70922329068c63746d","83d42d95cd844fc093fc09cee250edb8",3198738,1,135,0,1573,376,465,89
"83d42d95cd844fc093fc09cee250edb8","83d42d95cd844fc093fc09cee250edb8",3198738,8,0,1,1574,465,465,0
"83d42d95cd844fc093fc09cee250edb8","66baf19b6b904b70922329068c63746d",3198738,1,-135,0,1580,465,376,-89
"66baf19b6b904b70922329068c63746d","82ae07bc0c9b4570a41799290d1ef399",3198738,1,-140,0,1581,376,275,-101
"82ae07bc0c9b4570a41799290d1ef399","0d987bed3ffa4ed0b9a2e62e97b7b30f",3198738,1,-4,0,1582,275,272,-3
"0d987bed3ffa4ed0b9a2e62e97b7b30f","82ae07bc0c9b4570a41799290d1ef399",3198738,2,4,0,1607,272,275,3
"bb5a47f5ea01454a8b79455422d3b9da","bc5524e78a8544e2ae2fdc2f3462bbec",3198738,1,-1,0,1642,280,279,-1
"bc5524e78a8544e2ae2fdc2f3462bbec","0d987bed3ffa4ed0b9a2e62e97b7b30f",3198738,1,-9,0,1643,279,272,-7
"a37477c4e4c14169ad44b06b493007f6","b71bac264efb4abd97015447bd490db6",3198738,1,117,0,1690,283,370,87
"8d448d625b024c82a5eb240bbd7431d6","0c4079457ede49e3aeb5e86ed84bdf35",3198738,1,-57,0,1701,374,329,-45
"e36d261332f14e79bb4b467aceaeb9b5","8d448d625b024c82a5eb240bbd7431d6",3198738,1,53,0,1706,333,374,41
"4a29443515bb404cb8924e1c60a63b73","b2f0d654738f48158edff28e8d3a546e",3198738,1,234,0,1755,285,449,164
"b2f0d654738f48158edff28e8d3a546e","f60ee41ec635499abd48168342d32c2f",3198738,5,5,0,1756,449,453,4
"f60ee41ec635499abd48168342d32c2f","b2f0d654738f48158edff28e8d3a546e",3198738,4,-5,0,1757,453,449,-4
"f60ee41ec635499abd48168342d32c2f","f60ee41ec635499abd48168342d32c2f",3198738,73,0,1,1759,453,453,0
"b2f0d654738f48158edff28e8d3a546e","f67fbf45a5f146ed866965bc57c7c001",3198738,1,8,0,1821,449,454,5
"f67fbf45a5f146ed866965bc57c7c001","f67fbf45a5f146ed866965bc57c7c001",3198738,9,0,1,1822,454,454,0
"f67fbf45a5f146ed866965bc57c7c001","d937afe49bd24a07a550dda1c1155122",3198738,1,1,0,1831,454,455,1
"d937afe49bd24a07a550dda1c1155122","d937afe49bd24a07a550dda1c1155122",3198738,1,0,1,1832,455,455,0
"d937afe49bd24a07a550dda1c1155122","3628b3f7823443d0912a339096b69943",3198738,1,1,0,1833,455,456,1
"3628b3f7823443d0912a339096b69943","3628b3f7823443d0912a339096b69943",3198738,1,0,1,1834,456,456,0
"3628b3f7823443d0912a339096b69943","9e049ee647cf43ecbcb5ed792a8e7588",3198738,1,1,0,1835,456,457,1
"9e049ee647cf43ecbcb5ed792a8e7588","9e049ee647cf43ecbcb5ed792a8e7588",3198738,1,0,1,1836,457,457,0
"9e049ee647cf43ecbcb5ed792a8e7588","5256a214faaf410b93f76cea06428334",3198738,1,1,0,1837,457,458,1
"5256a214faaf410b93f76cea06428334","5256a214faaf410b93f76cea06428334",3198738,1,0,1,1838,458,458,0
"5256a214faaf410b93f76cea06428334","25c32b120fce40fa9b6c85133aeb4716",3198738,1,1,0,1839,458,459,1
"25c32b120fce40fa9b6c85133aeb4716","25c32b120fce40fa9b6c85133aeb4716",3198738,1,0,1,1840,459,459,0
"25c32b120fce40fa9b6c85133aeb4716","11bc14f2204949008b7d511b933363c1",3198738,1,1,0,1841,459,460,1
"11bc14f2204949008b7d511b933363c1","11bc14f2204949008b7d511b933363c1",3198738,1,0,1,1842,460,460,0
"11bc14f2204949008b7d511b933363c1","42de338840a34d15adb66e7b14fb9d2c",3198738,1,1,0,1843,460,461,1
"42de338840a34d15adb66e7b14fb9d2c","42de338840a34d15adb66e7b14fb9d2c",3198738,1,0,1,1844,461,461,0
"42de338840a34d15adb66e7b14fb9d2c","9da37c6210b1416b8079c274f70bf600",3198738,1,1,0,1845,461,462,1
"9da37c6210b1416b8079c274f70bf600","9da37c6210b1416b8079c274f70bf600",3198738,5,0,1,1846,462,462,0
"9da37c6210b1416b8079c274f70bf600","519119f1deac45ff9ab4f13529be5c6e",3198738,1,1,0,1851,462,463,1
"519119f1deac45ff9ab4f13529be5c6e","f67fbf45a5f146ed866965bc57c7c001",3198738,1,-9,0,1852,463,454,-9
"f67fbf45a5f146ed866965bc57c7c001","519119f1deac45ff9ab4f13529be5c6e",3198738,1,9,0,1853,454,463,9
"519119f1deac45ff9ab4f13529be5c6e","c5df9f40ec14463b9dcfdc73df3e9285",3198738,1,3,0,1854,463,464,1
"c5df9f40ec14463b9dcfdc73df3e9285","83d42d95cd844fc093fc09cee250edb8",3198738,1,3,0,1857,464,465,1
"83d42d95cd844fc093fc09cee250edb8","b71bac264efb4abd97015447bd490db6",3198738,1,-147,0,1860,465,370,-95
"8d448d625b024c82a5eb240bbd7431d6","b2f0d654738f48158edff28e8d3a546e",3198738,2,119,0,1864,374,449,75
"b2f0d654738f48158edff28e8d3a546e","8d448d625b024c82a5eb240bbd7431d6",3198738,1,-119,0,1865,449,374,-75
"8d448d625b024c82a5eb240bbd7431d6","f60ee41ec635499abd48168342d32c2f",3198738,1,124,0,1870,374,453,79
"f60ee41ec635499abd48168342d32c2f","b71bac264efb4abd97015447bd490db6",3198738,1,-129,0,1878,453,370,-83
"b613861cecf84ffcab01afb23f660475","b613861cecf84ffcab01afb23f660475",11385589,3,0,1,1,1,1,0
"b613861cecf84ffcab01afb23f660475","e2911e79efc2420eac45d9f671463d4b",11385589,1,3,0,4,1,2,1
"e2911e79efc2420eac45d9f671463d4b","519d1b8c59404d67b54e96c5c8a830b2",11385589,1,1,0,5,2,3,1
"519d1b8c59404d67b54e96c5c8a830b2","519d1b8c59404d67b54e96c5c8a830b2",11385589,1,0,1,6,3,3,0
"519d1b8c59404d67b54e96c5c8a830b2","e2911e79efc2420eac45d9f671463d4b",11385589,1,-1,0,7,3,2,-1
"e2911e79efc2420eac45d9f671463d4b","e2911e79efc2420eac45d9f671463d4b",11385589,1,0,1,8,2,2,0
"e2911e79efc2420eac45d9f671463d4b","531db53f81f646edb0cdcfe0085b03b7",11385589,1,2,0,9,2,4,2
"531db53f81f646edb0cdcfe0085b03b7","531db53f81f646edb0cdcfe0085b03b7",11385589,1,0,1,10,4,4,0
"531db53f81f646edb0cdcfe0085b03b7","4f5f94b2f95141e0a9d53a61da2276da",11385589,1,1,0,11,4,5,1
"4f5f94b2f95141e0a9d53a61da2276da","4f5f94b2f95141e0a9d53a61da2276da",11385589,1,0,1,12,5,5,0
"4f5f94b2f95141e0a9d53a61da2276da","6d541c89590949f99af293c4f2333f67",11385589,1,1,0,13,5,6,1
"6d541c89590949f99af293c4f2333f67","6d541c89590949f99af293c4f2333f67",11385589,1,0,1,14,6,6,0
"6d541c89590949f99af293c4f2333f67","dd5cf0b9fe4c4f1d8f5ff8e4c04879cb",11385589,1,1,0,15,6,7,1
"dd5cf0b9fe4c4f1d8f5ff8e4c04879cb","dd5cf0b9fe4c4f1d8f5ff8e4c04879cb",11385589,1,0,1,16,7,7,0
"dd5cf0b9fe4c4f1d8f5ff8e4c04879cb","f96261861edc426abe2248be4f0a709a",11385589,1,1,0,17,7,8,1
"f96261861edc426abe2248be4f0a709a","f96261861edc426abe2248be4f0a709a",11385589,1,0,1,18,8,8,0
"f96261861edc426abe2248be4f0a709a","66b5e16f4f75454fb5b8172079f0fa83",11385589,1,1,0,19,8,9,1
"66b5e16f4f75454fb5b8172079f0fa83","66b5e16f4f75454fb5b8172079f0fa83",11385589,1,0,1,20,9,9,0
"66b5e16f4f75454fb5b8172079f0fa83","0680571d4698477995e41842c36a54b2",11385589,1,1,0,21,9,10,1
"0680571d4698477995e41842c36a54b2","0680571d4698477995e41842c36a54b2",11385589,1,0,1,22,10,10,0
"0680571d4698477995e41842c36a54b2","9112f2bffece48e08c6d2287be204085",11385589,1,1,0,23,10,11,1
"9112f2bffece48e08c6d2287be204085","9112f2bffece48e08c6d2287be204085",11385589,1,0,1,24,11,11,0
"9112f2bffece48e08c6d2287be204085","56586aa865414f538729c7f7735d2bc6",11385589,1,3,0,25,11,12,1
"56586aa865414f538729c7f7735d2bc6","e2911e79efc2420eac45d9f671463d4b",11385589,1,-12,0,26,12,2,-10
"e2911e79efc2420eac45d9f671463d4b","56586aa865414f538729c7f7735d2bc6",11385589,1,12,0,27,2,12,10
"56586aa865414f538729c7f7735d2bc6","56586aa865414f538729c7f7735d2bc6",11385589,9,0,1,28,12,12,0
"56586aa865414f538729c7f7735d2bc6","b7f2b31585d94eb3bf86376714aa7070",11385589,1,2,0,33,12,13,1
"b7f2b31585d94eb3bf86376714aa7070","b7f2b31585d94eb3bf86376714aa7070",11385589,3,0,1,34,13,13,0
"b7f2b31585d94eb3bf86376714aa7070","3f1c815879794b929260d224becaff7e",11385589,1,2,0,37,13,14,1
"3f1c815879794b929260d224becaff7e","81c864a886d54a6b8ff85f7d736f4f95",11385589,1,2,0,38,14,15,1
"81c864a886d54a6b8ff85f7d736f4f95","5c5ceeee4562457ba6d41515aeebfbb1",11385589,1,4,0,39,15,17,2
"5c5ceeee4562457ba6d41515aeebfbb1","5c5ceeee4562457ba6d41515aeebfbb1",11385589,1,0,1,40,17,17,0
"5c5ceeee4562457ba6d41515aeebfbb1","9afd71a5298d4333b6849dfce1b9422c",11385589,1,3,0,41,17,18,1
"9afd71a5298d4333b6849dfce1b9422c","56586aa865414f538729c7f7735d2bc6",11385589,1,-13,0,42,18,12,-6
"56586aa865414f538729c7f7735d2bc6","9afd71a5298d4333b6849dfce1b9422c",11385589,1,13,0,43,12,18,6
"9afd71a5298d4333b6849dfce1b9422c","9afd71a5298d4333b6849dfce1b9422c",11385589,2,0,1,44,18,18,0
"9afd71a5298d4333b6849dfce1b9422c","b7719e26494940efa49512aedd0aac79",11385589,2,4,0,46,18,20,2
"b7719e26494940efa49512aedd0aac79","d4f45188d3c84a02ba08454e6403a818",11385589,3,5,0,47,20,24,4
"d4f45188d3c84a02ba08454e6403a818","d4c3b003e8274e429d2fa688d73fde6d",11385589,3,-2,0,48,24,22,-2
"d4c3b003e8274e429d2fa688d73fde6d","d4c3b003e8274e429d2fa688d73fde6d",11385589,1,0,1,49,22,22,0
"d4c3b003e8274e429d2fa688d73fde6d","b7719e26494940efa49512aedd0aac79",11385589,2,-3,0,50,22,20,-2
"d4c3b003e8274e429d2fa688d73fde6d","9afd71a5298d4333b6849dfce1b9422c",11385589,1,-7,0,53,22,18,-4
"b7719e26494940efa49512aedd0aac79","b7719e26494940efa49512aedd0aac79",11385589,1,0,1,58,20,20,0
"b7719e26494940efa49512aedd0aac79","afbf7250b99d47bea07172749483ca97",11385589,1,12,0,59,20,28,8
"afbf7250b99d47bea07172749483ca97","afbf7250b99d47bea07172749483ca97",11385589,1,0,1,60,28,28,0
"afbf7250b99d47bea07172749483ca97","4e51676dc72045d99c19b9fa7b22f8bc",11385589,1,3,0,61,28,29,1
"4e51676dc72045d99c19b9fa7b22f8bc","4e51676dc72045d99c19b9fa7b22f8bc",11385589,1,0,1,62,29,29,0
"4e51676dc72045d99c19b9fa7b22f8bc","51970cfa30e643e894e66ae85c8024cc",11385589,1,3,0,63,29,31,2
"51970cfa30e643e894e66ae85c8024cc","4e51676dc72045d99c19b9fa7b22f8bc",11385589,1,-3,0,64,31,29,-2
"4e51676dc72045d99c19b9fa7b22f8bc","c33c17be71ae4d588da7369472e5bb1b",11385589,1,9,0,65,29,34,5
"c33c17be71ae4d588da7369472e5bb1b","93679be414554a11b1893002f2229a93",11385589,1,3,0,66,34,35,1
"93679be414554a11b1893002f2229a93","c33c17be71ae4d588da7369472e5bb1b",11385589,1,-3,0,67,35,34,-1
"c33c17be71ae4d588da7369472e5bb1b","7040a13096d746ac84b8fac8d9752058",11385589,1,6,0,68,34,36,2
"7040a13096d746ac84b8fac8d9752058","93679be414554a11b1893002f2229a93",11385589,1,-3,0,69,36,35,-1
"93679be414554a11b1893002f2229a93","7040a13096d746ac84b8fac8d9752058",11385589,1,3,0,70,35,36,1
"7040a13096d746ac84b8fac8d9752058","9a0dc646f934470daf08c4b56ccf73db",11385589,1,3,0,71,36,37,1
"9a0dc646f934470daf08c4b56ccf73db","fc0e049d56024bc9a02c9a9c435c3df7",11385589,2,3,0,72,37,38,1
"fc0e049d56024bc9a02c9a9c435c3df7","9a0dc646f934470daf08c4b56ccf73db",11385589,1,-3,0,73,38,37,-1
"fc0e049d56024bc9a02c9a9c435c3df7","67a089198fcb4e1c8f2385786c2b296f",11385589,1,4,0,75,38,39,1
"67a089198fcb4e1c8f2385786c2b296f","64d48c6c9c7940639a932219a6c87198",11385589,2,1,0,76,39,40,1
"64d48c6c9c7940639a932219a6c87198","64d48c6c9c7940639a932219a6c87198",11385589,2,0,1,77,40,40,0
"64d48c6c9c7940639a932219a6c87198","b534b89233134e30a9b5645138bfa9ee",11385589,1,3,0,78,40,41,1
"b534b89233134e30a9b5645138bfa9ee","67a089198fcb4e1c8f2385786c2b296f",11385589,1,-4,0,79,41,39,-2
"67a089198fcb4e1c8f2385786c2b296f","6875d67fdd5f48168b62719df449bebd",11385589,1,8,0,80,39,45,6
"6875d67fdd5f48168b62719df449bebd","6875d67fdd5f48168b62719df449bebd",11385589,1,0,1,81,45,45,0
"6875d67fdd5f48168b62719df449bebd","0e37b720d23b4e7f8b313e79313fd107",11385589,1,-1,0,82,45,44,-1
"0e37b720d23b4e7f8b313e79313fd107","0e37b720d23b4e7f8b313e79313fd107",11385589,1,0,1,83,44,44,0
"0e37b720d23b4e7f8b313e79313fd107","b534b89233134e30a9b5645138bfa9ee",11385589,1,-3,0,84,44,41,-3
"6e13d61a7bdb44bca949c9f86fab3be5","67a089198fcb4e1c8f2385786c2b296f",11385589,1,-11,0,89,47,39,-8
"67a089198fcb4e1c8f2385786c2b296f","67a089198fcb4e1c8f2385786c2b296f",11385589,2,0,1,90,39,39,0
"64d48c6c9c7940639a932219a6c87198","56586aa865414f538729c7f7735d2bc6",11385589,1,-58,0,94,40,12,-28
"56586aa865414f538729c7f7735d2bc6","b534b89233134e30a9b5645138bfa9ee",11385589,1,61,0,99,12,41,29
"b534b89233134e30a9b5645138bfa9ee","6e13d61a7bdb44bca949c9f86fab3be5",11385589,3,7,0,100,41,47,6
"6e13d61a7bdb44bca949c9f86fab3be5","6e13d61a7bdb44bca949c9f86fab3be5",11385589,4,0,1,101,47,47,0
"6e13d61a7bdb44bca949c9f86fab3be5","195f78799f984cc2b06c48dfe36be751",11385589,1,2,0,102,47,49,2
"195f78799f984cc2b06c48dfe36be751","195f78799f984cc2b06c48dfe36be751",11385589,2,0,1,103,49,49,0
"195f78799f984cc2b06c48dfe36be751","d9c8d8c444a64dadbbb508652c721e17",11385589,1,-3,0,105,49,46,-3
"d9c8d8c444a64dadbbb508652c721e17","d0c74f735e024943943e40333d6d337f",11385589,2,6,0,106,46,51,5
"d0c74f735e024943943e40333d6d337f","d0c74f735e024943943e40333d6d337f",11385589,7,0,1,107,51,51,0
"d0c74f735e024943943e40333d6d337f","b534b89233134e30a9b5645138bfa9ee",11385589,1,-12,0,112,51,41,-10
"6e13d61a7bdb44bca949c9f86fab3be5","d9c8d8c444a64dadbbb508652c721e17",11385589,1,-1,0,114,47,46,-1
"d0c74f735e024943943e40333d6d337f","983f8ff320594b279a7f4a6fe132f9c5",11385589,1,2,0,118,51,53,2
"983f8ff320594b279a7f4a6fe132f9c5","983f8ff320594b279a7f4a6fe132f9c5",11385589,2,0,1,119,53,53,0
"983f8ff320594b279a7f4a6fe132f9c5","35adfa5d923046aebabfefd98f35ff05",11385589,1,1,0,121,53,54,1
"35adfa5d923046aebabfefd98f35ff05","35adfa5d923046aebabfefd98f35ff05",11385589,5,0,1,122,54,54,0
"35adfa5d923046aebabfefd98f35ff05","b6f8a98476224da1b40e555ececc7ed8",11385589,1,1,0,127,54,55,1
"b6f8a98476224da1b40e555ececc7ed8","b6f8a98476224da1b40e555ececc7ed8",11385589,2,0,1,128,55,55,0
"b6f8a98476224da1b40e555ececc7ed8","86e22cb5fe0e4b47a9489ecddf7ed78f",11385589,1,1,0,130,55,56,1
"86e22cb5fe0e4b47a9489ecddf7ed78f","86e22cb5fe0e4b47a9489ecddf7ed78f",11385589,2,0,1,131,56,56,0
"86e22cb5fe0e4b47a9489ecddf7ed78f","f924752d8a1149668870b1e7698486f7",11385589,1,-6,0,133,56,50,-6
"f924752d8a1149668870b1e7698486f7","a1f2f12debe5432fb7a70bcd12bacfb9",11385589,1,9,0,134,50,58,8
"a1f2f12debe5432fb7a70bcd12bacfb9","78f30e4dcac84e3cbea8b2cc6e0d62b3",11385589,2,1,0,135,58,59,1
"78f30e4dcac84e3cbea8b2cc6e0d62b3","a1f2f12debe5432fb7a70bcd12bacfb9",11385589,1,-1,0,136,59,58,-1
"a1f2f12debe5432fb7a70bcd12bacfb9","a1f2f12debe5432fb7a70bcd12bacfb9",11385589,31,0,1,137,58,58,0
"78f30e4dcac84e3cbea8b2cc6e0d62b3","78f30e4dcac84e3cbea8b2cc6e0d62b3",11385589,7,0,1,169,59,59,0
"78f30e4dcac84e3cbea8b2cc6e0d62b3","12aa6e1672ac4e7aa6449a7a8609cd72",11385589,1,-2,0,176,59,57,-2
"12aa6e1672ac4e7aa6449a7a8609cd72","a0a418b8540d479fa6e0f653b701da8b",11385589,1,8,0,177,57,64,7
"a0a418b8540d479fa6e0f653b701da8b","bc42d26810654ea9a1df1efe1e58c7d5",11385589,1,-1,0,178,64,63,-1
"bc42d26810654ea9a1df1efe1e58c7d5","4c943503763e4e349906eea3ed3c8e86",11385589,1,-2,0,179,63,61,-2
"4c943503763e4e349906eea3ed3c8e86","4c943503763e4e349906eea3ed3c8e86",11385589,1,0,1,180,61,61,0
"4c943503763e4e349906eea3ed3c8e86","bc42d26810654ea9a1df1efe1e58c7d5",11385589,1,2,0,181,61,63,2
"bc42d26810654ea9a1df1efe1e58c7d5","bc42d26810654ea9a1df1efe1e58c7d5",11385589,3,0,1,182,63,63,0
"bc42d26810654ea9a1df1efe1e58c7d5","a0a418b8540d479fa6e0f653b701da8b",11385589,1,1,0,185,63,64,1
"a0a418b8540d479fa6e0f653b701da8b","a0a418b8540d479fa6e0f653b701da8b",11385589,3,0,1,186,64,64,0
"a0a418b8540d479fa6e0f653b701da8b","309ccf3cc4fe429d9bfbaef53d3fa479",11385589,1,-4,0,189,64,60,-4
"309ccf3cc4fe429d9bfbaef53d3fa479","b534b89233134e30a9b5645138bfa9ee",11385589,1,-23,0,190,60,41,-19
"b534b89233134e30a9b5645138bfa9ee","d646286c8051419bbc2e31dd1db55ca8",11385589,1,33,0,191,41,67,26
"d646286c8051419bbc2e31dd1db55ca8","267f883678b24aed855fde42524975d9",11385589,1,4,0,192,67,71,4
"267f883678b24aed855fde42524975d9","267f883678b24aed855fde42524975d9",11385589,1,0,1,193,71,71,0
"267f883678b24aed855fde42524975d9","88fff56d0342490dbef9040750a20f6c",11385589,1,1,0,194,71,72,1
"88fff56d0342490dbef9040750a20f6c","88fff56d0342490dbef9040750a20f6c",11385589,1,0,1,195,72,72,0
"88fff56d0342490dbef9040750a20f6c","adb17b12b66c4a49a85fd34322f7df70",11385589,1,1,0,196,72,73,1
"adb17b12b66c4a49a85fd34322f7df70","adb17b12b66c4a49a85fd34322f7df70",11385589,1,0,1,197,73,73,0
"adb17b12b66c4a49a85fd34322f7df70","d646286c8051419bbc2e31dd1db55ca8",11385589,1,-6,0,198,73,67,-6
"d646286c8051419bbc2e31dd1db55ca8","a2becd407db34b189200a32546d9d569",11385589,3,9,0,199,67,75,8
"a2becd407db34b189200a32546d9d569","a2becd407db34b189200a32546d9d569",11385589,6,0,1,200,75,75,0
"a2becd407db34b189200a32546d9d569","d646286c8051419bbc2e31dd1db55ca8",11385589,2,-9,0,203,75,67,-8
"a2becd407db34b189200a32546d9d569","58c22b011d0f4c2ea6d13615edbb9eeb",11385589,1,2,0,210,75,77,2
"58c22b011d0f4c2ea6d13615edbb9eeb","58c22b011d0f4c2ea6d13615edbb9eeb",11385589,11,0,1,211,77,77,0
"58c22b011d0f4c2ea6d13615edbb9eeb","dd76e1861dc9461c830888729d091ee0",11385589,1,1,0,222,77,78,1
"dd76e1861dc9461c830888729d091ee0","dd76e1861dc9461c830888729d091ee0",11385589,8,0,1,223,78,78,0
"dd76e1861dc9461c830888729d091ee0","cd1d828f1a694b87913a7ea66c23803e",11385589,1,1,0,231,78,79,1
"cd1d828f1a694b87913a7ea66c23803e","cd1d828f1a694b87913a7ea66c23803e",11385589,2,0,1,232,79,79,0
"cd1d828f1a694b87913a7ea66c23803e","9176a3c2b4d2465fa8b0c67096c2a97e",11385589,1,1,0,234,79,80,1
"9176a3c2b4d2465fa8b0c67096c2a97e","9176a3c2b4d2465fa8b0c67096c2a97e",11385589,11,0,1,235,80,80,0
"9176a3c2b4d2465fa8b0c67096c2a97e","f8ec6445f7194e25b9101d4fbcb07a18",11385589,1,1,0,246,80,81,1
"f8ec6445f7194e25b9101d4fbcb07a18","f8ec6445f7194e25b9101d4fbcb07a18",11385589,2,0,1,247,81,81,0
"f8ec6445f7194e25b9101d4fbcb07a18","140d5b27b8574befad82c0a013b59dfa",11385589,1,-7,0,249,81,74,-7
"140d5b27b8574befad82c0a013b59dfa","d18a9ea32855445f8736581f5cb119ce",11385589,1,9,0,250,74,82,8
"d18a9ea32855445f8736581f5cb119ce","f564483cbd7a407681aa2fcca518cf5f",11385589,1,4,0,251,82,85,3
"f564483cbd7a407681aa2fcca518cf5f","f564483cbd7a407681aa2fcca518cf5f",11385589,1,0,1,252,85,85,0
"f564483cbd7a407681aa2fcca518cf5f","18fd01350bd5434ca636d59a599d768a",11385589,1,1,0,253,85,86,1
"18fd01350bd5434ca636d59a599d768a","18fd01350bd5434ca636d59a599d768a",11385589,8,0,1,254,86,86,0
"18fd01350bd5434ca636d59a599d768a","6a9f0ef185fb47f0937e29daa1c71ed5",11385589,1,5,0,262,86,90,4
"6a9f0ef185fb47f0937e29daa1c71ed5","ae5ac430ea254e708a6f5deaaf7464ae",11385589,1,-7,0,263,90,84,-6
"ae5ac430ea254e708a6f5deaaf7464ae","c681290961c94c4caf23b529d1ae6b9a",11385589,1,5,0,264,84,88,4
"c681290961c94c4caf23b529d1ae6b9a","c681290961c94c4caf23b529d1ae6b9a",11385589,1,0,1,265,88,88,0
"c681290961c94c4caf23b529d1ae6b9a","6a9f0ef185fb47f0937e29daa1c71ed5",11385589,1,2,0,266,88,90,2
"6a9f0ef185fb47f0937e29daa1c71ed5","6a9f0ef185fb47f0937e29daa1c71ed5",11385589,3,0,1,267,90,90,0
"6a9f0ef185fb47f0937e29daa1c71ed5","e20db35ced8544ddac5bc3839145e463",11385589,1,3,0,270,90,91,1
"e20db35ced8544ddac5bc3839145e463","d646286c8051419bbc2e31dd1db55ca8",11385589,1,-30,0,271,91,67,-24
"d646286c8051419bbc2e31dd1db55ca8","1febb706d7a34005ae8711ed49c76e64",11385589,1,33,0,272,67,94,27
"1febb706d7a34005ae8711ed49c76e64","1febb706d7a34005ae8711ed49c76e64",11385589,2,0,1,273,94,94,0
"1febb706d7a34005ae8711ed49c76e64","8f73ba6f5a0042f2850356ac38ac6f24",11385589,1,1,0,275,94,95,1
"8f73ba6f5a0042f2850356ac38ac6f24","8f73ba6f5a0042f2850356ac38ac6f24",11385589,5,0,1,276,95,95,0
"8f73ba6f5a0042f2850356ac38ac6f24","e2260b86653c46d7b14a41fb419dbf8c",11385589,1,1,0,281,95,96,1
"e2260b86653c46d7b14a41fb419dbf8c","e2260b86653c46d7b14a41fb419dbf8c",11385589,2,0,1,282,96,96,0
"e2260b86653c46d7b14a41fb419dbf8c","35eb641ad1d845bbba54915bce75a962",11385589,1,1,0,284,96,97,1
"35eb641ad1d845bbba54915bce75a962","35eb641ad1d845bbba54915bce75a962",11385589,5,0,1,285,97,97,0
"35eb641ad1d845bbba54915bce75a962","08be90ffbeea4795a138cd42ed8db56f",11385589,1,1,0,290,97,98,1
"08be90ffbeea4795a138cd42ed8db56f","08be90ffbeea4795a138cd42ed8db56f",11385589,5,0,1,291,98,98,0
"08be90ffbeea4795a138cd42ed8db56f","3007433c8f584dcbb5ac159c1c5f2be3",11385589,1,1,0,296,98,99,1
"3007433c8f584dcbb5ac159c1c5f2be3","3007433c8f584dcbb5ac159c1c5f2be3",11385589,5,0,1,297,99,99,0
"3007433c8f584dcbb5ac159c1c5f2be3","00ae5f0c51874a73a41ebea838d95682",11385589,1,3,0,302,99,101,2
"00ae5f0c51874a73a41ebea838d95682","e20db35ced8544ddac5bc3839145e463",11385589,2,-11,0,303,101,91,-10
"e20db35ced8544ddac5bc3839145e463","d391c8b6e56a43a7b654e9dee02d904b",11385589,2,13,0,304,91,103,12
"d391c8b6e56a43a7b654e9dee02d904b","00ae5f0c51874a73a41ebea838d95682",11385589,1,-2,0,305,103,101,-2
"00ae5f0c51874a73a41ebea838d95682","00ae5f0c51874a73a41ebea838d95682",11385589,4,0,1,306,101,101,0
"d391c8b6e56a43a7b654e9dee02d904b","e20db35ced8544ddac5bc3839145e463",11385589,1,-13,0,309,103,91,-12
"e20db35ced8544ddac5bc3839145e463","00ae5f0c51874a73a41ebea838d95682",11385589,1,11,0,310,91,101,10
"00ae5f0c51874a73a41ebea838d95682","d391c8b6e56a43a7b654e9dee02d904b",11385589,1,2,0,314,101,103,2
"d391c8b6e56a43a7b654e9dee02d904b","d391c8b6e56a43a7b654e9dee02d904b",11385589,15,0,1,315,103,103,0
"d391c8b6e56a43a7b654e9dee02d904b","6111116566fc4fd9abba409322bea245",11385589,1,1,0,330,103,104,1
"6111116566fc4fd9abba409322bea245","6111116566fc4fd9abba409322bea245",11385589,2,0,1,331,104,104,0
"6111116566fc4fd9abba409322bea245","a81b2235cb9c499eb9ea8ee0a8dd9725",11385589,1,1,0,333,104,105,1
"a81b2235cb9c499eb9ea8ee0a8dd9725","a81b2235cb9c499eb9ea8ee0a8dd9725",11385589,5,0,1,334,105,105,0
"a81b2235cb9c499eb9ea8ee0a8dd9725","2d4e0ab0ef3b4d73b82c72d4621a7579",11385589,1,1,0,339,105,106,1
"2d4e0ab0ef3b4d73b82c72d4621a7579","2d4e0ab0ef3b4d73b82c72d4621a7579",11385589,2,0,1,340,106,106,0
"2d4e0ab0ef3b4d73b82c72d4621a7579","8bdebf492ebd4e62b0d522e8ab5e5197",11385589,1,1,0,342,106,107,1
"8bdebf492ebd4e62b0d522e8ab5e5197","8bdebf492ebd4e62b0d522e8ab5e5197",11385589,2,0,1,343,107,107,0
"8bdebf492ebd4e62b0d522e8ab5e5197","73039f8c1eb9409cb4caee2cf968001e",11385589,1,-7,0,345,107,100,-7
"73039f8c1eb9409cb4caee2cf968001e","4280927ec4d643238aa49c32f9e06c6c",11385589,1,10,0,346,100,109,9
"4280927ec4d643238aa49c32f9e06c6c","4280927ec4d643238aa49c32f9e06c6c",11385589,1,0,1,347,109,109,0
"4280927ec4d643238aa49c32f9e06c6c","fc44e6a5f7654430af1227838224dceb",11385589,1,2,0,348,109,111,2
"fc44e6a5f7654430af1227838224dceb","fc44e6a5f7654430af1227838224dceb",11385589,2,0,1,349,111,111,0
"fc44e6a5f7654430af1227838224dceb","08111f75e22d409998cf8b85bd431f0a",11385589,1,-3,0,351,111,108,-3
"08111f75e22d409998cf8b85bd431f0a","a9ae0a3c070d455bb4369a8996313336",11385589,1,7,0,352,108,114,6
"a9ae0a3c070d455bb4369a8996313336","a9ae0a3c070d455bb4369a8996313336",11385589,1,0,1,353,114,114,0
"a9ae0a3c070d455bb4369a8996313336","71cec822bcff4f30a20e75dc63ef7b65",11385589,1,2,0,354,114,116,2
"71cec822bcff4f30a20e75dc63ef7b65","71cec822bcff4f30a20e75dc63ef7b65",11385589,1,0,1,355,116,116,0
"71cec822bcff4f30a20e75dc63ef7b65","37319e88176d4aefa91d7a9980dbae91",11385589,1,-4,0,356,116,112,-4
"37319e88176d4aefa91d7a9980dbae91","62bff51286ef4f348717a3cf6fe2318f",11385589,1,9,0,357,112,120,8
"62bff51286ef4f348717a3cf6fe2318f","62bff51286ef4f348717a3cf6fe2318f",11385589,4,0,1,358,120,120,0
"62bff51286ef4f348717a3cf6fe2318f","e20db35ced8544ddac5bc3839145e463",11385589,1,-33,0,362,120,91,-29
"e20db35ced8544ddac5bc3839145e463","779f9ddd1fd14d1e9e69f72219a1fdbd",11385589,1,36,0,363,91,121,30
"779f9ddd1fd14d1e9e69f72219a1fdbd","ae26e6cda8ad4a3f81bd347560d9579f",11385589,1,4,0,364,121,125,4
"ae26e6cda8ad4a3f81bd347560d9579f","ae26e6cda8ad4a3f81bd347560d9579f",11385589,3,0,1,365,125,125,0
"ae26e6cda8ad4a3f81bd347560d9579f","ee48df95832b4374aa273ceb27ec1315",11385589,1,1,0,368,125,126,1
"ee48df95832b4374aa273ceb27ec1315","ee48df95832b4374aa273ceb27ec1315",11385589,1,0,1,369,126,126,0
"ee48df95832b4374aa273ceb27ec1315","7a439da90b394756ad1777fc4c6dead5",11385589,1,1,0,370,126,127,1
"7a439da90b394756ad1777fc4c6dead5","7a439da90b394756ad1777fc4c6dead5",11385589,1,0,1,371,127,127,0
"7a439da90b394756ad1777fc4c6dead5","a8dd5213034441ac92724b4e83eb0bb2",11385589,1,3,0,372,127,129,2
"a8dd5213034441ac92724b4e83eb0bb2","779f9ddd1fd14d1e9e69f72219a1fdbd",11385589,3,-9,0,373,129,121,-8
"779f9ddd1fd14d1e9e69f72219a1fdbd","a8dd5213034441ac92724b4e83eb0bb2",11385589,3,9,0,374,121,129,8
"a8dd5213034441ac92724b4e83eb0bb2","a8dd5213034441ac92724b4e83eb0bb2",11385589,6,0,1,375,129,129,0
"a8dd5213034441ac92724b4e83eb0bb2","8115eab6556b45f5b415c3b8c26a12e5",11385589,1,2,0,385,129,131,2
"8115eab6556b45f5b415c3b8c26a12e5","8115eab6556b45f5b415c3b8c26a12e5",11385589,2,0,1,386,131,131,0
"8115eab6556b45f5b415c3b8c26a12e5","ec34b06efd844b46a4c4818ecdb9b8f4",11385589,1,1,0,388,131,132,1
"ec34b06efd844b46a4c4818ecdb9b8f4","ec34b06efd844b46a4c4818ecdb9b8f4",11385589,5,0,1,389,132,132,0
"ec34b06efd844b46a4c4818ecdb9b8f4","c2e1c2b9eac64109b343a088584b576b",11385589,1,1,0,394,132,133,1
"c2e1c2b9eac64109b343a088584b576b","c2e1c2b9eac64109b343a088584b576b",11385589,2,0,1,395,133,133,0
"c2e1c2b9eac64109b343a088584b576b","579338175e0b4bbb8ef3b712b5d8b54e",11385589,1,-5,0,397,133,128,-5
"579338175e0b4bbb8ef3b712b5d8b54e","8bc5795d6a984a3eace4e2811e52dd4f",11385589,1,8,0,398,128,135,7
"8bc5795d6a984a3eace4e2811e52dd4f","8bc5795d6a984a3eace4e2811e52dd4f",11385589,1,0,1,399,135,135,0
"8bc5795d6a984a3eace4e2811e52dd4f","b416d47c56a742199b5d7c7f19d6503a",11385589,1,-1,0,400,135,134,-1
"b416d47c56a742199b5d7c7f19d6503a","cd4532ad48034873ba8bce2aac0c9808",11385589,1,4,0,401,134,137,3
"cd4532ad48034873ba8bce2aac0c9808","cd4532ad48034873ba8bce2aac0c9808",11385589,1,0,1,402,137,137,0
"cd4532ad48034873ba8bce2aac0c9808","779f9ddd1fd14d1e9e69f72219a1fdbd",11385589,1,-19,0,403,137,121,-16
"779f9ddd1fd14d1e9e69f72219a1fdbd","df1de691dafe4549a18a4398ee9dfaf9",11385589,1,23,0,404,121,139,18
"df1de691dafe4549a18a4398ee9dfaf9","6c5ad271a44743479bfaea29b1db8d02",11385589,2,4,0,405,139,143,4
"6c5ad271a44743479bfaea29b1db8d02","df1de691dafe4549a18a4398ee9dfaf9",11385589,1,-4,0,406,143,139,-4
"6c5ad271a44743479bfaea29b1db8d02","83d311bed5374fee83d8d67a7d9d82dc",11385589,1,1,0,408,143,144,1
"83d311bed5374fee83d8d67a7d9d82dc","83d311bed5374fee83d8d67a7d9d82dc",11385589,1,0,1,409,144,144,0
"83d311bed5374fee83d8d67a7d9d82dc","402bba41861d43acb52a5abb89e8831e",11385589,1,1,0,410,144,145,1
"402bba41861d43acb52a5abb89e8831e","402bba41861d43acb52a5abb89e8831e",11385589,2,0,1,411,145,145,0
"402bba41861d43acb52a5abb89e8831e","8aae34f5ddbb4052a709b12e6b0d40fa",11385589,1,3,0,413,145,147,2
"8aae34f5ddbb4052a709b12e6b0d40fa","df1de691dafe4549a18a4398ee9dfaf9",11385589,1,-9,0,414,147,139,-8
"df1de691dafe4549a18a4398ee9dfaf9","8aae34f5ddbb4052a709b12e6b0d40fa",11385589,1,9,0,415,139,147,8
"8aae34f5ddbb4052a709b12e6b0d40fa","8aae34f5ddbb4052a709b12e6b0d40fa",11385589,2,0,1,416,147,147,0
"8aae34f5ddbb4052a709b12e6b0d40fa","645b3f0249f64f76af2e19eb4d0e55b7",11385589,1,2,0,418,147,149,2
"645b3f0249f64f76af2e19eb4d0e55b7","645b3f0249f64f76af2e19eb4d0e55b7",11385589,5,0,1,419,149,149,0
"645b3f0249f64f76af2e19eb4d0e55b7","7e7b8db5064d4369805ab370aac5ddfb",11385589,1,1,0,424,149,150,1
"7e7b8db5064d4369805ab370aac5ddfb","7e7b8db5064d4369805ab370aac5ddfb",11385589,5,0,1,425,150,150,0
"7e7b8db5064d4369805ab370aac5ddfb","8956d210ae7f41968fada86d4c979d6a",11385589,1,1,0,430,150,151,1
"8956d210ae7f41968fada86d4c979d6a","8956d210ae7f41968fada86d4c979d6a",11385589,2,0,1,431,151,151,0
"8956d210ae7f41968fada86d4c979d6a","f902b0f41b544d4dbf79664fd233648d",11385589,1,-5,0,433,151,146,-5
"f902b0f41b544d4dbf79664fd233648d","ae781e8b775e4ccd93bc800dad5c8376",11385589,1,8,0,434,146,153,7
"ae781e8b775e4ccd93bc800dad5c8376","ae781e8b775e4ccd93bc800dad5c8376",11385589,2,0,1,435,153,153,0
"ae781e8b775e4ccd93bc800dad5c8376","06882a8492d9499aa31555567f575ecb",11385589,1,1,0,437,153,154,1
"06882a8492d9499aa31555567f575ecb","06882a8492d9499aa31555567f575ecb",11385589,1,0,1,438,154,154,0
"06882a8492d9499aa31555567f575ecb","f293c508f409466a8f27ddd7d1e40b20",11385589,1,1,0,439,154,155,1
"f293c508f409466a8f27ddd7d1e40b20","f293c508f409466a8f27ddd7d1e40b20",11385589,2,0,1,440,155,155,0
"f293c508f409466a8f27ddd7d1e40b20","cc4ddef5bbbe48ebb605141b347c4ed1",11385589,1,1,0,442,155,156,1
"cc4ddef5bbbe48ebb605141b347c4ed1","cc4ddef5bbbe48ebb605141b347c4ed1",11385589,1,0,1,443,156,156,0
"cc4ddef5bbbe48ebb605141b347c4ed1","d313cec988a84645bee413e8d4724a4b",11385589,1,3,0,444,156,158,2
"d313cec988a84645bee413e8d4724a4b","f03480cf4eba413194d7af52fc0e7f28",11385589,1,-7,0,445,158,152,-6
"f03480cf4eba413194d7af52fc0e7f28","d313cec988a84645bee413e8d4724a4b",11385589,1,7,0,446,152,158,6
"d313cec988a84645bee413e8d4724a4b","d313cec988a84645bee413e8d4724a4b",11385589,3,0,1,447,158,158,0
"d313cec988a84645bee413e8d4724a4b","dc60696c76a74368a60f72246e47700d",11385589,1,1,0,450,158,159,1
"dc60696c76a74368a60f72246e47700d","dc60696c76a74368a60f72246e47700d",11385589,1,0,1,451,159,159,0
"dc60696c76a74368a60f72246e47700d","df1de691dafe4549a18a4398ee9dfaf9",11385589,1,-23,0,452,159,139,-20
"df1de691dafe4549a18a4398ee9dfaf9","78adeee1fa2c4fe0bc73f7bca9fcee86",11385589,1,26,0,453,139,160,21
"78adeee1fa2c4fe0bc73f7bca9fcee86","65202579580f4ad38d734b4ee39d22a8",11385589,5,5,0,454,160,164,4
"65202579580f4ad38d734b4ee39d22a8","65202579580f4ad38d734b4ee39d22a8",11385589,74,0,1,455,164,164,0
"65202579580f4ad38d734b4ee39d22a8","78adeee1fa2c4fe0bc73f7bca9fcee86",11385589,3,-5,0,461,164,160,-4
"65202579580f4ad38d734b4ee39d22a8","3cbcea2be0984e7dbd5a48195af10ce7",11385589,2,3,0,508,164,165,1
"3cbcea2be0984e7dbd5a48195af10ce7","78adeee1fa2c4fe0bc73f7bca9fcee86",11385589,2,-8,0,509,165,160,-5
"78adeee1fa2c4fe0bc73f7bca9fcee86","82e6285962b8400d9d6fc32436022a94",11385589,2,10,0,510,160,167,7
"82e6285962b8400d9d6fc32436022a94","a9ac840f098c4bd0a2ee896214ce29cd",11385589,3,3,0,511,167,168,1
"a9ac840f098c4bd0a2ee896214ce29cd","3cbcea2be0984e7dbd5a48195af10ce7",11385589,4,-5,0,512,168,165,-3
"3cbcea2be0984e7dbd5a48195af10ce7","a9ac840f098c4bd0a2ee896214ce29cd",11385589,3,5,0,513,165,168,3
"a9ac840f098c4bd0a2ee896214ce29cd","a9ac840f098c4bd0a2ee896214ce29cd",11385589,2,0,1,514,168,168,0
"3cbcea2be0984e7dbd5a48195af10ce7","82e6285962b8400d9d6fc32436022a94",11385589,2,2,0,516,165,167,2
"a9ac840f098c4bd0a2ee896214ce29cd","0c7262dff33c4087bc660ccf40f92f9c",11385589,5,4,0,520,168,169,1
"0c7262dff33c4087bc660ccf40f92f9c","b2275c3fad834f8d90737a2d9a6927d6",11385589,3,3,0,521,169,172,3
"b2275c3fad834f8d90737a2d9a6927d6","0c7262dff33c4087bc660ccf40f92f9c",11385589,2,-3,0,522,172,169,-3
"0c7262dff33c4087bc660ccf40f92f9c","a9ac840f098c4bd0a2ee896214ce29cd",11385589,3,-4,0,523,169,168,-1
"a9ac840f098c4bd0a2ee896214ce29cd","b2275c3fad834f8d90737a2d9a6927d6",11385589,1,7,0,526,168,172,4
"b2275c3fad834f8d90737a2d9a6927d6","a9ac840f098c4bd0a2ee896214ce29cd",11385589,1,-7,0,527,172,168,-4
"b2275c3fad834f8d90737a2d9a6927d6","b2275c3fad834f8d90737a2d9a6927d6",11385589,22,0,1,532,172,172,0
"b2275c3fad834f8d90737a2d9a6927d6","eb515a26030b41f8a82a1e6114420bad",11385589,1,1,0,554,172,173,1
"eb515a26030b41f8a82a1e6114420bad","eb515a26030b41f8a82a1e6114420bad",11385589,2,0,1,555,173,173,0
"eb515a26030b41f8a82a1e6114420bad","b42cc17b7de840f181a704558d0bc845",11385589,1,3,0,557,173,175,2
"b42cc17b7de840f181a704558d0bc845","0c7262dff33c4087bc660ccf40f92f9c",11385589,1,-7,0,558,175,169,-6
"0c7262dff33c4087bc660ccf40f92f9c","b42cc17b7de840f181a704558d0bc845",11385589,2,7,0,559,169,175,6
"b42cc17b7de840f181a704558d0bc845","b42cc17b7de840f181a704558d0bc845",11385589,5,0,1,560,175,175,0
"b42cc17b7de840f181a704558d0bc845","801f9e9135034f49bf5f8b4bdefedb41",11385589,1,2,0,565,175,177,2
"801f9e9135034f49bf5f8b4bdefedb41","801f9e9135034f49bf5f8b4bdefedb41",11385589,6,0,1,566,177,177,0
"801f9e9135034f49bf5f8b4bdefedb41","362fcb0699a14845ab29b2340093e528",11385589,1,-3,0,572,177,174,-3
"362fcb0699a14845ab29b2340093e528","ea38cc0e6e6e41edbabf210220808bf9",11385589,1,6,0,573,174,179,5
"ea38cc0e6e6e41edbabf210220808bf9","b87c552dd247427abe6ab5795b9c9d43",11385589,2,2,0,574,179,181,2
"b87c552dd247427abe6ab5795b9c9d43","ea38cc0e6e6e41edbabf210220808bf9",11385589,1,-2,0,575,181,179,-2
"b87c552dd247427abe6ab5795b9c9d43","b87c552dd247427abe6ab5795b9c9d43",11385589,7,0,1,577,181,181,0
"b87c552dd247427abe6ab5795b9c9d43","139b097acfca451689d80c9c6eebdf7b",11385589,3,-3,0,584,181,178,-3
"139b097acfca451689d80c9c6eebdf7b","30f660a1feb34582a739722532524f79",11385589,1,6,0,585,178,183,5
"30f660a1feb34582a739722532524f79","30f660a1feb34582a739722532524f79",11385589,5,0,1,586,183,183,0
"30f660a1feb34582a739722532524f79","2024b4885bd14338a39b7b509acbbd02",11385589,1,-1,0,591,183,182,-1
"2024b4885bd14338a39b7b509acbbd02","cf4c280bad6a43e6b131d8385ef9ef3f",11385589,1,3,0,592,182,184,2
"cf4c280bad6a43e6b131d8385ef9ef3f","b42cc17b7de840f181a704558d0bc845",11385589,1,-12,0,593,184,175,-9
"b42cc17b7de840f181a704558d0bc845","ea38cc0e6e6e41edbabf210220808bf9",11385589,2,5,0,594,175,179,4
"ea38cc0e6e6e41edbabf210220808bf9","362fcb0699a14845ab29b2340093e528",11385589,2,-6,0,595,179,174,-5
"362fcb0699a14845ab29b2340093e528","b87c552dd247427abe6ab5795b9c9d43",11385589,2,8,0,596,174,181,7
"139b097acfca451689d80c9c6eebdf7b","0c7262dff33c4087bc660ccf40f92f9c",11385589,1,-11,0,598,178,169,-9
"0c7262dff33c4087bc660ccf40f92f9c","0c7262dff33c4087bc660ccf40f92f9c",11385589,1,0,1,599,169,169,0
"0c7262dff33c4087bc660ccf40f92f9c","c3f63fe50d8e487c86bf8ef76c9cadd3",11385589,1,20,0,600,169,185,16
"c3f63fe50d8e487c86bf8ef76c9cadd3","c3f63fe50d8e487c86bf8ef76c9cadd3",11385589,1,0,1,601,185,185,0
"c3f63fe50d8e487c86bf8ef76c9cadd3","0c7262dff33c4087bc660ccf40f92f9c",11385589,1,-20,0,602,185,169,-16
"0c7262dff33c4087bc660ccf40f92f9c","c8e371568a0c4391b25796ae4e91952e",11385589,2,23,0,603,169,186,17
"c8e371568a0c4391b25796ae4e91952e","7d932b23e1c84326ae5aa4d3c0d813d1",11385589,1,2,0,604,186,188,2
"7d932b23e1c84326ae5aa4d3c0d813d1","7d932b23e1c84326ae5aa4d3c0d813d1",11385589,1,0,1,605,188,188,0
"7d932b23e1c84326ae5aa4d3c0d813d1","c8e371568a0c4391b25796ae4e91952e",11385589,1,-2,0,606,188,186,-2
"c8e371568a0c4391b25796ae4e91952e","ab11d94c6c8948ea90b88f19d2cd502b",11385589,4,5,0,607,186,190,4
"ab11d94c6c8948ea90b88f19d2cd502b","ab11d94c6c8948ea90b88f19d2cd502b",11385589,2,0,1,608,190,190,0
"ab11d94c6c8948ea90b88f19d2cd502b","f992451ed6ad4e68bb9e68ad6be7c4be",11385589,1,2,0,610,190,192,2
"f992451ed6ad4e68bb9e68ad6be7c4be","f992451ed6ad4e68bb9e68ad6be7c4be",11385589,1,0,1,611,192,192,0
"f992451ed6ad4e68bb9e68ad6be7c4be","6cd2dcaac46847d4a0bc53f296d90375",11385589,1,3,0,612,192,194,2
"6cd2dcaac46847d4a0bc53f296d90375","07b44a7a51e94c78b411c753fc39dab0",11385589,2,-6,0,613,194,189,-5
"07b44a7a51e94c78b411c753fc39dab0","6cd2dcaac46847d4a0bc53f296d90375",11385589,3,6,0,614,189,194,5
"6cd2dcaac46847d4a0bc53f296d90375","2d2580c9411c4972909db508d6956a58",11385589,1,2,0,615,194,196,2
"2d2580c9411c4972909db508d6956a58","2d2580c9411c4972909db508d6956a58",11385589,8,0,1,616,196,196,0
"2d2580c9411c4972909db508d6956a58","5bddb3d9ed264f3984702f048c7e5340",11385589,1,1,0,624,196,197,1
"5bddb3d9ed264f3984702f048c7e5340","5bddb3d9ed264f3984702f048c7e5340",11385589,2,0,1,625,197,197,0
"5bddb3d9ed264f3984702f048c7e5340","d5e8e2bd12a2466b9d6d90855f0eb079",11385589,1,1,0,627,197,198,1
"d5e8e2bd12a2466b9d6d90855f0eb079","d5e8e2bd12a2466b9d6d90855f0eb079",11385589,2,0,1,628,198,198,0
"d5e8e2bd12a2466b9d6d90855f0eb079","017d7ca8e0394b91aaadc9574df2202c",11385589,1,-5,0,630,198,193,-5
"017d7ca8e0394b91aaadc9574df2202c","54e8e9f0ea3e45c4bf3b8ac799ee31b1",11385589,1,8,0,631,193,200,7
"54e8e9f0ea3e45c4bf3b8ac799ee31b1","54e8e9f0ea3e45c4bf3b8ac799ee31b1",11385589,1,0,1,632,200,200,0
"54e8e9f0ea3e45c4bf3b8ac799ee31b1","c614a00911be4877a075f19315530fb0",11385589,1,1,0,633,200,201,1
"c614a00911be4877a075f19315530fb0","c614a00911be4877a075f19315530fb0",11385589,6,0,1,634,201,201,0
"c614a00911be4877a075f19315530fb0","a6c21bd8b95249c7972820a7a7d76aff",11385589,1,1,0,640,201,202,1
"a6c21bd8b95249c7972820a7a7d76aff","a6c21bd8b95249c7972820a7a7d76aff",11385589,1,0,1,641,202,202,0
"a6c21bd8b95249c7972820a7a7d76aff","c8e371568a0c4391b25796ae4e91952e",11385589,1,-19,0,642,202,186,-16
"ab11d94c6c8948ea90b88f19d2cd502b","c8e371568a0c4391b25796ae4e91952e",11385589,2,-5,0,644,190,186,-4
"c8e371568a0c4391b25796ae4e91952e","07b44a7a51e94c78b411c753fc39dab0",11385589,2,4,0,645,186,189,3
"6cd2dcaac46847d4a0bc53f296d90375","017d7ca8e0394b91aaadc9574df2202c",11385589,2,-1,0,647,194,193,-1
"017d7ca8e0394b91aaadc9574df2202c","bb329d880ab54120adaf203a693bb203",11385589,1,11,0,648,193,203,10
"bb329d880ab54120adaf203a693bb203","bb329d880ab54120adaf203a693bb203",11385589,1,0,1,649,203,203,0
"bb329d880ab54120adaf203a693bb203","f9170dd6bc6442b4acd832747609b09a",11385589,1,-4,0,650,203,199,-4
"f9170dd6bc6442b4acd832747609b09a","c8e371568a0c4391b25796ae4e91952e",11385589,1,-16,0,651,199,186,-13
"017d7ca8e0394b91aaadc9574df2202c","f9170dd6bc6442b4acd832747609b09a",11385589,2,7,0,657,193,199,6
"f9170dd6bc6442b4acd832747609b09a","334c2344009840079b1d0e1b7ce3d5a7",11385589,1,7,0,658,199,205,6
"334c2344009840079b1d0e1b7ce3d5a7","334c2344009840079b1d0e1b7ce3d5a7",11385589,1,0,1,659,205,205,0
"334c2344009840079b1d0e1b7ce3d5a7","c8e371568a0c4391b25796ae4e91952e",11385589,1,-23,0,660,205,186,-19
"c8e371568a0c4391b25796ae4e91952e","d7f13c8d63ec4e2aa673fbb9cf9c6933",11385589,1,26,0,661,186,206,20
"d7f13c8d63ec4e2aa673fbb9cf9c6933","7108f0e4c2584f1f9c471689ae4c885c",11385589,2,2,0,662,206,208,2
"7108f0e4c2584f1f9c471689ae4c885c","b9e80f77c3a44349863b19875725c384",11385589,2,-1,0,663,208,207,-1
"b9e80f77c3a44349863b19875725c384","b9e80f77c3a44349863b19875725c384",11385589,14,0,1,664,207,207,0
"b9e80f77c3a44349863b19875725c384","7108f0e4c2584f1f9c471689ae4c885c",11385589,3,1,0,678,207,208,1
"7108f0e4c2584f1f9c471689ae4c885c","7108f0e4c2584f1f9c471689ae4c885c",11385589,24,0,1,679,208,208,0
"7108f0e4c2584f1f9c471689ae4c885c","d7f13c8d63ec4e2aa673fbb9cf9c6933",11385589,2,-2,0,691,208,206,-2
"7108f0e4c2584f1f9c471689ae4c885c","09400e101c5d4b439cf9a26b03aae558",11385589,1,3,0,707,208,210,2
"09400e101c5d4b439cf9a26b03aae558","d7f13c8d63ec4e2aa673fbb9cf9c6933",11385589,1,-5,0,708,210,206,-4
"d7f13c8d63ec4e2aa673fbb9cf9c6933","3cbcea2be0984e7dbd5a48195af10ce7",11385589,1,-58,0,709,206,165,-41
"3cbcea2be0984e7dbd5a48195af10ce7","d7f13c8d63ec4e2aa673fbb9cf9c6933",11385589,1,58,0,713,165,206,41
"d7f13c8d63ec4e2aa673fbb9cf9c6933","09400e101c5d4b439cf9a26b03aae558",11385589,2,5,0,714,206,210,4
"09400e101c5d4b439cf9a26b03aae558","09400e101c5d4b439cf9a26b03aae558",11385589,2,0,1,715,210,210,0
"09400e101c5d4b439cf9a26b03aae558","a88efa7e50ce47159810ab553afa6d3a",11385589,1,2,0,717,210,212,2
"a88efa7e50ce47159810ab553afa6d3a","a88efa7e50ce47159810ab553afa6d3a",11385589,5,0,1,718,212,212,0
"a88efa7e50ce47159810ab553afa6d3a","a875096404ef4a9984b62d74cda916f9",11385589,1,-3,0,723,212,209,-3
"a875096404ef4a9984b62d74cda916f9","be502a7a43c44bf7b682698de79d9369",11385589,1,6,0,724,209,214,5
"be502a7a43c44bf7b682698de79d9369","f7fb1952f56b4189b86a9f8b7862d2b8",11385589,2,1,0,725,214,215,1
"f7fb1952f56b4189b86a9f8b7862d2b8","be502a7a43c44bf7b682698de79d9369",11385589,1,-1,0,726,215,214,-1
"f7fb1952f56b4189b86a9f8b7862d2b8","f7fb1952f56b4189b86a9f8b7862d2b8",11385589,11,0,1,728,215,215,0
"f7fb1952f56b4189b86a9f8b7862d2b8","b860ee85d8bc4a2f97958cfb71be3533",11385589,1,1,0,739,215,216,1
"b860ee85d8bc4a2f97958cfb71be3533","b860ee85d8bc4a2f97958cfb71be3533",11385589,2,0,1,740,216,216,0
"b860ee85d8bc4a2f97958cfb71be3533","ec341f459285443b8361f7f15638ff08",11385589,1,-3,0,742,216,213,-3
"ec341f459285443b8361f7f15638ff08","363837c182e04711840d896ae1e0339c",11385589,2,6,0,743,213,218,5
"363837c182e04711840d896ae1e0339c","363837c182e04711840d896ae1e0339c",11385589,12,0,1,744,218,218,0
"363837c182e04711840d896ae1e0339c","01b2051f8941460d89945e3b02d1ce78",11385589,2,-1,0,756,218,217,-1
"01b2051f8941460d89945e3b02d1ce78","91125ca626c5470eb145501f8c37f8db",11385589,1,4,0,757,217,220,3
"91125ca626c5470eb145501f8c37f8db","91125ca626c5470eb145501f8c37f8db",11385589,1,0,1,758,220,220,0
"91125ca626c5470eb145501f8c37f8db","d7f13c8d63ec4e2aa673fbb9cf9c6933",11385589,1,-18,0,759,220,206,-14
"d7f13c8d63ec4e2aa673fbb9cf9c6933","1c6721b1f63f4d30ba7746ea8af02a52",11385589,2,21,0,760,206,221,15
"1c6721b1f63f4d30ba7746ea8af02a52","77ecef8eff6b4a2caea7707669bf7475",11385589,4,1,0,761,221,222,1
"77ecef8eff6b4a2caea7707669bf7475","77ecef8eff6b4a2caea7707669bf7475",11385589,16,0,1,762,222,222,0
"77ecef8eff6b4a2caea7707669bf7475","1c6721b1f63f4d30ba7746ea8af02a52",11385589,3,-1,0,775,222,221,-1
"1c6721b1f63f4d30ba7746ea8af02a52","8b9ae98743bd4d4a8a87dff1c1244211",11385589,2,7,0,781,221,227,6
"8b9ae98743bd4d4a8a87dff1c1244211","d03cb855c70044cf8c35d9ec0de696e3",11385589,1,-3,0,782,227,224,-3
"d03cb855c70044cf8c35d9ec0de696e3","d03cb855c70044cf8c35d9ec0de696e3",11385589,3,0,1,783,224,224,0
"d03cb855c70044cf8c35d9ec0de696e3","a49a937d6896486d9a5396654abcf2e1",11385589,1,2,0,786,224,226,2
"a49a937d6896486d9a5396654abcf2e1","a49a937d6896486d9a5396654abcf2e1",11385589,1,0,1,787,226,226,0
"a49a937d6896486d9a5396654abcf2e1","8b9ae98743bd4d4a8a87dff1c1244211",11385589,1,1,0,788,226,227,1
"8b9ae98743bd4d4a8a87dff1c1244211","8b9ae98743bd4d4a8a87dff1c1244211",11385589,26,0,1,789,227,227,0
"8b9ae98743bd4d4a8a87dff1c1244211","2ab1535aac1346ba8801535bf729ef37",11385589,3,3,0,815,227,229,2
"2ab1535aac1346ba8801535bf729ef37","f7906d6f59b9489a91d2ef40db5a474d",11385589,3,-7,0,816,229,223,-6
"f7906d6f59b9489a91d2ef40db5a474d","2ab1535aac1346ba8801535bf729ef37",11385589,1,7,0,817,223,229,6
"2ab1535aac1346ba8801535bf729ef37","2ab1535aac1346ba8801535bf729ef37",11385589,6,0,1,818,229,229,0
"2ab1535aac1346ba8801535bf729ef37","a4f40fb48a8542c8949bae1f002cd9bc",11385589,1,2,0,824,229,231,2
"a4f40fb48a8542c8949bae1f002cd9bc","a4f40fb48a8542c8949bae1f002cd9bc",11385589,2,0,1,825,231,231,0
"a4f40fb48a8542c8949bae1f002cd9bc","8972c23e32044edb8a78fa1eed4e5947",11385589,1,1,0,827,231,232,1
"8972c23e32044edb8a78fa1eed4e5947","8972c23e32044edb8a78fa1eed4e5947",11385589,1,0,1,828,232,232,0
"8972c23e32044edb8a78fa1eed4e5947","92feb4a40f8344d38b6f722e42a53295",11385589,1,1,0,829,232,233,1
"92feb4a40f8344d38b6f722e42a53295","92feb4a40f8344d38b6f722e42a53295",11385589,2,0,1,830,233,233,0
"92feb4a40f8344d38b6f722e42a53295","5152833676bf4c6cb317060be10f68db",11385589,1,-5,0,832,233,228,-5
"5152833676bf4c6cb317060be10f68db","ca3e28f290354c08aefe5b0f769604e6",11385589,1,8,0,833,228,235,7
"ca3e28f290354c08aefe5b0f769604e6","ca3e28f290354c08aefe5b0f769604e6",11385589,4,0,1,834,235,235,0
"ca3e28f290354c08aefe5b0f769604e6","79a35eea833e4c2c9d22fc53c3c6445c",11385589,1,1,0,838,235,236,1
"79a35eea833e4c2c9d22fc53c3c6445c","79a35eea833e4c2c9d22fc53c3c6445c",11385589,4,0,1,839,236,236,0
"79a35eea833e4c2c9d22fc53c3c6445c","8f68228b1518449e9615cdafee41a2bd",11385589,1,1,0,843,236,237,1
"8f68228b1518449e9615cdafee41a2bd","8f68228b1518449e9615cdafee41a2bd",11385589,1,0,1,844,237,237,0
"8f68228b1518449e9615cdafee41a2bd","cab89fa5c3ed45a5aa550fc0352d6a42",11385589,1,1,0,845,237,238,1
"cab89fa5c3ed45a5aa550fc0352d6a42","cab89fa5c3ed45a5aa550fc0352d6a42",11385589,3,0,1,846,238,238,0
"cab89fa5c3ed45a5aa550fc0352d6a42","1c6721b1f63f4d30ba7746ea8af02a52",11385589,1,-20,0,849,238,221,-17
"1c6721b1f63f4d30ba7746ea8af02a52","d03cb855c70044cf8c35d9ec0de696e3",11385589,1,4,0,852,221,224,3
"d03cb855c70044cf8c35d9ec0de696e3","8b9ae98743bd4d4a8a87dff1c1244211",11385589,1,3,0,853,224,227,3
"f7906d6f59b9489a91d2ef40db5a474d","5152833676bf4c6cb317060be10f68db",11385589,2,6,0,856,223,228,5
"5152833676bf4c6cb317060be10f68db","66d4fad4f1cf4b46be0750a99ad7a35a",11385589,1,12,0,857,228,239,11
"66d4fad4f1cf4b46be0750a99ad7a35a","66d4fad4f1cf4b46be0750a99ad7a35a",11385589,1,0,1,858,239,239,0
"66d4fad4f1cf4b46be0750a99ad7a35a","0b04c8e2f86d48c7aeb7e225819cd32b",11385589,1,-5,0,859,239,234,-5
"0b04c8e2f86d48c7aeb7e225819cd32b","1c6721b1f63f4d30ba7746ea8af02a52",11385589,2,-16,0,860,234,221,-13
"1c6721b1f63f4d30ba7746ea8af02a52","2ae94c0cea4d480a9d5dca8fb1d7b542",11385589,4,27,0,861,221,242,21
"2ae94c0cea4d480a9d5dca8fb1d7b542","1ebf23f9d994469a85206e4c7b1bf5f5",11385589,3,3,0,862,242,245,3
"1ebf23f9d994469a85206e4c7b1bf5f5","1c6721b1f63f4d30ba7746ea8af02a52",11385589,1,-30,0,863,245,221,-24
"2ae94c0cea4d480a9d5dca8fb1d7b542","f53da5fd9bfe412da4b80d4742563b6c",11385589,1,-3,0,865,242,241,-1
"f53da5fd9bfe412da4b80d4742563b6c","f53da5fd9bfe412da4b80d4742563b6c",11385589,1,0,1,866,241,241,0
"f53da5fd9bfe412da4b80d4742563b6c","1c6721b1f63f4d30ba7746ea8af02a52",11385589,1,-24,0,867,241,221,-20
"1ebf23f9d994469a85206e4c7b1bf5f5","78adeee1fa2c4fe0bc73f7bca9fcee86",11385589,1,-117,0,870,245,160,-85
"82e6285962b8400d9d6fc32436022a94","3cbcea2be0984e7dbd5a48195af10ce7",11385589,1,-2,0,902,167,165,-2
"139b097acfca451689d80c9c6eebdf7b","2024b4885bd14338a39b7b509acbbd02",11385589,1,5,0,913,178,182,4
"2024b4885bd14338a39b7b509acbbd02","c8e371568a0c4391b25796ae4e91952e",11385589,1,7,0,914,182,186,4
"c8e371568a0c4391b25796ae4e91952e","0c7262dff33c4087bc660ccf40f92f9c",11385589,1,-23,0,915,186,169,-17
"ab11d94c6c8948ea90b88f19d2cd502b","6cd2dcaac46847d4a0bc53f296d90375",11385589,1,5,0,918,190,194,4
"07b44a7a51e94c78b411c753fc39dab0","017d7ca8e0394b91aaadc9574df2202c",11385589,1,5,0,920,189,193,4
"f9170dd6bc6442b4acd832747609b09a","d7f13c8d63ec4e2aa673fbb9cf9c6933",11385589,1,10,0,922,199,206,7
"d7f13c8d63ec4e2aa673fbb9cf9c6933","c8e371568a0c4391b25796ae4e91952e",11385589,1,-26,0,923,206,186,-20
"c8e371568a0c4391b25796ae4e91952e","b9e80f77c3a44349863b19875725c384",11385589,1,27,0,924,186,207,21
"09400e101c5d4b439cf9a26b03aae558","be502a7a43c44bf7b682698de79d9369",11385589,1,5,0,928,210,214,4
"be502a7a43c44bf7b682698de79d9369","a875096404ef4a9984b62d74cda916f9",11385589,1,-6,0,929,214,209,-5
"a875096404ef4a9984b62d74cda916f9","f7fb1952f56b4189b86a9f8b7862d2b8",11385589,1,7,0,930,209,215,6
"f7fb1952f56b4189b86a9f8b7862d2b8","ec341f459285443b8361f7f15638ff08",11385589,1,-2,0,931,215,213,-2
"01b2051f8941460d89945e3b02d1ce78","d7f13c8d63ec4e2aa673fbb9cf9c6933",11385589,1,-14,0,934,217,206,-11
"77ecef8eff6b4a2caea7707669bf7475","d03cb855c70044cf8c35d9ec0de696e3",11385589,1,3,0,937,222,224,2
"d03cb855c70044cf8c35d9ec0de696e3","1c6721b1f63f4d30ba7746ea8af02a52",11385589,1,-4,0,938,224,221,-3
"5152833676bf4c6cb317060be10f68db","0b04c8e2f86d48c7aeb7e225819cd32b",11385589,1,7,0,943,228,234,6
"1ebf23f9d994469a85206e4c7b1bf5f5","1ebf23f9d994469a85206e4c7b1bf5f5",11385589,11,0,1,947,245,245,0
"1ebf23f9d994469a85206e4c7b1bf5f5","85ae675b83e8422da842cfd25596af99",11385589,1,1,0,958,245,246,1
"85ae675b83e8422da842cfd25596af99","85ae675b83e8422da842cfd25596af99",11385589,1,0,1,959,246,246,0
"85ae675b83e8422da842cfd25596af99","fa235f0f364d47e4ae1c87f47bf8e6ba",11385589,1,8,0,960,246,252,6
"fa235f0f364d47e4ae1c87f47bf8e6ba","2ae94c0cea4d480a9d5dca8fb1d7b542",11385589,1,-12,0,961,252,242,-10
"2ae94c0cea4d480a9d5dca8fb1d7b542","fa235f0f364d47e4ae1c87f47bf8e6ba",11385589,1,12,0,962,242,252,10
"fa235f0f364d47e4ae1c87f47bf8e6ba","fa235f0f364d47e4ae1c87f47bf8e6ba",11385589,7,0,1,963,252,252,0
"fa235f0f364d47e4ae1c87f47bf8e6ba","79f7845465cc4ed19d8e4f1429541be0",11385589,1,2,0,970,252,254,2
"79f7845465cc4ed19d8e4f1429541be0","79f7845465cc4ed19d8e4f1429541be0",11385589,2,0,1,971,254,254,0
"79f7845465cc4ed19d8e4f1429541be0","00f61990949545828dd12f1303d47504",11385589,1,3,0,973,254,256,2
"00f61990949545828dd12f1303d47504","6e83e23f56544a19b94067c1c558d9c0",11385589,1,-11,0,974,256,247,-9
"6e83e23f56544a19b94067c1c558d9c0","00f61990949545828dd12f1303d47504",11385589,1,11,0,975,247,256,9
"00f61990949545828dd12f1303d47504","00f61990949545828dd12f1303d47504",11385589,3,0,1,976,256,256,0
"00f61990949545828dd12f1303d47504","ead7bb4b64e247d2ae632ab8a296b091",11385589,1,2,0,979,256,258,2
"ead7bb4b64e247d2ae632ab8a296b091","ead7bb4b64e247d2ae632ab8a296b091",11385589,2,0,1,980,258,258,0
"ead7bb4b64e247d2ae632ab8a296b091","41b0048dde734bb280bac6116baa8e27",11385589,1,1,0,982,258,259,1
"41b0048dde734bb280bac6116baa8e27","41b0048dde734bb280bac6116baa8e27",11385589,2,0,1,983,259,259,0
"41b0048dde734bb280bac6116baa8e27","b2389297ba624efebda5a6e711d70572",11385589,1,-2,0,985,259,257,-2
"b2389297ba624efebda5a6e711d70572","2ae94c0cea4d480a9d5dca8fb1d7b542",11385589,1,-18,0,986,257,242,-15
"2ae94c0cea4d480a9d5dca8fb1d7b542","00f61990949545828dd12f1303d47504",11385589,1,17,0,987,242,256,14
"00f61990949545828dd12f1303d47504","d989ebcfc12a4b669f0100dc1aa14f1e",11385589,1,-1,0,988,256,255,-1
"d989ebcfc12a4b669f0100dc1aa14f1e","b41c5a094a604ee0915327da5cc0beb7",11385589,1,5,0,989,255,260,5
"b41c5a094a604ee0915327da5cc0beb7","b41c5a094a604ee0915327da5cc0beb7",11385589,2,0,1,990,260,260,0
"b41c5a094a604ee0915327da5cc0beb7","d546341988904f069cfa86b21457d9d9",11385589,1,-10,0,992,260,251,-9
"d546341988904f069cfa86b21457d9d9","28c171777c52431ab6b925073bd63d46",11385589,1,15,0,993,251,264,13
"28c171777c52431ab6b925073bd63d46","28c171777c52431ab6b925073bd63d46",11385589,7,0,1,1000,264,264,0
"28c171777c52431ab6b925073bd63d46","ac160db940cb49ae8579162b1d52bb5d",11385589,1,2,0,1001,264,266,2
"ac160db940cb49ae8579162b1d52bb5d","ac160db940cb49ae8579162b1d52bb5d",11385589,7,0,1,1002,266,266,0
"ac160db940cb49ae8579162b1d52bb5d","d989ebcfc12a4b669f0100dc1aa14f1e",11385589,1,-12,0,1009,266,255,-11
"d989ebcfc12a4b669f0100dc1aa14f1e","44240778a97c4af0937817499b75707b",11385589,1,16,0,1010,255,269,14
"44240778a97c4af0937817499b75707b","44240778a97c4af0937817499b75707b",11385589,2,0,1,1011,269,269,0
"44240778a97c4af0937817499b75707b","7aa76d3e993840d8805f097cbdbcd44b",11385589,1,-9,0,1013,269,261,-8
"7aa76d3e993840d8805f097cbdbcd44b","865a4d3b43374da7944dc7d397f566d9",11385589,1,12,0,1014,261,271,10
"865a4d3b43374da7944dc7d397f566d9","865a4d3b43374da7944dc7d397f566d9",11385589,1,0,1,1015,271,271,0
"865a4d3b43374da7944dc7d397f566d9","0d987bed3ffa4ed0b9a2e62e97b7b30f",11385589,1,3,0,1016,271,272,1
"0d987bed3ffa4ed0b9a2e62e97b7b30f","2ae94c0cea4d480a9d5dca8fb1d7b542",11385589,1,-38,0,1017,272,242,-30
"2ae94c0cea4d480a9d5dca8fb1d7b542","0d987bed3ffa4ed0b9a2e62e97b7b30f",11385589,3,38,0,1018,242,272,30
"0d987bed3ffa4ed0b9a2e62e97b7b30f","82ae07bc0c9b4570a41799290d1ef399",11385589,1,4,0,1019,272,275,3
"82ae07bc0c9b4570a41799290d1ef399","bb5a47f5ea01454a8b79455422d3b9da",11385589,4,6,0,1020,275,280,5
"bb5a47f5ea01454a8b79455422d3b9da","bb5a47f5ea01454a8b79455422d3b9da",11385589,102,0,1,1021,280,280,0
"bb5a47f5ea01454a8b79455422d3b9da","bc5524e78a8544e2ae2fdc2f3462bbec",11385589,3,-1,0,1028,280,279,-1
"bc5524e78a8544e2ae2fdc2f3462bbec","82ae07bc0c9b4570a41799290d1ef399",11385589,3,-5,0,1029,279,275,-4
"82ae07bc0c9b4570a41799290d1ef399","2ae94c0cea4d480a9d5dca8fb1d7b542",11385589,1,-42,0,1030,275,242,-33
"0d987bed3ffa4ed0b9a2e62e97b7b30f","7028800abe7d4e27b613d1d6cbe26bf7",11385589,1,-8,0,1032,272,267,-5
"7028800abe7d4e27b613d1d6cbe26bf7","7aa76d3e993840d8805f097cbdbcd44b",11385589,1,-7,0,1033,267,261,-6
"7aa76d3e993840d8805f097cbdbcd44b","d989ebcfc12a4b669f0100dc1aa14f1e",11385589,1,-7,0,1034,261,255,-6
"d989ebcfc12a4b669f0100dc1aa14f1e","7aa76d3e993840d8805f097cbdbcd44b",11385589,1,7,0,1035,255,261,6
"7aa76d3e993840d8805f097cbdbcd44b","2ae94c0cea4d480a9d5dca8fb1d7b542",11385589,1,-23,0,1036,261,242,-19
"0d987bed3ffa4ed0b9a2e62e97b7b30f","0d987bed3ffa4ed0b9a2e62e97b7b30f",11385589,1,0,1,1038,272,272,0
"0d987bed3ffa4ed0b9a2e62e97b7b30f","bb5a47f5ea01454a8b79455422d3b9da",11385589,4,10,0,1039,272,280,8
"bb5a47f5ea01454a8b79455422d3b9da","82ae07bc0c9b4570a41799290d1ef399",11385589,1,-6,0,1046,280,275,-5
"bb5a47f5ea01454a8b79455422d3b9da","0d987bed3ffa4ed0b9a2e62e97b7b30f",11385589,4,-10,0,1120,280,272,-8
"0d987bed3ffa4ed0b9a2e62e97b7b30f","94cecc3f1e7d484b8e068e79241dfd73",11385589,3,13,0,1121,272,281,9
"94cecc3f1e7d484b8e068e79241dfd73","a37477c4e4c14169ad44b06b493007f6",11385589,3,2,0,1122,281,283,2
"a37477c4e4c14169ad44b06b493007f6","94cecc3f1e7d484b8e068e79241dfd73",11385589,3,-2,0,1123,283,281,-2
"94cecc3f1e7d484b8e068e79241dfd73","fab84b4fab5940efb4ea868ef8d09396",11385589,4,5,0,1124,281,284,3
"fab84b4fab5940efb4ea868ef8d09396","fab84b4fab5940efb4ea868ef8d09396",11385589,2,0,1,1125,284,284,0
"fab84b4fab5940efb4ea868ef8d09396","4a29443515bb404cb8924e1c60a63b73",11385589,2,4,0,1126,284,285,1
"4a29443515bb404cb8924e1c60a63b73","208c9b2796c944db8dacaa96082520ea",11385589,2,3,0,1127,285,288,3
"208c9b2796c944db8dacaa96082520ea","0d987bed3ffa4ed0b9a2e62e97b7b30f",11385589,1,-25,0,1128,288,272,-16
"a37477c4e4c14169ad44b06b493007f6","0d987bed3ffa4ed0b9a2e62e97b7b30f",11385589,1,-15,0,1151,283,272,-11
"fab84b4fab5940efb4ea868ef8d09396","94cecc3f1e7d484b8e068e79241dfd73",11385589,1,-5,0,1165,284,281,-3
"fab84b4fab5940efb4ea868ef8d09396","a37477c4e4c14169ad44b06b493007f6",11385589,1,-3,0,1167,284,283,-1
"208c9b2796c944db8dacaa96082520ea","208c9b2796c944db8dacaa96082520ea",11385589,1,0,1,1173,288,288,0
"208c9b2796c944db8dacaa96082520ea","4a29443515bb404cb8924e1c60a63b73",11385589,1,-3,0,1174,288,285,-3
"4a29443515bb404cb8924e1c60a63b73","7669a956527947d0add87455277e80b4",11385589,1,7,0,1175,285,291,6
"7669a956527947d0add87455277e80b4","7669a956527947d0add87455277e80b4",11385589,1,0,1,1176,291,291,0
"7669a956527947d0add87455277e80b4","869e967078f04da18dd0b0b9389a7424",11385589,1,3,0,1177,291,293,2
"869e967078f04da18dd0b0b9389a7424","6a9a3b5bde4a48daa896fe8c06eca56f",11385589,1,-5,0,1178,293,289,-4
"6a9a3b5bde4a48daa896fe8c06eca56f","869e967078f04da18dd0b0b9389a7424",11385589,1,5,0,1179,289,293,4
"869e967078f04da18dd0b0b9389a7424","869e967078f04da18dd0b0b9389a7424",11385589,3,0,1,1180,293,293,0
"869e967078f04da18dd0b0b9389a7424","51ab6291537748fab90d519aa09889d6",11385589,1,2,0,1183,293,295,2
"51ab6291537748fab90d519aa09889d6","51ab6291537748fab90d519aa09889d6",11385589,5,0,1,1184,295,295,0
"51ab6291537748fab90d519aa09889d6","34a6e49023fc4465bd5ca604330bbd1c",11385589,1,-3,0,1189,295,292,-3
"34a6e49023fc4465bd5ca604330bbd1c","4a29443515bb404cb8924e1c60a63b73",11385589,1,-9,0,1190,292,285,-7
"4a29443515bb404cb8924e1c60a63b73","ba0e59461bfb4a44b7b1c28a01f8d3b3",11385589,1,18,0,1191,285,299,14
"ba0e59461bfb4a44b7b1c28a01f8d3b3","21592f2a9e9c4b2f8c66ec5dbcbf6a2b",11385589,1,-4,0,1192,299,296,-3
"21592f2a9e9c4b2f8c66ec5dbcbf6a2b","ba0e59461bfb4a44b7b1c28a01f8d3b3",11385589,1,4,0,1193,296,299,3
"ba0e59461bfb4a44b7b1c28a01f8d3b3","0e0b36e731a645e7b1b8a88f5031ca38",11385589,1,2,0,1194,299,301,2
"0e0b36e731a645e7b1b8a88f5031ca38","0e0b36e731a645e7b1b8a88f5031ca38",11385589,9,0,1,1195,301,301,0
"0e0b36e731a645e7b1b8a88f5031ca38","a66a144637284c21afc6de17fea4bfb8",11385589,1,1,0,1204,301,302,1
"a66a144637284c21afc6de17fea4bfb8","a66a144637284c21afc6de17fea4bfb8",11385589,2,0,1,1205,302,302,0
"a66a144637284c21afc6de17fea4bfb8","7646a919d7e64fa990bca9b024ff089d",11385589,1,-4,0,1207,302,298,-4
"7646a919d7e64fa990bca9b024ff089d","e390b575229748ea8aac9364efe2bf00",11385589,1,7,0,1208,298,304,6
"e390b575229748ea8aac9364efe2bf00","e390b575229748ea8aac9364efe2bf00",11385589,1,0,1,1209,304,304,0
"e390b575229748ea8aac9364efe2bf00","4a29443515bb404cb8924e1c60a63b73",11385589,1,-24,0,1210,304,285,-19
"4a29443515bb404cb8924e1c60a63b73","3434c10e561d488a914e0f7d71907abd",11385589,1,27,0,1211,285,305,20
"3434c10e561d488a914e0f7d71907abd","53e7e900392747ccad52e711ab0f80d8",11385589,1,2,0,1212,305,307,2
"53e7e900392747ccad52e711ab0f80d8","53e7e900392747ccad52e711ab0f80d8",11385589,4,0,1,1213,307,307,0
"53e7e900392747ccad52e711ab0f80d8","3434c10e561d488a914e0f7d71907abd",11385589,1,-2,0,1217,307,305,-2
"3434c10e561d488a914e0f7d71907abd","130acc2aeb0448fdbb2de63bc5cebe5b",11385589,1,5,0,1218,305,309,4
"130acc2aeb0448fdbb2de63bc5cebe5b","9c062b3251034ebe90f5054e2a3b5120",11385589,1,2,0,1219,309,311,2
"9c062b3251034ebe90f5054e2a3b5120","9c062b3251034ebe90f5054e2a3b5120",11385589,2,0,1,1220,311,311,0
"9c062b3251034ebe90f5054e2a3b5120","ea859f8207e44537889daeaba13ac2e8",11385589,1,1,0,1222,311,312,1
"ea859f8207e44537889daeaba13ac2e8","ea859f8207e44537889daeaba13ac2e8",11385589,1,0,1,1223,312,312,0
"ea859f8207e44537889daeaba13ac2e8","56d94971a7a94257aa330183a8ebd0ea",11385589,1,1,0,1224,312,313,1
"56d94971a7a94257aa330183a8ebd0ea","56d94971a7a94257aa330183a8ebd0ea",11385589,1,0,1,1225,313,313,0
"56d94971a7a94257aa330183a8ebd0ea","141c0df6cd1946539aadd1c9b7068cd4",11385589,1,-5,0,1226,313,308,-5
"141c0df6cd1946539aadd1c9b7068cd4","13255e63e0aa4abf85e5211bf613d43e",11385589,1,10,0,1227,308,317,9
"13255e63e0aa4abf85e5211bf613d43e","13255e63e0aa4abf85e5211bf613d43e",11385589,1,0,1,1228,317,317,0
"13255e63e0aa4abf85e5211bf613d43e","0c787d16c9504873b1a4d903cec09948",11385589,1,-3,0,1229,317,314,-3
"0c787d16c9504873b1a4d903cec09948","86c27d40179e419c8e9d150fb6afa5d0",11385589,1,6,0,1230,314,319,5
"86c27d40179e419c8e9d150fb6afa5d0","86c27d40179e419c8e9d150fb6afa5d0",11385589,1,0,1,1231,319,319,0
"86c27d40179e419c8e9d150fb6afa5d0","24f1363179ad4aaa965484a78471912b",11385589,1,5,0,1232,319,323,4
"24f1363179ad4aaa965484a78471912b","47edbb64109243e6b0f8f64cdef90c6c",11385589,1,3,0,1233,323,326,3
"47edbb64109243e6b0f8f64cdef90c6c","8d7e0b55cf9849cda222a0f2440cec55",11385589,1,-9,0,1234,326,318,-8
"8d7e0b55cf9849cda222a0f2440cec55","24f1363179ad4aaa965484a78471912b",11385589,1,6,0,1235,318,323,5
"24f1363179ad4aaa965484a78471912b","3628bdce1dd2429ba924d2d4d09448d2",11385589,1,-1,0,1236,323,322,-1
"3628bdce1dd2429ba924d2d4d09448d2","56b3fd1a212a4764be39d979fde3326e",11385589,1,7,0,1237,322,328,6
"56b3fd1a212a4764be39d979fde3326e","56b3fd1a212a4764be39d979fde3326e",11385589,1,0,1,1238,328,328,0
"56b3fd1a212a4764be39d979fde3326e","0c4079457ede49e3aeb5e86ed84bdf35",11385589,1,3,0,1239,328,329,1
"0c4079457ede49e3aeb5e86ed84bdf35","3434c10e561d488a914e0f7d71907abd",11385589,1,-31,0,1240,329,305,-24
"3434c10e561d488a914e0f7d71907abd","38aea304b4fa46e1b29bb72f5cea4c93",11385589,1,33,0,1241,305,331,26
"38aea304b4fa46e1b29bb72f5cea4c93","38aea304b4fa46e1b29bb72f5cea4c93",11385589,3,0,1,1242,331,331,0
"38aea304b4fa46e1b29bb72f5cea4c93","e36d261332f14e79bb4b467aceaeb9b5",11385589,1,2,0,1245,331,333,2
"e36d261332f14e79bb4b467aceaeb9b5","e36d261332f14e79bb4b467aceaeb9b5",11385589,1,0,1,1246,333,333,0
"e36d261332f14e79bb4b467aceaeb9b5","c7e89b9d04744d2eab742fc24e3ef1ae",11385589,1,1,0,1247,333,334,1
"c7e89b9d04744d2eab742fc24e3ef1ae","c7e89b9d04744d2eab742fc24e3ef1ae",11385589,2,0,1,1248,334,334,0
"c7e89b9d04744d2eab742fc24e3ef1ae","fe49f8054b374a0ea4bb266ed135ff62",11385589,1,1,0,1250,334,335,1
"fe49f8054b374a0ea4bb266ed135ff62","fe49f8054b374a0ea4bb266ed135ff62",11385589,2,0,1,1251,335,335,0
"fe49f8054b374a0ea4bb266ed135ff62","d0a8f74af98642fe8360d22c42e45117",11385589,1,1,0,1253,335,336,1
"d0a8f74af98642fe8360d22c42e45117","d0a8f74af98642fe8360d22c42e45117",11385589,2,0,1,1254,336,336,0
"d0a8f74af98642fe8360d22c42e45117","0c4079457ede49e3aeb5e86ed84bdf35",11385589,1,-7,0,1256,336,329,-7
"0c4079457ede49e3aeb5e86ed84bdf35","a7c6339ca1da4368a18d471f0519f877",11385589,1,11,0,1257,329,339,10
"a7c6339ca1da4368a18d471f0519f877","a7c6339ca1da4368a18d471f0519f877",11385589,1,0,1,1258,339,339,0
"a7c6339ca1da4368a18d471f0519f877","bbc5139ca9024389a94db3a6f47dcff6",11385589,1,3,0,1259,339,341,2
"bbc5139ca9024389a94db3a6f47dcff6","b8b9418ab322418d9db9b40d96af873a",11385589,1,-5,0,1260,341,337,-4
"b8b9418ab322418d9db9b40d96af873a","bbc5139ca9024389a94db3a6f47dcff6",11385589,1,5,0,1261,337,341,4
"bbc5139ca9024389a94db3a6f47dcff6","bbc5139ca9024389a94db3a6f47dcff6",11385589,1,0,1,1262,341,341,0
"bbc5139ca9024389a94db3a6f47dcff6","4ee6ca9019ab4a1ab323f98094a9bd77",11385589,1,2,0,1263,341,343,2
"4ee6ca9019ab4a1ab323f98094a9bd77","4ee6ca9019ab4a1ab323f98094a9bd77",11385589,2,0,1,1264,343,343,0
"4ee6ca9019ab4a1ab323f98094a9bd77","b37947176785476f8b29d49a851366dc",11385589,1,1,0,1266,343,344,1
"b37947176785476f8b29d49a851366dc","b37947176785476f8b29d49a851366dc",11385589,2,0,1,1267,344,344,0
"b37947176785476f8b29d49a851366dc","fcea5b10d5a14a3b9324ffece8f6e1e5",11385589,1,1,0,1269,344,345,1
"fcea5b10d5a14a3b9324ffece8f6e1e5","fcea5b10d5a14a3b9324ffece8f6e1e5",11385589,2,0,1,1270,345,345,0
"fcea5b10d5a14a3b9324ffece8f6e1e5","c2490bc612d146edbe786556fab3651b",11385589,1,-5,0,1272,345,340,-5
"c2490bc612d146edbe786556fab3651b","6ac8bb048b854999a47edb35fe627f11",11385589,1,8,0,1273,340,347,7
"6ac8bb048b854999a47edb35fe627f11","6ac8bb048b854999a47edb35fe627f11",11385589,1,0,1,1274,347,347,0
"6ac8bb048b854999a47edb35fe627f11","0c4079457ede49e3aeb5e86ed84bdf35",11385589,1,-21,0,1275,347,329,-18
"0c4079457ede49e3aeb5e86ed84bdf35","30ead9794d4847abaf222ca966cc8630",11385589,1,24,0,1276,329,348,19
"30ead9794d4847abaf222ca966cc8630","eff0de7f2dbb42dfa1a2e686efab5b6d",11385589,1,6,0,1277,348,354,6
"eff0de7f2dbb42dfa1a2e686efab5b6d","09b9678ddc3d452ea4a3d46e15826065",11385589,1,-1,0,1278,354,353,-1
"09b9678ddc3d452ea4a3d46e15826065","c20993c944444fe085345591a8bd837e",11385589,1,-2,0,1279,353,351,-2
"c20993c944444fe085345591a8bd837e","897b7f51242c44aab2205c72fdcbf4cd",11385589,2,1,0,1280,351,352,1
"897b7f51242c44aab2205c72fdcbf4cd","c20993c944444fe085345591a8bd837e",11385589,1,-1,0,1281,352,351,-1
"c20993c944444fe085345591a8bd837e","c20993c944444fe085345591a8bd837e",11385589,3,0,1,1282,351,351,0
"897b7f51242c44aab2205c72fdcbf4cd","897b7f51242c44aab2205c72fdcbf4cd",11385589,3,0,1,1286,352,352,0
"897b7f51242c44aab2205c72fdcbf4cd","09b9678ddc3d452ea4a3d46e15826065",11385589,1,1,0,1289,352,353,1
"09b9678ddc3d452ea4a3d46e15826065","09b9678ddc3d452ea4a3d46e15826065",11385589,3,0,1,1290,353,353,0
"09b9678ddc3d452ea4a3d46e15826065","eff0de7f2dbb42dfa1a2e686efab5b6d",11385589,1,1,0,1293,353,354,1
"eff0de7f2dbb42dfa1a2e686efab5b6d","eff0de7f2dbb42dfa1a2e686efab5b6d",11385589,3,0,1,1294,354,354,0
"eff0de7f2dbb42dfa1a2e686efab5b6d","30ead9794d4847abaf222ca966cc8630",11385589,1,-6,0,1297,354,348,-6
"30ead9794d4847abaf222ca966cc8630","2fe14166dc9642c3bc666b86a57f943d",11385589,1,10,0,1298,348,357,9
"2fe14166dc9642c3bc666b86a57f943d","2fe14166dc9642c3bc666b86a57f943d",11385589,2,0,1,1299,357,357,0
"2fe14166dc9642c3bc666b86a57f943d","44421dd1e13a47a388c4a19834b744c7",11385589,1,2,0,1301,357,359,2
"44421dd1e13a47a388c4a19834b744c7","44421dd1e13a47a388c4a19834b744c7",11385589,2,0,1,1302,359,359,0
"44421dd1e13a47a388c4a19834b744c7","cb5fc7ef85d547c4be1a7439d0bf6052",11385589,1,1,0,1304,359,360,1
"cb5fc7ef85d547c4be1a7439d0bf6052","cb5fc7ef85d547c4be1a7439d0bf6052",11385589,2,0,1,1305,360,360,0
"cb5fc7ef85d547c4be1a7439d0bf6052","0a8f150a4cf747acbde62f4721823da3",11385589,1,1,0,1307,360,361,1
"0a8f150a4cf747acbde62f4721823da3","0a8f150a4cf747acbde62f4721823da3",11385589,2,0,1,1308,361,361,0
"0a8f150a4cf747acbde62f4721823da3","ab8fdad974ae471f9f24c3f9dd04462e",11385589,1,1,0,1310,361,362,1
"ab8fdad974ae471f9f24c3f9dd04462e","ab8fdad974ae471f9f24c3f9dd04462e",11385589,2,0,1,1311,362,362,0
"ab8fdad974ae471f9f24c3f9dd04462e","1ba8fef685d74a8194b9db252eb704fb",11385589,1,-7,0,1313,362,355,-7
"1ba8fef685d74a8194b9db252eb704fb","52580888dadb4fe3baa795683ea227bd",11385589,1,10,0,1314,355,364,9
"52580888dadb4fe3baa795683ea227bd","52580888dadb4fe3baa795683ea227bd",11385589,4,0,1,1315,364,364,0
"52580888dadb4fe3baa795683ea227bd","492a3bc6a1254f23a7998587961b22a4",11385589,1,3,0,1319,364,366,2
"492a3bc6a1254f23a7998587961b22a4","f00179e251a045b39c3f7a54f9aa4acc",11385589,1,-4,0,1320,366,363,-3
"f00179e251a045b39c3f7a54f9aa4acc","492a3bc6a1254f23a7998587961b22a4",11385589,1,4,0,1321,363,366,3
"492a3bc6a1254f23a7998587961b22a4","492a3bc6a1254f23a7998587961b22a4",11385589,5,0,1,1322,366,366,0
"492a3bc6a1254f23a7998587961b22a4","072a190fd302456290895f9f04d6940a",11385589,1,-1,0,1327,366,365,-1
"072a190fd302456290895f9f04d6940a","cfa457d1743848e4bb5e4beced6448ed",11385589,1,5,0,1328,365,369,4
"cfa457d1743848e4bb5e4beced6448ed","cfa457d1743848e4bb5e4beced6448ed",11385589,1,0,1,1329,369,369,0
"cfa457d1743848e4bb5e4beced6448ed","b71bac264efb4abd97015447bd490db6",11385589,1,3,0,1330,369,370,1
"b71bac264efb4abd97015447bd490db6","30ead9794d4847abaf222ca966cc8630",11385589,1,-28,0,1331,370,348,-22
"30ead9794d4847abaf222ca966cc8630","8d448d625b024c82a5eb240bbd7431d6",11385589,1,33,0,1332,348,374,26
"8d448d625b024c82a5eb240bbd7431d6","8d448d625b024c82a5eb240bbd7431d6",11385589,65,0,1,1333,374,374,0
"8d448d625b024c82a5eb240bbd7431d6","b71bac264efb4abd97015447bd490db6",11385589,5,-5,0,1335,374,370,-4
"b71bac264efb4abd97015447bd490db6","8d448d625b024c82a5eb240bbd7431d6",11385589,3,5,0,1336,370,374,4
"b71bac264efb4abd97015447bd490db6","d6d02b6ef04e4f17805504500b8ce441",11385589,3,8,0,1385,370,375,5
"d6d02b6ef04e4f17805504500b8ce441","d6d02b6ef04e4f17805504500b8ce441",11385589,4,0,1,1386,375,375,0
"d6d02b6ef04e4f17805504500b8ce441","b71bac264efb4abd97015447bd490db6",11385589,1,-8,0,1387,375,370,-5
"d6d02b6ef04e4f17805504500b8ce441","8d448d625b024c82a5eb240bbd7431d6",11385589,1,-3,0,1401,375,374,-1
"d6d02b6ef04e4f17805504500b8ce441","66baf19b6b904b70922329068c63746d",11385589,1,4,0,1415,375,376,1
"66baf19b6b904b70922329068c63746d","7f544639412e40a9ba27f43b415362ab",11385589,1,2,0,1416,376,378,2
"7f544639412e40a9ba27f43b415362ab","7f544639412e40a9ba27f43b415362ab",11385589,1,0,1,1417,378,378,0
"7f544639412e40a9ba27f43b415362ab","d5ae8642e15b46b8bd298b02274d4e9c",11385589,1,2,0,1418,378,380,2
"d5ae8642e15b46b8bd298b02274d4e9c","d5ae8642e15b46b8bd298b02274d4e9c",11385589,1,0,1,1419,380,380,0
"d5ae8642e15b46b8bd298b02274d4e9c","a0d10309a2dd456289147f84be9d37f9",11385589,1,1,0,1420,380,381,1
"a0d10309a2dd456289147f84be9d37f9","a0d10309a2dd456289147f84be9d37f9",11385589,2,0,1,1421,381,381,0
"a0d10309a2dd456289147f84be9d37f9","0fcbc3ca07b144138b8d85da581f09a8",11385589,1,1,0,1423,381,382,1
"0fcbc3ca07b144138b8d85da581f09a8","0fcbc3ca07b144138b8d85da581f09a8",11385589,2,0,1,1424,382,382,0
"0fcbc3ca07b144138b8d85da581f09a8","66baf19b6b904b70922329068c63746d",11385589,1,-6,0,1426,382,376,-6
"66baf19b6b904b70922329068c63746d","4890121ce5d74576b4632b77cfc23398",11385589,1,14,0,1427,376,388,12
"4890121ce5d74576b4632b77cfc23398","c2fca3669923477ab966ded303dea31c",11385589,1,-6,0,1428,388,383,-5
"c2fca3669923477ab966ded303dea31c","4890121ce5d74576b4632b77cfc23398",11385589,1,6,0,1429,383,388,5
"4890121ce5d74576b4632b77cfc23398","96bb2b3e85a34d8b9544514e89f6fe97",11385589,1,3,0,1430,388,390,2
"96bb2b3e85a34d8b9544514e89f6fe97","18d3b836dd804224883cc9180b60a8e1",11385589,1,-4,0,1431,390,387,-3
"18d3b836dd804224883cc9180b60a8e1","96bb2b3e85a34d8b9544514e89f6fe97",11385589,1,4,0,1432,387,390,3
"96bb2b3e85a34d8b9544514e89f6fe97","ac4e9b54acfe4670b4634859c7263cb5",11385589,1,2,0,1433,390,392,2
"ac4e9b54acfe4670b4634859c7263cb5","ac4e9b54acfe4670b4634859c7263cb5",11385589,1,0,1,1434,392,392,0
"ac4e9b54acfe4670b4634859c7263cb5","6f8881a745ac4c358a68b92c3b4abe81",11385589,1,3,0,1435,392,394,2
"6f8881a745ac4c358a68b92c3b4abe81","17f95d18bab743888e1736033dc3384d",11385589,1,-6,0,1436,394,389,-5
"17f95d18bab743888e1736033dc3384d","6f8881a745ac4c358a68b92c3b4abe81",11385589,1,6,0,1437,389,394,5
"6f8881a745ac4c358a68b92c3b4abe81","f7002c8484354eceac57bc7bd62c76c1",11385589,1,-1,0,1438,394,393,-1
"f7002c8484354eceac57bc7bd62c76c1","0c12af0a4e7f4002852cf84b2537c161",11385589,1,3,0,1439,393,395,2
"0c12af0a4e7f4002852cf84b2537c161","df8191ec5e584c838a899c378941a566",11385589,1,4,0,1440,395,398,3
"df8191ec5e584c838a899c378941a566","6f8881a745ac4c358a68b92c3b4abe81",11385589,1,-6,0,1441,398,394,-4
"6f8881a745ac4c358a68b92c3b4abe81","0c12af0a4e7f4002852cf84b2537c161",11385589,1,2,0,1442,394,395,1
"0c12af0a4e7f4002852cf84b2537c161","f7002c8484354eceac57bc7bd62c76c1",11385589,1,-3,0,1443,395,393,-2
"f7002c8484354eceac57bc7bd62c76c1","44a277ea44dc4ae689fab4b82f0b4098",11385589,1,5,0,1444,393,397,4
"44a277ea44dc4ae689fab4b82f0b4098","66baf19b6b904b70922329068c63746d",11385589,1,-26,0,1445,397,376,-21
"66baf19b6b904b70922329068c63746d","44a277ea44dc4ae689fab4b82f0b4098",11385589,1,26,0,1446,376,397,21
"44a277ea44dc4ae689fab4b82f0b4098","44a277ea44dc4ae689fab4b82f0b4098",11385589,1,0,1,1447,397,397,0
"44a277ea44dc4ae689fab4b82f0b4098","0c12af0a4e7f4002852cf84b2537c161",11385589,1,-2,0,1448,397,395,-2
"0c12af0a4e7f4002852cf84b2537c161","66baf19b6b904b70922329068c63746d",11385589,1,-24,0,1449,395,376,-19
"66baf19b6b904b70922329068c63746d","2b09a08242b54983aec7063990fb3f66",11385589,3,32,0,1450,376,400,24
"2b09a08242b54983aec7063990fb3f66","2b09a08242b54983aec7063990fb3f66",11385589,2,0,1,1451,400,400,0
"2b09a08242b54983aec7063990fb3f66","66baf19b6b904b70922329068c63746d",11385589,2,-32,0,1452,400,376,-24
"2b09a08242b54983aec7063990fb3f66","859e0b8d71694b12befb69ee698138f9",11385589,1,-3,0,1454,400,399,-1
"859e0b8d71694b12befb69ee698138f9","859e0b8d71694b12befb69ee698138f9",11385589,1,0,1,1455,399,399,0
"859e0b8d71694b12befb69ee698138f9","2b09a08242b54983aec7063990fb3f66",11385589,1,3,0,1456,399,400,1
"2b09a08242b54983aec7063990fb3f66","1f471b7a883a4df48211e8c6a81b59a7",11385589,1,1,0,1460,400,401,1
"1f471b7a883a4df48211e8c6a81b59a7","1f471b7a883a4df48211e8c6a81b59a7",11385589,1,0,1,1461,401,401,0
"1f471b7a883a4df48211e8c6a81b59a7","2b09a08242b54983aec7063990fb3f66",11385589,1,-1,0,1462,401,400,-1
"2b09a08242b54983aec7063990fb3f66","9de0d567bfa84fe5b77cb76f4a76a5d1",11385589,1,5,0,1463,400,404,4
"9de0d567bfa84fe5b77cb76f4a76a5d1","9de0d567bfa84fe5b77cb76f4a76a5d1",11385589,1,0,1,1464,404,404,0
"9de0d567bfa84fe5b77cb76f4a76a5d1","1157bd665ec4472fb58b751dc5099355",11385589,1,-1,0,1465,404,403,-1
"1157bd665ec4472fb58b751dc5099355","3c8a22d2f9c146ea956609e3ed4f2559",11385589,1,3,0,1466,403,405,2
"3c8a22d2f9c146ea956609e3ed4f2559","58fc9094275e4c49be3f4ba6d4acc0a4",11385589,1,2,0,1467,405,406,1
"58fc9094275e4c49be3f4ba6d4acc0a4","58fc9094275e4c49be3f4ba6d4acc0a4",11385589,1,0,1,1468,406,406,0
"58fc9094275e4c49be3f4ba6d4acc0a4","c1c1be90b2b14c1ab4a5e1ee3c241902",11385589,1,1,0,1469,406,407,1
"c1c1be90b2b14c1ab4a5e1ee3c241902","c1c1be90b2b14c1ab4a5e1ee3c241902",11385589,5,0,1,1470,407,407,0
"c1c1be90b2b14c1ab4a5e1ee3c241902","58fc9094275e4c49be3f4ba6d4acc0a4",11385589,1,-1,0,1475,407,406,-1
"58fc9094275e4c49be3f4ba6d4acc0a4","02b3a1bead9244c1ba2f857c7da8f82a",11385589,1,3,0,1476,406,408,2
"02b3a1bead9244c1ba2f857c7da8f82a","02b3a1bead9244c1ba2f857c7da8f82a",11385589,1,0,1,1477,408,408,0
"02b3a1bead9244c1ba2f857c7da8f82a","6206fc6479014bb193084c32409dc1b9",11385589,1,1,0,1478,408,409,1
"6206fc6479014bb193084c32409dc1b9","6206fc6479014bb193084c32409dc1b9",11385589,4,0,1,1479,409,409,0
"6206fc6479014bb193084c32409dc1b9","6a5f020451db426dacba9e2ea3fcc62a",11385589,1,2,0,1483,409,410,1
"6a5f020451db426dacba9e2ea3fcc62a","02b3a1bead9244c1ba2f857c7da8f82a",11385589,1,-3,0,1484,410,408,-2
"02b3a1bead9244c1ba2f857c7da8f82a","6a5f020451db426dacba9e2ea3fcc62a",11385589,1,3,0,1485,408,410,2
"6a5f020451db426dacba9e2ea3fcc62a","6a5f020451db426dacba9e2ea3fcc62a",11385589,2,0,1,1486,410,410,0
"6a5f020451db426dacba9e2ea3fcc62a","33a9d248b2e44588a5b07fc1342b9bc2",11385589,1,2,0,1488,410,411,1
"33a9d248b2e44588a5b07fc1342b9bc2","33a9d248b2e44588a5b07fc1342b9bc2",11385589,2,0,1,1489,411,411,0
"33a9d248b2e44588a5b07fc1342b9bc2","c6f26bd420634f1cb7989e76fe6b16c0",11385589,1,1,0,1490,411,412,1
"c6f26bd420634f1cb7989e76fe6b16c0","c6f26bd420634f1cb7989e76fe6b16c0",11385589,5,0,1,1491,412,412,0
"c6f26bd420634f1cb7989e76fe6b16c0","2a65ee6e2ac64f6a8a55fbe5373ec763",11385589,1,1,0,1496,412,413,1
"2a65ee6e2ac64f6a8a55fbe5373ec763","2a65ee6e2ac64f6a8a55fbe5373ec763",11385589,2,0,1,1497,413,413,0
"2a65ee6e2ac64f6a8a55fbe5373ec763","33a9d248b2e44588a5b07fc1342b9bc2",11385589,1,-2,0,1499,413,411,-2
"33a9d248b2e44588a5b07fc1342b9bc2","687055dad9fc40c3982478fe33ec01bf",11385589,1,4,0,1500,411,414,3
"687055dad9fc40c3982478fe33ec01bf","2add1669f08d4101913db15f8c23b3b7",11385589,1,3,0,1501,414,416,2
"2add1669f08d4101913db15f8c23b3b7","687055dad9fc40c3982478fe33ec01bf",11385589,1,-3,0,1502,416,414,-2
"687055dad9fc40c3982478fe33ec01bf","33a9d248b2e44588a5b07fc1342b9bc2",11385589,1,-4,0,1503,414,411,-3
"33a9d248b2e44588a5b07fc1342b9bc2","2b09a08242b54983aec7063990fb3f66",11385589,1,-17,0,1505,411,400,-11
"2b09a08242b54983aec7063990fb3f66","2add1669f08d4101913db15f8c23b3b7",11385589,2,24,0,1506,400,416,16
"2add1669f08d4101913db15f8c23b3b7","1fd0f6dadbc14ebc965faf6122190b96",11385589,1,-2,0,1507,416,415,-1
"1fd0f6dadbc14ebc965faf6122190b96","1fd0f6dadbc14ebc965faf6122190b96",11385589,1,0,1,1508,415,415,0
"1fd0f6dadbc14ebc965faf6122190b96","687055dad9fc40c3982478fe33ec01bf",11385589,1,-1,0,1509,415,414,-1
"687055dad9fc40c3982478fe33ec01bf","a2b4bd40cee2481ebd3fc179d6a5cd62",11385589,1,6,0,1510,414,417,3
"a2b4bd40cee2481ebd3fc179d6a5cd62","2b09a08242b54983aec7063990fb3f66",11385589,2,-27,0,1511,417,400,-17
"2b09a08242b54983aec7063990fb3f66","a2b4bd40cee2481ebd3fc179d6a5cd62",11385589,2,27,0,1512,400,417,17
"2add1669f08d4101913db15f8c23b3b7","2add1669f08d4101913db15f8c23b3b7",11385589,1,0,1,1515,416,416,0
"2add1669f08d4101913db15f8c23b3b7","2b09a08242b54983aec7063990fb3f66",11385589,1,-24,0,1516,416,400,-16
"a2b4bd40cee2481ebd3fc179d6a5cd62","e34e59dce2204f228f3a84b6725df60f",11385589,1,2,0,1518,417,419,2
"e34e59dce2204f228f3a84b6725df60f","e34e59dce2204f228f3a84b6725df60f",11385589,1,0,1,1519,419,419,0
"e34e59dce2204f228f3a84b6725df60f","bec48fc2e1294c7eb3d0aca780d731b8",11385589,1,2,0,1520,419,420,1
"bec48fc2e1294c7eb3d0aca780d731b8","a2b4bd40cee2481ebd3fc179d6a5cd62",11385589,1,-4,0,1521,420,417,-3
"a2b4bd40cee2481ebd3fc179d6a5cd62","bec48fc2e1294c7eb3d0aca780d731b8",11385589,1,4,0,1522,417,420,3
"bec48fc2e1294c7eb3d0aca780d731b8","bec48fc2e1294c7eb3d0aca780d731b8",11385589,1,0,1,1523,420,420,0
"bec48fc2e1294c7eb3d0aca780d731b8","dbde19fcce2a4c1abdc7f685c293a23f",11385589,1,3,0,1524,420,422,2
"dbde19fcce2a4c1abdc7f685c293a23f","a24600b0e49245f6bdba8c893cfeddb0",11385589,1,4,0,1525,422,425,3
"a24600b0e49245f6bdba8c893cfeddb0","a24600b0e49245f6bdba8c893cfeddb0",11385589,2,0,1,1526,425,425,0
"a24600b0e49245f6bdba8c893cfeddb0","a2b4bd40cee2481ebd3fc179d6a5cd62",11385589,1,-11,0,1528,425,417,-8
"a2b4bd40cee2481ebd3fc179d6a5cd62","24cf8786024543f19b89bc20034e60d7",11385589,1,18,0,1529,417,428,11
"24cf8786024543f19b89bc20034e60d7","f2a73be2f46840b182d7bd095378004e",11385589,1,1,0,1530,428,429,1
"f2a73be2f46840b182d7bd095378004e","f2a73be2f46840b182d7bd095378004e",11385589,2,0,1,1531,429,429,0
"f2a73be2f46840b182d7bd095378004e","604551fd4266430cb860fef58fa7dd61",11385589,1,1,0,1533,429,430,1
"604551fd4266430cb860fef58fa7dd61","604551fd4266430cb860fef58fa7dd61",11385589,7,0,1,1534,430,430,0
"604551fd4266430cb860fef58fa7dd61","24cf8786024543f19b89bc20034e60d7",11385589,1,-2,0,1541,430,428,-2
"24cf8786024543f19b89bc20034e60d7","dce46f8904594a62a6377a3587aaa663",11385589,1,4,0,1542,428,431,3
"dce46f8904594a62a6377a3587aaa663","dce46f8904594a62a6377a3587aaa663",11385589,1,0,1,1543,431,431,0
"dce46f8904594a62a6377a3587aaa663","9b9d0a249052413c869753b99682b0ac",11385589,1,1,0,1544,431,432,1
"9b9d0a249052413c869753b99682b0ac","9b9d0a249052413c869753b99682b0ac",11385589,3,0,1,1545,432,432,0
"9b9d0a249052413c869753b99682b0ac","061c175cc90f45fbad883025394e78dd",11385589,1,1,0,1548,432,433,1
"061c175cc90f45fbad883025394e78dd","061c175cc90f45fbad883025394e78dd",11385589,4,0,1,1549,433,433,0
"061c175cc90f45fbad883025394e78dd","dce46f8904594a62a6377a3587aaa663",11385589,1,-2,0,1553,433,431,-2
"dce46f8904594a62a6377a3587aaa663","74a7f8712e5449c2bc0b43c6f90dafed",11385589,1,5,0,1554,431,435,4
"74a7f8712e5449c2bc0b43c6f90dafed","74a7f8712e5449c2bc0b43c6f90dafed",11385589,1,0,1,1555,435,435,0
"74a7f8712e5449c2bc0b43c6f90dafed","66ada10dde9f43018588f1ced9d477fc",11385589,1,-1,0,1556,435,434,-1
"66ada10dde9f43018588f1ced9d477fc","24cf8786024543f19b89bc20034e60d7",11385589,1,-8,0,1557,434,428,-6
"24cf8786024543f19b89bc20034e60d7","070600601c4c439288445d2f0724807d",11385589,2,14,0,1558,428,437,9
"070600601c4c439288445d2f0724807d","1823b6de7d334a7aaabc4570719af4d9",11385589,2,2,0,1559,437,439,2
"1823b6de7d334a7aaabc4570719af4d9","070600601c4c439288445d2f0724807d",11385589,2,-2,0,1560,439,437,-2
"070600601c4c439288445d2f0724807d","24cf8786024543f19b89bc20034e60d7",11385589,1,-14,0,1561,437,428,-9
"24cf8786024543f19b89bc20034e60d7","bf12c96466d840a69bed7020b3f18bb8",11385589,1,11,0,1562,428,436,8
"bf12c96466d840a69bed7020b3f18bb8","bf12c96466d840a69bed7020b3f18bb8",11385589,1,0,1,1563,436,436,0
"bf12c96466d840a69bed7020b3f18bb8","24cf8786024543f19b89bc20034e60d7",11385589,1,-11,0,1564,436,428,-8
"1823b6de7d334a7aaabc4570719af4d9","1823b6de7d334a7aaabc4570719af4d9",11385589,15,0,1,1567,439,439,0
"070600601c4c439288445d2f0724807d","0380cd76a7d44bc3a4da1f15e4d68f89",11385589,1,4,0,1583,437,440,3
"0380cd76a7d44bc3a4da1f15e4d68f89","0380cd76a7d44bc3a4da1f15e4d68f89",11385589,3,0,1,1584,440,440,0
"0380cd76a7d44bc3a4da1f15e4d68f89","23b7673c8b5443108c2ef09382834a86",11385589,1,2,0,1587,440,441,1
"23b7673c8b5443108c2ef09382834a86","23b7673c8b5443108c2ef09382834a86",11385589,11,0,1,1588,441,441,0
"23b7673c8b5443108c2ef09382834a86","901e92500aea43c79f19f1b279050668",11385589,9,2,0,1589,441,442,1
"901e92500aea43c79f19f1b279050668","23b7673c8b5443108c2ef09382834a86",11385589,7,-2,0,1590,442,441,-1
"901e92500aea43c79f19f1b279050668","901e92500aea43c79f19f1b279050668",11385589,9,0,1,1592,442,442,0
"901e92500aea43c79f19f1b279050668","001339db8ced4cf78829ebe8b145449d",11385589,1,1,0,1593,442,443,1
"001339db8ced4cf78829ebe8b145449d","001339db8ced4cf78829ebe8b145449d",11385589,2,0,1,1594,443,443,0
"001339db8ced4cf78829ebe8b145449d","452745e0366e42ae81561bfddebcc6c3",11385589,1,1,0,1596,443,444,1
"452745e0366e42ae81561bfddebcc6c3","452745e0366e42ae81561bfddebcc6c3",11385589,2,0,1,1597,444,444,0
"452745e0366e42ae81561bfddebcc6c3","4660ff2089114e8db82ceb26a4f329e3",11385589,1,2,0,1599,444,445,1
"4660ff2089114e8db82ceb26a4f329e3","901e92500aea43c79f19f1b279050668",11385589,2,-4,0,1600,445,442,-3
"901e92500aea43c79f19f1b279050668","4660ff2089114e8db82ceb26a4f329e3",11385589,6,4,0,1601,442,445,3
"4660ff2089114e8db82ceb26a4f329e3","7bd5586eb9d8484eb74a433ee7bfe499",11385589,2,2,0,1602,445,446,1
"7bd5586eb9d8484eb74a433ee7bfe499","4660ff2089114e8db82ceb26a4f329e3",11385589,1,-2,0,1603,446,445,-1
"7bd5586eb9d8484eb74a433ee7bfe499","7bd5586eb9d8484eb74a433ee7bfe499",11385589,32,0,1,1605,446,446,0
"7bd5586eb9d8484eb74a433ee7bfe499","8a7f26e690f34dda97be16904518ca99",11385589,1,2,0,1637,446,447,1
"8a7f26e690f34dda97be16904518ca99","8a7f26e690f34dda97be16904518ca99",11385589,1,0,1,1638,447,447,0
"8a7f26e690f34dda97be16904518ca99","070600601c4c439288445d2f0724807d",11385589,1,-16,0,1639,447,437,-10
"070600601c4c439288445d2f0724807d","b2f0d654738f48158edff28e8d3a546e",11385589,1,21,0,1640,437,449,12
"b2f0d654738f48158edff28e8d3a546e","f60ee41ec635499abd48168342d32c2f",11385589,3,5,0,1641,449,453,4
"f60ee41ec635499abd48168342d32c2f","f60ee41ec635499abd48168342d32c2f",11385589,58,0,1,1642,453,453,0
"f60ee41ec635499abd48168342d32c2f","b2f0d654738f48158edff28e8d3a546e",11385589,2,-5,0,1647,453,449,-4
"b2f0d654738f48158edff28e8d3a546e","f67fbf45a5f146ed866965bc57c7c001",11385589,1,8,0,1696,449,454,5
"f67fbf45a5f146ed866965bc57c7c001","f67fbf45a5f146ed866965bc57c7c001",11385589,2,0,1,1697,454,454,0
"f67fbf45a5f146ed866965bc57c7c001","d937afe49bd24a07a550dda1c1155122",11385589,1,1,0,1699,454,455,1
"d937afe49bd24a07a550dda1c1155122","d937afe49bd24a07a550dda1c1155122",11385589,1,0,1,1700,455,455,0
"d937afe49bd24a07a550dda1c1155122","3628b3f7823443d0912a339096b69943",11385589,1,1,0,1701,455,456,1
"3628b3f7823443d0912a339096b69943","3628b3f7823443d0912a339096b69943",11385589,1,0,1,1702,456,456,0
"3628b3f7823443d0912a339096b69943","9e049ee647cf43ecbcb5ed792a8e7588",11385589,1,1,0,1703,456,457,1
"9e049ee647cf43ecbcb5ed792a8e7588","9e049ee647cf43ecbcb5ed792a8e7588",11385589,1,0,1,1704,457,457,0
"9e049ee647cf43ecbcb5ed792a8e7588","5256a214faaf410b93f76cea06428334",11385589,1,1,0,1705,457,458,1
"5256a214faaf410b93f76cea06428334","5256a214faaf410b93f76cea06428334",11385589,1,0,1,1706,458,458,0
"5256a214faaf410b93f76cea06428334","25c32b120fce40fa9b6c85133aeb4716",11385589,1,1,0,1707,458,459,1
"25c32b120fce40fa9b6c85133aeb4716","25c32b120fce40fa9b6c85133aeb4716",11385589,1,0,1,1708,459,459,0
"25c32b120fce40fa9b6c85133aeb4716","11bc14f2204949008b7d511b933363c1",11385589,1,1,0,1709,459,460,1
"11bc14f2204949008b7d511b933363c1","11bc14f2204949008b7d511b933363c1",11385589,1,0,1,1710,460,460,0
"11bc14f2204949008b7d511b933363c1","42de338840a34d15adb66e7b14fb9d2c",11385589,1,1,0,1711,460,461,1
"42de338840a34d15adb66e7b14fb9d2c","42de338840a34d15adb66e7b14fb9d2c",11385589,3,0,1,1712,461,461,0
"42de338840a34d15adb66e7b14fb9d2c","9da37c6210b1416b8079c274f70bf600",11385589,1,1,0,1715,461,462,1
"9da37c6210b1416b8079c274f70bf600","9da37c6210b1416b8079c274f70bf600",11385589,1,0,1,1716,462,462,0
"9da37c6210b1416b8079c274f70bf600","519119f1deac45ff9ab4f13529be5c6e",11385589,1,1,0,1717,462,463,1
"519119f1deac45ff9ab4f13529be5c6e","519119f1deac45ff9ab4f13529be5c6e",11385589,1,0,1,1718,463,463,0
"519119f1deac45ff9ab4f13529be5c6e","c5df9f40ec14463b9dcfdc73df3e9285",11385589,1,3,0,1719,463,464,1
"c5df9f40ec14463b9dcfdc73df3e9285","f67fbf45a5f146ed866965bc57c7c001",11385589,1,-12,0,1720,464,454,-10
"f67fbf45a5f146ed866965bc57c7c001","c5df9f40ec14463b9dcfdc73df3e9285",11385589,1,12,0,1721,454,464,10
"c5df9f40ec14463b9dcfdc73df3e9285","83d42d95cd844fc093fc09cee250edb8",11385589,2,3,0,1722,464,465,1
"83d42d95cd844fc093fc09cee250edb8","c5df9f40ec14463b9dcfdc73df3e9285",11385589,1,-3,0,1723,465,464,-1
"83d42d95cd844fc093fc09cee250edb8","83d42d95cd844fc093fc09cee250edb8",11385589,4,0,1,1725,465,465,0
"83d42d95cd844fc093fc09cee250edb8","b2f0d654738f48158edff28e8d3a546e",11385589,1,-23,0,1729,465,449,-16
"f60ee41ec635499abd48168342d32c2f","070600601c4c439288445d2f0724807d",11385589,1,-26,0,1738,453,437,-16
"070600601c4c439288445d2f0724807d","23b7673c8b5443108c2ef09382834a86",11385589,1,6,0,1739,437,441,4
"4660ff2089114e8db82ceb26a4f329e3","070600601c4c439288445d2f0724807d",11385589,4,-12,0,1748,445,437,-8
"070600601c4c439288445d2f0724807d","901e92500aea43c79f19f1b279050668",11385589,3,8,0,1749,437,442,5
"4660ff2089114e8db82ceb26a4f329e3","4660ff2089114e8db82ceb26a4f329e3",11385589,6,0,1,1759,445,445,0
"070600601c4c439288445d2f0724807d","4660ff2089114e8db82ceb26a4f329e3",11385589,1,12,0,1790,437,445,8
"4660ff2089114e8db82ceb26a4f329e3","23b7673c8b5443108c2ef09382834a86",11385589,1,-6,0,1791,445,441,-4
"23b7673c8b5443108c2ef09382834a86","4660ff2089114e8db82ceb26a4f329e3",11385589,1,6,0,1792,441,445,4
"b613861cecf84ffcab01afb23f660475","b613861cecf84ffcab01afb23f660475",21937630,2,0,1,1,1,1,0
"b613861cecf84ffcab01afb23f660475","e2911e79efc2420eac45d9f671463d4b",21937630,2,3,0,3,1,2,1
"e2911e79efc2420eac45d9f671463d4b","b613861cecf84ffcab01afb23f660475",21937630,1,-3,0,4,2,1,-1
"e2911e79efc2420eac45d9f671463d4b","e2911e79efc2420eac45d9f671463d4b",21937630,1,0,1,6,2,2,0
"e2911e79efc2420eac45d9f671463d4b","519d1b8c59404d67b54e96c5c8a830b2",21937630,1,1,0,7,2,3,1
"519d1b8c59404d67b54e96c5c8a830b2","519d1b8c59404d67b54e96c5c8a830b2",21937630,1,0,1,8,3,3,0
"519d1b8c59404d67b54e96c5c8a830b2","531db53f81f646edb0cdcfe0085b03b7",21937630,1,1,0,9,3,4,1
"531db53f81f646edb0cdcfe0085b03b7","531db53f81f646edb0cdcfe0085b03b7",21937630,1,0,1,10,4,4,0
"531db53f81f646edb0cdcfe0085b03b7","4f5f94b2f95141e0a9d53a61da2276da",21937630,1,1,0,11,4,5,1
"4f5f94b2f95141e0a9d53a61da2276da","4f5f94b2f95141e0a9d53a61da2276da",21937630,1,0,1,12,5,5,0
"4f5f94b2f95141e0a9d53a61da2276da","6d541c89590949f99af293c4f2333f67",21937630,1,1,0,13,5,6,1
"6d541c89590949f99af293c4f2333f67","6d541c89590949f99af293c4f2333f67",21937630,1,0,1,14,6,6,0
"6d541c89590949f99af293c4f2333f67","dd5cf0b9fe4c4f1d8f5ff8e4c04879cb",21937630,1,1,0,15,6,7,1
"dd5cf0b9fe4c4f1d8f5ff8e4c04879cb","dd5cf0b9fe4c4f1d8f5ff8e4c04879cb",21937630,1,0,1,16,7,7,0
"dd5cf0b9fe4c4f1d8f5ff8e4c04879cb","f96261861edc426abe2248be4f0a709a",21937630,1,1,0,17,7,8,1
"f96261861edc426abe2248be4f0a709a","f96261861edc426abe2248be4f0a709a",21937630,1,0,1,18,8,8,0
"f96261861edc426abe2248be4f0a709a","66b5e16f4f75454fb5b8172079f0fa83",21937630,1,1,0,19,8,9,1
"66b5e16f4f75454fb5b8172079f0fa83","66b5e16f4f75454fb5b8172079f0fa83",21937630,1,0,1,20,9,9,0
"66b5e16f4f75454fb5b8172079f0fa83","0680571d4698477995e41842c36a54b2",21937630,1,1,0,21,9,10,1
"0680571d4698477995e41842c36a54b2","0680571d4698477995e41842c36a54b2",21937630,2,0,1,22,10,10,0
"0680571d4698477995e41842c36a54b2","66b5e16f4f75454fb5b8172079f0fa83",21937630,1,-1,0,24,10,9,-1
"66b5e16f4f75454fb5b8172079f0fa83","f96261861edc426abe2248be4f0a709a",21937630,1,-1,0,25,9,8,-1
"f96261861edc426abe2248be4f0a709a","dd5cf0b9fe4c4f1d8f5ff8e4c04879cb",21937630,1,-1,0,26,8,7,-1
"dd5cf0b9fe4c4f1d8f5ff8e4c04879cb","6d541c89590949f99af293c4f2333f67",21937630,1,-1,0,27,7,6,-1
"6d541c89590949f99af293c4f2333f67","4f5f94b2f95141e0a9d53a61da2276da",21937630,1,-1,0,28,6,5,-1
"4f5f94b2f95141e0a9d53a61da2276da","519d1b8c59404d67b54e96c5c8a830b2",21937630,1,-2,0,29,5,3,-2
"519d1b8c59404d67b54e96c5c8a830b2","e2911e79efc2420eac45d9f671463d4b",21937630,1,-1,0,30,3,2,-1
"e2911e79efc2420eac45d9f671463d4b","9112f2bffece48e08c6d2287be204085",21937630,1,9,0,31,2,11,9
"9112f2bffece48e08c6d2287be204085","9112f2bffece48e08c6d2287be204085",21937630,1,0,1,32,11,11,0
"9112f2bffece48e08c6d2287be204085","56586aa865414f538729c7f7735d2bc6",21937630,1,3,0,33,11,12,1
"56586aa865414f538729c7f7735d2bc6","56586aa865414f538729c7f7735d2bc6",21937630,10,0,1,34,12,12,0
"56586aa865414f538729c7f7735d2bc6","b7f2b31585d94eb3bf86376714aa7070",21937630,3,2,0,42,12,13,1
"b7f2b31585d94eb3bf86376714aa7070","56586aa865414f538729c7f7735d2bc6",21937630,1,-2,0,43,13,12,-1
"b7f2b31585d94eb3bf86376714aa7070","b7f2b31585d94eb3bf86376714aa7070",21937630,15,0,1,45,13,13,0
"b7f2b31585d94eb3bf86376714aa7070","3f1c815879794b929260d224becaff7e",21937630,1,2,0,59,13,14,1
"3f1c815879794b929260d224becaff7e","56586aa865414f538729c7f7735d2bc6",21937630,1,-4,0,60,14,12,-2
"b7f2b31585d94eb3bf86376714aa7070","81c864a886d54a6b8ff85f7d736f4f95",21937630,1,4,0,65,13,15,2
"81c864a886d54a6b8ff85f7d736f4f95","5c5ceeee4562457ba6d41515aeebfbb1",21937630,1,4,0,66,15,17,2
"5c5ceeee4562457ba6d41515aeebfbb1","5c5ceeee4562457ba6d41515aeebfbb1",21937630,3,0,1,67,17,17,0
"5c5ceeee4562457ba6d41515aeebfbb1","56586aa865414f538729c7f7735d2bc6",21937630,1,-10,0,70,17,12,-5
"56586aa865414f538729c7f7735d2bc6","9afd71a5298d4333b6849dfce1b9422c",21937630,1,13,0,71,12,18,6
"9afd71a5298d4333b6849dfce1b9422c","9afd71a5298d4333b6849dfce1b9422c",21937630,2,0,1,72,18,18,0
"9afd71a5298d4333b6849dfce1b9422c","b7719e26494940efa49512aedd0aac79",21937630,1,4,0,74,18,20,2
"b7719e26494940efa49512aedd0aac79","9afd71a5298d4333b6849dfce1b9422c",21937630,1,-4,0,75,20,18,-2
"9afd71a5298d4333b6849dfce1b9422c","d4f45188d3c84a02ba08454e6403a818",21937630,1,9,0,76,18,24,6
"d4c3b003e8274e429d2fa688d73fde6d","d4c3b003e8274e429d2fa688d73fde6d",21937630,2,0,1,78,22,22,0
"d4c3b003e8274e429d2fa688d73fde6d","b7719e26494940efa49512aedd0aac79",21937630,1,-3,0,80,22,20,-2
"b7719e26494940efa49512aedd0aac79","b7719e26494940efa49512aedd0aac79",21937630,1,0,1,81,20,20,0
"b7719e26494940efa49512aedd0aac79","afbf7250b99d47bea07172749483ca97",21937630,1,12,0,82,20,28,8
"afbf7250b99d47bea07172749483ca97","afbf7250b99d47bea07172749483ca97",21937630,1,0,1,83,28,28,0
"afbf7250b99d47bea07172749483ca97","4e51676dc72045d99c19b9fa7b22f8bc",21937630,1,3,0,84,28,29,1
"4e51676dc72045d99c19b9fa7b22f8bc","4e51676dc72045d99c19b9fa7b22f8bc",21937630,1,0,1,85,29,29,0
"4e51676dc72045d99c19b9fa7b22f8bc","51970cfa30e643e894e66ae85c8024cc",21937630,1,3,0,86,29,31,2
"51970cfa30e643e894e66ae85c8024cc","c33c17be71ae4d588da7369472e5bb1b",21937630,1,6,0,87,31,34,3
"c33c17be71ae4d588da7369472e5bb1b","4e51676dc72045d99c19b9fa7b22f8bc",21937630,1,-9,0,88,34,29,-5
"4e51676dc72045d99c19b9fa7b22f8bc","93679be414554a11b1893002f2229a93",21937630,1,12,0,89,29,35,6
"93679be414554a11b1893002f2229a93","c33c17be71ae4d588da7369472e5bb1b",21937630,1,-3,0,90,35,34,-1
"7040a13096d746ac84b8fac8d9752058","7040a13096d746ac84b8fac8d9752058",21937630,1,0,1,93,36,36,0
"7040a13096d746ac84b8fac8d9752058","9a0dc646f934470daf08c4b56ccf73db",21937630,1,3,0,94,36,37,1
"9a0dc646f934470daf08c4b56ccf73db","fc0e049d56024bc9a02c9a9c435c3df7",21937630,2,3,0,95,37,38,1
"fc0e049d56024bc9a02c9a9c435c3df7","9a0dc646f934470daf08c4b56ccf73db",21937630,1,-3,0,96,38,37,-1
"fc0e049d56024bc9a02c9a9c435c3df7","fc0e049d56024bc9a02c9a9c435c3df7",21937630,7,0,1,100,38,38,0
"fc0e049d56024bc9a02c9a9c435c3df7","b613861cecf84ffcab01afb23f660475",21937630,1,-68,0,101,38,1,-37
"b613861cecf84ffcab01afb23f660475","fc0e049d56024bc9a02c9a9c435c3df7",21937630,1,68,0,102,1,38,37
"fc0e049d56024bc9a02c9a9c435c3df7","67a089198fcb4e1c8f2385786c2b296f",21937630,1,4,0,107,38,39,1
"67a089198fcb4e1c8f2385786c2b296f","64d48c6c9c7940639a932219a6c87198",21937630,4,1,0,108,39,40,1
"64d48c6c9c7940639a932219a6c87198","64d48c6c9c7940639a932219a6c87198",21937630,8,0,1,109,40,40,0
"64d48c6c9c7940639a932219a6c87198","67a089198fcb4e1c8f2385786c2b296f",21937630,4,-1,0,115,40,39,-1
"67a089198fcb4e1c8f2385786c2b296f","b534b89233134e30a9b5645138bfa9ee",21937630,3,4,0,116,39,41,2
"b534b89233134e30a9b5645138bfa9ee","67a089198fcb4e1c8f2385786c2b296f",21937630,1,-4,0,117,41,39,-2
"b534b89233134e30a9b5645138bfa9ee","0e37b720d23b4e7f8b313e79313fd107",21937630,1,3,0,121,41,44,3
"0e37b720d23b4e7f8b313e79313fd107","0e37b720d23b4e7f8b313e79313fd107",21937630,2,0,1,122,44,44,0
"0e37b720d23b4e7f8b313e79313fd107","6875d67fdd5f48168b62719df449bebd",21937630,1,1,0,124,44,45,1
"6875d67fdd5f48168b62719df449bebd","6875d67fdd5f48168b62719df449bebd",21937630,1,0,1,125,45,45,0
"6875d67fdd5f48168b62719df449bebd","b534b89233134e30a9b5645138bfa9ee",21937630,1,-4,0,126,45,41,-4
"b534b89233134e30a9b5645138bfa9ee","6e13d61a7bdb44bca949c9f86fab3be5",21937630,2,7,0,127,41,47,6
"6e13d61a7bdb44bca949c9f86fab3be5","d9c8d8c444a64dadbbb508652c721e17",21937630,1,-1,0,128,47,46,-1
"d9c8d8c444a64dadbbb508652c721e17","d0c74f735e024943943e40333d6d337f",21937630,2,6,0,129,46,51,5
"d0c74f735e024943943e40333d6d337f","67a089198fcb4e1c8f2385786c2b296f",21937630,1,-16,0,130,51,39,-12
"b534b89233134e30a9b5645138bfa9ee","b534b89233134e30a9b5645138bfa9ee",21937630,2,0,1,135,41,41,0
"6e13d61a7bdb44bca949c9f86fab3be5","6e13d61a7bdb44bca949c9f86fab3be5",21937630,1,0,1,137,47,47,0
"6e13d61a7bdb44bca949c9f86fab3be5","195f78799f984cc2b06c48dfe36be751",21937630,1,2,0,138,47,49,2
"195f78799f984cc2b06c48dfe36be751","195f78799f984cc2b06c48dfe36be751",21937630,2,0,1,139,49,49,0
"195f78799f984cc2b06c48dfe36be751","d9c8d8c444a64dadbbb508652c721e17",21937630,1,-3,0,141,49,46,-3
"d0c74f735e024943943e40333d6d337f","d0c74f735e024943943e40333d6d337f",21937630,1,0,1,143,51,51,0
"d0c74f735e024943943e40333d6d337f","983f8ff320594b279a7f4a6fe132f9c5",21937630,1,2,0,144,51,53,2
"983f8ff320594b279a7f4a6fe132f9c5","983f8ff320594b279a7f4a6fe132f9c5",21937630,2,0,1,145,53,53,0
"983f8ff320594b279a7f4a6fe132f9c5","35adfa5d923046aebabfefd98f35ff05",21937630,1,1,0,147,53,54,1
"35adfa5d923046aebabfefd98f35ff05","35adfa5d923046aebabfefd98f35ff05",21937630,8,0,1,148,54,54,0
"35adfa5d923046aebabfefd98f35ff05","b6f8a98476224da1b40e555ececc7ed8",21937630,1,1,0,156,54,55,1
"b6f8a98476224da1b40e555ececc7ed8","b6f8a98476224da1b40e555ececc7ed8",21937630,2,0,1,157,55,55,0
"b6f8a98476224da1b40e555ececc7ed8","86e22cb5fe0e4b47a9489ecddf7ed78f",21937630,1,1,0,159,55,56,1
"86e22cb5fe0e4b47a9489ecddf7ed78f","86e22cb5fe0e4b47a9489ecddf7ed78f",21937630,2,0,1,160,56,56,0
"86e22cb5fe0e4b47a9489ecddf7ed78f","f924752d8a1149668870b1e7698486f7",21937630,1,-6,0,162,56,50,-6
"f924752d8a1149668870b1e7698486f7","78f30e4dcac84e3cbea8b2cc6e0d62b3",21937630,2,10,0,163,50,59,9
"78f30e4dcac84e3cbea8b2cc6e0d62b3","a1f2f12debe5432fb7a70bcd12bacfb9",21937630,2,-1,0,164,59,58,-1
"a1f2f12debe5432fb7a70bcd12bacfb9","a1f2f12debe5432fb7a70bcd12bacfb9",21937630,39,0,1,165,58,58,0
"a1f2f12debe5432fb7a70bcd12bacfb9","12aa6e1672ac4e7aa6449a7a8609cd72",21937630,1,-1,0,168,58,57,-1
"12aa6e1672ac4e7aa6449a7a8609cd72","d0c74f735e024943943e40333d6d337f",21937630,1,-7,0,169,57,51,-6
"d0c74f735e024943943e40333d6d337f","f924752d8a1149668870b1e7698486f7",21937630,1,-1,0,170,51,50,-1
"a1f2f12debe5432fb7a70bcd12bacfb9","78f30e4dcac84e3cbea8b2cc6e0d62b3",21937630,1,1,0,209,58,59,1
"78f30e4dcac84e3cbea8b2cc6e0d62b3","78f30e4dcac84e3cbea8b2cc6e0d62b3",21937630,12,0,1,210,59,59,0
"78f30e4dcac84e3cbea8b2cc6e0d62b3","12aa6e1672ac4e7aa6449a7a8609cd72",21937630,1,-2,0,222,59,57,-2
"12aa6e1672ac4e7aa6449a7a8609cd72","bc42d26810654ea9a1df1efe1e58c7d5",21937630,1,7,0,223,57,63,6
"bc42d26810654ea9a1df1efe1e58c7d5","a0a418b8540d479fa6e0f653b701da8b",21937630,2,1,0,224,63,64,1
"a0a418b8540d479fa6e0f653b701da8b","4c943503763e4e349906eea3ed3c8e86",21937630,1,-3,0,225,64,61,-3
"4c943503763e4e349906eea3ed3c8e86","4c943503763e4e349906eea3ed3c8e86",21937630,1,0,1,226,61,61,0
"4c943503763e4e349906eea3ed3c8e86","bc42d26810654ea9a1df1efe1e58c7d5",21937630,1,2,0,227,61,63,2
"bc42d26810654ea9a1df1efe1e58c7d5","bc42d26810654ea9a1df1efe1e58c7d5",21937630,3,0,1,228,63,63,0
"a0a418b8540d479fa6e0f653b701da8b","a0a418b8540d479fa6e0f653b701da8b",21937630,3,0,1,232,64,64,0
"a0a418b8540d479fa6e0f653b701da8b","309ccf3cc4fe429d9bfbaef53d3fa479",21937630,1,-4,0,235,64,60,-4
"309ccf3cc4fe429d9bfbaef53d3fa479","b534b89233134e30a9b5645138bfa9ee",21937630,1,-23,0,236,60,41,-19
"d646286c8051419bbc2e31dd1db55ca8","267f883678b24aed855fde42524975d9",21937630,1,4,0,238,67,71,4
"267f883678b24aed855fde42524975d9","267f883678b24aed855fde42524975d9",21937630,1,0,1,239,71,71,0
"267f883678b24aed855fde42524975d9","88fff56d0342490dbef9040750a20f6c",21937630,1,1,0,240,71,72,1
"88fff56d0342490dbef9040750a20f6c","88fff56d0342490dbef9040750a20f6c",21937630,1,0,1,241,72,72,0
"88fff56d0342490dbef9040750a20f6c","adb17b12b66c4a49a85fd34322f7df70",21937630,1,1,0,242,72,73,1
"adb17b12b66c4a49a85fd34322f7df70","adb17b12b66c4a49a85fd34322f7df70",21937630,1,0,1,243,73,73,0
"adb17b12b66c4a49a85fd34322f7df70","a2becd407db34b189200a32546d9d569",21937630,1,3,0,244,73,75,2
"a2becd407db34b189200a32546d9d569","d646286c8051419bbc2e31dd1db55ca8",21937630,1,-9,0,245,75,67,-8
"d646286c8051419bbc2e31dd1db55ca8","a2becd407db34b189200a32546d9d569",21937630,1,9,0,246,67,75,8
"a2becd407db34b189200a32546d9d569","a2becd407db34b189200a32546d9d569",21937630,1,0,1,247,75,75,0
"a2becd407db34b189200a32546d9d569","58c22b011d0f4c2ea6d13615edbb9eeb",21937630,1,2,0,248,75,77,2
"58c22b011d0f4c2ea6d13615edbb9eeb","58c22b011d0f4c2ea6d13615edbb9eeb",21937630,12,0,1,249,77,77,0
"58c22b011d0f4c2ea6d13615edbb9eeb","dd76e1861dc9461c830888729d091ee0",21937630,1,1,0,261,77,78,1
"dd76e1861dc9461c830888729d091ee0","dd76e1861dc9461c830888729d091ee0",21937630,5,0,1,262,78,78,0
"dd76e1861dc9461c830888729d091ee0","cd1d828f1a694b87913a7ea66c23803e",21937630,1,1,0,267,78,79,1
"cd1d828f1a694b87913a7ea66c23803e","cd1d828f1a694b87913a7ea66c23803e",21937630,2,0,1,268,79,79,0
"cd1d828f1a694b87913a7ea66c23803e","9176a3c2b4d2465fa8b0c67096c2a97e",21937630,1,1,0,270,79,80,1
"9176a3c2b4d2465fa8b0c67096c2a97e","9176a3c2b4d2465fa8b0c67096c2a97e",21937630,5,0,1,271,80,80,0
"9176a3c2b4d2465fa8b0c67096c2a97e","f8ec6445f7194e25b9101d4fbcb07a18",21937630,1,1,0,276,80,81,1
"f8ec6445f7194e25b9101d4fbcb07a18","f8ec6445f7194e25b9101d4fbcb07a18",21937630,2,0,1,277,81,81,0
"f8ec6445f7194e25b9101d4fbcb07a18","140d5b27b8574befad82c0a013b59dfa",21937630,1,-7,0,279,81,74,-7
"d18a9ea32855445f8736581f5cb119ce","f564483cbd7a407681aa2fcca518cf5f",21937630,1,4,0,281,82,85,3
"f564483cbd7a407681aa2fcca518cf5f","f564483cbd7a407681aa2fcca518cf5f",21937630,4,0,1,282,85,85,0
"f564483cbd7a407681aa2fcca518cf5f","18fd01350bd5434ca636d59a599d768a",21937630,1,1,0,286,85,86,1
"18fd01350bd5434ca636d59a599d768a","18fd01350bd5434ca636d59a599d768a",21937630,9,0,1,287,86,86,0
"18fd01350bd5434ca636d59a599d768a","ae5ac430ea254e708a6f5deaaf7464ae",21937630,1,-2,0,296,86,84,-2
"6a9f0ef185fb47f0937e29daa1c71ed5","c681290961c94c4caf23b529d1ae6b9a",21937630,1,-2,0,302,90,88,-2
"c681290961c94c4caf23b529d1ae6b9a","c681290961c94c4caf23b529d1ae6b9a",21937630,1,0,1,303,88,88,0
"c681290961c94c4caf23b529d1ae6b9a","d646286c8051419bbc2e31dd1db55ca8",21937630,1,-25,0,304,88,67,-21
"d646286c8051419bbc2e31dd1db55ca8","e20db35ced8544ddac5bc3839145e463",21937630,1,30,0,305,67,91,24
"e20db35ced8544ddac5bc3839145e463","1febb706d7a34005ae8711ed49c76e64",21937630,1,3,0,306,91,94,3
"1febb706d7a34005ae8711ed49c76e64","1febb706d7a34005ae8711ed49c76e64",21937630,5,0,1,307,94,94,0
"1febb706d7a34005ae8711ed49c76e64","8f73ba6f5a0042f2850356ac38ac6f24",21937630,1,1,0,312,94,95,1
"8f73ba6f5a0042f2850356ac38ac6f24","8f73ba6f5a0042f2850356ac38ac6f24",21937630,5,0,1,313,95,95,0
"8f73ba6f5a0042f2850356ac38ac6f24","e2260b86653c46d7b14a41fb419dbf8c",21937630,1,1,0,318,95,96,1
"e2260b86653c46d7b14a41fb419dbf8c","e2260b86653c46d7b14a41fb419dbf8c",21937630,5,0,1,319,96,96,0
"e2260b86653c46d7b14a41fb419dbf8c","35eb641ad1d845bbba54915bce75a962",21937630,1,1,0,321,96,97,1
"35eb641ad1d845bbba54915bce75a962","35eb641ad1d845bbba54915bce75a962",21937630,5,0,1,322,97,97,0
"35eb641ad1d845bbba54915bce75a962","08be90ffbeea4795a138cd42ed8db56f",21937630,1,1,0,327,97,98,1
"08be90ffbeea4795a138cd42ed8db56f","08be90ffbeea4795a138cd42ed8db56f",21937630,7,0,1,328,98,98,0
"08be90ffbeea4795a138cd42ed8db56f","3007433c8f584dcbb5ac159c1c5f2be3",21937630,1,1,0,335,98,99,1
"3007433c8f584dcbb5ac159c1c5f2be3","3007433c8f584dcbb5ac159c1c5f2be3",21937630,2,0,1,336,99,99,0
"3007433c8f584dcbb5ac159c1c5f2be3","e20db35ced8544ddac5bc3839145e463",21937630,1,-8,0,338,99,91,-8
"e20db35ced8544ddac5bc3839145e463","00ae5f0c51874a73a41ebea838d95682",21937630,2,11,0,339,91,101,10
"00ae5f0c51874a73a41ebea838d95682","d391c8b6e56a43a7b654e9dee02d904b",21937630,2,2,0,340,101,103,2
"d391c8b6e56a43a7b654e9dee02d904b","d391c8b6e56a43a7b654e9dee02d904b",21937630,16,0,1,341,103,103,0
"d391c8b6e56a43a7b654e9dee02d904b","6111116566fc4fd9abba409322bea245",21937630,1,1,0,357,103,104,1
"6111116566fc4fd9abba409322bea245","6111116566fc4fd9abba409322bea245",21937630,2,0,1,358,104,104,0
"6111116566fc4fd9abba409322bea245","a81b2235cb9c499eb9ea8ee0a8dd9725",21937630,1,1,0,360,104,105,1
"a81b2235cb9c499eb9ea8ee0a8dd9725","a81b2235cb9c499eb9ea8ee0a8dd9725",21937630,2,0,1,361,105,105,0
"a81b2235cb9c499eb9ea8ee0a8dd9725","2d4e0ab0ef3b4d73b82c72d4621a7579",21937630,1,1,0,363,105,106,1
"2d4e0ab0ef3b4d73b82c72d4621a7579","2d4e0ab0ef3b4d73b82c72d4621a7579",21937630,2,0,1,364,106,106,0
"2d4e0ab0ef3b4d73b82c72d4621a7579","8bdebf492ebd4e62b0d522e8ab5e5197",21937630,1,1,0,366,106,107,1
"8bdebf492ebd4e62b0d522e8ab5e5197","8bdebf492ebd4e62b0d522e8ab5e5197",21937630,2,0,1,367,107,107,0
"8bdebf492ebd4e62b0d522e8ab5e5197","73039f8c1eb9409cb4caee2cf968001e",21937630,1,-7,0,369,107,100,-7
"73039f8c1eb9409cb4caee2cf968001e","4280927ec4d643238aa49c32f9e06c6c",21937630,2,10,0,370,100,109,9
"4280927ec4d643238aa49c32f9e06c6c","fc44e6a5f7654430af1227838224dceb",21937630,1,2,0,371,109,111,2
"fc44e6a5f7654430af1227838224dceb","fc44e6a5f7654430af1227838224dceb",21937630,6,0,1,372,111,111,0
"fc44e6a5f7654430af1227838224dceb","08111f75e22d409998cf8b85bd431f0a",21937630,1,-3,0,378,111,108,-3
"08111f75e22d409998cf8b85bd431f0a","e20db35ced8544ddac5bc3839145e463",21937630,1,-19,0,379,108,91,-17
"e20db35ced8544ddac5bc3839145e463","e2260b86653c46d7b14a41fb419dbf8c",21937630,1,5,0,380,91,96,5
"e2260b86653c46d7b14a41fb419dbf8c","e20db35ced8544ddac5bc3839145e463",21937630,1,-5,0,384,96,91,-5
"d391c8b6e56a43a7b654e9dee02d904b","73039f8c1eb9409cb4caee2cf968001e",21937630,1,-3,0,387,103,100,-3
"4280927ec4d643238aa49c32f9e06c6c","08111f75e22d409998cf8b85bd431f0a",21937630,1,-1,0,389,109,108,-1
"08111f75e22d409998cf8b85bd431f0a","71cec822bcff4f30a20e75dc63ef7b65",21937630,1,9,0,390,108,116,8
"71cec822bcff4f30a20e75dc63ef7b65","71cec822bcff4f30a20e75dc63ef7b65",21937630,7,0,1,391,116,116,0
"71cec822bcff4f30a20e75dc63ef7b65","37319e88176d4aefa91d7a9980dbae91",21937630,1,-4,0,398,116,112,-4
"37319e88176d4aefa91d7a9980dbae91","62bff51286ef4f348717a3cf6fe2318f",21937630,1,9,0,399,112,120,8
"62bff51286ef4f348717a3cf6fe2318f","62bff51286ef4f348717a3cf6fe2318f",21937630,4,0,1,400,120,120,0
"62bff51286ef4f348717a3cf6fe2318f","b1cd0e7dc3ad4a8eb91a4bfdbeb025b0",21937630,1,-2,0,404,120,118,-2
"b1cd0e7dc3ad4a8eb91a4bfdbeb025b0","b1cd0e7dc3ad4a8eb91a4bfdbeb025b0",21937630,4,0,1,405,118,118,0
"b1cd0e7dc3ad4a8eb91a4bfdbeb025b0","779f9ddd1fd14d1e9e69f72219a1fdbd",21937630,1,5,0,409,118,121,3
"779f9ddd1fd14d1e9e69f72219a1fdbd","e20db35ced8544ddac5bc3839145e463",21937630,1,-36,0,410,121,91,-30
"e20db35ced8544ddac5bc3839145e463","ae26e6cda8ad4a3f81bd347560d9579f",21937630,1,40,0,411,91,125,34
"ae26e6cda8ad4a3f81bd347560d9579f","ae26e6cda8ad4a3f81bd347560d9579f",21937630,3,0,1,412,125,125,0
"ae26e6cda8ad4a3f81bd347560d9579f","ee48df95832b4374aa273ceb27ec1315",21937630,1,1,0,415,125,126,1
"ee48df95832b4374aa273ceb27ec1315","ee48df95832b4374aa273ceb27ec1315",21937630,4,0,1,416,126,126,0
"ee48df95832b4374aa273ceb27ec1315","7a439da90b394756ad1777fc4c6dead5",21937630,1,1,0,420,126,127,1
"7a439da90b394756ad1777fc4c6dead5","7a439da90b394756ad1777fc4c6dead5",21937630,3,0,1,421,127,127,0
"7a439da90b394756ad1777fc4c6dead5","779f9ddd1fd14d1e9e69f72219a1fdbd",21937630,1,-6,0,424,127,121,-6
"779f9ddd1fd14d1e9e69f72219a1fdbd","a8dd5213034441ac92724b4e83eb0bb2",21937630,1,9,0,425,121,129,8
"a8dd5213034441ac92724b4e83eb0bb2","8115eab6556b45f5b415c3b8c26a12e5",21937630,1,2,0,426,129,131,2
"8115eab6556b45f5b415c3b8c26a12e5","8115eab6556b45f5b415c3b8c26a12e5",21937630,2,0,1,427,131,131,0
"8115eab6556b45f5b415c3b8c26a12e5","ec34b06efd844b46a4c4818ecdb9b8f4",21937630,1,1,0,429,131,132,1
"ec34b06efd844b46a4c4818ecdb9b8f4","ec34b06efd844b46a4c4818ecdb9b8f4",21937630,2,0,1,430,132,132,0
"ec34b06efd844b46a4c4818ecdb9b8f4","c2e1c2b9eac64109b343a088584b576b",21937630,1,1,0,432,132,133,1
"c2e1c2b9eac64109b343a088584b576b","c2e1c2b9eac64109b343a088584b576b",21937630,5,0,1,433,133,133,0
"c2e1c2b9eac64109b343a088584b576b","579338175e0b4bbb8ef3b712b5d8b54e",21937630,1,-5,0,438,133,128,-5
"579338175e0b4bbb8ef3b712b5d8b54e","8bc5795d6a984a3eace4e2811e52dd4f",21937630,1,8,0,439,128,135,7
"b416d47c56a742199b5d7c7f19d6503a","cd4532ad48034873ba8bce2aac0c9808",21937630,1,4,0,442,134,137,3
"cd4532ad48034873ba8bce2aac0c9808","779f9ddd1fd14d1e9e69f72219a1fdbd",21937630,1,-19,0,446,137,121,-16
"779f9ddd1fd14d1e9e69f72219a1fdbd","df1de691dafe4549a18a4398ee9dfaf9",21937630,1,23,0,447,121,139,18
"df1de691dafe4549a18a4398ee9dfaf9","83d311bed5374fee83d8d67a7d9d82dc",21937630,1,5,0,448,139,144,5
"83d311bed5374fee83d8d67a7d9d82dc","83d311bed5374fee83d8d67a7d9d82dc",21937630,1,0,1,449,144,144,0
"83d311bed5374fee83d8d67a7d9d82dc","402bba41861d43acb52a5abb89e8831e",21937630,1,1,0,450,144,145,1
"402bba41861d43acb52a5abb89e8831e","402bba41861d43acb52a5abb89e8831e",21937630,2,0,1,451,145,145,0
"402bba41861d43acb52a5abb89e8831e","8aae34f5ddbb4052a709b12e6b0d40fa",21937630,1,3,0,453,145,147,2
"8aae34f5ddbb4052a709b12e6b0d40fa","df1de691dafe4549a18a4398ee9dfaf9",21937630,1,-9,0,454,147,139,-8
"df1de691dafe4549a18a4398ee9dfaf9","645b3f0249f64f76af2e19eb4d0e55b7",21937630,1,11,0,455,139,149,10
"645b3f0249f64f76af2e19eb4d0e55b7","645b3f0249f64f76af2e19eb4d0e55b7",21937630,5,0,1,456,149,149,0
"645b3f0249f64f76af2e19eb4d0e55b7","7e7b8db5064d4369805ab370aac5ddfb",21937630,1,1,0,461,149,150,1
"7e7b8db5064d4369805ab370aac5ddfb","7e7b8db5064d4369805ab370aac5ddfb",21937630,2,0,1,462,150,150,0
"7e7b8db5064d4369805ab370aac5ddfb","8956d210ae7f41968fada86d4c979d6a",21937630,1,1,0,464,150,151,1
"8956d210ae7f41968fada86d4c979d6a","8956d210ae7f41968fada86d4c979d6a",21937630,5,0,1,465,151,151,0
"8956d210ae7f41968fada86d4c979d6a","f902b0f41b544d4dbf79664fd233648d",21937630,1,-5,0,470,151,146,-5
"f902b0f41b544d4dbf79664fd233648d","ae781e8b775e4ccd93bc800dad5c8376",21937630,1,8,0,471,146,153,7
"ae781e8b775e4ccd93bc800dad5c8376","ae781e8b775e4ccd93bc800dad5c8376",21937630,5,0,1,472,153,153,0
"ae781e8b775e4ccd93bc800dad5c8376","06882a8492d9499aa31555567f575ecb",21937630,1,1,0,477,153,154,1
"06882a8492d9499aa31555567f575ecb","06882a8492d9499aa31555567f575ecb",21937630,1,0,1,478,154,154,0
"06882a8492d9499aa31555567f575ecb","f293c508f409466a8f27ddd7d1e40b20",21937630,1,1,0,479,154,155,1
"f293c508f409466a8f27ddd7d1e40b20","f293c508f409466a8f27ddd7d1e40b20",21937630,10,0,1,480,155,155,0
"f293c508f409466a8f27ddd7d1e40b20","cc4ddef5bbbe48ebb605141b347c4ed1",21937630,1,1,0,490,155,156,1
"cc4ddef5bbbe48ebb605141b347c4ed1","cc4ddef5bbbe48ebb605141b347c4ed1",21937630,1,0,1,491,156,156,0
"cc4ddef5bbbe48ebb605141b347c4ed1","f03480cf4eba413194d7af52fc0e7f28",21937630,1,-4,0,492,156,152,-4
"f03480cf4eba413194d7af52fc0e7f28","d313cec988a84645bee413e8d4724a4b",21937630,1,7,0,493,152,158,6
"d313cec988a84645bee413e8d4724a4b","d313cec988a84645bee413e8d4724a4b",21937630,7,0,1,494,158,158,0
"d313cec988a84645bee413e8d4724a4b","df1de691dafe4549a18a4398ee9dfaf9",21937630,2,-22,0,498,158,139,-19
"df1de691dafe4549a18a4398ee9dfaf9","78adeee1fa2c4fe0bc73f7bca9fcee86",21937630,2,26,0,499,139,160,21
"78adeee1fa2c4fe0bc73f7bca9fcee86","dc60696c76a74368a60f72246e47700d",21937630,1,-3,0,500,160,159,-1
"dc60696c76a74368a60f72246e47700d","78adeee1fa2c4fe0bc73f7bca9fcee86",21937630,2,3,0,501,159,160,1
"78adeee1fa2c4fe0bc73f7bca9fcee86","df1de691dafe4549a18a4398ee9dfaf9",21937630,2,-26,0,502,160,139,-21
"78adeee1fa2c4fe0bc73f7bca9fcee86","d313cec988a84645bee413e8d4724a4b",21937630,1,-4,0,504,160,158,-2
"df1de691dafe4549a18a4398ee9dfaf9","df1de691dafe4549a18a4398ee9dfaf9",21937630,1,0,1,508,139,139,0
"df1de691dafe4549a18a4398ee9dfaf9","8aae34f5ddbb4052a709b12e6b0d40fa",21937630,1,9,0,509,139,147,8
"8aae34f5ddbb4052a709b12e6b0d40fa","d313cec988a84645bee413e8d4724a4b",21937630,1,13,0,510,147,158,11
"d313cec988a84645bee413e8d4724a4b","f902b0f41b544d4dbf79664fd233648d",21937630,1,-14,0,511,158,146,-12
"f902b0f41b544d4dbf79664fd233648d","d313cec988a84645bee413e8d4724a4b",21937630,1,14,0,512,146,158,12
"d313cec988a84645bee413e8d4724a4b","dc60696c76a74368a60f72246e47700d",21937630,1,1,0,514,158,159,1
"dc60696c76a74368a60f72246e47700d","dc60696c76a74368a60f72246e47700d",21937630,1,0,1,515,159,159,0
"df1de691dafe4549a18a4398ee9dfaf9","65202579580f4ad38d734b4ee39d22a8",21937630,1,31,0,518,139,164,25
"65202579580f4ad38d734b4ee39d22a8","65202579580f4ad38d734b4ee39d22a8",21937630,73,0,1,519,164,164,0
"65202579580f4ad38d734b4ee39d22a8","78adeee1fa2c4fe0bc73f7bca9fcee86",21937630,3,-5,0,521,164,160,-4
"78adeee1fa2c4fe0bc73f7bca9fcee86","65202579580f4ad38d734b4ee39d22a8",21937630,4,5,0,522,160,164,4
"65202579580f4ad38d734b4ee39d22a8","8959e6304a0348309a771e4d08d1b64a",21937630,1,-1,0,527,164,163,-1
"8959e6304a0348309a771e4d08d1b64a","65202579580f4ad38d734b4ee39d22a8",21937630,1,1,0,528,163,164,1
"78adeee1fa2c4fe0bc73f7bca9fcee86","3cbcea2be0984e7dbd5a48195af10ce7",21937630,1,8,0,540,160,165,5
"3cbcea2be0984e7dbd5a48195af10ce7","82e6285962b8400d9d6fc32436022a94",21937630,2,2,0,541,165,167,2
"82e6285962b8400d9d6fc32436022a94","3cbcea2be0984e7dbd5a48195af10ce7",21937630,3,-2,0,542,167,165,-2
"3cbcea2be0984e7dbd5a48195af10ce7","a9ac840f098c4bd0a2ee896214ce29cd",21937630,1,5,0,543,165,168,3
"a9ac840f098c4bd0a2ee896214ce29cd","0c7262dff33c4087bc660ccf40f92f9c",21937630,6,4,0,544,168,169,1
"0c7262dff33c4087bc660ccf40f92f9c","a9ac840f098c4bd0a2ee896214ce29cd",21937630,8,-4,0,545,169,168,-1
"a9ac840f098c4bd0a2ee896214ce29cd","b2275c3fad834f8d90737a2d9a6927d6",21937630,2,7,0,546,168,172,4
"b2275c3fad834f8d90737a2d9a6927d6","0c7262dff33c4087bc660ccf40f92f9c",21937630,6,-3,0,547,172,169,-3
"a9ac840f098c4bd0a2ee896214ce29cd","a9ac840f098c4bd0a2ee896214ce29cd",21937630,4,0,1,549,168,168,0
"0c7262dff33c4087bc660ccf40f92f9c","b2275c3fad834f8d90737a2d9a6927d6",21937630,6,3,0,551,169,172,3
"0c7262dff33c4087bc660ccf40f92f9c","0c7262dff33c4087bc660ccf40f92f9c",21937630,2,0,1,561,169,169,0
"b2275c3fad834f8d90737a2d9a6927d6","a9ac840f098c4bd0a2ee896214ce29cd",21937630,1,-7,0,564,172,168,-4
"a9ac840f098c4bd0a2ee896214ce29cd","3cbcea2be0984e7dbd5a48195af10ce7",21937630,1,-5,0,567,168,165,-3
"3cbcea2be0984e7dbd5a48195af10ce7","78adeee1fa2c4fe0bc73f7bca9fcee86",21937630,4,-8,0,570,165,160,-5
"65202579580f4ad38d734b4ee39d22a8","3cbcea2be0984e7dbd5a48195af10ce7",21937630,2,3,0,622,164,165,1
"78adeee1fa2c4fe0bc73f7bca9fcee86","82e6285962b8400d9d6fc32436022a94",21937630,2,10,0,624,160,167,7
"82e6285962b8400d9d6fc32436022a94","0c7262dff33c4087bc660ccf40f92f9c",21937630,1,7,0,640,167,169,2
"a9ac840f098c4bd0a2ee896214ce29cd","b7719e26494940efa49512aedd0aac79",21937630,1,-205,0,644,168,20,-148
"d4c3b003e8274e429d2fa688d73fde6d","5bc03c8f16354d04bd51f5bb93559ad3",21937630,1,4,0,648,22,26,4
"5bc03c8f16354d04bd51f5bb93559ad3","b7719e26494940efa49512aedd0aac79",21937630,1,-7,0,649,26,20,-6
"b7719e26494940efa49512aedd0aac79","d4f45188d3c84a02ba08454e6403a818",21937630,2,5,0,650,20,24,4
"d4c3b003e8274e429d2fa688d73fde6d","0c7262dff33c4087bc660ccf40f92f9c",21937630,2,206,0,652,22,169,147
"b2275c3fad834f8d90737a2d9a6927d6","b2275c3fad834f8d90737a2d9a6927d6",21937630,62,0,1,655,172,172,0
"b2275c3fad834f8d90737a2d9a6927d6","eb515a26030b41f8a82a1e6114420bad",21937630,1,1,0,724,172,173,1
"eb515a26030b41f8a82a1e6114420bad","eb515a26030b41f8a82a1e6114420bad",21937630,5,0,1,725,173,173,0
"eb515a26030b41f8a82a1e6114420bad","0c7262dff33c4087bc660ccf40f92f9c",21937630,1,-4,0,730,173,169,-4
"0c7262dff33c4087bc660ccf40f92f9c","b42cc17b7de840f181a704558d0bc845",21937630,2,7,0,731,169,175,6
"b42cc17b7de840f181a704558d0bc845","801f9e9135034f49bf5f8b4bdefedb41",21937630,1,2,0,732,175,177,2
"801f9e9135034f49bf5f8b4bdefedb41","801f9e9135034f49bf5f8b4bdefedb41",21937630,7,0,1,733,177,177,0
"801f9e9135034f49bf5f8b4bdefedb41","362fcb0699a14845ab29b2340093e528",21937630,1,-3,0,740,177,174,-3
"362fcb0699a14845ab29b2340093e528","ea38cc0e6e6e41edbabf210220808bf9",21937630,1,6,0,741,174,179,5
"ea38cc0e6e6e41edbabf210220808bf9","b87c552dd247427abe6ab5795b9c9d43",21937630,2,2,0,742,179,181,2
"b87c552dd247427abe6ab5795b9c9d43","b87c552dd247427abe6ab5795b9c9d43",21937630,12,0,1,743,181,181,0
"b87c552dd247427abe6ab5795b9c9d43","139b097acfca451689d80c9c6eebdf7b",21937630,2,-3,0,755,181,178,-3
"139b097acfca451689d80c9c6eebdf7b","30f660a1feb34582a739722532524f79",21937630,2,6,0,756,178,183,5
"30f660a1feb34582a739722532524f79","30f660a1feb34582a739722532524f79",21937630,9,0,1,757,183,183,0
"30f660a1feb34582a739722532524f79","ea38cc0e6e6e41edbabf210220808bf9",21937630,1,-5,0,758,183,179,-4
"b87c552dd247427abe6ab5795b9c9d43","2024b4885bd14338a39b7b509acbbd02",21937630,1,2,0,760,181,182,1
"2024b4885bd14338a39b7b509acbbd02","139b097acfca451689d80c9c6eebdf7b",21937630,1,-5,0,761,182,178,-4
"139b097acfca451689d80c9c6eebdf7b","b42cc17b7de840f181a704558d0bc845",21937630,1,-4,0,762,178,175,-3
"b42cc17b7de840f181a704558d0bc845","362fcb0699a14845ab29b2340093e528",21937630,1,-1,0,763,175,174,-1
"362fcb0699a14845ab29b2340093e528","30f660a1feb34582a739722532524f79",21937630,1,11,0,764,174,183,9
"30f660a1feb34582a739722532524f79","2024b4885bd14338a39b7b509acbbd02",21937630,2,-1,0,773,183,182,-1
"2024b4885bd14338a39b7b509acbbd02","0c7262dff33c4087bc660ccf40f92f9c",21937630,2,-16,0,774,182,169,-13
"0c7262dff33c4087bc660ccf40f92f9c","b7719e26494940efa49512aedd0aac79",21937630,1,-209,0,775,169,20,-149
"b42cc17b7de840f181a704558d0bc845","0c7262dff33c4087bc660ccf40f92f9c",21937630,1,-7,0,780,175,169,-6
"0c7262dff33c4087bc660ccf40f92f9c","ea38cc0e6e6e41edbabf210220808bf9",21937630,1,12,0,781,169,179,10
"ea38cc0e6e6e41edbabf210220808bf9","362fcb0699a14845ab29b2340093e528",21937630,1,-6,0,782,179,174,-5
"362fcb0699a14845ab29b2340093e528","b87c552dd247427abe6ab5795b9c9d43",21937630,1,8,0,783,174,181,7
"2024b4885bd14338a39b7b509acbbd02","cf4c280bad6a43e6b131d8385ef9ef3f",21937630,1,3,0,787,182,184,2
"cf4c280bad6a43e6b131d8385ef9ef3f","2024b4885bd14338a39b7b509acbbd02",21937630,1,-3,0,788,184,182,-2
"2024b4885bd14338a39b7b509acbbd02","c3f63fe50d8e487c86bf8ef76c9cadd3",21937630,1,4,0,789,182,185,3
"c3f63fe50d8e487c86bf8ef76c9cadd3","c3f63fe50d8e487c86bf8ef76c9cadd3",21937630,2,0,1,790,185,185,0
"c3f63fe50d8e487c86bf8ef76c9cadd3","0c7262dff33c4087bc660ccf40f92f9c",21937630,1,-20,0,792,185,169,-16
"0c7262dff33c4087bc660ccf40f92f9c","c8e371568a0c4391b25796ae4e91952e",21937630,4,23,0,793,169,186,17
"c8e371568a0c4391b25796ae4e91952e","7d932b23e1c84326ae5aa4d3c0d813d1",21937630,1,2,0,794,186,188,2
"7d932b23e1c84326ae5aa4d3c0d813d1","7d932b23e1c84326ae5aa4d3c0d813d1",21937630,2,0,1,795,188,188,0
"7d932b23e1c84326ae5aa4d3c0d813d1","c8e371568a0c4391b25796ae4e91952e",21937630,1,-2,0,797,188,186,-2
"c8e371568a0c4391b25796ae4e91952e","ab11d94c6c8948ea90b88f19d2cd502b",21937630,2,5,0,798,186,190,4
"ab11d94c6c8948ea90b88f19d2cd502b","f992451ed6ad4e68bb9e68ad6be7c4be",21937630,1,2,0,799,190,192,2
"f992451ed6ad4e68bb9e68ad6be7c4be","f992451ed6ad4e68bb9e68ad6be7c4be",21937630,5,0,1,800,192,192,0
"f992451ed6ad4e68bb9e68ad6be7c4be","6cd2dcaac46847d4a0bc53f296d90375",21937630,1,3,0,801,192,194,2
"6cd2dcaac46847d4a0bc53f296d90375","07b44a7a51e94c78b411c753fc39dab0",21937630,1,-6,0,802,194,189,-5
"07b44a7a51e94c78b411c753fc39dab0","2d2580c9411c4972909db508d6956a58",21937630,1,8,0,803,189,196,7
"2d2580c9411c4972909db508d6956a58","2d2580c9411c4972909db508d6956a58",21937630,2,0,1,804,196,196,0
"2d2580c9411c4972909db508d6956a58","5bddb3d9ed264f3984702f048c7e5340",21937630,1,1,0,806,196,197,1
"5bddb3d9ed264f3984702f048c7e5340","5bddb3d9ed264f3984702f048c7e5340",21937630,2,0,1,807,197,197,0
"5bddb3d9ed264f3984702f048c7e5340","d5e8e2bd12a2466b9d6d90855f0eb079",21937630,1,1,0,809,197,198,1
"d5e8e2bd12a2466b9d6d90855f0eb079","d5e8e2bd12a2466b9d6d90855f0eb079",21937630,3,0,1,810,198,198,0
"d5e8e2bd12a2466b9d6d90855f0eb079","017d7ca8e0394b91aaadc9574df2202c",21937630,1,-5,0,813,198,193,-5
"017d7ca8e0394b91aaadc9574df2202c","54e8e9f0ea3e45c4bf3b8ac799ee31b1",21937630,1,8,0,814,193,200,7
"54e8e9f0ea3e45c4bf3b8ac799ee31b1","54e8e9f0ea3e45c4bf3b8ac799ee31b1",21937630,1,0,1,815,200,200,0
"54e8e9f0ea3e45c4bf3b8ac799ee31b1","c614a00911be4877a075f19315530fb0",21937630,1,1,0,816,200,201,1
"c614a00911be4877a075f19315530fb0","c614a00911be4877a075f19315530fb0",21937630,6,0,1,817,201,201,0
"c614a00911be4877a075f19315530fb0","a6c21bd8b95249c7972820a7a7d76aff",21937630,1,1,0,823,201,202,1
"a6c21bd8b95249c7972820a7a7d76aff","a6c21bd8b95249c7972820a7a7d76aff",21937630,1,0,1,824,202,202,0
"a6c21bd8b95249c7972820a7a7d76aff","bb329d880ab54120adaf203a693bb203",21937630,1,1,0,825,202,203,1
"bb329d880ab54120adaf203a693bb203","bb329d880ab54120adaf203a693bb203",21937630,1,0,1,826,203,203,0
"bb329d880ab54120adaf203a693bb203","f9170dd6bc6442b4acd832747609b09a",21937630,1,-4,0,827,203,199,-4
"f9170dd6bc6442b4acd832747609b09a","334c2344009840079b1d0e1b7ce3d5a7",21937630,1,7,0,828,199,205,6
"334c2344009840079b1d0e1b7ce3d5a7","334c2344009840079b1d0e1b7ce3d5a7",21937630,1,0,1,829,205,205,0
"334c2344009840079b1d0e1b7ce3d5a7","c8e371568a0c4391b25796ae4e91952e",21937630,1,-23,0,830,205,186,-19
"c8e371568a0c4391b25796ae4e91952e","d7f13c8d63ec4e2aa673fbb9cf9c6933",21937630,3,26,0,831,186,206,20
"d7f13c8d63ec4e2aa673fbb9cf9c6933","b9e80f77c3a44349863b19875725c384",21937630,4,1,0,832,206,207,1
"b9e80f77c3a44349863b19875725c384","7108f0e4c2584f1f9c471689ae4c885c",21937630,5,1,0,833,207,208,1
"7108f0e4c2584f1f9c471689ae4c885c","b9e80f77c3a44349863b19875725c384",21937630,1,-1,0,834,208,207,-1
"b9e80f77c3a44349863b19875725c384","b9e80f77c3a44349863b19875725c384",21937630,46,0,1,835,207,207,0
"7108f0e4c2584f1f9c471689ae4c885c","7108f0e4c2584f1f9c471689ae4c885c",21937630,10,0,1,882,208,208,0
"7108f0e4c2584f1f9c471689ae4c885c","d7f13c8d63ec4e2aa673fbb9cf9c6933",21937630,3,-2,0,892,208,206,-2
"d7f13c8d63ec4e2aa673fbb9cf9c6933","09400e101c5d4b439cf9a26b03aae558",21937630,1,5,0,893,206,210,4
"09400e101c5d4b439cf9a26b03aae558","a88efa7e50ce47159810ab553afa6d3a",21937630,1,2,0,894,210,212,2
"a88efa7e50ce47159810ab553afa6d3a","a88efa7e50ce47159810ab553afa6d3a",21937630,5,0,1,895,212,212,0
"a88efa7e50ce47159810ab553afa6d3a","a875096404ef4a9984b62d74cda916f9",21937630,1,-3,0,900,212,209,-3
"a875096404ef4a9984b62d74cda916f9","be502a7a43c44bf7b682698de79d9369",21937630,1,6,0,901,209,214,5
"f7fb1952f56b4189b86a9f8b7862d2b8","0c7262dff33c4087bc660ccf40f92f9c",21937630,2,-60,0,903,215,169,-46
"c8e371568a0c4391b25796ae4e91952e","0c7262dff33c4087bc660ccf40f92f9c",21937630,1,-23,0,905,186,169,-17
"ab11d94c6c8948ea90b88f19d2cd502b","07b44a7a51e94c78b411c753fc39dab0",21937630,1,-1,0,908,190,189,-1
"07b44a7a51e94c78b411c753fc39dab0","6cd2dcaac46847d4a0bc53f296d90375",21937630,1,6,0,909,189,194,5
"6cd2dcaac46847d4a0bc53f296d90375","017d7ca8e0394b91aaadc9574df2202c",21937630,1,-1,0,910,194,193,-1
"017d7ca8e0394b91aaadc9574df2202c","f9170dd6bc6442b4acd832747609b09a",21937630,1,7,0,911,193,199,6
"f9170dd6bc6442b4acd832747609b09a","c8e371568a0c4391b25796ae4e91952e",21937630,1,-16,0,912,199,186,-13
"7108f0e4c2584f1f9c471689ae4c885c","09400e101c5d4b439cf9a26b03aae558",21937630,1,3,0,916,208,210,2
"09400e101c5d4b439cf9a26b03aae558","d7f13c8d63ec4e2aa673fbb9cf9c6933",21937630,1,-5,0,917,210,206,-4
"d7f13c8d63ec4e2aa673fbb9cf9c6933","be502a7a43c44bf7b682698de79d9369",21937630,1,10,0,918,206,214,8
"be502a7a43c44bf7b682698de79d9369","a875096404ef4a9984b62d74cda916f9",21937630,1,-6,0,919,214,209,-5
"a875096404ef4a9984b62d74cda916f9","f7fb1952f56b4189b86a9f8b7862d2b8",21937630,3,7,0,920,209,215,6
"f7fb1952f56b4189b86a9f8b7862d2b8","f7fb1952f56b4189b86a9f8b7862d2b8",21937630,16,0,1,921,215,215,0
"0c7262dff33c4087bc660ccf40f92f9c","cf4c280bad6a43e6b131d8385ef9ef3f",21937630,1,19,0,938,169,184,15
"cf4c280bad6a43e6b131d8385ef9ef3f","362fcb0699a14845ab29b2340093e528",21937630,1,-13,0,939,184,174,-10
"362fcb0699a14845ab29b2340093e528","139b097acfca451689d80c9c6eebdf7b",21937630,1,5,0,940,174,178,4
"139b097acfca451689d80c9c6eebdf7b","2024b4885bd14338a39b7b509acbbd02",21937630,1,5,0,941,178,182,4
"c8e371568a0c4391b25796ae4e91952e","c8e371568a0c4391b25796ae4e91952e",21937630,1,0,1,944,186,186,0
"c8e371568a0c4391b25796ae4e91952e","f992451ed6ad4e68bb9e68ad6be7c4be",21937630,1,7,0,945,186,192,6
"f992451ed6ad4e68bb9e68ad6be7c4be","07b44a7a51e94c78b411c753fc39dab0",21937630,1,-3,0,950,192,189,-3
"07b44a7a51e94c78b411c753fc39dab0","017d7ca8e0394b91aaadc9574df2202c",21937630,1,5,0,951,189,193,4
"017d7ca8e0394b91aaadc9574df2202c","c8e371568a0c4391b25796ae4e91952e",21937630,1,-9,0,952,193,186,-7
"d7f13c8d63ec4e2aa673fbb9cf9c6933","a875096404ef4a9984b62d74cda916f9",21937630,2,4,0,957,206,209,3
"be502a7a43c44bf7b682698de79d9369","d7f13c8d63ec4e2aa673fbb9cf9c6933",21937630,1,-10,0,960,214,206,-8
"f7fb1952f56b4189b86a9f8b7862d2b8","b860ee85d8bc4a2f97958cfb71be3533",21937630,1,1,0,966,215,216,1
"b860ee85d8bc4a2f97958cfb71be3533","b860ee85d8bc4a2f97958cfb71be3533",21937630,2,0,1,967,216,216,0
"b860ee85d8bc4a2f97958cfb71be3533","ec341f459285443b8361f7f15638ff08",21937630,1,-3,0,969,216,213,-3
"ec341f459285443b8361f7f15638ff08","01b2051f8941460d89945e3b02d1ce78",21937630,1,5,0,970,213,217,4
"01b2051f8941460d89945e3b02d1ce78","91125ca626c5470eb145501f8c37f8db",21937630,1,4,0,971,217,220,3
"91125ca626c5470eb145501f8c37f8db","91125ca626c5470eb145501f8c37f8db",21937630,1,0,1,972,220,220,0
"91125ca626c5470eb145501f8c37f8db","d7f13c8d63ec4e2aa673fbb9cf9c6933",21937630,1,-18,0,973,220,206,-14
"77ecef8eff6b4a2caea7707669bf7475","77ecef8eff6b4a2caea7707669bf7475",21937630,13,0,1,976,222,222,0
"8b9ae98743bd4d4a8a87dff1c1244211","a49a937d6896486d9a5396654abcf2e1",21937630,1,-1,0,996,227,226,-1
"a49a937d6896486d9a5396654abcf2e1","a49a937d6896486d9a5396654abcf2e1",21937630,4,0,1,1000,226,226,0
"a49a937d6896486d9a5396654abcf2e1","8b9ae98743bd4d4a8a87dff1c1244211",21937630,1,1,0,1001,226,227,1
"8b9ae98743bd4d4a8a87dff1c1244211","8b9ae98743bd4d4a8a87dff1c1244211",21937630,17,0,1,1002,227,227,0
"8b9ae98743bd4d4a8a87dff1c1244211","f7906d6f59b9489a91d2ef40db5a474d",21937630,3,-4,0,1007,227,223,-4
"f7906d6f59b9489a91d2ef40db5a474d","a4f40fb48a8542c8949bae1f002cd9bc",21937630,2,9,0,1008,223,231,8
"a4f40fb48a8542c8949bae1f002cd9bc","a4f40fb48a8542c8949bae1f002cd9bc",21937630,5,0,1,1009,231,231,0
"a4f40fb48a8542c8949bae1f002cd9bc","8972c23e32044edb8a78fa1eed4e5947",21937630,1,1,0,1011,231,232,1
"8972c23e32044edb8a78fa1eed4e5947","8972c23e32044edb8a78fa1eed4e5947",21937630,1,0,1,1012,232,232,0
"8972c23e32044edb8a78fa1eed4e5947","92feb4a40f8344d38b6f722e42a53295",21937630,1,1,0,1013,232,233,1
"92feb4a40f8344d38b6f722e42a53295","92feb4a40f8344d38b6f722e42a53295",21937630,2,0,1,1014,233,233,0
"92feb4a40f8344d38b6f722e42a53295","5152833676bf4c6cb317060be10f68db",21937630,1,-5,0,1016,233,228,-5
"5152833676bf4c6cb317060be10f68db","ca3e28f290354c08aefe5b0f769604e6",21937630,1,8,0,1017,228,235,7
"ca3e28f290354c08aefe5b0f769604e6","ca3e28f290354c08aefe5b0f769604e6",21937630,9,0,1,1018,235,235,0
"ca3e28f290354c08aefe5b0f769604e6","79a35eea833e4c2c9d22fc53c3c6445c",21937630,1,1,0,1027,235,236,1
"79a35eea833e4c2c9d22fc53c3c6445c","79a35eea833e4c2c9d22fc53c3c6445c",21937630,9,0,1,1028,236,236,0
"79a35eea833e4c2c9d22fc53c3c6445c","cab89fa5c3ed45a5aa550fc0352d6a42",21937630,1,2,0,1037,236,238,2
"cab89fa5c3ed45a5aa550fc0352d6a42","cab89fa5c3ed45a5aa550fc0352d6a42",21937630,3,0,1,1038,238,238,0
"cab89fa5c3ed45a5aa550fc0352d6a42","0b04c8e2f86d48c7aeb7e225819cd32b",21937630,1,-4,0,1041,238,234,-4
"0b04c8e2f86d48c7aeb7e225819cd32b","1c6721b1f63f4d30ba7746ea8af02a52",21937630,1,-16,0,1042,234,221,-13
"1c6721b1f63f4d30ba7746ea8af02a52","2ae94c0cea4d480a9d5dca8fb1d7b542",21937630,4,27,0,1043,221,242,21
"2ae94c0cea4d480a9d5dca8fb1d7b542","1ebf23f9d994469a85206e4c7b1bf5f5",21937630,8,3,0,1044,242,245,3
"1ebf23f9d994469a85206e4c7b1bf5f5","2ae94c0cea4d480a9d5dca8fb1d7b542",21937630,6,-3,0,1045,245,242,-3
"2ae94c0cea4d480a9d5dca8fb1d7b542","1c6721b1f63f4d30ba7746ea8af02a52",21937630,3,-27,0,1046,242,221,-21
"1c6721b1f63f4d30ba7746ea8af02a52","64dbedb3ce544f6aae8e10e0cf10f16d",21937630,1,23,0,1047,221,240,19
"64dbedb3ce544f6aae8e10e0cf10f16d","0b04c8e2f86d48c7aeb7e225819cd32b",21937630,1,-7,0,1048,240,234,-6
"0b04c8e2f86d48c7aeb7e225819cd32b","5152833676bf4c6cb317060be10f68db",21937630,1,-7,0,1049,234,228,-6
"5152833676bf4c6cb317060be10f68db","8b9ae98743bd4d4a8a87dff1c1244211",21937630,1,-2,0,1050,228,227,-1
"f7906d6f59b9489a91d2ef40db5a474d","5152833676bf4c6cb317060be10f68db",21937630,1,6,0,1064,223,228,5
"5152833676bf4c6cb317060be10f68db","8f68228b1518449e9615cdafee41a2bd",21937630,1,10,0,1065,228,237,9
"8f68228b1518449e9615cdafee41a2bd","8f68228b1518449e9615cdafee41a2bd",21937630,1,0,1,1066,237,237,0
"8f68228b1518449e9615cdafee41a2bd","66d4fad4f1cf4b46be0750a99ad7a35a",21937630,1,2,0,1067,237,239,2
"66d4fad4f1cf4b46be0750a99ad7a35a","66d4fad4f1cf4b46be0750a99ad7a35a",21937630,1,0,1,1068,239,239,0
"66d4fad4f1cf4b46be0750a99ad7a35a","0b04c8e2f86d48c7aeb7e225819cd32b",21937630,1,-5,0,1069,239,234,-5
"0b04c8e2f86d48c7aeb7e225819cd32b","f53da5fd9bfe412da4b80d4742563b6c",21937630,1,8,0,1070,234,241,7
"f53da5fd9bfe412da4b80d4742563b6c","f53da5fd9bfe412da4b80d4742563b6c",21937630,1,0,1,1071,241,241,0
"f53da5fd9bfe412da4b80d4742563b6c","2ae94c0cea4d480a9d5dca8fb1d7b542",21937630,1,3,0,1072,241,242,1
"1c6721b1f63f4d30ba7746ea8af02a52","1ebf23f9d994469a85206e4c7b1bf5f5",21937630,2,30,0,1074,221,245,24
"1ebf23f9d994469a85206e4c7b1bf5f5","1ebf23f9d994469a85206e4c7b1bf5f5",21937630,32,0,1,1075,245,245,0
"2ae94c0cea4d480a9d5dca8fb1d7b542","6e83e23f56544a19b94067c1c558d9c0",21937630,3,6,0,1110,242,247,5
"6e83e23f56544a19b94067c1c558d9c0","1ebf23f9d994469a85206e4c7b1bf5f5",21937630,1,-3,0,1111,247,245,-2
"1ebf23f9d994469a85206e4c7b1bf5f5","85ae675b83e8422da842cfd25596af99",21937630,3,1,0,1112,245,246,1
"85ae675b83e8422da842cfd25596af99","85ae675b83e8422da842cfd25596af99",21937630,4,0,1,1113,246,246,0
"85ae675b83e8422da842cfd25596af99","2ae94c0cea4d480a9d5dca8fb1d7b542",21937630,3,-4,0,1114,246,242,-4
"2ae94c0cea4d480a9d5dca8fb1d7b542","fa235f0f364d47e4ae1c87f47bf8e6ba",21937630,1,12,0,1115,242,252,10
"fa235f0f364d47e4ae1c87f47bf8e6ba","2ae94c0cea4d480a9d5dca8fb1d7b542",21937630,1,-12,0,1116,252,242,-10
"2ae94c0cea4d480a9d5dca8fb1d7b542","79f7845465cc4ed19d8e4f1429541be0",21937630,1,14,0,1117,242,254,12
"79f7845465cc4ed19d8e4f1429541be0","79f7845465cc4ed19d8e4f1429541be0",21937630,2,0,1,1118,254,254,0
"79f7845465cc4ed19d8e4f1429541be0","6e83e23f56544a19b94067c1c558d9c0",21937630,1,-8,0,1120,254,247,-7
"6e83e23f56544a19b94067c1c558d9c0","ead7bb4b64e247d2ae632ab8a296b091",21937630,1,13,0,1121,247,258,11
"ead7bb4b64e247d2ae632ab8a296b091","ead7bb4b64e247d2ae632ab8a296b091",21937630,4,0,1,1122,258,258,0
"ead7bb4b64e247d2ae632ab8a296b091","d546341988904f069cfa86b21457d9d9",21937630,1,-8,0,1124,258,251,-7
"d546341988904f069cfa86b21457d9d9","6e83e23f56544a19b94067c1c558d9c0",21937630,1,-5,0,1125,251,247,-4
"6e83e23f56544a19b94067c1c558d9c0","41b0048dde734bb280bac6116baa8e27",21937630,1,14,0,1126,247,259,12
"41b0048dde734bb280bac6116baa8e27","41b0048dde734bb280bac6116baa8e27",21937630,4,0,1,1127,259,259,0
"41b0048dde734bb280bac6116baa8e27","b41c5a094a604ee0915327da5cc0beb7",21937630,2,1,0,1129,259,260,1
"b41c5a094a604ee0915327da5cc0beb7","b41c5a094a604ee0915327da5cc0beb7",21937630,4,0,1,1130,260,260,0
"b41c5a094a604ee0915327da5cc0beb7","d546341988904f069cfa86b21457d9d9",21937630,2,-10,0,1132,260,251,-9
"d546341988904f069cfa86b21457d9d9","28c171777c52431ab6b925073bd63d46",21937630,2,15,0,1133,251,264,13
"28c171777c52431ab6b925073bd63d46","28c171777c52431ab6b925073bd63d46",21937630,10,0,1,1134,264,264,0
"28c171777c52431ab6b925073bd63d46","ac160db940cb49ae8579162b1d52bb5d",21937630,2,2,0,1141,264,266,2
"ac160db940cb49ae8579162b1d52bb5d","ac160db940cb49ae8579162b1d52bb5d",21937630,6,0,1,1142,266,266,0
"ac160db940cb49ae8579162b1d52bb5d","d989ebcfc12a4b669f0100dc1aa14f1e",21937630,2,-12,0,1145,266,255,-11
"d989ebcfc12a4b669f0100dc1aa14f1e","c6fd49b485cc4874b0bbdd9c6171e09c",21937630,2,15,0,1146,255,268,13
"c6fd49b485cc4874b0bbdd9c6171e09c","c6fd49b485cc4874b0bbdd9c6171e09c",21937630,6,0,1,1147,268,268,0
"c6fd49b485cc4874b0bbdd9c6171e09c","44240778a97c4af0937817499b75707b",21937630,2,1,0,1150,268,269,1
"44240778a97c4af0937817499b75707b","44240778a97c4af0937817499b75707b",21937630,4,0,1,1151,269,269,0
"44240778a97c4af0937817499b75707b","7aa76d3e993840d8805f097cbdbcd44b",21937630,2,-9,0,1153,269,261,-8
"7aa76d3e993840d8805f097cbdbcd44b","2ae94c0cea4d480a9d5dca8fb1d7b542",21937630,4,-23,0,1154,261,242,-19
"2ae94c0cea4d480a9d5dca8fb1d7b542","0d987bed3ffa4ed0b9a2e62e97b7b30f",21937630,7,38,0,1155,242,272,30
"0d987bed3ffa4ed0b9a2e62e97b7b30f","2ae94c0cea4d480a9d5dca8fb1d7b542",21937630,4,-38,0,1156,272,242,-30
"0d987bed3ffa4ed0b9a2e62e97b7b30f","fab84b4fab5940efb4ea868ef8d09396",21937630,1,18,0,1158,272,284,12
"fab84b4fab5940efb4ea868ef8d09396","fab84b4fab5940efb4ea868ef8d09396",21937630,2,0,1,1159,284,284,0
"fab84b4fab5940efb4ea868ef8d09396","779f9ddd1fd14d1e9e69f72219a1fdbd",21937630,2,-219,0,1161,284,121,-163
"779f9ddd1fd14d1e9e69f72219a1fdbd","d7f13c8d63ec4e2aa673fbb9cf9c6933",21937630,1,115,0,1162,121,206,85
"d7f13c8d63ec4e2aa673fbb9cf9c6933","1c6721b1f63f4d30ba7746ea8af02a52",21937630,5,21,0,1163,206,221,15
"1c6721b1f63f4d30ba7746ea8af02a52","d7f13c8d63ec4e2aa673fbb9cf9c6933",21937630,2,-21,0,1164,221,206,-15
"d7f13c8d63ec4e2aa673fbb9cf9c6933","77ecef8eff6b4a2caea7707669bf7475",21937630,2,22,0,1165,206,222,16
"77ecef8eff6b4a2caea7707669bf7475","1c6721b1f63f4d30ba7746ea8af02a52",21937630,5,-1,0,1166,222,221,-1
"1c6721b1f63f4d30ba7746ea8af02a52","8b9ae98743bd4d4a8a87dff1c1244211",21937630,4,7,0,1167,221,227,6
"a4f40fb48a8542c8949bae1f002cd9bc","5152833676bf4c6cb317060be10f68db",21937630,1,-3,0,1173,231,228,-3
"5152833676bf4c6cb317060be10f68db","1c6721b1f63f4d30ba7746ea8af02a52",21937630,1,-9,0,1174,228,221,-7
"1c6721b1f63f4d30ba7746ea8af02a52","77ecef8eff6b4a2caea7707669bf7475",21937630,5,1,0,1175,221,222,1
"77ecef8eff6b4a2caea7707669bf7475","f7906d6f59b9489a91d2ef40db5a474d",21937630,1,2,0,1176,222,223,1
"f7906d6f59b9489a91d2ef40db5a474d","1c6721b1f63f4d30ba7746ea8af02a52",21937630,2,-3,0,1177,223,221,-2
"1c6721b1f63f4d30ba7746ea8af02a52","1c6721b1f63f4d30ba7746ea8af02a52",21937630,2,0,1,1178,221,221,0
"8b9ae98743bd4d4a8a87dff1c1244211","2ae94c0cea4d480a9d5dca8fb1d7b542",21937630,1,20,0,1180,227,242,15
"6e83e23f56544a19b94067c1c558d9c0","d546341988904f069cfa86b21457d9d9",21937630,1,5,0,1184,247,251,4
"d546341988904f069cfa86b21457d9d9","d989ebcfc12a4b669f0100dc1aa14f1e",21937630,2,5,0,1185,251,255,4
"d989ebcfc12a4b669f0100dc1aa14f1e","7aa76d3e993840d8805f097cbdbcd44b",21937630,2,7,0,1186,255,261,6
"2ae94c0cea4d480a9d5dca8fb1d7b542","2ae94c0cea4d480a9d5dca8fb1d7b542",21937630,2,0,1,1190,242,242,0
"2ae94c0cea4d480a9d5dca8fb1d7b542","865a4d3b43374da7944dc7d397f566d9",21937630,2,35,0,1193,242,271,29
"865a4d3b43374da7944dc7d397f566d9","865a4d3b43374da7944dc7d397f566d9",21937630,4,0,1,1194,271,271,0
"865a4d3b43374da7944dc7d397f566d9","2ae94c0cea4d480a9d5dca8fb1d7b542",21937630,2,-35,0,1198,271,242,-29
"865a4d3b43374da7944dc7d397f566d9","0d987bed3ffa4ed0b9a2e62e97b7b30f",21937630,1,3,0,1200,271,272,1
"0d987bed3ffa4ed0b9a2e62e97b7b30f","0d987bed3ffa4ed0b9a2e62e97b7b30f",21937630,4,0,1,1201,272,272,0
"0d987bed3ffa4ed0b9a2e62e97b7b30f","865a4d3b43374da7944dc7d397f566d9",21937630,1,-3,0,1203,272,271,-1
"1ebf23f9d994469a85206e4c7b1bf5f5","94cecc3f1e7d484b8e068e79241dfd73",21937630,1,48,0,1206,245,281,36
"94cecc3f1e7d484b8e068e79241dfd73","a37477c4e4c14169ad44b06b493007f6",21937630,4,2,0,1207,281,283,2
"a37477c4e4c14169ad44b06b493007f6","4a29443515bb404cb8924e1c60a63b73",21937630,1,7,0,1208,283,285,2
"4a29443515bb404cb8924e1c60a63b73","208c9b2796c944db8dacaa96082520ea",21937630,1,3,0,1209,285,288,3
"208c9b2796c944db8dacaa96082520ea","4a29443515bb404cb8924e1c60a63b73",21937630,1,-3,0,1210,288,285,-3
"4a29443515bb404cb8924e1c60a63b73","4a29443515bb404cb8924e1c60a63b73",21937630,2,0,1,1211,285,285,0
"4a29443515bb404cb8924e1c60a63b73","2ae94c0cea4d480a9d5dca8fb1d7b542",21937630,1,-60,0,1212,285,242,-43
"1ebf23f9d994469a85206e4c7b1bf5f5","b9fbcb8c33b14f58925572b0b81e8e17",21937630,1,63,0,1214,245,290,45
"b9fbcb8c33b14f58925572b0b81e8e17","b9fbcb8c33b14f58925572b0b81e8e17",21937630,1,0,1,1215,290,290,0
"b9fbcb8c33b14f58925572b0b81e8e17","4a29443515bb404cb8924e1c60a63b73",21937630,1,-6,0,1216,290,285,-5
"4a29443515bb404cb8924e1c60a63b73","7669a956527947d0add87455277e80b4",21937630,1,7,0,1217,285,291,6
"7669a956527947d0add87455277e80b4","7669a956527947d0add87455277e80b4",21937630,3,0,1,1218,291,291,0
"7669a956527947d0add87455277e80b4","6a9a3b5bde4a48daa896fe8c06eca56f",21937630,1,-2,0,1221,291,289,-2
"6a9a3b5bde4a48daa896fe8c06eca56f","869e967078f04da18dd0b0b9389a7424",21937630,1,5,0,1222,289,293,4
"869e967078f04da18dd0b0b9389a7424","4a29443515bb404cb8924e1c60a63b73",21937630,1,-10,0,1223,293,285,-8
"4a29443515bb404cb8924e1c60a63b73","6a9a3b5bde4a48daa896fe8c06eca56f",21937630,1,5,0,1224,285,289,4
"6a9a3b5bde4a48daa896fe8c06eca56f","51ab6291537748fab90d519aa09889d6",21937630,1,7,0,1225,289,295,6
"51ab6291537748fab90d519aa09889d6","51ab6291537748fab90d519aa09889d6",21937630,11,0,1,1226,295,295,0
"51ab6291537748fab90d519aa09889d6","34a6e49023fc4465bd5ca604330bbd1c",21937630,1,-3,0,1237,295,292,-3
"34a6e49023fc4465bd5ca604330bbd1c","21592f2a9e9c4b2f8c66ec5dbcbf6a2b",21937630,1,5,0,1238,292,296,4
"21592f2a9e9c4b2f8c66ec5dbcbf6a2b","fab84b4fab5940efb4ea868ef8d09396",21937630,1,-18,0,1239,296,284,-12
"fab84b4fab5940efb4ea868ef8d09396","d7f13c8d63ec4e2aa673fbb9cf9c6933",21937630,1,-104,0,1240,284,206,-78
"d7f13c8d63ec4e2aa673fbb9cf9c6933","d7f13c8d63ec4e2aa673fbb9cf9c6933",21937630,1,0,1,1241,206,206,0
"2ae94c0cea4d480a9d5dca8fb1d7b542","30c9ba177afc49a695625d2bdec40207",21937630,1,9,0,1252,242,250,8
"30c9ba177afc49a695625d2bdec40207","30c9ba177afc49a695625d2bdec40207",21937630,2,0,1,1253,250,250,0
"30c9ba177afc49a695625d2bdec40207","6e83e23f56544a19b94067c1c558d9c0",21937630,1,-3,0,1255,250,247,-3
"6e83e23f56544a19b94067c1c558d9c0","00f61990949545828dd12f1303d47504",21937630,2,11,0,1256,247,256,9
"00f61990949545828dd12f1303d47504","d546341988904f069cfa86b21457d9d9",21937630,1,-6,0,1257,256,251,-5
"0d987bed3ffa4ed0b9a2e62e97b7b30f","82ae07bc0c9b4570a41799290d1ef399",21937630,2,4,0,1263,272,275,3
"82ae07bc0c9b4570a41799290d1ef399","bb5a47f5ea01454a8b79455422d3b9da",21937630,5,6,0,1264,275,280,5
"bb5a47f5ea01454a8b79455422d3b9da","bb5a47f5ea01454a8b79455422d3b9da",21937630,115,0,1,1265,280,280,0
"bb5a47f5ea01454a8b79455422d3b9da","bc5524e78a8544e2ae2fdc2f3462bbec",21937630,4,-1,0,1272,280,279,-1
"bc5524e78a8544e2ae2fdc2f3462bbec","0d987bed3ffa4ed0b9a2e62e97b7b30f",21937630,1,-9,0,1273,279,272,-7
"0d987bed3ffa4ed0b9a2e62e97b7b30f","bc5524e78a8544e2ae2fdc2f3462bbec",21937630,1,9,0,1274,272,279,7
"bc5524e78a8544e2ae2fdc2f3462bbec","bb5a47f5ea01454a8b79455422d3b9da",21937630,1,1,0,1275,279,280,1
"bc5524e78a8544e2ae2fdc2f3462bbec","82ae07bc0c9b4570a41799290d1ef399",21937630,3,-5,0,1284,279,275,-4
"82ae07bc0c9b4570a41799290d1ef399","0d987bed3ffa4ed0b9a2e62e97b7b30f",21937630,2,-4,0,1285,275,272,-3
"0d987bed3ffa4ed0b9a2e62e97b7b30f","bb5a47f5ea01454a8b79455422d3b9da",21937630,4,10,0,1286,272,280,8
"bb5a47f5ea01454a8b79455422d3b9da","82ae07bc0c9b4570a41799290d1ef399",21937630,2,-6,0,1293,280,275,-5
"bb5a47f5ea01454a8b79455422d3b9da","0d987bed3ffa4ed0b9a2e62e97b7b30f",21937630,3,-10,0,1307,280,272,-8
"0d987bed3ffa4ed0b9a2e62e97b7b30f","94cecc3f1e7d484b8e068e79241dfd73",21937630,4,13,0,1308,272,281,9
"a37477c4e4c14169ad44b06b493007f6","0d987bed3ffa4ed0b9a2e62e97b7b30f",21937630,1,-15,0,1310,283,272,-11
"94cecc3f1e7d484b8e068e79241dfd73","bb5a47f5ea01454a8b79455422d3b9da",21937630,1,-3,0,1312,281,280,-1
"a37477c4e4c14169ad44b06b493007f6","94cecc3f1e7d484b8e068e79241dfd73",21937630,2,-2,0,1385,283,281,-2
"94cecc3f1e7d484b8e068e79241dfd73","fab84b4fab5940efb4ea868ef8d09396",21937630,2,5,0,1386,281,284,3
"779f9ddd1fd14d1e9e69f72219a1fdbd","f661500307d74c908e9207d949ceb4aa",21937630,2,18,0,1388,121,136,15
"f661500307d74c908e9207d949ceb4aa","8bc5795d6a984a3eace4e2811e52dd4f",21937630,1,-2,0,1389,136,135,-1
"8bc5795d6a984a3eace4e2811e52dd4f","8bc5795d6a984a3eace4e2811e52dd4f",21937630,3,0,1,1390,135,135,0
"8bc5795d6a984a3eace4e2811e52dd4f","b416d47c56a742199b5d7c7f19d6503a",21937630,2,-1,0,1392,135,134,-1
"b416d47c56a742199b5d7c7f19d6503a","f661500307d74c908e9207d949ceb4aa",21937630,1,3,0,1393,134,136,2
"f661500307d74c908e9207d949ceb4aa","779f9ddd1fd14d1e9e69f72219a1fdbd",21937630,1,-18,0,1394,136,121,-15
"f661500307d74c908e9207d949ceb4aa","b416d47c56a742199b5d7c7f19d6503a",21937630,1,-3,0,1396,136,134,-2
"b416d47c56a742199b5d7c7f19d6503a","779f9ddd1fd14d1e9e69f72219a1fdbd",21937630,1,-15,0,1397,134,121,-13
"779f9ddd1fd14d1e9e69f72219a1fdbd","cd4532ad48034873ba8bce2aac0c9808",21937630,1,19,0,1398,121,137,16
"cd4532ad48034873ba8bce2aac0c9808","cd4532ad48034873ba8bce2aac0c9808",21937630,4,0,1,1399,137,137,0
"cd4532ad48034873ba8bce2aac0c9808","b613861cecf84ffcab01afb23f660475",21937630,1,-194,0,1400,137,1,-136
"b613861cecf84ffcab01afb23f660475","d7f13c8d63ec4e2aa673fbb9cf9c6933",21937630,1,290,0,1401,1,206,205
"d7f13c8d63ec4e2aa673fbb9cf9c6933","be95c065e45447c1bd8215ea6f130c7a",21937630,2,17,0,1402,206,219,13
"be95c065e45447c1bd8215ea6f130c7a","f7fb1952f56b4189b86a9f8b7862d2b8",21937630,1,-6,0,1403,219,215,-4
"f7fb1952f56b4189b86a9f8b7862d2b8","be502a7a43c44bf7b682698de79d9369",21937630,2,-1,0,1404,215,214,-1
"be502a7a43c44bf7b682698de79d9369","09400e101c5d4b439cf9a26b03aae558",21937630,1,-5,0,1405,214,210,-4
"09400e101c5d4b439cf9a26b03aae558","ec341f459285443b8361f7f15638ff08",21937630,1,4,0,1406,210,213,3
"ec341f459285443b8361f7f15638ff08","be502a7a43c44bf7b682698de79d9369",21937630,1,1,0,1407,213,214,1
"be502a7a43c44bf7b682698de79d9369","f7fb1952f56b4189b86a9f8b7862d2b8",21937630,2,1,0,1408,214,215,1
"f7fb1952f56b4189b86a9f8b7862d2b8","a875096404ef4a9984b62d74cda916f9",21937630,1,-7,0,1409,215,209,-6
"a875096404ef4a9984b62d74cda916f9","ec341f459285443b8361f7f15638ff08",21937630,1,5,0,1410,209,213,4
"ec341f459285443b8361f7f15638ff08","363837c182e04711840d896ae1e0339c",21937630,1,6,0,1411,213,218,5
"363837c182e04711840d896ae1e0339c","01b2051f8941460d89945e3b02d1ce78",21937630,2,-1,0,1412,218,217,-1
"01b2051f8941460d89945e3b02d1ce78","d7f13c8d63ec4e2aa673fbb9cf9c6933",21937630,1,-14,0,1413,217,206,-11
"77ecef8eff6b4a2caea7707669bf7475","8b9ae98743bd4d4a8a87dff1c1244211",21937630,1,6,0,1416,222,227,5
"8b9ae98743bd4d4a8a87dff1c1244211","d03cb855c70044cf8c35d9ec0de696e3",21937630,2,-3,0,1417,227,224,-3
"d03cb855c70044cf8c35d9ec0de696e3","1c6721b1f63f4d30ba7746ea8af02a52",21937630,2,-4,0,1418,224,221,-3
"1c6721b1f63f4d30ba7746ea8af02a52","f7906d6f59b9489a91d2ef40db5a474d",21937630,1,3,0,1419,221,223,2
"2ae94c0cea4d480a9d5dca8fb1d7b542","d7f13c8d63ec4e2aa673fbb9cf9c6933",21937630,1,-48,0,1429,242,206,-36
"00f61990949545828dd12f1303d47504","ead7bb4b64e247d2ae632ab8a296b091",21937630,1,2,0,1442,256,258,2
"ead7bb4b64e247d2ae632ab8a296b091","41b0048dde734bb280bac6116baa8e27",21937630,1,1,0,1445,258,259,1
"bb5a47f5ea01454a8b79455422d3b9da","94cecc3f1e7d484b8e068e79241dfd73",21937630,2,3,0,1481,280,281,1
"94cecc3f1e7d484b8e068e79241dfd73","0d987bed3ffa4ed0b9a2e62e97b7b30f",21937630,3,-13,0,1482,281,272,-9
"0d987bed3ffa4ed0b9a2e62e97b7b30f","a37477c4e4c14169ad44b06b493007f6",21937630,2,15,0,1483,272,283,11
"a37477c4e4c14169ad44b06b493007f6","d7f13c8d63ec4e2aa673fbb9cf9c6933",21937630,1,-101,0,1484,283,206,-77
"be95c065e45447c1bd8215ea6f130c7a","363837c182e04711840d896ae1e0339c",21937630,1,-2,0,1486,219,218,-1
"363837c182e04711840d896ae1e0339c","363837c182e04711840d896ae1e0339c",21937630,18,0,1,1487,218,218,0
"01b2051f8941460d89945e3b02d1ce78","4a29443515bb404cb8924e1c60a63b73",21937630,1,94,0,1506,217,285,68
"4a29443515bb404cb8924e1c60a63b73","0d987bed3ffa4ed0b9a2e62e97b7b30f",21937630,1,-22,0,1507,285,272,-13
"a37477c4e4c14169ad44b06b493007f6","fab84b4fab5940efb4ea868ef8d09396",21937630,1,3,0,1534,283,284,1
"fab84b4fab5940efb4ea868ef8d09396","94cecc3f1e7d484b8e068e79241dfd73",21937630,1,-5,0,1535,284,281,-3
"fab84b4fab5940efb4ea868ef8d09396","4a29443515bb404cb8924e1c60a63b73",21937630,1,4,0,1537,284,285,1
"4a29443515bb404cb8924e1c60a63b73","21592f2a9e9c4b2f8c66ec5dbcbf6a2b",21937630,2,14,0,1539,285,296,11
"21592f2a9e9c4b2f8c66ec5dbcbf6a2b","4a29443515bb404cb8924e1c60a63b73",21937630,1,-14,0,1540,296,285,-11
"21592f2a9e9c4b2f8c66ec5dbcbf6a2b","ba0e59461bfb4a44b7b1c28a01f8d3b3",21937630,1,4,0,1542,296,299,3
"ba0e59461bfb4a44b7b1c28a01f8d3b3","0e0b36e731a645e7b1b8a88f5031ca38",21937630,1,2,0,1543,299,301,2
"0e0b36e731a645e7b1b8a88f5031ca38","0e0b36e731a645e7b1b8a88f5031ca38",21937630,3,0,1,1544,301,301,0
"0e0b36e731a645e7b1b8a88f5031ca38","a66a144637284c21afc6de17fea4bfb8",21937630,1,1,0,1547,301,302,1
"a66a144637284c21afc6de17fea4bfb8","a66a144637284c21afc6de17fea4bfb8",21937630,2,0,1,1548,302,302,0
"a66a144637284c21afc6de17fea4bfb8","7646a919d7e64fa990bca9b024ff089d",21937630,1,-4,0,1550,302,298,-4
"7646a919d7e64fa990bca9b024ff089d","e390b575229748ea8aac9364efe2bf00",21937630,1,7,0,1551,298,304,6
"e390b575229748ea8aac9364efe2bf00","e390b575229748ea8aac9364efe2bf00",21937630,3,0,1,1552,304,304,0
"e390b575229748ea8aac9364efe2bf00","4a29443515bb404cb8924e1c60a63b73",21937630,1,-24,0,1555,304,285,-19
"4a29443515bb404cb8924e1c60a63b73","3434c10e561d488a914e0f7d71907abd",21937630,2,27,0,1556,285,305,20
"3434c10e561d488a914e0f7d71907abd","53e7e900392747ccad52e711ab0f80d8",21937630,1,2,0,1557,305,307,2
"53e7e900392747ccad52e711ab0f80d8","130acc2aeb0448fdbb2de63bc5cebe5b",21937630,1,3,0,1558,307,309,2
"130acc2aeb0448fdbb2de63bc5cebe5b","3434c10e561d488a914e0f7d71907abd",21937630,1,-5,0,1559,309,305,-4
"3434c10e561d488a914e0f7d71907abd","9c062b3251034ebe90f5054e2a3b5120",21937630,1,7,0,1560,305,311,6
"9c062b3251034ebe90f5054e2a3b5120","9c062b3251034ebe90f5054e2a3b5120",21937630,2,0,1,1561,311,311,0
"9c062b3251034ebe90f5054e2a3b5120","ea859f8207e44537889daeaba13ac2e8",21937630,1,1,0,1563,311,312,1
"ea859f8207e44537889daeaba13ac2e8","ea859f8207e44537889daeaba13ac2e8",21937630,1,0,1,1564,312,312,0
"ea859f8207e44537889daeaba13ac2e8","56d94971a7a94257aa330183a8ebd0ea",21937630,1,1,0,1565,312,313,1
"56d94971a7a94257aa330183a8ebd0ea","56d94971a7a94257aa330183a8ebd0ea",21937630,1,0,1,1566,313,313,0
"56d94971a7a94257aa330183a8ebd0ea","141c0df6cd1946539aadd1c9b7068cd4",21937630,1,-5,0,1567,313,308,-5
"141c0df6cd1946539aadd1c9b7068cd4","13255e63e0aa4abf85e5211bf613d43e",21937630,1,10,0,1568,308,317,9
"13255e63e0aa4abf85e5211bf613d43e","13255e63e0aa4abf85e5211bf613d43e",21937630,4,0,1,1569,317,317,0
"13255e63e0aa4abf85e5211bf613d43e","0c787d16c9504873b1a4d903cec09948",21937630,1,-3,0,1573,317,314,-3
"0c787d16c9504873b1a4d903cec09948","86c27d40179e419c8e9d150fb6afa5d0",21937630,1,6,0,1574,314,319,5
"86c27d40179e419c8e9d150fb6afa5d0","86c27d40179e419c8e9d150fb6afa5d0",21937630,8,0,1,1575,319,319,0
"86c27d40179e419c8e9d150fb6afa5d0","8d7e0b55cf9849cda222a0f2440cec55",21937630,1,-1,0,1583,319,318,-1
"8d7e0b55cf9849cda222a0f2440cec55","24f1363179ad4aaa965484a78471912b",21937630,1,6,0,1584,318,323,5
"24f1363179ad4aaa965484a78471912b","47edbb64109243e6b0f8f64cdef90c6c",21937630,4,3,0,1585,323,326,3
"47edbb64109243e6b0f8f64cdef90c6c","3434c10e561d488a914e0f7d71907abd",21937630,2,-25,0,1586,326,305,-21
"3434c10e561d488a914e0f7d71907abd","24f1363179ad4aaa965484a78471912b",21937630,3,22,0,1587,305,323,18
"47edbb64109243e6b0f8f64cdef90c6c","3628bdce1dd2429ba924d2d4d09448d2",21937630,1,-4,0,1592,326,322,-4
"3628bdce1dd2429ba924d2d4d09448d2","56b3fd1a212a4764be39d979fde3326e",21937630,1,7,0,1593,322,328,6
"56b3fd1a212a4764be39d979fde3326e","56b3fd1a212a4764be39d979fde3326e",21937630,1,0,1,1594,328,328,0
"56b3fd1a212a4764be39d979fde3326e","0c4079457ede49e3aeb5e86ed84bdf35",21937630,1,3,0,1595,328,329,1
"0c4079457ede49e3aeb5e86ed84bdf35","3434c10e561d488a914e0f7d71907abd",21937630,2,-31,0,1596,329,305,-24
"3434c10e561d488a914e0f7d71907abd","38aea304b4fa46e1b29bb72f5cea4c93",21937630,2,33,0,1597,305,331,26
"38aea304b4fa46e1b29bb72f5cea4c93","38aea304b4fa46e1b29bb72f5cea4c93",21937630,32,0,1,1598,331,331,0
"38aea304b4fa46e1b29bb72f5cea4c93","e36d261332f14e79bb4b467aceaeb9b5",21937630,1,2,0,1617,331,333,2
"e36d261332f14e79bb4b467aceaeb9b5","e36d261332f14e79bb4b467aceaeb9b5",21937630,1,0,1,1618,333,333,0
"e36d261332f14e79bb4b467aceaeb9b5","c7e89b9d04744d2eab742fc24e3ef1ae",21937630,1,1,0,1619,333,334,1
"c7e89b9d04744d2eab742fc24e3ef1ae","c7e89b9d04744d2eab742fc24e3ef1ae",21937630,2,0,1,1620,334,334,0
"c7e89b9d04744d2eab742fc24e3ef1ae","fe49f8054b374a0ea4bb266ed135ff62",21937630,1,1,0,1622,334,335,1
"fe49f8054b374a0ea4bb266ed135ff62","fe49f8054b374a0ea4bb266ed135ff62",21937630,2,0,1,1623,335,335,0
"fe49f8054b374a0ea4bb266ed135ff62","d0a8f74af98642fe8360d22c42e45117",21937630,1,1,0,1625,335,336,1
"d0a8f74af98642fe8360d22c42e45117","d0a8f74af98642fe8360d22c42e45117",21937630,2,0,1,1626,336,336,0
"d0a8f74af98642fe8360d22c42e45117","0c4079457ede49e3aeb5e86ed84bdf35",21937630,1,-7,0,1628,336,329,-7
"0c4079457ede49e3aeb5e86ed84bdf35","a7c6339ca1da4368a18d471f0519f877",21937630,1,11,0,1629,329,339,10
"a7c6339ca1da4368a18d471f0519f877","a7c6339ca1da4368a18d471f0519f877",21937630,1,0,1,1630,339,339,0
"a7c6339ca1da4368a18d471f0519f877","b8b9418ab322418d9db9b40d96af873a",21937630,1,-2,0,1631,339,337,-2
"b8b9418ab322418d9db9b40d96af873a","bbc5139ca9024389a94db3a6f47dcff6",21937630,1,5,0,1632,337,341,4
"bbc5139ca9024389a94db3a6f47dcff6","bbc5139ca9024389a94db3a6f47dcff6",21937630,21,0,1,1633,341,341,0
"bbc5139ca9024389a94db3a6f47dcff6","4ee6ca9019ab4a1ab323f98094a9bd77",21937630,1,2,0,1654,341,343,2
"4ee6ca9019ab4a1ab323f98094a9bd77","4ee6ca9019ab4a1ab323f98094a9bd77",21937630,2,0,1,1655,343,343,0
"4ee6ca9019ab4a1ab323f98094a9bd77","b37947176785476f8b29d49a851366dc",21937630,1,1,0,1657,343,344,1
"b37947176785476f8b29d49a851366dc","b37947176785476f8b29d49a851366dc",21937630,2,0,1,1658,344,344,0
"b37947176785476f8b29d49a851366dc","fcea5b10d5a14a3b9324ffece8f6e1e5",21937630,1,1,0,1660,344,345,1
"fcea5b10d5a14a3b9324ffece8f6e1e5","fcea5b10d5a14a3b9324ffece8f6e1e5",21937630,2,0,1,1661,345,345,0
"fcea5b10d5a14a3b9324ffece8f6e1e5","c2490bc612d146edbe786556fab3651b",21937630,1,-5,0,1663,345,340,-5
"c2490bc612d146edbe786556fab3651b","4a92daef4d504e1792575a26502bb7b7",21937630,1,7,0,1664,340,346,6
"4a92daef4d504e1792575a26502bb7b7","b8b9418ab322418d9db9b40d96af873a",21937630,1,-11,0,1665,346,337,-9
"b8b9418ab322418d9db9b40d96af873a","38aea304b4fa46e1b29bb72f5cea4c93",21937630,1,-7,0,1666,337,331,-6
"38aea304b4fa46e1b29bb72f5cea4c93","0c4079457ede49e3aeb5e86ed84bdf35",21937630,2,-2,0,1680,331,329,-2
"0c4079457ede49e3aeb5e86ed84bdf35","bbc5139ca9024389a94db3a6f47dcff6",21937630,1,14,0,1681,329,341,12
"bbc5139ca9024389a94db3a6f47dcff6","4a92daef4d504e1792575a26502bb7b7",21937630,1,6,0,1682,341,346,5
"4a92daef4d504e1792575a26502bb7b7","c2490bc612d146edbe786556fab3651b",21937630,1,-7,0,1683,346,340,-6
"c2490bc612d146edbe786556fab3651b","b8b9418ab322418d9db9b40d96af873a",21937630,1,-4,0,1684,340,337,-3
"b8b9418ab322418d9db9b40d96af873a","6ac8bb048b854999a47edb35fe627f11",21937630,1,12,0,1685,337,347,10
"6ac8bb048b854999a47edb35fe627f11","6ac8bb048b854999a47edb35fe627f11",21937630,1,0,1,1686,347,347,0
"6ac8bb048b854999a47edb35fe627f11","0c4079457ede49e3aeb5e86ed84bdf35",21937630,1,-21,0,1687,347,329,-18
"0c4079457ede49e3aeb5e86ed84bdf35","30ead9794d4847abaf222ca966cc8630",21937630,2,24,0,1688,329,348,19
"30ead9794d4847abaf222ca966cc8630","c20993c944444fe085345591a8bd837e",21937630,2,3,0,1689,348,351,3
"c20993c944444fe085345591a8bd837e","897b7f51242c44aab2205c72fdcbf4cd",21937630,3,1,0,1690,351,352,1
"897b7f51242c44aab2205c72fdcbf4cd","09b9678ddc3d452ea4a3d46e15826065",21937630,3,1,0,1691,352,353,1
"09b9678ddc3d452ea4a3d46e15826065","eff0de7f2dbb42dfa1a2e686efab5b6d",21937630,3,1,0,1692,353,354,1
"eff0de7f2dbb42dfa1a2e686efab5b6d","c20993c944444fe085345591a8bd837e",21937630,1,-3,0,1693,354,351,-3
"c20993c944444fe085345591a8bd837e","c20993c944444fe085345591a8bd837e",21937630,6,0,1,1694,351,351,0
"c20993c944444fe085345591a8bd837e","30ead9794d4847abaf222ca966cc8630",21937630,1,-3,0,1697,351,348,-3
"897b7f51242c44aab2205c72fdcbf4cd","c20993c944444fe085345591a8bd837e",21937630,1,-1,0,1700,352,351,-1
"c20993c944444fe085345591a8bd837e","09b9678ddc3d452ea4a3d46e15826065",21937630,1,2,0,1702,351,353,2
"eff0de7f2dbb42dfa1a2e686efab5b6d","897b7f51242c44aab2205c72fdcbf4cd",21937630,1,-2,0,1704,354,352,-2
"897b7f51242c44aab2205c72fdcbf4cd","897b7f51242c44aab2205c72fdcbf4cd",21937630,4,0,1,1705,352,352,0
"09b9678ddc3d452ea4a3d46e15826065","09b9678ddc3d452ea4a3d46e15826065",21937630,4,0,1,1709,353,353,0
"eff0de7f2dbb42dfa1a2e686efab5b6d","eff0de7f2dbb42dfa1a2e686efab5b6d",21937630,5,0,1,1713,354,354,0
"eff0de7f2dbb42dfa1a2e686efab5b6d","30ead9794d4847abaf222ca966cc8630",21937630,1,-6,0,1716,354,348,-6
"30ead9794d4847abaf222ca966cc8630","2fe14166dc9642c3bc666b86a57f943d",21937630,2,10,0,1717,348,357,9
"2fe14166dc9642c3bc666b86a57f943d","30ead9794d4847abaf222ca966cc8630",21937630,1,-10,0,1718,357,348,-9
"2fe14166dc9642c3bc666b86a57f943d","2fe14166dc9642c3bc666b86a57f943d",21937630,11,0,1,1720,357,357,0
"2fe14166dc9642c3bc666b86a57f943d","44421dd1e13a47a388c4a19834b744c7",21937630,1,2,0,1731,357,359,2
"44421dd1e13a47a388c4a19834b744c7","44421dd1e13a47a388c4a19834b744c7",21937630,2,0,1,1732,359,359,0
"44421dd1e13a47a388c4a19834b744c7","cb5fc7ef85d547c4be1a7439d0bf6052",21937630,1,1,0,1734,359,360,1
"cb5fc7ef85d547c4be1a7439d0bf6052","cb5fc7ef85d547c4be1a7439d0bf6052",21937630,5,0,1,1735,360,360,0
"cb5fc7ef85d547c4be1a7439d0bf6052","0a8f150a4cf747acbde62f4721823da3",21937630,1,1,0,1740,360,361,1
"0a8f150a4cf747acbde62f4721823da3","0a8f150a4cf747acbde62f4721823da3",21937630,2,0,1,1741,361,361,0
"0a8f150a4cf747acbde62f4721823da3","ab8fdad974ae471f9f24c3f9dd04462e",21937630,1,1,0,1743,361,362,1
"ab8fdad974ae471f9f24c3f9dd04462e","ab8fdad974ae471f9f24c3f9dd04462e",21937630,2,0,1,1744,362,362,0
"ab8fdad974ae471f9f24c3f9dd04462e","52580888dadb4fe3baa795683ea227bd",21937630,1,3,0,1746,362,364,2
"52580888dadb4fe3baa795683ea227bd","1ba8fef685d74a8194b9db252eb704fb",21937630,1,-10,0,1747,364,355,-9
"1ba8fef685d74a8194b9db252eb704fb","52580888dadb4fe3baa795683ea227bd",21937630,1,10,0,1748,355,364,9
"52580888dadb4fe3baa795683ea227bd","52580888dadb4fe3baa795683ea227bd",21937630,10,0,1,1749,364,364,0
"52580888dadb4fe3baa795683ea227bd","f00179e251a045b39c3f7a54f9aa4acc",21937630,1,-1,0,1759,364,363,-1
"f00179e251a045b39c3f7a54f9aa4acc","492a3bc6a1254f23a7998587961b22a4",21937630,1,4,0,1760,363,366,3
"492a3bc6a1254f23a7998587961b22a4","492a3bc6a1254f23a7998587961b22a4",21937630,7,0,1,1761,366,366,0
"492a3bc6a1254f23a7998587961b22a4","072a190fd302456290895f9f04d6940a",21937630,1,-1,0,1768,366,365,-1
"072a190fd302456290895f9f04d6940a","cfa457d1743848e4bb5e4beced6448ed",21937630,1,5,0,1769,365,369,4
"cfa457d1743848e4bb5e4beced6448ed","cfa457d1743848e4bb5e4beced6448ed",21937630,1,0,1,1770,369,369,0
"cfa457d1743848e4bb5e4beced6448ed","30ead9794d4847abaf222ca966cc8630",21937630,1,-25,0,1771,369,348,-21
"30ead9794d4847abaf222ca966cc8630","b71bac264efb4abd97015447bd490db6",21937630,2,28,0,1772,348,370,22
"b71bac264efb4abd97015447bd490db6","8d448d625b024c82a5eb240bbd7431d6",21937630,10,5,0,1773,370,374,4
"8d448d625b024c82a5eb240bbd7431d6","8d448d625b024c82a5eb240bbd7431d6",21937630,112,0,1,1774,374,374,0
"8d448d625b024c82a5eb240bbd7431d6","b71bac264efb4abd97015447bd490db6",21937630,5,-5,0,1777,374,370,-4
"8d448d625b024c82a5eb240bbd7431d6","1b4550d0dab04078b3bf08a655345bdc",21937630,1,-1,0,1797,374,373,-1
"1b4550d0dab04078b3bf08a655345bdc","8d448d625b024c82a5eb240bbd7431d6",21937630,1,1,0,1798,373,374,1
"8d448d625b024c82a5eb240bbd7431d6","d6d02b6ef04e4f17805504500b8ce441",21937630,1,3,0,1858,374,375,1
"d6d02b6ef04e4f17805504500b8ce441","b71bac264efb4abd97015447bd490db6",21937630,1,-8,0,1859,375,370,-5
"b71bac264efb4abd97015447bd490db6","d6d02b6ef04e4f17805504500b8ce441",21937630,1,8,0,1860,370,375,5
"d6d02b6ef04e4f17805504500b8ce441","3434c10e561d488a914e0f7d71907abd",21937630,1,-91,0,1861,375,305,-70
"3434c10e561d488a914e0f7d71907abd","86c27d40179e419c8e9d150fb6afa5d0",21937630,1,17,0,1862,305,319,14
"86c27d40179e419c8e9d150fb6afa5d0","43ea1b823a4b4e51b7c694c10725db82",21937630,1,10,0,1863,319,327,8
"43ea1b823a4b4e51b7c694c10725db82","8d7e0b55cf9849cda222a0f2440cec55",21937630,1,-11,0,1864,327,318,-9
"8d7e0b55cf9849cda222a0f2440cec55","47edbb64109243e6b0f8f64cdef90c6c",21937630,1,9,0,1865,318,326,8
"47edbb64109243e6b0f8f64cdef90c6c","24f1363179ad4aaa965484a78471912b",21937630,2,-3,0,1866,326,323,-3
"24f1363179ad4aaa965484a78471912b","b71bac264efb4abd97015447bd490db6",21937630,1,61,0,1867,323,370,47
"8d448d625b024c82a5eb240bbd7431d6","3434c10e561d488a914e0f7d71907abd",21937630,1,-88,0,1876,374,305,-69
"3434c10e561d488a914e0f7d71907abd","47edbb64109243e6b0f8f64cdef90c6c",21937630,1,25,0,1877,305,326,21
"24f1363179ad4aaa965484a78471912b","3628bdce1dd2429ba924d2d4d09448d2",21937630,1,-1,0,1879,323,322,-1
"3628bdce1dd2429ba924d2d4d09448d2","3628bdce1dd2429ba924d2d4d09448d2",21937630,1,0,1,1880,322,322,0
"3628bdce1dd2429ba924d2d4d09448d2","3434c10e561d488a914e0f7d71907abd",21937630,1,-21,0,1881,322,305,-17
"3434c10e561d488a914e0f7d71907abd","3434c10e561d488a914e0f7d71907abd",21937630,1,0,1,1882,305,305,0
"47edbb64109243e6b0f8f64cdef90c6c","43ea1b823a4b4e51b7c694c10725db82",21937630,1,2,0,1885,326,327,1
"43ea1b823a4b4e51b7c694c10725db82","3628bdce1dd2429ba924d2d4d09448d2",21937630,1,-6,0,1886,327,322,-5
"3628bdce1dd2429ba924d2d4d09448d2","0c4079457ede49e3aeb5e86ed84bdf35",21937630,1,10,0,1887,322,329,7
"0c4079457ede49e3aeb5e86ed84bdf35","0c4079457ede49e3aeb5e86ed84bdf35",21937630,1,0,1,1891,329,329,0
"30ead9794d4847abaf222ca966cc8630","897b7f51242c44aab2205c72fdcbf4cd",21937630,1,4,0,1893,348,352,4
"09b9678ddc3d452ea4a3d46e15826065","c20993c944444fe085345591a8bd837e",21937630,1,-2,0,1895,353,351,-2
"897b7f51242c44aab2205c72fdcbf4cd","eff0de7f2dbb42dfa1a2e686efab5b6d",21937630,1,2,0,1900,352,354,2
"eff0de7f2dbb42dfa1a2e686efab5b6d","09b9678ddc3d452ea4a3d46e15826065",21937630,1,-1,0,1903,354,353,-1
"09b9678ddc3d452ea4a3d46e15826065","30ead9794d4847abaf222ca966cc8630",21937630,1,-5,0,1905,353,348,-5
"30ead9794d4847abaf222ca966cc8630","c76574d21bc14aeea7ecd0b027f39858",21937630,1,23,0,1906,348,367,19
"c76574d21bc14aeea7ecd0b027f39858","30ead9794d4847abaf222ca966cc8630",21937630,1,-23,0,1907,367,348,-19
"8d448d625b024c82a5eb240bbd7431d6","86c27d40179e419c8e9d150fb6afa5d0",21937630,1,-71,0,1920,374,319,-55
"86c27d40179e419c8e9d150fb6afa5d0","3628bdce1dd2429ba924d2d4d09448d2",21937630,1,4,0,1921,319,322,3
"3628bdce1dd2429ba924d2d4d09448d2","8d7e0b55cf9849cda222a0f2440cec55",21937630,1,-5,0,1922,322,318,-4
"8d7e0b55cf9849cda222a0f2440cec55","13255e63e0aa4abf85e5211bf613d43e",21937630,1,-2,0,1923,318,317,-1
"13255e63e0aa4abf85e5211bf613d43e","b71bac264efb4abd97015447bd490db6",21937630,1,69,0,1924,317,370,53
"8d448d625b024c82a5eb240bbd7431d6","4a29443515bb404cb8924e1c60a63b73",21937630,1,-115,0,1942,374,285,-89
"4a29443515bb404cb8924e1c60a63b73","66baf19b6b904b70922329068c63746d",21937630,1,122,0,1943,285,376,91
"66baf19b6b904b70922329068c63746d","7f544639412e40a9ba27f43b415362ab",21937630,1,2,0,1944,376,378,2
"7f544639412e40a9ba27f43b415362ab","7f544639412e40a9ba27f43b415362ab",21937630,4,0,1,1945,378,378,0
"7f544639412e40a9ba27f43b415362ab","d5ae8642e15b46b8bd298b02274d4e9c",21937630,1,2,0,1949,378,380,2
"d5ae8642e15b46b8bd298b02274d4e9c","d5ae8642e15b46b8bd298b02274d4e9c",21937630,1,0,1,1950,380,380,0
"d5ae8642e15b46b8bd298b02274d4e9c","a0d10309a2dd456289147f84be9d37f9",21937630,1,1,0,1951,380,381,1
"a0d10309a2dd456289147f84be9d37f9","a0d10309a2dd456289147f84be9d37f9",21937630,2,0,1,1952,381,381,0
"a0d10309a2dd456289147f84be9d37f9","0fcbc3ca07b144138b8d85da581f09a8",21937630,1,1,0,1954,381,382,1
"0fcbc3ca07b144138b8d85da581f09a8","0fcbc3ca07b144138b8d85da581f09a8",21937630,2,0,1,1955,382,382,0
"0fcbc3ca07b144138b8d85da581f09a8","66baf19b6b904b70922329068c63746d",21937630,1,-6,0,1957,382,376,-6
"66baf19b6b904b70922329068c63746d","c2fca3669923477ab966ded303dea31c",21937630,1,8,0,1958,376,383,7
"c2fca3669923477ab966ded303dea31c","4890121ce5d74576b4632b77cfc23398",21937630,1,6,0,1959,383,388,5
"4890121ce5d74576b4632b77cfc23398","4890121ce5d74576b4632b77cfc23398",21937630,2,0,1,1960,388,388,0
"4890121ce5d74576b4632b77cfc23398","96bb2b3e85a34d8b9544514e89f6fe97",21937630,1,3,0,1962,388,390,2
"96bb2b3e85a34d8b9544514e89f6fe97","18d3b836dd804224883cc9180b60a8e1",21937630,1,-4,0,1963,390,387,-3
"18d3b836dd804224883cc9180b60a8e1","96bb2b3e85a34d8b9544514e89f6fe97",21937630,1,4,0,1964,387,390,3
"96bb2b3e85a34d8b9544514e89f6fe97","96bb2b3e85a34d8b9544514e89f6fe97",21937630,6,0,1,1965,390,390,0
"96bb2b3e85a34d8b9544514e89f6fe97","ac4e9b54acfe4670b4634859c7263cb5",21937630,1,2,0,1971,390,392,2
"ac4e9b54acfe4670b4634859c7263cb5","ac4e9b54acfe4670b4634859c7263cb5",21937630,1,0,1,1972,392,392,0
"ac4e9b54acfe4670b4634859c7263cb5","17f95d18bab743888e1736033dc3384d",21937630,1,-3,0,1973,392,389,-3
"17f95d18bab743888e1736033dc3384d","6f8881a745ac4c358a68b92c3b4abe81",21937630,1,6,0,1974,389,394,5
"6f8881a745ac4c358a68b92c3b4abe81","6f8881a745ac4c358a68b92c3b4abe81",21937630,3,0,1,1975,394,394,0
"6f8881a745ac4c358a68b92c3b4abe81","f7002c8484354eceac57bc7bd62c76c1",21937630,1,-1,0,1978,394,393,-1
"f7002c8484354eceac57bc7bd62c76c1","0c12af0a4e7f4002852cf84b2537c161",21937630,1,3,0,1979,393,395,2
"0c12af0a4e7f4002852cf84b2537c161","66baf19b6b904b70922329068c63746d",21937630,1,-24,0,1980,395,376,-19
"66baf19b6b904b70922329068c63746d","44a277ea44dc4ae689fab4b82f0b4098",21937630,1,26,0,1981,376,397,21
"44a277ea44dc4ae689fab4b82f0b4098","44a277ea44dc4ae689fab4b82f0b4098",21937630,3,0,1,1982,397,397,0
"44a277ea44dc4ae689fab4b82f0b4098","0c12af0a4e7f4002852cf84b2537c161",21937630,1,-2,0,1985,397,395,-2
"0c12af0a4e7f4002852cf84b2537c161","859e0b8d71694b12befb69ee698138f9",21937630,1,5,0,1986,395,399,4
"859e0b8d71694b12befb69ee698138f9","859e0b8d71694b12befb69ee698138f9",21937630,1,0,1,1987,399,399,0
"859e0b8d71694b12befb69ee698138f9","66baf19b6b904b70922329068c63746d",21937630,1,-29,0,1988,399,376,-23
"66baf19b6b904b70922329068c63746d","2b09a08242b54983aec7063990fb3f66",21937630,1,32,0,1989,376,400,24
"2b09a08242b54983aec7063990fb3f66","2b09a08242b54983aec7063990fb3f66",21937630,5,0,1,1990,400,400,0
"2b09a08242b54983aec7063990fb3f66","4a29443515bb404cb8924e1c60a63b73",21937630,1,-154,0,1991,400,285,-115
"4a29443515bb404cb8924e1c60a63b73","b71bac264efb4abd97015447bd490db6",21937630,1,110,0,1992,285,370,85
"8d448d625b024c82a5eb240bbd7431d6","2b09a08242b54983aec7063990fb3f66",21937630,1,39,0,2001,374,400,26
"2b09a08242b54983aec7063990fb3f66","1f471b7a883a4df48211e8c6a81b59a7",21937630,2,1,0,2003,400,401,1
"1f471b7a883a4df48211e8c6a81b59a7","2b09a08242b54983aec7063990fb3f66",21937630,1,-1,0,2004,401,400,-1
"1f471b7a883a4df48211e8c6a81b59a7","9de0d567bfa84fe5b77cb76f4a76a5d1",21937630,1,4,0,2006,401,404,3
"9de0d567bfa84fe5b77cb76f4a76a5d1","9de0d567bfa84fe5b77cb76f4a76a5d1",21937630,1,0,1,2007,404,404,0
"9de0d567bfa84fe5b77cb76f4a76a5d1","1157bd665ec4472fb58b751dc5099355",21937630,1,-1,0,2008,404,403,-1
"1157bd665ec4472fb58b751dc5099355","2b09a08242b54983aec7063990fb3f66",21937630,1,-4,0,2009,403,400,-3
"2b09a08242b54983aec7063990fb3f66","3c8a22d2f9c146ea956609e3ed4f2559",21937630,1,7,0,2013,400,405,5
"3c8a22d2f9c146ea956609e3ed4f2559","58fc9094275e4c49be3f4ba6d4acc0a4",21937630,1,2,0,2014,405,406,1
"58fc9094275e4c49be3f4ba6d4acc0a4","c1c1be90b2b14c1ab4a5e1ee3c241902",21937630,1,1,0,2015,406,407,1
"c1c1be90b2b14c1ab4a5e1ee3c241902","c1c1be90b2b14c1ab4a5e1ee3c241902",21937630,5,0,1,2016,407,407,0
"c1c1be90b2b14c1ab4a5e1ee3c241902","58fc9094275e4c49be3f4ba6d4acc0a4",21937630,1,-1,0,2021,407,406,-1
"58fc9094275e4c49be3f4ba6d4acc0a4","02b3a1bead9244c1ba2f857c7da8f82a",21937630,2,3,0,2022,406,408,2
"02b3a1bead9244c1ba2f857c7da8f82a","02b3a1bead9244c1ba2f857c7da8f82a",21937630,3,0,1,2023,408,408,0
"02b3a1bead9244c1ba2f857c7da8f82a","58fc9094275e4c49be3f4ba6d4acc0a4",21937630,2,-3,0,2024,408,406,-2
"58fc9094275e4c49be3f4ba6d4acc0a4","6206fc6479014bb193084c32409dc1b9",21937630,1,4,0,2027,406,409,3
"6206fc6479014bb193084c32409dc1b9","2b09a08242b54983aec7063990fb3f66",21937630,1,-13,0,2028,409,400,-9
"2b09a08242b54983aec7063990fb3f66","02b3a1bead9244c1ba2f857c7da8f82a",21937630,2,12,0,2029,400,408,8
"02b3a1bead9244c1ba2f857c7da8f82a","6a5f020451db426dacba9e2ea3fcc62a",21937630,1,3,0,2031,408,410,2
"6a5f020451db426dacba9e2ea3fcc62a","33a9d248b2e44588a5b07fc1342b9bc2",21937630,2,2,0,2032,410,411,1
"33a9d248b2e44588a5b07fc1342b9bc2","6a5f020451db426dacba9e2ea3fcc62a",21937630,1,-2,0,2033,411,410,-1
"33a9d248b2e44588a5b07fc1342b9bc2","33a9d248b2e44588a5b07fc1342b9bc2",21937630,3,0,1,2035,411,411,0
"33a9d248b2e44588a5b07fc1342b9bc2","c6f26bd420634f1cb7989e76fe6b16c0",21937630,1,1,0,2037,411,412,1
"c6f26bd420634f1cb7989e76fe6b16c0","c6f26bd420634f1cb7989e76fe6b16c0",21937630,5,0,1,2038,412,412,0
"c6f26bd420634f1cb7989e76fe6b16c0","2a65ee6e2ac64f6a8a55fbe5373ec763",21937630,1,1,0,2043,412,413,1
"2a65ee6e2ac64f6a8a55fbe5373ec763","2a65ee6e2ac64f6a8a55fbe5373ec763",21937630,2,0,1,2044,413,413,0
"2a65ee6e2ac64f6a8a55fbe5373ec763","33a9d248b2e44588a5b07fc1342b9bc2",21937630,1,-2,0,2046,413,411,-2
"33a9d248b2e44588a5b07fc1342b9bc2","1fd0f6dadbc14ebc965faf6122190b96",21937630,1,5,0,2047,411,415,4
"1fd0f6dadbc14ebc965faf6122190b96","1fd0f6dadbc14ebc965faf6122190b96",21937630,1,0,1,2048,415,415,0
"1fd0f6dadbc14ebc965faf6122190b96","687055dad9fc40c3982478fe33ec01bf",21937630,1,-1,0,2049,415,414,-1
"687055dad9fc40c3982478fe33ec01bf","2add1669f08d4101913db15f8c23b3b7",21937630,2,3,0,2050,414,416,2
"2add1669f08d4101913db15f8c23b3b7","687055dad9fc40c3982478fe33ec01bf",21937630,3,-3,0,2051,416,414,-2
"687055dad9fc40c3982478fe33ec01bf","2b09a08242b54983aec7063990fb3f66",21937630,1,-21,0,2052,414,400,-14
"02b3a1bead9244c1ba2f857c7da8f82a","2add1669f08d4101913db15f8c23b3b7",21937630,1,12,0,2055,408,416,8
"2add1669f08d4101913db15f8c23b3b7","2add1669f08d4101913db15f8c23b3b7",21937630,3,0,1,2056,416,416,0
"687055dad9fc40c3982478fe33ec01bf","33a9d248b2e44588a5b07fc1342b9bc2",21937630,1,-4,0,2058,414,411,-3
"33a9d248b2e44588a5b07fc1342b9bc2","2add1669f08d4101913db15f8c23b3b7",21937630,1,7,0,2060,411,416,5
"2add1669f08d4101913db15f8c23b3b7","2b09a08242b54983aec7063990fb3f66",21937630,1,-24,0,2065,416,400,-16
"2b09a08242b54983aec7063990fb3f66","a2b4bd40cee2481ebd3fc179d6a5cd62",21937630,1,27,0,2066,400,417,17
"a2b4bd40cee2481ebd3fc179d6a5cd62","a2b4bd40cee2481ebd3fc179d6a5cd62",21937630,2,0,1,2067,417,417,0
"a2b4bd40cee2481ebd3fc179d6a5cd62","bec48fc2e1294c7eb3d0aca780d731b8",21937630,6,4,0,2068,417,420,3
"bec48fc2e1294c7eb3d0aca780d731b8","bec48fc2e1294c7eb3d0aca780d731b8",21937630,11,0,1,2069,420,420,0
"bec48fc2e1294c7eb3d0aca780d731b8","dbde19fcce2a4c1abdc7f685c293a23f",21937630,2,3,0,2070,420,422,2
"dbde19fcce2a4c1abdc7f685c293a23f","a24600b0e49245f6bdba8c893cfeddb0",21937630,2,4,0,2071,422,425,3
"a24600b0e49245f6bdba8c893cfeddb0","a24600b0e49245f6bdba8c893cfeddb0",21937630,1,0,1,2072,425,425,0
"a24600b0e49245f6bdba8c893cfeddb0","5d290f75e44b4bdb8256c600debbb44d",21937630,2,2,0,2073,425,426,1
"5d290f75e44b4bdb8256c600debbb44d","e34e59dce2204f228f3a84b6725df60f",21937630,1,-11,0,2074,426,419,-7
"e34e59dce2204f228f3a84b6725df60f","e34e59dce2204f228f3a84b6725df60f",21937630,1,0,1,2075,419,419,0
"e34e59dce2204f228f3a84b6725df60f","a2b4bd40cee2481ebd3fc179d6a5cd62",21937630,1,-2,0,2076,419,417,-2
"bec48fc2e1294c7eb3d0aca780d731b8","a2b4bd40cee2481ebd3fc179d6a5cd62",21937630,3,-4,0,2086,420,417,-3
"bec48fc2e1294c7eb3d0aca780d731b8","24cf8786024543f19b89bc20034e60d7",21937630,1,14,0,2088,420,428,8
"24cf8786024543f19b89bc20034e60d7","f2a73be2f46840b182d7bd095378004e",21937630,4,1,0,2089,428,429,1
"f2a73be2f46840b182d7bd095378004e","a2b4bd40cee2481ebd3fc179d6a5cd62",21937630,1,-19,0,2090,429,417,-12
"bec48fc2e1294c7eb3d0aca780d731b8","a24600b0e49245f6bdba8c893cfeddb0",21937630,2,7,0,2093,420,425,5
"5d290f75e44b4bdb8256c600debbb44d","a24600b0e49245f6bdba8c893cfeddb0",21937630,1,-2,0,2095,426,425,-1
"a24600b0e49245f6bdba8c893cfeddb0","bec48fc2e1294c7eb3d0aca780d731b8",21937630,1,-7,0,2096,425,420,-5
"dbde19fcce2a4c1abdc7f685c293a23f","bec48fc2e1294c7eb3d0aca780d731b8",21937630,1,-3,0,2098,422,420,-2
"a24600b0e49245f6bdba8c893cfeddb0","dbde19fcce2a4c1abdc7f685c293a23f",21937630,1,-4,0,2103,425,422,-3
"a24600b0e49245f6bdba8c893cfeddb0","a2b4bd40cee2481ebd3fc179d6a5cd62",21937630,1,-11,0,2105,425,417,-8
"a2b4bd40cee2481ebd3fc179d6a5cd62","24cf8786024543f19b89bc20034e60d7",21937630,2,18,0,2106,417,428,11
"f2a73be2f46840b182d7bd095378004e","24cf8786024543f19b89bc20034e60d7",21937630,2,-1,0,2108,429,428,-1
"24cf8786024543f19b89bc20034e60d7","a2b4bd40cee2481ebd3fc179d6a5cd62",21937630,1,-18,0,2109,428,417,-11
"f2a73be2f46840b182d7bd095378004e","f2a73be2f46840b182d7bd095378004e",21937630,3,0,1,2113,429,429,0
"f2a73be2f46840b182d7bd095378004e","604551fd4266430cb860fef58fa7dd61",21937630,1,1,0,2116,429,430,1
"604551fd4266430cb860fef58fa7dd61","604551fd4266430cb860fef58fa7dd61",21937630,1,0,1,2117,430,430,0
"604551fd4266430cb860fef58fa7dd61","24cf8786024543f19b89bc20034e60d7",21937630,1,-2,0,2118,430,428,-2
"24cf8786024543f19b89bc20034e60d7","dce46f8904594a62a6377a3587aaa663",21937630,1,4,0,2119,428,431,3
"dce46f8904594a62a6377a3587aaa663","dce46f8904594a62a6377a3587aaa663",21937630,11,0,1,2120,431,431,0
"dce46f8904594a62a6377a3587aaa663","9b9d0a249052413c869753b99682b0ac",21937630,1,1,0,2131,431,432,1
"9b9d0a249052413c869753b99682b0ac","9b9d0a249052413c869753b99682b0ac",21937630,8,0,1,2132,432,432,0
"9b9d0a249052413c869753b99682b0ac","061c175cc90f45fbad883025394e78dd",21937630,1,1,0,2140,432,433,1
"061c175cc90f45fbad883025394e78dd","061c175cc90f45fbad883025394e78dd",21937630,4,0,1,2141,433,433,0
"061c175cc90f45fbad883025394e78dd","dce46f8904594a62a6377a3587aaa663",21937630,1,-2,0,2145,433,431,-2
"dce46f8904594a62a6377a3587aaa663","74a7f8712e5449c2bc0b43c6f90dafed",21937630,1,5,0,2146,431,435,4
"74a7f8712e5449c2bc0b43c6f90dafed","74a7f8712e5449c2bc0b43c6f90dafed",21937630,1,0,1,2147,435,435,0
"74a7f8712e5449c2bc0b43c6f90dafed","66ada10dde9f43018588f1ced9d477fc",21937630,1,-1,0,2148,435,434,-1
"66ada10dde9f43018588f1ced9d477fc","24cf8786024543f19b89bc20034e60d7",21937630,1,-8,0,2149,434,428,-6
"24cf8786024543f19b89bc20034e60d7","bf12c96466d840a69bed7020b3f18bb8",21937630,1,11,0,2152,428,436,8
"bf12c96466d840a69bed7020b3f18bb8","bf12c96466d840a69bed7020b3f18bb8",21937630,1,0,1,2153,436,436,0
"bf12c96466d840a69bed7020b3f18bb8","24cf8786024543f19b89bc20034e60d7",21937630,1,-11,0,2154,436,428,-8
"24cf8786024543f19b89bc20034e60d7","070600601c4c439288445d2f0724807d",21937630,1,14,0,2155,428,437,9
"070600601c4c439288445d2f0724807d","1823b6de7d334a7aaabc4570719af4d9",21937630,2,2,0,2156,437,439,2
"1823b6de7d334a7aaabc4570719af4d9","1823b6de7d334a7aaabc4570719af4d9",21937630,12,0,1,2157,439,439,0
"1823b6de7d334a7aaabc4570719af4d9","070600601c4c439288445d2f0724807d",21937630,2,-2,0,2169,439,437,-2
"070600601c4c439288445d2f0724807d","0380cd76a7d44bc3a4da1f15e4d68f89",21937630,1,4,0,2170,437,440,3
"0380cd76a7d44bc3a4da1f15e4d68f89","0380cd76a7d44bc3a4da1f15e4d68f89",21937630,1,0,1,2171,440,440,0
"0380cd76a7d44bc3a4da1f15e4d68f89","23b7673c8b5443108c2ef09382834a86",21937630,1,2,0,2172,440,441,1
"23b7673c8b5443108c2ef09382834a86","901e92500aea43c79f19f1b279050668",21937630,1,2,0,2173,441,442,1
"901e92500aea43c79f19f1b279050668","23b7673c8b5443108c2ef09382834a86",21937630,1,-2,0,2174,442,441,-1
"23b7673c8b5443108c2ef09382834a86","001339db8ced4cf78829ebe8b145449d",21937630,1,3,0,2175,441,443,2
"001339db8ced4cf78829ebe8b145449d","001339db8ced4cf78829ebe8b145449d",21937630,5,0,1,2176,443,443,0
"001339db8ced4cf78829ebe8b145449d","452745e0366e42ae81561bfddebcc6c3",21937630,1,1,0,2181,443,444,1
"452745e0366e42ae81561bfddebcc6c3","452745e0366e42ae81561bfddebcc6c3",21937630,3,0,1,2182,444,444,0
"452745e0366e42ae81561bfddebcc6c3","901e92500aea43c79f19f1b279050668",21937630,1,-2,0,2185,444,442,-2
"901e92500aea43c79f19f1b279050668","4660ff2089114e8db82ceb26a4f329e3",21937630,1,4,0,2186,442,445,3
"4660ff2089114e8db82ceb26a4f329e3","4660ff2089114e8db82ceb26a4f329e3",21937630,2,0,1,2187,445,445,0
"4660ff2089114e8db82ceb26a4f329e3","7bd5586eb9d8484eb74a433ee7bfe499",21937630,1,2,0,2188,445,446,1
"7bd5586eb9d8484eb74a433ee7bfe499","7bd5586eb9d8484eb74a433ee7bfe499",21937630,30,0,1,2189,446,446,0
"7bd5586eb9d8484eb74a433ee7bfe499","8a7f26e690f34dda97be16904518ca99",21937630,1,2,0,2217,446,447,1
"8a7f26e690f34dda97be16904518ca99","7bd5586eb9d8484eb74a433ee7bfe499",21937630,2,-2,0,2218,447,446,-1
"7bd5586eb9d8484eb74a433ee7bfe499","4660ff2089114e8db82ceb26a4f329e3",21937630,1,-2,0,2220,446,445,-1
"4660ff2089114e8db82ceb26a4f329e3","901e92500aea43c79f19f1b279050668",21937630,1,-4,0,2222,445,442,-3
"901e92500aea43c79f19f1b279050668","901e92500aea43c79f19f1b279050668",21937630,1,0,1,2223,442,442,0
"901e92500aea43c79f19f1b279050668","8a7f26e690f34dda97be16904518ca99",21937630,1,8,0,2224,442,447,5
"7bd5586eb9d8484eb74a433ee7bfe499","070600601c4c439288445d2f0724807d",21937630,1,-14,0,2227,446,437,-9
"070600601c4c439288445d2f0724807d","8a7f26e690f34dda97be16904518ca99",21937630,1,16,0,2230,437,447,10
"8a7f26e690f34dda97be16904518ca99","8a7f26e690f34dda97be16904518ca99",21937630,1,0,1,2231,447,447,0
"8a7f26e690f34dda97be16904518ca99","070600601c4c439288445d2f0724807d",21937630,1,-16,0,2232,447,437,-10
"070600601c4c439288445d2f0724807d","b2f0d654738f48158edff28e8d3a546e",21937630,1,21,0,2233,437,449,12
"b2f0d654738f48158edff28e8d3a546e","f60ee41ec635499abd48168342d32c2f",21937630,10,5,0,2234,449,453,4
"f60ee41ec635499abd48168342d32c2f","f60ee41ec635499abd48168342d32c2f",21937630,142,0,1,2235,453,453,0
"f60ee41ec635499abd48168342d32c2f","b2f0d654738f48158edff28e8d3a546e",21937630,6,-5,0,2237,453,449,-4
"f60ee41ec635499abd48168342d32c2f","f67fbf45a5f146ed866965bc57c7c001",21937630,2,3,0,2243,453,454,1
"f67fbf45a5f146ed866965bc57c7c001","b2f0d654738f48158edff28e8d3a546e",21937630,2,-8,0,2244,454,449,-5
"b2f0d654738f48158edff28e8d3a546e","f67fbf45a5f146ed866965bc57c7c001",21937630,2,8,0,2245,449,454,5
"f67fbf45a5f146ed866965bc57c7c001","c5df9f40ec14463b9dcfdc73df3e9285",21937630,3,12,0,2246,454,464,10
"c5df9f40ec14463b9dcfdc73df3e9285","c5df9f40ec14463b9dcfdc73df3e9285",21937630,2,0,1,2247,464,464,0
"c5df9f40ec14463b9dcfdc73df3e9285","83d42d95cd844fc093fc09cee250edb8",21937630,3,3,0,2249,464,465,1
"83d42d95cd844fc093fc09cee250edb8","83d42d95cd844fc093fc09cee250edb8",21937630,5,0,1,2250,465,465,0
"83d42d95cd844fc093fc09cee250edb8","b2f0d654738f48158edff28e8d3a546e",21937630,2,-23,0,2252,465,449,-16
"f67fbf45a5f146ed866965bc57c7c001","f67fbf45a5f146ed866965bc57c7c001",21937630,6,0,1,2262,454,454,0
"f67fbf45a5f146ed866965bc57c7c001","b534b89233134e30a9b5645138bfa9ee",21937630,1,-564,0,2264,454,41,-413
"b534b89233134e30a9b5645138bfa9ee","d646286c8051419bbc2e31dd1db55ca8",21937630,2,33,0,2266,41,67,26
"d646286c8051419bbc2e31dd1db55ca8","d646286c8051419bbc2e31dd1db55ca8",21937630,1,0,1,2267,67,67,0
"d646286c8051419bbc2e31dd1db55ca8","140d5b27b8574befad82c0a013b59dfa",21937630,1,8,0,2268,67,74,7
"140d5b27b8574befad82c0a013b59dfa","d18a9ea32855445f8736581f5cb119ce",21937630,2,9,0,2269,74,82,8
"d18a9ea32855445f8736581f5cb119ce","ae5ac430ea254e708a6f5deaaf7464ae",21937630,1,3,0,2270,82,84,2
"ae5ac430ea254e708a6f5deaaf7464ae","6a9f0ef185fb47f0937e29daa1c71ed5",21937630,2,7,0,2271,84,90,6
"6a9f0ef185fb47f0937e29daa1c71ed5","6a9f0ef185fb47f0937e29daa1c71ed5",21937630,6,0,1,2272,90,90,0
"6a9f0ef185fb47f0937e29daa1c71ed5","67a089198fcb4e1c8f2385786c2b296f",21937630,1,-64,0,2274,90,39,-51
"67a089198fcb4e1c8f2385786c2b296f","f67fbf45a5f146ed866965bc57c7c001",21937630,1,568,0,2278,39,454,415
"f67fbf45a5f146ed866965bc57c7c001","d937afe49bd24a07a550dda1c1155122",21937630,1,1,0,2281,454,455,1
"d937afe49bd24a07a550dda1c1155122","d937afe49bd24a07a550dda1c1155122",21937630,2,0,1,2282,455,455,0
"d937afe49bd24a07a550dda1c1155122","3628b3f7823443d0912a339096b69943",21937630,1,1,0,2284,455,456,1
"3628b3f7823443d0912a339096b69943","3628b3f7823443d0912a339096b69943",21937630,1,0,1,2285,456,456,0
"3628b3f7823443d0912a339096b69943","9e049ee647cf43ecbcb5ed792a8e7588",21937630,1,1,0,2286,456,457,1
"9e049ee647cf43ecbcb5ed792a8e7588","9e049ee647cf43ecbcb5ed792a8e7588",21937630,1,0,1,2287,457,457,0
"9e049ee647cf43ecbcb5ed792a8e7588","5256a214faaf410b93f76cea06428334",21937630,1,1,0,2288,457,458,1
"5256a214faaf410b93f76cea06428334","5256a214faaf410b93f76cea06428334",21937630,1,0,1,2289,458,458,0
"5256a214faaf410b93f76cea06428334","25c32b120fce40fa9b6c85133aeb4716",21937630,1,1,0,2290,458,459,1
"25c32b120fce40fa9b6c85133aeb4716","25c32b120fce40fa9b6c85133aeb4716",21937630,4,0,1,2291,459,459,0
"25c32b120fce40fa9b6c85133aeb4716","519119f1deac45ff9ab4f13529be5c6e",21937630,1,4,0,2294,459,463,4
"519119f1deac45ff9ab4f13529be5c6e","519119f1deac45ff9ab4f13529be5c6e",21937630,1,0,1,2295,463,463,0
"519119f1deac45ff9ab4f13529be5c6e","9da37c6210b1416b8079c274f70bf600",21937630,1,-1,0,2296,463,462,-1
"9da37c6210b1416b8079c274f70bf600","9da37c6210b1416b8079c274f70bf600",21937630,1,0,1,2297,462,462,0
"9da37c6210b1416b8079c274f70bf600","0c4079457ede49e3aeb5e86ed84bdf35",21937630,1,-192,0,2298,462,329,-133
"0c4079457ede49e3aeb5e86ed84bdf35","4a92daef4d504e1792575a26502bb7b7",21937630,1,20,0,2299,329,346,17
"4a92daef4d504e1792575a26502bb7b7","bbc5139ca9024389a94db3a6f47dcff6",21937630,1,-6,0,2300,346,341,-5
"bbc5139ca9024389a94db3a6f47dcff6","30ead9794d4847abaf222ca966cc8630",21937630,1,10,0,2301,341,348,7
"30ead9794d4847abaf222ca966cc8630","492a3bc6a1254f23a7998587961b22a4",21937630,1,21,0,2302,348,366,18
"492a3bc6a1254f23a7998587961b22a4","c76574d21bc14aeea7ecd0b027f39858",21937630,1,2,0,2303,366,367,1
"c76574d21bc14aeea7ecd0b027f39858","52580888dadb4fe3baa795683ea227bd",21937630,1,-5,0,2304,367,364,-3
"52580888dadb4fe3baa795683ea227bd","072a190fd302456290895f9f04d6940a",21937630,1,2,0,2305,364,365,1
"072a190fd302456290895f9f04d6940a","f00179e251a045b39c3f7a54f9aa4acc",21937630,1,-3,0,2306,365,363,-2
"f00179e251a045b39c3f7a54f9aa4acc","2fe14166dc9642c3bc666b86a57f943d",21937630,1,-7,0,2307,363,357,-6
"2fe14166dc9642c3bc666b86a57f943d","f00179e251a045b39c3f7a54f9aa4acc",21937630,1,7,0,2308,357,363,6
"f00179e251a045b39c3f7a54f9aa4acc","4a29443515bb404cb8924e1c60a63b73",21937630,1,-99,0,2309,363,285,-78
"3434c10e561d488a914e0f7d71907abd","141c0df6cd1946539aadd1c9b7068cd4",21937630,1,4,0,2311,305,308,3
"141c0df6cd1946539aadd1c9b7068cd4","130acc2aeb0448fdbb2de63bc5cebe5b",21937630,1,1,0,2312,308,309,1
"130acc2aeb0448fdbb2de63bc5cebe5b","42de338840a34d15adb66e7b14fb9d2c",21937630,1,217,0,2313,309,461,152
"42de338840a34d15adb66e7b14fb9d2c","42de338840a34d15adb66e7b14fb9d2c",21937630,1,0,1,2314,461,461,0
"42de338840a34d15adb66e7b14fb9d2c","11bc14f2204949008b7d511b933363c1",21937630,1,-1,0,2315,461,460,-1
"11bc14f2204949008b7d511b933363c1","11bc14f2204949008b7d511b933363c1",21937630,1,0,1,2316,460,460,0
"11bc14f2204949008b7d511b933363c1","25c32b120fce40fa9b6c85133aeb4716",21937630,1,-1,0,2317,460,459,-1
"25c32b120fce40fa9b6c85133aeb4716","c33c17be71ae4d588da7369472e5bb1b",21937630,1,-589,0,2319,459,34,-425
"c33c17be71ae4d588da7369472e5bb1b","c33c17be71ae4d588da7369472e5bb1b",21937630,1,0,1,2320,34,34,0
"c33c17be71ae4d588da7369472e5bb1b","93679be414554a11b1893002f2229a93",21937630,2,3,0,2321,34,35,1
"93679be414554a11b1893002f2229a93","93679be414554a11b1893002f2229a93",21937630,1,0,1,2322,35,35,0
"93679be414554a11b1893002f2229a93","7040a13096d746ac84b8fac8d9752058",21937630,2,3,0,2323,35,36,1
"7040a13096d746ac84b8fac8d9752058","b613861cecf84ffcab01afb23f660475",21937630,1,-62,0,2324,36,1,-35
"b613861cecf84ffcab01afb23f660475","a49d1bb4328949299686242fd0be5584",21937630,1,34,0,2325,1,21,20
"a49d1bb4328949299686242fd0be5584","b7719e26494940efa49512aedd0aac79",21937630,1,-2,0,2326,21,20,-1
"b7719e26494940efa49512aedd0aac79","a49d1bb4328949299686242fd0be5584",21937630,2,2,0,2327,20,21,1
"a49d1bb4328949299686242fd0be5584","d4f45188d3c84a02ba08454e6403a818",21937630,2,3,0,2328,21,24,3
"d4f45188d3c84a02ba08454e6403a818","d4c3b003e8274e429d2fa688d73fde6d",21937630,5,-2,0,2329,24,22,-2
"d4c3b003e8274e429d2fa688d73fde6d","c33c17be71ae4d588da7369472e5bb1b",21937630,1,21,0,2330,22,34,12
"c33c17be71ae4d588da7369472e5bb1b","f67fbf45a5f146ed866965bc57c7c001",21937630,1,584,0,2331,34,454,420
"f67fbf45a5f146ed866965bc57c7c001","66baf19b6b904b70922329068c63746d",21937630,1,-120,0,2334,454,376,-78
"66baf19b6b904b70922329068c63746d","83d42d95cd844fc093fc09cee250edb8",21937630,1,135,0,2335,376,465,89
"f60ee41ec635499abd48168342d32c2f","9428d8bd9c5a47b2a235b254e5e27ded",21937630,3,-1,0,2349,453,452,-1
"9428d8bd9c5a47b2a235b254e5e27ded","83d42d95cd844fc093fc09cee250edb8",21937630,1,19,0,2350,452,465,13
"83d42d95cd844fc093fc09cee250edb8","f60ee41ec635499abd48168342d32c2f",21937630,1,-18,0,2352,465,453,-12
"9428d8bd9c5a47b2a235b254e5e27ded","b2f0d654738f48158edff28e8d3a546e",21937630,1,-4,0,2362,452,449,-3
"f60ee41ec635499abd48168342d32c2f","66baf19b6b904b70922329068c63746d",21937630,1,-117,0,2377,453,376,-77
"66baf19b6b904b70922329068c63746d","f7002c8484354eceac57bc7bd62c76c1",21937630,1,21,0,2378,376,393,17
"f7002c8484354eceac57bc7bd62c76c1","66baf19b6b904b70922329068c63746d",21937630,1,-21,0,2379,393,376,-17
"66baf19b6b904b70922329068c63746d","6f8881a745ac4c358a68b92c3b4abe81",21937630,2,22,0,2380,376,394,18
"6f8881a745ac4c358a68b92c3b4abe81","f60ee41ec635499abd48168342d32c2f",21937630,1,95,0,2381,394,453,59
"9428d8bd9c5a47b2a235b254e5e27ded","bec48fc2e1294c7eb3d0aca780d731b8",21937630,1,-53,0,2406,452,420,-32
"bec48fc2e1294c7eb3d0aca780d731b8","f60ee41ec635499abd48168342d32c2f",21937630,1,54,0,2409,420,453,33
"c5df9f40ec14463b9dcfdc73df3e9285","f67fbf45a5f146ed866965bc57c7c001",21937630,1,-12,0,2470,464,454,-10
"83d42d95cd844fc093fc09cee250edb8","c5df9f40ec14463b9dcfdc73df3e9285",21937630,1,-3,0,2473,465,464,-1
"83d42d95cd844fc093fc09cee250edb8","66baf19b6b904b70922329068c63746d",21937630,1,-135,0,2476,465,376,-89
"6f8881a745ac4c358a68b92c3b4abe81","83d42d95cd844fc093fc09cee250edb8",21937630,1,113,0,2478,394,465,71
"83d42d95cd844fc093fc09cee250edb8","f67fbf45a5f146ed866965bc57c7c001",21937630,1,-15,0,2480,465,454,-11
"b613861cecf84ffcab01afb23f660475","b613861cecf84ffcab01afb23f660475",22850075,3,0,1,1,1,1,0
"b613861cecf84ffcab01afb23f660475","e2911e79efc2420eac45d9f671463d4b",22850075,2,3,0,4,1,2,1
"e2911e79efc2420eac45d9f671463d4b","b613861cecf84ffcab01afb23f660475",22850075,1,-3,0,5,2,1,-1
"e2911e79efc2420eac45d9f671463d4b","e2911e79efc2420eac45d9f671463d4b",22850075,1,0,1,7,2,2,0
"e2911e79efc2420eac45d9f671463d4b","519d1b8c59404d67b54e96c5c8a830b2",22850075,1,1,0,8,2,3,1
"519d1b8c59404d67b54e96c5c8a830b2","519d1b8c59404d67b54e96c5c8a830b2",22850075,4,0,1,10,3,3,0
"519d1b8c59404d67b54e96c5c8a830b2","531db53f81f646edb0cdcfe0085b03b7",22850075,1,1,0,13,3,4,1
"531db53f81f646edb0cdcfe0085b03b7","531db53f81f646edb0cdcfe0085b03b7",22850075,1,0,1,14,4,4,0
"531db53f81f646edb0cdcfe0085b03b7","4f5f94b2f95141e0a9d53a61da2276da",22850075,1,1,0,15,4,5,1
"4f5f94b2f95141e0a9d53a61da2276da","4f5f94b2f95141e0a9d53a61da2276da",22850075,1,0,1,16,5,5,0
"4f5f94b2f95141e0a9d53a61da2276da","6d541c89590949f99af293c4f2333f67",22850075,1,1,0,17,5,6,1
"6d541c89590949f99af293c4f2333f67","6d541c89590949f99af293c4f2333f67",22850075,1,0,1,18,6,6,0
"6d541c89590949f99af293c4f2333f67","dd5cf0b9fe4c4f1d8f5ff8e4c04879cb",22850075,1,1,0,19,6,7,1
"dd5cf0b9fe4c4f1d8f5ff8e4c04879cb","dd5cf0b9fe4c4f1d8f5ff8e4c04879cb",22850075,1,0,1,20,7,7,0
"dd5cf0b9fe4c4f1d8f5ff8e4c04879cb","f96261861edc426abe2248be4f0a709a",22850075,1,1,0,21,7,8,1
"f96261861edc426abe2248be4f0a709a","f96261861edc426abe2248be4f0a709a",22850075,2,0,1,22,8,8,0
"f96261861edc426abe2248be4f0a709a","66b5e16f4f75454fb5b8172079f0fa83",22850075,1,1,0,24,8,9,1
"66b5e16f4f75454fb5b8172079f0fa83","66b5e16f4f75454fb5b8172079f0fa83",22850075,1,0,1,25,9,9,0
"66b5e16f4f75454fb5b8172079f0fa83","0680571d4698477995e41842c36a54b2",22850075,1,1,0,26,9,10,1
"0680571d4698477995e41842c36a54b2","0680571d4698477995e41842c36a54b2",22850075,2,0,1,27,10,10,0
"0680571d4698477995e41842c36a54b2","9112f2bffece48e08c6d2287be204085",22850075,1,1,0,29,10,11,1
"9112f2bffece48e08c6d2287be204085","9112f2bffece48e08c6d2287be204085",22850075,2,0,1,30,11,11,0
"9112f2bffece48e08c6d2287be204085","56586aa865414f538729c7f7735d2bc6",22850075,1,3,0,32,11,12,1
"56586aa865414f538729c7f7735d2bc6","e2911e79efc2420eac45d9f671463d4b",22850075,1,-12,0,33,12,2,-10
"e2911e79efc2420eac45d9f671463d4b","56586aa865414f538729c7f7735d2bc6",22850075,1,12,0,34,2,12,10
"56586aa865414f538729c7f7735d2bc6","56586aa865414f538729c7f7735d2bc6",22850075,5,0,1,35,12,12,0
"56586aa865414f538729c7f7735d2bc6","b7f2b31585d94eb3bf86376714aa7070",22850075,1,2,0,40,12,13,1
"b7f2b31585d94eb3bf86376714aa7070","b7f2b31585d94eb3bf86376714aa7070",22850075,1,0,1,41,13,13,0
"b7f2b31585d94eb3bf86376714aa7070","3f1c815879794b929260d224becaff7e",22850075,1,2,0,42,13,14,1
"3f1c815879794b929260d224becaff7e","81c864a886d54a6b8ff85f7d736f4f95",22850075,1,2,0,43,14,15,1
"81c864a886d54a6b8ff85f7d736f4f95","5c5ceeee4562457ba6d41515aeebfbb1",22850075,1,4,0,44,15,17,2
"5c5ceeee4562457ba6d41515aeebfbb1","56586aa865414f538729c7f7735d2bc6",22850075,1,-10,0,45,17,12,-5
"56586aa865414f538729c7f7735d2bc6","9afd71a5298d4333b6849dfce1b9422c",22850075,1,13,0,46,12,18,6
"9afd71a5298d4333b6849dfce1b9422c","9afd71a5298d4333b6849dfce1b9422c",22850075,5,0,1,47,18,18,0
"9afd71a5298d4333b6849dfce1b9422c","b7719e26494940efa49512aedd0aac79",22850075,1,4,0,52,18,20,2
"b7719e26494940efa49512aedd0aac79","d4f45188d3c84a02ba08454e6403a818",22850075,1,5,0,53,20,24,4
"d4f45188d3c84a02ba08454e6403a818","d4c3b003e8274e429d2fa688d73fde6d",22850075,1,-2,0,54,24,22,-2
"d4c3b003e8274e429d2fa688d73fde6d","b7719e26494940efa49512aedd0aac79",22850075,1,-3,0,55,22,20,-2
"b7719e26494940efa49512aedd0aac79","afbf7250b99d47bea07172749483ca97",22850075,1,12,0,56,20,28,8
"afbf7250b99d47bea07172749483ca97","b7719e26494940efa49512aedd0aac79",22850075,1,-12,0,57,28,20,-8
"b7719e26494940efa49512aedd0aac79","4e51676dc72045d99c19b9fa7b22f8bc",22850075,1,15,0,58,20,29,9
"4e51676dc72045d99c19b9fa7b22f8bc","afbf7250b99d47bea07172749483ca97",22850075,1,-3,0,59,29,28,-1
"afbf7250b99d47bea07172749483ca97","4e51676dc72045d99c19b9fa7b22f8bc",22850075,1,3,0,60,28,29,1
"4e51676dc72045d99c19b9fa7b22f8bc","51970cfa30e643e894e66ae85c8024cc",22850075,1,3,0,61,29,31,2
"51970cfa30e643e894e66ae85c8024cc","4e51676dc72045d99c19b9fa7b22f8bc",22850075,1,-3,0,62,31,29,-2
"4e51676dc72045d99c19b9fa7b22f8bc","c33c17be71ae4d588da7369472e5bb1b",22850075,1,9,0,63,29,34,5
"c33c17be71ae4d588da7369472e5bb1b","93679be414554a11b1893002f2229a93",22850075,2,3,0,64,34,35,1
"93679be414554a11b1893002f2229a93","c33c17be71ae4d588da7369472e5bb1b",22850075,1,-3,0,65,35,34,-1
"93679be414554a11b1893002f2229a93","7040a13096d746ac84b8fac8d9752058",22850075,1,3,0,67,35,36,1
"7040a13096d746ac84b8fac8d9752058","9a0dc646f934470daf08c4b56ccf73db",22850075,1,3,0,68,36,37,1
"9a0dc646f934470daf08c4b56ccf73db","7040a13096d746ac84b8fac8d9752058",22850075,1,-3,0,69,37,36,-1
"7040a13096d746ac84b8fac8d9752058","fc0e049d56024bc9a02c9a9c435c3df7",22850075,1,6,0,70,36,38,2
"fc0e049d56024bc9a02c9a9c435c3df7","9a0dc646f934470daf08c4b56ccf73db",22850075,1,-3,0,71,38,37,-1
"9a0dc646f934470daf08c4b56ccf73db","fc0e049d56024bc9a02c9a9c435c3df7",22850075,1,3,0,72,37,38,1
"fc0e049d56024bc9a02c9a9c435c3df7","fc0e049d56024bc9a02c9a9c435c3df7",22850075,5,0,1,73,38,38,0
"fc0e049d56024bc9a02c9a9c435c3df7","67a089198fcb4e1c8f2385786c2b296f",22850075,1,4,0,78,38,39,1
"67a089198fcb4e1c8f2385786c2b296f","fc0e049d56024bc9a02c9a9c435c3df7",22850075,1,-4,0,79,39,38,-1
"fc0e049d56024bc9a02c9a9c435c3df7","64d48c6c9c7940639a932219a6c87198",22850075,1,5,0,80,38,40,2
"64d48c6c9c7940639a932219a6c87198","64d48c6c9c7940639a932219a6c87198",22850075,1,0,1,81,40,40,0
"64d48c6c9c7940639a932219a6c87198","b534b89233134e30a9b5645138bfa9ee",22850075,1,3,0,82,40,41,1
"b534b89233134e30a9b5645138bfa9ee","67a089198fcb4e1c8f2385786c2b296f",22850075,1,-4,0,83,41,39,-2
"67a089198fcb4e1c8f2385786c2b296f","0e37b720d23b4e7f8b313e79313fd107",22850075,1,7,0,84,39,44,5
"0e37b720d23b4e7f8b313e79313fd107","0e37b720d23b4e7f8b313e79313fd107",22850075,1,0,1,85,44,44,0
"0e37b720d23b4e7f8b313e79313fd107","6875d67fdd5f48168b62719df449bebd",22850075,1,1,0,86,44,45,1
"6875d67fdd5f48168b62719df449bebd","6875d67fdd5f48168b62719df449bebd",22850075,1,0,1,87,45,45,0
"6875d67fdd5f48168b62719df449bebd","6e13d61a7bdb44bca949c9f86fab3be5",22850075,1,3,0,88,45,47,2
"b534b89233134e30a9b5645138bfa9ee","195f78799f984cc2b06c48dfe36be751",22850075,1,9,0,90,41,49,8
"195f78799f984cc2b06c48dfe36be751","195f78799f984cc2b06c48dfe36be751",22850075,2,0,1,91,49,49,0
"195f78799f984cc2b06c48dfe36be751","d0c74f735e024943943e40333d6d337f",22850075,1,3,0,93,49,51,2
"d0c74f735e024943943e40333d6d337f","d9c8d8c444a64dadbbb508652c721e17",22850075,1,-6,0,94,51,46,-5
"d9c8d8c444a64dadbbb508652c721e17","983f8ff320594b279a7f4a6fe132f9c5",22850075,1,8,0,95,46,53,7
"983f8ff320594b279a7f4a6fe132f9c5","983f8ff320594b279a7f4a6fe132f9c5",22850075,2,0,1,96,53,53,0
"983f8ff320594b279a7f4a6fe132f9c5","35adfa5d923046aebabfefd98f35ff05",22850075,1,1,0,98,53,54,1
"35adfa5d923046aebabfefd98f35ff05","35adfa5d923046aebabfefd98f35ff05",22850075,3,0,1,100,54,54,0
"35adfa5d923046aebabfefd98f35ff05","b6f8a98476224da1b40e555ececc7ed8",22850075,1,1,0,102,54,55,1
"b6f8a98476224da1b40e555ececc7ed8","b6f8a98476224da1b40e555ececc7ed8",22850075,2,0,1,103,55,55,0
"b6f8a98476224da1b40e555ececc7ed8","86e22cb5fe0e4b47a9489ecddf7ed78f",22850075,1,1,0,105,55,56,1
"86e22cb5fe0e4b47a9489ecddf7ed78f","86e22cb5fe0e4b47a9489ecddf7ed78f",22850075,2,0,1,106,56,56,0
"86e22cb5fe0e4b47a9489ecddf7ed78f","f924752d8a1149668870b1e7698486f7",22850075,1,-6,0,108,56,50,-6
"f924752d8a1149668870b1e7698486f7","a1f2f12debe5432fb7a70bcd12bacfb9",22850075,1,9,0,109,50,58,8
"a1f2f12debe5432fb7a70bcd12bacfb9","78f30e4dcac84e3cbea8b2cc6e0d62b3",22850075,3,1,0,110,58,59,1
"78f30e4dcac84e3cbea8b2cc6e0d62b3","a1f2f12debe5432fb7a70bcd12bacfb9",22850075,2,-1,0,111,59,58,-1
"a1f2f12debe5432fb7a70bcd12bacfb9","a1f2f12debe5432fb7a70bcd12bacfb9",22850075,18,0,1,112,58,58,0
"78f30e4dcac84e3cbea8b2cc6e0d62b3","78f30e4dcac84e3cbea8b2cc6e0d62b3",22850075,16,0,1,124,59,59,0
"78f30e4dcac84e3cbea8b2cc6e0d62b3","a0a418b8540d479fa6e0f653b701da8b",22850075,1,6,0,149,59,64,5
"a0a418b8540d479fa6e0f653b701da8b","bc42d26810654ea9a1df1efe1e58c7d5",22850075,1,-1,0,150,64,63,-1
"bc42d26810654ea9a1df1efe1e58c7d5","12aa6e1672ac4e7aa6449a7a8609cd72",22850075,1,-7,0,151,63,57,-6
"12aa6e1672ac4e7aa6449a7a8609cd72","4c943503763e4e349906eea3ed3c8e86",22850075,1,5,0,152,57,61,4
"4c943503763e4e349906eea3ed3c8e86","4c943503763e4e349906eea3ed3c8e86",22850075,1,0,1,153,61,61,0
"4c943503763e4e349906eea3ed3c8e86","309ccf3cc4fe429d9bfbaef53d3fa479",22850075,1,-1,0,154,61,60,-1
"309ccf3cc4fe429d9bfbaef53d3fa479","d646286c8051419bbc2e31dd1db55ca8",22850075,1,10,0,155,60,67,7
"d646286c8051419bbc2e31dd1db55ca8","b534b89233134e30a9b5645138bfa9ee",22850075,1,-33,0,156,67,41,-26
"b534b89233134e30a9b5645138bfa9ee","267f883678b24aed855fde42524975d9",22850075,1,37,0,157,41,71,30
"267f883678b24aed855fde42524975d9","267f883678b24aed855fde42524975d9",22850075,1,0,1,158,71,71,0
"267f883678b24aed855fde42524975d9","88fff56d0342490dbef9040750a20f6c",22850075,1,1,0,159,71,72,1
"88fff56d0342490dbef9040750a20f6c","88fff56d0342490dbef9040750a20f6c",22850075,1,0,1,160,72,72,0
"88fff56d0342490dbef9040750a20f6c","adb17b12b66c4a49a85fd34322f7df70",22850075,1,1,0,161,72,73,1
"adb17b12b66c4a49a85fd34322f7df70","adb17b12b66c4a49a85fd34322f7df70",22850075,1,0,1,162,73,73,0
"adb17b12b66c4a49a85fd34322f7df70","d646286c8051419bbc2e31dd1db55ca8",22850075,1,-6,0,163,73,67,-6
"d646286c8051419bbc2e31dd1db55ca8","a2becd407db34b189200a32546d9d569",22850075,1,9,0,164,67,75,8
"a2becd407db34b189200a32546d9d569","58c22b011d0f4c2ea6d13615edbb9eeb",22850075,1,2,0,165,75,77,2
"58c22b011d0f4c2ea6d13615edbb9eeb","58c22b011d0f4c2ea6d13615edbb9eeb",22850075,2,0,1,166,77,77,0
"58c22b011d0f4c2ea6d13615edbb9eeb","dd76e1861dc9461c830888729d091ee0",22850075,1,1,0,168,77,78,1
"dd76e1861dc9461c830888729d091ee0","dd76e1861dc9461c830888729d091ee0",22850075,5,0,1,169,78,78,0
"dd76e1861dc9461c830888729d091ee0","cd1d828f1a694b87913a7ea66c23803e",22850075,1,1,0,174,78,79,1
"cd1d828f1a694b87913a7ea66c23803e","cd1d828f1a694b87913a7ea66c23803e",22850075,8,0,1,175,79,79,0
"cd1d828f1a694b87913a7ea66c23803e","9176a3c2b4d2465fa8b0c67096c2a97e",22850075,1,1,0,183,79,80,1
"9176a3c2b4d2465fa8b0c67096c2a97e","9176a3c2b4d2465fa8b0c67096c2a97e",22850075,5,0,1,184,80,80,0
"9176a3c2b4d2465fa8b0c67096c2a97e","f8ec6445f7194e25b9101d4fbcb07a18",22850075,1,1,0,189,80,81,1
"f8ec6445f7194e25b9101d4fbcb07a18","f8ec6445f7194e25b9101d4fbcb07a18",22850075,2,0,1,190,81,81,0
"f8ec6445f7194e25b9101d4fbcb07a18","140d5b27b8574befad82c0a013b59dfa",22850075,1,-7,0,192,81,74,-7
"140d5b27b8574befad82c0a013b59dfa","d18a9ea32855445f8736581f5cb119ce",22850075,1,9,0,193,74,82,8
"d18a9ea32855445f8736581f5cb119ce","f564483cbd7a407681aa2fcca518cf5f",22850075,1,4,0,194,82,85,3
"f564483cbd7a407681aa2fcca518cf5f","f564483cbd7a407681aa2fcca518cf5f",22850075,5,0,1,195,85,85,0
"f564483cbd7a407681aa2fcca518cf5f","18fd01350bd5434ca636d59a599d768a",22850075,1,1,0,200,85,86,1
"18fd01350bd5434ca636d59a599d768a","18fd01350bd5434ca636d59a599d768a",22850075,8,0,1,201,86,86,0
"18fd01350bd5434ca636d59a599d768a","6a9f0ef185fb47f0937e29daa1c71ed5",22850075,1,5,0,209,86,90,4
"6a9f0ef185fb47f0937e29daa1c71ed5","ae5ac430ea254e708a6f5deaaf7464ae",22850075,1,-7,0,210,90,84,-6
"ae5ac430ea254e708a6f5deaaf7464ae","d646286c8051419bbc2e31dd1db55ca8",22850075,1,-20,0,211,84,67,-17
"d646286c8051419bbc2e31dd1db55ca8","6a9f0ef185fb47f0937e29daa1c71ed5",22850075,1,27,0,212,67,90,23
"6a9f0ef185fb47f0937e29daa1c71ed5","c681290961c94c4caf23b529d1ae6b9a",22850075,1,-2,0,213,90,88,-2
"c681290961c94c4caf23b529d1ae6b9a","c681290961c94c4caf23b529d1ae6b9a",22850075,1,0,1,214,88,88,0
"c681290961c94c4caf23b529d1ae6b9a","6a9f0ef185fb47f0937e29daa1c71ed5",22850075,1,2,0,215,88,90,2
"6a9f0ef185fb47f0937e29daa1c71ed5","6a9f0ef185fb47f0937e29daa1c71ed5",22850075,3,0,1,216,90,90,0
"6a9f0ef185fb47f0937e29daa1c71ed5","d646286c8051419bbc2e31dd1db55ca8",22850075,1,-27,0,219,90,67,-23
"d646286c8051419bbc2e31dd1db55ca8","e20db35ced8544ddac5bc3839145e463",22850075,1,30,0,220,67,91,24
"e20db35ced8544ddac5bc3839145e463","1febb706d7a34005ae8711ed49c76e64",22850075,1,3,0,221,91,94,3
"1febb706d7a34005ae8711ed49c76e64","1febb706d7a34005ae8711ed49c76e64",22850075,7,0,1,222,94,94,0
"1febb706d7a34005ae8711ed49c76e64","8f73ba6f5a0042f2850356ac38ac6f24",22850075,1,1,0,229,94,95,1
"8f73ba6f5a0042f2850356ac38ac6f24","8f73ba6f5a0042f2850356ac38ac6f24",22850075,5,0,1,230,95,95,0
"8f73ba6f5a0042f2850356ac38ac6f24","e2260b86653c46d7b14a41fb419dbf8c",22850075,1,1,0,235,95,96,1
"e2260b86653c46d7b14a41fb419dbf8c","e2260b86653c46d7b14a41fb419dbf8c",22850075,2,0,1,236,96,96,0
"e2260b86653c46d7b14a41fb419dbf8c","35eb641ad1d845bbba54915bce75a962",22850075,1,1,0,238,96,97,1
"35eb641ad1d845bbba54915bce75a962","35eb641ad1d845bbba54915bce75a962",22850075,5,0,1,239,97,97,0
"35eb641ad1d845bbba54915bce75a962","08be90ffbeea4795a138cd42ed8db56f",22850075,1,1,0,244,97,98,1
"08be90ffbeea4795a138cd42ed8db56f","08be90ffbeea4795a138cd42ed8db56f",22850075,2,0,1,245,98,98,0
"08be90ffbeea4795a138cd42ed8db56f","3007433c8f584dcbb5ac159c1c5f2be3",22850075,1,1,0,247,98,99,1
"3007433c8f584dcbb5ac159c1c5f2be3","3007433c8f584dcbb5ac159c1c5f2be3",22850075,5,0,1,248,99,99,0
"3007433c8f584dcbb5ac159c1c5f2be3","e20db35ced8544ddac5bc3839145e463",22850075,1,-8,0,253,99,91,-8
"e20db35ced8544ddac5bc3839145e463","00ae5f0c51874a73a41ebea838d95682",22850075,2,11,0,254,91,101,10
"00ae5f0c51874a73a41ebea838d95682","d391c8b6e56a43a7b654e9dee02d904b",22850075,3,2,0,255,101,103,2
"d391c8b6e56a43a7b654e9dee02d904b","67a089198fcb4e1c8f2385786c2b296f",22850075,1,-80,0,256,103,39,-64
"67a089198fcb4e1c8f2385786c2b296f","78adeee1fa2c4fe0bc73f7bca9fcee86",22850075,2,152,0,257,39,160,121
"78adeee1fa2c4fe0bc73f7bca9fcee86","78adeee1fa2c4fe0bc73f7bca9fcee86",22850075,3,0,1,258,160,160,0
"78adeee1fa2c4fe0bc73f7bca9fcee86","3cbcea2be0984e7dbd5a48195af10ce7",22850075,1,8,0,260,160,165,5
"3cbcea2be0984e7dbd5a48195af10ce7","3cbcea2be0984e7dbd5a48195af10ce7",22850075,1,0,1,261,165,165,0
"3cbcea2be0984e7dbd5a48195af10ce7","82e6285962b8400d9d6fc32436022a94",22850075,2,2,0,262,165,167,2
"82e6285962b8400d9d6fc32436022a94","67a089198fcb4e1c8f2385786c2b296f",22850075,2,-162,0,263,167,39,-128
"67a089198fcb4e1c8f2385786c2b296f","73039f8c1eb9409cb4caee2cf968001e",22850075,1,77,0,264,39,100,61
"73039f8c1eb9409cb4caee2cf968001e","e20db35ced8544ddac5bc3839145e463",22850075,1,-10,0,265,100,91,-9
"d391c8b6e56a43a7b654e9dee02d904b","3cbcea2be0984e7dbd5a48195af10ce7",22850075,1,80,0,268,103,165,62
"67a089198fcb4e1c8f2385786c2b296f","e20db35ced8544ddac5bc3839145e463",22850075,1,67,0,271,39,91,52
"e20db35ced8544ddac5bc3839145e463","73039f8c1eb9409cb4caee2cf968001e",22850075,1,10,0,272,91,100,9
"73039f8c1eb9409cb4caee2cf968001e","00ae5f0c51874a73a41ebea838d95682",22850075,1,1,0,273,100,101,1
"d391c8b6e56a43a7b654e9dee02d904b","d391c8b6e56a43a7b654e9dee02d904b",22850075,21,0,1,275,103,103,0
"d391c8b6e56a43a7b654e9dee02d904b","6111116566fc4fd9abba409322bea245",22850075,1,1,0,296,103,104,1
"6111116566fc4fd9abba409322bea245","6111116566fc4fd9abba409322bea245",22850075,2,0,1,297,104,104,0
"6111116566fc4fd9abba409322bea245","a81b2235cb9c499eb9ea8ee0a8dd9725",22850075,1,1,0,299,104,105,1
"a81b2235cb9c499eb9ea8ee0a8dd9725","a81b2235cb9c499eb9ea8ee0a8dd9725",22850075,5,0,1,300,105,105,0
"a81b2235cb9c499eb9ea8ee0a8dd9725","2d4e0ab0ef3b4d73b82c72d4621a7579",22850075,1,1,0,305,105,106,1
"2d4e0ab0ef3b4d73b82c72d4621a7579","2d4e0ab0ef3b4d73b82c72d4621a7579",22850075,2,0,1,306,106,106,0
"2d4e0ab0ef3b4d73b82c72d4621a7579","8bdebf492ebd4e62b0d522e8ab5e5197",22850075,1,1,0,308,106,107,1
"8bdebf492ebd4e62b0d522e8ab5e5197","8bdebf492ebd4e62b0d522e8ab5e5197",22850075,2,0,1,309,107,107,0
"8bdebf492ebd4e62b0d522e8ab5e5197","73039f8c1eb9409cb4caee2cf968001e",22850075,1,-7,0,311,107,100,-7
"73039f8c1eb9409cb4caee2cf968001e","fc44e6a5f7654430af1227838224dceb",22850075,1,12,0,312,100,111,11
"fc44e6a5f7654430af1227838224dceb","fc44e6a5f7654430af1227838224dceb",22850075,2,0,1,313,111,111,0
"fc44e6a5f7654430af1227838224dceb","4280927ec4d643238aa49c32f9e06c6c",22850075,1,-2,0,315,111,109,-2
"4280927ec4d643238aa49c32f9e06c6c","4280927ec4d643238aa49c32f9e06c6c",22850075,2,0,1,316,109,109,0
"4280927ec4d643238aa49c32f9e06c6c","08111f75e22d409998cf8b85bd431f0a",22850075,1,-1,0,318,109,108,-1
"08111f75e22d409998cf8b85bd431f0a","a9ae0a3c070d455bb4369a8996313336",22850075,1,7,0,319,108,114,6
"a9ae0a3c070d455bb4369a8996313336","71cec822bcff4f30a20e75dc63ef7b65",22850075,1,2,0,320,114,116,2
"71cec822bcff4f30a20e75dc63ef7b65","71cec822bcff4f30a20e75dc63ef7b65",22850075,1,0,1,321,116,116,0
"71cec822bcff4f30a20e75dc63ef7b65","37319e88176d4aefa91d7a9980dbae91",22850075,1,-4,0,322,116,112,-4
"37319e88176d4aefa91d7a9980dbae91","62bff51286ef4f348717a3cf6fe2318f",22850075,1,9,0,323,112,120,8
"62bff51286ef4f348717a3cf6fe2318f","b1cd0e7dc3ad4a8eb91a4bfdbeb025b0",22850075,1,-2,0,324,120,118,-2
"b1cd0e7dc3ad4a8eb91a4bfdbeb025b0","b1cd0e7dc3ad4a8eb91a4bfdbeb025b0",22850075,1,0,1,325,118,118,0
"b1cd0e7dc3ad4a8eb91a4bfdbeb025b0","62bff51286ef4f348717a3cf6fe2318f",22850075,1,2,0,326,118,120,2
"62bff51286ef4f348717a3cf6fe2318f","62bff51286ef4f348717a3cf6fe2318f",22850075,3,0,1,327,120,120,0
"62bff51286ef4f348717a3cf6fe2318f","e20db35ced8544ddac5bc3839145e463",22850075,1,-33,0,330,120,91,-29
"e20db35ced8544ddac5bc3839145e463","779f9ddd1fd14d1e9e69f72219a1fdbd",22850075,1,36,0,331,91,121,30
"779f9ddd1fd14d1e9e69f72219a1fdbd","ae26e6cda8ad4a3f81bd347560d9579f",22850075,1,4,0,332,121,125,4
"ae26e6cda8ad4a3f81bd347560d9579f","ae26e6cda8ad4a3f81bd347560d9579f",22850075,5,0,1,333,125,125,0
"ae26e6cda8ad4a3f81bd347560d9579f","ee48df95832b4374aa273ceb27ec1315",22850075,1,1,0,338,125,126,1
"ee48df95832b4374aa273ceb27ec1315","ee48df95832b4374aa273ceb27ec1315",22850075,1,0,1,339,126,126,0
"ee48df95832b4374aa273ceb27ec1315","7a439da90b394756ad1777fc4c6dead5",22850075,1,1,0,340,126,127,1
"7a439da90b394756ad1777fc4c6dead5","7a439da90b394756ad1777fc4c6dead5",22850075,3,0,1,341,127,127,0
"7a439da90b394756ad1777fc4c6dead5","779f9ddd1fd14d1e9e69f72219a1fdbd",22850075,1,-6,0,344,127,121,-6
"779f9ddd1fd14d1e9e69f72219a1fdbd","a8dd5213034441ac92724b4e83eb0bb2",22850075,1,9,0,345,121,129,8
"a8dd5213034441ac92724b4e83eb0bb2","8115eab6556b45f5b415c3b8c26a12e5",22850075,1,2,0,346,129,131,2
"8115eab6556b45f5b415c3b8c26a12e5","8115eab6556b45f5b415c3b8c26a12e5",22850075,8,0,1,347,131,131,0
"8115eab6556b45f5b415c3b8c26a12e5","ec34b06efd844b46a4c4818ecdb9b8f4",22850075,1,1,0,355,131,132,1
"ec34b06efd844b46a4c4818ecdb9b8f4","ec34b06efd844b46a4c4818ecdb9b8f4",22850075,5,0,1,356,132,132,0
"ec34b06efd844b46a4c4818ecdb9b8f4","c2e1c2b9eac64109b343a088584b576b",22850075,1,1,0,361,132,133,1
"c2e1c2b9eac64109b343a088584b576b","c2e1c2b9eac64109b343a088584b576b",22850075,2,0,1,362,133,133,0
"c2e1c2b9eac64109b343a088584b576b","579338175e0b4bbb8ef3b712b5d8b54e",22850075,1,-5,0,364,133,128,-5
"579338175e0b4bbb8ef3b712b5d8b54e","8bc5795d6a984a3eace4e2811e52dd4f",22850075,1,8,0,365,128,135,7
"8bc5795d6a984a3eace4e2811e52dd4f","8bc5795d6a984a3eace4e2811e52dd4f",22850075,1,0,1,366,135,135,0
"8bc5795d6a984a3eace4e2811e52dd4f","b416d47c56a742199b5d7c7f19d6503a",22850075,1,-1,0,367,135,134,-1
"b416d47c56a742199b5d7c7f19d6503a","779f9ddd1fd14d1e9e69f72219a1fdbd",22850075,3,-15,0,368,134,121,-13
"779f9ddd1fd14d1e9e69f72219a1fdbd","b416d47c56a742199b5d7c7f19d6503a",22850075,2,15,0,369,121,134,13
"779f9ddd1fd14d1e9e69f72219a1fdbd","f661500307d74c908e9207d949ceb4aa",22850075,1,18,0,373,121,136,15
"f661500307d74c908e9207d949ceb4aa","779f9ddd1fd14d1e9e69f72219a1fdbd",22850075,1,-18,0,374,136,121,-15
"779f9ddd1fd14d1e9e69f72219a1fdbd","cd4532ad48034873ba8bce2aac0c9808",22850075,1,19,0,375,121,137,16
"cd4532ad48034873ba8bce2aac0c9808","cd4532ad48034873ba8bce2aac0c9808",22850075,1,0,1,376,137,137,0
"cd4532ad48034873ba8bce2aac0c9808","779f9ddd1fd14d1e9e69f72219a1fdbd",22850075,1,-19,0,377,137,121,-16
"779f9ddd1fd14d1e9e69f72219a1fdbd","df1de691dafe4549a18a4398ee9dfaf9",22850075,1,23,0,378,121,139,18
"df1de691dafe4549a18a4398ee9dfaf9","6c5ad271a44743479bfaea29b1db8d02",22850075,1,4,0,379,139,143,4
"6c5ad271a44743479bfaea29b1db8d02","83d311bed5374fee83d8d67a7d9d82dc",22850075,1,1,0,380,143,144,1
"83d311bed5374fee83d8d67a7d9d82dc","83d311bed5374fee83d8d67a7d9d82dc",22850075,1,0,1,381,144,144,0
"83d311bed5374fee83d8d67a7d9d82dc","402bba41861d43acb52a5abb89e8831e",22850075,1,1,0,382,144,145,1
"402bba41861d43acb52a5abb89e8831e","402bba41861d43acb52a5abb89e8831e",22850075,2,0,1,383,145,145,0
"402bba41861d43acb52a5abb89e8831e","df1de691dafe4549a18a4398ee9dfaf9",22850075,1,-6,0,385,145,139,-6
"df1de691dafe4549a18a4398ee9dfaf9","8aae34f5ddbb4052a709b12e6b0d40fa",22850075,1,9,0,386,139,147,8
"8aae34f5ddbb4052a709b12e6b0d40fa","645b3f0249f64f76af2e19eb4d0e55b7",22850075,1,2,0,387,147,149,2
"645b3f0249f64f76af2e19eb4d0e55b7","645b3f0249f64f76af2e19eb4d0e55b7",22850075,2,0,1,388,149,149,0
"645b3f0249f64f76af2e19eb4d0e55b7","7e7b8db5064d4369805ab370aac5ddfb",22850075,1,1,0,390,149,150,1
"7e7b8db5064d4369805ab370aac5ddfb","7e7b8db5064d4369805ab370aac5ddfb",22850075,5,0,1,391,150,150,0
"7e7b8db5064d4369805ab370aac5ddfb","8956d210ae7f41968fada86d4c979d6a",22850075,1,1,0,396,150,151,1
"8956d210ae7f41968fada86d4c979d6a","8956d210ae7f41968fada86d4c979d6a",22850075,2,0,1,397,151,151,0
"8956d210ae7f41968fada86d4c979d6a","f902b0f41b544d4dbf79664fd233648d",22850075,1,-5,0,399,151,146,-5
"f902b0f41b544d4dbf79664fd233648d","ae781e8b775e4ccd93bc800dad5c8376",22850075,1,8,0,400,146,153,7
"ae781e8b775e4ccd93bc800dad5c8376","ae781e8b775e4ccd93bc800dad5c8376",22850075,2,0,1,401,153,153,0
"ae781e8b775e4ccd93bc800dad5c8376","06882a8492d9499aa31555567f575ecb",22850075,1,1,0,403,153,154,1
"06882a8492d9499aa31555567f575ecb","06882a8492d9499aa31555567f575ecb",22850075,1,0,1,404,154,154,0
"06882a8492d9499aa31555567f575ecb","f293c508f409466a8f27ddd7d1e40b20",22850075,1,1,0,405,154,155,1
"f293c508f409466a8f27ddd7d1e40b20","f293c508f409466a8f27ddd7d1e40b20",22850075,9,0,1,406,155,155,0
"f293c508f409466a8f27ddd7d1e40b20","cc4ddef5bbbe48ebb605141b347c4ed1",22850075,1,1,0,415,155,156,1
"cc4ddef5bbbe48ebb605141b347c4ed1","cc4ddef5bbbe48ebb605141b347c4ed1",22850075,1,0,1,416,156,156,0
"cc4ddef5bbbe48ebb605141b347c4ed1","f03480cf4eba413194d7af52fc0e7f28",22850075,1,-4,0,417,156,152,-4
"f03480cf4eba413194d7af52fc0e7f28","d313cec988a84645bee413e8d4724a4b",22850075,1,7,0,418,152,158,6
"d313cec988a84645bee413e8d4724a4b","dc60696c76a74368a60f72246e47700d",22850075,1,1,0,419,158,159,1
"dc60696c76a74368a60f72246e47700d","dc60696c76a74368a60f72246e47700d",22850075,1,0,1,420,159,159,0
"dc60696c76a74368a60f72246e47700d","78adeee1fa2c4fe0bc73f7bca9fcee86",22850075,1,3,0,421,159,160,1
"78adeee1fa2c4fe0bc73f7bca9fcee86","df1de691dafe4549a18a4398ee9dfaf9",22850075,1,-26,0,422,160,139,-21
"df1de691dafe4549a18a4398ee9dfaf9","df1de691dafe4549a18a4398ee9dfaf9",22850075,1,0,1,423,139,139,0
"df1de691dafe4549a18a4398ee9dfaf9","d313cec988a84645bee413e8d4724a4b",22850075,1,22,0,424,139,158,19
"d313cec988a84645bee413e8d4724a4b","df1de691dafe4549a18a4398ee9dfaf9",22850075,1,-22,0,425,158,139,-19
"df1de691dafe4549a18a4398ee9dfaf9","78adeee1fa2c4fe0bc73f7bca9fcee86",22850075,1,26,0,426,139,160,21
"78adeee1fa2c4fe0bc73f7bca9fcee86","67a089198fcb4e1c8f2385786c2b296f",22850075,1,-152,0,427,160,39,-121
"67a089198fcb4e1c8f2385786c2b296f","d9c8d8c444a64dadbbb508652c721e17",22850075,1,10,0,428,39,46,7
"d9c8d8c444a64dadbbb508652c721e17","b534b89233134e30a9b5645138bfa9ee",22850075,1,-6,0,429,46,41,-5
"b534b89233134e30a9b5645138bfa9ee","6e13d61a7bdb44bca949c9f86fab3be5",22850075,2,7,0,430,41,47,6
"6e13d61a7bdb44bca949c9f86fab3be5","b534b89233134e30a9b5645138bfa9ee",22850075,2,-7,0,431,47,41,-6
"6e13d61a7bdb44bca949c9f86fab3be5","67a089198fcb4e1c8f2385786c2b296f",22850075,1,-11,0,433,47,39,-8
"78adeee1fa2c4fe0bc73f7bca9fcee86","65202579580f4ad38d734b4ee39d22a8",22850075,3,5,0,436,160,164,4
"65202579580f4ad38d734b4ee39d22a8","65202579580f4ad38d734b4ee39d22a8",22850075,68,0,1,437,164,164,0
"65202579580f4ad38d734b4ee39d22a8","78adeee1fa2c4fe0bc73f7bca9fcee86",22850075,1,-5,0,442,164,160,-4
"65202579580f4ad38d734b4ee39d22a8","3cbcea2be0984e7dbd5a48195af10ce7",22850075,1,3,0,492,164,165,1
"3cbcea2be0984e7dbd5a48195af10ce7","78adeee1fa2c4fe0bc73f7bca9fcee86",22850075,1,-8,0,493,165,160,-5
"78adeee1fa2c4fe0bc73f7bca9fcee86","82e6285962b8400d9d6fc32436022a94",22850075,1,10,0,494,160,167,7
"82e6285962b8400d9d6fc32436022a94","c33c17be71ae4d588da7369472e5bb1b",22850075,1,-178,0,495,167,34,-133
"c33c17be71ae4d588da7369472e5bb1b","c33c17be71ae4d588da7369472e5bb1b",22850075,2,0,1,496,34,34,0
"c33c17be71ae4d588da7369472e5bb1b","b613861cecf84ffcab01afb23f660475",22850075,1,-56,0,497,34,1,-33
"b613861cecf84ffcab01afb23f660475","78adeee1fa2c4fe0bc73f7bca9fcee86",22850075,1,224,0,498,1,160,159
"78adeee1fa2c4fe0bc73f7bca9fcee86","8959e6304a0348309a771e4d08d1b64a",22850075,1,4,0,499,160,163,3
"8959e6304a0348309a771e4d08d1b64a","65202579580f4ad38d734b4ee39d22a8",22850075,1,1,0,500,163,164,1
"65202579580f4ad38d734b4ee39d22a8","c33c17be71ae4d588da7369472e5bb1b",22850075,1,-173,0,508,164,34,-130
"c33c17be71ae4d588da7369472e5bb1b","0c7262dff33c4087bc660ccf40f92f9c",22850075,1,185,0,510,34,169,135
"0c7262dff33c4087bc660ccf40f92f9c","b2275c3fad834f8d90737a2d9a6927d6",22850075,2,3,0,511,169,172,3
"b2275c3fad834f8d90737a2d9a6927d6","8959e6304a0348309a771e4d08d1b64a",22850075,1,-16,0,512,172,163,-9
"8959e6304a0348309a771e4d08d1b64a","78adeee1fa2c4fe0bc73f7bca9fcee86",22850075,1,-4,0,513,163,160,-3
"65202579580f4ad38d734b4ee39d22a8","a9ac840f098c4bd0a2ee896214ce29cd",22850075,1,8,0,523,164,168,4
"a9ac840f098c4bd0a2ee896214ce29cd","a9ac840f098c4bd0a2ee896214ce29cd",22850075,2,0,1,524,168,168,0
"a9ac840f098c4bd0a2ee896214ce29cd","0c7262dff33c4087bc660ccf40f92f9c",22850075,2,4,0,526,168,169,1
"b2275c3fad834f8d90737a2d9a6927d6","b2275c3fad834f8d90737a2d9a6927d6",22850075,30,0,1,528,172,172,0
"b2275c3fad834f8d90737a2d9a6927d6","eb515a26030b41f8a82a1e6114420bad",22850075,1,1,0,558,172,173,1
"eb515a26030b41f8a82a1e6114420bad","eb515a26030b41f8a82a1e6114420bad",22850075,2,0,1,559,173,173,0
"eb515a26030b41f8a82a1e6114420bad","0c7262dff33c4087bc660ccf40f92f9c",22850075,1,-4,0,561,173,169,-4
"0c7262dff33c4087bc660ccf40f92f9c","b42cc17b7de840f181a704558d0bc845",22850075,1,7,0,562,169,175,6
"b42cc17b7de840f181a704558d0bc845","801f9e9135034f49bf5f8b4bdefedb41",22850075,1,2,0,563,175,177,2
"801f9e9135034f49bf5f8b4bdefedb41","801f9e9135034f49bf5f8b4bdefedb41",22850075,7,0,1,564,177,177,0
"801f9e9135034f49bf5f8b4bdefedb41","362fcb0699a14845ab29b2340093e528",22850075,1,-3,0,571,177,174,-3
"362fcb0699a14845ab29b2340093e528","b87c552dd247427abe6ab5795b9c9d43",22850075,1,8,0,572,174,181,7
"b87c552dd247427abe6ab5795b9c9d43","ea38cc0e6e6e41edbabf210220808bf9",22850075,1,-2,0,573,181,179,-2
"ea38cc0e6e6e41edbabf210220808bf9","b87c552dd247427abe6ab5795b9c9d43",22850075,2,2,0,574,179,181,2
"b87c552dd247427abe6ab5795b9c9d43","b87c552dd247427abe6ab5795b9c9d43",22850075,11,0,1,575,181,181,0
"b87c552dd247427abe6ab5795b9c9d43","139b097acfca451689d80c9c6eebdf7b",22850075,2,-3,0,586,181,178,-3
"139b097acfca451689d80c9c6eebdf7b","30f660a1feb34582a739722532524f79",22850075,2,6,0,587,178,183,5
"30f660a1feb34582a739722532524f79","30f660a1feb34582a739722532524f79",22850075,4,0,1,588,183,183,0
"30f660a1feb34582a739722532524f79","0c7262dff33c4087bc660ccf40f92f9c",22850075,1,-17,0,589,183,169,-14
"0c7262dff33c4087bc660ccf40f92f9c","2024b4885bd14338a39b7b509acbbd02",22850075,1,16,0,590,169,182,13
"2024b4885bd14338a39b7b509acbbd02","b2275c3fad834f8d90737a2d9a6927d6",22850075,1,-13,0,591,182,172,-10
"b2275c3fad834f8d90737a2d9a6927d6","a9ac840f098c4bd0a2ee896214ce29cd",22850075,1,-7,0,592,172,168,-4
"0c7262dff33c4087bc660ccf40f92f9c","0c7262dff33c4087bc660ccf40f92f9c",22850075,1,0,1,594,169,169,0
"0c7262dff33c4087bc660ccf40f92f9c","a9ac840f098c4bd0a2ee896214ce29cd",22850075,1,-4,0,595,169,168,-1
"a9ac840f098c4bd0a2ee896214ce29cd","b2275c3fad834f8d90737a2d9a6927d6",22850075,1,7,0,596,168,172,4
"b2275c3fad834f8d90737a2d9a6927d6","b42cc17b7de840f181a704558d0bc845",22850075,1,4,0,597,172,175,3
"b42cc17b7de840f181a704558d0bc845","0c7262dff33c4087bc660ccf40f92f9c",22850075,1,-7,0,598,175,169,-6
"0c7262dff33c4087bc660ccf40f92f9c","362fcb0699a14845ab29b2340093e528",22850075,1,6,0,599,169,174,5
"362fcb0699a14845ab29b2340093e528","ea38cc0e6e6e41edbabf210220808bf9",22850075,1,6,0,600,174,179,5
"30f660a1feb34582a739722532524f79","2024b4885bd14338a39b7b509acbbd02",22850075,1,-1,0,607,183,182,-1
"2024b4885bd14338a39b7b509acbbd02","c3f63fe50d8e487c86bf8ef76c9cadd3",22850075,1,4,0,608,182,185,3
"c3f63fe50d8e487c86bf8ef76c9cadd3","c3f63fe50d8e487c86bf8ef76c9cadd3",22850075,1,0,1,609,185,185,0
"c3f63fe50d8e487c86bf8ef76c9cadd3","0c7262dff33c4087bc660ccf40f92f9c",22850075,1,-20,0,610,185,169,-16
"0c7262dff33c4087bc660ccf40f92f9c","c8e371568a0c4391b25796ae4e91952e",22850075,1,23,0,611,169,186,17
"c8e371568a0c4391b25796ae4e91952e","7d932b23e1c84326ae5aa4d3c0d813d1",22850075,1,2,0,612,186,188,2
"7d932b23e1c84326ae5aa4d3c0d813d1","7d932b23e1c84326ae5aa4d3c0d813d1",22850075,3,0,1,613,188,188,0
"7d932b23e1c84326ae5aa4d3c0d813d1","c8e371568a0c4391b25796ae4e91952e",22850075,1,-2,0,616,188,186,-2
"c8e371568a0c4391b25796ae4e91952e","ab11d94c6c8948ea90b88f19d2cd502b",22850075,1,5,0,617,186,190,4
"ab11d94c6c8948ea90b88f19d2cd502b","f992451ed6ad4e68bb9e68ad6be7c4be",22850075,1,2,0,618,190,192,2
"f992451ed6ad4e68bb9e68ad6be7c4be","f992451ed6ad4e68bb9e68ad6be7c4be",22850075,1,0,1,619,192,192,0
"f992451ed6ad4e68bb9e68ad6be7c4be","6cd2dcaac46847d4a0bc53f296d90375",22850075,1,3,0,620,192,194,2
"6cd2dcaac46847d4a0bc53f296d90375","07b44a7a51e94c78b411c753fc39dab0",22850075,1,-6,0,621,194,189,-5
"07b44a7a51e94c78b411c753fc39dab0","2d2580c9411c4972909db508d6956a58",22850075,1,8,0,622,189,196,7
"2d2580c9411c4972909db508d6956a58","2d2580c9411c4972909db508d6956a58",22850075,5,0,1,623,196,196,0
"2d2580c9411c4972909db508d6956a58","5bddb3d9ed264f3984702f048c7e5340",22850075,1,1,0,628,196,197,1
"5bddb3d9ed264f3984702f048c7e5340","5bddb3d9ed264f3984702f048c7e5340",22850075,2,0,1,629,197,197,0
"5bddb3d9ed264f3984702f048c7e5340","d5e8e2bd12a2466b9d6d90855f0eb079",22850075,1,1,0,631,197,198,1
"d5e8e2bd12a2466b9d6d90855f0eb079","d5e8e2bd12a2466b9d6d90855f0eb079",22850075,2,0,1,632,198,198,0
"d5e8e2bd12a2466b9d6d90855f0eb079","017d7ca8e0394b91aaadc9574df2202c",22850075,1,-5,0,634,198,193,-5
"017d7ca8e0394b91aaadc9574df2202c","54e8e9f0ea3e45c4bf3b8ac799ee31b1",22850075,1,8,0,635,193,200,7
"54e8e9f0ea3e45c4bf3b8ac799ee31b1","54e8e9f0ea3e45c4bf3b8ac799ee31b1",22850075,1,0,1,636,200,200,0
"54e8e9f0ea3e45c4bf3b8ac799ee31b1","c614a00911be4877a075f19315530fb0",22850075,1,1,0,637,200,201,1
"c614a00911be4877a075f19315530fb0","c614a00911be4877a075f19315530fb0",22850075,6,0,1,638,201,201,0
"c614a00911be4877a075f19315530fb0","a6c21bd8b95249c7972820a7a7d76aff",22850075,1,1,0,644,201,202,1
"a6c21bd8b95249c7972820a7a7d76aff","a6c21bd8b95249c7972820a7a7d76aff",22850075,1,0,1,645,202,202,0
"a6c21bd8b95249c7972820a7a7d76aff","f9170dd6bc6442b4acd832747609b09a",22850075,1,-3,0,646,202,199,-3
"f9170dd6bc6442b4acd832747609b09a","6cd2dcaac46847d4a0bc53f296d90375",22850075,1,-6,0,647,199,194,-5
"6cd2dcaac46847d4a0bc53f296d90375","017d7ca8e0394b91aaadc9574df2202c",22850075,2,-1,0,648,194,193,-1
"017d7ca8e0394b91aaadc9574df2202c","f9170dd6bc6442b4acd832747609b09a",22850075,1,7,0,649,193,199,6
"f9170dd6bc6442b4acd832747609b09a","c8e371568a0c4391b25796ae4e91952e",22850075,1,-16,0,650,199,186,-13
"c8e371568a0c4391b25796ae4e91952e","334c2344009840079b1d0e1b7ce3d5a7",22850075,1,23,0,651,186,205,19
"334c2344009840079b1d0e1b7ce3d5a7","334c2344009840079b1d0e1b7ce3d5a7",22850075,1,0,1,652,205,205,0
"334c2344009840079b1d0e1b7ce3d5a7","b54257a550b94ebc9538f3a90eee9d7e",22850075,1,-1,0,653,205,204,-1
"b54257a550b94ebc9538f3a90eee9d7e","bb329d880ab54120adaf203a693bb203",22850075,1,-2,0,654,204,203,-1
"bb329d880ab54120adaf203a693bb203","bb329d880ab54120adaf203a693bb203",22850075,2,0,1,655,203,203,0
"bb329d880ab54120adaf203a693bb203","f9170dd6bc6442b4acd832747609b09a",22850075,1,-4,0,656,203,199,-4
"f9170dd6bc6442b4acd832747609b09a","d7f13c8d63ec4e2aa673fbb9cf9c6933",22850075,1,10,0,657,199,206,7
"d7f13c8d63ec4e2aa673fbb9cf9c6933","c8e371568a0c4391b25796ae4e91952e",22850075,2,-26,0,658,206,186,-20
"c8e371568a0c4391b25796ae4e91952e","b9e80f77c3a44349863b19875725c384",22850075,1,27,0,659,186,207,21
"b9e80f77c3a44349863b19875725c384","7108f0e4c2584f1f9c471689ae4c885c",22850075,2,1,0,660,207,208,1
"7108f0e4c2584f1f9c471689ae4c885c","b9e80f77c3a44349863b19875725c384",22850075,3,-1,0,661,208,207,-1
"b9e80f77c3a44349863b19875725c384","b9e80f77c3a44349863b19875725c384",22850075,22,0,1,662,207,207,0
"7108f0e4c2584f1f9c471689ae4c885c","7108f0e4c2584f1f9c471689ae4c885c",22850075,10,0,1,664,208,208,0
"b9e80f77c3a44349863b19875725c384","d7f13c8d63ec4e2aa673fbb9cf9c6933",22850075,1,-1,0,696,207,206,-1
"d7f13c8d63ec4e2aa673fbb9cf9c6933","09400e101c5d4b439cf9a26b03aae558",22850075,1,5,0,697,206,210,4
"09400e101c5d4b439cf9a26b03aae558","a88efa7e50ce47159810ab553afa6d3a",22850075,1,2,0,698,210,212,2
"a88efa7e50ce47159810ab553afa6d3a","a88efa7e50ce47159810ab553afa6d3a",22850075,5,0,1,699,212,212,0
"a88efa7e50ce47159810ab553afa6d3a","a875096404ef4a9984b62d74cda916f9",22850075,1,-3,0,704,212,209,-3
"a875096404ef4a9984b62d74cda916f9","be502a7a43c44bf7b682698de79d9369",22850075,2,6,0,705,209,214,5
"be502a7a43c44bf7b682698de79d9369","f7fb1952f56b4189b86a9f8b7862d2b8",22850075,2,1,0,706,214,215,1
"f7fb1952f56b4189b86a9f8b7862d2b8","f7fb1952f56b4189b86a9f8b7862d2b8",22850075,16,0,1,707,215,215,0
"f7fb1952f56b4189b86a9f8b7862d2b8","b860ee85d8bc4a2f97958cfb71be3533",22850075,1,1,0,723,215,216,1
"b860ee85d8bc4a2f97958cfb71be3533","b860ee85d8bc4a2f97958cfb71be3533",22850075,2,0,1,724,216,216,0
"b860ee85d8bc4a2f97958cfb71be3533","ec341f459285443b8361f7f15638ff08",22850075,1,-3,0,726,216,213,-3
"ec341f459285443b8361f7f15638ff08","363837c182e04711840d896ae1e0339c",22850075,2,6,0,727,213,218,5
"363837c182e04711840d896ae1e0339c","363837c182e04711840d896ae1e0339c",22850075,16,0,1,728,218,218,0
"363837c182e04711840d896ae1e0339c","01b2051f8941460d89945e3b02d1ce78",22850075,2,-1,0,744,218,217,-1
"01b2051f8941460d89945e3b02d1ce78","91125ca626c5470eb145501f8c37f8db",22850075,1,4,0,745,217,220,3
"91125ca626c5470eb145501f8c37f8db","91125ca626c5470eb145501f8c37f8db",22850075,1,0,1,746,220,220,0
"91125ca626c5470eb145501f8c37f8db","d7f13c8d63ec4e2aa673fbb9cf9c6933",22850075,1,-18,0,747,220,206,-14
"d7f13c8d63ec4e2aa673fbb9cf9c6933","1c6721b1f63f4d30ba7746ea8af02a52",22850075,2,21,0,748,206,221,15
"1c6721b1f63f4d30ba7746ea8af02a52","77ecef8eff6b4a2caea7707669bf7475",22850075,2,1,0,749,221,222,1
"77ecef8eff6b4a2caea7707669bf7475","77ecef8eff6b4a2caea7707669bf7475",22850075,12,0,1,750,222,222,0
"77ecef8eff6b4a2caea7707669bf7475","1c6721b1f63f4d30ba7746ea8af02a52",22850075,2,-1,0,762,222,221,-1
"1c6721b1f63f4d30ba7746ea8af02a52","d03cb855c70044cf8c35d9ec0de696e3",22850075,1,4,0,763,221,224,3
"d03cb855c70044cf8c35d9ec0de696e3","8b9ae98743bd4d4a8a87dff1c1244211",22850075,2,3,0,764,224,227,3
"8b9ae98743bd4d4a8a87dff1c1244211","a49a937d6896486d9a5396654abcf2e1",22850075,1,-1,0,765,227,226,-1
"a49a937d6896486d9a5396654abcf2e1","a49a937d6896486d9a5396654abcf2e1",22850075,3,0,1,766,226,226,0
"a49a937d6896486d9a5396654abcf2e1","8b9ae98743bd4d4a8a87dff1c1244211",22850075,1,1,0,769,226,227,1
"8b9ae98743bd4d4a8a87dff1c1244211","8b9ae98743bd4d4a8a87dff1c1244211",22850075,23,0,1,770,227,227,0
"8b9ae98743bd4d4a8a87dff1c1244211","f7906d6f59b9489a91d2ef40db5a474d",22850075,2,-4,0,793,227,223,-4
"f7906d6f59b9489a91d2ef40db5a474d","2ab1535aac1346ba8801535bf729ef37",22850075,3,7,0,794,223,229,6
"2ab1535aac1346ba8801535bf729ef37","a4f40fb48a8542c8949bae1f002cd9bc",22850075,1,2,0,795,229,231,2
"a4f40fb48a8542c8949bae1f002cd9bc","a4f40fb48a8542c8949bae1f002cd9bc",22850075,5,0,1,796,231,231,0
"a4f40fb48a8542c8949bae1f002cd9bc","8972c23e32044edb8a78fa1eed4e5947",22850075,1,1,0,801,231,232,1
"8972c23e32044edb8a78fa1eed4e5947","8972c23e32044edb8a78fa1eed4e5947",22850075,3,0,1,802,232,232,0
"8972c23e32044edb8a78fa1eed4e5947","92feb4a40f8344d38b6f722e42a53295",22850075,1,1,0,805,232,233,1
"92feb4a40f8344d38b6f722e42a53295","92feb4a40f8344d38b6f722e42a53295",22850075,2,0,1,806,233,233,0
"92feb4a40f8344d38b6f722e42a53295","5152833676bf4c6cb317060be10f68db",22850075,1,-5,0,808,233,228,-5
"5152833676bf4c6cb317060be10f68db","0c7262dff33c4087bc660ccf40f92f9c",22850075,2,-79,0,809,228,169,-59
"0c7262dff33c4087bc660ccf40f92f9c","1c6721b1f63f4d30ba7746ea8af02a52",22850075,1,70,0,810,169,221,52
"1c6721b1f63f4d30ba7746ea8af02a52","f7906d6f59b9489a91d2ef40db5a474d",22850075,1,3,0,811,221,223,2
"f7906d6f59b9489a91d2ef40db5a474d","d03cb855c70044cf8c35d9ec0de696e3",22850075,1,1,0,812,223,224,1
"2ab1535aac1346ba8801535bf729ef37","5152833676bf4c6cb317060be10f68db",22850075,3,-1,0,816,229,228,-1
"5152833676bf4c6cb317060be10f68db","ca3e28f290354c08aefe5b0f769604e6",22850075,1,8,0,817,228,235,7
"ca3e28f290354c08aefe5b0f769604e6","ca3e28f290354c08aefe5b0f769604e6",22850075,9,0,1,818,235,235,0
"ca3e28f290354c08aefe5b0f769604e6","79a35eea833e4c2c9d22fc53c3c6445c",22850075,1,1,0,827,235,236,1
"79a35eea833e4c2c9d22fc53c3c6445c","79a35eea833e4c2c9d22fc53c3c6445c",22850075,9,0,1,828,236,236,0
"79a35eea833e4c2c9d22fc53c3c6445c","8f68228b1518449e9615cdafee41a2bd",22850075,1,1,0,837,236,237,1
"8f68228b1518449e9615cdafee41a2bd","8f68228b1518449e9615cdafee41a2bd",22850075,1,0,1,838,237,237,0
"8f68228b1518449e9615cdafee41a2bd","cab89fa5c3ed45a5aa550fc0352d6a42",22850075,1,1,0,839,237,238,1
"cab89fa5c3ed45a5aa550fc0352d6a42","cab89fa5c3ed45a5aa550fc0352d6a42",22850075,1,0,1,840,238,238,0
"cab89fa5c3ed45a5aa550fc0352d6a42","0c7262dff33c4087bc660ccf40f92f9c",22850075,1,-90,0,841,238,169,-69
"0c7262dff33c4087bc660ccf40f92f9c","64dbedb3ce544f6aae8e10e0cf10f16d",22850075,1,93,0,842,169,240,71
"64dbedb3ce544f6aae8e10e0cf10f16d","1c6721b1f63f4d30ba7746ea8af02a52",22850075,1,-23,0,843,240,221,-19
"1c6721b1f63f4d30ba7746ea8af02a52","f53da5fd9bfe412da4b80d4742563b6c",22850075,1,24,0,844,221,241,20
"f53da5fd9bfe412da4b80d4742563b6c","f53da5fd9bfe412da4b80d4742563b6c",22850075,3,0,1,845,241,241,0
"f53da5fd9bfe412da4b80d4742563b6c","0c7262dff33c4087bc660ccf40f92f9c",22850075,1,-94,0,846,241,169,-72
"0c7262dff33c4087bc660ccf40f92f9c","d7f13c8d63ec4e2aa673fbb9cf9c6933",22850075,1,49,0,847,169,206,37
"c8e371568a0c4391b25796ae4e91952e","c8e371568a0c4391b25796ae4e91952e",22850075,1,0,1,849,186,186,0
"c8e371568a0c4391b25796ae4e91952e","d7f13c8d63ec4e2aa673fbb9cf9c6933",22850075,1,26,0,850,186,206,20
"d7f13c8d63ec4e2aa673fbb9cf9c6933","7108f0e4c2584f1f9c471689ae4c885c",22850075,1,2,0,851,206,208,2
"b9e80f77c3a44349863b19875725c384","09400e101c5d4b439cf9a26b03aae558",22850075,1,4,0,853,207,210,3
"09400e101c5d4b439cf9a26b03aae558","d7f13c8d63ec4e2aa673fbb9cf9c6933",22850075,1,-5,0,854,210,206,-4
"d7f13c8d63ec4e2aa673fbb9cf9c6933","a875096404ef4a9984b62d74cda916f9",22850075,1,4,0,855,206,209,3
"f7fb1952f56b4189b86a9f8b7862d2b8","ec341f459285443b8361f7f15638ff08",22850075,1,-2,0,858,215,213,-2
"01b2051f8941460d89945e3b02d1ce78","d7f13c8d63ec4e2aa673fbb9cf9c6933",22850075,1,-14,0,861,217,206,-11
"1c6721b1f63f4d30ba7746ea8af02a52","8b9ae98743bd4d4a8a87dff1c1244211",22850075,1,7,0,865,221,227,6
"8b9ae98743bd4d4a8a87dff1c1244211","d03cb855c70044cf8c35d9ec0de696e3",22850075,1,-3,0,866,227,224,-3
"d03cb855c70044cf8c35d9ec0de696e3","f7906d6f59b9489a91d2ef40db5a474d",22850075,1,-1,0,867,224,223,-1
"0c7262dff33c4087bc660ccf40f92f9c","017d7ca8e0394b91aaadc9574df2202c",22850075,1,32,0,871,169,193,24
"017d7ca8e0394b91aaadc9574df2202c","c8e371568a0c4391b25796ae4e91952e",22850075,1,-9,0,872,193,186,-7
"c8e371568a0c4391b25796ae4e91952e","6cd2dcaac46847d4a0bc53f296d90375",22850075,1,10,0,873,186,194,8
"017d7ca8e0394b91aaadc9574df2202c","bb329d880ab54120adaf203a693bb203",22850075,1,11,0,875,193,203,10
"bb329d880ab54120adaf203a693bb203","c8e371568a0c4391b25796ae4e91952e",22850075,1,-20,0,877,203,186,-17
"c8e371568a0c4391b25796ae4e91952e","1c6721b1f63f4d30ba7746ea8af02a52",22850075,1,47,0,878,186,221,35
"1c6721b1f63f4d30ba7746ea8af02a52","66d4fad4f1cf4b46be0750a99ad7a35a",22850075,1,21,0,879,221,239,18
"66d4fad4f1cf4b46be0750a99ad7a35a","66d4fad4f1cf4b46be0750a99ad7a35a",22850075,1,0,1,880,239,239,0
"66d4fad4f1cf4b46be0750a99ad7a35a","0b04c8e2f86d48c7aeb7e225819cd32b",22850075,1,-5,0,881,239,234,-5
"0b04c8e2f86d48c7aeb7e225819cd32b","1c6721b1f63f4d30ba7746ea8af02a52",22850075,1,-16,0,882,234,221,-13
"1c6721b1f63f4d30ba7746ea8af02a52","0b04c8e2f86d48c7aeb7e225819cd32b",22850075,2,16,0,883,221,234,13
"0b04c8e2f86d48c7aeb7e225819cd32b","f53da5fd9bfe412da4b80d4742563b6c",22850075,1,8,0,884,234,241,7
"f53da5fd9bfe412da4b80d4742563b6c","1c6721b1f63f4d30ba7746ea8af02a52",22850075,1,-24,0,886,241,221,-20
"0b04c8e2f86d48c7aeb7e225819cd32b","0c7262dff33c4087bc660ccf40f92f9c",22850075,1,-86,0,888,234,169,-65
"0c7262dff33c4087bc660ccf40f92f9c","5152833676bf4c6cb317060be10f68db",22850075,1,79,0,889,169,228,59
"5152833676bf4c6cb317060be10f68db","1c6721b1f63f4d30ba7746ea8af02a52",22850075,1,-9,0,890,228,221,-7
"1c6721b1f63f4d30ba7746ea8af02a52","2ab1535aac1346ba8801535bf729ef37",22850075,1,10,0,891,221,229,8
"5152833676bf4c6cb317060be10f68db","f53da5fd9bfe412da4b80d4742563b6c",22850075,1,15,0,893,228,241,13
"f53da5fd9bfe412da4b80d4742563b6c","2ae94c0cea4d480a9d5dca8fb1d7b542",22850075,1,3,0,895,241,242,1
"2ae94c0cea4d480a9d5dca8fb1d7b542","1c6721b1f63f4d30ba7746ea8af02a52",22850075,1,-27,0,896,242,221,-21
"1c6721b1f63f4d30ba7746ea8af02a52","1ebf23f9d994469a85206e4c7b1bf5f5",22850075,1,30,0,897,221,245,24
"1ebf23f9d994469a85206e4c7b1bf5f5","0c7262dff33c4087bc660ccf40f92f9c",22850075,1,-100,0,898,245,169,-76
"0c7262dff33c4087bc660ccf40f92f9c","2ae94c0cea4d480a9d5dca8fb1d7b542",22850075,1,97,0,899,169,242,73
"2ae94c0cea4d480a9d5dca8fb1d7b542","2ae94c0cea4d480a9d5dca8fb1d7b542",22850075,1,0,1,900,242,242,0
"2ae94c0cea4d480a9d5dca8fb1d7b542","1ebf23f9d994469a85206e4c7b1bf5f5",22850075,1,3,0,901,242,245,3
"1ebf23f9d994469a85206e4c7b1bf5f5","1ebf23f9d994469a85206e4c7b1bf5f5",22850075,10,0,1,902,245,245,0
"1ebf23f9d994469a85206e4c7b1bf5f5","85ae675b83e8422da842cfd25596af99",22850075,1,1,0,912,245,246,1
"85ae675b83e8422da842cfd25596af99","85ae675b83e8422da842cfd25596af99",22850075,3,0,1,913,246,246,0
"85ae675b83e8422da842cfd25596af99","2ae94c0cea4d480a9d5dca8fb1d7b542",22850075,1,-4,0,916,246,242,-4
"2ae94c0cea4d480a9d5dca8fb1d7b542","fa235f0f364d47e4ae1c87f47bf8e6ba",22850075,3,12,0,917,242,252,10
"fa235f0f364d47e4ae1c87f47bf8e6ba","2ae94c0cea4d480a9d5dca8fb1d7b542",22850075,2,-12,0,918,252,242,-10
"2ae94c0cea4d480a9d5dca8fb1d7b542","00f61990949545828dd12f1303d47504",22850075,2,17,0,921,242,256,14
"00f61990949545828dd12f1303d47504","2ae94c0cea4d480a9d5dca8fb1d7b542",22850075,1,-17,0,922,256,242,-14
"2ae94c0cea4d480a9d5dca8fb1d7b542","d989ebcfc12a4b669f0100dc1aa14f1e",22850075,1,16,0,923,242,255,13
"d989ebcfc12a4b669f0100dc1aa14f1e","1ebf23f9d994469a85206e4c7b1bf5f5",22850075,1,-13,0,924,255,245,-10
"1ebf23f9d994469a85206e4c7b1bf5f5","2ae94c0cea4d480a9d5dca8fb1d7b542",22850075,1,-3,0,925,245,242,-3
"fa235f0f364d47e4ae1c87f47bf8e6ba","79f7845465cc4ed19d8e4f1429541be0",22850075,1,2,0,927,252,254,2
"79f7845465cc4ed19d8e4f1429541be0","79f7845465cc4ed19d8e4f1429541be0",22850075,2,0,1,928,254,254,0
"79f7845465cc4ed19d8e4f1429541be0","6e83e23f56544a19b94067c1c558d9c0",22850075,1,-8,0,930,254,247,-7
"6e83e23f56544a19b94067c1c558d9c0","00f61990949545828dd12f1303d47504",22850075,1,11,0,931,247,256,9
"00f61990949545828dd12f1303d47504","ead7bb4b64e247d2ae632ab8a296b091",22850075,1,2,0,932,256,258,2
"ead7bb4b64e247d2ae632ab8a296b091","ead7bb4b64e247d2ae632ab8a296b091",22850075,2,0,1,933,258,258,0
"ead7bb4b64e247d2ae632ab8a296b091","41b0048dde734bb280bac6116baa8e27",22850075,1,1,0,935,258,259,1
"41b0048dde734bb280bac6116baa8e27","41b0048dde734bb280bac6116baa8e27",22850075,2,0,1,936,259,259,0
"41b0048dde734bb280bac6116baa8e27","b41c5a094a604ee0915327da5cc0beb7",22850075,1,1,0,938,259,260,1
"b41c5a094a604ee0915327da5cc0beb7","b41c5a094a604ee0915327da5cc0beb7",22850075,2,0,1,939,260,260,0
"b41c5a094a604ee0915327da5cc0beb7","d546341988904f069cfa86b21457d9d9",22850075,1,-10,0,941,260,251,-9
"d546341988904f069cfa86b21457d9d9","28c171777c52431ab6b925073bd63d46",22850075,1,15,0,942,251,264,13
"28c171777c52431ab6b925073bd63d46","28c171777c52431ab6b925073bd63d46",22850075,7,0,1,943,264,264,0
"28c171777c52431ab6b925073bd63d46","ac160db940cb49ae8579162b1d52bb5d",22850075,1,2,0,950,264,266,2
"ac160db940cb49ae8579162b1d52bb5d","ac160db940cb49ae8579162b1d52bb5d",22850075,11,0,1,951,266,266,0
"ac160db940cb49ae8579162b1d52bb5d","d989ebcfc12a4b669f0100dc1aa14f1e",22850075,1,-12,0,962,266,255,-11
"d989ebcfc12a4b669f0100dc1aa14f1e","c6fd49b485cc4874b0bbdd9c6171e09c",22850075,1,15,0,963,255,268,13
"c6fd49b485cc4874b0bbdd9c6171e09c","c6fd49b485cc4874b0bbdd9c6171e09c",22850075,3,0,1,964,268,268,0
"c6fd49b485cc4874b0bbdd9c6171e09c","44240778a97c4af0937817499b75707b",22850075,1,1,0,967,268,269,1
"44240778a97c4af0937817499b75707b","44240778a97c4af0937817499b75707b",22850075,2,0,1,968,269,269,0
"44240778a97c4af0937817499b75707b","7aa76d3e993840d8805f097cbdbcd44b",22850075,1,-9,0,970,269,261,-8
"7aa76d3e993840d8805f097cbdbcd44b","865a4d3b43374da7944dc7d397f566d9",22850075,1,12,0,971,261,271,10
"865a4d3b43374da7944dc7d397f566d9","865a4d3b43374da7944dc7d397f566d9",22850075,1,0,1,972,271,271,0
"865a4d3b43374da7944dc7d397f566d9","2ae94c0cea4d480a9d5dca8fb1d7b542",22850075,1,-35,0,973,271,242,-29
"2ae94c0cea4d480a9d5dca8fb1d7b542","0d987bed3ffa4ed0b9a2e62e97b7b30f",22850075,1,38,0,974,242,272,30
"0d987bed3ffa4ed0b9a2e62e97b7b30f","0c7262dff33c4087bc660ccf40f92f9c",22850075,1,-135,0,975,272,169,-103
"0c7262dff33c4087bc660ccf40f92f9c","d546341988904f069cfa86b21457d9d9",22850075,1,108,0,976,169,251,82
"d546341988904f069cfa86b21457d9d9","2ae94c0cea4d480a9d5dca8fb1d7b542",22850075,2,-11,0,977,251,242,-9
"00f61990949545828dd12f1303d47504","d546341988904f069cfa86b21457d9d9",22850075,2,-6,0,979,256,251,-5
"2ae94c0cea4d480a9d5dca8fb1d7b542","d546341988904f069cfa86b21457d9d9",22850075,1,11,0,981,242,251,9
"d546341988904f069cfa86b21457d9d9","00f61990949545828dd12f1303d47504",22850075,1,6,0,982,251,256,5
"d546341988904f069cfa86b21457d9d9","0c7262dff33c4087bc660ccf40f92f9c",22850075,1,-108,0,984,251,169,-82
"0c7262dff33c4087bc660ccf40f92f9c","0d987bed3ffa4ed0b9a2e62e97b7b30f",22850075,1,135,0,985,169,272,103
"0d987bed3ffa4ed0b9a2e62e97b7b30f","0d987bed3ffa4ed0b9a2e62e97b7b30f",22850075,2,0,1,986,272,272,0
"bb5a47f5ea01454a8b79455422d3b9da","82ae07bc0c9b4570a41799290d1ef399",22850075,1,-6,0,992,280,275,-5
"82ae07bc0c9b4570a41799290d1ef399","bb5a47f5ea01454a8b79455422d3b9da",22850075,1,6,0,993,275,280,5
"bb5a47f5ea01454a8b79455422d3b9da","bb5a47f5ea01454a8b79455422d3b9da",22850075,65,0,1,1000,280,280,0
"bb5a47f5ea01454a8b79455422d3b9da","bc5524e78a8544e2ae2fdc2f3462bbec",22850075,1,-1,0,1047,280,279,-1
"bc5524e78a8544e2ae2fdc2f3462bbec","0d987bed3ffa4ed0b9a2e62e97b7b30f",22850075,1,-9,0,1048,279,272,-7
"0d987bed3ffa4ed0b9a2e62e97b7b30f","bb5a47f5ea01454a8b79455422d3b9da",22850075,2,10,0,1049,272,280,8
"bb5a47f5ea01454a8b79455422d3b9da","94cecc3f1e7d484b8e068e79241dfd73",22850075,1,3,0,1059,280,281,1
"94cecc3f1e7d484b8e068e79241dfd73","0d987bed3ffa4ed0b9a2e62e97b7b30f",22850075,1,-13,0,1060,281,272,-9
"0d987bed3ffa4ed0b9a2e62e97b7b30f","a37477c4e4c14169ad44b06b493007f6",22850075,1,15,0,1061,272,283,11
"a37477c4e4c14169ad44b06b493007f6","94cecc3f1e7d484b8e068e79241dfd73",22850075,1,-2,0,1062,283,281,-2
"94cecc3f1e7d484b8e068e79241dfd73","a37477c4e4c14169ad44b06b493007f6",22850075,1,2,0,1063,281,283,2
"a37477c4e4c14169ad44b06b493007f6","fab84b4fab5940efb4ea868ef8d09396",22850075,1,3,0,1064,283,284,1
"fab84b4fab5940efb4ea868ef8d09396","4a29443515bb404cb8924e1c60a63b73",22850075,1,4,0,1065,284,285,1
"4a29443515bb404cb8924e1c60a63b73","4a29443515bb404cb8924e1c60a63b73",22850075,1,0,1,1066,285,285,0
"4a29443515bb404cb8924e1c60a63b73","208c9b2796c944db8dacaa96082520ea",22850075,2,3,0,1067,285,288,3
"208c9b2796c944db8dacaa96082520ea","4a29443515bb404cb8924e1c60a63b73",22850075,1,-3,0,1068,288,285,-3
"208c9b2796c944db8dacaa96082520ea","6a9a3b5bde4a48daa896fe8c06eca56f",22850075,1,2,0,1070,288,289,1
"6a9a3b5bde4a48daa896fe8c06eca56f","4a29443515bb404cb8924e1c60a63b73",22850075,1,-5,0,1071,289,285,-4
"4a29443515bb404cb8924e1c60a63b73","7669a956527947d0add87455277e80b4",22850075,1,7,0,1072,285,291,6
"7669a956527947d0add87455277e80b4","7669a956527947d0add87455277e80b4",22850075,1,0,1,1073,291,291,0
"7669a956527947d0add87455277e80b4","869e967078f04da18dd0b0b9389a7424",22850075,1,3,0,1074,291,293,2
"869e967078f04da18dd0b0b9389a7424","6a9a3b5bde4a48daa896fe8c06eca56f",22850075,1,-5,0,1075,293,289,-4
"6a9a3b5bde4a48daa896fe8c06eca56f","51ab6291537748fab90d519aa09889d6",22850075,1,7,0,1076,289,295,6
"51ab6291537748fab90d519aa09889d6","51ab6291537748fab90d519aa09889d6",22850075,5,0,1,1077,295,295,0
"51ab6291537748fab90d519aa09889d6","34a6e49023fc4465bd5ca604330bbd1c",22850075,1,-3,0,1082,295,292,-3
"34a6e49023fc4465bd5ca604330bbd1c","ba0e59461bfb4a44b7b1c28a01f8d3b3",22850075,1,9,0,1083,292,299,7
"ba0e59461bfb4a44b7b1c28a01f8d3b3","21592f2a9e9c4b2f8c66ec5dbcbf6a2b",22850075,1,-4,0,1084,299,296,-3
"21592f2a9e9c4b2f8c66ec5dbcbf6a2b","0e0b36e731a645e7b1b8a88f5031ca38",22850075,1,6,0,1085,296,301,5
"0e0b36e731a645e7b1b8a88f5031ca38","0e0b36e731a645e7b1b8a88f5031ca38",22850075,5,0,1,1086,301,301,0
"0e0b36e731a645e7b1b8a88f5031ca38","a66a144637284c21afc6de17fea4bfb8",22850075,1,1,0,1091,301,302,1
"a66a144637284c21afc6de17fea4bfb8","a66a144637284c21afc6de17fea4bfb8",22850075,2,0,1,1092,302,302,0
"a66a144637284c21afc6de17fea4bfb8","7646a919d7e64fa990bca9b024ff089d",22850075,1,-4,0,1094,302,298,-4
"7646a919d7e64fa990bca9b024ff089d","2c5bb2cbd0014420ad8c95d40e38efd1",22850075,1,6,0,1095,298,303,5
"2c5bb2cbd0014420ad8c95d40e38efd1","ba0e59461bfb4a44b7b1c28a01f8d3b3",22850075,1,-5,0,1096,303,299,-4
"ba0e59461bfb4a44b7b1c28a01f8d3b3","7646a919d7e64fa990bca9b024ff089d",22850075,1,-1,0,1097,299,298,-1
"7646a919d7e64fa990bca9b024ff089d","4a29443515bb404cb8924e1c60a63b73",22850075,1,-17,0,1098,298,285,-13
"4a29443515bb404cb8924e1c60a63b73","e390b575229748ea8aac9364efe2bf00",22850075,1,24,0,1099,285,304,19
"e390b575229748ea8aac9364efe2bf00","e390b575229748ea8aac9364efe2bf00",22850075,1,0,1,1100,304,304,0
"e390b575229748ea8aac9364efe2bf00","4a29443515bb404cb8924e1c60a63b73",22850075,1,-24,0,1101,304,285,-19
"4a29443515bb404cb8924e1c60a63b73","3434c10e561d488a914e0f7d71907abd",22850075,1,27,0,1102,285,305,20
"3434c10e561d488a914e0f7d71907abd","53e7e900392747ccad52e711ab0f80d8",22850075,1,2,0,1103,305,307,2
"53e7e900392747ccad52e711ab0f80d8","130acc2aeb0448fdbb2de63bc5cebe5b",22850075,1,3,0,1104,307,309,2
"130acc2aeb0448fdbb2de63bc5cebe5b","3434c10e561d488a914e0f7d71907abd",22850075,1,-5,0,1105,309,305,-4
"3434c10e561d488a914e0f7d71907abd","9c062b3251034ebe90f5054e2a3b5120",22850075,1,7,0,1106,305,311,6
"9c062b3251034ebe90f5054e2a3b5120","9c062b3251034ebe90f5054e2a3b5120",22850075,5,0,1,1107,311,311,0
"9c062b3251034ebe90f5054e2a3b5120","ea859f8207e44537889daeaba13ac2e8",22850075,1,1,0,1112,311,312,1
"ea859f8207e44537889daeaba13ac2e8","ea859f8207e44537889daeaba13ac2e8",22850075,1,0,1,1113,312,312,0
"ea859f8207e44537889daeaba13ac2e8","56d94971a7a94257aa330183a8ebd0ea",22850075,1,1,0,1114,312,313,1
"56d94971a7a94257aa330183a8ebd0ea","56d94971a7a94257aa330183a8ebd0ea",22850075,1,0,1,1115,313,313,0
"56d94971a7a94257aa330183a8ebd0ea","141c0df6cd1946539aadd1c9b7068cd4",22850075,1,-5,0,1116,313,308,-5
"141c0df6cd1946539aadd1c9b7068cd4","0c787d16c9504873b1a4d903cec09948",22850075,1,7,0,1117,308,314,6
"0c787d16c9504873b1a4d903cec09948","86c27d40179e419c8e9d150fb6afa5d0",22850075,1,6,0,1118,314,319,5
"86c27d40179e419c8e9d150fb6afa5d0","86c27d40179e419c8e9d150fb6afa5d0",22850075,2,0,1,1119,319,319,0
"86c27d40179e419c8e9d150fb6afa5d0","47edbb64109243e6b0f8f64cdef90c6c",22850075,1,8,0,1121,319,326,7
"47edbb64109243e6b0f8f64cdef90c6c","24f1363179ad4aaa965484a78471912b",22850075,3,-3,0,1122,326,323,-3
"24f1363179ad4aaa965484a78471912b","8d7e0b55cf9849cda222a0f2440cec55",22850075,1,-6,0,1123,323,318,-5
"8d7e0b55cf9849cda222a0f2440cec55","24f1363179ad4aaa965484a78471912b",22850075,1,6,0,1124,318,323,5
"24f1363179ad4aaa965484a78471912b","24f1363179ad4aaa965484a78471912b",22850075,3,0,1,1125,323,323,0
"24f1363179ad4aaa965484a78471912b","3628bdce1dd2429ba924d2d4d09448d2",22850075,1,-1,0,1127,323,322,-1
"3628bdce1dd2429ba924d2d4d09448d2","56b3fd1a212a4764be39d979fde3326e",22850075,1,7,0,1128,322,328,6
"56b3fd1a212a4764be39d979fde3326e","56b3fd1a212a4764be39d979fde3326e",22850075,1,0,1,1129,328,328,0
"56b3fd1a212a4764be39d979fde3326e","3434c10e561d488a914e0f7d71907abd",22850075,1,-28,0,1130,328,305,-23
"3434c10e561d488a914e0f7d71907abd","0c4079457ede49e3aeb5e86ed84bdf35",22850075,1,31,0,1131,305,329,24
"0c4079457ede49e3aeb5e86ed84bdf35","38aea304b4fa46e1b29bb72f5cea4c93",22850075,3,2,0,1132,329,331,2
"38aea304b4fa46e1b29bb72f5cea4c93","4a29443515bb404cb8924e1c60a63b73",22850075,2,-60,0,1133,331,285,-46
"4a29443515bb404cb8924e1c60a63b73","0c4079457ede49e3aeb5e86ed84bdf35",22850075,2,58,0,1134,285,329,44
"38aea304b4fa46e1b29bb72f5cea4c93","e36d261332f14e79bb4b467aceaeb9b5",22850075,1,2,0,1136,331,333,2
"e36d261332f14e79bb4b467aceaeb9b5","e36d261332f14e79bb4b467aceaeb9b5",22850075,1,0,1,1137,333,333,0
"e36d261332f14e79bb4b467aceaeb9b5","c7e89b9d04744d2eab742fc24e3ef1ae",22850075,1,1,0,1138,333,334,1
"c7e89b9d04744d2eab742fc24e3ef1ae","c7e89b9d04744d2eab742fc24e3ef1ae",22850075,2,0,1,1139,334,334,0
"c7e89b9d04744d2eab742fc24e3ef1ae","fe49f8054b374a0ea4bb266ed135ff62",22850075,1,1,0,1141,334,335,1
"fe49f8054b374a0ea4bb266ed135ff62","fe49f8054b374a0ea4bb266ed135ff62",22850075,5,0,1,1142,335,335,0
"fe49f8054b374a0ea4bb266ed135ff62","d0a8f74af98642fe8360d22c42e45117",22850075,1,1,0,1147,335,336,1
"d0a8f74af98642fe8360d22c42e45117","d0a8f74af98642fe8360d22c42e45117",22850075,5,0,1,1148,336,336,0
"d0a8f74af98642fe8360d22c42e45117","0c4079457ede49e3aeb5e86ed84bdf35",22850075,1,-7,0,1153,336,329,-7
"0c4079457ede49e3aeb5e86ed84bdf35","b8b9418ab322418d9db9b40d96af873a",22850075,1,9,0,1154,329,337,8
"b8b9418ab322418d9db9b40d96af873a","bbc5139ca9024389a94db3a6f47dcff6",22850075,1,5,0,1155,337,341,4
"bbc5139ca9024389a94db3a6f47dcff6","4ee6ca9019ab4a1ab323f98094a9bd77",22850075,1,2,0,1156,341,343,2
"4ee6ca9019ab4a1ab323f98094a9bd77","4ee6ca9019ab4a1ab323f98094a9bd77",22850075,5,0,1,1157,343,343,0
"4ee6ca9019ab4a1ab323f98094a9bd77","b37947176785476f8b29d49a851366dc",22850075,1,1,0,1162,343,344,1
"b37947176785476f8b29d49a851366dc","b37947176785476f8b29d49a851366dc",22850075,2,0,1,1163,344,344,0
"b37947176785476f8b29d49a851366dc","fcea5b10d5a14a3b9324ffece8f6e1e5",22850075,1,1,0,1165,344,345,1
"fcea5b10d5a14a3b9324ffece8f6e1e5","fcea5b10d5a14a3b9324ffece8f6e1e5",22850075,2,0,1,1166,345,345,0
"fcea5b10d5a14a3b9324ffece8f6e1e5","c2490bc612d146edbe786556fab3651b",22850075,1,-5,0,1168,345,340,-5
"c2490bc612d146edbe786556fab3651b","4a92daef4d504e1792575a26502bb7b7",22850075,2,7,0,1169,340,346,6
"4a92daef4d504e1792575a26502bb7b7","38aea304b4fa46e1b29bb72f5cea4c93",22850075,2,-18,0,1170,346,331,-15
"38aea304b4fa46e1b29bb72f5cea4c93","38aea304b4fa46e1b29bb72f5cea4c93",22850075,1,0,1,1171,331,331,0
"38aea304b4fa46e1b29bb72f5cea4c93","0c4079457ede49e3aeb5e86ed84bdf35",22850075,2,-2,0,1172,331,329,-2
"0c4079457ede49e3aeb5e86ed84bdf35","4a92daef4d504e1792575a26502bb7b7",22850075,1,20,0,1173,329,346,17
"4a92daef4d504e1792575a26502bb7b7","bbc5139ca9024389a94db3a6f47dcff6",22850075,2,-6,0,1174,346,341,-5
"bbc5139ca9024389a94db3a6f47dcff6","bbc5139ca9024389a94db3a6f47dcff6",22850075,1,0,1,1175,341,341,0
"bbc5139ca9024389a94db3a6f47dcff6","c2490bc612d146edbe786556fab3651b",22850075,2,-1,0,1176,341,340,-1
"c2490bc612d146edbe786556fab3651b","bbc5139ca9024389a94db3a6f47dcff6",22850075,1,1,0,1177,340,341,1
"bbc5139ca9024389a94db3a6f47dcff6","4a92daef4d504e1792575a26502bb7b7",22850075,1,6,0,1178,341,346,5
"4a92daef4d504e1792575a26502bb7b7","c2490bc612d146edbe786556fab3651b",22850075,1,-7,0,1179,346,340,-6
"c2490bc612d146edbe786556fab3651b","30ead9794d4847abaf222ca966cc8630",22850075,1,11,0,1183,340,348,8
"30ead9794d4847abaf222ca966cc8630","0c4079457ede49e3aeb5e86ed84bdf35",22850075,3,-24,0,1184,348,329,-19
"0c4079457ede49e3aeb5e86ed84bdf35","c20993c944444fe085345591a8bd837e",22850075,1,27,0,1185,329,351,22
"c20993c944444fe085345591a8bd837e","897b7f51242c44aab2205c72fdcbf4cd",22850075,3,1,0,1186,351,352,1
"897b7f51242c44aab2205c72fdcbf4cd","eff0de7f2dbb42dfa1a2e686efab5b6d",22850075,3,2,0,1187,352,354,2
"eff0de7f2dbb42dfa1a2e686efab5b6d","09b9678ddc3d452ea4a3d46e15826065",22850075,4,-1,0,1188,354,353,-1
"09b9678ddc3d452ea4a3d46e15826065","c20993c944444fe085345591a8bd837e",22850075,4,-2,0,1189,353,351,-2
"c20993c944444fe085345591a8bd837e","c20993c944444fe085345591a8bd837e",22850075,7,0,1,1190,351,351,0
"897b7f51242c44aab2205c72fdcbf4cd","897b7f51242c44aab2205c72fdcbf4cd",22850075,8,0,1,1194,352,352,0
"897b7f51242c44aab2205c72fdcbf4cd","09b9678ddc3d452ea4a3d46e15826065",22850075,2,1,0,1197,352,353,1
"09b9678ddc3d452ea4a3d46e15826065","09b9678ddc3d452ea4a3d46e15826065",22850075,8,0,1,1198,353,353,0
"09b9678ddc3d452ea4a3d46e15826065","eff0de7f2dbb42dfa1a2e686efab5b6d",22850075,2,1,0,1201,353,354,1
"eff0de7f2dbb42dfa1a2e686efab5b6d","eff0de7f2dbb42dfa1a2e686efab5b6d",22850075,7,0,1,1202,354,354,0
"eff0de7f2dbb42dfa1a2e686efab5b6d","30ead9794d4847abaf222ca966cc8630",22850075,1,-6,0,1205,354,348,-6
"30ead9794d4847abaf222ca966cc8630","2fe14166dc9642c3bc666b86a57f943d",22850075,3,10,0,1206,348,357,9
"2fe14166dc9642c3bc666b86a57f943d","44421dd1e13a47a388c4a19834b744c7",22850075,1,2,0,1207,357,359,2
"44421dd1e13a47a388c4a19834b744c7","44421dd1e13a47a388c4a19834b744c7",22850075,2,0,1,1208,359,359,0
"44421dd1e13a47a388c4a19834b744c7","cb5fc7ef85d547c4be1a7439d0bf6052",22850075,1,1,0,1210,359,360,1
"cb5fc7ef85d547c4be1a7439d0bf6052","cb5fc7ef85d547c4be1a7439d0bf6052",22850075,5,0,1,1211,360,360,0
"cb5fc7ef85d547c4be1a7439d0bf6052","0a8f150a4cf747acbde62f4721823da3",22850075,1,1,0,1216,360,361,1
"0a8f150a4cf747acbde62f4721823da3","0a8f150a4cf747acbde62f4721823da3",22850075,5,0,1,1217,361,361,0
"0a8f150a4cf747acbde62f4721823da3","ab8fdad974ae471f9f24c3f9dd04462e",22850075,1,1,0,1222,361,362,1
"ab8fdad974ae471f9f24c3f9dd04462e","ab8fdad974ae471f9f24c3f9dd04462e",22850075,2,0,1,1223,362,362,0
"ab8fdad974ae471f9f24c3f9dd04462e","52580888dadb4fe3baa795683ea227bd",22850075,1,3,0,1225,362,364,2
"52580888dadb4fe3baa795683ea227bd","1ba8fef685d74a8194b9db252eb704fb",22850075,1,-10,0,1226,364,355,-9
"1ba8fef685d74a8194b9db252eb704fb","f00179e251a045b39c3f7a54f9aa4acc",22850075,1,9,0,1227,355,363,8
"f00179e251a045b39c3f7a54f9aa4acc","2fe14166dc9642c3bc666b86a57f943d",22850075,1,-7,0,1228,363,357,-6
"2fe14166dc9642c3bc666b86a57f943d","c20993c944444fe085345591a8bd837e",22850075,1,-7,0,1229,357,351,-6
"c20993c944444fe085345591a8bd837e","1ba8fef685d74a8194b9db252eb704fb",22850075,1,5,0,1230,351,355,4
"1ba8fef685d74a8194b9db252eb704fb","eff0de7f2dbb42dfa1a2e686efab5b6d",22850075,1,-2,0,1231,355,354,-1
"09b9678ddc3d452ea4a3d46e15826065","897b7f51242c44aab2205c72fdcbf4cd",22850075,2,-1,0,1236,353,352,-1
"eff0de7f2dbb42dfa1a2e686efab5b6d","c20993c944444fe085345591a8bd837e",22850075,1,-3,0,1239,354,351,-3
"897b7f51242c44aab2205c72fdcbf4cd","30ead9794d4847abaf222ca966cc8630",22850075,2,-4,0,1242,352,348,-4
"0c4079457ede49e3aeb5e86ed84bdf35","6ac8bb048b854999a47edb35fe627f11",22850075,1,21,0,1244,329,347,18
"6ac8bb048b854999a47edb35fe627f11","6ac8bb048b854999a47edb35fe627f11",22850075,1,0,1,1245,347,347,0
"6ac8bb048b854999a47edb35fe627f11","30ead9794d4847abaf222ca966cc8630",22850075,1,3,0,1246,347,348,1
"0c4079457ede49e3aeb5e86ed84bdf35","09b9678ddc3d452ea4a3d46e15826065",22850075,1,29,0,1248,329,353,24
"c20993c944444fe085345591a8bd837e","eff0de7f2dbb42dfa1a2e686efab5b6d",22850075,2,3,0,1252,351,354,3
"eff0de7f2dbb42dfa1a2e686efab5b6d","897b7f51242c44aab2205c72fdcbf4cd",22850075,4,-2,0,1254,354,352,-2
"09b9678ddc3d452ea4a3d46e15826065","30ead9794d4847abaf222ca966cc8630",22850075,1,-5,0,1260,353,348,-5
"2fe14166dc9642c3bc666b86a57f943d","1ba8fef685d74a8194b9db252eb704fb",22850075,2,-2,0,1262,357,355,-2
"1ba8fef685d74a8194b9db252eb704fb","52580888dadb4fe3baa795683ea227bd",22850075,1,10,0,1263,355,364,9
"52580888dadb4fe3baa795683ea227bd","492a3bc6a1254f23a7998587961b22a4",22850075,1,3,0,1264,364,366,2
"492a3bc6a1254f23a7998587961b22a4","f00179e251a045b39c3f7a54f9aa4acc",22850075,1,-4,0,1265,366,363,-3
"f00179e251a045b39c3f7a54f9aa4acc","072a190fd302456290895f9f04d6940a",22850075,1,3,0,1266,363,365,2
"072a190fd302456290895f9f04d6940a","4a29443515bb404cb8924e1c60a63b73",22850075,1,-102,0,1267,365,285,-80
"4a29443515bb404cb8924e1c60a63b73","30ead9794d4847abaf222ca966cc8630",22850075,1,82,0,1268,285,348,63
"30ead9794d4847abaf222ca966cc8630","30ead9794d4847abaf222ca966cc8630",22850075,6,0,1,1269,348,348,0
"30ead9794d4847abaf222ca966cc8630","eff0de7f2dbb42dfa1a2e686efab5b6d",22850075,1,6,0,1274,348,354,6
"897b7f51242c44aab2205c72fdcbf4cd","c20993c944444fe085345591a8bd837e",22850075,2,-1,0,1282,352,351,-1
"c20993c944444fe085345591a8bd837e","09b9678ddc3d452ea4a3d46e15826065",22850075,2,2,0,1284,351,353,2
"1ba8fef685d74a8194b9db252eb704fb","cfa457d1743848e4bb5e4beced6448ed",22850075,1,17,0,1289,355,369,14
"cfa457d1743848e4bb5e4beced6448ed","cfa457d1743848e4bb5e4beced6448ed",22850075,1,0,1,1290,369,369,0
"cfa457d1743848e4bb5e4beced6448ed","b71bac264efb4abd97015447bd490db6",22850075,1,3,0,1291,369,370,1
"b71bac264efb4abd97015447bd490db6","30ead9794d4847abaf222ca966cc8630",22850075,1,-28,0,1292,370,348,-22
"30ead9794d4847abaf222ca966cc8630","b71bac264efb4abd97015447bd490db6",22850075,1,28,0,1294,348,370,22
"b71bac264efb4abd97015447bd490db6","eff0de7f2dbb42dfa1a2e686efab5b6d",22850075,1,-22,0,1295,370,354,-16
"c20993c944444fe085345591a8bd837e","c76574d21bc14aeea7ecd0b027f39858",22850075,1,20,0,1304,351,367,16
"c76574d21bc14aeea7ecd0b027f39858","c20993c944444fe085345591a8bd837e",22850075,1,-20,0,1305,367,351,-16
"c20993c944444fe085345591a8bd837e","0c4079457ede49e3aeb5e86ed84bdf35",22850075,1,-27,0,1308,351,329,-22
"0c4079457ede49e3aeb5e86ed84bdf35","30ead9794d4847abaf222ca966cc8630",22850075,1,24,0,1309,329,348,19
"30ead9794d4847abaf222ca966cc8630","4a92daef4d504e1792575a26502bb7b7",22850075,1,-4,0,1310,348,346,-2
"4a29443515bb404cb8924e1c60a63b73","b71bac264efb4abd97015447bd490db6",22850075,1,110,0,1313,285,370,85
"b71bac264efb4abd97015447bd490db6","b71bac264efb4abd97015447bd490db6",22850075,2,0,1,1314,370,370,0
"b71bac264efb4abd97015447bd490db6","8d448d625b024c82a5eb240bbd7431d6",22850075,4,5,0,1316,370,374,4
"8d448d625b024c82a5eb240bbd7431d6","8d448d625b024c82a5eb240bbd7431d6",22850075,75,0,1,1317,374,374,0
"8d448d625b024c82a5eb240bbd7431d6","d6d02b6ef04e4f17805504500b8ce441",22850075,1,3,0,1369,374,375,1
"d6d02b6ef04e4f17805504500b8ce441","b71bac264efb4abd97015447bd490db6",22850075,1,-8,0,1370,375,370,-5
"b71bac264efb4abd97015447bd490db6","d6d02b6ef04e4f17805504500b8ce441",22850075,1,8,0,1371,370,375,5
"d6d02b6ef04e4f17805504500b8ce441","3434c10e561d488a914e0f7d71907abd",22850075,1,-91,0,1372,375,305,-70
"3434c10e561d488a914e0f7d71907abd","24f1363179ad4aaa965484a78471912b",22850075,2,22,0,1373,305,323,18
"24f1363179ad4aaa965484a78471912b","47edbb64109243e6b0f8f64cdef90c6c",22850075,2,3,0,1374,323,326,3
"47edbb64109243e6b0f8f64cdef90c6c","43ea1b823a4b4e51b7c694c10725db82",22850075,1,2,0,1375,326,327,1
"43ea1b823a4b4e51b7c694c10725db82","4a29443515bb404cb8924e1c60a63b73",22850075,1,-54,0,1376,327,285,-42
"0c4079457ede49e3aeb5e86ed84bdf35","a7c6339ca1da4368a18d471f0519f877",22850075,1,11,0,1380,329,339,10
"a7c6339ca1da4368a18d471f0519f877","a7c6339ca1da4368a18d471f0519f877",22850075,1,0,1,1381,339,339,0
"a7c6339ca1da4368a18d471f0519f877","3434c10e561d488a914e0f7d71907abd",22850075,1,-42,0,1382,339,305,-34
"47edbb64109243e6b0f8f64cdef90c6c","b71bac264efb4abd97015447bd490db6",22850075,1,58,0,1385,326,370,44
"8d448d625b024c82a5eb240bbd7431d6","b71bac264efb4abd97015447bd490db6",22850075,1,-5,0,1394,374,370,-4
"8d448d625b024c82a5eb240bbd7431d6","3434c10e561d488a914e0f7d71907abd",22850075,2,-88,0,1405,374,305,-69
"3434c10e561d488a914e0f7d71907abd","47edbb64109243e6b0f8f64cdef90c6c",22850075,2,25,0,1406,305,326,21
"24f1363179ad4aaa965484a78471912b","b71bac264efb4abd97015447bd490db6",22850075,1,61,0,1408,323,370,47
"24f1363179ad4aaa965484a78471912b","d6d02b6ef04e4f17805504500b8ce441",22850075,1,69,0,1421,323,375,52
"d6d02b6ef04e4f17805504500b8ce441","d6d02b6ef04e4f17805504500b8ce441",22850075,1,0,1,1422,375,375,0
"d6d02b6ef04e4f17805504500b8ce441","66baf19b6b904b70922329068c63746d",22850075,1,4,0,1423,375,376,1
"66baf19b6b904b70922329068c63746d","66baf19b6b904b70922329068c63746d",22850075,5,0,1,1424,376,376,0
"66baf19b6b904b70922329068c63746d","7f544639412e40a9ba27f43b415362ab",22850075,4,2,0,1427,376,378,2
"7f544639412e40a9ba27f43b415362ab","66baf19b6b904b70922329068c63746d",22850075,2,-2,0,1428,378,376,-2
"7f544639412e40a9ba27f43b415362ab","d5ae8642e15b46b8bd298b02274d4e9c",22850075,1,2,0,1432,378,380,2
"d5ae8642e15b46b8bd298b02274d4e9c","d5ae8642e15b46b8bd298b02274d4e9c",22850075,1,0,1,1433,380,380,0
"d5ae8642e15b46b8bd298b02274d4e9c","a0d10309a2dd456289147f84be9d37f9",22850075,1,1,0,1434,380,381,1
"a0d10309a2dd456289147f84be9d37f9","a0d10309a2dd456289147f84be9d37f9",22850075,2,0,1,1435,381,381,0
"a0d10309a2dd456289147f84be9d37f9","0fcbc3ca07b144138b8d85da581f09a8",22850075,1,1,0,1437,381,382,1
"0fcbc3ca07b144138b8d85da581f09a8","0fcbc3ca07b144138b8d85da581f09a8",22850075,2,0,1,1438,382,382,0
"0fcbc3ca07b144138b8d85da581f09a8","66baf19b6b904b70922329068c63746d",22850075,1,-6,0,1440,382,376,-6
"66baf19b6b904b70922329068c63746d","4890121ce5d74576b4632b77cfc23398",22850075,1,14,0,1441,376,388,12
"4890121ce5d74576b4632b77cfc23398","c2fca3669923477ab966ded303dea31c",22850075,1,-6,0,1442,388,383,-5
"c2fca3669923477ab966ded303dea31c","18d3b836dd804224883cc9180b60a8e1",22850075,1,5,0,1443,383,387,4
"18d3b836dd804224883cc9180b60a8e1","96bb2b3e85a34d8b9544514e89f6fe97",22850075,1,4,0,1444,387,390,3
"96bb2b3e85a34d8b9544514e89f6fe97","66baf19b6b904b70922329068c63746d",22850075,2,-17,0,1445,390,376,-14
"7f544639412e40a9ba27f43b415362ab","96bb2b3e85a34d8b9544514e89f6fe97",22850075,1,15,0,1449,378,390,12
"66baf19b6b904b70922329068c63746d","ac4e9b54acfe4670b4634859c7263cb5",22850075,1,19,0,1451,376,392,16
"ac4e9b54acfe4670b4634859c7263cb5","ac4e9b54acfe4670b4634859c7263cb5",22850075,1,0,1,1452,392,392,0
"ac4e9b54acfe4670b4634859c7263cb5","66baf19b6b904b70922329068c63746d",22850075,1,-19,0,1453,392,376,-16
"66baf19b6b904b70922329068c63746d","96bb2b3e85a34d8b9544514e89f6fe97",22850075,1,17,0,1454,376,390,14
"96bb2b3e85a34d8b9544514e89f6fe97","17f95d18bab743888e1736033dc3384d",22850075,1,-1,0,1455,390,389,-1
"17f95d18bab743888e1736033dc3384d","6f8881a745ac4c358a68b92c3b4abe81",22850075,1,6,0,1456,389,394,5
"6f8881a745ac4c358a68b92c3b4abe81","66baf19b6b904b70922329068c63746d",22850075,4,-22,0,1457,394,376,-18
"66baf19b6b904b70922329068c63746d","6f8881a745ac4c358a68b92c3b4abe81",22850075,5,22,0,1458,376,394,18
"6f8881a745ac4c358a68b92c3b4abe81","f7002c8484354eceac57bc7bd62c76c1",22850075,2,-1,0,1465,394,393,-1
"f7002c8484354eceac57bc7bd62c76c1","44a277ea44dc4ae689fab4b82f0b4098",22850075,1,5,0,1466,393,397,4
"44a277ea44dc4ae689fab4b82f0b4098","44a277ea44dc4ae689fab4b82f0b4098",22850075,1,0,1,1467,397,397,0
"44a277ea44dc4ae689fab4b82f0b4098","0c12af0a4e7f4002852cf84b2537c161",22850075,1,-2,0,1468,397,395,-2
"0c12af0a4e7f4002852cf84b2537c161","66baf19b6b904b70922329068c63746d",22850075,1,-24,0,1469,395,376,-19
"f7002c8484354eceac57bc7bd62c76c1","0c12af0a4e7f4002852cf84b2537c161",22850075,1,3,0,1472,393,395,2
"0c12af0a4e7f4002852cf84b2537c161","859e0b8d71694b12befb69ee698138f9",22850075,1,5,0,1473,395,399,4
"859e0b8d71694b12befb69ee698138f9","859e0b8d71694b12befb69ee698138f9",22850075,1,0,1,1474,399,399,0
"859e0b8d71694b12befb69ee698138f9","66baf19b6b904b70922329068c63746d",22850075,1,-29,0,1475,399,376,-23
"66baf19b6b904b70922329068c63746d","2b09a08242b54983aec7063990fb3f66",22850075,1,32,0,1476,376,400,24
"2b09a08242b54983aec7063990fb3f66","2b09a08242b54983aec7063990fb3f66",22850075,3,0,1,1477,400,400,0
"2b09a08242b54983aec7063990fb3f66","1f471b7a883a4df48211e8c6a81b59a7",22850075,1,1,0,1478,400,401,1
"1f471b7a883a4df48211e8c6a81b59a7","1f471b7a883a4df48211e8c6a81b59a7",22850075,1,0,1,1479,401,401,0
"1f471b7a883a4df48211e8c6a81b59a7","2b09a08242b54983aec7063990fb3f66",22850075,1,-1,0,1480,401,400,-1
"2b09a08242b54983aec7063990fb3f66","9de0d567bfa84fe5b77cb76f4a76a5d1",22850075,1,5,0,1481,400,404,4
"9de0d567bfa84fe5b77cb76f4a76a5d1","9de0d567bfa84fe5b77cb76f4a76a5d1",22850075,1,0,1,1482,404,404,0
"9de0d567bfa84fe5b77cb76f4a76a5d1","1157bd665ec4472fb58b751dc5099355",22850075,1,-1,0,1483,404,403,-1
"1157bd665ec4472fb58b751dc5099355","3c8a22d2f9c146ea956609e3ed4f2559",22850075,1,3,0,1484,403,405,2
"3c8a22d2f9c146ea956609e3ed4f2559","58fc9094275e4c49be3f4ba6d4acc0a4",22850075,1,2,0,1485,405,406,1
"58fc9094275e4c49be3f4ba6d4acc0a4","c1c1be90b2b14c1ab4a5e1ee3c241902",22850075,1,1,0,1486,406,407,1
"c1c1be90b2b14c1ab4a5e1ee3c241902","c1c1be90b2b14c1ab4a5e1ee3c241902",22850075,5,0,1,1487,407,407,0
"c1c1be90b2b14c1ab4a5e1ee3c241902","02b3a1bead9244c1ba2f857c7da8f82a",22850075,1,2,0,1492,407,408,1
"02b3a1bead9244c1ba2f857c7da8f82a","58fc9094275e4c49be3f4ba6d4acc0a4",22850075,1,-3,0,1493,408,406,-2
"58fc9094275e4c49be3f4ba6d4acc0a4","6206fc6479014bb193084c32409dc1b9",22850075,1,4,0,1494,406,409,3
"6206fc6479014bb193084c32409dc1b9","6206fc6479014bb193084c32409dc1b9",22850075,7,0,1,1495,409,409,0
"6206fc6479014bb193084c32409dc1b9","02b3a1bead9244c1ba2f857c7da8f82a",22850075,1,-1,0,1502,409,408,-1
"02b3a1bead9244c1ba2f857c7da8f82a","6a5f020451db426dacba9e2ea3fcc62a",22850075,3,3,0,1503,408,410,2
"6a5f020451db426dacba9e2ea3fcc62a","33a9d248b2e44588a5b07fc1342b9bc2",22850075,2,2,0,1504,410,411,1
"33a9d248b2e44588a5b07fc1342b9bc2","6a5f020451db426dacba9e2ea3fcc62a",22850075,1,-2,0,1505,411,410,-1
"6a5f020451db426dacba9e2ea3fcc62a","c6f26bd420634f1cb7989e76fe6b16c0",22850075,1,3,0,1506,410,412,2
"c6f26bd420634f1cb7989e76fe6b16c0","c6f26bd420634f1cb7989e76fe6b16c0",22850075,5,0,1,1507,412,412,0
"c6f26bd420634f1cb7989e76fe6b16c0","2a65ee6e2ac64f6a8a55fbe5373ec763",22850075,1,1,0,1512,412,413,1
"2a65ee6e2ac64f6a8a55fbe5373ec763","2a65ee6e2ac64f6a8a55fbe5373ec763",22850075,5,0,1,1513,413,413,0
"2a65ee6e2ac64f6a8a55fbe5373ec763","33a9d248b2e44588a5b07fc1342b9bc2",22850075,1,-2,0,1518,413,411,-2
"33a9d248b2e44588a5b07fc1342b9bc2","687055dad9fc40c3982478fe33ec01bf",22850075,1,4,0,1519,411,414,3
"687055dad9fc40c3982478fe33ec01bf","2add1669f08d4101913db15f8c23b3b7",22850075,1,3,0,1520,414,416,2
"2add1669f08d4101913db15f8c23b3b7","2b09a08242b54983aec7063990fb3f66",22850075,2,-24,0,1521,416,400,-16
"2b09a08242b54983aec7063990fb3f66","1157bd665ec4472fb58b751dc5099355",22850075,1,4,0,1524,400,403,3
"1157bd665ec4472fb58b751dc5099355","66baf19b6b904b70922329068c63746d",22850075,1,-36,0,1525,403,376,-27
"66baf19b6b904b70922329068c63746d","58fc9094275e4c49be3f4ba6d4acc0a4",22850075,1,41,0,1526,376,406,30
"58fc9094275e4c49be3f4ba6d4acc0a4","2b09a08242b54983aec7063990fb3f66",22850075,1,-9,0,1527,406,400,-6
"2b09a08242b54983aec7063990fb3f66","58fc9094275e4c49be3f4ba6d4acc0a4",22850075,1,9,0,1528,400,406,6
"58fc9094275e4c49be3f4ba6d4acc0a4","58fc9094275e4c49be3f4ba6d4acc0a4",22850075,1,0,1,1529,406,406,0
"58fc9094275e4c49be3f4ba6d4acc0a4","02b3a1bead9244c1ba2f857c7da8f82a",22850075,1,3,0,1530,406,408,2
"02b3a1bead9244c1ba2f857c7da8f82a","02b3a1bead9244c1ba2f857c7da8f82a",22850075,1,0,1,1531,408,408,0
"6a5f020451db426dacba9e2ea3fcc62a","6a5f020451db426dacba9e2ea3fcc62a",22850075,1,0,1,1533,410,410,0
"33a9d248b2e44588a5b07fc1342b9bc2","33a9d248b2e44588a5b07fc1342b9bc2",22850075,1,0,1,1535,411,411,0
"33a9d248b2e44588a5b07fc1342b9bc2","1fd0f6dadbc14ebc965faf6122190b96",22850075,1,5,0,1536,411,415,4
"1fd0f6dadbc14ebc965faf6122190b96","1fd0f6dadbc14ebc965faf6122190b96",22850075,1,0,1,1537,415,415,0
"1fd0f6dadbc14ebc965faf6122190b96","687055dad9fc40c3982478fe33ec01bf",22850075,1,-1,0,1538,415,414,-1
"687055dad9fc40c3982478fe33ec01bf","2b09a08242b54983aec7063990fb3f66",22850075,1,-21,0,1539,414,400,-14
"2b09a08242b54983aec7063990fb3f66","2add1669f08d4101913db15f8c23b3b7",22850075,2,24,0,1540,400,416,16
"2add1669f08d4101913db15f8c23b3b7","2add1669f08d4101913db15f8c23b3b7",22850075,1,0,1,1541,416,416,0
"2b09a08242b54983aec7063990fb3f66","a2b4bd40cee2481ebd3fc179d6a5cd62",22850075,1,27,0,1543,400,417,17
"a2b4bd40cee2481ebd3fc179d6a5cd62","a2b4bd40cee2481ebd3fc179d6a5cd62",22850075,1,0,1,1544,417,417,0
"a2b4bd40cee2481ebd3fc179d6a5cd62","e34e59dce2204f228f3a84b6725df60f",22850075,1,2,0,1545,417,419,2
"e34e59dce2204f228f3a84b6725df60f","e34e59dce2204f228f3a84b6725df60f",22850075,1,0,1,1546,419,419,0
"e34e59dce2204f228f3a84b6725df60f","bec48fc2e1294c7eb3d0aca780d731b8",22850075,1,2,0,1547,419,420,1
"bec48fc2e1294c7eb3d0aca780d731b8","a2b4bd40cee2481ebd3fc179d6a5cd62",22850075,1,-4,0,1548,420,417,-3
"a2b4bd40cee2481ebd3fc179d6a5cd62","bec48fc2e1294c7eb3d0aca780d731b8",22850075,1,4,0,1549,417,420,3
"bec48fc2e1294c7eb3d0aca780d731b8","dbde19fcce2a4c1abdc7f685c293a23f",22850075,1,3,0,1550,420,422,2
"dbde19fcce2a4c1abdc7f685c293a23f","a24600b0e49245f6bdba8c893cfeddb0",22850075,1,4,0,1551,422,425,3
"a24600b0e49245f6bdba8c893cfeddb0","a24600b0e49245f6bdba8c893cfeddb0",22850075,1,0,1,1552,425,425,0
"a24600b0e49245f6bdba8c893cfeddb0","a2b4bd40cee2481ebd3fc179d6a5cd62",22850075,1,-11,0,1553,425,417,-8
"a2b4bd40cee2481ebd3fc179d6a5cd62","24cf8786024543f19b89bc20034e60d7",22850075,1,18,0,1554,417,428,11
"24cf8786024543f19b89bc20034e60d7","f2a73be2f46840b182d7bd095378004e",22850075,1,1,0,1555,428,429,1
"f2a73be2f46840b182d7bd095378004e","604551fd4266430cb860fef58fa7dd61",22850075,1,1,0,1556,429,430,1
"604551fd4266430cb860fef58fa7dd61","604551fd4266430cb860fef58fa7dd61",22850075,8,0,1,1557,430,430,0
"604551fd4266430cb860fef58fa7dd61","24cf8786024543f19b89bc20034e60d7",22850075,1,-2,0,1565,430,428,-2
"24cf8786024543f19b89bc20034e60d7","dce46f8904594a62a6377a3587aaa663",22850075,2,4,0,1566,428,431,3
"dce46f8904594a62a6377a3587aaa663","24cf8786024543f19b89bc20034e60d7",22850075,1,-4,0,1567,431,428,-3
"dce46f8904594a62a6377a3587aaa663","9b9d0a249052413c869753b99682b0ac",22850075,1,1,0,1569,431,432,1
"9b9d0a249052413c869753b99682b0ac","9b9d0a249052413c869753b99682b0ac",22850075,3,0,1,1570,432,432,0
"9b9d0a249052413c869753b99682b0ac","061c175cc90f45fbad883025394e78dd",22850075,1,1,0,1573,432,433,1
"061c175cc90f45fbad883025394e78dd","061c175cc90f45fbad883025394e78dd",22850075,1,0,1,1574,433,433,0
"061c175cc90f45fbad883025394e78dd","dce46f8904594a62a6377a3587aaa663",22850075,1,-2,0,1575,433,431,-2
"dce46f8904594a62a6377a3587aaa663","74a7f8712e5449c2bc0b43c6f90dafed",22850075,1,5,0,1576,431,435,4
"74a7f8712e5449c2bc0b43c6f90dafed","74a7f8712e5449c2bc0b43c6f90dafed",22850075,1,0,1,1577,435,435,0
"74a7f8712e5449c2bc0b43c6f90dafed","66ada10dde9f43018588f1ced9d477fc",22850075,1,-1,0,1578,435,434,-1
"66ada10dde9f43018588f1ced9d477fc","070600601c4c439288445d2f0724807d",22850075,1,6,0,1579,434,437,3
"070600601c4c439288445d2f0724807d","24cf8786024543f19b89bc20034e60d7",22850075,1,-14,0,1580,437,428,-9
"24cf8786024543f19b89bc20034e60d7","1823b6de7d334a7aaabc4570719af4d9",22850075,1,16,0,1581,428,439,11
"1823b6de7d334a7aaabc4570719af4d9","24cf8786024543f19b89bc20034e60d7",22850075,1,-16,0,1582,439,428,-11
"24cf8786024543f19b89bc20034e60d7","070600601c4c439288445d2f0724807d",22850075,2,14,0,1583,428,437,9
"070600601c4c439288445d2f0724807d","bf12c96466d840a69bed7020b3f18bb8",22850075,1,-3,0,1584,437,436,-1
"bf12c96466d840a69bed7020b3f18bb8","bf12c96466d840a69bed7020b3f18bb8",22850075,1,0,1,1585,436,436,0
"bf12c96466d840a69bed7020b3f18bb8","24cf8786024543f19b89bc20034e60d7",22850075,1,-11,0,1586,436,428,-8
"070600601c4c439288445d2f0724807d","1823b6de7d334a7aaabc4570719af4d9",22850075,1,2,0,1588,437,439,2
"1823b6de7d334a7aaabc4570719af4d9","1823b6de7d334a7aaabc4570719af4d9",22850075,17,0,1,1589,439,439,0
"1823b6de7d334a7aaabc4570719af4d9","0380cd76a7d44bc3a4da1f15e4d68f89",22850075,1,2,0,1606,439,440,1
"0380cd76a7d44bc3a4da1f15e4d68f89","070600601c4c439288445d2f0724807d",22850075,1,-4,0,1607,440,437,-3
"070600601c4c439288445d2f0724807d","23b7673c8b5443108c2ef09382834a86",22850075,1,6,0,1608,437,441,4
"23b7673c8b5443108c2ef09382834a86","0380cd76a7d44bc3a4da1f15e4d68f89",22850075,1,-2,0,1609,441,440,-1
"0380cd76a7d44bc3a4da1f15e4d68f89","23b7673c8b5443108c2ef09382834a86",22850075,1,2,0,1610,440,441,1
"23b7673c8b5443108c2ef09382834a86","901e92500aea43c79f19f1b279050668",22850075,1,2,0,1611,441,442,1
"901e92500aea43c79f19f1b279050668","001339db8ced4cf78829ebe8b145449d",22850075,1,1,0,1612,442,443,1
"001339db8ced4cf78829ebe8b145449d","001339db8ced4cf78829ebe8b145449d",22850075,11,0,1,1613,443,443,0
"001339db8ced4cf78829ebe8b145449d","452745e0366e42ae81561bfddebcc6c3",22850075,1,1,0,1624,443,444,1
"452745e0366e42ae81561bfddebcc6c3","452745e0366e42ae81561bfddebcc6c3",22850075,5,0,1,1625,444,444,0
"452745e0366e42ae81561bfddebcc6c3","901e92500aea43c79f19f1b279050668",22850075,1,-2,0,1630,444,442,-2
"901e92500aea43c79f19f1b279050668","4660ff2089114e8db82ceb26a4f329e3",22850075,1,4,0,1631,442,445,3
"4660ff2089114e8db82ceb26a4f329e3","7bd5586eb9d8484eb74a433ee7bfe499",22850075,2,2,0,1632,445,446,1
"7bd5586eb9d8484eb74a433ee7bfe499","4660ff2089114e8db82ceb26a4f329e3",22850075,1,-2,0,1633,446,445,-1
"7bd5586eb9d8484eb74a433ee7bfe499","7bd5586eb9d8484eb74a433ee7bfe499",22850075,8,0,1,1635,446,446,0
"7bd5586eb9d8484eb74a433ee7bfe499","8a7f26e690f34dda97be16904518ca99",22850075,1,2,0,1643,446,447,1
"8a7f26e690f34dda97be16904518ca99","8a7f26e690f34dda97be16904518ca99",22850075,1,0,1,1644,447,447,0
"8a7f26e690f34dda97be16904518ca99","b2f0d654738f48158edff28e8d3a546e",22850075,1,5,0,1645,447,449,2
"b2f0d654738f48158edff28e8d3a546e","070600601c4c439288445d2f0724807d",22850075,1,-21,0,1646,449,437,-12
"070600601c4c439288445d2f0724807d","2b09a08242b54983aec7063990fb3f66",22850075,1,-59,0,1647,437,400,-37
"2add1669f08d4101913db15f8c23b3b7","6a5f020451db426dacba9e2ea3fcc62a",22850075,1,-9,0,1649,416,410,-6
"6a5f020451db426dacba9e2ea3fcc62a","02b3a1bead9244c1ba2f857c7da8f82a",22850075,2,-3,0,1650,410,408,-2
"02b3a1bead9244c1ba2f857c7da8f82a","2b09a08242b54983aec7063990fb3f66",22850075,1,-12,0,1653,408,400,-8
"2b09a08242b54983aec7063990fb3f66","b2f0d654738f48158edff28e8d3a546e",22850075,1,80,0,1654,400,449,49
"b2f0d654738f48158edff28e8d3a546e","f60ee41ec635499abd48168342d32c2f",22850075,3,5,0,1655,449,453,4
"f60ee41ec635499abd48168342d32c2f","f60ee41ec635499abd48168342d32c2f",22850075,58,0,1,1656,453,453,0
"f60ee41ec635499abd48168342d32c2f","b2f0d654738f48158edff28e8d3a546e",22850075,2,-5,0,1657,453,449,-4
"b2f0d654738f48158edff28e8d3a546e","f67fbf45a5f146ed866965bc57c7c001",22850075,1,8,0,1710,449,454,5
"f67fbf45a5f146ed866965bc57c7c001","f67fbf45a5f146ed866965bc57c7c001",22850075,2,0,1,1711,454,454,0
"f67fbf45a5f146ed866965bc57c7c001","d937afe49bd24a07a550dda1c1155122",22850075,1,1,0,1713,454,455,1
"d937afe49bd24a07a550dda1c1155122","d937afe49bd24a07a550dda1c1155122",22850075,5,0,1,1714,455,455,0
"d937afe49bd24a07a550dda1c1155122","3628b3f7823443d0912a339096b69943",22850075,1,1,0,1719,455,456,1
"3628b3f7823443d0912a339096b69943","3628b3f7823443d0912a339096b69943",22850075,1,0,1,1720,456,456,0
"3628b3f7823443d0912a339096b69943","9e049ee647cf43ecbcb5ed792a8e7588",22850075,1,1,0,1721,456,457,1
"9e049ee647cf43ecbcb5ed792a8e7588","9e049ee647cf43ecbcb5ed792a8e7588",22850075,1,0,1,1722,457,457,0
"9e049ee647cf43ecbcb5ed792a8e7588","5256a214faaf410b93f76cea06428334",22850075,1,1,0,1723,457,458,1
"5256a214faaf410b93f76cea06428334","5256a214faaf410b93f76cea06428334",22850075,1,0,1,1724,458,458,0
"5256a214faaf410b93f76cea06428334","25c32b120fce40fa9b6c85133aeb4716",22850075,1,1,0,1725,458,459,1
"25c32b120fce40fa9b6c85133aeb4716","25c32b120fce40fa9b6c85133aeb4716",22850075,3,0,1,1726,459,459,0
"25c32b120fce40fa9b6c85133aeb4716","11bc14f2204949008b7d511b933363c1",22850075,1,1,0,1729,459,460,1
"11bc14f2204949008b7d511b933363c1","11bc14f2204949008b7d511b933363c1",22850075,3,0,1,1730,460,460,0
"11bc14f2204949008b7d511b933363c1","42de338840a34d15adb66e7b14fb9d2c",22850075,1,1,0,1733,460,461,1
"42de338840a34d15adb66e7b14fb9d2c","42de338840a34d15adb66e7b14fb9d2c",22850075,1,0,1,1734,461,461,0
"42de338840a34d15adb66e7b14fb9d2c","519119f1deac45ff9ab4f13529be5c6e",22850075,1,2,0,1735,461,463,2
"519119f1deac45ff9ab4f13529be5c6e","519119f1deac45ff9ab4f13529be5c6e",22850075,1,0,1,1736,463,463,0
"519119f1deac45ff9ab4f13529be5c6e","9da37c6210b1416b8079c274f70bf600",22850075,1,-1,0,1737,463,462,-1
"9da37c6210b1416b8079c274f70bf600","9da37c6210b1416b8079c274f70bf600",22850075,3,0,1,1738,462,462,0
"9da37c6210b1416b8079c274f70bf600","f67fbf45a5f146ed866965bc57c7c001",22850075,1,-8,0,1741,462,454,-8
"f67fbf45a5f146ed866965bc57c7c001","c5df9f40ec14463b9dcfdc73df3e9285",22850075,1,12,0,1742,454,464,10
"c5df9f40ec14463b9dcfdc73df3e9285","c5df9f40ec14463b9dcfdc73df3e9285",22850075,2,0,1,1743,464,464,0
"c5df9f40ec14463b9dcfdc73df3e9285","83d42d95cd844fc093fc09cee250edb8",22850075,1,3,0,1745,464,465,1
"83d42d95cd844fc093fc09cee250edb8","83d42d95cd844fc093fc09cee250edb8",22850075,2,0,1,1746,465,465,0
"83d42d95cd844fc093fc09cee250edb8","b2f0d654738f48158edff28e8d3a546e",22850075,1,-23,0,1748,465,449,-16
"b613861cecf84ffcab01afb23f660475","519d1b8c59404d67b54e96c5c8a830b2",22850106,1,4,0,1,1,3,2
"519d1b8c59404d67b54e96c5c8a830b2","531db53f81f646edb0cdcfe0085b03b7",22850106,1,1,0,2,3,4,1
"531db53f81f646edb0cdcfe0085b03b7","4f5f94b2f95141e0a9d53a61da2276da",22850106,1,1,0,3,4,5,1
"4f5f94b2f95141e0a9d53a61da2276da","6d541c89590949f99af293c4f2333f67",22850106,1,1,0,4,5,6,1
"6d541c89590949f99af293c4f2333f67","dd5cf0b9fe4c4f1d8f5ff8e4c04879cb",22850106,1,1,0,5,6,7,1
"dd5cf0b9fe4c4f1d8f5ff8e4c04879cb","f96261861edc426abe2248be4f0a709a",22850106,1,1,0,6,7,8,1
"f96261861edc426abe2248be4f0a709a","66b5e16f4f75454fb5b8172079f0fa83",22850106,1,1,0,7,8,9,1
"66b5e16f4f75454fb5b8172079f0fa83","0680571d4698477995e41842c36a54b2",22850106,1,1,0,8,9,10,1
"0680571d4698477995e41842c36a54b2","9112f2bffece48e08c6d2287be204085",22850106,1,1,0,9,10,11,1
"9112f2bffece48e08c6d2287be204085","56586aa865414f538729c7f7735d2bc6",22850106,1,3,0,10,11,12,1
"56586aa865414f538729c7f7735d2bc6","56586aa865414f538729c7f7735d2bc6",22850106,10,0,1,11,12,12,0
"56586aa865414f538729c7f7735d2bc6","e2911e79efc2420eac45d9f671463d4b",22850106,5,-12,0,12,12,2,-10
"e2911e79efc2420eac45d9f671463d4b","e2911e79efc2420eac45d9f671463d4b",22850106,5,0,1,13,2,2,0
"e2911e79efc2420eac45d9f671463d4b","56586aa865414f538729c7f7735d2bc6",22850106,6,12,0,14,2,12,10
"e2911e79efc2420eac45d9f671463d4b","9112f2bffece48e08c6d2287be204085",22850106,1,9,0,25,2,11,9
"9112f2bffece48e08c6d2287be204085","0680571d4698477995e41842c36a54b2",22850106,1,-1,0,26,11,10,-1
"0680571d4698477995e41842c36a54b2","66b5e16f4f75454fb5b8172079f0fa83",22850106,1,-1,0,27,10,9,-1
"66b5e16f4f75454fb5b8172079f0fa83","f96261861edc426abe2248be4f0a709a",22850106,1,-1,0,28,9,8,-1
"f96261861edc426abe2248be4f0a709a","dd5cf0b9fe4c4f1d8f5ff8e4c04879cb",22850106,1,-1,0,29,8,7,-1
"dd5cf0b9fe4c4f1d8f5ff8e4c04879cb","6d541c89590949f99af293c4f2333f67",22850106,1,-1,0,30,7,6,-1
"6d541c89590949f99af293c4f2333f67","4f5f94b2f95141e0a9d53a61da2276da",22850106,1,-1,0,31,6,5,-1
"4f5f94b2f95141e0a9d53a61da2276da","531db53f81f646edb0cdcfe0085b03b7",22850106,1,-1,0,32,5,4,-1
"531db53f81f646edb0cdcfe0085b03b7","519d1b8c59404d67b54e96c5c8a830b2",22850106,1,-1,0,33,4,3,-1
"519d1b8c59404d67b54e96c5c8a830b2","e2911e79efc2420eac45d9f671463d4b",22850106,1,-1,0,34,3,2,-1
"3f1c815879794b929260d224becaff7e","56586aa865414f538729c7f7735d2bc6",22850106,1,-4,0,45,14,12,-2
"56586aa865414f538729c7f7735d2bc6","3f1c815879794b929260d224becaff7e",22850106,1,4,0,48,12,14,2
"3f1c815879794b929260d224becaff7e","5c5ceeee4562457ba6d41515aeebfbb1",22850106,1,6,0,49,14,17,3
"5c5ceeee4562457ba6d41515aeebfbb1","81c864a886d54a6b8ff85f7d736f4f95",22850106,1,-4,0,50,17,15,-2
"9afd71a5298d4333b6849dfce1b9422c","d4c3b003e8274e429d2fa688d73fde6d",22850106,1,7,0,55,18,22,4
"d4c3b003e8274e429d2fa688d73fde6d","67a089198fcb4e1c8f2385786c2b296f",22850106,1,37,0,56,22,39,17
"64d48c6c9c7940639a932219a6c87198","67a089198fcb4e1c8f2385786c2b296f",22850106,2,-1,0,59,40,39,-1
"b534b89233134e30a9b5645138bfa9ee","0e37b720d23b4e7f8b313e79313fd107",22850106,1,3,0,61,41,44,3
"0e37b720d23b4e7f8b313e79313fd107","0e37b720d23b4e7f8b313e79313fd107",22850106,1,0,1,62,44,44,0
"0e37b720d23b4e7f8b313e79313fd107","6875d67fdd5f48168b62719df449bebd",22850106,1,1,0,63,44,45,1
"6875d67fdd5f48168b62719df449bebd","6875d67fdd5f48168b62719df449bebd",22850106,1,0,1,64,45,45,0
"6875d67fdd5f48168b62719df449bebd","b534b89233134e30a9b5645138bfa9ee",22850106,1,-4,0,65,45,41,-4
"6e13d61a7bdb44bca949c9f86fab3be5","195f78799f984cc2b06c48dfe36be751",22850106,1,2,0,68,47,49,2
"195f78799f984cc2b06c48dfe36be751","195f78799f984cc2b06c48dfe36be751",22850106,2,0,1,69,49,49,0
"195f78799f984cc2b06c48dfe36be751","d0c74f735e024943943e40333d6d337f",22850106,1,3,0,71,49,51,2
"d0c74f735e024943943e40333d6d337f","d9c8d8c444a64dadbbb508652c721e17",22850106,1,-6,0,72,51,46,-5
"d9c8d8c444a64dadbbb508652c721e17","67a089198fcb4e1c8f2385786c2b296f",22850106,1,-10,0,73,46,39,-7
"67a089198fcb4e1c8f2385786c2b296f","d9c8d8c444a64dadbbb508652c721e17",22850106,1,10,0,77,39,46,7
"d0c74f735e024943943e40333d6d337f","983f8ff320594b279a7f4a6fe132f9c5",22850106,1,2,0,84,51,53,2
"983f8ff320594b279a7f4a6fe132f9c5","983f8ff320594b279a7f4a6fe132f9c5",22850106,2,0,1,85,53,53,0
"983f8ff320594b279a7f4a6fe132f9c5","35adfa5d923046aebabfefd98f35ff05",22850106,1,1,0,87,53,54,1
"35adfa5d923046aebabfefd98f35ff05","35adfa5d923046aebabfefd98f35ff05",22850106,5,0,1,88,54,54,0
"35adfa5d923046aebabfefd98f35ff05","b6f8a98476224da1b40e555ececc7ed8",22850106,1,1,0,93,54,55,1
"b6f8a98476224da1b40e555ececc7ed8","b6f8a98476224da1b40e555ececc7ed8",22850106,2,0,1,94,55,55,0
"b6f8a98476224da1b40e555ececc7ed8","86e22cb5fe0e4b47a9489ecddf7ed78f",22850106,1,1,0,96,55,56,1
"86e22cb5fe0e4b47a9489ecddf7ed78f","86e22cb5fe0e4b47a9489ecddf7ed78f",22850106,2,0,1,97,56,56,0
"86e22cb5fe0e4b47a9489ecddf7ed78f","f924752d8a1149668870b1e7698486f7",22850106,1,-6,0,99,56,50,-6
"f924752d8a1149668870b1e7698486f7","a1f2f12debe5432fb7a70bcd12bacfb9",22850106,1,9,0,100,50,58,8
"a1f2f12debe5432fb7a70bcd12bacfb9","78f30e4dcac84e3cbea8b2cc6e0d62b3",22850106,1,1,0,101,58,59,1
"78f30e4dcac84e3cbea8b2cc6e0d62b3","78f30e4dcac84e3cbea8b2cc6e0d62b3",22850106,9,0,1,102,59,59,0
"78f30e4dcac84e3cbea8b2cc6e0d62b3","a1f2f12debe5432fb7a70bcd12bacfb9",22850106,1,-1,0,111,59,58,-1
"a1f2f12debe5432fb7a70bcd12bacfb9","a1f2f12debe5432fb7a70bcd12bacfb9",22850106,21,0,1,112,58,58,0
"a1f2f12debe5432fb7a70bcd12bacfb9","12aa6e1672ac4e7aa6449a7a8609cd72",22850106,1,-1,0,133,58,57,-1
"12aa6e1672ac4e7aa6449a7a8609cd72","a0a418b8540d479fa6e0f653b701da8b",22850106,1,8,0,134,57,64,7
"a0a418b8540d479fa6e0f653b701da8b","bc42d26810654ea9a1df1efe1e58c7d5",22850106,2,-1,0,135,64,63,-1
"bc42d26810654ea9a1df1efe1e58c7d5","afbf7250b99d47bea07172749483ca97",22850106,1,-58,0,136,63,28,-35
"4e51676dc72045d99c19b9fa7b22f8bc","a49d1bb4328949299686242fd0be5584",22850106,1,-13,0,140,29,21,-8
"a49d1bb4328949299686242fd0be5584","d4f45188d3c84a02ba08454e6403a818",22850106,1,3,0,143,21,24,3
"d4f45188d3c84a02ba08454e6403a818","d4c3b003e8274e429d2fa688d73fde6d",22850106,2,-2,0,144,24,22,-2
"d4c3b003e8274e429d2fa688d73fde6d","d4c3b003e8274e429d2fa688d73fde6d",22850106,1,0,1,145,22,22,0
"d4c3b003e8274e429d2fa688d73fde6d","b7719e26494940efa49512aedd0aac79",22850106,2,-3,0,146,22,20,-2
"b7719e26494940efa49512aedd0aac79","b7719e26494940efa49512aedd0aac79",22850106,2,0,1,147,20,20,0
"c33c17be71ae4d588da7369472e5bb1b","4e51676dc72045d99c19b9fa7b22f8bc",22850106,1,-9,0,157,34,29,-5
"4e51676dc72045d99c19b9fa7b22f8bc","d9c8d8c444a64dadbbb508652c721e17",22850106,1,35,0,158,29,46,17
"d9c8d8c444a64dadbbb508652c721e17","b534b89233134e30a9b5645138bfa9ee",22850106,2,-6,0,159,46,41,-5
"b534b89233134e30a9b5645138bfa9ee","6e13d61a7bdb44bca949c9f86fab3be5",22850106,4,7,0,160,41,47,6
"6e13d61a7bdb44bca949c9f86fab3be5","6e13d61a7bdb44bca949c9f86fab3be5",22850106,10,0,1,161,47,47,0
"6e13d61a7bdb44bca949c9f86fab3be5","b534b89233134e30a9b5645138bfa9ee",22850106,1,-7,0,168,47,41,-6
"b534b89233134e30a9b5645138bfa9ee","b534b89233134e30a9b5645138bfa9ee",22850106,1,0,1,169,41,41,0
"b534b89233134e30a9b5645138bfa9ee","f924752d8a1149668870b1e7698486f7",22850106,1,11,0,170,41,50,9
"f924752d8a1149668870b1e7698486f7","f924752d8a1149668870b1e7698486f7",22850106,1,0,1,171,50,50,0
"f924752d8a1149668870b1e7698486f7","b534b89233134e30a9b5645138bfa9ee",22850106,1,-11,0,172,50,41,-9
"b534b89233134e30a9b5645138bfa9ee","d0c74f735e024943943e40333d6d337f",22850106,1,12,0,173,41,51,10
"d0c74f735e024943943e40333d6d337f","d0c74f735e024943943e40333d6d337f",22850106,3,0,1,174,51,51,0
"d0c74f735e024943943e40333d6d337f","309ccf3cc4fe429d9bfbaef53d3fa479",22850106,1,11,0,175,51,60,9
"309ccf3cc4fe429d9bfbaef53d3fa479","b534b89233134e30a9b5645138bfa9ee",22850106,2,-23,0,176,60,41,-19
"b534b89233134e30a9b5645138bfa9ee","bc42d26810654ea9a1df1efe1e58c7d5",22850106,1,26,0,177,41,63,22
"bc42d26810654ea9a1df1efe1e58c7d5","a0a418b8540d479fa6e0f653b701da8b",22850106,4,1,0,178,63,64,1
"a0a418b8540d479fa6e0f653b701da8b","4c943503763e4e349906eea3ed3c8e86",22850106,1,-3,0,179,64,61,-3
"4c943503763e4e349906eea3ed3c8e86","4c943503763e4e349906eea3ed3c8e86",22850106,1,0,1,180,61,61,0
"4c943503763e4e349906eea3ed3c8e86","bc42d26810654ea9a1df1efe1e58c7d5",22850106,1,2,0,181,61,63,2
"bc42d26810654ea9a1df1efe1e58c7d5","bc42d26810654ea9a1df1efe1e58c7d5",22850106,4,0,1,182,63,63,0
"a0a418b8540d479fa6e0f653b701da8b","a0a418b8540d479fa6e0f653b701da8b",22850106,4,0,1,186,64,64,0
"a0a418b8540d479fa6e0f653b701da8b","309ccf3cc4fe429d9bfbaef53d3fa479",22850106,2,-4,0,189,64,60,-4
"b534b89233134e30a9b5645138bfa9ee","d646286c8051419bbc2e31dd1db55ca8",22850106,2,33,0,191,41,67,26
"d646286c8051419bbc2e31dd1db55ca8","267f883678b24aed855fde42524975d9",22850106,1,4,0,192,67,71,4
"267f883678b24aed855fde42524975d9","267f883678b24aed855fde42524975d9",22850106,1,0,1,193,71,71,0
"267f883678b24aed855fde42524975d9","88fff56d0342490dbef9040750a20f6c",22850106,1,1,0,194,71,72,1
"88fff56d0342490dbef9040750a20f6c","88fff56d0342490dbef9040750a20f6c",22850106,1,0,1,195,72,72,0
"88fff56d0342490dbef9040750a20f6c","adb17b12b66c4a49a85fd34322f7df70",22850106,1,1,0,196,72,73,1
"adb17b12b66c4a49a85fd34322f7df70","adb17b12b66c4a49a85fd34322f7df70",22850106,1,0,1,197,73,73,0
"adb17b12b66c4a49a85fd34322f7df70","d646286c8051419bbc2e31dd1db55ca8",22850106,1,-6,0,198,73,67,-6
"140d5b27b8574befad82c0a013b59dfa","d646286c8051419bbc2e31dd1db55ca8",22850106,2,-8,0,202,74,67,-7
"d646286c8051419bbc2e31dd1db55ca8","140d5b27b8574befad82c0a013b59dfa",22850106,1,8,0,203,67,74,7
"140d5b27b8574befad82c0a013b59dfa","140d5b27b8574befad82c0a013b59dfa",22850106,1,0,1,204,74,74,0
"a2becd407db34b189200a32546d9d569","58c22b011d0f4c2ea6d13615edbb9eeb",22850106,1,2,0,208,75,77,2
"58c22b011d0f4c2ea6d13615edbb9eeb","58c22b011d0f4c2ea6d13615edbb9eeb",22850106,2,0,1,209,77,77,0
"58c22b011d0f4c2ea6d13615edbb9eeb","a2becd407db34b189200a32546d9d569",22850106,1,-2,0,211,77,75,-2
"a2becd407db34b189200a32546d9d569","dd76e1861dc9461c830888729d091ee0",22850106,1,3,0,213,75,78,3
"dd76e1861dc9461c830888729d091ee0","dd76e1861dc9461c830888729d091ee0",22850106,8,0,1,214,78,78,0
"dd76e1861dc9461c830888729d091ee0","cd1d828f1a694b87913a7ea66c23803e",22850106,1,1,0,222,78,79,1
"cd1d828f1a694b87913a7ea66c23803e","cd1d828f1a694b87913a7ea66c23803e",22850106,2,0,1,223,79,79,0
"cd1d828f1a694b87913a7ea66c23803e","9176a3c2b4d2465fa8b0c67096c2a97e",22850106,1,1,0,225,79,80,1
"9176a3c2b4d2465fa8b0c67096c2a97e","9176a3c2b4d2465fa8b0c67096c2a97e",22850106,5,0,1,226,80,80,0
"9176a3c2b4d2465fa8b0c67096c2a97e","f8ec6445f7194e25b9101d4fbcb07a18",22850106,1,1,0,231,80,81,1
"f8ec6445f7194e25b9101d4fbcb07a18","f8ec6445f7194e25b9101d4fbcb07a18",22850106,2,0,1,232,81,81,0
"f8ec6445f7194e25b9101d4fbcb07a18","a2becd407db34b189200a32546d9d569",22850106,1,-6,0,234,81,75,-6
"d18a9ea32855445f8736581f5cb119ce","f564483cbd7a407681aa2fcca518cf5f",22850106,1,4,0,237,82,85,3
"f564483cbd7a407681aa2fcca518cf5f","f564483cbd7a407681aa2fcca518cf5f",22850106,1,0,1,238,85,85,0
"f564483cbd7a407681aa2fcca518cf5f","18fd01350bd5434ca636d59a599d768a",22850106,1,1,0,239,85,86,1
"18fd01350bd5434ca636d59a599d768a","18fd01350bd5434ca636d59a599d768a",22850106,8,0,1,240,86,86,0
"18fd01350bd5434ca636d59a599d768a","ae5ac430ea254e708a6f5deaaf7464ae",22850106,1,-2,0,248,86,84,-2
"ae5ac430ea254e708a6f5deaaf7464ae","d646286c8051419bbc2e31dd1db55ca8",22850106,1,-20,0,251,84,67,-17
"d646286c8051419bbc2e31dd1db55ca8","d646286c8051419bbc2e31dd1db55ca8",22850106,1,0,1,252,67,67,0
"d646286c8051419bbc2e31dd1db55ca8","42fb58708eaf4e5daa82bfca61b6f5fd",22850106,1,24,0,253,67,87,20
"42fb58708eaf4e5daa82bfca61b6f5fd","d646286c8051419bbc2e31dd1db55ca8",22850106,1,-24,0,254,87,67,-20
"d646286c8051419bbc2e31dd1db55ca8","6a9f0ef185fb47f0937e29daa1c71ed5",22850106,1,27,0,255,67,90,23
"6a9f0ef185fb47f0937e29daa1c71ed5","c681290961c94c4caf23b529d1ae6b9a",22850106,1,-2,0,256,90,88,-2
"c681290961c94c4caf23b529d1ae6b9a","c681290961c94c4caf23b529d1ae6b9a",22850106,1,0,1,257,88,88,0
"c681290961c94c4caf23b529d1ae6b9a","6a9f0ef185fb47f0937e29daa1c71ed5",22850106,1,2,0,258,88,90,2
"e20db35ced8544ddac5bc3839145e463","1febb706d7a34005ae8711ed49c76e64",22850106,1,3,0,264,91,94,3
"1febb706d7a34005ae8711ed49c76e64","1febb706d7a34005ae8711ed49c76e64",22850106,2,0,1,265,94,94,0
"1febb706d7a34005ae8711ed49c76e64","8f73ba6f5a0042f2850356ac38ac6f24",22850106,1,1,0,267,94,95,1
"8f73ba6f5a0042f2850356ac38ac6f24","8f73ba6f5a0042f2850356ac38ac6f24",22850106,5,0,1,268,95,95,0
"8f73ba6f5a0042f2850356ac38ac6f24","e2260b86653c46d7b14a41fb419dbf8c",22850106,1,1,0,273,95,96,1
"e2260b86653c46d7b14a41fb419dbf8c","e2260b86653c46d7b14a41fb419dbf8c",22850106,2,0,1,274,96,96,0
"e2260b86653c46d7b14a41fb419dbf8c","35eb641ad1d845bbba54915bce75a962",22850106,1,1,0,276,96,97,1
"35eb641ad1d845bbba54915bce75a962","35eb641ad1d845bbba54915bce75a962",22850106,2,0,1,277,97,97,0
"35eb641ad1d845bbba54915bce75a962","08be90ffbeea4795a138cd42ed8db56f",22850106,1,1,0,279,97,98,1
"08be90ffbeea4795a138cd42ed8db56f","08be90ffbeea4795a138cd42ed8db56f",22850106,5,0,1,280,98,98,0
"08be90ffbeea4795a138cd42ed8db56f","3007433c8f584dcbb5ac159c1c5f2be3",22850106,1,1,0,285,98,99,1
"3007433c8f584dcbb5ac159c1c5f2be3","3007433c8f584dcbb5ac159c1c5f2be3",22850106,5,0,1,286,99,99,0
"3007433c8f584dcbb5ac159c1c5f2be3","e20db35ced8544ddac5bc3839145e463",22850106,1,-8,0,291,99,91,-8
"d391c8b6e56a43a7b654e9dee02d904b","d391c8b6e56a43a7b654e9dee02d904b",22850106,15,0,1,296,103,103,0
"d391c8b6e56a43a7b654e9dee02d904b","6111116566fc4fd9abba409322bea245",22850106,1,1,0,311,103,104,1
"6111116566fc4fd9abba409322bea245","6111116566fc4fd9abba409322bea245",22850106,2,0,1,312,104,104,0
"6111116566fc4fd9abba409322bea245","a81b2235cb9c499eb9ea8ee0a8dd9725",22850106,1,1,0,314,104,105,1
"a81b2235cb9c499eb9ea8ee0a8dd9725","a81b2235cb9c499eb9ea8ee0a8dd9725",22850106,2,0,1,315,105,105,0
"a81b2235cb9c499eb9ea8ee0a8dd9725","2d4e0ab0ef3b4d73b82c72d4621a7579",22850106,1,1,0,317,105,106,1
"2d4e0ab0ef3b4d73b82c72d4621a7579","2d4e0ab0ef3b4d73b82c72d4621a7579",22850106,2,0,1,318,106,106,0
"2d4e0ab0ef3b4d73b82c72d4621a7579","8bdebf492ebd4e62b0d522e8ab5e5197",22850106,1,1,0,320,106,107,1
"8bdebf492ebd4e62b0d522e8ab5e5197","8bdebf492ebd4e62b0d522e8ab5e5197",22850106,2,0,1,321,107,107,0
"8bdebf492ebd4e62b0d522e8ab5e5197","4280927ec4d643238aa49c32f9e06c6c",22850106,1,3,0,323,107,109,2
"4280927ec4d643238aa49c32f9e06c6c","73039f8c1eb9409cb4caee2cf968001e",22850106,1,-10,0,324,109,100,-9
"4280927ec4d643238aa49c32f9e06c6c","fc44e6a5f7654430af1227838224dceb",22850106,1,2,0,326,109,111,2
"fc44e6a5f7654430af1227838224dceb","fc44e6a5f7654430af1227838224dceb",22850106,5,0,1,327,111,111,0
"fc44e6a5f7654430af1227838224dceb","08111f75e22d409998cf8b85bd431f0a",22850106,1,-3,0,332,111,108,-3
"08111f75e22d409998cf8b85bd431f0a","e20db35ced8544ddac5bc3839145e463",22850106,1,-19,0,333,108,91,-17
"e20db35ced8544ddac5bc3839145e463","e20db35ced8544ddac5bc3839145e463",22850106,1,0,1,334,91,91,0
"e20db35ced8544ddac5bc3839145e463","37319e88176d4aefa91d7a9980dbae91",22850106,1,24,0,335,91,112,21
"37319e88176d4aefa91d7a9980dbae91","e20db35ced8544ddac5bc3839145e463",22850106,1,-24,0,336,112,91,-21
"e20db35ced8544ddac5bc3839145e463","71cec822bcff4f30a20e75dc63ef7b65",22850106,1,28,0,337,91,116,25
"71cec822bcff4f30a20e75dc63ef7b65","71cec822bcff4f30a20e75dc63ef7b65",22850106,1,0,1,338,116,116,0
"71cec822bcff4f30a20e75dc63ef7b65","62bff51286ef4f348717a3cf6fe2318f",22850106,1,5,0,339,116,120,4
"37319e88176d4aefa91d7a9980dbae91","b1cd0e7dc3ad4a8eb91a4bfdbeb025b0",22850106,1,7,0,341,112,118,6
"b1cd0e7dc3ad4a8eb91a4bfdbeb025b0","b1cd0e7dc3ad4a8eb91a4bfdbeb025b0",22850106,1,0,1,342,118,118,0
"b1cd0e7dc3ad4a8eb91a4bfdbeb025b0","62bff51286ef4f348717a3cf6fe2318f",22850106,1,2,0,343,118,120,2
"62bff51286ef4f348717a3cf6fe2318f","e20db35ced8544ddac5bc3839145e463",22850106,1,-33,0,347,120,91,-29
"779f9ddd1fd14d1e9e69f72219a1fdbd","ae26e6cda8ad4a3f81bd347560d9579f",22850106,1,4,0,349,121,125,4
"ae26e6cda8ad4a3f81bd347560d9579f","ae26e6cda8ad4a3f81bd347560d9579f",22850106,1,0,1,350,125,125,0
"ae26e6cda8ad4a3f81bd347560d9579f","ee48df95832b4374aa273ceb27ec1315",22850106,1,1,0,351,125,126,1
"ee48df95832b4374aa273ceb27ec1315","ee48df95832b4374aa273ceb27ec1315",22850106,1,0,1,352,126,126,0
"ee48df95832b4374aa273ceb27ec1315","7a439da90b394756ad1777fc4c6dead5",22850106,1,1,0,353,126,127,1
"7a439da90b394756ad1777fc4c6dead5","7a439da90b394756ad1777fc4c6dead5",22850106,1,0,1,354,127,127,0
"7a439da90b394756ad1777fc4c6dead5","779f9ddd1fd14d1e9e69f72219a1fdbd",22850106,1,-6,0,355,127,121,-6
"a8dd5213034441ac92724b4e83eb0bb2","779f9ddd1fd14d1e9e69f72219a1fdbd",22850106,2,-9,0,357,129,121,-8
"779f9ddd1fd14d1e9e69f72219a1fdbd","579338175e0b4bbb8ef3b712b5d8b54e",22850106,2,8,0,358,121,128,7
"579338175e0b4bbb8ef3b712b5d8b54e","a8dd5213034441ac92724b4e83eb0bb2",22850106,1,1,0,359,128,129,1
"a8dd5213034441ac92724b4e83eb0bb2","8115eab6556b45f5b415c3b8c26a12e5",22850106,1,2,0,361,129,131,2
"8115eab6556b45f5b415c3b8c26a12e5","8115eab6556b45f5b415c3b8c26a12e5",22850106,2,0,1,362,131,131,0
"8115eab6556b45f5b415c3b8c26a12e5","ec34b06efd844b46a4c4818ecdb9b8f4",22850106,1,1,0,364,131,132,1
"ec34b06efd844b46a4c4818ecdb9b8f4","ec34b06efd844b46a4c4818ecdb9b8f4",22850106,2,0,1,365,132,132,0
"ec34b06efd844b46a4c4818ecdb9b8f4","c2e1c2b9eac64109b343a088584b576b",22850106,1,1,0,367,132,133,1
"c2e1c2b9eac64109b343a088584b576b","c2e1c2b9eac64109b343a088584b576b",22850106,2,0,1,368,133,133,0
"c2e1c2b9eac64109b343a088584b576b","579338175e0b4bbb8ef3b712b5d8b54e",22850106,1,-5,0,370,133,128,-5
"579338175e0b4bbb8ef3b712b5d8b54e","8bc5795d6a984a3eace4e2811e52dd4f",22850106,1,8,0,371,128,135,7
"8bc5795d6a984a3eace4e2811e52dd4f","8bc5795d6a984a3eace4e2811e52dd4f",22850106,4,0,1,372,135,135,0
"8bc5795d6a984a3eace4e2811e52dd4f","b416d47c56a742199b5d7c7f19d6503a",22850106,1,-1,0,376,135,134,-1
"b416d47c56a742199b5d7c7f19d6503a","779f9ddd1fd14d1e9e69f72219a1fdbd",22850106,1,-15,0,377,134,121,-13
"779f9ddd1fd14d1e9e69f72219a1fdbd","67a089198fcb4e1c8f2385786c2b296f",22850106,1,-103,0,378,121,39,-82
"67a089198fcb4e1c8f2385786c2b296f","f661500307d74c908e9207d949ceb4aa",22850106,1,121,0,379,39,136,97
"f661500307d74c908e9207d949ceb4aa","779f9ddd1fd14d1e9e69f72219a1fdbd",22850106,2,-18,0,380,136,121,-15
"779f9ddd1fd14d1e9e69f72219a1fdbd","779f9ddd1fd14d1e9e69f72219a1fdbd",22850106,1,0,1,381,121,121,0
"579338175e0b4bbb8ef3b712b5d8b54e","779f9ddd1fd14d1e9e69f72219a1fdbd",22850106,1,-8,0,383,128,121,-7
"779f9ddd1fd14d1e9e69f72219a1fdbd","f661500307d74c908e9207d949ceb4aa",22850106,1,18,0,386,121,136,15
"779f9ddd1fd14d1e9e69f72219a1fdbd","cd4532ad48034873ba8bce2aac0c9808",22850106,1,19,0,388,121,137,16
"cd4532ad48034873ba8bce2aac0c9808","cd4532ad48034873ba8bce2aac0c9808",22850106,1,0,1,389,137,137,0
"cd4532ad48034873ba8bce2aac0c9808","df1de691dafe4549a18a4398ee9dfaf9",22850106,1,4,0,390,137,139,2
"6c5ad271a44743479bfaea29b1db8d02","83d311bed5374fee83d8d67a7d9d82dc",22850106,1,1,0,394,143,144,1
"83d311bed5374fee83d8d67a7d9d82dc","83d311bed5374fee83d8d67a7d9d82dc",22850106,1,0,1,395,144,144,0
"83d311bed5374fee83d8d67a7d9d82dc","402bba41861d43acb52a5abb89e8831e",22850106,1,1,0,396,144,145,1
"402bba41861d43acb52a5abb89e8831e","402bba41861d43acb52a5abb89e8831e",22850106,2,0,1,397,145,145,0
"402bba41861d43acb52a5abb89e8831e","df1de691dafe4549a18a4398ee9dfaf9",22850106,1,-6,0,399,145,139,-6
"8aae34f5ddbb4052a709b12e6b0d40fa","645b3f0249f64f76af2e19eb4d0e55b7",22850106,1,2,0,402,147,149,2
"645b3f0249f64f76af2e19eb4d0e55b7","645b3f0249f64f76af2e19eb4d0e55b7",22850106,8,0,1,403,149,149,0
"645b3f0249f64f76af2e19eb4d0e55b7","7e7b8db5064d4369805ab370aac5ddfb",22850106,1,1,0,411,149,150,1
"7e7b8db5064d4369805ab370aac5ddfb","7e7b8db5064d4369805ab370aac5ddfb",22850106,2,0,1,412,150,150,0
"7e7b8db5064d4369805ab370aac5ddfb","8956d210ae7f41968fada86d4c979d6a",22850106,1,1,0,414,150,151,1
"8956d210ae7f41968fada86d4c979d6a","8956d210ae7f41968fada86d4c979d6a",22850106,2,0,1,415,151,151,0
"8956d210ae7f41968fada86d4c979d6a","f902b0f41b544d4dbf79664fd233648d",22850106,1,-5,0,417,151,146,-5
"f902b0f41b544d4dbf79664fd233648d","ae781e8b775e4ccd93bc800dad5c8376",22850106,1,8,0,418,146,153,7
"ae781e8b775e4ccd93bc800dad5c8376","ae781e8b775e4ccd93bc800dad5c8376",22850106,2,0,1,419,153,153,0
"ae781e8b775e4ccd93bc800dad5c8376","06882a8492d9499aa31555567f575ecb",22850106,1,1,0,421,153,154,1
"06882a8492d9499aa31555567f575ecb","06882a8492d9499aa31555567f575ecb",22850106,1,0,1,422,154,154,0
"06882a8492d9499aa31555567f575ecb","f293c508f409466a8f27ddd7d1e40b20",22850106,1,1,0,423,154,155,1
"f293c508f409466a8f27ddd7d1e40b20","f293c508f409466a8f27ddd7d1e40b20",22850106,2,0,1,424,155,155,0
"f293c508f409466a8f27ddd7d1e40b20","cc4ddef5bbbe48ebb605141b347c4ed1",22850106,1,1,0,426,155,156,1
"cc4ddef5bbbe48ebb605141b347c4ed1","cc4ddef5bbbe48ebb605141b347c4ed1",22850106,1,0,1,427,156,156,0
"cc4ddef5bbbe48ebb605141b347c4ed1","d313cec988a84645bee413e8d4724a4b",22850106,1,3,0,428,156,158,2
"d313cec988a84645bee413e8d4724a4b","f03480cf4eba413194d7af52fc0e7f28",22850106,1,-7,0,429,158,152,-6
"d313cec988a84645bee413e8d4724a4b","dc60696c76a74368a60f72246e47700d",22850106,1,1,0,434,158,159,1
"dc60696c76a74368a60f72246e47700d","dc60696c76a74368a60f72246e47700d",22850106,1,0,1,435,159,159,0
"dc60696c76a74368a60f72246e47700d","df1de691dafe4549a18a4398ee9dfaf9",22850106,1,-23,0,436,159,139,-20
"82e6285962b8400d9d6fc32436022a94","0c7262dff33c4087bc660ccf40f92f9c",22850106,1,7,0,524,167,169,2
"0c7262dff33c4087bc660ccf40f92f9c","0c7262dff33c4087bc660ccf40f92f9c",22850106,1,0,1,525,169,169,0
"0c7262dff33c4087bc660ccf40f92f9c","b2275c3fad834f8d90737a2d9a6927d6",22850106,1,3,0,526,169,172,3
"b2275c3fad834f8d90737a2d9a6927d6","b2275c3fad834f8d90737a2d9a6927d6",22850106,23,0,1,527,172,172,0
"b2275c3fad834f8d90737a2d9a6927d6","eb515a26030b41f8a82a1e6114420bad",22850106,1,1,0,550,172,173,1
"eb515a26030b41f8a82a1e6114420bad","eb515a26030b41f8a82a1e6114420bad",22850106,2,0,1,551,173,173,0
"eb515a26030b41f8a82a1e6114420bad","0c7262dff33c4087bc660ccf40f92f9c",22850106,1,-4,0,553,173,169,-4
"b42cc17b7de840f181a704558d0bc845","801f9e9135034f49bf5f8b4bdefedb41",22850106,1,2,0,556,175,177,2
"801f9e9135034f49bf5f8b4bdefedb41","801f9e9135034f49bf5f8b4bdefedb41",22850106,4,0,1,557,177,177,0
"801f9e9135034f49bf5f8b4bdefedb41","362fcb0699a14845ab29b2340093e528",22850106,1,-3,0,561,177,174,-3
"b87c552dd247427abe6ab5795b9c9d43","b87c552dd247427abe6ab5795b9c9d43",22850106,30,0,1,566,181,181,0
"b87c552dd247427abe6ab5795b9c9d43","139b097acfca451689d80c9c6eebdf7b",22850106,1,-3,0,596,181,178,-3
"139b097acfca451689d80c9c6eebdf7b","30f660a1feb34582a739722532524f79",22850106,1,6,0,597,178,183,5
"30f660a1feb34582a739722532524f79","30f660a1feb34582a739722532524f79",22850106,10,0,1,598,183,183,0
"30f660a1feb34582a739722532524f79","2024b4885bd14338a39b7b509acbbd02",22850106,1,-1,0,608,183,182,-1
"2024b4885bd14338a39b7b509acbbd02","c3f63fe50d8e487c86bf8ef76c9cadd3",22850106,1,4,0,609,182,185,3
"c3f63fe50d8e487c86bf8ef76c9cadd3","c3f63fe50d8e487c86bf8ef76c9cadd3",22850106,1,0,1,610,185,185,0
"c3f63fe50d8e487c86bf8ef76c9cadd3","c8e371568a0c4391b25796ae4e91952e",22850106,1,3,0,611,185,186,1
"c8e371568a0c4391b25796ae4e91952e","0c7262dff33c4087bc660ccf40f92f9c",22850106,2,-23,0,612,186,169,-17
"0c7262dff33c4087bc660ccf40f92f9c","7d932b23e1c84326ae5aa4d3c0d813d1",22850106,1,25,0,613,169,188,19
"7d932b23e1c84326ae5aa4d3c0d813d1","7d932b23e1c84326ae5aa4d3c0d813d1",22850106,3,0,1,614,188,188,0
"7d932b23e1c84326ae5aa4d3c0d813d1","c8e371568a0c4391b25796ae4e91952e",22850106,1,-2,0,617,188,186,-2
"ab11d94c6c8948ea90b88f19d2cd502b","f992451ed6ad4e68bb9e68ad6be7c4be",22850106,1,2,0,620,190,192,2
"f992451ed6ad4e68bb9e68ad6be7c4be","f992451ed6ad4e68bb9e68ad6be7c4be",22850106,1,0,1,621,192,192,0
"f992451ed6ad4e68bb9e68ad6be7c4be","07b44a7a51e94c78b411c753fc39dab0",22850106,1,-3,0,622,192,189,-3
"6cd2dcaac46847d4a0bc53f296d90375","6cd2dcaac46847d4a0bc53f296d90375",22850106,1,0,1,624,194,194,0
"6cd2dcaac46847d4a0bc53f296d90375","2d2580c9411c4972909db508d6956a58",22850106,1,2,0,625,194,196,2
"2d2580c9411c4972909db508d6956a58","2d2580c9411c4972909db508d6956a58",22850106,2,0,1,626,196,196,0
"2d2580c9411c4972909db508d6956a58","5bddb3d9ed264f3984702f048c7e5340",22850106,1,1,0,628,196,197,1
"5bddb3d9ed264f3984702f048c7e5340","5bddb3d9ed264f3984702f048c7e5340",22850106,2,0,1,629,197,197,0
"5bddb3d9ed264f3984702f048c7e5340","d5e8e2bd12a2466b9d6d90855f0eb079",22850106,1,1,0,631,197,198,1
"d5e8e2bd12a2466b9d6d90855f0eb079","d5e8e2bd12a2466b9d6d90855f0eb079",22850106,2,0,1,632,198,198,0
"d5e8e2bd12a2466b9d6d90855f0eb079","017d7ca8e0394b91aaadc9574df2202c",22850106,1,-5,0,634,198,193,-5
"017d7ca8e0394b91aaadc9574df2202c","54e8e9f0ea3e45c4bf3b8ac799ee31b1",22850106,1,8,0,635,193,200,7
"54e8e9f0ea3e45c4bf3b8ac799ee31b1","54e8e9f0ea3e45c4bf3b8ac799ee31b1",22850106,1,0,1,636,200,200,0
"54e8e9f0ea3e45c4bf3b8ac799ee31b1","c614a00911be4877a075f19315530fb0",22850106,1,1,0,637,200,201,1
"c614a00911be4877a075f19315530fb0","c614a00911be4877a075f19315530fb0",22850106,6,0,1,638,201,201,0
"c614a00911be4877a075f19315530fb0","a6c21bd8b95249c7972820a7a7d76aff",22850106,1,1,0,644,201,202,1
"a6c21bd8b95249c7972820a7a7d76aff","a6c21bd8b95249c7972820a7a7d76aff",22850106,2,0,1,645,202,202,0
"a6c21bd8b95249c7972820a7a7d76aff","c8e371568a0c4391b25796ae4e91952e",22850106,1,-19,0,647,202,186,-16
"0c7262dff33c4087bc660ccf40f92f9c","f9170dd6bc6442b4acd832747609b09a",22850106,1,39,0,649,169,199,30
"c8e371568a0c4391b25796ae4e91952e","bb329d880ab54120adaf203a693bb203",22850106,1,20,0,651,186,203,17
"bb329d880ab54120adaf203a693bb203","bb329d880ab54120adaf203a693bb203",22850106,1,0,1,652,203,203,0
"bb329d880ab54120adaf203a693bb203","f9170dd6bc6442b4acd832747609b09a",22850106,1,-4,0,653,203,199,-4
"c8e371568a0c4391b25796ae4e91952e","334c2344009840079b1d0e1b7ce3d5a7",22850106,1,23,0,655,186,205,19
"334c2344009840079b1d0e1b7ce3d5a7","334c2344009840079b1d0e1b7ce3d5a7",22850106,1,0,1,656,205,205,0
"334c2344009840079b1d0e1b7ce3d5a7","d7f13c8d63ec4e2aa673fbb9cf9c6933",22850106,1,3,0,657,205,206,1
"d7f13c8d63ec4e2aa673fbb9cf9c6933","c8e371568a0c4391b25796ae4e91952e",22850106,1,-26,0,658,206,186,-20
"c8e371568a0c4391b25796ae4e91952e","7108f0e4c2584f1f9c471689ae4c885c",22850106,1,28,0,659,186,208,22
"7108f0e4c2584f1f9c471689ae4c885c","b9e80f77c3a44349863b19875725c384",22850106,2,-1,0,660,208,207,-1
"b9e80f77c3a44349863b19875725c384","b9e80f77c3a44349863b19875725c384",22850106,19,0,1,661,207,207,0
"d7f13c8d63ec4e2aa673fbb9cf9c6933","d7f13c8d63ec4e2aa673fbb9cf9c6933",22850106,3,0,1,695,206,206,0
"d7f13c8d63ec4e2aa673fbb9cf9c6933","7108f0e4c2584f1f9c471689ae4c885c",22850106,1,2,0,696,206,208,2
"09400e101c5d4b439cf9a26b03aae558","a88efa7e50ce47159810ab553afa6d3a",22850106,1,2,0,709,210,212,2
"a88efa7e50ce47159810ab553afa6d3a","a88efa7e50ce47159810ab553afa6d3a",22850106,5,0,1,710,212,212,0
"a88efa7e50ce47159810ab553afa6d3a","a875096404ef4a9984b62d74cda916f9",22850106,1,-3,0,715,212,209,-3
"f7fb1952f56b4189b86a9f8b7862d2b8","f7fb1952f56b4189b86a9f8b7862d2b8",22850106,13,0,1,720,215,215,0
"f7fb1952f56b4189b86a9f8b7862d2b8","b860ee85d8bc4a2f97958cfb71be3533",22850106,1,1,0,733,215,216,1
"b860ee85d8bc4a2f97958cfb71be3533","b860ee85d8bc4a2f97958cfb71be3533",22850106,2,0,1,734,216,216,0
"b860ee85d8bc4a2f97958cfb71be3533","ec341f459285443b8361f7f15638ff08",22850106,1,-3,0,736,216,213,-3
"363837c182e04711840d896ae1e0339c","363837c182e04711840d896ae1e0339c",22850106,14,0,1,738,218,218,0
"363837c182e04711840d896ae1e0339c","be95c065e45447c1bd8215ea6f130c7a",22850106,1,2,0,754,218,219,1
"be95c065e45447c1bd8215ea6f130c7a","01b2051f8941460d89945e3b02d1ce78",22850106,1,-3,0,755,219,217,-2
"01b2051f8941460d89945e3b02d1ce78","be95c065e45447c1bd8215ea6f130c7a",22850106,1,3,0,756,217,219,2
"be95c065e45447c1bd8215ea6f130c7a","d7f13c8d63ec4e2aa673fbb9cf9c6933",22850106,1,-17,0,757,219,206,-13
"1c6721b1f63f4d30ba7746ea8af02a52","1c6721b1f63f4d30ba7746ea8af02a52",22850106,1,0,1,760,221,221,0
"77ecef8eff6b4a2caea7707669bf7475","77ecef8eff6b4a2caea7707669bf7475",22850106,13,0,1,763,222,222,0
"d03cb855c70044cf8c35d9ec0de696e3","a49a937d6896486d9a5396654abcf2e1",22850106,1,2,0,780,224,226,2
"8b9ae98743bd4d4a8a87dff1c1244211","d7f13c8d63ec4e2aa673fbb9cf9c6933",22850106,1,-28,0,824,227,206,-21
"d7f13c8d63ec4e2aa673fbb9cf9c6933","64dbedb3ce544f6aae8e10e0cf10f16d",22850106,1,44,0,826,206,240,34
"64dbedb3ce544f6aae8e10e0cf10f16d","1c6721b1f63f4d30ba7746ea8af02a52",22850106,1,-23,0,827,240,221,-19
"1c6721b1f63f4d30ba7746ea8af02a52","f53da5fd9bfe412da4b80d4742563b6c",22850106,1,24,0,828,221,241,20
"f53da5fd9bfe412da4b80d4742563b6c","f53da5fd9bfe412da4b80d4742563b6c",22850106,1,0,1,829,241,241,0
"f53da5fd9bfe412da4b80d4742563b6c","2ae94c0cea4d480a9d5dca8fb1d7b542",22850106,1,3,0,830,241,242,1
"1ebf23f9d994469a85206e4c7b1bf5f5","1ebf23f9d994469a85206e4c7b1bf5f5",22850106,10,0,1,833,245,245,0
"1ebf23f9d994469a85206e4c7b1bf5f5","85ae675b83e8422da842cfd25596af99",22850106,1,1,0,843,245,246,1
"85ae675b83e8422da842cfd25596af99","85ae675b83e8422da842cfd25596af99",22850106,1,0,1,844,246,246,0
"85ae675b83e8422da842cfd25596af99","fa235f0f364d47e4ae1c87f47bf8e6ba",22850106,1,8,0,845,246,252,6
"fa235f0f364d47e4ae1c87f47bf8e6ba","2ae94c0cea4d480a9d5dca8fb1d7b542",22850106,1,-12,0,846,252,242,-10
"2ae94c0cea4d480a9d5dca8fb1d7b542","fa235f0f364d47e4ae1c87f47bf8e6ba",22850106,1,12,0,847,242,252,10
"fa235f0f364d47e4ae1c87f47bf8e6ba","79f7845465cc4ed19d8e4f1429541be0",22850106,1,2,0,848,252,254,2
"79f7845465cc4ed19d8e4f1429541be0","79f7845465cc4ed19d8e4f1429541be0",22850106,2,0,1,849,254,254,0
"79f7845465cc4ed19d8e4f1429541be0","00f61990949545828dd12f1303d47504",22850106,1,3,0,851,254,256,2
"6e83e23f56544a19b94067c1c558d9c0","2ae94c0cea4d480a9d5dca8fb1d7b542",22850106,1,-6,0,853,247,242,-5
"2ae94c0cea4d480a9d5dca8fb1d7b542","28c171777c52431ab6b925073bd63d46",22850106,1,26,0,855,242,264,22
"28c171777c52431ab6b925073bd63d46","28c171777c52431ab6b925073bd63d46",22850106,7,0,1,856,264,264,0
"28c171777c52431ab6b925073bd63d46","ac160db940cb49ae8579162b1d52bb5d",22850106,1,2,0,863,264,266,2
"ac160db940cb49ae8579162b1d52bb5d","ac160db940cb49ae8579162b1d52bb5d",22850106,15,0,1,864,266,266,0
"ac160db940cb49ae8579162b1d52bb5d","d989ebcfc12a4b669f0100dc1aa14f1e",22850106,1,-12,0,879,266,255,-11
"d989ebcfc12a4b669f0100dc1aa14f1e","c6fd49b485cc4874b0bbdd9c6171e09c",22850106,1,15,0,880,255,268,13
"c6fd49b485cc4874b0bbdd9c6171e09c","c6fd49b485cc4874b0bbdd9c6171e09c",22850106,3,0,1,881,268,268,0
"c6fd49b485cc4874b0bbdd9c6171e09c","44240778a97c4af0937817499b75707b",22850106,1,1,0,884,268,269,1
"44240778a97c4af0937817499b75707b","44240778a97c4af0937817499b75707b",22850106,2,0,1,885,269,269,0
"44240778a97c4af0937817499b75707b","7aa76d3e993840d8805f097cbdbcd44b",22850106,1,-9,0,887,269,261,-8
"7aa76d3e993840d8805f097cbdbcd44b","865a4d3b43374da7944dc7d397f566d9",22850106,1,12,0,888,261,271,10
"865a4d3b43374da7944dc7d397f566d9","865a4d3b43374da7944dc7d397f566d9",22850106,1,0,1,889,271,271,0
"865a4d3b43374da7944dc7d397f566d9","2ae94c0cea4d480a9d5dca8fb1d7b542",22850106,1,-35,0,890,271,242,-29
"0d987bed3ffa4ed0b9a2e62e97b7b30f","362fcb0699a14845ab29b2340093e528",22850106,1,-129,0,892,272,174,-98
"362fcb0699a14845ab29b2340093e528","362fcb0699a14845ab29b2340093e528",22850106,1,0,1,893,174,174,0
"362fcb0699a14845ab29b2340093e528","0c7262dff33c4087bc660ccf40f92f9c",22850106,2,-6,0,894,174,169,-5
"0c7262dff33c4087bc660ccf40f92f9c","362fcb0699a14845ab29b2340093e528",22850106,1,6,0,895,169,174,5
"b42cc17b7de840f181a704558d0bc845","0d987bed3ffa4ed0b9a2e62e97b7b30f",22850106,1,128,0,898,175,272,97
"bb5a47f5ea01454a8b79455422d3b9da","bc5524e78a8544e2ae2fdc2f3462bbec",22850106,1,-1,0,910,280,279,-1
"bc5524e78a8544e2ae2fdc2f3462bbec","82ae07bc0c9b4570a41799290d1ef399",22850106,1,-5,0,911,279,275,-4
"82ae07bc0c9b4570a41799290d1ef399","0d987bed3ffa4ed0b9a2e62e97b7b30f",22850106,1,-4,0,912,275,272,-3
"0d987bed3ffa4ed0b9a2e62e97b7b30f","82ae07bc0c9b4570a41799290d1ef399",22850106,2,4,0,913,272,275,3
"a37477c4e4c14169ad44b06b493007f6","139b097acfca451689d80c9c6eebdf7b",22850106,1,-139,0,989,283,178,-105
"b87c552dd247427abe6ab5795b9c9d43","0d987bed3ffa4ed0b9a2e62e97b7b30f",22850106,1,121,0,993,181,272,91
"bb5a47f5ea01454a8b79455422d3b9da","bb5a47f5ea01454a8b79455422d3b9da",22850106,80,0,1,1000,280,280,0
"bb5a47f5ea01454a8b79455422d3b9da","4a29443515bb404cb8924e1c60a63b73",22850106,1,12,0,1002,280,285,5
"4a29443515bb404cb8924e1c60a63b73","4a29443515bb404cb8924e1c60a63b73",22850106,4,0,1,1003,285,285,0
"4a29443515bb404cb8924e1c60a63b73","208c9b2796c944db8dacaa96082520ea",22850106,3,3,0,1004,285,288,3
"208c9b2796c944db8dacaa96082520ea","208c9b2796c944db8dacaa96082520ea",22850106,2,0,1,1005,288,288,0
"208c9b2796c944db8dacaa96082520ea","4a29443515bb404cb8924e1c60a63b73",22850106,2,-3,0,1006,288,285,-3
"4a29443515bb404cb8924e1c60a63b73","7669a956527947d0add87455277e80b4",22850106,1,7,0,1007,285,291,6
"7669a956527947d0add87455277e80b4","7669a956527947d0add87455277e80b4",22850106,1,0,1,1008,291,291,0
"7669a956527947d0add87455277e80b4","6a9a3b5bde4a48daa896fe8c06eca56f",22850106,1,-2,0,1009,291,289,-2
"6a9a3b5bde4a48daa896fe8c06eca56f","869e967078f04da18dd0b0b9389a7424",22850106,2,5,0,1010,289,293,4
"869e967078f04da18dd0b0b9389a7424","869e967078f04da18dd0b0b9389a7424",22850106,2,0,1,1011,293,293,0
"869e967078f04da18dd0b0b9389a7424","51ab6291537748fab90d519aa09889d6",22850106,1,2,0,1012,293,295,2
"51ab6291537748fab90d519aa09889d6","51ab6291537748fab90d519aa09889d6",22850106,5,0,1,1013,295,295,0
"51ab6291537748fab90d519aa09889d6","34a6e49023fc4465bd5ca604330bbd1c",22850106,1,-3,0,1018,295,292,-3
"34a6e49023fc4465bd5ca604330bbd1c","ba0e59461bfb4a44b7b1c28a01f8d3b3",22850106,2,9,0,1019,292,299,7
"ba0e59461bfb4a44b7b1c28a01f8d3b3","21592f2a9e9c4b2f8c66ec5dbcbf6a2b",22850106,2,-4,0,1020,299,296,-3
"21592f2a9e9c4b2f8c66ec5dbcbf6a2b","ba0e59461bfb4a44b7b1c28a01f8d3b3",22850106,2,4,0,1021,296,299,3
"ba0e59461bfb4a44b7b1c28a01f8d3b3","0e0b36e731a645e7b1b8a88f5031ca38",22850106,1,2,0,1022,299,301,2
"0e0b36e731a645e7b1b8a88f5031ca38","0e0b36e731a645e7b1b8a88f5031ca38",22850106,2,0,1,1023,301,301,0
"0e0b36e731a645e7b1b8a88f5031ca38","a66a144637284c21afc6de17fea4bfb8",22850106,1,1,0,1025,301,302,1
"a66a144637284c21afc6de17fea4bfb8","a66a144637284c21afc6de17fea4bfb8",22850106,2,0,1,1026,302,302,0
"a66a144637284c21afc6de17fea4bfb8","7646a919d7e64fa990bca9b024ff089d",22850106,1,-4,0,1028,302,298,-4
"7646a919d7e64fa990bca9b024ff089d","4a29443515bb404cb8924e1c60a63b73",22850106,3,-17,0,1029,298,285,-13
"208c9b2796c944db8dacaa96082520ea","2c5bb2cbd0014420ad8c95d40e38efd1",22850106,1,20,0,1031,288,303,15
"2c5bb2cbd0014420ad8c95d40e38efd1","4a29443515bb404cb8924e1c60a63b73",22850106,1,-23,0,1032,303,285,-18
"4a29443515bb404cb8924e1c60a63b73","3434c10e561d488a914e0f7d71907abd",22850106,2,27,0,1034,285,305,20
"3434c10e561d488a914e0f7d71907abd","53e7e900392747ccad52e711ab0f80d8",22850106,3,2,0,1035,305,307,2
"53e7e900392747ccad52e711ab0f80d8","53e7e900392747ccad52e711ab0f80d8",22850106,2,0,1,1036,307,307,0
"53e7e900392747ccad52e711ab0f80d8","3434c10e561d488a914e0f7d71907abd",22850106,3,-2,0,1037,307,305,-2
"3434c10e561d488a914e0f7d71907abd","130acc2aeb0448fdbb2de63bc5cebe5b",22850106,5,5,0,1038,305,309,4
"130acc2aeb0448fdbb2de63bc5cebe5b","130acc2aeb0448fdbb2de63bc5cebe5b",22850106,3,0,1,1039,309,309,0
"130acc2aeb0448fdbb2de63bc5cebe5b","9c062b3251034ebe90f5054e2a3b5120",22850106,1,2,0,1040,309,311,2
"9c062b3251034ebe90f5054e2a3b5120","9c062b3251034ebe90f5054e2a3b5120",22850106,2,0,1,1041,311,311,0
"9c062b3251034ebe90f5054e2a3b5120","ea859f8207e44537889daeaba13ac2e8",22850106,1,1,0,1043,311,312,1
"ea859f8207e44537889daeaba13ac2e8","ea859f8207e44537889daeaba13ac2e8",22850106,1,0,1,1044,312,312,0
"ea859f8207e44537889daeaba13ac2e8","141c0df6cd1946539aadd1c9b7068cd4",22850106,1,-4,0,1045,312,308,-4
"141c0df6cd1946539aadd1c9b7068cd4","141c0df6cd1946539aadd1c9b7068cd4",22850106,1,0,1,1046,308,308,0
"141c0df6cd1946539aadd1c9b7068cd4","3434c10e561d488a914e0f7d71907abd",22850106,2,-4,0,1047,308,305,-3
"130acc2aeb0448fdbb2de63bc5cebe5b","56d94971a7a94257aa330183a8ebd0ea",22850106,1,4,0,1049,309,313,4
"56d94971a7a94257aa330183a8ebd0ea","56d94971a7a94257aa330183a8ebd0ea",22850106,9,0,1,1050,313,313,0
"56d94971a7a94257aa330183a8ebd0ea","141c0df6cd1946539aadd1c9b7068cd4",22850106,1,-5,0,1059,313,308,-5
"130acc2aeb0448fdbb2de63bc5cebe5b","141c0df6cd1946539aadd1c9b7068cd4",22850106,3,-1,0,1062,309,308,-1
"141c0df6cd1946539aadd1c9b7068cd4","13255e63e0aa4abf85e5211bf613d43e",22850106,1,10,0,1063,308,317,9
"13255e63e0aa4abf85e5211bf613d43e","13255e63e0aa4abf85e5211bf613d43e",22850106,1,0,1,1064,317,317,0
"13255e63e0aa4abf85e5211bf613d43e","86c27d40179e419c8e9d150fb6afa5d0",22850106,1,3,0,1065,317,319,2
"86c27d40179e419c8e9d150fb6afa5d0","0c787d16c9504873b1a4d903cec09948",22850106,3,-6,0,1066,319,314,-5
"0c787d16c9504873b1a4d903cec09948","86c27d40179e419c8e9d150fb6afa5d0",22850106,2,6,0,1067,314,319,5
"86c27d40179e419c8e9d150fb6afa5d0","8d7e0b55cf9849cda222a0f2440cec55",22850106,1,-1,0,1068,319,318,-1
"8d7e0b55cf9849cda222a0f2440cec55","24f1363179ad4aaa965484a78471912b",22850106,3,6,0,1069,318,323,5
"24f1363179ad4aaa965484a78471912b","47edbb64109243e6b0f8f64cdef90c6c",22850106,1,3,0,1070,323,326,3
"47edbb64109243e6b0f8f64cdef90c6c","24f1363179ad4aaa965484a78471912b",22850106,1,-3,0,1071,326,323,-3
"24f1363179ad4aaa965484a78471912b","3628bdce1dd2429ba924d2d4d09448d2",22850106,3,-1,0,1072,323,322,-1
"3628bdce1dd2429ba924d2d4d09448d2","0c4079457ede49e3aeb5e86ed84bdf35",22850106,1,10,0,1073,322,329,7
"0c4079457ede49e3aeb5e86ed84bdf35","0c4079457ede49e3aeb5e86ed84bdf35",22850106,1,0,1,1074,329,329,0
"0c4079457ede49e3aeb5e86ed84bdf35","38aea304b4fa46e1b29bb72f5cea4c93",22850106,9,2,0,1075,329,331,2
"38aea304b4fa46e1b29bb72f5cea4c93","38aea304b4fa46e1b29bb72f5cea4c93",22850106,12,0,1,1076,331,331,0
"38aea304b4fa46e1b29bb72f5cea4c93","2fe14166dc9642c3bc666b86a57f943d",22850106,1,32,0,1077,331,357,26
"2fe14166dc9642c3bc666b86a57f943d","0c4079457ede49e3aeb5e86ed84bdf35",22850106,1,-34,0,1078,357,329,-28
"38aea304b4fa46e1b29bb72f5cea4c93","0c4079457ede49e3aeb5e86ed84bdf35",22850106,6,-2,0,1081,331,329,-2
"38aea304b4fa46e1b29bb72f5cea4c93","e36d261332f14e79bb4b467aceaeb9b5",22850106,1,2,0,1096,331,333,2
"e36d261332f14e79bb4b467aceaeb9b5","e36d261332f14e79bb4b467aceaeb9b5",22850106,1,0,1,1097,333,333,0
"e36d261332f14e79bb4b467aceaeb9b5","c7e89b9d04744d2eab742fc24e3ef1ae",22850106,1,1,0,1098,333,334,1
"c7e89b9d04744d2eab742fc24e3ef1ae","c7e89b9d04744d2eab742fc24e3ef1ae",22850106,2,0,1,1099,334,334,0
"c7e89b9d04744d2eab742fc24e3ef1ae","fe49f8054b374a0ea4bb266ed135ff62",22850106,1,1,0,1101,334,335,1
"fe49f8054b374a0ea4bb266ed135ff62","fe49f8054b374a0ea4bb266ed135ff62",22850106,2,0,1,1102,335,335,0
"fe49f8054b374a0ea4bb266ed135ff62","d0a8f74af98642fe8360d22c42e45117",22850106,1,1,0,1104,335,336,1
"d0a8f74af98642fe8360d22c42e45117","d0a8f74af98642fe8360d22c42e45117",22850106,5,0,1,1105,336,336,0
"d0a8f74af98642fe8360d22c42e45117","0c4079457ede49e3aeb5e86ed84bdf35",22850106,1,-7,0,1110,336,329,-7
"0c4079457ede49e3aeb5e86ed84bdf35","a7c6339ca1da4368a18d471f0519f877",22850106,1,11,0,1111,329,339,10
"a7c6339ca1da4368a18d471f0519f877","a7c6339ca1da4368a18d471f0519f877",22850106,1,0,1,1112,339,339,0
"a7c6339ca1da4368a18d471f0519f877","b8b9418ab322418d9db9b40d96af873a",22850106,1,-2,0,1113,339,337,-2
"b8b9418ab322418d9db9b40d96af873a","bbc5139ca9024389a94db3a6f47dcff6",22850106,4,5,0,1114,337,341,4
"bbc5139ca9024389a94db3a6f47dcff6","bbc5139ca9024389a94db3a6f47dcff6",22850106,1,0,1,1115,341,341,0
"bbc5139ca9024389a94db3a6f47dcff6","4ee6ca9019ab4a1ab323f98094a9bd77",22850106,1,2,0,1116,341,343,2
"4ee6ca9019ab4a1ab323f98094a9bd77","4ee6ca9019ab4a1ab323f98094a9bd77",22850106,2,0,1,1117,343,343,0
"4ee6ca9019ab4a1ab323f98094a9bd77","b37947176785476f8b29d49a851366dc",22850106,1,1,0,1119,343,344,1
"b37947176785476f8b29d49a851366dc","b37947176785476f8b29d49a851366dc",22850106,2,0,1,1120,344,344,0
"b37947176785476f8b29d49a851366dc","fcea5b10d5a14a3b9324ffece8f6e1e5",22850106,1,1,0,1122,344,345,1
"fcea5b10d5a14a3b9324ffece8f6e1e5","fcea5b10d5a14a3b9324ffece8f6e1e5",22850106,2,0,1,1123,345,345,0
"fcea5b10d5a14a3b9324ffece8f6e1e5","c2490bc612d146edbe786556fab3651b",22850106,1,-5,0,1125,345,340,-5
"c2490bc612d146edbe786556fab3651b","0c4079457ede49e3aeb5e86ed84bdf35",22850106,1,-13,0,1126,340,329,-11
"0c4079457ede49e3aeb5e86ed84bdf35","b8b9418ab322418d9db9b40d96af873a",22850106,2,9,0,1129,329,337,8
"bbc5139ca9024389a94db3a6f47dcff6","c2490bc612d146edbe786556fab3651b",22850106,3,-1,0,1131,341,340,-1
"c2490bc612d146edbe786556fab3651b","6ac8bb048b854999a47edb35fe627f11",22850106,1,8,0,1132,340,347,7
"6ac8bb048b854999a47edb35fe627f11","6ac8bb048b854999a47edb35fe627f11",22850106,1,0,1,1133,347,347,0
"6ac8bb048b854999a47edb35fe627f11","0c4079457ede49e3aeb5e86ed84bdf35",22850106,1,-21,0,1134,347,329,-18
"0c4079457ede49e3aeb5e86ed84bdf35","30ead9794d4847abaf222ca966cc8630",22850106,1,24,0,1135,329,348,19
"30ead9794d4847abaf222ca966cc8630","c20993c944444fe085345591a8bd837e",22850106,1,3,0,1136,348,351,3
"c20993c944444fe085345591a8bd837e","897b7f51242c44aab2205c72fdcbf4cd",22850106,4,1,0,1137,351,352,1
"897b7f51242c44aab2205c72fdcbf4cd","09b9678ddc3d452ea4a3d46e15826065",22850106,4,1,0,1138,352,353,1
"09b9678ddc3d452ea4a3d46e15826065","eff0de7f2dbb42dfa1a2e686efab5b6d",22850106,2,1,0,1139,353,354,1
"eff0de7f2dbb42dfa1a2e686efab5b6d","c20993c944444fe085345591a8bd837e",22850106,3,-3,0,1140,354,351,-3
"c20993c944444fe085345591a8bd837e","c20993c944444fe085345591a8bd837e",22850106,5,0,1,1141,351,351,0
"897b7f51242c44aab2205c72fdcbf4cd","897b7f51242c44aab2205c72fdcbf4cd",22850106,5,0,1,1145,352,352,0
"09b9678ddc3d452ea4a3d46e15826065","09b9678ddc3d452ea4a3d46e15826065",22850106,5,0,1,1149,353,353,0
"eff0de7f2dbb42dfa1a2e686efab5b6d","eff0de7f2dbb42dfa1a2e686efab5b6d",22850106,5,0,1,1153,354,354,0
"eff0de7f2dbb42dfa1a2e686efab5b6d","2fe14166dc9642c3bc666b86a57f943d",22850106,1,4,0,1156,354,357,3
"2fe14166dc9642c3bc666b86a57f943d","30ead9794d4847abaf222ca966cc8630",22850106,2,-10,0,1157,357,348,-9
"30ead9794d4847abaf222ca966cc8630","2fe14166dc9642c3bc666b86a57f943d",22850106,3,10,0,1158,348,357,9
"2fe14166dc9642c3bc666b86a57f943d","44421dd1e13a47a388c4a19834b744c7",22850106,1,2,0,1159,357,359,2
"44421dd1e13a47a388c4a19834b744c7","44421dd1e13a47a388c4a19834b744c7",22850106,2,0,1,1160,359,359,0
"44421dd1e13a47a388c4a19834b744c7","cb5fc7ef85d547c4be1a7439d0bf6052",22850106,1,1,0,1162,359,360,1
"cb5fc7ef85d547c4be1a7439d0bf6052","cb5fc7ef85d547c4be1a7439d0bf6052",22850106,2,0,1,1163,360,360,0
"cb5fc7ef85d547c4be1a7439d0bf6052","0a8f150a4cf747acbde62f4721823da3",22850106,1,1,0,1165,360,361,1
"0a8f150a4cf747acbde62f4721823da3","0a8f150a4cf747acbde62f4721823da3",22850106,5,0,1,1166,361,361,0
"0a8f150a4cf747acbde62f4721823da3","ab8fdad974ae471f9f24c3f9dd04462e",22850106,1,1,0,1171,361,362,1
"ab8fdad974ae471f9f24c3f9dd04462e","ab8fdad974ae471f9f24c3f9dd04462e",22850106,2,0,1,1172,362,362,0
"ab8fdad974ae471f9f24c3f9dd04462e","52580888dadb4fe3baa795683ea227bd",22850106,1,3,0,1174,362,364,2
"52580888dadb4fe3baa795683ea227bd","1ba8fef685d74a8194b9db252eb704fb",22850106,1,-10,0,1175,364,355,-9
"1ba8fef685d74a8194b9db252eb704fb","52580888dadb4fe3baa795683ea227bd",22850106,3,10,0,1176,355,364,9
"52580888dadb4fe3baa795683ea227bd","f00179e251a045b39c3f7a54f9aa4acc",22850106,4,-1,0,1177,364,363,-1
"f00179e251a045b39c3f7a54f9aa4acc","492a3bc6a1254f23a7998587961b22a4",22850106,4,4,0,1178,363,366,3
"492a3bc6a1254f23a7998587961b22a4","492a3bc6a1254f23a7998587961b22a4",22850106,2,0,1,1179,366,366,0
"492a3bc6a1254f23a7998587961b22a4","072a190fd302456290895f9f04d6940a",22850106,3,-1,0,1180,366,365,-1
"072a190fd302456290895f9f04d6940a","b71bac264efb4abd97015447bd490db6",22850106,2,8,0,1181,365,370,5
"b71bac264efb4abd97015447bd490db6","b71bac264efb4abd97015447bd490db6",22850106,2,0,1,1182,370,370,0
"b71bac264efb4abd97015447bd490db6","4e51676dc72045d99c19b9fa7b22f8bc",22850106,1,-461,0,1183,370,29,-341
"4e51676dc72045d99c19b9fa7b22f8bc","4e51676dc72045d99c19b9fa7b22f8bc",22850106,7,0,1,1184,29,29,0
"4e51676dc72045d99c19b9fa7b22f8bc","51970cfa30e643e894e66ae85c8024cc",22850106,3,3,0,1186,29,31,2
"51970cfa30e643e894e66ae85c8024cc","4e51676dc72045d99c19b9fa7b22f8bc",22850106,3,-3,0,1187,31,29,-2
"4e51676dc72045d99c19b9fa7b22f8bc","c33c17be71ae4d588da7369472e5bb1b",22850106,3,9,0,1188,29,34,5
"c33c17be71ae4d588da7369472e5bb1b","b7719e26494940efa49512aedd0aac79",22850106,1,-24,0,1189,34,20,-14
"b7719e26494940efa49512aedd0aac79","a49d1bb4328949299686242fd0be5584",22850106,2,2,0,1190,20,21,1
"a49d1bb4328949299686242fd0be5584","b7719e26494940efa49512aedd0aac79",22850106,2,-2,0,1191,21,20,-1
"b7719e26494940efa49512aedd0aac79","afbf7250b99d47bea07172749483ca97",22850106,3,12,0,1192,20,28,8
"afbf7250b99d47bea07172749483ca97","afbf7250b99d47bea07172749483ca97",22850106,5,0,1,1193,28,28,0
"afbf7250b99d47bea07172749483ca97","4e51676dc72045d99c19b9fa7b22f8bc",22850106,4,3,0,1194,28,29,1
"4e51676dc72045d99c19b9fa7b22f8bc","fc0e049d56024bc9a02c9a9c435c3df7",22850106,1,21,0,1196,29,38,9
"fc0e049d56024bc9a02c9a9c435c3df7","fc0e049d56024bc9a02c9a9c435c3df7",22850106,2,0,1,1197,38,38,0
"fc0e049d56024bc9a02c9a9c435c3df7","67a089198fcb4e1c8f2385786c2b296f",22850106,2,4,0,1198,38,39,1
"67a089198fcb4e1c8f2385786c2b296f","fc0e049d56024bc9a02c9a9c435c3df7",22850106,1,-4,0,1199,39,38,-1
"67a089198fcb4e1c8f2385786c2b296f","64d48c6c9c7940639a932219a6c87198",22850106,4,1,0,1202,39,40,1
"64d48c6c9c7940639a932219a6c87198","73039f8c1eb9409cb4caee2cf968001e",22850106,1,76,0,1203,40,100,60
"73039f8c1eb9409cb4caee2cf968001e","e20db35ced8544ddac5bc3839145e463",22850106,1,-10,0,1204,100,91,-9
"e20db35ced8544ddac5bc3839145e463","00ae5f0c51874a73a41ebea838d95682",22850106,3,11,0,1205,91,101,10
"00ae5f0c51874a73a41ebea838d95682","d391c8b6e56a43a7b654e9dee02d904b",22850106,3,2,0,1206,101,103,2
"d391c8b6e56a43a7b654e9dee02d904b","139b097acfca451689d80c9c6eebdf7b",22850106,1,100,0,1207,103,178,75
"139b097acfca451689d80c9c6eebdf7b","0c7262dff33c4087bc660ccf40f92f9c",22850106,2,-11,0,1208,178,169,-9
"0c7262dff33c4087bc660ccf40f92f9c","ea38cc0e6e6e41edbabf210220808bf9",22850106,2,12,0,1209,169,179,10
"ea38cc0e6e6e41edbabf210220808bf9","b87c552dd247427abe6ab5795b9c9d43",22850106,5,2,0,1210,179,181,2
"b87c552dd247427abe6ab5795b9c9d43","ea38cc0e6e6e41edbabf210220808bf9",22850106,3,-2,0,1211,181,179,-2
"ea38cc0e6e6e41edbabf210220808bf9","139b097acfca451689d80c9c6eebdf7b",22850106,2,-1,0,1212,179,178,-1
"139b097acfca451689d80c9c6eebdf7b","2024b4885bd14338a39b7b509acbbd02",22850106,2,5,0,1213,178,182,4
"2024b4885bd14338a39b7b509acbbd02","a875096404ef4a9984b62d74cda916f9",22850106,1,37,0,1214,182,209,27
"a875096404ef4a9984b62d74cda916f9","d7f13c8d63ec4e2aa673fbb9cf9c6933",22850106,1,-4,0,1215,209,206,-3
"d7f13c8d63ec4e2aa673fbb9cf9c6933","09400e101c5d4b439cf9a26b03aae558",22850106,4,5,0,1216,206,210,4
"09400e101c5d4b439cf9a26b03aae558","09400e101c5d4b439cf9a26b03aae558",22850106,2,0,1,1217,210,210,0
"09400e101c5d4b439cf9a26b03aae558","a875096404ef4a9984b62d74cda916f9",22850106,2,-1,0,1218,210,209,-1
"a875096404ef4a9984b62d74cda916f9","be502a7a43c44bf7b682698de79d9369",22850106,2,6,0,1219,209,214,5
"be502a7a43c44bf7b682698de79d9369","f7fb1952f56b4189b86a9f8b7862d2b8",22850106,3,1,0,1220,214,215,1
"f7fb1952f56b4189b86a9f8b7862d2b8","be502a7a43c44bf7b682698de79d9369",22850106,3,-1,0,1221,215,214,-1
"be502a7a43c44bf7b682698de79d9369","ec341f459285443b8361f7f15638ff08",22850106,2,-1,0,1222,214,213,-1
"ec341f459285443b8361f7f15638ff08","363837c182e04711840d896ae1e0339c",22850106,3,6,0,1223,213,218,5
"363837c182e04711840d896ae1e0339c","01b2051f8941460d89945e3b02d1ce78",22850106,4,-1,0,1224,218,217,-1
"01b2051f8941460d89945e3b02d1ce78","d7f13c8d63ec4e2aa673fbb9cf9c6933",22850106,2,-14,0,1225,217,206,-11
"d7f13c8d63ec4e2aa673fbb9cf9c6933","01b2051f8941460d89945e3b02d1ce78",22850106,1,14,0,1226,206,217,11
"01b2051f8941460d89945e3b02d1ce78","363837c182e04711840d896ae1e0339c",22850106,2,1,0,1227,217,218,1
"01b2051f8941460d89945e3b02d1ce78","91125ca626c5470eb145501f8c37f8db",22850106,1,4,0,1229,217,220,3
"91125ca626c5470eb145501f8c37f8db","91125ca626c5470eb145501f8c37f8db",22850106,1,0,1,1230,220,220,0
"91125ca626c5470eb145501f8c37f8db","1c6721b1f63f4d30ba7746ea8af02a52",22850106,1,3,0,1231,220,221,1
"1c6721b1f63f4d30ba7746ea8af02a52","d7f13c8d63ec4e2aa673fbb9cf9c6933",22850106,3,-21,0,1232,221,206,-15
"d7f13c8d63ec4e2aa673fbb9cf9c6933","77ecef8eff6b4a2caea7707669bf7475",22850106,2,22,0,1233,206,222,16
"77ecef8eff6b4a2caea7707669bf7475","fab84b4fab5940efb4ea868ef8d09396",22850106,1,82,0,1234,222,284,62
"fab84b4fab5940efb4ea868ef8d09396","fab84b4fab5940efb4ea868ef8d09396",22850106,1,0,1,1235,284,284,0
"fab84b4fab5940efb4ea868ef8d09396","a9ac840f098c4bd0a2ee896214ce29cd",22850106,1,-157,0,1236,284,168,-116
"a9ac840f098c4bd0a2ee896214ce29cd","a9ac840f098c4bd0a2ee896214ce29cd",22850106,1,0,1,1237,168,168,0
"a9ac840f098c4bd0a2ee896214ce29cd","1c6721b1f63f4d30ba7746ea8af02a52",22850106,1,74,0,1238,168,221,53
"1c6721b1f63f4d30ba7746ea8af02a52","77ecef8eff6b4a2caea7707669bf7475",22850106,2,1,0,1239,221,222,1
"77ecef8eff6b4a2caea7707669bf7475","d03cb855c70044cf8c35d9ec0de696e3",22850106,1,3,0,1240,222,224,2
"d03cb855c70044cf8c35d9ec0de696e3","1c6721b1f63f4d30ba7746ea8af02a52",22850106,1,-4,0,1241,224,221,-3
"1c6721b1f63f4d30ba7746ea8af02a52","8b9ae98743bd4d4a8a87dff1c1244211",22850106,2,7,0,1242,221,227,6
"8b9ae98743bd4d4a8a87dff1c1244211","a49a937d6896486d9a5396654abcf2e1",22850106,1,-1,0,1243,227,226,-1
"a49a937d6896486d9a5396654abcf2e1","a49a937d6896486d9a5396654abcf2e1",22850106,2,0,1,1244,226,226,0
"a49a937d6896486d9a5396654abcf2e1","8b9ae98743bd4d4a8a87dff1c1244211",22850106,2,1,0,1245,226,227,1
"8b9ae98743bd4d4a8a87dff1c1244211","8b9ae98743bd4d4a8a87dff1c1244211",22850106,50,0,1,1246,227,227,0
"8b9ae98743bd4d4a8a87dff1c1244211","2ab1535aac1346ba8801535bf729ef37",22850106,1,3,0,1255,227,229,2
"2ab1535aac1346ba8801535bf729ef37","f7906d6f59b9489a91d2ef40db5a474d",22850106,2,-7,0,1256,229,223,-6
"f7906d6f59b9489a91d2ef40db5a474d","2ab1535aac1346ba8801535bf729ef37",22850106,2,7,0,1257,223,229,6
"2ab1535aac1346ba8801535bf729ef37","a4f40fb48a8542c8949bae1f002cd9bc",22850106,1,2,0,1258,229,231,2
"a4f40fb48a8542c8949bae1f002cd9bc","a4f40fb48a8542c8949bae1f002cd9bc",22850106,2,0,1,1259,231,231,0
"a4f40fb48a8542c8949bae1f002cd9bc","8972c23e32044edb8a78fa1eed4e5947",22850106,1,1,0,1261,231,232,1
"8972c23e32044edb8a78fa1eed4e5947","8972c23e32044edb8a78fa1eed4e5947",22850106,1,0,1,1262,232,232,0
"8972c23e32044edb8a78fa1eed4e5947","92feb4a40f8344d38b6f722e42a53295",22850106,1,1,0,1263,232,233,1
"92feb4a40f8344d38b6f722e42a53295","92feb4a40f8344d38b6f722e42a53295",22850106,2,0,1,1264,233,233,0
"92feb4a40f8344d38b6f722e42a53295","5152833676bf4c6cb317060be10f68db",22850106,1,-5,0,1266,233,228,-5
"5152833676bf4c6cb317060be10f68db","ca3e28f290354c08aefe5b0f769604e6",22850106,1,8,0,1267,228,235,7
"ca3e28f290354c08aefe5b0f769604e6","ca3e28f290354c08aefe5b0f769604e6",22850106,4,0,1,1268,235,235,0
"ca3e28f290354c08aefe5b0f769604e6","79a35eea833e4c2c9d22fc53c3c6445c",22850106,1,1,0,1272,235,236,1
"79a35eea833e4c2c9d22fc53c3c6445c","79a35eea833e4c2c9d22fc53c3c6445c",22850106,4,0,1,1273,236,236,0
"79a35eea833e4c2c9d22fc53c3c6445c","8f68228b1518449e9615cdafee41a2bd",22850106,1,1,0,1277,236,237,1
"8f68228b1518449e9615cdafee41a2bd","8f68228b1518449e9615cdafee41a2bd",22850106,1,0,1,1278,237,237,0
"8f68228b1518449e9615cdafee41a2bd","cab89fa5c3ed45a5aa550fc0352d6a42",22850106,1,1,0,1279,237,238,1
"cab89fa5c3ed45a5aa550fc0352d6a42","cab89fa5c3ed45a5aa550fc0352d6a42",22850106,1,0,1,1280,238,238,0
"cab89fa5c3ed45a5aa550fc0352d6a42","0c7262dff33c4087bc660ccf40f92f9c",22850106,1,-90,0,1281,238,169,-69
"0c7262dff33c4087bc660ccf40f92f9c","cf4c280bad6a43e6b131d8385ef9ef3f",22850106,1,19,0,1282,169,184,15
"cf4c280bad6a43e6b131d8385ef9ef3f","4a29443515bb404cb8924e1c60a63b73",22850106,1,138,0,1283,184,285,101
"4a29443515bb404cb8924e1c60a63b73","2c5bb2cbd0014420ad8c95d40e38efd1",22850106,2,23,0,1284,285,303,18
"2c5bb2cbd0014420ad8c95d40e38efd1","ba0e59461bfb4a44b7b1c28a01f8d3b3",22850106,1,-5,0,1285,303,299,-4
"ba0e59461bfb4a44b7b1c28a01f8d3b3","7646a919d7e64fa990bca9b024ff089d",22850106,2,-1,0,1286,299,298,-1
"2c5bb2cbd0014420ad8c95d40e38efd1","e390b575229748ea8aac9364efe2bf00",22850106,1,1,0,1290,303,304,1
"e390b575229748ea8aac9364efe2bf00","e390b575229748ea8aac9364efe2bf00",22850106,1,0,1,1291,304,304,0
"e390b575229748ea8aac9364efe2bf00","3434c10e561d488a914e0f7d71907abd",22850106,1,3,0,1292,304,305,1
"3434c10e561d488a914e0f7d71907abd","4a29443515bb404cb8924e1c60a63b73",22850106,1,-27,0,1293,305,285,-20
"4a29443515bb404cb8924e1c60a63b73","53e7e900392747ccad52e711ab0f80d8",22850106,1,29,0,1294,285,307,22
"53e7e900392747ccad52e711ab0f80d8","d7f13c8d63ec4e2aa673fbb9cf9c6933",22850106,1,-137,0,1295,307,206,-101
"d7f13c8d63ec4e2aa673fbb9cf9c6933","be95c065e45447c1bd8215ea6f130c7a",22850106,1,17,0,1296,206,219,13
"be95c065e45447c1bd8215ea6f130c7a","363837c182e04711840d896ae1e0339c",22850106,1,-2,0,1297,219,218,-1
"363837c182e04711840d896ae1e0339c","be502a7a43c44bf7b682698de79d9369",22850106,1,-5,0,1298,218,214,-4
"be502a7a43c44bf7b682698de79d9369","01b2051f8941460d89945e3b02d1ce78",22850106,1,4,0,1299,214,217,3
"01b2051f8941460d89945e3b02d1ce78","f7fb1952f56b4189b86a9f8b7862d2b8",22850106,1,-3,0,1300,217,215,-2
"f7fb1952f56b4189b86a9f8b7862d2b8","ec341f459285443b8361f7f15638ff08",22850106,1,-2,0,1301,215,213,-2
"ec341f459285443b8361f7f15638ff08","09400e101c5d4b439cf9a26b03aae558",22850106,1,-4,0,1302,213,210,-3
"a875096404ef4a9984b62d74cda916f9","b9e80f77c3a44349863b19875725c384",22850106,1,-3,0,1304,209,207,-2
"b9e80f77c3a44349863b19875725c384","7108f0e4c2584f1f9c471689ae4c885c",22850106,5,1,0,1305,207,208,1
"7108f0e4c2584f1f9c471689ae4c885c","7108f0e4c2584f1f9c471689ae4c885c",22850106,46,0,1,1306,208,208,0
"7108f0e4c2584f1f9c471689ae4c885c","d7f13c8d63ec4e2aa673fbb9cf9c6933",22850106,4,-2,0,1327,208,206,-2
"d7f13c8d63ec4e2aa673fbb9cf9c6933","b9e80f77c3a44349863b19875725c384",22850106,2,1,0,1328,206,207,1
"09400e101c5d4b439cf9a26b03aae558","b534b89233134e30a9b5645138bfa9ee",22850106,1,-219,0,1337,210,41,-169
"b534b89233134e30a9b5645138bfa9ee","1c6721b1f63f4d30ba7746ea8af02a52",22850106,1,235,0,1338,41,221,180
"1c6721b1f63f4d30ba7746ea8af02a52","66d4fad4f1cf4b46be0750a99ad7a35a",22850106,1,21,0,1339,221,239,18
"66d4fad4f1cf4b46be0750a99ad7a35a","66d4fad4f1cf4b46be0750a99ad7a35a",22850106,1,0,1,1340,239,239,0
"66d4fad4f1cf4b46be0750a99ad7a35a","3434c10e561d488a914e0f7d71907abd",22850106,1,93,0,1341,239,305,66
"141c0df6cd1946539aadd1c9b7068cd4","86c27d40179e419c8e9d150fb6afa5d0",22850106,2,13,0,1346,308,319,11
"0c787d16c9504873b1a4d903cec09948","47edbb64109243e6b0f8f64cdef90c6c",22850106,1,14,0,1348,314,326,12
"47edbb64109243e6b0f8f64cdef90c6c","8d7e0b55cf9849cda222a0f2440cec55",22850106,2,-9,0,1349,326,318,-8
"3628bdce1dd2429ba924d2d4d09448d2","1c6721b1f63f4d30ba7746ea8af02a52",22850106,1,-135,0,1352,322,221,-101
"1c6721b1f63f4d30ba7746ea8af02a52","0b04c8e2f86d48c7aeb7e225819cd32b",22850106,1,16,0,1353,221,234,13
"0b04c8e2f86d48c7aeb7e225819cd32b","2ae94c0cea4d480a9d5dca8fb1d7b542",22850106,1,11,0,1354,234,242,8
"2ae94c0cea4d480a9d5dca8fb1d7b542","1c6721b1f63f4d30ba7746ea8af02a52",22850106,2,-27,0,1355,242,221,-21
"1c6721b1f63f4d30ba7746ea8af02a52","1ebf23f9d994469a85206e4c7b1bf5f5",22850106,2,30,0,1356,221,245,24
"1ebf23f9d994469a85206e4c7b1bf5f5","2ae94c0cea4d480a9d5dca8fb1d7b542",22850106,2,-3,0,1357,245,242,-3
"2ae94c0cea4d480a9d5dca8fb1d7b542","30c9ba177afc49a695625d2bdec40207",22850106,1,9,0,1358,242,250,8
"30c9ba177afc49a695625d2bdec40207","30c9ba177afc49a695625d2bdec40207",22850106,2,0,1,1359,250,250,0
"30c9ba177afc49a695625d2bdec40207","6e83e23f56544a19b94067c1c558d9c0",22850106,1,-3,0,1361,250,247,-3
"6e83e23f56544a19b94067c1c558d9c0","00f61990949545828dd12f1303d47504",22850106,2,11,0,1362,247,256,9
"00f61990949545828dd12f1303d47504","7aa76d3e993840d8805f097cbdbcd44b",22850106,1,6,0,1363,256,261,5
"7aa76d3e993840d8805f097cbdbcd44b","2ae94c0cea4d480a9d5dca8fb1d7b542",22850106,3,-23,0,1364,261,242,-19
"2ae94c0cea4d480a9d5dca8fb1d7b542","7aa76d3e993840d8805f097cbdbcd44b",22850106,1,23,0,1365,242,261,19
"2ae94c0cea4d480a9d5dca8fb1d7b542","0d987bed3ffa4ed0b9a2e62e97b7b30f",22850106,4,38,0,1367,242,272,30
"0d987bed3ffa4ed0b9a2e62e97b7b30f","2ae94c0cea4d480a9d5dca8fb1d7b542",22850106,2,-38,0,1368,272,242,-30
"2ae94c0cea4d480a9d5dca8fb1d7b542","2ae94c0cea4d480a9d5dca8fb1d7b542",22850106,2,0,1,1369,242,242,0
"0d987bed3ffa4ed0b9a2e62e97b7b30f","0d987bed3ffa4ed0b9a2e62e97b7b30f",22850106,5,0,1,1371,272,272,0
"2ae94c0cea4d480a9d5dca8fb1d7b542","7028800abe7d4e27b613d1d6cbe26bf7",22850106,1,30,0,1373,242,267,25
"7028800abe7d4e27b613d1d6cbe26bf7","7aa76d3e993840d8805f097cbdbcd44b",22850106,1,-7,0,1374,267,261,-6
"7aa76d3e993840d8805f097cbdbcd44b","d989ebcfc12a4b669f0100dc1aa14f1e",22850106,1,-7,0,1375,261,255,-6
"d989ebcfc12a4b669f0100dc1aa14f1e","00f61990949545828dd12f1303d47504",22850106,1,1,0,1376,255,256,1
"00f61990949545828dd12f1303d47504","ead7bb4b64e247d2ae632ab8a296b091",22850106,1,2,0,1377,256,258,2
"ead7bb4b64e247d2ae632ab8a296b091","ead7bb4b64e247d2ae632ab8a296b091",22850106,2,0,1,1378,258,258,0
"ead7bb4b64e247d2ae632ab8a296b091","41b0048dde734bb280bac6116baa8e27",22850106,1,1,0,1380,258,259,1
"41b0048dde734bb280bac6116baa8e27","41b0048dde734bb280bac6116baa8e27",22850106,2,0,1,1381,259,259,0
"41b0048dde734bb280bac6116baa8e27","b41c5a094a604ee0915327da5cc0beb7",22850106,1,1,0,1383,259,260,1
"b41c5a094a604ee0915327da5cc0beb7","b41c5a094a604ee0915327da5cc0beb7",22850106,2,0,1,1384,260,260,0
"b41c5a094a604ee0915327da5cc0beb7","d546341988904f069cfa86b21457d9d9",22850106,1,-10,0,1386,260,251,-9
"d546341988904f069cfa86b21457d9d9","00f61990949545828dd12f1303d47504",22850106,1,6,0,1387,251,256,5
"00f61990949545828dd12f1303d47504","d989ebcfc12a4b669f0100dc1aa14f1e",22850106,1,-1,0,1388,256,255,-1
"d989ebcfc12a4b669f0100dc1aa14f1e","d546341988904f069cfa86b21457d9d9",22850106,1,-5,0,1389,255,251,-4
"d546341988904f069cfa86b21457d9d9","1ebf23f9d994469a85206e4c7b1bf5f5",22850106,1,-8,0,1390,251,245,-6
"1ebf23f9d994469a85206e4c7b1bf5f5","6e83e23f56544a19b94067c1c558d9c0",22850106,1,3,0,1391,245,247,2
"6e83e23f56544a19b94067c1c558d9c0","1c6721b1f63f4d30ba7746ea8af02a52",22850106,1,-33,0,1392,247,221,-26
"1c6721b1f63f4d30ba7746ea8af02a52","2ae94c0cea4d480a9d5dca8fb1d7b542",22850106,2,27,0,1393,221,242,21
"2ae94c0cea4d480a9d5dca8fb1d7b542","64dbedb3ce544f6aae8e10e0cf10f16d",22850106,1,-4,0,1394,242,240,-2
"64dbedb3ce544f6aae8e10e0cf10f16d","2ab1535aac1346ba8801535bf729ef37",22850106,1,-13,0,1395,240,229,-11
"2ab1535aac1346ba8801535bf729ef37","0b04c8e2f86d48c7aeb7e225819cd32b",22850106,1,6,0,1396,229,234,5
"0b04c8e2f86d48c7aeb7e225819cd32b","5152833676bf4c6cb317060be10f68db",22850106,1,-7,0,1397,234,228,-6
"5152833676bf4c6cb317060be10f68db","8b9ae98743bd4d4a8a87dff1c1244211",22850106,1,-2,0,1398,228,227,-1
"8b9ae98743bd4d4a8a87dff1c1244211","d03cb855c70044cf8c35d9ec0de696e3",22850106,2,-3,0,1399,227,224,-3
"d03cb855c70044cf8c35d9ec0de696e3","f7906d6f59b9489a91d2ef40db5a474d",22850106,1,-1,0,1400,224,223,-1
"f7906d6f59b9489a91d2ef40db5a474d","77ecef8eff6b4a2caea7707669bf7475",22850106,1,-2,0,1401,223,222,-1
"77ecef8eff6b4a2caea7707669bf7475","1c6721b1f63f4d30ba7746ea8af02a52",22850106,2,-1,0,1402,222,221,-1
"d7f13c8d63ec4e2aa673fbb9cf9c6933","3434c10e561d488a914e0f7d71907abd",22850106,1,135,0,1404,206,305,99
"3434c10e561d488a914e0f7d71907abd","56b3fd1a212a4764be39d979fde3326e",22850106,1,28,0,1405,305,328,23
"56b3fd1a212a4764be39d979fde3326e","56b3fd1a212a4764be39d979fde3326e",22850106,1,0,1,1406,328,328,0
"56b3fd1a212a4764be39d979fde3326e","3434c10e561d488a914e0f7d71907abd",22850106,1,-28,0,1407,328,305,-23
"3434c10e561d488a914e0f7d71907abd","0c4079457ede49e3aeb5e86ed84bdf35",22850106,3,31,0,1408,305,329,24
"38aea304b4fa46e1b29bb72f5cea4c93","30ead9794d4847abaf222ca966cc8630",22850106,1,22,0,1410,331,348,17
"30ead9794d4847abaf222ca966cc8630","3434c10e561d488a914e0f7d71907abd",22850106,1,-55,0,1411,348,305,-43
"3434c10e561d488a914e0f7d71907abd","3434c10e561d488a914e0f7d71907abd",22850106,1,0,1,1412,305,305,0
"c2490bc612d146edbe786556fab3651b","30ead9794d4847abaf222ca966cc8630",22850106,2,11,0,1419,340,348,8
"30ead9794d4847abaf222ca966cc8630","0c4079457ede49e3aeb5e86ed84bdf35",22850106,2,-24,0,1420,348,329,-19
"0c4079457ede49e3aeb5e86ed84bdf35","eff0de7f2dbb42dfa1a2e686efab5b6d",22850106,2,30,0,1421,329,354,25
"09b9678ddc3d452ea4a3d46e15826065","897b7f51242c44aab2205c72fdcbf4cd",22850106,2,-1,0,1425,353,352,-1
"897b7f51242c44aab2205c72fdcbf4cd","c20993c944444fe085345591a8bd837e",22850106,2,-1,0,1427,352,351,-1
"c20993c944444fe085345591a8bd837e","eff0de7f2dbb42dfa1a2e686efab5b6d",22850106,2,3,0,1429,351,354,3
"eff0de7f2dbb42dfa1a2e686efab5b6d","09b9678ddc3d452ea4a3d46e15826065",22850106,2,-1,0,1431,354,353,-1
"09b9678ddc3d452ea4a3d46e15826065","30ead9794d4847abaf222ca966cc8630",22850106,1,-5,0,1433,353,348,-5
"2fe14166dc9642c3bc666b86a57f943d","1ba8fef685d74a8194b9db252eb704fb",22850106,2,-2,0,1435,357,355,-2
"072a190fd302456290895f9f04d6940a","cfa457d1743848e4bb5e4beced6448ed",22850106,1,5,0,1440,365,369,4
"cfa457d1743848e4bb5e4beced6448ed","cfa457d1743848e4bb5e4beced6448ed",22850106,1,0,1,1441,369,369,0
"cfa457d1743848e4bb5e4beced6448ed","0c7262dff33c4087bc660ccf40f92f9c",22850106,1,-264,0,1442,369,169,-200
"0c7262dff33c4087bc660ccf40f92f9c","2024b4885bd14338a39b7b509acbbd02",22850106,1,16,0,1443,169,182,13
"2024b4885bd14338a39b7b509acbbd02","0c7262dff33c4087bc660ccf40f92f9c",22850106,2,-16,0,1444,182,169,-13
"0c7262dff33c4087bc660ccf40f92f9c","c8e371568a0c4391b25796ae4e91952e",22850106,2,23,0,1445,169,186,17
"c8e371568a0c4391b25796ae4e91952e","30ead9794d4847abaf222ca966cc8630",22850106,1,216,0,1446,186,348,162
"30ead9794d4847abaf222ca966cc8630","b71bac264efb4abd97015447bd490db6",22850106,1,28,0,1447,348,370,22
"b71bac264efb4abd97015447bd490db6","30ead9794d4847abaf222ca966cc8630",22850106,2,-28,0,1448,370,348,-22
"30ead9794d4847abaf222ca966cc8630","8d448d625b024c82a5eb240bbd7431d6",22850106,2,33,0,1449,348,374,26
"8d448d625b024c82a5eb240bbd7431d6","b71bac264efb4abd97015447bd490db6",22850106,5,-5,0,1450,374,370,-4
"b71bac264efb4abd97015447bd490db6","8d448d625b024c82a5eb240bbd7431d6",22850106,4,5,0,1451,370,374,4
"8d448d625b024c82a5eb240bbd7431d6","8d448d625b024c82a5eb240bbd7431d6",22850106,71,0,1,1452,374,374,0
"b71bac264efb4abd97015447bd490db6","d6d02b6ef04e4f17805504500b8ce441",22850106,2,8,0,1523,370,375,5
"d6d02b6ef04e4f17805504500b8ce441","d6d02b6ef04e4f17805504500b8ce441",22850106,1,0,1,1524,375,375,0
"d6d02b6ef04e4f17805504500b8ce441","66baf19b6b904b70922329068c63746d",22850106,2,4,0,1525,375,376,1
"66baf19b6b904b70922329068c63746d","66baf19b6b904b70922329068c63746d",22850106,2,0,1,1526,376,376,0
"66baf19b6b904b70922329068c63746d","7f544639412e40a9ba27f43b415362ab",22850106,2,2,0,1527,376,378,2
"7f544639412e40a9ba27f43b415362ab","7f544639412e40a9ba27f43b415362ab",22850106,2,0,1,1528,378,378,0
"7f544639412e40a9ba27f43b415362ab","d5ae8642e15b46b8bd298b02274d4e9c",22850106,1,2,0,1529,378,380,2
"d5ae8642e15b46b8bd298b02274d4e9c","d5ae8642e15b46b8bd298b02274d4e9c",22850106,5,0,1,1530,380,380,0
"d5ae8642e15b46b8bd298b02274d4e9c","a0d10309a2dd456289147f84be9d37f9",22850106,1,1,0,1535,380,381,1
"a0d10309a2dd456289147f84be9d37f9","a0d10309a2dd456289147f84be9d37f9",22850106,2,0,1,1536,381,381,0
"a0d10309a2dd456289147f84be9d37f9","0fcbc3ca07b144138b8d85da581f09a8",22850106,1,1,0,1538,381,382,1
"0fcbc3ca07b144138b8d85da581f09a8","0fcbc3ca07b144138b8d85da581f09a8",22850106,5,0,1,1539,382,382,0
"0fcbc3ca07b144138b8d85da581f09a8","66baf19b6b904b70922329068c63746d",22850106,1,-6,0,1544,382,376,-6
"66baf19b6b904b70922329068c63746d","4890121ce5d74576b4632b77cfc23398",22850106,3,14,0,1545,376,388,12
"4890121ce5d74576b4632b77cfc23398","c2fca3669923477ab966ded303dea31c",22850106,1,-6,0,1546,388,383,-5
"c2fca3669923477ab966ded303dea31c","4890121ce5d74576b4632b77cfc23398",22850106,2,6,0,1547,383,388,5
"4890121ce5d74576b4632b77cfc23398","66baf19b6b904b70922329068c63746d",22850106,1,-14,0,1548,388,376,-12
"4890121ce5d74576b4632b77cfc23398","4890121ce5d74576b4632b77cfc23398",22850106,2,0,1,1550,388,388,0
"4890121ce5d74576b4632b77cfc23398","18d3b836dd804224883cc9180b60a8e1",22850106,2,-1,0,1551,388,387,-1
"18d3b836dd804224883cc9180b60a8e1","96bb2b3e85a34d8b9544514e89f6fe97",22850106,3,4,0,1552,387,390,3
"96bb2b3e85a34d8b9544514e89f6fe97","96bb2b3e85a34d8b9544514e89f6fe97",22850106,2,0,1,1553,390,390,0
"96bb2b3e85a34d8b9544514e89f6fe97","17f95d18bab743888e1736033dc3384d",22850106,2,-1,0,1554,390,389,-1
"17f95d18bab743888e1736033dc3384d","4890121ce5d74576b4632b77cfc23398",22850106,1,-2,0,1555,389,388,-1
"4890121ce5d74576b4632b77cfc23398","96bb2b3e85a34d8b9544514e89f6fe97",22850106,2,3,0,1556,388,390,2
"96bb2b3e85a34d8b9544514e89f6fe97","18d3b836dd804224883cc9180b60a8e1",22850106,2,-4,0,1557,390,387,-3
"96bb2b3e85a34d8b9544514e89f6fe97","ac4e9b54acfe4670b4634859c7263cb5",22850106,1,2,0,1559,390,392,2
"ac4e9b54acfe4670b4634859c7263cb5","ac4e9b54acfe4670b4634859c7263cb5",22850106,2,0,1,1560,392,392,0
"ac4e9b54acfe4670b4634859c7263cb5","66baf19b6b904b70922329068c63746d",22850106,1,-19,0,1561,392,376,-16
"18d3b836dd804224883cc9180b60a8e1","ac4e9b54acfe4670b4634859c7263cb5",22850106,1,6,0,1565,387,392,5
"ac4e9b54acfe4670b4634859c7263cb5","17f95d18bab743888e1736033dc3384d",22850106,1,-3,0,1567,392,389,-3
"17f95d18bab743888e1736033dc3384d","6f8881a745ac4c358a68b92c3b4abe81",22850106,2,6,0,1568,389,394,5
"6f8881a745ac4c358a68b92c3b4abe81","6f8881a745ac4c358a68b92c3b4abe81",22850106,2,0,1,1569,394,394,0
"6f8881a745ac4c358a68b92c3b4abe81","f7002c8484354eceac57bc7bd62c76c1",22850106,2,-1,0,1570,394,393,-1
"f7002c8484354eceac57bc7bd62c76c1","0c12af0a4e7f4002852cf84b2537c161",22850106,2,3,0,1571,393,395,2
"0c12af0a4e7f4002852cf84b2537c161","66baf19b6b904b70922329068c63746d",22850106,3,-24,0,1572,395,376,-19
"66baf19b6b904b70922329068c63746d","44a277ea44dc4ae689fab4b82f0b4098",22850106,1,26,0,1573,376,397,21
"44a277ea44dc4ae689fab4b82f0b4098","44a277ea44dc4ae689fab4b82f0b4098",22850106,1,0,1,1574,397,397,0
"44a277ea44dc4ae689fab4b82f0b4098","0c12af0a4e7f4002852cf84b2537c161",22850106,1,-2,0,1575,397,395,-2
"66baf19b6b904b70922329068c63746d","859e0b8d71694b12befb69ee698138f9",22850106,1,29,0,1577,376,399,23
"859e0b8d71694b12befb69ee698138f9","859e0b8d71694b12befb69ee698138f9",22850106,1,0,1,1578,399,399,0
"859e0b8d71694b12befb69ee698138f9","66baf19b6b904b70922329068c63746d",22850106,1,-29,0,1579,399,376,-23
"66baf19b6b904b70922329068c63746d","2b09a08242b54983aec7063990fb3f66",22850106,2,32,0,1580,376,400,24
"2b09a08242b54983aec7063990fb3f66","2b09a08242b54983aec7063990fb3f66",22850106,5,0,1,1581,400,400,0
"2b09a08242b54983aec7063990fb3f66","1f471b7a883a4df48211e8c6a81b59a7",22850106,1,1,0,1583,400,401,1
"1f471b7a883a4df48211e8c6a81b59a7","1f471b7a883a4df48211e8c6a81b59a7",22850106,1,0,1,1584,401,401,0
"1f471b7a883a4df48211e8c6a81b59a7","2b09a08242b54983aec7063990fb3f66",22850106,1,-1,0,1585,401,400,-1
"2b09a08242b54983aec7063990fb3f66","9de0d567bfa84fe5b77cb76f4a76a5d1",22850106,1,5,0,1586,400,404,4
"9de0d567bfa84fe5b77cb76f4a76a5d1","9de0d567bfa84fe5b77cb76f4a76a5d1",22850106,1,0,1,1587,404,404,0
"9de0d567bfa84fe5b77cb76f4a76a5d1","1157bd665ec4472fb58b751dc5099355",22850106,1,-1,0,1588,404,403,-1
"1157bd665ec4472fb58b751dc5099355","3c8a22d2f9c146ea956609e3ed4f2559",22850106,2,3,0,1589,403,405,2
"3c8a22d2f9c146ea956609e3ed4f2559","58fc9094275e4c49be3f4ba6d4acc0a4",22850106,2,2,0,1590,405,406,1
"58fc9094275e4c49be3f4ba6d4acc0a4","2b09a08242b54983aec7063990fb3f66",22850106,1,-9,0,1591,406,400,-6
"2b09a08242b54983aec7063990fb3f66","58fc9094275e4c49be3f4ba6d4acc0a4",22850106,1,9,0,1592,400,406,6
"58fc9094275e4c49be3f4ba6d4acc0a4","58fc9094275e4c49be3f4ba6d4acc0a4",22850106,3,0,1,1593,406,406,0
"58fc9094275e4c49be3f4ba6d4acc0a4","02b3a1bead9244c1ba2f857c7da8f82a",22850106,2,3,0,1594,406,408,2
"02b3a1bead9244c1ba2f857c7da8f82a","02b3a1bead9244c1ba2f857c7da8f82a",22850106,5,0,1,1595,408,408,0
"02b3a1bead9244c1ba2f857c7da8f82a","6206fc6479014bb193084c32409dc1b9",22850106,1,1,0,1598,408,409,1
"6206fc6479014bb193084c32409dc1b9","6206fc6479014bb193084c32409dc1b9",22850106,7,0,1,1599,409,409,0
"6206fc6479014bb193084c32409dc1b9","02b3a1bead9244c1ba2f857c7da8f82a",22850106,1,-1,0,1606,409,408,-1
"02b3a1bead9244c1ba2f857c7da8f82a","6a5f020451db426dacba9e2ea3fcc62a",22850106,2,3,0,1607,408,410,2
"6a5f020451db426dacba9e2ea3fcc62a","6a5f020451db426dacba9e2ea3fcc62a",22850106,7,0,1,1608,410,410,0
"6a5f020451db426dacba9e2ea3fcc62a","33a9d248b2e44588a5b07fc1342b9bc2",22850106,2,2,0,1613,410,411,1
"33a9d248b2e44588a5b07fc1342b9bc2","33a9d248b2e44588a5b07fc1342b9bc2",22850106,3,0,1,1614,411,411,0
"33a9d248b2e44588a5b07fc1342b9bc2","c6f26bd420634f1cb7989e76fe6b16c0",22850106,1,1,0,1615,411,412,1
"c6f26bd420634f1cb7989e76fe6b16c0","c6f26bd420634f1cb7989e76fe6b16c0",22850106,5,0,1,1616,412,412,0
"c6f26bd420634f1cb7989e76fe6b16c0","2a65ee6e2ac64f6a8a55fbe5373ec763",22850106,1,1,0,1621,412,413,1
"2a65ee6e2ac64f6a8a55fbe5373ec763","2a65ee6e2ac64f6a8a55fbe5373ec763",22850106,2,0,1,1622,413,413,0
"2a65ee6e2ac64f6a8a55fbe5373ec763","33a9d248b2e44588a5b07fc1342b9bc2",22850106,1,-2,0,1624,413,411,-2
"33a9d248b2e44588a5b07fc1342b9bc2","687055dad9fc40c3982478fe33ec01bf",22850106,2,4,0,1625,411,414,3
"687055dad9fc40c3982478fe33ec01bf","2b09a08242b54983aec7063990fb3f66",22850106,3,-21,0,1626,414,400,-14
"2b09a08242b54983aec7063990fb3f66","687055dad9fc40c3982478fe33ec01bf",22850106,2,21,0,1627,400,414,14
"687055dad9fc40c3982478fe33ec01bf","33a9d248b2e44588a5b07fc1342b9bc2",22850106,1,-4,0,1628,414,411,-3
"33a9d248b2e44588a5b07fc1342b9bc2","2b09a08242b54983aec7063990fb3f66",22850106,1,-17,0,1629,411,400,-11
"2b09a08242b54983aec7063990fb3f66","1fd0f6dadbc14ebc965faf6122190b96",22850106,1,22,0,1630,400,415,15
"1fd0f6dadbc14ebc965faf6122190b96","1fd0f6dadbc14ebc965faf6122190b96",22850106,1,0,1,1631,415,415,0
"1fd0f6dadbc14ebc965faf6122190b96","687055dad9fc40c3982478fe33ec01bf",22850106,1,-1,0,1632,415,414,-1
"687055dad9fc40c3982478fe33ec01bf","2add1669f08d4101913db15f8c23b3b7",22850106,1,3,0,1635,414,416,2
"2add1669f08d4101913db15f8c23b3b7","2add1669f08d4101913db15f8c23b3b7",22850106,1,0,1,1636,416,416,0
"2add1669f08d4101913db15f8c23b3b7","2b09a08242b54983aec7063990fb3f66",22850106,1,-24,0,1637,416,400,-16
"2b09a08242b54983aec7063990fb3f66","a2b4bd40cee2481ebd3fc179d6a5cd62",22850106,2,27,0,1638,400,417,17
"a2b4bd40cee2481ebd3fc179d6a5cd62","e34e59dce2204f228f3a84b6725df60f",22850106,1,2,0,1639,417,419,2
"e34e59dce2204f228f3a84b6725df60f","e34e59dce2204f228f3a84b6725df60f",22850106,1,0,1,1640,419,419,0
"e34e59dce2204f228f3a84b6725df60f","a2b4bd40cee2481ebd3fc179d6a5cd62",22850106,1,-2,0,1641,419,417,-2
"a2b4bd40cee2481ebd3fc179d6a5cd62","bec48fc2e1294c7eb3d0aca780d731b8",22850106,2,4,0,1642,417,420,3
"bec48fc2e1294c7eb3d0aca780d731b8","bec48fc2e1294c7eb3d0aca780d731b8",22850106,6,0,1,1643,420,420,0
"bec48fc2e1294c7eb3d0aca780d731b8","a24600b0e49245f6bdba8c893cfeddb0",22850106,2,7,0,1647,420,425,5
"a24600b0e49245f6bdba8c893cfeddb0","dbde19fcce2a4c1abdc7f685c293a23f",22850106,2,-4,0,1648,425,422,-3
"dbde19fcce2a4c1abdc7f685c293a23f","a24600b0e49245f6bdba8c893cfeddb0",22850106,2,4,0,1649,422,425,3
"a24600b0e49245f6bdba8c893cfeddb0","a24600b0e49245f6bdba8c893cfeddb0",22850106,3,0,1,1650,425,425,0
"a24600b0e49245f6bdba8c893cfeddb0","a2b4bd40cee2481ebd3fc179d6a5cd62",22850106,2,-11,0,1652,425,417,-8
"a2b4bd40cee2481ebd3fc179d6a5cd62","24cf8786024543f19b89bc20034e60d7",22850106,2,18,0,1653,417,428,11
"24cf8786024543f19b89bc20034e60d7","f2a73be2f46840b182d7bd095378004e",22850106,2,1,0,1654,428,429,1
"f2a73be2f46840b182d7bd095378004e","f2a73be2f46840b182d7bd095378004e",22850106,2,0,1,1655,429,429,0
"f2a73be2f46840b182d7bd095378004e","604551fd4266430cb860fef58fa7dd61",22850106,1,1,0,1656,429,430,1
"604551fd4266430cb860fef58fa7dd61","604551fd4266430cb860fef58fa7dd61",22850106,4,0,1,1657,430,430,0
"604551fd4266430cb860fef58fa7dd61","dce46f8904594a62a6377a3587aaa663",22850106,1,2,0,1661,430,431,1
"dce46f8904594a62a6377a3587aaa663","24cf8786024543f19b89bc20034e60d7",22850106,2,-4,0,1662,431,428,-3
"24cf8786024543f19b89bc20034e60d7","24cf8786024543f19b89bc20034e60d7",22850106,1,0,1,1663,428,428,0
"24cf8786024543f19b89bc20034e60d7","dce46f8904594a62a6377a3587aaa663",22850106,2,4,0,1664,428,431,3
"dce46f8904594a62a6377a3587aaa663","dce46f8904594a62a6377a3587aaa663",22850106,4,0,1,1665,431,431,0
"dce46f8904594a62a6377a3587aaa663","9b9d0a249052413c869753b99682b0ac",22850106,1,1,0,1666,431,432,1
"9b9d0a249052413c869753b99682b0ac","9b9d0a249052413c869753b99682b0ac",22850106,8,0,1,1667,432,432,0
"9b9d0a249052413c869753b99682b0ac","061c175cc90f45fbad883025394e78dd",22850106,1,1,0,1675,432,433,1
"061c175cc90f45fbad883025394e78dd","061c175cc90f45fbad883025394e78dd",22850106,6,0,1,1676,433,433,0
"061c175cc90f45fbad883025394e78dd","dce46f8904594a62a6377a3587aaa663",22850106,1,-2,0,1682,433,431,-2
"24cf8786024543f19b89bc20034e60d7","66ada10dde9f43018588f1ced9d477fc",22850106,2,8,0,1684,428,434,6
"66ada10dde9f43018588f1ced9d477fc","dce46f8904594a62a6377a3587aaa663",22850106,1,-4,0,1685,434,431,-3
"dce46f8904594a62a6377a3587aaa663","74a7f8712e5449c2bc0b43c6f90dafed",22850106,1,5,0,1687,431,435,4
"74a7f8712e5449c2bc0b43c6f90dafed","74a7f8712e5449c2bc0b43c6f90dafed",22850106,1,0,1,1688,435,435,0
"74a7f8712e5449c2bc0b43c6f90dafed","66ada10dde9f43018588f1ced9d477fc",22850106,1,-1,0,1689,435,434,-1
"66ada10dde9f43018588f1ced9d477fc","24cf8786024543f19b89bc20034e60d7",22850106,2,-8,0,1690,434,428,-6
"66ada10dde9f43018588f1ced9d477fc","bf12c96466d840a69bed7020b3f18bb8",22850106,1,3,0,1692,434,436,2
"bf12c96466d840a69bed7020b3f18bb8","bf12c96466d840a69bed7020b3f18bb8",22850106,1,0,1,1693,436,436,0
"bf12c96466d840a69bed7020b3f18bb8","24cf8786024543f19b89bc20034e60d7",22850106,1,-11,0,1694,436,428,-8
"24cf8786024543f19b89bc20034e60d7","070600601c4c439288445d2f0724807d",22850106,2,14,0,1695,428,437,9
"070600601c4c439288445d2f0724807d","1823b6de7d334a7aaabc4570719af4d9",22850106,4,2,0,1696,437,439,2
"1823b6de7d334a7aaabc4570719af4d9","1823b6de7d334a7aaabc4570719af4d9",22850106,18,0,1,1697,439,439,0
"1823b6de7d334a7aaabc4570719af4d9","070600601c4c439288445d2f0724807d",22850106,4,-2,0,1704,439,437,-2
"070600601c4c439288445d2f0724807d","0380cd76a7d44bc3a4da1f15e4d68f89",22850106,4,4,0,1718,437,440,3
"0380cd76a7d44bc3a4da1f15e4d68f89","0380cd76a7d44bc3a4da1f15e4d68f89",22850106,7,0,1,1719,440,440,0
"0380cd76a7d44bc3a4da1f15e4d68f89","23b7673c8b5443108c2ef09382834a86",22850106,4,2,0,1722,440,441,1
"23b7673c8b5443108c2ef09382834a86","23b7673c8b5443108c2ef09382834a86",22850106,4,0,1,1723,441,441,0
"23b7673c8b5443108c2ef09382834a86","0380cd76a7d44bc3a4da1f15e4d68f89",22850106,1,-2,0,1724,441,440,-1
"0380cd76a7d44bc3a4da1f15e4d68f89","070600601c4c439288445d2f0724807d",22850106,1,-4,0,1725,440,437,-3
"23b7673c8b5443108c2ef09382834a86","901e92500aea43c79f19f1b279050668",22850106,3,2,0,1729,441,442,1
"901e92500aea43c79f19f1b279050668","23b7673c8b5443108c2ef09382834a86",22850106,1,-2,0,1730,442,441,-1
"23b7673c8b5443108c2ef09382834a86","070600601c4c439288445d2f0724807d",22850106,1,-6,0,1731,441,437,-4
"901e92500aea43c79f19f1b279050668","901e92500aea43c79f19f1b279050668",22850106,4,0,1,1739,442,442,0
"901e92500aea43c79f19f1b279050668","070600601c4c439288445d2f0724807d",22850106,1,-8,0,1740,442,437,-5
"070600601c4c439288445d2f0724807d","901e92500aea43c79f19f1b279050668",22850106,1,8,0,1741,437,442,5
"901e92500aea43c79f19f1b279050668","001339db8ced4cf78829ebe8b145449d",22850106,1,1,0,1742,442,443,1
"001339db8ced4cf78829ebe8b145449d","001339db8ced4cf78829ebe8b145449d",22850106,2,0,1,1743,443,443,0
"001339db8ced4cf78829ebe8b145449d","452745e0366e42ae81561bfddebcc6c3",22850106,1,1,0,1745,443,444,1
"452745e0366e42ae81561bfddebcc6c3","452745e0366e42ae81561bfddebcc6c3",22850106,5,0,1,1746,444,444,0
"452745e0366e42ae81561bfddebcc6c3","901e92500aea43c79f19f1b279050668",22850106,1,-2,0,1751,444,442,-2
"901e92500aea43c79f19f1b279050668","4660ff2089114e8db82ceb26a4f329e3",22850106,2,4,0,1752,442,445,3
"4660ff2089114e8db82ceb26a4f329e3","4660ff2089114e8db82ceb26a4f329e3",22850106,7,0,1,1753,445,445,0
"4660ff2089114e8db82ceb26a4f329e3","070600601c4c439288445d2f0724807d",22850106,1,-12,0,1754,445,437,-8
"070600601c4c439288445d2f0724807d","4660ff2089114e8db82ceb26a4f329e3",22850106,2,12,0,1755,437,445,8
"4660ff2089114e8db82ceb26a4f329e3","7bd5586eb9d8484eb74a433ee7bfe499",22850106,3,2,0,1758,445,446,1
"7bd5586eb9d8484eb74a433ee7bfe499","070600601c4c439288445d2f0724807d",22850106,1,-14,0,1759,446,437,-9
"7bd5586eb9d8484eb74a433ee7bfe499","7bd5586eb9d8484eb74a433ee7bfe499",22850106,11,0,1,1763,446,446,0
"7bd5586eb9d8484eb74a433ee7bfe499","b2f0d654738f48158edff28e8d3a546e",22850106,2,7,0,1772,446,449,3
"b2f0d654738f48158edff28e8d3a546e","b2f0d654738f48158edff28e8d3a546e",22850106,5,0,1,1773,449,449,0
"b2f0d654738f48158edff28e8d3a546e","f67fbf45a5f146ed866965bc57c7c001",22850106,3,8,0,1775,449,454,5
"f67fbf45a5f146ed866965bc57c7c001","f67fbf45a5f146ed866965bc57c7c001",22850106,4,0,1,1776,454,454,0
"f67fbf45a5f146ed866965bc57c7c001","b2f0d654738f48158edff28e8d3a546e",22850106,1,-8,0,1777,454,449,-5
"b2f0d654738f48158edff28e8d3a546e","8a7f26e690f34dda97be16904518ca99",22850106,1,-5,0,1781,449,447,-2
"8a7f26e690f34dda97be16904518ca99","070600601c4c439288445d2f0724807d",22850106,3,-16,0,1782,447,437,-10
"070600601c4c439288445d2f0724807d","8a7f26e690f34dda97be16904518ca99",22850106,2,16,0,1783,437,447,10
"8a7f26e690f34dda97be16904518ca99","7bd5586eb9d8484eb74a433ee7bfe499",22850106,1,-2,0,1784,447,446,-1
"7bd5586eb9d8484eb74a433ee7bfe499","4660ff2089114e8db82ceb26a4f329e3",22850106,1,-2,0,1786,446,445,-1
"4660ff2089114e8db82ceb26a4f329e3","901e92500aea43c79f19f1b279050668",22850106,1,-4,0,1788,445,442,-3
"901e92500aea43c79f19f1b279050668","8a7f26e690f34dda97be16904518ca99",22850106,1,8,0,1790,442,447,5
"8a7f26e690f34dda97be16904518ca99","8a7f26e690f34dda97be16904518ca99",22850106,1,0,1,1793,447,447,0
"070600601c4c439288445d2f0724807d","b2f0d654738f48158edff28e8d3a546e",22850106,1,21,0,1795,437,449,12
"f67fbf45a5f146ed866965bc57c7c001","d937afe49bd24a07a550dda1c1155122",22850106,1,1,0,1800,454,455,1
"d937afe49bd24a07a550dda1c1155122","d937afe49bd24a07a550dda1c1155122",22850106,1,0,1,1801,455,455,0
"d937afe49bd24a07a550dda1c1155122","3628b3f7823443d0912a339096b69943",22850106,1,1,0,1802,455,456,1
"3628b3f7823443d0912a339096b69943","3628b3f7823443d0912a339096b69943",22850106,1,0,1,1803,456,456,0
"3628b3f7823443d0912a339096b69943","9e049ee647cf43ecbcb5ed792a8e7588",22850106,1,1,0,1804,456,457,1
"9e049ee647cf43ecbcb5ed792a8e7588","9e049ee647cf43ecbcb5ed792a8e7588",22850106,1,0,1,1805,457,457,0
"9e049ee647cf43ecbcb5ed792a8e7588","5256a214faaf410b93f76cea06428334",22850106,1,1,0,1806,457,458,1
"5256a214faaf410b93f76cea06428334","5256a214faaf410b93f76cea06428334",22850106,1,0,1,1807,458,458,0
"5256a214faaf410b93f76cea06428334","25c32b120fce40fa9b6c85133aeb4716",22850106,1,1,0,1808,458,459,1
"25c32b120fce40fa9b6c85133aeb4716","25c32b120fce40fa9b6c85133aeb4716",22850106,1,0,1,1809,459,459,0
"25c32b120fce40fa9b6c85133aeb4716","11bc14f2204949008b7d511b933363c1",22850106,1,1,0,1810,459,460,1
"11bc14f2204949008b7d511b933363c1","11bc14f2204949008b7d511b933363c1",22850106,1,0,1,1811,460,460,0
"11bc14f2204949008b7d511b933363c1","42de338840a34d15adb66e7b14fb9d2c",22850106,1,1,0,1812,460,461,1
"42de338840a34d15adb66e7b14fb9d2c","42de338840a34d15adb66e7b14fb9d2c",22850106,1,0,1,1813,461,461,0
"42de338840a34d15adb66e7b14fb9d2c","9da37c6210b1416b8079c274f70bf600",22850106,1,1,0,1814,461,462,1
"9da37c6210b1416b8079c274f70bf600","9da37c6210b1416b8079c274f70bf600",22850106,1,0,1,1815,462,462,0
"9da37c6210b1416b8079c274f70bf600","519119f1deac45ff9ab4f13529be5c6e",22850106,1,1,0,1816,462,463,1
"519119f1deac45ff9ab4f13529be5c6e","519119f1deac45ff9ab4f13529be5c6e",22850106,1,0,1,1817,463,463,0
"519119f1deac45ff9ab4f13529be5c6e","c5df9f40ec14463b9dcfdc73df3e9285",22850106,1,3,0,1818,463,464,1
"c5df9f40ec14463b9dcfdc73df3e9285","f67fbf45a5f146ed866965bc57c7c001",22850106,1,-12,0,1819,464,454,-10
"f67fbf45a5f146ed866965bc57c7c001","c5df9f40ec14463b9dcfdc73df3e9285",22850106,1,12,0,1820,454,464,10
"c5df9f40ec14463b9dcfdc73df3e9285","c5df9f40ec14463b9dcfdc73df3e9285",22850106,2,0,1,1821,464,464,0
"c5df9f40ec14463b9dcfdc73df3e9285","9428d8bd9c5a47b2a235b254e5e27ded",22850106,1,-16,0,1823,464,452,-12
"9428d8bd9c5a47b2a235b254e5e27ded","b2f0d654738f48158edff28e8d3a546e",22850106,1,-4,0,1824,452,449,-3
"b2f0d654738f48158edff28e8d3a546e","f60ee41ec635499abd48168342d32c2f",22850106,3,5,0,1825,449,453,4
"f60ee41ec635499abd48168342d32c2f","f60ee41ec635499abd48168342d32c2f",22850106,65,0,1,1826,453,453,0
"f60ee41ec635499abd48168342d32c2f","b2f0d654738f48158edff28e8d3a546e",22850106,3,-5,0,1876,453,449,-4
"f67fbf45a5f146ed866965bc57c7c001","67a089198fcb4e1c8f2385786c2b296f",22850106,1,-568,0,1889,454,39,-415
"67a089198fcb4e1c8f2385786c2b296f","67a089198fcb4e1c8f2385786c2b296f",22850106,1,0,1,1890,39,39,0
"64d48c6c9c7940639a932219a6c87198","64d48c6c9c7940639a932219a6c87198",22850106,4,0,1,1892,40,40,0
"64d48c6c9c7940639a932219a6c87198","b534b89233134e30a9b5645138bfa9ee",22850106,1,3,0,1894,40,41,1
"b534b89233134e30a9b5645138bfa9ee","67a089198fcb4e1c8f2385786c2b296f",22850106,1,-4,0,1895,41,39,-2
"67a089198fcb4e1c8f2385786c2b296f","b534b89233134e30a9b5645138bfa9ee",22850106,2,4,0,1896,39,41,2
"6e13d61a7bdb44bca949c9f86fab3be5","d9c8d8c444a64dadbbb508652c721e17",22850106,2,-1,0,1899,47,46,-1
"d9c8d8c444a64dadbbb508652c721e17","d0c74f735e024943943e40333d6d337f",22850106,2,6,0,1900,46,51,5
"d0c74f735e024943943e40333d6d337f","a1f2f12debe5432fb7a70bcd12bacfb9",22850106,1,8,0,1902,51,58,7
"a1f2f12debe5432fb7a70bcd12bacfb9","f924752d8a1149668870b1e7698486f7",22850106,1,-9,0,1903,58,50,-8
"f924752d8a1149668870b1e7698486f7","78f30e4dcac84e3cbea8b2cc6e0d62b3",22850106,1,10,0,1904,50,59,9
"78f30e4dcac84e3cbea8b2cc6e0d62b3","12aa6e1672ac4e7aa6449a7a8609cd72",22850106,1,-2,0,1905,59,57,-2
"12aa6e1672ac4e7aa6449a7a8609cd72","bc42d26810654ea9a1df1efe1e58c7d5",22850106,1,7,0,1906,57,63,6
"309ccf3cc4fe429d9bfbaef53d3fa479","d646286c8051419bbc2e31dd1db55ca8",22850106,1,10,0,1913,60,67,7
"d646286c8051419bbc2e31dd1db55ca8","b534b89233134e30a9b5645138bfa9ee",22850106,1,-33,0,1914,67,41,-26
"d646286c8051419bbc2e31dd1db55ca8","a2becd407db34b189200a32546d9d569",22850106,3,9,0,1916,67,75,8
"a2becd407db34b189200a32546d9d569","a2becd407db34b189200a32546d9d569",22850106,4,0,1,1917,75,75,0
"a2becd407db34b189200a32546d9d569","140d5b27b8574befad82c0a013b59dfa",22850106,3,-1,0,1918,75,74,-1
"140d5b27b8574befad82c0a013b59dfa","d18a9ea32855445f8736581f5cb119ce",22850106,2,9,0,1919,74,82,8
"d18a9ea32855445f8736581f5cb119ce","6a9f0ef185fb47f0937e29daa1c71ed5",22850106,1,10,0,1920,82,90,8
"6a9f0ef185fb47f0937e29daa1c71ed5","6a9f0ef185fb47f0937e29daa1c71ed5",22850106,4,0,1,1921,90,90,0
"6a9f0ef185fb47f0937e29daa1c71ed5","ae5ac430ea254e708a6f5deaaf7464ae",22850106,2,-7,0,1922,90,84,-6
"ae5ac430ea254e708a6f5deaaf7464ae","6a9f0ef185fb47f0937e29daa1c71ed5",22850106,2,7,0,1923,84,90,6
"6a9f0ef185fb47f0937e29daa1c71ed5","d646286c8051419bbc2e31dd1db55ca8",22850106,2,-27,0,1924,90,67,-23
"d646286c8051419bbc2e31dd1db55ca8","e20db35ced8544ddac5bc3839145e463",22850106,2,30,0,1925,67,91,24
"00ae5f0c51874a73a41ebea838d95682","e20db35ced8544ddac5bc3839145e463",22850106,1,-11,0,1927,101,91,-10
"e20db35ced8544ddac5bc3839145e463","d391c8b6e56a43a7b654e9dee02d904b",22850106,1,13,0,1928,91,103,12
"d391c8b6e56a43a7b654e9dee02d904b","00ae5f0c51874a73a41ebea838d95682",22850106,2,-2,0,1929,103,101,-2
"00ae5f0c51874a73a41ebea838d95682","73039f8c1eb9409cb4caee2cf968001e",22850106,1,-1,0,1930,101,100,-1
"73039f8c1eb9409cb4caee2cf968001e","4280927ec4d643238aa49c32f9e06c6c",22850106,2,10,0,1931,100,109,9
"4280927ec4d643238aa49c32f9e06c6c","4280927ec4d643238aa49c32f9e06c6c",22850106,1,0,1,1932,109,109,0
"4280927ec4d643238aa49c32f9e06c6c","08111f75e22d409998cf8b85bd431f0a",22850106,1,-1,0,1933,109,108,-1
"08111f75e22d409998cf8b85bd431f0a","a9ae0a3c070d455bb4369a8996313336",22850106,1,7,0,1934,108,114,6
"a9ae0a3c070d455bb4369a8996313336","62bff51286ef4f348717a3cf6fe2318f",22850106,1,7,0,1935,114,120,6
"62bff51286ef4f348717a3cf6fe2318f","62bff51286ef4f348717a3cf6fe2318f",22850106,5,0,1,1936,120,120,0
"62bff51286ef4f348717a3cf6fe2318f","37319e88176d4aefa91d7a9980dbae91",22850106,2,-9,0,1938,120,112,-8
"37319e88176d4aefa91d7a9980dbae91","779f9ddd1fd14d1e9e69f72219a1fdbd",22850106,1,12,0,1939,112,121,9
"779f9ddd1fd14d1e9e69f72219a1fdbd","e20db35ced8544ddac5bc3839145e463",22850106,1,-36,0,1940,121,91,-30
"e20db35ced8544ddac5bc3839145e463","779f9ddd1fd14d1e9e69f72219a1fdbd",22850106,2,36,0,1941,91,121,30
"779f9ddd1fd14d1e9e69f72219a1fdbd","a8dd5213034441ac92724b4e83eb0bb2",22850106,3,9,0,1942,121,129,8
"a8dd5213034441ac92724b4e83eb0bb2","a8dd5213034441ac92724b4e83eb0bb2",22850106,2,0,1,1943,129,129,0
"a8dd5213034441ac92724b4e83eb0bb2","579338175e0b4bbb8ef3b712b5d8b54e",22850106,1,-1,0,1944,129,128,-1
"579338175e0b4bbb8ef3b712b5d8b54e","b416d47c56a742199b5d7c7f19d6503a",22850106,1,7,0,1945,128,134,6
"b416d47c56a742199b5d7c7f19d6503a","df1de691dafe4549a18a4398ee9dfaf9",22850106,1,8,0,1946,134,139,5
"df1de691dafe4549a18a4398ee9dfaf9","779f9ddd1fd14d1e9e69f72219a1fdbd",22850106,2,-23,0,1947,139,121,-18
"779f9ddd1fd14d1e9e69f72219a1fdbd","6c5ad271a44743479bfaea29b1db8d02",22850106,2,27,0,1948,121,143,22
"6c5ad271a44743479bfaea29b1db8d02","6c5ad271a44743479bfaea29b1db8d02",22850106,2,0,1,1949,143,143,0
"6c5ad271a44743479bfaea29b1db8d02","df1de691dafe4549a18a4398ee9dfaf9",22850106,1,-4,0,1950,143,139,-4
"df1de691dafe4549a18a4398ee9dfaf9","8aae34f5ddbb4052a709b12e6b0d40fa",22850106,2,9,0,1951,139,147,8
"8aae34f5ddbb4052a709b12e6b0d40fa","8aae34f5ddbb4052a709b12e6b0d40fa",22850106,2,0,1,1952,147,147,0
"8aae34f5ddbb4052a709b12e6b0d40fa","f902b0f41b544d4dbf79664fd233648d",22850106,1,-1,0,1953,147,146,-1
"f902b0f41b544d4dbf79664fd233648d","f03480cf4eba413194d7af52fc0e7f28",22850106,1,7,0,1954,146,152,6
"f03480cf4eba413194d7af52fc0e7f28","d313cec988a84645bee413e8d4724a4b",22850106,2,7,0,1955,152,158,6
"d313cec988a84645bee413e8d4724a4b","d313cec988a84645bee413e8d4724a4b",22850106,5,0,1,1956,158,158,0
"d313cec988a84645bee413e8d4724a4b","df1de691dafe4549a18a4398ee9dfaf9",22850106,1,-22,0,1958,158,139,-19
"df1de691dafe4549a18a4398ee9dfaf9","78adeee1fa2c4fe0bc73f7bca9fcee86",22850106,2,26,0,1959,139,160,21
"78adeee1fa2c4fe0bc73f7bca9fcee86","78adeee1fa2c4fe0bc73f7bca9fcee86",22850106,2,0,1,1960,160,160,0
"78adeee1fa2c4fe0bc73f7bca9fcee86","65202579580f4ad38d734b4ee39d22a8",22850106,5,5,0,1961,160,164,4
"65202579580f4ad38d734b4ee39d22a8","65202579580f4ad38d734b4ee39d22a8",22850106,82,0,1,1962,164,164,0
"65202579580f4ad38d734b4ee39d22a8","78adeee1fa2c4fe0bc73f7bca9fcee86",22850106,5,-5,0,1969,164,160,-4
"78adeee1fa2c4fe0bc73f7bca9fcee86","3cbcea2be0984e7dbd5a48195af10ce7",22850106,2,8,0,1970,160,165,5
"3cbcea2be0984e7dbd5a48195af10ce7","82e6285962b8400d9d6fc32436022a94",22850106,2,2,0,1971,165,167,2
"82e6285962b8400d9d6fc32436022a94","3cbcea2be0984e7dbd5a48195af10ce7",22850106,1,-2,0,1972,167,165,-2
"3cbcea2be0984e7dbd5a48195af10ce7","a9ac840f098c4bd0a2ee896214ce29cd",22850106,1,5,0,1973,165,168,3
"a9ac840f098c4bd0a2ee896214ce29cd","0c7262dff33c4087bc660ccf40f92f9c",22850106,1,4,0,1974,168,169,1
"0c7262dff33c4087bc660ccf40f92f9c","a9ac840f098c4bd0a2ee896214ce29cd",22850106,1,-4,0,1975,169,168,-1
"a9ac840f098c4bd0a2ee896214ce29cd","b2275c3fad834f8d90737a2d9a6927d6",22850106,1,7,0,1976,168,172,4
"b2275c3fad834f8d90737a2d9a6927d6","0c7262dff33c4087bc660ccf40f92f9c",22850106,1,-3,0,1977,172,169,-3
"0c7262dff33c4087bc660ccf40f92f9c","b42cc17b7de840f181a704558d0bc845",22850106,3,7,0,1978,169,175,6
"b42cc17b7de840f181a704558d0bc845","b42cc17b7de840f181a704558d0bc845",22850106,3,0,1,1979,175,175,0
"b42cc17b7de840f181a704558d0bc845","362fcb0699a14845ab29b2340093e528",22850106,1,-1,0,1981,175,174,-1
"362fcb0699a14845ab29b2340093e528","ea38cc0e6e6e41edbabf210220808bf9",22850106,2,6,0,1982,174,179,5
"c8e371568a0c4391b25796ae4e91952e","c8e371568a0c4391b25796ae4e91952e",22850106,1,0,1,1989,186,186,0
"c8e371568a0c4391b25796ae4e91952e","ab11d94c6c8948ea90b88f19d2cd502b",22850106,2,5,0,1990,186,190,4
"ab11d94c6c8948ea90b88f19d2cd502b","ab11d94c6c8948ea90b88f19d2cd502b",22850106,2,0,1,1991,190,190,0
"ab11d94c6c8948ea90b88f19d2cd502b","6cd2dcaac46847d4a0bc53f296d90375",22850106,1,5,0,1992,190,194,4
"6cd2dcaac46847d4a0bc53f296d90375","07b44a7a51e94c78b411c753fc39dab0",22850106,1,-6,0,1993,194,189,-5
"07b44a7a51e94c78b411c753fc39dab0","6cd2dcaac46847d4a0bc53f296d90375",22850106,2,6,0,1994,189,194,5
"6cd2dcaac46847d4a0bc53f296d90375","017d7ca8e0394b91aaadc9574df2202c",22850106,1,-1,0,1995,194,193,-1
"017d7ca8e0394b91aaadc9574df2202c","f9170dd6bc6442b4acd832747609b09a",22850106,1,7,0,1996,193,199,6
"f9170dd6bc6442b4acd832747609b09a","c8e371568a0c4391b25796ae4e91952e",22850106,3,-16,0,1997,199,186,-13
"c8e371568a0c4391b25796ae4e91952e","d7f13c8d63ec4e2aa673fbb9cf9c6933",22850106,1,26,0,1998,186,206,20
"7108f0e4c2584f1f9c471689ae4c885c","09400e101c5d4b439cf9a26b03aae558",22850106,1,3,0,2001,208,210,2
"09400e101c5d4b439cf9a26b03aae558","d7f13c8d63ec4e2aa673fbb9cf9c6933",22850106,1,-5,0,2002,210,206,-4
"09400e101c5d4b439cf9a26b03aae558","be502a7a43c44bf7b682698de79d9369",22850106,1,5,0,2004,210,214,4
"be502a7a43c44bf7b682698de79d9369","a875096404ef4a9984b62d74cda916f9",22850106,1,-6,0,2005,214,209,-5
"a875096404ef4a9984b62d74cda916f9","f7fb1952f56b4189b86a9f8b7862d2b8",22850106,1,7,0,2006,209,215,6
"d7f13c8d63ec4e2aa673fbb9cf9c6933","1c6721b1f63f4d30ba7746ea8af02a52",22850106,2,21,0,2012,206,221,15
"77ecef8eff6b4a2caea7707669bf7475","8b9ae98743bd4d4a8a87dff1c1244211",22850106,1,6,0,2014,222,227,5
"8b9ae98743bd4d4a8a87dff1c1244211","1c6721b1f63f4d30ba7746ea8af02a52",22850106,1,-7,0,2015,227,221,-6
"1c6721b1f63f4d30ba7746ea8af02a52","d03cb855c70044cf8c35d9ec0de696e3",22850106,1,4,0,2016,221,224,3
"d03cb855c70044cf8c35d9ec0de696e3","d03cb855c70044cf8c35d9ec0de696e3",22850106,2,0,1,2017,224,224,0
"d03cb855c70044cf8c35d9ec0de696e3","2ab1535aac1346ba8801535bf729ef37",22850106,1,6,0,2018,224,229,5
"2ab1535aac1346ba8801535bf729ef37","5152833676bf4c6cb317060be10f68db",22850106,1,-1,0,2021,229,228,-1
"5152833676bf4c6cb317060be10f68db","0b04c8e2f86d48c7aeb7e225819cd32b",22850106,1,7,0,2022,228,234,6
"0b04c8e2f86d48c7aeb7e225819cd32b","1c6721b1f63f4d30ba7746ea8af02a52",22850106,1,-16,0,2023,234,221,-13
"2ae94c0cea4d480a9d5dca8fb1d7b542","1ebf23f9d994469a85206e4c7b1bf5f5",22850106,1,3,0,2025,242,245,3
"2ae94c0cea4d480a9d5dca8fb1d7b542","00f61990949545828dd12f1303d47504",22850106,1,17,0,2027,242,256,14
"00f61990949545828dd12f1303d47504","6e83e23f56544a19b94067c1c558d9c0",22850106,2,-11,0,2028,256,247,-9
"00f61990949545828dd12f1303d47504","d546341988904f069cfa86b21457d9d9",22850106,1,-6,0,2030,256,251,-5
"d546341988904f069cfa86b21457d9d9","d989ebcfc12a4b669f0100dc1aa14f1e",22850106,1,5,0,2031,251,255,4
"d989ebcfc12a4b669f0100dc1aa14f1e","7aa76d3e993840d8805f097cbdbcd44b",22850106,1,7,0,2032,255,261,6
"0d987bed3ffa4ed0b9a2e62e97b7b30f","bb5a47f5ea01454a8b79455422d3b9da",22850106,5,10,0,2036,272,280,8
"bb5a47f5ea01454a8b79455422d3b9da","82ae07bc0c9b4570a41799290d1ef399",22850106,3,-6,0,2037,280,275,-5
"82ae07bc0c9b4570a41799290d1ef399","bb5a47f5ea01454a8b79455422d3b9da",22850106,5,6,0,2038,275,280,5
"bb5a47f5ea01454a8b79455422d3b9da","0d987bed3ffa4ed0b9a2e62e97b7b30f",22850106,5,-10,0,2045,280,272,-8
"0d987bed3ffa4ed0b9a2e62e97b7b30f","94cecc3f1e7d484b8e068e79241dfd73",22850106,2,13,0,2046,272,281,9
"94cecc3f1e7d484b8e068e79241dfd73","a37477c4e4c14169ad44b06b493007f6",22850106,2,2,0,2047,281,283,2
"a37477c4e4c14169ad44b06b493007f6","94cecc3f1e7d484b8e068e79241dfd73",22850106,1,-2,0,2048,283,281,-2
"94cecc3f1e7d484b8e068e79241dfd73","fab84b4fab5940efb4ea868ef8d09396",22850106,1,5,0,2049,281,284,3
"fab84b4fab5940efb4ea868ef8d09396","4a29443515bb404cb8924e1c60a63b73",22850106,1,4,0,2050,284,285,1
"4a29443515bb404cb8924e1c60a63b73","6a9a3b5bde4a48daa896fe8c06eca56f",22850106,1,5,0,2055,285,289,4
"869e967078f04da18dd0b0b9389a7424","34a6e49023fc4465bd5ca604330bbd1c",22850106,1,-1,0,2058,293,292,-1
"86c27d40179e419c8e9d150fb6afa5d0","47edbb64109243e6b0f8f64cdef90c6c",22850106,1,8,0,2075,319,326,7
"24f1363179ad4aaa965484a78471912b","24f1363179ad4aaa965484a78471912b",22850106,1,0,1,2078,323,323,0
"3628bdce1dd2429ba924d2d4d09448d2","3434c10e561d488a914e0f7d71907abd",22850106,1,-21,0,2080,322,305,-17
"0c4079457ede49e3aeb5e86ed84bdf35","bbc5139ca9024389a94db3a6f47dcff6",22850106,1,14,0,2085,329,341,12
"bbc5139ca9024389a94db3a6f47dcff6","b8b9418ab322418d9db9b40d96af873a",22850106,1,-5,0,2086,341,337,-4
"09b9678ddc3d452ea4a3d46e15826065","2fe14166dc9642c3bc666b86a57f943d",22850106,1,5,0,2103,353,357,4
"492a3bc6a1254f23a7998587961b22a4","52580888dadb4fe3baa795683ea227bd",22850106,1,-3,0,2110,366,364,-2
"52580888dadb4fe3baa795683ea227bd","072a190fd302456290895f9f04d6940a",22850106,1,2,0,2111,364,365,1
"072a190fd302456290895f9f04d6940a","52580888dadb4fe3baa795683ea227bd",22850106,1,-2,0,2112,365,364,-1
"8d448d625b024c82a5eb240bbd7431d6","d6d02b6ef04e4f17805504500b8ce441",22850106,1,3,0,2128,374,375,1
"d6d02b6ef04e4f17805504500b8ce441","b71bac264efb4abd97015447bd490db6",22850106,1,-8,0,2129,375,370,-5
"7f544639412e40a9ba27f43b415362ab","66baf19b6b904b70922329068c63746d",22850106,1,-2,0,2135,378,376,-2
"66baf19b6b904b70922329068c63746d","c2fca3669923477ab966ded303dea31c",22850106,1,8,0,2136,376,383,7
"2b09a08242b54983aec7063990fb3f66","1157bd665ec4472fb58b751dc5099355",22850106,1,4,0,2152,400,403,3
"a2b4bd40cee2481ebd3fc179d6a5cd62","a2b4bd40cee2481ebd3fc179d6a5cd62",22850106,1,0,1,2169,417,417,0
"f2a73be2f46840b182d7bd095378004e","24cf8786024543f19b89bc20034e60d7",22850106,1,-1,0,2181,429,428,-1
"dce46f8904594a62a6377a3587aaa663","66ada10dde9f43018588f1ced9d477fc",22850106,1,4,0,2185,431,434,3
"b2f0d654738f48158edff28e8d3a546e","070600601c4c439288445d2f0724807d",22850106,1,-21,0,2205,449,437,-12
"070600601c4c439288445d2f0724807d","f60ee41ec635499abd48168342d32c2f",22850106,1,26,0,2206,437,453,16
"f60ee41ec635499abd48168342d32c2f","9428d8bd9c5a47b2a235b254e5e27ded",22850106,1,-1,0,2215,453,452,-1
"9428d8bd9c5a47b2a235b254e5e27ded","b613861cecf84ffcab01afb23f660475",22850106,1,-636,0,2216,452,1,-451
"b613861cecf84ffcab01afb23f660475","b613861cecf84ffcab01afb23f660475",22850106,2,0,1,2217,1,1,0
"b613861cecf84ffcab01afb23f660475","e2911e79efc2420eac45d9f671463d4b",22850106,1,3,0,2219,1,2,1
"56586aa865414f538729c7f7735d2bc6","b7f2b31585d94eb3bf86376714aa7070",22850106,2,2,0,2225,12,13,1
"b7f2b31585d94eb3bf86376714aa7070","b7f2b31585d94eb3bf86376714aa7070",22850106,5,0,1,2226,13,13,0
"b7f2b31585d94eb3bf86376714aa7070","3f1c815879794b929260d224becaff7e",22850106,2,2,0,2228,13,14,1
"3f1c815879794b929260d224becaff7e","81c864a886d54a6b8ff85f7d736f4f95",22850106,1,2,0,2229,14,15,1
"81c864a886d54a6b8ff85f7d736f4f95","5c5ceeee4562457ba6d41515aeebfbb1",22850106,2,4,0,2230,15,17,2
"5c5ceeee4562457ba6d41515aeebfbb1","5c5ceeee4562457ba6d41515aeebfbb1",22850106,1,0,1,2231,17,17,0
"5c5ceeee4562457ba6d41515aeebfbb1","9afd71a5298d4333b6849dfce1b9422c",22850106,2,3,0,2232,17,18,1
"9afd71a5298d4333b6849dfce1b9422c","56586aa865414f538729c7f7735d2bc6",22850106,2,-13,0,2233,18,12,-6
"56586aa865414f538729c7f7735d2bc6","9afd71a5298d4333b6849dfce1b9422c",22850106,2,13,0,2234,12,18,6
"9afd71a5298d4333b6849dfce1b9422c","b7719e26494940efa49512aedd0aac79",22850106,1,4,0,2235,18,20,2
"b7719e26494940efa49512aedd0aac79","d4f45188d3c84a02ba08454e6403a818",22850106,1,5,0,2236,20,24,4
"c33c17be71ae4d588da7369472e5bb1b","c33c17be71ae4d588da7369472e5bb1b",22850106,1,0,1,2247,34,34,0
"c33c17be71ae4d588da7369472e5bb1b","93679be414554a11b1893002f2229a93",22850106,1,3,0,2248,34,35,1
"93679be414554a11b1893002f2229a93","93679be414554a11b1893002f2229a93",22850106,1,0,1,2249,35,35,0
"93679be414554a11b1893002f2229a93","7040a13096d746ac84b8fac8d9752058",22850106,1,3,0,2250,35,36,1
"7040a13096d746ac84b8fac8d9752058","9a0dc646f934470daf08c4b56ccf73db",22850106,1,3,0,2251,36,37,1
"9a0dc646f934470daf08c4b56ccf73db","7040a13096d746ac84b8fac8d9752058",22850106,1,-3,0,2252,37,36,-1
"b613861cecf84ffcab01afb23f660475","b613861cecf84ffcab01afb23f660475",22850177,4,0,1,1,1,1,0
"e2911e79efc2420eac45d9f671463d4b","519d1b8c59404d67b54e96c5c8a830b2",22850177,1,1,0,7,2,3,1
"519d1b8c59404d67b54e96c5c8a830b2","519d1b8c59404d67b54e96c5c8a830b2",22850177,1,0,1,8,3,3,0
"519d1b8c59404d67b54e96c5c8a830b2","531db53f81f646edb0cdcfe0085b03b7",22850177,1,1,0,9,3,4,1
"531db53f81f646edb0cdcfe0085b03b7","531db53f81f646edb0cdcfe0085b03b7",22850177,1,0,1,10,4,4,0
"531db53f81f646edb0cdcfe0085b03b7","4f5f94b2f95141e0a9d53a61da2276da",22850177,1,1,0,11,4,5,1
"4f5f94b2f95141e0a9d53a61da2276da","4f5f94b2f95141e0a9d53a61da2276da",22850177,1,0,1,12,5,5,0
"4f5f94b2f95141e0a9d53a61da2276da","6d541c89590949f99af293c4f2333f67",22850177,1,1,0,13,5,6,1
"6d541c89590949f99af293c4f2333f67","6d541c89590949f99af293c4f2333f67",22850177,1,0,1,14,6,6,0
"6d541c89590949f99af293c4f2333f67","dd5cf0b9fe4c4f1d8f5ff8e4c04879cb",22850177,1,1,0,15,6,7,1
"dd5cf0b9fe4c4f1d8f5ff8e4c04879cb","dd5cf0b9fe4c4f1d8f5ff8e4c04879cb",22850177,1,0,1,16,7,7,0
"dd5cf0b9fe4c4f1d8f5ff8e4c04879cb","f96261861edc426abe2248be4f0a709a",22850177,1,1,0,17,7,8,1
"f96261861edc426abe2248be4f0a709a","f96261861edc426abe2248be4f0a709a",22850177,1,0,1,18,8,8,0
"f96261861edc426abe2248be4f0a709a","66b5e16f4f75454fb5b8172079f0fa83",22850177,1,1,0,19,8,9,1
"66b5e16f4f75454fb5b8172079f0fa83","66b5e16f4f75454fb5b8172079f0fa83",22850177,1,0,1,20,9,9,0
"66b5e16f4f75454fb5b8172079f0fa83","0680571d4698477995e41842c36a54b2",22850177,1,1,0,21,9,10,1
"0680571d4698477995e41842c36a54b2","0680571d4698477995e41842c36a54b2",22850177,1,0,1,22,10,10,0
"0680571d4698477995e41842c36a54b2","9112f2bffece48e08c6d2287be204085",22850177,1,1,0,23,10,11,1
"9112f2bffece48e08c6d2287be204085","9112f2bffece48e08c6d2287be204085",22850177,1,0,1,24,11,11,0
"9112f2bffece48e08c6d2287be204085","e2911e79efc2420eac45d9f671463d4b",22850177,1,-9,0,25,11,2,-9
"3f1c815879794b929260d224becaff7e","56586aa865414f538729c7f7735d2bc6",22850177,3,-4,0,37,14,12,-2
"56586aa865414f538729c7f7735d2bc6","5c5ceeee4562457ba6d41515aeebfbb1",22850177,2,10,0,38,12,17,5
"9afd71a5298d4333b6849dfce1b9422c","9afd71a5298d4333b6849dfce1b9422c",22850177,3,0,1,43,18,18,0
"b7719e26494940efa49512aedd0aac79","d4f45188d3c84a02ba08454e6403a818",22850177,1,5,0,46,20,24,4
"a49d1bb4328949299686242fd0be5584","d4c3b003e8274e429d2fa688d73fde6d",22850177,1,1,0,50,21,22,1
"d4c3b003e8274e429d2fa688d73fde6d","d4f45188d3c84a02ba08454e6403a818",22850177,1,2,0,51,22,24,2
"d4f45188d3c84a02ba08454e6403a818","b7719e26494940efa49512aedd0aac79",22850177,1,-5,0,52,24,20,-4
"d4c3b003e8274e429d2fa688d73fde6d","9afd71a5298d4333b6849dfce1b9422c",22850177,1,-7,0,56,22,18,-4
"eb2a0eb537344a9e891c761662e400b6","81c864a886d54a6b8ff85f7d736f4f95",22850177,1,-2,0,68,16,15,-1
"81c864a886d54a6b8ff85f7d736f4f95","3f1c815879794b929260d224becaff7e",22850177,1,-2,0,69,15,14,-1
"56586aa865414f538729c7f7735d2bc6","e2911e79efc2420eac45d9f671463d4b",22850177,4,-12,0,72,12,2,-10
"56586aa865414f538729c7f7735d2bc6","b7f2b31585d94eb3bf86376714aa7070",22850177,11,2,0,100,12,13,1
"b7f2b31585d94eb3bf86376714aa7070","b7f2b31585d94eb3bf86376714aa7070",22850177,6,0,1,101,13,13,0
"b7f2b31585d94eb3bf86376714aa7070","3f1c815879794b929260d224becaff7e",22850177,5,2,0,102,13,14,1
"3f1c815879794b929260d224becaff7e","5c5ceeee4562457ba6d41515aeebfbb1",22850177,1,6,0,103,14,17,3
"5c5ceeee4562457ba6d41515aeebfbb1","81c864a886d54a6b8ff85f7d736f4f95",22850177,1,-4,0,104,17,15,-2
"81c864a886d54a6b8ff85f7d736f4f95","5c5ceeee4562457ba6d41515aeebfbb1",22850177,1,4,0,105,15,17,2
"5c5ceeee4562457ba6d41515aeebfbb1","5c5ceeee4562457ba6d41515aeebfbb1",22850177,3,0,1,106,17,17,0
"5c5ceeee4562457ba6d41515aeebfbb1","56586aa865414f538729c7f7735d2bc6",22850177,2,-10,0,107,17,12,-5
"56586aa865414f538729c7f7735d2bc6","9afd71a5298d4333b6849dfce1b9422c",22850177,3,13,0,108,12,18,6
"9afd71a5298d4333b6849dfce1b9422c","b7719e26494940efa49512aedd0aac79",22850177,3,4,0,109,18,20,2
"b7719e26494940efa49512aedd0aac79","9afd71a5298d4333b6849dfce1b9422c",22850177,3,-4,0,110,20,18,-2
"9afd71a5298d4333b6849dfce1b9422c","d4f45188d3c84a02ba08454e6403a818",22850177,1,9,0,111,18,24,6
"d4f45188d3c84a02ba08454e6403a818","d4c3b003e8274e429d2fa688d73fde6d",22850177,5,-2,0,112,24,22,-2
"d4c3b003e8274e429d2fa688d73fde6d","d4c3b003e8274e429d2fa688d73fde6d",22850177,2,0,1,113,22,22,0
"d4c3b003e8274e429d2fa688d73fde6d","b7719e26494940efa49512aedd0aac79",22850177,4,-3,0,115,22,20,-2
"b7719e26494940efa49512aedd0aac79","b7719e26494940efa49512aedd0aac79",22850177,2,0,1,116,20,20,0
"b7719e26494940efa49512aedd0aac79","afbf7250b99d47bea07172749483ca97",22850177,1,12,0,117,20,28,8
"afbf7250b99d47bea07172749483ca97","afbf7250b99d47bea07172749483ca97",22850177,2,0,1,118,28,28,0
"afbf7250b99d47bea07172749483ca97","4e51676dc72045d99c19b9fa7b22f8bc",22850177,1,3,0,119,28,29,1
"4e51676dc72045d99c19b9fa7b22f8bc","4e51676dc72045d99c19b9fa7b22f8bc",22850177,1,0,1,120,29,29,0
"4e51676dc72045d99c19b9fa7b22f8bc","51970cfa30e643e894e66ae85c8024cc",22850177,1,3,0,121,29,31,2
"51970cfa30e643e894e66ae85c8024cc","c33c17be71ae4d588da7369472e5bb1b",22850177,1,6,0,122,31,34,3
"c33c17be71ae4d588da7369472e5bb1b","4e51676dc72045d99c19b9fa7b22f8bc",22850177,2,-9,0,123,34,29,-5
"4e51676dc72045d99c19b9fa7b22f8bc","93679be414554a11b1893002f2229a93",22850177,1,12,0,124,29,35,6
"93679be414554a11b1893002f2229a93","c33c17be71ae4d588da7369472e5bb1b",22850177,3,-3,0,125,35,34,-1
"c33c17be71ae4d588da7369472e5bb1b","93679be414554a11b1893002f2229a93",22850177,3,3,0,126,34,35,1
"93679be414554a11b1893002f2229a93","7040a13096d746ac84b8fac8d9752058",22850177,2,3,0,127,35,36,1
"7040a13096d746ac84b8fac8d9752058","7040a13096d746ac84b8fac8d9752058",22850177,3,0,1,128,36,36,0
"7040a13096d746ac84b8fac8d9752058","9a0dc646f934470daf08c4b56ccf73db",22850177,2,3,0,129,36,37,1
"9a0dc646f934470daf08c4b56ccf73db","9a0dc646f934470daf08c4b56ccf73db",22850177,3,0,1,130,37,37,0
"9a0dc646f934470daf08c4b56ccf73db","fc0e049d56024bc9a02c9a9c435c3df7",22850177,2,3,0,131,37,38,1
"fc0e049d56024bc9a02c9a9c435c3df7","fc0e049d56024bc9a02c9a9c435c3df7",22850177,2,0,1,132,38,38,0
"fc0e049d56024bc9a02c9a9c435c3df7","67a089198fcb4e1c8f2385786c2b296f",22850177,3,4,0,133,38,39,1
"67a089198fcb4e1c8f2385786c2b296f","64d48c6c9c7940639a932219a6c87198",22850177,3,1,0,134,39,40,1
"64d48c6c9c7940639a932219a6c87198","67a089198fcb4e1c8f2385786c2b296f",22850177,3,-1,0,135,40,39,-1
"64d48c6c9c7940639a932219a6c87198","64d48c6c9c7940639a932219a6c87198",22850177,2,0,1,137,40,40,0
"67a089198fcb4e1c8f2385786c2b296f","b534b89233134e30a9b5645138bfa9ee",22850177,3,4,0,140,39,41,2
"b534b89233134e30a9b5645138bfa9ee","0e37b720d23b4e7f8b313e79313fd107",22850177,1,3,0,141,41,44,3
"0e37b720d23b4e7f8b313e79313fd107","0e37b720d23b4e7f8b313e79313fd107",22850177,1,0,1,142,44,44,0
"0e37b720d23b4e7f8b313e79313fd107","6875d67fdd5f48168b62719df449bebd",22850177,1,1,0,143,44,45,1
"6875d67fdd5f48168b62719df449bebd","6875d67fdd5f48168b62719df449bebd",22850177,1,0,1,144,45,45,0
"6875d67fdd5f48168b62719df449bebd","b534b89233134e30a9b5645138bfa9ee",22850177,1,-4,0,145,45,41,-4
"b534b89233134e30a9b5645138bfa9ee","6e13d61a7bdb44bca949c9f86fab3be5",22850177,2,7,0,146,41,47,6
"6e13d61a7bdb44bca949c9f86fab3be5","6e13d61a7bdb44bca949c9f86fab3be5",22850177,2,0,1,147,47,47,0
"6e13d61a7bdb44bca949c9f86fab3be5","195f78799f984cc2b06c48dfe36be751",22850177,1,2,0,149,47,49,2
"195f78799f984cc2b06c48dfe36be751","195f78799f984cc2b06c48dfe36be751",22850177,3,0,1,150,49,49,0
"195f78799f984cc2b06c48dfe36be751","d0c74f735e024943943e40333d6d337f",22850177,1,3,0,153,49,51,2
"d0c74f735e024943943e40333d6d337f","d9c8d8c444a64dadbbb508652c721e17",22850177,1,-6,0,154,51,46,-5
"d9c8d8c444a64dadbbb508652c721e17","d0c74f735e024943943e40333d6d337f",22850177,2,6,0,155,46,51,5
"d0c74f735e024943943e40333d6d337f","d0c74f735e024943943e40333d6d337f",22850177,1,0,1,156,51,51,0
"d0c74f735e024943943e40333d6d337f","983f8ff320594b279a7f4a6fe132f9c5",22850177,1,2,0,157,51,53,2
"983f8ff320594b279a7f4a6fe132f9c5","983f8ff320594b279a7f4a6fe132f9c5",22850177,2,0,1,158,53,53,0
"983f8ff320594b279a7f4a6fe132f9c5","35adfa5d923046aebabfefd98f35ff05",22850177,1,1,0,160,53,54,1
"35adfa5d923046aebabfefd98f35ff05","35adfa5d923046aebabfefd98f35ff05",22850177,2,0,1,161,54,54,0
"35adfa5d923046aebabfefd98f35ff05","b6f8a98476224da1b40e555ececc7ed8",22850177,1,1,0,163,54,55,1
"b6f8a98476224da1b40e555ececc7ed8","b6f8a98476224da1b40e555ececc7ed8",22850177,2,0,1,164,55,55,0
"b6f8a98476224da1b40e555ececc7ed8","86e22cb5fe0e4b47a9489ecddf7ed78f",22850177,1,1,0,166,55,56,1
"86e22cb5fe0e4b47a9489ecddf7ed78f","86e22cb5fe0e4b47a9489ecddf7ed78f",22850177,2,0,1,167,56,56,0
"86e22cb5fe0e4b47a9489ecddf7ed78f","f924752d8a1149668870b1e7698486f7",22850177,1,-6,0,169,56,50,-6
"a1f2f12debe5432fb7a70bcd12bacfb9","a1f2f12debe5432fb7a70bcd12bacfb9",22850177,10,0,1,173,58,58,0
"78f30e4dcac84e3cbea8b2cc6e0d62b3","78f30e4dcac84e3cbea8b2cc6e0d62b3",22850177,12,0,1,184,59,59,0
"12aa6e1672ac4e7aa6449a7a8609cd72","bc42d26810654ea9a1df1efe1e58c7d5",22850177,1,7,0,197,57,63,6
"a0a418b8540d479fa6e0f653b701da8b","4c943503763e4e349906eea3ed3c8e86",22850177,1,-3,0,199,64,61,-3
"4c943503763e4e349906eea3ed3c8e86","4c943503763e4e349906eea3ed3c8e86",22850177,1,0,1,200,61,61,0
"4c943503763e4e349906eea3ed3c8e86","bc42d26810654ea9a1df1efe1e58c7d5",22850177,1,2,0,201,61,63,2
"309ccf3cc4fe429d9bfbaef53d3fa479","d646286c8051419bbc2e31dd1db55ca8",22850177,1,10,0,210,60,67,7
"d646286c8051419bbc2e31dd1db55ca8","b534b89233134e30a9b5645138bfa9ee",22850177,1,-33,0,211,67,41,-26
"b534b89233134e30a9b5645138bfa9ee","d646286c8051419bbc2e31dd1db55ca8",22850177,1,33,0,212,41,67,26
"d646286c8051419bbc2e31dd1db55ca8","d646286c8051419bbc2e31dd1db55ca8",22850177,2,0,1,213,67,67,0
"d646286c8051419bbc2e31dd1db55ca8","267f883678b24aed855fde42524975d9",22850177,1,4,0,214,67,71,4
"267f883678b24aed855fde42524975d9","267f883678b24aed855fde42524975d9",22850177,1,0,1,215,71,71,0
"267f883678b24aed855fde42524975d9","88fff56d0342490dbef9040750a20f6c",22850177,1,1,0,216,71,72,1
"88fff56d0342490dbef9040750a20f6c","88fff56d0342490dbef9040750a20f6c",22850177,1,0,1,217,72,72,0
"88fff56d0342490dbef9040750a20f6c","adb17b12b66c4a49a85fd34322f7df70",22850177,1,1,0,218,72,73,1
"adb17b12b66c4a49a85fd34322f7df70","adb17b12b66c4a49a85fd34322f7df70",22850177,1,0,1,219,73,73,0
"adb17b12b66c4a49a85fd34322f7df70","d646286c8051419bbc2e31dd1db55ca8",22850177,1,-6,0,220,73,67,-6
"d646286c8051419bbc2e31dd1db55ca8","a2becd407db34b189200a32546d9d569",22850177,2,9,0,221,67,75,8
"a2becd407db34b189200a32546d9d569","a2becd407db34b189200a32546d9d569",22850177,2,0,1,222,75,75,0
"a2becd407db34b189200a32546d9d569","58c22b011d0f4c2ea6d13615edbb9eeb",22850177,1,2,0,224,75,77,2
"58c22b011d0f4c2ea6d13615edbb9eeb","58c22b011d0f4c2ea6d13615edbb9eeb",22850177,2,0,1,225,77,77,0
"58c22b011d0f4c2ea6d13615edbb9eeb","dd76e1861dc9461c830888729d091ee0",22850177,1,1,0,227,77,78,1
"dd76e1861dc9461c830888729d091ee0","dd76e1861dc9461c830888729d091ee0",22850177,2,0,1,228,78,78,0
"dd76e1861dc9461c830888729d091ee0","cd1d828f1a694b87913a7ea66c23803e",22850177,1,1,0,230,78,79,1
"cd1d828f1a694b87913a7ea66c23803e","cd1d828f1a694b87913a7ea66c23803e",22850177,2,0,1,231,79,79,0
"cd1d828f1a694b87913a7ea66c23803e","9176a3c2b4d2465fa8b0c67096c2a97e",22850177,1,1,0,233,79,80,1
"9176a3c2b4d2465fa8b0c67096c2a97e","9176a3c2b4d2465fa8b0c67096c2a97e",22850177,11,0,1,234,80,80,0
"9176a3c2b4d2465fa8b0c67096c2a97e","f8ec6445f7194e25b9101d4fbcb07a18",22850177,1,1,0,245,80,81,1
"f8ec6445f7194e25b9101d4fbcb07a18","f8ec6445f7194e25b9101d4fbcb07a18",22850177,2,0,1,246,81,81,0
"f8ec6445f7194e25b9101d4fbcb07a18","140d5b27b8574befad82c0a013b59dfa",22850177,1,-7,0,248,81,74,-7
"140d5b27b8574befad82c0a013b59dfa","d18a9ea32855445f8736581f5cb119ce",22850177,1,9,0,249,74,82,8
"d18a9ea32855445f8736581f5cb119ce","f564483cbd7a407681aa2fcca518cf5f",22850177,1,4,0,250,82,85,3
"f564483cbd7a407681aa2fcca518cf5f","f564483cbd7a407681aa2fcca518cf5f",22850177,7,0,1,251,85,85,0
"f564483cbd7a407681aa2fcca518cf5f","18fd01350bd5434ca636d59a599d768a",22850177,1,1,0,258,85,86,1
"18fd01350bd5434ca636d59a599d768a","18fd01350bd5434ca636d59a599d768a",22850177,9,0,1,259,86,86,0
"18fd01350bd5434ca636d59a599d768a","ae5ac430ea254e708a6f5deaaf7464ae",22850177,1,-2,0,268,86,84,-2
"ae5ac430ea254e708a6f5deaaf7464ae","6a9f0ef185fb47f0937e29daa1c71ed5",22850177,1,7,0,269,84,90,6
"6a9f0ef185fb47f0937e29daa1c71ed5","d646286c8051419bbc2e31dd1db55ca8",22850177,2,-27,0,270,90,67,-23
"a2becd407db34b189200a32546d9d569","140d5b27b8574befad82c0a013b59dfa",22850177,1,-1,0,273,75,74,-1
"140d5b27b8574befad82c0a013b59dfa","6a9f0ef185fb47f0937e29daa1c71ed5",22850177,1,19,0,274,74,90,16
"6a9f0ef185fb47f0937e29daa1c71ed5","ae5ac430ea254e708a6f5deaaf7464ae",22850177,1,-7,0,275,90,84,-6
"ae5ac430ea254e708a6f5deaaf7464ae","d646286c8051419bbc2e31dd1db55ca8",22850177,1,-20,0,276,84,67,-17
"d646286c8051419bbc2e31dd1db55ca8","6a9f0ef185fb47f0937e29daa1c71ed5",22850177,1,27,0,277,67,90,23
"6a9f0ef185fb47f0937e29daa1c71ed5","42fb58708eaf4e5daa82bfca61b6f5fd",22850177,1,-3,0,278,90,87,-3
"42fb58708eaf4e5daa82bfca61b6f5fd","c681290961c94c4caf23b529d1ae6b9a",22850177,1,1,0,279,87,88,1
"c681290961c94c4caf23b529d1ae6b9a","c681290961c94c4caf23b529d1ae6b9a",22850177,1,0,1,280,88,88,0
"c681290961c94c4caf23b529d1ae6b9a","6a9f0ef185fb47f0937e29daa1c71ed5",22850177,1,2,0,281,88,90,2
"6a9f0ef185fb47f0937e29daa1c71ed5","6a9f0ef185fb47f0937e29daa1c71ed5",22850177,3,0,1,282,90,90,0
"d646286c8051419bbc2e31dd1db55ca8","e20db35ced8544ddac5bc3839145e463",22850177,1,30,0,286,67,91,24
"e20db35ced8544ddac5bc3839145e463","1febb706d7a34005ae8711ed49c76e64",22850177,1,3,0,287,91,94,3
"1febb706d7a34005ae8711ed49c76e64","1febb706d7a34005ae8711ed49c76e64",22850177,2,0,1,288,94,94,0
"1febb706d7a34005ae8711ed49c76e64","8f73ba6f5a0042f2850356ac38ac6f24",22850177,1,1,0,290,94,95,1
"8f73ba6f5a0042f2850356ac38ac6f24","8f73ba6f5a0042f2850356ac38ac6f24",22850177,5,0,1,291,95,95,0
"8f73ba6f5a0042f2850356ac38ac6f24","e2260b86653c46d7b14a41fb419dbf8c",22850177,1,1,0,296,95,96,1
"e2260b86653c46d7b14a41fb419dbf8c","e2260b86653c46d7b14a41fb419dbf8c",22850177,2,0,1,297,96,96,0
"e2260b86653c46d7b14a41fb419dbf8c","35eb641ad1d845bbba54915bce75a962",22850177,1,1,0,299,96,97,1
"35eb641ad1d845bbba54915bce75a962","35eb641ad1d845bbba54915bce75a962",22850177,5,0,1,300,97,97,0
"35eb641ad1d845bbba54915bce75a962","08be90ffbeea4795a138cd42ed8db56f",22850177,1,1,0,305,97,98,1
"08be90ffbeea4795a138cd42ed8db56f","08be90ffbeea4795a138cd42ed8db56f",22850177,7,0,1,306,98,98,0
"08be90ffbeea4795a138cd42ed8db56f","3007433c8f584dcbb5ac159c1c5f2be3",22850177,1,1,0,313,98,99,1
"3007433c8f584dcbb5ac159c1c5f2be3","3007433c8f584dcbb5ac159c1c5f2be3",22850177,5,0,1,314,99,99,0
"3007433c8f584dcbb5ac159c1c5f2be3","00ae5f0c51874a73a41ebea838d95682",22850177,1,3,0,319,99,101,2
"00ae5f0c51874a73a41ebea838d95682","e20db35ced8544ddac5bc3839145e463",22850177,1,-11,0,320,101,91,-10
"e20db35ced8544ddac5bc3839145e463","d391c8b6e56a43a7b654e9dee02d904b",22850177,1,13,0,321,91,103,12
"d391c8b6e56a43a7b654e9dee02d904b","00ae5f0c51874a73a41ebea838d95682",22850177,1,-2,0,322,103,101,-2
"00ae5f0c51874a73a41ebea838d95682","00ae5f0c51874a73a41ebea838d95682",22850177,1,0,1,323,101,101,0
"00ae5f0c51874a73a41ebea838d95682","d391c8b6e56a43a7b654e9dee02d904b",22850177,2,2,0,324,101,103,2
"d391c8b6e56a43a7b654e9dee02d904b","d391c8b6e56a43a7b654e9dee02d904b",22850177,34,0,1,325,103,103,0
"d391c8b6e56a43a7b654e9dee02d904b","e20db35ced8544ddac5bc3839145e463",22850177,1,-13,0,359,103,91,-12
"e20db35ced8544ddac5bc3839145e463","e20db35ced8544ddac5bc3839145e463",22850177,1,0,1,360,91,91,0
"e20db35ced8544ddac5bc3839145e463","00ae5f0c51874a73a41ebea838d95682",22850177,1,11,0,361,91,101,10
"d391c8b6e56a43a7b654e9dee02d904b","6111116566fc4fd9abba409322bea245",22850177,1,1,0,363,103,104,1
"6111116566fc4fd9abba409322bea245","6111116566fc4fd9abba409322bea245",22850177,2,0,1,364,104,104,0
"6111116566fc4fd9abba409322bea245","a81b2235cb9c499eb9ea8ee0a8dd9725",22850177,1,1,0,366,104,105,1
"a81b2235cb9c499eb9ea8ee0a8dd9725","a81b2235cb9c499eb9ea8ee0a8dd9725",22850177,2,0,1,367,105,105,0
"a81b2235cb9c499eb9ea8ee0a8dd9725","2d4e0ab0ef3b4d73b82c72d4621a7579",22850177,1,1,0,369,105,106,1
"2d4e0ab0ef3b4d73b82c72d4621a7579","2d4e0ab0ef3b4d73b82c72d4621a7579",22850177,2,0,1,370,106,106,0
"2d4e0ab0ef3b4d73b82c72d4621a7579","8bdebf492ebd4e62b0d522e8ab5e5197",22850177,1,1,0,372,106,107,1
"8bdebf492ebd4e62b0d522e8ab5e5197","8bdebf492ebd4e62b0d522e8ab5e5197",22850177,2,0,1,373,107,107,0
"8bdebf492ebd4e62b0d522e8ab5e5197","4280927ec4d643238aa49c32f9e06c6c",22850177,1,3,0,375,107,109,2
"4280927ec4d643238aa49c32f9e06c6c","73039f8c1eb9409cb4caee2cf968001e",22850177,1,-10,0,376,109,100,-9
"73039f8c1eb9409cb4caee2cf968001e","4280927ec4d643238aa49c32f9e06c6c",22850177,1,10,0,377,100,109,9
"4280927ec4d643238aa49c32f9e06c6c","4280927ec4d643238aa49c32f9e06c6c",22850177,5,0,1,378,109,109,0
"4280927ec4d643238aa49c32f9e06c6c","e20db35ced8544ddac5bc3839145e463",22850177,1,-20,0,379,109,91,-18
"e20db35ced8544ddac5bc3839145e463","4280927ec4d643238aa49c32f9e06c6c",22850177,2,20,0,380,91,109,18
"4280927ec4d643238aa49c32f9e06c6c","fc44e6a5f7654430af1227838224dceb",22850177,1,2,0,385,109,111,2
"fc44e6a5f7654430af1227838224dceb","fc44e6a5f7654430af1227838224dceb",22850177,2,0,1,386,111,111,0
"fc44e6a5f7654430af1227838224dceb","08111f75e22d409998cf8b85bd431f0a",22850177,1,-3,0,388,111,108,-3
"08111f75e22d409998cf8b85bd431f0a","a9ae0a3c070d455bb4369a8996313336",22850177,2,7,0,389,108,114,6
"a9ae0a3c070d455bb4369a8996313336","a9ae0a3c070d455bb4369a8996313336",22850177,1,0,1,390,114,114,0
"a9ae0a3c070d455bb4369a8996313336","71cec822bcff4f30a20e75dc63ef7b65",22850177,3,2,0,391,114,116,2
"71cec822bcff4f30a20e75dc63ef7b65","71cec822bcff4f30a20e75dc63ef7b65",22850177,3,0,1,392,116,116,0
"71cec822bcff4f30a20e75dc63ef7b65","e20db35ced8544ddac5bc3839145e463",22850177,1,-28,0,393,116,91,-25
"4280927ec4d643238aa49c32f9e06c6c","08111f75e22d409998cf8b85bd431f0a",22850177,1,-1,0,395,109,108,-1
"71cec822bcff4f30a20e75dc63ef7b65","37319e88176d4aefa91d7a9980dbae91",22850177,2,-4,0,398,116,112,-4
"37319e88176d4aefa91d7a9980dbae91","62bff51286ef4f348717a3cf6fe2318f",22850177,2,9,0,399,112,120,8
"62bff51286ef4f348717a3cf6fe2318f","62bff51286ef4f348717a3cf6fe2318f",22850177,8,0,1,400,120,120,0
"62bff51286ef4f348717a3cf6fe2318f","b1cd0e7dc3ad4a8eb91a4bfdbeb025b0",22850177,1,-2,0,404,120,118,-2
"b1cd0e7dc3ad4a8eb91a4bfdbeb025b0","b1cd0e7dc3ad4a8eb91a4bfdbeb025b0",22850177,1,0,1,405,118,118,0
"b1cd0e7dc3ad4a8eb91a4bfdbeb025b0","3ec3a3563847406fa73338f9e9999cf3",22850177,1,-1,0,406,118,117,-1
"3ec3a3563847406fa73338f9e9999cf3","a9ae0a3c070d455bb4369a8996313336",22850177,1,-4,0,407,117,114,-3
"62bff51286ef4f348717a3cf6fe2318f","e20db35ced8544ddac5bc3839145e463",22850177,2,-33,0,415,120,91,-29
"e20db35ced8544ddac5bc3839145e463","779f9ddd1fd14d1e9e69f72219a1fdbd",22850177,3,36,0,416,91,121,30
"779f9ddd1fd14d1e9e69f72219a1fdbd","e20db35ced8544ddac5bc3839145e463",22850177,1,-36,0,417,121,91,-30
"779f9ddd1fd14d1e9e69f72219a1fdbd","62bff51286ef4f348717a3cf6fe2318f",22850177,1,-3,0,419,121,120,-1
"779f9ddd1fd14d1e9e69f72219a1fdbd","ae26e6cda8ad4a3f81bd347560d9579f",22850177,1,4,0,424,121,125,4
"ae26e6cda8ad4a3f81bd347560d9579f","ae26e6cda8ad4a3f81bd347560d9579f",22850177,1,0,1,425,125,125,0
"ae26e6cda8ad4a3f81bd347560d9579f","ee48df95832b4374aa273ceb27ec1315",22850177,1,1,0,426,125,126,1
"ee48df95832b4374aa273ceb27ec1315","ee48df95832b4374aa273ceb27ec1315",22850177,3,0,1,427,126,126,0
"ee48df95832b4374aa273ceb27ec1315","779f9ddd1fd14d1e9e69f72219a1fdbd",22850177,1,-5,0,430,126,121,-5
"779f9ddd1fd14d1e9e69f72219a1fdbd","a8dd5213034441ac92724b4e83eb0bb2",22850177,2,9,0,431,121,129,8
"a8dd5213034441ac92724b4e83eb0bb2","579338175e0b4bbb8ef3b712b5d8b54e",22850177,1,-1,0,432,129,128,-1
"579338175e0b4bbb8ef3b712b5d8b54e","7a439da90b394756ad1777fc4c6dead5",22850177,1,-2,0,433,128,127,-1
"7a439da90b394756ad1777fc4c6dead5","7a439da90b394756ad1777fc4c6dead5",22850177,1,0,1,434,127,127,0
"7a439da90b394756ad1777fc4c6dead5","a8dd5213034441ac92724b4e83eb0bb2",22850177,1,3,0,435,127,129,2
"a8dd5213034441ac92724b4e83eb0bb2","779f9ddd1fd14d1e9e69f72219a1fdbd",22850177,1,-9,0,436,129,121,-8
"779f9ddd1fd14d1e9e69f72219a1fdbd","779f9ddd1fd14d1e9e69f72219a1fdbd",22850177,1,0,1,437,121,121,0
"a8dd5213034441ac92724b4e83eb0bb2","a8dd5213034441ac92724b4e83eb0bb2",22850177,2,0,1,439,129,129,0
"a8dd5213034441ac92724b4e83eb0bb2","8115eab6556b45f5b415c3b8c26a12e5",22850177,1,2,0,441,129,131,2
"8115eab6556b45f5b415c3b8c26a12e5","8115eab6556b45f5b415c3b8c26a12e5",22850177,2,0,1,442,131,131,0
"8115eab6556b45f5b415c3b8c26a12e5","ec34b06efd844b46a4c4818ecdb9b8f4",22850177,1,1,0,444,131,132,1
"ec34b06efd844b46a4c4818ecdb9b8f4","ec34b06efd844b46a4c4818ecdb9b8f4",22850177,5,0,1,445,132,132,0
"ec34b06efd844b46a4c4818ecdb9b8f4","c2e1c2b9eac64109b343a088584b576b",22850177,1,1,0,450,132,133,1
"c2e1c2b9eac64109b343a088584b576b","c2e1c2b9eac64109b343a088584b576b",22850177,2,0,1,451,133,133,0
"c2e1c2b9eac64109b343a088584b576b","579338175e0b4bbb8ef3b712b5d8b54e",22850177,1,-5,0,453,133,128,-5
"579338175e0b4bbb8ef3b712b5d8b54e","8bc5795d6a984a3eace4e2811e52dd4f",22850177,1,8,0,454,128,135,7
"8bc5795d6a984a3eace4e2811e52dd4f","8bc5795d6a984a3eace4e2811e52dd4f",22850177,3,0,1,455,135,135,0
"8bc5795d6a984a3eace4e2811e52dd4f","b416d47c56a742199b5d7c7f19d6503a",22850177,1,-1,0,458,135,134,-1
"b416d47c56a742199b5d7c7f19d6503a","cd4532ad48034873ba8bce2aac0c9808",22850177,1,4,0,459,134,137,3
"cd4532ad48034873ba8bce2aac0c9808","cd4532ad48034873ba8bce2aac0c9808",22850177,1,0,1,460,137,137,0
"cd4532ad48034873ba8bce2aac0c9808","779f9ddd1fd14d1e9e69f72219a1fdbd",22850177,1,-19,0,461,137,121,-16
"779f9ddd1fd14d1e9e69f72219a1fdbd","df1de691dafe4549a18a4398ee9dfaf9",22850177,1,23,0,462,121,139,18
"df1de691dafe4549a18a4398ee9dfaf9","6c5ad271a44743479bfaea29b1db8d02",22850177,1,4,0,463,139,143,4
"6c5ad271a44743479bfaea29b1db8d02","6c5ad271a44743479bfaea29b1db8d02",22850177,3,0,1,464,143,143,0
"6c5ad271a44743479bfaea29b1db8d02","83d311bed5374fee83d8d67a7d9d82dc",22850177,1,1,0,467,143,144,1
"83d311bed5374fee83d8d67a7d9d82dc","83d311bed5374fee83d8d67a7d9d82dc",22850177,7,0,1,468,144,144,0
"83d311bed5374fee83d8d67a7d9d82dc","402bba41861d43acb52a5abb89e8831e",22850177,1,1,0,475,144,145,1
"402bba41861d43acb52a5abb89e8831e","402bba41861d43acb52a5abb89e8831e",22850177,5,0,1,476,145,145,0
"402bba41861d43acb52a5abb89e8831e","8aae34f5ddbb4052a709b12e6b0d40fa",22850177,1,3,0,481,145,147,2
"8aae34f5ddbb4052a709b12e6b0d40fa","df1de691dafe4549a18a4398ee9dfaf9",22850177,1,-9,0,482,147,139,-8
"df1de691dafe4549a18a4398ee9dfaf9","8aae34f5ddbb4052a709b12e6b0d40fa",22850177,1,9,0,483,139,147,8
"8aae34f5ddbb4052a709b12e6b0d40fa","8aae34f5ddbb4052a709b12e6b0d40fa",22850177,2,0,1,484,147,147,0
"8aae34f5ddbb4052a709b12e6b0d40fa","645b3f0249f64f76af2e19eb4d0e55b7",22850177,1,2,0,486,147,149,2
"645b3f0249f64f76af2e19eb4d0e55b7","645b3f0249f64f76af2e19eb4d0e55b7",22850177,8,0,1,487,149,149,0
"645b3f0249f64f76af2e19eb4d0e55b7","7e7b8db5064d4369805ab370aac5ddfb",22850177,1,1,0,495,149,150,1
"7e7b8db5064d4369805ab370aac5ddfb","7e7b8db5064d4369805ab370aac5ddfb",22850177,8,0,1,496,150,150,0
"7e7b8db5064d4369805ab370aac5ddfb","8956d210ae7f41968fada86d4c979d6a",22850177,1,1,0,504,150,151,1
"8956d210ae7f41968fada86d4c979d6a","8956d210ae7f41968fada86d4c979d6a",22850177,2,0,1,505,151,151,0
"8956d210ae7f41968fada86d4c979d6a","f902b0f41b544d4dbf79664fd233648d",22850177,1,-5,0,507,151,146,-5
"f902b0f41b544d4dbf79664fd233648d","ae781e8b775e4ccd93bc800dad5c8376",22850177,1,8,0,508,146,153,7
"ae781e8b775e4ccd93bc800dad5c8376","ae781e8b775e4ccd93bc800dad5c8376",22850177,2,0,1,509,153,153,0
"ae781e8b775e4ccd93bc800dad5c8376","06882a8492d9499aa31555567f575ecb",22850177,1,1,0,511,153,154,1
"06882a8492d9499aa31555567f575ecb","06882a8492d9499aa31555567f575ecb",22850177,2,0,1,512,154,154,0
"06882a8492d9499aa31555567f575ecb","f293c508f409466a8f27ddd7d1e40b20",22850177,1,1,0,514,154,155,1
"f293c508f409466a8f27ddd7d1e40b20","f293c508f409466a8f27ddd7d1e40b20",22850177,5,0,1,515,155,155,0
"f293c508f409466a8f27ddd7d1e40b20","cc4ddef5bbbe48ebb605141b347c4ed1",22850177,1,1,0,520,155,156,1
"cc4ddef5bbbe48ebb605141b347c4ed1","cc4ddef5bbbe48ebb605141b347c4ed1",22850177,5,0,1,521,156,156,0
"cc4ddef5bbbe48ebb605141b347c4ed1","d313cec988a84645bee413e8d4724a4b",22850177,1,3,0,526,156,158,2
"d313cec988a84645bee413e8d4724a4b","f03480cf4eba413194d7af52fc0e7f28",22850177,1,-7,0,527,158,152,-6
"f03480cf4eba413194d7af52fc0e7f28","d313cec988a84645bee413e8d4724a4b",22850177,1,7,0,528,152,158,6
"d313cec988a84645bee413e8d4724a4b","d313cec988a84645bee413e8d4724a4b",22850177,3,0,1,529,158,158,0
"d313cec988a84645bee413e8d4724a4b","dc60696c76a74368a60f72246e47700d",22850177,1,1,0,532,158,159,1
"dc60696c76a74368a60f72246e47700d","dc60696c76a74368a60f72246e47700d",22850177,1,0,1,533,159,159,0
"dc60696c76a74368a60f72246e47700d","df1de691dafe4549a18a4398ee9dfaf9",22850177,1,-23,0,534,159,139,-20
"df1de691dafe4549a18a4398ee9dfaf9","78adeee1fa2c4fe0bc73f7bca9fcee86",22850177,1,26,0,535,139,160,21
"78adeee1fa2c4fe0bc73f7bca9fcee86","78adeee1fa2c4fe0bc73f7bca9fcee86",22850177,3,0,1,536,160,160,0
"65202579580f4ad38d734b4ee39d22a8","78adeee1fa2c4fe0bc73f7bca9fcee86",22850177,2,-5,0,545,164,160,-4
"78adeee1fa2c4fe0bc73f7bca9fcee86","3cbcea2be0984e7dbd5a48195af10ce7",22850177,2,8,0,546,160,165,5
"3cbcea2be0984e7dbd5a48195af10ce7","82e6285962b8400d9d6fc32436022a94",22850177,3,2,0,547,165,167,2
"82e6285962b8400d9d6fc32436022a94","3cbcea2be0984e7dbd5a48195af10ce7",22850177,4,-2,0,548,167,165,-2
"a9ac840f098c4bd0a2ee896214ce29cd","a9ac840f098c4bd0a2ee896214ce29cd",22850177,4,0,1,550,168,168,0
"b2275c3fad834f8d90737a2d9a6927d6","1202ed221196417faa16c4348aed3971",22850177,1,-2,0,553,172,170,-2
"1202ed221196417faa16c4348aed3971","1202ed221196417faa16c4348aed3971",22850177,1,0,1,554,170,170,0
"1202ed221196417faa16c4348aed3971","0c7262dff33c4087bc660ccf40f92f9c",22850177,1,-1,0,555,170,169,-1
"0c7262dff33c4087bc660ccf40f92f9c","a9ac840f098c4bd0a2ee896214ce29cd",22850177,1,-4,0,560,169,168,-1
"a9ac840f098c4bd0a2ee896214ce29cd","82e6285962b8400d9d6fc32436022a94",22850177,1,-3,0,563,168,167,-1
"65202579580f4ad38d734b4ee39d22a8","0c7262dff33c4087bc660ccf40f92f9c",22850177,1,12,0,574,164,169,5
"b2275c3fad834f8d90737a2d9a6927d6","b2275c3fad834f8d90737a2d9a6927d6",22850177,63,0,1,576,172,172,0
"b2275c3fad834f8d90737a2d9a6927d6","eb515a26030b41f8a82a1e6114420bad",22850177,1,1,0,639,172,173,1
"eb515a26030b41f8a82a1e6114420bad","eb515a26030b41f8a82a1e6114420bad",22850177,2,0,1,640,173,173,0
"eb515a26030b41f8a82a1e6114420bad","b42cc17b7de840f181a704558d0bc845",22850177,1,3,0,642,173,175,2
"b42cc17b7de840f181a704558d0bc845","b42cc17b7de840f181a704558d0bc845",22850177,2,0,1,645,175,175,0
"b42cc17b7de840f181a704558d0bc845","801f9e9135034f49bf5f8b4bdefedb41",22850177,1,2,0,647,175,177,2
"801f9e9135034f49bf5f8b4bdefedb41","801f9e9135034f49bf5f8b4bdefedb41",22850177,11,0,1,648,177,177,0
"801f9e9135034f49bf5f8b4bdefedb41","ea38cc0e6e6e41edbabf210220808bf9",22850177,1,3,0,659,177,179,2
"ea38cc0e6e6e41edbabf210220808bf9","362fcb0699a14845ab29b2340093e528",22850177,1,-6,0,660,179,174,-5
"362fcb0699a14845ab29b2340093e528","b87c552dd247427abe6ab5795b9c9d43",22850177,1,8,0,661,174,181,7
"b87c552dd247427abe6ab5795b9c9d43","ea38cc0e6e6e41edbabf210220808bf9",22850177,1,-2,0,662,181,179,-2
"ea38cc0e6e6e41edbabf210220808bf9","ea38cc0e6e6e41edbabf210220808bf9",22850177,1,0,1,663,179,179,0
"b87c552dd247427abe6ab5795b9c9d43","b87c552dd247427abe6ab5795b9c9d43",22850177,9,0,1,665,181,181,0
"139b097acfca451689d80c9c6eebdf7b","30f660a1feb34582a739722532524f79",22850177,2,6,0,675,178,183,5
"30f660a1feb34582a739722532524f79","30f660a1feb34582a739722532524f79",22850177,8,0,1,676,183,183,0
"30f660a1feb34582a739722532524f79","2024b4885bd14338a39b7b509acbbd02",22850177,2,-1,0,677,183,182,-1
"2024b4885bd14338a39b7b509acbbd02","ea38cc0e6e6e41edbabf210220808bf9",22850177,1,-4,0,678,182,179,-3
"30f660a1feb34582a739722532524f79","0c7262dff33c4087bc660ccf40f92f9c",22850177,1,-17,0,683,183,169,-14
"0c7262dff33c4087bc660ccf40f92f9c","30f660a1feb34582a739722532524f79",22850177,1,17,0,684,169,183,14
"2024b4885bd14338a39b7b509acbbd02","c3f63fe50d8e487c86bf8ef76c9cadd3",22850177,1,4,0,692,182,185,3
"c3f63fe50d8e487c86bf8ef76c9cadd3","c3f63fe50d8e487c86bf8ef76c9cadd3",22850177,2,0,1,693,185,185,0
"c3f63fe50d8e487c86bf8ef76c9cadd3","0c7262dff33c4087bc660ccf40f92f9c",22850177,1,-20,0,694,185,169,-16
"0c7262dff33c4087bc660ccf40f92f9c","c3f63fe50d8e487c86bf8ef76c9cadd3",22850177,1,20,0,695,169,185,16
"c3f63fe50d8e487c86bf8ef76c9cadd3","c8e371568a0c4391b25796ae4e91952e",22850177,1,3,0,697,185,186,1
"c8e371568a0c4391b25796ae4e91952e","0c7262dff33c4087bc660ccf40f92f9c",22850177,1,-23,0,698,186,169,-17
"0c7262dff33c4087bc660ccf40f92f9c","7d932b23e1c84326ae5aa4d3c0d813d1",22850177,1,25,0,699,169,188,19
"7d932b23e1c84326ae5aa4d3c0d813d1","7d932b23e1c84326ae5aa4d3c0d813d1",22850177,1,0,1,700,188,188,0
"7d932b23e1c84326ae5aa4d3c0d813d1","c8e371568a0c4391b25796ae4e91952e",22850177,1,-2,0,701,188,186,-2
"ab11d94c6c8948ea90b88f19d2cd502b","ab11d94c6c8948ea90b88f19d2cd502b",22850177,1,0,1,703,190,190,0
"ab11d94c6c8948ea90b88f19d2cd502b","f992451ed6ad4e68bb9e68ad6be7c4be",22850177,1,2,0,704,190,192,2
"f992451ed6ad4e68bb9e68ad6be7c4be","f992451ed6ad4e68bb9e68ad6be7c4be",22850177,3,0,1,705,192,192,0
"f992451ed6ad4e68bb9e68ad6be7c4be","6cd2dcaac46847d4a0bc53f296d90375",22850177,1,3,0,708,192,194,2
"6cd2dcaac46847d4a0bc53f296d90375","07b44a7a51e94c78b411c753fc39dab0",22850177,1,-6,0,709,194,189,-5
"07b44a7a51e94c78b411c753fc39dab0","2d2580c9411c4972909db508d6956a58",22850177,1,8,0,710,189,196,7
"2d2580c9411c4972909db508d6956a58","2d2580c9411c4972909db508d6956a58",22850177,5,0,1,711,196,196,0
"2d2580c9411c4972909db508d6956a58","5bddb3d9ed264f3984702f048c7e5340",22850177,1,1,0,716,196,197,1
"5bddb3d9ed264f3984702f048c7e5340","5bddb3d9ed264f3984702f048c7e5340",22850177,2,0,1,717,197,197,0
"5bddb3d9ed264f3984702f048c7e5340","d5e8e2bd12a2466b9d6d90855f0eb079",22850177,1,1,0,719,197,198,1
"d5e8e2bd12a2466b9d6d90855f0eb079","d5e8e2bd12a2466b9d6d90855f0eb079",22850177,2,0,1,720,198,198,0
"d5e8e2bd12a2466b9d6d90855f0eb079","017d7ca8e0394b91aaadc9574df2202c",22850177,1,-5,0,722,198,193,-5
"017d7ca8e0394b91aaadc9574df2202c","54e8e9f0ea3e45c4bf3b8ac799ee31b1",22850177,1,8,0,723,193,200,7
"54e8e9f0ea3e45c4bf3b8ac799ee31b1","54e8e9f0ea3e45c4bf3b8ac799ee31b1",22850177,1,0,1,724,200,200,0
"54e8e9f0ea3e45c4bf3b8ac799ee31b1","c614a00911be4877a075f19315530fb0",22850177,1,1,0,725,200,201,1
"c614a00911be4877a075f19315530fb0","c614a00911be4877a075f19315530fb0",22850177,6,0,1,726,201,201,0
"c614a00911be4877a075f19315530fb0","a6c21bd8b95249c7972820a7a7d76aff",22850177,1,1,0,732,201,202,1
"a6c21bd8b95249c7972820a7a7d76aff","a6c21bd8b95249c7972820a7a7d76aff",22850177,1,0,1,733,202,202,0
"a6c21bd8b95249c7972820a7a7d76aff","c8e371568a0c4391b25796ae4e91952e",22850177,1,-19,0,734,202,186,-16
"c8e371568a0c4391b25796ae4e91952e","bb329d880ab54120adaf203a693bb203",22850177,1,20,0,735,186,203,17
"bb329d880ab54120adaf203a693bb203","bb329d880ab54120adaf203a693bb203",22850177,1,0,1,736,203,203,0
"bb329d880ab54120adaf203a693bb203","f9170dd6bc6442b4acd832747609b09a",22850177,1,-4,0,737,203,199,-4
"f9170dd6bc6442b4acd832747609b09a","b54257a550b94ebc9538f3a90eee9d7e",22850177,1,6,0,738,199,204,5
"b54257a550b94ebc9538f3a90eee9d7e","f9170dd6bc6442b4acd832747609b09a",22850177,2,-6,0,739,204,199,-5
"c8e371568a0c4391b25796ae4e91952e","a9ac840f098c4bd0a2ee896214ce29cd",22850177,1,-27,0,741,186,168,-18
"65202579580f4ad38d734b4ee39d22a8","c8e371568a0c4391b25796ae4e91952e",22850177,1,35,0,756,164,186,22
"c8e371568a0c4391b25796ae4e91952e","78adeee1fa2c4fe0bc73f7bca9fcee86",22850177,1,-40,0,757,186,160,-26
"362fcb0699a14845ab29b2340093e528","b2275c3fad834f8d90737a2d9a6927d6",22850177,1,-3,0,830,174,172,-2
"b2275c3fad834f8d90737a2d9a6927d6","b42cc17b7de840f181a704558d0bc845",22850177,1,4,0,831,172,175,3
"f9170dd6bc6442b4acd832747609b09a","334c2344009840079b1d0e1b7ce3d5a7",22850177,2,7,0,846,199,205,6
"334c2344009840079b1d0e1b7ce3d5a7","334c2344009840079b1d0e1b7ce3d5a7",22850177,3,0,1,847,205,205,0
"334c2344009840079b1d0e1b7ce3d5a7","b54257a550b94ebc9538f3a90eee9d7e",22850177,1,-1,0,850,205,204,-1
"334c2344009840079b1d0e1b7ce3d5a7","c8e371568a0c4391b25796ae4e91952e",22850177,1,-23,0,860,205,186,-19
"b9e80f77c3a44349863b19875725c384","b9e80f77c3a44349863b19875725c384",22850177,36,0,1,864,207,207,0
"7108f0e4c2584f1f9c471689ae4c885c","7108f0e4c2584f1f9c471689ae4c885c",22850177,12,0,1,901,208,208,0
"09400e101c5d4b439cf9a26b03aae558","09400e101c5d4b439cf9a26b03aae558",22850177,1,0,1,915,210,210,0
"09400e101c5d4b439cf9a26b03aae558","a88efa7e50ce47159810ab553afa6d3a",22850177,1,2,0,916,210,212,2
"a88efa7e50ce47159810ab553afa6d3a","a88efa7e50ce47159810ab553afa6d3a",22850177,3,0,1,917,212,212,0
"a88efa7e50ce47159810ab553afa6d3a","a875096404ef4a9984b62d74cda916f9",22850177,1,-3,0,920,212,209,-3
"f7fb1952f56b4189b86a9f8b7862d2b8","be502a7a43c44bf7b682698de79d9369",22850177,1,-1,0,923,215,214,-1
"f7fb1952f56b4189b86a9f8b7862d2b8","f7fb1952f56b4189b86a9f8b7862d2b8",22850177,15,0,1,925,215,215,0
"f7fb1952f56b4189b86a9f8b7862d2b8","b860ee85d8bc4a2f97958cfb71be3533",22850177,1,1,0,940,215,216,1
"b860ee85d8bc4a2f97958cfb71be3533","b860ee85d8bc4a2f97958cfb71be3533",22850177,8,0,1,941,216,216,0
"b860ee85d8bc4a2f97958cfb71be3533","ec341f459285443b8361f7f15638ff08",22850177,1,-3,0,949,216,213,-3
"363837c182e04711840d896ae1e0339c","363837c182e04711840d896ae1e0339c",22850177,19,0,1,951,218,218,0
"01b2051f8941460d89945e3b02d1ce78","91125ca626c5470eb145501f8c37f8db",22850177,1,4,0,971,217,220,3
"91125ca626c5470eb145501f8c37f8db","91125ca626c5470eb145501f8c37f8db",22850177,1,0,1,972,220,220,0
"91125ca626c5470eb145501f8c37f8db","d7f13c8d63ec4e2aa673fbb9cf9c6933",22850177,1,-18,0,973,220,206,-14
"77ecef8eff6b4a2caea7707669bf7475","77ecef8eff6b4a2caea7707669bf7475",22850177,12,0,1,976,222,222,0
"d03cb855c70044cf8c35d9ec0de696e3","a49a937d6896486d9a5396654abcf2e1",22850177,1,2,0,992,224,226,2
"a49a937d6896486d9a5396654abcf2e1","a49a937d6896486d9a5396654abcf2e1",22850177,1,0,1,993,226,226,0
"a49a937d6896486d9a5396654abcf2e1","8b9ae98743bd4d4a8a87dff1c1244211",22850177,1,1,0,994,226,227,1
"8b9ae98743bd4d4a8a87dff1c1244211","8b9ae98743bd4d4a8a87dff1c1244211",22850177,22,0,1,1000,227,227,0
"8b9ae98743bd4d4a8a87dff1c1244211","2ab1535aac1346ba8801535bf729ef37",22850177,3,3,0,1017,227,229,2
"2ab1535aac1346ba8801535bf729ef37","f7906d6f59b9489a91d2ef40db5a474d",22850177,4,-7,0,1018,229,223,-6
"f7906d6f59b9489a91d2ef40db5a474d","2ab1535aac1346ba8801535bf729ef37",22850177,1,7,0,1019,223,229,6
"2ab1535aac1346ba8801535bf729ef37","a4f40fb48a8542c8949bae1f002cd9bc",22850177,1,2,0,1020,229,231,2
"a4f40fb48a8542c8949bae1f002cd9bc","a4f40fb48a8542c8949bae1f002cd9bc",22850177,2,0,1,1021,231,231,0
"a4f40fb48a8542c8949bae1f002cd9bc","8972c23e32044edb8a78fa1eed4e5947",22850177,1,1,0,1023,231,232,1
"8972c23e32044edb8a78fa1eed4e5947","8972c23e32044edb8a78fa1eed4e5947",22850177,1,0,1,1024,232,232,0
"8972c23e32044edb8a78fa1eed4e5947","92feb4a40f8344d38b6f722e42a53295",22850177,1,1,0,1025,232,233,1
"92feb4a40f8344d38b6f722e42a53295","92feb4a40f8344d38b6f722e42a53295",22850177,2,0,1,1026,233,233,0
"92feb4a40f8344d38b6f722e42a53295","5152833676bf4c6cb317060be10f68db",22850177,1,-5,0,1028,233,228,-5
"5152833676bf4c6cb317060be10f68db","ca3e28f290354c08aefe5b0f769604e6",22850177,1,8,0,1029,228,235,7
"ca3e28f290354c08aefe5b0f769604e6","ca3e28f290354c08aefe5b0f769604e6",22850177,4,0,1,1030,235,235,0
"ca3e28f290354c08aefe5b0f769604e6","79a35eea833e4c2c9d22fc53c3c6445c",22850177,1,1,0,1034,235,236,1
"79a35eea833e4c2c9d22fc53c3c6445c","79a35eea833e4c2c9d22fc53c3c6445c",22850177,4,0,1,1035,236,236,0
"79a35eea833e4c2c9d22fc53c3c6445c","c8e371568a0c4391b25796ae4e91952e",22850177,1,-65,0,1039,236,186,-50
"c8e371568a0c4391b25796ae4e91952e","c8e371568a0c4391b25796ae4e91952e",22850177,3,0,1,1040,186,186,0
"c8e371568a0c4391b25796ae4e91952e","ab11d94c6c8948ea90b88f19d2cd502b",22850177,5,5,0,1041,186,190,4
"ab11d94c6c8948ea90b88f19d2cd502b","07b44a7a51e94c78b411c753fc39dab0",22850177,3,-1,0,1042,190,189,-1
"07b44a7a51e94c78b411c753fc39dab0","6cd2dcaac46847d4a0bc53f296d90375",22850177,4,6,0,1043,189,194,5
"6cd2dcaac46847d4a0bc53f296d90375","017d7ca8e0394b91aaadc9574df2202c",22850177,4,-1,0,1044,194,193,-1
"017d7ca8e0394b91aaadc9574df2202c","f9170dd6bc6442b4acd832747609b09a",22850177,4,7,0,1045,193,199,6
"f9170dd6bc6442b4acd832747609b09a","d7f13c8d63ec4e2aa673fbb9cf9c6933",22850177,1,10,0,1046,199,206,7
"d7f13c8d63ec4e2aa673fbb9cf9c6933","c8e371568a0c4391b25796ae4e91952e",22850177,1,-26,0,1047,206,186,-20
"c8e371568a0c4391b25796ae4e91952e","b9e80f77c3a44349863b19875725c384",22850177,1,27,0,1048,186,207,21
"b9e80f77c3a44349863b19875725c384","7108f0e4c2584f1f9c471689ae4c885c",22850177,2,1,0,1049,207,208,1
"7108f0e4c2584f1f9c471689ae4c885c","d7f13c8d63ec4e2aa673fbb9cf9c6933",22850177,2,-2,0,1050,208,206,-2
"d7f13c8d63ec4e2aa673fbb9cf9c6933","09400e101c5d4b439cf9a26b03aae558",22850177,2,5,0,1051,206,210,4
"09400e101c5d4b439cf9a26b03aae558","a875096404ef4a9984b62d74cda916f9",22850177,1,-1,0,1052,210,209,-1
"a875096404ef4a9984b62d74cda916f9","be502a7a43c44bf7b682698de79d9369",22850177,2,6,0,1053,209,214,5
"be502a7a43c44bf7b682698de79d9369","f7fb1952f56b4189b86a9f8b7862d2b8",22850177,4,1,0,1054,214,215,1
"f7fb1952f56b4189b86a9f8b7862d2b8","363837c182e04711840d896ae1e0339c",22850177,1,4,0,1055,215,218,3
"363837c182e04711840d896ae1e0339c","ec341f459285443b8361f7f15638ff08",22850177,1,-6,0,1056,218,213,-5
"ec341f459285443b8361f7f15638ff08","01b2051f8941460d89945e3b02d1ce78",22850177,1,5,0,1057,213,217,4
"01b2051f8941460d89945e3b02d1ce78","d7f13c8d63ec4e2aa673fbb9cf9c6933",22850177,1,-14,0,1058,217,206,-11
"d7f13c8d63ec4e2aa673fbb9cf9c6933","1c6721b1f63f4d30ba7746ea8af02a52",22850177,2,21,0,1059,206,221,15
"1c6721b1f63f4d30ba7746ea8af02a52","77ecef8eff6b4a2caea7707669bf7475",22850177,3,1,0,1060,221,222,1
"77ecef8eff6b4a2caea7707669bf7475","d03cb855c70044cf8c35d9ec0de696e3",22850177,1,3,0,1061,222,224,2
"d03cb855c70044cf8c35d9ec0de696e3","1c6721b1f63f4d30ba7746ea8af02a52",22850177,2,-4,0,1062,224,221,-3
"1c6721b1f63f4d30ba7746ea8af02a52","8b9ae98743bd4d4a8a87dff1c1244211",22850177,1,7,0,1063,221,227,6
"f7906d6f59b9489a91d2ef40db5a474d","5152833676bf4c6cb317060be10f68db",22850177,3,6,0,1066,223,228,5
"5152833676bf4c6cb317060be10f68db","8f68228b1518449e9615cdafee41a2bd",22850177,1,10,0,1067,228,237,9
"8f68228b1518449e9615cdafee41a2bd","8f68228b1518449e9615cdafee41a2bd",22850177,1,0,1,1068,237,237,0
"8f68228b1518449e9615cdafee41a2bd","cab89fa5c3ed45a5aa550fc0352d6a42",22850177,1,1,0,1069,237,238,1
"cab89fa5c3ed45a5aa550fc0352d6a42","cab89fa5c3ed45a5aa550fc0352d6a42",22850177,1,0,1,1070,238,238,0
"cab89fa5c3ed45a5aa550fc0352d6a42","1c6721b1f63f4d30ba7746ea8af02a52",22850177,1,-20,0,1071,238,221,-17
"77ecef8eff6b4a2caea7707669bf7475","1c6721b1f63f4d30ba7746ea8af02a52",22850177,2,-1,0,1073,222,221,-1
"1c6721b1f63f4d30ba7746ea8af02a52","d03cb855c70044cf8c35d9ec0de696e3",22850177,2,4,0,1074,221,224,3
"d03cb855c70044cf8c35d9ec0de696e3","8b9ae98743bd4d4a8a87dff1c1244211",22850177,2,3,0,1075,224,227,3
"5152833676bf4c6cb317060be10f68db","66d4fad4f1cf4b46be0750a99ad7a35a",22850177,1,12,0,1079,228,239,11
"66d4fad4f1cf4b46be0750a99ad7a35a","66d4fad4f1cf4b46be0750a99ad7a35a",22850177,1,0,1,1080,239,239,0
"66d4fad4f1cf4b46be0750a99ad7a35a","0b04c8e2f86d48c7aeb7e225819cd32b",22850177,1,-5,0,1081,239,234,-5
"0b04c8e2f86d48c7aeb7e225819cd32b","1c6721b1f63f4d30ba7746ea8af02a52",22850177,2,-16,0,1082,234,221,-13
"1c6721b1f63f4d30ba7746ea8af02a52","f53da5fd9bfe412da4b80d4742563b6c",22850177,1,24,0,1083,221,241,20
"f53da5fd9bfe412da4b80d4742563b6c","f53da5fd9bfe412da4b80d4742563b6c",22850177,1,0,1,1084,241,241,0
"f53da5fd9bfe412da4b80d4742563b6c","1c6721b1f63f4d30ba7746ea8af02a52",22850177,1,-24,0,1085,241,221,-20
"1c6721b1f63f4d30ba7746ea8af02a52","2ae94c0cea4d480a9d5dca8fb1d7b542",22850177,2,27,0,1086,221,242,21
"2ae94c0cea4d480a9d5dca8fb1d7b542","1ebf23f9d994469a85206e4c7b1bf5f5",22850177,2,3,0,1087,242,245,3
"1ebf23f9d994469a85206e4c7b1bf5f5","1ebf23f9d994469a85206e4c7b1bf5f5",22850177,11,0,1,1088,245,245,0
"1ebf23f9d994469a85206e4c7b1bf5f5","85ae675b83e8422da842cfd25596af99",22850177,1,1,0,1099,245,246,1
"85ae675b83e8422da842cfd25596af99","85ae675b83e8422da842cfd25596af99",22850177,1,0,1,1100,246,246,0
"85ae675b83e8422da842cfd25596af99","fa235f0f364d47e4ae1c87f47bf8e6ba",22850177,1,8,0,1101,246,252,6
"fa235f0f364d47e4ae1c87f47bf8e6ba","2ae94c0cea4d480a9d5dca8fb1d7b542",22850177,1,-12,0,1102,252,242,-10
"2ae94c0cea4d480a9d5dca8fb1d7b542","fa235f0f364d47e4ae1c87f47bf8e6ba",22850177,2,12,0,1103,242,252,10
"fa235f0f364d47e4ae1c87f47bf8e6ba","79f7845465cc4ed19d8e4f1429541be0",22850177,1,2,0,1104,252,254,2
"79f7845465cc4ed19d8e4f1429541be0","79f7845465cc4ed19d8e4f1429541be0",22850177,2,0,1,1105,254,254,0
"79f7845465cc4ed19d8e4f1429541be0","00f61990949545828dd12f1303d47504",22850177,1,3,0,1107,254,256,2
"00f61990949545828dd12f1303d47504","6e83e23f56544a19b94067c1c558d9c0",22850177,2,-11,0,1108,256,247,-9
"6e83e23f56544a19b94067c1c558d9c0","00f61990949545828dd12f1303d47504",22850177,1,11,0,1109,247,256,9
"00f61990949545828dd12f1303d47504","ead7bb4b64e247d2ae632ab8a296b091",22850177,1,2,0,1110,256,258,2
"ead7bb4b64e247d2ae632ab8a296b091","ead7bb4b64e247d2ae632ab8a296b091",22850177,2,0,1,1111,258,258,0
"ead7bb4b64e247d2ae632ab8a296b091","41b0048dde734bb280bac6116baa8e27",22850177,1,1,0,1113,258,259,1
"41b0048dde734bb280bac6116baa8e27","41b0048dde734bb280bac6116baa8e27",22850177,2,0,1,1114,259,259,0
"41b0048dde734bb280bac6116baa8e27","b41c5a094a604ee0915327da5cc0beb7",22850177,1,1,0,1116,259,260,1
"b41c5a094a604ee0915327da5cc0beb7","b41c5a094a604ee0915327da5cc0beb7",22850177,2,0,1,1117,260,260,0
"b41c5a094a604ee0915327da5cc0beb7","d546341988904f069cfa86b21457d9d9",22850177,1,-10,0,1119,260,251,-9
"d546341988904f069cfa86b21457d9d9","28c171777c52431ab6b925073bd63d46",22850177,1,15,0,1120,251,264,13
"28c171777c52431ab6b925073bd63d46","28c171777c52431ab6b925073bd63d46",22850177,3,0,1,1121,264,264,0
"28c171777c52431ab6b925073bd63d46","ac160db940cb49ae8579162b1d52bb5d",22850177,1,2,0,1124,264,266,2
"ac160db940cb49ae8579162b1d52bb5d","ac160db940cb49ae8579162b1d52bb5d",22850177,7,0,1,1125,266,266,0
"ac160db940cb49ae8579162b1d52bb5d","d989ebcfc12a4b669f0100dc1aa14f1e",22850177,1,-12,0,1132,266,255,-11
"d989ebcfc12a4b669f0100dc1aa14f1e","c6fd49b485cc4874b0bbdd9c6171e09c",22850177,1,15,0,1133,255,268,13
"c6fd49b485cc4874b0bbdd9c6171e09c","c6fd49b485cc4874b0bbdd9c6171e09c",22850177,7,0,1,1134,268,268,0
"c6fd49b485cc4874b0bbdd9c6171e09c","44240778a97c4af0937817499b75707b",22850177,1,1,0,1141,268,269,1
"44240778a97c4af0937817499b75707b","44240778a97c4af0937817499b75707b",22850177,2,0,1,1142,269,269,0
"44240778a97c4af0937817499b75707b","7aa76d3e993840d8805f097cbdbcd44b",22850177,1,-9,0,1144,269,261,-8
"7aa76d3e993840d8805f097cbdbcd44b","865a4d3b43374da7944dc7d397f566d9",22850177,1,12,0,1145,261,271,10
"865a4d3b43374da7944dc7d397f566d9","865a4d3b43374da7944dc7d397f566d9",22850177,1,0,1,1146,271,271,0
"865a4d3b43374da7944dc7d397f566d9","2ae94c0cea4d480a9d5dca8fb1d7b542",22850177,1,-35,0,1147,271,242,-29
"2ae94c0cea4d480a9d5dca8fb1d7b542","0d987bed3ffa4ed0b9a2e62e97b7b30f",22850177,2,38,0,1148,242,272,30
"0d987bed3ffa4ed0b9a2e62e97b7b30f","78adeee1fa2c4fe0bc73f7bca9fcee86",22850177,1,-152,0,1149,272,160,-112
"78adeee1fa2c4fe0bc73f7bca9fcee86","65202579580f4ad38d734b4ee39d22a8",22850177,5,5,0,1150,160,164,4
"65202579580f4ad38d734b4ee39d22a8","65202579580f4ad38d734b4ee39d22a8",22850177,88,0,1,1151,164,164,0
"65202579580f4ad38d734b4ee39d22a8","3cbcea2be0984e7dbd5a48195af10ce7",22850177,1,3,0,1160,164,165,1
"3cbcea2be0984e7dbd5a48195af10ce7","78adeee1fa2c4fe0bc73f7bca9fcee86",22850177,3,-8,0,1161,165,160,-5
"78adeee1fa2c4fe0bc73f7bca9fcee86","82e6285962b8400d9d6fc32436022a94",22850177,1,10,0,1162,160,167,7
"82e6285962b8400d9d6fc32436022a94","a9ac840f098c4bd0a2ee896214ce29cd",22850177,1,3,0,1163,167,168,1
"a9ac840f098c4bd0a2ee896214ce29cd","3cbcea2be0984e7dbd5a48195af10ce7",22850177,3,-5,0,1164,168,165,-3
"3cbcea2be0984e7dbd5a48195af10ce7","a9ac840f098c4bd0a2ee896214ce29cd",22850177,4,5,0,1165,165,168,3
"a9ac840f098c4bd0a2ee896214ce29cd","0c7262dff33c4087bc660ccf40f92f9c",22850177,3,4,0,1166,168,169,1
"0c7262dff33c4087bc660ccf40f92f9c","b2275c3fad834f8d90737a2d9a6927d6",22850177,6,3,0,1167,169,172,3
"b2275c3fad834f8d90737a2d9a6927d6","0c7262dff33c4087bc660ccf40f92f9c",22850177,4,-3,0,1168,172,169,-3
"0c7262dff33c4087bc660ccf40f92f9c","b42cc17b7de840f181a704558d0bc845",22850177,3,7,0,1169,169,175,6
"b42cc17b7de840f181a704558d0bc845","0c7262dff33c4087bc660ccf40f92f9c",22850177,3,-7,0,1170,175,169,-6
"0c7262dff33c4087bc660ccf40f92f9c","0c7262dff33c4087bc660ccf40f92f9c",22850177,1,0,1,1171,169,169,0
"0c7262dff33c4087bc660ccf40f92f9c","362fcb0699a14845ab29b2340093e528",22850177,2,6,0,1172,169,174,5
"362fcb0699a14845ab29b2340093e528","b42cc17b7de840f181a704558d0bc845",22850177,1,1,0,1173,174,175,1
"b42cc17b7de840f181a704558d0bc845","362fcb0699a14845ab29b2340093e528",22850177,2,-1,0,1174,175,174,-1
"362fcb0699a14845ab29b2340093e528","ea38cc0e6e6e41edbabf210220808bf9",22850177,2,6,0,1175,174,179,5
"ea38cc0e6e6e41edbabf210220808bf9","b87c552dd247427abe6ab5795b9c9d43",22850177,5,2,0,1176,179,181,2
"b87c552dd247427abe6ab5795b9c9d43","139b097acfca451689d80c9c6eebdf7b",22850177,4,-3,0,1177,181,178,-3
"139b097acfca451689d80c9c6eebdf7b","ea38cc0e6e6e41edbabf210220808bf9",22850177,1,1,0,1178,178,179,1
"b87c552dd247427abe6ab5795b9c9d43","2024b4885bd14338a39b7b509acbbd02",22850177,1,2,0,1180,181,182,1
"2024b4885bd14338a39b7b509acbbd02","139b097acfca451689d80c9c6eebdf7b",22850177,1,-5,0,1181,182,178,-4
"139b097acfca451689d80c9c6eebdf7b","2024b4885bd14338a39b7b509acbbd02",22850177,2,5,0,1182,178,182,4
"2024b4885bd14338a39b7b509acbbd02","0c7262dff33c4087bc660ccf40f92f9c",22850177,2,-16,0,1183,182,169,-13
"0c7262dff33c4087bc660ccf40f92f9c","c8e371568a0c4391b25796ae4e91952e",22850177,2,23,0,1184,169,186,17
"ab11d94c6c8948ea90b88f19d2cd502b","c8e371568a0c4391b25796ae4e91952e",22850177,1,-5,0,1186,190,186,-4
"c8e371568a0c4391b25796ae4e91952e","07b44a7a51e94c78b411c753fc39dab0",22850177,1,4,0,1187,186,189,3
"f9170dd6bc6442b4acd832747609b09a","c8e371568a0c4391b25796ae4e91952e",22850177,3,-16,0,1191,199,186,-13
"c8e371568a0c4391b25796ae4e91952e","d7f13c8d63ec4e2aa673fbb9cf9c6933",22850177,2,26,0,1192,186,206,20
"d7f13c8d63ec4e2aa673fbb9cf9c6933","7108f0e4c2584f1f9c471689ae4c885c",22850177,2,2,0,1193,206,208,2
"7108f0e4c2584f1f9c471689ae4c885c","b9e80f77c3a44349863b19875725c384",22850177,2,-1,0,1194,208,207,-1
"b9e80f77c3a44349863b19875725c384","09400e101c5d4b439cf9a26b03aae558",22850177,1,4,0,1195,207,210,3
"09400e101c5d4b439cf9a26b03aae558","d7f13c8d63ec4e2aa673fbb9cf9c6933",22850177,1,-5,0,1196,210,206,-4
"d7f13c8d63ec4e2aa673fbb9cf9c6933","be502a7a43c44bf7b682698de79d9369",22850177,1,10,0,1197,206,214,8
"f7fb1952f56b4189b86a9f8b7862d2b8","a875096404ef4a9984b62d74cda916f9",22850177,1,-7,0,1199,215,209,-6
"a875096404ef4a9984b62d74cda916f9","ec341f459285443b8361f7f15638ff08",22850177,1,5,0,1200,209,213,4
"ec341f459285443b8361f7f15638ff08","363837c182e04711840d896ae1e0339c",22850177,2,6,0,1201,213,218,5
"363837c182e04711840d896ae1e0339c","01b2051f8941460d89945e3b02d1ce78",22850177,2,-1,0,1202,218,217,-1
"01b2051f8941460d89945e3b02d1ce78","1c6721b1f63f4d30ba7746ea8af02a52",22850177,1,7,0,1203,217,221,4
"1c6721b1f63f4d30ba7746ea8af02a52","d7f13c8d63ec4e2aa673fbb9cf9c6933",22850177,1,-21,0,1204,221,206,-15
"d7f13c8d63ec4e2aa673fbb9cf9c6933","77ecef8eff6b4a2caea7707669bf7475",22850177,1,22,0,1205,206,222,16
"77ecef8eff6b4a2caea7707669bf7475","8b9ae98743bd4d4a8a87dff1c1244211",22850177,1,6,0,1206,222,227,5
"8b9ae98743bd4d4a8a87dff1c1244211","d03cb855c70044cf8c35d9ec0de696e3",22850177,2,-3,0,1207,227,224,-3
"1c6721b1f63f4d30ba7746ea8af02a52","2ab1535aac1346ba8801535bf729ef37",22850177,1,10,0,1209,221,229,8
"5152833676bf4c6cb317060be10f68db","0b04c8e2f86d48c7aeb7e225819cd32b",22850177,1,7,0,1212,228,234,6
"1ebf23f9d994469a85206e4c7b1bf5f5","2ae94c0cea4d480a9d5dca8fb1d7b542",22850177,1,-3,0,1216,245,242,-3
"fa235f0f364d47e4ae1c87f47bf8e6ba","00f61990949545828dd12f1303d47504",22850177,1,5,0,1218,252,256,4
"6e83e23f56544a19b94067c1c558d9c0","d546341988904f069cfa86b21457d9d9",22850177,1,5,0,1220,247,251,4
"d546341988904f069cfa86b21457d9d9","d989ebcfc12a4b669f0100dc1aa14f1e",22850177,1,5,0,1221,251,255,4
"d989ebcfc12a4b669f0100dc1aa14f1e","7aa76d3e993840d8805f097cbdbcd44b",22850177,1,7,0,1222,255,261,6
"7aa76d3e993840d8805f097cbdbcd44b","0d987bed3ffa4ed0b9a2e62e97b7b30f",22850177,1,15,0,1223,261,272,11
"0d987bed3ffa4ed0b9a2e62e97b7b30f","2ae94c0cea4d480a9d5dca8fb1d7b542",22850177,1,-38,0,1224,272,242,-30
"0d987bed3ffa4ed0b9a2e62e97b7b30f","bb5a47f5ea01454a8b79455422d3b9da",22850177,1,10,0,1226,272,280,8
"bb5a47f5ea01454a8b79455422d3b9da","82ae07bc0c9b4570a41799290d1ef399",22850177,1,-6,0,1227,280,275,-5
"82ae07bc0c9b4570a41799290d1ef399","bb5a47f5ea01454a8b79455422d3b9da",22850177,1,6,0,1228,275,280,5
"bb5a47f5ea01454a8b79455422d3b9da","bb5a47f5ea01454a8b79455422d3b9da",22850177,60,0,1,1229,280,280,0
"bb5a47f5ea01454a8b79455422d3b9da","bc5524e78a8544e2ae2fdc2f3462bbec",22850177,1,-1,0,1235,280,279,-1
"bc5524e78a8544e2ae2fdc2f3462bbec","bb5a47f5ea01454a8b79455422d3b9da",22850177,1,1,0,1236,279,280,1
"bb5a47f5ea01454a8b79455422d3b9da","94cecc3f1e7d484b8e068e79241dfd73",22850177,1,3,0,1291,280,281,1
"94cecc3f1e7d484b8e068e79241dfd73","0d987bed3ffa4ed0b9a2e62e97b7b30f",22850177,1,-13,0,1292,281,272,-9
"0d987bed3ffa4ed0b9a2e62e97b7b30f","a37477c4e4c14169ad44b06b493007f6",22850177,1,15,0,1293,272,283,11
"a37477c4e4c14169ad44b06b493007f6","94cecc3f1e7d484b8e068e79241dfd73",22850177,1,-2,0,1294,283,281,-2
"94cecc3f1e7d484b8e068e79241dfd73","a37477c4e4c14169ad44b06b493007f6",22850177,1,2,0,1295,281,283,2
"a37477c4e4c14169ad44b06b493007f6","fab84b4fab5940efb4ea868ef8d09396",22850177,1,3,0,1296,283,284,1
"fab84b4fab5940efb4ea868ef8d09396","fab84b4fab5940efb4ea868ef8d09396",22850177,1,0,1,1297,284,284,0
"fab84b4fab5940efb4ea868ef8d09396","4a29443515bb404cb8924e1c60a63b73",22850177,1,4,0,1298,284,285,1
"4a29443515bb404cb8924e1c60a63b73","208c9b2796c944db8dacaa96082520ea",22850177,3,3,0,1299,285,288,3
"208c9b2796c944db8dacaa96082520ea","208c9b2796c944db8dacaa96082520ea",22850177,1,0,1,1300,288,288,0
"208c9b2796c944db8dacaa96082520ea","4a29443515bb404cb8924e1c60a63b73",22850177,3,-3,0,1301,288,285,-3
"4a29443515bb404cb8924e1c60a63b73","7669a956527947d0add87455277e80b4",22850177,1,7,0,1302,285,291,6
"7669a956527947d0add87455277e80b4","7669a956527947d0add87455277e80b4",22850177,1,0,1,1303,291,291,0
"7669a956527947d0add87455277e80b4","6a9a3b5bde4a48daa896fe8c06eca56f",22850177,1,-2,0,1304,291,289,-2
"6a9a3b5bde4a48daa896fe8c06eca56f","869e967078f04da18dd0b0b9389a7424",22850177,2,5,0,1305,289,293,4
"869e967078f04da18dd0b0b9389a7424","869e967078f04da18dd0b0b9389a7424",22850177,1,0,1,1306,293,293,0
"869e967078f04da18dd0b0b9389a7424","51ab6291537748fab90d519aa09889d6",22850177,1,2,0,1307,293,295,2
"51ab6291537748fab90d519aa09889d6","51ab6291537748fab90d519aa09889d6",22850177,5,0,1,1308,295,295,0
"51ab6291537748fab90d519aa09889d6","34a6e49023fc4465bd5ca604330bbd1c",22850177,1,-3,0,1313,295,292,-3
"34a6e49023fc4465bd5ca604330bbd1c","ba0e59461bfb4a44b7b1c28a01f8d3b3",22850177,2,9,0,1314,292,299,7
"ba0e59461bfb4a44b7b1c28a01f8d3b3","21592f2a9e9c4b2f8c66ec5dbcbf6a2b",22850177,2,-4,0,1315,299,296,-3
"21592f2a9e9c4b2f8c66ec5dbcbf6a2b","ba0e59461bfb4a44b7b1c28a01f8d3b3",22850177,1,4,0,1316,296,299,3
"ba0e59461bfb4a44b7b1c28a01f8d3b3","0e0b36e731a645e7b1b8a88f5031ca38",22850177,1,2,0,1317,299,301,2
"0e0b36e731a645e7b1b8a88f5031ca38","0e0b36e731a645e7b1b8a88f5031ca38",22850177,5,0,1,1318,301,301,0
"0e0b36e731a645e7b1b8a88f5031ca38","a66a144637284c21afc6de17fea4bfb8",22850177,1,1,0,1323,301,302,1
"a66a144637284c21afc6de17fea4bfb8","a66a144637284c21afc6de17fea4bfb8",22850177,2,0,1,1324,302,302,0
"a66a144637284c21afc6de17fea4bfb8","7646a919d7e64fa990bca9b024ff089d",22850177,1,-4,0,1326,302,298,-4
"7646a919d7e64fa990bca9b024ff089d","2c5bb2cbd0014420ad8c95d40e38efd1",22850177,2,6,0,1327,298,303,5
"2c5bb2cbd0014420ad8c95d40e38efd1","ba0e59461bfb4a44b7b1c28a01f8d3b3",22850177,2,-5,0,1328,303,299,-4
"ba0e59461bfb4a44b7b1c28a01f8d3b3","7646a919d7e64fa990bca9b024ff089d",22850177,2,-1,0,1329,299,298,-1
"7646a919d7e64fa990bca9b024ff089d","4a29443515bb404cb8924e1c60a63b73",22850177,1,-17,0,1333,298,285,-13
"4a29443515bb404cb8924e1c60a63b73","6a9a3b5bde4a48daa896fe8c06eca56f",22850177,1,5,0,1338,285,289,4
"869e967078f04da18dd0b0b9389a7424","34a6e49023fc4465bd5ca604330bbd1c",22850177,1,-1,0,1340,293,292,-1
"21592f2a9e9c4b2f8c66ec5dbcbf6a2b","7646a919d7e64fa990bca9b024ff089d",22850177,1,3,0,1343,296,298,2
"7646a919d7e64fa990bca9b024ff089d","e390b575229748ea8aac9364efe2bf00",22850177,1,7,0,1344,298,304,6
"e390b575229748ea8aac9364efe2bf00","e390b575229748ea8aac9364efe2bf00",22850177,1,0,1,1345,304,304,0
"e390b575229748ea8aac9364efe2bf00","4a29443515bb404cb8924e1c60a63b73",22850177,1,-24,0,1346,304,285,-19
"4a29443515bb404cb8924e1c60a63b73","3434c10e561d488a914e0f7d71907abd",22850177,1,27,0,1347,285,305,20
"3434c10e561d488a914e0f7d71907abd","53e7e900392747ccad52e711ab0f80d8",22850177,1,2,0,1348,305,307,2
"53e7e900392747ccad52e711ab0f80d8","53e7e900392747ccad52e711ab0f80d8",22850177,2,0,1,1349,307,307,0
"53e7e900392747ccad52e711ab0f80d8","3434c10e561d488a914e0f7d71907abd",22850177,2,-2,0,1351,307,305,-2
"3434c10e561d488a914e0f7d71907abd","130acc2aeb0448fdbb2de63bc5cebe5b",22850177,2,5,0,1352,305,309,4
"130acc2aeb0448fdbb2de63bc5cebe5b","141c0df6cd1946539aadd1c9b7068cd4",22850177,1,-1,0,1353,309,308,-1
"141c0df6cd1946539aadd1c9b7068cd4","53e7e900392747ccad52e711ab0f80d8",22850177,1,-2,0,1354,308,307,-1
"130acc2aeb0448fdbb2de63bc5cebe5b","130acc2aeb0448fdbb2de63bc5cebe5b",22850177,1,0,1,1357,309,309,0
"130acc2aeb0448fdbb2de63bc5cebe5b","9c062b3251034ebe90f5054e2a3b5120",22850177,1,2,0,1358,309,311,2
"9c062b3251034ebe90f5054e2a3b5120","9c062b3251034ebe90f5054e2a3b5120",22850177,2,0,1,1359,311,311,0
"9c062b3251034ebe90f5054e2a3b5120","ea859f8207e44537889daeaba13ac2e8",22850177,1,1,0,1361,311,312,1
"ea859f8207e44537889daeaba13ac2e8","ea859f8207e44537889daeaba13ac2e8",22850177,1,0,1,1362,312,312,0
"ea859f8207e44537889daeaba13ac2e8","56d94971a7a94257aa330183a8ebd0ea",22850177,1,1,0,1363,312,313,1
"56d94971a7a94257aa330183a8ebd0ea","56d94971a7a94257aa330183a8ebd0ea",22850177,1,0,1,1364,313,313,0
"56d94971a7a94257aa330183a8ebd0ea","141c0df6cd1946539aadd1c9b7068cd4",22850177,1,-5,0,1365,313,308,-5
"141c0df6cd1946539aadd1c9b7068cd4","13255e63e0aa4abf85e5211bf613d43e",22850177,1,10,0,1366,308,317,9
"13255e63e0aa4abf85e5211bf613d43e","13255e63e0aa4abf85e5211bf613d43e",22850177,1,0,1,1367,317,317,0
"13255e63e0aa4abf85e5211bf613d43e","0c787d16c9504873b1a4d903cec09948",22850177,1,-3,0,1368,317,314,-3
"0c787d16c9504873b1a4d903cec09948","86c27d40179e419c8e9d150fb6afa5d0",22850177,1,6,0,1369,314,319,5
"86c27d40179e419c8e9d150fb6afa5d0","86c27d40179e419c8e9d150fb6afa5d0",22850177,2,0,1,1370,319,319,0
"86c27d40179e419c8e9d150fb6afa5d0","8d7e0b55cf9849cda222a0f2440cec55",22850177,1,-1,0,1372,319,318,-1
"8d7e0b55cf9849cda222a0f2440cec55","47edbb64109243e6b0f8f64cdef90c6c",22850177,1,9,0,1373,318,326,8
"47edbb64109243e6b0f8f64cdef90c6c","24f1363179ad4aaa965484a78471912b",22850177,1,-3,0,1374,326,323,-3
"24f1363179ad4aaa965484a78471912b","24f1363179ad4aaa965484a78471912b",22850177,1,0,1,1375,323,323,0
"24f1363179ad4aaa965484a78471912b","3628bdce1dd2429ba924d2d4d09448d2",22850177,1,-1,0,1376,323,322,-1
"3628bdce1dd2429ba924d2d4d09448d2","56b3fd1a212a4764be39d979fde3326e",22850177,1,7,0,1377,322,328,6
"56b3fd1a212a4764be39d979fde3326e","56b3fd1a212a4764be39d979fde3326e",22850177,1,0,1,1378,328,328,0
"56b3fd1a212a4764be39d979fde3326e","0c4079457ede49e3aeb5e86ed84bdf35",22850177,1,3,0,1379,328,329,1
"0c4079457ede49e3aeb5e86ed84bdf35","3434c10e561d488a914e0f7d71907abd",22850177,1,-31,0,1380,329,305,-24
"3434c10e561d488a914e0f7d71907abd","38aea304b4fa46e1b29bb72f5cea4c93",22850177,1,33,0,1381,305,331,26
"38aea304b4fa46e1b29bb72f5cea4c93","0c4079457ede49e3aeb5e86ed84bdf35",22850177,1,-2,0,1382,331,329,-2
"0c4079457ede49e3aeb5e86ed84bdf35","38aea304b4fa46e1b29bb72f5cea4c93",22850177,2,2,0,1383,329,331,2
"38aea304b4fa46e1b29bb72f5cea4c93","38aea304b4fa46e1b29bb72f5cea4c93",22850177,6,0,1,1384,331,331,0
"38aea304b4fa46e1b29bb72f5cea4c93","e36d261332f14e79bb4b467aceaeb9b5",22850177,1,2,0,1386,331,333,2
"e36d261332f14e79bb4b467aceaeb9b5","e36d261332f14e79bb4b467aceaeb9b5",22850177,1,0,1,1387,333,333,0
"e36d261332f14e79bb4b467aceaeb9b5","c7e89b9d04744d2eab742fc24e3ef1ae",22850177,1,1,0,1388,333,334,1
"c7e89b9d04744d2eab742fc24e3ef1ae","c7e89b9d04744d2eab742fc24e3ef1ae",22850177,2,0,1,1389,334,334,0
"c7e89b9d04744d2eab742fc24e3ef1ae","fe49f8054b374a0ea4bb266ed135ff62",22850177,1,1,0,1391,334,335,1
"fe49f8054b374a0ea4bb266ed135ff62","fe49f8054b374a0ea4bb266ed135ff62",22850177,2,0,1,1392,335,335,0
"fe49f8054b374a0ea4bb266ed135ff62","d0a8f74af98642fe8360d22c42e45117",22850177,1,1,0,1394,335,336,1
"d0a8f74af98642fe8360d22c42e45117","d0a8f74af98642fe8360d22c42e45117",22850177,2,0,1,1395,336,336,0
"d0a8f74af98642fe8360d22c42e45117","0c4079457ede49e3aeb5e86ed84bdf35",22850177,1,-7,0,1397,336,329,-7
"0c4079457ede49e3aeb5e86ed84bdf35","a7c6339ca1da4368a18d471f0519f877",22850177,1,11,0,1398,329,339,10
"a7c6339ca1da4368a18d471f0519f877","a7c6339ca1da4368a18d471f0519f877",22850177,1,0,1,1399,339,339,0
"a7c6339ca1da4368a18d471f0519f877","b8b9418ab322418d9db9b40d96af873a",22850177,1,-2,0,1400,339,337,-2
"b8b9418ab322418d9db9b40d96af873a","bbc5139ca9024389a94db3a6f47dcff6",22850177,1,5,0,1401,337,341,4
"bbc5139ca9024389a94db3a6f47dcff6","bbc5139ca9024389a94db3a6f47dcff6",22850177,1,0,1,1402,341,341,0
"bbc5139ca9024389a94db3a6f47dcff6","4ee6ca9019ab4a1ab323f98094a9bd77",22850177,1,2,0,1403,341,343,2
"4ee6ca9019ab4a1ab323f98094a9bd77","4ee6ca9019ab4a1ab323f98094a9bd77",22850177,2,0,1,1404,343,343,0
"4ee6ca9019ab4a1ab323f98094a9bd77","b37947176785476f8b29d49a851366dc",22850177,1,1,0,1406,343,344,1
"b37947176785476f8b29d49a851366dc","b37947176785476f8b29d49a851366dc",22850177,2,0,1,1407,344,344,0
"b37947176785476f8b29d49a851366dc","fcea5b10d5a14a3b9324ffece8f6e1e5",22850177,1,1,0,1409,344,345,1
"fcea5b10d5a14a3b9324ffece8f6e1e5","fcea5b10d5a14a3b9324ffece8f6e1e5",22850177,5,0,1,1410,345,345,0
"fcea5b10d5a14a3b9324ffece8f6e1e5","c2490bc612d146edbe786556fab3651b",22850177,1,-5,0,1415,345,340,-5
"c2490bc612d146edbe786556fab3651b","0c4079457ede49e3aeb5e86ed84bdf35",22850177,2,-13,0,1416,340,329,-11
"0c4079457ede49e3aeb5e86ed84bdf35","0c4079457ede49e3aeb5e86ed84bdf35",22850177,1,0,1,1417,329,329,0
"38aea304b4fa46e1b29bb72f5cea4c93","6ac8bb048b854999a47edb35fe627f11",22850177,1,19,0,1423,331,347,16
"6ac8bb048b854999a47edb35fe627f11","6ac8bb048b854999a47edb35fe627f11",22850177,1,0,1,1424,347,347,0
"6ac8bb048b854999a47edb35fe627f11","30ead9794d4847abaf222ca966cc8630",22850177,1,3,0,1425,347,348,1
"30ead9794d4847abaf222ca966cc8630","0c4079457ede49e3aeb5e86ed84bdf35",22850177,1,-24,0,1426,348,329,-19
"0c4079457ede49e3aeb5e86ed84bdf35","c20993c944444fe085345591a8bd837e",22850177,1,27,0,1427,329,351,22
"c20993c944444fe085345591a8bd837e","eff0de7f2dbb42dfa1a2e686efab5b6d",22850177,1,3,0,1428,351,354,3
"eff0de7f2dbb42dfa1a2e686efab5b6d","09b9678ddc3d452ea4a3d46e15826065",22850177,2,-1,0,1429,354,353,-1
"09b9678ddc3d452ea4a3d46e15826065","897b7f51242c44aab2205c72fdcbf4cd",22850177,2,-1,0,1430,353,352,-1
"897b7f51242c44aab2205c72fdcbf4cd","b8b9418ab322418d9db9b40d96af873a",22850177,1,-19,0,1431,352,337,-15
"b8b9418ab322418d9db9b40d96af873a","0c4079457ede49e3aeb5e86ed84bdf35",22850177,1,-9,0,1432,337,329,-8
"0c4079457ede49e3aeb5e86ed84bdf35","bbc5139ca9024389a94db3a6f47dcff6",22850177,1,14,0,1433,329,341,12
"bbc5139ca9024389a94db3a6f47dcff6","c2490bc612d146edbe786556fab3651b",22850177,1,-1,0,1434,341,340,-1
"0c4079457ede49e3aeb5e86ed84bdf35","30ead9794d4847abaf222ca966cc8630",22850177,1,24,0,1436,329,348,19
"30ead9794d4847abaf222ca966cc8630","eff0de7f2dbb42dfa1a2e686efab5b6d",22850177,1,6,0,1437,348,354,6
"897b7f51242c44aab2205c72fdcbf4cd","c20993c944444fe085345591a8bd837e",22850177,1,-1,0,1440,352,351,-1
"c20993c944444fe085345591a8bd837e","30ead9794d4847abaf222ca966cc8630",22850177,1,-3,0,1441,351,348,-3
"30ead9794d4847abaf222ca966cc8630","30ead9794d4847abaf222ca966cc8630",22850177,1,0,1,1442,348,348,0
"30ead9794d4847abaf222ca966cc8630","1ba8fef685d74a8194b9db252eb704fb",22850177,1,8,0,1443,348,355,7
"1ba8fef685d74a8194b9db252eb704fb","2fe14166dc9642c3bc666b86a57f943d",22850177,1,2,0,1444,355,357,2
"2fe14166dc9642c3bc666b86a57f943d","c20993c944444fe085345591a8bd837e",22850177,1,-7,0,1445,357,351,-6
"c20993c944444fe085345591a8bd837e","c20993c944444fe085345591a8bd837e",22850177,3,0,1,1446,351,351,0
"c20993c944444fe085345591a8bd837e","897b7f51242c44aab2205c72fdcbf4cd",22850177,1,1,0,1449,351,352,1
"897b7f51242c44aab2205c72fdcbf4cd","897b7f51242c44aab2205c72fdcbf4cd",22850177,3,0,1,1450,352,352,0
"897b7f51242c44aab2205c72fdcbf4cd","09b9678ddc3d452ea4a3d46e15826065",22850177,1,1,0,1453,352,353,1
"09b9678ddc3d452ea4a3d46e15826065","09b9678ddc3d452ea4a3d46e15826065",22850177,3,0,1,1454,353,353,0
"09b9678ddc3d452ea4a3d46e15826065","eff0de7f2dbb42dfa1a2e686efab5b6d",22850177,1,1,0,1457,353,354,1
"eff0de7f2dbb42dfa1a2e686efab5b6d","eff0de7f2dbb42dfa1a2e686efab5b6d",22850177,3,0,1,1458,354,354,0
"eff0de7f2dbb42dfa1a2e686efab5b6d","2fe14166dc9642c3bc666b86a57f943d",22850177,1,4,0,1461,354,357,3
"2fe14166dc9642c3bc666b86a57f943d","30ead9794d4847abaf222ca966cc8630",22850177,1,-10,0,1462,357,348,-9
"30ead9794d4847abaf222ca966cc8630","2fe14166dc9642c3bc666b86a57f943d",22850177,1,10,0,1463,348,357,9
"2fe14166dc9642c3bc666b86a57f943d","44421dd1e13a47a388c4a19834b744c7",22850177,1,2,0,1464,357,359,2
"44421dd1e13a47a388c4a19834b744c7","44421dd1e13a47a388c4a19834b744c7",22850177,2,0,1,1465,359,359,0
"44421dd1e13a47a388c4a19834b744c7","cb5fc7ef85d547c4be1a7439d0bf6052",22850177,1,1,0,1467,359,360,1
"cb5fc7ef85d547c4be1a7439d0bf6052","cb5fc7ef85d547c4be1a7439d0bf6052",22850177,2,0,1,1468,360,360,0
"cb5fc7ef85d547c4be1a7439d0bf6052","0a8f150a4cf747acbde62f4721823da3",22850177,1,1,0,1470,360,361,1
"0a8f150a4cf747acbde62f4721823da3","0a8f150a4cf747acbde62f4721823da3",22850177,2,0,1,1471,361,361,0
"0a8f150a4cf747acbde62f4721823da3","ab8fdad974ae471f9f24c3f9dd04462e",22850177,1,1,0,1473,361,362,1
"ab8fdad974ae471f9f24c3f9dd04462e","ab8fdad974ae471f9f24c3f9dd04462e",22850177,5,0,1,1474,362,362,0
"ab8fdad974ae471f9f24c3f9dd04462e","1ba8fef685d74a8194b9db252eb704fb",22850177,1,-7,0,1479,362,355,-7
"1ba8fef685d74a8194b9db252eb704fb","52580888dadb4fe3baa795683ea227bd",22850177,1,10,0,1480,355,364,9
"52580888dadb4fe3baa795683ea227bd","52580888dadb4fe3baa795683ea227bd",22850177,1,0,1,1481,364,364,0
"52580888dadb4fe3baa795683ea227bd","f00179e251a045b39c3f7a54f9aa4acc",22850177,1,-1,0,1482,364,363,-1
"f00179e251a045b39c3f7a54f9aa4acc","492a3bc6a1254f23a7998587961b22a4",22850177,1,4,0,1483,363,366,3
"492a3bc6a1254f23a7998587961b22a4","492a3bc6a1254f23a7998587961b22a4",22850177,1,0,1,1484,366,366,0
"492a3bc6a1254f23a7998587961b22a4","072a190fd302456290895f9f04d6940a",22850177,1,-1,0,1485,366,365,-1
"072a190fd302456290895f9f04d6940a","cfa457d1743848e4bb5e4beced6448ed",22850177,1,5,0,1486,365,369,4
"cfa457d1743848e4bb5e4beced6448ed","cfa457d1743848e4bb5e4beced6448ed",22850177,1,0,1,1487,369,369,0
"cfa457d1743848e4bb5e4beced6448ed","30ead9794d4847abaf222ca966cc8630",22850177,1,-25,0,1488,369,348,-21
"30ead9794d4847abaf222ca966cc8630","b71bac264efb4abd97015447bd490db6",22850177,1,28,0,1489,348,370,22
"b71bac264efb4abd97015447bd490db6","b71bac264efb4abd97015447bd490db6",22850177,2,0,1,1490,370,370,0
"b71bac264efb4abd97015447bd490db6","8d448d625b024c82a5eb240bbd7431d6",22850177,5,5,0,1492,370,374,4
"8d448d625b024c82a5eb240bbd7431d6","b71bac264efb4abd97015447bd490db6",22850177,3,-5,0,1493,374,370,-4
"8d448d625b024c82a5eb240bbd7431d6","8d448d625b024c82a5eb240bbd7431d6",22850177,79,0,1,1495,374,374,0
"b71bac264efb4abd97015447bd490db6","d6d02b6ef04e4f17805504500b8ce441",22850177,2,8,0,1551,370,375,5
"d6d02b6ef04e4f17805504500b8ce441","d6d02b6ef04e4f17805504500b8ce441",22850177,3,0,1,1552,375,375,0
"d6d02b6ef04e4f17805504500b8ce441","b613861cecf84ffcab01afb23f660475",22850177,1,-516,0,1553,375,1,-374
"b613861cecf84ffcab01afb23f660475","e2911e79efc2420eac45d9f671463d4b",22850177,3,3,0,1555,1,2,1
"e2911e79efc2420eac45d9f671463d4b","b613861cecf84ffcab01afb23f660475",22850177,1,-3,0,1556,2,1,-1
"e2911e79efc2420eac45d9f671463d4b","e2911e79efc2420eac45d9f671463d4b",22850177,5,0,1,1558,2,2,0
"e2911e79efc2420eac45d9f671463d4b","56586aa865414f538729c7f7735d2bc6",22850177,7,12,0,1559,2,12,10
"56586aa865414f538729c7f7735d2bc6","56586aa865414f538729c7f7735d2bc6",22850177,16,0,1,1560,12,12,0
"3f1c815879794b929260d224becaff7e","b71bac264efb4abd97015447bd490db6",22850177,2,489,0,1566,14,370,356
"8d448d625b024c82a5eb240bbd7431d6","c33c17be71ae4d588da7369472e5bb1b",22850177,1,-457,0,1575,374,34,-340
"c33c17be71ae4d588da7369472e5bb1b","c33c17be71ae4d588da7369472e5bb1b",22850177,2,0,1,1576,34,34,0
"b534b89233134e30a9b5645138bfa9ee","b534b89233134e30a9b5645138bfa9ee",22850177,1,0,1,1590,41,41,0
"6e13d61a7bdb44bca949c9f86fab3be5","d9c8d8c444a64dadbbb508652c721e17",22850177,2,-1,0,1592,47,46,-1
"d0c74f735e024943943e40333d6d337f","f924752d8a1149668870b1e7698486f7",22850177,1,-1,0,1594,51,50,-1
"f924752d8a1149668870b1e7698486f7","a1f2f12debe5432fb7a70bcd12bacfb9",22850177,2,9,0,1595,50,58,8
"a1f2f12debe5432fb7a70bcd12bacfb9","78f30e4dcac84e3cbea8b2cc6e0d62b3",22850177,3,1,0,1596,58,59,1
"78f30e4dcac84e3cbea8b2cc6e0d62b3","12aa6e1672ac4e7aa6449a7a8609cd72",22850177,2,-2,0,1597,59,57,-2
"12aa6e1672ac4e7aa6449a7a8609cd72","a0a418b8540d479fa6e0f653b701da8b",22850177,1,8,0,1598,57,64,7
"a0a418b8540d479fa6e0f653b701da8b","bc42d26810654ea9a1df1efe1e58c7d5",22850177,1,-1,0,1599,64,63,-1
"bc42d26810654ea9a1df1efe1e58c7d5","bc42d26810654ea9a1df1efe1e58c7d5",22850177,5,0,1,1600,63,63,0
"bc42d26810654ea9a1df1efe1e58c7d5","a0a418b8540d479fa6e0f653b701da8b",22850177,3,1,0,1602,63,64,1
"a0a418b8540d479fa6e0f653b701da8b","a0a418b8540d479fa6e0f653b701da8b",22850177,4,0,1,1603,64,64,0
"a0a418b8540d479fa6e0f653b701da8b","309ccf3cc4fe429d9bfbaef53d3fa479",22850177,2,-4,0,1604,64,60,-4
"309ccf3cc4fe429d9bfbaef53d3fa479","78f30e4dcac84e3cbea8b2cc6e0d62b3",22850177,1,-2,0,1605,60,59,-1
"78f30e4dcac84e3cbea8b2cc6e0d62b3","a1f2f12debe5432fb7a70bcd12bacfb9",22850177,2,-1,0,1606,59,58,-1
"a1f2f12debe5432fb7a70bcd12bacfb9","d0c74f735e024943943e40333d6d337f",22850177,1,-8,0,1607,58,51,-7
"d0c74f735e024943943e40333d6d337f","12aa6e1672ac4e7aa6449a7a8609cd72",22850177,1,7,0,1608,51,57,6
"12aa6e1672ac4e7aa6449a7a8609cd72","f924752d8a1149668870b1e7698486f7",22850177,1,-8,0,1609,57,50,-7
"f924752d8a1149668870b1e7698486f7","6e13d61a7bdb44bca949c9f86fab3be5",22850177,1,-4,0,1610,50,47,-3
"d9c8d8c444a64dadbbb508652c721e17","67a089198fcb4e1c8f2385786c2b296f",22850177,1,-10,0,1612,46,39,-7
"b534b89233134e30a9b5645138bfa9ee","64d48c6c9c7940639a932219a6c87198",22850177,1,-3,0,1614,41,40,-1
"64d48c6c9c7940639a932219a6c87198","fc0e049d56024bc9a02c9a9c435c3df7",22850177,1,-5,0,1615,40,38,-2
"67a089198fcb4e1c8f2385786c2b296f","fc0e049d56024bc9a02c9a9c435c3df7",22850177,1,-4,0,1617,39,38,-1
"fc0e049d56024bc9a02c9a9c435c3df7","9a0dc646f934470daf08c4b56ccf73db",22850177,1,-3,0,1618,38,37,-1
"9a0dc646f934470daf08c4b56ccf73db","7040a13096d746ac84b8fac8d9752058",22850177,1,-3,0,1620,37,36,-1
"7040a13096d746ac84b8fac8d9752058","93679be414554a11b1893002f2229a93",22850177,1,-3,0,1622,36,35,-1
"93679be414554a11b1893002f2229a93","93679be414554a11b1893002f2229a93",22850177,1,0,1,1623,35,35,0
"4e51676dc72045d99c19b9fa7b22f8bc","c9c52446b6294aa5a9c2abaed536c37e",22850177,1,5,0,1627,29,32,3
"c9c52446b6294aa5a9c2abaed536c37e","51970cfa30e643e894e66ae85c8024cc",22850177,1,-2,0,1628,32,31,-1
"51970cfa30e643e894e66ae85c8024cc","4e51676dc72045d99c19b9fa7b22f8bc",22850177,1,-3,0,1629,31,29,-2
"4e51676dc72045d99c19b9fa7b22f8bc","afbf7250b99d47bea07172749483ca97",22850177,1,-3,0,1630,29,28,-1
"afbf7250b99d47bea07172749483ca97","b7719e26494940efa49512aedd0aac79",22850177,1,-12,0,1632,28,20,-8
"b7719e26494940efa49512aedd0aac79","a49d1bb4328949299686242fd0be5584",22850177,4,2,0,1633,20,21,1
"a49d1bb4328949299686242fd0be5584","d4f45188d3c84a02ba08454e6403a818",22850177,3,3,0,1634,21,24,3
"9afd71a5298d4333b6849dfce1b9422c","56586aa865414f538729c7f7735d2bc6",22850177,2,-13,0,1638,18,12,-6
"9afd71a5298d4333b6849dfce1b9422c","5c5ceeee4562457ba6d41515aeebfbb1",22850177,1,-3,0,1640,18,17,-1
"5c5ceeee4562457ba6d41515aeebfbb1","eb2a0eb537344a9e891c761662e400b6",22850177,2,-2,0,1641,17,16,-1
"eb2a0eb537344a9e891c761662e400b6","b71bac264efb4abd97015447bd490db6",22850177,1,485,0,1642,16,370,354
"8d448d625b024c82a5eb240bbd7431d6","e2911e79efc2420eac45d9f671463d4b",22850177,1,-510,0,1654,374,2,-372
"b7f2b31585d94eb3bf86376714aa7070","56586aa865414f538729c7f7735d2bc6",22850177,6,-2,0,1660,13,12,-1
"d6d02b6ef04e4f17805504500b8ce441","66baf19b6b904b70922329068c63746d",22850177,1,4,0,1676,375,376,1
"66baf19b6b904b70922329068c63746d","7f544639412e40a9ba27f43b415362ab",22850177,4,2,0,1677,376,378,2
"7f544639412e40a9ba27f43b415362ab","7f544639412e40a9ba27f43b415362ab",22850177,2,0,1,1678,378,378,0
"7f544639412e40a9ba27f43b415362ab","66baf19b6b904b70922329068c63746d",22850177,2,-2,0,1679,378,376,-2
"7f544639412e40a9ba27f43b415362ab","d5ae8642e15b46b8bd298b02274d4e9c",22850177,1,2,0,1682,378,380,2
"d5ae8642e15b46b8bd298b02274d4e9c","d5ae8642e15b46b8bd298b02274d4e9c",22850177,1,0,1,1683,380,380,0
"d5ae8642e15b46b8bd298b02274d4e9c","a0d10309a2dd456289147f84be9d37f9",22850177,1,1,0,1684,380,381,1
"a0d10309a2dd456289147f84be9d37f9","a0d10309a2dd456289147f84be9d37f9",22850177,2,0,1,1685,381,381,0
"a0d10309a2dd456289147f84be9d37f9","0fcbc3ca07b144138b8d85da581f09a8",22850177,1,1,0,1687,381,382,1
"0fcbc3ca07b144138b8d85da581f09a8","0fcbc3ca07b144138b8d85da581f09a8",22850177,5,0,1,1688,382,382,0
"0fcbc3ca07b144138b8d85da581f09a8","66baf19b6b904b70922329068c63746d",22850177,1,-6,0,1693,382,376,-6
"66baf19b6b904b70922329068c63746d","4890121ce5d74576b4632b77cfc23398",22850177,2,14,0,1694,376,388,12
"4890121ce5d74576b4632b77cfc23398","c2fca3669923477ab966ded303dea31c",22850177,2,-6,0,1695,388,383,-5
"c2fca3669923477ab966ded303dea31c","4890121ce5d74576b4632b77cfc23398",22850177,1,6,0,1696,383,388,5
"4890121ce5d74576b4632b77cfc23398","18d3b836dd804224883cc9180b60a8e1",22850177,1,-1,0,1697,388,387,-1
"18d3b836dd804224883cc9180b60a8e1","96bb2b3e85a34d8b9544514e89f6fe97",22850177,2,4,0,1698,387,390,3
"96bb2b3e85a34d8b9544514e89f6fe97","96bb2b3e85a34d8b9544514e89f6fe97",22850177,2,0,1,1699,390,390,0
"96bb2b3e85a34d8b9544514e89f6fe97","ac4e9b54acfe4670b4634859c7263cb5",22850177,1,2,0,1701,390,392,2
"ac4e9b54acfe4670b4634859c7263cb5","ac4e9b54acfe4670b4634859c7263cb5",22850177,1,0,1,1702,392,392,0
"ac4e9b54acfe4670b4634859c7263cb5","6f8881a745ac4c358a68b92c3b4abe81",22850177,1,3,0,1703,392,394,2
"6f8881a745ac4c358a68b92c3b4abe81","17f95d18bab743888e1736033dc3384d",22850177,2,-6,0,1704,394,389,-5
"17f95d18bab743888e1736033dc3384d","6f8881a745ac4c358a68b92c3b4abe81",22850177,1,6,0,1705,389,394,5
"6f8881a745ac4c358a68b92c3b4abe81","6f8881a745ac4c358a68b92c3b4abe81",22850177,1,0,1,1706,394,394,0
"6f8881a745ac4c358a68b92c3b4abe81","f7002c8484354eceac57bc7bd62c76c1",22850177,1,-1,0,1707,394,393,-1
"f7002c8484354eceac57bc7bd62c76c1","66baf19b6b904b70922329068c63746d",22850177,1,-21,0,1708,393,376,-17
"c2fca3669923477ab966ded303dea31c","18d3b836dd804224883cc9180b60a8e1",22850177,1,5,0,1713,383,387,4
"96bb2b3e85a34d8b9544514e89f6fe97","6f8881a745ac4c358a68b92c3b4abe81",22850177,1,5,0,1715,390,394,4
"17f95d18bab743888e1736033dc3384d","f7002c8484354eceac57bc7bd62c76c1",22850177,1,5,0,1717,389,393,4
"f7002c8484354eceac57bc7bd62c76c1","44a277ea44dc4ae689fab4b82f0b4098",22850177,1,5,0,1718,393,397,4
"44a277ea44dc4ae689fab4b82f0b4098","44a277ea44dc4ae689fab4b82f0b4098",22850177,1,0,1,1719,397,397,0
"44a277ea44dc4ae689fab4b82f0b4098","0c12af0a4e7f4002852cf84b2537c161",22850177,1,-2,0,1720,397,395,-2
"0c12af0a4e7f4002852cf84b2537c161","66baf19b6b904b70922329068c63746d",22850177,1,-24,0,1721,395,376,-19
"66baf19b6b904b70922329068c63746d","df8191ec5e584c838a899c378941a566",22850177,1,28,0,1722,376,398,22
"df8191ec5e584c838a899c378941a566","66baf19b6b904b70922329068c63746d",22850177,1,-28,0,1723,398,376,-22
"66baf19b6b904b70922329068c63746d","66baf19b6b904b70922329068c63746d",22850177,2,0,1,1724,376,376,0
"7f544639412e40a9ba27f43b415362ab","859e0b8d71694b12befb69ee698138f9",22850177,1,27,0,1727,378,399,21
"859e0b8d71694b12befb69ee698138f9","859e0b8d71694b12befb69ee698138f9",22850177,1,0,1,1728,399,399,0
"859e0b8d71694b12befb69ee698138f9","66baf19b6b904b70922329068c63746d",22850177,1,-29,0,1729,399,376,-23
"66baf19b6b904b70922329068c63746d","2b09a08242b54983aec7063990fb3f66",22850177,1,32,0,1730,376,400,24
"2b09a08242b54983aec7063990fb3f66","2b09a08242b54983aec7063990fb3f66",22850177,3,0,1,1731,400,400,0
"2b09a08242b54983aec7063990fb3f66","1f471b7a883a4df48211e8c6a81b59a7",22850177,1,1,0,1733,400,401,1
"1f471b7a883a4df48211e8c6a81b59a7","1f471b7a883a4df48211e8c6a81b59a7",22850177,1,0,1,1734,401,401,0
"1f471b7a883a4df48211e8c6a81b59a7","2b09a08242b54983aec7063990fb3f66",22850177,1,-1,0,1735,401,400,-1
"2b09a08242b54983aec7063990fb3f66","9de0d567bfa84fe5b77cb76f4a76a5d1",22850177,1,5,0,1736,400,404,4
"9de0d567bfa84fe5b77cb76f4a76a5d1","9de0d567bfa84fe5b77cb76f4a76a5d1",22850177,1,0,1,1737,404,404,0
"9de0d567bfa84fe5b77cb76f4a76a5d1","1157bd665ec4472fb58b751dc5099355",22850177,1,-1,0,1738,404,403,-1
"1157bd665ec4472fb58b751dc5099355","58fc9094275e4c49be3f4ba6d4acc0a4",22850177,1,5,0,1739,403,406,3
"58fc9094275e4c49be3f4ba6d4acc0a4","3c8a22d2f9c146ea956609e3ed4f2559",22850177,1,-2,0,1740,406,405,-1
"3c8a22d2f9c146ea956609e3ed4f2559","58fc9094275e4c49be3f4ba6d4acc0a4",22850177,1,2,0,1741,405,406,1
"58fc9094275e4c49be3f4ba6d4acc0a4","c1c1be90b2b14c1ab4a5e1ee3c241902",22850177,1,1,0,1742,406,407,1
"c1c1be90b2b14c1ab4a5e1ee3c241902","c1c1be90b2b14c1ab4a5e1ee3c241902",22850177,5,0,1,1743,407,407,0
"c1c1be90b2b14c1ab4a5e1ee3c241902","02b3a1bead9244c1ba2f857c7da8f82a",22850177,1,2,0,1748,407,408,1
"02b3a1bead9244c1ba2f857c7da8f82a","58fc9094275e4c49be3f4ba6d4acc0a4",22850177,1,-3,0,1749,408,406,-2
"58fc9094275e4c49be3f4ba6d4acc0a4","02b3a1bead9244c1ba2f857c7da8f82a",22850177,1,3,0,1750,406,408,2
"02b3a1bead9244c1ba2f857c7da8f82a","6206fc6479014bb193084c32409dc1b9",22850177,1,1,0,1751,408,409,1
"6206fc6479014bb193084c32409dc1b9","6206fc6479014bb193084c32409dc1b9",22850177,7,0,1,1752,409,409,0
"6206fc6479014bb193084c32409dc1b9","02b3a1bead9244c1ba2f857c7da8f82a",22850177,1,-1,0,1759,409,408,-1
"02b3a1bead9244c1ba2f857c7da8f82a","6a5f020451db426dacba9e2ea3fcc62a",22850177,1,3,0,1760,408,410,2
"6a5f020451db426dacba9e2ea3fcc62a","6a5f020451db426dacba9e2ea3fcc62a",22850177,3,0,1,1761,410,410,0
"6a5f020451db426dacba9e2ea3fcc62a","33a9d248b2e44588a5b07fc1342b9bc2",22850177,2,2,0,1762,410,411,1
"33a9d248b2e44588a5b07fc1342b9bc2","6a5f020451db426dacba9e2ea3fcc62a",22850177,1,-2,0,1763,411,410,-1
"33a9d248b2e44588a5b07fc1342b9bc2","c6f26bd420634f1cb7989e76fe6b16c0",22850177,1,1,0,1765,411,412,1
"c6f26bd420634f1cb7989e76fe6b16c0","c6f26bd420634f1cb7989e76fe6b16c0",22850177,5,0,1,1766,412,412,0
"c6f26bd420634f1cb7989e76fe6b16c0","2a65ee6e2ac64f6a8a55fbe5373ec763",22850177,1,1,0,1771,412,413,1
"2a65ee6e2ac64f6a8a55fbe5373ec763","2a65ee6e2ac64f6a8a55fbe5373ec763",22850177,2,0,1,1772,413,413,0
"2a65ee6e2ac64f6a8a55fbe5373ec763","33a9d248b2e44588a5b07fc1342b9bc2",22850177,1,-2,0,1774,413,411,-2
"33a9d248b2e44588a5b07fc1342b9bc2","2b09a08242b54983aec7063990fb3f66",22850177,1,-17,0,1775,411,400,-11
"2b09a08242b54983aec7063990fb3f66","6a5f020451db426dacba9e2ea3fcc62a",22850177,1,15,0,1777,400,410,10
"6a5f020451db426dacba9e2ea3fcc62a","1fd0f6dadbc14ebc965faf6122190b96",22850177,1,7,0,1780,410,415,5
"1fd0f6dadbc14ebc965faf6122190b96","1fd0f6dadbc14ebc965faf6122190b96",22850177,1,0,1,1781,415,415,0
"1fd0f6dadbc14ebc965faf6122190b96","687055dad9fc40c3982478fe33ec01bf",22850177,1,-1,0,1782,415,414,-1
"687055dad9fc40c3982478fe33ec01bf","2add1669f08d4101913db15f8c23b3b7",22850177,1,3,0,1783,414,416,2
"2add1669f08d4101913db15f8c23b3b7","2add1669f08d4101913db15f8c23b3b7",22850177,1,0,1,1784,416,416,0
"2add1669f08d4101913db15f8c23b3b7","2b09a08242b54983aec7063990fb3f66",22850177,1,-24,0,1785,416,400,-16
"2b09a08242b54983aec7063990fb3f66","a2b4bd40cee2481ebd3fc179d6a5cd62",22850177,1,27,0,1786,400,417,17
"a2b4bd40cee2481ebd3fc179d6a5cd62","e34e59dce2204f228f3a84b6725df60f",22850177,1,2,0,1787,417,419,2
"e34e59dce2204f228f3a84b6725df60f","e34e59dce2204f228f3a84b6725df60f",22850177,1,0,1,1788,419,419,0
"e34e59dce2204f228f3a84b6725df60f","a2b4bd40cee2481ebd3fc179d6a5cd62",22850177,1,-2,0,1789,419,417,-2
"a2b4bd40cee2481ebd3fc179d6a5cd62","bec48fc2e1294c7eb3d0aca780d731b8",22850177,1,4,0,1790,417,420,3
"bec48fc2e1294c7eb3d0aca780d731b8","bec48fc2e1294c7eb3d0aca780d731b8",22850177,2,0,1,1791,420,420,0
"bec48fc2e1294c7eb3d0aca780d731b8","dbde19fcce2a4c1abdc7f685c293a23f",22850177,1,3,0,1793,420,422,2
"dbde19fcce2a4c1abdc7f685c293a23f","a24600b0e49245f6bdba8c893cfeddb0",22850177,1,4,0,1794,422,425,3
"a24600b0e49245f6bdba8c893cfeddb0","a24600b0e49245f6bdba8c893cfeddb0",22850177,2,0,1,1795,425,425,0
"a24600b0e49245f6bdba8c893cfeddb0","a2b4bd40cee2481ebd3fc179d6a5cd62",22850177,1,-11,0,1797,425,417,-8
"a2b4bd40cee2481ebd3fc179d6a5cd62","24cf8786024543f19b89bc20034e60d7",22850177,1,18,0,1798,417,428,11
"24cf8786024543f19b89bc20034e60d7","f2a73be2f46840b182d7bd095378004e",22850177,1,1,0,1799,428,429,1
"f2a73be2f46840b182d7bd095378004e","f2a73be2f46840b182d7bd095378004e",22850177,2,0,1,1800,429,429,0
"f2a73be2f46840b182d7bd095378004e","604551fd4266430cb860fef58fa7dd61",22850177,1,1,0,1802,429,430,1
"604551fd4266430cb860fef58fa7dd61","604551fd4266430cb860fef58fa7dd61",22850177,8,0,1,1803,430,430,0
"604551fd4266430cb860fef58fa7dd61","24cf8786024543f19b89bc20034e60d7",22850177,1,-2,0,1811,430,428,-2
"24cf8786024543f19b89bc20034e60d7","dce46f8904594a62a6377a3587aaa663",22850177,1,4,0,1812,428,431,3
"dce46f8904594a62a6377a3587aaa663","dce46f8904594a62a6377a3587aaa663",22850177,2,0,1,1813,431,431,0
"dce46f8904594a62a6377a3587aaa663","9b9d0a249052413c869753b99682b0ac",22850177,1,1,0,1815,431,432,1
"9b9d0a249052413c869753b99682b0ac","9b9d0a249052413c869753b99682b0ac",22850177,7,0,1,1816,432,432,0
"9b9d0a249052413c869753b99682b0ac","061c175cc90f45fbad883025394e78dd",22850177,1,1,0,1823,432,433,1
"061c175cc90f45fbad883025394e78dd","061c175cc90f45fbad883025394e78dd",22850177,6,0,1,1824,433,433,0
"061c175cc90f45fbad883025394e78dd","dce46f8904594a62a6377a3587aaa663",22850177,1,-2,0,1830,433,431,-2
"dce46f8904594a62a6377a3587aaa663","74a7f8712e5449c2bc0b43c6f90dafed",22850177,1,5,0,1831,431,435,4
"74a7f8712e5449c2bc0b43c6f90dafed","74a7f8712e5449c2bc0b43c6f90dafed",22850177,1,0,1,1832,435,435,0
"74a7f8712e5449c2bc0b43c6f90dafed","66ada10dde9f43018588f1ced9d477fc",22850177,1,-1,0,1833,435,434,-1
"66ada10dde9f43018588f1ced9d477fc","24cf8786024543f19b89bc20034e60d7",22850177,1,-8,0,1834,434,428,-6
"24cf8786024543f19b89bc20034e60d7","070600601c4c439288445d2f0724807d",22850177,2,14,0,1835,428,437,9
"070600601c4c439288445d2f0724807d","1823b6de7d334a7aaabc4570719af4d9",22850177,4,2,0,1836,437,439,2
"1823b6de7d334a7aaabc4570719af4d9","1823b6de7d334a7aaabc4570719af4d9",22850177,13,0,1,1837,439,439,0
"1823b6de7d334a7aaabc4570719af4d9","070600601c4c439288445d2f0724807d",22850177,1,-2,0,1850,439,437,-2
"070600601c4c439288445d2f0724807d","0380cd76a7d44bc3a4da1f15e4d68f89",22850177,3,4,0,1851,437,440,3
"0380cd76a7d44bc3a4da1f15e4d68f89","0380cd76a7d44bc3a4da1f15e4d68f89",22850177,4,0,1,1852,440,440,0
"0380cd76a7d44bc3a4da1f15e4d68f89","070600601c4c439288445d2f0724807d",22850177,4,-4,0,1853,440,437,-3
"1823b6de7d334a7aaabc4570719af4d9","24cf8786024543f19b89bc20034e60d7",22850177,1,-16,0,1855,439,428,-11
"24cf8786024543f19b89bc20034e60d7","bf12c96466d840a69bed7020b3f18bb8",22850177,1,11,0,1856,428,436,8
"bf12c96466d840a69bed7020b3f18bb8","bf12c96466d840a69bed7020b3f18bb8",22850177,1,0,1,1857,436,436,0
"bf12c96466d840a69bed7020b3f18bb8","24cf8786024543f19b89bc20034e60d7",22850177,1,-11,0,1858,436,428,-8
"1823b6de7d334a7aaabc4570719af4d9","0380cd76a7d44bc3a4da1f15e4d68f89",22850177,2,2,0,1861,439,440,1
"0380cd76a7d44bc3a4da1f15e4d68f89","23b7673c8b5443108c2ef09382834a86",22850177,1,2,0,1865,440,441,1
"23b7673c8b5443108c2ef09382834a86","23b7673c8b5443108c2ef09382834a86",22850177,4,0,1,1866,441,441,0
"23b7673c8b5443108c2ef09382834a86","901e92500aea43c79f19f1b279050668",22850177,2,2,0,1867,441,442,1
"901e92500aea43c79f19f1b279050668","23b7673c8b5443108c2ef09382834a86",22850177,2,-2,0,1868,442,441,-1
"901e92500aea43c79f19f1b279050668","001339db8ced4cf78829ebe8b145449d",22850177,1,1,0,1870,442,443,1
"001339db8ced4cf78829ebe8b145449d","001339db8ced4cf78829ebe8b145449d",22850177,8,0,1,1871,443,443,0
"001339db8ced4cf78829ebe8b145449d","452745e0366e42ae81561bfddebcc6c3",22850177,1,1,0,1879,443,444,1
"452745e0366e42ae81561bfddebcc6c3","452745e0366e42ae81561bfddebcc6c3",22850177,5,0,1,1880,444,444,0
"452745e0366e42ae81561bfddebcc6c3","901e92500aea43c79f19f1b279050668",22850177,1,-2,0,1885,444,442,-2
"901e92500aea43c79f19f1b279050668","4660ff2089114e8db82ceb26a4f329e3",22850177,1,4,0,1886,442,445,3
"4660ff2089114e8db82ceb26a4f329e3","4660ff2089114e8db82ceb26a4f329e3",22850177,7,0,1,1887,445,445,0
"4660ff2089114e8db82ceb26a4f329e3","7bd5586eb9d8484eb74a433ee7bfe499",22850177,1,2,0,1889,445,446,1
"7bd5586eb9d8484eb74a433ee7bfe499","7bd5586eb9d8484eb74a433ee7bfe499",22850177,18,0,1,1890,446,446,0
"7bd5586eb9d8484eb74a433ee7bfe499","070600601c4c439288445d2f0724807d",22850177,1,-14,0,1908,446,437,-9
"070600601c4c439288445d2f0724807d","8a7f26e690f34dda97be16904518ca99",22850177,2,16,0,1909,437,447,10
"8a7f26e690f34dda97be16904518ca99","4660ff2089114e8db82ceb26a4f329e3",22850177,1,-4,0,1910,447,445,-2
"4660ff2089114e8db82ceb26a4f329e3","901e92500aea43c79f19f1b279050668",22850177,1,-4,0,1915,445,442,-3
"901e92500aea43c79f19f1b279050668","901e92500aea43c79f19f1b279050668",22850177,2,0,1,1916,442,442,0
"23b7673c8b5443108c2ef09382834a86","0380cd76a7d44bc3a4da1f15e4d68f89",22850177,1,-2,0,1922,441,440,-1
"070600601c4c439288445d2f0724807d","b2f0d654738f48158edff28e8d3a546e",22850177,2,21,0,1926,437,449,12
"b2f0d654738f48158edff28e8d3a546e","b2f0d654738f48158edff28e8d3a546e",22850177,1,0,1,1927,449,449,0
"b2f0d654738f48158edff28e8d3a546e","070600601c4c439288445d2f0724807d",22850177,2,-21,0,1928,449,437,-12
"8a7f26e690f34dda97be16904518ca99","8a7f26e690f34dda97be16904518ca99",22850177,1,0,1,1930,447,447,0
"8a7f26e690f34dda97be16904518ca99","b2f0d654738f48158edff28e8d3a546e",22850177,1,5,0,1931,447,449,2
"b2f0d654738f48158edff28e8d3a546e","f60ee41ec635499abd48168342d32c2f",22850177,4,5,0,1934,449,453,4
"f60ee41ec635499abd48168342d32c2f","f60ee41ec635499abd48168342d32c2f",22850177,76,0,1,1935,453,453,0
"f60ee41ec635499abd48168342d32c2f","b2f0d654738f48158edff28e8d3a546e",22850177,4,-5,0,1942,453,449,-4
"f60ee41ec635499abd48168342d32c2f","9428d8bd9c5a47b2a235b254e5e27ded",22850177,1,-1,0,1951,453,452,-1
"9428d8bd9c5a47b2a235b254e5e27ded","f60ee41ec635499abd48168342d32c2f",22850177,1,1,0,1952,452,453,1
"b2f0d654738f48158edff28e8d3a546e","f67fbf45a5f146ed866965bc57c7c001",22850177,2,8,0,2009,449,454,5
"f67fbf45a5f146ed866965bc57c7c001","f67fbf45a5f146ed866965bc57c7c001",22850177,3,0,1,2010,454,454,0
"f67fbf45a5f146ed866965bc57c7c001","d937afe49bd24a07a550dda1c1155122",22850177,1,1,0,2012,454,455,1
"d937afe49bd24a07a550dda1c1155122","d937afe49bd24a07a550dda1c1155122",22850177,1,0,1,2013,455,455,0
"d937afe49bd24a07a550dda1c1155122","3628b3f7823443d0912a339096b69943",22850177,1,1,0,2014,455,456,1
"3628b3f7823443d0912a339096b69943","3628b3f7823443d0912a339096b69943",22850177,1,0,1,2015,456,456,0
"3628b3f7823443d0912a339096b69943","9e049ee647cf43ecbcb5ed792a8e7588",22850177,1,1,0,2016,456,457,1
"9e049ee647cf43ecbcb5ed792a8e7588","9e049ee647cf43ecbcb5ed792a8e7588",22850177,1,0,1,2017,457,457,0
"9e049ee647cf43ecbcb5ed792a8e7588","5256a214faaf410b93f76cea06428334",22850177,1,1,0,2018,457,458,1
"5256a214faaf410b93f76cea06428334","5256a214faaf410b93f76cea06428334",22850177,1,0,1,2019,458,458,0
"5256a214faaf410b93f76cea06428334","25c32b120fce40fa9b6c85133aeb4716",22850177,1,1,0,2020,458,459,1
"25c32b120fce40fa9b6c85133aeb4716","25c32b120fce40fa9b6c85133aeb4716",22850177,1,0,1,2021,459,459,0
"25c32b120fce40fa9b6c85133aeb4716","11bc14f2204949008b7d511b933363c1",22850177,1,1,0,2022,459,460,1
"11bc14f2204949008b7d511b933363c1","11bc14f2204949008b7d511b933363c1",22850177,1,0,1,2023,460,460,0
"11bc14f2204949008b7d511b933363c1","42de338840a34d15adb66e7b14fb9d2c",22850177,1,1,0,2024,460,461,1
"42de338840a34d15adb66e7b14fb9d2c","42de338840a34d15adb66e7b14fb9d2c",22850177,1,0,1,2025,461,461,0
"42de338840a34d15adb66e7b14fb9d2c","9da37c6210b1416b8079c274f70bf600",22850177,1,1,0,2026,461,462,1
"9da37c6210b1416b8079c274f70bf600","9da37c6210b1416b8079c274f70bf600",22850177,3,0,1,2027,462,462,0
"9da37c6210b1416b8079c274f70bf600","519119f1deac45ff9ab4f13529be5c6e",22850177,1,1,0,2030,462,463,1
"519119f1deac45ff9ab4f13529be5c6e","519119f1deac45ff9ab4f13529be5c6e",22850177,3,0,1,2031,463,463,0
"519119f1deac45ff9ab4f13529be5c6e","f67fbf45a5f146ed866965bc57c7c001",22850177,1,-9,0,2034,463,454,-9
"f67fbf45a5f146ed866965bc57c7c001","c5df9f40ec14463b9dcfdc73df3e9285",22850177,2,12,0,2035,454,464,10
"c5df9f40ec14463b9dcfdc73df3e9285","c5df9f40ec14463b9dcfdc73df3e9285",22850177,3,0,1,2036,464,464,0
"c5df9f40ec14463b9dcfdc73df3e9285","83d42d95cd844fc093fc09cee250edb8",22850177,1,3,0,2038,464,465,1
"83d42d95cd844fc093fc09cee250edb8","83d42d95cd844fc093fc09cee250edb8",22850177,3,0,1,2039,465,465,0
"83d42d95cd844fc093fc09cee250edb8","b2f0d654738f48158edff28e8d3a546e",22850177,1,-23,0,2042,465,449,-16
"c5df9f40ec14463b9dcfdc73df3e9285","070600601c4c439288445d2f0724807d",22850177,1,-41,0,2058,464,437,-27
"070600601c4c439288445d2f0724807d","4660ff2089114e8db82ceb26a4f329e3",22850177,1,12,0,2059,437,445,8
"4660ff2089114e8db82ceb26a4f329e3","070600601c4c439288445d2f0724807d",22850177,1,-12,0,2061,445,437,-8
"070600601c4c439288445d2f0724807d","070600601c4c439288445d2f0724807d",22850177,1,0,1,2062,437,437,0
"b7719e26494940efa49512aedd0aac79","b7719e26494940efa49512aedd0aac79",22850817,6,0,1,1,20,20,0
"e2911e79efc2420eac45d9f671463d4b","e2911e79efc2420eac45d9f671463d4b",22850817,6,0,1,10,2,2,0
"e2911e79efc2420eac45d9f671463d4b","519d1b8c59404d67b54e96c5c8a830b2",22850817,3,1,0,11,2,3,1
"519d1b8c59404d67b54e96c5c8a830b2","519d1b8c59404d67b54e96c5c8a830b2",22850817,1,0,1,12,3,3,0
"519d1b8c59404d67b54e96c5c8a830b2","531db53f81f646edb0cdcfe0085b03b7",22850817,3,1,0,13,3,4,1
"531db53f81f646edb0cdcfe0085b03b7","531db53f81f646edb0cdcfe0085b03b7",22850817,1,0,1,14,4,4,0
"531db53f81f646edb0cdcfe0085b03b7","4f5f94b2f95141e0a9d53a61da2276da",22850817,3,1,0,15,4,5,1
"4f5f94b2f95141e0a9d53a61da2276da","4f5f94b2f95141e0a9d53a61da2276da",22850817,1,0,1,16,5,5,0
"4f5f94b2f95141e0a9d53a61da2276da","6d541c89590949f99af293c4f2333f67",22850817,1,1,0,17,5,6,1
"6d541c89590949f99af293c4f2333f67","6d541c89590949f99af293c4f2333f67",22850817,1,0,1,18,6,6,0
"6d541c89590949f99af293c4f2333f67","dd5cf0b9fe4c4f1d8f5ff8e4c04879cb",22850817,2,1,0,19,6,7,1
"dd5cf0b9fe4c4f1d8f5ff8e4c04879cb","dd5cf0b9fe4c4f1d8f5ff8e4c04879cb",22850817,1,0,1,20,7,7,0
"dd5cf0b9fe4c4f1d8f5ff8e4c04879cb","f96261861edc426abe2248be4f0a709a",22850817,1,1,0,21,7,8,1
"f96261861edc426abe2248be4f0a709a","f96261861edc426abe2248be4f0a709a",22850817,1,0,1,22,8,8,0
"f96261861edc426abe2248be4f0a709a","66b5e16f4f75454fb5b8172079f0fa83",22850817,2,1,0,23,8,9,1
"66b5e16f4f75454fb5b8172079f0fa83","66b5e16f4f75454fb5b8172079f0fa83",22850817,3,0,1,24,9,9,0
"66b5e16f4f75454fb5b8172079f0fa83","f96261861edc426abe2248be4f0a709a",22850817,1,-1,0,26,9,8,-1
"f96261861edc426abe2248be4f0a709a","dd5cf0b9fe4c4f1d8f5ff8e4c04879cb",22850817,1,-1,0,27,8,7,-1
"dd5cf0b9fe4c4f1d8f5ff8e4c04879cb","6d541c89590949f99af293c4f2333f67",22850817,1,-1,0,28,7,6,-1
"6d541c89590949f99af293c4f2333f67","4f5f94b2f95141e0a9d53a61da2276da",22850817,1,-1,0,29,6,5,-1
"4f5f94b2f95141e0a9d53a61da2276da","e2911e79efc2420eac45d9f671463d4b",22850817,1,-3,0,30,5,2,-3
"e2911e79efc2420eac45d9f671463d4b","6d541c89590949f99af293c4f2333f67",22850817,1,4,0,34,2,6,4
"dd5cf0b9fe4c4f1d8f5ff8e4c04879cb","e2911e79efc2420eac45d9f671463d4b",22850817,1,-5,0,36,7,2,-5
"4f5f94b2f95141e0a9d53a61da2276da","f96261861edc426abe2248be4f0a709a",22850817,1,3,0,40,5,8,3
"66b5e16f4f75454fb5b8172079f0fa83","e2911e79efc2420eac45d9f671463d4b",22850817,1,-7,0,43,9,2,-7
"e2911e79efc2420eac45d9f671463d4b","b613861cecf84ffcab01afb23f660475",22850817,2,-3,0,44,2,1,-1
"b613861cecf84ffcab01afb23f660475","b613861cecf84ffcab01afb23f660475",22850817,7,0,1,45,1,1,0
"b613861cecf84ffcab01afb23f660475","e2911e79efc2420eac45d9f671463d4b",22850817,5,3,0,48,1,2,1
"e2911e79efc2420eac45d9f671463d4b","0680571d4698477995e41842c36a54b2",22850817,1,8,0,49,2,10,8
"0680571d4698477995e41842c36a54b2","0680571d4698477995e41842c36a54b2",22850817,2,0,1,50,10,10,0
"0680571d4698477995e41842c36a54b2","9112f2bffece48e08c6d2287be204085",22850817,1,1,0,52,10,11,1
"9112f2bffece48e08c6d2287be204085","9112f2bffece48e08c6d2287be204085",22850817,3,0,1,53,11,11,0
"9112f2bffece48e08c6d2287be204085","e2911e79efc2420eac45d9f671463d4b",22850817,2,-9,0,55,11,2,-9
"4f5f94b2f95141e0a9d53a61da2276da","56586aa865414f538729c7f7735d2bc6",22850817,1,9,0,59,5,12,7
"56586aa865414f538729c7f7735d2bc6","e2911e79efc2420eac45d9f671463d4b",22850817,2,-12,0,60,12,2,-10
"e2911e79efc2420eac45d9f671463d4b","56586aa865414f538729c7f7735d2bc6",22850817,4,12,0,61,2,12,10
"56586aa865414f538729c7f7735d2bc6","b613861cecf84ffcab01afb23f660475",22850817,1,-15,0,62,12,1,-11
"e2911e79efc2420eac45d9f671463d4b","9112f2bffece48e08c6d2287be204085",22850817,1,9,0,65,2,11,9
"3f1c815879794b929260d224becaff7e","81c864a886d54a6b8ff85f7d736f4f95",22850817,1,2,0,77,14,15,1
"81c864a886d54a6b8ff85f7d736f4f95","81c864a886d54a6b8ff85f7d736f4f95",22850817,2,0,1,78,15,15,0
"81c864a886d54a6b8ff85f7d736f4f95","5c5ceeee4562457ba6d41515aeebfbb1",22850817,1,4,0,80,15,17,2
"5c5ceeee4562457ba6d41515aeebfbb1","eb2a0eb537344a9e891c761662e400b6",22850817,1,-2,0,81,17,16,-1
"eb2a0eb537344a9e891c761662e400b6","5c5ceeee4562457ba6d41515aeebfbb1",22850817,1,2,0,82,16,17,1
"5c5ceeee4562457ba6d41515aeebfbb1","3f1c815879794b929260d224becaff7e",22850817,1,-6,0,83,17,14,-3
"3f1c815879794b929260d224becaff7e","5c5ceeee4562457ba6d41515aeebfbb1",22850817,1,6,0,84,14,17,3
"5c5ceeee4562457ba6d41515aeebfbb1","56586aa865414f538729c7f7735d2bc6",22850817,1,-10,0,85,17,12,-5
"56586aa865414f538729c7f7735d2bc6","9afd71a5298d4333b6849dfce1b9422c",22850817,1,13,0,86,12,18,6
"9afd71a5298d4333b6849dfce1b9422c","56586aa865414f538729c7f7735d2bc6",22850817,2,-13,0,88,18,12,-6
"56586aa865414f538729c7f7735d2bc6","5c5ceeee4562457ba6d41515aeebfbb1",22850817,1,10,0,89,12,17,5
"5c5ceeee4562457ba6d41515aeebfbb1","9afd71a5298d4333b6849dfce1b9422c",22850817,1,3,0,90,17,18,1
"56586aa865414f538729c7f7735d2bc6","b7719e26494940efa49512aedd0aac79",22850817,1,17,0,92,12,20,8
"d4c3b003e8274e429d2fa688d73fde6d","d4c3b003e8274e429d2fa688d73fde6d",22850817,11,0,1,100,22,22,0
"d4c3b003e8274e429d2fa688d73fde6d","b7719e26494940efa49512aedd0aac79",22850817,4,-3,0,103,22,20,-2
"b7719e26494940efa49512aedd0aac79","9afd71a5298d4333b6849dfce1b9422c",22850817,5,-4,0,104,20,18,-2
"9afd71a5298d4333b6849dfce1b9422c","b7719e26494940efa49512aedd0aac79",22850817,4,4,0,105,18,20,2
"b7719e26494940efa49512aedd0aac79","afbf7250b99d47bea07172749483ca97",22850817,3,12,0,107,20,28,8
"afbf7250b99d47bea07172749483ca97","afbf7250b99d47bea07172749483ca97",22850817,1,0,1,108,28,28,0
"afbf7250b99d47bea07172749483ca97","4e51676dc72045d99c19b9fa7b22f8bc",22850817,1,3,0,109,28,29,1
"4e51676dc72045d99c19b9fa7b22f8bc","4e51676dc72045d99c19b9fa7b22f8bc",22850817,1,0,1,110,29,29,0
"4e51676dc72045d99c19b9fa7b22f8bc","51970cfa30e643e894e66ae85c8024cc",22850817,2,3,0,111,29,31,2
"51970cfa30e643e894e66ae85c8024cc","c9c52446b6294aa5a9c2abaed536c37e",22850817,1,2,0,112,31,32,1
"c9c52446b6294aa5a9c2abaed536c37e","4e51676dc72045d99c19b9fa7b22f8bc",22850817,1,-5,0,113,32,29,-3
"51970cfa30e643e894e66ae85c8024cc","4e51676dc72045d99c19b9fa7b22f8bc",22850817,1,-3,0,115,31,29,-2
"4e51676dc72045d99c19b9fa7b22f8bc","c33c17be71ae4d588da7369472e5bb1b",22850817,2,9,0,116,29,34,5
"c33c17be71ae4d588da7369472e5bb1b","c33c17be71ae4d588da7369472e5bb1b",22850817,2,0,1,117,34,34,0
"c33c17be71ae4d588da7369472e5bb1b","93679be414554a11b1893002f2229a93",22850817,1,3,0,118,34,35,1
"93679be414554a11b1893002f2229a93","7040a13096d746ac84b8fac8d9752058",22850817,1,3,0,119,35,36,1
"7040a13096d746ac84b8fac8d9752058","93679be414554a11b1893002f2229a93",22850817,1,-3,0,120,36,35,-1
"93679be414554a11b1893002f2229a93","9a0dc646f934470daf08c4b56ccf73db",22850817,1,6,0,121,35,37,2
"9a0dc646f934470daf08c4b56ccf73db","7040a13096d746ac84b8fac8d9752058",22850817,1,-3,0,122,37,36,-1
"7040a13096d746ac84b8fac8d9752058","9a0dc646f934470daf08c4b56ccf73db",22850817,1,3,0,123,36,37,1
"9a0dc646f934470daf08c4b56ccf73db","fc0e049d56024bc9a02c9a9c435c3df7",22850817,4,3,0,124,37,38,1
"fc0e049d56024bc9a02c9a9c435c3df7","b7719e26494940efa49512aedd0aac79",22850817,1,-36,0,125,38,20,-18
"b7719e26494940efa49512aedd0aac79","b613861cecf84ffcab01afb23f660475",22850817,2,-32,0,126,20,1,-19
"b613861cecf84ffcab01afb23f660475","a49d1bb4328949299686242fd0be5584",22850817,1,34,0,127,1,21,20
"a49d1bb4328949299686242fd0be5584","b7719e26494940efa49512aedd0aac79",22850817,1,-2,0,128,21,20,-1
"b7719e26494940efa49512aedd0aac79","a49d1bb4328949299686242fd0be5584",22850817,3,2,0,129,20,21,1
"a49d1bb4328949299686242fd0be5584","d4c3b003e8274e429d2fa688d73fde6d",22850817,3,1,0,130,21,22,1
"d4c3b003e8274e429d2fa688d73fde6d","d4f45188d3c84a02ba08454e6403a818",22850817,1,2,0,131,22,24,2
"d4f45188d3c84a02ba08454e6403a818","9afd71a5298d4333b6849dfce1b9422c",22850817,1,-9,0,132,24,18,-6
"9afd71a5298d4333b6849dfce1b9422c","d4f45188d3c84a02ba08454e6403a818",22850817,4,9,0,136,18,24,6
"d4f45188d3c84a02ba08454e6403a818","d4c3b003e8274e429d2fa688d73fde6d",22850817,5,-2,0,137,24,22,-2
"d4c3b003e8274e429d2fa688d73fde6d","56586aa865414f538729c7f7735d2bc6",22850817,1,-20,0,138,22,12,-10
"56586aa865414f538729c7f7735d2bc6","3f1c815879794b929260d224becaff7e",22850817,1,4,0,139,12,14,2
"3f1c815879794b929260d224becaff7e","b613861cecf84ffcab01afb23f660475",22850817,1,-19,0,140,14,1,-13
"b613861cecf84ffcab01afb23f660475","b7719e26494940efa49512aedd0aac79",22850817,1,32,0,141,1,20,19
"a49d1bb4328949299686242fd0be5584","a49d1bb4328949299686242fd0be5584",22850817,1,0,1,143,21,21,0
"a49d1bb4328949299686242fd0be5584","d4f45188d3c84a02ba08454e6403a818",22850817,2,3,0,144,21,24,3
"b7719e26494940efa49512aedd0aac79","fc0e049d56024bc9a02c9a9c435c3df7",22850817,1,36,0,147,20,38,18
"fc0e049d56024bc9a02c9a9c435c3df7","fc0e049d56024bc9a02c9a9c435c3df7",22850817,3,0,1,148,38,38,0
"fc0e049d56024bc9a02c9a9c435c3df7","67a089198fcb4e1c8f2385786c2b296f",22850817,4,4,0,150,38,39,1
"67a089198fcb4e1c8f2385786c2b296f","fc0e049d56024bc9a02c9a9c435c3df7",22850817,2,-4,0,151,39,38,-1
"fc0e049d56024bc9a02c9a9c435c3df7","64d48c6c9c7940639a932219a6c87198",22850817,1,5,0,152,38,40,2
"64d48c6c9c7940639a932219a6c87198","67a089198fcb4e1c8f2385786c2b296f",22850817,12,-1,0,153,40,39,-1
"64d48c6c9c7940639a932219a6c87198","fc0e049d56024bc9a02c9a9c435c3df7",22850817,2,-5,0,157,40,38,-2
"67a089198fcb4e1c8f2385786c2b296f","b7719e26494940efa49512aedd0aac79",22850817,1,-40,0,159,39,20,-19
"d4f45188d3c84a02ba08454e6403a818","a49d1bb4328949299686242fd0be5584",22850817,2,-3,0,162,24,21,-3
"d4c3b003e8274e429d2fa688d73fde6d","67a089198fcb4e1c8f2385786c2b296f",22850817,1,37,0,164,22,39,17
"64d48c6c9c7940639a932219a6c87198","64d48c6c9c7940639a932219a6c87198",22850817,29,0,1,166,40,40,0
"b534b89233134e30a9b5645138bfa9ee","0e37b720d23b4e7f8b313e79313fd107",22850817,2,3,0,180,41,44,3
"0e37b720d23b4e7f8b313e79313fd107","6875d67fdd5f48168b62719df449bebd",22850817,2,1,0,181,44,45,1
"6875d67fdd5f48168b62719df449bebd","0e37b720d23b4e7f8b313e79313fd107",22850817,2,-1,0,182,45,44,-1
"0e37b720d23b4e7f8b313e79313fd107","0e37b720d23b4e7f8b313e79313fd107",22850817,1,0,1,183,44,44,0
"6875d67fdd5f48168b62719df449bebd","6875d67fdd5f48168b62719df449bebd",22850817,2,0,1,185,45,45,0
"0e37b720d23b4e7f8b313e79313fd107","6e13d61a7bdb44bca949c9f86fab3be5",22850817,2,4,0,188,44,47,3
"6e13d61a7bdb44bca949c9f86fab3be5","b534b89233134e30a9b5645138bfa9ee",22850817,6,-7,0,189,47,41,-6
"6e13d61a7bdb44bca949c9f86fab3be5","6e13d61a7bdb44bca949c9f86fab3be5",22850817,4,0,1,191,47,47,0
"6e13d61a7bdb44bca949c9f86fab3be5","195f78799f984cc2b06c48dfe36be751",22850817,1,2,0,193,47,49,2
"195f78799f984cc2b06c48dfe36be751","195f78799f984cc2b06c48dfe36be751",22850817,2,0,1,194,49,49,0
"195f78799f984cc2b06c48dfe36be751","d9c8d8c444a64dadbbb508652c721e17",22850817,1,-3,0,196,49,46,-3
"d9c8d8c444a64dadbbb508652c721e17","d0c74f735e024943943e40333d6d337f",22850817,5,6,0,197,46,51,5
"d0c74f735e024943943e40333d6d337f","d0c74f735e024943943e40333d6d337f",22850817,6,0,1,198,51,51,0
"d0c74f735e024943943e40333d6d337f","983f8ff320594b279a7f4a6fe132f9c5",22850817,1,2,0,203,51,53,2
"983f8ff320594b279a7f4a6fe132f9c5","983f8ff320594b279a7f4a6fe132f9c5",22850817,5,0,1,204,53,53,0
"983f8ff320594b279a7f4a6fe132f9c5","35adfa5d923046aebabfefd98f35ff05",22850817,1,1,0,209,53,54,1
"35adfa5d923046aebabfefd98f35ff05","35adfa5d923046aebabfefd98f35ff05",22850817,9,0,1,210,54,54,0
"35adfa5d923046aebabfefd98f35ff05","67a089198fcb4e1c8f2385786c2b296f",22850817,1,-19,0,212,54,39,-15
"fc0e049d56024bc9a02c9a9c435c3df7","9a0dc646f934470daf08c4b56ccf73db",22850817,2,-3,0,230,38,37,-1
"fc0e049d56024bc9a02c9a9c435c3df7","f924752d8a1149668870b1e7698486f7",22850817,1,19,0,232,38,50,12
"f924752d8a1149668870b1e7698486f7","f924752d8a1149668870b1e7698486f7",22850817,1,0,1,233,50,50,0
"f924752d8a1149668870b1e7698486f7","b534b89233134e30a9b5645138bfa9ee",22850817,1,-11,0,234,50,41,-9
"b534b89233134e30a9b5645138bfa9ee","d0c74f735e024943943e40333d6d337f",22850817,4,12,0,235,41,51,10
"d0c74f735e024943943e40333d6d337f","f924752d8a1149668870b1e7698486f7",22850817,5,-1,0,236,51,50,-1
"f924752d8a1149668870b1e7698486f7","6e13d61a7bdb44bca949c9f86fab3be5",22850817,2,-4,0,237,50,47,-3
"6e13d61a7bdb44bca949c9f86fab3be5","d9c8d8c444a64dadbbb508652c721e17",22850817,6,-1,0,238,47,46,-1
"d9c8d8c444a64dadbbb508652c721e17","b534b89233134e30a9b5645138bfa9ee",22850817,2,-6,0,239,46,41,-5
"67a089198fcb4e1c8f2385786c2b296f","9a0dc646f934470daf08c4b56ccf73db",22850817,1,-7,0,246,39,37,-2
"b534b89233134e30a9b5645138bfa9ee","d9c8d8c444a64dadbbb508652c721e17",22850817,1,6,0,258,41,46,5
"d9c8d8c444a64dadbbb508652c721e17","67a089198fcb4e1c8f2385786c2b296f",22850817,1,-10,0,259,46,39,-7
"b534b89233134e30a9b5645138bfa9ee","64d48c6c9c7940639a932219a6c87198",22850817,1,-3,0,261,41,40,-1
"67a089198fcb4e1c8f2385786c2b296f","6e13d61a7bdb44bca949c9f86fab3be5",22850817,1,11,0,265,39,47,8
"d0c74f735e024943943e40333d6d337f","35adfa5d923046aebabfefd98f35ff05",22850817,1,3,0,271,51,54,3
"35adfa5d923046aebabfefd98f35ff05","d0c74f735e024943943e40333d6d337f",22850817,1,-3,0,272,54,51,-3
"d0c74f735e024943943e40333d6d337f","b6f8a98476224da1b40e555ececc7ed8",22850817,1,4,0,273,51,55,4
"b6f8a98476224da1b40e555ececc7ed8","b6f8a98476224da1b40e555ececc7ed8",22850817,2,0,1,274,55,55,0
"b6f8a98476224da1b40e555ececc7ed8","86e22cb5fe0e4b47a9489ecddf7ed78f",22850817,1,1,0,276,55,56,1
"86e22cb5fe0e4b47a9489ecddf7ed78f","86e22cb5fe0e4b47a9489ecddf7ed78f",22850817,2,0,1,277,56,56,0
"86e22cb5fe0e4b47a9489ecddf7ed78f","35adfa5d923046aebabfefd98f35ff05",22850817,1,-2,0,279,56,54,-2
"35adfa5d923046aebabfefd98f35ff05","78f30e4dcac84e3cbea8b2cc6e0d62b3",22850817,1,6,0,282,54,59,5
"78f30e4dcac84e3cbea8b2cc6e0d62b3","f924752d8a1149668870b1e7698486f7",22850817,1,-10,0,283,59,50,-9
"f924752d8a1149668870b1e7698486f7","a1f2f12debe5432fb7a70bcd12bacfb9",22850817,4,9,0,284,50,58,8
"a1f2f12debe5432fb7a70bcd12bacfb9","a1f2f12debe5432fb7a70bcd12bacfb9",22850817,21,0,1,285,58,58,0
"12aa6e1672ac4e7aa6449a7a8609cd72","d0c74f735e024943943e40333d6d337f",22850817,1,-7,0,294,57,51,-6
"a0a418b8540d479fa6e0f653b701da8b","67a089198fcb4e1c8f2385786c2b296f",22850817,1,-31,0,336,64,39,-25
"67a089198fcb4e1c8f2385786c2b296f","309ccf3cc4fe429d9bfbaef53d3fa479",22850817,2,27,0,341,39,60,21
"b534b89233134e30a9b5645138bfa9ee","a0a418b8540d479fa6e0f653b701da8b",22850817,2,27,0,343,41,64,23
"d646286c8051419bbc2e31dd1db55ca8","267f883678b24aed855fde42524975d9",22850817,1,4,0,348,67,71,4
"267f883678b24aed855fde42524975d9","267f883678b24aed855fde42524975d9",22850817,1,0,1,349,71,71,0
"267f883678b24aed855fde42524975d9","88fff56d0342490dbef9040750a20f6c",22850817,1,1,0,350,71,72,1
"88fff56d0342490dbef9040750a20f6c","88fff56d0342490dbef9040750a20f6c",22850817,1,0,1,351,72,72,0
"88fff56d0342490dbef9040750a20f6c","adb17b12b66c4a49a85fd34322f7df70",22850817,1,1,0,352,72,73,1
"adb17b12b66c4a49a85fd34322f7df70","adb17b12b66c4a49a85fd34322f7df70",22850817,1,0,1,353,73,73,0
"adb17b12b66c4a49a85fd34322f7df70","a2becd407db34b189200a32546d9d569",22850817,1,3,0,354,73,75,2
"a2becd407db34b189200a32546d9d569","a2becd407db34b189200a32546d9d569",22850817,16,0,1,357,75,75,0
"a2becd407db34b189200a32546d9d569","58c22b011d0f4c2ea6d13615edbb9eeb",22850817,1,2,0,373,75,77,2
"58c22b011d0f4c2ea6d13615edbb9eeb","58c22b011d0f4c2ea6d13615edbb9eeb",22850817,2,0,1,374,77,77,0
"58c22b011d0f4c2ea6d13615edbb9eeb","dd76e1861dc9461c830888729d091ee0",22850817,1,1,0,376,77,78,1
"dd76e1861dc9461c830888729d091ee0","dd76e1861dc9461c830888729d091ee0",22850817,8,0,1,377,78,78,0
"dd76e1861dc9461c830888729d091ee0","cd1d828f1a694b87913a7ea66c23803e",22850817,1,1,0,385,78,79,1
"cd1d828f1a694b87913a7ea66c23803e","cd1d828f1a694b87913a7ea66c23803e",22850817,2,0,1,386,79,79,0
"cd1d828f1a694b87913a7ea66c23803e","9176a3c2b4d2465fa8b0c67096c2a97e",22850817,1,1,0,388,79,80,1
"9176a3c2b4d2465fa8b0c67096c2a97e","9176a3c2b4d2465fa8b0c67096c2a97e",22850817,5,0,1,389,80,80,0
"9176a3c2b4d2465fa8b0c67096c2a97e","f8ec6445f7194e25b9101d4fbcb07a18",22850817,1,1,0,394,80,81,1
"f8ec6445f7194e25b9101d4fbcb07a18","f8ec6445f7194e25b9101d4fbcb07a18",22850817,2,0,1,395,81,81,0
"f8ec6445f7194e25b9101d4fbcb07a18","140d5b27b8574befad82c0a013b59dfa",22850817,1,-7,0,397,81,74,-7
"140d5b27b8574befad82c0a013b59dfa","67a089198fcb4e1c8f2385786c2b296f",22850817,1,-45,0,398,74,39,-35
"67a089198fcb4e1c8f2385786c2b296f","d646286c8051419bbc2e31dd1db55ca8",22850817,3,37,0,399,39,67,28
"d646286c8051419bbc2e31dd1db55ca8","d18a9ea32855445f8736581f5cb119ce",22850817,1,17,0,400,67,82,15
"d18a9ea32855445f8736581f5cb119ce","d18a9ea32855445f8736581f5cb119ce",22850817,1,0,1,401,82,82,0
"d18a9ea32855445f8736581f5cb119ce","f564483cbd7a407681aa2fcca518cf5f",22850817,1,4,0,402,82,85,3
"f564483cbd7a407681aa2fcca518cf5f","f564483cbd7a407681aa2fcca518cf5f",22850817,1,0,1,403,85,85,0
"f564483cbd7a407681aa2fcca518cf5f","67a089198fcb4e1c8f2385786c2b296f",22850817,1,-58,0,404,85,39,-46
"64d48c6c9c7940639a932219a6c87198","42fb58708eaf4e5daa82bfca61b6f5fd",22850817,1,60,0,408,40,87,47
"42fb58708eaf4e5daa82bfca61b6f5fd","d646286c8051419bbc2e31dd1db55ca8",22850817,2,-24,0,409,87,67,-20
"d646286c8051419bbc2e31dd1db55ca8","6a9f0ef185fb47f0937e29daa1c71ed5",22850817,2,27,0,410,67,90,23
"d646286c8051419bbc2e31dd1db55ca8","1febb706d7a34005ae8711ed49c76e64",22850817,1,33,0,413,67,94,27
"1febb706d7a34005ae8711ed49c76e64","1febb706d7a34005ae8711ed49c76e64",22850817,2,0,1,414,94,94,0
"1febb706d7a34005ae8711ed49c76e64","8f73ba6f5a0042f2850356ac38ac6f24",22850817,1,1,0,416,94,95,1
"8f73ba6f5a0042f2850356ac38ac6f24","8f73ba6f5a0042f2850356ac38ac6f24",22850817,5,0,1,417,95,95,0
"8f73ba6f5a0042f2850356ac38ac6f24","e2260b86653c46d7b14a41fb419dbf8c",22850817,1,1,0,422,95,96,1
"e2260b86653c46d7b14a41fb419dbf8c","e2260b86653c46d7b14a41fb419dbf8c",22850817,2,0,1,423,96,96,0
"e2260b86653c46d7b14a41fb419dbf8c","35eb641ad1d845bbba54915bce75a962",22850817,1,1,0,425,96,97,1
"35eb641ad1d845bbba54915bce75a962","35eb641ad1d845bbba54915bce75a962",22850817,3,0,1,426,97,97,0
"35eb641ad1d845bbba54915bce75a962","08be90ffbeea4795a138cd42ed8db56f",22850817,1,1,0,429,97,98,1
"08be90ffbeea4795a138cd42ed8db56f","08be90ffbeea4795a138cd42ed8db56f",22850817,3,0,1,430,98,98,0
"08be90ffbeea4795a138cd42ed8db56f","3007433c8f584dcbb5ac159c1c5f2be3",22850817,1,1,0,433,98,99,1
"3007433c8f584dcbb5ac159c1c5f2be3","3007433c8f584dcbb5ac159c1c5f2be3",22850817,3,0,1,434,99,99,0
"3007433c8f584dcbb5ac159c1c5f2be3","00ae5f0c51874a73a41ebea838d95682",22850817,1,3,0,437,99,101,2
"d391c8b6e56a43a7b654e9dee02d904b","00ae5f0c51874a73a41ebea838d95682",22850817,2,-2,0,440,103,101,-2
"d391c8b6e56a43a7b654e9dee02d904b","d391c8b6e56a43a7b654e9dee02d904b",22850817,17,0,1,442,103,103,0
"d391c8b6e56a43a7b654e9dee02d904b","6111116566fc4fd9abba409322bea245",22850817,1,1,0,459,103,104,1
"6111116566fc4fd9abba409322bea245","6111116566fc4fd9abba409322bea245",22850817,2,0,1,460,104,104,0
"6111116566fc4fd9abba409322bea245","a81b2235cb9c499eb9ea8ee0a8dd9725",22850817,1,1,0,462,104,105,1
"a81b2235cb9c499eb9ea8ee0a8dd9725","a81b2235cb9c499eb9ea8ee0a8dd9725",22850817,2,0,1,463,105,105,0
"a81b2235cb9c499eb9ea8ee0a8dd9725","2d4e0ab0ef3b4d73b82c72d4621a7579",22850817,1,1,0,465,105,106,1
"2d4e0ab0ef3b4d73b82c72d4621a7579","2d4e0ab0ef3b4d73b82c72d4621a7579",22850817,2,0,1,466,106,106,0
"2d4e0ab0ef3b4d73b82c72d4621a7579","8bdebf492ebd4e62b0d522e8ab5e5197",22850817,1,1,0,468,106,107,1
"8bdebf492ebd4e62b0d522e8ab5e5197","8bdebf492ebd4e62b0d522e8ab5e5197",22850817,5,0,1,469,107,107,0
"8bdebf492ebd4e62b0d522e8ab5e5197","4280927ec4d643238aa49c32f9e06c6c",22850817,1,3,0,474,107,109,2
"4280927ec4d643238aa49c32f9e06c6c","fc44e6a5f7654430af1227838224dceb",22850817,1,2,0,477,109,111,2
"fc44e6a5f7654430af1227838224dceb","fc44e6a5f7654430af1227838224dceb",22850817,2,0,1,478,111,111,0
"fc44e6a5f7654430af1227838224dceb","08111f75e22d409998cf8b85bd431f0a",22850817,1,-3,0,480,111,108,-3
"a9ae0a3c070d455bb4369a8996313336","71cec822bcff4f30a20e75dc63ef7b65",22850817,1,2,0,482,114,116,2
"71cec822bcff4f30a20e75dc63ef7b65","71cec822bcff4f30a20e75dc63ef7b65",22850817,1,0,1,483,116,116,0
"71cec822bcff4f30a20e75dc63ef7b65","37319e88176d4aefa91d7a9980dbae91",22850817,1,-4,0,484,116,112,-4
"779f9ddd1fd14d1e9e69f72219a1fdbd","67a089198fcb4e1c8f2385786c2b296f",22850817,2,-103,0,488,121,39,-82
"d646286c8051419bbc2e31dd1db55ca8","ae5ac430ea254e708a6f5deaaf7464ae",22850817,1,20,0,490,67,84,17
"ae5ac430ea254e708a6f5deaaf7464ae","18fd01350bd5434ca636d59a599d768a",22850817,1,2,0,491,84,86,2
"18fd01350bd5434ca636d59a599d768a","18fd01350bd5434ca636d59a599d768a",22850817,9,0,1,492,86,86,0
"18fd01350bd5434ca636d59a599d768a","6a9f0ef185fb47f0937e29daa1c71ed5",22850817,1,5,0,501,86,90,4
"ae5ac430ea254e708a6f5deaaf7464ae","67a089198fcb4e1c8f2385786c2b296f",22850817,1,-57,0,503,84,39,-45
"67a089198fcb4e1c8f2385786c2b296f","12aa6e1672ac4e7aa6449a7a8609cd72",22850817,1,23,0,504,39,57,18
"12aa6e1672ac4e7aa6449a7a8609cd72","b534b89233134e30a9b5645138bfa9ee",22850817,1,-19,0,505,57,41,-16
"78f30e4dcac84e3cbea8b2cc6e0d62b3","67a089198fcb4e1c8f2385786c2b296f",22850817,1,-25,0,508,59,39,-20
"67a089198fcb4e1c8f2385786c2b296f","e20db35ced8544ddac5bc3839145e463",22850817,1,67,0,509,39,91,52
"e20db35ced8544ddac5bc3839145e463","37319e88176d4aefa91d7a9980dbae91",22850817,2,24,0,510,91,112,21
"37319e88176d4aefa91d7a9980dbae91","a9ae0a3c070d455bb4369a8996313336",22850817,1,2,0,511,112,114,2
"a9ae0a3c070d455bb4369a8996313336","67a089198fcb4e1c8f2385786c2b296f",22850817,1,-93,0,512,114,39,-75
"67a089198fcb4e1c8f2385786c2b296f","78adeee1fa2c4fe0bc73f7bca9fcee86",22850817,1,152,0,513,39,160,121
"65202579580f4ad38d734b4ee39d22a8","67a089198fcb4e1c8f2385786c2b296f",22850817,2,-157,0,524,164,39,-125
"bc42d26810654ea9a1df1efe1e58c7d5","67a089198fcb4e1c8f2385786c2b296f",22850817,1,-30,0,529,63,39,-24
"df1de691dafe4549a18a4398ee9dfaf9","6a9f0ef185fb47f0937e29daa1c71ed5",22850817,1,-62,0,534,139,90,-49
"6a9f0ef185fb47f0937e29daa1c71ed5","62bff51286ef4f348717a3cf6fe2318f",22850817,2,36,0,535,90,120,30
"62bff51286ef4f348717a3cf6fe2318f","d313cec988a84645bee413e8d4724a4b",22850817,2,48,0,536,120,158,38
"d313cec988a84645bee413e8d4724a4b","f4ce60b4a944484082ccb701b48b3da1",22850817,1,-1,0,537,158,157,-1
"f4ce60b4a944484082ccb701b48b3da1","73039f8c1eb9409cb4caee2cf968001e",22850817,1,-70,0,538,157,100,-57
"73039f8c1eb9409cb4caee2cf968001e","e20db35ced8544ddac5bc3839145e463",22850817,1,-10,0,539,100,91,-9
"00ae5f0c51874a73a41ebea838d95682","67a089198fcb4e1c8f2385786c2b296f",22850817,1,-78,0,543,101,39,-62
"67a089198fcb4e1c8f2385786c2b296f","08111f75e22d409998cf8b85bd431f0a",22850817,1,86,0,544,39,108,69
"08111f75e22d409998cf8b85bd431f0a","e20db35ced8544ddac5bc3839145e463",22850817,1,-19,0,545,108,91,-17
"e20db35ced8544ddac5bc3839145e463","4280927ec4d643238aa49c32f9e06c6c",22850817,1,20,0,546,91,109,18
"4280927ec4d643238aa49c32f9e06c6c","4280927ec4d643238aa49c32f9e06c6c",22850817,1,0,1,547,109,109,0
"a9ae0a3c070d455bb4369a8996313336","a9ae0a3c070d455bb4369a8996313336",22850817,6,0,1,550,114,114,0
"a9ae0a3c070d455bb4369a8996313336","e20db35ced8544ddac5bc3839145e463",22850817,1,-26,0,556,114,91,-23
"67a089198fcb4e1c8f2385786c2b296f","8959e6304a0348309a771e4d08d1b64a",22850817,1,156,0,565,39,163,124
"8959e6304a0348309a771e4d08d1b64a","78adeee1fa2c4fe0bc73f7bca9fcee86",22850817,2,-4,0,566,163,160,-3
"65202579580f4ad38d734b4ee39d22a8","8959e6304a0348309a771e4d08d1b64a",22850817,2,-1,0,575,164,163,-1
"8959e6304a0348309a771e4d08d1b64a","67a089198fcb4e1c8f2385786c2b296f",22850817,1,-156,0,576,163,39,-124
"67a089198fcb4e1c8f2385786c2b296f","779f9ddd1fd14d1e9e69f72219a1fdbd",22850817,1,103,0,577,39,121,82
"779f9ddd1fd14d1e9e69f72219a1fdbd","779f9ddd1fd14d1e9e69f72219a1fdbd",22850817,1,0,1,578,121,121,0
"779f9ddd1fd14d1e9e69f72219a1fdbd","ae26e6cda8ad4a3f81bd347560d9579f",22850817,1,4,0,579,121,125,4
"ae26e6cda8ad4a3f81bd347560d9579f","ae26e6cda8ad4a3f81bd347560d9579f",22850817,3,0,1,580,125,125,0
"ae26e6cda8ad4a3f81bd347560d9579f","ee48df95832b4374aa273ceb27ec1315",22850817,1,1,0,583,125,126,1
"ee48df95832b4374aa273ceb27ec1315","ee48df95832b4374aa273ceb27ec1315",22850817,1,0,1,584,126,126,0
"ee48df95832b4374aa273ceb27ec1315","7a439da90b394756ad1777fc4c6dead5",22850817,1,1,0,585,126,127,1
"7a439da90b394756ad1777fc4c6dead5","7a439da90b394756ad1777fc4c6dead5",22850817,5,0,1,586,127,127,0
"7a439da90b394756ad1777fc4c6dead5","779f9ddd1fd14d1e9e69f72219a1fdbd",22850817,1,-6,0,591,127,121,-6
"a8dd5213034441ac92724b4e83eb0bb2","a8dd5213034441ac92724b4e83eb0bb2",22850817,2,0,1,593,129,129,0
"a8dd5213034441ac92724b4e83eb0bb2","8115eab6556b45f5b415c3b8c26a12e5",22850817,1,2,0,594,129,131,2
"8115eab6556b45f5b415c3b8c26a12e5","8115eab6556b45f5b415c3b8c26a12e5",22850817,2,0,1,595,131,131,0
"8115eab6556b45f5b415c3b8c26a12e5","ec34b06efd844b46a4c4818ecdb9b8f4",22850817,1,1,0,597,131,132,1
"ec34b06efd844b46a4c4818ecdb9b8f4","ec34b06efd844b46a4c4818ecdb9b8f4",22850817,5,0,1,598,132,132,0
"ec34b06efd844b46a4c4818ecdb9b8f4","c2e1c2b9eac64109b343a088584b576b",22850817,1,1,0,603,132,133,1
"c2e1c2b9eac64109b343a088584b576b","c2e1c2b9eac64109b343a088584b576b",22850817,2,0,1,604,133,133,0
"c2e1c2b9eac64109b343a088584b576b","579338175e0b4bbb8ef3b712b5d8b54e",22850817,1,-5,0,606,133,128,-5
"b416d47c56a742199b5d7c7f19d6503a","a8dd5213034441ac92724b4e83eb0bb2",22850817,1,-6,0,608,134,129,-5
"579338175e0b4bbb8ef3b712b5d8b54e","8bc5795d6a984a3eace4e2811e52dd4f",22850817,1,8,0,611,128,135,7
"8bc5795d6a984a3eace4e2811e52dd4f","8bc5795d6a984a3eace4e2811e52dd4f",22850817,1,0,1,612,135,135,0
"8bc5795d6a984a3eace4e2811e52dd4f","b416d47c56a742199b5d7c7f19d6503a",22850817,1,-1,0,613,135,134,-1
"6c5ad271a44743479bfaea29b1db8d02","83d311bed5374fee83d8d67a7d9d82dc",22850817,1,1,0,617,143,144,1
"83d311bed5374fee83d8d67a7d9d82dc","83d311bed5374fee83d8d67a7d9d82dc",22850817,1,0,1,618,144,144,0
"83d311bed5374fee83d8d67a7d9d82dc","402bba41861d43acb52a5abb89e8831e",22850817,1,1,0,619,144,145,1
"402bba41861d43acb52a5abb89e8831e","402bba41861d43acb52a5abb89e8831e",22850817,2,0,1,620,145,145,0
"402bba41861d43acb52a5abb89e8831e","6c5ad271a44743479bfaea29b1db8d02",22850817,1,-2,0,622,145,143,-2
"6c5ad271a44743479bfaea29b1db8d02","6c5ad271a44743479bfaea29b1db8d02",22850817,1,0,1,623,143,143,0
"8aae34f5ddbb4052a709b12e6b0d40fa","8aae34f5ddbb4052a709b12e6b0d40fa",22850817,2,0,1,626,147,147,0
"8aae34f5ddbb4052a709b12e6b0d40fa","645b3f0249f64f76af2e19eb4d0e55b7",22850817,1,2,0,627,147,149,2
"645b3f0249f64f76af2e19eb4d0e55b7","645b3f0249f64f76af2e19eb4d0e55b7",22850817,2,0,1,628,149,149,0
"645b3f0249f64f76af2e19eb4d0e55b7","7e7b8db5064d4369805ab370aac5ddfb",22850817,1,1,0,630,149,150,1
"7e7b8db5064d4369805ab370aac5ddfb","7e7b8db5064d4369805ab370aac5ddfb",22850817,3,0,1,631,150,150,0
"7e7b8db5064d4369805ab370aac5ddfb","8956d210ae7f41968fada86d4c979d6a",22850817,1,1,0,634,150,151,1
"8956d210ae7f41968fada86d4c979d6a","8956d210ae7f41968fada86d4c979d6a",22850817,2,0,1,635,151,151,0
"8956d210ae7f41968fada86d4c979d6a","f902b0f41b544d4dbf79664fd233648d",22850817,1,-5,0,637,151,146,-5
"f902b0f41b544d4dbf79664fd233648d","ae781e8b775e4ccd93bc800dad5c8376",22850817,1,8,0,638,146,153,7
"ae781e8b775e4ccd93bc800dad5c8376","ae781e8b775e4ccd93bc800dad5c8376",22850817,2,0,1,639,153,153,0
"ae781e8b775e4ccd93bc800dad5c8376","06882a8492d9499aa31555567f575ecb",22850817,1,1,0,641,153,154,1
"06882a8492d9499aa31555567f575ecb","06882a8492d9499aa31555567f575ecb",22850817,1,0,1,642,154,154,0
"06882a8492d9499aa31555567f575ecb","f293c508f409466a8f27ddd7d1e40b20",22850817,1,1,0,643,154,155,1
"f293c508f409466a8f27ddd7d1e40b20","f293c508f409466a8f27ddd7d1e40b20",22850817,2,0,1,644,155,155,0
"f293c508f409466a8f27ddd7d1e40b20","cc4ddef5bbbe48ebb605141b347c4ed1",22850817,1,1,0,646,155,156,1
"cc4ddef5bbbe48ebb605141b347c4ed1","cc4ddef5bbbe48ebb605141b347c4ed1",22850817,1,0,1,647,156,156,0
"cc4ddef5bbbe48ebb605141b347c4ed1","d313cec988a84645bee413e8d4724a4b",22850817,1,3,0,648,156,158,2
"78adeee1fa2c4fe0bc73f7bca9fcee86","67a089198fcb4e1c8f2385786c2b296f",22850817,1,-152,0,652,160,39,-121
"67a089198fcb4e1c8f2385786c2b296f","f902b0f41b544d4dbf79664fd233648d",22850817,1,134,0,653,39,146,107
"f902b0f41b544d4dbf79664fd233648d","df1de691dafe4549a18a4398ee9dfaf9",22850817,1,-8,0,654,146,139,-7
"d313cec988a84645bee413e8d4724a4b","67a089198fcb4e1c8f2385786c2b296f",22850817,1,-148,0,660,158,39,-119
"67a089198fcb4e1c8f2385786c2b296f","f03480cf4eba413194d7af52fc0e7f28",22850817,1,141,0,661,39,152,113
"df1de691dafe4549a18a4398ee9dfaf9","f03480cf4eba413194d7af52fc0e7f28",22850817,1,15,0,663,139,152,13
"67a089198fcb4e1c8f2385786c2b296f","42fb58708eaf4e5daa82bfca61b6f5fd",22850817,1,61,0,681,39,87,48
"6a9f0ef185fb47f0937e29daa1c71ed5","67a089198fcb4e1c8f2385786c2b296f",22850817,1,-64,0,688,90,39,-51
"67a089198fcb4e1c8f2385786c2b296f","3cbcea2be0984e7dbd5a48195af10ce7",22850817,1,160,0,689,39,165,126
"82e6285962b8400d9d6fc32436022a94","67a089198fcb4e1c8f2385786c2b296f",22850817,2,-162,0,692,167,39,-128
"67a089198fcb4e1c8f2385786c2b296f","b613861cecf84ffcab01afb23f660475",22850817,1,-72,0,693,39,1,-38
"56586aa865414f538729c7f7735d2bc6","56586aa865414f538729c7f7735d2bc6",22850817,4,0,1,699,12,12,0
"56586aa865414f538729c7f7735d2bc6","b7f2b31585d94eb3bf86376714aa7070",22850817,2,2,0,701,12,13,1
"b7f2b31585d94eb3bf86376714aa7070","b7f2b31585d94eb3bf86376714aa7070",22850817,3,0,1,702,13,13,0
"b7f2b31585d94eb3bf86376714aa7070","3f1c815879794b929260d224becaff7e",22850817,2,2,0,703,13,14,1
"3f1c815879794b929260d224becaff7e","309ccf3cc4fe429d9bfbaef53d3fa479",22850817,1,80,0,704,14,60,46
"309ccf3cc4fe429d9bfbaef53d3fa479","78f30e4dcac84e3cbea8b2cc6e0d62b3",22850817,1,-2,0,709,60,59,-1
"a1f2f12debe5432fb7a70bcd12bacfb9","67a089198fcb4e1c8f2385786c2b296f",22850817,1,-24,0,711,58,39,-19
"df1de691dafe4549a18a4398ee9dfaf9","a0a418b8540d479fa6e0f653b701da8b",22850817,1,-95,0,717,139,64,-75
"bc42d26810654ea9a1df1efe1e58c7d5","6a9f0ef185fb47f0937e29daa1c71ed5",22850817,1,34,0,719,63,90,27
"78adeee1fa2c4fe0bc73f7bca9fcee86","62bff51286ef4f348717a3cf6fe2318f",22850817,1,-52,0,727,160,120,-40
"62bff51286ef4f348717a3cf6fe2318f","4c943503763e4e349906eea3ed3c8e86",22850817,1,-72,0,731,120,61,-59
"4c943503763e4e349906eea3ed3c8e86","4c943503763e4e349906eea3ed3c8e86",22850817,1,0,1,732,61,61,0
"4c943503763e4e349906eea3ed3c8e86","c681290961c94c4caf23b529d1ae6b9a",22850817,1,34,0,733,61,88,27
"c681290961c94c4caf23b529d1ae6b9a","c681290961c94c4caf23b529d1ae6b9a",22850817,1,0,1,734,88,88,0
"c681290961c94c4caf23b529d1ae6b9a","b1cd0e7dc3ad4a8eb91a4bfdbeb025b0",22850817,1,36,0,735,88,118,30
"b1cd0e7dc3ad4a8eb91a4bfdbeb025b0","b1cd0e7dc3ad4a8eb91a4bfdbeb025b0",22850817,1,0,1,736,118,118,0
"b1cd0e7dc3ad4a8eb91a4bfdbeb025b0","cd4532ad48034873ba8bce2aac0c9808",22850817,1,24,0,737,118,137,19
"cd4532ad48034873ba8bce2aac0c9808","cd4532ad48034873ba8bce2aac0c9808",22850817,1,0,1,738,137,137,0
"cd4532ad48034873ba8bce2aac0c9808","dc60696c76a74368a60f72246e47700d",22850817,1,27,0,739,137,159,22
"dc60696c76a74368a60f72246e47700d","dc60696c76a74368a60f72246e47700d",22850817,1,0,1,740,159,159,0
"dc60696c76a74368a60f72246e47700d","9afd71a5298d4333b6849dfce1b9422c",22850817,1,-193,0,741,159,18,-141
"9afd71a5298d4333b6849dfce1b9422c","9afd71a5298d4333b6849dfce1b9422c",22850817,3,0,1,742,18,18,0
"afbf7250b99d47bea07172749483ca97","b534b89233134e30a9b5645138bfa9ee",22850817,1,32,0,750,28,41,13
"a1f2f12debe5432fb7a70bcd12bacfb9","65202579580f4ad38d734b4ee39d22a8",22850817,1,133,0,765,58,164,106
"65202579580f4ad38d734b4ee39d22a8","3cbcea2be0984e7dbd5a48195af10ce7",22850817,1,3,0,787,164,165,1
"78adeee1fa2c4fe0bc73f7bca9fcee86","8959e6304a0348309a771e4d08d1b64a",22850817,1,4,0,813,160,163,3
"8959e6304a0348309a771e4d08d1b64a","65202579580f4ad38d734b4ee39d22a8",22850817,1,1,0,814,163,164,1
"67a089198fcb4e1c8f2385786c2b296f","a9ac840f098c4bd0a2ee896214ce29cd",22850817,1,165,0,925,39,168,129
"b2275c3fad834f8d90737a2d9a6927d6","9afd71a5298d4333b6849dfce1b9422c",22850817,1,-216,0,935,172,18,-154
"afbf7250b99d47bea07172749483ca97","b7719e26494940efa49512aedd0aac79",22850817,1,-12,0,944,28,20,-8
"b7719e26494940efa49512aedd0aac79","0c7262dff33c4087bc660ccf40f92f9c",22850817,1,209,0,945,20,169,149
"b42cc17b7de840f181a704558d0bc845","b42cc17b7de840f181a704558d0bc845",22850817,2,0,1,956,175,175,0
"b42cc17b7de840f181a704558d0bc845","ea38cc0e6e6e41edbabf210220808bf9",22850817,1,5,0,958,175,179,4
"ea38cc0e6e6e41edbabf210220808bf9","ea38cc0e6e6e41edbabf210220808bf9",22850817,1,0,1,961,179,179,0
"ea38cc0e6e6e41edbabf210220808bf9","c8e371568a0c4391b25796ae4e91952e",22850817,1,11,0,962,179,186,7
"6cd2dcaac46847d4a0bc53f296d90375","ab11d94c6c8948ea90b88f19d2cd502b",22850817,1,-5,0,969,194,190,-4
"6cd2dcaac46847d4a0bc53f296d90375","d7f13c8d63ec4e2aa673fbb9cf9c6933",22850817,1,16,0,973,194,206,12
"be502a7a43c44bf7b682698de79d9369","7108f0e4c2584f1f9c471689ae4c885c",22850817,1,-8,0,980,214,208,-6
"b9e80f77c3a44349863b19875725c384","363837c182e04711840d896ae1e0339c",22850817,1,14,0,982,207,218,11
"363837c182e04711840d896ae1e0339c","f7fb1952f56b4189b86a9f8b7862d2b8",22850817,1,-4,0,983,218,215,-3
"f7fb1952f56b4189b86a9f8b7862d2b8","09400e101c5d4b439cf9a26b03aae558",22850817,1,-6,0,984,215,210,-5
"be502a7a43c44bf7b682698de79d9369","1c6721b1f63f4d30ba7746ea8af02a52",22850817,1,11,0,988,214,221,7
"2ab1535aac1346ba8801535bf729ef37","8b9ae98743bd4d4a8a87dff1c1244211",22850817,1,-3,0,996,229,227,-2
"d03cb855c70044cf8c35d9ec0de696e3","d03cb855c70044cf8c35d9ec0de696e3",22850817,1,0,1,998,224,224,0
"2ab1535aac1346ba8801535bf729ef37","2ab1535aac1346ba8801535bf729ef37",22850817,1,0,1,1000,229,229,0
"2ab1535aac1346ba8801535bf729ef37","2ae94c0cea4d480a9d5dca8fb1d7b542",22850817,1,17,0,1001,229,242,13
"2ae94c0cea4d480a9d5dca8fb1d7b542","2ae94c0cea4d480a9d5dca8fb1d7b542",22850817,11,0,1,1002,242,242,0
"2ae94c0cea4d480a9d5dca8fb1d7b542","00f61990949545828dd12f1303d47504",22850817,6,17,0,1007,242,256,14
"00f61990949545828dd12f1303d47504","1ebf23f9d994469a85206e4c7b1bf5f5",22850817,1,-14,0,1008,256,245,-11
"1ebf23f9d994469a85206e4c7b1bf5f5","1ebf23f9d994469a85206e4c7b1bf5f5",22850817,11,0,1,1009,245,245,0
"1ebf23f9d994469a85206e4c7b1bf5f5","00f61990949545828dd12f1303d47504",22850817,1,14,0,1010,245,256,11
"00f61990949545828dd12f1303d47504","00f61990949545828dd12f1303d47504",22850817,4,0,1,1011,256,256,0
"00f61990949545828dd12f1303d47504","2ae94c0cea4d480a9d5dca8fb1d7b542",22850817,2,-17,0,1012,256,242,-14
"2ae94c0cea4d480a9d5dca8fb1d7b542","1ebf23f9d994469a85206e4c7b1bf5f5",22850817,8,3,0,1017,242,245,3
"1ebf23f9d994469a85206e4c7b1bf5f5","2ae94c0cea4d480a9d5dca8fb1d7b542",22850817,6,-3,0,1018,245,242,-3
"2ae94c0cea4d480a9d5dca8fb1d7b542","fa235f0f364d47e4ae1c87f47bf8e6ba",22850817,2,12,0,1019,242,252,10
"fa235f0f364d47e4ae1c87f47bf8e6ba","00f61990949545828dd12f1303d47504",22850817,1,5,0,1020,252,256,4
"00f61990949545828dd12f1303d47504","fa235f0f364d47e4ae1c87f47bf8e6ba",22850817,1,-5,0,1021,256,252,-4
"fa235f0f364d47e4ae1c87f47bf8e6ba","2ae94c0cea4d480a9d5dca8fb1d7b542",22850817,3,-12,0,1022,252,242,-10
"1ebf23f9d994469a85206e4c7b1bf5f5","0c7262dff33c4087bc660ccf40f92f9c",22850817,1,-100,0,1025,245,169,-76
"0c7262dff33c4087bc660ccf40f92f9c","7aa76d3e993840d8805f097cbdbcd44b",22850817,1,120,0,1026,169,261,92
"7aa76d3e993840d8805f097cbdbcd44b","2ae94c0cea4d480a9d5dca8fb1d7b542",22850817,1,-23,0,1027,261,242,-19
"2ae94c0cea4d480a9d5dca8fb1d7b542","7aa76d3e993840d8805f097cbdbcd44b",22850817,1,23,0,1028,242,261,19
"7aa76d3e993840d8805f097cbdbcd44b","0c7262dff33c4087bc660ccf40f92f9c",22850817,1,-120,0,1029,261,169,-92
"0c7262dff33c4087bc660ccf40f92f9c","0d987bed3ffa4ed0b9a2e62e97b7b30f",22850817,2,135,0,1030,169,272,103
"0d987bed3ffa4ed0b9a2e62e97b7b30f","0d987bed3ffa4ed0b9a2e62e97b7b30f",22850817,5,0,1,1031,272,272,0
"0d987bed3ffa4ed0b9a2e62e97b7b30f","0c7262dff33c4087bc660ccf40f92f9c",22850817,1,-135,0,1033,272,169,-103
"0d987bed3ffa4ed0b9a2e62e97b7b30f","bc5524e78a8544e2ae2fdc2f3462bbec",22850817,1,9,0,1035,272,279,7
"bc5524e78a8544e2ae2fdc2f3462bbec","bb5a47f5ea01454a8b79455422d3b9da",22850817,1,1,0,1036,279,280,1
"bb5a47f5ea01454a8b79455422d3b9da","bb5a47f5ea01454a8b79455422d3b9da",22850817,150,0,1,1037,280,280,0
"bb5a47f5ea01454a8b79455422d3b9da","0c7262dff33c4087bc660ccf40f92f9c",22850817,2,-145,0,1044,280,169,-111
"0c7262dff33c4087bc660ccf40f92f9c","0c7262dff33c4087bc660ccf40f92f9c",22850817,16,0,1,1045,169,169,0
"0c7262dff33c4087bc660ccf40f92f9c","b2275c3fad834f8d90737a2d9a6927d6",22850817,7,3,0,1046,169,172,3
"b2275c3fad834f8d90737a2d9a6927d6","0c7262dff33c4087bc660ccf40f92f9c",22850817,3,-3,0,1047,172,169,-3
"0c7262dff33c4087bc660ccf40f92f9c","c8e371568a0c4391b25796ae4e91952e",22850817,8,23,0,1048,169,186,17
"c8e371568a0c4391b25796ae4e91952e","d7f13c8d63ec4e2aa673fbb9cf9c6933",22850817,5,26,0,1049,186,206,20
"d7f13c8d63ec4e2aa673fbb9cf9c6933","d7f13c8d63ec4e2aa673fbb9cf9c6933",22850817,7,0,1,1050,206,206,0
"d7f13c8d63ec4e2aa673fbb9cf9c6933","0d987bed3ffa4ed0b9a2e62e97b7b30f",22850817,1,86,0,1052,206,272,66
"0d987bed3ffa4ed0b9a2e62e97b7b30f","82ae07bc0c9b4570a41799290d1ef399",22850817,3,4,0,1055,272,275,3
"82ae07bc0c9b4570a41799290d1ef399","bb5a47f5ea01454a8b79455422d3b9da",22850817,4,6,0,1056,275,280,5
"b2275c3fad834f8d90737a2d9a6927d6","b2275c3fad834f8d90737a2d9a6927d6",22850817,21,0,1,1068,172,172,0
"b2275c3fad834f8d90737a2d9a6927d6","eb515a26030b41f8a82a1e6114420bad",22850817,1,1,0,1089,172,173,1
"eb515a26030b41f8a82a1e6114420bad","eb515a26030b41f8a82a1e6114420bad",22850817,2,0,1,1090,173,173,0
"eb515a26030b41f8a82a1e6114420bad","0c7262dff33c4087bc660ccf40f92f9c",22850817,1,-4,0,1092,173,169,-4
"0c7262dff33c4087bc660ccf40f92f9c","b42cc17b7de840f181a704558d0bc845",22850817,1,7,0,1093,169,175,6
"b42cc17b7de840f181a704558d0bc845","801f9e9135034f49bf5f8b4bdefedb41",22850817,1,2,0,1094,175,177,2
"801f9e9135034f49bf5f8b4bdefedb41","801f9e9135034f49bf5f8b4bdefedb41",22850817,7,0,1,1095,177,177,0
"801f9e9135034f49bf5f8b4bdefedb41","b42cc17b7de840f181a704558d0bc845",22850817,1,-2,0,1102,177,175,-2
"b42cc17b7de840f181a704558d0bc845","362fcb0699a14845ab29b2340093e528",22850817,1,-1,0,1103,175,174,-1
"362fcb0699a14845ab29b2340093e528","ea38cc0e6e6e41edbabf210220808bf9",22850817,3,6,0,1104,174,179,5
"ea38cc0e6e6e41edbabf210220808bf9","b87c552dd247427abe6ab5795b9c9d43",22850817,5,2,0,1105,179,181,2
"b87c552dd247427abe6ab5795b9c9d43","ea38cc0e6e6e41edbabf210220808bf9",22850817,2,-2,0,1106,181,179,-2
"b87c552dd247427abe6ab5795b9c9d43","b87c552dd247427abe6ab5795b9c9d43",22850817,7,0,1,1108,181,181,0
"b87c552dd247427abe6ab5795b9c9d43","139b097acfca451689d80c9c6eebdf7b",22850817,4,-3,0,1115,181,178,-3
"139b097acfca451689d80c9c6eebdf7b","30f660a1feb34582a739722532524f79",22850817,1,6,0,1116,178,183,5
"30f660a1feb34582a739722532524f79","30f660a1feb34582a739722532524f79",22850817,7,0,1,1117,183,183,0
"30f660a1feb34582a739722532524f79","2024b4885bd14338a39b7b509acbbd02",22850817,1,-1,0,1124,183,182,-1
"2024b4885bd14338a39b7b509acbbd02","0c7262dff33c4087bc660ccf40f92f9c",22850817,3,-16,0,1125,182,169,-13
"c8e371568a0c4391b25796ae4e91952e","7d932b23e1c84326ae5aa4d3c0d813d1",22850817,1,2,0,1127,186,188,2
"7d932b23e1c84326ae5aa4d3c0d813d1","7d932b23e1c84326ae5aa4d3c0d813d1",22850817,3,0,1,1128,188,188,0
"7d932b23e1c84326ae5aa4d3c0d813d1","c8e371568a0c4391b25796ae4e91952e",22850817,1,-2,0,1131,188,186,-2
"c8e371568a0c4391b25796ae4e91952e","ab11d94c6c8948ea90b88f19d2cd502b",22850817,7,5,0,1132,186,190,4
"ab11d94c6c8948ea90b88f19d2cd502b","ab11d94c6c8948ea90b88f19d2cd502b",22850817,2,0,1,1133,190,190,0
"ab11d94c6c8948ea90b88f19d2cd502b","f992451ed6ad4e68bb9e68ad6be7c4be",22850817,1,2,0,1134,190,192,2
"f992451ed6ad4e68bb9e68ad6be7c4be","f992451ed6ad4e68bb9e68ad6be7c4be",22850817,1,0,1,1135,192,192,0
"f992451ed6ad4e68bb9e68ad6be7c4be","07b44a7a51e94c78b411c753fc39dab0",22850817,1,-3,0,1136,192,189,-3
"07b44a7a51e94c78b411c753fc39dab0","6cd2dcaac46847d4a0bc53f296d90375",22850817,5,6,0,1137,189,194,5
"6cd2dcaac46847d4a0bc53f296d90375","6cd2dcaac46847d4a0bc53f296d90375",22850817,2,0,1,1138,194,194,0
"6cd2dcaac46847d4a0bc53f296d90375","2d2580c9411c4972909db508d6956a58",22850817,1,2,0,1139,194,196,2
"2d2580c9411c4972909db508d6956a58","2d2580c9411c4972909db508d6956a58",22850817,9,0,1,1140,196,196,0
"2d2580c9411c4972909db508d6956a58","5bddb3d9ed264f3984702f048c7e5340",22850817,1,1,0,1149,196,197,1
"5bddb3d9ed264f3984702f048c7e5340","5bddb3d9ed264f3984702f048c7e5340",22850817,2,0,1,1150,197,197,0
"5bddb3d9ed264f3984702f048c7e5340","d5e8e2bd12a2466b9d6d90855f0eb079",22850817,1,1,0,1152,197,198,1
"d5e8e2bd12a2466b9d6d90855f0eb079","d5e8e2bd12a2466b9d6d90855f0eb079",22850817,2,0,1,1153,198,198,0
"d5e8e2bd12a2466b9d6d90855f0eb079","017d7ca8e0394b91aaadc9574df2202c",22850817,1,-5,0,1155,198,193,-5
"017d7ca8e0394b91aaadc9574df2202c","54e8e9f0ea3e45c4bf3b8ac799ee31b1",22850817,1,8,0,1156,193,200,7
"54e8e9f0ea3e45c4bf3b8ac799ee31b1","54e8e9f0ea3e45c4bf3b8ac799ee31b1",22850817,1,0,1,1157,200,200,0
"54e8e9f0ea3e45c4bf3b8ac799ee31b1","c614a00911be4877a075f19315530fb0",22850817,1,1,0,1158,200,201,1
"c614a00911be4877a075f19315530fb0","c614a00911be4877a075f19315530fb0",22850817,6,0,1,1159,201,201,0
"c614a00911be4877a075f19315530fb0","a6c21bd8b95249c7972820a7a7d76aff",22850817,1,1,0,1165,201,202,1
"a6c21bd8b95249c7972820a7a7d76aff","a6c21bd8b95249c7972820a7a7d76aff",22850817,1,0,1,1166,202,202,0
"a6c21bd8b95249c7972820a7a7d76aff","f9170dd6bc6442b4acd832747609b09a",22850817,2,-3,0,1167,202,199,-3
"f9170dd6bc6442b4acd832747609b09a","b54257a550b94ebc9538f3a90eee9d7e",22850817,3,6,0,1168,199,204,5
"b54257a550b94ebc9538f3a90eee9d7e","c8e371568a0c4391b25796ae4e91952e",22850817,1,-22,0,1169,204,186,-18
"c8e371568a0c4391b25796ae4e91952e","bb329d880ab54120adaf203a693bb203",22850817,1,20,0,1170,186,203,17
"bb329d880ab54120adaf203a693bb203","bb329d880ab54120adaf203a693bb203",22850817,3,0,1,1171,203,203,0
"bb329d880ab54120adaf203a693bb203","f9170dd6bc6442b4acd832747609b09a",22850817,2,-4,0,1172,203,199,-4
"f9170dd6bc6442b4acd832747609b09a","0c7262dff33c4087bc660ccf40f92f9c",22850817,2,-39,0,1173,199,169,-30
"0c7262dff33c4087bc660ccf40f92f9c","f9170dd6bc6442b4acd832747609b09a",22850817,1,39,0,1174,169,199,30
"f9170dd6bc6442b4acd832747609b09a","c8e371568a0c4391b25796ae4e91952e",22850817,4,-16,0,1175,199,186,-13
"c8e371568a0c4391b25796ae4e91952e","f9170dd6bc6442b4acd832747609b09a",22850817,1,16,0,1176,186,199,13
"c8e371568a0c4391b25796ae4e91952e","c8e371568a0c4391b25796ae4e91952e",22850817,11,0,1,1179,186,186,0
"ab11d94c6c8948ea90b88f19d2cd502b","07b44a7a51e94c78b411c753fc39dab0",22850817,4,-1,0,1182,190,189,-1
"6cd2dcaac46847d4a0bc53f296d90375","017d7ca8e0394b91aaadc9574df2202c",22850817,5,-1,0,1184,194,193,-1
"017d7ca8e0394b91aaadc9574df2202c","f9170dd6bc6442b4acd832747609b09a",22850817,6,7,0,1185,193,199,6
"017d7ca8e0394b91aaadc9574df2202c","bb329d880ab54120adaf203a693bb203",22850817,2,11,0,1192,193,203,10
"bb329d880ab54120adaf203a693bb203","a6c21bd8b95249c7972820a7a7d76aff",22850817,1,-1,0,1194,203,202,-1
"f9170dd6bc6442b4acd832747609b09a","6cd2dcaac46847d4a0bc53f296d90375",22850817,1,-6,0,1196,199,194,-5
"017d7ca8e0394b91aaadc9574df2202c","ab11d94c6c8948ea90b88f19d2cd502b",22850817,1,-4,0,1198,193,190,-3
"07b44a7a51e94c78b411c753fc39dab0","ab11d94c6c8948ea90b88f19d2cd502b",22850817,1,1,0,1200,189,190,1
"ab11d94c6c8948ea90b88f19d2cd502b","c8e371568a0c4391b25796ae4e91952e",22850817,3,-5,0,1201,190,186,-4
"c8e371568a0c4391b25796ae4e91952e","07b44a7a51e94c78b411c753fc39dab0",22850817,1,4,0,1202,186,189,3
"f9170dd6bc6442b4acd832747609b09a","67a089198fcb4e1c8f2385786c2b296f",22850817,1,-208,0,1206,199,39,-160
"67a089198fcb4e1c8f2385786c2b296f","67a089198fcb4e1c8f2385786c2b296f",22850817,6,0,1,1207,39,39,0
"67a089198fcb4e1c8f2385786c2b296f","64d48c6c9c7940639a932219a6c87198",22850817,15,1,0,1208,39,40,1
"64d48c6c9c7940639a932219a6c87198","b534b89233134e30a9b5645138bfa9ee",22850817,2,3,0,1209,40,41,1
"b534b89233134e30a9b5645138bfa9ee","67a089198fcb4e1c8f2385786c2b296f",22850817,3,-4,0,1210,41,39,-2
"67a089198fcb4e1c8f2385786c2b296f","b534b89233134e30a9b5645138bfa9ee",22850817,9,4,0,1211,39,41,2
"b534b89233134e30a9b5645138bfa9ee","6e13d61a7bdb44bca949c9f86fab3be5",22850817,9,7,0,1212,41,47,6
"6e13d61a7bdb44bca949c9f86fab3be5","d0c74f735e024943943e40333d6d337f",22850817,1,5,0,1213,47,51,4
"d0c74f735e024943943e40333d6d337f","d9c8d8c444a64dadbbb508652c721e17",22850817,4,-6,0,1214,51,46,-5
"d9c8d8c444a64dadbbb508652c721e17","f924752d8a1149668870b1e7698486f7",22850817,3,5,0,1215,46,50,4
"f924752d8a1149668870b1e7698486f7","78f30e4dcac84e3cbea8b2cc6e0d62b3",22850817,4,10,0,1216,50,59,9
"78f30e4dcac84e3cbea8b2cc6e0d62b3","a1f2f12debe5432fb7a70bcd12bacfb9",22850817,6,-1,0,1217,59,58,-1
"a1f2f12debe5432fb7a70bcd12bacfb9","12aa6e1672ac4e7aa6449a7a8609cd72",22850817,2,-1,0,1218,58,57,-1
"12aa6e1672ac4e7aa6449a7a8609cd72","bc42d26810654ea9a1df1efe1e58c7d5",22850817,3,7,0,1219,57,63,6
"bc42d26810654ea9a1df1efe1e58c7d5","a0a418b8540d479fa6e0f653b701da8b",22850817,8,1,0,1220,63,64,1
"a0a418b8540d479fa6e0f653b701da8b","309ccf3cc4fe429d9bfbaef53d3fa479",22850817,4,-4,0,1221,64,60,-4
"309ccf3cc4fe429d9bfbaef53d3fa479","d646286c8051419bbc2e31dd1db55ca8",22850817,5,10,0,1222,60,67,7
"d646286c8051419bbc2e31dd1db55ca8","b534b89233134e30a9b5645138bfa9ee",22850817,6,-33,0,1223,67,41,-26
"b534b89233134e30a9b5645138bfa9ee","a2becd407db34b189200a32546d9d569",22850817,1,42,0,1224,41,75,34
"a2becd407db34b189200a32546d9d569","d646286c8051419bbc2e31dd1db55ca8",22850817,3,-9,0,1225,75,67,-8
"d646286c8051419bbc2e31dd1db55ca8","140d5b27b8574befad82c0a013b59dfa",22850817,3,8,0,1226,67,74,7
"140d5b27b8574befad82c0a013b59dfa","d18a9ea32855445f8736581f5cb119ce",22850817,6,9,0,1227,74,82,8
"d18a9ea32855445f8736581f5cb119ce","6a9f0ef185fb47f0937e29daa1c71ed5",22850817,4,10,0,1228,82,90,8
"6a9f0ef185fb47f0937e29daa1c71ed5","ae5ac430ea254e708a6f5deaaf7464ae",22850817,5,-7,0,1229,90,84,-6
"ae5ac430ea254e708a6f5deaaf7464ae","6a9f0ef185fb47f0937e29daa1c71ed5",22850817,4,7,0,1230,84,90,6
"6a9f0ef185fb47f0937e29daa1c71ed5","6a9f0ef185fb47f0937e29daa1c71ed5",22850817,16,0,1,1231,90,90,0
"6a9f0ef185fb47f0937e29daa1c71ed5","e20db35ced8544ddac5bc3839145e463",22850817,2,3,0,1232,90,91,1
"e20db35ced8544ddac5bc3839145e463","d646286c8051419bbc2e31dd1db55ca8",22850817,3,-30,0,1233,91,67,-24
"d646286c8051419bbc2e31dd1db55ca8","00ae5f0c51874a73a41ebea838d95682",22850817,1,41,0,1234,67,101,34
"00ae5f0c51874a73a41ebea838d95682","e20db35ced8544ddac5bc3839145e463",22850817,3,-11,0,1235,101,91,-10
"e20db35ced8544ddac5bc3839145e463","d391c8b6e56a43a7b654e9dee02d904b",22850817,3,13,0,1236,91,103,12
"d391c8b6e56a43a7b654e9dee02d904b","4280927ec4d643238aa49c32f9e06c6c",22850817,3,7,0,1237,103,109,6
"4280927ec4d643238aa49c32f9e06c6c","73039f8c1eb9409cb4caee2cf968001e",22850817,4,-10,0,1238,109,100,-9
"73039f8c1eb9409cb4caee2cf968001e","08111f75e22d409998cf8b85bd431f0a",22850817,3,9,0,1239,100,108,8
"08111f75e22d409998cf8b85bd431f0a","a9ae0a3c070d455bb4369a8996313336",22850817,7,7,0,1240,108,114,6
"a9ae0a3c070d455bb4369a8996313336","37319e88176d4aefa91d7a9980dbae91",22850817,3,-2,0,1241,114,112,-2
"37319e88176d4aefa91d7a9980dbae91","62bff51286ef4f348717a3cf6fe2318f",22850817,4,9,0,1242,112,120,8
"62bff51286ef4f348717a3cf6fe2318f","62bff51286ef4f348717a3cf6fe2318f",22850817,14,0,1,1243,120,120,0
"62bff51286ef4f348717a3cf6fe2318f","e20db35ced8544ddac5bc3839145e463",22850817,5,-33,0,1245,120,91,-29
"e20db35ced8544ddac5bc3839145e463","779f9ddd1fd14d1e9e69f72219a1fdbd",22850817,10,36,0,1246,91,121,30
"779f9ddd1fd14d1e9e69f72219a1fdbd","a8dd5213034441ac92724b4e83eb0bb2",22850817,5,9,0,1247,121,129,8
"a8dd5213034441ac92724b4e83eb0bb2","779f9ddd1fd14d1e9e69f72219a1fdbd",22850817,4,-9,0,1248,129,121,-8
"779f9ddd1fd14d1e9e69f72219a1fdbd","579338175e0b4bbb8ef3b712b5d8b54e",22850817,4,8,0,1249,121,128,7
"579338175e0b4bbb8ef3b712b5d8b54e","b416d47c56a742199b5d7c7f19d6503a",22850817,6,7,0,1250,128,134,6
"b416d47c56a742199b5d7c7f19d6503a","779f9ddd1fd14d1e9e69f72219a1fdbd",22850817,3,-15,0,1251,134,121,-13
"779f9ddd1fd14d1e9e69f72219a1fdbd","df1de691dafe4549a18a4398ee9dfaf9",22850817,5,23,0,1252,121,139,18
"df1de691dafe4549a18a4398ee9dfaf9","6c5ad271a44743479bfaea29b1db8d02",22850817,3,4,0,1253,139,143,4
"6c5ad271a44743479bfaea29b1db8d02","8aae34f5ddbb4052a709b12e6b0d40fa",22850817,3,5,0,1254,143,147,4
"8aae34f5ddbb4052a709b12e6b0d40fa","df1de691dafe4549a18a4398ee9dfaf9",22850817,3,-9,0,1255,147,139,-8
"df1de691dafe4549a18a4398ee9dfaf9","f902b0f41b544d4dbf79664fd233648d",22850817,3,8,0,1256,139,146,7
"f902b0f41b544d4dbf79664fd233648d","f03480cf4eba413194d7af52fc0e7f28",22850817,4,7,0,1257,146,152,6
"f03480cf4eba413194d7af52fc0e7f28","d313cec988a84645bee413e8d4724a4b",22850817,7,7,0,1258,152,158,6
"d313cec988a84645bee413e8d4724a4b","d313cec988a84645bee413e8d4724a4b",22850817,14,0,1,1259,158,158,0
"d313cec988a84645bee413e8d4724a4b","df1de691dafe4549a18a4398ee9dfaf9",22850817,3,-22,0,1261,158,139,-19
"df1de691dafe4549a18a4398ee9dfaf9","78adeee1fa2c4fe0bc73f7bca9fcee86",22850817,5,26,0,1262,139,160,21
"78adeee1fa2c4fe0bc73f7bca9fcee86","d7f13c8d63ec4e2aa673fbb9cf9c6933",22850817,1,66,0,1263,160,206,46
"d7f13c8d63ec4e2aa673fbb9cf9c6933","b9e80f77c3a44349863b19875725c384",22850817,2,1,0,1265,206,207,1
"b9e80f77c3a44349863b19875725c384","7108f0e4c2584f1f9c471689ae4c885c",22850817,5,1,0,1266,207,208,1
"7108f0e4c2584f1f9c471689ae4c885c","b9e80f77c3a44349863b19875725c384",22850817,3,-1,0,1267,208,207,-1
"b9e80f77c3a44349863b19875725c384","b9e80f77c3a44349863b19875725c384",22850817,19,0,1,1268,207,207,0
"7108f0e4c2584f1f9c471689ae4c885c","7108f0e4c2584f1f9c471689ae4c885c",22850817,16,0,1,1288,208,208,0
"7108f0e4c2584f1f9c471689ae4c885c","d7f13c8d63ec4e2aa673fbb9cf9c6933",22850817,4,-2,0,1304,208,206,-2
"d7f13c8d63ec4e2aa673fbb9cf9c6933","09400e101c5d4b439cf9a26b03aae558",22850817,5,5,0,1305,206,210,4
"09400e101c5d4b439cf9a26b03aae558","a88efa7e50ce47159810ab553afa6d3a",22850817,1,2,0,1306,210,212,2
"a88efa7e50ce47159810ab553afa6d3a","a88efa7e50ce47159810ab553afa6d3a",22850817,3,0,1,1307,212,212,0
"a88efa7e50ce47159810ab553afa6d3a","a875096404ef4a9984b62d74cda916f9",22850817,1,-3,0,1310,212,209,-3
"a875096404ef4a9984b62d74cda916f9","be502a7a43c44bf7b682698de79d9369",22850817,2,6,0,1311,209,214,5
"be502a7a43c44bf7b682698de79d9369","f7fb1952f56b4189b86a9f8b7862d2b8",22850817,2,1,0,1312,214,215,1
"f7fb1952f56b4189b86a9f8b7862d2b8","f7fb1952f56b4189b86a9f8b7862d2b8",22850817,12,0,1,1313,215,215,0
"f7fb1952f56b4189b86a9f8b7862d2b8","b860ee85d8bc4a2f97958cfb71be3533",22850817,1,1,0,1325,215,216,1
"b860ee85d8bc4a2f97958cfb71be3533","b860ee85d8bc4a2f97958cfb71be3533",22850817,2,0,1,1326,216,216,0
"b860ee85d8bc4a2f97958cfb71be3533","ec341f459285443b8361f7f15638ff08",22850817,1,-3,0,1328,216,213,-3
"ec341f459285443b8361f7f15638ff08","363837c182e04711840d896ae1e0339c",22850817,5,6,0,1329,213,218,5
"363837c182e04711840d896ae1e0339c","363837c182e04711840d896ae1e0339c",22850817,12,0,1,1330,218,218,0
"363837c182e04711840d896ae1e0339c","01b2051f8941460d89945e3b02d1ce78",22850817,5,-1,0,1342,218,217,-1
"01b2051f8941460d89945e3b02d1ce78","1c6721b1f63f4d30ba7746ea8af02a52",22850817,1,7,0,1343,217,221,4
"1c6721b1f63f4d30ba7746ea8af02a52","d7f13c8d63ec4e2aa673fbb9cf9c6933",22850817,2,-21,0,1344,221,206,-15
"d7f13c8d63ec4e2aa673fbb9cf9c6933","77ecef8eff6b4a2caea7707669bf7475",22850817,2,22,0,1345,206,222,16
"77ecef8eff6b4a2caea7707669bf7475","77ecef8eff6b4a2caea7707669bf7475",22850817,12,0,1,1346,222,222,0
"77ecef8eff6b4a2caea7707669bf7475","d03cb855c70044cf8c35d9ec0de696e3",22850817,3,3,0,1358,222,224,2
"d03cb855c70044cf8c35d9ec0de696e3","1c6721b1f63f4d30ba7746ea8af02a52",22850817,2,-4,0,1359,224,221,-3
"1c6721b1f63f4d30ba7746ea8af02a52","8b9ae98743bd4d4a8a87dff1c1244211",22850817,2,7,0,1360,221,227,6
"8b9ae98743bd4d4a8a87dff1c1244211","a49a937d6896486d9a5396654abcf2e1",22850817,1,-1,0,1361,227,226,-1
"a49a937d6896486d9a5396654abcf2e1","a49a937d6896486d9a5396654abcf2e1",22850817,1,0,1,1362,226,226,0
"a49a937d6896486d9a5396654abcf2e1","8b9ae98743bd4d4a8a87dff1c1244211",22850817,1,1,0,1363,226,227,1
"8b9ae98743bd4d4a8a87dff1c1244211","8b9ae98743bd4d4a8a87dff1c1244211",22850817,25,0,1,1364,227,227,0
"8b9ae98743bd4d4a8a87dff1c1244211","2ab1535aac1346ba8801535bf729ef37",22850817,2,3,0,1389,227,229,2
"2ab1535aac1346ba8801535bf729ef37","f7906d6f59b9489a91d2ef40db5a474d",22850817,4,-7,0,1390,229,223,-6
"f7906d6f59b9489a91d2ef40db5a474d","a4f40fb48a8542c8949bae1f002cd9bc",22850817,1,9,0,1391,223,231,8
"a4f40fb48a8542c8949bae1f002cd9bc","a4f40fb48a8542c8949bae1f002cd9bc",22850817,8,0,1,1392,231,231,0
"a4f40fb48a8542c8949bae1f002cd9bc","8972c23e32044edb8a78fa1eed4e5947",22850817,1,1,0,1400,231,232,1
"8972c23e32044edb8a78fa1eed4e5947","8972c23e32044edb8a78fa1eed4e5947",22850817,2,0,1,1401,232,232,0
"8972c23e32044edb8a78fa1eed4e5947","92feb4a40f8344d38b6f722e42a53295",22850817,1,1,0,1403,232,233,1
"92feb4a40f8344d38b6f722e42a53295","92feb4a40f8344d38b6f722e42a53295",22850817,2,0,1,1404,233,233,0
"92feb4a40f8344d38b6f722e42a53295","5152833676bf4c6cb317060be10f68db",22850817,1,-5,0,1406,233,228,-5
"5152833676bf4c6cb317060be10f68db","ca3e28f290354c08aefe5b0f769604e6",22850817,1,8,0,1407,228,235,7
"ca3e28f290354c08aefe5b0f769604e6","ca3e28f290354c08aefe5b0f769604e6",22850817,4,0,1,1408,235,235,0
"ca3e28f290354c08aefe5b0f769604e6","79a35eea833e4c2c9d22fc53c3c6445c",22850817,1,1,0,1412,235,236,1
"79a35eea833e4c2c9d22fc53c3c6445c","79a35eea833e4c2c9d22fc53c3c6445c",22850817,4,0,1,1413,236,236,0
"79a35eea833e4c2c9d22fc53c3c6445c","cab89fa5c3ed45a5aa550fc0352d6a42",22850817,1,2,0,1417,236,238,2
"cab89fa5c3ed45a5aa550fc0352d6a42","cab89fa5c3ed45a5aa550fc0352d6a42",22850817,4,0,1,1418,238,238,0
"cab89fa5c3ed45a5aa550fc0352d6a42","2ae94c0cea4d480a9d5dca8fb1d7b542",22850817,1,7,0,1422,238,242,4
"2ae94c0cea4d480a9d5dca8fb1d7b542","1c6721b1f63f4d30ba7746ea8af02a52",22850817,2,-27,0,1426,242,221,-21
"1c6721b1f63f4d30ba7746ea8af02a52","64dbedb3ce544f6aae8e10e0cf10f16d",22850817,1,23,0,1427,221,240,19
"64dbedb3ce544f6aae8e10e0cf10f16d","0b04c8e2f86d48c7aeb7e225819cd32b",22850817,2,-7,0,1428,240,234,-6
"0b04c8e2f86d48c7aeb7e225819cd32b","2ab1535aac1346ba8801535bf729ef37",22850817,1,-6,0,1429,234,229,-5
"2ab1535aac1346ba8801535bf729ef37","5152833676bf4c6cb317060be10f68db",22850817,4,-1,0,1430,229,228,-1
"5152833676bf4c6cb317060be10f68db","0b04c8e2f86d48c7aeb7e225819cd32b",22850817,5,7,0,1431,228,234,6
"0b04c8e2f86d48c7aeb7e225819cd32b","2ae94c0cea4d480a9d5dca8fb1d7b542",22850817,1,11,0,1432,234,242,8
"1c6721b1f63f4d30ba7746ea8af02a52","1ebf23f9d994469a85206e4c7b1bf5f5",22850817,1,30,0,1434,221,245,24
"1ebf23f9d994469a85206e4c7b1bf5f5","85ae675b83e8422da842cfd25596af99",22850817,1,1,0,1445,245,246,1
"85ae675b83e8422da842cfd25596af99","85ae675b83e8422da842cfd25596af99",22850817,1,0,1,1446,246,246,0
"85ae675b83e8422da842cfd25596af99","fa235f0f364d47e4ae1c87f47bf8e6ba",22850817,1,8,0,1447,246,252,6
"2ae94c0cea4d480a9d5dca8fb1d7b542","79f7845465cc4ed19d8e4f1429541be0",22850817,1,14,0,1449,242,254,12
"79f7845465cc4ed19d8e4f1429541be0","79f7845465cc4ed19d8e4f1429541be0",22850817,2,0,1,1450,254,254,0
"79f7845465cc4ed19d8e4f1429541be0","6e83e23f56544a19b94067c1c558d9c0",22850817,1,-8,0,1452,254,247,-7
"6e83e23f56544a19b94067c1c558d9c0","00f61990949545828dd12f1303d47504",22850817,6,11,0,1453,247,256,9
"00f61990949545828dd12f1303d47504","ead7bb4b64e247d2ae632ab8a296b091",22850817,1,2,0,1454,256,258,2
"ead7bb4b64e247d2ae632ab8a296b091","ead7bb4b64e247d2ae632ab8a296b091",22850817,2,0,1,1455,258,258,0
"ead7bb4b64e247d2ae632ab8a296b091","41b0048dde734bb280bac6116baa8e27",22850817,1,1,0,1457,258,259,1
"41b0048dde734bb280bac6116baa8e27","41b0048dde734bb280bac6116baa8e27",22850817,2,0,1,1458,259,259,0
"41b0048dde734bb280bac6116baa8e27","b41c5a094a604ee0915327da5cc0beb7",22850817,1,1,0,1460,259,260,1
"b41c5a094a604ee0915327da5cc0beb7","b41c5a094a604ee0915327da5cc0beb7",22850817,2,0,1,1461,260,260,0
"b41c5a094a604ee0915327da5cc0beb7","d546341988904f069cfa86b21457d9d9",22850817,1,-10,0,1463,260,251,-9
"d546341988904f069cfa86b21457d9d9","28c171777c52431ab6b925073bd63d46",22850817,1,15,0,1464,251,264,13
"28c171777c52431ab6b925073bd63d46","28c171777c52431ab6b925073bd63d46",22850817,9,0,1,1465,264,264,0
"28c171777c52431ab6b925073bd63d46","ac160db940cb49ae8579162b1d52bb5d",22850817,1,2,0,1474,264,266,2
"ac160db940cb49ae8579162b1d52bb5d","ac160db940cb49ae8579162b1d52bb5d",22850817,3,0,1,1475,266,266,0
"ac160db940cb49ae8579162b1d52bb5d","d989ebcfc12a4b669f0100dc1aa14f1e",22850817,1,-12,0,1478,266,255,-11
"d989ebcfc12a4b669f0100dc1aa14f1e","c6fd49b485cc4874b0bbdd9c6171e09c",22850817,1,15,0,1479,255,268,13
"c6fd49b485cc4874b0bbdd9c6171e09c","c6fd49b485cc4874b0bbdd9c6171e09c",22850817,3,0,1,1480,268,268,0
"c6fd49b485cc4874b0bbdd9c6171e09c","44240778a97c4af0937817499b75707b",22850817,1,1,0,1483,268,269,1
"44240778a97c4af0937817499b75707b","44240778a97c4af0937817499b75707b",22850817,3,0,1,1484,269,269,0
"44240778a97c4af0937817499b75707b","7aa76d3e993840d8805f097cbdbcd44b",22850817,1,-9,0,1487,269,261,-8
"7aa76d3e993840d8805f097cbdbcd44b","0d987bed3ffa4ed0b9a2e62e97b7b30f",22850817,3,15,0,1488,261,272,11
"82ae07bc0c9b4570a41799290d1ef399","cf4c280bad6a43e6b131d8385ef9ef3f",22850817,1,-120,0,1490,275,184,-91
"cf4c280bad6a43e6b131d8385ef9ef3f","0c7262dff33c4087bc660ccf40f92f9c",22850817,1,-19,0,1491,184,169,-15
"0c7262dff33c4087bc660ccf40f92f9c","cf4c280bad6a43e6b131d8385ef9ef3f",22850817,1,19,0,1493,169,184,15
"cf4c280bad6a43e6b131d8385ef9ef3f","c3f63fe50d8e487c86bf8ef76c9cadd3",22850817,1,1,0,1494,184,185,1
"c3f63fe50d8e487c86bf8ef76c9cadd3","c3f63fe50d8e487c86bf8ef76c9cadd3",22850817,1,0,1,1495,185,185,0
"c3f63fe50d8e487c86bf8ef76c9cadd3","c8e371568a0c4391b25796ae4e91952e",22850817,1,3,0,1496,185,186,1
"c8e371568a0c4391b25796ae4e91952e","b54257a550b94ebc9538f3a90eee9d7e",22850817,1,22,0,1497,186,204,18
"b54257a550b94ebc9538f3a90eee9d7e","334c2344009840079b1d0e1b7ce3d5a7",22850817,1,1,0,1498,204,205,1
"334c2344009840079b1d0e1b7ce3d5a7","334c2344009840079b1d0e1b7ce3d5a7",22850817,1,0,1,1499,205,205,0
"334c2344009840079b1d0e1b7ce3d5a7","d7f13c8d63ec4e2aa673fbb9cf9c6933",22850817,1,3,0,1500,205,206,1
"d7f13c8d63ec4e2aa673fbb9cf9c6933","a875096404ef4a9984b62d74cda916f9",22850817,1,4,0,1501,206,209,3
"a875096404ef4a9984b62d74cda916f9","09400e101c5d4b439cf9a26b03aae558",22850817,1,1,0,1502,209,210,1
"09400e101c5d4b439cf9a26b03aae558","09400e101c5d4b439cf9a26b03aae558",22850817,3,0,1,1503,210,210,0
"09400e101c5d4b439cf9a26b03aae558","a875096404ef4a9984b62d74cda916f9",22850817,3,-1,0,1505,210,209,-1
"a875096404ef4a9984b62d74cda916f9","f7fb1952f56b4189b86a9f8b7862d2b8",22850817,3,7,0,1506,209,215,6
"f7fb1952f56b4189b86a9f8b7862d2b8","be502a7a43c44bf7b682698de79d9369",22850817,2,-1,0,1507,215,214,-1
"be502a7a43c44bf7b682698de79d9369","be502a7a43c44bf7b682698de79d9369",22850817,3,0,1,1508,214,214,0
"be502a7a43c44bf7b682698de79d9369","ec341f459285443b8361f7f15638ff08",22850817,2,-1,0,1510,214,213,-1
"01b2051f8941460d89945e3b02d1ce78","91125ca626c5470eb145501f8c37f8db",22850817,1,4,0,1513,217,220,3
"91125ca626c5470eb145501f8c37f8db","91125ca626c5470eb145501f8c37f8db",22850817,1,0,1,1514,220,220,0
"91125ca626c5470eb145501f8c37f8db","f7906d6f59b9489a91d2ef40db5a474d",22850817,1,6,0,1515,220,223,3
"f7906d6f59b9489a91d2ef40db5a474d","1c6721b1f63f4d30ba7746ea8af02a52",22850817,1,-3,0,1516,223,221,-2
"1c6721b1f63f4d30ba7746ea8af02a52","d03cb855c70044cf8c35d9ec0de696e3",22850817,4,4,0,1517,221,224,3
"d03cb855c70044cf8c35d9ec0de696e3","8b9ae98743bd4d4a8a87dff1c1244211",22850817,3,3,0,1518,224,227,3
"8b9ae98743bd4d4a8a87dff1c1244211","d03cb855c70044cf8c35d9ec0de696e3",22850817,2,-3,0,1519,227,224,-3
"d03cb855c70044cf8c35d9ec0de696e3","2ab1535aac1346ba8801535bf729ef37",22850817,4,6,0,1520,224,229,5
"f7906d6f59b9489a91d2ef40db5a474d","2ab1535aac1346ba8801535bf729ef37",22850817,3,7,0,1522,223,229,6
"5152833676bf4c6cb317060be10f68db","8f68228b1518449e9615cdafee41a2bd",22850817,1,10,0,1524,228,237,9
"8f68228b1518449e9615cdafee41a2bd","8f68228b1518449e9615cdafee41a2bd",22850817,1,0,1,1525,237,237,0
"8f68228b1518449e9615cdafee41a2bd","0b04c8e2f86d48c7aeb7e225819cd32b",22850817,1,-3,0,1526,237,234,-3
"0b04c8e2f86d48c7aeb7e225819cd32b","64dbedb3ce544f6aae8e10e0cf10f16d",22850817,2,7,0,1527,234,240,6
"0b04c8e2f86d48c7aeb7e225819cd32b","1c6721b1f63f4d30ba7746ea8af02a52",22850817,3,-16,0,1529,234,221,-13
"1c6721b1f63f4d30ba7746ea8af02a52","66d4fad4f1cf4b46be0750a99ad7a35a",22850817,1,21,0,1530,221,239,18
"66d4fad4f1cf4b46be0750a99ad7a35a","66d4fad4f1cf4b46be0750a99ad7a35a",22850817,1,0,1,1531,239,239,0
"66d4fad4f1cf4b46be0750a99ad7a35a","0b04c8e2f86d48c7aeb7e225819cd32b",22850817,1,-5,0,1532,239,234,-5
"64dbedb3ce544f6aae8e10e0cf10f16d","1c6721b1f63f4d30ba7746ea8af02a52",22850817,1,-23,0,1534,240,221,-19
"1c6721b1f63f4d30ba7746ea8af02a52","f53da5fd9bfe412da4b80d4742563b6c",22850817,1,24,0,1535,221,241,20
"f53da5fd9bfe412da4b80d4742563b6c","f53da5fd9bfe412da4b80d4742563b6c",22850817,1,0,1,1536,241,241,0
"f53da5fd9bfe412da4b80d4742563b6c","1c6721b1f63f4d30ba7746ea8af02a52",22850817,1,-24,0,1537,241,221,-20
"1c6721b1f63f4d30ba7746ea8af02a52","2ae94c0cea4d480a9d5dca8fb1d7b542",22850817,5,27,0,1538,221,242,21
"1ebf23f9d994469a85206e4c7b1bf5f5","d546341988904f069cfa86b21457d9d9",22850817,1,8,0,1540,245,251,6
"d546341988904f069cfa86b21457d9d9","2ae94c0cea4d480a9d5dca8fb1d7b542",22850817,3,-11,0,1541,251,242,-9
"00f61990949545828dd12f1303d47504","d546341988904f069cfa86b21457d9d9",22850817,7,-6,0,1544,256,251,-5
"d546341988904f069cfa86b21457d9d9","d989ebcfc12a4b669f0100dc1aa14f1e",22850817,6,5,0,1545,251,255,4
"d989ebcfc12a4b669f0100dc1aa14f1e","7aa76d3e993840d8805f097cbdbcd44b",22850817,6,7,0,1546,255,261,6
"7aa76d3e993840d8805f097cbdbcd44b","865a4d3b43374da7944dc7d397f566d9",22850817,1,12,0,1547,261,271,10
"865a4d3b43374da7944dc7d397f566d9","865a4d3b43374da7944dc7d397f566d9",22850817,1,0,1,1548,271,271,0
"865a4d3b43374da7944dc7d397f566d9","0d987bed3ffa4ed0b9a2e62e97b7b30f",22850817,1,3,0,1549,271,272,1
"0d987bed3ffa4ed0b9a2e62e97b7b30f","2ae94c0cea4d480a9d5dca8fb1d7b542",22850817,3,-38,0,1550,272,242,-30
"2ae94c0cea4d480a9d5dca8fb1d7b542","0d987bed3ffa4ed0b9a2e62e97b7b30f",22850817,5,38,0,1551,242,272,30
"bb5a47f5ea01454a8b79455422d3b9da","c33c17be71ae4d588da7369472e5bb1b",22850817,1,-330,0,1561,280,34,-246
"c33c17be71ae4d588da7369472e5bb1b","4e51676dc72045d99c19b9fa7b22f8bc",22850817,1,-9,0,1563,34,29,-5
"c33c17be71ae4d588da7369472e5bb1b","2ae94c0cea4d480a9d5dca8fb1d7b542",22850817,1,282,0,1565,34,242,208
"2ae94c0cea4d480a9d5dca8fb1d7b542","d546341988904f069cfa86b21457d9d9",22850817,1,11,0,1566,242,251,9
"d546341988904f069cfa86b21457d9d9","00f61990949545828dd12f1303d47504",22850817,1,6,0,1567,251,256,5
"d546341988904f069cfa86b21457d9d9","fa235f0f364d47e4ae1c87f47bf8e6ba",22850817,1,1,0,1574,251,252,1
"fa235f0f364d47e4ae1c87f47bf8e6ba","d989ebcfc12a4b669f0100dc1aa14f1e",22850817,1,4,0,1575,252,255,3
"d989ebcfc12a4b669f0100dc1aa14f1e","fa235f0f364d47e4ae1c87f47bf8e6ba",22850817,1,-4,0,1576,255,252,-3
"fa235f0f364d47e4ae1c87f47bf8e6ba","6e83e23f56544a19b94067c1c558d9c0",22850817,2,-6,0,1577,252,247,-5
"00f61990949545828dd12f1303d47504","0c7262dff33c4087bc660ccf40f92f9c",22850817,1,-114,0,1579,256,169,-87
"d7f13c8d63ec4e2aa673fbb9cf9c6933","1c6721b1f63f4d30ba7746ea8af02a52",22850817,5,21,0,1582,206,221,15
"0d987bed3ffa4ed0b9a2e62e97b7b30f","1ebf23f9d994469a85206e4c7b1bf5f5",22850817,1,-35,0,1586,272,245,-27
"7aa76d3e993840d8805f097cbdbcd44b","7aa76d3e993840d8805f097cbdbcd44b",22850817,1,0,1,1594,261,261,0
"7aa76d3e993840d8805f097cbdbcd44b","bb5a47f5ea01454a8b79455422d3b9da",22850817,1,25,0,1595,261,280,19
"bb5a47f5ea01454a8b79455422d3b9da","2ae94c0cea4d480a9d5dca8fb1d7b542",22850817,1,-48,0,1603,280,242,-38
"1ebf23f9d994469a85206e4c7b1bf5f5","fa235f0f364d47e4ae1c87f47bf8e6ba",22850817,1,9,0,1605,245,252,7
"2ae94c0cea4d480a9d5dca8fb1d7b542","6e83e23f56544a19b94067c1c558d9c0",22850817,2,6,0,1607,242,247,5
"7aa76d3e993840d8805f097cbdbcd44b","d546341988904f069cfa86b21457d9d9",22850817,1,-12,0,1612,261,251,-10
"7aa76d3e993840d8805f097cbdbcd44b","1c6721b1f63f4d30ba7746ea8af02a52",22850817,1,-50,0,1618,261,221,-40
"1c6721b1f63f4d30ba7746ea8af02a52","1c6721b1f63f4d30ba7746ea8af02a52",22850817,6,0,1,1619,221,221,0
"1c6721b1f63f4d30ba7746ea8af02a52","77ecef8eff6b4a2caea7707669bf7475",22850817,5,1,0,1620,221,222,1
"77ecef8eff6b4a2caea7707669bf7475","1c6721b1f63f4d30ba7746ea8af02a52",22850817,3,-1,0,1621,222,221,-1
"8b9ae98743bd4d4a8a87dff1c1244211","f7906d6f59b9489a91d2ef40db5a474d",22850817,2,-4,0,1624,227,223,-4
"0b04c8e2f86d48c7aeb7e225819cd32b","bc5524e78a8544e2ae2fdc2f3462bbec",22850817,1,58,0,1628,234,279,45
"bc5524e78a8544e2ae2fdc2f3462bbec","0d987bed3ffa4ed0b9a2e62e97b7b30f",22850817,5,-9,0,1629,279,272,-7
"0d987bed3ffa4ed0b9a2e62e97b7b30f","bb5a47f5ea01454a8b79455422d3b9da",22850817,8,10,0,1630,272,280,8
"bb5a47f5ea01454a8b79455422d3b9da","4a29443515bb404cb8924e1c60a63b73",22850817,1,12,0,1638,280,285,5
"4a29443515bb404cb8924e1c60a63b73","4a29443515bb404cb8924e1c60a63b73",22850817,3,0,1,1639,285,285,0
"4a29443515bb404cb8924e1c60a63b73","208c9b2796c944db8dacaa96082520ea",22850817,6,3,0,1640,285,288,3
"208c9b2796c944db8dacaa96082520ea","208c9b2796c944db8dacaa96082520ea",22850817,2,0,1,1641,288,288,0
"208c9b2796c944db8dacaa96082520ea","4a29443515bb404cb8924e1c60a63b73",22850817,6,-3,0,1642,288,285,-3
"4a29443515bb404cb8924e1c60a63b73","869e967078f04da18dd0b0b9389a7424",22850817,3,10,0,1648,285,293,8
"869e967078f04da18dd0b0b9389a7424","6a9a3b5bde4a48daa896fe8c06eca56f",22850817,3,-5,0,1649,293,289,-4
"6a9a3b5bde4a48daa896fe8c06eca56f","869e967078f04da18dd0b0b9389a7424",22850817,1,5,0,1650,289,293,4
"869e967078f04da18dd0b0b9389a7424","51ab6291537748fab90d519aa09889d6",22850817,1,2,0,1651,293,295,2
"51ab6291537748fab90d519aa09889d6","51ab6291537748fab90d519aa09889d6",22850817,5,0,1,1652,295,295,0
"51ab6291537748fab90d519aa09889d6","869e967078f04da18dd0b0b9389a7424",22850817,1,-2,0,1657,295,293,-2
"869e967078f04da18dd0b0b9389a7424","34a6e49023fc4465bd5ca604330bbd1c",22850817,1,-1,0,1658,293,292,-1
"34a6e49023fc4465bd5ca604330bbd1c","ba0e59461bfb4a44b7b1c28a01f8d3b3",22850817,2,9,0,1659,292,299,7
"ba0e59461bfb4a44b7b1c28a01f8d3b3","21592f2a9e9c4b2f8c66ec5dbcbf6a2b",22850817,2,-4,0,1660,299,296,-3
"21592f2a9e9c4b2f8c66ec5dbcbf6a2b","ba0e59461bfb4a44b7b1c28a01f8d3b3",22850817,2,4,0,1661,296,299,3
"ba0e59461bfb4a44b7b1c28a01f8d3b3","0e0b36e731a645e7b1b8a88f5031ca38",22850817,1,2,0,1662,299,301,2
"0e0b36e731a645e7b1b8a88f5031ca38","0e0b36e731a645e7b1b8a88f5031ca38",22850817,2,0,1,1663,301,301,0
"0e0b36e731a645e7b1b8a88f5031ca38","a66a144637284c21afc6de17fea4bfb8",22850817,1,1,0,1665,301,302,1
"a66a144637284c21afc6de17fea4bfb8","a66a144637284c21afc6de17fea4bfb8",22850817,2,0,1,1666,302,302,0
"a66a144637284c21afc6de17fea4bfb8","ba0e59461bfb4a44b7b1c28a01f8d3b3",22850817,1,-3,0,1668,302,299,-3
"ba0e59461bfb4a44b7b1c28a01f8d3b3","7646a919d7e64fa990bca9b024ff089d",22850817,2,-1,0,1669,299,298,-1
"7646a919d7e64fa990bca9b024ff089d","3434c10e561d488a914e0f7d71907abd",22850817,2,10,0,1670,298,305,7
"3434c10e561d488a914e0f7d71907abd","4a29443515bb404cb8924e1c60a63b73",22850817,3,-27,0,1671,305,285,-20
"4a29443515bb404cb8924e1c60a63b73","53e7e900392747ccad52e711ab0f80d8",22850817,3,29,0,1672,285,307,22
"53e7e900392747ccad52e711ab0f80d8","4a29443515bb404cb8924e1c60a63b73",22850817,1,-29,0,1673,307,285,-22
"4a29443515bb404cb8924e1c60a63b73","3434c10e561d488a914e0f7d71907abd",22850817,3,27,0,1674,285,305,20
"3434c10e561d488a914e0f7d71907abd","3434c10e561d488a914e0f7d71907abd",22850817,3,0,1,1675,305,305,0
"3434c10e561d488a914e0f7d71907abd","53e7e900392747ccad52e711ab0f80d8",22850817,3,2,0,1676,305,307,2
"53e7e900392747ccad52e711ab0f80d8","53e7e900392747ccad52e711ab0f80d8",22850817,3,0,1,1677,307,307,0
"53e7e900392747ccad52e711ab0f80d8","3434c10e561d488a914e0f7d71907abd",22850817,3,-2,0,1680,307,305,-2
"3434c10e561d488a914e0f7d71907abd","130acc2aeb0448fdbb2de63bc5cebe5b",22850817,5,5,0,1681,305,309,4
"130acc2aeb0448fdbb2de63bc5cebe5b","9c062b3251034ebe90f5054e2a3b5120",22850817,1,2,0,1682,309,311,2
"9c062b3251034ebe90f5054e2a3b5120","9c062b3251034ebe90f5054e2a3b5120",22850817,2,0,1,1683,311,311,0
"9c062b3251034ebe90f5054e2a3b5120","ea859f8207e44537889daeaba13ac2e8",22850817,1,1,0,1685,311,312,1
"ea859f8207e44537889daeaba13ac2e8","ea859f8207e44537889daeaba13ac2e8",22850817,9,0,1,1686,312,312,0
"ea859f8207e44537889daeaba13ac2e8","56d94971a7a94257aa330183a8ebd0ea",22850817,2,1,0,1694,312,313,1
"56d94971a7a94257aa330183a8ebd0ea","56d94971a7a94257aa330183a8ebd0ea",22850817,5,0,1,1695,313,313,0
"56d94971a7a94257aa330183a8ebd0ea","141c0df6cd1946539aadd1c9b7068cd4",22850817,1,-5,0,1700,313,308,-5
"141c0df6cd1946539aadd1c9b7068cd4","86c27d40179e419c8e9d150fb6afa5d0",22850817,2,13,0,1701,308,319,11
"86c27d40179e419c8e9d150fb6afa5d0","0c787d16c9504873b1a4d903cec09948",22850817,2,-6,0,1702,319,314,-5
"0c787d16c9504873b1a4d903cec09948","86c27d40179e419c8e9d150fb6afa5d0",22850817,2,6,0,1703,314,319,5
"86c27d40179e419c8e9d150fb6afa5d0","47edbb64109243e6b0f8f64cdef90c6c",22850817,2,8,0,1704,319,326,7
"47edbb64109243e6b0f8f64cdef90c6c","24f1363179ad4aaa965484a78471912b",22850817,2,-3,0,1705,326,323,-3
"24f1363179ad4aaa965484a78471912b","8d7e0b55cf9849cda222a0f2440cec55",22850817,1,-6,0,1706,323,318,-5
"8d7e0b55cf9849cda222a0f2440cec55","94cecc3f1e7d484b8e068e79241dfd73",22850817,1,-52,0,1707,318,281,-37
"94cecc3f1e7d484b8e068e79241dfd73","94cecc3f1e7d484b8e068e79241dfd73",22850817,3,0,1,1708,281,281,0
"94cecc3f1e7d484b8e068e79241dfd73","a37477c4e4c14169ad44b06b493007f6",22850817,5,2,0,1709,281,283,2
"a37477c4e4c14169ad44b06b493007f6","fab84b4fab5940efb4ea868ef8d09396",22850817,2,3,0,1710,283,284,1
"fab84b4fab5940efb4ea868ef8d09396","94cecc3f1e7d484b8e068e79241dfd73",22850817,2,-5,0,1711,284,281,-3
"94cecc3f1e7d484b8e068e79241dfd73","3434c10e561d488a914e0f7d71907abd",22850817,1,36,0,1712,281,305,24
"3434c10e561d488a914e0f7d71907abd","8d7e0b55cf9849cda222a0f2440cec55",22850817,1,16,0,1713,305,318,13
"8d7e0b55cf9849cda222a0f2440cec55","86c27d40179e419c8e9d150fb6afa5d0",22850817,1,1,0,1714,318,319,1
"86c27d40179e419c8e9d150fb6afa5d0","24f1363179ad4aaa965484a78471912b",22850817,1,5,0,1715,319,323,4
"24f1363179ad4aaa965484a78471912b","47edbb64109243e6b0f8f64cdef90c6c",22850817,2,3,0,1716,323,326,3
"47edbb64109243e6b0f8f64cdef90c6c","8d7e0b55cf9849cda222a0f2440cec55",22850817,3,-9,0,1717,326,318,-8
"8d7e0b55cf9849cda222a0f2440cec55","24f1363179ad4aaa965484a78471912b",22850817,2,6,0,1718,318,323,5
"24f1363179ad4aaa965484a78471912b","24f1363179ad4aaa965484a78471912b",22850817,1,0,1,1719,323,323,0
"24f1363179ad4aaa965484a78471912b","3628bdce1dd2429ba924d2d4d09448d2",22850817,2,-1,0,1720,323,322,-1
"3628bdce1dd2429ba924d2d4d09448d2","0c4079457ede49e3aeb5e86ed84bdf35",22850817,1,10,0,1721,322,329,7
"0c4079457ede49e3aeb5e86ed84bdf35","3434c10e561d488a914e0f7d71907abd",22850817,1,-31,0,1722,329,305,-24
"3434c10e561d488a914e0f7d71907abd","38aea304b4fa46e1b29bb72f5cea4c93",22850817,1,33,0,1723,305,331,26
"38aea304b4fa46e1b29bb72f5cea4c93","8d7e0b55cf9849cda222a0f2440cec55",22850817,1,-17,0,1724,331,318,-13
"8d7e0b55cf9849cda222a0f2440cec55","3434c10e561d488a914e0f7d71907abd",22850817,1,-16,0,1725,318,305,-13
"3434c10e561d488a914e0f7d71907abd","86c27d40179e419c8e9d150fb6afa5d0",22850817,1,17,0,1726,305,319,14
"86c27d40179e419c8e9d150fb6afa5d0","86c27d40179e419c8e9d150fb6afa5d0",22850817,1,0,1,1727,319,319,0
"86c27d40179e419c8e9d150fb6afa5d0","8d7e0b55cf9849cda222a0f2440cec55",22850817,1,-1,0,1728,319,318,-1
"8d7e0b55cf9849cda222a0f2440cec55","47edbb64109243e6b0f8f64cdef90c6c",22850817,1,9,0,1729,318,326,8
"24f1363179ad4aaa965484a78471912b","3434c10e561d488a914e0f7d71907abd",22850817,1,-22,0,1731,323,305,-18
"130acc2aeb0448fdbb2de63bc5cebe5b","130acc2aeb0448fdbb2de63bc5cebe5b",22850817,4,0,1,1733,309,309,0
"130acc2aeb0448fdbb2de63bc5cebe5b","141c0df6cd1946539aadd1c9b7068cd4",22850817,5,-1,0,1734,309,308,-1
"141c0df6cd1946539aadd1c9b7068cd4","3434c10e561d488a914e0f7d71907abd",22850817,2,-4,0,1735,308,305,-3
"141c0df6cd1946539aadd1c9b7068cd4","0c4079457ede49e3aeb5e86ed84bdf35",22850817,1,27,0,1739,308,329,21
"0c4079457ede49e3aeb5e86ed84bdf35","38aea304b4fa46e1b29bb72f5cea4c93",22850817,4,2,0,1740,329,331,2
"38aea304b4fa46e1b29bb72f5cea4c93","38aea304b4fa46e1b29bb72f5cea4c93",22850817,2,0,1,1741,331,331,0
"38aea304b4fa46e1b29bb72f5cea4c93","e36d261332f14e79bb4b467aceaeb9b5",22850817,1,2,0,1743,331,333,2
"e36d261332f14e79bb4b467aceaeb9b5","e36d261332f14e79bb4b467aceaeb9b5",22850817,1,0,1,1744,333,333,0
"e36d261332f14e79bb4b467aceaeb9b5","c7e89b9d04744d2eab742fc24e3ef1ae",22850817,1,1,0,1745,333,334,1
"c7e89b9d04744d2eab742fc24e3ef1ae","c7e89b9d04744d2eab742fc24e3ef1ae",22850817,2,0,1,1746,334,334,0
"c7e89b9d04744d2eab742fc24e3ef1ae","fe49f8054b374a0ea4bb266ed135ff62",22850817,1,1,0,1748,334,335,1
"fe49f8054b374a0ea4bb266ed135ff62","fe49f8054b374a0ea4bb266ed135ff62",22850817,2,0,1,1749,335,335,0
"fe49f8054b374a0ea4bb266ed135ff62","d0a8f74af98642fe8360d22c42e45117",22850817,1,1,0,1751,335,336,1
"d0a8f74af98642fe8360d22c42e45117","d0a8f74af98642fe8360d22c42e45117",22850817,2,0,1,1752,336,336,0
"d0a8f74af98642fe8360d22c42e45117","38aea304b4fa46e1b29bb72f5cea4c93",22850817,1,-5,0,1754,336,331,-5
"38aea304b4fa46e1b29bb72f5cea4c93","0c4079457ede49e3aeb5e86ed84bdf35",22850817,4,-2,0,1755,331,329,-2
"0c4079457ede49e3aeb5e86ed84bdf35","0c4079457ede49e3aeb5e86ed84bdf35",22850817,1,0,1,1756,329,329,0
"0c4079457ede49e3aeb5e86ed84bdf35","bbc5139ca9024389a94db3a6f47dcff6",22850817,3,14,0,1757,329,341,12
"bbc5139ca9024389a94db3a6f47dcff6","b8b9418ab322418d9db9b40d96af873a",22850817,2,-5,0,1758,341,337,-4
"b8b9418ab322418d9db9b40d96af873a","bbc5139ca9024389a94db3a6f47dcff6",22850817,2,5,0,1759,337,341,4
"bbc5139ca9024389a94db3a6f47dcff6","bbc5139ca9024389a94db3a6f47dcff6",22850817,2,0,1,1760,341,341,0
"bbc5139ca9024389a94db3a6f47dcff6","4ee6ca9019ab4a1ab323f98094a9bd77",22850817,1,2,0,1761,341,343,2
"4ee6ca9019ab4a1ab323f98094a9bd77","4ee6ca9019ab4a1ab323f98094a9bd77",22850817,2,0,1,1762,343,343,0
"4ee6ca9019ab4a1ab323f98094a9bd77","b37947176785476f8b29d49a851366dc",22850817,1,1,0,1764,343,344,1
"b37947176785476f8b29d49a851366dc","b37947176785476f8b29d49a851366dc",22850817,2,0,1,1765,344,344,0
"b37947176785476f8b29d49a851366dc","fcea5b10d5a14a3b9324ffece8f6e1e5",22850817,1,1,0,1767,344,345,1
"fcea5b10d5a14a3b9324ffece8f6e1e5","fcea5b10d5a14a3b9324ffece8f6e1e5",22850817,2,0,1,1768,345,345,0
"fcea5b10d5a14a3b9324ffece8f6e1e5","c2490bc612d146edbe786556fab3651b",22850817,1,-5,0,1770,345,340,-5
"c2490bc612d146edbe786556fab3651b","30ead9794d4847abaf222ca966cc8630",22850817,1,11,0,1771,340,348,8
"30ead9794d4847abaf222ca966cc8630","0c4079457ede49e3aeb5e86ed84bdf35",22850817,2,-24,0,1772,348,329,-19
"0c4079457ede49e3aeb5e86ed84bdf35","eff0de7f2dbb42dfa1a2e686efab5b6d",22850817,1,30,0,1773,329,354,25
"eff0de7f2dbb42dfa1a2e686efab5b6d","09b9678ddc3d452ea4a3d46e15826065",22850817,3,-1,0,1774,354,353,-1
"09b9678ddc3d452ea4a3d46e15826065","897b7f51242c44aab2205c72fdcbf4cd",22850817,4,-1,0,1775,353,352,-1
"897b7f51242c44aab2205c72fdcbf4cd","c20993c944444fe085345591a8bd837e",22850817,3,-1,0,1776,352,351,-1
"c20993c944444fe085345591a8bd837e","c20993c944444fe085345591a8bd837e",22850817,9,0,1,1777,351,351,0
"c20993c944444fe085345591a8bd837e","897b7f51242c44aab2205c72fdcbf4cd",22850817,1,1,0,1781,351,352,1
"897b7f51242c44aab2205c72fdcbf4cd","897b7f51242c44aab2205c72fdcbf4cd",22850817,8,0,1,1782,352,352,0
"897b7f51242c44aab2205c72fdcbf4cd","09b9678ddc3d452ea4a3d46e15826065",22850817,3,1,0,1785,352,353,1
"09b9678ddc3d452ea4a3d46e15826065","09b9678ddc3d452ea4a3d46e15826065",22850817,7,0,1,1786,353,353,0
"09b9678ddc3d452ea4a3d46e15826065","eff0de7f2dbb42dfa1a2e686efab5b6d",22850817,3,1,0,1789,353,354,1
"eff0de7f2dbb42dfa1a2e686efab5b6d","eff0de7f2dbb42dfa1a2e686efab5b6d",22850817,7,0,1,1790,354,354,0
"eff0de7f2dbb42dfa1a2e686efab5b6d","30ead9794d4847abaf222ca966cc8630",22850817,1,-6,0,1793,354,348,-6
"30ead9794d4847abaf222ca966cc8630","2fe14166dc9642c3bc666b86a57f943d",22850817,2,10,0,1794,348,357,9
"2fe14166dc9642c3bc666b86a57f943d","2fe14166dc9642c3bc666b86a57f943d",22850817,2,0,1,1795,357,357,0
"2fe14166dc9642c3bc666b86a57f943d","44421dd1e13a47a388c4a19834b744c7",22850817,1,2,0,1796,357,359,2
"44421dd1e13a47a388c4a19834b744c7","44421dd1e13a47a388c4a19834b744c7",22850817,2,0,1,1797,359,359,0
"44421dd1e13a47a388c4a19834b744c7","cb5fc7ef85d547c4be1a7439d0bf6052",22850817,1,1,0,1799,359,360,1
"cb5fc7ef85d547c4be1a7439d0bf6052","cb5fc7ef85d547c4be1a7439d0bf6052",22850817,2,0,1,1800,360,360,0
"cb5fc7ef85d547c4be1a7439d0bf6052","0a8f150a4cf747acbde62f4721823da3",22850817,1,1,0,1802,360,361,1
"0a8f150a4cf747acbde62f4721823da3","0a8f150a4cf747acbde62f4721823da3",22850817,2,0,1,1803,361,361,0
"0a8f150a4cf747acbde62f4721823da3","ab8fdad974ae471f9f24c3f9dd04462e",22850817,1,1,0,1805,361,362,1
"ab8fdad974ae471f9f24c3f9dd04462e","ab8fdad974ae471f9f24c3f9dd04462e",22850817,2,0,1,1806,362,362,0
"ab8fdad974ae471f9f24c3f9dd04462e","1ba8fef685d74a8194b9db252eb704fb",22850817,1,-7,0,1808,362,355,-7
"1ba8fef685d74a8194b9db252eb704fb","52580888dadb4fe3baa795683ea227bd",22850817,2,10,0,1809,355,364,9
"52580888dadb4fe3baa795683ea227bd","52580888dadb4fe3baa795683ea227bd",22850817,2,0,1,1810,364,364,0
"52580888dadb4fe3baa795683ea227bd","492a3bc6a1254f23a7998587961b22a4",22850817,2,3,0,1811,364,366,2
"492a3bc6a1254f23a7998587961b22a4","f00179e251a045b39c3f7a54f9aa4acc",22850817,2,-4,0,1812,366,363,-3
"f00179e251a045b39c3f7a54f9aa4acc","492a3bc6a1254f23a7998587961b22a4",22850817,3,4,0,1813,363,366,3
"492a3bc6a1254f23a7998587961b22a4","072a190fd302456290895f9f04d6940a",22850817,4,-1,0,1814,366,365,-1
"072a190fd302456290895f9f04d6940a","30ead9794d4847abaf222ca966cc8630",22850817,2,-20,0,1815,365,348,-17
"30ead9794d4847abaf222ca966cc8630","b71bac264efb4abd97015447bd490db6",22850817,3,28,0,1816,348,370,22
"b71bac264efb4abd97015447bd490db6","8d448d625b024c82a5eb240bbd7431d6",22850817,11,5,0,1817,370,374,4
"8d448d625b024c82a5eb240bbd7431d6","b71bac264efb4abd97015447bd490db6",22850817,8,-5,0,1818,374,370,-4
"8d448d625b024c82a5eb240bbd7431d6","8d448d625b024c82a5eb240bbd7431d6",22850817,105,0,1,1820,374,374,0
"8d448d625b024c82a5eb240bbd7431d6","c2490bc612d146edbe786556fab3651b",22850817,1,-44,0,1826,374,340,-34
"c2490bc612d146edbe786556fab3651b","0c4079457ede49e3aeb5e86ed84bdf35",22850817,3,-13,0,1827,340,329,-11
"bbc5139ca9024389a94db3a6f47dcff6","94cecc3f1e7d484b8e068e79241dfd73",22850817,1,-81,0,1829,341,281,-60
"a37477c4e4c14169ad44b06b493007f6","94cecc3f1e7d484b8e068e79241dfd73",22850817,4,-2,0,1832,283,281,-2
"a37477c4e4c14169ad44b06b493007f6","6e83e23f56544a19b94067c1c558d9c0",22850817,1,-47,0,1834,283,247,-36
"6e83e23f56544a19b94067c1c558d9c0","2ae94c0cea4d480a9d5dca8fb1d7b542",22850817,1,-6,0,1835,247,242,-5
"2ae94c0cea4d480a9d5dca8fb1d7b542","30c9ba177afc49a695625d2bdec40207",22850817,1,9,0,1836,242,250,8
"30c9ba177afc49a695625d2bdec40207","30c9ba177afc49a695625d2bdec40207",22850817,2,0,1,1837,250,250,0
"30c9ba177afc49a695625d2bdec40207","6e83e23f56544a19b94067c1c558d9c0",22850817,1,-3,0,1839,250,247,-3
"00f61990949545828dd12f1303d47504","94cecc3f1e7d484b8e068e79241dfd73",22850817,1,34,0,1841,256,281,25
"94cecc3f1e7d484b8e068e79241dfd73","fab84b4fab5940efb4ea868ef8d09396",22850817,4,5,0,1845,281,284,3
"fab84b4fab5940efb4ea868ef8d09396","d6d02b6ef04e4f17805504500b8ce441",22850817,1,122,0,1846,284,375,91
"d6d02b6ef04e4f17805504500b8ce441","d6d02b6ef04e4f17805504500b8ce441",22850817,24,0,1,1847,375,375,0
"d6d02b6ef04e4f17805504500b8ce441","b71bac264efb4abd97015447bd490db6",22850817,3,-8,0,1849,375,370,-5
"b71bac264efb4abd97015447bd490db6","d6d02b6ef04e4f17805504500b8ce441",22850817,6,8,0,1850,370,375,5
"d6d02b6ef04e4f17805504500b8ce441","8d448d625b024c82a5eb240bbd7431d6",22850817,1,-3,0,1851,375,374,-1
"8d448d625b024c82a5eb240bbd7431d6","bc5524e78a8544e2ae2fdc2f3462bbec",22850817,2,-128,0,1859,374,279,-95
"bb5a47f5ea01454a8b79455422d3b9da","2c5bb2cbd0014420ad8c95d40e38efd1",22850817,1,35,0,1935,280,303,23
"2c5bb2cbd0014420ad8c95d40e38efd1","4a29443515bb404cb8924e1c60a63b73",22850817,1,-23,0,1936,303,285,-18
"4a29443515bb404cb8924e1c60a63b73","e390b575229748ea8aac9364efe2bf00",22850817,1,24,0,1937,285,304,19
"e390b575229748ea8aac9364efe2bf00","e390b575229748ea8aac9364efe2bf00",22850817,1,0,1,1938,304,304,0
"e390b575229748ea8aac9364efe2bf00","43ea1b823a4b4e51b7c694c10725db82",22850817,1,30,0,1939,304,327,23
"43ea1b823a4b4e51b7c694c10725db82","3434c10e561d488a914e0f7d71907abd",22850817,1,-27,0,1940,327,305,-22
"3434c10e561d488a914e0f7d71907abd","56b3fd1a212a4764be39d979fde3326e",22850817,2,28,0,1941,305,328,23
"56b3fd1a212a4764be39d979fde3326e","56b3fd1a212a4764be39d979fde3326e",22850817,2,0,1,1942,328,328,0
"56b3fd1a212a4764be39d979fde3326e","3434c10e561d488a914e0f7d71907abd",22850817,1,-28,0,1943,328,305,-23
"56b3fd1a212a4764be39d979fde3326e","0c4079457ede49e3aeb5e86ed84bdf35",22850817,1,3,0,1946,328,329,1
"0c4079457ede49e3aeb5e86ed84bdf35","6ac8bb048b854999a47edb35fe627f11",22850817,1,21,0,1947,329,347,18
"6ac8bb048b854999a47edb35fe627f11","6ac8bb048b854999a47edb35fe627f11",22850817,1,0,1,1948,347,347,0
"6ac8bb048b854999a47edb35fe627f11","4a29443515bb404cb8924e1c60a63b73",22850817,1,-79,0,1949,347,285,-62
"4a29443515bb404cb8924e1c60a63b73","6a9a3b5bde4a48daa896fe8c06eca56f",22850817,1,5,0,1950,285,289,4
"6a9a3b5bde4a48daa896fe8c06eca56f","7669a956527947d0add87455277e80b4",22850817,1,2,0,1951,289,291,2
"7669a956527947d0add87455277e80b4","7669a956527947d0add87455277e80b4",22850817,1,0,1,1952,291,291,0
"7669a956527947d0add87455277e80b4","0c787d16c9504873b1a4d903cec09948",22850817,1,31,0,1953,291,314,23
"0c787d16c9504873b1a4d903cec09948","3434c10e561d488a914e0f7d71907abd",22850817,1,-11,0,1954,314,305,-9
"3434c10e561d488a914e0f7d71907abd","13255e63e0aa4abf85e5211bf613d43e",22850817,1,14,0,1955,305,317,12
"13255e63e0aa4abf85e5211bf613d43e","13255e63e0aa4abf85e5211bf613d43e",22850817,1,0,1,1956,317,317,0
"13255e63e0aa4abf85e5211bf613d43e","0c4079457ede49e3aeb5e86ed84bdf35",22850817,1,17,0,1957,317,329,12
"0c4079457ede49e3aeb5e86ed84bdf35","b8b9418ab322418d9db9b40d96af873a",22850817,2,9,0,1958,329,337,8
"b8b9418ab322418d9db9b40d96af873a","a7c6339ca1da4368a18d471f0519f877",22850817,1,2,0,1959,337,339,2
"a7c6339ca1da4368a18d471f0519f877","a7c6339ca1da4368a18d471f0519f877",22850817,1,0,1,1960,339,339,0
"a7c6339ca1da4368a18d471f0519f877","bc5524e78a8544e2ae2fdc2f3462bbec",22850817,1,-82,0,1961,339,279,-60
"bb5a47f5ea01454a8b79455422d3b9da","bc5524e78a8544e2ae2fdc2f3462bbec",22850817,1,-1,0,1971,280,279,-1
"bb5a47f5ea01454a8b79455422d3b9da","c76574d21bc14aeea7ecd0b027f39858",22850817,1,117,0,1981,280,367,87
"c76574d21bc14aeea7ecd0b027f39858","30ead9794d4847abaf222ca966cc8630",22850817,1,-23,0,1982,367,348,-19
"30ead9794d4847abaf222ca966cc8630","cfa457d1743848e4bb5e4beced6448ed",22850817,1,25,0,1983,348,369,21
"cfa457d1743848e4bb5e4beced6448ed","cfa457d1743848e4bb5e4beced6448ed",22850817,1,0,1,1984,369,369,0
"cfa457d1743848e4bb5e4beced6448ed","b71bac264efb4abd97015447bd490db6",22850817,1,3,0,1985,369,370,1
"b71bac264efb4abd97015447bd490db6","b71bac264efb4abd97015447bd490db6",22850817,1,0,1,1986,370,370,0
"bb5a47f5ea01454a8b79455422d3b9da","94cecc3f1e7d484b8e068e79241dfd73",22850817,3,3,0,2008,280,281,1
"94cecc3f1e7d484b8e068e79241dfd73","0d987bed3ffa4ed0b9a2e62e97b7b30f",22850817,3,-13,0,2009,281,272,-9
"0d987bed3ffa4ed0b9a2e62e97b7b30f","a37477c4e4c14169ad44b06b493007f6",22850817,3,15,0,2010,272,283,11
"a37477c4e4c14169ad44b06b493007f6","1b4550d0dab04078b3bf08a655345bdc",22850817,1,121,0,2011,283,373,90
"1b4550d0dab04078b3bf08a655345bdc","b71bac264efb4abd97015447bd490db6",22850817,3,-4,0,2012,373,370,-3
"d6d02b6ef04e4f17805504500b8ce441","fab84b4fab5940efb4ea868ef8d09396",22850817,1,-122,0,2069,375,284,-91
"fab84b4fab5940efb4ea868ef8d09396","fab84b4fab5940efb4ea868ef8d09396",22850817,3,0,1,2070,284,284,0
"fab84b4fab5940efb4ea868ef8d09396","4a29443515bb404cb8924e1c60a63b73",22850817,5,4,0,2071,284,285,1
"4a29443515bb404cb8924e1c60a63b73","fab84b4fab5940efb4ea868ef8d09396",22850817,2,-4,0,2072,285,284,-1
"fab84b4fab5940efb4ea868ef8d09396","208c9b2796c944db8dacaa96082520ea",22850817,1,7,0,2073,284,288,4
"fab84b4fab5940efb4ea868ef8d09396","30ead9794d4847abaf222ca966cc8630",22850817,1,86,0,2076,284,348,64
"30ead9794d4847abaf222ca966cc8630","30ead9794d4847abaf222ca966cc8630",22850817,1,0,1,2077,348,348,0
"30ead9794d4847abaf222ca966cc8630","eff0de7f2dbb42dfa1a2e686efab5b6d",22850817,1,6,0,2078,348,354,6
"eff0de7f2dbb42dfa1a2e686efab5b6d","897b7f51242c44aab2205c72fdcbf4cd",22850817,4,-2,0,2080,354,352,-2
"eff0de7f2dbb42dfa1a2e686efab5b6d","c20993c944444fe085345591a8bd837e",22850817,2,-3,0,2086,354,351,-3
"c20993c944444fe085345591a8bd837e","09b9678ddc3d452ea4a3d46e15826065",22850817,3,2,0,2089,351,353,2
"09b9678ddc3d452ea4a3d46e15826065","fab84b4fab5940efb4ea868ef8d09396",22850817,1,-91,0,2090,353,284,-69
"208c9b2796c944db8dacaa96082520ea","3434c10e561d488a914e0f7d71907abd",22850817,1,24,0,2093,288,305,17
"3434c10e561d488a914e0f7d71907abd","141c0df6cd1946539aadd1c9b7068cd4",22850817,1,4,0,2094,305,308,3
"141c0df6cd1946539aadd1c9b7068cd4","130acc2aeb0448fdbb2de63bc5cebe5b",22850817,1,1,0,2095,308,309,1
"0c787d16c9504873b1a4d903cec09948","24f1363179ad4aaa965484a78471912b",22850817,1,11,0,2100,314,323,9
"8d7e0b55cf9849cda222a0f2440cec55","3628bdce1dd2429ba924d2d4d09448d2",22850817,1,5,0,2103,318,322,4
"3628bdce1dd2429ba924d2d4d09448d2","3434c10e561d488a914e0f7d71907abd",22850817,2,-21,0,2104,322,305,-17
"3434c10e561d488a914e0f7d71907abd","0c4079457ede49e3aeb5e86ed84bdf35",22850817,3,31,0,2105,305,329,24
"bbc5139ca9024389a94db3a6f47dcff6","c2490bc612d146edbe786556fab3651b",22850817,1,-1,0,2111,341,340,-1
"0c4079457ede49e3aeb5e86ed84bdf35","30ead9794d4847abaf222ca966cc8630",22850817,3,24,0,2113,329,348,19
"30ead9794d4847abaf222ca966cc8630","c20993c944444fe085345591a8bd837e",22850817,2,3,0,2114,348,351,3
"897b7f51242c44aab2205c72fdcbf4cd","eff0de7f2dbb42dfa1a2e686efab5b6d",22850817,1,2,0,2117,352,354,2
"c20993c944444fe085345591a8bd837e","eff0de7f2dbb42dfa1a2e686efab5b6d",22850817,4,3,0,2122,351,354,3
"09b9678ddc3d452ea4a3d46e15826065","30ead9794d4847abaf222ca966cc8630",22850817,1,-5,0,2126,353,348,-5
"2fe14166dc9642c3bc666b86a57f943d","1ba8fef685d74a8194b9db252eb704fb",22850817,1,-2,0,2129,357,355,-2
"072a190fd302456290895f9f04d6940a","c76574d21bc14aeea7ecd0b027f39858",22850817,1,3,0,2136,365,367,2
"c76574d21bc14aeea7ecd0b027f39858","492a3bc6a1254f23a7998587961b22a4",22850817,1,-2,0,2137,367,366,-1
"492a3bc6a1254f23a7998587961b22a4","492a3bc6a1254f23a7998587961b22a4",22850817,1,0,1,2138,366,366,0
"d6d02b6ef04e4f17805504500b8ce441","66baf19b6b904b70922329068c63746d",22850817,6,4,0,2155,375,376,1
"66baf19b6b904b70922329068c63746d","7f544639412e40a9ba27f43b415362ab",22850817,11,2,0,2156,376,378,2
"7f544639412e40a9ba27f43b415362ab","66baf19b6b904b70922329068c63746d",22850817,7,-2,0,2157,378,376,-2
"66baf19b6b904b70922329068c63746d","66baf19b6b904b70922329068c63746d",22850817,5,0,1,2158,376,376,0
"7f544639412e40a9ba27f43b415362ab","141c0df6cd1946539aadd1c9b7068cd4",22850817,1,-93,0,2163,378,308,-70
"141c0df6cd1946539aadd1c9b7068cd4","d6d02b6ef04e4f17805504500b8ce441",22850817,1,87,0,2168,308,375,67
"7f544639412e40a9ba27f43b415362ab","1b4550d0dab04078b3bf08a655345bdc",22850817,1,-10,0,2174,378,373,-5
"7f544639412e40a9ba27f43b415362ab","d6d02b6ef04e4f17805504500b8ce441",22850817,1,-6,0,2192,378,375,-3
"7f544639412e40a9ba27f43b415362ab","7f544639412e40a9ba27f43b415362ab",22850817,2,0,1,2202,378,378,0
"7f544639412e40a9ba27f43b415362ab","d5ae8642e15b46b8bd298b02274d4e9c",22850817,1,2,0,2203,378,380,2
"d5ae8642e15b46b8bd298b02274d4e9c","d5ae8642e15b46b8bd298b02274d4e9c",22850817,1,0,1,2204,380,380,0
"d5ae8642e15b46b8bd298b02274d4e9c","a0d10309a2dd456289147f84be9d37f9",22850817,1,1,0,2205,380,381,1
"a0d10309a2dd456289147f84be9d37f9","a0d10309a2dd456289147f84be9d37f9",22850817,2,0,1,2206,381,381,0
"a0d10309a2dd456289147f84be9d37f9","0fcbc3ca07b144138b8d85da581f09a8",22850817,1,1,0,2208,381,382,1
"0fcbc3ca07b144138b8d85da581f09a8","0fcbc3ca07b144138b8d85da581f09a8",22850817,6,0,1,2209,382,382,0
"0fcbc3ca07b144138b8d85da581f09a8","66baf19b6b904b70922329068c63746d",22850817,1,-6,0,2215,382,376,-6
"66baf19b6b904b70922329068c63746d","c2fca3669923477ab966ded303dea31c",22850817,3,8,0,2216,376,383,7
"c2fca3669923477ab966ded303dea31c","4890121ce5d74576b4632b77cfc23398",22850817,4,6,0,2217,383,388,5
"4890121ce5d74576b4632b77cfc23398","4890121ce5d74576b4632b77cfc23398",22850817,2,0,1,2218,388,388,0
"4890121ce5d74576b4632b77cfc23398","18d3b836dd804224883cc9180b60a8e1",22850817,3,-1,0,2220,388,387,-1
"18d3b836dd804224883cc9180b60a8e1","96bb2b3e85a34d8b9544514e89f6fe97",22850817,4,4,0,2221,387,390,3
"96bb2b3e85a34d8b9544514e89f6fe97","96bb2b3e85a34d8b9544514e89f6fe97",22850817,2,0,1,2222,390,390,0
"96bb2b3e85a34d8b9544514e89f6fe97","17f95d18bab743888e1736033dc3384d",22850817,3,-1,0,2224,390,389,-1
"17f95d18bab743888e1736033dc3384d","6f8881a745ac4c358a68b92c3b4abe81",22850817,4,6,0,2225,389,394,5
"6f8881a745ac4c358a68b92c3b4abe81","6f8881a745ac4c358a68b92c3b4abe81",22850817,2,0,1,2226,394,394,0
"6f8881a745ac4c358a68b92c3b4abe81","f7002c8484354eceac57bc7bd62c76c1",22850817,4,-1,0,2227,394,393,-1
"f7002c8484354eceac57bc7bd62c76c1","0c12af0a4e7f4002852cf84b2537c161",22850817,4,3,0,2228,393,395,2
"0c12af0a4e7f4002852cf84b2537c161","66baf19b6b904b70922329068c63746d",22850817,3,-24,0,2229,395,376,-19
"66baf19b6b904b70922329068c63746d","2b09a08242b54983aec7063990fb3f66",22850817,7,32,0,2230,376,400,24
"2b09a08242b54983aec7063990fb3f66","2b09a08242b54983aec7063990fb3f66",22850817,15,0,1,2231,400,400,0
"2b09a08242b54983aec7063990fb3f66","1157bd665ec4472fb58b751dc5099355",22850817,4,4,0,2234,400,403,3
"1157bd665ec4472fb58b751dc5099355","58fc9094275e4c49be3f4ba6d4acc0a4",22850817,2,5,0,2235,403,406,3
"58fc9094275e4c49be3f4ba6d4acc0a4","3c8a22d2f9c146ea956609e3ed4f2559",22850817,2,-2,0,2236,406,405,-1
"3c8a22d2f9c146ea956609e3ed4f2559","58fc9094275e4c49be3f4ba6d4acc0a4",22850817,3,2,0,2237,405,406,1
"58fc9094275e4c49be3f4ba6d4acc0a4","02b3a1bead9244c1ba2f857c7da8f82a",22850817,5,3,0,2238,406,408,2
"02b3a1bead9244c1ba2f857c7da8f82a","58fc9094275e4c49be3f4ba6d4acc0a4",22850817,2,-3,0,2239,408,406,-2
"02b3a1bead9244c1ba2f857c7da8f82a","02b3a1bead9244c1ba2f857c7da8f82a",22850817,3,0,1,2241,408,408,0
"02b3a1bead9244c1ba2f857c7da8f82a","6a5f020451db426dacba9e2ea3fcc62a",22850817,4,3,0,2242,408,410,2
"6a5f020451db426dacba9e2ea3fcc62a","6a5f020451db426dacba9e2ea3fcc62a",22850817,5,0,1,2243,410,410,0
"6a5f020451db426dacba9e2ea3fcc62a","33a9d248b2e44588a5b07fc1342b9bc2",22850817,6,2,0,2244,410,411,1
"33a9d248b2e44588a5b07fc1342b9bc2","6a5f020451db426dacba9e2ea3fcc62a",22850817,2,-2,0,2245,411,410,-1
"33a9d248b2e44588a5b07fc1342b9bc2","33a9d248b2e44588a5b07fc1342b9bc2",22850817,8,0,1,2247,411,411,0
"33a9d248b2e44588a5b07fc1342b9bc2","687055dad9fc40c3982478fe33ec01bf",22850817,4,4,0,2249,411,414,3
"687055dad9fc40c3982478fe33ec01bf","2b09a08242b54983aec7063990fb3f66",22850817,4,-21,0,2250,414,400,-14
"2b09a08242b54983aec7063990fb3f66","a2b4bd40cee2481ebd3fc179d6a5cd62",22850817,6,27,0,2251,400,417,17
"a2b4bd40cee2481ebd3fc179d6a5cd62","a2b4bd40cee2481ebd3fc179d6a5cd62",22850817,4,0,1,2252,417,417,0
"a2b4bd40cee2481ebd3fc179d6a5cd62","bec48fc2e1294c7eb3d0aca780d731b8",22850817,6,4,0,2253,417,420,3
"bec48fc2e1294c7eb3d0aca780d731b8","bec48fc2e1294c7eb3d0aca780d731b8",22850817,5,0,1,2254,420,420,0
"bec48fc2e1294c7eb3d0aca780d731b8","a2b4bd40cee2481ebd3fc179d6a5cd62",22850817,3,-4,0,2255,420,417,-3
"bec48fc2e1294c7eb3d0aca780d731b8","a24600b0e49245f6bdba8c893cfeddb0",22850817,2,7,0,2258,420,425,5
"a24600b0e49245f6bdba8c893cfeddb0","dbde19fcce2a4c1abdc7f685c293a23f",22850817,2,-4,0,2259,425,422,-3
"dbde19fcce2a4c1abdc7f685c293a23f","a24600b0e49245f6bdba8c893cfeddb0",22850817,4,4,0,2260,422,425,3
"a24600b0e49245f6bdba8c893cfeddb0","a24600b0e49245f6bdba8c893cfeddb0",22850817,3,0,1,2261,425,425,0
"a24600b0e49245f6bdba8c893cfeddb0","24cf8786024543f19b89bc20034e60d7",22850817,3,7,0,2262,425,428,3
"24cf8786024543f19b89bc20034e60d7","a2b4bd40cee2481ebd3fc179d6a5cd62",22850817,4,-18,0,2263,428,417,-11
"a2b4bd40cee2481ebd3fc179d6a5cd62","f2a73be2f46840b182d7bd095378004e",22850817,4,19,0,2264,417,429,12
"f2a73be2f46840b182d7bd095378004e","f2a73be2f46840b182d7bd095378004e",22850817,2,0,1,2265,429,429,0
"f2a73be2f46840b182d7bd095378004e","dce46f8904594a62a6377a3587aaa663",22850817,1,3,0,2266,429,431,2
"dce46f8904594a62a6377a3587aaa663","24cf8786024543f19b89bc20034e60d7",22850817,1,-4,0,2267,431,428,-3
"24cf8786024543f19b89bc20034e60d7","dce46f8904594a62a6377a3587aaa663",22850817,4,4,0,2268,428,431,3
"dce46f8904594a62a6377a3587aaa663","dce46f8904594a62a6377a3587aaa663",22850817,4,0,1,2269,431,431,0
"dce46f8904594a62a6377a3587aaa663","66ada10dde9f43018588f1ced9d477fc",22850817,4,4,0,2270,431,434,3
"66ada10dde9f43018588f1ced9d477fc","24cf8786024543f19b89bc20034e60d7",22850817,4,-8,0,2271,434,428,-6
"24cf8786024543f19b89bc20034e60d7","070600601c4c439288445d2f0724807d",22850817,5,14,0,2272,428,437,9
"070600601c4c439288445d2f0724807d","1823b6de7d334a7aaabc4570719af4d9",22850817,4,2,0,2273,437,439,2
"1823b6de7d334a7aaabc4570719af4d9","070600601c4c439288445d2f0724807d",22850817,4,-2,0,2274,439,437,-2
"070600601c4c439288445d2f0724807d","0380cd76a7d44bc3a4da1f15e4d68f89",22850817,4,4,0,2275,437,440,3
"0380cd76a7d44bc3a4da1f15e4d68f89","0380cd76a7d44bc3a4da1f15e4d68f89",22850817,5,0,1,2276,440,440,0
"0380cd76a7d44bc3a4da1f15e4d68f89","23b7673c8b5443108c2ef09382834a86",22850817,4,2,0,2278,440,441,1
"23b7673c8b5443108c2ef09382834a86","23b7673c8b5443108c2ef09382834a86",22850817,5,0,1,2279,441,441,0
"23b7673c8b5443108c2ef09382834a86","901e92500aea43c79f19f1b279050668",22850817,4,2,0,2281,441,442,1
"901e92500aea43c79f19f1b279050668","901e92500aea43c79f19f1b279050668",22850817,2,0,1,2282,442,442,0
"901e92500aea43c79f19f1b279050668","4660ff2089114e8db82ceb26a4f329e3",22850817,6,4,0,2283,442,445,3
"4660ff2089114e8db82ceb26a4f329e3","901e92500aea43c79f19f1b279050668",22850817,4,-4,0,2284,445,442,-3
"4660ff2089114e8db82ceb26a4f329e3","4660ff2089114e8db82ceb26a4f329e3",22850817,2,0,1,2286,445,445,0
"4660ff2089114e8db82ceb26a4f329e3","7bd5586eb9d8484eb74a433ee7bfe499",22850817,4,2,0,2287,445,446,1
"7bd5586eb9d8484eb74a433ee7bfe499","7bd5586eb9d8484eb74a433ee7bfe499",22850817,17,0,1,2288,446,446,0
"7bd5586eb9d8484eb74a433ee7bfe499","b2f0d654738f48158edff28e8d3a546e",22850817,3,7,0,2289,446,449,3
"b2f0d654738f48158edff28e8d3a546e","070600601c4c439288445d2f0724807d",22850817,4,-21,0,2290,449,437,-12
"070600601c4c439288445d2f0724807d","f60ee41ec635499abd48168342d32c2f",22850817,4,26,0,2291,437,453,16
"f60ee41ec635499abd48168342d32c2f","f67fbf45a5f146ed866965bc57c7c001",22850817,5,3,0,2292,453,454,1
"f67fbf45a5f146ed866965bc57c7c001","b2f0d654738f48158edff28e8d3a546e",22850817,6,-8,0,2293,454,449,-5
"b2f0d654738f48158edff28e8d3a546e","f60ee41ec635499abd48168342d32c2f",22850817,15,5,0,2294,449,453,4
"f60ee41ec635499abd48168342d32c2f","b2f0d654738f48158edff28e8d3a546e",22850817,12,-5,0,2295,453,449,-4
"f60ee41ec635499abd48168342d32c2f","f60ee41ec635499abd48168342d32c2f",22850817,117,0,1,2297,453,453,0
"f60ee41ec635499abd48168342d32c2f","9428d8bd9c5a47b2a235b254e5e27ded",22850817,1,-1,0,2312,453,452,-1
"9428d8bd9c5a47b2a235b254e5e27ded","f60ee41ec635499abd48168342d32c2f",22850817,1,1,0,2313,452,453,1
"b2f0d654738f48158edff28e8d3a546e","c5df9f40ec14463b9dcfdc73df3e9285",22850817,2,20,0,2324,449,464,15
"c5df9f40ec14463b9dcfdc73df3e9285","f67fbf45a5f146ed866965bc57c7c001",22850817,2,-12,0,2325,464,454,-10
"f67fbf45a5f146ed866965bc57c7c001","c5df9f40ec14463b9dcfdc73df3e9285",22850817,5,12,0,2326,454,464,10
"c5df9f40ec14463b9dcfdc73df3e9285","c5df9f40ec14463b9dcfdc73df3e9285",22850817,11,0,1,2327,464,464,0
"c5df9f40ec14463b9dcfdc73df3e9285","83d42d95cd844fc093fc09cee250edb8",22850817,8,3,0,2328,464,465,1
"83d42d95cd844fc093fc09cee250edb8","83d42d95cd844fc093fc09cee250edb8",22850817,13,0,1,2329,465,465,0
"83d42d95cd844fc093fc09cee250edb8","66baf19b6b904b70922329068c63746d",22850817,1,-135,0,2331,465,376,-89
"66baf19b6b904b70922329068c63746d","4890121ce5d74576b4632b77cfc23398",22850817,1,14,0,2334,376,388,12
"4890121ce5d74576b4632b77cfc23398","c2fca3669923477ab966ded303dea31c",22850817,1,-6,0,2335,388,383,-5
"4890121ce5d74576b4632b77cfc23398","96bb2b3e85a34d8b9544514e89f6fe97",22850817,1,3,0,2337,388,390,2
"96bb2b3e85a34d8b9544514e89f6fe97","18d3b836dd804224883cc9180b60a8e1",22850817,1,-4,0,2338,390,387,-3
"2b09a08242b54983aec7063990fb3f66","1f471b7a883a4df48211e8c6a81b59a7",22850817,1,1,0,2349,400,401,1
"1f471b7a883a4df48211e8c6a81b59a7","1f471b7a883a4df48211e8c6a81b59a7",22850817,1,0,1,2350,401,401,0
"1f471b7a883a4df48211e8c6a81b59a7","2b09a08242b54983aec7063990fb3f66",22850817,1,-1,0,2351,401,400,-1
"1157bd665ec4472fb58b751dc5099355","3c8a22d2f9c146ea956609e3ed4f2559",22850817,2,3,0,2354,403,405,2
"58fc9094275e4c49be3f4ba6d4acc0a4","58fc9094275e4c49be3f4ba6d4acc0a4",22850817,2,0,1,2356,406,406,0
"58fc9094275e4c49be3f4ba6d4acc0a4","c1c1be90b2b14c1ab4a5e1ee3c241902",22850817,1,1,0,2357,406,407,1
"c1c1be90b2b14c1ab4a5e1ee3c241902","c1c1be90b2b14c1ab4a5e1ee3c241902",22850817,5,0,1,2358,407,407,0
"c1c1be90b2b14c1ab4a5e1ee3c241902","58fc9094275e4c49be3f4ba6d4acc0a4",22850817,1,-1,0,2363,407,406,-1
"02b3a1bead9244c1ba2f857c7da8f82a","6206fc6479014bb193084c32409dc1b9",22850817,1,1,0,2366,408,409,1
"6206fc6479014bb193084c32409dc1b9","6206fc6479014bb193084c32409dc1b9",22850817,1,0,1,2367,409,409,0
"6206fc6479014bb193084c32409dc1b9","02b3a1bead9244c1ba2f857c7da8f82a",22850817,1,-1,0,2368,409,408,-1
"33a9d248b2e44588a5b07fc1342b9bc2","c6f26bd420634f1cb7989e76fe6b16c0",22850817,1,1,0,2378,411,412,1
"c6f26bd420634f1cb7989e76fe6b16c0","c6f26bd420634f1cb7989e76fe6b16c0",22850817,5,0,1,2379,412,412,0
"c6f26bd420634f1cb7989e76fe6b16c0","2a65ee6e2ac64f6a8a55fbe5373ec763",22850817,1,1,0,2384,412,413,1
"2a65ee6e2ac64f6a8a55fbe5373ec763","2a65ee6e2ac64f6a8a55fbe5373ec763",22850817,2,0,1,2385,413,413,0
"2a65ee6e2ac64f6a8a55fbe5373ec763","33a9d248b2e44588a5b07fc1342b9bc2",22850817,1,-2,0,2387,413,411,-2
"bec48fc2e1294c7eb3d0aca780d731b8","dbde19fcce2a4c1abdc7f685c293a23f",22850817,2,3,0,2398,420,422,2
"a24600b0e49245f6bdba8c893cfeddb0","a2b4bd40cee2481ebd3fc179d6a5cd62",22850817,1,-11,0,2402,425,417,-8
"a2b4bd40cee2481ebd3fc179d6a5cd62","24cf8786024543f19b89bc20034e60d7",22850817,3,18,0,2403,417,428,11
"24cf8786024543f19b89bc20034e60d7","f2a73be2f46840b182d7bd095378004e",22850817,1,1,0,2404,428,429,1
"f2a73be2f46840b182d7bd095378004e","604551fd4266430cb860fef58fa7dd61",22850817,1,1,0,2406,429,430,1
"604551fd4266430cb860fef58fa7dd61","604551fd4266430cb860fef58fa7dd61",22850817,9,0,1,2407,430,430,0
"604551fd4266430cb860fef58fa7dd61","24cf8786024543f19b89bc20034e60d7",22850817,1,-2,0,2416,430,428,-2
"dce46f8904594a62a6377a3587aaa663","9b9d0a249052413c869753b99682b0ac",22850817,1,1,0,2419,431,432,1
"9b9d0a249052413c869753b99682b0ac","9b9d0a249052413c869753b99682b0ac",22850817,2,0,1,2420,432,432,0
"9b9d0a249052413c869753b99682b0ac","061c175cc90f45fbad883025394e78dd",22850817,1,1,0,2422,432,433,1
"061c175cc90f45fbad883025394e78dd","061c175cc90f45fbad883025394e78dd",22850817,1,0,1,2423,433,433,0
"061c175cc90f45fbad883025394e78dd","dce46f8904594a62a6377a3587aaa663",22850817,1,-2,0,2424,433,431,-2
"1823b6de7d334a7aaabc4570719af4d9","1823b6de7d334a7aaabc4570719af4d9",22850817,11,0,1,2429,439,439,0
"901e92500aea43c79f19f1b279050668","001339db8ced4cf78829ebe8b145449d",22850817,1,1,0,2449,442,443,1
"001339db8ced4cf78829ebe8b145449d","001339db8ced4cf78829ebe8b145449d",22850817,5,0,1,2450,443,443,0
"001339db8ced4cf78829ebe8b145449d","452745e0366e42ae81561bfddebcc6c3",22850817,1,1,0,2455,443,444,1
"452745e0366e42ae81561bfddebcc6c3","452745e0366e42ae81561bfddebcc6c3",22850817,2,0,1,2456,444,444,0
"452745e0366e42ae81561bfddebcc6c3","4660ff2089114e8db82ceb26a4f329e3",22850817,1,2,0,2458,444,445,1
"b2f0d654738f48158edff28e8d3a546e","f67fbf45a5f146ed866965bc57c7c001",22850817,5,8,0,2488,449,454,5
"83d42d95cd844fc093fc09cee250edb8","c5df9f40ec14463b9dcfdc73df3e9285",22850817,3,-3,0,2499,465,464,-1
"83d42d95cd844fc093fc09cee250edb8","67a089198fcb4e1c8f2385786c2b296f",22850817,3,-583,0,2504,465,39,-426
"b534b89233134e30a9b5645138bfa9ee","b534b89233134e30a9b5645138bfa9ee",22850817,5,0,1,2510,41,41,0
"a1f2f12debe5432fb7a70bcd12bacfb9","bc42d26810654ea9a1df1efe1e58c7d5",22850817,2,6,0,2517,58,63,5
"a0a418b8540d479fa6e0f653b701da8b","12aa6e1672ac4e7aa6449a7a8609cd72",22850817,2,-8,0,2519,64,57,-7
"12aa6e1672ac4e7aa6449a7a8609cd72","309ccf3cc4fe429d9bfbaef53d3fa479",22850817,1,4,0,2520,57,60,3
"b534b89233134e30a9b5645138bfa9ee","d646286c8051419bbc2e31dd1db55ca8",22850817,7,33,0,2524,41,67,26
"d646286c8051419bbc2e31dd1db55ca8","7af822066add4e7f8e007e4eee31a8bf",22850817,1,-4,0,2525,67,65,-2
"7af822066add4e7f8e007e4eee31a8bf","a0a418b8540d479fa6e0f653b701da8b",22850817,1,-2,0,2526,65,64,-1
"a0a418b8540d479fa6e0f653b701da8b","bc42d26810654ea9a1df1efe1e58c7d5",22850817,8,-1,0,2527,64,63,-1
"bc42d26810654ea9a1df1efe1e58c7d5","309ccf3cc4fe429d9bfbaef53d3fa479",22850817,4,-3,0,2528,63,60,-3
"309ccf3cc4fe429d9bfbaef53d3fa479","b534b89233134e30a9b5645138bfa9ee",22850817,6,-23,0,2529,60,41,-19
"d646286c8051419bbc2e31dd1db55ca8","d646286c8051419bbc2e31dd1db55ca8",22850817,3,0,1,2531,67,67,0
"d646286c8051419bbc2e31dd1db55ca8","a2becd407db34b189200a32546d9d569",22850817,5,9,0,2532,67,75,8
"a2becd407db34b189200a32546d9d569","140d5b27b8574befad82c0a013b59dfa",22850817,4,-1,0,2533,75,74,-1
"d18a9ea32855445f8736581f5cb119ce","ae5ac430ea254e708a6f5deaaf7464ae",22850817,2,3,0,2535,82,84,2
"6a9f0ef185fb47f0937e29daa1c71ed5","d646286c8051419bbc2e31dd1db55ca8",22850817,3,-27,0,2539,90,67,-23
"d646286c8051419bbc2e31dd1db55ca8","e20db35ced8544ddac5bc3839145e463",22850817,7,30,0,2540,67,91,24
"e20db35ced8544ddac5bc3839145e463","e20db35ced8544ddac5bc3839145e463",22850817,4,0,1,2541,91,91,0
"e20db35ced8544ddac5bc3839145e463","00ae5f0c51874a73a41ebea838d95682",22850817,6,11,0,2542,91,101,10
"00ae5f0c51874a73a41ebea838d95682","d391c8b6e56a43a7b654e9dee02d904b",22850817,6,2,0,2543,101,103,2
"d391c8b6e56a43a7b654e9dee02d904b","73039f8c1eb9409cb4caee2cf968001e",22850817,2,-3,0,2544,103,100,-3
"73039f8c1eb9409cb4caee2cf968001e","4280927ec4d643238aa49c32f9e06c6c",22850817,3,10,0,2545,100,109,9
"4280927ec4d643238aa49c32f9e06c6c","08111f75e22d409998cf8b85bd431f0a",22850817,2,-1,0,2546,109,108,-1
"a9ae0a3c070d455bb4369a8996313336","62bff51286ef4f348717a3cf6fe2318f",22850817,3,7,0,2548,114,120,6
"62bff51286ef4f348717a3cf6fe2318f","37319e88176d4aefa91d7a9980dbae91",22850817,3,-9,0,2551,120,112,-8
"37319e88176d4aefa91d7a9980dbae91","e20db35ced8544ddac5bc3839145e463",22850817,2,-24,0,2552,112,91,-21
"779f9ddd1fd14d1e9e69f72219a1fdbd","e20db35ced8544ddac5bc3839145e463",22850817,4,-36,0,2554,121,91,-30
"779f9ddd1fd14d1e9e69f72219a1fdbd","62bff51286ef4f348717a3cf6fe2318f",22850817,1,-3,0,2556,121,120,-1
"62bff51286ef4f348717a3cf6fe2318f","b1cd0e7dc3ad4a8eb91a4bfdbeb025b0",22850817,1,-2,0,2557,120,118,-2
"b1cd0e7dc3ad4a8eb91a4bfdbeb025b0","62bff51286ef4f348717a3cf6fe2318f",22850817,1,2,0,2558,118,120,2
"6c5ad271a44743479bfaea29b1db8d02","df1de691dafe4549a18a4398ee9dfaf9",22850817,3,-4,0,2569,143,139,-4
"df1de691dafe4549a18a4398ee9dfaf9","8aae34f5ddbb4052a709b12e6b0d40fa",22850817,4,9,0,2570,139,147,8
"8aae34f5ddbb4052a709b12e6b0d40fa","f902b0f41b544d4dbf79664fd233648d",22850817,3,-1,0,2571,147,146,-1
"f902b0f41b544d4dbf79664fd233648d","d313cec988a84645bee413e8d4724a4b",22850817,2,14,0,2572,146,158,12
"d313cec988a84645bee413e8d4724a4b","f03480cf4eba413194d7af52fc0e7f28",22850817,3,-7,0,2573,158,152,-6
"78adeee1fa2c4fe0bc73f7bca9fcee86","78adeee1fa2c4fe0bc73f7bca9fcee86",22850817,8,0,1,2578,160,160,0
"78adeee1fa2c4fe0bc73f7bca9fcee86","65202579580f4ad38d734b4ee39d22a8",22850817,18,5,0,2579,160,164,4
"65202579580f4ad38d734b4ee39d22a8","65202579580f4ad38d734b4ee39d22a8",22850817,163,0,1,2580,164,164,0
"65202579580f4ad38d734b4ee39d22a8","0c7262dff33c4087bc660ccf40f92f9c",22850817,1,12,0,2587,164,169,5
"b2275c3fad834f8d90737a2d9a6927d6","b42cc17b7de840f181a704558d0bc845",22850817,4,4,0,2590,172,175,3
"b42cc17b7de840f181a704558d0bc845","0c7262dff33c4087bc660ccf40f92f9c",22850817,3,-7,0,2591,175,169,-6
"0c7262dff33c4087bc660ccf40f92f9c","362fcb0699a14845ab29b2340093e528",22850817,2,6,0,2592,169,174,5
"139b097acfca451689d80c9c6eebdf7b","2024b4885bd14338a39b7b509acbbd02",22850817,3,5,0,2596,178,182,4
"ab11d94c6c8948ea90b88f19d2cd502b","6cd2dcaac46847d4a0bc53f296d90375",22850817,4,5,0,2601,190,194,4
"6cd2dcaac46847d4a0bc53f296d90375","07b44a7a51e94c78b411c753fc39dab0",22850817,4,-6,0,2602,194,189,-5
"07b44a7a51e94c78b411c753fc39dab0","017d7ca8e0394b91aaadc9574df2202c",22850817,4,5,0,2603,189,193,4
"f9170dd6bc6442b4acd832747609b09a","d7f13c8d63ec4e2aa673fbb9cf9c6933",22850817,1,10,0,2605,199,206,7
"d7f13c8d63ec4e2aa673fbb9cf9c6933","c8e371568a0c4391b25796ae4e91952e",22850817,2,-26,0,2606,206,186,-20
"c8e371568a0c4391b25796ae4e91952e","b9e80f77c3a44349863b19875725c384",22850817,2,27,0,2607,186,207,21
"09400e101c5d4b439cf9a26b03aae558","be502a7a43c44bf7b682698de79d9369",22850817,3,5,0,2611,210,214,4
"be502a7a43c44bf7b682698de79d9369","a875096404ef4a9984b62d74cda916f9",22850817,1,-6,0,2612,214,209,-5
"f7fb1952f56b4189b86a9f8b7862d2b8","ec341f459285443b8361f7f15638ff08",22850817,2,-2,0,2614,215,213,-2
"01b2051f8941460d89945e3b02d1ce78","d7f13c8d63ec4e2aa673fbb9cf9c6933",22850817,3,-14,0,2617,217,206,-11
"f7906d6f59b9489a91d2ef40db5a474d","5152833676bf4c6cb317060be10f68db",22850817,2,6,0,2625,223,228,5
"00f61990949545828dd12f1303d47504","6e83e23f56544a19b94067c1c558d9c0",22850817,1,-11,0,2632,256,247,-9
"6e83e23f56544a19b94067c1c558d9c0","d546341988904f069cfa86b21457d9d9",22850817,1,5,0,2633,247,251,4
"bb5a47f5ea01454a8b79455422d3b9da","82ae07bc0c9b4570a41799290d1ef399",22850817,2,-6,0,2643,280,275,-5
"6a9a3b5bde4a48daa896fe8c06eca56f","34a6e49023fc4465bd5ca604330bbd1c",22850817,2,4,0,2659,289,292,3
"21592f2a9e9c4b2f8c66ec5dbcbf6a2b","7646a919d7e64fa990bca9b024ff089d",22850817,1,3,0,2662,296,298,2
"53e7e900392747ccad52e711ab0f80d8","7bd5586eb9d8484eb74a433ee7bfe499",22850817,1,198,0,2666,307,446,139
"7bd5586eb9d8484eb74a433ee7bfe499","070600601c4c439288445d2f0724807d",22850817,5,-14,0,2667,446,437,-9
"070600601c4c439288445d2f0724807d","7bd5586eb9d8484eb74a433ee7bfe499",22850817,2,14,0,2668,437,446,9
"070600601c4c439288445d2f0724807d","b2f0d654738f48158edff28e8d3a546e",22850817,3,21,0,2671,437,449,12
"f67fbf45a5f146ed866965bc57c7c001","f67fbf45a5f146ed866965bc57c7c001",22850817,4,0,1,2683,454,454,0
"f67fbf45a5f146ed866965bc57c7c001","d937afe49bd24a07a550dda1c1155122",22850817,1,1,0,2685,454,455,1
"d937afe49bd24a07a550dda1c1155122","d937afe49bd24a07a550dda1c1155122",22850817,1,0,1,2686,455,455,0
"d937afe49bd24a07a550dda1c1155122","3628b3f7823443d0912a339096b69943",22850817,1,1,0,2687,455,456,1
"3628b3f7823443d0912a339096b69943","3628b3f7823443d0912a339096b69943",22850817,1,0,1,2688,456,456,0
"3628b3f7823443d0912a339096b69943","9e049ee647cf43ecbcb5ed792a8e7588",22850817,1,1,0,2689,456,457,1
"9e049ee647cf43ecbcb5ed792a8e7588","9e049ee647cf43ecbcb5ed792a8e7588",22850817,1,0,1,2690,457,457,0
"9e049ee647cf43ecbcb5ed792a8e7588","5256a214faaf410b93f76cea06428334",22850817,1,1,0,2691,457,458,1
"5256a214faaf410b93f76cea06428334","5256a214faaf410b93f76cea06428334",22850817,1,0,1,2692,458,458,0
"5256a214faaf410b93f76cea06428334","25c32b120fce40fa9b6c85133aeb4716",22850817,1,1,0,2693,458,459,1
"25c32b120fce40fa9b6c85133aeb4716","25c32b120fce40fa9b6c85133aeb4716",22850817,2,0,1,2694,459,459,0
"25c32b120fce40fa9b6c85133aeb4716","42de338840a34d15adb66e7b14fb9d2c",22850817,1,2,0,2695,459,461,2
"42de338840a34d15adb66e7b14fb9d2c","42de338840a34d15adb66e7b14fb9d2c",22850817,1,0,1,2696,461,461,0
"42de338840a34d15adb66e7b14fb9d2c","9da37c6210b1416b8079c274f70bf600",22850817,1,1,0,2697,461,462,1
"9da37c6210b1416b8079c274f70bf600","9da37c6210b1416b8079c274f70bf600",22850817,1,0,1,2698,462,462,0
"9da37c6210b1416b8079c274f70bf600","519119f1deac45ff9ab4f13529be5c6e",22850817,1,1,0,2699,462,463,1
"519119f1deac45ff9ab4f13529be5c6e","519119f1deac45ff9ab4f13529be5c6e",22850817,1,0,1,2700,463,463,0
"519119f1deac45ff9ab4f13529be5c6e","3434c10e561d488a914e0f7d71907abd",22850817,1,-224,0,2701,463,305,-158
"53e7e900392747ccad52e711ab0f80d8","130acc2aeb0448fdbb2de63bc5cebe5b",22850817,1,3,0,2704,307,309,2
"130acc2aeb0448fdbb2de63bc5cebe5b","3434c10e561d488a914e0f7d71907abd",22850817,1,-5,0,2705,309,305,-4
"3434c10e561d488a914e0f7d71907abd","11bc14f2204949008b7d511b933363c1",22850817,1,221,0,2706,305,460,155
"11bc14f2204949008b7d511b933363c1","11bc14f2204949008b7d511b933363c1",22850817,2,0,1,2707,460,460,0
"11bc14f2204949008b7d511b933363c1","ea859f8207e44537889daeaba13ac2e8",22850817,1,-213,0,2708,460,312,-148
"56d94971a7a94257aa330183a8ebd0ea","f67fbf45a5f146ed866965bc57c7c001",22850817,1,206,0,2711,313,454,141
"f67fbf45a5f146ed866965bc57c7c001","7bd5586eb9d8484eb74a433ee7bfe499",22850817,1,-15,0,2712,454,446,-8
"f60ee41ec635499abd48168342d32c2f","66baf19b6b904b70922329068c63746d",22850817,1,-117,0,2727,453,376,-77
"96bb2b3e85a34d8b9544514e89f6fe97","66baf19b6b904b70922329068c63746d",22850817,1,-17,0,2736,390,376,-14
"66baf19b6b904b70922329068c63746d","17f95d18bab743888e1736033dc3384d",22850817,1,16,0,2740,376,389,13
"17f95d18bab743888e1736033dc3384d","96bb2b3e85a34d8b9544514e89f6fe97",22850817,1,1,0,2741,389,390,1
"96bb2b3e85a34d8b9544514e89f6fe97","ac4e9b54acfe4670b4634859c7263cb5",22850817,1,2,0,2742,390,392,2
"ac4e9b54acfe4670b4634859c7263cb5","ac4e9b54acfe4670b4634859c7263cb5",22850817,1,0,1,2743,392,392,0
"ac4e9b54acfe4670b4634859c7263cb5","17f95d18bab743888e1736033dc3384d",22850817,1,-3,0,2744,392,389,-3
"3c8a22d2f9c146ea956609e3ed4f2559","02b3a1bead9244c1ba2f857c7da8f82a",22850817,1,5,0,2755,405,408,3
"a2b4bd40cee2481ebd3fc179d6a5cd62","a24600b0e49245f6bdba8c893cfeddb0",22850817,1,11,0,2767,417,425,8
"a24600b0e49245f6bdba8c893cfeddb0","bec48fc2e1294c7eb3d0aca780d731b8",22850817,1,-7,0,2768,425,420,-5
"f2a73be2f46840b182d7bd095378004e","24cf8786024543f19b89bc20034e60d7",22850817,3,-1,0,2774,429,428,-1
"0380cd76a7d44bc3a4da1f15e4d68f89","1823b6de7d334a7aaabc4570719af4d9",22850817,1,-2,0,2781,440,439,-1
"070600601c4c439288445d2f0724807d","23b7673c8b5443108c2ef09382834a86",22850817,1,6,0,2783,437,441,4
"23b7673c8b5443108c2ef09382834a86","0380cd76a7d44bc3a4da1f15e4d68f89",22850817,1,-2,0,2784,441,440,-1
"f67fbf45a5f146ed866965bc57c7c001","25c32b120fce40fa9b6c85133aeb4716",22850817,1,5,0,2805,454,459,5
"25c32b120fce40fa9b6c85133aeb4716","11bc14f2204949008b7d511b933363c1",22850817,1,1,0,2807,459,460,1
"11bc14f2204949008b7d511b933363c1","d646286c8051419bbc2e31dd1db55ca8",22850817,1,-537,0,2809,460,67,-393
"140d5b27b8574befad82c0a013b59dfa","a2becd407db34b189200a32546d9d569",22850817,1,1,0,2811,74,75,1
"d391c8b6e56a43a7b654e9dee02d904b","66baf19b6b904b70922329068c63746d",22850817,1,368,0,2823,103,376,273
"66baf19b6b904b70922329068c63746d","859e0b8d71694b12befb69ee698138f9",22850817,1,29,0,2824,376,399,23
"859e0b8d71694b12befb69ee698138f9","859e0b8d71694b12befb69ee698138f9",22850817,1,0,1,2825,399,399,0
"859e0b8d71694b12befb69ee698138f9","66baf19b6b904b70922329068c63746d",22850817,1,-29,0,2826,399,376,-23
"2b09a08242b54983aec7063990fb3f66","2add1669f08d4101913db15f8c23b3b7",22850817,1,24,0,2830,400,416,16
"2add1669f08d4101913db15f8c23b3b7","2add1669f08d4101913db15f8c23b3b7",22850817,1,0,1,2831,416,416,0
"2add1669f08d4101913db15f8c23b3b7","24cf8786024543f19b89bc20034e60d7",22850817,1,21,0,2832,416,428,12
"24cf8786024543f19b89bc20034e60d7","bf12c96466d840a69bed7020b3f18bb8",22850817,1,11,0,2833,428,436,8
"bf12c96466d840a69bed7020b3f18bb8","bf12c96466d840a69bed7020b3f18bb8",22850817,1,0,1,2834,436,436,0
"bf12c96466d840a69bed7020b3f18bb8","070600601c4c439288445d2f0724807d",22850817,1,3,0,2835,436,437,1
"070600601c4c439288445d2f0724807d","8a7f26e690f34dda97be16904518ca99",22850817,1,16,0,2836,437,447,10
"8a7f26e690f34dda97be16904518ca99","8a7f26e690f34dda97be16904518ca99",22850817,1,0,1,2837,447,447,0
"8a7f26e690f34dda97be16904518ca99","66baf19b6b904b70922329068c63746d",22850817,1,-107,0,2838,447,376,-71
"66baf19b6b904b70922329068c63746d","24cf8786024543f19b89bc20034e60d7",22850817,1,77,0,2839,376,428,52
"24cf8786024543f19b89bc20034e60d7","66baf19b6b904b70922329068c63746d",22850817,1,-77,0,2840,428,376,-52
"24cf8786024543f19b89bc20034e60d7","74a7f8712e5449c2bc0b43c6f90dafed",22850817,1,9,0,2844,428,435,7
"74a7f8712e5449c2bc0b43c6f90dafed","74a7f8712e5449c2bc0b43c6f90dafed",22850817,1,0,1,2845,435,435,0
"74a7f8712e5449c2bc0b43c6f90dafed","e34e59dce2204f228f3a84b6725df60f",22850817,1,-25,0,2846,435,419,-16
"e34e59dce2204f228f3a84b6725df60f","e34e59dce2204f228f3a84b6725df60f",22850817,1,0,1,2847,419,419,0
"e34e59dce2204f228f3a84b6725df60f","1fd0f6dadbc14ebc965faf6122190b96",22850817,1,-7,0,2848,419,415,-4
"1fd0f6dadbc14ebc965faf6122190b96","1fd0f6dadbc14ebc965faf6122190b96",22850817,1,0,1,2849,415,415,0
"1fd0f6dadbc14ebc965faf6122190b96","44a277ea44dc4ae689fab4b82f0b4098",22850817,1,-28,0,2850,415,397,-18
"44a277ea44dc4ae689fab4b82f0b4098","44a277ea44dc4ae689fab4b82f0b4098",22850817,1,0,1,2851,397,397,0
"44a277ea44dc4ae689fab4b82f0b4098","2b09a08242b54983aec7063990fb3f66",22850817,1,6,0,2852,397,400,3
"2b09a08242b54983aec7063990fb3f66","9de0d567bfa84fe5b77cb76f4a76a5d1",22850817,1,5,0,2853,400,404,4
"9de0d567bfa84fe5b77cb76f4a76a5d1","9de0d567bfa84fe5b77cb76f4a76a5d1",22850817,1,0,1,2854,404,404,0
"9de0d567bfa84fe5b77cb76f4a76a5d1","f67fbf45a5f146ed866965bc57c7c001",22850817,1,83,0,2855,404,454,50
"b2f0d654738f48158edff28e8d3a546e","b2f0d654738f48158edff28e8d3a546e",22850817,2,0,1,2858,449,449,0
"83d42d95cd844fc093fc09cee250edb8","9428d8bd9c5a47b2a235b254e5e27ded",22850817,1,-19,0,2925,465,452,-13
"9428d8bd9c5a47b2a235b254e5e27ded","b2f0d654738f48158edff28e8d3a546e",22850817,1,-4,0,2926,452,449,-3
"f60ee41ec635499abd48168342d32c2f","1b4550d0dab04078b3bf08a655345bdc",22850817,1,-125,0,2937,453,373,-80
"8d448d625b024c82a5eb240bbd7431d6","3cbcea2be0984e7dbd5a48195af10ce7",22850817,1,-281,0,2947,374,165,-209
"3cbcea2be0984e7dbd5a48195af10ce7","3cbcea2be0984e7dbd5a48195af10ce7",22850817,4,0,1,2948,165,165,0
"3cbcea2be0984e7dbd5a48195af10ce7","82e6285962b8400d9d6fc32436022a94",22850817,9,2,0,2949,165,167,2
"82e6285962b8400d9d6fc32436022a94","d6d02b6ef04e4f17805504500b8ce441",22850817,1,282,0,2950,167,375,208
"d6d02b6ef04e4f17805504500b8ce441","b7719e26494940efa49512aedd0aac79",22850817,1,-484,0,2953,375,20,-355
"b7719e26494940efa49512aedd0aac79","d4f45188d3c84a02ba08454e6403a818",22850817,1,5,0,2954,20,24,4
"d4c3b003e8274e429d2fa688d73fde6d","5bc03c8f16354d04bd51f5bb93559ad3",22850817,1,4,0,2960,22,26,4
"5bc03c8f16354d04bd51f5bb93559ad3","b7719e26494940efa49512aedd0aac79",22850817,1,-7,0,2961,26,20,-6
"b7719e26494940efa49512aedd0aac79","d6d02b6ef04e4f17805504500b8ce441",22850817,1,484,0,2962,20,375,355
"d6d02b6ef04e4f17805504500b8ce441","c5df9f40ec14463b9dcfdc73df3e9285",22850817,1,136,0,2966,375,464,89
"c5df9f40ec14463b9dcfdc73df3e9285","67a089198fcb4e1c8f2385786c2b296f",22850817,1,-580,0,2969,464,39,-425
"d9c8d8c444a64dadbbb508652c721e17","35adfa5d923046aebabfefd98f35ff05",22850817,1,9,0,2978,46,54,8
"35adfa5d923046aebabfefd98f35ff05","f924752d8a1149668870b1e7698486f7",22850817,1,-4,0,2984,54,50,-4
"a1f2f12debe5432fb7a70bcd12bacfb9","78f30e4dcac84e3cbea8b2cc6e0d62b3",22850817,6,1,0,2986,58,59,1
"78f30e4dcac84e3cbea8b2cc6e0d62b3","bc42d26810654ea9a1df1efe1e58c7d5",22850817,2,5,0,2987,59,63,4
"bc42d26810654ea9a1df1efe1e58c7d5","12aa6e1672ac4e7aa6449a7a8609cd72",22850817,2,-7,0,2988,63,57,-6
"12aa6e1672ac4e7aa6449a7a8609cd72","a0a418b8540d479fa6e0f653b701da8b",22850817,3,8,0,2989,57,64,7
"b534b89233134e30a9b5645138bfa9ee","f03480cf4eba413194d7af52fc0e7f28",22850817,1,137,0,2993,41,152,111
"f03480cf4eba413194d7af52fc0e7f28","df1de691dafe4549a18a4398ee9dfaf9",22850817,3,-15,0,2994,152,139,-13
"df1de691dafe4549a18a4398ee9dfaf9","779f9ddd1fd14d1e9e69f72219a1fdbd",22850817,4,-23,0,2995,139,121,-18
"e20db35ced8544ddac5bc3839145e463","a9ae0a3c070d455bb4369a8996313336",22850817,2,26,0,2997,91,114,23
"a9ae0a3c070d455bb4369a8996313336","d646286c8051419bbc2e31dd1db55ca8",22850817,1,-56,0,2998,114,67,-47
"b534b89233134e30a9b5645138bfa9ee","a1f2f12debe5432fb7a70bcd12bacfb9",22850817,2,20,0,3000,41,58,17
"78f30e4dcac84e3cbea8b2cc6e0d62b3","78f30e4dcac84e3cbea8b2cc6e0d62b3",22850817,17,0,1,3002,59,59,0
"78f30e4dcac84e3cbea8b2cc6e0d62b3","12aa6e1672ac4e7aa6449a7a8609cd72",22850817,2,-2,0,3004,59,57,-2
"bc42d26810654ea9a1df1efe1e58c7d5","bc42d26810654ea9a1df1efe1e58c7d5",22850817,6,0,1,3008,63,63,0
"a0a418b8540d479fa6e0f653b701da8b","a0a418b8540d479fa6e0f653b701da8b",22850817,8,0,1,3012,64,64,0
"ae5ac430ea254e708a6f5deaaf7464ae","d646286c8051419bbc2e31dd1db55ca8",22850817,1,-20,0,3028,84,67,-17
"b416d47c56a742199b5d7c7f19d6503a","df1de691dafe4549a18a4398ee9dfaf9",22850817,3,8,0,3047,134,139,5
"779f9ddd1fd14d1e9e69f72219a1fdbd","6c5ad271a44743479bfaea29b1db8d02",22850817,3,27,0,3049,121,143,22
"d313cec988a84645bee413e8d4724a4b","78adeee1fa2c4fe0bc73f7bca9fcee86",22850817,4,4,0,3057,158,160,2
"78adeee1fa2c4fe0bc73f7bca9fcee86","df1de691dafe4549a18a4398ee9dfaf9",22850817,3,-26,0,3058,160,139,-21
"df1de691dafe4549a18a4398ee9dfaf9","65202579580f4ad38d734b4ee39d22a8",22850817,2,31,0,3059,139,164,25
"65202579580f4ad38d734b4ee39d22a8","78adeee1fa2c4fe0bc73f7bca9fcee86",22850817,16,-5,0,3067,164,160,-4
"78adeee1fa2c4fe0bc73f7bca9fcee86","3cbcea2be0984e7dbd5a48195af10ce7",22850817,5,8,0,3068,160,165,5
"3cbcea2be0984e7dbd5a48195af10ce7","78adeee1fa2c4fe0bc73f7bca9fcee86",22850817,4,-8,0,3069,165,160,-5
"78adeee1fa2c4fe0bc73f7bca9fcee86","82e6285962b8400d9d6fc32436022a94",22850817,2,10,0,3070,160,167,7
"82e6285962b8400d9d6fc32436022a94","3cbcea2be0984e7dbd5a48195af10ce7",22850817,6,-2,0,3071,167,165,-2
"3cbcea2be0984e7dbd5a48195af10ce7","a9ac840f098c4bd0a2ee896214ce29cd",22850817,4,5,0,3072,165,168,3
"a9ac840f098c4bd0a2ee896214ce29cd","0c7262dff33c4087bc660ccf40f92f9c",22850817,2,4,0,3073,168,169,1
"0c7262dff33c4087bc660ccf40f92f9c","a9ac840f098c4bd0a2ee896214ce29cd",22850817,2,-4,0,3074,169,168,-1
"a9ac840f098c4bd0a2ee896214ce29cd","b2275c3fad834f8d90737a2d9a6927d6",22850817,2,7,0,3075,168,172,4
"0c4079457ede49e3aeb5e86ed84bdf35","09b9678ddc3d452ea4a3d46e15826065",22850817,1,29,0,3123,329,353,24
"09b9678ddc3d452ea4a3d46e15826065","c20993c944444fe085345591a8bd837e",22850817,1,-2,0,3129,353,351,-2
"897b7f51242c44aab2205c72fdcbf4cd","30ead9794d4847abaf222ca966cc8630",22850817,1,-4,0,3135,352,348,-4
"b71bac264efb4abd97015447bd490db6","30ead9794d4847abaf222ca966cc8630",22850817,2,-28,0,3137,370,348,-22
"30ead9794d4847abaf222ca966cc8630","8d448d625b024c82a5eb240bbd7431d6",22850817,2,33,0,3138,348,374,26
"8d448d625b024c82a5eb240bbd7431d6","d6d02b6ef04e4f17805504500b8ce441",22850817,2,3,0,3147,374,375,1
"24cf8786024543f19b89bc20034e60d7","24cf8786024543f19b89bc20034e60d7",22850817,1,0,1,3165,428,428,0
"070600601c4c439288445d2f0724807d","070600601c4c439288445d2f0724807d",22850817,1,0,1,3167,437,437,0
"1823b6de7d334a7aaabc4570719af4d9","b2f0d654738f48158edff28e8d3a546e",22850817,1,19,0,3169,439,449,10
"ae5ac430ea254e708a6f5deaaf7464ae","e20db35ced8544ddac5bc3839145e463",22850817,1,10,0,3218,84,91,7
"4280927ec4d643238aa49c32f9e06c6c","e20db35ced8544ddac5bc3839145e463",22850817,1,-20,0,3226,109,91,-18
"e20db35ced8544ddac5bc3839145e463","08111f75e22d409998cf8b85bd431f0a",22850817,1,19,0,3227,91,108,17
"37319e88176d4aefa91d7a9980dbae91","779f9ddd1fd14d1e9e69f72219a1fdbd",22850817,2,12,0,3233,112,121,9
"e20db35ced8544ddac5bc3839145e463","a8dd5213034441ac92724b4e83eb0bb2",22850817,1,45,0,3235,91,129,38
"a9ac840f098c4bd0a2ee896214ce29cd","3cbcea2be0984e7dbd5a48195af10ce7",22850817,3,-5,0,3265,168,165,-3
"a9ac840f098c4bd0a2ee896214ce29cd","a9ac840f098c4bd0a2ee896214ce29cd",22850817,3,0,1,3270,168,168,0
"a9ac840f098c4bd0a2ee896214ce29cd","fab84b4fab5940efb4ea868ef8d09396",22850817,1,157,0,3271,168,284,116
"fab84b4fab5940efb4ea868ef8d09396","3cbcea2be0984e7dbd5a48195af10ce7",22850817,1,-162,0,3272,284,165,-119
"82e6285962b8400d9d6fc32436022a94","0c7262dff33c4087bc660ccf40f92f9c",22850817,1,7,0,3275,167,169,2
"2024b4885bd14338a39b7b509acbbd02","c8e371568a0c4391b25796ae4e91952e",22850817,1,7,0,3285,182,186,4
"c8e371568a0c4391b25796ae4e91952e","0c7262dff33c4087bc660ccf40f92f9c",22850817,1,-23,0,3286,186,169,-17
"b54257a550b94ebc9538f3a90eee9d7e","ab11d94c6c8948ea90b88f19d2cd502b",22850817,1,-17,0,3297,204,190,-14
"c8e371568a0c4391b25796ae4e91952e","6cd2dcaac46847d4a0bc53f296d90375",22850817,2,10,0,3299,186,194,8
"b54257a550b94ebc9538f3a90eee9d7e","f9170dd6bc6442b4acd832747609b09a",22850817,1,-6,0,3304,204,199,-5
"f9170dd6bc6442b4acd832747609b09a","ab11d94c6c8948ea90b88f19d2cd502b",22850817,1,-11,0,3305,199,190,-9
"d7f13c8d63ec4e2aa673fbb9cf9c6933","7108f0e4c2584f1f9c471689ae4c885c",22850817,1,2,0,3313,206,208,2
"b9e80f77c3a44349863b19875725c384","d7f13c8d63ec4e2aa673fbb9cf9c6933",22850817,1,-1,0,3315,207,206,-1
"0b04c8e2f86d48c7aeb7e225819cd32b","0c7262dff33c4087bc660ccf40f92f9c",22850817,1,-86,0,3333,234,169,-65
"0c7262dff33c4087bc660ccf40f92f9c","ea38cc0e6e6e41edbabf210220808bf9",22850817,1,12,0,3340,169,179,10
"ea38cc0e6e6e41edbabf210220808bf9","362fcb0699a14845ab29b2340093e528",22850817,1,-6,0,3341,179,174,-5
"362fcb0699a14845ab29b2340093e528","b87c552dd247427abe6ab5795b9c9d43",22850817,1,8,0,3342,174,181,7
"77ecef8eff6b4a2caea7707669bf7475","8b9ae98743bd4d4a8a87dff1c1244211",22850817,1,6,0,3368,222,227,5
"8b9ae98743bd4d4a8a87dff1c1244211","1c6721b1f63f4d30ba7746ea8af02a52",22850817,1,-7,0,3369,227,221,-6
"bb5a47f5ea01454a8b79455422d3b9da","0d987bed3ffa4ed0b9a2e62e97b7b30f",22850817,1,-10,0,3396,280,272,-8
"0d987bed3ffa4ed0b9a2e62e97b7b30f","94cecc3f1e7d484b8e068e79241dfd73",22850817,1,13,0,3397,272,281,9
"34a6e49023fc4465bd5ca604330bbd1c","21592f2a9e9c4b2f8c66ec5dbcbf6a2b",22850817,1,5,0,3408,292,296,4
"7646a919d7e64fa990bca9b024ff089d","4a29443515bb404cb8924e1c60a63b73",22850817,1,-17,0,3411,298,285,-13
"141c0df6cd1946539aadd1c9b7068cd4","0c787d16c9504873b1a4d903cec09948",22850817,1,7,0,3417,308,314,6
"b8b9418ab322418d9db9b40d96af873a","c2490bc612d146edbe786556fab3651b",22850817,1,4,0,3429,337,340,3
"897b7f51242c44aab2205c72fdcbf4cd","2fe14166dc9642c3bc666b86a57f943d",22850817,1,6,0,3444,352,357,5
"2fe14166dc9642c3bc666b86a57f943d","30ead9794d4847abaf222ca966cc8630",22850817,1,-10,0,3445,357,348,-9
"30ead9794d4847abaf222ca966cc8630","52580888dadb4fe3baa795683ea227bd",22850817,1,18,0,3446,348,364,16
"52580888dadb4fe3baa795683ea227bd","1ba8fef685d74a8194b9db252eb704fb",22850817,1,-10,0,3447,364,355,-9
"1ba8fef685d74a8194b9db252eb704fb","f00179e251a045b39c3f7a54f9aa4acc",22850817,1,9,0,3448,355,363,8
"072a190fd302456290895f9f04d6940a","b71bac264efb4abd97015447bd490db6",22850817,1,8,0,3451,365,370,5
"0c12af0a4e7f4002852cf84b2537c161","2b09a08242b54983aec7063990fb3f66",22850817,1,8,0,3477,395,400,5
"2b09a08242b54983aec7063990fb3f66","66baf19b6b904b70922329068c63746d",22850817,1,-32,0,3478,400,376,-24
"901e92500aea43c79f19f1b279050668","7bd5586eb9d8484eb74a433ee7bfe499",22850817,1,6,0,3519,442,446,4
"7bd5586eb9d8484eb74a433ee7bfe499","4660ff2089114e8db82ceb26a4f329e3",22850817,1,-2,0,3520,446,445,-1
"a8dd5213034441ac92724b4e83eb0bb2","579338175e0b4bbb8ef3b712b5d8b54e",22850817,2,-1,0,3589,129,128,-1
"82e6285962b8400d9d6fc32436022a94","a9ac840f098c4bd0a2ee896214ce29cd",22850817,1,3,0,3615,167,168,1
"3cbcea2be0984e7dbd5a48195af10ce7","b534b89233134e30a9b5645138bfa9ee",22850817,1,-156,0,3617,165,41,-124
"b534b89233134e30a9b5645138bfa9ee","bc42d26810654ea9a1df1efe1e58c7d5",22850817,2,26,0,3618,41,63,22
"b613861cecf84ffcab01afb23f660475","b613861cecf84ffcab01afb23f660475",22851593,5,0,1,1,1,1,0
"e2911e79efc2420eac45d9f671463d4b","b613861cecf84ffcab01afb23f660475",22851593,1,-3,0,5,2,1,-1
"519d1b8c59404d67b54e96c5c8a830b2","519d1b8c59404d67b54e96c5c8a830b2",22851593,2,0,1,10,3,3,0
"519d1b8c59404d67b54e96c5c8a830b2","531db53f81f646edb0cdcfe0085b03b7",22851593,2,1,0,12,3,4,1
"531db53f81f646edb0cdcfe0085b03b7","531db53f81f646edb0cdcfe0085b03b7",22851593,2,0,1,13,4,4,0
"531db53f81f646edb0cdcfe0085b03b7","4f5f94b2f95141e0a9d53a61da2276da",22851593,2,1,0,15,4,5,1
"4f5f94b2f95141e0a9d53a61da2276da","4f5f94b2f95141e0a9d53a61da2276da",22851593,1,0,1,16,5,5,0
"4f5f94b2f95141e0a9d53a61da2276da","6d541c89590949f99af293c4f2333f67",22851593,2,1,0,17,5,6,1
"6d541c89590949f99af293c4f2333f67","6d541c89590949f99af293c4f2333f67",22851593,1,0,1,18,6,6,0
"6d541c89590949f99af293c4f2333f67","dd5cf0b9fe4c4f1d8f5ff8e4c04879cb",22851593,2,1,0,19,6,7,1
"dd5cf0b9fe4c4f1d8f5ff8e4c04879cb","dd5cf0b9fe4c4f1d8f5ff8e4c04879cb",22851593,3,0,1,20,7,7,0
"f96261861edc426abe2248be4f0a709a","f96261861edc426abe2248be4f0a709a",22851593,3,0,1,23,8,8,0
"66b5e16f4f75454fb5b8172079f0fa83","66b5e16f4f75454fb5b8172079f0fa83",22851593,2,0,1,26,9,9,0
"66b5e16f4f75454fb5b8172079f0fa83","9112f2bffece48e08c6d2287be204085",22851593,1,2,0,28,9,11,2
"9112f2bffece48e08c6d2287be204085","9112f2bffece48e08c6d2287be204085",22851593,4,0,1,29,11,11,0
"9112f2bffece48e08c6d2287be204085","dd5cf0b9fe4c4f1d8f5ff8e4c04879cb",22851593,1,-4,0,33,11,7,-4
"f96261861edc426abe2248be4f0a709a","6d541c89590949f99af293c4f2333f67",22851593,1,-2,0,37,8,6,-2
"6d541c89590949f99af293c4f2333f67","0680571d4698477995e41842c36a54b2",22851593,1,4,0,38,6,10,4
"0680571d4698477995e41842c36a54b2","0680571d4698477995e41842c36a54b2",22851593,4,0,1,39,10,10,0
"0680571d4698477995e41842c36a54b2","56586aa865414f538729c7f7735d2bc6",22851593,1,4,0,43,10,12,2
"56586aa865414f538729c7f7735d2bc6","e2911e79efc2420eac45d9f671463d4b",22851593,3,-12,0,44,12,2,-10
"b7f2b31585d94eb3bf86376714aa7070","b7f2b31585d94eb3bf86376714aa7070",22851593,2,0,1,71,13,13,0
"3f1c815879794b929260d224becaff7e","56586aa865414f538729c7f7735d2bc6",22851593,1,-4,0,74,14,12,-2
"56586aa865414f538729c7f7735d2bc6","81c864a886d54a6b8ff85f7d736f4f95",22851593,1,6,0,77,12,15,3
"81c864a886d54a6b8ff85f7d736f4f95","5c5ceeee4562457ba6d41515aeebfbb1",22851593,1,4,0,78,15,17,2
"5c5ceeee4562457ba6d41515aeebfbb1","5c5ceeee4562457ba6d41515aeebfbb1",22851593,1,0,1,79,17,17,0
"b7719e26494940efa49512aedd0aac79","9afd71a5298d4333b6849dfce1b9422c",22851593,2,-4,0,84,20,18,-2
"9afd71a5298d4333b6849dfce1b9422c","d4f45188d3c84a02ba08454e6403a818",22851593,1,9,0,85,18,24,6
"d4c3b003e8274e429d2fa688d73fde6d","9afd71a5298d4333b6849dfce1b9422c",22851593,1,-7,0,92,22,18,-4
"d4c3b003e8274e429d2fa688d73fde6d","d4c3b003e8274e429d2fa688d73fde6d",22851593,8,0,1,100,22,22,0
"d4c3b003e8274e429d2fa688d73fde6d","b7719e26494940efa49512aedd0aac79",22851593,3,-3,0,103,22,20,-2
"b7719e26494940efa49512aedd0aac79","afbf7250b99d47bea07172749483ca97",22851593,5,12,0,104,20,28,8
"afbf7250b99d47bea07172749483ca97","b7719e26494940efa49512aedd0aac79",22851593,3,-12,0,105,28,20,-8
"afbf7250b99d47bea07172749483ca97","4e51676dc72045d99c19b9fa7b22f8bc",22851593,3,3,0,107,28,29,1
"4e51676dc72045d99c19b9fa7b22f8bc","4e51676dc72045d99c19b9fa7b22f8bc",22851593,1,0,1,108,29,29,0
"4e51676dc72045d99c19b9fa7b22f8bc","51970cfa30e643e894e66ae85c8024cc",22851593,3,3,0,109,29,31,2
"51970cfa30e643e894e66ae85c8024cc","4e51676dc72045d99c19b9fa7b22f8bc",22851593,3,-3,0,110,31,29,-2
"4e51676dc72045d99c19b9fa7b22f8bc","c33c17be71ae4d588da7369472e5bb1b",22851593,2,9,0,111,29,34,5
"c33c17be71ae4d588da7369472e5bb1b","93679be414554a11b1893002f2229a93",22851593,4,3,0,112,34,35,1
"93679be414554a11b1893002f2229a93","c33c17be71ae4d588da7369472e5bb1b",22851593,2,-3,0,113,35,34,-1
"93679be414554a11b1893002f2229a93","7040a13096d746ac84b8fac8d9752058",22851593,2,3,0,115,35,36,1
"7040a13096d746ac84b8fac8d9752058","9a0dc646f934470daf08c4b56ccf73db",22851593,2,3,0,116,36,37,1
"9a0dc646f934470daf08c4b56ccf73db","7040a13096d746ac84b8fac8d9752058",22851593,2,-3,0,117,37,36,-1
"9a0dc646f934470daf08c4b56ccf73db","fc0e049d56024bc9a02c9a9c435c3df7",22851593,1,3,0,119,37,38,1
"fc0e049d56024bc9a02c9a9c435c3df7","67a089198fcb4e1c8f2385786c2b296f",22851593,2,4,0,120,38,39,1
"67a089198fcb4e1c8f2385786c2b296f","fc0e049d56024bc9a02c9a9c435c3df7",22851593,3,-4,0,121,39,38,-1
"fc0e049d56024bc9a02c9a9c435c3df7","64d48c6c9c7940639a932219a6c87198",22851593,2,5,0,122,38,40,2
"64d48c6c9c7940639a932219a6c87198","67a089198fcb4e1c8f2385786c2b296f",22851593,7,-1,0,123,40,39,-1
"67a089198fcb4e1c8f2385786c2b296f","64d48c6c9c7940639a932219a6c87198",22851593,5,1,0,124,39,40,1
"fc0e049d56024bc9a02c9a9c435c3df7","fc0e049d56024bc9a02c9a9c435c3df7",22851593,1,0,1,127,38,38,0
"67a089198fcb4e1c8f2385786c2b296f","67a089198fcb4e1c8f2385786c2b296f",22851593,5,0,1,131,39,39,0
"64d48c6c9c7940639a932219a6c87198","64d48c6c9c7940639a932219a6c87198",22851593,3,0,1,133,40,40,0
"67a089198fcb4e1c8f2385786c2b296f","9afd71a5298d4333b6849dfce1b9422c",22851593,1,-44,0,136,39,18,-21
"9afd71a5298d4333b6849dfce1b9422c","67a089198fcb4e1c8f2385786c2b296f",22851593,1,44,0,137,18,39,21
"67a089198fcb4e1c8f2385786c2b296f","b534b89233134e30a9b5645138bfa9ee",22851593,4,4,0,139,39,41,2
"b534b89233134e30a9b5645138bfa9ee","b534b89233134e30a9b5645138bfa9ee",22851593,3,0,1,140,41,41,0
"b534b89233134e30a9b5645138bfa9ee","a1f2f12debe5432fb7a70bcd12bacfb9",22851593,1,20,0,141,41,58,17
"a1f2f12debe5432fb7a70bcd12bacfb9","78f30e4dcac84e3cbea8b2cc6e0d62b3",22851593,5,1,0,142,58,59,1
"78f30e4dcac84e3cbea8b2cc6e0d62b3","b534b89233134e30a9b5645138bfa9ee",22851593,1,-21,0,143,59,41,-18
"b534b89233134e30a9b5645138bfa9ee","bc42d26810654ea9a1df1efe1e58c7d5",22851593,1,26,0,144,41,63,22
"bc42d26810654ea9a1df1efe1e58c7d5","a0a418b8540d479fa6e0f653b701da8b",22851593,3,1,0,145,63,64,1
"a0a418b8540d479fa6e0f653b701da8b","12aa6e1672ac4e7aa6449a7a8609cd72",22851593,2,-8,0,146,64,57,-7
"12aa6e1672ac4e7aa6449a7a8609cd72","309ccf3cc4fe429d9bfbaef53d3fa479",22851593,2,4,0,147,57,60,3
"309ccf3cc4fe429d9bfbaef53d3fa479","d646286c8051419bbc2e31dd1db55ca8",22851593,3,10,0,148,60,67,7
"d646286c8051419bbc2e31dd1db55ca8","b534b89233134e30a9b5645138bfa9ee",22851593,5,-33,0,149,67,41,-26
"b534b89233134e30a9b5645138bfa9ee","d646286c8051419bbc2e31dd1db55ca8",22851593,3,33,0,150,41,67,26
"d646286c8051419bbc2e31dd1db55ca8","d18a9ea32855445f8736581f5cb119ce",22851593,1,17,0,155,67,82,15
"d18a9ea32855445f8736581f5cb119ce","6a9f0ef185fb47f0937e29daa1c71ed5",22851593,2,10,0,156,82,90,8
"6a9f0ef185fb47f0937e29daa1c71ed5","ae5ac430ea254e708a6f5deaaf7464ae",22851593,2,-7,0,157,90,84,-6
"ae5ac430ea254e708a6f5deaaf7464ae","d646286c8051419bbc2e31dd1db55ca8",22851593,1,-20,0,158,84,67,-17
"d646286c8051419bbc2e31dd1db55ca8","e20db35ced8544ddac5bc3839145e463",22851593,1,30,0,159,67,91,24
"e20db35ced8544ddac5bc3839145e463","e20db35ced8544ddac5bc3839145e463",22851593,1,0,1,160,91,91,0
"e20db35ced8544ddac5bc3839145e463","d391c8b6e56a43a7b654e9dee02d904b",22851593,2,13,0,161,91,103,12
"d391c8b6e56a43a7b654e9dee02d904b","e20db35ced8544ddac5bc3839145e463",22851593,1,-13,0,162,103,91,-12
"e20db35ced8544ddac5bc3839145e463","73039f8c1eb9409cb4caee2cf968001e",22851593,1,10,0,163,91,100,9
"73039f8c1eb9409cb4caee2cf968001e","08111f75e22d409998cf8b85bd431f0a",22851593,3,9,0,164,100,108,8
"08111f75e22d409998cf8b85bd431f0a","62bff51286ef4f348717a3cf6fe2318f",22851593,1,14,0,165,108,120,12
"62bff51286ef4f348717a3cf6fe2318f","37319e88176d4aefa91d7a9980dbae91",22851593,3,-9,0,166,120,112,-8
"37319e88176d4aefa91d7a9980dbae91","3ec3a3563847406fa73338f9e9999cf3",22851593,1,6,0,167,112,117,5
"3ec3a3563847406fa73338f9e9999cf3","37319e88176d4aefa91d7a9980dbae91",22851593,1,-6,0,168,117,112,-5
"37319e88176d4aefa91d7a9980dbae91","62bff51286ef4f348717a3cf6fe2318f",22851593,3,9,0,169,112,120,8
"62bff51286ef4f348717a3cf6fe2318f","e20db35ced8544ddac5bc3839145e463",22851593,3,-33,0,170,120,91,-29
"779f9ddd1fd14d1e9e69f72219a1fdbd","3cbcea2be0984e7dbd5a48195af10ce7",22851593,1,57,0,177,121,165,44
"3cbcea2be0984e7dbd5a48195af10ce7","82e6285962b8400d9d6fc32436022a94",22851593,2,2,0,178,165,167,2
"82e6285962b8400d9d6fc32436022a94","3cbcea2be0984e7dbd5a48195af10ce7",22851593,3,-2,0,179,167,165,-2
"3cbcea2be0984e7dbd5a48195af10ce7","a9ac840f098c4bd0a2ee896214ce29cd",22851593,3,5,0,180,165,168,3
"a9ac840f098c4bd0a2ee896214ce29cd","a9ac840f098c4bd0a2ee896214ce29cd",22851593,2,0,1,181,168,168,0
"a9ac840f098c4bd0a2ee896214ce29cd","3cbcea2be0984e7dbd5a48195af10ce7",22851593,2,-5,0,182,168,165,-3
"a9ac840f098c4bd0a2ee896214ce29cd","0c7262dff33c4087bc660ccf40f92f9c",22851593,3,4,0,186,168,169,1
"0c7262dff33c4087bc660ccf40f92f9c","a9ac840f098c4bd0a2ee896214ce29cd",22851593,2,-4,0,187,169,168,-1
"a9ac840f098c4bd0a2ee896214ce29cd","b2275c3fad834f8d90737a2d9a6927d6",22851593,1,7,0,188,168,172,4
"b2275c3fad834f8d90737a2d9a6927d6","a9ac840f098c4bd0a2ee896214ce29cd",22851593,1,-7,0,189,172,168,-4
"a9ac840f098c4bd0a2ee896214ce29cd","b534b89233134e30a9b5645138bfa9ee",22851593,1,-161,0,192,168,41,-127
"b534b89233134e30a9b5645138bfa9ee","7af822066add4e7f8e007e4eee31a8bf",22851593,1,29,0,193,41,65,24
"7af822066add4e7f8e007e4eee31a8bf","a0a418b8540d479fa6e0f653b701da8b",22851593,1,-2,0,194,65,64,-1
"a0a418b8540d479fa6e0f653b701da8b","bc42d26810654ea9a1df1efe1e58c7d5",22851593,3,-1,0,195,64,63,-1
"bc42d26810654ea9a1df1efe1e58c7d5","309ccf3cc4fe429d9bfbaef53d3fa479",22851593,1,-3,0,196,63,60,-3
"309ccf3cc4fe429d9bfbaef53d3fa479","a1f2f12debe5432fb7a70bcd12bacfb9",22851593,1,-3,0,197,60,58,-2
"78f30e4dcac84e3cbea8b2cc6e0d62b3","12aa6e1672ac4e7aa6449a7a8609cd72",22851593,1,-2,0,199,59,57,-2
"12aa6e1672ac4e7aa6449a7a8609cd72","d0c74f735e024943943e40333d6d337f",22851593,2,-7,0,200,57,51,-6
"d0c74f735e024943943e40333d6d337f","67a089198fcb4e1c8f2385786c2b296f",22851593,1,-16,0,201,51,39,-12
"b534b89233134e30a9b5645138bfa9ee","67a089198fcb4e1c8f2385786c2b296f",22851593,1,-4,0,210,41,39,-2
"b534b89233134e30a9b5645138bfa9ee","0e37b720d23b4e7f8b313e79313fd107",22851593,1,3,0,214,41,44,3
"0e37b720d23b4e7f8b313e79313fd107","0e37b720d23b4e7f8b313e79313fd107",22851593,1,0,1,215,44,44,0
"0e37b720d23b4e7f8b313e79313fd107","6875d67fdd5f48168b62719df449bebd",22851593,1,1,0,216,44,45,1
"6875d67fdd5f48168b62719df449bebd","6875d67fdd5f48168b62719df449bebd",22851593,1,0,1,217,45,45,0
"6875d67fdd5f48168b62719df449bebd","6e13d61a7bdb44bca949c9f86fab3be5",22851593,1,3,0,218,45,47,2
"6e13d61a7bdb44bca949c9f86fab3be5","b534b89233134e30a9b5645138bfa9ee",22851593,1,-7,0,219,47,41,-6
"6e13d61a7bdb44bca949c9f86fab3be5","6e13d61a7bdb44bca949c9f86fab3be5",22851593,1,0,1,221,47,47,0
"6e13d61a7bdb44bca949c9f86fab3be5","195f78799f984cc2b06c48dfe36be751",22851593,1,2,0,222,47,49,2
"195f78799f984cc2b06c48dfe36be751","195f78799f984cc2b06c48dfe36be751",22851593,2,0,1,223,49,49,0
"195f78799f984cc2b06c48dfe36be751","d0c74f735e024943943e40333d6d337f",22851593,1,3,0,225,49,51,2
"d9c8d8c444a64dadbbb508652c721e17","d0c74f735e024943943e40333d6d337f",22851593,1,6,0,227,46,51,5
"d0c74f735e024943943e40333d6d337f","d0c74f735e024943943e40333d6d337f",22851593,2,0,1,228,51,51,0
"d0c74f735e024943943e40333d6d337f","983f8ff320594b279a7f4a6fe132f9c5",22851593,1,2,0,229,51,53,2
"983f8ff320594b279a7f4a6fe132f9c5","983f8ff320594b279a7f4a6fe132f9c5",22851593,2,0,1,230,53,53,0
"983f8ff320594b279a7f4a6fe132f9c5","35adfa5d923046aebabfefd98f35ff05",22851593,1,1,0,232,53,54,1
"35adfa5d923046aebabfefd98f35ff05","35adfa5d923046aebabfefd98f35ff05",22851593,6,0,1,233,54,54,0
"35adfa5d923046aebabfefd98f35ff05","b6f8a98476224da1b40e555ececc7ed8",22851593,1,1,0,239,54,55,1
"b6f8a98476224da1b40e555ececc7ed8","b6f8a98476224da1b40e555ececc7ed8",22851593,2,0,1,240,55,55,0
"b6f8a98476224da1b40e555ececc7ed8","86e22cb5fe0e4b47a9489ecddf7ed78f",22851593,1,1,0,242,55,56,1
"86e22cb5fe0e4b47a9489ecddf7ed78f","86e22cb5fe0e4b47a9489ecddf7ed78f",22851593,2,0,1,243,56,56,0
"86e22cb5fe0e4b47a9489ecddf7ed78f","f924752d8a1149668870b1e7698486f7",22851593,1,-6,0,245,56,50,-6
"78f30e4dcac84e3cbea8b2cc6e0d62b3","d0c74f735e024943943e40333d6d337f",22851593,1,-9,0,248,59,51,-8
"d0c74f735e024943943e40333d6d337f","12aa6e1672ac4e7aa6449a7a8609cd72",22851593,1,7,0,249,51,57,6
"d0c74f735e024943943e40333d6d337f","f924752d8a1149668870b1e7698486f7",22851593,1,-1,0,252,51,50,-1
"f924752d8a1149668870b1e7698486f7","78f30e4dcac84e3cbea8b2cc6e0d62b3",22851593,1,10,0,253,50,59,9
"78f30e4dcac84e3cbea8b2cc6e0d62b3","a1f2f12debe5432fb7a70bcd12bacfb9",22851593,2,-1,0,254,59,58,-1
"78f30e4dcac84e3cbea8b2cc6e0d62b3","78f30e4dcac84e3cbea8b2cc6e0d62b3",22851593,7,0,1,256,59,59,0
"a1f2f12debe5432fb7a70bcd12bacfb9","a1f2f12debe5432fb7a70bcd12bacfb9",22851593,23,0,1,264,58,58,0
"a1f2f12debe5432fb7a70bcd12bacfb9","bc42d26810654ea9a1df1efe1e58c7d5",22851593,1,6,0,287,58,63,5
"bc42d26810654ea9a1df1efe1e58c7d5","12aa6e1672ac4e7aa6449a7a8609cd72",22851593,1,-7,0,288,63,57,-6
"12aa6e1672ac4e7aa6449a7a8609cd72","a0a418b8540d479fa6e0f653b701da8b",22851593,1,8,0,289,57,64,7
"a0a418b8540d479fa6e0f653b701da8b","4c943503763e4e349906eea3ed3c8e86",22851593,1,-3,0,298,64,61,-3
"4c943503763e4e349906eea3ed3c8e86","4c943503763e4e349906eea3ed3c8e86",22851593,1,0,1,299,61,61,0
"4c943503763e4e349906eea3ed3c8e86","309ccf3cc4fe429d9bfbaef53d3fa479",22851593,1,-1,0,300,61,60,-1
"b534b89233134e30a9b5645138bfa9ee","267f883678b24aed855fde42524975d9",22851593,1,37,0,303,41,71,30
"267f883678b24aed855fde42524975d9","267f883678b24aed855fde42524975d9",22851593,1,0,1,304,71,71,0
"267f883678b24aed855fde42524975d9","88fff56d0342490dbef9040750a20f6c",22851593,1,1,0,305,71,72,1
"88fff56d0342490dbef9040750a20f6c","88fff56d0342490dbef9040750a20f6c",22851593,1,0,1,306,72,72,0
"88fff56d0342490dbef9040750a20f6c","adb17b12b66c4a49a85fd34322f7df70",22851593,1,1,0,307,72,73,1
"adb17b12b66c4a49a85fd34322f7df70","adb17b12b66c4a49a85fd34322f7df70",22851593,1,0,1,308,73,73,0
"adb17b12b66c4a49a85fd34322f7df70","d646286c8051419bbc2e31dd1db55ca8",22851593,1,-6,0,309,73,67,-6
"d646286c8051419bbc2e31dd1db55ca8","a2becd407db34b189200a32546d9d569",22851593,2,9,0,310,67,75,8
"a2becd407db34b189200a32546d9d569","a2becd407db34b189200a32546d9d569",22851593,2,0,1,311,75,75,0
"d646286c8051419bbc2e31dd1db55ca8","d646286c8051419bbc2e31dd1db55ca8",22851593,2,0,1,313,67,67,0
"140d5b27b8574befad82c0a013b59dfa","a2becd407db34b189200a32546d9d569",22851593,1,1,0,316,74,75,1
"a2becd407db34b189200a32546d9d569","58c22b011d0f4c2ea6d13615edbb9eeb",22851593,1,2,0,317,75,77,2
"58c22b011d0f4c2ea6d13615edbb9eeb","58c22b011d0f4c2ea6d13615edbb9eeb",22851593,2,0,1,318,77,77,0
"58c22b011d0f4c2ea6d13615edbb9eeb","dd76e1861dc9461c830888729d091ee0",22851593,1,1,0,320,77,78,1
"dd76e1861dc9461c830888729d091ee0","dd76e1861dc9461c830888729d091ee0",22851593,5,0,1,321,78,78,0
"dd76e1861dc9461c830888729d091ee0","cd1d828f1a694b87913a7ea66c23803e",22851593,1,1,0,326,78,79,1
"cd1d828f1a694b87913a7ea66c23803e","cd1d828f1a694b87913a7ea66c23803e",22851593,2,0,1,327,79,79,0
"cd1d828f1a694b87913a7ea66c23803e","9176a3c2b4d2465fa8b0c67096c2a97e",22851593,1,1,0,329,79,80,1
"9176a3c2b4d2465fa8b0c67096c2a97e","9176a3c2b4d2465fa8b0c67096c2a97e",22851593,5,0,1,330,80,80,0
"9176a3c2b4d2465fa8b0c67096c2a97e","f8ec6445f7194e25b9101d4fbcb07a18",22851593,1,1,0,335,80,81,1
"f8ec6445f7194e25b9101d4fbcb07a18","f8ec6445f7194e25b9101d4fbcb07a18",22851593,2,0,1,336,81,81,0
"f8ec6445f7194e25b9101d4fbcb07a18","140d5b27b8574befad82c0a013b59dfa",22851593,1,-7,0,338,81,74,-7
"d18a9ea32855445f8736581f5cb119ce","f564483cbd7a407681aa2fcca518cf5f",22851593,1,4,0,340,82,85,3
"f564483cbd7a407681aa2fcca518cf5f","f564483cbd7a407681aa2fcca518cf5f",22851593,1,0,1,341,85,85,0
"f564483cbd7a407681aa2fcca518cf5f","18fd01350bd5434ca636d59a599d768a",22851593,1,1,0,342,85,86,1
"18fd01350bd5434ca636d59a599d768a","18fd01350bd5434ca636d59a599d768a",22851593,9,0,1,343,86,86,0
"18fd01350bd5434ca636d59a599d768a","ae5ac430ea254e708a6f5deaaf7464ae",22851593,1,-2,0,352,86,84,-2
"6a9f0ef185fb47f0937e29daa1c71ed5","c681290961c94c4caf23b529d1ae6b9a",22851593,1,-2,0,358,90,88,-2
"c681290961c94c4caf23b529d1ae6b9a","c681290961c94c4caf23b529d1ae6b9a",22851593,1,0,1,359,88,88,0
"c681290961c94c4caf23b529d1ae6b9a","e20db35ced8544ddac5bc3839145e463",22851593,1,5,0,360,88,91,3
"d646286c8051419bbc2e31dd1db55ca8","67a089198fcb4e1c8f2385786c2b296f",22851593,1,-37,0,362,67,39,-28
"67a089198fcb4e1c8f2385786c2b296f","140d5b27b8574befad82c0a013b59dfa",22851593,1,45,0,363,39,74,35
"140d5b27b8574befad82c0a013b59dfa","d646286c8051419bbc2e31dd1db55ca8",22851593,1,-8,0,364,74,67,-7
"a2becd407db34b189200a32546d9d569","140d5b27b8574befad82c0a013b59dfa",22851593,1,-1,0,367,75,74,-1
"140d5b27b8574befad82c0a013b59dfa","67a089198fcb4e1c8f2385786c2b296f",22851593,1,-45,0,368,74,39,-35
"67a089198fcb4e1c8f2385786c2b296f","0c7262dff33c4087bc660ccf40f92f9c",22851593,2,169,0,369,39,169,130
"0c7262dff33c4087bc660ccf40f92f9c","67a089198fcb4e1c8f2385786c2b296f",22851593,1,-169,0,370,169,39,-130
"67a089198fcb4e1c8f2385786c2b296f","b2275c3fad834f8d90737a2d9a6927d6",22851593,1,172,0,371,39,172,133
"b2275c3fad834f8d90737a2d9a6927d6","9afd71a5298d4333b6849dfce1b9422c",22851593,1,-216,0,372,172,18,-154
"9afd71a5298d4333b6849dfce1b9422c","56586aa865414f538729c7f7735d2bc6",22851593,3,-13,0,375,18,12,-6
"56586aa865414f538729c7f7735d2bc6","5c5ceeee4562457ba6d41515aeebfbb1",22851593,1,10,0,376,12,17,5
"5c5ceeee4562457ba6d41515aeebfbb1","9afd71a5298d4333b6849dfce1b9422c",22851593,2,3,0,377,17,18,1
"b613861cecf84ffcab01afb23f660475","78adeee1fa2c4fe0bc73f7bca9fcee86",22851593,1,224,0,385,1,160,159
"65202579580f4ad38d734b4ee39d22a8","78adeee1fa2c4fe0bc73f7bca9fcee86",22851593,1,-5,0,394,164,160,-4
"78adeee1fa2c4fe0bc73f7bca9fcee86","c33c17be71ae4d588da7369472e5bb1b",22851593,1,-168,0,395,160,34,-126
"c33c17be71ae4d588da7369472e5bb1b","4e51676dc72045d99c19b9fa7b22f8bc",22851593,2,-9,0,397,34,29,-5
"4e51676dc72045d99c19b9fa7b22f8bc","c9c52446b6294aa5a9c2abaed536c37e",22851593,1,5,0,398,29,32,3
"c9c52446b6294aa5a9c2abaed536c37e","51970cfa30e643e894e66ae85c8024cc",22851593,1,-2,0,399,32,31,-1
"51970cfa30e643e894e66ae85c8024cc","c33c17be71ae4d588da7369472e5bb1b",22851593,1,6,0,402,31,34,3
"4e51676dc72045d99c19b9fa7b22f8bc","8959e6304a0348309a771e4d08d1b64a",22851593,1,181,0,404,29,163,134
"8959e6304a0348309a771e4d08d1b64a","3cbcea2be0984e7dbd5a48195af10ce7",22851593,1,4,0,415,163,165,2
"82e6285962b8400d9d6fc32436022a94","67a089198fcb4e1c8f2385786c2b296f",22851593,1,-162,0,418,167,39,-128
"67a089198fcb4e1c8f2385786c2b296f","e20db35ced8544ddac5bc3839145e463",22851593,1,67,0,419,39,91,52
"e20db35ced8544ddac5bc3839145e463","1febb706d7a34005ae8711ed49c76e64",22851593,1,3,0,420,91,94,3
"1febb706d7a34005ae8711ed49c76e64","1febb706d7a34005ae8711ed49c76e64",22851593,2,0,1,421,94,94,0
"1febb706d7a34005ae8711ed49c76e64","8f73ba6f5a0042f2850356ac38ac6f24",22851593,1,1,0,423,94,95,1
"8f73ba6f5a0042f2850356ac38ac6f24","8f73ba6f5a0042f2850356ac38ac6f24",22851593,6,0,1,424,95,95,0
"8f73ba6f5a0042f2850356ac38ac6f24","e2260b86653c46d7b14a41fb419dbf8c",22851593,1,1,0,430,95,96,1
"e2260b86653c46d7b14a41fb419dbf8c","e2260b86653c46d7b14a41fb419dbf8c",22851593,3,0,1,431,96,96,0
"e2260b86653c46d7b14a41fb419dbf8c","35eb641ad1d845bbba54915bce75a962",22851593,1,1,0,434,96,97,1
"35eb641ad1d845bbba54915bce75a962","35eb641ad1d845bbba54915bce75a962",22851593,6,0,1,435,97,97,0
"35eb641ad1d845bbba54915bce75a962","08be90ffbeea4795a138cd42ed8db56f",22851593,1,1,0,441,97,98,1
"08be90ffbeea4795a138cd42ed8db56f","08be90ffbeea4795a138cd42ed8db56f",22851593,6,0,1,442,98,98,0
"08be90ffbeea4795a138cd42ed8db56f","3007433c8f584dcbb5ac159c1c5f2be3",22851593,1,1,0,448,98,99,1
"3007433c8f584dcbb5ac159c1c5f2be3","3007433c8f584dcbb5ac159c1c5f2be3",22851593,3,0,1,449,99,99,0
"3007433c8f584dcbb5ac159c1c5f2be3","e20db35ced8544ddac5bc3839145e463",22851593,1,-8,0,452,99,91,-8
"e20db35ced8544ddac5bc3839145e463","00ae5f0c51874a73a41ebea838d95682",22851593,1,11,0,453,91,101,10
"00ae5f0c51874a73a41ebea838d95682","d391c8b6e56a43a7b654e9dee02d904b",22851593,2,2,0,454,101,103,2
"d391c8b6e56a43a7b654e9dee02d904b","00ae5f0c51874a73a41ebea838d95682",22851593,3,-2,0,455,103,101,-2
"00ae5f0c51874a73a41ebea838d95682","6111116566fc4fd9abba409322bea245",22851593,1,3,0,456,101,104,3
"6111116566fc4fd9abba409322bea245","6111116566fc4fd9abba409322bea245",22851593,2,0,1,457,104,104,0
"6111116566fc4fd9abba409322bea245","a81b2235cb9c499eb9ea8ee0a8dd9725",22851593,1,1,0,459,104,105,1
"a81b2235cb9c499eb9ea8ee0a8dd9725","a81b2235cb9c499eb9ea8ee0a8dd9725",22851593,2,0,1,460,105,105,0
"a81b2235cb9c499eb9ea8ee0a8dd9725","2d4e0ab0ef3b4d73b82c72d4621a7579",22851593,1,1,0,462,105,106,1
"2d4e0ab0ef3b4d73b82c72d4621a7579","2d4e0ab0ef3b4d73b82c72d4621a7579",22851593,2,0,1,463,106,106,0
"2d4e0ab0ef3b4d73b82c72d4621a7579","8bdebf492ebd4e62b0d522e8ab5e5197",22851593,1,1,0,465,106,107,1
"8bdebf492ebd4e62b0d522e8ab5e5197","8bdebf492ebd4e62b0d522e8ab5e5197",22851593,6,0,1,466,107,107,0
"8bdebf492ebd4e62b0d522e8ab5e5197","d391c8b6e56a43a7b654e9dee02d904b",22851593,1,-4,0,472,107,103,-4
"d391c8b6e56a43a7b654e9dee02d904b","d391c8b6e56a43a7b654e9dee02d904b",22851593,15,0,1,473,103,103,0
"00ae5f0c51874a73a41ebea838d95682","73039f8c1eb9409cb4caee2cf968001e",22851593,1,-1,0,489,101,100,-1
"73039f8c1eb9409cb4caee2cf968001e","4280927ec4d643238aa49c32f9e06c6c",22851593,1,10,0,490,100,109,9
"4280927ec4d643238aa49c32f9e06c6c","08111f75e22d409998cf8b85bd431f0a",22851593,1,-1,0,491,109,108,-1
"08111f75e22d409998cf8b85bd431f0a","00ae5f0c51874a73a41ebea838d95682",22851593,1,-8,0,492,108,101,-7
"00ae5f0c51874a73a41ebea838d95682","4280927ec4d643238aa49c32f9e06c6c",22851593,1,9,0,495,101,109,8
"08111f75e22d409998cf8b85bd431f0a","fc44e6a5f7654430af1227838224dceb",22851593,1,3,0,498,108,111,3
"fc44e6a5f7654430af1227838224dceb","fc44e6a5f7654430af1227838224dceb",22851593,2,0,1,499,111,111,0
"fc44e6a5f7654430af1227838224dceb","a9ae0a3c070d455bb4369a8996313336",22851593,1,4,0,501,111,114,3
"a9ae0a3c070d455bb4369a8996313336","08111f75e22d409998cf8b85bd431f0a",22851593,2,-7,0,502,114,108,-6
"08111f75e22d409998cf8b85bd431f0a","37319e88176d4aefa91d7a9980dbae91",22851593,1,5,0,503,108,112,4
"37319e88176d4aefa91d7a9980dbae91","4280927ec4d643238aa49c32f9e06c6c",22851593,1,-4,0,504,112,109,-3
"4280927ec4d643238aa49c32f9e06c6c","4280927ec4d643238aa49c32f9e06c6c",22851593,1,0,1,505,109,109,0
"4280927ec4d643238aa49c32f9e06c6c","a9ae0a3c070d455bb4369a8996313336",22851593,1,6,0,506,109,114,5
"08111f75e22d409998cf8b85bd431f0a","e20db35ced8544ddac5bc3839145e463",22851593,1,-19,0,508,108,91,-17
"e20db35ced8544ddac5bc3839145e463","a9ae0a3c070d455bb4369a8996313336",22851593,1,26,0,509,91,114,23
"a9ae0a3c070d455bb4369a8996313336","71cec822bcff4f30a20e75dc63ef7b65",22851593,1,2,0,510,114,116,2
"71cec822bcff4f30a20e75dc63ef7b65","71cec822bcff4f30a20e75dc63ef7b65",22851593,1,0,1,511,116,116,0
"71cec822bcff4f30a20e75dc63ef7b65","a9ae0a3c070d455bb4369a8996313336",22851593,1,-2,0,512,116,114,-2
"a9ae0a3c070d455bb4369a8996313336","37319e88176d4aefa91d7a9980dbae91",22851593,1,-2,0,513,114,112,-2
"62bff51286ef4f348717a3cf6fe2318f","3ec3a3563847406fa73338f9e9999cf3",22851593,2,-3,0,519,120,117,-3
"3ec3a3563847406fa73338f9e9999cf3","a9ae0a3c070d455bb4369a8996313336",22851593,1,-4,0,520,117,114,-3
"3ec3a3563847406fa73338f9e9999cf3","62bff51286ef4f348717a3cf6fe2318f",22851593,1,3,0,526,117,120,3
"b1cd0e7dc3ad4a8eb91a4bfdbeb025b0","779f9ddd1fd14d1e9e69f72219a1fdbd",22851593,1,5,0,531,118,121,3
"e20db35ced8544ddac5bc3839145e463","67a089198fcb4e1c8f2385786c2b296f",22851593,1,-67,0,533,91,39,-52
"67a089198fcb4e1c8f2385786c2b296f","8959e6304a0348309a771e4d08d1b64a",22851593,1,156,0,534,39,163,124
"65202579580f4ad38d734b4ee39d22a8","e20db35ced8544ddac5bc3839145e463",22851593,1,-90,0,544,164,91,-73
"62bff51286ef4f348717a3cf6fe2318f","78adeee1fa2c4fe0bc73f7bca9fcee86",22851593,1,52,0,552,120,160,40
"65202579580f4ad38d734b4ee39d22a8","779f9ddd1fd14d1e9e69f72219a1fdbd",22851593,1,-54,0,561,164,121,-43
"779f9ddd1fd14d1e9e69f72219a1fdbd","ae26e6cda8ad4a3f81bd347560d9579f",22851593,1,4,0,563,121,125,4
"ae26e6cda8ad4a3f81bd347560d9579f","ae26e6cda8ad4a3f81bd347560d9579f",22851593,3,0,1,564,125,125,0
"ae26e6cda8ad4a3f81bd347560d9579f","ee48df95832b4374aa273ceb27ec1315",22851593,1,1,0,567,125,126,1
"ee48df95832b4374aa273ceb27ec1315","ee48df95832b4374aa273ceb27ec1315",22851593,1,0,1,568,126,126,0
"ee48df95832b4374aa273ceb27ec1315","7a439da90b394756ad1777fc4c6dead5",22851593,1,1,0,569,126,127,1
"7a439da90b394756ad1777fc4c6dead5","7a439da90b394756ad1777fc4c6dead5",22851593,1,0,1,570,127,127,0
"7a439da90b394756ad1777fc4c6dead5","a8dd5213034441ac92724b4e83eb0bb2",22851593,1,3,0,571,127,129,2
"779f9ddd1fd14d1e9e69f72219a1fdbd","a8dd5213034441ac92724b4e83eb0bb2",22851593,1,9,0,573,121,129,8
"a8dd5213034441ac92724b4e83eb0bb2","8115eab6556b45f5b415c3b8c26a12e5",22851593,1,2,0,576,129,131,2
"8115eab6556b45f5b415c3b8c26a12e5","8115eab6556b45f5b415c3b8c26a12e5",22851593,2,0,1,577,131,131,0
"8115eab6556b45f5b415c3b8c26a12e5","ec34b06efd844b46a4c4818ecdb9b8f4",22851593,1,1,0,579,131,132,1
"ec34b06efd844b46a4c4818ecdb9b8f4","ec34b06efd844b46a4c4818ecdb9b8f4",22851593,5,0,1,580,132,132,0
"ec34b06efd844b46a4c4818ecdb9b8f4","c2e1c2b9eac64109b343a088584b576b",22851593,1,1,0,585,132,133,1
"c2e1c2b9eac64109b343a088584b576b","c2e1c2b9eac64109b343a088584b576b",22851593,5,0,1,586,133,133,0
"c2e1c2b9eac64109b343a088584b576b","579338175e0b4bbb8ef3b712b5d8b54e",22851593,1,-5,0,591,133,128,-5
"579338175e0b4bbb8ef3b712b5d8b54e","8bc5795d6a984a3eace4e2811e52dd4f",22851593,1,8,0,592,128,135,7
"8bc5795d6a984a3eace4e2811e52dd4f","8bc5795d6a984a3eace4e2811e52dd4f",22851593,1,0,1,593,135,135,0
"8bc5795d6a984a3eace4e2811e52dd4f","b416d47c56a742199b5d7c7f19d6503a",22851593,1,-1,0,594,135,134,-1
"83d311bed5374fee83d8d67a7d9d82dc","83d311bed5374fee83d8d67a7d9d82dc",22851593,1,0,1,602,144,144,0
"402bba41861d43acb52a5abb89e8831e","402bba41861d43acb52a5abb89e8831e",22851593,2,0,1,604,145,145,0
"402bba41861d43acb52a5abb89e8831e","df1de691dafe4549a18a4398ee9dfaf9",22851593,1,-6,0,606,145,139,-6
"8aae34f5ddbb4052a709b12e6b0d40fa","645b3f0249f64f76af2e19eb4d0e55b7",22851593,1,2,0,611,147,149,2
"645b3f0249f64f76af2e19eb4d0e55b7","645b3f0249f64f76af2e19eb4d0e55b7",22851593,5,0,1,612,149,149,0
"645b3f0249f64f76af2e19eb4d0e55b7","7e7b8db5064d4369805ab370aac5ddfb",22851593,1,1,0,617,149,150,1
"7e7b8db5064d4369805ab370aac5ddfb","7e7b8db5064d4369805ab370aac5ddfb",22851593,2,0,1,618,150,150,0
"7e7b8db5064d4369805ab370aac5ddfb","8956d210ae7f41968fada86d4c979d6a",22851593,1,1,0,620,150,151,1
"8956d210ae7f41968fada86d4c979d6a","8956d210ae7f41968fada86d4c979d6a",22851593,2,0,1,621,151,151,0
"8956d210ae7f41968fada86d4c979d6a","f902b0f41b544d4dbf79664fd233648d",22851593,1,-5,0,623,151,146,-5
"f902b0f41b544d4dbf79664fd233648d","8aae34f5ddbb4052a709b12e6b0d40fa",22851593,1,1,0,624,146,147,1
"8aae34f5ddbb4052a709b12e6b0d40fa","f03480cf4eba413194d7af52fc0e7f28",22851593,1,6,0,625,147,152,5
"f03480cf4eba413194d7af52fc0e7f28","8aae34f5ddbb4052a709b12e6b0d40fa",22851593,2,-6,0,626,152,147,-5
"f902b0f41b544d4dbf79664fd233648d","ae781e8b775e4ccd93bc800dad5c8376",22851593,1,8,0,633,146,153,7
"ae781e8b775e4ccd93bc800dad5c8376","ae781e8b775e4ccd93bc800dad5c8376",22851593,2,0,1,634,153,153,0
"ae781e8b775e4ccd93bc800dad5c8376","06882a8492d9499aa31555567f575ecb",22851593,1,1,0,636,153,154,1
"06882a8492d9499aa31555567f575ecb","06882a8492d9499aa31555567f575ecb",22851593,1,0,1,637,154,154,0
"06882a8492d9499aa31555567f575ecb","f293c508f409466a8f27ddd7d1e40b20",22851593,1,1,0,638,154,155,1
"f293c508f409466a8f27ddd7d1e40b20","f293c508f409466a8f27ddd7d1e40b20",22851593,2,0,1,639,155,155,0
"f293c508f409466a8f27ddd7d1e40b20","cc4ddef5bbbe48ebb605141b347c4ed1",22851593,1,1,0,641,155,156,1
"cc4ddef5bbbe48ebb605141b347c4ed1","cc4ddef5bbbe48ebb605141b347c4ed1",22851593,3,0,1,642,156,156,0
"cc4ddef5bbbe48ebb605141b347c4ed1","f03480cf4eba413194d7af52fc0e7f28",22851593,1,-4,0,645,156,152,-4
"d313cec988a84645bee413e8d4724a4b","78adeee1fa2c4fe0bc73f7bca9fcee86",22851593,1,4,0,651,158,160,2
"82e6285962b8400d9d6fc32436022a94","a9ac840f098c4bd0a2ee896214ce29cd",22851593,1,3,0,665,167,168,1
"3cbcea2be0984e7dbd5a48195af10ce7","67a089198fcb4e1c8f2385786c2b296f",22851593,1,-160,0,667,165,39,-126
"b2275c3fad834f8d90737a2d9a6927d6","0c7262dff33c4087bc660ccf40f92f9c",22851593,2,-3,0,670,172,169,-3
"b2275c3fad834f8d90737a2d9a6927d6","b2275c3fad834f8d90737a2d9a6927d6",22851593,41,0,1,674,172,172,0
"b2275c3fad834f8d90737a2d9a6927d6","eb515a26030b41f8a82a1e6114420bad",22851593,1,1,0,714,172,173,1
"eb515a26030b41f8a82a1e6114420bad","eb515a26030b41f8a82a1e6114420bad",22851593,2,0,1,715,173,173,0
"eb515a26030b41f8a82a1e6114420bad","b2275c3fad834f8d90737a2d9a6927d6",22851593,1,-1,0,717,173,172,-1
"0c7262dff33c4087bc660ccf40f92f9c","b42cc17b7de840f181a704558d0bc845",22851593,1,7,0,720,169,175,6
"b42cc17b7de840f181a704558d0bc845","b42cc17b7de840f181a704558d0bc845",22851593,3,0,1,721,175,175,0
"b42cc17b7de840f181a704558d0bc845","801f9e9135034f49bf5f8b4bdefedb41",22851593,1,2,0,724,175,177,2
"801f9e9135034f49bf5f8b4bdefedb41","801f9e9135034f49bf5f8b4bdefedb41",22851593,8,0,1,725,177,177,0
"801f9e9135034f49bf5f8b4bdefedb41","b87c552dd247427abe6ab5795b9c9d43",22851593,1,5,0,733,177,181,4
"ea38cc0e6e6e41edbabf210220808bf9","362fcb0699a14845ab29b2340093e528",22851593,1,-6,0,735,179,174,-5
"ea38cc0e6e6e41edbabf210220808bf9","ea38cc0e6e6e41edbabf210220808bf9",22851593,3,0,1,737,179,179,0
"139b097acfca451689d80c9c6eebdf7b","b87c552dd247427abe6ab5795b9c9d43",22851593,1,3,0,747,178,181,3
"b87c552dd247427abe6ab5795b9c9d43","2024b4885bd14338a39b7b509acbbd02",22851593,1,2,0,748,181,182,1
"2024b4885bd14338a39b7b509acbbd02","ea38cc0e6e6e41edbabf210220808bf9",22851593,3,-4,0,749,182,179,-3
"ea38cc0e6e6e41edbabf210220808bf9","139b097acfca451689d80c9c6eebdf7b",22851593,3,-1,0,751,179,178,-1
"139b097acfca451689d80c9c6eebdf7b","ea38cc0e6e6e41edbabf210220808bf9",22851593,2,1,0,757,178,179,1
"ea38cc0e6e6e41edbabf210220808bf9","2024b4885bd14338a39b7b509acbbd02",22851593,3,4,0,758,179,182,3
"2024b4885bd14338a39b7b509acbbd02","b87c552dd247427abe6ab5795b9c9d43",22851593,3,-2,0,759,182,181,-1
"2024b4885bd14338a39b7b509acbbd02","cf4c280bad6a43e6b131d8385ef9ef3f",22851593,1,3,0,768,182,184,2
"0c7262dff33c4087bc660ccf40f92f9c","30f660a1feb34582a739722532524f79",22851593,1,17,0,780,169,183,14
"30f660a1feb34582a739722532524f79","30f660a1feb34582a739722532524f79",22851593,9,0,1,781,183,183,0
"30f660a1feb34582a739722532524f79","2024b4885bd14338a39b7b509acbbd02",22851593,1,-1,0,790,183,182,-1
"2024b4885bd14338a39b7b509acbbd02","c8e371568a0c4391b25796ae4e91952e",22851593,1,7,0,791,182,186,4
"0c7262dff33c4087bc660ccf40f92f9c","7d932b23e1c84326ae5aa4d3c0d813d1",22851593,1,25,0,793,169,188,19
"ab11d94c6c8948ea90b88f19d2cd502b","f992451ed6ad4e68bb9e68ad6be7c4be",22851593,1,2,0,798,190,192,2
"f992451ed6ad4e68bb9e68ad6be7c4be","f992451ed6ad4e68bb9e68ad6be7c4be",22851593,1,0,1,799,192,192,0
"f992451ed6ad4e68bb9e68ad6be7c4be","6cd2dcaac46847d4a0bc53f296d90375",22851593,1,3,0,800,192,194,2
"6cd2dcaac46847d4a0bc53f296d90375","07b44a7a51e94c78b411c753fc39dab0",22851593,2,-6,0,801,194,189,-5
"07b44a7a51e94c78b411c753fc39dab0","017d7ca8e0394b91aaadc9574df2202c",22851593,1,5,0,802,189,193,4
"017d7ca8e0394b91aaadc9574df2202c","ab11d94c6c8948ea90b88f19d2cd502b",22851593,1,-4,0,803,193,190,-3
"ab11d94c6c8948ea90b88f19d2cd502b","ab11d94c6c8948ea90b88f19d2cd502b",22851593,1,0,1,804,190,190,0
"017d7ca8e0394b91aaadc9574df2202c","c8e371568a0c4391b25796ae4e91952e",22851593,1,-9,0,808,193,186,-7
"ab11d94c6c8948ea90b88f19d2cd502b","6cd2dcaac46847d4a0bc53f296d90375",22851593,1,5,0,810,190,194,4
"6cd2dcaac46847d4a0bc53f296d90375","6cd2dcaac46847d4a0bc53f296d90375",22851593,1,0,1,813,194,194,0
"2d2580c9411c4972909db508d6956a58","2d2580c9411c4972909db508d6956a58",22851593,6,0,1,815,196,196,0
"2d2580c9411c4972909db508d6956a58","5bddb3d9ed264f3984702f048c7e5340",22851593,1,1,0,821,196,197,1
"5bddb3d9ed264f3984702f048c7e5340","5bddb3d9ed264f3984702f048c7e5340",22851593,5,0,1,822,197,197,0
"5bddb3d9ed264f3984702f048c7e5340","d5e8e2bd12a2466b9d6d90855f0eb079",22851593,1,1,0,827,197,198,1
"d5e8e2bd12a2466b9d6d90855f0eb079","d5e8e2bd12a2466b9d6d90855f0eb079",22851593,2,0,1,828,198,198,0
"d5e8e2bd12a2466b9d6d90855f0eb079","017d7ca8e0394b91aaadc9574df2202c",22851593,1,-5,0,830,198,193,-5
"017d7ca8e0394b91aaadc9574df2202c","54e8e9f0ea3e45c4bf3b8ac799ee31b1",22851593,1,8,0,831,193,200,7
"54e8e9f0ea3e45c4bf3b8ac799ee31b1","54e8e9f0ea3e45c4bf3b8ac799ee31b1",22851593,1,0,1,832,200,200,0
"54e8e9f0ea3e45c4bf3b8ac799ee31b1","c614a00911be4877a075f19315530fb0",22851593,1,1,0,833,200,201,1
"c614a00911be4877a075f19315530fb0","c614a00911be4877a075f19315530fb0",22851593,6,0,1,834,201,201,0
"c614a00911be4877a075f19315530fb0","f9170dd6bc6442b4acd832747609b09a",22851593,1,-2,0,840,201,199,-2
"b9e80f77c3a44349863b19875725c384","b9e80f77c3a44349863b19875725c384",22851593,25,0,1,846,207,207,0
"7108f0e4c2584f1f9c471689ae4c885c","7108f0e4c2584f1f9c471689ae4c885c",22851593,10,0,1,872,208,208,0
"09400e101c5d4b439cf9a26b03aae558","09400e101c5d4b439cf9a26b03aae558",22851593,3,0,1,884,210,210,0
"09400e101c5d4b439cf9a26b03aae558","a88efa7e50ce47159810ab553afa6d3a",22851593,1,2,0,887,210,212,2
"a88efa7e50ce47159810ab553afa6d3a","a88efa7e50ce47159810ab553afa6d3a",22851593,5,0,1,888,212,212,0
"a88efa7e50ce47159810ab553afa6d3a","be502a7a43c44bf7b682698de79d9369",22851593,1,3,0,893,212,214,2
"be502a7a43c44bf7b682698de79d9369","f7fb1952f56b4189b86a9f8b7862d2b8",22851593,2,1,0,894,214,215,1
"f7fb1952f56b4189b86a9f8b7862d2b8","a875096404ef4a9984b62d74cda916f9",22851593,1,-7,0,895,215,209,-6
"a875096404ef4a9984b62d74cda916f9","be502a7a43c44bf7b682698de79d9369",22851593,1,6,0,896,209,214,5
"f7fb1952f56b4189b86a9f8b7862d2b8","f7fb1952f56b4189b86a9f8b7862d2b8",22851593,13,0,1,898,215,215,0
"f7fb1952f56b4189b86a9f8b7862d2b8","b860ee85d8bc4a2f97958cfb71be3533",22851593,1,1,0,911,215,216,1
"b860ee85d8bc4a2f97958cfb71be3533","b860ee85d8bc4a2f97958cfb71be3533",22851593,11,0,1,912,216,216,0
"b860ee85d8bc4a2f97958cfb71be3533","ec341f459285443b8361f7f15638ff08",22851593,1,-3,0,923,216,213,-3
"363837c182e04711840d896ae1e0339c","363837c182e04711840d896ae1e0339c",22851593,12,0,1,925,218,218,0
"01b2051f8941460d89945e3b02d1ce78","be95c065e45447c1bd8215ea6f130c7a",22851593,1,3,0,938,217,219,2
"be95c065e45447c1bd8215ea6f130c7a","363837c182e04711840d896ae1e0339c",22851593,1,-2,0,939,219,218,-1
"77ecef8eff6b4a2caea7707669bf7475","77ecef8eff6b4a2caea7707669bf7475",22851593,12,0,1,944,222,222,0
"77ecef8eff6b4a2caea7707669bf7475","d03cb855c70044cf8c35d9ec0de696e3",22851593,1,3,0,956,222,224,2
"d03cb855c70044cf8c35d9ec0de696e3","1c6721b1f63f4d30ba7746ea8af02a52",22851593,1,-4,0,957,224,221,-3
"1c6721b1f63f4d30ba7746ea8af02a52","8b9ae98743bd4d4a8a87dff1c1244211",22851593,1,7,0,958,221,227,6
"8b9ae98743bd4d4a8a87dff1c1244211","d03cb855c70044cf8c35d9ec0de696e3",22851593,1,-3,0,959,227,224,-3
"d03cb855c70044cf8c35d9ec0de696e3","a49a937d6896486d9a5396654abcf2e1",22851593,2,2,0,960,224,226,2
"a49a937d6896486d9a5396654abcf2e1","a49a937d6896486d9a5396654abcf2e1",22851593,4,0,1,961,226,226,0
"a49a937d6896486d9a5396654abcf2e1","d03cb855c70044cf8c35d9ec0de696e3",22851593,1,-2,0,962,226,224,-2
"d03cb855c70044cf8c35d9ec0de696e3","d03cb855c70044cf8c35d9ec0de696e3",22851593,1,0,1,963,224,224,0
"a49a937d6896486d9a5396654abcf2e1","8b9ae98743bd4d4a8a87dff1c1244211",22851593,1,1,0,968,226,227,1
"8b9ae98743bd4d4a8a87dff1c1244211","8b9ae98743bd4d4a8a87dff1c1244211",22851593,27,0,1,969,227,227,0
"2ab1535aac1346ba8801535bf729ef37","a4f40fb48a8542c8949bae1f002cd9bc",22851593,1,2,0,1000,229,231,2
"a4f40fb48a8542c8949bae1f002cd9bc","a4f40fb48a8542c8949bae1f002cd9bc",22851593,2,0,1,1001,231,231,0
"a4f40fb48a8542c8949bae1f002cd9bc","8972c23e32044edb8a78fa1eed4e5947",22851593,1,1,0,1003,231,232,1
"8972c23e32044edb8a78fa1eed4e5947","8972c23e32044edb8a78fa1eed4e5947",22851593,1,0,1,1004,232,232,0
"8972c23e32044edb8a78fa1eed4e5947","92feb4a40f8344d38b6f722e42a53295",22851593,2,1,0,1005,232,233,1
"92feb4a40f8344d38b6f722e42a53295","92feb4a40f8344d38b6f722e42a53295",22851593,2,0,1,1006,233,233,0
"92feb4a40f8344d38b6f722e42a53295","5152833676bf4c6cb317060be10f68db",22851593,1,-5,0,1008,233,228,-5
"5152833676bf4c6cb317060be10f68db","2ab1535aac1346ba8801535bf729ef37",22851593,1,1,0,1009,228,229,1
"2ab1535aac1346ba8801535bf729ef37","0b04c8e2f86d48c7aeb7e225819cd32b",22851593,1,6,0,1010,229,234,5
"0b04c8e2f86d48c7aeb7e225819cd32b","2ab1535aac1346ba8801535bf729ef37",22851593,1,-6,0,1011,234,229,-5
"2ab1535aac1346ba8801535bf729ef37","5152833676bf4c6cb317060be10f68db",22851593,4,-1,0,1012,229,228,-1
"5152833676bf4c6cb317060be10f68db","ca3e28f290354c08aefe5b0f769604e6",22851593,1,8,0,1013,228,235,7
"ca3e28f290354c08aefe5b0f769604e6","ca3e28f290354c08aefe5b0f769604e6",22851593,9,0,1,1014,235,235,0
"ca3e28f290354c08aefe5b0f769604e6","79a35eea833e4c2c9d22fc53c3c6445c",22851593,1,1,0,1023,235,236,1
"79a35eea833e4c2c9d22fc53c3c6445c","79a35eea833e4c2c9d22fc53c3c6445c",22851593,4,0,1,1024,236,236,0
"79a35eea833e4c2c9d22fc53c3c6445c","cab89fa5c3ed45a5aa550fc0352d6a42",22851593,1,2,0,1028,236,238,2
"cab89fa5c3ed45a5aa550fc0352d6a42","cab89fa5c3ed45a5aa550fc0352d6a42",22851593,5,0,1,1029,238,238,0
"cab89fa5c3ed45a5aa550fc0352d6a42","0b04c8e2f86d48c7aeb7e225819cd32b",22851593,1,-4,0,1034,238,234,-4
"0b04c8e2f86d48c7aeb7e225819cd32b","1c6721b1f63f4d30ba7746ea8af02a52",22851593,1,-16,0,1035,234,221,-13
"1c6721b1f63f4d30ba7746ea8af02a52","2ae94c0cea4d480a9d5dca8fb1d7b542",22851593,2,27,0,1036,221,242,21
"2ae94c0cea4d480a9d5dca8fb1d7b542","1ebf23f9d994469a85206e4c7b1bf5f5",22851593,3,3,0,1037,242,245,3
"1ebf23f9d994469a85206e4c7b1bf5f5","1ebf23f9d994469a85206e4c7b1bf5f5",22851593,20,0,1,1038,245,245,0
"1ebf23f9d994469a85206e4c7b1bf5f5","85ae675b83e8422da842cfd25596af99",22851593,2,1,0,1048,245,246,1
"85ae675b83e8422da842cfd25596af99","85ae675b83e8422da842cfd25596af99",22851593,1,0,1,1049,246,246,0
"85ae675b83e8422da842cfd25596af99","2ae94c0cea4d480a9d5dca8fb1d7b542",22851593,1,-4,0,1050,246,242,-4
"2ae94c0cea4d480a9d5dca8fb1d7b542","fa235f0f364d47e4ae1c87f47bf8e6ba",22851593,4,12,0,1051,242,252,10
"fa235f0f364d47e4ae1c87f47bf8e6ba","fa235f0f364d47e4ae1c87f47bf8e6ba",22851593,3,0,1,1052,252,252,0
"fa235f0f364d47e4ae1c87f47bf8e6ba","79f7845465cc4ed19d8e4f1429541be0",22851593,2,2,0,1054,252,254,2
"79f7845465cc4ed19d8e4f1429541be0","79f7845465cc4ed19d8e4f1429541be0",22851593,2,0,1,1055,254,254,0
"79f7845465cc4ed19d8e4f1429541be0","6e83e23f56544a19b94067c1c558d9c0",22851593,2,-8,0,1057,254,247,-7
"6e83e23f56544a19b94067c1c558d9c0","00f61990949545828dd12f1303d47504",22851593,2,11,0,1058,247,256,9
"00f61990949545828dd12f1303d47504","2ae94c0cea4d480a9d5dca8fb1d7b542",22851593,1,-17,0,1059,256,242,-14
"1ebf23f9d994469a85206e4c7b1bf5f5","2ae94c0cea4d480a9d5dca8fb1d7b542",22851593,4,-3,0,1061,245,242,-3
"fa235f0f364d47e4ae1c87f47bf8e6ba","00f61990949545828dd12f1303d47504",22851593,1,5,0,1063,252,256,4
"00f61990949545828dd12f1303d47504","6e83e23f56544a19b94067c1c558d9c0",22851593,3,-11,0,1064,256,247,-9
"6e83e23f56544a19b94067c1c558d9c0","ead7bb4b64e247d2ae632ab8a296b091",22851593,1,13,0,1065,247,258,11
"ead7bb4b64e247d2ae632ab8a296b091","ead7bb4b64e247d2ae632ab8a296b091",22851593,2,0,1,1066,258,258,0
"ead7bb4b64e247d2ae632ab8a296b091","41b0048dde734bb280bac6116baa8e27",22851593,1,1,0,1068,258,259,1
"41b0048dde734bb280bac6116baa8e27","41b0048dde734bb280bac6116baa8e27",22851593,6,0,1,1069,259,259,0
"41b0048dde734bb280bac6116baa8e27","b41c5a094a604ee0915327da5cc0beb7",22851593,1,1,0,1075,259,260,1
"b41c5a094a604ee0915327da5cc0beb7","b41c5a094a604ee0915327da5cc0beb7",22851593,2,0,1,1076,260,260,0
"b41c5a094a604ee0915327da5cc0beb7","00f61990949545828dd12f1303d47504",22851593,1,-4,0,1078,260,256,-4
"00f61990949545828dd12f1303d47504","d546341988904f069cfa86b21457d9d9",22851593,2,-6,0,1079,256,251,-5
"d546341988904f069cfa86b21457d9d9","28c171777c52431ab6b925073bd63d46",22851593,1,15,0,1080,251,264,13
"28c171777c52431ab6b925073bd63d46","28c171777c52431ab6b925073bd63d46",22851593,5,0,1,1081,264,264,0
"28c171777c52431ab6b925073bd63d46","ac160db940cb49ae8579162b1d52bb5d",22851593,2,2,0,1086,264,266,2
"ac160db940cb49ae8579162b1d52bb5d","ac160db940cb49ae8579162b1d52bb5d",22851593,8,0,1,1087,266,266,0
"ac160db940cb49ae8579162b1d52bb5d","d989ebcfc12a4b669f0100dc1aa14f1e",22851593,2,-12,0,1095,266,255,-11
"d989ebcfc12a4b669f0100dc1aa14f1e","c6fd49b485cc4874b0bbdd9c6171e09c",22851593,2,15,0,1096,255,268,13
"c6fd49b485cc4874b0bbdd9c6171e09c","c6fd49b485cc4874b0bbdd9c6171e09c",22851593,9,0,1,1097,268,268,0
"c6fd49b485cc4874b0bbdd9c6171e09c","44240778a97c4af0937817499b75707b",22851593,3,1,0,1102,268,269,1
"44240778a97c4af0937817499b75707b","44240778a97c4af0937817499b75707b",22851593,6,0,1,1103,269,269,0
"44240778a97c4af0937817499b75707b","7aa76d3e993840d8805f097cbdbcd44b",22851593,3,-9,0,1105,269,261,-8
"7aa76d3e993840d8805f097cbdbcd44b","2ae94c0cea4d480a9d5dca8fb1d7b542",22851593,1,-23,0,1106,261,242,-19
"2ae94c0cea4d480a9d5dca8fb1d7b542","0d987bed3ffa4ed0b9a2e62e97b7b30f",22851593,4,38,0,1107,242,272,30
"0d987bed3ffa4ed0b9a2e62e97b7b30f","0d987bed3ffa4ed0b9a2e62e97b7b30f",22851593,1,0,1,1108,272,272,0
"0d987bed3ffa4ed0b9a2e62e97b7b30f","bb5a47f5ea01454a8b79455422d3b9da",22851593,3,10,0,1109,272,280,8
"bb5a47f5ea01454a8b79455422d3b9da","bb5a47f5ea01454a8b79455422d3b9da",22851593,32,0,1,1110,280,280,0
"bb5a47f5ea01454a8b79455422d3b9da","82ae07bc0c9b4570a41799290d1ef399",22851593,3,-6,0,1113,280,275,-5
"82ae07bc0c9b4570a41799290d1ef399","bb5a47f5ea01454a8b79455422d3b9da",22851593,4,6,0,1114,275,280,5
"bb5a47f5ea01454a8b79455422d3b9da","94cecc3f1e7d484b8e068e79241dfd73",22851593,3,3,0,1118,280,281,1
"94cecc3f1e7d484b8e068e79241dfd73","0d987bed3ffa4ed0b9a2e62e97b7b30f",22851593,3,-13,0,1119,281,272,-9
"0d987bed3ffa4ed0b9a2e62e97b7b30f","a37477c4e4c14169ad44b06b493007f6",22851593,3,15,0,1120,272,283,11
"a37477c4e4c14169ad44b06b493007f6","94cecc3f1e7d484b8e068e79241dfd73",22851593,1,-2,0,1121,283,281,-2
"94cecc3f1e7d484b8e068e79241dfd73","fab84b4fab5940efb4ea868ef8d09396",22851593,2,5,0,1122,281,284,3
"fab84b4fab5940efb4ea868ef8d09396","fab84b4fab5940efb4ea868ef8d09396",22851593,1,0,1,1123,284,284,0
"fab84b4fab5940efb4ea868ef8d09396","4a29443515bb404cb8924e1c60a63b73",22851593,2,4,0,1124,284,285,1
"4a29443515bb404cb8924e1c60a63b73","208c9b2796c944db8dacaa96082520ea",22851593,2,3,0,1125,285,288,3
"208c9b2796c944db8dacaa96082520ea","208c9b2796c944db8dacaa96082520ea",22851593,8,0,1,1126,288,288,0
"208c9b2796c944db8dacaa96082520ea","4a29443515bb404cb8924e1c60a63b73",22851593,8,-3,0,1129,288,285,-3
"4a29443515bb404cb8924e1c60a63b73","6a9a3b5bde4a48daa896fe8c06eca56f",22851593,4,5,0,1130,285,289,4
"6a9a3b5bde4a48daa896fe8c06eca56f","208c9b2796c944db8dacaa96082520ea",22851593,4,-2,0,1131,289,288,-1
"4a29443515bb404cb8924e1c60a63b73","869e967078f04da18dd0b0b9389a7424",22851593,3,10,0,1138,285,293,8
"869e967078f04da18dd0b0b9389a7424","6a9a3b5bde4a48daa896fe8c06eca56f",22851593,3,-5,0,1139,293,289,-4
"6a9a3b5bde4a48daa896fe8c06eca56f","869e967078f04da18dd0b0b9389a7424",22851593,1,5,0,1140,289,293,4
"869e967078f04da18dd0b0b9389a7424","869e967078f04da18dd0b0b9389a7424",22851593,1,0,1,1141,293,293,0
"869e967078f04da18dd0b0b9389a7424","51ab6291537748fab90d519aa09889d6",22851593,1,2,0,1142,293,295,2
"51ab6291537748fab90d519aa09889d6","51ab6291537748fab90d519aa09889d6",22851593,12,0,1,1143,295,295,0
"51ab6291537748fab90d519aa09889d6","34a6e49023fc4465bd5ca604330bbd1c",22851593,1,-3,0,1155,295,292,-3
"34a6e49023fc4465bd5ca604330bbd1c","ba0e59461bfb4a44b7b1c28a01f8d3b3",22851593,1,9,0,1156,292,299,7
"ba0e59461bfb4a44b7b1c28a01f8d3b3","21592f2a9e9c4b2f8c66ec5dbcbf6a2b",22851593,3,-4,0,1157,299,296,-3
"21592f2a9e9c4b2f8c66ec5dbcbf6a2b","ba0e59461bfb4a44b7b1c28a01f8d3b3",22851593,2,4,0,1158,296,299,3
"ba0e59461bfb4a44b7b1c28a01f8d3b3","ba0e59461bfb4a44b7b1c28a01f8d3b3",22851593,2,0,1,1159,299,299,0
"ba0e59461bfb4a44b7b1c28a01f8d3b3","0e0b36e731a645e7b1b8a88f5031ca38",22851593,2,2,0,1160,299,301,2
"0e0b36e731a645e7b1b8a88f5031ca38","0e0b36e731a645e7b1b8a88f5031ca38",22851593,9,0,1,1161,301,301,0
"0e0b36e731a645e7b1b8a88f5031ca38","a66a144637284c21afc6de17fea4bfb8",22851593,2,1,0,1170,301,302,1
"a66a144637284c21afc6de17fea4bfb8","a66a144637284c21afc6de17fea4bfb8",22851593,3,0,1,1171,302,302,0
"a66a144637284c21afc6de17fea4bfb8","7646a919d7e64fa990bca9b024ff089d",22851593,2,-4,0,1174,302,298,-4
"7646a919d7e64fa990bca9b024ff089d","2c5bb2cbd0014420ad8c95d40e38efd1",22851593,3,6,0,1175,298,303,5
"2c5bb2cbd0014420ad8c95d40e38efd1","ba0e59461bfb4a44b7b1c28a01f8d3b3",22851593,3,-5,0,1176,303,299,-4
"ba0e59461bfb4a44b7b1c28a01f8d3b3","7646a919d7e64fa990bca9b024ff089d",22851593,4,-1,0,1177,299,298,-1
"7646a919d7e64fa990bca9b024ff089d","3434c10e561d488a914e0f7d71907abd",22851593,1,10,0,1178,298,305,7
"3434c10e561d488a914e0f7d71907abd","4a29443515bb404cb8924e1c60a63b73",22851593,4,-27,0,1179,305,285,-20
"4a29443515bb404cb8924e1c60a63b73","53e7e900392747ccad52e711ab0f80d8",22851593,1,29,0,1180,285,307,22
"53e7e900392747ccad52e711ab0f80d8","53e7e900392747ccad52e711ab0f80d8",22851593,7,0,1,1181,307,307,0
"53e7e900392747ccad52e711ab0f80d8","3434c10e561d488a914e0f7d71907abd",22851593,8,-2,0,1186,307,305,-2
"4a29443515bb404cb8924e1c60a63b73","3434c10e561d488a914e0f7d71907abd",22851593,8,27,0,1188,285,305,20
"3434c10e561d488a914e0f7d71907abd","53e7e900392747ccad52e711ab0f80d8",22851593,7,2,0,1191,305,307,2
"3434c10e561d488a914e0f7d71907abd","130acc2aeb0448fdbb2de63bc5cebe5b",22851593,4,5,0,1194,305,309,4
"130acc2aeb0448fdbb2de63bc5cebe5b","130acc2aeb0448fdbb2de63bc5cebe5b",22851593,3,0,1,1195,309,309,0
"130acc2aeb0448fdbb2de63bc5cebe5b","53e7e900392747ccad52e711ab0f80d8",22851593,1,-3,0,1197,309,307,-2
"130acc2aeb0448fdbb2de63bc5cebe5b","9c062b3251034ebe90f5054e2a3b5120",22851593,1,2,0,1203,309,311,2
"9c062b3251034ebe90f5054e2a3b5120","9c062b3251034ebe90f5054e2a3b5120",22851593,3,0,1,1204,311,311,0
"9c062b3251034ebe90f5054e2a3b5120","ea859f8207e44537889daeaba13ac2e8",22851593,1,1,0,1207,311,312,1
"ea859f8207e44537889daeaba13ac2e8","ea859f8207e44537889daeaba13ac2e8",22851593,2,0,1,1208,312,312,0
"ea859f8207e44537889daeaba13ac2e8","56d94971a7a94257aa330183a8ebd0ea",22851593,1,1,0,1210,312,313,1
"56d94971a7a94257aa330183a8ebd0ea","56d94971a7a94257aa330183a8ebd0ea",22851593,5,0,1,1211,313,313,0
"56d94971a7a94257aa330183a8ebd0ea","141c0df6cd1946539aadd1c9b7068cd4",22851593,1,-5,0,1216,313,308,-5
"141c0df6cd1946539aadd1c9b7068cd4","0c787d16c9504873b1a4d903cec09948",22851593,3,7,0,1217,308,314,6
"0c787d16c9504873b1a4d903cec09948","86c27d40179e419c8e9d150fb6afa5d0",22851593,2,6,0,1218,314,319,5
"86c27d40179e419c8e9d150fb6afa5d0","86c27d40179e419c8e9d150fb6afa5d0",22851593,2,0,1,1219,319,319,0
"86c27d40179e419c8e9d150fb6afa5d0","47edbb64109243e6b0f8f64cdef90c6c",22851593,1,8,0,1220,319,326,7
"47edbb64109243e6b0f8f64cdef90c6c","8d7e0b55cf9849cda222a0f2440cec55",22851593,1,-9,0,1221,326,318,-8
"8d7e0b55cf9849cda222a0f2440cec55","24f1363179ad4aaa965484a78471912b",22851593,1,6,0,1222,318,323,5
"24f1363179ad4aaa965484a78471912b","3628bdce1dd2429ba924d2d4d09448d2",22851593,5,-1,0,1223,323,322,-1
"3628bdce1dd2429ba924d2d4d09448d2","3434c10e561d488a914e0f7d71907abd",22851593,5,-21,0,1224,322,305,-17
"3434c10e561d488a914e0f7d71907abd","0c4079457ede49e3aeb5e86ed84bdf35",22851593,5,31,0,1225,305,329,24
"0c4079457ede49e3aeb5e86ed84bdf35","38aea304b4fa46e1b29bb72f5cea4c93",22851593,4,2,0,1226,329,331,2
"38aea304b4fa46e1b29bb72f5cea4c93","38aea304b4fa46e1b29bb72f5cea4c93",22851593,4,0,1,1227,331,331,0
"38aea304b4fa46e1b29bb72f5cea4c93","e36d261332f14e79bb4b467aceaeb9b5",22851593,1,2,0,1230,331,333,2
"e36d261332f14e79bb4b467aceaeb9b5","e36d261332f14e79bb4b467aceaeb9b5",22851593,1,0,1,1231,333,333,0
"e36d261332f14e79bb4b467aceaeb9b5","c7e89b9d04744d2eab742fc24e3ef1ae",22851593,1,1,0,1232,333,334,1
"c7e89b9d04744d2eab742fc24e3ef1ae","38aea304b4fa46e1b29bb72f5cea4c93",22851593,1,-3,0,1233,334,331,-3
"38aea304b4fa46e1b29bb72f5cea4c93","c7e89b9d04744d2eab742fc24e3ef1ae",22851593,1,3,0,1235,331,334,3
"c7e89b9d04744d2eab742fc24e3ef1ae","c7e89b9d04744d2eab742fc24e3ef1ae",22851593,2,0,1,1236,334,334,0
"c7e89b9d04744d2eab742fc24e3ef1ae","fe49f8054b374a0ea4bb266ed135ff62",22851593,1,1,0,1238,334,335,1
"fe49f8054b374a0ea4bb266ed135ff62","fe49f8054b374a0ea4bb266ed135ff62",22851593,3,0,1,1239,335,335,0
"fe49f8054b374a0ea4bb266ed135ff62","3434c10e561d488a914e0f7d71907abd",22851593,1,-37,0,1242,335,305,-30
"53e7e900392747ccad52e711ab0f80d8","130acc2aeb0448fdbb2de63bc5cebe5b",22851593,1,3,0,1244,307,309,2
"130acc2aeb0448fdbb2de63bc5cebe5b","3434c10e561d488a914e0f7d71907abd",22851593,1,-5,0,1245,309,305,-4
"3434c10e561d488a914e0f7d71907abd","141c0df6cd1946539aadd1c9b7068cd4",22851593,1,4,0,1246,305,308,3
"0c787d16c9504873b1a4d903cec09948","0c4079457ede49e3aeb5e86ed84bdf35",22851593,1,20,0,1248,314,329,15
"0c4079457ede49e3aeb5e86ed84bdf35","3434c10e561d488a914e0f7d71907abd",22851593,1,-31,0,1249,329,305,-24
"3434c10e561d488a914e0f7d71907abd","38aea304b4fa46e1b29bb72f5cea4c93",22851593,1,33,0,1250,305,331,26
"38aea304b4fa46e1b29bb72f5cea4c93","d0a8f74af98642fe8360d22c42e45117",22851593,1,5,0,1251,331,336,5
"d0a8f74af98642fe8360d22c42e45117","d0a8f74af98642fe8360d22c42e45117",22851593,2,0,1,1252,336,336,0
"d0a8f74af98642fe8360d22c42e45117","0c4079457ede49e3aeb5e86ed84bdf35",22851593,1,-7,0,1254,336,329,-7
"0c4079457ede49e3aeb5e86ed84bdf35","bbc5139ca9024389a94db3a6f47dcff6",22851593,4,14,0,1255,329,341,12
"bbc5139ca9024389a94db3a6f47dcff6","b8b9418ab322418d9db9b40d96af873a",22851593,4,-5,0,1256,341,337,-4
"b8b9418ab322418d9db9b40d96af873a","bbc5139ca9024389a94db3a6f47dcff6",22851593,3,5,0,1257,337,341,4
"bbc5139ca9024389a94db3a6f47dcff6","1c6721b1f63f4d30ba7746ea8af02a52",22851593,1,-159,0,1258,341,221,-120
"1c6721b1f63f4d30ba7746ea8af02a52","64dbedb3ce544f6aae8e10e0cf10f16d",22851593,2,23,0,1259,221,240,19
"64dbedb3ce544f6aae8e10e0cf10f16d","2ab1535aac1346ba8801535bf729ef37",22851593,1,-13,0,1260,240,229,-11
"2ab1535aac1346ba8801535bf729ef37","c8e371568a0c4391b25796ae4e91952e",22851593,1,-57,0,1261,229,186,-43
"c8e371568a0c4391b25796ae4e91952e","d7f13c8d63ec4e2aa673fbb9cf9c6933",22851593,2,26,0,1262,186,206,20
"d7f13c8d63ec4e2aa673fbb9cf9c6933","c8e371568a0c4391b25796ae4e91952e",22851593,5,-26,0,1263,206,186,-20
"c8e371568a0c4391b25796ae4e91952e","b9e80f77c3a44349863b19875725c384",22851593,4,27,0,1264,186,207,21
"b9e80f77c3a44349863b19875725c384","7108f0e4c2584f1f9c471689ae4c885c",22851593,5,1,0,1265,207,208,1
"7108f0e4c2584f1f9c471689ae4c885c","be502a7a43c44bf7b682698de79d9369",22851593,1,8,0,1266,208,214,6
"be502a7a43c44bf7b682698de79d9369","d7f13c8d63ec4e2aa673fbb9cf9c6933",22851593,1,-10,0,1267,214,206,-8
"d7f13c8d63ec4e2aa673fbb9cf9c6933","f7fb1952f56b4189b86a9f8b7862d2b8",22851593,2,11,0,1268,206,215,9
"f7fb1952f56b4189b86a9f8b7862d2b8","ec341f459285443b8361f7f15638ff08",22851593,1,-2,0,1269,215,213,-2
"ec341f459285443b8361f7f15638ff08","363837c182e04711840d896ae1e0339c",22851593,4,6,0,1270,213,218,5
"363837c182e04711840d896ae1e0339c","01b2051f8941460d89945e3b02d1ce78",22851593,6,-1,0,1271,218,217,-1
"01b2051f8941460d89945e3b02d1ce78","0c7262dff33c4087bc660ccf40f92f9c",22851593,1,-63,0,1272,217,169,-48
"0c7262dff33c4087bc660ccf40f92f9c","01b2051f8941460d89945e3b02d1ce78",22851593,1,63,0,1273,169,217,48
"01b2051f8941460d89945e3b02d1ce78","d7f13c8d63ec4e2aa673fbb9cf9c6933",22851593,5,-14,0,1274,217,206,-11
"d7f13c8d63ec4e2aa673fbb9cf9c6933","363837c182e04711840d896ae1e0339c",22851593,3,15,0,1275,206,218,12
"363837c182e04711840d896ae1e0339c","c8e371568a0c4391b25796ae4e91952e",22851593,1,-41,0,1276,218,186,-32
"7108f0e4c2584f1f9c471689ae4c885c","d7f13c8d63ec4e2aa673fbb9cf9c6933",22851593,3,-2,0,1281,208,206,-2
"01b2051f8941460d89945e3b02d1ce78","f7fb1952f56b4189b86a9f8b7862d2b8",22851593,1,-3,0,1284,217,215,-2
"f7fb1952f56b4189b86a9f8b7862d2b8","be502a7a43c44bf7b682698de79d9369",22851593,3,-1,0,1285,215,214,-1
"be502a7a43c44bf7b682698de79d9369","ec341f459285443b8361f7f15638ff08",22851593,1,-1,0,1286,214,213,-1
"ec341f459285443b8361f7f15638ff08","09400e101c5d4b439cf9a26b03aae558",22851593,1,-4,0,1287,213,210,-3
"09400e101c5d4b439cf9a26b03aae558","b9e80f77c3a44349863b19875725c384",22851593,1,-4,0,1288,210,207,-3
"b9e80f77c3a44349863b19875725c384","a875096404ef4a9984b62d74cda916f9",22851593,1,3,0,1289,207,209,2
"a875096404ef4a9984b62d74cda916f9","7108f0e4c2584f1f9c471689ae4c885c",22851593,1,-2,0,1290,209,208,-1
"d7f13c8d63ec4e2aa673fbb9cf9c6933","01b2051f8941460d89945e3b02d1ce78",22851593,1,14,0,1292,206,217,11
"363837c182e04711840d896ae1e0339c","0c7262dff33c4087bc660ccf40f92f9c",22851593,1,-64,0,1295,218,169,-49
"0c7262dff33c4087bc660ccf40f92f9c","d7f13c8d63ec4e2aa673fbb9cf9c6933",22851593,1,49,0,1296,169,206,37
"d7f13c8d63ec4e2aa673fbb9cf9c6933","d7f13c8d63ec4e2aa673fbb9cf9c6933",22851593,1,0,1,1297,206,206,0
"d7f13c8d63ec4e2aa673fbb9cf9c6933","7108f0e4c2584f1f9c471689ae4c885c",22851593,1,2,0,1298,206,208,2
"7108f0e4c2584f1f9c471689ae4c885c","b9e80f77c3a44349863b19875725c384",22851593,4,-1,0,1299,208,207,-1
"b9e80f77c3a44349863b19875725c384","d7f13c8d63ec4e2aa673fbb9cf9c6933",22851593,3,-1,0,1300,207,206,-1
"d7f13c8d63ec4e2aa673fbb9cf9c6933","09400e101c5d4b439cf9a26b03aae558",22851593,2,5,0,1301,206,210,4
"09400e101c5d4b439cf9a26b03aae558","f7fb1952f56b4189b86a9f8b7862d2b8",22851593,1,6,0,1302,210,215,5
"be502a7a43c44bf7b682698de79d9369","a875096404ef4a9984b62d74cda916f9",22851593,2,-6,0,1304,214,209,-5
"a875096404ef4a9984b62d74cda916f9","ec341f459285443b8361f7f15638ff08",22851593,2,5,0,1305,209,213,4
"d7f13c8d63ec4e2aa673fbb9cf9c6933","1c6721b1f63f4d30ba7746ea8af02a52",22851593,4,21,0,1309,206,221,15
"1c6721b1f63f4d30ba7746ea8af02a52","77ecef8eff6b4a2caea7707669bf7475",22851593,5,1,0,1310,221,222,1
"77ecef8eff6b4a2caea7707669bf7475","0c7262dff33c4087bc660ccf40f92f9c",22851593,1,-71,0,1311,222,169,-53
"0c7262dff33c4087bc660ccf40f92f9c","b87c552dd247427abe6ab5795b9c9d43",22851593,2,14,0,1312,169,181,12
"b87c552dd247427abe6ab5795b9c9d43","ea38cc0e6e6e41edbabf210220808bf9",22851593,6,-2,0,1313,181,179,-2
"ea38cc0e6e6e41edbabf210220808bf9","cf4c280bad6a43e6b131d8385ef9ef3f",22851593,2,7,0,1314,179,184,5
"cf4c280bad6a43e6b131d8385ef9ef3f","ea38cc0e6e6e41edbabf210220808bf9",22851593,2,-7,0,1315,184,179,-5
"ea38cc0e6e6e41edbabf210220808bf9","b87c552dd247427abe6ab5795b9c9d43",22851593,6,2,0,1316,179,181,2
"b87c552dd247427abe6ab5795b9c9d43","b87c552dd247427abe6ab5795b9c9d43",22851593,14,0,1,1317,181,181,0
"b87c552dd247427abe6ab5795b9c9d43","139b097acfca451689d80c9c6eebdf7b",22851593,6,-3,0,1324,181,178,-3
"139b097acfca451689d80c9c6eebdf7b","0c7262dff33c4087bc660ccf40f92f9c",22851593,2,-11,0,1325,178,169,-9
"0c7262dff33c4087bc660ccf40f92f9c","c8e371568a0c4391b25796ae4e91952e",22851593,3,23,0,1326,169,186,17
"c8e371568a0c4391b25796ae4e91952e","c8e371568a0c4391b25796ae4e91952e",22851593,2,0,1,1327,186,186,0
"c8e371568a0c4391b25796ae4e91952e","7d932b23e1c84326ae5aa4d3c0d813d1",22851593,1,2,0,1328,186,188,2
"7d932b23e1c84326ae5aa4d3c0d813d1","7d932b23e1c84326ae5aa4d3c0d813d1",22851593,4,0,1,1329,188,188,0
"7d932b23e1c84326ae5aa4d3c0d813d1","ab11d94c6c8948ea90b88f19d2cd502b",22851593,2,3,0,1332,188,190,2
"ab11d94c6c8948ea90b88f19d2cd502b","c8e371568a0c4391b25796ae4e91952e",22851593,2,-5,0,1333,190,186,-4
"c8e371568a0c4391b25796ae4e91952e","07b44a7a51e94c78b411c753fc39dab0",22851593,1,4,0,1334,186,189,3
"07b44a7a51e94c78b411c753fc39dab0","c8e371568a0c4391b25796ae4e91952e",22851593,1,-4,0,1335,189,186,-3
"c8e371568a0c4391b25796ae4e91952e","6cd2dcaac46847d4a0bc53f296d90375",22851593,2,10,0,1336,186,194,8
"6cd2dcaac46847d4a0bc53f296d90375","f9170dd6bc6442b4acd832747609b09a",22851593,2,6,0,1337,194,199,5
"f9170dd6bc6442b4acd832747609b09a","6cd2dcaac46847d4a0bc53f296d90375",22851593,1,-6,0,1338,199,194,-5
"6cd2dcaac46847d4a0bc53f296d90375","2d2580c9411c4972909db508d6956a58",22851593,2,2,0,1339,194,196,2
"2d2580c9411c4972909db508d6956a58","017d7ca8e0394b91aaadc9574df2202c",22851593,1,-3,0,1340,196,193,-3
"017d7ca8e0394b91aaadc9574df2202c","1c6721b1f63f4d30ba7746ea8af02a52",22851593,1,38,0,1341,193,221,28
"77ecef8eff6b4a2caea7707669bf7475","1c6721b1f63f4d30ba7746ea8af02a52",22851593,3,-1,0,1343,222,221,-1
"1c6721b1f63f4d30ba7746ea8af02a52","2ab1535aac1346ba8801535bf729ef37",22851593,1,10,0,1344,221,229,8
"2ab1535aac1346ba8801535bf729ef37","2ab1535aac1346ba8801535bf729ef37",22851593,3,0,1,1345,229,229,0
"2ab1535aac1346ba8801535bf729ef37","8972c23e32044edb8a78fa1eed4e5947",22851593,1,3,0,1346,229,232,3
"92feb4a40f8344d38b6f722e42a53295","a4f40fb48a8542c8949bae1f002cd9bc",22851593,1,-2,0,1348,233,231,-2
"a4f40fb48a8542c8949bae1f002cd9bc","2ab1535aac1346ba8801535bf729ef37",22851593,1,-2,0,1349,231,229,-2
"5152833676bf4c6cb317060be10f68db","0b04c8e2f86d48c7aeb7e225819cd32b",22851593,2,7,0,1351,228,234,6
"0b04c8e2f86d48c7aeb7e225819cd32b","2ae94c0cea4d480a9d5dca8fb1d7b542",22851593,2,11,0,1352,234,242,8
"2ae94c0cea4d480a9d5dca8fb1d7b542","1c6721b1f63f4d30ba7746ea8af02a52",22851593,2,-27,0,1353,242,221,-21
"1c6721b1f63f4d30ba7746ea8af02a52","1ebf23f9d994469a85206e4c7b1bf5f5",22851593,2,30,0,1354,221,245,24
"85ae675b83e8422da842cfd25596af99","fa235f0f364d47e4ae1c87f47bf8e6ba",22851593,1,8,0,1356,246,252,6
"fa235f0f364d47e4ae1c87f47bf8e6ba","2ae94c0cea4d480a9d5dca8fb1d7b542",22851593,2,-12,0,1357,252,242,-10
"2ae94c0cea4d480a9d5dca8fb1d7b542","6e83e23f56544a19b94067c1c558d9c0",22851593,1,6,0,1358,242,247,5
"6e83e23f56544a19b94067c1c558d9c0","1ebf23f9d994469a85206e4c7b1bf5f5",22851593,1,-3,0,1359,247,245,-2
"1ebf23f9d994469a85206e4c7b1bf5f5","fa235f0f364d47e4ae1c87f47bf8e6ba",22851593,1,9,0,1370,245,252,7
"d546341988904f069cfa86b21457d9d9","44240778a97c4af0937817499b75707b",22851593,1,21,0,1377,251,269,18
"44240778a97c4af0937817499b75707b","c6fd49b485cc4874b0bbdd9c6171e09c",22851593,2,-1,0,1378,269,268,-1
"c6fd49b485cc4874b0bbdd9c6171e09c","7aa76d3e993840d8805f097cbdbcd44b",22851593,2,-8,0,1379,268,261,-7
"7aa76d3e993840d8805f097cbdbcd44b","7028800abe7d4e27b613d1d6cbe26bf7",22851593,2,7,0,1380,261,267,6
"7028800abe7d4e27b613d1d6cbe26bf7","c6fd49b485cc4874b0bbdd9c6171e09c",22851593,1,1,0,1381,267,268,1
"7028800abe7d4e27b613d1d6cbe26bf7","7aa76d3e993840d8805f097cbdbcd44b",22851593,2,-7,0,1386,267,261,-6
"7aa76d3e993840d8805f097cbdbcd44b","28c171777c52431ab6b925073bd63d46",22851593,1,3,0,1387,261,264,3
"7aa76d3e993840d8805f097cbdbcd44b","0d987bed3ffa4ed0b9a2e62e97b7b30f",22851593,2,15,0,1400,261,272,11
"0d987bed3ffa4ed0b9a2e62e97b7b30f","2ae94c0cea4d480a9d5dca8fb1d7b542",22851593,2,-38,0,1401,272,242,-30
"bb5a47f5ea01454a8b79455422d3b9da","bc5524e78a8544e2ae2fdc2f3462bbec",22851593,2,-1,0,1412,280,279,-1
"bc5524e78a8544e2ae2fdc2f3462bbec","bb5a47f5ea01454a8b79455422d3b9da",22851593,1,1,0,1413,279,280,1
"a37477c4e4c14169ad44b06b493007f6","4a29443515bb404cb8924e1c60a63b73",22851593,1,7,0,1425,283,285,2
"4a29443515bb404cb8924e1c60a63b73","4a29443515bb404cb8924e1c60a63b73",22851593,2,0,1,1426,285,285,0
"130acc2aeb0448fdbb2de63bc5cebe5b","141c0df6cd1946539aadd1c9b7068cd4",22851593,2,-1,0,1432,309,308,-1
"86c27d40179e419c8e9d150fb6afa5d0","8d7e0b55cf9849cda222a0f2440cec55",22851593,2,-1,0,1435,319,318,-1
"8d7e0b55cf9849cda222a0f2440cec55","47edbb64109243e6b0f8f64cdef90c6c",22851593,3,9,0,1436,318,326,8
"47edbb64109243e6b0f8f64cdef90c6c","43ea1b823a4b4e51b7c694c10725db82",22851593,1,2,0,1437,326,327,1
"43ea1b823a4b4e51b7c694c10725db82","24f1363179ad4aaa965484a78471912b",22851593,2,-5,0,1438,327,323,-4
"38aea304b4fa46e1b29bb72f5cea4c93","0c4079457ede49e3aeb5e86ed84bdf35",22851593,3,-2,0,1443,331,329,-2
"bbc5139ca9024389a94db3a6f47dcff6","bbc5139ca9024389a94db3a6f47dcff6",22851593,2,0,1,1447,341,341,0
"bbc5139ca9024389a94db3a6f47dcff6","4ee6ca9019ab4a1ab323f98094a9bd77",22851593,2,2,0,1449,341,343,2
"4ee6ca9019ab4a1ab323f98094a9bd77","4ee6ca9019ab4a1ab323f98094a9bd77",22851593,2,0,1,1450,343,343,0
"4ee6ca9019ab4a1ab323f98094a9bd77","b37947176785476f8b29d49a851366dc",22851593,2,1,0,1452,343,344,1
"b37947176785476f8b29d49a851366dc","b37947176785476f8b29d49a851366dc",22851593,2,0,1,1453,344,344,0
"b37947176785476f8b29d49a851366dc","fcea5b10d5a14a3b9324ffece8f6e1e5",22851593,2,1,0,1455,344,345,1
"fcea5b10d5a14a3b9324ffece8f6e1e5","fcea5b10d5a14a3b9324ffece8f6e1e5",22851593,5,0,1,1456,345,345,0
"fcea5b10d5a14a3b9324ffece8f6e1e5","c2490bc612d146edbe786556fab3651b",22851593,1,-5,0,1461,345,340,-5
"c2490bc612d146edbe786556fab3651b","4a92daef4d504e1792575a26502bb7b7",22851593,3,7,0,1462,340,346,6
"4a92daef4d504e1792575a26502bb7b7","bbc5139ca9024389a94db3a6f47dcff6",22851593,2,-6,0,1463,346,341,-5
"fcea5b10d5a14a3b9324ffece8f6e1e5","bbc5139ca9024389a94db3a6f47dcff6",22851593,1,-4,0,1467,345,341,-4
"bbc5139ca9024389a94db3a6f47dcff6","c2490bc612d146edbe786556fab3651b",22851593,3,-1,0,1468,341,340,-1
"c2490bc612d146edbe786556fab3651b","30ead9794d4847abaf222ca966cc8630",22851593,1,11,0,1474,340,348,8
"30ead9794d4847abaf222ca966cc8630","0c4079457ede49e3aeb5e86ed84bdf35",22851593,1,-24,0,1475,348,329,-19
"0c4079457ede49e3aeb5e86ed84bdf35","eff0de7f2dbb42dfa1a2e686efab5b6d",22851593,1,30,0,1476,329,354,25
"eff0de7f2dbb42dfa1a2e686efab5b6d","c20993c944444fe085345591a8bd837e",22851593,2,-3,0,1477,354,351,-3
"c20993c944444fe085345591a8bd837e","09b9678ddc3d452ea4a3d46e15826065",22851593,2,2,0,1478,351,353,2
"09b9678ddc3d452ea4a3d46e15826065","897b7f51242c44aab2205c72fdcbf4cd",22851593,2,-1,0,1479,353,352,-1
"897b7f51242c44aab2205c72fdcbf4cd","c20993c944444fe085345591a8bd837e",22851593,1,-1,0,1480,352,351,-1
"c20993c944444fe085345591a8bd837e","c20993c944444fe085345591a8bd837e",22851593,5,0,1,1481,351,351,0
"c20993c944444fe085345591a8bd837e","897b7f51242c44aab2205c72fdcbf4cd",22851593,1,1,0,1484,351,352,1
"897b7f51242c44aab2205c72fdcbf4cd","897b7f51242c44aab2205c72fdcbf4cd",22851593,4,0,1,1485,352,352,0
"897b7f51242c44aab2205c72fdcbf4cd","09b9678ddc3d452ea4a3d46e15826065",22851593,1,1,0,1488,352,353,1
"09b9678ddc3d452ea4a3d46e15826065","09b9678ddc3d452ea4a3d46e15826065",22851593,5,0,1,1489,353,353,0
"09b9678ddc3d452ea4a3d46e15826065","eff0de7f2dbb42dfa1a2e686efab5b6d",22851593,1,1,0,1492,353,354,1
"eff0de7f2dbb42dfa1a2e686efab5b6d","eff0de7f2dbb42dfa1a2e686efab5b6d",22851593,5,0,1,1493,354,354,0
"eff0de7f2dbb42dfa1a2e686efab5b6d","30ead9794d4847abaf222ca966cc8630",22851593,1,-6,0,1496,354,348,-6
"30ead9794d4847abaf222ca966cc8630","2fe14166dc9642c3bc666b86a57f943d",22851593,1,10,0,1497,348,357,9
"2fe14166dc9642c3bc666b86a57f943d","2fe14166dc9642c3bc666b86a57f943d",22851593,3,0,1,1498,357,357,0
"2fe14166dc9642c3bc666b86a57f943d","44421dd1e13a47a388c4a19834b744c7",22851593,1,2,0,1500,357,359,2
"44421dd1e13a47a388c4a19834b744c7","44421dd1e13a47a388c4a19834b744c7",22851593,2,0,1,1501,359,359,0
"44421dd1e13a47a388c4a19834b744c7","2fe14166dc9642c3bc666b86a57f943d",22851593,1,-2,0,1503,359,357,-2
"2fe14166dc9642c3bc666b86a57f943d","1ba8fef685d74a8194b9db252eb704fb",22851593,1,-2,0,1504,357,355,-2
"1ba8fef685d74a8194b9db252eb704fb","1ba8fef685d74a8194b9db252eb704fb",22851593,1,0,1,1505,355,355,0
"1ba8fef685d74a8194b9db252eb704fb","52580888dadb4fe3baa795683ea227bd",22851593,3,10,0,1506,355,364,9
"52580888dadb4fe3baa795683ea227bd","52580888dadb4fe3baa795683ea227bd",22851593,6,0,1,1507,364,364,0
"52580888dadb4fe3baa795683ea227bd","2fe14166dc9642c3bc666b86a57f943d",22851593,2,-8,0,1509,364,357,-7
"2fe14166dc9642c3bc666b86a57f943d","f00179e251a045b39c3f7a54f9aa4acc",22851593,2,7,0,1510,357,363,6
"f00179e251a045b39c3f7a54f9aa4acc","2fe14166dc9642c3bc666b86a57f943d",22851593,1,-7,0,1511,363,357,-6
"2fe14166dc9642c3bc666b86a57f943d","cb5fc7ef85d547c4be1a7439d0bf6052",22851593,1,3,0,1513,357,360,3
"cb5fc7ef85d547c4be1a7439d0bf6052","cb5fc7ef85d547c4be1a7439d0bf6052",22851593,6,0,1,1514,360,360,0
"cb5fc7ef85d547c4be1a7439d0bf6052","0a8f150a4cf747acbde62f4721823da3",22851593,1,1,0,1520,360,361,1
"0a8f150a4cf747acbde62f4721823da3","0a8f150a4cf747acbde62f4721823da3",22851593,2,0,1,1521,361,361,0
"0a8f150a4cf747acbde62f4721823da3","ab8fdad974ae471f9f24c3f9dd04462e",22851593,1,1,0,1523,361,362,1
"ab8fdad974ae471f9f24c3f9dd04462e","ab8fdad974ae471f9f24c3f9dd04462e",22851593,2,0,1,1524,362,362,0
"ab8fdad974ae471f9f24c3f9dd04462e","1ba8fef685d74a8194b9db252eb704fb",22851593,1,-7,0,1526,362,355,-7
"52580888dadb4fe3baa795683ea227bd","492a3bc6a1254f23a7998587961b22a4",22851593,3,3,0,1529,364,366,2
"492a3bc6a1254f23a7998587961b22a4","f00179e251a045b39c3f7a54f9aa4acc",22851593,3,-4,0,1530,366,363,-3
"f00179e251a045b39c3f7a54f9aa4acc","072a190fd302456290895f9f04d6940a",22851593,2,3,0,1531,363,365,2
"072a190fd302456290895f9f04d6940a","52580888dadb4fe3baa795683ea227bd",22851593,4,-2,0,1532,365,364,-1
"52580888dadb4fe3baa795683ea227bd","f00179e251a045b39c3f7a54f9aa4acc",22851593,1,-1,0,1533,364,363,-1
"f00179e251a045b39c3f7a54f9aa4acc","492a3bc6a1254f23a7998587961b22a4",22851593,3,4,0,1534,363,366,3
"492a3bc6a1254f23a7998587961b22a4","52580888dadb4fe3baa795683ea227bd",22851593,1,-3,0,1535,366,364,-2
"52580888dadb4fe3baa795683ea227bd","072a190fd302456290895f9f04d6940a",22851593,2,2,0,1536,364,365,1
"492a3bc6a1254f23a7998587961b22a4","492a3bc6a1254f23a7998587961b22a4",22851593,2,0,1,1547,366,366,0
"492a3bc6a1254f23a7998587961b22a4","072a190fd302456290895f9f04d6940a",22851593,2,-1,0,1548,366,365,-1
"072a190fd302456290895f9f04d6940a","30ead9794d4847abaf222ca966cc8630",22851593,1,-20,0,1549,365,348,-17
"30ead9794d4847abaf222ca966cc8630","b71bac264efb4abd97015447bd490db6",22851593,4,28,0,1550,348,370,22
"b71bac264efb4abd97015447bd490db6","8d448d625b024c82a5eb240bbd7431d6",22851593,8,5,0,1551,370,374,4
"8d448d625b024c82a5eb240bbd7431d6","8d448d625b024c82a5eb240bbd7431d6",22851593,52,0,1,1552,374,374,0
"8d448d625b024c82a5eb240bbd7431d6","b71bac264efb4abd97015447bd490db6",22851593,5,-5,0,1558,374,370,-4
"8d448d625b024c82a5eb240bbd7431d6","1b4550d0dab04078b3bf08a655345bdc",22851593,3,-1,0,1560,374,373,-1
"1b4550d0dab04078b3bf08a655345bdc","8d448d625b024c82a5eb240bbd7431d6",22851593,2,1,0,1561,373,374,1
"8d448d625b024c82a5eb240bbd7431d6","d6d02b6ef04e4f17805504500b8ce441",22851593,3,3,0,1580,374,375,1
"d6d02b6ef04e4f17805504500b8ce441","b71bac264efb4abd97015447bd490db6",22851593,6,-8,0,1581,375,370,-5
"b71bac264efb4abd97015447bd490db6","d6d02b6ef04e4f17805504500b8ce441",22851593,6,8,0,1582,370,375,5
"d6d02b6ef04e4f17805504500b8ce441","8d448d625b024c82a5eb240bbd7431d6",22851593,2,-3,0,1585,375,374,-1
"d6d02b6ef04e4f17805504500b8ce441","d6d02b6ef04e4f17805504500b8ce441",22851593,26,0,1,1595,375,375,0
"d6d02b6ef04e4f17805504500b8ce441","e20db35ced8544ddac5bc3839145e463",22851593,1,-377,0,1596,375,91,-284
"e20db35ced8544ddac5bc3839145e463","62bff51286ef4f348717a3cf6fe2318f",22851593,4,33,0,1597,91,120,29
"62bff51286ef4f348717a3cf6fe2318f","62bff51286ef4f348717a3cf6fe2318f",22851593,14,0,1,1598,120,120,0
"62bff51286ef4f348717a3cf6fe2318f","b1cd0e7dc3ad4a8eb91a4bfdbeb025b0",22851593,2,-2,0,1600,120,118,-2
"b1cd0e7dc3ad4a8eb91a4bfdbeb025b0","b1cd0e7dc3ad4a8eb91a4bfdbeb025b0",22851593,3,0,1,1601,118,118,0
"b1cd0e7dc3ad4a8eb91a4bfdbeb025b0","e20db35ced8544ddac5bc3839145e463",22851593,1,-31,0,1604,118,91,-27
"e20db35ced8544ddac5bc3839145e463","779f9ddd1fd14d1e9e69f72219a1fdbd",22851593,2,36,0,1605,91,121,30
"779f9ddd1fd14d1e9e69f72219a1fdbd","779f9ddd1fd14d1e9e69f72219a1fdbd",22851593,11,0,1,1606,121,121,0
"779f9ddd1fd14d1e9e69f72219a1fdbd","f661500307d74c908e9207d949ceb4aa",22851593,3,18,0,1607,121,136,15
"f661500307d74c908e9207d949ceb4aa","a8dd5213034441ac92724b4e83eb0bb2",22851593,2,-9,0,1608,136,129,-7
"a8dd5213034441ac92724b4e83eb0bb2","b416d47c56a742199b5d7c7f19d6503a",22851593,1,6,0,1609,129,134,5
"b416d47c56a742199b5d7c7f19d6503a","779f9ddd1fd14d1e9e69f72219a1fdbd",22851593,4,-15,0,1610,134,121,-13
"f661500307d74c908e9207d949ceb4aa","f661500307d74c908e9207d949ceb4aa",22851593,1,0,1,1613,136,136,0
"f661500307d74c908e9207d949ceb4aa","b416d47c56a742199b5d7c7f19d6503a",22851593,1,-3,0,1614,136,134,-2
"b416d47c56a742199b5d7c7f19d6503a","a8dd5213034441ac92724b4e83eb0bb2",22851593,1,-6,0,1615,134,129,-5
"a8dd5213034441ac92724b4e83eb0bb2","a8dd5213034441ac92724b4e83eb0bb2",22851593,4,0,1,1616,129,129,0
"a8dd5213034441ac92724b4e83eb0bb2","579338175e0b4bbb8ef3b712b5d8b54e",22851593,2,-1,0,1618,129,128,-1
"579338175e0b4bbb8ef3b712b5d8b54e","779f9ddd1fd14d1e9e69f72219a1fdbd",22851593,1,-8,0,1619,128,121,-7
"779f9ddd1fd14d1e9e69f72219a1fdbd","df1de691dafe4549a18a4398ee9dfaf9",22851593,5,23,0,1620,121,139,18
"df1de691dafe4549a18a4398ee9dfaf9","6c5ad271a44743479bfaea29b1db8d02",22851593,7,4,0,1621,139,143,4
"6c5ad271a44743479bfaea29b1db8d02","6c5ad271a44743479bfaea29b1db8d02",22851593,4,0,1,1622,143,143,0
"6c5ad271a44743479bfaea29b1db8d02","df1de691dafe4549a18a4398ee9dfaf9",22851593,5,-4,0,1623,143,139,-4
"df1de691dafe4549a18a4398ee9dfaf9","8aae34f5ddbb4052a709b12e6b0d40fa",22851593,4,9,0,1624,139,147,8
"8aae34f5ddbb4052a709b12e6b0d40fa","6c5ad271a44743479bfaea29b1db8d02",22851593,1,-5,0,1625,147,143,-4
"6c5ad271a44743479bfaea29b1db8d02","f902b0f41b544d4dbf79664fd233648d",22851593,1,4,0,1626,143,146,3
"f902b0f41b544d4dbf79664fd233648d","6c5ad271a44743479bfaea29b1db8d02",22851593,1,-4,0,1627,146,143,-3
"6c5ad271a44743479bfaea29b1db8d02","83d311bed5374fee83d8d67a7d9d82dc",22851593,2,1,0,1628,143,144,1
"83d311bed5374fee83d8d67a7d9d82dc","402bba41861d43acb52a5abb89e8831e",22851593,2,1,0,1629,144,145,1
"402bba41861d43acb52a5abb89e8831e","8aae34f5ddbb4052a709b12e6b0d40fa",22851593,1,3,0,1630,145,147,2
"8aae34f5ddbb4052a709b12e6b0d40fa","df1de691dafe4549a18a4398ee9dfaf9",22851593,3,-9,0,1631,147,139,-8
"df1de691dafe4549a18a4398ee9dfaf9","f902b0f41b544d4dbf79664fd233648d",22851593,2,8,0,1632,139,146,7
"f902b0f41b544d4dbf79664fd233648d","d313cec988a84645bee413e8d4724a4b",22851593,4,14,0,1633,146,158,12
"d313cec988a84645bee413e8d4724a4b","d313cec988a84645bee413e8d4724a4b",22851593,16,0,1,1634,158,158,0
"d313cec988a84645bee413e8d4724a4b","df1de691dafe4549a18a4398ee9dfaf9",22851593,2,-22,0,1636,158,139,-19
"df1de691dafe4549a18a4398ee9dfaf9","df1de691dafe4549a18a4398ee9dfaf9",22851593,2,0,1,1637,139,139,0
"6c5ad271a44743479bfaea29b1db8d02","779f9ddd1fd14d1e9e69f72219a1fdbd",22851593,1,-27,0,1640,143,121,-22
"df1de691dafe4549a18a4398ee9dfaf9","d313cec988a84645bee413e8d4724a4b",22851593,2,22,0,1647,139,158,19
"d313cec988a84645bee413e8d4724a4b","6c5ad271a44743479bfaea29b1db8d02",22851593,1,-18,0,1650,158,143,-15
"6c5ad271a44743479bfaea29b1db8d02","f4ce60b4a944484082ccb701b48b3da1",22851593,1,17,0,1651,143,157,14
"f4ce60b4a944484082ccb701b48b3da1","8aae34f5ddbb4052a709b12e6b0d40fa",22851593,2,-12,0,1652,157,147,-10
"8aae34f5ddbb4052a709b12e6b0d40fa","f902b0f41b544d4dbf79664fd233648d",22851593,5,-1,0,1655,147,146,-1
"f902b0f41b544d4dbf79664fd233648d","f03480cf4eba413194d7af52fc0e7f28",22851593,2,7,0,1656,146,152,6
"f03480cf4eba413194d7af52fc0e7f28","d313cec988a84645bee413e8d4724a4b",22851593,4,7,0,1657,152,158,6
"d313cec988a84645bee413e8d4724a4b","f4ce60b4a944484082ccb701b48b3da1",22851593,2,-1,0,1660,158,157,-1
"f4ce60b4a944484082ccb701b48b3da1","6c5ad271a44743479bfaea29b1db8d02",22851593,1,-17,0,1661,157,143,-14
"8aae34f5ddbb4052a709b12e6b0d40fa","8aae34f5ddbb4052a709b12e6b0d40fa",22851593,7,0,1,1664,147,147,0
"d313cec988a84645bee413e8d4724a4b","f03480cf4eba413194d7af52fc0e7f28",22851593,2,-7,0,1667,158,152,-6
"d313cec988a84645bee413e8d4724a4b","2ae94c0cea4d480a9d5dca8fb1d7b542",22851593,1,118,0,1670,158,242,84
"2ae94c0cea4d480a9d5dca8fb1d7b542","7028800abe7d4e27b613d1d6cbe26bf7",22851593,1,30,0,1671,242,267,25
"7028800abe7d4e27b613d1d6cbe26bf7","1ebf23f9d994469a85206e4c7b1bf5f5",22851593,1,-27,0,1672,267,245,-22
"fa235f0f364d47e4ae1c87f47bf8e6ba","6e83e23f56544a19b94067c1c558d9c0",22851593,1,-6,0,1676,252,247,-5
"6e83e23f56544a19b94067c1c558d9c0","7028800abe7d4e27b613d1d6cbe26bf7",22851593,1,24,0,1677,247,267,20
"7028800abe7d4e27b613d1d6cbe26bf7","7028800abe7d4e27b613d1d6cbe26bf7",22851593,1,0,1,1678,267,267,0
"7aa76d3e993840d8805f097cbdbcd44b","44240778a97c4af0937817499b75707b",22851593,1,9,0,1680,261,269,8
"7aa76d3e993840d8805f097cbdbcd44b","865a4d3b43374da7944dc7d397f566d9",22851593,1,12,0,1683,261,271,10
"865a4d3b43374da7944dc7d397f566d9","865a4d3b43374da7944dc7d397f566d9",22851593,3,0,1,1684,271,271,0
"865a4d3b43374da7944dc7d397f566d9","2ae94c0cea4d480a9d5dca8fb1d7b542",22851593,1,-35,0,1687,271,242,-29
"0d987bed3ffa4ed0b9a2e62e97b7b30f","779f9ddd1fd14d1e9e69f72219a1fdbd",22851593,1,-201,0,1689,272,121,-151
"579338175e0b4bbb8ef3b712b5d8b54e","b416d47c56a742199b5d7c7f19d6503a",22851593,2,7,0,1693,128,134,6
"779f9ddd1fd14d1e9e69f72219a1fdbd","cd4532ad48034873ba8bce2aac0c9808",22851593,1,19,0,1695,121,137,16
"cd4532ad48034873ba8bce2aac0c9808","cd4532ad48034873ba8bce2aac0c9808",22851593,1,0,1,1696,137,137,0
"cd4532ad48034873ba8bce2aac0c9808","779f9ddd1fd14d1e9e69f72219a1fdbd",22851593,1,-19,0,1697,137,121,-16
"d313cec988a84645bee413e8d4724a4b","dc60696c76a74368a60f72246e47700d",22851593,1,1,0,1713,158,159,1
"dc60696c76a74368a60f72246e47700d","dc60696c76a74368a60f72246e47700d",22851593,1,0,1,1714,159,159,0
"dc60696c76a74368a60f72246e47700d","78adeee1fa2c4fe0bc73f7bca9fcee86",22851593,1,3,0,1715,159,160,1
"78adeee1fa2c4fe0bc73f7bca9fcee86","df1de691dafe4549a18a4398ee9dfaf9",22851593,2,-26,0,1716,160,139,-21
"df1de691dafe4549a18a4398ee9dfaf9","0c7262dff33c4087bc660ccf40f92f9c",22851593,1,43,0,1717,139,169,30
"0c7262dff33c4087bc660ccf40f92f9c","2024b4885bd14338a39b7b509acbbd02",22851593,1,16,0,1718,169,182,13
"2024b4885bd14338a39b7b509acbbd02","0c7262dff33c4087bc660ccf40f92f9c",22851593,2,-16,0,1719,182,169,-13
"0c7262dff33c4087bc660ccf40f92f9c","0c7262dff33c4087bc660ccf40f92f9c",22851593,3,0,1,1720,169,169,0
"cf4c280bad6a43e6b131d8385ef9ef3f","139b097acfca451689d80c9c6eebdf7b",22851593,1,-8,0,1724,184,178,-6
"139b097acfca451689d80c9c6eebdf7b","c3f63fe50d8e487c86bf8ef76c9cadd3",22851593,1,9,0,1725,178,185,7
"c3f63fe50d8e487c86bf8ef76c9cadd3","c3f63fe50d8e487c86bf8ef76c9cadd3",22851593,1,0,1,1726,185,185,0
"c3f63fe50d8e487c86bf8ef76c9cadd3","c8e371568a0c4391b25796ae4e91952e",22851593,1,3,0,1727,185,186,1
"c8e371568a0c4391b25796ae4e91952e","0c7262dff33c4087bc660ccf40f92f9c",22851593,2,-23,0,1728,186,169,-17
"f9170dd6bc6442b4acd832747609b09a","017d7ca8e0394b91aaadc9574df2202c",22851593,1,-7,0,1732,199,193,-6
"017d7ca8e0394b91aaadc9574df2202c","a6c21bd8b95249c7972820a7a7d76aff",22851593,1,10,0,1733,193,202,9
"a6c21bd8b95249c7972820a7a7d76aff","a6c21bd8b95249c7972820a7a7d76aff",22851593,1,0,1,1734,202,202,0
"a6c21bd8b95249c7972820a7a7d76aff","bb329d880ab54120adaf203a693bb203",22851593,1,1,0,1735,202,203,1
"bb329d880ab54120adaf203a693bb203","bb329d880ab54120adaf203a693bb203",22851593,2,0,1,1736,203,203,0
"bb329d880ab54120adaf203a693bb203","f9170dd6bc6442b4acd832747609b09a",22851593,1,-4,0,1738,203,199,-4
"f9170dd6bc6442b4acd832747609b09a","334c2344009840079b1d0e1b7ce3d5a7",22851593,1,7,0,1739,199,205,6
"334c2344009840079b1d0e1b7ce3d5a7","334c2344009840079b1d0e1b7ce3d5a7",22851593,1,0,1,1740,205,205,0
"334c2344009840079b1d0e1b7ce3d5a7","d7f13c8d63ec4e2aa673fbb9cf9c6933",22851593,1,3,0,1741,205,206,1
"c8e371568a0c4391b25796ae4e91952e","7108f0e4c2584f1f9c471689ae4c885c",22851593,1,28,0,1743,186,208,22
"d7f13c8d63ec4e2aa673fbb9cf9c6933","be95c065e45447c1bd8215ea6f130c7a",22851593,1,17,0,1746,206,219,13
"be95c065e45447c1bd8215ea6f130c7a","7108f0e4c2584f1f9c471689ae4c885c",22851593,1,-15,0,1747,219,208,-11
"d7f13c8d63ec4e2aa673fbb9cf9c6933","0c7262dff33c4087bc660ccf40f92f9c",22851593,1,-49,0,1750,206,169,-37
"0c7262dff33c4087bc660ccf40f92f9c","cf4c280bad6a43e6b131d8385ef9ef3f",22851593,1,19,0,1751,169,184,15
"cf4c280bad6a43e6b131d8385ef9ef3f","d7f13c8d63ec4e2aa673fbb9cf9c6933",22851593,1,30,0,1752,184,206,22
"d7f13c8d63ec4e2aa673fbb9cf9c6933","91125ca626c5470eb145501f8c37f8db",22851593,1,18,0,1753,206,220,14
"91125ca626c5470eb145501f8c37f8db","91125ca626c5470eb145501f8c37f8db",22851593,1,0,1,1754,220,220,0
"91125ca626c5470eb145501f8c37f8db","d7f13c8d63ec4e2aa673fbb9cf9c6933",22851593,1,-18,0,1755,220,206,-14
"1c6721b1f63f4d30ba7746ea8af02a52","d03cb855c70044cf8c35d9ec0de696e3",22851593,2,4,0,1759,221,224,3
"d03cb855c70044cf8c35d9ec0de696e3","8b9ae98743bd4d4a8a87dff1c1244211",22851593,2,3,0,1760,224,227,3
"8b9ae98743bd4d4a8a87dff1c1244211","f7906d6f59b9489a91d2ef40db5a474d",22851593,3,-4,0,1761,227,223,-4
"f7906d6f59b9489a91d2ef40db5a474d","2ab1535aac1346ba8801535bf729ef37",22851593,3,7,0,1762,223,229,6
"5152833676bf4c6cb317060be10f68db","8f68228b1518449e9615cdafee41a2bd",22851593,1,10,0,1764,228,237,9
"8f68228b1518449e9615cdafee41a2bd","8f68228b1518449e9615cdafee41a2bd",22851593,1,0,1,1765,237,237,0
"8f68228b1518449e9615cdafee41a2bd","66d4fad4f1cf4b46be0750a99ad7a35a",22851593,1,2,0,1766,237,239,2
"66d4fad4f1cf4b46be0750a99ad7a35a","66d4fad4f1cf4b46be0750a99ad7a35a",22851593,1,0,1,1767,239,239,0
"66d4fad4f1cf4b46be0750a99ad7a35a","0b04c8e2f86d48c7aeb7e225819cd32b",22851593,1,-5,0,1768,239,234,-5
"0b04c8e2f86d48c7aeb7e225819cd32b","f53da5fd9bfe412da4b80d4742563b6c",22851593,1,8,0,1769,234,241,7
"f53da5fd9bfe412da4b80d4742563b6c","f53da5fd9bfe412da4b80d4742563b6c",22851593,1,0,1,1770,241,241,0
"f53da5fd9bfe412da4b80d4742563b6c","1c6721b1f63f4d30ba7746ea8af02a52",22851593,1,-24,0,1771,241,221,-20
"2ae94c0cea4d480a9d5dca8fb1d7b542","30c9ba177afc49a695625d2bdec40207",22851593,1,9,0,1775,242,250,8
"30c9ba177afc49a695625d2bdec40207","30c9ba177afc49a695625d2bdec40207",22851593,3,0,1,1776,250,250,0
"30c9ba177afc49a695625d2bdec40207","00f61990949545828dd12f1303d47504",22851593,1,8,0,1779,250,256,6
"6e83e23f56544a19b94067c1c558d9c0","1c6721b1f63f4d30ba7746ea8af02a52",22851593,1,-33,0,1781,247,221,-26
"64dbedb3ce544f6aae8e10e0cf10f16d","0c7262dff33c4087bc660ccf40f92f9c",22851593,1,-93,0,1783,240,169,-71
"0c7262dff33c4087bc660ccf40f92f9c","94cecc3f1e7d484b8e068e79241dfd73",22851593,1,148,0,1784,169,281,112
"94cecc3f1e7d484b8e068e79241dfd73","a37477c4e4c14169ad44b06b493007f6",22851593,1,2,0,1785,281,283,2
"a37477c4e4c14169ad44b06b493007f6","fab84b4fab5940efb4ea868ef8d09396",22851593,2,3,0,1786,283,284,1
"fab84b4fab5940efb4ea868ef8d09396","94cecc3f1e7d484b8e068e79241dfd73",22851593,2,-5,0,1787,284,281,-3
"4a29443515bb404cb8924e1c60a63b73","ba0e59461bfb4a44b7b1c28a01f8d3b3",22851593,2,18,0,1792,285,299,14
"ba0e59461bfb4a44b7b1c28a01f8d3b3","6a9a3b5bde4a48daa896fe8c06eca56f",22851593,1,-13,0,1793,299,289,-10
"6a9a3b5bde4a48daa896fe8c06eca56f","ba0e59461bfb4a44b7b1c28a01f8d3b3",22851593,3,13,0,1794,289,299,10
"21592f2a9e9c4b2f8c66ec5dbcbf6a2b","7646a919d7e64fa990bca9b024ff089d",22851593,1,3,0,1805,296,298,2
"7646a919d7e64fa990bca9b024ff089d","208c9b2796c944db8dacaa96082520ea",22851593,1,-14,0,1806,298,288,-10
"208c9b2796c944db8dacaa96082520ea","2c5bb2cbd0014420ad8c95d40e38efd1",22851593,1,20,0,1807,288,303,15
"2c5bb2cbd0014420ad8c95d40e38efd1","208c9b2796c944db8dacaa96082520ea",22851593,1,-20,0,1808,303,288,-15
"21592f2a9e9c4b2f8c66ec5dbcbf6a2b","34a6e49023fc4465bd5ca604330bbd1c",22851593,1,-5,0,1823,296,292,-4
"34a6e49023fc4465bd5ca604330bbd1c","7646a919d7e64fa990bca9b024ff089d",22851593,1,8,0,1824,292,298,6
"7646a919d7e64fa990bca9b024ff089d","4a29443515bb404cb8924e1c60a63b73",22851593,2,-17,0,1825,298,285,-13
"3434c10e561d488a914e0f7d71907abd","86c27d40179e419c8e9d150fb6afa5d0",22851593,1,17,0,1829,305,319,14
"86c27d40179e419c8e9d150fb6afa5d0","0c787d16c9504873b1a4d903cec09948",22851593,1,-6,0,1830,319,314,-5
"0c787d16c9504873b1a4d903cec09948","8d7e0b55cf9849cda222a0f2440cec55",22851593,1,5,0,1831,314,318,4
"47edbb64109243e6b0f8f64cdef90c6c","24f1363179ad4aaa965484a78471912b",22851593,4,-3,0,1833,326,323,-3
"b8b9418ab322418d9db9b40d96af873a","c2490bc612d146edbe786556fab3651b",22851593,1,4,0,1841,337,340,3
"c2490bc612d146edbe786556fab3651b","0c4079457ede49e3aeb5e86ed84bdf35",22851593,1,-13,0,1842,340,329,-11
"0c4079457ede49e3aeb5e86ed84bdf35","30ead9794d4847abaf222ca966cc8630",22851593,1,24,0,1843,329,348,19
"30ead9794d4847abaf222ca966cc8630","897b7f51242c44aab2205c72fdcbf4cd",22851593,1,4,0,1844,348,352,4
"897b7f51242c44aab2205c72fdcbf4cd","eff0de7f2dbb42dfa1a2e686efab5b6d",22851593,1,2,0,1846,352,354,2
"897b7f51242c44aab2205c72fdcbf4cd","30ead9794d4847abaf222ca966cc8630",22851593,1,-4,0,1856,352,348,-4
"30ead9794d4847abaf222ca966cc8630","30ead9794d4847abaf222ca966cc8630",22851593,2,0,1,1857,348,348,0
"d6d02b6ef04e4f17805504500b8ce441","66baf19b6b904b70922329068c63746d",22851593,1,4,0,1872,375,376,1
"66baf19b6b904b70922329068c63746d","7f544639412e40a9ba27f43b415362ab",22851593,5,2,0,1873,376,378,2
"7f544639412e40a9ba27f43b415362ab","66baf19b6b904b70922329068c63746d",22851593,4,-2,0,1874,378,376,-2
"66baf19b6b904b70922329068c63746d","4890121ce5d74576b4632b77cfc23398",22851593,1,14,0,1877,376,388,12
"4890121ce5d74576b4632b77cfc23398","c2fca3669923477ab966ded303dea31c",22851593,1,-6,0,1878,388,383,-5
"c2fca3669923477ab966ded303dea31c","4890121ce5d74576b4632b77cfc23398",22851593,1,6,0,1879,383,388,5
"4890121ce5d74576b4632b77cfc23398","18d3b836dd804224883cc9180b60a8e1",22851593,3,-1,0,1880,388,387,-1
"18d3b836dd804224883cc9180b60a8e1","96bb2b3e85a34d8b9544514e89f6fe97",22851593,3,4,0,1881,387,390,3
"96bb2b3e85a34d8b9544514e89f6fe97","4890121ce5d74576b4632b77cfc23398",22851593,3,-3,0,1882,390,388,-2
"4890121ce5d74576b4632b77cfc23398","17f95d18bab743888e1736033dc3384d",22851593,3,2,0,1883,388,389,1
"17f95d18bab743888e1736033dc3384d","4890121ce5d74576b4632b77cfc23398",22851593,3,-2,0,1884,389,388,-1
"4890121ce5d74576b4632b77cfc23398","96bb2b3e85a34d8b9544514e89f6fe97",22851593,1,3,0,1890,388,390,2
"96bb2b3e85a34d8b9544514e89f6fe97","18d3b836dd804224883cc9180b60a8e1",22851593,1,-4,0,1891,390,387,-3
"18d3b836dd804224883cc9180b60a8e1","17f95d18bab743888e1736033dc3384d",22851593,1,3,0,1892,387,389,2
"17f95d18bab743888e1736033dc3384d","6f8881a745ac4c358a68b92c3b4abe81",22851593,2,6,0,1893,389,394,5
"6f8881a745ac4c358a68b92c3b4abe81","6f8881a745ac4c358a68b92c3b4abe81",22851593,1,0,1,1894,394,394,0
"6f8881a745ac4c358a68b92c3b4abe81","f7002c8484354eceac57bc7bd62c76c1",22851593,1,-1,0,1895,394,393,-1
"f7002c8484354eceac57bc7bd62c76c1","0c12af0a4e7f4002852cf84b2537c161",22851593,1,3,0,1896,393,395,2
"0c12af0a4e7f4002852cf84b2537c161","2b09a08242b54983aec7063990fb3f66",22851593,1,8,0,1897,395,400,5
"2b09a08242b54983aec7063990fb3f66","66baf19b6b904b70922329068c63746d",22851593,1,-32,0,1898,400,376,-24
"66baf19b6b904b70922329068c63746d","2b09a08242b54983aec7063990fb3f66",22851593,2,32,0,1899,376,400,24
"2b09a08242b54983aec7063990fb3f66","1f471b7a883a4df48211e8c6a81b59a7",22851593,1,1,0,1900,400,401,1
"1f471b7a883a4df48211e8c6a81b59a7","1f471b7a883a4df48211e8c6a81b59a7",22851593,2,0,1,1901,401,401,0
"1f471b7a883a4df48211e8c6a81b59a7","2b09a08242b54983aec7063990fb3f66",22851593,1,-1,0,1903,401,400,-1
"2b09a08242b54983aec7063990fb3f66","2b09a08242b54983aec7063990fb3f66",22851593,11,0,1,1904,400,400,0
"2b09a08242b54983aec7063990fb3f66","1157bd665ec4472fb58b751dc5099355",22851593,2,4,0,1905,400,403,3
"1157bd665ec4472fb58b751dc5099355","2b09a08242b54983aec7063990fb3f66",22851593,2,-4,0,1906,403,400,-3
"1157bd665ec4472fb58b751dc5099355","3c8a22d2f9c146ea956609e3ed4f2559",22851593,1,3,0,1910,403,405,2
"3c8a22d2f9c146ea956609e3ed4f2559","58fc9094275e4c49be3f4ba6d4acc0a4",22851593,4,2,0,1911,405,406,1
"58fc9094275e4c49be3f4ba6d4acc0a4","58fc9094275e4c49be3f4ba6d4acc0a4",22851593,4,0,1,1912,406,406,0
"58fc9094275e4c49be3f4ba6d4acc0a4","3c8a22d2f9c146ea956609e3ed4f2559",22851593,3,-2,0,1913,406,405,-1
"58fc9094275e4c49be3f4ba6d4acc0a4","c1c1be90b2b14c1ab4a5e1ee3c241902",22851593,1,1,0,1922,406,407,1
"c1c1be90b2b14c1ab4a5e1ee3c241902","c1c1be90b2b14c1ab4a5e1ee3c241902",22851593,5,0,1,1923,407,407,0
"c1c1be90b2b14c1ab4a5e1ee3c241902","02b3a1bead9244c1ba2f857c7da8f82a",22851593,1,2,0,1928,407,408,1
"02b3a1bead9244c1ba2f857c7da8f82a","58fc9094275e4c49be3f4ba6d4acc0a4",22851593,1,-3,0,1929,408,406,-2
"58fc9094275e4c49be3f4ba6d4acc0a4","6206fc6479014bb193084c32409dc1b9",22851593,1,4,0,1930,406,409,3
"6206fc6479014bb193084c32409dc1b9","6206fc6479014bb193084c32409dc1b9",22851593,4,0,1,1931,409,409,0
"6206fc6479014bb193084c32409dc1b9","02b3a1bead9244c1ba2f857c7da8f82a",22851593,1,-1,0,1935,409,408,-1
"02b3a1bead9244c1ba2f857c7da8f82a","02b3a1bead9244c1ba2f857c7da8f82a",22851593,3,0,1,1936,408,408,0
"02b3a1bead9244c1ba2f857c7da8f82a","6a5f020451db426dacba9e2ea3fcc62a",22851593,2,3,0,1937,408,410,2
"6a5f020451db426dacba9e2ea3fcc62a","6a5f020451db426dacba9e2ea3fcc62a",22851593,5,0,1,1938,410,410,0
"6a5f020451db426dacba9e2ea3fcc62a","02b3a1bead9244c1ba2f857c7da8f82a",22851593,1,-3,0,1939,410,408,-2
"6a5f020451db426dacba9e2ea3fcc62a","33a9d248b2e44588a5b07fc1342b9bc2",22851593,1,2,0,1945,410,411,1
"33a9d248b2e44588a5b07fc1342b9bc2","c6f26bd420634f1cb7989e76fe6b16c0",22851593,1,1,0,1946,411,412,1
"c6f26bd420634f1cb7989e76fe6b16c0","c6f26bd420634f1cb7989e76fe6b16c0",22851593,5,0,1,1947,412,412,0
"c6f26bd420634f1cb7989e76fe6b16c0","33a9d248b2e44588a5b07fc1342b9bc2",22851593,1,-1,0,1952,412,411,-1
"33a9d248b2e44588a5b07fc1342b9bc2","33a9d248b2e44588a5b07fc1342b9bc2",22851593,1,0,1,1953,411,411,0
"33a9d248b2e44588a5b07fc1342b9bc2","2a65ee6e2ac64f6a8a55fbe5373ec763",22851593,1,2,0,1954,411,413,2
"2a65ee6e2ac64f6a8a55fbe5373ec763","2a65ee6e2ac64f6a8a55fbe5373ec763",22851593,2,0,1,1955,413,413,0
"2a65ee6e2ac64f6a8a55fbe5373ec763","33a9d248b2e44588a5b07fc1342b9bc2",22851593,1,-2,0,1957,413,411,-2
"33a9d248b2e44588a5b07fc1342b9bc2","687055dad9fc40c3982478fe33ec01bf",22851593,1,4,0,1958,411,414,3
"687055dad9fc40c3982478fe33ec01bf","2b09a08242b54983aec7063990fb3f66",22851593,1,-21,0,1959,414,400,-14
"2b09a08242b54983aec7063990fb3f66","a2b4bd40cee2481ebd3fc179d6a5cd62",22851593,3,27,0,1960,400,417,17
"a2b4bd40cee2481ebd3fc179d6a5cd62","bec48fc2e1294c7eb3d0aca780d731b8",22851593,2,4,0,1961,417,420,3
"bec48fc2e1294c7eb3d0aca780d731b8","a2b4bd40cee2481ebd3fc179d6a5cd62",22851593,1,-4,0,1962,420,417,-3
"bec48fc2e1294c7eb3d0aca780d731b8","bec48fc2e1294c7eb3d0aca780d731b8",22851593,5,0,1,1964,420,420,0
"bec48fc2e1294c7eb3d0aca780d731b8","dbde19fcce2a4c1abdc7f685c293a23f",22851593,3,3,0,1965,420,422,2
"dbde19fcce2a4c1abdc7f685c293a23f","bec48fc2e1294c7eb3d0aca780d731b8",22851593,2,-3,0,1966,422,420,-2
"dbde19fcce2a4c1abdc7f685c293a23f","a24600b0e49245f6bdba8c893cfeddb0",22851593,1,4,0,1974,422,425,3
"a24600b0e49245f6bdba8c893cfeddb0","a24600b0e49245f6bdba8c893cfeddb0",22851593,4,0,1,1975,425,425,0
"a24600b0e49245f6bdba8c893cfeddb0","5d290f75e44b4bdb8256c600debbb44d",22851593,1,2,0,1977,425,426,1
"5d290f75e44b4bdb8256c600debbb44d","a24600b0e49245f6bdba8c893cfeddb0",22851593,1,-2,0,1978,426,425,-1
"a24600b0e49245f6bdba8c893cfeddb0","24cf8786024543f19b89bc20034e60d7",22851593,1,7,0,1981,425,428,3
"24cf8786024543f19b89bc20034e60d7","a2b4bd40cee2481ebd3fc179d6a5cd62",22851593,4,-18,0,1982,428,417,-11
"a2b4bd40cee2481ebd3fc179d6a5cd62","f2a73be2f46840b182d7bd095378004e",22851593,1,19,0,1983,417,429,12
"f2a73be2f46840b182d7bd095378004e","a2b4bd40cee2481ebd3fc179d6a5cd62",22851593,2,-19,0,1984,429,417,-12
"a2b4bd40cee2481ebd3fc179d6a5cd62","24cf8786024543f19b89bc20034e60d7",22851593,6,18,0,1985,417,428,11
"24cf8786024543f19b89bc20034e60d7","f2a73be2f46840b182d7bd095378004e",22851593,5,1,0,1988,428,429,1
"f2a73be2f46840b182d7bd095378004e","604551fd4266430cb860fef58fa7dd61",22851593,2,1,0,1989,429,430,1
"604551fd4266430cb860fef58fa7dd61","f2a73be2f46840b182d7bd095378004e",22851593,1,-1,0,1990,430,429,-1
"604551fd4266430cb860fef58fa7dd61","604551fd4266430cb860fef58fa7dd61",22851593,1,0,1,1992,430,430,0
"604551fd4266430cb860fef58fa7dd61","24cf8786024543f19b89bc20034e60d7",22851593,1,-2,0,1993,430,428,-2
"24cf8786024543f19b89bc20034e60d7","dce46f8904594a62a6377a3587aaa663",22851593,4,4,0,1994,428,431,3
"dce46f8904594a62a6377a3587aaa663","dce46f8904594a62a6377a3587aaa663",22851593,5,0,1,1995,431,431,0
"dce46f8904594a62a6377a3587aaa663","f2a73be2f46840b182d7bd095378004e",22851593,4,-3,0,1996,431,429,-2
"f2a73be2f46840b182d7bd095378004e","f2a73be2f46840b182d7bd095378004e",22851593,4,0,1,1997,429,429,0
"f2a73be2f46840b182d7bd095378004e","24cf8786024543f19b89bc20034e60d7",22851593,6,-1,0,1998,429,428,-1
"dce46f8904594a62a6377a3587aaa663","9b9d0a249052413c869753b99682b0ac",22851593,1,1,0,2005,431,432,1
"9b9d0a249052413c869753b99682b0ac","9b9d0a249052413c869753b99682b0ac",22851593,4,0,1,2006,432,432,0
"9b9d0a249052413c869753b99682b0ac","061c175cc90f45fbad883025394e78dd",22851593,1,1,0,2010,432,433,1
"061c175cc90f45fbad883025394e78dd","061c175cc90f45fbad883025394e78dd",22851593,5,0,1,2011,433,433,0
"061c175cc90f45fbad883025394e78dd","dce46f8904594a62a6377a3587aaa663",22851593,2,-2,0,2016,433,431,-2
"dce46f8904594a62a6377a3587aaa663","66ada10dde9f43018588f1ced9d477fc",22851593,1,4,0,2018,431,434,3
"66ada10dde9f43018588f1ced9d477fc","24cf8786024543f19b89bc20034e60d7",22851593,2,-8,0,2019,434,428,-6
"24cf8786024543f19b89bc20034e60d7","070600601c4c439288445d2f0724807d",22851593,1,14,0,2020,428,437,9
"070600601c4c439288445d2f0724807d","1823b6de7d334a7aaabc4570719af4d9",22851593,1,2,0,2021,437,439,2
"1823b6de7d334a7aaabc4570719af4d9","1823b6de7d334a7aaabc4570719af4d9",22851593,24,0,1,2022,439,439,0
"1823b6de7d334a7aaabc4570719af4d9","070600601c4c439288445d2f0724807d",22851593,2,-2,0,2034,439,437,-2
"070600601c4c439288445d2f0724807d","0380cd76a7d44bc3a4da1f15e4d68f89",22851593,4,4,0,2035,437,440,3
"0380cd76a7d44bc3a4da1f15e4d68f89","0380cd76a7d44bc3a4da1f15e4d68f89",22851593,8,0,1,2036,440,440,0
"0380cd76a7d44bc3a4da1f15e4d68f89","1823b6de7d334a7aaabc4570719af4d9",22851593,1,-2,0,2037,440,439,-1
"0380cd76a7d44bc3a4da1f15e4d68f89","23b7673c8b5443108c2ef09382834a86",22851593,1,2,0,2054,440,441,1
"23b7673c8b5443108c2ef09382834a86","23b7673c8b5443108c2ef09382834a86",22851593,1,0,1,2055,441,441,0
"23b7673c8b5443108c2ef09382834a86","901e92500aea43c79f19f1b279050668",22851593,1,2,0,2056,441,442,1
"901e92500aea43c79f19f1b279050668","23b7673c8b5443108c2ef09382834a86",22851593,1,-2,0,2057,442,441,-1
"23b7673c8b5443108c2ef09382834a86","452745e0366e42ae81561bfddebcc6c3",22851593,1,4,0,2058,441,444,3
"452745e0366e42ae81561bfddebcc6c3","452745e0366e42ae81561bfddebcc6c3",22851593,8,0,1,2059,444,444,0
"452745e0366e42ae81561bfddebcc6c3","901e92500aea43c79f19f1b279050668",22851593,1,-2,0,2065,444,442,-2
"901e92500aea43c79f19f1b279050668","452745e0366e42ae81561bfddebcc6c3",22851593,1,2,0,2066,442,444,2
"452745e0366e42ae81561bfddebcc6c3","001339db8ced4cf78829ebe8b145449d",22851593,1,-1,0,2069,444,443,-1
"001339db8ced4cf78829ebe8b145449d","001339db8ced4cf78829ebe8b145449d",22851593,12,0,1,2070,443,443,0
"001339db8ced4cf78829ebe8b145449d","901e92500aea43c79f19f1b279050668",22851593,1,-1,0,2082,443,442,-1
"901e92500aea43c79f19f1b279050668","4660ff2089114e8db82ceb26a4f329e3",22851593,1,4,0,2083,442,445,3
"4660ff2089114e8db82ceb26a4f329e3","4660ff2089114e8db82ceb26a4f329e3",22851593,4,0,1,2084,445,445,0
"4660ff2089114e8db82ceb26a4f329e3","7bd5586eb9d8484eb74a433ee7bfe499",22851593,2,2,0,2086,445,446,1
"7bd5586eb9d8484eb74a433ee7bfe499","7bd5586eb9d8484eb74a433ee7bfe499",22851593,13,0,1,2087,446,446,0
"7bd5586eb9d8484eb74a433ee7bfe499","4660ff2089114e8db82ceb26a4f329e3",22851593,3,-2,0,2088,446,445,-1
"7bd5586eb9d8484eb74a433ee7bfe499","070600601c4c439288445d2f0724807d",22851593,1,-14,0,2099,446,437,-9
"070600601c4c439288445d2f0724807d","b2f0d654738f48158edff28e8d3a546e",22851593,1,21,0,2100,437,449,12
"b2f0d654738f48158edff28e8d3a546e","b2f0d654738f48158edff28e8d3a546e",22851593,2,0,1,2101,449,449,0
"b2f0d654738f48158edff28e8d3a546e","f60ee41ec635499abd48168342d32c2f",22851593,1,5,0,2102,449,453,4
"f60ee41ec635499abd48168342d32c2f","f60ee41ec635499abd48168342d32c2f",22851593,7,0,1,2103,453,453,0
"f60ee41ec635499abd48168342d32c2f","b2f0d654738f48158edff28e8d3a546e",22851593,1,-5,0,2110,453,449,-4
"b2f0d654738f48158edff28e8d3a546e","f67fbf45a5f146ed866965bc57c7c001",22851593,1,8,0,2111,449,454,5
"f67fbf45a5f146ed866965bc57c7c001","4a29443515bb404cb8924e1c60a63b73",22851593,1,-242,0,2112,454,285,-169
"4a29443515bb404cb8924e1c60a63b73","b2f0d654738f48158edff28e8d3a546e",22851593,1,234,0,2113,285,449,164
"b2f0d654738f48158edff28e8d3a546e","4a29443515bb404cb8924e1c60a63b73",22851593,1,-234,0,2114,449,285,-164
"4a29443515bb404cb8924e1c60a63b73","2c5bb2cbd0014420ad8c95d40e38efd1",22851593,1,23,0,2115,285,303,18
"2c5bb2cbd0014420ad8c95d40e38efd1","7669a956527947d0add87455277e80b4",22851593,1,-16,0,2116,303,291,-12
"7669a956527947d0add87455277e80b4","7669a956527947d0add87455277e80b4",22851593,1,0,1,2117,291,291,0
"7669a956527947d0add87455277e80b4","6a9a3b5bde4a48daa896fe8c06eca56f",22851593,1,-2,0,2118,291,289,-2
"ba0e59461bfb4a44b7b1c28a01f8d3b3","2c5bb2cbd0014420ad8c95d40e38efd1",22851593,1,5,0,2120,299,303,4
"2c5bb2cbd0014420ad8c95d40e38efd1","4a29443515bb404cb8924e1c60a63b73",22851593,1,-23,0,2121,303,285,-18
"7646a919d7e64fa990bca9b024ff089d","e390b575229748ea8aac9364efe2bf00",22851593,1,7,0,2124,298,304,6
"e390b575229748ea8aac9364efe2bf00","e390b575229748ea8aac9364efe2bf00",22851593,1,0,1,2125,304,304,0
"e390b575229748ea8aac9364efe2bf00","4a29443515bb404cb8924e1c60a63b73",22851593,1,-24,0,2126,304,285,-19
"3434c10e561d488a914e0f7d71907abd","3434c10e561d488a914e0f7d71907abd",22851593,2,0,1,2131,305,305,0
"3434c10e561d488a914e0f7d71907abd","b7719e26494940efa49512aedd0aac79",22851593,1,-393,0,2132,305,20,-285
"b7719e26494940efa49512aedd0aac79","d4f45188d3c84a02ba08454e6403a818",22851593,4,5,0,2133,20,24,4
"d4f45188d3c84a02ba08454e6403a818","d4c3b003e8274e429d2fa688d73fde6d",22851593,5,-2,0,2134,24,22,-2
"d4c3b003e8274e429d2fa688d73fde6d","b613861cecf84ffcab01afb23f660475",22851593,2,-35,0,2135,22,1,-21
"b613861cecf84ffcab01afb23f660475","e2911e79efc2420eac45d9f671463d4b",22851593,3,3,0,2137,1,2,1
"e2911e79efc2420eac45d9f671463d4b","e2911e79efc2420eac45d9f671463d4b",22851593,3,0,1,2138,2,2,0
"e2911e79efc2420eac45d9f671463d4b","519d1b8c59404d67b54e96c5c8a830b2",22851593,2,1,0,2139,2,3,1
"dd5cf0b9fe4c4f1d8f5ff8e4c04879cb","f96261861edc426abe2248be4f0a709a",22851593,3,1,0,2144,7,8,1
"f96261861edc426abe2248be4f0a709a","66b5e16f4f75454fb5b8172079f0fa83",22851593,2,1,0,2145,8,9,1
"66b5e16f4f75454fb5b8172079f0fa83","0680571d4698477995e41842c36a54b2",22851593,1,1,0,2146,9,10,1
"0680571d4698477995e41842c36a54b2","9112f2bffece48e08c6d2287be204085",22851593,1,1,0,2147,10,11,1
"9112f2bffece48e08c6d2287be204085","e2911e79efc2420eac45d9f671463d4b",22851593,1,-9,0,2148,11,2,-9
"e2911e79efc2420eac45d9f671463d4b","56586aa865414f538729c7f7735d2bc6",22851593,4,12,0,2149,2,12,10
"56586aa865414f538729c7f7735d2bc6","56586aa865414f538729c7f7735d2bc6",22851593,21,0,1,2150,12,12,0
"56586aa865414f538729c7f7735d2bc6","b7f2b31585d94eb3bf86376714aa7070",22851593,4,2,0,2151,12,13,1
"b7f2b31585d94eb3bf86376714aa7070","56586aa865414f538729c7f7735d2bc6",22851593,2,-2,0,2152,13,12,-1
"b7f2b31585d94eb3bf86376714aa7070","3f1c815879794b929260d224becaff7e",22851593,2,2,0,2154,13,14,1
"3f1c815879794b929260d224becaff7e","5c5ceeee4562457ba6d41515aeebfbb1",22851593,1,6,0,2155,14,17,3
"5c5ceeee4562457ba6d41515aeebfbb1","81c864a886d54a6b8ff85f7d736f4f95",22851593,1,-4,0,2156,17,15,-2
"81c864a886d54a6b8ff85f7d736f4f95","56586aa865414f538729c7f7735d2bc6",22851593,1,-6,0,2157,15,12,-3
"56586aa865414f538729c7f7735d2bc6","9afd71a5298d4333b6849dfce1b9422c",22851593,3,13,0,2158,12,18,6
"9afd71a5298d4333b6849dfce1b9422c","9afd71a5298d4333b6849dfce1b9422c",22851593,3,0,1,2159,18,18,0
"9afd71a5298d4333b6849dfce1b9422c","b7719e26494940efa49512aedd0aac79",22851593,5,4,0,2160,18,20,2
"b7719e26494940efa49512aedd0aac79","4e51676dc72045d99c19b9fa7b22f8bc",22851593,1,15,0,2166,20,29,9
"4e51676dc72045d99c19b9fa7b22f8bc","afbf7250b99d47bea07172749483ca97",22851593,1,-3,0,2167,29,28,-1
"c33c17be71ae4d588da7369472e5bb1b","c33c17be71ae4d588da7369472e5bb1b",22851593,4,0,1,2172,34,34,0
"7040a13096d746ac84b8fac8d9752058","93679be414554a11b1893002f2229a93",22851593,1,-3,0,2175,36,35,-1
"93679be414554a11b1893002f2229a93","9a0dc646f934470daf08c4b56ccf73db",22851593,1,6,0,2176,35,37,2
"7040a13096d746ac84b8fac8d9752058","fc0e049d56024bc9a02c9a9c435c3df7",22851593,1,6,0,2178,36,38,2
"fc0e049d56024bc9a02c9a9c435c3df7","9a0dc646f934470daf08c4b56ccf73db",22851593,1,-3,0,2179,38,37,-1
"9a0dc646f934470daf08c4b56ccf73db","67a089198fcb4e1c8f2385786c2b296f",22851593,1,7,0,2180,37,39,2
"b534b89233134e30a9b5645138bfa9ee","6e13d61a7bdb44bca949c9f86fab3be5",22851593,2,7,0,2186,41,47,6
"6e13d61a7bdb44bca949c9f86fab3be5","d0c74f735e024943943e40333d6d337f",22851593,1,5,0,2187,47,51,4
"d0c74f735e024943943e40333d6d337f","d9c8d8c444a64dadbbb508652c721e17",22851593,2,-6,0,2188,51,46,-5
"d9c8d8c444a64dadbbb508652c721e17","f924752d8a1149668870b1e7698486f7",22851593,1,5,0,2189,46,50,4
"f924752d8a1149668870b1e7698486f7","a1f2f12debe5432fb7a70bcd12bacfb9",22851593,2,9,0,2190,50,58,8
"78f30e4dcac84e3cbea8b2cc6e0d62b3","a0a418b8540d479fa6e0f653b701da8b",22851593,1,6,0,2192,59,64,5
"a0a418b8540d479fa6e0f653b701da8b","a0a418b8540d479fa6e0f653b701da8b",22851593,4,0,1,2193,64,64,0
"bc42d26810654ea9a1df1efe1e58c7d5","bc42d26810654ea9a1df1efe1e58c7d5",22851593,5,0,1,2195,63,63,0
"b534b89233134e30a9b5645138bfa9ee","a2becd407db34b189200a32546d9d569",22851593,1,42,0,2202,41,75,34
"a2becd407db34b189200a32546d9d569","d646286c8051419bbc2e31dd1db55ca8",22851593,2,-9,0,2203,75,67,-8
"d646286c8051419bbc2e31dd1db55ca8","140d5b27b8574befad82c0a013b59dfa",22851593,2,8,0,2204,67,74,7
"140d5b27b8574befad82c0a013b59dfa","d18a9ea32855445f8736581f5cb119ce",22851593,2,9,0,2205,74,82,8
"6a9f0ef185fb47f0937e29daa1c71ed5","6a9f0ef185fb47f0937e29daa1c71ed5",22851593,5,0,1,2207,90,90,0
"ae5ac430ea254e708a6f5deaaf7464ae","6a9f0ef185fb47f0937e29daa1c71ed5",22851593,2,7,0,2209,84,90,6
"6a9f0ef185fb47f0937e29daa1c71ed5","e20db35ced8544ddac5bc3839145e463",22851593,1,3,0,2210,90,91,1
"e20db35ced8544ddac5bc3839145e463","d646286c8051419bbc2e31dd1db55ca8",22851593,2,-30,0,2211,91,67,-24
"d646286c8051419bbc2e31dd1db55ca8","00ae5f0c51874a73a41ebea838d95682",22851593,1,41,0,2212,67,101,34
"00ae5f0c51874a73a41ebea838d95682","e20db35ced8544ddac5bc3839145e463",22851593,1,-11,0,2213,101,91,-10
"d391c8b6e56a43a7b654e9dee02d904b","4280927ec4d643238aa49c32f9e06c6c",22851593,1,7,0,2215,103,109,6
"4280927ec4d643238aa49c32f9e06c6c","73039f8c1eb9409cb4caee2cf968001e",22851593,2,-10,0,2216,109,100,-9
"08111f75e22d409998cf8b85bd431f0a","a9ae0a3c070d455bb4369a8996313336",22851593,1,7,0,2218,108,114,6
"a9ae0a3c070d455bb4369a8996313336","62bff51286ef4f348717a3cf6fe2318f",22851593,2,7,0,2219,114,120,6
"37319e88176d4aefa91d7a9980dbae91","779f9ddd1fd14d1e9e69f72219a1fdbd",22851593,1,12,0,2223,112,121,9
"779f9ddd1fd14d1e9e69f72219a1fdbd","e20db35ced8544ddac5bc3839145e463",22851593,2,-36,0,2224,121,91,-30
"e20db35ced8544ddac5bc3839145e463","a8dd5213034441ac92724b4e83eb0bb2",22851593,1,45,0,2225,91,129,38
"a8dd5213034441ac92724b4e83eb0bb2","779f9ddd1fd14d1e9e69f72219a1fdbd",22851593,2,-9,0,2226,129,121,-8
"779f9ddd1fd14d1e9e69f72219a1fdbd","579338175e0b4bbb8ef3b712b5d8b54e",22851593,1,8,0,2227,121,128,7
"6c5ad271a44743479bfaea29b1db8d02","8aae34f5ddbb4052a709b12e6b0d40fa",22851593,1,5,0,2232,143,147,4
"df1de691dafe4549a18a4398ee9dfaf9","78adeee1fa2c4fe0bc73f7bca9fcee86",22851593,2,26,0,2240,139,160,21
"78adeee1fa2c4fe0bc73f7bca9fcee86","78adeee1fa2c4fe0bc73f7bca9fcee86",22851593,1,0,1,2241,160,160,0
"78adeee1fa2c4fe0bc73f7bca9fcee86","65202579580f4ad38d734b4ee39d22a8",22851593,7,5,0,2242,160,164,4
"65202579580f4ad38d734b4ee39d22a8","65202579580f4ad38d734b4ee39d22a8",22851593,49,0,1,2243,164,164,0
"65202579580f4ad38d734b4ee39d22a8","3cbcea2be0984e7dbd5a48195af10ce7",22851593,2,3,0,2250,164,165,1
"3cbcea2be0984e7dbd5a48195af10ce7","78adeee1fa2c4fe0bc73f7bca9fcee86",22851593,3,-8,0,2251,165,160,-5
"78adeee1fa2c4fe0bc73f7bca9fcee86","82e6285962b8400d9d6fc32436022a94",22851593,3,10,0,2252,160,167,7
"0c7262dff33c4087bc660ccf40f92f9c","b2275c3fad834f8d90737a2d9a6927d6",22851593,3,3,0,2257,169,172,3
"b2275c3fad834f8d90737a2d9a6927d6","b42cc17b7de840f181a704558d0bc845",22851593,1,4,0,2258,172,175,3
"b42cc17b7de840f181a704558d0bc845","0c7262dff33c4087bc660ccf40f92f9c",22851593,1,-7,0,2259,175,169,-6
"0c7262dff33c4087bc660ccf40f92f9c","362fcb0699a14845ab29b2340093e528",22851593,1,6,0,2260,169,174,5
"362fcb0699a14845ab29b2340093e528","ea38cc0e6e6e41edbabf210220808bf9",22851593,2,6,0,2261,174,179,5
"139b097acfca451689d80c9c6eebdf7b","2024b4885bd14338a39b7b509acbbd02",22851593,4,5,0,2264,178,182,4
"c8e371568a0c4391b25796ae4e91952e","ab11d94c6c8948ea90b88f19d2cd502b",22851593,3,5,0,2268,186,190,4
"ab11d94c6c8948ea90b88f19d2cd502b","07b44a7a51e94c78b411c753fc39dab0",22851593,2,-1,0,2269,190,189,-1
"07b44a7a51e94c78b411c753fc39dab0","6cd2dcaac46847d4a0bc53f296d90375",22851593,3,6,0,2270,189,194,5
"6cd2dcaac46847d4a0bc53f296d90375","017d7ca8e0394b91aaadc9574df2202c",22851593,2,-1,0,2271,194,193,-1
"017d7ca8e0394b91aaadc9574df2202c","f9170dd6bc6442b4acd832747609b09a",22851593,1,7,0,2272,193,199,6
"f9170dd6bc6442b4acd832747609b09a","d7f13c8d63ec4e2aa673fbb9cf9c6933",22851593,2,10,0,2273,199,206,7
"7108f0e4c2584f1f9c471689ae4c885c","09400e101c5d4b439cf9a26b03aae558",22851593,1,3,0,2277,208,210,2
"09400e101c5d4b439cf9a26b03aae558","d7f13c8d63ec4e2aa673fbb9cf9c6933",22851593,1,-5,0,2278,210,206,-4
"2ae94c0cea4d480a9d5dca8fb1d7b542","00f61990949545828dd12f1303d47504",22851593,1,17,0,2299,242,256,14
"6e83e23f56544a19b94067c1c558d9c0","d546341988904f069cfa86b21457d9d9",22851593,1,5,0,2301,247,251,4
"d546341988904f069cfa86b21457d9d9","d989ebcfc12a4b669f0100dc1aa14f1e",22851593,1,5,0,2302,251,255,4
"d989ebcfc12a4b669f0100dc1aa14f1e","7aa76d3e993840d8805f097cbdbcd44b",22851593,1,7,0,2303,255,261,6
"0d987bed3ffa4ed0b9a2e62e97b7b30f","82ae07bc0c9b4570a41799290d1ef399",22851593,1,4,0,2307,272,275,3
"94cecc3f1e7d484b8e068e79241dfd73","4a29443515bb404cb8924e1c60a63b73",22851593,1,9,0,2321,281,285,4
"4a29443515bb404cb8924e1c60a63b73","fab84b4fab5940efb4ea868ef8d09396",22851593,1,-4,0,2322,285,284,-1
"fab84b4fab5940efb4ea868ef8d09396","208c9b2796c944db8dacaa96082520ea",22851593,1,7,0,2323,284,288,4
"6a9a3b5bde4a48daa896fe8c06eca56f","34a6e49023fc4465bd5ca604330bbd1c",22851593,1,4,0,2327,289,292,3
"34a6e49023fc4465bd5ca604330bbd1c","21592f2a9e9c4b2f8c66ec5dbcbf6a2b",22851593,1,5,0,2328,292,296,4
"141c0df6cd1946539aadd1c9b7068cd4","3434c10e561d488a914e0f7d71907abd",22851593,1,-4,0,2337,308,305,-3
"3434c10e561d488a914e0f7d71907abd","30ead9794d4847abaf222ca966cc8630",22851593,1,55,0,2338,305,348,43
"30ead9794d4847abaf222ca966cc8630","3434c10e561d488a914e0f7d71907abd",22851593,1,-55,0,2340,348,305,-43
"4a92daef4d504e1792575a26502bb7b7","a7c6339ca1da4368a18d471f0519f877",22851593,1,-9,0,2347,346,339,-7
"a7c6339ca1da4368a18d471f0519f877","a7c6339ca1da4368a18d471f0519f877",22851593,1,0,1,2348,339,339,0
"a7c6339ca1da4368a18d471f0519f877","b8b9418ab322418d9db9b40d96af873a",22851593,1,-2,0,2349,339,337,-2
"b8b9418ab322418d9db9b40d96af873a","38aea304b4fa46e1b29bb72f5cea4c93",22851593,1,-7,0,2350,337,331,-6
"38aea304b4fa46e1b29bb72f5cea4c93","4a92daef4d504e1792575a26502bb7b7",22851593,1,18,0,2351,331,346,15
"4a92daef4d504e1792575a26502bb7b7","38aea304b4fa46e1b29bb72f5cea4c93",22851593,1,-18,0,2352,346,331,-15
"0c4079457ede49e3aeb5e86ed84bdf35","6ac8bb048b854999a47edb35fe627f11",22851593,1,21,0,2354,329,347,18
"6ac8bb048b854999a47edb35fe627f11","6ac8bb048b854999a47edb35fe627f11",22851593,1,0,1,2355,347,347,0
"6ac8bb048b854999a47edb35fe627f11","3434c10e561d488a914e0f7d71907abd",22851593,1,-52,0,2356,347,305,-42
"3434c10e561d488a914e0f7d71907abd","13255e63e0aa4abf85e5211bf613d43e",22851593,1,14,0,2358,305,317,12
"13255e63e0aa4abf85e5211bf613d43e","13255e63e0aa4abf85e5211bf613d43e",22851593,1,0,1,2359,317,317,0
"13255e63e0aa4abf85e5211bf613d43e","3434c10e561d488a914e0f7d71907abd",22851593,1,-14,0,2360,317,305,-12
"3434c10e561d488a914e0f7d71907abd","0c787d16c9504873b1a4d903cec09948",22851593,1,11,0,2361,305,314,9
"0c787d16c9504873b1a4d903cec09948","24f1363179ad4aaa965484a78471912b",22851593,1,11,0,2362,314,323,9
"24f1363179ad4aaa965484a78471912b","47edbb64109243e6b0f8f64cdef90c6c",22851593,3,3,0,2363,323,326,3
"47edbb64109243e6b0f8f64cdef90c6c","3628bdce1dd2429ba924d2d4d09448d2",22851593,1,-4,0,2364,326,322,-4
"3628bdce1dd2429ba924d2d4d09448d2","86c27d40179e419c8e9d150fb6afa5d0",22851593,1,-4,0,2365,322,319,-3
"86c27d40179e419c8e9d150fb6afa5d0","43ea1b823a4b4e51b7c694c10725db82",22851593,1,10,0,2366,319,327,8
"43ea1b823a4b4e51b7c694c10725db82","86c27d40179e419c8e9d150fb6afa5d0",22851593,1,-10,0,2367,327,319,-8
"3434c10e561d488a914e0f7d71907abd","56b3fd1a212a4764be39d979fde3326e",22851593,1,28,0,2374,305,328,23
"56b3fd1a212a4764be39d979fde3326e","56b3fd1a212a4764be39d979fde3326e",22851593,1,0,1,2375,328,328,0
"56b3fd1a212a4764be39d979fde3326e","3434c10e561d488a914e0f7d71907abd",22851593,1,-28,0,2376,328,305,-23
"38aea304b4fa46e1b29bb72f5cea4c93","30ead9794d4847abaf222ca966cc8630",22851593,1,22,0,2379,331,348,17
"30ead9794d4847abaf222ca966cc8630","cfa457d1743848e4bb5e4beced6448ed",22851593,1,25,0,2380,348,369,21
"cfa457d1743848e4bb5e4beced6448ed","cfa457d1743848e4bb5e4beced6448ed",22851593,1,0,1,2381,369,369,0
"cfa457d1743848e4bb5e4beced6448ed","30ead9794d4847abaf222ca966cc8630",22851593,1,-25,0,2382,369,348,-21
"b71bac264efb4abd97015447bd490db6","66baf19b6b904b70922329068c63746d",22851593,1,12,0,2384,370,376,6
"7f544639412e40a9ba27f43b415362ab","7f544639412e40a9ba27f43b415362ab",22851593,6,0,1,2386,378,378,0
"7f544639412e40a9ba27f43b415362ab","a0d10309a2dd456289147f84be9d37f9",22851593,1,3,0,2388,378,381,3
"a0d10309a2dd456289147f84be9d37f9","7f544639412e40a9ba27f43b415362ab",22851593,1,-3,0,2389,381,378,-3
"7f544639412e40a9ba27f43b415362ab","070600601c4c439288445d2f0724807d",22851593,1,89,0,2391,378,437,59
"070600601c4c439288445d2f0724807d","8a7f26e690f34dda97be16904518ca99",22851593,2,16,0,2392,437,447,10
"8a7f26e690f34dda97be16904518ca99","7bd5586eb9d8484eb74a433ee7bfe499",22851593,2,-2,0,2393,447,446,-1
"4660ff2089114e8db82ceb26a4f329e3","8a7f26e690f34dda97be16904518ca99",22851593,1,4,0,2400,445,447,2
"4660ff2089114e8db82ceb26a4f329e3","0380cd76a7d44bc3a4da1f15e4d68f89",22851593,1,-8,0,2403,445,440,-5
"0380cd76a7d44bc3a4da1f15e4d68f89","7bd5586eb9d8484eb74a433ee7bfe499",22851593,1,10,0,2404,440,446,6
"7bd5586eb9d8484eb74a433ee7bfe499","0380cd76a7d44bc3a4da1f15e4d68f89",22851593,1,-10,0,2405,446,440,-6
"0380cd76a7d44bc3a4da1f15e4d68f89","070600601c4c439288445d2f0724807d",22851593,2,-4,0,2407,440,437,-3
"070600601c4c439288445d2f0724807d","a2b4bd40cee2481ebd3fc179d6a5cd62",22851593,1,-32,0,2408,437,417,-20
"a2b4bd40cee2481ebd3fc179d6a5cd62","a2b4bd40cee2481ebd3fc179d6a5cd62",22851593,5,0,1,2409,417,417,0
"24cf8786024543f19b89bc20034e60d7","66ada10dde9f43018588f1ced9d477fc",22851593,2,8,0,2413,428,434,6
"66ada10dde9f43018588f1ced9d477fc","dce46f8904594a62a6377a3587aaa663",22851593,2,-4,0,2414,434,431,-3
"a2b4bd40cee2481ebd3fc179d6a5cd62","5d290f75e44b4bdb8256c600debbb44d",22851593,2,13,0,2419,417,426,9
"5d290f75e44b4bdb8256c600debbb44d","a2b4bd40cee2481ebd3fc179d6a5cd62",22851593,2,-13,0,2420,426,417,-9
"a2b4bd40cee2481ebd3fc179d6a5cd62","2b09a08242b54983aec7063990fb3f66",22851593,2,-27,0,2421,417,400,-17
"a2b4bd40cee2481ebd3fc179d6a5cd62","070600601c4c439288445d2f0724807d",22851593,1,32,0,2425,417,437,20
"070600601c4c439288445d2f0724807d","070600601c4c439288445d2f0724807d",22851593,1,0,1,2426,437,437,0
"0380cd76a7d44bc3a4da1f15e4d68f89","8a7f26e690f34dda97be16904518ca99",22851593,2,12,0,2428,440,447,7
"8a7f26e690f34dda97be16904518ca99","0380cd76a7d44bc3a4da1f15e4d68f89",22851593,2,-12,0,2429,447,440,-7
"0380cd76a7d44bc3a4da1f15e4d68f89","d6d02b6ef04e4f17805504500b8ce441",22851593,1,-99,0,2430,440,375,-65
"d6d02b6ef04e4f17805504500b8ce441","4a29443515bb404cb8924e1c60a63b73",22851593,2,-118,0,2434,375,285,-90
"3434c10e561d488a914e0f7d71907abd","3628bdce1dd2429ba924d2d4d09448d2",22851593,1,21,0,2436,305,322,17
"3628bdce1dd2429ba924d2d4d09448d2","47edbb64109243e6b0f8f64cdef90c6c",22851593,1,4,0,2437,322,326,4
"24f1363179ad4aaa965484a78471912b","070600601c4c439288445d2f0724807d",22851593,1,164,0,2439,323,437,114
"8a7f26e690f34dda97be16904518ca99","8a7f26e690f34dda97be16904518ca99",22851593,1,0,1,2449,447,447,0
"8a7f26e690f34dda97be16904518ca99","24cf8786024543f19b89bc20034e60d7",22851593,1,-30,0,2450,447,428,-19
"f2a73be2f46840b182d7bd095378004e","dce46f8904594a62a6377a3587aaa663",22851593,1,3,0,2456,429,431,2
"dce46f8904594a62a6377a3587aaa663","a2b4bd40cee2481ebd3fc179d6a5cd62",22851593,1,-22,0,2457,431,417,-14
"dce46f8904594a62a6377a3587aaa663","061c175cc90f45fbad883025394e78dd",22851593,1,2,0,2466,431,433,2
"dce46f8904594a62a6377a3587aaa663","74a7f8712e5449c2bc0b43c6f90dafed",22851593,1,5,0,2469,431,435,4
"74a7f8712e5449c2bc0b43c6f90dafed","74a7f8712e5449c2bc0b43c6f90dafed",22851593,1,0,1,2470,435,435,0
"74a7f8712e5449c2bc0b43c6f90dafed","66ada10dde9f43018588f1ced9d477fc",22851593,1,-1,0,2471,435,434,-1
"24cf8786024543f19b89bc20034e60d7","bf12c96466d840a69bed7020b3f18bb8",22851593,1,11,0,2473,428,436,8
"bf12c96466d840a69bed7020b3f18bb8","bf12c96466d840a69bed7020b3f18bb8",22851593,1,0,1,2474,436,436,0
"bf12c96466d840a69bed7020b3f18bb8","a2b4bd40cee2481ebd3fc179d6a5cd62",22851593,1,-29,0,2475,436,417,-19
"a2b4bd40cee2481ebd3fc179d6a5cd62","e34e59dce2204f228f3a84b6725df60f",22851593,1,2,0,2483,417,419,2
"e34e59dce2204f228f3a84b6725df60f","e34e59dce2204f228f3a84b6725df60f",22851593,1,0,1,2484,419,419,0
"e34e59dce2204f228f3a84b6725df60f","a2b4bd40cee2481ebd3fc179d6a5cd62",22851593,1,-2,0,2485,419,417,-2
"a2b4bd40cee2481ebd3fc179d6a5cd62","2add1669f08d4101913db15f8c23b3b7",22851593,1,-3,0,2489,417,416,-1
"2add1669f08d4101913db15f8c23b3b7","1157bd665ec4472fb58b751dc5099355",22851593,1,-20,0,2490,416,403,-13
"1157bd665ec4472fb58b751dc5099355","1157bd665ec4472fb58b751dc5099355",22851593,1,0,1,2491,403,403,0
"2b09a08242b54983aec7063990fb3f66","2add1669f08d4101913db15f8c23b3b7",22851593,1,24,0,2496,400,416,16
"2add1669f08d4101913db15f8c23b3b7","9de0d567bfa84fe5b77cb76f4a76a5d1",22851593,1,-19,0,2497,416,404,-12
"9de0d567bfa84fe5b77cb76f4a76a5d1","9de0d567bfa84fe5b77cb76f4a76a5d1",22851593,1,0,1,2498,404,404,0
"9de0d567bfa84fe5b77cb76f4a76a5d1","66baf19b6b904b70922329068c63746d",22851593,1,-37,0,2499,404,376,-28
"7f544639412e40a9ba27f43b415362ab","d5ae8642e15b46b8bd298b02274d4e9c",22851593,1,2,0,2503,378,380,2
"d5ae8642e15b46b8bd298b02274d4e9c","d5ae8642e15b46b8bd298b02274d4e9c",22851593,2,0,1,2504,380,380,0
"d5ae8642e15b46b8bd298b02274d4e9c","a0d10309a2dd456289147f84be9d37f9",22851593,1,1,0,2506,380,381,1
"a0d10309a2dd456289147f84be9d37f9","a0d10309a2dd456289147f84be9d37f9",22851593,2,0,1,2507,381,381,0
"a0d10309a2dd456289147f84be9d37f9","0fcbc3ca07b144138b8d85da581f09a8",22851593,1,1,0,2509,381,382,1
"0fcbc3ca07b144138b8d85da581f09a8","0fcbc3ca07b144138b8d85da581f09a8",22851593,3,0,1,2510,382,382,0
"0fcbc3ca07b144138b8d85da581f09a8","66baf19b6b904b70922329068c63746d",22851593,1,-6,0,2513,382,376,-6
"66baf19b6b904b70922329068c63746d","c2fca3669923477ab966ded303dea31c",22851593,2,8,0,2514,376,383,7
"c2fca3669923477ab966ded303dea31c","7f544639412e40a9ba27f43b415362ab",22851593,1,-6,0,2515,383,378,-5
"c2fca3669923477ab966ded303dea31c","96bb2b3e85a34d8b9544514e89f6fe97",22851593,1,9,0,2519,383,390,7
"96bb2b3e85a34d8b9544514e89f6fe97","66baf19b6b904b70922329068c63746d",22851593,1,-17,0,2520,390,376,-14
"66baf19b6b904b70922329068c63746d","96bb2b3e85a34d8b9544514e89f6fe97",22851593,2,17,0,2521,376,390,14
"96bb2b3e85a34d8b9544514e89f6fe97","96bb2b3e85a34d8b9544514e89f6fe97",22851593,3,0,1,2522,390,390,0
"96bb2b3e85a34d8b9544514e89f6fe97","17f95d18bab743888e1736033dc3384d",22851593,1,-1,0,2530,390,389,-1
"17f95d18bab743888e1736033dc3384d","7f544639412e40a9ba27f43b415362ab",22851593,1,-14,0,2531,389,378,-11
"7f544639412e40a9ba27f43b415362ab","c2fca3669923477ab966ded303dea31c",22851593,1,6,0,2532,378,383,5
"c2fca3669923477ab966ded303dea31c","66baf19b6b904b70922329068c63746d",22851593,1,-8,0,2533,383,376,-7
"96bb2b3e85a34d8b9544514e89f6fe97","ac4e9b54acfe4670b4634859c7263cb5",22851593,1,2,0,2535,390,392,2
"ac4e9b54acfe4670b4634859c7263cb5","ac4e9b54acfe4670b4634859c7263cb5",22851593,1,0,1,2536,392,392,0
"ac4e9b54acfe4670b4634859c7263cb5","17f95d18bab743888e1736033dc3384d",22851593,1,-3,0,2537,392,389,-3
"6f8881a745ac4c358a68b92c3b4abe81","96bb2b3e85a34d8b9544514e89f6fe97",22851593,1,-5,0,2539,394,390,-4
"96bb2b3e85a34d8b9544514e89f6fe97","f7002c8484354eceac57bc7bd62c76c1",22851593,1,4,0,2540,390,393,3
"f7002c8484354eceac57bc7bd62c76c1","96bb2b3e85a34d8b9544514e89f6fe97",22851593,1,-4,0,2541,393,390,-3
"96bb2b3e85a34d8b9544514e89f6fe97","6f8881a745ac4c358a68b92c3b4abe81",22851593,1,5,0,2542,390,394,4
"6f8881a745ac4c358a68b92c3b4abe81","17f95d18bab743888e1736033dc3384d",22851593,1,-6,0,2543,394,389,-5
"17f95d18bab743888e1736033dc3384d","f7002c8484354eceac57bc7bd62c76c1",22851593,1,5,0,2544,389,393,4
"f7002c8484354eceac57bc7bd62c76c1","44a277ea44dc4ae689fab4b82f0b4098",22851593,1,5,0,2545,393,397,4
"44a277ea44dc4ae689fab4b82f0b4098","44a277ea44dc4ae689fab4b82f0b4098",22851593,1,0,1,2546,397,397,0
"44a277ea44dc4ae689fab4b82f0b4098","0c12af0a4e7f4002852cf84b2537c161",22851593,1,-2,0,2547,397,395,-2
"0c12af0a4e7f4002852cf84b2537c161","6f8881a745ac4c358a68b92c3b4abe81",22851593,1,-2,0,2548,395,394,-1
"6f8881a745ac4c358a68b92c3b4abe81","df8191ec5e584c838a899c378941a566",22851593,1,6,0,2549,394,398,4
"df8191ec5e584c838a899c378941a566","f7002c8484354eceac57bc7bd62c76c1",22851593,1,-7,0,2550,398,393,-5
"f7002c8484354eceac57bc7bd62c76c1","4890121ce5d74576b4632b77cfc23398",22851593,1,-7,0,2551,393,388,-5
"4890121ce5d74576b4632b77cfc23398","df8191ec5e584c838a899c378941a566",22851593,1,14,0,2552,388,398,10
"df8191ec5e584c838a899c378941a566","18d3b836dd804224883cc9180b60a8e1",22851593,1,-15,0,2553,398,387,-11
"18d3b836dd804224883cc9180b60a8e1","df8191ec5e584c838a899c378941a566",22851593,1,15,0,2554,387,398,11
"df8191ec5e584c838a899c378941a566","7f544639412e40a9ba27f43b415362ab",22851593,1,-26,0,2555,398,378,-20
"66baf19b6b904b70922329068c63746d","859e0b8d71694b12befb69ee698138f9",22851593,1,29,0,2557,376,399,23
"859e0b8d71694b12befb69ee698138f9","859e0b8d71694b12befb69ee698138f9",22851593,1,0,1,2558,399,399,0
"859e0b8d71694b12befb69ee698138f9","66baf19b6b904b70922329068c63746d",22851593,1,-29,0,2559,399,376,-23
"2b09a08242b54983aec7063990fb3f66","1fd0f6dadbc14ebc965faf6122190b96",22851593,1,22,0,2565,400,415,15
"1fd0f6dadbc14ebc965faf6122190b96","1fd0f6dadbc14ebc965faf6122190b96",22851593,1,0,1,2566,415,415,0
"1fd0f6dadbc14ebc965faf6122190b96","687055dad9fc40c3982478fe33ec01bf",22851593,1,-1,0,2567,415,414,-1
"687055dad9fc40c3982478fe33ec01bf","2add1669f08d4101913db15f8c23b3b7",22851593,1,3,0,2568,414,416,2
"2add1669f08d4101913db15f8c23b3b7","6a5f020451db426dacba9e2ea3fcc62a",22851593,2,-9,0,2569,416,410,-6
"6a5f020451db426dacba9e2ea3fcc62a","2add1669f08d4101913db15f8c23b3b7",22851593,2,9,0,2572,410,416,6
"2add1669f08d4101913db15f8c23b3b7","2add1669f08d4101913db15f8c23b3b7",22851593,1,0,1,2575,416,416,0
"2add1669f08d4101913db15f8c23b3b7","f67fbf45a5f146ed866965bc57c7c001",22851593,1,64,0,2576,416,454,38
"f67fbf45a5f146ed866965bc57c7c001","f67fbf45a5f146ed866965bc57c7c001",22851593,2,0,1,2577,454,454,0
"f67fbf45a5f146ed866965bc57c7c001","d937afe49bd24a07a550dda1c1155122",22851593,1,1,0,2579,454,455,1
"d937afe49bd24a07a550dda1c1155122","d937afe49bd24a07a550dda1c1155122",22851593,1,0,1,2580,455,455,0
"d937afe49bd24a07a550dda1c1155122","3628b3f7823443d0912a339096b69943",22851593,1,1,0,2581,455,456,1
"3628b3f7823443d0912a339096b69943","3628b3f7823443d0912a339096b69943",22851593,1,0,1,2582,456,456,0
"3628b3f7823443d0912a339096b69943","9e049ee647cf43ecbcb5ed792a8e7588",22851593,1,1,0,2583,456,457,1
"9e049ee647cf43ecbcb5ed792a8e7588","9e049ee647cf43ecbcb5ed792a8e7588",22851593,1,0,1,2584,457,457,0
"9e049ee647cf43ecbcb5ed792a8e7588","5256a214faaf410b93f76cea06428334",22851593,1,1,0,2585,457,458,1
"5256a214faaf410b93f76cea06428334","5256a214faaf410b93f76cea06428334",22851593,1,0,1,2586,458,458,0
"5256a214faaf410b93f76cea06428334","25c32b120fce40fa9b6c85133aeb4716",22851593,1,1,0,2587,458,459,1
"25c32b120fce40fa9b6c85133aeb4716","25c32b120fce40fa9b6c85133aeb4716",22851593,5,0,1,2588,459,459,0
"25c32b120fce40fa9b6c85133aeb4716","11bc14f2204949008b7d511b933363c1",22851593,1,1,0,2593,459,460,1
"11bc14f2204949008b7d511b933363c1","11bc14f2204949008b7d511b933363c1",22851593,1,0,1,2594,460,460,0
"11bc14f2204949008b7d511b933363c1","42de338840a34d15adb66e7b14fb9d2c",22851593,1,1,0,2595,460,461,1
"42de338840a34d15adb66e7b14fb9d2c","42de338840a34d15adb66e7b14fb9d2c",22851593,1,0,1,2596,461,461,0
"42de338840a34d15adb66e7b14fb9d2c","9da37c6210b1416b8079c274f70bf600",22851593,1,1,0,2597,461,462,1
"9da37c6210b1416b8079c274f70bf600","9da37c6210b1416b8079c274f70bf600",22851593,1,0,1,2598,462,462,0
"9da37c6210b1416b8079c274f70bf600","519119f1deac45ff9ab4f13529be5c6e",22851593,1,1,0,2599,462,463,1
"519119f1deac45ff9ab4f13529be5c6e","519119f1deac45ff9ab4f13529be5c6e",22851593,1,0,1,2600,463,463,0
"519119f1deac45ff9ab4f13529be5c6e","f67fbf45a5f146ed866965bc57c7c001",22851593,1,-9,0,2601,463,454,-9
"f67fbf45a5f146ed866965bc57c7c001","c5df9f40ec14463b9dcfdc73df3e9285",22851593,1,12,0,2602,454,464,10
"c5df9f40ec14463b9dcfdc73df3e9285","c5df9f40ec14463b9dcfdc73df3e9285",22851593,11,0,1,2603,464,464,0
"c5df9f40ec14463b9dcfdc73df3e9285","83d42d95cd844fc093fc09cee250edb8",22851593,4,3,0,2605,464,465,1
"83d42d95cd844fc093fc09cee250edb8","83d42d95cd844fc093fc09cee250edb8",22851593,12,0,1,2606,465,465,0
"83d42d95cd844fc093fc09cee250edb8","c5df9f40ec14463b9dcfdc73df3e9285",22851593,2,-3,0,2607,465,464,-1
"83d42d95cd844fc093fc09cee250edb8","78adeee1fa2c4fe0bc73f7bca9fcee86",22851593,1,-431,0,2620,465,160,-305
"65202579580f4ad38d734b4ee39d22a8","8959e6304a0348309a771e4d08d1b64a",22851593,2,-1,0,2629,164,163,-1
"8959e6304a0348309a771e4d08d1b64a","78adeee1fa2c4fe0bc73f7bca9fcee86",22851593,3,-4,0,2630,163,160,-3
"78adeee1fa2c4fe0bc73f7bca9fcee86","0d987bed3ffa4ed0b9a2e62e97b7b30f",22851593,1,152,0,2631,160,272,112
"bc5524e78a8544e2ae2fdc2f3462bbec","82ae07bc0c9b4570a41799290d1ef399",22851593,1,-5,0,2641,279,275,-4
"82ae07bc0c9b4570a41799290d1ef399","0d987bed3ffa4ed0b9a2e62e97b7b30f",22851593,1,-4,0,2642,275,272,-3
"0d987bed3ffa4ed0b9a2e62e97b7b30f","b71bac264efb4abd97015447bd490db6",22851593,1,132,0,2643,272,370,98
"b71bac264efb4abd97015447bd490db6","3628bdce1dd2429ba924d2d4d09448d2",22851593,1,-62,0,2644,370,322,-48
"3434c10e561d488a914e0f7d71907abd","47edbb64109243e6b0f8f64cdef90c6c",22851593,1,25,0,2646,305,326,21
"24f1363179ad4aaa965484a78471912b","24f1363179ad4aaa965484a78471912b",22851593,4,0,1,2648,323,323,0
"3628bdce1dd2429ba924d2d4d09448d2","43ea1b823a4b4e51b7c694c10725db82",22851593,1,6,0,2653,322,327,5
"47edbb64109243e6b0f8f64cdef90c6c","d6d02b6ef04e4f17805504500b8ce441",22851593,2,66,0,2656,326,375,49
"4a29443515bb404cb8924e1c60a63b73","d6d02b6ef04e4f17805504500b8ce441",22851593,1,118,0,2660,285,375,90
"1b4550d0dab04078b3bf08a655345bdc","b71bac264efb4abd97015447bd490db6",22851593,1,-4,0,2678,373,370,-3
"b71bac264efb4abd97015447bd490db6","30ead9794d4847abaf222ca966cc8630",22851593,2,-28,0,2679,370,348,-22
"30ead9794d4847abaf222ca966cc8630","c76574d21bc14aeea7ecd0b027f39858",22851593,1,23,0,2680,348,367,19
"c76574d21bc14aeea7ecd0b027f39858","492a3bc6a1254f23a7998587961b22a4",22851593,1,-2,0,2681,367,366,-1
"f00179e251a045b39c3f7a54f9aa4acc","1ba8fef685d74a8194b9db252eb704fb",22851593,1,-9,0,2687,363,355,-8
"072a190fd302456290895f9f04d6940a","f00179e251a045b39c3f7a54f9aa4acc",22851593,1,-3,0,2691,365,363,-2
"492a3bc6a1254f23a7998587961b22a4","b71bac264efb4abd97015447bd490db6",22851593,1,7,0,2693,366,370,4
"d6d02b6ef04e4f17805504500b8ce441","3434c10e561d488a914e0f7d71907abd",22851593,1,-91,0,2712,375,305,-70
"3434c10e561d488a914e0f7d71907abd","24f1363179ad4aaa965484a78471912b",22851593,1,22,0,2713,305,323,18
"d6d02b6ef04e4f17805504500b8ce441","c5df9f40ec14463b9dcfdc73df3e9285",22851593,2,136,0,2719,375,464,89
"c5df9f40ec14463b9dcfdc73df3e9285","d6d02b6ef04e4f17805504500b8ce441",22851593,1,-136,0,2722,464,375,-89
"c5df9f40ec14463b9dcfdc73df3e9285","66baf19b6b904b70922329068c63746d",22851593,2,-132,0,2729,464,376,-88
"66baf19b6b904b70922329068c63746d","c5df9f40ec14463b9dcfdc73df3e9285",22851593,1,132,0,2730,376,464,88
"66baf19b6b904b70922329068c63746d","66baf19b6b904b70922329068c63746d",22851593,2,0,1,2736,376,376,0
"7f544639412e40a9ba27f43b415362ab","c5df9f40ec14463b9dcfdc73df3e9285",22851593,1,130,0,2739,378,464,86
"83d42d95cd844fc093fc09cee250edb8","c33c17be71ae4d588da7369472e5bb1b",22851593,1,-599,0,2744,465,34,-431
"c33c17be71ae4d588da7369472e5bb1b","b7719e26494940efa49512aedd0aac79",22851593,1,-24,0,2749,34,20,-14
"4e51676dc72045d99c19b9fa7b22f8bc","b613861cecf84ffcab01afb23f660475",22851593,1,-47,0,2754,29,1,-28
"b613861cecf84ffcab01afb23f660475","d6d02b6ef04e4f17805504500b8ce441",22851593,1,516,0,2755,1,375,374
"8d448d625b024c82a5eb240bbd7431d6","b2f0d654738f48158edff28e8d3a546e",22851593,1,119,0,2767,374,449,75
"b2f0d654738f48158edff28e8d3a546e","c33c17be71ae4d588da7369472e5bb1b",22851593,1,-576,0,2768,449,34,-415
"c33c17be71ae4d588da7369472e5bb1b","a49d1bb4328949299686242fd0be5584",22851593,1,-22,0,2769,34,21,-13
"a49d1bb4328949299686242fd0be5584","b7719e26494940efa49512aedd0aac79",22851593,1,-2,0,2770,21,20,-1
"b7719e26494940efa49512aedd0aac79","d4c3b003e8274e429d2fa688d73fde6d",22851593,2,3,0,2771,20,22,2
"d4c3b003e8274e429d2fa688d73fde6d","a49d1bb4328949299686242fd0be5584",22851593,1,-1,0,2772,22,21,-1
"a49d1bb4328949299686242fd0be5584","d4f45188d3c84a02ba08454e6403a818",22851593,1,3,0,2773,21,24,3
"d4f45188d3c84a02ba08454e6403a818","512364d4619742bb9e4e531f07ceaed7",22851593,1,597,0,2774,24,451,427
"512364d4619742bb9e4e531f07ceaed7","512364d4619742bb9e4e531f07ceaed7",22851593,1,0,1,2775,451,451,0
"512364d4619742bb9e4e531f07ceaed7","b2f0d654738f48158edff28e8d3a546e",22851593,1,-2,0,2776,451,449,-2
"b613861cecf84ffcab01afb23f660475","b613861cecf84ffcab01afb23f660475",22851664,5,0,1,1,1,1,0
"b613861cecf84ffcab01afb23f660475","e2911e79efc2420eac45d9f671463d4b",22851664,1,3,0,5,1,2,1
"e2911e79efc2420eac45d9f671463d4b","e2911e79efc2420eac45d9f671463d4b",22851664,4,0,1,6,2,2,0
"e2911e79efc2420eac45d9f671463d4b","519d1b8c59404d67b54e96c5c8a830b2",22851664,1,1,0,9,2,3,1
"519d1b8c59404d67b54e96c5c8a830b2","519d1b8c59404d67b54e96c5c8a830b2",22851664,1,0,1,10,3,3,0
"519d1b8c59404d67b54e96c5c8a830b2","531db53f81f646edb0cdcfe0085b03b7",22851664,1,1,0,11,3,4,1
"531db53f81f646edb0cdcfe0085b03b7","531db53f81f646edb0cdcfe0085b03b7",22851664,1,0,1,12,4,4,0
"531db53f81f646edb0cdcfe0085b03b7","4f5f94b2f95141e0a9d53a61da2276da",22851664,1,1,0,13,4,5,1
"4f5f94b2f95141e0a9d53a61da2276da","4f5f94b2f95141e0a9d53a61da2276da",22851664,1,0,1,14,5,5,0
"4f5f94b2f95141e0a9d53a61da2276da","6d541c89590949f99af293c4f2333f67",22851664,1,1,0,15,5,6,1
"6d541c89590949f99af293c4f2333f67","6d541c89590949f99af293c4f2333f67",22851664,1,0,1,16,6,6,0
"6d541c89590949f99af293c4f2333f67","dd5cf0b9fe4c4f1d8f5ff8e4c04879cb",22851664,1,1,0,17,6,7,1
"dd5cf0b9fe4c4f1d8f5ff8e4c04879cb","dd5cf0b9fe4c4f1d8f5ff8e4c04879cb",22851664,1,0,1,18,7,7,0
"dd5cf0b9fe4c4f1d8f5ff8e4c04879cb","f96261861edc426abe2248be4f0a709a",22851664,1,1,0,19,7,8,1
"f96261861edc426abe2248be4f0a709a","f96261861edc426abe2248be4f0a709a",22851664,2,0,1,20,8,8,0
"f96261861edc426abe2248be4f0a709a","66b5e16f4f75454fb5b8172079f0fa83",22851664,1,1,0,22,8,9,1
"66b5e16f4f75454fb5b8172079f0fa83","66b5e16f4f75454fb5b8172079f0fa83",22851664,2,0,1,23,9,9,0
"66b5e16f4f75454fb5b8172079f0fa83","0680571d4698477995e41842c36a54b2",22851664,1,1,0,25,9,10,1
"0680571d4698477995e41842c36a54b2","0680571d4698477995e41842c36a54b2",22851664,2,0,1,26,10,10,0
"0680571d4698477995e41842c36a54b2","9112f2bffece48e08c6d2287be204085",22851664,1,1,0,28,10,11,1
"9112f2bffece48e08c6d2287be204085","9112f2bffece48e08c6d2287be204085",22851664,2,0,1,29,11,11,0
"9112f2bffece48e08c6d2287be204085","e2911e79efc2420eac45d9f671463d4b",22851664,1,-9,0,31,11,2,-9
"e2911e79efc2420eac45d9f671463d4b","56586aa865414f538729c7f7735d2bc6",22851664,2,12,0,32,2,12,10
"b7f2b31585d94eb3bf86376714aa7070","56586aa865414f538729c7f7735d2bc6",22851664,2,-2,0,40,13,12,-1
"3f1c815879794b929260d224becaff7e","fc0e049d56024bc9a02c9a9c435c3df7",22851664,1,49,0,46,14,38,24
"fc0e049d56024bc9a02c9a9c435c3df7","9a0dc646f934470daf08c4b56ccf73db",22851664,1,-3,0,49,38,37,-1
"9a0dc646f934470daf08c4b56ccf73db","b613861cecf84ffcab01afb23f660475",22851664,1,-65,0,50,37,1,-36
"b613861cecf84ffcab01afb23f660475","fc0e049d56024bc9a02c9a9c435c3df7",22851664,1,68,0,51,1,38,37
"fc0e049d56024bc9a02c9a9c435c3df7","b613861cecf84ffcab01afb23f660475",22851664,1,-68,0,54,38,1,-37
"b613861cecf84ffcab01afb23f660475","67a089198fcb4e1c8f2385786c2b296f",22851664,1,72,0,56,1,39,38
"64d48c6c9c7940639a932219a6c87198","e2911e79efc2420eac45d9f671463d4b",22851664,1,-70,0,59,40,2,-38
"3f1c815879794b929260d224becaff7e","56586aa865414f538729c7f7735d2bc6",22851664,1,-4,0,67,14,12,-2
"81c864a886d54a6b8ff85f7d736f4f95","5c5ceeee4562457ba6d41515aeebfbb1",22851664,1,4,0,75,15,17,2
"5c5ceeee4562457ba6d41515aeebfbb1","5c5ceeee4562457ba6d41515aeebfbb1",22851664,1,0,1,76,17,17,0
"5c5ceeee4562457ba6d41515aeebfbb1","56586aa865414f538729c7f7735d2bc6",22851664,1,-10,0,77,17,12,-5
"9afd71a5298d4333b6849dfce1b9422c","b613861cecf84ffcab01afb23f660475",22851664,1,-28,0,81,18,1,-17
"b613861cecf84ffcab01afb23f660475","a49d1bb4328949299686242fd0be5584",22851664,1,34,0,82,1,21,20
"afbf7250b99d47bea07172749483ca97","afbf7250b99d47bea07172749483ca97",22851664,1,0,1,86,28,28,0
"51970cfa30e643e894e66ae85c8024cc","c33c17be71ae4d588da7369472e5bb1b",22851664,1,6,0,92,31,34,3
"c33c17be71ae4d588da7369472e5bb1b","4e51676dc72045d99c19b9fa7b22f8bc",22851664,1,-9,0,93,34,29,-5
"93679be414554a11b1893002f2229a93","93679be414554a11b1893002f2229a93",22851664,1,0,1,96,35,35,0
"9a0dc646f934470daf08c4b56ccf73db","7040a13096d746ac84b8fac8d9752058",22851664,1,-3,0,99,37,36,-1
"7040a13096d746ac84b8fac8d9752058","9a0dc646f934470daf08c4b56ccf73db",22851664,3,3,0,100,36,37,1
"9a0dc646f934470daf08c4b56ccf73db","fc0e049d56024bc9a02c9a9c435c3df7",22851664,2,3,0,101,37,38,1
"fc0e049d56024bc9a02c9a9c435c3df7","fc0e049d56024bc9a02c9a9c435c3df7",22851664,5,0,1,102,38,38,0
"fc0e049d56024bc9a02c9a9c435c3df7","67a089198fcb4e1c8f2385786c2b296f",22851664,4,4,0,103,38,39,1
"67a089198fcb4e1c8f2385786c2b296f","64d48c6c9c7940639a932219a6c87198",22851664,7,1,0,104,39,40,1
"64d48c6c9c7940639a932219a6c87198","64d48c6c9c7940639a932219a6c87198",22851664,3,0,1,105,40,40,0
"64d48c6c9c7940639a932219a6c87198","67a089198fcb4e1c8f2385786c2b296f",22851664,6,-1,0,106,40,39,-1
"67a089198fcb4e1c8f2385786c2b296f","b534b89233134e30a9b5645138bfa9ee",22851664,4,4,0,107,39,41,2
"b534b89233134e30a9b5645138bfa9ee","67a089198fcb4e1c8f2385786c2b296f",22851664,2,-4,0,108,41,39,-2
"b534b89233134e30a9b5645138bfa9ee","64d48c6c9c7940639a932219a6c87198",22851664,1,-3,0,110,41,40,-1
"b534b89233134e30a9b5645138bfa9ee","0e37b720d23b4e7f8b313e79313fd107",22851664,1,3,0,114,41,44,3
"0e37b720d23b4e7f8b313e79313fd107","0e37b720d23b4e7f8b313e79313fd107",22851664,2,0,1,115,44,44,0
"0e37b720d23b4e7f8b313e79313fd107","6875d67fdd5f48168b62719df449bebd",22851664,1,1,0,117,44,45,1
"6875d67fdd5f48168b62719df449bebd","6875d67fdd5f48168b62719df449bebd",22851664,2,0,1,118,45,45,0
"6875d67fdd5f48168b62719df449bebd","b534b89233134e30a9b5645138bfa9ee",22851664,1,-4,0,120,45,41,-4
"b534b89233134e30a9b5645138bfa9ee","6e13d61a7bdb44bca949c9f86fab3be5",22851664,2,7,0,121,41,47,6
"6e13d61a7bdb44bca949c9f86fab3be5","6e13d61a7bdb44bca949c9f86fab3be5",22851664,1,0,1,122,47,47,0
"6e13d61a7bdb44bca949c9f86fab3be5","195f78799f984cc2b06c48dfe36be751",22851664,1,2,0,123,47,49,2
"195f78799f984cc2b06c48dfe36be751","195f78799f984cc2b06c48dfe36be751",22851664,3,0,1,124,49,49,0
"195f78799f984cc2b06c48dfe36be751","d9c8d8c444a64dadbbb508652c721e17",22851664,1,-3,0,127,49,46,-3
"d9c8d8c444a64dadbbb508652c721e17","d0c74f735e024943943e40333d6d337f",22851664,2,6,0,128,46,51,5
"d0c74f735e024943943e40333d6d337f","d0c74f735e024943943e40333d6d337f",22851664,1,0,1,129,51,51,0
"d0c74f735e024943943e40333d6d337f","983f8ff320594b279a7f4a6fe132f9c5",22851664,1,2,0,130,51,53,2
"983f8ff320594b279a7f4a6fe132f9c5","983f8ff320594b279a7f4a6fe132f9c5",22851664,2,0,1,131,53,53,0
"983f8ff320594b279a7f4a6fe132f9c5","35adfa5d923046aebabfefd98f35ff05",22851664,1,1,0,133,53,54,1
"35adfa5d923046aebabfefd98f35ff05","35adfa5d923046aebabfefd98f35ff05",22851664,5,0,1,134,54,54,0
"35adfa5d923046aebabfefd98f35ff05","b6f8a98476224da1b40e555ececc7ed8",22851664,1,1,0,139,54,55,1
"b6f8a98476224da1b40e555ececc7ed8","b6f8a98476224da1b40e555ececc7ed8",22851664,2,0,1,140,55,55,0
"b6f8a98476224da1b40e555ececc7ed8","86e22cb5fe0e4b47a9489ecddf7ed78f",22851664,1,1,0,142,55,56,1
"86e22cb5fe0e4b47a9489ecddf7ed78f","86e22cb5fe0e4b47a9489ecddf7ed78f",22851664,2,0,1,143,56,56,0
"86e22cb5fe0e4b47a9489ecddf7ed78f","f924752d8a1149668870b1e7698486f7",22851664,1,-6,0,145,56,50,-6
"f924752d8a1149668870b1e7698486f7","78f30e4dcac84e3cbea8b2cc6e0d62b3",22851664,2,10,0,146,50,59,9
"78f30e4dcac84e3cbea8b2cc6e0d62b3","a1f2f12debe5432fb7a70bcd12bacfb9",22851664,2,-1,0,147,59,58,-1
"a1f2f12debe5432fb7a70bcd12bacfb9","67a089198fcb4e1c8f2385786c2b296f",22851664,1,-24,0,148,58,39,-19
"64d48c6c9c7940639a932219a6c87198","b534b89233134e30a9b5645138bfa9ee",22851664,1,3,0,150,40,41,1
"b534b89233134e30a9b5645138bfa9ee","d0c74f735e024943943e40333d6d337f",22851664,1,12,0,151,41,51,10
"d0c74f735e024943943e40333d6d337f","fc0e049d56024bc9a02c9a9c435c3df7",22851664,1,-20,0,152,51,38,-13
"67a089198fcb4e1c8f2385786c2b296f","fc0e049d56024bc9a02c9a9c435c3df7",22851664,2,-4,0,154,39,38,-1
"67a089198fcb4e1c8f2385786c2b296f","12aa6e1672ac4e7aa6449a7a8609cd72",22851664,1,23,0,160,39,57,18
"12aa6e1672ac4e7aa6449a7a8609cd72","b534b89233134e30a9b5645138bfa9ee",22851664,1,-19,0,161,57,41,-16
"b534b89233134e30a9b5645138bfa9ee","78f30e4dcac84e3cbea8b2cc6e0d62b3",22851664,1,21,0,162,41,59,18
"a1f2f12debe5432fb7a70bcd12bacfb9","a1f2f12debe5432fb7a70bcd12bacfb9",22851664,24,0,1,164,58,58,0
"a1f2f12debe5432fb7a70bcd12bacfb9","78f30e4dcac84e3cbea8b2cc6e0d62b3",22851664,1,1,0,188,58,59,1
"78f30e4dcac84e3cbea8b2cc6e0d62b3","78f30e4dcac84e3cbea8b2cc6e0d62b3",22851664,11,0,1,189,59,59,0
"78f30e4dcac84e3cbea8b2cc6e0d62b3","12aa6e1672ac4e7aa6449a7a8609cd72",22851664,1,-2,0,200,59,57,-2
"12aa6e1672ac4e7aa6449a7a8609cd72","a0a418b8540d479fa6e0f653b701da8b",22851664,2,8,0,201,57,64,7
"a0a418b8540d479fa6e0f653b701da8b","bc42d26810654ea9a1df1efe1e58c7d5",22851664,2,-1,0,202,64,63,-1
"bc42d26810654ea9a1df1efe1e58c7d5","4c943503763e4e349906eea3ed3c8e86",22851664,1,-2,0,203,63,61,-2
"4c943503763e4e349906eea3ed3c8e86","4c943503763e4e349906eea3ed3c8e86",22851664,1,0,1,204,61,61,0
"4c943503763e4e349906eea3ed3c8e86","309ccf3cc4fe429d9bfbaef53d3fa479",22851664,1,-1,0,205,61,60,-1
"309ccf3cc4fe429d9bfbaef53d3fa479","d646286c8051419bbc2e31dd1db55ca8",22851664,1,10,0,206,60,67,7
"d646286c8051419bbc2e31dd1db55ca8","b534b89233134e30a9b5645138bfa9ee",22851664,1,-33,0,207,67,41,-26
"67a089198fcb4e1c8f2385786c2b296f","a9ac840f098c4bd0a2ee896214ce29cd",22851664,1,165,0,211,39,168,129
"a9ac840f098c4bd0a2ee896214ce29cd","a9ac840f098c4bd0a2ee896214ce29cd",22851664,6,0,1,212,168,168,0
"a9ac840f098c4bd0a2ee896214ce29cd","0c7262dff33c4087bc660ccf40f92f9c",22851664,3,4,0,213,168,169,1
"b2275c3fad834f8d90737a2d9a6927d6","d646286c8051419bbc2e31dd1db55ca8",22851664,1,-135,0,215,172,67,-105
"d646286c8051419bbc2e31dd1db55ca8","267f883678b24aed855fde42524975d9",22851664,1,4,0,217,67,71,4
"267f883678b24aed855fde42524975d9","267f883678b24aed855fde42524975d9",22851664,3,0,1,218,71,71,0
"267f883678b24aed855fde42524975d9","88fff56d0342490dbef9040750a20f6c",22851664,1,1,0,221,71,72,1
"88fff56d0342490dbef9040750a20f6c","88fff56d0342490dbef9040750a20f6c",22851664,1,0,1,222,72,72,0
"88fff56d0342490dbef9040750a20f6c","adb17b12b66c4a49a85fd34322f7df70",22851664,1,1,0,223,72,73,1
"adb17b12b66c4a49a85fd34322f7df70","adb17b12b66c4a49a85fd34322f7df70",22851664,1,0,1,224,73,73,0
"adb17b12b66c4a49a85fd34322f7df70","d646286c8051419bbc2e31dd1db55ca8",22851664,1,-6,0,225,73,67,-6
"a2becd407db34b189200a32546d9d569","a2becd407db34b189200a32546d9d569",22851664,12,0,1,227,75,75,0
"a2becd407db34b189200a32546d9d569","58c22b011d0f4c2ea6d13615edbb9eeb",22851664,1,2,0,234,75,77,2
"58c22b011d0f4c2ea6d13615edbb9eeb","58c22b011d0f4c2ea6d13615edbb9eeb",22851664,11,0,1,235,77,77,0
"58c22b011d0f4c2ea6d13615edbb9eeb","dd76e1861dc9461c830888729d091ee0",22851664,1,1,0,246,77,78,1
"dd76e1861dc9461c830888729d091ee0","dd76e1861dc9461c830888729d091ee0",22851664,8,0,1,247,78,78,0
"dd76e1861dc9461c830888729d091ee0","a2becd407db34b189200a32546d9d569",22851664,1,-3,0,255,78,75,-3
"a2becd407db34b189200a32546d9d569","cd1d828f1a694b87913a7ea66c23803e",22851664,1,4,0,260,75,79,4
"cd1d828f1a694b87913a7ea66c23803e","cd1d828f1a694b87913a7ea66c23803e",22851664,5,0,1,261,79,79,0
"cd1d828f1a694b87913a7ea66c23803e","a2becd407db34b189200a32546d9d569",22851664,1,-4,0,266,79,75,-4
"a2becd407db34b189200a32546d9d569","9176a3c2b4d2465fa8b0c67096c2a97e",22851664,1,5,0,268,75,80,5
"9176a3c2b4d2465fa8b0c67096c2a97e","9176a3c2b4d2465fa8b0c67096c2a97e",22851664,5,0,1,269,80,80,0
"9176a3c2b4d2465fa8b0c67096c2a97e","f8ec6445f7194e25b9101d4fbcb07a18",22851664,1,1,0,274,80,81,1
"f8ec6445f7194e25b9101d4fbcb07a18","f8ec6445f7194e25b9101d4fbcb07a18",22851664,2,0,1,275,81,81,0
"f8ec6445f7194e25b9101d4fbcb07a18","140d5b27b8574befad82c0a013b59dfa",22851664,1,-7,0,277,81,74,-7
"d18a9ea32855445f8736581f5cb119ce","f564483cbd7a407681aa2fcca518cf5f",22851664,1,4,0,279,82,85,3
"f564483cbd7a407681aa2fcca518cf5f","f564483cbd7a407681aa2fcca518cf5f",22851664,7,0,1,280,85,85,0
"f564483cbd7a407681aa2fcca518cf5f","18fd01350bd5434ca636d59a599d768a",22851664,1,1,0,287,85,86,1
"18fd01350bd5434ca636d59a599d768a","18fd01350bd5434ca636d59a599d768a",22851664,9,0,1,288,86,86,0
"18fd01350bd5434ca636d59a599d768a","ae5ac430ea254e708a6f5deaaf7464ae",22851664,1,-2,0,297,86,84,-2
"6a9f0ef185fb47f0937e29daa1c71ed5","c681290961c94c4caf23b529d1ae6b9a",22851664,1,-2,0,299,90,88,-2
"c681290961c94c4caf23b529d1ae6b9a","c681290961c94c4caf23b529d1ae6b9a",22851664,1,0,1,300,88,88,0
"c681290961c94c4caf23b529d1ae6b9a","6a9f0ef185fb47f0937e29daa1c71ed5",22851664,1,2,0,301,88,90,2
"e20db35ced8544ddac5bc3839145e463","1febb706d7a34005ae8711ed49c76e64",22851664,1,3,0,307,91,94,3
"1febb706d7a34005ae8711ed49c76e64","1febb706d7a34005ae8711ed49c76e64",22851664,2,0,1,308,94,94,0
"1febb706d7a34005ae8711ed49c76e64","8f73ba6f5a0042f2850356ac38ac6f24",22851664,1,1,0,310,94,95,1
"8f73ba6f5a0042f2850356ac38ac6f24","8f73ba6f5a0042f2850356ac38ac6f24",22851664,6,0,1,311,95,95,0
"8f73ba6f5a0042f2850356ac38ac6f24","e2260b86653c46d7b14a41fb419dbf8c",22851664,1,1,0,317,95,96,1
"e2260b86653c46d7b14a41fb419dbf8c","e2260b86653c46d7b14a41fb419dbf8c",22851664,2,0,1,318,96,96,0
"e2260b86653c46d7b14a41fb419dbf8c","35eb641ad1d845bbba54915bce75a962",22851664,1,1,0,320,96,97,1
"35eb641ad1d845bbba54915bce75a962","35eb641ad1d845bbba54915bce75a962",22851664,2,0,1,321,97,97,0
"35eb641ad1d845bbba54915bce75a962","08be90ffbeea4795a138cd42ed8db56f",22851664,1,1,0,323,97,98,1
"08be90ffbeea4795a138cd42ed8db56f","08be90ffbeea4795a138cd42ed8db56f",22851664,5,0,1,324,98,98,0
"08be90ffbeea4795a138cd42ed8db56f","3007433c8f584dcbb5ac159c1c5f2be3",22851664,1,1,0,329,98,99,1
"3007433c8f584dcbb5ac159c1c5f2be3","3007433c8f584dcbb5ac159c1c5f2be3",22851664,5,0,1,330,99,99,0
"3007433c8f584dcbb5ac159c1c5f2be3","e20db35ced8544ddac5bc3839145e463",22851664,1,-8,0,335,99,91,-8
"d391c8b6e56a43a7b654e9dee02d904b","00ae5f0c51874a73a41ebea838d95682",22851664,2,-2,0,337,103,101,-2
"e20db35ced8544ddac5bc3839145e463","e20db35ced8544ddac5bc3839145e463",22851664,2,0,1,339,91,91,0
"00ae5f0c51874a73a41ebea838d95682","d391c8b6e56a43a7b654e9dee02d904b",22851664,2,2,0,342,101,103,2
"00ae5f0c51874a73a41ebea838d95682","00ae5f0c51874a73a41ebea838d95682",22851664,2,0,1,344,101,101,0
"d391c8b6e56a43a7b654e9dee02d904b","d391c8b6e56a43a7b654e9dee02d904b",22851664,15,0,1,347,103,103,0
"d391c8b6e56a43a7b654e9dee02d904b","6111116566fc4fd9abba409322bea245",22851664,1,1,0,362,103,104,1
"6111116566fc4fd9abba409322bea245","6111116566fc4fd9abba409322bea245",22851664,4,0,1,363,104,104,0
"6111116566fc4fd9abba409322bea245","a81b2235cb9c499eb9ea8ee0a8dd9725",22851664,1,1,0,365,104,105,1
"a81b2235cb9c499eb9ea8ee0a8dd9725","a81b2235cb9c499eb9ea8ee0a8dd9725",22851664,2,0,1,366,105,105,0
"a81b2235cb9c499eb9ea8ee0a8dd9725","6111116566fc4fd9abba409322bea245",22851664,1,-1,0,368,105,104,-1
"6111116566fc4fd9abba409322bea245","2d4e0ab0ef3b4d73b82c72d4621a7579",22851664,1,2,0,371,104,106,2
"2d4e0ab0ef3b4d73b82c72d4621a7579","2d4e0ab0ef3b4d73b82c72d4621a7579",22851664,2,0,1,372,106,106,0
"2d4e0ab0ef3b4d73b82c72d4621a7579","8bdebf492ebd4e62b0d522e8ab5e5197",22851664,1,1,0,374,106,107,1
"8bdebf492ebd4e62b0d522e8ab5e5197","8bdebf492ebd4e62b0d522e8ab5e5197",22851664,5,0,1,375,107,107,0
"8bdebf492ebd4e62b0d522e8ab5e5197","73039f8c1eb9409cb4caee2cf968001e",22851664,1,-7,0,380,107,100,-7
"4280927ec4d643238aa49c32f9e06c6c","4280927ec4d643238aa49c32f9e06c6c",22851664,1,0,1,382,109,109,0
"4280927ec4d643238aa49c32f9e06c6c","fc44e6a5f7654430af1227838224dceb",22851664,1,2,0,383,109,111,2
"fc44e6a5f7654430af1227838224dceb","fc44e6a5f7654430af1227838224dceb",22851664,2,0,1,384,111,111,0
"fc44e6a5f7654430af1227838224dceb","08111f75e22d409998cf8b85bd431f0a",22851664,1,-3,0,386,111,108,-3
"a9ae0a3c070d455bb4369a8996313336","a9ae0a3c070d455bb4369a8996313336",22851664,4,0,1,388,114,114,0
"a9ae0a3c070d455bb4369a8996313336","71cec822bcff4f30a20e75dc63ef7b65",22851664,1,2,0,392,114,116,2
"71cec822bcff4f30a20e75dc63ef7b65","71cec822bcff4f30a20e75dc63ef7b65",22851664,3,0,1,393,116,116,0
"71cec822bcff4f30a20e75dc63ef7b65","37319e88176d4aefa91d7a9980dbae91",22851664,1,-4,0,396,116,112,-4
"37319e88176d4aefa91d7a9980dbae91","62bff51286ef4f348717a3cf6fe2318f",22851664,1,9,0,397,112,120,8
"62bff51286ef4f348717a3cf6fe2318f","b1cd0e7dc3ad4a8eb91a4bfdbeb025b0",22851664,1,-2,0,398,120,118,-2
"b1cd0e7dc3ad4a8eb91a4bfdbeb025b0","b1cd0e7dc3ad4a8eb91a4bfdbeb025b0",22851664,1,0,1,399,118,118,0
"b1cd0e7dc3ad4a8eb91a4bfdbeb025b0","62bff51286ef4f348717a3cf6fe2318f",22851664,1,2,0,400,118,120,2
"62bff51286ef4f348717a3cf6fe2318f","e20db35ced8544ddac5bc3839145e463",22851664,1,-33,0,404,120,91,-29
"779f9ddd1fd14d1e9e69f72219a1fdbd","ae26e6cda8ad4a3f81bd347560d9579f",22851664,1,4,0,406,121,125,4
"ae26e6cda8ad4a3f81bd347560d9579f","ae26e6cda8ad4a3f81bd347560d9579f",22851664,1,0,1,407,125,125,0
"ae26e6cda8ad4a3f81bd347560d9579f","ee48df95832b4374aa273ceb27ec1315",22851664,1,1,0,408,125,126,1
"ee48df95832b4374aa273ceb27ec1315","ee48df95832b4374aa273ceb27ec1315",22851664,1,0,1,409,126,126,0
"ee48df95832b4374aa273ceb27ec1315","7a439da90b394756ad1777fc4c6dead5",22851664,1,1,0,410,126,127,1
"7a439da90b394756ad1777fc4c6dead5","7a439da90b394756ad1777fc4c6dead5",22851664,1,0,1,411,127,127,0
"7a439da90b394756ad1777fc4c6dead5","779f9ddd1fd14d1e9e69f72219a1fdbd",22851664,1,-6,0,412,127,121,-6
"a8dd5213034441ac92724b4e83eb0bb2","78adeee1fa2c4fe0bc73f7bca9fcee86",22851664,1,40,0,414,129,160,31
"df1de691dafe4549a18a4398ee9dfaf9","d313cec988a84645bee413e8d4724a4b",22851664,1,22,0,418,139,158,19
"d313cec988a84645bee413e8d4724a4b","779f9ddd1fd14d1e9e69f72219a1fdbd",22851664,1,-45,0,419,158,121,-37
"a8dd5213034441ac92724b4e83eb0bb2","779f9ddd1fd14d1e9e69f72219a1fdbd",22851664,1,-9,0,422,129,121,-8
"a8dd5213034441ac92724b4e83eb0bb2","8115eab6556b45f5b415c3b8c26a12e5",22851664,1,2,0,424,129,131,2
"8115eab6556b45f5b415c3b8c26a12e5","8115eab6556b45f5b415c3b8c26a12e5",22851664,2,0,1,425,131,131,0
"8115eab6556b45f5b415c3b8c26a12e5","ec34b06efd844b46a4c4818ecdb9b8f4",22851664,1,1,0,427,131,132,1
"ec34b06efd844b46a4c4818ecdb9b8f4","ec34b06efd844b46a4c4818ecdb9b8f4",22851664,8,0,1,428,132,132,0
"ec34b06efd844b46a4c4818ecdb9b8f4","c2e1c2b9eac64109b343a088584b576b",22851664,1,1,0,436,132,133,1
"c2e1c2b9eac64109b343a088584b576b","c2e1c2b9eac64109b343a088584b576b",22851664,8,0,1,437,133,133,0
"c2e1c2b9eac64109b343a088584b576b","579338175e0b4bbb8ef3b712b5d8b54e",22851664,1,-5,0,445,133,128,-5
"579338175e0b4bbb8ef3b712b5d8b54e","8bc5795d6a984a3eace4e2811e52dd4f",22851664,1,8,0,446,128,135,7
"8bc5795d6a984a3eace4e2811e52dd4f","8bc5795d6a984a3eace4e2811e52dd4f",22851664,1,0,1,447,135,135,0
"8bc5795d6a984a3eace4e2811e52dd4f","b416d47c56a742199b5d7c7f19d6503a",22851664,1,-1,0,448,135,134,-1
"b416d47c56a742199b5d7c7f19d6503a","cd4532ad48034873ba8bce2aac0c9808",22851664,1,4,0,449,134,137,3
"cd4532ad48034873ba8bce2aac0c9808","cd4532ad48034873ba8bce2aac0c9808",22851664,1,0,1,450,137,137,0
"cd4532ad48034873ba8bce2aac0c9808","df1de691dafe4549a18a4398ee9dfaf9",22851664,1,4,0,451,137,139,2
"df1de691dafe4549a18a4398ee9dfaf9","779f9ddd1fd14d1e9e69f72219a1fdbd",22851664,1,-23,0,452,139,121,-18
"779f9ddd1fd14d1e9e69f72219a1fdbd","6c5ad271a44743479bfaea29b1db8d02",22851664,1,27,0,453,121,143,22
"df1de691dafe4549a18a4398ee9dfaf9","df1de691dafe4549a18a4398ee9dfaf9",22851664,2,0,1,455,139,139,0
"6c5ad271a44743479bfaea29b1db8d02","6c5ad271a44743479bfaea29b1db8d02",22851664,4,0,1,457,143,143,0
"6c5ad271a44743479bfaea29b1db8d02","83d311bed5374fee83d8d67a7d9d82dc",22851664,1,1,0,461,143,144,1
"83d311bed5374fee83d8d67a7d9d82dc","83d311bed5374fee83d8d67a7d9d82dc",22851664,3,0,1,462,144,144,0
"83d311bed5374fee83d8d67a7d9d82dc","402bba41861d43acb52a5abb89e8831e",22851664,1,1,0,465,144,145,1
"402bba41861d43acb52a5abb89e8831e","402bba41861d43acb52a5abb89e8831e",22851664,2,0,1,466,145,145,0
"402bba41861d43acb52a5abb89e8831e","df1de691dafe4549a18a4398ee9dfaf9",22851664,1,-6,0,468,145,139,-6
"8aae34f5ddbb4052a709b12e6b0d40fa","8aae34f5ddbb4052a709b12e6b0d40fa",22851664,1,0,1,470,147,147,0
"8aae34f5ddbb4052a709b12e6b0d40fa","645b3f0249f64f76af2e19eb4d0e55b7",22851664,1,2,0,471,147,149,2
"645b3f0249f64f76af2e19eb4d0e55b7","645b3f0249f64f76af2e19eb4d0e55b7",22851664,9,0,1,472,149,149,0
"645b3f0249f64f76af2e19eb4d0e55b7","7e7b8db5064d4369805ab370aac5ddfb",22851664,1,1,0,481,149,150,1
"7e7b8db5064d4369805ab370aac5ddfb","7e7b8db5064d4369805ab370aac5ddfb",22851664,2,0,1,482,150,150,0
"7e7b8db5064d4369805ab370aac5ddfb","8956d210ae7f41968fada86d4c979d6a",22851664,1,1,0,484,150,151,1
"8956d210ae7f41968fada86d4c979d6a","8956d210ae7f41968fada86d4c979d6a",22851664,2,0,1,485,151,151,0
"8956d210ae7f41968fada86d4c979d6a","f902b0f41b544d4dbf79664fd233648d",22851664,1,-5,0,487,151,146,-5
"f902b0f41b544d4dbf79664fd233648d","ae781e8b775e4ccd93bc800dad5c8376",22851664,1,8,0,488,146,153,7
"ae781e8b775e4ccd93bc800dad5c8376","ae781e8b775e4ccd93bc800dad5c8376",22851664,2,0,1,489,153,153,0
"ae781e8b775e4ccd93bc800dad5c8376","06882a8492d9499aa31555567f575ecb",22851664,1,1,0,491,153,154,1
"06882a8492d9499aa31555567f575ecb","06882a8492d9499aa31555567f575ecb",22851664,1,0,1,492,154,154,0
"06882a8492d9499aa31555567f575ecb","f293c508f409466a8f27ddd7d1e40b20",22851664,1,1,0,493,154,155,1
"f293c508f409466a8f27ddd7d1e40b20","f293c508f409466a8f27ddd7d1e40b20",22851664,5,0,1,494,155,155,0
"f293c508f409466a8f27ddd7d1e40b20","cc4ddef5bbbe48ebb605141b347c4ed1",22851664,1,1,0,499,155,156,1
"cc4ddef5bbbe48ebb605141b347c4ed1","cc4ddef5bbbe48ebb605141b347c4ed1",22851664,1,0,1,500,156,156,0
"cc4ddef5bbbe48ebb605141b347c4ed1","f03480cf4eba413194d7af52fc0e7f28",22851664,1,-4,0,501,156,152,-4
"d313cec988a84645bee413e8d4724a4b","dc60696c76a74368a60f72246e47700d",22851664,2,1,0,507,158,159,1
"dc60696c76a74368a60f72246e47700d","dc60696c76a74368a60f72246e47700d",22851664,2,0,1,508,159,159,0
"dc60696c76a74368a60f72246e47700d","78adeee1fa2c4fe0bc73f7bca9fcee86",22851664,1,3,0,509,159,160,1
"df1de691dafe4549a18a4398ee9dfaf9","78adeee1fa2c4fe0bc73f7bca9fcee86",22851664,2,26,0,512,139,160,21
"78adeee1fa2c4fe0bc73f7bca9fcee86","d313cec988a84645bee413e8d4724a4b",22851664,1,-4,0,513,160,158,-2
"dc60696c76a74368a60f72246e47700d","df1de691dafe4549a18a4398ee9dfaf9",22851664,1,-23,0,518,159,139,-20
"3cbcea2be0984e7dbd5a48195af10ce7","3cbcea2be0984e7dbd5a48195af10ce7",22851664,1,0,1,533,165,165,0
"82e6285962b8400d9d6fc32436022a94","a9ac840f098c4bd0a2ee896214ce29cd",22851664,1,3,0,535,167,168,1
"b2275c3fad834f8d90737a2d9a6927d6","0c7262dff33c4087bc660ccf40f92f9c",22851664,1,-3,0,540,172,169,-3
"b2275c3fad834f8d90737a2d9a6927d6","a9ac840f098c4bd0a2ee896214ce29cd",22851664,1,-7,0,542,172,168,-4
"a9ac840f098c4bd0a2ee896214ce29cd","3cbcea2be0984e7dbd5a48195af10ce7",22851664,1,-5,0,545,168,165,-3
"82e6285962b8400d9d6fc32436022a94","78adeee1fa2c4fe0bc73f7bca9fcee86",22851664,1,-10,0,547,167,160,-7
"65202579580f4ad38d734b4ee39d22a8","0c7262dff33c4087bc660ccf40f92f9c",22851664,1,12,0,558,164,169,5
"0c7262dff33c4087bc660ccf40f92f9c","0c7262dff33c4087bc660ccf40f92f9c",22851664,5,0,1,559,169,169,0
"b2275c3fad834f8d90737a2d9a6927d6","eb515a26030b41f8a82a1e6114420bad",22851664,1,1,0,581,172,173,1
"eb515a26030b41f8a82a1e6114420bad","eb515a26030b41f8a82a1e6114420bad",22851664,2,0,1,582,173,173,0
"eb515a26030b41f8a82a1e6114420bad","0c7262dff33c4087bc660ccf40f92f9c",22851664,1,-4,0,584,173,169,-4
"0c7262dff33c4087bc660ccf40f92f9c","b42cc17b7de840f181a704558d0bc845",22851664,1,7,0,585,169,175,6
"b42cc17b7de840f181a704558d0bc845","b42cc17b7de840f181a704558d0bc845",22851664,5,0,1,586,175,175,0
"b42cc17b7de840f181a704558d0bc845","801f9e9135034f49bf5f8b4bdefedb41",22851664,1,2,0,591,175,177,2
"801f9e9135034f49bf5f8b4bdefedb41","801f9e9135034f49bf5f8b4bdefedb41",22851664,4,0,1,592,177,177,0
"801f9e9135034f49bf5f8b4bdefedb41","362fcb0699a14845ab29b2340093e528",22851664,1,-3,0,596,177,174,-3
"362fcb0699a14845ab29b2340093e528","ea38cc0e6e6e41edbabf210220808bf9",22851664,1,6,0,597,174,179,5
"ea38cc0e6e6e41edbabf210220808bf9","b87c552dd247427abe6ab5795b9c9d43",22851664,2,2,0,598,179,181,2
"b87c552dd247427abe6ab5795b9c9d43","ea38cc0e6e6e41edbabf210220808bf9",22851664,1,-2,0,599,181,179,-2
"b87c552dd247427abe6ab5795b9c9d43","b87c552dd247427abe6ab5795b9c9d43",22851664,7,0,1,601,181,181,0
"139b097acfca451689d80c9c6eebdf7b","30f660a1feb34582a739722532524f79",22851664,1,6,0,609,178,183,5
"30f660a1feb34582a739722532524f79","30f660a1feb34582a739722532524f79",22851664,3,0,1,610,183,183,0
"30f660a1feb34582a739722532524f79","2024b4885bd14338a39b7b509acbbd02",22851664,1,-1,0,613,183,182,-1
"2024b4885bd14338a39b7b509acbbd02","0c7262dff33c4087bc660ccf40f92f9c",22851664,1,-16,0,614,182,169,-13
"c8e371568a0c4391b25796ae4e91952e","7d932b23e1c84326ae5aa4d3c0d813d1",22851664,1,2,0,616,186,188,2
"7d932b23e1c84326ae5aa4d3c0d813d1","7d932b23e1c84326ae5aa4d3c0d813d1",22851664,1,0,1,617,188,188,0
"7d932b23e1c84326ae5aa4d3c0d813d1","c8e371568a0c4391b25796ae4e91952e",22851664,1,-2,0,618,188,186,-2
"ab11d94c6c8948ea90b88f19d2cd502b","ab11d94c6c8948ea90b88f19d2cd502b",22851664,2,0,1,620,190,190,0
"ab11d94c6c8948ea90b88f19d2cd502b","f992451ed6ad4e68bb9e68ad6be7c4be",22851664,1,2,0,622,190,192,2
"f992451ed6ad4e68bb9e68ad6be7c4be","f992451ed6ad4e68bb9e68ad6be7c4be",22851664,3,0,1,623,192,192,0
"f992451ed6ad4e68bb9e68ad6be7c4be","07b44a7a51e94c78b411c753fc39dab0",22851664,1,-3,0,626,192,189,-3
"6cd2dcaac46847d4a0bc53f296d90375","6cd2dcaac46847d4a0bc53f296d90375",22851664,1,0,1,628,194,194,0
"6cd2dcaac46847d4a0bc53f296d90375","2d2580c9411c4972909db508d6956a58",22851664,1,2,0,629,194,196,2
"2d2580c9411c4972909db508d6956a58","2d2580c9411c4972909db508d6956a58",22851664,5,0,1,630,196,196,0
"2d2580c9411c4972909db508d6956a58","5bddb3d9ed264f3984702f048c7e5340",22851664,1,1,0,635,196,197,1
"5bddb3d9ed264f3984702f048c7e5340","5bddb3d9ed264f3984702f048c7e5340",22851664,2,0,1,636,197,197,0
"5bddb3d9ed264f3984702f048c7e5340","d5e8e2bd12a2466b9d6d90855f0eb079",22851664,1,1,0,638,197,198,1
"d5e8e2bd12a2466b9d6d90855f0eb079","d5e8e2bd12a2466b9d6d90855f0eb079",22851664,2,0,1,639,198,198,0
"d5e8e2bd12a2466b9d6d90855f0eb079","017d7ca8e0394b91aaadc9574df2202c",22851664,1,-5,0,641,198,193,-5
"017d7ca8e0394b91aaadc9574df2202c","54e8e9f0ea3e45c4bf3b8ac799ee31b1",22851664,1,8,0,642,193,200,7
"54e8e9f0ea3e45c4bf3b8ac799ee31b1","54e8e9f0ea3e45c4bf3b8ac799ee31b1",22851664,1,0,1,643,200,200,0
"54e8e9f0ea3e45c4bf3b8ac799ee31b1","c614a00911be4877a075f19315530fb0",22851664,1,1,0,644,200,201,1
"c614a00911be4877a075f19315530fb0","c614a00911be4877a075f19315530fb0",22851664,6,0,1,645,201,201,0
"c614a00911be4877a075f19315530fb0","a6c21bd8b95249c7972820a7a7d76aff",22851664,1,1,0,651,201,202,1
"a6c21bd8b95249c7972820a7a7d76aff","a6c21bd8b95249c7972820a7a7d76aff",22851664,2,0,1,652,202,202,0
"a6c21bd8b95249c7972820a7a7d76aff","f9170dd6bc6442b4acd832747609b09a",22851664,1,-3,0,654,202,199,-3
"f9170dd6bc6442b4acd832747609b09a","b54257a550b94ebc9538f3a90eee9d7e",22851664,1,6,0,655,199,204,5
"b54257a550b94ebc9538f3a90eee9d7e","bb329d880ab54120adaf203a693bb203",22851664,1,-2,0,656,204,203,-1
"bb329d880ab54120adaf203a693bb203","bb329d880ab54120adaf203a693bb203",22851664,2,0,1,657,203,203,0
"bb329d880ab54120adaf203a693bb203","f9170dd6bc6442b4acd832747609b09a",22851664,2,-4,0,658,203,199,-4
"017d7ca8e0394b91aaadc9574df2202c","bb329d880ab54120adaf203a693bb203",22851664,1,11,0,665,193,203,10
"c8e371568a0c4391b25796ae4e91952e","b54257a550b94ebc9538f3a90eee9d7e",22851664,1,22,0,670,186,204,18
"b54257a550b94ebc9538f3a90eee9d7e","c8e371568a0c4391b25796ae4e91952e",22851664,1,-22,0,671,204,186,-18
"c8e371568a0c4391b25796ae4e91952e","334c2344009840079b1d0e1b7ce3d5a7",22851664,1,23,0,672,186,205,19
"334c2344009840079b1d0e1b7ce3d5a7","334c2344009840079b1d0e1b7ce3d5a7",22851664,1,0,1,673,205,205,0
"334c2344009840079b1d0e1b7ce3d5a7","c8e371568a0c4391b25796ae4e91952e",22851664,1,-23,0,674,205,186,-19
"d7f13c8d63ec4e2aa673fbb9cf9c6933","b9e80f77c3a44349863b19875725c384",22851664,1,1,0,676,206,207,1
"b9e80f77c3a44349863b19875725c384","7108f0e4c2584f1f9c471689ae4c885c",22851664,2,1,0,677,207,208,1
"7108f0e4c2584f1f9c471689ae4c885c","78adeee1fa2c4fe0bc73f7bca9fcee86",22851664,1,-68,0,678,208,160,-48
"65202579580f4ad38d734b4ee39d22a8","d7f13c8d63ec4e2aa673fbb9cf9c6933",22851664,1,61,0,689,164,206,42
"d7f13c8d63ec4e2aa673fbb9cf9c6933","d7f13c8d63ec4e2aa673fbb9cf9c6933",22851664,1,0,1,690,206,206,0
"b9e80f77c3a44349863b19875725c384","b9e80f77c3a44349863b19875725c384",22851664,19,0,1,693,207,207,0
"7108f0e4c2584f1f9c471689ae4c885c","7108f0e4c2584f1f9c471689ae4c885c",22851664,23,0,1,713,208,208,0
"7108f0e4c2584f1f9c471689ae4c885c","09400e101c5d4b439cf9a26b03aae558",22851664,1,3,0,736,208,210,2
"d7f13c8d63ec4e2aa673fbb9cf9c6933","09400e101c5d4b439cf9a26b03aae558",22851664,1,5,0,738,206,210,4
"09400e101c5d4b439cf9a26b03aae558","a88efa7e50ce47159810ab553afa6d3a",22851664,1,2,0,739,210,212,2
"a88efa7e50ce47159810ab553afa6d3a","a88efa7e50ce47159810ab553afa6d3a",22851664,5,0,1,740,212,212,0
"a88efa7e50ce47159810ab553afa6d3a","a875096404ef4a9984b62d74cda916f9",22851664,1,-3,0,745,212,209,-3
"a875096404ef4a9984b62d74cda916f9","f7fb1952f56b4189b86a9f8b7862d2b8",22851664,1,7,0,746,209,215,6
"f7fb1952f56b4189b86a9f8b7862d2b8","be502a7a43c44bf7b682698de79d9369",22851664,1,-1,0,747,215,214,-1
"be502a7a43c44bf7b682698de79d9369","be502a7a43c44bf7b682698de79d9369",22851664,1,0,1,748,214,214,0
"f7fb1952f56b4189b86a9f8b7862d2b8","f7fb1952f56b4189b86a9f8b7862d2b8",22851664,11,0,1,750,215,215,0
"f7fb1952f56b4189b86a9f8b7862d2b8","b860ee85d8bc4a2f97958cfb71be3533",22851664,1,1,0,761,215,216,1
"b860ee85d8bc4a2f97958cfb71be3533","b860ee85d8bc4a2f97958cfb71be3533",22851664,2,0,1,762,216,216,0
"b860ee85d8bc4a2f97958cfb71be3533","ec341f459285443b8361f7f15638ff08",22851664,1,-3,0,764,216,213,-3
"363837c182e04711840d896ae1e0339c","363837c182e04711840d896ae1e0339c",22851664,16,0,1,766,218,218,0
"01b2051f8941460d89945e3b02d1ce78","91125ca626c5470eb145501f8c37f8db",22851664,1,4,0,783,217,220,3
"91125ca626c5470eb145501f8c37f8db","91125ca626c5470eb145501f8c37f8db",22851664,1,0,1,784,220,220,0
"91125ca626c5470eb145501f8c37f8db","d7f13c8d63ec4e2aa673fbb9cf9c6933",22851664,1,-18,0,785,220,206,-14
"77ecef8eff6b4a2caea7707669bf7475","0c7262dff33c4087bc660ccf40f92f9c",22851664,1,-71,0,788,222,169,-53
"0c7262dff33c4087bc660ccf40f92f9c","1c6721b1f63f4d30ba7746ea8af02a52",22851664,1,70,0,792,169,221,52
"1c6721b1f63f4d30ba7746ea8af02a52","1c6721b1f63f4d30ba7746ea8af02a52",22851664,1,0,1,793,221,221,0
"77ecef8eff6b4a2caea7707669bf7475","77ecef8eff6b4a2caea7707669bf7475",22851664,13,0,1,795,222,222,0
"77ecef8eff6b4a2caea7707669bf7475","1c6721b1f63f4d30ba7746ea8af02a52",22851664,3,-1,0,808,222,221,-1
"8b9ae98743bd4d4a8a87dff1c1244211","d03cb855c70044cf8c35d9ec0de696e3",22851664,1,-3,0,810,227,224,-3
"d03cb855c70044cf8c35d9ec0de696e3","d03cb855c70044cf8c35d9ec0de696e3",22851664,1,0,1,811,224,224,0
"d03cb855c70044cf8c35d9ec0de696e3","a49a937d6896486d9a5396654abcf2e1",22851664,1,2,0,812,224,226,2
"a49a937d6896486d9a5396654abcf2e1","a49a937d6896486d9a5396654abcf2e1",22851664,1,0,1,813,226,226,0
"a49a937d6896486d9a5396654abcf2e1","8b9ae98743bd4d4a8a87dff1c1244211",22851664,1,1,0,814,226,227,1
"8b9ae98743bd4d4a8a87dff1c1244211","8b9ae98743bd4d4a8a87dff1c1244211",22851664,32,0,1,815,227,227,0
"f7906d6f59b9489a91d2ef40db5a474d","2ab1535aac1346ba8801535bf729ef37",22851664,1,7,0,849,223,229,6
"2ab1535aac1346ba8801535bf729ef37","a4f40fb48a8542c8949bae1f002cd9bc",22851664,1,2,0,850,229,231,2
"a4f40fb48a8542c8949bae1f002cd9bc","a4f40fb48a8542c8949bae1f002cd9bc",22851664,2,0,1,851,231,231,0
"a4f40fb48a8542c8949bae1f002cd9bc","8972c23e32044edb8a78fa1eed4e5947",22851664,1,1,0,853,231,232,1
"8972c23e32044edb8a78fa1eed4e5947","8972c23e32044edb8a78fa1eed4e5947",22851664,1,0,1,854,232,232,0
"8972c23e32044edb8a78fa1eed4e5947","92feb4a40f8344d38b6f722e42a53295",22851664,1,1,0,855,232,233,1
"92feb4a40f8344d38b6f722e42a53295","92feb4a40f8344d38b6f722e42a53295",22851664,2,0,1,856,233,233,0
"92feb4a40f8344d38b6f722e42a53295","5152833676bf4c6cb317060be10f68db",22851664,1,-5,0,858,233,228,-5
"5152833676bf4c6cb317060be10f68db","ca3e28f290354c08aefe5b0f769604e6",22851664,1,8,0,859,228,235,7
"ca3e28f290354c08aefe5b0f769604e6","ca3e28f290354c08aefe5b0f769604e6",22851664,9,0,1,860,235,235,0
"ca3e28f290354c08aefe5b0f769604e6","79a35eea833e4c2c9d22fc53c3c6445c",22851664,1,1,0,869,235,236,1
"79a35eea833e4c2c9d22fc53c3c6445c","79a35eea833e4c2c9d22fc53c3c6445c",22851664,9,0,1,870,236,236,0
"79a35eea833e4c2c9d22fc53c3c6445c","8f68228b1518449e9615cdafee41a2bd",22851664,1,1,0,879,236,237,1
"8f68228b1518449e9615cdafee41a2bd","8f68228b1518449e9615cdafee41a2bd",22851664,1,0,1,880,237,237,0
"8f68228b1518449e9615cdafee41a2bd","cab89fa5c3ed45a5aa550fc0352d6a42",22851664,1,1,0,881,237,238,1
"cab89fa5c3ed45a5aa550fc0352d6a42","cab89fa5c3ed45a5aa550fc0352d6a42",22851664,1,0,1,882,238,238,0
"cab89fa5c3ed45a5aa550fc0352d6a42","1c6721b1f63f4d30ba7746ea8af02a52",22851664,1,-20,0,883,238,221,-17
"1c6721b1f63f4d30ba7746ea8af02a52","d03cb855c70044cf8c35d9ec0de696e3",22851664,2,4,0,886,221,224,3
"d03cb855c70044cf8c35d9ec0de696e3","8b9ae98743bd4d4a8a87dff1c1244211",22851664,2,3,0,887,224,227,3
"5152833676bf4c6cb317060be10f68db","66d4fad4f1cf4b46be0750a99ad7a35a",22851664,1,12,0,891,228,239,11
"66d4fad4f1cf4b46be0750a99ad7a35a","66d4fad4f1cf4b46be0750a99ad7a35a",22851664,1,0,1,892,239,239,0
"66d4fad4f1cf4b46be0750a99ad7a35a","0b04c8e2f86d48c7aeb7e225819cd32b",22851664,1,-5,0,893,239,234,-5
"8b9ae98743bd4d4a8a87dff1c1244211","1c6721b1f63f4d30ba7746ea8af02a52",22851664,1,-7,0,899,227,221,-6
"1c6721b1f63f4d30ba7746ea8af02a52","64dbedb3ce544f6aae8e10e0cf10f16d",22851664,1,23,0,900,221,240,19
"64dbedb3ce544f6aae8e10e0cf10f16d","1c6721b1f63f4d30ba7746ea8af02a52",22851664,1,-23,0,901,240,221,-19
"1c6721b1f63f4d30ba7746ea8af02a52","f53da5fd9bfe412da4b80d4742563b6c",22851664,1,24,0,902,221,241,20
"f53da5fd9bfe412da4b80d4742563b6c","f53da5fd9bfe412da4b80d4742563b6c",22851664,1,0,1,903,241,241,0
"f53da5fd9bfe412da4b80d4742563b6c","1c6721b1f63f4d30ba7746ea8af02a52",22851664,1,-24,0,904,241,221,-20
"1ebf23f9d994469a85206e4c7b1bf5f5","85ae675b83e8422da842cfd25596af99",22851664,1,1,0,913,245,246,1
"85ae675b83e8422da842cfd25596af99","85ae675b83e8422da842cfd25596af99",22851664,1,0,1,914,246,246,0
"85ae675b83e8422da842cfd25596af99","2ae94c0cea4d480a9d5dca8fb1d7b542",22851664,1,-4,0,915,246,242,-4
"2ae94c0cea4d480a9d5dca8fb1d7b542","6e83e23f56544a19b94067c1c558d9c0",22851664,1,6,0,916,242,247,5
"0c7262dff33c4087bc660ccf40f92f9c","d989ebcfc12a4b669f0100dc1aa14f1e",22851664,1,113,0,919,169,255,86
"d989ebcfc12a4b669f0100dc1aa14f1e","2ae94c0cea4d480a9d5dca8fb1d7b542",22851664,1,-16,0,920,255,242,-13
"2ae94c0cea4d480a9d5dca8fb1d7b542","d989ebcfc12a4b669f0100dc1aa14f1e",22851664,1,16,0,921,242,255,13
"d989ebcfc12a4b669f0100dc1aa14f1e","00f61990949545828dd12f1303d47504",22851664,1,1,0,922,255,256,1
"00f61990949545828dd12f1303d47504","00f61990949545828dd12f1303d47504",22851664,1,0,1,923,256,256,0
"00f61990949545828dd12f1303d47504","ead7bb4b64e247d2ae632ab8a296b091",22851664,1,2,0,924,256,258,2
"ead7bb4b64e247d2ae632ab8a296b091","ead7bb4b64e247d2ae632ab8a296b091",22851664,2,0,1,925,258,258,0
"ead7bb4b64e247d2ae632ab8a296b091","41b0048dde734bb280bac6116baa8e27",22851664,1,1,0,927,258,259,1
"41b0048dde734bb280bac6116baa8e27","41b0048dde734bb280bac6116baa8e27",22851664,5,0,1,928,259,259,0
"41b0048dde734bb280bac6116baa8e27","b41c5a094a604ee0915327da5cc0beb7",22851664,1,1,0,933,259,260,1
"b41c5a094a604ee0915327da5cc0beb7","b41c5a094a604ee0915327da5cc0beb7",22851664,5,0,1,934,260,260,0
"b41c5a094a604ee0915327da5cc0beb7","d546341988904f069cfa86b21457d9d9",22851664,1,-10,0,939,260,251,-9
"d546341988904f069cfa86b21457d9d9","28c171777c52431ab6b925073bd63d46",22851664,1,15,0,940,251,264,13
"28c171777c52431ab6b925073bd63d46","28c171777c52431ab6b925073bd63d46",22851664,12,0,1,941,264,264,0
"28c171777c52431ab6b925073bd63d46","ac160db940cb49ae8579162b1d52bb5d",22851664,1,2,0,953,264,266,2
"ac160db940cb49ae8579162b1d52bb5d","ac160db940cb49ae8579162b1d52bb5d",22851664,7,0,1,954,266,266,0
"ac160db940cb49ae8579162b1d52bb5d","d989ebcfc12a4b669f0100dc1aa14f1e",22851664,1,-12,0,961,266,255,-11
"d989ebcfc12a4b669f0100dc1aa14f1e","c6fd49b485cc4874b0bbdd9c6171e09c",22851664,1,15,0,962,255,268,13
"c6fd49b485cc4874b0bbdd9c6171e09c","c6fd49b485cc4874b0bbdd9c6171e09c",22851664,7,0,1,963,268,268,0
"c6fd49b485cc4874b0bbdd9c6171e09c","44240778a97c4af0937817499b75707b",22851664,1,1,0,970,268,269,1
"44240778a97c4af0937817499b75707b","44240778a97c4af0937817499b75707b",22851664,2,0,1,971,269,269,0
"44240778a97c4af0937817499b75707b","7aa76d3e993840d8805f097cbdbcd44b",22851664,1,-9,0,973,269,261,-8
"7aa76d3e993840d8805f097cbdbcd44b","865a4d3b43374da7944dc7d397f566d9",22851664,1,12,0,974,261,271,10
"865a4d3b43374da7944dc7d397f566d9","865a4d3b43374da7944dc7d397f566d9",22851664,1,0,1,975,271,271,0
"865a4d3b43374da7944dc7d397f566d9","0d987bed3ffa4ed0b9a2e62e97b7b30f",22851664,1,3,0,976,271,272,1
"0d987bed3ffa4ed0b9a2e62e97b7b30f","2ae94c0cea4d480a9d5dca8fb1d7b542",22851664,1,-38,0,977,272,242,-30
"fab84b4fab5940efb4ea868ef8d09396","0c7262dff33c4087bc660ccf40f92f9c",22851664,1,-153,0,993,284,169,-115
"c8e371568a0c4391b25796ae4e91952e","fab84b4fab5940efb4ea868ef8d09396",22851664,1,130,0,996,186,284,98
"fab84b4fab5940efb4ea868ef8d09396","4a29443515bb404cb8924e1c60a63b73",22851664,2,4,0,1000,284,285,1
"4a29443515bb404cb8924e1c60a63b73","208c9b2796c944db8dacaa96082520ea",22851664,3,3,0,1001,285,288,3
"208c9b2796c944db8dacaa96082520ea","208c9b2796c944db8dacaa96082520ea",22851664,2,0,1,1002,288,288,0
"208c9b2796c944db8dacaa96082520ea","4a29443515bb404cb8924e1c60a63b73",22851664,3,-3,0,1004,288,285,-3
"4a29443515bb404cb8924e1c60a63b73","7669a956527947d0add87455277e80b4",22851664,1,7,0,1005,285,291,6
"7669a956527947d0add87455277e80b4","7669a956527947d0add87455277e80b4",22851664,1,0,1,1006,291,291,0
"7669a956527947d0add87455277e80b4","6a9a3b5bde4a48daa896fe8c06eca56f",22851664,1,-2,0,1007,291,289,-2
"6a9a3b5bde4a48daa896fe8c06eca56f","869e967078f04da18dd0b0b9389a7424",22851664,3,5,0,1008,289,293,4
"869e967078f04da18dd0b0b9389a7424","869e967078f04da18dd0b0b9389a7424",22851664,2,0,1,1009,293,293,0
"869e967078f04da18dd0b0b9389a7424","51ab6291537748fab90d519aa09889d6",22851664,1,2,0,1010,293,295,2
"51ab6291537748fab90d519aa09889d6","51ab6291537748fab90d519aa09889d6",22851664,11,0,1,1011,295,295,0
"51ab6291537748fab90d519aa09889d6","34a6e49023fc4465bd5ca604330bbd1c",22851664,1,-3,0,1022,295,292,-3
"34a6e49023fc4465bd5ca604330bbd1c","21592f2a9e9c4b2f8c66ec5dbcbf6a2b",22851664,1,5,0,1023,292,296,4
"21592f2a9e9c4b2f8c66ec5dbcbf6a2b","ba0e59461bfb4a44b7b1c28a01f8d3b3",22851664,1,4,0,1024,296,299,3
"ba0e59461bfb4a44b7b1c28a01f8d3b3","ba0e59461bfb4a44b7b1c28a01f8d3b3",22851664,1,0,1,1025,299,299,0
"ba0e59461bfb4a44b7b1c28a01f8d3b3","0e0b36e731a645e7b1b8a88f5031ca38",22851664,1,2,0,1026,299,301,2
"0e0b36e731a645e7b1b8a88f5031ca38","0e0b36e731a645e7b1b8a88f5031ca38",22851664,5,0,1,1027,301,301,0
"0e0b36e731a645e7b1b8a88f5031ca38","a66a144637284c21afc6de17fea4bfb8",22851664,1,1,0,1032,301,302,1
"a66a144637284c21afc6de17fea4bfb8","a66a144637284c21afc6de17fea4bfb8",22851664,2,0,1,1033,302,302,0
"a66a144637284c21afc6de17fea4bfb8","7646a919d7e64fa990bca9b024ff089d",22851664,1,-4,0,1035,302,298,-4
"7646a919d7e64fa990bca9b024ff089d","4a29443515bb404cb8924e1c60a63b73",22851664,2,-17,0,1036,298,285,-13
"4a29443515bb404cb8924e1c60a63b73","6a9a3b5bde4a48daa896fe8c06eca56f",22851664,2,5,0,1039,285,289,4
"869e967078f04da18dd0b0b9389a7424","34a6e49023fc4465bd5ca604330bbd1c",22851664,2,-1,0,1041,293,292,-1
"34a6e49023fc4465bd5ca604330bbd1c","ba0e59461bfb4a44b7b1c28a01f8d3b3",22851664,2,9,0,1042,292,299,7
"ba0e59461bfb4a44b7b1c28a01f8d3b3","21592f2a9e9c4b2f8c66ec5dbcbf6a2b",22851664,2,-4,0,1043,299,296,-3
"21592f2a9e9c4b2f8c66ec5dbcbf6a2b","7646a919d7e64fa990bca9b024ff089d",22851664,2,3,0,1044,296,298,2
"7646a919d7e64fa990bca9b024ff089d","e390b575229748ea8aac9364efe2bf00",22851664,1,7,0,1045,298,304,6
"e390b575229748ea8aac9364efe2bf00","e390b575229748ea8aac9364efe2bf00",22851664,1,0,1,1046,304,304,0
"e390b575229748ea8aac9364efe2bf00","4a29443515bb404cb8924e1c60a63b73",22851664,1,-24,0,1047,304,285,-19
"4a29443515bb404cb8924e1c60a63b73","3434c10e561d488a914e0f7d71907abd",22851664,2,27,0,1048,285,305,20
"3434c10e561d488a914e0f7d71907abd","53e7e900392747ccad52e711ab0f80d8",22851664,2,2,0,1049,305,307,2
"53e7e900392747ccad52e711ab0f80d8","3434c10e561d488a914e0f7d71907abd",22851664,2,-2,0,1050,307,305,-2
"3434c10e561d488a914e0f7d71907abd","130acc2aeb0448fdbb2de63bc5cebe5b",22851664,2,5,0,1051,305,309,4
"130acc2aeb0448fdbb2de63bc5cebe5b","9c062b3251034ebe90f5054e2a3b5120",22851664,1,2,0,1052,309,311,2
"9c062b3251034ebe90f5054e2a3b5120","9c062b3251034ebe90f5054e2a3b5120",22851664,2,0,1,1053,311,311,0
"9c062b3251034ebe90f5054e2a3b5120","ea859f8207e44537889daeaba13ac2e8",22851664,1,1,0,1055,311,312,1
"ea859f8207e44537889daeaba13ac2e8","ea859f8207e44537889daeaba13ac2e8",22851664,7,0,1,1056,312,312,0
"ea859f8207e44537889daeaba13ac2e8","56d94971a7a94257aa330183a8ebd0ea",22851664,1,1,0,1063,312,313,1
"56d94971a7a94257aa330183a8ebd0ea","56d94971a7a94257aa330183a8ebd0ea",22851664,8,0,1,1064,313,313,0
"56d94971a7a94257aa330183a8ebd0ea","141c0df6cd1946539aadd1c9b7068cd4",22851664,1,-5,0,1072,313,308,-5
"141c0df6cd1946539aadd1c9b7068cd4","13255e63e0aa4abf85e5211bf613d43e",22851664,1,10,0,1073,308,317,9
"13255e63e0aa4abf85e5211bf613d43e","13255e63e0aa4abf85e5211bf613d43e",22851664,1,0,1,1074,317,317,0
"13255e63e0aa4abf85e5211bf613d43e","0c787d16c9504873b1a4d903cec09948",22851664,1,-3,0,1075,317,314,-3
"0c787d16c9504873b1a4d903cec09948","86c27d40179e419c8e9d150fb6afa5d0",22851664,2,6,0,1076,314,319,5
"86c27d40179e419c8e9d150fb6afa5d0","8d7e0b55cf9849cda222a0f2440cec55",22851664,2,-1,0,1077,319,318,-1
"8d7e0b55cf9849cda222a0f2440cec55","24f1363179ad4aaa965484a78471912b",22851664,3,6,0,1078,318,323,5
"24f1363179ad4aaa965484a78471912b","47edbb64109243e6b0f8f64cdef90c6c",22851664,2,3,0,1079,323,326,3
"47edbb64109243e6b0f8f64cdef90c6c","3628bdce1dd2429ba924d2d4d09448d2",22851664,2,-4,0,1080,326,322,-4
"3628bdce1dd2429ba924d2d4d09448d2","47edbb64109243e6b0f8f64cdef90c6c",22851664,1,4,0,1081,322,326,4
"47edbb64109243e6b0f8f64cdef90c6c","43ea1b823a4b4e51b7c694c10725db82",22851664,1,2,0,1082,326,327,1
"43ea1b823a4b4e51b7c694c10725db82","24f1363179ad4aaa965484a78471912b",22851664,1,-5,0,1083,327,323,-4
"24f1363179ad4aaa965484a78471912b","4a29443515bb404cb8924e1c60a63b73",22851664,1,-49,0,1084,323,285,-38
"4a29443515bb404cb8924e1c60a63b73","0c787d16c9504873b1a4d903cec09948",22851664,1,38,0,1085,285,314,29
"0c787d16c9504873b1a4d903cec09948","3434c10e561d488a914e0f7d71907abd",22851664,1,-11,0,1086,314,305,-9
"3434c10e561d488a914e0f7d71907abd","0c787d16c9504873b1a4d903cec09948",22851664,1,11,0,1087,305,314,9
"3628bdce1dd2429ba924d2d4d09448d2","4a29443515bb404cb8924e1c60a63b73",22851664,1,-48,0,1093,322,285,-37
"4a29443515bb404cb8924e1c60a63b73","8d7e0b55cf9849cda222a0f2440cec55",22851664,1,43,0,1094,285,318,33
"8d7e0b55cf9849cda222a0f2440cec55","3434c10e561d488a914e0f7d71907abd",22851664,1,-16,0,1095,318,305,-13
"3434c10e561d488a914e0f7d71907abd","86c27d40179e419c8e9d150fb6afa5d0",22851664,1,17,0,1096,305,319,14
"86c27d40179e419c8e9d150fb6afa5d0","3434c10e561d488a914e0f7d71907abd",22851664,1,-17,0,1097,319,305,-14
"3434c10e561d488a914e0f7d71907abd","43ea1b823a4b4e51b7c694c10725db82",22851664,1,27,0,1098,305,327,22
"43ea1b823a4b4e51b7c694c10725db82","3434c10e561d488a914e0f7d71907abd",22851664,1,-27,0,1099,327,305,-22
"3434c10e561d488a914e0f7d71907abd","56b3fd1a212a4764be39d979fde3326e",22851664,1,28,0,1100,305,328,23
"56b3fd1a212a4764be39d979fde3326e","56b3fd1a212a4764be39d979fde3326e",22851664,1,0,1,1101,328,328,0
"56b3fd1a212a4764be39d979fde3326e","3434c10e561d488a914e0f7d71907abd",22851664,1,-28,0,1102,328,305,-23
"3434c10e561d488a914e0f7d71907abd","0c4079457ede49e3aeb5e86ed84bdf35",22851664,1,31,0,1103,305,329,24
"0c4079457ede49e3aeb5e86ed84bdf35","38aea304b4fa46e1b29bb72f5cea4c93",22851664,2,2,0,1104,329,331,2
"38aea304b4fa46e1b29bb72f5cea4c93","e36d261332f14e79bb4b467aceaeb9b5",22851664,1,2,0,1105,331,333,2
"e36d261332f14e79bb4b467aceaeb9b5","e36d261332f14e79bb4b467aceaeb9b5",22851664,1,0,1,1106,333,333,0
"e36d261332f14e79bb4b467aceaeb9b5","c7e89b9d04744d2eab742fc24e3ef1ae",22851664,1,1,0,1107,333,334,1
"c7e89b9d04744d2eab742fc24e3ef1ae","c7e89b9d04744d2eab742fc24e3ef1ae",22851664,2,0,1,1108,334,334,0
"c7e89b9d04744d2eab742fc24e3ef1ae","fe49f8054b374a0ea4bb266ed135ff62",22851664,1,1,0,1110,334,335,1
"fe49f8054b374a0ea4bb266ed135ff62","fe49f8054b374a0ea4bb266ed135ff62",22851664,2,0,1,1111,335,335,0
"fe49f8054b374a0ea4bb266ed135ff62","d0a8f74af98642fe8360d22c42e45117",22851664,1,1,0,1113,335,336,1
"d0a8f74af98642fe8360d22c42e45117","d0a8f74af98642fe8360d22c42e45117",22851664,5,0,1,1114,336,336,0
"d0a8f74af98642fe8360d22c42e45117","0c4079457ede49e3aeb5e86ed84bdf35",22851664,1,-7,0,1119,336,329,-7
"0c4079457ede49e3aeb5e86ed84bdf35","a7c6339ca1da4368a18d471f0519f877",22851664,1,11,0,1120,329,339,10
"a7c6339ca1da4368a18d471f0519f877","a7c6339ca1da4368a18d471f0519f877",22851664,1,0,1,1121,339,339,0
"a7c6339ca1da4368a18d471f0519f877","bbc5139ca9024389a94db3a6f47dcff6",22851664,1,3,0,1122,339,341,2
"bbc5139ca9024389a94db3a6f47dcff6","b8b9418ab322418d9db9b40d96af873a",22851664,2,-5,0,1123,341,337,-4
"b8b9418ab322418d9db9b40d96af873a","4ee6ca9019ab4a1ab323f98094a9bd77",22851664,1,7,0,1124,337,343,6
"4ee6ca9019ab4a1ab323f98094a9bd77","4ee6ca9019ab4a1ab323f98094a9bd77",22851664,8,0,1,1125,343,343,0
"4ee6ca9019ab4a1ab323f98094a9bd77","b37947176785476f8b29d49a851366dc",22851664,1,1,0,1133,343,344,1
"b37947176785476f8b29d49a851366dc","b37947176785476f8b29d49a851366dc",22851664,2,0,1,1134,344,344,0
"b37947176785476f8b29d49a851366dc","fcea5b10d5a14a3b9324ffece8f6e1e5",22851664,1,1,0,1136,344,345,1
"fcea5b10d5a14a3b9324ffece8f6e1e5","fcea5b10d5a14a3b9324ffece8f6e1e5",22851664,2,0,1,1137,345,345,0
"fcea5b10d5a14a3b9324ffece8f6e1e5","c2490bc612d146edbe786556fab3651b",22851664,1,-5,0,1139,345,340,-5
"c2490bc612d146edbe786556fab3651b","0c4079457ede49e3aeb5e86ed84bdf35",22851664,2,-13,0,1140,340,329,-11
"38aea304b4fa46e1b29bb72f5cea4c93","0c4079457ede49e3aeb5e86ed84bdf35",22851664,2,-2,0,1142,331,329,-2
"0c4079457ede49e3aeb5e86ed84bdf35","b8b9418ab322418d9db9b40d96af873a",22851664,1,9,0,1143,329,337,8
"b8b9418ab322418d9db9b40d96af873a","bbc5139ca9024389a94db3a6f47dcff6",22851664,1,5,0,1144,337,341,4
"bbc5139ca9024389a94db3a6f47dcff6","c2490bc612d146edbe786556fab3651b",22851664,1,-1,0,1145,341,340,-1
"c2490bc612d146edbe786556fab3651b","6ac8bb048b854999a47edb35fe627f11",22851664,1,8,0,1146,340,347,7
"6ac8bb048b854999a47edb35fe627f11","6ac8bb048b854999a47edb35fe627f11",22851664,1,0,1,1147,347,347,0
"6ac8bb048b854999a47edb35fe627f11","30ead9794d4847abaf222ca966cc8630",22851664,1,3,0,1148,347,348,1
"30ead9794d4847abaf222ca966cc8630","0c4079457ede49e3aeb5e86ed84bdf35",22851664,1,-24,0,1149,348,329,-19
"0c4079457ede49e3aeb5e86ed84bdf35","09b9678ddc3d452ea4a3d46e15826065",22851664,1,29,0,1150,329,353,24
"09b9678ddc3d452ea4a3d46e15826065","897b7f51242c44aab2205c72fdcbf4cd",22851664,2,-1,0,1151,353,352,-1
"897b7f51242c44aab2205c72fdcbf4cd","c20993c944444fe085345591a8bd837e",22851664,2,-1,0,1152,352,351,-1
"c20993c944444fe085345591a8bd837e","eff0de7f2dbb42dfa1a2e686efab5b6d",22851664,1,3,0,1153,351,354,3
"eff0de7f2dbb42dfa1a2e686efab5b6d","c20993c944444fe085345591a8bd837e",22851664,2,-3,0,1154,354,351,-3
"c20993c944444fe085345591a8bd837e","c20993c944444fe085345591a8bd837e",22851664,4,0,1,1155,351,351,0
"c20993c944444fe085345591a8bd837e","897b7f51242c44aab2205c72fdcbf4cd",22851664,2,1,0,1158,351,352,1
"897b7f51242c44aab2205c72fdcbf4cd","897b7f51242c44aab2205c72fdcbf4cd",22851664,3,0,1,1159,352,352,0
"897b7f51242c44aab2205c72fdcbf4cd","09b9678ddc3d452ea4a3d46e15826065",22851664,1,1,0,1162,352,353,1
"09b9678ddc3d452ea4a3d46e15826065","09b9678ddc3d452ea4a3d46e15826065",22851664,4,0,1,1163,353,353,0
"09b9678ddc3d452ea4a3d46e15826065","eff0de7f2dbb42dfa1a2e686efab5b6d",22851664,1,1,0,1166,353,354,1
"eff0de7f2dbb42dfa1a2e686efab5b6d","eff0de7f2dbb42dfa1a2e686efab5b6d",22851664,4,0,1,1167,354,354,0
"eff0de7f2dbb42dfa1a2e686efab5b6d","30ead9794d4847abaf222ca966cc8630",22851664,1,-6,0,1170,354,348,-6
"30ead9794d4847abaf222ca966cc8630","2fe14166dc9642c3bc666b86a57f943d",22851664,2,10,0,1171,348,357,9
"2fe14166dc9642c3bc666b86a57f943d","4a29443515bb404cb8924e1c60a63b73",22851664,1,-92,0,1172,357,285,-72
"4a29443515bb404cb8924e1c60a63b73","30ead9794d4847abaf222ca966cc8630",22851664,1,82,0,1173,285,348,63
"30ead9794d4847abaf222ca966cc8630","1ba8fef685d74a8194b9db252eb704fb",22851664,1,8,0,1174,348,355,7
"1ba8fef685d74a8194b9db252eb704fb","2fe14166dc9642c3bc666b86a57f943d",22851664,1,2,0,1175,355,357,2
"2fe14166dc9642c3bc666b86a57f943d","44421dd1e13a47a388c4a19834b744c7",22851664,1,2,0,1176,357,359,2
"44421dd1e13a47a388c4a19834b744c7","44421dd1e13a47a388c4a19834b744c7",22851664,2,0,1,1177,359,359,0
"44421dd1e13a47a388c4a19834b744c7","cb5fc7ef85d547c4be1a7439d0bf6052",22851664,1,1,0,1179,359,360,1
"cb5fc7ef85d547c4be1a7439d0bf6052","cb5fc7ef85d547c4be1a7439d0bf6052",22851664,5,0,1,1180,360,360,0
"cb5fc7ef85d547c4be1a7439d0bf6052","0a8f150a4cf747acbde62f4721823da3",22851664,1,1,0,1185,360,361,1
"0a8f150a4cf747acbde62f4721823da3","0a8f150a4cf747acbde62f4721823da3",22851664,5,0,1,1186,361,361,0
"0a8f150a4cf747acbde62f4721823da3","ab8fdad974ae471f9f24c3f9dd04462e",22851664,1,1,0,1191,361,362,1
"ab8fdad974ae471f9f24c3f9dd04462e","ab8fdad974ae471f9f24c3f9dd04462e",22851664,5,0,1,1192,362,362,0
"ab8fdad974ae471f9f24c3f9dd04462e","1ba8fef685d74a8194b9db252eb704fb",22851664,1,-7,0,1197,362,355,-7
"1ba8fef685d74a8194b9db252eb704fb","52580888dadb4fe3baa795683ea227bd",22851664,2,10,0,1198,355,364,9
"52580888dadb4fe3baa795683ea227bd","492a3bc6a1254f23a7998587961b22a4",22851664,2,3,0,1199,364,366,2
"492a3bc6a1254f23a7998587961b22a4","f00179e251a045b39c3f7a54f9aa4acc",22851664,2,-4,0,1200,366,363,-3
"f00179e251a045b39c3f7a54f9aa4acc","072a190fd302456290895f9f04d6940a",22851664,2,3,0,1201,363,365,2
"072a190fd302456290895f9f04d6940a","cfa457d1743848e4bb5e4beced6448ed",22851664,1,5,0,1202,365,369,4
"cfa457d1743848e4bb5e4beced6448ed","cfa457d1743848e4bb5e4beced6448ed",22851664,1,0,1,1203,369,369,0
"cfa457d1743848e4bb5e4beced6448ed","b71bac264efb4abd97015447bd490db6",22851664,1,3,0,1204,369,370,1
"b71bac264efb4abd97015447bd490db6","30ead9794d4847abaf222ca966cc8630",22851664,1,-28,0,1205,370,348,-22
"30ead9794d4847abaf222ca966cc8630","b71bac264efb4abd97015447bd490db6",22851664,2,28,0,1206,348,370,22
"b71bac264efb4abd97015447bd490db6","8d448d625b024c82a5eb240bbd7431d6",22851664,3,5,0,1207,370,374,4
"8d448d625b024c82a5eb240bbd7431d6","8d448d625b024c82a5eb240bbd7431d6",22851664,68,0,1,1208,374,374,0
"8d448d625b024c82a5eb240bbd7431d6","d6d02b6ef04e4f17805504500b8ce441",22851664,2,3,0,1260,374,375,1
"d6d02b6ef04e4f17805504500b8ce441","b71bac264efb4abd97015447bd490db6",22851664,2,-8,0,1261,375,370,-5
"b71bac264efb4abd97015447bd490db6","d6d02b6ef04e4f17805504500b8ce441",22851664,3,8,0,1262,370,375,5
"d6d02b6ef04e4f17805504500b8ce441","d6d02b6ef04e4f17805504500b8ce441",22851664,3,0,1,1263,375,375,0
"d6d02b6ef04e4f17805504500b8ce441","66baf19b6b904b70922329068c63746d",22851664,2,4,0,1264,375,376,1
"66baf19b6b904b70922329068c63746d","7f544639412e40a9ba27f43b415362ab",22851664,3,2,0,1265,376,378,2
"7f544639412e40a9ba27f43b415362ab","d5ae8642e15b46b8bd298b02274d4e9c",22851664,1,2,0,1266,378,380,2
"d5ae8642e15b46b8bd298b02274d4e9c","d5ae8642e15b46b8bd298b02274d4e9c",22851664,1,0,1,1267,380,380,0
"d5ae8642e15b46b8bd298b02274d4e9c","a0d10309a2dd456289147f84be9d37f9",22851664,1,1,0,1268,380,381,1
"a0d10309a2dd456289147f84be9d37f9","a0d10309a2dd456289147f84be9d37f9",22851664,2,0,1,1269,381,381,0
"a0d10309a2dd456289147f84be9d37f9","0fcbc3ca07b144138b8d85da581f09a8",22851664,1,1,0,1271,381,382,1
"0fcbc3ca07b144138b8d85da581f09a8","0fcbc3ca07b144138b8d85da581f09a8",22851664,8,0,1,1272,382,382,0
"0fcbc3ca07b144138b8d85da581f09a8","66baf19b6b904b70922329068c63746d",22851664,1,-6,0,1280,382,376,-6
"66baf19b6b904b70922329068c63746d","c2fca3669923477ab966ded303dea31c",22851664,2,8,0,1281,376,383,7
"c2fca3669923477ab966ded303dea31c","4890121ce5d74576b4632b77cfc23398",22851664,2,6,0,1282,383,388,5
"4890121ce5d74576b4632b77cfc23398","96bb2b3e85a34d8b9544514e89f6fe97",22851664,1,3,0,1283,388,390,2
"96bb2b3e85a34d8b9544514e89f6fe97","18d3b836dd804224883cc9180b60a8e1",22851664,2,-4,0,1284,390,387,-3
"18d3b836dd804224883cc9180b60a8e1","ac4e9b54acfe4670b4634859c7263cb5",22851664,1,6,0,1285,387,392,5
"ac4e9b54acfe4670b4634859c7263cb5","ac4e9b54acfe4670b4634859c7263cb5",22851664,2,0,1,1286,392,392,0
"ac4e9b54acfe4670b4634859c7263cb5","66baf19b6b904b70922329068c63746d",22851664,1,-19,0,1287,392,376,-16
"7f544639412e40a9ba27f43b415362ab","66baf19b6b904b70922329068c63746d",22851664,3,-2,0,1289,378,376,-2
"66baf19b6b904b70922329068c63746d","4890121ce5d74576b4632b77cfc23398",22851664,3,14,0,1290,376,388,12
"4890121ce5d74576b4632b77cfc23398","c2fca3669923477ab966ded303dea31c",22851664,2,-6,0,1291,388,383,-5
"c2fca3669923477ab966ded303dea31c","18d3b836dd804224883cc9180b60a8e1",22851664,1,5,0,1292,383,387,4
"18d3b836dd804224883cc9180b60a8e1","96bb2b3e85a34d8b9544514e89f6fe97",22851664,2,4,0,1293,387,390,3
"96bb2b3e85a34d8b9544514e89f6fe97","ac4e9b54acfe4670b4634859c7263cb5",22851664,1,2,0,1294,390,392,2
"ac4e9b54acfe4670b4634859c7263cb5","17f95d18bab743888e1736033dc3384d",22851664,1,-3,0,1296,392,389,-3
"17f95d18bab743888e1736033dc3384d","6f8881a745ac4c358a68b92c3b4abe81",22851664,3,6,0,1297,389,394,5
"6f8881a745ac4c358a68b92c3b4abe81","f7002c8484354eceac57bc7bd62c76c1",22851664,3,-1,0,1298,394,393,-1
"f7002c8484354eceac57bc7bd62c76c1","44a277ea44dc4ae689fab4b82f0b4098",22851664,1,5,0,1299,393,397,4
"44a277ea44dc4ae689fab4b82f0b4098","44a277ea44dc4ae689fab4b82f0b4098",22851664,1,0,1,1300,397,397,0
"44a277ea44dc4ae689fab4b82f0b4098","0c12af0a4e7f4002852cf84b2537c161",22851664,1,-2,0,1301,397,395,-2
"0c12af0a4e7f4002852cf84b2537c161","66baf19b6b904b70922329068c63746d",22851664,3,-24,0,1302,395,376,-19
"66baf19b6b904b70922329068c63746d","df8191ec5e584c838a899c378941a566",22851664,1,28,0,1303,376,398,22
"df8191ec5e584c838a899c378941a566","66baf19b6b904b70922329068c63746d",22851664,1,-28,0,1304,398,376,-22
"66baf19b6b904b70922329068c63746d","859e0b8d71694b12befb69ee698138f9",22851664,1,29,0,1305,376,399,23
"859e0b8d71694b12befb69ee698138f9","859e0b8d71694b12befb69ee698138f9",22851664,1,0,1,1306,399,399,0
"859e0b8d71694b12befb69ee698138f9","66baf19b6b904b70922329068c63746d",22851664,1,-29,0,1307,399,376,-23
"66baf19b6b904b70922329068c63746d","2b09a08242b54983aec7063990fb3f66",22851664,6,32,0,1308,376,400,24
"2b09a08242b54983aec7063990fb3f66","2b09a08242b54983aec7063990fb3f66",22851664,15,0,1,1309,400,400,0
"2b09a08242b54983aec7063990fb3f66","1f471b7a883a4df48211e8c6a81b59a7",22851664,1,1,0,1310,400,401,1
"1f471b7a883a4df48211e8c6a81b59a7","1f471b7a883a4df48211e8c6a81b59a7",22851664,1,0,1,1311,401,401,0
"1f471b7a883a4df48211e8c6a81b59a7","2b09a08242b54983aec7063990fb3f66",22851664,1,-1,0,1312,401,400,-1
"2b09a08242b54983aec7063990fb3f66","c76574d21bc14aeea7ecd0b027f39858",22851664,1,-49,0,1313,400,367,-33
"c76574d21bc14aeea7ecd0b027f39858","30ead9794d4847abaf222ca966cc8630",22851664,1,-23,0,1314,367,348,-19
"30ead9794d4847abaf222ca966cc8630","c76574d21bc14aeea7ecd0b027f39858",22851664,1,23,0,1315,348,367,19
"c76574d21bc14aeea7ecd0b027f39858","492a3bc6a1254f23a7998587961b22a4",22851664,1,-2,0,1316,367,366,-1
"492a3bc6a1254f23a7998587961b22a4","52580888dadb4fe3baa795683ea227bd",22851664,1,-3,0,1317,366,364,-2
"52580888dadb4fe3baa795683ea227bd","072a190fd302456290895f9f04d6940a",22851664,1,2,0,1318,364,365,1
"072a190fd302456290895f9f04d6940a","2fe14166dc9642c3bc666b86a57f943d",22851664,1,-10,0,1319,365,357,-8
"2fe14166dc9642c3bc666b86a57f943d","f00179e251a045b39c3f7a54f9aa4acc",22851664,1,7,0,1320,357,363,6
"f00179e251a045b39c3f7a54f9aa4acc","4a29443515bb404cb8924e1c60a63b73",22851664,1,-99,0,1321,363,285,-78
"4a29443515bb404cb8924e1c60a63b73","2add1669f08d4101913db15f8c23b3b7",22851664,1,178,0,1322,285,416,131
"2add1669f08d4101913db15f8c23b3b7","2b09a08242b54983aec7063990fb3f66",22851664,2,-24,0,1323,416,400,-16
"2b09a08242b54983aec7063990fb3f66","17f95d18bab743888e1736033dc3384d",22851664,1,-16,0,1324,400,389,-11
"17f95d18bab743888e1736033dc3384d","66baf19b6b904b70922329068c63746d",22851664,1,-16,0,1325,389,376,-13
"66baf19b6b904b70922329068c63746d","96bb2b3e85a34d8b9544514e89f6fe97",22851664,1,17,0,1326,376,390,14
"96bb2b3e85a34d8b9544514e89f6fe97","17f95d18bab743888e1736033dc3384d",22851664,1,-1,0,1327,390,389,-1
"f7002c8484354eceac57bc7bd62c76c1","0c12af0a4e7f4002852cf84b2537c161",22851664,3,3,0,1330,393,395,2
"2b09a08242b54983aec7063990fb3f66","9de0d567bfa84fe5b77cb76f4a76a5d1",22851664,1,5,0,1335,400,404,4
"9de0d567bfa84fe5b77cb76f4a76a5d1","9de0d567bfa84fe5b77cb76f4a76a5d1",22851664,1,0,1,1336,404,404,0
"9de0d567bfa84fe5b77cb76f4a76a5d1","1157bd665ec4472fb58b751dc5099355",22851664,1,-1,0,1337,404,403,-1
"1157bd665ec4472fb58b751dc5099355","3c8a22d2f9c146ea956609e3ed4f2559",22851664,2,3,0,1338,403,405,2
"3c8a22d2f9c146ea956609e3ed4f2559","58fc9094275e4c49be3f4ba6d4acc0a4",22851664,5,2,0,1339,405,406,1
"58fc9094275e4c49be3f4ba6d4acc0a4","c1c1be90b2b14c1ab4a5e1ee3c241902",22851664,1,1,0,1340,406,407,1
"c1c1be90b2b14c1ab4a5e1ee3c241902","c1c1be90b2b14c1ab4a5e1ee3c241902",22851664,5,0,1,1341,407,407,0
"c1c1be90b2b14c1ab4a5e1ee3c241902","58fc9094275e4c49be3f4ba6d4acc0a4",22851664,1,-1,0,1346,407,406,-1
"58fc9094275e4c49be3f4ba6d4acc0a4","02b3a1bead9244c1ba2f857c7da8f82a",22851664,6,3,0,1347,406,408,2
"02b3a1bead9244c1ba2f857c7da8f82a","6206fc6479014bb193084c32409dc1b9",22851664,1,1,0,1348,408,409,1
"6206fc6479014bb193084c32409dc1b9","6206fc6479014bb193084c32409dc1b9",22851664,4,0,1,1349,409,409,0
"6206fc6479014bb193084c32409dc1b9","02b3a1bead9244c1ba2f857c7da8f82a",22851664,1,-1,0,1353,409,408,-1
"02b3a1bead9244c1ba2f857c7da8f82a","6a5f020451db426dacba9e2ea3fcc62a",22851664,5,3,0,1354,408,410,2
"6a5f020451db426dacba9e2ea3fcc62a","33a9d248b2e44588a5b07fc1342b9bc2",22851664,4,2,0,1355,410,411,1
"33a9d248b2e44588a5b07fc1342b9bc2","6a5f020451db426dacba9e2ea3fcc62a",22851664,3,-2,0,1356,411,410,-1
"6a5f020451db426dacba9e2ea3fcc62a","c6f26bd420634f1cb7989e76fe6b16c0",22851664,1,3,0,1357,410,412,2
"c6f26bd420634f1cb7989e76fe6b16c0","c6f26bd420634f1cb7989e76fe6b16c0",22851664,5,0,1,1358,412,412,0
"c6f26bd420634f1cb7989e76fe6b16c0","2a65ee6e2ac64f6a8a55fbe5373ec763",22851664,1,1,0,1363,412,413,1
"2a65ee6e2ac64f6a8a55fbe5373ec763","2a65ee6e2ac64f6a8a55fbe5373ec763",22851664,2,0,1,1364,413,413,0
"2a65ee6e2ac64f6a8a55fbe5373ec763","33a9d248b2e44588a5b07fc1342b9bc2",22851664,1,-2,0,1366,413,411,-2
"33a9d248b2e44588a5b07fc1342b9bc2","687055dad9fc40c3982478fe33ec01bf",22851664,3,4,0,1367,411,414,3
"687055dad9fc40c3982478fe33ec01bf","2b09a08242b54983aec7063990fb3f66",22851664,3,-21,0,1368,414,400,-14
"2b09a08242b54983aec7063990fb3f66","a2b4bd40cee2481ebd3fc179d6a5cd62",22851664,3,27,0,1369,400,417,17
"a2b4bd40cee2481ebd3fc179d6a5cd62","e34e59dce2204f228f3a84b6725df60f",22851664,1,2,0,1370,417,419,2
"e34e59dce2204f228f3a84b6725df60f","e34e59dce2204f228f3a84b6725df60f",22851664,1,0,1,1371,419,419,0
"e34e59dce2204f228f3a84b6725df60f","a2b4bd40cee2481ebd3fc179d6a5cd62",22851664,1,-2,0,1372,419,417,-2
"a2b4bd40cee2481ebd3fc179d6a5cd62","bec48fc2e1294c7eb3d0aca780d731b8",22851664,4,4,0,1373,417,420,3
"bec48fc2e1294c7eb3d0aca780d731b8","bec48fc2e1294c7eb3d0aca780d731b8",22851664,5,0,1,1374,420,420,0
"bec48fc2e1294c7eb3d0aca780d731b8","a24600b0e49245f6bdba8c893cfeddb0",22851664,3,7,0,1375,420,425,5
"a24600b0e49245f6bdba8c893cfeddb0","dbde19fcce2a4c1abdc7f685c293a23f",22851664,3,-4,0,1376,425,422,-3
"dbde19fcce2a4c1abdc7f685c293a23f","a24600b0e49245f6bdba8c893cfeddb0",22851664,4,4,0,1377,422,425,3
"a24600b0e49245f6bdba8c893cfeddb0","a2b4bd40cee2481ebd3fc179d6a5cd62",22851664,3,-11,0,1378,425,417,-8
"a2b4bd40cee2481ebd3fc179d6a5cd62","24cf8786024543f19b89bc20034e60d7",22851664,3,18,0,1379,417,428,11
"24cf8786024543f19b89bc20034e60d7","f2a73be2f46840b182d7bd095378004e",22851664,6,1,0,1380,428,429,1
"f2a73be2f46840b182d7bd095378004e","604551fd4266430cb860fef58fa7dd61",22851664,1,1,0,1381,429,430,1
"604551fd4266430cb860fef58fa7dd61","604551fd4266430cb860fef58fa7dd61",22851664,8,0,1,1382,430,430,0
"604551fd4266430cb860fef58fa7dd61","24cf8786024543f19b89bc20034e60d7",22851664,1,-2,0,1390,430,428,-2
"24cf8786024543f19b89bc20034e60d7","dce46f8904594a62a6377a3587aaa663",22851664,5,4,0,1391,428,431,3
"dce46f8904594a62a6377a3587aaa663","9b9d0a249052413c869753b99682b0ac",22851664,1,1,0,1392,431,432,1
"9b9d0a249052413c869753b99682b0ac","9b9d0a249052413c869753b99682b0ac",22851664,7,0,1,1393,432,432,0
"9b9d0a249052413c869753b99682b0ac","061c175cc90f45fbad883025394e78dd",22851664,1,1,0,1400,432,433,1
"061c175cc90f45fbad883025394e78dd","061c175cc90f45fbad883025394e78dd",22851664,5,0,1,1401,433,433,0
"061c175cc90f45fbad883025394e78dd","dce46f8904594a62a6377a3587aaa663",22851664,1,-2,0,1406,433,431,-2
"dce46f8904594a62a6377a3587aaa663","66baf19b6b904b70922329068c63746d",22851664,1,-81,0,1407,431,376,-55
"66baf19b6b904b70922329068c63746d","070600601c4c439288445d2f0724807d",22851664,2,91,0,1408,376,437,61
"070600601c4c439288445d2f0724807d","070600601c4c439288445d2f0724807d",22851664,3,0,1,1409,437,437,0
"070600601c4c439288445d2f0724807d","1823b6de7d334a7aaabc4570719af4d9",22851664,5,2,0,1410,437,439,2
"1823b6de7d334a7aaabc4570719af4d9","1823b6de7d334a7aaabc4570719af4d9",22851664,14,0,1,1411,439,439,0
"1823b6de7d334a7aaabc4570719af4d9","070600601c4c439288445d2f0724807d",22851664,4,-2,0,1423,439,437,-2
"070600601c4c439288445d2f0724807d","0380cd76a7d44bc3a4da1f15e4d68f89",22851664,4,4,0,1428,437,440,3
"0380cd76a7d44bc3a4da1f15e4d68f89","0380cd76a7d44bc3a4da1f15e4d68f89",22851664,3,0,1,1429,440,440,0
"0380cd76a7d44bc3a4da1f15e4d68f89","23b7673c8b5443108c2ef09382834a86",22851664,3,2,0,1430,440,441,1
"23b7673c8b5443108c2ef09382834a86","901e92500aea43c79f19f1b279050668",22851664,5,2,0,1431,441,442,1
"901e92500aea43c79f19f1b279050668","23b7673c8b5443108c2ef09382834a86",22851664,3,-2,0,1432,442,441,-1
"23b7673c8b5443108c2ef09382834a86","001339db8ced4cf78829ebe8b145449d",22851664,1,3,0,1433,441,443,2
"001339db8ced4cf78829ebe8b145449d","001339db8ced4cf78829ebe8b145449d",22851664,11,0,1,1434,443,443,0
"001339db8ced4cf78829ebe8b145449d","452745e0366e42ae81561bfddebcc6c3",22851664,1,1,0,1445,443,444,1
"452745e0366e42ae81561bfddebcc6c3","452745e0366e42ae81561bfddebcc6c3",22851664,2,0,1,1446,444,444,0
"452745e0366e42ae81561bfddebcc6c3","901e92500aea43c79f19f1b279050668",22851664,1,-2,0,1448,444,442,-2
"901e92500aea43c79f19f1b279050668","4660ff2089114e8db82ceb26a4f329e3",22851664,4,4,0,1449,442,445,3
"4660ff2089114e8db82ceb26a4f329e3","7bd5586eb9d8484eb74a433ee7bfe499",22851664,4,2,0,1450,445,446,1
"7bd5586eb9d8484eb74a433ee7bfe499","4660ff2089114e8db82ceb26a4f329e3",22851664,1,-2,0,1451,446,445,-1
"7bd5586eb9d8484eb74a433ee7bfe499","7bd5586eb9d8484eb74a433ee7bfe499",22851664,10,0,1,1453,446,446,0
"7bd5586eb9d8484eb74a433ee7bfe499","070600601c4c439288445d2f0724807d",22851664,1,-14,0,1461,446,437,-9
"070600601c4c439288445d2f0724807d","b2f0d654738f48158edff28e8d3a546e",22851664,2,21,0,1462,437,449,12
"b2f0d654738f48158edff28e8d3a546e","b2f0d654738f48158edff28e8d3a546e",22851664,3,0,1,1463,449,449,0
"b2f0d654738f48158edff28e8d3a546e","f60ee41ec635499abd48168342d32c2f",22851664,3,5,0,1464,449,453,4
"f60ee41ec635499abd48168342d32c2f","f60ee41ec635499abd48168342d32c2f",22851664,66,0,1,1465,453,453,0
"f60ee41ec635499abd48168342d32c2f","b2f0d654738f48158edff28e8d3a546e",22851664,4,-5,0,1483,453,449,-4
"b2f0d654738f48158edff28e8d3a546e","f67fbf45a5f146ed866965bc57c7c001",22851664,3,8,0,1484,449,454,5
"f67fbf45a5f146ed866965bc57c7c001","f67fbf45a5f146ed866965bc57c7c001",22851664,4,0,1,1485,454,454,0
"f67fbf45a5f146ed866965bc57c7c001","d937afe49bd24a07a550dda1c1155122",22851664,1,1,0,1487,454,455,1
"d937afe49bd24a07a550dda1c1155122","d937afe49bd24a07a550dda1c1155122",22851664,5,0,1,1488,455,455,0
"d937afe49bd24a07a550dda1c1155122","3628b3f7823443d0912a339096b69943",22851664,1,1,0,1493,455,456,1
"3628b3f7823443d0912a339096b69943","3628b3f7823443d0912a339096b69943",22851664,1,0,1,1494,456,456,0
"3628b3f7823443d0912a339096b69943","9e049ee647cf43ecbcb5ed792a8e7588",22851664,1,1,0,1495,456,457,1
"9e049ee647cf43ecbcb5ed792a8e7588","9e049ee647cf43ecbcb5ed792a8e7588",22851664,1,0,1,1496,457,457,0
"9e049ee647cf43ecbcb5ed792a8e7588","5256a214faaf410b93f76cea06428334",22851664,1,1,0,1497,457,458,1
"5256a214faaf410b93f76cea06428334","5256a214faaf410b93f76cea06428334",22851664,1,0,1,1498,458,458,0
"5256a214faaf410b93f76cea06428334","25c32b120fce40fa9b6c85133aeb4716",22851664,1,1,0,1499,458,459,1
"25c32b120fce40fa9b6c85133aeb4716","25c32b120fce40fa9b6c85133aeb4716",22851664,5,0,1,1500,459,459,0
"25c32b120fce40fa9b6c85133aeb4716","11bc14f2204949008b7d511b933363c1",22851664,1,1,0,1505,459,460,1
"11bc14f2204949008b7d511b933363c1","11bc14f2204949008b7d511b933363c1",22851664,5,0,1,1506,460,460,0
"11bc14f2204949008b7d511b933363c1","42de338840a34d15adb66e7b14fb9d2c",22851664,1,1,0,1511,460,461,1
"42de338840a34d15adb66e7b14fb9d2c","42de338840a34d15adb66e7b14fb9d2c",22851664,3,0,1,1512,461,461,0
"42de338840a34d15adb66e7b14fb9d2c","9da37c6210b1416b8079c274f70bf600",22851664,1,1,0,1515,461,462,1
"9da37c6210b1416b8079c274f70bf600","9da37c6210b1416b8079c274f70bf600",22851664,10,0,1,1516,462,462,0
"9da37c6210b1416b8079c274f70bf600","519119f1deac45ff9ab4f13529be5c6e",22851664,1,1,0,1526,462,463,1
"519119f1deac45ff9ab4f13529be5c6e","519119f1deac45ff9ab4f13529be5c6e",22851664,1,0,1,1527,463,463,0
"519119f1deac45ff9ab4f13529be5c6e","c5df9f40ec14463b9dcfdc73df3e9285",22851664,1,3,0,1528,463,464,1
"c5df9f40ec14463b9dcfdc73df3e9285","f67fbf45a5f146ed866965bc57c7c001",22851664,2,-12,0,1529,464,454,-10
"f67fbf45a5f146ed866965bc57c7c001","c5df9f40ec14463b9dcfdc73df3e9285",22851664,2,12,0,1530,454,464,10
"c5df9f40ec14463b9dcfdc73df3e9285","c5df9f40ec14463b9dcfdc73df3e9285",22851664,7,0,1,1531,464,464,0
"c5df9f40ec14463b9dcfdc73df3e9285","83d42d95cd844fc093fc09cee250edb8",22851664,2,3,0,1532,464,465,1
"83d42d95cd844fc093fc09cee250edb8","83d42d95cd844fc093fc09cee250edb8",22851664,7,0,1,1533,465,465,0
"83d42d95cd844fc093fc09cee250edb8","8959e6304a0348309a771e4d08d1b64a",22851664,1,-427,0,1535,465,163,-302
"8959e6304a0348309a771e4d08d1b64a","78adeee1fa2c4fe0bc73f7bca9fcee86",22851664,2,-4,0,1536,163,160,-3
"78adeee1fa2c4fe0bc73f7bca9fcee86","65202579580f4ad38d734b4ee39d22a8",22851664,7,5,0,1537,160,164,4
"65202579580f4ad38d734b4ee39d22a8","65202579580f4ad38d734b4ee39d22a8",22851664,85,0,1,1538,164,164,0
"65202579580f4ad38d734b4ee39d22a8","78adeee1fa2c4fe0bc73f7bca9fcee86",22851664,3,-5,0,1588,164,160,-4
"78adeee1fa2c4fe0bc73f7bca9fcee86","3cbcea2be0984e7dbd5a48195af10ce7",22851664,1,8,0,1589,160,165,5
"3cbcea2be0984e7dbd5a48195af10ce7","82e6285962b8400d9d6fc32436022a94",22851664,3,2,0,1590,165,167,2
"82e6285962b8400d9d6fc32436022a94","56586aa865414f538729c7f7735d2bc6",22851664,1,-219,0,1591,167,12,-155
"56586aa865414f538729c7f7735d2bc6","56586aa865414f538729c7f7735d2bc6",22851664,15,0,1,1592,12,12,0
"56586aa865414f538729c7f7735d2bc6","b7f2b31585d94eb3bf86376714aa7070",22851664,6,2,0,1595,12,13,1
"b7f2b31585d94eb3bf86376714aa7070","b7f2b31585d94eb3bf86376714aa7070",22851664,7,0,1,1596,13,13,0
"b7f2b31585d94eb3bf86376714aa7070","3f1c815879794b929260d224becaff7e",22851664,4,2,0,1599,13,14,1
"3f1c815879794b929260d224becaff7e","5c5ceeee4562457ba6d41515aeebfbb1",22851664,2,6,0,1600,14,17,3
"5c5ceeee4562457ba6d41515aeebfbb1","81c864a886d54a6b8ff85f7d736f4f95",22851664,2,-4,0,1601,17,15,-2
"81c864a886d54a6b8ff85f7d736f4f95","56586aa865414f538729c7f7735d2bc6",22851664,1,-6,0,1602,15,12,-3
"56586aa865414f538729c7f7735d2bc6","9afd71a5298d4333b6849dfce1b9422c",22851664,2,13,0,1603,12,18,6
"9afd71a5298d4333b6849dfce1b9422c","9afd71a5298d4333b6849dfce1b9422c",22851664,3,0,1,1604,18,18,0
"9afd71a5298d4333b6849dfce1b9422c","b7719e26494940efa49512aedd0aac79",22851664,1,4,0,1605,18,20,2
"b7719e26494940efa49512aedd0aac79","d4f45188d3c84a02ba08454e6403a818",22851664,1,5,0,1606,20,24,4
"d4f45188d3c84a02ba08454e6403a818","d4c3b003e8274e429d2fa688d73fde6d",22851664,2,-2,0,1607,24,22,-2
"d4c3b003e8274e429d2fa688d73fde6d","b7719e26494940efa49512aedd0aac79",22851664,3,-3,0,1608,22,20,-2
"b7719e26494940efa49512aedd0aac79","b7719e26494940efa49512aedd0aac79",22851664,3,0,1,1609,20,20,0
"b7719e26494940efa49512aedd0aac79","afbf7250b99d47bea07172749483ca97",22851664,5,12,0,1610,20,28,8
"afbf7250b99d47bea07172749483ca97","a49d1bb4328949299686242fd0be5584",22851664,1,-10,0,1611,28,21,-7
"a49d1bb4328949299686242fd0be5584","b7719e26494940efa49512aedd0aac79",22851664,3,-2,0,1612,21,20,-1
"afbf7250b99d47bea07172749483ca97","b7719e26494940efa49512aedd0aac79",22851664,1,-12,0,1614,28,20,-8
"afbf7250b99d47bea07172749483ca97","4e51676dc72045d99c19b9fa7b22f8bc",22851664,2,3,0,1616,28,29,1
"4e51676dc72045d99c19b9fa7b22f8bc","4e51676dc72045d99c19b9fa7b22f8bc",22851664,2,0,1,1617,29,29,0
"4e51676dc72045d99c19b9fa7b22f8bc","51970cfa30e643e894e66ae85c8024cc",22851664,3,3,0,1618,29,31,2
"51970cfa30e643e894e66ae85c8024cc","4e51676dc72045d99c19b9fa7b22f8bc",22851664,2,-3,0,1619,31,29,-2
"4e51676dc72045d99c19b9fa7b22f8bc","c33c17be71ae4d588da7369472e5bb1b",22851664,2,9,0,1620,29,34,5
"c33c17be71ae4d588da7369472e5bb1b","93679be414554a11b1893002f2229a93",22851664,3,3,0,1621,34,35,1
"93679be414554a11b1893002f2229a93","c33c17be71ae4d588da7369472e5bb1b",22851664,1,-3,0,1622,35,34,-1
"93679be414554a11b1893002f2229a93","7040a13096d746ac84b8fac8d9752058",22851664,2,3,0,1624,35,36,1
"7040a13096d746ac84b8fac8d9752058","7040a13096d746ac84b8fac8d9752058",22851664,1,0,1,1625,36,36,0
"9a0dc646f934470daf08c4b56ccf73db","9a0dc646f934470daf08c4b56ccf73db",22851664,1,0,1,1627,37,37,0
"fc0e049d56024bc9a02c9a9c435c3df7","64d48c6c9c7940639a932219a6c87198",22851664,1,5,0,1631,38,40,2
"64d48c6c9c7940639a932219a6c87198","a49d1bb4328949299686242fd0be5584",22851664,1,-39,0,1632,40,21,-19
"b7719e26494940efa49512aedd0aac79","a49d1bb4328949299686242fd0be5584",22851664,2,2,0,1634,20,21,1
"a49d1bb4328949299686242fd0be5584","d4c3b003e8274e429d2fa688d73fde6d",22851664,1,1,0,1635,21,22,1
"d4c3b003e8274e429d2fa688d73fde6d","d4f45188d3c84a02ba08454e6403a818",22851664,1,2,0,1636,22,24,2
"d4f45188d3c84a02ba08454e6403a818","5bc03c8f16354d04bd51f5bb93559ad3",22851664,1,2,0,1637,24,26,2
"5bc03c8f16354d04bd51f5bb93559ad3","d4c3b003e8274e429d2fa688d73fde6d",22851664,1,-4,0,1638,26,22,-4
"a49d1bb4328949299686242fd0be5584","d4f45188d3c84a02ba08454e6403a818",22851664,1,3,0,1641,21,24,3
"afbf7250b99d47bea07172749483ca97","8959e6304a0348309a771e4d08d1b64a",22851664,1,184,0,1646,28,163,135
"78adeee1fa2c4fe0bc73f7bca9fcee86","78adeee1fa2c4fe0bc73f7bca9fcee86",22851664,7,0,1,1648,160,160,0
"78adeee1fa2c4fe0bc73f7bca9fcee86","1c6721b1f63f4d30ba7746ea8af02a52",22851664,1,87,0,1649,160,221,61
"1c6721b1f63f4d30ba7746ea8af02a52","5152833676bf4c6cb317060be10f68db",22851664,1,9,0,1650,221,228,7
"5152833676bf4c6cb317060be10f68db","6e83e23f56544a19b94067c1c558d9c0",22851664,1,24,0,1651,228,247,19
"6e83e23f56544a19b94067c1c558d9c0","2ae94c0cea4d480a9d5dca8fb1d7b542",22851664,1,-6,0,1652,247,242,-5
"2ae94c0cea4d480a9d5dca8fb1d7b542","30c9ba177afc49a695625d2bdec40207",22851664,1,9,0,1653,242,250,8
"30c9ba177afc49a695625d2bdec40207","30c9ba177afc49a695625d2bdec40207",22851664,2,0,1,1654,250,250,0
"30c9ba177afc49a695625d2bdec40207","6e83e23f56544a19b94067c1c558d9c0",22851664,1,-3,0,1656,250,247,-3
"6e83e23f56544a19b94067c1c558d9c0","00f61990949545828dd12f1303d47504",22851664,2,11,0,1657,247,256,9
"00f61990949545828dd12f1303d47504","0c7262dff33c4087bc660ccf40f92f9c",22851664,2,-114,0,1658,256,169,-87
"0c7262dff33c4087bc660ccf40f92f9c","2ae94c0cea4d480a9d5dca8fb1d7b542",22851664,1,97,0,1659,169,242,73
"2ae94c0cea4d480a9d5dca8fb1d7b542","2ae94c0cea4d480a9d5dca8fb1d7b542",22851664,1,0,1,1660,242,242,0
"2ae94c0cea4d480a9d5dca8fb1d7b542","1ebf23f9d994469a85206e4c7b1bf5f5",22851664,3,3,0,1661,242,245,3
"1ebf23f9d994469a85206e4c7b1bf5f5","1ebf23f9d994469a85206e4c7b1bf5f5",22851664,38,0,1,1662,245,245,0
"1ebf23f9d994469a85206e4c7b1bf5f5","2ae94c0cea4d480a9d5dca8fb1d7b542",22851664,2,-3,0,1694,245,242,-3
"2ae94c0cea4d480a9d5dca8fb1d7b542","0c7262dff33c4087bc660ccf40f92f9c",22851664,1,-97,0,1695,242,169,-73
"0c7262dff33c4087bc660ccf40f92f9c","0d987bed3ffa4ed0b9a2e62e97b7b30f",22851664,1,135,0,1696,169,272,103
"0d987bed3ffa4ed0b9a2e62e97b7b30f","0d987bed3ffa4ed0b9a2e62e97b7b30f",22851664,3,0,1,1697,272,272,0
"0d987bed3ffa4ed0b9a2e62e97b7b30f","82ae07bc0c9b4570a41799290d1ef399",22851664,4,4,0,1699,272,275,3
"82ae07bc0c9b4570a41799290d1ef399","bb5a47f5ea01454a8b79455422d3b9da",22851664,4,6,0,1700,275,280,5
"bb5a47f5ea01454a8b79455422d3b9da","bb5a47f5ea01454a8b79455422d3b9da",22851664,80,0,1,1701,280,280,0
"bb5a47f5ea01454a8b79455422d3b9da","bc5524e78a8544e2ae2fdc2f3462bbec",22851664,1,-1,0,1708,280,279,-1
"bc5524e78a8544e2ae2fdc2f3462bbec","82ae07bc0c9b4570a41799290d1ef399",22851664,1,-5,0,1709,279,275,-4
"82ae07bc0c9b4570a41799290d1ef399","0d987bed3ffa4ed0b9a2e62e97b7b30f",22851664,1,-4,0,1710,275,272,-3
"bb5a47f5ea01454a8b79455422d3b9da","94cecc3f1e7d484b8e068e79241dfd73",22851664,3,3,0,1770,280,281,1
"94cecc3f1e7d484b8e068e79241dfd73","0d987bed3ffa4ed0b9a2e62e97b7b30f",22851664,3,-13,0,1771,281,272,-9
"0d987bed3ffa4ed0b9a2e62e97b7b30f","a37477c4e4c14169ad44b06b493007f6",22851664,3,15,0,1772,272,283,11
"a37477c4e4c14169ad44b06b493007f6","1b4550d0dab04078b3bf08a655345bdc",22851664,1,121,0,1773,283,373,90
"1b4550d0dab04078b3bf08a655345bdc","b71bac264efb4abd97015447bd490db6",22851664,1,-4,0,1774,373,370,-3
"d6d02b6ef04e4f17805504500b8ce441","18d3b836dd804224883cc9180b60a8e1",22851664,1,17,0,1788,375,387,12
"18d3b836dd804224883cc9180b60a8e1","66baf19b6b904b70922329068c63746d",22851664,1,-13,0,1789,387,376,-11
"4890121ce5d74576b4632b77cfc23398","18d3b836dd804224883cc9180b60a8e1",22851664,2,-1,0,1791,388,387,-1
"18d3b836dd804224883cc9180b60a8e1","7f544639412e40a9ba27f43b415362ab",22851664,1,-11,0,1792,387,378,-9
"7f544639412e40a9ba27f43b415362ab","c2fca3669923477ab966ded303dea31c",22851664,1,6,0,1793,378,383,5
"c2fca3669923477ab966ded303dea31c","7f544639412e40a9ba27f43b415362ab",22851664,1,-6,0,1794,383,378,-5
"4890121ce5d74576b4632b77cfc23398","4890121ce5d74576b4632b77cfc23398",22851664,1,0,1,1798,388,388,0
"96bb2b3e85a34d8b9544514e89f6fe97","6f8881a745ac4c358a68b92c3b4abe81",22851664,1,5,0,1801,390,394,4
"6f8881a745ac4c358a68b92c3b4abe81","17f95d18bab743888e1736033dc3384d",22851664,2,-6,0,1802,394,389,-5
"0c12af0a4e7f4002852cf84b2537c161","2b09a08242b54983aec7063990fb3f66",22851664,1,8,0,1806,395,400,5
"2b09a08242b54983aec7063990fb3f66","66baf19b6b904b70922329068c63746d",22851664,1,-32,0,1807,400,376,-24
"2b09a08242b54983aec7063990fb3f66","1157bd665ec4472fb58b751dc5099355",22851664,4,4,0,1811,400,403,3
"58fc9094275e4c49be3f4ba6d4acc0a4","58fc9094275e4c49be3f4ba6d4acc0a4",22851664,6,0,1,1814,406,406,0
"02b3a1bead9244c1ba2f857c7da8f82a","02b3a1bead9244c1ba2f857c7da8f82a",22851664,5,0,1,1817,408,408,0
"02b3a1bead9244c1ba2f857c7da8f82a","66baf19b6b904b70922329068c63746d",22851664,1,-44,0,1818,408,376,-32
"1157bd665ec4472fb58b751dc5099355","58fc9094275e4c49be3f4ba6d4acc0a4",22851664,3,5,0,1825,403,406,3
"58fc9094275e4c49be3f4ba6d4acc0a4","3c8a22d2f9c146ea956609e3ed4f2559",22851664,3,-2,0,1826,406,405,-1
"6a5f020451db426dacba9e2ea3fcc62a","6a5f020451db426dacba9e2ea3fcc62a",22851664,2,0,1,1833,410,410,0
"33a9d248b2e44588a5b07fc1342b9bc2","33a9d248b2e44588a5b07fc1342b9bc2",22851664,2,0,1,1836,411,411,0
"33a9d248b2e44588a5b07fc1342b9bc2","1fd0f6dadbc14ebc965faf6122190b96",22851664,1,5,0,1838,411,415,4
"1fd0f6dadbc14ebc965faf6122190b96","1fd0f6dadbc14ebc965faf6122190b96",22851664,1,0,1,1839,415,415,0
"1fd0f6dadbc14ebc965faf6122190b96","687055dad9fc40c3982478fe33ec01bf",22851664,1,-1,0,1840,415,414,-1
"6a5f020451db426dacba9e2ea3fcc62a","02b3a1bead9244c1ba2f857c7da8f82a",22851664,2,-3,0,1850,410,408,-2
"02b3a1bead9244c1ba2f857c7da8f82a","33a9d248b2e44588a5b07fc1342b9bc2",22851664,2,5,0,1851,408,411,3
"687055dad9fc40c3982478fe33ec01bf","2add1669f08d4101913db15f8c23b3b7",22851664,1,3,0,1855,414,416,2
"2add1669f08d4101913db15f8c23b3b7","2add1669f08d4101913db15f8c23b3b7",22851664,1,0,1,1856,416,416,0
"a2b4bd40cee2481ebd3fc179d6a5cd62","a2b4bd40cee2481ebd3fc179d6a5cd62",22851664,2,0,1,1859,417,417,0
"f2a73be2f46840b182d7bd095378004e","b2f0d654738f48158edff28e8d3a546e",22851664,1,34,0,1868,429,449,20
"f67fbf45a5f146ed866965bc57c7c001","2b09a08242b54983aec7063990fb3f66",22851664,1,-88,0,1916,454,400,-54
"2b09a08242b54983aec7063990fb3f66","58fc9094275e4c49be3f4ba6d4acc0a4",22851664,1,9,0,1917,400,406,6
"6a5f020451db426dacba9e2ea3fcc62a","66baf19b6b904b70922329068c63746d",22851664,1,-47,0,1925,410,376,-34
"2b09a08242b54983aec7063990fb3f66","bec48fc2e1294c7eb3d0aca780d731b8",22851664,1,31,0,1929,400,420,20
"bec48fc2e1294c7eb3d0aca780d731b8","a2b4bd40cee2481ebd3fc179d6a5cd62",22851664,1,-4,0,1930,420,417,-3
"bec48fc2e1294c7eb3d0aca780d731b8","dbde19fcce2a4c1abdc7f685c293a23f",22851664,1,3,0,1934,420,422,2
"a24600b0e49245f6bdba8c893cfeddb0","a24600b0e49245f6bdba8c893cfeddb0",22851664,2,0,1,1936,425,425,0
"a24600b0e49245f6bdba8c893cfeddb0","66baf19b6b904b70922329068c63746d",22851664,1,-70,0,1938,425,376,-49
"66baf19b6b904b70922329068c63746d","24cf8786024543f19b89bc20034e60d7",22851664,1,77,0,1939,376,428,52
"24cf8786024543f19b89bc20034e60d7","24cf8786024543f19b89bc20034e60d7",22851664,2,0,1,1940,428,428,0
"f2a73be2f46840b182d7bd095378004e","f2a73be2f46840b182d7bd095378004e",22851664,1,0,1,1942,429,429,0
"f2a73be2f46840b182d7bd095378004e","24cf8786024543f19b89bc20034e60d7",22851664,3,-1,0,1943,429,428,-1
"dce46f8904594a62a6377a3587aaa663","dce46f8904594a62a6377a3587aaa663",22851664,7,0,1,1945,431,431,0
"dce46f8904594a62a6377a3587aaa663","74a7f8712e5449c2bc0b43c6f90dafed",22851664,1,5,0,1947,431,435,4
"74a7f8712e5449c2bc0b43c6f90dafed","74a7f8712e5449c2bc0b43c6f90dafed",22851664,1,0,1,1948,435,435,0
"74a7f8712e5449c2bc0b43c6f90dafed","66ada10dde9f43018588f1ced9d477fc",22851664,1,-1,0,1949,435,434,-1
"66ada10dde9f43018588f1ced9d477fc","24cf8786024543f19b89bc20034e60d7",22851664,2,-8,0,1950,434,428,-6
"dce46f8904594a62a6377a3587aaa663","66ada10dde9f43018588f1ced9d477fc",22851664,4,4,0,1955,431,434,3
"66ada10dde9f43018588f1ced9d477fc","bf12c96466d840a69bed7020b3f18bb8",22851664,3,3,0,1956,434,436,2
"bf12c96466d840a69bed7020b3f18bb8","66ada10dde9f43018588f1ced9d477fc",22851664,2,-3,0,1957,436,434,-2
"66ada10dde9f43018588f1ced9d477fc","dce46f8904594a62a6377a3587aaa663",22851664,1,-4,0,1958,434,431,-3
"bf12c96466d840a69bed7020b3f18bb8","bf12c96466d840a69bed7020b3f18bb8",22851664,2,0,1,1964,436,436,0
"f2a73be2f46840b182d7bd095378004e","dce46f8904594a62a6377a3587aaa663",22851664,1,3,0,1969,429,431,2
"dce46f8904594a62a6377a3587aaa663","24cf8786024543f19b89bc20034e60d7",22851664,1,-4,0,1970,431,428,-3
"bf12c96466d840a69bed7020b3f18bb8","24cf8786024543f19b89bc20034e60d7",22851664,1,-11,0,1975,436,428,-8
"24cf8786024543f19b89bc20034e60d7","070600601c4c439288445d2f0724807d",22851664,1,14,0,1976,428,437,9
"0380cd76a7d44bc3a4da1f15e4d68f89","66baf19b6b904b70922329068c63746d",22851664,1,-95,0,1980,440,376,-64
"23b7673c8b5443108c2ef09382834a86","23b7673c8b5443108c2ef09382834a86",22851664,1,0,1,1989,441,441,0
"4660ff2089114e8db82ceb26a4f329e3","901e92500aea43c79f19f1b279050668",22851664,1,-4,0,1994,445,442,-3
"4660ff2089114e8db82ceb26a4f329e3","4660ff2089114e8db82ceb26a4f329e3",22851664,2,0,1,1996,445,445,0
"7bd5586eb9d8484eb74a433ee7bfe499","8a7f26e690f34dda97be16904518ca99",22851664,1,2,0,1999,446,447,1
"8a7f26e690f34dda97be16904518ca99","8a7f26e690f34dda97be16904518ca99",22851664,1,0,1,2000,447,447,0
"8a7f26e690f34dda97be16904518ca99","070600601c4c439288445d2f0724807d",22851664,1,-16,0,2001,447,437,-10
"b2f0d654738f48158edff28e8d3a546e","56586aa865414f538729c7f7735d2bc6",22851664,1,-617,0,2003,449,12,-437
"56586aa865414f538729c7f7735d2bc6","779f9ddd1fd14d1e9e69f72219a1fdbd",22851664,1,160,0,2007,12,121,109
"779f9ddd1fd14d1e9e69f72219a1fdbd","779f9ddd1fd14d1e9e69f72219a1fdbd",22851664,4,0,1,2008,121,121,0
"779f9ddd1fd14d1e9e69f72219a1fdbd","a8dd5213034441ac92724b4e83eb0bb2",22851664,5,9,0,2010,121,129,8
"a8dd5213034441ac92724b4e83eb0bb2","a8dd5213034441ac92724b4e83eb0bb2",22851664,1,0,1,2011,129,129,0
"a8dd5213034441ac92724b4e83eb0bb2","b416d47c56a742199b5d7c7f19d6503a",22851664,1,6,0,2012,129,134,5
"b416d47c56a742199b5d7c7f19d6503a","779f9ddd1fd14d1e9e69f72219a1fdbd",22851664,3,-15,0,2013,134,121,-13
"779f9ddd1fd14d1e9e69f72219a1fdbd","b416d47c56a742199b5d7c7f19d6503a",22851664,1,15,0,2014,121,134,13
"779f9ddd1fd14d1e9e69f72219a1fdbd","df1de691dafe4549a18a4398ee9dfaf9",22851664,2,23,0,2016,121,139,18
"df1de691dafe4549a18a4398ee9dfaf9","6c5ad271a44743479bfaea29b1db8d02",22851664,3,4,0,2017,139,143,4
"6c5ad271a44743479bfaea29b1db8d02","df1de691dafe4549a18a4398ee9dfaf9",22851664,3,-4,0,2018,143,139,-4
"df1de691dafe4549a18a4398ee9dfaf9","8aae34f5ddbb4052a709b12e6b0d40fa",22851664,3,9,0,2019,139,147,8
"8aae34f5ddbb4052a709b12e6b0d40fa","1c6721b1f63f4d30ba7746ea8af02a52",22851664,1,104,0,2020,147,221,74
"1c6721b1f63f4d30ba7746ea8af02a52","2ab1535aac1346ba8801535bf729ef37",22851664,1,10,0,2021,221,229,8
"2ab1535aac1346ba8801535bf729ef37","2ab1535aac1346ba8801535bf729ef37",22851664,1,0,1,2022,229,229,0
"2ab1535aac1346ba8801535bf729ef37","34a6e49023fc4465bd5ca604330bbd1c",22851664,1,86,0,2023,229,292,63
"34a6e49023fc4465bd5ca604330bbd1c","4a29443515bb404cb8924e1c60a63b73",22851664,1,-9,0,2024,292,285,-7
"4a29443515bb404cb8924e1c60a63b73","869e967078f04da18dd0b0b9389a7424",22851664,1,10,0,2025,285,293,8
"869e967078f04da18dd0b0b9389a7424","83d42d95cd844fc093fc09cee250edb8",22851664,1,247,0,2027,293,465,172
"83d42d95cd844fc093fc09cee250edb8","c5df9f40ec14463b9dcfdc73df3e9285",22851664,1,-3,0,2031,465,464,-1
"f67fbf45a5f146ed866965bc57c7c001","070600601c4c439288445d2f0724807d",22851664,1,-29,0,2038,454,437,-17
"1823b6de7d334a7aaabc4570719af4d9","78adeee1fa2c4fe0bc73f7bca9fcee86",22851664,1,-389,0,2041,439,160,-279
"65202579580f4ad38d734b4ee39d22a8","67a089198fcb4e1c8f2385786c2b296f",22851664,1,-157,0,2052,164,39,-125
"67a089198fcb4e1c8f2385786c2b296f","67a089198fcb4e1c8f2385786c2b296f",22851664,1,0,1,2053,39,39,0
"b534b89233134e30a9b5645138bfa9ee","b534b89233134e30a9b5645138bfa9ee",22851664,1,0,1,2057,41,41,0
"6e13d61a7bdb44bca949c9f86fab3be5","d9c8d8c444a64dadbbb508652c721e17",22851664,1,-1,0,2059,47,46,-1
"d0c74f735e024943943e40333d6d337f","a1f2f12debe5432fb7a70bcd12bacfb9",22851664,1,8,0,2061,51,58,7
"a1f2f12debe5432fb7a70bcd12bacfb9","f924752d8a1149668870b1e7698486f7",22851664,1,-9,0,2062,58,50,-8
"78f30e4dcac84e3cbea8b2cc6e0d62b3","bc42d26810654ea9a1df1efe1e58c7d5",22851664,1,5,0,2064,59,63,4
"bc42d26810654ea9a1df1efe1e58c7d5","12aa6e1672ac4e7aa6449a7a8609cd72",22851664,1,-7,0,2065,63,57,-6
"bc42d26810654ea9a1df1efe1e58c7d5","bc42d26810654ea9a1df1efe1e58c7d5",22851664,3,0,1,2068,63,63,0
"bc42d26810654ea9a1df1efe1e58c7d5","a0a418b8540d479fa6e0f653b701da8b",22851664,1,1,0,2071,63,64,1
"a0a418b8540d479fa6e0f653b701da8b","a0a418b8540d479fa6e0f653b701da8b",22851664,3,0,1,2072,64,64,0
"a0a418b8540d479fa6e0f653b701da8b","309ccf3cc4fe429d9bfbaef53d3fa479",22851664,1,-4,0,2075,64,60,-4
"309ccf3cc4fe429d9bfbaef53d3fa479","b534b89233134e30a9b5645138bfa9ee",22851664,1,-23,0,2076,60,41,-19
"b534b89233134e30a9b5645138bfa9ee","d646286c8051419bbc2e31dd1db55ca8",22851664,1,33,0,2077,41,67,26
"d646286c8051419bbc2e31dd1db55ca8","d646286c8051419bbc2e31dd1db55ca8",22851664,2,0,1,2078,67,67,0
"d646286c8051419bbc2e31dd1db55ca8","a2becd407db34b189200a32546d9d569",22851664,2,9,0,2079,67,75,8
"a2becd407db34b189200a32546d9d569","140d5b27b8574befad82c0a013b59dfa",22851664,1,-1,0,2080,75,74,-1
"140d5b27b8574befad82c0a013b59dfa","d18a9ea32855445f8736581f5cb119ce",22851664,2,9,0,2081,74,82,8
"d18a9ea32855445f8736581f5cb119ce","6a9f0ef185fb47f0937e29daa1c71ed5",22851664,1,10,0,2082,82,90,8
"6a9f0ef185fb47f0937e29daa1c71ed5","ae5ac430ea254e708a6f5deaaf7464ae",22851664,1,-7,0,2083,90,84,-6
"ae5ac430ea254e708a6f5deaaf7464ae","6a9f0ef185fb47f0937e29daa1c71ed5",22851664,2,7,0,2084,84,90,6
"6a9f0ef185fb47f0937e29daa1c71ed5","6a9f0ef185fb47f0937e29daa1c71ed5",22851664,4,0,1,2085,90,90,0
"6a9f0ef185fb47f0937e29daa1c71ed5","d646286c8051419bbc2e31dd1db55ca8",22851664,2,-27,0,2086,90,67,-23
"d646286c8051419bbc2e31dd1db55ca8","e20db35ced8544ddac5bc3839145e463",22851664,2,30,0,2087,67,91,24
"e20db35ced8544ddac5bc3839145e463","00ae5f0c51874a73a41ebea838d95682",22851664,2,11,0,2088,91,101,10
"00ae5f0c51874a73a41ebea838d95682","e20db35ced8544ddac5bc3839145e463",22851664,2,-11,0,2089,101,91,-10
"e20db35ced8544ddac5bc3839145e463","d391c8b6e56a43a7b654e9dee02d904b",22851664,2,13,0,2090,91,103,12
"d391c8b6e56a43a7b654e9dee02d904b","73039f8c1eb9409cb4caee2cf968001e",22851664,1,-3,0,2091,103,100,-3
"73039f8c1eb9409cb4caee2cf968001e","4280927ec4d643238aa49c32f9e06c6c",22851664,2,10,0,2092,100,109,9
"4280927ec4d643238aa49c32f9e06c6c","08111f75e22d409998cf8b85bd431f0a",22851664,1,-1,0,2093,109,108,-1
"08111f75e22d409998cf8b85bd431f0a","a9ae0a3c070d455bb4369a8996313336",22851664,2,7,0,2094,108,114,6
"a9ae0a3c070d455bb4369a8996313336","62bff51286ef4f348717a3cf6fe2318f",22851664,1,7,0,2095,114,120,6
"62bff51286ef4f348717a3cf6fe2318f","62bff51286ef4f348717a3cf6fe2318f",22851664,5,0,1,2096,120,120,0
"62bff51286ef4f348717a3cf6fe2318f","37319e88176d4aefa91d7a9980dbae91",22851664,1,-9,0,2098,120,112,-8
"37319e88176d4aefa91d7a9980dbae91","e20db35ced8544ddac5bc3839145e463",22851664,1,-24,0,2099,112,91,-21
"e20db35ced8544ddac5bc3839145e463","779f9ddd1fd14d1e9e69f72219a1fdbd",22851664,2,36,0,2100,91,121,30
"a8dd5213034441ac92724b4e83eb0bb2","579338175e0b4bbb8ef3b712b5d8b54e",22851664,1,-1,0,2103,129,128,-1
"579338175e0b4bbb8ef3b712b5d8b54e","b416d47c56a742199b5d7c7f19d6503a",22851664,1,7,0,2104,128,134,6
"8aae34f5ddbb4052a709b12e6b0d40fa","f902b0f41b544d4dbf79664fd233648d",22851664,1,-1,0,2110,147,146,-1
"f902b0f41b544d4dbf79664fd233648d","f03480cf4eba413194d7af52fc0e7f28",22851664,1,7,0,2111,146,152,6
"f03480cf4eba413194d7af52fc0e7f28","d313cec988a84645bee413e8d4724a4b",22851664,2,7,0,2112,152,158,6
"d313cec988a84645bee413e8d4724a4b","d313cec988a84645bee413e8d4724a4b",22851664,8,0,1,2113,158,158,0
"d313cec988a84645bee413e8d4724a4b","78adeee1fa2c4fe0bc73f7bca9fcee86",22851664,1,4,0,2115,158,160,2
"78adeee1fa2c4fe0bc73f7bca9fcee86","df1de691dafe4549a18a4398ee9dfaf9",22851664,3,-26,0,2116,160,139,-21
"df1de691dafe4549a18a4398ee9dfaf9","65202579580f4ad38d734b4ee39d22a8",22851664,1,31,0,2117,139,164,25
"65202579580f4ad38d734b4ee39d22a8","3cbcea2be0984e7dbd5a48195af10ce7",22851664,2,3,0,2126,164,165,1
"3cbcea2be0984e7dbd5a48195af10ce7","78adeee1fa2c4fe0bc73f7bca9fcee86",22851664,2,-8,0,2127,165,160,-5
"78adeee1fa2c4fe0bc73f7bca9fcee86","82e6285962b8400d9d6fc32436022a94",22851664,2,10,0,2128,160,167,7
"82e6285962b8400d9d6fc32436022a94","3cbcea2be0984e7dbd5a48195af10ce7",22851664,2,-2,0,2129,167,165,-2
"3cbcea2be0984e7dbd5a48195af10ce7","a9ac840f098c4bd0a2ee896214ce29cd",22851664,1,5,0,2130,165,168,3
"0c7262dff33c4087bc660ccf40f92f9c","b2275c3fad834f8d90737a2d9a6927d6",22851664,5,3,0,2133,169,172,3
"b2275c3fad834f8d90737a2d9a6927d6","b2275c3fad834f8d90737a2d9a6927d6",22851664,28,0,1,2134,172,172,0
"b2275c3fad834f8d90737a2d9a6927d6","b42cc17b7de840f181a704558d0bc845",22851664,1,4,0,2142,172,175,3
"b42cc17b7de840f181a704558d0bc845","0c7262dff33c4087bc660ccf40f92f9c",22851664,1,-7,0,2143,175,169,-6
"0c7262dff33c4087bc660ccf40f92f9c","ea38cc0e6e6e41edbabf210220808bf9",22851664,1,12,0,2144,169,179,10
"ea38cc0e6e6e41edbabf210220808bf9","362fcb0699a14845ab29b2340093e528",22851664,1,-6,0,2145,179,174,-5
"362fcb0699a14845ab29b2340093e528","b87c552dd247427abe6ab5795b9c9d43",22851664,1,8,0,2146,174,181,7
"b87c552dd247427abe6ab5795b9c9d43","139b097acfca451689d80c9c6eebdf7b",22851664,2,-3,0,2147,181,178,-3
"139b097acfca451689d80c9c6eebdf7b","2024b4885bd14338a39b7b509acbbd02",22851664,1,5,0,2148,178,182,4
"2024b4885bd14338a39b7b509acbbd02","c3f63fe50d8e487c86bf8ef76c9cadd3",22851664,1,4,0,2149,182,185,3
"c3f63fe50d8e487c86bf8ef76c9cadd3","c3f63fe50d8e487c86bf8ef76c9cadd3",22851664,1,0,1,2150,185,185,0
"c3f63fe50d8e487c86bf8ef76c9cadd3","0c7262dff33c4087bc660ccf40f92f9c",22851664,1,-20,0,2151,185,169,-16
"0c7262dff33c4087bc660ccf40f92f9c","c8e371568a0c4391b25796ae4e91952e",22851664,3,23,0,2152,169,186,17
"c8e371568a0c4391b25796ae4e91952e","c8e371568a0c4391b25796ae4e91952e",22851664,3,0,1,2153,186,186,0
"c8e371568a0c4391b25796ae4e91952e","ab11d94c6c8948ea90b88f19d2cd502b",22851664,3,5,0,2154,186,190,4
"ab11d94c6c8948ea90b88f19d2cd502b","07b44a7a51e94c78b411c753fc39dab0",22851664,2,-1,0,2155,190,189,-1
"07b44a7a51e94c78b411c753fc39dab0","6cd2dcaac46847d4a0bc53f296d90375",22851664,3,6,0,2156,189,194,5
"6cd2dcaac46847d4a0bc53f296d90375","017d7ca8e0394b91aaadc9574df2202c",22851664,2,-1,0,2157,194,193,-1
"017d7ca8e0394b91aaadc9574df2202c","f9170dd6bc6442b4acd832747609b09a",22851664,1,7,0,2158,193,199,6
"f9170dd6bc6442b4acd832747609b09a","c8e371568a0c4391b25796ae4e91952e",22851664,3,-16,0,2159,199,186,-13
"c8e371568a0c4391b25796ae4e91952e","d7f13c8d63ec4e2aa673fbb9cf9c6933",22851664,2,26,0,2160,186,206,20
"d7f13c8d63ec4e2aa673fbb9cf9c6933","7108f0e4c2584f1f9c471689ae4c885c",22851664,2,2,0,2161,206,208,2
"7108f0e4c2584f1f9c471689ae4c885c","b9e80f77c3a44349863b19875725c384",22851664,2,-1,0,2162,208,207,-1
"b9e80f77c3a44349863b19875725c384","09400e101c5d4b439cf9a26b03aae558",22851664,1,4,0,2163,207,210,3
"09400e101c5d4b439cf9a26b03aae558","d7f13c8d63ec4e2aa673fbb9cf9c6933",22851664,2,-5,0,2164,210,206,-4
"d7f13c8d63ec4e2aa673fbb9cf9c6933","a875096404ef4a9984b62d74cda916f9",22851664,1,4,0,2165,206,209,3
"a875096404ef4a9984b62d74cda916f9","be502a7a43c44bf7b682698de79d9369",22851664,1,6,0,2166,209,214,5
"be502a7a43c44bf7b682698de79d9369","f7fb1952f56b4189b86a9f8b7862d2b8",22851664,2,1,0,2167,214,215,1
"f7fb1952f56b4189b86a9f8b7862d2b8","ec341f459285443b8361f7f15638ff08",22851664,1,-2,0,2168,215,213,-2
"ec341f459285443b8361f7f15638ff08","363837c182e04711840d896ae1e0339c",22851664,2,6,0,2169,213,218,5
"363837c182e04711840d896ae1e0339c","01b2051f8941460d89945e3b02d1ce78",22851664,2,-1,0,2170,218,217,-1
"01b2051f8941460d89945e3b02d1ce78","d7f13c8d63ec4e2aa673fbb9cf9c6933",22851664,1,-14,0,2171,217,206,-11
"d7f13c8d63ec4e2aa673fbb9cf9c6933","1c6721b1f63f4d30ba7746ea8af02a52",22851664,2,21,0,2172,206,221,15
"1c6721b1f63f4d30ba7746ea8af02a52","77ecef8eff6b4a2caea7707669bf7475",22851664,5,1,0,2173,221,222,1
"77ecef8eff6b4a2caea7707669bf7475","d03cb855c70044cf8c35d9ec0de696e3",22851664,1,3,0,2174,222,224,2
"d03cb855c70044cf8c35d9ec0de696e3","1c6721b1f63f4d30ba7746ea8af02a52",22851664,1,-4,0,2175,224,221,-3
"1c6721b1f63f4d30ba7746ea8af02a52","8b9ae98743bd4d4a8a87dff1c1244211",22851664,2,7,0,2176,221,227,6
"8b9ae98743bd4d4a8a87dff1c1244211","2ab1535aac1346ba8801535bf729ef37",22851664,3,3,0,2177,227,229,2
"2ab1535aac1346ba8801535bf729ef37","f7906d6f59b9489a91d2ef40db5a474d",22851664,3,-7,0,2178,229,223,-6
"f7906d6f59b9489a91d2ef40db5a474d","5152833676bf4c6cb317060be10f68db",22851664,2,6,0,2179,223,228,5
"5152833676bf4c6cb317060be10f68db","0b04c8e2f86d48c7aeb7e225819cd32b",22851664,1,7,0,2180,228,234,6
"0b04c8e2f86d48c7aeb7e225819cd32b","1c6721b1f63f4d30ba7746ea8af02a52",22851664,2,-16,0,2181,234,221,-13
"1c6721b1f63f4d30ba7746ea8af02a52","2ae94c0cea4d480a9d5dca8fb1d7b542",22851664,2,27,0,2182,221,242,21
"2ae94c0cea4d480a9d5dca8fb1d7b542","00f61990949545828dd12f1303d47504",22851664,1,17,0,2185,242,256,14
"00f61990949545828dd12f1303d47504","6e83e23f56544a19b94067c1c558d9c0",22851664,1,-11,0,2186,256,247,-9
"6e83e23f56544a19b94067c1c558d9c0","d546341988904f069cfa86b21457d9d9",22851664,1,5,0,2187,247,251,4
"d546341988904f069cfa86b21457d9d9","d989ebcfc12a4b669f0100dc1aa14f1e",22851664,1,5,0,2188,251,255,4
"d989ebcfc12a4b669f0100dc1aa14f1e","7aa76d3e993840d8805f097cbdbcd44b",22851664,1,7,0,2189,255,261,6
"7aa76d3e993840d8805f097cbdbcd44b","2ae94c0cea4d480a9d5dca8fb1d7b542",22851664,1,-23,0,2190,261,242,-19
"2ae94c0cea4d480a9d5dca8fb1d7b542","0d987bed3ffa4ed0b9a2e62e97b7b30f",22851664,2,38,0,2191,242,272,30
"a37477c4e4c14169ad44b06b493007f6","94cecc3f1e7d484b8e068e79241dfd73",22851664,2,-2,0,2207,283,281,-2
"94cecc3f1e7d484b8e068e79241dfd73","fab84b4fab5940efb4ea868ef8d09396",22851664,2,5,0,2208,281,284,3
"fab84b4fab5940efb4ea868ef8d09396","fab84b4fab5940efb4ea868ef8d09396",22851664,4,0,1,2209,284,284,0
"130acc2aeb0448fdbb2de63bc5cebe5b","141c0df6cd1946539aadd1c9b7068cd4",22851664,1,-1,0,2224,309,308,-1
"141c0df6cd1946539aadd1c9b7068cd4","86c27d40179e419c8e9d150fb6afa5d0",22851664,1,13,0,2225,308,319,11
"86c27d40179e419c8e9d150fb6afa5d0","0c787d16c9504873b1a4d903cec09948",22851664,1,-6,0,2226,319,314,-5
"0c787d16c9504873b1a4d903cec09948","47edbb64109243e6b0f8f64cdef90c6c",22851664,1,14,0,2227,314,326,12
"47edbb64109243e6b0f8f64cdef90c6c","8d7e0b55cf9849cda222a0f2440cec55",22851664,1,-9,0,2228,326,318,-8
"24f1363179ad4aaa965484a78471912b","3628bdce1dd2429ba924d2d4d09448d2",22851664,1,-1,0,2230,323,322,-1
"3628bdce1dd2429ba924d2d4d09448d2","0c4079457ede49e3aeb5e86ed84bdf35",22851664,1,10,0,2231,322,329,7
"0c4079457ede49e3aeb5e86ed84bdf35","3434c10e561d488a914e0f7d71907abd",22851664,1,-31,0,2232,329,305,-24
"3434c10e561d488a914e0f7d71907abd","38aea304b4fa46e1b29bb72f5cea4c93",22851664,1,33,0,2233,305,331,26
"0c4079457ede49e3aeb5e86ed84bdf35","bbc5139ca9024389a94db3a6f47dcff6",22851664,1,14,0,2235,329,341,12
"b8b9418ab322418d9db9b40d96af873a","c2490bc612d146edbe786556fab3651b",22851664,1,4,0,2237,337,340,3
"0c4079457ede49e3aeb5e86ed84bdf35","30ead9794d4847abaf222ca966cc8630",22851664,1,24,0,2239,329,348,19
"30ead9794d4847abaf222ca966cc8630","897b7f51242c44aab2205c72fdcbf4cd",22851664,1,4,0,2240,348,352,4
"897b7f51242c44aab2205c72fdcbf4cd","eff0de7f2dbb42dfa1a2e686efab5b6d",22851664,2,2,0,2241,352,354,2
"c20993c944444fe085345591a8bd837e","09b9678ddc3d452ea4a3d46e15826065",22851664,1,2,0,2243,351,353,2
"eff0de7f2dbb42dfa1a2e686efab5b6d","09b9678ddc3d452ea4a3d46e15826065",22851664,1,-1,0,2250,354,353,-1
"09b9678ddc3d452ea4a3d46e15826065","30ead9794d4847abaf222ca966cc8630",22851664,1,-5,0,2252,353,348,-5
"2fe14166dc9642c3bc666b86a57f943d","1ba8fef685d74a8194b9db252eb704fb",22851664,1,-2,0,2254,357,355,-2
"072a190fd302456290895f9f04d6940a","30ead9794d4847abaf222ca966cc8630",22851664,1,-20,0,2259,365,348,-17
"b71bac264efb4abd97015447bd490db6","b71bac264efb4abd97015447bd490db6",22851664,1,0,1,2261,370,370,0
"8d448d625b024c82a5eb240bbd7431d6","b71bac264efb4abd97015447bd490db6",22851664,1,-5,0,2270,374,370,-4
"c2fca3669923477ab966ded303dea31c","96bb2b3e85a34d8b9544514e89f6fe97",22851664,1,9,0,2279,383,390,7
"18d3b836dd804224883cc9180b60a8e1","6f8881a745ac4c358a68b92c3b4abe81",22851664,1,9,0,2281,387,394,7
"17f95d18bab743888e1736033dc3384d","f7002c8484354eceac57bc7bd62c76c1",22851664,1,5,0,2283,389,393,4
"66ada10dde9f43018588f1ced9d477fc","070600601c4c439288445d2f0724807d",22851664,1,6,0,2315,434,437,3
"070600601c4c439288445d2f0724807d","24cf8786024543f19b89bc20034e60d7",22851664,1,-14,0,2316,437,428,-9
"24cf8786024543f19b89bc20034e60d7","1823b6de7d334a7aaabc4570719af4d9",22851664,1,16,0,2317,428,439,11
"1823b6de7d334a7aaabc4570719af4d9","0380cd76a7d44bc3a4da1f15e4d68f89",22851664,1,2,0,2318,439,440,1
"0380cd76a7d44bc3a4da1f15e4d68f89","070600601c4c439288445d2f0724807d",22851664,1,-4,0,2319,440,437,-3
"7bd5586eb9d8484eb74a433ee7bfe499","b2f0d654738f48158edff28e8d3a546e",22851664,1,7,0,2329,446,449,3
"b2f0d654738f48158edff28e8d3a546e","070600601c4c439288445d2f0724807d",22851664,1,-21,0,2330,449,437,-12
"070600601c4c439288445d2f0724807d","f60ee41ec635499abd48168342d32c2f",22851664,1,26,0,2331,437,453,16
"b7719e26494940efa49512aedd0aac79","b613861cecf84ffcab01afb23f660475",22851744,1,-32,0,1,20,1,-19
"b613861cecf84ffcab01afb23f660475","b613861cecf84ffcab01afb23f660475",22851744,5,0,1,2,1,1,0
"b613861cecf84ffcab01afb23f660475","e2911e79efc2420eac45d9f671463d4b",22851744,2,3,0,7,1,2,1
"e2911e79efc2420eac45d9f671463d4b","b613861cecf84ffcab01afb23f660475",22851744,1,-3,0,8,2,1,-1
"e2911e79efc2420eac45d9f671463d4b","e2911e79efc2420eac45d9f671463d4b",22851744,1,0,1,10,2,2,0
"e2911e79efc2420eac45d9f671463d4b","519d1b8c59404d67b54e96c5c8a830b2",22851744,1,1,0,11,2,3,1
"519d1b8c59404d67b54e96c5c8a830b2","519d1b8c59404d67b54e96c5c8a830b2",22851744,1,0,1,12,3,3,0
"519d1b8c59404d67b54e96c5c8a830b2","531db53f81f646edb0cdcfe0085b03b7",22851744,1,1,0,13,3,4,1
"531db53f81f646edb0cdcfe0085b03b7","531db53f81f646edb0cdcfe0085b03b7",22851744,1,0,1,14,4,4,0
"531db53f81f646edb0cdcfe0085b03b7","4f5f94b2f95141e0a9d53a61da2276da",22851744,1,1,0,15,4,5,1
"4f5f94b2f95141e0a9d53a61da2276da","4f5f94b2f95141e0a9d53a61da2276da",22851744,1,0,1,16,5,5,0
"4f5f94b2f95141e0a9d53a61da2276da","6d541c89590949f99af293c4f2333f67",22851744,1,1,0,17,5,6,1
"6d541c89590949f99af293c4f2333f67","6d541c89590949f99af293c4f2333f67",22851744,1,0,1,18,6,6,0
"6d541c89590949f99af293c4f2333f67","dd5cf0b9fe4c4f1d8f5ff8e4c04879cb",22851744,1,1,0,19,6,7,1
"dd5cf0b9fe4c4f1d8f5ff8e4c04879cb","dd5cf0b9fe4c4f1d8f5ff8e4c04879cb",22851744,1,0,1,20,7,7,0
"dd5cf0b9fe4c4f1d8f5ff8e4c04879cb","f96261861edc426abe2248be4f0a709a",22851744,1,1,0,21,7,8,1
"f96261861edc426abe2248be4f0a709a","f96261861edc426abe2248be4f0a709a",22851744,1,0,1,22,8,8,0
"f96261861edc426abe2248be4f0a709a","66b5e16f4f75454fb5b8172079f0fa83",22851744,1,1,0,23,8,9,1
"66b5e16f4f75454fb5b8172079f0fa83","66b5e16f4f75454fb5b8172079f0fa83",22851744,1,0,1,24,9,9,0
"66b5e16f4f75454fb5b8172079f0fa83","0680571d4698477995e41842c36a54b2",22851744,1,1,0,25,9,10,1
"0680571d4698477995e41842c36a54b2","0680571d4698477995e41842c36a54b2",22851744,1,0,1,26,10,10,0
"0680571d4698477995e41842c36a54b2","9112f2bffece48e08c6d2287be204085",22851744,1,1,0,27,10,11,1
"9112f2bffece48e08c6d2287be204085","9112f2bffece48e08c6d2287be204085",22851744,1,0,1,28,11,11,0
"9112f2bffece48e08c6d2287be204085","e2911e79efc2420eac45d9f671463d4b",22851744,1,-9,0,29,11,2,-9
"e2911e79efc2420eac45d9f671463d4b","56586aa865414f538729c7f7735d2bc6",22851744,1,12,0,30,2,12,10
"56586aa865414f538729c7f7735d2bc6","56586aa865414f538729c7f7735d2bc6",22851744,3,0,1,31,12,12,0
"56586aa865414f538729c7f7735d2bc6","b7f2b31585d94eb3bf86376714aa7070",22851744,1,2,0,34,12,13,1
"b7f2b31585d94eb3bf86376714aa7070","b7f2b31585d94eb3bf86376714aa7070",22851744,2,0,1,35,13,13,0
"b7f2b31585d94eb3bf86376714aa7070","3f1c815879794b929260d224becaff7e",22851744,1,2,0,37,13,14,1
"3f1c815879794b929260d224becaff7e","81c864a886d54a6b8ff85f7d736f4f95",22851744,1,2,0,38,14,15,1
"81c864a886d54a6b8ff85f7d736f4f95","5c5ceeee4562457ba6d41515aeebfbb1",22851744,1,4,0,39,15,17,2
"5c5ceeee4562457ba6d41515aeebfbb1","5c5ceeee4562457ba6d41515aeebfbb1",22851744,1,0,1,40,17,17,0
"5c5ceeee4562457ba6d41515aeebfbb1","56586aa865414f538729c7f7735d2bc6",22851744,1,-10,0,41,17,12,-5
"56586aa865414f538729c7f7735d2bc6","9afd71a5298d4333b6849dfce1b9422c",22851744,1,13,0,42,12,18,6
"9afd71a5298d4333b6849dfce1b9422c","9afd71a5298d4333b6849dfce1b9422c",22851744,2,0,1,43,18,18,0
"9afd71a5298d4333b6849dfce1b9422c","b7719e26494940efa49512aedd0aac79",22851744,1,4,0,45,18,20,2
"b7719e26494940efa49512aedd0aac79","d4f45188d3c84a02ba08454e6403a818",22851744,1,5,0,46,20,24,4
"d4f45188d3c84a02ba08454e6403a818","d4c3b003e8274e429d2fa688d73fde6d",22851744,1,-2,0,47,24,22,-2
"d4c3b003e8274e429d2fa688d73fde6d","d4c3b003e8274e429d2fa688d73fde6d",22851744,1,0,1,48,22,22,0
"d4c3b003e8274e429d2fa688d73fde6d","b7719e26494940efa49512aedd0aac79",22851744,1,-3,0,49,22,20,-2
"b7719e26494940efa49512aedd0aac79","b7719e26494940efa49512aedd0aac79",22851744,1,0,1,50,20,20,0
"b7719e26494940efa49512aedd0aac79","afbf7250b99d47bea07172749483ca97",22851744,1,12,0,51,20,28,8
"afbf7250b99d47bea07172749483ca97","afbf7250b99d47bea07172749483ca97",22851744,1,0,1,52,28,28,0
"afbf7250b99d47bea07172749483ca97","4e51676dc72045d99c19b9fa7b22f8bc",22851744,1,3,0,53,28,29,1
"4e51676dc72045d99c19b9fa7b22f8bc","4e51676dc72045d99c19b9fa7b22f8bc",22851744,1,0,1,54,29,29,0
"4e51676dc72045d99c19b9fa7b22f8bc","51970cfa30e643e894e66ae85c8024cc",22851744,1,3,0,55,29,31,2
"51970cfa30e643e894e66ae85c8024cc","4e51676dc72045d99c19b9fa7b22f8bc",22851744,1,-3,0,56,31,29,-2
"4e51676dc72045d99c19b9fa7b22f8bc","c33c17be71ae4d588da7369472e5bb1b",22851744,1,9,0,57,29,34,5
"c33c17be71ae4d588da7369472e5bb1b","c33c17be71ae4d588da7369472e5bb1b",22851744,1,0,1,58,34,34,0
"c33c17be71ae4d588da7369472e5bb1b","93679be414554a11b1893002f2229a93",22851744,1,3,0,59,34,35,1
"93679be414554a11b1893002f2229a93","93679be414554a11b1893002f2229a93",22851744,1,0,1,60,35,35,0
"93679be414554a11b1893002f2229a93","7040a13096d746ac84b8fac8d9752058",22851744,1,3,0,61,35,36,1
"7040a13096d746ac84b8fac8d9752058","7040a13096d746ac84b8fac8d9752058",22851744,1,0,1,62,36,36,0
"7040a13096d746ac84b8fac8d9752058","9a0dc646f934470daf08c4b56ccf73db",22851744,1,3,0,63,36,37,1
"9a0dc646f934470daf08c4b56ccf73db","9a0dc646f934470daf08c4b56ccf73db",22851744,1,0,1,64,37,37,0
"9a0dc646f934470daf08c4b56ccf73db","fc0e049d56024bc9a02c9a9c435c3df7",22851744,1,3,0,65,37,38,1
"fc0e049d56024bc9a02c9a9c435c3df7","fc0e049d56024bc9a02c9a9c435c3df7",22851744,1,0,1,66,38,38,0
"fc0e049d56024bc9a02c9a9c435c3df7","67a089198fcb4e1c8f2385786c2b296f",22851744,1,4,0,67,38,39,1
"67a089198fcb4e1c8f2385786c2b296f","64d48c6c9c7940639a932219a6c87198",22851744,2,1,0,68,39,40,1
"64d48c6c9c7940639a932219a6c87198","64d48c6c9c7940639a932219a6c87198",22851744,1,0,1,69,40,40,0
"64d48c6c9c7940639a932219a6c87198","67a089198fcb4e1c8f2385786c2b296f",22851744,1,-1,0,70,40,39,-1
"67a089198fcb4e1c8f2385786c2b296f","b534b89233134e30a9b5645138bfa9ee",22851744,1,4,0,71,39,41,2
"b534b89233134e30a9b5645138bfa9ee","b534b89233134e30a9b5645138bfa9ee",22851744,1,0,1,72,41,41,0
"b534b89233134e30a9b5645138bfa9ee","0e37b720d23b4e7f8b313e79313fd107",22851744,1,3,0,73,41,44,3
"0e37b720d23b4e7f8b313e79313fd107","0e37b720d23b4e7f8b313e79313fd107",22851744,4,0,1,74,44,44,0
"0e37b720d23b4e7f8b313e79313fd107","6875d67fdd5f48168b62719df449bebd",22851744,1,1,0,78,44,45,1
"6875d67fdd5f48168b62719df449bebd","6875d67fdd5f48168b62719df449bebd",22851744,1,0,1,79,45,45,0
"6875d67fdd5f48168b62719df449bebd","6e13d61a7bdb44bca949c9f86fab3be5",22851744,1,3,0,80,45,47,2
"6e13d61a7bdb44bca949c9f86fab3be5","b534b89233134e30a9b5645138bfa9ee",22851744,1,-7,0,81,47,41,-6
"b534b89233134e30a9b5645138bfa9ee","6e13d61a7bdb44bca949c9f86fab3be5",22851744,1,7,0,82,41,47,6
"6e13d61a7bdb44bca949c9f86fab3be5","6e13d61a7bdb44bca949c9f86fab3be5",22851744,1,0,1,83,47,47,0
"6e13d61a7bdb44bca949c9f86fab3be5","195f78799f984cc2b06c48dfe36be751",22851744,1,2,0,84,47,49,2
"195f78799f984cc2b06c48dfe36be751","195f78799f984cc2b06c48dfe36be751",22851744,2,0,1,85,49,49,0
"195f78799f984cc2b06c48dfe36be751","d9c8d8c444a64dadbbb508652c721e17",22851744,1,-3,0,87,49,46,-3
"d9c8d8c444a64dadbbb508652c721e17","d0c74f735e024943943e40333d6d337f",22851744,1,6,0,88,46,51,5
"d0c74f735e024943943e40333d6d337f","d0c74f735e024943943e40333d6d337f",22851744,1,0,1,89,51,51,0
"d0c74f735e024943943e40333d6d337f","983f8ff320594b279a7f4a6fe132f9c5",22851744,1,2,0,90,51,53,2
"983f8ff320594b279a7f4a6fe132f9c5","983f8ff320594b279a7f4a6fe132f9c5",22851744,2,0,1,91,53,53,0
"983f8ff320594b279a7f4a6fe132f9c5","35adfa5d923046aebabfefd98f35ff05",22851744,1,1,0,93,53,54,1
"35adfa5d923046aebabfefd98f35ff05","35adfa5d923046aebabfefd98f35ff05",22851744,5,0,1,94,54,54,0
"35adfa5d923046aebabfefd98f35ff05","b6f8a98476224da1b40e555ececc7ed8",22851744,1,1,0,99,54,55,1
"b6f8a98476224da1b40e555ececc7ed8","b6f8a98476224da1b40e555ececc7ed8",22851744,2,0,1,100,55,55,0
"b6f8a98476224da1b40e555ececc7ed8","86e22cb5fe0e4b47a9489ecddf7ed78f",22851744,1,1,0,102,55,56,1
"86e22cb5fe0e4b47a9489ecddf7ed78f","86e22cb5fe0e4b47a9489ecddf7ed78f",22851744,2,0,1,103,56,56,0
"86e22cb5fe0e4b47a9489ecddf7ed78f","f924752d8a1149668870b1e7698486f7",22851744,1,-6,0,105,56,50,-6
"f924752d8a1149668870b1e7698486f7","a1f2f12debe5432fb7a70bcd12bacfb9",22851744,1,9,0,106,50,58,8
"a1f2f12debe5432fb7a70bcd12bacfb9","78f30e4dcac84e3cbea8b2cc6e0d62b3",22851744,2,1,0,107,58,59,1
"78f30e4dcac84e3cbea8b2cc6e0d62b3","a1f2f12debe5432fb7a70bcd12bacfb9",22851744,1,-1,0,108,59,58,-1
"a1f2f12debe5432fb7a70bcd12bacfb9","a1f2f12debe5432fb7a70bcd12bacfb9",22851744,14,0,1,109,58,58,0
"78f30e4dcac84e3cbea8b2cc6e0d62b3","78f30e4dcac84e3cbea8b2cc6e0d62b3",22851744,7,0,1,124,59,59,0
"78f30e4dcac84e3cbea8b2cc6e0d62b3","a0a418b8540d479fa6e0f653b701da8b",22851744,1,6,0,131,59,64,5
"a0a418b8540d479fa6e0f653b701da8b","12aa6e1672ac4e7aa6449a7a8609cd72",22851744,1,-8,0,132,64,57,-7
"12aa6e1672ac4e7aa6449a7a8609cd72","bc42d26810654ea9a1df1efe1e58c7d5",22851744,1,7,0,133,57,63,6
"bc42d26810654ea9a1df1efe1e58c7d5","4c943503763e4e349906eea3ed3c8e86",22851744,1,-2,0,134,63,61,-2
"4c943503763e4e349906eea3ed3c8e86","4c943503763e4e349906eea3ed3c8e86",22851744,1,0,1,135,61,61,0
"4c943503763e4e349906eea3ed3c8e86","bc42d26810654ea9a1df1efe1e58c7d5",22851744,1,2,0,136,61,63,2
"bc42d26810654ea9a1df1efe1e58c7d5","bc42d26810654ea9a1df1efe1e58c7d5",22851744,3,0,1,137,63,63,0
"bc42d26810654ea9a1df1efe1e58c7d5","a0a418b8540d479fa6e0f653b701da8b",22851744,1,1,0,140,63,64,1
"a0a418b8540d479fa6e0f653b701da8b","a0a418b8540d479fa6e0f653b701da8b",22851744,3,0,1,141,64,64,0
"a0a418b8540d479fa6e0f653b701da8b","309ccf3cc4fe429d9bfbaef53d3fa479",22851744,1,-4,0,144,64,60,-4
"309ccf3cc4fe429d9bfbaef53d3fa479","b534b89233134e30a9b5645138bfa9ee",22851744,1,-23,0,145,60,41,-19
"b534b89233134e30a9b5645138bfa9ee","d646286c8051419bbc2e31dd1db55ca8",22851744,1,33,0,146,41,67,26
"d646286c8051419bbc2e31dd1db55ca8","267f883678b24aed855fde42524975d9",22851744,1,4,0,147,67,71,4
"267f883678b24aed855fde42524975d9","267f883678b24aed855fde42524975d9",22851744,1,0,1,148,71,71,0
"267f883678b24aed855fde42524975d9","88fff56d0342490dbef9040750a20f6c",22851744,1,1,0,149,71,72,1
"88fff56d0342490dbef9040750a20f6c","88fff56d0342490dbef9040750a20f6c",22851744,1,0,1,150,72,72,0
"88fff56d0342490dbef9040750a20f6c","adb17b12b66c4a49a85fd34322f7df70",22851744,1,1,0,151,72,73,1
"adb17b12b66c4a49a85fd34322f7df70","adb17b12b66c4a49a85fd34322f7df70",22851744,1,0,1,152,73,73,0
"adb17b12b66c4a49a85fd34322f7df70","a2becd407db34b189200a32546d9d569",22851744,1,3,0,153,73,75,2
"a2becd407db34b189200a32546d9d569","d646286c8051419bbc2e31dd1db55ca8",22851744,1,-9,0,154,75,67,-8
"d646286c8051419bbc2e31dd1db55ca8","a2becd407db34b189200a32546d9d569",22851744,1,9,0,155,67,75,8
"a2becd407db34b189200a32546d9d569","a2becd407db34b189200a32546d9d569",22851744,1,0,1,156,75,75,0
"a2becd407db34b189200a32546d9d569","58c22b011d0f4c2ea6d13615edbb9eeb",22851744,1,2,0,157,75,77,2
"58c22b011d0f4c2ea6d13615edbb9eeb","58c22b011d0f4c2ea6d13615edbb9eeb",22851744,2,0,1,158,77,77,0
"58c22b011d0f4c2ea6d13615edbb9eeb","dd76e1861dc9461c830888729d091ee0",22851744,1,1,0,160,77,78,1
"dd76e1861dc9461c830888729d091ee0","dd76e1861dc9461c830888729d091ee0",22851744,5,0,1,161,78,78,0
"dd76e1861dc9461c830888729d091ee0","cd1d828f1a694b87913a7ea66c23803e",22851744,1,1,0,166,78,79,1
"cd1d828f1a694b87913a7ea66c23803e","cd1d828f1a694b87913a7ea66c23803e",22851744,2,0,1,167,79,79,0
"cd1d828f1a694b87913a7ea66c23803e","9176a3c2b4d2465fa8b0c67096c2a97e",22851744,1,1,0,169,79,80,1
"9176a3c2b4d2465fa8b0c67096c2a97e","9176a3c2b4d2465fa8b0c67096c2a97e",22851744,11,0,1,170,80,80,0
"9176a3c2b4d2465fa8b0c67096c2a97e","f8ec6445f7194e25b9101d4fbcb07a18",22851744,1,1,0,181,80,81,1
"f8ec6445f7194e25b9101d4fbcb07a18","f8ec6445f7194e25b9101d4fbcb07a18",22851744,2,0,1,182,81,81,0
"f8ec6445f7194e25b9101d4fbcb07a18","140d5b27b8574befad82c0a013b59dfa",22851744,1,-7,0,184,81,74,-7
"140d5b27b8574befad82c0a013b59dfa","d18a9ea32855445f8736581f5cb119ce",22851744,1,9,0,185,74,82,8
"d18a9ea32855445f8736581f5cb119ce","f564483cbd7a407681aa2fcca518cf5f",22851744,1,4,0,186,82,85,3
"f564483cbd7a407681aa2fcca518cf5f","f564483cbd7a407681aa2fcca518cf5f",22851744,1,0,1,187,85,85,0
"f564483cbd7a407681aa2fcca518cf5f","18fd01350bd5434ca636d59a599d768a",22851744,1,1,0,188,85,86,1
"18fd01350bd5434ca636d59a599d768a","18fd01350bd5434ca636d59a599d768a",22851744,8,0,1,189,86,86,0
"18fd01350bd5434ca636d59a599d768a","ae5ac430ea254e708a6f5deaaf7464ae",22851744,1,-2,0,197,86,84,-2
"ae5ac430ea254e708a6f5deaaf7464ae","6a9f0ef185fb47f0937e29daa1c71ed5",22851744,1,7,0,198,84,90,6
"6a9f0ef185fb47f0937e29daa1c71ed5","c681290961c94c4caf23b529d1ae6b9a",22851744,1,-2,0,199,90,88,-2
"c681290961c94c4caf23b529d1ae6b9a","c681290961c94c4caf23b529d1ae6b9a",22851744,1,0,1,200,88,88,0
"c681290961c94c4caf23b529d1ae6b9a","6a9f0ef185fb47f0937e29daa1c71ed5",22851744,1,2,0,201,88,90,2
"6a9f0ef185fb47f0937e29daa1c71ed5","6a9f0ef185fb47f0937e29daa1c71ed5",22851744,3,0,1,202,90,90,0
"6a9f0ef185fb47f0937e29daa1c71ed5","d646286c8051419bbc2e31dd1db55ca8",22851744,1,-27,0,205,90,67,-23
"d646286c8051419bbc2e31dd1db55ca8","e20db35ced8544ddac5bc3839145e463",22851744,1,30,0,206,67,91,24
"e20db35ced8544ddac5bc3839145e463","1febb706d7a34005ae8711ed49c76e64",22851744,1,3,0,207,91,94,3
"1febb706d7a34005ae8711ed49c76e64","1febb706d7a34005ae8711ed49c76e64",22851744,2,0,1,208,94,94,0
"1febb706d7a34005ae8711ed49c76e64","8f73ba6f5a0042f2850356ac38ac6f24",22851744,1,1,0,210,94,95,1
"8f73ba6f5a0042f2850356ac38ac6f24","8f73ba6f5a0042f2850356ac38ac6f24",22851744,5,0,1,211,95,95,0
"8f73ba6f5a0042f2850356ac38ac6f24","e2260b86653c46d7b14a41fb419dbf8c",22851744,1,1,0,216,95,96,1
"e2260b86653c46d7b14a41fb419dbf8c","e2260b86653c46d7b14a41fb419dbf8c",22851744,2,0,1,217,96,96,0
"e2260b86653c46d7b14a41fb419dbf8c","35eb641ad1d845bbba54915bce75a962",22851744,1,1,0,219,96,97,1
"35eb641ad1d845bbba54915bce75a962","35eb641ad1d845bbba54915bce75a962",22851744,2,0,1,220,97,97,0
"35eb641ad1d845bbba54915bce75a962","08be90ffbeea4795a138cd42ed8db56f",22851744,1,1,0,222,97,98,1
"08be90ffbeea4795a138cd42ed8db56f","08be90ffbeea4795a138cd42ed8db56f",22851744,2,0,1,223,98,98,0
"08be90ffbeea4795a138cd42ed8db56f","3007433c8f584dcbb5ac159c1c5f2be3",22851744,1,1,0,225,98,99,1
"3007433c8f584dcbb5ac159c1c5f2be3","3007433c8f584dcbb5ac159c1c5f2be3",22851744,2,0,1,226,99,99,0
"3007433c8f584dcbb5ac159c1c5f2be3","e20db35ced8544ddac5bc3839145e463",22851744,1,-8,0,228,99,91,-8
"e20db35ced8544ddac5bc3839145e463","00ae5f0c51874a73a41ebea838d95682",22851744,1,11,0,229,91,101,10
"00ae5f0c51874a73a41ebea838d95682","d391c8b6e56a43a7b654e9dee02d904b",22851744,2,2,0,230,101,103,2
"d391c8b6e56a43a7b654e9dee02d904b","00ae5f0c51874a73a41ebea838d95682",22851744,1,-2,0,231,103,101,-2
"00ae5f0c51874a73a41ebea838d95682","00ae5f0c51874a73a41ebea838d95682",22851744,1,0,1,232,101,101,0
"d391c8b6e56a43a7b654e9dee02d904b","d391c8b6e56a43a7b654e9dee02d904b",22851744,20,0,1,234,103,103,0
"d391c8b6e56a43a7b654e9dee02d904b","6111116566fc4fd9abba409322bea245",22851744,1,1,0,254,103,104,1
"6111116566fc4fd9abba409322bea245","6111116566fc4fd9abba409322bea245",22851744,2,0,1,255,104,104,0
"6111116566fc4fd9abba409322bea245","a81b2235cb9c499eb9ea8ee0a8dd9725",22851744,1,1,0,257,104,105,1
"a81b2235cb9c499eb9ea8ee0a8dd9725","a81b2235cb9c499eb9ea8ee0a8dd9725",22851744,2,0,1,258,105,105,0
"a81b2235cb9c499eb9ea8ee0a8dd9725","2d4e0ab0ef3b4d73b82c72d4621a7579",22851744,1,1,0,260,105,106,1
"2d4e0ab0ef3b4d73b82c72d4621a7579","2d4e0ab0ef3b4d73b82c72d4621a7579",22851744,2,0,1,261,106,106,0
"2d4e0ab0ef3b4d73b82c72d4621a7579","8bdebf492ebd4e62b0d522e8ab5e5197",22851744,1,1,0,263,106,107,1
"8bdebf492ebd4e62b0d522e8ab5e5197","8bdebf492ebd4e62b0d522e8ab5e5197",22851744,2,0,1,264,107,107,0
"8bdebf492ebd4e62b0d522e8ab5e5197","73039f8c1eb9409cb4caee2cf968001e",22851744,1,-7,0,266,107,100,-7
"73039f8c1eb9409cb4caee2cf968001e","4280927ec4d643238aa49c32f9e06c6c",22851744,1,10,0,267,100,109,9
"4280927ec4d643238aa49c32f9e06c6c","4280927ec4d643238aa49c32f9e06c6c",22851744,2,0,1,268,109,109,0
"4280927ec4d643238aa49c32f9e06c6c","fc44e6a5f7654430af1227838224dceb",22851744,1,2,0,270,109,111,2
"fc44e6a5f7654430af1227838224dceb","fc44e6a5f7654430af1227838224dceb",22851744,2,0,1,271,111,111,0
"fc44e6a5f7654430af1227838224dceb","08111f75e22d409998cf8b85bd431f0a",22851744,1,-3,0,273,111,108,-3
"08111f75e22d409998cf8b85bd431f0a","a9ae0a3c070d455bb4369a8996313336",22851744,1,7,0,274,108,114,6
"a9ae0a3c070d455bb4369a8996313336","a9ae0a3c070d455bb4369a8996313336",22851744,1,0,1,275,114,114,0
"a9ae0a3c070d455bb4369a8996313336","e20db35ced8544ddac5bc3839145e463",22851744,1,-26,0,276,114,91,-23
"e20db35ced8544ddac5bc3839145e463","a9ae0a3c070d455bb4369a8996313336",22851744,1,26,0,277,91,114,23
"a9ae0a3c070d455bb4369a8996313336","71cec822bcff4f30a20e75dc63ef7b65",22851744,1,2,0,278,114,116,2
"71cec822bcff4f30a20e75dc63ef7b65","71cec822bcff4f30a20e75dc63ef7b65",22851744,1,0,1,279,116,116,0
"71cec822bcff4f30a20e75dc63ef7b65","37319e88176d4aefa91d7a9980dbae91",22851744,1,-4,0,280,116,112,-4
"37319e88176d4aefa91d7a9980dbae91","62bff51286ef4f348717a3cf6fe2318f",22851744,1,9,0,281,112,120,8
"62bff51286ef4f348717a3cf6fe2318f","b1cd0e7dc3ad4a8eb91a4bfdbeb025b0",22851744,1,-2,0,282,120,118,-2
"b1cd0e7dc3ad4a8eb91a4bfdbeb025b0","b1cd0e7dc3ad4a8eb91a4bfdbeb025b0",22851744,1,0,1,283,118,118,0
"b1cd0e7dc3ad4a8eb91a4bfdbeb025b0","62bff51286ef4f348717a3cf6fe2318f",22851744,1,2,0,284,118,120,2
"62bff51286ef4f348717a3cf6fe2318f","62bff51286ef4f348717a3cf6fe2318f",22851744,3,0,1,285,120,120,0
"62bff51286ef4f348717a3cf6fe2318f","e20db35ced8544ddac5bc3839145e463",22851744,1,-33,0,288,120,91,-29
"e20db35ced8544ddac5bc3839145e463","779f9ddd1fd14d1e9e69f72219a1fdbd",22851744,1,36,0,289,91,121,30
"779f9ddd1fd14d1e9e69f72219a1fdbd","ae26e6cda8ad4a3f81bd347560d9579f",22851744,1,4,0,290,121,125,4
"ae26e6cda8ad4a3f81bd347560d9579f","ae26e6cda8ad4a3f81bd347560d9579f",22851744,1,0,1,291,125,125,0
"ae26e6cda8ad4a3f81bd347560d9579f","ee48df95832b4374aa273ceb27ec1315",22851744,1,1,0,292,125,126,1
"ee48df95832b4374aa273ceb27ec1315","ee48df95832b4374aa273ceb27ec1315",22851744,1,0,1,293,126,126,0
"ee48df95832b4374aa273ceb27ec1315","7a439da90b394756ad1777fc4c6dead5",22851744,1,1,0,294,126,127,1
"7a439da90b394756ad1777fc4c6dead5","7a439da90b394756ad1777fc4c6dead5",22851744,1,0,1,295,127,127,0
"7a439da90b394756ad1777fc4c6dead5","a8dd5213034441ac92724b4e83eb0bb2",22851744,1,3,0,296,127,129,2
"a8dd5213034441ac92724b4e83eb0bb2","779f9ddd1fd14d1e9e69f72219a1fdbd",22851744,1,-9,0,297,129,121,-8
"779f9ddd1fd14d1e9e69f72219a1fdbd","a8dd5213034441ac92724b4e83eb0bb2",22851744,1,9,0,298,121,129,8
"a8dd5213034441ac92724b4e83eb0bb2","a8dd5213034441ac92724b4e83eb0bb2",22851744,1,0,1,299,129,129,0
"a8dd5213034441ac92724b4e83eb0bb2","8115eab6556b45f5b415c3b8c26a12e5",22851744,1,2,0,300,129,131,2
"8115eab6556b45f5b415c3b8c26a12e5","8115eab6556b45f5b415c3b8c26a12e5",22851744,2,0,1,301,131,131,0
"8115eab6556b45f5b415c3b8c26a12e5","ec34b06efd844b46a4c4818ecdb9b8f4",22851744,1,1,0,303,131,132,1
"ec34b06efd844b46a4c4818ecdb9b8f4","ec34b06efd844b46a4c4818ecdb9b8f4",22851744,2,0,1,304,132,132,0
"ec34b06efd844b46a4c4818ecdb9b8f4","c2e1c2b9eac64109b343a088584b576b",22851744,1,1,0,306,132,133,1
"c2e1c2b9eac64109b343a088584b576b","c2e1c2b9eac64109b343a088584b576b",22851744,2,0,1,307,133,133,0
"c2e1c2b9eac64109b343a088584b576b","579338175e0b4bbb8ef3b712b5d8b54e",22851744,1,-5,0,309,133,128,-5
"579338175e0b4bbb8ef3b712b5d8b54e","8bc5795d6a984a3eace4e2811e52dd4f",22851744,1,8,0,310,128,135,7
"8bc5795d6a984a3eace4e2811e52dd4f","8bc5795d6a984a3eace4e2811e52dd4f",22851744,1,0,1,311,135,135,0
"8bc5795d6a984a3eace4e2811e52dd4f","b416d47c56a742199b5d7c7f19d6503a",22851744,1,-1,0,312,135,134,-1
"b416d47c56a742199b5d7c7f19d6503a","779f9ddd1fd14d1e9e69f72219a1fdbd",22851744,1,-15,0,313,134,121,-13
"779f9ddd1fd14d1e9e69f72219a1fdbd","cd4532ad48034873ba8bce2aac0c9808",22851744,1,19,0,314,121,137,16
"cd4532ad48034873ba8bce2aac0c9808","cd4532ad48034873ba8bce2aac0c9808",22851744,1,0,1,315,137,137,0
"cd4532ad48034873ba8bce2aac0c9808","779f9ddd1fd14d1e9e69f72219a1fdbd",22851744,1,-19,0,316,137,121,-16
"779f9ddd1fd14d1e9e69f72219a1fdbd","df1de691dafe4549a18a4398ee9dfaf9",22851744,1,23,0,317,121,139,18
"df1de691dafe4549a18a4398ee9dfaf9","6c5ad271a44743479bfaea29b1db8d02",22851744,1,4,0,318,139,143,4
"6c5ad271a44743479bfaea29b1db8d02","6c5ad271a44743479bfaea29b1db8d02",22851744,5,0,1,319,143,143,0
"6c5ad271a44743479bfaea29b1db8d02","83d311bed5374fee83d8d67a7d9d82dc",22851744,1,1,0,322,143,144,1
"83d311bed5374fee83d8d67a7d9d82dc","83d311bed5374fee83d8d67a7d9d82dc",22851744,1,0,1,323,144,144,0
"83d311bed5374fee83d8d67a7d9d82dc","402bba41861d43acb52a5abb89e8831e",22851744,1,1,0,324,144,145,1
"402bba41861d43acb52a5abb89e8831e","402bba41861d43acb52a5abb89e8831e",22851744,2,0,1,325,145,145,0
"402bba41861d43acb52a5abb89e8831e","df1de691dafe4549a18a4398ee9dfaf9",22851744,1,-6,0,327,145,139,-6
"df1de691dafe4549a18a4398ee9dfaf9","8aae34f5ddbb4052a709b12e6b0d40fa",22851744,2,9,0,328,139,147,8
"8aae34f5ddbb4052a709b12e6b0d40fa","8aae34f5ddbb4052a709b12e6b0d40fa",22851744,5,0,1,329,147,147,0
"8aae34f5ddbb4052a709b12e6b0d40fa","645b3f0249f64f76af2e19eb4d0e55b7",22851744,1,2,0,332,147,149,2
"645b3f0249f64f76af2e19eb4d0e55b7","645b3f0249f64f76af2e19eb4d0e55b7",22851744,2,0,1,333,149,149,0
"645b3f0249f64f76af2e19eb4d0e55b7","f902b0f41b544d4dbf79664fd233648d",22851744,1,-3,0,335,149,146,-3
"f902b0f41b544d4dbf79664fd233648d","6c5ad271a44743479bfaea29b1db8d02",22851744,1,-4,0,336,146,143,-3
"6c5ad271a44743479bfaea29b1db8d02","df1de691dafe4549a18a4398ee9dfaf9",22851744,1,-4,0,339,143,139,-4
"8aae34f5ddbb4052a709b12e6b0d40fa","7e7b8db5064d4369805ab370aac5ddfb",22851744,1,3,0,343,147,150,3
"7e7b8db5064d4369805ab370aac5ddfb","7e7b8db5064d4369805ab370aac5ddfb",22851744,5,0,1,344,150,150,0
"7e7b8db5064d4369805ab370aac5ddfb","8956d210ae7f41968fada86d4c979d6a",22851744,1,1,0,349,150,151,1
"8956d210ae7f41968fada86d4c979d6a","8956d210ae7f41968fada86d4c979d6a",22851744,2,0,1,350,151,151,0
"8956d210ae7f41968fada86d4c979d6a","f902b0f41b544d4dbf79664fd233648d",22851744,1,-5,0,352,151,146,-5
"f902b0f41b544d4dbf79664fd233648d","ae781e8b775e4ccd93bc800dad5c8376",22851744,1,8,0,353,146,153,7
"ae781e8b775e4ccd93bc800dad5c8376","ae781e8b775e4ccd93bc800dad5c8376",22851744,2,0,1,354,153,153,0
"ae781e8b775e4ccd93bc800dad5c8376","06882a8492d9499aa31555567f575ecb",22851744,1,1,0,356,153,154,1
"06882a8492d9499aa31555567f575ecb","06882a8492d9499aa31555567f575ecb",22851744,1,0,1,357,154,154,0
"06882a8492d9499aa31555567f575ecb","f293c508f409466a8f27ddd7d1e40b20",22851744,1,1,0,358,154,155,1
"f293c508f409466a8f27ddd7d1e40b20","f293c508f409466a8f27ddd7d1e40b20",22851744,2,0,1,359,155,155,0
"f293c508f409466a8f27ddd7d1e40b20","cc4ddef5bbbe48ebb605141b347c4ed1",22851744,1,1,0,361,155,156,1
"cc4ddef5bbbe48ebb605141b347c4ed1","cc4ddef5bbbe48ebb605141b347c4ed1",22851744,1,0,1,362,156,156,0
"cc4ddef5bbbe48ebb605141b347c4ed1","d313cec988a84645bee413e8d4724a4b",22851744,1,3,0,363,156,158,2
"d313cec988a84645bee413e8d4724a4b","f03480cf4eba413194d7af52fc0e7f28",22851744,1,-7,0,364,158,152,-6
"f03480cf4eba413194d7af52fc0e7f28","d313cec988a84645bee413e8d4724a4b",22851744,1,7,0,365,152,158,6
"d313cec988a84645bee413e8d4724a4b","d313cec988a84645bee413e8d4724a4b",22851744,3,0,1,366,158,158,0
"d313cec988a84645bee413e8d4724a4b","dc60696c76a74368a60f72246e47700d",22851744,1,1,0,369,158,159,1
"dc60696c76a74368a60f72246e47700d","dc60696c76a74368a60f72246e47700d",22851744,1,0,1,370,159,159,0
"dc60696c76a74368a60f72246e47700d","78adeee1fa2c4fe0bc73f7bca9fcee86",22851744,1,3,0,371,159,160,1
"78adeee1fa2c4fe0bc73f7bca9fcee86","df1de691dafe4549a18a4398ee9dfaf9",22851744,1,-26,0,372,160,139,-21
"df1de691dafe4549a18a4398ee9dfaf9","78adeee1fa2c4fe0bc73f7bca9fcee86",22851744,1,26,0,373,139,160,21
"78adeee1fa2c4fe0bc73f7bca9fcee86","65202579580f4ad38d734b4ee39d22a8",22851744,1,5,0,374,160,164,4
"65202579580f4ad38d734b4ee39d22a8","65202579580f4ad38d734b4ee39d22a8",22851744,54,0,1,375,164,164,0
"65202579580f4ad38d734b4ee39d22a8","78adeee1fa2c4fe0bc73f7bca9fcee86",22851744,1,-5,0,429,164,160,-4
"78adeee1fa2c4fe0bc73f7bca9fcee86","3cbcea2be0984e7dbd5a48195af10ce7",22851744,1,8,0,430,160,165,5
"3cbcea2be0984e7dbd5a48195af10ce7","82e6285962b8400d9d6fc32436022a94",22851744,1,2,0,431,165,167,2
"82e6285962b8400d9d6fc32436022a94","3cbcea2be0984e7dbd5a48195af10ce7",22851744,1,-2,0,432,167,165,-2
"3cbcea2be0984e7dbd5a48195af10ce7","a9ac840f098c4bd0a2ee896214ce29cd",22851744,1,5,0,433,165,168,3
"a9ac840f098c4bd0a2ee896214ce29cd","a9ac840f098c4bd0a2ee896214ce29cd",22851744,4,0,1,434,168,168,0
"a9ac840f098c4bd0a2ee896214ce29cd","0c7262dff33c4087bc660ccf40f92f9c",22851744,5,4,0,435,168,169,1
"0c7262dff33c4087bc660ccf40f92f9c","b2275c3fad834f8d90737a2d9a6927d6",22851744,5,3,0,436,169,172,3
"b2275c3fad834f8d90737a2d9a6927d6","b2275c3fad834f8d90737a2d9a6927d6",22851744,26,0,1,437,172,172,0
"b2275c3fad834f8d90737a2d9a6927d6","a9ac840f098c4bd0a2ee896214ce29cd",22851744,1,-7,0,463,172,168,-4
"0c7262dff33c4087bc660ccf40f92f9c","a9ac840f098c4bd0a2ee896214ce29cd",22851744,3,-4,0,465,169,168,-1
"b2275c3fad834f8d90737a2d9a6927d6","0c7262dff33c4087bc660ccf40f92f9c",22851744,3,-3,0,469,172,169,-3
"b2275c3fad834f8d90737a2d9a6927d6","eb515a26030b41f8a82a1e6114420bad",22851744,1,1,0,481,172,173,1
"eb515a26030b41f8a82a1e6114420bad","eb515a26030b41f8a82a1e6114420bad",22851744,2,0,1,482,173,173,0
"eb515a26030b41f8a82a1e6114420bad","0c7262dff33c4087bc660ccf40f92f9c",22851744,1,-4,0,484,173,169,-4
"0c7262dff33c4087bc660ccf40f92f9c","b42cc17b7de840f181a704558d0bc845",22851744,1,7,0,485,169,175,6
"b42cc17b7de840f181a704558d0bc845","b42cc17b7de840f181a704558d0bc845",22851744,2,0,1,486,175,175,0
"b42cc17b7de840f181a704558d0bc845","801f9e9135034f49bf5f8b4bdefedb41",22851744,1,2,0,488,175,177,2
"801f9e9135034f49bf5f8b4bdefedb41","801f9e9135034f49bf5f8b4bdefedb41",22851744,10,0,1,489,177,177,0
"801f9e9135034f49bf5f8b4bdefedb41","ea38cc0e6e6e41edbabf210220808bf9",22851744,1,3,0,499,177,179,2
"ea38cc0e6e6e41edbabf210220808bf9","362fcb0699a14845ab29b2340093e528",22851744,1,-6,0,500,179,174,-5
"362fcb0699a14845ab29b2340093e528","b87c552dd247427abe6ab5795b9c9d43",22851744,1,8,0,501,174,181,7
"b87c552dd247427abe6ab5795b9c9d43","ea38cc0e6e6e41edbabf210220808bf9",22851744,1,-2,0,502,181,179,-2
"ea38cc0e6e6e41edbabf210220808bf9","ea38cc0e6e6e41edbabf210220808bf9",22851744,1,0,1,503,179,179,0
"ea38cc0e6e6e41edbabf210220808bf9","b87c552dd247427abe6ab5795b9c9d43",22851744,1,2,0,504,179,181,2
"b87c552dd247427abe6ab5795b9c9d43","b87c552dd247427abe6ab5795b9c9d43",22851744,7,0,1,505,181,181,0
"b87c552dd247427abe6ab5795b9c9d43","139b097acfca451689d80c9c6eebdf7b",22851744,1,-3,0,512,181,178,-3
"139b097acfca451689d80c9c6eebdf7b","30f660a1feb34582a739722532524f79",22851744,1,6,0,513,178,183,5
"30f660a1feb34582a739722532524f79","30f660a1feb34582a739722532524f79",22851744,5,0,1,514,183,183,0
"30f660a1feb34582a739722532524f79","2024b4885bd14338a39b7b509acbbd02",22851744,1,-1,0,519,183,182,-1
"2024b4885bd14338a39b7b509acbbd02","c3f63fe50d8e487c86bf8ef76c9cadd3",22851744,1,4,0,520,182,185,3
"c3f63fe50d8e487c86bf8ef76c9cadd3","c3f63fe50d8e487c86bf8ef76c9cadd3",22851744,1,0,1,521,185,185,0
"c3f63fe50d8e487c86bf8ef76c9cadd3","0c7262dff33c4087bc660ccf40f92f9c",22851744,1,-20,0,522,185,169,-16
"0c7262dff33c4087bc660ccf40f92f9c","c8e371568a0c4391b25796ae4e91952e",22851744,1,23,0,523,169,186,17
"c8e371568a0c4391b25796ae4e91952e","7d932b23e1c84326ae5aa4d3c0d813d1",22851744,1,2,0,524,186,188,2
"7d932b23e1c84326ae5aa4d3c0d813d1","7d932b23e1c84326ae5aa4d3c0d813d1",22851744,5,0,1,525,188,188,0
"7d932b23e1c84326ae5aa4d3c0d813d1","c8e371568a0c4391b25796ae4e91952e",22851744,1,-2,0,530,188,186,-2
"c8e371568a0c4391b25796ae4e91952e","ab11d94c6c8948ea90b88f19d2cd502b",22851744,1,5,0,531,186,190,4
"ab11d94c6c8948ea90b88f19d2cd502b","ab11d94c6c8948ea90b88f19d2cd502b",22851744,2,0,1,532,190,190,0
"ab11d94c6c8948ea90b88f19d2cd502b","f992451ed6ad4e68bb9e68ad6be7c4be",22851744,1,2,0,534,190,192,2
"f992451ed6ad4e68bb9e68ad6be7c4be","f992451ed6ad4e68bb9e68ad6be7c4be",22851744,1,0,1,535,192,192,0
"f992451ed6ad4e68bb9e68ad6be7c4be","07b44a7a51e94c78b411c753fc39dab0",22851744,1,-3,0,536,192,189,-3
"07b44a7a51e94c78b411c753fc39dab0","6cd2dcaac46847d4a0bc53f296d90375",22851744,1,6,0,537,189,194,5
"6cd2dcaac46847d4a0bc53f296d90375","6cd2dcaac46847d4a0bc53f296d90375",22851744,2,0,1,538,194,194,0
"6cd2dcaac46847d4a0bc53f296d90375","2d2580c9411c4972909db508d6956a58",22851744,1,2,0,540,194,196,2
"2d2580c9411c4972909db508d6956a58","2d2580c9411c4972909db508d6956a58",22851744,2,0,1,541,196,196,0
"2d2580c9411c4972909db508d6956a58","5bddb3d9ed264f3984702f048c7e5340",22851744,1,1,0,543,196,197,1
"5bddb3d9ed264f3984702f048c7e5340","5bddb3d9ed264f3984702f048c7e5340",22851744,2,0,1,544,197,197,0
"5bddb3d9ed264f3984702f048c7e5340","d5e8e2bd12a2466b9d6d90855f0eb079",22851744,1,1,0,546,197,198,1
"d5e8e2bd12a2466b9d6d90855f0eb079","d5e8e2bd12a2466b9d6d90855f0eb079",22851744,2,0,1,547,198,198,0
"d5e8e2bd12a2466b9d6d90855f0eb079","017d7ca8e0394b91aaadc9574df2202c",22851744,1,-5,0,549,198,193,-5
"017d7ca8e0394b91aaadc9574df2202c","54e8e9f0ea3e45c4bf3b8ac799ee31b1",22851744,1,8,0,550,193,200,7
"54e8e9f0ea3e45c4bf3b8ac799ee31b1","54e8e9f0ea3e45c4bf3b8ac799ee31b1",22851744,1,0,1,551,200,200,0
"54e8e9f0ea3e45c4bf3b8ac799ee31b1","c614a00911be4877a075f19315530fb0",22851744,1,1,0,552,200,201,1
"c614a00911be4877a075f19315530fb0","c614a00911be4877a075f19315530fb0",22851744,6,0,1,553,201,201,0
"c614a00911be4877a075f19315530fb0","bb329d880ab54120adaf203a693bb203",22851744,1,2,0,559,201,203,2
"bb329d880ab54120adaf203a693bb203","bb329d880ab54120adaf203a693bb203",22851744,1,0,1,560,203,203,0
"bb329d880ab54120adaf203a693bb203","a6c21bd8b95249c7972820a7a7d76aff",22851744,1,-1,0,561,203,202,-1
"a6c21bd8b95249c7972820a7a7d76aff","a6c21bd8b95249c7972820a7a7d76aff",22851744,1,0,1,562,202,202,0
"a6c21bd8b95249c7972820a7a7d76aff","f9170dd6bc6442b4acd832747609b09a",22851744,1,-3,0,563,202,199,-3
"f9170dd6bc6442b4acd832747609b09a","334c2344009840079b1d0e1b7ce3d5a7",22851744,1,7,0,564,199,205,6
"334c2344009840079b1d0e1b7ce3d5a7","334c2344009840079b1d0e1b7ce3d5a7",22851744,1,0,1,565,205,205,0
"334c2344009840079b1d0e1b7ce3d5a7","d7f13c8d63ec4e2aa673fbb9cf9c6933",22851744,1,3,0,566,205,206,1
"d7f13c8d63ec4e2aa673fbb9cf9c6933","c8e371568a0c4391b25796ae4e91952e",22851744,1,-26,0,567,206,186,-20
"c8e371568a0c4391b25796ae4e91952e","b9e80f77c3a44349863b19875725c384",22851744,1,27,0,568,186,207,21
"b9e80f77c3a44349863b19875725c384","7108f0e4c2584f1f9c471689ae4c885c",22851744,2,1,0,569,207,208,1
"7108f0e4c2584f1f9c471689ae4c885c","b9e80f77c3a44349863b19875725c384",22851744,1,-1,0,570,208,207,-1
"b9e80f77c3a44349863b19875725c384","b9e80f77c3a44349863b19875725c384",22851744,11,0,1,571,207,207,0
"7108f0e4c2584f1f9c471689ae4c885c","7108f0e4c2584f1f9c471689ae4c885c",22851744,10,0,1,583,208,208,0
"7108f0e4c2584f1f9c471689ae4c885c","d7f13c8d63ec4e2aa673fbb9cf9c6933",22851744,1,-2,0,593,208,206,-2
"d7f13c8d63ec4e2aa673fbb9cf9c6933","09400e101c5d4b439cf9a26b03aae558",22851744,1,5,0,594,206,210,4
"09400e101c5d4b439cf9a26b03aae558","09400e101c5d4b439cf9a26b03aae558",22851744,2,0,1,595,210,210,0
"09400e101c5d4b439cf9a26b03aae558","a88efa7e50ce47159810ab553afa6d3a",22851744,1,2,0,597,210,212,2
"a88efa7e50ce47159810ab553afa6d3a","a88efa7e50ce47159810ab553afa6d3a",22851744,2,0,1,598,212,212,0
"a88efa7e50ce47159810ab553afa6d3a","a875096404ef4a9984b62d74cda916f9",22851744,1,-3,0,600,212,209,-3
"a875096404ef4a9984b62d74cda916f9","be502a7a43c44bf7b682698de79d9369",22851744,1,6,0,601,209,214,5
"be502a7a43c44bf7b682698de79d9369","f7fb1952f56b4189b86a9f8b7862d2b8",22851744,2,1,0,602,214,215,1
"f7fb1952f56b4189b86a9f8b7862d2b8","be502a7a43c44bf7b682698de79d9369",22851744,1,-1,0,603,215,214,-1
"be502a7a43c44bf7b682698de79d9369","be502a7a43c44bf7b682698de79d9369",22851744,1,0,1,604,214,214,0
"f7fb1952f56b4189b86a9f8b7862d2b8","f7fb1952f56b4189b86a9f8b7862d2b8",22851744,18,0,1,606,215,215,0
"f7fb1952f56b4189b86a9f8b7862d2b8","b860ee85d8bc4a2f97958cfb71be3533",22851744,1,1,0,624,215,216,1
"b860ee85d8bc4a2f97958cfb71be3533","b860ee85d8bc4a2f97958cfb71be3533",22851744,2,0,1,625,216,216,0
"b860ee85d8bc4a2f97958cfb71be3533","ec341f459285443b8361f7f15638ff08",22851744,1,-3,0,627,216,213,-3
"ec341f459285443b8361f7f15638ff08","363837c182e04711840d896ae1e0339c",22851744,1,6,0,628,213,218,5
"363837c182e04711840d896ae1e0339c","363837c182e04711840d896ae1e0339c",22851744,12,0,1,629,218,218,0
"363837c182e04711840d896ae1e0339c","01b2051f8941460d89945e3b02d1ce78",22851744,1,-1,0,641,218,217,-1
"01b2051f8941460d89945e3b02d1ce78","d7f13c8d63ec4e2aa673fbb9cf9c6933",22851744,1,-14,0,642,217,206,-11
"d7f13c8d63ec4e2aa673fbb9cf9c6933","d7f13c8d63ec4e2aa673fbb9cf9c6933",22851744,1,0,1,643,206,206,0
"d7f13c8d63ec4e2aa673fbb9cf9c6933","91125ca626c5470eb145501f8c37f8db",22851744,1,18,0,644,206,220,14
"91125ca626c5470eb145501f8c37f8db","91125ca626c5470eb145501f8c37f8db",22851744,1,0,1,645,220,220,0
"91125ca626c5470eb145501f8c37f8db","d7f13c8d63ec4e2aa673fbb9cf9c6933",22851744,1,-18,0,646,220,206,-14
"d7f13c8d63ec4e2aa673fbb9cf9c6933","1c6721b1f63f4d30ba7746ea8af02a52",22851744,1,21,0,647,206,221,15
"1c6721b1f63f4d30ba7746ea8af02a52","1c6721b1f63f4d30ba7746ea8af02a52",22851744,1,0,1,648,221,221,0
"1c6721b1f63f4d30ba7746ea8af02a52","77ecef8eff6b4a2caea7707669bf7475",22851744,2,1,0,649,221,222,1
"77ecef8eff6b4a2caea7707669bf7475","1c6721b1f63f4d30ba7746ea8af02a52",22851744,1,-1,0,650,222,221,-1
"77ecef8eff6b4a2caea7707669bf7475","77ecef8eff6b4a2caea7707669bf7475",22851744,12,0,1,652,222,222,0
"77ecef8eff6b4a2caea7707669bf7475","d03cb855c70044cf8c35d9ec0de696e3",22851744,1,3,0,664,222,224,2
"d03cb855c70044cf8c35d9ec0de696e3","1c6721b1f63f4d30ba7746ea8af02a52",22851744,1,-4,0,665,224,221,-3
"1c6721b1f63f4d30ba7746ea8af02a52","8b9ae98743bd4d4a8a87dff1c1244211",22851744,1,7,0,666,221,227,6
"8b9ae98743bd4d4a8a87dff1c1244211","d03cb855c70044cf8c35d9ec0de696e3",22851744,1,-3,0,667,227,224,-3
"d03cb855c70044cf8c35d9ec0de696e3","d03cb855c70044cf8c35d9ec0de696e3",22851744,1,0,1,668,224,224,0
"d03cb855c70044cf8c35d9ec0de696e3","a49a937d6896486d9a5396654abcf2e1",22851744,1,2,0,669,224,226,2
"a49a937d6896486d9a5396654abcf2e1","a49a937d6896486d9a5396654abcf2e1",22851744,1,0,1,670,226,226,0
"a49a937d6896486d9a5396654abcf2e1","8b9ae98743bd4d4a8a87dff1c1244211",22851744,1,1,0,671,226,227,1
"8b9ae98743bd4d4a8a87dff1c1244211","8b9ae98743bd4d4a8a87dff1c1244211",22851744,13,0,1,672,227,227,0
"8b9ae98743bd4d4a8a87dff1c1244211","f7906d6f59b9489a91d2ef40db5a474d",22851744,1,-4,0,685,227,223,-4
"f7906d6f59b9489a91d2ef40db5a474d","2ab1535aac1346ba8801535bf729ef37",22851744,1,7,0,686,223,229,6
"2ab1535aac1346ba8801535bf729ef37","2ab1535aac1346ba8801535bf729ef37",22851744,3,0,1,687,229,229,0
"2ab1535aac1346ba8801535bf729ef37","a4f40fb48a8542c8949bae1f002cd9bc",22851744,1,2,0,690,229,231,2
"a4f40fb48a8542c8949bae1f002cd9bc","a4f40fb48a8542c8949bae1f002cd9bc",22851744,2,0,1,691,231,231,0
"a4f40fb48a8542c8949bae1f002cd9bc","8972c23e32044edb8a78fa1eed4e5947",22851744,1,1,0,693,231,232,1
"8972c23e32044edb8a78fa1eed4e5947","8972c23e32044edb8a78fa1eed4e5947",22851744,1,0,1,694,232,232,0
"8972c23e32044edb8a78fa1eed4e5947","92feb4a40f8344d38b6f722e42a53295",22851744,1,1,0,695,232,233,1
"92feb4a40f8344d38b6f722e42a53295","92feb4a40f8344d38b6f722e42a53295",22851744,2,0,1,696,233,233,0
"92feb4a40f8344d38b6f722e42a53295","5152833676bf4c6cb317060be10f68db",22851744,1,-5,0,698,233,228,-5
"5152833676bf4c6cb317060be10f68db","ca3e28f290354c08aefe5b0f769604e6",22851744,1,8,0,699,228,235,7
"ca3e28f290354c08aefe5b0f769604e6","ca3e28f290354c08aefe5b0f769604e6",22851744,4,0,1,700,235,235,0
"ca3e28f290354c08aefe5b0f769604e6","79a35eea833e4c2c9d22fc53c3c6445c",22851744,1,1,0,704,235,236,1
"79a35eea833e4c2c9d22fc53c3c6445c","79a35eea833e4c2c9d22fc53c3c6445c",22851744,4,0,1,705,236,236,0
"79a35eea833e4c2c9d22fc53c3c6445c","8f68228b1518449e9615cdafee41a2bd",22851744,1,1,0,709,236,237,1
"8f68228b1518449e9615cdafee41a2bd","8f68228b1518449e9615cdafee41a2bd",22851744,1,0,1,710,237,237,0
"8f68228b1518449e9615cdafee41a2bd","cab89fa5c3ed45a5aa550fc0352d6a42",22851744,1,1,0,711,237,238,1
"cab89fa5c3ed45a5aa550fc0352d6a42","cab89fa5c3ed45a5aa550fc0352d6a42",22851744,1,0,1,712,238,238,0
"cab89fa5c3ed45a5aa550fc0352d6a42","66d4fad4f1cf4b46be0750a99ad7a35a",22851744,1,1,0,713,238,239,1
"66d4fad4f1cf4b46be0750a99ad7a35a","66d4fad4f1cf4b46be0750a99ad7a35a",22851744,1,0,1,714,239,239,0
"66d4fad4f1cf4b46be0750a99ad7a35a","0b04c8e2f86d48c7aeb7e225819cd32b",22851744,1,-5,0,715,239,234,-5
"0b04c8e2f86d48c7aeb7e225819cd32b","f53da5fd9bfe412da4b80d4742563b6c",22851744,1,8,0,716,234,241,7
"f53da5fd9bfe412da4b80d4742563b6c","f53da5fd9bfe412da4b80d4742563b6c",22851744,1,0,1,717,241,241,0
"f53da5fd9bfe412da4b80d4742563b6c","1c6721b1f63f4d30ba7746ea8af02a52",22851744,1,-24,0,718,241,221,-20
"1c6721b1f63f4d30ba7746ea8af02a52","2ae94c0cea4d480a9d5dca8fb1d7b542",22851744,1,27,0,719,221,242,21
"2ae94c0cea4d480a9d5dca8fb1d7b542","1ebf23f9d994469a85206e4c7b1bf5f5",22851744,2,3,0,720,242,245,3
"1ebf23f9d994469a85206e4c7b1bf5f5","1ebf23f9d994469a85206e4c7b1bf5f5",22851744,12,0,1,721,245,245,0
"1ebf23f9d994469a85206e4c7b1bf5f5","85ae675b83e8422da842cfd25596af99",22851744,1,1,0,733,245,246,1
"85ae675b83e8422da842cfd25596af99","85ae675b83e8422da842cfd25596af99",22851744,1,0,1,734,246,246,0
"85ae675b83e8422da842cfd25596af99","fa235f0f364d47e4ae1c87f47bf8e6ba",22851744,1,8,0,735,246,252,6
"fa235f0f364d47e4ae1c87f47bf8e6ba","2ae94c0cea4d480a9d5dca8fb1d7b542",22851744,2,-12,0,736,252,242,-10
"2ae94c0cea4d480a9d5dca8fb1d7b542","fa235f0f364d47e4ae1c87f47bf8e6ba",22851744,1,12,0,737,242,252,10
"fa235f0f364d47e4ae1c87f47bf8e6ba","fa235f0f364d47e4ae1c87f47bf8e6ba",22851744,1,0,1,738,252,252,0
"fa235f0f364d47e4ae1c87f47bf8e6ba","79f7845465cc4ed19d8e4f1429541be0",22851744,1,2,0,739,252,254,2
"79f7845465cc4ed19d8e4f1429541be0","79f7845465cc4ed19d8e4f1429541be0",22851744,2,0,1,740,254,254,0
"79f7845465cc4ed19d8e4f1429541be0","6e83e23f56544a19b94067c1c558d9c0",22851744,1,-8,0,742,254,247,-7
"6e83e23f56544a19b94067c1c558d9c0","00f61990949545828dd12f1303d47504",22851744,1,11,0,743,247,256,9
"00f61990949545828dd12f1303d47504","00f61990949545828dd12f1303d47504",22851744,2,0,1,744,256,256,0
"00f61990949545828dd12f1303d47504","ead7bb4b64e247d2ae632ab8a296b091",22851744,1,2,0,746,256,258,2
"ead7bb4b64e247d2ae632ab8a296b091","ead7bb4b64e247d2ae632ab8a296b091",22851744,2,0,1,747,258,258,0
"ead7bb4b64e247d2ae632ab8a296b091","41b0048dde734bb280bac6116baa8e27",22851744,1,1,0,749,258,259,1
"41b0048dde734bb280bac6116baa8e27","41b0048dde734bb280bac6116baa8e27",22851744,2,0,1,750,259,259,0
"41b0048dde734bb280bac6116baa8e27","b41c5a094a604ee0915327da5cc0beb7",22851744,1,1,0,752,259,260,1
"b41c5a094a604ee0915327da5cc0beb7","b41c5a094a604ee0915327da5cc0beb7",22851744,8,0,1,753,260,260,0
"b41c5a094a604ee0915327da5cc0beb7","d546341988904f069cfa86b21457d9d9",22851744,1,-10,0,761,260,251,-9
"d546341988904f069cfa86b21457d9d9","28c171777c52431ab6b925073bd63d46",22851744,1,15,0,762,251,264,13
"28c171777c52431ab6b925073bd63d46","28c171777c52431ab6b925073bd63d46",22851744,3,0,1,763,264,264,0
"28c171777c52431ab6b925073bd63d46","ac160db940cb49ae8579162b1d52bb5d",22851744,1,2,0,766,264,266,2
"ac160db940cb49ae8579162b1d52bb5d","ac160db940cb49ae8579162b1d52bb5d",22851744,3,0,1,767,266,266,0
"ac160db940cb49ae8579162b1d52bb5d","d989ebcfc12a4b669f0100dc1aa14f1e",22851744,1,-12,0,770,266,255,-11
"d989ebcfc12a4b669f0100dc1aa14f1e","c6fd49b485cc4874b0bbdd9c6171e09c",22851744,1,15,0,771,255,268,13
"c6fd49b485cc4874b0bbdd9c6171e09c","c6fd49b485cc4874b0bbdd9c6171e09c",22851744,3,0,1,772,268,268,0
"c6fd49b485cc4874b0bbdd9c6171e09c","44240778a97c4af0937817499b75707b",22851744,1,1,0,775,268,269,1
"44240778a97c4af0937817499b75707b","44240778a97c4af0937817499b75707b",22851744,2,0,1,776,269,269,0
"44240778a97c4af0937817499b75707b","7aa76d3e993840d8805f097cbdbcd44b",22851744,1,-9,0,778,269,261,-8
"7aa76d3e993840d8805f097cbdbcd44b","865a4d3b43374da7944dc7d397f566d9",22851744,1,12,0,779,261,271,10
"865a4d3b43374da7944dc7d397f566d9","865a4d3b43374da7944dc7d397f566d9",22851744,1,0,1,780,271,271,0
"865a4d3b43374da7944dc7d397f566d9","2ae94c0cea4d480a9d5dca8fb1d7b542",22851744,1,-35,0,781,271,242,-29
"2ae94c0cea4d480a9d5dca8fb1d7b542","0d987bed3ffa4ed0b9a2e62e97b7b30f",22851744,5,38,0,782,242,272,30
"0d987bed3ffa4ed0b9a2e62e97b7b30f","0d987bed3ffa4ed0b9a2e62e97b7b30f",22851744,4,0,1,783,272,272,0
"0d987bed3ffa4ed0b9a2e62e97b7b30f","bb5a47f5ea01454a8b79455422d3b9da",22851744,3,10,0,784,272,280,8
"bb5a47f5ea01454a8b79455422d3b9da","bb5a47f5ea01454a8b79455422d3b9da",22851744,108,0,1,785,280,280,0
"bb5a47f5ea01454a8b79455422d3b9da","82ae07bc0c9b4570a41799290d1ef399",22851744,4,-6,0,790,280,275,-5
"82ae07bc0c9b4570a41799290d1ef399","bb5a47f5ea01454a8b79455422d3b9da",22851744,6,6,0,791,275,280,5
"bb5a47f5ea01454a8b79455422d3b9da","2ae94c0cea4d480a9d5dca8fb1d7b542",22851744,3,-48,0,800,280,242,-38
"1ebf23f9d994469a85206e4c7b1bf5f5","fa235f0f364d47e4ae1c87f47bf8e6ba",22851744,1,9,0,802,245,252,7
"2ae94c0cea4d480a9d5dca8fb1d7b542","00f61990949545828dd12f1303d47504",22851744,2,17,0,804,242,256,14
"00f61990949545828dd12f1303d47504","6e83e23f56544a19b94067c1c558d9c0",22851744,1,-11,0,805,256,247,-9
"6e83e23f56544a19b94067c1c558d9c0","d546341988904f069cfa86b21457d9d9",22851744,1,5,0,806,247,251,4
"d546341988904f069cfa86b21457d9d9","d989ebcfc12a4b669f0100dc1aa14f1e",22851744,2,5,0,807,251,255,4
"d989ebcfc12a4b669f0100dc1aa14f1e","7aa76d3e993840d8805f097cbdbcd44b",22851744,4,7,0,808,255,261,6
"7aa76d3e993840d8805f097cbdbcd44b","2ae94c0cea4d480a9d5dca8fb1d7b542",22851744,3,-23,0,809,261,242,-19
"0d987bed3ffa4ed0b9a2e62e97b7b30f","82ae07bc0c9b4570a41799290d1ef399",22851744,2,4,0,812,272,275,3
"bb5a47f5ea01454a8b79455422d3b9da","67a089198fcb4e1c8f2385786c2b296f",22851744,1,-314,0,821,280,39,-241
"64d48c6c9c7940639a932219a6c87198","2ae94c0cea4d480a9d5dca8fb1d7b542",22851744,1,265,0,823,40,242,202
"00f61990949545828dd12f1303d47504","d546341988904f069cfa86b21457d9d9",22851744,1,-6,0,825,256,251,-5
"2ae94c0cea4d480a9d5dca8fb1d7b542","d989ebcfc12a4b669f0100dc1aa14f1e",22851744,2,16,0,841,242,255,13
"7aa76d3e993840d8805f097cbdbcd44b","0d987bed3ffa4ed0b9a2e62e97b7b30f",22851744,1,15,0,843,261,272,11
"0d987bed3ffa4ed0b9a2e62e97b7b30f","2ae94c0cea4d480a9d5dca8fb1d7b542",22851744,1,-38,0,844,272,242,-30
"bb5a47f5ea01454a8b79455422d3b9da","bc5524e78a8544e2ae2fdc2f3462bbec",22851744,1,-1,0,860,280,279,-1
"bc5524e78a8544e2ae2fdc2f3462bbec","bb5a47f5ea01454a8b79455422d3b9da",22851744,1,1,0,861,279,280,1
"bb5a47f5ea01454a8b79455422d3b9da","94cecc3f1e7d484b8e068e79241dfd73",22851744,1,3,0,934,280,281,1
"94cecc3f1e7d484b8e068e79241dfd73","0d987bed3ffa4ed0b9a2e62e97b7b30f",22851744,2,-13,0,935,281,272,-9
"0d987bed3ffa4ed0b9a2e62e97b7b30f","a37477c4e4c14169ad44b06b493007f6",22851744,1,15,0,936,272,283,11
"a37477c4e4c14169ad44b06b493007f6","94cecc3f1e7d484b8e068e79241dfd73",22851744,2,-2,0,937,283,281,-2
"94cecc3f1e7d484b8e068e79241dfd73","94cecc3f1e7d484b8e068e79241dfd73",22851744,3,0,1,938,281,281,0
"0d987bed3ffa4ed0b9a2e62e97b7b30f","94cecc3f1e7d484b8e068e79241dfd73",22851744,2,13,0,942,272,281,9
"94cecc3f1e7d484b8e068e79241dfd73","bb5a47f5ea01454a8b79455422d3b9da",22851744,1,-3,0,943,281,280,-1
"bb5a47f5ea01454a8b79455422d3b9da","0d987bed3ffa4ed0b9a2e62e97b7b30f",22851744,1,-10,0,953,280,272,-8
"94cecc3f1e7d484b8e068e79241dfd73","a37477c4e4c14169ad44b06b493007f6",22851744,1,2,0,955,281,283,2
"94cecc3f1e7d484b8e068e79241dfd73","fab84b4fab5940efb4ea868ef8d09396",22851744,1,5,0,957,281,284,3
"fab84b4fab5940efb4ea868ef8d09396","fab84b4fab5940efb4ea868ef8d09396",22851744,1,0,1,958,284,284,0
"fab84b4fab5940efb4ea868ef8d09396","4a29443515bb404cb8924e1c60a63b73",22851744,1,4,0,959,284,285,1
"4a29443515bb404cb8924e1c60a63b73","208c9b2796c944db8dacaa96082520ea",22851744,3,3,0,960,285,288,3
"208c9b2796c944db8dacaa96082520ea","4a29443515bb404cb8924e1c60a63b73",22851744,4,-3,0,961,288,285,-3
"208c9b2796c944db8dacaa96082520ea","208c9b2796c944db8dacaa96082520ea",22851744,3,0,1,963,288,288,0
"208c9b2796c944db8dacaa96082520ea","6a9a3b5bde4a48daa896fe8c06eca56f",22851744,1,2,0,968,288,289,1
"6a9a3b5bde4a48daa896fe8c06eca56f","208c9b2796c944db8dacaa96082520ea",22851744,2,-2,0,969,289,288,-1
"4a29443515bb404cb8924e1c60a63b73","6a9a3b5bde4a48daa896fe8c06eca56f",22851744,1,5,0,971,285,289,4
"4a29443515bb404cb8924e1c60a63b73","7669a956527947d0add87455277e80b4",22851744,1,7,0,974,285,291,6
"7669a956527947d0add87455277e80b4","7669a956527947d0add87455277e80b4",22851744,1,0,1,975,291,291,0
"7669a956527947d0add87455277e80b4","869e967078f04da18dd0b0b9389a7424",22851744,1,3,0,976,291,293,2
"869e967078f04da18dd0b0b9389a7424","6a9a3b5bde4a48daa896fe8c06eca56f",22851744,1,-5,0,977,293,289,-4
"6a9a3b5bde4a48daa896fe8c06eca56f","869e967078f04da18dd0b0b9389a7424",22851744,1,5,0,978,289,293,4
"869e967078f04da18dd0b0b9389a7424","869e967078f04da18dd0b0b9389a7424",22851744,1,0,1,979,293,293,0
"869e967078f04da18dd0b0b9389a7424","51ab6291537748fab90d519aa09889d6",22851744,1,2,0,980,293,295,2
"51ab6291537748fab90d519aa09889d6","51ab6291537748fab90d519aa09889d6",22851744,5,0,1,981,295,295,0
"51ab6291537748fab90d519aa09889d6","34a6e49023fc4465bd5ca604330bbd1c",22851744,1,-3,0,986,295,292,-3
"34a6e49023fc4465bd5ca604330bbd1c","21592f2a9e9c4b2f8c66ec5dbcbf6a2b",22851744,1,5,0,987,292,296,4
"21592f2a9e9c4b2f8c66ec5dbcbf6a2b","ba0e59461bfb4a44b7b1c28a01f8d3b3",22851744,1,4,0,988,296,299,3
"ba0e59461bfb4a44b7b1c28a01f8d3b3","ba0e59461bfb4a44b7b1c28a01f8d3b3",22851744,2,0,1,989,299,299,0
"ba0e59461bfb4a44b7b1c28a01f8d3b3","0e0b36e731a645e7b1b8a88f5031ca38",22851744,1,2,0,991,299,301,2
"0e0b36e731a645e7b1b8a88f5031ca38","0e0b36e731a645e7b1b8a88f5031ca38",22851744,5,0,1,992,301,301,0
"0e0b36e731a645e7b1b8a88f5031ca38","a66a144637284c21afc6de17fea4bfb8",22851744,1,1,0,997,301,302,1
"a66a144637284c21afc6de17fea4bfb8","a66a144637284c21afc6de17fea4bfb8",22851744,2,0,1,998,302,302,0
"a66a144637284c21afc6de17fea4bfb8","7646a919d7e64fa990bca9b024ff089d",22851744,1,-4,0,1000,302,298,-4
"7646a919d7e64fa990bca9b024ff089d","e390b575229748ea8aac9364efe2bf00",22851744,1,7,0,1001,298,304,6
"e390b575229748ea8aac9364efe2bf00","e390b575229748ea8aac9364efe2bf00",22851744,1,0,1,1002,304,304,0
"e390b575229748ea8aac9364efe2bf00","4a29443515bb404cb8924e1c60a63b73",22851744,1,-24,0,1003,304,285,-19
"4a29443515bb404cb8924e1c60a63b73","3434c10e561d488a914e0f7d71907abd",22851744,1,27,0,1004,285,305,20
"3434c10e561d488a914e0f7d71907abd","53e7e900392747ccad52e711ab0f80d8",22851744,1,2,0,1005,305,307,2
"53e7e900392747ccad52e711ab0f80d8","53e7e900392747ccad52e711ab0f80d8",22851744,3,0,1,1006,307,307,0
"53e7e900392747ccad52e711ab0f80d8","3434c10e561d488a914e0f7d71907abd",22851744,1,-2,0,1009,307,305,-2
"3434c10e561d488a914e0f7d71907abd","130acc2aeb0448fdbb2de63bc5cebe5b",22851744,1,5,0,1010,305,309,4
"130acc2aeb0448fdbb2de63bc5cebe5b","130acc2aeb0448fdbb2de63bc5cebe5b",22851744,2,0,1,1011,309,309,0
"130acc2aeb0448fdbb2de63bc5cebe5b","9c062b3251034ebe90f5054e2a3b5120",22851744,1,2,0,1013,309,311,2
"9c062b3251034ebe90f5054e2a3b5120","9c062b3251034ebe90f5054e2a3b5120",22851744,2,0,1,1014,311,311,0
"9c062b3251034ebe90f5054e2a3b5120","ea859f8207e44537889daeaba13ac2e8",22851744,1,1,0,1016,311,312,1
"ea859f8207e44537889daeaba13ac2e8","ea859f8207e44537889daeaba13ac2e8",22851744,1,0,1,1017,312,312,0
"ea859f8207e44537889daeaba13ac2e8","56d94971a7a94257aa330183a8ebd0ea",22851744,1,1,0,1018,312,313,1
"56d94971a7a94257aa330183a8ebd0ea","56d94971a7a94257aa330183a8ebd0ea",22851744,1,0,1,1019,313,313,0
"56d94971a7a94257aa330183a8ebd0ea","141c0df6cd1946539aadd1c9b7068cd4",22851744,1,-5,0,1020,313,308,-5
"141c0df6cd1946539aadd1c9b7068cd4","13255e63e0aa4abf85e5211bf613d43e",22851744,1,10,0,1021,308,317,9
"13255e63e0aa4abf85e5211bf613d43e","13255e63e0aa4abf85e5211bf613d43e",22851744,2,0,1,1022,317,317,0
"13255e63e0aa4abf85e5211bf613d43e","0c787d16c9504873b1a4d903cec09948",22851744,1,-3,0,1024,317,314,-3
"0c787d16c9504873b1a4d903cec09948","86c27d40179e419c8e9d150fb6afa5d0",22851744,1,6,0,1025,314,319,5
"86c27d40179e419c8e9d150fb6afa5d0","86c27d40179e419c8e9d150fb6afa5d0",22851744,2,0,1,1026,319,319,0
"86c27d40179e419c8e9d150fb6afa5d0","8d7e0b55cf9849cda222a0f2440cec55",22851744,1,-1,0,1028,319,318,-1
"8d7e0b55cf9849cda222a0f2440cec55","24f1363179ad4aaa965484a78471912b",22851744,1,6,0,1029,318,323,5
"24f1363179ad4aaa965484a78471912b","47edbb64109243e6b0f8f64cdef90c6c",22851744,1,3,0,1030,323,326,3
"47edbb64109243e6b0f8f64cdef90c6c","24f1363179ad4aaa965484a78471912b",22851744,1,-3,0,1031,326,323,-3
"24f1363179ad4aaa965484a78471912b","24f1363179ad4aaa965484a78471912b",22851744,1,0,1,1032,323,323,0
"24f1363179ad4aaa965484a78471912b","3628bdce1dd2429ba924d2d4d09448d2",22851744,1,-1,0,1033,323,322,-1
"3628bdce1dd2429ba924d2d4d09448d2","56b3fd1a212a4764be39d979fde3326e",22851744,1,7,0,1034,322,328,6
"56b3fd1a212a4764be39d979fde3326e","56b3fd1a212a4764be39d979fde3326e",22851744,1,0,1,1035,328,328,0
"56b3fd1a212a4764be39d979fde3326e","3434c10e561d488a914e0f7d71907abd",22851744,1,-28,0,1036,328,305,-23
"3434c10e561d488a914e0f7d71907abd","0c4079457ede49e3aeb5e86ed84bdf35",22851744,1,31,0,1037,305,329,24
"0c4079457ede49e3aeb5e86ed84bdf35","38aea304b4fa46e1b29bb72f5cea4c93",22851744,1,2,0,1038,329,331,2
"38aea304b4fa46e1b29bb72f5cea4c93","38aea304b4fa46e1b29bb72f5cea4c93",22851744,3,0,1,1039,331,331,0
"38aea304b4fa46e1b29bb72f5cea4c93","e36d261332f14e79bb4b467aceaeb9b5",22851744,1,2,0,1042,331,333,2
"e36d261332f14e79bb4b467aceaeb9b5","e36d261332f14e79bb4b467aceaeb9b5",22851744,1,0,1,1043,333,333,0
"e36d261332f14e79bb4b467aceaeb9b5","c7e89b9d04744d2eab742fc24e3ef1ae",22851744,1,1,0,1044,333,334,1
"c7e89b9d04744d2eab742fc24e3ef1ae","c7e89b9d04744d2eab742fc24e3ef1ae",22851744,2,0,1,1045,334,334,0
"c7e89b9d04744d2eab742fc24e3ef1ae","fe49f8054b374a0ea4bb266ed135ff62",22851744,1,1,0,1047,334,335,1
"fe49f8054b374a0ea4bb266ed135ff62","fe49f8054b374a0ea4bb266ed135ff62",22851744,2,0,1,1048,335,335,0
"fe49f8054b374a0ea4bb266ed135ff62","d0a8f74af98642fe8360d22c42e45117",22851744,1,1,0,1050,335,336,1
"d0a8f74af98642fe8360d22c42e45117","d0a8f74af98642fe8360d22c42e45117",22851744,2,0,1,1051,336,336,0
"d0a8f74af98642fe8360d22c42e45117","0c4079457ede49e3aeb5e86ed84bdf35",22851744,1,-7,0,1053,336,329,-7
"0c4079457ede49e3aeb5e86ed84bdf35","a7c6339ca1da4368a18d471f0519f877",22851744,1,11,0,1054,329,339,10
"a7c6339ca1da4368a18d471f0519f877","a7c6339ca1da4368a18d471f0519f877",22851744,1,0,1,1055,339,339,0
"a7c6339ca1da4368a18d471f0519f877","b8b9418ab322418d9db9b40d96af873a",22851744,1,-2,0,1056,339,337,-2
"b8b9418ab322418d9db9b40d96af873a","bbc5139ca9024389a94db3a6f47dcff6",22851744,1,5,0,1057,337,341,4
"bbc5139ca9024389a94db3a6f47dcff6","bbc5139ca9024389a94db3a6f47dcff6",22851744,2,0,1,1058,341,341,0
"bbc5139ca9024389a94db3a6f47dcff6","4ee6ca9019ab4a1ab323f98094a9bd77",22851744,1,2,0,1060,341,343,2
"4ee6ca9019ab4a1ab323f98094a9bd77","4ee6ca9019ab4a1ab323f98094a9bd77",22851744,2,0,1,1061,343,343,0
"4ee6ca9019ab4a1ab323f98094a9bd77","b37947176785476f8b29d49a851366dc",22851744,1,1,0,1063,343,344,1
"b37947176785476f8b29d49a851366dc","b37947176785476f8b29d49a851366dc",22851744,2,0,1,1064,344,344,0
"b37947176785476f8b29d49a851366dc","fcea5b10d5a14a3b9324ffece8f6e1e5",22851744,1,1,0,1066,344,345,1
"fcea5b10d5a14a3b9324ffece8f6e1e5","fcea5b10d5a14a3b9324ffece8f6e1e5",22851744,2,0,1,1067,345,345,0
"fcea5b10d5a14a3b9324ffece8f6e1e5","c2490bc612d146edbe786556fab3651b",22851744,1,-5,0,1069,345,340,-5
"c2490bc612d146edbe786556fab3651b","4a92daef4d504e1792575a26502bb7b7",22851744,1,7,0,1070,340,346,6
"4a92daef4d504e1792575a26502bb7b7","38aea304b4fa46e1b29bb72f5cea4c93",22851744,1,-18,0,1071,346,331,-15
"38aea304b4fa46e1b29bb72f5cea4c93","0c4079457ede49e3aeb5e86ed84bdf35",22851744,1,-2,0,1072,331,329,-2
"0c4079457ede49e3aeb5e86ed84bdf35","0c4079457ede49e3aeb5e86ed84bdf35",22851744,1,0,1,1073,329,329,0
"0c4079457ede49e3aeb5e86ed84bdf35","6ac8bb048b854999a47edb35fe627f11",22851744,1,21,0,1074,329,347,18
"6ac8bb048b854999a47edb35fe627f11","6ac8bb048b854999a47edb35fe627f11",22851744,1,0,1,1075,347,347,0
"6ac8bb048b854999a47edb35fe627f11","0c4079457ede49e3aeb5e86ed84bdf35",22851744,1,-21,0,1076,347,329,-18
"0c4079457ede49e3aeb5e86ed84bdf35","30ead9794d4847abaf222ca966cc8630",22851744,1,24,0,1077,329,348,19
"30ead9794d4847abaf222ca966cc8630","09b9678ddc3d452ea4a3d46e15826065",22851744,1,5,0,1078,348,353,5
"09b9678ddc3d452ea4a3d46e15826065","897b7f51242c44aab2205c72fdcbf4cd",22851744,1,-1,0,1079,353,352,-1
"897b7f51242c44aab2205c72fdcbf4cd","eff0de7f2dbb42dfa1a2e686efab5b6d",22851744,1,2,0,1080,352,354,2
"eff0de7f2dbb42dfa1a2e686efab5b6d","c20993c944444fe085345591a8bd837e",22851744,1,-3,0,1081,354,351,-3
"c20993c944444fe085345591a8bd837e","c20993c944444fe085345591a8bd837e",22851744,4,0,1,1082,351,351,0
"c20993c944444fe085345591a8bd837e","897b7f51242c44aab2205c72fdcbf4cd",22851744,1,1,0,1086,351,352,1
"897b7f51242c44aab2205c72fdcbf4cd","897b7f51242c44aab2205c72fdcbf4cd",22851744,3,0,1,1087,352,352,0
"897b7f51242c44aab2205c72fdcbf4cd","09b9678ddc3d452ea4a3d46e15826065",22851744,1,1,0,1090,352,353,1
"09b9678ddc3d452ea4a3d46e15826065","09b9678ddc3d452ea4a3d46e15826065",22851744,3,0,1,1091,353,353,0
"09b9678ddc3d452ea4a3d46e15826065","eff0de7f2dbb42dfa1a2e686efab5b6d",22851744,1,1,0,1094,353,354,1
"eff0de7f2dbb42dfa1a2e686efab5b6d","eff0de7f2dbb42dfa1a2e686efab5b6d",22851744,3,0,1,1095,354,354,0
"eff0de7f2dbb42dfa1a2e686efab5b6d","2fe14166dc9642c3bc666b86a57f943d",22851744,1,4,0,1098,354,357,3
"2fe14166dc9642c3bc666b86a57f943d","30ead9794d4847abaf222ca966cc8630",22851744,1,-10,0,1099,357,348,-9
"30ead9794d4847abaf222ca966cc8630","2fe14166dc9642c3bc666b86a57f943d",22851744,2,10,0,1100,348,357,9
"2fe14166dc9642c3bc666b86a57f943d","2fe14166dc9642c3bc666b86a57f943d",22851744,2,0,1,1101,357,357,0
"2fe14166dc9642c3bc666b86a57f943d","44421dd1e13a47a388c4a19834b744c7",22851744,1,2,0,1103,357,359,2
"44421dd1e13a47a388c4a19834b744c7","44421dd1e13a47a388c4a19834b744c7",22851744,2,0,1,1104,359,359,0
"44421dd1e13a47a388c4a19834b744c7","cb5fc7ef85d547c4be1a7439d0bf6052",22851744,1,1,0,1106,359,360,1
"cb5fc7ef85d547c4be1a7439d0bf6052","cb5fc7ef85d547c4be1a7439d0bf6052",22851744,5,0,1,1107,360,360,0
"cb5fc7ef85d547c4be1a7439d0bf6052","0a8f150a4cf747acbde62f4721823da3",22851744,1,1,0,1112,360,361,1
"0a8f150a4cf747acbde62f4721823da3","0a8f150a4cf747acbde62f4721823da3",22851744,2,0,1,1113,361,361,0
"0a8f150a4cf747acbde62f4721823da3","ab8fdad974ae471f9f24c3f9dd04462e",22851744,1,1,0,1115,361,362,1
"ab8fdad974ae471f9f24c3f9dd04462e","ab8fdad974ae471f9f24c3f9dd04462e",22851744,2,0,1,1116,362,362,0
"ab8fdad974ae471f9f24c3f9dd04462e","1ba8fef685d74a8194b9db252eb704fb",22851744,1,-7,0,1118,362,355,-7
"1ba8fef685d74a8194b9db252eb704fb","52580888dadb4fe3baa795683ea227bd",22851744,2,10,0,1119,355,364,9
"52580888dadb4fe3baa795683ea227bd","52580888dadb4fe3baa795683ea227bd",22851744,4,0,1,1120,364,364,0
"52580888dadb4fe3baa795683ea227bd","492a3bc6a1254f23a7998587961b22a4",22851744,2,3,0,1122,364,366,2
"492a3bc6a1254f23a7998587961b22a4","f00179e251a045b39c3f7a54f9aa4acc",22851744,2,-4,0,1123,366,363,-3
"f00179e251a045b39c3f7a54f9aa4acc","492a3bc6a1254f23a7998587961b22a4",22851744,2,4,0,1124,363,366,3
"492a3bc6a1254f23a7998587961b22a4","492a3bc6a1254f23a7998587961b22a4",22851744,1,0,1,1125,366,366,0
"492a3bc6a1254f23a7998587961b22a4","072a190fd302456290895f9f04d6940a",22851744,2,-1,0,1126,366,365,-1
"072a190fd302456290895f9f04d6940a","30ead9794d4847abaf222ca966cc8630",22851744,1,-20,0,1127,365,348,-17
"2fe14166dc9642c3bc666b86a57f943d","c76574d21bc14aeea7ecd0b027f39858",22851744,1,13,0,1129,357,367,10
"c76574d21bc14aeea7ecd0b027f39858","2fe14166dc9642c3bc666b86a57f943d",22851744,1,-13,0,1130,367,357,-10
"2fe14166dc9642c3bc666b86a57f943d","1ba8fef685d74a8194b9db252eb704fb",22851744,1,-2,0,1131,357,355,-2
"072a190fd302456290895f9f04d6940a","c76574d21bc14aeea7ecd0b027f39858",22851744,1,3,0,1138,365,367,2
"c76574d21bc14aeea7ecd0b027f39858","52580888dadb4fe3baa795683ea227bd",22851744,1,-5,0,1139,367,364,-3
"52580888dadb4fe3baa795683ea227bd","f00179e251a045b39c3f7a54f9aa4acc",22851744,1,-1,0,1141,364,363,-1
"f00179e251a045b39c3f7a54f9aa4acc","cfa457d1743848e4bb5e4beced6448ed",22851744,1,8,0,1142,363,369,6
"cfa457d1743848e4bb5e4beced6448ed","cfa457d1743848e4bb5e4beced6448ed",22851744,1,0,1,1143,369,369,0
"cfa457d1743848e4bb5e4beced6448ed","30ead9794d4847abaf222ca966cc8630",22851744,1,-25,0,1144,369,348,-21
"30ead9794d4847abaf222ca966cc8630","b71bac264efb4abd97015447bd490db6",22851744,1,28,0,1145,348,370,22
"b71bac264efb4abd97015447bd490db6","b71bac264efb4abd97015447bd490db6",22851744,1,0,1,1146,370,370,0
"b71bac264efb4abd97015447bd490db6","8d448d625b024c82a5eb240bbd7431d6",22851744,4,5,0,1147,370,374,4
"8d448d625b024c82a5eb240bbd7431d6","8d448d625b024c82a5eb240bbd7431d6",22851744,71,0,1,1148,374,374,0
"8d448d625b024c82a5eb240bbd7431d6","b71bac264efb4abd97015447bd490db6",22851744,4,-5,0,1153,374,370,-4
"b71bac264efb4abd97015447bd490db6","d6d02b6ef04e4f17805504500b8ce441",22851744,3,8,0,1206,370,375,5
"d6d02b6ef04e4f17805504500b8ce441","d6d02b6ef04e4f17805504500b8ce441",22851744,5,0,1,1207,375,375,0
"d6d02b6ef04e4f17805504500b8ce441","66baf19b6b904b70922329068c63746d",22851744,2,4,0,1209,375,376,1
"66baf19b6b904b70922329068c63746d","66baf19b6b904b70922329068c63746d",22851744,1,0,1,1210,376,376,0
"66baf19b6b904b70922329068c63746d","7f544639412e40a9ba27f43b415362ab",22851744,2,2,0,1211,376,378,2
"7f544639412e40a9ba27f43b415362ab","7f544639412e40a9ba27f43b415362ab",22851744,4,0,1,1212,378,378,0
"7f544639412e40a9ba27f43b415362ab","d5ae8642e15b46b8bd298b02274d4e9c",22851744,1,2,0,1215,378,380,2
"d5ae8642e15b46b8bd298b02274d4e9c","d5ae8642e15b46b8bd298b02274d4e9c",22851744,1,0,1,1216,380,380,0
"d5ae8642e15b46b8bd298b02274d4e9c","a0d10309a2dd456289147f84be9d37f9",22851744,1,1,0,1217,380,381,1
"a0d10309a2dd456289147f84be9d37f9","a0d10309a2dd456289147f84be9d37f9",22851744,2,0,1,1218,381,381,0
"a0d10309a2dd456289147f84be9d37f9","0fcbc3ca07b144138b8d85da581f09a8",22851744,1,1,0,1220,381,382,1
"0fcbc3ca07b144138b8d85da581f09a8","0fcbc3ca07b144138b8d85da581f09a8",22851744,2,0,1,1221,382,382,0
"0fcbc3ca07b144138b8d85da581f09a8","66baf19b6b904b70922329068c63746d",22851744,1,-6,0,1223,382,376,-6
"66baf19b6b904b70922329068c63746d","4890121ce5d74576b4632b77cfc23398",22851744,1,14,0,1224,376,388,12
"4890121ce5d74576b4632b77cfc23398","c2fca3669923477ab966ded303dea31c",22851744,1,-6,0,1225,388,383,-5
"c2fca3669923477ab966ded303dea31c","4890121ce5d74576b4632b77cfc23398",22851744,2,6,0,1226,383,388,5
"4890121ce5d74576b4632b77cfc23398","4890121ce5d74576b4632b77cfc23398",22851744,2,0,1,1227,388,388,0
"4890121ce5d74576b4632b77cfc23398","b71bac264efb4abd97015447bd490db6",22851744,1,-26,0,1228,388,370,-18
"d6d02b6ef04e4f17805504500b8ce441","b71bac264efb4abd97015447bd490db6",22851744,1,-8,0,1242,375,370,-5
"7f544639412e40a9ba27f43b415362ab","66baf19b6b904b70922329068c63746d",22851744,1,-2,0,1258,378,376,-2
"66baf19b6b904b70922329068c63746d","c2fca3669923477ab966ded303dea31c",22851744,1,8,0,1259,376,383,7
"4890121ce5d74576b4632b77cfc23398","18d3b836dd804224883cc9180b60a8e1",22851744,1,-1,0,1262,388,387,-1
"18d3b836dd804224883cc9180b60a8e1","96bb2b3e85a34d8b9544514e89f6fe97",22851744,2,4,0,1263,387,390,3
"96bb2b3e85a34d8b9544514e89f6fe97","96bb2b3e85a34d8b9544514e89f6fe97",22851744,1,0,1,1264,390,390,0
"96bb2b3e85a34d8b9544514e89f6fe97","ac4e9b54acfe4670b4634859c7263cb5",22851744,1,2,0,1265,390,392,2
"ac4e9b54acfe4670b4634859c7263cb5","ac4e9b54acfe4670b4634859c7263cb5",22851744,1,0,1,1266,392,392,0
"ac4e9b54acfe4670b4634859c7263cb5","6f8881a745ac4c358a68b92c3b4abe81",22851744,1,3,0,1267,392,394,2
"6f8881a745ac4c358a68b92c3b4abe81","17f95d18bab743888e1736033dc3384d",22851744,2,-6,0,1268,394,389,-5
"17f95d18bab743888e1736033dc3384d","6f8881a745ac4c358a68b92c3b4abe81",22851744,1,6,0,1269,389,394,5
"6f8881a745ac4c358a68b92c3b4abe81","6f8881a745ac4c358a68b92c3b4abe81",22851744,3,0,1,1270,394,394,0
"6f8881a745ac4c358a68b92c3b4abe81","f7002c8484354eceac57bc7bd62c76c1",22851744,1,-1,0,1273,394,393,-1
"f7002c8484354eceac57bc7bd62c76c1","4890121ce5d74576b4632b77cfc23398",22851744,1,-7,0,1274,393,388,-5
"4890121ce5d74576b4632b77cfc23398","96bb2b3e85a34d8b9544514e89f6fe97",22851744,1,3,0,1275,388,390,2
"96bb2b3e85a34d8b9544514e89f6fe97","18d3b836dd804224883cc9180b60a8e1",22851744,1,-4,0,1276,390,387,-3
"96bb2b3e85a34d8b9544514e89f6fe97","6f8881a745ac4c358a68b92c3b4abe81",22851744,1,5,0,1278,390,394,4
"17f95d18bab743888e1736033dc3384d","f7002c8484354eceac57bc7bd62c76c1",22851744,1,5,0,1280,389,393,4
"f7002c8484354eceac57bc7bd62c76c1","44a277ea44dc4ae689fab4b82f0b4098",22851744,1,5,0,1281,393,397,4
"44a277ea44dc4ae689fab4b82f0b4098","44a277ea44dc4ae689fab4b82f0b4098",22851744,1,0,1,1282,397,397,0
"44a277ea44dc4ae689fab4b82f0b4098","0c12af0a4e7f4002852cf84b2537c161",22851744,1,-2,0,1283,397,395,-2
"0c12af0a4e7f4002852cf84b2537c161","859e0b8d71694b12befb69ee698138f9",22851744,1,5,0,1284,395,399,4
"859e0b8d71694b12befb69ee698138f9","859e0b8d71694b12befb69ee698138f9",22851744,1,0,1,1285,399,399,0
"859e0b8d71694b12befb69ee698138f9","66baf19b6b904b70922329068c63746d",22851744,1,-29,0,1286,399,376,-23
"66baf19b6b904b70922329068c63746d","2b09a08242b54983aec7063990fb3f66",22851744,1,32,0,1287,376,400,24
"2b09a08242b54983aec7063990fb3f66","2b09a08242b54983aec7063990fb3f66",22851744,5,0,1,1288,400,400,0
"2b09a08242b54983aec7063990fb3f66","1f471b7a883a4df48211e8c6a81b59a7",22851744,1,1,0,1293,400,401,1
"1f471b7a883a4df48211e8c6a81b59a7","1f471b7a883a4df48211e8c6a81b59a7",22851744,1,0,1,1294,401,401,0
"1f471b7a883a4df48211e8c6a81b59a7","2b09a08242b54983aec7063990fb3f66",22851744,1,-1,0,1295,401,400,-1
"2b09a08242b54983aec7063990fb3f66","9de0d567bfa84fe5b77cb76f4a76a5d1",22851744,1,5,0,1296,400,404,4
"9de0d567bfa84fe5b77cb76f4a76a5d1","9de0d567bfa84fe5b77cb76f4a76a5d1",22851744,1,0,1,1297,404,404,0
"9de0d567bfa84fe5b77cb76f4a76a5d1","1157bd665ec4472fb58b751dc5099355",22851744,1,-1,0,1298,404,403,-1
"1157bd665ec4472fb58b751dc5099355","58fc9094275e4c49be3f4ba6d4acc0a4",22851744,1,5,0,1299,403,406,3
"58fc9094275e4c49be3f4ba6d4acc0a4","3c8a22d2f9c146ea956609e3ed4f2559",22851744,1,-2,0,1300,406,405,-1
"3c8a22d2f9c146ea956609e3ed4f2559","58fc9094275e4c49be3f4ba6d4acc0a4",22851744,1,2,0,1301,405,406,1
"58fc9094275e4c49be3f4ba6d4acc0a4","58fc9094275e4c49be3f4ba6d4acc0a4",22851744,2,0,1,1302,406,406,0
"58fc9094275e4c49be3f4ba6d4acc0a4","c1c1be90b2b14c1ab4a5e1ee3c241902",22851744,1,1,0,1303,406,407,1
"c1c1be90b2b14c1ab4a5e1ee3c241902","c1c1be90b2b14c1ab4a5e1ee3c241902",22851744,5,0,1,1304,407,407,0
"c1c1be90b2b14c1ab4a5e1ee3c241902","58fc9094275e4c49be3f4ba6d4acc0a4",22851744,1,-1,0,1309,407,406,-1
"58fc9094275e4c49be3f4ba6d4acc0a4","02b3a1bead9244c1ba2f857c7da8f82a",22851744,1,3,0,1310,406,408,2
"02b3a1bead9244c1ba2f857c7da8f82a","02b3a1bead9244c1ba2f857c7da8f82a",22851744,2,0,1,1311,408,408,0
"02b3a1bead9244c1ba2f857c7da8f82a","6206fc6479014bb193084c32409dc1b9",22851744,1,1,0,1313,408,409,1
"6206fc6479014bb193084c32409dc1b9","6206fc6479014bb193084c32409dc1b9",22851744,1,0,1,1314,409,409,0
"6206fc6479014bb193084c32409dc1b9","6a5f020451db426dacba9e2ea3fcc62a",22851744,1,2,0,1315,409,410,1
"6a5f020451db426dacba9e2ea3fcc62a","02b3a1bead9244c1ba2f857c7da8f82a",22851744,3,-3,0,1316,410,408,-2
"02b3a1bead9244c1ba2f857c7da8f82a","6a5f020451db426dacba9e2ea3fcc62a",22851744,2,3,0,1317,408,410,2
"6a5f020451db426dacba9e2ea3fcc62a","6a5f020451db426dacba9e2ea3fcc62a",22851744,3,0,1,1318,410,410,0
"6a5f020451db426dacba9e2ea3fcc62a","33a9d248b2e44588a5b07fc1342b9bc2",22851744,2,2,0,1320,410,411,1
"33a9d248b2e44588a5b07fc1342b9bc2","33a9d248b2e44588a5b07fc1342b9bc2",22851744,3,0,1,1321,411,411,0
"33a9d248b2e44588a5b07fc1342b9bc2","c6f26bd420634f1cb7989e76fe6b16c0",22851744,1,1,0,1324,411,412,1
"c6f26bd420634f1cb7989e76fe6b16c0","c6f26bd420634f1cb7989e76fe6b16c0",22851744,5,0,1,1325,412,412,0
"c6f26bd420634f1cb7989e76fe6b16c0","2a65ee6e2ac64f6a8a55fbe5373ec763",22851744,1,1,0,1330,412,413,1
"2a65ee6e2ac64f6a8a55fbe5373ec763","2a65ee6e2ac64f6a8a55fbe5373ec763",22851744,2,0,1,1331,413,413,0
"2a65ee6e2ac64f6a8a55fbe5373ec763","33a9d248b2e44588a5b07fc1342b9bc2",22851744,1,-2,0,1333,413,411,-2
"33a9d248b2e44588a5b07fc1342b9bc2","1fd0f6dadbc14ebc965faf6122190b96",22851744,1,5,0,1334,411,415,4
"1fd0f6dadbc14ebc965faf6122190b96","2b09a08242b54983aec7063990fb3f66",22851744,1,-22,0,1335,415,400,-15
"2b09a08242b54983aec7063990fb3f66","33a9d248b2e44588a5b07fc1342b9bc2",22851744,1,17,0,1336,400,411,11
"33a9d248b2e44588a5b07fc1342b9bc2","687055dad9fc40c3982478fe33ec01bf",22851744,1,4,0,1337,411,414,3
"687055dad9fc40c3982478fe33ec01bf","33a9d248b2e44588a5b07fc1342b9bc2",22851744,1,-4,0,1338,414,411,-3
"33a9d248b2e44588a5b07fc1342b9bc2","6a5f020451db426dacba9e2ea3fcc62a",22851744,2,-2,0,1339,411,410,-1
"02b3a1bead9244c1ba2f857c7da8f82a","2b09a08242b54983aec7063990fb3f66",22851744,1,-12,0,1346,408,400,-8
"2b09a08242b54983aec7063990fb3f66","58fc9094275e4c49be3f4ba6d4acc0a4",22851744,1,9,0,1347,400,406,6
"58fc9094275e4c49be3f4ba6d4acc0a4","687055dad9fc40c3982478fe33ec01bf",22851744,1,12,0,1348,406,414,8
"687055dad9fc40c3982478fe33ec01bf","58fc9094275e4c49be3f4ba6d4acc0a4",22851744,1,-12,0,1349,414,406,-8
"58fc9094275e4c49be3f4ba6d4acc0a4","1fd0f6dadbc14ebc965faf6122190b96",22851744,1,13,0,1351,406,415,9
"1fd0f6dadbc14ebc965faf6122190b96","1fd0f6dadbc14ebc965faf6122190b96",22851744,1,0,1,1352,415,415,0
"1fd0f6dadbc14ebc965faf6122190b96","687055dad9fc40c3982478fe33ec01bf",22851744,1,-1,0,1353,415,414,-1
"687055dad9fc40c3982478fe33ec01bf","2add1669f08d4101913db15f8c23b3b7",22851744,1,3,0,1354,414,416,2
"2add1669f08d4101913db15f8c23b3b7","2add1669f08d4101913db15f8c23b3b7",22851744,1,0,1,1355,416,416,0
"2add1669f08d4101913db15f8c23b3b7","2b09a08242b54983aec7063990fb3f66",22851744,1,-24,0,1356,416,400,-16
"2b09a08242b54983aec7063990fb3f66","a2b4bd40cee2481ebd3fc179d6a5cd62",22851744,1,27,0,1357,400,417,17
"a2b4bd40cee2481ebd3fc179d6a5cd62","e34e59dce2204f228f3a84b6725df60f",22851744,1,2,0,1358,417,419,2
"e34e59dce2204f228f3a84b6725df60f","e34e59dce2204f228f3a84b6725df60f",22851744,1,0,1,1359,419,419,0
"e34e59dce2204f228f3a84b6725df60f","bec48fc2e1294c7eb3d0aca780d731b8",22851744,1,2,0,1360,419,420,1
"bec48fc2e1294c7eb3d0aca780d731b8","a2b4bd40cee2481ebd3fc179d6a5cd62",22851744,1,-4,0,1361,420,417,-3
"a2b4bd40cee2481ebd3fc179d6a5cd62","bec48fc2e1294c7eb3d0aca780d731b8",22851744,1,4,0,1362,417,420,3
"bec48fc2e1294c7eb3d0aca780d731b8","bec48fc2e1294c7eb3d0aca780d731b8",22851744,2,0,1,1363,420,420,0
"bec48fc2e1294c7eb3d0aca780d731b8","a24600b0e49245f6bdba8c893cfeddb0",22851744,1,7,0,1365,420,425,5
"a24600b0e49245f6bdba8c893cfeddb0","dbde19fcce2a4c1abdc7f685c293a23f",22851744,1,-4,0,1366,425,422,-3
"dbde19fcce2a4c1abdc7f685c293a23f","a24600b0e49245f6bdba8c893cfeddb0",22851744,1,4,0,1367,422,425,3
"a24600b0e49245f6bdba8c893cfeddb0","a24600b0e49245f6bdba8c893cfeddb0",22851744,2,0,1,1368,425,425,0
"a24600b0e49245f6bdba8c893cfeddb0","a2b4bd40cee2481ebd3fc179d6a5cd62",22851744,1,-11,0,1370,425,417,-8
"a2b4bd40cee2481ebd3fc179d6a5cd62","a2b4bd40cee2481ebd3fc179d6a5cd62",22851744,1,0,1,1371,417,417,0
"a2b4bd40cee2481ebd3fc179d6a5cd62","24cf8786024543f19b89bc20034e60d7",22851744,1,18,0,1372,417,428,11
"24cf8786024543f19b89bc20034e60d7","f2a73be2f46840b182d7bd095378004e",22851744,1,1,0,1373,428,429,1
"f2a73be2f46840b182d7bd095378004e","f2a73be2f46840b182d7bd095378004e",22851744,4,0,1,1374,429,429,0
"f2a73be2f46840b182d7bd095378004e","604551fd4266430cb860fef58fa7dd61",22851744,1,1,0,1378,429,430,1
"604551fd4266430cb860fef58fa7dd61","604551fd4266430cb860fef58fa7dd61",22851744,9,0,1,1379,430,430,0
"604551fd4266430cb860fef58fa7dd61","24cf8786024543f19b89bc20034e60d7",22851744,1,-2,0,1388,430,428,-2
"24cf8786024543f19b89bc20034e60d7","dce46f8904594a62a6377a3587aaa663",22851744,1,4,0,1389,428,431,3
"dce46f8904594a62a6377a3587aaa663","dce46f8904594a62a6377a3587aaa663",22851744,2,0,1,1390,431,431,0
"dce46f8904594a62a6377a3587aaa663","9b9d0a249052413c869753b99682b0ac",22851744,1,1,0,1392,431,432,1
"9b9d0a249052413c869753b99682b0ac","9b9d0a249052413c869753b99682b0ac",22851744,3,0,1,1393,432,432,0
"9b9d0a249052413c869753b99682b0ac","061c175cc90f45fbad883025394e78dd",22851744,1,1,0,1396,432,433,1
"061c175cc90f45fbad883025394e78dd","061c175cc90f45fbad883025394e78dd",22851744,1,0,1,1397,433,433,0
"061c175cc90f45fbad883025394e78dd","dce46f8904594a62a6377a3587aaa663",22851744,1,-2,0,1398,433,431,-2
"dce46f8904594a62a6377a3587aaa663","74a7f8712e5449c2bc0b43c6f90dafed",22851744,1,5,0,1399,431,435,4
"74a7f8712e5449c2bc0b43c6f90dafed","74a7f8712e5449c2bc0b43c6f90dafed",22851744,1,0,1,1400,435,435,0
"74a7f8712e5449c2bc0b43c6f90dafed","66ada10dde9f43018588f1ced9d477fc",22851744,1,-1,0,1401,435,434,-1
"66ada10dde9f43018588f1ced9d477fc","bf12c96466d840a69bed7020b3f18bb8",22851744,1,3,0,1402,434,436,2
"bf12c96466d840a69bed7020b3f18bb8","bf12c96466d840a69bed7020b3f18bb8",22851744,1,0,1,1403,436,436,0
"bf12c96466d840a69bed7020b3f18bb8","24cf8786024543f19b89bc20034e60d7",22851744,1,-11,0,1404,436,428,-8
"24cf8786024543f19b89bc20034e60d7","070600601c4c439288445d2f0724807d",22851744,1,14,0,1405,428,437,9
"070600601c4c439288445d2f0724807d","1823b6de7d334a7aaabc4570719af4d9",22851744,1,2,0,1406,437,439,2
"1823b6de7d334a7aaabc4570719af4d9","1823b6de7d334a7aaabc4570719af4d9",22851744,11,0,1,1407,439,439,0
"1823b6de7d334a7aaabc4570719af4d9","070600601c4c439288445d2f0724807d",22851744,1,-2,0,1418,439,437,-2
"070600601c4c439288445d2f0724807d","0380cd76a7d44bc3a4da1f15e4d68f89",22851744,1,4,0,1419,437,440,3
"0380cd76a7d44bc3a4da1f15e4d68f89","0380cd76a7d44bc3a4da1f15e4d68f89",22851744,3,0,1,1420,440,440,0
"0380cd76a7d44bc3a4da1f15e4d68f89","23b7673c8b5443108c2ef09382834a86",22851744,1,2,0,1423,440,441,1
"23b7673c8b5443108c2ef09382834a86","23b7673c8b5443108c2ef09382834a86",22851744,3,0,1,1424,441,441,0
"23b7673c8b5443108c2ef09382834a86","901e92500aea43c79f19f1b279050668",22851744,1,2,0,1427,441,442,1
"901e92500aea43c79f19f1b279050668","901e92500aea43c79f19f1b279050668",22851744,2,0,1,1428,442,442,0
"901e92500aea43c79f19f1b279050668","001339db8ced4cf78829ebe8b145449d",22851744,1,1,0,1430,442,443,1
"001339db8ced4cf78829ebe8b145449d","001339db8ced4cf78829ebe8b145449d",22851744,2,0,1,1431,443,443,0
"001339db8ced4cf78829ebe8b145449d","452745e0366e42ae81561bfddebcc6c3",22851744,1,1,0,1433,443,444,1
"452745e0366e42ae81561bfddebcc6c3","452745e0366e42ae81561bfddebcc6c3",22851744,5,0,1,1434,444,444,0
"452745e0366e42ae81561bfddebcc6c3","4660ff2089114e8db82ceb26a4f329e3",22851744,1,2,0,1439,444,445,1
"4660ff2089114e8db82ceb26a4f329e3","901e92500aea43c79f19f1b279050668",22851744,1,-4,0,1440,445,442,-3
"901e92500aea43c79f19f1b279050668","4660ff2089114e8db82ceb26a4f329e3",22851744,1,4,0,1441,442,445,3
"4660ff2089114e8db82ceb26a4f329e3","4660ff2089114e8db82ceb26a4f329e3",22851744,2,0,1,1442,445,445,0
"4660ff2089114e8db82ceb26a4f329e3","7bd5586eb9d8484eb74a433ee7bfe499",22851744,1,2,0,1444,445,446,1
"7bd5586eb9d8484eb74a433ee7bfe499","7bd5586eb9d8484eb74a433ee7bfe499",22851744,9,0,1,1445,446,446,0
"7bd5586eb9d8484eb74a433ee7bfe499","8a7f26e690f34dda97be16904518ca99",22851744,1,2,0,1454,446,447,1
"8a7f26e690f34dda97be16904518ca99","8a7f26e690f34dda97be16904518ca99",22851744,1,0,1,1455,447,447,0
"8a7f26e690f34dda97be16904518ca99","070600601c4c439288445d2f0724807d",22851744,1,-16,0,1456,447,437,-10
"070600601c4c439288445d2f0724807d","b2f0d654738f48158edff28e8d3a546e",22851744,1,21,0,1457,437,449,12
"b2f0d654738f48158edff28e8d3a546e","f60ee41ec635499abd48168342d32c2f",22851744,3,5,0,1458,449,453,4
"f60ee41ec635499abd48168342d32c2f","f60ee41ec635499abd48168342d32c2f",22851744,62,0,1,1459,453,453,0
"f60ee41ec635499abd48168342d32c2f","b2f0d654738f48158edff28e8d3a546e",22851744,2,-5,0,1460,453,449,-4
"b2f0d654738f48158edff28e8d3a546e","f67fbf45a5f146ed866965bc57c7c001",22851744,1,8,0,1515,449,454,5
"f67fbf45a5f146ed866965bc57c7c001","f67fbf45a5f146ed866965bc57c7c001",22851744,2,0,1,1516,454,454,0
"f67fbf45a5f146ed866965bc57c7c001","d937afe49bd24a07a550dda1c1155122",22851744,1,1,0,1518,454,455,1
"d937afe49bd24a07a550dda1c1155122","d937afe49bd24a07a550dda1c1155122",22851744,1,0,1,1519,455,455,0
"d937afe49bd24a07a550dda1c1155122","3628b3f7823443d0912a339096b69943",22851744,1,1,0,1520,455,456,1
"3628b3f7823443d0912a339096b69943","3628b3f7823443d0912a339096b69943",22851744,1,0,1,1521,456,456,0
"3628b3f7823443d0912a339096b69943","9e049ee647cf43ecbcb5ed792a8e7588",22851744,1,1,0,1522,456,457,1
"9e049ee647cf43ecbcb5ed792a8e7588","9e049ee647cf43ecbcb5ed792a8e7588",22851744,1,0,1,1523,457,457,0
"9e049ee647cf43ecbcb5ed792a8e7588","5256a214faaf410b93f76cea06428334",22851744,1,1,0,1524,457,458,1
"5256a214faaf410b93f76cea06428334","5256a214faaf410b93f76cea06428334",22851744,1,0,1,1525,458,458,0
"5256a214faaf410b93f76cea06428334","25c32b120fce40fa9b6c85133aeb4716",22851744,1,1,0,1526,458,459,1
"25c32b120fce40fa9b6c85133aeb4716","25c32b120fce40fa9b6c85133aeb4716",22851744,1,0,1,1527,459,459,0
"25c32b120fce40fa9b6c85133aeb4716","11bc14f2204949008b7d511b933363c1",22851744,1,1,0,1528,459,460,1
"11bc14f2204949008b7d511b933363c1","11bc14f2204949008b7d511b933363c1",22851744,1,0,1,1529,460,460,0
"11bc14f2204949008b7d511b933363c1","42de338840a34d15adb66e7b14fb9d2c",22851744,1,1,0,1530,460,461,1
"42de338840a34d15adb66e7b14fb9d2c","42de338840a34d15adb66e7b14fb9d2c",22851744,1,0,1,1531,461,461,0
"42de338840a34d15adb66e7b14fb9d2c","9da37c6210b1416b8079c274f70bf600",22851744,1,1,0,1532,461,462,1
"9da37c6210b1416b8079c274f70bf600","9da37c6210b1416b8079c274f70bf600",22851744,1,0,1,1533,462,462,0
"9da37c6210b1416b8079c274f70bf600","519119f1deac45ff9ab4f13529be5c6e",22851744,1,1,0,1534,462,463,1
"519119f1deac45ff9ab4f13529be5c6e","519119f1deac45ff9ab4f13529be5c6e",22851744,1,0,1,1535,463,463,0
"519119f1deac45ff9ab4f13529be5c6e","f67fbf45a5f146ed866965bc57c7c001",22851744,1,-9,0,1536,463,454,-9
"f67fbf45a5f146ed866965bc57c7c001","c5df9f40ec14463b9dcfdc73df3e9285",22851744,1,12,0,1537,454,464,10
"c5df9f40ec14463b9dcfdc73df3e9285","c5df9f40ec14463b9dcfdc73df3e9285",22851744,2,0,1,1538,464,464,0
"c5df9f40ec14463b9dcfdc73df3e9285","83d42d95cd844fc093fc09cee250edb8",22851744,1,3,0,1540,464,465,1
"83d42d95cd844fc093fc09cee250edb8","83d42d95cd844fc093fc09cee250edb8",22851744,5,0,1,1541,465,465,0
"83d42d95cd844fc093fc09cee250edb8","b2f0d654738f48158edff28e8d3a546e",22851744,1,-23,0,1546,465,449,-16
"b613861cecf84ffcab01afb23f660475","b613861cecf84ffcab01afb23f660475",22851777,4,0,1,1,1,1,0
"b613861cecf84ffcab01afb23f660475","e2911e79efc2420eac45d9f671463d4b",22851777,1,3,0,5,1,2,1
"e2911e79efc2420eac45d9f671463d4b","519d1b8c59404d67b54e96c5c8a830b2",22851777,1,1,0,8,2,3,1
"519d1b8c59404d67b54e96c5c8a830b2","519d1b8c59404d67b54e96c5c8a830b2",22851777,1,0,1,9,3,3,0
"519d1b8c59404d67b54e96c5c8a830b2","531db53f81f646edb0cdcfe0085b03b7",22851777,1,1,0,10,3,4,1
"531db53f81f646edb0cdcfe0085b03b7","531db53f81f646edb0cdcfe0085b03b7",22851777,1,0,1,11,4,4,0
"531db53f81f646edb0cdcfe0085b03b7","4f5f94b2f95141e0a9d53a61da2276da",22851777,1,1,0,12,4,5,1
"4f5f94b2f95141e0a9d53a61da2276da","4f5f94b2f95141e0a9d53a61da2276da",22851777,1,0,1,13,5,5,0
"4f5f94b2f95141e0a9d53a61da2276da","6d541c89590949f99af293c4f2333f67",22851777,1,1,0,14,5,6,1
"6d541c89590949f99af293c4f2333f67","6d541c89590949f99af293c4f2333f67",22851777,1,0,1,15,6,6,0
"6d541c89590949f99af293c4f2333f67","dd5cf0b9fe4c4f1d8f5ff8e4c04879cb",22851777,1,1,0,16,6,7,1
"dd5cf0b9fe4c4f1d8f5ff8e4c04879cb","dd5cf0b9fe4c4f1d8f5ff8e4c04879cb",22851777,2,0,1,17,7,7,0
"dd5cf0b9fe4c4f1d8f5ff8e4c04879cb","6d541c89590949f99af293c4f2333f67",22851777,1,-1,0,19,7,6,-1
"6d541c89590949f99af293c4f2333f67","f96261861edc426abe2248be4f0a709a",22851777,1,2,0,20,6,8,2
"f96261861edc426abe2248be4f0a709a","f96261861edc426abe2248be4f0a709a",22851777,2,0,1,21,8,8,0
"f96261861edc426abe2248be4f0a709a","66b5e16f4f75454fb5b8172079f0fa83",22851777,1,1,0,23,8,9,1
"66b5e16f4f75454fb5b8172079f0fa83","66b5e16f4f75454fb5b8172079f0fa83",22851777,2,0,1,24,9,9,0
"66b5e16f4f75454fb5b8172079f0fa83","0680571d4698477995e41842c36a54b2",22851777,1,1,0,26,9,10,1
"0680571d4698477995e41842c36a54b2","0680571d4698477995e41842c36a54b2",22851777,2,0,1,27,10,10,0
"0680571d4698477995e41842c36a54b2","9112f2bffece48e08c6d2287be204085",22851777,1,1,0,29,10,11,1
"9112f2bffece48e08c6d2287be204085","9112f2bffece48e08c6d2287be204085",22851777,2,0,1,30,11,11,0
"9112f2bffece48e08c6d2287be204085","e2911e79efc2420eac45d9f671463d4b",22851777,1,-9,0,32,11,2,-9
"e2911e79efc2420eac45d9f671463d4b","56586aa865414f538729c7f7735d2bc6",22851777,3,12,0,33,2,12,10
"b7f2b31585d94eb3bf86376714aa7070","b7f2b31585d94eb3bf86376714aa7070",22851777,3,0,1,38,13,13,0
"3f1c815879794b929260d224becaff7e","81c864a886d54a6b8ff85f7d736f4f95",22851777,1,2,0,40,14,15,1
"81c864a886d54a6b8ff85f7d736f4f95","3f1c815879794b929260d224becaff7e",22851777,1,-2,0,41,15,14,-1
"3f1c815879794b929260d224becaff7e","b7f2b31585d94eb3bf86376714aa7070",22851777,1,-2,0,42,14,13,-1
"b7f2b31585d94eb3bf86376714aa7070","e2911e79efc2420eac45d9f671463d4b",22851777,3,-14,0,43,13,2,-11
"e2911e79efc2420eac45d9f671463d4b","b7f2b31585d94eb3bf86376714aa7070",22851777,1,14,0,49,2,13,11
"b7f2b31585d94eb3bf86376714aa7070","56586aa865414f538729c7f7735d2bc6",22851777,1,-2,0,50,13,12,-1
"e2911e79efc2420eac45d9f671463d4b","e2911e79efc2420eac45d9f671463d4b",22851777,3,0,1,53,2,2,0
"56586aa865414f538729c7f7735d2bc6","81c864a886d54a6b8ff85f7d736f4f95",22851777,1,6,0,58,12,15,3
"81c864a886d54a6b8ff85f7d736f4f95","5c5ceeee4562457ba6d41515aeebfbb1",22851777,1,4,0,59,15,17,2
"5c5ceeee4562457ba6d41515aeebfbb1","9afd71a5298d4333b6849dfce1b9422c",22851777,1,3,0,60,17,18,1
"9afd71a5298d4333b6849dfce1b9422c","56586aa865414f538729c7f7735d2bc6",22851777,1,-13,0,61,18,12,-6
"56586aa865414f538729c7f7735d2bc6","b7719e26494940efa49512aedd0aac79",22851777,1,17,0,62,12,20,8
"b7719e26494940efa49512aedd0aac79","9afd71a5298d4333b6849dfce1b9422c",22851777,1,-4,0,63,20,18,-2
"9afd71a5298d4333b6849dfce1b9422c","d4f45188d3c84a02ba08454e6403a818",22851777,1,9,0,64,18,24,6
"afbf7250b99d47bea07172749483ca97","b7719e26494940efa49512aedd0aac79",22851777,1,-12,0,68,28,20,-8
"b7719e26494940efa49512aedd0aac79","4e51676dc72045d99c19b9fa7b22f8bc",22851777,1,15,0,69,20,29,9
"4e51676dc72045d99c19b9fa7b22f8bc","afbf7250b99d47bea07172749483ca97",22851777,1,-3,0,70,29,28,-1
"afbf7250b99d47bea07172749483ca97","4e51676dc72045d99c19b9fa7b22f8bc",22851777,1,3,0,71,28,29,1
"4e51676dc72045d99c19b9fa7b22f8bc","51970cfa30e643e894e66ae85c8024cc",22851777,1,3,0,72,29,31,2
"51970cfa30e643e894e66ae85c8024cc","4e51676dc72045d99c19b9fa7b22f8bc",22851777,1,-3,0,73,31,29,-2
"4e51676dc72045d99c19b9fa7b22f8bc","c33c17be71ae4d588da7369472e5bb1b",22851777,3,9,0,74,29,34,5
"c33c17be71ae4d588da7369472e5bb1b","4e51676dc72045d99c19b9fa7b22f8bc",22851777,2,-9,0,75,34,29,-5
"c33c17be71ae4d588da7369472e5bb1b","c33c17be71ae4d588da7369472e5bb1b",22851777,1,0,1,79,34,34,0
"c33c17be71ae4d588da7369472e5bb1b","93679be414554a11b1893002f2229a93",22851777,1,3,0,80,34,35,1
"93679be414554a11b1893002f2229a93","7040a13096d746ac84b8fac8d9752058",22851777,3,3,0,81,35,36,1
"7040a13096d746ac84b8fac8d9752058","93679be414554a11b1893002f2229a93",22851777,2,-3,0,82,36,35,-1
"93679be414554a11b1893002f2229a93","93679be414554a11b1893002f2229a93",22851777,1,0,1,85,35,35,0
"7040a13096d746ac84b8fac8d9752058","9a0dc646f934470daf08c4b56ccf73db",22851777,2,3,0,87,36,37,1
"9a0dc646f934470daf08c4b56ccf73db","7040a13096d746ac84b8fac8d9752058",22851777,1,-3,0,88,37,36,-1
"9a0dc646f934470daf08c4b56ccf73db","fc0e049d56024bc9a02c9a9c435c3df7",22851777,1,3,0,90,37,38,1
"fc0e049d56024bc9a02c9a9c435c3df7","b613861cecf84ffcab01afb23f660475",22851777,1,-68,0,91,38,1,-37
"b7f2b31585d94eb3bf86376714aa7070","3f1c815879794b929260d224becaff7e",22851777,2,2,0,100,13,14,1
"3f1c815879794b929260d224becaff7e","5c5ceeee4562457ba6d41515aeebfbb1",22851777,1,6,0,101,14,17,3
"5c5ceeee4562457ba6d41515aeebfbb1","5c5ceeee4562457ba6d41515aeebfbb1",22851777,1,0,1,102,17,17,0
"5c5ceeee4562457ba6d41515aeebfbb1","56586aa865414f538729c7f7735d2bc6",22851777,1,-10,0,103,17,12,-5
"56586aa865414f538729c7f7735d2bc6","9afd71a5298d4333b6849dfce1b9422c",22851777,1,13,0,104,12,18,6
"9afd71a5298d4333b6849dfce1b9422c","b613861cecf84ffcab01afb23f660475",22851777,1,-28,0,105,18,1,-17
"b613861cecf84ffcab01afb23f660475","56586aa865414f538729c7f7735d2bc6",22851777,2,15,0,106,1,12,11
"56586aa865414f538729c7f7735d2bc6","56586aa865414f538729c7f7735d2bc6",22851777,16,0,1,107,12,12,0
"56586aa865414f538729c7f7735d2bc6","b7f2b31585d94eb3bf86376714aa7070",22851777,6,2,0,111,12,13,1
"b7f2b31585d94eb3bf86376714aa7070","b613861cecf84ffcab01afb23f660475",22851777,1,-17,0,112,13,1,-12
"b613861cecf84ffcab01afb23f660475","a49d1bb4328949299686242fd0be5584",22851777,2,34,0,113,1,21,20
"a49d1bb4328949299686242fd0be5584","b7719e26494940efa49512aedd0aac79",22851777,4,-2,0,114,21,20,-1
"b7719e26494940efa49512aedd0aac79","67a089198fcb4e1c8f2385786c2b296f",22851777,1,40,0,115,20,39,19
"67a089198fcb4e1c8f2385786c2b296f","64d48c6c9c7940639a932219a6c87198",22851777,5,1,0,116,39,40,1
"64d48c6c9c7940639a932219a6c87198","56586aa865414f538729c7f7735d2bc6",22851777,1,-58,0,117,40,12,-28
"b7f2b31585d94eb3bf86376714aa7070","a49d1bb4328949299686242fd0be5584",22851777,1,17,0,119,13,21,8
"b7719e26494940efa49512aedd0aac79","b7719e26494940efa49512aedd0aac79",22851777,4,0,1,121,20,20,0
"b7719e26494940efa49512aedd0aac79","afbf7250b99d47bea07172749483ca97",22851777,2,12,0,122,20,28,8
"afbf7250b99d47bea07172749483ca97","67a089198fcb4e1c8f2385786c2b296f",22851777,1,28,0,123,28,39,11
"67a089198fcb4e1c8f2385786c2b296f","67a089198fcb4e1c8f2385786c2b296f",22851777,2,0,1,124,39,39,0
"64d48c6c9c7940639a932219a6c87198","64d48c6c9c7940639a932219a6c87198",22851777,3,0,1,126,40,40,0
"64d48c6c9c7940639a932219a6c87198","67a089198fcb4e1c8f2385786c2b296f",22851777,3,-1,0,128,40,39,-1
"67a089198fcb4e1c8f2385786c2b296f","b534b89233134e30a9b5645138bfa9ee",22851777,2,4,0,129,39,41,2
"b534b89233134e30a9b5645138bfa9ee","0e37b720d23b4e7f8b313e79313fd107",22851777,1,3,0,130,41,44,3
"0e37b720d23b4e7f8b313e79313fd107","0e37b720d23b4e7f8b313e79313fd107",22851777,5,0,1,131,44,44,0
"0e37b720d23b4e7f8b313e79313fd107","6875d67fdd5f48168b62719df449bebd",22851777,1,1,0,136,44,45,1
"6875d67fdd5f48168b62719df449bebd","6875d67fdd5f48168b62719df449bebd",22851777,4,0,1,137,45,45,0
"6875d67fdd5f48168b62719df449bebd","6e13d61a7bdb44bca949c9f86fab3be5",22851777,1,3,0,141,45,47,2
"6e13d61a7bdb44bca949c9f86fab3be5","b534b89233134e30a9b5645138bfa9ee",22851777,1,-7,0,142,47,41,-6
"b534b89233134e30a9b5645138bfa9ee","6e13d61a7bdb44bca949c9f86fab3be5",22851777,4,7,0,143,41,47,6
"6e13d61a7bdb44bca949c9f86fab3be5","195f78799f984cc2b06c48dfe36be751",22851777,1,2,0,144,47,49,2
"195f78799f984cc2b06c48dfe36be751","195f78799f984cc2b06c48dfe36be751",22851777,8,0,1,145,49,49,0
"195f78799f984cc2b06c48dfe36be751","d9c8d8c444a64dadbbb508652c721e17",22851777,1,-3,0,153,49,46,-3
"d9c8d8c444a64dadbbb508652c721e17","d0c74f735e024943943e40333d6d337f",22851777,2,6,0,154,46,51,5
"d0c74f735e024943943e40333d6d337f","d0c74f735e024943943e40333d6d337f",22851777,1,0,1,155,51,51,0
"d0c74f735e024943943e40333d6d337f","983f8ff320594b279a7f4a6fe132f9c5",22851777,1,2,0,156,51,53,2
"983f8ff320594b279a7f4a6fe132f9c5","983f8ff320594b279a7f4a6fe132f9c5",22851777,2,0,1,157,53,53,0
"983f8ff320594b279a7f4a6fe132f9c5","35adfa5d923046aebabfefd98f35ff05",22851777,1,1,0,159,53,54,1
"35adfa5d923046aebabfefd98f35ff05","35adfa5d923046aebabfefd98f35ff05",22851777,8,0,1,160,54,54,0
"35adfa5d923046aebabfefd98f35ff05","b6f8a98476224da1b40e555ececc7ed8",22851777,1,1,0,168,54,55,1
"b6f8a98476224da1b40e555ececc7ed8","b6f8a98476224da1b40e555ececc7ed8",22851777,2,0,1,169,55,55,0
"b6f8a98476224da1b40e555ececc7ed8","86e22cb5fe0e4b47a9489ecddf7ed78f",22851777,1,1,0,171,55,56,1
"86e22cb5fe0e4b47a9489ecddf7ed78f","86e22cb5fe0e4b47a9489ecddf7ed78f",22851777,2,0,1,172,56,56,0
"86e22cb5fe0e4b47a9489ecddf7ed78f","f924752d8a1149668870b1e7698486f7",22851777,1,-6,0,174,56,50,-6
"f924752d8a1149668870b1e7698486f7","a1f2f12debe5432fb7a70bcd12bacfb9",22851777,1,9,0,175,50,58,8
"a1f2f12debe5432fb7a70bcd12bacfb9","78f30e4dcac84e3cbea8b2cc6e0d62b3",22851777,2,1,0,176,58,59,1
"78f30e4dcac84e3cbea8b2cc6e0d62b3","a1f2f12debe5432fb7a70bcd12bacfb9",22851777,1,-1,0,177,59,58,-1
"a1f2f12debe5432fb7a70bcd12bacfb9","a1f2f12debe5432fb7a70bcd12bacfb9",22851777,32,0,1,178,58,58,0
"78f30e4dcac84e3cbea8b2cc6e0d62b3","78f30e4dcac84e3cbea8b2cc6e0d62b3",22851777,13,0,1,211,59,59,0
"78f30e4dcac84e3cbea8b2cc6e0d62b3","bc42d26810654ea9a1df1efe1e58c7d5",22851777,1,5,0,224,59,63,4
"bc42d26810654ea9a1df1efe1e58c7d5","a0a418b8540d479fa6e0f653b701da8b",22851777,2,1,0,225,63,64,1
"a0a418b8540d479fa6e0f653b701da8b","12aa6e1672ac4e7aa6449a7a8609cd72",22851777,1,-8,0,226,64,57,-7
"12aa6e1672ac4e7aa6449a7a8609cd72","4c943503763e4e349906eea3ed3c8e86",22851777,1,5,0,227,57,61,4
"4c943503763e4e349906eea3ed3c8e86","4c943503763e4e349906eea3ed3c8e86",22851777,1,0,1,228,61,61,0
"4c943503763e4e349906eea3ed3c8e86","bc42d26810654ea9a1df1efe1e58c7d5",22851777,1,2,0,229,61,63,2
"bc42d26810654ea9a1df1efe1e58c7d5","bc42d26810654ea9a1df1efe1e58c7d5",22851777,3,0,1,230,63,63,0
"a0a418b8540d479fa6e0f653b701da8b","a0a418b8540d479fa6e0f653b701da8b",22851777,3,0,1,234,64,64,0
"a0a418b8540d479fa6e0f653b701da8b","309ccf3cc4fe429d9bfbaef53d3fa479",22851777,1,-4,0,237,64,60,-4
"309ccf3cc4fe429d9bfbaef53d3fa479","b534b89233134e30a9b5645138bfa9ee",22851777,1,-23,0,238,60,41,-19
"b534b89233134e30a9b5645138bfa9ee","d646286c8051419bbc2e31dd1db55ca8",22851777,1,33,0,239,41,67,26
"d646286c8051419bbc2e31dd1db55ca8","67a089198fcb4e1c8f2385786c2b296f",22851777,1,-37,0,240,67,39,-28
"64d48c6c9c7940639a932219a6c87198","d9c8d8c444a64dadbbb508652c721e17",22851777,1,9,0,243,40,46,6
"d9c8d8c444a64dadbbb508652c721e17","b534b89233134e30a9b5645138bfa9ee",22851777,3,-6,0,244,46,41,-5
"6e13d61a7bdb44bca949c9f86fab3be5","6e13d61a7bdb44bca949c9f86fab3be5",22851777,2,0,1,246,47,47,0
"6e13d61a7bdb44bca949c9f86fab3be5","67a089198fcb4e1c8f2385786c2b296f",22851777,2,-11,0,247,47,39,-8
"67a089198fcb4e1c8f2385786c2b296f","d9c8d8c444a64dadbbb508652c721e17",22851777,1,10,0,248,39,46,7
"67a089198fcb4e1c8f2385786c2b296f","d646286c8051419bbc2e31dd1db55ca8",22851777,1,37,0,252,39,67,28
"d646286c8051419bbc2e31dd1db55ca8","d646286c8051419bbc2e31dd1db55ca8",22851777,1,0,1,253,67,67,0
"d646286c8051419bbc2e31dd1db55ca8","267f883678b24aed855fde42524975d9",22851777,1,4,0,254,67,71,4
"267f883678b24aed855fde42524975d9","267f883678b24aed855fde42524975d9",22851777,2,0,1,255,71,71,0
"267f883678b24aed855fde42524975d9","88fff56d0342490dbef9040750a20f6c",22851777,1,1,0,256,71,72,1
"88fff56d0342490dbef9040750a20f6c","88fff56d0342490dbef9040750a20f6c",22851777,1,0,1,257,72,72,0
"88fff56d0342490dbef9040750a20f6c","267f883678b24aed855fde42524975d9",22851777,1,-1,0,258,72,71,-1
"267f883678b24aed855fde42524975d9","adb17b12b66c4a49a85fd34322f7df70",22851777,1,2,0,260,71,73,2
"adb17b12b66c4a49a85fd34322f7df70","adb17b12b66c4a49a85fd34322f7df70",22851777,1,0,1,261,73,73,0
"adb17b12b66c4a49a85fd34322f7df70","d646286c8051419bbc2e31dd1db55ca8",22851777,1,-6,0,262,73,67,-6
"d646286c8051419bbc2e31dd1db55ca8","a2becd407db34b189200a32546d9d569",22851777,2,9,0,263,67,75,8
"a2becd407db34b189200a32546d9d569","67a089198fcb4e1c8f2385786c2b296f",22851777,1,-46,0,264,75,39,-36
"b534b89233134e30a9b5645138bfa9ee","d9c8d8c444a64dadbbb508652c721e17",22851777,1,6,0,268,41,46,5
"d9c8d8c444a64dadbbb508652c721e17","6e13d61a7bdb44bca949c9f86fab3be5",22851777,1,1,0,269,46,47,1
"6e13d61a7bdb44bca949c9f86fab3be5","d9c8d8c444a64dadbbb508652c721e17",22851777,2,-1,0,270,47,46,-1
"d0c74f735e024943943e40333d6d337f","140d5b27b8574befad82c0a013b59dfa",22851777,1,29,0,276,51,74,23
"140d5b27b8574befad82c0a013b59dfa","d646286c8051419bbc2e31dd1db55ca8",22851777,1,-8,0,277,74,67,-7
"a2becd407db34b189200a32546d9d569","a2becd407db34b189200a32546d9d569",22851777,1,0,1,279,75,75,0
"a2becd407db34b189200a32546d9d569","58c22b011d0f4c2ea6d13615edbb9eeb",22851777,1,2,0,280,75,77,2
"58c22b011d0f4c2ea6d13615edbb9eeb","58c22b011d0f4c2ea6d13615edbb9eeb",22851777,2,0,1,281,77,77,0
"58c22b011d0f4c2ea6d13615edbb9eeb","dd76e1861dc9461c830888729d091ee0",22851777,1,1,0,283,77,78,1
"dd76e1861dc9461c830888729d091ee0","dd76e1861dc9461c830888729d091ee0",22851777,5,0,1,284,78,78,0
"dd76e1861dc9461c830888729d091ee0","cd1d828f1a694b87913a7ea66c23803e",22851777,1,1,0,289,78,79,1
"cd1d828f1a694b87913a7ea66c23803e","cd1d828f1a694b87913a7ea66c23803e",22851777,8,0,1,290,79,79,0
"cd1d828f1a694b87913a7ea66c23803e","9176a3c2b4d2465fa8b0c67096c2a97e",22851777,1,1,0,298,79,80,1
"9176a3c2b4d2465fa8b0c67096c2a97e","9176a3c2b4d2465fa8b0c67096c2a97e",22851777,5,0,1,299,80,80,0
"9176a3c2b4d2465fa8b0c67096c2a97e","f8ec6445f7194e25b9101d4fbcb07a18",22851777,1,1,0,304,80,81,1
"f8ec6445f7194e25b9101d4fbcb07a18","f8ec6445f7194e25b9101d4fbcb07a18",22851777,2,0,1,305,81,81,0
"f8ec6445f7194e25b9101d4fbcb07a18","140d5b27b8574befad82c0a013b59dfa",22851777,1,-7,0,307,81,74,-7
"140d5b27b8574befad82c0a013b59dfa","a49d1bb4328949299686242fd0be5584",22851777,1,-83,0,308,74,21,-53
"b7719e26494940efa49512aedd0aac79","a49d1bb4328949299686242fd0be5584",22851777,2,2,0,310,20,21,1
"a49d1bb4328949299686242fd0be5584","d4f45188d3c84a02ba08454e6403a818",22851777,2,3,0,311,21,24,3
"d4f45188d3c84a02ba08454e6403a818","d4c3b003e8274e429d2fa688d73fde6d",22851777,3,-2,0,312,24,22,-2
"d4c3b003e8274e429d2fa688d73fde6d","d4c3b003e8274e429d2fa688d73fde6d",22851777,1,0,1,313,22,22,0
"d4c3b003e8274e429d2fa688d73fde6d","b7719e26494940efa49512aedd0aac79",22851777,4,-3,0,314,22,20,-2
"b7719e26494940efa49512aedd0aac79","b613861cecf84ffcab01afb23f660475",22851777,1,-32,0,315,20,1,-19
"b7719e26494940efa49512aedd0aac79","5bc03c8f16354d04bd51f5bb93559ad3",22851777,1,7,0,325,20,26,6
"5bc03c8f16354d04bd51f5bb93559ad3","d4c3b003e8274e429d2fa688d73fde6d",22851777,1,-4,0,326,26,22,-4
"b7719e26494940efa49512aedd0aac79","ae5ac430ea254e708a6f5deaaf7464ae",22851777,1,97,0,328,20,84,64
"ae5ac430ea254e708a6f5deaaf7464ae","d646286c8051419bbc2e31dd1db55ca8",22851777,1,-20,0,329,84,67,-17
"d646286c8051419bbc2e31dd1db55ca8","f564483cbd7a407681aa2fcca518cf5f",22851777,1,21,0,330,67,85,18
"f564483cbd7a407681aa2fcca518cf5f","f564483cbd7a407681aa2fcca518cf5f",22851777,1,0,1,331,85,85,0
"f564483cbd7a407681aa2fcca518cf5f","18fd01350bd5434ca636d59a599d768a",22851777,1,1,0,332,85,86,1
"18fd01350bd5434ca636d59a599d768a","18fd01350bd5434ca636d59a599d768a",22851777,8,0,1,333,86,86,0
"18fd01350bd5434ca636d59a599d768a","ae5ac430ea254e708a6f5deaaf7464ae",22851777,1,-2,0,341,86,84,-2
"ae5ac430ea254e708a6f5deaaf7464ae","6a9f0ef185fb47f0937e29daa1c71ed5",22851777,1,7,0,342,84,90,6
"6a9f0ef185fb47f0937e29daa1c71ed5","c681290961c94c4caf23b529d1ae6b9a",22851777,1,-2,0,343,90,88,-2
"c681290961c94c4caf23b529d1ae6b9a","c681290961c94c4caf23b529d1ae6b9a",22851777,1,0,1,344,88,88,0
"c681290961c94c4caf23b529d1ae6b9a","6a9f0ef185fb47f0937e29daa1c71ed5",22851777,1,2,0,345,88,90,2
"6a9f0ef185fb47f0937e29daa1c71ed5","6a9f0ef185fb47f0937e29daa1c71ed5",22851777,3,0,1,346,90,90,0
"6a9f0ef185fb47f0937e29daa1c71ed5","e20db35ced8544ddac5bc3839145e463",22851777,1,3,0,349,90,91,1
"e20db35ced8544ddac5bc3839145e463","d646286c8051419bbc2e31dd1db55ca8",22851777,1,-30,0,350,91,67,-24
"d646286c8051419bbc2e31dd1db55ca8","1febb706d7a34005ae8711ed49c76e64",22851777,1,33,0,351,67,94,27
"1febb706d7a34005ae8711ed49c76e64","1febb706d7a34005ae8711ed49c76e64",22851777,2,0,1,352,94,94,0
"1febb706d7a34005ae8711ed49c76e64","8f73ba6f5a0042f2850356ac38ac6f24",22851777,1,1,0,354,94,95,1
"8f73ba6f5a0042f2850356ac38ac6f24","8f73ba6f5a0042f2850356ac38ac6f24",22851777,5,0,1,355,95,95,0
"8f73ba6f5a0042f2850356ac38ac6f24","e2260b86653c46d7b14a41fb419dbf8c",22851777,1,1,0,360,95,96,1
"e2260b86653c46d7b14a41fb419dbf8c","e2260b86653c46d7b14a41fb419dbf8c",22851777,2,0,1,361,96,96,0
"e2260b86653c46d7b14a41fb419dbf8c","35eb641ad1d845bbba54915bce75a962",22851777,1,1,0,363,96,97,1
"35eb641ad1d845bbba54915bce75a962","35eb641ad1d845bbba54915bce75a962",22851777,5,0,1,364,97,97,0
"35eb641ad1d845bbba54915bce75a962","08be90ffbeea4795a138cd42ed8db56f",22851777,1,1,0,369,97,98,1
"08be90ffbeea4795a138cd42ed8db56f","08be90ffbeea4795a138cd42ed8db56f",22851777,2,0,1,370,98,98,0
"08be90ffbeea4795a138cd42ed8db56f","3007433c8f584dcbb5ac159c1c5f2be3",22851777,1,1,0,372,98,99,1
"3007433c8f584dcbb5ac159c1c5f2be3","3007433c8f584dcbb5ac159c1c5f2be3",22851777,5,0,1,373,99,99,0
"3007433c8f584dcbb5ac159c1c5f2be3","e20db35ced8544ddac5bc3839145e463",22851777,1,-8,0,378,99,91,-8
"e20db35ced8544ddac5bc3839145e463","00ae5f0c51874a73a41ebea838d95682",22851777,1,11,0,379,91,101,10
"00ae5f0c51874a73a41ebea838d95682","d391c8b6e56a43a7b654e9dee02d904b",22851777,2,2,0,380,101,103,2
"d391c8b6e56a43a7b654e9dee02d904b","00ae5f0c51874a73a41ebea838d95682",22851777,1,-2,0,381,103,101,-2
"d391c8b6e56a43a7b654e9dee02d904b","d391c8b6e56a43a7b654e9dee02d904b",22851777,18,0,1,383,103,103,0
"d391c8b6e56a43a7b654e9dee02d904b","6111116566fc4fd9abba409322bea245",22851777,1,1,0,401,103,104,1
"6111116566fc4fd9abba409322bea245","6111116566fc4fd9abba409322bea245",22851777,2,0,1,402,104,104,0
"6111116566fc4fd9abba409322bea245","a81b2235cb9c499eb9ea8ee0a8dd9725",22851777,1,1,0,404,104,105,1
"a81b2235cb9c499eb9ea8ee0a8dd9725","a81b2235cb9c499eb9ea8ee0a8dd9725",22851777,5,0,1,405,105,105,0
"a81b2235cb9c499eb9ea8ee0a8dd9725","2d4e0ab0ef3b4d73b82c72d4621a7579",22851777,1,1,0,410,105,106,1
"2d4e0ab0ef3b4d73b82c72d4621a7579","2d4e0ab0ef3b4d73b82c72d4621a7579",22851777,2,0,1,411,106,106,0
"2d4e0ab0ef3b4d73b82c72d4621a7579","8bdebf492ebd4e62b0d522e8ab5e5197",22851777,1,1,0,413,106,107,1
"8bdebf492ebd4e62b0d522e8ab5e5197","8bdebf492ebd4e62b0d522e8ab5e5197",22851777,2,0,1,414,107,107,0
"8bdebf492ebd4e62b0d522e8ab5e5197","73039f8c1eb9409cb4caee2cf968001e",22851777,1,-7,0,416,107,100,-7
"73039f8c1eb9409cb4caee2cf968001e","4280927ec4d643238aa49c32f9e06c6c",22851777,1,10,0,417,100,109,9
"4280927ec4d643238aa49c32f9e06c6c","a9ac840f098c4bd0a2ee896214ce29cd",22851777,1,78,0,418,109,168,59
"a9ac840f098c4bd0a2ee896214ce29cd","a9ac840f098c4bd0a2ee896214ce29cd",22851777,2,0,1,419,168,168,0
"a9ac840f098c4bd0a2ee896214ce29cd","0c7262dff33c4087bc660ccf40f92f9c",22851777,1,4,0,421,168,169,1
"0c7262dff33c4087bc660ccf40f92f9c","b2275c3fad834f8d90737a2d9a6927d6",22851777,2,3,0,422,169,172,3
"b2275c3fad834f8d90737a2d9a6927d6","3cbcea2be0984e7dbd5a48195af10ce7",22851777,1,-12,0,423,172,165,-7
"3cbcea2be0984e7dbd5a48195af10ce7","3cbcea2be0984e7dbd5a48195af10ce7",22851777,1,0,1,424,165,165,0
"3cbcea2be0984e7dbd5a48195af10ce7","82e6285962b8400d9d6fc32436022a94",22851777,3,2,0,425,165,167,2
"82e6285962b8400d9d6fc32436022a94","a9ac840f098c4bd0a2ee896214ce29cd",22851777,1,3,0,426,167,168,1
"a9ac840f098c4bd0a2ee896214ce29cd","3cbcea2be0984e7dbd5a48195af10ce7",22851777,2,-5,0,427,168,165,-3
"3cbcea2be0984e7dbd5a48195af10ce7","a9ac840f098c4bd0a2ee896214ce29cd",22851777,1,5,0,428,165,168,3
"82e6285962b8400d9d6fc32436022a94","78adeee1fa2c4fe0bc73f7bca9fcee86",22851777,1,-10,0,431,167,160,-7
"78adeee1fa2c4fe0bc73f7bca9fcee86","3cbcea2be0984e7dbd5a48195af10ce7",22851777,3,8,0,432,160,165,5
"3cbcea2be0984e7dbd5a48195af10ce7","65202579580f4ad38d734b4ee39d22a8",22851777,2,-3,0,433,165,164,-1
"78adeee1fa2c4fe0bc73f7bca9fcee86","df1de691dafe4549a18a4398ee9dfaf9",22851777,1,-26,0,443,160,139,-21
"df1de691dafe4549a18a4398ee9dfaf9","d313cec988a84645bee413e8d4724a4b",22851777,1,22,0,444,139,158,19
"d313cec988a84645bee413e8d4724a4b","08111f75e22d409998cf8b85bd431f0a",22851777,1,-62,0,445,158,108,-50
"08111f75e22d409998cf8b85bd431f0a","e20db35ced8544ddac5bc3839145e463",22851777,2,-19,0,446,108,91,-17
"e20db35ced8544ddac5bc3839145e463","4280927ec4d643238aa49c32f9e06c6c",22851777,2,20,0,447,91,109,18
"4280927ec4d643238aa49c32f9e06c6c","4280927ec4d643238aa49c32f9e06c6c",22851777,4,0,1,448,109,109,0
"4280927ec4d643238aa49c32f9e06c6c","fc44e6a5f7654430af1227838224dceb",22851777,1,2,0,451,109,111,2
"fc44e6a5f7654430af1227838224dceb","fc44e6a5f7654430af1227838224dceb",22851777,5,0,1,452,111,111,0
"fc44e6a5f7654430af1227838224dceb","08111f75e22d409998cf8b85bd431f0a",22851777,1,-3,0,457,111,108,-3
"08111f75e22d409998cf8b85bd431f0a","71cec822bcff4f30a20e75dc63ef7b65",22851777,1,9,0,458,108,116,8
"71cec822bcff4f30a20e75dc63ef7b65","71cec822bcff4f30a20e75dc63ef7b65",22851777,1,0,1,459,116,116,0
"71cec822bcff4f30a20e75dc63ef7b65","37319e88176d4aefa91d7a9980dbae91",22851777,1,-4,0,460,116,112,-4
"37319e88176d4aefa91d7a9980dbae91","62bff51286ef4f348717a3cf6fe2318f",22851777,4,9,0,461,112,120,8
"62bff51286ef4f348717a3cf6fe2318f","62bff51286ef4f348717a3cf6fe2318f",22851777,10,0,1,462,120,120,0
"62bff51286ef4f348717a3cf6fe2318f","b1cd0e7dc3ad4a8eb91a4bfdbeb025b0",22851777,1,-2,0,466,120,118,-2
"b1cd0e7dc3ad4a8eb91a4bfdbeb025b0","b1cd0e7dc3ad4a8eb91a4bfdbeb025b0",22851777,1,0,1,467,118,118,0
"b1cd0e7dc3ad4a8eb91a4bfdbeb025b0","e20db35ced8544ddac5bc3839145e463",22851777,1,-31,0,468,118,91,-27
"e20db35ced8544ddac5bc3839145e463","e20db35ced8544ddac5bc3839145e463",22851777,2,0,1,469,91,91,0
"e20db35ced8544ddac5bc3839145e463","3ec3a3563847406fa73338f9e9999cf3",22851777,1,30,0,470,91,117,26
"3ec3a3563847406fa73338f9e9999cf3","37319e88176d4aefa91d7a9980dbae91",22851777,1,-6,0,471,117,112,-5
"37319e88176d4aefa91d7a9980dbae91","e20db35ced8544ddac5bc3839145e463",22851777,2,-24,0,472,112,91,-21
"e20db35ced8544ddac5bc3839145e463","37319e88176d4aefa91d7a9980dbae91",22851777,2,24,0,474,91,112,21
"62bff51286ef4f348717a3cf6fe2318f","e20db35ced8544ddac5bc3839145e463",22851777,1,-33,0,480,120,91,-29
"e20db35ced8544ddac5bc3839145e463","779f9ddd1fd14d1e9e69f72219a1fdbd",22851777,1,36,0,481,91,121,30
"779f9ddd1fd14d1e9e69f72219a1fdbd","ae26e6cda8ad4a3f81bd347560d9579f",22851777,1,4,0,482,121,125,4
"ae26e6cda8ad4a3f81bd347560d9579f","ae26e6cda8ad4a3f81bd347560d9579f",22851777,3,0,1,483,125,125,0
"ae26e6cda8ad4a3f81bd347560d9579f","ee48df95832b4374aa273ceb27ec1315",22851777,1,1,0,486,125,126,1
"ee48df95832b4374aa273ceb27ec1315","ee48df95832b4374aa273ceb27ec1315",22851777,1,0,1,487,126,126,0
"ee48df95832b4374aa273ceb27ec1315","7a439da90b394756ad1777fc4c6dead5",22851777,1,1,0,488,126,127,1
"7a439da90b394756ad1777fc4c6dead5","7a439da90b394756ad1777fc4c6dead5",22851777,1,0,1,489,127,127,0
"7a439da90b394756ad1777fc4c6dead5","779f9ddd1fd14d1e9e69f72219a1fdbd",22851777,1,-6,0,490,127,121,-6
"779f9ddd1fd14d1e9e69f72219a1fdbd","a8dd5213034441ac92724b4e83eb0bb2",22851777,1,9,0,491,121,129,8
"a8dd5213034441ac92724b4e83eb0bb2","a8dd5213034441ac92724b4e83eb0bb2",22851777,1,0,1,492,129,129,0
"a8dd5213034441ac92724b4e83eb0bb2","8115eab6556b45f5b415c3b8c26a12e5",22851777,1,2,0,493,129,131,2
"8115eab6556b45f5b415c3b8c26a12e5","8115eab6556b45f5b415c3b8c26a12e5",22851777,2,0,1,494,131,131,0
"8115eab6556b45f5b415c3b8c26a12e5","ec34b06efd844b46a4c4818ecdb9b8f4",22851777,1,1,0,496,131,132,1
"ec34b06efd844b46a4c4818ecdb9b8f4","ec34b06efd844b46a4c4818ecdb9b8f4",22851777,2,0,1,497,132,132,0
"ec34b06efd844b46a4c4818ecdb9b8f4","c2e1c2b9eac64109b343a088584b576b",22851777,1,1,0,499,132,133,1
"c2e1c2b9eac64109b343a088584b576b","c2e1c2b9eac64109b343a088584b576b",22851777,2,0,1,500,133,133,0
"c2e1c2b9eac64109b343a088584b576b","579338175e0b4bbb8ef3b712b5d8b54e",22851777,1,-5,0,502,133,128,-5
"579338175e0b4bbb8ef3b712b5d8b54e","8bc5795d6a984a3eace4e2811e52dd4f",22851777,1,8,0,503,128,135,7
"8bc5795d6a984a3eace4e2811e52dd4f","8bc5795d6a984a3eace4e2811e52dd4f",22851777,3,0,1,504,135,135,0
"8bc5795d6a984a3eace4e2811e52dd4f","b416d47c56a742199b5d7c7f19d6503a",22851777,1,-1,0,507,135,134,-1
"b416d47c56a742199b5d7c7f19d6503a","cd4532ad48034873ba8bce2aac0c9808",22851777,1,4,0,508,134,137,3
"cd4532ad48034873ba8bce2aac0c9808","cd4532ad48034873ba8bce2aac0c9808",22851777,1,0,1,509,137,137,0
"cd4532ad48034873ba8bce2aac0c9808","779f9ddd1fd14d1e9e69f72219a1fdbd",22851777,1,-19,0,510,137,121,-16
"779f9ddd1fd14d1e9e69f72219a1fdbd","df1de691dafe4549a18a4398ee9dfaf9",22851777,1,23,0,511,121,139,18
"df1de691dafe4549a18a4398ee9dfaf9","67a089198fcb4e1c8f2385786c2b296f",22851777,1,-126,0,512,139,39,-100
"67a089198fcb4e1c8f2385786c2b296f","df1de691dafe4549a18a4398ee9dfaf9",22851777,3,126,0,514,39,139,100
"df1de691dafe4549a18a4398ee9dfaf9","df1de691dafe4549a18a4398ee9dfaf9",22851777,3,0,1,515,139,139,0
"df1de691dafe4549a18a4398ee9dfaf9","8aae34f5ddbb4052a709b12e6b0d40fa",22851777,4,9,0,516,139,147,8
"8aae34f5ddbb4052a709b12e6b0d40fa","8aae34f5ddbb4052a709b12e6b0d40fa",22851777,6,0,1,517,147,147,0
"8aae34f5ddbb4052a709b12e6b0d40fa","645b3f0249f64f76af2e19eb4d0e55b7",22851777,1,2,0,520,147,149,2
"645b3f0249f64f76af2e19eb4d0e55b7","645b3f0249f64f76af2e19eb4d0e55b7",22851777,5,0,1,521,149,149,0
"645b3f0249f64f76af2e19eb4d0e55b7","7e7b8db5064d4369805ab370aac5ddfb",22851777,1,1,0,526,149,150,1
"7e7b8db5064d4369805ab370aac5ddfb","7e7b8db5064d4369805ab370aac5ddfb",22851777,2,0,1,527,150,150,0
"7e7b8db5064d4369805ab370aac5ddfb","8956d210ae7f41968fada86d4c979d6a",22851777,1,1,0,529,150,151,1
"8956d210ae7f41968fada86d4c979d6a","8956d210ae7f41968fada86d4c979d6a",22851777,2,0,1,530,151,151,0
"8956d210ae7f41968fada86d4c979d6a","8aae34f5ddbb4052a709b12e6b0d40fa",22851777,1,-4,0,532,151,147,-4
"8aae34f5ddbb4052a709b12e6b0d40fa","f902b0f41b544d4dbf79664fd233648d",22851777,4,-1,0,533,147,146,-1
"f902b0f41b544d4dbf79664fd233648d","ae781e8b775e4ccd93bc800dad5c8376",22851777,1,8,0,534,146,153,7
"ae781e8b775e4ccd93bc800dad5c8376","ae781e8b775e4ccd93bc800dad5c8376",22851777,2,0,1,535,153,153,0
"ae781e8b775e4ccd93bc800dad5c8376","06882a8492d9499aa31555567f575ecb",22851777,1,1,0,537,153,154,1
"06882a8492d9499aa31555567f575ecb","06882a8492d9499aa31555567f575ecb",22851777,1,0,1,538,154,154,0
"06882a8492d9499aa31555567f575ecb","f293c508f409466a8f27ddd7d1e40b20",22851777,1,1,0,539,154,155,1
"f293c508f409466a8f27ddd7d1e40b20","f293c508f409466a8f27ddd7d1e40b20",22851777,2,0,1,540,155,155,0
"f293c508f409466a8f27ddd7d1e40b20","cc4ddef5bbbe48ebb605141b347c4ed1",22851777,1,1,0,542,155,156,1
"cc4ddef5bbbe48ebb605141b347c4ed1","cc4ddef5bbbe48ebb605141b347c4ed1",22851777,3,0,1,543,156,156,0
"cc4ddef5bbbe48ebb605141b347c4ed1","d313cec988a84645bee413e8d4724a4b",22851777,1,3,0,546,156,158,2
"d313cec988a84645bee413e8d4724a4b","f03480cf4eba413194d7af52fc0e7f28",22851777,1,-7,0,547,158,152,-6
"f03480cf4eba413194d7af52fc0e7f28","d313cec988a84645bee413e8d4724a4b",22851777,1,7,0,548,152,158,6
"d313cec988a84645bee413e8d4724a4b","d313cec988a84645bee413e8d4724a4b",22851777,3,0,1,549,158,158,0
"d313cec988a84645bee413e8d4724a4b","dc60696c76a74368a60f72246e47700d",22851777,1,1,0,552,158,159,1
"dc60696c76a74368a60f72246e47700d","dc60696c76a74368a60f72246e47700d",22851777,1,0,1,553,159,159,0
"dc60696c76a74368a60f72246e47700d","df1de691dafe4549a18a4398ee9dfaf9",22851777,1,-23,0,554,159,139,-20
"df1de691dafe4549a18a4398ee9dfaf9","78adeee1fa2c4fe0bc73f7bca9fcee86",22851777,1,26,0,555,139,160,21
"65202579580f4ad38d734b4ee39d22a8","3cbcea2be0984e7dbd5a48195af10ce7",22851777,2,3,0,565,164,165,1
"3cbcea2be0984e7dbd5a48195af10ce7","78adeee1fa2c4fe0bc73f7bca9fcee86",22851777,2,-8,0,566,165,160,-5
"78adeee1fa2c4fe0bc73f7bca9fcee86","82e6285962b8400d9d6fc32436022a94",22851777,2,10,0,567,160,167,7
"82e6285962b8400d9d6fc32436022a94","67a089198fcb4e1c8f2385786c2b296f",22851777,3,-162,0,568,167,39,-128
"df1de691dafe4549a18a4398ee9dfaf9","83d311bed5374fee83d8d67a7d9d82dc",22851777,1,5,0,571,139,144,5
"83d311bed5374fee83d8d67a7d9d82dc","83d311bed5374fee83d8d67a7d9d82dc",22851777,1,0,1,572,144,144,0
"83d311bed5374fee83d8d67a7d9d82dc","402bba41861d43acb52a5abb89e8831e",22851777,1,1,0,573,144,145,1
"402bba41861d43acb52a5abb89e8831e","402bba41861d43acb52a5abb89e8831e",22851777,2,0,1,574,145,145,0
"402bba41861d43acb52a5abb89e8831e","df1de691dafe4549a18a4398ee9dfaf9",22851777,1,-6,0,576,145,139,-6
"f902b0f41b544d4dbf79664fd233648d","67a089198fcb4e1c8f2385786c2b296f",22851777,3,-134,0,580,146,39,-107
"67a089198fcb4e1c8f2385786c2b296f","f902b0f41b544d4dbf79664fd233648d",22851777,1,134,0,581,39,146,107
"f902b0f41b544d4dbf79664fd233648d","df1de691dafe4549a18a4398ee9dfaf9",22851777,1,-8,0,582,146,139,-7
"67a089198fcb4e1c8f2385786c2b296f","78adeee1fa2c4fe0bc73f7bca9fcee86",22851777,2,152,0,589,39,160,121
"df1de691dafe4549a18a4398ee9dfaf9","6c5ad271a44743479bfaea29b1db8d02",22851777,1,4,0,666,139,143,4
"6c5ad271a44743479bfaea29b1db8d02","6c5ad271a44743479bfaea29b1db8d02",22851777,1,0,1,667,143,143,0
"6c5ad271a44743479bfaea29b1db8d02","df1de691dafe4549a18a4398ee9dfaf9",22851777,1,-4,0,668,143,139,-4
"67a089198fcb4e1c8f2385786c2b296f","08111f75e22d409998cf8b85bd431f0a",22851777,1,86,0,673,39,108,69
"4280927ec4d643238aa49c32f9e06c6c","08111f75e22d409998cf8b85bd431f0a",22851777,1,-1,0,677,109,108,-1
"08111f75e22d409998cf8b85bd431f0a","a9ae0a3c070d455bb4369a8996313336",22851777,1,7,0,678,108,114,6
"a9ae0a3c070d455bb4369a8996313336","37319e88176d4aefa91d7a9980dbae91",22851777,2,-2,0,679,114,112,-2
"62bff51286ef4f348717a3cf6fe2318f","a9ae0a3c070d455bb4369a8996313336",22851777,1,-7,0,683,120,114,-6
"a9ae0a3c070d455bb4369a8996313336","3ec3a3563847406fa73338f9e9999cf3",22851777,1,4,0,684,114,117,3
"3ec3a3563847406fa73338f9e9999cf3","a9ae0a3c070d455bb4369a8996313336",22851777,1,-4,0,685,117,114,-3
"62bff51286ef4f348717a3cf6fe2318f","67a089198fcb4e1c8f2385786c2b296f",22851777,1,-100,0,690,120,39,-81
"67a089198fcb4e1c8f2385786c2b296f","0c7262dff33c4087bc660ccf40f92f9c",22851777,1,169,0,691,39,169,130
"b2275c3fad834f8d90737a2d9a6927d6","b2275c3fad834f8d90737a2d9a6927d6",22851777,24,0,1,693,172,172,0
"b2275c3fad834f8d90737a2d9a6927d6","eb515a26030b41f8a82a1e6114420bad",22851777,1,1,0,717,172,173,1
"eb515a26030b41f8a82a1e6114420bad","eb515a26030b41f8a82a1e6114420bad",22851777,2,0,1,718,173,173,0
"eb515a26030b41f8a82a1e6114420bad","b42cc17b7de840f181a704558d0bc845",22851777,1,3,0,720,173,175,2
"0c7262dff33c4087bc660ccf40f92f9c","362fcb0699a14845ab29b2340093e528",22851777,1,6,0,723,169,174,5
"362fcb0699a14845ab29b2340093e528","0c7262dff33c4087bc660ccf40f92f9c",22851777,1,-6,0,724,174,169,-5
"b42cc17b7de840f181a704558d0bc845","b42cc17b7de840f181a704558d0bc845",22851777,1,0,1,726,175,175,0
"b42cc17b7de840f181a704558d0bc845","801f9e9135034f49bf5f8b4bdefedb41",22851777,1,2,0,727,175,177,2
"801f9e9135034f49bf5f8b4bdefedb41","801f9e9135034f49bf5f8b4bdefedb41",22851777,7,0,1,728,177,177,0
"801f9e9135034f49bf5f8b4bdefedb41","ea38cc0e6e6e41edbabf210220808bf9",22851777,1,3,0,735,177,179,2
"ea38cc0e6e6e41edbabf210220808bf9","362fcb0699a14845ab29b2340093e528",22851777,1,-6,0,736,179,174,-5
"362fcb0699a14845ab29b2340093e528","b87c552dd247427abe6ab5795b9c9d43",22851777,1,8,0,737,174,181,7
"b87c552dd247427abe6ab5795b9c9d43","ea38cc0e6e6e41edbabf210220808bf9",22851777,1,-2,0,738,181,179,-2
"ea38cc0e6e6e41edbabf210220808bf9","b87c552dd247427abe6ab5795b9c9d43",22851777,1,2,0,739,179,181,2
"b87c552dd247427abe6ab5795b9c9d43","b87c552dd247427abe6ab5795b9c9d43",22851777,13,0,1,740,181,181,0
"b87c552dd247427abe6ab5795b9c9d43","139b097acfca451689d80c9c6eebdf7b",22851777,1,-3,0,753,181,178,-3
"139b097acfca451689d80c9c6eebdf7b","30f660a1feb34582a739722532524f79",22851777,1,6,0,754,178,183,5
"30f660a1feb34582a739722532524f79","30f660a1feb34582a739722532524f79",22851777,5,0,1,755,183,183,0
"30f660a1feb34582a739722532524f79","2024b4885bd14338a39b7b509acbbd02",22851777,1,-1,0,760,183,182,-1
"2024b4885bd14338a39b7b509acbbd02","c3f63fe50d8e487c86bf8ef76c9cadd3",22851777,1,4,0,761,182,185,3
"c3f63fe50d8e487c86bf8ef76c9cadd3","c3f63fe50d8e487c86bf8ef76c9cadd3",22851777,1,0,1,762,185,185,0
"c3f63fe50d8e487c86bf8ef76c9cadd3","c8e371568a0c4391b25796ae4e91952e",22851777,1,3,0,763,185,186,1
"c8e371568a0c4391b25796ae4e91952e","0c7262dff33c4087bc660ccf40f92f9c",22851777,1,-23,0,764,186,169,-17
"0c7262dff33c4087bc660ccf40f92f9c","7d932b23e1c84326ae5aa4d3c0d813d1",22851777,1,25,0,765,169,188,19
"7d932b23e1c84326ae5aa4d3c0d813d1","7d932b23e1c84326ae5aa4d3c0d813d1",22851777,3,0,1,766,188,188,0
"7d932b23e1c84326ae5aa4d3c0d813d1","c8e371568a0c4391b25796ae4e91952e",22851777,1,-2,0,769,188,186,-2
"c8e371568a0c4391b25796ae4e91952e","ab11d94c6c8948ea90b88f19d2cd502b",22851777,1,5,0,770,186,190,4
"ab11d94c6c8948ea90b88f19d2cd502b","ab11d94c6c8948ea90b88f19d2cd502b",22851777,1,0,1,771,190,190,0
"ab11d94c6c8948ea90b88f19d2cd502b","f992451ed6ad4e68bb9e68ad6be7c4be",22851777,1,2,0,772,190,192,2
"f992451ed6ad4e68bb9e68ad6be7c4be","f992451ed6ad4e68bb9e68ad6be7c4be",22851777,5,0,1,773,192,192,0
"f992451ed6ad4e68bb9e68ad6be7c4be","07b44a7a51e94c78b411c753fc39dab0",22851777,1,-3,0,778,192,189,-3
"07b44a7a51e94c78b411c753fc39dab0","6cd2dcaac46847d4a0bc53f296d90375",22851777,1,6,0,779,189,194,5
"6cd2dcaac46847d4a0bc53f296d90375","6cd2dcaac46847d4a0bc53f296d90375",22851777,1,0,1,780,194,194,0
"6cd2dcaac46847d4a0bc53f296d90375","2d2580c9411c4972909db508d6956a58",22851777,1,2,0,781,194,196,2
"2d2580c9411c4972909db508d6956a58","2d2580c9411c4972909db508d6956a58",22851777,5,0,1,782,196,196,0
"2d2580c9411c4972909db508d6956a58","5bddb3d9ed264f3984702f048c7e5340",22851777,1,1,0,787,196,197,1
"5bddb3d9ed264f3984702f048c7e5340","5bddb3d9ed264f3984702f048c7e5340",22851777,2,0,1,788,197,197,0
"5bddb3d9ed264f3984702f048c7e5340","d5e8e2bd12a2466b9d6d90855f0eb079",22851777,1,1,0,790,197,198,1
"d5e8e2bd12a2466b9d6d90855f0eb079","d5e8e2bd12a2466b9d6d90855f0eb079",22851777,2,0,1,791,198,198,0
"d5e8e2bd12a2466b9d6d90855f0eb079","017d7ca8e0394b91aaadc9574df2202c",22851777,1,-5,0,793,198,193,-5
"017d7ca8e0394b91aaadc9574df2202c","54e8e9f0ea3e45c4bf3b8ac799ee31b1",22851777,1,8,0,794,193,200,7
"54e8e9f0ea3e45c4bf3b8ac799ee31b1","54e8e9f0ea3e45c4bf3b8ac799ee31b1",22851777,1,0,1,795,200,200,0
"54e8e9f0ea3e45c4bf3b8ac799ee31b1","c614a00911be4877a075f19315530fb0",22851777,1,1,0,796,200,201,1
"c614a00911be4877a075f19315530fb0","c614a00911be4877a075f19315530fb0",22851777,6,0,1,797,201,201,0
"c614a00911be4877a075f19315530fb0","a6c21bd8b95249c7972820a7a7d76aff",22851777,1,1,0,803,201,202,1
"a6c21bd8b95249c7972820a7a7d76aff","a6c21bd8b95249c7972820a7a7d76aff",22851777,1,0,1,804,202,202,0
"a6c21bd8b95249c7972820a7a7d76aff","0c7262dff33c4087bc660ccf40f92f9c",22851777,1,-42,0,805,202,169,-33
"0c7262dff33c4087bc660ccf40f92f9c","017d7ca8e0394b91aaadc9574df2202c",22851777,1,32,0,807,169,193,24
"017d7ca8e0394b91aaadc9574df2202c","c8e371568a0c4391b25796ae4e91952e",22851777,1,-9,0,808,193,186,-7
"c8e371568a0c4391b25796ae4e91952e","6cd2dcaac46847d4a0bc53f296d90375",22851777,1,10,0,809,186,194,8
"6cd2dcaac46847d4a0bc53f296d90375","017d7ca8e0394b91aaadc9574df2202c",22851777,1,-1,0,810,194,193,-1
"017d7ca8e0394b91aaadc9574df2202c","bb329d880ab54120adaf203a693bb203",22851777,1,11,0,811,193,203,10
"bb329d880ab54120adaf203a693bb203","bb329d880ab54120adaf203a693bb203",22851777,1,0,1,812,203,203,0
"bb329d880ab54120adaf203a693bb203","f9170dd6bc6442b4acd832747609b09a",22851777,1,-4,0,813,203,199,-4
"f9170dd6bc6442b4acd832747609b09a","d7f13c8d63ec4e2aa673fbb9cf9c6933",22851777,1,10,0,814,199,206,7
"d7f13c8d63ec4e2aa673fbb9cf9c6933","c8e371568a0c4391b25796ae4e91952e",22851777,2,-26,0,815,206,186,-20
"c8e371568a0c4391b25796ae4e91952e","7108f0e4c2584f1f9c471689ae4c885c",22851777,1,28,0,816,186,208,22
"7108f0e4c2584f1f9c471689ae4c885c","b9e80f77c3a44349863b19875725c384",22851777,2,-1,0,817,208,207,-1
"b9e80f77c3a44349863b19875725c384","d7f13c8d63ec4e2aa673fbb9cf9c6933",22851777,1,-1,0,818,207,206,-1
"c8e371568a0c4391b25796ae4e91952e","334c2344009840079b1d0e1b7ce3d5a7",22851777,1,23,0,820,186,205,19
"334c2344009840079b1d0e1b7ce3d5a7","334c2344009840079b1d0e1b7ce3d5a7",22851777,1,0,1,821,205,205,0
"334c2344009840079b1d0e1b7ce3d5a7","c8e371568a0c4391b25796ae4e91952e",22851777,1,-23,0,822,205,186,-19
"c8e371568a0c4391b25796ae4e91952e","d7f13c8d63ec4e2aa673fbb9cf9c6933",22851777,1,26,0,823,186,206,20
"d7f13c8d63ec4e2aa673fbb9cf9c6933","7108f0e4c2584f1f9c471689ae4c885c",22851777,1,2,0,824,206,208,2
"b9e80f77c3a44349863b19875725c384","b9e80f77c3a44349863b19875725c384",22851777,18,0,1,826,207,207,0
"b9e80f77c3a44349863b19875725c384","7108f0e4c2584f1f9c471689ae4c885c",22851777,1,1,0,844,207,208,1
"7108f0e4c2584f1f9c471689ae4c885c","7108f0e4c2584f1f9c471689ae4c885c",22851777,13,0,1,845,208,208,0
"7108f0e4c2584f1f9c471689ae4c885c","d7f13c8d63ec4e2aa673fbb9cf9c6933",22851777,1,-2,0,858,208,206,-2
"d7f13c8d63ec4e2aa673fbb9cf9c6933","09400e101c5d4b439cf9a26b03aae558",22851777,1,5,0,859,206,210,4
"09400e101c5d4b439cf9a26b03aae558","09400e101c5d4b439cf9a26b03aae558",22851777,1,0,1,860,210,210,0
"09400e101c5d4b439cf9a26b03aae558","a88efa7e50ce47159810ab553afa6d3a",22851777,1,2,0,861,210,212,2
"a88efa7e50ce47159810ab553afa6d3a","a88efa7e50ce47159810ab553afa6d3a",22851777,5,0,1,862,212,212,0
"a88efa7e50ce47159810ab553afa6d3a","a875096404ef4a9984b62d74cda916f9",22851777,1,-3,0,867,212,209,-3
"a875096404ef4a9984b62d74cda916f9","be502a7a43c44bf7b682698de79d9369",22851777,1,6,0,868,209,214,5
"be502a7a43c44bf7b682698de79d9369","f7fb1952f56b4189b86a9f8b7862d2b8",22851777,2,1,0,869,214,215,1
"f7fb1952f56b4189b86a9f8b7862d2b8","be502a7a43c44bf7b682698de79d9369",22851777,1,-1,0,870,215,214,-1
"f7fb1952f56b4189b86a9f8b7862d2b8","f7fb1952f56b4189b86a9f8b7862d2b8",22851777,19,0,1,872,215,215,0
"f7fb1952f56b4189b86a9f8b7862d2b8","b860ee85d8bc4a2f97958cfb71be3533",22851777,1,1,0,891,215,216,1
"b860ee85d8bc4a2f97958cfb71be3533","b860ee85d8bc4a2f97958cfb71be3533",22851777,2,0,1,892,216,216,0
"b860ee85d8bc4a2f97958cfb71be3533","ec341f459285443b8361f7f15638ff08",22851777,1,-3,0,894,216,213,-3
"ec341f459285443b8361f7f15638ff08","363837c182e04711840d896ae1e0339c",22851777,1,6,0,895,213,218,5
"363837c182e04711840d896ae1e0339c","363837c182e04711840d896ae1e0339c",22851777,12,0,1,896,218,218,0
"363837c182e04711840d896ae1e0339c","01b2051f8941460d89945e3b02d1ce78",22851777,1,-1,0,908,218,217,-1
"01b2051f8941460d89945e3b02d1ce78","91125ca626c5470eb145501f8c37f8db",22851777,1,4,0,909,217,220,3
"91125ca626c5470eb145501f8c37f8db","91125ca626c5470eb145501f8c37f8db",22851777,1,0,1,910,220,220,0
"91125ca626c5470eb145501f8c37f8db","1c6721b1f63f4d30ba7746ea8af02a52",22851777,1,3,0,911,220,221,1
"1c6721b1f63f4d30ba7746ea8af02a52","d7f13c8d63ec4e2aa673fbb9cf9c6933",22851777,1,-21,0,912,221,206,-15
"d7f13c8d63ec4e2aa673fbb9cf9c6933","77ecef8eff6b4a2caea7707669bf7475",22851777,1,22,0,913,206,222,16
"77ecef8eff6b4a2caea7707669bf7475","77ecef8eff6b4a2caea7707669bf7475",22851777,12,0,1,914,222,222,0
"1c6721b1f63f4d30ba7746ea8af02a52","d03cb855c70044cf8c35d9ec0de696e3",22851777,2,4,0,927,221,224,3
"d03cb855c70044cf8c35d9ec0de696e3","8b9ae98743bd4d4a8a87dff1c1244211",22851777,3,3,0,928,224,227,3
"8b9ae98743bd4d4a8a87dff1c1244211","d03cb855c70044cf8c35d9ec0de696e3",22851777,1,-3,0,929,227,224,-3
"8b9ae98743bd4d4a8a87dff1c1244211","8b9ae98743bd4d4a8a87dff1c1244211",22851777,36,0,1,931,227,227,0
"8b9ae98743bd4d4a8a87dff1c1244211","f7906d6f59b9489a91d2ef40db5a474d",22851777,2,-4,0,967,227,223,-4
"f7906d6f59b9489a91d2ef40db5a474d","77ecef8eff6b4a2caea7707669bf7475",22851777,1,-2,0,968,223,222,-1
"77ecef8eff6b4a2caea7707669bf7475","d03cb855c70044cf8c35d9ec0de696e3",22851777,1,3,0,969,222,224,2
"d03cb855c70044cf8c35d9ec0de696e3","1c6721b1f63f4d30ba7746ea8af02a52",22851777,1,-4,0,970,224,221,-3
"1c6721b1f63f4d30ba7746ea8af02a52","8b9ae98743bd4d4a8a87dff1c1244211",22851777,1,7,0,971,221,227,6
"8b9ae98743bd4d4a8a87dff1c1244211","a49a937d6896486d9a5396654abcf2e1",22851777,1,-1,0,972,227,226,-1
"a49a937d6896486d9a5396654abcf2e1","a49a937d6896486d9a5396654abcf2e1",22851777,5,0,1,973,226,226,0
"a49a937d6896486d9a5396654abcf2e1","f7906d6f59b9489a91d2ef40db5a474d",22851777,1,-3,0,978,226,223,-3
"f7906d6f59b9489a91d2ef40db5a474d","2ab1535aac1346ba8801535bf729ef37",22851777,1,7,0,979,223,229,6
"2ab1535aac1346ba8801535bf729ef37","2ab1535aac1346ba8801535bf729ef37",22851777,1,0,1,980,229,229,0
"2ab1535aac1346ba8801535bf729ef37","a4f40fb48a8542c8949bae1f002cd9bc",22851777,1,2,0,981,229,231,2
"a4f40fb48a8542c8949bae1f002cd9bc","a4f40fb48a8542c8949bae1f002cd9bc",22851777,2,0,1,982,231,231,0
"a4f40fb48a8542c8949bae1f002cd9bc","8972c23e32044edb8a78fa1eed4e5947",22851777,1,1,0,984,231,232,1
"8972c23e32044edb8a78fa1eed4e5947","8972c23e32044edb8a78fa1eed4e5947",22851777,1,0,1,985,232,232,0
"8972c23e32044edb8a78fa1eed4e5947","92feb4a40f8344d38b6f722e42a53295",22851777,1,1,0,986,232,233,1
"92feb4a40f8344d38b6f722e42a53295","92feb4a40f8344d38b6f722e42a53295",22851777,2,0,1,987,233,233,0
"92feb4a40f8344d38b6f722e42a53295","0c7262dff33c4087bc660ccf40f92f9c",22851777,1,-84,0,989,233,169,-64
"0c7262dff33c4087bc660ccf40f92f9c","1c6721b1f63f4d30ba7746ea8af02a52",22851777,1,70,0,990,169,221,52
"1c6721b1f63f4d30ba7746ea8af02a52","1c6721b1f63f4d30ba7746ea8af02a52",22851777,1,0,1,991,221,221,0
"f7906d6f59b9489a91d2ef40db5a474d","ca3e28f290354c08aefe5b0f769604e6",22851777,1,14,0,997,223,235,12
"ca3e28f290354c08aefe5b0f769604e6","ca3e28f290354c08aefe5b0f769604e6",22851777,4,0,1,1000,235,235,0
"ca3e28f290354c08aefe5b0f769604e6","79a35eea833e4c2c9d22fc53c3c6445c",22851777,1,1,0,1002,235,236,1
"79a35eea833e4c2c9d22fc53c3c6445c","79a35eea833e4c2c9d22fc53c3c6445c",22851777,9,0,1,1003,236,236,0
"79a35eea833e4c2c9d22fc53c3c6445c","8f68228b1518449e9615cdafee41a2bd",22851777,1,1,0,1012,236,237,1
"8f68228b1518449e9615cdafee41a2bd","8f68228b1518449e9615cdafee41a2bd",22851777,1,0,1,1013,237,237,0
"8f68228b1518449e9615cdafee41a2bd","cab89fa5c3ed45a5aa550fc0352d6a42",22851777,1,1,0,1014,237,238,1
"cab89fa5c3ed45a5aa550fc0352d6a42","cab89fa5c3ed45a5aa550fc0352d6a42",22851777,5,0,1,1015,238,238,0
"cab89fa5c3ed45a5aa550fc0352d6a42","1c6721b1f63f4d30ba7746ea8af02a52",22851777,1,-20,0,1020,238,221,-17
"1c6721b1f63f4d30ba7746ea8af02a52","77ecef8eff6b4a2caea7707669bf7475",22851777,2,1,0,1021,221,222,1
"77ecef8eff6b4a2caea7707669bf7475","1c6721b1f63f4d30ba7746ea8af02a52",22851777,3,-1,0,1022,222,221,-1
"1c6721b1f63f4d30ba7746ea8af02a52","66d4fad4f1cf4b46be0750a99ad7a35a",22851777,1,21,0,1023,221,239,18
"66d4fad4f1cf4b46be0750a99ad7a35a","66d4fad4f1cf4b46be0750a99ad7a35a",22851777,1,0,1,1024,239,239,0
"66d4fad4f1cf4b46be0750a99ad7a35a","0b04c8e2f86d48c7aeb7e225819cd32b",22851777,1,-5,0,1025,239,234,-5
"0b04c8e2f86d48c7aeb7e225819cd32b","1c6721b1f63f4d30ba7746ea8af02a52",22851777,1,-16,0,1026,234,221,-13
"1c6721b1f63f4d30ba7746ea8af02a52","2ae94c0cea4d480a9d5dca8fb1d7b542",22851777,2,27,0,1027,221,242,21
"2ae94c0cea4d480a9d5dca8fb1d7b542","2ae94c0cea4d480a9d5dca8fb1d7b542",22851777,3,0,1,1028,242,242,0
"2ae94c0cea4d480a9d5dca8fb1d7b542","1c6721b1f63f4d30ba7746ea8af02a52",22851777,1,-27,0,1029,242,221,-21
"1c6721b1f63f4d30ba7746ea8af02a52","1ebf23f9d994469a85206e4c7b1bf5f5",22851777,1,30,0,1030,221,245,24
"1ebf23f9d994469a85206e4c7b1bf5f5","f53da5fd9bfe412da4b80d4742563b6c",22851777,1,-6,0,1031,245,241,-4
"f53da5fd9bfe412da4b80d4742563b6c","f53da5fd9bfe412da4b80d4742563b6c",22851777,1,0,1,1032,241,241,0
"f53da5fd9bfe412da4b80d4742563b6c","1c6721b1f63f4d30ba7746ea8af02a52",22851777,1,-24,0,1033,241,221,-20
"2ae94c0cea4d480a9d5dca8fb1d7b542","1ebf23f9d994469a85206e4c7b1bf5f5",22851777,2,3,0,1035,242,245,3
"1ebf23f9d994469a85206e4c7b1bf5f5","0c7262dff33c4087bc660ccf40f92f9c",22851777,1,-100,0,1036,245,169,-76
"0c7262dff33c4087bc660ccf40f92f9c","0c7262dff33c4087bc660ccf40f92f9c",22851777,3,0,1,1037,169,169,0
"0c7262dff33c4087bc660ccf40f92f9c","78adeee1fa2c4fe0bc73f7bca9fcee86",22851777,1,-17,0,1038,169,160,-9
"78adeee1fa2c4fe0bc73f7bca9fcee86","78adeee1fa2c4fe0bc73f7bca9fcee86",22851777,6,0,1,1039,160,160,0
"78adeee1fa2c4fe0bc73f7bca9fcee86","65202579580f4ad38d734b4ee39d22a8",22851777,7,5,0,1041,160,164,4
"65202579580f4ad38d734b4ee39d22a8","65202579580f4ad38d734b4ee39d22a8",22851777,102,0,1,1042,164,164,0
"65202579580f4ad38d734b4ee39d22a8","8959e6304a0348309a771e4d08d1b64a",22851777,2,-1,0,1051,164,163,-1
"8959e6304a0348309a771e4d08d1b64a","65202579580f4ad38d734b4ee39d22a8",22851777,1,1,0,1052,163,164,1
"65202579580f4ad38d734b4ee39d22a8","78adeee1fa2c4fe0bc73f7bca9fcee86",22851777,3,-5,0,1054,164,160,-4
"65202579580f4ad38d734b4ee39d22a8","2ae94c0cea4d480a9d5dca8fb1d7b542",22851777,2,109,0,1061,164,242,78
"1ebf23f9d994469a85206e4c7b1bf5f5","1ebf23f9d994469a85206e4c7b1bf5f5",22851777,12,0,1,1064,245,245,0
"1ebf23f9d994469a85206e4c7b1bf5f5","85ae675b83e8422da842cfd25596af99",22851777,1,1,0,1076,245,246,1
"85ae675b83e8422da842cfd25596af99","85ae675b83e8422da842cfd25596af99",22851777,1,0,1,1077,246,246,0
"85ae675b83e8422da842cfd25596af99","2ae94c0cea4d480a9d5dca8fb1d7b542",22851777,1,-4,0,1078,246,242,-4
"2ae94c0cea4d480a9d5dca8fb1d7b542","fa235f0f364d47e4ae1c87f47bf8e6ba",22851777,1,12,0,1079,242,252,10
"fa235f0f364d47e4ae1c87f47bf8e6ba","fa235f0f364d47e4ae1c87f47bf8e6ba",22851777,1,0,1,1080,252,252,0
"fa235f0f364d47e4ae1c87f47bf8e6ba","79f7845465cc4ed19d8e4f1429541be0",22851777,1,2,0,1081,252,254,2
"79f7845465cc4ed19d8e4f1429541be0","79f7845465cc4ed19d8e4f1429541be0",22851777,2,0,1,1082,254,254,0
"79f7845465cc4ed19d8e4f1429541be0","6e83e23f56544a19b94067c1c558d9c0",22851777,1,-8,0,1084,254,247,-7
"6e83e23f56544a19b94067c1c558d9c0","00f61990949545828dd12f1303d47504",22851777,2,11,0,1085,247,256,9
"00f61990949545828dd12f1303d47504","78adeee1fa2c4fe0bc73f7bca9fcee86",22851777,1,-131,0,1086,256,160,-96
"2ae94c0cea4d480a9d5dca8fb1d7b542","d989ebcfc12a4b669f0100dc1aa14f1e",22851777,1,16,0,1098,242,255,13
"d989ebcfc12a4b669f0100dc1aa14f1e","28c171777c52431ab6b925073bd63d46",22851777,1,10,0,1099,255,264,9
"28c171777c52431ab6b925073bd63d46","28c171777c52431ab6b925073bd63d46",22851777,11,0,1,1100,264,264,0
"28c171777c52431ab6b925073bd63d46","ac160db940cb49ae8579162b1d52bb5d",22851777,1,2,0,1111,264,266,2
"ac160db940cb49ae8579162b1d52bb5d","ac160db940cb49ae8579162b1d52bb5d",22851777,7,0,1,1112,266,266,0
"ac160db940cb49ae8579162b1d52bb5d","d989ebcfc12a4b669f0100dc1aa14f1e",22851777,1,-12,0,1119,266,255,-11
"d989ebcfc12a4b669f0100dc1aa14f1e","c6fd49b485cc4874b0bbdd9c6171e09c",22851777,1,15,0,1120,255,268,13
"c6fd49b485cc4874b0bbdd9c6171e09c","c6fd49b485cc4874b0bbdd9c6171e09c",22851777,7,0,1,1121,268,268,0
"c6fd49b485cc4874b0bbdd9c6171e09c","44240778a97c4af0937817499b75707b",22851777,1,1,0,1128,268,269,1
"44240778a97c4af0937817499b75707b","44240778a97c4af0937817499b75707b",22851777,2,0,1,1129,269,269,0
"44240778a97c4af0937817499b75707b","7aa76d3e993840d8805f097cbdbcd44b",22851777,1,-9,0,1131,269,261,-8
"7aa76d3e993840d8805f097cbdbcd44b","865a4d3b43374da7944dc7d397f566d9",22851777,1,12,0,1132,261,271,10
"865a4d3b43374da7944dc7d397f566d9","865a4d3b43374da7944dc7d397f566d9",22851777,2,0,1,1133,271,271,0
"865a4d3b43374da7944dc7d397f566d9","0d987bed3ffa4ed0b9a2e62e97b7b30f",22851777,1,3,0,1134,271,272,1
"0d987bed3ffa4ed0b9a2e62e97b7b30f","2ae94c0cea4d480a9d5dca8fb1d7b542",22851777,2,-38,0,1135,272,242,-30
"2ae94c0cea4d480a9d5dca8fb1d7b542","0d987bed3ffa4ed0b9a2e62e97b7b30f",22851777,2,38,0,1136,242,272,30
"0d987bed3ffa4ed0b9a2e62e97b7b30f","bb5a47f5ea01454a8b79455422d3b9da",22851777,5,10,0,1137,272,280,8
"bb5a47f5ea01454a8b79455422d3b9da","bb5a47f5ea01454a8b79455422d3b9da",22851777,104,0,1,1138,280,280,0
"bb5a47f5ea01454a8b79455422d3b9da","82ae07bc0c9b4570a41799290d1ef399",22851777,5,-6,0,1140,280,275,-5
"82ae07bc0c9b4570a41799290d1ef399","bb5a47f5ea01454a8b79455422d3b9da",22851777,4,6,0,1141,275,280,5
"bb5a47f5ea01454a8b79455422d3b9da","0d987bed3ffa4ed0b9a2e62e97b7b30f",22851777,1,-10,0,1146,280,272,-8
"0d987bed3ffa4ed0b9a2e62e97b7b30f","94cecc3f1e7d484b8e068e79241dfd73",22851777,2,13,0,1147,272,281,9
"94cecc3f1e7d484b8e068e79241dfd73","a37477c4e4c14169ad44b06b493007f6",22851777,1,2,0,1148,281,283,2
"a37477c4e4c14169ad44b06b493007f6","0d987bed3ffa4ed0b9a2e62e97b7b30f",22851777,1,-15,0,1149,283,272,-11
"94cecc3f1e7d484b8e068e79241dfd73","bb5a47f5ea01454a8b79455422d3b9da",22851777,1,-3,0,1151,281,280,-1
"bb5a47f5ea01454a8b79455422d3b9da","94cecc3f1e7d484b8e068e79241dfd73",22851777,3,3,0,1159,280,281,1
"94cecc3f1e7d484b8e068e79241dfd73","0d987bed3ffa4ed0b9a2e62e97b7b30f",22851777,4,-13,0,1160,281,272,-9
"0d987bed3ffa4ed0b9a2e62e97b7b30f","a37477c4e4c14169ad44b06b493007f6",22851777,2,15,0,1161,272,283,11
"a37477c4e4c14169ad44b06b493007f6","94cecc3f1e7d484b8e068e79241dfd73",22851777,1,-2,0,1162,283,281,-2
"bb5a47f5ea01454a8b79455422d3b9da","0c7262dff33c4087bc660ccf40f92f9c",22851777,1,-145,0,1172,280,169,-111
"0c7262dff33c4087bc660ccf40f92f9c","fab84b4fab5940efb4ea868ef8d09396",22851777,1,153,0,1173,169,284,115
"fab84b4fab5940efb4ea868ef8d09396","fab84b4fab5940efb4ea868ef8d09396",22851777,1,0,1,1174,284,284,0
"fab84b4fab5940efb4ea868ef8d09396","4a29443515bb404cb8924e1c60a63b73",22851777,2,4,0,1175,284,285,1
"4a29443515bb404cb8924e1c60a63b73","208c9b2796c944db8dacaa96082520ea",22851777,2,3,0,1176,285,288,3
"208c9b2796c944db8dacaa96082520ea","d989ebcfc12a4b669f0100dc1aa14f1e",22851777,1,-47,0,1177,288,255,-33
"d989ebcfc12a4b669f0100dc1aa14f1e","2ae94c0cea4d480a9d5dca8fb1d7b542",22851777,1,-16,0,1178,255,242,-13
"2ae94c0cea4d480a9d5dca8fb1d7b542","00f61990949545828dd12f1303d47504",22851777,1,17,0,1179,242,256,14
"00f61990949545828dd12f1303d47504","d989ebcfc12a4b669f0100dc1aa14f1e",22851777,1,-1,0,1180,256,255,-1
"d989ebcfc12a4b669f0100dc1aa14f1e","00f61990949545828dd12f1303d47504",22851777,1,1,0,1181,255,256,1
"00f61990949545828dd12f1303d47504","ead7bb4b64e247d2ae632ab8a296b091",22851777,1,2,0,1182,256,258,2
"ead7bb4b64e247d2ae632ab8a296b091","ead7bb4b64e247d2ae632ab8a296b091",22851777,2,0,1,1183,258,258,0
"ead7bb4b64e247d2ae632ab8a296b091","41b0048dde734bb280bac6116baa8e27",22851777,1,1,0,1185,258,259,1
"41b0048dde734bb280bac6116baa8e27","41b0048dde734bb280bac6116baa8e27",22851777,2,0,1,1186,259,259,0
"41b0048dde734bb280bac6116baa8e27","b41c5a094a604ee0915327da5cc0beb7",22851777,1,1,0,1188,259,260,1
"b41c5a094a604ee0915327da5cc0beb7","b41c5a094a604ee0915327da5cc0beb7",22851777,2,0,1,1189,260,260,0
"b41c5a094a604ee0915327da5cc0beb7","d546341988904f069cfa86b21457d9d9",22851777,1,-10,0,1191,260,251,-9
"d546341988904f069cfa86b21457d9d9","0c7262dff33c4087bc660ccf40f92f9c",22851777,1,-108,0,1192,251,169,-82
"0c7262dff33c4087bc660ccf40f92f9c","4a29443515bb404cb8924e1c60a63b73",22851777,1,157,0,1193,169,285,116
"4a29443515bb404cb8924e1c60a63b73","4a29443515bb404cb8924e1c60a63b73",22851777,2,0,1,1194,285,285,0
"208c9b2796c944db8dacaa96082520ea","208c9b2796c944db8dacaa96082520ea",22851777,1,0,1,1196,288,288,0
"208c9b2796c944db8dacaa96082520ea","4a29443515bb404cb8924e1c60a63b73",22851777,3,-3,0,1197,288,285,-3
"4a29443515bb404cb8924e1c60a63b73","7669a956527947d0add87455277e80b4",22851777,1,7,0,1198,285,291,6
"7669a956527947d0add87455277e80b4","7669a956527947d0add87455277e80b4",22851777,2,0,1,1199,291,291,0
"7669a956527947d0add87455277e80b4","6a9a3b5bde4a48daa896fe8c06eca56f",22851777,1,-2,0,1200,291,289,-2
"6a9a3b5bde4a48daa896fe8c06eca56f","208c9b2796c944db8dacaa96082520ea",22851777,2,-2,0,1201,289,288,-1
"4a29443515bb404cb8924e1c60a63b73","6a9a3b5bde4a48daa896fe8c06eca56f",22851777,3,5,0,1203,285,289,4
"6a9a3b5bde4a48daa896fe8c06eca56f","869e967078f04da18dd0b0b9389a7424",22851777,2,5,0,1207,289,293,4
"869e967078f04da18dd0b0b9389a7424","34a6e49023fc4465bd5ca604330bbd1c",22851777,1,-1,0,1208,293,292,-1
"34a6e49023fc4465bd5ca604330bbd1c","fab84b4fab5940efb4ea868ef8d09396",22851777,1,-13,0,1209,292,284,-8
"6a9a3b5bde4a48daa896fe8c06eca56f","7669a956527947d0add87455277e80b4",22851777,1,2,0,1212,289,291,2
"7669a956527947d0add87455277e80b4","869e967078f04da18dd0b0b9389a7424",22851777,1,3,0,1214,291,293,2
"869e967078f04da18dd0b0b9389a7424","6a9a3b5bde4a48daa896fe8c06eca56f",22851777,1,-5,0,1215,293,289,-4
"869e967078f04da18dd0b0b9389a7424","51ab6291537748fab90d519aa09889d6",22851777,1,2,0,1217,293,295,2
"51ab6291537748fab90d519aa09889d6","51ab6291537748fab90d519aa09889d6",22851777,11,0,1,1218,295,295,0
"51ab6291537748fab90d519aa09889d6","34a6e49023fc4465bd5ca604330bbd1c",22851777,1,-3,0,1229,295,292,-3
"34a6e49023fc4465bd5ca604330bbd1c","21592f2a9e9c4b2f8c66ec5dbcbf6a2b",22851777,1,5,0,1230,292,296,4
"21592f2a9e9c4b2f8c66ec5dbcbf6a2b","ba0e59461bfb4a44b7b1c28a01f8d3b3",22851777,1,4,0,1231,296,299,3
"ba0e59461bfb4a44b7b1c28a01f8d3b3","ba0e59461bfb4a44b7b1c28a01f8d3b3",22851777,1,0,1,1232,299,299,0
"ba0e59461bfb4a44b7b1c28a01f8d3b3","0e0b36e731a645e7b1b8a88f5031ca38",22851777,1,2,0,1233,299,301,2
"0e0b36e731a645e7b1b8a88f5031ca38","0e0b36e731a645e7b1b8a88f5031ca38",22851777,9,0,1,1234,301,301,0
"0e0b36e731a645e7b1b8a88f5031ca38","a66a144637284c21afc6de17fea4bfb8",22851777,1,1,0,1243,301,302,1
"a66a144637284c21afc6de17fea4bfb8","a66a144637284c21afc6de17fea4bfb8",22851777,2,0,1,1244,302,302,0
"a66a144637284c21afc6de17fea4bfb8","7646a919d7e64fa990bca9b024ff089d",22851777,1,-4,0,1246,302,298,-4
"7646a919d7e64fa990bca9b024ff089d","4a29443515bb404cb8924e1c60a63b73",22851777,1,-17,0,1247,298,285,-13
"4a29443515bb404cb8924e1c60a63b73","2c5bb2cbd0014420ad8c95d40e38efd1",22851777,1,23,0,1249,285,303,18
"2c5bb2cbd0014420ad8c95d40e38efd1","4a29443515bb404cb8924e1c60a63b73",22851777,1,-23,0,1250,303,285,-18
"4a29443515bb404cb8924e1c60a63b73","e390b575229748ea8aac9364efe2bf00",22851777,1,24,0,1251,285,304,19
"e390b575229748ea8aac9364efe2bf00","e390b575229748ea8aac9364efe2bf00",22851777,1,0,1,1252,304,304,0
"e390b575229748ea8aac9364efe2bf00","3434c10e561d488a914e0f7d71907abd",22851777,1,3,0,1253,304,305,1
"3434c10e561d488a914e0f7d71907abd","4a29443515bb404cb8924e1c60a63b73",22851777,1,-27,0,1254,305,285,-20
"4a29443515bb404cb8924e1c60a63b73","53e7e900392747ccad52e711ab0f80d8",22851777,1,29,0,1255,285,307,22
"53e7e900392747ccad52e711ab0f80d8","53e7e900392747ccad52e711ab0f80d8",22851777,1,0,1,1256,307,307,0
"53e7e900392747ccad52e711ab0f80d8","130acc2aeb0448fdbb2de63bc5cebe5b",22851777,1,3,0,1257,307,309,2
"130acc2aeb0448fdbb2de63bc5cebe5b","3434c10e561d488a914e0f7d71907abd",22851777,1,-5,0,1258,309,305,-4
"3434c10e561d488a914e0f7d71907abd","130acc2aeb0448fdbb2de63bc5cebe5b",22851777,1,5,0,1259,305,309,4
"130acc2aeb0448fdbb2de63bc5cebe5b","9c062b3251034ebe90f5054e2a3b5120",22851777,1,2,0,1260,309,311,2
"9c062b3251034ebe90f5054e2a3b5120","9c062b3251034ebe90f5054e2a3b5120",22851777,2,0,1,1261,311,311,0
"9c062b3251034ebe90f5054e2a3b5120","ea859f8207e44537889daeaba13ac2e8",22851777,1,1,0,1263,311,312,1
"ea859f8207e44537889daeaba13ac2e8","ea859f8207e44537889daeaba13ac2e8",22851777,1,0,1,1264,312,312,0
"ea859f8207e44537889daeaba13ac2e8","56d94971a7a94257aa330183a8ebd0ea",22851777,1,1,0,1265,312,313,1
"56d94971a7a94257aa330183a8ebd0ea","56d94971a7a94257aa330183a8ebd0ea",22851777,1,0,1,1266,313,313,0
"56d94971a7a94257aa330183a8ebd0ea","141c0df6cd1946539aadd1c9b7068cd4",22851777,1,-5,0,1267,313,308,-5
"141c0df6cd1946539aadd1c9b7068cd4","13255e63e0aa4abf85e5211bf613d43e",22851777,1,10,0,1268,308,317,9
"13255e63e0aa4abf85e5211bf613d43e","13255e63e0aa4abf85e5211bf613d43e",22851777,1,0,1,1269,317,317,0
"13255e63e0aa4abf85e5211bf613d43e","0c787d16c9504873b1a4d903cec09948",22851777,1,-3,0,1270,317,314,-3
"0c787d16c9504873b1a4d903cec09948","86c27d40179e419c8e9d150fb6afa5d0",22851777,1,6,0,1271,314,319,5
"86c27d40179e419c8e9d150fb6afa5d0","3434c10e561d488a914e0f7d71907abd",22851777,1,-17,0,1272,319,305,-14
"3434c10e561d488a914e0f7d71907abd","8d7e0b55cf9849cda222a0f2440cec55",22851777,1,16,0,1273,305,318,13
"8d7e0b55cf9849cda222a0f2440cec55","3434c10e561d488a914e0f7d71907abd",22851777,1,-16,0,1274,318,305,-13
"3434c10e561d488a914e0f7d71907abd","86c27d40179e419c8e9d150fb6afa5d0",22851777,1,17,0,1275,305,319,14
"86c27d40179e419c8e9d150fb6afa5d0","86c27d40179e419c8e9d150fb6afa5d0",22851777,1,0,1,1276,319,319,0
"86c27d40179e419c8e9d150fb6afa5d0","47edbb64109243e6b0f8f64cdef90c6c",22851777,1,8,0,1277,319,326,7
"47edbb64109243e6b0f8f64cdef90c6c","8d7e0b55cf9849cda222a0f2440cec55",22851777,1,-9,0,1278,326,318,-8
"8d7e0b55cf9849cda222a0f2440cec55","24f1363179ad4aaa965484a78471912b",22851777,1,6,0,1279,318,323,5
"24f1363179ad4aaa965484a78471912b","24f1363179ad4aaa965484a78471912b",22851777,1,0,1,1280,323,323,0
"24f1363179ad4aaa965484a78471912b","3628bdce1dd2429ba924d2d4d09448d2",22851777,1,-1,0,1281,323,322,-1
"3628bdce1dd2429ba924d2d4d09448d2","56b3fd1a212a4764be39d979fde3326e",22851777,1,7,0,1282,322,328,6
"56b3fd1a212a4764be39d979fde3326e","56b3fd1a212a4764be39d979fde3326e",22851777,1,0,1,1283,328,328,0
"56b3fd1a212a4764be39d979fde3326e","3434c10e561d488a914e0f7d71907abd",22851777,1,-28,0,1284,328,305,-23
"3434c10e561d488a914e0f7d71907abd","0c4079457ede49e3aeb5e86ed84bdf35",22851777,3,31,0,1285,305,329,24
"0c4079457ede49e3aeb5e86ed84bdf35","38aea304b4fa46e1b29bb72f5cea4c93",22851777,5,2,0,1286,329,331,2
"38aea304b4fa46e1b29bb72f5cea4c93","38aea304b4fa46e1b29bb72f5cea4c93",22851777,2,0,1,1287,331,331,0
"38aea304b4fa46e1b29bb72f5cea4c93","e36d261332f14e79bb4b467aceaeb9b5",22851777,1,2,0,1288,331,333,2
"e36d261332f14e79bb4b467aceaeb9b5","e36d261332f14e79bb4b467aceaeb9b5",22851777,1,0,1,1289,333,333,0
"e36d261332f14e79bb4b467aceaeb9b5","c7e89b9d04744d2eab742fc24e3ef1ae",22851777,1,1,0,1290,333,334,1
"c7e89b9d04744d2eab742fc24e3ef1ae","c7e89b9d04744d2eab742fc24e3ef1ae",22851777,5,0,1,1291,334,334,0
"c7e89b9d04744d2eab742fc24e3ef1ae","fe49f8054b374a0ea4bb266ed135ff62",22851777,1,1,0,1296,334,335,1
"fe49f8054b374a0ea4bb266ed135ff62","fe49f8054b374a0ea4bb266ed135ff62",22851777,4,0,1,1297,335,335,0
"fe49f8054b374a0ea4bb266ed135ff62","d0a8f74af98642fe8360d22c42e45117",22851777,1,1,0,1299,335,336,1
"d0a8f74af98642fe8360d22c42e45117","d0a8f74af98642fe8360d22c42e45117",22851777,5,0,1,1300,336,336,0
"d0a8f74af98642fe8360d22c42e45117","0c4079457ede49e3aeb5e86ed84bdf35",22851777,1,-7,0,1302,336,329,-7
"0c4079457ede49e3aeb5e86ed84bdf35","a7c6339ca1da4368a18d471f0519f877",22851777,2,11,0,1303,329,339,10
"a7c6339ca1da4368a18d471f0519f877","a7c6339ca1da4368a18d471f0519f877",22851777,2,0,1,1304,339,339,0
"a7c6339ca1da4368a18d471f0519f877","b8b9418ab322418d9db9b40d96af873a",22851777,2,-2,0,1305,339,337,-2
"b8b9418ab322418d9db9b40d96af873a","bbc5139ca9024389a94db3a6f47dcff6",22851777,5,5,0,1306,337,341,4
"bbc5139ca9024389a94db3a6f47dcff6","4a29443515bb404cb8924e1c60a63b73",22851777,1,-72,0,1307,341,285,-56
"4a29443515bb404cb8924e1c60a63b73","3628bdce1dd2429ba924d2d4d09448d2",22851777,1,48,0,1308,285,322,37
"3628bdce1dd2429ba924d2d4d09448d2","3434c10e561d488a914e0f7d71907abd",22851777,2,-21,0,1309,322,305,-17
"3434c10e561d488a914e0f7d71907abd","24f1363179ad4aaa965484a78471912b",22851777,1,22,0,1310,305,323,18
"24f1363179ad4aaa965484a78471912b","47edbb64109243e6b0f8f64cdef90c6c",22851777,1,3,0,1311,323,326,3
"47edbb64109243e6b0f8f64cdef90c6c","3628bdce1dd2429ba924d2d4d09448d2",22851777,1,-4,0,1312,326,322,-4
"0c4079457ede49e3aeb5e86ed84bdf35","b8b9418ab322418d9db9b40d96af873a",22851777,4,9,0,1315,329,337,8
"b8b9418ab322418d9db9b40d96af873a","b8b9418ab322418d9db9b40d96af873a",22851777,1,0,1,1316,337,337,0
"bbc5139ca9024389a94db3a6f47dcff6","bbc5139ca9024389a94db3a6f47dcff6",22851777,1,0,1,1318,341,341,0
"bbc5139ca9024389a94db3a6f47dcff6","4ee6ca9019ab4a1ab323f98094a9bd77",22851777,1,2,0,1319,341,343,2
"4ee6ca9019ab4a1ab323f98094a9bd77","4ee6ca9019ab4a1ab323f98094a9bd77",22851777,2,0,1,1320,343,343,0
"4ee6ca9019ab4a1ab323f98094a9bd77","b37947176785476f8b29d49a851366dc",22851777,1,1,0,1322,343,344,1
"b37947176785476f8b29d49a851366dc","b37947176785476f8b29d49a851366dc",22851777,2,0,1,1323,344,344,0
"b37947176785476f8b29d49a851366dc","fcea5b10d5a14a3b9324ffece8f6e1e5",22851777,1,1,0,1325,344,345,1
"fcea5b10d5a14a3b9324ffece8f6e1e5","fcea5b10d5a14a3b9324ffece8f6e1e5",22851777,2,0,1,1326,345,345,0
"fcea5b10d5a14a3b9324ffece8f6e1e5","c2490bc612d146edbe786556fab3651b",22851777,1,-5,0,1328,345,340,-5
"c2490bc612d146edbe786556fab3651b","6ac8bb048b854999a47edb35fe627f11",22851777,1,8,0,1329,340,347,7
"6ac8bb048b854999a47edb35fe627f11","6ac8bb048b854999a47edb35fe627f11",22851777,1,0,1,1330,347,347,0
"6ac8bb048b854999a47edb35fe627f11","0c4079457ede49e3aeb5e86ed84bdf35",22851777,1,-21,0,1331,347,329,-18
"0c4079457ede49e3aeb5e86ed84bdf35","30ead9794d4847abaf222ca966cc8630",22851777,2,24,0,1332,329,348,19
"30ead9794d4847abaf222ca966cc8630","09b9678ddc3d452ea4a3d46e15826065",22851777,1,5,0,1333,348,353,5
"09b9678ddc3d452ea4a3d46e15826065","897b7f51242c44aab2205c72fdcbf4cd",22851777,3,-1,0,1334,353,352,-1
"897b7f51242c44aab2205c72fdcbf4cd","eff0de7f2dbb42dfa1a2e686efab5b6d",22851777,2,2,0,1335,352,354,2
"eff0de7f2dbb42dfa1a2e686efab5b6d","c20993c944444fe085345591a8bd837e",22851777,3,-3,0,1336,354,351,-3
"c20993c944444fe085345591a8bd837e","c20993c944444fe085345591a8bd837e",22851777,5,0,1,1337,351,351,0
"c20993c944444fe085345591a8bd837e","897b7f51242c44aab2205c72fdcbf4cd",22851777,2,1,0,1341,351,352,1
"897b7f51242c44aab2205c72fdcbf4cd","897b7f51242c44aab2205c72fdcbf4cd",22851777,5,0,1,1342,352,352,0
"897b7f51242c44aab2205c72fdcbf4cd","09b9678ddc3d452ea4a3d46e15826065",22851777,1,1,0,1345,352,353,1
"09b9678ddc3d452ea4a3d46e15826065","09b9678ddc3d452ea4a3d46e15826065",22851777,3,0,1,1346,353,353,0
"09b9678ddc3d452ea4a3d46e15826065","eff0de7f2dbb42dfa1a2e686efab5b6d",22851777,4,1,0,1349,353,354,1
"eff0de7f2dbb42dfa1a2e686efab5b6d","eff0de7f2dbb42dfa1a2e686efab5b6d",22851777,3,0,1,1350,354,354,0
"eff0de7f2dbb42dfa1a2e686efab5b6d","30ead9794d4847abaf222ca966cc8630",22851777,1,-6,0,1353,354,348,-6
"30ead9794d4847abaf222ca966cc8630","2fe14166dc9642c3bc666b86a57f943d",22851777,3,10,0,1354,348,357,9
"2fe14166dc9642c3bc666b86a57f943d","2fe14166dc9642c3bc666b86a57f943d",22851777,2,0,1,1355,357,357,0
"2fe14166dc9642c3bc666b86a57f943d","44421dd1e13a47a388c4a19834b744c7",22851777,2,2,0,1356,357,359,2
"44421dd1e13a47a388c4a19834b744c7","44421dd1e13a47a388c4a19834b744c7",22851777,6,0,1,1357,359,359,0
"44421dd1e13a47a388c4a19834b744c7","cb5fc7ef85d547c4be1a7439d0bf6052",22851777,1,1,0,1359,359,360,1
"cb5fc7ef85d547c4be1a7439d0bf6052","cb5fc7ef85d547c4be1a7439d0bf6052",22851777,5,0,1,1360,360,360,0
"cb5fc7ef85d547c4be1a7439d0bf6052","0a8f150a4cf747acbde62f4721823da3",22851777,1,1,0,1365,360,361,1
"0a8f150a4cf747acbde62f4721823da3","0a8f150a4cf747acbde62f4721823da3",22851777,6,0,1,1366,361,361,0
"0a8f150a4cf747acbde62f4721823da3","ab8fdad974ae471f9f24c3f9dd04462e",22851777,1,1,0,1372,361,362,1
"ab8fdad974ae471f9f24c3f9dd04462e","ab8fdad974ae471f9f24c3f9dd04462e",22851777,4,0,1,1373,362,362,0
"ab8fdad974ae471f9f24c3f9dd04462e","1ba8fef685d74a8194b9db252eb704fb",22851777,1,-7,0,1375,362,355,-7
"1ba8fef685d74a8194b9db252eb704fb","52580888dadb4fe3baa795683ea227bd",22851777,4,10,0,1376,355,364,9
"52580888dadb4fe3baa795683ea227bd","52580888dadb4fe3baa795683ea227bd",22851777,2,0,1,1377,364,364,0
"52580888dadb4fe3baa795683ea227bd","492a3bc6a1254f23a7998587961b22a4",22851777,1,3,0,1378,364,366,2
"492a3bc6a1254f23a7998587961b22a4","f00179e251a045b39c3f7a54f9aa4acc",22851777,1,-4,0,1379,366,363,-3
"f00179e251a045b39c3f7a54f9aa4acc","492a3bc6a1254f23a7998587961b22a4",22851777,4,4,0,1380,363,366,3
"492a3bc6a1254f23a7998587961b22a4","072a190fd302456290895f9f04d6940a",22851777,5,-1,0,1381,366,365,-1
"072a190fd302456290895f9f04d6940a","c76574d21bc14aeea7ecd0b027f39858",22851777,1,3,0,1382,365,367,2
"c76574d21bc14aeea7ecd0b027f39858","492a3bc6a1254f23a7998587961b22a4",22851777,1,-2,0,1383,367,366,-1
"072a190fd302456290895f9f04d6940a","52580888dadb4fe3baa795683ea227bd",22851777,1,-2,0,1385,365,364,-1
"52580888dadb4fe3baa795683ea227bd","2fe14166dc9642c3bc666b86a57f943d",22851777,1,-8,0,1386,364,357,-7
"2fe14166dc9642c3bc666b86a57f943d","f00179e251a045b39c3f7a54f9aa4acc",22851777,1,7,0,1387,357,363,6
"f00179e251a045b39c3f7a54f9aa4acc","1ba8fef685d74a8194b9db252eb704fb",22851777,1,-9,0,1388,363,355,-8
"52580888dadb4fe3baa795683ea227bd","f00179e251a045b39c3f7a54f9aa4acc",22851777,3,-1,0,1390,364,363,-1
"072a190fd302456290895f9f04d6940a","cfa457d1743848e4bb5e4beced6448ed",22851777,2,5,0,1393,365,369,4
"cfa457d1743848e4bb5e4beced6448ed","cfa457d1743848e4bb5e4beced6448ed",22851777,2,0,1,1394,369,369,0
"cfa457d1743848e4bb5e4beced6448ed","b71bac264efb4abd97015447bd490db6",22851777,2,3,0,1395,369,370,1
"b71bac264efb4abd97015447bd490db6","30ead9794d4847abaf222ca966cc8630",22851777,3,-28,0,1396,370,348,-22
"30ead9794d4847abaf222ca966cc8630","b71bac264efb4abd97015447bd490db6",22851777,1,28,0,1397,348,370,22
"b71bac264efb4abd97015447bd490db6","8d448d625b024c82a5eb240bbd7431d6",22851777,10,5,0,1398,370,374,4
"8d448d625b024c82a5eb240bbd7431d6","8d448d625b024c82a5eb240bbd7431d6",22851777,114,0,1,1399,374,374,0
"8d448d625b024c82a5eb240bbd7431d6","b71bac264efb4abd97015447bd490db6",22851777,7,-5,0,1406,374,370,-4
"b71bac264efb4abd97015447bd490db6","d6d02b6ef04e4f17805504500b8ce441",22851777,3,8,0,1407,370,375,5
"d6d02b6ef04e4f17805504500b8ce441","d6d02b6ef04e4f17805504500b8ce441",22851777,8,0,1,1408,375,375,0
"d6d02b6ef04e4f17805504500b8ce441","4a29443515bb404cb8924e1c60a63b73",22851777,2,-118,0,1409,375,285,-90
"4a29443515bb404cb8924e1c60a63b73","7028800abe7d4e27b613d1d6cbe26bf7",22851777,1,-30,0,1410,285,267,-18
"7028800abe7d4e27b613d1d6cbe26bf7","2ae94c0cea4d480a9d5dca8fb1d7b542",22851777,2,-30,0,1411,267,242,-25
"2ae94c0cea4d480a9d5dca8fb1d7b542","7028800abe7d4e27b613d1d6cbe26bf7",22851777,1,30,0,1412,242,267,25
"7028800abe7d4e27b613d1d6cbe26bf7","7aa76d3e993840d8805f097cbdbcd44b",22851777,1,-7,0,1413,267,261,-6
"7aa76d3e993840d8805f097cbdbcd44b","0d987bed3ffa4ed0b9a2e62e97b7b30f",22851777,1,15,0,1414,261,272,11
"0d987bed3ffa4ed0b9a2e62e97b7b30f","b8b9418ab322418d9db9b40d96af873a",22851777,1,89,0,1428,272,337,65
"b8b9418ab322418d9db9b40d96af873a","0c4079457ede49e3aeb5e86ed84bdf35",22851777,4,-9,0,1429,337,329,-8
"bbc5139ca9024389a94db3a6f47dcff6","0c4079457ede49e3aeb5e86ed84bdf35",22851777,1,-14,0,1432,341,329,-12
"0c4079457ede49e3aeb5e86ed84bdf35","0c7262dff33c4087bc660ccf40f92f9c",22851777,1,-215,0,1433,329,169,-160
"0c7262dff33c4087bc660ccf40f92f9c","b42cc17b7de840f181a704558d0bc845",22851777,4,7,0,1434,169,175,6
"b42cc17b7de840f181a704558d0bc845","0c7262dff33c4087bc660ccf40f92f9c",22851777,3,-7,0,1435,175,169,-6
"0c7262dff33c4087bc660ccf40f92f9c","b8b9418ab322418d9db9b40d96af873a",22851777,1,224,0,1436,169,337,168
"bbc5139ca9024389a94db3a6f47dcff6","c2490bc612d146edbe786556fab3651b",22851777,2,-1,0,1440,341,340,-1
"c2490bc612d146edbe786556fab3651b","4a29443515bb404cb8924e1c60a63b73",22851777,2,-71,0,1441,340,285,-55
"4a29443515bb404cb8924e1c60a63b73","1ba8fef685d74a8194b9db252eb704fb",22851777,1,90,0,1442,285,355,70
"1ba8fef685d74a8194b9db252eb704fb","30ead9794d4847abaf222ca966cc8630",22851777,2,-8,0,1443,355,348,-7
"44421dd1e13a47a388c4a19834b744c7","ab8fdad974ae471f9f24c3f9dd04462e",22851777,1,3,0,1448,359,362,3
"ab8fdad974ae471f9f24c3f9dd04462e","44421dd1e13a47a388c4a19834b744c7",22851777,1,-3,0,1451,362,359,-3
"44421dd1e13a47a388c4a19834b744c7","1ba8fef685d74a8194b9db252eb704fb",22851777,1,-4,0,1454,359,355,-4
"52580888dadb4fe3baa795683ea227bd","30ead9794d4847abaf222ca966cc8630",22851777,1,-18,0,1456,364,348,-16
"30ead9794d4847abaf222ca966cc8630","1b4550d0dab04078b3bf08a655345bdc",22851777,1,32,0,1457,348,373,25
"1b4550d0dab04078b3bf08a655345bdc","b71bac264efb4abd97015447bd490db6",22851777,5,-4,0,1458,373,370,-3
"8d448d625b024c82a5eb240bbd7431d6","1b4550d0dab04078b3bf08a655345bdc",22851777,1,-1,0,1467,374,373,-1
"1b4550d0dab04078b3bf08a655345bdc","8d448d625b024c82a5eb240bbd7431d6",22851777,2,1,0,1468,373,374,1
"b71bac264efb4abd97015447bd490db6","b71bac264efb4abd97015447bd490db6",22851777,1,0,1,1478,370,370,0
"8d448d625b024c82a5eb240bbd7431d6","4a29443515bb404cb8924e1c60a63b73",22851777,1,-115,0,1488,374,285,-89
"4a29443515bb404cb8924e1c60a63b73","0c4079457ede49e3aeb5e86ed84bdf35",22851777,2,58,0,1489,285,329,44
"0c4079457ede49e3aeb5e86ed84bdf35","0c4079457ede49e3aeb5e86ed84bdf35",22851777,2,0,1,1490,329,329,0
"38aea304b4fa46e1b29bb72f5cea4c93","0c4079457ede49e3aeb5e86ed84bdf35",22851777,2,-2,0,1492,331,329,-2
"0c4079457ede49e3aeb5e86ed84bdf35","3434c10e561d488a914e0f7d71907abd",22851777,1,-31,0,1493,329,305,-24
"3434c10e561d488a914e0f7d71907abd","3434c10e561d488a914e0f7d71907abd",22851777,1,0,1,1494,305,305,0
"0c4079457ede49e3aeb5e86ed84bdf35","bbc5139ca9024389a94db3a6f47dcff6",22851777,2,14,0,1498,329,341,12
"bbc5139ca9024389a94db3a6f47dcff6","b8b9418ab322418d9db9b40d96af873a",22851777,2,-5,0,1499,341,337,-4
"b8b9418ab322418d9db9b40d96af873a","c2490bc612d146edbe786556fab3651b",22851777,2,4,0,1500,337,340,3
"c2490bc612d146edbe786556fab3651b","30ead9794d4847abaf222ca966cc8630",22851777,1,11,0,1501,340,348,8
"30ead9794d4847abaf222ca966cc8630","0c4079457ede49e3aeb5e86ed84bdf35",22851777,2,-24,0,1502,348,329,-19
"0c4079457ede49e3aeb5e86ed84bdf35","09b9678ddc3d452ea4a3d46e15826065",22851777,1,29,0,1503,329,353,24
"09b9678ddc3d452ea4a3d46e15826065","c20993c944444fe085345591a8bd837e",22851777,1,-2,0,1504,353,351,-2
"c20993c944444fe085345591a8bd837e","09b9678ddc3d452ea4a3d46e15826065",22851777,3,2,0,1505,351,353,2
"eff0de7f2dbb42dfa1a2e686efab5b6d","897b7f51242c44aab2205c72fdcbf4cd",22851777,1,-2,0,1507,354,352,-2
"897b7f51242c44aab2205c72fdcbf4cd","c20993c944444fe085345591a8bd837e",22851777,2,-1,0,1509,352,351,-1
"c20993c944444fe085345591a8bd837e","eff0de7f2dbb42dfa1a2e686efab5b6d",22851777,1,3,0,1510,351,354,3
"eff0de7f2dbb42dfa1a2e686efab5b6d","4a29443515bb404cb8924e1c60a63b73",22851777,1,-88,0,1515,354,285,-69
"38aea304b4fa46e1b29bb72f5cea4c93","4a29443515bb404cb8924e1c60a63b73",22851777,1,-60,0,1520,331,285,-46
"4a29443515bb404cb8924e1c60a63b73","1b4550d0dab04078b3bf08a655345bdc",22851777,1,114,0,1521,285,373,88
"d6d02b6ef04e4f17805504500b8ce441","0c7262dff33c4087bc660ccf40f92f9c",22851777,1,-275,0,1579,375,169,-206
"0c7262dff33c4087bc660ccf40f92f9c","b71bac264efb4abd97015447bd490db6",22851777,1,267,0,1582,169,370,201
"b71bac264efb4abd97015447bd490db6","1b4550d0dab04078b3bf08a655345bdc",22851777,1,4,0,1583,370,373,3
"8d448d625b024c82a5eb240bbd7431d6","0c7262dff33c4087bc660ccf40f92f9c",22851777,1,-272,0,1592,374,169,-205
"b42cc17b7de840f181a704558d0bc845","1b4550d0dab04078b3bf08a655345bdc",22851777,1,264,0,1594,175,373,198
"8d448d625b024c82a5eb240bbd7431d6","66baf19b6b904b70922329068c63746d",22851777,1,7,0,1606,374,376,2
"66baf19b6b904b70922329068c63746d","7f544639412e40a9ba27f43b415362ab",22851777,6,2,0,1607,376,378,2
"7f544639412e40a9ba27f43b415362ab","66baf19b6b904b70922329068c63746d",22851777,3,-2,0,1608,378,376,-2
"66baf19b6b904b70922329068c63746d","b8b9418ab322418d9db9b40d96af873a",22851777,1,-55,0,1609,376,337,-39
"4a29443515bb404cb8924e1c60a63b73","6e83e23f56544a19b94067c1c558d9c0",22851777,1,-54,0,1617,285,247,-38
"6e83e23f56544a19b94067c1c558d9c0","2ae94c0cea4d480a9d5dca8fb1d7b542",22851777,1,-6,0,1618,247,242,-5
"2ae94c0cea4d480a9d5dca8fb1d7b542","30c9ba177afc49a695625d2bdec40207",22851777,1,9,0,1619,242,250,8
"30c9ba177afc49a695625d2bdec40207","30c9ba177afc49a695625d2bdec40207",22851777,2,0,1,1620,250,250,0
"30c9ba177afc49a695625d2bdec40207","6e83e23f56544a19b94067c1c558d9c0",22851777,1,-3,0,1622,250,247,-3
"00f61990949545828dd12f1303d47504","2ae94c0cea4d480a9d5dca8fb1d7b542",22851777,1,-17,0,1624,256,242,-14
"2ae94c0cea4d480a9d5dca8fb1d7b542","6e83e23f56544a19b94067c1c558d9c0",22851777,1,6,0,1626,242,247,5
"6e83e23f56544a19b94067c1c558d9c0","0c7262dff33c4087bc660ccf40f92f9c",22851777,1,-103,0,1627,247,169,-78
"0c7262dff33c4087bc660ccf40f92f9c","0d987bed3ffa4ed0b9a2e62e97b7b30f",22851777,1,135,0,1628,169,272,103
"0d987bed3ffa4ed0b9a2e62e97b7b30f","0d987bed3ffa4ed0b9a2e62e97b7b30f",22851777,2,0,1,1629,272,272,0
"82ae07bc0c9b4570a41799290d1ef399","bc5524e78a8544e2ae2fdc2f3462bbec",22851777,1,5,0,1640,275,279,4
"bc5524e78a8544e2ae2fdc2f3462bbec","bb5a47f5ea01454a8b79455422d3b9da",22851777,2,1,0,1641,279,280,1
"bb5a47f5ea01454a8b79455422d3b9da","bc5524e78a8544e2ae2fdc2f3462bbec",22851777,1,-1,0,1650,280,279,-1
"bc5524e78a8544e2ae2fdc2f3462bbec","82ae07bc0c9b4570a41799290d1ef399",22851777,1,-5,0,1651,279,275,-4
"82ae07bc0c9b4570a41799290d1ef399","0d987bed3ffa4ed0b9a2e62e97b7b30f",22851777,1,-4,0,1652,275,272,-3
"a37477c4e4c14169ad44b06b493007f6","66baf19b6b904b70922329068c63746d",22851777,1,129,0,1715,283,376,93
"66baf19b6b904b70922329068c63746d","66baf19b6b904b70922329068c63746d",22851777,5,0,1,1716,376,376,0
"7f544639412e40a9ba27f43b415362ab","7f544639412e40a9ba27f43b415362ab",22851777,1,0,1,1718,378,378,0
"7f544639412e40a9ba27f43b415362ab","d5ae8642e15b46b8bd298b02274d4e9c",22851777,1,2,0,1719,378,380,2
"d5ae8642e15b46b8bd298b02274d4e9c","d5ae8642e15b46b8bd298b02274d4e9c",22851777,1,0,1,1720,380,380,0
"d5ae8642e15b46b8bd298b02274d4e9c","a0d10309a2dd456289147f84be9d37f9",22851777,1,1,0,1721,380,381,1
"a0d10309a2dd456289147f84be9d37f9","a0d10309a2dd456289147f84be9d37f9",22851777,2,0,1,1722,381,381,0
"a0d10309a2dd456289147f84be9d37f9","0fcbc3ca07b144138b8d85da581f09a8",22851777,1,1,0,1724,381,382,1
"0fcbc3ca07b144138b8d85da581f09a8","0fcbc3ca07b144138b8d85da581f09a8",22851777,8,0,1,1725,382,382,0
"0fcbc3ca07b144138b8d85da581f09a8","66baf19b6b904b70922329068c63746d",22851777,1,-6,0,1733,382,376,-6
"66baf19b6b904b70922329068c63746d","c2fca3669923477ab966ded303dea31c",22851777,1,8,0,1734,376,383,7
"c2fca3669923477ab966ded303dea31c","4890121ce5d74576b4632b77cfc23398",22851777,1,6,0,1735,383,388,5
"4890121ce5d74576b4632b77cfc23398","4890121ce5d74576b4632b77cfc23398",22851777,1,0,1,1736,388,388,0
"4890121ce5d74576b4632b77cfc23398","96bb2b3e85a34d8b9544514e89f6fe97",22851777,1,3,0,1737,388,390,2
"96bb2b3e85a34d8b9544514e89f6fe97","18d3b836dd804224883cc9180b60a8e1",22851777,1,-4,0,1738,390,387,-3
"18d3b836dd804224883cc9180b60a8e1","96bb2b3e85a34d8b9544514e89f6fe97",22851777,2,4,0,1739,387,390,3
"96bb2b3e85a34d8b9544514e89f6fe97","ac4e9b54acfe4670b4634859c7263cb5",22851777,1,2,0,1740,390,392,2
"ac4e9b54acfe4670b4634859c7263cb5","ac4e9b54acfe4670b4634859c7263cb5",22851777,1,0,1,1741,392,392,0
"ac4e9b54acfe4670b4634859c7263cb5","17f95d18bab743888e1736033dc3384d",22851777,1,-3,0,1742,392,389,-3
"17f95d18bab743888e1736033dc3384d","6f8881a745ac4c358a68b92c3b4abe81",22851777,1,6,0,1743,389,394,5
"6f8881a745ac4c358a68b92c3b4abe81","6f8881a745ac4c358a68b92c3b4abe81",22851777,1,0,1,1744,394,394,0
"6f8881a745ac4c358a68b92c3b4abe81","f7002c8484354eceac57bc7bd62c76c1",22851777,2,-1,0,1745,394,393,-1
"f7002c8484354eceac57bc7bd62c76c1","6f8881a745ac4c358a68b92c3b4abe81",22851777,2,1,0,1746,393,394,1
"6f8881a745ac4c358a68b92c3b4abe81","0c12af0a4e7f4002852cf84b2537c161",22851777,3,2,0,1747,394,395,1
"0c12af0a4e7f4002852cf84b2537c161","f7002c8484354eceac57bc7bd62c76c1",22851777,2,-3,0,1748,395,393,-2
"f7002c8484354eceac57bc7bd62c76c1","66baf19b6b904b70922329068c63746d",22851777,1,-21,0,1752,393,376,-17
"66baf19b6b904b70922329068c63746d","0c12af0a4e7f4002852cf84b2537c161",22851777,2,24,0,1755,376,395,19
"0c12af0a4e7f4002852cf84b2537c161","66baf19b6b904b70922329068c63746d",22851777,2,-24,0,1756,395,376,-19
"66baf19b6b904b70922329068c63746d","6f8881a745ac4c358a68b92c3b4abe81",22851777,1,22,0,1757,376,394,18
"0c12af0a4e7f4002852cf84b2537c161","6f8881a745ac4c358a68b92c3b4abe81",22851777,1,-2,0,1759,395,394,-1
"f7002c8484354eceac57bc7bd62c76c1","44a277ea44dc4ae689fab4b82f0b4098",22851777,1,5,0,1761,393,397,4
"44a277ea44dc4ae689fab4b82f0b4098","44a277ea44dc4ae689fab4b82f0b4098",22851777,1,0,1,1762,397,397,0
"44a277ea44dc4ae689fab4b82f0b4098","0c12af0a4e7f4002852cf84b2537c161",22851777,1,-2,0,1763,397,395,-2
"0c12af0a4e7f4002852cf84b2537c161","859e0b8d71694b12befb69ee698138f9",22851777,1,5,0,1766,395,399,4
"859e0b8d71694b12befb69ee698138f9","859e0b8d71694b12befb69ee698138f9",22851777,1,0,1,1767,399,399,0
"859e0b8d71694b12befb69ee698138f9","66baf19b6b904b70922329068c63746d",22851777,1,-29,0,1768,399,376,-23
"66baf19b6b904b70922329068c63746d","2b09a08242b54983aec7063990fb3f66",22851777,2,32,0,1769,376,400,24
"2b09a08242b54983aec7063990fb3f66","2b09a08242b54983aec7063990fb3f66",22851777,4,0,1,1770,400,400,0
"2b09a08242b54983aec7063990fb3f66","1f471b7a883a4df48211e8c6a81b59a7",22851777,1,1,0,1772,400,401,1
"1f471b7a883a4df48211e8c6a81b59a7","1f471b7a883a4df48211e8c6a81b59a7",22851777,1,0,1,1773,401,401,0
"1f471b7a883a4df48211e8c6a81b59a7","2b09a08242b54983aec7063990fb3f66",22851777,1,-1,0,1774,401,400,-1
"2b09a08242b54983aec7063990fb3f66","9de0d567bfa84fe5b77cb76f4a76a5d1",22851777,1,5,0,1775,400,404,4
"9de0d567bfa84fe5b77cb76f4a76a5d1","9de0d567bfa84fe5b77cb76f4a76a5d1",22851777,1,0,1,1776,404,404,0
"9de0d567bfa84fe5b77cb76f4a76a5d1","1157bd665ec4472fb58b751dc5099355",22851777,1,-1,0,1777,404,403,-1
"1157bd665ec4472fb58b751dc5099355","3c8a22d2f9c146ea956609e3ed4f2559",22851777,1,3,0,1778,403,405,2
"3c8a22d2f9c146ea956609e3ed4f2559","58fc9094275e4c49be3f4ba6d4acc0a4",22851777,1,2,0,1779,405,406,1
"58fc9094275e4c49be3f4ba6d4acc0a4","58fc9094275e4c49be3f4ba6d4acc0a4",22851777,1,0,1,1780,406,406,0
"58fc9094275e4c49be3f4ba6d4acc0a4","c1c1be90b2b14c1ab4a5e1ee3c241902",22851777,1,1,0,1781,406,407,1
"c1c1be90b2b14c1ab4a5e1ee3c241902","c1c1be90b2b14c1ab4a5e1ee3c241902",22851777,5,0,1,1782,407,407,0
"c1c1be90b2b14c1ab4a5e1ee3c241902","58fc9094275e4c49be3f4ba6d4acc0a4",22851777,1,-1,0,1787,407,406,-1
"58fc9094275e4c49be3f4ba6d4acc0a4","02b3a1bead9244c1ba2f857c7da8f82a",22851777,1,3,0,1788,406,408,2
"02b3a1bead9244c1ba2f857c7da8f82a","66baf19b6b904b70922329068c63746d",22851777,1,-44,0,1789,408,376,-32
"66baf19b6b904b70922329068c63746d","7028800abe7d4e27b613d1d6cbe26bf7",22851777,1,-152,0,1790,376,267,-109
"2ae94c0cea4d480a9d5dca8fb1d7b542","865a4d3b43374da7944dc7d397f566d9",22851777,1,35,0,1792,242,271,29
"865a4d3b43374da7944dc7d397f566d9","0c7262dff33c4087bc660ccf40f92f9c",22851777,1,-132,0,1794,271,169,-102
"0c7262dff33c4087bc660ccf40f92f9c","1b4550d0dab04078b3bf08a655345bdc",22851777,1,271,0,1795,169,373,204
"8d448d625b024c82a5eb240bbd7431d6","0d987bed3ffa4ed0b9a2e62e97b7b30f",22851777,1,-137,0,1805,374,272,-102
"0d987bed3ffa4ed0b9a2e62e97b7b30f","bc5524e78a8544e2ae2fdc2f3462bbec",22851777,1,9,0,1806,272,279,7
"bb5a47f5ea01454a8b79455422d3b9da","8959e6304a0348309a771e4d08d1b64a",22851777,1,-158,0,1817,280,163,-117
"8959e6304a0348309a771e4d08d1b64a","78adeee1fa2c4fe0bc73f7bca9fcee86",22851777,2,-4,0,1818,163,160,-3
"65202579580f4ad38d734b4ee39d22a8","2b09a08242b54983aec7063990fb3f66",22851777,1,323,0,1827,164,400,236
"2b09a08242b54983aec7063990fb3f66","02b3a1bead9244c1ba2f857c7da8f82a",22851777,1,12,0,1828,400,408,8
"02b3a1bead9244c1ba2f857c7da8f82a","02b3a1bead9244c1ba2f857c7da8f82a",22851777,2,0,1,1829,408,408,0
"02b3a1bead9244c1ba2f857c7da8f82a","6206fc6479014bb193084c32409dc1b9",22851777,1,1,0,1831,408,409,1
"6206fc6479014bb193084c32409dc1b9","6206fc6479014bb193084c32409dc1b9",22851777,9,0,1,1832,409,409,0
"6206fc6479014bb193084c32409dc1b9","02b3a1bead9244c1ba2f857c7da8f82a",22851777,1,-1,0,1841,409,408,-1
"02b3a1bead9244c1ba2f857c7da8f82a","6a5f020451db426dacba9e2ea3fcc62a",22851777,1,3,0,1842,408,410,2
"6a5f020451db426dacba9e2ea3fcc62a","6a5f020451db426dacba9e2ea3fcc62a",22851777,2,0,1,1843,410,410,0
"6a5f020451db426dacba9e2ea3fcc62a","33a9d248b2e44588a5b07fc1342b9bc2",22851777,1,2,0,1845,410,411,1
"33a9d248b2e44588a5b07fc1342b9bc2","33a9d248b2e44588a5b07fc1342b9bc2",22851777,1,0,1,1846,411,411,0
"33a9d248b2e44588a5b07fc1342b9bc2","c6f26bd420634f1cb7989e76fe6b16c0",22851777,1,1,0,1847,411,412,1
"c6f26bd420634f1cb7989e76fe6b16c0","c6f26bd420634f1cb7989e76fe6b16c0",22851777,5,0,1,1848,412,412,0
"c6f26bd420634f1cb7989e76fe6b16c0","2a65ee6e2ac64f6a8a55fbe5373ec763",22851777,1,1,0,1853,412,413,1
"2a65ee6e2ac64f6a8a55fbe5373ec763","2a65ee6e2ac64f6a8a55fbe5373ec763",22851777,2,0,1,1854,413,413,0
"2a65ee6e2ac64f6a8a55fbe5373ec763","33a9d248b2e44588a5b07fc1342b9bc2",22851777,1,-2,0,1856,413,411,-2
"33a9d248b2e44588a5b07fc1342b9bc2","1fd0f6dadbc14ebc965faf6122190b96",22851777,1,5,0,1857,411,415,4
"1fd0f6dadbc14ebc965faf6122190b96","1fd0f6dadbc14ebc965faf6122190b96",22851777,1,0,1,1858,415,415,0
"1fd0f6dadbc14ebc965faf6122190b96","687055dad9fc40c3982478fe33ec01bf",22851777,1,-1,0,1859,415,414,-1
"687055dad9fc40c3982478fe33ec01bf","7aa76d3e993840d8805f097cbdbcd44b",22851777,1,-212,0,1860,414,261,-153
"7aa76d3e993840d8805f097cbdbcd44b","2ae94c0cea4d480a9d5dca8fb1d7b542",22851777,1,-23,0,1861,261,242,-19
"2ae94c0cea4d480a9d5dca8fb1d7b542","2add1669f08d4101913db15f8c23b3b7",22851777,1,238,0,1862,242,416,174
"2add1669f08d4101913db15f8c23b3b7","2b09a08242b54983aec7063990fb3f66",22851777,1,-24,0,1863,416,400,-16
"2b09a08242b54983aec7063990fb3f66","2add1669f08d4101913db15f8c23b3b7",22851777,1,24,0,1864,400,416,16
"2add1669f08d4101913db15f8c23b3b7","2add1669f08d4101913db15f8c23b3b7",22851777,1,0,1,1865,416,416,0
"2add1669f08d4101913db15f8c23b3b7","a2b4bd40cee2481ebd3fc179d6a5cd62",22851777,1,3,0,1866,416,417,1
"a2b4bd40cee2481ebd3fc179d6a5cd62","2b09a08242b54983aec7063990fb3f66",22851777,1,-27,0,1867,417,400,-17
"2b09a08242b54983aec7063990fb3f66","e34e59dce2204f228f3a84b6725df60f",22851777,1,29,0,1868,400,419,19
"e34e59dce2204f228f3a84b6725df60f","e34e59dce2204f228f3a84b6725df60f",22851777,1,0,1,1869,419,419,0
"e34e59dce2204f228f3a84b6725df60f","a2b4bd40cee2481ebd3fc179d6a5cd62",22851777,1,-2,0,1870,419,417,-2
"a2b4bd40cee2481ebd3fc179d6a5cd62","bec48fc2e1294c7eb3d0aca780d731b8",22851777,1,4,0,1871,417,420,3
"bec48fc2e1294c7eb3d0aca780d731b8","bec48fc2e1294c7eb3d0aca780d731b8",22851777,2,0,1,1872,420,420,0
"bec48fc2e1294c7eb3d0aca780d731b8","a24600b0e49245f6bdba8c893cfeddb0",22851777,1,7,0,1874,420,425,5
"a24600b0e49245f6bdba8c893cfeddb0","dbde19fcce2a4c1abdc7f685c293a23f",22851777,1,-4,0,1875,425,422,-3
"dbde19fcce2a4c1abdc7f685c293a23f","a24600b0e49245f6bdba8c893cfeddb0",22851777,1,4,0,1876,422,425,3
"a24600b0e49245f6bdba8c893cfeddb0","a24600b0e49245f6bdba8c893cfeddb0",22851777,1,0,1,1877,425,425,0
"a24600b0e49245f6bdba8c893cfeddb0","24cf8786024543f19b89bc20034e60d7",22851777,1,7,0,1878,425,428,3
"24cf8786024543f19b89bc20034e60d7","a2b4bd40cee2481ebd3fc179d6a5cd62",22851777,1,-18,0,1879,428,417,-11
"a2b4bd40cee2481ebd3fc179d6a5cd62","f2a73be2f46840b182d7bd095378004e",22851777,1,19,0,1880,417,429,12
"f2a73be2f46840b182d7bd095378004e","66baf19b6b904b70922329068c63746d",22851777,2,-78,0,1881,429,376,-53
"66baf19b6b904b70922329068c63746d","24cf8786024543f19b89bc20034e60d7",22851777,1,77,0,1882,376,428,52
"24cf8786024543f19b89bc20034e60d7","24cf8786024543f19b89bc20034e60d7",22851777,1,0,1,1883,428,428,0
"24cf8786024543f19b89bc20034e60d7","f2a73be2f46840b182d7bd095378004e",22851777,2,1,0,1884,428,429,1
"f2a73be2f46840b182d7bd095378004e","f2a73be2f46840b182d7bd095378004e",22851777,1,0,1,1885,429,429,0
"f2a73be2f46840b182d7bd095378004e","604551fd4266430cb860fef58fa7dd61",22851777,1,1,0,1886,429,430,1
"604551fd4266430cb860fef58fa7dd61","604551fd4266430cb860fef58fa7dd61",22851777,9,0,1,1887,430,430,0
"604551fd4266430cb860fef58fa7dd61","24cf8786024543f19b89bc20034e60d7",22851777,1,-2,0,1896,430,428,-2
"24cf8786024543f19b89bc20034e60d7","dce46f8904594a62a6377a3587aaa663",22851777,2,4,0,1897,428,431,3
"dce46f8904594a62a6377a3587aaa663","dce46f8904594a62a6377a3587aaa663",22851777,1,0,1,1898,431,431,0
"dce46f8904594a62a6377a3587aaa663","9b9d0a249052413c869753b99682b0ac",22851777,2,1,0,1899,431,432,1
"9b9d0a249052413c869753b99682b0ac","9b9d0a249052413c869753b99682b0ac",22851777,2,0,1,1900,432,432,0
"9b9d0a249052413c869753b99682b0ac","061c175cc90f45fbad883025394e78dd",22851777,1,1,0,1901,432,433,1
"061c175cc90f45fbad883025394e78dd","061c175cc90f45fbad883025394e78dd",22851777,5,0,1,1902,433,433,0
"061c175cc90f45fbad883025394e78dd","dce46f8904594a62a6377a3587aaa663",22851777,1,-2,0,1907,433,431,-2
"dce46f8904594a62a6377a3587aaa663","74a7f8712e5449c2bc0b43c6f90dafed",22851777,2,5,0,1908,431,435,4
"74a7f8712e5449c2bc0b43c6f90dafed","74a7f8712e5449c2bc0b43c6f90dafed",22851777,2,0,1,1909,435,435,0
"74a7f8712e5449c2bc0b43c6f90dafed","66ada10dde9f43018588f1ced9d477fc",22851777,2,-1,0,1910,435,434,-1
"66ada10dde9f43018588f1ced9d477fc","24cf8786024543f19b89bc20034e60d7",22851777,2,-8,0,1911,434,428,-6
"66baf19b6b904b70922329068c63746d","66ada10dde9f43018588f1ced9d477fc",22851777,1,85,0,1914,376,434,58
"24cf8786024543f19b89bc20034e60d7","66ada10dde9f43018588f1ced9d477fc",22851777,1,8,0,1916,428,434,6
"66ada10dde9f43018588f1ced9d477fc","bf12c96466d840a69bed7020b3f18bb8",22851777,2,3,0,1917,434,436,2
"bf12c96466d840a69bed7020b3f18bb8","bf12c96466d840a69bed7020b3f18bb8",22851777,2,0,1,1918,436,436,0
"bf12c96466d840a69bed7020b3f18bb8","070600601c4c439288445d2f0724807d",22851777,1,3,0,1919,436,437,1
"070600601c4c439288445d2f0724807d","24cf8786024543f19b89bc20034e60d7",22851777,1,-14,0,1920,437,428,-9
"24cf8786024543f19b89bc20034e60d7","1823b6de7d334a7aaabc4570719af4d9",22851777,1,16,0,1921,428,439,11
"1823b6de7d334a7aaabc4570719af4d9","1823b6de7d334a7aaabc4570719af4d9",22851777,16,0,1,1922,439,439,0
"1823b6de7d334a7aaabc4570719af4d9","0380cd76a7d44bc3a4da1f15e4d68f89",22851777,1,2,0,1938,439,440,1
"0380cd76a7d44bc3a4da1f15e4d68f89","070600601c4c439288445d2f0724807d",22851777,1,-4,0,1939,440,437,-3
"070600601c4c439288445d2f0724807d","0380cd76a7d44bc3a4da1f15e4d68f89",22851777,2,4,0,1940,437,440,3
"0380cd76a7d44bc3a4da1f15e4d68f89","23b7673c8b5443108c2ef09382834a86",22851777,2,2,0,1941,440,441,1
"23b7673c8b5443108c2ef09382834a86","0380cd76a7d44bc3a4da1f15e4d68f89",22851777,1,-2,0,1942,441,440,-1
"23b7673c8b5443108c2ef09382834a86","23b7673c8b5443108c2ef09382834a86",22851777,2,0,1,1944,441,441,0
"23b7673c8b5443108c2ef09382834a86","901e92500aea43c79f19f1b279050668",22851777,2,2,0,1945,441,442,1
"901e92500aea43c79f19f1b279050668","901e92500aea43c79f19f1b279050668",22851777,4,0,1,1946,442,442,0
"901e92500aea43c79f19f1b279050668","001339db8ced4cf78829ebe8b145449d",22851777,1,1,0,1947,442,443,1
"001339db8ced4cf78829ebe8b145449d","001339db8ced4cf78829ebe8b145449d",22851777,11,0,1,1948,443,443,0
"001339db8ced4cf78829ebe8b145449d","452745e0366e42ae81561bfddebcc6c3",22851777,1,1,0,1959,443,444,1
"452745e0366e42ae81561bfddebcc6c3","452745e0366e42ae81561bfddebcc6c3",22851777,7,0,1,1960,444,444,0
"452745e0366e42ae81561bfddebcc6c3","901e92500aea43c79f19f1b279050668",22851777,2,-2,0,1965,444,442,-2
"901e92500aea43c79f19f1b279050668","4660ff2089114e8db82ceb26a4f329e3",22851777,3,4,0,1966,442,445,3
"4660ff2089114e8db82ceb26a4f329e3","4660ff2089114e8db82ceb26a4f329e3",22851777,3,0,1,1967,445,445,0
"4660ff2089114e8db82ceb26a4f329e3","7bd5586eb9d8484eb74a433ee7bfe499",22851777,2,2,0,1969,445,446,1
"7bd5586eb9d8484eb74a433ee7bfe499","7bd5586eb9d8484eb74a433ee7bfe499",22851777,23,0,1,1970,446,446,0
"7bd5586eb9d8484eb74a433ee7bfe499","8a7f26e690f34dda97be16904518ca99",22851777,2,2,0,1992,446,447,1
"8a7f26e690f34dda97be16904518ca99","8a7f26e690f34dda97be16904518ca99",22851777,2,0,1,1993,447,447,0
"8a7f26e690f34dda97be16904518ca99","b2f0d654738f48158edff28e8d3a546e",22851777,1,5,0,1994,447,449,2
"b2f0d654738f48158edff28e8d3a546e","070600601c4c439288445d2f0724807d",22851777,1,-21,0,1995,449,437,-12
"070600601c4c439288445d2f0724807d","b2f0d654738f48158edff28e8d3a546e",22851777,2,21,0,1996,437,449,12
"b2f0d654738f48158edff28e8d3a546e","f60ee41ec635499abd48168342d32c2f",22851777,5,5,0,1997,449,453,4
"f60ee41ec635499abd48168342d32c2f","f60ee41ec635499abd48168342d32c2f",22851777,87,0,1,1998,453,453,0
"f60ee41ec635499abd48168342d32c2f","9428d8bd9c5a47b2a235b254e5e27ded",22851777,1,-1,0,2005,453,452,-1
"9428d8bd9c5a47b2a235b254e5e27ded","f60ee41ec635499abd48168342d32c2f",22851777,2,1,0,2006,452,453,1
"f60ee41ec635499abd48168342d32c2f","b2f0d654738f48158edff28e8d3a546e",22851777,2,-5,0,2014,453,449,-4
"f60ee41ec635499abd48168342d32c2f","f67fbf45a5f146ed866965bc57c7c001",22851777,1,3,0,2060,453,454,1
"f67fbf45a5f146ed866965bc57c7c001","b2f0d654738f48158edff28e8d3a546e",22851777,3,-8,0,2061,454,449,-5
"b2f0d654738f48158edff28e8d3a546e","f67fbf45a5f146ed866965bc57c7c001",22851777,2,8,0,2062,449,454,5
"f67fbf45a5f146ed866965bc57c7c001","f67fbf45a5f146ed866965bc57c7c001",22851777,5,0,1,2063,454,454,0
"f67fbf45a5f146ed866965bc57c7c001","d937afe49bd24a07a550dda1c1155122",22851777,1,1,0,2065,454,455,1
"d937afe49bd24a07a550dda1c1155122","d937afe49bd24a07a550dda1c1155122",22851777,4,0,1,2066,455,455,0
"d937afe49bd24a07a550dda1c1155122","3628b3f7823443d0912a339096b69943",22851777,1,1,0,2070,455,456,1
"3628b3f7823443d0912a339096b69943","3628b3f7823443d0912a339096b69943",22851777,1,0,1,2071,456,456,0
"3628b3f7823443d0912a339096b69943","9e049ee647cf43ecbcb5ed792a8e7588",22851777,1,1,0,2072,456,457,1
"9e049ee647cf43ecbcb5ed792a8e7588","9e049ee647cf43ecbcb5ed792a8e7588",22851777,1,0,1,2073,457,457,0
"9e049ee647cf43ecbcb5ed792a8e7588","5256a214faaf410b93f76cea06428334",22851777,1,1,0,2074,457,458,1
"5256a214faaf410b93f76cea06428334","5256a214faaf410b93f76cea06428334",22851777,1,0,1,2075,458,458,0
"5256a214faaf410b93f76cea06428334","25c32b120fce40fa9b6c85133aeb4716",22851777,1,1,0,2076,458,459,1
"25c32b120fce40fa9b6c85133aeb4716","25c32b120fce40fa9b6c85133aeb4716",22851777,1,0,1,2077,459,459,0
"25c32b120fce40fa9b6c85133aeb4716","11bc14f2204949008b7d511b933363c1",22851777,1,1,0,2078,459,460,1
"11bc14f2204949008b7d511b933363c1","11bc14f2204949008b7d511b933363c1",22851777,1,0,1,2079,460,460,0
"11bc14f2204949008b7d511b933363c1","42de338840a34d15adb66e7b14fb9d2c",22851777,1,1,0,2080,460,461,1
"42de338840a34d15adb66e7b14fb9d2c","42de338840a34d15adb66e7b14fb9d2c",22851777,1,0,1,2081,461,461,0
"42de338840a34d15adb66e7b14fb9d2c","9da37c6210b1416b8079c274f70bf600",22851777,1,1,0,2082,461,462,1
"9da37c6210b1416b8079c274f70bf600","9da37c6210b1416b8079c274f70bf600",22851777,2,0,1,2083,462,462,0
"9da37c6210b1416b8079c274f70bf600","66baf19b6b904b70922329068c63746d",22851777,1,-128,0,2084,462,376,-86
"66baf19b6b904b70922329068c63746d","4890121ce5d74576b4632b77cfc23398",22851777,1,14,0,2088,376,388,12
"4890121ce5d74576b4632b77cfc23398","c2fca3669923477ab966ded303dea31c",22851777,1,-6,0,2089,388,383,-5
"c2fca3669923477ab966ded303dea31c","18d3b836dd804224883cc9180b60a8e1",22851777,1,5,0,2090,383,387,4
"96bb2b3e85a34d8b9544514e89f6fe97","6f8881a745ac4c358a68b92c3b4abe81",22851777,1,5,0,2092,390,394,4
"6f8881a745ac4c358a68b92c3b4abe81","17f95d18bab743888e1736033dc3384d",22851777,1,-6,0,2093,394,389,-5
"17f95d18bab743888e1736033dc3384d","f7002c8484354eceac57bc7bd62c76c1",22851777,1,5,0,2094,389,393,4
"f7002c8484354eceac57bc7bd62c76c1","0c12af0a4e7f4002852cf84b2537c161",22851777,1,3,0,2095,393,395,2
"0c12af0a4e7f4002852cf84b2537c161","2b09a08242b54983aec7063990fb3f66",22851777,1,8,0,2096,395,400,5
"2b09a08242b54983aec7063990fb3f66","66baf19b6b904b70922329068c63746d",22851777,1,-32,0,2097,400,376,-24
"2b09a08242b54983aec7063990fb3f66","1157bd665ec4472fb58b751dc5099355",22851777,1,4,0,2102,400,403,3
"1157bd665ec4472fb58b751dc5099355","58fc9094275e4c49be3f4ba6d4acc0a4",22851777,1,5,0,2103,403,406,3
"58fc9094275e4c49be3f4ba6d4acc0a4","3c8a22d2f9c146ea956609e3ed4f2559",22851777,1,-2,0,2104,406,405,-1
"3c8a22d2f9c146ea956609e3ed4f2559","66baf19b6b904b70922329068c63746d",22851777,1,-39,0,2105,405,376,-29
"7f544639412e40a9ba27f43b415362ab","9da37c6210b1416b8079c274f70bf600",22851777,1,126,0,2109,378,462,84
"9da37c6210b1416b8079c274f70bf600","519119f1deac45ff9ab4f13529be5c6e",22851777,1,1,0,2111,462,463,1
"519119f1deac45ff9ab4f13529be5c6e","519119f1deac45ff9ab4f13529be5c6e",22851777,1,0,1,2112,463,463,0
"519119f1deac45ff9ab4f13529be5c6e","f67fbf45a5f146ed866965bc57c7c001",22851777,1,-9,0,2113,463,454,-9
"f67fbf45a5f146ed866965bc57c7c001","c5df9f40ec14463b9dcfdc73df3e9285",22851777,3,12,0,2114,454,464,10
"c5df9f40ec14463b9dcfdc73df3e9285","c5df9f40ec14463b9dcfdc73df3e9285",22851777,14,0,1,2115,464,464,0
"c5df9f40ec14463b9dcfdc73df3e9285","83d42d95cd844fc093fc09cee250edb8",22851777,4,3,0,2117,464,465,1
"83d42d95cd844fc093fc09cee250edb8","83d42d95cd844fc093fc09cee250edb8",22851777,6,0,1,2118,465,465,0
"83d42d95cd844fc093fc09cee250edb8","0c4079457ede49e3aeb5e86ed84bdf35",22851777,1,-199,0,2120,465,329,-136
"b8b9418ab322418d9db9b40d96af873a","a7c6339ca1da4368a18d471f0519f877",22851777,1,2,0,2122,337,339,2
"a7c6339ca1da4368a18d471f0519f877","38aea304b4fa46e1b29bb72f5cea4c93",22851777,1,-9,0,2123,339,331,-8
"38aea304b4fa46e1b29bb72f5cea4c93","b8b9418ab322418d9db9b40d96af873a",22851777,2,7,0,2124,331,337,6
"b8b9418ab322418d9db9b40d96af873a","d0a8f74af98642fe8360d22c42e45117",22851777,1,-2,0,2128,337,336,-1
"d0a8f74af98642fe8360d22c42e45117","fe49f8054b374a0ea4bb266ed135ff62",22851777,1,-1,0,2132,336,335,-1
"fe49f8054b374a0ea4bb266ed135ff62","0c4079457ede49e3aeb5e86ed84bdf35",22851777,1,-6,0,2135,335,329,-6
"c2490bc612d146edbe786556fab3651b","0c4079457ede49e3aeb5e86ed84bdf35",22851777,1,-13,0,2139,340,329,-11
"30ead9794d4847abaf222ca966cc8630","30ead9794d4847abaf222ca966cc8630",22851777,1,0,1,2141,348,348,0
"0c4079457ede49e3aeb5e86ed84bdf35","eff0de7f2dbb42dfa1a2e686efab5b6d",22851777,1,30,0,2143,329,354,25
"eff0de7f2dbb42dfa1a2e686efab5b6d","09b9678ddc3d452ea4a3d46e15826065",22851777,2,-1,0,2144,354,353,-1
"897b7f51242c44aab2205c72fdcbf4cd","1ba8fef685d74a8194b9db252eb704fb",22851777,1,4,0,2155,352,355,3
"2fe14166dc9642c3bc666b86a57f943d","4a29443515bb404cb8924e1c60a63b73",22851777,1,-92,0,2159,357,285,-72
"4a29443515bb404cb8924e1c60a63b73","072a190fd302456290895f9f04d6940a",22851777,1,102,0,2160,285,365,80
"072a190fd302456290895f9f04d6940a","30ead9794d4847abaf222ca966cc8630",22851777,1,-20,0,2161,365,348,-17
"30ead9794d4847abaf222ca966cc8630","1ba8fef685d74a8194b9db252eb704fb",22851777,1,8,0,2162,348,355,7
"492a3bc6a1254f23a7998587961b22a4","492a3bc6a1254f23a7998587961b22a4",22851777,2,0,1,2167,366,366,0
"30ead9794d4847abaf222ca966cc8630","8d448d625b024c82a5eb240bbd7431d6",22851777,1,33,0,2173,348,374,26
"d6d02b6ef04e4f17805504500b8ce441","66baf19b6b904b70922329068c63746d",22851777,1,4,0,2186,375,376,1
"7f544639412e40a9ba27f43b415362ab","dce46f8904594a62a6377a3587aaa663",22851777,1,79,0,2188,378,431,53
"dce46f8904594a62a6377a3587aaa663","24cf8786024543f19b89bc20034e60d7",22851777,1,-4,0,2189,431,428,-3
"9b9d0a249052413c869753b99682b0ac","dce46f8904594a62a6377a3587aaa663",22851777,1,-1,0,2193,432,431,-1
"bf12c96466d840a69bed7020b3f18bb8","24cf8786024543f19b89bc20034e60d7",22851777,1,-11,0,2199,436,428,-8
"24cf8786024543f19b89bc20034e60d7","070600601c4c439288445d2f0724807d",22851777,1,14,0,2200,428,437,9
"070600601c4c439288445d2f0724807d","1823b6de7d334a7aaabc4570719af4d9",22851777,1,2,0,2201,437,439,2
"1823b6de7d334a7aaabc4570719af4d9","070600601c4c439288445d2f0724807d",22851777,1,-2,0,2202,439,437,-2
"0380cd76a7d44bc3a4da1f15e4d68f89","66baf19b6b904b70922329068c63746d",22851777,1,-95,0,2204,440,376,-64
"66baf19b6b904b70922329068c63746d","901e92500aea43c79f19f1b279050668",22851777,1,99,0,2205,376,442,66
"901e92500aea43c79f19f1b279050668","070600601c4c439288445d2f0724807d",22851777,1,-8,0,2206,442,437,-5
"070600601c4c439288445d2f0724807d","901e92500aea43c79f19f1b279050668",22851777,2,8,0,2207,437,442,5
"901e92500aea43c79f19f1b279050668","452745e0366e42ae81561bfddebcc6c3",22851777,1,2,0,2208,442,444,2
"8a7f26e690f34dda97be16904518ca99","070600601c4c439288445d2f0724807d",22851777,1,-16,0,2218,447,437,-10
"f60ee41ec635499abd48168342d32c2f","66baf19b6b904b70922329068c63746d",22851777,2,-117,0,2229,453,376,-77
"66baf19b6b904b70922329068c63746d","23b7673c8b5443108c2ef09382834a86",22851777,1,97,0,2230,376,441,65
"23b7673c8b5443108c2ef09382834a86","070600601c4c439288445d2f0724807d",22851777,1,-6,0,2231,441,437,-4
"070600601c4c439288445d2f0724807d","23b7673c8b5443108c2ef09382834a86",22851777,1,6,0,2232,437,441,4
"4660ff2089114e8db82ceb26a4f329e3","66baf19b6b904b70922329068c63746d",22851777,1,-103,0,2238,445,376,-69
"66baf19b6b904b70922329068c63746d","f67fbf45a5f146ed866965bc57c7c001",22851777,2,120,0,2239,376,454,78
"c5df9f40ec14463b9dcfdc73df3e9285","f67fbf45a5f146ed866965bc57c7c001",22851777,2,-12,0,2242,464,454,-10
"83d42d95cd844fc093fc09cee250edb8","66baf19b6b904b70922329068c63746d",22851777,1,-135,0,2247,465,376,-89
"66baf19b6b904b70922329068c63746d","c5df9f40ec14463b9dcfdc73df3e9285",22851777,2,132,0,2248,376,464,88
"c5df9f40ec14463b9dcfdc73df3e9285","070600601c4c439288445d2f0724807d",22851777,1,-41,0,2251,464,437,-27
"901e92500aea43c79f19f1b279050668","66baf19b6b904b70922329068c63746d",22851777,1,-99,0,2254,442,376,-66
"66baf19b6b904b70922329068c63746d","f00179e251a045b39c3f7a54f9aa4acc",22851777,1,-23,0,2255,376,363,-13
"f00179e251a045b39c3f7a54f9aa4acc","30ead9794d4847abaf222ca966cc8630",22851777,1,-17,0,2256,363,348,-15
"30ead9794d4847abaf222ca966cc8630","52580888dadb4fe3baa795683ea227bd",22851777,1,18,0,2257,348,364,16
"072a190fd302456290895f9f04d6940a","b71bac264efb4abd97015447bd490db6",22851777,1,8,0,2262,365,370,5
"30ead9794d4847abaf222ca966cc8630","4a29443515bb404cb8924e1c60a63b73",22851777,1,-82,0,2264,348,285,-63
"4a29443515bb404cb8924e1c60a63b73","d6d02b6ef04e4f17805504500b8ce441",22851777,1,118,0,2265,285,375,90
"4a29443515bb404cb8924e1c60a63b73","c5df9f40ec14463b9dcfdc73df3e9285",22851777,1,254,0,2269,285,464,179
"83d42d95cd844fc093fc09cee250edb8","c5df9f40ec14463b9dcfdc73df3e9285",22851777,2,-3,0,2276,465,464,-1
"c5df9f40ec14463b9dcfdc73df3e9285","d6d02b6ef04e4f17805504500b8ce441",22851777,1,-136,0,2284,464,375,-89
"d6d02b6ef04e4f17805504500b8ce441","f67fbf45a5f146ed866965bc57c7c001",22851777,1,124,0,2287,375,454,79
"f67fbf45a5f146ed866965bc57c7c001","66baf19b6b904b70922329068c63746d",22851777,1,-120,0,2289,454,376,-78
"f60ee41ec635499abd48168342d32c2f","1b4550d0dab04078b3bf08a655345bdc",22851777,1,-125,0,2302,453,373,-80
"8d448d625b024c82a5eb240bbd7431d6","b2f0d654738f48158edff28e8d3a546e",22851777,1,119,0,2312,374,449,75
"b2f0d654738f48158edff28e8d3a546e","9428d8bd9c5a47b2a235b254e5e27ded",22851777,1,4,0,2313,449,452,3
"f67fbf45a5f146ed866965bc57c7c001","f60ee41ec635499abd48168342d32c2f",22851777,1,-3,0,2330,454,453,-1
"b613861cecf84ffcab01afb23f660475","b613861cecf84ffcab01afb23f660475",22852637,7,0,1,1,1,1,0
"b613861cecf84ffcab01afb23f660475","e2911e79efc2420eac45d9f671463d4b",22852637,1,3,0,7,1,2,1
"e2911e79efc2420eac45d9f671463d4b","e2911e79efc2420eac45d9f671463d4b",22852637,2,0,1,8,2,2,0
"e2911e79efc2420eac45d9f671463d4b","519d1b8c59404d67b54e96c5c8a830b2",22852637,1,1,0,10,2,3,1
"519d1b8c59404d67b54e96c5c8a830b2","519d1b8c59404d67b54e96c5c8a830b2",22852637,1,0,1,11,3,3,0
"519d1b8c59404d67b54e96c5c8a830b2","531db53f81f646edb0cdcfe0085b03b7",22852637,1,1,0,12,3,4,1
"531db53f81f646edb0cdcfe0085b03b7","531db53f81f646edb0cdcfe0085b03b7",22852637,1,0,1,13,4,4,0
"531db53f81f646edb0cdcfe0085b03b7","4f5f94b2f95141e0a9d53a61da2276da",22852637,1,1,0,14,4,5,1
"4f5f94b2f95141e0a9d53a61da2276da","4f5f94b2f95141e0a9d53a61da2276da",22852637,1,0,1,15,5,5,0
"4f5f94b2f95141e0a9d53a61da2276da","6d541c89590949f99af293c4f2333f67",22852637,1,1,0,16,5,6,1
"6d541c89590949f99af293c4f2333f67","6d541c89590949f99af293c4f2333f67",22852637,1,0,1,17,6,6,0
"6d541c89590949f99af293c4f2333f67","dd5cf0b9fe4c4f1d8f5ff8e4c04879cb",22852637,1,1,0,18,6,7,1
"dd5cf0b9fe4c4f1d8f5ff8e4c04879cb","dd5cf0b9fe4c4f1d8f5ff8e4c04879cb",22852637,1,0,1,19,7,7,0
"dd5cf0b9fe4c4f1d8f5ff8e4c04879cb","f96261861edc426abe2248be4f0a709a",22852637,1,1,0,20,7,8,1
"f96261861edc426abe2248be4f0a709a","f96261861edc426abe2248be4f0a709a",22852637,1,0,1,21,8,8,0
"f96261861edc426abe2248be4f0a709a","66b5e16f4f75454fb5b8172079f0fa83",22852637,1,1,0,22,8,9,1
"66b5e16f4f75454fb5b8172079f0fa83","66b5e16f4f75454fb5b8172079f0fa83",22852637,1,0,1,23,9,9,0
"66b5e16f4f75454fb5b8172079f0fa83","0680571d4698477995e41842c36a54b2",22852637,1,1,0,24,9,10,1
"0680571d4698477995e41842c36a54b2","0680571d4698477995e41842c36a54b2",22852637,1,0,1,25,10,10,0
"0680571d4698477995e41842c36a54b2","9112f2bffece48e08c6d2287be204085",22852637,1,1,0,26,10,11,1
"9112f2bffece48e08c6d2287be204085","9112f2bffece48e08c6d2287be204085",22852637,1,0,1,27,11,11,0
"9112f2bffece48e08c6d2287be204085","56586aa865414f538729c7f7735d2bc6",22852637,1,3,0,28,11,12,1
"56586aa865414f538729c7f7735d2bc6","e2911e79efc2420eac45d9f671463d4b",22852637,1,-12,0,29,12,2,-10
"e2911e79efc2420eac45d9f671463d4b","56586aa865414f538729c7f7735d2bc6",22852637,1,12,0,30,2,12,10
"56586aa865414f538729c7f7735d2bc6","56586aa865414f538729c7f7735d2bc6",22852637,2,0,1,31,12,12,0
"56586aa865414f538729c7f7735d2bc6","b7f2b31585d94eb3bf86376714aa7070",22852637,2,2,0,33,12,13,1
"b7f2b31585d94eb3bf86376714aa7070","56586aa865414f538729c7f7735d2bc6",22852637,1,-2,0,34,13,12,-1
"b7f2b31585d94eb3bf86376714aa7070","b7f2b31585d94eb3bf86376714aa7070",22852637,1,0,1,36,13,13,0
"b7f2b31585d94eb3bf86376714aa7070","3f1c815879794b929260d224becaff7e",22852637,1,2,0,37,13,14,1
"3f1c815879794b929260d224becaff7e","5c5ceeee4562457ba6d41515aeebfbb1",22852637,1,6,0,38,14,17,3
"5c5ceeee4562457ba6d41515aeebfbb1","81c864a886d54a6b8ff85f7d736f4f95",22852637,1,-4,0,39,17,15,-2
"81c864a886d54a6b8ff85f7d736f4f95","5c5ceeee4562457ba6d41515aeebfbb1",22852637,1,4,0,40,15,17,2
"5c5ceeee4562457ba6d41515aeebfbb1","5c5ceeee4562457ba6d41515aeebfbb1",22852637,5,0,1,41,17,17,0
"5c5ceeee4562457ba6d41515aeebfbb1","56586aa865414f538729c7f7735d2bc6",22852637,1,-10,0,46,17,12,-5
"56586aa865414f538729c7f7735d2bc6","9afd71a5298d4333b6849dfce1b9422c",22852637,1,13,0,47,12,18,6
"9afd71a5298d4333b6849dfce1b9422c","9afd71a5298d4333b6849dfce1b9422c",22852637,1,0,1,48,18,18,0
"9afd71a5298d4333b6849dfce1b9422c","b7719e26494940efa49512aedd0aac79",22852637,1,4,0,49,18,20,2
"b7719e26494940efa49512aedd0aac79","d4f45188d3c84a02ba08454e6403a818",22852637,1,5,0,50,20,24,4
"d4f45188d3c84a02ba08454e6403a818","d4c3b003e8274e429d2fa688d73fde6d",22852637,1,-2,0,51,24,22,-2
"d4c3b003e8274e429d2fa688d73fde6d","d4c3b003e8274e429d2fa688d73fde6d",22852637,1,0,1,52,22,22,0
"d4c3b003e8274e429d2fa688d73fde6d","b7719e26494940efa49512aedd0aac79",22852637,1,-3,0,53,22,20,-2
"afbf7250b99d47bea07172749483ca97","afbf7250b99d47bea07172749483ca97",22852637,1,0,1,56,28,28,0
"4e51676dc72045d99c19b9fa7b22f8bc","4e51676dc72045d99c19b9fa7b22f8bc",22852637,1,0,1,58,29,29,0
"51970cfa30e643e894e66ae85c8024cc","c33c17be71ae4d588da7369472e5bb1b",22852637,1,6,0,60,31,34,3
"c33c17be71ae4d588da7369472e5bb1b","4e51676dc72045d99c19b9fa7b22f8bc",22852637,1,-9,0,61,34,29,-5
"9a0dc646f934470daf08c4b56ccf73db","9a0dc646f934470daf08c4b56ccf73db",22852637,1,0,1,68,37,37,0
"fc0e049d56024bc9a02c9a9c435c3df7","b7719e26494940efa49512aedd0aac79",22852637,2,-36,0,70,38,20,-18
"afbf7250b99d47bea07172749483ca97","b7719e26494940efa49512aedd0aac79",22852637,1,-12,0,72,28,20,-8
"b7719e26494940efa49512aedd0aac79","fc0e049d56024bc9a02c9a9c435c3df7",22852637,2,36,0,73,20,38,18
"fc0e049d56024bc9a02c9a9c435c3df7","fc0e049d56024bc9a02c9a9c435c3df7",22852637,5,0,1,74,38,38,0
"fc0e049d56024bc9a02c9a9c435c3df7","67a089198fcb4e1c8f2385786c2b296f",22852637,1,4,0,83,38,39,1
"67a089198fcb4e1c8f2385786c2b296f","64d48c6c9c7940639a932219a6c87198",22852637,1,1,0,85,39,40,1
"64d48c6c9c7940639a932219a6c87198","64d48c6c9c7940639a932219a6c87198",22852637,1,0,1,86,40,40,0
"64d48c6c9c7940639a932219a6c87198","67a089198fcb4e1c8f2385786c2b296f",22852637,1,-1,0,87,40,39,-1
"67a089198fcb4e1c8f2385786c2b296f","b534b89233134e30a9b5645138bfa9ee",22852637,1,4,0,88,39,41,2
"b534b89233134e30a9b5645138bfa9ee","0e37b720d23b4e7f8b313e79313fd107",22852637,1,3,0,92,41,44,3
"0e37b720d23b4e7f8b313e79313fd107","0e37b720d23b4e7f8b313e79313fd107",22852637,3,0,1,93,44,44,0
"0e37b720d23b4e7f8b313e79313fd107","6875d67fdd5f48168b62719df449bebd",22852637,1,1,0,96,44,45,1
"6875d67fdd5f48168b62719df449bebd","6875d67fdd5f48168b62719df449bebd",22852637,1,0,1,97,45,45,0
"6875d67fdd5f48168b62719df449bebd","b534b89233134e30a9b5645138bfa9ee",22852637,1,-4,0,98,45,41,-4
"6e13d61a7bdb44bca949c9f86fab3be5","6e13d61a7bdb44bca949c9f86fab3be5",22852637,1,0,1,100,47,47,0
"6e13d61a7bdb44bca949c9f86fab3be5","195f78799f984cc2b06c48dfe36be751",22852637,1,2,0,101,47,49,2
"195f78799f984cc2b06c48dfe36be751","195f78799f984cc2b06c48dfe36be751",22852637,2,0,1,102,49,49,0
"195f78799f984cc2b06c48dfe36be751","d9c8d8c444a64dadbbb508652c721e17",22852637,1,-3,0,104,49,46,-3
"d9c8d8c444a64dadbbb508652c721e17","d0c74f735e024943943e40333d6d337f",22852637,1,6,0,105,46,51,5
"d0c74f735e024943943e40333d6d337f","d0c74f735e024943943e40333d6d337f",22852637,1,0,1,106,51,51,0
"d0c74f735e024943943e40333d6d337f","983f8ff320594b279a7f4a6fe132f9c5",22852637,1,2,0,107,51,53,2
"983f8ff320594b279a7f4a6fe132f9c5","983f8ff320594b279a7f4a6fe132f9c5",22852637,2,0,1,108,53,53,0
"983f8ff320594b279a7f4a6fe132f9c5","35adfa5d923046aebabfefd98f35ff05",22852637,1,1,0,110,53,54,1
"35adfa5d923046aebabfefd98f35ff05","35adfa5d923046aebabfefd98f35ff05",22852637,5,0,1,111,54,54,0
"35adfa5d923046aebabfefd98f35ff05","b6f8a98476224da1b40e555ececc7ed8",22852637,1,1,0,116,54,55,1
"b6f8a98476224da1b40e555ececc7ed8","b6f8a98476224da1b40e555ececc7ed8",22852637,2,0,1,117,55,55,0
"b6f8a98476224da1b40e555ececc7ed8","86e22cb5fe0e4b47a9489ecddf7ed78f",22852637,1,1,0,119,55,56,1
"86e22cb5fe0e4b47a9489ecddf7ed78f","86e22cb5fe0e4b47a9489ecddf7ed78f",22852637,2,0,1,120,56,56,0
"86e22cb5fe0e4b47a9489ecddf7ed78f","f924752d8a1149668870b1e7698486f7",22852637,1,-6,0,122,56,50,-6
"f924752d8a1149668870b1e7698486f7","a1f2f12debe5432fb7a70bcd12bacfb9",22852637,1,9,0,123,50,58,8
"a1f2f12debe5432fb7a70bcd12bacfb9","78f30e4dcac84e3cbea8b2cc6e0d62b3",22852637,2,1,0,124,58,59,1
"78f30e4dcac84e3cbea8b2cc6e0d62b3","a1f2f12debe5432fb7a70bcd12bacfb9",22852637,1,-1,0,125,59,58,-1
"a1f2f12debe5432fb7a70bcd12bacfb9","a1f2f12debe5432fb7a70bcd12bacfb9",22852637,17,0,1,126,58,58,0
"78f30e4dcac84e3cbea8b2cc6e0d62b3","78f30e4dcac84e3cbea8b2cc6e0d62b3",22852637,9,0,1,144,59,59,0
"78f30e4dcac84e3cbea8b2cc6e0d62b3","a0a418b8540d479fa6e0f653b701da8b",22852637,1,6,0,153,59,64,5
"a0a418b8540d479fa6e0f653b701da8b","12aa6e1672ac4e7aa6449a7a8609cd72",22852637,1,-8,0,154,64,57,-7
"12aa6e1672ac4e7aa6449a7a8609cd72","bc42d26810654ea9a1df1efe1e58c7d5",22852637,1,7,0,155,57,63,6
"bc42d26810654ea9a1df1efe1e58c7d5","4c943503763e4e349906eea3ed3c8e86",22852637,1,-2,0,156,63,61,-2
"4c943503763e4e349906eea3ed3c8e86","4c943503763e4e349906eea3ed3c8e86",22852637,3,0,1,157,61,61,0
"4c943503763e4e349906eea3ed3c8e86","bc42d26810654ea9a1df1efe1e58c7d5",22852637,1,2,0,160,61,63,2
"bc42d26810654ea9a1df1efe1e58c7d5","bc42d26810654ea9a1df1efe1e58c7d5",22852637,3,0,1,161,63,63,0
"bc42d26810654ea9a1df1efe1e58c7d5","309ccf3cc4fe429d9bfbaef53d3fa479",22852637,1,-3,0,164,63,60,-3
"309ccf3cc4fe429d9bfbaef53d3fa479","d646286c8051419bbc2e31dd1db55ca8",22852637,1,10,0,165,60,67,7
"d646286c8051419bbc2e31dd1db55ca8","b534b89233134e30a9b5645138bfa9ee",22852637,1,-33,0,166,67,41,-26
"b534b89233134e30a9b5645138bfa9ee","b534b89233134e30a9b5645138bfa9ee",22852637,4,0,1,167,41,41,0
"b534b89233134e30a9b5645138bfa9ee","d9c8d8c444a64dadbbb508652c721e17",22852637,1,6,0,168,41,46,5
"d9c8d8c444a64dadbbb508652c721e17","6e13d61a7bdb44bca949c9f86fab3be5",22852637,1,1,0,169,46,47,1
"6e13d61a7bdb44bca949c9f86fab3be5","b534b89233134e30a9b5645138bfa9ee",22852637,3,-7,0,170,47,41,-6
"b534b89233134e30a9b5645138bfa9ee","78adeee1fa2c4fe0bc73f7bca9fcee86",22852637,2,148,0,171,41,160,119
"78adeee1fa2c4fe0bc73f7bca9fcee86","78adeee1fa2c4fe0bc73f7bca9fcee86",22852637,6,0,1,172,160,160,0
"78adeee1fa2c4fe0bc73f7bca9fcee86","d646286c8051419bbc2e31dd1db55ca8",22852637,1,-115,0,173,160,67,-93
"d646286c8051419bbc2e31dd1db55ca8","d646286c8051419bbc2e31dd1db55ca8",22852637,1,0,1,174,67,67,0
"d646286c8051419bbc2e31dd1db55ca8","267f883678b24aed855fde42524975d9",22852637,1,4,0,175,67,71,4
"267f883678b24aed855fde42524975d9","267f883678b24aed855fde42524975d9",22852637,1,0,1,176,71,71,0
"267f883678b24aed855fde42524975d9","88fff56d0342490dbef9040750a20f6c",22852637,1,1,0,177,71,72,1
"88fff56d0342490dbef9040750a20f6c","88fff56d0342490dbef9040750a20f6c",22852637,1,0,1,178,72,72,0
"88fff56d0342490dbef9040750a20f6c","adb17b12b66c4a49a85fd34322f7df70",22852637,1,1,0,179,72,73,1
"adb17b12b66c4a49a85fd34322f7df70","adb17b12b66c4a49a85fd34322f7df70",22852637,1,0,1,180,73,73,0
"adb17b12b66c4a49a85fd34322f7df70","a2becd407db34b189200a32546d9d569",22852637,1,3,0,181,73,75,2
"a2becd407db34b189200a32546d9d569","d646286c8051419bbc2e31dd1db55ca8",22852637,1,-9,0,182,75,67,-8
"d646286c8051419bbc2e31dd1db55ca8","a2becd407db34b189200a32546d9d569",22852637,2,9,0,183,67,75,8
"a2becd407db34b189200a32546d9d569","58c22b011d0f4c2ea6d13615edbb9eeb",22852637,1,2,0,184,75,77,2
"58c22b011d0f4c2ea6d13615edbb9eeb","58c22b011d0f4c2ea6d13615edbb9eeb",22852637,5,0,1,185,77,77,0
"58c22b011d0f4c2ea6d13615edbb9eeb","dd76e1861dc9461c830888729d091ee0",22852637,1,1,0,190,77,78,1
"dd76e1861dc9461c830888729d091ee0","dd76e1861dc9461c830888729d091ee0",22852637,5,0,1,191,78,78,0
"dd76e1861dc9461c830888729d091ee0","cd1d828f1a694b87913a7ea66c23803e",22852637,1,1,0,196,78,79,1
"cd1d828f1a694b87913a7ea66c23803e","cd1d828f1a694b87913a7ea66c23803e",22852637,2,0,1,197,79,79,0
"cd1d828f1a694b87913a7ea66c23803e","9176a3c2b4d2465fa8b0c67096c2a97e",22852637,1,1,0,199,79,80,1
"9176a3c2b4d2465fa8b0c67096c2a97e","9176a3c2b4d2465fa8b0c67096c2a97e",22852637,5,0,1,200,80,80,0
"9176a3c2b4d2465fa8b0c67096c2a97e","f8ec6445f7194e25b9101d4fbcb07a18",22852637,1,1,0,205,80,81,1
"f8ec6445f7194e25b9101d4fbcb07a18","f8ec6445f7194e25b9101d4fbcb07a18",22852637,2,0,1,206,81,81,0
"f8ec6445f7194e25b9101d4fbcb07a18","140d5b27b8574befad82c0a013b59dfa",22852637,1,-7,0,208,81,74,-7
"140d5b27b8574befad82c0a013b59dfa","d18a9ea32855445f8736581f5cb119ce",22852637,1,9,0,209,74,82,8
"d18a9ea32855445f8736581f5cb119ce","f564483cbd7a407681aa2fcca518cf5f",22852637,1,4,0,210,82,85,3
"f564483cbd7a407681aa2fcca518cf5f","f564483cbd7a407681aa2fcca518cf5f",22852637,1,0,1,211,85,85,0
"f564483cbd7a407681aa2fcca518cf5f","18fd01350bd5434ca636d59a599d768a",22852637,1,1,0,212,85,86,1
"18fd01350bd5434ca636d59a599d768a","18fd01350bd5434ca636d59a599d768a",22852637,9,0,1,213,86,86,0
"18fd01350bd5434ca636d59a599d768a","6a9f0ef185fb47f0937e29daa1c71ed5",22852637,1,5,0,222,86,90,4
"6a9f0ef185fb47f0937e29daa1c71ed5","ae5ac430ea254e708a6f5deaaf7464ae",22852637,1,-7,0,223,90,84,-6
"ae5ac430ea254e708a6f5deaaf7464ae","c681290961c94c4caf23b529d1ae6b9a",22852637,1,5,0,224,84,88,4
"c681290961c94c4caf23b529d1ae6b9a","c681290961c94c4caf23b529d1ae6b9a",22852637,1,0,1,225,88,88,0
"c681290961c94c4caf23b529d1ae6b9a","6a9f0ef185fb47f0937e29daa1c71ed5",22852637,1,2,0,226,88,90,2
"d646286c8051419bbc2e31dd1db55ca8","c33c17be71ae4d588da7369472e5bb1b",22852637,1,-53,0,232,67,34,-33
"c33c17be71ae4d588da7369472e5bb1b","e20db35ced8544ddac5bc3839145e463",22852637,1,83,0,234,34,91,57
"e20db35ced8544ddac5bc3839145e463","e20db35ced8544ddac5bc3839145e463",22852637,1,0,1,235,91,91,0
"e20db35ced8544ddac5bc3839145e463","1febb706d7a34005ae8711ed49c76e64",22852637,1,3,0,236,91,94,3
"1febb706d7a34005ae8711ed49c76e64","1febb706d7a34005ae8711ed49c76e64",22852637,5,0,1,237,94,94,0
"1febb706d7a34005ae8711ed49c76e64","8f73ba6f5a0042f2850356ac38ac6f24",22852637,1,1,0,242,94,95,1
"8f73ba6f5a0042f2850356ac38ac6f24","8f73ba6f5a0042f2850356ac38ac6f24",22852637,5,0,1,243,95,95,0
"8f73ba6f5a0042f2850356ac38ac6f24","e2260b86653c46d7b14a41fb419dbf8c",22852637,1,1,0,248,95,96,1
"e2260b86653c46d7b14a41fb419dbf8c","e2260b86653c46d7b14a41fb419dbf8c",22852637,2,0,1,249,96,96,0
"e2260b86653c46d7b14a41fb419dbf8c","35eb641ad1d845bbba54915bce75a962",22852637,1,1,0,251,96,97,1
"35eb641ad1d845bbba54915bce75a962","35eb641ad1d845bbba54915bce75a962",22852637,5,0,1,252,97,97,0
"35eb641ad1d845bbba54915bce75a962","08be90ffbeea4795a138cd42ed8db56f",22852637,1,1,0,257,97,98,1
"08be90ffbeea4795a138cd42ed8db56f","08be90ffbeea4795a138cd42ed8db56f",22852637,5,0,1,258,98,98,0
"08be90ffbeea4795a138cd42ed8db56f","3007433c8f584dcbb5ac159c1c5f2be3",22852637,1,1,0,263,98,99,1
"3007433c8f584dcbb5ac159c1c5f2be3","3007433c8f584dcbb5ac159c1c5f2be3",22852637,2,0,1,264,99,99,0
"3007433c8f584dcbb5ac159c1c5f2be3","00ae5f0c51874a73a41ebea838d95682",22852637,1,3,0,266,99,101,2
"d391c8b6e56a43a7b654e9dee02d904b","00ae5f0c51874a73a41ebea838d95682",22852637,1,-2,0,269,103,101,-2
"00ae5f0c51874a73a41ebea838d95682","d391c8b6e56a43a7b654e9dee02d904b",22852637,1,2,0,270,101,103,2
"d391c8b6e56a43a7b654e9dee02d904b","d391c8b6e56a43a7b654e9dee02d904b",22852637,15,0,1,271,103,103,0
"d391c8b6e56a43a7b654e9dee02d904b","6111116566fc4fd9abba409322bea245",22852637,1,1,0,286,103,104,1
"6111116566fc4fd9abba409322bea245","6111116566fc4fd9abba409322bea245",22852637,2,0,1,287,104,104,0
"6111116566fc4fd9abba409322bea245","a81b2235cb9c499eb9ea8ee0a8dd9725",22852637,1,1,0,289,104,105,1
"a81b2235cb9c499eb9ea8ee0a8dd9725","a81b2235cb9c499eb9ea8ee0a8dd9725",22852637,2,0,1,290,105,105,0
"a81b2235cb9c499eb9ea8ee0a8dd9725","2d4e0ab0ef3b4d73b82c72d4621a7579",22852637,1,1,0,292,105,106,1
"2d4e0ab0ef3b4d73b82c72d4621a7579","2d4e0ab0ef3b4d73b82c72d4621a7579",22852637,2,0,1,293,106,106,0
"2d4e0ab0ef3b4d73b82c72d4621a7579","8bdebf492ebd4e62b0d522e8ab5e5197",22852637,1,1,0,295,106,107,1
"8bdebf492ebd4e62b0d522e8ab5e5197","8bdebf492ebd4e62b0d522e8ab5e5197",22852637,8,0,1,296,107,107,0
"8bdebf492ebd4e62b0d522e8ab5e5197","73039f8c1eb9409cb4caee2cf968001e",22852637,1,-7,0,304,107,100,-7
"73039f8c1eb9409cb4caee2cf968001e","4280927ec4d643238aa49c32f9e06c6c",22852637,1,10,0,305,100,109,9
"4280927ec4d643238aa49c32f9e06c6c","4280927ec4d643238aa49c32f9e06c6c",22852637,1,0,1,306,109,109,0
"4280927ec4d643238aa49c32f9e06c6c","fc44e6a5f7654430af1227838224dceb",22852637,1,2,0,307,109,111,2
"fc44e6a5f7654430af1227838224dceb","fc44e6a5f7654430af1227838224dceb",22852637,8,0,1,308,111,111,0
"fc44e6a5f7654430af1227838224dceb","08111f75e22d409998cf8b85bd431f0a",22852637,1,-3,0,316,111,108,-3
"a9ae0a3c070d455bb4369a8996313336","a9ae0a3c070d455bb4369a8996313336",22852637,1,0,1,318,114,114,0
"a9ae0a3c070d455bb4369a8996313336","71cec822bcff4f30a20e75dc63ef7b65",22852637,1,2,0,319,114,116,2
"71cec822bcff4f30a20e75dc63ef7b65","71cec822bcff4f30a20e75dc63ef7b65",22852637,3,0,1,320,116,116,0
"71cec822bcff4f30a20e75dc63ef7b65","37319e88176d4aefa91d7a9980dbae91",22852637,1,-4,0,323,116,112,-4
"62bff51286ef4f348717a3cf6fe2318f","b1cd0e7dc3ad4a8eb91a4bfdbeb025b0",22852637,1,-2,0,325,120,118,-2
"b1cd0e7dc3ad4a8eb91a4bfdbeb025b0","b1cd0e7dc3ad4a8eb91a4bfdbeb025b0",22852637,1,0,1,326,118,118,0
"b1cd0e7dc3ad4a8eb91a4bfdbeb025b0","62bff51286ef4f348717a3cf6fe2318f",22852637,1,2,0,327,118,120,2
"62bff51286ef4f348717a3cf6fe2318f","e20db35ced8544ddac5bc3839145e463",22852637,1,-33,0,331,120,91,-29
"e20db35ced8544ddac5bc3839145e463","779f9ddd1fd14d1e9e69f72219a1fdbd",22852637,1,36,0,332,91,121,30
"779f9ddd1fd14d1e9e69f72219a1fdbd","779f9ddd1fd14d1e9e69f72219a1fdbd",22852637,2,0,1,333,121,121,0
"779f9ddd1fd14d1e9e69f72219a1fdbd","ae26e6cda8ad4a3f81bd347560d9579f",22852637,1,4,0,335,121,125,4
"ae26e6cda8ad4a3f81bd347560d9579f","ae26e6cda8ad4a3f81bd347560d9579f",22852637,1,0,1,336,125,125,0
"ae26e6cda8ad4a3f81bd347560d9579f","ee48df95832b4374aa273ceb27ec1315",22852637,1,1,0,337,125,126,1
"ee48df95832b4374aa273ceb27ec1315","ee48df95832b4374aa273ceb27ec1315",22852637,1,0,1,338,126,126,0
"ee48df95832b4374aa273ceb27ec1315","7a439da90b394756ad1777fc4c6dead5",22852637,1,1,0,339,126,127,1
"7a439da90b394756ad1777fc4c6dead5","7a439da90b394756ad1777fc4c6dead5",22852637,1,0,1,340,127,127,0
"7a439da90b394756ad1777fc4c6dead5","779f9ddd1fd14d1e9e69f72219a1fdbd",22852637,1,-6,0,341,127,121,-6
"779f9ddd1fd14d1e9e69f72219a1fdbd","a8dd5213034441ac92724b4e83eb0bb2",22852637,1,9,0,342,121,129,8
"a8dd5213034441ac92724b4e83eb0bb2","a8dd5213034441ac92724b4e83eb0bb2",22852637,1,0,1,343,129,129,0
"a8dd5213034441ac92724b4e83eb0bb2","8115eab6556b45f5b415c3b8c26a12e5",22852637,1,2,0,344,129,131,2
"8115eab6556b45f5b415c3b8c26a12e5","8115eab6556b45f5b415c3b8c26a12e5",22852637,2,0,1,345,131,131,0
"8115eab6556b45f5b415c3b8c26a12e5","ec34b06efd844b46a4c4818ecdb9b8f4",22852637,1,1,0,347,131,132,1
"ec34b06efd844b46a4c4818ecdb9b8f4","ec34b06efd844b46a4c4818ecdb9b8f4",22852637,2,0,1,348,132,132,0
"ec34b06efd844b46a4c4818ecdb9b8f4","c2e1c2b9eac64109b343a088584b576b",22852637,1,1,0,350,132,133,1
"c2e1c2b9eac64109b343a088584b576b","c2e1c2b9eac64109b343a088584b576b",22852637,2,0,1,351,133,133,0
"c2e1c2b9eac64109b343a088584b576b","579338175e0b4bbb8ef3b712b5d8b54e",22852637,1,-5,0,353,133,128,-5
"579338175e0b4bbb8ef3b712b5d8b54e","8bc5795d6a984a3eace4e2811e52dd4f",22852637,1,8,0,354,128,135,7
"8bc5795d6a984a3eace4e2811e52dd4f","8bc5795d6a984a3eace4e2811e52dd4f",22852637,3,0,1,355,135,135,0
"8bc5795d6a984a3eace4e2811e52dd4f","b416d47c56a742199b5d7c7f19d6503a",22852637,1,-1,0,358,135,134,-1
"b416d47c56a742199b5d7c7f19d6503a","cd4532ad48034873ba8bce2aac0c9808",22852637,1,4,0,359,134,137,3
"cd4532ad48034873ba8bce2aac0c9808","cd4532ad48034873ba8bce2aac0c9808",22852637,1,0,1,360,137,137,0
"cd4532ad48034873ba8bce2aac0c9808","779f9ddd1fd14d1e9e69f72219a1fdbd",22852637,1,-19,0,361,137,121,-16
"6c5ad271a44743479bfaea29b1db8d02","c33c17be71ae4d588da7369472e5bb1b",22852637,1,-146,0,364,143,34,-109
"c33c17be71ae4d588da7369472e5bb1b","8959e6304a0348309a771e4d08d1b64a",22852637,1,172,0,366,34,163,129
"8959e6304a0348309a771e4d08d1b64a","78adeee1fa2c4fe0bc73f7bca9fcee86",22852637,1,-4,0,367,163,160,-3
"df1de691dafe4549a18a4398ee9dfaf9","df1de691dafe4549a18a4398ee9dfaf9",22852637,1,0,1,379,139,139,0
"6c5ad271a44743479bfaea29b1db8d02","6c5ad271a44743479bfaea29b1db8d02",22852637,1,0,1,381,143,143,0
"6c5ad271a44743479bfaea29b1db8d02","83d311bed5374fee83d8d67a7d9d82dc",22852637,1,1,0,382,143,144,1
"83d311bed5374fee83d8d67a7d9d82dc","83d311bed5374fee83d8d67a7d9d82dc",22852637,1,0,1,383,144,144,0
"83d311bed5374fee83d8d67a7d9d82dc","402bba41861d43acb52a5abb89e8831e",22852637,1,1,0,384,144,145,1
"402bba41861d43acb52a5abb89e8831e","402bba41861d43acb52a5abb89e8831e",22852637,2,0,1,385,145,145,0
"402bba41861d43acb52a5abb89e8831e","df1de691dafe4549a18a4398ee9dfaf9",22852637,1,-6,0,387,145,139,-6
"8aae34f5ddbb4052a709b12e6b0d40fa","8aae34f5ddbb4052a709b12e6b0d40fa",22852637,1,0,1,389,147,147,0
"8aae34f5ddbb4052a709b12e6b0d40fa","645b3f0249f64f76af2e19eb4d0e55b7",22852637,1,2,0,390,147,149,2
"645b3f0249f64f76af2e19eb4d0e55b7","645b3f0249f64f76af2e19eb4d0e55b7",22852637,2,0,1,391,149,149,0
"645b3f0249f64f76af2e19eb4d0e55b7","7e7b8db5064d4369805ab370aac5ddfb",22852637,1,1,0,393,149,150,1
"7e7b8db5064d4369805ab370aac5ddfb","7e7b8db5064d4369805ab370aac5ddfb",22852637,2,0,1,394,150,150,0
"7e7b8db5064d4369805ab370aac5ddfb","8956d210ae7f41968fada86d4c979d6a",22852637,1,1,0,396,150,151,1
"8956d210ae7f41968fada86d4c979d6a","8956d210ae7f41968fada86d4c979d6a",22852637,2,0,1,397,151,151,0
"8956d210ae7f41968fada86d4c979d6a","f902b0f41b544d4dbf79664fd233648d",22852637,1,-5,0,399,151,146,-5
"f902b0f41b544d4dbf79664fd233648d","ae781e8b775e4ccd93bc800dad5c8376",22852637,1,8,0,400,146,153,7
"ae781e8b775e4ccd93bc800dad5c8376","ae781e8b775e4ccd93bc800dad5c8376",22852637,2,0,1,401,153,153,0
"ae781e8b775e4ccd93bc800dad5c8376","06882a8492d9499aa31555567f575ecb",22852637,1,1,0,403,153,154,1
"06882a8492d9499aa31555567f575ecb","06882a8492d9499aa31555567f575ecb",22852637,1,0,1,404,154,154,0
"06882a8492d9499aa31555567f575ecb","f293c508f409466a8f27ddd7d1e40b20",22852637,1,1,0,405,154,155,1
"f293c508f409466a8f27ddd7d1e40b20","f293c508f409466a8f27ddd7d1e40b20",22852637,5,0,1,406,155,155,0
"f293c508f409466a8f27ddd7d1e40b20","cc4ddef5bbbe48ebb605141b347c4ed1",22852637,1,1,0,411,155,156,1
"cc4ddef5bbbe48ebb605141b347c4ed1","cc4ddef5bbbe48ebb605141b347c4ed1",22852637,1,0,1,412,156,156,0
"cc4ddef5bbbe48ebb605141b347c4ed1","d313cec988a84645bee413e8d4724a4b",22852637,1,3,0,413,156,158,2
"f03480cf4eba413194d7af52fc0e7f28","dc60696c76a74368a60f72246e47700d",22852637,1,8,0,415,152,159,7
"dc60696c76a74368a60f72246e47700d","dc60696c76a74368a60f72246e47700d",22852637,1,0,1,416,159,159,0
"dc60696c76a74368a60f72246e47700d","78adeee1fa2c4fe0bc73f7bca9fcee86",22852637,1,3,0,417,159,160,1
"df1de691dafe4549a18a4398ee9dfaf9","d9c8d8c444a64dadbbb508652c721e17",22852637,1,-116,0,419,139,46,-93
"d9c8d8c444a64dadbbb508652c721e17","b534b89233134e30a9b5645138bfa9ee",22852637,2,-6,0,420,46,41,-5
"b534b89233134e30a9b5645138bfa9ee","6e13d61a7bdb44bca949c9f86fab3be5",22852637,3,7,0,421,41,47,6
"b534b89233134e30a9b5645138bfa9ee","140d5b27b8574befad82c0a013b59dfa",22852637,1,41,0,423,41,74,33
"140d5b27b8574befad82c0a013b59dfa","d646286c8051419bbc2e31dd1db55ca8",22852637,1,-8,0,424,74,67,-7
"a2becd407db34b189200a32546d9d569","78adeee1fa2c4fe0bc73f7bca9fcee86",22852637,1,106,0,426,75,160,85
"78adeee1fa2c4fe0bc73f7bca9fcee86","67a089198fcb4e1c8f2385786c2b296f",22852637,1,-152,0,428,160,39,-121
"67a089198fcb4e1c8f2385786c2b296f","d9c8d8c444a64dadbbb508652c721e17",22852637,1,10,0,429,39,46,7
"82e6285962b8400d9d6fc32436022a94","78adeee1fa2c4fe0bc73f7bca9fcee86",22852637,1,-10,0,512,167,160,-7
"65202579580f4ad38d734b4ee39d22a8","a9ac840f098c4bd0a2ee896214ce29cd",22852637,1,8,0,521,164,168,4
"0c7262dff33c4087bc660ccf40f92f9c","b2275c3fad834f8d90737a2d9a6927d6",22852637,2,3,0,527,169,172,3
"b2275c3fad834f8d90737a2d9a6927d6","0c7262dff33c4087bc660ccf40f92f9c",22852637,1,-3,0,528,172,169,-3
"0c7262dff33c4087bc660ccf40f92f9c","0d987bed3ffa4ed0b9a2e62e97b7b30f",22852637,1,135,0,529,169,272,103
"0d987bed3ffa4ed0b9a2e62e97b7b30f","0c7262dff33c4087bc660ccf40f92f9c",22852637,1,-135,0,531,272,169,-103
"b2275c3fad834f8d90737a2d9a6927d6","b2275c3fad834f8d90737a2d9a6927d6",22852637,20,0,1,533,172,172,0
"b2275c3fad834f8d90737a2d9a6927d6","eb515a26030b41f8a82a1e6114420bad",22852637,1,1,0,553,172,173,1
"eb515a26030b41f8a82a1e6114420bad","eb515a26030b41f8a82a1e6114420bad",22852637,2,0,1,554,173,173,0
"eb515a26030b41f8a82a1e6114420bad","b42cc17b7de840f181a704558d0bc845",22852637,1,3,0,556,173,175,2
"0c7262dff33c4087bc660ccf40f92f9c","b42cc17b7de840f181a704558d0bc845",22852637,1,7,0,558,169,175,6
"b42cc17b7de840f181a704558d0bc845","801f9e9135034f49bf5f8b4bdefedb41",22852637,1,2,0,559,175,177,2
"801f9e9135034f49bf5f8b4bdefedb41","801f9e9135034f49bf5f8b4bdefedb41",22852637,7,0,1,560,177,177,0
"801f9e9135034f49bf5f8b4bdefedb41","362fcb0699a14845ab29b2340093e528",22852637,1,-3,0,567,177,174,-3
"b87c552dd247427abe6ab5795b9c9d43","ea38cc0e6e6e41edbabf210220808bf9",22852637,2,-2,0,569,181,179,-2
"ea38cc0e6e6e41edbabf210220808bf9","ea38cc0e6e6e41edbabf210220808bf9",22852637,1,0,1,570,179,179,0
"ea38cc0e6e6e41edbabf210220808bf9","b87c552dd247427abe6ab5795b9c9d43",22852637,1,2,0,571,179,181,2
"b87c552dd247427abe6ab5795b9c9d43","b87c552dd247427abe6ab5795b9c9d43",22852637,8,0,1,572,181,181,0
"139b097acfca451689d80c9c6eebdf7b","ea38cc0e6e6e41edbabf210220808bf9",22852637,2,1,0,580,178,179,1
"ea38cc0e6e6e41edbabf210220808bf9","2024b4885bd14338a39b7b509acbbd02",22852637,2,4,0,581,179,182,3
"2024b4885bd14338a39b7b509acbbd02","b87c552dd247427abe6ab5795b9c9d43",22852637,1,-2,0,582,182,181,-1
"b87c552dd247427abe6ab5795b9c9d43","b42cc17b7de840f181a704558d0bc845",22852637,1,-7,0,583,181,175,-6
"b42cc17b7de840f181a704558d0bc845","139b097acfca451689d80c9c6eebdf7b",22852637,1,4,0,584,175,178,3
"362fcb0699a14845ab29b2340093e528","139b097acfca451689d80c9c6eebdf7b",22852637,1,5,0,587,174,178,4
"139b097acfca451689d80c9c6eebdf7b","b87c552dd247427abe6ab5795b9c9d43",22852637,1,3,0,588,178,181,3
"2024b4885bd14338a39b7b509acbbd02","139b097acfca451689d80c9c6eebdf7b",22852637,1,-5,0,592,182,178,-4
"139b097acfca451689d80c9c6eebdf7b","30f660a1feb34582a739722532524f79",22852637,1,6,0,593,178,183,5
"30f660a1feb34582a739722532524f79","30f660a1feb34582a739722532524f79",22852637,5,0,1,594,183,183,0
"30f660a1feb34582a739722532524f79","2024b4885bd14338a39b7b509acbbd02",22852637,1,-1,0,599,183,182,-1
"2024b4885bd14338a39b7b509acbbd02","c3f63fe50d8e487c86bf8ef76c9cadd3",22852637,1,4,0,600,182,185,3
"c3f63fe50d8e487c86bf8ef76c9cadd3","c3f63fe50d8e487c86bf8ef76c9cadd3",22852637,1,0,1,601,185,185,0
"c3f63fe50d8e487c86bf8ef76c9cadd3","0c7262dff33c4087bc660ccf40f92f9c",22852637,1,-20,0,602,185,169,-16
"0c7262dff33c4087bc660ccf40f92f9c","c8e371568a0c4391b25796ae4e91952e",22852637,2,23,0,603,169,186,17
"c8e371568a0c4391b25796ae4e91952e","c8e371568a0c4391b25796ae4e91952e",22852637,3,0,1,606,186,186,0
"c8e371568a0c4391b25796ae4e91952e","7d932b23e1c84326ae5aa4d3c0d813d1",22852637,1,2,0,607,186,188,2
"7d932b23e1c84326ae5aa4d3c0d813d1","7d932b23e1c84326ae5aa4d3c0d813d1",22852637,1,0,1,608,188,188,0
"7d932b23e1c84326ae5aa4d3c0d813d1","ab11d94c6c8948ea90b88f19d2cd502b",22852637,1,3,0,609,188,190,2
"c8e371568a0c4391b25796ae4e91952e","ab11d94c6c8948ea90b88f19d2cd502b",22852637,3,5,0,611,186,190,4
"ab11d94c6c8948ea90b88f19d2cd502b","f992451ed6ad4e68bb9e68ad6be7c4be",22852637,1,2,0,612,190,192,2
"f992451ed6ad4e68bb9e68ad6be7c4be","f992451ed6ad4e68bb9e68ad6be7c4be",22852637,3,0,1,613,192,192,0
"f992451ed6ad4e68bb9e68ad6be7c4be","6cd2dcaac46847d4a0bc53f296d90375",22852637,1,3,0,616,192,194,2
"07b44a7a51e94c78b411c753fc39dab0","6cd2dcaac46847d4a0bc53f296d90375",22852637,3,6,0,618,189,194,5
"6cd2dcaac46847d4a0bc53f296d90375","6cd2dcaac46847d4a0bc53f296d90375",22852637,1,0,1,619,194,194,0
"6cd2dcaac46847d4a0bc53f296d90375","2d2580c9411c4972909db508d6956a58",22852637,1,2,0,620,194,196,2
"2d2580c9411c4972909db508d6956a58","2d2580c9411c4972909db508d6956a58",22852637,2,0,1,621,196,196,0
"2d2580c9411c4972909db508d6956a58","5bddb3d9ed264f3984702f048c7e5340",22852637,1,1,0,623,196,197,1
"5bddb3d9ed264f3984702f048c7e5340","5bddb3d9ed264f3984702f048c7e5340",22852637,2,0,1,624,197,197,0
"5bddb3d9ed264f3984702f048c7e5340","d5e8e2bd12a2466b9d6d90855f0eb079",22852637,1,1,0,626,197,198,1
"d5e8e2bd12a2466b9d6d90855f0eb079","d5e8e2bd12a2466b9d6d90855f0eb079",22852637,2,0,1,627,198,198,0
"d5e8e2bd12a2466b9d6d90855f0eb079","017d7ca8e0394b91aaadc9574df2202c",22852637,1,-5,0,629,198,193,-5
"017d7ca8e0394b91aaadc9574df2202c","54e8e9f0ea3e45c4bf3b8ac799ee31b1",22852637,1,8,0,630,193,200,7
"54e8e9f0ea3e45c4bf3b8ac799ee31b1","54e8e9f0ea3e45c4bf3b8ac799ee31b1",22852637,1,0,1,631,200,200,0
"54e8e9f0ea3e45c4bf3b8ac799ee31b1","c614a00911be4877a075f19315530fb0",22852637,1,1,0,632,200,201,1
"c614a00911be4877a075f19315530fb0","c614a00911be4877a075f19315530fb0",22852637,6,0,1,633,201,201,0
"c614a00911be4877a075f19315530fb0","a6c21bd8b95249c7972820a7a7d76aff",22852637,1,1,0,639,201,202,1
"a6c21bd8b95249c7972820a7a7d76aff","a6c21bd8b95249c7972820a7a7d76aff",22852637,1,0,1,640,202,202,0
"a6c21bd8b95249c7972820a7a7d76aff","f9170dd6bc6442b4acd832747609b09a",22852637,1,-3,0,641,202,199,-3
"f9170dd6bc6442b4acd832747609b09a","6cd2dcaac46847d4a0bc53f296d90375",22852637,1,-6,0,642,199,194,-5
"6cd2dcaac46847d4a0bc53f296d90375","017d7ca8e0394b91aaadc9574df2202c",22852637,3,-1,0,643,194,193,-1
"017d7ca8e0394b91aaadc9574df2202c","bb329d880ab54120adaf203a693bb203",22852637,2,11,0,644,193,203,10
"bb329d880ab54120adaf203a693bb203","c8e371568a0c4391b25796ae4e91952e",22852637,1,-20,0,645,203,186,-17
"ab11d94c6c8948ea90b88f19d2cd502b","07b44a7a51e94c78b411c753fc39dab0",22852637,2,-1,0,648,190,189,-1
"bb329d880ab54120adaf203a693bb203","bb329d880ab54120adaf203a693bb203",22852637,1,0,1,652,203,203,0
"bb329d880ab54120adaf203a693bb203","f9170dd6bc6442b4acd832747609b09a",22852637,1,-4,0,653,203,199,-4
"f9170dd6bc6442b4acd832747609b09a","b54257a550b94ebc9538f3a90eee9d7e",22852637,2,6,0,654,199,204,5
"b54257a550b94ebc9538f3a90eee9d7e","f9170dd6bc6442b4acd832747609b09a",22852637,2,-6,0,655,204,199,-5
"f9170dd6bc6442b4acd832747609b09a","c8e371568a0c4391b25796ae4e91952e",22852637,1,-16,0,658,199,186,-13
"f9170dd6bc6442b4acd832747609b09a","334c2344009840079b1d0e1b7ce3d5a7",22852637,1,7,0,665,199,205,6
"334c2344009840079b1d0e1b7ce3d5a7","334c2344009840079b1d0e1b7ce3d5a7",22852637,1,0,1,666,205,205,0
"334c2344009840079b1d0e1b7ce3d5a7","c8e371568a0c4391b25796ae4e91952e",22852637,1,-23,0,667,205,186,-19
"c8e371568a0c4391b25796ae4e91952e","d7f13c8d63ec4e2aa673fbb9cf9c6933",22852637,1,26,0,668,186,206,20
"d7f13c8d63ec4e2aa673fbb9cf9c6933","7108f0e4c2584f1f9c471689ae4c885c",22852637,2,2,0,669,206,208,2
"7108f0e4c2584f1f9c471689ae4c885c","b9e80f77c3a44349863b19875725c384",22852637,2,-1,0,670,208,207,-1
"b9e80f77c3a44349863b19875725c384","d7f13c8d63ec4e2aa673fbb9cf9c6933",22852637,1,-1,0,671,207,206,-1
"d7f13c8d63ec4e2aa673fbb9cf9c6933","d7f13c8d63ec4e2aa673fbb9cf9c6933",22852637,1,0,1,672,206,206,0
"b9e80f77c3a44349863b19875725c384","b9e80f77c3a44349863b19875725c384",22852637,28,0,1,675,207,207,0
"7108f0e4c2584f1f9c471689ae4c885c","7108f0e4c2584f1f9c471689ae4c885c",22852637,18,0,1,704,208,208,0
"7108f0e4c2584f1f9c471689ae4c885c","09400e101c5d4b439cf9a26b03aae558",22852637,1,3,0,722,208,210,2
"09400e101c5d4b439cf9a26b03aae558","d7f13c8d63ec4e2aa673fbb9cf9c6933",22852637,1,-5,0,723,210,206,-4
"09400e101c5d4b439cf9a26b03aae558","a88efa7e50ce47159810ab553afa6d3a",22852637,1,2,0,725,210,212,2
"a88efa7e50ce47159810ab553afa6d3a","a88efa7e50ce47159810ab553afa6d3a",22852637,21,0,1,726,212,212,0
"a88efa7e50ce47159810ab553afa6d3a","a875096404ef4a9984b62d74cda916f9",22852637,1,-3,0,747,212,209,-3
"f7fb1952f56b4189b86a9f8b7862d2b8","be502a7a43c44bf7b682698de79d9369",22852637,1,-1,0,749,215,214,-1
"be502a7a43c44bf7b682698de79d9369","be502a7a43c44bf7b682698de79d9369",22852637,1,0,1,750,214,214,0
"be502a7a43c44bf7b682698de79d9369","f7fb1952f56b4189b86a9f8b7862d2b8",22852637,1,1,0,751,214,215,1
"f7fb1952f56b4189b86a9f8b7862d2b8","f7fb1952f56b4189b86a9f8b7862d2b8",22852637,22,0,1,752,215,215,0
"f7fb1952f56b4189b86a9f8b7862d2b8","b860ee85d8bc4a2f97958cfb71be3533",22852637,1,1,0,774,215,216,1
"b860ee85d8bc4a2f97958cfb71be3533","b860ee85d8bc4a2f97958cfb71be3533",22852637,2,0,1,775,216,216,0
"b860ee85d8bc4a2f97958cfb71be3533","ec341f459285443b8361f7f15638ff08",22852637,1,-3,0,777,216,213,-3
"363837c182e04711840d896ae1e0339c","363837c182e04711840d896ae1e0339c",22852637,49,0,1,779,218,218,0
"01b2051f8941460d89945e3b02d1ce78","91125ca626c5470eb145501f8c37f8db",22852637,2,4,0,829,217,220,3
"91125ca626c5470eb145501f8c37f8db","91125ca626c5470eb145501f8c37f8db",22852637,2,0,1,830,220,220,0
"91125ca626c5470eb145501f8c37f8db","d7f13c8d63ec4e2aa673fbb9cf9c6933",22852637,2,-18,0,831,220,206,-14
"d7f13c8d63ec4e2aa673fbb9cf9c6933","b9e80f77c3a44349863b19875725c384",22852637,1,1,0,832,206,207,1
"d7f13c8d63ec4e2aa673fbb9cf9c6933","1c6721b1f63f4d30ba7746ea8af02a52",22852637,1,21,0,845,206,221,15
"1c6721b1f63f4d30ba7746ea8af02a52","77ecef8eff6b4a2caea7707669bf7475",22852637,2,1,0,846,221,222,1
"77ecef8eff6b4a2caea7707669bf7475","0c7262dff33c4087bc660ccf40f92f9c",22852637,1,-71,0,847,222,169,-53
"0c7262dff33c4087bc660ccf40f92f9c","3cbcea2be0984e7dbd5a48195af10ce7",22852637,1,-9,0,848,169,165,-4
"67a089198fcb4e1c8f2385786c2b296f","1c6721b1f63f4d30ba7746ea8af02a52",22852637,1,239,0,851,39,221,182
"1c6721b1f63f4d30ba7746ea8af02a52","1c6721b1f63f4d30ba7746ea8af02a52",22852637,1,0,1,852,221,221,0
"77ecef8eff6b4a2caea7707669bf7475","77ecef8eff6b4a2caea7707669bf7475",22852637,13,0,1,854,222,222,0
"1c6721b1f63f4d30ba7746ea8af02a52","d03cb855c70044cf8c35d9ec0de696e3",22852637,1,4,0,868,221,224,3
"d03cb855c70044cf8c35d9ec0de696e3","8b9ae98743bd4d4a8a87dff1c1244211",22852637,1,3,0,869,224,227,3
"d03cb855c70044cf8c35d9ec0de696e3","a49a937d6896486d9a5396654abcf2e1",22852637,1,2,0,871,224,226,2
"a49a937d6896486d9a5396654abcf2e1","a49a937d6896486d9a5396654abcf2e1",22852637,1,0,1,872,226,226,0
"a49a937d6896486d9a5396654abcf2e1","8b9ae98743bd4d4a8a87dff1c1244211",22852637,1,1,0,873,226,227,1
"8b9ae98743bd4d4a8a87dff1c1244211","8b9ae98743bd4d4a8a87dff1c1244211",22852637,25,0,1,874,227,227,0
"8b9ae98743bd4d4a8a87dff1c1244211","f7906d6f59b9489a91d2ef40db5a474d",22852637,1,-4,0,899,227,223,-4
"f7906d6f59b9489a91d2ef40db5a474d","2ab1535aac1346ba8801535bf729ef37",22852637,1,7,0,900,223,229,6
"2ab1535aac1346ba8801535bf729ef37","2ab1535aac1346ba8801535bf729ef37",22852637,1,0,1,901,229,229,0
"2ab1535aac1346ba8801535bf729ef37","a4f40fb48a8542c8949bae1f002cd9bc",22852637,1,2,0,902,229,231,2
"a4f40fb48a8542c8949bae1f002cd9bc","a4f40fb48a8542c8949bae1f002cd9bc",22852637,2,0,1,903,231,231,0
"a4f40fb48a8542c8949bae1f002cd9bc","8972c23e32044edb8a78fa1eed4e5947",22852637,1,1,0,905,231,232,1
"8972c23e32044edb8a78fa1eed4e5947","8972c23e32044edb8a78fa1eed4e5947",22852637,1,0,1,906,232,232,0
"8972c23e32044edb8a78fa1eed4e5947","92feb4a40f8344d38b6f722e42a53295",22852637,1,1,0,907,232,233,1
"92feb4a40f8344d38b6f722e42a53295","92feb4a40f8344d38b6f722e42a53295",22852637,2,0,1,908,233,233,0
"92feb4a40f8344d38b6f722e42a53295","5152833676bf4c6cb317060be10f68db",22852637,1,-5,0,910,233,228,-5
"5152833676bf4c6cb317060be10f68db","ca3e28f290354c08aefe5b0f769604e6",22852637,1,8,0,911,228,235,7
"ca3e28f290354c08aefe5b0f769604e6","ca3e28f290354c08aefe5b0f769604e6",22852637,9,0,1,912,235,235,0
"ca3e28f290354c08aefe5b0f769604e6","79a35eea833e4c2c9d22fc53c3c6445c",22852637,1,1,0,921,235,236,1
"79a35eea833e4c2c9d22fc53c3c6445c","79a35eea833e4c2c9d22fc53c3c6445c",22852637,4,0,1,922,236,236,0
"79a35eea833e4c2c9d22fc53c3c6445c","8f68228b1518449e9615cdafee41a2bd",22852637,1,1,0,926,236,237,1
"8f68228b1518449e9615cdafee41a2bd","8f68228b1518449e9615cdafee41a2bd",22852637,1,0,1,927,237,237,0
"8f68228b1518449e9615cdafee41a2bd","cab89fa5c3ed45a5aa550fc0352d6a42",22852637,1,1,0,928,237,238,1
"cab89fa5c3ed45a5aa550fc0352d6a42","cab89fa5c3ed45a5aa550fc0352d6a42",22852637,1,0,1,929,238,238,0
"cab89fa5c3ed45a5aa550fc0352d6a42","66d4fad4f1cf4b46be0750a99ad7a35a",22852637,1,1,0,930,238,239,1
"66d4fad4f1cf4b46be0750a99ad7a35a","66d4fad4f1cf4b46be0750a99ad7a35a",22852637,1,0,1,931,239,239,0
"66d4fad4f1cf4b46be0750a99ad7a35a","0b04c8e2f86d48c7aeb7e225819cd32b",22852637,1,-5,0,932,239,234,-5
"0b04c8e2f86d48c7aeb7e225819cd32b","f53da5fd9bfe412da4b80d4742563b6c",22852637,1,8,0,933,234,241,7
"f53da5fd9bfe412da4b80d4742563b6c","f53da5fd9bfe412da4b80d4742563b6c",22852637,1,0,1,934,241,241,0
"f53da5fd9bfe412da4b80d4742563b6c","2ae94c0cea4d480a9d5dca8fb1d7b542",22852637,1,3,0,935,241,242,1
"1ebf23f9d994469a85206e4c7b1bf5f5","1ebf23f9d994469a85206e4c7b1bf5f5",22852637,19,0,1,938,245,245,0
"1ebf23f9d994469a85206e4c7b1bf5f5","85ae675b83e8422da842cfd25596af99",22852637,1,1,0,957,245,246,1
"85ae675b83e8422da842cfd25596af99","85ae675b83e8422da842cfd25596af99",22852637,1,0,1,958,246,246,0
"85ae675b83e8422da842cfd25596af99","fa235f0f364d47e4ae1c87f47bf8e6ba",22852637,1,8,0,959,246,252,6
"fa235f0f364d47e4ae1c87f47bf8e6ba","2ae94c0cea4d480a9d5dca8fb1d7b542",22852637,1,-12,0,960,252,242,-10
"2ae94c0cea4d480a9d5dca8fb1d7b542","fa235f0f364d47e4ae1c87f47bf8e6ba",22852637,1,12,0,961,242,252,10
"fa235f0f364d47e4ae1c87f47bf8e6ba","79f7845465cc4ed19d8e4f1429541be0",22852637,1,2,0,962,252,254,2
"79f7845465cc4ed19d8e4f1429541be0","79f7845465cc4ed19d8e4f1429541be0",22852637,2,0,1,963,254,254,0
"79f7845465cc4ed19d8e4f1429541be0","6e83e23f56544a19b94067c1c558d9c0",22852637,1,-8,0,965,254,247,-7
"00f61990949545828dd12f1303d47504","00f61990949545828dd12f1303d47504",22852637,1,0,1,967,256,256,0
"00f61990949545828dd12f1303d47504","ead7bb4b64e247d2ae632ab8a296b091",22852637,1,2,0,968,256,258,2
"ead7bb4b64e247d2ae632ab8a296b091","ead7bb4b64e247d2ae632ab8a296b091",22852637,2,0,1,969,258,258,0
"ead7bb4b64e247d2ae632ab8a296b091","41b0048dde734bb280bac6116baa8e27",22852637,1,1,0,971,258,259,1
"41b0048dde734bb280bac6116baa8e27","41b0048dde734bb280bac6116baa8e27",22852637,2,0,1,972,259,259,0
"41b0048dde734bb280bac6116baa8e27","b41c5a094a604ee0915327da5cc0beb7",22852637,1,1,0,974,259,260,1
"b41c5a094a604ee0915327da5cc0beb7","b41c5a094a604ee0915327da5cc0beb7",22852637,5,0,1,975,260,260,0
"b41c5a094a604ee0915327da5cc0beb7","d546341988904f069cfa86b21457d9d9",22852637,1,-10,0,980,260,251,-9
"d546341988904f069cfa86b21457d9d9","28c171777c52431ab6b925073bd63d46",22852637,1,15,0,981,251,264,13
"28c171777c52431ab6b925073bd63d46","28c171777c52431ab6b925073bd63d46",22852637,7,0,1,982,264,264,0
"28c171777c52431ab6b925073bd63d46","ac160db940cb49ae8579162b1d52bb5d",22852637,1,2,0,989,264,266,2
"ac160db940cb49ae8579162b1d52bb5d","ac160db940cb49ae8579162b1d52bb5d",22852637,3,0,1,990,266,266,0
"ac160db940cb49ae8579162b1d52bb5d","d989ebcfc12a4b669f0100dc1aa14f1e",22852637,1,-12,0,993,266,255,-11
"d989ebcfc12a4b669f0100dc1aa14f1e","c6fd49b485cc4874b0bbdd9c6171e09c",22852637,1,15,0,994,255,268,13
"c6fd49b485cc4874b0bbdd9c6171e09c","c6fd49b485cc4874b0bbdd9c6171e09c",22852637,7,0,1,1000,268,268,0
"c6fd49b485cc4874b0bbdd9c6171e09c","44240778a97c4af0937817499b75707b",22852637,1,1,0,1002,268,269,1
"44240778a97c4af0937817499b75707b","44240778a97c4af0937817499b75707b",22852637,2,0,1,1003,269,269,0
"44240778a97c4af0937817499b75707b","7aa76d3e993840d8805f097cbdbcd44b",22852637,1,-9,0,1005,269,261,-8
"7aa76d3e993840d8805f097cbdbcd44b","865a4d3b43374da7944dc7d397f566d9",22852637,1,12,0,1006,261,271,10
"865a4d3b43374da7944dc7d397f566d9","865a4d3b43374da7944dc7d397f566d9",22852637,1,0,1,1007,271,271,0
"865a4d3b43374da7944dc7d397f566d9","2ae94c0cea4d480a9d5dca8fb1d7b542",22852637,1,-35,0,1008,271,242,-29
"2ae94c0cea4d480a9d5dca8fb1d7b542","0d987bed3ffa4ed0b9a2e62e97b7b30f",22852637,4,38,0,1009,242,272,30
"0d987bed3ffa4ed0b9a2e62e97b7b30f","0d987bed3ffa4ed0b9a2e62e97b7b30f",22852637,3,0,1,1010,272,272,0
"0d987bed3ffa4ed0b9a2e62e97b7b30f","bb5a47f5ea01454a8b79455422d3b9da",22852637,6,10,0,1011,272,280,8
"bb5a47f5ea01454a8b79455422d3b9da","bb5a47f5ea01454a8b79455422d3b9da",22852637,103,0,1,1012,280,280,0
"bb5a47f5ea01454a8b79455422d3b9da","82ae07bc0c9b4570a41799290d1ef399",22852637,6,-6,0,1014,280,275,-5
"82ae07bc0c9b4570a41799290d1ef399","bb5a47f5ea01454a8b79455422d3b9da",22852637,4,6,0,1015,275,280,5
"bb5a47f5ea01454a8b79455422d3b9da","bc5524e78a8544e2ae2fdc2f3462bbec",22852637,2,-1,0,1020,280,279,-1
"bc5524e78a8544e2ae2fdc2f3462bbec","0d987bed3ffa4ed0b9a2e62e97b7b30f",22852637,1,-9,0,1021,279,272,-7
"0d987bed3ffa4ed0b9a2e62e97b7b30f","2ae94c0cea4d480a9d5dca8fb1d7b542",22852637,3,-38,0,1023,272,242,-30
"0d987bed3ffa4ed0b9a2e62e97b7b30f","7028800abe7d4e27b613d1d6cbe26bf7",22852637,1,-8,0,1025,272,267,-5
"7028800abe7d4e27b613d1d6cbe26bf7","7aa76d3e993840d8805f097cbdbcd44b",22852637,1,-7,0,1026,267,261,-6
"7aa76d3e993840d8805f097cbdbcd44b","d546341988904f069cfa86b21457d9d9",22852637,1,-12,0,1027,261,251,-10
"d546341988904f069cfa86b21457d9d9","00f61990949545828dd12f1303d47504",22852637,1,6,0,1028,251,256,5
"00f61990949545828dd12f1303d47504","d989ebcfc12a4b669f0100dc1aa14f1e",22852637,1,-1,0,1029,256,255,-1
"d989ebcfc12a4b669f0100dc1aa14f1e","fa235f0f364d47e4ae1c87f47bf8e6ba",22852637,1,-4,0,1030,255,252,-3
"fa235f0f364d47e4ae1c87f47bf8e6ba","6e83e23f56544a19b94067c1c558d9c0",22852637,1,-6,0,1031,252,247,-5
"6e83e23f56544a19b94067c1c558d9c0","00f61990949545828dd12f1303d47504",22852637,2,11,0,1032,247,256,9
"00f61990949545828dd12f1303d47504","d546341988904f069cfa86b21457d9d9",22852637,1,-6,0,1033,256,251,-5
"d546341988904f069cfa86b21457d9d9","d989ebcfc12a4b669f0100dc1aa14f1e",22852637,2,5,0,1034,251,255,4
"d989ebcfc12a4b669f0100dc1aa14f1e","7aa76d3e993840d8805f097cbdbcd44b",22852637,2,7,0,1035,255,261,6
"7aa76d3e993840d8805f097cbdbcd44b","0d987bed3ffa4ed0b9a2e62e97b7b30f",22852637,2,15,0,1036,261,272,11
"bc5524e78a8544e2ae2fdc2f3462bbec","bb5a47f5ea01454a8b79455422d3b9da",22852637,3,1,0,1049,279,280,1
"82ae07bc0c9b4570a41799290d1ef399","0d987bed3ffa4ed0b9a2e62e97b7b30f",22852637,1,-4,0,1052,275,272,-3
"82ae07bc0c9b4570a41799290d1ef399","bc5524e78a8544e2ae2fdc2f3462bbec",22852637,1,5,0,1062,275,279,4
"bb5a47f5ea01454a8b79455422d3b9da","94cecc3f1e7d484b8e068e79241dfd73",22852637,2,3,0,1122,280,281,1
"94cecc3f1e7d484b8e068e79241dfd73","0d987bed3ffa4ed0b9a2e62e97b7b30f",22852637,2,-13,0,1123,281,272,-9
"0d987bed3ffa4ed0b9a2e62e97b7b30f","a37477c4e4c14169ad44b06b493007f6",22852637,2,15,0,1124,272,283,11
"a37477c4e4c14169ad44b06b493007f6","3cbcea2be0984e7dbd5a48195af10ce7",22852637,1,-159,0,1125,283,165,-118
"3cbcea2be0984e7dbd5a48195af10ce7","82e6285962b8400d9d6fc32436022a94",22852637,63,2,0,1126,165,167,2
"82e6285962b8400d9d6fc32436022a94","3cbcea2be0984e7dbd5a48195af10ce7",22852637,37,-2,0,1127,167,165,-2
"82e6285962b8400d9d6fc32436022a94","0d987bed3ffa4ed0b9a2e62e97b7b30f",22852637,3,142,0,1129,167,272,105
"0d987bed3ffa4ed0b9a2e62e97b7b30f","bc5524e78a8544e2ae2fdc2f3462bbec",22852637,1,9,0,1130,272,279,7
"bb5a47f5ea01454a8b79455422d3b9da","3cbcea2be0984e7dbd5a48195af10ce7",22852637,3,-154,0,1139,280,165,-115
"82e6285962b8400d9d6fc32436022a94","93679be414554a11b1893002f2229a93",22852637,2,-175,0,1167,167,35,-132
"93679be414554a11b1893002f2229a93","3cbcea2be0984e7dbd5a48195af10ce7",22852637,3,173,0,1168,35,165,130
"82e6285962b8400d9d6fc32436022a94","b71bac264efb4abd97015447bd490db6",22852637,2,274,0,1172,167,370,203
"b71bac264efb4abd97015447bd490db6","b71bac264efb4abd97015447bd490db6",22852637,6,0,1,1173,370,370,0
"b71bac264efb4abd97015447bd490db6","1b4550d0dab04078b3bf08a655345bdc",22852637,1,4,0,1174,370,373,3
"1b4550d0dab04078b3bf08a655345bdc","b71bac264efb4abd97015447bd490db6",22852637,1,-4,0,1175,373,370,-3
"b71bac264efb4abd97015447bd490db6","8d448d625b024c82a5eb240bbd7431d6",22852637,6,5,0,1176,370,374,4
"8d448d625b024c82a5eb240bbd7431d6","8d448d625b024c82a5eb240bbd7431d6",22852637,75,0,1,1177,374,374,0
"8d448d625b024c82a5eb240bbd7431d6","3cbcea2be0984e7dbd5a48195af10ce7",22852637,1,-281,0,1184,374,165,-209
"82e6285962b8400d9d6fc32436022a94","67a089198fcb4e1c8f2385786c2b296f",22852637,9,-162,0,1186,167,39,-128
"67a089198fcb4e1c8f2385786c2b296f","67a089198fcb4e1c8f2385786c2b296f",22852637,2,0,1,1187,39,39,0
"67a089198fcb4e1c8f2385786c2b296f","3cbcea2be0984e7dbd5a48195af10ce7",22852637,2,160,0,1188,39,165,126
"67a089198fcb4e1c8f2385786c2b296f","4a29443515bb404cb8924e1c60a63b73",22852637,1,326,0,1191,39,285,246
"4a29443515bb404cb8924e1c60a63b73","4a29443515bb404cb8924e1c60a63b73",22852637,2,0,1,1192,285,285,0
"4a29443515bb404cb8924e1c60a63b73","208c9b2796c944db8dacaa96082520ea",22852637,4,3,0,1193,285,288,3
"208c9b2796c944db8dacaa96082520ea","208c9b2796c944db8dacaa96082520ea",22852637,1,0,1,1194,288,288,0
"208c9b2796c944db8dacaa96082520ea","4a29443515bb404cb8924e1c60a63b73",22852637,3,-3,0,1195,288,285,-3
"4a29443515bb404cb8924e1c60a63b73","7669a956527947d0add87455277e80b4",22852637,1,7,0,1196,285,291,6
"7669a956527947d0add87455277e80b4","7669a956527947d0add87455277e80b4",22852637,1,0,1,1197,291,291,0
"7669a956527947d0add87455277e80b4","869e967078f04da18dd0b0b9389a7424",22852637,1,3,0,1198,291,293,2
"869e967078f04da18dd0b0b9389a7424","6a9a3b5bde4a48daa896fe8c06eca56f",22852637,2,-5,0,1199,293,289,-4
"6a9a3b5bde4a48daa896fe8c06eca56f","869e967078f04da18dd0b0b9389a7424",22852637,1,5,0,1200,289,293,4
"869e967078f04da18dd0b0b9389a7424","51ab6291537748fab90d519aa09889d6",22852637,1,2,0,1201,293,295,2
"51ab6291537748fab90d519aa09889d6","51ab6291537748fab90d519aa09889d6",22852637,5,0,1,1202,295,295,0
"51ab6291537748fab90d519aa09889d6","34a6e49023fc4465bd5ca604330bbd1c",22852637,1,-3,0,1207,295,292,-3
"34a6e49023fc4465bd5ca604330bbd1c","21592f2a9e9c4b2f8c66ec5dbcbf6a2b",22852637,1,5,0,1208,292,296,4
"21592f2a9e9c4b2f8c66ec5dbcbf6a2b","ba0e59461bfb4a44b7b1c28a01f8d3b3",22852637,1,4,0,1209,296,299,3
"ba0e59461bfb4a44b7b1c28a01f8d3b3","ba0e59461bfb4a44b7b1c28a01f8d3b3",22852637,1,0,1,1210,299,299,0
"ba0e59461bfb4a44b7b1c28a01f8d3b3","0e0b36e731a645e7b1b8a88f5031ca38",22852637,1,2,0,1211,299,301,2
"0e0b36e731a645e7b1b8a88f5031ca38","0e0b36e731a645e7b1b8a88f5031ca38",22852637,5,0,1,1212,301,301,0
"0e0b36e731a645e7b1b8a88f5031ca38","a66a144637284c21afc6de17fea4bfb8",22852637,1,1,0,1217,301,302,1
"a66a144637284c21afc6de17fea4bfb8","a66a144637284c21afc6de17fea4bfb8",22852637,2,0,1,1218,302,302,0
"a66a144637284c21afc6de17fea4bfb8","7646a919d7e64fa990bca9b024ff089d",22852637,1,-4,0,1220,302,298,-4
"7646a919d7e64fa990bca9b024ff089d","e390b575229748ea8aac9364efe2bf00",22852637,1,7,0,1221,298,304,6
"e390b575229748ea8aac9364efe2bf00","e390b575229748ea8aac9364efe2bf00",22852637,1,0,1,1222,304,304,0
"e390b575229748ea8aac9364efe2bf00","4a29443515bb404cb8924e1c60a63b73",22852637,1,-24,0,1223,304,285,-19
"4a29443515bb404cb8924e1c60a63b73","3434c10e561d488a914e0f7d71907abd",22852637,1,27,0,1224,285,305,20
"3434c10e561d488a914e0f7d71907abd","53e7e900392747ccad52e711ab0f80d8",22852637,1,2,0,1225,305,307,2
"53e7e900392747ccad52e711ab0f80d8","53e7e900392747ccad52e711ab0f80d8",22852637,1,0,1,1226,307,307,0
"53e7e900392747ccad52e711ab0f80d8","130acc2aeb0448fdbb2de63bc5cebe5b",22852637,2,3,0,1227,307,309,2
"130acc2aeb0448fdbb2de63bc5cebe5b","3434c10e561d488a914e0f7d71907abd",22852637,2,-5,0,1228,309,305,-4
"3434c10e561d488a914e0f7d71907abd","9c062b3251034ebe90f5054e2a3b5120",22852637,1,7,0,1229,305,311,6
"9c062b3251034ebe90f5054e2a3b5120","9c062b3251034ebe90f5054e2a3b5120",22852637,2,0,1,1230,311,311,0
"9c062b3251034ebe90f5054e2a3b5120","ea859f8207e44537889daeaba13ac2e8",22852637,1,1,0,1232,311,312,1
"ea859f8207e44537889daeaba13ac2e8","ea859f8207e44537889daeaba13ac2e8",22852637,1,0,1,1233,312,312,0
"ea859f8207e44537889daeaba13ac2e8","56d94971a7a94257aa330183a8ebd0ea",22852637,1,1,0,1234,312,313,1
"56d94971a7a94257aa330183a8ebd0ea","56d94971a7a94257aa330183a8ebd0ea",22852637,4,0,1,1235,313,313,0
"56d94971a7a94257aa330183a8ebd0ea","141c0df6cd1946539aadd1c9b7068cd4",22852637,1,-5,0,1239,313,308,-5
"141c0df6cd1946539aadd1c9b7068cd4","13255e63e0aa4abf85e5211bf613d43e",22852637,1,10,0,1240,308,317,9
"13255e63e0aa4abf85e5211bf613d43e","13255e63e0aa4abf85e5211bf613d43e",22852637,1,0,1,1241,317,317,0
"13255e63e0aa4abf85e5211bf613d43e","86c27d40179e419c8e9d150fb6afa5d0",22852637,1,3,0,1242,317,319,2
"86c27d40179e419c8e9d150fb6afa5d0","0c787d16c9504873b1a4d903cec09948",22852637,1,-6,0,1243,319,314,-5
"0c787d16c9504873b1a4d903cec09948","86c27d40179e419c8e9d150fb6afa5d0",22852637,1,6,0,1244,314,319,5
"86c27d40179e419c8e9d150fb6afa5d0","47edbb64109243e6b0f8f64cdef90c6c",22852637,1,8,0,1245,319,326,7
"47edbb64109243e6b0f8f64cdef90c6c","24f1363179ad4aaa965484a78471912b",22852637,2,-3,0,1246,326,323,-3
"24f1363179ad4aaa965484a78471912b","8d7e0b55cf9849cda222a0f2440cec55",22852637,1,-6,0,1247,323,318,-5
"8d7e0b55cf9849cda222a0f2440cec55","24f1363179ad4aaa965484a78471912b",22852637,1,6,0,1248,318,323,5
"24f1363179ad4aaa965484a78471912b","3434c10e561d488a914e0f7d71907abd",22852637,1,-22,0,1249,323,305,-18
"3434c10e561d488a914e0f7d71907abd","47edbb64109243e6b0f8f64cdef90c6c",22852637,1,25,0,1250,305,326,21
"24f1363179ad4aaa965484a78471912b","3628bdce1dd2429ba924d2d4d09448d2",22852637,1,-1,0,1252,323,322,-1
"3628bdce1dd2429ba924d2d4d09448d2","56b3fd1a212a4764be39d979fde3326e",22852637,1,7,0,1253,322,328,6
"56b3fd1a212a4764be39d979fde3326e","56b3fd1a212a4764be39d979fde3326e",22852637,1,0,1,1254,328,328,0
"56b3fd1a212a4764be39d979fde3326e","3434c10e561d488a914e0f7d71907abd",22852637,1,-28,0,1255,328,305,-23
"3434c10e561d488a914e0f7d71907abd","0c4079457ede49e3aeb5e86ed84bdf35",22852637,1,31,0,1256,305,329,24
"0c4079457ede49e3aeb5e86ed84bdf35","38aea304b4fa46e1b29bb72f5cea4c93",22852637,6,2,0,1257,329,331,2
"38aea304b4fa46e1b29bb72f5cea4c93","4a29443515bb404cb8924e1c60a63b73",22852637,2,-60,0,1258,331,285,-46
"4a29443515bb404cb8924e1c60a63b73","0c4079457ede49e3aeb5e86ed84bdf35",22852637,2,58,0,1259,285,329,44
"0c4079457ede49e3aeb5e86ed84bdf35","0c4079457ede49e3aeb5e86ed84bdf35",22852637,4,0,1,1260,329,329,0
"38aea304b4fa46e1b29bb72f5cea4c93","38aea304b4fa46e1b29bb72f5cea4c93",22852637,4,0,1,1262,331,331,0
"38aea304b4fa46e1b29bb72f5cea4c93","e36d261332f14e79bb4b467aceaeb9b5",22852637,1,2,0,1263,331,333,2
"e36d261332f14e79bb4b467aceaeb9b5","e36d261332f14e79bb4b467aceaeb9b5",22852637,1,0,1,1264,333,333,0
"e36d261332f14e79bb4b467aceaeb9b5","c7e89b9d04744d2eab742fc24e3ef1ae",22852637,1,1,0,1265,333,334,1
"c7e89b9d04744d2eab742fc24e3ef1ae","c7e89b9d04744d2eab742fc24e3ef1ae",22852637,2,0,1,1266,334,334,0
"c7e89b9d04744d2eab742fc24e3ef1ae","fe49f8054b374a0ea4bb266ed135ff62",22852637,1,1,0,1268,334,335,1
"fe49f8054b374a0ea4bb266ed135ff62","fe49f8054b374a0ea4bb266ed135ff62",22852637,2,0,1,1269,335,335,0
"fe49f8054b374a0ea4bb266ed135ff62","d0a8f74af98642fe8360d22c42e45117",22852637,1,1,0,1271,335,336,1
"d0a8f74af98642fe8360d22c42e45117","d0a8f74af98642fe8360d22c42e45117",22852637,2,0,1,1272,336,336,0
"d0a8f74af98642fe8360d22c42e45117","0c4079457ede49e3aeb5e86ed84bdf35",22852637,1,-7,0,1274,336,329,-7
"0c4079457ede49e3aeb5e86ed84bdf35","bbc5139ca9024389a94db3a6f47dcff6",22852637,2,14,0,1275,329,341,12
"bbc5139ca9024389a94db3a6f47dcff6","b8b9418ab322418d9db9b40d96af873a",22852637,2,-5,0,1276,341,337,-4
"b8b9418ab322418d9db9b40d96af873a","bbc5139ca9024389a94db3a6f47dcff6",22852637,1,5,0,1277,337,341,4
"bbc5139ca9024389a94db3a6f47dcff6","bbc5139ca9024389a94db3a6f47dcff6",22852637,1,0,1,1278,341,341,0
"bbc5139ca9024389a94db3a6f47dcff6","4ee6ca9019ab4a1ab323f98094a9bd77",22852637,1,2,0,1279,341,343,2
"4ee6ca9019ab4a1ab323f98094a9bd77","4ee6ca9019ab4a1ab323f98094a9bd77",22852637,2,0,1,1280,343,343,0
"4ee6ca9019ab4a1ab323f98094a9bd77","b37947176785476f8b29d49a851366dc",22852637,1,1,0,1282,343,344,1
"b37947176785476f8b29d49a851366dc","b37947176785476f8b29d49a851366dc",22852637,2,0,1,1283,344,344,0
"b37947176785476f8b29d49a851366dc","fcea5b10d5a14a3b9324ffece8f6e1e5",22852637,1,1,0,1285,344,345,1
"fcea5b10d5a14a3b9324ffece8f6e1e5","fcea5b10d5a14a3b9324ffece8f6e1e5",22852637,2,0,1,1286,345,345,0
"fcea5b10d5a14a3b9324ffece8f6e1e5","c2490bc612d146edbe786556fab3651b",22852637,1,-5,0,1288,345,340,-5
"c2490bc612d146edbe786556fab3651b","6ac8bb048b854999a47edb35fe627f11",22852637,1,8,0,1289,340,347,7
"6ac8bb048b854999a47edb35fe627f11","6ac8bb048b854999a47edb35fe627f11",22852637,1,0,1,1290,347,347,0
"6ac8bb048b854999a47edb35fe627f11","30ead9794d4847abaf222ca966cc8630",22852637,1,3,0,1291,347,348,1
"30ead9794d4847abaf222ca966cc8630","0c4079457ede49e3aeb5e86ed84bdf35",22852637,1,-24,0,1292,348,329,-19
"0c4079457ede49e3aeb5e86ed84bdf35","eff0de7f2dbb42dfa1a2e686efab5b6d",22852637,1,30,0,1293,329,354,25
"eff0de7f2dbb42dfa1a2e686efab5b6d","09b9678ddc3d452ea4a3d46e15826065",22852637,2,-1,0,1294,354,353,-1
"09b9678ddc3d452ea4a3d46e15826065","897b7f51242c44aab2205c72fdcbf4cd",22852637,1,-1,0,1295,353,352,-1
"897b7f51242c44aab2205c72fdcbf4cd","c20993c944444fe085345591a8bd837e",22852637,1,-1,0,1296,352,351,-1
"c20993c944444fe085345591a8bd837e","4a29443515bb404cb8924e1c60a63b73",22852637,1,-85,0,1297,351,285,-66
"4a29443515bb404cb8924e1c60a63b73","30ead9794d4847abaf222ca966cc8630",22852637,1,82,0,1298,285,348,63
"30ead9794d4847abaf222ca966cc8630","897b7f51242c44aab2205c72fdcbf4cd",22852637,1,4,0,1299,348,352,4
"897b7f51242c44aab2205c72fdcbf4cd","eff0de7f2dbb42dfa1a2e686efab5b6d",22852637,1,2,0,1300,352,354,2
"09b9678ddc3d452ea4a3d46e15826065","c20993c944444fe085345591a8bd837e",22852637,1,-2,0,1302,353,351,-2
"c20993c944444fe085345591a8bd837e","eff0de7f2dbb42dfa1a2e686efab5b6d",22852637,1,3,0,1303,351,354,3
"eff0de7f2dbb42dfa1a2e686efab5b6d","eff0de7f2dbb42dfa1a2e686efab5b6d",22852637,3,0,1,1304,354,354,0
"eff0de7f2dbb42dfa1a2e686efab5b6d","30ead9794d4847abaf222ca966cc8630",22852637,1,-6,0,1307,354,348,-6
"30ead9794d4847abaf222ca966cc8630","2fe14166dc9642c3bc666b86a57f943d",22852637,1,10,0,1308,348,357,9
"2fe14166dc9642c3bc666b86a57f943d","2fe14166dc9642c3bc666b86a57f943d",22852637,1,0,1,1309,357,357,0
"2fe14166dc9642c3bc666b86a57f943d","44421dd1e13a47a388c4a19834b744c7",22852637,1,2,0,1310,357,359,2
"44421dd1e13a47a388c4a19834b744c7","44421dd1e13a47a388c4a19834b744c7",22852637,2,0,1,1311,359,359,0
"44421dd1e13a47a388c4a19834b744c7","cb5fc7ef85d547c4be1a7439d0bf6052",22852637,1,1,0,1313,359,360,1
"cb5fc7ef85d547c4be1a7439d0bf6052","cb5fc7ef85d547c4be1a7439d0bf6052",22852637,2,0,1,1314,360,360,0
"cb5fc7ef85d547c4be1a7439d0bf6052","0a8f150a4cf747acbde62f4721823da3",22852637,1,1,0,1316,360,361,1
"0a8f150a4cf747acbde62f4721823da3","0a8f150a4cf747acbde62f4721823da3",22852637,5,0,1,1317,361,361,0
"0a8f150a4cf747acbde62f4721823da3","ab8fdad974ae471f9f24c3f9dd04462e",22852637,1,1,0,1322,361,362,1
"ab8fdad974ae471f9f24c3f9dd04462e","ab8fdad974ae471f9f24c3f9dd04462e",22852637,2,0,1,1323,362,362,0
"ab8fdad974ae471f9f24c3f9dd04462e","1ba8fef685d74a8194b9db252eb704fb",22852637,1,-7,0,1325,362,355,-7
"1ba8fef685d74a8194b9db252eb704fb","52580888dadb4fe3baa795683ea227bd",22852637,1,10,0,1326,355,364,9
"52580888dadb4fe3baa795683ea227bd","52580888dadb4fe3baa795683ea227bd",22852637,4,0,1,1327,364,364,0
"52580888dadb4fe3baa795683ea227bd","f00179e251a045b39c3f7a54f9aa4acc",22852637,1,-1,0,1328,364,363,-1
"f00179e251a045b39c3f7a54f9aa4acc","492a3bc6a1254f23a7998587961b22a4",22852637,1,4,0,1329,363,366,3
"492a3bc6a1254f23a7998587961b22a4","492a3bc6a1254f23a7998587961b22a4",22852637,1,0,1,1330,366,366,0
"492a3bc6a1254f23a7998587961b22a4","072a190fd302456290895f9f04d6940a",22852637,1,-1,0,1331,366,365,-1
"072a190fd302456290895f9f04d6940a","c76574d21bc14aeea7ecd0b027f39858",22852637,1,3,0,1332,365,367,2
"c76574d21bc14aeea7ecd0b027f39858","492a3bc6a1254f23a7998587961b22a4",22852637,1,-2,0,1333,367,366,-1
"492a3bc6a1254f23a7998587961b22a4","f00179e251a045b39c3f7a54f9aa4acc",22852637,1,-4,0,1334,366,363,-3
"f00179e251a045b39c3f7a54f9aa4acc","30ead9794d4847abaf222ca966cc8630",22852637,1,-17,0,1335,363,348,-15
"30ead9794d4847abaf222ca966cc8630","52580888dadb4fe3baa795683ea227bd",22852637,1,18,0,1336,348,364,16
"52580888dadb4fe3baa795683ea227bd","c76574d21bc14aeea7ecd0b027f39858",22852637,1,5,0,1340,364,367,3
"c76574d21bc14aeea7ecd0b027f39858","30ead9794d4847abaf222ca966cc8630",22852637,1,-23,0,1341,367,348,-19
"30ead9794d4847abaf222ca966cc8630","cfa457d1743848e4bb5e4beced6448ed",22852637,1,25,0,1342,348,369,21
"cfa457d1743848e4bb5e4beced6448ed","cfa457d1743848e4bb5e4beced6448ed",22852637,1,0,1,1343,369,369,0
"cfa457d1743848e4bb5e4beced6448ed","30ead9794d4847abaf222ca966cc8630",22852637,1,-25,0,1344,369,348,-21
"30ead9794d4847abaf222ca966cc8630","b71bac264efb4abd97015447bd490db6",22852637,1,28,0,1345,348,370,22
"b71bac264efb4abd97015447bd490db6","3cbcea2be0984e7dbd5a48195af10ce7",22852637,2,-276,0,1346,370,165,-205
"67a089198fcb4e1c8f2385786c2b296f","0c4079457ede49e3aeb5e86ed84bdf35",22852637,2,384,0,1349,39,329,290
"bbc5139ca9024389a94db3a6f47dcff6","4a92daef4d504e1792575a26502bb7b7",22852637,1,6,0,1351,341,346,5
"4a92daef4d504e1792575a26502bb7b7","c2490bc612d146edbe786556fab3651b",22852637,1,-7,0,1352,346,340,-6
"c2490bc612d146edbe786556fab3651b","a7c6339ca1da4368a18d471f0519f877",22852637,1,-2,0,1353,340,339,-1
"a7c6339ca1da4368a18d471f0519f877","a7c6339ca1da4368a18d471f0519f877",22852637,1,0,1,1354,339,339,0
"a7c6339ca1da4368a18d471f0519f877","bbc5139ca9024389a94db3a6f47dcff6",22852637,1,3,0,1355,339,341,2
"b8b9418ab322418d9db9b40d96af873a","3cbcea2be0984e7dbd5a48195af10ce7",22852637,1,-233,0,1357,337,165,-172
"38aea304b4fa46e1b29bb72f5cea4c93","b71bac264efb4abd97015447bd490db6",22852637,2,50,0,1362,331,370,39
"8d448d625b024c82a5eb240bbd7431d6","b71bac264efb4abd97015447bd490db6",22852637,5,-5,0,1370,374,370,-4
"b71bac264efb4abd97015447bd490db6","4a29443515bb404cb8924e1c60a63b73",22852637,1,-110,0,1379,370,285,-85
"b71bac264efb4abd97015447bd490db6","d6d02b6ef04e4f17805504500b8ce441",22852637,1,8,0,1441,370,375,5
"d6d02b6ef04e4f17805504500b8ce441","d6d02b6ef04e4f17805504500b8ce441",22852637,4,0,1,1442,375,375,0
"d6d02b6ef04e4f17805504500b8ce441","3cbcea2be0984e7dbd5a48195af10ce7",22852637,1,-284,0,1443,375,165,-210
"3cbcea2be0984e7dbd5a48195af10ce7","3cbcea2be0984e7dbd5a48195af10ce7",22852637,10,0,1,1450,165,165,0
"82e6285962b8400d9d6fc32436022a94","fc0e049d56024bc9a02c9a9c435c3df7",22852637,1,-166,0,1472,167,38,-129
"fc0e049d56024bc9a02c9a9c435c3df7","c33c17be71ae4d588da7369472e5bb1b",22852637,1,-12,0,1473,38,34,-4
"c33c17be71ae4d588da7369472e5bb1b","c33c17be71ae4d588da7369472e5bb1b",22852637,3,0,1,1474,34,34,0
"c33c17be71ae4d588da7369472e5bb1b","93679be414554a11b1893002f2229a93",22852637,5,3,0,1475,34,35,1
"93679be414554a11b1893002f2229a93","93679be414554a11b1893002f2229a93",22852637,3,0,1,1476,35,35,0
"93679be414554a11b1893002f2229a93","c33c17be71ae4d588da7369472e5bb1b",22852637,2,-3,0,1477,35,34,-1
"82e6285962b8400d9d6fc32436022a94","b2f0d654738f48158edff28e8d3a546e",22852637,2,398,0,1481,167,449,282
"b2f0d654738f48158edff28e8d3a546e","b2f0d654738f48158edff28e8d3a546e",22852637,4,0,1,1482,449,449,0
"b2f0d654738f48158edff28e8d3a546e","f67fbf45a5f146ed866965bc57c7c001",22852637,3,8,0,1483,449,454,5
"f67fbf45a5f146ed866965bc57c7c001","f67fbf45a5f146ed866965bc57c7c001",22852637,5,0,1,1484,454,454,0
"f67fbf45a5f146ed866965bc57c7c001","3cbcea2be0984e7dbd5a48195af10ce7",22852637,2,-408,0,1485,454,165,-289
"67a089198fcb4e1c8f2385786c2b296f","66baf19b6b904b70922329068c63746d",22852637,1,448,0,1488,39,376,337
"66baf19b6b904b70922329068c63746d","66baf19b6b904b70922329068c63746d",22852637,4,0,1,1489,376,376,0
"66baf19b6b904b70922329068c63746d","7f544639412e40a9ba27f43b415362ab",22852637,3,2,0,1490,376,378,2
"7f544639412e40a9ba27f43b415362ab","7f544639412e40a9ba27f43b415362ab",22852637,2,0,1,1491,378,378,0
"7f544639412e40a9ba27f43b415362ab","d5ae8642e15b46b8bd298b02274d4e9c",22852637,1,2,0,1492,378,380,2
"d5ae8642e15b46b8bd298b02274d4e9c","d5ae8642e15b46b8bd298b02274d4e9c",22852637,1,0,1,1493,380,380,0
"d5ae8642e15b46b8bd298b02274d4e9c","a0d10309a2dd456289147f84be9d37f9",22852637,1,1,0,1494,380,381,1
"a0d10309a2dd456289147f84be9d37f9","a0d10309a2dd456289147f84be9d37f9",22852637,2,0,1,1495,381,381,0
"a0d10309a2dd456289147f84be9d37f9","0fcbc3ca07b144138b8d85da581f09a8",22852637,1,1,0,1497,381,382,1
"0fcbc3ca07b144138b8d85da581f09a8","0fcbc3ca07b144138b8d85da581f09a8",22852637,2,0,1,1498,382,382,0
"0fcbc3ca07b144138b8d85da581f09a8","66baf19b6b904b70922329068c63746d",22852637,1,-6,0,1500,382,376,-6
"66baf19b6b904b70922329068c63746d","c2fca3669923477ab966ded303dea31c",22852637,1,8,0,1501,376,383,7
"c2fca3669923477ab966ded303dea31c","4890121ce5d74576b4632b77cfc23398",22852637,1,6,0,1502,383,388,5
"4890121ce5d74576b4632b77cfc23398","4890121ce5d74576b4632b77cfc23398",22852637,1,0,1,1503,388,388,0
"4890121ce5d74576b4632b77cfc23398","18d3b836dd804224883cc9180b60a8e1",22852637,1,-1,0,1504,388,387,-1
"18d3b836dd804224883cc9180b60a8e1","96bb2b3e85a34d8b9544514e89f6fe97",22852637,1,4,0,1505,387,390,3
"96bb2b3e85a34d8b9544514e89f6fe97","96bb2b3e85a34d8b9544514e89f6fe97",22852637,1,0,1,1506,390,390,0
"96bb2b3e85a34d8b9544514e89f6fe97","ac4e9b54acfe4670b4634859c7263cb5",22852637,1,2,0,1507,390,392,2
"ac4e9b54acfe4670b4634859c7263cb5","ac4e9b54acfe4670b4634859c7263cb5",22852637,3,0,1,1508,392,392,0
"ac4e9b54acfe4670b4634859c7263cb5","6f8881a745ac4c358a68b92c3b4abe81",22852637,1,3,0,1511,392,394,2
"6f8881a745ac4c358a68b92c3b4abe81","17f95d18bab743888e1736033dc3384d",22852637,1,-6,0,1512,394,389,-5
"17f95d18bab743888e1736033dc3384d","6f8881a745ac4c358a68b92c3b4abe81",22852637,1,6,0,1513,389,394,5
"6f8881a745ac4c358a68b92c3b4abe81","f7002c8484354eceac57bc7bd62c76c1",22852637,1,-1,0,1514,394,393,-1
"f7002c8484354eceac57bc7bd62c76c1","44a277ea44dc4ae689fab4b82f0b4098",22852637,1,5,0,1515,393,397,4
"44a277ea44dc4ae689fab4b82f0b4098","44a277ea44dc4ae689fab4b82f0b4098",22852637,1,0,1,1516,397,397,0
"44a277ea44dc4ae689fab4b82f0b4098","0c12af0a4e7f4002852cf84b2537c161",22852637,1,-2,0,1517,397,395,-2
"0c12af0a4e7f4002852cf84b2537c161","859e0b8d71694b12befb69ee698138f9",22852637,1,5,0,1518,395,399,4
"859e0b8d71694b12befb69ee698138f9","859e0b8d71694b12befb69ee698138f9",22852637,1,0,1,1519,399,399,0
"859e0b8d71694b12befb69ee698138f9","2b09a08242b54983aec7063990fb3f66",22852637,1,3,0,1520,399,400,1
"2b09a08242b54983aec7063990fb3f66","66baf19b6b904b70922329068c63746d",22852637,1,-32,0,1521,400,376,-24
"66baf19b6b904b70922329068c63746d","2b09a08242b54983aec7063990fb3f66",22852637,1,32,0,1522,376,400,24
"2b09a08242b54983aec7063990fb3f66","3cbcea2be0984e7dbd5a48195af10ce7",22852637,1,-320,0,1523,400,165,-235
"67a089198fcb4e1c8f2385786c2b296f","2b09a08242b54983aec7063990fb3f66",22852637,1,480,0,1526,39,400,361
"2b09a08242b54983aec7063990fb3f66","2b09a08242b54983aec7063990fb3f66",22852637,8,0,1,1527,400,400,0
"2b09a08242b54983aec7063990fb3f66","1f471b7a883a4df48211e8c6a81b59a7",22852637,1,1,0,1530,400,401,1
"1f471b7a883a4df48211e8c6a81b59a7","1f471b7a883a4df48211e8c6a81b59a7",22852637,1,0,1,1531,401,401,0
"1f471b7a883a4df48211e8c6a81b59a7","2b09a08242b54983aec7063990fb3f66",22852637,1,-1,0,1532,401,400,-1
"2b09a08242b54983aec7063990fb3f66","9de0d567bfa84fe5b77cb76f4a76a5d1",22852637,1,5,0,1533,400,404,4
"9de0d567bfa84fe5b77cb76f4a76a5d1","9de0d567bfa84fe5b77cb76f4a76a5d1",22852637,1,0,1,1534,404,404,0
"9de0d567bfa84fe5b77cb76f4a76a5d1","1157bd665ec4472fb58b751dc5099355",22852637,1,-1,0,1535,404,403,-1
"1157bd665ec4472fb58b751dc5099355","3c8a22d2f9c146ea956609e3ed4f2559",22852637,2,3,0,1536,403,405,2
"3c8a22d2f9c146ea956609e3ed4f2559","58fc9094275e4c49be3f4ba6d4acc0a4",22852637,2,2,0,1537,405,406,1
"58fc9094275e4c49be3f4ba6d4acc0a4","58fc9094275e4c49be3f4ba6d4acc0a4",22852637,2,0,1,1538,406,406,0
"58fc9094275e4c49be3f4ba6d4acc0a4","c1c1be90b2b14c1ab4a5e1ee3c241902",22852637,1,1,0,1539,406,407,1
"c1c1be90b2b14c1ab4a5e1ee3c241902","c1c1be90b2b14c1ab4a5e1ee3c241902",22852637,5,0,1,1540,407,407,0
"c1c1be90b2b14c1ab4a5e1ee3c241902","58fc9094275e4c49be3f4ba6d4acc0a4",22852637,1,-1,0,1545,407,406,-1
"58fc9094275e4c49be3f4ba6d4acc0a4","02b3a1bead9244c1ba2f857c7da8f82a",22852637,1,3,0,1546,406,408,2
"02b3a1bead9244c1ba2f857c7da8f82a","02b3a1bead9244c1ba2f857c7da8f82a",22852637,1,0,1,1547,408,408,0
"02b3a1bead9244c1ba2f857c7da8f82a","6206fc6479014bb193084c32409dc1b9",22852637,1,1,0,1548,408,409,1
"6206fc6479014bb193084c32409dc1b9","6206fc6479014bb193084c32409dc1b9",22852637,1,0,1,1549,409,409,0
"6206fc6479014bb193084c32409dc1b9","02b3a1bead9244c1ba2f857c7da8f82a",22852637,1,-1,0,1550,409,408,-1
"02b3a1bead9244c1ba2f857c7da8f82a","6a5f020451db426dacba9e2ea3fcc62a",22852637,1,3,0,1551,408,410,2
"6a5f020451db426dacba9e2ea3fcc62a","6a5f020451db426dacba9e2ea3fcc62a",22852637,1,0,1,1552,410,410,0
"6a5f020451db426dacba9e2ea3fcc62a","33a9d248b2e44588a5b07fc1342b9bc2",22852637,2,2,0,1553,410,411,1
"33a9d248b2e44588a5b07fc1342b9bc2","6a5f020451db426dacba9e2ea3fcc62a",22852637,1,-2,0,1554,411,410,-1
"33a9d248b2e44588a5b07fc1342b9bc2","33a9d248b2e44588a5b07fc1342b9bc2",22852637,1,0,1,1556,411,411,0
"33a9d248b2e44588a5b07fc1342b9bc2","c6f26bd420634f1cb7989e76fe6b16c0",22852637,1,1,0,1557,411,412,1
"c6f26bd420634f1cb7989e76fe6b16c0","c6f26bd420634f1cb7989e76fe6b16c0",22852637,5,0,1,1558,412,412,0
"c6f26bd420634f1cb7989e76fe6b16c0","2a65ee6e2ac64f6a8a55fbe5373ec763",22852637,1,1,0,1563,412,413,1
"2a65ee6e2ac64f6a8a55fbe5373ec763","2a65ee6e2ac64f6a8a55fbe5373ec763",22852637,2,0,1,1564,413,413,0
"2a65ee6e2ac64f6a8a55fbe5373ec763","33a9d248b2e44588a5b07fc1342b9bc2",22852637,1,-2,0,1566,413,411,-2
"33a9d248b2e44588a5b07fc1342b9bc2","1fd0f6dadbc14ebc965faf6122190b96",22852637,1,5,0,1567,411,415,4
"1fd0f6dadbc14ebc965faf6122190b96","1fd0f6dadbc14ebc965faf6122190b96",22852637,1,0,1,1568,415,415,0
"1fd0f6dadbc14ebc965faf6122190b96","687055dad9fc40c3982478fe33ec01bf",22852637,1,-1,0,1569,415,414,-1
"687055dad9fc40c3982478fe33ec01bf","2add1669f08d4101913db15f8c23b3b7",22852637,1,3,0,1570,414,416,2
"2add1669f08d4101913db15f8c23b3b7","2add1669f08d4101913db15f8c23b3b7",22852637,1,0,1,1571,416,416,0
"2add1669f08d4101913db15f8c23b3b7","a2b4bd40cee2481ebd3fc179d6a5cd62",22852637,1,3,0,1572,416,417,1
"a2b4bd40cee2481ebd3fc179d6a5cd62","2b09a08242b54983aec7063990fb3f66",22852637,3,-27,0,1573,417,400,-17
"2b09a08242b54983aec7063990fb3f66","a2b4bd40cee2481ebd3fc179d6a5cd62",22852637,3,27,0,1575,400,417,17
"a2b4bd40cee2481ebd3fc179d6a5cd62","bec48fc2e1294c7eb3d0aca780d731b8",22852637,6,4,0,1578,417,420,3
"bec48fc2e1294c7eb3d0aca780d731b8","bec48fc2e1294c7eb3d0aca780d731b8",22852637,5,0,1,1579,420,420,0
"bec48fc2e1294c7eb3d0aca780d731b8","dbde19fcce2a4c1abdc7f685c293a23f",22852637,2,3,0,1581,420,422,2
"dbde19fcce2a4c1abdc7f685c293a23f","a24600b0e49245f6bdba8c893cfeddb0",22852637,3,4,0,1582,422,425,3
"a24600b0e49245f6bdba8c893cfeddb0","a24600b0e49245f6bdba8c893cfeddb0",22852637,4,0,1,1583,425,425,0
"a24600b0e49245f6bdba8c893cfeddb0","a2b4bd40cee2481ebd3fc179d6a5cd62",22852637,1,-11,0,1585,425,417,-8
"a2b4bd40cee2481ebd3fc179d6a5cd62","24cf8786024543f19b89bc20034e60d7",22852637,1,18,0,1586,417,428,11
"24cf8786024543f19b89bc20034e60d7","f2a73be2f46840b182d7bd095378004e",22852637,3,1,0,1587,428,429,1
"f2a73be2f46840b182d7bd095378004e","3cbcea2be0984e7dbd5a48195af10ce7",22852637,2,-366,0,1588,429,165,-264
"3cbcea2be0984e7dbd5a48195af10ce7","a9ac840f098c4bd0a2ee896214ce29cd",22852637,1,5,0,1591,165,168,3
"a9ac840f098c4bd0a2ee896214ce29cd","a9ac840f098c4bd0a2ee896214ce29cd",22852637,1,0,1,1592,168,168,0
"a9ac840f098c4bd0a2ee896214ce29cd","67a089198fcb4e1c8f2385786c2b296f",22852637,1,-165,0,1593,168,39,-129
"67a089198fcb4e1c8f2385786c2b296f","a2b4bd40cee2481ebd3fc179d6a5cd62",22852637,1,507,0,1594,39,417,378
"a2b4bd40cee2481ebd3fc179d6a5cd62","a2b4bd40cee2481ebd3fc179d6a5cd62",22852637,1,0,1,1595,417,417,0
"bec48fc2e1294c7eb3d0aca780d731b8","a2b4bd40cee2481ebd3fc179d6a5cd62",22852637,4,-4,0,1597,420,417,-3
"a2b4bd40cee2481ebd3fc179d6a5cd62","e34e59dce2204f228f3a84b6725df60f",22852637,1,2,0,1600,417,419,2
"e34e59dce2204f228f3a84b6725df60f","e34e59dce2204f228f3a84b6725df60f",22852637,1,0,1,1601,419,419,0
"e34e59dce2204f228f3a84b6725df60f","a2b4bd40cee2481ebd3fc179d6a5cd62",22852637,1,-2,0,1602,419,417,-2
"a24600b0e49245f6bdba8c893cfeddb0","24cf8786024543f19b89bc20034e60d7",22852637,2,7,0,1610,425,428,3
"24cf8786024543f19b89bc20034e60d7","a2b4bd40cee2481ebd3fc179d6a5cd62",22852637,2,-18,0,1611,428,417,-11
"a2b4bd40cee2481ebd3fc179d6a5cd62","f2a73be2f46840b182d7bd095378004e",22852637,2,19,0,1612,417,429,12
"f2a73be2f46840b182d7bd095378004e","2b09a08242b54983aec7063990fb3f66",22852637,1,-46,0,1613,429,400,-29
"2b09a08242b54983aec7063990fb3f66","bec48fc2e1294c7eb3d0aca780d731b8",22852637,1,31,0,1616,400,420,20
"bec48fc2e1294c7eb3d0aca780d731b8","a24600b0e49245f6bdba8c893cfeddb0",22852637,1,7,0,1619,420,425,5
"a24600b0e49245f6bdba8c893cfeddb0","dbde19fcce2a4c1abdc7f685c293a23f",22852637,1,-4,0,1620,425,422,-3
"f2a73be2f46840b182d7bd095378004e","f2a73be2f46840b182d7bd095378004e",22852637,2,0,1,1625,429,429,0
"f2a73be2f46840b182d7bd095378004e","604551fd4266430cb860fef58fa7dd61",22852637,2,1,0,1626,429,430,1
"604551fd4266430cb860fef58fa7dd61","604551fd4266430cb860fef58fa7dd61",22852637,9,0,1,1627,430,430,0
"604551fd4266430cb860fef58fa7dd61","dce46f8904594a62a6377a3587aaa663",22852637,1,2,0,1636,430,431,1
"dce46f8904594a62a6377a3587aaa663","24cf8786024543f19b89bc20034e60d7",22852637,3,-4,0,1637,431,428,-3
"24cf8786024543f19b89bc20034e60d7","dce46f8904594a62a6377a3587aaa663",22852637,3,4,0,1638,428,431,3
"dce46f8904594a62a6377a3587aaa663","dce46f8904594a62a6377a3587aaa663",22852637,2,0,1,1639,431,431,0
"dce46f8904594a62a6377a3587aaa663","9b9d0a249052413c869753b99682b0ac",22852637,1,1,0,1641,431,432,1
"9b9d0a249052413c869753b99682b0ac","9b9d0a249052413c869753b99682b0ac",22852637,3,0,1,1642,432,432,0
"9b9d0a249052413c869753b99682b0ac","061c175cc90f45fbad883025394e78dd",22852637,1,1,0,1645,432,433,1
"061c175cc90f45fbad883025394e78dd","061c175cc90f45fbad883025394e78dd",22852637,6,0,1,1646,433,433,0
"061c175cc90f45fbad883025394e78dd","dce46f8904594a62a6377a3587aaa663",22852637,2,-2,0,1652,433,431,-2
"dce46f8904594a62a6377a3587aaa663","74a7f8712e5449c2bc0b43c6f90dafed",22852637,1,5,0,1653,431,435,4
"74a7f8712e5449c2bc0b43c6f90dafed","74a7f8712e5449c2bc0b43c6f90dafed",22852637,1,0,1,1654,435,435,0
"74a7f8712e5449c2bc0b43c6f90dafed","66ada10dde9f43018588f1ced9d477fc",22852637,1,-1,0,1655,435,434,-1
"66ada10dde9f43018588f1ced9d477fc","070600601c4c439288445d2f0724807d",22852637,1,6,0,1656,434,437,3
"070600601c4c439288445d2f0724807d","24cf8786024543f19b89bc20034e60d7",22852637,1,-14,0,1657,437,428,-9
"24cf8786024543f19b89bc20034e60d7","1823b6de7d334a7aaabc4570719af4d9",22852637,1,16,0,1658,428,439,11
"1823b6de7d334a7aaabc4570719af4d9","1823b6de7d334a7aaabc4570719af4d9",22852637,31,0,1,1659,439,439,0
"1823b6de7d334a7aaabc4570719af4d9","070600601c4c439288445d2f0724807d",22852637,2,-2,0,1690,439,437,-2
"070600601c4c439288445d2f0724807d","0380cd76a7d44bc3a4da1f15e4d68f89",22852637,2,4,0,1691,437,440,3
"0380cd76a7d44bc3a4da1f15e4d68f89","0380cd76a7d44bc3a4da1f15e4d68f89",22852637,1,0,1,1692,440,440,0
"0380cd76a7d44bc3a4da1f15e4d68f89","23b7673c8b5443108c2ef09382834a86",22852637,3,2,0,1693,440,441,1
"23b7673c8b5443108c2ef09382834a86","0380cd76a7d44bc3a4da1f15e4d68f89",22852637,2,-2,0,1694,441,440,-1
"23b7673c8b5443108c2ef09382834a86","901e92500aea43c79f19f1b279050668",22852637,3,2,0,1696,441,442,1
"901e92500aea43c79f19f1b279050668","23b7673c8b5443108c2ef09382834a86",22852637,2,-2,0,1697,442,441,-1
"901e92500aea43c79f19f1b279050668","001339db8ced4cf78829ebe8b145449d",22852637,1,1,0,1699,442,443,1
"001339db8ced4cf78829ebe8b145449d","001339db8ced4cf78829ebe8b145449d",22852637,2,0,1,1700,443,443,0
"001339db8ced4cf78829ebe8b145449d","452745e0366e42ae81561bfddebcc6c3",22852637,1,1,0,1702,443,444,1
"452745e0366e42ae81561bfddebcc6c3","452745e0366e42ae81561bfddebcc6c3",22852637,2,0,1,1703,444,444,0
"452745e0366e42ae81561bfddebcc6c3","4660ff2089114e8db82ceb26a4f329e3",22852637,1,2,0,1705,444,445,1
"4660ff2089114e8db82ceb26a4f329e3","901e92500aea43c79f19f1b279050668",22852637,2,-4,0,1706,445,442,-3
"901e92500aea43c79f19f1b279050668","4660ff2089114e8db82ceb26a4f329e3",22852637,1,4,0,1707,442,445,3
"4660ff2089114e8db82ceb26a4f329e3","4660ff2089114e8db82ceb26a4f329e3",22852637,4,0,1,1708,445,445,0
"4660ff2089114e8db82ceb26a4f329e3","7bd5586eb9d8484eb74a433ee7bfe499",22852637,1,2,0,1709,445,446,1
"7bd5586eb9d8484eb74a433ee7bfe499","7bd5586eb9d8484eb74a433ee7bfe499",22852637,22,0,1,1710,446,446,0
"7bd5586eb9d8484eb74a433ee7bfe499","8a7f26e690f34dda97be16904518ca99",22852637,1,2,0,1732,446,447,1
"8a7f26e690f34dda97be16904518ca99","8a7f26e690f34dda97be16904518ca99",22852637,1,0,1,1733,447,447,0
"8a7f26e690f34dda97be16904518ca99","070600601c4c439288445d2f0724807d",22852637,1,-16,0,1734,447,437,-10
"070600601c4c439288445d2f0724807d","b2f0d654738f48158edff28e8d3a546e",22852637,1,21,0,1735,437,449,12
"b2f0d654738f48158edff28e8d3a546e","f60ee41ec635499abd48168342d32c2f",22852637,5,5,0,1736,449,453,4
"f60ee41ec635499abd48168342d32c2f","f60ee41ec635499abd48168342d32c2f",22852637,70,0,1,1737,453,453,0
"f60ee41ec635499abd48168342d32c2f","b2f0d654738f48158edff28e8d3a546e",22852637,4,-5,0,1744,453,449,-4
"f67fbf45a5f146ed866965bc57c7c001","519119f1deac45ff9ab4f13529be5c6e",22852637,1,9,0,1747,454,463,9
"519119f1deac45ff9ab4f13529be5c6e","519119f1deac45ff9ab4f13529be5c6e",22852637,1,0,1,1748,463,463,0
"519119f1deac45ff9ab4f13529be5c6e","11bc14f2204949008b7d511b933363c1",22852637,1,-3,0,1749,463,460,-3
"11bc14f2204949008b7d511b933363c1","11bc14f2204949008b7d511b933363c1",22852637,5,0,1,1750,460,460,0
"11bc14f2204949008b7d511b933363c1","25c32b120fce40fa9b6c85133aeb4716",22852637,1,-1,0,1753,460,459,-1
"25c32b120fce40fa9b6c85133aeb4716","25c32b120fce40fa9b6c85133aeb4716",22852637,5,0,1,1754,459,459,0
"25c32b120fce40fa9b6c85133aeb4716","d646286c8051419bbc2e31dd1db55ca8",22852637,1,-536,0,1757,459,67,-392
"d646286c8051419bbc2e31dd1db55ca8","ae5ac430ea254e708a6f5deaaf7464ae",22852637,1,20,0,1758,67,84,17
"ae5ac430ea254e708a6f5deaaf7464ae","ae5ac430ea254e708a6f5deaaf7464ae",22852637,1,0,1,1759,84,84,0
"ae5ac430ea254e708a6f5deaaf7464ae","6a9f0ef185fb47f0937e29daa1c71ed5",22852637,1,7,0,1760,84,90,6
"6a9f0ef185fb47f0937e29daa1c71ed5","6a9f0ef185fb47f0937e29daa1c71ed5",22852637,7,0,1,1761,90,90,0
"6a9f0ef185fb47f0937e29daa1c71ed5","d646286c8051419bbc2e31dd1db55ca8",22852637,1,-27,0,1763,90,67,-23
"d646286c8051419bbc2e31dd1db55ca8","e20db35ced8544ddac5bc3839145e463",22852637,1,30,0,1764,67,91,24
"e20db35ced8544ddac5bc3839145e463","00ae5f0c51874a73a41ebea838d95682",22852637,1,11,0,1765,91,101,10
"00ae5f0c51874a73a41ebea838d95682","e20db35ced8544ddac5bc3839145e463",22852637,3,-11,0,1766,101,91,-10
"e20db35ced8544ddac5bc3839145e463","d391c8b6e56a43a7b654e9dee02d904b",22852637,3,13,0,1767,91,103,12
"d391c8b6e56a43a7b654e9dee02d904b","4280927ec4d643238aa49c32f9e06c6c",22852637,2,7,0,1768,103,109,6
"4280927ec4d643238aa49c32f9e06c6c","73039f8c1eb9409cb4caee2cf968001e",22852637,2,-10,0,1769,109,100,-9
"73039f8c1eb9409cb4caee2cf968001e","08111f75e22d409998cf8b85bd431f0a",22852637,1,9,0,1770,100,108,8
"08111f75e22d409998cf8b85bd431f0a","a9ae0a3c070d455bb4369a8996313336",22852637,2,7,0,1771,108,114,6
"a9ae0a3c070d455bb4369a8996313336","62bff51286ef4f348717a3cf6fe2318f",22852637,1,7,0,1772,114,120,6
"62bff51286ef4f348717a3cf6fe2318f","37319e88176d4aefa91d7a9980dbae91",22852637,2,-9,0,1773,120,112,-8
"37319e88176d4aefa91d7a9980dbae91","62bff51286ef4f348717a3cf6fe2318f",22852637,2,9,0,1774,112,120,8
"62bff51286ef4f348717a3cf6fe2318f","62bff51286ef4f348717a3cf6fe2318f",22852637,6,0,1,1775,120,120,0
"62bff51286ef4f348717a3cf6fe2318f","779f9ddd1fd14d1e9e69f72219a1fdbd",22852637,1,3,0,1776,120,121,1
"779f9ddd1fd14d1e9e69f72219a1fdbd","e20db35ced8544ddac5bc3839145e463",22852637,2,-36,0,1777,121,91,-30
"e20db35ced8544ddac5bc3839145e463","a8dd5213034441ac92724b4e83eb0bb2",22852637,2,45,0,1778,91,129,38
"a8dd5213034441ac92724b4e83eb0bb2","779f9ddd1fd14d1e9e69f72219a1fdbd",22852637,2,-9,0,1779,129,121,-8
"779f9ddd1fd14d1e9e69f72219a1fdbd","579338175e0b4bbb8ef3b712b5d8b54e",22852637,2,8,0,1780,121,128,7
"579338175e0b4bbb8ef3b712b5d8b54e","b416d47c56a742199b5d7c7f19d6503a",22852637,2,7,0,1781,128,134,6
"b416d47c56a742199b5d7c7f19d6503a","779f9ddd1fd14d1e9e69f72219a1fdbd",22852637,2,-15,0,1782,134,121,-13
"779f9ddd1fd14d1e9e69f72219a1fdbd","df1de691dafe4549a18a4398ee9dfaf9",22852637,3,23,0,1783,121,139,18
"df1de691dafe4549a18a4398ee9dfaf9","6c5ad271a44743479bfaea29b1db8d02",22852637,4,4,0,1784,139,143,4
"6c5ad271a44743479bfaea29b1db8d02","8aae34f5ddbb4052a709b12e6b0d40fa",22852637,1,5,0,1785,143,147,4
"8aae34f5ddbb4052a709b12e6b0d40fa","df1de691dafe4549a18a4398ee9dfaf9",22852637,1,-9,0,1786,147,139,-8
"df1de691dafe4549a18a4398ee9dfaf9","f902b0f41b544d4dbf79664fd233648d",22852637,1,8,0,1787,139,146,7
"f902b0f41b544d4dbf79664fd233648d","d313cec988a84645bee413e8d4724a4b",22852637,1,14,0,1788,146,158,12
"d313cec988a84645bee413e8d4724a4b","f03480cf4eba413194d7af52fc0e7f28",22852637,2,-7,0,1789,158,152,-6
"f03480cf4eba413194d7af52fc0e7f28","78adeee1fa2c4fe0bc73f7bca9fcee86",22852637,1,11,0,1790,152,160,8
"78adeee1fa2c4fe0bc73f7bca9fcee86","df1de691dafe4549a18a4398ee9dfaf9",22852637,3,-26,0,1791,160,139,-21
"df1de691dafe4549a18a4398ee9dfaf9","65202579580f4ad38d734b4ee39d22a8",22852637,1,31,0,1792,139,164,25
"65202579580f4ad38d734b4ee39d22a8","78adeee1fa2c4fe0bc73f7bca9fcee86",22852637,2,-5,0,1793,164,160,-4
"78adeee1fa2c4fe0bc73f7bca9fcee86","65202579580f4ad38d734b4ee39d22a8",22852637,6,5,0,1794,160,164,4
"65202579580f4ad38d734b4ee39d22a8","65202579580f4ad38d734b4ee39d22a8",22852637,86,0,1,1795,164,164,0
"65202579580f4ad38d734b4ee39d22a8","3cbcea2be0984e7dbd5a48195af10ce7",22852637,4,3,0,1801,164,165,1
"3cbcea2be0984e7dbd5a48195af10ce7","78adeee1fa2c4fe0bc73f7bca9fcee86",22852637,3,-8,0,1802,165,160,-5
"78adeee1fa2c4fe0bc73f7bca9fcee86","82e6285962b8400d9d6fc32436022a94",22852637,2,10,0,1803,160,167,7
"82e6285962b8400d9d6fc32436022a94","a9ac840f098c4bd0a2ee896214ce29cd",22852637,2,3,0,1804,167,168,1
"a9ac840f098c4bd0a2ee896214ce29cd","3cbcea2be0984e7dbd5a48195af10ce7",22852637,3,-5,0,1805,168,165,-3
"3cbcea2be0984e7dbd5a48195af10ce7","0c7262dff33c4087bc660ccf40f92f9c",22852637,2,9,0,1806,165,169,4
"0c7262dff33c4087bc660ccf40f92f9c","a9ac840f098c4bd0a2ee896214ce29cd",22852637,1,-4,0,1807,169,168,-1
"a9ac840f098c4bd0a2ee896214ce29cd","b2275c3fad834f8d90737a2d9a6927d6",22852637,1,7,0,1808,168,172,4
"b2275c3fad834f8d90737a2d9a6927d6","b42cc17b7de840f181a704558d0bc845",22852637,1,4,0,1809,172,175,3
"b42cc17b7de840f181a704558d0bc845","0c7262dff33c4087bc660ccf40f92f9c",22852637,2,-7,0,1810,175,169,-6
"0c7262dff33c4087bc660ccf40f92f9c","ea38cc0e6e6e41edbabf210220808bf9",22852637,1,12,0,1811,169,179,10
"ea38cc0e6e6e41edbabf210220808bf9","362fcb0699a14845ab29b2340093e528",22852637,2,-6,0,1812,179,174,-5
"362fcb0699a14845ab29b2340093e528","b87c552dd247427abe6ab5795b9c9d43",22852637,2,8,0,1813,174,181,7
"b87c552dd247427abe6ab5795b9c9d43","139b097acfca451689d80c9c6eebdf7b",22852637,2,-3,0,1814,181,178,-3
"139b097acfca451689d80c9c6eebdf7b","2024b4885bd14338a39b7b509acbbd02",22852637,1,5,0,1815,178,182,4
"2024b4885bd14338a39b7b509acbbd02","c8e371568a0c4391b25796ae4e91952e",22852637,1,7,0,1816,182,186,4
"c8e371568a0c4391b25796ae4e91952e","0c7262dff33c4087bc660ccf40f92f9c",22852637,2,-23,0,1817,186,169,-17
"0c7262dff33c4087bc660ccf40f92f9c","ab11d94c6c8948ea90b88f19d2cd502b",22852637,1,28,0,1818,169,190,21
"ab11d94c6c8948ea90b88f19d2cd502b","c8e371568a0c4391b25796ae4e91952e",22852637,2,-5,0,1819,190,186,-4
"c8e371568a0c4391b25796ae4e91952e","6cd2dcaac46847d4a0bc53f296d90375",22852637,1,10,0,1820,186,194,8
"6cd2dcaac46847d4a0bc53f296d90375","07b44a7a51e94c78b411c753fc39dab0",22852637,2,-6,0,1821,194,189,-5
"07b44a7a51e94c78b411c753fc39dab0","017d7ca8e0394b91aaadc9574df2202c",22852637,1,5,0,1822,189,193,4
"017d7ca8e0394b91aaadc9574df2202c","f9170dd6bc6442b4acd832747609b09a",22852637,2,7,0,1823,193,199,6
"f9170dd6bc6442b4acd832747609b09a","d7f13c8d63ec4e2aa673fbb9cf9c6933",22852637,1,10,0,1824,199,206,7
"d7f13c8d63ec4e2aa673fbb9cf9c6933","c8e371568a0c4391b25796ae4e91952e",22852637,1,-26,0,1825,206,186,-20
"c8e371568a0c4391b25796ae4e91952e","b9e80f77c3a44349863b19875725c384",22852637,1,27,0,1826,186,207,21
"b9e80f77c3a44349863b19875725c384","7108f0e4c2584f1f9c471689ae4c885c",22852637,3,1,0,1827,207,208,1
"7108f0e4c2584f1f9c471689ae4c885c","d7f13c8d63ec4e2aa673fbb9cf9c6933",22852637,2,-2,0,1828,208,206,-2
"d7f13c8d63ec4e2aa673fbb9cf9c6933","09400e101c5d4b439cf9a26b03aae558",22852637,3,5,0,1829,206,210,4
"09400e101c5d4b439cf9a26b03aae558","be502a7a43c44bf7b682698de79d9369",22852637,2,5,0,1830,210,214,4
"be502a7a43c44bf7b682698de79d9369","a875096404ef4a9984b62d74cda916f9",22852637,2,-6,0,1831,214,209,-5
"a875096404ef4a9984b62d74cda916f9","f7fb1952f56b4189b86a9f8b7862d2b8",22852637,3,7,0,1832,209,215,6
"f7fb1952f56b4189b86a9f8b7862d2b8","ec341f459285443b8361f7f15638ff08",22852637,2,-2,0,1833,215,213,-2
"ec341f459285443b8361f7f15638ff08","363837c182e04711840d896ae1e0339c",22852637,3,6,0,1834,213,218,5
"363837c182e04711840d896ae1e0339c","01b2051f8941460d89945e3b02d1ce78",22852637,3,-1,0,1835,218,217,-1
"01b2051f8941460d89945e3b02d1ce78","1c6721b1f63f4d30ba7746ea8af02a52",22852637,1,7,0,1836,217,221,4
"1c6721b1f63f4d30ba7746ea8af02a52","d7f13c8d63ec4e2aa673fbb9cf9c6933",22852637,1,-21,0,1837,221,206,-15
"d7f13c8d63ec4e2aa673fbb9cf9c6933","77ecef8eff6b4a2caea7707669bf7475",22852637,1,22,0,1838,206,222,16
"77ecef8eff6b4a2caea7707669bf7475","1c6721b1f63f4d30ba7746ea8af02a52",22852637,2,-1,0,1839,222,221,-1
"1c6721b1f63f4d30ba7746ea8af02a52","8b9ae98743bd4d4a8a87dff1c1244211",22852637,1,7,0,1840,221,227,6
"8b9ae98743bd4d4a8a87dff1c1244211","d03cb855c70044cf8c35d9ec0de696e3",22852637,2,-3,0,1841,227,224,-3
"d03cb855c70044cf8c35d9ec0de696e3","2ab1535aac1346ba8801535bf729ef37",22852637,1,6,0,1842,224,229,5
"2ab1535aac1346ba8801535bf729ef37","f7906d6f59b9489a91d2ef40db5a474d",22852637,1,-7,0,1843,229,223,-6
"f7906d6f59b9489a91d2ef40db5a474d","5152833676bf4c6cb317060be10f68db",22852637,1,6,0,1844,223,228,5
"5152833676bf4c6cb317060be10f68db","0b04c8e2f86d48c7aeb7e225819cd32b",22852637,1,7,0,1845,228,234,6
"0b04c8e2f86d48c7aeb7e225819cd32b","2ae94c0cea4d480a9d5dca8fb1d7b542",22852637,1,11,0,1846,234,242,8
"2ae94c0cea4d480a9d5dca8fb1d7b542","1c6721b1f63f4d30ba7746ea8af02a52",22852637,2,-27,0,1847,242,221,-21
"1c6721b1f63f4d30ba7746ea8af02a52","1ebf23f9d994469a85206e4c7b1bf5f5",22852637,2,30,0,1848,221,245,24
"1ebf23f9d994469a85206e4c7b1bf5f5","2ae94c0cea4d480a9d5dca8fb1d7b542",22852637,1,-3,0,1849,245,242,-3
"2ae94c0cea4d480a9d5dca8fb1d7b542","00f61990949545828dd12f1303d47504",22852637,1,17,0,1850,242,256,14
"00f61990949545828dd12f1303d47504","6e83e23f56544a19b94067c1c558d9c0",22852637,1,-11,0,1851,256,247,-9
"6e83e23f56544a19b94067c1c558d9c0","d546341988904f069cfa86b21457d9d9",22852637,1,5,0,1852,247,251,4
"a37477c4e4c14169ad44b06b493007f6","fab84b4fab5940efb4ea868ef8d09396",22852637,1,3,0,1870,283,284,1
"fab84b4fab5940efb4ea868ef8d09396","94cecc3f1e7d484b8e068e79241dfd73",22852637,1,-5,0,1871,284,281,-3
"94cecc3f1e7d484b8e068e79241dfd73","0c7262dff33c4087bc660ccf40f92f9c",22852637,1,-148,0,1872,281,169,-112
"0c7262dff33c4087bc660ccf40f92f9c","4a29443515bb404cb8924e1c60a63b73",22852637,2,157,0,1873,169,285,116
"4a29443515bb404cb8924e1c60a63b73","869e967078f04da18dd0b0b9389a7424",22852637,1,10,0,1877,285,293,8
"6a9a3b5bde4a48daa896fe8c06eca56f","34a6e49023fc4465bd5ca604330bbd1c",22852637,1,4,0,1879,289,292,3
"34a6e49023fc4465bd5ca604330bbd1c","ba0e59461bfb4a44b7b1c28a01f8d3b3",22852637,1,9,0,1880,292,299,7
"ba0e59461bfb4a44b7b1c28a01f8d3b3","21592f2a9e9c4b2f8c66ec5dbcbf6a2b",22852637,1,-4,0,1881,299,296,-3
"21592f2a9e9c4b2f8c66ec5dbcbf6a2b","7646a919d7e64fa990bca9b024ff089d",22852637,1,3,0,1882,296,298,2
"7646a919d7e64fa990bca9b024ff089d","3434c10e561d488a914e0f7d71907abd",22852637,1,10,0,1883,298,305,7
"3434c10e561d488a914e0f7d71907abd","4a29443515bb404cb8924e1c60a63b73",22852637,1,-27,0,1884,305,285,-20
"4a29443515bb404cb8924e1c60a63b73","53e7e900392747ccad52e711ab0f80d8",22852637,1,29,0,1885,285,307,22
"3434c10e561d488a914e0f7d71907abd","f67fbf45a5f146ed866965bc57c7c001",22852637,1,215,0,1888,305,454,149
"f67fbf45a5f146ed866965bc57c7c001","11bc14f2204949008b7d511b933363c1",22852637,1,6,0,1890,454,460,6
"11bc14f2204949008b7d511b933363c1","5256a214faaf410b93f76cea06428334",22852637,1,-2,0,1893,460,458,-2
"5256a214faaf410b93f76cea06428334","5256a214faaf410b93f76cea06428334",22852637,1,0,1,1894,458,458,0
"5256a214faaf410b93f76cea06428334","9e049ee647cf43ecbcb5ed792a8e7588",22852637,1,-1,0,1895,458,457,-1
"9e049ee647cf43ecbcb5ed792a8e7588","9e049ee647cf43ecbcb5ed792a8e7588",22852637,1,0,1,1896,457,457,0
"9e049ee647cf43ecbcb5ed792a8e7588","3628b3f7823443d0912a339096b69943",22852637,1,-1,0,1897,457,456,-1
"3628b3f7823443d0912a339096b69943","3628b3f7823443d0912a339096b69943",22852637,1,0,1,1898,456,456,0
"3628b3f7823443d0912a339096b69943","d937afe49bd24a07a550dda1c1155122",22852637,1,-1,0,1899,456,455,-1
"d937afe49bd24a07a550dda1c1155122","d937afe49bd24a07a550dda1c1155122",22852637,1,0,1,1900,455,455,0
"d937afe49bd24a07a550dda1c1155122","f67fbf45a5f146ed866965bc57c7c001",22852637,1,-1,0,1901,455,454,-1
"f67fbf45a5f146ed866965bc57c7c001","0c4079457ede49e3aeb5e86ed84bdf35",22852637,1,-184,0,1903,454,329,-125
"4a29443515bb404cb8924e1c60a63b73","f67fbf45a5f146ed866965bc57c7c001",22852637,1,242,0,1908,285,454,169
"f67fbf45a5f146ed866965bc57c7c001","42de338840a34d15adb66e7b14fb9d2c",22852637,1,7,0,1910,454,461,7
"42de338840a34d15adb66e7b14fb9d2c","42de338840a34d15adb66e7b14fb9d2c",22852637,1,0,1,1911,461,461,0
"42de338840a34d15adb66e7b14fb9d2c","66baf19b6b904b70922329068c63746d",22852637,1,-127,0,1912,461,376,-85
"7f544639412e40a9ba27f43b415362ab","66baf19b6b904b70922329068c63746d",22852637,1,-2,0,1916,378,376,-2
"66baf19b6b904b70922329068c63746d","f67fbf45a5f146ed866965bc57c7c001",22852637,1,120,0,1917,376,454,78
"f67fbf45a5f146ed866965bc57c7c001","9da37c6210b1416b8079c274f70bf600",22852637,1,8,0,1919,454,462,8
"9da37c6210b1416b8079c274f70bf600","9da37c6210b1416b8079c274f70bf600",22852637,1,0,1,1920,462,462,0
"9da37c6210b1416b8079c274f70bf600","25c32b120fce40fa9b6c85133aeb4716",22852637,1,-3,0,1921,462,459,-3
"25c32b120fce40fa9b6c85133aeb4716","c5df9f40ec14463b9dcfdc73df3e9285",22852637,1,7,0,1924,459,464,5
"c5df9f40ec14463b9dcfdc73df3e9285","f67fbf45a5f146ed866965bc57c7c001",22852637,2,-12,0,1925,464,454,-10
"f67fbf45a5f146ed866965bc57c7c001","c5df9f40ec14463b9dcfdc73df3e9285",22852637,3,12,0,1926,454,464,10
"c5df9f40ec14463b9dcfdc73df3e9285","3cbcea2be0984e7dbd5a48195af10ce7",22852637,1,-420,0,1927,464,165,-299
"82e6285962b8400d9d6fc32436022a94","4a29443515bb404cb8924e1c60a63b73",22852637,1,164,0,1932,167,285,118
"4a29443515bb404cb8924e1c60a63b73","b2f0d654738f48158edff28e8d3a546e",22852637,1,234,0,1933,285,449,164
"b2f0d654738f48158edff28e8d3a546e","66baf19b6b904b70922329068c63746d",22852637,1,-112,0,1935,449,376,-73
"66baf19b6b904b70922329068c63746d","dce46f8904594a62a6377a3587aaa663",22852637,1,81,0,1936,376,431,55
"24cf8786024543f19b89bc20034e60d7","9428d8bd9c5a47b2a235b254e5e27ded",22852637,1,39,0,1940,428,452,24
"9428d8bd9c5a47b2a235b254e5e27ded","b2f0d654738f48158edff28e8d3a546e",22852637,1,-4,0,1941,452,449,-3
"c5df9f40ec14463b9dcfdc73df3e9285","83d42d95cd844fc093fc09cee250edb8",22852637,2,3,0,2009,464,465,1
"83d42d95cd844fc093fc09cee250edb8","c5df9f40ec14463b9dcfdc73df3e9285",22852637,1,-3,0,2010,465,464,-1
"83d42d95cd844fc093fc09cee250edb8","83d42d95cd844fc093fc09cee250edb8",22852637,5,0,1,2012,465,465,0
"83d42d95cd844fc093fc09cee250edb8","fab84b4fab5940efb4ea868ef8d09396",22852637,1,-261,0,2014,465,284,-181
"fab84b4fab5940efb4ea868ef8d09396","fab84b4fab5940efb4ea868ef8d09396",22852637,4,0,1,2015,284,284,0
"fab84b4fab5940efb4ea868ef8d09396","4a29443515bb404cb8924e1c60a63b73",22852637,2,4,0,2017,284,285,1
"4a29443515bb404cb8924e1c60a63b73","fab84b4fab5940efb4ea868ef8d09396",22852637,1,-4,0,2020,285,284,-1
"208c9b2796c944db8dacaa96082520ea","fab84b4fab5940efb4ea868ef8d09396",22852637,1,-7,0,2025,288,284,-4
"fab84b4fab5940efb4ea868ef8d09396","0c7262dff33c4087bc660ccf40f92f9c",22852637,1,-153,0,2026,284,169,-115
"4a29443515bb404cb8924e1c60a63b73","3cbcea2be0984e7dbd5a48195af10ce7",22852637,1,-166,0,2028,285,165,-120
"f60ee41ec635499abd48168342d32c2f","d646286c8051419bbc2e31dd1db55ca8",22852637,1,-528,0,2069,453,67,-386
"d646286c8051419bbc2e31dd1db55ca8","6a9f0ef185fb47f0937e29daa1c71ed5",22852637,1,27,0,2070,67,90,23
"6a9f0ef185fb47f0937e29daa1c71ed5","e20db35ced8544ddac5bc3839145e463",22852637,2,3,0,2073,90,91,1
"e20db35ced8544ddac5bc3839145e463","d646286c8051419bbc2e31dd1db55ca8",22852637,2,-30,0,2074,91,67,-24
"d646286c8051419bbc2e31dd1db55ca8","00ae5f0c51874a73a41ebea838d95682",22852637,1,41,0,2075,67,101,34
"73039f8c1eb9409cb4caee2cf968001e","a9ae0a3c070d455bb4369a8996313336",22852637,1,16,0,2080,100,114,14
"a9ae0a3c070d455bb4369a8996313336","08111f75e22d409998cf8b85bd431f0a",22852637,1,-7,0,2081,114,108,-6
"08111f75e22d409998cf8b85bd431f0a","62bff51286ef4f348717a3cf6fe2318f",22852637,1,14,0,2082,108,120,12
"37319e88176d4aefa91d7a9980dbae91","779f9ddd1fd14d1e9e69f72219a1fdbd",22852637,1,12,0,2086,112,121,9
"6c5ad271a44743479bfaea29b1db8d02","df1de691dafe4549a18a4398ee9dfaf9",22852637,1,-4,0,2095,143,139,-4
"df1de691dafe4549a18a4398ee9dfaf9","8aae34f5ddbb4052a709b12e6b0d40fa",22852637,2,9,0,2096,139,147,8
"8aae34f5ddbb4052a709b12e6b0d40fa","f902b0f41b544d4dbf79664fd233648d",22852637,1,-1,0,2097,147,146,-1
"f902b0f41b544d4dbf79664fd233648d","f03480cf4eba413194d7af52fc0e7f28",22852637,1,7,0,2098,146,152,6
"f03480cf4eba413194d7af52fc0e7f28","d313cec988a84645bee413e8d4724a4b",22852637,1,7,0,2099,152,158,6
"d313cec988a84645bee413e8d4724a4b","df1de691dafe4549a18a4398ee9dfaf9",22852637,1,-22,0,2100,158,139,-19
"df1de691dafe4549a18a4398ee9dfaf9","78adeee1fa2c4fe0bc73f7bca9fcee86",22852637,1,26,0,2101,139,160,21
"82e6285962b8400d9d6fc32436022a94","f67fbf45a5f146ed866965bc57c7c001",22852637,1,406,0,2113,167,454,287
"82e6285962b8400d9d6fc32436022a94","83d42d95cd844fc093fc09cee250edb8",22852637,1,421,0,2120,167,465,298
"83d42d95cd844fc093fc09cee250edb8","66baf19b6b904b70922329068c63746d",22852637,1,-135,0,2124,465,376,-89
"7f544639412e40a9ba27f43b415362ab","2b09a08242b54983aec7063990fb3f66",22852637,1,30,0,2128,378,400,22
"2b09a08242b54983aec7063990fb3f66","1157bd665ec4472fb58b751dc5099355",22852637,1,4,0,2133,400,403,3
"58fc9094275e4c49be3f4ba6d4acc0a4","bec48fc2e1294c7eb3d0aca780d731b8",22852637,1,22,0,2137,406,420,14
"bec48fc2e1294c7eb3d0aca780d731b8","24cf8786024543f19b89bc20034e60d7",22852637,1,14,0,2141,420,428,8
"24cf8786024543f19b89bc20034e60d7","24cf8786024543f19b89bc20034e60d7",22852637,1,0,1,2142,428,428,0
"67a089198fcb4e1c8f2385786c2b296f","070600601c4c439288445d2f0724807d",22852637,1,539,0,2148,39,437,398
"070600601c4c439288445d2f0724807d","4660ff2089114e8db82ceb26a4f329e3",22852637,1,12,0,2149,437,445,8
"901e92500aea43c79f19f1b279050668","901e92500aea43c79f19f1b279050668",22852637,1,0,1,2154,442,442,0
"901e92500aea43c79f19f1b279050668","0380cd76a7d44bc3a4da1f15e4d68f89",22852637,1,-4,0,2157,442,440,-2
"0380cd76a7d44bc3a4da1f15e4d68f89","3cbcea2be0984e7dbd5a48195af10ce7",22852637,1,-383,0,2160,440,165,-275
"82e6285962b8400d9d6fc32436022a94","66baf19b6b904b70922329068c63746d",22852637,1,286,0,2167,167,376,209
"66baf19b6b904b70922329068c63746d","a49d1bb4328949299686242fd0be5584",22852637,1,-486,0,2168,376,21,-355
"a49d1bb4328949299686242fd0be5584","b7719e26494940efa49512aedd0aac79",22852637,1,-2,0,2169,21,20,-1
"b7719e26494940efa49512aedd0aac79","b7719e26494940efa49512aedd0aac79",22852637,2,0,1,2170,20,20,0
"b7719e26494940efa49512aedd0aac79","afbf7250b99d47bea07172749483ca97",22852637,3,12,0,2171,20,28,8
"afbf7250b99d47bea07172749483ca97","4e51676dc72045d99c19b9fa7b22f8bc",22852637,3,3,0,2172,28,29,1
"4e51676dc72045d99c19b9fa7b22f8bc","afbf7250b99d47bea07172749483ca97",22852637,1,-3,0,2173,29,28,-1
"4e51676dc72045d99c19b9fa7b22f8bc","51970cfa30e643e894e66ae85c8024cc",22852637,4,3,0,2175,29,31,2
"51970cfa30e643e894e66ae85c8024cc","4e51676dc72045d99c19b9fa7b22f8bc",22852637,3,-3,0,2176,31,29,-2
"4e51676dc72045d99c19b9fa7b22f8bc","c33c17be71ae4d588da7369472e5bb1b",22852637,2,9,0,2181,29,34,5
"93679be414554a11b1893002f2229a93","7040a13096d746ac84b8fac8d9752058",22852637,2,3,0,2185,35,36,1
"7040a13096d746ac84b8fac8d9752058","7040a13096d746ac84b8fac8d9752058",22852637,2,0,1,2186,36,36,0
"7040a13096d746ac84b8fac8d9752058","9a0dc646f934470daf08c4b56ccf73db",22852637,2,3,0,2187,36,37,1
"9a0dc646f934470daf08c4b56ccf73db","fc0e049d56024bc9a02c9a9c435c3df7",22852637,3,3,0,2188,37,38,1
"fc0e049d56024bc9a02c9a9c435c3df7","9a0dc646f934470daf08c4b56ccf73db",22852637,2,-3,0,2189,38,37,-1
"9a0dc646f934470daf08c4b56ccf73db","b613861cecf84ffcab01afb23f660475",22852637,1,-65,0,2190,37,1,-36
"b613861cecf84ffcab01afb23f660475","d6d02b6ef04e4f17805504500b8ce441",22852637,1,516,0,2192,1,375,374
"d6d02b6ef04e4f17805504500b8ce441","4a29443515bb404cb8924e1c60a63b73",22852637,1,-118,0,2196,375,285,-90
"4a29443515bb404cb8924e1c60a63b73","24cf8786024543f19b89bc20034e60d7",22852637,1,199,0,2197,285,428,143
"604551fd4266430cb860fef58fa7dd61","24cf8786024543f19b89bc20034e60d7",22852637,1,-2,0,2200,430,428,-2
"dce46f8904594a62a6377a3587aaa663","061c175cc90f45fbad883025394e78dd",22852637,1,2,0,2202,431,433,2
"dce46f8904594a62a6377a3587aaa663","66ada10dde9f43018588f1ced9d477fc",22852637,1,4,0,2204,431,434,3
"66ada10dde9f43018588f1ced9d477fc","bf12c96466d840a69bed7020b3f18bb8",22852637,1,3,0,2205,434,436,2
"bf12c96466d840a69bed7020b3f18bb8","bf12c96466d840a69bed7020b3f18bb8",22852637,2,0,1,2206,436,436,0
"bf12c96466d840a69bed7020b3f18bb8","24cf8786024543f19b89bc20034e60d7",22852637,2,-11,0,2207,436,428,-8
"24cf8786024543f19b89bc20034e60d7","070600601c4c439288445d2f0724807d",22852637,1,14,0,2208,428,437,9
"070600601c4c439288445d2f0724807d","1823b6de7d334a7aaabc4570719af4d9",22852637,1,2,0,2209,437,439,2
"0380cd76a7d44bc3a4da1f15e4d68f89","66baf19b6b904b70922329068c63746d",22852637,1,-95,0,2212,440,376,-64
"66baf19b6b904b70922329068c63746d","0c4079457ede49e3aeb5e86ed84bdf35",22852637,1,-64,0,2213,376,329,-47
"38aea304b4fa46e1b29bb72f5cea4c93","3cbcea2be0984e7dbd5a48195af10ce7",22852637,1,-226,0,2217,331,165,-166
"82e6285962b8400d9d6fc32436022a94","bf12c96466d840a69bed7020b3f18bb8",22852637,1,374,0,2225,167,436,269
"24cf8786024543f19b89bc20034e60d7","3cbcea2be0984e7dbd5a48195af10ce7",22852637,1,-365,0,2228,428,165,-263
"b613861cecf84ffcab01afb23f660475","b613861cecf84ffcab01afb23f660475",22852816,3,0,1,1,1,1,0
"b613861cecf84ffcab01afb23f660475","e2911e79efc2420eac45d9f671463d4b",22852816,1,3,0,4,1,2,1
"e2911e79efc2420eac45d9f671463d4b","e2911e79efc2420eac45d9f671463d4b",22852816,2,0,1,5,2,2,0
"e2911e79efc2420eac45d9f671463d4b","519d1b8c59404d67b54e96c5c8a830b2",22852816,1,1,0,7,2,3,1
"519d1b8c59404d67b54e96c5c8a830b2","519d1b8c59404d67b54e96c5c8a830b2",22852816,1,0,1,8,3,3,0
"519d1b8c59404d67b54e96c5c8a830b2","531db53f81f646edb0cdcfe0085b03b7",22852816,1,1,0,9,3,4,1
"531db53f81f646edb0cdcfe0085b03b7","531db53f81f646edb0cdcfe0085b03b7",22852816,1,0,1,10,4,4,0
"531db53f81f646edb0cdcfe0085b03b7","4f5f94b2f95141e0a9d53a61da2276da",22852816,1,1,0,11,4,5,1
"4f5f94b2f95141e0a9d53a61da2276da","4f5f94b2f95141e0a9d53a61da2276da",22852816,1,0,1,12,5,5,0
"4f5f94b2f95141e0a9d53a61da2276da","6d541c89590949f99af293c4f2333f67",22852816,1,1,0,13,5,6,1
"6d541c89590949f99af293c4f2333f67","6d541c89590949f99af293c4f2333f67",22852816,1,0,1,14,6,6,0
"6d541c89590949f99af293c4f2333f67","dd5cf0b9fe4c4f1d8f5ff8e4c04879cb",22852816,1,1,0,15,6,7,1
"dd5cf0b9fe4c4f1d8f5ff8e4c04879cb","dd5cf0b9fe4c4f1d8f5ff8e4c04879cb",22852816,2,0,1,16,7,7,0
"dd5cf0b9fe4c4f1d8f5ff8e4c04879cb","f96261861edc426abe2248be4f0a709a",22852816,1,1,0,18,7,8,1
"f96261861edc426abe2248be4f0a709a","f96261861edc426abe2248be4f0a709a",22852816,2,0,1,19,8,8,0
"f96261861edc426abe2248be4f0a709a","66b5e16f4f75454fb5b8172079f0fa83",22852816,1,1,0,21,8,9,1
"66b5e16f4f75454fb5b8172079f0fa83","66b5e16f4f75454fb5b8172079f0fa83",22852816,2,0,1,22,9,9,0
"66b5e16f4f75454fb5b8172079f0fa83","0680571d4698477995e41842c36a54b2",22852816,1,1,0,24,9,10,1
"0680571d4698477995e41842c36a54b2","0680571d4698477995e41842c36a54b2",22852816,1,0,1,25,10,10,0
"0680571d4698477995e41842c36a54b2","9112f2bffece48e08c6d2287be204085",22852816,1,1,0,26,10,11,1
"9112f2bffece48e08c6d2287be204085","9112f2bffece48e08c6d2287be204085",22852816,2,0,1,27,11,11,0
"9112f2bffece48e08c6d2287be204085","56586aa865414f538729c7f7735d2bc6",22852816,1,3,0,29,11,12,1
"56586aa865414f538729c7f7735d2bc6","e2911e79efc2420eac45d9f671463d4b",22852816,1,-12,0,30,12,2,-10
"e2911e79efc2420eac45d9f671463d4b","56586aa865414f538729c7f7735d2bc6",22852816,1,12,0,31,2,12,10
"56586aa865414f538729c7f7735d2bc6","56586aa865414f538729c7f7735d2bc6",22852816,5,0,1,32,12,12,0
"56586aa865414f538729c7f7735d2bc6","b7f2b31585d94eb3bf86376714aa7070",22852816,1,2,0,35,12,13,1
"b7f2b31585d94eb3bf86376714aa7070","b7f2b31585d94eb3bf86376714aa7070",22852816,2,0,1,36,13,13,0
"b7f2b31585d94eb3bf86376714aa7070","3f1c815879794b929260d224becaff7e",22852816,1,2,0,38,13,14,1
"3f1c815879794b929260d224becaff7e","56586aa865414f538729c7f7735d2bc6",22852816,1,-4,0,39,14,12,-2
"56586aa865414f538729c7f7735d2bc6","5c5ceeee4562457ba6d41515aeebfbb1",22852816,1,10,0,42,12,17,5
"5c5ceeee4562457ba6d41515aeebfbb1","81c864a886d54a6b8ff85f7d736f4f95",22852816,1,-4,0,43,17,15,-2
"81c864a886d54a6b8ff85f7d736f4f95","5c5ceeee4562457ba6d41515aeebfbb1",22852816,1,4,0,44,15,17,2
"5c5ceeee4562457ba6d41515aeebfbb1","9afd71a5298d4333b6849dfce1b9422c",22852816,1,3,0,45,17,18,1
"9afd71a5298d4333b6849dfce1b9422c","56586aa865414f538729c7f7735d2bc6",22852816,1,-13,0,46,18,12,-6
"56586aa865414f538729c7f7735d2bc6","9afd71a5298d4333b6849dfce1b9422c",22852816,1,13,0,47,12,18,6
"9afd71a5298d4333b6849dfce1b9422c","9afd71a5298d4333b6849dfce1b9422c",22852816,2,0,1,48,18,18,0
"9afd71a5298d4333b6849dfce1b9422c","b7719e26494940efa49512aedd0aac79",22852816,1,4,0,50,18,20,2
"d4c3b003e8274e429d2fa688d73fde6d","d4c3b003e8274e429d2fa688d73fde6d",22852816,2,0,1,53,22,22,0
"d4c3b003e8274e429d2fa688d73fde6d","b7719e26494940efa49512aedd0aac79",22852816,2,-3,0,55,22,20,-2
"b7719e26494940efa49512aedd0aac79","afbf7250b99d47bea07172749483ca97",22852816,4,12,0,56,20,28,8
"afbf7250b99d47bea07172749483ca97","b7719e26494940efa49512aedd0aac79",22852816,3,-12,0,57,28,20,-8
"afbf7250b99d47bea07172749483ca97","4e51676dc72045d99c19b9fa7b22f8bc",22852816,2,3,0,59,28,29,1
"4e51676dc72045d99c19b9fa7b22f8bc","93679be414554a11b1893002f2229a93",22852816,1,12,0,64,29,35,6
"93679be414554a11b1893002f2229a93","c33c17be71ae4d588da7369472e5bb1b",22852816,2,-3,0,65,35,34,-1
"c33c17be71ae4d588da7369472e5bb1b","7040a13096d746ac84b8fac8d9752058",22852816,1,6,0,66,34,36,2
"93679be414554a11b1893002f2229a93","9a0dc646f934470daf08c4b56ccf73db",22852816,1,6,0,68,35,37,2
"9a0dc646f934470daf08c4b56ccf73db","7040a13096d746ac84b8fac8d9752058",22852816,2,-3,0,69,37,36,-1
"fc0e049d56024bc9a02c9a9c435c3df7","9a0dc646f934470daf08c4b56ccf73db",22852816,1,-3,0,76,38,37,-1
"7040a13096d746ac84b8fac8d9752058","7040a13096d746ac84b8fac8d9752058",22852816,1,0,1,79,36,36,0
"93679be414554a11b1893002f2229a93","93679be414554a11b1893002f2229a93",22852816,1,0,1,81,35,35,0
"c33c17be71ae4d588da7369472e5bb1b","c33c17be71ae4d588da7369472e5bb1b",22852816,1,0,1,83,34,34,0
"4e51676dc72045d99c19b9fa7b22f8bc","c9c52446b6294aa5a9c2abaed536c37e",22852816,1,5,0,85,29,32,3
"c9c52446b6294aa5a9c2abaed536c37e","51970cfa30e643e894e66ae85c8024cc",22852816,1,-2,0,86,32,31,-1
"51970cfa30e643e894e66ae85c8024cc","4e51676dc72045d99c19b9fa7b22f8bc",22852816,1,-3,0,87,31,29,-2
"4e51676dc72045d99c19b9fa7b22f8bc","afbf7250b99d47bea07172749483ca97",22852816,1,-3,0,88,29,28,-1
"afbf7250b99d47bea07172749483ca97","afbf7250b99d47bea07172749483ca97",22852816,1,0,1,89,28,28,0
"b7719e26494940efa49512aedd0aac79","a23ae40d7a9e4ee4828cc06415a3218c",22852816,1,9,0,91,20,27,7
"4e51676dc72045d99c19b9fa7b22f8bc","4e51676dc72045d99c19b9fa7b22f8bc",22852816,3,0,1,100,29,29,0
"4e51676dc72045d99c19b9fa7b22f8bc","51970cfa30e643e894e66ae85c8024cc",22852816,2,3,0,102,29,31,2
"51970cfa30e643e894e66ae85c8024cc","c33c17be71ae4d588da7369472e5bb1b",22852816,2,6,0,103,31,34,3
"c33c17be71ae4d588da7369472e5bb1b","4e51676dc72045d99c19b9fa7b22f8bc",22852816,3,-9,0,104,34,29,-5
"4e51676dc72045d99c19b9fa7b22f8bc","c33c17be71ae4d588da7369472e5bb1b",22852816,1,9,0,105,29,34,5
"c33c17be71ae4d588da7369472e5bb1b","93679be414554a11b1893002f2229a93",22852816,1,3,0,106,34,35,1
"93679be414554a11b1893002f2229a93","7040a13096d746ac84b8fac8d9752058",22852816,2,3,0,107,35,36,1
"7040a13096d746ac84b8fac8d9752058","93679be414554a11b1893002f2229a93",22852816,3,-3,0,108,36,35,-1
"7040a13096d746ac84b8fac8d9752058","9a0dc646f934470daf08c4b56ccf73db",22852816,2,3,0,110,36,37,1
"9a0dc646f934470daf08c4b56ccf73db","9a0dc646f934470daf08c4b56ccf73db",22852816,2,0,1,111,37,37,0
"9a0dc646f934470daf08c4b56ccf73db","fc0e049d56024bc9a02c9a9c435c3df7",22852816,2,3,0,112,37,38,1
"fc0e049d56024bc9a02c9a9c435c3df7","fc0e049d56024bc9a02c9a9c435c3df7",22852816,6,0,1,113,38,38,0
"fc0e049d56024bc9a02c9a9c435c3df7","b7719e26494940efa49512aedd0aac79",22852816,1,-36,0,115,38,20,-18
"b7719e26494940efa49512aedd0aac79","d4f45188d3c84a02ba08454e6403a818",22852816,4,5,0,116,20,24,4
"d4f45188d3c84a02ba08454e6403a818","d4c3b003e8274e429d2fa688d73fde6d",22852816,4,-2,0,117,24,22,-2
"d4c3b003e8274e429d2fa688d73fde6d","a23ae40d7a9e4ee4828cc06415a3218c",22852816,1,6,0,118,22,27,5
"a23ae40d7a9e4ee4828cc06415a3218c","a23ae40d7a9e4ee4828cc06415a3218c",22852816,1,0,1,119,27,27,0
"a23ae40d7a9e4ee4828cc06415a3218c","b7719e26494940efa49512aedd0aac79",22852816,2,-9,0,120,27,20,-7
"d4c3b003e8274e429d2fa688d73fde6d","67a089198fcb4e1c8f2385786c2b296f",22852816,1,37,0,123,22,39,17
"67a089198fcb4e1c8f2385786c2b296f","64d48c6c9c7940639a932219a6c87198",22852816,3,1,0,124,39,40,1
"64d48c6c9c7940639a932219a6c87198","64d48c6c9c7940639a932219a6c87198",22852816,1,0,1,125,40,40,0
"64d48c6c9c7940639a932219a6c87198","67a089198fcb4e1c8f2385786c2b296f",22852816,1,-1,0,126,40,39,-1
"67a089198fcb4e1c8f2385786c2b296f","b534b89233134e30a9b5645138bfa9ee",22852816,1,4,0,127,39,41,2
"b534b89233134e30a9b5645138bfa9ee","0e37b720d23b4e7f8b313e79313fd107",22852816,1,3,0,128,41,44,3
"0e37b720d23b4e7f8b313e79313fd107","0e37b720d23b4e7f8b313e79313fd107",22852816,1,0,1,129,44,44,0
"0e37b720d23b4e7f8b313e79313fd107","6875d67fdd5f48168b62719df449bebd",22852816,1,1,0,130,44,45,1
"6875d67fdd5f48168b62719df449bebd","6875d67fdd5f48168b62719df449bebd",22852816,1,0,1,131,45,45,0
"6875d67fdd5f48168b62719df449bebd","b534b89233134e30a9b5645138bfa9ee",22852816,1,-4,0,132,45,41,-4
"b534b89233134e30a9b5645138bfa9ee","6e13d61a7bdb44bca949c9f86fab3be5",22852816,1,7,0,133,41,47,6
"6e13d61a7bdb44bca949c9f86fab3be5","6e13d61a7bdb44bca949c9f86fab3be5",22852816,1,0,1,134,47,47,0
"6e13d61a7bdb44bca949c9f86fab3be5","195f78799f984cc2b06c48dfe36be751",22852816,1,2,0,135,47,49,2
"195f78799f984cc2b06c48dfe36be751","195f78799f984cc2b06c48dfe36be751",22852816,2,0,1,136,49,49,0
"195f78799f984cc2b06c48dfe36be751","d9c8d8c444a64dadbbb508652c721e17",22852816,1,-3,0,138,49,46,-3
"d9c8d8c444a64dadbbb508652c721e17","d0c74f735e024943943e40333d6d337f",22852816,1,6,0,139,46,51,5
"d0c74f735e024943943e40333d6d337f","d0c74f735e024943943e40333d6d337f",22852816,1,0,1,140,51,51,0
"d0c74f735e024943943e40333d6d337f","983f8ff320594b279a7f4a6fe132f9c5",22852816,1,2,0,141,51,53,2
"983f8ff320594b279a7f4a6fe132f9c5","983f8ff320594b279a7f4a6fe132f9c5",22852816,2,0,1,142,53,53,0
"983f8ff320594b279a7f4a6fe132f9c5","35adfa5d923046aebabfefd98f35ff05",22852816,1,1,0,144,53,54,1
"35adfa5d923046aebabfefd98f35ff05","35adfa5d923046aebabfefd98f35ff05",22852816,5,0,1,145,54,54,0
"35adfa5d923046aebabfefd98f35ff05","b6f8a98476224da1b40e555ececc7ed8",22852816,1,1,0,150,54,55,1
"b6f8a98476224da1b40e555ececc7ed8","b6f8a98476224da1b40e555ececc7ed8",22852816,2,0,1,151,55,55,0
"b6f8a98476224da1b40e555ececc7ed8","86e22cb5fe0e4b47a9489ecddf7ed78f",22852816,1,1,0,153,55,56,1
"86e22cb5fe0e4b47a9489ecddf7ed78f","86e22cb5fe0e4b47a9489ecddf7ed78f",22852816,2,0,1,154,56,56,0
"86e22cb5fe0e4b47a9489ecddf7ed78f","f924752d8a1149668870b1e7698486f7",22852816,1,-6,0,156,56,50,-6
"f924752d8a1149668870b1e7698486f7","a1f2f12debe5432fb7a70bcd12bacfb9",22852816,1,9,0,157,50,58,8
"a1f2f12debe5432fb7a70bcd12bacfb9","78f30e4dcac84e3cbea8b2cc6e0d62b3",22852816,2,1,0,158,58,59,1
"78f30e4dcac84e3cbea8b2cc6e0d62b3","a1f2f12debe5432fb7a70bcd12bacfb9",22852816,1,-1,0,159,59,58,-1
"a1f2f12debe5432fb7a70bcd12bacfb9","a1f2f12debe5432fb7a70bcd12bacfb9",22852816,30,0,1,160,58,58,0
"78f30e4dcac84e3cbea8b2cc6e0d62b3","78f30e4dcac84e3cbea8b2cc6e0d62b3",22852816,11,0,1,191,59,59,0
"78f30e4dcac84e3cbea8b2cc6e0d62b3","12aa6e1672ac4e7aa6449a7a8609cd72",22852816,1,-2,0,202,59,57,-2
"12aa6e1672ac4e7aa6449a7a8609cd72","a0a418b8540d479fa6e0f653b701da8b",22852816,1,8,0,203,57,64,7
"a0a418b8540d479fa6e0f653b701da8b","bc42d26810654ea9a1df1efe1e58c7d5",22852816,1,-1,0,204,64,63,-1
"bc42d26810654ea9a1df1efe1e58c7d5","4c943503763e4e349906eea3ed3c8e86",22852816,1,-2,0,205,63,61,-2
"4c943503763e4e349906eea3ed3c8e86","4c943503763e4e349906eea3ed3c8e86",22852816,1,0,1,206,61,61,0
"4c943503763e4e349906eea3ed3c8e86","bc42d26810654ea9a1df1efe1e58c7d5",22852816,1,2,0,207,61,63,2
"bc42d26810654ea9a1df1efe1e58c7d5","bc42d26810654ea9a1df1efe1e58c7d5",22852816,3,0,1,208,63,63,0
"bc42d26810654ea9a1df1efe1e58c7d5","309ccf3cc4fe429d9bfbaef53d3fa479",22852816,1,-3,0,211,63,60,-3
"309ccf3cc4fe429d9bfbaef53d3fa479","b534b89233134e30a9b5645138bfa9ee",22852816,1,-23,0,212,60,41,-19
"b534b89233134e30a9b5645138bfa9ee","d646286c8051419bbc2e31dd1db55ca8",22852816,1,33,0,213,41,67,26
"d646286c8051419bbc2e31dd1db55ca8","267f883678b24aed855fde42524975d9",22852816,1,4,0,214,67,71,4
"267f883678b24aed855fde42524975d9","267f883678b24aed855fde42524975d9",22852816,1,0,1,215,71,71,0
"267f883678b24aed855fde42524975d9","88fff56d0342490dbef9040750a20f6c",22852816,1,1,0,216,71,72,1
"88fff56d0342490dbef9040750a20f6c","88fff56d0342490dbef9040750a20f6c",22852816,1,0,1,217,72,72,0
"88fff56d0342490dbef9040750a20f6c","adb17b12b66c4a49a85fd34322f7df70",22852816,1,1,0,218,72,73,1
"adb17b12b66c4a49a85fd34322f7df70","adb17b12b66c4a49a85fd34322f7df70",22852816,1,0,1,219,73,73,0
"adb17b12b66c4a49a85fd34322f7df70","d646286c8051419bbc2e31dd1db55ca8",22852816,1,-6,0,220,73,67,-6
"d646286c8051419bbc2e31dd1db55ca8","a2becd407db34b189200a32546d9d569",22852816,3,9,0,221,67,75,8
"a2becd407db34b189200a32546d9d569","a2becd407db34b189200a32546d9d569",22852816,5,0,1,222,75,75,0
"a2becd407db34b189200a32546d9d569","67a089198fcb4e1c8f2385786c2b296f",22852816,1,-46,0,224,75,39,-36
"64d48c6c9c7940639a932219a6c87198","d646286c8051419bbc2e31dd1db55ca8",22852816,1,36,0,226,40,67,27
"a2becd407db34b189200a32546d9d569","d646286c8051419bbc2e31dd1db55ca8",22852816,1,-9,0,230,75,67,-8
"a2becd407db34b189200a32546d9d569","58c22b011d0f4c2ea6d13615edbb9eeb",22852816,1,2,0,233,75,77,2
"58c22b011d0f4c2ea6d13615edbb9eeb","58c22b011d0f4c2ea6d13615edbb9eeb",22852816,2,0,1,234,77,77,0
"58c22b011d0f4c2ea6d13615edbb9eeb","dd76e1861dc9461c830888729d091ee0",22852816,1,1,0,236,77,78,1
"dd76e1861dc9461c830888729d091ee0","dd76e1861dc9461c830888729d091ee0",22852816,5,0,1,237,78,78,0
"dd76e1861dc9461c830888729d091ee0","cd1d828f1a694b87913a7ea66c23803e",22852816,1,1,0,242,78,79,1
"cd1d828f1a694b87913a7ea66c23803e","cd1d828f1a694b87913a7ea66c23803e",22852816,2,0,1,243,79,79,0
"cd1d828f1a694b87913a7ea66c23803e","9176a3c2b4d2465fa8b0c67096c2a97e",22852816,1,1,0,245,79,80,1
"9176a3c2b4d2465fa8b0c67096c2a97e","9176a3c2b4d2465fa8b0c67096c2a97e",22852816,5,0,1,246,80,80,0
"9176a3c2b4d2465fa8b0c67096c2a97e","f8ec6445f7194e25b9101d4fbcb07a18",22852816,1,1,0,251,80,81,1
"f8ec6445f7194e25b9101d4fbcb07a18","f8ec6445f7194e25b9101d4fbcb07a18",22852816,2,0,1,252,81,81,0
"f8ec6445f7194e25b9101d4fbcb07a18","140d5b27b8574befad82c0a013b59dfa",22852816,1,-7,0,254,81,74,-7
"140d5b27b8574befad82c0a013b59dfa","d18a9ea32855445f8736581f5cb119ce",22852816,1,9,0,255,74,82,8
"d18a9ea32855445f8736581f5cb119ce","f564483cbd7a407681aa2fcca518cf5f",22852816,1,4,0,256,82,85,3
"f564483cbd7a407681aa2fcca518cf5f","f564483cbd7a407681aa2fcca518cf5f",22852816,1,0,1,257,85,85,0
"f564483cbd7a407681aa2fcca518cf5f","18fd01350bd5434ca636d59a599d768a",22852816,1,1,0,258,85,86,1
"18fd01350bd5434ca636d59a599d768a","18fd01350bd5434ca636d59a599d768a",22852816,10,0,1,259,86,86,0
"18fd01350bd5434ca636d59a599d768a","ae5ac430ea254e708a6f5deaaf7464ae",22852816,1,-2,0,269,86,84,-2
"ae5ac430ea254e708a6f5deaaf7464ae","6a9f0ef185fb47f0937e29daa1c71ed5",22852816,1,7,0,270,84,90,6
"6a9f0ef185fb47f0937e29daa1c71ed5","c681290961c94c4caf23b529d1ae6b9a",22852816,1,-2,0,271,90,88,-2
"c681290961c94c4caf23b529d1ae6b9a","c681290961c94c4caf23b529d1ae6b9a",22852816,1,0,1,272,88,88,0
"c681290961c94c4caf23b529d1ae6b9a","6a9f0ef185fb47f0937e29daa1c71ed5",22852816,1,2,0,273,88,90,2
"6a9f0ef185fb47f0937e29daa1c71ed5","6a9f0ef185fb47f0937e29daa1c71ed5",22852816,3,0,1,274,90,90,0
"6a9f0ef185fb47f0937e29daa1c71ed5","e20db35ced8544ddac5bc3839145e463",22852816,1,3,0,277,90,91,1
"e20db35ced8544ddac5bc3839145e463","d646286c8051419bbc2e31dd1db55ca8",22852816,1,-30,0,278,91,67,-24
"d646286c8051419bbc2e31dd1db55ca8","e20db35ced8544ddac5bc3839145e463",22852816,1,30,0,279,67,91,24
"e20db35ced8544ddac5bc3839145e463","231c15562ab8497daeb55e56acf3b35c",22852816,1,2,0,280,91,93,2
"231c15562ab8497daeb55e56acf3b35c","231c15562ab8497daeb55e56acf3b35c",22852816,1,0,1,281,93,93,0
"231c15562ab8497daeb55e56acf3b35c","e20db35ced8544ddac5bc3839145e463",22852816,1,-2,0,282,93,91,-2
"e20db35ced8544ddac5bc3839145e463","1febb706d7a34005ae8711ed49c76e64",22852816,1,3,0,283,91,94,3
"1febb706d7a34005ae8711ed49c76e64","1febb706d7a34005ae8711ed49c76e64",22852816,3,0,1,284,94,94,0
"1febb706d7a34005ae8711ed49c76e64","8f73ba6f5a0042f2850356ac38ac6f24",22852816,1,1,0,287,94,95,1
"8f73ba6f5a0042f2850356ac38ac6f24","8f73ba6f5a0042f2850356ac38ac6f24",22852816,6,0,1,288,95,95,0
"8f73ba6f5a0042f2850356ac38ac6f24","e2260b86653c46d7b14a41fb419dbf8c",22852816,1,1,0,294,95,96,1
"e2260b86653c46d7b14a41fb419dbf8c","e2260b86653c46d7b14a41fb419dbf8c",22852816,2,0,1,295,96,96,0
"e2260b86653c46d7b14a41fb419dbf8c","35eb641ad1d845bbba54915bce75a962",22852816,1,1,0,297,96,97,1
"35eb641ad1d845bbba54915bce75a962","35eb641ad1d845bbba54915bce75a962",22852816,6,0,1,298,97,97,0
"35eb641ad1d845bbba54915bce75a962","08be90ffbeea4795a138cd42ed8db56f",22852816,1,1,0,304,97,98,1
"08be90ffbeea4795a138cd42ed8db56f","08be90ffbeea4795a138cd42ed8db56f",22852816,5,0,1,305,98,98,0
"08be90ffbeea4795a138cd42ed8db56f","3007433c8f584dcbb5ac159c1c5f2be3",22852816,1,1,0,310,98,99,1
"3007433c8f584dcbb5ac159c1c5f2be3","3007433c8f584dcbb5ac159c1c5f2be3",22852816,2,0,1,311,99,99,0
"3007433c8f584dcbb5ac159c1c5f2be3","e20db35ced8544ddac5bc3839145e463",22852816,1,-8,0,313,99,91,-8
"e20db35ced8544ddac5bc3839145e463","00ae5f0c51874a73a41ebea838d95682",22852816,1,11,0,314,91,101,10
"00ae5f0c51874a73a41ebea838d95682","d391c8b6e56a43a7b654e9dee02d904b",22852816,2,2,0,315,101,103,2
"d391c8b6e56a43a7b654e9dee02d904b","00ae5f0c51874a73a41ebea838d95682",22852816,1,-2,0,316,103,101,-2
"d391c8b6e56a43a7b654e9dee02d904b","d391c8b6e56a43a7b654e9dee02d904b",22852816,15,0,1,318,103,103,0
"d391c8b6e56a43a7b654e9dee02d904b","6111116566fc4fd9abba409322bea245",22852816,1,1,0,333,103,104,1
"6111116566fc4fd9abba409322bea245","6111116566fc4fd9abba409322bea245",22852816,2,0,1,334,104,104,0
"6111116566fc4fd9abba409322bea245","a81b2235cb9c499eb9ea8ee0a8dd9725",22852816,1,1,0,336,104,105,1
"a81b2235cb9c499eb9ea8ee0a8dd9725","a81b2235cb9c499eb9ea8ee0a8dd9725",22852816,2,0,1,337,105,105,0
"a81b2235cb9c499eb9ea8ee0a8dd9725","2d4e0ab0ef3b4d73b82c72d4621a7579",22852816,1,1,0,339,105,106,1
"2d4e0ab0ef3b4d73b82c72d4621a7579","2d4e0ab0ef3b4d73b82c72d4621a7579",22852816,2,0,1,340,106,106,0
"2d4e0ab0ef3b4d73b82c72d4621a7579","8bdebf492ebd4e62b0d522e8ab5e5197",22852816,1,1,0,342,106,107,1
"8bdebf492ebd4e62b0d522e8ab5e5197","8bdebf492ebd4e62b0d522e8ab5e5197",22852816,5,0,1,343,107,107,0
"8bdebf492ebd4e62b0d522e8ab5e5197","73039f8c1eb9409cb4caee2cf968001e",22852816,1,-7,0,348,107,100,-7
"73039f8c1eb9409cb4caee2cf968001e","4280927ec4d643238aa49c32f9e06c6c",22852816,1,10,0,349,100,109,9
"4280927ec4d643238aa49c32f9e06c6c","4280927ec4d643238aa49c32f9e06c6c",22852816,1,0,1,350,109,109,0
"4280927ec4d643238aa49c32f9e06c6c","fc44e6a5f7654430af1227838224dceb",22852816,1,2,0,351,109,111,2
"fc44e6a5f7654430af1227838224dceb","fc44e6a5f7654430af1227838224dceb",22852816,2,0,1,352,111,111,0
"fc44e6a5f7654430af1227838224dceb","08111f75e22d409998cf8b85bd431f0a",22852816,1,-3,0,354,111,108,-3
"08111f75e22d409998cf8b85bd431f0a","a9ae0a3c070d455bb4369a8996313336",22852816,1,7,0,355,108,114,6
"a9ae0a3c070d455bb4369a8996313336","a9ae0a3c070d455bb4369a8996313336",22852816,1,0,1,356,114,114,0
"a9ae0a3c070d455bb4369a8996313336","71cec822bcff4f30a20e75dc63ef7b65",22852816,1,2,0,357,114,116,2
"71cec822bcff4f30a20e75dc63ef7b65","71cec822bcff4f30a20e75dc63ef7b65",22852816,1,0,1,358,116,116,0
"71cec822bcff4f30a20e75dc63ef7b65","37319e88176d4aefa91d7a9980dbae91",22852816,1,-4,0,359,116,112,-4
"37319e88176d4aefa91d7a9980dbae91","62bff51286ef4f348717a3cf6fe2318f",22852816,1,9,0,360,112,120,8
"62bff51286ef4f348717a3cf6fe2318f","b1cd0e7dc3ad4a8eb91a4bfdbeb025b0",22852816,1,-2,0,361,120,118,-2
"b1cd0e7dc3ad4a8eb91a4bfdbeb025b0","b1cd0e7dc3ad4a8eb91a4bfdbeb025b0",22852816,1,0,1,362,118,118,0
"b1cd0e7dc3ad4a8eb91a4bfdbeb025b0","62bff51286ef4f348717a3cf6fe2318f",22852816,1,2,0,363,118,120,2
"62bff51286ef4f348717a3cf6fe2318f","62bff51286ef4f348717a3cf6fe2318f",22852816,3,0,1,364,120,120,0
"62bff51286ef4f348717a3cf6fe2318f","e20db35ced8544ddac5bc3839145e463",22852816,1,-33,0,367,120,91,-29
"e20db35ced8544ddac5bc3839145e463","779f9ddd1fd14d1e9e69f72219a1fdbd",22852816,1,36,0,368,91,121,30
"779f9ddd1fd14d1e9e69f72219a1fdbd","ae26e6cda8ad4a3f81bd347560d9579f",22852816,1,4,0,369,121,125,4
"ae26e6cda8ad4a3f81bd347560d9579f","ae26e6cda8ad4a3f81bd347560d9579f",22852816,1,0,1,370,125,125,0
"ae26e6cda8ad4a3f81bd347560d9579f","ee48df95832b4374aa273ceb27ec1315",22852816,1,1,0,371,125,126,1
"ee48df95832b4374aa273ceb27ec1315","ee48df95832b4374aa273ceb27ec1315",22852816,1,0,1,372,126,126,0
"ee48df95832b4374aa273ceb27ec1315","7a439da90b394756ad1777fc4c6dead5",22852816,1,1,0,373,126,127,1
"7a439da90b394756ad1777fc4c6dead5","7a439da90b394756ad1777fc4c6dead5",22852816,1,0,1,374,127,127,0
"7a439da90b394756ad1777fc4c6dead5","779f9ddd1fd14d1e9e69f72219a1fdbd",22852816,1,-6,0,375,127,121,-6
"779f9ddd1fd14d1e9e69f72219a1fdbd","a8dd5213034441ac92724b4e83eb0bb2",22852816,1,9,0,376,121,129,8
"a8dd5213034441ac92724b4e83eb0bb2","a8dd5213034441ac92724b4e83eb0bb2",22852816,1,0,1,377,129,129,0
"a8dd5213034441ac92724b4e83eb0bb2","8115eab6556b45f5b415c3b8c26a12e5",22852816,1,2,0,378,129,131,2
"8115eab6556b45f5b415c3b8c26a12e5","8115eab6556b45f5b415c3b8c26a12e5",22852816,2,0,1,379,131,131,0
"8115eab6556b45f5b415c3b8c26a12e5","ec34b06efd844b46a4c4818ecdb9b8f4",22852816,1,1,0,381,131,132,1
"ec34b06efd844b46a4c4818ecdb9b8f4","ec34b06efd844b46a4c4818ecdb9b8f4",22852816,2,0,1,382,132,132,0
"ec34b06efd844b46a4c4818ecdb9b8f4","c2e1c2b9eac64109b343a088584b576b",22852816,1,1,0,384,132,133,1
"c2e1c2b9eac64109b343a088584b576b","c2e1c2b9eac64109b343a088584b576b",22852816,2,0,1,385,133,133,0
"c2e1c2b9eac64109b343a088584b576b","579338175e0b4bbb8ef3b712b5d8b54e",22852816,1,-5,0,387,133,128,-5
"579338175e0b4bbb8ef3b712b5d8b54e","8bc5795d6a984a3eace4e2811e52dd4f",22852816,1,8,0,388,128,135,7
"8bc5795d6a984a3eace4e2811e52dd4f","8bc5795d6a984a3eace4e2811e52dd4f",22852816,1,0,1,389,135,135,0
"8bc5795d6a984a3eace4e2811e52dd4f","b416d47c56a742199b5d7c7f19d6503a",22852816,1,-1,0,390,135,134,-1
"b416d47c56a742199b5d7c7f19d6503a","cd4532ad48034873ba8bce2aac0c9808",22852816,1,4,0,391,134,137,3
"cd4532ad48034873ba8bce2aac0c9808","cd4532ad48034873ba8bce2aac0c9808",22852816,3,0,1,392,137,137,0
"cd4532ad48034873ba8bce2aac0c9808","779f9ddd1fd14d1e9e69f72219a1fdbd",22852816,1,-19,0,395,137,121,-16
"779f9ddd1fd14d1e9e69f72219a1fdbd","df1de691dafe4549a18a4398ee9dfaf9",22852816,1,23,0,396,121,139,18
"df1de691dafe4549a18a4398ee9dfaf9","6c5ad271a44743479bfaea29b1db8d02",22852816,1,4,0,397,139,143,4
"6c5ad271a44743479bfaea29b1db8d02","6c5ad271a44743479bfaea29b1db8d02",22852816,1,0,1,398,143,143,0
"6c5ad271a44743479bfaea29b1db8d02","83d311bed5374fee83d8d67a7d9d82dc",22852816,1,1,0,399,143,144,1
"83d311bed5374fee83d8d67a7d9d82dc","83d311bed5374fee83d8d67a7d9d82dc",22852816,1,0,1,400,144,144,0
"83d311bed5374fee83d8d67a7d9d82dc","402bba41861d43acb52a5abb89e8831e",22852816,1,1,0,401,144,145,1
"402bba41861d43acb52a5abb89e8831e","402bba41861d43acb52a5abb89e8831e",22852816,2,0,1,402,145,145,0
"402bba41861d43acb52a5abb89e8831e","df1de691dafe4549a18a4398ee9dfaf9",22852816,1,-6,0,404,145,139,-6
"df1de691dafe4549a18a4398ee9dfaf9","8aae34f5ddbb4052a709b12e6b0d40fa",22852816,1,9,0,405,139,147,8
"8aae34f5ddbb4052a709b12e6b0d40fa","8aae34f5ddbb4052a709b12e6b0d40fa",22852816,1,0,1,406,147,147,0
"8aae34f5ddbb4052a709b12e6b0d40fa","645b3f0249f64f76af2e19eb4d0e55b7",22852816,1,2,0,407,147,149,2
"645b3f0249f64f76af2e19eb4d0e55b7","645b3f0249f64f76af2e19eb4d0e55b7",22852816,6,0,1,408,149,149,0
"645b3f0249f64f76af2e19eb4d0e55b7","7e7b8db5064d4369805ab370aac5ddfb",22852816,1,1,0,414,149,150,1
"7e7b8db5064d4369805ab370aac5ddfb","7e7b8db5064d4369805ab370aac5ddfb",22852816,2,0,1,415,150,150,0
"7e7b8db5064d4369805ab370aac5ddfb","8956d210ae7f41968fada86d4c979d6a",22852816,1,1,0,417,150,151,1
"8956d210ae7f41968fada86d4c979d6a","8956d210ae7f41968fada86d4c979d6a",22852816,2,0,1,418,151,151,0
"8956d210ae7f41968fada86d4c979d6a","f902b0f41b544d4dbf79664fd233648d",22852816,1,-5,0,420,151,146,-5
"f902b0f41b544d4dbf79664fd233648d","ae781e8b775e4ccd93bc800dad5c8376",22852816,1,8,0,421,146,153,7
"ae781e8b775e4ccd93bc800dad5c8376","ae781e8b775e4ccd93bc800dad5c8376",22852816,2,0,1,422,153,153,0
"ae781e8b775e4ccd93bc800dad5c8376","06882a8492d9499aa31555567f575ecb",22852816,1,1,0,424,153,154,1
"06882a8492d9499aa31555567f575ecb","06882a8492d9499aa31555567f575ecb",22852816,1,0,1,425,154,154,0
"06882a8492d9499aa31555567f575ecb","f293c508f409466a8f27ddd7d1e40b20",22852816,1,1,0,426,154,155,1
"f293c508f409466a8f27ddd7d1e40b20","f293c508f409466a8f27ddd7d1e40b20",22852816,2,0,1,427,155,155,0
"f293c508f409466a8f27ddd7d1e40b20","cc4ddef5bbbe48ebb605141b347c4ed1",22852816,1,1,0,429,155,156,1
"cc4ddef5bbbe48ebb605141b347c4ed1","cc4ddef5bbbe48ebb605141b347c4ed1",22852816,5,0,1,430,156,156,0
"cc4ddef5bbbe48ebb605141b347c4ed1","d313cec988a84645bee413e8d4724a4b",22852816,1,3,0,435,156,158,2
"d313cec988a84645bee413e8d4724a4b","f03480cf4eba413194d7af52fc0e7f28",22852816,1,-7,0,436,158,152,-6
"f03480cf4eba413194d7af52fc0e7f28","d313cec988a84645bee413e8d4724a4b",22852816,1,7,0,437,152,158,6
"d313cec988a84645bee413e8d4724a4b","d313cec988a84645bee413e8d4724a4b",22852816,3,0,1,438,158,158,0
"d313cec988a84645bee413e8d4724a4b","dc60696c76a74368a60f72246e47700d",22852816,1,1,0,441,158,159,1
"dc60696c76a74368a60f72246e47700d","dc60696c76a74368a60f72246e47700d",22852816,1,0,1,442,159,159,0
"dc60696c76a74368a60f72246e47700d","df1de691dafe4549a18a4398ee9dfaf9",22852816,1,-23,0,443,159,139,-20
"df1de691dafe4549a18a4398ee9dfaf9","78adeee1fa2c4fe0bc73f7bca9fcee86",22852816,1,26,0,444,139,160,21
"78adeee1fa2c4fe0bc73f7bca9fcee86","67a089198fcb4e1c8f2385786c2b296f",22852816,1,-152,0,445,160,39,-121
"64d48c6c9c7940639a932219a6c87198","78adeee1fa2c4fe0bc73f7bca9fcee86",22852816,1,151,0,447,40,160,120
"78adeee1fa2c4fe0bc73f7bca9fcee86","78adeee1fa2c4fe0bc73f7bca9fcee86",22852816,1,0,1,448,160,160,0
"78adeee1fa2c4fe0bc73f7bca9fcee86","65202579580f4ad38d734b4ee39d22a8",22852816,2,5,0,449,160,164,4
"65202579580f4ad38d734b4ee39d22a8","65202579580f4ad38d734b4ee39d22a8",22852816,51,0,1,450,164,164,0
"65202579580f4ad38d734b4ee39d22a8","78adeee1fa2c4fe0bc73f7bca9fcee86",22852816,2,-5,0,455,164,160,-4
"78adeee1fa2c4fe0bc73f7bca9fcee86","3cbcea2be0984e7dbd5a48195af10ce7",22852816,1,8,0,504,160,165,5
"3cbcea2be0984e7dbd5a48195af10ce7","82e6285962b8400d9d6fc32436022a94",22852816,2,2,0,505,165,167,2
"82e6285962b8400d9d6fc32436022a94","3cbcea2be0984e7dbd5a48195af10ce7",22852816,1,-2,0,506,167,165,-2
"82e6285962b8400d9d6fc32436022a94","0c7262dff33c4087bc660ccf40f92f9c",22852816,1,7,0,508,167,169,2
"0c7262dff33c4087bc660ccf40f92f9c","b2275c3fad834f8d90737a2d9a6927d6",22852816,1,3,0,509,169,172,3
"b2275c3fad834f8d90737a2d9a6927d6","b2275c3fad834f8d90737a2d9a6927d6",22852816,20,0,1,510,172,172,0
"b2275c3fad834f8d90737a2d9a6927d6","eb515a26030b41f8a82a1e6114420bad",22852816,1,1,0,530,172,173,1
"eb515a26030b41f8a82a1e6114420bad","eb515a26030b41f8a82a1e6114420bad",22852816,2,0,1,531,173,173,0
"eb515a26030b41f8a82a1e6114420bad","0c7262dff33c4087bc660ccf40f92f9c",22852816,1,-4,0,533,173,169,-4
"0c7262dff33c4087bc660ccf40f92f9c","b42cc17b7de840f181a704558d0bc845",22852816,1,7,0,534,169,175,6
"b42cc17b7de840f181a704558d0bc845","b42cc17b7de840f181a704558d0bc845",22852816,1,0,1,535,175,175,0
"b42cc17b7de840f181a704558d0bc845","801f9e9135034f49bf5f8b4bdefedb41",22852816,1,2,0,536,175,177,2
"801f9e9135034f49bf5f8b4bdefedb41","801f9e9135034f49bf5f8b4bdefedb41",22852816,7,0,1,537,177,177,0
"801f9e9135034f49bf5f8b4bdefedb41","ea38cc0e6e6e41edbabf210220808bf9",22852816,1,3,0,544,177,179,2
"ea38cc0e6e6e41edbabf210220808bf9","362fcb0699a14845ab29b2340093e528",22852816,1,-6,0,545,179,174,-5
"362fcb0699a14845ab29b2340093e528","b87c552dd247427abe6ab5795b9c9d43",22852816,1,8,0,546,174,181,7
"b87c552dd247427abe6ab5795b9c9d43","ea38cc0e6e6e41edbabf210220808bf9",22852816,1,-2,0,547,181,179,-2
"ea38cc0e6e6e41edbabf210220808bf9","b87c552dd247427abe6ab5795b9c9d43",22852816,1,2,0,548,179,181,2
"b87c552dd247427abe6ab5795b9c9d43","b87c552dd247427abe6ab5795b9c9d43",22852816,9,0,1,549,181,181,0
"b87c552dd247427abe6ab5795b9c9d43","139b097acfca451689d80c9c6eebdf7b",22852816,1,-3,0,558,181,178,-3
"139b097acfca451689d80c9c6eebdf7b","30f660a1feb34582a739722532524f79",22852816,1,6,0,559,178,183,5
"30f660a1feb34582a739722532524f79","30f660a1feb34582a739722532524f79",22852816,9,0,1,560,183,183,0
"30f660a1feb34582a739722532524f79","2024b4885bd14338a39b7b509acbbd02",22852816,1,-1,0,569,183,182,-1
"2024b4885bd14338a39b7b509acbbd02","c3f63fe50d8e487c86bf8ef76c9cadd3",22852816,1,4,0,570,182,185,3
"c3f63fe50d8e487c86bf8ef76c9cadd3","c3f63fe50d8e487c86bf8ef76c9cadd3",22852816,1,0,1,571,185,185,0
"c3f63fe50d8e487c86bf8ef76c9cadd3","0c7262dff33c4087bc660ccf40f92f9c",22852816,1,-20,0,572,185,169,-16
"c8e371568a0c4391b25796ae4e91952e","7d932b23e1c84326ae5aa4d3c0d813d1",22852816,1,2,0,574,186,188,2
"7d932b23e1c84326ae5aa4d3c0d813d1","7d932b23e1c84326ae5aa4d3c0d813d1",22852816,3,0,1,575,188,188,0
"7d932b23e1c84326ae5aa4d3c0d813d1","c8e371568a0c4391b25796ae4e91952e",22852816,1,-2,0,578,188,186,-2
"ab11d94c6c8948ea90b88f19d2cd502b","ab11d94c6c8948ea90b88f19d2cd502b",22852816,1,0,1,580,190,190,0
"ab11d94c6c8948ea90b88f19d2cd502b","f992451ed6ad4e68bb9e68ad6be7c4be",22852816,1,2,0,581,190,192,2
"f992451ed6ad4e68bb9e68ad6be7c4be","f992451ed6ad4e68bb9e68ad6be7c4be",22852816,1,0,1,582,192,192,0
"f992451ed6ad4e68bb9e68ad6be7c4be","6cd2dcaac46847d4a0bc53f296d90375",22852816,1,3,0,583,192,194,2
"6cd2dcaac46847d4a0bc53f296d90375","07b44a7a51e94c78b411c753fc39dab0",22852816,1,-6,0,584,194,189,-5
"6cd2dcaac46847d4a0bc53f296d90375","2d2580c9411c4972909db508d6956a58",22852816,1,2,0,586,194,196,2
"2d2580c9411c4972909db508d6956a58","2d2580c9411c4972909db508d6956a58",22852816,2,0,1,587,196,196,0
"2d2580c9411c4972909db508d6956a58","5bddb3d9ed264f3984702f048c7e5340",22852816,1,1,0,589,196,197,1
"5bddb3d9ed264f3984702f048c7e5340","5bddb3d9ed264f3984702f048c7e5340",22852816,2,0,1,590,197,197,0
"5bddb3d9ed264f3984702f048c7e5340","d5e8e2bd12a2466b9d6d90855f0eb079",22852816,1,1,0,592,197,198,1
"d5e8e2bd12a2466b9d6d90855f0eb079","d5e8e2bd12a2466b9d6d90855f0eb079",22852816,2,0,1,593,198,198,0
"d5e8e2bd12a2466b9d6d90855f0eb079","017d7ca8e0394b91aaadc9574df2202c",22852816,1,-5,0,595,198,193,-5
"017d7ca8e0394b91aaadc9574df2202c","54e8e9f0ea3e45c4bf3b8ac799ee31b1",22852816,1,8,0,596,193,200,7
"54e8e9f0ea3e45c4bf3b8ac799ee31b1","54e8e9f0ea3e45c4bf3b8ac799ee31b1",22852816,1,0,1,597,200,200,0
"54e8e9f0ea3e45c4bf3b8ac799ee31b1","c614a00911be4877a075f19315530fb0",22852816,1,1,0,598,200,201,1
"c614a00911be4877a075f19315530fb0","c614a00911be4877a075f19315530fb0",22852816,6,0,1,599,201,201,0
"c614a00911be4877a075f19315530fb0","a6c21bd8b95249c7972820a7a7d76aff",22852816,1,1,0,605,201,202,1
"a6c21bd8b95249c7972820a7a7d76aff","a6c21bd8b95249c7972820a7a7d76aff",22852816,3,0,1,606,202,202,0
"a6c21bd8b95249c7972820a7a7d76aff","bb329d880ab54120adaf203a693bb203",22852816,1,1,0,607,202,203,1
"bb329d880ab54120adaf203a693bb203","a6c21bd8b95249c7972820a7a7d76aff",22852816,1,-1,0,608,203,202,-1
"a6c21bd8b95249c7972820a7a7d76aff","f9170dd6bc6442b4acd832747609b09a",22852816,1,-3,0,611,202,199,-3
"f9170dd6bc6442b4acd832747609b09a","6cd2dcaac46847d4a0bc53f296d90375",22852816,1,-6,0,612,199,194,-5
"017d7ca8e0394b91aaadc9574df2202c","bb329d880ab54120adaf203a693bb203",22852816,1,11,0,614,193,203,10
"bb329d880ab54120adaf203a693bb203","bb329d880ab54120adaf203a693bb203",22852816,1,0,1,615,203,203,0
"bb329d880ab54120adaf203a693bb203","f9170dd6bc6442b4acd832747609b09a",22852816,1,-4,0,616,203,199,-4
"f9170dd6bc6442b4acd832747609b09a","c8e371568a0c4391b25796ae4e91952e",22852816,1,-16,0,617,199,186,-13
"017d7ca8e0394b91aaadc9574df2202c","f9170dd6bc6442b4acd832747609b09a",22852816,2,7,0,623,193,199,6
"f9170dd6bc6442b4acd832747609b09a","334c2344009840079b1d0e1b7ce3d5a7",22852816,1,7,0,624,199,205,6
"334c2344009840079b1d0e1b7ce3d5a7","334c2344009840079b1d0e1b7ce3d5a7",22852816,1,0,1,625,205,205,0
"334c2344009840079b1d0e1b7ce3d5a7","c8e371568a0c4391b25796ae4e91952e",22852816,1,-23,0,626,205,186,-19
"c8e371568a0c4391b25796ae4e91952e","d7f13c8d63ec4e2aa673fbb9cf9c6933",22852816,2,26,0,627,186,206,20
"d7f13c8d63ec4e2aa673fbb9cf9c6933","7108f0e4c2584f1f9c471689ae4c885c",22852816,2,2,0,628,206,208,2
"b9e80f77c3a44349863b19875725c384","b9e80f77c3a44349863b19875725c384",22852816,47,0,1,636,207,207,0
"b9e80f77c3a44349863b19875725c384","7108f0e4c2584f1f9c471689ae4c885c",22852816,4,1,0,683,207,208,1
"7108f0e4c2584f1f9c471689ae4c885c","7108f0e4c2584f1f9c471689ae4c885c",22852816,15,0,1,684,208,208,0
"7108f0e4c2584f1f9c471689ae4c885c","d7f13c8d63ec4e2aa673fbb9cf9c6933",22852816,4,-2,0,699,208,206,-2
"d7f13c8d63ec4e2aa673fbb9cf9c6933","09400e101c5d4b439cf9a26b03aae558",22852816,2,5,0,700,206,210,4
"09400e101c5d4b439cf9a26b03aae558","09400e101c5d4b439cf9a26b03aae558",22852816,1,0,1,701,210,210,0
"09400e101c5d4b439cf9a26b03aae558","a88efa7e50ce47159810ab553afa6d3a",22852816,1,2,0,702,210,212,2
"a88efa7e50ce47159810ab553afa6d3a","a88efa7e50ce47159810ab553afa6d3a",22852816,2,0,1,703,212,212,0
"a88efa7e50ce47159810ab553afa6d3a","a875096404ef4a9984b62d74cda916f9",22852816,1,-3,0,705,212,209,-3
"a875096404ef4a9984b62d74cda916f9","f7fb1952f56b4189b86a9f8b7862d2b8",22852816,1,7,0,706,209,215,6
"f7fb1952f56b4189b86a9f8b7862d2b8","be502a7a43c44bf7b682698de79d9369",22852816,3,-1,0,707,215,214,-1
"be502a7a43c44bf7b682698de79d9369","d7f13c8d63ec4e2aa673fbb9cf9c6933",22852816,1,-10,0,708,214,206,-8
"d7f13c8d63ec4e2aa673fbb9cf9c6933","b9e80f77c3a44349863b19875725c384",22852816,2,1,0,709,206,207,1
"d7f13c8d63ec4e2aa673fbb9cf9c6933","363837c182e04711840d896ae1e0339c",22852816,1,15,0,712,206,218,12
"363837c182e04711840d896ae1e0339c","01b2051f8941460d89945e3b02d1ce78",22852816,7,-1,0,713,218,217,-1
"01b2051f8941460d89945e3b02d1ce78","be502a7a43c44bf7b682698de79d9369",22852816,2,-4,0,714,217,214,-3
"be502a7a43c44bf7b682698de79d9369","f7fb1952f56b4189b86a9f8b7862d2b8",22852816,4,1,0,715,214,215,1
"f7fb1952f56b4189b86a9f8b7862d2b8","f7fb1952f56b4189b86a9f8b7862d2b8",22852816,28,0,1,718,215,215,0
"f7fb1952f56b4189b86a9f8b7862d2b8","b860ee85d8bc4a2f97958cfb71be3533",22852816,2,1,0,735,215,216,1
"b860ee85d8bc4a2f97958cfb71be3533","b860ee85d8bc4a2f97958cfb71be3533",22852816,4,0,1,736,216,216,0
"b860ee85d8bc4a2f97958cfb71be3533","ec341f459285443b8361f7f15638ff08",22852816,2,-3,0,738,216,213,-3
"ec341f459285443b8361f7f15638ff08","363837c182e04711840d896ae1e0339c",22852816,4,6,0,739,213,218,5
"363837c182e04711840d896ae1e0339c","363837c182e04711840d896ae1e0339c",22852816,12,0,1,740,218,218,0
"01b2051f8941460d89945e3b02d1ce78","91125ca626c5470eb145501f8c37f8db",22852816,1,4,0,753,217,220,3
"91125ca626c5470eb145501f8c37f8db","be95c065e45447c1bd8215ea6f130c7a",22852816,1,-1,0,754,220,219,-1
"be95c065e45447c1bd8215ea6f130c7a","363837c182e04711840d896ae1e0339c",22852816,3,-2,0,755,219,218,-1
"01b2051f8941460d89945e3b02d1ce78","be95c065e45447c1bd8215ea6f130c7a",22852816,1,3,0,757,217,219,2
"be502a7a43c44bf7b682698de79d9369","be95c065e45447c1bd8215ea6f130c7a",22852816,2,7,0,761,214,219,5
"be95c065e45447c1bd8215ea6f130c7a","f7fb1952f56b4189b86a9f8b7862d2b8",22852816,2,-6,0,762,219,215,-4
"f7fb1952f56b4189b86a9f8b7862d2b8","ec341f459285443b8361f7f15638ff08",22852816,2,-2,0,763,215,213,-2
"01b2051f8941460d89945e3b02d1ce78","d7f13c8d63ec4e2aa673fbb9cf9c6933",22852816,3,-14,0,766,217,206,-11
"d7f13c8d63ec4e2aa673fbb9cf9c6933","be95c065e45447c1bd8215ea6f130c7a",22852816,1,17,0,770,206,219,13
"01b2051f8941460d89945e3b02d1ce78","363837c182e04711840d896ae1e0339c",22852816,1,1,0,773,217,218,1
"363837c182e04711840d896ae1e0339c","be95c065e45447c1bd8215ea6f130c7a",22852816,1,2,0,774,218,219,1
"be95c065e45447c1bd8215ea6f130c7a","01b2051f8941460d89945e3b02d1ce78",22852816,1,-3,0,775,219,217,-2
"d7f13c8d63ec4e2aa673fbb9cf9c6933","91125ca626c5470eb145501f8c37f8db",22852816,1,18,0,780,206,220,14
"91125ca626c5470eb145501f8c37f8db","91125ca626c5470eb145501f8c37f8db",22852816,1,0,1,781,220,220,0
"91125ca626c5470eb145501f8c37f8db","be502a7a43c44bf7b682698de79d9369",22852816,1,-8,0,782,220,214,-6
"363837c182e04711840d896ae1e0339c","0c7262dff33c4087bc660ccf40f92f9c",22852816,1,-64,0,787,218,169,-49
"f9170dd6bc6442b4acd832747609b09a","d7f13c8d63ec4e2aa673fbb9cf9c6933",22852816,1,10,0,796,199,206,7
"c8e371568a0c4391b25796ae4e91952e","b9e80f77c3a44349863b19875725c384",22852816,1,27,0,798,186,207,21
"09400e101c5d4b439cf9a26b03aae558","a875096404ef4a9984b62d74cda916f9",22852816,1,-1,0,802,210,209,-1
"a875096404ef4a9984b62d74cda916f9","be502a7a43c44bf7b682698de79d9369",22852816,1,6,0,803,209,214,5
"1c6721b1f63f4d30ba7746ea8af02a52","77ecef8eff6b4a2caea7707669bf7475",22852816,2,1,0,826,221,222,1
"77ecef8eff6b4a2caea7707669bf7475","77ecef8eff6b4a2caea7707669bf7475",22852816,12,0,1,827,222,222,0
"1c6721b1f63f4d30ba7746ea8af02a52","d03cb855c70044cf8c35d9ec0de696e3",22852816,3,4,0,840,221,224,3
"d03cb855c70044cf8c35d9ec0de696e3","8b9ae98743bd4d4a8a87dff1c1244211",22852816,3,3,0,841,224,227,3
"d03cb855c70044cf8c35d9ec0de696e3","1c6721b1f63f4d30ba7746ea8af02a52",22852816,1,-4,0,843,224,221,-3
"d03cb855c70044cf8c35d9ec0de696e3","a49a937d6896486d9a5396654abcf2e1",22852816,1,2,0,849,224,226,2
"a49a937d6896486d9a5396654abcf2e1","a49a937d6896486d9a5396654abcf2e1",22852816,1,0,1,850,226,226,0
"a49a937d6896486d9a5396654abcf2e1","8b9ae98743bd4d4a8a87dff1c1244211",22852816,1,1,0,851,226,227,1
"8b9ae98743bd4d4a8a87dff1c1244211","8b9ae98743bd4d4a8a87dff1c1244211",22852816,19,0,1,852,227,227,0
"8b9ae98743bd4d4a8a87dff1c1244211","1c6721b1f63f4d30ba7746ea8af02a52",22852816,1,-7,0,861,227,221,-6
"8b9ae98743bd4d4a8a87dff1c1244211","2ab1535aac1346ba8801535bf729ef37",22852816,1,3,0,874,227,229,2
"f7906d6f59b9489a91d2ef40db5a474d","2ab1535aac1346ba8801535bf729ef37",22852816,1,7,0,876,223,229,6
"2ab1535aac1346ba8801535bf729ef37","a4f40fb48a8542c8949bae1f002cd9bc",22852816,1,2,0,877,229,231,2
"a4f40fb48a8542c8949bae1f002cd9bc","a4f40fb48a8542c8949bae1f002cd9bc",22852816,2,0,1,878,231,231,0
"a4f40fb48a8542c8949bae1f002cd9bc","8972c23e32044edb8a78fa1eed4e5947",22852816,1,1,0,880,231,232,1
"8972c23e32044edb8a78fa1eed4e5947","8972c23e32044edb8a78fa1eed4e5947",22852816,1,0,1,881,232,232,0
"8972c23e32044edb8a78fa1eed4e5947","92feb4a40f8344d38b6f722e42a53295",22852816,1,1,0,882,232,233,1
"92feb4a40f8344d38b6f722e42a53295","92feb4a40f8344d38b6f722e42a53295",22852816,5,0,1,883,233,233,0
"92feb4a40f8344d38b6f722e42a53295","5152833676bf4c6cb317060be10f68db",22852816,1,-5,0,888,233,228,-5
"5152833676bf4c6cb317060be10f68db","ca3e28f290354c08aefe5b0f769604e6",22852816,1,8,0,889,228,235,7
"ca3e28f290354c08aefe5b0f769604e6","ca3e28f290354c08aefe5b0f769604e6",22852816,14,0,1,890,235,235,0
"ca3e28f290354c08aefe5b0f769604e6","79a35eea833e4c2c9d22fc53c3c6445c",22852816,1,1,0,904,235,236,1
"79a35eea833e4c2c9d22fc53c3c6445c","79a35eea833e4c2c9d22fc53c3c6445c",22852816,9,0,1,905,236,236,0
"79a35eea833e4c2c9d22fc53c3c6445c","8f68228b1518449e9615cdafee41a2bd",22852816,1,1,0,914,236,237,1
"8f68228b1518449e9615cdafee41a2bd","8f68228b1518449e9615cdafee41a2bd",22852816,1,0,1,915,237,237,0
"8f68228b1518449e9615cdafee41a2bd","cab89fa5c3ed45a5aa550fc0352d6a42",22852816,1,1,0,916,237,238,1
"cab89fa5c3ed45a5aa550fc0352d6a42","cab89fa5c3ed45a5aa550fc0352d6a42",22852816,6,0,1,917,238,238,0
"cab89fa5c3ed45a5aa550fc0352d6a42","1c6721b1f63f4d30ba7746ea8af02a52",22852816,1,-20,0,923,238,221,-17
"1c6721b1f63f4d30ba7746ea8af02a52","66d4fad4f1cf4b46be0750a99ad7a35a",22852816,1,21,0,924,221,239,18
"66d4fad4f1cf4b46be0750a99ad7a35a","66d4fad4f1cf4b46be0750a99ad7a35a",22852816,1,0,1,925,239,239,0
"66d4fad4f1cf4b46be0750a99ad7a35a","0b04c8e2f86d48c7aeb7e225819cd32b",22852816,1,-5,0,926,239,234,-5
"1c6721b1f63f4d30ba7746ea8af02a52","f53da5fd9bfe412da4b80d4742563b6c",22852816,1,24,0,928,221,241,20
"f53da5fd9bfe412da4b80d4742563b6c","f53da5fd9bfe412da4b80d4742563b6c",22852816,1,0,1,929,241,241,0
"f53da5fd9bfe412da4b80d4742563b6c","1c6721b1f63f4d30ba7746ea8af02a52",22852816,1,-24,0,930,241,221,-20
"1ebf23f9d994469a85206e4c7b1bf5f5","1ebf23f9d994469a85206e4c7b1bf5f5",22852816,15,0,1,933,245,245,0
"1ebf23f9d994469a85206e4c7b1bf5f5","85ae675b83e8422da842cfd25596af99",22852816,1,1,0,948,245,246,1
"85ae675b83e8422da842cfd25596af99","85ae675b83e8422da842cfd25596af99",22852816,1,0,1,949,246,246,0
"85ae675b83e8422da842cfd25596af99","2ae94c0cea4d480a9d5dca8fb1d7b542",22852816,1,-4,0,950,246,242,-4
"2ae94c0cea4d480a9d5dca8fb1d7b542","fa235f0f364d47e4ae1c87f47bf8e6ba",22852816,1,12,0,951,242,252,10
"fa235f0f364d47e4ae1c87f47bf8e6ba","fa235f0f364d47e4ae1c87f47bf8e6ba",22852816,1,0,1,952,252,252,0
"fa235f0f364d47e4ae1c87f47bf8e6ba","79f7845465cc4ed19d8e4f1429541be0",22852816,1,2,0,953,252,254,2
"79f7845465cc4ed19d8e4f1429541be0","79f7845465cc4ed19d8e4f1429541be0",22852816,6,0,1,954,254,254,0
"79f7845465cc4ed19d8e4f1429541be0","6e83e23f56544a19b94067c1c558d9c0",22852816,1,-8,0,960,254,247,-7
"6e83e23f56544a19b94067c1c558d9c0","00f61990949545828dd12f1303d47504",22852816,1,11,0,961,247,256,9
"00f61990949545828dd12f1303d47504","00f61990949545828dd12f1303d47504",22852816,1,0,1,962,256,256,0
"00f61990949545828dd12f1303d47504","ead7bb4b64e247d2ae632ab8a296b091",22852816,1,2,0,963,256,258,2
"ead7bb4b64e247d2ae632ab8a296b091","ead7bb4b64e247d2ae632ab8a296b091",22852816,2,0,1,964,258,258,0
"ead7bb4b64e247d2ae632ab8a296b091","41b0048dde734bb280bac6116baa8e27",22852816,1,1,0,966,258,259,1
"41b0048dde734bb280bac6116baa8e27","41b0048dde734bb280bac6116baa8e27",22852816,2,0,1,967,259,259,0
"41b0048dde734bb280bac6116baa8e27","b41c5a094a604ee0915327da5cc0beb7",22852816,1,1,0,969,259,260,1
"b41c5a094a604ee0915327da5cc0beb7","b41c5a094a604ee0915327da5cc0beb7",22852816,8,0,1,970,260,260,0
"b41c5a094a604ee0915327da5cc0beb7","d546341988904f069cfa86b21457d9d9",22852816,1,-10,0,978,260,251,-9
"d546341988904f069cfa86b21457d9d9","28c171777c52431ab6b925073bd63d46",22852816,1,15,0,979,251,264,13
"28c171777c52431ab6b925073bd63d46","28c171777c52431ab6b925073bd63d46",22852816,7,0,1,980,264,264,0
"28c171777c52431ab6b925073bd63d46","ac160db940cb49ae8579162b1d52bb5d",22852816,1,2,0,987,264,266,2
"ac160db940cb49ae8579162b1d52bb5d","ac160db940cb49ae8579162b1d52bb5d",22852816,7,0,1,988,266,266,0
"ac160db940cb49ae8579162b1d52bb5d","d989ebcfc12a4b669f0100dc1aa14f1e",22852816,1,-12,0,995,266,255,-11
"d989ebcfc12a4b669f0100dc1aa14f1e","c6fd49b485cc4874b0bbdd9c6171e09c",22852816,1,15,0,996,255,268,13
"c6fd49b485cc4874b0bbdd9c6171e09c","c6fd49b485cc4874b0bbdd9c6171e09c",22852816,3,0,1,997,268,268,0
"c6fd49b485cc4874b0bbdd9c6171e09c","44240778a97c4af0937817499b75707b",22852816,1,1,0,1000,268,269,1
"44240778a97c4af0937817499b75707b","44240778a97c4af0937817499b75707b",22852816,2,0,1,1001,269,269,0
"44240778a97c4af0937817499b75707b","7aa76d3e993840d8805f097cbdbcd44b",22852816,1,-9,0,1003,269,261,-8
"7aa76d3e993840d8805f097cbdbcd44b","865a4d3b43374da7944dc7d397f566d9",22852816,1,12,0,1004,261,271,10
"865a4d3b43374da7944dc7d397f566d9","865a4d3b43374da7944dc7d397f566d9",22852816,1,0,1,1005,271,271,0
"865a4d3b43374da7944dc7d397f566d9","2ae94c0cea4d480a9d5dca8fb1d7b542",22852816,1,-35,0,1006,271,242,-29
"2ae94c0cea4d480a9d5dca8fb1d7b542","0d987bed3ffa4ed0b9a2e62e97b7b30f",22852816,2,38,0,1007,242,272,30
"0d987bed3ffa4ed0b9a2e62e97b7b30f","0d987bed3ffa4ed0b9a2e62e97b7b30f",22852816,1,0,1,1008,272,272,0
"0d987bed3ffa4ed0b9a2e62e97b7b30f","0c7262dff33c4087bc660ccf40f92f9c",22852816,1,-135,0,1009,272,169,-103
"0c7262dff33c4087bc660ccf40f92f9c","0c7262dff33c4087bc660ccf40f92f9c",22852816,2,0,1,1010,169,169,0
"0c7262dff33c4087bc660ccf40f92f9c","c8e371568a0c4391b25796ae4e91952e",22852816,3,23,0,1011,169,186,17
"c8e371568a0c4391b25796ae4e91952e","c8e371568a0c4391b25796ae4e91952e",22852816,3,0,1,1012,186,186,0
"c8e371568a0c4391b25796ae4e91952e","ab11d94c6c8948ea90b88f19d2cd502b",22852816,4,5,0,1013,186,190,4
"ab11d94c6c8948ea90b88f19d2cd502b","07b44a7a51e94c78b411c753fc39dab0",22852816,3,-1,0,1014,190,189,-1
"07b44a7a51e94c78b411c753fc39dab0","6cd2dcaac46847d4a0bc53f296d90375",22852816,4,6,0,1015,189,194,5
"6cd2dcaac46847d4a0bc53f296d90375","017d7ca8e0394b91aaadc9574df2202c",22852816,4,-1,0,1016,194,193,-1
"017d7ca8e0394b91aaadc9574df2202c","d7f13c8d63ec4e2aa673fbb9cf9c6933",22852816,1,17,0,1017,193,206,13
"d7f13c8d63ec4e2aa673fbb9cf9c6933","c8e371568a0c4391b25796ae4e91952e",22852816,4,-26,0,1018,206,186,-20
"c8e371568a0c4391b25796ae4e91952e","7108f0e4c2584f1f9c471689ae4c885c",22852816,2,28,0,1019,186,208,22
"7108f0e4c2584f1f9c471689ae4c885c","b9e80f77c3a44349863b19875725c384",22852816,4,-1,0,1020,208,207,-1
"b9e80f77c3a44349863b19875725c384","d7f13c8d63ec4e2aa673fbb9cf9c6933",22852816,3,-1,0,1021,207,206,-1
"d7f13c8d63ec4e2aa673fbb9cf9c6933","1c6721b1f63f4d30ba7746ea8af02a52",22852816,2,21,0,1022,206,221,15
"1c6721b1f63f4d30ba7746ea8af02a52","d7f13c8d63ec4e2aa673fbb9cf9c6933",22852816,1,-21,0,1023,221,206,-15
"d7f13c8d63ec4e2aa673fbb9cf9c6933","77ecef8eff6b4a2caea7707669bf7475",22852816,1,22,0,1024,206,222,16
"77ecef8eff6b4a2caea7707669bf7475","1c6721b1f63f4d30ba7746ea8af02a52",22852816,3,-1,0,1025,222,221,-1
"1c6721b1f63f4d30ba7746ea8af02a52","8b9ae98743bd4d4a8a87dff1c1244211",22852816,1,7,0,1026,221,227,6
"8b9ae98743bd4d4a8a87dff1c1244211","d03cb855c70044cf8c35d9ec0de696e3",22852816,3,-3,0,1027,227,224,-3
"d03cb855c70044cf8c35d9ec0de696e3","2ab1535aac1346ba8801535bf729ef37",22852816,1,6,0,1028,224,229,5
"2ab1535aac1346ba8801535bf729ef37","f7906d6f59b9489a91d2ef40db5a474d",22852816,2,-7,0,1029,229,223,-6
"f7906d6f59b9489a91d2ef40db5a474d","5152833676bf4c6cb317060be10f68db",22852816,1,6,0,1030,223,228,5
"5152833676bf4c6cb317060be10f68db","0b04c8e2f86d48c7aeb7e225819cd32b",22852816,1,7,0,1031,228,234,6
"0b04c8e2f86d48c7aeb7e225819cd32b","1c6721b1f63f4d30ba7746ea8af02a52",22852816,2,-16,0,1032,234,221,-13
"1c6721b1f63f4d30ba7746ea8af02a52","2ae94c0cea4d480a9d5dca8fb1d7b542",22852816,2,27,0,1033,221,242,21
"2ae94c0cea4d480a9d5dca8fb1d7b542","1ebf23f9d994469a85206e4c7b1bf5f5",22852816,2,3,0,1034,242,245,3
"1ebf23f9d994469a85206e4c7b1bf5f5","fa235f0f364d47e4ae1c87f47bf8e6ba",22852816,1,9,0,1035,245,252,7
"fa235f0f364d47e4ae1c87f47bf8e6ba","2ae94c0cea4d480a9d5dca8fb1d7b542",22852816,1,-12,0,1036,252,242,-10
"2ae94c0cea4d480a9d5dca8fb1d7b542","00f61990949545828dd12f1303d47504",22852816,1,17,0,1037,242,256,14
"00f61990949545828dd12f1303d47504","6e83e23f56544a19b94067c1c558d9c0",22852816,1,-11,0,1038,256,247,-9
"6e83e23f56544a19b94067c1c558d9c0","d546341988904f069cfa86b21457d9d9",22852816,1,5,0,1039,247,251,4
"d546341988904f069cfa86b21457d9d9","d989ebcfc12a4b669f0100dc1aa14f1e",22852816,1,5,0,1040,251,255,4
"d989ebcfc12a4b669f0100dc1aa14f1e","7aa76d3e993840d8805f097cbdbcd44b",22852816,1,7,0,1041,255,261,6
"7aa76d3e993840d8805f097cbdbcd44b","0d987bed3ffa4ed0b9a2e62e97b7b30f",22852816,1,15,0,1042,261,272,11
"0d987bed3ffa4ed0b9a2e62e97b7b30f","2ae94c0cea4d480a9d5dca8fb1d7b542",22852816,1,-38,0,1043,272,242,-30
"0d987bed3ffa4ed0b9a2e62e97b7b30f","bb5a47f5ea01454a8b79455422d3b9da",22852816,1,10,0,1045,272,280,8
"bb5a47f5ea01454a8b79455422d3b9da","bb5a47f5ea01454a8b79455422d3b9da",22852816,60,0,1,1046,280,280,0
"bb5a47f5ea01454a8b79455422d3b9da","82ae07bc0c9b4570a41799290d1ef399",22852816,1,-6,0,1049,280,275,-5
"82ae07bc0c9b4570a41799290d1ef399","bb5a47f5ea01454a8b79455422d3b9da",22852816,1,6,0,1050,275,280,5
"bb5a47f5ea01454a8b79455422d3b9da","94cecc3f1e7d484b8e068e79241dfd73",22852816,1,3,0,1108,280,281,1
"94cecc3f1e7d484b8e068e79241dfd73","0d987bed3ffa4ed0b9a2e62e97b7b30f",22852816,1,-13,0,1109,281,272,-9
"0d987bed3ffa4ed0b9a2e62e97b7b30f","a37477c4e4c14169ad44b06b493007f6",22852816,1,15,0,1110,272,283,11
"a37477c4e4c14169ad44b06b493007f6","94cecc3f1e7d484b8e068e79241dfd73",22852816,1,-2,0,1111,283,281,-2
"94cecc3f1e7d484b8e068e79241dfd73","fab84b4fab5940efb4ea868ef8d09396",22852816,1,5,0,1112,281,284,3
"fab84b4fab5940efb4ea868ef8d09396","fab84b4fab5940efb4ea868ef8d09396",22852816,3,0,1,1113,284,284,0
"fab84b4fab5940efb4ea868ef8d09396","4a29443515bb404cb8924e1c60a63b73",22852816,5,4,0,1114,284,285,1
"4a29443515bb404cb8924e1c60a63b73","208c9b2796c944db8dacaa96082520ea",22852816,13,3,0,1115,285,288,3
"208c9b2796c944db8dacaa96082520ea","fab84b4fab5940efb4ea868ef8d09396",22852816,1,-7,0,1116,288,284,-4
"208c9b2796c944db8dacaa96082520ea","4a29443515bb404cb8924e1c60a63b73",22852816,9,-3,0,1120,288,285,-3
"208c9b2796c944db8dacaa96082520ea","208c9b2796c944db8dacaa96082520ea",22852816,2,0,1,1122,288,288,0
"4a29443515bb404cb8924e1c60a63b73","7669a956527947d0add87455277e80b4",22852816,1,7,0,1124,285,291,6
"7669a956527947d0add87455277e80b4","7669a956527947d0add87455277e80b4",22852816,1,0,1,1125,291,291,0
"7669a956527947d0add87455277e80b4","6a9a3b5bde4a48daa896fe8c06eca56f",22852816,1,-2,0,1126,291,289,-2
"6a9a3b5bde4a48daa896fe8c06eca56f","869e967078f04da18dd0b0b9389a7424",22852816,5,5,0,1127,289,293,4
"869e967078f04da18dd0b0b9389a7424","869e967078f04da18dd0b0b9389a7424",22852816,1,0,1,1128,293,293,0
"869e967078f04da18dd0b0b9389a7424","51ab6291537748fab90d519aa09889d6",22852816,2,2,0,1129,293,295,2
"51ab6291537748fab90d519aa09889d6","51ab6291537748fab90d519aa09889d6",22852816,10,0,1,1130,295,295,0
"51ab6291537748fab90d519aa09889d6","34a6e49023fc4465bd5ca604330bbd1c",22852816,3,-3,0,1135,295,292,-3
"34a6e49023fc4465bd5ca604330bbd1c","21592f2a9e9c4b2f8c66ec5dbcbf6a2b",22852816,3,5,0,1136,292,296,4
"21592f2a9e9c4b2f8c66ec5dbcbf6a2b","ba0e59461bfb4a44b7b1c28a01f8d3b3",22852816,3,4,0,1137,296,299,3
"ba0e59461bfb4a44b7b1c28a01f8d3b3","ba0e59461bfb4a44b7b1c28a01f8d3b3",22852816,3,0,1,1138,299,299,0
"ba0e59461bfb4a44b7b1c28a01f8d3b3","0e0b36e731a645e7b1b8a88f5031ca38",22852816,1,2,0,1141,299,301,2
"0e0b36e731a645e7b1b8a88f5031ca38","0e0b36e731a645e7b1b8a88f5031ca38",22852816,2,0,1,1142,301,301,0
"0e0b36e731a645e7b1b8a88f5031ca38","a66a144637284c21afc6de17fea4bfb8",22852816,1,1,0,1144,301,302,1
"a66a144637284c21afc6de17fea4bfb8","a66a144637284c21afc6de17fea4bfb8",22852816,5,0,1,1145,302,302,0
"a66a144637284c21afc6de17fea4bfb8","7646a919d7e64fa990bca9b024ff089d",22852816,1,-4,0,1150,302,298,-4
"7646a919d7e64fa990bca9b024ff089d","4a29443515bb404cb8924e1c60a63b73",22852816,4,-17,0,1151,298,285,-13
"208c9b2796c944db8dacaa96082520ea","869e967078f04da18dd0b0b9389a7424",22852816,1,7,0,1153,288,293,5
"869e967078f04da18dd0b0b9389a7424","4a29443515bb404cb8924e1c60a63b73",22852816,1,-10,0,1154,293,285,-8
"4a29443515bb404cb8924e1c60a63b73","34a6e49023fc4465bd5ca604330bbd1c",22852816,1,9,0,1155,285,292,7
"34a6e49023fc4465bd5ca604330bbd1c","869e967078f04da18dd0b0b9389a7424",22852816,1,1,0,1156,292,293,1
"869e967078f04da18dd0b0b9389a7424","21592f2a9e9c4b2f8c66ec5dbcbf6a2b",22852816,1,4,0,1157,293,296,3
"21592f2a9e9c4b2f8c66ec5dbcbf6a2b","869e967078f04da18dd0b0b9389a7424",22852816,2,-4,0,1158,296,293,-3
"869e967078f04da18dd0b0b9389a7424","34a6e49023fc4465bd5ca604330bbd1c",22852816,4,-1,0,1159,293,292,-1
"34a6e49023fc4465bd5ca604330bbd1c","ba0e59461bfb4a44b7b1c28a01f8d3b3",22852816,4,9,0,1160,292,299,7
"ba0e59461bfb4a44b7b1c28a01f8d3b3","21592f2a9e9c4b2f8c66ec5dbcbf6a2b",22852816,4,-4,0,1161,299,296,-3
"869e967078f04da18dd0b0b9389a7424","7646a919d7e64fa990bca9b024ff089d",22852816,1,7,0,1163,293,298,5
"7646a919d7e64fa990bca9b024ff089d","51ab6291537748fab90d519aa09889d6",22852816,1,-5,0,1164,298,295,-3
"21592f2a9e9c4b2f8c66ec5dbcbf6a2b","7646a919d7e64fa990bca9b024ff089d",22852816,2,3,0,1168,296,298,2
"7646a919d7e64fa990bca9b024ff089d","e390b575229748ea8aac9364efe2bf00",22852816,1,7,0,1169,298,304,6
"e390b575229748ea8aac9364efe2bf00","e390b575229748ea8aac9364efe2bf00",22852816,1,0,1,1170,304,304,0
"e390b575229748ea8aac9364efe2bf00","3434c10e561d488a914e0f7d71907abd",22852816,1,3,0,1171,304,305,1
"3434c10e561d488a914e0f7d71907abd","4a29443515bb404cb8924e1c60a63b73",22852816,4,-27,0,1172,305,285,-20
"4a29443515bb404cb8924e1c60a63b73","53e7e900392747ccad52e711ab0f80d8",22852816,3,29,0,1173,285,307,22
"53e7e900392747ccad52e711ab0f80d8","53e7e900392747ccad52e711ab0f80d8",22852816,1,0,1,1174,307,307,0
"53e7e900392747ccad52e711ab0f80d8","3434c10e561d488a914e0f7d71907abd",22852816,6,-2,0,1175,307,305,-2
"3434c10e561d488a914e0f7d71907abd","130acc2aeb0448fdbb2de63bc5cebe5b",22852816,2,5,0,1176,305,309,4
"130acc2aeb0448fdbb2de63bc5cebe5b","130acc2aeb0448fdbb2de63bc5cebe5b",22852816,1,0,1,1177,309,309,0
"130acc2aeb0448fdbb2de63bc5cebe5b","9c062b3251034ebe90f5054e2a3b5120",22852816,1,2,0,1178,309,311,2
"9c062b3251034ebe90f5054e2a3b5120","9c062b3251034ebe90f5054e2a3b5120",22852816,2,0,1,1179,311,311,0
"9c062b3251034ebe90f5054e2a3b5120","ea859f8207e44537889daeaba13ac2e8",22852816,1,1,0,1181,311,312,1
"ea859f8207e44537889daeaba13ac2e8","ea859f8207e44537889daeaba13ac2e8",22852816,4,0,1,1182,312,312,0
"ea859f8207e44537889daeaba13ac2e8","56d94971a7a94257aa330183a8ebd0ea",22852816,1,1,0,1186,312,313,1
"56d94971a7a94257aa330183a8ebd0ea","56d94971a7a94257aa330183a8ebd0ea",22852816,1,0,1,1187,313,313,0
"56d94971a7a94257aa330183a8ebd0ea","141c0df6cd1946539aadd1c9b7068cd4",22852816,1,-5,0,1188,313,308,-5
"141c0df6cd1946539aadd1c9b7068cd4","13255e63e0aa4abf85e5211bf613d43e",22852816,1,10,0,1189,308,317,9
"13255e63e0aa4abf85e5211bf613d43e","13255e63e0aa4abf85e5211bf613d43e",22852816,1,0,1,1190,317,317,0
"13255e63e0aa4abf85e5211bf613d43e","86c27d40179e419c8e9d150fb6afa5d0",22852816,1,3,0,1191,317,319,2
"86c27d40179e419c8e9d150fb6afa5d0","0c787d16c9504873b1a4d903cec09948",22852816,3,-6,0,1192,319,314,-5
"0c787d16c9504873b1a4d903cec09948","86c27d40179e419c8e9d150fb6afa5d0",22852816,1,6,0,1193,314,319,5
"86c27d40179e419c8e9d150fb6afa5d0","8d7e0b55cf9849cda222a0f2440cec55",22852816,2,-1,0,1194,319,318,-1
"8d7e0b55cf9849cda222a0f2440cec55","47edbb64109243e6b0f8f64cdef90c6c",22852816,2,9,0,1195,318,326,8
"47edbb64109243e6b0f8f64cdef90c6c","24f1363179ad4aaa965484a78471912b",22852816,4,-3,0,1196,326,323,-3
"24f1363179ad4aaa965484a78471912b","24f1363179ad4aaa965484a78471912b",22852816,2,0,1,1197,323,323,0
"24f1363179ad4aaa965484a78471912b","3628bdce1dd2429ba924d2d4d09448d2",22852816,2,-1,0,1199,323,322,-1
"3628bdce1dd2429ba924d2d4d09448d2","56b3fd1a212a4764be39d979fde3326e",22852816,1,7,0,1200,322,328,6
"56b3fd1a212a4764be39d979fde3326e","56b3fd1a212a4764be39d979fde3326e",22852816,1,0,1,1201,328,328,0
"56b3fd1a212a4764be39d979fde3326e","0c4079457ede49e3aeb5e86ed84bdf35",22852816,1,3,0,1202,328,329,1
"0c4079457ede49e3aeb5e86ed84bdf35","3434c10e561d488a914e0f7d71907abd",22852816,5,-31,0,1203,329,305,-24
"3434c10e561d488a914e0f7d71907abd","38aea304b4fa46e1b29bb72f5cea4c93",22852816,3,33,0,1204,305,331,26
"38aea304b4fa46e1b29bb72f5cea4c93","4a29443515bb404cb8924e1c60a63b73",22852816,1,-60,0,1205,331,285,-46
"4a29443515bb404cb8924e1c60a63b73","869e967078f04da18dd0b0b9389a7424",22852816,3,10,0,1209,285,293,8
"869e967078f04da18dd0b0b9389a7424","6a9a3b5bde4a48daa896fe8c06eca56f",22852816,3,-5,0,1210,293,289,-4
"4a29443515bb404cb8924e1c60a63b73","3434c10e561d488a914e0f7d71907abd",22852816,5,27,0,1223,285,305,20
"3434c10e561d488a914e0f7d71907abd","53e7e900392747ccad52e711ab0f80d8",22852816,5,2,0,1224,305,307,2
"3434c10e561d488a914e0f7d71907abd","24f1363179ad4aaa965484a78471912b",22852816,1,22,0,1226,305,323,18
"24f1363179ad4aaa965484a78471912b","47edbb64109243e6b0f8f64cdef90c6c",22852816,1,3,0,1227,323,326,3
"3628bdce1dd2429ba924d2d4d09448d2","3434c10e561d488a914e0f7d71907abd",22852816,5,-21,0,1230,322,305,-17
"3434c10e561d488a914e0f7d71907abd","0c4079457ede49e3aeb5e86ed84bdf35",22852816,6,31,0,1231,305,329,24
"0c4079457ede49e3aeb5e86ed84bdf35","38aea304b4fa46e1b29bb72f5cea4c93",22852816,5,2,0,1232,329,331,2
"38aea304b4fa46e1b29bb72f5cea4c93","38aea304b4fa46e1b29bb72f5cea4c93",22852816,6,0,1,1233,331,331,0
"38aea304b4fa46e1b29bb72f5cea4c93","e36d261332f14e79bb4b467aceaeb9b5",22852816,1,2,0,1239,331,333,2
"e36d261332f14e79bb4b467aceaeb9b5","e36d261332f14e79bb4b467aceaeb9b5",22852816,1,0,1,1240,333,333,0
"e36d261332f14e79bb4b467aceaeb9b5","c7e89b9d04744d2eab742fc24e3ef1ae",22852816,1,1,0,1241,333,334,1
"c7e89b9d04744d2eab742fc24e3ef1ae","c7e89b9d04744d2eab742fc24e3ef1ae",22852816,2,0,1,1242,334,334,0
"c7e89b9d04744d2eab742fc24e3ef1ae","fe49f8054b374a0ea4bb266ed135ff62",22852816,1,1,0,1244,334,335,1
"fe49f8054b374a0ea4bb266ed135ff62","fe49f8054b374a0ea4bb266ed135ff62",22852816,2,0,1,1245,335,335,0
"fe49f8054b374a0ea4bb266ed135ff62","d0a8f74af98642fe8360d22c42e45117",22852816,1,1,0,1247,335,336,1
"d0a8f74af98642fe8360d22c42e45117","d0a8f74af98642fe8360d22c42e45117",22852816,2,0,1,1248,336,336,0
"d0a8f74af98642fe8360d22c42e45117","0c4079457ede49e3aeb5e86ed84bdf35",22852816,1,-7,0,1250,336,329,-7
"0c4079457ede49e3aeb5e86ed84bdf35","a7c6339ca1da4368a18d471f0519f877",22852816,1,11,0,1251,329,339,10
"a7c6339ca1da4368a18d471f0519f877","a7c6339ca1da4368a18d471f0519f877",22852816,1,0,1,1252,339,339,0
"a7c6339ca1da4368a18d471f0519f877","b8b9418ab322418d9db9b40d96af873a",22852816,1,-2,0,1253,339,337,-2
"b8b9418ab322418d9db9b40d96af873a","bbc5139ca9024389a94db3a6f47dcff6",22852816,2,5,0,1254,337,341,4
"bbc5139ca9024389a94db3a6f47dcff6","bbc5139ca9024389a94db3a6f47dcff6",22852816,4,0,1,1255,341,341,0
"bbc5139ca9024389a94db3a6f47dcff6","4ee6ca9019ab4a1ab323f98094a9bd77",22852816,1,2,0,1259,341,343,2
"4ee6ca9019ab4a1ab323f98094a9bd77","4ee6ca9019ab4a1ab323f98094a9bd77",22852816,2,0,1,1260,343,343,0
"4ee6ca9019ab4a1ab323f98094a9bd77","b37947176785476f8b29d49a851366dc",22852816,1,1,0,1262,343,344,1
"b37947176785476f8b29d49a851366dc","b37947176785476f8b29d49a851366dc",22852816,2,0,1,1263,344,344,0
"b37947176785476f8b29d49a851366dc","fcea5b10d5a14a3b9324ffece8f6e1e5",22852816,1,1,0,1265,344,345,1
"fcea5b10d5a14a3b9324ffece8f6e1e5","fcea5b10d5a14a3b9324ffece8f6e1e5",22852816,5,0,1,1266,345,345,0
"fcea5b10d5a14a3b9324ffece8f6e1e5","c2490bc612d146edbe786556fab3651b",22852816,1,-5,0,1271,345,340,-5
"c2490bc612d146edbe786556fab3651b","0c4079457ede49e3aeb5e86ed84bdf35",22852816,1,-13,0,1272,340,329,-11
"38aea304b4fa46e1b29bb72f5cea4c93","0c4079457ede49e3aeb5e86ed84bdf35",22852816,5,-2,0,1274,331,329,-2
"0c4079457ede49e3aeb5e86ed84bdf35","bbc5139ca9024389a94db3a6f47dcff6",22852816,1,14,0,1275,329,341,12
"bbc5139ca9024389a94db3a6f47dcff6","b8b9418ab322418d9db9b40d96af873a",22852816,1,-5,0,1276,341,337,-4
"b8b9418ab322418d9db9b40d96af873a","c2490bc612d146edbe786556fab3651b",22852816,1,4,0,1277,337,340,3
"c2490bc612d146edbe786556fab3651b","6ac8bb048b854999a47edb35fe627f11",22852816,1,8,0,1278,340,347,7
"6ac8bb048b854999a47edb35fe627f11","6ac8bb048b854999a47edb35fe627f11",22852816,1,0,1,1279,347,347,0
"6ac8bb048b854999a47edb35fe627f11","0c4079457ede49e3aeb5e86ed84bdf35",22852816,1,-21,0,1280,347,329,-18
"0c4079457ede49e3aeb5e86ed84bdf35","30ead9794d4847abaf222ca966cc8630",22852816,3,24,0,1281,329,348,19
"30ead9794d4847abaf222ca966cc8630","09b9678ddc3d452ea4a3d46e15826065",22852816,2,5,0,1282,348,353,5
"09b9678ddc3d452ea4a3d46e15826065","897b7f51242c44aab2205c72fdcbf4cd",22852816,5,-1,0,1283,353,352,-1
"897b7f51242c44aab2205c72fdcbf4cd","c20993c944444fe085345591a8bd837e",22852816,3,-1,0,1284,352,351,-1
"c20993c944444fe085345591a8bd837e","eff0de7f2dbb42dfa1a2e686efab5b6d",22852816,2,3,0,1285,351,354,3
"eff0de7f2dbb42dfa1a2e686efab5b6d","c20993c944444fe085345591a8bd837e",22852816,6,-3,0,1286,354,351,-3
"c20993c944444fe085345591a8bd837e","c20993c944444fe085345591a8bd837e",22852816,5,0,1,1287,351,351,0
"c20993c944444fe085345591a8bd837e","897b7f51242c44aab2205c72fdcbf4cd",22852816,5,1,0,1290,351,352,1
"897b7f51242c44aab2205c72fdcbf4cd","897b7f51242c44aab2205c72fdcbf4cd",22852816,7,0,1,1291,352,352,0
"897b7f51242c44aab2205c72fdcbf4cd","09b9678ddc3d452ea4a3d46e15826065",22852816,3,1,0,1294,352,353,1
"09b9678ddc3d452ea4a3d46e15826065","09b9678ddc3d452ea4a3d46e15826065",22852816,6,0,1,1295,353,353,0
"09b9678ddc3d452ea4a3d46e15826065","eff0de7f2dbb42dfa1a2e686efab5b6d",22852816,5,1,0,1298,353,354,1
"eff0de7f2dbb42dfa1a2e686efab5b6d","eff0de7f2dbb42dfa1a2e686efab5b6d",22852816,8,0,1,1299,354,354,0
"eff0de7f2dbb42dfa1a2e686efab5b6d","30ead9794d4847abaf222ca966cc8630",22852816,2,-6,0,1302,354,348,-6
"30ead9794d4847abaf222ca966cc8630","2fe14166dc9642c3bc666b86a57f943d",22852816,3,10,0,1303,348,357,9
"2fe14166dc9642c3bc666b86a57f943d","2fe14166dc9642c3bc666b86a57f943d",22852816,3,0,1,1304,357,357,0
"2fe14166dc9642c3bc666b86a57f943d","44421dd1e13a47a388c4a19834b744c7",22852816,1,2,0,1306,357,359,2
"44421dd1e13a47a388c4a19834b744c7","44421dd1e13a47a388c4a19834b744c7",22852816,2,0,1,1307,359,359,0
"44421dd1e13a47a388c4a19834b744c7","cb5fc7ef85d547c4be1a7439d0bf6052",22852816,1,1,0,1309,359,360,1
"cb5fc7ef85d547c4be1a7439d0bf6052","cb5fc7ef85d547c4be1a7439d0bf6052",22852816,2,0,1,1310,360,360,0
"cb5fc7ef85d547c4be1a7439d0bf6052","0a8f150a4cf747acbde62f4721823da3",22852816,1,1,0,1312,360,361,1
"0a8f150a4cf747acbde62f4721823da3","0a8f150a4cf747acbde62f4721823da3",22852816,2,0,1,1313,361,361,0
"0a8f150a4cf747acbde62f4721823da3","ab8fdad974ae471f9f24c3f9dd04462e",22852816,1,1,0,1315,361,362,1
"ab8fdad974ae471f9f24c3f9dd04462e","ab8fdad974ae471f9f24c3f9dd04462e",22852816,2,0,1,1316,362,362,0
"ab8fdad974ae471f9f24c3f9dd04462e","1ba8fef685d74a8194b9db252eb704fb",22852816,1,-7,0,1318,362,355,-7
"1ba8fef685d74a8194b9db252eb704fb","52580888dadb4fe3baa795683ea227bd",22852816,3,10,0,1319,355,364,9
"52580888dadb4fe3baa795683ea227bd","52580888dadb4fe3baa795683ea227bd",22852816,3,0,1,1320,364,364,0
"52580888dadb4fe3baa795683ea227bd","f00179e251a045b39c3f7a54f9aa4acc",22852816,2,-1,0,1323,364,363,-1
"f00179e251a045b39c3f7a54f9aa4acc","492a3bc6a1254f23a7998587961b22a4",22852816,2,4,0,1324,363,366,3
"492a3bc6a1254f23a7998587961b22a4","492a3bc6a1254f23a7998587961b22a4",22852816,2,0,1,1325,366,366,0
"492a3bc6a1254f23a7998587961b22a4","072a190fd302456290895f9f04d6940a",22852816,2,-1,0,1326,366,365,-1
"072a190fd302456290895f9f04d6940a","b71bac264efb4abd97015447bd490db6",22852816,1,8,0,1327,365,370,5
"b71bac264efb4abd97015447bd490db6","30ead9794d4847abaf222ca966cc8630",22852816,5,-28,0,1328,370,348,-22
"30ead9794d4847abaf222ca966cc8630","b71bac264efb4abd97015447bd490db6",22852816,6,28,0,1329,348,370,22
"30ead9794d4847abaf222ca966cc8630","4a29443515bb404cb8924e1c60a63b73",22852816,1,-82,0,1333,348,285,-63
"6a9a3b5bde4a48daa896fe8c06eca56f","34a6e49023fc4465bd5ca604330bbd1c",22852816,1,4,0,1338,289,292,3
"21592f2a9e9c4b2f8c66ec5dbcbf6a2b","3434c10e561d488a914e0f7d71907abd",22852816,1,13,0,1341,296,305,9
"3434c10e561d488a914e0f7d71907abd","7646a919d7e64fa990bca9b024ff089d",22852816,1,-10,0,1342,305,298,-7
"30ead9794d4847abaf222ca966cc8630","0c4079457ede49e3aeb5e86ed84bdf35",22852816,2,-24,0,1353,348,329,-19
"0c4079457ede49e3aeb5e86ed84bdf35","09b9678ddc3d452ea4a3d46e15826065",22852816,2,29,0,1354,329,353,24
"09b9678ddc3d452ea4a3d46e15826065","c20993c944444fe085345591a8bd837e",22852816,2,-2,0,1356,353,351,-2
"897b7f51242c44aab2205c72fdcbf4cd","eff0de7f2dbb42dfa1a2e686efab5b6d",22852816,5,2,0,1360,352,354,2
"09b9678ddc3d452ea4a3d46e15826065","30ead9794d4847abaf222ca966cc8630",22852816,1,-5,0,1366,353,348,-5
"2fe14166dc9642c3bc666b86a57f943d","1ba8fef685d74a8194b9db252eb704fb",22852816,2,-2,0,1368,357,355,-2
"072a190fd302456290895f9f04d6940a","c20993c944444fe085345591a8bd837e",22852816,1,-17,0,1374,365,351,-14
"c20993c944444fe085345591a8bd837e","09b9678ddc3d452ea4a3d46e15826065",22852816,5,2,0,1379,351,353,2
"eff0de7f2dbb42dfa1a2e686efab5b6d","897b7f51242c44aab2205c72fdcbf4cd",22852816,3,-2,0,1381,354,352,-2
"897b7f51242c44aab2205c72fdcbf4cd","c76574d21bc14aeea7ecd0b027f39858",22852816,1,19,0,1382,352,367,15
"c76574d21bc14aeea7ecd0b027f39858","09b9678ddc3d452ea4a3d46e15826065",22852816,1,-18,0,1383,367,353,-14
"52580888dadb4fe3baa795683ea227bd","492a3bc6a1254f23a7998587961b22a4",22852816,1,3,0,1392,364,366,2
"492a3bc6a1254f23a7998587961b22a4","f00179e251a045b39c3f7a54f9aa4acc",22852816,1,-4,0,1393,366,363,-3
"f00179e251a045b39c3f7a54f9aa4acc","072a190fd302456290895f9f04d6940a",22852816,1,3,0,1394,363,365,2
"072a190fd302456290895f9f04d6940a","cfa457d1743848e4bb5e4beced6448ed",22852816,1,5,0,1395,365,369,4
"cfa457d1743848e4bb5e4beced6448ed","cfa457d1743848e4bb5e4beced6448ed",22852816,1,0,1,1396,369,369,0
"cfa457d1743848e4bb5e4beced6448ed","30ead9794d4847abaf222ca966cc8630",22852816,1,-25,0,1397,369,348,-21
"b71bac264efb4abd97015447bd490db6","b71bac264efb4abd97015447bd490db6",22852816,1,0,1,1399,370,370,0
"30ead9794d4847abaf222ca966cc8630","492a3bc6a1254f23a7998587961b22a4",22852816,1,21,0,1401,348,366,18
"492a3bc6a1254f23a7998587961b22a4","c76574d21bc14aeea7ecd0b027f39858",22852816,1,2,0,1402,366,367,1
"c76574d21bc14aeea7ecd0b027f39858","072a190fd302456290895f9f04d6940a",22852816,1,-3,0,1403,367,365,-2
"072a190fd302456290895f9f04d6940a","52580888dadb4fe3baa795683ea227bd",22852816,1,-2,0,1404,365,364,-1
"52580888dadb4fe3baa795683ea227bd","2fe14166dc9642c3bc666b86a57f943d",22852816,1,-8,0,1405,364,357,-7
"2fe14166dc9642c3bc666b86a57f943d","f00179e251a045b39c3f7a54f9aa4acc",22852816,1,7,0,1406,357,363,6
"f00179e251a045b39c3f7a54f9aa4acc","c20993c944444fe085345591a8bd837e",22852816,1,-14,0,1407,363,351,-12
"c20993c944444fe085345591a8bd837e","1ba8fef685d74a8194b9db252eb704fb",22852816,1,5,0,1408,351,355,4
"1ba8fef685d74a8194b9db252eb704fb","c20993c944444fe085345591a8bd837e",22852816,1,-5,0,1409,355,351,-4
"eff0de7f2dbb42dfa1a2e686efab5b6d","09b9678ddc3d452ea4a3d46e15826065",22852816,1,-1,0,1418,354,353,-1
"09b9678ddc3d452ea4a3d46e15826065","0c4079457ede49e3aeb5e86ed84bdf35",22852816,1,-29,0,1419,353,329,-24
"0c4079457ede49e3aeb5e86ed84bdf35","c20993c944444fe085345591a8bd837e",22852816,1,27,0,1420,329,351,22
"c20993c944444fe085345591a8bd837e","30ead9794d4847abaf222ca966cc8630",22852816,2,-3,0,1421,351,348,-3
"30ead9794d4847abaf222ca966cc8630","bbc5139ca9024389a94db3a6f47dcff6",22852816,1,-10,0,1422,348,341,-7
"bbc5139ca9024389a94db3a6f47dcff6","4a92daef4d504e1792575a26502bb7b7",22852816,1,6,0,1423,341,346,5
"4a92daef4d504e1792575a26502bb7b7","c2490bc612d146edbe786556fab3651b",22852816,1,-7,0,1424,346,340,-6
"c2490bc612d146edbe786556fab3651b","38aea304b4fa46e1b29bb72f5cea4c93",22852816,1,-11,0,1425,340,331,-9
"38aea304b4fa46e1b29bb72f5cea4c93","b8b9418ab322418d9db9b40d96af873a",22852816,1,7,0,1426,331,337,6
"b8b9418ab322418d9db9b40d96af873a","0c4079457ede49e3aeb5e86ed84bdf35",22852816,1,-9,0,1427,337,329,-8
"53e7e900392747ccad52e711ab0f80d8","43ea1b823a4b4e51b7c694c10725db82",22852816,1,25,0,1430,307,327,20
"43ea1b823a4b4e51b7c694c10725db82","3434c10e561d488a914e0f7d71907abd",22852816,1,-27,0,1431,327,305,-22
"3434c10e561d488a914e0f7d71907abd","86c27d40179e419c8e9d150fb6afa5d0",22852816,2,17,0,1432,305,319,14
"8d7e0b55cf9849cda222a0f2440cec55","24f1363179ad4aaa965484a78471912b",22852816,1,6,0,1434,318,323,5
"24f1363179ad4aaa965484a78471912b","0c787d16c9504873b1a4d903cec09948",22852816,1,-11,0,1435,323,314,-9
"0c787d16c9504873b1a4d903cec09948","47edbb64109243e6b0f8f64cdef90c6c",22852816,3,14,0,1436,314,326,12
"47edbb64109243e6b0f8f64cdef90c6c","53e7e900392747ccad52e711ab0f80d8",22852816,1,-23,0,1437,326,307,-19
"53e7e900392747ccad52e711ab0f80d8","3628bdce1dd2429ba924d2d4d09448d2",22852816,1,19,0,1438,307,322,15
"208c9b2796c944db8dacaa96082520ea","2c5bb2cbd0014420ad8c95d40e38efd1",22852816,2,20,0,1442,288,303,15
"2c5bb2cbd0014420ad8c95d40e38efd1","4a29443515bb404cb8924e1c60a63b73",22852816,1,-23,0,1443,303,285,-18
"4a29443515bb404cb8924e1c60a63b73","fab84b4fab5940efb4ea868ef8d09396",22852816,2,-4,0,1444,285,284,-1
"4a29443515bb404cb8924e1c60a63b73","4a29443515bb404cb8924e1c60a63b73",22852816,3,0,1,1449,285,285,0
"86c27d40179e419c8e9d150fb6afa5d0","24f1363179ad4aaa965484a78471912b",22852816,1,5,0,1455,319,323,4
"24f1363179ad4aaa965484a78471912b","8d7e0b55cf9849cda222a0f2440cec55",22852816,3,-6,0,1456,323,318,-5
"47edbb64109243e6b0f8f64cdef90c6c","3628bdce1dd2429ba924d2d4d09448d2",22852816,1,-4,0,1458,326,322,-4
"3434c10e561d488a914e0f7d71907abd","43ea1b823a4b4e51b7c694c10725db82",22852816,1,27,0,1464,305,327,22
"43ea1b823a4b4e51b7c694c10725db82","130acc2aeb0448fdbb2de63bc5cebe5b",22852816,1,-22,0,1465,327,309,-18
"130acc2aeb0448fdbb2de63bc5cebe5b","141c0df6cd1946539aadd1c9b7068cd4",22852816,2,-1,0,1466,309,308,-1
"141c0df6cd1946539aadd1c9b7068cd4","0c787d16c9504873b1a4d903cec09948",22852816,1,7,0,1467,308,314,6
"0c787d16c9504873b1a4d903cec09948","24f1363179ad4aaa965484a78471912b",22852816,1,11,0,1468,314,323,9
"24f1363179ad4aaa965484a78471912b","43ea1b823a4b4e51b7c694c10725db82",22852816,1,5,0,1469,323,327,4
"43ea1b823a4b4e51b7c694c10725db82","47edbb64109243e6b0f8f64cdef90c6c",22852816,1,-2,0,1470,327,326,-1
"47edbb64109243e6b0f8f64cdef90c6c","86c27d40179e419c8e9d150fb6afa5d0",22852816,1,-8,0,1471,326,319,-7
"86c27d40179e419c8e9d150fb6afa5d0","3628bdce1dd2429ba924d2d4d09448d2",22852816,1,4,0,1472,319,322,3
"3628bdce1dd2429ba924d2d4d09448d2","8d7e0b55cf9849cda222a0f2440cec55",22852816,1,-5,0,1473,322,318,-4
"8d7e0b55cf9849cda222a0f2440cec55","0c787d16c9504873b1a4d903cec09948",22852816,1,-5,0,1474,318,314,-4
"0c787d16c9504873b1a4d903cec09948","130acc2aeb0448fdbb2de63bc5cebe5b",22852816,1,-6,0,1475,314,309,-5
"130acc2aeb0448fdbb2de63bc5cebe5b","3434c10e561d488a914e0f7d71907abd",22852816,2,-5,0,1476,309,305,-4
"3434c10e561d488a914e0f7d71907abd","141c0df6cd1946539aadd1c9b7068cd4",22852816,2,4,0,1477,305,308,3
"141c0df6cd1946539aadd1c9b7068cd4","53e7e900392747ccad52e711ab0f80d8",22852816,1,-2,0,1478,308,307,-1
"53e7e900392747ccad52e711ab0f80d8","4a29443515bb404cb8924e1c60a63b73",22852816,1,-29,0,1479,307,285,-22
"2c5bb2cbd0014420ad8c95d40e38efd1","fab84b4fab5940efb4ea868ef8d09396",22852816,1,-27,0,1482,303,284,-19
"ba0e59461bfb4a44b7b1c28a01f8d3b3","4a29443515bb404cb8924e1c60a63b73",22852816,1,-18,0,1494,299,285,-14
"53e7e900392747ccad52e711ab0f80d8","130acc2aeb0448fdbb2de63bc5cebe5b",22852816,1,3,0,1500,307,309,2
"141c0df6cd1946539aadd1c9b7068cd4","86c27d40179e419c8e9d150fb6afa5d0",22852816,2,13,0,1503,308,319,11
"8d7e0b55cf9849cda222a0f2440cec55","3628bdce1dd2429ba924d2d4d09448d2",22852816,2,5,0,1508,318,322,4
"0c4079457ede49e3aeb5e86ed84bdf35","b8b9418ab322418d9db9b40d96af873a",22852816,1,9,0,1513,329,337,8
"bbc5139ca9024389a94db3a6f47dcff6","c2490bc612d146edbe786556fab3651b",22852816,1,-1,0,1515,341,340,-1
"c2490bc612d146edbe786556fab3651b","30ead9794d4847abaf222ca966cc8630",22852816,1,11,0,1516,340,348,8
"897b7f51242c44aab2205c72fdcbf4cd","2fe14166dc9642c3bc666b86a57f943d",22852816,1,6,0,1530,352,357,5
"2fe14166dc9642c3bc666b86a57f943d","30ead9794d4847abaf222ca966cc8630",22852816,1,-10,0,1531,357,348,-9
"30ead9794d4847abaf222ca966cc8630","1ba8fef685d74a8194b9db252eb704fb",22852816,1,8,0,1532,348,355,7
"1ba8fef685d74a8194b9db252eb704fb","30ead9794d4847abaf222ca966cc8630",22852816,1,-8,0,1533,355,348,-7
"b71bac264efb4abd97015447bd490db6","8d448d625b024c82a5eb240bbd7431d6",22852816,3,5,0,1535,370,374,4
"8d448d625b024c82a5eb240bbd7431d6","8d448d625b024c82a5eb240bbd7431d6",22852816,57,0,1,1536,374,374,0
"8d448d625b024c82a5eb240bbd7431d6","b71bac264efb4abd97015447bd490db6",22852816,1,-5,0,1537,374,370,-4
"8d448d625b024c82a5eb240bbd7431d6","4a29443515bb404cb8924e1c60a63b73",22852816,1,-115,0,1555,374,285,-89
"4a29443515bb404cb8924e1c60a63b73","6a9a3b5bde4a48daa896fe8c06eca56f",22852816,2,5,0,1558,285,289,4
"34a6e49023fc4465bd5ca604330bbd1c","3434c10e561d488a914e0f7d71907abd",22852816,1,18,0,1561,292,305,13
"3434c10e561d488a914e0f7d71907abd","3434c10e561d488a914e0f7d71907abd",22852816,1,0,1,1565,305,305,0
"0c4079457ede49e3aeb5e86ed84bdf35","0c4079457ede49e3aeb5e86ed84bdf35",22852816,1,0,1,1569,329,329,0
"8d448d625b024c82a5eb240bbd7431d6","d6d02b6ef04e4f17805504500b8ce441",22852816,1,3,0,1628,374,375,1
"d6d02b6ef04e4f17805504500b8ce441","b71bac264efb4abd97015447bd490db6",22852816,1,-8,0,1629,375,370,-5
"b71bac264efb4abd97015447bd490db6","d6d02b6ef04e4f17805504500b8ce441",22852816,1,8,0,1630,370,375,5
"d6d02b6ef04e4f17805504500b8ce441","66baf19b6b904b70922329068c63746d",22852816,1,4,0,1631,375,376,1
"66baf19b6b904b70922329068c63746d","7f544639412e40a9ba27f43b415362ab",22852816,4,2,0,1632,376,378,2
"7f544639412e40a9ba27f43b415362ab","7f544639412e40a9ba27f43b415362ab",22852816,1,0,1,1633,378,378,0
"7f544639412e40a9ba27f43b415362ab","d5ae8642e15b46b8bd298b02274d4e9c",22852816,1,2,0,1634,378,380,2
"d5ae8642e15b46b8bd298b02274d4e9c","d5ae8642e15b46b8bd298b02274d4e9c",22852816,1,0,1,1635,380,380,0
"d5ae8642e15b46b8bd298b02274d4e9c","a0d10309a2dd456289147f84be9d37f9",22852816,1,1,0,1636,380,381,1
"a0d10309a2dd456289147f84be9d37f9","a0d10309a2dd456289147f84be9d37f9",22852816,2,0,1,1637,381,381,0
"a0d10309a2dd456289147f84be9d37f9","0fcbc3ca07b144138b8d85da581f09a8",22852816,1,1,0,1639,381,382,1
"0fcbc3ca07b144138b8d85da581f09a8","0fcbc3ca07b144138b8d85da581f09a8",22852816,2,0,1,1640,382,382,0
"0fcbc3ca07b144138b8d85da581f09a8","66baf19b6b904b70922329068c63746d",22852816,1,-6,0,1642,382,376,-6
"66baf19b6b904b70922329068c63746d","4890121ce5d74576b4632b77cfc23398",22852816,1,14,0,1643,376,388,12
"4890121ce5d74576b4632b77cfc23398","c2fca3669923477ab966ded303dea31c",22852816,1,-6,0,1644,388,383,-5
"c2fca3669923477ab966ded303dea31c","4890121ce5d74576b4632b77cfc23398",22852816,1,6,0,1645,383,388,5
"4890121ce5d74576b4632b77cfc23398","18d3b836dd804224883cc9180b60a8e1",22852816,1,-1,0,1646,388,387,-1
"18d3b836dd804224883cc9180b60a8e1","96bb2b3e85a34d8b9544514e89f6fe97",22852816,1,4,0,1647,387,390,3
"96bb2b3e85a34d8b9544514e89f6fe97","96bb2b3e85a34d8b9544514e89f6fe97",22852816,1,0,1,1648,390,390,0
"96bb2b3e85a34d8b9544514e89f6fe97","ac4e9b54acfe4670b4634859c7263cb5",22852816,1,2,0,1649,390,392,2
"ac4e9b54acfe4670b4634859c7263cb5","ac4e9b54acfe4670b4634859c7263cb5",22852816,1,0,1,1650,392,392,0
"ac4e9b54acfe4670b4634859c7263cb5","17f95d18bab743888e1736033dc3384d",22852816,1,-3,0,1651,392,389,-3
"17f95d18bab743888e1736033dc3384d","6f8881a745ac4c358a68b92c3b4abe81",22852816,2,6,0,1652,389,394,5
"6f8881a745ac4c358a68b92c3b4abe81","6f8881a745ac4c358a68b92c3b4abe81",22852816,1,0,1,1653,394,394,0
"6f8881a745ac4c358a68b92c3b4abe81","f7002c8484354eceac57bc7bd62c76c1",22852816,2,-1,0,1654,394,393,-1
"f7002c8484354eceac57bc7bd62c76c1","66baf19b6b904b70922329068c63746d",22852816,1,-21,0,1655,393,376,-17
"7f544639412e40a9ba27f43b415362ab","66baf19b6b904b70922329068c63746d",22852816,3,-2,0,1657,378,376,-2
"66baf19b6b904b70922329068c63746d","44a277ea44dc4ae689fab4b82f0b4098",22852816,1,26,0,1658,376,397,21
"44a277ea44dc4ae689fab4b82f0b4098","44a277ea44dc4ae689fab4b82f0b4098",22852816,1,0,1,1659,397,397,0
"44a277ea44dc4ae689fab4b82f0b4098","0c12af0a4e7f4002852cf84b2537c161",22852816,1,-2,0,1660,397,395,-2
"0c12af0a4e7f4002852cf84b2537c161","df8191ec5e584c838a899c378941a566",22852816,2,4,0,1661,395,398,3
"df8191ec5e584c838a899c378941a566","0c12af0a4e7f4002852cf84b2537c161",22852816,1,-4,0,1662,398,395,-3
"df8191ec5e584c838a899c378941a566","7f544639412e40a9ba27f43b415362ab",22852816,1,-26,0,1664,398,378,-20
"66baf19b6b904b70922329068c63746d","96bb2b3e85a34d8b9544514e89f6fe97",22852816,1,17,0,1666,376,390,14
"96bb2b3e85a34d8b9544514e89f6fe97","df8191ec5e584c838a899c378941a566",22852816,1,11,0,1667,390,398,8
"df8191ec5e584c838a899c378941a566","17f95d18bab743888e1736033dc3384d",22852816,1,-12,0,1668,398,389,-9
"17f95d18bab743888e1736033dc3384d","66baf19b6b904b70922329068c63746d",22852816,1,-16,0,1669,389,376,-13
"66baf19b6b904b70922329068c63746d","859e0b8d71694b12befb69ee698138f9",22852816,1,29,0,1672,376,399,23
"859e0b8d71694b12befb69ee698138f9","859e0b8d71694b12befb69ee698138f9",22852816,1,0,1,1673,399,399,0
"859e0b8d71694b12befb69ee698138f9","66baf19b6b904b70922329068c63746d",22852816,1,-29,0,1674,399,376,-23
"66baf19b6b904b70922329068c63746d","2b09a08242b54983aec7063990fb3f66",22852816,2,32,0,1675,376,400,24
"2b09a08242b54983aec7063990fb3f66","2b09a08242b54983aec7063990fb3f66",22852816,4,0,1,1676,400,400,0
"2b09a08242b54983aec7063990fb3f66","1f471b7a883a4df48211e8c6a81b59a7",22852816,1,1,0,1678,400,401,1
"1f471b7a883a4df48211e8c6a81b59a7","1f471b7a883a4df48211e8c6a81b59a7",22852816,2,0,1,1679,401,401,0
"1f471b7a883a4df48211e8c6a81b59a7","2b09a08242b54983aec7063990fb3f66",22852816,1,-1,0,1681,401,400,-1
"2b09a08242b54983aec7063990fb3f66","9de0d567bfa84fe5b77cb76f4a76a5d1",22852816,1,5,0,1682,400,404,4
"9de0d567bfa84fe5b77cb76f4a76a5d1","9de0d567bfa84fe5b77cb76f4a76a5d1",22852816,1,0,1,1683,404,404,0
"9de0d567bfa84fe5b77cb76f4a76a5d1","1157bd665ec4472fb58b751dc5099355",22852816,1,-1,0,1684,404,403,-1
"1157bd665ec4472fb58b751dc5099355","3c8a22d2f9c146ea956609e3ed4f2559",22852816,1,3,0,1685,403,405,2
"3c8a22d2f9c146ea956609e3ed4f2559","58fc9094275e4c49be3f4ba6d4acc0a4",22852816,1,2,0,1686,405,406,1
"58fc9094275e4c49be3f4ba6d4acc0a4","58fc9094275e4c49be3f4ba6d4acc0a4",22852816,1,0,1,1687,406,406,0
"58fc9094275e4c49be3f4ba6d4acc0a4","c1c1be90b2b14c1ab4a5e1ee3c241902",22852816,1,1,0,1688,406,407,1
"c1c1be90b2b14c1ab4a5e1ee3c241902","c1c1be90b2b14c1ab4a5e1ee3c241902",22852816,5,0,1,1689,407,407,0
"c1c1be90b2b14c1ab4a5e1ee3c241902","58fc9094275e4c49be3f4ba6d4acc0a4",22852816,1,-1,0,1694,407,406,-1
"58fc9094275e4c49be3f4ba6d4acc0a4","02b3a1bead9244c1ba2f857c7da8f82a",22852816,1,3,0,1695,406,408,2
"02b3a1bead9244c1ba2f857c7da8f82a","02b3a1bead9244c1ba2f857c7da8f82a",22852816,3,0,1,1696,408,408,0
"02b3a1bead9244c1ba2f857c7da8f82a","2b09a08242b54983aec7063990fb3f66",22852816,1,-12,0,1697,408,400,-8
"2b09a08242b54983aec7063990fb3f66","02b3a1bead9244c1ba2f857c7da8f82a",22852816,2,12,0,1698,400,408,8
"02b3a1bead9244c1ba2f857c7da8f82a","6206fc6479014bb193084c32409dc1b9",22852816,1,1,0,1700,408,409,1
"6206fc6479014bb193084c32409dc1b9","6206fc6479014bb193084c32409dc1b9",22852816,4,0,1,1701,409,409,0
"6206fc6479014bb193084c32409dc1b9","02b3a1bead9244c1ba2f857c7da8f82a",22852816,1,-1,0,1705,409,408,-1
"02b3a1bead9244c1ba2f857c7da8f82a","6a5f020451db426dacba9e2ea3fcc62a",22852816,1,3,0,1706,408,410,2
"6a5f020451db426dacba9e2ea3fcc62a","6a5f020451db426dacba9e2ea3fcc62a",22852816,3,0,1,1707,410,410,0
"6a5f020451db426dacba9e2ea3fcc62a","33a9d248b2e44588a5b07fc1342b9bc2",22852816,1,2,0,1710,410,411,1
"33a9d248b2e44588a5b07fc1342b9bc2","33a9d248b2e44588a5b07fc1342b9bc2",22852816,1,0,1,1711,411,411,0
"33a9d248b2e44588a5b07fc1342b9bc2","c6f26bd420634f1cb7989e76fe6b16c0",22852816,1,1,0,1712,411,412,1
"c6f26bd420634f1cb7989e76fe6b16c0","c6f26bd420634f1cb7989e76fe6b16c0",22852816,5,0,1,1713,412,412,0
"c6f26bd420634f1cb7989e76fe6b16c0","2a65ee6e2ac64f6a8a55fbe5373ec763",22852816,1,1,0,1718,412,413,1
"2a65ee6e2ac64f6a8a55fbe5373ec763","2a65ee6e2ac64f6a8a55fbe5373ec763",22852816,2,0,1,1719,413,413,0
"2a65ee6e2ac64f6a8a55fbe5373ec763","33a9d248b2e44588a5b07fc1342b9bc2",22852816,1,-2,0,1721,413,411,-2
"33a9d248b2e44588a5b07fc1342b9bc2","1fd0f6dadbc14ebc965faf6122190b96",22852816,1,5,0,1722,411,415,4
"1fd0f6dadbc14ebc965faf6122190b96","1fd0f6dadbc14ebc965faf6122190b96",22852816,1,0,1,1723,415,415,0
"1fd0f6dadbc14ebc965faf6122190b96","687055dad9fc40c3982478fe33ec01bf",22852816,1,-1,0,1724,415,414,-1
"687055dad9fc40c3982478fe33ec01bf","2b09a08242b54983aec7063990fb3f66",22852816,1,-21,0,1725,414,400,-14
"02b3a1bead9244c1ba2f857c7da8f82a","2add1669f08d4101913db15f8c23b3b7",22852816,1,12,0,1728,408,416,8
"2add1669f08d4101913db15f8c23b3b7","2add1669f08d4101913db15f8c23b3b7",22852816,1,0,1,1729,416,416,0
"2add1669f08d4101913db15f8c23b3b7","2b09a08242b54983aec7063990fb3f66",22852816,1,-24,0,1730,416,400,-16
"2b09a08242b54983aec7063990fb3f66","a2b4bd40cee2481ebd3fc179d6a5cd62",22852816,2,27,0,1731,400,417,17
"a2b4bd40cee2481ebd3fc179d6a5cd62","e34e59dce2204f228f3a84b6725df60f",22852816,1,2,0,1732,417,419,2
"e34e59dce2204f228f3a84b6725df60f","e34e59dce2204f228f3a84b6725df60f",22852816,1,0,1,1733,419,419,0
"e34e59dce2204f228f3a84b6725df60f","a2b4bd40cee2481ebd3fc179d6a5cd62",22852816,1,-2,0,1734,419,417,-2
"a2b4bd40cee2481ebd3fc179d6a5cd62","bec48fc2e1294c7eb3d0aca780d731b8",22852816,2,4,0,1735,417,420,3
"bec48fc2e1294c7eb3d0aca780d731b8","66baf19b6b904b70922329068c63746d",22852816,1,-63,0,1736,420,376,-44
"7f544639412e40a9ba27f43b415362ab","4890121ce5d74576b4632b77cfc23398",22852816,1,12,0,1738,378,388,10
"4890121ce5d74576b4632b77cfc23398","66baf19b6b904b70922329068c63746d",22852816,1,-14,0,1739,388,376,-12
"66baf19b6b904b70922329068c63746d","c2fca3669923477ab966ded303dea31c",22852816,1,8,0,1740,376,383,7
"c2fca3669923477ab966ded303dea31c","96bb2b3e85a34d8b9544514e89f6fe97",22852816,1,9,0,1741,383,390,7
"96bb2b3e85a34d8b9544514e89f6fe97","18d3b836dd804224883cc9180b60a8e1",22852816,1,-4,0,1742,390,387,-3
"18d3b836dd804224883cc9180b60a8e1","17f95d18bab743888e1736033dc3384d",22852816,1,3,0,1743,387,389,2
"f7002c8484354eceac57bc7bd62c76c1","0c12af0a4e7f4002852cf84b2537c161",22852816,1,3,0,1746,393,395,2
"0c12af0a4e7f4002852cf84b2537c161","2b09a08242b54983aec7063990fb3f66",22852816,1,8,0,1747,395,400,5
"2b09a08242b54983aec7063990fb3f66","66baf19b6b904b70922329068c63746d",22852816,1,-32,0,1748,400,376,-24
"a2b4bd40cee2481ebd3fc179d6a5cd62","a2b4bd40cee2481ebd3fc179d6a5cd62",22852816,2,0,1,1753,417,417,0
"bec48fc2e1294c7eb3d0aca780d731b8","bec48fc2e1294c7eb3d0aca780d731b8",22852816,2,0,1,1756,420,420,0
"bec48fc2e1294c7eb3d0aca780d731b8","dbde19fcce2a4c1abdc7f685c293a23f",22852816,1,3,0,1758,420,422,2
"dbde19fcce2a4c1abdc7f685c293a23f","a24600b0e49245f6bdba8c893cfeddb0",22852816,3,4,0,1759,422,425,3
"a24600b0e49245f6bdba8c893cfeddb0","a24600b0e49245f6bdba8c893cfeddb0",22852816,6,0,1,1760,425,425,0
"a24600b0e49245f6bdba8c893cfeddb0","dbde19fcce2a4c1abdc7f685c293a23f",22852816,2,-4,0,1762,425,422,-3
"a24600b0e49245f6bdba8c893cfeddb0","a2b4bd40cee2481ebd3fc179d6a5cd62",22852816,1,-11,0,1770,425,417,-8
"a2b4bd40cee2481ebd3fc179d6a5cd62","24cf8786024543f19b89bc20034e60d7",22852816,1,18,0,1771,417,428,11
"24cf8786024543f19b89bc20034e60d7","f2a73be2f46840b182d7bd095378004e",22852816,2,1,0,1772,428,429,1
"f2a73be2f46840b182d7bd095378004e","f2a73be2f46840b182d7bd095378004e",22852816,1,0,1,1773,429,429,0
"f2a73be2f46840b182d7bd095378004e","604551fd4266430cb860fef58fa7dd61",22852816,1,1,0,1774,429,430,1
"604551fd4266430cb860fef58fa7dd61","604551fd4266430cb860fef58fa7dd61",22852816,7,0,1,1775,430,430,0
"604551fd4266430cb860fef58fa7dd61","24cf8786024543f19b89bc20034e60d7",22852816,1,-2,0,1782,430,428,-2
"24cf8786024543f19b89bc20034e60d7","dce46f8904594a62a6377a3587aaa663",22852816,2,4,0,1783,428,431,3
"dce46f8904594a62a6377a3587aaa663","dce46f8904594a62a6377a3587aaa663",22852816,2,0,1,1784,431,431,0
"dce46f8904594a62a6377a3587aaa663","9b9d0a249052413c869753b99682b0ac",22852816,1,1,0,1785,431,432,1
"9b9d0a249052413c869753b99682b0ac","9b9d0a249052413c869753b99682b0ac",22852816,3,0,1,1786,432,432,0
"9b9d0a249052413c869753b99682b0ac","061c175cc90f45fbad883025394e78dd",22852816,1,1,0,1789,432,433,1
"061c175cc90f45fbad883025394e78dd","061c175cc90f45fbad883025394e78dd",22852816,4,0,1,1790,433,433,0
"061c175cc90f45fbad883025394e78dd","dce46f8904594a62a6377a3587aaa663",22852816,1,-2,0,1794,433,431,-2
"dce46f8904594a62a6377a3587aaa663","74a7f8712e5449c2bc0b43c6f90dafed",22852816,1,5,0,1795,431,435,4
"74a7f8712e5449c2bc0b43c6f90dafed","74a7f8712e5449c2bc0b43c6f90dafed",22852816,1,0,1,1796,435,435,0
"74a7f8712e5449c2bc0b43c6f90dafed","66ada10dde9f43018588f1ced9d477fc",22852816,1,-1,0,1797,435,434,-1
"66ada10dde9f43018588f1ced9d477fc","24cf8786024543f19b89bc20034e60d7",22852816,1,-8,0,1798,434,428,-6
"f2a73be2f46840b182d7bd095378004e","dce46f8904594a62a6377a3587aaa663",22852816,1,3,0,1800,429,431,2
"dce46f8904594a62a6377a3587aaa663","24cf8786024543f19b89bc20034e60d7",22852816,1,-4,0,1801,431,428,-3
"dce46f8904594a62a6377a3587aaa663","bf12c96466d840a69bed7020b3f18bb8",22852816,1,7,0,1803,431,436,5
"bf12c96466d840a69bed7020b3f18bb8","bf12c96466d840a69bed7020b3f18bb8",22852816,1,0,1,1804,436,436,0
"bf12c96466d840a69bed7020b3f18bb8","24cf8786024543f19b89bc20034e60d7",22852816,1,-11,0,1805,436,428,-8
"24cf8786024543f19b89bc20034e60d7","070600601c4c439288445d2f0724807d",22852816,3,14,0,1806,428,437,9
"070600601c4c439288445d2f0724807d","1823b6de7d334a7aaabc4570719af4d9",22852816,2,2,0,1807,437,439,2
"1823b6de7d334a7aaabc4570719af4d9","1823b6de7d334a7aaabc4570719af4d9",22852816,12,0,1,1808,439,439,0
"1823b6de7d334a7aaabc4570719af4d9","070600601c4c439288445d2f0724807d",22852816,1,-2,0,1820,439,437,-2
"070600601c4c439288445d2f0724807d","0380cd76a7d44bc3a4da1f15e4d68f89",22852816,1,4,0,1821,437,440,3
"0380cd76a7d44bc3a4da1f15e4d68f89","0380cd76a7d44bc3a4da1f15e4d68f89",22852816,2,0,1,1822,440,440,0
"0380cd76a7d44bc3a4da1f15e4d68f89","23b7673c8b5443108c2ef09382834a86",22852816,1,2,0,1824,440,441,1
"23b7673c8b5443108c2ef09382834a86","23b7673c8b5443108c2ef09382834a86",22852816,3,0,1,1825,441,441,0
"23b7673c8b5443108c2ef09382834a86","901e92500aea43c79f19f1b279050668",22852816,1,2,0,1827,441,442,1
"901e92500aea43c79f19f1b279050668","901e92500aea43c79f19f1b279050668",22852816,2,0,1,1828,442,442,0
"901e92500aea43c79f19f1b279050668","001339db8ced4cf78829ebe8b145449d",22852816,1,1,0,1829,442,443,1
"001339db8ced4cf78829ebe8b145449d","001339db8ced4cf78829ebe8b145449d",22852816,11,0,1,1830,443,443,0
"001339db8ced4cf78829ebe8b145449d","452745e0366e42ae81561bfddebcc6c3",22852816,1,1,0,1841,443,444,1
"452745e0366e42ae81561bfddebcc6c3","452745e0366e42ae81561bfddebcc6c3",22852816,5,0,1,1842,444,444,0
"452745e0366e42ae81561bfddebcc6c3","4660ff2089114e8db82ceb26a4f329e3",22852816,1,2,0,1847,444,445,1
"4660ff2089114e8db82ceb26a4f329e3","901e92500aea43c79f19f1b279050668",22852816,2,-4,0,1848,445,442,-3
"901e92500aea43c79f19f1b279050668","4660ff2089114e8db82ceb26a4f329e3",22852816,1,4,0,1849,442,445,3
"4660ff2089114e8db82ceb26a4f329e3","4660ff2089114e8db82ceb26a4f329e3",22852816,2,0,1,1850,445,445,0
"4660ff2089114e8db82ceb26a4f329e3","7bd5586eb9d8484eb74a433ee7bfe499",22852816,1,2,0,1851,445,446,1
"7bd5586eb9d8484eb74a433ee7bfe499","7bd5586eb9d8484eb74a433ee7bfe499",22852816,25,0,1,1852,446,446,0
"7bd5586eb9d8484eb74a433ee7bfe499","8a7f26e690f34dda97be16904518ca99",22852816,1,2,0,1876,446,447,1
"8a7f26e690f34dda97be16904518ca99","8a7f26e690f34dda97be16904518ca99",22852816,1,0,1,1877,447,447,0
"8a7f26e690f34dda97be16904518ca99","070600601c4c439288445d2f0724807d",22852816,1,-16,0,1878,447,437,-10
"070600601c4c439288445d2f0724807d","b2f0d654738f48158edff28e8d3a546e",22852816,2,21,0,1879,437,449,12
"b2f0d654738f48158edff28e8d3a546e","4a29443515bb404cb8924e1c60a63b73",22852816,1,-234,0,1880,449,285,-164
"ba0e59461bfb4a44b7b1c28a01f8d3b3","7646a919d7e64fa990bca9b024ff089d",22852816,1,-1,0,1888,299,298,-1
"38aea304b4fa46e1b29bb72f5cea4c93","b2f0d654738f48158edff28e8d3a546e",22852816,1,174,0,1905,331,449,118
"b2f0d654738f48158edff28e8d3a546e","b2f0d654738f48158edff28e8d3a546e",22852816,1,0,1,1906,449,449,0
"b2f0d654738f48158edff28e8d3a546e","070600601c4c439288445d2f0724807d",22852816,2,-21,0,1907,449,437,-12
"070600601c4c439288445d2f0724807d","8a7f26e690f34dda97be16904518ca99",22852816,1,16,0,1908,437,447,10
"8a7f26e690f34dda97be16904518ca99","7bd5586eb9d8484eb74a433ee7bfe499",22852816,1,-2,0,1909,447,446,-1
"7bd5586eb9d8484eb74a433ee7bfe499","4660ff2089114e8db82ceb26a4f329e3",22852816,1,-2,0,1911,446,445,-1
"901e92500aea43c79f19f1b279050668","23b7673c8b5443108c2ef09382834a86",22852816,1,-2,0,1915,442,441,-1
"23b7673c8b5443108c2ef09382834a86","0380cd76a7d44bc3a4da1f15e4d68f89",22852816,1,-2,0,1917,441,440,-1
"0380cd76a7d44bc3a4da1f15e4d68f89","1823b6de7d334a7aaabc4570719af4d9",22852816,1,-2,0,1918,440,439,-1
"1823b6de7d334a7aaabc4570719af4d9","0380cd76a7d44bc3a4da1f15e4d68f89",22852816,1,2,0,1919,439,440,1
"0380cd76a7d44bc3a4da1f15e4d68f89","24cf8786024543f19b89bc20034e60d7",22852816,1,-18,0,1920,440,428,-12
"070600601c4c439288445d2f0724807d","bf12c96466d840a69bed7020b3f18bb8",22852816,1,-3,0,1922,437,436,-1
"bf12c96466d840a69bed7020b3f18bb8","66ada10dde9f43018588f1ced9d477fc",22852816,1,-3,0,1923,436,434,-2
"66ada10dde9f43018588f1ced9d477fc","dce46f8904594a62a6377a3587aaa663",22852816,1,-4,0,1924,434,431,-3
"dce46f8904594a62a6377a3587aaa663","f2a73be2f46840b182d7bd095378004e",22852816,1,-3,0,1926,431,429,-2
"f2a73be2f46840b182d7bd095378004e","070600601c4c439288445d2f0724807d",22852816,1,13,0,1927,429,437,8
"070600601c4c439288445d2f0724807d","24cf8786024543f19b89bc20034e60d7",22852816,1,-14,0,1928,437,428,-9
"24cf8786024543f19b89bc20034e60d7","24cf8786024543f19b89bc20034e60d7",22852816,1,0,1,1929,428,428,0
"1823b6de7d334a7aaabc4570719af4d9","b2f0d654738f48158edff28e8d3a546e",22852816,1,19,0,1932,439,449,10
"b2f0d654738f48158edff28e8d3a546e","f60ee41ec635499abd48168342d32c2f",22852816,1,5,0,1935,449,453,4
"f60ee41ec635499abd48168342d32c2f","f60ee41ec635499abd48168342d32c2f",22852816,50,0,1,1936,453,453,0
"f60ee41ec635499abd48168342d32c2f","b2f0d654738f48158edff28e8d3a546e",22852816,1,-5,0,1986,453,449,-4
"b2f0d654738f48158edff28e8d3a546e","f67fbf45a5f146ed866965bc57c7c001",22852816,1,8,0,1987,449,454,5
"f67fbf45a5f146ed866965bc57c7c001","f67fbf45a5f146ed866965bc57c7c001",22852816,2,0,1,1988,454,454,0
"f67fbf45a5f146ed866965bc57c7c001","d937afe49bd24a07a550dda1c1155122",22852816,1,1,0,1990,454,455,1
"d937afe49bd24a07a550dda1c1155122","d937afe49bd24a07a550dda1c1155122",22852816,1,0,1,1991,455,455,0
"d937afe49bd24a07a550dda1c1155122","3628b3f7823443d0912a339096b69943",22852816,1,1,0,1992,455,456,1
"3628b3f7823443d0912a339096b69943","3628b3f7823443d0912a339096b69943",22852816,1,0,1,1993,456,456,0
"3628b3f7823443d0912a339096b69943","9e049ee647cf43ecbcb5ed792a8e7588",22852816,1,1,0,1994,456,457,1
"9e049ee647cf43ecbcb5ed792a8e7588","9e049ee647cf43ecbcb5ed792a8e7588",22852816,1,0,1,1995,457,457,0
"9e049ee647cf43ecbcb5ed792a8e7588","5256a214faaf410b93f76cea06428334",22852816,1,1,0,1996,457,458,1
"5256a214faaf410b93f76cea06428334","5256a214faaf410b93f76cea06428334",22852816,1,0,1,1997,458,458,0
"5256a214faaf410b93f76cea06428334","25c32b120fce40fa9b6c85133aeb4716",22852816,1,1,0,1998,458,459,1
"25c32b120fce40fa9b6c85133aeb4716","25c32b120fce40fa9b6c85133aeb4716",22852816,3,0,1,1999,459,459,0
"25c32b120fce40fa9b6c85133aeb4716","11bc14f2204949008b7d511b933363c1",22852816,1,1,0,2002,459,460,1
"11bc14f2204949008b7d511b933363c1","11bc14f2204949008b7d511b933363c1",22852816,3,0,1,2003,460,460,0
"11bc14f2204949008b7d511b933363c1","42de338840a34d15adb66e7b14fb9d2c",22852816,1,1,0,2006,460,461,1
"42de338840a34d15adb66e7b14fb9d2c","42de338840a34d15adb66e7b14fb9d2c",22852816,1,0,1,2007,461,461,0
"42de338840a34d15adb66e7b14fb9d2c","9da37c6210b1416b8079c274f70bf600",22852816,1,1,0,2008,461,462,1
"9da37c6210b1416b8079c274f70bf600","9da37c6210b1416b8079c274f70bf600",22852816,1,0,1,2009,462,462,0
"9da37c6210b1416b8079c274f70bf600","519119f1deac45ff9ab4f13529be5c6e",22852816,1,1,0,2010,462,463,1
"519119f1deac45ff9ab4f13529be5c6e","519119f1deac45ff9ab4f13529be5c6e",22852816,5,0,1,2011,463,463,0
"519119f1deac45ff9ab4f13529be5c6e","c5df9f40ec14463b9dcfdc73df3e9285",22852816,1,3,0,2016,463,464,1
"c5df9f40ec14463b9dcfdc73df3e9285","f67fbf45a5f146ed866965bc57c7c001",22852816,1,-12,0,2017,464,454,-10
"f67fbf45a5f146ed866965bc57c7c001","c5df9f40ec14463b9dcfdc73df3e9285",22852816,1,12,0,2018,454,464,10
"c5df9f40ec14463b9dcfdc73df3e9285","c5df9f40ec14463b9dcfdc73df3e9285",22852816,1,0,1,2019,464,464,0
"c5df9f40ec14463b9dcfdc73df3e9285","83d42d95cd844fc093fc09cee250edb8",22852816,1,3,0,2020,464,465,1
"83d42d95cd844fc093fc09cee250edb8","83d42d95cd844fc093fc09cee250edb8",22852816,3,0,1,2021,465,465,0
"e2911e79efc2420eac45d9f671463d4b","e2911e79efc2420eac45d9f671463d4b",22853418,3,0,1,1,2,2,0
"e2911e79efc2420eac45d9f671463d4b","b613861cecf84ffcab01afb23f660475",22853418,1,-3,0,2,2,1,-1
"b613861cecf84ffcab01afb23f660475","b613861cecf84ffcab01afb23f660475",22853418,6,0,1,3,1,1,0
"b613861cecf84ffcab01afb23f660475","e2911e79efc2420eac45d9f671463d4b",22853418,1,3,0,9,1,2,1
"e2911e79efc2420eac45d9f671463d4b","519d1b8c59404d67b54e96c5c8a830b2",22853418,1,1,0,12,2,3,1
"519d1b8c59404d67b54e96c5c8a830b2","519d1b8c59404d67b54e96c5c8a830b2",22853418,1,0,1,13,3,3,0
"519d1b8c59404d67b54e96c5c8a830b2","531db53f81f646edb0cdcfe0085b03b7",22853418,1,1,0,14,3,4,1
"531db53f81f646edb0cdcfe0085b03b7","531db53f81f646edb0cdcfe0085b03b7",22853418,1,0,1,15,4,4,0
"531db53f81f646edb0cdcfe0085b03b7","4f5f94b2f95141e0a9d53a61da2276da",22853418,1,1,0,16,4,5,1
"4f5f94b2f95141e0a9d53a61da2276da","4f5f94b2f95141e0a9d53a61da2276da",22853418,1,0,1,17,5,5,0
"4f5f94b2f95141e0a9d53a61da2276da","6d541c89590949f99af293c4f2333f67",22853418,1,1,0,18,5,6,1
"6d541c89590949f99af293c4f2333f67","6d541c89590949f99af293c4f2333f67",22853418,1,0,1,19,6,6,0
"6d541c89590949f99af293c4f2333f67","dd5cf0b9fe4c4f1d8f5ff8e4c04879cb",22853418,1,1,0,20,6,7,1
"dd5cf0b9fe4c4f1d8f5ff8e4c04879cb","dd5cf0b9fe4c4f1d8f5ff8e4c04879cb",22853418,1,0,1,21,7,7,0
"dd5cf0b9fe4c4f1d8f5ff8e4c04879cb","f96261861edc426abe2248be4f0a709a",22853418,1,1,0,22,7,8,1
"f96261861edc426abe2248be4f0a709a","f96261861edc426abe2248be4f0a709a",22853418,1,0,1,23,8,8,0
"f96261861edc426abe2248be4f0a709a","66b5e16f4f75454fb5b8172079f0fa83",22853418,1,1,0,24,8,9,1
"66b5e16f4f75454fb5b8172079f0fa83","66b5e16f4f75454fb5b8172079f0fa83",22853418,1,0,1,25,9,9,0
"66b5e16f4f75454fb5b8172079f0fa83","0680571d4698477995e41842c36a54b2",22853418,1,1,0,26,9,10,1
"0680571d4698477995e41842c36a54b2","0680571d4698477995e41842c36a54b2",22853418,1,0,1,27,10,10,0
"0680571d4698477995e41842c36a54b2","9112f2bffece48e08c6d2287be204085",22853418,1,1,0,28,10,11,1
"9112f2bffece48e08c6d2287be204085","9112f2bffece48e08c6d2287be204085",22853418,1,0,1,29,11,11,0
"9112f2bffece48e08c6d2287be204085","56586aa865414f538729c7f7735d2bc6",22853418,1,3,0,30,11,12,1
"56586aa865414f538729c7f7735d2bc6","e2911e79efc2420eac45d9f671463d4b",22853418,1,-12,0,31,12,2,-10
"e2911e79efc2420eac45d9f671463d4b","56586aa865414f538729c7f7735d2bc6",22853418,1,12,0,32,2,12,10
"56586aa865414f538729c7f7735d2bc6","56586aa865414f538729c7f7735d2bc6",22853418,4,0,1,33,12,12,0
"56586aa865414f538729c7f7735d2bc6","b7f2b31585d94eb3bf86376714aa7070",22853418,1,2,0,35,12,13,1
"b7f2b31585d94eb3bf86376714aa7070","b7f2b31585d94eb3bf86376714aa7070",22853418,2,0,1,36,13,13,0
"b7f2b31585d94eb3bf86376714aa7070","3f1c815879794b929260d224becaff7e",22853418,1,2,0,38,13,14,1
"3f1c815879794b929260d224becaff7e","56586aa865414f538729c7f7735d2bc6",22853418,1,-4,0,39,14,12,-2
"56586aa865414f538729c7f7735d2bc6","3f1c815879794b929260d224becaff7e",22853418,1,4,0,42,12,14,2
"3f1c815879794b929260d224becaff7e","81c864a886d54a6b8ff85f7d736f4f95",22853418,1,2,0,43,14,15,1
"81c864a886d54a6b8ff85f7d736f4f95","5c5ceeee4562457ba6d41515aeebfbb1",22853418,1,4,0,44,15,17,2
"5c5ceeee4562457ba6d41515aeebfbb1","5c5ceeee4562457ba6d41515aeebfbb1",22853418,1,0,1,45,17,17,0
"5c5ceeee4562457ba6d41515aeebfbb1","9afd71a5298d4333b6849dfce1b9422c",22853418,1,3,0,46,17,18,1
"9afd71a5298d4333b6849dfce1b9422c","56586aa865414f538729c7f7735d2bc6",22853418,1,-13,0,47,18,12,-6
"56586aa865414f538729c7f7735d2bc6","9afd71a5298d4333b6849dfce1b9422c",22853418,1,13,0,48,12,18,6
"9afd71a5298d4333b6849dfce1b9422c","b7719e26494940efa49512aedd0aac79",22853418,1,4,0,49,18,20,2
"b7719e26494940efa49512aedd0aac79","d4f45188d3c84a02ba08454e6403a818",22853418,1,5,0,50,20,24,4
"d4f45188d3c84a02ba08454e6403a818","d4c3b003e8274e429d2fa688d73fde6d",22853418,1,-2,0,51,24,22,-2
"d4c3b003e8274e429d2fa688d73fde6d","d4c3b003e8274e429d2fa688d73fde6d",22853418,5,0,1,52,22,22,0
"d4c3b003e8274e429d2fa688d73fde6d","b7719e26494940efa49512aedd0aac79",22853418,1,-3,0,57,22,20,-2
"b7719e26494940efa49512aedd0aac79","b7719e26494940efa49512aedd0aac79",22853418,1,0,1,58,20,20,0
"b7719e26494940efa49512aedd0aac79","afbf7250b99d47bea07172749483ca97",22853418,1,12,0,59,20,28,8
"afbf7250b99d47bea07172749483ca97","afbf7250b99d47bea07172749483ca97",22853418,1,0,1,60,28,28,0
"afbf7250b99d47bea07172749483ca97","4e51676dc72045d99c19b9fa7b22f8bc",22853418,1,3,0,61,28,29,1
"4e51676dc72045d99c19b9fa7b22f8bc","4e51676dc72045d99c19b9fa7b22f8bc",22853418,1,0,1,62,29,29,0
"4e51676dc72045d99c19b9fa7b22f8bc","51970cfa30e643e894e66ae85c8024cc",22853418,1,3,0,63,29,31,2
"51970cfa30e643e894e66ae85c8024cc","4e51676dc72045d99c19b9fa7b22f8bc",22853418,1,-3,0,64,31,29,-2
"4e51676dc72045d99c19b9fa7b22f8bc","c33c17be71ae4d588da7369472e5bb1b",22853418,1,9,0,65,29,34,5
"c33c17be71ae4d588da7369472e5bb1b","93679be414554a11b1893002f2229a93",22853418,2,3,0,66,34,35,1
"93679be414554a11b1893002f2229a93","c33c17be71ae4d588da7369472e5bb1b",22853418,1,-3,0,67,35,34,-1
"93679be414554a11b1893002f2229a93","7040a13096d746ac84b8fac8d9752058",22853418,1,3,0,69,35,36,1
"7040a13096d746ac84b8fac8d9752058","7040a13096d746ac84b8fac8d9752058",22853418,1,0,1,70,36,36,0
"fc0e049d56024bc9a02c9a9c435c3df7","67a089198fcb4e1c8f2385786c2b296f",22853418,1,4,0,80,38,39,1
"64d48c6c9c7940639a932219a6c87198","64d48c6c9c7940639a932219a6c87198",22853418,1,0,1,82,40,40,0
"b534b89233134e30a9b5645138bfa9ee","0e37b720d23b4e7f8b313e79313fd107",22853418,1,3,0,85,41,44,3
"0e37b720d23b4e7f8b313e79313fd107","0e37b720d23b4e7f8b313e79313fd107",22853418,1,0,1,86,44,44,0
"0e37b720d23b4e7f8b313e79313fd107","6875d67fdd5f48168b62719df449bebd",22853418,1,1,0,87,44,45,1
"6875d67fdd5f48168b62719df449bebd","6875d67fdd5f48168b62719df449bebd",22853418,1,0,1,88,45,45,0
"6875d67fdd5f48168b62719df449bebd","b534b89233134e30a9b5645138bfa9ee",22853418,1,-4,0,89,45,41,-4
"6e13d61a7bdb44bca949c9f86fab3be5","6e13d61a7bdb44bca949c9f86fab3be5",22853418,1,0,1,91,47,47,0
"6e13d61a7bdb44bca949c9f86fab3be5","195f78799f984cc2b06c48dfe36be751",22853418,1,2,0,92,47,49,2
"195f78799f984cc2b06c48dfe36be751","195f78799f984cc2b06c48dfe36be751",22853418,2,0,1,93,49,49,0
"195f78799f984cc2b06c48dfe36be751","d9c8d8c444a64dadbbb508652c721e17",22853418,1,-3,0,95,49,46,-3
"d9c8d8c444a64dadbbb508652c721e17","d0c74f735e024943943e40333d6d337f",22853418,1,6,0,96,46,51,5
"d0c74f735e024943943e40333d6d337f","d0c74f735e024943943e40333d6d337f",22853418,1,0,1,97,51,51,0
"d0c74f735e024943943e40333d6d337f","983f8ff320594b279a7f4a6fe132f9c5",22853418,1,2,0,98,51,53,2
"983f8ff320594b279a7f4a6fe132f9c5","983f8ff320594b279a7f4a6fe132f9c5",22853418,2,0,1,100,53,53,0
"983f8ff320594b279a7f4a6fe132f9c5","35adfa5d923046aebabfefd98f35ff05",22853418,1,1,0,101,53,54,1
"35adfa5d923046aebabfefd98f35ff05","35adfa5d923046aebabfefd98f35ff05",22853418,5,0,1,102,54,54,0
"35adfa5d923046aebabfefd98f35ff05","b6f8a98476224da1b40e555ececc7ed8",22853418,1,1,0,107,54,55,1
"b6f8a98476224da1b40e555ececc7ed8","b6f8a98476224da1b40e555ececc7ed8",22853418,2,0,1,108,55,55,0
"b6f8a98476224da1b40e555ececc7ed8","86e22cb5fe0e4b47a9489ecddf7ed78f",22853418,1,1,0,110,55,56,1
"86e22cb5fe0e4b47a9489ecddf7ed78f","86e22cb5fe0e4b47a9489ecddf7ed78f",22853418,2,0,1,111,56,56,0
"86e22cb5fe0e4b47a9489ecddf7ed78f","f924752d8a1149668870b1e7698486f7",22853418,1,-6,0,113,56,50,-6
"f924752d8a1149668870b1e7698486f7","a1f2f12debe5432fb7a70bcd12bacfb9",22853418,1,9,0,114,50,58,8
"a1f2f12debe5432fb7a70bcd12bacfb9","78f30e4dcac84e3cbea8b2cc6e0d62b3",22853418,2,1,0,115,58,59,1
"78f30e4dcac84e3cbea8b2cc6e0d62b3","a1f2f12debe5432fb7a70bcd12bacfb9",22853418,3,-1,0,116,59,58,-1
"a1f2f12debe5432fb7a70bcd12bacfb9","a1f2f12debe5432fb7a70bcd12bacfb9",22853418,10,0,1,117,58,58,0
"78f30e4dcac84e3cbea8b2cc6e0d62b3","78f30e4dcac84e3cbea8b2cc6e0d62b3",22853418,7,0,1,128,59,59,0
"78f30e4dcac84e3cbea8b2cc6e0d62b3","12aa6e1672ac4e7aa6449a7a8609cd72",22853418,1,-2,0,135,59,57,-2
"12aa6e1672ac4e7aa6449a7a8609cd72","bc42d26810654ea9a1df1efe1e58c7d5",22853418,1,7,0,136,57,63,6
"bc42d26810654ea9a1df1efe1e58c7d5","a0a418b8540d479fa6e0f653b701da8b",22853418,3,1,0,137,63,64,1
"a0a418b8540d479fa6e0f653b701da8b","309ccf3cc4fe429d9bfbaef53d3fa479",22853418,3,-4,0,138,64,60,-4
"309ccf3cc4fe429d9bfbaef53d3fa479","b534b89233134e30a9b5645138bfa9ee",22853418,2,-23,0,139,60,41,-19
"b534b89233134e30a9b5645138bfa9ee","d646286c8051419bbc2e31dd1db55ca8",22853418,3,33,0,140,41,67,26
"d646286c8051419bbc2e31dd1db55ca8","d646286c8051419bbc2e31dd1db55ca8",22853418,2,0,1,141,67,67,0
"d646286c8051419bbc2e31dd1db55ca8","ae5ac430ea254e708a6f5deaaf7464ae",22853418,1,20,0,142,67,84,17
"ae5ac430ea254e708a6f5deaaf7464ae","b534b89233134e30a9b5645138bfa9ee",22853418,1,-53,0,143,84,41,-43
"d646286c8051419bbc2e31dd1db55ca8","7af822066add4e7f8e007e4eee31a8bf",22853418,1,-4,0,145,67,65,-2
"7af822066add4e7f8e007e4eee31a8bf","a0a418b8540d479fa6e0f653b701da8b",22853418,1,-2,0,146,65,64,-1
"a0a418b8540d479fa6e0f653b701da8b","bc42d26810654ea9a1df1efe1e58c7d5",22853418,4,-1,0,147,64,63,-1
"bc42d26810654ea9a1df1efe1e58c7d5","4c943503763e4e349906eea3ed3c8e86",22853418,1,-2,0,148,63,61,-2
"4c943503763e4e349906eea3ed3c8e86","4c943503763e4e349906eea3ed3c8e86",22853418,2,0,1,149,61,61,0
"4c943503763e4e349906eea3ed3c8e86","bc42d26810654ea9a1df1efe1e58c7d5",22853418,1,2,0,151,61,63,2
"bc42d26810654ea9a1df1efe1e58c7d5","bc42d26810654ea9a1df1efe1e58c7d5",22853418,6,0,1,152,63,63,0
"a0a418b8540d479fa6e0f653b701da8b","a0a418b8540d479fa6e0f653b701da8b",22853418,5,0,1,156,64,64,0
"309ccf3cc4fe429d9bfbaef53d3fa479","d646286c8051419bbc2e31dd1db55ca8",22853418,1,10,0,160,60,67,7
"d646286c8051419bbc2e31dd1db55ca8","b534b89233134e30a9b5645138bfa9ee",22853418,2,-33,0,161,67,41,-26
"b534b89233134e30a9b5645138bfa9ee","267f883678b24aed855fde42524975d9",22853418,1,37,0,162,41,71,30
"267f883678b24aed855fde42524975d9","267f883678b24aed855fde42524975d9",22853418,1,0,1,163,71,71,0
"267f883678b24aed855fde42524975d9","88fff56d0342490dbef9040750a20f6c",22853418,1,1,0,164,71,72,1
"88fff56d0342490dbef9040750a20f6c","88fff56d0342490dbef9040750a20f6c",22853418,1,0,1,165,72,72,0
"88fff56d0342490dbef9040750a20f6c","adb17b12b66c4a49a85fd34322f7df70",22853418,1,1,0,166,72,73,1
"adb17b12b66c4a49a85fd34322f7df70","adb17b12b66c4a49a85fd34322f7df70",22853418,1,0,1,167,73,73,0
"adb17b12b66c4a49a85fd34322f7df70","a2becd407db34b189200a32546d9d569",22853418,1,3,0,168,73,75,2
"a2becd407db34b189200a32546d9d569","d646286c8051419bbc2e31dd1db55ca8",22853418,1,-9,0,169,75,67,-8
"d646286c8051419bbc2e31dd1db55ca8","a2becd407db34b189200a32546d9d569",22853418,2,9,0,170,67,75,8
"a2becd407db34b189200a32546d9d569","58c22b011d0f4c2ea6d13615edbb9eeb",22853418,1,2,0,171,75,77,2
"58c22b011d0f4c2ea6d13615edbb9eeb","58c22b011d0f4c2ea6d13615edbb9eeb",22853418,5,0,1,172,77,77,0
"58c22b011d0f4c2ea6d13615edbb9eeb","dd76e1861dc9461c830888729d091ee0",22853418,1,1,0,177,77,78,1
"dd76e1861dc9461c830888729d091ee0","dd76e1861dc9461c830888729d091ee0",22853418,8,0,1,178,78,78,0
"dd76e1861dc9461c830888729d091ee0","cd1d828f1a694b87913a7ea66c23803e",22853418,1,1,0,186,78,79,1
"cd1d828f1a694b87913a7ea66c23803e","cd1d828f1a694b87913a7ea66c23803e",22853418,2,0,1,187,79,79,0
"cd1d828f1a694b87913a7ea66c23803e","9176a3c2b4d2465fa8b0c67096c2a97e",22853418,1,1,0,189,79,80,1
"9176a3c2b4d2465fa8b0c67096c2a97e","9176a3c2b4d2465fa8b0c67096c2a97e",22853418,5,0,1,190,80,80,0
"9176a3c2b4d2465fa8b0c67096c2a97e","f8ec6445f7194e25b9101d4fbcb07a18",22853418,1,1,0,195,80,81,1
"f8ec6445f7194e25b9101d4fbcb07a18","f8ec6445f7194e25b9101d4fbcb07a18",22853418,2,0,1,196,81,81,0
"f8ec6445f7194e25b9101d4fbcb07a18","140d5b27b8574befad82c0a013b59dfa",22853418,1,-7,0,198,81,74,-7
"140d5b27b8574befad82c0a013b59dfa","d18a9ea32855445f8736581f5cb119ce",22853418,2,9,0,199,74,82,8
"d18a9ea32855445f8736581f5cb119ce","f564483cbd7a407681aa2fcca518cf5f",22853418,1,4,0,200,82,85,3
"f564483cbd7a407681aa2fcca518cf5f","f564483cbd7a407681aa2fcca518cf5f",22853418,4,0,1,201,85,85,0
"f564483cbd7a407681aa2fcca518cf5f","18fd01350bd5434ca636d59a599d768a",22853418,1,1,0,205,85,86,1
"18fd01350bd5434ca636d59a599d768a","18fd01350bd5434ca636d59a599d768a",22853418,8,0,1,206,86,86,0
"18fd01350bd5434ca636d59a599d768a","ae5ac430ea254e708a6f5deaaf7464ae",22853418,1,-2,0,214,86,84,-2
"ae5ac430ea254e708a6f5deaaf7464ae","6a9f0ef185fb47f0937e29daa1c71ed5",22853418,2,7,0,215,84,90,6
"6a9f0ef185fb47f0937e29daa1c71ed5","c681290961c94c4caf23b529d1ae6b9a",22853418,1,-2,0,216,90,88,-2
"c681290961c94c4caf23b529d1ae6b9a","c681290961c94c4caf23b529d1ae6b9a",22853418,2,0,1,217,88,88,0
"c681290961c94c4caf23b529d1ae6b9a","6a9f0ef185fb47f0937e29daa1c71ed5",22853418,1,2,0,219,88,90,2
"6a9f0ef185fb47f0937e29daa1c71ed5","6a9f0ef185fb47f0937e29daa1c71ed5",22853418,6,0,1,220,90,90,0
"6a9f0ef185fb47f0937e29daa1c71ed5","e20db35ced8544ddac5bc3839145e463",22853418,1,3,0,223,90,91,1
"e20db35ced8544ddac5bc3839145e463","d646286c8051419bbc2e31dd1db55ca8",22853418,1,-30,0,224,91,67,-24
"d646286c8051419bbc2e31dd1db55ca8","1febb706d7a34005ae8711ed49c76e64",22853418,1,33,0,225,67,94,27
"1febb706d7a34005ae8711ed49c76e64","1febb706d7a34005ae8711ed49c76e64",22853418,2,0,1,226,94,94,0
"1febb706d7a34005ae8711ed49c76e64","8f73ba6f5a0042f2850356ac38ac6f24",22853418,1,1,0,228,94,95,1
"8f73ba6f5a0042f2850356ac38ac6f24","8f73ba6f5a0042f2850356ac38ac6f24",22853418,5,0,1,229,95,95,0
"8f73ba6f5a0042f2850356ac38ac6f24","e2260b86653c46d7b14a41fb419dbf8c",22853418,1,1,0,234,95,96,1
"e2260b86653c46d7b14a41fb419dbf8c","e2260b86653c46d7b14a41fb419dbf8c",22853418,2,0,1,235,96,96,0
"e2260b86653c46d7b14a41fb419dbf8c","35eb641ad1d845bbba54915bce75a962",22853418,1,1,0,237,96,97,1
"35eb641ad1d845bbba54915bce75a962","35eb641ad1d845bbba54915bce75a962",22853418,2,0,1,238,97,97,0
"35eb641ad1d845bbba54915bce75a962","08be90ffbeea4795a138cd42ed8db56f",22853418,1,1,0,240,97,98,1
"08be90ffbeea4795a138cd42ed8db56f","08be90ffbeea4795a138cd42ed8db56f",22853418,5,0,1,241,98,98,0
"08be90ffbeea4795a138cd42ed8db56f","3007433c8f584dcbb5ac159c1c5f2be3",22853418,1,1,0,246,98,99,1
"3007433c8f584dcbb5ac159c1c5f2be3","3007433c8f584dcbb5ac159c1c5f2be3",22853418,5,0,1,247,99,99,0
"3007433c8f584dcbb5ac159c1c5f2be3","e20db35ced8544ddac5bc3839145e463",22853418,1,-8,0,252,99,91,-8
"e20db35ced8544ddac5bc3839145e463","d391c8b6e56a43a7b654e9dee02d904b",22853418,1,13,0,253,91,103,12
"d391c8b6e56a43a7b654e9dee02d904b","00ae5f0c51874a73a41ebea838d95682",22853418,1,-2,0,254,103,101,-2
"00ae5f0c51874a73a41ebea838d95682","00ae5f0c51874a73a41ebea838d95682",22853418,1,0,1,255,101,101,0
"00ae5f0c51874a73a41ebea838d95682","d391c8b6e56a43a7b654e9dee02d904b",22853418,1,2,0,256,101,103,2
"d391c8b6e56a43a7b654e9dee02d904b","d391c8b6e56a43a7b654e9dee02d904b",22853418,30,0,1,257,103,103,0
"d391c8b6e56a43a7b654e9dee02d904b","6111116566fc4fd9abba409322bea245",22853418,1,1,0,287,103,104,1
"6111116566fc4fd9abba409322bea245","6111116566fc4fd9abba409322bea245",22853418,2,0,1,288,104,104,0
"6111116566fc4fd9abba409322bea245","a81b2235cb9c499eb9ea8ee0a8dd9725",22853418,1,1,0,290,104,105,1
"a81b2235cb9c499eb9ea8ee0a8dd9725","a81b2235cb9c499eb9ea8ee0a8dd9725",22853418,2,0,1,291,105,105,0
"a81b2235cb9c499eb9ea8ee0a8dd9725","2d4e0ab0ef3b4d73b82c72d4621a7579",22853418,1,1,0,293,105,106,1
"2d4e0ab0ef3b4d73b82c72d4621a7579","2d4e0ab0ef3b4d73b82c72d4621a7579",22853418,2,0,1,294,106,106,0
"2d4e0ab0ef3b4d73b82c72d4621a7579","8bdebf492ebd4e62b0d522e8ab5e5197",22853418,1,1,0,296,106,107,1
"8bdebf492ebd4e62b0d522e8ab5e5197","8bdebf492ebd4e62b0d522e8ab5e5197",22853418,2,0,1,297,107,107,0
"8bdebf492ebd4e62b0d522e8ab5e5197","73039f8c1eb9409cb4caee2cf968001e",22853418,1,-7,0,299,107,100,-7
"73039f8c1eb9409cb4caee2cf968001e","4280927ec4d643238aa49c32f9e06c6c",22853418,1,10,0,300,100,109,9
"4280927ec4d643238aa49c32f9e06c6c","4280927ec4d643238aa49c32f9e06c6c",22853418,1,0,1,301,109,109,0
"4280927ec4d643238aa49c32f9e06c6c","fc44e6a5f7654430af1227838224dceb",22853418,1,2,0,302,109,111,2
"fc44e6a5f7654430af1227838224dceb","fc44e6a5f7654430af1227838224dceb",22853418,2,0,1,303,111,111,0
"fc44e6a5f7654430af1227838224dceb","08111f75e22d409998cf8b85bd431f0a",22853418,1,-3,0,305,111,108,-3
"08111f75e22d409998cf8b85bd431f0a","a9ae0a3c070d455bb4369a8996313336",22853418,1,7,0,306,108,114,6
"a9ae0a3c070d455bb4369a8996313336","a9ae0a3c070d455bb4369a8996313336",22853418,1,0,1,307,114,114,0
"a9ae0a3c070d455bb4369a8996313336","71cec822bcff4f30a20e75dc63ef7b65",22853418,1,2,0,308,114,116,2
"71cec822bcff4f30a20e75dc63ef7b65","71cec822bcff4f30a20e75dc63ef7b65",22853418,5,0,1,309,116,116,0
"71cec822bcff4f30a20e75dc63ef7b65","37319e88176d4aefa91d7a9980dbae91",22853418,1,-4,0,314,116,112,-4
"37319e88176d4aefa91d7a9980dbae91","62bff51286ef4f348717a3cf6fe2318f",22853418,1,9,0,315,112,120,8
"62bff51286ef4f348717a3cf6fe2318f","b1cd0e7dc3ad4a8eb91a4bfdbeb025b0",22853418,1,-2,0,316,120,118,-2
"b1cd0e7dc3ad4a8eb91a4bfdbeb025b0","b1cd0e7dc3ad4a8eb91a4bfdbeb025b0",22853418,3,0,1,317,118,118,0
"b1cd0e7dc3ad4a8eb91a4bfdbeb025b0","779f9ddd1fd14d1e9e69f72219a1fdbd",22853418,1,5,0,320,118,121,3
"779f9ddd1fd14d1e9e69f72219a1fdbd","e20db35ced8544ddac5bc3839145e463",22853418,1,-36,0,321,121,91,-30
"e20db35ced8544ddac5bc3839145e463","62bff51286ef4f348717a3cf6fe2318f",22853418,2,33,0,322,91,120,29
"62bff51286ef4f348717a3cf6fe2318f","e20db35ced8544ddac5bc3839145e463",22853418,2,-33,0,326,120,91,-29
"779f9ddd1fd14d1e9e69f72219a1fdbd","ae26e6cda8ad4a3f81bd347560d9579f",22853418,1,4,0,333,121,125,4
"ae26e6cda8ad4a3f81bd347560d9579f","ae26e6cda8ad4a3f81bd347560d9579f",22853418,1,0,1,334,125,125,0
"ae26e6cda8ad4a3f81bd347560d9579f","ee48df95832b4374aa273ceb27ec1315",22853418,1,1,0,335,125,126,1
"ee48df95832b4374aa273ceb27ec1315","ee48df95832b4374aa273ceb27ec1315",22853418,1,0,1,336,126,126,0
"ee48df95832b4374aa273ceb27ec1315","7a439da90b394756ad1777fc4c6dead5",22853418,1,1,0,337,126,127,1
"7a439da90b394756ad1777fc4c6dead5","7a439da90b394756ad1777fc4c6dead5",22853418,1,0,1,338,127,127,0
"7a439da90b394756ad1777fc4c6dead5","779f9ddd1fd14d1e9e69f72219a1fdbd",22853418,1,-6,0,339,127,121,-6
"779f9ddd1fd14d1e9e69f72219a1fdbd","a8dd5213034441ac92724b4e83eb0bb2",22853418,2,9,0,340,121,129,8
"a8dd5213034441ac92724b4e83eb0bb2","a8dd5213034441ac92724b4e83eb0bb2",22853418,1,0,1,341,129,129,0
"a8dd5213034441ac92724b4e83eb0bb2","8115eab6556b45f5b415c3b8c26a12e5",22853418,1,2,0,342,129,131,2
"8115eab6556b45f5b415c3b8c26a12e5","8115eab6556b45f5b415c3b8c26a12e5",22853418,2,0,1,343,131,131,0
"8115eab6556b45f5b415c3b8c26a12e5","ec34b06efd844b46a4c4818ecdb9b8f4",22853418,1,1,0,345,131,132,1
"ec34b06efd844b46a4c4818ecdb9b8f4","ec34b06efd844b46a4c4818ecdb9b8f4",22853418,2,0,1,346,132,132,0
"ec34b06efd844b46a4c4818ecdb9b8f4","c2e1c2b9eac64109b343a088584b576b",22853418,1,1,0,348,132,133,1
"c2e1c2b9eac64109b343a088584b576b","c2e1c2b9eac64109b343a088584b576b",22853418,2,0,1,349,133,133,0
"c2e1c2b9eac64109b343a088584b576b","579338175e0b4bbb8ef3b712b5d8b54e",22853418,1,-5,0,351,133,128,-5
"579338175e0b4bbb8ef3b712b5d8b54e","8bc5795d6a984a3eace4e2811e52dd4f",22853418,1,8,0,352,128,135,7
"8bc5795d6a984a3eace4e2811e52dd4f","8bc5795d6a984a3eace4e2811e52dd4f",22853418,1,0,1,353,135,135,0
"8bc5795d6a984a3eace4e2811e52dd4f","b416d47c56a742199b5d7c7f19d6503a",22853418,1,-1,0,354,135,134,-1
"b416d47c56a742199b5d7c7f19d6503a","cd4532ad48034873ba8bce2aac0c9808",22853418,1,4,0,355,134,137,3
"cd4532ad48034873ba8bce2aac0c9808","cd4532ad48034873ba8bce2aac0c9808",22853418,1,0,1,356,137,137,0
"cd4532ad48034873ba8bce2aac0c9808","779f9ddd1fd14d1e9e69f72219a1fdbd",22853418,1,-19,0,357,137,121,-16
"779f9ddd1fd14d1e9e69f72219a1fdbd","df1de691dafe4549a18a4398ee9dfaf9",22853418,2,23,0,358,121,139,18
"df1de691dafe4549a18a4398ee9dfaf9","6c5ad271a44743479bfaea29b1db8d02",22853418,2,4,0,359,139,143,4
"6c5ad271a44743479bfaea29b1db8d02","6c5ad271a44743479bfaea29b1db8d02",22853418,1,0,1,360,143,143,0
"6c5ad271a44743479bfaea29b1db8d02","83d311bed5374fee83d8d67a7d9d82dc",22853418,1,1,0,361,143,144,1
"83d311bed5374fee83d8d67a7d9d82dc","83d311bed5374fee83d8d67a7d9d82dc",22853418,1,0,1,362,144,144,0
"83d311bed5374fee83d8d67a7d9d82dc","402bba41861d43acb52a5abb89e8831e",22853418,1,1,0,363,144,145,1
"402bba41861d43acb52a5abb89e8831e","402bba41861d43acb52a5abb89e8831e",22853418,2,0,1,364,145,145,0
"402bba41861d43acb52a5abb89e8831e","df1de691dafe4549a18a4398ee9dfaf9",22853418,1,-6,0,366,145,139,-6
"df1de691dafe4549a18a4398ee9dfaf9","8aae34f5ddbb4052a709b12e6b0d40fa",22853418,1,9,0,367,139,147,8
"8aae34f5ddbb4052a709b12e6b0d40fa","8aae34f5ddbb4052a709b12e6b0d40fa",22853418,1,0,1,368,147,147,0
"8aae34f5ddbb4052a709b12e6b0d40fa","645b3f0249f64f76af2e19eb4d0e55b7",22853418,1,2,0,369,147,149,2
"645b3f0249f64f76af2e19eb4d0e55b7","645b3f0249f64f76af2e19eb4d0e55b7",22853418,2,0,1,370,149,149,0
"645b3f0249f64f76af2e19eb4d0e55b7","7e7b8db5064d4369805ab370aac5ddfb",22853418,1,1,0,372,149,150,1
"7e7b8db5064d4369805ab370aac5ddfb","7e7b8db5064d4369805ab370aac5ddfb",22853418,2,0,1,373,150,150,0
"7e7b8db5064d4369805ab370aac5ddfb","8956d210ae7f41968fada86d4c979d6a",22853418,1,1,0,375,150,151,1
"8956d210ae7f41968fada86d4c979d6a","8956d210ae7f41968fada86d4c979d6a",22853418,2,0,1,376,151,151,0
"8956d210ae7f41968fada86d4c979d6a","f902b0f41b544d4dbf79664fd233648d",22853418,1,-5,0,378,151,146,-5
"f902b0f41b544d4dbf79664fd233648d","ae781e8b775e4ccd93bc800dad5c8376",22853418,1,8,0,379,146,153,7
"ae781e8b775e4ccd93bc800dad5c8376","ae781e8b775e4ccd93bc800dad5c8376",22853418,8,0,1,380,153,153,0
"ae781e8b775e4ccd93bc800dad5c8376","06882a8492d9499aa31555567f575ecb",22853418,1,1,0,388,153,154,1
"06882a8492d9499aa31555567f575ecb","06882a8492d9499aa31555567f575ecb",22853418,1,0,1,389,154,154,0
"06882a8492d9499aa31555567f575ecb","f293c508f409466a8f27ddd7d1e40b20",22853418,1,1,0,390,154,155,1
"f293c508f409466a8f27ddd7d1e40b20","f293c508f409466a8f27ddd7d1e40b20",22853418,2,0,1,391,155,155,0
"f293c508f409466a8f27ddd7d1e40b20","cc4ddef5bbbe48ebb605141b347c4ed1",22853418,1,1,0,393,155,156,1
"cc4ddef5bbbe48ebb605141b347c4ed1","cc4ddef5bbbe48ebb605141b347c4ed1",22853418,1,0,1,394,156,156,0
"cc4ddef5bbbe48ebb605141b347c4ed1","f03480cf4eba413194d7af52fc0e7f28",22853418,1,-4,0,395,156,152,-4
"f03480cf4eba413194d7af52fc0e7f28","d313cec988a84645bee413e8d4724a4b",22853418,1,7,0,396,152,158,6
"d313cec988a84645bee413e8d4724a4b","dc60696c76a74368a60f72246e47700d",22853418,1,1,0,401,158,159,1
"dc60696c76a74368a60f72246e47700d","dc60696c76a74368a60f72246e47700d",22853418,3,0,1,402,159,159,0
"dc60696c76a74368a60f72246e47700d","78adeee1fa2c4fe0bc73f7bca9fcee86",22853418,1,3,0,405,159,160,1
"df1de691dafe4549a18a4398ee9dfaf9","65202579580f4ad38d734b4ee39d22a8",22853418,1,31,0,407,139,164,25
"65202579580f4ad38d734b4ee39d22a8","78adeee1fa2c4fe0bc73f7bca9fcee86",22853418,3,-5,0,412,164,160,-4
"78adeee1fa2c4fe0bc73f7bca9fcee86","65202579580f4ad38d734b4ee39d22a8",22853418,2,5,0,413,160,164,4
"82e6285962b8400d9d6fc32436022a94","67a089198fcb4e1c8f2385786c2b296f",22853418,1,-162,0,478,167,39,-128
"67a089198fcb4e1c8f2385786c2b296f","64d48c6c9c7940639a932219a6c87198",22853418,2,1,0,479,39,40,1
"64d48c6c9c7940639a932219a6c87198","b534b89233134e30a9b5645138bfa9ee",22853418,1,3,0,480,40,41,1
"b534b89233134e30a9b5645138bfa9ee","67a089198fcb4e1c8f2385786c2b296f",22853418,1,-4,0,481,41,39,-2
"b534b89233134e30a9b5645138bfa9ee","6e13d61a7bdb44bca949c9f86fab3be5",22853418,2,7,0,483,41,47,6
"6e13d61a7bdb44bca949c9f86fab3be5","d9c8d8c444a64dadbbb508652c721e17",22853418,1,-1,0,484,47,46,-1
"d9c8d8c444a64dadbbb508652c721e17","d9c8d8c444a64dadbbb508652c721e17",22853418,2,0,1,485,46,46,0
"d9c8d8c444a64dadbbb508652c721e17","78f30e4dcac84e3cbea8b2cc6e0d62b3",22853418,1,15,0,487,46,59,13
"a1f2f12debe5432fb7a70bcd12bacfb9","12aa6e1672ac4e7aa6449a7a8609cd72",22853418,1,-1,0,489,58,57,-1
"12aa6e1672ac4e7aa6449a7a8609cd72","a0a418b8540d479fa6e0f653b701da8b",22853418,2,8,0,490,57,64,7
"309ccf3cc4fe429d9bfbaef53d3fa479","78f30e4dcac84e3cbea8b2cc6e0d62b3",22853418,1,-2,0,497,60,59,-1
"a1f2f12debe5432fb7a70bcd12bacfb9","a0a418b8540d479fa6e0f653b701da8b",22853418,1,7,0,499,58,64,6
"bc42d26810654ea9a1df1efe1e58c7d5","12aa6e1672ac4e7aa6449a7a8609cd72",22853418,1,-7,0,501,63,57,-6
"bc42d26810654ea9a1df1efe1e58c7d5","309ccf3cc4fe429d9bfbaef53d3fa479",22853418,1,-3,0,506,63,60,-3
"a2becd407db34b189200a32546d9d569","140d5b27b8574befad82c0a013b59dfa",22853418,1,-1,0,511,75,74,-1
"d18a9ea32855445f8736581f5cb119ce","6a9f0ef185fb47f0937e29daa1c71ed5",22853418,1,10,0,513,82,90,8
"6a9f0ef185fb47f0937e29daa1c71ed5","ae5ac430ea254e708a6f5deaaf7464ae",22853418,1,-7,0,515,90,84,-6
"6a9f0ef185fb47f0937e29daa1c71ed5","d646286c8051419bbc2e31dd1db55ca8",22853418,1,-27,0,517,90,67,-23
"e20db35ced8544ddac5bc3839145e463","e20db35ced8544ddac5bc3839145e463",22853418,1,0,1,519,91,91,0
"e20db35ced8544ddac5bc3839145e463","00ae5f0c51874a73a41ebea838d95682",22853418,1,11,0,520,91,101,10
"00ae5f0c51874a73a41ebea838d95682","4280927ec4d643238aa49c32f9e06c6c",22853418,1,9,0,521,101,109,8
"4280927ec4d643238aa49c32f9e06c6c","73039f8c1eb9409cb4caee2cf968001e",22853418,1,-10,0,522,109,100,-9
"73039f8c1eb9409cb4caee2cf968001e","08111f75e22d409998cf8b85bd431f0a",22853418,1,9,0,523,100,108,8
"08111f75e22d409998cf8b85bd431f0a","d391c8b6e56a43a7b654e9dee02d904b",22853418,1,-6,0,524,108,103,-5
"d391c8b6e56a43a7b654e9dee02d904b","e20db35ced8544ddac5bc3839145e463",22853418,1,-13,0,525,103,91,-12
"62bff51286ef4f348717a3cf6fe2318f","37319e88176d4aefa91d7a9980dbae91",22853418,1,-9,0,529,120,112,-8
"37319e88176d4aefa91d7a9980dbae91","779f9ddd1fd14d1e9e69f72219a1fdbd",22853418,1,12,0,530,112,121,9
"a8dd5213034441ac92724b4e83eb0bb2","779f9ddd1fd14d1e9e69f72219a1fdbd",22853418,1,-9,0,532,129,121,-8
"779f9ddd1fd14d1e9e69f72219a1fdbd","b416d47c56a742199b5d7c7f19d6503a",22853418,1,15,0,533,121,134,13
"b416d47c56a742199b5d7c7f19d6503a","579338175e0b4bbb8ef3b712b5d8b54e",22853418,1,-7,0,534,134,128,-6
"579338175e0b4bbb8ef3b712b5d8b54e","779f9ddd1fd14d1e9e69f72219a1fdbd",22853418,1,-8,0,535,128,121,-7
"6c5ad271a44743479bfaea29b1db8d02","df1de691dafe4549a18a4398ee9dfaf9",22853418,1,-4,0,538,143,139,-4
"df1de691dafe4549a18a4398ee9dfaf9","df1de691dafe4549a18a4398ee9dfaf9",22853418,1,0,1,539,139,139,0
"df1de691dafe4549a18a4398ee9dfaf9","f03480cf4eba413194d7af52fc0e7f28",22853418,1,15,0,540,139,152,13
"f03480cf4eba413194d7af52fc0e7f28","8aae34f5ddbb4052a709b12e6b0d40fa",22853418,1,-6,0,541,152,147,-5
"8aae34f5ddbb4052a709b12e6b0d40fa","d313cec988a84645bee413e8d4724a4b",22853418,1,13,0,542,147,158,11
"d313cec988a84645bee413e8d4724a4b","df1de691dafe4549a18a4398ee9dfaf9",22853418,1,-22,0,543,158,139,-19
"df1de691dafe4549a18a4398ee9dfaf9","78adeee1fa2c4fe0bc73f7bca9fcee86",22853418,1,26,0,544,139,160,21
"78adeee1fa2c4fe0bc73f7bca9fcee86","78adeee1fa2c4fe0bc73f7bca9fcee86",22853418,1,0,1,545,160,160,0
"78adeee1fa2c4fe0bc73f7bca9fcee86","d313cec988a84645bee413e8d4724a4b",22853418,1,-4,0,546,160,158,-2
"d313cec988a84645bee413e8d4724a4b","f902b0f41b544d4dbf79664fd233648d",22853418,1,-14,0,548,158,146,-12
"f902b0f41b544d4dbf79664fd233648d","65202579580f4ad38d734b4ee39d22a8",22853418,1,23,0,549,146,164,18
"65202579580f4ad38d734b4ee39d22a8","3cbcea2be0984e7dbd5a48195af10ce7",22853418,1,3,0,571,164,165,1
"3cbcea2be0984e7dbd5a48195af10ce7","78adeee1fa2c4fe0bc73f7bca9fcee86",22853418,1,-8,0,572,165,160,-5
"78adeee1fa2c4fe0bc73f7bca9fcee86","82e6285962b8400d9d6fc32436022a94",22853418,1,10,0,573,160,167,7
"82e6285962b8400d9d6fc32436022a94","0c7262dff33c4087bc660ccf40f92f9c",22853418,1,7,0,574,167,169,2
"b2275c3fad834f8d90737a2d9a6927d6","b2275c3fad834f8d90737a2d9a6927d6",22853418,26,0,1,576,172,172,0
"b2275c3fad834f8d90737a2d9a6927d6","eb515a26030b41f8a82a1e6114420bad",22853418,1,1,0,602,172,173,1
"eb515a26030b41f8a82a1e6114420bad","eb515a26030b41f8a82a1e6114420bad",22853418,2,0,1,603,173,173,0
"eb515a26030b41f8a82a1e6114420bad","b42cc17b7de840f181a704558d0bc845",22853418,1,3,0,605,173,175,2
"b42cc17b7de840f181a704558d0bc845","0c7262dff33c4087bc660ccf40f92f9c",22853418,1,-7,0,606,175,169,-6
"0c7262dff33c4087bc660ccf40f92f9c","b42cc17b7de840f181a704558d0bc845",22853418,1,7,0,607,169,175,6
"b42cc17b7de840f181a704558d0bc845","801f9e9135034f49bf5f8b4bdefedb41",22853418,1,2,0,608,175,177,2
"801f9e9135034f49bf5f8b4bdefedb41","801f9e9135034f49bf5f8b4bdefedb41",22853418,11,0,1,609,177,177,0
"801f9e9135034f49bf5f8b4bdefedb41","ea38cc0e6e6e41edbabf210220808bf9",22853418,1,3,0,620,177,179,2
"ea38cc0e6e6e41edbabf210220808bf9","362fcb0699a14845ab29b2340093e528",22853418,1,-6,0,621,179,174,-5
"362fcb0699a14845ab29b2340093e528","b87c552dd247427abe6ab5795b9c9d43",22853418,1,8,0,622,174,181,7
"b87c552dd247427abe6ab5795b9c9d43","ea38cc0e6e6e41edbabf210220808bf9",22853418,1,-2,0,623,181,179,-2
"ea38cc0e6e6e41edbabf210220808bf9","b87c552dd247427abe6ab5795b9c9d43",22853418,1,2,0,624,179,181,2
"b87c552dd247427abe6ab5795b9c9d43","b87c552dd247427abe6ab5795b9c9d43",22853418,12,0,1,625,181,181,0
"b87c552dd247427abe6ab5795b9c9d43","139b097acfca451689d80c9c6eebdf7b",22853418,1,-3,0,637,181,178,-3
"139b097acfca451689d80c9c6eebdf7b","30f660a1feb34582a739722532524f79",22853418,1,6,0,638,178,183,5
"30f660a1feb34582a739722532524f79","30f660a1feb34582a739722532524f79",22853418,3,0,1,639,183,183,0
"30f660a1feb34582a739722532524f79","2024b4885bd14338a39b7b509acbbd02",22853418,1,-1,0,642,183,182,-1
"2024b4885bd14338a39b7b509acbbd02","c3f63fe50d8e487c86bf8ef76c9cadd3",22853418,1,4,0,643,182,185,3
"c3f63fe50d8e487c86bf8ef76c9cadd3","c3f63fe50d8e487c86bf8ef76c9cadd3",22853418,4,0,1,644,185,185,0
"c3f63fe50d8e487c86bf8ef76c9cadd3","c8e371568a0c4391b25796ae4e91952e",22853418,1,3,0,648,185,186,1
"0c7262dff33c4087bc660ccf40f92f9c","7d932b23e1c84326ae5aa4d3c0d813d1",22853418,1,25,0,650,169,188,19
"7d932b23e1c84326ae5aa4d3c0d813d1","7d932b23e1c84326ae5aa4d3c0d813d1",22853418,1,0,1,651,188,188,0
"7d932b23e1c84326ae5aa4d3c0d813d1","ab11d94c6c8948ea90b88f19d2cd502b",22853418,1,3,0,652,188,190,2
"ab11d94c6c8948ea90b88f19d2cd502b","c8e371568a0c4391b25796ae4e91952e",22853418,2,-5,0,653,190,186,-4
"ab11d94c6c8948ea90b88f19d2cd502b","f992451ed6ad4e68bb9e68ad6be7c4be",22853418,1,2,0,655,190,192,2
"f992451ed6ad4e68bb9e68ad6be7c4be","f992451ed6ad4e68bb9e68ad6be7c4be",22853418,1,0,1,656,192,192,0
"f992451ed6ad4e68bb9e68ad6be7c4be","07b44a7a51e94c78b411c753fc39dab0",22853418,1,-3,0,657,192,189,-3
"6cd2dcaac46847d4a0bc53f296d90375","6cd2dcaac46847d4a0bc53f296d90375",22853418,1,0,1,659,194,194,0
"6cd2dcaac46847d4a0bc53f296d90375","2d2580c9411c4972909db508d6956a58",22853418,2,2,0,660,194,196,2
"2d2580c9411c4972909db508d6956a58","2d2580c9411c4972909db508d6956a58",22853418,7,0,1,661,196,196,0
"2d2580c9411c4972909db508d6956a58","5bddb3d9ed264f3984702f048c7e5340",22853418,2,1,0,666,196,197,1
"5bddb3d9ed264f3984702f048c7e5340","5bddb3d9ed264f3984702f048c7e5340",22853418,7,0,1,667,197,197,0
"5bddb3d9ed264f3984702f048c7e5340","d5e8e2bd12a2466b9d6d90855f0eb079",22853418,2,1,0,669,197,198,1
"d5e8e2bd12a2466b9d6d90855f0eb079","d5e8e2bd12a2466b9d6d90855f0eb079",22853418,10,0,1,670,198,198,0
"d5e8e2bd12a2466b9d6d90855f0eb079","017d7ca8e0394b91aaadc9574df2202c",22853418,3,-5,0,672,198,193,-5
"017d7ca8e0394b91aaadc9574df2202c","54e8e9f0ea3e45c4bf3b8ac799ee31b1",22853418,1,8,0,673,193,200,7
"54e8e9f0ea3e45c4bf3b8ac799ee31b1","54e8e9f0ea3e45c4bf3b8ac799ee31b1",22853418,1,0,1,674,200,200,0
"54e8e9f0ea3e45c4bf3b8ac799ee31b1","c614a00911be4877a075f19315530fb0",22853418,1,1,0,675,200,201,1
"c614a00911be4877a075f19315530fb0","c614a00911be4877a075f19315530fb0",22853418,6,0,1,676,201,201,0
"c614a00911be4877a075f19315530fb0","a6c21bd8b95249c7972820a7a7d76aff",22853418,1,1,0,682,201,202,1
"a6c21bd8b95249c7972820a7a7d76aff","a6c21bd8b95249c7972820a7a7d76aff",22853418,4,0,1,683,202,202,0
"a6c21bd8b95249c7972820a7a7d76aff","f9170dd6bc6442b4acd832747609b09a",22853418,1,-3,0,687,202,199,-3
"f9170dd6bc6442b4acd832747609b09a","6cd2dcaac46847d4a0bc53f296d90375",22853418,1,-6,0,688,199,194,-5
"6cd2dcaac46847d4a0bc53f296d90375","d5e8e2bd12a2466b9d6d90855f0eb079",22853418,1,4,0,689,194,198,4
"017d7ca8e0394b91aaadc9574df2202c","0c7262dff33c4087bc660ccf40f92f9c",22853418,1,-32,0,694,193,169,-24
"017d7ca8e0394b91aaadc9574df2202c","bb329d880ab54120adaf203a693bb203",22853418,1,11,0,702,193,203,10
"bb329d880ab54120adaf203a693bb203","bb329d880ab54120adaf203a693bb203",22853418,1,0,1,703,203,203,0
"bb329d880ab54120adaf203a693bb203","f9170dd6bc6442b4acd832747609b09a",22853418,1,-4,0,704,203,199,-4
"f9170dd6bc6442b4acd832747609b09a","0c7262dff33c4087bc660ccf40f92f9c",22853418,1,-39,0,705,199,169,-30
"f9170dd6bc6442b4acd832747609b09a","334c2344009840079b1d0e1b7ce3d5a7",22853418,1,7,0,729,199,205,6
"334c2344009840079b1d0e1b7ce3d5a7","334c2344009840079b1d0e1b7ce3d5a7",22853418,1,0,1,730,205,205,0
"334c2344009840079b1d0e1b7ce3d5a7","c8e371568a0c4391b25796ae4e91952e",22853418,1,-23,0,731,205,186,-19
"b9e80f77c3a44349863b19875725c384","b9e80f77c3a44349863b19875725c384",22853418,22,0,1,735,207,207,0
"7108f0e4c2584f1f9c471689ae4c885c","7108f0e4c2584f1f9c471689ae4c885c",22853418,27,0,1,758,208,208,0
"09400e101c5d4b439cf9a26b03aae558","09400e101c5d4b439cf9a26b03aae558",22853418,1,0,1,787,210,210,0
"09400e101c5d4b439cf9a26b03aae558","a88efa7e50ce47159810ab553afa6d3a",22853418,1,2,0,788,210,212,2
"a88efa7e50ce47159810ab553afa6d3a","a88efa7e50ce47159810ab553afa6d3a",22853418,2,0,1,789,212,212,0
"a88efa7e50ce47159810ab553afa6d3a","a875096404ef4a9984b62d74cda916f9",22853418,1,-3,0,791,212,209,-3
"a875096404ef4a9984b62d74cda916f9","be502a7a43c44bf7b682698de79d9369",22853418,1,6,0,792,209,214,5
"be502a7a43c44bf7b682698de79d9369","f7fb1952f56b4189b86a9f8b7862d2b8",22853418,2,1,0,793,214,215,1
"f7fb1952f56b4189b86a9f8b7862d2b8","be502a7a43c44bf7b682698de79d9369",22853418,1,-1,0,794,215,214,-1
"f7fb1952f56b4189b86a9f8b7862d2b8","f7fb1952f56b4189b86a9f8b7862d2b8",22853418,21,0,1,796,215,215,0
"f7fb1952f56b4189b86a9f8b7862d2b8","b860ee85d8bc4a2f97958cfb71be3533",22853418,1,1,0,817,215,216,1
"b860ee85d8bc4a2f97958cfb71be3533","b860ee85d8bc4a2f97958cfb71be3533",22853418,2,0,1,818,216,216,0
"b860ee85d8bc4a2f97958cfb71be3533","ec341f459285443b8361f7f15638ff08",22853418,1,-3,0,820,216,213,-3
"ec341f459285443b8361f7f15638ff08","363837c182e04711840d896ae1e0339c",22853418,1,6,0,821,213,218,5
"363837c182e04711840d896ae1e0339c","363837c182e04711840d896ae1e0339c",22853418,24,0,1,822,218,218,0
"363837c182e04711840d896ae1e0339c","01b2051f8941460d89945e3b02d1ce78",22853418,3,-1,0,834,218,217,-1
"01b2051f8941460d89945e3b02d1ce78","be95c065e45447c1bd8215ea6f130c7a",22853418,1,3,0,835,217,219,2
"be95c065e45447c1bd8215ea6f130c7a","363837c182e04711840d896ae1e0339c",22853418,1,-2,0,836,219,218,-1
"01b2051f8941460d89945e3b02d1ce78","91125ca626c5470eb145501f8c37f8db",22853418,1,4,0,838,217,220,3
"91125ca626c5470eb145501f8c37f8db","91125ca626c5470eb145501f8c37f8db",22853418,3,0,1,839,220,220,0
"91125ca626c5470eb145501f8c37f8db","d7f13c8d63ec4e2aa673fbb9cf9c6933",22853418,1,-18,0,842,220,206,-14
"77ecef8eff6b4a2caea7707669bf7475","77ecef8eff6b4a2caea7707669bf7475",22853418,12,0,1,845,222,222,0
"1c6721b1f63f4d30ba7746ea8af02a52","d03cb855c70044cf8c35d9ec0de696e3",22853418,2,4,0,858,221,224,3
"d03cb855c70044cf8c35d9ec0de696e3","8b9ae98743bd4d4a8a87dff1c1244211",22853418,2,3,0,859,224,227,3
"8b9ae98743bd4d4a8a87dff1c1244211","d03cb855c70044cf8c35d9ec0de696e3",22853418,1,-3,0,860,227,224,-3
"d03cb855c70044cf8c35d9ec0de696e3","a49a937d6896486d9a5396654abcf2e1",22853418,1,2,0,861,224,226,2
"a49a937d6896486d9a5396654abcf2e1","a49a937d6896486d9a5396654abcf2e1",22853418,1,0,1,862,226,226,0
"a49a937d6896486d9a5396654abcf2e1","8b9ae98743bd4d4a8a87dff1c1244211",22853418,1,1,0,863,226,227,1
"8b9ae98743bd4d4a8a87dff1c1244211","8b9ae98743bd4d4a8a87dff1c1244211",22853418,29,0,1,864,227,227,0
"8b9ae98743bd4d4a8a87dff1c1244211","f7906d6f59b9489a91d2ef40db5a474d",22853418,2,-4,0,893,227,223,-4
"f7906d6f59b9489a91d2ef40db5a474d","2ab1535aac1346ba8801535bf729ef37",22853418,2,7,0,894,223,229,6
"2ab1535aac1346ba8801535bf729ef37","2ab1535aac1346ba8801535bf729ef37",22853418,2,0,1,895,229,229,0
"2ab1535aac1346ba8801535bf729ef37","a4f40fb48a8542c8949bae1f002cd9bc",22853418,1,2,0,897,229,231,2
"a4f40fb48a8542c8949bae1f002cd9bc","a4f40fb48a8542c8949bae1f002cd9bc",22853418,2,0,1,898,231,231,0
"a4f40fb48a8542c8949bae1f002cd9bc","8972c23e32044edb8a78fa1eed4e5947",22853418,1,1,0,900,231,232,1
"8972c23e32044edb8a78fa1eed4e5947","8972c23e32044edb8a78fa1eed4e5947",22853418,1,0,1,901,232,232,0
"8972c23e32044edb8a78fa1eed4e5947","92feb4a40f8344d38b6f722e42a53295",22853418,1,1,0,902,232,233,1
"92feb4a40f8344d38b6f722e42a53295","92feb4a40f8344d38b6f722e42a53295",22853418,5,0,1,903,233,233,0
"92feb4a40f8344d38b6f722e42a53295","5152833676bf4c6cb317060be10f68db",22853418,1,-5,0,908,233,228,-5
"5152833676bf4c6cb317060be10f68db","d03cb855c70044cf8c35d9ec0de696e3",22853418,1,-5,0,909,228,224,-4
"d03cb855c70044cf8c35d9ec0de696e3","0b04c8e2f86d48c7aeb7e225819cd32b",22853418,1,12,0,910,224,234,10
"0b04c8e2f86d48c7aeb7e225819cd32b","8b9ae98743bd4d4a8a87dff1c1244211",22853418,1,-9,0,911,234,227,-7
"8b9ae98743bd4d4a8a87dff1c1244211","2ab1535aac1346ba8801535bf729ef37",22853418,1,3,0,912,227,229,2
"2ab1535aac1346ba8801535bf729ef37","f7906d6f59b9489a91d2ef40db5a474d",22853418,1,-7,0,913,229,223,-6
"f7906d6f59b9489a91d2ef40db5a474d","5152833676bf4c6cb317060be10f68db",22853418,1,6,0,914,223,228,5
"5152833676bf4c6cb317060be10f68db","ca3e28f290354c08aefe5b0f769604e6",22853418,1,8,0,915,228,235,7
"ca3e28f290354c08aefe5b0f769604e6","ca3e28f290354c08aefe5b0f769604e6",22853418,14,0,1,916,235,235,0
"ca3e28f290354c08aefe5b0f769604e6","79a35eea833e4c2c9d22fc53c3c6445c",22853418,1,1,0,930,235,236,1
"79a35eea833e4c2c9d22fc53c3c6445c","79a35eea833e4c2c9d22fc53c3c6445c",22853418,8,0,1,931,236,236,0
"79a35eea833e4c2c9d22fc53c3c6445c","8f68228b1518449e9615cdafee41a2bd",22853418,2,1,0,935,236,237,1
"8f68228b1518449e9615cdafee41a2bd","8f68228b1518449e9615cdafee41a2bd",22853418,2,0,1,936,237,237,0
"8f68228b1518449e9615cdafee41a2bd","cab89fa5c3ed45a5aa550fc0352d6a42",22853418,1,1,0,937,237,238,1
"cab89fa5c3ed45a5aa550fc0352d6a42","cab89fa5c3ed45a5aa550fc0352d6a42",22853418,3,0,1,938,238,238,0
"cab89fa5c3ed45a5aa550fc0352d6a42","0c7262dff33c4087bc660ccf40f92f9c",22853418,1,-90,0,941,238,169,-69
"d7f13c8d63ec4e2aa673fbb9cf9c6933","363837c182e04711840d896ae1e0339c",22853418,1,15,0,951,206,218,12
"2ab1535aac1346ba8801535bf729ef37","5152833676bf4c6cb317060be10f68db",22853418,1,-1,0,973,229,228,-1
"5152833676bf4c6cb317060be10f68db","79a35eea833e4c2c9d22fc53c3c6445c",22853418,1,9,0,974,228,236,8
"8f68228b1518449e9615cdafee41a2bd","66d4fad4f1cf4b46be0750a99ad7a35a",22853418,1,2,0,981,237,239,2
"66d4fad4f1cf4b46be0750a99ad7a35a","66d4fad4f1cf4b46be0750a99ad7a35a",22853418,1,0,1,982,239,239,0
"66d4fad4f1cf4b46be0750a99ad7a35a","0b04c8e2f86d48c7aeb7e225819cd32b",22853418,1,-5,0,983,239,234,-5
"0b04c8e2f86d48c7aeb7e225819cd32b","0c7262dff33c4087bc660ccf40f92f9c",22853418,1,-86,0,984,234,169,-65
"c8e371568a0c4391b25796ae4e91952e","07b44a7a51e94c78b411c753fc39dab0",22853418,1,4,0,989,186,189,3
"07b44a7a51e94c78b411c753fc39dab0","c8e371568a0c4391b25796ae4e91952e",22853418,1,-4,0,990,189,186,-3
"09400e101c5d4b439cf9a26b03aae558","be502a7a43c44bf7b682698de79d9369",22853418,1,5,0,996,210,214,4
"be502a7a43c44bf7b682698de79d9369","a875096404ef4a9984b62d74cda916f9",22853418,1,-6,0,997,214,209,-5
"a875096404ef4a9984b62d74cda916f9","f7fb1952f56b4189b86a9f8b7862d2b8",22853418,1,7,0,998,209,215,6
"f7fb1952f56b4189b86a9f8b7862d2b8","ec341f459285443b8361f7f15638ff08",22853418,1,-2,0,999,215,213,-2
"ec341f459285443b8361f7f15638ff08","d7f13c8d63ec4e2aa673fbb9cf9c6933",22853418,1,-9,0,1000,213,206,-7
"d7f13c8d63ec4e2aa673fbb9cf9c6933","1c6721b1f63f4d30ba7746ea8af02a52",22853418,8,21,0,1001,206,221,15
"1c6721b1f63f4d30ba7746ea8af02a52","77ecef8eff6b4a2caea7707669bf7475",22853418,8,1,0,1002,221,222,1
"77ecef8eff6b4a2caea7707669bf7475","1c6721b1f63f4d30ba7746ea8af02a52",22853418,10,-1,0,1003,222,221,-1
"1c6721b1f63f4d30ba7746ea8af02a52","0b04c8e2f86d48c7aeb7e225819cd32b",22853418,1,16,0,1004,221,234,13
"0b04c8e2f86d48c7aeb7e225819cd32b","f53da5fd9bfe412da4b80d4742563b6c",22853418,1,8,0,1005,234,241,7
"f53da5fd9bfe412da4b80d4742563b6c","f53da5fd9bfe412da4b80d4742563b6c",22853418,1,0,1,1006,241,241,0
"f53da5fd9bfe412da4b80d4742563b6c","1c6721b1f63f4d30ba7746ea8af02a52",22853418,1,-24,0,1007,241,221,-20
"1c6721b1f63f4d30ba7746ea8af02a52","2ae94c0cea4d480a9d5dca8fb1d7b542",22853418,8,27,0,1008,221,242,21
"2ae94c0cea4d480a9d5dca8fb1d7b542","1ebf23f9d994469a85206e4c7b1bf5f5",22853418,7,3,0,1009,242,245,3
"1ebf23f9d994469a85206e4c7b1bf5f5","2ae94c0cea4d480a9d5dca8fb1d7b542",22853418,5,-3,0,1010,245,242,-3
"2ae94c0cea4d480a9d5dca8fb1d7b542","0d987bed3ffa4ed0b9a2e62e97b7b30f",22853418,12,38,0,1011,242,272,30
"0d987bed3ffa4ed0b9a2e62e97b7b30f","2ae94c0cea4d480a9d5dca8fb1d7b542",22853418,4,-38,0,1012,272,242,-30
"1ebf23f9d994469a85206e4c7b1bf5f5","7028800abe7d4e27b613d1d6cbe26bf7",22853418,1,27,0,1016,245,267,22
"7028800abe7d4e27b613d1d6cbe26bf7","1ebf23f9d994469a85206e4c7b1bf5f5",22853418,1,-27,0,1017,267,245,-22
"1ebf23f9d994469a85206e4c7b1bf5f5","1ebf23f9d994469a85206e4c7b1bf5f5",22853418,21,0,1,1018,245,245,0
"1ebf23f9d994469a85206e4c7b1bf5f5","85ae675b83e8422da842cfd25596af99",22853418,1,1,0,1039,245,246,1
"85ae675b83e8422da842cfd25596af99","85ae675b83e8422da842cfd25596af99",22853418,1,0,1,1040,246,246,0
"85ae675b83e8422da842cfd25596af99","fa235f0f364d47e4ae1c87f47bf8e6ba",22853418,1,8,0,1041,246,252,6
"fa235f0f364d47e4ae1c87f47bf8e6ba","2ae94c0cea4d480a9d5dca8fb1d7b542",22853418,2,-12,0,1042,252,242,-10
"2ae94c0cea4d480a9d5dca8fb1d7b542","fa235f0f364d47e4ae1c87f47bf8e6ba",22853418,1,12,0,1043,242,252,10
"fa235f0f364d47e4ae1c87f47bf8e6ba","79f7845465cc4ed19d8e4f1429541be0",22853418,1,2,0,1044,252,254,2
"79f7845465cc4ed19d8e4f1429541be0","79f7845465cc4ed19d8e4f1429541be0",22853418,6,0,1,1045,254,254,0
"79f7845465cc4ed19d8e4f1429541be0","6e83e23f56544a19b94067c1c558d9c0",22853418,2,-8,0,1047,254,247,-7
"6e83e23f56544a19b94067c1c558d9c0","00f61990949545828dd12f1303d47504",22853418,3,11,0,1048,247,256,9
"00f61990949545828dd12f1303d47504","fa235f0f364d47e4ae1c87f47bf8e6ba",22853418,1,-5,0,1049,256,252,-4
"fa235f0f364d47e4ae1c87f47bf8e6ba","d546341988904f069cfa86b21457d9d9",22853418,1,-1,0,1050,252,251,-1
"d546341988904f069cfa86b21457d9d9","79f7845465cc4ed19d8e4f1429541be0",22853418,1,3,0,1051,251,254,3
"79f7845465cc4ed19d8e4f1429541be0","00f61990949545828dd12f1303d47504",22853418,1,3,0,1054,254,256,2
"00f61990949545828dd12f1303d47504","6e83e23f56544a19b94067c1c558d9c0",22853418,1,-11,0,1055,256,247,-9
"00f61990949545828dd12f1303d47504","ead7bb4b64e247d2ae632ab8a296b091",22853418,1,2,0,1057,256,258,2
"ead7bb4b64e247d2ae632ab8a296b091","ead7bb4b64e247d2ae632ab8a296b091",22853418,2,0,1,1058,258,258,0
"ead7bb4b64e247d2ae632ab8a296b091","41b0048dde734bb280bac6116baa8e27",22853418,1,1,0,1060,258,259,1
"41b0048dde734bb280bac6116baa8e27","41b0048dde734bb280bac6116baa8e27",22853418,2,0,1,1061,259,259,0
"41b0048dde734bb280bac6116baa8e27","b41c5a094a604ee0915327da5cc0beb7",22853418,1,1,0,1063,259,260,1
"b41c5a094a604ee0915327da5cc0beb7","b41c5a094a604ee0915327da5cc0beb7",22853418,2,0,1,1064,260,260,0
"b41c5a094a604ee0915327da5cc0beb7","d546341988904f069cfa86b21457d9d9",22853418,1,-10,0,1066,260,251,-9
"d546341988904f069cfa86b21457d9d9","28c171777c52431ab6b925073bd63d46",22853418,1,15,0,1067,251,264,13
"28c171777c52431ab6b925073bd63d46","28c171777c52431ab6b925073bd63d46",22853418,7,0,1,1068,264,264,0
"28c171777c52431ab6b925073bd63d46","ac160db940cb49ae8579162b1d52bb5d",22853418,1,2,0,1075,264,266,2
"ac160db940cb49ae8579162b1d52bb5d","ac160db940cb49ae8579162b1d52bb5d",22853418,3,0,1,1076,266,266,0
"ac160db940cb49ae8579162b1d52bb5d","d989ebcfc12a4b669f0100dc1aa14f1e",22853418,1,-12,0,1079,266,255,-11
"d989ebcfc12a4b669f0100dc1aa14f1e","c6fd49b485cc4874b0bbdd9c6171e09c",22853418,1,15,0,1080,255,268,13
"c6fd49b485cc4874b0bbdd9c6171e09c","c6fd49b485cc4874b0bbdd9c6171e09c",22853418,7,0,1,1081,268,268,0
"c6fd49b485cc4874b0bbdd9c6171e09c","44240778a97c4af0937817499b75707b",22853418,1,1,0,1088,268,269,1
"44240778a97c4af0937817499b75707b","44240778a97c4af0937817499b75707b",22853418,2,0,1,1089,269,269,0
"44240778a97c4af0937817499b75707b","7aa76d3e993840d8805f097cbdbcd44b",22853418,1,-9,0,1091,269,261,-8
"7aa76d3e993840d8805f097cbdbcd44b","865a4d3b43374da7944dc7d397f566d9",22853418,1,12,0,1092,261,271,10
"865a4d3b43374da7944dc7d397f566d9","865a4d3b43374da7944dc7d397f566d9",22853418,1,0,1,1093,271,271,0
"865a4d3b43374da7944dc7d397f566d9","2ae94c0cea4d480a9d5dca8fb1d7b542",22853418,1,-35,0,1094,271,242,-29
"0d987bed3ffa4ed0b9a2e62e97b7b30f","0d987bed3ffa4ed0b9a2e62e97b7b30f",22853418,4,0,1,1096,272,272,0
"0d987bed3ffa4ed0b9a2e62e97b7b30f","bb5a47f5ea01454a8b79455422d3b9da",22853418,16,10,0,1097,272,280,8
"bb5a47f5ea01454a8b79455422d3b9da","bb5a47f5ea01454a8b79455422d3b9da",22853418,167,0,1,1098,280,280,0
"bb5a47f5ea01454a8b79455422d3b9da","82ae07bc0c9b4570a41799290d1ef399",22853418,3,-6,0,1105,280,275,-5
"82ae07bc0c9b4570a41799290d1ef399","0c7262dff33c4087bc660ccf40f92f9c",22853418,1,-139,0,1106,275,169,-106
"0c7262dff33c4087bc660ccf40f92f9c","0c7262dff33c4087bc660ccf40f92f9c",22853418,7,0,1,1107,169,169,0
"0c7262dff33c4087bc660ccf40f92f9c","c8e371568a0c4391b25796ae4e91952e",22853418,15,23,0,1108,169,186,17
"c8e371568a0c4391b25796ae4e91952e","c8e371568a0c4391b25796ae4e91952e",22853418,9,0,1,1109,186,186,0
"c8e371568a0c4391b25796ae4e91952e","ab11d94c6c8948ea90b88f19d2cd502b",22853418,5,5,0,1110,186,190,4
"ab11d94c6c8948ea90b88f19d2cd502b","07b44a7a51e94c78b411c753fc39dab0",22853418,3,-1,0,1111,190,189,-1
"07b44a7a51e94c78b411c753fc39dab0","6cd2dcaac46847d4a0bc53f296d90375",22853418,4,6,0,1112,189,194,5
"6cd2dcaac46847d4a0bc53f296d90375","017d7ca8e0394b91aaadc9574df2202c",22853418,2,-1,0,1113,194,193,-1
"017d7ca8e0394b91aaadc9574df2202c","f9170dd6bc6442b4acd832747609b09a",22853418,2,7,0,1114,193,199,6
"f9170dd6bc6442b4acd832747609b09a","c8e371568a0c4391b25796ae4e91952e",22853418,1,-16,0,1115,199,186,-13
"c8e371568a0c4391b25796ae4e91952e","d7f13c8d63ec4e2aa673fbb9cf9c6933",22853418,10,26,0,1116,186,206,20
"d7f13c8d63ec4e2aa673fbb9cf9c6933","7108f0e4c2584f1f9c471689ae4c885c",22853418,4,2,0,1117,206,208,2
"7108f0e4c2584f1f9c471689ae4c885c","b9e80f77c3a44349863b19875725c384",22853418,4,-1,0,1118,208,207,-1
"b9e80f77c3a44349863b19875725c384","363837c182e04711840d896ae1e0339c",22853418,1,14,0,1119,207,218,11
"363837c182e04711840d896ae1e0339c","d7f13c8d63ec4e2aa673fbb9cf9c6933",22853418,1,-15,0,1120,218,206,-12
"d7f13c8d63ec4e2aa673fbb9cf9c6933","01b2051f8941460d89945e3b02d1ce78",22853418,1,14,0,1121,206,217,11
"01b2051f8941460d89945e3b02d1ce78","1c6721b1f63f4d30ba7746ea8af02a52",22853418,2,7,0,1122,217,221,4
"1c6721b1f63f4d30ba7746ea8af02a52","d7f13c8d63ec4e2aa673fbb9cf9c6933",22853418,5,-21,0,1123,221,206,-15
"d7f13c8d63ec4e2aa673fbb9cf9c6933","77ecef8eff6b4a2caea7707669bf7475",22853418,3,22,0,1124,206,222,16
"1c6721b1f63f4d30ba7746ea8af02a52","1c6721b1f63f4d30ba7746ea8af02a52",22853418,4,0,1,1126,221,221,0
"1ebf23f9d994469a85206e4c7b1bf5f5","fa235f0f364d47e4ae1c87f47bf8e6ba",22853418,1,9,0,1129,245,252,7
"2ae94c0cea4d480a9d5dca8fb1d7b542","79f7845465cc4ed19d8e4f1429541be0",22853418,1,14,0,1131,242,254,12
"00f61990949545828dd12f1303d47504","d546341988904f069cfa86b21457d9d9",22853418,1,-6,0,1136,256,251,-5
"d546341988904f069cfa86b21457d9d9","2ae94c0cea4d480a9d5dca8fb1d7b542",22853418,1,-11,0,1137,251,242,-9
"bb5a47f5ea01454a8b79455422d3b9da","0c7262dff33c4087bc660ccf40f92f9c",22853418,1,-145,0,1152,280,169,-111
"d7f13c8d63ec4e2aa673fbb9cf9c6933","c8e371568a0c4391b25796ae4e91952e",22853418,5,-26,0,1157,206,186,-20
"c8e371568a0c4391b25796ae4e91952e","b9e80f77c3a44349863b19875725c384",22853418,3,27,0,1158,186,207,21
"b9e80f77c3a44349863b19875725c384","7108f0e4c2584f1f9c471689ae4c885c",22853418,7,1,0,1159,207,208,1
"7108f0e4c2584f1f9c471689ae4c885c","d7f13c8d63ec4e2aa673fbb9cf9c6933",22853418,7,-2,0,1160,208,206,-2
"2ae94c0cea4d480a9d5dca8fb1d7b542","2ae94c0cea4d480a9d5dca8fb1d7b542",22853418,6,0,1,1169,242,242,0
"bb5a47f5ea01454a8b79455422d3b9da","bc5524e78a8544e2ae2fdc2f3462bbec",22853418,5,-1,0,1180,280,279,-1
"bc5524e78a8544e2ae2fdc2f3462bbec","82ae07bc0c9b4570a41799290d1ef399",22853418,2,-5,0,1181,279,275,-4
"82ae07bc0c9b4570a41799290d1ef399","bb5a47f5ea01454a8b79455422d3b9da",22853418,4,6,0,1182,275,280,5
"bb5a47f5ea01454a8b79455422d3b9da","94cecc3f1e7d484b8e068e79241dfd73",22853418,2,3,0,1198,280,281,1
"94cecc3f1e7d484b8e068e79241dfd73","0d987bed3ffa4ed0b9a2e62e97b7b30f",22853418,7,-13,0,1199,281,272,-9
"0d987bed3ffa4ed0b9a2e62e97b7b30f","a37477c4e4c14169ad44b06b493007f6",22853418,1,15,0,1200,272,283,11
"a37477c4e4c14169ad44b06b493007f6","0c7262dff33c4087bc660ccf40f92f9c",22853418,3,-150,0,1201,283,169,-114
"d7f13c8d63ec4e2aa673fbb9cf9c6933","d7f13c8d63ec4e2aa673fbb9cf9c6933",22853418,3,0,1,1207,206,206,0
"d7f13c8d63ec4e2aa673fbb9cf9c6933","b9e80f77c3a44349863b19875725c384",22853418,3,1,0,1208,206,207,1
"b9e80f77c3a44349863b19875725c384","d7f13c8d63ec4e2aa673fbb9cf9c6933",22853418,3,-1,0,1209,207,206,-1
"7108f0e4c2584f1f9c471689ae4c885c","1c6721b1f63f4d30ba7746ea8af02a52",22853418,1,19,0,1211,208,221,13
"0d987bed3ffa4ed0b9a2e62e97b7b30f","1ebf23f9d994469a85206e4c7b1bf5f5",22853418,2,-35,0,1219,272,245,-27
"1ebf23f9d994469a85206e4c7b1bf5f5","0d987bed3ffa4ed0b9a2e62e97b7b30f",22853418,2,35,0,1220,245,272,27
"bb5a47f5ea01454a8b79455422d3b9da","0d987bed3ffa4ed0b9a2e62e97b7b30f",22853418,9,-10,0,1229,280,272,-8
"0d987bed3ffa4ed0b9a2e62e97b7b30f","94cecc3f1e7d484b8e068e79241dfd73",22853418,7,13,0,1230,272,281,9
"94cecc3f1e7d484b8e068e79241dfd73","a37477c4e4c14169ad44b06b493007f6",22853418,11,2,0,1231,281,283,2
"c8e371568a0c4391b25796ae4e91952e","0c7262dff33c4087bc660ccf40f92f9c",22853418,6,-23,0,1234,186,169,-17
"d7f13c8d63ec4e2aa673fbb9cf9c6933","09400e101c5d4b439cf9a26b03aae558",22853418,3,5,0,1241,206,210,4
"09400e101c5d4b439cf9a26b03aae558","a875096404ef4a9984b62d74cda916f9",22853418,1,-1,0,1242,210,209,-1
"a875096404ef4a9984b62d74cda916f9","1c6721b1f63f4d30ba7746ea8af02a52",22853418,1,17,0,1243,209,221,12
"d7f13c8d63ec4e2aa673fbb9cf9c6933","d03cb855c70044cf8c35d9ec0de696e3",22853418,1,25,0,1245,206,224,18
"d03cb855c70044cf8c35d9ec0de696e3","1c6721b1f63f4d30ba7746ea8af02a52",22853418,1,-4,0,1246,224,221,-3
"1c6721b1f63f4d30ba7746ea8af02a52","f7906d6f59b9489a91d2ef40db5a474d",22853418,1,3,0,1249,221,223,2
"f7906d6f59b9489a91d2ef40db5a474d","8b9ae98743bd4d4a8a87dff1c1244211",22853418,1,4,0,1250,223,227,4
"8b9ae98743bd4d4a8a87dff1c1244211","2ae94c0cea4d480a9d5dca8fb1d7b542",22853418,1,20,0,1251,227,242,15
"a37477c4e4c14169ad44b06b493007f6","fab84b4fab5940efb4ea868ef8d09396",22853418,1,3,0,1268,283,284,1
"fab84b4fab5940efb4ea868ef8d09396","fab84b4fab5940efb4ea868ef8d09396",22853418,9,0,1,1269,284,284,0
"fab84b4fab5940efb4ea868ef8d09396","4a29443515bb404cb8924e1c60a63b73",22853418,10,4,0,1270,284,285,1
"4a29443515bb404cb8924e1c60a63b73","208c9b2796c944db8dacaa96082520ea",22853418,6,3,0,1271,285,288,3
"208c9b2796c944db8dacaa96082520ea","208c9b2796c944db8dacaa96082520ea",22853418,1,0,1,1272,288,288,0
"208c9b2796c944db8dacaa96082520ea","4a29443515bb404cb8924e1c60a63b73",22853418,8,-3,0,1273,288,285,-3
"4a29443515bb404cb8924e1c60a63b73","7669a956527947d0add87455277e80b4",22853418,1,7,0,1274,285,291,6
"7669a956527947d0add87455277e80b4","7669a956527947d0add87455277e80b4",22853418,1,0,1,1275,291,291,0
"7669a956527947d0add87455277e80b4","6a9a3b5bde4a48daa896fe8c06eca56f",22853418,1,-2,0,1276,291,289,-2
"6a9a3b5bde4a48daa896fe8c06eca56f","869e967078f04da18dd0b0b9389a7424",22853418,2,5,0,1277,289,293,4
"869e967078f04da18dd0b0b9389a7424","869e967078f04da18dd0b0b9389a7424",22853418,2,0,1,1278,293,293,0
"869e967078f04da18dd0b0b9389a7424","51ab6291537748fab90d519aa09889d6",22853418,1,2,0,1280,293,295,2
"51ab6291537748fab90d519aa09889d6","51ab6291537748fab90d519aa09889d6",22853418,5,0,1,1281,295,295,0
"51ab6291537748fab90d519aa09889d6","34a6e49023fc4465bd5ca604330bbd1c",22853418,1,-3,0,1286,295,292,-3
"34a6e49023fc4465bd5ca604330bbd1c","ba0e59461bfb4a44b7b1c28a01f8d3b3",22853418,2,9,0,1287,292,299,7
"ba0e59461bfb4a44b7b1c28a01f8d3b3","21592f2a9e9c4b2f8c66ec5dbcbf6a2b",22853418,2,-4,0,1288,299,296,-3
"21592f2a9e9c4b2f8c66ec5dbcbf6a2b","ba0e59461bfb4a44b7b1c28a01f8d3b3",22853418,1,4,0,1289,296,299,3
"ba0e59461bfb4a44b7b1c28a01f8d3b3","0e0b36e731a645e7b1b8a88f5031ca38",22853418,1,2,0,1290,299,301,2
"0e0b36e731a645e7b1b8a88f5031ca38","0e0b36e731a645e7b1b8a88f5031ca38",22853418,2,0,1,1291,301,301,0
"0e0b36e731a645e7b1b8a88f5031ca38","a66a144637284c21afc6de17fea4bfb8",22853418,1,1,0,1293,301,302,1
"a66a144637284c21afc6de17fea4bfb8","a66a144637284c21afc6de17fea4bfb8",22853418,2,0,1,1294,302,302,0
"a66a144637284c21afc6de17fea4bfb8","7646a919d7e64fa990bca9b024ff089d",22853418,1,-4,0,1296,302,298,-4
"7646a919d7e64fa990bca9b024ff089d","ba0e59461bfb4a44b7b1c28a01f8d3b3",22853418,1,1,0,1297,298,299,1
"ba0e59461bfb4a44b7b1c28a01f8d3b3","2c5bb2cbd0014420ad8c95d40e38efd1",22853418,1,5,0,1298,299,303,4
"2c5bb2cbd0014420ad8c95d40e38efd1","7646a919d7e64fa990bca9b024ff089d",22853418,1,-6,0,1299,303,298,-5
"7646a919d7e64fa990bca9b024ff089d","2c5bb2cbd0014420ad8c95d40e38efd1",22853418,1,6,0,1300,298,303,5
"2c5bb2cbd0014420ad8c95d40e38efd1","ba0e59461bfb4a44b7b1c28a01f8d3b3",22853418,1,-5,0,1301,303,299,-4
"ba0e59461bfb4a44b7b1c28a01f8d3b3","7646a919d7e64fa990bca9b024ff089d",22853418,2,-1,0,1302,299,298,-1
"7646a919d7e64fa990bca9b024ff089d","fab84b4fab5940efb4ea868ef8d09396",22853418,2,-21,0,1303,298,284,-14
"4a29443515bb404cb8924e1c60a63b73","4a29443515bb404cb8924e1c60a63b73",22853418,3,0,1,1306,285,285,0
"4a29443515bb404cb8924e1c60a63b73","fab84b4fab5940efb4ea868ef8d09396",22853418,9,-4,0,1307,285,284,-1
"fab84b4fab5940efb4ea868ef8d09396","208c9b2796c944db8dacaa96082520ea",22853418,4,7,0,1313,284,288,4
"4a29443515bb404cb8924e1c60a63b73","6a9a3b5bde4a48daa896fe8c06eca56f",22853418,2,5,0,1315,285,289,4
"6a9a3b5bde4a48daa896fe8c06eca56f","ba0e59461bfb4a44b7b1c28a01f8d3b3",22853418,1,13,0,1316,289,299,10
"4a29443515bb404cb8924e1c60a63b73","e390b575229748ea8aac9364efe2bf00",22853418,1,24,0,1324,285,304,19
"e390b575229748ea8aac9364efe2bf00","e390b575229748ea8aac9364efe2bf00",22853418,1,0,1,1325,304,304,0
"e390b575229748ea8aac9364efe2bf00","3434c10e561d488a914e0f7d71907abd",22853418,1,3,0,1326,304,305,1
"3434c10e561d488a914e0f7d71907abd","4a29443515bb404cb8924e1c60a63b73",22853418,7,-27,0,1327,305,285,-20
"4a29443515bb404cb8924e1c60a63b73","53e7e900392747ccad52e711ab0f80d8",22853418,4,29,0,1328,285,307,22
"53e7e900392747ccad52e711ab0f80d8","53e7e900392747ccad52e711ab0f80d8",22853418,3,0,1,1329,307,307,0
"53e7e900392747ccad52e711ab0f80d8","3434c10e561d488a914e0f7d71907abd",22853418,6,-2,0,1332,307,305,-2
"3434c10e561d488a914e0f7d71907abd","130acc2aeb0448fdbb2de63bc5cebe5b",22853418,2,5,0,1333,305,309,4
"130acc2aeb0448fdbb2de63bc5cebe5b","130acc2aeb0448fdbb2de63bc5cebe5b",22853418,2,0,1,1334,309,309,0
"130acc2aeb0448fdbb2de63bc5cebe5b","9c062b3251034ebe90f5054e2a3b5120",22853418,1,2,0,1336,309,311,2
"9c062b3251034ebe90f5054e2a3b5120","9c062b3251034ebe90f5054e2a3b5120",22853418,2,0,1,1337,311,311,0
"9c062b3251034ebe90f5054e2a3b5120","ea859f8207e44537889daeaba13ac2e8",22853418,1,1,0,1339,311,312,1
"ea859f8207e44537889daeaba13ac2e8","ea859f8207e44537889daeaba13ac2e8",22853418,1,0,1,1340,312,312,0
"ea859f8207e44537889daeaba13ac2e8","56d94971a7a94257aa330183a8ebd0ea",22853418,1,1,0,1341,312,313,1
"56d94971a7a94257aa330183a8ebd0ea","56d94971a7a94257aa330183a8ebd0ea",22853418,1,0,1,1342,313,313,0
"56d94971a7a94257aa330183a8ebd0ea","141c0df6cd1946539aadd1c9b7068cd4",22853418,1,-5,0,1343,313,308,-5
"141c0df6cd1946539aadd1c9b7068cd4","13255e63e0aa4abf85e5211bf613d43e",22853418,1,10,0,1344,308,317,9
"13255e63e0aa4abf85e5211bf613d43e","13255e63e0aa4abf85e5211bf613d43e",22853418,3,0,1,1345,317,317,0
"13255e63e0aa4abf85e5211bf613d43e","0c787d16c9504873b1a4d903cec09948",22853418,1,-3,0,1348,317,314,-3
"0c787d16c9504873b1a4d903cec09948","86c27d40179e419c8e9d150fb6afa5d0",22853418,2,6,0,1349,314,319,5
"86c27d40179e419c8e9d150fb6afa5d0","86c27d40179e419c8e9d150fb6afa5d0",22853418,1,0,1,1350,319,319,0
"86c27d40179e419c8e9d150fb6afa5d0","8d7e0b55cf9849cda222a0f2440cec55",22853418,1,-1,0,1351,319,318,-1
"8d7e0b55cf9849cda222a0f2440cec55","24f1363179ad4aaa965484a78471912b",22853418,2,6,0,1352,318,323,5
"24f1363179ad4aaa965484a78471912b","47edbb64109243e6b0f8f64cdef90c6c",22853418,1,3,0,1353,323,326,3
"47edbb64109243e6b0f8f64cdef90c6c","24f1363179ad4aaa965484a78471912b",22853418,2,-3,0,1354,326,323,-3
"24f1363179ad4aaa965484a78471912b","24f1363179ad4aaa965484a78471912b",22853418,1,0,1,1355,323,323,0
"24f1363179ad4aaa965484a78471912b","3628bdce1dd2429ba924d2d4d09448d2",22853418,2,-1,0,1356,323,322,-1
"3628bdce1dd2429ba924d2d4d09448d2","fab84b4fab5940efb4ea868ef8d09396",22853418,1,-52,0,1357,322,284,-38
"4a29443515bb404cb8924e1c60a63b73","3434c10e561d488a914e0f7d71907abd",22853418,7,27,0,1362,285,305,20
"3434c10e561d488a914e0f7d71907abd","56b3fd1a212a4764be39d979fde3326e",22853418,1,28,0,1366,305,328,23
"56b3fd1a212a4764be39d979fde3326e","56b3fd1a212a4764be39d979fde3326e",22853418,1,0,1,1367,328,328,0
"56b3fd1a212a4764be39d979fde3326e","0c4079457ede49e3aeb5e86ed84bdf35",22853418,1,3,0,1368,328,329,1
"0c4079457ede49e3aeb5e86ed84bdf35","3434c10e561d488a914e0f7d71907abd",22853418,7,-31,0,1369,329,305,-24
"3434c10e561d488a914e0f7d71907abd","38aea304b4fa46e1b29bb72f5cea4c93",22853418,4,33,0,1370,305,331,26
"38aea304b4fa46e1b29bb72f5cea4c93","38aea304b4fa46e1b29bb72f5cea4c93",22853418,3,0,1,1371,331,331,0
"38aea304b4fa46e1b29bb72f5cea4c93","e36d261332f14e79bb4b467aceaeb9b5",22853418,1,2,0,1373,331,333,2
"e36d261332f14e79bb4b467aceaeb9b5","e36d261332f14e79bb4b467aceaeb9b5",22853418,1,0,1,1374,333,333,0
"e36d261332f14e79bb4b467aceaeb9b5","c7e89b9d04744d2eab742fc24e3ef1ae",22853418,1,1,0,1375,333,334,1
"c7e89b9d04744d2eab742fc24e3ef1ae","c7e89b9d04744d2eab742fc24e3ef1ae",22853418,2,0,1,1376,334,334,0
"c7e89b9d04744d2eab742fc24e3ef1ae","fe49f8054b374a0ea4bb266ed135ff62",22853418,1,1,0,1378,334,335,1
"fe49f8054b374a0ea4bb266ed135ff62","fe49f8054b374a0ea4bb266ed135ff62",22853418,2,0,1,1379,335,335,0
"fe49f8054b374a0ea4bb266ed135ff62","d0a8f74af98642fe8360d22c42e45117",22853418,1,1,0,1381,335,336,1
"d0a8f74af98642fe8360d22c42e45117","d0a8f74af98642fe8360d22c42e45117",22853418,2,0,1,1382,336,336,0
"d0a8f74af98642fe8360d22c42e45117","0c4079457ede49e3aeb5e86ed84bdf35",22853418,1,-7,0,1384,336,329,-7
"0c4079457ede49e3aeb5e86ed84bdf35","a7c6339ca1da4368a18d471f0519f877",22853418,1,11,0,1385,329,339,10
"a7c6339ca1da4368a18d471f0519f877","a7c6339ca1da4368a18d471f0519f877",22853418,1,0,1,1386,339,339,0
"a7c6339ca1da4368a18d471f0519f877","b8b9418ab322418d9db9b40d96af873a",22853418,1,-2,0,1387,339,337,-2
"b8b9418ab322418d9db9b40d96af873a","bbc5139ca9024389a94db3a6f47dcff6",22853418,2,5,0,1388,337,341,4
"bbc5139ca9024389a94db3a6f47dcff6","bbc5139ca9024389a94db3a6f47dcff6",22853418,2,0,1,1389,341,341,0
"bbc5139ca9024389a94db3a6f47dcff6","4ee6ca9019ab4a1ab323f98094a9bd77",22853418,1,2,0,1391,341,343,2
"4ee6ca9019ab4a1ab323f98094a9bd77","4ee6ca9019ab4a1ab323f98094a9bd77",22853418,2,0,1,1392,343,343,0
"4ee6ca9019ab4a1ab323f98094a9bd77","b37947176785476f8b29d49a851366dc",22853418,1,1,0,1394,343,344,1
"b37947176785476f8b29d49a851366dc","b37947176785476f8b29d49a851366dc",22853418,2,0,1,1395,344,344,0
"b37947176785476f8b29d49a851366dc","fcea5b10d5a14a3b9324ffece8f6e1e5",22853418,1,1,0,1397,344,345,1
"fcea5b10d5a14a3b9324ffece8f6e1e5","fcea5b10d5a14a3b9324ffece8f6e1e5",22853418,2,0,1,1398,345,345,0
"fcea5b10d5a14a3b9324ffece8f6e1e5","c2490bc612d146edbe786556fab3651b",22853418,1,-5,0,1400,345,340,-5
"c2490bc612d146edbe786556fab3651b","fab84b4fab5940efb4ea868ef8d09396",22853418,1,-75,0,1401,340,284,-56
"3434c10e561d488a914e0f7d71907abd","0c4079457ede49e3aeb5e86ed84bdf35",22853418,4,31,0,1410,305,329,24
"38aea304b4fa46e1b29bb72f5cea4c93","0c4079457ede49e3aeb5e86ed84bdf35",22853418,6,-2,0,1413,331,329,-2
"0c4079457ede49e3aeb5e86ed84bdf35","6ac8bb048b854999a47edb35fe627f11",22853418,1,21,0,1414,329,347,18
"6ac8bb048b854999a47edb35fe627f11","4a92daef4d504e1792575a26502bb7b7",22853418,1,-1,0,1415,347,346,-1
"4a92daef4d504e1792575a26502bb7b7","b8b9418ab322418d9db9b40d96af873a",22853418,1,-11,0,1416,346,337,-9
"b8b9418ab322418d9db9b40d96af873a","38aea304b4fa46e1b29bb72f5cea4c93",22853418,1,-7,0,1417,337,331,-6
"3434c10e561d488a914e0f7d71907abd","47edbb64109243e6b0f8f64cdef90c6c",22853418,1,25,0,1420,305,326,21
"47edbb64109243e6b0f8f64cdef90c6c","43ea1b823a4b4e51b7c694c10725db82",22853418,1,2,0,1421,326,327,1
"43ea1b823a4b4e51b7c694c10725db82","24f1363179ad4aaa965484a78471912b",22853418,1,-5,0,1422,327,323,-4
"24f1363179ad4aaa965484a78471912b","130acc2aeb0448fdbb2de63bc5cebe5b",22853418,1,-17,0,1423,323,309,-14
"130acc2aeb0448fdbb2de63bc5cebe5b","3628bdce1dd2429ba924d2d4d09448d2",22853418,1,16,0,1424,309,322,13
"3628bdce1dd2429ba924d2d4d09448d2","141c0df6cd1946539aadd1c9b7068cd4",22853418,1,-17,0,1425,322,308,-14
"141c0df6cd1946539aadd1c9b7068cd4","0c787d16c9504873b1a4d903cec09948",22853418,2,7,0,1426,308,314,6
"0c787d16c9504873b1a4d903cec09948","53e7e900392747ccad52e711ab0f80d8",22853418,1,-9,0,1427,314,307,-7
"208c9b2796c944db8dacaa96082520ea","2c5bb2cbd0014420ad8c95d40e38efd1",22853418,4,20,0,1431,288,303,15
"2c5bb2cbd0014420ad8c95d40e38efd1","4a29443515bb404cb8924e1c60a63b73",22853418,3,-23,0,1432,303,285,-18
"869e967078f04da18dd0b0b9389a7424","34a6e49023fc4465bd5ca604330bbd1c",22853418,1,-1,0,1435,293,292,-1
"21592f2a9e9c4b2f8c66ec5dbcbf6a2b","7646a919d7e64fa990bca9b024ff089d",22853418,1,3,0,1438,296,298,2
"7646a919d7e64fa990bca9b024ff089d","4a29443515bb404cb8924e1c60a63b73",22853418,1,-17,0,1439,298,285,-13
"3434c10e561d488a914e0f7d71907abd","53e7e900392747ccad52e711ab0f80d8",22853418,5,2,0,1441,305,307,2
"130acc2aeb0448fdbb2de63bc5cebe5b","141c0df6cd1946539aadd1c9b7068cd4",22853418,1,-1,0,1444,309,308,-1
"86c27d40179e419c8e9d150fb6afa5d0","47edbb64109243e6b0f8f64cdef90c6c",22853418,1,8,0,1447,319,326,7
"47edbb64109243e6b0f8f64cdef90c6c","8d7e0b55cf9849cda222a0f2440cec55",22853418,1,-9,0,1448,326,318,-8
"3628bdce1dd2429ba924d2d4d09448d2","3434c10e561d488a914e0f7d71907abd",22853418,1,-21,0,1451,322,305,-17
"0c4079457ede49e3aeb5e86ed84bdf35","38aea304b4fa46e1b29bb72f5cea4c93",22853418,2,2,0,1453,329,331,2
"0c4079457ede49e3aeb5e86ed84bdf35","b8b9418ab322418d9db9b40d96af873a",22853418,1,9,0,1456,329,337,8
"bbc5139ca9024389a94db3a6f47dcff6","c2490bc612d146edbe786556fab3651b",22853418,1,-1,0,1458,341,340,-1
"c2490bc612d146edbe786556fab3651b","6ac8bb048b854999a47edb35fe627f11",22853418,1,8,0,1459,340,347,7
"6ac8bb048b854999a47edb35fe627f11","6ac8bb048b854999a47edb35fe627f11",22853418,1,0,1,1460,347,347,0
"6ac8bb048b854999a47edb35fe627f11","0c4079457ede49e3aeb5e86ed84bdf35",22853418,1,-21,0,1461,347,329,-18
"0c4079457ede49e3aeb5e86ed84bdf35","30ead9794d4847abaf222ca966cc8630",22853418,4,24,0,1462,329,348,19
"30ead9794d4847abaf222ca966cc8630","c20993c944444fe085345591a8bd837e",22853418,4,3,0,1463,348,351,3
"c20993c944444fe085345591a8bd837e","897b7f51242c44aab2205c72fdcbf4cd",22853418,4,1,0,1464,351,352,1
"897b7f51242c44aab2205c72fdcbf4cd","09b9678ddc3d452ea4a3d46e15826065",22853418,6,1,0,1465,352,353,1
"09b9678ddc3d452ea4a3d46e15826065","eff0de7f2dbb42dfa1a2e686efab5b6d",22853418,5,1,0,1466,353,354,1
"eff0de7f2dbb42dfa1a2e686efab5b6d","c20993c944444fe085345591a8bd837e",22853418,1,-3,0,1467,354,351,-3
"c20993c944444fe085345591a8bd837e","c20993c944444fe085345591a8bd837e",22853418,12,0,1,1468,351,351,0
"897b7f51242c44aab2205c72fdcbf4cd","897b7f51242c44aab2205c72fdcbf4cd",22853418,10,0,1,1472,352,352,0
"09b9678ddc3d452ea4a3d46e15826065","09b9678ddc3d452ea4a3d46e15826065",22853418,9,0,1,1476,353,353,0
"eff0de7f2dbb42dfa1a2e686efab5b6d","eff0de7f2dbb42dfa1a2e686efab5b6d",22853418,8,0,1,1480,354,354,0
"eff0de7f2dbb42dfa1a2e686efab5b6d","30ead9794d4847abaf222ca966cc8630",22853418,5,-6,0,1483,354,348,-6
"30ead9794d4847abaf222ca966cc8630","2fe14166dc9642c3bc666b86a57f943d",22853418,1,10,0,1484,348,357,9
"2fe14166dc9642c3bc666b86a57f943d","2fe14166dc9642c3bc666b86a57f943d",22853418,1,0,1,1485,357,357,0
"2fe14166dc9642c3bc666b86a57f943d","44421dd1e13a47a388c4a19834b744c7",22853418,1,2,0,1486,357,359,2
"44421dd1e13a47a388c4a19834b744c7","44421dd1e13a47a388c4a19834b744c7",22853418,2,0,1,1487,359,359,0
"44421dd1e13a47a388c4a19834b744c7","cb5fc7ef85d547c4be1a7439d0bf6052",22853418,1,1,0,1489,359,360,1
"cb5fc7ef85d547c4be1a7439d0bf6052","cb5fc7ef85d547c4be1a7439d0bf6052",22853418,2,0,1,1490,360,360,0
"cb5fc7ef85d547c4be1a7439d0bf6052","0a8f150a4cf747acbde62f4721823da3",22853418,1,1,0,1492,360,361,1
"0a8f150a4cf747acbde62f4721823da3","0a8f150a4cf747acbde62f4721823da3",22853418,5,0,1,1493,361,361,0
"0a8f150a4cf747acbde62f4721823da3","ab8fdad974ae471f9f24c3f9dd04462e",22853418,1,1,0,1498,361,362,1
"ab8fdad974ae471f9f24c3f9dd04462e","ab8fdad974ae471f9f24c3f9dd04462e",22853418,2,0,1,1499,362,362,0
"ab8fdad974ae471f9f24c3f9dd04462e","1ba8fef685d74a8194b9db252eb704fb",22853418,1,-7,0,1501,362,355,-7
"1ba8fef685d74a8194b9db252eb704fb","52580888dadb4fe3baa795683ea227bd",22853418,1,10,0,1502,355,364,9
"52580888dadb4fe3baa795683ea227bd","52580888dadb4fe3baa795683ea227bd",22853418,1,0,1,1503,364,364,0
"52580888dadb4fe3baa795683ea227bd","f00179e251a045b39c3f7a54f9aa4acc",22853418,1,-1,0,1504,364,363,-1
"f00179e251a045b39c3f7a54f9aa4acc","492a3bc6a1254f23a7998587961b22a4",22853418,1,4,0,1505,363,366,3
"492a3bc6a1254f23a7998587961b22a4","492a3bc6a1254f23a7998587961b22a4",22853418,2,0,1,1506,366,366,0
"492a3bc6a1254f23a7998587961b22a4","072a190fd302456290895f9f04d6940a",22853418,1,-1,0,1508,366,365,-1
"072a190fd302456290895f9f04d6940a","cfa457d1743848e4bb5e4beced6448ed",22853418,1,5,0,1509,365,369,4
"cfa457d1743848e4bb5e4beced6448ed","cfa457d1743848e4bb5e4beced6448ed",22853418,1,0,1,1510,369,369,0
"cfa457d1743848e4bb5e4beced6448ed","b71bac264efb4abd97015447bd490db6",22853418,1,3,0,1511,369,370,1
"b71bac264efb4abd97015447bd490db6","30ead9794d4847abaf222ca966cc8630",22853418,4,-28,0,1512,370,348,-22
"30ead9794d4847abaf222ca966cc8630","b71bac264efb4abd97015447bd490db6",22853418,4,28,0,1513,348,370,22
"b71bac264efb4abd97015447bd490db6","8d448d625b024c82a5eb240bbd7431d6",22853418,8,5,0,1514,370,374,4
"8d448d625b024c82a5eb240bbd7431d6","8d448d625b024c82a5eb240bbd7431d6",22853418,105,0,1,1515,374,374,0
"8d448d625b024c82a5eb240bbd7431d6","0c7262dff33c4087bc660ccf40f92f9c",22853418,1,-272,0,1522,374,169,-205
"bc5524e78a8544e2ae2fdc2f3462bbec","0d987bed3ffa4ed0b9a2e62e97b7b30f",22853418,1,-9,0,1551,279,272,-7
"a37477c4e4c14169ad44b06b493007f6","94cecc3f1e7d484b8e068e79241dfd73",22853418,8,-2,0,1554,283,281,-2
"94cecc3f1e7d484b8e068e79241dfd73","fab84b4fab5940efb4ea868ef8d09396",22853418,3,5,0,1555,281,284,3
"53e7e900392747ccad52e711ab0f80d8","0c4079457ede49e3aeb5e86ed84bdf35",22853418,1,29,0,1563,307,329,22
"3434c10e561d488a914e0f7d71907abd","3434c10e561d488a914e0f7d71907abd",22853418,1,0,1,1565,305,305,0
"0c4079457ede49e3aeb5e86ed84bdf35","0c4079457ede49e3aeb5e86ed84bdf35",22853418,1,0,1,1568,329,329,0
"30ead9794d4847abaf222ca966cc8630","09b9678ddc3d452ea4a3d46e15826065",22853418,3,5,0,1570,348,353,5
"09b9678ddc3d452ea4a3d46e15826065","c20993c944444fe085345591a8bd837e",22853418,5,-2,0,1571,353,351,-2
"c20993c944444fe085345591a8bd837e","eff0de7f2dbb42dfa1a2e686efab5b6d",22853418,4,3,0,1572,351,354,3
"eff0de7f2dbb42dfa1a2e686efab5b6d","897b7f51242c44aab2205c72fdcbf4cd",22853418,7,-2,0,1573,354,352,-2
"897b7f51242c44aab2205c72fdcbf4cd","c20993c944444fe085345591a8bd837e",22853418,2,-1,0,1574,352,351,-1
"c20993c944444fe085345591a8bd837e","09b9678ddc3d452ea4a3d46e15826065",22853418,4,2,0,1576,351,353,2
"09b9678ddc3d452ea4a3d46e15826065","897b7f51242c44aab2205c72fdcbf4cd",22853418,3,-1,0,1578,353,352,-1
"897b7f51242c44aab2205c72fdcbf4cd","eff0de7f2dbb42dfa1a2e686efab5b6d",22853418,5,2,0,1580,352,354,2
"30ead9794d4847abaf222ca966cc8630","30ead9794d4847abaf222ca966cc8630",22853418,1,0,1,1583,348,348,0
"8d448d625b024c82a5eb240bbd7431d6","b71bac264efb4abd97015447bd490db6",22853418,3,-5,0,1586,374,370,-4
"8d448d625b024c82a5eb240bbd7431d6","fab84b4fab5940efb4ea868ef8d09396",22853418,1,-119,0,1594,374,284,-90
"30ead9794d4847abaf222ca966cc8630","0c4079457ede49e3aeb5e86ed84bdf35",22853418,2,-24,0,1608,348,329,-19
"0c4079457ede49e3aeb5e86ed84bdf35","c20993c944444fe085345591a8bd837e",22853418,1,27,0,1609,329,351,22
"897b7f51242c44aab2205c72fdcbf4cd","b71bac264efb4abd97015447bd490db6",22853418,1,24,0,1622,352,370,18
"30ead9794d4847abaf222ca966cc8630","8d448d625b024c82a5eb240bbd7431d6",22853418,1,33,0,1624,348,374,26
"8d448d625b024c82a5eb240bbd7431d6","66baf19b6b904b70922329068c63746d",22853418,1,7,0,1658,374,376,2
"66baf19b6b904b70922329068c63746d","7f544639412e40a9ba27f43b415362ab",22853418,10,2,0,1659,376,378,2
"7f544639412e40a9ba27f43b415362ab","7f544639412e40a9ba27f43b415362ab",22853418,1,0,1,1660,378,378,0
"7f544639412e40a9ba27f43b415362ab","d5ae8642e15b46b8bd298b02274d4e9c",22853418,1,2,0,1661,378,380,2
"d5ae8642e15b46b8bd298b02274d4e9c","d5ae8642e15b46b8bd298b02274d4e9c",22853418,1,0,1,1662,380,380,0
"d5ae8642e15b46b8bd298b02274d4e9c","a0d10309a2dd456289147f84be9d37f9",22853418,1,1,0,1663,380,381,1
"a0d10309a2dd456289147f84be9d37f9","a0d10309a2dd456289147f84be9d37f9",22853418,2,0,1,1664,381,381,0
"a0d10309a2dd456289147f84be9d37f9","0fcbc3ca07b144138b8d85da581f09a8",22853418,1,1,0,1666,381,382,1
"0fcbc3ca07b144138b8d85da581f09a8","0fcbc3ca07b144138b8d85da581f09a8",22853418,2,0,1,1667,382,382,0
"0fcbc3ca07b144138b8d85da581f09a8","66baf19b6b904b70922329068c63746d",22853418,1,-6,0,1669,382,376,-6
"66baf19b6b904b70922329068c63746d","4890121ce5d74576b4632b77cfc23398",22853418,1,14,0,1670,376,388,12
"4890121ce5d74576b4632b77cfc23398","c2fca3669923477ab966ded303dea31c",22853418,1,-6,0,1671,388,383,-5
"c2fca3669923477ab966ded303dea31c","4890121ce5d74576b4632b77cfc23398",22853418,2,6,0,1672,383,388,5
"4890121ce5d74576b4632b77cfc23398","18d3b836dd804224883cc9180b60a8e1",22853418,1,-1,0,1673,388,387,-1
"18d3b836dd804224883cc9180b60a8e1","96bb2b3e85a34d8b9544514e89f6fe97",22853418,1,4,0,1674,387,390,3
"96bb2b3e85a34d8b9544514e89f6fe97","96bb2b3e85a34d8b9544514e89f6fe97",22853418,1,0,1,1675,390,390,0
"96bb2b3e85a34d8b9544514e89f6fe97","ac4e9b54acfe4670b4634859c7263cb5",22853418,1,2,0,1676,390,392,2
"ac4e9b54acfe4670b4634859c7263cb5","ac4e9b54acfe4670b4634859c7263cb5",22853418,1,0,1,1677,392,392,0
"ac4e9b54acfe4670b4634859c7263cb5","17f95d18bab743888e1736033dc3384d",22853418,1,-3,0,1678,392,389,-3
"17f95d18bab743888e1736033dc3384d","6f8881a745ac4c358a68b92c3b4abe81",22853418,1,6,0,1679,389,394,5
"6f8881a745ac4c358a68b92c3b4abe81","6f8881a745ac4c358a68b92c3b4abe81",22853418,1,0,1,1680,394,394,0
"6f8881a745ac4c358a68b92c3b4abe81","f7002c8484354eceac57bc7bd62c76c1",22853418,1,-1,0,1681,394,393,-1
"f7002c8484354eceac57bc7bd62c76c1","66baf19b6b904b70922329068c63746d",22853418,1,-21,0,1682,393,376,-17
"7f544639412e40a9ba27f43b415362ab","66baf19b6b904b70922329068c63746d",22853418,6,-2,0,1684,378,376,-2
"66baf19b6b904b70922329068c63746d","44a277ea44dc4ae689fab4b82f0b4098",22853418,1,26,0,1685,376,397,21
"44a277ea44dc4ae689fab4b82f0b4098","44a277ea44dc4ae689fab4b82f0b4098",22853418,1,0,1,1686,397,397,0
"44a277ea44dc4ae689fab4b82f0b4098","0c12af0a4e7f4002852cf84b2537c161",22853418,1,-2,0,1687,397,395,-2
"0c12af0a4e7f4002852cf84b2537c161","66baf19b6b904b70922329068c63746d",22853418,1,-24,0,1688,395,376,-19
"66baf19b6b904b70922329068c63746d","859e0b8d71694b12befb69ee698138f9",22853418,1,29,0,1691,376,399,23
"859e0b8d71694b12befb69ee698138f9","859e0b8d71694b12befb69ee698138f9",22853418,1,0,1,1692,399,399,0
"859e0b8d71694b12befb69ee698138f9","66baf19b6b904b70922329068c63746d",22853418,1,-29,0,1693,399,376,-23
"66baf19b6b904b70922329068c63746d","2b09a08242b54983aec7063990fb3f66",22853418,9,32,0,1694,376,400,24
"2b09a08242b54983aec7063990fb3f66","2b09a08242b54983aec7063990fb3f66",22853418,15,0,1,1695,400,400,0
"2b09a08242b54983aec7063990fb3f66","1f471b7a883a4df48211e8c6a81b59a7",22853418,1,1,0,1698,400,401,1
"1f471b7a883a4df48211e8c6a81b59a7","1f471b7a883a4df48211e8c6a81b59a7",22853418,1,0,1,1699,401,401,0
"1f471b7a883a4df48211e8c6a81b59a7","2b09a08242b54983aec7063990fb3f66",22853418,1,-1,0,1700,401,400,-1
"2b09a08242b54983aec7063990fb3f66","9de0d567bfa84fe5b77cb76f4a76a5d1",22853418,1,5,0,1701,400,404,4
"9de0d567bfa84fe5b77cb76f4a76a5d1","9de0d567bfa84fe5b77cb76f4a76a5d1",22853418,1,0,1,1702,404,404,0
"9de0d567bfa84fe5b77cb76f4a76a5d1","1157bd665ec4472fb58b751dc5099355",22853418,1,-1,0,1703,404,403,-1
"1157bd665ec4472fb58b751dc5099355","3c8a22d2f9c146ea956609e3ed4f2559",22853418,1,3,0,1704,403,405,2
"3c8a22d2f9c146ea956609e3ed4f2559","58fc9094275e4c49be3f4ba6d4acc0a4",22853418,1,2,0,1705,405,406,1
"58fc9094275e4c49be3f4ba6d4acc0a4","58fc9094275e4c49be3f4ba6d4acc0a4",22853418,1,0,1,1706,406,406,0
"58fc9094275e4c49be3f4ba6d4acc0a4","c1c1be90b2b14c1ab4a5e1ee3c241902",22853418,1,1,0,1707,406,407,1
"c1c1be90b2b14c1ab4a5e1ee3c241902","c1c1be90b2b14c1ab4a5e1ee3c241902",22853418,5,0,1,1708,407,407,0
"c1c1be90b2b14c1ab4a5e1ee3c241902","58fc9094275e4c49be3f4ba6d4acc0a4",22853418,1,-1,0,1713,407,406,-1
"58fc9094275e4c49be3f4ba6d4acc0a4","02b3a1bead9244c1ba2f857c7da8f82a",22853418,1,3,0,1714,406,408,2
"02b3a1bead9244c1ba2f857c7da8f82a","02b3a1bead9244c1ba2f857c7da8f82a",22853418,1,0,1,1715,408,408,0
"02b3a1bead9244c1ba2f857c7da8f82a","6206fc6479014bb193084c32409dc1b9",22853418,1,1,0,1716,408,409,1
"6206fc6479014bb193084c32409dc1b9","6206fc6479014bb193084c32409dc1b9",22853418,1,0,1,1717,409,409,0
"6206fc6479014bb193084c32409dc1b9","02b3a1bead9244c1ba2f857c7da8f82a",22853418,1,-1,0,1718,409,408,-1
"02b3a1bead9244c1ba2f857c7da8f82a","6a5f020451db426dacba9e2ea3fcc62a",22853418,1,3,0,1719,408,410,2
"6a5f020451db426dacba9e2ea3fcc62a","6a5f020451db426dacba9e2ea3fcc62a",22853418,5,0,1,1720,410,410,0
"6a5f020451db426dacba9e2ea3fcc62a","33a9d248b2e44588a5b07fc1342b9bc2",22853418,2,2,0,1723,410,411,1
"33a9d248b2e44588a5b07fc1342b9bc2","33a9d248b2e44588a5b07fc1342b9bc2",22853418,2,0,1,1724,411,411,0
"33a9d248b2e44588a5b07fc1342b9bc2","6a5f020451db426dacba9e2ea3fcc62a",22853418,1,-2,0,1725,411,410,-1
"33a9d248b2e44588a5b07fc1342b9bc2","c6f26bd420634f1cb7989e76fe6b16c0",22853418,1,1,0,1730,411,412,1
"c6f26bd420634f1cb7989e76fe6b16c0","c6f26bd420634f1cb7989e76fe6b16c0",22853418,5,0,1,1731,412,412,0
"c6f26bd420634f1cb7989e76fe6b16c0","2a65ee6e2ac64f6a8a55fbe5373ec763",22853418,1,1,0,1736,412,413,1
"2a65ee6e2ac64f6a8a55fbe5373ec763","2a65ee6e2ac64f6a8a55fbe5373ec763",22853418,2,0,1,1737,413,413,0
"2a65ee6e2ac64f6a8a55fbe5373ec763","33a9d248b2e44588a5b07fc1342b9bc2",22853418,1,-2,0,1739,413,411,-2
"33a9d248b2e44588a5b07fc1342b9bc2","66baf19b6b904b70922329068c63746d",22853418,1,-49,0,1740,411,376,-35
"7f544639412e40a9ba27f43b415362ab","c2fca3669923477ab966ded303dea31c",22853418,1,6,0,1744,378,383,5
"c2fca3669923477ab966ded303dea31c","66baf19b6b904b70922329068c63746d",22853418,1,-8,0,1745,383,376,-7
"66baf19b6b904b70922329068c63746d","c2fca3669923477ab966ded303dea31c",22853418,1,8,0,1746,376,383,7
"c2fca3669923477ab966ded303dea31c","2b09a08242b54983aec7063990fb3f66",22853418,1,24,0,1747,383,400,17
"2b09a08242b54983aec7063990fb3f66","66baf19b6b904b70922329068c63746d",22853418,5,-32,0,1748,400,376,-24
"2b09a08242b54983aec7063990fb3f66","1fd0f6dadbc14ebc965faf6122190b96",22853418,1,22,0,1751,400,415,15
"1fd0f6dadbc14ebc965faf6122190b96","1fd0f6dadbc14ebc965faf6122190b96",22853418,1,0,1,1752,415,415,0
"1fd0f6dadbc14ebc965faf6122190b96","687055dad9fc40c3982478fe33ec01bf",22853418,1,-1,0,1753,415,414,-1
"687055dad9fc40c3982478fe33ec01bf","66baf19b6b904b70922329068c63746d",22853418,1,-53,0,1754,414,376,-38
"66baf19b6b904b70922329068c63746d","18d3b836dd804224883cc9180b60a8e1",22853418,1,13,0,1757,376,387,11
"18d3b836dd804224883cc9180b60a8e1","c2fca3669923477ab966ded303dea31c",22853418,1,-5,0,1758,387,383,-4
"4890121ce5d74576b4632b77cfc23398","17f95d18bab743888e1736033dc3384d",22853418,1,2,0,1760,388,389,1
"17f95d18bab743888e1736033dc3384d","96bb2b3e85a34d8b9544514e89f6fe97",22853418,1,1,0,1761,389,390,1
"96bb2b3e85a34d8b9544514e89f6fe97","66baf19b6b904b70922329068c63746d",22853418,1,-17,0,1762,390,376,-14
"2b09a08242b54983aec7063990fb3f66","2add1669f08d4101913db15f8c23b3b7",22853418,4,24,0,1766,400,416,16
"2add1669f08d4101913db15f8c23b3b7","2add1669f08d4101913db15f8c23b3b7",22853418,1,0,1,1767,416,416,0
"2add1669f08d4101913db15f8c23b3b7","2b09a08242b54983aec7063990fb3f66",22853418,4,-24,0,1768,416,400,-16
"2b09a08242b54983aec7063990fb3f66","a2b4bd40cee2481ebd3fc179d6a5cd62",22853418,5,27,0,1769,400,417,17
"a2b4bd40cee2481ebd3fc179d6a5cd62","e34e59dce2204f228f3a84b6725df60f",22853418,1,2,0,1770,417,419,2
"e34e59dce2204f228f3a84b6725df60f","e34e59dce2204f228f3a84b6725df60f",22853418,1,0,1,1771,419,419,0
"e34e59dce2204f228f3a84b6725df60f","a2b4bd40cee2481ebd3fc179d6a5cd62",22853418,1,-2,0,1772,419,417,-2
"a2b4bd40cee2481ebd3fc179d6a5cd62","bec48fc2e1294c7eb3d0aca780d731b8",22853418,2,4,0,1773,417,420,3
"bec48fc2e1294c7eb3d0aca780d731b8","bec48fc2e1294c7eb3d0aca780d731b8",22853418,2,0,1,1774,420,420,0
"bec48fc2e1294c7eb3d0aca780d731b8","dbde19fcce2a4c1abdc7f685c293a23f",22853418,1,3,0,1776,420,422,2
"dbde19fcce2a4c1abdc7f685c293a23f","a24600b0e49245f6bdba8c893cfeddb0",22853418,1,4,0,1777,422,425,3
"a24600b0e49245f6bdba8c893cfeddb0","a24600b0e49245f6bdba8c893cfeddb0",22853418,2,0,1,1778,425,425,0
"a24600b0e49245f6bdba8c893cfeddb0","24cf8786024543f19b89bc20034e60d7",22853418,1,7,0,1780,425,428,3
"24cf8786024543f19b89bc20034e60d7","a2b4bd40cee2481ebd3fc179d6a5cd62",22853418,3,-18,0,1781,428,417,-11
"a2b4bd40cee2481ebd3fc179d6a5cd62","f2a73be2f46840b182d7bd095378004e",22853418,2,19,0,1782,417,429,12
"f2a73be2f46840b182d7bd095378004e","f2a73be2f46840b182d7bd095378004e",22853418,1,0,1,1783,429,429,0
"f2a73be2f46840b182d7bd095378004e","604551fd4266430cb860fef58fa7dd61",22853418,1,1,0,1784,429,430,1
"604551fd4266430cb860fef58fa7dd61","604551fd4266430cb860fef58fa7dd61",22853418,4,0,1,1785,430,430,0
"604551fd4266430cb860fef58fa7dd61","dce46f8904594a62a6377a3587aaa663",22853418,1,2,0,1789,430,431,1
"dce46f8904594a62a6377a3587aaa663","24cf8786024543f19b89bc20034e60d7",22853418,1,-4,0,1790,431,428,-3
"24cf8786024543f19b89bc20034e60d7","dce46f8904594a62a6377a3587aaa663",22853418,3,4,0,1791,428,431,3
"dce46f8904594a62a6377a3587aaa663","dce46f8904594a62a6377a3587aaa663",22853418,3,0,1,1792,431,431,0
"dce46f8904594a62a6377a3587aaa663","9b9d0a249052413c869753b99682b0ac",22853418,1,1,0,1793,431,432,1
"9b9d0a249052413c869753b99682b0ac","9b9d0a249052413c869753b99682b0ac",22853418,1,0,1,1794,432,432,0
"9b9d0a249052413c869753b99682b0ac","061c175cc90f45fbad883025394e78dd",22853418,1,1,0,1795,432,433,1
"061c175cc90f45fbad883025394e78dd","061c175cc90f45fbad883025394e78dd",22853418,5,0,1,1796,433,433,0
"061c175cc90f45fbad883025394e78dd","dce46f8904594a62a6377a3587aaa663",22853418,1,-2,0,1801,433,431,-2
"dce46f8904594a62a6377a3587aaa663","74a7f8712e5449c2bc0b43c6f90dafed",22853418,1,5,0,1802,431,435,4
"74a7f8712e5449c2bc0b43c6f90dafed","74a7f8712e5449c2bc0b43c6f90dafed",22853418,1,0,1,1803,435,435,0
"74a7f8712e5449c2bc0b43c6f90dafed","66ada10dde9f43018588f1ced9d477fc",22853418,1,-1,0,1804,435,434,-1
"66ada10dde9f43018588f1ced9d477fc","66baf19b6b904b70922329068c63746d",22853418,1,-85,0,1805,434,376,-58
"2b09a08242b54983aec7063990fb3f66","1157bd665ec4472fb58b751dc5099355",22853418,1,4,0,1812,400,403,3
"1157bd665ec4472fb58b751dc5099355","a2b4bd40cee2481ebd3fc179d6a5cd62",22853418,1,23,0,1813,403,417,14
"a2b4bd40cee2481ebd3fc179d6a5cd62","2b09a08242b54983aec7063990fb3f66",22853418,5,-27,0,1814,417,400,-17
"a2b4bd40cee2481ebd3fc179d6a5cd62","24cf8786024543f19b89bc20034e60d7",22853418,6,18,0,1816,417,428,11
"f2a73be2f46840b182d7bd095378004e","24cf8786024543f19b89bc20034e60d7",22853418,4,-1,0,1819,429,428,-1
"dce46f8904594a62a6377a3587aaa663","bf12c96466d840a69bed7020b3f18bb8",22853418,1,7,0,1822,431,436,5
"bf12c96466d840a69bed7020b3f18bb8","bf12c96466d840a69bed7020b3f18bb8",22853418,1,0,1,1823,436,436,0
"bf12c96466d840a69bed7020b3f18bb8","070600601c4c439288445d2f0724807d",22853418,1,3,0,1824,436,437,1
"070600601c4c439288445d2f0724807d","24cf8786024543f19b89bc20034e60d7",22853418,4,-14,0,1825,437,428,-9
"24cf8786024543f19b89bc20034e60d7","1823b6de7d334a7aaabc4570719af4d9",22853418,3,16,0,1826,428,439,11
"1823b6de7d334a7aaabc4570719af4d9","070600601c4c439288445d2f0724807d",22853418,6,-2,0,1827,439,437,-2
"070600601c4c439288445d2f0724807d","b2f0d654738f48158edff28e8d3a546e",22853418,9,21,0,1828,437,449,12
"b2f0d654738f48158edff28e8d3a546e","070600601c4c439288445d2f0724807d",22853418,7,-21,0,1829,449,437,-12
"070600601c4c439288445d2f0724807d","8a7f26e690f34dda97be16904518ca99",22853418,3,16,0,1832,437,447,10
"8a7f26e690f34dda97be16904518ca99","1823b6de7d334a7aaabc4570719af4d9",22853418,2,-14,0,1833,447,439,-8
"1823b6de7d334a7aaabc4570719af4d9","1823b6de7d334a7aaabc4570719af4d9",22853418,11,0,1,1834,439,439,0
"1823b6de7d334a7aaabc4570719af4d9","0380cd76a7d44bc3a4da1f15e4d68f89",22853418,1,2,0,1845,439,440,1
"0380cd76a7d44bc3a4da1f15e4d68f89","070600601c4c439288445d2f0724807d",22853418,1,-4,0,1846,440,437,-3
"070600601c4c439288445d2f0724807d","0380cd76a7d44bc3a4da1f15e4d68f89",22853418,1,4,0,1847,437,440,3
"0380cd76a7d44bc3a4da1f15e4d68f89","23b7673c8b5443108c2ef09382834a86",22853418,2,2,0,1848,440,441,1
"23b7673c8b5443108c2ef09382834a86","0380cd76a7d44bc3a4da1f15e4d68f89",22853418,1,-2,0,1849,441,440,-1
"23b7673c8b5443108c2ef09382834a86","23b7673c8b5443108c2ef09382834a86",22853418,1,0,1,1851,441,441,0
"23b7673c8b5443108c2ef09382834a86","901e92500aea43c79f19f1b279050668",22853418,1,2,0,1852,441,442,1
"901e92500aea43c79f19f1b279050668","901e92500aea43c79f19f1b279050668",22853418,1,0,1,1853,442,442,0
"901e92500aea43c79f19f1b279050668","001339db8ced4cf78829ebe8b145449d",22853418,1,1,0,1854,442,443,1
"001339db8ced4cf78829ebe8b145449d","001339db8ced4cf78829ebe8b145449d",22853418,11,0,1,1855,443,443,0
"001339db8ced4cf78829ebe8b145449d","452745e0366e42ae81561bfddebcc6c3",22853418,1,1,0,1866,443,444,1
"452745e0366e42ae81561bfddebcc6c3","452745e0366e42ae81561bfddebcc6c3",22853418,2,0,1,1867,444,444,0
"452745e0366e42ae81561bfddebcc6c3","901e92500aea43c79f19f1b279050668",22853418,1,-2,0,1869,444,442,-2
"901e92500aea43c79f19f1b279050668","4660ff2089114e8db82ceb26a4f329e3",22853418,1,4,0,1870,442,445,3
"4660ff2089114e8db82ceb26a4f329e3","4660ff2089114e8db82ceb26a4f329e3",22853418,2,0,1,1871,445,445,0
"4660ff2089114e8db82ceb26a4f329e3","7bd5586eb9d8484eb74a433ee7bfe499",22853418,1,2,0,1873,445,446,1
"7bd5586eb9d8484eb74a433ee7bfe499","7bd5586eb9d8484eb74a433ee7bfe499",22853418,15,0,1,1874,446,446,0
"7bd5586eb9d8484eb74a433ee7bfe499","8a7f26e690f34dda97be16904518ca99",22853418,1,2,0,1888,446,447,1
"8a7f26e690f34dda97be16904518ca99","24cf8786024543f19b89bc20034e60d7",22853418,1,-30,0,1889,447,428,-19
"070600601c4c439288445d2f0724807d","bf12c96466d840a69bed7020b3f18bb8",22853418,1,-3,0,1892,437,436,-1
"bf12c96466d840a69bed7020b3f18bb8","f2a73be2f46840b182d7bd095378004e",22853418,2,-10,0,1893,436,429,-7
"f2a73be2f46840b182d7bd095378004e","66ada10dde9f43018588f1ced9d477fc",22853418,1,7,0,1894,429,434,5
"66ada10dde9f43018588f1ced9d477fc","a2b4bd40cee2481ebd3fc179d6a5cd62",22853418,1,-26,0,1895,434,417,-17
"24cf8786024543f19b89bc20034e60d7","5d290f75e44b4bdb8256c600debbb44d",22853418,2,-5,0,1897,428,426,-2
"5d290f75e44b4bdb8256c600debbb44d","a2b4bd40cee2481ebd3fc179d6a5cd62",22853418,3,-13,0,1898,426,417,-9
"2b09a08242b54983aec7063990fb3f66","7f544639412e40a9ba27f43b415362ab",22853418,2,-30,0,1904,400,378,-22
"7f544639412e40a9ba27f43b415362ab","df8191ec5e584c838a899c378941a566",22853418,4,26,0,1905,378,398,20
"df8191ec5e584c838a899c378941a566","66baf19b6b904b70922329068c63746d",22853418,4,-28,0,1906,398,376,-22
"66baf19b6b904b70922329068c63746d","66baf19b6b904b70922329068c63746d",22853418,4,0,1,1907,376,376,0
"2b09a08242b54983aec7063990fb3f66","bec48fc2e1294c7eb3d0aca780d731b8",22853418,1,31,0,1915,400,420,20
"bec48fc2e1294c7eb3d0aca780d731b8","a2b4bd40cee2481ebd3fc179d6a5cd62",22853418,2,-4,0,1916,420,417,-3
"24cf8786024543f19b89bc20034e60d7","f2a73be2f46840b182d7bd095378004e",22853418,4,1,0,1920,428,429,1
"24cf8786024543f19b89bc20034e60d7","24cf8786024543f19b89bc20034e60d7",22853418,1,0,1,1922,428,428,0
"24cf8786024543f19b89bc20034e60d7","070600601c4c439288445d2f0724807d",22853418,1,14,0,1923,428,437,9
"070600601c4c439288445d2f0724807d","1823b6de7d334a7aaabc4570719af4d9",22853418,2,2,0,1924,437,439,2
"8a7f26e690f34dda97be16904518ca99","8a7f26e690f34dda97be16904518ca99",22853418,1,0,1,1927,447,447,0
"8a7f26e690f34dda97be16904518ca99","070600601c4c439288445d2f0724807d",22853418,2,-16,0,1928,447,437,-10
"b2f0d654738f48158edff28e8d3a546e","d6d02b6ef04e4f17805504500b8ce441",22853418,1,-116,0,1930,449,375,-74
"d6d02b6ef04e4f17805504500b8ce441","d6d02b6ef04e4f17805504500b8ce441",22853418,8,0,1,1931,375,375,0
"d6d02b6ef04e4f17805504500b8ce441","b71bac264efb4abd97015447bd490db6",22853418,4,-8,0,1933,375,370,-5
"8d448d625b024c82a5eb240bbd7431d6","1b4550d0dab04078b3bf08a655345bdc",22853418,4,-1,0,1977,374,373,-1
"1b4550d0dab04078b3bf08a655345bdc","b71bac264efb4abd97015447bd490db6",22853418,1,-4,0,1978,373,370,-3
"b71bac264efb4abd97015447bd490db6","b71bac264efb4abd97015447bd490db6",22853418,1,0,1,1979,370,370,0
"30ead9794d4847abaf222ca966cc8630","c76574d21bc14aeea7ecd0b027f39858",22853418,1,23,0,1981,348,367,19
"c76574d21bc14aeea7ecd0b027f39858","897b7f51242c44aab2205c72fdcbf4cd",22853418,1,-19,0,1982,367,352,-15
"eff0de7f2dbb42dfa1a2e686efab5b6d","0c4079457ede49e3aeb5e86ed84bdf35",22853418,1,-30,0,1990,354,329,-25
"0c4079457ede49e3aeb5e86ed84bdf35","eff0de7f2dbb42dfa1a2e686efab5b6d",22853418,1,30,0,1991,329,354,25
"eff0de7f2dbb42dfa1a2e686efab5b6d","09b9678ddc3d452ea4a3d46e15826065",22853418,2,-1,0,1992,354,353,-1
"09b9678ddc3d452ea4a3d46e15826065","30ead9794d4847abaf222ca966cc8630",22853418,1,-5,0,1993,353,348,-5
"eff0de7f2dbb42dfa1a2e686efab5b6d","38aea304b4fa46e1b29bb72f5cea4c93",22853418,1,-28,0,1996,354,331,-23
"38aea304b4fa46e1b29bb72f5cea4c93","4a92daef4d504e1792575a26502bb7b7",22853418,3,18,0,1997,331,346,15
"4a92daef4d504e1792575a26502bb7b7","3434c10e561d488a914e0f7d71907abd",22853418,2,-51,0,1998,346,305,-41
"0c4079457ede49e3aeb5e86ed84bdf35","47edbb64109243e6b0f8f64cdef90c6c",22853418,1,-6,0,2000,329,326,-3
"24f1363179ad4aaa965484a78471912b","43ea1b823a4b4e51b7c694c10725db82",22853418,1,5,0,2002,323,327,4
"43ea1b823a4b4e51b7c694c10725db82","53e7e900392747ccad52e711ab0f80d8",22853418,1,-25,0,2003,327,307,-20
"53e7e900392747ccad52e711ab0f80d8","3628bdce1dd2429ba924d2d4d09448d2",22853418,1,19,0,2004,307,322,15
"3628bdce1dd2429ba924d2d4d09448d2","4a29443515bb404cb8924e1c60a63b73",22853418,1,-48,0,2005,322,285,-37
"3434c10e561d488a914e0f7d71907abd","208c9b2796c944db8dacaa96082520ea",22853418,2,-24,0,2007,305,288,-17
"fab84b4fab5940efb4ea868ef8d09396","94cecc3f1e7d484b8e068e79241dfd73",22853418,4,-5,0,2011,284,281,-3
"fab84b4fab5940efb4ea868ef8d09396","a37477c4e4c14169ad44b06b493007f6",22853418,1,-3,0,2013,284,283,-1
"bb5a47f5ea01454a8b79455422d3b9da","66baf19b6b904b70922329068c63746d",22853418,1,134,0,2024,280,376,96
"a2b4bd40cee2481ebd3fc179d6a5cd62","a2b4bd40cee2481ebd3fc179d6a5cd62",22853418,2,0,1,2033,417,417,0
"dce46f8904594a62a6377a3587aaa663","66ada10dde9f43018588f1ced9d477fc",22853418,1,4,0,2040,431,434,3
"66ada10dde9f43018588f1ced9d477fc","070600601c4c439288445d2f0724807d",22853418,1,6,0,2041,434,437,3
"070600601c4c439288445d2f0724807d","070600601c4c439288445d2f0724807d",22853418,2,0,1,2045,437,437,0
"b2f0d654738f48158edff28e8d3a546e","b2f0d654738f48158edff28e8d3a546e",22853418,3,0,1,2049,449,449,0
"b2f0d654738f48158edff28e8d3a546e","f60ee41ec635499abd48168342d32c2f",22853418,1,5,0,2052,449,453,4
"f60ee41ec635499abd48168342d32c2f","f60ee41ec635499abd48168342d32c2f",22853418,81,0,1,2053,453,453,0
"f60ee41ec635499abd48168342d32c2f","83d42d95cd844fc093fc09cee250edb8",22853418,1,18,0,2073,453,465,12
"83d42d95cd844fc093fc09cee250edb8","83d42d95cd844fc093fc09cee250edb8",22853418,12,0,1,2074,465,465,0
"83d42d95cd844fc093fc09cee250edb8","c5df9f40ec14463b9dcfdc73df3e9285",22853418,4,-3,0,2076,465,464,-1
"c5df9f40ec14463b9dcfdc73df3e9285","c5df9f40ec14463b9dcfdc73df3e9285",22853418,8,0,1,2077,464,464,0
"c5df9f40ec14463b9dcfdc73df3e9285","f67fbf45a5f146ed866965bc57c7c001",22853418,6,-12,0,2078,464,454,-10
"f67fbf45a5f146ed866965bc57c7c001","c5df9f40ec14463b9dcfdc73df3e9285",22853418,2,12,0,2079,454,464,10
"f67fbf45a5f146ed866965bc57c7c001","f67fbf45a5f146ed866965bc57c7c001",22853418,1,0,1,2081,454,454,0
"f67fbf45a5f146ed866965bc57c7c001","d937afe49bd24a07a550dda1c1155122",22853418,1,1,0,2082,454,455,1
"d937afe49bd24a07a550dda1c1155122","d937afe49bd24a07a550dda1c1155122",22853418,1,0,1,2083,455,455,0
"d937afe49bd24a07a550dda1c1155122","3628b3f7823443d0912a339096b69943",22853418,1,1,0,2084,455,456,1
"3628b3f7823443d0912a339096b69943","3628b3f7823443d0912a339096b69943",22853418,1,0,1,2085,456,456,0
"3628b3f7823443d0912a339096b69943","9e049ee647cf43ecbcb5ed792a8e7588",22853418,1,1,0,2086,456,457,1
"9e049ee647cf43ecbcb5ed792a8e7588","9e049ee647cf43ecbcb5ed792a8e7588",22853418,1,0,1,2087,457,457,0
"9e049ee647cf43ecbcb5ed792a8e7588","5256a214faaf410b93f76cea06428334",22853418,1,1,0,2088,457,458,1
"5256a214faaf410b93f76cea06428334","5256a214faaf410b93f76cea06428334",22853418,1,0,1,2089,458,458,0
"5256a214faaf410b93f76cea06428334","25c32b120fce40fa9b6c85133aeb4716",22853418,1,1,0,2090,458,459,1
"25c32b120fce40fa9b6c85133aeb4716","25c32b120fce40fa9b6c85133aeb4716",22853418,3,0,1,2091,459,459,0
"25c32b120fce40fa9b6c85133aeb4716","11bc14f2204949008b7d511b933363c1",22853418,1,1,0,2094,459,460,1
"11bc14f2204949008b7d511b933363c1","11bc14f2204949008b7d511b933363c1",22853418,1,0,1,2095,460,460,0
"11bc14f2204949008b7d511b933363c1","42de338840a34d15adb66e7b14fb9d2c",22853418,1,1,0,2096,460,461,1
"42de338840a34d15adb66e7b14fb9d2c","42de338840a34d15adb66e7b14fb9d2c",22853418,5,0,1,2097,461,461,0
"42de338840a34d15adb66e7b14fb9d2c","9da37c6210b1416b8079c274f70bf600",22853418,1,1,0,2102,461,462,1
"9da37c6210b1416b8079c274f70bf600","9da37c6210b1416b8079c274f70bf600",22853418,9,0,1,2103,462,462,0
"9da37c6210b1416b8079c274f70bf600","519119f1deac45ff9ab4f13529be5c6e",22853418,1,1,0,2112,462,463,1
"519119f1deac45ff9ab4f13529be5c6e","519119f1deac45ff9ab4f13529be5c6e",22853418,3,0,1,2113,463,463,0
"519119f1deac45ff9ab4f13529be5c6e","c5df9f40ec14463b9dcfdc73df3e9285",22853418,1,3,0,2116,463,464,1
"c5df9f40ec14463b9dcfdc73df3e9285","83d42d95cd844fc093fc09cee250edb8",22853418,1,3,0,2120,464,465,1
"f67fbf45a5f146ed866965bc57c7c001","b2f0d654738f48158edff28e8d3a546e",22853418,4,-8,0,2127,454,449,-5
"b2f0d654738f48158edff28e8d3a546e","f67fbf45a5f146ed866965bc57c7c001",22853418,4,8,0,2128,449,454,5
"f67fbf45a5f146ed866965bc57c7c001","f60ee41ec635499abd48168342d32c2f",22853418,4,-3,0,2129,454,453,-1
"f60ee41ec635499abd48168342d32c2f","f67fbf45a5f146ed866965bc57c7c001",22853418,1,3,0,2170,453,454,1
"f60ee41ec635499abd48168342d32c2f","9428d8bd9c5a47b2a235b254e5e27ded",22853418,3,-1,0,2182,453,452,-1
"9428d8bd9c5a47b2a235b254e5e27ded","070600601c4c439288445d2f0724807d",22853418,1,-25,0,2183,452,437,-15
"b2f0d654738f48158edff28e8d3a546e","8a7f26e690f34dda97be16904518ca99",22853418,2,-5,0,2185,449,447,-2
"8a7f26e690f34dda97be16904518ca99","7bd5586eb9d8484eb74a433ee7bfe499",22853418,1,-2,0,2186,447,446,-1
"7bd5586eb9d8484eb74a433ee7bfe499","1823b6de7d334a7aaabc4570719af4d9",22853418,1,-12,0,2188,446,439,-7
"24cf8786024543f19b89bc20034e60d7","bf12c96466d840a69bed7020b3f18bb8",22853418,2,11,0,2191,428,436,8
"a2b4bd40cee2481ebd3fc179d6a5cd62","5d290f75e44b4bdb8256c600debbb44d",22853418,1,13,0,2195,417,426,9
"5d290f75e44b4bdb8256c600debbb44d","2b09a08242b54983aec7063990fb3f66",22853418,1,-40,0,2196,426,400,-26
"a2b4bd40cee2481ebd3fc179d6a5cd62","2add1669f08d4101913db15f8c23b3b7",22853418,1,-3,0,2198,417,416,-1
"66baf19b6b904b70922329068c63746d","d6d02b6ef04e4f17805504500b8ce441",22853418,3,-4,0,2205,376,375,-1
"1b4550d0dab04078b3bf08a655345bdc","8d448d625b024c82a5eb240bbd7431d6",22853418,2,1,0,2212,373,374,1
"8d448d625b024c82a5eb240bbd7431d6","30ead9794d4847abaf222ca966cc8630",22853418,1,-33,0,2218,374,348,-26
"b71bac264efb4abd97015447bd490db6","897b7f51242c44aab2205c72fdcbf4cd",22853418,1,-24,0,2220,370,352,-18
"c20993c944444fe085345591a8bd837e","c76574d21bc14aeea7ecd0b027f39858",22853418,2,20,0,2225,351,367,16
"c76574d21bc14aeea7ecd0b027f39858","eff0de7f2dbb42dfa1a2e686efab5b6d",22853418,2,-17,0,2226,367,354,-13
"897b7f51242c44aab2205c72fdcbf4cd","2fe14166dc9642c3bc666b86a57f943d",22853418,1,6,0,2233,352,357,5
"2fe14166dc9642c3bc666b86a57f943d","30ead9794d4847abaf222ca966cc8630",22853418,1,-10,0,2234,357,348,-9
"eff0de7f2dbb42dfa1a2e686efab5b6d","1ba8fef685d74a8194b9db252eb704fb",22853418,1,2,0,2242,354,355,1
"1ba8fef685d74a8194b9db252eb704fb","09b9678ddc3d452ea4a3d46e15826065",22853418,1,-3,0,2243,355,353,-2
"0c4079457ede49e3aeb5e86ed84bdf35","4a92daef4d504e1792575a26502bb7b7",22853418,1,20,0,2252,329,346,17
"53e7e900392747ccad52e711ab0f80d8","43ea1b823a4b4e51b7c694c10725db82",22853418,3,25,0,2255,307,327,20
"43ea1b823a4b4e51b7c694c10725db82","4a29443515bb404cb8924e1c60a63b73",22853418,1,-54,0,2256,327,285,-42
"bc5524e78a8544e2ae2fdc2f3462bbec","83d42d95cd844fc093fc09cee250edb8",22853418,1,270,0,2277,279,465,186
"9428d8bd9c5a47b2a235b254e5e27ded","b2f0d654738f48158edff28e8d3a546e",22853418,2,-4,0,2299,452,449,-3
"1823b6de7d334a7aaabc4570719af4d9","24cf8786024543f19b89bc20034e60d7",22853418,1,-16,0,2309,439,428,-11
"f2a73be2f46840b182d7bd095378004e","a2b4bd40cee2481ebd3fc179d6a5cd62",22853418,1,-19,0,2311,429,417,-12
"bf12c96466d840a69bed7020b3f18bb8","5d290f75e44b4bdb8256c600debbb44d",22853418,1,-16,0,2314,436,426,-10
"1b4550d0dab04078b3bf08a655345bdc","30ead9794d4847abaf222ca966cc8630",22853418,1,-32,0,2337,373,348,-25
"b71bac264efb4abd97015447bd490db6","eff0de7f2dbb42dfa1a2e686efab5b6d",22853418,1,-22,0,2339,370,354,-16
"09b9678ddc3d452ea4a3d46e15826065","c76574d21bc14aeea7ecd0b027f39858",22853418,1,18,0,2343,353,367,14
"c76574d21bc14aeea7ecd0b027f39858","c20993c944444fe085345591a8bd837e",22853418,1,-20,0,2344,367,351,-16
"897b7f51242c44aab2205c72fdcbf4cd","0c4079457ede49e3aeb5e86ed84bdf35",22853418,1,-28,0,2352,352,329,-23
"30ead9794d4847abaf222ca966cc8630","38aea304b4fa46e1b29bb72f5cea4c93",22853418,1,-22,0,2354,348,331,-17
"4a92daef4d504e1792575a26502bb7b7","0c4079457ede49e3aeb5e86ed84bdf35",22853418,2,-20,0,2356,346,329,-17
"43ea1b823a4b4e51b7c694c10725db82","3434c10e561d488a914e0f7d71907abd",22853418,2,-27,0,2360,327,305,-22
"2c5bb2cbd0014420ad8c95d40e38efd1","fab84b4fab5940efb4ea868ef8d09396",22853418,2,-27,0,2364,303,284,-19
"bc5524e78a8544e2ae2fdc2f3462bbec","2ae94c0cea4d480a9d5dca8fb1d7b542",22853418,1,-47,0,2380,279,242,-37
"0d987bed3ffa4ed0b9a2e62e97b7b30f","7028800abe7d4e27b613d1d6cbe26bf7",22853418,1,-8,0,2382,272,267,-5
"7028800abe7d4e27b613d1d6cbe26bf7","30c9ba177afc49a695625d2bdec40207",22853418,1,-21,0,2383,267,250,-17
"30c9ba177afc49a695625d2bdec40207","30c9ba177afc49a695625d2bdec40207",22853418,2,0,1,2384,250,250,0
"30c9ba177afc49a695625d2bdec40207","6e83e23f56544a19b94067c1c558d9c0",22853418,1,-3,0,2386,250,247,-3
"6e83e23f56544a19b94067c1c558d9c0","1ebf23f9d994469a85206e4c7b1bf5f5",22853418,1,-3,0,2387,247,245,-2
"1ebf23f9d994469a85206e4c7b1bf5f5","1c6721b1f63f4d30ba7746ea8af02a52",22853418,1,-30,0,2388,245,221,-24
"2ae94c0cea4d480a9d5dca8fb1d7b542","64dbedb3ce544f6aae8e10e0cf10f16d",22853418,1,-4,0,2390,242,240,-2
"64dbedb3ce544f6aae8e10e0cf10f16d","d7f13c8d63ec4e2aa673fbb9cf9c6933",22853418,1,-44,0,2391,240,206,-34
"77ecef8eff6b4a2caea7707669bf7475","be95c065e45447c1bd8215ea6f130c7a",22853418,1,-5,0,2394,222,219,-3
"be95c065e45447c1bd8215ea6f130c7a","b9e80f77c3a44349863b19875725c384",22853418,1,-16,0,2395,219,207,-12
"c8e371568a0c4391b25796ae4e91952e","b54257a550b94ebc9538f3a90eee9d7e",22853418,1,22,0,2399,186,204,18
"b54257a550b94ebc9538f3a90eee9d7e","c8e371568a0c4391b25796ae4e91952e",22853418,1,-22,0,2400,204,186,-18
"0c7262dff33c4087bc660ccf40f92f9c","cf4c280bad6a43e6b131d8385ef9ef3f",22853418,2,19,0,2402,169,184,15
"cf4c280bad6a43e6b131d8385ef9ef3f","0c7262dff33c4087bc660ccf40f92f9c",22853418,2,-19,0,2403,184,169,-15
"0c7262dff33c4087bc660ccf40f92f9c","b2275c3fad834f8d90737a2d9a6927d6",22853418,4,3,0,2404,169,172,3
"b2275c3fad834f8d90737a2d9a6927d6","a9ac840f098c4bd0a2ee896214ce29cd",22853418,1,-7,0,2405,172,168,-4
"a9ac840f098c4bd0a2ee896214ce29cd","a9ac840f098c4bd0a2ee896214ce29cd",22853418,2,0,1,2406,168,168,0
"a9ac840f098c4bd0a2ee896214ce29cd","0c7262dff33c4087bc660ccf40f92f9c",22853418,1,4,0,2407,168,169,1
"b2275c3fad834f8d90737a2d9a6927d6","0c7262dff33c4087bc660ccf40f92f9c",22853418,2,-3,0,2409,172,169,-3
"0c7262dff33c4087bc660ccf40f92f9c","a9ac840f098c4bd0a2ee896214ce29cd",22853418,1,-4,0,2410,169,168,-1
"a9ac840f098c4bd0a2ee896214ce29cd","3cbcea2be0984e7dbd5a48195af10ce7",22853418,1,-5,0,2412,168,165,-3
"3cbcea2be0984e7dbd5a48195af10ce7","82e6285962b8400d9d6fc32436022a94",22853418,2,2,0,2413,165,167,2
"82e6285962b8400d9d6fc32436022a94","78adeee1fa2c4fe0bc73f7bca9fcee86",22853418,1,-10,0,2414,167,160,-7
"78adeee1fa2c4fe0bc73f7bca9fcee86","3cbcea2be0984e7dbd5a48195af10ce7",22853418,2,8,0,2415,160,165,5
"3cbcea2be0984e7dbd5a48195af10ce7","65202579580f4ad38d734b4ee39d22a8",22853418,1,-3,0,2416,165,164,-1
"65202579580f4ad38d734b4ee39d22a8","65202579580f4ad38d734b4ee39d22a8",22853418,91,0,1,2417,164,164,0
"65202579580f4ad38d734b4ee39d22a8","8959e6304a0348309a771e4d08d1b64a",22853418,1,-1,0,2424,164,163,-1
"8959e6304a0348309a771e4d08d1b64a","78adeee1fa2c4fe0bc73f7bca9fcee86",22853418,1,-4,0,2425,163,160,-3
"78adeee1fa2c4fe0bc73f7bca9fcee86","df1de691dafe4549a18a4398ee9dfaf9",22853418,2,-26,0,2426,160,139,-21
"df1de691dafe4549a18a4398ee9dfaf9","d313cec988a84645bee413e8d4724a4b",22853418,1,22,0,2427,139,158,19
"d313cec988a84645bee413e8d4724a4b","d313cec988a84645bee413e8d4724a4b",22853418,7,0,1,2428,158,158,0
"d313cec988a84645bee413e8d4724a4b","f4ce60b4a944484082ccb701b48b3da1",22853418,1,-1,0,2430,158,157,-1
"f4ce60b4a944484082ccb701b48b3da1","6c5ad271a44743479bfaea29b1db8d02",22853418,1,-17,0,2431,157,143,-14
"6c5ad271a44743479bfaea29b1db8d02","f03480cf4eba413194d7af52fc0e7f28",22853418,1,11,0,2432,143,152,9
"f03480cf4eba413194d7af52fc0e7f28","df1de691dafe4549a18a4398ee9dfaf9",22853418,1,-15,0,2433,152,139,-13
"df1de691dafe4549a18a4398ee9dfaf9","779f9ddd1fd14d1e9e69f72219a1fdbd",22853418,1,-23,0,2434,139,121,-18
"779f9ddd1fd14d1e9e69f72219a1fdbd","f661500307d74c908e9207d949ceb4aa",22853418,1,18,0,2435,121,136,15
"f661500307d74c908e9207d949ceb4aa","e20db35ced8544ddac5bc3839145e463",22853418,1,-54,0,2436,136,91,-45
"e20db35ced8544ddac5bc3839145e463","779f9ddd1fd14d1e9e69f72219a1fdbd",22853418,3,36,0,2437,91,121,30
"779f9ddd1fd14d1e9e69f72219a1fdbd","62bff51286ef4f348717a3cf6fe2318f",22853418,2,-3,0,2438,121,120,-1
"62bff51286ef4f348717a3cf6fe2318f","62bff51286ef4f348717a3cf6fe2318f",22853418,9,0,1,2439,120,120,0
"62bff51286ef4f348717a3cf6fe2318f","3ec3a3563847406fa73338f9e9999cf3",22853418,1,-3,0,2441,120,117,-3
"3ec3a3563847406fa73338f9e9999cf3","d646286c8051419bbc2e31dd1db55ca8",22853418,1,-60,0,2442,117,67,-50
"d646286c8051419bbc2e31dd1db55ca8","e20db35ced8544ddac5bc3839145e463",22853418,2,30,0,2443,67,91,24
"e20db35ced8544ddac5bc3839145e463","6a9f0ef185fb47f0937e29daa1c71ed5",22853418,1,-3,0,2444,91,90,-1
"6a9f0ef185fb47f0937e29daa1c71ed5","42fb58708eaf4e5daa82bfca61b6f5fd",22853418,1,-3,0,2447,90,87,-3
"42fb58708eaf4e5daa82bfca61b6f5fd","d646286c8051419bbc2e31dd1db55ca8",22853418,1,-24,0,2448,87,67,-20
"b534b89233134e30a9b5645138bfa9ee","7af822066add4e7f8e007e4eee31a8bf",22853418,1,29,0,2450,41,65,24
"7af822066add4e7f8e007e4eee31a8bf","67a089198fcb4e1c8f2385786c2b296f",22853418,1,-33,0,2451,65,39,-26
"67a089198fcb4e1c8f2385786c2b296f","b534b89233134e30a9b5645138bfa9ee",22853418,3,4,0,2452,39,41,2
"b534b89233134e30a9b5645138bfa9ee","64d48c6c9c7940639a932219a6c87198",22853418,1,-3,0,2453,41,40,-1
"64d48c6c9c7940639a932219a6c87198","67a089198fcb4e1c8f2385786c2b296f",22853418,2,-1,0,2454,40,39,-1
"67a089198fcb4e1c8f2385786c2b296f","fc0e049d56024bc9a02c9a9c435c3df7",22853418,1,-4,0,2455,39,38,-1
"fc0e049d56024bc9a02c9a9c435c3df7","fc0e049d56024bc9a02c9a9c435c3df7",22853418,8,0,1,2456,38,38,0
"fc0e049d56024bc9a02c9a9c435c3df7","9a0dc646f934470daf08c4b56ccf73db",22853418,4,-3,0,2458,38,37,-1
"9a0dc646f934470daf08c4b56ccf73db","fc0e049d56024bc9a02c9a9c435c3df7",22853418,4,3,0,2459,37,38,1
"9a0dc646f934470daf08c4b56ccf73db","7040a13096d746ac84b8fac8d9752058",22853418,1,-3,0,2464,37,36,-1
"7040a13096d746ac84b8fac8d9752058","9a0dc646f934470daf08c4b56ccf73db",22853418,2,3,0,2465,36,37,1
"9a0dc646f934470daf08c4b56ccf73db","83d42d95cd844fc093fc09cee250edb8",22853418,1,590,0,2466,37,465,428
"f2a73be2f46840b182d7bd095378004e","bf12c96466d840a69bed7020b3f18bb8",22853418,1,10,0,2491,429,436,7
"bf12c96466d840a69bed7020b3f18bb8","a2b4bd40cee2481ebd3fc179d6a5cd62",22853418,1,-29,0,2492,436,417,-19
"2add1669f08d4101913db15f8c23b3b7","66baf19b6b904b70922329068c63746d",22853418,1,-56,0,2500,416,376,-40
"09b9678ddc3d452ea4a3d46e15826065","0c4079457ede49e3aeb5e86ed84bdf35",22853418,1,-29,0,2528,353,329,-24
"0c4079457ede49e3aeb5e86ed84bdf35","09b9678ddc3d452ea4a3d46e15826065",22853418,1,29,0,2529,329,353,24
"09b9678ddc3d452ea4a3d46e15826065","38aea304b4fa46e1b29bb72f5cea4c93",22853418,1,-27,0,2534,353,331,-22
"4a29443515bb404cb8924e1c60a63b73","2c5bb2cbd0014420ad8c95d40e38efd1",22853418,1,23,0,2542,285,303,18
"2ae94c0cea4d480a9d5dca8fb1d7b542","bb5a47f5ea01454a8b79455422d3b9da",22853418,1,48,0,2597,242,280,38
"fab84b4fab5940efb4ea868ef8d09396","0c7262dff33c4087bc660ccf40f92f9c",22853418,1,-153,0,2684,284,169,-115
"c8e371568a0c4391b25796ae4e91952e","7108f0e4c2584f1f9c471689ae4c885c",22853418,1,28,0,2691,186,208,22
"1c6721b1f63f4d30ba7746ea8af02a52","64dbedb3ce544f6aae8e10e0cf10f16d",22853418,1,23,0,2698,221,240,19
"64dbedb3ce544f6aae8e10e0cf10f16d","1c6721b1f63f4d30ba7746ea8af02a52",22853418,1,-23,0,2699,240,221,-19
"b7719e26494940efa49512aedd0aac79","b613861cecf84ffcab01afb23f660475",22854564,1,-32,0,1,20,1,-19
"b613861cecf84ffcab01afb23f660475","b613861cecf84ffcab01afb23f660475",22854564,3,0,1,2,1,1,0
"b613861cecf84ffcab01afb23f660475","e2911e79efc2420eac45d9f671463d4b",22854564,1,3,0,5,1,2,1
"e2911e79efc2420eac45d9f671463d4b","e2911e79efc2420eac45d9f671463d4b",22854564,2,0,1,6,2,2,0
"e2911e79efc2420eac45d9f671463d4b","519d1b8c59404d67b54e96c5c8a830b2",22854564,1,1,0,8,2,3,1
"519d1b8c59404d67b54e96c5c8a830b2","519d1b8c59404d67b54e96c5c8a830b2",22854564,4,0,1,10,3,3,0
"519d1b8c59404d67b54e96c5c8a830b2","531db53f81f646edb0cdcfe0085b03b7",22854564,1,1,0,13,3,4,1
"531db53f81f646edb0cdcfe0085b03b7","531db53f81f646edb0cdcfe0085b03b7",22854564,1,0,1,14,4,4,0
"531db53f81f646edb0cdcfe0085b03b7","4f5f94b2f95141e0a9d53a61da2276da",22854564,1,1,0,15,4,5,1
"4f5f94b2f95141e0a9d53a61da2276da","4f5f94b2f95141e0a9d53a61da2276da",22854564,1,0,1,16,5,5,0
"4f5f94b2f95141e0a9d53a61da2276da","6d541c89590949f99af293c4f2333f67",22854564,1,1,0,17,5,6,1
"6d541c89590949f99af293c4f2333f67","6d541c89590949f99af293c4f2333f67",22854564,1,0,1,18,6,6,0
"6d541c89590949f99af293c4f2333f67","dd5cf0b9fe4c4f1d8f5ff8e4c04879cb",22854564,1,1,0,19,6,7,1
"dd5cf0b9fe4c4f1d8f5ff8e4c04879cb","dd5cf0b9fe4c4f1d8f5ff8e4c04879cb",22854564,1,0,1,20,7,7,0
"dd5cf0b9fe4c4f1d8f5ff8e4c04879cb","f96261861edc426abe2248be4f0a709a",22854564,1,1,0,21,7,8,1
"f96261861edc426abe2248be4f0a709a","f96261861edc426abe2248be4f0a709a",22854564,1,0,1,22,8,8,0
"f96261861edc426abe2248be4f0a709a","66b5e16f4f75454fb5b8172079f0fa83",22854564,1,1,0,23,8,9,1
"66b5e16f4f75454fb5b8172079f0fa83","66b5e16f4f75454fb5b8172079f0fa83",22854564,2,0,1,24,9,9,0
"66b5e16f4f75454fb5b8172079f0fa83","0680571d4698477995e41842c36a54b2",22854564,1,1,0,26,9,10,1
"0680571d4698477995e41842c36a54b2","0680571d4698477995e41842c36a54b2",22854564,1,0,1,27,10,10,0
"0680571d4698477995e41842c36a54b2","9112f2bffece48e08c6d2287be204085",22854564,1,1,0,28,10,11,1
"9112f2bffece48e08c6d2287be204085","9112f2bffece48e08c6d2287be204085",22854564,1,0,1,29,11,11,0
"9112f2bffece48e08c6d2287be204085","56586aa865414f538729c7f7735d2bc6",22854564,1,3,0,30,11,12,1
"56586aa865414f538729c7f7735d2bc6","e2911e79efc2420eac45d9f671463d4b",22854564,1,-12,0,31,12,2,-10
"e2911e79efc2420eac45d9f671463d4b","56586aa865414f538729c7f7735d2bc6",22854564,1,12,0,32,2,12,10
"b7f2b31585d94eb3bf86376714aa7070","3f1c815879794b929260d224becaff7e",22854564,1,2,0,50,13,14,1
"3f1c815879794b929260d224becaff7e","3f1c815879794b929260d224becaff7e",22854564,1,0,1,51,14,14,0
"3f1c815879794b929260d224becaff7e","81c864a886d54a6b8ff85f7d736f4f95",22854564,2,2,0,52,14,15,1
"81c864a886d54a6b8ff85f7d736f4f95","3f1c815879794b929260d224becaff7e",22854564,1,-2,0,53,15,14,-1
"3f1c815879794b929260d224becaff7e","56586aa865414f538729c7f7735d2bc6",22854564,1,-4,0,54,14,12,-2
"56586aa865414f538729c7f7735d2bc6","3f1c815879794b929260d224becaff7e",22854564,1,4,0,57,12,14,2
"81c864a886d54a6b8ff85f7d736f4f95","5c5ceeee4562457ba6d41515aeebfbb1",22854564,1,4,0,59,15,17,2
"5c5ceeee4562457ba6d41515aeebfbb1","5c5ceeee4562457ba6d41515aeebfbb1",22854564,4,0,1,60,17,17,0
"5c5ceeee4562457ba6d41515aeebfbb1","56586aa865414f538729c7f7735d2bc6",22854564,2,-10,0,64,17,12,-5
"56586aa865414f538729c7f7735d2bc6","9afd71a5298d4333b6849dfce1b9422c",22854564,1,13,0,65,12,18,6
"9afd71a5298d4333b6849dfce1b9422c","9afd71a5298d4333b6849dfce1b9422c",22854564,2,0,1,66,18,18,0
"9afd71a5298d4333b6849dfce1b9422c","b7719e26494940efa49512aedd0aac79",22854564,1,4,0,68,18,20,2
"d4f45188d3c84a02ba08454e6403a818","d4c3b003e8274e429d2fa688d73fde6d",22854564,1,-2,0,70,24,22,-2
"d4c3b003e8274e429d2fa688d73fde6d","d4c3b003e8274e429d2fa688d73fde6d",22854564,1,0,1,71,22,22,0
"afbf7250b99d47bea07172749483ca97","4e51676dc72045d99c19b9fa7b22f8bc",22854564,1,3,0,76,28,29,1
"4e51676dc72045d99c19b9fa7b22f8bc","4e51676dc72045d99c19b9fa7b22f8bc",22854564,3,0,1,77,29,29,0
"4e51676dc72045d99c19b9fa7b22f8bc","51970cfa30e643e894e66ae85c8024cc",22854564,1,3,0,80,29,31,2
"51970cfa30e643e894e66ae85c8024cc","4e51676dc72045d99c19b9fa7b22f8bc",22854564,1,-3,0,81,31,29,-2
"4e51676dc72045d99c19b9fa7b22f8bc","c33c17be71ae4d588da7369472e5bb1b",22854564,1,9,0,82,29,34,5
"c33c17be71ae4d588da7369472e5bb1b","c33c17be71ae4d588da7369472e5bb1b",22854564,1,0,1,83,34,34,0
"c33c17be71ae4d588da7369472e5bb1b","93679be414554a11b1893002f2229a93",22854564,1,3,0,84,34,35,1
"93679be414554a11b1893002f2229a93","93679be414554a11b1893002f2229a93",22854564,1,0,1,85,35,35,0
"93679be414554a11b1893002f2229a93","7040a13096d746ac84b8fac8d9752058",22854564,1,3,0,86,35,36,1
"7040a13096d746ac84b8fac8d9752058","7040a13096d746ac84b8fac8d9752058",22854564,1,0,1,87,36,36,0
"7040a13096d746ac84b8fac8d9752058","9a0dc646f934470daf08c4b56ccf73db",22854564,1,3,0,88,36,37,1
"9a0dc646f934470daf08c4b56ccf73db","fc0e049d56024bc9a02c9a9c435c3df7",22854564,1,3,0,89,37,38,1
"fc0e049d56024bc9a02c9a9c435c3df7","9a0dc646f934470daf08c4b56ccf73db",22854564,1,-3,0,90,38,37,-1
"9a0dc646f934470daf08c4b56ccf73db","56586aa865414f538729c7f7735d2bc6",22854564,1,-50,0,91,37,12,-25
"56586aa865414f538729c7f7735d2bc6","5c5ceeee4562457ba6d41515aeebfbb1",22854564,1,10,0,92,12,17,5
"b7f2b31585d94eb3bf86376714aa7070","5c5ceeee4562457ba6d41515aeebfbb1",22854564,1,8,0,95,13,17,4
"5c5ceeee4562457ba6d41515aeebfbb1","d4c3b003e8274e429d2fa688d73fde6d",22854564,1,10,0,96,17,22,5
"d4c3b003e8274e429d2fa688d73fde6d","fc0e049d56024bc9a02c9a9c435c3df7",22854564,1,33,0,97,22,38,16
"fc0e049d56024bc9a02c9a9c435c3df7","fc0e049d56024bc9a02c9a9c435c3df7",22854564,2,0,1,98,38,38,0
"fc0e049d56024bc9a02c9a9c435c3df7","56586aa865414f538729c7f7735d2bc6",22854564,1,-53,0,100,38,12,-26
"56586aa865414f538729c7f7735d2bc6","56586aa865414f538729c7f7735d2bc6",22854564,12,0,1,101,12,12,0
"56586aa865414f538729c7f7735d2bc6","b7f2b31585d94eb3bf86376714aa7070",22854564,3,2,0,105,12,13,1
"b7f2b31585d94eb3bf86376714aa7070","b7f2b31585d94eb3bf86376714aa7070",22854564,11,0,1,106,13,13,0
"b7f2b31585d94eb3bf86376714aa7070","fc0e049d56024bc9a02c9a9c435c3df7",22854564,1,51,0,107,13,38,25
"fc0e049d56024bc9a02c9a9c435c3df7","67a089198fcb4e1c8f2385786c2b296f",22854564,1,4,0,108,38,39,1
"67a089198fcb4e1c8f2385786c2b296f","67a089198fcb4e1c8f2385786c2b296f",22854564,2,0,1,109,39,39,0
"67a089198fcb4e1c8f2385786c2b296f","64d48c6c9c7940639a932219a6c87198",22854564,2,1,0,110,39,40,1
"64d48c6c9c7940639a932219a6c87198","64d48c6c9c7940639a932219a6c87198",22854564,2,0,1,111,40,40,0
"64d48c6c9c7940639a932219a6c87198","b534b89233134e30a9b5645138bfa9ee",22854564,1,3,0,112,40,41,1
"b534b89233134e30a9b5645138bfa9ee","b534b89233134e30a9b5645138bfa9ee",22854564,4,0,1,113,41,41,0
"b534b89233134e30a9b5645138bfa9ee","a0a418b8540d479fa6e0f653b701da8b",22854564,1,27,0,115,41,64,23
"a0a418b8540d479fa6e0f653b701da8b","bc42d26810654ea9a1df1efe1e58c7d5",22854564,4,-1,0,116,64,63,-1
"bc42d26810654ea9a1df1efe1e58c7d5","309ccf3cc4fe429d9bfbaef53d3fa479",22854564,1,-3,0,117,63,60,-3
"309ccf3cc4fe429d9bfbaef53d3fa479","b534b89233134e30a9b5645138bfa9ee",22854564,2,-23,0,118,60,41,-19
"b534b89233134e30a9b5645138bfa9ee","0e37b720d23b4e7f8b313e79313fd107",22854564,1,3,0,120,41,44,3
"0e37b720d23b4e7f8b313e79313fd107","0e37b720d23b4e7f8b313e79313fd107",22854564,2,0,1,121,44,44,0
"0e37b720d23b4e7f8b313e79313fd107","6875d67fdd5f48168b62719df449bebd",22854564,1,1,0,123,44,45,1
"6875d67fdd5f48168b62719df449bebd","6e13d61a7bdb44bca949c9f86fab3be5",22854564,1,3,0,124,45,47,2
"6e13d61a7bdb44bca949c9f86fab3be5","d9c8d8c444a64dadbbb508652c721e17",22854564,3,-1,0,125,47,46,-1
"d9c8d8c444a64dadbbb508652c721e17","b534b89233134e30a9b5645138bfa9ee",22854564,4,-6,0,126,46,41,-5
"b534b89233134e30a9b5645138bfa9ee","6e13d61a7bdb44bca949c9f86fab3be5",22854564,6,7,0,127,41,47,6
"6e13d61a7bdb44bca949c9f86fab3be5","6e13d61a7bdb44bca949c9f86fab3be5",22854564,2,0,1,128,47,47,0
"6e13d61a7bdb44bca949c9f86fab3be5","6875d67fdd5f48168b62719df449bebd",22854564,1,-3,0,129,47,45,-2
"6875d67fdd5f48168b62719df449bebd","195f78799f984cc2b06c48dfe36be751",22854564,1,5,0,130,45,49,4
"195f78799f984cc2b06c48dfe36be751","195f78799f984cc2b06c48dfe36be751",22854564,5,0,1,131,49,49,0
"195f78799f984cc2b06c48dfe36be751","d0c74f735e024943943e40333d6d337f",22854564,2,3,0,132,49,51,2
"d0c74f735e024943943e40333d6d337f","983f8ff320594b279a7f4a6fe132f9c5",22854564,1,2,0,133,51,53,2
"983f8ff320594b279a7f4a6fe132f9c5","983f8ff320594b279a7f4a6fe132f9c5",22854564,1,0,1,134,53,53,0
"983f8ff320594b279a7f4a6fe132f9c5","d9c8d8c444a64dadbbb508652c721e17",22854564,1,-8,0,135,53,46,-7
"6e13d61a7bdb44bca949c9f86fab3be5","d0c74f735e024943943e40333d6d337f",22854564,1,5,0,138,47,51,4
"d0c74f735e024943943e40333d6d337f","d9c8d8c444a64dadbbb508652c721e17",22854564,2,-6,0,139,51,46,-5
"d9c8d8c444a64dadbbb508652c721e17","bc42d26810654ea9a1df1efe1e58c7d5",22854564,1,20,0,140,46,63,17
"bc42d26810654ea9a1df1efe1e58c7d5","f924752d8a1149668870b1e7698486f7",22854564,3,-15,0,141,63,50,-13
"f924752d8a1149668870b1e7698486f7","a0a418b8540d479fa6e0f653b701da8b",22854564,1,16,0,142,50,64,14
"a0a418b8540d479fa6e0f653b701da8b","309ccf3cc4fe429d9bfbaef53d3fa479",22854564,2,-4,0,143,64,60,-4
"309ccf3cc4fe429d9bfbaef53d3fa479","78f30e4dcac84e3cbea8b2cc6e0d62b3",22854564,3,-2,0,144,60,59,-1
"78f30e4dcac84e3cbea8b2cc6e0d62b3","a1f2f12debe5432fb7a70bcd12bacfb9",22854564,5,-1,0,145,59,58,-1
"a1f2f12debe5432fb7a70bcd12bacfb9","d0c74f735e024943943e40333d6d337f",22854564,1,-8,0,146,58,51,-7
"d0c74f735e024943943e40333d6d337f","12aa6e1672ac4e7aa6449a7a8609cd72",22854564,3,7,0,147,51,57,6
"12aa6e1672ac4e7aa6449a7a8609cd72","d0c74f735e024943943e40333d6d337f",22854564,1,-7,0,148,57,51,-6
"d0c74f735e024943943e40333d6d337f","a0a418b8540d479fa6e0f653b701da8b",22854564,1,15,0,149,51,64,13
"f924752d8a1149668870b1e7698486f7","a1f2f12debe5432fb7a70bcd12bacfb9",22854564,3,9,0,152,50,58,8
"a1f2f12debe5432fb7a70bcd12bacfb9","309ccf3cc4fe429d9bfbaef53d3fa479",22854564,1,3,0,153,58,60,2
"78f30e4dcac84e3cbea8b2cc6e0d62b3","d0c74f735e024943943e40333d6d337f",22854564,1,-9,0,155,59,51,-8
"12aa6e1672ac4e7aa6449a7a8609cd72","f924752d8a1149668870b1e7698486f7",22854564,1,-8,0,157,57,50,-7
"f924752d8a1149668870b1e7698486f7","7af822066add4e7f8e007e4eee31a8bf",22854564,1,18,0,158,50,65,15
"7af822066add4e7f8e007e4eee31a8bf","6e13d61a7bdb44bca949c9f86fab3be5",22854564,1,-22,0,159,65,47,-18
"6e13d61a7bdb44bca949c9f86fab3be5","195f78799f984cc2b06c48dfe36be751",22854564,3,2,0,160,47,49,2
"195f78799f984cc2b06c48dfe36be751","d9c8d8c444a64dadbbb508652c721e17",22854564,2,-3,0,161,49,46,-3
"d9c8d8c444a64dadbbb508652c721e17","d0c74f735e024943943e40333d6d337f",22854564,4,6,0,162,46,51,5
"d0c74f735e024943943e40333d6d337f","78f30e4dcac84e3cbea8b2cc6e0d62b3",22854564,1,9,0,163,51,59,8
"a1f2f12debe5432fb7a70bcd12bacfb9","f924752d8a1149668870b1e7698486f7",22854564,1,-9,0,165,58,50,-8
"f924752d8a1149668870b1e7698486f7","d0c74f735e024943943e40333d6d337f",22854564,1,1,0,166,50,51,1
"12aa6e1672ac4e7aa6449a7a8609cd72","a0a418b8540d479fa6e0f653b701da8b",22854564,1,8,0,168,57,64,7
"f924752d8a1149668870b1e7698486f7","35adfa5d923046aebabfefd98f35ff05",22854564,1,4,0,171,50,54,4
"35adfa5d923046aebabfefd98f35ff05","35adfa5d923046aebabfefd98f35ff05",22854564,6,0,1,172,54,54,0
"35adfa5d923046aebabfefd98f35ff05","b6f8a98476224da1b40e555ececc7ed8",22854564,1,1,0,177,54,55,1
"b6f8a98476224da1b40e555ececc7ed8","b6f8a98476224da1b40e555ececc7ed8",22854564,1,0,1,178,55,55,0
"b6f8a98476224da1b40e555ececc7ed8","86e22cb5fe0e4b47a9489ecddf7ed78f",22854564,1,1,0,179,55,56,1
"86e22cb5fe0e4b47a9489ecddf7ed78f","86e22cb5fe0e4b47a9489ecddf7ed78f",22854564,1,0,1,180,56,56,0
"86e22cb5fe0e4b47a9489ecddf7ed78f","a1f2f12debe5432fb7a70bcd12bacfb9",22854564,1,3,0,181,56,58,2
"a1f2f12debe5432fb7a70bcd12bacfb9","78f30e4dcac84e3cbea8b2cc6e0d62b3",22854564,4,1,0,182,58,59,1
"a1f2f12debe5432fb7a70bcd12bacfb9","a1f2f12debe5432fb7a70bcd12bacfb9",22854564,10,0,1,184,58,58,0
"78f30e4dcac84e3cbea8b2cc6e0d62b3","78f30e4dcac84e3cbea8b2cc6e0d62b3",22854564,7,0,1,195,59,59,0
"78f30e4dcac84e3cbea8b2cc6e0d62b3","309ccf3cc4fe429d9bfbaef53d3fa479",22854564,1,2,0,202,59,60,1
"a1f2f12debe5432fb7a70bcd12bacfb9","12aa6e1672ac4e7aa6449a7a8609cd72",22854564,1,-1,0,205,58,57,-1
"12aa6e1672ac4e7aa6449a7a8609cd72","bc42d26810654ea9a1df1efe1e58c7d5",22854564,1,7,0,206,57,63,6
"bc42d26810654ea9a1df1efe1e58c7d5","a0a418b8540d479fa6e0f653b701da8b",22854564,2,1,0,207,63,64,1
"a0a418b8540d479fa6e0f653b701da8b","d0c74f735e024943943e40333d6d337f",22854564,1,-15,0,208,64,51,-13
"d0c74f735e024943943e40333d6d337f","309ccf3cc4fe429d9bfbaef53d3fa479",22854564,1,11,0,209,51,60,9
"309ccf3cc4fe429d9bfbaef53d3fa479","35adfa5d923046aebabfefd98f35ff05",22854564,1,-8,0,210,60,54,-6
"35adfa5d923046aebabfefd98f35ff05","b534b89233134e30a9b5645138bfa9ee",22854564,1,-15,0,212,54,41,-13
"d9c8d8c444a64dadbbb508652c721e17","f924752d8a1149668870b1e7698486f7",22854564,1,5,0,219,46,50,4
"f924752d8a1149668870b1e7698486f7","78f30e4dcac84e3cbea8b2cc6e0d62b3",22854564,1,10,0,220,50,59,9
"a1f2f12debe5432fb7a70bcd12bacfb9","a0a418b8540d479fa6e0f653b701da8b",22854564,1,7,0,222,58,64,6
"bc42d26810654ea9a1df1efe1e58c7d5","12aa6e1672ac4e7aa6449a7a8609cd72",22854564,1,-7,0,224,63,57,-6
"12aa6e1672ac4e7aa6449a7a8609cd72","4c943503763e4e349906eea3ed3c8e86",22854564,1,5,0,225,57,61,4
"4c943503763e4e349906eea3ed3c8e86","4c943503763e4e349906eea3ed3c8e86",22854564,1,0,1,226,61,61,0
"4c943503763e4e349906eea3ed3c8e86","bc42d26810654ea9a1df1efe1e58c7d5",22854564,1,2,0,227,61,63,2
"bc42d26810654ea9a1df1efe1e58c7d5","bc42d26810654ea9a1df1efe1e58c7d5",22854564,3,0,1,228,63,63,0
"a0a418b8540d479fa6e0f653b701da8b","a0a418b8540d479fa6e0f653b701da8b",22854564,3,0,1,232,64,64,0
"b534b89233134e30a9b5645138bfa9ee","d646286c8051419bbc2e31dd1db55ca8",22854564,1,33,0,237,41,67,26
"d646286c8051419bbc2e31dd1db55ca8","d646286c8051419bbc2e31dd1db55ca8",22854564,3,0,1,238,67,67,0
"d646286c8051419bbc2e31dd1db55ca8","a2becd407db34b189200a32546d9d569",22854564,4,9,0,240,67,75,8
"a2becd407db34b189200a32546d9d569","d646286c8051419bbc2e31dd1db55ca8",22854564,3,-9,0,241,75,67,-8
"a2becd407db34b189200a32546d9d569","140d5b27b8574befad82c0a013b59dfa",22854564,3,-1,0,243,75,74,-1
"140d5b27b8574befad82c0a013b59dfa","d18a9ea32855445f8736581f5cb119ce",22854564,2,9,0,244,74,82,8
"d18a9ea32855445f8736581f5cb119ce","ae5ac430ea254e708a6f5deaaf7464ae",22854564,1,3,0,245,82,84,2
"ae5ac430ea254e708a6f5deaaf7464ae","6a9f0ef185fb47f0937e29daa1c71ed5",22854564,2,7,0,246,84,90,6
"6a9f0ef185fb47f0937e29daa1c71ed5","d646286c8051419bbc2e31dd1db55ca8",22854564,2,-27,0,247,90,67,-23
"d646286c8051419bbc2e31dd1db55ca8","e20db35ced8544ddac5bc3839145e463",22854564,2,30,0,248,67,91,24
"e20db35ced8544ddac5bc3839145e463","67a089198fcb4e1c8f2385786c2b296f",22854564,1,-67,0,249,91,39,-52
"67a089198fcb4e1c8f2385786c2b296f","d646286c8051419bbc2e31dd1db55ca8",22854564,1,37,0,250,39,67,28
"d646286c8051419bbc2e31dd1db55ca8","267f883678b24aed855fde42524975d9",22854564,1,4,0,252,67,71,4
"267f883678b24aed855fde42524975d9","88fff56d0342490dbef9040750a20f6c",22854564,1,1,0,253,71,72,1
"88fff56d0342490dbef9040750a20f6c","adb17b12b66c4a49a85fd34322f7df70",22854564,1,1,0,254,72,73,1
"adb17b12b66c4a49a85fd34322f7df70","a2becd407db34b189200a32546d9d569",22854564,1,3,0,255,73,75,2
"a2becd407db34b189200a32546d9d569","a2becd407db34b189200a32546d9d569",22854564,2,0,1,256,75,75,0
"d646286c8051419bbc2e31dd1db55ca8","140d5b27b8574befad82c0a013b59dfa",22854564,2,8,0,258,67,74,7
"140d5b27b8574befad82c0a013b59dfa","a2becd407db34b189200a32546d9d569",22854564,1,1,0,259,74,75,1
"140d5b27b8574befad82c0a013b59dfa","6a9f0ef185fb47f0937e29daa1c71ed5",22854564,1,19,0,262,74,90,16
"6a9f0ef185fb47f0937e29daa1c71ed5","ae5ac430ea254e708a6f5deaaf7464ae",22854564,1,-7,0,263,90,84,-6
"ae5ac430ea254e708a6f5deaaf7464ae","d646286c8051419bbc2e31dd1db55ca8",22854564,1,-20,0,264,84,67,-17
"e20db35ced8544ddac5bc3839145e463","00ae5f0c51874a73a41ebea838d95682",22854564,2,11,0,266,91,101,10
"00ae5f0c51874a73a41ebea838d95682","e20db35ced8544ddac5bc3839145e463",22854564,3,-11,0,267,101,91,-10
"e20db35ced8544ddac5bc3839145e463","d391c8b6e56a43a7b654e9dee02d904b",22854564,3,13,0,268,91,103,12
"d391c8b6e56a43a7b654e9dee02d904b","00ae5f0c51874a73a41ebea838d95682",22854564,4,-2,0,269,103,101,-2
"00ae5f0c51874a73a41ebea838d95682","73039f8c1eb9409cb4caee2cf968001e",22854564,3,-1,0,270,101,100,-1
"73039f8c1eb9409cb4caee2cf968001e","4280927ec4d643238aa49c32f9e06c6c",22854564,4,10,0,271,100,109,9
"4280927ec4d643238aa49c32f9e06c6c","4280927ec4d643238aa49c32f9e06c6c",22854564,3,0,1,272,109,109,0
"4280927ec4d643238aa49c32f9e06c6c","08111f75e22d409998cf8b85bd431f0a",22854564,2,-1,0,273,109,108,-1
"08111f75e22d409998cf8b85bd431f0a","a9ae0a3c070d455bb4369a8996313336",22854564,3,7,0,274,108,114,6
"a9ae0a3c070d455bb4369a8996313336","37319e88176d4aefa91d7a9980dbae91",22854564,1,-2,0,275,114,112,-2
"37319e88176d4aefa91d7a9980dbae91","62bff51286ef4f348717a3cf6fe2318f",22854564,1,9,0,276,112,120,8
"62bff51286ef4f348717a3cf6fe2318f","e20db35ced8544ddac5bc3839145e463",22854564,2,-33,0,277,120,91,-29
"e20db35ced8544ddac5bc3839145e463","779f9ddd1fd14d1e9e69f72219a1fdbd",22854564,2,36,0,278,91,121,30
"779f9ddd1fd14d1e9e69f72219a1fdbd","779f9ddd1fd14d1e9e69f72219a1fdbd",22854564,6,0,1,279,121,121,0
"779f9ddd1fd14d1e9e69f72219a1fdbd","a8dd5213034441ac92724b4e83eb0bb2",22854564,3,9,0,280,121,129,8
"a8dd5213034441ac92724b4e83eb0bb2","a8dd5213034441ac92724b4e83eb0bb2",22854564,1,0,1,281,129,129,0
"a8dd5213034441ac92724b4e83eb0bb2","579338175e0b4bbb8ef3b712b5d8b54e",22854564,1,-1,0,282,129,128,-1
"579338175e0b4bbb8ef3b712b5d8b54e","b416d47c56a742199b5d7c7f19d6503a",22854564,1,7,0,283,128,134,6
"b416d47c56a742199b5d7c7f19d6503a","779f9ddd1fd14d1e9e69f72219a1fdbd",22854564,1,-15,0,284,134,121,-13
"779f9ddd1fd14d1e9e69f72219a1fdbd","df1de691dafe4549a18a4398ee9dfaf9",22854564,2,23,0,285,121,139,18
"6c5ad271a44743479bfaea29b1db8d02","df1de691dafe4549a18a4398ee9dfaf9",22854564,3,-4,0,288,143,139,-4
"df1de691dafe4549a18a4398ee9dfaf9","8aae34f5ddbb4052a709b12e6b0d40fa",22854564,2,9,0,289,139,147,8
"8aae34f5ddbb4052a709b12e6b0d40fa","8aae34f5ddbb4052a709b12e6b0d40fa",22854564,2,0,1,290,147,147,0
"8aae34f5ddbb4052a709b12e6b0d40fa","f902b0f41b544d4dbf79664fd233648d",22854564,1,-1,0,292,147,146,-1
"f902b0f41b544d4dbf79664fd233648d","d313cec988a84645bee413e8d4724a4b",22854564,1,14,0,293,146,158,12
"d313cec988a84645bee413e8d4724a4b","f03480cf4eba413194d7af52fc0e7f28",22854564,1,-7,0,294,158,152,-6
"f03480cf4eba413194d7af52fc0e7f28","78adeee1fa2c4fe0bc73f7bca9fcee86",22854564,1,11,0,295,152,160,8
"78adeee1fa2c4fe0bc73f7bca9fcee86","df1de691dafe4549a18a4398ee9dfaf9",22854564,2,-26,0,296,160,139,-21
"df1de691dafe4549a18a4398ee9dfaf9","78adeee1fa2c4fe0bc73f7bca9fcee86",22854564,1,26,0,297,139,160,21
"78adeee1fa2c4fe0bc73f7bca9fcee86","65202579580f4ad38d734b4ee39d22a8",22854564,6,5,0,298,160,164,4
"65202579580f4ad38d734b4ee39d22a8","65202579580f4ad38d734b4ee39d22a8",22854564,86,0,1,299,164,164,0
"65202579580f4ad38d734b4ee39d22a8","67a089198fcb4e1c8f2385786c2b296f",22854564,1,-157,0,306,164,39,-125
"67a089198fcb4e1c8f2385786c2b296f","58c22b011d0f4c2ea6d13615edbb9eeb",22854564,1,48,0,307,39,77,38
"58c22b011d0f4c2ea6d13615edbb9eeb","58c22b011d0f4c2ea6d13615edbb9eeb",22854564,7,0,1,308,77,77,0
"58c22b011d0f4c2ea6d13615edbb9eeb","dd76e1861dc9461c830888729d091ee0",22854564,1,1,0,315,77,78,1
"dd76e1861dc9461c830888729d091ee0","dd76e1861dc9461c830888729d091ee0",22854564,3,0,1,316,78,78,0
"dd76e1861dc9461c830888729d091ee0","cd1d828f1a694b87913a7ea66c23803e",22854564,1,1,0,319,78,79,1
"cd1d828f1a694b87913a7ea66c23803e","cd1d828f1a694b87913a7ea66c23803e",22854564,1,0,1,320,79,79,0
"cd1d828f1a694b87913a7ea66c23803e","9176a3c2b4d2465fa8b0c67096c2a97e",22854564,1,1,0,321,79,80,1
"9176a3c2b4d2465fa8b0c67096c2a97e","9176a3c2b4d2465fa8b0c67096c2a97e",22854564,4,0,1,322,80,80,0
"9176a3c2b4d2465fa8b0c67096c2a97e","f8ec6445f7194e25b9101d4fbcb07a18",22854564,1,1,0,326,80,81,1
"f8ec6445f7194e25b9101d4fbcb07a18","f8ec6445f7194e25b9101d4fbcb07a18",22854564,1,0,1,327,81,81,0
"f8ec6445f7194e25b9101d4fbcb07a18","d646286c8051419bbc2e31dd1db55ca8",22854564,1,-15,0,328,81,67,-14
"140d5b27b8574befad82c0a013b59dfa","d646286c8051419bbc2e31dd1db55ca8",22854564,1,-8,0,331,74,67,-7
"a2becd407db34b189200a32546d9d569","d18a9ea32855445f8736581f5cb119ce",22854564,1,8,0,333,75,82,7
"d18a9ea32855445f8736581f5cb119ce","a2becd407db34b189200a32546d9d569",22854564,1,-8,0,334,82,75,-7
"d18a9ea32855445f8736581f5cb119ce","f564483cbd7a407681aa2fcca518cf5f",22854564,1,4,0,338,82,85,3
"f564483cbd7a407681aa2fcca518cf5f","f564483cbd7a407681aa2fcca518cf5f",22854564,3,0,1,339,85,85,0
"f564483cbd7a407681aa2fcca518cf5f","18fd01350bd5434ca636d59a599d768a",22854564,1,1,0,342,85,86,1
"18fd01350bd5434ca636d59a599d768a","18fd01350bd5434ca636d59a599d768a",22854564,9,0,1,343,86,86,0
"18fd01350bd5434ca636d59a599d768a","ae5ac430ea254e708a6f5deaaf7464ae",22854564,1,-2,0,352,86,84,-2
"6a9f0ef185fb47f0937e29daa1c71ed5","c681290961c94c4caf23b529d1ae6b9a",22854564,1,-2,0,354,90,88,-2
"c681290961c94c4caf23b529d1ae6b9a","c681290961c94c4caf23b529d1ae6b9a",22854564,1,0,1,355,88,88,0
"c681290961c94c4caf23b529d1ae6b9a","6a9f0ef185fb47f0937e29daa1c71ed5",22854564,1,2,0,356,88,90,2
"6a9f0ef185fb47f0937e29daa1c71ed5","6a9f0ef185fb47f0937e29daa1c71ed5",22854564,6,0,1,357,90,90,0
"6a9f0ef185fb47f0937e29daa1c71ed5","e20db35ced8544ddac5bc3839145e463",22854564,2,3,0,360,90,91,1
"e20db35ced8544ddac5bc3839145e463","d646286c8051419bbc2e31dd1db55ca8",22854564,1,-30,0,361,91,67,-24
"d646286c8051419bbc2e31dd1db55ca8","67a089198fcb4e1c8f2385786c2b296f",22854564,1,-37,0,362,67,39,-28
"b534b89233134e30a9b5645138bfa9ee","d9c8d8c444a64dadbbb508652c721e17",22854564,1,6,0,364,41,46,5
"d9c8d8c444a64dadbbb508652c721e17","6e13d61a7bdb44bca949c9f86fab3be5",22854564,1,1,0,365,46,47,1
"6e13d61a7bdb44bca949c9f86fab3be5","d646286c8051419bbc2e31dd1db55ca8",22854564,1,26,0,366,47,67,20
"d646286c8051419bbc2e31dd1db55ca8","6a9f0ef185fb47f0937e29daa1c71ed5",22854564,1,27,0,367,67,90,23
"6a9f0ef185fb47f0937e29daa1c71ed5","42fb58708eaf4e5daa82bfca61b6f5fd",22854564,1,-3,0,370,90,87,-3
"42fb58708eaf4e5daa82bfca61b6f5fd","d18a9ea32855445f8736581f5cb119ce",22854564,1,-7,0,371,87,82,-5
"d18a9ea32855445f8736581f5cb119ce","6a9f0ef185fb47f0937e29daa1c71ed5",22854564,1,10,0,372,82,90,8
"e20db35ced8544ddac5bc3839145e463","6a9f0ef185fb47f0937e29daa1c71ed5",22854564,1,-3,0,374,91,90,-1
"d646286c8051419bbc2e31dd1db55ca8","1febb706d7a34005ae8711ed49c76e64",22854564,1,33,0,377,67,94,27
"1febb706d7a34005ae8711ed49c76e64","1febb706d7a34005ae8711ed49c76e64",22854564,5,0,1,378,94,94,0
"1febb706d7a34005ae8711ed49c76e64","8f73ba6f5a0042f2850356ac38ac6f24",22854564,1,1,0,383,94,95,1
"8f73ba6f5a0042f2850356ac38ac6f24","8f73ba6f5a0042f2850356ac38ac6f24",22854564,5,0,1,384,95,95,0
"8f73ba6f5a0042f2850356ac38ac6f24","e2260b86653c46d7b14a41fb419dbf8c",22854564,1,1,0,389,95,96,1
"e2260b86653c46d7b14a41fb419dbf8c","e2260b86653c46d7b14a41fb419dbf8c",22854564,5,0,1,390,96,96,0
"e2260b86653c46d7b14a41fb419dbf8c","35eb641ad1d845bbba54915bce75a962",22854564,1,1,0,395,96,97,1
"35eb641ad1d845bbba54915bce75a962","35eb641ad1d845bbba54915bce75a962",22854564,3,0,1,396,97,97,0
"35eb641ad1d845bbba54915bce75a962","08be90ffbeea4795a138cd42ed8db56f",22854564,1,1,0,398,97,98,1
"08be90ffbeea4795a138cd42ed8db56f","08be90ffbeea4795a138cd42ed8db56f",22854564,5,0,1,399,98,98,0
"08be90ffbeea4795a138cd42ed8db56f","3007433c8f584dcbb5ac159c1c5f2be3",22854564,1,1,0,404,98,99,1
"3007433c8f584dcbb5ac159c1c5f2be3","3007433c8f584dcbb5ac159c1c5f2be3",22854564,2,0,1,405,99,99,0
"3007433c8f584dcbb5ac159c1c5f2be3","00ae5f0c51874a73a41ebea838d95682",22854564,1,3,0,407,99,101,2
"00ae5f0c51874a73a41ebea838d95682","d391c8b6e56a43a7b654e9dee02d904b",22854564,1,2,0,411,101,103,2
"d391c8b6e56a43a7b654e9dee02d904b","d391c8b6e56a43a7b654e9dee02d904b",22854564,15,0,1,412,103,103,0
"d391c8b6e56a43a7b654e9dee02d904b","6111116566fc4fd9abba409322bea245",22854564,1,1,0,427,103,104,1
"6111116566fc4fd9abba409322bea245","6111116566fc4fd9abba409322bea245",22854564,2,0,1,428,104,104,0
"6111116566fc4fd9abba409322bea245","a81b2235cb9c499eb9ea8ee0a8dd9725",22854564,1,1,0,430,104,105,1
"a81b2235cb9c499eb9ea8ee0a8dd9725","a81b2235cb9c499eb9ea8ee0a8dd9725",22854564,2,0,1,431,105,105,0
"a81b2235cb9c499eb9ea8ee0a8dd9725","2d4e0ab0ef3b4d73b82c72d4621a7579",22854564,1,1,0,433,105,106,1
"2d4e0ab0ef3b4d73b82c72d4621a7579","2d4e0ab0ef3b4d73b82c72d4621a7579",22854564,2,0,1,434,106,106,0
"2d4e0ab0ef3b4d73b82c72d4621a7579","8bdebf492ebd4e62b0d522e8ab5e5197",22854564,1,1,0,436,106,107,1
"8bdebf492ebd4e62b0d522e8ab5e5197","8bdebf492ebd4e62b0d522e8ab5e5197",22854564,2,0,1,437,107,107,0
"8bdebf492ebd4e62b0d522e8ab5e5197","73039f8c1eb9409cb4caee2cf968001e",22854564,1,-7,0,439,107,100,-7
"4280927ec4d643238aa49c32f9e06c6c","00ae5f0c51874a73a41ebea838d95682",22854564,1,-9,0,441,109,101,-8
"00ae5f0c51874a73a41ebea838d95682","08111f75e22d409998cf8b85bd431f0a",22854564,1,8,0,442,101,108,7
"08111f75e22d409998cf8b85bd431f0a","d391c8b6e56a43a7b654e9dee02d904b",22854564,1,-6,0,443,108,103,-5
"4280927ec4d643238aa49c32f9e06c6c","fc44e6a5f7654430af1227838224dceb",22854564,1,2,0,448,109,111,2
"fc44e6a5f7654430af1227838224dceb","fc44e6a5f7654430af1227838224dceb",22854564,5,0,1,449,111,111,0
"fc44e6a5f7654430af1227838224dceb","08111f75e22d409998cf8b85bd431f0a",22854564,1,-3,0,454,111,108,-3
"a9ae0a3c070d455bb4369a8996313336","e20db35ced8544ddac5bc3839145e463",22854564,1,-26,0,456,114,91,-23
"e20db35ced8544ddac5bc3839145e463","e20db35ced8544ddac5bc3839145e463",22854564,1,0,1,457,91,91,0
"00ae5f0c51874a73a41ebea838d95682","00ae5f0c51874a73a41ebea838d95682",22854564,1,0,1,462,101,101,0
"a9ae0a3c070d455bb4369a8996313336","a9ae0a3c070d455bb4369a8996313336",22854564,2,0,1,468,114,114,0
"a9ae0a3c070d455bb4369a8996313336","71cec822bcff4f30a20e75dc63ef7b65",22854564,1,2,0,470,114,116,2
"71cec822bcff4f30a20e75dc63ef7b65","71cec822bcff4f30a20e75dc63ef7b65",22854564,1,0,1,471,116,116,0
"71cec822bcff4f30a20e75dc63ef7b65","62bff51286ef4f348717a3cf6fe2318f",22854564,1,5,0,472,116,120,4
"62bff51286ef4f348717a3cf6fe2318f","37319e88176d4aefa91d7a9980dbae91",22854564,2,-9,0,473,120,112,-8
"37319e88176d4aefa91d7a9980dbae91","3ec3a3563847406fa73338f9e9999cf3",22854564,1,6,0,474,112,117,5
"3ec3a3563847406fa73338f9e9999cf3","35eb641ad1d845bbba54915bce75a962",22854564,1,-24,0,475,117,97,-20
"35eb641ad1d845bbba54915bce75a962","e20db35ced8544ddac5bc3839145e463",22854564,1,-6,0,477,97,91,-6
"e20db35ced8544ddac5bc3839145e463","62bff51286ef4f348717a3cf6fe2318f",22854564,2,33,0,478,91,120,29
"62bff51286ef4f348717a3cf6fe2318f","a9ae0a3c070d455bb4369a8996313336",22854564,1,-7,0,479,120,114,-6
"a9ae0a3c070d455bb4369a8996313336","3ec3a3563847406fa73338f9e9999cf3",22854564,1,4,0,480,114,117,3
"3ec3a3563847406fa73338f9e9999cf3","62bff51286ef4f348717a3cf6fe2318f",22854564,1,3,0,481,117,120,3
"37319e88176d4aefa91d7a9980dbae91","e20db35ced8544ddac5bc3839145e463",22854564,1,-24,0,483,112,91,-21
"62bff51286ef4f348717a3cf6fe2318f","b1cd0e7dc3ad4a8eb91a4bfdbeb025b0",22854564,1,-2,0,485,120,118,-2
"b1cd0e7dc3ad4a8eb91a4bfdbeb025b0","b1cd0e7dc3ad4a8eb91a4bfdbeb025b0",22854564,1,0,1,486,118,118,0
"b1cd0e7dc3ad4a8eb91a4bfdbeb025b0","62bff51286ef4f348717a3cf6fe2318f",22854564,1,2,0,487,118,120,2
"62bff51286ef4f348717a3cf6fe2318f","62bff51286ef4f348717a3cf6fe2318f",22854564,5,0,1,488,120,120,0
"a8dd5213034441ac92724b4e83eb0bb2","779f9ddd1fd14d1e9e69f72219a1fdbd",22854564,2,-9,0,498,129,121,-8
"779f9ddd1fd14d1e9e69f72219a1fdbd","67a089198fcb4e1c8f2385786c2b296f",22854564,1,-103,0,499,121,39,-82
"67a089198fcb4e1c8f2385786c2b296f","78adeee1fa2c4fe0bc73f7bca9fcee86",22854564,1,152,0,500,39,160,121
"78adeee1fa2c4fe0bc73f7bca9fcee86","62bff51286ef4f348717a3cf6fe2318f",22854564,1,-52,0,501,160,120,-40
"62bff51286ef4f348717a3cf6fe2318f","ae26e6cda8ad4a3f81bd347560d9579f",22854564,1,7,0,504,120,125,5
"ae26e6cda8ad4a3f81bd347560d9579f","ae26e6cda8ad4a3f81bd347560d9579f",22854564,1,0,1,505,125,125,0
"ae26e6cda8ad4a3f81bd347560d9579f","ee48df95832b4374aa273ceb27ec1315",22854564,1,1,0,506,125,126,1
"ee48df95832b4374aa273ceb27ec1315","ee48df95832b4374aa273ceb27ec1315",22854564,1,0,1,507,126,126,0
"ee48df95832b4374aa273ceb27ec1315","7a439da90b394756ad1777fc4c6dead5",22854564,1,1,0,508,126,127,1
"7a439da90b394756ad1777fc4c6dead5","a8dd5213034441ac92724b4e83eb0bb2",22854564,1,3,0,509,127,129,2
"a8dd5213034441ac92724b4e83eb0bb2","8115eab6556b45f5b415c3b8c26a12e5",22854564,1,2,0,512,129,131,2
"8115eab6556b45f5b415c3b8c26a12e5","8115eab6556b45f5b415c3b8c26a12e5",22854564,1,0,1,513,131,131,0
"8115eab6556b45f5b415c3b8c26a12e5","ec34b06efd844b46a4c4818ecdb9b8f4",22854564,1,1,0,514,131,132,1
"ec34b06efd844b46a4c4818ecdb9b8f4","ec34b06efd844b46a4c4818ecdb9b8f4",22854564,1,0,1,515,132,132,0
"ec34b06efd844b46a4c4818ecdb9b8f4","c2e1c2b9eac64109b343a088584b576b",22854564,1,1,0,516,132,133,1
"c2e1c2b9eac64109b343a088584b576b","c2e1c2b9eac64109b343a088584b576b",22854564,1,0,1,517,133,133,0
"c2e1c2b9eac64109b343a088584b576b","8bc5795d6a984a3eace4e2811e52dd4f",22854564,1,3,0,518,133,135,2
"8bc5795d6a984a3eace4e2811e52dd4f","779f9ddd1fd14d1e9e69f72219a1fdbd",22854564,1,-16,0,519,135,121,-14
"779f9ddd1fd14d1e9e69f72219a1fdbd","cd4532ad48034873ba8bce2aac0c9808",22854564,1,19,0,521,121,137,16
"cd4532ad48034873ba8bce2aac0c9808","cd4532ad48034873ba8bce2aac0c9808",22854564,2,0,1,522,137,137,0
"cd4532ad48034873ba8bce2aac0c9808","779f9ddd1fd14d1e9e69f72219a1fdbd",22854564,1,-19,0,524,137,121,-16
"6c5ad271a44743479bfaea29b1db8d02","83d311bed5374fee83d8d67a7d9d82dc",22854564,1,1,0,527,143,144,1
"83d311bed5374fee83d8d67a7d9d82dc","402bba41861d43acb52a5abb89e8831e",22854564,1,1,0,528,144,145,1
"402bba41861d43acb52a5abb89e8831e","402bba41861d43acb52a5abb89e8831e",22854564,3,0,1,529,145,145,0
"402bba41861d43acb52a5abb89e8831e","8aae34f5ddbb4052a709b12e6b0d40fa",22854564,1,3,0,530,145,147,2
"8aae34f5ddbb4052a709b12e6b0d40fa","402bba41861d43acb52a5abb89e8831e",22854564,1,-3,0,531,147,145,-2
"402bba41861d43acb52a5abb89e8831e","df1de691dafe4549a18a4398ee9dfaf9",22854564,1,-6,0,534,145,139,-6
"8aae34f5ddbb4052a709b12e6b0d40fa","645b3f0249f64f76af2e19eb4d0e55b7",22854564,1,2,0,536,147,149,2
"645b3f0249f64f76af2e19eb4d0e55b7","645b3f0249f64f76af2e19eb4d0e55b7",22854564,2,0,1,537,149,149,0
"645b3f0249f64f76af2e19eb4d0e55b7","7e7b8db5064d4369805ab370aac5ddfb",22854564,1,1,0,539,149,150,1
"7e7b8db5064d4369805ab370aac5ddfb","7e7b8db5064d4369805ab370aac5ddfb",22854564,2,0,1,540,150,150,0
"7e7b8db5064d4369805ab370aac5ddfb","8956d210ae7f41968fada86d4c979d6a",22854564,1,1,0,542,150,151,1
"8956d210ae7f41968fada86d4c979d6a","8956d210ae7f41968fada86d4c979d6a",22854564,2,0,1,543,151,151,0
"8956d210ae7f41968fada86d4c979d6a","f902b0f41b544d4dbf79664fd233648d",22854564,1,-5,0,545,151,146,-5
"f902b0f41b544d4dbf79664fd233648d","ae781e8b775e4ccd93bc800dad5c8376",22854564,1,8,0,546,146,153,7
"ae781e8b775e4ccd93bc800dad5c8376","ae781e8b775e4ccd93bc800dad5c8376",22854564,2,0,1,547,153,153,0
"ae781e8b775e4ccd93bc800dad5c8376","06882a8492d9499aa31555567f575ecb",22854564,1,1,0,549,153,154,1
"06882a8492d9499aa31555567f575ecb","06882a8492d9499aa31555567f575ecb",22854564,1,0,1,550,154,154,0
"06882a8492d9499aa31555567f575ecb","f293c508f409466a8f27ddd7d1e40b20",22854564,1,1,0,551,154,155,1
"f293c508f409466a8f27ddd7d1e40b20","f293c508f409466a8f27ddd7d1e40b20",22854564,2,0,1,552,155,155,0
"f293c508f409466a8f27ddd7d1e40b20","cc4ddef5bbbe48ebb605141b347c4ed1",22854564,1,1,0,554,155,156,1
"cc4ddef5bbbe48ebb605141b347c4ed1","cc4ddef5bbbe48ebb605141b347c4ed1",22854564,1,0,1,555,156,156,0
"cc4ddef5bbbe48ebb605141b347c4ed1","f03480cf4eba413194d7af52fc0e7f28",22854564,1,-4,0,556,156,152,-4
"f03480cf4eba413194d7af52fc0e7f28","d313cec988a84645bee413e8d4724a4b",22854564,1,7,0,557,152,158,6
"d313cec988a84645bee413e8d4724a4b","d313cec988a84645bee413e8d4724a4b",22854564,4,0,1,558,158,158,0
"d313cec988a84645bee413e8d4724a4b","dc60696c76a74368a60f72246e47700d",22854564,1,1,0,562,158,159,1
"dc60696c76a74368a60f72246e47700d","dc60696c76a74368a60f72246e47700d",22854564,1,0,1,563,159,159,0
"dc60696c76a74368a60f72246e47700d","78adeee1fa2c4fe0bc73f7bca9fcee86",22854564,1,3,0,564,159,160,1
"df1de691dafe4549a18a4398ee9dfaf9","f902b0f41b544d4dbf79664fd233648d",22854564,1,8,0,570,139,146,7
"f902b0f41b544d4dbf79664fd233648d","8aae34f5ddbb4052a709b12e6b0d40fa",22854564,1,1,0,571,146,147,1
"8aae34f5ddbb4052a709b12e6b0d40fa","6c5ad271a44743479bfaea29b1db8d02",22854564,1,-5,0,572,147,143,-4
"df1de691dafe4549a18a4398ee9dfaf9","d9c8d8c444a64dadbbb508652c721e17",22854564,1,-116,0,579,139,46,-93
"d0c74f735e024943943e40333d6d337f","78adeee1fa2c4fe0bc73f7bca9fcee86",22854564,1,136,0,584,51,160,109
"65202579580f4ad38d734b4ee39d22a8","78adeee1fa2c4fe0bc73f7bca9fcee86",22854564,4,-5,0,587,164,160,-4
"78adeee1fa2c4fe0bc73f7bca9fcee86","8959e6304a0348309a771e4d08d1b64a",22854564,1,4,0,596,160,163,3
"8959e6304a0348309a771e4d08d1b64a","65202579580f4ad38d734b4ee39d22a8",22854564,1,1,0,597,163,164,1
"78adeee1fa2c4fe0bc73f7bca9fcee86","3cbcea2be0984e7dbd5a48195af10ce7",22854564,1,8,0,651,160,165,5
"3cbcea2be0984e7dbd5a48195af10ce7","82e6285962b8400d9d6fc32436022a94",22854564,1,2,0,652,165,167,2
"82e6285962b8400d9d6fc32436022a94","3cbcea2be0984e7dbd5a48195af10ce7",22854564,1,-2,0,653,167,165,-2
"3cbcea2be0984e7dbd5a48195af10ce7","a9ac840f098c4bd0a2ee896214ce29cd",22854564,1,5,0,654,165,168,3
"a9ac840f098c4bd0a2ee896214ce29cd","a9ac840f098c4bd0a2ee896214ce29cd",22854564,1,0,1,655,168,168,0
"a9ac840f098c4bd0a2ee896214ce29cd","0c7262dff33c4087bc660ccf40f92f9c",22854564,1,4,0,656,168,169,1
"0c7262dff33c4087bc660ccf40f92f9c","b2275c3fad834f8d90737a2d9a6927d6",22854564,3,3,0,657,169,172,3
"b2275c3fad834f8d90737a2d9a6927d6","78adeee1fa2c4fe0bc73f7bca9fcee86",22854564,2,-20,0,658,172,160,-12
"65202579580f4ad38d734b4ee39d22a8","b2275c3fad834f8d90737a2d9a6927d6",22854564,1,15,0,680,164,172,8
"65202579580f4ad38d734b4ee39d22a8","0c7262dff33c4087bc660ccf40f92f9c",22854564,1,12,0,692,164,169,5
"0c7262dff33c4087bc660ccf40f92f9c","0c7262dff33c4087bc660ccf40f92f9c",22854564,2,0,1,693,169,169,0
"b2275c3fad834f8d90737a2d9a6927d6","0c7262dff33c4087bc660ccf40f92f9c",22854564,1,-3,0,695,172,169,-3
"0c7262dff33c4087bc660ccf40f92f9c","b42cc17b7de840f181a704558d0bc845",22854564,2,7,0,696,169,175,6
"b42cc17b7de840f181a704558d0bc845","b42cc17b7de840f181a704558d0bc845",22854564,7,0,1,697,175,175,0
"b42cc17b7de840f181a704558d0bc845","0c7262dff33c4087bc660ccf40f92f9c",22854564,1,-7,0,698,175,169,-6
"b2275c3fad834f8d90737a2d9a6927d6","b2275c3fad834f8d90737a2d9a6927d6",22854564,44,0,1,701,172,172,0
"b2275c3fad834f8d90737a2d9a6927d6","eb515a26030b41f8a82a1e6114420bad",22854564,1,1,0,745,172,173,1
"eb515a26030b41f8a82a1e6114420bad","eb515a26030b41f8a82a1e6114420bad",22854564,5,0,1,746,173,173,0
"eb515a26030b41f8a82a1e6114420bad","0c7262dff33c4087bc660ccf40f92f9c",22854564,1,-4,0,751,173,169,-4
"b42cc17b7de840f181a704558d0bc845","801f9e9135034f49bf5f8b4bdefedb41",22854564,1,2,0,755,175,177,2
"801f9e9135034f49bf5f8b4bdefedb41","801f9e9135034f49bf5f8b4bdefedb41",22854564,7,0,1,756,177,177,0
"801f9e9135034f49bf5f8b4bdefedb41","b42cc17b7de840f181a704558d0bc845",22854564,1,-2,0,763,177,175,-2
"b42cc17b7de840f181a704558d0bc845","362fcb0699a14845ab29b2340093e528",22854564,1,-1,0,768,175,174,-1
"362fcb0699a14845ab29b2340093e528","b87c552dd247427abe6ab5795b9c9d43",22854564,1,8,0,769,174,181,7
"b87c552dd247427abe6ab5795b9c9d43","ea38cc0e6e6e41edbabf210220808bf9",22854564,1,-2,0,770,181,179,-2
"ea38cc0e6e6e41edbabf210220808bf9","ea38cc0e6e6e41edbabf210220808bf9",22854564,3,0,1,771,179,179,0
"ea38cc0e6e6e41edbabf210220808bf9","b87c552dd247427abe6ab5795b9c9d43",22854564,2,2,0,774,179,181,2
"b87c552dd247427abe6ab5795b9c9d43","b87c552dd247427abe6ab5795b9c9d43",22854564,13,0,1,775,181,181,0
"b87c552dd247427abe6ab5795b9c9d43","139b097acfca451689d80c9c6eebdf7b",22854564,1,-3,0,788,181,178,-3
"139b097acfca451689d80c9c6eebdf7b","30f660a1feb34582a739722532524f79",22854564,1,6,0,789,178,183,5
"30f660a1feb34582a739722532524f79","30f660a1feb34582a739722532524f79",22854564,5,0,1,790,183,183,0
"30f660a1feb34582a739722532524f79","2024b4885bd14338a39b7b509acbbd02",22854564,1,-1,0,795,183,182,-1
"2024b4885bd14338a39b7b509acbbd02","c3f63fe50d8e487c86bf8ef76c9cadd3",22854564,1,4,0,796,182,185,3
"c3f63fe50d8e487c86bf8ef76c9cadd3","c3f63fe50d8e487c86bf8ef76c9cadd3",22854564,1,0,1,797,185,185,0
"c3f63fe50d8e487c86bf8ef76c9cadd3","0c7262dff33c4087bc660ccf40f92f9c",22854564,1,-20,0,798,185,169,-16
"0c7262dff33c4087bc660ccf40f92f9c","c8e371568a0c4391b25796ae4e91952e",22854564,1,23,0,799,169,186,17
"c8e371568a0c4391b25796ae4e91952e","7d932b23e1c84326ae5aa4d3c0d813d1",22854564,1,2,0,800,186,188,2
"7d932b23e1c84326ae5aa4d3c0d813d1","7d932b23e1c84326ae5aa4d3c0d813d1",22854564,1,0,1,801,188,188,0
"7d932b23e1c84326ae5aa4d3c0d813d1","ab11d94c6c8948ea90b88f19d2cd502b",22854564,1,3,0,802,188,190,2
"ab11d94c6c8948ea90b88f19d2cd502b","c8e371568a0c4391b25796ae4e91952e",22854564,2,-5,0,803,190,186,-4
"c8e371568a0c4391b25796ae4e91952e","ab11d94c6c8948ea90b88f19d2cd502b",22854564,3,5,0,804,186,190,4
"ab11d94c6c8948ea90b88f19d2cd502b","ab11d94c6c8948ea90b88f19d2cd502b",22854564,13,0,1,805,190,190,0
"ab11d94c6c8948ea90b88f19d2cd502b","07b44a7a51e94c78b411c753fc39dab0",22854564,2,-1,0,807,190,189,-1
"07b44a7a51e94c78b411c753fc39dab0","07b44a7a51e94c78b411c753fc39dab0",22854564,1,0,1,808,189,189,0
"07b44a7a51e94c78b411c753fc39dab0","c8e371568a0c4391b25796ae4e91952e",22854564,1,-4,0,809,189,186,-3
"c8e371568a0c4391b25796ae4e91952e","07b44a7a51e94c78b411c753fc39dab0",22854564,1,4,0,812,186,189,3
"07b44a7a51e94c78b411c753fc39dab0","ab11d94c6c8948ea90b88f19d2cd502b",22854564,1,1,0,813,189,190,1
"ab11d94c6c8948ea90b88f19d2cd502b","f992451ed6ad4e68bb9e68ad6be7c4be",22854564,1,2,0,824,190,192,2
"f992451ed6ad4e68bb9e68ad6be7c4be","f992451ed6ad4e68bb9e68ad6be7c4be",22854564,6,0,1,825,192,192,0
"f992451ed6ad4e68bb9e68ad6be7c4be","07b44a7a51e94c78b411c753fc39dab0",22854564,1,-3,0,831,192,189,-3
"07b44a7a51e94c78b411c753fc39dab0","6cd2dcaac46847d4a0bc53f296d90375",22854564,2,6,0,832,189,194,5
"6cd2dcaac46847d4a0bc53f296d90375","6cd2dcaac46847d4a0bc53f296d90375",22854564,6,0,1,833,194,194,0
"6cd2dcaac46847d4a0bc53f296d90375","b42cc17b7de840f181a704558d0bc845",22854564,1,-26,0,834,194,175,-19
"b42cc17b7de840f181a704558d0bc845","ea38cc0e6e6e41edbabf210220808bf9",22854564,1,5,0,835,175,179,4
"b87c552dd247427abe6ab5795b9c9d43","ab11d94c6c8948ea90b88f19d2cd502b",22854564,1,14,0,837,181,190,9
"ab11d94c6c8948ea90b88f19d2cd502b","6cd2dcaac46847d4a0bc53f296d90375",22854564,1,5,0,838,190,194,4
"6cd2dcaac46847d4a0bc53f296d90375","c8e371568a0c4391b25796ae4e91952e",22854564,1,-10,0,839,194,186,-8
"c8e371568a0c4391b25796ae4e91952e","f9170dd6bc6442b4acd832747609b09a",22854564,2,16,0,840,186,199,13
"f9170dd6bc6442b4acd832747609b09a","f9170dd6bc6442b4acd832747609b09a",22854564,1,0,1,841,199,199,0
"f9170dd6bc6442b4acd832747609b09a","6cd2dcaac46847d4a0bc53f296d90375",22854564,3,-6,0,842,199,194,-5
"6cd2dcaac46847d4a0bc53f296d90375","2d2580c9411c4972909db508d6956a58",22854564,1,2,0,844,194,196,2
"2d2580c9411c4972909db508d6956a58","2d2580c9411c4972909db508d6956a58",22854564,8,0,1,845,196,196,0
"2d2580c9411c4972909db508d6956a58","5bddb3d9ed264f3984702f048c7e5340",22854564,1,1,0,853,196,197,1
"5bddb3d9ed264f3984702f048c7e5340","5bddb3d9ed264f3984702f048c7e5340",22854564,2,0,1,854,197,197,0
"5bddb3d9ed264f3984702f048c7e5340","d5e8e2bd12a2466b9d6d90855f0eb079",22854564,1,1,0,856,197,198,1
"d5e8e2bd12a2466b9d6d90855f0eb079","d5e8e2bd12a2466b9d6d90855f0eb079",22854564,2,0,1,857,198,198,0
"d5e8e2bd12a2466b9d6d90855f0eb079","017d7ca8e0394b91aaadc9574df2202c",22854564,1,-5,0,859,198,193,-5
"017d7ca8e0394b91aaadc9574df2202c","54e8e9f0ea3e45c4bf3b8ac799ee31b1",22854564,1,8,0,860,193,200,7
"54e8e9f0ea3e45c4bf3b8ac799ee31b1","54e8e9f0ea3e45c4bf3b8ac799ee31b1",22854564,1,0,1,861,200,200,0
"54e8e9f0ea3e45c4bf3b8ac799ee31b1","f9170dd6bc6442b4acd832747609b09a",22854564,1,-1,0,862,200,199,-1
"f9170dd6bc6442b4acd832747609b09a","b54257a550b94ebc9538f3a90eee9d7e",22854564,1,6,0,863,199,204,5
"b54257a550b94ebc9538f3a90eee9d7e","c614a00911be4877a075f19315530fb0",22854564,1,-4,0,864,204,201,-3
"c614a00911be4877a075f19315530fb0","c614a00911be4877a075f19315530fb0",22854564,6,0,1,865,201,201,0
"c614a00911be4877a075f19315530fb0","d9c8d8c444a64dadbbb508652c721e17",22854564,1,-200,0,871,201,46,-155
"78f30e4dcac84e3cbea8b2cc6e0d62b3","c8e371568a0c4391b25796ae4e91952e",22854564,1,167,0,882,59,186,127
"f9170dd6bc6442b4acd832747609b09a","c8e371568a0c4391b25796ae4e91952e",22854564,1,-16,0,884,199,186,-13
"6cd2dcaac46847d4a0bc53f296d90375","017d7ca8e0394b91aaadc9574df2202c",22854564,3,-1,0,893,194,193,-1
"017d7ca8e0394b91aaadc9574df2202c","a6c21bd8b95249c7972820a7a7d76aff",22854564,1,10,0,894,193,202,9
"a6c21bd8b95249c7972820a7a7d76aff","a6c21bd8b95249c7972820a7a7d76aff",22854564,1,0,1,895,202,202,0
"a6c21bd8b95249c7972820a7a7d76aff","f9170dd6bc6442b4acd832747609b09a",22854564,1,-3,0,896,202,199,-3
"017d7ca8e0394b91aaadc9574df2202c","f9170dd6bc6442b4acd832747609b09a",22854564,1,7,0,899,193,199,6
"017d7ca8e0394b91aaadc9574df2202c","bb329d880ab54120adaf203a693bb203",22854564,1,11,0,902,193,203,10
"bb329d880ab54120adaf203a693bb203","c8e371568a0c4391b25796ae4e91952e",22854564,1,-20,0,903,203,186,-17
"c8e371568a0c4391b25796ae4e91952e","bb329d880ab54120adaf203a693bb203",22854564,1,20,0,904,186,203,17
"bb329d880ab54120adaf203a693bb203","bb329d880ab54120adaf203a693bb203",22854564,1,0,1,905,203,203,0
"bb329d880ab54120adaf203a693bb203","f9170dd6bc6442b4acd832747609b09a",22854564,1,-4,0,906,203,199,-4
"f9170dd6bc6442b4acd832747609b09a","334c2344009840079b1d0e1b7ce3d5a7",22854564,1,7,0,907,199,205,6
"334c2344009840079b1d0e1b7ce3d5a7","334c2344009840079b1d0e1b7ce3d5a7",22854564,1,0,1,908,205,205,0
"334c2344009840079b1d0e1b7ce3d5a7","d7f13c8d63ec4e2aa673fbb9cf9c6933",22854564,1,3,0,909,205,206,1
"d7f13c8d63ec4e2aa673fbb9cf9c6933","c8e371568a0c4391b25796ae4e91952e",22854564,1,-26,0,910,206,186,-20
"c8e371568a0c4391b25796ae4e91952e","b9e80f77c3a44349863b19875725c384",22854564,1,27,0,911,186,207,21
"b9e80f77c3a44349863b19875725c384","7108f0e4c2584f1f9c471689ae4c885c",22854564,2,1,0,912,207,208,1
"7108f0e4c2584f1f9c471689ae4c885c","b9e80f77c3a44349863b19875725c384",22854564,1,-1,0,913,208,207,-1
"b9e80f77c3a44349863b19875725c384","b9e80f77c3a44349863b19875725c384",22854564,27,0,1,914,207,207,0
"7108f0e4c2584f1f9c471689ae4c885c","7108f0e4c2584f1f9c471689ae4c885c",22854564,10,0,1,942,208,208,0
"7108f0e4c2584f1f9c471689ae4c885c","d7f13c8d63ec4e2aa673fbb9cf9c6933",22854564,1,-2,0,952,208,206,-2
"09400e101c5d4b439cf9a26b03aae558","09400e101c5d4b439cf9a26b03aae558",22854564,7,0,1,954,210,210,0
"09400e101c5d4b439cf9a26b03aae558","a88efa7e50ce47159810ab553afa6d3a",22854564,1,2,0,955,210,212,2
"a88efa7e50ce47159810ab553afa6d3a","a88efa7e50ce47159810ab553afa6d3a",22854564,11,0,1,956,212,212,0
"a88efa7e50ce47159810ab553afa6d3a","a875096404ef4a9984b62d74cda916f9",22854564,1,-3,0,967,212,209,-3
"a875096404ef4a9984b62d74cda916f9","be502a7a43c44bf7b682698de79d9369",22854564,1,6,0,968,209,214,5
"be502a7a43c44bf7b682698de79d9369","f7fb1952f56b4189b86a9f8b7862d2b8",22854564,2,1,0,969,214,215,1
"f7fb1952f56b4189b86a9f8b7862d2b8","a875096404ef4a9984b62d74cda916f9",22854564,1,-7,0,971,215,209,-6
"a875096404ef4a9984b62d74cda916f9","d7f13c8d63ec4e2aa673fbb9cf9c6933",22854564,1,-4,0,972,209,206,-3
"a875096404ef4a9984b62d74cda916f9","f7fb1952f56b4189b86a9f8b7862d2b8",22854564,2,7,0,979,209,215,6
"ec341f459285443b8361f7f15638ff08","09400e101c5d4b439cf9a26b03aae558",22854564,1,-4,0,983,213,210,-3
"09400e101c5d4b439cf9a26b03aae558","be502a7a43c44bf7b682698de79d9369",22854564,1,5,0,986,210,214,4
"be502a7a43c44bf7b682698de79d9369","a875096404ef4a9984b62d74cda916f9",22854564,1,-6,0,987,214,209,-5
"f7fb1952f56b4189b86a9f8b7862d2b8","f7fb1952f56b4189b86a9f8b7862d2b8",22854564,18,0,1,1000,215,215,0
"f7fb1952f56b4189b86a9f8b7862d2b8","b860ee85d8bc4a2f97958cfb71be3533",22854564,1,1,0,1012,215,216,1
"b860ee85d8bc4a2f97958cfb71be3533","b860ee85d8bc4a2f97958cfb71be3533",22854564,2,0,1,1013,216,216,0
"b860ee85d8bc4a2f97958cfb71be3533","ec341f459285443b8361f7f15638ff08",22854564,1,-3,0,1015,216,213,-3
"ec341f459285443b8361f7f15638ff08","363837c182e04711840d896ae1e0339c",22854564,1,6,0,1016,213,218,5
"363837c182e04711840d896ae1e0339c","363837c182e04711840d896ae1e0339c",22854564,22,0,1,1017,218,218,0
"363837c182e04711840d896ae1e0339c","d7f13c8d63ec4e2aa673fbb9cf9c6933",22854564,2,-15,0,1033,218,206,-12
"d7f13c8d63ec4e2aa673fbb9cf9c6933","09400e101c5d4b439cf9a26b03aae558",22854564,3,5,0,1034,206,210,4
"09400e101c5d4b439cf9a26b03aae558","a875096404ef4a9984b62d74cda916f9",22854564,2,-1,0,1035,210,209,-1
"a875096404ef4a9984b62d74cda916f9","363837c182e04711840d896ae1e0339c",22854564,1,11,0,1036,209,218,9
"363837c182e04711840d896ae1e0339c","01b2051f8941460d89945e3b02d1ce78",22854564,1,-1,0,1043,218,217,-1
"01b2051f8941460d89945e3b02d1ce78","91125ca626c5470eb145501f8c37f8db",22854564,1,4,0,1044,217,220,3
"91125ca626c5470eb145501f8c37f8db","91125ca626c5470eb145501f8c37f8db",22854564,1,0,1,1045,220,220,0
"91125ca626c5470eb145501f8c37f8db","1c6721b1f63f4d30ba7746ea8af02a52",22854564,1,3,0,1046,220,221,1
"1c6721b1f63f4d30ba7746ea8af02a52","d7f13c8d63ec4e2aa673fbb9cf9c6933",22854564,3,-21,0,1047,221,206,-15
"d7f13c8d63ec4e2aa673fbb9cf9c6933","77ecef8eff6b4a2caea7707669bf7475",22854564,1,22,0,1048,206,222,16
"77ecef8eff6b4a2caea7707669bf7475","1c6721b1f63f4d30ba7746ea8af02a52",22854564,3,-1,0,1049,222,221,-1
"d7f13c8d63ec4e2aa673fbb9cf9c6933","be95c065e45447c1bd8215ea6f130c7a",22854564,1,17,0,1051,206,219,13
"be95c065e45447c1bd8215ea6f130c7a","363837c182e04711840d896ae1e0339c",22854564,1,-2,0,1052,219,218,-1
"363837c182e04711840d896ae1e0339c","be502a7a43c44bf7b682698de79d9369",22854564,1,-5,0,1053,218,214,-4
"be502a7a43c44bf7b682698de79d9369","01b2051f8941460d89945e3b02d1ce78",22854564,1,4,0,1054,214,217,3
"01b2051f8941460d89945e3b02d1ce78","f7fb1952f56b4189b86a9f8b7862d2b8",22854564,1,-3,0,1055,217,215,-2
"f7fb1952f56b4189b86a9f8b7862d2b8","be502a7a43c44bf7b682698de79d9369",22854564,3,-1,0,1056,215,214,-1
"be502a7a43c44bf7b682698de79d9369","be502a7a43c44bf7b682698de79d9369",22854564,16,0,1,1057,214,214,0
"be502a7a43c44bf7b682698de79d9369","ec341f459285443b8361f7f15638ff08",22854564,2,-1,0,1068,214,213,-1
"ec341f459285443b8361f7f15638ff08","01b2051f8941460d89945e3b02d1ce78",22854564,1,5,0,1069,213,217,4
"01b2051f8941460d89945e3b02d1ce78","363837c182e04711840d896ae1e0339c",22854564,1,1,0,1070,217,218,1
"d7f13c8d63ec4e2aa673fbb9cf9c6933","1c6721b1f63f4d30ba7746ea8af02a52",22854564,2,21,0,1072,206,221,15
"1c6721b1f63f4d30ba7746ea8af02a52","77ecef8eff6b4a2caea7707669bf7475",22854564,1,1,0,1075,221,222,1
"1c6721b1f63f4d30ba7746ea8af02a52","d03cb855c70044cf8c35d9ec0de696e3",22854564,3,4,0,1077,221,224,3
"d03cb855c70044cf8c35d9ec0de696e3","8b9ae98743bd4d4a8a87dff1c1244211",22854564,3,3,0,1078,224,227,3
"8b9ae98743bd4d4a8a87dff1c1244211","d03cb855c70044cf8c35d9ec0de696e3",22854564,2,-3,0,1079,227,224,-3
"d03cb855c70044cf8c35d9ec0de696e3","2ab1535aac1346ba8801535bf729ef37",22854564,1,6,0,1080,224,229,5
"2ab1535aac1346ba8801535bf729ef37","f7906d6f59b9489a91d2ef40db5a474d",22854564,1,-7,0,1081,229,223,-6
"f7906d6f59b9489a91d2ef40db5a474d","2ab1535aac1346ba8801535bf729ef37",22854564,2,7,0,1082,223,229,6
"2ab1535aac1346ba8801535bf729ef37","5152833676bf4c6cb317060be10f68db",22854564,1,-1,0,1083,229,228,-1
"5152833676bf4c6cb317060be10f68db","0b04c8e2f86d48c7aeb7e225819cd32b",22854564,1,7,0,1084,228,234,6
"0b04c8e2f86d48c7aeb7e225819cd32b","64dbedb3ce544f6aae8e10e0cf10f16d",22854564,1,7,0,1085,234,240,6
"64dbedb3ce544f6aae8e10e0cf10f16d","77ecef8eff6b4a2caea7707669bf7475",22854564,1,-22,0,1086,240,222,-18
"77ecef8eff6b4a2caea7707669bf7475","77ecef8eff6b4a2caea7707669bf7475",22854564,12,0,1,1087,222,222,0
"77ecef8eff6b4a2caea7707669bf7475","d03cb855c70044cf8c35d9ec0de696e3",22854564,1,3,0,1099,222,224,2
"d03cb855c70044cf8c35d9ec0de696e3","1c6721b1f63f4d30ba7746ea8af02a52",22854564,1,-4,0,1100,224,221,-3
"1c6721b1f63f4d30ba7746ea8af02a52","8b9ae98743bd4d4a8a87dff1c1244211",22854564,1,7,0,1101,221,227,6
"8b9ae98743bd4d4a8a87dff1c1244211","2ae94c0cea4d480a9d5dca8fb1d7b542",22854564,1,20,0,1102,227,242,15
"2ae94c0cea4d480a9d5dca8fb1d7b542","2ae94c0cea4d480a9d5dca8fb1d7b542",22854564,2,0,1,1103,242,242,0
"2ae94c0cea4d480a9d5dca8fb1d7b542","1ebf23f9d994469a85206e4c7b1bf5f5",22854564,4,3,0,1104,242,245,3
"1ebf23f9d994469a85206e4c7b1bf5f5","2ae94c0cea4d480a9d5dca8fb1d7b542",22854564,2,-3,0,1105,245,242,-3
"2ae94c0cea4d480a9d5dca8fb1d7b542","fa235f0f364d47e4ae1c87f47bf8e6ba",22854564,2,12,0,1106,242,252,10
"fa235f0f364d47e4ae1c87f47bf8e6ba","fa235f0f364d47e4ae1c87f47bf8e6ba",22854564,22,0,1,1107,252,252,0
"fa235f0f364d47e4ae1c87f47bf8e6ba","00f61990949545828dd12f1303d47504",22854564,1,5,0,1108,252,256,4
"00f61990949545828dd12f1303d47504","6e83e23f56544a19b94067c1c558d9c0",22854564,1,-11,0,1109,256,247,-9
"6e83e23f56544a19b94067c1c558d9c0","00f61990949545828dd12f1303d47504",22854564,4,11,0,1110,247,256,9
"00f61990949545828dd12f1303d47504","d546341988904f069cfa86b21457d9d9",22854564,3,-6,0,1111,256,251,-5
"d546341988904f069cfa86b21457d9d9","d989ebcfc12a4b669f0100dc1aa14f1e",22854564,3,5,0,1112,251,255,4
"d989ebcfc12a4b669f0100dc1aa14f1e","7aa76d3e993840d8805f097cbdbcd44b",22854564,3,7,0,1113,255,261,6
"7aa76d3e993840d8805f097cbdbcd44b","0c7262dff33c4087bc660ccf40f92f9c",22854564,1,-120,0,1114,261,169,-92
"0c7262dff33c4087bc660ccf40f92f9c","0d987bed3ffa4ed0b9a2e62e97b7b30f",22854564,1,135,0,1115,169,272,103
"0d987bed3ffa4ed0b9a2e62e97b7b30f","0d987bed3ffa4ed0b9a2e62e97b7b30f",22854564,4,0,1,1116,272,272,0
"0d987bed3ffa4ed0b9a2e62e97b7b30f","bb5a47f5ea01454a8b79455422d3b9da",22854564,3,10,0,1118,272,280,8
"bb5a47f5ea01454a8b79455422d3b9da","bb5a47f5ea01454a8b79455422d3b9da",22854564,87,0,1,1119,280,280,0
"bb5a47f5ea01454a8b79455422d3b9da","82ae07bc0c9b4570a41799290d1ef399",22854564,3,-6,0,1120,280,275,-5
"82ae07bc0c9b4570a41799290d1ef399","bb5a47f5ea01454a8b79455422d3b9da",22854564,4,6,0,1121,275,280,5
"bb5a47f5ea01454a8b79455422d3b9da","94cecc3f1e7d484b8e068e79241dfd73",22854564,1,3,0,1127,280,281,1
"94cecc3f1e7d484b8e068e79241dfd73","94cecc3f1e7d484b8e068e79241dfd73",22854564,1,0,1,1128,281,281,0
"94cecc3f1e7d484b8e068e79241dfd73","a37477c4e4c14169ad44b06b493007f6",22854564,3,2,0,1129,281,283,2
"a37477c4e4c14169ad44b06b493007f6","1c6721b1f63f4d30ba7746ea8af02a52",22854564,1,-80,0,1130,283,221,-62
"8b9ae98743bd4d4a8a87dff1c1244211","f7906d6f59b9489a91d2ef40db5a474d",22854564,2,-4,0,1133,227,223,-4
"f7906d6f59b9489a91d2ef40db5a474d","77ecef8eff6b4a2caea7707669bf7475",22854564,1,-2,0,1134,223,222,-1
"d03cb855c70044cf8c35d9ec0de696e3","d03cb855c70044cf8c35d9ec0de696e3",22854564,3,0,1,1139,224,224,0
"d03cb855c70044cf8c35d9ec0de696e3","a49a937d6896486d9a5396654abcf2e1",22854564,1,2,0,1142,224,226,2
"a49a937d6896486d9a5396654abcf2e1","a49a937d6896486d9a5396654abcf2e1",22854564,3,0,1,1143,226,226,0
"a49a937d6896486d9a5396654abcf2e1","8b9ae98743bd4d4a8a87dff1c1244211",22854564,1,1,0,1146,226,227,1
"8b9ae98743bd4d4a8a87dff1c1244211","8b9ae98743bd4d4a8a87dff1c1244211",22854564,15,0,1,1147,227,227,0
"2ab1535aac1346ba8801535bf729ef37","2ab1535aac1346ba8801535bf729ef37",22854564,2,0,1,1164,229,229,0
"2ab1535aac1346ba8801535bf729ef37","a4f40fb48a8542c8949bae1f002cd9bc",22854564,1,2,0,1166,229,231,2
"a4f40fb48a8542c8949bae1f002cd9bc","a4f40fb48a8542c8949bae1f002cd9bc",22854564,2,0,1,1167,231,231,0
"a4f40fb48a8542c8949bae1f002cd9bc","8972c23e32044edb8a78fa1eed4e5947",22854564,1,1,0,1169,231,232,1
"8972c23e32044edb8a78fa1eed4e5947","8972c23e32044edb8a78fa1eed4e5947",22854564,1,0,1,1170,232,232,0
"8972c23e32044edb8a78fa1eed4e5947","92feb4a40f8344d38b6f722e42a53295",22854564,1,1,0,1171,232,233,1
"92feb4a40f8344d38b6f722e42a53295","92feb4a40f8344d38b6f722e42a53295",22854564,2,0,1,1172,233,233,0
"92feb4a40f8344d38b6f722e42a53295","5152833676bf4c6cb317060be10f68db",22854564,1,-5,0,1174,233,228,-5
"5152833676bf4c6cb317060be10f68db","ca3e28f290354c08aefe5b0f769604e6",22854564,1,8,0,1175,228,235,7
"ca3e28f290354c08aefe5b0f769604e6","ca3e28f290354c08aefe5b0f769604e6",22854564,9,0,1,1176,235,235,0
"ca3e28f290354c08aefe5b0f769604e6","79a35eea833e4c2c9d22fc53c3c6445c",22854564,1,1,0,1185,235,236,1
"79a35eea833e4c2c9d22fc53c3c6445c","79a35eea833e4c2c9d22fc53c3c6445c",22854564,4,0,1,1186,236,236,0
"79a35eea833e4c2c9d22fc53c3c6445c","8f68228b1518449e9615cdafee41a2bd",22854564,1,1,0,1190,236,237,1
"8f68228b1518449e9615cdafee41a2bd","8f68228b1518449e9615cdafee41a2bd",22854564,1,0,1,1191,237,237,0
"8f68228b1518449e9615cdafee41a2bd","cab89fa5c3ed45a5aa550fc0352d6a42",22854564,1,1,0,1192,237,238,1
"cab89fa5c3ed45a5aa550fc0352d6a42","cab89fa5c3ed45a5aa550fc0352d6a42",22854564,1,0,1,1193,238,238,0
"cab89fa5c3ed45a5aa550fc0352d6a42","66d4fad4f1cf4b46be0750a99ad7a35a",22854564,1,1,0,1194,238,239,1
"66d4fad4f1cf4b46be0750a99ad7a35a","66d4fad4f1cf4b46be0750a99ad7a35a",22854564,1,0,1,1195,239,239,0
"66d4fad4f1cf4b46be0750a99ad7a35a","0b04c8e2f86d48c7aeb7e225819cd32b",22854564,1,-5,0,1196,239,234,-5
"0b04c8e2f86d48c7aeb7e225819cd32b","f53da5fd9bfe412da4b80d4742563b6c",22854564,1,8,0,1197,234,241,7
"f53da5fd9bfe412da4b80d4742563b6c","f53da5fd9bfe412da4b80d4742563b6c",22854564,1,0,1,1198,241,241,0
"f53da5fd9bfe412da4b80d4742563b6c","1c6721b1f63f4d30ba7746ea8af02a52",22854564,1,-24,0,1199,241,221,-20
"1c6721b1f63f4d30ba7746ea8af02a52","2ae94c0cea4d480a9d5dca8fb1d7b542",22854564,1,27,0,1200,221,242,21
"1ebf23f9d994469a85206e4c7b1bf5f5","1ebf23f9d994469a85206e4c7b1bf5f5",22854564,11,0,1,1202,245,245,0
"1ebf23f9d994469a85206e4c7b1bf5f5","85ae675b83e8422da842cfd25596af99",22854564,1,1,0,1213,245,246,1
"85ae675b83e8422da842cfd25596af99","fa235f0f364d47e4ae1c87f47bf8e6ba",22854564,1,8,0,1214,246,252,6
"fa235f0f364d47e4ae1c87f47bf8e6ba","2ae94c0cea4d480a9d5dca8fb1d7b542",22854564,2,-12,0,1215,252,242,-10
"1ebf23f9d994469a85206e4c7b1bf5f5","fa235f0f364d47e4ae1c87f47bf8e6ba",22854564,1,9,0,1217,245,252,7
"fa235f0f364d47e4ae1c87f47bf8e6ba","79f7845465cc4ed19d8e4f1429541be0",22854564,1,2,0,1241,252,254,2
"79f7845465cc4ed19d8e4f1429541be0","79f7845465cc4ed19d8e4f1429541be0",22854564,2,0,1,1242,254,254,0
"79f7845465cc4ed19d8e4f1429541be0","6e83e23f56544a19b94067c1c558d9c0",22854564,1,-8,0,1244,254,247,-7
"d546341988904f069cfa86b21457d9d9","00f61990949545828dd12f1303d47504",22854564,1,6,0,1247,251,256,5
"00f61990949545828dd12f1303d47504","d989ebcfc12a4b669f0100dc1aa14f1e",22854564,3,-1,0,1248,256,255,-1
"d989ebcfc12a4b669f0100dc1aa14f1e","d546341988904f069cfa86b21457d9d9",22854564,1,-5,0,1249,255,251,-4
"d546341988904f069cfa86b21457d9d9","7aa76d3e993840d8805f097cbdbcd44b",22854564,1,12,0,1250,251,261,10
"7aa76d3e993840d8805f097cbdbcd44b","7028800abe7d4e27b613d1d6cbe26bf7",22854564,2,7,0,1251,261,267,6
"7028800abe7d4e27b613d1d6cbe26bf7","00f61990949545828dd12f1303d47504",22854564,1,-13,0,1252,267,256,-11
"d989ebcfc12a4b669f0100dc1aa14f1e","2ae94c0cea4d480a9d5dca8fb1d7b542",22854564,1,-16,0,1254,255,242,-13
"2ae94c0cea4d480a9d5dca8fb1d7b542","00f61990949545828dd12f1303d47504",22854564,1,17,0,1255,242,256,14
"d989ebcfc12a4b669f0100dc1aa14f1e","00f61990949545828dd12f1303d47504",22854564,1,1,0,1257,255,256,1
"00f61990949545828dd12f1303d47504","00f61990949545828dd12f1303d47504",22854564,4,0,1,1258,256,256,0
"00f61990949545828dd12f1303d47504","ead7bb4b64e247d2ae632ab8a296b091",22854564,1,2,0,1262,256,258,2
"ead7bb4b64e247d2ae632ab8a296b091","ead7bb4b64e247d2ae632ab8a296b091",22854564,2,0,1,1263,258,258,0
"ead7bb4b64e247d2ae632ab8a296b091","41b0048dde734bb280bac6116baa8e27",22854564,1,1,0,1265,258,259,1
"41b0048dde734bb280bac6116baa8e27","41b0048dde734bb280bac6116baa8e27",22854564,2,0,1,1266,259,259,0
"41b0048dde734bb280bac6116baa8e27","b41c5a094a604ee0915327da5cc0beb7",22854564,1,1,0,1268,259,260,1
"b41c5a094a604ee0915327da5cc0beb7","b41c5a094a604ee0915327da5cc0beb7",22854564,2,0,1,1269,260,260,0
"b41c5a094a604ee0915327da5cc0beb7","d546341988904f069cfa86b21457d9d9",22854564,1,-10,0,1271,260,251,-9
"7028800abe7d4e27b613d1d6cbe26bf7","28c171777c52431ab6b925073bd63d46",22854564,1,-4,0,1275,267,264,-3
"28c171777c52431ab6b925073bd63d46","28c171777c52431ab6b925073bd63d46",22854564,7,0,1,1276,264,264,0
"28c171777c52431ab6b925073bd63d46","ac160db940cb49ae8579162b1d52bb5d",22854564,1,2,0,1283,264,266,2
"ac160db940cb49ae8579162b1d52bb5d","ac160db940cb49ae8579162b1d52bb5d",22854564,3,0,1,1284,266,266,0
"ac160db940cb49ae8579162b1d52bb5d","d989ebcfc12a4b669f0100dc1aa14f1e",22854564,1,-12,0,1287,266,255,-11
"d989ebcfc12a4b669f0100dc1aa14f1e","c6fd49b485cc4874b0bbdd9c6171e09c",22854564,1,15,0,1288,255,268,13
"c6fd49b485cc4874b0bbdd9c6171e09c","c6fd49b485cc4874b0bbdd9c6171e09c",22854564,3,0,1,1289,268,268,0
"c6fd49b485cc4874b0bbdd9c6171e09c","44240778a97c4af0937817499b75707b",22854564,1,1,0,1292,268,269,1
"44240778a97c4af0937817499b75707b","44240778a97c4af0937817499b75707b",22854564,2,0,1,1293,269,269,0
"44240778a97c4af0937817499b75707b","7aa76d3e993840d8805f097cbdbcd44b",22854564,1,-9,0,1295,269,261,-8
"7aa76d3e993840d8805f097cbdbcd44b","865a4d3b43374da7944dc7d397f566d9",22854564,1,12,0,1296,261,271,10
"865a4d3b43374da7944dc7d397f566d9","865a4d3b43374da7944dc7d397f566d9",22854564,1,0,1,1297,271,271,0
"865a4d3b43374da7944dc7d397f566d9","0d987bed3ffa4ed0b9a2e62e97b7b30f",22854564,1,3,0,1298,271,272,1
"0d987bed3ffa4ed0b9a2e62e97b7b30f","2ae94c0cea4d480a9d5dca8fb1d7b542",22854564,1,-38,0,1299,272,242,-30
"2ae94c0cea4d480a9d5dca8fb1d7b542","0d987bed3ffa4ed0b9a2e62e97b7b30f",22854564,3,38,0,1300,242,272,30
"bb5a47f5ea01454a8b79455422d3b9da","78adeee1fa2c4fe0bc73f7bca9fcee86",22854564,1,-162,0,1310,280,160,-120
"78adeee1fa2c4fe0bc73f7bca9fcee86","78adeee1fa2c4fe0bc73f7bca9fcee86",22854564,8,0,1,1311,160,160,0
"78adeee1fa2c4fe0bc73f7bca9fcee86","2ae94c0cea4d480a9d5dca8fb1d7b542",22854564,1,114,0,1312,160,242,82
"2ae94c0cea4d480a9d5dca8fb1d7b542","7aa76d3e993840d8805f097cbdbcd44b",22854564,1,23,0,1315,242,261,19
"7aa76d3e993840d8805f097cbdbcd44b","2ae94c0cea4d480a9d5dca8fb1d7b542",22854564,2,-23,0,1316,261,242,-19
"0d987bed3ffa4ed0b9a2e62e97b7b30f","82ae07bc0c9b4570a41799290d1ef399",22854564,3,4,0,1319,272,275,3
"82ae07bc0c9b4570a41799290d1ef399","0d987bed3ffa4ed0b9a2e62e97b7b30f",22854564,2,-4,0,1320,275,272,-3
"bb5a47f5ea01454a8b79455422d3b9da","0d987bed3ffa4ed0b9a2e62e97b7b30f",22854564,2,-10,0,1394,280,272,-8
"0d987bed3ffa4ed0b9a2e62e97b7b30f","94cecc3f1e7d484b8e068e79241dfd73",22854564,2,13,0,1395,272,281,9
"a37477c4e4c14169ad44b06b493007f6","94cecc3f1e7d484b8e068e79241dfd73",22854564,2,-2,0,1397,283,281,-2
"94cecc3f1e7d484b8e068e79241dfd73","fab84b4fab5940efb4ea868ef8d09396",22854564,2,5,0,1398,281,284,3
"fab84b4fab5940efb4ea868ef8d09396","fab84b4fab5940efb4ea868ef8d09396",22854564,2,0,1,1399,284,284,0
"fab84b4fab5940efb4ea868ef8d09396","4a29443515bb404cb8924e1c60a63b73",22854564,3,4,0,1400,284,285,1
"4a29443515bb404cb8924e1c60a63b73","208c9b2796c944db8dacaa96082520ea",22854564,4,3,0,1401,285,288,3
"208c9b2796c944db8dacaa96082520ea","4a29443515bb404cb8924e1c60a63b73",22854564,3,-3,0,1402,288,285,-3
"4a29443515bb404cb8924e1c60a63b73","4a29443515bb404cb8924e1c60a63b73",22854564,5,0,1,1403,285,285,0
"208c9b2796c944db8dacaa96082520ea","208c9b2796c944db8dacaa96082520ea",22854564,3,0,1,1409,288,288,0
"4a29443515bb404cb8924e1c60a63b73","7669a956527947d0add87455277e80b4",22854564,1,7,0,1413,285,291,6
"7669a956527947d0add87455277e80b4","7669a956527947d0add87455277e80b4",22854564,1,0,1,1414,291,291,0
"7669a956527947d0add87455277e80b4","6a9a3b5bde4a48daa896fe8c06eca56f",22854564,1,-2,0,1415,291,289,-2
"6a9a3b5bde4a48daa896fe8c06eca56f","869e967078f04da18dd0b0b9389a7424",22854564,1,5,0,1416,289,293,4
"869e967078f04da18dd0b0b9389a7424","869e967078f04da18dd0b0b9389a7424",22854564,13,0,1,1417,293,293,0
"869e967078f04da18dd0b0b9389a7424","51ab6291537748fab90d519aa09889d6",22854564,1,2,0,1420,293,295,2
"51ab6291537748fab90d519aa09889d6","51ab6291537748fab90d519aa09889d6",22854564,5,0,1,1421,295,295,0
"51ab6291537748fab90d519aa09889d6","869e967078f04da18dd0b0b9389a7424",22854564,1,-2,0,1426,295,293,-2
"869e967078f04da18dd0b0b9389a7424","34a6e49023fc4465bd5ca604330bbd1c",22854564,2,-1,0,1437,293,292,-1
"34a6e49023fc4465bd5ca604330bbd1c","ba0e59461bfb4a44b7b1c28a01f8d3b3",22854564,2,9,0,1438,292,299,7
"ba0e59461bfb4a44b7b1c28a01f8d3b3","21592f2a9e9c4b2f8c66ec5dbcbf6a2b",22854564,2,-4,0,1439,299,296,-3
"21592f2a9e9c4b2f8c66ec5dbcbf6a2b","ba0e59461bfb4a44b7b1c28a01f8d3b3",22854564,1,4,0,1440,296,299,3
"ba0e59461bfb4a44b7b1c28a01f8d3b3","ba0e59461bfb4a44b7b1c28a01f8d3b3",22854564,12,0,1,1441,299,299,0
"ba0e59461bfb4a44b7b1c28a01f8d3b3","0e0b36e731a645e7b1b8a88f5031ca38",22854564,1,2,0,1444,299,301,2
"0e0b36e731a645e7b1b8a88f5031ca38","0e0b36e731a645e7b1b8a88f5031ca38",22854564,5,0,1,1445,301,301,0
"0e0b36e731a645e7b1b8a88f5031ca38","a66a144637284c21afc6de17fea4bfb8",22854564,1,1,0,1450,301,302,1
"a66a144637284c21afc6de17fea4bfb8","a66a144637284c21afc6de17fea4bfb8",22854564,2,0,1,1451,302,302,0
"a66a144637284c21afc6de17fea4bfb8","7646a919d7e64fa990bca9b024ff089d",22854564,1,-4,0,1453,302,298,-4
"7646a919d7e64fa990bca9b024ff089d","e390b575229748ea8aac9364efe2bf00",22854564,1,7,0,1454,298,304,6
"e390b575229748ea8aac9364efe2bf00","e390b575229748ea8aac9364efe2bf00",22854564,1,0,1,1455,304,304,0
"e390b575229748ea8aac9364efe2bf00","4a29443515bb404cb8924e1c60a63b73",22854564,1,-24,0,1456,304,285,-19
"4a29443515bb404cb8924e1c60a63b73","3434c10e561d488a914e0f7d71907abd",22854564,4,27,0,1457,285,305,20
"3434c10e561d488a914e0f7d71907abd","53e7e900392747ccad52e711ab0f80d8",22854564,5,2,0,1458,305,307,2
"53e7e900392747ccad52e711ab0f80d8","4a29443515bb404cb8924e1c60a63b73",22854564,2,-29,0,1459,307,285,-22
"3434c10e561d488a914e0f7d71907abd","3434c10e561d488a914e0f7d71907abd",22854564,5,0,1,1461,305,305,0
"53e7e900392747ccad52e711ab0f80d8","86c27d40179e419c8e9d150fb6afa5d0",22854564,1,15,0,1463,307,319,12
"86c27d40179e419c8e9d150fb6afa5d0","3434c10e561d488a914e0f7d71907abd",22854564,1,-17,0,1464,319,305,-14
"3434c10e561d488a914e0f7d71907abd","34a6e49023fc4465bd5ca604330bbd1c",22854564,1,-18,0,1465,305,292,-13
"34a6e49023fc4465bd5ca604330bbd1c","4a29443515bb404cb8924e1c60a63b73",22854564,1,-9,0,1466,292,285,-7
"4a29443515bb404cb8924e1c60a63b73","869e967078f04da18dd0b0b9389a7424",22854564,1,10,0,1467,285,293,8
"ba0e59461bfb4a44b7b1c28a01f8d3b3","3434c10e561d488a914e0f7d71907abd",22854564,1,9,0,1479,299,305,6
"3434c10e561d488a914e0f7d71907abd","141c0df6cd1946539aadd1c9b7068cd4",22854564,2,4,0,1480,305,308,3
"141c0df6cd1946539aadd1c9b7068cd4","130acc2aeb0448fdbb2de63bc5cebe5b",22854564,1,1,0,1481,308,309,1
"130acc2aeb0448fdbb2de63bc5cebe5b","130acc2aeb0448fdbb2de63bc5cebe5b",22854564,12,0,1,1482,309,309,0
"130acc2aeb0448fdbb2de63bc5cebe5b","9c062b3251034ebe90f5054e2a3b5120",22854564,1,2,0,1494,309,311,2
"9c062b3251034ebe90f5054e2a3b5120","9c062b3251034ebe90f5054e2a3b5120",22854564,5,0,1,1495,311,311,0
"9c062b3251034ebe90f5054e2a3b5120","ea859f8207e44537889daeaba13ac2e8",22854564,1,1,0,1500,311,312,1
"ea859f8207e44537889daeaba13ac2e8","ea859f8207e44537889daeaba13ac2e8",22854564,1,0,1,1501,312,312,0
"ea859f8207e44537889daeaba13ac2e8","56d94971a7a94257aa330183a8ebd0ea",22854564,1,1,0,1502,312,313,1
"56d94971a7a94257aa330183a8ebd0ea","56d94971a7a94257aa330183a8ebd0ea",22854564,1,0,1,1503,313,313,0
"56d94971a7a94257aa330183a8ebd0ea","141c0df6cd1946539aadd1c9b7068cd4",22854564,1,-5,0,1504,313,308,-5
"141c0df6cd1946539aadd1c9b7068cd4","13255e63e0aa4abf85e5211bf613d43e",22854564,1,10,0,1505,308,317,9
"13255e63e0aa4abf85e5211bf613d43e","13255e63e0aa4abf85e5211bf613d43e",22854564,1,0,1,1506,317,317,0
"13255e63e0aa4abf85e5211bf613d43e","0c787d16c9504873b1a4d903cec09948",22854564,1,-3,0,1507,317,314,-3
"0c787d16c9504873b1a4d903cec09948","86c27d40179e419c8e9d150fb6afa5d0",22854564,1,6,0,1508,314,319,5
"86c27d40179e419c8e9d150fb6afa5d0","86c27d40179e419c8e9d150fb6afa5d0",22854564,10,0,1,1509,319,319,0
"86c27d40179e419c8e9d150fb6afa5d0","8d7e0b55cf9849cda222a0f2440cec55",22854564,1,-1,0,1519,319,318,-1
"8d7e0b55cf9849cda222a0f2440cec55","53e7e900392747ccad52e711ab0f80d8",22854564,1,-14,0,1520,318,307,-11
"53e7e900392747ccad52e711ab0f80d8","53e7e900392747ccad52e711ab0f80d8",22854564,6,0,1,1521,307,307,0
"53e7e900392747ccad52e711ab0f80d8","3434c10e561d488a914e0f7d71907abd",22854564,1,-2,0,1523,307,305,-2
"3434c10e561d488a914e0f7d71907abd","86c27d40179e419c8e9d150fb6afa5d0",22854564,1,17,0,1524,305,319,14
"86c27d40179e419c8e9d150fb6afa5d0","47edbb64109243e6b0f8f64cdef90c6c",22854564,1,8,0,1525,319,326,7
"47edbb64109243e6b0f8f64cdef90c6c","8d7e0b55cf9849cda222a0f2440cec55",22854564,1,-9,0,1526,326,318,-8
"8d7e0b55cf9849cda222a0f2440cec55","24f1363179ad4aaa965484a78471912b",22854564,1,6,0,1527,318,323,5
"24f1363179ad4aaa965484a78471912b","24f1363179ad4aaa965484a78471912b",22854564,9,0,1,1528,323,323,0
"24f1363179ad4aaa965484a78471912b","3628bdce1dd2429ba924d2d4d09448d2",22854564,1,-1,0,1537,323,322,-1
"3628bdce1dd2429ba924d2d4d09448d2","56b3fd1a212a4764be39d979fde3326e",22854564,1,7,0,1538,322,328,6
"56b3fd1a212a4764be39d979fde3326e","56b3fd1a212a4764be39d979fde3326e",22854564,1,0,1,1539,328,328,0
"56b3fd1a212a4764be39d979fde3326e","3434c10e561d488a914e0f7d71907abd",22854564,1,-28,0,1540,328,305,-23
"3434c10e561d488a914e0f7d71907abd","0c4079457ede49e3aeb5e86ed84bdf35",22854564,2,31,0,1541,305,329,24
"0c4079457ede49e3aeb5e86ed84bdf35","38aea304b4fa46e1b29bb72f5cea4c93",22854564,3,2,0,1542,329,331,2
"38aea304b4fa46e1b29bb72f5cea4c93","3434c10e561d488a914e0f7d71907abd",22854564,1,-33,0,1543,331,305,-26
"4a29443515bb404cb8924e1c60a63b73","0c4079457ede49e3aeb5e86ed84bdf35",22854564,1,58,0,1550,285,329,44
"0c4079457ede49e3aeb5e86ed84bdf35","0c4079457ede49e3aeb5e86ed84bdf35",22854564,2,0,1,1551,329,329,0
"38aea304b4fa46e1b29bb72f5cea4c93","38aea304b4fa46e1b29bb72f5cea4c93",22854564,18,0,1,1553,331,331,0
"38aea304b4fa46e1b29bb72f5cea4c93","e36d261332f14e79bb4b467aceaeb9b5",22854564,1,2,0,1569,331,333,2
"e36d261332f14e79bb4b467aceaeb9b5","e36d261332f14e79bb4b467aceaeb9b5",22854564,1,0,1,1570,333,333,0
"e36d261332f14e79bb4b467aceaeb9b5","c7e89b9d04744d2eab742fc24e3ef1ae",22854564,1,1,0,1571,333,334,1
"c7e89b9d04744d2eab742fc24e3ef1ae","c7e89b9d04744d2eab742fc24e3ef1ae",22854564,2,0,1,1572,334,334,0
"c7e89b9d04744d2eab742fc24e3ef1ae","fe49f8054b374a0ea4bb266ed135ff62",22854564,1,1,0,1574,334,335,1
"fe49f8054b374a0ea4bb266ed135ff62","fe49f8054b374a0ea4bb266ed135ff62",22854564,2,0,1,1575,335,335,0
"fe49f8054b374a0ea4bb266ed135ff62","d0a8f74af98642fe8360d22c42e45117",22854564,1,1,0,1577,335,336,1
"d0a8f74af98642fe8360d22c42e45117","d0a8f74af98642fe8360d22c42e45117",22854564,2,0,1,1578,336,336,0
"d0a8f74af98642fe8360d22c42e45117","0c4079457ede49e3aeb5e86ed84bdf35",22854564,1,-7,0,1580,336,329,-7
"0c4079457ede49e3aeb5e86ed84bdf35","a7c6339ca1da4368a18d471f0519f877",22854564,1,11,0,1581,329,339,10
"a7c6339ca1da4368a18d471f0519f877","a7c6339ca1da4368a18d471f0519f877",22854564,1,0,1,1582,339,339,0
"a7c6339ca1da4368a18d471f0519f877","b8b9418ab322418d9db9b40d96af873a",22854564,1,-2,0,1583,339,337,-2
"b8b9418ab322418d9db9b40d96af873a","bbc5139ca9024389a94db3a6f47dcff6",22854564,1,5,0,1584,337,341,4
"bbc5139ca9024389a94db3a6f47dcff6","bbc5139ca9024389a94db3a6f47dcff6",22854564,11,0,1,1585,341,341,0
"bbc5139ca9024389a94db3a6f47dcff6","4ee6ca9019ab4a1ab323f98094a9bd77",22854564,1,2,0,1587,341,343,2
"4ee6ca9019ab4a1ab323f98094a9bd77","4ee6ca9019ab4a1ab323f98094a9bd77",22854564,2,0,1,1588,343,343,0
"4ee6ca9019ab4a1ab323f98094a9bd77","b37947176785476f8b29d49a851366dc",22854564,1,1,0,1590,343,344,1
"b37947176785476f8b29d49a851366dc","b37947176785476f8b29d49a851366dc",22854564,5,0,1,1591,344,344,0
"b37947176785476f8b29d49a851366dc","fcea5b10d5a14a3b9324ffece8f6e1e5",22854564,1,1,0,1596,344,345,1
"fcea5b10d5a14a3b9324ffece8f6e1e5","fcea5b10d5a14a3b9324ffece8f6e1e5",22854564,5,0,1,1597,345,345,0
"fcea5b10d5a14a3b9324ffece8f6e1e5","c2490bc612d146edbe786556fab3651b",22854564,1,-5,0,1602,345,340,-5
"c2490bc612d146edbe786556fab3651b","bbc5139ca9024389a94db3a6f47dcff6",22854564,2,1,0,1603,340,341,1
"bbc5139ca9024389a94db3a6f47dcff6","4a92daef4d504e1792575a26502bb7b7",22854564,1,6,0,1604,341,346,5
"4a92daef4d504e1792575a26502bb7b7","bbc5139ca9024389a94db3a6f47dcff6",22854564,1,-6,0,1605,346,341,-5
"bbc5139ca9024389a94db3a6f47dcff6","c2490bc612d146edbe786556fab3651b",22854564,1,-1,0,1615,341,340,-1
"c2490bc612d146edbe786556fab3651b","6ac8bb048b854999a47edb35fe627f11",22854564,1,8,0,1616,340,347,7
"6ac8bb048b854999a47edb35fe627f11","4a92daef4d504e1792575a26502bb7b7",22854564,1,-1,0,1617,347,346,-1
"4a92daef4d504e1792575a26502bb7b7","38aea304b4fa46e1b29bb72f5cea4c93",22854564,1,-18,0,1618,346,331,-15
"38aea304b4fa46e1b29bb72f5cea4c93","b8b9418ab322418d9db9b40d96af873a",22854564,1,7,0,1619,331,337,6
"b8b9418ab322418d9db9b40d96af873a","38aea304b4fa46e1b29bb72f5cea4c93",22854564,1,-7,0,1620,337,331,-6
"38aea304b4fa46e1b29bb72f5cea4c93","0c4079457ede49e3aeb5e86ed84bdf35",22854564,2,-2,0,1623,331,329,-2
"0c4079457ede49e3aeb5e86ed84bdf35","6ac8bb048b854999a47edb35fe627f11",22854564,1,21,0,1624,329,347,18
"6ac8bb048b854999a47edb35fe627f11","6ac8bb048b854999a47edb35fe627f11",22854564,1,0,1,1625,347,347,0
"6ac8bb048b854999a47edb35fe627f11","30ead9794d4847abaf222ca966cc8630",22854564,1,3,0,1626,347,348,1
"30ead9794d4847abaf222ca966cc8630","0c4079457ede49e3aeb5e86ed84bdf35",22854564,2,-24,0,1627,348,329,-19
"0c4079457ede49e3aeb5e86ed84bdf35","eff0de7f2dbb42dfa1a2e686efab5b6d",22854564,2,30,0,1628,329,354,25
"eff0de7f2dbb42dfa1a2e686efab5b6d","09b9678ddc3d452ea4a3d46e15826065",22854564,3,-1,0,1629,354,353,-1
"09b9678ddc3d452ea4a3d46e15826065","897b7f51242c44aab2205c72fdcbf4cd",22854564,3,-1,0,1630,353,352,-1
"897b7f51242c44aab2205c72fdcbf4cd","c20993c944444fe085345591a8bd837e",22854564,5,-1,0,1631,352,351,-1
"c20993c944444fe085345591a8bd837e","c20993c944444fe085345591a8bd837e",22854564,7,0,1,1632,351,351,0
"c20993c944444fe085345591a8bd837e","897b7f51242c44aab2205c72fdcbf4cd",22854564,7,1,0,1636,351,352,1
"897b7f51242c44aab2205c72fdcbf4cd","897b7f51242c44aab2205c72fdcbf4cd",22854564,6,0,1,1637,352,352,0
"897b7f51242c44aab2205c72fdcbf4cd","09b9678ddc3d452ea4a3d46e15826065",22854564,4,1,0,1640,352,353,1
"09b9678ddc3d452ea4a3d46e15826065","09b9678ddc3d452ea4a3d46e15826065",22854564,7,0,1,1641,353,353,0
"09b9678ddc3d452ea4a3d46e15826065","eff0de7f2dbb42dfa1a2e686efab5b6d",22854564,5,1,0,1644,353,354,1
"eff0de7f2dbb42dfa1a2e686efab5b6d","eff0de7f2dbb42dfa1a2e686efab5b6d",22854564,7,0,1,1645,354,354,0
"eff0de7f2dbb42dfa1a2e686efab5b6d","30ead9794d4847abaf222ca966cc8630",22854564,1,-6,0,1648,354,348,-6
"30ead9794d4847abaf222ca966cc8630","2fe14166dc9642c3bc666b86a57f943d",22854564,2,10,0,1649,348,357,9
"2fe14166dc9642c3bc666b86a57f943d","2fe14166dc9642c3bc666b86a57f943d",22854564,7,0,1,1650,357,357,0
"2fe14166dc9642c3bc666b86a57f943d","1ba8fef685d74a8194b9db252eb704fb",22854564,2,-2,0,1653,357,355,-2
"1ba8fef685d74a8194b9db252eb704fb","09b9678ddc3d452ea4a3d46e15826065",22854564,1,-3,0,1654,355,353,-2
"eff0de7f2dbb42dfa1a2e686efab5b6d","c20993c944444fe085345591a8bd837e",22854564,2,-3,0,1656,354,351,-3
"897b7f51242c44aab2205c72fdcbf4cd","eff0de7f2dbb42dfa1a2e686efab5b6d",22854564,2,2,0,1658,352,354,2
"09b9678ddc3d452ea4a3d46e15826065","c20993c944444fe085345591a8bd837e",22854564,2,-2,0,1663,353,351,-2
"eff0de7f2dbb42dfa1a2e686efab5b6d","1ba8fef685d74a8194b9db252eb704fb",22854564,1,2,0,1678,354,355,1
"1ba8fef685d74a8194b9db252eb704fb","30ead9794d4847abaf222ca966cc8630",22854564,1,-8,0,1679,355,348,-7
"1ba8fef685d74a8194b9db252eb704fb","52580888dadb4fe3baa795683ea227bd",22854564,3,10,0,1684,355,364,9
"52580888dadb4fe3baa795683ea227bd","f00179e251a045b39c3f7a54f9aa4acc",22854564,4,-1,0,1685,364,363,-1
"f00179e251a045b39c3f7a54f9aa4acc","492a3bc6a1254f23a7998587961b22a4",22854564,3,4,0,1686,363,366,3
"492a3bc6a1254f23a7998587961b22a4","072a190fd302456290895f9f04d6940a",22854564,4,-1,0,1687,366,365,-1
"072a190fd302456290895f9f04d6940a","c76574d21bc14aeea7ecd0b027f39858",22854564,2,3,0,1688,365,367,2
"c76574d21bc14aeea7ecd0b027f39858","2fe14166dc9642c3bc666b86a57f943d",22854564,1,-13,0,1689,367,357,-10
"2fe14166dc9642c3bc666b86a57f943d","44421dd1e13a47a388c4a19834b744c7",22854564,1,2,0,1692,357,359,2
"44421dd1e13a47a388c4a19834b744c7","44421dd1e13a47a388c4a19834b744c7",22854564,2,0,1,1693,359,359,0
"44421dd1e13a47a388c4a19834b744c7","cb5fc7ef85d547c4be1a7439d0bf6052",22854564,1,1,0,1695,359,360,1
"cb5fc7ef85d547c4be1a7439d0bf6052","cb5fc7ef85d547c4be1a7439d0bf6052",22854564,5,0,1,1696,360,360,0
"cb5fc7ef85d547c4be1a7439d0bf6052","0a8f150a4cf747acbde62f4721823da3",22854564,1,1,0,1701,360,361,1
"0a8f150a4cf747acbde62f4721823da3","0a8f150a4cf747acbde62f4721823da3",22854564,2,0,1,1702,361,361,0
"0a8f150a4cf747acbde62f4721823da3","ab8fdad974ae471f9f24c3f9dd04462e",22854564,1,1,0,1704,361,362,1
"ab8fdad974ae471f9f24c3f9dd04462e","ab8fdad974ae471f9f24c3f9dd04462e",22854564,2,0,1,1705,362,362,0
"ab8fdad974ae471f9f24c3f9dd04462e","1ba8fef685d74a8194b9db252eb704fb",22854564,1,-7,0,1707,362,355,-7
"f00179e251a045b39c3f7a54f9aa4acc","2fe14166dc9642c3bc666b86a57f943d",22854564,1,-7,0,1710,363,357,-6
"2fe14166dc9642c3bc666b86a57f943d","c20993c944444fe085345591a8bd837e",22854564,1,-7,0,1711,357,351,-6
"c20993c944444fe085345591a8bd837e","09b9678ddc3d452ea4a3d46e15826065",22854564,2,2,0,1717,351,353,2
"eff0de7f2dbb42dfa1a2e686efab5b6d","2fe14166dc9642c3bc666b86a57f943d",22854564,1,4,0,1723,354,357,3
"2fe14166dc9642c3bc666b86a57f943d","52580888dadb4fe3baa795683ea227bd",22854564,1,8,0,1724,357,364,7
"52580888dadb4fe3baa795683ea227bd","52580888dadb4fe3baa795683ea227bd",22854564,1,0,1,1725,364,364,0
"52580888dadb4fe3baa795683ea227bd","1ba8fef685d74a8194b9db252eb704fb",22854564,1,-10,0,1726,364,355,-9
"072a190fd302456290895f9f04d6940a","492a3bc6a1254f23a7998587961b22a4",22854564,2,1,0,1731,365,366,1
"492a3bc6a1254f23a7998587961b22a4","492a3bc6a1254f23a7998587961b22a4",22854564,1,0,1,1732,366,366,0
"c76574d21bc14aeea7ecd0b027f39858","52580888dadb4fe3baa795683ea227bd",22854564,1,-5,0,1735,367,364,-3
"072a190fd302456290895f9f04d6940a","30ead9794d4847abaf222ca966cc8630",22854564,1,-20,0,1739,365,348,-17
"30ead9794d4847abaf222ca966cc8630","78adeee1fa2c4fe0bc73f7bca9fcee86",22854564,1,-256,0,1740,348,160,-188
"78adeee1fa2c4fe0bc73f7bca9fcee86","cfa457d1743848e4bb5e4beced6448ed",22854564,1,281,0,1741,160,369,209
"cfa457d1743848e4bb5e4beced6448ed","cfa457d1743848e4bb5e4beced6448ed",22854564,1,0,1,1742,369,369,0
"cfa457d1743848e4bb5e4beced6448ed","b71bac264efb4abd97015447bd490db6",22854564,1,3,0,1743,369,370,1
"b71bac264efb4abd97015447bd490db6","30ead9794d4847abaf222ca966cc8630",22854564,1,-28,0,1744,370,348,-22
"30ead9794d4847abaf222ca966cc8630","b71bac264efb4abd97015447bd490db6",22854564,2,28,0,1745,348,370,22
"b71bac264efb4abd97015447bd490db6","8d448d625b024c82a5eb240bbd7431d6",22854564,5,5,0,1746,370,374,4
"8d448d625b024c82a5eb240bbd7431d6","8d448d625b024c82a5eb240bbd7431d6",22854564,99,0,1,1747,374,374,0
"8d448d625b024c82a5eb240bbd7431d6","b71bac264efb4abd97015447bd490db6",22854564,3,-5,0,1754,374,370,-4
"b71bac264efb4abd97015447bd490db6","b71bac264efb4abd97015447bd490db6",22854564,5,0,1,1755,370,370,0
"b71bac264efb4abd97015447bd490db6","d6d02b6ef04e4f17805504500b8ce441",22854564,4,8,0,1822,370,375,5
"d6d02b6ef04e4f17805504500b8ce441","d6d02b6ef04e4f17805504500b8ce441",22854564,39,0,1,1823,375,375,0
"d6d02b6ef04e4f17805504500b8ce441","66baf19b6b904b70922329068c63746d",22854564,4,4,0,1825,375,376,1
"66baf19b6b904b70922329068c63746d","7f544639412e40a9ba27f43b415362ab",22854564,5,2,0,1826,376,378,2
"7f544639412e40a9ba27f43b415362ab","66baf19b6b904b70922329068c63746d",22854564,3,-2,0,1827,378,376,-2
"66baf19b6b904b70922329068c63746d","d6d02b6ef04e4f17805504500b8ce441",22854564,1,-4,0,1828,376,375,-1
"d6d02b6ef04e4f17805504500b8ce441","b71bac264efb4abd97015447bd490db6",22854564,3,-8,0,1832,375,370,-5
"8d448d625b024c82a5eb240bbd7431d6","66baf19b6b904b70922329068c63746d",22854564,1,7,0,1843,374,376,2
"7f544639412e40a9ba27f43b415362ab","d5ae8642e15b46b8bd298b02274d4e9c",22854564,1,2,0,1845,378,380,2
"d5ae8642e15b46b8bd298b02274d4e9c","a0d10309a2dd456289147f84be9d37f9",22854564,1,1,0,1846,380,381,1
"a0d10309a2dd456289147f84be9d37f9","a0d10309a2dd456289147f84be9d37f9",22854564,1,0,1,1847,381,381,0
"a0d10309a2dd456289147f84be9d37f9","0fcbc3ca07b144138b8d85da581f09a8",22854564,1,1,0,1848,381,382,1
"0fcbc3ca07b144138b8d85da581f09a8","0fcbc3ca07b144138b8d85da581f09a8",22854564,1,0,1,1849,382,382,0
"0fcbc3ca07b144138b8d85da581f09a8","66baf19b6b904b70922329068c63746d",22854564,1,-6,0,1850,382,376,-6
"66baf19b6b904b70922329068c63746d","96bb2b3e85a34d8b9544514e89f6fe97",22854564,1,17,0,1851,376,390,14
"96bb2b3e85a34d8b9544514e89f6fe97","18d3b836dd804224883cc9180b60a8e1",22854564,1,-4,0,1852,390,387,-3
"18d3b836dd804224883cc9180b60a8e1","66baf19b6b904b70922329068c63746d",22854564,1,-13,0,1853,387,376,-11
"66baf19b6b904b70922329068c63746d","4890121ce5d74576b4632b77cfc23398",22854564,2,14,0,1854,376,388,12
"4890121ce5d74576b4632b77cfc23398","4890121ce5d74576b4632b77cfc23398",22854564,4,0,1,1855,388,388,0
"4890121ce5d74576b4632b77cfc23398","7f544639412e40a9ba27f43b415362ab",22854564,1,-12,0,1857,388,378,-10
"7f544639412e40a9ba27f43b415362ab","18d3b836dd804224883cc9180b60a8e1",22854564,1,11,0,1858,378,387,9
"18d3b836dd804224883cc9180b60a8e1","7f544639412e40a9ba27f43b415362ab",22854564,1,-11,0,1859,387,378,-9
"66baf19b6b904b70922329068c63746d","c2fca3669923477ab966ded303dea31c",22854564,1,8,0,1861,376,383,7
"c2fca3669923477ab966ded303dea31c","96bb2b3e85a34d8b9544514e89f6fe97",22854564,1,9,0,1862,383,390,7
"96bb2b3e85a34d8b9544514e89f6fe97","4890121ce5d74576b4632b77cfc23398",22854564,1,-3,0,1863,390,388,-2
"4890121ce5d74576b4632b77cfc23398","17f95d18bab743888e1736033dc3384d",22854564,1,2,0,1864,388,389,1
"17f95d18bab743888e1736033dc3384d","18d3b836dd804224883cc9180b60a8e1",22854564,1,-3,0,1865,389,387,-2
"18d3b836dd804224883cc9180b60a8e1","96bb2b3e85a34d8b9544514e89f6fe97",22854564,2,4,0,1866,387,390,3
"96bb2b3e85a34d8b9544514e89f6fe97","96bb2b3e85a34d8b9544514e89f6fe97",22854564,3,0,1,1867,390,390,0
"96bb2b3e85a34d8b9544514e89f6fe97","17f95d18bab743888e1736033dc3384d",22854564,2,-1,0,1868,390,389,-1
"17f95d18bab743888e1736033dc3384d","6f8881a745ac4c358a68b92c3b4abe81",22854564,3,6,0,1869,389,394,5
"6f8881a745ac4c358a68b92c3b4abe81","6f8881a745ac4c358a68b92c3b4abe81",22854564,2,0,1,1870,394,394,0
"6f8881a745ac4c358a68b92c3b4abe81","f7002c8484354eceac57bc7bd62c76c1",22854564,4,-1,0,1871,394,393,-1
"f7002c8484354eceac57bc7bd62c76c1","0c12af0a4e7f4002852cf84b2537c161",22854564,2,3,0,1872,393,395,2
"0c12af0a4e7f4002852cf84b2537c161","df8191ec5e584c838a899c378941a566",22854564,2,4,0,1873,395,398,3
"df8191ec5e584c838a899c378941a566","0c12af0a4e7f4002852cf84b2537c161",22854564,1,-4,0,1874,398,395,-3
"0c12af0a4e7f4002852cf84b2537c161","7f544639412e40a9ba27f43b415362ab",22854564,1,-22,0,1875,395,378,-17
"7f544639412e40a9ba27f43b415362ab","7f544639412e40a9ba27f43b415362ab",22854564,7,0,1,1876,378,378,0
"4890121ce5d74576b4632b77cfc23398","c2fca3669923477ab966ded303dea31c",22854564,1,-6,0,1883,388,383,-5
"c2fca3669923477ab966ded303dea31c","4890121ce5d74576b4632b77cfc23398",22854564,1,6,0,1884,383,388,5
"4890121ce5d74576b4632b77cfc23398","18d3b836dd804224883cc9180b60a8e1",22854564,1,-1,0,1887,388,387,-1
"f7002c8484354eceac57bc7bd62c76c1","96bb2b3e85a34d8b9544514e89f6fe97",22854564,1,-4,0,1894,393,390,-3
"96bb2b3e85a34d8b9544514e89f6fe97","ac4e9b54acfe4670b4634859c7263cb5",22854564,1,2,0,1895,390,392,2
"ac4e9b54acfe4670b4634859c7263cb5","ac4e9b54acfe4670b4634859c7263cb5",22854564,1,0,1,1896,392,392,0
"ac4e9b54acfe4670b4634859c7263cb5","17f95d18bab743888e1736033dc3384d",22854564,1,-3,0,1897,392,389,-3
"df8191ec5e584c838a899c378941a566","6f8881a745ac4c358a68b92c3b4abe81",22854564,1,-6,0,1903,398,394,-4
"6f8881a745ac4c358a68b92c3b4abe81","66baf19b6b904b70922329068c63746d",22854564,1,-22,0,1904,394,376,-18
"66baf19b6b904b70922329068c63746d","66baf19b6b904b70922329068c63746d",22854564,4,0,1,1905,376,376,0
"66baf19b6b904b70922329068c63746d","6f8881a745ac4c358a68b92c3b4abe81",22854564,1,22,0,1906,376,394,18
"f7002c8484354eceac57bc7bd62c76c1","44a277ea44dc4ae689fab4b82f0b4098",22854564,1,5,0,1908,393,397,4
"44a277ea44dc4ae689fab4b82f0b4098","44a277ea44dc4ae689fab4b82f0b4098",22854564,1,0,1,1909,397,397,0
"44a277ea44dc4ae689fab4b82f0b4098","0c12af0a4e7f4002852cf84b2537c161",22854564,1,-2,0,1910,397,395,-2
"0c12af0a4e7f4002852cf84b2537c161","859e0b8d71694b12befb69ee698138f9",22854564,1,5,0,1911,395,399,4
"859e0b8d71694b12befb69ee698138f9","859e0b8d71694b12befb69ee698138f9",22854564,1,0,1,1912,399,399,0
"859e0b8d71694b12befb69ee698138f9","66baf19b6b904b70922329068c63746d",22854564,1,-29,0,1913,399,376,-23
"66baf19b6b904b70922329068c63746d","2b09a08242b54983aec7063990fb3f66",22854564,1,32,0,1914,376,400,24
"2b09a08242b54983aec7063990fb3f66","2b09a08242b54983aec7063990fb3f66",22854564,13,0,1,1915,400,400,0
"2b09a08242b54983aec7063990fb3f66","66baf19b6b904b70922329068c63746d",22854564,1,-32,0,1916,400,376,-24
"66baf19b6b904b70922329068c63746d","83d42d95cd844fc093fc09cee250edb8",22854564,1,135,0,1918,376,465,89
"83d42d95cd844fc093fc09cee250edb8","83d42d95cd844fc093fc09cee250edb8",22854564,11,0,1,1919,465,465,0
"83d42d95cd844fc093fc09cee250edb8","2b09a08242b54983aec7063990fb3f66",22854564,1,-103,0,1920,465,400,-65
"2b09a08242b54983aec7063990fb3f66","1157bd665ec4472fb58b751dc5099355",22854564,2,4,0,1926,400,403,3
"1157bd665ec4472fb58b751dc5099355","2b09a08242b54983aec7063990fb3f66",22854564,2,-4,0,1927,403,400,-3
"2b09a08242b54983aec7063990fb3f66","3c8a22d2f9c146ea956609e3ed4f2559",22854564,1,7,0,1928,400,405,5
"3c8a22d2f9c146ea956609e3ed4f2559","2b09a08242b54983aec7063990fb3f66",22854564,1,-7,0,1929,405,400,-5
"2b09a08242b54983aec7063990fb3f66","58fc9094275e4c49be3f4ba6d4acc0a4",22854564,1,9,0,1931,400,406,6
"58fc9094275e4c49be3f4ba6d4acc0a4","58fc9094275e4c49be3f4ba6d4acc0a4",22854564,13,0,1,1932,406,406,0
"58fc9094275e4c49be3f4ba6d4acc0a4","02b3a1bead9244c1ba2f857c7da8f82a",22854564,3,3,0,1934,406,408,2
"02b3a1bead9244c1ba2f857c7da8f82a","02b3a1bead9244c1ba2f857c7da8f82a",22854564,4,0,1,1935,408,408,0
"02b3a1bead9244c1ba2f857c7da8f82a","6a5f020451db426dacba9e2ea3fcc62a",22854564,4,3,0,1936,408,410,2
"6a5f020451db426dacba9e2ea3fcc62a","02b3a1bead9244c1ba2f857c7da8f82a",22854564,1,-3,0,1937,410,408,-2
"6a5f020451db426dacba9e2ea3fcc62a","33a9d248b2e44588a5b07fc1342b9bc2",22854564,5,2,0,1939,410,411,1
"33a9d248b2e44588a5b07fc1342b9bc2","6a5f020451db426dacba9e2ea3fcc62a",22854564,1,-2,0,1940,411,410,-1
"33a9d248b2e44588a5b07fc1342b9bc2","33a9d248b2e44588a5b07fc1342b9bc2",22854564,19,0,1,1942,411,411,0
"33a9d248b2e44588a5b07fc1342b9bc2","687055dad9fc40c3982478fe33ec01bf",22854564,2,4,0,1943,411,414,3
"687055dad9fc40c3982478fe33ec01bf","2b09a08242b54983aec7063990fb3f66",22854564,2,-21,0,1944,414,400,-14
"2b09a08242b54983aec7063990fb3f66","1f471b7a883a4df48211e8c6a81b59a7",22854564,1,1,0,1948,400,401,1
"1f471b7a883a4df48211e8c6a81b59a7","1f471b7a883a4df48211e8c6a81b59a7",22854564,1,0,1,1949,401,401,0
"1f471b7a883a4df48211e8c6a81b59a7","2b09a08242b54983aec7063990fb3f66",22854564,1,-1,0,1950,401,400,-1
"2b09a08242b54983aec7063990fb3f66","9de0d567bfa84fe5b77cb76f4a76a5d1",22854564,1,5,0,1952,400,404,4
"9de0d567bfa84fe5b77cb76f4a76a5d1","9de0d567bfa84fe5b77cb76f4a76a5d1",22854564,1,0,1,1953,404,404,0
"9de0d567bfa84fe5b77cb76f4a76a5d1","1157bd665ec4472fb58b751dc5099355",22854564,1,-1,0,1954,404,403,-1
"1157bd665ec4472fb58b751dc5099355","58fc9094275e4c49be3f4ba6d4acc0a4",22854564,1,5,0,1957,403,406,3
"58fc9094275e4c49be3f4ba6d4acc0a4","3c8a22d2f9c146ea956609e3ed4f2559",22854564,1,-2,0,1958,406,405,-1
"3c8a22d2f9c146ea956609e3ed4f2559","58fc9094275e4c49be3f4ba6d4acc0a4",22854564,1,2,0,1959,405,406,1
"58fc9094275e4c49be3f4ba6d4acc0a4","c1c1be90b2b14c1ab4a5e1ee3c241902",22854564,1,1,0,1960,406,407,1
"c1c1be90b2b14c1ab4a5e1ee3c241902","c1c1be90b2b14c1ab4a5e1ee3c241902",22854564,5,0,1,1961,407,407,0
"c1c1be90b2b14c1ab4a5e1ee3c241902","58fc9094275e4c49be3f4ba6d4acc0a4",22854564,1,-1,0,1966,407,406,-1
"02b3a1bead9244c1ba2f857c7da8f82a","6206fc6479014bb193084c32409dc1b9",22854564,1,1,0,1977,408,409,1
"6206fc6479014bb193084c32409dc1b9","6206fc6479014bb193084c32409dc1b9",22854564,1,0,1,1978,409,409,0
"6206fc6479014bb193084c32409dc1b9","6a5f020451db426dacba9e2ea3fcc62a",22854564,1,2,0,1979,409,410,1
"6a5f020451db426dacba9e2ea3fcc62a","6a5f020451db426dacba9e2ea3fcc62a",22854564,12,0,1,1980,410,410,0
"33a9d248b2e44588a5b07fc1342b9bc2","02b3a1bead9244c1ba2f857c7da8f82a",22854564,1,-5,0,1989,411,408,-3
"2b09a08242b54983aec7063990fb3f66","02b3a1bead9244c1ba2f857c7da8f82a",22854564,1,12,0,1995,400,408,8
"02b3a1bead9244c1ba2f857c7da8f82a","58fc9094275e4c49be3f4ba6d4acc0a4",22854564,1,-3,0,1996,408,406,-2
"33a9d248b2e44588a5b07fc1342b9bc2","c6f26bd420634f1cb7989e76fe6b16c0",22854564,1,1,0,2026,411,412,1
"c6f26bd420634f1cb7989e76fe6b16c0","c6f26bd420634f1cb7989e76fe6b16c0",22854564,5,0,1,2027,412,412,0
"c6f26bd420634f1cb7989e76fe6b16c0","2a65ee6e2ac64f6a8a55fbe5373ec763",22854564,1,1,0,2032,412,413,1
"2a65ee6e2ac64f6a8a55fbe5373ec763","2a65ee6e2ac64f6a8a55fbe5373ec763",22854564,2,0,1,2033,413,413,0
"2a65ee6e2ac64f6a8a55fbe5373ec763","33a9d248b2e44588a5b07fc1342b9bc2",22854564,1,-2,0,2035,413,411,-2
"33a9d248b2e44588a5b07fc1342b9bc2","1fd0f6dadbc14ebc965faf6122190b96",22854564,1,5,0,2036,411,415,4
"1fd0f6dadbc14ebc965faf6122190b96","1fd0f6dadbc14ebc965faf6122190b96",22854564,1,0,1,2037,415,415,0
"1fd0f6dadbc14ebc965faf6122190b96","687055dad9fc40c3982478fe33ec01bf",22854564,1,-1,0,2038,415,414,-1
"687055dad9fc40c3982478fe33ec01bf","2add1669f08d4101913db15f8c23b3b7",22854564,1,3,0,2039,414,416,2
"2add1669f08d4101913db15f8c23b3b7","2add1669f08d4101913db15f8c23b3b7",22854564,1,0,1,2040,416,416,0
"2add1669f08d4101913db15f8c23b3b7","2b09a08242b54983aec7063990fb3f66",22854564,1,-24,0,2041,416,400,-16
"2b09a08242b54983aec7063990fb3f66","a2b4bd40cee2481ebd3fc179d6a5cd62",22854564,2,27,0,2042,400,417,17
"a2b4bd40cee2481ebd3fc179d6a5cd62","a2b4bd40cee2481ebd3fc179d6a5cd62",22854564,2,0,1,2043,417,417,0
"a2b4bd40cee2481ebd3fc179d6a5cd62","e34e59dce2204f228f3a84b6725df60f",22854564,1,2,0,2044,417,419,2
"e34e59dce2204f228f3a84b6725df60f","e34e59dce2204f228f3a84b6725df60f",22854564,2,0,1,2045,419,419,0
"e34e59dce2204f228f3a84b6725df60f","a2b4bd40cee2481ebd3fc179d6a5cd62",22854564,1,-2,0,2047,419,417,-2
"a2b4bd40cee2481ebd3fc179d6a5cd62","bec48fc2e1294c7eb3d0aca780d731b8",22854564,4,4,0,2048,417,420,3
"bec48fc2e1294c7eb3d0aca780d731b8","bec48fc2e1294c7eb3d0aca780d731b8",22854564,9,0,1,2049,420,420,0
"bec48fc2e1294c7eb3d0aca780d731b8","a2b4bd40cee2481ebd3fc179d6a5cd62",22854564,3,-4,0,2051,420,417,-3
"bec48fc2e1294c7eb3d0aca780d731b8","a24600b0e49245f6bdba8c893cfeddb0",22854564,1,7,0,2057,420,425,5
"a24600b0e49245f6bdba8c893cfeddb0","dbde19fcce2a4c1abdc7f685c293a23f",22854564,2,-4,0,2058,425,422,-3
"dbde19fcce2a4c1abdc7f685c293a23f","a24600b0e49245f6bdba8c893cfeddb0",22854564,2,4,0,2059,422,425,3
"a24600b0e49245f6bdba8c893cfeddb0","a24600b0e49245f6bdba8c893cfeddb0",22854564,12,0,1,2060,425,425,0
"a24600b0e49245f6bdba8c893cfeddb0","24cf8786024543f19b89bc20034e60d7",22854564,1,7,0,2074,425,428,3
"24cf8786024543f19b89bc20034e60d7","a2b4bd40cee2481ebd3fc179d6a5cd62",22854564,1,-18,0,2075,428,417,-11
"a2b4bd40cee2481ebd3fc179d6a5cd62","f2a73be2f46840b182d7bd095378004e",22854564,1,19,0,2076,417,429,12
"f2a73be2f46840b182d7bd095378004e","66baf19b6b904b70922329068c63746d",22854564,2,-78,0,2077,429,376,-53
"66baf19b6b904b70922329068c63746d","24cf8786024543f19b89bc20034e60d7",22854564,2,77,0,2078,376,428,52
"24cf8786024543f19b89bc20034e60d7","f2a73be2f46840b182d7bd095378004e",22854564,4,1,0,2079,428,429,1
"f2a73be2f46840b182d7bd095378004e","f2a73be2f46840b182d7bd095378004e",22854564,4,0,1,2080,429,429,0
"f2a73be2f46840b182d7bd095378004e","24cf8786024543f19b89bc20034e60d7",22854564,1,-1,0,2082,429,428,-1
"f2a73be2f46840b182d7bd095378004e","a2b4bd40cee2481ebd3fc179d6a5cd62",22854564,1,-19,0,2084,429,417,-12
"a2b4bd40cee2481ebd3fc179d6a5cd62","24cf8786024543f19b89bc20034e60d7",22854564,2,18,0,2085,417,428,11
"24cf8786024543f19b89bc20034e60d7","66baf19b6b904b70922329068c63746d",22854564,1,-77,0,2086,428,376,-52
"66baf19b6b904b70922329068c63746d","070600601c4c439288445d2f0724807d",22854564,2,91,0,2087,376,437,61
"070600601c4c439288445d2f0724807d","070600601c4c439288445d2f0724807d",22854564,4,0,1,2088,437,437,0
"070600601c4c439288445d2f0724807d","1823b6de7d334a7aaabc4570719af4d9",22854564,5,2,0,2089,437,439,2
"1823b6de7d334a7aaabc4570719af4d9","66baf19b6b904b70922329068c63746d",22854564,1,-93,0,2090,439,376,-63
"24cf8786024543f19b89bc20034e60d7","24cf8786024543f19b89bc20034e60d7",22854564,2,0,1,2092,428,428,0
"f2a73be2f46840b182d7bd095378004e","604551fd4266430cb860fef58fa7dd61",22854564,1,1,0,2094,429,430,1
"604551fd4266430cb860fef58fa7dd61","604551fd4266430cb860fef58fa7dd61",22854564,1,0,1,2095,430,430,0
"604551fd4266430cb860fef58fa7dd61","24cf8786024543f19b89bc20034e60d7",22854564,1,-2,0,2096,430,428,-2
"24cf8786024543f19b89bc20034e60d7","dce46f8904594a62a6377a3587aaa663",22854564,3,4,0,2097,428,431,3
"dce46f8904594a62a6377a3587aaa663","dce46f8904594a62a6377a3587aaa663",22854564,9,0,1,2098,431,431,0
"dce46f8904594a62a6377a3587aaa663","66ada10dde9f43018588f1ced9d477fc",22854564,2,4,0,2102,431,434,3
"66ada10dde9f43018588f1ced9d477fc","bf12c96466d840a69bed7020b3f18bb8",22854564,2,3,0,2103,434,436,2
"bf12c96466d840a69bed7020b3f18bb8","dce46f8904594a62a6377a3587aaa663",22854564,1,-7,0,2104,436,431,-5
"66ada10dde9f43018588f1ced9d477fc","66baf19b6b904b70922329068c63746d",22854564,1,-85,0,2108,434,376,-58
"1823b6de7d334a7aaabc4570719af4d9","24cf8786024543f19b89bc20034e60d7",22854564,1,-16,0,2112,439,428,-11
"66baf19b6b904b70922329068c63746d","dce46f8904594a62a6377a3587aaa663",22854564,1,81,0,2118,376,431,55
"dce46f8904594a62a6377a3587aaa663","24cf8786024543f19b89bc20034e60d7",22854564,1,-4,0,2119,431,428,-3
"dce46f8904594a62a6377a3587aaa663","070600601c4c439288445d2f0724807d",22854564,1,10,0,2122,431,437,6
"1823b6de7d334a7aaabc4570719af4d9","0380cd76a7d44bc3a4da1f15e4d68f89",22854564,1,2,0,2125,439,440,1
"0380cd76a7d44bc3a4da1f15e4d68f89","070600601c4c439288445d2f0724807d",22854564,2,-4,0,2126,440,437,-3
"070600601c4c439288445d2f0724807d","0380cd76a7d44bc3a4da1f15e4d68f89",22854564,4,4,0,2127,437,440,3
"0380cd76a7d44bc3a4da1f15e4d68f89","0380cd76a7d44bc3a4da1f15e4d68f89",22854564,5,0,1,2128,440,440,0
"0380cd76a7d44bc3a4da1f15e4d68f89","23b7673c8b5443108c2ef09382834a86",22854564,1,2,0,2129,440,441,1
"23b7673c8b5443108c2ef09382834a86","23b7673c8b5443108c2ef09382834a86",22854564,2,0,1,2130,441,441,0
"23b7673c8b5443108c2ef09382834a86","901e92500aea43c79f19f1b279050668",22854564,2,2,0,2132,441,442,1
"901e92500aea43c79f19f1b279050668","901e92500aea43c79f19f1b279050668",22854564,2,0,1,2133,442,442,0
"901e92500aea43c79f19f1b279050668","4660ff2089114e8db82ceb26a4f329e3",22854564,1,4,0,2135,442,445,3
"4660ff2089114e8db82ceb26a4f329e3","4660ff2089114e8db82ceb26a4f329e3",22854564,5,0,1,2136,445,445,0
"4660ff2089114e8db82ceb26a4f329e3","7bd5586eb9d8484eb74a433ee7bfe499",22854564,7,2,0,2138,445,446,1
"7bd5586eb9d8484eb74a433ee7bfe499","f2a73be2f46840b182d7bd095378004e",22854564,1,-27,0,2139,446,429,-17
"f2a73be2f46840b182d7bd095378004e","dce46f8904594a62a6377a3587aaa663",22854564,1,3,0,2140,429,431,2
"dce46f8904594a62a6377a3587aaa663","9b9d0a249052413c869753b99682b0ac",22854564,1,1,0,2141,431,432,1
"9b9d0a249052413c869753b99682b0ac","061c175cc90f45fbad883025394e78dd",22854564,1,1,0,2142,432,433,1
"061c175cc90f45fbad883025394e78dd","061c175cc90f45fbad883025394e78dd",22854564,3,0,1,2143,433,433,0
"061c175cc90f45fbad883025394e78dd","24cf8786024543f19b89bc20034e60d7",22854564,1,-6,0,2146,433,428,-5
"24cf8786024543f19b89bc20034e60d7","74a7f8712e5449c2bc0b43c6f90dafed",22854564,1,9,0,2147,428,435,7
"74a7f8712e5449c2bc0b43c6f90dafed","74a7f8712e5449c2bc0b43c6f90dafed",22854564,1,0,1,2148,435,435,0
"74a7f8712e5449c2bc0b43c6f90dafed","66ada10dde9f43018588f1ced9d477fc",22854564,1,-1,0,2149,435,434,-1
"bf12c96466d840a69bed7020b3f18bb8","bf12c96466d840a69bed7020b3f18bb8",22854564,2,0,1,2151,436,436,0
"bf12c96466d840a69bed7020b3f18bb8","24cf8786024543f19b89bc20034e60d7",22854564,1,-11,0,2153,436,428,-8
"24cf8786024543f19b89bc20034e60d7","070600601c4c439288445d2f0724807d",22854564,1,14,0,2154,428,437,9
"1823b6de7d334a7aaabc4570719af4d9","bf12c96466d840a69bed7020b3f18bb8",22854564,1,-5,0,2156,439,436,-3
"bf12c96466d840a69bed7020b3f18bb8","1823b6de7d334a7aaabc4570719af4d9",22854564,1,5,0,2157,436,439,3
"1823b6de7d334a7aaabc4570719af4d9","1823b6de7d334a7aaabc4570719af4d9",22854564,13,0,1,2158,439,439,0
"1823b6de7d334a7aaabc4570719af4d9","b71bac264efb4abd97015447bd490db6",22854564,1,-105,0,2160,439,370,-69
"b71bac264efb4abd97015447bd490db6","1823b6de7d334a7aaabc4570719af4d9",22854564,1,105,0,2161,370,439,69
"1823b6de7d334a7aaabc4570719af4d9","070600601c4c439288445d2f0724807d",22854564,2,-2,0,2162,439,437,-2
"0380cd76a7d44bc3a4da1f15e4d68f89","1823b6de7d334a7aaabc4570719af4d9",22854564,1,-2,0,2183,440,439,-1
"1823b6de7d334a7aaabc4570719af4d9","23b7673c8b5443108c2ef09382834a86",22854564,1,4,0,2184,439,441,2
"901e92500aea43c79f19f1b279050668","001339db8ced4cf78829ebe8b145449d",22854564,1,1,0,2186,442,443,1
"001339db8ced4cf78829ebe8b145449d","001339db8ced4cf78829ebe8b145449d",22854564,3,0,1,2187,443,443,0
"001339db8ced4cf78829ebe8b145449d","452745e0366e42ae81561bfddebcc6c3",22854564,1,1,0,2190,443,444,1
"452745e0366e42ae81561bfddebcc6c3","452745e0366e42ae81561bfddebcc6c3",22854564,1,0,1,2191,444,444,0
"452745e0366e42ae81561bfddebcc6c3","4660ff2089114e8db82ceb26a4f329e3",22854564,1,2,0,2192,444,445,1
"7bd5586eb9d8484eb74a433ee7bfe499","070600601c4c439288445d2f0724807d",22854564,2,-14,0,2194,446,437,-9
"0380cd76a7d44bc3a4da1f15e4d68f89","4660ff2089114e8db82ceb26a4f329e3",22854564,1,8,0,2197,440,445,5
"7bd5586eb9d8484eb74a433ee7bfe499","7bd5586eb9d8484eb74a433ee7bfe499",22854564,30,0,1,2200,446,446,0
"7bd5586eb9d8484eb74a433ee7bfe499","8a7f26e690f34dda97be16904518ca99",22854564,2,2,0,2201,446,447,1
"8a7f26e690f34dda97be16904518ca99","7bd5586eb9d8484eb74a433ee7bfe499",22854564,1,-2,0,2202,447,446,-1
"7bd5586eb9d8484eb74a433ee7bfe499","4660ff2089114e8db82ceb26a4f329e3",22854564,4,-2,0,2230,446,445,-1
"7bd5586eb9d8484eb74a433ee7bfe499","b2f0d654738f48158edff28e8d3a546e",22854564,1,7,0,2236,446,449,3
"b2f0d654738f48158edff28e8d3a546e","b2f0d654738f48158edff28e8d3a546e",22854564,3,0,1,2237,449,449,0
"b2f0d654738f48158edff28e8d3a546e","7bd5586eb9d8484eb74a433ee7bfe499",22854564,1,-7,0,2239,449,446,-3
"070600601c4c439288445d2f0724807d","7bd5586eb9d8484eb74a433ee7bfe499",22854564,1,14,0,2241,437,446,9
"4660ff2089114e8db82ceb26a4f329e3","8a7f26e690f34dda97be16904518ca99",22854564,1,4,0,2244,445,447,2
"8a7f26e690f34dda97be16904518ca99","4660ff2089114e8db82ceb26a4f329e3",22854564,1,-4,0,2245,447,445,-2
"8a7f26e690f34dda97be16904518ca99","8a7f26e690f34dda97be16904518ca99",22854564,1,0,1,2251,447,447,0
"8a7f26e690f34dda97be16904518ca99","b2f0d654738f48158edff28e8d3a546e",22854564,1,5,0,2252,447,449,2
"b2f0d654738f48158edff28e8d3a546e","070600601c4c439288445d2f0724807d",22854564,1,-21,0,2253,449,437,-12
"070600601c4c439288445d2f0724807d","83d42d95cd844fc093fc09cee250edb8",22854564,1,44,0,2254,437,465,28
"83d42d95cd844fc093fc09cee250edb8","b2f0d654738f48158edff28e8d3a546e",22854564,1,-23,0,2257,465,449,-16
"b2f0d654738f48158edff28e8d3a546e","66baf19b6b904b70922329068c63746d",22854564,1,-112,0,2259,449,376,-73
"7f544639412e40a9ba27f43b415362ab","2b09a08242b54983aec7063990fb3f66",22854564,1,30,0,2264,378,400,22
"dce46f8904594a62a6377a3587aaa663","f2a73be2f46840b182d7bd095378004e",22854564,1,-3,0,2280,431,429,-2
"f2a73be2f46840b182d7bd095378004e","9428d8bd9c5a47b2a235b254e5e27ded",22854564,1,38,0,2281,429,452,23
"9428d8bd9c5a47b2a235b254e5e27ded","b2f0d654738f48158edff28e8d3a546e",22854564,4,-4,0,2282,452,449,-3
"b2f0d654738f48158edff28e8d3a546e","f60ee41ec635499abd48168342d32c2f",22854564,9,5,0,2283,449,453,4
"f60ee41ec635499abd48168342d32c2f","f60ee41ec635499abd48168342d32c2f",22854564,117,0,1,2284,453,453,0
"f60ee41ec635499abd48168342d32c2f","b2f0d654738f48158edff28e8d3a546e",22854564,8,-5,0,2336,453,449,-4
"b2f0d654738f48158edff28e8d3a546e","f67fbf45a5f146ed866965bc57c7c001",22854564,2,8,0,2337,449,454,5
"f67fbf45a5f146ed866965bc57c7c001","d937afe49bd24a07a550dda1c1155122",22854564,1,1,0,2338,454,455,1
"d937afe49bd24a07a550dda1c1155122","d937afe49bd24a07a550dda1c1155122",22854564,1,0,1,2339,455,455,0
"d937afe49bd24a07a550dda1c1155122","3628b3f7823443d0912a339096b69943",22854564,1,1,0,2340,455,456,1
"3628b3f7823443d0912a339096b69943","3628b3f7823443d0912a339096b69943",22854564,1,0,1,2341,456,456,0
"3628b3f7823443d0912a339096b69943","9e049ee647cf43ecbcb5ed792a8e7588",22854564,1,1,0,2342,456,457,1
"9e049ee647cf43ecbcb5ed792a8e7588","9e049ee647cf43ecbcb5ed792a8e7588",22854564,1,0,1,2343,457,457,0
"9e049ee647cf43ecbcb5ed792a8e7588","5256a214faaf410b93f76cea06428334",22854564,1,1,0,2344,457,458,1
"5256a214faaf410b93f76cea06428334","5256a214faaf410b93f76cea06428334",22854564,1,0,1,2345,458,458,0
"5256a214faaf410b93f76cea06428334","25c32b120fce40fa9b6c85133aeb4716",22854564,1,1,0,2346,458,459,1
"25c32b120fce40fa9b6c85133aeb4716","25c32b120fce40fa9b6c85133aeb4716",22854564,5,0,1,2347,459,459,0
"25c32b120fce40fa9b6c85133aeb4716","11bc14f2204949008b7d511b933363c1",22854564,1,1,0,2348,459,460,1
"11bc14f2204949008b7d511b933363c1","11bc14f2204949008b7d511b933363c1",22854564,1,0,1,2349,460,460,0
"11bc14f2204949008b7d511b933363c1","9da37c6210b1416b8079c274f70bf600",22854564,1,2,0,2350,460,462,2
"9da37c6210b1416b8079c274f70bf600","9da37c6210b1416b8079c274f70bf600",22854564,1,0,1,2351,462,462,0
"9da37c6210b1416b8079c274f70bf600","519119f1deac45ff9ab4f13529be5c6e",22854564,1,1,0,2352,462,463,1
"519119f1deac45ff9ab4f13529be5c6e","519119f1deac45ff9ab4f13529be5c6e",22854564,1,0,1,2353,463,463,0
"519119f1deac45ff9ab4f13529be5c6e","f67fbf45a5f146ed866965bc57c7c001",22854564,1,-9,0,2354,463,454,-9
"f67fbf45a5f146ed866965bc57c7c001","f67fbf45a5f146ed866965bc57c7c001",22854564,2,0,1,2355,454,454,0
"f67fbf45a5f146ed866965bc57c7c001","3434c10e561d488a914e0f7d71907abd",22854564,1,-215,0,2356,454,305,-149
"53e7e900392747ccad52e711ab0f80d8","42de338840a34d15adb66e7b14fb9d2c",22854564,1,220,0,2360,307,461,154
"42de338840a34d15adb66e7b14fb9d2c","42de338840a34d15adb66e7b14fb9d2c",22854564,1,0,1,2361,461,461,0
"42de338840a34d15adb66e7b14fb9d2c","25c32b120fce40fa9b6c85133aeb4716",22854564,1,-2,0,2362,461,459,-2
"25c32b120fce40fa9b6c85133aeb4716","f67fbf45a5f146ed866965bc57c7c001",22854564,1,-5,0,2367,459,454,-5
"f67fbf45a5f146ed866965bc57c7c001","c5df9f40ec14463b9dcfdc73df3e9285",22854564,6,12,0,2368,454,464,10
"c5df9f40ec14463b9dcfdc73df3e9285","c5df9f40ec14463b9dcfdc73df3e9285",22854564,5,0,1,2369,464,464,0
"c5df9f40ec14463b9dcfdc73df3e9285","66baf19b6b904b70922329068c63746d",22854564,1,-132,0,2370,464,376,-88
"66baf19b6b904b70922329068c63746d","9428d8bd9c5a47b2a235b254e5e27ded",22854564,1,116,0,2371,376,452,76
"f60ee41ec635499abd48168342d32c2f","f67fbf45a5f146ed866965bc57c7c001",22854564,1,3,0,2381,453,454,1
"f67fbf45a5f146ed866965bc57c7c001","b2f0d654738f48158edff28e8d3a546e",22854564,1,-8,0,2382,454,449,-5
"b2f0d654738f48158edff28e8d3a546e","c5df9f40ec14463b9dcfdc73df3e9285",22854564,1,20,0,2383,449,464,15
"c5df9f40ec14463b9dcfdc73df3e9285","f67fbf45a5f146ed866965bc57c7c001",22854564,4,-12,0,2384,464,454,-10
"c5df9f40ec14463b9dcfdc73df3e9285","83d42d95cd844fc093fc09cee250edb8",22854564,5,3,0,2386,464,465,1
"83d42d95cd844fc093fc09cee250edb8","c5df9f40ec14463b9dcfdc73df3e9285",22854564,2,-3,0,2387,465,464,-1
"83d42d95cd844fc093fc09cee250edb8","9428d8bd9c5a47b2a235b254e5e27ded",22854564,1,-19,0,2395,465,452,-13
"f60ee41ec635499abd48168342d32c2f","9428d8bd9c5a47b2a235b254e5e27ded",22854564,1,-1,0,2405,453,452,-1
"b2f0d654738f48158edff28e8d3a546e","9428d8bd9c5a47b2a235b254e5e27ded",22854564,1,4,0,2452,449,452,3
"9428d8bd9c5a47b2a235b254e5e27ded","f60ee41ec635499abd48168342d32c2f",22854564,1,1,0,2453,452,453,1
"f67fbf45a5f146ed866965bc57c7c001","a49d1bb4328949299686242fd0be5584",22854564,1,-606,0,2474,454,21,-433
"a49d1bb4328949299686242fd0be5584","b7719e26494940efa49512aedd0aac79",22854564,1,-2,0,2475,21,20,-1
"b7719e26494940efa49512aedd0aac79","afbf7250b99d47bea07172749483ca97",22854564,4,12,0,2476,20,28,8
"afbf7250b99d47bea07172749483ca97","b7719e26494940efa49512aedd0aac79",22854564,2,-12,0,2477,28,20,-8
"b7719e26494940efa49512aedd0aac79","b7719e26494940efa49512aedd0aac79",22854564,2,0,1,2478,20,20,0
"b7719e26494940efa49512aedd0aac79","d4f45188d3c84a02ba08454e6403a818",22854564,2,5,0,2479,20,24,4
"d4f45188d3c84a02ba08454e6403a818","a49d1bb4328949299686242fd0be5584",22854564,1,-3,0,2480,24,21,-3
"a49d1bb4328949299686242fd0be5584","d4c3b003e8274e429d2fa688d73fde6d",22854564,1,1,0,2481,21,22,1
"d4c3b003e8274e429d2fa688d73fde6d","b7719e26494940efa49512aedd0aac79",22854564,2,-3,0,2482,22,20,-2
"afbf7250b99d47bea07172749483ca97","67a089198fcb4e1c8f2385786c2b296f",22854564,1,28,0,2485,28,39,11
"64d48c6c9c7940639a932219a6c87198","67a089198fcb4e1c8f2385786c2b296f",22854564,1,-1,0,2489,40,39,-1
"67a089198fcb4e1c8f2385786c2b296f","b534b89233134e30a9b5645138bfa9ee",22854564,2,4,0,2490,39,41,2
"d0c74f735e024943943e40333d6d337f","d0c74f735e024943943e40333d6d337f",22854564,1,0,1,2496,51,51,0
"d0c74f735e024943943e40333d6d337f","f924752d8a1149668870b1e7698486f7",22854564,2,-1,0,2497,51,50,-1
"78f30e4dcac84e3cbea8b2cc6e0d62b3","67a089198fcb4e1c8f2385786c2b296f",22854564,1,-25,0,2500,59,39,-20
"67a089198fcb4e1c8f2385786c2b296f","df1de691dafe4549a18a4398ee9dfaf9",22854564,1,126,0,2501,39,139,100
"df1de691dafe4549a18a4398ee9dfaf9","df1de691dafe4549a18a4398ee9dfaf9",22854564,3,0,1,2502,139,139,0
"df1de691dafe4549a18a4398ee9dfaf9","6c5ad271a44743479bfaea29b1db8d02",22854564,4,4,0,2503,139,143,4
"6c5ad271a44743479bfaea29b1db8d02","6c5ad271a44743479bfaea29b1db8d02",22854564,7,0,1,2504,143,143,0
"6c5ad271a44743479bfaea29b1db8d02","8aae34f5ddbb4052a709b12e6b0d40fa",22854564,1,5,0,2505,143,147,4
"8aae34f5ddbb4052a709b12e6b0d40fa","df1de691dafe4549a18a4398ee9dfaf9",22854564,1,-9,0,2506,147,139,-8
"df1de691dafe4549a18a4398ee9dfaf9","67a089198fcb4e1c8f2385786c2b296f",22854564,1,-126,0,2507,139,39,-100
"67a089198fcb4e1c8f2385786c2b296f","2ae94c0cea4d480a9d5dca8fb1d7b542",22854564,1,266,0,2508,39,242,203
"2ae94c0cea4d480a9d5dca8fb1d7b542","6e83e23f56544a19b94067c1c558d9c0",22854564,2,6,0,2509,242,247,5
"6e83e23f56544a19b94067c1c558d9c0","30c9ba177afc49a695625d2bdec40207",22854564,1,3,0,2510,247,250,3
"30c9ba177afc49a695625d2bdec40207","30c9ba177afc49a695625d2bdec40207",22854564,4,0,1,2511,250,250,0
"30c9ba177afc49a695625d2bdec40207","6e83e23f56544a19b94067c1c558d9c0",22854564,1,-3,0,2513,250,247,-3
"00f61990949545828dd12f1303d47504","0c7262dff33c4087bc660ccf40f92f9c",22854564,1,-114,0,2515,256,169,-87
"0c7262dff33c4087bc660ccf40f92f9c","d6d02b6ef04e4f17805504500b8ce441",22854564,1,275,0,2516,169,375,206
"d6d02b6ef04e4f17805504500b8ce441","4a29443515bb404cb8924e1c60a63b73",22854564,4,-118,0,2520,375,285,-90
"4a29443515bb404cb8924e1c60a63b73","d6d02b6ef04e4f17805504500b8ce441",22854564,3,118,0,2521,285,375,90
"4a29443515bb404cb8924e1c60a63b73","c5df9f40ec14463b9dcfdc73df3e9285",22854564,1,254,0,2537,285,464,179
"83d42d95cd844fc093fc09cee250edb8","66baf19b6b904b70922329068c63746d",22854564,2,-135,0,2548,465,376,-89
"66baf19b6b904b70922329068c63746d","f67fbf45a5f146ed866965bc57c7c001",22854564,1,120,0,2549,376,454,78
"66baf19b6b904b70922329068c63746d","30c9ba177afc49a695625d2bdec40207",22854564,1,-173,0,2559,376,250,-126
"30c9ba177afc49a695625d2bdec40207","2ae94c0cea4d480a9d5dca8fb1d7b542",22854564,2,-9,0,2561,250,242,-8
"4a29443515bb404cb8924e1c60a63b73","fab84b4fab5940efb4ea868ef8d09396",22854564,1,-4,0,2586,285,284,-1
"208c9b2796c944db8dacaa96082520ea","869e967078f04da18dd0b0b9389a7424",22854564,1,7,0,2589,288,293,5
"869e967078f04da18dd0b0b9389a7424","6a9a3b5bde4a48daa896fe8c06eca56f",22854564,1,-5,0,2590,293,289,-4
"6a9a3b5bde4a48daa896fe8c06eca56f","4a29443515bb404cb8924e1c60a63b73",22854564,1,-5,0,2591,289,285,-4
"4a29443515bb404cb8924e1c60a63b73","34a6e49023fc4465bd5ca604330bbd1c",22854564,1,9,0,2592,285,292,7
"34a6e49023fc4465bd5ca604330bbd1c","7646a919d7e64fa990bca9b024ff089d",22854564,1,8,0,2593,292,298,6
"7646a919d7e64fa990bca9b024ff089d","ba0e59461bfb4a44b7b1c28a01f8d3b3",22854564,1,1,0,2594,298,299,1
"21592f2a9e9c4b2f8c66ec5dbcbf6a2b","4a29443515bb404cb8924e1c60a63b73",22854564,1,-14,0,2596,296,285,-11
"3434c10e561d488a914e0f7d71907abd","4a29443515bb404cb8924e1c60a63b73",22854564,1,-27,0,2599,305,285,-20
"53e7e900392747ccad52e711ab0f80d8","130acc2aeb0448fdbb2de63bc5cebe5b",22854564,1,3,0,2603,307,309,2
"130acc2aeb0448fdbb2de63bc5cebe5b","3434c10e561d488a914e0f7d71907abd",22854564,1,-5,0,2604,309,305,-4
"141c0df6cd1946539aadd1c9b7068cd4","86c27d40179e419c8e9d150fb6afa5d0",22854564,1,13,0,2606,308,319,11
"86c27d40179e419c8e9d150fb6afa5d0","0c787d16c9504873b1a4d903cec09948",22854564,1,-6,0,2607,319,314,-5
"0c787d16c9504873b1a4d903cec09948","8d7e0b55cf9849cda222a0f2440cec55",22854564,1,5,0,2608,314,318,4
"8d7e0b55cf9849cda222a0f2440cec55","3628bdce1dd2429ba924d2d4d09448d2",22854564,1,5,0,2609,318,322,4
"3628bdce1dd2429ba924d2d4d09448d2","24f1363179ad4aaa965484a78471912b",22854564,1,1,0,2610,322,323,1
"24f1363179ad4aaa965484a78471912b","3434c10e561d488a914e0f7d71907abd",22854564,1,-22,0,2611,323,305,-18
"0c4079457ede49e3aeb5e86ed84bdf35","b8b9418ab322418d9db9b40d96af873a",22854564,1,9,0,2617,329,337,8
"b8b9418ab322418d9db9b40d96af873a","c2490bc612d146edbe786556fab3651b",22854564,1,4,0,2618,337,340,3
"bbc5139ca9024389a94db3a6f47dcff6","30ead9794d4847abaf222ca966cc8630",22854564,1,10,0,2620,341,348,7
"eff0de7f2dbb42dfa1a2e686efab5b6d","897b7f51242c44aab2205c72fdcbf4cd",22854564,1,-2,0,2628,354,352,-2
"c20993c944444fe085345591a8bd837e","2fe14166dc9642c3bc666b86a57f943d",22854564,1,7,0,2633,351,357,6
"2fe14166dc9642c3bc666b86a57f943d","30ead9794d4847abaf222ca966cc8630",22854564,1,-10,0,2634,357,348,-9
"30ead9794d4847abaf222ca966cc8630","1ba8fef685d74a8194b9db252eb704fb",22854564,1,8,0,2635,348,355,7
"1ba8fef685d74a8194b9db252eb704fb","eff0de7f2dbb42dfa1a2e686efab5b6d",22854564,1,-2,0,2636,355,354,-1
"eff0de7f2dbb42dfa1a2e686efab5b6d","f00179e251a045b39c3f7a54f9aa4acc",22854564,1,11,0,2637,354,363,9
"f00179e251a045b39c3f7a54f9aa4acc","52580888dadb4fe3baa795683ea227bd",22854564,1,1,0,2638,363,364,1
"52580888dadb4fe3baa795683ea227bd","072a190fd302456290895f9f04d6940a",22854564,1,2,0,2639,364,365,1
"492a3bc6a1254f23a7998587961b22a4","30ead9794d4847abaf222ca966cc8630",22854564,1,-21,0,2641,366,348,-18
"8d448d625b024c82a5eb240bbd7431d6","d6d02b6ef04e4f17805504500b8ce441",22854564,2,3,0,2653,374,375,1
"7f544639412e40a9ba27f43b415362ab","30c9ba177afc49a695625d2bdec40207",22854564,1,-175,0,2659,378,250,-128
"2ae94c0cea4d480a9d5dca8fb1d7b542","d6d02b6ef04e4f17805504500b8ce441",22854564,1,178,0,2663,242,375,133
"66baf19b6b904b70922329068c63746d","4a29443515bb404cb8924e1c60a63b73",22854564,1,-122,0,2668,376,285,-91
"4a29443515bb404cb8924e1c60a63b73","7f544639412e40a9ba27f43b415362ab",22854564,1,124,0,2669,285,378,93
"7f544639412e40a9ba27f43b415362ab","d6d02b6ef04e4f17805504500b8ce441",22854564,2,-6,0,2670,378,375,-3
"d6d02b6ef04e4f17805504500b8ce441","070600601c4c439288445d2f0724807d",22854564,1,95,0,2677,375,437,62
"070600601c4c439288445d2f0724807d","d6d02b6ef04e4f17805504500b8ce441",22854564,1,-95,0,2678,437,375,-62
"d6d02b6ef04e4f17805504500b8ce441","8d448d625b024c82a5eb240bbd7431d6",22854564,1,-3,0,2683,375,374,-1
"d6d02b6ef04e4f17805504500b8ce441","1b4550d0dab04078b3bf08a655345bdc",22854564,1,-4,0,2695,375,373,-2
"1b4550d0dab04078b3bf08a655345bdc","b71bac264efb4abd97015447bd490db6",22854564,1,-4,0,2696,373,370,-3
"b613861cecf84ffcab01afb23f660475","b613861cecf84ffcab01afb23f660475",22855139,6,0,1,1,1,1,0
"e2911e79efc2420eac45d9f671463d4b","519d1b8c59404d67b54e96c5c8a830b2",22855139,1,1,0,8,2,3,1
"519d1b8c59404d67b54e96c5c8a830b2","519d1b8c59404d67b54e96c5c8a830b2",22855139,1,0,1,9,3,3,0
"519d1b8c59404d67b54e96c5c8a830b2","531db53f81f646edb0cdcfe0085b03b7",22855139,1,1,0,10,3,4,1
"531db53f81f646edb0cdcfe0085b03b7","531db53f81f646edb0cdcfe0085b03b7",22855139,1,0,1,11,4,4,0
"531db53f81f646edb0cdcfe0085b03b7","4f5f94b2f95141e0a9d53a61da2276da",22855139,1,1,0,12,4,5,1
"4f5f94b2f95141e0a9d53a61da2276da","4f5f94b2f95141e0a9d53a61da2276da",22855139,1,0,1,13,5,5,0
"4f5f94b2f95141e0a9d53a61da2276da","6d541c89590949f99af293c4f2333f67",22855139,1,1,0,14,5,6,1
"6d541c89590949f99af293c4f2333f67","6d541c89590949f99af293c4f2333f67",22855139,1,0,1,15,6,6,0
"6d541c89590949f99af293c4f2333f67","dd5cf0b9fe4c4f1d8f5ff8e4c04879cb",22855139,1,1,0,16,6,7,1
"dd5cf0b9fe4c4f1d8f5ff8e4c04879cb","dd5cf0b9fe4c4f1d8f5ff8e4c04879cb",22855139,3,0,1,17,7,7,0
"dd5cf0b9fe4c4f1d8f5ff8e4c04879cb","f96261861edc426abe2248be4f0a709a",22855139,1,1,0,20,7,8,1
"f96261861edc426abe2248be4f0a709a","f96261861edc426abe2248be4f0a709a",22855139,1,0,1,21,8,8,0
"f96261861edc426abe2248be4f0a709a","66b5e16f4f75454fb5b8172079f0fa83",22855139,1,1,0,22,8,9,1
"66b5e16f4f75454fb5b8172079f0fa83","66b5e16f4f75454fb5b8172079f0fa83",22855139,4,0,1,23,9,9,0
"66b5e16f4f75454fb5b8172079f0fa83","0680571d4698477995e41842c36a54b2",22855139,1,1,0,27,9,10,1
"0680571d4698477995e41842c36a54b2","0680571d4698477995e41842c36a54b2",22855139,1,0,1,28,10,10,0
"0680571d4698477995e41842c36a54b2","9112f2bffece48e08c6d2287be204085",22855139,1,1,0,29,10,11,1
"9112f2bffece48e08c6d2287be204085","9112f2bffece48e08c6d2287be204085",22855139,1,0,1,30,11,11,0
"9112f2bffece48e08c6d2287be204085","56586aa865414f538729c7f7735d2bc6",22855139,1,3,0,31,11,12,1
"56586aa865414f538729c7f7735d2bc6","67a089198fcb4e1c8f2385786c2b296f",22855139,2,57,0,34,12,39,27
"64d48c6c9c7940639a932219a6c87198","56586aa865414f538729c7f7735d2bc6",22855139,1,-58,0,36,40,12,-28
"56586aa865414f538729c7f7735d2bc6","b613861cecf84ffcab01afb23f660475",22855139,1,-15,0,40,12,1,-11
"b613861cecf84ffcab01afb23f660475","b7f2b31585d94eb3bf86376714aa7070",22855139,1,17,0,41,1,13,12
"b7f2b31585d94eb3bf86376714aa7070","56586aa865414f538729c7f7735d2bc6",22855139,2,-2,0,42,13,12,-1
"56586aa865414f538729c7f7735d2bc6","3f1c815879794b929260d224becaff7e",22855139,1,4,0,46,12,14,2
"3f1c815879794b929260d224becaff7e","56586aa865414f538729c7f7735d2bc6",22855139,1,-4,0,47,14,12,-2
"56586aa865414f538729c7f7735d2bc6","eb2a0eb537344a9e891c761662e400b6",22855139,1,8,0,49,12,16,4
"eb2a0eb537344a9e891c761662e400b6","56586aa865414f538729c7f7735d2bc6",22855139,2,-8,0,50,16,12,-4
"56586aa865414f538729c7f7735d2bc6","5c5ceeee4562457ba6d41515aeebfbb1",22855139,2,10,0,51,12,17,5
"5c5ceeee4562457ba6d41515aeebfbb1","5c5ceeee4562457ba6d41515aeebfbb1",22855139,2,0,1,52,17,17,0
"5c5ceeee4562457ba6d41515aeebfbb1","56586aa865414f538729c7f7735d2bc6",22855139,1,-10,0,53,17,12,-5
"9afd71a5298d4333b6849dfce1b9422c","b613861cecf84ffcab01afb23f660475",22855139,1,-28,0,55,18,1,-17
"b613861cecf84ffcab01afb23f660475","eb2a0eb537344a9e891c761662e400b6",22855139,1,23,0,56,1,16,15
"5c5ceeee4562457ba6d41515aeebfbb1","eb2a0eb537344a9e891c761662e400b6",22855139,1,-2,0,60,17,16,-1
"eb2a0eb537344a9e891c761662e400b6","5c5ceeee4562457ba6d41515aeebfbb1",22855139,1,2,0,61,16,17,1
"81c864a886d54a6b8ff85f7d736f4f95","9afd71a5298d4333b6849dfce1b9422c",22855139,1,7,0,63,15,18,3
"9afd71a5298d4333b6849dfce1b9422c","56586aa865414f538729c7f7735d2bc6",22855139,1,-13,0,64,18,12,-6
"64d48c6c9c7940639a932219a6c87198","a49d1bb4328949299686242fd0be5584",22855139,1,-39,0,67,40,21,-19
"a49d1bb4328949299686242fd0be5584","b7719e26494940efa49512aedd0aac79",22855139,2,-2,0,68,21,20,-1
"afbf7250b99d47bea07172749483ca97","b7719e26494940efa49512aedd0aac79",22855139,1,-12,0,70,28,20,-8
"51970cfa30e643e894e66ae85c8024cc","c9c52446b6294aa5a9c2abaed536c37e",22855139,1,2,0,75,31,32,1
"c9c52446b6294aa5a9c2abaed536c37e","b613861cecf84ffcab01afb23f660475",22855139,1,-52,0,76,32,1,-31
"b613861cecf84ffcab01afb23f660475","b7719e26494940efa49512aedd0aac79",22855139,1,32,0,77,1,20,19
"d4c3b003e8274e429d2fa688d73fde6d","d4c3b003e8274e429d2fa688d73fde6d",22855139,1,0,1,82,22,22,0
"d4c3b003e8274e429d2fa688d73fde6d","b613861cecf84ffcab01afb23f660475",22855139,2,-35,0,83,22,1,-21
"b613861cecf84ffcab01afb23f660475","a49d1bb4328949299686242fd0be5584",22855139,1,34,0,84,1,21,20
"b613861cecf84ffcab01afb23f660475","c33c17be71ae4d588da7369472e5bb1b",22855139,1,56,0,90,1,34,33
"c33c17be71ae4d588da7369472e5bb1b","c33c17be71ae4d588da7369472e5bb1b",22855139,1,0,1,91,34,34,0
"b613861cecf84ffcab01afb23f660475","7040a13096d746ac84b8fac8d9752058",22855139,1,62,0,97,1,36,35
"7040a13096d746ac84b8fac8d9752058","9a0dc646f934470daf08c4b56ccf73db",22855139,2,3,0,100,36,37,1
"9a0dc646f934470daf08c4b56ccf73db","9a0dc646f934470daf08c4b56ccf73db",22855139,5,0,1,101,37,37,0
"9a0dc646f934470daf08c4b56ccf73db","fc0e049d56024bc9a02c9a9c435c3df7",22855139,2,3,0,102,37,38,1
"fc0e049d56024bc9a02c9a9c435c3df7","67a089198fcb4e1c8f2385786c2b296f",22855139,2,4,0,103,38,39,1
"67a089198fcb4e1c8f2385786c2b296f","fc0e049d56024bc9a02c9a9c435c3df7",22855139,2,-4,0,104,39,38,-1
"fc0e049d56024bc9a02c9a9c435c3df7","64d48c6c9c7940639a932219a6c87198",22855139,2,5,0,105,38,40,2
"64d48c6c9c7940639a932219a6c87198","7040a13096d746ac84b8fac8d9752058",22855139,1,-11,0,106,40,36,-4
"7040a13096d746ac84b8fac8d9752058","7040a13096d746ac84b8fac8d9752058",22855139,5,0,1,107,36,36,0
"7040a13096d746ac84b8fac8d9752058","b613861cecf84ffcab01afb23f660475",22855139,2,-62,0,109,36,1,-35
"b613861cecf84ffcab01afb23f660475","9a0dc646f934470daf08c4b56ccf73db",22855139,1,65,0,110,1,37,36
"9a0dc646f934470daf08c4b56ccf73db","b613861cecf84ffcab01afb23f660475",22855139,1,-65,0,113,37,1,-36
"b613861cecf84ffcab01afb23f660475","67a089198fcb4e1c8f2385786c2b296f",22855139,1,72,0,114,1,39,38
"67a089198fcb4e1c8f2385786c2b296f","64d48c6c9c7940639a932219a6c87198",22855139,10,1,0,115,39,40,1
"64d48c6c9c7940639a932219a6c87198","67a089198fcb4e1c8f2385786c2b296f",22855139,6,-1,0,116,40,39,-1
"67a089198fcb4e1c8f2385786c2b296f","9a0dc646f934470daf08c4b56ccf73db",22855139,1,-7,0,117,39,37,-2
"9a0dc646f934470daf08c4b56ccf73db","67a089198fcb4e1c8f2385786c2b296f",22855139,1,7,0,119,37,39,2
"67a089198fcb4e1c8f2385786c2b296f","67a089198fcb4e1c8f2385786c2b296f",22855139,8,0,1,120,39,39,0
"64d48c6c9c7940639a932219a6c87198","64d48c6c9c7940639a932219a6c87198",22855139,1,0,1,122,40,40,0
"64d48c6c9c7940639a932219a6c87198","b534b89233134e30a9b5645138bfa9ee",22855139,3,3,0,123,40,41,1
"b534b89233134e30a9b5645138bfa9ee","67a089198fcb4e1c8f2385786c2b296f",22855139,4,-4,0,124,41,39,-2
"67a089198fcb4e1c8f2385786c2b296f","b534b89233134e30a9b5645138bfa9ee",22855139,2,4,0,125,39,41,2
"b534b89233134e30a9b5645138bfa9ee","b534b89233134e30a9b5645138bfa9ee",22855139,1,0,1,126,41,41,0
"b534b89233134e30a9b5645138bfa9ee","0e37b720d23b4e7f8b313e79313fd107",22855139,1,3,0,127,41,44,3
"0e37b720d23b4e7f8b313e79313fd107","0e37b720d23b4e7f8b313e79313fd107",22855139,2,0,1,128,44,44,0
"0e37b720d23b4e7f8b313e79313fd107","6875d67fdd5f48168b62719df449bebd",22855139,1,1,0,130,44,45,1
"6875d67fdd5f48168b62719df449bebd","6875d67fdd5f48168b62719df449bebd",22855139,5,0,1,131,45,45,0
"6875d67fdd5f48168b62719df449bebd","6e13d61a7bdb44bca949c9f86fab3be5",22855139,1,3,0,136,45,47,2
"6e13d61a7bdb44bca949c9f86fab3be5","b534b89233134e30a9b5645138bfa9ee",22855139,1,-7,0,137,47,41,-6
"b534b89233134e30a9b5645138bfa9ee","6e13d61a7bdb44bca949c9f86fab3be5",22855139,4,7,0,138,41,47,6
"6e13d61a7bdb44bca949c9f86fab3be5","195f78799f984cc2b06c48dfe36be751",22855139,1,2,0,139,47,49,2
"195f78799f984cc2b06c48dfe36be751","195f78799f984cc2b06c48dfe36be751",22855139,5,0,1,140,49,49,0
"195f78799f984cc2b06c48dfe36be751","d0c74f735e024943943e40333d6d337f",22855139,1,3,0,145,49,51,2
"d0c74f735e024943943e40333d6d337f","d9c8d8c444a64dadbbb508652c721e17",22855139,2,-6,0,146,51,46,-5
"d9c8d8c444a64dadbbb508652c721e17","d0c74f735e024943943e40333d6d337f",22855139,1,6,0,147,46,51,5
"d0c74f735e024943943e40333d6d337f","983f8ff320594b279a7f4a6fe132f9c5",22855139,1,2,0,148,51,53,2
"983f8ff320594b279a7f4a6fe132f9c5","983f8ff320594b279a7f4a6fe132f9c5",22855139,5,0,1,149,53,53,0
"983f8ff320594b279a7f4a6fe132f9c5","35adfa5d923046aebabfefd98f35ff05",22855139,1,1,0,154,53,54,1
"35adfa5d923046aebabfefd98f35ff05","35adfa5d923046aebabfefd98f35ff05",22855139,2,0,1,155,54,54,0
"35adfa5d923046aebabfefd98f35ff05","b6f8a98476224da1b40e555ececc7ed8",22855139,1,1,0,157,54,55,1
"b6f8a98476224da1b40e555ececc7ed8","b6f8a98476224da1b40e555ececc7ed8",22855139,5,0,1,158,55,55,0
"b6f8a98476224da1b40e555ececc7ed8","86e22cb5fe0e4b47a9489ecddf7ed78f",22855139,1,1,0,163,55,56,1
"86e22cb5fe0e4b47a9489ecddf7ed78f","86e22cb5fe0e4b47a9489ecddf7ed78f",22855139,2,0,1,164,56,56,0
"86e22cb5fe0e4b47a9489ecddf7ed78f","a1f2f12debe5432fb7a70bcd12bacfb9",22855139,1,3,0,166,56,58,2
"a1f2f12debe5432fb7a70bcd12bacfb9","f924752d8a1149668870b1e7698486f7",22855139,1,-9,0,167,58,50,-8
"f924752d8a1149668870b1e7698486f7","78f30e4dcac84e3cbea8b2cc6e0d62b3",22855139,2,10,0,168,50,59,9
"78f30e4dcac84e3cbea8b2cc6e0d62b3","a1f2f12debe5432fb7a70bcd12bacfb9",22855139,2,-1,0,169,59,58,-1
"a1f2f12debe5432fb7a70bcd12bacfb9","a1f2f12debe5432fb7a70bcd12bacfb9",22855139,13,0,1,170,58,58,0
"a1f2f12debe5432fb7a70bcd12bacfb9","78f30e4dcac84e3cbea8b2cc6e0d62b3",22855139,1,1,0,183,58,59,1
"78f30e4dcac84e3cbea8b2cc6e0d62b3","78f30e4dcac84e3cbea8b2cc6e0d62b3",22855139,15,0,1,184,59,59,0
"78f30e4dcac84e3cbea8b2cc6e0d62b3","bc42d26810654ea9a1df1efe1e58c7d5",22855139,1,5,0,199,59,63,4
"bc42d26810654ea9a1df1efe1e58c7d5","a0a418b8540d479fa6e0f653b701da8b",22855139,2,1,0,200,63,64,1
"a0a418b8540d479fa6e0f653b701da8b","12aa6e1672ac4e7aa6449a7a8609cd72",22855139,2,-8,0,201,64,57,-7
"12aa6e1672ac4e7aa6449a7a8609cd72","4c943503763e4e349906eea3ed3c8e86",22855139,1,5,0,202,57,61,4
"4c943503763e4e349906eea3ed3c8e86","4c943503763e4e349906eea3ed3c8e86",22855139,1,0,1,203,61,61,0
"4c943503763e4e349906eea3ed3c8e86","bc42d26810654ea9a1df1efe1e58c7d5",22855139,1,2,0,204,61,63,2
"bc42d26810654ea9a1df1efe1e58c7d5","bc42d26810654ea9a1df1efe1e58c7d5",22855139,5,0,1,205,63,63,0
"a0a418b8540d479fa6e0f653b701da8b","a0a418b8540d479fa6e0f653b701da8b",22855139,5,0,1,209,64,64,0
"a0a418b8540d479fa6e0f653b701da8b","309ccf3cc4fe429d9bfbaef53d3fa479",22855139,1,-4,0,212,64,60,-4
"309ccf3cc4fe429d9bfbaef53d3fa479","7af822066add4e7f8e007e4eee31a8bf",22855139,1,6,0,213,60,65,5
"7af822066add4e7f8e007e4eee31a8bf","6e13d61a7bdb44bca949c9f86fab3be5",22855139,1,-22,0,214,65,47,-18
"6e13d61a7bdb44bca949c9f86fab3be5","67a089198fcb4e1c8f2385786c2b296f",22855139,2,-11,0,215,47,39,-8
"67a089198fcb4e1c8f2385786c2b296f","d9c8d8c444a64dadbbb508652c721e17",22855139,2,10,0,216,39,46,7
"d9c8d8c444a64dadbbb508652c721e17","b534b89233134e30a9b5645138bfa9ee",22855139,2,-6,0,217,46,41,-5
"6e13d61a7bdb44bca949c9f86fab3be5","6e13d61a7bdb44bca949c9f86fab3be5",22855139,4,0,1,219,47,47,0
"6e13d61a7bdb44bca949c9f86fab3be5","d646286c8051419bbc2e31dd1db55ca8",22855139,1,26,0,220,47,67,20
"d646286c8051419bbc2e31dd1db55ca8","d646286c8051419bbc2e31dd1db55ca8",22855139,2,0,1,221,67,67,0
"d646286c8051419bbc2e31dd1db55ca8","267f883678b24aed855fde42524975d9",22855139,1,4,0,222,67,71,4
"267f883678b24aed855fde42524975d9","267f883678b24aed855fde42524975d9",22855139,3,0,1,223,71,71,0
"267f883678b24aed855fde42524975d9","88fff56d0342490dbef9040750a20f6c",22855139,1,1,0,226,71,72,1
"88fff56d0342490dbef9040750a20f6c","88fff56d0342490dbef9040750a20f6c",22855139,1,0,1,227,72,72,0
"88fff56d0342490dbef9040750a20f6c","adb17b12b66c4a49a85fd34322f7df70",22855139,1,1,0,228,72,73,1
"adb17b12b66c4a49a85fd34322f7df70","adb17b12b66c4a49a85fd34322f7df70",22855139,3,0,1,229,73,73,0
"adb17b12b66c4a49a85fd34322f7df70","d646286c8051419bbc2e31dd1db55ca8",22855139,1,-6,0,232,73,67,-6
"d646286c8051419bbc2e31dd1db55ca8","a2becd407db34b189200a32546d9d569",22855139,2,9,0,233,67,75,8
"a2becd407db34b189200a32546d9d569","a2becd407db34b189200a32546d9d569",22855139,1,0,1,234,75,75,0
"a2becd407db34b189200a32546d9d569","58c22b011d0f4c2ea6d13615edbb9eeb",22855139,1,2,0,235,75,77,2
"58c22b011d0f4c2ea6d13615edbb9eeb","58c22b011d0f4c2ea6d13615edbb9eeb",22855139,11,0,1,236,77,77,0
"58c22b011d0f4c2ea6d13615edbb9eeb","dd76e1861dc9461c830888729d091ee0",22855139,1,1,0,247,77,78,1
"dd76e1861dc9461c830888729d091ee0","dd76e1861dc9461c830888729d091ee0",22855139,5,0,1,248,78,78,0
"dd76e1861dc9461c830888729d091ee0","cd1d828f1a694b87913a7ea66c23803e",22855139,1,1,0,253,78,79,1
"cd1d828f1a694b87913a7ea66c23803e","cd1d828f1a694b87913a7ea66c23803e",22855139,5,0,1,254,79,79,0
"cd1d828f1a694b87913a7ea66c23803e","9176a3c2b4d2465fa8b0c67096c2a97e",22855139,1,1,0,259,79,80,1
"9176a3c2b4d2465fa8b0c67096c2a97e","9176a3c2b4d2465fa8b0c67096c2a97e",22855139,5,0,1,260,80,80,0
"9176a3c2b4d2465fa8b0c67096c2a97e","f8ec6445f7194e25b9101d4fbcb07a18",22855139,1,1,0,265,80,81,1
"f8ec6445f7194e25b9101d4fbcb07a18","f8ec6445f7194e25b9101d4fbcb07a18",22855139,2,0,1,266,81,81,0
"f8ec6445f7194e25b9101d4fbcb07a18","140d5b27b8574befad82c0a013b59dfa",22855139,1,-7,0,268,81,74,-7
"140d5b27b8574befad82c0a013b59dfa","a2becd407db34b189200a32546d9d569",22855139,1,1,0,269,74,75,1
"a2becd407db34b189200a32546d9d569","d18a9ea32855445f8736581f5cb119ce",22855139,1,8,0,270,75,82,7
"d18a9ea32855445f8736581f5cb119ce","140d5b27b8574befad82c0a013b59dfa",22855139,1,-9,0,271,82,74,-8
"140d5b27b8574befad82c0a013b59dfa","d646286c8051419bbc2e31dd1db55ca8",22855139,1,-8,0,272,74,67,-7
"d646286c8051419bbc2e31dd1db55ca8","ae5ac430ea254e708a6f5deaaf7464ae",22855139,1,20,0,273,67,84,17
"ae5ac430ea254e708a6f5deaaf7464ae","d18a9ea32855445f8736581f5cb119ce",22855139,1,-3,0,274,84,82,-2
"d18a9ea32855445f8736581f5cb119ce","f564483cbd7a407681aa2fcca518cf5f",22855139,1,4,0,275,82,85,3
"f564483cbd7a407681aa2fcca518cf5f","f564483cbd7a407681aa2fcca518cf5f",22855139,4,0,1,276,85,85,0
"f564483cbd7a407681aa2fcca518cf5f","18fd01350bd5434ca636d59a599d768a",22855139,1,1,0,280,85,86,1
"18fd01350bd5434ca636d59a599d768a","18fd01350bd5434ca636d59a599d768a",22855139,9,0,1,281,86,86,0
"6a9f0ef185fb47f0937e29daa1c71ed5","c681290961c94c4caf23b529d1ae6b9a",22855139,1,-2,0,292,90,88,-2
"c681290961c94c4caf23b529d1ae6b9a","c681290961c94c4caf23b529d1ae6b9a",22855139,1,0,1,293,88,88,0
"c681290961c94c4caf23b529d1ae6b9a","6a9f0ef185fb47f0937e29daa1c71ed5",22855139,1,2,0,294,88,90,2
"67a089198fcb4e1c8f2385786c2b296f","e20db35ced8544ddac5bc3839145e463",22855139,3,67,0,301,39,91,52
"e20db35ced8544ddac5bc3839145e463","e20db35ced8544ddac5bc3839145e463",22855139,2,0,1,302,91,91,0
"e20db35ced8544ddac5bc3839145e463","1febb706d7a34005ae8711ed49c76e64",22855139,1,3,0,303,91,94,3
"1febb706d7a34005ae8711ed49c76e64","1febb706d7a34005ae8711ed49c76e64",22855139,2,0,1,304,94,94,0
"1febb706d7a34005ae8711ed49c76e64","8f73ba6f5a0042f2850356ac38ac6f24",22855139,1,1,0,306,94,95,1
"8f73ba6f5a0042f2850356ac38ac6f24","8f73ba6f5a0042f2850356ac38ac6f24",22855139,5,0,1,307,95,95,0
"8f73ba6f5a0042f2850356ac38ac6f24","e2260b86653c46d7b14a41fb419dbf8c",22855139,1,1,0,312,95,96,1
"e2260b86653c46d7b14a41fb419dbf8c","e2260b86653c46d7b14a41fb419dbf8c",22855139,2,0,1,313,96,96,0
"e2260b86653c46d7b14a41fb419dbf8c","35eb641ad1d845bbba54915bce75a962",22855139,1,1,0,315,96,97,1
"35eb641ad1d845bbba54915bce75a962","35eb641ad1d845bbba54915bce75a962",22855139,6,0,1,316,97,97,0
"35eb641ad1d845bbba54915bce75a962","08be90ffbeea4795a138cd42ed8db56f",22855139,1,1,0,322,97,98,1
"08be90ffbeea4795a138cd42ed8db56f","08be90ffbeea4795a138cd42ed8db56f",22855139,6,0,1,323,98,98,0
"08be90ffbeea4795a138cd42ed8db56f","3007433c8f584dcbb5ac159c1c5f2be3",22855139,1,1,0,329,98,99,1
"3007433c8f584dcbb5ac159c1c5f2be3","3007433c8f584dcbb5ac159c1c5f2be3",22855139,5,0,1,330,99,99,0
"3007433c8f584dcbb5ac159c1c5f2be3","e20db35ced8544ddac5bc3839145e463",22855139,1,-8,0,335,99,91,-8
"d391c8b6e56a43a7b654e9dee02d904b","00ae5f0c51874a73a41ebea838d95682",22855139,5,-2,0,338,103,101,-2
"d391c8b6e56a43a7b654e9dee02d904b","d391c8b6e56a43a7b654e9dee02d904b",22855139,15,0,1,340,103,103,0
"d391c8b6e56a43a7b654e9dee02d904b","6111116566fc4fd9abba409322bea245",22855139,1,1,0,355,103,104,1
"6111116566fc4fd9abba409322bea245","6111116566fc4fd9abba409322bea245",22855139,2,0,1,356,104,104,0
"6111116566fc4fd9abba409322bea245","a81b2235cb9c499eb9ea8ee0a8dd9725",22855139,1,1,0,358,104,105,1
"a81b2235cb9c499eb9ea8ee0a8dd9725","a81b2235cb9c499eb9ea8ee0a8dd9725",22855139,6,0,1,359,105,105,0
"a81b2235cb9c499eb9ea8ee0a8dd9725","2d4e0ab0ef3b4d73b82c72d4621a7579",22855139,1,1,0,365,105,106,1
"2d4e0ab0ef3b4d73b82c72d4621a7579","2d4e0ab0ef3b4d73b82c72d4621a7579",22855139,2,0,1,366,106,106,0
"2d4e0ab0ef3b4d73b82c72d4621a7579","8bdebf492ebd4e62b0d522e8ab5e5197",22855139,1,1,0,368,106,107,1
"8bdebf492ebd4e62b0d522e8ab5e5197","8bdebf492ebd4e62b0d522e8ab5e5197",22855139,2,0,1,369,107,107,0
"8bdebf492ebd4e62b0d522e8ab5e5197","73039f8c1eb9409cb4caee2cf968001e",22855139,1,-7,0,371,107,100,-7
"73039f8c1eb9409cb4caee2cf968001e","4280927ec4d643238aa49c32f9e06c6c",22855139,3,10,0,372,100,109,9
"4280927ec4d643238aa49c32f9e06c6c","08111f75e22d409998cf8b85bd431f0a",22855139,2,-1,0,373,109,108,-1
"08111f75e22d409998cf8b85bd431f0a","e20db35ced8544ddac5bc3839145e463",22855139,1,-19,0,374,108,91,-17
"e20db35ced8544ddac5bc3839145e463","d391c8b6e56a43a7b654e9dee02d904b",22855139,3,13,0,375,91,103,12
"00ae5f0c51874a73a41ebea838d95682","73039f8c1eb9409cb4caee2cf968001e",22855139,3,-1,0,377,101,100,-1
"73039f8c1eb9409cb4caee2cf968001e","00ae5f0c51874a73a41ebea838d95682",22855139,6,1,0,378,100,101,1
"00ae5f0c51874a73a41ebea838d95682","e20db35ced8544ddac5bc3839145e463",22855139,2,-11,0,379,101,91,-10
"d391c8b6e56a43a7b654e9dee02d904b","08111f75e22d409998cf8b85bd431f0a",22855139,1,6,0,385,103,108,5
"08111f75e22d409998cf8b85bd431f0a","4280927ec4d643238aa49c32f9e06c6c",22855139,1,1,0,386,108,109,1
"00ae5f0c51874a73a41ebea838d95682","08111f75e22d409998cf8b85bd431f0a",22855139,1,8,0,389,101,108,7
"08111f75e22d409998cf8b85bd431f0a","d391c8b6e56a43a7b654e9dee02d904b",22855139,1,-6,0,390,108,103,-5
"08111f75e22d409998cf8b85bd431f0a","00ae5f0c51874a73a41ebea838d95682",22855139,1,-8,0,395,108,101,-7
"73039f8c1eb9409cb4caee2cf968001e","d391c8b6e56a43a7b654e9dee02d904b",22855139,1,3,0,397,100,103,3
"d391c8b6e56a43a7b654e9dee02d904b","e20db35ced8544ddac5bc3839145e463",22855139,1,-13,0,398,103,91,-12
"e20db35ced8544ddac5bc3839145e463","73039f8c1eb9409cb4caee2cf968001e",22855139,2,10,0,399,91,100,9
"73039f8c1eb9409cb4caee2cf968001e","e20db35ced8544ddac5bc3839145e463",22855139,2,-10,0,404,100,91,-9
"d391c8b6e56a43a7b654e9dee02d904b","73039f8c1eb9409cb4caee2cf968001e",22855139,2,-3,0,407,103,100,-3
"4280927ec4d643238aa49c32f9e06c6c","4280927ec4d643238aa49c32f9e06c6c",22855139,1,0,1,409,109,109,0
"4280927ec4d643238aa49c32f9e06c6c","fc44e6a5f7654430af1227838224dceb",22855139,1,2,0,410,109,111,2
"fc44e6a5f7654430af1227838224dceb","fc44e6a5f7654430af1227838224dceb",22855139,5,0,1,411,111,111,0
"fc44e6a5f7654430af1227838224dceb","08111f75e22d409998cf8b85bd431f0a",22855139,1,-3,0,416,111,108,-3
"a9ae0a3c070d455bb4369a8996313336","00ae5f0c51874a73a41ebea838d95682",22855139,1,-15,0,418,114,101,-13
"00ae5f0c51874a73a41ebea838d95682","37319e88176d4aefa91d7a9980dbae91",22855139,1,13,0,419,101,112,11
"37319e88176d4aefa91d7a9980dbae91","d391c8b6e56a43a7b654e9dee02d904b",22855139,1,-11,0,420,112,103,-9
"00ae5f0c51874a73a41ebea838d95682","4280927ec4d643238aa49c32f9e06c6c",22855139,2,9,0,426,101,109,8
"73039f8c1eb9409cb4caee2cf968001e","67a089198fcb4e1c8f2385786c2b296f",22855139,1,-77,0,428,100,39,-61
"67a089198fcb4e1c8f2385786c2b296f","37319e88176d4aefa91d7a9980dbae91",22855139,1,91,0,443,39,112,73
"37319e88176d4aefa91d7a9980dbae91","e20db35ced8544ddac5bc3839145e463",22855139,1,-24,0,444,112,91,-21
"e20db35ced8544ddac5bc3839145e463","a9ae0a3c070d455bb4369a8996313336",22855139,1,26,0,445,91,114,23
"a9ae0a3c070d455bb4369a8996313336","a9ae0a3c070d455bb4369a8996313336",22855139,1,0,1,446,114,114,0
"a9ae0a3c070d455bb4369a8996313336","71cec822bcff4f30a20e75dc63ef7b65",22855139,1,2,0,447,114,116,2
"71cec822bcff4f30a20e75dc63ef7b65","71cec822bcff4f30a20e75dc63ef7b65",22855139,3,0,1,448,116,116,0
"71cec822bcff4f30a20e75dc63ef7b65","37319e88176d4aefa91d7a9980dbae91",22855139,1,-4,0,451,116,112,-4
"62bff51286ef4f348717a3cf6fe2318f","a9ae0a3c070d455bb4369a8996313336",22855139,1,-7,0,453,120,114,-6
"a9ae0a3c070d455bb4369a8996313336","3ec3a3563847406fa73338f9e9999cf3",22855139,1,4,0,454,114,117,3
"3ec3a3563847406fa73338f9e9999cf3","37319e88176d4aefa91d7a9980dbae91",22855139,1,-6,0,455,117,112,-5
"62bff51286ef4f348717a3cf6fe2318f","67a089198fcb4e1c8f2385786c2b296f",22855139,1,-100,0,457,120,39,-81
"62bff51286ef4f348717a3cf6fe2318f","e20db35ced8544ddac5bc3839145e463",22855139,2,-33,0,461,120,91,-29
"e20db35ced8544ddac5bc3839145e463","b1cd0e7dc3ad4a8eb91a4bfdbeb025b0",22855139,1,31,0,462,91,118,27
"b1cd0e7dc3ad4a8eb91a4bfdbeb025b0","b1cd0e7dc3ad4a8eb91a4bfdbeb025b0",22855139,1,0,1,463,118,118,0
"b1cd0e7dc3ad4a8eb91a4bfdbeb025b0","62bff51286ef4f348717a3cf6fe2318f",22855139,1,2,0,464,118,120,2
"779f9ddd1fd14d1e9e69f72219a1fdbd","67a089198fcb4e1c8f2385786c2b296f",22855139,2,-103,0,470,121,39,-82
"67a089198fcb4e1c8f2385786c2b296f","3cbcea2be0984e7dbd5a48195af10ce7",22855139,5,160,0,471,39,165,126
"3cbcea2be0984e7dbd5a48195af10ce7","3cbcea2be0984e7dbd5a48195af10ce7",22855139,9,0,1,472,165,165,0
"3cbcea2be0984e7dbd5a48195af10ce7","82e6285962b8400d9d6fc32436022a94",22855139,13,2,0,473,165,167,2
"82e6285962b8400d9d6fc32436022a94","3cbcea2be0984e7dbd5a48195af10ce7",22855139,5,-2,0,474,167,165,-2
"82e6285962b8400d9d6fc32436022a94","67a089198fcb4e1c8f2385786c2b296f",22855139,6,-162,0,479,167,39,-128
"65202579580f4ad38d734b4ee39d22a8","67a089198fcb4e1c8f2385786c2b296f",22855139,1,-157,0,495,164,39,-125
"779f9ddd1fd14d1e9e69f72219a1fdbd","ae26e6cda8ad4a3f81bd347560d9579f",22855139,1,4,0,502,121,125,4
"ae26e6cda8ad4a3f81bd347560d9579f","ae26e6cda8ad4a3f81bd347560d9579f",22855139,5,0,1,503,125,125,0
"ae26e6cda8ad4a3f81bd347560d9579f","ee48df95832b4374aa273ceb27ec1315",22855139,1,1,0,508,125,126,1
"ee48df95832b4374aa273ceb27ec1315","ee48df95832b4374aa273ceb27ec1315",22855139,3,0,1,509,126,126,0
"ee48df95832b4374aa273ceb27ec1315","7a439da90b394756ad1777fc4c6dead5",22855139,1,1,0,512,126,127,1
"7a439da90b394756ad1777fc4c6dead5","7a439da90b394756ad1777fc4c6dead5",22855139,1,0,1,513,127,127,0
"7a439da90b394756ad1777fc4c6dead5","a8dd5213034441ac92724b4e83eb0bb2",22855139,1,3,0,514,127,129,2
"779f9ddd1fd14d1e9e69f72219a1fdbd","a8dd5213034441ac92724b4e83eb0bb2",22855139,1,9,0,516,121,129,8
"a8dd5213034441ac92724b4e83eb0bb2","8115eab6556b45f5b415c3b8c26a12e5",22855139,1,2,0,517,129,131,2
"8115eab6556b45f5b415c3b8c26a12e5","8115eab6556b45f5b415c3b8c26a12e5",22855139,2,0,1,518,131,131,0
"8115eab6556b45f5b415c3b8c26a12e5","ec34b06efd844b46a4c4818ecdb9b8f4",22855139,1,1,0,520,131,132,1
"ec34b06efd844b46a4c4818ecdb9b8f4","ec34b06efd844b46a4c4818ecdb9b8f4",22855139,5,0,1,521,132,132,0
"ec34b06efd844b46a4c4818ecdb9b8f4","c2e1c2b9eac64109b343a088584b576b",22855139,1,1,0,526,132,133,1
"c2e1c2b9eac64109b343a088584b576b","c2e1c2b9eac64109b343a088584b576b",22855139,2,0,1,527,133,133,0
"c2e1c2b9eac64109b343a088584b576b","579338175e0b4bbb8ef3b712b5d8b54e",22855139,1,-5,0,529,133,128,-5
"579338175e0b4bbb8ef3b712b5d8b54e","8bc5795d6a984a3eace4e2811e52dd4f",22855139,1,8,0,530,128,135,7
"8bc5795d6a984a3eace4e2811e52dd4f","8bc5795d6a984a3eace4e2811e52dd4f",22855139,3,0,1,531,135,135,0
"8bc5795d6a984a3eace4e2811e52dd4f","b416d47c56a742199b5d7c7f19d6503a",22855139,1,-1,0,534,135,134,-1
"b416d47c56a742199b5d7c7f19d6503a","cd4532ad48034873ba8bce2aac0c9808",22855139,1,4,0,535,134,137,3
"cd4532ad48034873ba8bce2aac0c9808","cd4532ad48034873ba8bce2aac0c9808",22855139,1,0,1,536,137,137,0
"cd4532ad48034873ba8bce2aac0c9808","df1de691dafe4549a18a4398ee9dfaf9",22855139,1,4,0,537,137,139,2
"df1de691dafe4549a18a4398ee9dfaf9","779f9ddd1fd14d1e9e69f72219a1fdbd",22855139,1,-23,0,538,139,121,-18
"67a089198fcb4e1c8f2385786c2b296f","6c5ad271a44743479bfaea29b1db8d02",22855139,1,130,0,540,39,143,104
"df1de691dafe4549a18a4398ee9dfaf9","df1de691dafe4549a18a4398ee9dfaf9",22855139,2,0,1,542,139,139,0
"6c5ad271a44743479bfaea29b1db8d02","6c5ad271a44743479bfaea29b1db8d02",22855139,1,0,1,544,143,143,0
"6c5ad271a44743479bfaea29b1db8d02","83d311bed5374fee83d8d67a7d9d82dc",22855139,1,1,0,545,143,144,1
"83d311bed5374fee83d8d67a7d9d82dc","83d311bed5374fee83d8d67a7d9d82dc",22855139,2,0,1,546,144,144,0
"83d311bed5374fee83d8d67a7d9d82dc","402bba41861d43acb52a5abb89e8831e",22855139,1,1,0,547,144,145,1
"402bba41861d43acb52a5abb89e8831e","402bba41861d43acb52a5abb89e8831e",22855139,2,0,1,548,145,145,0
"402bba41861d43acb52a5abb89e8831e","8aae34f5ddbb4052a709b12e6b0d40fa",22855139,1,3,0,550,145,147,2
"8aae34f5ddbb4052a709b12e6b0d40fa","df1de691dafe4549a18a4398ee9dfaf9",22855139,2,-9,0,551,147,139,-8
"645b3f0249f64f76af2e19eb4d0e55b7","645b3f0249f64f76af2e19eb4d0e55b7",22855139,10,0,1,554,149,149,0
"645b3f0249f64f76af2e19eb4d0e55b7","7e7b8db5064d4369805ab370aac5ddfb",22855139,1,1,0,564,149,150,1
"7e7b8db5064d4369805ab370aac5ddfb","7e7b8db5064d4369805ab370aac5ddfb",22855139,5,0,1,565,150,150,0
"7e7b8db5064d4369805ab370aac5ddfb","8956d210ae7f41968fada86d4c979d6a",22855139,1,1,0,570,150,151,1
"8956d210ae7f41968fada86d4c979d6a","8956d210ae7f41968fada86d4c979d6a",22855139,2,0,1,571,151,151,0
"8956d210ae7f41968fada86d4c979d6a","f902b0f41b544d4dbf79664fd233648d",22855139,1,-5,0,573,151,146,-5
"f902b0f41b544d4dbf79664fd233648d","67a089198fcb4e1c8f2385786c2b296f",22855139,1,-134,0,574,146,39,-107
"67a089198fcb4e1c8f2385786c2b296f","df1de691dafe4549a18a4398ee9dfaf9",22855139,2,126,0,575,39,139,100
"6c5ad271a44743479bfaea29b1db8d02","8aae34f5ddbb4052a709b12e6b0d40fa",22855139,1,5,0,578,143,147,4
"6c5ad271a44743479bfaea29b1db8d02","f902b0f41b544d4dbf79664fd233648d",22855139,1,4,0,581,143,146,3
"f902b0f41b544d4dbf79664fd233648d","83d311bed5374fee83d8d67a7d9d82dc",22855139,1,-3,0,582,146,144,-2
"83d311bed5374fee83d8d67a7d9d82dc","67a089198fcb4e1c8f2385786c2b296f",22855139,1,-131,0,584,144,39,-105
"df1de691dafe4549a18a4398ee9dfaf9","f03480cf4eba413194d7af52fc0e7f28",22855139,1,15,0,586,139,152,13
"f03480cf4eba413194d7af52fc0e7f28","ae781e8b775e4ccd93bc800dad5c8376",22855139,1,1,0,587,152,153,1
"ae781e8b775e4ccd93bc800dad5c8376","ae781e8b775e4ccd93bc800dad5c8376",22855139,2,0,1,588,153,153,0
"ae781e8b775e4ccd93bc800dad5c8376","06882a8492d9499aa31555567f575ecb",22855139,1,1,0,590,153,154,1
"06882a8492d9499aa31555567f575ecb","06882a8492d9499aa31555567f575ecb",22855139,1,0,1,591,154,154,0
"06882a8492d9499aa31555567f575ecb","f293c508f409466a8f27ddd7d1e40b20",22855139,1,1,0,592,154,155,1
"f293c508f409466a8f27ddd7d1e40b20","f293c508f409466a8f27ddd7d1e40b20",22855139,9,0,1,593,155,155,0
"f293c508f409466a8f27ddd7d1e40b20","cc4ddef5bbbe48ebb605141b347c4ed1",22855139,1,1,0,602,155,156,1
"cc4ddef5bbbe48ebb605141b347c4ed1","cc4ddef5bbbe48ebb605141b347c4ed1",22855139,1,0,1,603,156,156,0
"cc4ddef5bbbe48ebb605141b347c4ed1","d313cec988a84645bee413e8d4724a4b",22855139,1,3,0,604,156,158,2
"d313cec988a84645bee413e8d4724a4b","f03480cf4eba413194d7af52fc0e7f28",22855139,1,-7,0,605,158,152,-6
"d313cec988a84645bee413e8d4724a4b","dc60696c76a74368a60f72246e47700d",22855139,1,1,0,610,158,159,1
"dc60696c76a74368a60f72246e47700d","dc60696c76a74368a60f72246e47700d",22855139,1,0,1,611,159,159,0
"dc60696c76a74368a60f72246e47700d","78adeee1fa2c4fe0bc73f7bca9fcee86",22855139,1,3,0,612,159,160,1
"df1de691dafe4549a18a4398ee9dfaf9","67a089198fcb4e1c8f2385786c2b296f",22855139,1,-126,0,614,139,39,-100
"67a089198fcb4e1c8f2385786c2b296f","78adeee1fa2c4fe0bc73f7bca9fcee86",22855139,3,152,0,626,39,160,121
"78adeee1fa2c4fe0bc73f7bca9fcee86","78adeee1fa2c4fe0bc73f7bca9fcee86",22855139,2,0,1,627,160,160,0
"78adeee1fa2c4fe0bc73f7bca9fcee86","67a089198fcb4e1c8f2385786c2b296f",22855139,2,-152,0,628,160,39,-121
"d646286c8051419bbc2e31dd1db55ca8","d18a9ea32855445f8736581f5cb119ce",22855139,1,17,0,639,67,82,15
"d18a9ea32855445f8736581f5cb119ce","67a089198fcb4e1c8f2385786c2b296f",22855139,1,-54,0,640,82,39,-43
"78adeee1fa2c4fe0bc73f7bca9fcee86","3cbcea2be0984e7dbd5a48195af10ce7",22855139,1,8,0,699,160,165,5
"67a089198fcb4e1c8f2385786c2b296f","a9ac840f098c4bd0a2ee896214ce29cd",22855139,2,165,0,710,39,168,129
"a9ac840f098c4bd0a2ee896214ce29cd","a9ac840f098c4bd0a2ee896214ce29cd",22855139,2,0,1,711,168,168,0
"a9ac840f098c4bd0a2ee896214ce29cd","67a089198fcb4e1c8f2385786c2b296f",22855139,1,-165,0,712,168,39,-129
"67a089198fcb4e1c8f2385786c2b296f","b7719e26494940efa49512aedd0aac79",22855139,1,-40,0,713,39,20,-19
"b7719e26494940efa49512aedd0aac79","a49d1bb4328949299686242fd0be5584",22855139,3,2,0,714,20,21,1
"a49d1bb4328949299686242fd0be5584","a49d1bb4328949299686242fd0be5584",22855139,1,0,1,715,21,21,0
"a49d1bb4328949299686242fd0be5584","d4f45188d3c84a02ba08454e6403a818",22855139,3,3,0,716,21,24,3
"d4f45188d3c84a02ba08454e6403a818","a49d1bb4328949299686242fd0be5584",22855139,2,-3,0,717,24,21,-3
"a49d1bb4328949299686242fd0be5584","d4c3b003e8274e429d2fa688d73fde6d",22855139,2,1,0,718,21,22,1
"b7719e26494940efa49512aedd0aac79","0c7262dff33c4087bc660ccf40f92f9c",22855139,1,209,0,720,20,169,149
"0c7262dff33c4087bc660ccf40f92f9c","b2275c3fad834f8d90737a2d9a6927d6",22855139,7,3,0,721,169,172,3
"b2275c3fad834f8d90737a2d9a6927d6","3cbcea2be0984e7dbd5a48195af10ce7",22855139,2,-12,0,726,172,165,-7
"82e6285962b8400d9d6fc32436022a94","0c7262dff33c4087bc660ccf40f92f9c",22855139,2,7,0,729,167,169,2
"0c7262dff33c4087bc660ccf40f92f9c","3cbcea2be0984e7dbd5a48195af10ce7",22855139,1,-9,0,740,169,165,-4
"a9ac840f098c4bd0a2ee896214ce29cd","0c7262dff33c4087bc660ccf40f92f9c",22855139,1,4,0,748,168,169,1
"b2275c3fad834f8d90737a2d9a6927d6","b2275c3fad834f8d90737a2d9a6927d6",22855139,32,0,1,751,172,172,0
"b2275c3fad834f8d90737a2d9a6927d6","eb515a26030b41f8a82a1e6114420bad",22855139,1,1,0,783,172,173,1
"eb515a26030b41f8a82a1e6114420bad","eb515a26030b41f8a82a1e6114420bad",22855139,2,0,1,784,173,173,0
"eb515a26030b41f8a82a1e6114420bad","b42cc17b7de840f181a704558d0bc845",22855139,1,3,0,786,173,175,2
"b42cc17b7de840f181a704558d0bc845","0c7262dff33c4087bc660ccf40f92f9c",22855139,1,-7,0,787,175,169,-6
"801f9e9135034f49bf5f8b4bdefedb41","801f9e9135034f49bf5f8b4bdefedb41",22855139,8,0,1,790,177,177,0
"b87c552dd247427abe6ab5795b9c9d43","ea38cc0e6e6e41edbabf210220808bf9",22855139,1,-2,0,801,181,179,-2
"ea38cc0e6e6e41edbabf210220808bf9","ea38cc0e6e6e41edbabf210220808bf9",22855139,2,0,1,802,179,179,0
"b87c552dd247427abe6ab5795b9c9d43","b87c552dd247427abe6ab5795b9c9d43",22855139,7,0,1,805,181,181,0
"139b097acfca451689d80c9c6eebdf7b","30f660a1feb34582a739722532524f79",22855139,1,6,0,813,178,183,5
"30f660a1feb34582a739722532524f79","30f660a1feb34582a739722532524f79",22855139,7,0,1,814,183,183,0
"30f660a1feb34582a739722532524f79","2024b4885bd14338a39b7b509acbbd02",22855139,1,-1,0,821,183,182,-1
"2024b4885bd14338a39b7b509acbbd02","c3f63fe50d8e487c86bf8ef76c9cadd3",22855139,1,4,0,822,182,185,3
"c3f63fe50d8e487c86bf8ef76c9cadd3","c3f63fe50d8e487c86bf8ef76c9cadd3",22855139,1,0,1,823,185,185,0
"c3f63fe50d8e487c86bf8ef76c9cadd3","0c7262dff33c4087bc660ccf40f92f9c",22855139,1,-20,0,824,185,169,-16
"c8e371568a0c4391b25796ae4e91952e","7d932b23e1c84326ae5aa4d3c0d813d1",22855139,1,2,0,826,186,188,2
"7d932b23e1c84326ae5aa4d3c0d813d1","7d932b23e1c84326ae5aa4d3c0d813d1",22855139,1,0,1,827,188,188,0
"7d932b23e1c84326ae5aa4d3c0d813d1","c8e371568a0c4391b25796ae4e91952e",22855139,1,-2,0,828,188,186,-2
"ab11d94c6c8948ea90b88f19d2cd502b","ab11d94c6c8948ea90b88f19d2cd502b",22855139,1,0,1,830,190,190,0
"ab11d94c6c8948ea90b88f19d2cd502b","f992451ed6ad4e68bb9e68ad6be7c4be",22855139,1,2,0,831,190,192,2
"f992451ed6ad4e68bb9e68ad6be7c4be","f992451ed6ad4e68bb9e68ad6be7c4be",22855139,3,0,1,832,192,192,0
"f992451ed6ad4e68bb9e68ad6be7c4be","07b44a7a51e94c78b411c753fc39dab0",22855139,1,-3,0,835,192,189,-3
"07b44a7a51e94c78b411c753fc39dab0","6cd2dcaac46847d4a0bc53f296d90375",22855139,1,6,0,836,189,194,5
"6cd2dcaac46847d4a0bc53f296d90375","6cd2dcaac46847d4a0bc53f296d90375",22855139,1,0,1,837,194,194,0
"6cd2dcaac46847d4a0bc53f296d90375","2d2580c9411c4972909db508d6956a58",22855139,1,2,0,838,194,196,2
"2d2580c9411c4972909db508d6956a58","2d2580c9411c4972909db508d6956a58",22855139,9,0,1,839,196,196,0
"2d2580c9411c4972909db508d6956a58","5bddb3d9ed264f3984702f048c7e5340",22855139,1,1,0,848,196,197,1
"5bddb3d9ed264f3984702f048c7e5340","5bddb3d9ed264f3984702f048c7e5340",22855139,2,0,1,849,197,197,0
"5bddb3d9ed264f3984702f048c7e5340","d5e8e2bd12a2466b9d6d90855f0eb079",22855139,1,1,0,851,197,198,1
"d5e8e2bd12a2466b9d6d90855f0eb079","d5e8e2bd12a2466b9d6d90855f0eb079",22855139,2,0,1,852,198,198,0
"d5e8e2bd12a2466b9d6d90855f0eb079","017d7ca8e0394b91aaadc9574df2202c",22855139,1,-5,0,854,198,193,-5
"017d7ca8e0394b91aaadc9574df2202c","54e8e9f0ea3e45c4bf3b8ac799ee31b1",22855139,1,8,0,855,193,200,7
"54e8e9f0ea3e45c4bf3b8ac799ee31b1","54e8e9f0ea3e45c4bf3b8ac799ee31b1",22855139,1,0,1,856,200,200,0
"54e8e9f0ea3e45c4bf3b8ac799ee31b1","c614a00911be4877a075f19315530fb0",22855139,1,1,0,857,200,201,1
"c614a00911be4877a075f19315530fb0","c614a00911be4877a075f19315530fb0",22855139,6,0,1,858,201,201,0
"c614a00911be4877a075f19315530fb0","a6c21bd8b95249c7972820a7a7d76aff",22855139,1,1,0,864,201,202,1
"a6c21bd8b95249c7972820a7a7d76aff","a6c21bd8b95249c7972820a7a7d76aff",22855139,1,0,1,865,202,202,0
"a6c21bd8b95249c7972820a7a7d76aff","bb329d880ab54120adaf203a693bb203",22855139,1,1,0,866,202,203,1
"bb329d880ab54120adaf203a693bb203","bb329d880ab54120adaf203a693bb203",22855139,1,0,1,867,203,203,0
"bb329d880ab54120adaf203a693bb203","f9170dd6bc6442b4acd832747609b09a",22855139,1,-4,0,868,203,199,-4
"f9170dd6bc6442b4acd832747609b09a","334c2344009840079b1d0e1b7ce3d5a7",22855139,1,7,0,869,199,205,6
"334c2344009840079b1d0e1b7ce3d5a7","334c2344009840079b1d0e1b7ce3d5a7",22855139,1,0,1,870,205,205,0
"334c2344009840079b1d0e1b7ce3d5a7","d7f13c8d63ec4e2aa673fbb9cf9c6933",22855139,1,3,0,871,205,206,1
"d7f13c8d63ec4e2aa673fbb9cf9c6933","c8e371568a0c4391b25796ae4e91952e",22855139,1,-26,0,872,206,186,-20
"c8e371568a0c4391b25796ae4e91952e","b9e80f77c3a44349863b19875725c384",22855139,1,27,0,873,186,207,21
"7108f0e4c2584f1f9c471689ae4c885c","0c7262dff33c4087bc660ccf40f92f9c",22855139,1,-51,0,875,208,169,-39
"d7f13c8d63ec4e2aa673fbb9cf9c6933","d7f13c8d63ec4e2aa673fbb9cf9c6933",22855139,1,0,1,877,206,206,0
"7108f0e4c2584f1f9c471689ae4c885c","b9e80f77c3a44349863b19875725c384",22855139,1,-1,0,880,208,207,-1
"b9e80f77c3a44349863b19875725c384","b9e80f77c3a44349863b19875725c384",22855139,57,0,1,881,207,207,0
"7108f0e4c2584f1f9c471689ae4c885c","7108f0e4c2584f1f9c471689ae4c885c",22855139,13,0,1,939,208,208,0
"7108f0e4c2584f1f9c471689ae4c885c","09400e101c5d4b439cf9a26b03aae558",22855139,1,3,0,952,208,210,2
"09400e101c5d4b439cf9a26b03aae558","d7f13c8d63ec4e2aa673fbb9cf9c6933",22855139,1,-5,0,953,210,206,-4
"09400e101c5d4b439cf9a26b03aae558","a88efa7e50ce47159810ab553afa6d3a",22855139,1,2,0,955,210,212,2
"a88efa7e50ce47159810ab553afa6d3a","a88efa7e50ce47159810ab553afa6d3a",22855139,5,0,1,956,212,212,0
"a88efa7e50ce47159810ab553afa6d3a","a875096404ef4a9984b62d74cda916f9",22855139,1,-3,0,961,212,209,-3
"f7fb1952f56b4189b86a9f8b7862d2b8","be502a7a43c44bf7b682698de79d9369",22855139,1,-1,0,964,215,214,-1
"be502a7a43c44bf7b682698de79d9369","be502a7a43c44bf7b682698de79d9369",22855139,2,0,1,965,214,214,0
"f7fb1952f56b4189b86a9f8b7862d2b8","f7fb1952f56b4189b86a9f8b7862d2b8",22855139,15,0,1,968,215,215,0
"f7fb1952f56b4189b86a9f8b7862d2b8","b860ee85d8bc4a2f97958cfb71be3533",22855139,1,1,0,983,215,216,1
"b860ee85d8bc4a2f97958cfb71be3533","b860ee85d8bc4a2f97958cfb71be3533",22855139,2,0,1,984,216,216,0
"b860ee85d8bc4a2f97958cfb71be3533","363837c182e04711840d896ae1e0339c",22855139,1,3,0,986,216,218,2
"363837c182e04711840d896ae1e0339c","363837c182e04711840d896ae1e0339c",22855139,11,0,1,989,218,218,0
"363837c182e04711840d896ae1e0339c","01b2051f8941460d89945e3b02d1ce78",22855139,2,-1,0,1000,218,217,-1
"01b2051f8941460d89945e3b02d1ce78","91125ca626c5470eb145501f8c37f8db",22855139,1,4,0,1001,217,220,3
"91125ca626c5470eb145501f8c37f8db","91125ca626c5470eb145501f8c37f8db",22855139,1,0,1,1002,220,220,0
"91125ca626c5470eb145501f8c37f8db","1c6721b1f63f4d30ba7746ea8af02a52",22855139,1,3,0,1003,220,221,1
"1c6721b1f63f4d30ba7746ea8af02a52","d7f13c8d63ec4e2aa673fbb9cf9c6933",22855139,1,-21,0,1004,221,206,-15
"d7f13c8d63ec4e2aa673fbb9cf9c6933","77ecef8eff6b4a2caea7707669bf7475",22855139,1,22,0,1005,206,222,16
"77ecef8eff6b4a2caea7707669bf7475","77ecef8eff6b4a2caea7707669bf7475",22855139,15,0,1,1006,222,222,0
"77ecef8eff6b4a2caea7707669bf7475","8b9ae98743bd4d4a8a87dff1c1244211",22855139,1,6,0,1021,222,227,5
"8b9ae98743bd4d4a8a87dff1c1244211","d03cb855c70044cf8c35d9ec0de696e3",22855139,1,-3,0,1022,227,224,-3
"d03cb855c70044cf8c35d9ec0de696e3","1c6721b1f63f4d30ba7746ea8af02a52",22855139,1,-4,0,1023,224,221,-3
"1c6721b1f63f4d30ba7746ea8af02a52","d03cb855c70044cf8c35d9ec0de696e3",22855139,2,4,0,1024,221,224,3
"d03cb855c70044cf8c35d9ec0de696e3","a49a937d6896486d9a5396654abcf2e1",22855139,1,2,0,1025,224,226,2
"a49a937d6896486d9a5396654abcf2e1","a49a937d6896486d9a5396654abcf2e1",22855139,5,0,1,1026,226,226,0
"a49a937d6896486d9a5396654abcf2e1","8b9ae98743bd4d4a8a87dff1c1244211",22855139,1,1,0,1031,226,227,1
"8b9ae98743bd4d4a8a87dff1c1244211","8b9ae98743bd4d4a8a87dff1c1244211",22855139,38,0,1,1032,227,227,0
"8b9ae98743bd4d4a8a87dff1c1244211","2ab1535aac1346ba8801535bf729ef37",22855139,1,3,0,1070,227,229,2
"2ab1535aac1346ba8801535bf729ef37","f7906d6f59b9489a91d2ef40db5a474d",22855139,1,-7,0,1071,229,223,-6
"f7906d6f59b9489a91d2ef40db5a474d","2ab1535aac1346ba8801535bf729ef37",22855139,2,7,0,1072,223,229,6
"2ab1535aac1346ba8801535bf729ef37","a4f40fb48a8542c8949bae1f002cd9bc",22855139,2,2,0,1073,229,231,2
"a4f40fb48a8542c8949bae1f002cd9bc","a4f40fb48a8542c8949bae1f002cd9bc",22855139,4,0,1,1074,231,231,0
"a4f40fb48a8542c8949bae1f002cd9bc","8972c23e32044edb8a78fa1eed4e5947",22855139,1,1,0,1076,231,232,1
"8972c23e32044edb8a78fa1eed4e5947","8972c23e32044edb8a78fa1eed4e5947",22855139,1,0,1,1077,232,232,0
"8972c23e32044edb8a78fa1eed4e5947","92feb4a40f8344d38b6f722e42a53295",22855139,1,1,0,1078,232,233,1
"92feb4a40f8344d38b6f722e42a53295","92feb4a40f8344d38b6f722e42a53295",22855139,2,0,1,1079,233,233,0
"92feb4a40f8344d38b6f722e42a53295","5152833676bf4c6cb317060be10f68db",22855139,1,-5,0,1081,233,228,-5
"5152833676bf4c6cb317060be10f68db","0b04c8e2f86d48c7aeb7e225819cd32b",22855139,2,7,0,1082,228,234,6
"0b04c8e2f86d48c7aeb7e225819cd32b","2ab1535aac1346ba8801535bf729ef37",22855139,1,-6,0,1083,234,229,-5
"2ab1535aac1346ba8801535bf729ef37","5152833676bf4c6cb317060be10f68db",22855139,2,-1,0,1084,229,228,-1
"5152833676bf4c6cb317060be10f68db","1c6721b1f63f4d30ba7746ea8af02a52",22855139,2,-9,0,1085,228,221,-7
"1c6721b1f63f4d30ba7746ea8af02a52","77ecef8eff6b4a2caea7707669bf7475",22855139,2,1,0,1086,221,222,1
"77ecef8eff6b4a2caea7707669bf7475","0c7262dff33c4087bc660ccf40f92f9c",22855139,1,-71,0,1087,222,169,-53
"0c7262dff33c4087bc660ccf40f92f9c","5152833676bf4c6cb317060be10f68db",22855139,1,79,0,1088,169,228,59
"1c6721b1f63f4d30ba7746ea8af02a52","2ab1535aac1346ba8801535bf729ef37",22855139,1,10,0,1090,221,229,8
"2ab1535aac1346ba8801535bf729ef37","2ab1535aac1346ba8801535bf729ef37",22855139,1,0,1,1091,229,229,0
"a4f40fb48a8542c8949bae1f002cd9bc","5152833676bf4c6cb317060be10f68db",22855139,1,-3,0,1095,231,228,-3
"5152833676bf4c6cb317060be10f68db","ca3e28f290354c08aefe5b0f769604e6",22855139,1,8,0,1096,228,235,7
"ca3e28f290354c08aefe5b0f769604e6","ca3e28f290354c08aefe5b0f769604e6",22855139,14,0,1,1097,235,235,0
"ca3e28f290354c08aefe5b0f769604e6","79a35eea833e4c2c9d22fc53c3c6445c",22855139,1,1,0,1111,235,236,1
"79a35eea833e4c2c9d22fc53c3c6445c","79a35eea833e4c2c9d22fc53c3c6445c",22855139,4,0,1,1112,236,236,0
"79a35eea833e4c2c9d22fc53c3c6445c","8f68228b1518449e9615cdafee41a2bd",22855139,1,1,0,1116,236,237,1
"8f68228b1518449e9615cdafee41a2bd","8f68228b1518449e9615cdafee41a2bd",22855139,1,0,1,1117,237,237,0
"8f68228b1518449e9615cdafee41a2bd","cab89fa5c3ed45a5aa550fc0352d6a42",22855139,1,1,0,1118,237,238,1
"cab89fa5c3ed45a5aa550fc0352d6a42","cab89fa5c3ed45a5aa550fc0352d6a42",22855139,3,0,1,1119,238,238,0
"cab89fa5c3ed45a5aa550fc0352d6a42","66d4fad4f1cf4b46be0750a99ad7a35a",22855139,1,1,0,1122,238,239,1
"66d4fad4f1cf4b46be0750a99ad7a35a","66d4fad4f1cf4b46be0750a99ad7a35a",22855139,1,0,1,1123,239,239,0
"66d4fad4f1cf4b46be0750a99ad7a35a","0b04c8e2f86d48c7aeb7e225819cd32b",22855139,1,-5,0,1124,239,234,-5
"0b04c8e2f86d48c7aeb7e225819cd32b","f53da5fd9bfe412da4b80d4742563b6c",22855139,1,8,0,1125,234,241,7
"f53da5fd9bfe412da4b80d4742563b6c","f53da5fd9bfe412da4b80d4742563b6c",22855139,1,0,1,1126,241,241,0
"f53da5fd9bfe412da4b80d4742563b6c","1c6721b1f63f4d30ba7746ea8af02a52",22855139,1,-24,0,1127,241,221,-20
"1c6721b1f63f4d30ba7746ea8af02a52","2ae94c0cea4d480a9d5dca8fb1d7b542",22855139,1,27,0,1128,221,242,21
"2ae94c0cea4d480a9d5dca8fb1d7b542","1ebf23f9d994469a85206e4c7b1bf5f5",22855139,1,3,0,1129,242,245,3
"1ebf23f9d994469a85206e4c7b1bf5f5","1ebf23f9d994469a85206e4c7b1bf5f5",22855139,16,0,1,1130,245,245,0
"1ebf23f9d994469a85206e4c7b1bf5f5","85ae675b83e8422da842cfd25596af99",22855139,1,1,0,1146,245,246,1
"85ae675b83e8422da842cfd25596af99","85ae675b83e8422da842cfd25596af99",22855139,1,0,1,1147,246,246,0
"85ae675b83e8422da842cfd25596af99","2ae94c0cea4d480a9d5dca8fb1d7b542",22855139,1,-4,0,1148,246,242,-4
"2ae94c0cea4d480a9d5dca8fb1d7b542","fa235f0f364d47e4ae1c87f47bf8e6ba",22855139,1,12,0,1149,242,252,10
"fa235f0f364d47e4ae1c87f47bf8e6ba","fa235f0f364d47e4ae1c87f47bf8e6ba",22855139,1,0,1,1150,252,252,0
"fa235f0f364d47e4ae1c87f47bf8e6ba","79f7845465cc4ed19d8e4f1429541be0",22855139,1,2,0,1151,252,254,2
"79f7845465cc4ed19d8e4f1429541be0","79f7845465cc4ed19d8e4f1429541be0",22855139,10,0,1,1152,254,254,0
"79f7845465cc4ed19d8e4f1429541be0","6e83e23f56544a19b94067c1c558d9c0",22855139,1,-8,0,1162,254,247,-7
"6e83e23f56544a19b94067c1c558d9c0","00f61990949545828dd12f1303d47504",22855139,2,11,0,1163,247,256,9
"00f61990949545828dd12f1303d47504","0c7262dff33c4087bc660ccf40f92f9c",22855139,1,-114,0,1164,256,169,-87
"0c7262dff33c4087bc660ccf40f92f9c","0c7262dff33c4087bc660ccf40f92f9c",22855139,4,0,1,1165,169,169,0
"0c7262dff33c4087bc660ccf40f92f9c","2ae94c0cea4d480a9d5dca8fb1d7b542",22855139,1,97,0,1166,169,242,73
"2ae94c0cea4d480a9d5dca8fb1d7b542","d989ebcfc12a4b669f0100dc1aa14f1e",22855139,1,16,0,1167,242,255,13
"d989ebcfc12a4b669f0100dc1aa14f1e","d989ebcfc12a4b669f0100dc1aa14f1e",22855139,1,0,1,1168,255,255,0
"d989ebcfc12a4b669f0100dc1aa14f1e","00f61990949545828dd12f1303d47504",22855139,2,1,0,1169,255,256,1
"00f61990949545828dd12f1303d47504","d989ebcfc12a4b669f0100dc1aa14f1e",22855139,1,-1,0,1170,256,255,-1
"00f61990949545828dd12f1303d47504","ead7bb4b64e247d2ae632ab8a296b091",22855139,1,2,0,1172,256,258,2
"ead7bb4b64e247d2ae632ab8a296b091","ead7bb4b64e247d2ae632ab8a296b091",22855139,2,0,1,1173,258,258,0
"ead7bb4b64e247d2ae632ab8a296b091","41b0048dde734bb280bac6116baa8e27",22855139,1,1,0,1175,258,259,1
"41b0048dde734bb280bac6116baa8e27","41b0048dde734bb280bac6116baa8e27",22855139,2,0,1,1176,259,259,0
"41b0048dde734bb280bac6116baa8e27","b41c5a094a604ee0915327da5cc0beb7",22855139,1,1,0,1178,259,260,1
"b41c5a094a604ee0915327da5cc0beb7","b41c5a094a604ee0915327da5cc0beb7",22855139,6,0,1,1179,260,260,0
"b41c5a094a604ee0915327da5cc0beb7","d546341988904f069cfa86b21457d9d9",22855139,1,-10,0,1185,260,251,-9
"d546341988904f069cfa86b21457d9d9","28c171777c52431ab6b925073bd63d46",22855139,1,15,0,1186,251,264,13
"28c171777c52431ab6b925073bd63d46","28c171777c52431ab6b925073bd63d46",22855139,7,0,1,1187,264,264,0
"28c171777c52431ab6b925073bd63d46","ac160db940cb49ae8579162b1d52bb5d",22855139,1,2,0,1194,264,266,2
"ac160db940cb49ae8579162b1d52bb5d","ac160db940cb49ae8579162b1d52bb5d",22855139,7,0,1,1195,266,266,0
"ac160db940cb49ae8579162b1d52bb5d","d989ebcfc12a4b669f0100dc1aa14f1e",22855139,1,-12,0,1202,266,255,-11
"d989ebcfc12a4b669f0100dc1aa14f1e","c6fd49b485cc4874b0bbdd9c6171e09c",22855139,1,15,0,1203,255,268,13
"c6fd49b485cc4874b0bbdd9c6171e09c","c6fd49b485cc4874b0bbdd9c6171e09c",22855139,7,0,1,1204,268,268,0
"c6fd49b485cc4874b0bbdd9c6171e09c","44240778a97c4af0937817499b75707b",22855139,1,1,0,1211,268,269,1
"44240778a97c4af0937817499b75707b","44240778a97c4af0937817499b75707b",22855139,2,0,1,1212,269,269,0
"44240778a97c4af0937817499b75707b","7aa76d3e993840d8805f097cbdbcd44b",22855139,1,-9,0,1214,269,261,-8
"7aa76d3e993840d8805f097cbdbcd44b","865a4d3b43374da7944dc7d397f566d9",22855139,1,12,0,1215,261,271,10
"865a4d3b43374da7944dc7d397f566d9","865a4d3b43374da7944dc7d397f566d9",22855139,1,0,1,1216,271,271,0
"865a4d3b43374da7944dc7d397f566d9","0d987bed3ffa4ed0b9a2e62e97b7b30f",22855139,1,3,0,1217,271,272,1
"0d987bed3ffa4ed0b9a2e62e97b7b30f","2ae94c0cea4d480a9d5dca8fb1d7b542",22855139,2,-38,0,1218,272,242,-30
"2ae94c0cea4d480a9d5dca8fb1d7b542","0c7262dff33c4087bc660ccf40f92f9c",22855139,2,-97,0,1219,242,169,-73
"0c7262dff33c4087bc660ccf40f92f9c","0d987bed3ffa4ed0b9a2e62e97b7b30f",22855139,3,135,0,1220,169,272,103
"0d987bed3ffa4ed0b9a2e62e97b7b30f","0d987bed3ffa4ed0b9a2e62e97b7b30f",22855139,5,0,1,1221,272,272,0
"0d987bed3ffa4ed0b9a2e62e97b7b30f","0c7262dff33c4087bc660ccf40f92f9c",22855139,2,-135,0,1223,272,169,-103
"0c7262dff33c4087bc660ccf40f92f9c","7aa76d3e993840d8805f097cbdbcd44b",22855139,1,120,0,1224,169,261,92
"7aa76d3e993840d8805f097cbdbcd44b","2ae94c0cea4d480a9d5dca8fb1d7b542",22855139,2,-23,0,1225,261,242,-19
"2ae94c0cea4d480a9d5dca8fb1d7b542","7aa76d3e993840d8805f097cbdbcd44b",22855139,1,23,0,1226,242,261,19
"7aa76d3e993840d8805f097cbdbcd44b","0d987bed3ffa4ed0b9a2e62e97b7b30f",22855139,1,15,0,1227,261,272,11
"2ae94c0cea4d480a9d5dca8fb1d7b542","0d987bed3ffa4ed0b9a2e62e97b7b30f",22855139,2,38,0,1229,242,272,30
"0c7262dff33c4087bc660ccf40f92f9c","d7f13c8d63ec4e2aa673fbb9cf9c6933",22855139,2,49,0,1231,169,206,37
"d7f13c8d63ec4e2aa673fbb9cf9c6933","ec341f459285443b8361f7f15638ff08",22855139,1,9,0,1232,206,213,7
"ec341f459285443b8361f7f15638ff08","be502a7a43c44bf7b682698de79d9369",22855139,1,1,0,1233,213,214,1
"be502a7a43c44bf7b682698de79d9369","f7fb1952f56b4189b86a9f8b7862d2b8",22855139,4,1,0,1234,214,215,1
"f7fb1952f56b4189b86a9f8b7862d2b8","363837c182e04711840d896ae1e0339c",22855139,1,4,0,1235,215,218,3
"363837c182e04711840d896ae1e0339c","ec341f459285443b8361f7f15638ff08",22855139,2,-6,0,1236,218,213,-5
"ec341f459285443b8361f7f15638ff08","01b2051f8941460d89945e3b02d1ce78",22855139,1,5,0,1237,213,217,4
"01b2051f8941460d89945e3b02d1ce78","0c7262dff33c4087bc660ccf40f92f9c",22855139,1,-63,0,1238,217,169,-48
"0c7262dff33c4087bc660ccf40f92f9c","d546341988904f069cfa86b21457d9d9",22855139,1,108,0,1239,169,251,82
"d546341988904f069cfa86b21457d9d9","2ae94c0cea4d480a9d5dca8fb1d7b542",22855139,1,-11,0,1240,251,242,-9
"2ae94c0cea4d480a9d5dca8fb1d7b542","00f61990949545828dd12f1303d47504",22855139,2,17,0,1241,242,256,14
"00f61990949545828dd12f1303d47504","d546341988904f069cfa86b21457d9d9",22855139,1,-6,0,1242,256,251,-5
"d546341988904f069cfa86b21457d9d9","0c7262dff33c4087bc660ccf40f92f9c",22855139,1,-108,0,1243,251,169,-82
"0d987bed3ffa4ed0b9a2e62e97b7b30f","82ae07bc0c9b4570a41799290d1ef399",22855139,1,4,0,1245,272,275,3
"82ae07bc0c9b4570a41799290d1ef399","82ae07bc0c9b4570a41799290d1ef399",22855139,1,0,1,1246,275,275,0
"82ae07bc0c9b4570a41799290d1ef399","0c7262dff33c4087bc660ccf40f92f9c",22855139,1,-139,0,1247,275,169,-106
"0c7262dff33c4087bc660ccf40f92f9c","7028800abe7d4e27b613d1d6cbe26bf7",22855139,1,127,0,1248,169,267,98
"7028800abe7d4e27b613d1d6cbe26bf7","2ae94c0cea4d480a9d5dca8fb1d7b542",22855139,1,-30,0,1249,267,242,-25
"0d987bed3ffa4ed0b9a2e62e97b7b30f","bb5a47f5ea01454a8b79455422d3b9da",22855139,3,10,0,1254,272,280,8
"bb5a47f5ea01454a8b79455422d3b9da","bb5a47f5ea01454a8b79455422d3b9da",22855139,71,0,1,1255,280,280,0
"bb5a47f5ea01454a8b79455422d3b9da","82ae07bc0c9b4570a41799290d1ef399",22855139,2,-6,0,1257,280,275,-5
"82ae07bc0c9b4570a41799290d1ef399","bb5a47f5ea01454a8b79455422d3b9da",22855139,2,6,0,1258,275,280,5
"bb5a47f5ea01454a8b79455422d3b9da","94cecc3f1e7d484b8e068e79241dfd73",22855139,2,3,0,1313,280,281,1
"94cecc3f1e7d484b8e068e79241dfd73","0d987bed3ffa4ed0b9a2e62e97b7b30f",22855139,2,-13,0,1314,281,272,-9
"0d987bed3ffa4ed0b9a2e62e97b7b30f","a37477c4e4c14169ad44b06b493007f6",22855139,2,15,0,1315,272,283,11
"a37477c4e4c14169ad44b06b493007f6","0c7262dff33c4087bc660ccf40f92f9c",22855139,2,-150,0,1316,283,169,-114
"0c7262dff33c4087bc660ccf40f92f9c","78adeee1fa2c4fe0bc73f7bca9fcee86",22855139,1,-17,0,1317,169,160,-9
"78adeee1fa2c4fe0bc73f7bca9fcee86","8959e6304a0348309a771e4d08d1b64a",22855139,1,4,0,1318,160,163,3
"8959e6304a0348309a771e4d08d1b64a","65202579580f4ad38d734b4ee39d22a8",22855139,1,1,0,1319,163,164,1
"65202579580f4ad38d734b4ee39d22a8","65202579580f4ad38d734b4ee39d22a8",22855139,73,0,1,1320,164,164,0
"65202579580f4ad38d734b4ee39d22a8","94cecc3f1e7d484b8e068e79241dfd73",22855139,1,160,0,1329,164,281,117
"94cecc3f1e7d484b8e068e79241dfd73","94cecc3f1e7d484b8e068e79241dfd73",22855139,5,0,1,1330,281,281,0
"94cecc3f1e7d484b8e068e79241dfd73","a37477c4e4c14169ad44b06b493007f6",22855139,6,2,0,1331,281,283,2
"0c7262dff33c4087bc660ccf40f92f9c","94cecc3f1e7d484b8e068e79241dfd73",22855139,1,148,0,1333,169,281,112
"a37477c4e4c14169ad44b06b493007f6","94cecc3f1e7d484b8e068e79241dfd73",22855139,3,-2,0,1336,283,281,-2
"a37477c4e4c14169ad44b06b493007f6","d6d02b6ef04e4f17805504500b8ce441",22855139,2,125,0,1339,283,375,92
"d6d02b6ef04e4f17805504500b8ce441","d6d02b6ef04e4f17805504500b8ce441",22855139,51,0,1,1340,375,375,0
"d6d02b6ef04e4f17805504500b8ce441","94cecc3f1e7d484b8e068e79241dfd73",22855139,1,-127,0,1343,375,281,-94
"d6d02b6ef04e4f17805504500b8ce441","4a29443515bb404cb8924e1c60a63b73",22855139,8,-118,0,1351,375,285,-90
"4a29443515bb404cb8924e1c60a63b73","fab84b4fab5940efb4ea868ef8d09396",22855139,2,-4,0,1352,285,284,-1
"fab84b4fab5940efb4ea868ef8d09396","fab84b4fab5940efb4ea868ef8d09396",22855139,5,0,1,1353,284,284,0
"fab84b4fab5940efb4ea868ef8d09396","4a29443515bb404cb8924e1c60a63b73",22855139,2,4,0,1356,284,285,1
"4a29443515bb404cb8924e1c60a63b73","208c9b2796c944db8dacaa96082520ea",22855139,4,3,0,1357,285,288,3
"208c9b2796c944db8dacaa96082520ea","94cecc3f1e7d484b8e068e79241dfd73",22855139,1,-12,0,1358,288,281,-7
"a37477c4e4c14169ad44b06b493007f6","fab84b4fab5940efb4ea868ef8d09396",22855139,1,3,0,1360,283,284,1
"fab84b4fab5940efb4ea868ef8d09396","0c7262dff33c4087bc660ccf40f92f9c",22855139,1,-153,0,1363,284,169,-115
"0c7262dff33c4087bc660ccf40f92f9c","6e83e23f56544a19b94067c1c558d9c0",22855139,1,103,0,1364,169,247,78
"6e83e23f56544a19b94067c1c558d9c0","2ae94c0cea4d480a9d5dca8fb1d7b542",22855139,2,-6,0,1365,247,242,-5
"2ae94c0cea4d480a9d5dca8fb1d7b542","4a29443515bb404cb8924e1c60a63b73",22855139,1,60,0,1366,242,285,43
"4a29443515bb404cb8924e1c60a63b73","4a29443515bb404cb8924e1c60a63b73",22855139,3,0,1,1367,285,285,0
"208c9b2796c944db8dacaa96082520ea","208c9b2796c944db8dacaa96082520ea",22855139,1,0,1,1369,288,288,0
"208c9b2796c944db8dacaa96082520ea","4a29443515bb404cb8924e1c60a63b73",22855139,4,-3,0,1370,288,285,-3
"4a29443515bb404cb8924e1c60a63b73","7669a956527947d0add87455277e80b4",22855139,1,7,0,1376,285,291,6
"7669a956527947d0add87455277e80b4","7669a956527947d0add87455277e80b4",22855139,1,0,1,1377,291,291,0
"7669a956527947d0add87455277e80b4","869e967078f04da18dd0b0b9389a7424",22855139,1,3,0,1378,291,293,2
"869e967078f04da18dd0b0b9389a7424","6a9a3b5bde4a48daa896fe8c06eca56f",22855139,1,-5,0,1379,293,289,-4
"6a9a3b5bde4a48daa896fe8c06eca56f","869e967078f04da18dd0b0b9389a7424",22855139,2,5,0,1380,289,293,4
"869e967078f04da18dd0b0b9389a7424","51ab6291537748fab90d519aa09889d6",22855139,1,2,0,1381,293,295,2
"51ab6291537748fab90d519aa09889d6","51ab6291537748fab90d519aa09889d6",22855139,11,0,1,1382,295,295,0
"51ab6291537748fab90d519aa09889d6","34a6e49023fc4465bd5ca604330bbd1c",22855139,1,-3,0,1393,295,292,-3
"34a6e49023fc4465bd5ca604330bbd1c","21592f2a9e9c4b2f8c66ec5dbcbf6a2b",22855139,2,5,0,1394,292,296,4
"21592f2a9e9c4b2f8c66ec5dbcbf6a2b","ba0e59461bfb4a44b7b1c28a01f8d3b3",22855139,2,4,0,1395,296,299,3
"ba0e59461bfb4a44b7b1c28a01f8d3b3","ba0e59461bfb4a44b7b1c28a01f8d3b3",22855139,1,0,1,1396,299,299,0
"ba0e59461bfb4a44b7b1c28a01f8d3b3","0e0b36e731a645e7b1b8a88f5031ca38",22855139,2,2,0,1397,299,301,2
"0e0b36e731a645e7b1b8a88f5031ca38","0e0b36e731a645e7b1b8a88f5031ca38",22855139,10,0,1,1398,301,301,0
"0e0b36e731a645e7b1b8a88f5031ca38","a66a144637284c21afc6de17fea4bfb8",22855139,1,1,0,1408,301,302,1
"a66a144637284c21afc6de17fea4bfb8","a66a144637284c21afc6de17fea4bfb8",22855139,2,0,1,1409,302,302,0
"a66a144637284c21afc6de17fea4bfb8","7646a919d7e64fa990bca9b024ff089d",22855139,1,-4,0,1411,302,298,-4
"7646a919d7e64fa990bca9b024ff089d","e390b575229748ea8aac9364efe2bf00",22855139,1,7,0,1412,298,304,6
"e390b575229748ea8aac9364efe2bf00","e390b575229748ea8aac9364efe2bf00",22855139,1,0,1,1413,304,304,0
"e390b575229748ea8aac9364efe2bf00","4a29443515bb404cb8924e1c60a63b73",22855139,1,-24,0,1414,304,285,-19
"4a29443515bb404cb8924e1c60a63b73","3434c10e561d488a914e0f7d71907abd",22855139,6,27,0,1415,285,305,20
"3434c10e561d488a914e0f7d71907abd","53e7e900392747ccad52e711ab0f80d8",22855139,6,2,0,1416,305,307,2
"53e7e900392747ccad52e711ab0f80d8","53e7e900392747ccad52e711ab0f80d8",22855139,2,0,1,1417,307,307,0
"53e7e900392747ccad52e711ab0f80d8","3434c10e561d488a914e0f7d71907abd",22855139,6,-2,0,1418,307,305,-2
"3434c10e561d488a914e0f7d71907abd","130acc2aeb0448fdbb2de63bc5cebe5b",22855139,4,5,0,1419,305,309,4
"130acc2aeb0448fdbb2de63bc5cebe5b","3434c10e561d488a914e0f7d71907abd",22855139,2,-5,0,1420,309,305,-4
"3434c10e561d488a914e0f7d71907abd","3434c10e561d488a914e0f7d71907abd",22855139,1,0,1,1421,305,305,0
"130acc2aeb0448fdbb2de63bc5cebe5b","141c0df6cd1946539aadd1c9b7068cd4",22855139,2,-1,0,1426,309,308,-1
"141c0df6cd1946539aadd1c9b7068cd4","53e7e900392747ccad52e711ab0f80d8",22855139,2,-2,0,1427,308,307,-1
"130acc2aeb0448fdbb2de63bc5cebe5b","130acc2aeb0448fdbb2de63bc5cebe5b",22855139,1,0,1,1430,309,309,0
"130acc2aeb0448fdbb2de63bc5cebe5b","9c062b3251034ebe90f5054e2a3b5120",22855139,1,2,0,1431,309,311,2
"9c062b3251034ebe90f5054e2a3b5120","9c062b3251034ebe90f5054e2a3b5120",22855139,8,0,1,1432,311,311,0
"9c062b3251034ebe90f5054e2a3b5120","ea859f8207e44537889daeaba13ac2e8",22855139,1,1,0,1440,311,312,1
"ea859f8207e44537889daeaba13ac2e8","ea859f8207e44537889daeaba13ac2e8",22855139,9,0,1,1441,312,312,0
"ea859f8207e44537889daeaba13ac2e8","56d94971a7a94257aa330183a8ebd0ea",22855139,2,1,0,1450,312,313,1
"56d94971a7a94257aa330183a8ebd0ea","56d94971a7a94257aa330183a8ebd0ea",22855139,9,0,1,1451,313,313,0
"56d94971a7a94257aa330183a8ebd0ea","141c0df6cd1946539aadd1c9b7068cd4",22855139,2,-5,0,1460,313,308,-5
"141c0df6cd1946539aadd1c9b7068cd4","0c787d16c9504873b1a4d903cec09948",22855139,1,7,0,1461,308,314,6
"0c787d16c9504873b1a4d903cec09948","53e7e900392747ccad52e711ab0f80d8",22855139,1,-9,0,1462,314,307,-7
"53e7e900392747ccad52e711ab0f80d8","4a29443515bb404cb8924e1c60a63b73",22855139,1,-29,0,1463,307,285,-22
"3434c10e561d488a914e0f7d71907abd","4a29443515bb404cb8924e1c60a63b73",22855139,2,-27,0,1465,305,285,-20
"3434c10e561d488a914e0f7d71907abd","13255e63e0aa4abf85e5211bf613d43e",22855139,1,14,0,1477,305,317,12
"13255e63e0aa4abf85e5211bf613d43e","13255e63e0aa4abf85e5211bf613d43e",22855139,1,0,1,1478,317,317,0
"13255e63e0aa4abf85e5211bf613d43e","0c787d16c9504873b1a4d903cec09948",22855139,1,-3,0,1479,317,314,-3
"0c787d16c9504873b1a4d903cec09948","86c27d40179e419c8e9d150fb6afa5d0",22855139,1,6,0,1480,314,319,5
"86c27d40179e419c8e9d150fb6afa5d0","86c27d40179e419c8e9d150fb6afa5d0",22855139,1,0,1,1481,319,319,0
"86c27d40179e419c8e9d150fb6afa5d0","8d7e0b55cf9849cda222a0f2440cec55",22855139,2,-1,0,1482,319,318,-1
"8d7e0b55cf9849cda222a0f2440cec55","47edbb64109243e6b0f8f64cdef90c6c",22855139,1,9,0,1483,318,326,8
"47edbb64109243e6b0f8f64cdef90c6c","24f1363179ad4aaa965484a78471912b",22855139,3,-3,0,1484,326,323,-3
"24f1363179ad4aaa965484a78471912b","24f1363179ad4aaa965484a78471912b",22855139,1,0,1,1485,323,323,0
"24f1363179ad4aaa965484a78471912b","3434c10e561d488a914e0f7d71907abd",22855139,2,-22,0,1486,323,305,-18
"3434c10e561d488a914e0f7d71907abd","47edbb64109243e6b0f8f64cdef90c6c",22855139,1,25,0,1487,305,326,21
"53e7e900392747ccad52e711ab0f80d8","6e83e23f56544a19b94067c1c558d9c0",22855139,1,-83,0,1491,307,247,-60
"2ae94c0cea4d480a9d5dca8fb1d7b542","30c9ba177afc49a695625d2bdec40207",22855139,1,9,0,1493,242,250,8
"30c9ba177afc49a695625d2bdec40207","30c9ba177afc49a695625d2bdec40207",22855139,2,0,1,1494,250,250,0
"30c9ba177afc49a695625d2bdec40207","6e83e23f56544a19b94067c1c558d9c0",22855139,1,-3,0,1496,250,247,-3
"00f61990949545828dd12f1303d47504","3434c10e561d488a914e0f7d71907abd",22855139,1,70,0,1498,256,305,49
"3434c10e561d488a914e0f7d71907abd","43ea1b823a4b4e51b7c694c10725db82",22855139,2,27,0,1499,305,327,22
"43ea1b823a4b4e51b7c694c10725db82","43ea1b823a4b4e51b7c694c10725db82",22855139,1,0,1,1500,327,327,0
"43ea1b823a4b4e51b7c694c10725db82","47edbb64109243e6b0f8f64cdef90c6c",22855139,1,-2,0,1501,327,326,-1
"24f1363179ad4aaa965484a78471912b","86c27d40179e419c8e9d150fb6afa5d0",22855139,1,-5,0,1503,323,319,-4
"86c27d40179e419c8e9d150fb6afa5d0","3628bdce1dd2429ba924d2d4d09448d2",22855139,1,4,0,1504,319,322,3
"3628bdce1dd2429ba924d2d4d09448d2","3434c10e561d488a914e0f7d71907abd",22855139,1,-21,0,1505,322,305,-17
"43ea1b823a4b4e51b7c694c10725db82","86c27d40179e419c8e9d150fb6afa5d0",22855139,1,-10,0,1507,327,319,-8
"8d7e0b55cf9849cda222a0f2440cec55","24f1363179ad4aaa965484a78471912b",22855139,3,6,0,1509,318,323,5
"24f1363179ad4aaa965484a78471912b","47edbb64109243e6b0f8f64cdef90c6c",22855139,1,3,0,1510,323,326,3
"47edbb64109243e6b0f8f64cdef90c6c","8d7e0b55cf9849cda222a0f2440cec55",22855139,3,-9,0,1511,326,318,-8
"8d7e0b55cf9849cda222a0f2440cec55","56b3fd1a212a4764be39d979fde3326e",22855139,1,12,0,1512,318,328,10
"56b3fd1a212a4764be39d979fde3326e","56b3fd1a212a4764be39d979fde3326e",22855139,1,0,1,1513,328,328,0
"56b3fd1a212a4764be39d979fde3326e","3434c10e561d488a914e0f7d71907abd",22855139,1,-28,0,1514,328,305,-23
"3434c10e561d488a914e0f7d71907abd","0c4079457ede49e3aeb5e86ed84bdf35",22855139,1,31,0,1515,305,329,24
"0c4079457ede49e3aeb5e86ed84bdf35","38aea304b4fa46e1b29bb72f5cea4c93",22855139,4,2,0,1516,329,331,2
"38aea304b4fa46e1b29bb72f5cea4c93","0c4079457ede49e3aeb5e86ed84bdf35",22855139,3,-2,0,1517,331,329,-2
"0c4079457ede49e3aeb5e86ed84bdf35","0c4079457ede49e3aeb5e86ed84bdf35",22855139,2,0,1,1518,329,329,0
"38aea304b4fa46e1b29bb72f5cea4c93","38aea304b4fa46e1b29bb72f5cea4c93",22855139,1,0,1,1520,331,331,0
"38aea304b4fa46e1b29bb72f5cea4c93","e36d261332f14e79bb4b467aceaeb9b5",22855139,1,2,0,1521,331,333,2
"e36d261332f14e79bb4b467aceaeb9b5","e36d261332f14e79bb4b467aceaeb9b5",22855139,5,0,1,1522,333,333,0
"e36d261332f14e79bb4b467aceaeb9b5","c7e89b9d04744d2eab742fc24e3ef1ae",22855139,1,1,0,1527,333,334,1
"c7e89b9d04744d2eab742fc24e3ef1ae","c7e89b9d04744d2eab742fc24e3ef1ae",22855139,6,0,1,1528,334,334,0
"c7e89b9d04744d2eab742fc24e3ef1ae","fe49f8054b374a0ea4bb266ed135ff62",22855139,1,1,0,1534,334,335,1
"fe49f8054b374a0ea4bb266ed135ff62","fe49f8054b374a0ea4bb266ed135ff62",22855139,5,0,1,1535,335,335,0
"fe49f8054b374a0ea4bb266ed135ff62","d0a8f74af98642fe8360d22c42e45117",22855139,1,1,0,1540,335,336,1
"d0a8f74af98642fe8360d22c42e45117","d0a8f74af98642fe8360d22c42e45117",22855139,2,0,1,1541,336,336,0
"d0a8f74af98642fe8360d22c42e45117","0c4079457ede49e3aeb5e86ed84bdf35",22855139,1,-7,0,1543,336,329,-7
"0c4079457ede49e3aeb5e86ed84bdf35","a7c6339ca1da4368a18d471f0519f877",22855139,1,11,0,1544,329,339,10
"a7c6339ca1da4368a18d471f0519f877","a7c6339ca1da4368a18d471f0519f877",22855139,1,0,1,1545,339,339,0
"a7c6339ca1da4368a18d471f0519f877","bbc5139ca9024389a94db3a6f47dcff6",22855139,1,3,0,1546,339,341,2
"bbc5139ca9024389a94db3a6f47dcff6","b8b9418ab322418d9db9b40d96af873a",22855139,2,-5,0,1547,341,337,-4
"b8b9418ab322418d9db9b40d96af873a","bbc5139ca9024389a94db3a6f47dcff6",22855139,1,5,0,1548,337,341,4
"bbc5139ca9024389a94db3a6f47dcff6","4ee6ca9019ab4a1ab323f98094a9bd77",22855139,1,2,0,1549,341,343,2
"4ee6ca9019ab4a1ab323f98094a9bd77","4ee6ca9019ab4a1ab323f98094a9bd77",22855139,2,0,1,1550,343,343,0
"4ee6ca9019ab4a1ab323f98094a9bd77","b37947176785476f8b29d49a851366dc",22855139,1,1,0,1552,343,344,1
"b37947176785476f8b29d49a851366dc","b37947176785476f8b29d49a851366dc",22855139,2,0,1,1553,344,344,0
"b37947176785476f8b29d49a851366dc","fcea5b10d5a14a3b9324ffece8f6e1e5",22855139,1,1,0,1555,344,345,1
"fcea5b10d5a14a3b9324ffece8f6e1e5","fcea5b10d5a14a3b9324ffece8f6e1e5",22855139,2,0,1,1556,345,345,0
"fcea5b10d5a14a3b9324ffece8f6e1e5","c2490bc612d146edbe786556fab3651b",22855139,1,-5,0,1558,345,340,-5
"c2490bc612d146edbe786556fab3651b","4a92daef4d504e1792575a26502bb7b7",22855139,1,7,0,1559,340,346,6
"4a92daef4d504e1792575a26502bb7b7","bbc5139ca9024389a94db3a6f47dcff6",22855139,1,-6,0,1560,346,341,-5
"bbc5139ca9024389a94db3a6f47dcff6","c2490bc612d146edbe786556fab3651b",22855139,2,-1,0,1561,341,340,-1
"c2490bc612d146edbe786556fab3651b","0c4079457ede49e3aeb5e86ed84bdf35",22855139,1,-13,0,1562,340,329,-11
"0c4079457ede49e3aeb5e86ed84bdf35","bbc5139ca9024389a94db3a6f47dcff6",22855139,2,14,0,1565,329,341,12
"bbc5139ca9024389a94db3a6f47dcff6","bbc5139ca9024389a94db3a6f47dcff6",22855139,1,0,1,1566,341,341,0
"c2490bc612d146edbe786556fab3651b","6ac8bb048b854999a47edb35fe627f11",22855139,1,8,0,1568,340,347,7
"6ac8bb048b854999a47edb35fe627f11","6ac8bb048b854999a47edb35fe627f11",22855139,1,0,1,1569,347,347,0
"6ac8bb048b854999a47edb35fe627f11","0c4079457ede49e3aeb5e86ed84bdf35",22855139,1,-21,0,1570,347,329,-18
"0c4079457ede49e3aeb5e86ed84bdf35","30ead9794d4847abaf222ca966cc8630",22855139,1,24,0,1571,329,348,19
"30ead9794d4847abaf222ca966cc8630","eff0de7f2dbb42dfa1a2e686efab5b6d",22855139,2,6,0,1572,348,354,6
"eff0de7f2dbb42dfa1a2e686efab5b6d","c20993c944444fe085345591a8bd837e",22855139,6,-3,0,1573,354,351,-3
"c20993c944444fe085345591a8bd837e","09b9678ddc3d452ea4a3d46e15826065",22855139,4,2,0,1574,351,353,2
"09b9678ddc3d452ea4a3d46e15826065","897b7f51242c44aab2205c72fdcbf4cd",22855139,2,-1,0,1575,353,352,-1
"897b7f51242c44aab2205c72fdcbf4cd","4a29443515bb404cb8924e1c60a63b73",22855139,1,-86,0,1576,352,285,-67
"4a29443515bb404cb8924e1c60a63b73","30ead9794d4847abaf222ca966cc8630",22855139,2,82,0,1577,285,348,63
"30ead9794d4847abaf222ca966cc8630","30ead9794d4847abaf222ca966cc8630",22855139,2,0,1,1578,348,348,0
"30ead9794d4847abaf222ca966cc8630","c20993c944444fe085345591a8bd837e",22855139,2,3,0,1579,348,351,3
"c20993c944444fe085345591a8bd837e","897b7f51242c44aab2205c72fdcbf4cd",22855139,7,1,0,1580,351,352,1
"897b7f51242c44aab2205c72fdcbf4cd","09b9678ddc3d452ea4a3d46e15826065",22855139,2,1,0,1581,352,353,1
"09b9678ddc3d452ea4a3d46e15826065","eff0de7f2dbb42dfa1a2e686efab5b6d",22855139,5,1,0,1582,353,354,1
"c20993c944444fe085345591a8bd837e","c20993c944444fe085345591a8bd837e",22855139,7,0,1,1584,351,351,0
"897b7f51242c44aab2205c72fdcbf4cd","897b7f51242c44aab2205c72fdcbf4cd",22855139,8,0,1,1588,352,352,0
"09b9678ddc3d452ea4a3d46e15826065","09b9678ddc3d452ea4a3d46e15826065",22855139,8,0,1,1592,353,353,0
"eff0de7f2dbb42dfa1a2e686efab5b6d","eff0de7f2dbb42dfa1a2e686efab5b6d",22855139,6,0,1,1596,354,354,0
"eff0de7f2dbb42dfa1a2e686efab5b6d","30ead9794d4847abaf222ca966cc8630",22855139,1,-6,0,1599,354,348,-6
"30ead9794d4847abaf222ca966cc8630","2fe14166dc9642c3bc666b86a57f943d",22855139,1,10,0,1600,348,357,9
"2fe14166dc9642c3bc666b86a57f943d","2fe14166dc9642c3bc666b86a57f943d",22855139,1,0,1,1601,357,357,0
"2fe14166dc9642c3bc666b86a57f943d","44421dd1e13a47a388c4a19834b744c7",22855139,1,2,0,1602,357,359,2
"44421dd1e13a47a388c4a19834b744c7","44421dd1e13a47a388c4a19834b744c7",22855139,2,0,1,1603,359,359,0
"44421dd1e13a47a388c4a19834b744c7","cb5fc7ef85d547c4be1a7439d0bf6052",22855139,1,1,0,1605,359,360,1
"cb5fc7ef85d547c4be1a7439d0bf6052","cb5fc7ef85d547c4be1a7439d0bf6052",22855139,2,0,1,1606,360,360,0
"cb5fc7ef85d547c4be1a7439d0bf6052","0a8f150a4cf747acbde62f4721823da3",22855139,1,1,0,1608,360,361,1
"0a8f150a4cf747acbde62f4721823da3","0a8f150a4cf747acbde62f4721823da3",22855139,2,0,1,1609,361,361,0
"0a8f150a4cf747acbde62f4721823da3","ab8fdad974ae471f9f24c3f9dd04462e",22855139,1,1,0,1611,361,362,1
"ab8fdad974ae471f9f24c3f9dd04462e","ab8fdad974ae471f9f24c3f9dd04462e",22855139,2,0,1,1612,362,362,0
"ab8fdad974ae471f9f24c3f9dd04462e","1ba8fef685d74a8194b9db252eb704fb",22855139,1,-7,0,1614,362,355,-7
"1ba8fef685d74a8194b9db252eb704fb","52580888dadb4fe3baa795683ea227bd",22855139,2,10,0,1615,355,364,9
"52580888dadb4fe3baa795683ea227bd","f00179e251a045b39c3f7a54f9aa4acc",22855139,1,-1,0,1616,364,363,-1
"f00179e251a045b39c3f7a54f9aa4acc","2fe14166dc9642c3bc666b86a57f943d",22855139,1,-7,0,1617,363,357,-6
"2fe14166dc9642c3bc666b86a57f943d","30ead9794d4847abaf222ca966cc8630",22855139,3,-10,0,1618,357,348,-9
"eff0de7f2dbb42dfa1a2e686efab5b6d","897b7f51242c44aab2205c72fdcbf4cd",22855139,1,-2,0,1622,354,352,-2
"897b7f51242c44aab2205c72fdcbf4cd","eff0de7f2dbb42dfa1a2e686efab5b6d",22855139,5,2,0,1623,352,354,2
"eff0de7f2dbb42dfa1a2e686efab5b6d","09b9678ddc3d452ea4a3d46e15826065",22855139,3,-1,0,1625,354,353,-1
"09b9678ddc3d452ea4a3d46e15826065","c20993c944444fe085345591a8bd837e",22855139,1,-2,0,1627,353,351,-2
"897b7f51242c44aab2205c72fdcbf4cd","2fe14166dc9642c3bc666b86a57f943d",22855139,1,6,0,1631,352,357,5
"30ead9794d4847abaf222ca966cc8630","1ba8fef685d74a8194b9db252eb704fb",22855139,1,8,0,1633,348,355,7
"52580888dadb4fe3baa795683ea227bd","52580888dadb4fe3baa795683ea227bd",22855139,1,0,1,1635,364,364,0
"52580888dadb4fe3baa795683ea227bd","492a3bc6a1254f23a7998587961b22a4",22855139,1,3,0,1636,364,366,2
"492a3bc6a1254f23a7998587961b22a4","f00179e251a045b39c3f7a54f9aa4acc",22855139,2,-4,0,1637,366,363,-3
"f00179e251a045b39c3f7a54f9aa4acc","492a3bc6a1254f23a7998587961b22a4",22855139,1,4,0,1638,363,366,3
"492a3bc6a1254f23a7998587961b22a4","072a190fd302456290895f9f04d6940a",22855139,1,-1,0,1639,366,365,-1
"072a190fd302456290895f9f04d6940a","c76574d21bc14aeea7ecd0b027f39858",22855139,1,3,0,1640,365,367,2
"c76574d21bc14aeea7ecd0b027f39858","c20993c944444fe085345591a8bd837e",22855139,1,-20,0,1641,367,351,-16
"09b9678ddc3d452ea4a3d46e15826065","30ead9794d4847abaf222ca966cc8630",22855139,1,-5,0,1653,353,348,-5
"30ead9794d4847abaf222ca966cc8630","cfa457d1743848e4bb5e4beced6448ed",22855139,1,25,0,1654,348,369,21
"cfa457d1743848e4bb5e4beced6448ed","cfa457d1743848e4bb5e4beced6448ed",22855139,1,0,1,1655,369,369,0
"cfa457d1743848e4bb5e4beced6448ed","30ead9794d4847abaf222ca966cc8630",22855139,1,-25,0,1656,369,348,-21
"30ead9794d4847abaf222ca966cc8630","b71bac264efb4abd97015447bd490db6",22855139,2,28,0,1657,348,370,22
"b71bac264efb4abd97015447bd490db6","4a29443515bb404cb8924e1c60a63b73",22855139,3,-110,0,1658,370,285,-85
"4a29443515bb404cb8924e1c60a63b73","b71bac264efb4abd97015447bd490db6",22855139,5,110,0,1659,285,370,85
"b71bac264efb4abd97015447bd490db6","b71bac264efb4abd97015447bd490db6",22855139,4,0,1,1660,370,370,0
"b71bac264efb4abd97015447bd490db6","bc5524e78a8544e2ae2fdc2f3462bbec",22855139,1,-123,0,1661,370,279,-91
"bc5524e78a8544e2ae2fdc2f3462bbec","0d987bed3ffa4ed0b9a2e62e97b7b30f",22855139,1,-9,0,1662,279,272,-7
"bb5a47f5ea01454a8b79455422d3b9da","b71bac264efb4abd97015447bd490db6",22855139,1,122,0,1673,280,370,90
"897b7f51242c44aab2205c72fdcbf4cd","c20993c944444fe085345591a8bd837e",22855139,1,-1,0,1687,352,351,-1
"eff0de7f2dbb42dfa1a2e686efab5b6d","4a29443515bb404cb8924e1c60a63b73",22855139,1,-88,0,1692,354,285,-69
"4a29443515bb404cb8924e1c60a63b73","0c4079457ede49e3aeb5e86ed84bdf35",22855139,1,58,0,1693,285,329,44
"38aea304b4fa46e1b29bb72f5cea4c93","4a29443515bb404cb8924e1c60a63b73",22855139,1,-60,0,1696,331,285,-46
"b71bac264efb4abd97015447bd490db6","8d448d625b024c82a5eb240bbd7431d6",22855139,15,5,0,1699,370,374,4
"8d448d625b024c82a5eb240bbd7431d6","8d448d625b024c82a5eb240bbd7431d6",22855139,161,0,1,1700,374,374,0
"8d448d625b024c82a5eb240bbd7431d6","b71bac264efb4abd97015447bd490db6",22855139,9,-5,0,1702,374,370,-4
"8d448d625b024c82a5eb240bbd7431d6","d6d02b6ef04e4f17805504500b8ce441",22855139,8,3,0,1751,374,375,1
"d6d02b6ef04e4f17805504500b8ce441","b71bac264efb4abd97015447bd490db6",22855139,16,-8,0,1752,375,370,-5
"b71bac264efb4abd97015447bd490db6","d6d02b6ef04e4f17805504500b8ce441",22855139,16,8,0,1753,370,375,5
"4a29443515bb404cb8924e1c60a63b73","2c5bb2cbd0014420ad8c95d40e38efd1",22855139,1,23,0,1755,285,303,18
"2c5bb2cbd0014420ad8c95d40e38efd1","4a29443515bb404cb8924e1c60a63b73",22855139,1,-23,0,1756,303,285,-18
"3434c10e561d488a914e0f7d71907abd","8d7e0b55cf9849cda222a0f2440cec55",22855139,1,16,0,1759,305,318,13
"8d7e0b55cf9849cda222a0f2440cec55","86c27d40179e419c8e9d150fb6afa5d0",22855139,1,1,0,1760,318,319,1
"86c27d40179e419c8e9d150fb6afa5d0","47edbb64109243e6b0f8f64cdef90c6c",22855139,1,8,0,1761,319,326,7
"24f1363179ad4aaa965484a78471912b","4a29443515bb404cb8924e1c60a63b73",22855139,1,-49,0,1764,323,285,-38
"4a29443515bb404cb8924e1c60a63b73","d6d02b6ef04e4f17805504500b8ce441",22855139,5,118,0,1765,285,375,90
"d6d02b6ef04e4f17805504500b8ce441","8d448d625b024c82a5eb240bbd7431d6",22855139,3,-3,0,1796,375,374,-1
"8d448d625b024c82a5eb240bbd7431d6","4a29443515bb404cb8924e1c60a63b73",22855139,3,-115,0,1804,374,285,-89
"4a29443515bb404cb8924e1c60a63b73","1b4550d0dab04078b3bf08a655345bdc",22855139,2,114,0,1805,285,373,88
"1b4550d0dab04078b3bf08a655345bdc","b71bac264efb4abd97015447bd490db6",22855139,3,-4,0,1806,373,370,-3
"b71bac264efb4abd97015447bd490db6","1b4550d0dab04078b3bf08a655345bdc",22855139,2,4,0,1832,370,373,3
"1b4550d0dab04078b3bf08a655345bdc","8d448d625b024c82a5eb240bbd7431d6",22855139,2,1,0,1833,373,374,1
"d6d02b6ef04e4f17805504500b8ce441","66baf19b6b904b70922329068c63746d",22855139,5,4,0,1937,375,376,1
"66baf19b6b904b70922329068c63746d","7f544639412e40a9ba27f43b415362ab",22855139,8,2,0,1938,376,378,2
"7f544639412e40a9ba27f43b415362ab","d6d02b6ef04e4f17805504500b8ce441",22855139,1,-6,0,1939,378,375,-3
"7f544639412e40a9ba27f43b415362ab","7f544639412e40a9ba27f43b415362ab",22855139,1,0,1,1944,378,378,0
"7f544639412e40a9ba27f43b415362ab","d5ae8642e15b46b8bd298b02274d4e9c",22855139,2,2,0,1945,378,380,2
"d5ae8642e15b46b8bd298b02274d4e9c","d5ae8642e15b46b8bd298b02274d4e9c",22855139,1,0,1,1946,380,380,0
"d5ae8642e15b46b8bd298b02274d4e9c","a0d10309a2dd456289147f84be9d37f9",22855139,1,1,0,1947,380,381,1
"a0d10309a2dd456289147f84be9d37f9","a0d10309a2dd456289147f84be9d37f9",22855139,2,0,1,1948,381,381,0
"a0d10309a2dd456289147f84be9d37f9","0fcbc3ca07b144138b8d85da581f09a8",22855139,1,1,0,1950,381,382,1
"0fcbc3ca07b144138b8d85da581f09a8","0fcbc3ca07b144138b8d85da581f09a8",22855139,9,0,1,1951,382,382,0
"0fcbc3ca07b144138b8d85da581f09a8","66baf19b6b904b70922329068c63746d",22855139,1,-6,0,1960,382,376,-6
"66baf19b6b904b70922329068c63746d","c2fca3669923477ab966ded303dea31c",22855139,2,8,0,1961,376,383,7
"c2fca3669923477ab966ded303dea31c","7f544639412e40a9ba27f43b415362ab",22855139,1,-6,0,1962,383,378,-5
"7f544639412e40a9ba27f43b415362ab","66baf19b6b904b70922329068c63746d",22855139,5,-2,0,1963,378,376,-2
"66baf19b6b904b70922329068c63746d","66baf19b6b904b70922329068c63746d",22855139,7,0,1,1964,376,376,0
"66baf19b6b904b70922329068c63746d","1b4550d0dab04078b3bf08a655345bdc",22855139,1,-8,0,1965,376,373,-3
"c2fca3669923477ab966ded303dea31c","4890121ce5d74576b4632b77cfc23398",22855139,1,6,0,1984,383,388,5
"4890121ce5d74576b4632b77cfc23398","4890121ce5d74576b4632b77cfc23398",22855139,1,0,1,1985,388,388,0
"4890121ce5d74576b4632b77cfc23398","18d3b836dd804224883cc9180b60a8e1",22855139,1,-1,0,1986,388,387,-1
"18d3b836dd804224883cc9180b60a8e1","96bb2b3e85a34d8b9544514e89f6fe97",22855139,2,4,0,1987,387,390,3
"96bb2b3e85a34d8b9544514e89f6fe97","96bb2b3e85a34d8b9544514e89f6fe97",22855139,1,0,1,1988,390,390,0
"96bb2b3e85a34d8b9544514e89f6fe97","66baf19b6b904b70922329068c63746d",22855139,1,-17,0,1989,390,376,-14
"66baf19b6b904b70922329068c63746d","96bb2b3e85a34d8b9544514e89f6fe97",22855139,1,17,0,1994,376,390,14
"96bb2b3e85a34d8b9544514e89f6fe97","ac4e9b54acfe4670b4634859c7263cb5",22855139,1,2,0,1995,390,392,2
"ac4e9b54acfe4670b4634859c7263cb5","ac4e9b54acfe4670b4634859c7263cb5",22855139,1,0,1,1996,392,392,0
"ac4e9b54acfe4670b4634859c7263cb5","17f95d18bab743888e1736033dc3384d",22855139,1,-3,0,1997,392,389,-3
"17f95d18bab743888e1736033dc3384d","6f8881a745ac4c358a68b92c3b4abe81",22855139,2,6,0,1998,389,394,5
"6f8881a745ac4c358a68b92c3b4abe81","6f8881a745ac4c358a68b92c3b4abe81",22855139,1,0,1,1999,394,394,0
"6f8881a745ac4c358a68b92c3b4abe81","f7002c8484354eceac57bc7bd62c76c1",22855139,2,-1,0,2000,394,393,-1
"f7002c8484354eceac57bc7bd62c76c1","44a277ea44dc4ae689fab4b82f0b4098",22855139,1,5,0,2001,393,397,4
"44a277ea44dc4ae689fab4b82f0b4098","44a277ea44dc4ae689fab4b82f0b4098",22855139,1,0,1,2002,397,397,0
"44a277ea44dc4ae689fab4b82f0b4098","0c12af0a4e7f4002852cf84b2537c161",22855139,1,-2,0,2003,397,395,-2
"0c12af0a4e7f4002852cf84b2537c161","859e0b8d71694b12befb69ee698138f9",22855139,1,5,0,2004,395,399,4
"859e0b8d71694b12befb69ee698138f9","859e0b8d71694b12befb69ee698138f9",22855139,1,0,1,2005,399,399,0
"859e0b8d71694b12befb69ee698138f9","2b09a08242b54983aec7063990fb3f66",22855139,1,3,0,2006,399,400,1
"2b09a08242b54983aec7063990fb3f66","66baf19b6b904b70922329068c63746d",22855139,3,-32,0,2007,400,376,-24
"66baf19b6b904b70922329068c63746d","2b09a08242b54983aec7063990fb3f66",22855139,4,32,0,2008,376,400,24
"2b09a08242b54983aec7063990fb3f66","2b09a08242b54983aec7063990fb3f66",22855139,13,0,1,2009,400,400,0
"2b09a08242b54983aec7063990fb3f66","1f471b7a883a4df48211e8c6a81b59a7",22855139,2,1,0,2010,400,401,1
"1f471b7a883a4df48211e8c6a81b59a7","1f471b7a883a4df48211e8c6a81b59a7",22855139,3,0,1,2011,401,401,0
"1f471b7a883a4df48211e8c6a81b59a7","66baf19b6b904b70922329068c63746d",22855139,1,-33,0,2014,401,376,-25
"2b09a08242b54983aec7063990fb3f66","9de0d567bfa84fe5b77cb76f4a76a5d1",22855139,1,5,0,2021,400,404,4
"9de0d567bfa84fe5b77cb76f4a76a5d1","9de0d567bfa84fe5b77cb76f4a76a5d1",22855139,1,0,1,2022,404,404,0
"9de0d567bfa84fe5b77cb76f4a76a5d1","1157bd665ec4472fb58b751dc5099355",22855139,1,-1,0,2023,404,403,-1
"1157bd665ec4472fb58b751dc5099355","2b09a08242b54983aec7063990fb3f66",22855139,1,-4,0,2024,403,400,-3
"2b09a08242b54983aec7063990fb3f66","3c8a22d2f9c146ea956609e3ed4f2559",22855139,2,7,0,2025,400,405,5
"3c8a22d2f9c146ea956609e3ed4f2559","2b09a08242b54983aec7063990fb3f66",22855139,2,-7,0,2026,405,400,-5
"2b09a08242b54983aec7063990fb3f66","d6d02b6ef04e4f17805504500b8ce441",22855139,2,-36,0,2033,400,375,-25
"4a29443515bb404cb8924e1c60a63b73","2b09a08242b54983aec7063990fb3f66",22855139,1,154,0,2060,285,400,115
"1f471b7a883a4df48211e8c6a81b59a7","2b09a08242b54983aec7063990fb3f66",22855139,1,-1,0,2064,401,400,-1
"d6d02b6ef04e4f17805504500b8ce441","3c8a22d2f9c146ea956609e3ed4f2559",22855139,1,43,0,2071,375,405,30
"3c8a22d2f9c146ea956609e3ed4f2559","58fc9094275e4c49be3f4ba6d4acc0a4",22855139,2,2,0,2074,405,406,1
"58fc9094275e4c49be3f4ba6d4acc0a4","58fc9094275e4c49be3f4ba6d4acc0a4",22855139,2,0,1,2075,406,406,0
"58fc9094275e4c49be3f4ba6d4acc0a4","c1c1be90b2b14c1ab4a5e1ee3c241902",22855139,1,1,0,2076,406,407,1
"c1c1be90b2b14c1ab4a5e1ee3c241902","c1c1be90b2b14c1ab4a5e1ee3c241902",22855139,5,0,1,2077,407,407,0
"c1c1be90b2b14c1ab4a5e1ee3c241902","58fc9094275e4c49be3f4ba6d4acc0a4",22855139,1,-1,0,2082,407,406,-1
"58fc9094275e4c49be3f4ba6d4acc0a4","02b3a1bead9244c1ba2f857c7da8f82a",22855139,2,3,0,2083,406,408,2
"02b3a1bead9244c1ba2f857c7da8f82a","02b3a1bead9244c1ba2f857c7da8f82a",22855139,1,0,1,2084,408,408,0
"02b3a1bead9244c1ba2f857c7da8f82a","6206fc6479014bb193084c32409dc1b9",22855139,3,1,0,2085,408,409,1
"6206fc6479014bb193084c32409dc1b9","6206fc6479014bb193084c32409dc1b9",22855139,9,0,1,2086,409,409,0
"6206fc6479014bb193084c32409dc1b9","02b3a1bead9244c1ba2f857c7da8f82a",22855139,1,-1,0,2095,409,408,-1
"02b3a1bead9244c1ba2f857c7da8f82a","6a5f020451db426dacba9e2ea3fcc62a",22855139,2,3,0,2096,408,410,2
"6a5f020451db426dacba9e2ea3fcc62a","6a5f020451db426dacba9e2ea3fcc62a",22855139,3,0,1,2097,410,410,0
"6a5f020451db426dacba9e2ea3fcc62a","33a9d248b2e44588a5b07fc1342b9bc2",22855139,4,2,0,2099,410,411,1
"33a9d248b2e44588a5b07fc1342b9bc2","66baf19b6b904b70922329068c63746d",22855139,1,-49,0,2100,411,376,-35
"66baf19b6b904b70922329068c63746d","6a5f020451db426dacba9e2ea3fcc62a",22855139,1,47,0,2101,376,410,34
"6a5f020451db426dacba9e2ea3fcc62a","2b09a08242b54983aec7063990fb3f66",22855139,1,-15,0,2102,410,400,-10
"2b09a08242b54983aec7063990fb3f66","6a5f020451db426dacba9e2ea3fcc62a",22855139,1,15,0,2103,400,410,10
"33a9d248b2e44588a5b07fc1342b9bc2","6a5f020451db426dacba9e2ea3fcc62a",22855139,1,-2,0,2106,411,410,-1
"33a9d248b2e44588a5b07fc1342b9bc2","c6f26bd420634f1cb7989e76fe6b16c0",22855139,1,1,0,2108,411,412,1
"c6f26bd420634f1cb7989e76fe6b16c0","c6f26bd420634f1cb7989e76fe6b16c0",22855139,5,0,1,2109,412,412,0
"c6f26bd420634f1cb7989e76fe6b16c0","2a65ee6e2ac64f6a8a55fbe5373ec763",22855139,1,1,0,2114,412,413,1
"2a65ee6e2ac64f6a8a55fbe5373ec763","2a65ee6e2ac64f6a8a55fbe5373ec763",22855139,8,0,1,2115,413,413,0
"2a65ee6e2ac64f6a8a55fbe5373ec763","33a9d248b2e44588a5b07fc1342b9bc2",22855139,1,-2,0,2123,413,411,-2
"33a9d248b2e44588a5b07fc1342b9bc2","2b09a08242b54983aec7063990fb3f66",22855139,2,-17,0,2124,411,400,-11
"2b09a08242b54983aec7063990fb3f66","33a9d248b2e44588a5b07fc1342b9bc2",22855139,2,17,0,2125,400,411,11
"33a9d248b2e44588a5b07fc1342b9bc2","33a9d248b2e44588a5b07fc1342b9bc2",22855139,2,0,1,2128,411,411,0
"33a9d248b2e44588a5b07fc1342b9bc2","1fd0f6dadbc14ebc965faf6122190b96",22855139,1,5,0,2129,411,415,4
"1fd0f6dadbc14ebc965faf6122190b96","1fd0f6dadbc14ebc965faf6122190b96",22855139,1,0,1,2130,415,415,0
"1fd0f6dadbc14ebc965faf6122190b96","687055dad9fc40c3982478fe33ec01bf",22855139,1,-1,0,2131,415,414,-1
"687055dad9fc40c3982478fe33ec01bf","2add1669f08d4101913db15f8c23b3b7",22855139,1,3,0,2132,414,416,2
"2add1669f08d4101913db15f8c23b3b7","2add1669f08d4101913db15f8c23b3b7",22855139,1,0,1,2133,416,416,0
"2add1669f08d4101913db15f8c23b3b7","a2b4bd40cee2481ebd3fc179d6a5cd62",22855139,1,3,0,2134,416,417,1
"a2b4bd40cee2481ebd3fc179d6a5cd62","2b09a08242b54983aec7063990fb3f66",22855139,1,-27,0,2135,417,400,-17
"66baf19b6b904b70922329068c63746d","a2b4bd40cee2481ebd3fc179d6a5cd62",22855139,1,59,0,2137,376,417,41
"a2b4bd40cee2481ebd3fc179d6a5cd62","e34e59dce2204f228f3a84b6725df60f",22855139,1,2,0,2138,417,419,2
"e34e59dce2204f228f3a84b6725df60f","e34e59dce2204f228f3a84b6725df60f",22855139,1,0,1,2139,419,419,0
"e34e59dce2204f228f3a84b6725df60f","bec48fc2e1294c7eb3d0aca780d731b8",22855139,1,2,0,2140,419,420,1
"bec48fc2e1294c7eb3d0aca780d731b8","a2b4bd40cee2481ebd3fc179d6a5cd62",22855139,2,-4,0,2141,420,417,-3
"a2b4bd40cee2481ebd3fc179d6a5cd62","bec48fc2e1294c7eb3d0aca780d731b8",22855139,3,4,0,2142,417,420,3
"bec48fc2e1294c7eb3d0aca780d731b8","bec48fc2e1294c7eb3d0aca780d731b8",22855139,1,0,1,2143,420,420,0
"bec48fc2e1294c7eb3d0aca780d731b8","a24600b0e49245f6bdba8c893cfeddb0",22855139,2,7,0,2144,420,425,5
"a24600b0e49245f6bdba8c893cfeddb0","dbde19fcce2a4c1abdc7f685c293a23f",22855139,3,-4,0,2145,425,422,-3
"dbde19fcce2a4c1abdc7f685c293a23f","a24600b0e49245f6bdba8c893cfeddb0",22855139,3,4,0,2146,422,425,3
"a24600b0e49245f6bdba8c893cfeddb0","a24600b0e49245f6bdba8c893cfeddb0",22855139,2,0,1,2147,425,425,0
"a24600b0e49245f6bdba8c893cfeddb0","a2b4bd40cee2481ebd3fc179d6a5cd62",22855139,1,-11,0,2151,425,417,-8
"a2b4bd40cee2481ebd3fc179d6a5cd62","24cf8786024543f19b89bc20034e60d7",22855139,2,18,0,2152,417,428,11
"24cf8786024543f19b89bc20034e60d7","f2a73be2f46840b182d7bd095378004e",22855139,3,1,0,2153,428,429,1
"f2a73be2f46840b182d7bd095378004e","24cf8786024543f19b89bc20034e60d7",22855139,5,-1,0,2154,429,428,-1
"24cf8786024543f19b89bc20034e60d7","a2b4bd40cee2481ebd3fc179d6a5cd62",22855139,3,-18,0,2155,428,417,-11
"a2b4bd40cee2481ebd3fc179d6a5cd62","f2a73be2f46840b182d7bd095378004e",22855139,2,19,0,2158,417,429,12
"f2a73be2f46840b182d7bd095378004e","f2a73be2f46840b182d7bd095378004e",22855139,2,0,1,2159,429,429,0
"f2a73be2f46840b182d7bd095378004e","604551fd4266430cb860fef58fa7dd61",22855139,1,1,0,2160,429,430,1
"604551fd4266430cb860fef58fa7dd61","604551fd4266430cb860fef58fa7dd61",22855139,7,0,1,2161,430,430,0
"604551fd4266430cb860fef58fa7dd61","24cf8786024543f19b89bc20034e60d7",22855139,1,-2,0,2168,430,428,-2
"24cf8786024543f19b89bc20034e60d7","dce46f8904594a62a6377a3587aaa663",22855139,5,4,0,2169,428,431,3
"dce46f8904594a62a6377a3587aaa663","dce46f8904594a62a6377a3587aaa663",22855139,2,0,1,2170,431,431,0
"dce46f8904594a62a6377a3587aaa663","f2a73be2f46840b182d7bd095378004e",22855139,2,-3,0,2171,431,429,-2
"f2a73be2f46840b182d7bd095378004e","dce46f8904594a62a6377a3587aaa663",22855139,1,3,0,2175,429,431,2
"dce46f8904594a62a6377a3587aaa663","66baf19b6b904b70922329068c63746d",22855139,1,-81,0,2176,431,376,-55
"66baf19b6b904b70922329068c63746d","24cf8786024543f19b89bc20034e60d7",22855139,1,77,0,2177,376,428,52
"24cf8786024543f19b89bc20034e60d7","24cf8786024543f19b89bc20034e60d7",22855139,1,0,1,2178,428,428,0
"dce46f8904594a62a6377a3587aaa663","24cf8786024543f19b89bc20034e60d7",22855139,1,-4,0,2183,431,428,-3
"dce46f8904594a62a6377a3587aaa663","9b9d0a249052413c869753b99682b0ac",22855139,1,1,0,2188,431,432,1
"9b9d0a249052413c869753b99682b0ac","9b9d0a249052413c869753b99682b0ac",22855139,3,0,1,2189,432,432,0
"9b9d0a249052413c869753b99682b0ac","061c175cc90f45fbad883025394e78dd",22855139,1,1,0,2192,432,433,1
"061c175cc90f45fbad883025394e78dd","061c175cc90f45fbad883025394e78dd",22855139,6,0,1,2193,433,433,0
"061c175cc90f45fbad883025394e78dd","dce46f8904594a62a6377a3587aaa663",22855139,2,-2,0,2199,433,431,-2
"dce46f8904594a62a6377a3587aaa663","74a7f8712e5449c2bc0b43c6f90dafed",22855139,1,5,0,2200,431,435,4
"74a7f8712e5449c2bc0b43c6f90dafed","74a7f8712e5449c2bc0b43c6f90dafed",22855139,1,0,1,2201,435,435,0
"74a7f8712e5449c2bc0b43c6f90dafed","66ada10dde9f43018588f1ced9d477fc",22855139,1,-1,0,2202,435,434,-1
"66ada10dde9f43018588f1ced9d477fc","bf12c96466d840a69bed7020b3f18bb8",22855139,1,3,0,2203,434,436,2
"bf12c96466d840a69bed7020b3f18bb8","bf12c96466d840a69bed7020b3f18bb8",22855139,1,0,1,2204,436,436,0
"bf12c96466d840a69bed7020b3f18bb8","24cf8786024543f19b89bc20034e60d7",22855139,1,-11,0,2205,436,428,-8
"24cf8786024543f19b89bc20034e60d7","070600601c4c439288445d2f0724807d",22855139,2,14,0,2206,428,437,9
"070600601c4c439288445d2f0724807d","1823b6de7d334a7aaabc4570719af4d9",22855139,2,2,0,2207,437,439,2
"1823b6de7d334a7aaabc4570719af4d9","1823b6de7d334a7aaabc4570719af4d9",22855139,12,0,1,2208,439,439,0
"1823b6de7d334a7aaabc4570719af4d9","0380cd76a7d44bc3a4da1f15e4d68f89",22855139,1,2,0,2220,439,440,1
"0380cd76a7d44bc3a4da1f15e4d68f89","070600601c4c439288445d2f0724807d",22855139,1,-4,0,2221,440,437,-3
"070600601c4c439288445d2f0724807d","0380cd76a7d44bc3a4da1f15e4d68f89",22855139,2,4,0,2222,437,440,3
"0380cd76a7d44bc3a4da1f15e4d68f89","23b7673c8b5443108c2ef09382834a86",22855139,3,2,0,2223,440,441,1
"23b7673c8b5443108c2ef09382834a86","0380cd76a7d44bc3a4da1f15e4d68f89",22855139,1,-2,0,2224,441,440,-1
"23b7673c8b5443108c2ef09382834a86","901e92500aea43c79f19f1b279050668",22855139,3,2,0,2226,441,442,1
"901e92500aea43c79f19f1b279050668","23b7673c8b5443108c2ef09382834a86",22855139,1,-2,0,2227,442,441,-1
"901e92500aea43c79f19f1b279050668","001339db8ced4cf78829ebe8b145449d",22855139,1,1,0,2229,442,443,1
"001339db8ced4cf78829ebe8b145449d","001339db8ced4cf78829ebe8b145449d",22855139,12,0,1,2230,443,443,0
"001339db8ced4cf78829ebe8b145449d","452745e0366e42ae81561bfddebcc6c3",22855139,1,1,0,2242,443,444,1
"452745e0366e42ae81561bfddebcc6c3","452745e0366e42ae81561bfddebcc6c3",22855139,5,0,1,2243,444,444,0
"452745e0366e42ae81561bfddebcc6c3","901e92500aea43c79f19f1b279050668",22855139,1,-2,0,2248,444,442,-2
"901e92500aea43c79f19f1b279050668","4660ff2089114e8db82ceb26a4f329e3",22855139,2,4,0,2249,442,445,3
"4660ff2089114e8db82ceb26a4f329e3","4660ff2089114e8db82ceb26a4f329e3",22855139,3,0,1,2250,445,445,0
"4660ff2089114e8db82ceb26a4f329e3","7bd5586eb9d8484eb74a433ee7bfe499",22855139,2,2,0,2252,445,446,1
"7bd5586eb9d8484eb74a433ee7bfe499","070600601c4c439288445d2f0724807d",22855139,2,-14,0,2253,446,437,-9
"070600601c4c439288445d2f0724807d","7bd5586eb9d8484eb74a433ee7bfe499",22855139,1,14,0,2254,437,446,9
"7bd5586eb9d8484eb74a433ee7bfe499","7bd5586eb9d8484eb74a433ee7bfe499",22855139,9,0,1,2255,446,446,0
"070600601c4c439288445d2f0724807d","4660ff2089114e8db82ceb26a4f329e3",22855139,1,12,0,2265,437,445,8
"4660ff2089114e8db82ceb26a4f329e3","66baf19b6b904b70922329068c63746d",22855139,1,-103,0,2267,445,376,-69
"66baf19b6b904b70922329068c63746d","8a7f26e690f34dda97be16904518ca99",22855139,1,107,0,2268,376,447,71
"8a7f26e690f34dda97be16904518ca99","070600601c4c439288445d2f0724807d",22855139,1,-16,0,2269,447,437,-10
"070600601c4c439288445d2f0724807d","8a7f26e690f34dda97be16904518ca99",22855139,1,16,0,2270,437,447,10
"8a7f26e690f34dda97be16904518ca99","8a7f26e690f34dda97be16904518ca99",22855139,1,0,1,2271,447,447,0
"8a7f26e690f34dda97be16904518ca99","66baf19b6b904b70922329068c63746d",22855139,1,-107,0,2272,447,376,-71
"66baf19b6b904b70922329068c63746d","b2f0d654738f48158edff28e8d3a546e",22855139,2,112,0,2273,376,449,73
"b2f0d654738f48158edff28e8d3a546e","070600601c4c439288445d2f0724807d",22855139,2,-21,0,2274,449,437,-12
"070600601c4c439288445d2f0724807d","b71bac264efb4abd97015447bd490db6",22855139,1,-103,0,2275,437,370,-67
"7f544639412e40a9ba27f43b415362ab","b2f0d654738f48158edff28e8d3a546e",22855139,1,110,0,2292,378,449,71
"b2f0d654738f48158edff28e8d3a546e","66baf19b6b904b70922329068c63746d",22855139,2,-112,0,2293,449,376,-73
"66baf19b6b904b70922329068c63746d","c5df9f40ec14463b9dcfdc73df3e9285",22855139,1,132,0,2294,376,464,88
"c5df9f40ec14463b9dcfdc73df3e9285","c5df9f40ec14463b9dcfdc73df3e9285",22855139,5,0,1,2295,464,464,0
"c5df9f40ec14463b9dcfdc73df3e9285","83d42d95cd844fc093fc09cee250edb8",22855139,4,3,0,2298,464,465,1
"83d42d95cd844fc093fc09cee250edb8","83d42d95cd844fc093fc09cee250edb8",22855139,11,0,1,2299,465,465,0
"83d42d95cd844fc093fc09cee250edb8","c5df9f40ec14463b9dcfdc73df3e9285",22855139,2,-3,0,2300,465,464,-1
"c5df9f40ec14463b9dcfdc73df3e9285","f67fbf45a5f146ed866965bc57c7c001",22855139,3,-12,0,2303,464,454,-10
"f67fbf45a5f146ed866965bc57c7c001","c5df9f40ec14463b9dcfdc73df3e9285",22855139,4,12,0,2304,454,464,10
"c5df9f40ec14463b9dcfdc73df3e9285","66baf19b6b904b70922329068c63746d",22855139,1,-132,0,2305,464,376,-88
"66baf19b6b904b70922329068c63746d","f67fbf45a5f146ed866965bc57c7c001",22855139,1,120,0,2306,376,454,78
"f67fbf45a5f146ed866965bc57c7c001","f67fbf45a5f146ed866965bc57c7c001",22855139,5,0,1,2307,454,454,0
"f67fbf45a5f146ed866965bc57c7c001","b2f0d654738f48158edff28e8d3a546e",22855139,2,-8,0,2308,454,449,-5
"b2f0d654738f48158edff28e8d3a546e","b2f0d654738f48158edff28e8d3a546e",22855139,2,0,1,2309,449,449,0
"b2f0d654738f48158edff28e8d3a546e","f60ee41ec635499abd48168342d32c2f",22855139,3,5,0,2317,449,453,4
"f60ee41ec635499abd48168342d32c2f","f60ee41ec635499abd48168342d32c2f",22855139,58,0,1,2318,453,453,0
"f60ee41ec635499abd48168342d32c2f","b2f0d654738f48158edff28e8d3a546e",22855139,2,-5,0,2322,453,449,-4
"f60ee41ec635499abd48168342d32c2f","f67fbf45a5f146ed866965bc57c7c001",22855139,1,3,0,2369,453,454,1
"b2f0d654738f48158edff28e8d3a546e","b613861cecf84ffcab01afb23f660475",22855139,1,-632,0,2371,449,1,-448
"b613861cecf84ffcab01afb23f660475","e2911e79efc2420eac45d9f671463d4b",22855139,2,3,0,2374,1,2,1
"e2911e79efc2420eac45d9f671463d4b","56586aa865414f538729c7f7735d2bc6",22855139,3,12,0,2375,2,12,10
"56586aa865414f538729c7f7735d2bc6","e2911e79efc2420eac45d9f671463d4b",22855139,2,-12,0,2376,12,2,-10
"56586aa865414f538729c7f7735d2bc6","56586aa865414f538729c7f7735d2bc6",22855139,5,0,1,2378,12,12,0
"56586aa865414f538729c7f7735d2bc6","b7f2b31585d94eb3bf86376714aa7070",22855139,2,2,0,2379,12,13,1
"b7f2b31585d94eb3bf86376714aa7070","b7f2b31585d94eb3bf86376714aa7070",22855139,2,0,1,2380,13,13,0
"b7f2b31585d94eb3bf86376714aa7070","3f1c815879794b929260d224becaff7e",22855139,1,2,0,2381,13,14,1
"3f1c815879794b929260d224becaff7e","5c5ceeee4562457ba6d41515aeebfbb1",22855139,1,6,0,2382,14,17,3
"5c5ceeee4562457ba6d41515aeebfbb1","81c864a886d54a6b8ff85f7d736f4f95",22855139,2,-4,0,2383,17,15,-2
"81c864a886d54a6b8ff85f7d736f4f95","56586aa865414f538729c7f7735d2bc6",22855139,1,-6,0,2384,15,12,-3
"56586aa865414f538729c7f7735d2bc6","9afd71a5298d4333b6849dfce1b9422c",22855139,2,13,0,2385,12,18,6
"9afd71a5298d4333b6849dfce1b9422c","b7719e26494940efa49512aedd0aac79",22855139,1,4,0,2386,18,20,2
"b7719e26494940efa49512aedd0aac79","9afd71a5298d4333b6849dfce1b9422c",22855139,1,-4,0,2387,20,18,-2
"9afd71a5298d4333b6849dfce1b9422c","d4f45188d3c84a02ba08454e6403a818",22855139,1,9,0,2388,18,24,6
"d4f45188d3c84a02ba08454e6403a818","d4c3b003e8274e429d2fa688d73fde6d",22855139,2,-2,0,2389,24,22,-2
"d4c3b003e8274e429d2fa688d73fde6d","b7719e26494940efa49512aedd0aac79",22855139,2,-3,0,2390,22,20,-2
"b7719e26494940efa49512aedd0aac79","b7719e26494940efa49512aedd0aac79",22855139,1,0,1,2391,20,20,0
"b7719e26494940efa49512aedd0aac79","afbf7250b99d47bea07172749483ca97",22855139,3,12,0,2392,20,28,8
"afbf7250b99d47bea07172749483ca97","afbf7250b99d47bea07172749483ca97",22855139,1,0,1,2393,28,28,0
"afbf7250b99d47bea07172749483ca97","4e51676dc72045d99c19b9fa7b22f8bc",22855139,2,3,0,2394,28,29,1
"4e51676dc72045d99c19b9fa7b22f8bc","4e51676dc72045d99c19b9fa7b22f8bc",22855139,2,0,1,2395,29,29,0
"4e51676dc72045d99c19b9fa7b22f8bc","51970cfa30e643e894e66ae85c8024cc",22855139,2,3,0,2396,29,31,2
"51970cfa30e643e894e66ae85c8024cc","4e51676dc72045d99c19b9fa7b22f8bc",22855139,1,-3,0,2397,31,29,-2
"4e51676dc72045d99c19b9fa7b22f8bc","c33c17be71ae4d588da7369472e5bb1b",22855139,1,9,0,2398,29,34,5
"c33c17be71ae4d588da7369472e5bb1b","93679be414554a11b1893002f2229a93",22855139,4,3,0,2399,34,35,1
"93679be414554a11b1893002f2229a93","c33c17be71ae4d588da7369472e5bb1b",22855139,2,-3,0,2400,35,34,-1
"93679be414554a11b1893002f2229a93","7040a13096d746ac84b8fac8d9752058",22855139,2,3,0,2402,35,36,1
"6e13d61a7bdb44bca949c9f86fab3be5","d0c74f735e024943943e40333d6d337f",22855139,1,5,0,2418,47,51,4
"d9c8d8c444a64dadbbb508652c721e17","f924752d8a1149668870b1e7698486f7",22855139,1,5,0,2420,46,50,4
"a1f2f12debe5432fb7a70bcd12bacfb9","a0a418b8540d479fa6e0f653b701da8b",22855139,1,7,0,2423,58,64,6
"12aa6e1672ac4e7aa6449a7a8609cd72","bc42d26810654ea9a1df1efe1e58c7d5",22855139,1,7,0,2427,57,63,6
"bc42d26810654ea9a1df1efe1e58c7d5","309ccf3cc4fe429d9bfbaef53d3fa479",22855139,1,-3,0,2430,63,60,-3
"309ccf3cc4fe429d9bfbaef53d3fa479","d646286c8051419bbc2e31dd1db55ca8",22855139,1,10,0,2431,60,67,7
"d646286c8051419bbc2e31dd1db55ca8","b534b89233134e30a9b5645138bfa9ee",22855139,1,-33,0,2432,67,41,-26
"67a089198fcb4e1c8f2385786c2b296f","d646286c8051419bbc2e31dd1db55ca8",22855139,2,37,0,2434,39,67,28
"a2becd407db34b189200a32546d9d569","d646286c8051419bbc2e31dd1db55ca8",22855139,1,-9,0,2437,75,67,-8
"d646286c8051419bbc2e31dd1db55ca8","140d5b27b8574befad82c0a013b59dfa",22855139,1,8,0,2438,67,74,7
"140d5b27b8574befad82c0a013b59dfa","d18a9ea32855445f8736581f5cb119ce",22855139,1,9,0,2439,74,82,8
"d18a9ea32855445f8736581f5cb119ce","18fd01350bd5434ca636d59a599d768a",22855139,1,5,0,2440,82,86,4
"18fd01350bd5434ca636d59a599d768a","ae5ac430ea254e708a6f5deaaf7464ae",22855139,2,-2,0,2441,86,84,-2
"ae5ac430ea254e708a6f5deaaf7464ae","6a9f0ef185fb47f0937e29daa1c71ed5",22855139,2,7,0,2442,84,90,6
"6a9f0ef185fb47f0937e29daa1c71ed5","6a9f0ef185fb47f0937e29daa1c71ed5",22855139,5,0,1,2443,90,90,0
"6a9f0ef185fb47f0937e29daa1c71ed5","d646286c8051419bbc2e31dd1db55ca8",22855139,2,-27,0,2445,90,67,-23
"d646286c8051419bbc2e31dd1db55ca8","e20db35ced8544ddac5bc3839145e463",22855139,2,30,0,2446,67,91,24
"e20db35ced8544ddac5bc3839145e463","35eb641ad1d845bbba54915bce75a962",22855139,1,6,0,2447,91,97,6
"35eb641ad1d845bbba54915bce75a962","e20db35ced8544ddac5bc3839145e463",22855139,1,-6,0,2448,97,91,-6
"e20db35ced8544ddac5bc3839145e463","00ae5f0c51874a73a41ebea838d95682",22855139,3,11,0,2449,91,101,10
"00ae5f0c51874a73a41ebea838d95682","d391c8b6e56a43a7b654e9dee02d904b",22855139,7,2,0,2450,101,103,2
"d391c8b6e56a43a7b654e9dee02d904b","4280927ec4d643238aa49c32f9e06c6c",22855139,3,7,0,2451,103,109,6
"4280927ec4d643238aa49c32f9e06c6c","73039f8c1eb9409cb4caee2cf968001e",22855139,6,-10,0,2452,109,100,-9
"73039f8c1eb9409cb4caee2cf968001e","08111f75e22d409998cf8b85bd431f0a",22855139,1,9,0,2453,100,108,8
"08111f75e22d409998cf8b85bd431f0a","a9ae0a3c070d455bb4369a8996313336",22855139,2,7,0,2454,108,114,6
"a9ae0a3c070d455bb4369a8996313336","37319e88176d4aefa91d7a9980dbae91",22855139,1,-2,0,2455,114,112,-2
"37319e88176d4aefa91d7a9980dbae91","62bff51286ef4f348717a3cf6fe2318f",22855139,3,9,0,2456,112,120,8
"62bff51286ef4f348717a3cf6fe2318f","62bff51286ef4f348717a3cf6fe2318f",22855139,9,0,1,2457,120,120,0
"62bff51286ef4f348717a3cf6fe2318f","779f9ddd1fd14d1e9e69f72219a1fdbd",22855139,3,3,0,2459,120,121,1
"779f9ddd1fd14d1e9e69f72219a1fdbd","e20db35ced8544ddac5bc3839145e463",22855139,4,-36,0,2460,121,91,-30
"e20db35ced8544ddac5bc3839145e463","67a089198fcb4e1c8f2385786c2b296f",22855139,3,-67,0,2461,91,39,-52
"67a089198fcb4e1c8f2385786c2b296f","779f9ddd1fd14d1e9e69f72219a1fdbd",22855139,2,103,0,2462,39,121,82
"779f9ddd1fd14d1e9e69f72219a1fdbd","779f9ddd1fd14d1e9e69f72219a1fdbd",22855139,2,0,1,2463,121,121,0
"e20db35ced8544ddac5bc3839145e463","779f9ddd1fd14d1e9e69f72219a1fdbd",22855139,2,36,0,2465,91,121,30
"779f9ddd1fd14d1e9e69f72219a1fdbd","62bff51286ef4f348717a3cf6fe2318f",22855139,1,-3,0,2466,121,120,-1
"e20db35ced8544ddac5bc3839145e463","62bff51286ef4f348717a3cf6fe2318f",22855139,2,33,0,2471,91,120,29
"e20db35ced8544ddac5bc3839145e463","a8dd5213034441ac92724b4e83eb0bb2",22855139,1,45,0,2476,91,129,38
"a8dd5213034441ac92724b4e83eb0bb2","779f9ddd1fd14d1e9e69f72219a1fdbd",22855139,2,-9,0,2477,129,121,-8
"779f9ddd1fd14d1e9e69f72219a1fdbd","579338175e0b4bbb8ef3b712b5d8b54e",22855139,1,8,0,2478,121,128,7
"579338175e0b4bbb8ef3b712b5d8b54e","b416d47c56a742199b5d7c7f19d6503a",22855139,1,7,0,2479,128,134,6
"b416d47c56a742199b5d7c7f19d6503a","779f9ddd1fd14d1e9e69f72219a1fdbd",22855139,1,-15,0,2480,134,121,-13
"779f9ddd1fd14d1e9e69f72219a1fdbd","df1de691dafe4549a18a4398ee9dfaf9",22855139,1,23,0,2481,121,139,18
"df1de691dafe4549a18a4398ee9dfaf9","6c5ad271a44743479bfaea29b1db8d02",22855139,4,4,0,2482,139,143,4
"6c5ad271a44743479bfaea29b1db8d02","df1de691dafe4549a18a4398ee9dfaf9",22855139,2,-4,0,2483,143,139,-4
"df1de691dafe4549a18a4398ee9dfaf9","8aae34f5ddbb4052a709b12e6b0d40fa",22855139,2,9,0,2484,139,147,8
"8aae34f5ddbb4052a709b12e6b0d40fa","645b3f0249f64f76af2e19eb4d0e55b7",22855139,2,2,0,2485,147,149,2
"645b3f0249f64f76af2e19eb4d0e55b7","f902b0f41b544d4dbf79664fd233648d",22855139,1,-3,0,2486,149,146,-3
"f902b0f41b544d4dbf79664fd233648d","f03480cf4eba413194d7af52fc0e7f28",22855139,1,7,0,2487,146,152,6
"f03480cf4eba413194d7af52fc0e7f28","d313cec988a84645bee413e8d4724a4b",22855139,2,7,0,2488,152,158,6
"d313cec988a84645bee413e8d4724a4b","d313cec988a84645bee413e8d4724a4b",22855139,5,0,1,2489,158,158,0
"d313cec988a84645bee413e8d4724a4b","78adeee1fa2c4fe0bc73f7bca9fcee86",22855139,1,4,0,2491,158,160,2
"78adeee1fa2c4fe0bc73f7bca9fcee86","df1de691dafe4549a18a4398ee9dfaf9",22855139,2,-26,0,2492,160,139,-21
"df1de691dafe4549a18a4398ee9dfaf9","65202579580f4ad38d734b4ee39d22a8",22855139,1,31,0,2493,139,164,25
"65202579580f4ad38d734b4ee39d22a8","78adeee1fa2c4fe0bc73f7bca9fcee86",22855139,3,-5,0,2496,164,160,-4
"78adeee1fa2c4fe0bc73f7bca9fcee86","65202579580f4ad38d734b4ee39d22a8",22855139,4,5,0,2497,160,164,4
"65202579580f4ad38d734b4ee39d22a8","3cbcea2be0984e7dbd5a48195af10ce7",22855139,1,3,0,2502,164,165,1
"3cbcea2be0984e7dbd5a48195af10ce7","78adeee1fa2c4fe0bc73f7bca9fcee86",22855139,2,-8,0,2503,165,160,-5
"78adeee1fa2c4fe0bc73f7bca9fcee86","82e6285962b8400d9d6fc32436022a94",22855139,1,10,0,2504,160,167,7
"82e6285962b8400d9d6fc32436022a94","a9ac840f098c4bd0a2ee896214ce29cd",22855139,1,3,0,2505,167,168,1
"a9ac840f098c4bd0a2ee896214ce29cd","3cbcea2be0984e7dbd5a48195af10ce7",22855139,1,-5,0,2506,168,165,-3
"3cbcea2be0984e7dbd5a48195af10ce7","0c7262dff33c4087bc660ccf40f92f9c",22855139,1,9,0,2507,165,169,4
"0c7262dff33c4087bc660ccf40f92f9c","a9ac840f098c4bd0a2ee896214ce29cd",22855139,1,-4,0,2508,169,168,-1
"a9ac840f098c4bd0a2ee896214ce29cd","b2275c3fad834f8d90737a2d9a6927d6",22855139,1,7,0,2509,168,172,4
"b2275c3fad834f8d90737a2d9a6927d6","0c7262dff33c4087bc660ccf40f92f9c",22855139,5,-3,0,2510,172,169,-3
"0c7262dff33c4087bc660ccf40f92f9c","b42cc17b7de840f181a704558d0bc845",22855139,2,7,0,2511,169,175,6
"b42cc17b7de840f181a704558d0bc845","801f9e9135034f49bf5f8b4bdefedb41",22855139,2,2,0,2512,175,177,2
"801f9e9135034f49bf5f8b4bdefedb41","362fcb0699a14845ab29b2340093e528",22855139,2,-3,0,2513,177,174,-3
"362fcb0699a14845ab29b2340093e528","ea38cc0e6e6e41edbabf210220808bf9",22855139,2,6,0,2514,174,179,5
"ea38cc0e6e6e41edbabf210220808bf9","b87c552dd247427abe6ab5795b9c9d43",22855139,3,2,0,2515,179,181,2
"b87c552dd247427abe6ab5795b9c9d43","139b097acfca451689d80c9c6eebdf7b",22855139,2,-3,0,2516,181,178,-3
"139b097acfca451689d80c9c6eebdf7b","2024b4885bd14338a39b7b509acbbd02",22855139,1,5,0,2517,178,182,4
"2024b4885bd14338a39b7b509acbbd02","c8e371568a0c4391b25796ae4e91952e",22855139,1,7,0,2518,182,186,4
"c8e371568a0c4391b25796ae4e91952e","0c7262dff33c4087bc660ccf40f92f9c",22855139,1,-23,0,2519,186,169,-17
"0c7262dff33c4087bc660ccf40f92f9c","c8e371568a0c4391b25796ae4e91952e",22855139,2,23,0,2520,169,186,17
"c8e371568a0c4391b25796ae4e91952e","ab11d94c6c8948ea90b88f19d2cd502b",22855139,2,5,0,2521,186,190,4
"ab11d94c6c8948ea90b88f19d2cd502b","6cd2dcaac46847d4a0bc53f296d90375",22855139,1,5,0,2522,190,194,4
"6cd2dcaac46847d4a0bc53f296d90375","07b44a7a51e94c78b411c753fc39dab0",22855139,1,-6,0,2523,194,189,-5
"07b44a7a51e94c78b411c753fc39dab0","017d7ca8e0394b91aaadc9574df2202c",22855139,1,5,0,2524,189,193,4
"017d7ca8e0394b91aaadc9574df2202c","f9170dd6bc6442b4acd832747609b09a",22855139,1,7,0,2525,193,199,6
"f9170dd6bc6442b4acd832747609b09a","c8e371568a0c4391b25796ae4e91952e",22855139,1,-16,0,2526,199,186,-13
"c8e371568a0c4391b25796ae4e91952e","d7f13c8d63ec4e2aa673fbb9cf9c6933",22855139,1,26,0,2527,186,206,20
"d7f13c8d63ec4e2aa673fbb9cf9c6933","b9e80f77c3a44349863b19875725c384",22855139,2,1,0,2528,206,207,1
"b9e80f77c3a44349863b19875725c384","7108f0e4c2584f1f9c471689ae4c885c",22855139,4,1,0,2529,207,208,1
"7108f0e4c2584f1f9c471689ae4c885c","d7f13c8d63ec4e2aa673fbb9cf9c6933",22855139,1,-2,0,2530,208,206,-2
"d7f13c8d63ec4e2aa673fbb9cf9c6933","09400e101c5d4b439cf9a26b03aae558",22855139,2,5,0,2531,206,210,4
"09400e101c5d4b439cf9a26b03aae558","a875096404ef4a9984b62d74cda916f9",22855139,1,-1,0,2532,210,209,-1
"a875096404ef4a9984b62d74cda916f9","be502a7a43c44bf7b682698de79d9369",22855139,2,6,0,2533,209,214,5
"f7fb1952f56b4189b86a9f8b7862d2b8","ec341f459285443b8361f7f15638ff08",22855139,1,-2,0,2535,215,213,-2
"ec341f459285443b8361f7f15638ff08","363837c182e04711840d896ae1e0339c",22855139,2,6,0,2536,213,218,5
"01b2051f8941460d89945e3b02d1ce78","d7f13c8d63ec4e2aa673fbb9cf9c6933",22855139,1,-14,0,2538,217,206,-11
"d7f13c8d63ec4e2aa673fbb9cf9c6933","1c6721b1f63f4d30ba7746ea8af02a52",22855139,1,21,0,2539,206,221,15
"77ecef8eff6b4a2caea7707669bf7475","1c6721b1f63f4d30ba7746ea8af02a52",22855139,1,-1,0,2541,222,221,-1
"d03cb855c70044cf8c35d9ec0de696e3","8b9ae98743bd4d4a8a87dff1c1244211",22855139,1,3,0,2543,224,227,3
"8b9ae98743bd4d4a8a87dff1c1244211","f7906d6f59b9489a91d2ef40db5a474d",22855139,1,-4,0,2544,227,223,-4
"0b04c8e2f86d48c7aeb7e225819cd32b","2ae94c0cea4d480a9d5dca8fb1d7b542",22855139,1,11,0,2548,234,242,8
"2ae94c0cea4d480a9d5dca8fb1d7b542","1c6721b1f63f4d30ba7746ea8af02a52",22855139,1,-27,0,2549,242,221,-21
"1c6721b1f63f4d30ba7746ea8af02a52","1ebf23f9d994469a85206e4c7b1bf5f5",22855139,1,30,0,2550,221,245,24
"1ebf23f9d994469a85206e4c7b1bf5f5","2ae94c0cea4d480a9d5dca8fb1d7b542",22855139,1,-3,0,2551,245,242,-3
"00f61990949545828dd12f1303d47504","6e83e23f56544a19b94067c1c558d9c0",22855139,1,-11,0,2553,256,247,-9
"6e83e23f56544a19b94067c1c558d9c0","d546341988904f069cfa86b21457d9d9",22855139,1,5,0,2554,247,251,4
"d546341988904f069cfa86b21457d9d9","d989ebcfc12a4b669f0100dc1aa14f1e",22855139,1,5,0,2555,251,255,4
"d989ebcfc12a4b669f0100dc1aa14f1e","7aa76d3e993840d8805f097cbdbcd44b",22855139,1,7,0,2556,255,261,6
"94cecc3f1e7d484b8e068e79241dfd73","fab84b4fab5940efb4ea868ef8d09396",22855139,1,5,0,2573,281,284,3
"fab84b4fab5940efb4ea868ef8d09396","208c9b2796c944db8dacaa96082520ea",22855139,1,7,0,2576,284,288,4
"4a29443515bb404cb8924e1c60a63b73","6a9a3b5bde4a48daa896fe8c06eca56f",22855139,1,5,0,2578,285,289,4
"869e967078f04da18dd0b0b9389a7424","34a6e49023fc4465bd5ca604330bbd1c",22855139,1,-1,0,2580,293,292,-1
"0e0b36e731a645e7b1b8a88f5031ca38","7646a919d7e64fa990bca9b024ff089d",22855139,1,-3,0,2584,301,298,-3
"7646a919d7e64fa990bca9b024ff089d","4a29443515bb404cb8924e1c60a63b73",22855139,1,-17,0,2585,298,285,-13
"53e7e900392747ccad52e711ab0f80d8","130acc2aeb0448fdbb2de63bc5cebe5b",22855139,1,3,0,2588,307,309,2
"3434c10e561d488a914e0f7d71907abd","ea859f8207e44537889daeaba13ac2e8",22855139,1,8,0,2590,305,312,7
"141c0df6cd1946539aadd1c9b7068cd4","86c27d40179e419c8e9d150fb6afa5d0",22855139,1,13,0,2593,308,319,11
"86c27d40179e419c8e9d150fb6afa5d0","0c787d16c9504873b1a4d903cec09948",22855139,1,-6,0,2594,319,314,-5
"0c787d16c9504873b1a4d903cec09948","47edbb64109243e6b0f8f64cdef90c6c",22855139,1,14,0,2595,314,326,12
"24f1363179ad4aaa965484a78471912b","3628bdce1dd2429ba924d2d4d09448d2",22855139,1,-1,0,2598,323,322,-1
"3628bdce1dd2429ba924d2d4d09448d2","0c4079457ede49e3aeb5e86ed84bdf35",22855139,1,10,0,2599,322,329,7
"0c4079457ede49e3aeb5e86ed84bdf35","3434c10e561d488a914e0f7d71907abd",22855139,1,-31,0,2600,329,305,-24
"3434c10e561d488a914e0f7d71907abd","38aea304b4fa46e1b29bb72f5cea4c93",22855139,1,33,0,2601,305,331,26
"b8b9418ab322418d9db9b40d96af873a","c2490bc612d146edbe786556fab3651b",22855139,1,4,0,2605,337,340,3
"c2490bc612d146edbe786556fab3651b","30ead9794d4847abaf222ca966cc8630",22855139,1,11,0,2606,340,348,8
"30ead9794d4847abaf222ca966cc8630","0c4079457ede49e3aeb5e86ed84bdf35",22855139,1,-24,0,2607,348,329,-19
"0c4079457ede49e3aeb5e86ed84bdf35","09b9678ddc3d452ea4a3d46e15826065",22855139,1,29,0,2608,329,353,24
"09b9678ddc3d452ea4a3d46e15826065","2fe14166dc9642c3bc666b86a57f943d",22855139,1,5,0,2620,353,357,4
"30ead9794d4847abaf222ca966cc8630","52580888dadb4fe3baa795683ea227bd",22855139,1,18,0,2622,348,364,16
"52580888dadb4fe3baa795683ea227bd","1ba8fef685d74a8194b9db252eb704fb",22855139,1,-10,0,2623,364,355,-9
"1ba8fef685d74a8194b9db252eb704fb","492a3bc6a1254f23a7998587961b22a4",22855139,1,13,0,2624,355,366,11
"f00179e251a045b39c3f7a54f9aa4acc","072a190fd302456290895f9f04d6940a",22855139,1,3,0,2626,363,365,2
"072a190fd302456290895f9f04d6940a","30ead9794d4847abaf222ca966cc8630",22855139,1,-20,0,2627,365,348,-17
"66baf19b6b904b70922329068c63746d","4890121ce5d74576b4632b77cfc23398",22855139,1,14,0,2645,376,388,12
"4890121ce5d74576b4632b77cfc23398","c2fca3669923477ab966ded303dea31c",22855139,1,-6,0,2646,388,383,-5
"c2fca3669923477ab966ded303dea31c","18d3b836dd804224883cc9180b60a8e1",22855139,1,5,0,2647,383,387,4
"96bb2b3e85a34d8b9544514e89f6fe97","17f95d18bab743888e1736033dc3384d",22855139,1,-1,0,2649,390,389,-1
"f7002c8484354eceac57bc7bd62c76c1","0c12af0a4e7f4002852cf84b2537c161",22855139,1,3,0,2652,393,395,2
"0c12af0a4e7f4002852cf84b2537c161","66baf19b6b904b70922329068c63746d",22855139,1,-24,0,2653,395,376,-19
"2b09a08242b54983aec7063990fb3f66","1157bd665ec4472fb58b751dc5099355",22855139,1,4,0,2657,400,403,3
"1157bd665ec4472fb58b751dc5099355","3c8a22d2f9c146ea956609e3ed4f2559",22855139,1,3,0,2658,403,405,2
"6206fc6479014bb193084c32409dc1b9","6a5f020451db426dacba9e2ea3fcc62a",22855139,1,2,0,2663,409,410,1
"6a5f020451db426dacba9e2ea3fcc62a","02b3a1bead9244c1ba2f857c7da8f82a",22855139,1,-3,0,2664,410,408,-2
"33a9d248b2e44588a5b07fc1342b9bc2","687055dad9fc40c3982478fe33ec01bf",22855139,1,4,0,2668,411,414,3
"687055dad9fc40c3982478fe33ec01bf","2b09a08242b54983aec7063990fb3f66",22855139,1,-21,0,2669,414,400,-14
"2b09a08242b54983aec7063990fb3f66","a2b4bd40cee2481ebd3fc179d6a5cd62",22855139,1,27,0,2670,400,417,17
"a24600b0e49245f6bdba8c893cfeddb0","24cf8786024543f19b89bc20034e60d7",22855139,1,7,0,2677,425,428,3
"dce46f8904594a62a6377a3587aaa663","061c175cc90f45fbad883025394e78dd",22855139,1,2,0,2682,431,433,2
"dce46f8904594a62a6377a3587aaa663","66ada10dde9f43018588f1ced9d477fc",22855139,1,4,0,2684,431,434,3
"66ada10dde9f43018588f1ced9d477fc","24cf8786024543f19b89bc20034e60d7",22855139,1,-8,0,2685,434,428,-6
"1823b6de7d334a7aaabc4570719af4d9","070600601c4c439288445d2f0724807d",22855139,1,-2,0,2688,439,437,-2
"0380cd76a7d44bc3a4da1f15e4d68f89","0380cd76a7d44bc3a4da1f15e4d68f89",22855139,1,0,1,2690,440,440,0
"23b7673c8b5443108c2ef09382834a86","23b7673c8b5443108c2ef09382834a86",22855139,1,0,1,2692,441,441,0
"4660ff2089114e8db82ceb26a4f329e3","901e92500aea43c79f19f1b279050668",22855139,1,-4,0,2695,445,442,-3
"901e92500aea43c79f19f1b279050668","7bd5586eb9d8484eb74a433ee7bfe499",22855139,1,6,0,2696,442,446,4
"7bd5586eb9d8484eb74a433ee7bfe499","4660ff2089114e8db82ceb26a4f329e3",22855139,1,-2,0,2697,446,445,-1
"7bd5586eb9d8484eb74a433ee7bfe499","b2f0d654738f48158edff28e8d3a546e",22855139,1,7,0,2699,446,449,3
"070600601c4c439288445d2f0724807d","b2f0d654738f48158edff28e8d3a546e",22855139,1,21,0,2701,437,449,12
"b2f0d654738f48158edff28e8d3a546e","f67fbf45a5f146ed866965bc57c7c001",22855139,1,8,0,2713,449,454,5
"f67fbf45a5f146ed866965bc57c7c001","e2911e79efc2420eac45d9f671463d4b",22855139,1,-637,0,2716,454,2,-452
"e2911e79efc2420eac45d9f671463d4b","e2911e79efc2420eac45d9f671463d4b",22855139,4,0,1,2717,2,2,0
"e2911e79efc2420eac45d9f671463d4b","f67fbf45a5f146ed866965bc57c7c001",22855139,1,637,0,2719,2,454,452
"f67fbf45a5f146ed866965bc57c7c001","d937afe49bd24a07a550dda1c1155122",22855139,1,1,0,2721,454,455,1
"d937afe49bd24a07a550dda1c1155122","d937afe49bd24a07a550dda1c1155122",22855139,4,0,1,2722,455,455,0
"d937afe49bd24a07a550dda1c1155122","519d1b8c59404d67b54e96c5c8a830b2",22855139,1,-637,0,2723,455,3,-452
"519d1b8c59404d67b54e96c5c8a830b2","d937afe49bd24a07a550dda1c1155122",22855139,1,637,0,2724,3,455,452
"d937afe49bd24a07a550dda1c1155122","3628b3f7823443d0912a339096b69943",22855139,1,1,0,2728,455,456,1
"3628b3f7823443d0912a339096b69943","3628b3f7823443d0912a339096b69943",22855139,1,0,1,2729,456,456,0
"3628b3f7823443d0912a339096b69943","9e049ee647cf43ecbcb5ed792a8e7588",22855139,1,1,0,2730,456,457,1
"9e049ee647cf43ecbcb5ed792a8e7588","9e049ee647cf43ecbcb5ed792a8e7588",22855139,1,0,1,2731,457,457,0
"9e049ee647cf43ecbcb5ed792a8e7588","5256a214faaf410b93f76cea06428334",22855139,1,1,0,2732,457,458,1
"5256a214faaf410b93f76cea06428334","5256a214faaf410b93f76cea06428334",22855139,1,0,1,2733,458,458,0
"5256a214faaf410b93f76cea06428334","25c32b120fce40fa9b6c85133aeb4716",22855139,1,1,0,2734,458,459,1
"25c32b120fce40fa9b6c85133aeb4716","25c32b120fce40fa9b6c85133aeb4716",22855139,1,0,1,2735,459,459,0
"25c32b120fce40fa9b6c85133aeb4716","11bc14f2204949008b7d511b933363c1",22855139,1,1,0,2736,459,460,1
"11bc14f2204949008b7d511b933363c1","11bc14f2204949008b7d511b933363c1",22855139,1,0,1,2737,460,460,0
"11bc14f2204949008b7d511b933363c1","42de338840a34d15adb66e7b14fb9d2c",22855139,1,1,0,2738,460,461,1
"42de338840a34d15adb66e7b14fb9d2c","42de338840a34d15adb66e7b14fb9d2c",22855139,1,0,1,2739,461,461,0
"42de338840a34d15adb66e7b14fb9d2c","9da37c6210b1416b8079c274f70bf600",22855139,1,1,0,2740,461,462,1
"9da37c6210b1416b8079c274f70bf600","9da37c6210b1416b8079c274f70bf600",22855139,4,0,1,2741,462,462,0
"9da37c6210b1416b8079c274f70bf600","66baf19b6b904b70922329068c63746d",22855139,2,-128,0,2744,462,376,-86
"d5ae8642e15b46b8bd298b02274d4e9c","9da37c6210b1416b8079c274f70bf600",22855139,1,124,0,2748,380,462,82
"66baf19b6b904b70922329068c63746d","02b3a1bead9244c1ba2f857c7da8f82a",22855139,1,44,0,2751,376,408,32
"02b3a1bead9244c1ba2f857c7da8f82a","2b09a08242b54983aec7063990fb3f66",22855139,1,-12,0,2752,408,400,-8
"2b09a08242b54983aec7063990fb3f66","02b3a1bead9244c1ba2f857c7da8f82a",22855139,1,12,0,2753,400,408,8
"6206fc6479014bb193084c32409dc1b9","519119f1deac45ff9ab4f13529be5c6e",22855139,1,84,0,2755,409,463,54
"519119f1deac45ff9ab4f13529be5c6e","519119f1deac45ff9ab4f13529be5c6e",22855139,1,0,1,2756,463,463,0
"519119f1deac45ff9ab4f13529be5c6e","c5df9f40ec14463b9dcfdc73df3e9285",22855139,1,3,0,2757,463,464,1
"83d42d95cd844fc093fc09cee250edb8","f67fbf45a5f146ed866965bc57c7c001",22855139,1,-15,0,2764,465,454,-11
"83d42d95cd844fc093fc09cee250edb8","66baf19b6b904b70922329068c63746d",22855139,1,-135,0,2779,465,376,-89
"b613861cecf84ffcab01afb23f660475","b613861cecf84ffcab01afb23f660475",22855392,7,0,1,1,1,1,0
"e2911e79efc2420eac45d9f671463d4b","b613861cecf84ffcab01afb23f660475",22855392,1,-3,0,9,2,1,-1
"b613861cecf84ffcab01afb23f660475","e2911e79efc2420eac45d9f671463d4b",22855392,2,3,0,10,1,2,1
"e2911e79efc2420eac45d9f671463d4b","e2911e79efc2420eac45d9f671463d4b",22855392,5,0,1,11,2,2,0
"e2911e79efc2420eac45d9f671463d4b","519d1b8c59404d67b54e96c5c8a830b2",22855392,2,1,0,12,2,3,1
"519d1b8c59404d67b54e96c5c8a830b2","519d1b8c59404d67b54e96c5c8a830b2",22855392,2,0,1,13,3,3,0
"519d1b8c59404d67b54e96c5c8a830b2","531db53f81f646edb0cdcfe0085b03b7",22855392,1,1,0,14,3,4,1
"531db53f81f646edb0cdcfe0085b03b7","531db53f81f646edb0cdcfe0085b03b7",22855392,1,0,1,15,4,4,0
"531db53f81f646edb0cdcfe0085b03b7","4f5f94b2f95141e0a9d53a61da2276da",22855392,1,1,0,16,4,5,1
"4f5f94b2f95141e0a9d53a61da2276da","4f5f94b2f95141e0a9d53a61da2276da",22855392,1,0,1,17,5,5,0
"4f5f94b2f95141e0a9d53a61da2276da","6d541c89590949f99af293c4f2333f67",22855392,1,1,0,18,5,6,1
"6d541c89590949f99af293c4f2333f67","6d541c89590949f99af293c4f2333f67",22855392,1,0,1,19,6,6,0
"6d541c89590949f99af293c4f2333f67","f96261861edc426abe2248be4f0a709a",22855392,1,2,0,20,6,8,2
"f96261861edc426abe2248be4f0a709a","f96261861edc426abe2248be4f0a709a",22855392,2,0,1,21,8,8,0
"f96261861edc426abe2248be4f0a709a","66b5e16f4f75454fb5b8172079f0fa83",22855392,1,1,0,23,8,9,1
"66b5e16f4f75454fb5b8172079f0fa83","66b5e16f4f75454fb5b8172079f0fa83",22855392,2,0,1,24,9,9,0
"66b5e16f4f75454fb5b8172079f0fa83","0680571d4698477995e41842c36a54b2",22855392,1,1,0,26,9,10,1
"0680571d4698477995e41842c36a54b2","0680571d4698477995e41842c36a54b2",22855392,1,0,1,27,10,10,0
"0680571d4698477995e41842c36a54b2","9112f2bffece48e08c6d2287be204085",22855392,1,1,0,28,10,11,1
"9112f2bffece48e08c6d2287be204085","9112f2bffece48e08c6d2287be204085",22855392,1,0,1,29,11,11,0
"9112f2bffece48e08c6d2287be204085","56586aa865414f538729c7f7735d2bc6",22855392,1,3,0,30,11,12,1
"56586aa865414f538729c7f7735d2bc6","e2911e79efc2420eac45d9f671463d4b",22855392,2,-12,0,31,12,2,-10
"519d1b8c59404d67b54e96c5c8a830b2","dd5cf0b9fe4c4f1d8f5ff8e4c04879cb",22855392,1,4,0,38,3,7,4
"dd5cf0b9fe4c4f1d8f5ff8e4c04879cb","dd5cf0b9fe4c4f1d8f5ff8e4c04879cb",22855392,1,0,1,39,7,7,0
"dd5cf0b9fe4c4f1d8f5ff8e4c04879cb","56586aa865414f538729c7f7735d2bc6",22855392,1,7,0,40,7,12,5
"e2911e79efc2420eac45d9f671463d4b","56586aa865414f538729c7f7735d2bc6",22855392,1,12,0,42,2,12,10
"56586aa865414f538729c7f7735d2bc6","56586aa865414f538729c7f7735d2bc6",22855392,3,0,1,43,12,12,0
"56586aa865414f538729c7f7735d2bc6","b7f2b31585d94eb3bf86376714aa7070",22855392,1,2,0,46,12,13,1
"b7f2b31585d94eb3bf86376714aa7070","b7f2b31585d94eb3bf86376714aa7070",22855392,2,0,1,47,13,13,0
"b7f2b31585d94eb3bf86376714aa7070","3f1c815879794b929260d224becaff7e",22855392,1,2,0,49,13,14,1
"3f1c815879794b929260d224becaff7e","81c864a886d54a6b8ff85f7d736f4f95",22855392,1,2,0,50,14,15,1
"81c864a886d54a6b8ff85f7d736f4f95","5c5ceeee4562457ba6d41515aeebfbb1",22855392,1,4,0,51,15,17,2
"5c5ceeee4562457ba6d41515aeebfbb1","5c5ceeee4562457ba6d41515aeebfbb1",22855392,1,0,1,52,17,17,0
"5c5ceeee4562457ba6d41515aeebfbb1","9afd71a5298d4333b6849dfce1b9422c",22855392,1,3,0,53,17,18,1
"9afd71a5298d4333b6849dfce1b9422c","56586aa865414f538729c7f7735d2bc6",22855392,2,-13,0,54,18,12,-6
"56586aa865414f538729c7f7735d2bc6","9afd71a5298d4333b6849dfce1b9422c",22855392,3,13,0,55,12,18,6
"9afd71a5298d4333b6849dfce1b9422c","9afd71a5298d4333b6849dfce1b9422c",22855392,1,0,1,56,18,18,0
"9afd71a5298d4333b6849dfce1b9422c","5c5ceeee4562457ba6d41515aeebfbb1",22855392,1,-3,0,59,18,17,-1
"5c5ceeee4562457ba6d41515aeebfbb1","56586aa865414f538729c7f7735d2bc6",22855392,1,-10,0,60,17,12,-5
"9afd71a5298d4333b6849dfce1b9422c","b7719e26494940efa49512aedd0aac79",22855392,1,4,0,62,18,20,2
"b7719e26494940efa49512aedd0aac79","9afd71a5298d4333b6849dfce1b9422c",22855392,1,-4,0,63,20,18,-2
"9afd71a5298d4333b6849dfce1b9422c","d4f45188d3c84a02ba08454e6403a818",22855392,1,9,0,64,18,24,6
"d4f45188d3c84a02ba08454e6403a818","d4c3b003e8274e429d2fa688d73fde6d",22855392,1,-2,0,65,24,22,-2
"d4c3b003e8274e429d2fa688d73fde6d","d4c3b003e8274e429d2fa688d73fde6d",22855392,6,0,1,66,22,22,0
"d4c3b003e8274e429d2fa688d73fde6d","b7719e26494940efa49512aedd0aac79",22855392,1,-3,0,72,22,20,-2
"b7719e26494940efa49512aedd0aac79","b7719e26494940efa49512aedd0aac79",22855392,2,0,1,73,20,20,0
"afbf7250b99d47bea07172749483ca97","afbf7250b99d47bea07172749483ca97",22855392,1,0,1,75,28,28,0
"51970cfa30e643e894e66ae85c8024cc","c33c17be71ae4d588da7369472e5bb1b",22855392,1,6,0,79,31,34,3
"c33c17be71ae4d588da7369472e5bb1b","4e51676dc72045d99c19b9fa7b22f8bc",22855392,1,-9,0,80,34,29,-5
"93679be414554a11b1893002f2229a93","93679be414554a11b1893002f2229a93",22855392,1,0,1,83,35,35,0
"7040a13096d746ac84b8fac8d9752058","7040a13096d746ac84b8fac8d9752058",22855392,1,0,1,85,36,36,0
"9a0dc646f934470daf08c4b56ccf73db","9a0dc646f934470daf08c4b56ccf73db",22855392,1,0,1,89,37,37,0
"fc0e049d56024bc9a02c9a9c435c3df7","b7719e26494940efa49512aedd0aac79",22855392,1,-36,0,98,38,20,-18
"b7719e26494940efa49512aedd0aac79","afbf7250b99d47bea07172749483ca97",22855392,4,12,0,100,20,28,8
"afbf7250b99d47bea07172749483ca97","b7719e26494940efa49512aedd0aac79",22855392,2,-12,0,101,28,20,-8
"afbf7250b99d47bea07172749483ca97","4e51676dc72045d99c19b9fa7b22f8bc",22855392,2,3,0,105,28,29,1
"4e51676dc72045d99c19b9fa7b22f8bc","4e51676dc72045d99c19b9fa7b22f8bc",22855392,2,0,1,106,29,29,0
"4e51676dc72045d99c19b9fa7b22f8bc","51970cfa30e643e894e66ae85c8024cc",22855392,2,3,0,107,29,31,2
"51970cfa30e643e894e66ae85c8024cc","4e51676dc72045d99c19b9fa7b22f8bc",22855392,1,-3,0,108,31,29,-2
"4e51676dc72045d99c19b9fa7b22f8bc","c33c17be71ae4d588da7369472e5bb1b",22855392,2,9,0,109,29,34,5
"c33c17be71ae4d588da7369472e5bb1b","93679be414554a11b1893002f2229a93",22855392,3,3,0,110,34,35,1
"93679be414554a11b1893002f2229a93","c33c17be71ae4d588da7369472e5bb1b",22855392,1,-3,0,111,35,34,-1
"93679be414554a11b1893002f2229a93","7040a13096d746ac84b8fac8d9752058",22855392,2,3,0,113,35,36,1
"7040a13096d746ac84b8fac8d9752058","9a0dc646f934470daf08c4b56ccf73db",22855392,2,3,0,114,36,37,1
"9a0dc646f934470daf08c4b56ccf73db","7040a13096d746ac84b8fac8d9752058",22855392,1,-3,0,115,37,36,-1
"7040a13096d746ac84b8fac8d9752058","fc0e049d56024bc9a02c9a9c435c3df7",22855392,1,6,0,116,36,38,2
"fc0e049d56024bc9a02c9a9c435c3df7","9a0dc646f934470daf08c4b56ccf73db",22855392,3,-3,0,117,38,37,-1
"9a0dc646f934470daf08c4b56ccf73db","fc0e049d56024bc9a02c9a9c435c3df7",22855392,4,3,0,118,37,38,1
"fc0e049d56024bc9a02c9a9c435c3df7","fc0e049d56024bc9a02c9a9c435c3df7",22855392,7,0,1,119,38,38,0
"fc0e049d56024bc9a02c9a9c435c3df7","67a089198fcb4e1c8f2385786c2b296f",22855392,3,4,0,120,38,39,1
"67a089198fcb4e1c8f2385786c2b296f","64d48c6c9c7940639a932219a6c87198",22855392,3,1,0,121,39,40,1
"64d48c6c9c7940639a932219a6c87198","64d48c6c9c7940639a932219a6c87198",22855392,1,0,1,122,40,40,0
"64d48c6c9c7940639a932219a6c87198","b534b89233134e30a9b5645138bfa9ee",22855392,2,3,0,123,40,41,1
"b534b89233134e30a9b5645138bfa9ee","67a089198fcb4e1c8f2385786c2b296f",22855392,2,-4,0,124,41,39,-2
"67a089198fcb4e1c8f2385786c2b296f","0e37b720d23b4e7f8b313e79313fd107",22855392,1,7,0,125,39,44,5
"0e37b720d23b4e7f8b313e79313fd107","0e37b720d23b4e7f8b313e79313fd107",22855392,3,0,1,126,44,44,0
"0e37b720d23b4e7f8b313e79313fd107","6875d67fdd5f48168b62719df449bebd",22855392,3,1,0,128,44,45,1
"6875d67fdd5f48168b62719df449bebd","6875d67fdd5f48168b62719df449bebd",22855392,2,0,1,129,45,45,0
"6875d67fdd5f48168b62719df449bebd","0e37b720d23b4e7f8b313e79313fd107",22855392,2,-1,0,130,45,44,-1
"6875d67fdd5f48168b62719df449bebd","6e13d61a7bdb44bca949c9f86fab3be5",22855392,1,3,0,136,45,47,2
"6e13d61a7bdb44bca949c9f86fab3be5","b534b89233134e30a9b5645138bfa9ee",22855392,1,-7,0,137,47,41,-6
"b534b89233134e30a9b5645138bfa9ee","6e13d61a7bdb44bca949c9f86fab3be5",22855392,3,7,0,138,41,47,6
"6e13d61a7bdb44bca949c9f86fab3be5","6e13d61a7bdb44bca949c9f86fab3be5",22855392,3,0,1,139,47,47,0
"6e13d61a7bdb44bca949c9f86fab3be5","195f78799f984cc2b06c48dfe36be751",22855392,1,2,0,140,47,49,2
"195f78799f984cc2b06c48dfe36be751","195f78799f984cc2b06c48dfe36be751",22855392,2,0,1,141,49,49,0
"195f78799f984cc2b06c48dfe36be751","d0c74f735e024943943e40333d6d337f",22855392,1,3,0,143,49,51,2
"d0c74f735e024943943e40333d6d337f","d9c8d8c444a64dadbbb508652c721e17",22855392,1,-6,0,144,51,46,-5
"d9c8d8c444a64dadbbb508652c721e17","f924752d8a1149668870b1e7698486f7",22855392,1,5,0,145,46,50,4
"f924752d8a1149668870b1e7698486f7","b534b89233134e30a9b5645138bfa9ee",22855392,1,-11,0,146,50,41,-9
"6e13d61a7bdb44bca949c9f86fab3be5","d9c8d8c444a64dadbbb508652c721e17",22855392,2,-1,0,150,47,46,-1
"d9c8d8c444a64dadbbb508652c721e17","d0c74f735e024943943e40333d6d337f",22855392,2,6,0,151,46,51,5
"d0c74f735e024943943e40333d6d337f","b534b89233134e30a9b5645138bfa9ee",22855392,2,-12,0,152,51,41,-10
"b534b89233134e30a9b5645138bfa9ee","d0c74f735e024943943e40333d6d337f",22855392,1,12,0,153,41,51,10
"d0c74f735e024943943e40333d6d337f","983f8ff320594b279a7f4a6fe132f9c5",22855392,1,2,0,154,51,53,2
"983f8ff320594b279a7f4a6fe132f9c5","983f8ff320594b279a7f4a6fe132f9c5",22855392,2,0,1,155,53,53,0
"983f8ff320594b279a7f4a6fe132f9c5","35adfa5d923046aebabfefd98f35ff05",22855392,1,1,0,157,53,54,1
"35adfa5d923046aebabfefd98f35ff05","35adfa5d923046aebabfefd98f35ff05",22855392,2,0,1,158,54,54,0
"35adfa5d923046aebabfefd98f35ff05","b6f8a98476224da1b40e555ececc7ed8",22855392,1,1,0,160,54,55,1
"b6f8a98476224da1b40e555ececc7ed8","b6f8a98476224da1b40e555ececc7ed8",22855392,2,0,1,161,55,55,0
"b6f8a98476224da1b40e555ececc7ed8","86e22cb5fe0e4b47a9489ecddf7ed78f",22855392,1,1,0,163,55,56,1
"86e22cb5fe0e4b47a9489ecddf7ed78f","86e22cb5fe0e4b47a9489ecddf7ed78f",22855392,2,0,1,164,56,56,0
"86e22cb5fe0e4b47a9489ecddf7ed78f","f924752d8a1149668870b1e7698486f7",22855392,1,-6,0,166,56,50,-6
"f924752d8a1149668870b1e7698486f7","a1f2f12debe5432fb7a70bcd12bacfb9",22855392,1,9,0,167,50,58,8
"a1f2f12debe5432fb7a70bcd12bacfb9","78f30e4dcac84e3cbea8b2cc6e0d62b3",22855392,3,1,0,168,58,59,1
"78f30e4dcac84e3cbea8b2cc6e0d62b3","a1f2f12debe5432fb7a70bcd12bacfb9",22855392,3,-1,0,169,59,58,-1
"a1f2f12debe5432fb7a70bcd12bacfb9","a1f2f12debe5432fb7a70bcd12bacfb9",22855392,14,0,1,170,58,58,0
"78f30e4dcac84e3cbea8b2cc6e0d62b3","78f30e4dcac84e3cbea8b2cc6e0d62b3",22855392,7,0,1,185,59,59,0
"78f30e4dcac84e3cbea8b2cc6e0d62b3","67a089198fcb4e1c8f2385786c2b296f",22855392,1,-25,0,189,59,39,-20
"64d48c6c9c7940639a932219a6c87198","fc0e049d56024bc9a02c9a9c435c3df7",22855392,1,-5,0,191,40,38,-2
"67a089198fcb4e1c8f2385786c2b296f","d0c74f735e024943943e40333d6d337f",22855392,1,16,0,197,39,51,12
"b534b89233134e30a9b5645138bfa9ee","f924752d8a1149668870b1e7698486f7",22855392,1,11,0,199,41,50,9
"f924752d8a1149668870b1e7698486f7","78f30e4dcac84e3cbea8b2cc6e0d62b3",22855392,2,10,0,200,50,59,9
"78f30e4dcac84e3cbea8b2cc6e0d62b3","12aa6e1672ac4e7aa6449a7a8609cd72",22855392,1,-2,0,206,59,57,-2
"12aa6e1672ac4e7aa6449a7a8609cd72","bc42d26810654ea9a1df1efe1e58c7d5",22855392,1,7,0,207,57,63,6
"bc42d26810654ea9a1df1efe1e58c7d5","a0a418b8540d479fa6e0f653b701da8b",22855392,1,1,0,208,63,64,1
"a0a418b8540d479fa6e0f653b701da8b","4c943503763e4e349906eea3ed3c8e86",22855392,1,-3,0,209,64,61,-3
"4c943503763e4e349906eea3ed3c8e86","4c943503763e4e349906eea3ed3c8e86",22855392,1,0,1,210,61,61,0
"4c943503763e4e349906eea3ed3c8e86","309ccf3cc4fe429d9bfbaef53d3fa479",22855392,1,-1,0,211,61,60,-1
"309ccf3cc4fe429d9bfbaef53d3fa479","d646286c8051419bbc2e31dd1db55ca8",22855392,2,10,0,212,60,67,7
"d646286c8051419bbc2e31dd1db55ca8","b534b89233134e30a9b5645138bfa9ee",22855392,2,-33,0,213,67,41,-26
"b534b89233134e30a9b5645138bfa9ee","267f883678b24aed855fde42524975d9",22855392,1,37,0,214,41,71,30
"267f883678b24aed855fde42524975d9","267f883678b24aed855fde42524975d9",22855392,1,0,1,215,71,71,0
"267f883678b24aed855fde42524975d9","88fff56d0342490dbef9040750a20f6c",22855392,1,1,0,216,71,72,1
"88fff56d0342490dbef9040750a20f6c","88fff56d0342490dbef9040750a20f6c",22855392,1,0,1,217,72,72,0
"88fff56d0342490dbef9040750a20f6c","adb17b12b66c4a49a85fd34322f7df70",22855392,1,1,0,218,72,73,1
"adb17b12b66c4a49a85fd34322f7df70","adb17b12b66c4a49a85fd34322f7df70",22855392,1,0,1,219,73,73,0
"adb17b12b66c4a49a85fd34322f7df70","d646286c8051419bbc2e31dd1db55ca8",22855392,1,-6,0,220,73,67,-6
"d646286c8051419bbc2e31dd1db55ca8","a2becd407db34b189200a32546d9d569",22855392,1,9,0,221,67,75,8
"a2becd407db34b189200a32546d9d569","a2becd407db34b189200a32546d9d569",22855392,1,0,1,222,75,75,0
"a2becd407db34b189200a32546d9d569","58c22b011d0f4c2ea6d13615edbb9eeb",22855392,1,2,0,223,75,77,2
"58c22b011d0f4c2ea6d13615edbb9eeb","58c22b011d0f4c2ea6d13615edbb9eeb",22855392,2,0,1,224,77,77,0
"58c22b011d0f4c2ea6d13615edbb9eeb","dd76e1861dc9461c830888729d091ee0",22855392,1,1,0,226,77,78,1
"dd76e1861dc9461c830888729d091ee0","dd76e1861dc9461c830888729d091ee0",22855392,8,0,1,227,78,78,0
"dd76e1861dc9461c830888729d091ee0","cd1d828f1a694b87913a7ea66c23803e",22855392,1,1,0,235,78,79,1
"cd1d828f1a694b87913a7ea66c23803e","cd1d828f1a694b87913a7ea66c23803e",22855392,2,0,1,236,79,79,0
"cd1d828f1a694b87913a7ea66c23803e","b534b89233134e30a9b5645138bfa9ee",22855392,1,-46,0,238,79,41,-38
"b534b89233134e30a9b5645138bfa9ee","b534b89233134e30a9b5645138bfa9ee",22855392,1,0,1,239,41,41,0
"d0c74f735e024943943e40333d6d337f","f924752d8a1149668870b1e7698486f7",22855392,1,-1,0,243,51,50,-1
"a1f2f12debe5432fb7a70bcd12bacfb9","bc42d26810654ea9a1df1efe1e58c7d5",22855392,1,6,0,246,58,63,5
"bc42d26810654ea9a1df1efe1e58c7d5","12aa6e1672ac4e7aa6449a7a8609cd72",22855392,1,-7,0,247,63,57,-6
"12aa6e1672ac4e7aa6449a7a8609cd72","a0a418b8540d479fa6e0f653b701da8b",22855392,1,8,0,248,57,64,7
"a0a418b8540d479fa6e0f653b701da8b","309ccf3cc4fe429d9bfbaef53d3fa479",22855392,1,-4,0,249,64,60,-4
"b534b89233134e30a9b5645138bfa9ee","a2becd407db34b189200a32546d9d569",22855392,1,42,0,252,41,75,34
"a2becd407db34b189200a32546d9d569","d646286c8051419bbc2e31dd1db55ca8",22855392,1,-9,0,253,75,67,-8
"d646286c8051419bbc2e31dd1db55ca8","9176a3c2b4d2465fa8b0c67096c2a97e",22855392,1,14,0,254,67,80,13
"9176a3c2b4d2465fa8b0c67096c2a97e","9176a3c2b4d2465fa8b0c67096c2a97e",22855392,5,0,1,255,80,80,0
"9176a3c2b4d2465fa8b0c67096c2a97e","f8ec6445f7194e25b9101d4fbcb07a18",22855392,1,1,0,260,80,81,1
"f8ec6445f7194e25b9101d4fbcb07a18","f8ec6445f7194e25b9101d4fbcb07a18",22855392,2,0,1,261,81,81,0
"f8ec6445f7194e25b9101d4fbcb07a18","140d5b27b8574befad82c0a013b59dfa",22855392,1,-7,0,263,81,74,-7
"140d5b27b8574befad82c0a013b59dfa","d646286c8051419bbc2e31dd1db55ca8",22855392,1,-8,0,264,74,67,-7
"d646286c8051419bbc2e31dd1db55ca8","d18a9ea32855445f8736581f5cb119ce",22855392,1,17,0,265,67,82,15
"d18a9ea32855445f8736581f5cb119ce","f564483cbd7a407681aa2fcca518cf5f",22855392,1,4,0,266,82,85,3
"f564483cbd7a407681aa2fcca518cf5f","f564483cbd7a407681aa2fcca518cf5f",22855392,4,0,1,267,85,85,0
"f564483cbd7a407681aa2fcca518cf5f","18fd01350bd5434ca636d59a599d768a",22855392,1,1,0,271,85,86,1
"18fd01350bd5434ca636d59a599d768a","18fd01350bd5434ca636d59a599d768a",22855392,8,0,1,272,86,86,0
"18fd01350bd5434ca636d59a599d768a","ae5ac430ea254e708a6f5deaaf7464ae",22855392,1,-2,0,280,86,84,-2
"ae5ac430ea254e708a6f5deaaf7464ae","6a9f0ef185fb47f0937e29daa1c71ed5",22855392,2,7,0,281,84,90,6
"6a9f0ef185fb47f0937e29daa1c71ed5","c681290961c94c4caf23b529d1ae6b9a",22855392,1,-2,0,282,90,88,-2
"c681290961c94c4caf23b529d1ae6b9a","c681290961c94c4caf23b529d1ae6b9a",22855392,1,0,1,283,88,88,0
"c681290961c94c4caf23b529d1ae6b9a","6a9f0ef185fb47f0937e29daa1c71ed5",22855392,1,2,0,284,88,90,2
"6a9f0ef185fb47f0937e29daa1c71ed5","6a9f0ef185fb47f0937e29daa1c71ed5",22855392,14,0,1,285,90,90,0
"6a9f0ef185fb47f0937e29daa1c71ed5","d646286c8051419bbc2e31dd1db55ca8",22855392,1,-27,0,288,90,67,-23
"d646286c8051419bbc2e31dd1db55ca8","e20db35ced8544ddac5bc3839145e463",22855392,6,30,0,289,67,91,24
"e20db35ced8544ddac5bc3839145e463","1febb706d7a34005ae8711ed49c76e64",22855392,1,3,0,290,91,94,3
"1febb706d7a34005ae8711ed49c76e64","1febb706d7a34005ae8711ed49c76e64",22855392,4,0,1,291,94,94,0
"1febb706d7a34005ae8711ed49c76e64","8f73ba6f5a0042f2850356ac38ac6f24",22855392,1,1,0,293,94,95,1
"8f73ba6f5a0042f2850356ac38ac6f24","8f73ba6f5a0042f2850356ac38ac6f24",22855392,5,0,1,294,95,95,0
"8f73ba6f5a0042f2850356ac38ac6f24","e2260b86653c46d7b14a41fb419dbf8c",22855392,1,1,0,299,95,96,1
"e2260b86653c46d7b14a41fb419dbf8c","e2260b86653c46d7b14a41fb419dbf8c",22855392,4,0,1,300,96,96,0
"e2260b86653c46d7b14a41fb419dbf8c","08be90ffbeea4795a138cd42ed8db56f",22855392,1,2,0,302,96,98,2
"08be90ffbeea4795a138cd42ed8db56f","08be90ffbeea4795a138cd42ed8db56f",22855392,5,0,1,303,98,98,0
"08be90ffbeea4795a138cd42ed8db56f","3007433c8f584dcbb5ac159c1c5f2be3",22855392,1,1,0,308,98,99,1
"3007433c8f584dcbb5ac159c1c5f2be3","3007433c8f584dcbb5ac159c1c5f2be3",22855392,5,0,1,309,99,99,0
"3007433c8f584dcbb5ac159c1c5f2be3","00ae5f0c51874a73a41ebea838d95682",22855392,1,3,0,314,99,101,2
"00ae5f0c51874a73a41ebea838d95682","e20db35ced8544ddac5bc3839145e463",22855392,1,-11,0,315,101,91,-10
"e20db35ced8544ddac5bc3839145e463","d391c8b6e56a43a7b654e9dee02d904b",22855392,2,13,0,316,91,103,12
"d391c8b6e56a43a7b654e9dee02d904b","73039f8c1eb9409cb4caee2cf968001e",22855392,5,-3,0,317,103,100,-3
"73039f8c1eb9409cb4caee2cf968001e","e2260b86653c46d7b14a41fb419dbf8c",22855392,1,-5,0,318,100,96,-4
"e2260b86653c46d7b14a41fb419dbf8c","1febb706d7a34005ae8711ed49c76e64",22855392,1,-2,0,321,96,94,-2
"1febb706d7a34005ae8711ed49c76e64","e20db35ced8544ddac5bc3839145e463",22855392,1,-3,0,324,94,91,-3
"e20db35ced8544ddac5bc3839145e463","00ae5f0c51874a73a41ebea838d95682",22855392,6,11,0,325,91,101,10
"00ae5f0c51874a73a41ebea838d95682","d391c8b6e56a43a7b654e9dee02d904b",22855392,7,2,0,326,101,103,2
"73039f8c1eb9409cb4caee2cf968001e","e20db35ced8544ddac5bc3839145e463",22855392,2,-10,0,328,100,91,-9
"e20db35ced8544ddac5bc3839145e463","d646286c8051419bbc2e31dd1db55ca8",22855392,5,-30,0,329,91,67,-24
"d646286c8051419bbc2e31dd1db55ca8","6a9f0ef185fb47f0937e29daa1c71ed5",22855392,1,27,0,330,67,90,23
"6a9f0ef185fb47f0937e29daa1c71ed5","e20db35ced8544ddac5bc3839145e463",22855392,3,3,0,333,90,91,1
"d391c8b6e56a43a7b654e9dee02d904b","00ae5f0c51874a73a41ebea838d95682",22855392,2,-2,0,338,103,101,-2
"d391c8b6e56a43a7b654e9dee02d904b","d391c8b6e56a43a7b654e9dee02d904b",22855392,18,0,1,340,103,103,0
"73039f8c1eb9409cb4caee2cf968001e","d646286c8051419bbc2e31dd1db55ca8",22855392,2,-40,0,344,100,67,-33
"e20db35ced8544ddac5bc3839145e463","6a9f0ef185fb47f0937e29daa1c71ed5",22855392,3,-3,0,346,91,90,-1
"d646286c8051419bbc2e31dd1db55ca8","d391c8b6e56a43a7b654e9dee02d904b",22855392,1,43,0,351,67,103,36
"d391c8b6e56a43a7b654e9dee02d904b","e20db35ced8544ddac5bc3839145e463",22855392,2,-13,0,352,103,91,-12
"00ae5f0c51874a73a41ebea838d95682","73039f8c1eb9409cb4caee2cf968001e",22855392,2,-1,0,354,101,100,-1
"e20db35ced8544ddac5bc3839145e463","e20db35ced8544ddac5bc3839145e463",22855392,1,0,1,356,91,91,0
"73039f8c1eb9409cb4caee2cf968001e","d391c8b6e56a43a7b654e9dee02d904b",22855392,1,3,0,362,100,103,3
"d391c8b6e56a43a7b654e9dee02d904b","d646286c8051419bbc2e31dd1db55ca8",22855392,1,-43,0,363,103,67,-36
"6a9f0ef185fb47f0937e29daa1c71ed5","42fb58708eaf4e5daa82bfca61b6f5fd",22855392,2,-3,0,366,90,87,-3
"42fb58708eaf4e5daa82bfca61b6f5fd","6a9f0ef185fb47f0937e29daa1c71ed5",22855392,2,3,0,367,87,90,3
"6a9f0ef185fb47f0937e29daa1c71ed5","ae5ac430ea254e708a6f5deaaf7464ae",22855392,2,-7,0,372,90,84,-6
"ae5ac430ea254e708a6f5deaaf7464ae","e20db35ced8544ddac5bc3839145e463",22855392,1,10,0,373,84,91,7
"d646286c8051419bbc2e31dd1db55ca8","35eb641ad1d845bbba54915bce75a962",22855392,1,36,0,375,67,97,30
"35eb641ad1d845bbba54915bce75a962","35eb641ad1d845bbba54915bce75a962",22855392,6,0,1,376,97,97,0
"35eb641ad1d845bbba54915bce75a962","e20db35ced8544ddac5bc3839145e463",22855392,1,-6,0,382,97,91,-6
"00ae5f0c51874a73a41ebea838d95682","00ae5f0c51874a73a41ebea838d95682",22855392,2,0,1,401,101,101,0
"d391c8b6e56a43a7b654e9dee02d904b","6111116566fc4fd9abba409322bea245",22855392,1,1,0,419,103,104,1
"6111116566fc4fd9abba409322bea245","6111116566fc4fd9abba409322bea245",22855392,2,0,1,420,104,104,0
"6111116566fc4fd9abba409322bea245","a81b2235cb9c499eb9ea8ee0a8dd9725",22855392,1,1,0,422,104,105,1
"a81b2235cb9c499eb9ea8ee0a8dd9725","a81b2235cb9c499eb9ea8ee0a8dd9725",22855392,2,0,1,423,105,105,0
"a81b2235cb9c499eb9ea8ee0a8dd9725","2d4e0ab0ef3b4d73b82c72d4621a7579",22855392,1,1,0,425,105,106,1
"2d4e0ab0ef3b4d73b82c72d4621a7579","2d4e0ab0ef3b4d73b82c72d4621a7579",22855392,2,0,1,426,106,106,0
"2d4e0ab0ef3b4d73b82c72d4621a7579","8bdebf492ebd4e62b0d522e8ab5e5197",22855392,1,1,0,428,106,107,1
"8bdebf492ebd4e62b0d522e8ab5e5197","8bdebf492ebd4e62b0d522e8ab5e5197",22855392,2,0,1,429,107,107,0
"8bdebf492ebd4e62b0d522e8ab5e5197","4280927ec4d643238aa49c32f9e06c6c",22855392,1,3,0,431,107,109,2
"4280927ec4d643238aa49c32f9e06c6c","73039f8c1eb9409cb4caee2cf968001e",22855392,1,-10,0,432,109,100,-9
"73039f8c1eb9409cb4caee2cf968001e","4280927ec4d643238aa49c32f9e06c6c",22855392,1,10,0,433,100,109,9
"4280927ec4d643238aa49c32f9e06c6c","4280927ec4d643238aa49c32f9e06c6c",22855392,1,0,1,434,109,109,0
"4280927ec4d643238aa49c32f9e06c6c","fc44e6a5f7654430af1227838224dceb",22855392,1,2,0,435,109,111,2
"fc44e6a5f7654430af1227838224dceb","fc44e6a5f7654430af1227838224dceb",22855392,2,0,1,436,111,111,0
"fc44e6a5f7654430af1227838224dceb","08111f75e22d409998cf8b85bd431f0a",22855392,1,-3,0,438,111,108,-3
"08111f75e22d409998cf8b85bd431f0a","a9ae0a3c070d455bb4369a8996313336",22855392,1,7,0,439,108,114,6
"a9ae0a3c070d455bb4369a8996313336","a9ae0a3c070d455bb4369a8996313336",22855392,1,0,1,440,114,114,0
"a9ae0a3c070d455bb4369a8996313336","37319e88176d4aefa91d7a9980dbae91",22855392,1,-2,0,441,114,112,-2
"37319e88176d4aefa91d7a9980dbae91","4280927ec4d643238aa49c32f9e06c6c",22855392,1,-4,0,442,112,109,-3
"4280927ec4d643238aa49c32f9e06c6c","08111f75e22d409998cf8b85bd431f0a",22855392,1,-1,0,443,109,108,-1
"08111f75e22d409998cf8b85bd431f0a","00ae5f0c51874a73a41ebea838d95682",22855392,1,-8,0,444,108,101,-7
"73039f8c1eb9409cb4caee2cf968001e","a9ae0a3c070d455bb4369a8996313336",22855392,1,16,0,447,100,114,14
"a9ae0a3c070d455bb4369a8996313336","71cec822bcff4f30a20e75dc63ef7b65",22855392,1,2,0,448,114,116,2
"71cec822bcff4f30a20e75dc63ef7b65","71cec822bcff4f30a20e75dc63ef7b65",22855392,3,0,1,449,116,116,0
"71cec822bcff4f30a20e75dc63ef7b65","37319e88176d4aefa91d7a9980dbae91",22855392,1,-4,0,452,116,112,-4
"37319e88176d4aefa91d7a9980dbae91","62bff51286ef4f348717a3cf6fe2318f",22855392,1,9,0,453,112,120,8
"62bff51286ef4f348717a3cf6fe2318f","b1cd0e7dc3ad4a8eb91a4bfdbeb025b0",22855392,1,-2,0,454,120,118,-2
"b1cd0e7dc3ad4a8eb91a4bfdbeb025b0","b1cd0e7dc3ad4a8eb91a4bfdbeb025b0",22855392,1,0,1,455,118,118,0
"b1cd0e7dc3ad4a8eb91a4bfdbeb025b0","62bff51286ef4f348717a3cf6fe2318f",22855392,1,2,0,456,118,120,2
"62bff51286ef4f348717a3cf6fe2318f","e20db35ced8544ddac5bc3839145e463",22855392,2,-33,0,460,120,91,-29
"779f9ddd1fd14d1e9e69f72219a1fdbd","a8dd5213034441ac92724b4e83eb0bb2",22855392,3,9,0,462,121,129,8
"a8dd5213034441ac92724b4e83eb0bb2","779f9ddd1fd14d1e9e69f72219a1fdbd",22855392,2,-9,0,463,129,121,-8
"779f9ddd1fd14d1e9e69f72219a1fdbd","579338175e0b4bbb8ef3b712b5d8b54e",22855392,1,8,0,464,121,128,7
"579338175e0b4bbb8ef3b712b5d8b54e","b416d47c56a742199b5d7c7f19d6503a",22855392,1,7,0,465,128,134,6
"b416d47c56a742199b5d7c7f19d6503a","779f9ddd1fd14d1e9e69f72219a1fdbd",22855392,1,-15,0,466,134,121,-13
"779f9ddd1fd14d1e9e69f72219a1fdbd","df1de691dafe4549a18a4398ee9dfaf9",22855392,2,23,0,467,121,139,18
"df1de691dafe4549a18a4398ee9dfaf9","6c5ad271a44743479bfaea29b1db8d02",22855392,1,4,0,468,139,143,4
"6c5ad271a44743479bfaea29b1db8d02","779f9ddd1fd14d1e9e69f72219a1fdbd",22855392,1,-27,0,469,143,121,-22
"df1de691dafe4549a18a4398ee9dfaf9","f661500307d74c908e9207d949ceb4aa",22855392,1,-5,0,471,139,136,-3
"f661500307d74c908e9207d949ceb4aa","a8dd5213034441ac92724b4e83eb0bb2",22855392,1,-9,0,472,136,129,-7
"a8dd5213034441ac92724b4e83eb0bb2","b416d47c56a742199b5d7c7f19d6503a",22855392,1,6,0,473,129,134,5
"b416d47c56a742199b5d7c7f19d6503a","579338175e0b4bbb8ef3b712b5d8b54e",22855392,1,-7,0,474,134,128,-6
"579338175e0b4bbb8ef3b712b5d8b54e","779f9ddd1fd14d1e9e69f72219a1fdbd",22855392,1,-8,0,475,128,121,-7
"779f9ddd1fd14d1e9e69f72219a1fdbd","e20db35ced8544ddac5bc3839145e463",22855392,1,-36,0,476,121,91,-30
"e20db35ced8544ddac5bc3839145e463","62bff51286ef4f348717a3cf6fe2318f",22855392,1,33,0,477,91,120,29
"779f9ddd1fd14d1e9e69f72219a1fdbd","ae26e6cda8ad4a3f81bd347560d9579f",22855392,1,4,0,482,121,125,4
"ae26e6cda8ad4a3f81bd347560d9579f","ae26e6cda8ad4a3f81bd347560d9579f",22855392,3,0,1,483,125,125,0
"ae26e6cda8ad4a3f81bd347560d9579f","ee48df95832b4374aa273ceb27ec1315",22855392,1,1,0,486,125,126,1
"ee48df95832b4374aa273ceb27ec1315","ee48df95832b4374aa273ceb27ec1315",22855392,1,0,1,487,126,126,0
"ee48df95832b4374aa273ceb27ec1315","7a439da90b394756ad1777fc4c6dead5",22855392,1,1,0,488,126,127,1
"7a439da90b394756ad1777fc4c6dead5","7a439da90b394756ad1777fc4c6dead5",22855392,1,0,1,489,127,127,0
"7a439da90b394756ad1777fc4c6dead5","779f9ddd1fd14d1e9e69f72219a1fdbd",22855392,1,-6,0,490,127,121,-6
"779f9ddd1fd14d1e9e69f72219a1fdbd","779f9ddd1fd14d1e9e69f72219a1fdbd",22855392,1,0,1,493,121,121,0
"a8dd5213034441ac92724b4e83eb0bb2","a8dd5213034441ac92724b4e83eb0bb2",22855392,2,0,1,495,129,129,0
"a8dd5213034441ac92724b4e83eb0bb2","8115eab6556b45f5b415c3b8c26a12e5",22855392,1,2,0,497,129,131,2
"8115eab6556b45f5b415c3b8c26a12e5","8115eab6556b45f5b415c3b8c26a12e5",22855392,2,0,1,498,131,131,0
"8115eab6556b45f5b415c3b8c26a12e5","ec34b06efd844b46a4c4818ecdb9b8f4",22855392,1,1,0,500,131,132,1
"ec34b06efd844b46a4c4818ecdb9b8f4","ec34b06efd844b46a4c4818ecdb9b8f4",22855392,2,0,1,501,132,132,0
"ec34b06efd844b46a4c4818ecdb9b8f4","c2e1c2b9eac64109b343a088584b576b",22855392,1,1,0,503,132,133,1
"c2e1c2b9eac64109b343a088584b576b","c2e1c2b9eac64109b343a088584b576b",22855392,5,0,1,504,133,133,0
"c2e1c2b9eac64109b343a088584b576b","579338175e0b4bbb8ef3b712b5d8b54e",22855392,1,-5,0,509,133,128,-5
"579338175e0b4bbb8ef3b712b5d8b54e","8bc5795d6a984a3eace4e2811e52dd4f",22855392,1,8,0,510,128,135,7
"8bc5795d6a984a3eace4e2811e52dd4f","8bc5795d6a984a3eace4e2811e52dd4f",22855392,1,0,1,511,135,135,0
"8bc5795d6a984a3eace4e2811e52dd4f","b416d47c56a742199b5d7c7f19d6503a",22855392,1,-1,0,512,135,134,-1
"b416d47c56a742199b5d7c7f19d6503a","cd4532ad48034873ba8bce2aac0c9808",22855392,1,4,0,513,134,137,3
"cd4532ad48034873ba8bce2aac0c9808","cd4532ad48034873ba8bce2aac0c9808",22855392,1,0,1,514,137,137,0
"cd4532ad48034873ba8bce2aac0c9808","df1de691dafe4549a18a4398ee9dfaf9",22855392,1,4,0,515,137,139,2
"779f9ddd1fd14d1e9e69f72219a1fdbd","6c5ad271a44743479bfaea29b1db8d02",22855392,1,27,0,517,121,143,22
"6c5ad271a44743479bfaea29b1db8d02","6c5ad271a44743479bfaea29b1db8d02",22855392,1,0,1,518,143,143,0
"6c5ad271a44743479bfaea29b1db8d02","83d311bed5374fee83d8d67a7d9d82dc",22855392,1,1,0,519,143,144,1
"83d311bed5374fee83d8d67a7d9d82dc","83d311bed5374fee83d8d67a7d9d82dc",22855392,1,0,1,520,144,144,0
"83d311bed5374fee83d8d67a7d9d82dc","402bba41861d43acb52a5abb89e8831e",22855392,1,1,0,521,144,145,1
"402bba41861d43acb52a5abb89e8831e","402bba41861d43acb52a5abb89e8831e",22855392,8,0,1,522,145,145,0
"402bba41861d43acb52a5abb89e8831e","8aae34f5ddbb4052a709b12e6b0d40fa",22855392,1,3,0,530,145,147,2
"8aae34f5ddbb4052a709b12e6b0d40fa","df1de691dafe4549a18a4398ee9dfaf9",22855392,1,-9,0,531,147,139,-8
"df1de691dafe4549a18a4398ee9dfaf9","f902b0f41b544d4dbf79664fd233648d",22855392,1,8,0,532,139,146,7
"f902b0f41b544d4dbf79664fd233648d","8aae34f5ddbb4052a709b12e6b0d40fa",22855392,1,1,0,533,146,147,1
"8aae34f5ddbb4052a709b12e6b0d40fa","f03480cf4eba413194d7af52fc0e7f28",22855392,1,6,0,534,147,152,5
"8aae34f5ddbb4052a709b12e6b0d40fa","645b3f0249f64f76af2e19eb4d0e55b7",22855392,1,2,0,536,147,149,2
"645b3f0249f64f76af2e19eb4d0e55b7","645b3f0249f64f76af2e19eb4d0e55b7",22855392,8,0,1,537,149,149,0
"645b3f0249f64f76af2e19eb4d0e55b7","7e7b8db5064d4369805ab370aac5ddfb",22855392,1,1,0,543,149,150,1
"7e7b8db5064d4369805ab370aac5ddfb","7e7b8db5064d4369805ab370aac5ddfb",22855392,2,0,1,544,150,150,0
"7e7b8db5064d4369805ab370aac5ddfb","645b3f0249f64f76af2e19eb4d0e55b7",22855392,1,-1,0,546,150,149,-1
"645b3f0249f64f76af2e19eb4d0e55b7","8956d210ae7f41968fada86d4c979d6a",22855392,1,2,0,549,149,151,2
"8956d210ae7f41968fada86d4c979d6a","8956d210ae7f41968fada86d4c979d6a",22855392,2,0,1,550,151,151,0
"8956d210ae7f41968fada86d4c979d6a","f902b0f41b544d4dbf79664fd233648d",22855392,1,-5,0,552,151,146,-5
"f902b0f41b544d4dbf79664fd233648d","ae781e8b775e4ccd93bc800dad5c8376",22855392,1,8,0,553,146,153,7
"ae781e8b775e4ccd93bc800dad5c8376","ae781e8b775e4ccd93bc800dad5c8376",22855392,2,0,1,554,153,153,0
"ae781e8b775e4ccd93bc800dad5c8376","06882a8492d9499aa31555567f575ecb",22855392,1,1,0,556,153,154,1
"06882a8492d9499aa31555567f575ecb","06882a8492d9499aa31555567f575ecb",22855392,3,0,1,557,154,154,0
"06882a8492d9499aa31555567f575ecb","f293c508f409466a8f27ddd7d1e40b20",22855392,1,1,0,560,154,155,1
"f293c508f409466a8f27ddd7d1e40b20","f293c508f409466a8f27ddd7d1e40b20",22855392,8,0,1,561,155,155,0
"f293c508f409466a8f27ddd7d1e40b20","cc4ddef5bbbe48ebb605141b347c4ed1",22855392,1,1,0,569,155,156,1
"cc4ddef5bbbe48ebb605141b347c4ed1","cc4ddef5bbbe48ebb605141b347c4ed1",22855392,3,0,1,570,156,156,0
"cc4ddef5bbbe48ebb605141b347c4ed1","f03480cf4eba413194d7af52fc0e7f28",22855392,1,-4,0,573,156,152,-4
"f03480cf4eba413194d7af52fc0e7f28","d313cec988a84645bee413e8d4724a4b",22855392,2,7,0,574,152,158,6
"d313cec988a84645bee413e8d4724a4b","dc60696c76a74368a60f72246e47700d",22855392,2,1,0,579,158,159,1
"dc60696c76a74368a60f72246e47700d","dc60696c76a74368a60f72246e47700d",22855392,2,0,1,580,159,159,0
"dc60696c76a74368a60f72246e47700d","f4ce60b4a944484082ccb701b48b3da1",22855392,1,-2,0,581,159,157,-2
"dc60696c76a74368a60f72246e47700d","df1de691dafe4549a18a4398ee9dfaf9",22855392,1,-23,0,588,159,139,-20
"65202579580f4ad38d734b4ee39d22a8","78adeee1fa2c4fe0bc73f7bca9fcee86",22855392,6,-5,0,595,164,160,-4
"78adeee1fa2c4fe0bc73f7bca9fcee86","f4ce60b4a944484082ccb701b48b3da1",22855392,1,-5,0,602,160,157,-3
"f4ce60b4a944484082ccb701b48b3da1","d313cec988a84645bee413e8d4724a4b",22855392,1,1,0,603,157,158,1
"d313cec988a84645bee413e8d4724a4b","f03480cf4eba413194d7af52fc0e7f28",22855392,1,-7,0,609,158,152,-6
"f03480cf4eba413194d7af52fc0e7f28","df1de691dafe4549a18a4398ee9dfaf9",22855392,1,-15,0,610,152,139,-13
"78adeee1fa2c4fe0bc73f7bca9fcee86","78adeee1fa2c4fe0bc73f7bca9fcee86",22855392,2,0,1,612,160,160,0
"78adeee1fa2c4fe0bc73f7bca9fcee86","3cbcea2be0984e7dbd5a48195af10ce7",22855392,1,8,0,691,160,165,5
"82e6285962b8400d9d6fc32436022a94","0c7262dff33c4087bc660ccf40f92f9c",22855392,1,7,0,693,167,169,2
"b2275c3fad834f8d90737a2d9a6927d6","0c7262dff33c4087bc660ccf40f92f9c",22855392,5,-3,0,695,172,169,-3
"b2275c3fad834f8d90737a2d9a6927d6","b2275c3fad834f8d90737a2d9a6927d6",22855392,24,0,1,697,172,172,0
"b2275c3fad834f8d90737a2d9a6927d6","eb515a26030b41f8a82a1e6114420bad",22855392,1,1,0,721,172,173,1
"eb515a26030b41f8a82a1e6114420bad","eb515a26030b41f8a82a1e6114420bad",22855392,2,0,1,722,173,173,0
"eb515a26030b41f8a82a1e6114420bad","b42cc17b7de840f181a704558d0bc845",22855392,1,3,0,724,173,175,2
"b42cc17b7de840f181a704558d0bc845","0c7262dff33c4087bc660ccf40f92f9c",22855392,1,-7,0,725,175,169,-6
"0c7262dff33c4087bc660ccf40f92f9c","0c7262dff33c4087bc660ccf40f92f9c",22855392,1,0,1,726,169,169,0
"0c7262dff33c4087bc660ccf40f92f9c","801f9e9135034f49bf5f8b4bdefedb41",22855392,1,9,0,729,169,177,8
"801f9e9135034f49bf5f8b4bdefedb41","801f9e9135034f49bf5f8b4bdefedb41",22855392,11,0,1,730,177,177,0
"801f9e9135034f49bf5f8b4bdefedb41","ea38cc0e6e6e41edbabf210220808bf9",22855392,1,3,0,737,177,179,2
"ea38cc0e6e6e41edbabf210220808bf9","b87c552dd247427abe6ab5795b9c9d43",22855392,5,2,0,738,179,181,2
"b87c552dd247427abe6ab5795b9c9d43","362fcb0699a14845ab29b2340093e528",22855392,3,-8,0,739,181,174,-7
"362fcb0699a14845ab29b2340093e528","139b097acfca451689d80c9c6eebdf7b",22855392,3,5,0,740,174,178,4
"139b097acfca451689d80c9c6eebdf7b","b42cc17b7de840f181a704558d0bc845",22855392,4,-4,0,741,178,175,-3
"b42cc17b7de840f181a704558d0bc845","362fcb0699a14845ab29b2340093e528",22855392,1,-1,0,742,175,174,-1
"362fcb0699a14845ab29b2340093e528","ea38cc0e6e6e41edbabf210220808bf9",22855392,3,6,0,743,174,179,5
"ea38cc0e6e6e41edbabf210220808bf9","362fcb0699a14845ab29b2340093e528",22855392,3,-6,0,744,179,174,-5
"362fcb0699a14845ab29b2340093e528","b87c552dd247427abe6ab5795b9c9d43",22855392,4,8,0,745,174,181,7
"b87c552dd247427abe6ab5795b9c9d43","0c7262dff33c4087bc660ccf40f92f9c",22855392,1,-14,0,746,181,169,-12
"0c7262dff33c4087bc660ccf40f92f9c","139b097acfca451689d80c9c6eebdf7b",22855392,1,11,0,749,169,178,9
"b42cc17b7de840f181a704558d0bc845","b87c552dd247427abe6ab5795b9c9d43",22855392,2,7,0,751,175,181,6
"ea38cc0e6e6e41edbabf210220808bf9","139b097acfca451689d80c9c6eebdf7b",22855392,3,-1,0,754,179,178,-1
"b42cc17b7de840f181a704558d0bc845","801f9e9135034f49bf5f8b4bdefedb41",22855392,1,2,0,756,175,177,2
"801f9e9135034f49bf5f8b4bdefedb41","362fcb0699a14845ab29b2340093e528",22855392,1,-3,0,761,177,174,-3
"b87c552dd247427abe6ab5795b9c9d43","b87c552dd247427abe6ab5795b9c9d43",22855392,8,0,1,766,181,181,0
"b87c552dd247427abe6ab5795b9c9d43","139b097acfca451689d80c9c6eebdf7b",22855392,3,-3,0,774,181,178,-3
"139b097acfca451689d80c9c6eebdf7b","ea38cc0e6e6e41edbabf210220808bf9",22855392,1,1,0,775,178,179,1
"b87c552dd247427abe6ab5795b9c9d43","2024b4885bd14338a39b7b509acbbd02",22855392,2,2,0,777,181,182,1
"2024b4885bd14338a39b7b509acbbd02","0c7262dff33c4087bc660ccf40f92f9c",22855392,2,-16,0,778,182,169,-13
"0c7262dff33c4087bc660ccf40f92f9c","ea38cc0e6e6e41edbabf210220808bf9",22855392,1,12,0,779,169,179,10
"b87c552dd247427abe6ab5795b9c9d43","ea38cc0e6e6e41edbabf210220808bf9",22855392,3,-2,0,784,181,179,-2
"139b097acfca451689d80c9c6eebdf7b","0c7262dff33c4087bc660ccf40f92f9c",22855392,1,-11,0,787,178,169,-9
"0c7262dff33c4087bc660ccf40f92f9c","362fcb0699a14845ab29b2340093e528",22855392,2,6,0,790,169,174,5
"139b097acfca451689d80c9c6eebdf7b","2024b4885bd14338a39b7b509acbbd02",22855392,1,5,0,793,178,182,4
"2024b4885bd14338a39b7b509acbbd02","ea38cc0e6e6e41edbabf210220808bf9",22855392,1,-4,0,794,182,179,-3
"139b097acfca451689d80c9c6eebdf7b","139b097acfca451689d80c9c6eebdf7b",22855392,1,0,1,798,178,178,0
"139b097acfca451689d80c9c6eebdf7b","30f660a1feb34582a739722532524f79",22855392,1,6,0,799,178,183,5
"30f660a1feb34582a739722532524f79","30f660a1feb34582a739722532524f79",22855392,7,0,1,800,183,183,0
"30f660a1feb34582a739722532524f79","2024b4885bd14338a39b7b509acbbd02",22855392,1,-1,0,807,183,182,-1
"2024b4885bd14338a39b7b509acbbd02","cf4c280bad6a43e6b131d8385ef9ef3f",22855392,1,3,0,808,182,184,2
"cf4c280bad6a43e6b131d8385ef9ef3f","b42cc17b7de840f181a704558d0bc845",22855392,1,-12,0,809,184,175,-9
"b42cc17b7de840f181a704558d0bc845","b42cc17b7de840f181a704558d0bc845",22855392,1,0,1,810,175,175,0
"b42cc17b7de840f181a704558d0bc845","ea38cc0e6e6e41edbabf210220808bf9",22855392,1,5,0,811,175,179,4
"139b097acfca451689d80c9c6eebdf7b","c3f63fe50d8e487c86bf8ef76c9cadd3",22855392,1,9,0,816,178,185,7
"c3f63fe50d8e487c86bf8ef76c9cadd3","c3f63fe50d8e487c86bf8ef76c9cadd3",22855392,1,0,1,817,185,185,0
"c3f63fe50d8e487c86bf8ef76c9cadd3","0c7262dff33c4087bc660ccf40f92f9c",22855392,1,-20,0,818,185,169,-16
"0c7262dff33c4087bc660ccf40f92f9c","c8e371568a0c4391b25796ae4e91952e",22855392,2,23,0,819,169,186,17
"c8e371568a0c4391b25796ae4e91952e","7d932b23e1c84326ae5aa4d3c0d813d1",22855392,1,2,0,820,186,188,2
"7d932b23e1c84326ae5aa4d3c0d813d1","7d932b23e1c84326ae5aa4d3c0d813d1",22855392,3,0,1,821,188,188,0
"7d932b23e1c84326ae5aa4d3c0d813d1","ab11d94c6c8948ea90b88f19d2cd502b",22855392,1,3,0,824,188,190,2
"ab11d94c6c8948ea90b88f19d2cd502b","c8e371568a0c4391b25796ae4e91952e",22855392,1,-5,0,825,190,186,-4
"c8e371568a0c4391b25796ae4e91952e","0c7262dff33c4087bc660ccf40f92f9c",22855392,1,-23,0,826,186,169,-17
"139b097acfca451689d80c9c6eebdf7b","b87c552dd247427abe6ab5795b9c9d43",22855392,1,3,0,831,178,181,3
"c8e371568a0c4391b25796ae4e91952e","ab11d94c6c8948ea90b88f19d2cd502b",22855392,1,5,0,841,186,190,4
"ab11d94c6c8948ea90b88f19d2cd502b","ab11d94c6c8948ea90b88f19d2cd502b",22855392,1,0,1,842,190,190,0
"ab11d94c6c8948ea90b88f19d2cd502b","f992451ed6ad4e68bb9e68ad6be7c4be",22855392,1,2,0,843,190,192,2
"f992451ed6ad4e68bb9e68ad6be7c4be","f992451ed6ad4e68bb9e68ad6be7c4be",22855392,1,0,1,844,192,192,0
"f992451ed6ad4e68bb9e68ad6be7c4be","07b44a7a51e94c78b411c753fc39dab0",22855392,1,-3,0,845,192,189,-3
"07b44a7a51e94c78b411c753fc39dab0","6cd2dcaac46847d4a0bc53f296d90375",22855392,1,6,0,846,189,194,5
"6cd2dcaac46847d4a0bc53f296d90375","c8e371568a0c4391b25796ae4e91952e",22855392,1,-10,0,847,194,186,-8
"c8e371568a0c4391b25796ae4e91952e","6cd2dcaac46847d4a0bc53f296d90375",22855392,1,10,0,849,186,194,8
"6cd2dcaac46847d4a0bc53f296d90375","6cd2dcaac46847d4a0bc53f296d90375",22855392,1,0,1,850,194,194,0
"6cd2dcaac46847d4a0bc53f296d90375","017d7ca8e0394b91aaadc9574df2202c",22855392,2,-1,0,851,194,193,-1
"f9170dd6bc6442b4acd832747609b09a","6cd2dcaac46847d4a0bc53f296d90375",22855392,2,-6,0,853,199,194,-5
"6cd2dcaac46847d4a0bc53f296d90375","b54257a550b94ebc9538f3a90eee9d7e",22855392,1,12,0,854,194,204,10
"b54257a550b94ebc9538f3a90eee9d7e","2d2580c9411c4972909db508d6956a58",22855392,1,-10,0,855,204,196,-8
"2d2580c9411c4972909db508d6956a58","2d2580c9411c4972909db508d6956a58",22855392,8,0,1,856,196,196,0
"2d2580c9411c4972909db508d6956a58","5bddb3d9ed264f3984702f048c7e5340",22855392,1,1,0,864,196,197,1
"5bddb3d9ed264f3984702f048c7e5340","5bddb3d9ed264f3984702f048c7e5340",22855392,2,0,1,865,197,197,0
"5bddb3d9ed264f3984702f048c7e5340","d5e8e2bd12a2466b9d6d90855f0eb079",22855392,1,1,0,867,197,198,1
"d5e8e2bd12a2466b9d6d90855f0eb079","d5e8e2bd12a2466b9d6d90855f0eb079",22855392,2,0,1,868,198,198,0
"d5e8e2bd12a2466b9d6d90855f0eb079","017d7ca8e0394b91aaadc9574df2202c",22855392,1,-5,0,870,198,193,-5
"017d7ca8e0394b91aaadc9574df2202c","54e8e9f0ea3e45c4bf3b8ac799ee31b1",22855392,1,8,0,871,193,200,7
"54e8e9f0ea3e45c4bf3b8ac799ee31b1","54e8e9f0ea3e45c4bf3b8ac799ee31b1",22855392,1,0,1,872,200,200,0
"54e8e9f0ea3e45c4bf3b8ac799ee31b1","c614a00911be4877a075f19315530fb0",22855392,1,1,0,873,200,201,1
"c614a00911be4877a075f19315530fb0","c614a00911be4877a075f19315530fb0",22855392,6,0,1,874,201,201,0
"c614a00911be4877a075f19315530fb0","a6c21bd8b95249c7972820a7a7d76aff",22855392,1,1,0,880,201,202,1
"a6c21bd8b95249c7972820a7a7d76aff","a6c21bd8b95249c7972820a7a7d76aff",22855392,1,0,1,881,202,202,0
"a6c21bd8b95249c7972820a7a7d76aff","f9170dd6bc6442b4acd832747609b09a",22855392,1,-3,0,882,202,199,-3
"f9170dd6bc6442b4acd832747609b09a","b54257a550b94ebc9538f3a90eee9d7e",22855392,1,6,0,886,199,204,5
"b54257a550b94ebc9538f3a90eee9d7e","c8e371568a0c4391b25796ae4e91952e",22855392,1,-22,0,887,204,186,-18
"c8e371568a0c4391b25796ae4e91952e","bb329d880ab54120adaf203a693bb203",22855392,1,20,0,890,186,203,17
"bb329d880ab54120adaf203a693bb203","bb329d880ab54120adaf203a693bb203",22855392,1,0,1,891,203,203,0
"bb329d880ab54120adaf203a693bb203","f9170dd6bc6442b4acd832747609b09a",22855392,1,-4,0,892,203,199,-4
"c8e371568a0c4391b25796ae4e91952e","334c2344009840079b1d0e1b7ce3d5a7",22855392,1,23,0,895,186,205,19
"334c2344009840079b1d0e1b7ce3d5a7","334c2344009840079b1d0e1b7ce3d5a7",22855392,1,0,1,896,205,205,0
"334c2344009840079b1d0e1b7ce3d5a7","c8e371568a0c4391b25796ae4e91952e",22855392,1,-23,0,897,205,186,-19
"b9e80f77c3a44349863b19875725c384","b9e80f77c3a44349863b19875725c384",22855392,26,0,1,902,207,207,0
"7108f0e4c2584f1f9c471689ae4c885c","7108f0e4c2584f1f9c471689ae4c885c",22855392,16,0,1,929,208,208,0
"d7f13c8d63ec4e2aa673fbb9cf9c6933","09400e101c5d4b439cf9a26b03aae558",22855392,2,5,0,946,206,210,4
"09400e101c5d4b439cf9a26b03aae558","d7f13c8d63ec4e2aa673fbb9cf9c6933",22855392,1,-5,0,947,210,206,-4
"09400e101c5d4b439cf9a26b03aae558","09400e101c5d4b439cf9a26b03aae558",22855392,1,0,1,949,210,210,0
"09400e101c5d4b439cf9a26b03aae558","a88efa7e50ce47159810ab553afa6d3a",22855392,1,2,0,950,210,212,2
"a88efa7e50ce47159810ab553afa6d3a","a88efa7e50ce47159810ab553afa6d3a",22855392,5,0,1,951,212,212,0
"a88efa7e50ce47159810ab553afa6d3a","be502a7a43c44bf7b682698de79d9369",22855392,1,3,0,956,212,214,2
"be502a7a43c44bf7b682698de79d9369","f7fb1952f56b4189b86a9f8b7862d2b8",22855392,2,1,0,957,214,215,1
"f7fb1952f56b4189b86a9f8b7862d2b8","a875096404ef4a9984b62d74cda916f9",22855392,1,-7,0,958,215,209,-6
"a875096404ef4a9984b62d74cda916f9","be502a7a43c44bf7b682698de79d9369",22855392,1,6,0,959,209,214,5
"f7fb1952f56b4189b86a9f8b7862d2b8","f7fb1952f56b4189b86a9f8b7862d2b8",22855392,15,0,1,961,215,215,0
"f7fb1952f56b4189b86a9f8b7862d2b8","b860ee85d8bc4a2f97958cfb71be3533",22855392,1,1,0,976,215,216,1
"b860ee85d8bc4a2f97958cfb71be3533","b860ee85d8bc4a2f97958cfb71be3533",22855392,2,0,1,977,216,216,0
"b860ee85d8bc4a2f97958cfb71be3533","363837c182e04711840d896ae1e0339c",22855392,1,3,0,979,216,218,2
"363837c182e04711840d896ae1e0339c","363837c182e04711840d896ae1e0339c",22855392,17,0,1,982,218,218,0
"01b2051f8941460d89945e3b02d1ce78","be95c065e45447c1bd8215ea6f130c7a",22855392,1,3,0,1000,217,219,2
"be95c065e45447c1bd8215ea6f130c7a","363837c182e04711840d896ae1e0339c",22855392,1,-2,0,1001,219,218,-1
"363837c182e04711840d896ae1e0339c","01b2051f8941460d89945e3b02d1ce78",22855392,3,-1,0,1002,218,217,-1
"01b2051f8941460d89945e3b02d1ce78","91125ca626c5470eb145501f8c37f8db",22855392,1,4,0,1003,217,220,3
"91125ca626c5470eb145501f8c37f8db","91125ca626c5470eb145501f8c37f8db",22855392,1,0,1,1004,220,220,0
"91125ca626c5470eb145501f8c37f8db","f7fb1952f56b4189b86a9f8b7862d2b8",22855392,1,-7,0,1005,220,215,-5
"f7fb1952f56b4189b86a9f8b7862d2b8","be95c065e45447c1bd8215ea6f130c7a",22855392,1,6,0,1006,215,219,4
"be95c065e45447c1bd8215ea6f130c7a","be502a7a43c44bf7b682698de79d9369",22855392,1,-7,0,1007,219,214,-5
"be502a7a43c44bf7b682698de79d9369","be502a7a43c44bf7b682698de79d9369",22855392,2,0,1,1008,214,214,0
"be502a7a43c44bf7b682698de79d9369","363837c182e04711840d896ae1e0339c",22855392,1,5,0,1010,214,218,4
"363837c182e04711840d896ae1e0339c","ec341f459285443b8361f7f15638ff08",22855392,2,-6,0,1011,218,213,-5
"ec341f459285443b8361f7f15638ff08","01b2051f8941460d89945e3b02d1ce78",22855392,1,5,0,1012,213,217,4
"01b2051f8941460d89945e3b02d1ce78","d7f13c8d63ec4e2aa673fbb9cf9c6933",22855392,1,-14,0,1013,217,206,-11
"d7f13c8d63ec4e2aa673fbb9cf9c6933","1c6721b1f63f4d30ba7746ea8af02a52",22855392,4,21,0,1014,206,221,15
"1c6721b1f63f4d30ba7746ea8af02a52","d03cb855c70044cf8c35d9ec0de696e3",22855392,4,4,0,1015,221,224,3
"d03cb855c70044cf8c35d9ec0de696e3","1c6721b1f63f4d30ba7746ea8af02a52",22855392,5,-4,0,1016,224,221,-3
"1c6721b1f63f4d30ba7746ea8af02a52","77ecef8eff6b4a2caea7707669bf7475",22855392,6,1,0,1017,221,222,1
"77ecef8eff6b4a2caea7707669bf7475","8b9ae98743bd4d4a8a87dff1c1244211",22855392,4,6,0,1018,222,227,5
"8b9ae98743bd4d4a8a87dff1c1244211","d03cb855c70044cf8c35d9ec0de696e3",22855392,5,-3,0,1019,227,224,-3
"d03cb855c70044cf8c35d9ec0de696e3","a49a937d6896486d9a5396654abcf2e1",22855392,1,2,0,1020,224,226,2
"a49a937d6896486d9a5396654abcf2e1","a49a937d6896486d9a5396654abcf2e1",22855392,1,0,1,1021,226,226,0
"a49a937d6896486d9a5396654abcf2e1","8b9ae98743bd4d4a8a87dff1c1244211",22855392,1,1,0,1022,226,227,1
"8b9ae98743bd4d4a8a87dff1c1244211","8b9ae98743bd4d4a8a87dff1c1244211",22855392,23,0,1,1023,227,227,0
"8b9ae98743bd4d4a8a87dff1c1244211","f7906d6f59b9489a91d2ef40db5a474d",22855392,4,-4,0,1046,227,223,-4
"f7906d6f59b9489a91d2ef40db5a474d","2ab1535aac1346ba8801535bf729ef37",22855392,2,7,0,1047,223,229,6
"2ab1535aac1346ba8801535bf729ef37","2ab1535aac1346ba8801535bf729ef37",22855392,1,0,1,1048,229,229,0
"2ab1535aac1346ba8801535bf729ef37","a4f40fb48a8542c8949bae1f002cd9bc",22855392,1,2,0,1049,229,231,2
"a4f40fb48a8542c8949bae1f002cd9bc","a4f40fb48a8542c8949bae1f002cd9bc",22855392,8,0,1,1050,231,231,0
"a4f40fb48a8542c8949bae1f002cd9bc","8972c23e32044edb8a78fa1eed4e5947",22855392,1,1,0,1058,231,232,1
"8972c23e32044edb8a78fa1eed4e5947","8972c23e32044edb8a78fa1eed4e5947",22855392,3,0,1,1059,232,232,0
"8972c23e32044edb8a78fa1eed4e5947","92feb4a40f8344d38b6f722e42a53295",22855392,1,1,0,1062,232,233,1
"92feb4a40f8344d38b6f722e42a53295","92feb4a40f8344d38b6f722e42a53295",22855392,2,0,1,1063,233,233,0
"92feb4a40f8344d38b6f722e42a53295","5152833676bf4c6cb317060be10f68db",22855392,1,-5,0,1065,233,228,-5
"5152833676bf4c6cb317060be10f68db","0b04c8e2f86d48c7aeb7e225819cd32b",22855392,3,7,0,1066,228,234,6
"0b04c8e2f86d48c7aeb7e225819cd32b","77ecef8eff6b4a2caea7707669bf7475",22855392,1,-15,0,1067,234,222,-12
"77ecef8eff6b4a2caea7707669bf7475","77ecef8eff6b4a2caea7707669bf7475",22855392,28,0,1,1068,222,222,0
"77ecef8eff6b4a2caea7707669bf7475","1c6721b1f63f4d30ba7746ea8af02a52",22855392,10,-1,0,1080,222,221,-1
"1c6721b1f63f4d30ba7746ea8af02a52","8b9ae98743bd4d4a8a87dff1c1244211",22855392,6,7,0,1081,221,227,6
"d03cb855c70044cf8c35d9ec0de696e3","f7906d6f59b9489a91d2ef40db5a474d",22855392,2,-1,0,1083,224,223,-1
"f7906d6f59b9489a91d2ef40db5a474d","77ecef8eff6b4a2caea7707669bf7475",22855392,4,-2,0,1084,223,222,-1
"1c6721b1f63f4d30ba7746ea8af02a52","d7f13c8d63ec4e2aa673fbb9cf9c6933",22855392,6,-21,0,1086,221,206,-15
"d7f13c8d63ec4e2aa673fbb9cf9c6933","77ecef8eff6b4a2caea7707669bf7475",22855392,4,22,0,1089,206,222,16
"77ecef8eff6b4a2caea7707669bf7475","d03cb855c70044cf8c35d9ec0de696e3",22855392,4,3,0,1090,222,224,2
"d03cb855c70044cf8c35d9ec0de696e3","8b9ae98743bd4d4a8a87dff1c1244211",22855392,3,3,0,1091,224,227,3
"8b9ae98743bd4d4a8a87dff1c1244211","1c6721b1f63f4d30ba7746ea8af02a52",22855392,3,-7,0,1092,227,221,-6
"1c6721b1f63f4d30ba7746ea8af02a52","2ab1535aac1346ba8801535bf729ef37",22855392,1,10,0,1093,221,229,8
"2ab1535aac1346ba8801535bf729ef37","f7906d6f59b9489a91d2ef40db5a474d",22855392,3,-7,0,1094,229,223,-6
"2ab1535aac1346ba8801535bf729ef37","5152833676bf4c6cb317060be10f68db",22855392,1,-1,0,1096,229,228,-1
"5152833676bf4c6cb317060be10f68db","2ab1535aac1346ba8801535bf729ef37",22855392,1,1,0,1097,228,229,1
"2ab1535aac1346ba8801535bf729ef37","0b04c8e2f86d48c7aeb7e225819cd32b",22855392,1,6,0,1098,229,234,5
"0b04c8e2f86d48c7aeb7e225819cd32b","5152833676bf4c6cb317060be10f68db",22855392,1,-7,0,1099,234,228,-6
"5152833676bf4c6cb317060be10f68db","77ecef8eff6b4a2caea7707669bf7475",22855392,1,-8,0,1100,228,222,-6
"1c6721b1f63f4d30ba7746ea8af02a52","1c6721b1f63f4d30ba7746ea8af02a52",22855392,3,0,1,1111,221,221,0
"1c6721b1f63f4d30ba7746ea8af02a52","0b04c8e2f86d48c7aeb7e225819cd32b",22855392,1,16,0,1112,221,234,13
"0b04c8e2f86d48c7aeb7e225819cd32b","ca3e28f290354c08aefe5b0f769604e6",22855392,1,1,0,1113,234,235,1
"ca3e28f290354c08aefe5b0f769604e6","ca3e28f290354c08aefe5b0f769604e6",22855392,4,0,1,1114,235,235,0
"ca3e28f290354c08aefe5b0f769604e6","79a35eea833e4c2c9d22fc53c3c6445c",22855392,1,1,0,1118,235,236,1
"79a35eea833e4c2c9d22fc53c3c6445c","79a35eea833e4c2c9d22fc53c3c6445c",22855392,9,0,1,1119,236,236,0
"79a35eea833e4c2c9d22fc53c3c6445c","8f68228b1518449e9615cdafee41a2bd",22855392,1,1,0,1128,236,237,1
"8f68228b1518449e9615cdafee41a2bd","8f68228b1518449e9615cdafee41a2bd",22855392,1,0,1,1129,237,237,0
"8f68228b1518449e9615cdafee41a2bd","cab89fa5c3ed45a5aa550fc0352d6a42",22855392,1,1,0,1130,237,238,1
"cab89fa5c3ed45a5aa550fc0352d6a42","cab89fa5c3ed45a5aa550fc0352d6a42",22855392,6,0,1,1131,238,238,0
"cab89fa5c3ed45a5aa550fc0352d6a42","1c6721b1f63f4d30ba7746ea8af02a52",22855392,1,-20,0,1137,238,221,-17
"f7906d6f59b9489a91d2ef40db5a474d","66d4fad4f1cf4b46be0750a99ad7a35a",22855392,1,18,0,1155,223,239,16
"66d4fad4f1cf4b46be0750a99ad7a35a","66d4fad4f1cf4b46be0750a99ad7a35a",22855392,1,0,1,1156,239,239,0
"66d4fad4f1cf4b46be0750a99ad7a35a","0b04c8e2f86d48c7aeb7e225819cd32b",22855392,1,-5,0,1157,239,234,-5
"0b04c8e2f86d48c7aeb7e225819cd32b","64dbedb3ce544f6aae8e10e0cf10f16d",22855392,2,7,0,1158,234,240,6
"64dbedb3ce544f6aae8e10e0cf10f16d","64dbedb3ce544f6aae8e10e0cf10f16d",22855392,1,0,1,1159,240,240,0
"64dbedb3ce544f6aae8e10e0cf10f16d","0b04c8e2f86d48c7aeb7e225819cd32b",22855392,1,-7,0,1160,240,234,-6
"64dbedb3ce544f6aae8e10e0cf10f16d","77ecef8eff6b4a2caea7707669bf7475",22855392,4,-22,0,1162,240,222,-18
"1c6721b1f63f4d30ba7746ea8af02a52","f53da5fd9bfe412da4b80d4742563b6c",22855392,1,24,0,1184,221,241,20
"f53da5fd9bfe412da4b80d4742563b6c","f53da5fd9bfe412da4b80d4742563b6c",22855392,1,0,1,1185,241,241,0
"f53da5fd9bfe412da4b80d4742563b6c","64dbedb3ce544f6aae8e10e0cf10f16d",22855392,1,-1,0,1186,241,240,-1
"77ecef8eff6b4a2caea7707669bf7475","f7906d6f59b9489a91d2ef40db5a474d",22855392,2,2,0,1192,222,223,1
"f7906d6f59b9489a91d2ef40db5a474d","1c6721b1f63f4d30ba7746ea8af02a52",22855392,2,-3,0,1193,223,221,-2
"8b9ae98743bd4d4a8a87dff1c1244211","2ab1535aac1346ba8801535bf729ef37",22855392,1,3,0,1196,227,229,2
"1c6721b1f63f4d30ba7746ea8af02a52","64dbedb3ce544f6aae8e10e0cf10f16d",22855392,2,23,0,1199,221,240,19
"8b9ae98743bd4d4a8a87dff1c1244211","c8e371568a0c4391b25796ae4e91952e",22855392,1,-54,0,1207,227,186,-41
"c8e371568a0c4391b25796ae4e91952e","c8e371568a0c4391b25796ae4e91952e",22855392,11,0,1,1208,186,186,0
"c8e371568a0c4391b25796ae4e91952e","07b44a7a51e94c78b411c753fc39dab0",22855392,1,4,0,1209,186,189,3
"07b44a7a51e94c78b411c753fc39dab0","017d7ca8e0394b91aaadc9574df2202c",22855392,1,5,0,1210,189,193,4
"017d7ca8e0394b91aaadc9574df2202c","f9170dd6bc6442b4acd832747609b09a",22855392,3,7,0,1211,193,199,6
"f9170dd6bc6442b4acd832747609b09a","c8e371568a0c4391b25796ae4e91952e",22855392,2,-16,0,1212,199,186,-13
"c8e371568a0c4391b25796ae4e91952e","d7f13c8d63ec4e2aa673fbb9cf9c6933",22855392,2,26,0,1213,186,206,20
"d7f13c8d63ec4e2aa673fbb9cf9c6933","d7f13c8d63ec4e2aa673fbb9cf9c6933",22855392,1,0,1,1214,206,206,0
"d7f13c8d63ec4e2aa673fbb9cf9c6933","b9e80f77c3a44349863b19875725c384",22855392,2,1,0,1215,206,207,1
"b9e80f77c3a44349863b19875725c384","7108f0e4c2584f1f9c471689ae4c885c",22855392,3,1,0,1216,207,208,1
"7108f0e4c2584f1f9c471689ae4c885c","d7f13c8d63ec4e2aa673fbb9cf9c6933",22855392,2,-2,0,1217,208,206,-2
"d7f13c8d63ec4e2aa673fbb9cf9c6933","a875096404ef4a9984b62d74cda916f9",22855392,1,4,0,1218,206,209,3
"a875096404ef4a9984b62d74cda916f9","f7fb1952f56b4189b86a9f8b7862d2b8",22855392,1,7,0,1219,209,215,6
"f7fb1952f56b4189b86a9f8b7862d2b8","ec341f459285443b8361f7f15638ff08",22855392,1,-2,0,1220,215,213,-2
"ec341f459285443b8361f7f15638ff08","363837c182e04711840d896ae1e0339c",22855392,2,6,0,1221,213,218,5
"01b2051f8941460d89945e3b02d1ce78","1c6721b1f63f4d30ba7746ea8af02a52",22855392,1,7,0,1223,217,221,4
"1c6721b1f63f4d30ba7746ea8af02a52","f7906d6f59b9489a91d2ef40db5a474d",22855392,1,3,0,1228,221,223,2
"f7906d6f59b9489a91d2ef40db5a474d","5152833676bf4c6cb317060be10f68db",22855392,2,6,0,1229,223,228,5
"0b04c8e2f86d48c7aeb7e225819cd32b","1c6721b1f63f4d30ba7746ea8af02a52",22855392,2,-16,0,1231,234,221,-13
"1c6721b1f63f4d30ba7746ea8af02a52","2ae94c0cea4d480a9d5dca8fb1d7b542",22855392,2,27,0,1232,221,242,21
"2ae94c0cea4d480a9d5dca8fb1d7b542","1ebf23f9d994469a85206e4c7b1bf5f5",22855392,3,3,0,1233,242,245,3
"1ebf23f9d994469a85206e4c7b1bf5f5","1c6721b1f63f4d30ba7746ea8af02a52",22855392,1,-30,0,1234,245,221,-24
"77ecef8eff6b4a2caea7707669bf7475","64dbedb3ce544f6aae8e10e0cf10f16d",22855392,1,22,0,1236,222,240,18
"64dbedb3ce544f6aae8e10e0cf10f16d","1c6721b1f63f4d30ba7746ea8af02a52",22855392,1,-23,0,1237,240,221,-19
"d03cb855c70044cf8c35d9ec0de696e3","77ecef8eff6b4a2caea7707669bf7475",22855392,1,-3,0,1240,224,222,-2
"f7906d6f59b9489a91d2ef40db5a474d","d7f13c8d63ec4e2aa673fbb9cf9c6933",22855392,1,-24,0,1242,223,206,-17
"d03cb855c70044cf8c35d9ec0de696e3","2ab1535aac1346ba8801535bf729ef37",22855392,1,6,0,1250,224,229,5
"1ebf23f9d994469a85206e4c7b1bf5f5","1ebf23f9d994469a85206e4c7b1bf5f5",22855392,10,0,1,1257,245,245,0
"1ebf23f9d994469a85206e4c7b1bf5f5","85ae675b83e8422da842cfd25596af99",22855392,1,1,0,1267,245,246,1
"85ae675b83e8422da842cfd25596af99","85ae675b83e8422da842cfd25596af99",22855392,3,0,1,1268,246,246,0
"85ae675b83e8422da842cfd25596af99","2ae94c0cea4d480a9d5dca8fb1d7b542",22855392,1,-4,0,1271,246,242,-4
"2ae94c0cea4d480a9d5dca8fb1d7b542","fa235f0f364d47e4ae1c87f47bf8e6ba",22855392,1,12,0,1272,242,252,10
"fa235f0f364d47e4ae1c87f47bf8e6ba","2ae94c0cea4d480a9d5dca8fb1d7b542",22855392,1,-12,0,1273,252,242,-10
"2ae94c0cea4d480a9d5dca8fb1d7b542","00f61990949545828dd12f1303d47504",22855392,1,17,0,1274,242,256,14
"00f61990949545828dd12f1303d47504","d546341988904f069cfa86b21457d9d9",22855392,1,-6,0,1275,256,251,-5
"d546341988904f069cfa86b21457d9d9","fa235f0f364d47e4ae1c87f47bf8e6ba",22855392,1,1,0,1276,251,252,1
"fa235f0f364d47e4ae1c87f47bf8e6ba","fa235f0f364d47e4ae1c87f47bf8e6ba",22855392,1,0,1,1277,252,252,0
"fa235f0f364d47e4ae1c87f47bf8e6ba","79f7845465cc4ed19d8e4f1429541be0",22855392,1,2,0,1278,252,254,2
"79f7845465cc4ed19d8e4f1429541be0","79f7845465cc4ed19d8e4f1429541be0",22855392,2,0,1,1279,254,254,0
"79f7845465cc4ed19d8e4f1429541be0","00f61990949545828dd12f1303d47504",22855392,1,3,0,1281,254,256,2
"00f61990949545828dd12f1303d47504","6e83e23f56544a19b94067c1c558d9c0",22855392,2,-11,0,1282,256,247,-9
"6e83e23f56544a19b94067c1c558d9c0","00f61990949545828dd12f1303d47504",22855392,1,11,0,1283,247,256,9
"00f61990949545828dd12f1303d47504","ead7bb4b64e247d2ae632ab8a296b091",22855392,1,2,0,1284,256,258,2
"ead7bb4b64e247d2ae632ab8a296b091","ead7bb4b64e247d2ae632ab8a296b091",22855392,2,0,1,1285,258,258,0
"ead7bb4b64e247d2ae632ab8a296b091","41b0048dde734bb280bac6116baa8e27",22855392,1,1,0,1287,258,259,1
"41b0048dde734bb280bac6116baa8e27","41b0048dde734bb280bac6116baa8e27",22855392,5,0,1,1288,259,259,0
"41b0048dde734bb280bac6116baa8e27","b41c5a094a604ee0915327da5cc0beb7",22855392,1,1,0,1293,259,260,1
"b41c5a094a604ee0915327da5cc0beb7","b41c5a094a604ee0915327da5cc0beb7",22855392,2,0,1,1294,260,260,0
"b41c5a094a604ee0915327da5cc0beb7","d546341988904f069cfa86b21457d9d9",22855392,1,-10,0,1296,260,251,-9
"d546341988904f069cfa86b21457d9d9","28c171777c52431ab6b925073bd63d46",22855392,1,15,0,1297,251,264,13
"28c171777c52431ab6b925073bd63d46","28c171777c52431ab6b925073bd63d46",22855392,7,0,1,1298,264,264,0
"28c171777c52431ab6b925073bd63d46","ac160db940cb49ae8579162b1d52bb5d",22855392,1,2,0,1305,264,266,2
"ac160db940cb49ae8579162b1d52bb5d","ac160db940cb49ae8579162b1d52bb5d",22855392,7,0,1,1306,266,266,0
"ac160db940cb49ae8579162b1d52bb5d","d989ebcfc12a4b669f0100dc1aa14f1e",22855392,1,-12,0,1313,266,255,-11
"d989ebcfc12a4b669f0100dc1aa14f1e","c6fd49b485cc4874b0bbdd9c6171e09c",22855392,1,15,0,1314,255,268,13
"c6fd49b485cc4874b0bbdd9c6171e09c","c6fd49b485cc4874b0bbdd9c6171e09c",22855392,7,0,1,1315,268,268,0
"c6fd49b485cc4874b0bbdd9c6171e09c","44240778a97c4af0937817499b75707b",22855392,1,1,0,1322,268,269,1
"44240778a97c4af0937817499b75707b","44240778a97c4af0937817499b75707b",22855392,2,0,1,1323,269,269,0
"44240778a97c4af0937817499b75707b","7aa76d3e993840d8805f097cbdbcd44b",22855392,1,-9,0,1325,269,261,-8
"7aa76d3e993840d8805f097cbdbcd44b","865a4d3b43374da7944dc7d397f566d9",22855392,1,12,0,1326,261,271,10
"865a4d3b43374da7944dc7d397f566d9","865a4d3b43374da7944dc7d397f566d9",22855392,1,0,1,1327,271,271,0
"865a4d3b43374da7944dc7d397f566d9","0d987bed3ffa4ed0b9a2e62e97b7b30f",22855392,1,3,0,1328,271,272,1
"0d987bed3ffa4ed0b9a2e62e97b7b30f","2ae94c0cea4d480a9d5dca8fb1d7b542",22855392,4,-38,0,1329,272,242,-30
"2ae94c0cea4d480a9d5dca8fb1d7b542","0d987bed3ffa4ed0b9a2e62e97b7b30f",22855392,5,38,0,1330,242,272,30
"0d987bed3ffa4ed0b9a2e62e97b7b30f","82ae07bc0c9b4570a41799290d1ef399",22855392,3,4,0,1331,272,275,3
"82ae07bc0c9b4570a41799290d1ef399","0d987bed3ffa4ed0b9a2e62e97b7b30f",22855392,2,-4,0,1332,275,272,-3
"82ae07bc0c9b4570a41799290d1ef399","2ae94c0cea4d480a9d5dca8fb1d7b542",22855392,1,-42,0,1334,275,242,-33
"0d987bed3ffa4ed0b9a2e62e97b7b30f","7028800abe7d4e27b613d1d6cbe26bf7",22855392,1,-8,0,1336,272,267,-5
"7028800abe7d4e27b613d1d6cbe26bf7","7aa76d3e993840d8805f097cbdbcd44b",22855392,1,-7,0,1337,267,261,-6
"7aa76d3e993840d8805f097cbdbcd44b","0d987bed3ffa4ed0b9a2e62e97b7b30f",22855392,1,15,0,1338,261,272,11
"0d987bed3ffa4ed0b9a2e62e97b7b30f","bb5a47f5ea01454a8b79455422d3b9da",22855392,13,10,0,1341,272,280,8
"bb5a47f5ea01454a8b79455422d3b9da","bb5a47f5ea01454a8b79455422d3b9da",22855392,151,0,1,1342,280,280,0
"bb5a47f5ea01454a8b79455422d3b9da","82ae07bc0c9b4570a41799290d1ef399",22855392,2,-6,0,1345,280,275,-5
"82ae07bc0c9b4570a41799290d1ef399","bb5a47f5ea01454a8b79455422d3b9da",22855392,2,6,0,1346,275,280,5
"bb5a47f5ea01454a8b79455422d3b9da","2ae94c0cea4d480a9d5dca8fb1d7b542",22855392,1,-48,0,1350,280,242,-38
"1ebf23f9d994469a85206e4c7b1bf5f5","0d987bed3ffa4ed0b9a2e62e97b7b30f",22855392,1,35,0,1352,245,272,27
"bb5a47f5ea01454a8b79455422d3b9da","bc5524e78a8544e2ae2fdc2f3462bbec",22855392,1,-1,0,1361,280,279,-1
"bc5524e78a8544e2ae2fdc2f3462bbec","0d987bed3ffa4ed0b9a2e62e97b7b30f",22855392,1,-9,0,1362,279,272,-7
"0d987bed3ffa4ed0b9a2e62e97b7b30f","0d987bed3ffa4ed0b9a2e62e97b7b30f",22855392,1,0,1,1363,272,272,0
"bb5a47f5ea01454a8b79455422d3b9da","0d987bed3ffa4ed0b9a2e62e97b7b30f",22855392,2,-10,0,1390,280,272,-8
"0d987bed3ffa4ed0b9a2e62e97b7b30f","94cecc3f1e7d484b8e068e79241dfd73",22855392,2,13,0,1391,272,281,9
"94cecc3f1e7d484b8e068e79241dfd73","a37477c4e4c14169ad44b06b493007f6",22855392,7,2,0,1392,281,283,2
"a37477c4e4c14169ad44b06b493007f6","94cecc3f1e7d484b8e068e79241dfd73",22855392,3,-2,0,1393,283,281,-2
"a37477c4e4c14169ad44b06b493007f6","3cbcea2be0984e7dbd5a48195af10ce7",22855392,1,-159,0,1397,283,165,-118
"3cbcea2be0984e7dbd5a48195af10ce7","82e6285962b8400d9d6fc32436022a94",22855392,6,2,0,1398,165,167,2
"82e6285962b8400d9d6fc32436022a94","3cbcea2be0984e7dbd5a48195af10ce7",22855392,3,-2,0,1399,167,165,-2
"3cbcea2be0984e7dbd5a48195af10ce7","94cecc3f1e7d484b8e068e79241dfd73",22855392,1,157,0,1402,165,281,116
"94cecc3f1e7d484b8e068e79241dfd73","4a29443515bb404cb8924e1c60a63b73",22855392,1,9,0,1405,281,285,4
"4a29443515bb404cb8924e1c60a63b73","208c9b2796c944db8dacaa96082520ea",22855392,4,3,0,1406,285,288,3
"208c9b2796c944db8dacaa96082520ea","208c9b2796c944db8dacaa96082520ea",22855392,1,0,1,1407,288,288,0
"208c9b2796c944db8dacaa96082520ea","4a29443515bb404cb8924e1c60a63b73",22855392,3,-3,0,1408,288,285,-3
"4a29443515bb404cb8924e1c60a63b73","7669a956527947d0add87455277e80b4",22855392,1,7,0,1409,285,291,6
"7669a956527947d0add87455277e80b4","7669a956527947d0add87455277e80b4",22855392,1,0,1,1410,291,291,0
"7669a956527947d0add87455277e80b4","869e967078f04da18dd0b0b9389a7424",22855392,1,3,0,1411,291,293,2
"869e967078f04da18dd0b0b9389a7424","6a9a3b5bde4a48daa896fe8c06eca56f",22855392,2,-5,0,1412,293,289,-4
"6a9a3b5bde4a48daa896fe8c06eca56f","869e967078f04da18dd0b0b9389a7424",22855392,1,5,0,1413,289,293,4
"869e967078f04da18dd0b0b9389a7424","869e967078f04da18dd0b0b9389a7424",22855392,7,0,1,1414,293,293,0
"869e967078f04da18dd0b0b9389a7424","51ab6291537748fab90d519aa09889d6",22855392,1,2,0,1421,293,295,2
"51ab6291537748fab90d519aa09889d6","51ab6291537748fab90d519aa09889d6",22855392,11,0,1,1422,295,295,0
"51ab6291537748fab90d519aa09889d6","34a6e49023fc4465bd5ca604330bbd1c",22855392,1,-3,0,1433,295,292,-3
"34a6e49023fc4465bd5ca604330bbd1c","ba0e59461bfb4a44b7b1c28a01f8d3b3",22855392,2,9,0,1434,292,299,7
"ba0e59461bfb4a44b7b1c28a01f8d3b3","21592f2a9e9c4b2f8c66ec5dbcbf6a2b",22855392,2,-4,0,1435,299,296,-3
"21592f2a9e9c4b2f8c66ec5dbcbf6a2b","4a29443515bb404cb8924e1c60a63b73",22855392,1,-14,0,1436,296,285,-11
"4a29443515bb404cb8924e1c60a63b73","ba0e59461bfb4a44b7b1c28a01f8d3b3",22855392,1,18,0,1437,285,299,14
"ba0e59461bfb4a44b7b1c28a01f8d3b3","ba0e59461bfb4a44b7b1c28a01f8d3b3",22855392,1,0,1,1438,299,299,0
"ba0e59461bfb4a44b7b1c28a01f8d3b3","0e0b36e731a645e7b1b8a88f5031ca38",22855392,1,2,0,1439,299,301,2
"0e0b36e731a645e7b1b8a88f5031ca38","0e0b36e731a645e7b1b8a88f5031ca38",22855392,2,0,1,1440,301,301,0
"0e0b36e731a645e7b1b8a88f5031ca38","a66a144637284c21afc6de17fea4bfb8",22855392,1,1,0,1442,301,302,1
"a66a144637284c21afc6de17fea4bfb8","a66a144637284c21afc6de17fea4bfb8",22855392,2,0,1,1443,302,302,0
"a66a144637284c21afc6de17fea4bfb8","7646a919d7e64fa990bca9b024ff089d",22855392,1,-4,0,1445,302,298,-4
"7646a919d7e64fa990bca9b024ff089d","e390b575229748ea8aac9364efe2bf00",22855392,1,7,0,1446,298,304,6
"e390b575229748ea8aac9364efe2bf00","e390b575229748ea8aac9364efe2bf00",22855392,1,0,1,1447,304,304,0
"e390b575229748ea8aac9364efe2bf00","3434c10e561d488a914e0f7d71907abd",22855392,1,3,0,1448,304,305,1
"3434c10e561d488a914e0f7d71907abd","4a29443515bb404cb8924e1c60a63b73",22855392,6,-27,0,1449,305,285,-20
"4a29443515bb404cb8924e1c60a63b73","53e7e900392747ccad52e711ab0f80d8",22855392,3,29,0,1450,285,307,22
"53e7e900392747ccad52e711ab0f80d8","53e7e900392747ccad52e711ab0f80d8",22855392,11,0,1,1451,307,307,0
"53e7e900392747ccad52e711ab0f80d8","130acc2aeb0448fdbb2de63bc5cebe5b",22855392,3,3,0,1452,307,309,2
"130acc2aeb0448fdbb2de63bc5cebe5b","3434c10e561d488a914e0f7d71907abd",22855392,3,-5,0,1453,309,305,-4
"3434c10e561d488a914e0f7d71907abd","53e7e900392747ccad52e711ab0f80d8",22855392,4,2,0,1454,305,307,2
"53e7e900392747ccad52e711ab0f80d8","141c0df6cd1946539aadd1c9b7068cd4",22855392,2,2,0,1455,307,308,1
"141c0df6cd1946539aadd1c9b7068cd4","53e7e900392747ccad52e711ab0f80d8",22855392,2,-2,0,1456,308,307,-1
"3434c10e561d488a914e0f7d71907abd","130acc2aeb0448fdbb2de63bc5cebe5b",22855392,4,5,0,1462,305,309,4
"130acc2aeb0448fdbb2de63bc5cebe5b","9c062b3251034ebe90f5054e2a3b5120",22855392,1,2,0,1463,309,311,2
"9c062b3251034ebe90f5054e2a3b5120","9c062b3251034ebe90f5054e2a3b5120",22855392,2,0,1,1464,311,311,0
"9c062b3251034ebe90f5054e2a3b5120","ea859f8207e44537889daeaba13ac2e8",22855392,1,1,0,1466,311,312,1
"ea859f8207e44537889daeaba13ac2e8","ea859f8207e44537889daeaba13ac2e8",22855392,1,0,1,1467,312,312,0
"ea859f8207e44537889daeaba13ac2e8","56d94971a7a94257aa330183a8ebd0ea",22855392,1,1,0,1468,312,313,1
"56d94971a7a94257aa330183a8ebd0ea","56d94971a7a94257aa330183a8ebd0ea",22855392,1,0,1,1469,313,313,0
"56d94971a7a94257aa330183a8ebd0ea","141c0df6cd1946539aadd1c9b7068cd4",22855392,1,-5,0,1470,313,308,-5
"141c0df6cd1946539aadd1c9b7068cd4","13255e63e0aa4abf85e5211bf613d43e",22855392,1,10,0,1471,308,317,9
"13255e63e0aa4abf85e5211bf613d43e","13255e63e0aa4abf85e5211bf613d43e",22855392,1,0,1,1472,317,317,0
"13255e63e0aa4abf85e5211bf613d43e","0c787d16c9504873b1a4d903cec09948",22855392,1,-3,0,1473,317,314,-3
"0c787d16c9504873b1a4d903cec09948","86c27d40179e419c8e9d150fb6afa5d0",22855392,2,6,0,1474,314,319,5
"86c27d40179e419c8e9d150fb6afa5d0","86c27d40179e419c8e9d150fb6afa5d0",22855392,3,0,1,1475,319,319,0
"86c27d40179e419c8e9d150fb6afa5d0","8d7e0b55cf9849cda222a0f2440cec55",22855392,3,-1,0,1476,319,318,-1
"8d7e0b55cf9849cda222a0f2440cec55","24f1363179ad4aaa965484a78471912b",22855392,2,6,0,1477,318,323,5
"24f1363179ad4aaa965484a78471912b","47edbb64109243e6b0f8f64cdef90c6c",22855392,2,3,0,1478,323,326,3
"47edbb64109243e6b0f8f64cdef90c6c","24f1363179ad4aaa965484a78471912b",22855392,2,-3,0,1479,326,323,-3
"24f1363179ad4aaa965484a78471912b","3628bdce1dd2429ba924d2d4d09448d2",22855392,2,-1,0,1480,323,322,-1
"3628bdce1dd2429ba924d2d4d09448d2","43ea1b823a4b4e51b7c694c10725db82",22855392,1,6,0,1481,322,327,5
"43ea1b823a4b4e51b7c694c10725db82","86c27d40179e419c8e9d150fb6afa5d0",22855392,2,-10,0,1482,327,319,-8
"86c27d40179e419c8e9d150fb6afa5d0","43ea1b823a4b4e51b7c694c10725db82",22855392,1,10,0,1483,319,327,8
"47edbb64109243e6b0f8f64cdef90c6c","3628bdce1dd2429ba924d2d4d09448d2",22855392,1,-4,0,1490,326,322,-4
"3628bdce1dd2429ba924d2d4d09448d2","53e7e900392747ccad52e711ab0f80d8",22855392,1,-19,0,1491,322,307,-15
"3434c10e561d488a914e0f7d71907abd","141c0df6cd1946539aadd1c9b7068cd4",22855392,1,4,0,1496,305,308,3
"53e7e900392747ccad52e711ab0f80d8","3434c10e561d488a914e0f7d71907abd",22855392,7,-2,0,1501,307,305,-2
"130acc2aeb0448fdbb2de63bc5cebe5b","53e7e900392747ccad52e711ab0f80d8",22855392,1,-3,0,1503,309,307,-2
"141c0df6cd1946539aadd1c9b7068cd4","3434c10e561d488a914e0f7d71907abd",22855392,1,-4,0,1505,308,305,-3
"4a29443515bb404cb8924e1c60a63b73","4a29443515bb404cb8924e1c60a63b73",22855392,2,0,1,1507,285,285,0
"4a29443515bb404cb8924e1c60a63b73","3434c10e561d488a914e0f7d71907abd",22855392,3,27,0,1508,285,305,20
"130acc2aeb0448fdbb2de63bc5cebe5b","141c0df6cd1946539aadd1c9b7068cd4",22855392,2,-1,0,1514,309,308,-1
"141c0df6cd1946539aadd1c9b7068cd4","56b3fd1a212a4764be39d979fde3326e",22855392,1,24,0,1515,308,328,20
"56b3fd1a212a4764be39d979fde3326e","56b3fd1a212a4764be39d979fde3326e",22855392,1,0,1,1516,328,328,0
"56b3fd1a212a4764be39d979fde3326e","0c4079457ede49e3aeb5e86ed84bdf35",22855392,1,3,0,1517,328,329,1
"0c4079457ede49e3aeb5e86ed84bdf35","3434c10e561d488a914e0f7d71907abd",22855392,4,-31,0,1518,329,305,-24
"3434c10e561d488a914e0f7d71907abd","38aea304b4fa46e1b29bb72f5cea4c93",22855392,3,33,0,1519,305,331,26
"38aea304b4fa46e1b29bb72f5cea4c93","0c4079457ede49e3aeb5e86ed84bdf35",22855392,3,-2,0,1520,331,329,-2
"3434c10e561d488a914e0f7d71907abd","0c4079457ede49e3aeb5e86ed84bdf35",22855392,3,31,0,1522,305,329,24
"38aea304b4fa46e1b29bb72f5cea4c93","38aea304b4fa46e1b29bb72f5cea4c93",22855392,1,0,1,1525,331,331,0
"38aea304b4fa46e1b29bb72f5cea4c93","e36d261332f14e79bb4b467aceaeb9b5",22855392,1,2,0,1526,331,333,2
"e36d261332f14e79bb4b467aceaeb9b5","e36d261332f14e79bb4b467aceaeb9b5",22855392,1,0,1,1527,333,333,0
"e36d261332f14e79bb4b467aceaeb9b5","c7e89b9d04744d2eab742fc24e3ef1ae",22855392,1,1,0,1528,333,334,1
"c7e89b9d04744d2eab742fc24e3ef1ae","c7e89b9d04744d2eab742fc24e3ef1ae",22855392,8,0,1,1529,334,334,0
"c7e89b9d04744d2eab742fc24e3ef1ae","fe49f8054b374a0ea4bb266ed135ff62",22855392,1,1,0,1537,334,335,1
"fe49f8054b374a0ea4bb266ed135ff62","fe49f8054b374a0ea4bb266ed135ff62",22855392,5,0,1,1538,335,335,0
"fe49f8054b374a0ea4bb266ed135ff62","d0a8f74af98642fe8360d22c42e45117",22855392,1,1,0,1543,335,336,1
"d0a8f74af98642fe8360d22c42e45117","d0a8f74af98642fe8360d22c42e45117",22855392,2,0,1,1544,336,336,0
"d0a8f74af98642fe8360d22c42e45117","0c4079457ede49e3aeb5e86ed84bdf35",22855392,1,-7,0,1546,336,329,-7
"0c4079457ede49e3aeb5e86ed84bdf35","a7c6339ca1da4368a18d471f0519f877",22855392,1,11,0,1547,329,339,10
"a7c6339ca1da4368a18d471f0519f877","a7c6339ca1da4368a18d471f0519f877",22855392,1,0,1,1548,339,339,0
"a7c6339ca1da4368a18d471f0519f877","bbc5139ca9024389a94db3a6f47dcff6",22855392,1,3,0,1549,339,341,2
"bbc5139ca9024389a94db3a6f47dcff6","b8b9418ab322418d9db9b40d96af873a",22855392,2,-5,0,1550,341,337,-4
"b8b9418ab322418d9db9b40d96af873a","c2490bc612d146edbe786556fab3651b",22855392,2,4,0,1551,337,340,3
"c2490bc612d146edbe786556fab3651b","38aea304b4fa46e1b29bb72f5cea4c93",22855392,1,-11,0,1552,340,331,-9
"38aea304b4fa46e1b29bb72f5cea4c93","3434c10e561d488a914e0f7d71907abd",22855392,1,-33,0,1553,331,305,-26
"0c4079457ede49e3aeb5e86ed84bdf35","43ea1b823a4b4e51b7c694c10725db82",22855392,1,-4,0,1555,329,327,-2
"43ea1b823a4b4e51b7c694c10725db82","53e7e900392747ccad52e711ab0f80d8",22855392,1,-25,0,1556,327,307,-20
"3434c10e561d488a914e0f7d71907abd","3434c10e561d488a914e0f7d71907abd",22855392,1,0,1,1570,305,305,0
"0c4079457ede49e3aeb5e86ed84bdf35","38aea304b4fa46e1b29bb72f5cea4c93",22855392,1,2,0,1572,329,331,2
"0c4079457ede49e3aeb5e86ed84bdf35","bbc5139ca9024389a94db3a6f47dcff6",22855392,2,14,0,1574,329,341,12
"bbc5139ca9024389a94db3a6f47dcff6","bbc5139ca9024389a94db3a6f47dcff6",22855392,2,0,1,1575,341,341,0
"bbc5139ca9024389a94db3a6f47dcff6","4ee6ca9019ab4a1ab323f98094a9bd77",22855392,1,2,0,1577,341,343,2
"4ee6ca9019ab4a1ab323f98094a9bd77","4ee6ca9019ab4a1ab323f98094a9bd77",22855392,2,0,1,1578,343,343,0
"4ee6ca9019ab4a1ab323f98094a9bd77","b37947176785476f8b29d49a851366dc",22855392,1,1,0,1580,343,344,1
"b37947176785476f8b29d49a851366dc","b37947176785476f8b29d49a851366dc",22855392,2,0,1,1581,344,344,0
"b37947176785476f8b29d49a851366dc","fcea5b10d5a14a3b9324ffece8f6e1e5",22855392,1,1,0,1583,344,345,1
"fcea5b10d5a14a3b9324ffece8f6e1e5","fcea5b10d5a14a3b9324ffece8f6e1e5",22855392,5,0,1,1584,345,345,0
"fcea5b10d5a14a3b9324ffece8f6e1e5","c2490bc612d146edbe786556fab3651b",22855392,1,-5,0,1589,345,340,-5
"c2490bc612d146edbe786556fab3651b","4a92daef4d504e1792575a26502bb7b7",22855392,1,7,0,1590,340,346,6
"4a92daef4d504e1792575a26502bb7b7","bbc5139ca9024389a94db3a6f47dcff6",22855392,1,-6,0,1591,346,341,-5
"bbc5139ca9024389a94db3a6f47dcff6","c2490bc612d146edbe786556fab3651b",22855392,1,-1,0,1592,341,340,-1
"c2490bc612d146edbe786556fab3651b","6ac8bb048b854999a47edb35fe627f11",22855392,1,8,0,1593,340,347,7
"6ac8bb048b854999a47edb35fe627f11","6ac8bb048b854999a47edb35fe627f11",22855392,1,0,1,1594,347,347,0
"6ac8bb048b854999a47edb35fe627f11","30ead9794d4847abaf222ca966cc8630",22855392,1,3,0,1595,347,348,1
"30ead9794d4847abaf222ca966cc8630","0c4079457ede49e3aeb5e86ed84bdf35",22855392,2,-24,0,1596,348,329,-19
"0c4079457ede49e3aeb5e86ed84bdf35","897b7f51242c44aab2205c72fdcbf4cd",22855392,1,28,0,1597,329,352,23
"897b7f51242c44aab2205c72fdcbf4cd","09b9678ddc3d452ea4a3d46e15826065",22855392,2,1,0,1598,352,353,1
"09b9678ddc3d452ea4a3d46e15826065","c20993c944444fe085345591a8bd837e",22855392,2,-2,0,1599,353,351,-2
"c20993c944444fe085345591a8bd837e","eff0de7f2dbb42dfa1a2e686efab5b6d",22855392,1,3,0,1600,351,354,3
"eff0de7f2dbb42dfa1a2e686efab5b6d","c20993c944444fe085345591a8bd837e",22855392,1,-3,0,1601,354,351,-3
"c20993c944444fe085345591a8bd837e","c20993c944444fe085345591a8bd837e",22855392,4,0,1,1602,351,351,0
"c20993c944444fe085345591a8bd837e","897b7f51242c44aab2205c72fdcbf4cd",22855392,3,1,0,1605,351,352,1
"897b7f51242c44aab2205c72fdcbf4cd","897b7f51242c44aab2205c72fdcbf4cd",22855392,4,0,1,1606,352,352,0
"09b9678ddc3d452ea4a3d46e15826065","09b9678ddc3d452ea4a3d46e15826065",22855392,5,0,1,1610,353,353,0
"09b9678ddc3d452ea4a3d46e15826065","eff0de7f2dbb42dfa1a2e686efab5b6d",22855392,1,1,0,1613,353,354,1
"eff0de7f2dbb42dfa1a2e686efab5b6d","eff0de7f2dbb42dfa1a2e686efab5b6d",22855392,5,0,1,1614,354,354,0
"eff0de7f2dbb42dfa1a2e686efab5b6d","2fe14166dc9642c3bc666b86a57f943d",22855392,1,4,0,1617,354,357,3
"2fe14166dc9642c3bc666b86a57f943d","30ead9794d4847abaf222ca966cc8630",22855392,1,-10,0,1618,357,348,-9
"30ead9794d4847abaf222ca966cc8630","2fe14166dc9642c3bc666b86a57f943d",22855392,2,10,0,1619,348,357,9
"2fe14166dc9642c3bc666b86a57f943d","44421dd1e13a47a388c4a19834b744c7",22855392,1,2,0,1620,357,359,2
"44421dd1e13a47a388c4a19834b744c7","44421dd1e13a47a388c4a19834b744c7",22855392,2,0,1,1621,359,359,0
"44421dd1e13a47a388c4a19834b744c7","cb5fc7ef85d547c4be1a7439d0bf6052",22855392,1,1,0,1623,359,360,1
"cb5fc7ef85d547c4be1a7439d0bf6052","cb5fc7ef85d547c4be1a7439d0bf6052",22855392,2,0,1,1624,360,360,0
"cb5fc7ef85d547c4be1a7439d0bf6052","0a8f150a4cf747acbde62f4721823da3",22855392,1,1,0,1626,360,361,1
"0a8f150a4cf747acbde62f4721823da3","0a8f150a4cf747acbde62f4721823da3",22855392,5,0,1,1627,361,361,0
"0a8f150a4cf747acbde62f4721823da3","ab8fdad974ae471f9f24c3f9dd04462e",22855392,1,1,0,1632,361,362,1
"ab8fdad974ae471f9f24c3f9dd04462e","ab8fdad974ae471f9f24c3f9dd04462e",22855392,2,0,1,1633,362,362,0
"ab8fdad974ae471f9f24c3f9dd04462e","52580888dadb4fe3baa795683ea227bd",22855392,1,3,0,1635,362,364,2
"52580888dadb4fe3baa795683ea227bd","1ba8fef685d74a8194b9db252eb704fb",22855392,1,-10,0,1636,364,355,-9
"1ba8fef685d74a8194b9db252eb704fb","52580888dadb4fe3baa795683ea227bd",22855392,1,10,0,1637,355,364,9
"52580888dadb4fe3baa795683ea227bd","f00179e251a045b39c3f7a54f9aa4acc",22855392,1,-1,0,1638,364,363,-1
"f00179e251a045b39c3f7a54f9aa4acc","492a3bc6a1254f23a7998587961b22a4",22855392,1,4,0,1639,363,366,3
"492a3bc6a1254f23a7998587961b22a4","492a3bc6a1254f23a7998587961b22a4",22855392,1,0,1,1640,366,366,0
"492a3bc6a1254f23a7998587961b22a4","072a190fd302456290895f9f04d6940a",22855392,1,-1,0,1641,366,365,-1
"072a190fd302456290895f9f04d6940a","cfa457d1743848e4bb5e4beced6448ed",22855392,1,5,0,1642,365,369,4
"cfa457d1743848e4bb5e4beced6448ed","cfa457d1743848e4bb5e4beced6448ed",22855392,1,0,1,1643,369,369,0
"cfa457d1743848e4bb5e4beced6448ed","30ead9794d4847abaf222ca966cc8630",22855392,1,-25,0,1644,369,348,-21
"30ead9794d4847abaf222ca966cc8630","b71bac264efb4abd97015447bd490db6",22855392,2,28,0,1645,348,370,22
"b71bac264efb4abd97015447bd490db6","8d448d625b024c82a5eb240bbd7431d6",22855392,13,5,0,1646,370,374,4
"8d448d625b024c82a5eb240bbd7431d6","8d448d625b024c82a5eb240bbd7431d6",22855392,131,0,1,1647,374,374,0
"8d448d625b024c82a5eb240bbd7431d6","b71bac264efb4abd97015447bd490db6",22855392,5,-5,0,1649,374,370,-4
"8d448d625b024c82a5eb240bbd7431d6","1b4550d0dab04078b3bf08a655345bdc",22855392,4,-1,0,1655,374,373,-1
"1b4550d0dab04078b3bf08a655345bdc","df1de691dafe4549a18a4398ee9dfaf9",22855392,1,-314,0,1656,373,139,-234
"df1de691dafe4549a18a4398ee9dfaf9","d313cec988a84645bee413e8d4724a4b",22855392,3,22,0,1657,139,158,19
"d313cec988a84645bee413e8d4724a4b","d313cec988a84645bee413e8d4724a4b",22855392,21,0,1,1658,158,158,0
"d313cec988a84645bee413e8d4724a4b","df1de691dafe4549a18a4398ee9dfaf9",22855392,1,-22,0,1660,158,139,-19
"df1de691dafe4549a18a4398ee9dfaf9","78adeee1fa2c4fe0bc73f7bca9fcee86",22855392,6,26,0,1661,139,160,21
"78adeee1fa2c4fe0bc73f7bca9fcee86","0d987bed3ffa4ed0b9a2e62e97b7b30f",22855392,1,152,0,1662,160,272,112
"bb5a47f5ea01454a8b79455422d3b9da","b71bac264efb4abd97015447bd490db6",22855392,4,122,0,1687,280,370,90
"1b4550d0dab04078b3bf08a655345bdc","8d448d625b024c82a5eb240bbd7431d6",22855392,1,1,0,1697,373,374,1
"1b4550d0dab04078b3bf08a655345bdc","d6d02b6ef04e4f17805504500b8ce441",22855392,1,4,0,1707,373,375,2
"d6d02b6ef04e4f17805504500b8ce441","b71bac264efb4abd97015447bd490db6",22855392,4,-8,0,1708,375,370,-5
"b71bac264efb4abd97015447bd490db6","d6d02b6ef04e4f17805504500b8ce441",22855392,4,8,0,1709,370,375,5
"d6d02b6ef04e4f17805504500b8ce441","d6d02b6ef04e4f17805504500b8ce441",22855392,19,0,1,1710,375,375,0
"8d448d625b024c82a5eb240bbd7431d6","0d987bed3ffa4ed0b9a2e62e97b7b30f",22855392,4,-137,0,1720,374,272,-102
"bb5a47f5ea01454a8b79455422d3b9da","94cecc3f1e7d484b8e068e79241dfd73",22855392,3,3,0,1762,280,281,1
"94cecc3f1e7d484b8e068e79241dfd73","0d987bed3ffa4ed0b9a2e62e97b7b30f",22855392,2,-13,0,1763,281,272,-9
"0d987bed3ffa4ed0b9a2e62e97b7b30f","a37477c4e4c14169ad44b06b493007f6",22855392,2,15,0,1764,272,283,11
"a37477c4e4c14169ad44b06b493007f6","0d987bed3ffa4ed0b9a2e62e97b7b30f",22855392,1,-15,0,1765,283,272,-11
"bb5a47f5ea01454a8b79455422d3b9da","df1de691dafe4549a18a4398ee9dfaf9",22855392,1,-188,0,1774,280,139,-141
"d313cec988a84645bee413e8d4724a4b","0d987bed3ffa4ed0b9a2e62e97b7b30f",22855392,1,156,0,1778,158,272,114
"a37477c4e4c14169ad44b06b493007f6","0c7262dff33c4087bc660ccf40f92f9c",22855392,1,-150,0,1789,283,169,-114
"0c7262dff33c4087bc660ccf40f92f9c","a9ac840f098c4bd0a2ee896214ce29cd",22855392,1,-4,0,1790,169,168,-1
"a9ac840f098c4bd0a2ee896214ce29cd","a9ac840f098c4bd0a2ee896214ce29cd",22855392,3,0,1,1791,168,168,0
"a9ac840f098c4bd0a2ee896214ce29cd","0c7262dff33c4087bc660ccf40f92f9c",22855392,1,4,0,1793,168,169,1
"0c7262dff33c4087bc660ccf40f92f9c","b2275c3fad834f8d90737a2d9a6927d6",22855392,7,3,0,1794,169,172,3
"b2275c3fad834f8d90737a2d9a6927d6","fab84b4fab5940efb4ea868ef8d09396",22855392,1,150,0,1795,172,284,112
"fab84b4fab5940efb4ea868ef8d09396","fab84b4fab5940efb4ea868ef8d09396",22855392,2,0,1,1796,284,284,0
"fab84b4fab5940efb4ea868ef8d09396","4a29443515bb404cb8924e1c60a63b73",22855392,3,4,0,1797,284,285,1
"208c9b2796c944db8dacaa96082520ea","fab84b4fab5940efb4ea868ef8d09396",22855392,1,-7,0,1799,288,284,-4
"fab84b4fab5940efb4ea868ef8d09396","fc0e049d56024bc9a02c9a9c435c3df7",22855392,1,-326,0,1801,284,38,-246
"67a089198fcb4e1c8f2385786c2b296f","fc0e049d56024bc9a02c9a9c435c3df7",22855392,1,-4,0,1803,39,38,-1
"fc0e049d56024bc9a02c9a9c435c3df7","64d48c6c9c7940639a932219a6c87198",22855392,1,5,0,1804,38,40,2
"64d48c6c9c7940639a932219a6c87198","a9ac840f098c4bd0a2ee896214ce29cd",22855392,1,164,0,1805,40,168,128
"a9ac840f098c4bd0a2ee896214ce29cd","fab84b4fab5940efb4ea868ef8d09396",22855392,1,157,0,1806,168,284,116
"fab84b4fab5940efb4ea868ef8d09396","94cecc3f1e7d484b8e068e79241dfd73",22855392,3,-5,0,1807,284,281,-3
"a37477c4e4c14169ad44b06b493007f6","8aae34f5ddbb4052a709b12e6b0d40fa",22855392,1,-184,0,1809,283,147,-136
"8aae34f5ddbb4052a709b12e6b0d40fa","0d987bed3ffa4ed0b9a2e62e97b7b30f",22855392,1,169,0,1810,147,272,125
"1b4550d0dab04078b3bf08a655345bdc","b71bac264efb4abd97015447bd490db6",22855392,1,-4,0,1829,373,370,-3
"b71bac264efb4abd97015447bd490db6","30ead9794d4847abaf222ca966cc8630",22855392,1,-28,0,1830,370,348,-22
"30ead9794d4847abaf222ca966cc8630","492a3bc6a1254f23a7998587961b22a4",22855392,1,21,0,1831,348,366,18
"492a3bc6a1254f23a7998587961b22a4","c76574d21bc14aeea7ecd0b027f39858",22855392,1,2,0,1832,366,367,1
"c76574d21bc14aeea7ecd0b027f39858","492a3bc6a1254f23a7998587961b22a4",22855392,1,-2,0,1833,367,366,-1
"492a3bc6a1254f23a7998587961b22a4","52580888dadb4fe3baa795683ea227bd",22855392,1,-3,0,1834,366,364,-2
"52580888dadb4fe3baa795683ea227bd","072a190fd302456290895f9f04d6940a",22855392,1,2,0,1835,364,365,1
"072a190fd302456290895f9f04d6940a","52580888dadb4fe3baa795683ea227bd",22855392,1,-2,0,1836,365,364,-1
"52580888dadb4fe3baa795683ea227bd","2fe14166dc9642c3bc666b86a57f943d",22855392,1,-8,0,1837,364,357,-7
"2fe14166dc9642c3bc666b86a57f943d","f00179e251a045b39c3f7a54f9aa4acc",22855392,1,7,0,1838,357,363,6
"f00179e251a045b39c3f7a54f9aa4acc","0d987bed3ffa4ed0b9a2e62e97b7b30f",22855392,1,-121,0,1839,363,272,-91
"a37477c4e4c14169ad44b06b493007f6","fab84b4fab5940efb4ea868ef8d09396",22855392,2,3,0,1853,283,284,1
"94cecc3f1e7d484b8e068e79241dfd73","fab84b4fab5940efb4ea868ef8d09396",22855392,2,5,0,1855,281,284,3
"4a29443515bb404cb8924e1c60a63b73","869e967078f04da18dd0b0b9389a7424",22855392,1,10,0,1859,285,293,8
"6a9a3b5bde4a48daa896fe8c06eca56f","34a6e49023fc4465bd5ca604330bbd1c",22855392,1,4,0,1861,289,292,3
"21592f2a9e9c4b2f8c66ec5dbcbf6a2b","7646a919d7e64fa990bca9b024ff089d",22855392,1,3,0,1864,296,298,2
"7646a919d7e64fa990bca9b024ff089d","3434c10e561d488a914e0f7d71907abd",22855392,1,10,0,1865,298,305,7
"141c0df6cd1946539aadd1c9b7068cd4","0c787d16c9504873b1a4d903cec09948",22855392,1,7,0,1871,308,314,6
"8d7e0b55cf9849cda222a0f2440cec55","47edbb64109243e6b0f8f64cdef90c6c",22855392,1,9,0,1874,318,326,8
"3628bdce1dd2429ba924d2d4d09448d2","0c4079457ede49e3aeb5e86ed84bdf35",22855392,1,10,0,1877,322,329,7
"c2490bc612d146edbe786556fab3651b","30ead9794d4847abaf222ca966cc8630",22855392,1,11,0,1884,340,348,8
"0c4079457ede49e3aeb5e86ed84bdf35","eff0de7f2dbb42dfa1a2e686efab5b6d",22855392,1,30,0,1886,329,354,25
"eff0de7f2dbb42dfa1a2e686efab5b6d","09b9678ddc3d452ea4a3d46e15826065",22855392,1,-1,0,1889,354,353,-1
"897b7f51242c44aab2205c72fdcbf4cd","c20993c944444fe085345591a8bd837e",22855392,1,-1,0,1896,352,351,-1
"897b7f51242c44aab2205c72fdcbf4cd","30ead9794d4847abaf222ca966cc8630",22855392,1,-4,0,1898,352,348,-4
"2fe14166dc9642c3bc666b86a57f943d","1ba8fef685d74a8194b9db252eb704fb",22855392,1,-2,0,1900,357,355,-2
"1ba8fef685d74a8194b9db252eb704fb","30ead9794d4847abaf222ca966cc8630",22855392,1,-8,0,1901,355,348,-7
"4a29443515bb404cb8924e1c60a63b73","b71bac264efb4abd97015447bd490db6",22855392,1,110,0,1930,285,370,85
"8d448d625b024c82a5eb240bbd7431d6","df1de691dafe4549a18a4398ee9dfaf9",22855392,1,-315,0,2032,374,139,-235
"d313cec988a84645bee413e8d4724a4b","d6d02b6ef04e4f17805504500b8ce441",22855392,1,296,0,2036,158,375,217
"d6d02b6ef04e4f17805504500b8ce441","8d448d625b024c82a5eb240bbd7431d6",22855392,1,-3,0,2040,375,374,-1
"d6d02b6ef04e4f17805504500b8ce441","0d987bed3ffa4ed0b9a2e62e97b7b30f",22855392,1,-140,0,2053,375,272,-103
"bb5a47f5ea01454a8b79455422d3b9da","fab84b4fab5940efb4ea868ef8d09396",22855392,1,8,0,2062,280,284,4
"fab84b4fab5940efb4ea868ef8d09396","78adeee1fa2c4fe0bc73f7bca9fcee86",22855392,1,-170,0,2063,284,160,-124
"78adeee1fa2c4fe0bc73f7bca9fcee86","df1de691dafe4549a18a4398ee9dfaf9",22855392,1,-26,0,2064,160,139,-21
"78adeee1fa2c4fe0bc73f7bca9fcee86","d313cec988a84645bee413e8d4724a4b",22855392,2,-4,0,2066,160,158,-2
"d313cec988a84645bee413e8d4724a4b","b71bac264efb4abd97015447bd490db6",22855392,1,288,0,2069,158,370,212
"8d448d625b024c82a5eb240bbd7431d6","d6d02b6ef04e4f17805504500b8ce441",22855392,1,3,0,2078,374,375,1
"d6d02b6ef04e4f17805504500b8ce441","66baf19b6b904b70922329068c63746d",22855392,3,4,0,2082,375,376,1
"66baf19b6b904b70922329068c63746d","7f544639412e40a9ba27f43b415362ab",22855392,5,2,0,2083,376,378,2
"7f544639412e40a9ba27f43b415362ab","7f544639412e40a9ba27f43b415362ab",22855392,6,0,1,2084,378,378,0
"7f544639412e40a9ba27f43b415362ab","66baf19b6b904b70922329068c63746d",22855392,3,-2,0,2089,378,376,-2
"66baf19b6b904b70922329068c63746d","d6d02b6ef04e4f17805504500b8ce441",22855392,1,-4,0,2090,376,375,-1
"66baf19b6b904b70922329068c63746d","66baf19b6b904b70922329068c63746d",22855392,1,0,1,2096,376,376,0
"7f544639412e40a9ba27f43b415362ab","d5ae8642e15b46b8bd298b02274d4e9c",22855392,1,2,0,2099,378,380,2
"d5ae8642e15b46b8bd298b02274d4e9c","d5ae8642e15b46b8bd298b02274d4e9c",22855392,1,0,1,2100,380,380,0
"d5ae8642e15b46b8bd298b02274d4e9c","a0d10309a2dd456289147f84be9d37f9",22855392,1,1,0,2101,380,381,1
"a0d10309a2dd456289147f84be9d37f9","a0d10309a2dd456289147f84be9d37f9",22855392,2,0,1,2102,381,381,0
"a0d10309a2dd456289147f84be9d37f9","0fcbc3ca07b144138b8d85da581f09a8",22855392,1,1,0,2104,381,382,1
"0fcbc3ca07b144138b8d85da581f09a8","0fcbc3ca07b144138b8d85da581f09a8",22855392,5,0,1,2105,382,382,0
"0fcbc3ca07b144138b8d85da581f09a8","66baf19b6b904b70922329068c63746d",22855392,1,-6,0,2110,382,376,-6
"66baf19b6b904b70922329068c63746d","4890121ce5d74576b4632b77cfc23398",22855392,1,14,0,2111,376,388,12
"4890121ce5d74576b4632b77cfc23398","c2fca3669923477ab966ded303dea31c",22855392,1,-6,0,2112,388,383,-5
"c2fca3669923477ab966ded303dea31c","4890121ce5d74576b4632b77cfc23398",22855392,1,6,0,2113,383,388,5
"4890121ce5d74576b4632b77cfc23398","96bb2b3e85a34d8b9544514e89f6fe97",22855392,1,3,0,2114,388,390,2
"96bb2b3e85a34d8b9544514e89f6fe97","18d3b836dd804224883cc9180b60a8e1",22855392,1,-4,0,2115,390,387,-3
"18d3b836dd804224883cc9180b60a8e1","96bb2b3e85a34d8b9544514e89f6fe97",22855392,1,4,0,2116,387,390,3
"96bb2b3e85a34d8b9544514e89f6fe97","ac4e9b54acfe4670b4634859c7263cb5",22855392,1,2,0,2117,390,392,2
"ac4e9b54acfe4670b4634859c7263cb5","ac4e9b54acfe4670b4634859c7263cb5",22855392,1,0,1,2118,392,392,0
"ac4e9b54acfe4670b4634859c7263cb5","6f8881a745ac4c358a68b92c3b4abe81",22855392,1,3,0,2119,392,394,2
"6f8881a745ac4c358a68b92c3b4abe81","17f95d18bab743888e1736033dc3384d",22855392,1,-6,0,2120,394,389,-5
"17f95d18bab743888e1736033dc3384d","6f8881a745ac4c358a68b92c3b4abe81",22855392,1,6,0,2121,389,394,5
"6f8881a745ac4c358a68b92c3b4abe81","f7002c8484354eceac57bc7bd62c76c1",22855392,2,-1,0,2122,394,393,-1
"f7002c8484354eceac57bc7bd62c76c1","0c12af0a4e7f4002852cf84b2537c161",22855392,1,3,0,2123,393,395,2
"0c12af0a4e7f4002852cf84b2537c161","6f8881a745ac4c358a68b92c3b4abe81",22855392,1,-2,0,2124,395,394,-1
"6f8881a745ac4c358a68b92c3b4abe81","6f8881a745ac4c358a68b92c3b4abe81",22855392,1,0,1,2125,394,394,0
"f7002c8484354eceac57bc7bd62c76c1","6f8881a745ac4c358a68b92c3b4abe81",22855392,1,1,0,2127,393,394,1
"6f8881a745ac4c358a68b92c3b4abe81","0c12af0a4e7f4002852cf84b2537c161",22855392,1,2,0,2128,394,395,1
"0c12af0a4e7f4002852cf84b2537c161","66baf19b6b904b70922329068c63746d",22855392,1,-24,0,2129,395,376,-19
"66baf19b6b904b70922329068c63746d","44a277ea44dc4ae689fab4b82f0b4098",22855392,1,26,0,2132,376,397,21
"44a277ea44dc4ae689fab4b82f0b4098","44a277ea44dc4ae689fab4b82f0b4098",22855392,1,0,1,2133,397,397,0
"44a277ea44dc4ae689fab4b82f0b4098","0c12af0a4e7f4002852cf84b2537c161",22855392,1,-2,0,2134,397,395,-2
"0c12af0a4e7f4002852cf84b2537c161","859e0b8d71694b12befb69ee698138f9",22855392,1,5,0,2135,395,399,4
"859e0b8d71694b12befb69ee698138f9","859e0b8d71694b12befb69ee698138f9",22855392,1,0,1,2136,399,399,0
"859e0b8d71694b12befb69ee698138f9","2b09a08242b54983aec7063990fb3f66",22855392,1,3,0,2137,399,400,1
"2b09a08242b54983aec7063990fb3f66","66baf19b6b904b70922329068c63746d",22855392,3,-32,0,2138,400,376,-24
"66baf19b6b904b70922329068c63746d","2b09a08242b54983aec7063990fb3f66",22855392,3,32,0,2139,376,400,24
"2b09a08242b54983aec7063990fb3f66","2b09a08242b54983aec7063990fb3f66",22855392,4,0,1,2140,400,400,0
"2b09a08242b54983aec7063990fb3f66","1f471b7a883a4df48211e8c6a81b59a7",22855392,1,1,0,2146,400,401,1
"1f471b7a883a4df48211e8c6a81b59a7","1f471b7a883a4df48211e8c6a81b59a7",22855392,1,0,1,2147,401,401,0
"1f471b7a883a4df48211e8c6a81b59a7","2b09a08242b54983aec7063990fb3f66",22855392,1,-1,0,2148,401,400,-1
"2b09a08242b54983aec7063990fb3f66","9de0d567bfa84fe5b77cb76f4a76a5d1",22855392,1,5,0,2149,400,404,4
"9de0d567bfa84fe5b77cb76f4a76a5d1","9de0d567bfa84fe5b77cb76f4a76a5d1",22855392,1,0,1,2150,404,404,0
"9de0d567bfa84fe5b77cb76f4a76a5d1","1157bd665ec4472fb58b751dc5099355",22855392,1,-1,0,2151,404,403,-1
"1157bd665ec4472fb58b751dc5099355","58fc9094275e4c49be3f4ba6d4acc0a4",22855392,1,5,0,2152,403,406,3
"58fc9094275e4c49be3f4ba6d4acc0a4","3c8a22d2f9c146ea956609e3ed4f2559",22855392,1,-2,0,2153,406,405,-1
"3c8a22d2f9c146ea956609e3ed4f2559","58fc9094275e4c49be3f4ba6d4acc0a4",22855392,2,2,0,2154,405,406,1
"58fc9094275e4c49be3f4ba6d4acc0a4","c1c1be90b2b14c1ab4a5e1ee3c241902",22855392,1,1,0,2155,406,407,1
"c1c1be90b2b14c1ab4a5e1ee3c241902","c1c1be90b2b14c1ab4a5e1ee3c241902",22855392,5,0,1,2156,407,407,0
"c1c1be90b2b14c1ab4a5e1ee3c241902","02b3a1bead9244c1ba2f857c7da8f82a",22855392,1,2,0,2161,407,408,1
"02b3a1bead9244c1ba2f857c7da8f82a","58fc9094275e4c49be3f4ba6d4acc0a4",22855392,3,-3,0,2162,408,406,-2
"58fc9094275e4c49be3f4ba6d4acc0a4","2b09a08242b54983aec7063990fb3f66",22855392,1,-9,0,2163,406,400,-6
"2b09a08242b54983aec7063990fb3f66","1157bd665ec4472fb58b751dc5099355",22855392,1,4,0,2166,400,403,3
"1157bd665ec4472fb58b751dc5099355","3c8a22d2f9c146ea956609e3ed4f2559",22855392,1,3,0,2167,403,405,2
"58fc9094275e4c49be3f4ba6d4acc0a4","02b3a1bead9244c1ba2f857c7da8f82a",22855392,3,3,0,2169,406,408,2
"58fc9094275e4c49be3f4ba6d4acc0a4","58fc9094275e4c49be3f4ba6d4acc0a4",22855392,2,0,1,2171,406,406,0
"02b3a1bead9244c1ba2f857c7da8f82a","02b3a1bead9244c1ba2f857c7da8f82a",22855392,1,0,1,2176,408,408,0
"02b3a1bead9244c1ba2f857c7da8f82a","6206fc6479014bb193084c32409dc1b9",22855392,1,1,0,2177,408,409,1
"6206fc6479014bb193084c32409dc1b9","6206fc6479014bb193084c32409dc1b9",22855392,1,0,1,2178,409,409,0
"6206fc6479014bb193084c32409dc1b9","6a5f020451db426dacba9e2ea3fcc62a",22855392,1,2,0,2179,409,410,1
"6a5f020451db426dacba9e2ea3fcc62a","02b3a1bead9244c1ba2f857c7da8f82a",22855392,1,-3,0,2180,410,408,-2
"02b3a1bead9244c1ba2f857c7da8f82a","6a5f020451db426dacba9e2ea3fcc62a",22855392,1,3,0,2181,408,410,2
"6a5f020451db426dacba9e2ea3fcc62a","33a9d248b2e44588a5b07fc1342b9bc2",22855392,2,2,0,2182,410,411,1
"33a9d248b2e44588a5b07fc1342b9bc2","6a5f020451db426dacba9e2ea3fcc62a",22855392,1,-2,0,2183,411,410,-1
"33a9d248b2e44588a5b07fc1342b9bc2","c6f26bd420634f1cb7989e76fe6b16c0",22855392,1,1,0,2185,411,412,1
"c6f26bd420634f1cb7989e76fe6b16c0","c6f26bd420634f1cb7989e76fe6b16c0",22855392,5,0,1,2186,412,412,0
"c6f26bd420634f1cb7989e76fe6b16c0","2a65ee6e2ac64f6a8a55fbe5373ec763",22855392,1,1,0,2191,412,413,1
"2a65ee6e2ac64f6a8a55fbe5373ec763","2a65ee6e2ac64f6a8a55fbe5373ec763",22855392,5,0,1,2192,413,413,0
"2a65ee6e2ac64f6a8a55fbe5373ec763","33a9d248b2e44588a5b07fc1342b9bc2",22855392,1,-2,0,2197,413,411,-2
"33a9d248b2e44588a5b07fc1342b9bc2","1fd0f6dadbc14ebc965faf6122190b96",22855392,1,5,0,2198,411,415,4
"1fd0f6dadbc14ebc965faf6122190b96","1fd0f6dadbc14ebc965faf6122190b96",22855392,1,0,1,2199,415,415,0
"1fd0f6dadbc14ebc965faf6122190b96","687055dad9fc40c3982478fe33ec01bf",22855392,1,-1,0,2200,415,414,-1
"687055dad9fc40c3982478fe33ec01bf","2add1669f08d4101913db15f8c23b3b7",22855392,1,3,0,2201,414,416,2
"2add1669f08d4101913db15f8c23b3b7","2add1669f08d4101913db15f8c23b3b7",22855392,1,0,1,2202,416,416,0
"2add1669f08d4101913db15f8c23b3b7","a2b4bd40cee2481ebd3fc179d6a5cd62",22855392,1,3,0,2203,416,417,1
"a2b4bd40cee2481ebd3fc179d6a5cd62","2b09a08242b54983aec7063990fb3f66",22855392,3,-27,0,2204,417,400,-17
"2b09a08242b54983aec7063990fb3f66","a2b4bd40cee2481ebd3fc179d6a5cd62",22855392,2,27,0,2205,400,417,17
"2b09a08242b54983aec7063990fb3f66","e34e59dce2204f228f3a84b6725df60f",22855392,1,29,0,2209,400,419,19
"e34e59dce2204f228f3a84b6725df60f","e34e59dce2204f228f3a84b6725df60f",22855392,1,0,1,2210,419,419,0
"e34e59dce2204f228f3a84b6725df60f","a2b4bd40cee2481ebd3fc179d6a5cd62",22855392,1,-2,0,2211,419,417,-2
"a2b4bd40cee2481ebd3fc179d6a5cd62","bec48fc2e1294c7eb3d0aca780d731b8",22855392,2,4,0,2212,417,420,3
"bec48fc2e1294c7eb3d0aca780d731b8","bec48fc2e1294c7eb3d0aca780d731b8",22855392,3,0,1,2213,420,420,0
"bec48fc2e1294c7eb3d0aca780d731b8","dbde19fcce2a4c1abdc7f685c293a23f",22855392,1,3,0,2216,420,422,2
"dbde19fcce2a4c1abdc7f685c293a23f","a2b4bd40cee2481ebd3fc179d6a5cd62",22855392,1,-7,0,2217,422,417,-5
"bec48fc2e1294c7eb3d0aca780d731b8","a2b4bd40cee2481ebd3fc179d6a5cd62",22855392,1,-4,0,2219,420,417,-3
"a2b4bd40cee2481ebd3fc179d6a5cd62","a2b4bd40cee2481ebd3fc179d6a5cd62",22855392,2,0,1,2220,417,417,0
"a2b4bd40cee2481ebd3fc179d6a5cd62","a24600b0e49245f6bdba8c893cfeddb0",22855392,1,11,0,2222,417,425,8
"a24600b0e49245f6bdba8c893cfeddb0","dbde19fcce2a4c1abdc7f685c293a23f",22855392,1,-4,0,2223,425,422,-3
"dbde19fcce2a4c1abdc7f685c293a23f","a24600b0e49245f6bdba8c893cfeddb0",22855392,1,4,0,2224,422,425,3
"a24600b0e49245f6bdba8c893cfeddb0","a24600b0e49245f6bdba8c893cfeddb0",22855392,1,0,1,2225,425,425,0
"a24600b0e49245f6bdba8c893cfeddb0","24cf8786024543f19b89bc20034e60d7",22855392,1,7,0,2226,425,428,3
"24cf8786024543f19b89bc20034e60d7","a2b4bd40cee2481ebd3fc179d6a5cd62",22855392,2,-18,0,2227,428,417,-11
"a2b4bd40cee2481ebd3fc179d6a5cd62","f2a73be2f46840b182d7bd095378004e",22855392,1,19,0,2228,417,429,12
"f2a73be2f46840b182d7bd095378004e","a2b4bd40cee2481ebd3fc179d6a5cd62",22855392,1,-19,0,2229,429,417,-12
"a2b4bd40cee2481ebd3fc179d6a5cd62","24cf8786024543f19b89bc20034e60d7",22855392,2,18,0,2230,417,428,11
"24cf8786024543f19b89bc20034e60d7","f2a73be2f46840b182d7bd095378004e",22855392,1,1,0,2233,428,429,1
"f2a73be2f46840b182d7bd095378004e","f2a73be2f46840b182d7bd095378004e",22855392,1,0,1,2234,429,429,0
"f2a73be2f46840b182d7bd095378004e","604551fd4266430cb860fef58fa7dd61",22855392,1,1,0,2235,429,430,1
"604551fd4266430cb860fef58fa7dd61","604551fd4266430cb860fef58fa7dd61",22855392,1,0,1,2236,430,430,0
"604551fd4266430cb860fef58fa7dd61","dce46f8904594a62a6377a3587aaa663",22855392,1,2,0,2237,430,431,1
"dce46f8904594a62a6377a3587aaa663","24cf8786024543f19b89bc20034e60d7",22855392,1,-4,0,2238,431,428,-3
"24cf8786024543f19b89bc20034e60d7","dce46f8904594a62a6377a3587aaa663",22855392,1,4,0,2239,428,431,3
"dce46f8904594a62a6377a3587aaa663","9b9d0a249052413c869753b99682b0ac",22855392,1,1,0,2240,431,432,1
"9b9d0a249052413c869753b99682b0ac","9b9d0a249052413c869753b99682b0ac",22855392,7,0,1,2241,432,432,0
"9b9d0a249052413c869753b99682b0ac","061c175cc90f45fbad883025394e78dd",22855392,1,1,0,2248,432,433,1
"061c175cc90f45fbad883025394e78dd","061c175cc90f45fbad883025394e78dd",22855392,1,0,1,2249,433,433,0
"061c175cc90f45fbad883025394e78dd","dce46f8904594a62a6377a3587aaa663",22855392,1,-2,0,2250,433,431,-2
"dce46f8904594a62a6377a3587aaa663","66ada10dde9f43018588f1ced9d477fc",22855392,2,4,0,2251,431,434,3
"66ada10dde9f43018588f1ced9d477fc","dce46f8904594a62a6377a3587aaa663",22855392,2,-4,0,2252,434,431,-3
"dce46f8904594a62a6377a3587aaa663","dce46f8904594a62a6377a3587aaa663",22855392,5,0,1,2253,431,431,0
"dce46f8904594a62a6377a3587aaa663","74a7f8712e5449c2bc0b43c6f90dafed",22855392,2,5,0,2257,431,435,4
"74a7f8712e5449c2bc0b43c6f90dafed","dce46f8904594a62a6377a3587aaa663",22855392,1,-5,0,2258,435,431,-4
"74a7f8712e5449c2bc0b43c6f90dafed","74a7f8712e5449c2bc0b43c6f90dafed",22855392,1,0,1,2263,435,435,0
"74a7f8712e5449c2bc0b43c6f90dafed","66ada10dde9f43018588f1ced9d477fc",22855392,1,-1,0,2264,435,434,-1
"66ada10dde9f43018588f1ced9d477fc","bf12c96466d840a69bed7020b3f18bb8",22855392,1,3,0,2265,434,436,2
"bf12c96466d840a69bed7020b3f18bb8","bf12c96466d840a69bed7020b3f18bb8",22855392,1,0,1,2266,436,436,0
"bf12c96466d840a69bed7020b3f18bb8","24cf8786024543f19b89bc20034e60d7",22855392,1,-11,0,2267,436,428,-8
"24cf8786024543f19b89bc20034e60d7","070600601c4c439288445d2f0724807d",22855392,2,14,0,2268,428,437,9
"070600601c4c439288445d2f0724807d","1823b6de7d334a7aaabc4570719af4d9",22855392,4,2,0,2269,437,439,2
"1823b6de7d334a7aaabc4570719af4d9","24cf8786024543f19b89bc20034e60d7",22855392,1,-16,0,2270,439,428,-11
"070600601c4c439288445d2f0724807d","24cf8786024543f19b89bc20034e60d7",22855392,1,-14,0,2272,437,428,-9
"24cf8786024543f19b89bc20034e60d7","1823b6de7d334a7aaabc4570719af4d9",22855392,1,16,0,2273,428,439,11
"1823b6de7d334a7aaabc4570719af4d9","1823b6de7d334a7aaabc4570719af4d9",22855392,16,0,1,2274,439,439,0
"1823b6de7d334a7aaabc4570719af4d9","070600601c4c439288445d2f0724807d",22855392,1,-2,0,2279,439,437,-2
"1823b6de7d334a7aaabc4570719af4d9","0380cd76a7d44bc3a4da1f15e4d68f89",22855392,2,2,0,2292,439,440,1
"0380cd76a7d44bc3a4da1f15e4d68f89","070600601c4c439288445d2f0724807d",22855392,2,-4,0,2293,440,437,-3
"070600601c4c439288445d2f0724807d","0380cd76a7d44bc3a4da1f15e4d68f89",22855392,2,4,0,2294,437,440,3
"0380cd76a7d44bc3a4da1f15e4d68f89","0380cd76a7d44bc3a4da1f15e4d68f89",22855392,1,0,1,2295,440,440,0
"0380cd76a7d44bc3a4da1f15e4d68f89","23b7673c8b5443108c2ef09382834a86",22855392,2,2,0,2296,440,441,1
"23b7673c8b5443108c2ef09382834a86","23b7673c8b5443108c2ef09382834a86",22855392,3,0,1,2297,441,441,0
"23b7673c8b5443108c2ef09382834a86","901e92500aea43c79f19f1b279050668",22855392,1,2,0,2299,441,442,1
"901e92500aea43c79f19f1b279050668","901e92500aea43c79f19f1b279050668",22855392,1,0,1,2300,442,442,0
"901e92500aea43c79f19f1b279050668","001339db8ced4cf78829ebe8b145449d",22855392,1,1,0,2301,442,443,1
"001339db8ced4cf78829ebe8b145449d","001339db8ced4cf78829ebe8b145449d",22855392,5,0,1,2302,443,443,0
"001339db8ced4cf78829ebe8b145449d","452745e0366e42ae81561bfddebcc6c3",22855392,1,1,0,2307,443,444,1
"452745e0366e42ae81561bfddebcc6c3","452745e0366e42ae81561bfddebcc6c3",22855392,5,0,1,2308,444,444,0
"452745e0366e42ae81561bfddebcc6c3","901e92500aea43c79f19f1b279050668",22855392,1,-2,0,2313,444,442,-2
"901e92500aea43c79f19f1b279050668","4660ff2089114e8db82ceb26a4f329e3",22855392,2,4,0,2314,442,445,3
"4660ff2089114e8db82ceb26a4f329e3","901e92500aea43c79f19f1b279050668",22855392,1,-4,0,2315,445,442,-3
"4660ff2089114e8db82ceb26a4f329e3","070600601c4c439288445d2f0724807d",22855392,2,-12,0,2317,445,437,-8
"1823b6de7d334a7aaabc4570719af4d9","4660ff2089114e8db82ceb26a4f329e3",22855392,1,10,0,2319,439,445,6
"070600601c4c439288445d2f0724807d","4660ff2089114e8db82ceb26a4f329e3",22855392,1,12,0,2321,437,445,8
"4660ff2089114e8db82ceb26a4f329e3","4660ff2089114e8db82ceb26a4f329e3",22855392,1,0,1,2322,445,445,0
"4660ff2089114e8db82ceb26a4f329e3","7bd5586eb9d8484eb74a433ee7bfe499",22855392,1,2,0,2323,445,446,1
"7bd5586eb9d8484eb74a433ee7bfe499","7bd5586eb9d8484eb74a433ee7bfe499",22855392,13,0,1,2324,446,446,0
"7bd5586eb9d8484eb74a433ee7bfe499","8a7f26e690f34dda97be16904518ca99",22855392,1,2,0,2337,446,447,1
"8a7f26e690f34dda97be16904518ca99","8a7f26e690f34dda97be16904518ca99",22855392,1,0,1,2338,447,447,0
"8a7f26e690f34dda97be16904518ca99","070600601c4c439288445d2f0724807d",22855392,1,-16,0,2339,447,437,-10
"070600601c4c439288445d2f0724807d","b2f0d654738f48158edff28e8d3a546e",22855392,3,21,0,2340,437,449,12
"b2f0d654738f48158edff28e8d3a546e","070600601c4c439288445d2f0724807d",22855392,2,-21,0,2341,449,437,-12
"b2f0d654738f48158edff28e8d3a546e","b2f0d654738f48158edff28e8d3a546e",22855392,4,0,1,2343,449,449,0
"070600601c4c439288445d2f0724807d","070600601c4c439288445d2f0724807d",22855392,1,0,1,2345,437,437,0
"23b7673c8b5443108c2ef09382834a86","070600601c4c439288445d2f0724807d",22855392,1,-6,0,2352,441,437,-4
"b2f0d654738f48158edff28e8d3a546e","f60ee41ec635499abd48168342d32c2f",22855392,5,5,0,2355,449,453,4
"f60ee41ec635499abd48168342d32c2f","f60ee41ec635499abd48168342d32c2f",22855392,82,0,1,2356,453,453,0
"f60ee41ec635499abd48168342d32c2f","9428d8bd9c5a47b2a235b254e5e27ded",22855392,1,-1,0,2363,453,452,-1
"9428d8bd9c5a47b2a235b254e5e27ded","b2f0d654738f48158edff28e8d3a546e",22855392,1,-4,0,2364,452,449,-3
"f60ee41ec635499abd48168342d32c2f","b2f0d654738f48158edff28e8d3a546e",22855392,3,-5,0,2388,453,449,-4
"b2f0d654738f48158edff28e8d3a546e","f67fbf45a5f146ed866965bc57c7c001",22855392,2,8,0,2433,449,454,5
"f67fbf45a5f146ed866965bc57c7c001","f67fbf45a5f146ed866965bc57c7c001",22855392,2,0,1,2434,454,454,0
"f67fbf45a5f146ed866965bc57c7c001","b2f0d654738f48158edff28e8d3a546e",22855392,2,-8,0,2435,454,449,-5
"f60ee41ec635499abd48168342d32c2f","f67fbf45a5f146ed866965bc57c7c001",22855392,1,3,0,2452,453,454,1
"f67fbf45a5f146ed866965bc57c7c001","d937afe49bd24a07a550dda1c1155122",22855392,1,1,0,2456,454,455,1
"d937afe49bd24a07a550dda1c1155122","d937afe49bd24a07a550dda1c1155122",22855392,1,0,1,2457,455,455,0
"d937afe49bd24a07a550dda1c1155122","3628b3f7823443d0912a339096b69943",22855392,1,1,0,2458,455,456,1
"3628b3f7823443d0912a339096b69943","3628b3f7823443d0912a339096b69943",22855392,1,0,1,2459,456,456,0
"3628b3f7823443d0912a339096b69943","9e049ee647cf43ecbcb5ed792a8e7588",22855392,1,1,0,2460,456,457,1
"9e049ee647cf43ecbcb5ed792a8e7588","9e049ee647cf43ecbcb5ed792a8e7588",22855392,1,0,1,2461,457,457,0
"9e049ee647cf43ecbcb5ed792a8e7588","5256a214faaf410b93f76cea06428334",22855392,1,1,0,2462,457,458,1
"5256a214faaf410b93f76cea06428334","5256a214faaf410b93f76cea06428334",22855392,1,0,1,2463,458,458,0
"5256a214faaf410b93f76cea06428334","25c32b120fce40fa9b6c85133aeb4716",22855392,1,1,0,2464,458,459,1
"25c32b120fce40fa9b6c85133aeb4716","25c32b120fce40fa9b6c85133aeb4716",22855392,3,0,1,2465,459,459,0
"25c32b120fce40fa9b6c85133aeb4716","11bc14f2204949008b7d511b933363c1",22855392,1,1,0,2468,459,460,1
"11bc14f2204949008b7d511b933363c1","11bc14f2204949008b7d511b933363c1",22855392,3,0,1,2469,460,460,0
"11bc14f2204949008b7d511b933363c1","42de338840a34d15adb66e7b14fb9d2c",22855392,1,1,0,2472,460,461,1
"42de338840a34d15adb66e7b14fb9d2c","42de338840a34d15adb66e7b14fb9d2c",22855392,1,0,1,2473,461,461,0
"42de338840a34d15adb66e7b14fb9d2c","9da37c6210b1416b8079c274f70bf600",22855392,1,1,0,2474,461,462,1
"9da37c6210b1416b8079c274f70bf600","9da37c6210b1416b8079c274f70bf600",22855392,3,0,1,2475,462,462,0
"9da37c6210b1416b8079c274f70bf600","7108f0e4c2584f1f9c471689ae4c885c",22855392,1,-356,0,2478,462,208,-254
"7108f0e4c2584f1f9c471689ae4c885c","b9e80f77c3a44349863b19875725c384",22855392,2,-1,0,2479,208,207,-1
"b9e80f77c3a44349863b19875725c384","8b9ae98743bd4d4a8a87dff1c1244211",22855392,1,27,0,2480,207,227,20
"8b9ae98743bd4d4a8a87dff1c1244211","519119f1deac45ff9ab4f13529be5c6e",22855392,1,331,0,2481,227,463,236
"519119f1deac45ff9ab4f13529be5c6e","519119f1deac45ff9ab4f13529be5c6e",22855392,1,0,1,2482,463,463,0
"519119f1deac45ff9ab4f13529be5c6e","f67fbf45a5f146ed866965bc57c7c001",22855392,1,-9,0,2483,463,454,-9
"f67fbf45a5f146ed866965bc57c7c001","c5df9f40ec14463b9dcfdc73df3e9285",22855392,1,12,0,2484,454,464,10
"c5df9f40ec14463b9dcfdc73df3e9285","c5df9f40ec14463b9dcfdc73df3e9285",22855392,9,0,1,2485,464,464,0
"c5df9f40ec14463b9dcfdc73df3e9285","83d42d95cd844fc093fc09cee250edb8",22855392,9,3,0,2487,464,465,1
"83d42d95cd844fc093fc09cee250edb8","83d42d95cd844fc093fc09cee250edb8",22855392,31,0,1,2488,465,465,0
"83d42d95cd844fc093fc09cee250edb8","c5df9f40ec14463b9dcfdc73df3e9285",22855392,7,-3,0,2489,465,464,-1
"83d42d95cd844fc093fc09cee250edb8","2ae94c0cea4d480a9d5dca8fb1d7b542",22855392,1,-317,0,2536,465,242,-223
"2ae94c0cea4d480a9d5dca8fb1d7b542","30c9ba177afc49a695625d2bdec40207",22855392,1,9,0,2537,242,250,8
"30c9ba177afc49a695625d2bdec40207","30c9ba177afc49a695625d2bdec40207",22855392,2,0,1,2538,250,250,0
"30c9ba177afc49a695625d2bdec40207","00f61990949545828dd12f1303d47504",22855392,1,8,0,2540,250,256,6
"6e83e23f56544a19b94067c1c558d9c0","a9ac840f098c4bd0a2ee896214ce29cd",22855392,1,-107,0,2542,247,168,-79
"a9ac840f098c4bd0a2ee896214ce29cd","3cbcea2be0984e7dbd5a48195af10ce7",22855392,1,-5,0,2544,168,165,-3
"3cbcea2be0984e7dbd5a48195af10ce7","78adeee1fa2c4fe0bc73f7bca9fcee86",22855392,1,-8,0,2547,165,160,-5
"78adeee1fa2c4fe0bc73f7bca9fcee86","65202579580f4ad38d734b4ee39d22a8",22855392,8,5,0,2548,160,164,4
"65202579580f4ad38d734b4ee39d22a8","65202579580f4ad38d734b4ee39d22a8",22855392,80,0,1,2549,164,164,0
"65202579580f4ad38d734b4ee39d22a8","8959e6304a0348309a771e4d08d1b64a",22855392,2,-1,0,2556,164,163,-1
"8959e6304a0348309a771e4d08d1b64a","df1de691dafe4549a18a4398ee9dfaf9",22855392,2,-30,0,2557,163,139,-24
"d313cec988a84645bee413e8d4724a4b","f4ce60b4a944484082ccb701b48b3da1",22855392,1,-1,0,2562,158,157,-1
"f4ce60b4a944484082ccb701b48b3da1","f03480cf4eba413194d7af52fc0e7f28",22855392,2,-6,0,2563,157,152,-5
"f03480cf4eba413194d7af52fc0e7f28","8aae34f5ddbb4052a709b12e6b0d40fa",22855392,2,-6,0,2564,152,147,-5
"8aae34f5ddbb4052a709b12e6b0d40fa","f902b0f41b544d4dbf79664fd233648d",22855392,1,-1,0,2565,147,146,-1
"f902b0f41b544d4dbf79664fd233648d","6c5ad271a44743479bfaea29b1db8d02",22855392,1,-4,0,2566,146,143,-3
"6c5ad271a44743479bfaea29b1db8d02","df1de691dafe4549a18a4398ee9dfaf9",22855392,1,-4,0,2567,143,139,-4
"df1de691dafe4549a18a4398ee9dfaf9","779f9ddd1fd14d1e9e69f72219a1fdbd",22855392,2,-23,0,2568,139,121,-18
"779f9ddd1fd14d1e9e69f72219a1fdbd","f661500307d74c908e9207d949ceb4aa",22855392,1,18,0,2569,121,136,15
"f661500307d74c908e9207d949ceb4aa","b416d47c56a742199b5d7c7f19d6503a",22855392,1,-3,0,2570,136,134,-2
"b416d47c56a742199b5d7c7f19d6503a","e20db35ced8544ddac5bc3839145e463",22855392,1,-51,0,2571,134,91,-43
"e20db35ced8544ddac5bc3839145e463","779f9ddd1fd14d1e9e69f72219a1fdbd",22855392,3,36,0,2572,91,121,30
"779f9ddd1fd14d1e9e69f72219a1fdbd","62bff51286ef4f348717a3cf6fe2318f",22855392,1,-3,0,2573,121,120,-1
"62bff51286ef4f348717a3cf6fe2318f","62bff51286ef4f348717a3cf6fe2318f",22855392,7,0,1,2574,120,120,0
"62bff51286ef4f348717a3cf6fe2318f","d6d02b6ef04e4f17805504500b8ce441",22855392,1,344,0,2576,120,375,255
"d6d02b6ef04e4f17805504500b8ce441","c5df9f40ec14463b9dcfdc73df3e9285",22855392,1,136,0,2583,375,464,89
"83d42d95cd844fc093fc09cee250edb8","d6d02b6ef04e4f17805504500b8ce441",22855392,1,-139,0,2589,465,375,-90
"d6d02b6ef04e4f17805504500b8ce441","3cbcea2be0984e7dbd5a48195af10ce7",22855392,1,-284,0,2594,375,165,-210
"82e6285962b8400d9d6fc32436022a94","d6d02b6ef04e4f17805504500b8ce441",22855392,1,282,0,2596,167,375,208
"7f544639412e40a9ba27f43b415362ab","afbf7250b99d47bea07172749483ca97",22855392,1,-478,0,2602,378,28,-350
"afbf7250b99d47bea07172749483ca97","b534b89233134e30a9b5645138bfa9ee",22855392,1,32,0,2603,28,41,13
"b534b89233134e30a9b5645138bfa9ee","3cbcea2be0984e7dbd5a48195af10ce7",22855392,1,156,0,2604,41,165,124
"b613861cecf84ffcab01afb23f660475","b613861cecf84ffcab01afb23f660475",22856155,4,0,1,1,1,1,0
"b613861cecf84ffcab01afb23f660475","e2911e79efc2420eac45d9f671463d4b",22856155,1,3,0,5,1,2,1
"e2911e79efc2420eac45d9f671463d4b","e2911e79efc2420eac45d9f671463d4b",22856155,2,0,1,6,2,2,0
"e2911e79efc2420eac45d9f671463d4b","519d1b8c59404d67b54e96c5c8a830b2",22856155,1,1,0,8,2,3,1
"519d1b8c59404d67b54e96c5c8a830b2","519d1b8c59404d67b54e96c5c8a830b2",22856155,2,0,1,10,3,3,0
"519d1b8c59404d67b54e96c5c8a830b2","531db53f81f646edb0cdcfe0085b03b7",22856155,1,1,0,11,3,4,1
"531db53f81f646edb0cdcfe0085b03b7","531db53f81f646edb0cdcfe0085b03b7",22856155,1,0,1,12,4,4,0
"531db53f81f646edb0cdcfe0085b03b7","4f5f94b2f95141e0a9d53a61da2276da",22856155,1,1,0,13,4,5,1
"4f5f94b2f95141e0a9d53a61da2276da","4f5f94b2f95141e0a9d53a61da2276da",22856155,1,0,1,14,5,5,0
"4f5f94b2f95141e0a9d53a61da2276da","6d541c89590949f99af293c4f2333f67",22856155,1,1,0,15,5,6,1
"6d541c89590949f99af293c4f2333f67","6d541c89590949f99af293c4f2333f67",22856155,1,0,1,16,6,6,0
"6d541c89590949f99af293c4f2333f67","dd5cf0b9fe4c4f1d8f5ff8e4c04879cb",22856155,1,1,0,17,6,7,1
"dd5cf0b9fe4c4f1d8f5ff8e4c04879cb","dd5cf0b9fe4c4f1d8f5ff8e4c04879cb",22856155,1,0,1,18,7,7,0
"dd5cf0b9fe4c4f1d8f5ff8e4c04879cb","f96261861edc426abe2248be4f0a709a",22856155,1,1,0,19,7,8,1
"f96261861edc426abe2248be4f0a709a","f96261861edc426abe2248be4f0a709a",22856155,1,0,1,20,8,8,0
"f96261861edc426abe2248be4f0a709a","66b5e16f4f75454fb5b8172079f0fa83",22856155,1,1,0,21,8,9,1
"66b5e16f4f75454fb5b8172079f0fa83","66b5e16f4f75454fb5b8172079f0fa83",22856155,1,0,1,22,9,9,0
"66b5e16f4f75454fb5b8172079f0fa83","0680571d4698477995e41842c36a54b2",22856155,1,1,0,23,9,10,1
"0680571d4698477995e41842c36a54b2","0680571d4698477995e41842c36a54b2",22856155,1,0,1,24,10,10,0
"0680571d4698477995e41842c36a54b2","9112f2bffece48e08c6d2287be204085",22856155,1,1,0,25,10,11,1
"9112f2bffece48e08c6d2287be204085","9112f2bffece48e08c6d2287be204085",22856155,1,0,1,26,11,11,0
"9112f2bffece48e08c6d2287be204085","e2911e79efc2420eac45d9f671463d4b",22856155,1,-9,0,27,11,2,-9
"e2911e79efc2420eac45d9f671463d4b","56586aa865414f538729c7f7735d2bc6",22856155,3,12,0,28,2,12,10
"56586aa865414f538729c7f7735d2bc6","56586aa865414f538729c7f7735d2bc6",22856155,9,0,1,29,12,12,0
"56586aa865414f538729c7f7735d2bc6","b7f2b31585d94eb3bf86376714aa7070",22856155,4,2,0,34,12,13,1
"b7f2b31585d94eb3bf86376714aa7070","56586aa865414f538729c7f7735d2bc6",22856155,2,-2,0,35,13,12,-1
"b7f2b31585d94eb3bf86376714aa7070","b7f2b31585d94eb3bf86376714aa7070",22856155,4,0,1,37,13,13,0
"b7f2b31585d94eb3bf86376714aa7070","3f1c815879794b929260d224becaff7e",22856155,2,2,0,39,13,14,1
"3f1c815879794b929260d224becaff7e","56586aa865414f538729c7f7735d2bc6",22856155,1,-4,0,40,14,12,-2
"56586aa865414f538729c7f7735d2bc6","e2911e79efc2420eac45d9f671463d4b",22856155,2,-12,0,47,12,2,-10
"3f1c815879794b929260d224becaff7e","81c864a886d54a6b8ff85f7d736f4f95",22856155,1,2,0,55,14,15,1
"81c864a886d54a6b8ff85f7d736f4f95","5c5ceeee4562457ba6d41515aeebfbb1",22856155,1,4,0,56,15,17,2
"5c5ceeee4562457ba6d41515aeebfbb1","5c5ceeee4562457ba6d41515aeebfbb1",22856155,1,0,1,57,17,17,0
"5c5ceeee4562457ba6d41515aeebfbb1","9afd71a5298d4333b6849dfce1b9422c",22856155,1,3,0,58,17,18,1
"9afd71a5298d4333b6849dfce1b9422c","56586aa865414f538729c7f7735d2bc6",22856155,1,-13,0,59,18,12,-6
"56586aa865414f538729c7f7735d2bc6","9afd71a5298d4333b6849dfce1b9422c",22856155,1,13,0,60,12,18,6
"9afd71a5298d4333b6849dfce1b9422c","9afd71a5298d4333b6849dfce1b9422c",22856155,2,0,1,61,18,18,0
"9afd71a5298d4333b6849dfce1b9422c","b7719e26494940efa49512aedd0aac79",22856155,1,4,0,63,18,20,2
"d4c3b003e8274e429d2fa688d73fde6d","d4c3b003e8274e429d2fa688d73fde6d",22856155,4,0,1,66,22,22,0
"afbf7250b99d47bea07172749483ca97","afbf7250b99d47bea07172749483ca97",22856155,2,0,1,73,28,28,0
"afbf7250b99d47bea07172749483ca97","b7719e26494940efa49512aedd0aac79",22856155,1,-12,0,74,28,20,-8
"afbf7250b99d47bea07172749483ca97","4e51676dc72045d99c19b9fa7b22f8bc",22856155,1,3,0,78,28,29,1
"4e51676dc72045d99c19b9fa7b22f8bc","51970cfa30e643e894e66ae85c8024cc",22856155,1,3,0,80,29,31,2
"51970cfa30e643e894e66ae85c8024cc","4e51676dc72045d99c19b9fa7b22f8bc",22856155,1,-3,0,81,31,29,-2
"c33c17be71ae4d588da7369472e5bb1b","7040a13096d746ac84b8fac8d9752058",22856155,1,6,0,85,34,36,2
"7040a13096d746ac84b8fac8d9752058","93679be414554a11b1893002f2229a93",22856155,1,-3,0,86,36,35,-1
"93679be414554a11b1893002f2229a93","9a0dc646f934470daf08c4b56ccf73db",22856155,1,6,0,87,35,37,2
"fc0e049d56024bc9a02c9a9c435c3df7","fc0e049d56024bc9a02c9a9c435c3df7",22856155,1,0,1,91,38,38,0
"64d48c6c9c7940639a932219a6c87198","67a089198fcb4e1c8f2385786c2b296f",22856155,1,-1,0,95,40,39,-1
"b534b89233134e30a9b5645138bfa9ee","0e37b720d23b4e7f8b313e79313fd107",22856155,1,3,0,97,41,44,3
"0e37b720d23b4e7f8b313e79313fd107","0e37b720d23b4e7f8b313e79313fd107",22856155,1,0,1,98,44,44,0
"0e37b720d23b4e7f8b313e79313fd107","6875d67fdd5f48168b62719df449bebd",22856155,1,1,0,99,44,45,1
"6875d67fdd5f48168b62719df449bebd","6875d67fdd5f48168b62719df449bebd",22856155,3,0,1,100,45,45,0
"6875d67fdd5f48168b62719df449bebd","b534b89233134e30a9b5645138bfa9ee",22856155,1,-4,0,103,45,41,-4
"b534b89233134e30a9b5645138bfa9ee","6e13d61a7bdb44bca949c9f86fab3be5",22856155,2,7,0,104,41,47,6
"6e13d61a7bdb44bca949c9f86fab3be5","6e13d61a7bdb44bca949c9f86fab3be5",22856155,3,0,1,105,47,47,0
"6e13d61a7bdb44bca949c9f86fab3be5","195f78799f984cc2b06c48dfe36be751",22856155,1,2,0,108,47,49,2
"195f78799f984cc2b06c48dfe36be751","195f78799f984cc2b06c48dfe36be751",22856155,2,0,1,109,49,49,0
"195f78799f984cc2b06c48dfe36be751","d9c8d8c444a64dadbbb508652c721e17",22856155,1,-3,0,111,49,46,-3
"d9c8d8c444a64dadbbb508652c721e17","d0c74f735e024943943e40333d6d337f",22856155,2,6,0,112,46,51,5
"d0c74f735e024943943e40333d6d337f","d0c74f735e024943943e40333d6d337f",22856155,1,0,1,113,51,51,0
"d0c74f735e024943943e40333d6d337f","983f8ff320594b279a7f4a6fe132f9c5",22856155,1,2,0,114,51,53,2
"983f8ff320594b279a7f4a6fe132f9c5","983f8ff320594b279a7f4a6fe132f9c5",22856155,2,0,1,115,53,53,0
"983f8ff320594b279a7f4a6fe132f9c5","35adfa5d923046aebabfefd98f35ff05",22856155,1,1,0,117,53,54,1
"35adfa5d923046aebabfefd98f35ff05","35adfa5d923046aebabfefd98f35ff05",22856155,2,0,1,118,54,54,0
"35adfa5d923046aebabfefd98f35ff05","b6f8a98476224da1b40e555ececc7ed8",22856155,1,1,0,120,54,55,1
"b6f8a98476224da1b40e555ececc7ed8","b6f8a98476224da1b40e555ececc7ed8",22856155,2,0,1,121,55,55,0
"b6f8a98476224da1b40e555ececc7ed8","86e22cb5fe0e4b47a9489ecddf7ed78f",22856155,1,1,0,123,55,56,1
"86e22cb5fe0e4b47a9489ecddf7ed78f","86e22cb5fe0e4b47a9489ecddf7ed78f",22856155,2,0,1,124,56,56,0
"86e22cb5fe0e4b47a9489ecddf7ed78f","f924752d8a1149668870b1e7698486f7",22856155,1,-6,0,126,56,50,-6
"f924752d8a1149668870b1e7698486f7","a1f2f12debe5432fb7a70bcd12bacfb9",22856155,1,9,0,127,50,58,8
"a1f2f12debe5432fb7a70bcd12bacfb9","78f30e4dcac84e3cbea8b2cc6e0d62b3",22856155,2,1,0,128,58,59,1
"78f30e4dcac84e3cbea8b2cc6e0d62b3","a1f2f12debe5432fb7a70bcd12bacfb9",22856155,1,-1,0,129,59,58,-1
"a1f2f12debe5432fb7a70bcd12bacfb9","a1f2f12debe5432fb7a70bcd12bacfb9",22856155,22,0,1,130,58,58,0
"78f30e4dcac84e3cbea8b2cc6e0d62b3","78f30e4dcac84e3cbea8b2cc6e0d62b3",22856155,11,0,1,153,59,59,0
"78f30e4dcac84e3cbea8b2cc6e0d62b3","bc42d26810654ea9a1df1efe1e58c7d5",22856155,1,5,0,164,59,63,4
"bc42d26810654ea9a1df1efe1e58c7d5","a0a418b8540d479fa6e0f653b701da8b",22856155,1,1,0,165,63,64,1
"a0a418b8540d479fa6e0f653b701da8b","12aa6e1672ac4e7aa6449a7a8609cd72",22856155,2,-8,0,166,64,57,-7
"12aa6e1672ac4e7aa6449a7a8609cd72","4c943503763e4e349906eea3ed3c8e86",22856155,1,5,0,167,57,61,4
"4c943503763e4e349906eea3ed3c8e86","4c943503763e4e349906eea3ed3c8e86",22856155,1,0,1,168,61,61,0
"4c943503763e4e349906eea3ed3c8e86","309ccf3cc4fe429d9bfbaef53d3fa479",22856155,1,-1,0,169,61,60,-1
"309ccf3cc4fe429d9bfbaef53d3fa479","d646286c8051419bbc2e31dd1db55ca8",22856155,1,10,0,170,60,67,7
"d646286c8051419bbc2e31dd1db55ca8","b534b89233134e30a9b5645138bfa9ee",22856155,3,-33,0,171,67,41,-26
"b534b89233134e30a9b5645138bfa9ee","267f883678b24aed855fde42524975d9",22856155,1,37,0,172,41,71,30
"267f883678b24aed855fde42524975d9","267f883678b24aed855fde42524975d9",22856155,1,0,1,173,71,71,0
"267f883678b24aed855fde42524975d9","88fff56d0342490dbef9040750a20f6c",22856155,1,1,0,174,71,72,1
"88fff56d0342490dbef9040750a20f6c","88fff56d0342490dbef9040750a20f6c",22856155,1,0,1,175,72,72,0
"88fff56d0342490dbef9040750a20f6c","adb17b12b66c4a49a85fd34322f7df70",22856155,1,1,0,176,72,73,1
"adb17b12b66c4a49a85fd34322f7df70","adb17b12b66c4a49a85fd34322f7df70",22856155,1,0,1,177,73,73,0
"adb17b12b66c4a49a85fd34322f7df70","d646286c8051419bbc2e31dd1db55ca8",22856155,1,-6,0,178,73,67,-6
"d646286c8051419bbc2e31dd1db55ca8","a2becd407db34b189200a32546d9d569",22856155,2,9,0,179,67,75,8
"a2becd407db34b189200a32546d9d569","a2becd407db34b189200a32546d9d569",22856155,2,0,1,180,75,75,0
"a2becd407db34b189200a32546d9d569","58c22b011d0f4c2ea6d13615edbb9eeb",22856155,1,2,0,181,75,77,2
"58c22b011d0f4c2ea6d13615edbb9eeb","58c22b011d0f4c2ea6d13615edbb9eeb",22856155,11,0,1,182,77,77,0
"58c22b011d0f4c2ea6d13615edbb9eeb","dd76e1861dc9461c830888729d091ee0",22856155,1,1,0,193,77,78,1
"dd76e1861dc9461c830888729d091ee0","dd76e1861dc9461c830888729d091ee0",22856155,5,0,1,194,78,78,0
"dd76e1861dc9461c830888729d091ee0","cd1d828f1a694b87913a7ea66c23803e",22856155,1,1,0,199,78,79,1
"cd1d828f1a694b87913a7ea66c23803e","cd1d828f1a694b87913a7ea66c23803e",22856155,5,0,1,200,79,79,0
"cd1d828f1a694b87913a7ea66c23803e","9176a3c2b4d2465fa8b0c67096c2a97e",22856155,1,1,0,205,79,80,1
"9176a3c2b4d2465fa8b0c67096c2a97e","9176a3c2b4d2465fa8b0c67096c2a97e",22856155,5,0,1,206,80,80,0
"9176a3c2b4d2465fa8b0c67096c2a97e","f8ec6445f7194e25b9101d4fbcb07a18",22856155,1,1,0,211,80,81,1
"f8ec6445f7194e25b9101d4fbcb07a18","f8ec6445f7194e25b9101d4fbcb07a18",22856155,2,0,1,212,81,81,0
"f8ec6445f7194e25b9101d4fbcb07a18","140d5b27b8574befad82c0a013b59dfa",22856155,1,-7,0,214,81,74,-7
"140d5b27b8574befad82c0a013b59dfa","d18a9ea32855445f8736581f5cb119ce",22856155,2,9,0,215,74,82,8
"d18a9ea32855445f8736581f5cb119ce","ae5ac430ea254e708a6f5deaaf7464ae",22856155,1,3,0,216,82,84,2
"ae5ac430ea254e708a6f5deaaf7464ae","d18a9ea32855445f8736581f5cb119ce",22856155,1,-3,0,217,84,82,-2
"d18a9ea32855445f8736581f5cb119ce","f564483cbd7a407681aa2fcca518cf5f",22856155,1,4,0,218,82,85,3
"f564483cbd7a407681aa2fcca518cf5f","f564483cbd7a407681aa2fcca518cf5f",22856155,4,0,1,219,85,85,0
"f564483cbd7a407681aa2fcca518cf5f","18fd01350bd5434ca636d59a599d768a",22856155,1,1,0,223,85,86,1
"18fd01350bd5434ca636d59a599d768a","18fd01350bd5434ca636d59a599d768a",22856155,9,0,1,224,86,86,0
"18fd01350bd5434ca636d59a599d768a","6a9f0ef185fb47f0937e29daa1c71ed5",22856155,1,5,0,233,86,90,4
"6a9f0ef185fb47f0937e29daa1c71ed5","ae5ac430ea254e708a6f5deaaf7464ae",22856155,2,-7,0,234,90,84,-6
"ae5ac430ea254e708a6f5deaaf7464ae","c681290961c94c4caf23b529d1ae6b9a",22856155,1,5,0,235,84,88,4
"c681290961c94c4caf23b529d1ae6b9a","c681290961c94c4caf23b529d1ae6b9a",22856155,2,0,1,236,88,88,0
"c681290961c94c4caf23b529d1ae6b9a","d646286c8051419bbc2e31dd1db55ca8",22856155,1,-25,0,238,88,67,-21
"d646286c8051419bbc2e31dd1db55ca8","e20db35ced8544ddac5bc3839145e463",22856155,3,30,0,239,67,91,24
"e20db35ced8544ddac5bc3839145e463","b7719e26494940efa49512aedd0aac79",22856155,1,-107,0,240,91,20,-71
"d4c3b003e8274e429d2fa688d73fde6d","231c15562ab8497daeb55e56acf3b35c",22856155,1,106,0,243,22,93,71
"231c15562ab8497daeb55e56acf3b35c","231c15562ab8497daeb55e56acf3b35c",22856155,1,0,1,244,93,93,0
"231c15562ab8497daeb55e56acf3b35c","e20db35ced8544ddac5bc3839145e463",22856155,1,-2,0,245,93,91,-2
"e20db35ced8544ddac5bc3839145e463","1febb706d7a34005ae8711ed49c76e64",22856155,1,3,0,246,91,94,3
"1febb706d7a34005ae8711ed49c76e64","1febb706d7a34005ae8711ed49c76e64",22856155,4,0,1,247,94,94,0
"1febb706d7a34005ae8711ed49c76e64","8f73ba6f5a0042f2850356ac38ac6f24",22856155,1,1,0,249,94,95,1
"8f73ba6f5a0042f2850356ac38ac6f24","8f73ba6f5a0042f2850356ac38ac6f24",22856155,5,0,1,250,95,95,0
"8f73ba6f5a0042f2850356ac38ac6f24","e2260b86653c46d7b14a41fb419dbf8c",22856155,1,1,0,255,95,96,1
"e2260b86653c46d7b14a41fb419dbf8c","e2260b86653c46d7b14a41fb419dbf8c",22856155,2,0,1,256,96,96,0
"e2260b86653c46d7b14a41fb419dbf8c","35eb641ad1d845bbba54915bce75a962",22856155,1,1,0,258,96,97,1
"35eb641ad1d845bbba54915bce75a962","35eb641ad1d845bbba54915bce75a962",22856155,2,0,1,259,97,97,0
"35eb641ad1d845bbba54915bce75a962","08be90ffbeea4795a138cd42ed8db56f",22856155,1,1,0,261,97,98,1
"08be90ffbeea4795a138cd42ed8db56f","08be90ffbeea4795a138cd42ed8db56f",22856155,5,0,1,262,98,98,0
"08be90ffbeea4795a138cd42ed8db56f","3007433c8f584dcbb5ac159c1c5f2be3",22856155,1,1,0,267,98,99,1
"3007433c8f584dcbb5ac159c1c5f2be3","3007433c8f584dcbb5ac159c1c5f2be3",22856155,5,0,1,268,99,99,0
"3007433c8f584dcbb5ac159c1c5f2be3","d391c8b6e56a43a7b654e9dee02d904b",22856155,1,5,0,273,99,103,4
"d391c8b6e56a43a7b654e9dee02d904b","00ae5f0c51874a73a41ebea838d95682",22856155,1,-2,0,274,103,101,-2
"00ae5f0c51874a73a41ebea838d95682","e20db35ced8544ddac5bc3839145e463",22856155,2,-11,0,275,101,91,-10
"e20db35ced8544ddac5bc3839145e463","00ae5f0c51874a73a41ebea838d95682",22856155,2,11,0,276,91,101,10
"00ae5f0c51874a73a41ebea838d95682","d391c8b6e56a43a7b654e9dee02d904b",22856155,2,2,0,277,101,103,2
"d391c8b6e56a43a7b654e9dee02d904b","d391c8b6e56a43a7b654e9dee02d904b",22856155,15,0,1,278,103,103,0
"d391c8b6e56a43a7b654e9dee02d904b","6111116566fc4fd9abba409322bea245",22856155,1,1,0,293,103,104,1
"6111116566fc4fd9abba409322bea245","6111116566fc4fd9abba409322bea245",22856155,2,0,1,294,104,104,0
"6111116566fc4fd9abba409322bea245","a81b2235cb9c499eb9ea8ee0a8dd9725",22856155,1,1,0,296,104,105,1
"a81b2235cb9c499eb9ea8ee0a8dd9725","a81b2235cb9c499eb9ea8ee0a8dd9725",22856155,8,0,1,297,105,105,0
"a81b2235cb9c499eb9ea8ee0a8dd9725","2d4e0ab0ef3b4d73b82c72d4621a7579",22856155,1,1,0,305,105,106,1
"2d4e0ab0ef3b4d73b82c72d4621a7579","2d4e0ab0ef3b4d73b82c72d4621a7579",22856155,2,0,1,306,106,106,0
"2d4e0ab0ef3b4d73b82c72d4621a7579","8bdebf492ebd4e62b0d522e8ab5e5197",22856155,1,1,0,308,106,107,1
"8bdebf492ebd4e62b0d522e8ab5e5197","8bdebf492ebd4e62b0d522e8ab5e5197",22856155,2,0,1,309,107,107,0
"8bdebf492ebd4e62b0d522e8ab5e5197","73039f8c1eb9409cb4caee2cf968001e",22856155,1,-7,0,311,107,100,-7
"73039f8c1eb9409cb4caee2cf968001e","4280927ec4d643238aa49c32f9e06c6c",22856155,3,10,0,312,100,109,9
"4280927ec4d643238aa49c32f9e06c6c","08111f75e22d409998cf8b85bd431f0a",22856155,1,-1,0,313,109,108,-1
"08111f75e22d409998cf8b85bd431f0a","00ae5f0c51874a73a41ebea838d95682",22856155,1,-8,0,314,108,101,-7
"d391c8b6e56a43a7b654e9dee02d904b","73039f8c1eb9409cb4caee2cf968001e",22856155,2,-3,0,316,103,100,-3
"73039f8c1eb9409cb4caee2cf968001e","00ae5f0c51874a73a41ebea838d95682",22856155,1,1,0,317,100,101,1
"e20db35ced8544ddac5bc3839145e463","d391c8b6e56a43a7b654e9dee02d904b",22856155,1,13,0,319,91,103,12
"d391c8b6e56a43a7b654e9dee02d904b","4280927ec4d643238aa49c32f9e06c6c",22856155,1,7,0,320,103,109,6
"4280927ec4d643238aa49c32f9e06c6c","73039f8c1eb9409cb4caee2cf968001e",22856155,2,-10,0,321,109,100,-9
"4280927ec4d643238aa49c32f9e06c6c","fc44e6a5f7654430af1227838224dceb",22856155,1,2,0,323,109,111,2
"fc44e6a5f7654430af1227838224dceb","fc44e6a5f7654430af1227838224dceb",22856155,5,0,1,324,111,111,0
"fc44e6a5f7654430af1227838224dceb","a9ae0a3c070d455bb4369a8996313336",22856155,1,4,0,329,111,114,3
"a9ae0a3c070d455bb4369a8996313336","08111f75e22d409998cf8b85bd431f0a",22856155,2,-7,0,330,114,108,-6
"08111f75e22d409998cf8b85bd431f0a","37319e88176d4aefa91d7a9980dbae91",22856155,2,5,0,331,108,112,4
"37319e88176d4aefa91d7a9980dbae91","e20db35ced8544ddac5bc3839145e463",22856155,1,-24,0,332,112,91,-21
"e20db35ced8544ddac5bc3839145e463","62bff51286ef4f348717a3cf6fe2318f",22856155,2,33,0,333,91,120,29
"62bff51286ef4f348717a3cf6fe2318f","779f9ddd1fd14d1e9e69f72219a1fdbd",22856155,2,3,0,334,120,121,1
"779f9ddd1fd14d1e9e69f72219a1fdbd","779f9ddd1fd14d1e9e69f72219a1fdbd",22856155,5,0,1,335,121,121,0
"779f9ddd1fd14d1e9e69f72219a1fdbd","e20db35ced8544ddac5bc3839145e463",22856155,11,-36,0,336,121,91,-30
"62bff51286ef4f348717a3cf6fe2318f","3ec3a3563847406fa73338f9e9999cf3",22856155,2,-3,0,338,120,117,-3
"3ec3a3563847406fa73338f9e9999cf3","a9ae0a3c070d455bb4369a8996313336",22856155,2,-4,0,339,117,114,-3
"a9ae0a3c070d455bb4369a8996313336","a9ae0a3c070d455bb4369a8996313336",22856155,1,0,1,340,114,114,0
"a9ae0a3c070d455bb4369a8996313336","b7719e26494940efa49512aedd0aac79",22856155,1,-133,0,341,114,20,-94
"d4c3b003e8274e429d2fa688d73fde6d","a9ae0a3c070d455bb4369a8996313336",22856155,1,130,0,344,22,114,92
"a9ae0a3c070d455bb4369a8996313336","e20db35ced8544ddac5bc3839145e463",22856155,1,-26,0,345,114,91,-23
"e20db35ced8544ddac5bc3839145e463","a9ae0a3c070d455bb4369a8996313336",22856155,1,26,0,346,91,114,23
"a9ae0a3c070d455bb4369a8996313336","71cec822bcff4f30a20e75dc63ef7b65",22856155,1,2,0,347,114,116,2
"71cec822bcff4f30a20e75dc63ef7b65","71cec822bcff4f30a20e75dc63ef7b65",22856155,3,0,1,348,116,116,0
"71cec822bcff4f30a20e75dc63ef7b65","37319e88176d4aefa91d7a9980dbae91",22856155,1,-4,0,351,116,112,-4
"37319e88176d4aefa91d7a9980dbae91","62bff51286ef4f348717a3cf6fe2318f",22856155,2,9,0,352,112,120,8
"62bff51286ef4f348717a3cf6fe2318f","b1cd0e7dc3ad4a8eb91a4bfdbeb025b0",22856155,1,-2,0,353,120,118,-2
"b1cd0e7dc3ad4a8eb91a4bfdbeb025b0","b1cd0e7dc3ad4a8eb91a4bfdbeb025b0",22856155,2,0,1,354,118,118,0
"b1cd0e7dc3ad4a8eb91a4bfdbeb025b0","62bff51286ef4f348717a3cf6fe2318f",22856155,1,2,0,356,118,120,2
"62bff51286ef4f348717a3cf6fe2318f","62bff51286ef4f348717a3cf6fe2318f",22856155,7,0,1,357,120,120,0
"e20db35ced8544ddac5bc3839145e463","779f9ddd1fd14d1e9e69f72219a1fdbd",22856155,11,36,0,362,91,121,30
"e20db35ced8544ddac5bc3839145e463","e20db35ced8544ddac5bc3839145e463",22856155,4,0,1,364,91,91,0
"779f9ddd1fd14d1e9e69f72219a1fdbd","62bff51286ef4f348717a3cf6fe2318f",22856155,1,-3,0,389,121,120,-1
"a9ae0a3c070d455bb4369a8996313336","4280927ec4d643238aa49c32f9e06c6c",22856155,1,-6,0,394,114,109,-5
"4280927ec4d643238aa49c32f9e06c6c","37319e88176d4aefa91d7a9980dbae91",22856155,1,4,0,395,109,112,3
"37319e88176d4aefa91d7a9980dbae91","00ae5f0c51874a73a41ebea838d95682",22856155,1,-13,0,396,112,101,-11
"00ae5f0c51874a73a41ebea838d95682","08111f75e22d409998cf8b85bd431f0a",22856155,1,8,0,397,101,108,7
"08111f75e22d409998cf8b85bd431f0a","d391c8b6e56a43a7b654e9dee02d904b",22856155,1,-6,0,398,108,103,-5
"73039f8c1eb9409cb4caee2cf968001e","e20db35ced8544ddac5bc3839145e463",22856155,1,-10,0,400,100,91,-9
"e20db35ced8544ddac5bc3839145e463","d646286c8051419bbc2e31dd1db55ca8",22856155,4,-30,0,401,91,67,-24
"d646286c8051419bbc2e31dd1db55ca8","6a9f0ef185fb47f0937e29daa1c71ed5",22856155,1,27,0,406,67,90,23
"ae5ac430ea254e708a6f5deaaf7464ae","42fb58708eaf4e5daa82bfca61b6f5fd",22856155,1,4,0,408,84,87,3
"42fb58708eaf4e5daa82bfca61b6f5fd","a2becd407db34b189200a32546d9d569",22856155,1,-15,0,409,87,75,-12
"a2becd407db34b189200a32546d9d569","d18a9ea32855445f8736581f5cb119ce",22856155,1,8,0,410,75,82,7
"d18a9ea32855445f8736581f5cb119ce","140d5b27b8574befad82c0a013b59dfa",22856155,1,-9,0,411,82,74,-8
"140d5b27b8574befad82c0a013b59dfa","d646286c8051419bbc2e31dd1db55ca8",22856155,1,-8,0,412,74,67,-7
"b534b89233134e30a9b5645138bfa9ee","d646286c8051419bbc2e31dd1db55ca8",22856155,3,33,0,414,41,67,26
"b534b89233134e30a9b5645138bfa9ee","b534b89233134e30a9b5645138bfa9ee",22856155,1,0,1,416,41,41,0
"d646286c8051419bbc2e31dd1db55ca8","7af822066add4e7f8e007e4eee31a8bf",22856155,1,-4,0,418,67,65,-2
"7af822066add4e7f8e007e4eee31a8bf","a0a418b8540d479fa6e0f653b701da8b",22856155,1,-2,0,419,65,64,-1
"a0a418b8540d479fa6e0f653b701da8b","bc42d26810654ea9a1df1efe1e58c7d5",22856155,1,-1,0,420,64,63,-1
"bc42d26810654ea9a1df1efe1e58c7d5","309ccf3cc4fe429d9bfbaef53d3fa479",22856155,2,-3,0,421,63,60,-3
"309ccf3cc4fe429d9bfbaef53d3fa479","a1f2f12debe5432fb7a70bcd12bacfb9",22856155,1,-3,0,422,60,58,-2
"a1f2f12debe5432fb7a70bcd12bacfb9","12aa6e1672ac4e7aa6449a7a8609cd72",22856155,1,-1,0,423,58,57,-1
"12aa6e1672ac4e7aa6449a7a8609cd72","6e13d61a7bdb44bca949c9f86fab3be5",22856155,1,-12,0,424,57,47,-10
"6e13d61a7bdb44bca949c9f86fab3be5","d0c74f735e024943943e40333d6d337f",22856155,2,5,0,425,47,51,4
"d0c74f735e024943943e40333d6d337f","f924752d8a1149668870b1e7698486f7",22856155,1,-1,0,426,51,50,-1
"f924752d8a1149668870b1e7698486f7","78f30e4dcac84e3cbea8b2cc6e0d62b3",22856155,2,10,0,427,50,59,9
"78f30e4dcac84e3cbea8b2cc6e0d62b3","d9c8d8c444a64dadbbb508652c721e17",22856155,1,-15,0,428,59,46,-13
"d9c8d8c444a64dadbbb508652c721e17","67a089198fcb4e1c8f2385786c2b296f",22856155,1,-10,0,429,46,39,-7
"b534b89233134e30a9b5645138bfa9ee","64d48c6c9c7940639a932219a6c87198",22856155,1,-3,0,431,41,40,-1
"64d48c6c9c7940639a932219a6c87198","64d48c6c9c7940639a932219a6c87198",22856155,9,0,1,432,40,40,0
"67a089198fcb4e1c8f2385786c2b296f","6e13d61a7bdb44bca949c9f86fab3be5",22856155,1,11,0,442,39,47,8
"6e13d61a7bdb44bca949c9f86fab3be5","b534b89233134e30a9b5645138bfa9ee",22856155,1,-7,0,443,47,41,-6
"d0c74f735e024943943e40333d6d337f","d9c8d8c444a64dadbbb508652c721e17",22856155,1,-6,0,446,51,46,-5
"d0c74f735e024943943e40333d6d337f","a1f2f12debe5432fb7a70bcd12bacfb9",22856155,1,8,0,448,51,58,7
"a1f2f12debe5432fb7a70bcd12bacfb9","f924752d8a1149668870b1e7698486f7",22856155,1,-9,0,449,58,50,-8
"78f30e4dcac84e3cbea8b2cc6e0d62b3","a0a418b8540d479fa6e0f653b701da8b",22856155,1,6,0,451,59,64,5
"12aa6e1672ac4e7aa6449a7a8609cd72","bc42d26810654ea9a1df1efe1e58c7d5",22856155,1,7,0,453,57,63,6
"309ccf3cc4fe429d9bfbaef53d3fa479","b534b89233134e30a9b5645138bfa9ee",22856155,1,-23,0,455,60,41,-19
"d646286c8051419bbc2e31dd1db55ca8","d646286c8051419bbc2e31dd1db55ca8",22856155,1,0,1,457,67,67,0
"a2becd407db34b189200a32546d9d569","140d5b27b8574befad82c0a013b59dfa",22856155,1,-1,0,460,75,74,-1
"d18a9ea32855445f8736581f5cb119ce","18fd01350bd5434ca636d59a599d768a",22856155,1,5,0,462,82,86,4
"18fd01350bd5434ca636d59a599d768a","ae5ac430ea254e708a6f5deaaf7464ae",22856155,1,-2,0,463,86,84,-2
"ae5ac430ea254e708a6f5deaaf7464ae","6a9f0ef185fb47f0937e29daa1c71ed5",22856155,1,7,0,464,84,90,6
"6a9f0ef185fb47f0937e29daa1c71ed5","e20db35ced8544ddac5bc3839145e463",22856155,1,3,0,465,90,91,1
"d646286c8051419bbc2e31dd1db55ca8","1febb706d7a34005ae8711ed49c76e64",22856155,1,33,0,467,67,94,27
"1febb706d7a34005ae8711ed49c76e64","d391c8b6e56a43a7b654e9dee02d904b",22856155,1,10,0,470,94,103,9
"d391c8b6e56a43a7b654e9dee02d904b","e20db35ced8544ddac5bc3839145e463",22856155,1,-13,0,471,103,91,-12
"00ae5f0c51874a73a41ebea838d95682","00ae5f0c51874a73a41ebea838d95682",22856155,1,0,1,473,101,101,0
"00ae5f0c51874a73a41ebea838d95682","4280927ec4d643238aa49c32f9e06c6c",22856155,1,9,0,474,101,109,8
"4280927ec4d643238aa49c32f9e06c6c","a9ae0a3c070d455bb4369a8996313336",22856155,1,6,0,477,109,114,5
"62bff51286ef4f348717a3cf6fe2318f","e20db35ced8544ddac5bc3839145e463",22856155,1,-33,0,483,120,91,-29
"779f9ddd1fd14d1e9e69f72219a1fdbd","ae26e6cda8ad4a3f81bd347560d9579f",22856155,1,4,0,485,121,125,4
"ae26e6cda8ad4a3f81bd347560d9579f","ae26e6cda8ad4a3f81bd347560d9579f",22856155,1,0,1,486,125,125,0
"ae26e6cda8ad4a3f81bd347560d9579f","ee48df95832b4374aa273ceb27ec1315",22856155,1,1,0,487,125,126,1
"ee48df95832b4374aa273ceb27ec1315","ee48df95832b4374aa273ceb27ec1315",22856155,1,0,1,488,126,126,0
"ee48df95832b4374aa273ceb27ec1315","7a439da90b394756ad1777fc4c6dead5",22856155,1,1,0,489,126,127,1
"7a439da90b394756ad1777fc4c6dead5","7a439da90b394756ad1777fc4c6dead5",22856155,1,0,1,490,127,127,0
"7a439da90b394756ad1777fc4c6dead5","a8dd5213034441ac92724b4e83eb0bb2",22856155,1,3,0,491,127,129,2
"a8dd5213034441ac92724b4e83eb0bb2","779f9ddd1fd14d1e9e69f72219a1fdbd",22856155,1,-9,0,492,129,121,-8
"779f9ddd1fd14d1e9e69f72219a1fdbd","a8dd5213034441ac92724b4e83eb0bb2",22856155,1,9,0,493,121,129,8
"a8dd5213034441ac92724b4e83eb0bb2","a8dd5213034441ac92724b4e83eb0bb2",22856155,2,0,1,494,129,129,0
"a8dd5213034441ac92724b4e83eb0bb2","8115eab6556b45f5b415c3b8c26a12e5",22856155,1,2,0,496,129,131,2
"8115eab6556b45f5b415c3b8c26a12e5","8115eab6556b45f5b415c3b8c26a12e5",22856155,2,0,1,497,131,131,0
"8115eab6556b45f5b415c3b8c26a12e5","ec34b06efd844b46a4c4818ecdb9b8f4",22856155,1,1,0,499,131,132,1
"ec34b06efd844b46a4c4818ecdb9b8f4","ec34b06efd844b46a4c4818ecdb9b8f4",22856155,8,0,1,500,132,132,0
"ec34b06efd844b46a4c4818ecdb9b8f4","c2e1c2b9eac64109b343a088584b576b",22856155,1,1,0,508,132,133,1
"c2e1c2b9eac64109b343a088584b576b","c2e1c2b9eac64109b343a088584b576b",22856155,2,0,1,509,133,133,0
"c2e1c2b9eac64109b343a088584b576b","579338175e0b4bbb8ef3b712b5d8b54e",22856155,1,-5,0,511,133,128,-5
"579338175e0b4bbb8ef3b712b5d8b54e","8bc5795d6a984a3eace4e2811e52dd4f",22856155,1,8,0,512,128,135,7
"8bc5795d6a984a3eace4e2811e52dd4f","8bc5795d6a984a3eace4e2811e52dd4f",22856155,3,0,1,513,135,135,0
"8bc5795d6a984a3eace4e2811e52dd4f","b416d47c56a742199b5d7c7f19d6503a",22856155,1,-1,0,516,135,134,-1
"b416d47c56a742199b5d7c7f19d6503a","cd4532ad48034873ba8bce2aac0c9808",22856155,1,4,0,517,134,137,3
"cd4532ad48034873ba8bce2aac0c9808","cd4532ad48034873ba8bce2aac0c9808",22856155,1,0,1,518,137,137,0
"cd4532ad48034873ba8bce2aac0c9808","df1de691dafe4549a18a4398ee9dfaf9",22856155,1,4,0,519,137,139,2
"df1de691dafe4549a18a4398ee9dfaf9","779f9ddd1fd14d1e9e69f72219a1fdbd",22856155,1,-23,0,520,139,121,-18
"779f9ddd1fd14d1e9e69f72219a1fdbd","6c5ad271a44743479bfaea29b1db8d02",22856155,1,27,0,521,121,143,22
"6c5ad271a44743479bfaea29b1db8d02","6c5ad271a44743479bfaea29b1db8d02",22856155,3,0,1,522,143,143,0
"6c5ad271a44743479bfaea29b1db8d02","83d311bed5374fee83d8d67a7d9d82dc",22856155,1,1,0,525,143,144,1
"83d311bed5374fee83d8d67a7d9d82dc","83d311bed5374fee83d8d67a7d9d82dc",22856155,5,0,1,526,144,144,0
"83d311bed5374fee83d8d67a7d9d82dc","402bba41861d43acb52a5abb89e8831e",22856155,1,1,0,531,144,145,1
"402bba41861d43acb52a5abb89e8831e","402bba41861d43acb52a5abb89e8831e",22856155,2,0,1,532,145,145,0
"402bba41861d43acb52a5abb89e8831e","df1de691dafe4549a18a4398ee9dfaf9",22856155,1,-6,0,534,145,139,-6
"df1de691dafe4549a18a4398ee9dfaf9","8aae34f5ddbb4052a709b12e6b0d40fa",22856155,1,9,0,535,139,147,8
"8aae34f5ddbb4052a709b12e6b0d40fa","8aae34f5ddbb4052a709b12e6b0d40fa",22856155,2,0,1,536,147,147,0
"8aae34f5ddbb4052a709b12e6b0d40fa","645b3f0249f64f76af2e19eb4d0e55b7",22856155,1,2,0,538,147,149,2
"645b3f0249f64f76af2e19eb4d0e55b7","645b3f0249f64f76af2e19eb4d0e55b7",22856155,2,0,1,539,149,149,0
"645b3f0249f64f76af2e19eb4d0e55b7","7e7b8db5064d4369805ab370aac5ddfb",22856155,1,1,0,541,149,150,1
"7e7b8db5064d4369805ab370aac5ddfb","7e7b8db5064d4369805ab370aac5ddfb",22856155,2,0,1,542,150,150,0
"7e7b8db5064d4369805ab370aac5ddfb","8956d210ae7f41968fada86d4c979d6a",22856155,1,1,0,544,150,151,1
"8956d210ae7f41968fada86d4c979d6a","8956d210ae7f41968fada86d4c979d6a",22856155,2,0,1,545,151,151,0
"8956d210ae7f41968fada86d4c979d6a","f902b0f41b544d4dbf79664fd233648d",22856155,1,-5,0,547,151,146,-5
"f902b0f41b544d4dbf79664fd233648d","ae781e8b775e4ccd93bc800dad5c8376",22856155,1,8,0,548,146,153,7
"ae781e8b775e4ccd93bc800dad5c8376","ae781e8b775e4ccd93bc800dad5c8376",22856155,2,0,1,549,153,153,0
"ae781e8b775e4ccd93bc800dad5c8376","06882a8492d9499aa31555567f575ecb",22856155,1,1,0,551,153,154,1
"06882a8492d9499aa31555567f575ecb","06882a8492d9499aa31555567f575ecb",22856155,1,0,1,552,154,154,0
"06882a8492d9499aa31555567f575ecb","f293c508f409466a8f27ddd7d1e40b20",22856155,1,1,0,553,154,155,1
"f293c508f409466a8f27ddd7d1e40b20","f293c508f409466a8f27ddd7d1e40b20",22856155,9,0,1,554,155,155,0
"f293c508f409466a8f27ddd7d1e40b20","cc4ddef5bbbe48ebb605141b347c4ed1",22856155,1,1,0,563,155,156,1
"cc4ddef5bbbe48ebb605141b347c4ed1","cc4ddef5bbbe48ebb605141b347c4ed1",22856155,3,0,1,564,156,156,0
"cc4ddef5bbbe48ebb605141b347c4ed1","d313cec988a84645bee413e8d4724a4b",22856155,1,3,0,567,156,158,2
"d313cec988a84645bee413e8d4724a4b","f03480cf4eba413194d7af52fc0e7f28",22856155,1,-7,0,568,158,152,-6
"f03480cf4eba413194d7af52fc0e7f28","d313cec988a84645bee413e8d4724a4b",22856155,1,7,0,569,152,158,6
"d313cec988a84645bee413e8d4724a4b","d313cec988a84645bee413e8d4724a4b",22856155,3,0,1,570,158,158,0
"d313cec988a84645bee413e8d4724a4b","dc60696c76a74368a60f72246e47700d",22856155,1,1,0,573,158,159,1
"dc60696c76a74368a60f72246e47700d","dc60696c76a74368a60f72246e47700d",22856155,2,0,1,574,159,159,0
"dc60696c76a74368a60f72246e47700d","df1de691dafe4549a18a4398ee9dfaf9",22856155,1,-23,0,576,159,139,-20
"df1de691dafe4549a18a4398ee9dfaf9","78adeee1fa2c4fe0bc73f7bca9fcee86",22856155,1,26,0,577,139,160,21
"65202579580f4ad38d734b4ee39d22a8","78adeee1fa2c4fe0bc73f7bca9fcee86",22856155,3,-5,0,583,164,160,-4
"65202579580f4ad38d734b4ee39d22a8","8959e6304a0348309a771e4d08d1b64a",22856155,1,-1,0,596,164,163,-1
"8959e6304a0348309a771e4d08d1b64a","65202579580f4ad38d734b4ee39d22a8",22856155,1,1,0,597,163,164,1
"65202579580f4ad38d734b4ee39d22a8","3cbcea2be0984e7dbd5a48195af10ce7",22856155,1,3,0,663,164,165,1
"3cbcea2be0984e7dbd5a48195af10ce7","78adeee1fa2c4fe0bc73f7bca9fcee86",22856155,1,-8,0,664,165,160,-5
"78adeee1fa2c4fe0bc73f7bca9fcee86","82e6285962b8400d9d6fc32436022a94",22856155,1,10,0,665,160,167,7
"82e6285962b8400d9d6fc32436022a94","a9ac840f098c4bd0a2ee896214ce29cd",22856155,1,3,0,666,167,168,1
"a9ac840f098c4bd0a2ee896214ce29cd","3cbcea2be0984e7dbd5a48195af10ce7",22856155,1,-5,0,667,168,165,-3
"3cbcea2be0984e7dbd5a48195af10ce7","a9ac840f098c4bd0a2ee896214ce29cd",22856155,1,5,0,668,165,168,3
"a9ac840f098c4bd0a2ee896214ce29cd","0c7262dff33c4087bc660ccf40f92f9c",22856155,1,4,0,669,168,169,1
"0c7262dff33c4087bc660ccf40f92f9c","b2275c3fad834f8d90737a2d9a6927d6",22856155,1,3,0,670,169,172,3
"b2275c3fad834f8d90737a2d9a6927d6","b2275c3fad834f8d90737a2d9a6927d6",22856155,62,0,1,671,172,172,0
"b2275c3fad834f8d90737a2d9a6927d6","eb515a26030b41f8a82a1e6114420bad",22856155,1,1,0,733,172,173,1
"eb515a26030b41f8a82a1e6114420bad","eb515a26030b41f8a82a1e6114420bad",22856155,5,0,1,734,173,173,0
"eb515a26030b41f8a82a1e6114420bad","b42cc17b7de840f181a704558d0bc845",22856155,1,3,0,739,173,175,2
"b42cc17b7de840f181a704558d0bc845","0c7262dff33c4087bc660ccf40f92f9c",22856155,1,-7,0,740,175,169,-6
"0c7262dff33c4087bc660ccf40f92f9c","b42cc17b7de840f181a704558d0bc845",22856155,1,7,0,741,169,175,6
"b42cc17b7de840f181a704558d0bc845","b42cc17b7de840f181a704558d0bc845",22856155,1,0,1,742,175,175,0
"b42cc17b7de840f181a704558d0bc845","801f9e9135034f49bf5f8b4bdefedb41",22856155,1,2,0,743,175,177,2
"801f9e9135034f49bf5f8b4bdefedb41","801f9e9135034f49bf5f8b4bdefedb41",22856155,6,0,1,744,177,177,0
"801f9e9135034f49bf5f8b4bdefedb41","b87c552dd247427abe6ab5795b9c9d43",22856155,1,5,0,750,177,181,4
"b87c552dd247427abe6ab5795b9c9d43","ea38cc0e6e6e41edbabf210220808bf9",22856155,1,-2,0,751,181,179,-2
"ea38cc0e6e6e41edbabf210220808bf9","362fcb0699a14845ab29b2340093e528",22856155,1,-6,0,752,179,174,-5
"362fcb0699a14845ab29b2340093e528","ea38cc0e6e6e41edbabf210220808bf9",22856155,1,6,0,753,174,179,5
"ea38cc0e6e6e41edbabf210220808bf9","ea38cc0e6e6e41edbabf210220808bf9",22856155,2,0,1,754,179,179,0
"ea38cc0e6e6e41edbabf210220808bf9","b87c552dd247427abe6ab5795b9c9d43",22856155,1,2,0,756,179,181,2
"b87c552dd247427abe6ab5795b9c9d43","b87c552dd247427abe6ab5795b9c9d43",22856155,7,0,1,757,181,181,0
"b87c552dd247427abe6ab5795b9c9d43","139b097acfca451689d80c9c6eebdf7b",22856155,1,-3,0,764,181,178,-3
"139b097acfca451689d80c9c6eebdf7b","30f660a1feb34582a739722532524f79",22856155,1,6,0,765,178,183,5
"30f660a1feb34582a739722532524f79","30f660a1feb34582a739722532524f79",22856155,10,0,1,766,183,183,0
"30f660a1feb34582a739722532524f79","2024b4885bd14338a39b7b509acbbd02",22856155,1,-1,0,776,183,182,-1
"2024b4885bd14338a39b7b509acbbd02","c3f63fe50d8e487c86bf8ef76c9cadd3",22856155,1,4,0,777,182,185,3
"c3f63fe50d8e487c86bf8ef76c9cadd3","c3f63fe50d8e487c86bf8ef76c9cadd3",22856155,1,0,1,778,185,185,0
"c3f63fe50d8e487c86bf8ef76c9cadd3","c8e371568a0c4391b25796ae4e91952e",22856155,1,3,0,779,185,186,1
"c8e371568a0c4391b25796ae4e91952e","0c7262dff33c4087bc660ccf40f92f9c",22856155,1,-23,0,780,186,169,-17
"0c7262dff33c4087bc660ccf40f92f9c","7d932b23e1c84326ae5aa4d3c0d813d1",22856155,1,25,0,781,169,188,19
"7d932b23e1c84326ae5aa4d3c0d813d1","7d932b23e1c84326ae5aa4d3c0d813d1",22856155,4,0,1,782,188,188,0
"7d932b23e1c84326ae5aa4d3c0d813d1","ab11d94c6c8948ea90b88f19d2cd502b",22856155,1,3,0,786,188,190,2
"ab11d94c6c8948ea90b88f19d2cd502b","c8e371568a0c4391b25796ae4e91952e",22856155,1,-5,0,787,190,186,-4
"c8e371568a0c4391b25796ae4e91952e","ab11d94c6c8948ea90b88f19d2cd502b",22856155,1,5,0,788,186,190,4
"ab11d94c6c8948ea90b88f19d2cd502b","ab11d94c6c8948ea90b88f19d2cd502b",22856155,1,0,1,789,190,190,0
"ab11d94c6c8948ea90b88f19d2cd502b","f992451ed6ad4e68bb9e68ad6be7c4be",22856155,1,2,0,790,190,192,2
"f992451ed6ad4e68bb9e68ad6be7c4be","f992451ed6ad4e68bb9e68ad6be7c4be",22856155,1,0,1,791,192,192,0
"f992451ed6ad4e68bb9e68ad6be7c4be","6cd2dcaac46847d4a0bc53f296d90375",22856155,1,3,0,792,192,194,2
"6cd2dcaac46847d4a0bc53f296d90375","07b44a7a51e94c78b411c753fc39dab0",22856155,1,-6,0,793,194,189,-5
"07b44a7a51e94c78b411c753fc39dab0","6cd2dcaac46847d4a0bc53f296d90375",22856155,1,6,0,794,189,194,5
"6cd2dcaac46847d4a0bc53f296d90375","6cd2dcaac46847d4a0bc53f296d90375",22856155,1,0,1,795,194,194,0
"6cd2dcaac46847d4a0bc53f296d90375","2d2580c9411c4972909db508d6956a58",22856155,1,2,0,796,194,196,2
"2d2580c9411c4972909db508d6956a58","2d2580c9411c4972909db508d6956a58",22856155,2,0,1,797,196,196,0
"2d2580c9411c4972909db508d6956a58","5bddb3d9ed264f3984702f048c7e5340",22856155,1,1,0,799,196,197,1
"5bddb3d9ed264f3984702f048c7e5340","5bddb3d9ed264f3984702f048c7e5340",22856155,2,0,1,800,197,197,0
"5bddb3d9ed264f3984702f048c7e5340","d5e8e2bd12a2466b9d6d90855f0eb079",22856155,1,1,0,802,197,198,1
"d5e8e2bd12a2466b9d6d90855f0eb079","d5e8e2bd12a2466b9d6d90855f0eb079",22856155,2,0,1,803,198,198,0
"d5e8e2bd12a2466b9d6d90855f0eb079","017d7ca8e0394b91aaadc9574df2202c",22856155,1,-5,0,805,198,193,-5
"017d7ca8e0394b91aaadc9574df2202c","54e8e9f0ea3e45c4bf3b8ac799ee31b1",22856155,1,8,0,806,193,200,7
"54e8e9f0ea3e45c4bf3b8ac799ee31b1","54e8e9f0ea3e45c4bf3b8ac799ee31b1",22856155,1,0,1,807,200,200,0
"54e8e9f0ea3e45c4bf3b8ac799ee31b1","c614a00911be4877a075f19315530fb0",22856155,1,1,0,808,200,201,1
"c614a00911be4877a075f19315530fb0","c614a00911be4877a075f19315530fb0",22856155,6,0,1,809,201,201,0
"c614a00911be4877a075f19315530fb0","a6c21bd8b95249c7972820a7a7d76aff",22856155,1,1,0,815,201,202,1
"a6c21bd8b95249c7972820a7a7d76aff","a6c21bd8b95249c7972820a7a7d76aff",22856155,1,0,1,816,202,202,0
"a6c21bd8b95249c7972820a7a7d76aff","bb329d880ab54120adaf203a693bb203",22856155,1,1,0,817,202,203,1
"bb329d880ab54120adaf203a693bb203","bb329d880ab54120adaf203a693bb203",22856155,1,0,1,818,203,203,0
"bb329d880ab54120adaf203a693bb203","f9170dd6bc6442b4acd832747609b09a",22856155,1,-4,0,819,203,199,-4
"f9170dd6bc6442b4acd832747609b09a","334c2344009840079b1d0e1b7ce3d5a7",22856155,1,7,0,820,199,205,6
"334c2344009840079b1d0e1b7ce3d5a7","334c2344009840079b1d0e1b7ce3d5a7",22856155,1,0,1,821,205,205,0
"334c2344009840079b1d0e1b7ce3d5a7","d7f13c8d63ec4e2aa673fbb9cf9c6933",22856155,1,3,0,822,205,206,1
"d7f13c8d63ec4e2aa673fbb9cf9c6933","c8e371568a0c4391b25796ae4e91952e",22856155,5,-26,0,823,206,186,-20
"c8e371568a0c4391b25796ae4e91952e","b9e80f77c3a44349863b19875725c384",22856155,1,27,0,824,186,207,21
"7108f0e4c2584f1f9c471689ae4c885c","a875096404ef4a9984b62d74cda916f9",22856155,1,2,0,826,208,209,1
"a875096404ef4a9984b62d74cda916f9","be502a7a43c44bf7b682698de79d9369",22856155,2,6,0,827,209,214,5
"be502a7a43c44bf7b682698de79d9369","09400e101c5d4b439cf9a26b03aae558",22856155,1,-5,0,828,214,210,-4
"d7f13c8d63ec4e2aa673fbb9cf9c6933","f7fb1952f56b4189b86a9f8b7862d2b8",22856155,1,11,0,830,206,215,9
"f7fb1952f56b4189b86a9f8b7862d2b8","ec341f459285443b8361f7f15638ff08",22856155,2,-2,0,831,215,213,-2
"ec341f459285443b8361f7f15638ff08","363837c182e04711840d896ae1e0339c",22856155,2,6,0,832,213,218,5
"01b2051f8941460d89945e3b02d1ce78","f7fb1952f56b4189b86a9f8b7862d2b8",22856155,1,-3,0,834,217,215,-2
"be502a7a43c44bf7b682698de79d9369","ec341f459285443b8361f7f15638ff08",22856155,1,-1,0,836,214,213,-1
"ec341f459285443b8361f7f15638ff08","09400e101c5d4b439cf9a26b03aae558",22856155,1,-4,0,837,213,210,-3
"09400e101c5d4b439cf9a26b03aae558","a875096404ef4a9984b62d74cda916f9",22856155,1,-1,0,838,210,209,-1
"a875096404ef4a9984b62d74cda916f9","d7f13c8d63ec4e2aa673fbb9cf9c6933",22856155,1,-4,0,839,209,206,-3
"c8e371568a0c4391b25796ae4e91952e","7108f0e4c2584f1f9c471689ae4c885c",22856155,1,28,0,841,186,208,22
"b9e80f77c3a44349863b19875725c384","d7f13c8d63ec4e2aa673fbb9cf9c6933",22856155,2,-1,0,843,207,206,-1
"c8e371568a0c4391b25796ae4e91952e","d7f13c8d63ec4e2aa673fbb9cf9c6933",22856155,3,26,0,845,186,206,20
"c8e371568a0c4391b25796ae4e91952e","c8e371568a0c4391b25796ae4e91952e",22856155,2,0,1,847,186,186,0
"d7f13c8d63ec4e2aa673fbb9cf9c6933","a875096404ef4a9984b62d74cda916f9",22856155,1,4,0,853,206,209,3
"363837c182e04711840d896ae1e0339c","1c6721b1f63f4d30ba7746ea8af02a52",22856155,1,6,0,858,218,221,3
"1c6721b1f63f4d30ba7746ea8af02a52","01b2051f8941460d89945e3b02d1ce78",22856155,1,-7,0,859,221,217,-4
"01b2051f8941460d89945e3b02d1ce78","d7f13c8d63ec4e2aa673fbb9cf9c6933",22856155,1,-14,0,860,217,206,-11
"d7f13c8d63ec4e2aa673fbb9cf9c6933","1c6721b1f63f4d30ba7746ea8af02a52",22856155,1,21,0,862,206,221,15
"1c6721b1f63f4d30ba7746ea8af02a52","1c6721b1f63f4d30ba7746ea8af02a52",22856155,1,0,1,863,221,221,0
"d03cb855c70044cf8c35d9ec0de696e3","2ab1535aac1346ba8801535bf729ef37",22856155,1,6,0,866,224,229,5
"2ab1535aac1346ba8801535bf729ef37","8b9ae98743bd4d4a8a87dff1c1244211",22856155,1,-3,0,867,229,227,-2
"8b9ae98743bd4d4a8a87dff1c1244211","f7906d6f59b9489a91d2ef40db5a474d",22856155,1,-4,0,868,227,223,-4
"f7906d6f59b9489a91d2ef40db5a474d","5152833676bf4c6cb317060be10f68db",22856155,2,6,0,869,223,228,5
"5152833676bf4c6cb317060be10f68db","1c6721b1f63f4d30ba7746ea8af02a52",22856155,1,-9,0,870,228,221,-7
"0b04c8e2f86d48c7aeb7e225819cd32b","2ae94c0cea4d480a9d5dca8fb1d7b542",22856155,1,11,0,872,234,242,8
"2ae94c0cea4d480a9d5dca8fb1d7b542","2ae94c0cea4d480a9d5dca8fb1d7b542",22856155,5,0,1,873,242,242,0
"2ae94c0cea4d480a9d5dca8fb1d7b542","1c6721b1f63f4d30ba7746ea8af02a52",22856155,1,-27,0,874,242,221,-21
"1c6721b1f63f4d30ba7746ea8af02a52","1ebf23f9d994469a85206e4c7b1bf5f5",22856155,1,30,0,875,221,245,24
"1ebf23f9d994469a85206e4c7b1bf5f5","fa235f0f364d47e4ae1c87f47bf8e6ba",22856155,1,9,0,876,245,252,7
"2ae94c0cea4d480a9d5dca8fb1d7b542","6e83e23f56544a19b94067c1c558d9c0",22856155,1,6,0,878,242,247,5
"00f61990949545828dd12f1303d47504","d546341988904f069cfa86b21457d9d9",22856155,2,-6,0,880,256,251,-5
"d546341988904f069cfa86b21457d9d9","d989ebcfc12a4b669f0100dc1aa14f1e",22856155,1,5,0,881,251,255,4
"d989ebcfc12a4b669f0100dc1aa14f1e","7aa76d3e993840d8805f097cbdbcd44b",22856155,1,7,0,882,255,261,6
"7aa76d3e993840d8805f097cbdbcd44b","2ae94c0cea4d480a9d5dca8fb1d7b542",22856155,1,-23,0,883,261,242,-19
"2ae94c0cea4d480a9d5dca8fb1d7b542","7028800abe7d4e27b613d1d6cbe26bf7",22856155,1,30,0,915,242,267,25
"7028800abe7d4e27b613d1d6cbe26bf7","7aa76d3e993840d8805f097cbdbcd44b",22856155,1,-7,0,916,267,261,-6
"7aa76d3e993840d8805f097cbdbcd44b","d989ebcfc12a4b669f0100dc1aa14f1e",22856155,1,-7,0,917,261,255,-6
"d989ebcfc12a4b669f0100dc1aa14f1e","00f61990949545828dd12f1303d47504",22856155,1,1,0,918,255,256,1
"d546341988904f069cfa86b21457d9d9","fa235f0f364d47e4ae1c87f47bf8e6ba",22856155,1,1,0,920,251,252,1
"fa235f0f364d47e4ae1c87f47bf8e6ba","6e83e23f56544a19b94067c1c558d9c0",22856155,1,-6,0,921,252,247,-5
"6e83e23f56544a19b94067c1c558d9c0","1ebf23f9d994469a85206e4c7b1bf5f5",22856155,1,-3,0,922,247,245,-2
"1ebf23f9d994469a85206e4c7b1bf5f5","1c6721b1f63f4d30ba7746ea8af02a52",22856155,1,-30,0,923,245,221,-24
"2ae94c0cea4d480a9d5dca8fb1d7b542","64dbedb3ce544f6aae8e10e0cf10f16d",22856155,1,-4,0,925,242,240,-2
"64dbedb3ce544f6aae8e10e0cf10f16d","0b04c8e2f86d48c7aeb7e225819cd32b",22856155,1,-7,0,926,240,234,-6
"0b04c8e2f86d48c7aeb7e225819cd32b","2ab1535aac1346ba8801535bf729ef37",22856155,1,-6,0,927,234,229,-5
"5152833676bf4c6cb317060be10f68db","d03cb855c70044cf8c35d9ec0de696e3",22856155,1,-5,0,930,228,224,-4
"8b9ae98743bd4d4a8a87dff1c1244211","77ecef8eff6b4a2caea7707669bf7475",22856155,1,-6,0,932,227,222,-5
"d7f13c8d63ec4e2aa673fbb9cf9c6933","363837c182e04711840d896ae1e0339c",22856155,1,15,0,935,206,218,12
"be95c065e45447c1bd8215ea6f130c7a","f7fb1952f56b4189b86a9f8b7862d2b8",22856155,1,-6,0,937,219,215,-4
"be502a7a43c44bf7b682698de79d9369","01b2051f8941460d89945e3b02d1ce78",22856155,1,4,0,939,214,217,3
"ec341f459285443b8361f7f15638ff08","a875096404ef4a9984b62d74cda916f9",22856155,1,-5,0,941,213,209,-4
"a875096404ef4a9984b62d74cda916f9","09400e101c5d4b439cf9a26b03aae558",22856155,1,1,0,942,209,210,1
"09400e101c5d4b439cf9a26b03aae558","7108f0e4c2584f1f9c471689ae4c885c",22856155,1,-3,0,943,210,208,-2
"b9e80f77c3a44349863b19875725c384","b9e80f77c3a44349863b19875725c384",22856155,39,0,1,951,207,207,0
"7108f0e4c2584f1f9c471689ae4c885c","7108f0e4c2584f1f9c471689ae4c885c",22856155,11,0,1,1000,208,208,0
"7108f0e4c2584f1f9c471689ae4c885c","09400e101c5d4b439cf9a26b03aae558",22856155,2,3,0,1002,208,210,2
"09400e101c5d4b439cf9a26b03aae558","d7f13c8d63ec4e2aa673fbb9cf9c6933",22856155,5,-5,0,1003,210,206,-4
"d7f13c8d63ec4e2aa673fbb9cf9c6933","d7f13c8d63ec4e2aa673fbb9cf9c6933",22856155,2,0,1,1004,206,206,0
"d7f13c8d63ec4e2aa673fbb9cf9c6933","b9e80f77c3a44349863b19875725c384",22856155,2,1,0,1005,206,207,1
"b9e80f77c3a44349863b19875725c384","7108f0e4c2584f1f9c471689ae4c885c",22856155,4,1,0,1006,207,208,1
"7108f0e4c2584f1f9c471689ae4c885c","d7f13c8d63ec4e2aa673fbb9cf9c6933",22856155,1,-2,0,1007,208,206,-2
"d7f13c8d63ec4e2aa673fbb9cf9c6933","7108f0e4c2584f1f9c471689ae4c885c",22856155,2,2,0,1008,206,208,2
"7108f0e4c2584f1f9c471689ae4c885c","b9e80f77c3a44349863b19875725c384",22856155,4,-1,0,1009,208,207,-1
"b9e80f77c3a44349863b19875725c384","09400e101c5d4b439cf9a26b03aae558",22856155,1,4,0,1010,207,210,3
"d7f13c8d63ec4e2aa673fbb9cf9c6933","09400e101c5d4b439cf9a26b03aae558",22856155,2,5,0,1012,206,210,4
"09400e101c5d4b439cf9a26b03aae558","09400e101c5d4b439cf9a26b03aae558",22856155,4,0,1,1013,210,210,0
"09400e101c5d4b439cf9a26b03aae558","a88efa7e50ce47159810ab553afa6d3a",22856155,1,2,0,1019,210,212,2
"a88efa7e50ce47159810ab553afa6d3a","a88efa7e50ce47159810ab553afa6d3a",22856155,11,0,1,1020,212,212,0
"a88efa7e50ce47159810ab553afa6d3a","be502a7a43c44bf7b682698de79d9369",22856155,1,3,0,1031,212,214,2
"be502a7a43c44bf7b682698de79d9369","a875096404ef4a9984b62d74cda916f9",22856155,1,-6,0,1032,214,209,-5
"a875096404ef4a9984b62d74cda916f9","f7fb1952f56b4189b86a9f8b7862d2b8",22856155,1,7,0,1033,209,215,6
"f7fb1952f56b4189b86a9f8b7862d2b8","be502a7a43c44bf7b682698de79d9369",22856155,3,-1,0,1034,215,214,-1
"be502a7a43c44bf7b682698de79d9369","be502a7a43c44bf7b682698de79d9369",22856155,1,0,1,1035,214,214,0
"be502a7a43c44bf7b682698de79d9369","f7fb1952f56b4189b86a9f8b7862d2b8",22856155,3,1,0,1036,214,215,1
"f7fb1952f56b4189b86a9f8b7862d2b8","f7fb1952f56b4189b86a9f8b7862d2b8",22856155,17,0,1,1037,215,215,0
"f7fb1952f56b4189b86a9f8b7862d2b8","b860ee85d8bc4a2f97958cfb71be3533",22856155,1,1,0,1054,215,216,1
"b860ee85d8bc4a2f97958cfb71be3533","b860ee85d8bc4a2f97958cfb71be3533",22856155,2,0,1,1055,216,216,0
"b860ee85d8bc4a2f97958cfb71be3533","be502a7a43c44bf7b682698de79d9369",22856155,1,-2,0,1057,216,214,-2
"f7fb1952f56b4189b86a9f8b7862d2b8","01b2051f8941460d89945e3b02d1ce78",22856155,1,3,0,1059,215,217,2
"01b2051f8941460d89945e3b02d1ce78","ec341f459285443b8361f7f15638ff08",22856155,2,-5,0,1060,217,213,-4
"ec341f459285443b8361f7f15638ff08","01b2051f8941460d89945e3b02d1ce78",22856155,1,5,0,1061,213,217,4
"01b2051f8941460d89945e3b02d1ce78","363837c182e04711840d896ae1e0339c",22856155,1,1,0,1062,217,218,1
"363837c182e04711840d896ae1e0339c","be95c065e45447c1bd8215ea6f130c7a",22856155,2,2,0,1063,218,219,1
"be95c065e45447c1bd8215ea6f130c7a","363837c182e04711840d896ae1e0339c",22856155,1,-2,0,1064,219,218,-1
"363837c182e04711840d896ae1e0339c","363837c182e04711840d896ae1e0339c",22856155,11,0,1,1065,218,218,0
"363837c182e04711840d896ae1e0339c","01b2051f8941460d89945e3b02d1ce78",22856155,2,-1,0,1076,218,217,-1
"01b2051f8941460d89945e3b02d1ce78","91125ca626c5470eb145501f8c37f8db",22856155,1,4,0,1077,217,220,3
"91125ca626c5470eb145501f8c37f8db","91125ca626c5470eb145501f8c37f8db",22856155,1,0,1,1078,220,220,0
"91125ca626c5470eb145501f8c37f8db","1c6721b1f63f4d30ba7746ea8af02a52",22856155,1,3,0,1079,220,221,1
"1c6721b1f63f4d30ba7746ea8af02a52","d7f13c8d63ec4e2aa673fbb9cf9c6933",22856155,2,-21,0,1080,221,206,-15
"d7f13c8d63ec4e2aa673fbb9cf9c6933","77ecef8eff6b4a2caea7707669bf7475",22856155,1,22,0,1081,206,222,16
"77ecef8eff6b4a2caea7707669bf7475","77ecef8eff6b4a2caea7707669bf7475",22856155,12,0,1,1082,222,222,0
"77ecef8eff6b4a2caea7707669bf7475","1c6721b1f63f4d30ba7746ea8af02a52",22856155,2,-1,0,1094,222,221,-1
"1c6721b1f63f4d30ba7746ea8af02a52","d03cb855c70044cf8c35d9ec0de696e3",22856155,2,4,0,1095,221,224,3
"d03cb855c70044cf8c35d9ec0de696e3","8b9ae98743bd4d4a8a87dff1c1244211",22856155,3,3,0,1096,224,227,3
"8b9ae98743bd4d4a8a87dff1c1244211","1c6721b1f63f4d30ba7746ea8af02a52",22856155,2,-7,0,1097,227,221,-6
"1c6721b1f63f4d30ba7746ea8af02a52","77ecef8eff6b4a2caea7707669bf7475",22856155,2,1,0,1098,221,222,1
"77ecef8eff6b4a2caea7707669bf7475","d03cb855c70044cf8c35d9ec0de696e3",22856155,2,3,0,1099,222,224,2
"d03cb855c70044cf8c35d9ec0de696e3","d03cb855c70044cf8c35d9ec0de696e3",22856155,3,0,1,1103,224,224,0
"d03cb855c70044cf8c35d9ec0de696e3","a49a937d6896486d9a5396654abcf2e1",22856155,1,2,0,1106,224,226,2
"a49a937d6896486d9a5396654abcf2e1","a49a937d6896486d9a5396654abcf2e1",22856155,1,0,1,1107,226,226,0
"a49a937d6896486d9a5396654abcf2e1","8b9ae98743bd4d4a8a87dff1c1244211",22856155,1,1,0,1108,226,227,1
"8b9ae98743bd4d4a8a87dff1c1244211","8b9ae98743bd4d4a8a87dff1c1244211",22856155,13,0,1,1109,227,227,0
"8b9ae98743bd4d4a8a87dff1c1244211","2ab1535aac1346ba8801535bf729ef37",22856155,1,3,0,1122,227,229,2
"2ab1535aac1346ba8801535bf729ef37","f7906d6f59b9489a91d2ef40db5a474d",22856155,2,-7,0,1123,229,223,-6
"f7906d6f59b9489a91d2ef40db5a474d","2ab1535aac1346ba8801535bf729ef37",22856155,1,7,0,1124,223,229,6
"2ab1535aac1346ba8801535bf729ef37","2ab1535aac1346ba8801535bf729ef37",22856155,1,0,1,1125,229,229,0
"2ab1535aac1346ba8801535bf729ef37","a4f40fb48a8542c8949bae1f002cd9bc",22856155,1,2,0,1126,229,231,2
"a4f40fb48a8542c8949bae1f002cd9bc","a4f40fb48a8542c8949bae1f002cd9bc",22856155,2,0,1,1127,231,231,0
"a4f40fb48a8542c8949bae1f002cd9bc","8972c23e32044edb8a78fa1eed4e5947",22856155,1,1,0,1129,231,232,1
"8972c23e32044edb8a78fa1eed4e5947","8972c23e32044edb8a78fa1eed4e5947",22856155,3,0,1,1130,232,232,0
"8972c23e32044edb8a78fa1eed4e5947","92feb4a40f8344d38b6f722e42a53295",22856155,1,1,0,1133,232,233,1
"92feb4a40f8344d38b6f722e42a53295","92feb4a40f8344d38b6f722e42a53295",22856155,5,0,1,1134,233,233,0
"92feb4a40f8344d38b6f722e42a53295","5152833676bf4c6cb317060be10f68db",22856155,1,-5,0,1139,233,228,-5
"5152833676bf4c6cb317060be10f68db","ca3e28f290354c08aefe5b0f769604e6",22856155,1,8,0,1140,228,235,7
"ca3e28f290354c08aefe5b0f769604e6","ca3e28f290354c08aefe5b0f769604e6",22856155,4,0,1,1141,235,235,0
"ca3e28f290354c08aefe5b0f769604e6","79a35eea833e4c2c9d22fc53c3c6445c",22856155,1,1,0,1145,235,236,1
"79a35eea833e4c2c9d22fc53c3c6445c","79a35eea833e4c2c9d22fc53c3c6445c",22856155,9,0,1,1146,236,236,0
"79a35eea833e4c2c9d22fc53c3c6445c","8f68228b1518449e9615cdafee41a2bd",22856155,1,1,0,1155,236,237,1
"8f68228b1518449e9615cdafee41a2bd","8f68228b1518449e9615cdafee41a2bd",22856155,1,0,1,1156,237,237,0
"8f68228b1518449e9615cdafee41a2bd","cab89fa5c3ed45a5aa550fc0352d6a42",22856155,1,1,0,1157,237,238,1
"cab89fa5c3ed45a5aa550fc0352d6a42","cab89fa5c3ed45a5aa550fc0352d6a42",22856155,1,0,1,1158,238,238,0
"cab89fa5c3ed45a5aa550fc0352d6a42","66d4fad4f1cf4b46be0750a99ad7a35a",22856155,1,1,0,1159,238,239,1
"66d4fad4f1cf4b46be0750a99ad7a35a","66d4fad4f1cf4b46be0750a99ad7a35a",22856155,1,0,1,1160,239,239,0
"66d4fad4f1cf4b46be0750a99ad7a35a","0b04c8e2f86d48c7aeb7e225819cd32b",22856155,1,-5,0,1161,239,234,-5
"0b04c8e2f86d48c7aeb7e225819cd32b","1c6721b1f63f4d30ba7746ea8af02a52",22856155,1,-16,0,1162,234,221,-13
"1c6721b1f63f4d30ba7746ea8af02a52","0b04c8e2f86d48c7aeb7e225819cd32b",22856155,2,16,0,1163,221,234,13
"0b04c8e2f86d48c7aeb7e225819cd32b","f53da5fd9bfe412da4b80d4742563b6c",22856155,1,8,0,1164,234,241,7
"f53da5fd9bfe412da4b80d4742563b6c","f53da5fd9bfe412da4b80d4742563b6c",22856155,1,0,1,1165,241,241,0
"f53da5fd9bfe412da4b80d4742563b6c","1c6721b1f63f4d30ba7746ea8af02a52",22856155,1,-24,0,1166,241,221,-20
"1c6721b1f63f4d30ba7746ea8af02a52","2ae94c0cea4d480a9d5dca8fb1d7b542",22856155,2,27,0,1167,221,242,21
"2ae94c0cea4d480a9d5dca8fb1d7b542","1ebf23f9d994469a85206e4c7b1bf5f5",22856155,1,3,0,1168,242,245,3
"1ebf23f9d994469a85206e4c7b1bf5f5","1ebf23f9d994469a85206e4c7b1bf5f5",22856155,15,0,1,1169,245,245,0
"1ebf23f9d994469a85206e4c7b1bf5f5","85ae675b83e8422da842cfd25596af99",22856155,1,1,0,1184,245,246,1
"85ae675b83e8422da842cfd25596af99","85ae675b83e8422da842cfd25596af99",22856155,1,0,1,1185,246,246,0
"85ae675b83e8422da842cfd25596af99","fa235f0f364d47e4ae1c87f47bf8e6ba",22856155,1,8,0,1186,246,252,6
"fa235f0f364d47e4ae1c87f47bf8e6ba","2ae94c0cea4d480a9d5dca8fb1d7b542",22856155,2,-12,0,1187,252,242,-10
"2ae94c0cea4d480a9d5dca8fb1d7b542","fa235f0f364d47e4ae1c87f47bf8e6ba",22856155,1,12,0,1188,242,252,10
"fa235f0f364d47e4ae1c87f47bf8e6ba","fa235f0f364d47e4ae1c87f47bf8e6ba",22856155,8,0,1,1189,252,252,0
"fa235f0f364d47e4ae1c87f47bf8e6ba","79f7845465cc4ed19d8e4f1429541be0",22856155,1,2,0,1197,252,254,2
"79f7845465cc4ed19d8e4f1429541be0","79f7845465cc4ed19d8e4f1429541be0",22856155,2,0,1,1198,254,254,0
"79f7845465cc4ed19d8e4f1429541be0","00f61990949545828dd12f1303d47504",22856155,1,3,0,1200,254,256,2
"00f61990949545828dd12f1303d47504","6e83e23f56544a19b94067c1c558d9c0",22856155,1,-11,0,1201,256,247,-9
"6e83e23f56544a19b94067c1c558d9c0","00f61990949545828dd12f1303d47504",22856155,2,11,0,1202,247,256,9
"00f61990949545828dd12f1303d47504","00f61990949545828dd12f1303d47504",22856155,1,0,1,1203,256,256,0
"00f61990949545828dd12f1303d47504","ead7bb4b64e247d2ae632ab8a296b091",22856155,1,2,0,1204,256,258,2
"ead7bb4b64e247d2ae632ab8a296b091","ead7bb4b64e247d2ae632ab8a296b091",22856155,2,0,1,1205,258,258,0
"ead7bb4b64e247d2ae632ab8a296b091","41b0048dde734bb280bac6116baa8e27",22856155,1,1,0,1207,258,259,1
"41b0048dde734bb280bac6116baa8e27","41b0048dde734bb280bac6116baa8e27",22856155,2,0,1,1208,259,259,0
"41b0048dde734bb280bac6116baa8e27","b41c5a094a604ee0915327da5cc0beb7",22856155,1,1,0,1210,259,260,1
"b41c5a094a604ee0915327da5cc0beb7","b41c5a094a604ee0915327da5cc0beb7",22856155,2,0,1,1211,260,260,0
"b41c5a094a604ee0915327da5cc0beb7","d546341988904f069cfa86b21457d9d9",22856155,1,-10,0,1213,260,251,-9
"d546341988904f069cfa86b21457d9d9","28c171777c52431ab6b925073bd63d46",22856155,1,15,0,1214,251,264,13
"28c171777c52431ab6b925073bd63d46","28c171777c52431ab6b925073bd63d46",22856155,11,0,1,1215,264,264,0
"28c171777c52431ab6b925073bd63d46","ac160db940cb49ae8579162b1d52bb5d",22856155,1,2,0,1226,264,266,2
"ac160db940cb49ae8579162b1d52bb5d","ac160db940cb49ae8579162b1d52bb5d",22856155,3,0,1,1227,266,266,0
"ac160db940cb49ae8579162b1d52bb5d","d989ebcfc12a4b669f0100dc1aa14f1e",22856155,1,-12,0,1230,266,255,-11
"d989ebcfc12a4b669f0100dc1aa14f1e","c6fd49b485cc4874b0bbdd9c6171e09c",22856155,1,15,0,1231,255,268,13
"c6fd49b485cc4874b0bbdd9c6171e09c","c6fd49b485cc4874b0bbdd9c6171e09c",22856155,7,0,1,1232,268,268,0
"c6fd49b485cc4874b0bbdd9c6171e09c","44240778a97c4af0937817499b75707b",22856155,1,1,0,1239,268,269,1
"44240778a97c4af0937817499b75707b","44240778a97c4af0937817499b75707b",22856155,5,0,1,1240,269,269,0
"44240778a97c4af0937817499b75707b","7aa76d3e993840d8805f097cbdbcd44b",22856155,1,-9,0,1245,269,261,-8
"7aa76d3e993840d8805f097cbdbcd44b","865a4d3b43374da7944dc7d397f566d9",22856155,1,12,0,1246,261,271,10
"865a4d3b43374da7944dc7d397f566d9","865a4d3b43374da7944dc7d397f566d9",22856155,2,0,1,1247,271,271,0
"865a4d3b43374da7944dc7d397f566d9","0d987bed3ffa4ed0b9a2e62e97b7b30f",22856155,1,3,0,1248,271,272,1
"0d987bed3ffa4ed0b9a2e62e97b7b30f","2ae94c0cea4d480a9d5dca8fb1d7b542",22856155,13,-38,0,1249,272,242,-30
"2ae94c0cea4d480a9d5dca8fb1d7b542","0d987bed3ffa4ed0b9a2e62e97b7b30f",22856155,13,38,0,1250,242,272,30
"2ae94c0cea4d480a9d5dca8fb1d7b542","865a4d3b43374da7944dc7d397f566d9",22856155,1,35,0,1252,242,271,29
"865a4d3b43374da7944dc7d397f566d9","2ae94c0cea4d480a9d5dca8fb1d7b542",22856155,1,-35,0,1254,271,242,-29
"0d987bed3ffa4ed0b9a2e62e97b7b30f","0d987bed3ffa4ed0b9a2e62e97b7b30f",22856155,6,0,1,1256,272,272,0
"0d987bed3ffa4ed0b9a2e62e97b7b30f","82ae07bc0c9b4570a41799290d1ef399",22856155,1,4,0,1257,272,275,3
"82ae07bc0c9b4570a41799290d1ef399","0d987bed3ffa4ed0b9a2e62e97b7b30f",22856155,1,-4,0,1258,275,272,-3
"0d987bed3ffa4ed0b9a2e62e97b7b30f","bb5a47f5ea01454a8b79455422d3b9da",22856155,14,10,0,1259,272,280,8
"bb5a47f5ea01454a8b79455422d3b9da","bb5a47f5ea01454a8b79455422d3b9da",22856155,156,0,1,1260,280,280,0
"bb5a47f5ea01454a8b79455422d3b9da","82ae07bc0c9b4570a41799290d1ef399",22856155,1,-6,0,1261,280,275,-5
"82ae07bc0c9b4570a41799290d1ef399","bb5a47f5ea01454a8b79455422d3b9da",22856155,1,6,0,1262,275,280,5
"bb5a47f5ea01454a8b79455422d3b9da","0d987bed3ffa4ed0b9a2e62e97b7b30f",22856155,9,-10,0,1268,280,272,-8
"bb5a47f5ea01454a8b79455422d3b9da","78adeee1fa2c4fe0bc73f7bca9fcee86",22856155,2,-162,0,1295,280,160,-120
"78adeee1fa2c4fe0bc73f7bca9fcee86","65202579580f4ad38d734b4ee39d22a8",22856155,6,5,0,1296,160,164,4
"65202579580f4ad38d734b4ee39d22a8","65202579580f4ad38d734b4ee39d22a8",22856155,92,0,1,1297,164,164,0
"65202579580f4ad38d734b4ee39d22a8","0d987bed3ffa4ed0b9a2e62e97b7b30f",22856155,2,147,0,1306,164,272,108
"0d987bed3ffa4ed0b9a2e62e97b7b30f","94cecc3f1e7d484b8e068e79241dfd73",22856155,4,13,0,1363,272,281,9
"94cecc3f1e7d484b8e068e79241dfd73","a37477c4e4c14169ad44b06b493007f6",22856155,7,2,0,1364,281,283,2
"a37477c4e4c14169ad44b06b493007f6","94cecc3f1e7d484b8e068e79241dfd73",22856155,8,-2,0,1365,283,281,-2
"94cecc3f1e7d484b8e068e79241dfd73","0d987bed3ffa4ed0b9a2e62e97b7b30f",22856155,7,-13,0,1366,281,272,-9
"bb5a47f5ea01454a8b79455422d3b9da","94cecc3f1e7d484b8e068e79241dfd73",22856155,4,3,0,1375,280,281,1
"0d987bed3ffa4ed0b9a2e62e97b7b30f","a37477c4e4c14169ad44b06b493007f6",22856155,4,15,0,1377,272,283,11
"a37477c4e4c14169ad44b06b493007f6","0d987bed3ffa4ed0b9a2e62e97b7b30f",22856155,3,-15,0,1408,283,272,-11
"94cecc3f1e7d484b8e068e79241dfd73","bb5a47f5ea01454a8b79455422d3b9da",22856155,1,-3,0,1410,281,280,-1
"94cecc3f1e7d484b8e068e79241dfd73","4a29443515bb404cb8924e1c60a63b73",22856155,1,9,0,1500,281,285,4
"4a29443515bb404cb8924e1c60a63b73","208c9b2796c944db8dacaa96082520ea",22856155,2,3,0,1501,285,288,3
"208c9b2796c944db8dacaa96082520ea","208c9b2796c944db8dacaa96082520ea",22856155,4,0,1,1502,288,288,0
"208c9b2796c944db8dacaa96082520ea","4a29443515bb404cb8924e1c60a63b73",22856155,2,-3,0,1505,288,285,-3
"4a29443515bb404cb8924e1c60a63b73","7669a956527947d0add87455277e80b4",22856155,1,7,0,1506,285,291,6
"7669a956527947d0add87455277e80b4","7669a956527947d0add87455277e80b4",22856155,1,0,1,1507,291,291,0
"7669a956527947d0add87455277e80b4","869e967078f04da18dd0b0b9389a7424",22856155,1,3,0,1508,291,293,2
"869e967078f04da18dd0b0b9389a7424","6a9a3b5bde4a48daa896fe8c06eca56f",22856155,2,-5,0,1509,293,289,-4
"6a9a3b5bde4a48daa896fe8c06eca56f","869e967078f04da18dd0b0b9389a7424",22856155,2,5,0,1510,289,293,4
"869e967078f04da18dd0b0b9389a7424","869e967078f04da18dd0b0b9389a7424",22856155,5,0,1,1511,293,293,0
"869e967078f04da18dd0b0b9389a7424","51ab6291537748fab90d519aa09889d6",22856155,1,2,0,1516,293,295,2
"51ab6291537748fab90d519aa09889d6","51ab6291537748fab90d519aa09889d6",22856155,5,0,1,1517,295,295,0
"51ab6291537748fab90d519aa09889d6","34a6e49023fc4465bd5ca604330bbd1c",22856155,1,-3,0,1522,295,292,-3
"34a6e49023fc4465bd5ca604330bbd1c","21592f2a9e9c4b2f8c66ec5dbcbf6a2b",22856155,2,5,0,1523,292,296,4
"21592f2a9e9c4b2f8c66ec5dbcbf6a2b","ba0e59461bfb4a44b7b1c28a01f8d3b3",22856155,2,4,0,1524,296,299,3
"ba0e59461bfb4a44b7b1c28a01f8d3b3","ba0e59461bfb4a44b7b1c28a01f8d3b3",22856155,4,0,1,1525,299,299,0
"ba0e59461bfb4a44b7b1c28a01f8d3b3","0e0b36e731a645e7b1b8a88f5031ca38",22856155,1,2,0,1529,299,301,2
"0e0b36e731a645e7b1b8a88f5031ca38","0e0b36e731a645e7b1b8a88f5031ca38",22856155,2,0,1,1530,301,301,0
"0e0b36e731a645e7b1b8a88f5031ca38","a66a144637284c21afc6de17fea4bfb8",22856155,1,1,0,1532,301,302,1
"a66a144637284c21afc6de17fea4bfb8","a66a144637284c21afc6de17fea4bfb8",22856155,2,0,1,1533,302,302,0
"a66a144637284c21afc6de17fea4bfb8","7646a919d7e64fa990bca9b024ff089d",22856155,1,-4,0,1535,302,298,-4
"7646a919d7e64fa990bca9b024ff089d","e390b575229748ea8aac9364efe2bf00",22856155,1,7,0,1536,298,304,6
"e390b575229748ea8aac9364efe2bf00","e390b575229748ea8aac9364efe2bf00",22856155,1,0,1,1537,304,304,0
"e390b575229748ea8aac9364efe2bf00","3434c10e561d488a914e0f7d71907abd",22856155,1,3,0,1538,304,305,1
"3434c10e561d488a914e0f7d71907abd","4a29443515bb404cb8924e1c60a63b73",22856155,1,-27,0,1539,305,285,-20
"4a29443515bb404cb8924e1c60a63b73","53e7e900392747ccad52e711ab0f80d8",22856155,1,29,0,1540,285,307,22
"53e7e900392747ccad52e711ab0f80d8","53e7e900392747ccad52e711ab0f80d8",22856155,6,0,1,1541,307,307,0
"53e7e900392747ccad52e711ab0f80d8","3434c10e561d488a914e0f7d71907abd",22856155,2,-2,0,1547,307,305,-2
"3434c10e561d488a914e0f7d71907abd","130acc2aeb0448fdbb2de63bc5cebe5b",22856155,2,5,0,1548,305,309,4
"130acc2aeb0448fdbb2de63bc5cebe5b","130acc2aeb0448fdbb2de63bc5cebe5b",22856155,4,0,1,1549,309,309,0
"130acc2aeb0448fdbb2de63bc5cebe5b","9c062b3251034ebe90f5054e2a3b5120",22856155,1,2,0,1553,309,311,2
"9c062b3251034ebe90f5054e2a3b5120","9c062b3251034ebe90f5054e2a3b5120",22856155,2,0,1,1554,311,311,0
"9c062b3251034ebe90f5054e2a3b5120","ea859f8207e44537889daeaba13ac2e8",22856155,1,1,0,1556,311,312,1
"ea859f8207e44537889daeaba13ac2e8","ea859f8207e44537889daeaba13ac2e8",22856155,4,0,1,1557,312,312,0
"ea859f8207e44537889daeaba13ac2e8","56d94971a7a94257aa330183a8ebd0ea",22856155,1,1,0,1561,312,313,1
"56d94971a7a94257aa330183a8ebd0ea","56d94971a7a94257aa330183a8ebd0ea",22856155,7,0,1,1562,313,313,0
"56d94971a7a94257aa330183a8ebd0ea","141c0df6cd1946539aadd1c9b7068cd4",22856155,1,-5,0,1569,313,308,-5
"141c0df6cd1946539aadd1c9b7068cd4","0c787d16c9504873b1a4d903cec09948",22856155,1,7,0,1570,308,314,6
"0c787d16c9504873b1a4d903cec09948","130acc2aeb0448fdbb2de63bc5cebe5b",22856155,1,-6,0,1571,314,309,-5
"130acc2aeb0448fdbb2de63bc5cebe5b","141c0df6cd1946539aadd1c9b7068cd4",22856155,2,-1,0,1572,309,308,-1
"141c0df6cd1946539aadd1c9b7068cd4","3434c10e561d488a914e0f7d71907abd",22856155,1,-4,0,1573,308,305,-3
"3434c10e561d488a914e0f7d71907abd","3434c10e561d488a914e0f7d71907abd",22856155,6,0,1,1574,305,305,0
"3434c10e561d488a914e0f7d71907abd","b7719e26494940efa49512aedd0aac79",22856155,2,-393,0,1580,305,20,-285
"b7719e26494940efa49512aedd0aac79","d4f45188d3c84a02ba08454e6403a818",22856155,6,5,0,1581,20,24,4
"d4f45188d3c84a02ba08454e6403a818","d4c3b003e8274e429d2fa688d73fde6d",22856155,6,-2,0,1582,24,22,-2
"d4c3b003e8274e429d2fa688d73fde6d","16593e49f7584ef286ebbfc96d4cbfcc",22856155,1,403,0,1583,22,316,294
"16593e49f7584ef286ebbfc96d4cbfcc","3434c10e561d488a914e0f7d71907abd",22856155,1,-13,0,1584,316,305,-11
"d4c3b003e8274e429d2fa688d73fde6d","b7719e26494940efa49512aedd0aac79",22856155,2,-3,0,1588,22,20,-2
"b7719e26494940efa49512aedd0aac79","b7719e26494940efa49512aedd0aac79",22856155,3,0,1,1589,20,20,0
"b7719e26494940efa49512aedd0aac79","afbf7250b99d47bea07172749483ca97",22856155,3,12,0,1590,20,28,8
"afbf7250b99d47bea07172749483ca97","c9c52446b6294aa5a9c2abaed536c37e",22856155,1,8,0,1591,28,32,4
"c9c52446b6294aa5a9c2abaed536c37e","4e51676dc72045d99c19b9fa7b22f8bc",22856155,2,-5,0,1592,32,29,-3
"4e51676dc72045d99c19b9fa7b22f8bc","4e51676dc72045d99c19b9fa7b22f8bc",22856155,6,0,1,1593,29,29,0
"4e51676dc72045d99c19b9fa7b22f8bc","c33c17be71ae4d588da7369472e5bb1b",22856155,8,9,0,1594,29,34,5
"c33c17be71ae4d588da7369472e5bb1b","93679be414554a11b1893002f2229a93",22856155,6,3,0,1595,34,35,1
"93679be414554a11b1893002f2229a93","c33c17be71ae4d588da7369472e5bb1b",22856155,3,-3,0,1596,35,34,-1
"93679be414554a11b1893002f2229a93","7040a13096d746ac84b8fac8d9752058",22856155,3,3,0,1598,35,36,1
"7040a13096d746ac84b8fac8d9752058","9a0dc646f934470daf08c4b56ccf73db",22856155,4,3,0,1599,36,37,1
"9a0dc646f934470daf08c4b56ccf73db","7040a13096d746ac84b8fac8d9752058",22856155,3,-3,0,1600,37,36,-1
"9a0dc646f934470daf08c4b56ccf73db","fc0e049d56024bc9a02c9a9c435c3df7",22856155,3,3,0,1602,37,38,1
"fc0e049d56024bc9a02c9a9c435c3df7","67a089198fcb4e1c8f2385786c2b296f",22856155,4,4,0,1603,38,39,1
"67a089198fcb4e1c8f2385786c2b296f","fc0e049d56024bc9a02c9a9c435c3df7",22856155,2,-4,0,1604,39,38,-1
"fc0e049d56024bc9a02c9a9c435c3df7","64d48c6c9c7940639a932219a6c87198",22856155,1,5,0,1605,38,40,2
"64d48c6c9c7940639a932219a6c87198","fab84b4fab5940efb4ea868ef8d09396",22856155,1,321,0,1606,40,284,244
"fab84b4fab5940efb4ea868ef8d09396","fab84b4fab5940efb4ea868ef8d09396",22856155,11,0,1,1607,284,284,0
"fab84b4fab5940efb4ea868ef8d09396","4a29443515bb404cb8924e1c60a63b73",22856155,1,4,0,1618,284,285,1
"4a29443515bb404cb8924e1c60a63b73","869e967078f04da18dd0b0b9389a7424",22856155,1,10,0,1622,285,293,8
"869e967078f04da18dd0b0b9389a7424","34a6e49023fc4465bd5ca604330bbd1c",22856155,1,-1,0,1625,293,292,-1
"ba0e59461bfb4a44b7b1c28a01f8d3b3","7646a919d7e64fa990bca9b024ff089d",22856155,1,-1,0,1628,299,298,-1
"7646a919d7e64fa990bca9b024ff089d","4a29443515bb404cb8924e1c60a63b73",22856155,1,-17,0,1629,298,285,-13
"4a29443515bb404cb8924e1c60a63b73","3434c10e561d488a914e0f7d71907abd",22856155,1,27,0,1630,285,305,20
"3434c10e561d488a914e0f7d71907abd","53e7e900392747ccad52e711ab0f80d8",22856155,1,2,0,1631,305,307,2
"141c0df6cd1946539aadd1c9b7068cd4","13255e63e0aa4abf85e5211bf613d43e",22856155,1,10,0,1635,308,317,9
"13255e63e0aa4abf85e5211bf613d43e","13255e63e0aa4abf85e5211bf613d43e",22856155,1,0,1,1636,317,317,0
"13255e63e0aa4abf85e5211bf613d43e","86c27d40179e419c8e9d150fb6afa5d0",22856155,1,3,0,1637,317,319,2
"86c27d40179e419c8e9d150fb6afa5d0","0c787d16c9504873b1a4d903cec09948",22856155,1,-6,0,1638,319,314,-5
"0c787d16c9504873b1a4d903cec09948","86c27d40179e419c8e9d150fb6afa5d0",22856155,1,6,0,1639,314,319,5
"86c27d40179e419c8e9d150fb6afa5d0","86c27d40179e419c8e9d150fb6afa5d0",22856155,1,0,1,1640,319,319,0
"86c27d40179e419c8e9d150fb6afa5d0","8d7e0b55cf9849cda222a0f2440cec55",22856155,2,-1,0,1641,319,318,-1
"8d7e0b55cf9849cda222a0f2440cec55","47edbb64109243e6b0f8f64cdef90c6c",22856155,2,9,0,1642,318,326,8
"47edbb64109243e6b0f8f64cdef90c6c","24f1363179ad4aaa965484a78471912b",22856155,3,-3,0,1643,326,323,-3
"24f1363179ad4aaa965484a78471912b","3628bdce1dd2429ba924d2d4d09448d2",22856155,3,-1,0,1644,323,322,-1
"3628bdce1dd2429ba924d2d4d09448d2","0c4079457ede49e3aeb5e86ed84bdf35",22856155,1,10,0,1645,322,329,7
"0c4079457ede49e3aeb5e86ed84bdf35","3434c10e561d488a914e0f7d71907abd",22856155,3,-31,0,1646,329,305,-24
"3434c10e561d488a914e0f7d71907abd","38aea304b4fa46e1b29bb72f5cea4c93",22856155,1,33,0,1647,305,331,26
"38aea304b4fa46e1b29bb72f5cea4c93","0c4079457ede49e3aeb5e86ed84bdf35",22856155,1,-2,0,1648,331,329,-2
"3434c10e561d488a914e0f7d71907abd","0c4079457ede49e3aeb5e86ed84bdf35",22856155,2,31,0,1650,305,329,24
"3434c10e561d488a914e0f7d71907abd","24f1363179ad4aaa965484a78471912b",22856155,1,22,0,1652,305,323,18
"24f1363179ad4aaa965484a78471912b","43ea1b823a4b4e51b7c694c10725db82",22856155,1,5,0,1653,323,327,4
"43ea1b823a4b4e51b7c694c10725db82","47edbb64109243e6b0f8f64cdef90c6c",22856155,1,-2,0,1654,327,326,-1
"47edbb64109243e6b0f8f64cdef90c6c","3628bdce1dd2429ba924d2d4d09448d2",22856155,1,-4,0,1655,326,322,-4
"3628bdce1dd2429ba924d2d4d09448d2","86c27d40179e419c8e9d150fb6afa5d0",22856155,2,-4,0,1656,322,319,-3
"86c27d40179e419c8e9d150fb6afa5d0","3434c10e561d488a914e0f7d71907abd",22856155,1,-17,0,1657,319,305,-14
"3434c10e561d488a914e0f7d71907abd","47edbb64109243e6b0f8f64cdef90c6c",22856155,1,25,0,1658,305,326,21
"24f1363179ad4aaa965484a78471912b","24f1363179ad4aaa965484a78471912b",22856155,2,0,1,1660,323,323,0
"3628bdce1dd2429ba924d2d4d09448d2","56b3fd1a212a4764be39d979fde3326e",22856155,1,7,0,1668,322,328,6
"56b3fd1a212a4764be39d979fde3326e","56b3fd1a212a4764be39d979fde3326e",22856155,1,0,1,1669,328,328,0
"56b3fd1a212a4764be39d979fde3326e","3434c10e561d488a914e0f7d71907abd",22856155,1,-28,0,1670,328,305,-23
"0c4079457ede49e3aeb5e86ed84bdf35","38aea304b4fa46e1b29bb72f5cea4c93",22856155,1,2,0,1672,329,331,2
"38aea304b4fa46e1b29bb72f5cea4c93","38aea304b4fa46e1b29bb72f5cea4c93",22856155,7,0,1,1673,331,331,0
"38aea304b4fa46e1b29bb72f5cea4c93","e36d261332f14e79bb4b467aceaeb9b5",22856155,1,2,0,1680,331,333,2
"e36d261332f14e79bb4b467aceaeb9b5","e36d261332f14e79bb4b467aceaeb9b5",22856155,1,0,1,1681,333,333,0
"e36d261332f14e79bb4b467aceaeb9b5","c7e89b9d04744d2eab742fc24e3ef1ae",22856155,1,1,0,1682,333,334,1
"c7e89b9d04744d2eab742fc24e3ef1ae","c7e89b9d04744d2eab742fc24e3ef1ae",22856155,2,0,1,1683,334,334,0
"c7e89b9d04744d2eab742fc24e3ef1ae","fe49f8054b374a0ea4bb266ed135ff62",22856155,1,1,0,1685,334,335,1
"fe49f8054b374a0ea4bb266ed135ff62","fe49f8054b374a0ea4bb266ed135ff62",22856155,2,0,1,1686,335,335,0
"fe49f8054b374a0ea4bb266ed135ff62","d0a8f74af98642fe8360d22c42e45117",22856155,1,1,0,1688,335,336,1
"d0a8f74af98642fe8360d22c42e45117","d0a8f74af98642fe8360d22c42e45117",22856155,2,0,1,1689,336,336,0
"d0a8f74af98642fe8360d22c42e45117","0c4079457ede49e3aeb5e86ed84bdf35",22856155,1,-7,0,1691,336,329,-7
"0c4079457ede49e3aeb5e86ed84bdf35","a7c6339ca1da4368a18d471f0519f877",22856155,1,11,0,1692,329,339,10
"a7c6339ca1da4368a18d471f0519f877","a7c6339ca1da4368a18d471f0519f877",22856155,1,0,1,1693,339,339,0
"a7c6339ca1da4368a18d471f0519f877","bbc5139ca9024389a94db3a6f47dcff6",22856155,1,3,0,1694,339,341,2
"bbc5139ca9024389a94db3a6f47dcff6","b8b9418ab322418d9db9b40d96af873a",22856155,1,-5,0,1695,341,337,-4
"b8b9418ab322418d9db9b40d96af873a","bbc5139ca9024389a94db3a6f47dcff6",22856155,1,5,0,1696,337,341,4
"bbc5139ca9024389a94db3a6f47dcff6","bbc5139ca9024389a94db3a6f47dcff6",22856155,2,0,1,1697,341,341,0
"bbc5139ca9024389a94db3a6f47dcff6","4ee6ca9019ab4a1ab323f98094a9bd77",22856155,1,2,0,1699,341,343,2
"4ee6ca9019ab4a1ab323f98094a9bd77","4ee6ca9019ab4a1ab323f98094a9bd77",22856155,2,0,1,1700,343,343,0
"4ee6ca9019ab4a1ab323f98094a9bd77","b37947176785476f8b29d49a851366dc",22856155,1,1,0,1702,343,344,1
"b37947176785476f8b29d49a851366dc","b37947176785476f8b29d49a851366dc",22856155,2,0,1,1703,344,344,0
"b37947176785476f8b29d49a851366dc","fcea5b10d5a14a3b9324ffece8f6e1e5",22856155,1,1,0,1705,344,345,1
"fcea5b10d5a14a3b9324ffece8f6e1e5","fcea5b10d5a14a3b9324ffece8f6e1e5",22856155,2,0,1,1706,345,345,0
"fcea5b10d5a14a3b9324ffece8f6e1e5","c2490bc612d146edbe786556fab3651b",22856155,1,-5,0,1708,345,340,-5
"c2490bc612d146edbe786556fab3651b","0c4079457ede49e3aeb5e86ed84bdf35",22856155,1,-13,0,1709,340,329,-11
"0c4079457ede49e3aeb5e86ed84bdf35","6ac8bb048b854999a47edb35fe627f11",22856155,1,21,0,1710,329,347,18
"6ac8bb048b854999a47edb35fe627f11","6ac8bb048b854999a47edb35fe627f11",22856155,1,0,1,1711,347,347,0
"6ac8bb048b854999a47edb35fe627f11","0c4079457ede49e3aeb5e86ed84bdf35",22856155,1,-21,0,1712,347,329,-18
"0c4079457ede49e3aeb5e86ed84bdf35","30ead9794d4847abaf222ca966cc8630",22856155,1,24,0,1713,329,348,19
"30ead9794d4847abaf222ca966cc8630","09b9678ddc3d452ea4a3d46e15826065",22856155,1,5,0,1714,348,353,5
"09b9678ddc3d452ea4a3d46e15826065","c20993c944444fe085345591a8bd837e",22856155,1,-2,0,1715,353,351,-2
"c20993c944444fe085345591a8bd837e","897b7f51242c44aab2205c72fdcbf4cd",22856155,2,1,0,1716,351,352,1
"897b7f51242c44aab2205c72fdcbf4cd","eff0de7f2dbb42dfa1a2e686efab5b6d",22856155,1,2,0,1717,352,354,2
"eff0de7f2dbb42dfa1a2e686efab5b6d","c20993c944444fe085345591a8bd837e",22856155,1,-3,0,1718,354,351,-3
"c20993c944444fe085345591a8bd837e","c20993c944444fe085345591a8bd837e",22856155,3,0,1,1719,351,351,0
"897b7f51242c44aab2205c72fdcbf4cd","897b7f51242c44aab2205c72fdcbf4cd",22856155,3,0,1,1723,352,352,0
"897b7f51242c44aab2205c72fdcbf4cd","09b9678ddc3d452ea4a3d46e15826065",22856155,1,1,0,1726,352,353,1
"09b9678ddc3d452ea4a3d46e15826065","09b9678ddc3d452ea4a3d46e15826065",22856155,3,0,1,1727,353,353,0
"09b9678ddc3d452ea4a3d46e15826065","eff0de7f2dbb42dfa1a2e686efab5b6d",22856155,1,1,0,1730,353,354,1
"eff0de7f2dbb42dfa1a2e686efab5b6d","eff0de7f2dbb42dfa1a2e686efab5b6d",22856155,3,0,1,1731,354,354,0
"eff0de7f2dbb42dfa1a2e686efab5b6d","2fe14166dc9642c3bc666b86a57f943d",22856155,1,4,0,1734,354,357,3
"2fe14166dc9642c3bc666b86a57f943d","30ead9794d4847abaf222ca966cc8630",22856155,1,-10,0,1735,357,348,-9
"30ead9794d4847abaf222ca966cc8630","2fe14166dc9642c3bc666b86a57f943d",22856155,1,10,0,1736,348,357,9
"2fe14166dc9642c3bc666b86a57f943d","2fe14166dc9642c3bc666b86a57f943d",22856155,3,0,1,1737,357,357,0
"2fe14166dc9642c3bc666b86a57f943d","44421dd1e13a47a388c4a19834b744c7",22856155,1,2,0,1740,357,359,2
"44421dd1e13a47a388c4a19834b744c7","44421dd1e13a47a388c4a19834b744c7",22856155,8,0,1,1741,359,359,0
"44421dd1e13a47a388c4a19834b744c7","cb5fc7ef85d547c4be1a7439d0bf6052",22856155,1,1,0,1749,359,360,1
"cb5fc7ef85d547c4be1a7439d0bf6052","cb5fc7ef85d547c4be1a7439d0bf6052",22856155,2,0,1,1750,360,360,0
"cb5fc7ef85d547c4be1a7439d0bf6052","0a8f150a4cf747acbde62f4721823da3",22856155,1,1,0,1752,360,361,1
"0a8f150a4cf747acbde62f4721823da3","0a8f150a4cf747acbde62f4721823da3",22856155,2,0,1,1753,361,361,0
"0a8f150a4cf747acbde62f4721823da3","ab8fdad974ae471f9f24c3f9dd04462e",22856155,1,1,0,1755,361,362,1
"ab8fdad974ae471f9f24c3f9dd04462e","ab8fdad974ae471f9f24c3f9dd04462e",22856155,2,0,1,1756,362,362,0
"ab8fdad974ae471f9f24c3f9dd04462e","52580888dadb4fe3baa795683ea227bd",22856155,1,3,0,1758,362,364,2
"52580888dadb4fe3baa795683ea227bd","1ba8fef685d74a8194b9db252eb704fb",22856155,1,-10,0,1759,364,355,-9
"1ba8fef685d74a8194b9db252eb704fb","52580888dadb4fe3baa795683ea227bd",22856155,1,10,0,1760,355,364,9
"52580888dadb4fe3baa795683ea227bd","52580888dadb4fe3baa795683ea227bd",22856155,1,0,1,1761,364,364,0
"52580888dadb4fe3baa795683ea227bd","492a3bc6a1254f23a7998587961b22a4",22856155,1,3,0,1762,364,366,2
"492a3bc6a1254f23a7998587961b22a4","f00179e251a045b39c3f7a54f9aa4acc",22856155,1,-4,0,1763,366,363,-3
"f00179e251a045b39c3f7a54f9aa4acc","30ead9794d4847abaf222ca966cc8630",22856155,1,-17,0,1764,363,348,-15
"30ead9794d4847abaf222ca966cc8630","492a3bc6a1254f23a7998587961b22a4",22856155,1,21,0,1765,348,366,18
"492a3bc6a1254f23a7998587961b22a4","492a3bc6a1254f23a7998587961b22a4",22856155,6,0,1,1766,366,366,0
"492a3bc6a1254f23a7998587961b22a4","072a190fd302456290895f9f04d6940a",22856155,1,-1,0,1772,366,365,-1
"072a190fd302456290895f9f04d6940a","cfa457d1743848e4bb5e4beced6448ed",22856155,1,5,0,1773,365,369,4
"cfa457d1743848e4bb5e4beced6448ed","cfa457d1743848e4bb5e4beced6448ed",22856155,1,0,1,1774,369,369,0
"cfa457d1743848e4bb5e4beced6448ed","30ead9794d4847abaf222ca966cc8630",22856155,1,-25,0,1775,369,348,-21
"30ead9794d4847abaf222ca966cc8630","b71bac264efb4abd97015447bd490db6",22856155,2,28,0,1776,348,370,22
"b71bac264efb4abd97015447bd490db6","6e83e23f56544a19b94067c1c558d9c0",22856155,1,-164,0,1777,370,247,-123
"6e83e23f56544a19b94067c1c558d9c0","2ae94c0cea4d480a9d5dca8fb1d7b542",22856155,1,-6,0,1778,247,242,-5
"2ae94c0cea4d480a9d5dca8fb1d7b542","30c9ba177afc49a695625d2bdec40207",22856155,1,9,0,1779,242,250,8
"30c9ba177afc49a695625d2bdec40207","30c9ba177afc49a695625d2bdec40207",22856155,6,0,1,1780,250,250,0
"30c9ba177afc49a695625d2bdec40207","2ae94c0cea4d480a9d5dca8fb1d7b542",22856155,1,-9,0,1786,250,242,-8
"2ae94c0cea4d480a9d5dca8fb1d7b542","30ead9794d4847abaf222ca966cc8630",22856155,1,142,0,1787,242,348,106
"30ead9794d4847abaf222ca966cc8630","30ead9794d4847abaf222ca966cc8630",22856155,1,0,1,1788,348,348,0
"b71bac264efb4abd97015447bd490db6","8d448d625b024c82a5eb240bbd7431d6",22856155,8,5,0,1790,370,374,4
"8d448d625b024c82a5eb240bbd7431d6","8d448d625b024c82a5eb240bbd7431d6",22856155,101,0,1,1791,374,374,0
"8d448d625b024c82a5eb240bbd7431d6","b71bac264efb4abd97015447bd490db6",22856155,6,-5,0,1797,374,370,-4
"b71bac264efb4abd97015447bd490db6","d6d02b6ef04e4f17805504500b8ce441",22856155,7,8,0,1851,370,375,5
"d6d02b6ef04e4f17805504500b8ce441","d6d02b6ef04e4f17805504500b8ce441",22856155,9,0,1,1852,375,375,0
"d6d02b6ef04e4f17805504500b8ce441","b71bac264efb4abd97015447bd490db6",22856155,8,-8,0,1853,375,370,-5
"8d448d625b024c82a5eb240bbd7431d6","d6d02b6ef04e4f17805504500b8ce441",22856155,2,3,0,1864,374,375,1
"d6d02b6ef04e4f17805504500b8ce441","4e51676dc72045d99c19b9fa7b22f8bc",22856155,1,-469,0,1931,375,29,-346
"4e51676dc72045d99c19b9fa7b22f8bc","c9c52446b6294aa5a9c2abaed536c37e",22856155,1,5,0,1932,29,32,3
"7040a13096d746ac84b8fac8d9752058","4e51676dc72045d99c19b9fa7b22f8bc",22856155,1,-15,0,1940,36,29,-7
"c33c17be71ae4d588da7369472e5bb1b","c33c17be71ae4d588da7369472e5bb1b",22856155,2,0,1,1944,34,34,0
"c33c17be71ae4d588da7369472e5bb1b","4e51676dc72045d99c19b9fa7b22f8bc",22856155,4,-9,0,1946,34,29,-5
"93679be414554a11b1893002f2229a93","93679be414554a11b1893002f2229a93",22856155,1,0,1,1956,35,35,0
"7040a13096d746ac84b8fac8d9752058","7040a13096d746ac84b8fac8d9752058",22856155,1,0,1,1958,36,36,0
"7040a13096d746ac84b8fac8d9752058","fc0e049d56024bc9a02c9a9c435c3df7",22856155,1,6,0,1961,36,38,2
"fc0e049d56024bc9a02c9a9c435c3df7","9a0dc646f934470daf08c4b56ccf73db",22856155,1,-3,0,1962,38,37,-1
"67a089198fcb4e1c8f2385786c2b296f","64d48c6c9c7940639a932219a6c87198",22856155,2,1,0,1967,39,40,1
"64d48c6c9c7940639a932219a6c87198","b534b89233134e30a9b5645138bfa9ee",22856155,2,3,0,1968,40,41,1
"b534b89233134e30a9b5645138bfa9ee","67a089198fcb4e1c8f2385786c2b296f",22856155,3,-4,0,1969,41,39,-2
"67a089198fcb4e1c8f2385786c2b296f","b534b89233134e30a9b5645138bfa9ee",22856155,3,4,0,1970,39,41,2
"67a089198fcb4e1c8f2385786c2b296f","66baf19b6b904b70922329068c63746d",22856155,1,448,0,1972,39,376,337
"66baf19b6b904b70922329068c63746d","66baf19b6b904b70922329068c63746d",22856155,1,0,1,1973,376,376,0
"66baf19b6b904b70922329068c63746d","7f544639412e40a9ba27f43b415362ab",22856155,1,2,0,1974,376,378,2
"7f544639412e40a9ba27f43b415362ab","7f544639412e40a9ba27f43b415362ab",22856155,5,0,1,1975,378,378,0
"7f544639412e40a9ba27f43b415362ab","d5ae8642e15b46b8bd298b02274d4e9c",22856155,1,2,0,1980,378,380,2
"d5ae8642e15b46b8bd298b02274d4e9c","d5ae8642e15b46b8bd298b02274d4e9c",22856155,1,0,1,1981,380,380,0
"d5ae8642e15b46b8bd298b02274d4e9c","a0d10309a2dd456289147f84be9d37f9",22856155,1,1,0,1982,380,381,1
"a0d10309a2dd456289147f84be9d37f9","a0d10309a2dd456289147f84be9d37f9",22856155,2,0,1,1983,381,381,0
"a0d10309a2dd456289147f84be9d37f9","0fcbc3ca07b144138b8d85da581f09a8",22856155,1,1,0,1985,381,382,1
"0fcbc3ca07b144138b8d85da581f09a8","0fcbc3ca07b144138b8d85da581f09a8",22856155,2,0,1,1986,382,382,0
"0fcbc3ca07b144138b8d85da581f09a8","66baf19b6b904b70922329068c63746d",22856155,1,-6,0,1988,382,376,-6
"66baf19b6b904b70922329068c63746d","c2fca3669923477ab966ded303dea31c",22856155,1,8,0,1989,376,383,7
"c2fca3669923477ab966ded303dea31c","4890121ce5d74576b4632b77cfc23398",22856155,1,6,0,1990,383,388,5
"4890121ce5d74576b4632b77cfc23398","4890121ce5d74576b4632b77cfc23398",22856155,4,0,1,1991,388,388,0
"4890121ce5d74576b4632b77cfc23398","18d3b836dd804224883cc9180b60a8e1",22856155,1,-1,0,1995,388,387,-1
"18d3b836dd804224883cc9180b60a8e1","96bb2b3e85a34d8b9544514e89f6fe97",22856155,1,4,0,1996,387,390,3
"96bb2b3e85a34d8b9544514e89f6fe97","96bb2b3e85a34d8b9544514e89f6fe97",22856155,2,0,1,1997,390,390,0
"96bb2b3e85a34d8b9544514e89f6fe97","ac4e9b54acfe4670b4634859c7263cb5",22856155,1,2,0,1999,390,392,2
"ac4e9b54acfe4670b4634859c7263cb5","ac4e9b54acfe4670b4634859c7263cb5",22856155,1,0,1,2000,392,392,0
"ac4e9b54acfe4670b4634859c7263cb5","6f8881a745ac4c358a68b92c3b4abe81",22856155,1,3,0,2001,392,394,2
"6f8881a745ac4c358a68b92c3b4abe81","17f95d18bab743888e1736033dc3384d",22856155,1,-6,0,2002,394,389,-5
"17f95d18bab743888e1736033dc3384d","6f8881a745ac4c358a68b92c3b4abe81",22856155,1,6,0,2003,389,394,5
"6f8881a745ac4c358a68b92c3b4abe81","6f8881a745ac4c358a68b92c3b4abe81",22856155,1,0,1,2004,394,394,0
"6f8881a745ac4c358a68b92c3b4abe81","f7002c8484354eceac57bc7bd62c76c1",22856155,1,-1,0,2005,394,393,-1
"f7002c8484354eceac57bc7bd62c76c1","44a277ea44dc4ae689fab4b82f0b4098",22856155,1,5,0,2006,393,397,4
"44a277ea44dc4ae689fab4b82f0b4098","44a277ea44dc4ae689fab4b82f0b4098",22856155,1,0,1,2007,397,397,0
"44a277ea44dc4ae689fab4b82f0b4098","0c12af0a4e7f4002852cf84b2537c161",22856155,1,-2,0,2008,397,395,-2
"0c12af0a4e7f4002852cf84b2537c161","859e0b8d71694b12befb69ee698138f9",22856155,1,5,0,2009,395,399,4
"859e0b8d71694b12befb69ee698138f9","859e0b8d71694b12befb69ee698138f9",22856155,1,0,1,2010,399,399,0
"859e0b8d71694b12befb69ee698138f9","2b09a08242b54983aec7063990fb3f66",22856155,1,3,0,2011,399,400,1
"2b09a08242b54983aec7063990fb3f66","66baf19b6b904b70922329068c63746d",22856155,1,-32,0,2012,400,376,-24
"66baf19b6b904b70922329068c63746d","2b09a08242b54983aec7063990fb3f66",22856155,1,32,0,2013,376,400,24
"2b09a08242b54983aec7063990fb3f66","2b09a08242b54983aec7063990fb3f66",22856155,7,0,1,2014,400,400,0
"2b09a08242b54983aec7063990fb3f66","1f471b7a883a4df48211e8c6a81b59a7",22856155,1,1,0,2020,400,401,1
"1f471b7a883a4df48211e8c6a81b59a7","1f471b7a883a4df48211e8c6a81b59a7",22856155,1,0,1,2021,401,401,0
"1f471b7a883a4df48211e8c6a81b59a7","2b09a08242b54983aec7063990fb3f66",22856155,1,-1,0,2022,401,400,-1
"2b09a08242b54983aec7063990fb3f66","9de0d567bfa84fe5b77cb76f4a76a5d1",22856155,1,5,0,2024,400,404,4
"9de0d567bfa84fe5b77cb76f4a76a5d1","9de0d567bfa84fe5b77cb76f4a76a5d1",22856155,2,0,1,2025,404,404,0
"9de0d567bfa84fe5b77cb76f4a76a5d1","1157bd665ec4472fb58b751dc5099355",22856155,2,-1,0,2026,404,403,-1
"1157bd665ec4472fb58b751dc5099355","3c8a22d2f9c146ea956609e3ed4f2559",22856155,2,3,0,2027,403,405,2
"3c8a22d2f9c146ea956609e3ed4f2559","9de0d567bfa84fe5b77cb76f4a76a5d1",22856155,1,-2,0,2028,405,404,-1
"3c8a22d2f9c146ea956609e3ed4f2559","58fc9094275e4c49be3f4ba6d4acc0a4",22856155,1,2,0,2032,405,406,1
"58fc9094275e4c49be3f4ba6d4acc0a4","58fc9094275e4c49be3f4ba6d4acc0a4",22856155,3,0,1,2033,406,406,0
"58fc9094275e4c49be3f4ba6d4acc0a4","c1c1be90b2b14c1ab4a5e1ee3c241902",22856155,1,1,0,2036,406,407,1
"c1c1be90b2b14c1ab4a5e1ee3c241902","c1c1be90b2b14c1ab4a5e1ee3c241902",22856155,5,0,1,2037,407,407,0
"c1c1be90b2b14c1ab4a5e1ee3c241902","02b3a1bead9244c1ba2f857c7da8f82a",22856155,1,2,0,2042,407,408,1
"02b3a1bead9244c1ba2f857c7da8f82a","58fc9094275e4c49be3f4ba6d4acc0a4",22856155,1,-3,0,2043,408,406,-2
"58fc9094275e4c49be3f4ba6d4acc0a4","02b3a1bead9244c1ba2f857c7da8f82a",22856155,1,3,0,2044,406,408,2
"02b3a1bead9244c1ba2f857c7da8f82a","02b3a1bead9244c1ba2f857c7da8f82a",22856155,2,0,1,2045,408,408,0
"02b3a1bead9244c1ba2f857c7da8f82a","6206fc6479014bb193084c32409dc1b9",22856155,1,1,0,2047,408,409,1
"6206fc6479014bb193084c32409dc1b9","6206fc6479014bb193084c32409dc1b9",22856155,1,0,1,2048,409,409,0
"6206fc6479014bb193084c32409dc1b9","6a5f020451db426dacba9e2ea3fcc62a",22856155,1,2,0,2049,409,410,1
"6a5f020451db426dacba9e2ea3fcc62a","02b3a1bead9244c1ba2f857c7da8f82a",22856155,1,-3,0,2050,410,408,-2
"02b3a1bead9244c1ba2f857c7da8f82a","6a5f020451db426dacba9e2ea3fcc62a",22856155,1,3,0,2051,408,410,2
"6a5f020451db426dacba9e2ea3fcc62a","6a5f020451db426dacba9e2ea3fcc62a",22856155,2,0,1,2052,410,410,0
"6a5f020451db426dacba9e2ea3fcc62a","33a9d248b2e44588a5b07fc1342b9bc2",22856155,1,2,0,2054,410,411,1
"33a9d248b2e44588a5b07fc1342b9bc2","33a9d248b2e44588a5b07fc1342b9bc2",22856155,4,0,1,2055,411,411,0
"33a9d248b2e44588a5b07fc1342b9bc2","c6f26bd420634f1cb7989e76fe6b16c0",22856155,1,1,0,2059,411,412,1
"c6f26bd420634f1cb7989e76fe6b16c0","c6f26bd420634f1cb7989e76fe6b16c0",22856155,5,0,1,2060,412,412,0
"c6f26bd420634f1cb7989e76fe6b16c0","2a65ee6e2ac64f6a8a55fbe5373ec763",22856155,1,1,0,2065,412,413,1
"2a65ee6e2ac64f6a8a55fbe5373ec763","2a65ee6e2ac64f6a8a55fbe5373ec763",22856155,2,0,1,2066,413,413,0
"2a65ee6e2ac64f6a8a55fbe5373ec763","33a9d248b2e44588a5b07fc1342b9bc2",22856155,1,-2,0,2068,413,411,-2
"33a9d248b2e44588a5b07fc1342b9bc2","2b09a08242b54983aec7063990fb3f66",22856155,1,-17,0,2069,411,400,-11
"2b09a08242b54983aec7063990fb3f66","1fd0f6dadbc14ebc965faf6122190b96",22856155,1,22,0,2070,400,415,15
"1fd0f6dadbc14ebc965faf6122190b96","1fd0f6dadbc14ebc965faf6122190b96",22856155,1,0,1,2071,415,415,0
"1fd0f6dadbc14ebc965faf6122190b96","687055dad9fc40c3982478fe33ec01bf",22856155,1,-1,0,2072,415,414,-1
"687055dad9fc40c3982478fe33ec01bf","2add1669f08d4101913db15f8c23b3b7",22856155,1,3,0,2073,414,416,2
"2add1669f08d4101913db15f8c23b3b7","2add1669f08d4101913db15f8c23b3b7",22856155,1,0,1,2074,416,416,0
"2add1669f08d4101913db15f8c23b3b7","2b09a08242b54983aec7063990fb3f66",22856155,1,-24,0,2075,416,400,-16
"2b09a08242b54983aec7063990fb3f66","a2b4bd40cee2481ebd3fc179d6a5cd62",22856155,1,27,0,2076,400,417,17
"a2b4bd40cee2481ebd3fc179d6a5cd62","e34e59dce2204f228f3a84b6725df60f",22856155,1,2,0,2077,417,419,2
"e34e59dce2204f228f3a84b6725df60f","e34e59dce2204f228f3a84b6725df60f",22856155,1,0,1,2078,419,419,0
"e34e59dce2204f228f3a84b6725df60f","a2b4bd40cee2481ebd3fc179d6a5cd62",22856155,1,-2,0,2079,419,417,-2
"a2b4bd40cee2481ebd3fc179d6a5cd62","bec48fc2e1294c7eb3d0aca780d731b8",22856155,1,4,0,2080,417,420,3
"bec48fc2e1294c7eb3d0aca780d731b8","bec48fc2e1294c7eb3d0aca780d731b8",22856155,3,0,1,2081,420,420,0
"bec48fc2e1294c7eb3d0aca780d731b8","dbde19fcce2a4c1abdc7f685c293a23f",22856155,1,3,0,2084,420,422,2
"dbde19fcce2a4c1abdc7f685c293a23f","a24600b0e49245f6bdba8c893cfeddb0",22856155,1,4,0,2085,422,425,3
"a24600b0e49245f6bdba8c893cfeddb0","a24600b0e49245f6bdba8c893cfeddb0",22856155,3,0,1,2086,425,425,0
"a24600b0e49245f6bdba8c893cfeddb0","a2b4bd40cee2481ebd3fc179d6a5cd62",22856155,2,-11,0,2087,425,417,-8
"a2b4bd40cee2481ebd3fc179d6a5cd62","a24600b0e49245f6bdba8c893cfeddb0",22856155,1,11,0,2088,417,425,8
"a2b4bd40cee2481ebd3fc179d6a5cd62","24cf8786024543f19b89bc20034e60d7",22856155,1,18,0,2092,417,428,11
"24cf8786024543f19b89bc20034e60d7","f2a73be2f46840b182d7bd095378004e",22856155,1,1,0,2093,428,429,1
"f2a73be2f46840b182d7bd095378004e","f2a73be2f46840b182d7bd095378004e",22856155,3,0,1,2094,429,429,0
"f2a73be2f46840b182d7bd095378004e","604551fd4266430cb860fef58fa7dd61",22856155,1,1,0,2097,429,430,1
"604551fd4266430cb860fef58fa7dd61","604551fd4266430cb860fef58fa7dd61",22856155,7,0,1,2098,430,430,0
"604551fd4266430cb860fef58fa7dd61","dce46f8904594a62a6377a3587aaa663",22856155,1,2,0,2105,430,431,1
"dce46f8904594a62a6377a3587aaa663","24cf8786024543f19b89bc20034e60d7",22856155,3,-4,0,2106,431,428,-3
"24cf8786024543f19b89bc20034e60d7","dce46f8904594a62a6377a3587aaa663",22856155,2,4,0,2107,428,431,3
"dce46f8904594a62a6377a3587aaa663","dce46f8904594a62a6377a3587aaa663",22856155,1,0,1,2108,431,431,0
"dce46f8904594a62a6377a3587aaa663","f2a73be2f46840b182d7bd095378004e",22856155,1,-3,0,2109,431,429,-2
"f2a73be2f46840b182d7bd095378004e","dce46f8904594a62a6377a3587aaa663",22856155,1,3,0,2110,429,431,2
"dce46f8904594a62a6377a3587aaa663","9b9d0a249052413c869753b99682b0ac",22856155,1,1,0,2113,431,432,1
"9b9d0a249052413c869753b99682b0ac","9b9d0a249052413c869753b99682b0ac",22856155,3,0,1,2114,432,432,0
"9b9d0a249052413c869753b99682b0ac","061c175cc90f45fbad883025394e78dd",22856155,1,1,0,2117,432,433,1
"061c175cc90f45fbad883025394e78dd","061c175cc90f45fbad883025394e78dd",22856155,1,0,1,2118,433,433,0
"061c175cc90f45fbad883025394e78dd","dce46f8904594a62a6377a3587aaa663",22856155,1,-2,0,2119,433,431,-2
"24cf8786024543f19b89bc20034e60d7","74a7f8712e5449c2bc0b43c6f90dafed",22856155,1,9,0,2121,428,435,7
"74a7f8712e5449c2bc0b43c6f90dafed","74a7f8712e5449c2bc0b43c6f90dafed",22856155,1,0,1,2122,435,435,0
"74a7f8712e5449c2bc0b43c6f90dafed","66ada10dde9f43018588f1ced9d477fc",22856155,1,-1,0,2123,435,434,-1
"66ada10dde9f43018588f1ced9d477fc","bf12c96466d840a69bed7020b3f18bb8",22856155,1,3,0,2124,434,436,2
"bf12c96466d840a69bed7020b3f18bb8","bf12c96466d840a69bed7020b3f18bb8",22856155,1,0,1,2125,436,436,0
"bf12c96466d840a69bed7020b3f18bb8","24cf8786024543f19b89bc20034e60d7",22856155,1,-11,0,2126,436,428,-8
"24cf8786024543f19b89bc20034e60d7","070600601c4c439288445d2f0724807d",22856155,1,14,0,2127,428,437,9
"070600601c4c439288445d2f0724807d","1823b6de7d334a7aaabc4570719af4d9",22856155,1,2,0,2128,437,439,2
"1823b6de7d334a7aaabc4570719af4d9","1823b6de7d334a7aaabc4570719af4d9",22856155,11,0,1,2129,439,439,0
"1823b6de7d334a7aaabc4570719af4d9","0380cd76a7d44bc3a4da1f15e4d68f89",22856155,1,2,0,2140,439,440,1
"0380cd76a7d44bc3a4da1f15e4d68f89","070600601c4c439288445d2f0724807d",22856155,1,-4,0,2141,440,437,-3
"070600601c4c439288445d2f0724807d","0380cd76a7d44bc3a4da1f15e4d68f89",22856155,1,4,0,2142,437,440,3
"0380cd76a7d44bc3a4da1f15e4d68f89","0380cd76a7d44bc3a4da1f15e4d68f89",22856155,3,0,1,2143,440,440,0
"0380cd76a7d44bc3a4da1f15e4d68f89","23b7673c8b5443108c2ef09382834a86",22856155,1,2,0,2146,440,441,1
"23b7673c8b5443108c2ef09382834a86","23b7673c8b5443108c2ef09382834a86",22856155,3,0,1,2147,441,441,0
"23b7673c8b5443108c2ef09382834a86","901e92500aea43c79f19f1b279050668",22856155,2,2,0,2150,441,442,1
"901e92500aea43c79f19f1b279050668","23b7673c8b5443108c2ef09382834a86",22856155,1,-2,0,2151,442,441,-1
"901e92500aea43c79f19f1b279050668","901e92500aea43c79f19f1b279050668",22856155,1,0,1,2153,442,442,0
"901e92500aea43c79f19f1b279050668","001339db8ced4cf78829ebe8b145449d",22856155,1,1,0,2154,442,443,1
"001339db8ced4cf78829ebe8b145449d","001339db8ced4cf78829ebe8b145449d",22856155,2,0,1,2155,443,443,0
"001339db8ced4cf78829ebe8b145449d","452745e0366e42ae81561bfddebcc6c3",22856155,1,1,0,2157,443,444,1
"452745e0366e42ae81561bfddebcc6c3","452745e0366e42ae81561bfddebcc6c3",22856155,5,0,1,2158,444,444,0
"452745e0366e42ae81561bfddebcc6c3","4660ff2089114e8db82ceb26a4f329e3",22856155,1,2,0,2163,444,445,1
"4660ff2089114e8db82ceb26a4f329e3","901e92500aea43c79f19f1b279050668",22856155,1,-4,0,2164,445,442,-3
"901e92500aea43c79f19f1b279050668","4660ff2089114e8db82ceb26a4f329e3",22856155,1,4,0,2165,442,445,3
"4660ff2089114e8db82ceb26a4f329e3","4660ff2089114e8db82ceb26a4f329e3",22856155,3,0,1,2166,445,445,0
"4660ff2089114e8db82ceb26a4f329e3","7bd5586eb9d8484eb74a433ee7bfe499",22856155,1,2,0,2169,445,446,1
"7bd5586eb9d8484eb74a433ee7bfe499","7bd5586eb9d8484eb74a433ee7bfe499",22856155,18,0,1,2170,446,446,0
"7bd5586eb9d8484eb74a433ee7bfe499","8a7f26e690f34dda97be16904518ca99",22856155,1,2,0,2188,446,447,1
"8a7f26e690f34dda97be16904518ca99","8a7f26e690f34dda97be16904518ca99",22856155,1,0,1,2189,447,447,0
"8a7f26e690f34dda97be16904518ca99","070600601c4c439288445d2f0724807d",22856155,1,-16,0,2190,447,437,-10
"070600601c4c439288445d2f0724807d","b2f0d654738f48158edff28e8d3a546e",22856155,1,21,0,2191,437,449,12
"b2f0d654738f48158edff28e8d3a546e","f60ee41ec635499abd48168342d32c2f",22856155,5,5,0,2192,449,453,4
"f60ee41ec635499abd48168342d32c2f","f60ee41ec635499abd48168342d32c2f",22856155,80,0,1,2193,453,453,0
"f60ee41ec635499abd48168342d32c2f","b2f0d654738f48158edff28e8d3a546e",22856155,3,-5,0,2194,453,449,-4
"f60ee41ec635499abd48168342d32c2f","b7719e26494940efa49512aedd0aac79",22856155,1,-605,0,2214,453,20,-433
"d4c3b003e8274e429d2fa688d73fde6d","b2f0d654738f48158edff28e8d3a546e",22856155,1,597,0,2217,22,449,427
"f60ee41ec635499abd48168342d32c2f","f67fbf45a5f146ed866965bc57c7c001",22856155,1,3,0,2284,453,454,1
"f67fbf45a5f146ed866965bc57c7c001","b2f0d654738f48158edff28e8d3a546e",22856155,1,-8,0,2285,454,449,-5
"b2f0d654738f48158edff28e8d3a546e","f67fbf45a5f146ed866965bc57c7c001",22856155,1,8,0,2286,449,454,5
"f67fbf45a5f146ed866965bc57c7c001","f67fbf45a5f146ed866965bc57c7c001",22856155,1,0,1,2287,454,454,0
"f67fbf45a5f146ed866965bc57c7c001","d937afe49bd24a07a550dda1c1155122",22856155,1,1,0,2288,454,455,1
"d937afe49bd24a07a550dda1c1155122","d937afe49bd24a07a550dda1c1155122",22856155,1,0,1,2289,455,455,0
"d937afe49bd24a07a550dda1c1155122","3628b3f7823443d0912a339096b69943",22856155,1,1,0,2290,455,456,1
"3628b3f7823443d0912a339096b69943","3628b3f7823443d0912a339096b69943",22856155,1,0,1,2291,456,456,0
"3628b3f7823443d0912a339096b69943","9e049ee647cf43ecbcb5ed792a8e7588",22856155,1,1,0,2292,456,457,1
"9e049ee647cf43ecbcb5ed792a8e7588","9e049ee647cf43ecbcb5ed792a8e7588",22856155,1,0,1,2293,457,457,0
"9e049ee647cf43ecbcb5ed792a8e7588","5256a214faaf410b93f76cea06428334",22856155,1,1,0,2294,457,458,1
"5256a214faaf410b93f76cea06428334","5256a214faaf410b93f76cea06428334",22856155,1,0,1,2295,458,458,0
"5256a214faaf410b93f76cea06428334","25c32b120fce40fa9b6c85133aeb4716",22856155,1,1,0,2296,458,459,1
"25c32b120fce40fa9b6c85133aeb4716","25c32b120fce40fa9b6c85133aeb4716",22856155,6,0,1,2297,459,459,0
"25c32b120fce40fa9b6c85133aeb4716","11bc14f2204949008b7d511b933363c1",22856155,1,1,0,2303,459,460,1
"11bc14f2204949008b7d511b933363c1","11bc14f2204949008b7d511b933363c1",22856155,5,0,1,2304,460,460,0
"11bc14f2204949008b7d511b933363c1","42de338840a34d15adb66e7b14fb9d2c",22856155,1,1,0,2309,460,461,1
"42de338840a34d15adb66e7b14fb9d2c","42de338840a34d15adb66e7b14fb9d2c",22856155,1,0,1,2310,461,461,0
"42de338840a34d15adb66e7b14fb9d2c","9da37c6210b1416b8079c274f70bf600",22856155,1,1,0,2311,461,462,1
"9da37c6210b1416b8079c274f70bf600","9da37c6210b1416b8079c274f70bf600",22856155,1,0,1,2312,462,462,0
"9da37c6210b1416b8079c274f70bf600","519119f1deac45ff9ab4f13529be5c6e",22856155,1,1,0,2313,462,463,1
"519119f1deac45ff9ab4f13529be5c6e","519119f1deac45ff9ab4f13529be5c6e",22856155,1,0,1,2314,463,463,0
"519119f1deac45ff9ab4f13529be5c6e","c5df9f40ec14463b9dcfdc73df3e9285",22856155,1,3,0,2315,463,464,1
"c5df9f40ec14463b9dcfdc73df3e9285","f67fbf45a5f146ed866965bc57c7c001",22856155,3,-12,0,2316,464,454,-10
"f67fbf45a5f146ed866965bc57c7c001","c5df9f40ec14463b9dcfdc73df3e9285",22856155,3,12,0,2317,454,464,10
"c5df9f40ec14463b9dcfdc73df3e9285","c5df9f40ec14463b9dcfdc73df3e9285",22856155,2,0,1,2322,464,464,0
"c5df9f40ec14463b9dcfdc73df3e9285","83d42d95cd844fc093fc09cee250edb8",22856155,2,3,0,2324,464,465,1
"83d42d95cd844fc093fc09cee250edb8","c5df9f40ec14463b9dcfdc73df3e9285",22856155,1,-3,0,2325,465,464,-1
"83d42d95cd844fc093fc09cee250edb8","83d42d95cd844fc093fc09cee250edb8",22856155,12,0,1,2327,465,465,0
"b613861cecf84ffcab01afb23f660475","b613861cecf84ffcab01afb23f660475",22856815,7,0,1,1,1,1,0
"e2911e79efc2420eac45d9f671463d4b","b613861cecf84ffcab01afb23f660475",22856815,1,-3,0,5,2,1,-1
"b613861cecf84ffcab01afb23f660475","e2911e79efc2420eac45d9f671463d4b",22856815,2,3,0,10,1,2,1
"e2911e79efc2420eac45d9f671463d4b","e2911e79efc2420eac45d9f671463d4b",22856815,3,0,1,11,2,2,0
"e2911e79efc2420eac45d9f671463d4b","519d1b8c59404d67b54e96c5c8a830b2",22856815,1,1,0,13,2,3,1
"519d1b8c59404d67b54e96c5c8a830b2","519d1b8c59404d67b54e96c5c8a830b2",22856815,1,0,1,14,3,3,0
"519d1b8c59404d67b54e96c5c8a830b2","531db53f81f646edb0cdcfe0085b03b7",22856815,1,1,0,15,3,4,1
"531db53f81f646edb0cdcfe0085b03b7","531db53f81f646edb0cdcfe0085b03b7",22856815,1,0,1,16,4,4,0
"531db53f81f646edb0cdcfe0085b03b7","4f5f94b2f95141e0a9d53a61da2276da",22856815,1,1,0,17,4,5,1
"4f5f94b2f95141e0a9d53a61da2276da","4f5f94b2f95141e0a9d53a61da2276da",22856815,1,0,1,18,5,5,0
"4f5f94b2f95141e0a9d53a61da2276da","6d541c89590949f99af293c4f2333f67",22856815,1,1,0,19,5,6,1
"6d541c89590949f99af293c4f2333f67","6d541c89590949f99af293c4f2333f67",22856815,1,0,1,20,6,6,0
"6d541c89590949f99af293c4f2333f67","dd5cf0b9fe4c4f1d8f5ff8e4c04879cb",22856815,1,1,0,21,6,7,1
"dd5cf0b9fe4c4f1d8f5ff8e4c04879cb","dd5cf0b9fe4c4f1d8f5ff8e4c04879cb",22856815,1,0,1,22,7,7,0
"dd5cf0b9fe4c4f1d8f5ff8e4c04879cb","f96261861edc426abe2248be4f0a709a",22856815,1,1,0,23,7,8,1
"f96261861edc426abe2248be4f0a709a","f96261861edc426abe2248be4f0a709a",22856815,1,0,1,24,8,8,0
"f96261861edc426abe2248be4f0a709a","66b5e16f4f75454fb5b8172079f0fa83",22856815,1,1,0,25,8,9,1
"66b5e16f4f75454fb5b8172079f0fa83","66b5e16f4f75454fb5b8172079f0fa83",22856815,1,0,1,26,9,9,0
"66b5e16f4f75454fb5b8172079f0fa83","0680571d4698477995e41842c36a54b2",22856815,1,1,0,27,9,10,1
"0680571d4698477995e41842c36a54b2","0680571d4698477995e41842c36a54b2",22856815,1,0,1,28,10,10,0
"0680571d4698477995e41842c36a54b2","56586aa865414f538729c7f7735d2bc6",22856815,1,4,0,29,10,12,2
"56586aa865414f538729c7f7735d2bc6","e2911e79efc2420eac45d9f671463d4b",22856815,1,-12,0,30,12,2,-10
"e2911e79efc2420eac45d9f671463d4b","9112f2bffece48e08c6d2287be204085",22856815,2,9,0,31,2,11,9
"9112f2bffece48e08c6d2287be204085","e2911e79efc2420eac45d9f671463d4b",22856815,2,-9,0,32,11,2,-9
"9112f2bffece48e08c6d2287be204085","9112f2bffece48e08c6d2287be204085",22856815,1,0,1,35,11,11,0
"e2911e79efc2420eac45d9f671463d4b","56586aa865414f538729c7f7735d2bc6",22856815,1,12,0,37,2,12,10
"56586aa865414f538729c7f7735d2bc6","56586aa865414f538729c7f7735d2bc6",22856815,3,0,1,38,12,12,0
"56586aa865414f538729c7f7735d2bc6","b7f2b31585d94eb3bf86376714aa7070",22856815,1,2,0,41,12,13,1
"b7f2b31585d94eb3bf86376714aa7070","b7f2b31585d94eb3bf86376714aa7070",22856815,2,0,1,42,13,13,0
"b7f2b31585d94eb3bf86376714aa7070","3f1c815879794b929260d224becaff7e",22856815,1,2,0,44,13,14,1
"3f1c815879794b929260d224becaff7e","5c5ceeee4562457ba6d41515aeebfbb1",22856815,1,6,0,45,14,17,3
"5c5ceeee4562457ba6d41515aeebfbb1","81c864a886d54a6b8ff85f7d736f4f95",22856815,1,-4,0,46,17,15,-2
"81c864a886d54a6b8ff85f7d736f4f95","5c5ceeee4562457ba6d41515aeebfbb1",22856815,1,4,0,47,15,17,2
"5c5ceeee4562457ba6d41515aeebfbb1","56586aa865414f538729c7f7735d2bc6",22856815,1,-10,0,48,17,12,-5
"56586aa865414f538729c7f7735d2bc6","9afd71a5298d4333b6849dfce1b9422c",22856815,1,13,0,49,12,18,6
"9afd71a5298d4333b6849dfce1b9422c","67a089198fcb4e1c8f2385786c2b296f",22856815,1,44,0,50,18,39,21
"b534b89233134e30a9b5645138bfa9ee","0e37b720d23b4e7f8b313e79313fd107",22856815,1,3,0,55,41,44,3
"0e37b720d23b4e7f8b313e79313fd107","0e37b720d23b4e7f8b313e79313fd107",22856815,1,0,1,56,44,44,0
"0e37b720d23b4e7f8b313e79313fd107","6875d67fdd5f48168b62719df449bebd",22856815,1,1,0,57,44,45,1
"6875d67fdd5f48168b62719df449bebd","6875d67fdd5f48168b62719df449bebd",22856815,3,0,1,58,45,45,0
"6875d67fdd5f48168b62719df449bebd","b534b89233134e30a9b5645138bfa9ee",22856815,1,-4,0,61,45,41,-4
"6e13d61a7bdb44bca949c9f86fab3be5","6e13d61a7bdb44bca949c9f86fab3be5",22856815,2,0,1,63,47,47,0
"6e13d61a7bdb44bca949c9f86fab3be5","195f78799f984cc2b06c48dfe36be751",22856815,1,2,0,65,47,49,2
"195f78799f984cc2b06c48dfe36be751","195f78799f984cc2b06c48dfe36be751",22856815,2,0,1,66,49,49,0
"195f78799f984cc2b06c48dfe36be751","d0c74f735e024943943e40333d6d337f",22856815,1,3,0,68,49,51,2
"d0c74f735e024943943e40333d6d337f","d9c8d8c444a64dadbbb508652c721e17",22856815,1,-6,0,69,51,46,-5
"d0c74f735e024943943e40333d6d337f","d0c74f735e024943943e40333d6d337f",22856815,1,0,1,71,51,51,0
"d0c74f735e024943943e40333d6d337f","983f8ff320594b279a7f4a6fe132f9c5",22856815,1,2,0,72,51,53,2
"983f8ff320594b279a7f4a6fe132f9c5","983f8ff320594b279a7f4a6fe132f9c5",22856815,2,0,1,73,53,53,0
"983f8ff320594b279a7f4a6fe132f9c5","35adfa5d923046aebabfefd98f35ff05",22856815,1,1,0,75,53,54,1
"35adfa5d923046aebabfefd98f35ff05","35adfa5d923046aebabfefd98f35ff05",22856815,8,0,1,76,54,54,0
"35adfa5d923046aebabfefd98f35ff05","b6f8a98476224da1b40e555ececc7ed8",22856815,1,1,0,84,54,55,1
"b6f8a98476224da1b40e555ececc7ed8","b6f8a98476224da1b40e555ececc7ed8",22856815,8,0,1,85,55,55,0
"b6f8a98476224da1b40e555ececc7ed8","86e22cb5fe0e4b47a9489ecddf7ed78f",22856815,1,1,0,93,55,56,1
"86e22cb5fe0e4b47a9489ecddf7ed78f","86e22cb5fe0e4b47a9489ecddf7ed78f",22856815,2,0,1,94,56,56,0
"86e22cb5fe0e4b47a9489ecddf7ed78f","f924752d8a1149668870b1e7698486f7",22856815,1,-6,0,96,56,50,-6
"f924752d8a1149668870b1e7698486f7","a1f2f12debe5432fb7a70bcd12bacfb9",22856815,1,9,0,97,50,58,8
"78f30e4dcac84e3cbea8b2cc6e0d62b3","a1f2f12debe5432fb7a70bcd12bacfb9",22856815,2,-1,0,100,59,58,-1
"a1f2f12debe5432fb7a70bcd12bacfb9","a1f2f12debe5432fb7a70bcd12bacfb9",22856815,27,0,1,101,58,58,0
"a1f2f12debe5432fb7a70bcd12bacfb9","78f30e4dcac84e3cbea8b2cc6e0d62b3",22856815,2,1,0,128,58,59,1
"78f30e4dcac84e3cbea8b2cc6e0d62b3","78f30e4dcac84e3cbea8b2cc6e0d62b3",22856815,18,0,1,129,59,59,0
"78f30e4dcac84e3cbea8b2cc6e0d62b3","a0a418b8540d479fa6e0f653b701da8b",22856815,1,6,0,146,59,64,5
"a0a418b8540d479fa6e0f653b701da8b","bc42d26810654ea9a1df1efe1e58c7d5",22856815,1,-1,0,147,64,63,-1
"bc42d26810654ea9a1df1efe1e58c7d5","12aa6e1672ac4e7aa6449a7a8609cd72",22856815,1,-7,0,148,63,57,-6
"12aa6e1672ac4e7aa6449a7a8609cd72","4c943503763e4e349906eea3ed3c8e86",22856815,1,5,0,149,57,61,4
"4c943503763e4e349906eea3ed3c8e86","4c943503763e4e349906eea3ed3c8e86",22856815,1,0,1,150,61,61,0
"4c943503763e4e349906eea3ed3c8e86","309ccf3cc4fe429d9bfbaef53d3fa479",22856815,1,-1,0,151,61,60,-1
"309ccf3cc4fe429d9bfbaef53d3fa479","d646286c8051419bbc2e31dd1db55ca8",22856815,2,10,0,152,60,67,7
"d646286c8051419bbc2e31dd1db55ca8","b534b89233134e30a9b5645138bfa9ee",22856815,2,-33,0,153,67,41,-26
"b534b89233134e30a9b5645138bfa9ee","b534b89233134e30a9b5645138bfa9ee",22856815,1,0,1,154,41,41,0
"b534b89233134e30a9b5645138bfa9ee","d646286c8051419bbc2e31dd1db55ca8",22856815,1,33,0,155,41,67,26
"d646286c8051419bbc2e31dd1db55ca8","67a089198fcb4e1c8f2385786c2b296f",22856815,1,-37,0,156,67,39,-28
"67a089198fcb4e1c8f2385786c2b296f","64d48c6c9c7940639a932219a6c87198",22856815,3,1,0,157,39,40,1
"64d48c6c9c7940639a932219a6c87198","67a089198fcb4e1c8f2385786c2b296f",22856815,3,-1,0,158,40,39,-1
"67a089198fcb4e1c8f2385786c2b296f","fc0e049d56024bc9a02c9a9c435c3df7",22856815,3,-4,0,159,39,38,-1
"fc0e049d56024bc9a02c9a9c435c3df7","fc0e049d56024bc9a02c9a9c435c3df7",22856815,3,0,1,160,38,38,0
"fc0e049d56024bc9a02c9a9c435c3df7","67a089198fcb4e1c8f2385786c2b296f",22856815,2,4,0,163,38,39,1
"fc0e049d56024bc9a02c9a9c435c3df7","64d48c6c9c7940639a932219a6c87198",22856815,2,5,0,165,38,40,2
"64d48c6c9c7940639a932219a6c87198","64d48c6c9c7940639a932219a6c87198",22856815,2,0,1,166,40,40,0
"64d48c6c9c7940639a932219a6c87198","b534b89233134e30a9b5645138bfa9ee",22856815,2,3,0,167,40,41,1
"b534b89233134e30a9b5645138bfa9ee","67a089198fcb4e1c8f2385786c2b296f",22856815,2,-4,0,168,41,39,-2
"67a089198fcb4e1c8f2385786c2b296f","b534b89233134e30a9b5645138bfa9ee",22856815,3,4,0,169,39,41,2
"b534b89233134e30a9b5645138bfa9ee","6e13d61a7bdb44bca949c9f86fab3be5",22856815,2,7,0,170,41,47,6
"6e13d61a7bdb44bca949c9f86fab3be5","d9c8d8c444a64dadbbb508652c721e17",22856815,1,-1,0,171,47,46,-1
"d9c8d8c444a64dadbbb508652c721e17","d0c74f735e024943943e40333d6d337f",22856815,2,6,0,172,46,51,5
"d0c74f735e024943943e40333d6d337f","f924752d8a1149668870b1e7698486f7",22856815,1,-1,0,173,51,50,-1
"f924752d8a1149668870b1e7698486f7","78f30e4dcac84e3cbea8b2cc6e0d62b3",22856815,1,10,0,174,50,59,9
"a1f2f12debe5432fb7a70bcd12bacfb9","12aa6e1672ac4e7aa6449a7a8609cd72",22856815,1,-1,0,176,58,57,-1
"12aa6e1672ac4e7aa6449a7a8609cd72","bc42d26810654ea9a1df1efe1e58c7d5",22856815,1,7,0,177,57,63,6
"bc42d26810654ea9a1df1efe1e58c7d5","a0a418b8540d479fa6e0f653b701da8b",22856815,1,1,0,178,63,64,1
"a0a418b8540d479fa6e0f653b701da8b","309ccf3cc4fe429d9bfbaef53d3fa479",22856815,1,-4,0,179,64,60,-4
"b534b89233134e30a9b5645138bfa9ee","267f883678b24aed855fde42524975d9",22856815,1,37,0,182,41,71,30
"267f883678b24aed855fde42524975d9","267f883678b24aed855fde42524975d9",22856815,1,0,1,183,71,71,0
"267f883678b24aed855fde42524975d9","88fff56d0342490dbef9040750a20f6c",22856815,1,1,0,184,71,72,1
"88fff56d0342490dbef9040750a20f6c","88fff56d0342490dbef9040750a20f6c",22856815,1,0,1,185,72,72,0
"88fff56d0342490dbef9040750a20f6c","adb17b12b66c4a49a85fd34322f7df70",22856815,1,1,0,186,72,73,1
"adb17b12b66c4a49a85fd34322f7df70","adb17b12b66c4a49a85fd34322f7df70",22856815,1,0,1,187,73,73,0
"adb17b12b66c4a49a85fd34322f7df70","d646286c8051419bbc2e31dd1db55ca8",22856815,1,-6,0,188,73,67,-6
"d646286c8051419bbc2e31dd1db55ca8","a2becd407db34b189200a32546d9d569",22856815,2,9,0,189,67,75,8
"a2becd407db34b189200a32546d9d569","140d5b27b8574befad82c0a013b59dfa",22856815,1,-1,0,190,75,74,-1
"140d5b27b8574befad82c0a013b59dfa","d646286c8051419bbc2e31dd1db55ca8",22856815,1,-8,0,191,74,67,-7
"a2becd407db34b189200a32546d9d569","a2becd407db34b189200a32546d9d569",22856815,1,0,1,193,75,75,0
"a2becd407db34b189200a32546d9d569","58c22b011d0f4c2ea6d13615edbb9eeb",22856815,1,2,0,194,75,77,2
"58c22b011d0f4c2ea6d13615edbb9eeb","58c22b011d0f4c2ea6d13615edbb9eeb",22856815,2,0,1,195,77,77,0
"58c22b011d0f4c2ea6d13615edbb9eeb","dd76e1861dc9461c830888729d091ee0",22856815,1,1,0,197,77,78,1
"dd76e1861dc9461c830888729d091ee0","dd76e1861dc9461c830888729d091ee0",22856815,5,0,1,198,78,78,0
"dd76e1861dc9461c830888729d091ee0","cd1d828f1a694b87913a7ea66c23803e",22856815,1,1,0,203,78,79,1
"cd1d828f1a694b87913a7ea66c23803e","cd1d828f1a694b87913a7ea66c23803e",22856815,2,0,1,204,79,79,0
"cd1d828f1a694b87913a7ea66c23803e","9176a3c2b4d2465fa8b0c67096c2a97e",22856815,1,1,0,206,79,80,1
"9176a3c2b4d2465fa8b0c67096c2a97e","9176a3c2b4d2465fa8b0c67096c2a97e",22856815,5,0,1,207,80,80,0
"9176a3c2b4d2465fa8b0c67096c2a97e","f8ec6445f7194e25b9101d4fbcb07a18",22856815,1,1,0,212,80,81,1
"f8ec6445f7194e25b9101d4fbcb07a18","f8ec6445f7194e25b9101d4fbcb07a18",22856815,2,0,1,213,81,81,0
"f8ec6445f7194e25b9101d4fbcb07a18","140d5b27b8574befad82c0a013b59dfa",22856815,1,-7,0,215,81,74,-7
"140d5b27b8574befad82c0a013b59dfa","d18a9ea32855445f8736581f5cb119ce",22856815,1,9,0,216,74,82,8
"d18a9ea32855445f8736581f5cb119ce","f564483cbd7a407681aa2fcca518cf5f",22856815,1,4,0,217,82,85,3
"f564483cbd7a407681aa2fcca518cf5f","f564483cbd7a407681aa2fcca518cf5f",22856815,1,0,1,218,85,85,0
"f564483cbd7a407681aa2fcca518cf5f","18fd01350bd5434ca636d59a599d768a",22856815,1,1,0,219,85,86,1
"18fd01350bd5434ca636d59a599d768a","18fd01350bd5434ca636d59a599d768a",22856815,8,0,1,220,86,86,0
"18fd01350bd5434ca636d59a599d768a","ae5ac430ea254e708a6f5deaaf7464ae",22856815,1,-2,0,228,86,84,-2
"ae5ac430ea254e708a6f5deaaf7464ae","6a9f0ef185fb47f0937e29daa1c71ed5",22856815,1,7,0,229,84,90,6
"6a9f0ef185fb47f0937e29daa1c71ed5","c681290961c94c4caf23b529d1ae6b9a",22856815,1,-2,0,230,90,88,-2
"c681290961c94c4caf23b529d1ae6b9a","c681290961c94c4caf23b529d1ae6b9a",22856815,1,0,1,231,88,88,0
"c681290961c94c4caf23b529d1ae6b9a","6a9f0ef185fb47f0937e29daa1c71ed5",22856815,1,2,0,232,88,90,2
"6a9f0ef185fb47f0937e29daa1c71ed5","6a9f0ef185fb47f0937e29daa1c71ed5",22856815,3,0,1,233,90,90,0
"6a9f0ef185fb47f0937e29daa1c71ed5","d646286c8051419bbc2e31dd1db55ca8",22856815,1,-27,0,236,90,67,-23
"d646286c8051419bbc2e31dd1db55ca8","e20db35ced8544ddac5bc3839145e463",22856815,1,30,0,237,67,91,24
"e20db35ced8544ddac5bc3839145e463","1febb706d7a34005ae8711ed49c76e64",22856815,1,3,0,238,91,94,3
"1febb706d7a34005ae8711ed49c76e64","1febb706d7a34005ae8711ed49c76e64",22856815,2,0,1,239,94,94,0
"1febb706d7a34005ae8711ed49c76e64","8f73ba6f5a0042f2850356ac38ac6f24",22856815,1,1,0,241,94,95,1
"8f73ba6f5a0042f2850356ac38ac6f24","8f73ba6f5a0042f2850356ac38ac6f24",22856815,5,0,1,242,95,95,0
"8f73ba6f5a0042f2850356ac38ac6f24","e2260b86653c46d7b14a41fb419dbf8c",22856815,1,1,0,247,95,96,1
"e2260b86653c46d7b14a41fb419dbf8c","e2260b86653c46d7b14a41fb419dbf8c",22856815,2,0,1,248,96,96,0
"e2260b86653c46d7b14a41fb419dbf8c","35eb641ad1d845bbba54915bce75a962",22856815,1,1,0,250,96,97,1
"35eb641ad1d845bbba54915bce75a962","35eb641ad1d845bbba54915bce75a962",22856815,5,0,1,251,97,97,0
"35eb641ad1d845bbba54915bce75a962","08be90ffbeea4795a138cd42ed8db56f",22856815,1,1,0,256,97,98,1
"08be90ffbeea4795a138cd42ed8db56f","08be90ffbeea4795a138cd42ed8db56f",22856815,3,0,1,257,98,98,0
"08be90ffbeea4795a138cd42ed8db56f","3007433c8f584dcbb5ac159c1c5f2be3",22856815,1,1,0,260,98,99,1
"3007433c8f584dcbb5ac159c1c5f2be3","3007433c8f584dcbb5ac159c1c5f2be3",22856815,3,0,1,261,99,99,0
"3007433c8f584dcbb5ac159c1c5f2be3","00ae5f0c51874a73a41ebea838d95682",22856815,1,3,0,264,99,101,2
"00ae5f0c51874a73a41ebea838d95682","e20db35ced8544ddac5bc3839145e463",22856815,1,-11,0,265,101,91,-10
"e20db35ced8544ddac5bc3839145e463","d391c8b6e56a43a7b654e9dee02d904b",22856815,1,13,0,266,91,103,12
"d391c8b6e56a43a7b654e9dee02d904b","e20db35ced8544ddac5bc3839145e463",22856815,1,-13,0,267,103,91,-12
"e20db35ced8544ddac5bc3839145e463","00ae5f0c51874a73a41ebea838d95682",22856815,1,11,0,268,91,101,10
"00ae5f0c51874a73a41ebea838d95682","d391c8b6e56a43a7b654e9dee02d904b",22856815,2,2,0,269,101,103,2
"d391c8b6e56a43a7b654e9dee02d904b","00ae5f0c51874a73a41ebea838d95682",22856815,1,-2,0,270,103,101,-2
"00ae5f0c51874a73a41ebea838d95682","00ae5f0c51874a73a41ebea838d95682",22856815,1,0,1,271,101,101,0
"d391c8b6e56a43a7b654e9dee02d904b","d391c8b6e56a43a7b654e9dee02d904b",22856815,15,0,1,273,103,103,0
"d391c8b6e56a43a7b654e9dee02d904b","6111116566fc4fd9abba409322bea245",22856815,1,1,0,288,103,104,1
"6111116566fc4fd9abba409322bea245","6111116566fc4fd9abba409322bea245",22856815,2,0,1,289,104,104,0
"6111116566fc4fd9abba409322bea245","a81b2235cb9c499eb9ea8ee0a8dd9725",22856815,1,1,0,291,104,105,1
"a81b2235cb9c499eb9ea8ee0a8dd9725","a81b2235cb9c499eb9ea8ee0a8dd9725",22856815,5,0,1,292,105,105,0
"a81b2235cb9c499eb9ea8ee0a8dd9725","2d4e0ab0ef3b4d73b82c72d4621a7579",22856815,1,1,0,297,105,106,1
"2d4e0ab0ef3b4d73b82c72d4621a7579","2d4e0ab0ef3b4d73b82c72d4621a7579",22856815,2,0,1,298,106,106,0
"2d4e0ab0ef3b4d73b82c72d4621a7579","8bdebf492ebd4e62b0d522e8ab5e5197",22856815,1,1,0,300,106,107,1
"8bdebf492ebd4e62b0d522e8ab5e5197","8bdebf492ebd4e62b0d522e8ab5e5197",22856815,2,0,1,301,107,107,0
"8bdebf492ebd4e62b0d522e8ab5e5197","4280927ec4d643238aa49c32f9e06c6c",22856815,1,3,0,303,107,109,2
"4280927ec4d643238aa49c32f9e06c6c","73039f8c1eb9409cb4caee2cf968001e",22856815,1,-10,0,304,109,100,-9
"73039f8c1eb9409cb4caee2cf968001e","4280927ec4d643238aa49c32f9e06c6c",22856815,1,10,0,305,100,109,9
"4280927ec4d643238aa49c32f9e06c6c","fc44e6a5f7654430af1227838224dceb",22856815,1,2,0,306,109,111,2
"fc44e6a5f7654430af1227838224dceb","fc44e6a5f7654430af1227838224dceb",22856815,5,0,1,307,111,111,0
"fc44e6a5f7654430af1227838224dceb","08111f75e22d409998cf8b85bd431f0a",22856815,1,-3,0,312,111,108,-3
"08111f75e22d409998cf8b85bd431f0a","a9ae0a3c070d455bb4369a8996313336",22856815,1,7,0,313,108,114,6
"a9ae0a3c070d455bb4369a8996313336","a9ae0a3c070d455bb4369a8996313336",22856815,1,0,1,314,114,114,0
"a9ae0a3c070d455bb4369a8996313336","71cec822bcff4f30a20e75dc63ef7b65",22856815,1,2,0,315,114,116,2
"71cec822bcff4f30a20e75dc63ef7b65","71cec822bcff4f30a20e75dc63ef7b65",22856815,1,0,1,316,116,116,0
"71cec822bcff4f30a20e75dc63ef7b65","37319e88176d4aefa91d7a9980dbae91",22856815,1,-4,0,317,116,112,-4
"37319e88176d4aefa91d7a9980dbae91","62bff51286ef4f348717a3cf6fe2318f",22856815,1,9,0,318,112,120,8
"62bff51286ef4f348717a3cf6fe2318f","b1cd0e7dc3ad4a8eb91a4bfdbeb025b0",22856815,1,-2,0,319,120,118,-2
"b1cd0e7dc3ad4a8eb91a4bfdbeb025b0","b1cd0e7dc3ad4a8eb91a4bfdbeb025b0",22856815,1,0,1,320,118,118,0
"b1cd0e7dc3ad4a8eb91a4bfdbeb025b0","62bff51286ef4f348717a3cf6fe2318f",22856815,1,2,0,321,118,120,2
"62bff51286ef4f348717a3cf6fe2318f","62bff51286ef4f348717a3cf6fe2318f",22856815,3,0,1,322,120,120,0
"62bff51286ef4f348717a3cf6fe2318f","e20db35ced8544ddac5bc3839145e463",22856815,1,-33,0,325,120,91,-29
"e20db35ced8544ddac5bc3839145e463","779f9ddd1fd14d1e9e69f72219a1fdbd",22856815,1,36,0,326,91,121,30
"779f9ddd1fd14d1e9e69f72219a1fdbd","ae26e6cda8ad4a3f81bd347560d9579f",22856815,1,4,0,327,121,125,4
"ae26e6cda8ad4a3f81bd347560d9579f","ae26e6cda8ad4a3f81bd347560d9579f",22856815,1,0,1,328,125,125,0
"ae26e6cda8ad4a3f81bd347560d9579f","ee48df95832b4374aa273ceb27ec1315",22856815,1,1,0,329,125,126,1
"ee48df95832b4374aa273ceb27ec1315","ee48df95832b4374aa273ceb27ec1315",22856815,1,0,1,330,126,126,0
"ee48df95832b4374aa273ceb27ec1315","7a439da90b394756ad1777fc4c6dead5",22856815,1,1,0,331,126,127,1
"7a439da90b394756ad1777fc4c6dead5","7a439da90b394756ad1777fc4c6dead5",22856815,1,0,1,332,127,127,0
"7a439da90b394756ad1777fc4c6dead5","a8dd5213034441ac92724b4e83eb0bb2",22856815,1,3,0,333,127,129,2
"a8dd5213034441ac92724b4e83eb0bb2","779f9ddd1fd14d1e9e69f72219a1fdbd",22856815,1,-9,0,334,129,121,-8
"779f9ddd1fd14d1e9e69f72219a1fdbd","a8dd5213034441ac92724b4e83eb0bb2",22856815,1,9,0,335,121,129,8
"a8dd5213034441ac92724b4e83eb0bb2","8115eab6556b45f5b415c3b8c26a12e5",22856815,1,2,0,336,129,131,2
"8115eab6556b45f5b415c3b8c26a12e5","8115eab6556b45f5b415c3b8c26a12e5",22856815,2,0,1,337,131,131,0
"8115eab6556b45f5b415c3b8c26a12e5","ec34b06efd844b46a4c4818ecdb9b8f4",22856815,1,1,0,339,131,132,1
"ec34b06efd844b46a4c4818ecdb9b8f4","ec34b06efd844b46a4c4818ecdb9b8f4",22856815,5,0,1,340,132,132,0
"ec34b06efd844b46a4c4818ecdb9b8f4","c2e1c2b9eac64109b343a088584b576b",22856815,1,1,0,345,132,133,1
"c2e1c2b9eac64109b343a088584b576b","c2e1c2b9eac64109b343a088584b576b",22856815,2,0,1,346,133,133,0
"c2e1c2b9eac64109b343a088584b576b","579338175e0b4bbb8ef3b712b5d8b54e",22856815,1,-5,0,348,133,128,-5
"579338175e0b4bbb8ef3b712b5d8b54e","8bc5795d6a984a3eace4e2811e52dd4f",22856815,1,8,0,349,128,135,7
"8bc5795d6a984a3eace4e2811e52dd4f","8bc5795d6a984a3eace4e2811e52dd4f",22856815,5,0,1,350,135,135,0
"8bc5795d6a984a3eace4e2811e52dd4f","b416d47c56a742199b5d7c7f19d6503a",22856815,1,-1,0,355,135,134,-1
"b416d47c56a742199b5d7c7f19d6503a","779f9ddd1fd14d1e9e69f72219a1fdbd",22856815,1,-15,0,356,134,121,-13
"779f9ddd1fd14d1e9e69f72219a1fdbd","cd4532ad48034873ba8bce2aac0c9808",22856815,1,19,0,357,121,137,16
"cd4532ad48034873ba8bce2aac0c9808","cd4532ad48034873ba8bce2aac0c9808",22856815,1,0,1,358,137,137,0
"cd4532ad48034873ba8bce2aac0c9808","779f9ddd1fd14d1e9e69f72219a1fdbd",22856815,1,-19,0,359,137,121,-16
"779f9ddd1fd14d1e9e69f72219a1fdbd","df1de691dafe4549a18a4398ee9dfaf9",22856815,1,23,0,360,121,139,18
"df1de691dafe4549a18a4398ee9dfaf9","6c5ad271a44743479bfaea29b1db8d02",22856815,1,4,0,361,139,143,4
"6c5ad271a44743479bfaea29b1db8d02","6c5ad271a44743479bfaea29b1db8d02",22856815,2,0,1,362,143,143,0
"6c5ad271a44743479bfaea29b1db8d02","83d311bed5374fee83d8d67a7d9d82dc",22856815,1,1,0,364,143,144,1
"83d311bed5374fee83d8d67a7d9d82dc","83d311bed5374fee83d8d67a7d9d82dc",22856815,1,0,1,365,144,144,0
"83d311bed5374fee83d8d67a7d9d82dc","402bba41861d43acb52a5abb89e8831e",22856815,1,1,0,366,144,145,1
"402bba41861d43acb52a5abb89e8831e","402bba41861d43acb52a5abb89e8831e",22856815,2,0,1,367,145,145,0
"402bba41861d43acb52a5abb89e8831e","df1de691dafe4549a18a4398ee9dfaf9",22856815,1,-6,0,369,145,139,-6
"df1de691dafe4549a18a4398ee9dfaf9","8aae34f5ddbb4052a709b12e6b0d40fa",22856815,1,9,0,370,139,147,8
"8aae34f5ddbb4052a709b12e6b0d40fa","8aae34f5ddbb4052a709b12e6b0d40fa",22856815,1,0,1,371,147,147,0
"8aae34f5ddbb4052a709b12e6b0d40fa","645b3f0249f64f76af2e19eb4d0e55b7",22856815,1,2,0,372,147,149,2
"645b3f0249f64f76af2e19eb4d0e55b7","645b3f0249f64f76af2e19eb4d0e55b7",22856815,2,0,1,373,149,149,0
"645b3f0249f64f76af2e19eb4d0e55b7","7e7b8db5064d4369805ab370aac5ddfb",22856815,1,1,0,375,149,150,1
"7e7b8db5064d4369805ab370aac5ddfb","7e7b8db5064d4369805ab370aac5ddfb",22856815,8,0,1,376,150,150,0
"7e7b8db5064d4369805ab370aac5ddfb","8956d210ae7f41968fada86d4c979d6a",22856815,1,1,0,384,150,151,1
"8956d210ae7f41968fada86d4c979d6a","8956d210ae7f41968fada86d4c979d6a",22856815,2,0,1,385,151,151,0
"8956d210ae7f41968fada86d4c979d6a","f902b0f41b544d4dbf79664fd233648d",22856815,1,-5,0,387,151,146,-5
"f902b0f41b544d4dbf79664fd233648d","ae781e8b775e4ccd93bc800dad5c8376",22856815,1,8,0,388,146,153,7
"ae781e8b775e4ccd93bc800dad5c8376","ae781e8b775e4ccd93bc800dad5c8376",22856815,2,0,1,389,153,153,0
"ae781e8b775e4ccd93bc800dad5c8376","06882a8492d9499aa31555567f575ecb",22856815,1,1,0,391,153,154,1
"06882a8492d9499aa31555567f575ecb","06882a8492d9499aa31555567f575ecb",22856815,1,0,1,392,154,154,0
"06882a8492d9499aa31555567f575ecb","f293c508f409466a8f27ddd7d1e40b20",22856815,1,1,0,393,154,155,1
"f293c508f409466a8f27ddd7d1e40b20","f293c508f409466a8f27ddd7d1e40b20",22856815,8,0,1,394,155,155,0
"f293c508f409466a8f27ddd7d1e40b20","cc4ddef5bbbe48ebb605141b347c4ed1",22856815,1,1,0,402,155,156,1
"cc4ddef5bbbe48ebb605141b347c4ed1","cc4ddef5bbbe48ebb605141b347c4ed1",22856815,3,0,1,403,156,156,0
"cc4ddef5bbbe48ebb605141b347c4ed1","d313cec988a84645bee413e8d4724a4b",22856815,1,3,0,406,156,158,2
"d313cec988a84645bee413e8d4724a4b","f03480cf4eba413194d7af52fc0e7f28",22856815,1,-7,0,407,158,152,-6
"f03480cf4eba413194d7af52fc0e7f28","d313cec988a84645bee413e8d4724a4b",22856815,1,7,0,408,152,158,6
"d313cec988a84645bee413e8d4724a4b","d313cec988a84645bee413e8d4724a4b",22856815,3,0,1,409,158,158,0
"d313cec988a84645bee413e8d4724a4b","dc60696c76a74368a60f72246e47700d",22856815,1,1,0,412,158,159,1
"dc60696c76a74368a60f72246e47700d","dc60696c76a74368a60f72246e47700d",22856815,1,0,1,413,159,159,0
"dc60696c76a74368a60f72246e47700d","df1de691dafe4549a18a4398ee9dfaf9",22856815,1,-23,0,414,159,139,-20
"df1de691dafe4549a18a4398ee9dfaf9","78adeee1fa2c4fe0bc73f7bca9fcee86",22856815,1,26,0,415,139,160,21
"78adeee1fa2c4fe0bc73f7bca9fcee86","65202579580f4ad38d734b4ee39d22a8",22856815,5,5,0,416,160,164,4
"65202579580f4ad38d734b4ee39d22a8","78adeee1fa2c4fe0bc73f7bca9fcee86",22856815,4,-5,0,417,164,160,-4
"65202579580f4ad38d734b4ee39d22a8","65202579580f4ad38d734b4ee39d22a8",22856815,74,0,1,419,164,164,0
"78adeee1fa2c4fe0bc73f7bca9fcee86","3cbcea2be0984e7dbd5a48195af10ce7",22856815,3,8,0,426,160,165,5
"3cbcea2be0984e7dbd5a48195af10ce7","82e6285962b8400d9d6fc32436022a94",22856815,4,2,0,427,165,167,2
"82e6285962b8400d9d6fc32436022a94","3cbcea2be0984e7dbd5a48195af10ce7",22856815,4,-2,0,428,167,165,-2
"3cbcea2be0984e7dbd5a48195af10ce7","78adeee1fa2c4fe0bc73f7bca9fcee86",22856815,3,-8,0,429,165,160,-5
"65202579580f4ad38d734b4ee39d22a8","3cbcea2be0984e7dbd5a48195af10ce7",22856815,1,3,0,438,164,165,1
"78adeee1fa2c4fe0bc73f7bca9fcee86","82e6285962b8400d9d6fc32436022a94",22856815,1,10,0,440,160,167,7
"82e6285962b8400d9d6fc32436022a94","a9ac840f098c4bd0a2ee896214ce29cd",22856815,1,3,0,441,167,168,1
"a9ac840f098c4bd0a2ee896214ce29cd","3cbcea2be0984e7dbd5a48195af10ce7",22856815,2,-5,0,442,168,165,-3
"3cbcea2be0984e7dbd5a48195af10ce7","a9ac840f098c4bd0a2ee896214ce29cd",22856815,3,5,0,443,165,168,3
"a9ac840f098c4bd0a2ee896214ce29cd","0c7262dff33c4087bc660ccf40f92f9c",22856815,3,4,0,444,168,169,1
"0c7262dff33c4087bc660ccf40f92f9c","b2275c3fad834f8d90737a2d9a6927d6",22856815,3,3,0,445,169,172,3
"b2275c3fad834f8d90737a2d9a6927d6","0c7262dff33c4087bc660ccf40f92f9c",22856815,1,-3,0,446,172,169,-3
"b2275c3fad834f8d90737a2d9a6927d6","a9ac840f098c4bd0a2ee896214ce29cd",22856815,1,-7,0,448,172,168,-4
"0c7262dff33c4087bc660ccf40f92f9c","a9ac840f098c4bd0a2ee896214ce29cd",22856815,1,-4,0,450,169,168,-1
"3cbcea2be0984e7dbd5a48195af10ce7","3cbcea2be0984e7dbd5a48195af10ce7",22856815,1,0,1,454,165,165,0
"78adeee1fa2c4fe0bc73f7bca9fcee86","78adeee1fa2c4fe0bc73f7bca9fcee86",22856815,1,0,1,456,160,160,0
"a9ac840f098c4bd0a2ee896214ce29cd","78adeee1fa2c4fe0bc73f7bca9fcee86",22856815,1,-13,0,515,168,160,-8
"a9ac840f098c4bd0a2ee896214ce29cd","a9ac840f098c4bd0a2ee896214ce29cd",22856815,1,0,1,531,168,168,0
"b2275c3fad834f8d90737a2d9a6927d6","b2275c3fad834f8d90737a2d9a6927d6",22856815,34,0,1,534,172,172,0
"b2275c3fad834f8d90737a2d9a6927d6","eb515a26030b41f8a82a1e6114420bad",22856815,1,1,0,568,172,173,1
"eb515a26030b41f8a82a1e6114420bad","eb515a26030b41f8a82a1e6114420bad",22856815,5,0,1,569,173,173,0
"eb515a26030b41f8a82a1e6114420bad","b42cc17b7de840f181a704558d0bc845",22856815,1,3,0,574,173,175,2
"b42cc17b7de840f181a704558d0bc845","0c7262dff33c4087bc660ccf40f92f9c",22856815,1,-7,0,575,175,169,-6
"0c7262dff33c4087bc660ccf40f92f9c","b42cc17b7de840f181a704558d0bc845",22856815,1,7,0,576,169,175,6
"b42cc17b7de840f181a704558d0bc845","801f9e9135034f49bf5f8b4bdefedb41",22856815,1,2,0,577,175,177,2
"801f9e9135034f49bf5f8b4bdefedb41","801f9e9135034f49bf5f8b4bdefedb41",22856815,7,0,1,578,177,177,0
"801f9e9135034f49bf5f8b4bdefedb41","ea38cc0e6e6e41edbabf210220808bf9",22856815,1,3,0,585,177,179,2
"ea38cc0e6e6e41edbabf210220808bf9","362fcb0699a14845ab29b2340093e528",22856815,1,-6,0,586,179,174,-5
"362fcb0699a14845ab29b2340093e528","b87c552dd247427abe6ab5795b9c9d43",22856815,1,8,0,587,174,181,7
"b87c552dd247427abe6ab5795b9c9d43","0c7262dff33c4087bc660ccf40f92f9c",22856815,1,-14,0,588,181,169,-12
"0c7262dff33c4087bc660ccf40f92f9c","ea38cc0e6e6e41edbabf210220808bf9",22856815,1,12,0,589,169,179,10
"ea38cc0e6e6e41edbabf210220808bf9","b87c552dd247427abe6ab5795b9c9d43",22856815,2,2,0,590,179,181,2
"b87c552dd247427abe6ab5795b9c9d43","ea38cc0e6e6e41edbabf210220808bf9",22856815,1,-2,0,591,181,179,-2
"b87c552dd247427abe6ab5795b9c9d43","b87c552dd247427abe6ab5795b9c9d43",22856815,9,0,1,593,181,181,0
"b87c552dd247427abe6ab5795b9c9d43","139b097acfca451689d80c9c6eebdf7b",22856815,1,-3,0,602,181,178,-3
"139b097acfca451689d80c9c6eebdf7b","30f660a1feb34582a739722532524f79",22856815,1,6,0,603,178,183,5
"30f660a1feb34582a739722532524f79","30f660a1feb34582a739722532524f79",22856815,9,0,1,604,183,183,0
"30f660a1feb34582a739722532524f79","2024b4885bd14338a39b7b509acbbd02",22856815,1,-1,0,613,183,182,-1
"2024b4885bd14338a39b7b509acbbd02","c3f63fe50d8e487c86bf8ef76c9cadd3",22856815,1,4,0,614,182,185,3
"c3f63fe50d8e487c86bf8ef76c9cadd3","c3f63fe50d8e487c86bf8ef76c9cadd3",22856815,1,0,1,615,185,185,0
"c3f63fe50d8e487c86bf8ef76c9cadd3","0c7262dff33c4087bc660ccf40f92f9c",22856815,1,-20,0,616,185,169,-16
"0c7262dff33c4087bc660ccf40f92f9c","c8e371568a0c4391b25796ae4e91952e",22856815,1,23,0,617,169,186,17
"c8e371568a0c4391b25796ae4e91952e","7d932b23e1c84326ae5aa4d3c0d813d1",22856815,1,2,0,618,186,188,2
"7d932b23e1c84326ae5aa4d3c0d813d1","7d932b23e1c84326ae5aa4d3c0d813d1",22856815,1,0,1,619,188,188,0
"7d932b23e1c84326ae5aa4d3c0d813d1","ab11d94c6c8948ea90b88f19d2cd502b",22856815,1,3,0,620,188,190,2
"ab11d94c6c8948ea90b88f19d2cd502b","c8e371568a0c4391b25796ae4e91952e",22856815,1,-5,0,621,190,186,-4
"c8e371568a0c4391b25796ae4e91952e","ab11d94c6c8948ea90b88f19d2cd502b",22856815,2,5,0,622,186,190,4
"ab11d94c6c8948ea90b88f19d2cd502b","f992451ed6ad4e68bb9e68ad6be7c4be",22856815,1,2,0,623,190,192,2
"f992451ed6ad4e68bb9e68ad6be7c4be","f992451ed6ad4e68bb9e68ad6be7c4be",22856815,1,0,1,624,192,192,0
"f992451ed6ad4e68bb9e68ad6be7c4be","07b44a7a51e94c78b411c753fc39dab0",22856815,1,-3,0,625,192,189,-3
"07b44a7a51e94c78b411c753fc39dab0","6cd2dcaac46847d4a0bc53f296d90375",22856815,1,6,0,626,189,194,5
"6cd2dcaac46847d4a0bc53f296d90375","6cd2dcaac46847d4a0bc53f296d90375",22856815,1,0,1,627,194,194,0
"6cd2dcaac46847d4a0bc53f296d90375","2d2580c9411c4972909db508d6956a58",22856815,1,2,0,628,194,196,2
"2d2580c9411c4972909db508d6956a58","2d2580c9411c4972909db508d6956a58",22856815,5,0,1,629,196,196,0
"2d2580c9411c4972909db508d6956a58","d5e8e2bd12a2466b9d6d90855f0eb079",22856815,1,2,0,634,196,198,2
"d5e8e2bd12a2466b9d6d90855f0eb079","d5e8e2bd12a2466b9d6d90855f0eb079",22856815,2,0,1,635,198,198,0
"d5e8e2bd12a2466b9d6d90855f0eb079","017d7ca8e0394b91aaadc9574df2202c",22856815,1,-5,0,637,198,193,-5
"017d7ca8e0394b91aaadc9574df2202c","54e8e9f0ea3e45c4bf3b8ac799ee31b1",22856815,1,8,0,638,193,200,7
"54e8e9f0ea3e45c4bf3b8ac799ee31b1","54e8e9f0ea3e45c4bf3b8ac799ee31b1",22856815,1,0,1,639,200,200,0
"54e8e9f0ea3e45c4bf3b8ac799ee31b1","c614a00911be4877a075f19315530fb0",22856815,1,1,0,640,200,201,1
"c614a00911be4877a075f19315530fb0","c614a00911be4877a075f19315530fb0",22856815,13,0,1,641,201,201,0
"c614a00911be4877a075f19315530fb0","bb329d880ab54120adaf203a693bb203",22856815,1,2,0,654,201,203,2
"bb329d880ab54120adaf203a693bb203","bb329d880ab54120adaf203a693bb203",22856815,1,0,1,655,203,203,0
"bb329d880ab54120adaf203a693bb203","f9170dd6bc6442b4acd832747609b09a",22856815,1,-4,0,656,203,199,-4
"f9170dd6bc6442b4acd832747609b09a","b54257a550b94ebc9538f3a90eee9d7e",22856815,1,6,0,657,199,204,5
"b54257a550b94ebc9538f3a90eee9d7e","c8e371568a0c4391b25796ae4e91952e",22856815,1,-22,0,658,204,186,-18
"c8e371568a0c4391b25796ae4e91952e","c8e371568a0c4391b25796ae4e91952e",22856815,1,0,1,659,186,186,0
"ab11d94c6c8948ea90b88f19d2cd502b","6cd2dcaac46847d4a0bc53f296d90375",22856815,1,5,0,661,190,194,4
"6cd2dcaac46847d4a0bc53f296d90375","07b44a7a51e94c78b411c753fc39dab0",22856815,1,-6,0,662,194,189,-5
"07b44a7a51e94c78b411c753fc39dab0","5bddb3d9ed264f3984702f048c7e5340",22856815,1,9,0,663,189,197,8
"5bddb3d9ed264f3984702f048c7e5340","5bddb3d9ed264f3984702f048c7e5340",22856815,2,0,1,664,197,197,0
"5bddb3d9ed264f3984702f048c7e5340","017d7ca8e0394b91aaadc9574df2202c",22856815,1,-4,0,666,197,193,-4
"017d7ca8e0394b91aaadc9574df2202c","a6c21bd8b95249c7972820a7a7d76aff",22856815,1,10,0,667,193,202,9
"a6c21bd8b95249c7972820a7a7d76aff","a6c21bd8b95249c7972820a7a7d76aff",22856815,1,0,1,668,202,202,0
"a6c21bd8b95249c7972820a7a7d76aff","f9170dd6bc6442b4acd832747609b09a",22856815,1,-3,0,669,202,199,-3
"f9170dd6bc6442b4acd832747609b09a","c8e371568a0c4391b25796ae4e91952e",22856815,1,-16,0,670,199,186,-13
"c8e371568a0c4391b25796ae4e91952e","f9170dd6bc6442b4acd832747609b09a",22856815,1,16,0,671,186,199,13
"f9170dd6bc6442b4acd832747609b09a","334c2344009840079b1d0e1b7ce3d5a7",22856815,1,7,0,672,199,205,6
"334c2344009840079b1d0e1b7ce3d5a7","334c2344009840079b1d0e1b7ce3d5a7",22856815,1,0,1,673,205,205,0
"334c2344009840079b1d0e1b7ce3d5a7","d7f13c8d63ec4e2aa673fbb9cf9c6933",22856815,1,3,0,674,205,206,1
"d7f13c8d63ec4e2aa673fbb9cf9c6933","c8e371568a0c4391b25796ae4e91952e",22856815,1,-26,0,675,206,186,-20
"c8e371568a0c4391b25796ae4e91952e","7108f0e4c2584f1f9c471689ae4c885c",22856815,1,28,0,676,186,208,22
"7108f0e4c2584f1f9c471689ae4c885c","b9e80f77c3a44349863b19875725c384",22856815,1,-1,0,677,208,207,-1
"b9e80f77c3a44349863b19875725c384","b9e80f77c3a44349863b19875725c384",22856815,18,0,1,678,207,207,0
"b9e80f77c3a44349863b19875725c384","7108f0e4c2584f1f9c471689ae4c885c",22856815,2,1,0,696,207,208,1
"7108f0e4c2584f1f9c471689ae4c885c","7108f0e4c2584f1f9c471689ae4c885c",22856815,66,0,1,697,208,208,0
"7108f0e4c2584f1f9c471689ae4c885c","09400e101c5d4b439cf9a26b03aae558",22856815,1,3,0,763,208,210,2
"09400e101c5d4b439cf9a26b03aae558","d7f13c8d63ec4e2aa673fbb9cf9c6933",22856815,1,-5,0,764,210,206,-4
"d7f13c8d63ec4e2aa673fbb9cf9c6933","09400e101c5d4b439cf9a26b03aae558",22856815,2,5,0,765,206,210,4
"09400e101c5d4b439cf9a26b03aae558","09400e101c5d4b439cf9a26b03aae558",22856815,1,0,1,766,210,210,0
"09400e101c5d4b439cf9a26b03aae558","a88efa7e50ce47159810ab553afa6d3a",22856815,1,2,0,767,210,212,2
"a88efa7e50ce47159810ab553afa6d3a","a88efa7e50ce47159810ab553afa6d3a",22856815,5,0,1,768,212,212,0
"a88efa7e50ce47159810ab553afa6d3a","a875096404ef4a9984b62d74cda916f9",22856815,1,-3,0,773,212,209,-3
"a875096404ef4a9984b62d74cda916f9","be502a7a43c44bf7b682698de79d9369",22856815,1,6,0,774,209,214,5
"be502a7a43c44bf7b682698de79d9369","be502a7a43c44bf7b682698de79d9369",22856815,1,0,1,777,214,214,0
"f7fb1952f56b4189b86a9f8b7862d2b8","f7fb1952f56b4189b86a9f8b7862d2b8",22856815,11,0,1,779,215,215,0
"f7fb1952f56b4189b86a9f8b7862d2b8","b860ee85d8bc4a2f97958cfb71be3533",22856815,1,1,0,790,215,216,1
"363837c182e04711840d896ae1e0339c","363837c182e04711840d896ae1e0339c",22856815,15,0,1,798,218,218,0
"01b2051f8941460d89945e3b02d1ce78","be95c065e45447c1bd8215ea6f130c7a",22856815,2,3,0,814,217,219,2
"be95c065e45447c1bd8215ea6f130c7a","363837c182e04711840d896ae1e0339c",22856815,2,-2,0,815,219,218,-1
"01b2051f8941460d89945e3b02d1ce78","f7fb1952f56b4189b86a9f8b7862d2b8",22856815,1,-3,0,817,217,215,-2
"be502a7a43c44bf7b682698de79d9369","363837c182e04711840d896ae1e0339c",22856815,1,5,0,819,214,218,4
"363837c182e04711840d896ae1e0339c","ec341f459285443b8361f7f15638ff08",22856815,2,-6,0,820,218,213,-5
"ec341f459285443b8361f7f15638ff08","01b2051f8941460d89945e3b02d1ce78",22856815,2,5,0,821,213,217,4
"01b2051f8941460d89945e3b02d1ce78","be502a7a43c44bf7b682698de79d9369",22856815,1,-4,0,822,217,214,-3
"f7fb1952f56b4189b86a9f8b7862d2b8","ec341f459285443b8361f7f15638ff08",22856815,1,-2,0,824,215,213,-2
"01b2051f8941460d89945e3b02d1ce78","d7f13c8d63ec4e2aa673fbb9cf9c6933",22856815,1,-14,0,830,217,206,-11
"d7f13c8d63ec4e2aa673fbb9cf9c6933","b9e80f77c3a44349863b19875725c384",22856815,1,1,0,831,206,207,1
"7108f0e4c2584f1f9c471689ae4c885c","d7f13c8d63ec4e2aa673fbb9cf9c6933",22856815,1,-2,0,833,208,206,-2
"09400e101c5d4b439cf9a26b03aae558","be502a7a43c44bf7b682698de79d9369",22856815,1,5,0,835,210,214,4
"be502a7a43c44bf7b682698de79d9369","a875096404ef4a9984b62d74cda916f9",22856815,1,-6,0,836,214,209,-5
"a875096404ef4a9984b62d74cda916f9","f7fb1952f56b4189b86a9f8b7862d2b8",22856815,1,7,0,837,209,215,6
"f7fb1952f56b4189b86a9f8b7862d2b8","363837c182e04711840d896ae1e0339c",22856815,1,4,0,838,215,218,3
"01b2051f8941460d89945e3b02d1ce78","91125ca626c5470eb145501f8c37f8db",22856815,1,4,0,841,217,220,3
"91125ca626c5470eb145501f8c37f8db","1c6721b1f63f4d30ba7746ea8af02a52",22856815,1,3,0,843,220,221,1
"77ecef8eff6b4a2caea7707669bf7475","77ecef8eff6b4a2caea7707669bf7475",22856815,13,0,1,846,222,222,0
"77ecef8eff6b4a2caea7707669bf7475","d03cb855c70044cf8c35d9ec0de696e3",22856815,1,3,0,859,222,224,2
"d03cb855c70044cf8c35d9ec0de696e3","1c6721b1f63f4d30ba7746ea8af02a52",22856815,1,-4,0,860,224,221,-3
"8b9ae98743bd4d4a8a87dff1c1244211","1c6721b1f63f4d30ba7746ea8af02a52",22856815,1,-7,0,862,227,221,-6
"1c6721b1f63f4d30ba7746ea8af02a52","d03cb855c70044cf8c35d9ec0de696e3",22856815,2,4,0,863,221,224,3
"d03cb855c70044cf8c35d9ec0de696e3","8b9ae98743bd4d4a8a87dff1c1244211",22856815,2,3,0,864,224,227,3
"d03cb855c70044cf8c35d9ec0de696e3","a49a937d6896486d9a5396654abcf2e1",22856815,1,2,0,866,224,226,2
"a49a937d6896486d9a5396654abcf2e1","a49a937d6896486d9a5396654abcf2e1",22856815,5,0,1,867,226,226,0
"a49a937d6896486d9a5396654abcf2e1","8b9ae98743bd4d4a8a87dff1c1244211",22856815,1,1,0,872,226,227,1
"8b9ae98743bd4d4a8a87dff1c1244211","8b9ae98743bd4d4a8a87dff1c1244211",22856815,93,0,1,873,227,227,0
"8b9ae98743bd4d4a8a87dff1c1244211","f7906d6f59b9489a91d2ef40db5a474d",22856815,1,-4,0,966,227,223,-4
"f7906d6f59b9489a91d2ef40db5a474d","2ab1535aac1346ba8801535bf729ef37",22856815,1,7,0,967,223,229,6
"2ab1535aac1346ba8801535bf729ef37","2ab1535aac1346ba8801535bf729ef37",22856815,1,0,1,968,229,229,0
"2ab1535aac1346ba8801535bf729ef37","a4f40fb48a8542c8949bae1f002cd9bc",22856815,1,2,0,969,229,231,2
"a4f40fb48a8542c8949bae1f002cd9bc","a4f40fb48a8542c8949bae1f002cd9bc",22856815,2,0,1,970,231,231,0
"a4f40fb48a8542c8949bae1f002cd9bc","8972c23e32044edb8a78fa1eed4e5947",22856815,1,1,0,972,231,232,1
"8972c23e32044edb8a78fa1eed4e5947","8972c23e32044edb8a78fa1eed4e5947",22856815,1,0,1,973,232,232,0
"8972c23e32044edb8a78fa1eed4e5947","92feb4a40f8344d38b6f722e42a53295",22856815,1,1,0,974,232,233,1
"92feb4a40f8344d38b6f722e42a53295","92feb4a40f8344d38b6f722e42a53295",22856815,2,0,1,975,233,233,0
"92feb4a40f8344d38b6f722e42a53295","5152833676bf4c6cb317060be10f68db",22856815,1,-5,0,977,233,228,-5
"5152833676bf4c6cb317060be10f68db","ca3e28f290354c08aefe5b0f769604e6",22856815,1,8,0,978,228,235,7
"ca3e28f290354c08aefe5b0f769604e6","ca3e28f290354c08aefe5b0f769604e6",22856815,4,0,1,979,235,235,0
"ca3e28f290354c08aefe5b0f769604e6","79a35eea833e4c2c9d22fc53c3c6445c",22856815,1,1,0,983,235,236,1
"79a35eea833e4c2c9d22fc53c3c6445c","79a35eea833e4c2c9d22fc53c3c6445c",22856815,4,0,1,984,236,236,0
"79a35eea833e4c2c9d22fc53c3c6445c","8f68228b1518449e9615cdafee41a2bd",22856815,1,1,0,988,236,237,1
"8f68228b1518449e9615cdafee41a2bd","8f68228b1518449e9615cdafee41a2bd",22856815,1,0,1,989,237,237,0
"8f68228b1518449e9615cdafee41a2bd","cab89fa5c3ed45a5aa550fc0352d6a42",22856815,1,1,0,990,237,238,1
"cab89fa5c3ed45a5aa550fc0352d6a42","cab89fa5c3ed45a5aa550fc0352d6a42",22856815,5,0,1,991,238,238,0
"cab89fa5c3ed45a5aa550fc0352d6a42","1c6721b1f63f4d30ba7746ea8af02a52",22856815,1,-20,0,996,238,221,-17
"8b9ae98743bd4d4a8a87dff1c1244211","2ab1535aac1346ba8801535bf729ef37",22856815,1,3,0,999,227,229,2
"2ab1535aac1346ba8801535bf729ef37","f7906d6f59b9489a91d2ef40db5a474d",22856815,2,-7,0,1000,229,223,-6
"f7906d6f59b9489a91d2ef40db5a474d","5152833676bf4c6cb317060be10f68db",22856815,2,6,0,1001,223,228,5
"5152833676bf4c6cb317060be10f68db","66d4fad4f1cf4b46be0750a99ad7a35a",22856815,1,12,0,1002,228,239,11
"66d4fad4f1cf4b46be0750a99ad7a35a","66d4fad4f1cf4b46be0750a99ad7a35a",22856815,1,0,1,1003,239,239,0
"66d4fad4f1cf4b46be0750a99ad7a35a","0b04c8e2f86d48c7aeb7e225819cd32b",22856815,1,-5,0,1004,239,234,-5
"0b04c8e2f86d48c7aeb7e225819cd32b","64dbedb3ce544f6aae8e10e0cf10f16d",22856815,2,7,0,1005,234,240,6
"64dbedb3ce544f6aae8e10e0cf10f16d","0b04c8e2f86d48c7aeb7e225819cd32b",22856815,2,-7,0,1006,240,234,-6
"0b04c8e2f86d48c7aeb7e225819cd32b","1c6721b1f63f4d30ba7746ea8af02a52",22856815,1,-16,0,1009,234,221,-13
"1c6721b1f63f4d30ba7746ea8af02a52","8b9ae98743bd4d4a8a87dff1c1244211",22856815,2,7,0,1010,221,227,6
"8b9ae98743bd4d4a8a87dff1c1244211","d03cb855c70044cf8c35d9ec0de696e3",22856815,2,-3,0,1011,227,224,-3
"d03cb855c70044cf8c35d9ec0de696e3","2ab1535aac1346ba8801535bf729ef37",22856815,1,6,0,1012,224,229,5
"5152833676bf4c6cb317060be10f68db","0b04c8e2f86d48c7aeb7e225819cd32b",22856815,1,7,0,1015,228,234,6
"0b04c8e2f86d48c7aeb7e225819cd32b","f53da5fd9bfe412da4b80d4742563b6c",22856815,1,8,0,1016,234,241,7
"f53da5fd9bfe412da4b80d4742563b6c","f53da5fd9bfe412da4b80d4742563b6c",22856815,1,0,1,1017,241,241,0
"f53da5fd9bfe412da4b80d4742563b6c","1c6721b1f63f4d30ba7746ea8af02a52",22856815,1,-24,0,1018,241,221,-20
"1c6721b1f63f4d30ba7746ea8af02a52","2ae94c0cea4d480a9d5dca8fb1d7b542",22856815,1,27,0,1019,221,242,21
"2ae94c0cea4d480a9d5dca8fb1d7b542","1ebf23f9d994469a85206e4c7b1bf5f5",22856815,2,3,0,1020,242,245,3
"1ebf23f9d994469a85206e4c7b1bf5f5","2ae94c0cea4d480a9d5dca8fb1d7b542",22856815,1,-3,0,1021,245,242,-3
"1ebf23f9d994469a85206e4c7b1bf5f5","1ebf23f9d994469a85206e4c7b1bf5f5",22856815,25,0,1,1023,245,245,0
"1ebf23f9d994469a85206e4c7b1bf5f5","85ae675b83e8422da842cfd25596af99",22856815,1,1,0,1048,245,246,1
"85ae675b83e8422da842cfd25596af99","85ae675b83e8422da842cfd25596af99",22856815,3,0,1,1049,246,246,0
"85ae675b83e8422da842cfd25596af99","2ae94c0cea4d480a9d5dca8fb1d7b542",22856815,1,-4,0,1052,246,242,-4
"2ae94c0cea4d480a9d5dca8fb1d7b542","30c9ba177afc49a695625d2bdec40207",22856815,1,9,0,1053,242,250,8
"30c9ba177afc49a695625d2bdec40207","30c9ba177afc49a695625d2bdec40207",22856815,2,0,1,1054,250,250,0
"30c9ba177afc49a695625d2bdec40207","6e83e23f56544a19b94067c1c558d9c0",22856815,1,-3,0,1056,250,247,-3
"6e83e23f56544a19b94067c1c558d9c0","00f61990949545828dd12f1303d47504",22856815,1,11,0,1057,247,256,9
"00f61990949545828dd12f1303d47504","00f61990949545828dd12f1303d47504",22856815,1,0,1,1058,256,256,0
"00f61990949545828dd12f1303d47504","ead7bb4b64e247d2ae632ab8a296b091",22856815,1,2,0,1059,256,258,2
"ead7bb4b64e247d2ae632ab8a296b091","ead7bb4b64e247d2ae632ab8a296b091",22856815,2,0,1,1060,258,258,0
"ead7bb4b64e247d2ae632ab8a296b091","41b0048dde734bb280bac6116baa8e27",22856815,1,1,0,1062,258,259,1
"41b0048dde734bb280bac6116baa8e27","41b0048dde734bb280bac6116baa8e27",22856815,2,0,1,1063,259,259,0
"41b0048dde734bb280bac6116baa8e27","b41c5a094a604ee0915327da5cc0beb7",22856815,1,1,0,1065,259,260,1
"b41c5a094a604ee0915327da5cc0beb7","b41c5a094a604ee0915327da5cc0beb7",22856815,2,0,1,1066,260,260,0
"b41c5a094a604ee0915327da5cc0beb7","d546341988904f069cfa86b21457d9d9",22856815,1,-10,0,1068,260,251,-9
"d546341988904f069cfa86b21457d9d9","28c171777c52431ab6b925073bd63d46",22856815,1,15,0,1069,251,264,13
"28c171777c52431ab6b925073bd63d46","28c171777c52431ab6b925073bd63d46",22856815,7,0,1,1070,264,264,0
"28c171777c52431ab6b925073bd63d46","ac160db940cb49ae8579162b1d52bb5d",22856815,1,2,0,1077,264,266,2
"ac160db940cb49ae8579162b1d52bb5d","ac160db940cb49ae8579162b1d52bb5d",22856815,7,0,1,1078,266,266,0
"ac160db940cb49ae8579162b1d52bb5d","d989ebcfc12a4b669f0100dc1aa14f1e",22856815,1,-12,0,1085,266,255,-11
"d989ebcfc12a4b669f0100dc1aa14f1e","c6fd49b485cc4874b0bbdd9c6171e09c",22856815,1,15,0,1086,255,268,13
"c6fd49b485cc4874b0bbdd9c6171e09c","c6fd49b485cc4874b0bbdd9c6171e09c",22856815,7,0,1,1087,268,268,0
"c6fd49b485cc4874b0bbdd9c6171e09c","44240778a97c4af0937817499b75707b",22856815,1,1,0,1094,268,269,1
"44240778a97c4af0937817499b75707b","44240778a97c4af0937817499b75707b",22856815,2,0,1,1095,269,269,0
"44240778a97c4af0937817499b75707b","7aa76d3e993840d8805f097cbdbcd44b",22856815,1,-9,0,1097,269,261,-8
"7aa76d3e993840d8805f097cbdbcd44b","865a4d3b43374da7944dc7d397f566d9",22856815,1,12,0,1098,261,271,10
"865a4d3b43374da7944dc7d397f566d9","865a4d3b43374da7944dc7d397f566d9",22856815,1,0,1,1099,271,271,0
"865a4d3b43374da7944dc7d397f566d9","0d987bed3ffa4ed0b9a2e62e97b7b30f",22856815,1,3,0,1100,271,272,1
"0d987bed3ffa4ed0b9a2e62e97b7b30f","2ae94c0cea4d480a9d5dca8fb1d7b542",22856815,2,-38,0,1101,272,242,-30
"2ae94c0cea4d480a9d5dca8fb1d7b542","0d987bed3ffa4ed0b9a2e62e97b7b30f",22856815,2,38,0,1102,242,272,30
"0d987bed3ffa4ed0b9a2e62e97b7b30f","0d987bed3ffa4ed0b9a2e62e97b7b30f",22856815,4,0,1,1103,272,272,0
"2ae94c0cea4d480a9d5dca8fb1d7b542","2ae94c0cea4d480a9d5dca8fb1d7b542",22856815,1,0,1,1105,242,242,0
"0d987bed3ffa4ed0b9a2e62e97b7b30f","bb5a47f5ea01454a8b79455422d3b9da",22856815,2,10,0,1110,272,280,8
"bb5a47f5ea01454a8b79455422d3b9da","bb5a47f5ea01454a8b79455422d3b9da",22856815,85,0,1,1111,280,280,0
"bb5a47f5ea01454a8b79455422d3b9da","82ae07bc0c9b4570a41799290d1ef399",22856815,2,-6,0,1117,280,275,-5
"82ae07bc0c9b4570a41799290d1ef399","bb5a47f5ea01454a8b79455422d3b9da",22856815,3,6,0,1118,275,280,5
"bb5a47f5ea01454a8b79455422d3b9da","bc5524e78a8544e2ae2fdc2f3462bbec",22856815,1,-1,0,1124,280,279,-1
"bc5524e78a8544e2ae2fdc2f3462bbec","bb5a47f5ea01454a8b79455422d3b9da",22856815,1,1,0,1125,279,280,1
"bb5a47f5ea01454a8b79455422d3b9da","0d987bed3ffa4ed0b9a2e62e97b7b30f",22856815,2,-10,0,1186,280,272,-8
"0d987bed3ffa4ed0b9a2e62e97b7b30f","94cecc3f1e7d484b8e068e79241dfd73",22856815,1,13,0,1187,272,281,9
"94cecc3f1e7d484b8e068e79241dfd73","a37477c4e4c14169ad44b06b493007f6",22856815,1,2,0,1188,281,283,2
"a37477c4e4c14169ad44b06b493007f6","fab84b4fab5940efb4ea868ef8d09396",22856815,1,3,0,1189,283,284,1
"fab84b4fab5940efb4ea868ef8d09396","94cecc3f1e7d484b8e068e79241dfd73",22856815,1,-5,0,1190,284,281,-3
"94cecc3f1e7d484b8e068e79241dfd73","fab84b4fab5940efb4ea868ef8d09396",22856815,2,5,0,1191,281,284,3
"fab84b4fab5940efb4ea868ef8d09396","4a29443515bb404cb8924e1c60a63b73",22856815,2,4,0,1192,284,285,1
"4a29443515bb404cb8924e1c60a63b73","208c9b2796c944db8dacaa96082520ea",22856815,4,3,0,1193,285,288,3
"208c9b2796c944db8dacaa96082520ea","4a29443515bb404cb8924e1c60a63b73",22856815,4,-3,0,1194,288,285,-3
"208c9b2796c944db8dacaa96082520ea","208c9b2796c944db8dacaa96082520ea",22856815,1,0,1,1196,288,288,0
"208c9b2796c944db8dacaa96082520ea","6a9a3b5bde4a48daa896fe8c06eca56f",22856815,1,2,0,1199,288,289,1
"6a9a3b5bde4a48daa896fe8c06eca56f","4a29443515bb404cb8924e1c60a63b73",22856815,1,-5,0,1200,289,285,-4
"4a29443515bb404cb8924e1c60a63b73","7669a956527947d0add87455277e80b4",22856815,1,7,0,1201,285,291,6
"7669a956527947d0add87455277e80b4","7669a956527947d0add87455277e80b4",22856815,1,0,1,1202,291,291,0
"7669a956527947d0add87455277e80b4","6a9a3b5bde4a48daa896fe8c06eca56f",22856815,1,-2,0,1203,291,289,-2
"6a9a3b5bde4a48daa896fe8c06eca56f","869e967078f04da18dd0b0b9389a7424",22856815,1,5,0,1204,289,293,4
"869e967078f04da18dd0b0b9389a7424","869e967078f04da18dd0b0b9389a7424",22856815,1,0,1,1205,293,293,0
"869e967078f04da18dd0b0b9389a7424","51ab6291537748fab90d519aa09889d6",22856815,1,2,0,1206,293,295,2
"51ab6291537748fab90d519aa09889d6","51ab6291537748fab90d519aa09889d6",22856815,5,0,1,1207,295,295,0
"51ab6291537748fab90d519aa09889d6","34a6e49023fc4465bd5ca604330bbd1c",22856815,1,-3,0,1212,295,292,-3
"34a6e49023fc4465bd5ca604330bbd1c","21592f2a9e9c4b2f8c66ec5dbcbf6a2b",22856815,3,5,0,1213,292,296,4
"21592f2a9e9c4b2f8c66ec5dbcbf6a2b","ba0e59461bfb4a44b7b1c28a01f8d3b3",22856815,3,4,0,1214,296,299,3
"ba0e59461bfb4a44b7b1c28a01f8d3b3","ba0e59461bfb4a44b7b1c28a01f8d3b3",22856815,1,0,1,1215,299,299,0
"ba0e59461bfb4a44b7b1c28a01f8d3b3","0e0b36e731a645e7b1b8a88f5031ca38",22856815,1,2,0,1216,299,301,2
"0e0b36e731a645e7b1b8a88f5031ca38","0e0b36e731a645e7b1b8a88f5031ca38",22856815,2,0,1,1217,301,301,0
"0e0b36e731a645e7b1b8a88f5031ca38","a66a144637284c21afc6de17fea4bfb8",22856815,1,1,0,1219,301,302,1
"a66a144637284c21afc6de17fea4bfb8","a66a144637284c21afc6de17fea4bfb8",22856815,2,0,1,1220,302,302,0
"a66a144637284c21afc6de17fea4bfb8","7646a919d7e64fa990bca9b024ff089d",22856815,1,-4,0,1222,302,298,-4
"7646a919d7e64fa990bca9b024ff089d","4a29443515bb404cb8924e1c60a63b73",22856815,1,-17,0,1223,298,285,-13
"4a29443515bb404cb8924e1c60a63b73","869e967078f04da18dd0b0b9389a7424",22856815,2,10,0,1226,285,293,8
"869e967078f04da18dd0b0b9389a7424","6a9a3b5bde4a48daa896fe8c06eca56f",22856815,2,-5,0,1227,293,289,-4
"6a9a3b5bde4a48daa896fe8c06eca56f","34a6e49023fc4465bd5ca604330bbd1c",22856815,2,4,0,1228,289,292,3
"ba0e59461bfb4a44b7b1c28a01f8d3b3","7646a919d7e64fa990bca9b024ff089d",22856815,2,-1,0,1231,299,298,-1
"7646a919d7e64fa990bca9b024ff089d","e390b575229748ea8aac9364efe2bf00",22856815,1,7,0,1232,298,304,6
"e390b575229748ea8aac9364efe2bf00","e390b575229748ea8aac9364efe2bf00",22856815,1,0,1,1233,304,304,0
"e390b575229748ea8aac9364efe2bf00","3434c10e561d488a914e0f7d71907abd",22856815,1,3,0,1234,304,305,1
"3434c10e561d488a914e0f7d71907abd","4a29443515bb404cb8924e1c60a63b73",22856815,2,-27,0,1235,305,285,-20
"4a29443515bb404cb8924e1c60a63b73","53e7e900392747ccad52e711ab0f80d8",22856815,2,29,0,1236,285,307,22
"53e7e900392747ccad52e711ab0f80d8","0d987bed3ffa4ed0b9a2e62e97b7b30f",22856815,1,-51,0,1237,307,272,-35
"bb5a47f5ea01454a8b79455422d3b9da","94cecc3f1e7d484b8e068e79241dfd73",22856815,1,3,0,1246,280,281,1
"94cecc3f1e7d484b8e068e79241dfd73","0d987bed3ffa4ed0b9a2e62e97b7b30f",22856815,1,-13,0,1247,281,272,-9
"0d987bed3ffa4ed0b9a2e62e97b7b30f","a37477c4e4c14169ad44b06b493007f6",22856815,1,15,0,1248,272,283,11
"a37477c4e4c14169ad44b06b493007f6","94cecc3f1e7d484b8e068e79241dfd73",22856815,1,-2,0,1249,283,281,-2
"4a29443515bb404cb8924e1c60a63b73","fab84b4fab5940efb4ea868ef8d09396",22856815,1,-4,0,1252,285,284,-1
"fab84b4fab5940efb4ea868ef8d09396","208c9b2796c944db8dacaa96082520ea",22856815,1,7,0,1253,284,288,4
"7646a919d7e64fa990bca9b024ff089d","3434c10e561d488a914e0f7d71907abd",22856815,1,10,0,1261,298,305,7
"53e7e900392747ccad52e711ab0f80d8","53e7e900392747ccad52e711ab0f80d8",22856815,1,0,1,1264,307,307,0
"53e7e900392747ccad52e711ab0f80d8","3434c10e561d488a914e0f7d71907abd",22856815,1,-2,0,1265,307,305,-2
"3434c10e561d488a914e0f7d71907abd","130acc2aeb0448fdbb2de63bc5cebe5b",22856815,1,5,0,1266,305,309,4
"130acc2aeb0448fdbb2de63bc5cebe5b","130acc2aeb0448fdbb2de63bc5cebe5b",22856815,1,0,1,1267,309,309,0
"130acc2aeb0448fdbb2de63bc5cebe5b","9c062b3251034ebe90f5054e2a3b5120",22856815,1,2,0,1268,309,311,2
"9c062b3251034ebe90f5054e2a3b5120","9c062b3251034ebe90f5054e2a3b5120",22856815,2,0,1,1269,311,311,0
"9c062b3251034ebe90f5054e2a3b5120","ea859f8207e44537889daeaba13ac2e8",22856815,1,1,0,1271,311,312,1
"ea859f8207e44537889daeaba13ac2e8","ea859f8207e44537889daeaba13ac2e8",22856815,3,0,1,1272,312,312,0
"ea859f8207e44537889daeaba13ac2e8","56d94971a7a94257aa330183a8ebd0ea",22856815,1,1,0,1274,312,313,1
"56d94971a7a94257aa330183a8ebd0ea","56d94971a7a94257aa330183a8ebd0ea",22856815,1,0,1,1275,313,313,0
"56d94971a7a94257aa330183a8ebd0ea","ea859f8207e44537889daeaba13ac2e8",22856815,1,-1,0,1276,313,312,-1
"ea859f8207e44537889daeaba13ac2e8","141c0df6cd1946539aadd1c9b7068cd4",22856815,1,-4,0,1278,312,308,-4
"141c0df6cd1946539aadd1c9b7068cd4","13255e63e0aa4abf85e5211bf613d43e",22856815,1,10,0,1279,308,317,9
"13255e63e0aa4abf85e5211bf613d43e","13255e63e0aa4abf85e5211bf613d43e",22856815,1,0,1,1280,317,317,0
"13255e63e0aa4abf85e5211bf613d43e","86c27d40179e419c8e9d150fb6afa5d0",22856815,1,3,0,1281,317,319,2
"86c27d40179e419c8e9d150fb6afa5d0","0c787d16c9504873b1a4d903cec09948",22856815,1,-6,0,1282,319,314,-5
"0c787d16c9504873b1a4d903cec09948","3434c10e561d488a914e0f7d71907abd",22856815,1,-11,0,1283,314,305,-9
"3434c10e561d488a914e0f7d71907abd","86c27d40179e419c8e9d150fb6afa5d0",22856815,3,17,0,1284,305,319,14
"86c27d40179e419c8e9d150fb6afa5d0","86c27d40179e419c8e9d150fb6afa5d0",22856815,1,0,1,1285,319,319,0
"86c27d40179e419c8e9d150fb6afa5d0","47edbb64109243e6b0f8f64cdef90c6c",22856815,2,8,0,1286,319,326,7
"47edbb64109243e6b0f8f64cdef90c6c","24f1363179ad4aaa965484a78471912b",22856815,2,-3,0,1287,326,323,-3
"24f1363179ad4aaa965484a78471912b","8d7e0b55cf9849cda222a0f2440cec55",22856815,1,-6,0,1288,323,318,-5
"8d7e0b55cf9849cda222a0f2440cec55","24f1363179ad4aaa965484a78471912b",22856815,2,6,0,1289,318,323,5
"24f1363179ad4aaa965484a78471912b","3434c10e561d488a914e0f7d71907abd",22856815,1,-22,0,1290,323,305,-18
"47edbb64109243e6b0f8f64cdef90c6c","8d7e0b55cf9849cda222a0f2440cec55",22856815,1,-9,0,1293,326,318,-8
"24f1363179ad4aaa965484a78471912b","3628bdce1dd2429ba924d2d4d09448d2",22856815,2,-1,0,1295,323,322,-1
"3628bdce1dd2429ba924d2d4d09448d2","3434c10e561d488a914e0f7d71907abd",22856815,1,-21,0,1296,322,305,-17
"86c27d40179e419c8e9d150fb6afa5d0","8d7e0b55cf9849cda222a0f2440cec55",22856815,1,-1,0,1298,319,318,-1
"8d7e0b55cf9849cda222a0f2440cec55","47edbb64109243e6b0f8f64cdef90c6c",22856815,1,9,0,1299,318,326,8
"3628bdce1dd2429ba924d2d4d09448d2","56b3fd1a212a4764be39d979fde3326e",22856815,1,7,0,1302,322,328,6
"56b3fd1a212a4764be39d979fde3326e","56b3fd1a212a4764be39d979fde3326e",22856815,1,0,1,1303,328,328,0
"56b3fd1a212a4764be39d979fde3326e","3434c10e561d488a914e0f7d71907abd",22856815,1,-28,0,1304,328,305,-23
"3434c10e561d488a914e0f7d71907abd","0c4079457ede49e3aeb5e86ed84bdf35",22856815,1,31,0,1305,305,329,24
"0c4079457ede49e3aeb5e86ed84bdf35","38aea304b4fa46e1b29bb72f5cea4c93",22856815,3,2,0,1306,329,331,2
"38aea304b4fa46e1b29bb72f5cea4c93","38aea304b4fa46e1b29bb72f5cea4c93",22856815,1,0,1,1307,331,331,0
"38aea304b4fa46e1b29bb72f5cea4c93","e36d261332f14e79bb4b467aceaeb9b5",22856815,1,2,0,1308,331,333,2
"e36d261332f14e79bb4b467aceaeb9b5","e36d261332f14e79bb4b467aceaeb9b5",22856815,1,0,1,1309,333,333,0
"e36d261332f14e79bb4b467aceaeb9b5","c7e89b9d04744d2eab742fc24e3ef1ae",22856815,1,1,0,1310,333,334,1
"c7e89b9d04744d2eab742fc24e3ef1ae","c7e89b9d04744d2eab742fc24e3ef1ae",22856815,2,0,1,1311,334,334,0
"c7e89b9d04744d2eab742fc24e3ef1ae","fe49f8054b374a0ea4bb266ed135ff62",22856815,1,1,0,1313,334,335,1
"fe49f8054b374a0ea4bb266ed135ff62","fe49f8054b374a0ea4bb266ed135ff62",22856815,2,0,1,1314,335,335,0
"fe49f8054b374a0ea4bb266ed135ff62","d0a8f74af98642fe8360d22c42e45117",22856815,1,1,0,1316,335,336,1
"d0a8f74af98642fe8360d22c42e45117","d0a8f74af98642fe8360d22c42e45117",22856815,2,0,1,1317,336,336,0
"d0a8f74af98642fe8360d22c42e45117","0c4079457ede49e3aeb5e86ed84bdf35",22856815,1,-7,0,1319,336,329,-7
"0c4079457ede49e3aeb5e86ed84bdf35","a7c6339ca1da4368a18d471f0519f877",22856815,1,11,0,1320,329,339,10
"a7c6339ca1da4368a18d471f0519f877","a7c6339ca1da4368a18d471f0519f877",22856815,1,0,1,1321,339,339,0
"a7c6339ca1da4368a18d471f0519f877","bbc5139ca9024389a94db3a6f47dcff6",22856815,1,3,0,1322,339,341,2
"bbc5139ca9024389a94db3a6f47dcff6","b8b9418ab322418d9db9b40d96af873a",22856815,3,-5,0,1323,341,337,-4
"b8b9418ab322418d9db9b40d96af873a","bbc5139ca9024389a94db3a6f47dcff6",22856815,1,5,0,1324,337,341,4
"bbc5139ca9024389a94db3a6f47dcff6","bbc5139ca9024389a94db3a6f47dcff6",22856815,4,0,1,1325,341,341,0
"bbc5139ca9024389a94db3a6f47dcff6","4ee6ca9019ab4a1ab323f98094a9bd77",22856815,1,2,0,1329,341,343,2
"4ee6ca9019ab4a1ab323f98094a9bd77","4ee6ca9019ab4a1ab323f98094a9bd77",22856815,2,0,1,1330,343,343,0
"4ee6ca9019ab4a1ab323f98094a9bd77","b37947176785476f8b29d49a851366dc",22856815,1,1,0,1332,343,344,1
"b37947176785476f8b29d49a851366dc","b37947176785476f8b29d49a851366dc",22856815,2,0,1,1333,344,344,0
"b37947176785476f8b29d49a851366dc","fcea5b10d5a14a3b9324ffece8f6e1e5",22856815,1,1,0,1335,344,345,1
"fcea5b10d5a14a3b9324ffece8f6e1e5","fcea5b10d5a14a3b9324ffece8f6e1e5",22856815,8,0,1,1336,345,345,0
"fcea5b10d5a14a3b9324ffece8f6e1e5","c2490bc612d146edbe786556fab3651b",22856815,1,-5,0,1344,345,340,-5
"c2490bc612d146edbe786556fab3651b","0c4079457ede49e3aeb5e86ed84bdf35",22856815,2,-13,0,1345,340,329,-11
"38aea304b4fa46e1b29bb72f5cea4c93","0c4079457ede49e3aeb5e86ed84bdf35",22856815,2,-2,0,1347,331,329,-2
"0c4079457ede49e3aeb5e86ed84bdf35","bbc5139ca9024389a94db3a6f47dcff6",22856815,2,14,0,1348,329,341,12
"b8b9418ab322418d9db9b40d96af873a","c2490bc612d146edbe786556fab3651b",22856815,2,4,0,1350,337,340,3
"c2490bc612d146edbe786556fab3651b","bbc5139ca9024389a94db3a6f47dcff6",22856815,2,1,0,1351,340,341,1
"bbc5139ca9024389a94db3a6f47dcff6","4a92daef4d504e1792575a26502bb7b7",22856815,2,6,0,1352,341,346,5
"4a92daef4d504e1792575a26502bb7b7","c2490bc612d146edbe786556fab3651b",22856815,2,-7,0,1353,346,340,-6
"c2490bc612d146edbe786556fab3651b","6ac8bb048b854999a47edb35fe627f11",22856815,1,8,0,1363,340,347,7
"6ac8bb048b854999a47edb35fe627f11","6ac8bb048b854999a47edb35fe627f11",22856815,1,0,1,1364,347,347,0
"6ac8bb048b854999a47edb35fe627f11","30ead9794d4847abaf222ca966cc8630",22856815,1,3,0,1365,347,348,1
"30ead9794d4847abaf222ca966cc8630","0c4079457ede49e3aeb5e86ed84bdf35",22856815,1,-24,0,1366,348,329,-19
"0c4079457ede49e3aeb5e86ed84bdf35","09b9678ddc3d452ea4a3d46e15826065",22856815,1,29,0,1367,329,353,24
"09b9678ddc3d452ea4a3d46e15826065","c20993c944444fe085345591a8bd837e",22856815,1,-2,0,1368,353,351,-2
"c20993c944444fe085345591a8bd837e","897b7f51242c44aab2205c72fdcbf4cd",22856815,2,1,0,1369,351,352,1
"897b7f51242c44aab2205c72fdcbf4cd","eff0de7f2dbb42dfa1a2e686efab5b6d",22856815,2,2,0,1370,352,354,2
"eff0de7f2dbb42dfa1a2e686efab5b6d","30ead9794d4847abaf222ca966cc8630",22856815,2,-6,0,1371,354,348,-6
"30ead9794d4847abaf222ca966cc8630","c20993c944444fe085345591a8bd837e",22856815,1,3,0,1372,348,351,3
"c20993c944444fe085345591a8bd837e","09b9678ddc3d452ea4a3d46e15826065",22856815,1,2,0,1373,351,353,2
"09b9678ddc3d452ea4a3d46e15826065","897b7f51242c44aab2205c72fdcbf4cd",22856815,1,-1,0,1374,353,352,-1
"eff0de7f2dbb42dfa1a2e686efab5b6d","c20993c944444fe085345591a8bd837e",22856815,1,-3,0,1376,354,351,-3
"c20993c944444fe085345591a8bd837e","c20993c944444fe085345591a8bd837e",22856815,3,0,1,1377,351,351,0
"897b7f51242c44aab2205c72fdcbf4cd","897b7f51242c44aab2205c72fdcbf4cd",22856815,3,0,1,1381,352,352,0
"897b7f51242c44aab2205c72fdcbf4cd","09b9678ddc3d452ea4a3d46e15826065",22856815,1,1,0,1384,352,353,1
"09b9678ddc3d452ea4a3d46e15826065","09b9678ddc3d452ea4a3d46e15826065",22856815,3,0,1,1385,353,353,0
"09b9678ddc3d452ea4a3d46e15826065","eff0de7f2dbb42dfa1a2e686efab5b6d",22856815,1,1,0,1388,353,354,1
"eff0de7f2dbb42dfa1a2e686efab5b6d","eff0de7f2dbb42dfa1a2e686efab5b6d",22856815,3,0,1,1389,354,354,0
"30ead9794d4847abaf222ca966cc8630","2fe14166dc9642c3bc666b86a57f943d",22856815,1,10,0,1393,348,357,9
"2fe14166dc9642c3bc666b86a57f943d","2fe14166dc9642c3bc666b86a57f943d",22856815,1,0,1,1394,357,357,0
"2fe14166dc9642c3bc666b86a57f943d","44421dd1e13a47a388c4a19834b744c7",22856815,1,2,0,1395,357,359,2
"44421dd1e13a47a388c4a19834b744c7","44421dd1e13a47a388c4a19834b744c7",22856815,2,0,1,1396,359,359,0
"44421dd1e13a47a388c4a19834b744c7","cb5fc7ef85d547c4be1a7439d0bf6052",22856815,1,1,0,1398,359,360,1
"cb5fc7ef85d547c4be1a7439d0bf6052","cb5fc7ef85d547c4be1a7439d0bf6052",22856815,5,0,1,1399,360,360,0
"cb5fc7ef85d547c4be1a7439d0bf6052","0a8f150a4cf747acbde62f4721823da3",22856815,1,1,0,1404,360,361,1
"0a8f150a4cf747acbde62f4721823da3","0a8f150a4cf747acbde62f4721823da3",22856815,2,0,1,1405,361,361,0
"0a8f150a4cf747acbde62f4721823da3","ab8fdad974ae471f9f24c3f9dd04462e",22856815,1,1,0,1407,361,362,1
"ab8fdad974ae471f9f24c3f9dd04462e","ab8fdad974ae471f9f24c3f9dd04462e",22856815,2,0,1,1408,362,362,0
"ab8fdad974ae471f9f24c3f9dd04462e","52580888dadb4fe3baa795683ea227bd",22856815,1,3,0,1410,362,364,2
"52580888dadb4fe3baa795683ea227bd","1ba8fef685d74a8194b9db252eb704fb",22856815,1,-10,0,1411,364,355,-9
"1ba8fef685d74a8194b9db252eb704fb","52580888dadb4fe3baa795683ea227bd",22856815,1,10,0,1412,355,364,9
"52580888dadb4fe3baa795683ea227bd","f00179e251a045b39c3f7a54f9aa4acc",22856815,1,-1,0,1413,364,363,-1
"f00179e251a045b39c3f7a54f9aa4acc","492a3bc6a1254f23a7998587961b22a4",22856815,1,4,0,1414,363,366,3
"492a3bc6a1254f23a7998587961b22a4","30ead9794d4847abaf222ca966cc8630",22856815,1,-21,0,1415,366,348,-18
"30ead9794d4847abaf222ca966cc8630","492a3bc6a1254f23a7998587961b22a4",22856815,1,21,0,1416,348,366,18
"492a3bc6a1254f23a7998587961b22a4","492a3bc6a1254f23a7998587961b22a4",22856815,1,0,1,1417,366,366,0
"492a3bc6a1254f23a7998587961b22a4","072a190fd302456290895f9f04d6940a",22856815,1,-1,0,1418,366,365,-1
"072a190fd302456290895f9f04d6940a","492a3bc6a1254f23a7998587961b22a4",22856815,1,1,0,1419,365,366,1
"492a3bc6a1254f23a7998587961b22a4","c76574d21bc14aeea7ecd0b027f39858",22856815,1,2,0,1420,366,367,1
"c76574d21bc14aeea7ecd0b027f39858","072a190fd302456290895f9f04d6940a",22856815,1,-3,0,1421,367,365,-2
"072a190fd302456290895f9f04d6940a","52580888dadb4fe3baa795683ea227bd",22856815,1,-2,0,1422,365,364,-1
"52580888dadb4fe3baa795683ea227bd","492a3bc6a1254f23a7998587961b22a4",22856815,1,3,0,1423,364,366,2
"492a3bc6a1254f23a7998587961b22a4","f00179e251a045b39c3f7a54f9aa4acc",22856815,1,-4,0,1424,366,363,-3
"f00179e251a045b39c3f7a54f9aa4acc","072a190fd302456290895f9f04d6940a",22856815,1,3,0,1425,363,365,2
"072a190fd302456290895f9f04d6940a","b71bac264efb4abd97015447bd490db6",22856815,1,8,0,1426,365,370,5
"b71bac264efb4abd97015447bd490db6","30ead9794d4847abaf222ca966cc8630",22856815,2,-28,0,1427,370,348,-22
"30ead9794d4847abaf222ca966cc8630","30ead9794d4847abaf222ca966cc8630",22856815,2,0,1,1428,348,348,0
"30ead9794d4847abaf222ca966cc8630","b71bac264efb4abd97015447bd490db6",22856815,2,28,0,1429,348,370,22
"b71bac264efb4abd97015447bd490db6","8d448d625b024c82a5eb240bbd7431d6",22856815,4,5,0,1432,370,374,4
"8d448d625b024c82a5eb240bbd7431d6","8d448d625b024c82a5eb240bbd7431d6",22856815,64,0,1,1433,374,374,0
"8d448d625b024c82a5eb240bbd7431d6","b71bac264efb4abd97015447bd490db6",22856815,3,-5,0,1436,374,370,-4
"8d448d625b024c82a5eb240bbd7431d6","1b4550d0dab04078b3bf08a655345bdc",22856815,1,-1,0,1441,374,373,-1
"1b4550d0dab04078b3bf08a655345bdc","8d448d625b024c82a5eb240bbd7431d6",22856815,1,1,0,1442,373,374,1
"b71bac264efb4abd97015447bd490db6","d6d02b6ef04e4f17805504500b8ce441",22856815,2,8,0,1495,370,375,5
"d6d02b6ef04e4f17805504500b8ce441","d6d02b6ef04e4f17805504500b8ce441",22856815,5,0,1,1496,375,375,0
"d6d02b6ef04e4f17805504500b8ce441","66baf19b6b904b70922329068c63746d",22856815,2,4,0,1498,375,376,1
"66baf19b6b904b70922329068c63746d","7f544639412e40a9ba27f43b415362ab",22856815,4,2,0,1499,376,378,2
"7f544639412e40a9ba27f43b415362ab","7f544639412e40a9ba27f43b415362ab",22856815,1,0,1,1500,378,378,0
"7f544639412e40a9ba27f43b415362ab","d5ae8642e15b46b8bd298b02274d4e9c",22856815,1,2,0,1501,378,380,2
"d5ae8642e15b46b8bd298b02274d4e9c","d5ae8642e15b46b8bd298b02274d4e9c",22856815,1,0,1,1502,380,380,0
"d5ae8642e15b46b8bd298b02274d4e9c","a0d10309a2dd456289147f84be9d37f9",22856815,1,1,0,1503,380,381,1
"a0d10309a2dd456289147f84be9d37f9","a0d10309a2dd456289147f84be9d37f9",22856815,2,0,1,1504,381,381,0
"a0d10309a2dd456289147f84be9d37f9","0fcbc3ca07b144138b8d85da581f09a8",22856815,1,1,0,1506,381,382,1
"0fcbc3ca07b144138b8d85da581f09a8","0fcbc3ca07b144138b8d85da581f09a8",22856815,8,0,1,1507,382,382,0
"0fcbc3ca07b144138b8d85da581f09a8","66baf19b6b904b70922329068c63746d",22856815,1,-6,0,1515,382,376,-6
"66baf19b6b904b70922329068c63746d","b71bac264efb4abd97015447bd490db6",22856815,1,-12,0,1516,376,370,-6
"8d448d625b024c82a5eb240bbd7431d6","d6d02b6ef04e4f17805504500b8ce441",22856815,1,3,0,1527,374,375,1
"d6d02b6ef04e4f17805504500b8ce441","b71bac264efb4abd97015447bd490db6",22856815,1,-8,0,1528,375,370,-5
"7f544639412e40a9ba27f43b415362ab","66baf19b6b904b70922329068c63746d",22856815,3,-2,0,1533,378,376,-2
"66baf19b6b904b70922329068c63746d","c2fca3669923477ab966ded303dea31c",22856815,1,8,0,1534,376,383,7
"c2fca3669923477ab966ded303dea31c","4890121ce5d74576b4632b77cfc23398",22856815,1,6,0,1535,383,388,5
"4890121ce5d74576b4632b77cfc23398","4890121ce5d74576b4632b77cfc23398",22856815,1,0,1,1536,388,388,0
"4890121ce5d74576b4632b77cfc23398","18d3b836dd804224883cc9180b60a8e1",22856815,1,-1,0,1537,388,387,-1
"18d3b836dd804224883cc9180b60a8e1","96bb2b3e85a34d8b9544514e89f6fe97",22856815,2,4,0,1538,387,390,3
"96bb2b3e85a34d8b9544514e89f6fe97","96bb2b3e85a34d8b9544514e89f6fe97",22856815,1,0,1,1539,390,390,0
"96bb2b3e85a34d8b9544514e89f6fe97","ac4e9b54acfe4670b4634859c7263cb5",22856815,1,2,0,1540,390,392,2
"ac4e9b54acfe4670b4634859c7263cb5","ac4e9b54acfe4670b4634859c7263cb5",22856815,1,0,1,1541,392,392,0
"ac4e9b54acfe4670b4634859c7263cb5","6f8881a745ac4c358a68b92c3b4abe81",22856815,1,3,0,1542,392,394,2
"6f8881a745ac4c358a68b92c3b4abe81","17f95d18bab743888e1736033dc3384d",22856815,1,-6,0,1543,394,389,-5
"17f95d18bab743888e1736033dc3384d","6f8881a745ac4c358a68b92c3b4abe81",22856815,2,6,0,1544,389,394,5
"6f8881a745ac4c358a68b92c3b4abe81","f7002c8484354eceac57bc7bd62c76c1",22856815,2,-1,0,1545,394,393,-1
"f7002c8484354eceac57bc7bd62c76c1","66baf19b6b904b70922329068c63746d",22856815,1,-21,0,1546,393,376,-17
"66baf19b6b904b70922329068c63746d","4890121ce5d74576b4632b77cfc23398",22856815,1,14,0,1549,376,388,12
"4890121ce5d74576b4632b77cfc23398","c2fca3669923477ab966ded303dea31c",22856815,1,-6,0,1550,388,383,-5
"c2fca3669923477ab966ded303dea31c","18d3b836dd804224883cc9180b60a8e1",22856815,1,5,0,1551,383,387,4
"96bb2b3e85a34d8b9544514e89f6fe97","17f95d18bab743888e1736033dc3384d",22856815,1,-1,0,1553,390,389,-1
"f7002c8484354eceac57bc7bd62c76c1","44a277ea44dc4ae689fab4b82f0b4098",22856815,1,5,0,1556,393,397,4
"44a277ea44dc4ae689fab4b82f0b4098","44a277ea44dc4ae689fab4b82f0b4098",22856815,1,0,1,1557,397,397,0
"44a277ea44dc4ae689fab4b82f0b4098","0c12af0a4e7f4002852cf84b2537c161",22856815,1,-2,0,1558,397,395,-2
"0c12af0a4e7f4002852cf84b2537c161","66baf19b6b904b70922329068c63746d",22856815,1,-24,0,1559,395,376,-19
"66baf19b6b904b70922329068c63746d","859e0b8d71694b12befb69ee698138f9",22856815,1,29,0,1562,376,399,23
"859e0b8d71694b12befb69ee698138f9","859e0b8d71694b12befb69ee698138f9",22856815,1,0,1,1563,399,399,0
"859e0b8d71694b12befb69ee698138f9","66baf19b6b904b70922329068c63746d",22856815,1,-29,0,1564,399,376,-23
"66baf19b6b904b70922329068c63746d","2b09a08242b54983aec7063990fb3f66",22856815,1,32,0,1565,376,400,24
"2b09a08242b54983aec7063990fb3f66","2b09a08242b54983aec7063990fb3f66",22856815,3,0,1,1566,400,400,0
"2b09a08242b54983aec7063990fb3f66","1f471b7a883a4df48211e8c6a81b59a7",22856815,1,1,0,1568,400,401,1
"1f471b7a883a4df48211e8c6a81b59a7","1f471b7a883a4df48211e8c6a81b59a7",22856815,1,0,1,1569,401,401,0
"1f471b7a883a4df48211e8c6a81b59a7","2b09a08242b54983aec7063990fb3f66",22856815,1,-1,0,1570,401,400,-1
"2b09a08242b54983aec7063990fb3f66","9de0d567bfa84fe5b77cb76f4a76a5d1",22856815,1,5,0,1572,400,404,4
"9de0d567bfa84fe5b77cb76f4a76a5d1","9de0d567bfa84fe5b77cb76f4a76a5d1",22856815,3,0,1,1573,404,404,0
"9de0d567bfa84fe5b77cb76f4a76a5d1","1157bd665ec4472fb58b751dc5099355",22856815,2,-1,0,1574,404,403,-1
"1157bd665ec4472fb58b751dc5099355","3c8a22d2f9c146ea956609e3ed4f2559",22856815,4,3,0,1575,403,405,2
"3c8a22d2f9c146ea956609e3ed4f2559","58fc9094275e4c49be3f4ba6d4acc0a4",22856815,3,2,0,1576,405,406,1
"58fc9094275e4c49be3f4ba6d4acc0a4","58fc9094275e4c49be3f4ba6d4acc0a4",22856815,2,0,1,1577,406,406,0
"58fc9094275e4c49be3f4ba6d4acc0a4","c1c1be90b2b14c1ab4a5e1ee3c241902",22856815,2,1,0,1578,406,407,1
"c1c1be90b2b14c1ab4a5e1ee3c241902","c1c1be90b2b14c1ab4a5e1ee3c241902",22856815,11,0,1,1579,407,407,0
"c1c1be90b2b14c1ab4a5e1ee3c241902","58fc9094275e4c49be3f4ba6d4acc0a4",22856815,1,-1,0,1584,407,406,-1
"58fc9094275e4c49be3f4ba6d4acc0a4","02b3a1bead9244c1ba2f857c7da8f82a",22856815,5,3,0,1585,406,408,2
"02b3a1bead9244c1ba2f857c7da8f82a","02b3a1bead9244c1ba2f857c7da8f82a",22856815,1,0,1,1586,408,408,0
"02b3a1bead9244c1ba2f857c7da8f82a","6206fc6479014bb193084c32409dc1b9",22856815,2,1,0,1587,408,409,1
"6206fc6479014bb193084c32409dc1b9","6206fc6479014bb193084c32409dc1b9",22856815,6,0,1,1588,409,409,0
"6206fc6479014bb193084c32409dc1b9","02b3a1bead9244c1ba2f857c7da8f82a",22856815,2,-1,0,1592,409,408,-1
"02b3a1bead9244c1ba2f857c7da8f82a","6a5f020451db426dacba9e2ea3fcc62a",22856815,3,3,0,1593,408,410,2
"6a5f020451db426dacba9e2ea3fcc62a","6a5f020451db426dacba9e2ea3fcc62a",22856815,2,0,1,1594,410,410,0
"6a5f020451db426dacba9e2ea3fcc62a","33a9d248b2e44588a5b07fc1342b9bc2",22856815,5,2,0,1595,410,411,1
"33a9d248b2e44588a5b07fc1342b9bc2","6a5f020451db426dacba9e2ea3fcc62a",22856815,2,-2,0,1596,411,410,-1
"33a9d248b2e44588a5b07fc1342b9bc2","c6f26bd420634f1cb7989e76fe6b16c0",22856815,2,1,0,1598,411,412,1
"c6f26bd420634f1cb7989e76fe6b16c0","c6f26bd420634f1cb7989e76fe6b16c0",22856815,5,0,1,1599,412,412,0
"c6f26bd420634f1cb7989e76fe6b16c0","2a65ee6e2ac64f6a8a55fbe5373ec763",22856815,2,1,0,1604,412,413,1
"2a65ee6e2ac64f6a8a55fbe5373ec763","2a65ee6e2ac64f6a8a55fbe5373ec763",22856815,4,0,1,1605,413,413,0
"2a65ee6e2ac64f6a8a55fbe5373ec763","33a9d248b2e44588a5b07fc1342b9bc2",22856815,2,-2,0,1607,413,411,-2
"33a9d248b2e44588a5b07fc1342b9bc2","687055dad9fc40c3982478fe33ec01bf",22856815,1,4,0,1608,411,414,3
"687055dad9fc40c3982478fe33ec01bf","2b09a08242b54983aec7063990fb3f66",22856815,2,-21,0,1609,414,400,-14
"2b09a08242b54983aec7063990fb3f66","1157bd665ec4472fb58b751dc5099355",22856815,2,4,0,1610,400,403,3
"3c8a22d2f9c146ea956609e3ed4f2559","9de0d567bfa84fe5b77cb76f4a76a5d1",22856815,1,-2,0,1612,405,404,-1
"02b3a1bead9244c1ba2f857c7da8f82a","58fc9094275e4c49be3f4ba6d4acc0a4",22856815,3,-3,0,1624,408,406,-2
"c1c1be90b2b14c1ab4a5e1ee3c241902","02b3a1bead9244c1ba2f857c7da8f82a",22856815,1,2,0,1632,407,408,1
"33a9d248b2e44588a5b07fc1342b9bc2","1fd0f6dadbc14ebc965faf6122190b96",22856815,1,5,0,1643,411,415,4
"1fd0f6dadbc14ebc965faf6122190b96","1fd0f6dadbc14ebc965faf6122190b96",22856815,2,0,1,1644,415,415,0
"1fd0f6dadbc14ebc965faf6122190b96","687055dad9fc40c3982478fe33ec01bf",22856815,1,-1,0,1646,415,414,-1
"33a9d248b2e44588a5b07fc1342b9bc2","2add1669f08d4101913db15f8c23b3b7",22856815,1,7,0,1658,411,416,5
"2add1669f08d4101913db15f8c23b3b7","2add1669f08d4101913db15f8c23b3b7",22856815,2,0,1,1659,416,416,0
"2add1669f08d4101913db15f8c23b3b7","2b09a08242b54983aec7063990fb3f66",22856815,1,-24,0,1661,416,400,-16
"2b09a08242b54983aec7063990fb3f66","a2b4bd40cee2481ebd3fc179d6a5cd62",22856815,1,27,0,1662,400,417,17
"a2b4bd40cee2481ebd3fc179d6a5cd62","e34e59dce2204f228f3a84b6725df60f",22856815,1,2,0,1663,417,419,2
"e34e59dce2204f228f3a84b6725df60f","e34e59dce2204f228f3a84b6725df60f",22856815,2,0,1,1664,419,419,0
"e34e59dce2204f228f3a84b6725df60f","a2b4bd40cee2481ebd3fc179d6a5cd62",22856815,1,-2,0,1666,419,417,-2
"a2b4bd40cee2481ebd3fc179d6a5cd62","bec48fc2e1294c7eb3d0aca780d731b8",22856815,1,4,0,1667,417,420,3
"bec48fc2e1294c7eb3d0aca780d731b8","bec48fc2e1294c7eb3d0aca780d731b8",22856815,2,0,1,1668,420,420,0
"bec48fc2e1294c7eb3d0aca780d731b8","dbde19fcce2a4c1abdc7f685c293a23f",22856815,1,3,0,1670,420,422,2
"dbde19fcce2a4c1abdc7f685c293a23f","a24600b0e49245f6bdba8c893cfeddb0",22856815,1,4,0,1671,422,425,3
"a24600b0e49245f6bdba8c893cfeddb0","a24600b0e49245f6bdba8c893cfeddb0",22856815,2,0,1,1672,425,425,0
"a24600b0e49245f6bdba8c893cfeddb0","a2b4bd40cee2481ebd3fc179d6a5cd62",22856815,1,-11,0,1674,425,417,-8
"a2b4bd40cee2481ebd3fc179d6a5cd62","24cf8786024543f19b89bc20034e60d7",22856815,1,18,0,1675,417,428,11
"24cf8786024543f19b89bc20034e60d7","f2a73be2f46840b182d7bd095378004e",22856815,1,1,0,1676,428,429,1
"f2a73be2f46840b182d7bd095378004e","f2a73be2f46840b182d7bd095378004e",22856815,1,0,1,1677,429,429,0
"f2a73be2f46840b182d7bd095378004e","604551fd4266430cb860fef58fa7dd61",22856815,1,1,0,1678,429,430,1
"604551fd4266430cb860fef58fa7dd61","604551fd4266430cb860fef58fa7dd61",22856815,8,0,1,1679,430,430,0
"604551fd4266430cb860fef58fa7dd61","24cf8786024543f19b89bc20034e60d7",22856815,1,-2,0,1687,430,428,-2
"24cf8786024543f19b89bc20034e60d7","dce46f8904594a62a6377a3587aaa663",22856815,3,4,0,1688,428,431,3
"dce46f8904594a62a6377a3587aaa663","dce46f8904594a62a6377a3587aaa663",22856815,2,0,1,1689,431,431,0
"dce46f8904594a62a6377a3587aaa663","061c175cc90f45fbad883025394e78dd",22856815,1,2,0,1690,431,433,2
"061c175cc90f45fbad883025394e78dd","061c175cc90f45fbad883025394e78dd",22856815,3,0,1,1691,433,433,0
"061c175cc90f45fbad883025394e78dd","24cf8786024543f19b89bc20034e60d7",22856815,1,-6,0,1692,433,428,-5
"dce46f8904594a62a6377a3587aaa663","9b9d0a249052413c869753b99682b0ac",22856815,1,1,0,1694,431,432,1
"9b9d0a249052413c869753b99682b0ac","9b9d0a249052413c869753b99682b0ac",22856815,4,0,1,1695,432,432,0
"9b9d0a249052413c869753b99682b0ac","061c175cc90f45fbad883025394e78dd",22856815,2,1,0,1696,432,433,1
"061c175cc90f45fbad883025394e78dd","9b9d0a249052413c869753b99682b0ac",22856815,2,-1,0,1699,433,432,-1
"9b9d0a249052413c869753b99682b0ac","dce46f8904594a62a6377a3587aaa663",22856815,1,-1,0,1705,432,431,-1
"dce46f8904594a62a6377a3587aaa663","74a7f8712e5449c2bc0b43c6f90dafed",22856815,1,5,0,1706,431,435,4
"74a7f8712e5449c2bc0b43c6f90dafed","74a7f8712e5449c2bc0b43c6f90dafed",22856815,2,0,1,1707,435,435,0
"74a7f8712e5449c2bc0b43c6f90dafed","66ada10dde9f43018588f1ced9d477fc",22856815,1,-1,0,1709,435,434,-1
"66ada10dde9f43018588f1ced9d477fc","24cf8786024543f19b89bc20034e60d7",22856815,1,-8,0,1710,434,428,-6
"dce46f8904594a62a6377a3587aaa663","66ada10dde9f43018588f1ced9d477fc",22856815,1,4,0,1713,431,434,3
"66ada10dde9f43018588f1ced9d477fc","bf12c96466d840a69bed7020b3f18bb8",22856815,1,3,0,1714,434,436,2
"bf12c96466d840a69bed7020b3f18bb8","bf12c96466d840a69bed7020b3f18bb8",22856815,4,0,1,1715,436,436,0
"bf12c96466d840a69bed7020b3f18bb8","070600601c4c439288445d2f0724807d",22856815,1,3,0,1719,436,437,1
"070600601c4c439288445d2f0724807d","24cf8786024543f19b89bc20034e60d7",22856815,1,-14,0,1720,437,428,-9
"24cf8786024543f19b89bc20034e60d7","1823b6de7d334a7aaabc4570719af4d9",22856815,1,16,0,1721,428,439,11
"1823b6de7d334a7aaabc4570719af4d9","070600601c4c439288445d2f0724807d",22856815,1,-2,0,1722,439,437,-2
"070600601c4c439288445d2f0724807d","1823b6de7d334a7aaabc4570719af4d9",22856815,1,2,0,1723,437,439,2
"1823b6de7d334a7aaabc4570719af4d9","1823b6de7d334a7aaabc4570719af4d9",22856815,13,0,1,1724,439,439,0
"1823b6de7d334a7aaabc4570719af4d9","0380cd76a7d44bc3a4da1f15e4d68f89",22856815,1,2,0,1737,439,440,1
"0380cd76a7d44bc3a4da1f15e4d68f89","070600601c4c439288445d2f0724807d",22856815,1,-4,0,1738,440,437,-3
"070600601c4c439288445d2f0724807d","0380cd76a7d44bc3a4da1f15e4d68f89",22856815,1,4,0,1739,437,440,3
"0380cd76a7d44bc3a4da1f15e4d68f89","0380cd76a7d44bc3a4da1f15e4d68f89",22856815,1,0,1,1740,440,440,0
"0380cd76a7d44bc3a4da1f15e4d68f89","23b7673c8b5443108c2ef09382834a86",22856815,1,2,0,1741,440,441,1
"23b7673c8b5443108c2ef09382834a86","23b7673c8b5443108c2ef09382834a86",22856815,1,0,1,1742,441,441,0
"23b7673c8b5443108c2ef09382834a86","901e92500aea43c79f19f1b279050668",22856815,2,2,0,1743,441,442,1
"901e92500aea43c79f19f1b279050668","23b7673c8b5443108c2ef09382834a86",22856815,1,-2,0,1744,442,441,-1
"901e92500aea43c79f19f1b279050668","001339db8ced4cf78829ebe8b145449d",22856815,1,1,0,1746,442,443,1
"001339db8ced4cf78829ebe8b145449d","001339db8ced4cf78829ebe8b145449d",22856815,10,0,1,1747,443,443,0
"001339db8ced4cf78829ebe8b145449d","452745e0366e42ae81561bfddebcc6c3",22856815,1,1,0,1752,443,444,1
"452745e0366e42ae81561bfddebcc6c3","452745e0366e42ae81561bfddebcc6c3",22856815,2,0,1,1753,444,444,0
"452745e0366e42ae81561bfddebcc6c3","001339db8ced4cf78829ebe8b145449d",22856815,1,-1,0,1755,444,443,-1
"001339db8ced4cf78829ebe8b145449d","4660ff2089114e8db82ceb26a4f329e3",22856815,1,3,0,1761,443,445,2
"4660ff2089114e8db82ceb26a4f329e3","901e92500aea43c79f19f1b279050668",22856815,1,-4,0,1762,445,442,-3
"901e92500aea43c79f19f1b279050668","4660ff2089114e8db82ceb26a4f329e3",22856815,1,4,0,1763,442,445,3
"4660ff2089114e8db82ceb26a4f329e3","4660ff2089114e8db82ceb26a4f329e3",22856815,1,0,1,1764,445,445,0
"4660ff2089114e8db82ceb26a4f329e3","7bd5586eb9d8484eb74a433ee7bfe499",22856815,1,2,0,1765,445,446,1
"7bd5586eb9d8484eb74a433ee7bfe499","7bd5586eb9d8484eb74a433ee7bfe499",22856815,14,0,1,1766,446,446,0
"7bd5586eb9d8484eb74a433ee7bfe499","8a7f26e690f34dda97be16904518ca99",22856815,1,2,0,1780,446,447,1
"8a7f26e690f34dda97be16904518ca99","8a7f26e690f34dda97be16904518ca99",22856815,4,0,1,1781,447,447,0
"8a7f26e690f34dda97be16904518ca99","070600601c4c439288445d2f0724807d",22856815,1,-16,0,1785,447,437,-10
"070600601c4c439288445d2f0724807d","b2f0d654738f48158edff28e8d3a546e",22856815,1,21,0,1786,437,449,12
"b2f0d654738f48158edff28e8d3a546e","f60ee41ec635499abd48168342d32c2f",22856815,2,5,0,1787,449,453,4
"f60ee41ec635499abd48168342d32c2f","b2f0d654738f48158edff28e8d3a546e",22856815,1,-5,0,1788,453,449,-4
"f60ee41ec635499abd48168342d32c2f","f60ee41ec635499abd48168342d32c2f",22856815,49,0,1,1790,453,453,0
"f60ee41ec635499abd48168342d32c2f","f67fbf45a5f146ed866965bc57c7c001",22856815,1,3,0,1839,453,454,1
"f67fbf45a5f146ed866965bc57c7c001","b2f0d654738f48158edff28e8d3a546e",22856815,1,-8,0,1840,454,449,-5
"b2f0d654738f48158edff28e8d3a546e","f67fbf45a5f146ed866965bc57c7c001",22856815,1,8,0,1841,449,454,5
"f67fbf45a5f146ed866965bc57c7c001","f67fbf45a5f146ed866965bc57c7c001",22856815,1,0,1,1842,454,454,0
"f67fbf45a5f146ed866965bc57c7c001","d937afe49bd24a07a550dda1c1155122",22856815,1,1,0,1843,454,455,1
"d937afe49bd24a07a550dda1c1155122","d937afe49bd24a07a550dda1c1155122",22856815,1,0,1,1844,455,455,0
"d937afe49bd24a07a550dda1c1155122","3628b3f7823443d0912a339096b69943",22856815,1,1,0,1845,455,456,1
"3628b3f7823443d0912a339096b69943","3628b3f7823443d0912a339096b69943",22856815,1,0,1,1846,456,456,0
"3628b3f7823443d0912a339096b69943","9e049ee647cf43ecbcb5ed792a8e7588",22856815,1,1,0,1847,456,457,1
"9e049ee647cf43ecbcb5ed792a8e7588","9e049ee647cf43ecbcb5ed792a8e7588",22856815,1,0,1,1848,457,457,0
"9e049ee647cf43ecbcb5ed792a8e7588","5256a214faaf410b93f76cea06428334",22856815,1,1,0,1849,457,458,1
"5256a214faaf410b93f76cea06428334","5256a214faaf410b93f76cea06428334",22856815,1,0,1,1850,458,458,0
"5256a214faaf410b93f76cea06428334","25c32b120fce40fa9b6c85133aeb4716",22856815,1,1,0,1851,458,459,1
"25c32b120fce40fa9b6c85133aeb4716","25c32b120fce40fa9b6c85133aeb4716",22856815,1,0,1,1852,459,459,0
"25c32b120fce40fa9b6c85133aeb4716","42de338840a34d15adb66e7b14fb9d2c",22856815,1,2,0,1853,459,461,2
"42de338840a34d15adb66e7b14fb9d2c","42de338840a34d15adb66e7b14fb9d2c",22856815,1,0,1,1854,461,461,0
"42de338840a34d15adb66e7b14fb9d2c","9da37c6210b1416b8079c274f70bf600",22856815,1,1,0,1855,461,462,1
"9da37c6210b1416b8079c274f70bf600","9da37c6210b1416b8079c274f70bf600",22856815,1,0,1,1856,462,462,0
"9da37c6210b1416b8079c274f70bf600","519119f1deac45ff9ab4f13529be5c6e",22856815,1,1,0,1857,462,463,1
"519119f1deac45ff9ab4f13529be5c6e","519119f1deac45ff9ab4f13529be5c6e",22856815,1,0,1,1858,463,463,0
"519119f1deac45ff9ab4f13529be5c6e","11bc14f2204949008b7d511b933363c1",22856815,1,-3,0,1859,463,460,-3
"11bc14f2204949008b7d511b933363c1","11bc14f2204949008b7d511b933363c1",22856815,6,0,1,1860,460,460,0
"11bc14f2204949008b7d511b933363c1","c5df9f40ec14463b9dcfdc73df3e9285",22856815,1,6,0,1866,460,464,4
"c5df9f40ec14463b9dcfdc73df3e9285","f67fbf45a5f146ed866965bc57c7c001",22856815,1,-12,0,1867,464,454,-10
"f67fbf45a5f146ed866965bc57c7c001","c5df9f40ec14463b9dcfdc73df3e9285",22856815,1,12,0,1868,454,464,10
"c5df9f40ec14463b9dcfdc73df3e9285","c5df9f40ec14463b9dcfdc73df3e9285",22856815,11,0,1,1869,464,464,0
"c5df9f40ec14463b9dcfdc73df3e9285","83d42d95cd844fc093fc09cee250edb8",22856815,2,3,0,1872,464,465,1
"83d42d95cd844fc093fc09cee250edb8","83d42d95cd844fc093fc09cee250edb8",22856815,12,0,1,1873,465,465,0
"83d42d95cd844fc093fc09cee250edb8","d7f13c8d63ec4e2aa673fbb9cf9c6933",22856815,1,-365,0,1879,465,206,-259
"d7f13c8d63ec4e2aa673fbb9cf9c6933","ec341f459285443b8361f7f15638ff08",22856815,1,9,0,1880,206,213,7
"ec341f459285443b8361f7f15638ff08","be502a7a43c44bf7b682698de79d9369",22856815,1,1,0,1881,213,214,1
"be502a7a43c44bf7b682698de79d9369","f7fb1952f56b4189b86a9f8b7862d2b8",22856815,5,1,0,1882,214,215,1
"f7fb1952f56b4189b86a9f8b7862d2b8","be502a7a43c44bf7b682698de79d9369",22856815,3,-1,0,1883,215,214,-1
"be502a7a43c44bf7b682698de79d9369","b860ee85d8bc4a2f97958cfb71be3533",22856815,1,2,0,1884,214,216,2
"b860ee85d8bc4a2f97958cfb71be3533","b860ee85d8bc4a2f97958cfb71be3533",22856815,8,0,1,1885,216,216,0
"b860ee85d8bc4a2f97958cfb71be3533","ec341f459285443b8361f7f15638ff08",22856815,2,-3,0,1888,216,213,-3
"ec341f459285443b8361f7f15638ff08","363837c182e04711840d896ae1e0339c",22856815,3,6,0,1889,213,218,5
"363837c182e04711840d896ae1e0339c","01b2051f8941460d89945e3b02d1ce78",22856815,5,-1,0,1890,218,217,-1
"01b2051f8941460d89945e3b02d1ce78","1c6721b1f63f4d30ba7746ea8af02a52",22856815,1,7,0,1891,217,221,4
"1c6721b1f63f4d30ba7746ea8af02a52","d7f13c8d63ec4e2aa673fbb9cf9c6933",22856815,2,-21,0,1892,221,206,-15
"d7f13c8d63ec4e2aa673fbb9cf9c6933","77ecef8eff6b4a2caea7707669bf7475",22856815,2,22,0,1893,206,222,16
"77ecef8eff6b4a2caea7707669bf7475","d7f13c8d63ec4e2aa673fbb9cf9c6933",22856815,1,-22,0,1894,222,206,-16
"d7f13c8d63ec4e2aa673fbb9cf9c6933","1c6721b1f63f4d30ba7746ea8af02a52",22856815,1,21,0,1895,206,221,15
"1c6721b1f63f4d30ba7746ea8af02a52","91125ca626c5470eb145501f8c37f8db",22856815,1,-3,0,1896,221,220,-1
"91125ca626c5470eb145501f8c37f8db","91125ca626c5470eb145501f8c37f8db",22856815,3,0,1,1897,220,220,0
"91125ca626c5470eb145501f8c37f8db","d7f13c8d63ec4e2aa673fbb9cf9c6933",22856815,1,-18,0,1899,220,206,-14
"d7f13c8d63ec4e2aa673fbb9cf9c6933","be502a7a43c44bf7b682698de79d9369",22856815,1,10,0,1900,206,214,8
"f7fb1952f56b4189b86a9f8b7862d2b8","82ae07bc0c9b4570a41799290d1ef399",22856815,1,79,0,1902,215,275,60
"82ae07bc0c9b4570a41799290d1ef399","0d987bed3ffa4ed0b9a2e62e97b7b30f",22856815,1,-4,0,1903,275,272,-3
"0d987bed3ffa4ed0b9a2e62e97b7b30f","82ae07bc0c9b4570a41799290d1ef399",22856815,1,4,0,1904,272,275,3
"0d987bed3ffa4ed0b9a2e62e97b7b30f","c76574d21bc14aeea7ecd0b027f39858",22856815,1,127,0,1916,272,367,95
"c76574d21bc14aeea7ecd0b027f39858","30ead9794d4847abaf222ca966cc8630",22856815,1,-23,0,1917,367,348,-19
"30ead9794d4847abaf222ca966cc8630","cfa457d1743848e4bb5e4beced6448ed",22856815,1,25,0,1918,348,369,21
"cfa457d1743848e4bb5e4beced6448ed","cfa457d1743848e4bb5e4beced6448ed",22856815,4,0,1,1919,369,369,0
"cfa457d1743848e4bb5e4beced6448ed","d6d02b6ef04e4f17805504500b8ce441",22856815,1,11,0,1923,369,375,6
"d6d02b6ef04e4f17805504500b8ce441","30ead9794d4847abaf222ca966cc8630",22856815,1,-36,0,1926,375,348,-27
"30ead9794d4847abaf222ca966cc8630","c5df9f40ec14463b9dcfdc73df3e9285",22856815,1,172,0,1927,348,464,116
"c5df9f40ec14463b9dcfdc73df3e9285","30ead9794d4847abaf222ca966cc8630",22856815,1,-172,0,1933,464,348,-116
"30ead9794d4847abaf222ca966cc8630","afbf7250b99d47bea07172749483ca97",22856815,1,-436,0,1935,348,28,-320
"afbf7250b99d47bea07172749483ca97","afbf7250b99d47bea07172749483ca97",22856815,3,0,1,1936,28,28,0
"afbf7250b99d47bea07172749483ca97","4e51676dc72045d99c19b9fa7b22f8bc",22856815,2,3,0,1938,28,29,1
"4e51676dc72045d99c19b9fa7b22f8bc","4e51676dc72045d99c19b9fa7b22f8bc",22856815,1,0,1,1939,29,29,0
"4e51676dc72045d99c19b9fa7b22f8bc","51970cfa30e643e894e66ae85c8024cc",22856815,2,3,0,1940,29,31,2
"51970cfa30e643e894e66ae85c8024cc","4e51676dc72045d99c19b9fa7b22f8bc",22856815,1,-3,0,1941,31,29,-2
"4e51676dc72045d99c19b9fa7b22f8bc","c33c17be71ae4d588da7369472e5bb1b",22856815,1,9,0,1942,29,34,5
"c33c17be71ae4d588da7369472e5bb1b","93679be414554a11b1893002f2229a93",22856815,1,3,0,1943,34,35,1
"93679be414554a11b1893002f2229a93","c33c17be71ae4d588da7369472e5bb1b",22856815,1,-3,0,1944,35,34,-1
"c33c17be71ae4d588da7369472e5bb1b","7040a13096d746ac84b8fac8d9752058",22856815,1,6,0,1945,34,36,2
"7040a13096d746ac84b8fac8d9752058","93679be414554a11b1893002f2229a93",22856815,1,-3,0,1946,36,35,-1
"93679be414554a11b1893002f2229a93","7040a13096d746ac84b8fac8d9752058",22856815,1,3,0,1947,35,36,1
"7040a13096d746ac84b8fac8d9752058","9a0dc646f934470daf08c4b56ccf73db",22856815,1,3,0,1948,36,37,1
"9a0dc646f934470daf08c4b56ccf73db","9a0dc646f934470daf08c4b56ccf73db",22856815,1,0,1,1949,37,37,0
"9a0dc646f934470daf08c4b56ccf73db","fc0e049d56024bc9a02c9a9c435c3df7",22856815,1,3,0,1950,37,38,1
"67a089198fcb4e1c8f2385786c2b296f","67a089198fcb4e1c8f2385786c2b296f",22856815,1,0,1,1956,39,39,0
"b534b89233134e30a9b5645138bfa9ee","b7719e26494940efa49512aedd0aac79",22856815,1,-44,0,1960,41,20,-21
"b7719e26494940efa49512aedd0aac79","a49d1bb4328949299686242fd0be5584",22856815,2,2,0,1961,20,21,1
"a49d1bb4328949299686242fd0be5584","afbf7250b99d47bea07172749483ca97",22856815,1,10,0,1962,21,28,7
"afbf7250b99d47bea07172749483ca97","b7719e26494940efa49512aedd0aac79",22856815,2,-12,0,1963,28,20,-8
"b7719e26494940efa49512aedd0aac79","4e51676dc72045d99c19b9fa7b22f8bc",22856815,1,15,0,1964,20,29,9
"4e51676dc72045d99c19b9fa7b22f8bc","afbf7250b99d47bea07172749483ca97",22856815,1,-3,0,1965,29,28,-1
"51970cfa30e643e894e66ae85c8024cc","a49d1bb4328949299686242fd0be5584",22856815,1,-16,0,1968,31,21,-10
"a49d1bb4328949299686242fd0be5584","b7719e26494940efa49512aedd0aac79",22856815,1,-2,0,1969,21,20,-1
"b7719e26494940efa49512aedd0aac79","b7719e26494940efa49512aedd0aac79",22856815,3,0,1,1970,20,20,0
"b7719e26494940efa49512aedd0aac79","afbf7250b99d47bea07172749483ca97",22856815,1,12,0,1971,20,28,8
"b7719e26494940efa49512aedd0aac79","d4f45188d3c84a02ba08454e6403a818",22856815,2,5,0,1974,20,24,4
"d4f45188d3c84a02ba08454e6403a818","a49d1bb4328949299686242fd0be5584",22856815,1,-3,0,1975,24,21,-3
"a49d1bb4328949299686242fd0be5584","d4c3b003e8274e429d2fa688d73fde6d",22856815,1,1,0,1976,21,22,1
"d4c3b003e8274e429d2fa688d73fde6d","b7719e26494940efa49512aedd0aac79",22856815,2,-3,0,1977,22,20,-2
"b7719e26494940efa49512aedd0aac79","9afd71a5298d4333b6849dfce1b9422c",22856815,3,-4,0,1979,20,18,-2
"9afd71a5298d4333b6849dfce1b9422c","b7719e26494940efa49512aedd0aac79",22856815,2,4,0,1980,18,20,2
"9afd71a5298d4333b6849dfce1b9422c","d4f45188d3c84a02ba08454e6403a818",22856815,1,9,0,1983,18,24,6
"d4f45188d3c84a02ba08454e6403a818","d4c3b003e8274e429d2fa688d73fde6d",22856815,3,-2,0,1984,24,22,-2
"d4c3b003e8274e429d2fa688d73fde6d","d4c3b003e8274e429d2fa688d73fde6d",22856815,1,0,1,1985,22,22,0
"a49d1bb4328949299686242fd0be5584","d4f45188d3c84a02ba08454e6403a818",22856815,1,3,0,1988,21,24,3
"d4c3b003e8274e429d2fa688d73fde6d","5bc03c8f16354d04bd51f5bb93559ad3",22856815,1,4,0,1990,22,26,4
"5bc03c8f16354d04bd51f5bb93559ad3","b7719e26494940efa49512aedd0aac79",22856815,1,-7,0,1991,26,20,-6
"9afd71a5298d4333b6849dfce1b9422c","9afd71a5298d4333b6849dfce1b9422c",22856815,1,0,1,1993,18,18,0
"d4c3b003e8274e429d2fa688d73fde6d","83d42d95cd844fc093fc09cee250edb8",22856815,1,620,0,1997,22,465,443
"83d42d95cd844fc093fc09cee250edb8","b7719e26494940efa49512aedd0aac79",22856815,1,-623,0,2002,465,20,-445
"b7719e26494940efa49512aedd0aac79","c5df9f40ec14463b9dcfdc73df3e9285",22856815,1,620,0,2003,20,464,444
"b613861cecf84ffcab01afb23f660475","b613861cecf84ffcab01afb23f660475",22857180,3,0,1,1,1,1,0
"b613861cecf84ffcab01afb23f660475","e2911e79efc2420eac45d9f671463d4b",22857180,3,3,0,3,1,2,1
"e2911e79efc2420eac45d9f671463d4b","b613861cecf84ffcab01afb23f660475",22857180,2,-3,0,4,2,1,-1
"e2911e79efc2420eac45d9f671463d4b","e2911e79efc2420eac45d9f671463d4b",22857180,3,0,1,10,2,2,0
"e2911e79efc2420eac45d9f671463d4b","519d1b8c59404d67b54e96c5c8a830b2",22857180,1,1,0,12,2,3,1
"519d1b8c59404d67b54e96c5c8a830b2","519d1b8c59404d67b54e96c5c8a830b2",22857180,1,0,1,13,3,3,0
"519d1b8c59404d67b54e96c5c8a830b2","531db53f81f646edb0cdcfe0085b03b7",22857180,1,1,0,14,3,4,1
"531db53f81f646edb0cdcfe0085b03b7","531db53f81f646edb0cdcfe0085b03b7",22857180,1,0,1,15,4,4,0
"531db53f81f646edb0cdcfe0085b03b7","4f5f94b2f95141e0a9d53a61da2276da",22857180,1,1,0,16,4,5,1
"4f5f94b2f95141e0a9d53a61da2276da","4f5f94b2f95141e0a9d53a61da2276da",22857180,1,0,1,17,5,5,0
"4f5f94b2f95141e0a9d53a61da2276da","6d541c89590949f99af293c4f2333f67",22857180,1,1,0,18,5,6,1
"6d541c89590949f99af293c4f2333f67","6d541c89590949f99af293c4f2333f67",22857180,1,0,1,19,6,6,0
"6d541c89590949f99af293c4f2333f67","dd5cf0b9fe4c4f1d8f5ff8e4c04879cb",22857180,1,1,0,20,6,7,1
"dd5cf0b9fe4c4f1d8f5ff8e4c04879cb","dd5cf0b9fe4c4f1d8f5ff8e4c04879cb",22857180,1,0,1,21,7,7,0
"dd5cf0b9fe4c4f1d8f5ff8e4c04879cb","f96261861edc426abe2248be4f0a709a",22857180,1,1,0,22,7,8,1
"f96261861edc426abe2248be4f0a709a","f96261861edc426abe2248be4f0a709a",22857180,1,0,1,23,8,8,0
"f96261861edc426abe2248be4f0a709a","66b5e16f4f75454fb5b8172079f0fa83",22857180,1,1,0,24,8,9,1
"66b5e16f4f75454fb5b8172079f0fa83","66b5e16f4f75454fb5b8172079f0fa83",22857180,1,0,1,25,9,9,0
"66b5e16f4f75454fb5b8172079f0fa83","0680571d4698477995e41842c36a54b2",22857180,1,1,0,26,9,10,1
"0680571d4698477995e41842c36a54b2","0680571d4698477995e41842c36a54b2",22857180,1,0,1,27,10,10,0
"0680571d4698477995e41842c36a54b2","9112f2bffece48e08c6d2287be204085",22857180,1,1,0,28,10,11,1
"9112f2bffece48e08c6d2287be204085","9112f2bffece48e08c6d2287be204085",22857180,1,0,1,29,11,11,0
"9112f2bffece48e08c6d2287be204085","e2911e79efc2420eac45d9f671463d4b",22857180,1,-9,0,30,11,2,-9
"e2911e79efc2420eac45d9f671463d4b","56586aa865414f538729c7f7735d2bc6",22857180,1,12,0,31,2,12,10
"56586aa865414f538729c7f7735d2bc6","56586aa865414f538729c7f7735d2bc6",22857180,9,0,1,32,12,12,0
"56586aa865414f538729c7f7735d2bc6","b7f2b31585d94eb3bf86376714aa7070",22857180,3,2,0,37,12,13,1
"b7f2b31585d94eb3bf86376714aa7070","b7f2b31585d94eb3bf86376714aa7070",22857180,4,0,1,38,13,13,0
"b7f2b31585d94eb3bf86376714aa7070","3f1c815879794b929260d224becaff7e",22857180,3,2,0,40,13,14,1
"3f1c815879794b929260d224becaff7e","56586aa865414f538729c7f7735d2bc6",22857180,2,-4,0,41,14,12,-2
"3f1c815879794b929260d224becaff7e","81c864a886d54a6b8ff85f7d736f4f95",22857180,1,2,0,53,14,15,1
"81c864a886d54a6b8ff85f7d736f4f95","5c5ceeee4562457ba6d41515aeebfbb1",22857180,1,4,0,54,15,17,2
"5c5ceeee4562457ba6d41515aeebfbb1","5c5ceeee4562457ba6d41515aeebfbb1",22857180,1,0,1,55,17,17,0
"5c5ceeee4562457ba6d41515aeebfbb1","56586aa865414f538729c7f7735d2bc6",22857180,1,-10,0,56,17,12,-5
"56586aa865414f538729c7f7735d2bc6","9afd71a5298d4333b6849dfce1b9422c",22857180,1,13,0,57,12,18,6
"9afd71a5298d4333b6849dfce1b9422c","9afd71a5298d4333b6849dfce1b9422c",22857180,3,0,1,58,18,18,0
"9afd71a5298d4333b6849dfce1b9422c","b7719e26494940efa49512aedd0aac79",22857180,1,4,0,61,18,20,2
"b7719e26494940efa49512aedd0aac79","9afd71a5298d4333b6849dfce1b9422c",22857180,1,-4,0,62,20,18,-2
"9afd71a5298d4333b6849dfce1b9422c","d4f45188d3c84a02ba08454e6403a818",22857180,1,9,0,63,18,24,6
"d4f45188d3c84a02ba08454e6403a818","d4c3b003e8274e429d2fa688d73fde6d",22857180,1,-2,0,64,24,22,-2
"d4c3b003e8274e429d2fa688d73fde6d","d4c3b003e8274e429d2fa688d73fde6d",22857180,1,0,1,65,22,22,0
"d4c3b003e8274e429d2fa688d73fde6d","b7719e26494940efa49512aedd0aac79",22857180,1,-3,0,66,22,20,-2
"b7719e26494940efa49512aedd0aac79","b7719e26494940efa49512aedd0aac79",22857180,1,0,1,67,20,20,0
"b7719e26494940efa49512aedd0aac79","afbf7250b99d47bea07172749483ca97",22857180,1,12,0,68,20,28,8
"afbf7250b99d47bea07172749483ca97","afbf7250b99d47bea07172749483ca97",22857180,1,0,1,69,28,28,0
"afbf7250b99d47bea07172749483ca97","4e51676dc72045d99c19b9fa7b22f8bc",22857180,1,3,0,70,28,29,1
"4e51676dc72045d99c19b9fa7b22f8bc","4e51676dc72045d99c19b9fa7b22f8bc",22857180,1,0,1,71,29,29,0
"4e51676dc72045d99c19b9fa7b22f8bc","51970cfa30e643e894e66ae85c8024cc",22857180,1,3,0,72,29,31,2
"51970cfa30e643e894e66ae85c8024cc","4e51676dc72045d99c19b9fa7b22f8bc",22857180,1,-3,0,73,31,29,-2
"4e51676dc72045d99c19b9fa7b22f8bc","c33c17be71ae4d588da7369472e5bb1b",22857180,1,9,0,74,29,34,5
"c33c17be71ae4d588da7369472e5bb1b","93679be414554a11b1893002f2229a93",22857180,2,3,0,75,34,35,1
"93679be414554a11b1893002f2229a93","c33c17be71ae4d588da7369472e5bb1b",22857180,1,-3,0,76,35,34,-1
"93679be414554a11b1893002f2229a93","7040a13096d746ac84b8fac8d9752058",22857180,1,3,0,78,35,36,1
"7040a13096d746ac84b8fac8d9752058","9a0dc646f934470daf08c4b56ccf73db",22857180,2,3,0,79,36,37,1
"9a0dc646f934470daf08c4b56ccf73db","7040a13096d746ac84b8fac8d9752058",22857180,1,-3,0,80,37,36,-1
"9a0dc646f934470daf08c4b56ccf73db","fc0e049d56024bc9a02c9a9c435c3df7",22857180,1,3,0,82,37,38,1
"fc0e049d56024bc9a02c9a9c435c3df7","fc0e049d56024bc9a02c9a9c435c3df7",22857180,1,0,1,83,38,38,0
"fc0e049d56024bc9a02c9a9c435c3df7","67a089198fcb4e1c8f2385786c2b296f",22857180,1,4,0,84,38,39,1
"64d48c6c9c7940639a932219a6c87198","67a089198fcb4e1c8f2385786c2b296f",22857180,2,-1,0,86,40,39,-1
"64d48c6c9c7940639a932219a6c87198","64d48c6c9c7940639a932219a6c87198",22857180,2,0,1,88,40,40,0
"67a089198fcb4e1c8f2385786c2b296f","b534b89233134e30a9b5645138bfa9ee",22857180,1,4,0,91,39,41,2
"b534b89233134e30a9b5645138bfa9ee","0e37b720d23b4e7f8b313e79313fd107",22857180,1,3,0,92,41,44,3
"0e37b720d23b4e7f8b313e79313fd107","0e37b720d23b4e7f8b313e79313fd107",22857180,1,0,1,93,44,44,0
"0e37b720d23b4e7f8b313e79313fd107","6875d67fdd5f48168b62719df449bebd",22857180,1,1,0,94,44,45,1
"6875d67fdd5f48168b62719df449bebd","6875d67fdd5f48168b62719df449bebd",22857180,1,0,1,95,45,45,0
"6875d67fdd5f48168b62719df449bebd","6e13d61a7bdb44bca949c9f86fab3be5",22857180,1,3,0,96,45,47,2
"6e13d61a7bdb44bca949c9f86fab3be5","6e13d61a7bdb44bca949c9f86fab3be5",22857180,1,0,1,99,47,47,0
"6e13d61a7bdb44bca949c9f86fab3be5","195f78799f984cc2b06c48dfe36be751",22857180,1,2,0,100,47,49,2
"195f78799f984cc2b06c48dfe36be751","195f78799f984cc2b06c48dfe36be751",22857180,2,0,1,101,49,49,0
"195f78799f984cc2b06c48dfe36be751","d9c8d8c444a64dadbbb508652c721e17",22857180,1,-3,0,103,49,46,-3
"d9c8d8c444a64dadbbb508652c721e17","d0c74f735e024943943e40333d6d337f",22857180,2,6,0,104,46,51,5
"d0c74f735e024943943e40333d6d337f","d0c74f735e024943943e40333d6d337f",22857180,1,0,1,105,51,51,0
"d0c74f735e024943943e40333d6d337f","983f8ff320594b279a7f4a6fe132f9c5",22857180,1,2,0,106,51,53,2
"983f8ff320594b279a7f4a6fe132f9c5","983f8ff320594b279a7f4a6fe132f9c5",22857180,2,0,1,107,53,53,0
"983f8ff320594b279a7f4a6fe132f9c5","35adfa5d923046aebabfefd98f35ff05",22857180,1,1,0,109,53,54,1
"35adfa5d923046aebabfefd98f35ff05","35adfa5d923046aebabfefd98f35ff05",22857180,2,0,1,110,54,54,0
"35adfa5d923046aebabfefd98f35ff05","b6f8a98476224da1b40e555ececc7ed8",22857180,1,1,0,112,54,55,1
"b6f8a98476224da1b40e555ececc7ed8","b6f8a98476224da1b40e555ececc7ed8",22857180,2,0,1,113,55,55,0
"b6f8a98476224da1b40e555ececc7ed8","86e22cb5fe0e4b47a9489ecddf7ed78f",22857180,1,1,0,115,55,56,1
"86e22cb5fe0e4b47a9489ecddf7ed78f","86e22cb5fe0e4b47a9489ecddf7ed78f",22857180,2,0,1,116,56,56,0
"86e22cb5fe0e4b47a9489ecddf7ed78f","f924752d8a1149668870b1e7698486f7",22857180,1,-6,0,118,56,50,-6
"f924752d8a1149668870b1e7698486f7","a1f2f12debe5432fb7a70bcd12bacfb9",22857180,1,9,0,119,50,58,8
"a1f2f12debe5432fb7a70bcd12bacfb9","78f30e4dcac84e3cbea8b2cc6e0d62b3",22857180,2,1,0,120,58,59,1
"78f30e4dcac84e3cbea8b2cc6e0d62b3","a1f2f12debe5432fb7a70bcd12bacfb9",22857180,1,-1,0,121,59,58,-1
"a1f2f12debe5432fb7a70bcd12bacfb9","a1f2f12debe5432fb7a70bcd12bacfb9",22857180,21,0,1,122,58,58,0
"78f30e4dcac84e3cbea8b2cc6e0d62b3","78f30e4dcac84e3cbea8b2cc6e0d62b3",22857180,11,0,1,144,59,59,0
"78f30e4dcac84e3cbea8b2cc6e0d62b3","12aa6e1672ac4e7aa6449a7a8609cd72",22857180,2,-2,0,155,59,57,-2
"12aa6e1672ac4e7aa6449a7a8609cd72","bc42d26810654ea9a1df1efe1e58c7d5",22857180,1,7,0,156,57,63,6
"bc42d26810654ea9a1df1efe1e58c7d5","a0a418b8540d479fa6e0f653b701da8b",22857180,2,1,0,157,63,64,1
"a0a418b8540d479fa6e0f653b701da8b","4c943503763e4e349906eea3ed3c8e86",22857180,1,-3,0,158,64,61,-3
"4c943503763e4e349906eea3ed3c8e86","4c943503763e4e349906eea3ed3c8e86",22857180,2,0,1,159,61,61,0
"4c943503763e4e349906eea3ed3c8e86","b534b89233134e30a9b5645138bfa9ee",22857180,1,-24,0,160,61,41,-20
"b534b89233134e30a9b5645138bfa9ee","6e13d61a7bdb44bca949c9f86fab3be5",22857180,2,7,0,161,41,47,6
"6e13d61a7bdb44bca949c9f86fab3be5","b534b89233134e30a9b5645138bfa9ee",22857180,2,-7,0,162,47,41,-6
"b534b89233134e30a9b5645138bfa9ee","d9c8d8c444a64dadbbb508652c721e17",22857180,1,6,0,163,41,46,5
"d0c74f735e024943943e40333d6d337f","a1f2f12debe5432fb7a70bcd12bacfb9",22857180,1,8,0,165,51,58,7
"a1f2f12debe5432fb7a70bcd12bacfb9","f924752d8a1149668870b1e7698486f7",22857180,1,-9,0,166,58,50,-8
"f924752d8a1149668870b1e7698486f7","78f30e4dcac84e3cbea8b2cc6e0d62b3",22857180,1,10,0,167,50,59,9
"12aa6e1672ac4e7aa6449a7a8609cd72","a0a418b8540d479fa6e0f653b701da8b",22857180,1,8,0,169,57,64,7
"a0a418b8540d479fa6e0f653b701da8b","bc42d26810654ea9a1df1efe1e58c7d5",22857180,1,-1,0,170,64,63,-1
"bc42d26810654ea9a1df1efe1e58c7d5","4c943503763e4e349906eea3ed3c8e86",22857180,1,-2,0,171,63,61,-2
"4c943503763e4e349906eea3ed3c8e86","bc42d26810654ea9a1df1efe1e58c7d5",22857180,1,2,0,173,61,63,2
"bc42d26810654ea9a1df1efe1e58c7d5","bc42d26810654ea9a1df1efe1e58c7d5",22857180,3,0,1,174,63,63,0
"a0a418b8540d479fa6e0f653b701da8b","a0a418b8540d479fa6e0f653b701da8b",22857180,3,0,1,178,64,64,0
"a0a418b8540d479fa6e0f653b701da8b","309ccf3cc4fe429d9bfbaef53d3fa479",22857180,1,-4,0,181,64,60,-4
"309ccf3cc4fe429d9bfbaef53d3fa479","d646286c8051419bbc2e31dd1db55ca8",22857180,1,10,0,182,60,67,7
"d646286c8051419bbc2e31dd1db55ca8","b534b89233134e30a9b5645138bfa9ee",22857180,1,-33,0,183,67,41,-26
"b534b89233134e30a9b5645138bfa9ee","267f883678b24aed855fde42524975d9",22857180,1,37,0,184,41,71,30
"267f883678b24aed855fde42524975d9","267f883678b24aed855fde42524975d9",22857180,1,0,1,185,71,71,0
"267f883678b24aed855fde42524975d9","88fff56d0342490dbef9040750a20f6c",22857180,1,1,0,186,71,72,1
"88fff56d0342490dbef9040750a20f6c","88fff56d0342490dbef9040750a20f6c",22857180,1,0,1,187,72,72,0
"88fff56d0342490dbef9040750a20f6c","adb17b12b66c4a49a85fd34322f7df70",22857180,1,1,0,188,72,73,1
"adb17b12b66c4a49a85fd34322f7df70","adb17b12b66c4a49a85fd34322f7df70",22857180,1,0,1,189,73,73,0
"adb17b12b66c4a49a85fd34322f7df70","d646286c8051419bbc2e31dd1db55ca8",22857180,1,-6,0,190,73,67,-6
"d646286c8051419bbc2e31dd1db55ca8","a2becd407db34b189200a32546d9d569",22857180,1,9,0,191,67,75,8
"a2becd407db34b189200a32546d9d569","a2becd407db34b189200a32546d9d569",22857180,1,0,1,192,75,75,0
"a2becd407db34b189200a32546d9d569","58c22b011d0f4c2ea6d13615edbb9eeb",22857180,1,2,0,193,75,77,2
"58c22b011d0f4c2ea6d13615edbb9eeb","58c22b011d0f4c2ea6d13615edbb9eeb",22857180,2,0,1,194,77,77,0
"58c22b011d0f4c2ea6d13615edbb9eeb","dd76e1861dc9461c830888729d091ee0",22857180,1,1,0,196,77,78,1
"dd76e1861dc9461c830888729d091ee0","dd76e1861dc9461c830888729d091ee0",22857180,5,0,1,197,78,78,0
"dd76e1861dc9461c830888729d091ee0","cd1d828f1a694b87913a7ea66c23803e",22857180,1,1,0,202,78,79,1
"cd1d828f1a694b87913a7ea66c23803e","cd1d828f1a694b87913a7ea66c23803e",22857180,2,0,1,203,79,79,0
"cd1d828f1a694b87913a7ea66c23803e","9176a3c2b4d2465fa8b0c67096c2a97e",22857180,1,1,0,205,79,80,1
"9176a3c2b4d2465fa8b0c67096c2a97e","9176a3c2b4d2465fa8b0c67096c2a97e",22857180,5,0,1,206,80,80,0
"9176a3c2b4d2465fa8b0c67096c2a97e","f8ec6445f7194e25b9101d4fbcb07a18",22857180,1,1,0,211,80,81,1
"f8ec6445f7194e25b9101d4fbcb07a18","f8ec6445f7194e25b9101d4fbcb07a18",22857180,2,0,1,212,81,81,0
"f8ec6445f7194e25b9101d4fbcb07a18","140d5b27b8574befad82c0a013b59dfa",22857180,1,-7,0,214,81,74,-7
"140d5b27b8574befad82c0a013b59dfa","d18a9ea32855445f8736581f5cb119ce",22857180,1,9,0,215,74,82,8
"d18a9ea32855445f8736581f5cb119ce","f564483cbd7a407681aa2fcca518cf5f",22857180,1,4,0,216,82,85,3
"f564483cbd7a407681aa2fcca518cf5f","f564483cbd7a407681aa2fcca518cf5f",22857180,1,0,1,217,85,85,0
"f564483cbd7a407681aa2fcca518cf5f","18fd01350bd5434ca636d59a599d768a",22857180,1,1,0,218,85,86,1
"18fd01350bd5434ca636d59a599d768a","18fd01350bd5434ca636d59a599d768a",22857180,8,0,1,219,86,86,0
"18fd01350bd5434ca636d59a599d768a","ae5ac430ea254e708a6f5deaaf7464ae",22857180,1,-2,0,227,86,84,-2
"6a9f0ef185fb47f0937e29daa1c71ed5","c681290961c94c4caf23b529d1ae6b9a",22857180,1,-2,0,229,90,88,-2
"c681290961c94c4caf23b529d1ae6b9a","c681290961c94c4caf23b529d1ae6b9a",22857180,1,0,1,230,88,88,0
"c681290961c94c4caf23b529d1ae6b9a","6a9f0ef185fb47f0937e29daa1c71ed5",22857180,1,2,0,231,88,90,2
"e20db35ced8544ddac5bc3839145e463","1febb706d7a34005ae8711ed49c76e64",22857180,1,3,0,237,91,94,3
"1febb706d7a34005ae8711ed49c76e64","1febb706d7a34005ae8711ed49c76e64",22857180,2,0,1,238,94,94,0
"1febb706d7a34005ae8711ed49c76e64","8f73ba6f5a0042f2850356ac38ac6f24",22857180,1,1,0,240,94,95,1
"8f73ba6f5a0042f2850356ac38ac6f24","8f73ba6f5a0042f2850356ac38ac6f24",22857180,5,0,1,241,95,95,0
"8f73ba6f5a0042f2850356ac38ac6f24","e2260b86653c46d7b14a41fb419dbf8c",22857180,1,1,0,246,95,96,1
"e2260b86653c46d7b14a41fb419dbf8c","e2260b86653c46d7b14a41fb419dbf8c",22857180,2,0,1,247,96,96,0
"e2260b86653c46d7b14a41fb419dbf8c","35eb641ad1d845bbba54915bce75a962",22857180,1,1,0,249,96,97,1
"35eb641ad1d845bbba54915bce75a962","35eb641ad1d845bbba54915bce75a962",22857180,2,0,1,250,97,97,0
"35eb641ad1d845bbba54915bce75a962","08be90ffbeea4795a138cd42ed8db56f",22857180,1,1,0,252,97,98,1
"08be90ffbeea4795a138cd42ed8db56f","08be90ffbeea4795a138cd42ed8db56f",22857180,3,0,1,253,98,98,0
"08be90ffbeea4795a138cd42ed8db56f","3007433c8f584dcbb5ac159c1c5f2be3",22857180,1,1,0,256,98,99,1
"3007433c8f584dcbb5ac159c1c5f2be3","3007433c8f584dcbb5ac159c1c5f2be3",22857180,5,0,1,257,99,99,0
"3007433c8f584dcbb5ac159c1c5f2be3","e20db35ced8544ddac5bc3839145e463",22857180,1,-8,0,262,99,91,-8
"d391c8b6e56a43a7b654e9dee02d904b","73039f8c1eb9409cb4caee2cf968001e",22857180,1,-3,0,265,103,100,-3
"73039f8c1eb9409cb4caee2cf968001e","4280927ec4d643238aa49c32f9e06c6c",22857180,2,10,0,266,100,109,9
"4280927ec4d643238aa49c32f9e06c6c","08111f75e22d409998cf8b85bd431f0a",22857180,1,-1,0,267,109,108,-1
"e20db35ced8544ddac5bc3839145e463","779f9ddd1fd14d1e9e69f72219a1fdbd",22857180,2,36,0,273,91,121,30
"b416d47c56a742199b5d7c7f19d6503a","df1de691dafe4549a18a4398ee9dfaf9",22857180,1,8,0,277,134,139,5
"df1de691dafe4549a18a4398ee9dfaf9","779f9ddd1fd14d1e9e69f72219a1fdbd",22857180,1,-23,0,278,139,121,-18
"779f9ddd1fd14d1e9e69f72219a1fdbd","6c5ad271a44743479bfaea29b1db8d02",22857180,1,27,0,279,121,143,22
"f902b0f41b544d4dbf79664fd233648d","8aae34f5ddbb4052a709b12e6b0d40fa",22857180,1,1,0,282,146,147,1
"8aae34f5ddbb4052a709b12e6b0d40fa","f03480cf4eba413194d7af52fc0e7f28",22857180,1,6,0,283,147,152,5
"78adeee1fa2c4fe0bc73f7bca9fcee86","d646286c8051419bbc2e31dd1db55ca8",22857180,1,-115,0,287,160,67,-93
"d646286c8051419bbc2e31dd1db55ca8","d18a9ea32855445f8736581f5cb119ce",22857180,1,17,0,288,67,82,15
"d18a9ea32855445f8736581f5cb119ce","d18a9ea32855445f8736581f5cb119ce",22857180,1,0,1,289,82,82,0
"d18a9ea32855445f8736581f5cb119ce","d646286c8051419bbc2e31dd1db55ca8",22857180,1,-17,0,290,82,67,-15
"d646286c8051419bbc2e31dd1db55ca8","73039f8c1eb9409cb4caee2cf968001e",22857180,1,40,0,291,67,100,33
"73039f8c1eb9409cb4caee2cf968001e","e20db35ced8544ddac5bc3839145e463",22857180,1,-10,0,292,100,91,-9
"d391c8b6e56a43a7b654e9dee02d904b","d391c8b6e56a43a7b654e9dee02d904b",22857180,15,0,1,297,103,103,0
"d391c8b6e56a43a7b654e9dee02d904b","6111116566fc4fd9abba409322bea245",22857180,1,1,0,312,103,104,1
"6111116566fc4fd9abba409322bea245","6111116566fc4fd9abba409322bea245",22857180,2,0,1,313,104,104,0
"6111116566fc4fd9abba409322bea245","a81b2235cb9c499eb9ea8ee0a8dd9725",22857180,1,1,0,315,104,105,1
"a81b2235cb9c499eb9ea8ee0a8dd9725","a81b2235cb9c499eb9ea8ee0a8dd9725",22857180,2,0,1,316,105,105,0
"a81b2235cb9c499eb9ea8ee0a8dd9725","2d4e0ab0ef3b4d73b82c72d4621a7579",22857180,1,1,0,318,105,106,1
"2d4e0ab0ef3b4d73b82c72d4621a7579","2d4e0ab0ef3b4d73b82c72d4621a7579",22857180,2,0,1,319,106,106,0
"2d4e0ab0ef3b4d73b82c72d4621a7579","8bdebf492ebd4e62b0d522e8ab5e5197",22857180,1,1,0,321,106,107,1
"8bdebf492ebd4e62b0d522e8ab5e5197","8bdebf492ebd4e62b0d522e8ab5e5197",22857180,2,0,1,322,107,107,0
"8bdebf492ebd4e62b0d522e8ab5e5197","73039f8c1eb9409cb4caee2cf968001e",22857180,1,-7,0,324,107,100,-7
"4280927ec4d643238aa49c32f9e06c6c","4280927ec4d643238aa49c32f9e06c6c",22857180,1,0,1,326,109,109,0
"4280927ec4d643238aa49c32f9e06c6c","fc44e6a5f7654430af1227838224dceb",22857180,1,2,0,327,109,111,2
"fc44e6a5f7654430af1227838224dceb","fc44e6a5f7654430af1227838224dceb",22857180,2,0,1,328,111,111,0
"fc44e6a5f7654430af1227838224dceb","08111f75e22d409998cf8b85bd431f0a",22857180,1,-3,0,330,111,108,-3
"a9ae0a3c070d455bb4369a8996313336","a9ae0a3c070d455bb4369a8996313336",22857180,1,0,1,332,114,114,0
"a9ae0a3c070d455bb4369a8996313336","71cec822bcff4f30a20e75dc63ef7b65",22857180,1,2,0,333,114,116,2
"71cec822bcff4f30a20e75dc63ef7b65","71cec822bcff4f30a20e75dc63ef7b65",22857180,1,0,1,334,116,116,0
"71cec822bcff4f30a20e75dc63ef7b65","62bff51286ef4f348717a3cf6fe2318f",22857180,1,5,0,335,116,120,4
"e20db35ced8544ddac5bc3839145e463","e20db35ced8544ddac5bc3839145e463",22857180,2,0,1,338,91,91,0
"e20db35ced8544ddac5bc3839145e463","3ec3a3563847406fa73338f9e9999cf3",22857180,1,30,0,340,91,117,26
"3ec3a3563847406fa73338f9e9999cf3","e20db35ced8544ddac5bc3839145e463",22857180,1,-30,0,341,117,91,-26
"62bff51286ef4f348717a3cf6fe2318f","b1cd0e7dc3ad4a8eb91a4bfdbeb025b0",22857180,1,-2,0,343,120,118,-2
"b1cd0e7dc3ad4a8eb91a4bfdbeb025b0","b1cd0e7dc3ad4a8eb91a4bfdbeb025b0",22857180,1,0,1,344,118,118,0
"b1cd0e7dc3ad4a8eb91a4bfdbeb025b0","62bff51286ef4f348717a3cf6fe2318f",22857180,1,2,0,345,118,120,2
"62bff51286ef4f348717a3cf6fe2318f","e20db35ced8544ddac5bc3839145e463",22857180,1,-33,0,349,120,91,-29
"779f9ddd1fd14d1e9e69f72219a1fdbd","ae26e6cda8ad4a3f81bd347560d9579f",22857180,1,4,0,351,121,125,4
"ae26e6cda8ad4a3f81bd347560d9579f","ae26e6cda8ad4a3f81bd347560d9579f",22857180,1,0,1,352,125,125,0
"ae26e6cda8ad4a3f81bd347560d9579f","ee48df95832b4374aa273ceb27ec1315",22857180,1,1,0,353,125,126,1
"ee48df95832b4374aa273ceb27ec1315","ee48df95832b4374aa273ceb27ec1315",22857180,1,0,1,354,126,126,0
"ee48df95832b4374aa273ceb27ec1315","7a439da90b394756ad1777fc4c6dead5",22857180,1,1,0,355,126,127,1
"7a439da90b394756ad1777fc4c6dead5","7a439da90b394756ad1777fc4c6dead5",22857180,1,0,1,356,127,127,0
"7a439da90b394756ad1777fc4c6dead5","779f9ddd1fd14d1e9e69f72219a1fdbd",22857180,1,-6,0,357,127,121,-6
"a8dd5213034441ac92724b4e83eb0bb2","a8dd5213034441ac92724b4e83eb0bb2",22857180,1,0,1,359,129,129,0
"a8dd5213034441ac92724b4e83eb0bb2","8115eab6556b45f5b415c3b8c26a12e5",22857180,1,2,0,360,129,131,2
"8115eab6556b45f5b415c3b8c26a12e5","8115eab6556b45f5b415c3b8c26a12e5",22857180,2,0,1,361,131,131,0
"8115eab6556b45f5b415c3b8c26a12e5","ec34b06efd844b46a4c4818ecdb9b8f4",22857180,1,1,0,363,131,132,1
"ec34b06efd844b46a4c4818ecdb9b8f4","ec34b06efd844b46a4c4818ecdb9b8f4",22857180,2,0,1,364,132,132,0
"ec34b06efd844b46a4c4818ecdb9b8f4","c2e1c2b9eac64109b343a088584b576b",22857180,1,1,0,366,132,133,1
"c2e1c2b9eac64109b343a088584b576b","c2e1c2b9eac64109b343a088584b576b",22857180,2,0,1,367,133,133,0
"c2e1c2b9eac64109b343a088584b576b","579338175e0b4bbb8ef3b712b5d8b54e",22857180,1,-5,0,369,133,128,-5
"579338175e0b4bbb8ef3b712b5d8b54e","8bc5795d6a984a3eace4e2811e52dd4f",22857180,1,8,0,370,128,135,7
"8bc5795d6a984a3eace4e2811e52dd4f","8bc5795d6a984a3eace4e2811e52dd4f",22857180,3,0,1,371,135,135,0
"8bc5795d6a984a3eace4e2811e52dd4f","b416d47c56a742199b5d7c7f19d6503a",22857180,1,-1,0,374,135,134,-1
"b416d47c56a742199b5d7c7f19d6503a","cd4532ad48034873ba8bce2aac0c9808",22857180,1,4,0,375,134,137,3
"cd4532ad48034873ba8bce2aac0c9808","cd4532ad48034873ba8bce2aac0c9808",22857180,1,0,1,376,137,137,0
"cd4532ad48034873ba8bce2aac0c9808","779f9ddd1fd14d1e9e69f72219a1fdbd",22857180,1,-19,0,377,137,121,-16
"6c5ad271a44743479bfaea29b1db8d02","6c5ad271a44743479bfaea29b1db8d02",22857180,1,0,1,380,143,143,0
"6c5ad271a44743479bfaea29b1db8d02","83d311bed5374fee83d8d67a7d9d82dc",22857180,1,1,0,381,143,144,1
"83d311bed5374fee83d8d67a7d9d82dc","83d311bed5374fee83d8d67a7d9d82dc",22857180,1,0,1,382,144,144,0
"83d311bed5374fee83d8d67a7d9d82dc","402bba41861d43acb52a5abb89e8831e",22857180,1,1,0,383,144,145,1
"402bba41861d43acb52a5abb89e8831e","402bba41861d43acb52a5abb89e8831e",22857180,2,0,1,384,145,145,0
"402bba41861d43acb52a5abb89e8831e","8aae34f5ddbb4052a709b12e6b0d40fa",22857180,1,3,0,386,145,147,2
"8aae34f5ddbb4052a709b12e6b0d40fa","645b3f0249f64f76af2e19eb4d0e55b7",22857180,1,2,0,389,147,149,2
"645b3f0249f64f76af2e19eb4d0e55b7","645b3f0249f64f76af2e19eb4d0e55b7",22857180,3,0,1,390,149,149,0
"645b3f0249f64f76af2e19eb4d0e55b7","7e7b8db5064d4369805ab370aac5ddfb",22857180,1,1,0,393,149,150,1
"7e7b8db5064d4369805ab370aac5ddfb","7e7b8db5064d4369805ab370aac5ddfb",22857180,2,0,1,394,150,150,0
"7e7b8db5064d4369805ab370aac5ddfb","8956d210ae7f41968fada86d4c979d6a",22857180,1,1,0,396,150,151,1
"8956d210ae7f41968fada86d4c979d6a","8956d210ae7f41968fada86d4c979d6a",22857180,2,0,1,397,151,151,0
"8956d210ae7f41968fada86d4c979d6a","f902b0f41b544d4dbf79664fd233648d",22857180,1,-5,0,399,151,146,-5
"f902b0f41b544d4dbf79664fd233648d","ae781e8b775e4ccd93bc800dad5c8376",22857180,1,8,0,400,146,153,7
"ae781e8b775e4ccd93bc800dad5c8376","ae781e8b775e4ccd93bc800dad5c8376",22857180,2,0,1,401,153,153,0
"ae781e8b775e4ccd93bc800dad5c8376","06882a8492d9499aa31555567f575ecb",22857180,1,1,0,403,153,154,1
"06882a8492d9499aa31555567f575ecb","06882a8492d9499aa31555567f575ecb",22857180,1,0,1,404,154,154,0
"06882a8492d9499aa31555567f575ecb","f293c508f409466a8f27ddd7d1e40b20",22857180,1,1,0,405,154,155,1
"f293c508f409466a8f27ddd7d1e40b20","f293c508f409466a8f27ddd7d1e40b20",22857180,2,0,1,406,155,155,0
"f293c508f409466a8f27ddd7d1e40b20","cc4ddef5bbbe48ebb605141b347c4ed1",22857180,1,1,0,408,155,156,1
"cc4ddef5bbbe48ebb605141b347c4ed1","cc4ddef5bbbe48ebb605141b347c4ed1",22857180,1,0,1,409,156,156,0
"cc4ddef5bbbe48ebb605141b347c4ed1","d313cec988a84645bee413e8d4724a4b",22857180,1,3,0,410,156,158,2
"d313cec988a84645bee413e8d4724a4b","dc60696c76a74368a60f72246e47700d",22857180,1,1,0,416,158,159,1
"dc60696c76a74368a60f72246e47700d","dc60696c76a74368a60f72246e47700d",22857180,1,0,1,417,159,159,0
"dc60696c76a74368a60f72246e47700d","78adeee1fa2c4fe0bc73f7bca9fcee86",22857180,1,3,0,418,159,160,1
"78adeee1fa2c4fe0bc73f7bca9fcee86","df1de691dafe4549a18a4398ee9dfaf9",22857180,1,-26,0,419,160,139,-21
"df1de691dafe4549a18a4398ee9dfaf9","65202579580f4ad38d734b4ee39d22a8",22857180,1,31,0,420,139,164,25
"82e6285962b8400d9d6fc32436022a94","67a089198fcb4e1c8f2385786c2b296f",22857180,1,-162,0,479,167,39,-128
"67a089198fcb4e1c8f2385786c2b296f","64d48c6c9c7940639a932219a6c87198",22857180,3,1,0,480,39,40,1
"64d48c6c9c7940639a932219a6c87198","b534b89233134e30a9b5645138bfa9ee",22857180,1,3,0,481,40,41,1
"b534b89233134e30a9b5645138bfa9ee","67a089198fcb4e1c8f2385786c2b296f",22857180,1,-4,0,482,41,39,-2
"67a089198fcb4e1c8f2385786c2b296f","67a089198fcb4e1c8f2385786c2b296f",22857180,1,0,1,483,39,39,0
"67a089198fcb4e1c8f2385786c2b296f","a9ac840f098c4bd0a2ee896214ce29cd",22857180,1,165,0,484,39,168,129
"b2275c3fad834f8d90737a2d9a6927d6","b2275c3fad834f8d90737a2d9a6927d6",22857180,20,0,1,493,172,172,0
"b2275c3fad834f8d90737a2d9a6927d6","eb515a26030b41f8a82a1e6114420bad",22857180,1,1,0,513,172,173,1
"eb515a26030b41f8a82a1e6114420bad","eb515a26030b41f8a82a1e6114420bad",22857180,2,0,1,514,173,173,0
"eb515a26030b41f8a82a1e6114420bad","0c7262dff33c4087bc660ccf40f92f9c",22857180,1,-4,0,516,173,169,-4
"b42cc17b7de840f181a704558d0bc845","b42cc17b7de840f181a704558d0bc845",22857180,1,0,1,518,175,175,0
"b42cc17b7de840f181a704558d0bc845","801f9e9135034f49bf5f8b4bdefedb41",22857180,1,2,0,519,175,177,2
"801f9e9135034f49bf5f8b4bdefedb41","801f9e9135034f49bf5f8b4bdefedb41",22857180,4,0,1,520,177,177,0
"801f9e9135034f49bf5f8b4bdefedb41","362fcb0699a14845ab29b2340093e528",22857180,1,-3,0,524,177,174,-3
"362fcb0699a14845ab29b2340093e528","ea38cc0e6e6e41edbabf210220808bf9",22857180,1,6,0,525,174,179,5
"ea38cc0e6e6e41edbabf210220808bf9","b87c552dd247427abe6ab5795b9c9d43",22857180,4,2,0,526,179,181,2
"b87c552dd247427abe6ab5795b9c9d43","b87c552dd247427abe6ab5795b9c9d43",22857180,8,0,1,529,181,181,0
"139b097acfca451689d80c9c6eebdf7b","30f660a1feb34582a739722532524f79",22857180,1,6,0,538,178,183,5
"30f660a1feb34582a739722532524f79","30f660a1feb34582a739722532524f79",22857180,3,0,1,539,183,183,0
"30f660a1feb34582a739722532524f79","2024b4885bd14338a39b7b509acbbd02",22857180,1,-1,0,542,183,182,-1
"2024b4885bd14338a39b7b509acbbd02","c3f63fe50d8e487c86bf8ef76c9cadd3",22857180,1,4,0,543,182,185,3
"c3f63fe50d8e487c86bf8ef76c9cadd3","c3f63fe50d8e487c86bf8ef76c9cadd3",22857180,1,0,1,544,185,185,0
"c3f63fe50d8e487c86bf8ef76c9cadd3","c8e371568a0c4391b25796ae4e91952e",22857180,1,3,0,545,185,186,1
"0c7262dff33c4087bc660ccf40f92f9c","7d932b23e1c84326ae5aa4d3c0d813d1",22857180,1,25,0,547,169,188,19
"7d932b23e1c84326ae5aa4d3c0d813d1","7d932b23e1c84326ae5aa4d3c0d813d1",22857180,1,0,1,548,188,188,0
"7d932b23e1c84326ae5aa4d3c0d813d1","ab11d94c6c8948ea90b88f19d2cd502b",22857180,1,3,0,549,188,190,2
"ab11d94c6c8948ea90b88f19d2cd502b","f992451ed6ad4e68bb9e68ad6be7c4be",22857180,1,2,0,552,190,192,2
"f992451ed6ad4e68bb9e68ad6be7c4be","f992451ed6ad4e68bb9e68ad6be7c4be",22857180,3,0,1,553,192,192,0
"f992451ed6ad4e68bb9e68ad6be7c4be","07b44a7a51e94c78b411c753fc39dab0",22857180,1,-3,0,556,192,189,-3
"07b44a7a51e94c78b411c753fc39dab0","6cd2dcaac46847d4a0bc53f296d90375",22857180,1,6,0,557,189,194,5
"6cd2dcaac46847d4a0bc53f296d90375","6cd2dcaac46847d4a0bc53f296d90375",22857180,1,0,1,558,194,194,0
"6cd2dcaac46847d4a0bc53f296d90375","2d2580c9411c4972909db508d6956a58",22857180,1,2,0,559,194,196,2
"2d2580c9411c4972909db508d6956a58","2d2580c9411c4972909db508d6956a58",22857180,2,0,1,560,196,196,0
"2d2580c9411c4972909db508d6956a58","5bddb3d9ed264f3984702f048c7e5340",22857180,1,1,0,562,196,197,1
"5bddb3d9ed264f3984702f048c7e5340","5bddb3d9ed264f3984702f048c7e5340",22857180,2,0,1,563,197,197,0
"5bddb3d9ed264f3984702f048c7e5340","d5e8e2bd12a2466b9d6d90855f0eb079",22857180,1,1,0,565,197,198,1
"d5e8e2bd12a2466b9d6d90855f0eb079","d5e8e2bd12a2466b9d6d90855f0eb079",22857180,2,0,1,566,198,198,0
"d5e8e2bd12a2466b9d6d90855f0eb079","017d7ca8e0394b91aaadc9574df2202c",22857180,1,-5,0,568,198,193,-5
"017d7ca8e0394b91aaadc9574df2202c","54e8e9f0ea3e45c4bf3b8ac799ee31b1",22857180,1,8,0,569,193,200,7
"54e8e9f0ea3e45c4bf3b8ac799ee31b1","54e8e9f0ea3e45c4bf3b8ac799ee31b1",22857180,1,0,1,570,200,200,0
"54e8e9f0ea3e45c4bf3b8ac799ee31b1","c614a00911be4877a075f19315530fb0",22857180,1,1,0,571,200,201,1
"c614a00911be4877a075f19315530fb0","c614a00911be4877a075f19315530fb0",22857180,6,0,1,572,201,201,0
"c614a00911be4877a075f19315530fb0","a6c21bd8b95249c7972820a7a7d76aff",22857180,1,1,0,578,201,202,1
"a6c21bd8b95249c7972820a7a7d76aff","a6c21bd8b95249c7972820a7a7d76aff",22857180,1,0,1,579,202,202,0
"a6c21bd8b95249c7972820a7a7d76aff","bb329d880ab54120adaf203a693bb203",22857180,1,1,0,580,202,203,1
"bb329d880ab54120adaf203a693bb203","bb329d880ab54120adaf203a693bb203",22857180,1,0,1,581,203,203,0
"bb329d880ab54120adaf203a693bb203","f9170dd6bc6442b4acd832747609b09a",22857180,1,-4,0,582,203,199,-4
"f9170dd6bc6442b4acd832747609b09a","334c2344009840079b1d0e1b7ce3d5a7",22857180,1,7,0,583,199,205,6
"334c2344009840079b1d0e1b7ce3d5a7","334c2344009840079b1d0e1b7ce3d5a7",22857180,1,0,1,584,205,205,0
"334c2344009840079b1d0e1b7ce3d5a7","c8e371568a0c4391b25796ae4e91952e",22857180,1,-23,0,585,205,186,-19
"b9e80f77c3a44349863b19875725c384","b9e80f77c3a44349863b19875725c384",22857180,22,0,1,589,207,207,0
"7108f0e4c2584f1f9c471689ae4c885c","7108f0e4c2584f1f9c471689ae4c885c",22857180,11,0,1,612,208,208,0
"7108f0e4c2584f1f9c471689ae4c885c","d7f13c8d63ec4e2aa673fbb9cf9c6933",22857180,1,-2,0,623,208,206,-2
"d7f13c8d63ec4e2aa673fbb9cf9c6933","09400e101c5d4b439cf9a26b03aae558",22857180,1,5,0,624,206,210,4
"09400e101c5d4b439cf9a26b03aae558","09400e101c5d4b439cf9a26b03aae558",22857180,9,0,1,625,210,210,0
"09400e101c5d4b439cf9a26b03aae558","a88efa7e50ce47159810ab553afa6d3a",22857180,1,2,0,634,210,212,2
"a88efa7e50ce47159810ab553afa6d3a","a88efa7e50ce47159810ab553afa6d3a",22857180,5,0,1,635,212,212,0
"a88efa7e50ce47159810ab553afa6d3a","a875096404ef4a9984b62d74cda916f9",22857180,1,-3,0,640,212,209,-3
"a875096404ef4a9984b62d74cda916f9","be502a7a43c44bf7b682698de79d9369",22857180,1,6,0,641,209,214,5
"be502a7a43c44bf7b682698de79d9369","f7fb1952f56b4189b86a9f8b7862d2b8",22857180,2,1,0,642,214,215,1
"be502a7a43c44bf7b682698de79d9369","be502a7a43c44bf7b682698de79d9369",22857180,1,0,1,644,214,214,0
"f7fb1952f56b4189b86a9f8b7862d2b8","f7fb1952f56b4189b86a9f8b7862d2b8",22857180,11,0,1,646,215,215,0
"f7fb1952f56b4189b86a9f8b7862d2b8","b860ee85d8bc4a2f97958cfb71be3533",22857180,1,1,0,657,215,216,1
"b860ee85d8bc4a2f97958cfb71be3533","b860ee85d8bc4a2f97958cfb71be3533",22857180,2,0,1,658,216,216,0
"b860ee85d8bc4a2f97958cfb71be3533","ec341f459285443b8361f7f15638ff08",22857180,1,-3,0,660,216,213,-3
"363837c182e04711840d896ae1e0339c","363837c182e04711840d896ae1e0339c",22857180,12,0,1,662,218,218,0
"01b2051f8941460d89945e3b02d1ce78","91125ca626c5470eb145501f8c37f8db",22857180,1,4,0,675,217,220,3
"91125ca626c5470eb145501f8c37f8db","91125ca626c5470eb145501f8c37f8db",22857180,1,0,1,676,220,220,0
"91125ca626c5470eb145501f8c37f8db","d7f13c8d63ec4e2aa673fbb9cf9c6933",22857180,1,-18,0,677,220,206,-14
"d7f13c8d63ec4e2aa673fbb9cf9c6933","1c6721b1f63f4d30ba7746ea8af02a52",22857180,1,21,0,678,206,221,15
"1c6721b1f63f4d30ba7746ea8af02a52","77ecef8eff6b4a2caea7707669bf7475",22857180,1,1,0,679,221,222,1
"77ecef8eff6b4a2caea7707669bf7475","77ecef8eff6b4a2caea7707669bf7475",22857180,12,0,1,680,222,222,0
"8b9ae98743bd4d4a8a87dff1c1244211","1c6721b1f63f4d30ba7746ea8af02a52",22857180,1,-7,0,694,227,221,-6
"d03cb855c70044cf8c35d9ec0de696e3","a49a937d6896486d9a5396654abcf2e1",22857180,1,2,0,696,224,226,2
"a49a937d6896486d9a5396654abcf2e1","a49a937d6896486d9a5396654abcf2e1",22857180,1,0,1,697,226,226,0
"a49a937d6896486d9a5396654abcf2e1","8b9ae98743bd4d4a8a87dff1c1244211",22857180,1,1,0,698,226,227,1
"8b9ae98743bd4d4a8a87dff1c1244211","8b9ae98743bd4d4a8a87dff1c1244211",22857180,25,0,1,699,227,227,0
"f7906d6f59b9489a91d2ef40db5a474d","2ab1535aac1346ba8801535bf729ef37",22857180,1,7,0,726,223,229,6
"2ab1535aac1346ba8801535bf729ef37","2ab1535aac1346ba8801535bf729ef37",22857180,2,0,1,727,229,229,0
"2ab1535aac1346ba8801535bf729ef37","a4f40fb48a8542c8949bae1f002cd9bc",22857180,1,2,0,729,229,231,2
"a4f40fb48a8542c8949bae1f002cd9bc","a4f40fb48a8542c8949bae1f002cd9bc",22857180,2,0,1,730,231,231,0
"a4f40fb48a8542c8949bae1f002cd9bc","8972c23e32044edb8a78fa1eed4e5947",22857180,1,1,0,732,231,232,1
"8972c23e32044edb8a78fa1eed4e5947","8972c23e32044edb8a78fa1eed4e5947",22857180,1,0,1,733,232,232,0
"8972c23e32044edb8a78fa1eed4e5947","92feb4a40f8344d38b6f722e42a53295",22857180,1,1,0,734,232,233,1
"92feb4a40f8344d38b6f722e42a53295","92feb4a40f8344d38b6f722e42a53295",22857180,2,0,1,735,233,233,0
"92feb4a40f8344d38b6f722e42a53295","5152833676bf4c6cb317060be10f68db",22857180,1,-5,0,737,233,228,-5
"5152833676bf4c6cb317060be10f68db","ca3e28f290354c08aefe5b0f769604e6",22857180,1,8,0,738,228,235,7
"ca3e28f290354c08aefe5b0f769604e6","ca3e28f290354c08aefe5b0f769604e6",22857180,4,0,1,739,235,235,0
"ca3e28f290354c08aefe5b0f769604e6","79a35eea833e4c2c9d22fc53c3c6445c",22857180,1,1,0,743,235,236,1
"79a35eea833e4c2c9d22fc53c3c6445c","79a35eea833e4c2c9d22fc53c3c6445c",22857180,4,0,1,744,236,236,0
"79a35eea833e4c2c9d22fc53c3c6445c","8f68228b1518449e9615cdafee41a2bd",22857180,1,1,0,748,236,237,1
"8f68228b1518449e9615cdafee41a2bd","8f68228b1518449e9615cdafee41a2bd",22857180,1,0,1,749,237,237,0
"8f68228b1518449e9615cdafee41a2bd","cab89fa5c3ed45a5aa550fc0352d6a42",22857180,1,1,0,750,237,238,1
"cab89fa5c3ed45a5aa550fc0352d6a42","cab89fa5c3ed45a5aa550fc0352d6a42",22857180,1,0,1,751,238,238,0
"cab89fa5c3ed45a5aa550fc0352d6a42","66d4fad4f1cf4b46be0750a99ad7a35a",22857180,1,1,0,752,238,239,1
"66d4fad4f1cf4b46be0750a99ad7a35a","66d4fad4f1cf4b46be0750a99ad7a35a",22857180,1,0,1,753,239,239,0
"66d4fad4f1cf4b46be0750a99ad7a35a","0b04c8e2f86d48c7aeb7e225819cd32b",22857180,1,-5,0,754,239,234,-5
"0b04c8e2f86d48c7aeb7e225819cd32b","f53da5fd9bfe412da4b80d4742563b6c",22857180,1,8,0,755,234,241,7
"f53da5fd9bfe412da4b80d4742563b6c","f53da5fd9bfe412da4b80d4742563b6c",22857180,1,0,1,756,241,241,0
"f53da5fd9bfe412da4b80d4742563b6c","1c6721b1f63f4d30ba7746ea8af02a52",22857180,1,-24,0,757,241,221,-20
"1ebf23f9d994469a85206e4c7b1bf5f5","1ebf23f9d994469a85206e4c7b1bf5f5",22857180,10,0,1,760,245,245,0
"1ebf23f9d994469a85206e4c7b1bf5f5","85ae675b83e8422da842cfd25596af99",22857180,1,1,0,770,245,246,1
"85ae675b83e8422da842cfd25596af99","85ae675b83e8422da842cfd25596af99",22857180,1,0,1,771,246,246,0
"85ae675b83e8422da842cfd25596af99","2ae94c0cea4d480a9d5dca8fb1d7b542",22857180,1,-4,0,772,246,242,-4
"2ae94c0cea4d480a9d5dca8fb1d7b542","fa235f0f364d47e4ae1c87f47bf8e6ba",22857180,1,12,0,773,242,252,10
"fa235f0f364d47e4ae1c87f47bf8e6ba","fa235f0f364d47e4ae1c87f47bf8e6ba",22857180,3,0,1,774,252,252,0
"fa235f0f364d47e4ae1c87f47bf8e6ba","79f7845465cc4ed19d8e4f1429541be0",22857180,1,2,0,777,252,254,2
"79f7845465cc4ed19d8e4f1429541be0","79f7845465cc4ed19d8e4f1429541be0",22857180,2,0,1,778,254,254,0
"79f7845465cc4ed19d8e4f1429541be0","6e83e23f56544a19b94067c1c558d9c0",22857180,1,-8,0,780,254,247,-7
"00f61990949545828dd12f1303d47504","00f61990949545828dd12f1303d47504",22857180,1,0,1,782,256,256,0
"00f61990949545828dd12f1303d47504","ead7bb4b64e247d2ae632ab8a296b091",22857180,1,2,0,783,256,258,2
"ead7bb4b64e247d2ae632ab8a296b091","ead7bb4b64e247d2ae632ab8a296b091",22857180,2,0,1,784,258,258,0
"ead7bb4b64e247d2ae632ab8a296b091","41b0048dde734bb280bac6116baa8e27",22857180,1,1,0,786,258,259,1
"41b0048dde734bb280bac6116baa8e27","41b0048dde734bb280bac6116baa8e27",22857180,2,0,1,787,259,259,0
"41b0048dde734bb280bac6116baa8e27","b41c5a094a604ee0915327da5cc0beb7",22857180,1,1,0,789,259,260,1
"b41c5a094a604ee0915327da5cc0beb7","b41c5a094a604ee0915327da5cc0beb7",22857180,2,0,1,790,260,260,0
"b41c5a094a604ee0915327da5cc0beb7","d546341988904f069cfa86b21457d9d9",22857180,1,-10,0,792,260,251,-9
"d546341988904f069cfa86b21457d9d9","28c171777c52431ab6b925073bd63d46",22857180,1,15,0,793,251,264,13
"28c171777c52431ab6b925073bd63d46","28c171777c52431ab6b925073bd63d46",22857180,3,0,1,794,264,264,0
"28c171777c52431ab6b925073bd63d46","ac160db940cb49ae8579162b1d52bb5d",22857180,1,2,0,797,264,266,2
"ac160db940cb49ae8579162b1d52bb5d","ac160db940cb49ae8579162b1d52bb5d",22857180,3,0,1,798,266,266,0
"ac160db940cb49ae8579162b1d52bb5d","d989ebcfc12a4b669f0100dc1aa14f1e",22857180,1,-12,0,801,266,255,-11
"d989ebcfc12a4b669f0100dc1aa14f1e","c6fd49b485cc4874b0bbdd9c6171e09c",22857180,1,15,0,802,255,268,13
"c6fd49b485cc4874b0bbdd9c6171e09c","c6fd49b485cc4874b0bbdd9c6171e09c",22857180,3,0,1,803,268,268,0
"c6fd49b485cc4874b0bbdd9c6171e09c","44240778a97c4af0937817499b75707b",22857180,1,1,0,806,268,269,1
"44240778a97c4af0937817499b75707b","44240778a97c4af0937817499b75707b",22857180,2,0,1,807,269,269,0
"44240778a97c4af0937817499b75707b","7aa76d3e993840d8805f097cbdbcd44b",22857180,1,-9,0,809,269,261,-8
"7aa76d3e993840d8805f097cbdbcd44b","865a4d3b43374da7944dc7d397f566d9",22857180,1,12,0,810,261,271,10
"865a4d3b43374da7944dc7d397f566d9","865a4d3b43374da7944dc7d397f566d9",22857180,1,0,1,811,271,271,0
"865a4d3b43374da7944dc7d397f566d9","2ae94c0cea4d480a9d5dca8fb1d7b542",22857180,1,-35,0,812,271,242,-29
"bb5a47f5ea01454a8b79455422d3b9da","94cecc3f1e7d484b8e068e79241dfd73",22857180,1,3,0,895,280,281,1
"94cecc3f1e7d484b8e068e79241dfd73","0d987bed3ffa4ed0b9a2e62e97b7b30f",22857180,1,-13,0,896,281,272,-9
"0d987bed3ffa4ed0b9a2e62e97b7b30f","a37477c4e4c14169ad44b06b493007f6",22857180,1,15,0,897,272,283,11
"a37477c4e4c14169ad44b06b493007f6","94cecc3f1e7d484b8e068e79241dfd73",22857180,1,-2,0,898,283,281,-2
"fab84b4fab5940efb4ea868ef8d09396","fab84b4fab5940efb4ea868ef8d09396",22857180,1,0,1,900,284,284,0
"208c9b2796c944db8dacaa96082520ea","d7f13c8d63ec4e2aa673fbb9cf9c6933",22857180,1,-111,0,903,288,206,-82
"d7f13c8d63ec4e2aa673fbb9cf9c6933","01b2051f8941460d89945e3b02d1ce78",22857180,1,14,0,904,206,217,11
"01b2051f8941460d89945e3b02d1ce78","363837c182e04711840d896ae1e0339c",22857180,1,1,0,905,217,218,1
"363837c182e04711840d896ae1e0339c","0c7262dff33c4087bc660ccf40f92f9c",22857180,1,-64,0,906,218,169,-49
"0c7262dff33c4087bc660ccf40f92f9c","0c7262dff33c4087bc660ccf40f92f9c",22857180,1,0,1,907,169,169,0
"0c7262dff33c4087bc660ccf40f92f9c","139b097acfca451689d80c9c6eebdf7b",22857180,2,11,0,908,169,178,9
"139b097acfca451689d80c9c6eebdf7b","ea38cc0e6e6e41edbabf210220808bf9",22857180,1,1,0,909,178,179,1
"139b097acfca451689d80c9c6eebdf7b","0c7262dff33c4087bc660ccf40f92f9c",22857180,3,-11,0,912,178,169,-9
"0c7262dff33c4087bc660ccf40f92f9c","ea38cc0e6e6e41edbabf210220808bf9",22857180,1,12,0,915,169,179,10
"0c7262dff33c4087bc660ccf40f92f9c","0d987bed3ffa4ed0b9a2e62e97b7b30f",22857180,1,135,0,919,169,272,103
"208c9b2796c944db8dacaa96082520ea","208c9b2796c944db8dacaa96082520ea",22857180,1,0,1,938,288,288,0
"4a29443515bb404cb8924e1c60a63b73","7669a956527947d0add87455277e80b4",22857180,1,7,0,940,285,291,6
"7669a956527947d0add87455277e80b4","7669a956527947d0add87455277e80b4",22857180,3,0,1,941,291,291,0
"7669a956527947d0add87455277e80b4","6a9a3b5bde4a48daa896fe8c06eca56f",22857180,1,-2,0,944,291,289,-2
"869e967078f04da18dd0b0b9389a7424","869e967078f04da18dd0b0b9389a7424",22857180,1,0,1,946,293,293,0
"869e967078f04da18dd0b0b9389a7424","51ab6291537748fab90d519aa09889d6",22857180,1,2,0,947,293,295,2
"51ab6291537748fab90d519aa09889d6","51ab6291537748fab90d519aa09889d6",22857180,5,0,1,948,295,295,0
"51ab6291537748fab90d519aa09889d6","34a6e49023fc4465bd5ca604330bbd1c",22857180,1,-3,0,953,295,292,-3
"21592f2a9e9c4b2f8c66ec5dbcbf6a2b","ba0e59461bfb4a44b7b1c28a01f8d3b3",22857180,1,4,0,956,296,299,3
"ba0e59461bfb4a44b7b1c28a01f8d3b3","0e0b36e731a645e7b1b8a88f5031ca38",22857180,1,2,0,957,299,301,2
"0e0b36e731a645e7b1b8a88f5031ca38","0e0b36e731a645e7b1b8a88f5031ca38",22857180,6,0,1,958,301,301,0
"0e0b36e731a645e7b1b8a88f5031ca38","a66a144637284c21afc6de17fea4bfb8",22857180,1,1,0,964,301,302,1
"a66a144637284c21afc6de17fea4bfb8","a66a144637284c21afc6de17fea4bfb8",22857180,2,0,1,965,302,302,0
"a66a144637284c21afc6de17fea4bfb8","7646a919d7e64fa990bca9b024ff089d",22857180,1,-4,0,967,302,298,-4
"7646a919d7e64fa990bca9b024ff089d","e390b575229748ea8aac9364efe2bf00",22857180,1,7,0,968,298,304,6
"e390b575229748ea8aac9364efe2bf00","e390b575229748ea8aac9364efe2bf00",22857180,3,0,1,969,304,304,0
"e390b575229748ea8aac9364efe2bf00","4a29443515bb404cb8924e1c60a63b73",22857180,1,-24,0,972,304,285,-19
"53e7e900392747ccad52e711ab0f80d8","53e7e900392747ccad52e711ab0f80d8",22857180,1,0,1,975,307,307,0
"53e7e900392747ccad52e711ab0f80d8","3434c10e561d488a914e0f7d71907abd",22857180,1,-2,0,976,307,305,-2
"3434c10e561d488a914e0f7d71907abd","130acc2aeb0448fdbb2de63bc5cebe5b",22857180,1,5,0,977,305,309,4
"130acc2aeb0448fdbb2de63bc5cebe5b","130acc2aeb0448fdbb2de63bc5cebe5b",22857180,2,0,1,978,309,309,0
"130acc2aeb0448fdbb2de63bc5cebe5b","9c062b3251034ebe90f5054e2a3b5120",22857180,1,2,0,980,309,311,2
"9c062b3251034ebe90f5054e2a3b5120","9c062b3251034ebe90f5054e2a3b5120",22857180,2,0,1,981,311,311,0
"9c062b3251034ebe90f5054e2a3b5120","ea859f8207e44537889daeaba13ac2e8",22857180,1,1,0,983,311,312,1
"ea859f8207e44537889daeaba13ac2e8","ea859f8207e44537889daeaba13ac2e8",22857180,1,0,1,984,312,312,0
"ea859f8207e44537889daeaba13ac2e8","56d94971a7a94257aa330183a8ebd0ea",22857180,1,1,0,985,312,313,1
"56d94971a7a94257aa330183a8ebd0ea","56d94971a7a94257aa330183a8ebd0ea",22857180,1,0,1,986,313,313,0
"56d94971a7a94257aa330183a8ebd0ea","141c0df6cd1946539aadd1c9b7068cd4",22857180,1,-5,0,987,313,308,-5
"141c0df6cd1946539aadd1c9b7068cd4","13255e63e0aa4abf85e5211bf613d43e",22857180,1,10,0,988,308,317,9
"13255e63e0aa4abf85e5211bf613d43e","13255e63e0aa4abf85e5211bf613d43e",22857180,3,0,1,989,317,317,0
"13255e63e0aa4abf85e5211bf613d43e","0c787d16c9504873b1a4d903cec09948",22857180,1,-3,0,992,317,314,-3
"0c787d16c9504873b1a4d903cec09948","86c27d40179e419c8e9d150fb6afa5d0",22857180,1,6,0,993,314,319,5
"86c27d40179e419c8e9d150fb6afa5d0","86c27d40179e419c8e9d150fb6afa5d0",22857180,2,0,1,994,319,319,0
"86c27d40179e419c8e9d150fb6afa5d0","24f1363179ad4aaa965484a78471912b",22857180,1,5,0,996,319,323,4
"24f1363179ad4aaa965484a78471912b","8d7e0b55cf9849cda222a0f2440cec55",22857180,1,-6,0,997,323,318,-5
"8d7e0b55cf9849cda222a0f2440cec55","47edbb64109243e6b0f8f64cdef90c6c",22857180,1,9,0,998,318,326,8
"47edbb64109243e6b0f8f64cdef90c6c","24f1363179ad4aaa965484a78471912b",22857180,1,-3,0,999,326,323,-3
"24f1363179ad4aaa965484a78471912b","3628bdce1dd2429ba924d2d4d09448d2",22857180,1,-1,0,1000,323,322,-1
"3628bdce1dd2429ba924d2d4d09448d2","56b3fd1a212a4764be39d979fde3326e",22857180,1,7,0,1001,322,328,6
"56b3fd1a212a4764be39d979fde3326e","56b3fd1a212a4764be39d979fde3326e",22857180,1,0,1,1002,328,328,0
"56b3fd1a212a4764be39d979fde3326e","3434c10e561d488a914e0f7d71907abd",22857180,1,-28,0,1003,328,305,-23
"3434c10e561d488a914e0f7d71907abd","0c4079457ede49e3aeb5e86ed84bdf35",22857180,1,31,0,1004,305,329,24
"0c4079457ede49e3aeb5e86ed84bdf35","38aea304b4fa46e1b29bb72f5cea4c93",22857180,1,2,0,1005,329,331,2
"38aea304b4fa46e1b29bb72f5cea4c93","38aea304b4fa46e1b29bb72f5cea4c93",22857180,9,0,1,1006,331,331,0
"38aea304b4fa46e1b29bb72f5cea4c93","e36d261332f14e79bb4b467aceaeb9b5",22857180,1,2,0,1015,331,333,2
"e36d261332f14e79bb4b467aceaeb9b5","e36d261332f14e79bb4b467aceaeb9b5",22857180,1,0,1,1016,333,333,0
"e36d261332f14e79bb4b467aceaeb9b5","c7e89b9d04744d2eab742fc24e3ef1ae",22857180,1,1,0,1017,333,334,1
"c7e89b9d04744d2eab742fc24e3ef1ae","c7e89b9d04744d2eab742fc24e3ef1ae",22857180,3,0,1,1018,334,334,0
"c7e89b9d04744d2eab742fc24e3ef1ae","fe49f8054b374a0ea4bb266ed135ff62",22857180,1,1,0,1021,334,335,1
"fe49f8054b374a0ea4bb266ed135ff62","fe49f8054b374a0ea4bb266ed135ff62",22857180,2,0,1,1022,335,335,0
"fe49f8054b374a0ea4bb266ed135ff62","d0a8f74af98642fe8360d22c42e45117",22857180,1,1,0,1024,335,336,1
"d0a8f74af98642fe8360d22c42e45117","d0a8f74af98642fe8360d22c42e45117",22857180,2,0,1,1025,336,336,0
"d0a8f74af98642fe8360d22c42e45117","0c4079457ede49e3aeb5e86ed84bdf35",22857180,1,-7,0,1027,336,329,-7
"0c4079457ede49e3aeb5e86ed84bdf35","a7c6339ca1da4368a18d471f0519f877",22857180,1,11,0,1028,329,339,10
"a7c6339ca1da4368a18d471f0519f877","a7c6339ca1da4368a18d471f0519f877",22857180,1,0,1,1029,339,339,0
"a7c6339ca1da4368a18d471f0519f877","b8b9418ab322418d9db9b40d96af873a",22857180,1,-2,0,1030,339,337,-2
"b8b9418ab322418d9db9b40d96af873a","bbc5139ca9024389a94db3a6f47dcff6",22857180,1,5,0,1031,337,341,4
"bbc5139ca9024389a94db3a6f47dcff6","bbc5139ca9024389a94db3a6f47dcff6",22857180,2,0,1,1032,341,341,0
"bbc5139ca9024389a94db3a6f47dcff6","4ee6ca9019ab4a1ab323f98094a9bd77",22857180,1,2,0,1034,341,343,2
"4ee6ca9019ab4a1ab323f98094a9bd77","4ee6ca9019ab4a1ab323f98094a9bd77",22857180,2,0,1,1035,343,343,0
"4ee6ca9019ab4a1ab323f98094a9bd77","b37947176785476f8b29d49a851366dc",22857180,1,1,0,1037,343,344,1
"b37947176785476f8b29d49a851366dc","b37947176785476f8b29d49a851366dc",22857180,2,0,1,1038,344,344,0
"b37947176785476f8b29d49a851366dc","fcea5b10d5a14a3b9324ffece8f6e1e5",22857180,1,1,0,1040,344,345,1
"fcea5b10d5a14a3b9324ffece8f6e1e5","fcea5b10d5a14a3b9324ffece8f6e1e5",22857180,2,0,1,1041,345,345,0
"fcea5b10d5a14a3b9324ffece8f6e1e5","c2490bc612d146edbe786556fab3651b",22857180,1,-5,0,1043,345,340,-5
"c2490bc612d146edbe786556fab3651b","6ac8bb048b854999a47edb35fe627f11",22857180,1,8,0,1044,340,347,7
"6ac8bb048b854999a47edb35fe627f11","6ac8bb048b854999a47edb35fe627f11",22857180,1,0,1,1045,347,347,0
"6ac8bb048b854999a47edb35fe627f11","0c4079457ede49e3aeb5e86ed84bdf35",22857180,1,-21,0,1046,347,329,-18
"0c4079457ede49e3aeb5e86ed84bdf35","30ead9794d4847abaf222ca966cc8630",22857180,1,24,0,1047,329,348,19
"30ead9794d4847abaf222ca966cc8630","09b9678ddc3d452ea4a3d46e15826065",22857180,1,5,0,1048,348,353,5
"09b9678ddc3d452ea4a3d46e15826065","eff0de7f2dbb42dfa1a2e686efab5b6d",22857180,2,1,0,1049,353,354,1
"eff0de7f2dbb42dfa1a2e686efab5b6d","897b7f51242c44aab2205c72fdcbf4cd",22857180,1,-2,0,1050,354,352,-2
"897b7f51242c44aab2205c72fdcbf4cd","c20993c944444fe085345591a8bd837e",22857180,1,-1,0,1051,352,351,-1
"c20993c944444fe085345591a8bd837e","c20993c944444fe085345591a8bd837e",22857180,4,0,1,1052,351,351,0
"c20993c944444fe085345591a8bd837e","897b7f51242c44aab2205c72fdcbf4cd",22857180,1,1,0,1056,351,352,1
"897b7f51242c44aab2205c72fdcbf4cd","897b7f51242c44aab2205c72fdcbf4cd",22857180,3,0,1,1057,352,352,0
"897b7f51242c44aab2205c72fdcbf4cd","09b9678ddc3d452ea4a3d46e15826065",22857180,1,1,0,1060,352,353,1
"09b9678ddc3d452ea4a3d46e15826065","09b9678ddc3d452ea4a3d46e15826065",22857180,3,0,1,1061,353,353,0
"eff0de7f2dbb42dfa1a2e686efab5b6d","eff0de7f2dbb42dfa1a2e686efab5b6d",22857180,3,0,1,1065,354,354,0
"eff0de7f2dbb42dfa1a2e686efab5b6d","30ead9794d4847abaf222ca966cc8630",22857180,1,-6,0,1068,354,348,-6
"30ead9794d4847abaf222ca966cc8630","2fe14166dc9642c3bc666b86a57f943d",22857180,1,10,0,1069,348,357,9
"2fe14166dc9642c3bc666b86a57f943d","2fe14166dc9642c3bc666b86a57f943d",22857180,3,0,1,1070,357,357,0
"2fe14166dc9642c3bc666b86a57f943d","44421dd1e13a47a388c4a19834b744c7",22857180,1,2,0,1073,357,359,2
"44421dd1e13a47a388c4a19834b744c7","44421dd1e13a47a388c4a19834b744c7",22857180,2,0,1,1074,359,359,0
"44421dd1e13a47a388c4a19834b744c7","cb5fc7ef85d547c4be1a7439d0bf6052",22857180,1,1,0,1076,359,360,1
"cb5fc7ef85d547c4be1a7439d0bf6052","cb5fc7ef85d547c4be1a7439d0bf6052",22857180,2,0,1,1077,360,360,0
"cb5fc7ef85d547c4be1a7439d0bf6052","0a8f150a4cf747acbde62f4721823da3",22857180,1,1,0,1079,360,361,1
"0a8f150a4cf747acbde62f4721823da3","0a8f150a4cf747acbde62f4721823da3",22857180,2,0,1,1080,361,361,0
"0a8f150a4cf747acbde62f4721823da3","1ba8fef685d74a8194b9db252eb704fb",22857180,1,-6,0,1082,361,355,-6
"1ba8fef685d74a8194b9db252eb704fb","52580888dadb4fe3baa795683ea227bd",22857180,1,10,0,1083,355,364,9
"52580888dadb4fe3baa795683ea227bd","52580888dadb4fe3baa795683ea227bd",22857180,5,0,1,1084,364,364,0
"52580888dadb4fe3baa795683ea227bd","f00179e251a045b39c3f7a54f9aa4acc",22857180,1,-1,0,1089,364,363,-1
"f00179e251a045b39c3f7a54f9aa4acc","492a3bc6a1254f23a7998587961b22a4",22857180,1,4,0,1090,363,366,3
"492a3bc6a1254f23a7998587961b22a4","492a3bc6a1254f23a7998587961b22a4",22857180,1,0,1,1091,366,366,0
"492a3bc6a1254f23a7998587961b22a4","072a190fd302456290895f9f04d6940a",22857180,1,-1,0,1092,366,365,-1
"072a190fd302456290895f9f04d6940a","cfa457d1743848e4bb5e4beced6448ed",22857180,1,5,0,1093,365,369,4
"cfa457d1743848e4bb5e4beced6448ed","cfa457d1743848e4bb5e4beced6448ed",22857180,1,0,1,1094,369,369,0
"cfa457d1743848e4bb5e4beced6448ed","30ead9794d4847abaf222ca966cc8630",22857180,1,-25,0,1095,369,348,-21
"30ead9794d4847abaf222ca966cc8630","b71bac264efb4abd97015447bd490db6",22857180,1,28,0,1096,348,370,22
"b71bac264efb4abd97015447bd490db6","8d448d625b024c82a5eb240bbd7431d6",22857180,2,5,0,1097,370,374,4
"8d448d625b024c82a5eb240bbd7431d6","8d448d625b024c82a5eb240bbd7431d6",22857180,59,0,1,1098,374,374,0
"8d448d625b024c82a5eb240bbd7431d6","b71bac264efb4abd97015447bd490db6",22857180,2,-5,0,1099,374,370,-4
"b71bac264efb4abd97015447bd490db6","d6d02b6ef04e4f17805504500b8ce441",22857180,1,8,0,1160,370,375,5
"d6d02b6ef04e4f17805504500b8ce441","d6d02b6ef04e4f17805504500b8ce441",22857180,5,0,1,1161,375,375,0
"d6d02b6ef04e4f17805504500b8ce441","66baf19b6b904b70922329068c63746d",22857180,1,4,0,1166,375,376,1
"66baf19b6b904b70922329068c63746d","7f544639412e40a9ba27f43b415362ab",22857180,4,2,0,1167,376,378,2
"7f544639412e40a9ba27f43b415362ab","66baf19b6b904b70922329068c63746d",22857180,3,-2,0,1168,378,376,-2
"66baf19b6b904b70922329068c63746d","66baf19b6b904b70922329068c63746d",22857180,2,0,1,1169,376,376,0
"7f544639412e40a9ba27f43b415362ab","7f544639412e40a9ba27f43b415362ab",22857180,2,0,1,1172,378,378,0
"7f544639412e40a9ba27f43b415362ab","d5ae8642e15b46b8bd298b02274d4e9c",22857180,1,2,0,1174,378,380,2
"d5ae8642e15b46b8bd298b02274d4e9c","d5ae8642e15b46b8bd298b02274d4e9c",22857180,1,0,1,1175,380,380,0
"d5ae8642e15b46b8bd298b02274d4e9c","a0d10309a2dd456289147f84be9d37f9",22857180,1,1,0,1176,380,381,1
"a0d10309a2dd456289147f84be9d37f9","a0d10309a2dd456289147f84be9d37f9",22857180,2,0,1,1177,381,381,0
"a0d10309a2dd456289147f84be9d37f9","0fcbc3ca07b144138b8d85da581f09a8",22857180,1,1,0,1179,381,382,1
"0fcbc3ca07b144138b8d85da581f09a8","0fcbc3ca07b144138b8d85da581f09a8",22857180,2,0,1,1180,382,382,0
"0fcbc3ca07b144138b8d85da581f09a8","66baf19b6b904b70922329068c63746d",22857180,1,-6,0,1182,382,376,-6
"66baf19b6b904b70922329068c63746d","4890121ce5d74576b4632b77cfc23398",22857180,1,14,0,1183,376,388,12
"4890121ce5d74576b4632b77cfc23398","c2fca3669923477ab966ded303dea31c",22857180,1,-6,0,1184,388,383,-5
"c2fca3669923477ab966ded303dea31c","4890121ce5d74576b4632b77cfc23398",22857180,2,6,0,1185,383,388,5
"4890121ce5d74576b4632b77cfc23398","4890121ce5d74576b4632b77cfc23398",22857180,1,0,1,1186,388,388,0
"4890121ce5d74576b4632b77cfc23398","18d3b836dd804224883cc9180b60a8e1",22857180,1,-1,0,1187,388,387,-1
"18d3b836dd804224883cc9180b60a8e1","96bb2b3e85a34d8b9544514e89f6fe97",22857180,1,4,0,1188,387,390,3
"96bb2b3e85a34d8b9544514e89f6fe97","96bb2b3e85a34d8b9544514e89f6fe97",22857180,1,0,1,1189,390,390,0
"96bb2b3e85a34d8b9544514e89f6fe97","ac4e9b54acfe4670b4634859c7263cb5",22857180,1,2,0,1190,390,392,2
"ac4e9b54acfe4670b4634859c7263cb5","ac4e9b54acfe4670b4634859c7263cb5",22857180,4,0,1,1191,392,392,0
"ac4e9b54acfe4670b4634859c7263cb5","17f95d18bab743888e1736033dc3384d",22857180,1,-3,0,1195,392,389,-3
"17f95d18bab743888e1736033dc3384d","6f8881a745ac4c358a68b92c3b4abe81",22857180,1,6,0,1196,389,394,5
"6f8881a745ac4c358a68b92c3b4abe81","6f8881a745ac4c358a68b92c3b4abe81",22857180,2,0,1,1197,394,394,0
"6f8881a745ac4c358a68b92c3b4abe81","f7002c8484354eceac57bc7bd62c76c1",22857180,2,-1,0,1199,394,393,-1
"f7002c8484354eceac57bc7bd62c76c1","66baf19b6b904b70922329068c63746d",22857180,1,-21,0,1200,393,376,-17
"66baf19b6b904b70922329068c63746d","6f8881a745ac4c358a68b92c3b4abe81",22857180,1,22,0,1205,376,394,18
"f7002c8484354eceac57bc7bd62c76c1","44a277ea44dc4ae689fab4b82f0b4098",22857180,1,5,0,1207,393,397,4
"44a277ea44dc4ae689fab4b82f0b4098","44a277ea44dc4ae689fab4b82f0b4098",22857180,1,0,1,1208,397,397,0
"44a277ea44dc4ae689fab4b82f0b4098","0c12af0a4e7f4002852cf84b2537c161",22857180,1,-2,0,1209,397,395,-2
"0c12af0a4e7f4002852cf84b2537c161","859e0b8d71694b12befb69ee698138f9",22857180,1,5,0,1210,395,399,4
"859e0b8d71694b12befb69ee698138f9","859e0b8d71694b12befb69ee698138f9",22857180,1,0,1,1211,399,399,0
"859e0b8d71694b12befb69ee698138f9","2b09a08242b54983aec7063990fb3f66",22857180,1,3,0,1212,399,400,1
"2b09a08242b54983aec7063990fb3f66","66baf19b6b904b70922329068c63746d",22857180,2,-32,0,1213,400,376,-24
"66baf19b6b904b70922329068c63746d","2b09a08242b54983aec7063990fb3f66",22857180,2,32,0,1214,376,400,24
"2b09a08242b54983aec7063990fb3f66","2b09a08242b54983aec7063990fb3f66",22857180,3,0,1,1215,400,400,0
"2b09a08242b54983aec7063990fb3f66","1f471b7a883a4df48211e8c6a81b59a7",22857180,1,1,0,1216,400,401,1
"1f471b7a883a4df48211e8c6a81b59a7","1f471b7a883a4df48211e8c6a81b59a7",22857180,1,0,1,1217,401,401,0
"1f471b7a883a4df48211e8c6a81b59a7","2b09a08242b54983aec7063990fb3f66",22857180,1,-1,0,1218,401,400,-1
"2b09a08242b54983aec7063990fb3f66","9de0d567bfa84fe5b77cb76f4a76a5d1",22857180,1,5,0,1219,400,404,4
"9de0d567bfa84fe5b77cb76f4a76a5d1","9de0d567bfa84fe5b77cb76f4a76a5d1",22857180,1,0,1,1220,404,404,0
"9de0d567bfa84fe5b77cb76f4a76a5d1","1157bd665ec4472fb58b751dc5099355",22857180,1,-1,0,1221,404,403,-1
"1157bd665ec4472fb58b751dc5099355","3c8a22d2f9c146ea956609e3ed4f2559",22857180,1,3,0,1222,403,405,2
"3c8a22d2f9c146ea956609e3ed4f2559","58fc9094275e4c49be3f4ba6d4acc0a4",22857180,2,2,0,1223,405,406,1
"58fc9094275e4c49be3f4ba6d4acc0a4","58fc9094275e4c49be3f4ba6d4acc0a4",22857180,3,0,1,1224,406,406,0
"58fc9094275e4c49be3f4ba6d4acc0a4","3c8a22d2f9c146ea956609e3ed4f2559",22857180,1,-2,0,1226,406,405,-1
"58fc9094275e4c49be3f4ba6d4acc0a4","c1c1be90b2b14c1ab4a5e1ee3c241902",22857180,1,1,0,1229,406,407,1
"c1c1be90b2b14c1ab4a5e1ee3c241902","c1c1be90b2b14c1ab4a5e1ee3c241902",22857180,5,0,1,1230,407,407,0
"c1c1be90b2b14c1ab4a5e1ee3c241902","58fc9094275e4c49be3f4ba6d4acc0a4",22857180,1,-1,0,1235,407,406,-1
"58fc9094275e4c49be3f4ba6d4acc0a4","02b3a1bead9244c1ba2f857c7da8f82a",22857180,1,3,0,1236,406,408,2
"02b3a1bead9244c1ba2f857c7da8f82a","02b3a1bead9244c1ba2f857c7da8f82a",22857180,1,0,1,1237,408,408,0
"02b3a1bead9244c1ba2f857c7da8f82a","6206fc6479014bb193084c32409dc1b9",22857180,1,1,0,1238,408,409,1
"6206fc6479014bb193084c32409dc1b9","6206fc6479014bb193084c32409dc1b9",22857180,1,0,1,1239,409,409,0
"6206fc6479014bb193084c32409dc1b9","02b3a1bead9244c1ba2f857c7da8f82a",22857180,1,-1,0,1240,409,408,-1
"02b3a1bead9244c1ba2f857c7da8f82a","6a5f020451db426dacba9e2ea3fcc62a",22857180,1,3,0,1241,408,410,2
"6a5f020451db426dacba9e2ea3fcc62a","6a5f020451db426dacba9e2ea3fcc62a",22857180,2,0,1,1242,410,410,0
"6a5f020451db426dacba9e2ea3fcc62a","33a9d248b2e44588a5b07fc1342b9bc2",22857180,1,2,0,1244,410,411,1
"33a9d248b2e44588a5b07fc1342b9bc2","33a9d248b2e44588a5b07fc1342b9bc2",22857180,4,0,1,1245,411,411,0
"33a9d248b2e44588a5b07fc1342b9bc2","c6f26bd420634f1cb7989e76fe6b16c0",22857180,1,1,0,1249,411,412,1
"c6f26bd420634f1cb7989e76fe6b16c0","c6f26bd420634f1cb7989e76fe6b16c0",22857180,5,0,1,1250,412,412,0
"c6f26bd420634f1cb7989e76fe6b16c0","2a65ee6e2ac64f6a8a55fbe5373ec763",22857180,1,1,0,1255,412,413,1
"2a65ee6e2ac64f6a8a55fbe5373ec763","2a65ee6e2ac64f6a8a55fbe5373ec763",22857180,2,0,1,1256,413,413,0
"2a65ee6e2ac64f6a8a55fbe5373ec763","33a9d248b2e44588a5b07fc1342b9bc2",22857180,1,-2,0,1258,413,411,-2
"33a9d248b2e44588a5b07fc1342b9bc2","1fd0f6dadbc14ebc965faf6122190b96",22857180,1,5,0,1259,411,415,4
"1fd0f6dadbc14ebc965faf6122190b96","1fd0f6dadbc14ebc965faf6122190b96",22857180,2,0,1,1260,415,415,0
"1fd0f6dadbc14ebc965faf6122190b96","687055dad9fc40c3982478fe33ec01bf",22857180,1,-1,0,1262,415,414,-1
"687055dad9fc40c3982478fe33ec01bf","2add1669f08d4101913db15f8c23b3b7",22857180,1,3,0,1263,414,416,2
"2add1669f08d4101913db15f8c23b3b7","2add1669f08d4101913db15f8c23b3b7",22857180,1,0,1,1264,416,416,0
"2add1669f08d4101913db15f8c23b3b7","2b09a08242b54983aec7063990fb3f66",22857180,1,-24,0,1265,416,400,-16
"2b09a08242b54983aec7063990fb3f66","a2b4bd40cee2481ebd3fc179d6a5cd62",22857180,1,27,0,1266,400,417,17
"a2b4bd40cee2481ebd3fc179d6a5cd62","e34e59dce2204f228f3a84b6725df60f",22857180,1,2,0,1267,417,419,2
"e34e59dce2204f228f3a84b6725df60f","e34e59dce2204f228f3a84b6725df60f",22857180,1,0,1,1268,419,419,0
"e34e59dce2204f228f3a84b6725df60f","bec48fc2e1294c7eb3d0aca780d731b8",22857180,1,2,0,1269,419,420,1
"bec48fc2e1294c7eb3d0aca780d731b8","a2b4bd40cee2481ebd3fc179d6a5cd62",22857180,1,-4,0,1270,420,417,-3
"a2b4bd40cee2481ebd3fc179d6a5cd62","bec48fc2e1294c7eb3d0aca780d731b8",22857180,1,4,0,1271,417,420,3
"bec48fc2e1294c7eb3d0aca780d731b8","bec48fc2e1294c7eb3d0aca780d731b8",22857180,16,0,1,1272,420,420,0
"bec48fc2e1294c7eb3d0aca780d731b8","a24600b0e49245f6bdba8c893cfeddb0",22857180,1,7,0,1288,420,425,5
"a24600b0e49245f6bdba8c893cfeddb0","dbde19fcce2a4c1abdc7f685c293a23f",22857180,1,-4,0,1289,425,422,-3
"dbde19fcce2a4c1abdc7f685c293a23f","a24600b0e49245f6bdba8c893cfeddb0",22857180,1,4,0,1290,422,425,3
"a24600b0e49245f6bdba8c893cfeddb0","a24600b0e49245f6bdba8c893cfeddb0",22857180,9,0,1,1291,425,425,0
"a24600b0e49245f6bdba8c893cfeddb0","a2b4bd40cee2481ebd3fc179d6a5cd62",22857180,1,-11,0,1300,425,417,-8
"a2b4bd40cee2481ebd3fc179d6a5cd62","24cf8786024543f19b89bc20034e60d7",22857180,1,18,0,1301,417,428,11
"24cf8786024543f19b89bc20034e60d7","f2a73be2f46840b182d7bd095378004e",22857180,1,1,0,1302,428,429,1
"f2a73be2f46840b182d7bd095378004e","f2a73be2f46840b182d7bd095378004e",22857180,6,0,1,1303,429,429,0
"f2a73be2f46840b182d7bd095378004e","604551fd4266430cb860fef58fa7dd61",22857180,1,1,0,1309,429,430,1
"604551fd4266430cb860fef58fa7dd61","604551fd4266430cb860fef58fa7dd61",22857180,1,0,1,1310,430,430,0
"604551fd4266430cb860fef58fa7dd61","24cf8786024543f19b89bc20034e60d7",22857180,1,-2,0,1311,430,428,-2
"24cf8786024543f19b89bc20034e60d7","dce46f8904594a62a6377a3587aaa663",22857180,1,4,0,1312,428,431,3
"dce46f8904594a62a6377a3587aaa663","dce46f8904594a62a6377a3587aaa663",22857180,1,0,1,1313,431,431,0
"dce46f8904594a62a6377a3587aaa663","9b9d0a249052413c869753b99682b0ac",22857180,1,1,0,1314,431,432,1
"9b9d0a249052413c869753b99682b0ac","9b9d0a249052413c869753b99682b0ac",22857180,8,0,1,1315,432,432,0
"9b9d0a249052413c869753b99682b0ac","061c175cc90f45fbad883025394e78dd",22857180,1,1,0,1323,432,433,1
"061c175cc90f45fbad883025394e78dd","061c175cc90f45fbad883025394e78dd",22857180,1,0,1,1324,433,433,0
"061c175cc90f45fbad883025394e78dd","dce46f8904594a62a6377a3587aaa663",22857180,1,-2,0,1325,433,431,-2
"dce46f8904594a62a6377a3587aaa663","74a7f8712e5449c2bc0b43c6f90dafed",22857180,1,5,0,1326,431,435,4
"74a7f8712e5449c2bc0b43c6f90dafed","74a7f8712e5449c2bc0b43c6f90dafed",22857180,1,0,1,1327,435,435,0
"74a7f8712e5449c2bc0b43c6f90dafed","66ada10dde9f43018588f1ced9d477fc",22857180,1,-1,0,1328,435,434,-1
"66ada10dde9f43018588f1ced9d477fc","bf12c96466d840a69bed7020b3f18bb8",22857180,1,3,0,1329,434,436,2
"bf12c96466d840a69bed7020b3f18bb8","bf12c96466d840a69bed7020b3f18bb8",22857180,2,0,1,1330,436,436,0
"bf12c96466d840a69bed7020b3f18bb8","24cf8786024543f19b89bc20034e60d7",22857180,1,-11,0,1332,436,428,-8
"24cf8786024543f19b89bc20034e60d7","070600601c4c439288445d2f0724807d",22857180,1,14,0,1333,428,437,9
"070600601c4c439288445d2f0724807d","1823b6de7d334a7aaabc4570719af4d9",22857180,1,2,0,1334,437,439,2
"1823b6de7d334a7aaabc4570719af4d9","1823b6de7d334a7aaabc4570719af4d9",22857180,11,0,1,1335,439,439,0
"1823b6de7d334a7aaabc4570719af4d9","0380cd76a7d44bc3a4da1f15e4d68f89",22857180,1,2,0,1346,439,440,1
"0380cd76a7d44bc3a4da1f15e4d68f89","070600601c4c439288445d2f0724807d",22857180,1,-4,0,1347,440,437,-3
"070600601c4c439288445d2f0724807d","0380cd76a7d44bc3a4da1f15e4d68f89",22857180,1,4,0,1348,437,440,3
"0380cd76a7d44bc3a4da1f15e4d68f89","0380cd76a7d44bc3a4da1f15e4d68f89",22857180,2,0,1,1349,440,440,0
"0380cd76a7d44bc3a4da1f15e4d68f89","23b7673c8b5443108c2ef09382834a86",22857180,1,2,0,1351,440,441,1
"23b7673c8b5443108c2ef09382834a86","23b7673c8b5443108c2ef09382834a86",22857180,2,0,1,1352,441,441,0
"23b7673c8b5443108c2ef09382834a86","901e92500aea43c79f19f1b279050668",22857180,1,2,0,1354,441,442,1
"901e92500aea43c79f19f1b279050668","901e92500aea43c79f19f1b279050668",22857180,1,0,1,1355,442,442,0
"901e92500aea43c79f19f1b279050668","001339db8ced4cf78829ebe8b145449d",22857180,1,1,0,1356,442,443,1
"001339db8ced4cf78829ebe8b145449d","001339db8ced4cf78829ebe8b145449d",22857180,2,0,1,1357,443,443,0
"001339db8ced4cf78829ebe8b145449d","452745e0366e42ae81561bfddebcc6c3",22857180,1,1,0,1359,443,444,1
"452745e0366e42ae81561bfddebcc6c3","452745e0366e42ae81561bfddebcc6c3",22857180,2,0,1,1360,444,444,0
"452745e0366e42ae81561bfddebcc6c3","901e92500aea43c79f19f1b279050668",22857180,1,-2,0,1362,444,442,-2
"901e92500aea43c79f19f1b279050668","4660ff2089114e8db82ceb26a4f329e3",22857180,1,4,0,1363,442,445,3
"4660ff2089114e8db82ceb26a4f329e3","4660ff2089114e8db82ceb26a4f329e3",22857180,3,0,1,1364,445,445,0
"4660ff2089114e8db82ceb26a4f329e3","7bd5586eb9d8484eb74a433ee7bfe499",22857180,1,2,0,1367,445,446,1
"7bd5586eb9d8484eb74a433ee7bfe499","7bd5586eb9d8484eb74a433ee7bfe499",22857180,9,0,1,1368,446,446,0
"7bd5586eb9d8484eb74a433ee7bfe499","8a7f26e690f34dda97be16904518ca99",22857180,1,2,0,1377,446,447,1
"8a7f26e690f34dda97be16904518ca99","8a7f26e690f34dda97be16904518ca99",22857180,1,0,1,1378,447,447,0
"8a7f26e690f34dda97be16904518ca99","070600601c4c439288445d2f0724807d",22857180,1,-16,0,1379,447,437,-10
"070600601c4c439288445d2f0724807d","b2f0d654738f48158edff28e8d3a546e",22857180,1,21,0,1380,437,449,12
"b2f0d654738f48158edff28e8d3a546e","66baf19b6b904b70922329068c63746d",22857180,1,-112,0,1381,449,376,-73
"66baf19b6b904b70922329068c63746d","c2fca3669923477ab966ded303dea31c",22857180,1,8,0,1382,376,383,7
"4890121ce5d74576b4632b77cfc23398","96bb2b3e85a34d8b9544514e89f6fe97",22857180,1,3,0,1384,388,390,2
"96bb2b3e85a34d8b9544514e89f6fe97","18d3b836dd804224883cc9180b60a8e1",22857180,1,-4,0,1385,390,387,-3
"18d3b836dd804224883cc9180b60a8e1","6f8881a745ac4c358a68b92c3b4abe81",22857180,1,9,0,1386,387,394,7
"6f8881a745ac4c358a68b92c3b4abe81","17f95d18bab743888e1736033dc3384d",22857180,1,-6,0,1387,394,389,-5
"17f95d18bab743888e1736033dc3384d","f7002c8484354eceac57bc7bd62c76c1",22857180,1,5,0,1388,389,393,4
"f7002c8484354eceac57bc7bd62c76c1","0c12af0a4e7f4002852cf84b2537c161",22857180,1,3,0,1389,393,395,2
"0c12af0a4e7f4002852cf84b2537c161","66baf19b6b904b70922329068c63746d",22857180,1,-24,0,1390,395,376,-19
"66baf19b6b904b70922329068c63746d","b2f0d654738f48158edff28e8d3a546e",22857180,1,112,0,1395,376,449,73
"b2f0d654738f48158edff28e8d3a546e","b2f0d654738f48158edff28e8d3a546e",22857180,1,0,1,1396,449,449,0
"b2f0d654738f48158edff28e8d3a546e","f60ee41ec635499abd48168342d32c2f",22857180,2,5,0,1397,449,453,4
"f60ee41ec635499abd48168342d32c2f","f60ee41ec635499abd48168342d32c2f",22857180,53,0,1,1398,453,453,0
"f60ee41ec635499abd48168342d32c2f","b2f0d654738f48158edff28e8d3a546e",22857180,1,-5,0,1401,453,449,-4
"f60ee41ec635499abd48168342d32c2f","f67fbf45a5f146ed866965bc57c7c001",22857180,1,3,0,1453,453,454,1
"f67fbf45a5f146ed866965bc57c7c001","b2f0d654738f48158edff28e8d3a546e",22857180,1,-8,0,1454,454,449,-5
"b2f0d654738f48158edff28e8d3a546e","f67fbf45a5f146ed866965bc57c7c001",22857180,1,8,0,1455,449,454,5
"f67fbf45a5f146ed866965bc57c7c001","f67fbf45a5f146ed866965bc57c7c001",22857180,1,0,1,1456,454,454,0
"f67fbf45a5f146ed866965bc57c7c001","d937afe49bd24a07a550dda1c1155122",22857180,1,1,0,1457,454,455,1
"d937afe49bd24a07a550dda1c1155122","d937afe49bd24a07a550dda1c1155122",22857180,1,0,1,1458,455,455,0
"d937afe49bd24a07a550dda1c1155122","3628b3f7823443d0912a339096b69943",22857180,1,1,0,1459,455,456,1
"3628b3f7823443d0912a339096b69943","3628b3f7823443d0912a339096b69943",22857180,1,0,1,1460,456,456,0
"3628b3f7823443d0912a339096b69943","9e049ee647cf43ecbcb5ed792a8e7588",22857180,1,1,0,1461,456,457,1
"9e049ee647cf43ecbcb5ed792a8e7588","9e049ee647cf43ecbcb5ed792a8e7588",22857180,1,0,1,1462,457,457,0
"9e049ee647cf43ecbcb5ed792a8e7588","5256a214faaf410b93f76cea06428334",22857180,1,1,0,1463,457,458,1
"5256a214faaf410b93f76cea06428334","5256a214faaf410b93f76cea06428334",22857180,1,0,1,1464,458,458,0
"5256a214faaf410b93f76cea06428334","25c32b120fce40fa9b6c85133aeb4716",22857180,1,1,0,1465,458,459,1
"25c32b120fce40fa9b6c85133aeb4716","25c32b120fce40fa9b6c85133aeb4716",22857180,1,0,1,1466,459,459,0
"25c32b120fce40fa9b6c85133aeb4716","11bc14f2204949008b7d511b933363c1",22857180,1,1,0,1467,459,460,1
"11bc14f2204949008b7d511b933363c1","11bc14f2204949008b7d511b933363c1",22857180,1,0,1,1468,460,460,0
"11bc14f2204949008b7d511b933363c1","42de338840a34d15adb66e7b14fb9d2c",22857180,1,1,0,1469,460,461,1
"42de338840a34d15adb66e7b14fb9d2c","42de338840a34d15adb66e7b14fb9d2c",22857180,1,0,1,1470,461,461,0
"42de338840a34d15adb66e7b14fb9d2c","9da37c6210b1416b8079c274f70bf600",22857180,1,1,0,1471,461,462,1
"9da37c6210b1416b8079c274f70bf600","9da37c6210b1416b8079c274f70bf600",22857180,1,0,1,1472,462,462,0
"9da37c6210b1416b8079c274f70bf600","519119f1deac45ff9ab4f13529be5c6e",22857180,1,1,0,1473,462,463,1
"519119f1deac45ff9ab4f13529be5c6e","519119f1deac45ff9ab4f13529be5c6e",22857180,1,0,1,1474,463,463,0
"519119f1deac45ff9ab4f13529be5c6e","f67fbf45a5f146ed866965bc57c7c001",22857180,1,-9,0,1475,463,454,-9
"f67fbf45a5f146ed866965bc57c7c001","c5df9f40ec14463b9dcfdc73df3e9285",22857180,1,12,0,1476,454,464,10
"c5df9f40ec14463b9dcfdc73df3e9285","c5df9f40ec14463b9dcfdc73df3e9285",22857180,4,0,1,1477,464,464,0
"c5df9f40ec14463b9dcfdc73df3e9285","83d42d95cd844fc093fc09cee250edb8",22857180,2,3,0,1479,464,465,1
"83d42d95cd844fc093fc09cee250edb8","83d42d95cd844fc093fc09cee250edb8",22857180,6,0,1,1480,465,465,0
"83d42d95cd844fc093fc09cee250edb8","c5df9f40ec14463b9dcfdc73df3e9285",22857180,1,-3,0,1482,465,464,-1
"83d42d95cd844fc093fc09cee250edb8","d646286c8051419bbc2e31dd1db55ca8",22857180,1,-546,0,1490,465,67,-398
"d646286c8051419bbc2e31dd1db55ca8","6a9f0ef185fb47f0937e29daa1c71ed5",22857180,5,27,0,1491,67,90,23
"6a9f0ef185fb47f0937e29daa1c71ed5","6a9f0ef185fb47f0937e29daa1c71ed5",22857180,12,0,1,1492,90,90,0
"6a9f0ef185fb47f0937e29daa1c71ed5","ae5ac430ea254e708a6f5deaaf7464ae",22857180,1,-7,0,1493,90,84,-6
"ae5ac430ea254e708a6f5deaaf7464ae","6a9f0ef185fb47f0937e29daa1c71ed5",22857180,2,7,0,1494,84,90,6
"6a9f0ef185fb47f0937e29daa1c71ed5","d646286c8051419bbc2e31dd1db55ca8",22857180,4,-27,0,1495,90,67,-23
"d646286c8051419bbc2e31dd1db55ca8","e20db35ced8544ddac5bc3839145e463",22857180,4,30,0,1496,67,91,24
"e20db35ced8544ddac5bc3839145e463","00ae5f0c51874a73a41ebea838d95682",22857180,4,11,0,1497,91,101,10
"00ae5f0c51874a73a41ebea838d95682","e20db35ced8544ddac5bc3839145e463",22857180,1,-11,0,1498,101,91,-10
"e20db35ced8544ddac5bc3839145e463","d391c8b6e56a43a7b654e9dee02d904b",22857180,2,13,0,1499,91,103,12
"d391c8b6e56a43a7b654e9dee02d904b","4280927ec4d643238aa49c32f9e06c6c",22857180,1,7,0,1500,103,109,6
"4280927ec4d643238aa49c32f9e06c6c","73039f8c1eb9409cb4caee2cf968001e",22857180,3,-10,0,1501,109,100,-9
"73039f8c1eb9409cb4caee2cf968001e","08111f75e22d409998cf8b85bd431f0a",22857180,3,9,0,1502,100,108,8
"08111f75e22d409998cf8b85bd431f0a","a9ae0a3c070d455bb4369a8996313336",22857180,5,7,0,1503,108,114,6
"a9ae0a3c070d455bb4369a8996313336","37319e88176d4aefa91d7a9980dbae91",22857180,3,-2,0,1504,114,112,-2
"37319e88176d4aefa91d7a9980dbae91","62bff51286ef4f348717a3cf6fe2318f",22857180,3,9,0,1505,112,120,8
"62bff51286ef4f348717a3cf6fe2318f","62bff51286ef4f348717a3cf6fe2318f",22857180,8,0,1,1506,120,120,0
"62bff51286ef4f348717a3cf6fe2318f","779f9ddd1fd14d1e9e69f72219a1fdbd",22857180,4,3,0,1508,120,121,1
"779f9ddd1fd14d1e9e69f72219a1fdbd","e20db35ced8544ddac5bc3839145e463",22857180,3,-36,0,1509,121,91,-30
"e20db35ced8544ddac5bc3839145e463","a8dd5213034441ac92724b4e83eb0bb2",22857180,2,45,0,1510,91,129,38
"a8dd5213034441ac92724b4e83eb0bb2","779f9ddd1fd14d1e9e69f72219a1fdbd",22857180,2,-9,0,1511,129,121,-8
"779f9ddd1fd14d1e9e69f72219a1fdbd","b416d47c56a742199b5d7c7f19d6503a",22857180,2,15,0,1512,121,134,13
"b416d47c56a742199b5d7c7f19d6503a","579338175e0b4bbb8ef3b712b5d8b54e",22857180,1,-7,0,1513,134,128,-6
"579338175e0b4bbb8ef3b712b5d8b54e","779f9ddd1fd14d1e9e69f72219a1fdbd",22857180,1,-8,0,1514,128,121,-7
"779f9ddd1fd14d1e9e69f72219a1fdbd","df1de691dafe4549a18a4398ee9dfaf9",22857180,4,23,0,1515,121,139,18
"df1de691dafe4549a18a4398ee9dfaf9","6c5ad271a44743479bfaea29b1db8d02",22857180,4,4,0,1516,139,143,4
"6c5ad271a44743479bfaea29b1db8d02","8aae34f5ddbb4052a709b12e6b0d40fa",22857180,1,5,0,1517,143,147,4
"8aae34f5ddbb4052a709b12e6b0d40fa","df1de691dafe4549a18a4398ee9dfaf9",22857180,2,-9,0,1518,147,139,-8
"df1de691dafe4549a18a4398ee9dfaf9","f902b0f41b544d4dbf79664fd233648d",22857180,2,8,0,1519,139,146,7
"f902b0f41b544d4dbf79664fd233648d","d313cec988a84645bee413e8d4724a4b",22857180,2,14,0,1520,146,158,12
"d313cec988a84645bee413e8d4724a4b","d313cec988a84645bee413e8d4724a4b",22857180,7,0,1,1521,158,158,0
"d313cec988a84645bee413e8d4724a4b","f03480cf4eba413194d7af52fc0e7f28",22857180,4,-7,0,1523,158,152,-6
"f03480cf4eba413194d7af52fc0e7f28","df1de691dafe4549a18a4398ee9dfaf9",22857180,1,-15,0,1524,152,139,-13
"df1de691dafe4549a18a4398ee9dfaf9","78adeee1fa2c4fe0bc73f7bca9fcee86",22857180,3,26,0,1525,139,160,21
"78adeee1fa2c4fe0bc73f7bca9fcee86","65202579580f4ad38d734b4ee39d22a8",22857180,7,5,0,1526,160,164,4
"65202579580f4ad38d734b4ee39d22a8","65202579580f4ad38d734b4ee39d22a8",22857180,79,0,1,1527,164,164,0
"65202579580f4ad38d734b4ee39d22a8","78adeee1fa2c4fe0bc73f7bca9fcee86",22857180,6,-5,0,1530,164,160,-4
"65202579580f4ad38d734b4ee39d22a8","3cbcea2be0984e7dbd5a48195af10ce7",22857180,1,3,0,1535,164,165,1
"3cbcea2be0984e7dbd5a48195af10ce7","78adeee1fa2c4fe0bc73f7bca9fcee86",22857180,1,-8,0,1536,165,160,-5
"78adeee1fa2c4fe0bc73f7bca9fcee86","82e6285962b8400d9d6fc32436022a94",22857180,1,10,0,1537,160,167,7
"82e6285962b8400d9d6fc32436022a94","3cbcea2be0984e7dbd5a48195af10ce7",22857180,2,-2,0,1538,167,165,-2
"3cbcea2be0984e7dbd5a48195af10ce7","a9ac840f098c4bd0a2ee896214ce29cd",22857180,4,5,0,1539,165,168,3
"a9ac840f098c4bd0a2ee896214ce29cd","a9ac840f098c4bd0a2ee896214ce29cd",22857180,3,0,1,1540,168,168,0
"a9ac840f098c4bd0a2ee896214ce29cd","d646286c8051419bbc2e31dd1db55ca8",22857180,1,-128,0,1541,168,67,-101
"00ae5f0c51874a73a41ebea838d95682","d391c8b6e56a43a7b654e9dee02d904b",22857180,4,2,0,1548,101,103,2
"d391c8b6e56a43a7b654e9dee02d904b","e20db35ced8544ddac5bc3839145e463",22857180,1,-13,0,1549,103,91,-12
"e20db35ced8544ddac5bc3839145e463","4280927ec4d643238aa49c32f9e06c6c",22857180,1,20,0,1550,91,109,18
"779f9ddd1fd14d1e9e69f72219a1fdbd","579338175e0b4bbb8ef3b712b5d8b54e",22857180,1,8,0,1562,121,128,7
"579338175e0b4bbb8ef3b712b5d8b54e","b416d47c56a742199b5d7c7f19d6503a",22857180,3,7,0,1563,128,134,6
"b416d47c56a742199b5d7c7f19d6503a","779f9ddd1fd14d1e9e69f72219a1fdbd",22857180,4,-15,0,1564,134,121,-13
"6c5ad271a44743479bfaea29b1db8d02","df1de691dafe4549a18a4398ee9dfaf9",22857180,3,-4,0,1567,143,139,-4
"df1de691dafe4549a18a4398ee9dfaf9","8aae34f5ddbb4052a709b12e6b0d40fa",22857180,3,9,0,1568,139,147,8
"8aae34f5ddbb4052a709b12e6b0d40fa","f902b0f41b544d4dbf79664fd233648d",22857180,2,-1,0,1569,147,146,-1
"f03480cf4eba413194d7af52fc0e7f28","d313cec988a84645bee413e8d4724a4b",22857180,3,7,0,1572,152,158,6
"d313cec988a84645bee413e8d4724a4b","df1de691dafe4549a18a4398ee9dfaf9",22857180,3,-22,0,1574,158,139,-19
"78adeee1fa2c4fe0bc73f7bca9fcee86","3cbcea2be0984e7dbd5a48195af10ce7",22857180,3,8,0,1586,160,165,5
"3cbcea2be0984e7dbd5a48195af10ce7","82e6285962b8400d9d6fc32436022a94",22857180,4,2,0,1587,165,167,2
"a9ac840f098c4bd0a2ee896214ce29cd","0c7262dff33c4087bc660ccf40f92f9c",22857180,3,4,0,1591,168,169,1
"0c7262dff33c4087bc660ccf40f92f9c","b2275c3fad834f8d90737a2d9a6927d6",22857180,3,3,0,1592,169,172,3
"b2275c3fad834f8d90737a2d9a6927d6","0c7262dff33c4087bc660ccf40f92f9c",22857180,2,-3,0,1593,172,169,-3
"0c7262dff33c4087bc660ccf40f92f9c","b87c552dd247427abe6ab5795b9c9d43",22857180,1,14,0,1594,169,181,12
"b87c552dd247427abe6ab5795b9c9d43","ea38cc0e6e6e41edbabf210220808bf9",22857180,2,-2,0,1595,181,179,-2
"ea38cc0e6e6e41edbabf210220808bf9","139b097acfca451689d80c9c6eebdf7b",22857180,1,-1,0,1596,179,178,-1
"139b097acfca451689d80c9c6eebdf7b","2024b4885bd14338a39b7b509acbbd02",22857180,2,5,0,1597,178,182,4
"2024b4885bd14338a39b7b509acbbd02","c8e371568a0c4391b25796ae4e91952e",22857180,1,7,0,1598,182,186,4
"c8e371568a0c4391b25796ae4e91952e","0c7262dff33c4087bc660ccf40f92f9c",22857180,2,-23,0,1599,186,169,-17
"0c7262dff33c4087bc660ccf40f92f9c","ab11d94c6c8948ea90b88f19d2cd502b",22857180,1,28,0,1600,169,190,21
"ab11d94c6c8948ea90b88f19d2cd502b","c8e371568a0c4391b25796ae4e91952e",22857180,2,-5,0,1601,190,186,-4
"c8e371568a0c4391b25796ae4e91952e","6cd2dcaac46847d4a0bc53f296d90375",22857180,1,10,0,1602,186,194,8
"6cd2dcaac46847d4a0bc53f296d90375","07b44a7a51e94c78b411c753fc39dab0",22857180,2,-6,0,1603,194,189,-5
"07b44a7a51e94c78b411c753fc39dab0","017d7ca8e0394b91aaadc9574df2202c",22857180,2,5,0,1604,189,193,4
"017d7ca8e0394b91aaadc9574df2202c","f9170dd6bc6442b4acd832747609b09a",22857180,2,7,0,1605,193,199,6
"f9170dd6bc6442b4acd832747609b09a","d7f13c8d63ec4e2aa673fbb9cf9c6933",22857180,1,10,0,1606,199,206,7
"d7f13c8d63ec4e2aa673fbb9cf9c6933","c8e371568a0c4391b25796ae4e91952e",22857180,1,-26,0,1607,206,186,-20
"c8e371568a0c4391b25796ae4e91952e","d7f13c8d63ec4e2aa673fbb9cf9c6933",22857180,3,26,0,1608,186,206,20
"d7f13c8d63ec4e2aa673fbb9cf9c6933","7108f0e4c2584f1f9c471689ae4c885c",22857180,2,2,0,1609,206,208,2
"7108f0e4c2584f1f9c471689ae4c885c","b9e80f77c3a44349863b19875725c384",22857180,2,-1,0,1610,208,207,-1
"b9e80f77c3a44349863b19875725c384","09400e101c5d4b439cf9a26b03aae558",22857180,1,4,0,1611,207,210,3
"09400e101c5d4b439cf9a26b03aae558","a875096404ef4a9984b62d74cda916f9",22857180,1,-1,0,1612,210,209,-1
"a875096404ef4a9984b62d74cda916f9","f7fb1952f56b4189b86a9f8b7862d2b8",22857180,1,7,0,1613,209,215,6
"f7fb1952f56b4189b86a9f8b7862d2b8","be502a7a43c44bf7b682698de79d9369",22857180,2,-1,0,1614,215,214,-1
"be502a7a43c44bf7b682698de79d9369","ec341f459285443b8361f7f15638ff08",22857180,1,-1,0,1615,214,213,-1
"ec341f459285443b8361f7f15638ff08","363837c182e04711840d896ae1e0339c",22857180,3,6,0,1616,213,218,5
"363837c182e04711840d896ae1e0339c","01b2051f8941460d89945e3b02d1ce78",22857180,3,-1,0,1617,218,217,-1
"01b2051f8941460d89945e3b02d1ce78","1c6721b1f63f4d30ba7746ea8af02a52",22857180,2,7,0,1618,217,221,4
"1c6721b1f63f4d30ba7746ea8af02a52","d7f13c8d63ec4e2aa673fbb9cf9c6933",22857180,2,-21,0,1619,221,206,-15
"d7f13c8d63ec4e2aa673fbb9cf9c6933","77ecef8eff6b4a2caea7707669bf7475",22857180,2,22,0,1620,206,222,16
"77ecef8eff6b4a2caea7707669bf7475","d03cb855c70044cf8c35d9ec0de696e3",22857180,2,3,0,1621,222,224,2
"d03cb855c70044cf8c35d9ec0de696e3","1c6721b1f63f4d30ba7746ea8af02a52",22857180,1,-4,0,1622,224,221,-3
"1c6721b1f63f4d30ba7746ea8af02a52","8b9ae98743bd4d4a8a87dff1c1244211",22857180,1,7,0,1623,221,227,6
"8b9ae98743bd4d4a8a87dff1c1244211","2ab1535aac1346ba8801535bf729ef37",22857180,3,3,0,1624,227,229,2
"2ab1535aac1346ba8801535bf729ef37","f7906d6f59b9489a91d2ef40db5a474d",22857180,2,-7,0,1625,229,223,-6
"f7906d6f59b9489a91d2ef40db5a474d","5152833676bf4c6cb317060be10f68db",22857180,1,6,0,1626,223,228,5
"5152833676bf4c6cb317060be10f68db","0b04c8e2f86d48c7aeb7e225819cd32b",22857180,1,7,0,1627,228,234,6
"0b04c8e2f86d48c7aeb7e225819cd32b","2ae94c0cea4d480a9d5dca8fb1d7b542",22857180,1,11,0,1628,234,242,8
"2ae94c0cea4d480a9d5dca8fb1d7b542","1c6721b1f63f4d30ba7746ea8af02a52",22857180,1,-27,0,1629,242,221,-21
"1c6721b1f63f4d30ba7746ea8af02a52","2ae94c0cea4d480a9d5dca8fb1d7b542",22857180,3,27,0,1630,221,242,21
"2ae94c0cea4d480a9d5dca8fb1d7b542","1ebf23f9d994469a85206e4c7b1bf5f5",22857180,3,3,0,1631,242,245,3
"1ebf23f9d994469a85206e4c7b1bf5f5","6e83e23f56544a19b94067c1c558d9c0",22857180,1,3,0,1632,245,247,2
"6e83e23f56544a19b94067c1c558d9c0","00f61990949545828dd12f1303d47504",22857180,4,11,0,1633,247,256,9
"00f61990949545828dd12f1303d47504","d546341988904f069cfa86b21457d9d9",22857180,3,-6,0,1634,256,251,-5
"d546341988904f069cfa86b21457d9d9","30c9ba177afc49a695625d2bdec40207",22857180,1,-2,0,1635,251,250,-1
"30c9ba177afc49a695625d2bdec40207","30c9ba177afc49a695625d2bdec40207",22857180,2,0,1,1636,250,250,0
"30c9ba177afc49a695625d2bdec40207","6e83e23f56544a19b94067c1c558d9c0",22857180,1,-3,0,1638,250,247,-3
"d546341988904f069cfa86b21457d9d9","d989ebcfc12a4b669f0100dc1aa14f1e",22857180,2,5,0,1641,251,255,4
"d989ebcfc12a4b669f0100dc1aa14f1e","7aa76d3e993840d8805f097cbdbcd44b",22857180,2,7,0,1642,255,261,6
"7aa76d3e993840d8805f097cbdbcd44b","2ae94c0cea4d480a9d5dca8fb1d7b542",22857180,2,-23,0,1643,261,242,-19
"2ae94c0cea4d480a9d5dca8fb1d7b542","0d987bed3ffa4ed0b9a2e62e97b7b30f",22857180,3,38,0,1644,242,272,30
"0d987bed3ffa4ed0b9a2e62e97b7b30f","0d987bed3ffa4ed0b9a2e62e97b7b30f",22857180,3,0,1,1645,272,272,0
"0d987bed3ffa4ed0b9a2e62e97b7b30f","82ae07bc0c9b4570a41799290d1ef399",22857180,1,4,0,1646,272,275,3
"82ae07bc0c9b4570a41799290d1ef399","bb5a47f5ea01454a8b79455422d3b9da",22857180,3,6,0,1647,275,280,5
"bb5a47f5ea01454a8b79455422d3b9da","bb5a47f5ea01454a8b79455422d3b9da",22857180,99,0,1,1648,280,280,0
"bb5a47f5ea01454a8b79455422d3b9da","0d987bed3ffa4ed0b9a2e62e97b7b30f",22857180,3,-10,0,1655,280,272,-8
"0d987bed3ffa4ed0b9a2e62e97b7b30f","94cecc3f1e7d484b8e068e79241dfd73",22857180,3,13,0,1656,272,281,9
"94cecc3f1e7d484b8e068e79241dfd73","a37477c4e4c14169ad44b06b493007f6",22857180,3,2,0,1657,281,283,2
"a37477c4e4c14169ad44b06b493007f6","fab84b4fab5940efb4ea868ef8d09396",22857180,3,3,0,1658,283,284,1
"fab84b4fab5940efb4ea868ef8d09396","94cecc3f1e7d484b8e068e79241dfd73",22857180,3,-5,0,1659,284,281,-3
"94cecc3f1e7d484b8e068e79241dfd73","fab84b4fab5940efb4ea868ef8d09396",22857180,4,5,0,1660,281,284,3
"fab84b4fab5940efb4ea868ef8d09396","4a29443515bb404cb8924e1c60a63b73",22857180,4,4,0,1661,284,285,1
"4a29443515bb404cb8924e1c60a63b73","208c9b2796c944db8dacaa96082520ea",22857180,4,3,0,1662,285,288,3
"208c9b2796c944db8dacaa96082520ea","4a29443515bb404cb8924e1c60a63b73",22857180,2,-3,0,1663,288,285,-3
"4a29443515bb404cb8924e1c60a63b73","6a9a3b5bde4a48daa896fe8c06eca56f",22857180,1,5,0,1664,285,289,4
"6a9a3b5bde4a48daa896fe8c06eca56f","869e967078f04da18dd0b0b9389a7424",22857180,2,5,0,1665,289,293,4
"869e967078f04da18dd0b0b9389a7424","34a6e49023fc4465bd5ca604330bbd1c",22857180,1,-1,0,1666,293,292,-1
"34a6e49023fc4465bd5ca604330bbd1c","ba0e59461bfb4a44b7b1c28a01f8d3b3",22857180,2,9,0,1667,292,299,7
"ba0e59461bfb4a44b7b1c28a01f8d3b3","21592f2a9e9c4b2f8c66ec5dbcbf6a2b",22857180,2,-4,0,1668,299,296,-3
"21592f2a9e9c4b2f8c66ec5dbcbf6a2b","7646a919d7e64fa990bca9b024ff089d",22857180,1,3,0,1669,296,298,2
"7646a919d7e64fa990bca9b024ff089d","4a29443515bb404cb8924e1c60a63b73",22857180,2,-17,0,1670,298,285,-13
"4a29443515bb404cb8924e1c60a63b73","3434c10e561d488a914e0f7d71907abd",22857180,2,27,0,1671,285,305,20
"3434c10e561d488a914e0f7d71907abd","53e7e900392747ccad52e711ab0f80d8",22857180,2,2,0,1672,305,307,2
"53e7e900392747ccad52e711ab0f80d8","d646286c8051419bbc2e31dd1db55ca8",22857180,1,-318,0,1673,307,67,-240
"6a9f0ef185fb47f0937e29daa1c71ed5","42fb58708eaf4e5daa82bfca61b6f5fd",22857180,1,-3,0,1681,90,87,-3
"42fb58708eaf4e5daa82bfca61b6f5fd","e20db35ced8544ddac5bc3839145e463",22857180,1,6,0,1682,87,91,4
"e20db35ced8544ddac5bc3839145e463","d646286c8051419bbc2e31dd1db55ca8",22857180,2,-30,0,1683,91,67,-24
"d391c8b6e56a43a7b654e9dee02d904b","00ae5f0c51874a73a41ebea838d95682",22857180,2,-2,0,1686,103,101,-2
"00ae5f0c51874a73a41ebea838d95682","4280927ec4d643238aa49c32f9e06c6c",22857180,1,9,0,1687,101,109,8
"a9ae0a3c070d455bb4369a8996313336","62bff51286ef4f348717a3cf6fe2318f",22857180,1,7,0,1691,114,120,6
"62bff51286ef4f348717a3cf6fe2318f","37319e88176d4aefa91d7a9980dbae91",22857180,2,-9,0,1692,120,112,-8
"37319e88176d4aefa91d7a9980dbae91","e20db35ced8544ddac5bc3839145e463",22857180,2,-24,0,1693,112,91,-21
"e20db35ced8544ddac5bc3839145e463","62bff51286ef4f348717a3cf6fe2318f",22857180,2,33,0,1694,91,120,29
"779f9ddd1fd14d1e9e69f72219a1fdbd","779f9ddd1fd14d1e9e69f72219a1fdbd",22857180,1,0,1,1697,121,121,0
"779f9ddd1fd14d1e9e69f72219a1fdbd","a8dd5213034441ac92724b4e83eb0bb2",22857180,3,9,0,1698,121,129,8
"a8dd5213034441ac92724b4e83eb0bb2","579338175e0b4bbb8ef3b712b5d8b54e",22857180,2,-1,0,1699,129,128,-1
"f902b0f41b544d4dbf79664fd233648d","78adeee1fa2c4fe0bc73f7bca9fcee86",22857180,1,18,0,1707,146,160,14
"78adeee1fa2c4fe0bc73f7bca9fcee86","d313cec988a84645bee413e8d4724a4b",22857180,1,-4,0,1708,160,158,-2
"df1de691dafe4549a18a4398ee9dfaf9","d313cec988a84645bee413e8d4724a4b",22857180,1,22,0,1711,139,158,19
"f03480cf4eba413194d7af52fc0e7f28","78adeee1fa2c4fe0bc73f7bca9fcee86",22857180,1,11,0,1713,152,160,8
"82e6285962b8400d9d6fc32436022a94","a9ac840f098c4bd0a2ee896214ce29cd",22857180,2,3,0,1725,167,168,1
"a9ac840f098c4bd0a2ee896214ce29cd","3cbcea2be0984e7dbd5a48195af10ce7",22857180,3,-5,0,1726,168,165,-3
"0c7262dff33c4087bc660ccf40f92f9c","b42cc17b7de840f181a704558d0bc845",22857180,2,7,0,1731,169,175,6
"b42cc17b7de840f181a704558d0bc845","ea38cc0e6e6e41edbabf210220808bf9",22857180,1,5,0,1732,175,179,4
"ea38cc0e6e6e41edbabf210220808bf9","362fcb0699a14845ab29b2340093e528",22857180,1,-6,0,1733,179,174,-5
"362fcb0699a14845ab29b2340093e528","b87c552dd247427abe6ab5795b9c9d43",22857180,1,8,0,1734,174,181,7
"b87c552dd247427abe6ab5795b9c9d43","139b097acfca451689d80c9c6eebdf7b",22857180,4,-3,0,1735,181,178,-3
"2024b4885bd14338a39b7b509acbbd02","0c7262dff33c4087bc660ccf40f92f9c",22857180,1,-16,0,1737,182,169,-13
"0c7262dff33c4087bc660ccf40f92f9c","c8e371568a0c4391b25796ae4e91952e",22857180,1,23,0,1738,169,186,17
"c8e371568a0c4391b25796ae4e91952e","c8e371568a0c4391b25796ae4e91952e",22857180,1,0,1,1739,186,186,0
"c8e371568a0c4391b25796ae4e91952e","ab11d94c6c8948ea90b88f19d2cd502b",22857180,3,5,0,1740,186,190,4
"ab11d94c6c8948ea90b88f19d2cd502b","6cd2dcaac46847d4a0bc53f296d90375",22857180,1,5,0,1741,190,194,4
"f9170dd6bc6442b4acd832747609b09a","c8e371568a0c4391b25796ae4e91952e",22857180,1,-16,0,1745,199,186,-13
"d7f13c8d63ec4e2aa673fbb9cf9c6933","b9e80f77c3a44349863b19875725c384",22857180,1,1,0,1747,206,207,1
"b9e80f77c3a44349863b19875725c384","7108f0e4c2584f1f9c471689ae4c885c",22857180,2,1,0,1748,207,208,1
"7108f0e4c2584f1f9c471689ae4c885c","09400e101c5d4b439cf9a26b03aae558",22857180,1,3,0,1749,208,210,2
"09400e101c5d4b439cf9a26b03aae558","be502a7a43c44bf7b682698de79d9369",22857180,1,5,0,1750,210,214,4
"be502a7a43c44bf7b682698de79d9369","a875096404ef4a9984b62d74cda916f9",22857180,1,-6,0,1751,214,209,-5
"a875096404ef4a9984b62d74cda916f9","d7f13c8d63ec4e2aa673fbb9cf9c6933",22857180,1,-4,0,1752,209,206,-3
"d7f13c8d63ec4e2aa673fbb9cf9c6933","ec341f459285443b8361f7f15638ff08",22857180,1,9,0,1753,206,213,7
"77ecef8eff6b4a2caea7707669bf7475","1c6721b1f63f4d30ba7746ea8af02a52",22857180,1,-1,0,1759,222,221,-1
"1c6721b1f63f4d30ba7746ea8af02a52","d03cb855c70044cf8c35d9ec0de696e3",22857180,2,4,0,1760,221,224,3
"d03cb855c70044cf8c35d9ec0de696e3","8b9ae98743bd4d4a8a87dff1c1244211",22857180,2,3,0,1761,224,227,3
"2ab1535aac1346ba8801535bf729ef37","5152833676bf4c6cb317060be10f68db",22857180,1,-1,0,1763,229,228,-1
"5152833676bf4c6cb317060be10f68db","f7906d6f59b9489a91d2ef40db5a474d",22857180,1,-6,0,1764,228,223,-5
"f7906d6f59b9489a91d2ef40db5a474d","0b04c8e2f86d48c7aeb7e225819cd32b",22857180,1,13,0,1765,223,234,11
"0b04c8e2f86d48c7aeb7e225819cd32b","1c6721b1f63f4d30ba7746ea8af02a52",22857180,1,-16,0,1766,234,221,-13
"1ebf23f9d994469a85206e4c7b1bf5f5","2ae94c0cea4d480a9d5dca8fb1d7b542",22857180,1,-3,0,1769,245,242,-3
"2ae94c0cea4d480a9d5dca8fb1d7b542","6e83e23f56544a19b94067c1c558d9c0",22857180,1,6,0,1770,242,247,5
"0d987bed3ffa4ed0b9a2e62e97b7b30f","bb5a47f5ea01454a8b79455422d3b9da",22857180,3,10,0,1778,272,280,8
"bb5a47f5ea01454a8b79455422d3b9da","82ae07bc0c9b4570a41799290d1ef399",22857180,2,-6,0,1781,280,275,-5
"208c9b2796c944db8dacaa96082520ea","2ae94c0cea4d480a9d5dca8fb1d7b542",22857180,1,-63,0,1795,288,242,-46
"2ae94c0cea4d480a9d5dca8fb1d7b542","2ae94c0cea4d480a9d5dca8fb1d7b542",22857180,1,0,1,1796,242,242,0
"2ae94c0cea4d480a9d5dca8fb1d7b542","d646286c8051419bbc2e31dd1db55ca8",22857180,1,-229,0,1797,242,67,-175
"6a9f0ef185fb47f0937e29daa1c71ed5","e20db35ced8544ddac5bc3839145e463",22857180,1,3,0,1801,90,91,1
"d646286c8051419bbc2e31dd1db55ca8","78adeee1fa2c4fe0bc73f7bca9fcee86",22857180,1,115,0,1803,67,160,93
"65202579580f4ad38d734b4ee39d22a8","7646a919d7e64fa990bca9b024ff089d",22857180,1,186,0,1812,164,298,134
"4a29443515bb404cb8924e1c60a63b73","ba0e59461bfb4a44b7b1c28a01f8d3b3",22857180,1,18,0,1814,285,299,14
"ba0e59461bfb4a44b7b1c28a01f8d3b3","b416d47c56a742199b5d7c7f19d6503a",22857180,1,-226,0,1815,299,134,-165
"779f9ddd1fd14d1e9e69f72219a1fdbd","07b44a7a51e94c78b411c753fc39dab0",22857180,1,93,0,1819,121,189,68
"07b44a7a51e94c78b411c753fc39dab0","c8e371568a0c4391b25796ae4e91952e",22857180,1,-4,0,1820,189,186,-3
"b613861cecf84ffcab01afb23f660475","b613861cecf84ffcab01afb23f660475",22857747,3,0,1,1,1,1,0
"b613861cecf84ffcab01afb23f660475","e2911e79efc2420eac45d9f671463d4b",22857747,2,3,0,4,1,2,1
"e2911e79efc2420eac45d9f671463d4b","b613861cecf84ffcab01afb23f660475",22857747,1,-3,0,5,2,1,-1
"e2911e79efc2420eac45d9f671463d4b","e2911e79efc2420eac45d9f671463d4b",22857747,1,0,1,7,2,2,0
"e2911e79efc2420eac45d9f671463d4b","519d1b8c59404d67b54e96c5c8a830b2",22857747,1,1,0,8,2,3,1
"519d1b8c59404d67b54e96c5c8a830b2","519d1b8c59404d67b54e96c5c8a830b2",22857747,1,0,1,9,3,3,0
"519d1b8c59404d67b54e96c5c8a830b2","531db53f81f646edb0cdcfe0085b03b7",22857747,1,1,0,10,3,4,1
"531db53f81f646edb0cdcfe0085b03b7","531db53f81f646edb0cdcfe0085b03b7",22857747,1,0,1,11,4,4,0
"531db53f81f646edb0cdcfe0085b03b7","4f5f94b2f95141e0a9d53a61da2276da",22857747,1,1,0,12,4,5,1
"4f5f94b2f95141e0a9d53a61da2276da","4f5f94b2f95141e0a9d53a61da2276da",22857747,1,0,1,13,5,5,0
"4f5f94b2f95141e0a9d53a61da2276da","6d541c89590949f99af293c4f2333f67",22857747,1,1,0,14,5,6,1
"6d541c89590949f99af293c4f2333f67","6d541c89590949f99af293c4f2333f67",22857747,1,0,1,15,6,6,0
"6d541c89590949f99af293c4f2333f67","dd5cf0b9fe4c4f1d8f5ff8e4c04879cb",22857747,1,1,0,16,6,7,1
"dd5cf0b9fe4c4f1d8f5ff8e4c04879cb","dd5cf0b9fe4c4f1d8f5ff8e4c04879cb",22857747,1,0,1,17,7,7,0
"dd5cf0b9fe4c4f1d8f5ff8e4c04879cb","f96261861edc426abe2248be4f0a709a",22857747,1,1,0,18,7,8,1
"f96261861edc426abe2248be4f0a709a","f96261861edc426abe2248be4f0a709a",22857747,1,0,1,19,8,8,0
"f96261861edc426abe2248be4f0a709a","66b5e16f4f75454fb5b8172079f0fa83",22857747,1,1,0,20,8,9,1
"66b5e16f4f75454fb5b8172079f0fa83","66b5e16f4f75454fb5b8172079f0fa83",22857747,1,0,1,21,9,9,0
"66b5e16f4f75454fb5b8172079f0fa83","0680571d4698477995e41842c36a54b2",22857747,1,1,0,22,9,10,1
"0680571d4698477995e41842c36a54b2","0680571d4698477995e41842c36a54b2",22857747,1,0,1,23,10,10,0
"0680571d4698477995e41842c36a54b2","9112f2bffece48e08c6d2287be204085",22857747,1,1,0,24,10,11,1
"9112f2bffece48e08c6d2287be204085","9112f2bffece48e08c6d2287be204085",22857747,1,0,1,25,11,11,0
"9112f2bffece48e08c6d2287be204085","56586aa865414f538729c7f7735d2bc6",22857747,1,3,0,26,11,12,1
"56586aa865414f538729c7f7735d2bc6","e2911e79efc2420eac45d9f671463d4b",22857747,1,-12,0,27,12,2,-10
"e2911e79efc2420eac45d9f671463d4b","56586aa865414f538729c7f7735d2bc6",22857747,1,12,0,28,2,12,10
"56586aa865414f538729c7f7735d2bc6","56586aa865414f538729c7f7735d2bc6",22857747,12,0,1,29,12,12,0
"56586aa865414f538729c7f7735d2bc6","b7f2b31585d94eb3bf86376714aa7070",22857747,1,2,0,36,12,13,1
"b7f2b31585d94eb3bf86376714aa7070","b7f2b31585d94eb3bf86376714aa7070",22857747,4,0,1,37,13,13,0
"b7f2b31585d94eb3bf86376714aa7070","3f1c815879794b929260d224becaff7e",22857747,1,2,0,41,13,14,1
"3f1c815879794b929260d224becaff7e","5c5ceeee4562457ba6d41515aeebfbb1",22857747,1,6,0,42,14,17,3
"5c5ceeee4562457ba6d41515aeebfbb1","81c864a886d54a6b8ff85f7d736f4f95",22857747,2,-4,0,43,17,15,-2
"81c864a886d54a6b8ff85f7d736f4f95","5c5ceeee4562457ba6d41515aeebfbb1",22857747,1,4,0,44,15,17,2
"5c5ceeee4562457ba6d41515aeebfbb1","9afd71a5298d4333b6849dfce1b9422c",22857747,1,3,0,45,17,18,1
"9afd71a5298d4333b6849dfce1b9422c","56586aa865414f538729c7f7735d2bc6",22857747,1,-13,0,46,18,12,-6
"56586aa865414f538729c7f7735d2bc6","5c5ceeee4562457ba6d41515aeebfbb1",22857747,1,10,0,52,12,17,5
"81c864a886d54a6b8ff85f7d736f4f95","56586aa865414f538729c7f7735d2bc6",22857747,1,-6,0,54,15,12,-3
"56586aa865414f538729c7f7735d2bc6","9afd71a5298d4333b6849dfce1b9422c",22857747,1,13,0,55,12,18,6
"9afd71a5298d4333b6849dfce1b9422c","9afd71a5298d4333b6849dfce1b9422c",22857747,1,0,1,56,18,18,0
"9afd71a5298d4333b6849dfce1b9422c","b7719e26494940efa49512aedd0aac79",22857747,1,4,0,57,18,20,2
"b7719e26494940efa49512aedd0aac79","d4f45188d3c84a02ba08454e6403a818",22857747,1,5,0,58,20,24,4
"d4f45188d3c84a02ba08454e6403a818","d4c3b003e8274e429d2fa688d73fde6d",22857747,1,-2,0,59,24,22,-2
"d4c3b003e8274e429d2fa688d73fde6d","b7719e26494940efa49512aedd0aac79",22857747,1,-3,0,60,22,20,-2
"b7719e26494940efa49512aedd0aac79","b7719e26494940efa49512aedd0aac79",22857747,1,0,1,61,20,20,0
"b7719e26494940efa49512aedd0aac79","afbf7250b99d47bea07172749483ca97",22857747,1,12,0,62,20,28,8
"afbf7250b99d47bea07172749483ca97","afbf7250b99d47bea07172749483ca97",22857747,1,0,1,63,28,28,0
"afbf7250b99d47bea07172749483ca97","4e51676dc72045d99c19b9fa7b22f8bc",22857747,1,3,0,64,28,29,1
"4e51676dc72045d99c19b9fa7b22f8bc","4e51676dc72045d99c19b9fa7b22f8bc",22857747,1,0,1,65,29,29,0
"4e51676dc72045d99c19b9fa7b22f8bc","51970cfa30e643e894e66ae85c8024cc",22857747,1,3,0,66,29,31,2
"51970cfa30e643e894e66ae85c8024cc","4e51676dc72045d99c19b9fa7b22f8bc",22857747,1,-3,0,67,31,29,-2
"4e51676dc72045d99c19b9fa7b22f8bc","c33c17be71ae4d588da7369472e5bb1b",22857747,1,9,0,68,29,34,5
"c33c17be71ae4d588da7369472e5bb1b","93679be414554a11b1893002f2229a93",22857747,2,3,0,69,34,35,1
"93679be414554a11b1893002f2229a93","c33c17be71ae4d588da7369472e5bb1b",22857747,1,-3,0,70,35,34,-1
"93679be414554a11b1893002f2229a93","7040a13096d746ac84b8fac8d9752058",22857747,1,3,0,72,35,36,1
"7040a13096d746ac84b8fac8d9752058","9a0dc646f934470daf08c4b56ccf73db",22857747,2,3,0,73,36,37,1
"9a0dc646f934470daf08c4b56ccf73db","7040a13096d746ac84b8fac8d9752058",22857747,1,-3,0,74,37,36,-1
"9a0dc646f934470daf08c4b56ccf73db","fc0e049d56024bc9a02c9a9c435c3df7",22857747,1,3,0,76,37,38,1
"fc0e049d56024bc9a02c9a9c435c3df7","67a089198fcb4e1c8f2385786c2b296f",22857747,1,4,0,77,38,39,1
"67a089198fcb4e1c8f2385786c2b296f","fc0e049d56024bc9a02c9a9c435c3df7",22857747,1,-4,0,78,39,38,-1
"fc0e049d56024bc9a02c9a9c435c3df7","64d48c6c9c7940639a932219a6c87198",22857747,1,5,0,79,38,40,2
"64d48c6c9c7940639a932219a6c87198","64d48c6c9c7940639a932219a6c87198",22857747,3,0,1,80,40,40,0
"64d48c6c9c7940639a932219a6c87198","67a089198fcb4e1c8f2385786c2b296f",22857747,1,-1,0,83,40,39,-1
"67a089198fcb4e1c8f2385786c2b296f","b534b89233134e30a9b5645138bfa9ee",22857747,1,4,0,84,39,41,2
"b534b89233134e30a9b5645138bfa9ee","0e37b720d23b4e7f8b313e79313fd107",22857747,1,3,0,85,41,44,3
"0e37b720d23b4e7f8b313e79313fd107","0e37b720d23b4e7f8b313e79313fd107",22857747,1,0,1,86,44,44,0
"0e37b720d23b4e7f8b313e79313fd107","6875d67fdd5f48168b62719df449bebd",22857747,1,1,0,87,44,45,1
"6875d67fdd5f48168b62719df449bebd","6875d67fdd5f48168b62719df449bebd",22857747,1,0,1,88,45,45,0
"6875d67fdd5f48168b62719df449bebd","b534b89233134e30a9b5645138bfa9ee",22857747,1,-4,0,89,45,41,-4
"b534b89233134e30a9b5645138bfa9ee","6e13d61a7bdb44bca949c9f86fab3be5",22857747,1,7,0,90,41,47,6
"6e13d61a7bdb44bca949c9f86fab3be5","6e13d61a7bdb44bca949c9f86fab3be5",22857747,2,0,1,91,47,47,0
"6e13d61a7bdb44bca949c9f86fab3be5","195f78799f984cc2b06c48dfe36be751",22857747,1,2,0,93,47,49,2
"195f78799f984cc2b06c48dfe36be751","195f78799f984cc2b06c48dfe36be751",22857747,2,0,1,94,49,49,0
"195f78799f984cc2b06c48dfe36be751","d9c8d8c444a64dadbbb508652c721e17",22857747,1,-3,0,96,49,46,-3
"d9c8d8c444a64dadbbb508652c721e17","d0c74f735e024943943e40333d6d337f",22857747,1,6,0,97,46,51,5
"d0c74f735e024943943e40333d6d337f","b534b89233134e30a9b5645138bfa9ee",22857747,1,-12,0,98,51,41,-10
"b534b89233134e30a9b5645138bfa9ee","d0c74f735e024943943e40333d6d337f",22857747,1,12,0,99,41,51,10
"d0c74f735e024943943e40333d6d337f","d0c74f735e024943943e40333d6d337f",22857747,1,0,1,100,51,51,0
"d0c74f735e024943943e40333d6d337f","983f8ff320594b279a7f4a6fe132f9c5",22857747,1,2,0,101,51,53,2
"983f8ff320594b279a7f4a6fe132f9c5","983f8ff320594b279a7f4a6fe132f9c5",22857747,2,0,1,102,53,53,0
"983f8ff320594b279a7f4a6fe132f9c5","35adfa5d923046aebabfefd98f35ff05",22857747,1,1,0,104,53,54,1
"35adfa5d923046aebabfefd98f35ff05","35adfa5d923046aebabfefd98f35ff05",22857747,5,0,1,105,54,54,0
"35adfa5d923046aebabfefd98f35ff05","b6f8a98476224da1b40e555ececc7ed8",22857747,1,1,0,110,54,55,1
"b6f8a98476224da1b40e555ececc7ed8","b6f8a98476224da1b40e555ececc7ed8",22857747,2,0,1,111,55,55,0
"b6f8a98476224da1b40e555ececc7ed8","86e22cb5fe0e4b47a9489ecddf7ed78f",22857747,1,1,0,113,55,56,1
"86e22cb5fe0e4b47a9489ecddf7ed78f","86e22cb5fe0e4b47a9489ecddf7ed78f",22857747,2,0,1,114,56,56,0
"86e22cb5fe0e4b47a9489ecddf7ed78f","f924752d8a1149668870b1e7698486f7",22857747,1,-6,0,116,56,50,-6
"f924752d8a1149668870b1e7698486f7","78f30e4dcac84e3cbea8b2cc6e0d62b3",22857747,1,10,0,117,50,59,9
"78f30e4dcac84e3cbea8b2cc6e0d62b3","a1f2f12debe5432fb7a70bcd12bacfb9",22857747,1,-1,0,118,59,58,-1
"a1f2f12debe5432fb7a70bcd12bacfb9","a1f2f12debe5432fb7a70bcd12bacfb9",22857747,20,0,1,119,58,58,0
"a1f2f12debe5432fb7a70bcd12bacfb9","78f30e4dcac84e3cbea8b2cc6e0d62b3",22857747,1,1,0,139,58,59,1
"78f30e4dcac84e3cbea8b2cc6e0d62b3","78f30e4dcac84e3cbea8b2cc6e0d62b3",22857747,17,0,1,140,59,59,0
"78f30e4dcac84e3cbea8b2cc6e0d62b3","12aa6e1672ac4e7aa6449a7a8609cd72",22857747,1,-2,0,157,59,57,-2
"12aa6e1672ac4e7aa6449a7a8609cd72","bc42d26810654ea9a1df1efe1e58c7d5",22857747,1,7,0,158,57,63,6
"bc42d26810654ea9a1df1efe1e58c7d5","a0a418b8540d479fa6e0f653b701da8b",22857747,1,1,0,159,63,64,1
"a0a418b8540d479fa6e0f653b701da8b","4c943503763e4e349906eea3ed3c8e86",22857747,1,-3,0,160,64,61,-3
"4c943503763e4e349906eea3ed3c8e86","4c943503763e4e349906eea3ed3c8e86",22857747,1,0,1,161,61,61,0
"4c943503763e4e349906eea3ed3c8e86","309ccf3cc4fe429d9bfbaef53d3fa479",22857747,1,-1,0,162,61,60,-1
"309ccf3cc4fe429d9bfbaef53d3fa479","b534b89233134e30a9b5645138bfa9ee",22857747,1,-23,0,163,60,41,-19
"b534b89233134e30a9b5645138bfa9ee","d646286c8051419bbc2e31dd1db55ca8",22857747,1,33,0,164,41,67,26
"d646286c8051419bbc2e31dd1db55ca8","267f883678b24aed855fde42524975d9",22857747,1,4,0,165,67,71,4
"267f883678b24aed855fde42524975d9","267f883678b24aed855fde42524975d9",22857747,1,0,1,166,71,71,0
"267f883678b24aed855fde42524975d9","88fff56d0342490dbef9040750a20f6c",22857747,1,1,0,167,71,72,1
"88fff56d0342490dbef9040750a20f6c","88fff56d0342490dbef9040750a20f6c",22857747,1,0,1,168,72,72,0
"88fff56d0342490dbef9040750a20f6c","adb17b12b66c4a49a85fd34322f7df70",22857747,1,1,0,169,72,73,1
"adb17b12b66c4a49a85fd34322f7df70","adb17b12b66c4a49a85fd34322f7df70",22857747,1,0,1,170,73,73,0
"adb17b12b66c4a49a85fd34322f7df70","d646286c8051419bbc2e31dd1db55ca8",22857747,1,-6,0,171,73,67,-6
"d646286c8051419bbc2e31dd1db55ca8","a2becd407db34b189200a32546d9d569",22857747,1,9,0,172,67,75,8
"a2becd407db34b189200a32546d9d569","a2becd407db34b189200a32546d9d569",22857747,1,0,1,173,75,75,0
"a2becd407db34b189200a32546d9d569","58c22b011d0f4c2ea6d13615edbb9eeb",22857747,1,2,0,174,75,77,2
"58c22b011d0f4c2ea6d13615edbb9eeb","58c22b011d0f4c2ea6d13615edbb9eeb",22857747,2,0,1,175,77,77,0
"58c22b011d0f4c2ea6d13615edbb9eeb","dd76e1861dc9461c830888729d091ee0",22857747,1,1,0,177,77,78,1
"dd76e1861dc9461c830888729d091ee0","dd76e1861dc9461c830888729d091ee0",22857747,2,0,1,178,78,78,0
"dd76e1861dc9461c830888729d091ee0","cd1d828f1a694b87913a7ea66c23803e",22857747,1,1,0,180,78,79,1
"cd1d828f1a694b87913a7ea66c23803e","cd1d828f1a694b87913a7ea66c23803e",22857747,2,0,1,181,79,79,0
"cd1d828f1a694b87913a7ea66c23803e","9176a3c2b4d2465fa8b0c67096c2a97e",22857747,1,1,0,183,79,80,1
"9176a3c2b4d2465fa8b0c67096c2a97e","9176a3c2b4d2465fa8b0c67096c2a97e",22857747,5,0,1,184,80,80,0
"9176a3c2b4d2465fa8b0c67096c2a97e","f8ec6445f7194e25b9101d4fbcb07a18",22857747,1,1,0,189,80,81,1
"f8ec6445f7194e25b9101d4fbcb07a18","f8ec6445f7194e25b9101d4fbcb07a18",22857747,2,0,1,190,81,81,0
"f8ec6445f7194e25b9101d4fbcb07a18","140d5b27b8574befad82c0a013b59dfa",22857747,1,-7,0,192,81,74,-7
"140d5b27b8574befad82c0a013b59dfa","d18a9ea32855445f8736581f5cb119ce",22857747,1,9,0,193,74,82,8
"d18a9ea32855445f8736581f5cb119ce","f564483cbd7a407681aa2fcca518cf5f",22857747,1,4,0,194,82,85,3
"f564483cbd7a407681aa2fcca518cf5f","f564483cbd7a407681aa2fcca518cf5f",22857747,6,0,1,195,85,85,0
"f564483cbd7a407681aa2fcca518cf5f","18fd01350bd5434ca636d59a599d768a",22857747,1,1,0,201,85,86,1
"18fd01350bd5434ca636d59a599d768a","18fd01350bd5434ca636d59a599d768a",22857747,8,0,1,202,86,86,0
"18fd01350bd5434ca636d59a599d768a","ae5ac430ea254e708a6f5deaaf7464ae",22857747,1,-2,0,210,86,84,-2
"ae5ac430ea254e708a6f5deaaf7464ae","6a9f0ef185fb47f0937e29daa1c71ed5",22857747,1,7,0,211,84,90,6
"6a9f0ef185fb47f0937e29daa1c71ed5","c681290961c94c4caf23b529d1ae6b9a",22857747,1,-2,0,212,90,88,-2
"c681290961c94c4caf23b529d1ae6b9a","c681290961c94c4caf23b529d1ae6b9a",22857747,1,0,1,213,88,88,0
"c681290961c94c4caf23b529d1ae6b9a","6a9f0ef185fb47f0937e29daa1c71ed5",22857747,1,2,0,214,88,90,2
"6a9f0ef185fb47f0937e29daa1c71ed5","d646286c8051419bbc2e31dd1db55ca8",22857747,1,-27,0,215,90,67,-23
"d646286c8051419bbc2e31dd1db55ca8","e20db35ced8544ddac5bc3839145e463",22857747,1,30,0,216,67,91,24
"e20db35ced8544ddac5bc3839145e463","e20db35ced8544ddac5bc3839145e463",22857747,1,0,1,217,91,91,0
"e20db35ced8544ddac5bc3839145e463","1febb706d7a34005ae8711ed49c76e64",22857747,1,3,0,218,91,94,3
"1febb706d7a34005ae8711ed49c76e64","1febb706d7a34005ae8711ed49c76e64",22857747,2,0,1,219,94,94,0
"1febb706d7a34005ae8711ed49c76e64","8f73ba6f5a0042f2850356ac38ac6f24",22857747,1,1,0,221,94,95,1
"8f73ba6f5a0042f2850356ac38ac6f24","8f73ba6f5a0042f2850356ac38ac6f24",22857747,5,0,1,222,95,95,0
"8f73ba6f5a0042f2850356ac38ac6f24","e2260b86653c46d7b14a41fb419dbf8c",22857747,1,1,0,227,95,96,1
"e2260b86653c46d7b14a41fb419dbf8c","e2260b86653c46d7b14a41fb419dbf8c",22857747,2,0,1,228,96,96,0
"e2260b86653c46d7b14a41fb419dbf8c","35eb641ad1d845bbba54915bce75a962",22857747,1,1,0,230,96,97,1
"35eb641ad1d845bbba54915bce75a962","35eb641ad1d845bbba54915bce75a962",22857747,2,0,1,231,97,97,0
"35eb641ad1d845bbba54915bce75a962","08be90ffbeea4795a138cd42ed8db56f",22857747,1,1,0,233,97,98,1
"08be90ffbeea4795a138cd42ed8db56f","08be90ffbeea4795a138cd42ed8db56f",22857747,5,0,1,234,98,98,0
"08be90ffbeea4795a138cd42ed8db56f","3007433c8f584dcbb5ac159c1c5f2be3",22857747,1,1,0,239,98,99,1
"3007433c8f584dcbb5ac159c1c5f2be3","3007433c8f584dcbb5ac159c1c5f2be3",22857747,5,0,1,240,99,99,0
"3007433c8f584dcbb5ac159c1c5f2be3","e20db35ced8544ddac5bc3839145e463",22857747,1,-8,0,245,99,91,-8
"e20db35ced8544ddac5bc3839145e463","d391c8b6e56a43a7b654e9dee02d904b",22857747,1,13,0,246,91,103,12
"d391c8b6e56a43a7b654e9dee02d904b","00ae5f0c51874a73a41ebea838d95682",22857747,1,-2,0,247,103,101,-2
"00ae5f0c51874a73a41ebea838d95682","00ae5f0c51874a73a41ebea838d95682",22857747,2,0,1,248,101,101,0
"00ae5f0c51874a73a41ebea838d95682","d391c8b6e56a43a7b654e9dee02d904b",22857747,1,2,0,250,101,103,2
"d391c8b6e56a43a7b654e9dee02d904b","d391c8b6e56a43a7b654e9dee02d904b",22857747,15,0,1,251,103,103,0
"d391c8b6e56a43a7b654e9dee02d904b","6111116566fc4fd9abba409322bea245",22857747,1,1,0,266,103,104,1
"6111116566fc4fd9abba409322bea245","6111116566fc4fd9abba409322bea245",22857747,2,0,1,267,104,104,0
"6111116566fc4fd9abba409322bea245","a81b2235cb9c499eb9ea8ee0a8dd9725",22857747,1,1,0,269,104,105,1
"a81b2235cb9c499eb9ea8ee0a8dd9725","a81b2235cb9c499eb9ea8ee0a8dd9725",22857747,2,0,1,270,105,105,0
"a81b2235cb9c499eb9ea8ee0a8dd9725","2d4e0ab0ef3b4d73b82c72d4621a7579",22857747,1,1,0,272,105,106,1
"2d4e0ab0ef3b4d73b82c72d4621a7579","2d4e0ab0ef3b4d73b82c72d4621a7579",22857747,2,0,1,273,106,106,0
"2d4e0ab0ef3b4d73b82c72d4621a7579","8bdebf492ebd4e62b0d522e8ab5e5197",22857747,1,1,0,275,106,107,1
"8bdebf492ebd4e62b0d522e8ab5e5197","8bdebf492ebd4e62b0d522e8ab5e5197",22857747,2,0,1,276,107,107,0
"8bdebf492ebd4e62b0d522e8ab5e5197","73039f8c1eb9409cb4caee2cf968001e",22857747,1,-7,0,278,107,100,-7
"73039f8c1eb9409cb4caee2cf968001e","4280927ec4d643238aa49c32f9e06c6c",22857747,1,10,0,279,100,109,9
"4280927ec4d643238aa49c32f9e06c6c","4280927ec4d643238aa49c32f9e06c6c",22857747,1,0,1,280,109,109,0
"4280927ec4d643238aa49c32f9e06c6c","fc44e6a5f7654430af1227838224dceb",22857747,1,2,0,281,109,111,2
"fc44e6a5f7654430af1227838224dceb","fc44e6a5f7654430af1227838224dceb",22857747,2,0,1,282,111,111,0
"fc44e6a5f7654430af1227838224dceb","08111f75e22d409998cf8b85bd431f0a",22857747,1,-3,0,284,111,108,-3
"08111f75e22d409998cf8b85bd431f0a","a9ae0a3c070d455bb4369a8996313336",22857747,1,7,0,285,108,114,6
"a9ae0a3c070d455bb4369a8996313336","a9ae0a3c070d455bb4369a8996313336",22857747,1,0,1,286,114,114,0
"a9ae0a3c070d455bb4369a8996313336","71cec822bcff4f30a20e75dc63ef7b65",22857747,1,2,0,287,114,116,2
"71cec822bcff4f30a20e75dc63ef7b65","71cec822bcff4f30a20e75dc63ef7b65",22857747,1,0,1,288,116,116,0
"71cec822bcff4f30a20e75dc63ef7b65","37319e88176d4aefa91d7a9980dbae91",22857747,1,-4,0,289,116,112,-4
"37319e88176d4aefa91d7a9980dbae91","62bff51286ef4f348717a3cf6fe2318f",22857747,1,9,0,290,112,120,8
"62bff51286ef4f348717a3cf6fe2318f","3ec3a3563847406fa73338f9e9999cf3",22857747,1,-3,0,291,120,117,-3
"3ec3a3563847406fa73338f9e9999cf3","e20db35ced8544ddac5bc3839145e463",22857747,1,-30,0,292,117,91,-26
"e20db35ced8544ddac5bc3839145e463","62bff51286ef4f348717a3cf6fe2318f",22857747,1,33,0,293,91,120,29
"62bff51286ef4f348717a3cf6fe2318f","b1cd0e7dc3ad4a8eb91a4bfdbeb025b0",22857747,1,-2,0,294,120,118,-2
"b1cd0e7dc3ad4a8eb91a4bfdbeb025b0","b1cd0e7dc3ad4a8eb91a4bfdbeb025b0",22857747,1,0,1,295,118,118,0
"b1cd0e7dc3ad4a8eb91a4bfdbeb025b0","62bff51286ef4f348717a3cf6fe2318f",22857747,1,2,0,296,118,120,2
"62bff51286ef4f348717a3cf6fe2318f","62bff51286ef4f348717a3cf6fe2318f",22857747,3,0,1,297,120,120,0
"62bff51286ef4f348717a3cf6fe2318f","e20db35ced8544ddac5bc3839145e463",22857747,1,-33,0,300,120,91,-29
"e20db35ced8544ddac5bc3839145e463","779f9ddd1fd14d1e9e69f72219a1fdbd",22857747,1,36,0,301,91,121,30
"779f9ddd1fd14d1e9e69f72219a1fdbd","b37e701092c444e8a0009767edc5f622",22857747,1,1,0,302,121,122,1
"b37e701092c444e8a0009767edc5f622","b37e701092c444e8a0009767edc5f622",22857747,1,0,1,303,122,122,0
"b37e701092c444e8a0009767edc5f622","779f9ddd1fd14d1e9e69f72219a1fdbd",22857747,1,-1,0,304,122,121,-1
"779f9ddd1fd14d1e9e69f72219a1fdbd","ae26e6cda8ad4a3f81bd347560d9579f",22857747,1,4,0,305,121,125,4
"ae26e6cda8ad4a3f81bd347560d9579f","ae26e6cda8ad4a3f81bd347560d9579f",22857747,1,0,1,306,125,125,0
"ae26e6cda8ad4a3f81bd347560d9579f","ee48df95832b4374aa273ceb27ec1315",22857747,1,1,0,307,125,126,1
"ee48df95832b4374aa273ceb27ec1315","ee48df95832b4374aa273ceb27ec1315",22857747,1,0,1,308,126,126,0
"ee48df95832b4374aa273ceb27ec1315","7a439da90b394756ad1777fc4c6dead5",22857747,1,1,0,309,126,127,1
"7a439da90b394756ad1777fc4c6dead5","7a439da90b394756ad1777fc4c6dead5",22857747,1,0,1,310,127,127,0
"7a439da90b394756ad1777fc4c6dead5","779f9ddd1fd14d1e9e69f72219a1fdbd",22857747,1,-6,0,311,127,121,-6
"779f9ddd1fd14d1e9e69f72219a1fdbd","a8dd5213034441ac92724b4e83eb0bb2",22857747,1,9,0,312,121,129,8
"a8dd5213034441ac92724b4e83eb0bb2","a8dd5213034441ac92724b4e83eb0bb2",22857747,1,0,1,313,129,129,0
"a8dd5213034441ac92724b4e83eb0bb2","8115eab6556b45f5b415c3b8c26a12e5",22857747,1,2,0,314,129,131,2
"8115eab6556b45f5b415c3b8c26a12e5","8115eab6556b45f5b415c3b8c26a12e5",22857747,2,0,1,315,131,131,0
"8115eab6556b45f5b415c3b8c26a12e5","ec34b06efd844b46a4c4818ecdb9b8f4",22857747,1,1,0,317,131,132,1
"ec34b06efd844b46a4c4818ecdb9b8f4","ec34b06efd844b46a4c4818ecdb9b8f4",22857747,2,0,1,318,132,132,0
"ec34b06efd844b46a4c4818ecdb9b8f4","c2e1c2b9eac64109b343a088584b576b",22857747,1,1,0,320,132,133,1
"c2e1c2b9eac64109b343a088584b576b","c2e1c2b9eac64109b343a088584b576b",22857747,2,0,1,321,133,133,0
"c2e1c2b9eac64109b343a088584b576b","579338175e0b4bbb8ef3b712b5d8b54e",22857747,1,-5,0,323,133,128,-5
"579338175e0b4bbb8ef3b712b5d8b54e","8bc5795d6a984a3eace4e2811e52dd4f",22857747,1,8,0,324,128,135,7
"8bc5795d6a984a3eace4e2811e52dd4f","8bc5795d6a984a3eace4e2811e52dd4f",22857747,1,0,1,325,135,135,0
"8bc5795d6a984a3eace4e2811e52dd4f","b416d47c56a742199b5d7c7f19d6503a",22857747,1,-1,0,326,135,134,-1
"b416d47c56a742199b5d7c7f19d6503a","cd4532ad48034873ba8bce2aac0c9808",22857747,1,4,0,327,134,137,3
"cd4532ad48034873ba8bce2aac0c9808","cd4532ad48034873ba8bce2aac0c9808",22857747,1,0,1,328,137,137,0
"cd4532ad48034873ba8bce2aac0c9808","df1de691dafe4549a18a4398ee9dfaf9",22857747,1,4,0,329,137,139,2
"df1de691dafe4549a18a4398ee9dfaf9","779f9ddd1fd14d1e9e69f72219a1fdbd",22857747,1,-23,0,330,139,121,-18
"779f9ddd1fd14d1e9e69f72219a1fdbd","6c5ad271a44743479bfaea29b1db8d02",22857747,1,27,0,331,121,143,22
"6c5ad271a44743479bfaea29b1db8d02","6c5ad271a44743479bfaea29b1db8d02",22857747,1,0,1,332,143,143,0
"6c5ad271a44743479bfaea29b1db8d02","83d311bed5374fee83d8d67a7d9d82dc",22857747,1,1,0,333,143,144,1
"83d311bed5374fee83d8d67a7d9d82dc","83d311bed5374fee83d8d67a7d9d82dc",22857747,1,0,1,334,144,144,0
"83d311bed5374fee83d8d67a7d9d82dc","402bba41861d43acb52a5abb89e8831e",22857747,1,1,0,335,144,145,1
"402bba41861d43acb52a5abb89e8831e","402bba41861d43acb52a5abb89e8831e",22857747,2,0,1,336,145,145,0
"402bba41861d43acb52a5abb89e8831e","8aae34f5ddbb4052a709b12e6b0d40fa",22857747,1,3,0,338,145,147,2
"8aae34f5ddbb4052a709b12e6b0d40fa","df1de691dafe4549a18a4398ee9dfaf9",22857747,1,-9,0,339,147,139,-8
"df1de691dafe4549a18a4398ee9dfaf9","8aae34f5ddbb4052a709b12e6b0d40fa",22857747,1,9,0,340,139,147,8
"8aae34f5ddbb4052a709b12e6b0d40fa","645b3f0249f64f76af2e19eb4d0e55b7",22857747,1,2,0,341,147,149,2
"645b3f0249f64f76af2e19eb4d0e55b7","645b3f0249f64f76af2e19eb4d0e55b7",22857747,5,0,1,342,149,149,0
"645b3f0249f64f76af2e19eb4d0e55b7","7e7b8db5064d4369805ab370aac5ddfb",22857747,1,1,0,347,149,150,1
"7e7b8db5064d4369805ab370aac5ddfb","7e7b8db5064d4369805ab370aac5ddfb",22857747,2,0,1,348,150,150,0
"7e7b8db5064d4369805ab370aac5ddfb","8956d210ae7f41968fada86d4c979d6a",22857747,1,1,0,350,150,151,1
"8956d210ae7f41968fada86d4c979d6a","8956d210ae7f41968fada86d4c979d6a",22857747,2,0,1,351,151,151,0
"8956d210ae7f41968fada86d4c979d6a","f902b0f41b544d4dbf79664fd233648d",22857747,1,-5,0,353,151,146,-5
"f902b0f41b544d4dbf79664fd233648d","ae781e8b775e4ccd93bc800dad5c8376",22857747,1,8,0,354,146,153,7
"ae781e8b775e4ccd93bc800dad5c8376","ae781e8b775e4ccd93bc800dad5c8376",22857747,2,0,1,355,153,153,0
"ae781e8b775e4ccd93bc800dad5c8376","06882a8492d9499aa31555567f575ecb",22857747,1,1,0,357,153,154,1
"06882a8492d9499aa31555567f575ecb","06882a8492d9499aa31555567f575ecb",22857747,1,0,1,358,154,154,0
"06882a8492d9499aa31555567f575ecb","f293c508f409466a8f27ddd7d1e40b20",22857747,1,1,0,359,154,155,1
"f293c508f409466a8f27ddd7d1e40b20","f293c508f409466a8f27ddd7d1e40b20",22857747,2,0,1,360,155,155,0
"f293c508f409466a8f27ddd7d1e40b20","cc4ddef5bbbe48ebb605141b347c4ed1",22857747,1,1,0,362,155,156,1
"cc4ddef5bbbe48ebb605141b347c4ed1","cc4ddef5bbbe48ebb605141b347c4ed1",22857747,1,0,1,363,156,156,0
"cc4ddef5bbbe48ebb605141b347c4ed1","d313cec988a84645bee413e8d4724a4b",22857747,1,3,0,364,156,158,2
"d313cec988a84645bee413e8d4724a4b","f03480cf4eba413194d7af52fc0e7f28",22857747,1,-7,0,365,158,152,-6
"f03480cf4eba413194d7af52fc0e7f28","d313cec988a84645bee413e8d4724a4b",22857747,1,7,0,366,152,158,6
"d313cec988a84645bee413e8d4724a4b","d313cec988a84645bee413e8d4724a4b",22857747,3,0,1,367,158,158,0
"d313cec988a84645bee413e8d4724a4b","dc60696c76a74368a60f72246e47700d",22857747,1,1,0,370,158,159,1
"dc60696c76a74368a60f72246e47700d","dc60696c76a74368a60f72246e47700d",22857747,1,0,1,371,159,159,0
"dc60696c76a74368a60f72246e47700d","df1de691dafe4549a18a4398ee9dfaf9",22857747,1,-23,0,372,159,139,-20
"df1de691dafe4549a18a4398ee9dfaf9","78adeee1fa2c4fe0bc73f7bca9fcee86",22857747,1,26,0,373,139,160,21
"65202579580f4ad38d734b4ee39d22a8","78adeee1fa2c4fe0bc73f7bca9fcee86",22857747,3,-5,0,378,164,160,-4
"65202579580f4ad38d734b4ee39d22a8","0c7262dff33c4087bc660ccf40f92f9c",22857747,1,12,0,401,164,169,5
"b2275c3fad834f8d90737a2d9a6927d6","b2275c3fad834f8d90737a2d9a6927d6",22857747,23,0,1,403,172,172,0
"b2275c3fad834f8d90737a2d9a6927d6","eb515a26030b41f8a82a1e6114420bad",22857747,1,1,0,426,172,173,1
"eb515a26030b41f8a82a1e6114420bad","eb515a26030b41f8a82a1e6114420bad",22857747,2,0,1,427,173,173,0
"eb515a26030b41f8a82a1e6114420bad","0c7262dff33c4087bc660ccf40f92f9c",22857747,1,-4,0,429,173,169,-4
"b42cc17b7de840f181a704558d0bc845","b42cc17b7de840f181a704558d0bc845",22857747,1,0,1,431,175,175,0
"801f9e9135034f49bf5f8b4bdefedb41","362fcb0699a14845ab29b2340093e528",22857747,1,-3,0,437,177,174,-3
"362fcb0699a14845ab29b2340093e528","ea38cc0e6e6e41edbabf210220808bf9",22857747,1,6,0,438,174,179,5
"ea38cc0e6e6e41edbabf210220808bf9","b87c552dd247427abe6ab5795b9c9d43",22857747,1,2,0,439,179,181,2
"b87c552dd247427abe6ab5795b9c9d43","b87c552dd247427abe6ab5795b9c9d43",22857747,8,0,1,440,181,181,0
"b87c552dd247427abe6ab5795b9c9d43","ea38cc0e6e6e41edbabf210220808bf9",22857747,1,-2,0,448,181,179,-2
"ea38cc0e6e6e41edbabf210220808bf9","139b097acfca451689d80c9c6eebdf7b",22857747,1,-1,0,449,179,178,-1
"0c7262dff33c4087bc660ccf40f92f9c","c3f63fe50d8e487c86bf8ef76c9cadd3",22857747,1,20,0,461,169,185,16
"c8e371568a0c4391b25796ae4e91952e","7d932b23e1c84326ae5aa4d3c0d813d1",22857747,1,2,0,465,186,188,2
"7d932b23e1c84326ae5aa4d3c0d813d1","7d932b23e1c84326ae5aa4d3c0d813d1",22857747,1,0,1,466,188,188,0
"7d932b23e1c84326ae5aa4d3c0d813d1","ab11d94c6c8948ea90b88f19d2cd502b",22857747,1,3,0,467,188,190,2
"ab11d94c6c8948ea90b88f19d2cd502b","c8e371568a0c4391b25796ae4e91952e",22857747,1,-5,0,468,190,186,-4
"ab11d94c6c8948ea90b88f19d2cd502b","f992451ed6ad4e68bb9e68ad6be7c4be",22857747,1,2,0,470,190,192,2
"f992451ed6ad4e68bb9e68ad6be7c4be","f992451ed6ad4e68bb9e68ad6be7c4be",22857747,1,0,1,471,192,192,0
"f992451ed6ad4e68bb9e68ad6be7c4be","07b44a7a51e94c78b411c753fc39dab0",22857747,1,-3,0,472,192,189,-3
"6cd2dcaac46847d4a0bc53f296d90375","6cd2dcaac46847d4a0bc53f296d90375",22857747,1,0,1,474,194,194,0
"6cd2dcaac46847d4a0bc53f296d90375","2d2580c9411c4972909db508d6956a58",22857747,1,2,0,475,194,196,2
"2d2580c9411c4972909db508d6956a58","2d2580c9411c4972909db508d6956a58",22857747,2,0,1,476,196,196,0
"2d2580c9411c4972909db508d6956a58","5bddb3d9ed264f3984702f048c7e5340",22857747,1,1,0,478,196,197,1
"5bddb3d9ed264f3984702f048c7e5340","5bddb3d9ed264f3984702f048c7e5340",22857747,2,0,1,479,197,197,0
"5bddb3d9ed264f3984702f048c7e5340","d5e8e2bd12a2466b9d6d90855f0eb079",22857747,1,1,0,481,197,198,1
"d5e8e2bd12a2466b9d6d90855f0eb079","d5e8e2bd12a2466b9d6d90855f0eb079",22857747,2,0,1,482,198,198,0
"d5e8e2bd12a2466b9d6d90855f0eb079","017d7ca8e0394b91aaadc9574df2202c",22857747,1,-5,0,484,198,193,-5
"017d7ca8e0394b91aaadc9574df2202c","54e8e9f0ea3e45c4bf3b8ac799ee31b1",22857747,1,8,0,485,193,200,7
"54e8e9f0ea3e45c4bf3b8ac799ee31b1","54e8e9f0ea3e45c4bf3b8ac799ee31b1",22857747,1,0,1,486,200,200,0
"54e8e9f0ea3e45c4bf3b8ac799ee31b1","c614a00911be4877a075f19315530fb0",22857747,1,1,0,487,200,201,1
"c614a00911be4877a075f19315530fb0","c614a00911be4877a075f19315530fb0",22857747,6,0,1,488,201,201,0
"c614a00911be4877a075f19315530fb0","a6c21bd8b95249c7972820a7a7d76aff",22857747,1,1,0,494,201,202,1
"a6c21bd8b95249c7972820a7a7d76aff","a6c21bd8b95249c7972820a7a7d76aff",22857747,1,0,1,495,202,202,0
"a6c21bd8b95249c7972820a7a7d76aff","bb329d880ab54120adaf203a693bb203",22857747,1,1,0,496,202,203,1
"bb329d880ab54120adaf203a693bb203","bb329d880ab54120adaf203a693bb203",22857747,1,0,1,497,203,203,0
"bb329d880ab54120adaf203a693bb203","f9170dd6bc6442b4acd832747609b09a",22857747,1,-4,0,498,203,199,-4
"f9170dd6bc6442b4acd832747609b09a","334c2344009840079b1d0e1b7ce3d5a7",22857747,1,7,0,499,199,205,6
"334c2344009840079b1d0e1b7ce3d5a7","334c2344009840079b1d0e1b7ce3d5a7",22857747,1,0,1,500,205,205,0
"334c2344009840079b1d0e1b7ce3d5a7","c8e371568a0c4391b25796ae4e91952e",22857747,1,-23,0,501,205,186,-19
"d7f13c8d63ec4e2aa673fbb9cf9c6933","b9e80f77c3a44349863b19875725c384",22857747,1,1,0,503,206,207,1
"b9e80f77c3a44349863b19875725c384","7108f0e4c2584f1f9c471689ae4c885c",22857747,2,1,0,504,207,208,1
"b9e80f77c3a44349863b19875725c384","b9e80f77c3a44349863b19875725c384",22857747,13,0,1,506,207,207,0
"7108f0e4c2584f1f9c471689ae4c885c","7108f0e4c2584f1f9c471689ae4c885c",22857747,11,0,1,520,208,208,0
"7108f0e4c2584f1f9c471689ae4c885c","d7f13c8d63ec4e2aa673fbb9cf9c6933",22857747,1,-2,0,531,208,206,-2
"d7f13c8d63ec4e2aa673fbb9cf9c6933","09400e101c5d4b439cf9a26b03aae558",22857747,2,5,0,532,206,210,4
"09400e101c5d4b439cf9a26b03aae558","a88efa7e50ce47159810ab553afa6d3a",22857747,1,2,0,533,210,212,2
"a88efa7e50ce47159810ab553afa6d3a","a88efa7e50ce47159810ab553afa6d3a",22857747,5,0,1,534,212,212,0
"a88efa7e50ce47159810ab553afa6d3a","d7f13c8d63ec4e2aa673fbb9cf9c6933",22857747,1,-7,0,539,212,206,-6
"09400e101c5d4b439cf9a26b03aae558","09400e101c5d4b439cf9a26b03aae558",22857747,1,0,1,541,210,210,0
"09400e101c5d4b439cf9a26b03aae558","a875096404ef4a9984b62d74cda916f9",22857747,1,-1,0,542,210,209,-1
"a875096404ef4a9984b62d74cda916f9","be502a7a43c44bf7b682698de79d9369",22857747,1,6,0,543,209,214,5
"f7fb1952f56b4189b86a9f8b7862d2b8","f7fb1952f56b4189b86a9f8b7862d2b8",22857747,12,0,1,545,215,215,0
"f7fb1952f56b4189b86a9f8b7862d2b8","be502a7a43c44bf7b682698de79d9369",22857747,1,-1,0,557,215,214,-1
"be502a7a43c44bf7b682698de79d9369","be502a7a43c44bf7b682698de79d9369",22857747,1,0,1,558,214,214,0
"be502a7a43c44bf7b682698de79d9369","b860ee85d8bc4a2f97958cfb71be3533",22857747,1,2,0,559,214,216,2
"b860ee85d8bc4a2f97958cfb71be3533","b860ee85d8bc4a2f97958cfb71be3533",22857747,2,0,1,560,216,216,0
"b860ee85d8bc4a2f97958cfb71be3533","ec341f459285443b8361f7f15638ff08",22857747,1,-3,0,562,216,213,-3
"ec341f459285443b8361f7f15638ff08","363837c182e04711840d896ae1e0339c",22857747,1,6,0,563,213,218,5
"363837c182e04711840d896ae1e0339c","363837c182e04711840d896ae1e0339c",22857747,12,0,1,564,218,218,0
"363837c182e04711840d896ae1e0339c","01b2051f8941460d89945e3b02d1ce78",22857747,3,-1,0,576,218,217,-1
"01b2051f8941460d89945e3b02d1ce78","91125ca626c5470eb145501f8c37f8db",22857747,1,4,0,577,217,220,3
"91125ca626c5470eb145501f8c37f8db","91125ca626c5470eb145501f8c37f8db",22857747,1,0,1,578,220,220,0
"91125ca626c5470eb145501f8c37f8db","1c6721b1f63f4d30ba7746ea8af02a52",22857747,1,3,0,579,220,221,1
"1c6721b1f63f4d30ba7746ea8af02a52","d7f13c8d63ec4e2aa673fbb9cf9c6933",22857747,1,-21,0,580,221,206,-15
"d7f13c8d63ec4e2aa673fbb9cf9c6933","77ecef8eff6b4a2caea7707669bf7475",22857747,1,22,0,581,206,222,16
"77ecef8eff6b4a2caea7707669bf7475","77ecef8eff6b4a2caea7707669bf7475",22857747,12,0,1,582,222,222,0
"1c6721b1f63f4d30ba7746ea8af02a52","8b9ae98743bd4d4a8a87dff1c1244211",22857747,1,7,0,595,221,227,6
"8b9ae98743bd4d4a8a87dff1c1244211","d03cb855c70044cf8c35d9ec0de696e3",22857747,2,-3,0,596,227,224,-3
"d03cb855c70044cf8c35d9ec0de696e3","1c6721b1f63f4d30ba7746ea8af02a52",22857747,1,-4,0,597,224,221,-3
"1c6721b1f63f4d30ba7746ea8af02a52","d03cb855c70044cf8c35d9ec0de696e3",22857747,1,4,0,598,221,224,3
"d03cb855c70044cf8c35d9ec0de696e3","8b9ae98743bd4d4a8a87dff1c1244211",22857747,1,3,0,599,224,227,3
"d03cb855c70044cf8c35d9ec0de696e3","a49a937d6896486d9a5396654abcf2e1",22857747,1,2,0,601,224,226,2
"a49a937d6896486d9a5396654abcf2e1","a49a937d6896486d9a5396654abcf2e1",22857747,4,0,1,602,226,226,0
"a49a937d6896486d9a5396654abcf2e1","8b9ae98743bd4d4a8a87dff1c1244211",22857747,1,1,0,606,226,227,1
"8b9ae98743bd4d4a8a87dff1c1244211","8b9ae98743bd4d4a8a87dff1c1244211",22857747,19,0,1,607,227,227,0
"8b9ae98743bd4d4a8a87dff1c1244211","f7906d6f59b9489a91d2ef40db5a474d",22857747,1,-4,0,626,227,223,-4
"f7906d6f59b9489a91d2ef40db5a474d","2ab1535aac1346ba8801535bf729ef37",22857747,1,7,0,627,223,229,6
"2ab1535aac1346ba8801535bf729ef37","a4f40fb48a8542c8949bae1f002cd9bc",22857747,1,2,0,628,229,231,2
"a4f40fb48a8542c8949bae1f002cd9bc","a4f40fb48a8542c8949bae1f002cd9bc",22857747,2,0,1,629,231,231,0
"a4f40fb48a8542c8949bae1f002cd9bc","92feb4a40f8344d38b6f722e42a53295",22857747,1,2,0,631,231,233,2
"92feb4a40f8344d38b6f722e42a53295","92feb4a40f8344d38b6f722e42a53295",22857747,2,0,1,632,233,233,0
"92feb4a40f8344d38b6f722e42a53295","2ab1535aac1346ba8801535bf729ef37",22857747,1,-4,0,634,233,229,-4
"2ab1535aac1346ba8801535bf729ef37","8972c23e32044edb8a78fa1eed4e5947",22857747,1,3,0,635,229,232,3
"8972c23e32044edb8a78fa1eed4e5947","8972c23e32044edb8a78fa1eed4e5947",22857747,3,0,1,636,232,232,0
"8972c23e32044edb8a78fa1eed4e5947","2ab1535aac1346ba8801535bf729ef37",22857747,1,-3,0,639,232,229,-3
"2ab1535aac1346ba8801535bf729ef37","2ab1535aac1346ba8801535bf729ef37",22857747,1,0,1,640,229,229,0
"2ab1535aac1346ba8801535bf729ef37","5152833676bf4c6cb317060be10f68db",22857747,1,-1,0,641,229,228,-1
"5152833676bf4c6cb317060be10f68db","ca3e28f290354c08aefe5b0f769604e6",22857747,1,8,0,642,228,235,7
"0b04c8e2f86d48c7aeb7e225819cd32b","1c6721b1f63f4d30ba7746ea8af02a52",22857747,2,-16,0,669,234,221,-13
"1c6721b1f63f4d30ba7746ea8af02a52","1c6721b1f63f4d30ba7746ea8af02a52",22857747,1,0,1,670,221,221,0
"1c6721b1f63f4d30ba7746ea8af02a52","f53da5fd9bfe412da4b80d4742563b6c",22857747,1,24,0,671,221,241,20
"f53da5fd9bfe412da4b80d4742563b6c","1c6721b1f63f4d30ba7746ea8af02a52",22857747,1,-24,0,673,241,221,-20
"1c6721b1f63f4d30ba7746ea8af02a52","2ae94c0cea4d480a9d5dca8fb1d7b542",22857747,2,27,0,674,221,242,21
"2ae94c0cea4d480a9d5dca8fb1d7b542","1ebf23f9d994469a85206e4c7b1bf5f5",22857747,3,3,0,675,242,245,3
"1ebf23f9d994469a85206e4c7b1bf5f5","d7f13c8d63ec4e2aa673fbb9cf9c6933",22857747,1,-51,0,676,245,206,-39
"d7f13c8d63ec4e2aa673fbb9cf9c6933","01b2051f8941460d89945e3b02d1ce78",22857747,1,14,0,677,206,217,11
"01b2051f8941460d89945e3b02d1ce78","363837c182e04711840d896ae1e0339c",22857747,1,1,0,678,217,218,1
"01b2051f8941460d89945e3b02d1ce78","be95c065e45447c1bd8215ea6f130c7a",22857747,1,3,0,680,217,219,2
"be95c065e45447c1bd8215ea6f130c7a","363837c182e04711840d896ae1e0339c",22857747,1,-2,0,681,219,218,-1
"1c6721b1f63f4d30ba7746ea8af02a52","0b04c8e2f86d48c7aeb7e225819cd32b",22857747,1,16,0,687,221,234,13
"1ebf23f9d994469a85206e4c7b1bf5f5","1ebf23f9d994469a85206e4c7b1bf5f5",22857747,13,0,1,693,245,245,0
"1ebf23f9d994469a85206e4c7b1bf5f5","85ae675b83e8422da842cfd25596af99",22857747,1,1,0,706,245,246,1
"85ae675b83e8422da842cfd25596af99","85ae675b83e8422da842cfd25596af99",22857747,1,0,1,707,246,246,0
"85ae675b83e8422da842cfd25596af99","2ae94c0cea4d480a9d5dca8fb1d7b542",22857747,1,-4,0,708,246,242,-4
"2ae94c0cea4d480a9d5dca8fb1d7b542","fa235f0f364d47e4ae1c87f47bf8e6ba",22857747,1,12,0,709,242,252,10
"fa235f0f364d47e4ae1c87f47bf8e6ba","79f7845465cc4ed19d8e4f1429541be0",22857747,1,2,0,710,252,254,2
"79f7845465cc4ed19d8e4f1429541be0","79f7845465cc4ed19d8e4f1429541be0",22857747,2,0,1,711,254,254,0
"79f7845465cc4ed19d8e4f1429541be0","fa235f0f364d47e4ae1c87f47bf8e6ba",22857747,1,-2,0,713,254,252,-2
"fa235f0f364d47e4ae1c87f47bf8e6ba","fa235f0f364d47e4ae1c87f47bf8e6ba",22857747,2,0,1,714,252,252,0
"fa235f0f364d47e4ae1c87f47bf8e6ba","6e83e23f56544a19b94067c1c558d9c0",22857747,1,-6,0,716,252,247,-5
"6e83e23f56544a19b94067c1c558d9c0","00f61990949545828dd12f1303d47504",22857747,1,11,0,717,247,256,9
"00f61990949545828dd12f1303d47504","ead7bb4b64e247d2ae632ab8a296b091",22857747,1,2,0,718,256,258,2
"b41c5a094a604ee0915327da5cc0beb7","00f61990949545828dd12f1303d47504",22857747,1,-4,0,730,260,256,-4
"00f61990949545828dd12f1303d47504","d546341988904f069cfa86b21457d9d9",22857747,1,-6,0,731,256,251,-5
"d546341988904f069cfa86b21457d9d9","28c171777c52431ab6b925073bd63d46",22857747,1,15,0,732,251,264,13
"28c171777c52431ab6b925073bd63d46","28c171777c52431ab6b925073bd63d46",22857747,7,0,1,733,264,264,0
"28c171777c52431ab6b925073bd63d46","ac160db940cb49ae8579162b1d52bb5d",22857747,1,2,0,740,264,266,2
"ac160db940cb49ae8579162b1d52bb5d","ac160db940cb49ae8579162b1d52bb5d",22857747,15,0,1,741,266,266,0
"ac160db940cb49ae8579162b1d52bb5d","d989ebcfc12a4b669f0100dc1aa14f1e",22857747,1,-12,0,756,266,255,-11
"d989ebcfc12a4b669f0100dc1aa14f1e","c6fd49b485cc4874b0bbdd9c6171e09c",22857747,1,15,0,757,255,268,13
"7aa76d3e993840d8805f097cbdbcd44b","865a4d3b43374da7944dc7d397f566d9",22857747,1,12,0,765,261,271,10
"865a4d3b43374da7944dc7d397f566d9","0d987bed3ffa4ed0b9a2e62e97b7b30f",22857747,1,3,0,767,271,272,1
"82ae07bc0c9b4570a41799290d1ef399","94cecc3f1e7d484b8e068e79241dfd73",22857747,1,9,0,779,275,281,6
"208c9b2796c944db8dacaa96082520ea","208c9b2796c944db8dacaa96082520ea",22857747,1,0,1,789,288,288,0
"208c9b2796c944db8dacaa96082520ea","4a29443515bb404cb8924e1c60a63b73",22857747,1,-3,0,790,288,285,-3
"4a29443515bb404cb8924e1c60a63b73","7669a956527947d0add87455277e80b4",22857747,1,7,0,791,285,291,6
"7669a956527947d0add87455277e80b4","7669a956527947d0add87455277e80b4",22857747,1,0,1,792,291,291,0
"7669a956527947d0add87455277e80b4","6a9a3b5bde4a48daa896fe8c06eca56f",22857747,1,-2,0,793,291,289,-2
"6a9a3b5bde4a48daa896fe8c06eca56f","869e967078f04da18dd0b0b9389a7424",22857747,1,5,0,794,289,293,4
"869e967078f04da18dd0b0b9389a7424","869e967078f04da18dd0b0b9389a7424",22857747,1,0,1,795,293,293,0
"869e967078f04da18dd0b0b9389a7424","51ab6291537748fab90d519aa09889d6",22857747,1,2,0,796,293,295,2
"ba0e59461bfb4a44b7b1c28a01f8d3b3","ba0e59461bfb4a44b7b1c28a01f8d3b3",22857747,1,0,1,805,299,299,0
"7646a919d7e64fa990bca9b024ff089d","e390b575229748ea8aac9364efe2bf00",22857747,1,7,0,813,298,304,6
"e390b575229748ea8aac9364efe2bf00","e390b575229748ea8aac9364efe2bf00",22857747,1,0,1,814,304,304,0
"e390b575229748ea8aac9364efe2bf00","3434c10e561d488a914e0f7d71907abd",22857747,1,3,0,815,304,305,1
"53e7e900392747ccad52e711ab0f80d8","53e7e900392747ccad52e711ab0f80d8",22857747,1,0,1,818,307,307,0
"130acc2aeb0448fdbb2de63bc5cebe5b","130acc2aeb0448fdbb2de63bc5cebe5b",22857747,1,0,1,821,309,309,0
"130acc2aeb0448fdbb2de63bc5cebe5b","9c062b3251034ebe90f5054e2a3b5120",22857747,1,2,0,822,309,311,2
"9c062b3251034ebe90f5054e2a3b5120","9c062b3251034ebe90f5054e2a3b5120",22857747,2,0,1,823,311,311,0
"9c062b3251034ebe90f5054e2a3b5120","ea859f8207e44537889daeaba13ac2e8",22857747,1,1,0,825,311,312,1
"ea859f8207e44537889daeaba13ac2e8","ea859f8207e44537889daeaba13ac2e8",22857747,7,0,1,826,312,312,0
"ea859f8207e44537889daeaba13ac2e8","56d94971a7a94257aa330183a8ebd0ea",22857747,1,1,0,833,312,313,1
"56d94971a7a94257aa330183a8ebd0ea","56d94971a7a94257aa330183a8ebd0ea",22857747,1,0,1,834,313,313,0
"56d94971a7a94257aa330183a8ebd0ea","141c0df6cd1946539aadd1c9b7068cd4",22857747,1,-5,0,835,313,308,-5
"86c27d40179e419c8e9d150fb6afa5d0","86c27d40179e419c8e9d150fb6afa5d0",22857747,1,0,1,840,319,319,0
"47edbb64109243e6b0f8f64cdef90c6c","24f1363179ad4aaa965484a78471912b",22857747,2,-3,0,844,326,323,-3
"24f1363179ad4aaa965484a78471912b","3628bdce1dd2429ba924d2d4d09448d2",22857747,1,-1,0,845,323,322,-1
"3628bdce1dd2429ba924d2d4d09448d2","47edbb64109243e6b0f8f64cdef90c6c",22857747,1,4,0,846,322,326,4
"24f1363179ad4aaa965484a78471912b","43ea1b823a4b4e51b7c694c10725db82",22857747,1,5,0,848,323,327,4
"43ea1b823a4b4e51b7c694c10725db82","3628bdce1dd2429ba924d2d4d09448d2",22857747,1,-6,0,849,327,322,-5
"38aea304b4fa46e1b29bb72f5cea4c93","38aea304b4fa46e1b29bb72f5cea4c93",22857747,1,0,1,855,331,331,0
"38aea304b4fa46e1b29bb72f5cea4c93","e36d261332f14e79bb4b467aceaeb9b5",22857747,1,2,0,856,331,333,2
"e36d261332f14e79bb4b467aceaeb9b5","e36d261332f14e79bb4b467aceaeb9b5",22857747,1,0,1,857,333,333,0
"e36d261332f14e79bb4b467aceaeb9b5","c7e89b9d04744d2eab742fc24e3ef1ae",22857747,1,1,0,858,333,334,1
"c7e89b9d04744d2eab742fc24e3ef1ae","c7e89b9d04744d2eab742fc24e3ef1ae",22857747,2,0,1,859,334,334,0
"c7e89b9d04744d2eab742fc24e3ef1ae","fe49f8054b374a0ea4bb266ed135ff62",22857747,1,1,0,861,334,335,1
"fe49f8054b374a0ea4bb266ed135ff62","fe49f8054b374a0ea4bb266ed135ff62",22857747,2,0,1,862,335,335,0
"fe49f8054b374a0ea4bb266ed135ff62","d0a8f74af98642fe8360d22c42e45117",22857747,1,1,0,864,335,336,1
"d0a8f74af98642fe8360d22c42e45117","d0a8f74af98642fe8360d22c42e45117",22857747,2,0,1,865,336,336,0
"d0a8f74af98642fe8360d22c42e45117","0c4079457ede49e3aeb5e86ed84bdf35",22857747,1,-7,0,867,336,329,-7
"0c4079457ede49e3aeb5e86ed84bdf35","a7c6339ca1da4368a18d471f0519f877",22857747,1,11,0,868,329,339,10
"a7c6339ca1da4368a18d471f0519f877","a7c6339ca1da4368a18d471f0519f877",22857747,1,0,1,869,339,339,0
"a7c6339ca1da4368a18d471f0519f877","bbc5139ca9024389a94db3a6f47dcff6",22857747,1,3,0,870,339,341,2
"bbc5139ca9024389a94db3a6f47dcff6","b8b9418ab322418d9db9b40d96af873a",22857747,1,-5,0,871,341,337,-4
"b8b9418ab322418d9db9b40d96af873a","4ee6ca9019ab4a1ab323f98094a9bd77",22857747,1,7,0,872,337,343,6
"4ee6ca9019ab4a1ab323f98094a9bd77","4ee6ca9019ab4a1ab323f98094a9bd77",22857747,2,0,1,873,343,343,0
"4ee6ca9019ab4a1ab323f98094a9bd77","b37947176785476f8b29d49a851366dc",22857747,1,1,0,875,343,344,1
"b37947176785476f8b29d49a851366dc","b37947176785476f8b29d49a851366dc",22857747,2,0,1,876,344,344,0
"b37947176785476f8b29d49a851366dc","bbc5139ca9024389a94db3a6f47dcff6",22857747,1,-3,0,878,344,341,-3
"bbc5139ca9024389a94db3a6f47dcff6","fcea5b10d5a14a3b9324ffece8f6e1e5",22857747,1,4,0,879,341,345,4
"fcea5b10d5a14a3b9324ffece8f6e1e5","fcea5b10d5a14a3b9324ffece8f6e1e5",22857747,2,0,1,880,345,345,0
"fcea5b10d5a14a3b9324ffece8f6e1e5","c2490bc612d146edbe786556fab3651b",22857747,1,-5,0,882,345,340,-5
"30ead9794d4847abaf222ca966cc8630","c20993c944444fe085345591a8bd837e",22857747,1,3,0,887,348,351,3
"eff0de7f2dbb42dfa1a2e686efab5b6d","30ead9794d4847abaf222ca966cc8630",22857747,2,-6,0,907,354,348,-6
"30ead9794d4847abaf222ca966cc8630","2fe14166dc9642c3bc666b86a57f943d",22857747,2,10,0,908,348,357,9
"2fe14166dc9642c3bc666b86a57f943d","2fe14166dc9642c3bc666b86a57f943d",22857747,1,0,1,909,357,357,0
"2fe14166dc9642c3bc666b86a57f943d","44421dd1e13a47a388c4a19834b744c7",22857747,1,2,0,910,357,359,2
"44421dd1e13a47a388c4a19834b744c7","44421dd1e13a47a388c4a19834b744c7",22857747,2,0,1,911,359,359,0
"44421dd1e13a47a388c4a19834b744c7","cb5fc7ef85d547c4be1a7439d0bf6052",22857747,1,1,0,913,359,360,1
"cb5fc7ef85d547c4be1a7439d0bf6052","cb5fc7ef85d547c4be1a7439d0bf6052",22857747,2,0,1,914,360,360,0
"cb5fc7ef85d547c4be1a7439d0bf6052","0a8f150a4cf747acbde62f4721823da3",22857747,1,1,0,916,360,361,1
"0a8f150a4cf747acbde62f4721823da3","0a8f150a4cf747acbde62f4721823da3",22857747,2,0,1,917,361,361,0
"0a8f150a4cf747acbde62f4721823da3","ab8fdad974ae471f9f24c3f9dd04462e",22857747,1,1,0,919,361,362,1
"ab8fdad974ae471f9f24c3f9dd04462e","ab8fdad974ae471f9f24c3f9dd04462e",22857747,2,0,1,920,362,362,0
"ab8fdad974ae471f9f24c3f9dd04462e","52580888dadb4fe3baa795683ea227bd",22857747,1,3,0,922,362,364,2
"52580888dadb4fe3baa795683ea227bd","1ba8fef685d74a8194b9db252eb704fb",22857747,1,-10,0,923,364,355,-9
"492a3bc6a1254f23a7998587961b22a4","492a3bc6a1254f23a7998587961b22a4",22857747,1,0,1,927,366,366,0
"072a190fd302456290895f9f04d6940a","897b7f51242c44aab2205c72fdcbf4cd",22857747,1,-16,0,929,365,352,-13
"897b7f51242c44aab2205c72fdcbf4cd","c20993c944444fe085345591a8bd837e",22857747,1,-1,0,930,352,351,-1
"c20993c944444fe085345591a8bd837e","eff0de7f2dbb42dfa1a2e686efab5b6d",22857747,1,3,0,931,351,354,3
"eff0de7f2dbb42dfa1a2e686efab5b6d","c76574d21bc14aeea7ecd0b027f39858",22857747,1,17,0,932,354,367,13
"c76574d21bc14aeea7ecd0b027f39858","897b7f51242c44aab2205c72fdcbf4cd",22857747,1,-19,0,933,367,352,-15
"c20993c944444fe085345591a8bd837e","09b9678ddc3d452ea4a3d46e15826065",22857747,1,2,0,937,351,353,2
"09b9678ddc3d452ea4a3d46e15826065","897b7f51242c44aab2205c72fdcbf4cd",22857747,1,-1,0,939,353,352,-1
"897b7f51242c44aab2205c72fdcbf4cd","eff0de7f2dbb42dfa1a2e686efab5b6d",22857747,1,2,0,940,352,354,2
"2fe14166dc9642c3bc666b86a57f943d","1ba8fef685d74a8194b9db252eb704fb",22857747,1,-2,0,944,357,355,-2
"1ba8fef685d74a8194b9db252eb704fb","cfa457d1743848e4bb5e4beced6448ed",22857747,1,17,0,945,355,369,14
"30ead9794d4847abaf222ca966cc8630","8d448d625b024c82a5eb240bbd7431d6",22857747,1,33,0,949,348,374,26
"d6d02b6ef04e4f17805504500b8ce441","b2f0d654738f48158edff28e8d3a546e",22857747,1,116,0,963,375,449,74
"b2f0d654738f48158edff28e8d3a546e","b2f0d654738f48158edff28e8d3a546e",22857747,1,0,1,964,449,449,0
"f60ee41ec635499abd48168342d32c2f","f60ee41ec635499abd48168342d32c2f",22857747,69,0,1,1000,453,453,0
"f60ee41ec635499abd48168342d32c2f","78adeee1fa2c4fe0bc73f7bca9fcee86",22857747,1,-413,0,1008,453,160,-293
"78adeee1fa2c4fe0bc73f7bca9fcee86","65202579580f4ad38d734b4ee39d22a8",22857747,6,5,0,1009,160,164,4
"65202579580f4ad38d734b4ee39d22a8","65202579580f4ad38d734b4ee39d22a8",22857747,81,0,1,1010,164,164,0
"65202579580f4ad38d734b4ee39d22a8","0d987bed3ffa4ed0b9a2e62e97b7b30f",22857747,1,147,0,1062,164,272,108
"0d987bed3ffa4ed0b9a2e62e97b7b30f","bb5a47f5ea01454a8b79455422d3b9da",22857747,6,10,0,1063,272,280,8
"bb5a47f5ea01454a8b79455422d3b9da","bb5a47f5ea01454a8b79455422d3b9da",22857747,92,0,1,1064,280,280,0
"bb5a47f5ea01454a8b79455422d3b9da","bc5524e78a8544e2ae2fdc2f3462bbec",22857747,2,-1,0,1071,280,279,-1
"bc5524e78a8544e2ae2fdc2f3462bbec","0d987bed3ffa4ed0b9a2e62e97b7b30f",22857747,2,-9,0,1072,279,272,-7
"bb5a47f5ea01454a8b79455422d3b9da","82ae07bc0c9b4570a41799290d1ef399",22857747,3,-6,0,1078,280,275,-5
"82ae07bc0c9b4570a41799290d1ef399","bb5a47f5ea01454a8b79455422d3b9da",22857747,2,6,0,1079,275,280,5
"bb5a47f5ea01454a8b79455422d3b9da","b2f0d654738f48158edff28e8d3a546e",22857747,1,246,0,1082,280,449,169
"b2f0d654738f48158edff28e8d3a546e","f60ee41ec635499abd48168342d32c2f",22857747,4,5,0,1083,449,453,4
"f60ee41ec635499abd48168342d32c2f","66baf19b6b904b70922329068c63746d",22857747,1,-117,0,1092,453,376,-77
"66baf19b6b904b70922329068c63746d","7f544639412e40a9ba27f43b415362ab",22857747,2,2,0,1093,376,378,2
"7f544639412e40a9ba27f43b415362ab","7f544639412e40a9ba27f43b415362ab",22857747,2,0,1,1094,378,378,0
"7f544639412e40a9ba27f43b415362ab","d5ae8642e15b46b8bd298b02274d4e9c",22857747,1,2,0,1096,378,380,2
"d5ae8642e15b46b8bd298b02274d4e9c","d5ae8642e15b46b8bd298b02274d4e9c",22857747,1,0,1,1097,380,380,0
"d5ae8642e15b46b8bd298b02274d4e9c","a0d10309a2dd456289147f84be9d37f9",22857747,1,1,0,1098,380,381,1
"a0d10309a2dd456289147f84be9d37f9","a0d10309a2dd456289147f84be9d37f9",22857747,2,0,1,1099,381,381,0
"a0d10309a2dd456289147f84be9d37f9","0fcbc3ca07b144138b8d85da581f09a8",22857747,1,1,0,1101,381,382,1
"0fcbc3ca07b144138b8d85da581f09a8","0fcbc3ca07b144138b8d85da581f09a8",22857747,2,0,1,1102,382,382,0
"0fcbc3ca07b144138b8d85da581f09a8","66baf19b6b904b70922329068c63746d",22857747,1,-6,0,1104,382,376,-6
"66baf19b6b904b70922329068c63746d","4890121ce5d74576b4632b77cfc23398",22857747,1,14,0,1105,376,388,12
"4890121ce5d74576b4632b77cfc23398","c2fca3669923477ab966ded303dea31c",22857747,1,-6,0,1106,388,383,-5
"c2fca3669923477ab966ded303dea31c","4890121ce5d74576b4632b77cfc23398",22857747,2,6,0,1107,383,388,5
"4890121ce5d74576b4632b77cfc23398","18d3b836dd804224883cc9180b60a8e1",22857747,2,-1,0,1108,388,387,-1
"18d3b836dd804224883cc9180b60a8e1","96bb2b3e85a34d8b9544514e89f6fe97",22857747,2,4,0,1109,387,390,3
"96bb2b3e85a34d8b9544514e89f6fe97","96bb2b3e85a34d8b9544514e89f6fe97",22857747,1,0,1,1110,390,390,0
"96bb2b3e85a34d8b9544514e89f6fe97","ac4e9b54acfe4670b4634859c7263cb5",22857747,1,2,0,1111,390,392,2
"ac4e9b54acfe4670b4634859c7263cb5","ac4e9b54acfe4670b4634859c7263cb5",22857747,3,0,1,1112,392,392,0
"ac4e9b54acfe4670b4634859c7263cb5","17f95d18bab743888e1736033dc3384d",22857747,1,-3,0,1115,392,389,-3
"17f95d18bab743888e1736033dc3384d","6f8881a745ac4c358a68b92c3b4abe81",22857747,2,6,0,1116,389,394,5
"6f8881a745ac4c358a68b92c3b4abe81","6f8881a745ac4c358a68b92c3b4abe81",22857747,1,0,1,1117,394,394,0
"6f8881a745ac4c358a68b92c3b4abe81","f7002c8484354eceac57bc7bd62c76c1",22857747,2,-1,0,1118,394,393,-1
"f7002c8484354eceac57bc7bd62c76c1","78adeee1fa2c4fe0bc73f7bca9fcee86",22857747,1,-317,0,1119,393,160,-233
"65202579580f4ad38d734b4ee39d22a8","3cbcea2be0984e7dbd5a48195af10ce7",22857747,1,3,0,1130,164,165,1
"3cbcea2be0984e7dbd5a48195af10ce7","78adeee1fa2c4fe0bc73f7bca9fcee86",22857747,1,-8,0,1131,165,160,-5
"78adeee1fa2c4fe0bc73f7bca9fcee86","82e6285962b8400d9d6fc32436022a94",22857747,1,10,0,1132,160,167,7
"82e6285962b8400d9d6fc32436022a94","3cbcea2be0984e7dbd5a48195af10ce7",22857747,1,-2,0,1133,167,165,-2
"3cbcea2be0984e7dbd5a48195af10ce7","3cbcea2be0984e7dbd5a48195af10ce7",22857747,2,0,1,1134,165,165,0
"3cbcea2be0984e7dbd5a48195af10ce7","82e6285962b8400d9d6fc32436022a94",22857747,1,2,0,1136,165,167,2
"82e6285962b8400d9d6fc32436022a94","a9ac840f098c4bd0a2ee896214ce29cd",22857747,1,3,0,1137,167,168,1
"a9ac840f098c4bd0a2ee896214ce29cd","3cbcea2be0984e7dbd5a48195af10ce7",22857747,1,-5,0,1138,168,165,-3
"3cbcea2be0984e7dbd5a48195af10ce7","0c7262dff33c4087bc660ccf40f92f9c",22857747,1,9,0,1139,165,169,4
"0c7262dff33c4087bc660ccf40f92f9c","a9ac840f098c4bd0a2ee896214ce29cd",22857747,1,-4,0,1140,169,168,-1
"a9ac840f098c4bd0a2ee896214ce29cd","b2275c3fad834f8d90737a2d9a6927d6",22857747,1,7,0,1141,168,172,4
"b2275c3fad834f8d90737a2d9a6927d6","0c7262dff33c4087bc660ccf40f92f9c",22857747,2,-3,0,1142,172,169,-3
"0c7262dff33c4087bc660ccf40f92f9c","b42cc17b7de840f181a704558d0bc845",22857747,2,7,0,1143,169,175,6
"b42cc17b7de840f181a704558d0bc845","ea38cc0e6e6e41edbabf210220808bf9",22857747,1,5,0,1144,175,179,4
"ea38cc0e6e6e41edbabf210220808bf9","362fcb0699a14845ab29b2340093e528",22857747,2,-6,0,1145,179,174,-5
"362fcb0699a14845ab29b2340093e528","b87c552dd247427abe6ab5795b9c9d43",22857747,2,8,0,1146,174,181,7
"b87c552dd247427abe6ab5795b9c9d43","139b097acfca451689d80c9c6eebdf7b",22857747,2,-3,0,1147,181,178,-3
"139b097acfca451689d80c9c6eebdf7b","2024b4885bd14338a39b7b509acbbd02",22857747,1,5,0,1148,178,182,4
"2024b4885bd14338a39b7b509acbbd02","cf4c280bad6a43e6b131d8385ef9ef3f",22857747,1,3,0,1149,182,184,2
"cf4c280bad6a43e6b131d8385ef9ef3f","b42cc17b7de840f181a704558d0bc845",22857747,1,-12,0,1150,184,175,-9
"b42cc17b7de840f181a704558d0bc845","801f9e9135034f49bf5f8b4bdefedb41",22857747,2,2,0,1151,175,177,2
"801f9e9135034f49bf5f8b4bdefedb41","801f9e9135034f49bf5f8b4bdefedb41",22857747,8,0,1,1152,177,177,0
"801f9e9135034f49bf5f8b4bdefedb41","ea38cc0e6e6e41edbabf210220808bf9",22857747,1,3,0,1156,177,179,2
"139b097acfca451689d80c9c6eebdf7b","30f660a1feb34582a739722532524f79",22857747,2,6,0,1160,178,183,5
"30f660a1feb34582a739722532524f79","30f660a1feb34582a739722532524f79",22857747,6,0,1,1161,183,183,0
"30f660a1feb34582a739722532524f79","2024b4885bd14338a39b7b509acbbd02",22857747,2,-1,0,1162,183,182,-1
"2024b4885bd14338a39b7b509acbbd02","c3f63fe50d8e487c86bf8ef76c9cadd3",22857747,2,4,0,1163,182,185,3
"c3f63fe50d8e487c86bf8ef76c9cadd3","c3f63fe50d8e487c86bf8ef76c9cadd3",22857747,4,0,1,1164,185,185,0
"c3f63fe50d8e487c86bf8ef76c9cadd3","0c7262dff33c4087bc660ccf40f92f9c",22857747,3,-20,0,1165,185,169,-16
"0c7262dff33c4087bc660ccf40f92f9c","c8e371568a0c4391b25796ae4e91952e",22857747,2,23,0,1166,169,186,17
"c8e371568a0c4391b25796ae4e91952e","c8e371568a0c4391b25796ae4e91952e",22857747,1,0,1,1167,186,186,0
"c8e371568a0c4391b25796ae4e91952e","ab11d94c6c8948ea90b88f19d2cd502b",22857747,2,5,0,1168,186,190,4
"ab11d94c6c8948ea90b88f19d2cd502b","07b44a7a51e94c78b411c753fc39dab0",22857747,1,-1,0,1169,190,189,-1
"07b44a7a51e94c78b411c753fc39dab0","6cd2dcaac46847d4a0bc53f296d90375",22857747,2,6,0,1170,189,194,5
"6cd2dcaac46847d4a0bc53f296d90375","017d7ca8e0394b91aaadc9574df2202c",22857747,1,-1,0,1171,194,193,-1
"017d7ca8e0394b91aaadc9574df2202c","f9170dd6bc6442b4acd832747609b09a",22857747,1,7,0,1172,193,199,6
"f9170dd6bc6442b4acd832747609b09a","c8e371568a0c4391b25796ae4e91952e",22857747,1,-16,0,1173,199,186,-13
"c8e371568a0c4391b25796ae4e91952e","d7f13c8d63ec4e2aa673fbb9cf9c6933",22857747,2,26,0,1174,186,206,20
"d7f13c8d63ec4e2aa673fbb9cf9c6933","7108f0e4c2584f1f9c471689ae4c885c",22857747,1,2,0,1175,206,208,2
"7108f0e4c2584f1f9c471689ae4c885c","b9e80f77c3a44349863b19875725c384",22857747,2,-1,0,1176,208,207,-1
"b9e80f77c3a44349863b19875725c384","09400e101c5d4b439cf9a26b03aae558",22857747,1,4,0,1177,207,210,3
"09400e101c5d4b439cf9a26b03aae558","d7f13c8d63ec4e2aa673fbb9cf9c6933",22857747,1,-5,0,1178,210,206,-4
"d7f13c8d63ec4e2aa673fbb9cf9c6933","be502a7a43c44bf7b682698de79d9369",22857747,1,10,0,1179,206,214,8
"be502a7a43c44bf7b682698de79d9369","f7fb1952f56b4189b86a9f8b7862d2b8",22857747,2,1,0,1180,214,215,1
"f7fb1952f56b4189b86a9f8b7862d2b8","a875096404ef4a9984b62d74cda916f9",22857747,1,-7,0,1181,215,209,-6
"a875096404ef4a9984b62d74cda916f9","363837c182e04711840d896ae1e0339c",22857747,1,11,0,1182,209,218,9
"363837c182e04711840d896ae1e0339c","ec341f459285443b8361f7f15638ff08",22857747,1,-6,0,1183,218,213,-5
"ec341f459285443b8361f7f15638ff08","01b2051f8941460d89945e3b02d1ce78",22857747,1,5,0,1184,213,217,4
"01b2051f8941460d89945e3b02d1ce78","d7f13c8d63ec4e2aa673fbb9cf9c6933",22857747,2,-14,0,1185,217,206,-11
"d7f13c8d63ec4e2aa673fbb9cf9c6933","1c6721b1f63f4d30ba7746ea8af02a52",22857747,2,21,0,1186,206,221,15
"1c6721b1f63f4d30ba7746ea8af02a52","77ecef8eff6b4a2caea7707669bf7475",22857747,2,1,0,1187,221,222,1
"77ecef8eff6b4a2caea7707669bf7475","1c6721b1f63f4d30ba7746ea8af02a52",22857747,3,-1,0,1188,222,221,-1
"1c6721b1f63f4d30ba7746ea8af02a52","66d4fad4f1cf4b46be0750a99ad7a35a",22857747,1,21,0,1189,221,239,18
"66d4fad4f1cf4b46be0750a99ad7a35a","66d4fad4f1cf4b46be0750a99ad7a35a",22857747,3,0,1,1190,239,239,0
"66d4fad4f1cf4b46be0750a99ad7a35a","ca3e28f290354c08aefe5b0f769604e6",22857747,1,-4,0,1191,239,235,-4
"ca3e28f290354c08aefe5b0f769604e6","ca3e28f290354c08aefe5b0f769604e6",22857747,13,0,1,1192,235,235,0
"ca3e28f290354c08aefe5b0f769604e6","79a35eea833e4c2c9d22fc53c3c6445c",22857747,2,1,0,1196,235,236,1
"79a35eea833e4c2c9d22fc53c3c6445c","79a35eea833e4c2c9d22fc53c3c6445c",22857747,13,0,1,1197,236,236,0
"79a35eea833e4c2c9d22fc53c3c6445c","8f68228b1518449e9615cdafee41a2bd",22857747,2,1,0,1201,236,237,1
"8f68228b1518449e9615cdafee41a2bd","8f68228b1518449e9615cdafee41a2bd",22857747,2,0,1,1202,237,237,0
"8f68228b1518449e9615cdafee41a2bd","cab89fa5c3ed45a5aa550fc0352d6a42",22857747,2,1,0,1203,237,238,1
"cab89fa5c3ed45a5aa550fc0352d6a42","cab89fa5c3ed45a5aa550fc0352d6a42",22857747,2,0,1,1204,238,238,0
"cab89fa5c3ed45a5aa550fc0352d6a42","66d4fad4f1cf4b46be0750a99ad7a35a",22857747,2,1,0,1205,238,239,1
"66d4fad4f1cf4b46be0750a99ad7a35a","0b04c8e2f86d48c7aeb7e225819cd32b",22857747,2,-5,0,1207,239,234,-5
"0b04c8e2f86d48c7aeb7e225819cd32b","f53da5fd9bfe412da4b80d4742563b6c",22857747,1,8,0,1208,234,241,7
"f53da5fd9bfe412da4b80d4742563b6c","f53da5fd9bfe412da4b80d4742563b6c",22857747,2,0,1,1209,241,241,0
"f53da5fd9bfe412da4b80d4742563b6c","2ae94c0cea4d480a9d5dca8fb1d7b542",22857747,1,3,0,1210,241,242,1
"2ae94c0cea4d480a9d5dca8fb1d7b542","1c6721b1f63f4d30ba7746ea8af02a52",22857747,1,-27,0,1211,242,221,-21
"1c6721b1f63f4d30ba7746ea8af02a52","1ebf23f9d994469a85206e4c7b1bf5f5",22857747,1,30,0,1212,221,245,24
"1ebf23f9d994469a85206e4c7b1bf5f5","2ae94c0cea4d480a9d5dca8fb1d7b542",22857747,2,-3,0,1213,245,242,-3
"2ae94c0cea4d480a9d5dca8fb1d7b542","30c9ba177afc49a695625d2bdec40207",22857747,1,9,0,1214,242,250,8
"30c9ba177afc49a695625d2bdec40207","30c9ba177afc49a695625d2bdec40207",22857747,2,0,1,1215,250,250,0
"30c9ba177afc49a695625d2bdec40207","00f61990949545828dd12f1303d47504",22857747,1,8,0,1217,250,256,6
"00f61990949545828dd12f1303d47504","6e83e23f56544a19b94067c1c558d9c0",22857747,1,-11,0,1218,256,247,-9
"6e83e23f56544a19b94067c1c558d9c0","ead7bb4b64e247d2ae632ab8a296b091",22857747,1,13,0,1219,247,258,11
"ead7bb4b64e247d2ae632ab8a296b091","ead7bb4b64e247d2ae632ab8a296b091",22857747,4,0,1,1220,258,258,0
"ead7bb4b64e247d2ae632ab8a296b091","41b0048dde734bb280bac6116baa8e27",22857747,2,1,0,1222,258,259,1
"41b0048dde734bb280bac6116baa8e27","41b0048dde734bb280bac6116baa8e27",22857747,4,0,1,1223,259,259,0
"41b0048dde734bb280bac6116baa8e27","b41c5a094a604ee0915327da5cc0beb7",22857747,2,1,0,1225,259,260,1
"b41c5a094a604ee0915327da5cc0beb7","b41c5a094a604ee0915327da5cc0beb7",22857747,7,0,1,1226,260,260,0
"b41c5a094a604ee0915327da5cc0beb7","d546341988904f069cfa86b21457d9d9",22857747,1,-10,0,1228,260,251,-9
"d546341988904f069cfa86b21457d9d9","c6fd49b485cc4874b0bbdd9c6171e09c",22857747,1,20,0,1229,251,268,17
"c6fd49b485cc4874b0bbdd9c6171e09c","c6fd49b485cc4874b0bbdd9c6171e09c",22857747,6,0,1,1230,268,268,0
"c6fd49b485cc4874b0bbdd9c6171e09c","44240778a97c4af0937817499b75707b",22857747,2,1,0,1233,268,269,1
"44240778a97c4af0937817499b75707b","44240778a97c4af0937817499b75707b",22857747,4,0,1,1234,269,269,0
"44240778a97c4af0937817499b75707b","7aa76d3e993840d8805f097cbdbcd44b",22857747,2,-9,0,1236,269,261,-8
"7aa76d3e993840d8805f097cbdbcd44b","2ae94c0cea4d480a9d5dca8fb1d7b542",22857747,1,-23,0,1237,261,242,-19
"2ae94c0cea4d480a9d5dca8fb1d7b542","0d987bed3ffa4ed0b9a2e62e97b7b30f",22857747,4,38,0,1238,242,272,30
"0d987bed3ffa4ed0b9a2e62e97b7b30f","0d987bed3ffa4ed0b9a2e62e97b7b30f",22857747,4,0,1,1239,272,272,0
"0d987bed3ffa4ed0b9a2e62e97b7b30f","2ae94c0cea4d480a9d5dca8fb1d7b542",22857747,2,-38,0,1242,272,242,-30
"2ae94c0cea4d480a9d5dca8fb1d7b542","2ae94c0cea4d480a9d5dca8fb1d7b542",22857747,3,0,1,1243,242,242,0
"0d987bed3ffa4ed0b9a2e62e97b7b30f","865a4d3b43374da7944dc7d397f566d9",22857747,1,-3,0,1247,272,271,-1
"865a4d3b43374da7944dc7d397f566d9","865a4d3b43374da7944dc7d397f566d9",22857747,2,0,1,1248,271,271,0
"865a4d3b43374da7944dc7d397f566d9","2ae94c0cea4d480a9d5dca8fb1d7b542",22857747,1,-35,0,1249,271,242,-29
"bb5a47f5ea01454a8b79455422d3b9da","94cecc3f1e7d484b8e068e79241dfd73",22857747,1,3,0,1261,280,281,1
"94cecc3f1e7d484b8e068e79241dfd73","0d987bed3ffa4ed0b9a2e62e97b7b30f",22857747,2,-13,0,1262,281,272,-9
"0d987bed3ffa4ed0b9a2e62e97b7b30f","a37477c4e4c14169ad44b06b493007f6",22857747,2,15,0,1263,272,283,11
"a37477c4e4c14169ad44b06b493007f6","94cecc3f1e7d484b8e068e79241dfd73",22857747,3,-2,0,1264,283,281,-2
"94cecc3f1e7d484b8e068e79241dfd73","fab84b4fab5940efb4ea868ef8d09396",22857747,2,5,0,1265,281,284,3
"fab84b4fab5940efb4ea868ef8d09396","fab84b4fab5940efb4ea868ef8d09396",22857747,2,0,1,1266,284,284,0
"fab84b4fab5940efb4ea868ef8d09396","4a29443515bb404cb8924e1c60a63b73",22857747,2,4,0,1267,284,285,1
"4a29443515bb404cb8924e1c60a63b73","208c9b2796c944db8dacaa96082520ea",22857747,2,3,0,1268,285,288,3
"208c9b2796c944db8dacaa96082520ea","869e967078f04da18dd0b0b9389a7424",22857747,1,7,0,1269,288,293,5
"869e967078f04da18dd0b0b9389a7424","4a29443515bb404cb8924e1c60a63b73",22857747,1,-10,0,1270,293,285,-8
"4a29443515bb404cb8924e1c60a63b73","51ab6291537748fab90d519aa09889d6",22857747,1,12,0,1271,285,295,10
"51ab6291537748fab90d519aa09889d6","51ab6291537748fab90d519aa09889d6",22857747,10,0,1,1272,295,295,0
"51ab6291537748fab90d519aa09889d6","34a6e49023fc4465bd5ca604330bbd1c",22857747,2,-3,0,1277,295,292,-3
"34a6e49023fc4465bd5ca604330bbd1c","21592f2a9e9c4b2f8c66ec5dbcbf6a2b",22857747,2,5,0,1278,292,296,4
"21592f2a9e9c4b2f8c66ec5dbcbf6a2b","ba0e59461bfb4a44b7b1c28a01f8d3b3",22857747,2,4,0,1279,296,299,3
"ba0e59461bfb4a44b7b1c28a01f8d3b3","0e0b36e731a645e7b1b8a88f5031ca38",22857747,2,2,0,1280,299,301,2
"0e0b36e731a645e7b1b8a88f5031ca38","0e0b36e731a645e7b1b8a88f5031ca38",22857747,4,0,1,1281,301,301,0
"0e0b36e731a645e7b1b8a88f5031ca38","a66a144637284c21afc6de17fea4bfb8",22857747,2,1,0,1283,301,302,1
"a66a144637284c21afc6de17fea4bfb8","a66a144637284c21afc6de17fea4bfb8",22857747,4,0,1,1284,302,302,0
"a66a144637284c21afc6de17fea4bfb8","7646a919d7e64fa990bca9b024ff089d",22857747,2,-4,0,1286,302,298,-4
"7646a919d7e64fa990bca9b024ff089d","3434c10e561d488a914e0f7d71907abd",22857747,1,10,0,1287,298,305,7
"3434c10e561d488a914e0f7d71907abd","4a29443515bb404cb8924e1c60a63b73",22857747,2,-27,0,1288,305,285,-20
"4a29443515bb404cb8924e1c60a63b73","53e7e900392747ccad52e711ab0f80d8",22857747,2,29,0,1289,285,307,22
"53e7e900392747ccad52e711ab0f80d8","3434c10e561d488a914e0f7d71907abd",22857747,2,-2,0,1290,307,305,-2
"3434c10e561d488a914e0f7d71907abd","130acc2aeb0448fdbb2de63bc5cebe5b",22857747,2,5,0,1291,305,309,4
"130acc2aeb0448fdbb2de63bc5cebe5b","141c0df6cd1946539aadd1c9b7068cd4",22857747,1,-1,0,1292,309,308,-1
"141c0df6cd1946539aadd1c9b7068cd4","13255e63e0aa4abf85e5211bf613d43e",22857747,2,10,0,1293,308,317,9
"13255e63e0aa4abf85e5211bf613d43e","13255e63e0aa4abf85e5211bf613d43e",22857747,2,0,1,1294,317,317,0
"13255e63e0aa4abf85e5211bf613d43e","0c787d16c9504873b1a4d903cec09948",22857747,2,-3,0,1295,317,314,-3
"0c787d16c9504873b1a4d903cec09948","86c27d40179e419c8e9d150fb6afa5d0",22857747,2,6,0,1296,314,319,5
"86c27d40179e419c8e9d150fb6afa5d0","8d7e0b55cf9849cda222a0f2440cec55",22857747,2,-1,0,1297,319,318,-1
"8d7e0b55cf9849cda222a0f2440cec55","24f1363179ad4aaa965484a78471912b",22857747,2,6,0,1298,318,323,5
"24f1363179ad4aaa965484a78471912b","47edbb64109243e6b0f8f64cdef90c6c",22857747,2,3,0,1299,323,326,3
"47edbb64109243e6b0f8f64cdef90c6c","3628bdce1dd2429ba924d2d4d09448d2",22857747,1,-4,0,1300,326,322,-4
"3628bdce1dd2429ba924d2d4d09448d2","56b3fd1a212a4764be39d979fde3326e",22857747,2,7,0,1301,322,328,6
"56b3fd1a212a4764be39d979fde3326e","56b3fd1a212a4764be39d979fde3326e",22857747,2,0,1,1302,328,328,0
"56b3fd1a212a4764be39d979fde3326e","3434c10e561d488a914e0f7d71907abd",22857747,2,-28,0,1303,328,305,-23
"3434c10e561d488a914e0f7d71907abd","0c4079457ede49e3aeb5e86ed84bdf35",22857747,2,31,0,1304,305,329,24
"0c4079457ede49e3aeb5e86ed84bdf35","38aea304b4fa46e1b29bb72f5cea4c93",22857747,2,2,0,1305,329,331,2
"38aea304b4fa46e1b29bb72f5cea4c93","0c4079457ede49e3aeb5e86ed84bdf35",22857747,1,-2,0,1306,331,329,-2
"0c4079457ede49e3aeb5e86ed84bdf35","b8b9418ab322418d9db9b40d96af873a",22857747,1,9,0,1307,329,337,8
"b8b9418ab322418d9db9b40d96af873a","bbc5139ca9024389a94db3a6f47dcff6",22857747,1,5,0,1308,337,341,4
"bbc5139ca9024389a94db3a6f47dcff6","c2490bc612d146edbe786556fab3651b",22857747,1,-1,0,1309,341,340,-1
"c2490bc612d146edbe786556fab3651b","6ac8bb048b854999a47edb35fe627f11",22857747,2,8,0,1310,340,347,7
"6ac8bb048b854999a47edb35fe627f11","6ac8bb048b854999a47edb35fe627f11",22857747,2,0,1,1311,347,347,0
"6ac8bb048b854999a47edb35fe627f11","0c4079457ede49e3aeb5e86ed84bdf35",22857747,2,-21,0,1312,347,329,-18
"0c4079457ede49e3aeb5e86ed84bdf35","30ead9794d4847abaf222ca966cc8630",22857747,2,24,0,1313,329,348,19
"30ead9794d4847abaf222ca966cc8630","eff0de7f2dbb42dfa1a2e686efab5b6d",22857747,1,6,0,1314,348,354,6
"eff0de7f2dbb42dfa1a2e686efab5b6d","897b7f51242c44aab2205c72fdcbf4cd",22857747,1,-2,0,1315,354,352,-2
"897b7f51242c44aab2205c72fdcbf4cd","09b9678ddc3d452ea4a3d46e15826065",22857747,5,1,0,1316,352,353,1
"09b9678ddc3d452ea4a3d46e15826065","c20993c944444fe085345591a8bd837e",22857747,2,-2,0,1317,353,351,-2
"c20993c944444fe085345591a8bd837e","897b7f51242c44aab2205c72fdcbf4cd",22857747,3,1,0,1318,351,352,1
"897b7f51242c44aab2205c72fdcbf4cd","897b7f51242c44aab2205c72fdcbf4cd",22857747,4,0,1,1319,352,352,0
"09b9678ddc3d452ea4a3d46e15826065","09b9678ddc3d452ea4a3d46e15826065",22857747,5,0,1,1321,353,353,0
"09b9678ddc3d452ea4a3d46e15826065","eff0de7f2dbb42dfa1a2e686efab5b6d",22857747,3,1,0,1322,353,354,1
"eff0de7f2dbb42dfa1a2e686efab5b6d","eff0de7f2dbb42dfa1a2e686efab5b6d",22857747,5,0,1,1323,354,354,0
"eff0de7f2dbb42dfa1a2e686efab5b6d","c20993c944444fe085345591a8bd837e",22857747,2,-3,0,1324,354,351,-3
"c20993c944444fe085345591a8bd837e","c20993c944444fe085345591a8bd837e",22857747,5,0,1,1325,351,351,0
"c20993c944444fe085345591a8bd837e","2fe14166dc9642c3bc666b86a57f943d",22857747,1,7,0,1326,351,357,6
"2fe14166dc9642c3bc666b86a57f943d","30ead9794d4847abaf222ca966cc8630",22857747,1,-10,0,1327,357,348,-9
"30ead9794d4847abaf222ca966cc8630","1ba8fef685d74a8194b9db252eb704fb",22857747,1,8,0,1328,348,355,7
"1ba8fef685d74a8194b9db252eb704fb","52580888dadb4fe3baa795683ea227bd",22857747,2,10,0,1329,355,364,9
"52580888dadb4fe3baa795683ea227bd","f00179e251a045b39c3f7a54f9aa4acc",22857747,2,-1,0,1330,364,363,-1
"f00179e251a045b39c3f7a54f9aa4acc","492a3bc6a1254f23a7998587961b22a4",22857747,2,4,0,1331,363,366,3
"492a3bc6a1254f23a7998587961b22a4","072a190fd302456290895f9f04d6940a",22857747,2,-1,0,1332,366,365,-1
"072a190fd302456290895f9f04d6940a","cfa457d1743848e4bb5e4beced6448ed",22857747,1,5,0,1333,365,369,4
"cfa457d1743848e4bb5e4beced6448ed","cfa457d1743848e4bb5e4beced6448ed",22857747,2,0,1,1334,369,369,0
"cfa457d1743848e4bb5e4beced6448ed","b71bac264efb4abd97015447bd490db6",22857747,2,3,0,1335,369,370,1
"b71bac264efb4abd97015447bd490db6","30ead9794d4847abaf222ca966cc8630",22857747,2,-28,0,1336,370,348,-22
"30ead9794d4847abaf222ca966cc8630","b71bac264efb4abd97015447bd490db6",22857747,1,28,0,1337,348,370,22
"b71bac264efb4abd97015447bd490db6","8d448d625b024c82a5eb240bbd7431d6",22857747,3,5,0,1338,370,374,4
"8d448d625b024c82a5eb240bbd7431d6","8d448d625b024c82a5eb240bbd7431d6",22857747,63,0,1,1339,374,374,0
"8d448d625b024c82a5eb240bbd7431d6","b71bac264efb4abd97015447bd490db6",22857747,3,-5,0,1346,374,370,-4
"b71bac264efb4abd97015447bd490db6","d6d02b6ef04e4f17805504500b8ce441",22857747,2,8,0,1347,370,375,5
"d6d02b6ef04e4f17805504500b8ce441","d6d02b6ef04e4f17805504500b8ce441",22857747,6,0,1,1348,375,375,0
"d6d02b6ef04e4f17805504500b8ce441","66baf19b6b904b70922329068c63746d",22857747,1,4,0,1350,375,376,1
"7f544639412e40a9ba27f43b415362ab","66baf19b6b904b70922329068c63746d",22857747,1,-2,0,1352,378,376,-2
"66baf19b6b904b70922329068c63746d","c2fca3669923477ab966ded303dea31c",22857747,1,8,0,1353,376,383,7
"96bb2b3e85a34d8b9544514e89f6fe97","17f95d18bab743888e1736033dc3384d",22857747,1,-1,0,1357,390,389,-1
"f7002c8484354eceac57bc7bd62c76c1","44a277ea44dc4ae689fab4b82f0b4098",22857747,1,5,0,1360,393,397,4
"44a277ea44dc4ae689fab4b82f0b4098","44a277ea44dc4ae689fab4b82f0b4098",22857747,1,0,1,1361,397,397,0
"44a277ea44dc4ae689fab4b82f0b4098","0c12af0a4e7f4002852cf84b2537c161",22857747,1,-2,0,1362,397,395,-2
"0c12af0a4e7f4002852cf84b2537c161","859e0b8d71694b12befb69ee698138f9",22857747,1,5,0,1363,395,399,4
"859e0b8d71694b12befb69ee698138f9","859e0b8d71694b12befb69ee698138f9",22857747,1,0,1,1364,399,399,0
"859e0b8d71694b12befb69ee698138f9","2b09a08242b54983aec7063990fb3f66",22857747,1,3,0,1365,399,400,1
"2b09a08242b54983aec7063990fb3f66","66baf19b6b904b70922329068c63746d",22857747,1,-32,0,1366,400,376,-24
"66baf19b6b904b70922329068c63746d","2b09a08242b54983aec7063990fb3f66",22857747,1,32,0,1367,376,400,24
"2b09a08242b54983aec7063990fb3f66","1f471b7a883a4df48211e8c6a81b59a7",22857747,1,1,0,1368,400,401,1
"1f471b7a883a4df48211e8c6a81b59a7","1f471b7a883a4df48211e8c6a81b59a7",22857747,1,0,1,1369,401,401,0
"1f471b7a883a4df48211e8c6a81b59a7","2b09a08242b54983aec7063990fb3f66",22857747,1,-1,0,1370,401,400,-1
"2b09a08242b54983aec7063990fb3f66","2b09a08242b54983aec7063990fb3f66",22857747,1,0,1,1371,400,400,0
"2b09a08242b54983aec7063990fb3f66","9de0d567bfa84fe5b77cb76f4a76a5d1",22857747,1,5,0,1372,400,404,4
"9de0d567bfa84fe5b77cb76f4a76a5d1","9de0d567bfa84fe5b77cb76f4a76a5d1",22857747,1,0,1,1373,404,404,0
"9de0d567bfa84fe5b77cb76f4a76a5d1","1157bd665ec4472fb58b751dc5099355",22857747,1,-1,0,1374,404,403,-1
"1157bd665ec4472fb58b751dc5099355","58fc9094275e4c49be3f4ba6d4acc0a4",22857747,1,5,0,1375,403,406,3
"58fc9094275e4c49be3f4ba6d4acc0a4","3c8a22d2f9c146ea956609e3ed4f2559",22857747,1,-2,0,1376,406,405,-1
"3c8a22d2f9c146ea956609e3ed4f2559","c1c1be90b2b14c1ab4a5e1ee3c241902",22857747,1,3,0,1377,405,407,2
"c1c1be90b2b14c1ab4a5e1ee3c241902","c1c1be90b2b14c1ab4a5e1ee3c241902",22857747,5,0,1,1378,407,407,0
"c1c1be90b2b14c1ab4a5e1ee3c241902","58fc9094275e4c49be3f4ba6d4acc0a4",22857747,1,-1,0,1383,407,406,-1
"58fc9094275e4c49be3f4ba6d4acc0a4","58fc9094275e4c49be3f4ba6d4acc0a4",22857747,2,0,1,1384,406,406,0
"58fc9094275e4c49be3f4ba6d4acc0a4","02b3a1bead9244c1ba2f857c7da8f82a",22857747,1,3,0,1386,406,408,2
"02b3a1bead9244c1ba2f857c7da8f82a","2b09a08242b54983aec7063990fb3f66",22857747,1,-12,0,1387,408,400,-8
"2b09a08242b54983aec7063990fb3f66","02b3a1bead9244c1ba2f857c7da8f82a",22857747,1,12,0,1388,400,408,8
"02b3a1bead9244c1ba2f857c7da8f82a","6206fc6479014bb193084c32409dc1b9",22857747,2,1,0,1389,408,409,1
"6206fc6479014bb193084c32409dc1b9","6206fc6479014bb193084c32409dc1b9",22857747,7,0,1,1390,409,409,0
"6206fc6479014bb193084c32409dc1b9","02b3a1bead9244c1ba2f857c7da8f82a",22857747,2,-1,0,1395,409,408,-1
"02b3a1bead9244c1ba2f857c7da8f82a","6a5f020451db426dacba9e2ea3fcc62a",22857747,1,3,0,1400,408,410,2
"6a5f020451db426dacba9e2ea3fcc62a","6a5f020451db426dacba9e2ea3fcc62a",22857747,2,0,1,1401,410,410,0
"6a5f020451db426dacba9e2ea3fcc62a","33a9d248b2e44588a5b07fc1342b9bc2",22857747,1,2,0,1403,410,411,1
"33a9d248b2e44588a5b07fc1342b9bc2","33a9d248b2e44588a5b07fc1342b9bc2",22857747,1,0,1,1404,411,411,0
"33a9d248b2e44588a5b07fc1342b9bc2","687055dad9fc40c3982478fe33ec01bf",22857747,1,4,0,1405,411,414,3
"687055dad9fc40c3982478fe33ec01bf","33a9d248b2e44588a5b07fc1342b9bc2",22857747,1,-4,0,1406,414,411,-3
"33a9d248b2e44588a5b07fc1342b9bc2","2add1669f08d4101913db15f8c23b3b7",22857747,1,7,0,1407,411,416,5
"2add1669f08d4101913db15f8c23b3b7","33a9d248b2e44588a5b07fc1342b9bc2",22857747,1,-7,0,1408,416,411,-5
"33a9d248b2e44588a5b07fc1342b9bc2","c6f26bd420634f1cb7989e76fe6b16c0",22857747,1,1,0,1409,411,412,1
"c6f26bd420634f1cb7989e76fe6b16c0","c6f26bd420634f1cb7989e76fe6b16c0",22857747,5,0,1,1410,412,412,0
"c6f26bd420634f1cb7989e76fe6b16c0","2a65ee6e2ac64f6a8a55fbe5373ec763",22857747,1,1,0,1415,412,413,1
"2a65ee6e2ac64f6a8a55fbe5373ec763","2a65ee6e2ac64f6a8a55fbe5373ec763",22857747,2,0,1,1416,413,413,0
"2a65ee6e2ac64f6a8a55fbe5373ec763","33a9d248b2e44588a5b07fc1342b9bc2",22857747,1,-2,0,1418,413,411,-2
"33a9d248b2e44588a5b07fc1342b9bc2","1fd0f6dadbc14ebc965faf6122190b96",22857747,1,5,0,1419,411,415,4
"1fd0f6dadbc14ebc965faf6122190b96","1fd0f6dadbc14ebc965faf6122190b96",22857747,1,0,1,1420,415,415,0
"1fd0f6dadbc14ebc965faf6122190b96","687055dad9fc40c3982478fe33ec01bf",22857747,1,-1,0,1421,415,414,-1
"687055dad9fc40c3982478fe33ec01bf","2add1669f08d4101913db15f8c23b3b7",22857747,1,3,0,1422,414,416,2
"2add1669f08d4101913db15f8c23b3b7","2add1669f08d4101913db15f8c23b3b7",22857747,1,0,1,1423,416,416,0
"2add1669f08d4101913db15f8c23b3b7","2b09a08242b54983aec7063990fb3f66",22857747,1,-24,0,1424,416,400,-16
"2b09a08242b54983aec7063990fb3f66","a2b4bd40cee2481ebd3fc179d6a5cd62",22857747,1,27,0,1425,400,417,17
"a2b4bd40cee2481ebd3fc179d6a5cd62","a2b4bd40cee2481ebd3fc179d6a5cd62",22857747,2,0,1,1426,417,417,0
"a2b4bd40cee2481ebd3fc179d6a5cd62","e34e59dce2204f228f3a84b6725df60f",22857747,1,2,0,1428,417,419,2
"e34e59dce2204f228f3a84b6725df60f","e34e59dce2204f228f3a84b6725df60f",22857747,1,0,1,1429,419,419,0
"e34e59dce2204f228f3a84b6725df60f","bec48fc2e1294c7eb3d0aca780d731b8",22857747,1,2,0,1430,419,420,1
"bec48fc2e1294c7eb3d0aca780d731b8","a2b4bd40cee2481ebd3fc179d6a5cd62",22857747,1,-4,0,1431,420,417,-3
"a2b4bd40cee2481ebd3fc179d6a5cd62","bec48fc2e1294c7eb3d0aca780d731b8",22857747,1,4,0,1432,417,420,3
"bec48fc2e1294c7eb3d0aca780d731b8","bec48fc2e1294c7eb3d0aca780d731b8",22857747,2,0,1,1433,420,420,0
"bec48fc2e1294c7eb3d0aca780d731b8","dbde19fcce2a4c1abdc7f685c293a23f",22857747,1,3,0,1435,420,422,2
"dbde19fcce2a4c1abdc7f685c293a23f","a24600b0e49245f6bdba8c893cfeddb0",22857747,1,4,0,1436,422,425,3
"a24600b0e49245f6bdba8c893cfeddb0","a24600b0e49245f6bdba8c893cfeddb0",22857747,2,0,1,1437,425,425,0
"a24600b0e49245f6bdba8c893cfeddb0","a2b4bd40cee2481ebd3fc179d6a5cd62",22857747,1,-11,0,1439,425,417,-8
"a2b4bd40cee2481ebd3fc179d6a5cd62","24cf8786024543f19b89bc20034e60d7",22857747,1,18,0,1440,417,428,11
"24cf8786024543f19b89bc20034e60d7","f2a73be2f46840b182d7bd095378004e",22857747,2,1,0,1441,428,429,1
"f2a73be2f46840b182d7bd095378004e","f2a73be2f46840b182d7bd095378004e",22857747,2,0,1,1442,429,429,0
"f2a73be2f46840b182d7bd095378004e","24cf8786024543f19b89bc20034e60d7",22857747,1,-1,0,1443,429,428,-1
"f2a73be2f46840b182d7bd095378004e","604551fd4266430cb860fef58fa7dd61",22857747,1,1,0,1446,429,430,1
"604551fd4266430cb860fef58fa7dd61","604551fd4266430cb860fef58fa7dd61",22857747,8,0,1,1447,430,430,0
"604551fd4266430cb860fef58fa7dd61","24cf8786024543f19b89bc20034e60d7",22857747,1,-2,0,1455,430,428,-2
"24cf8786024543f19b89bc20034e60d7","dce46f8904594a62a6377a3587aaa663",22857747,1,4,0,1456,428,431,3
"dce46f8904594a62a6377a3587aaa663","dce46f8904594a62a6377a3587aaa663",22857747,3,0,1,1457,431,431,0
"dce46f8904594a62a6377a3587aaa663","9b9d0a249052413c869753b99682b0ac",22857747,1,1,0,1460,431,432,1
"9b9d0a249052413c869753b99682b0ac","9b9d0a249052413c869753b99682b0ac",22857747,3,0,1,1461,432,432,0
"9b9d0a249052413c869753b99682b0ac","061c175cc90f45fbad883025394e78dd",22857747,1,1,0,1464,432,433,1
"061c175cc90f45fbad883025394e78dd","061c175cc90f45fbad883025394e78dd",22857747,5,0,1,1465,433,433,0
"061c175cc90f45fbad883025394e78dd","dce46f8904594a62a6377a3587aaa663",22857747,1,-2,0,1470,433,431,-2
"dce46f8904594a62a6377a3587aaa663","24cf8786024543f19b89bc20034e60d7",22857747,1,-4,0,1471,431,428,-3
"24cf8786024543f19b89bc20034e60d7","74a7f8712e5449c2bc0b43c6f90dafed",22857747,1,9,0,1472,428,435,7
"74a7f8712e5449c2bc0b43c6f90dafed","74a7f8712e5449c2bc0b43c6f90dafed",22857747,1,0,1,1473,435,435,0
"74a7f8712e5449c2bc0b43c6f90dafed","66ada10dde9f43018588f1ced9d477fc",22857747,1,-1,0,1474,435,434,-1
"66ada10dde9f43018588f1ced9d477fc","bf12c96466d840a69bed7020b3f18bb8",22857747,1,3,0,1475,434,436,2
"bf12c96466d840a69bed7020b3f18bb8","bf12c96466d840a69bed7020b3f18bb8",22857747,1,0,1,1476,436,436,0
"bf12c96466d840a69bed7020b3f18bb8","24cf8786024543f19b89bc20034e60d7",22857747,1,-11,0,1477,436,428,-8
"24cf8786024543f19b89bc20034e60d7","070600601c4c439288445d2f0724807d",22857747,1,14,0,1478,428,437,9
"070600601c4c439288445d2f0724807d","1823b6de7d334a7aaabc4570719af4d9",22857747,1,2,0,1479,437,439,2
"1823b6de7d334a7aaabc4570719af4d9","1823b6de7d334a7aaabc4570719af4d9",22857747,11,0,1,1480,439,439,0
"1823b6de7d334a7aaabc4570719af4d9","0380cd76a7d44bc3a4da1f15e4d68f89",22857747,1,2,0,1491,439,440,1
"0380cd76a7d44bc3a4da1f15e4d68f89","070600601c4c439288445d2f0724807d",22857747,1,-4,0,1492,440,437,-3
"070600601c4c439288445d2f0724807d","0380cd76a7d44bc3a4da1f15e4d68f89",22857747,1,4,0,1493,437,440,3
"0380cd76a7d44bc3a4da1f15e4d68f89","0380cd76a7d44bc3a4da1f15e4d68f89",22857747,1,0,1,1494,440,440,0
"0380cd76a7d44bc3a4da1f15e4d68f89","23b7673c8b5443108c2ef09382834a86",22857747,1,2,0,1495,440,441,1
"23b7673c8b5443108c2ef09382834a86","23b7673c8b5443108c2ef09382834a86",22857747,2,0,1,1496,441,441,0
"23b7673c8b5443108c2ef09382834a86","901e92500aea43c79f19f1b279050668",22857747,1,2,0,1498,441,442,1
"901e92500aea43c79f19f1b279050668","901e92500aea43c79f19f1b279050668",22857747,1,0,1,1499,442,442,0
"901e92500aea43c79f19f1b279050668","001339db8ced4cf78829ebe8b145449d",22857747,1,1,0,1500,442,443,1
"001339db8ced4cf78829ebe8b145449d","001339db8ced4cf78829ebe8b145449d",22857747,5,0,1,1501,443,443,0
"001339db8ced4cf78829ebe8b145449d","452745e0366e42ae81561bfddebcc6c3",22857747,1,1,0,1506,443,444,1
"452745e0366e42ae81561bfddebcc6c3","452745e0366e42ae81561bfddebcc6c3",22857747,2,0,1,1507,444,444,0
"452745e0366e42ae81561bfddebcc6c3","901e92500aea43c79f19f1b279050668",22857747,1,-2,0,1509,444,442,-2
"901e92500aea43c79f19f1b279050668","4660ff2089114e8db82ceb26a4f329e3",22857747,1,4,0,1510,442,445,3
"4660ff2089114e8db82ceb26a4f329e3","4660ff2089114e8db82ceb26a4f329e3",22857747,2,0,1,1511,445,445,0
"4660ff2089114e8db82ceb26a4f329e3","7bd5586eb9d8484eb74a433ee7bfe499",22857747,1,2,0,1513,445,446,1
"7bd5586eb9d8484eb74a433ee7bfe499","7bd5586eb9d8484eb74a433ee7bfe499",22857747,10,0,1,1514,446,446,0
"7bd5586eb9d8484eb74a433ee7bfe499","8a7f26e690f34dda97be16904518ca99",22857747,2,2,0,1524,446,447,1
"8a7f26e690f34dda97be16904518ca99","8a7f26e690f34dda97be16904518ca99",22857747,1,0,1,1525,447,447,0
"8a7f26e690f34dda97be16904518ca99","b2f0d654738f48158edff28e8d3a546e",22857747,1,5,0,1526,447,449,2
"b2f0d654738f48158edff28e8d3a546e","070600601c4c439288445d2f0724807d",22857747,1,-21,0,1527,449,437,-12
"070600601c4c439288445d2f0724807d","070600601c4c439288445d2f0724807d",22857747,1,0,1,1528,437,437,0
"070600601c4c439288445d2f0724807d","7bd5586eb9d8484eb74a433ee7bfe499",22857747,1,14,0,1529,437,446,9
"8a7f26e690f34dda97be16904518ca99","7bd5586eb9d8484eb74a433ee7bfe499",22857747,1,-2,0,1531,447,446,-1
"7bd5586eb9d8484eb74a433ee7bfe499","070600601c4c439288445d2f0724807d",22857747,1,-14,0,1532,446,437,-9
"070600601c4c439288445d2f0724807d","b2f0d654738f48158edff28e8d3a546e",22857747,1,21,0,1533,437,449,12
"f60ee41ec635499abd48168342d32c2f","b2f0d654738f48158edff28e8d3a546e",22857747,1,-5,0,1541,453,449,-4
"f60ee41ec635499abd48168342d32c2f","f67fbf45a5f146ed866965bc57c7c001",22857747,1,3,0,1556,453,454,1
"f67fbf45a5f146ed866965bc57c7c001","b2f0d654738f48158edff28e8d3a546e",22857747,1,-8,0,1557,454,449,-5
"b2f0d654738f48158edff28e8d3a546e","f67fbf45a5f146ed866965bc57c7c001",22857747,1,8,0,1558,449,454,5
"f67fbf45a5f146ed866965bc57c7c001","f67fbf45a5f146ed866965bc57c7c001",22857747,1,0,1,1559,454,454,0
"f67fbf45a5f146ed866965bc57c7c001","d937afe49bd24a07a550dda1c1155122",22857747,1,1,0,1560,454,455,1
"d937afe49bd24a07a550dda1c1155122","d937afe49bd24a07a550dda1c1155122",22857747,3,0,1,1561,455,455,0
"d937afe49bd24a07a550dda1c1155122","3628b3f7823443d0912a339096b69943",22857747,1,1,0,1564,455,456,1
"3628b3f7823443d0912a339096b69943","3628b3f7823443d0912a339096b69943",22857747,1,0,1,1565,456,456,0
"3628b3f7823443d0912a339096b69943","9e049ee647cf43ecbcb5ed792a8e7588",22857747,1,1,0,1566,456,457,1
"9e049ee647cf43ecbcb5ed792a8e7588","9e049ee647cf43ecbcb5ed792a8e7588",22857747,1,0,1,1567,457,457,0
"9e049ee647cf43ecbcb5ed792a8e7588","5256a214faaf410b93f76cea06428334",22857747,1,1,0,1568,457,458,1
"5256a214faaf410b93f76cea06428334","5256a214faaf410b93f76cea06428334",22857747,1,0,1,1569,458,458,0
"5256a214faaf410b93f76cea06428334","25c32b120fce40fa9b6c85133aeb4716",22857747,1,1,0,1570,458,459,1
"25c32b120fce40fa9b6c85133aeb4716","25c32b120fce40fa9b6c85133aeb4716",22857747,1,0,1,1571,459,459,0
"25c32b120fce40fa9b6c85133aeb4716","11bc14f2204949008b7d511b933363c1",22857747,1,1,0,1572,459,460,1
"11bc14f2204949008b7d511b933363c1","11bc14f2204949008b7d511b933363c1",22857747,3,0,1,1573,460,460,0
"11bc14f2204949008b7d511b933363c1","42de338840a34d15adb66e7b14fb9d2c",22857747,1,1,0,1576,460,461,1
"42de338840a34d15adb66e7b14fb9d2c","42de338840a34d15adb66e7b14fb9d2c",22857747,1,0,1,1577,461,461,0
"42de338840a34d15adb66e7b14fb9d2c","9da37c6210b1416b8079c274f70bf600",22857747,1,1,0,1578,461,462,1
"9da37c6210b1416b8079c274f70bf600","9da37c6210b1416b8079c274f70bf600",22857747,3,0,1,1579,462,462,0
"9da37c6210b1416b8079c274f70bf600","519119f1deac45ff9ab4f13529be5c6e",22857747,1,1,0,1582,462,463,1
"519119f1deac45ff9ab4f13529be5c6e","519119f1deac45ff9ab4f13529be5c6e",22857747,1,0,1,1583,463,463,0
"519119f1deac45ff9ab4f13529be5c6e","f67fbf45a5f146ed866965bc57c7c001",22857747,1,-9,0,1584,463,454,-9
"f67fbf45a5f146ed866965bc57c7c001","c5df9f40ec14463b9dcfdc73df3e9285",22857747,1,12,0,1585,454,464,10
"c5df9f40ec14463b9dcfdc73df3e9285","c5df9f40ec14463b9dcfdc73df3e9285",22857747,1,0,1,1586,464,464,0
"c5df9f40ec14463b9dcfdc73df3e9285","0d987bed3ffa4ed0b9a2e62e97b7b30f",22857747,1,-276,0,1587,464,272,-192
"0d987bed3ffa4ed0b9a2e62e97b7b30f","94cecc3f1e7d484b8e068e79241dfd73",22857747,2,13,0,1648,272,281,9
"94cecc3f1e7d484b8e068e79241dfd73","a37477c4e4c14169ad44b06b493007f6",22857747,3,2,0,1649,281,283,2
"a37477c4e4c14169ad44b06b493007f6","b71bac264efb4abd97015447bd490db6",22857747,1,117,0,1650,283,370,87
"8d448d625b024c82a5eb240bbd7431d6","0d987bed3ffa4ed0b9a2e62e97b7b30f",22857747,1,-137,0,1702,374,272,-102
"bb5a47f5ea01454a8b79455422d3b9da","0d987bed3ffa4ed0b9a2e62e97b7b30f",22857747,1,-10,0,1713,280,272,-8
"a37477c4e4c14169ad44b06b493007f6","a9ac840f098c4bd0a2ee896214ce29cd",22857747,1,-154,0,1716,283,168,-115
"a9ac840f098c4bd0a2ee896214ce29cd","a9ac840f098c4bd0a2ee896214ce29cd",22857747,1,0,1,1717,168,168,0
"a9ac840f098c4bd0a2ee896214ce29cd","0c7262dff33c4087bc660ccf40f92f9c",22857747,1,4,0,1718,168,169,1
"0c7262dff33c4087bc660ccf40f92f9c","b2275c3fad834f8d90737a2d9a6927d6",22857747,2,3,0,1719,169,172,3
"0c7262dff33c4087bc660ccf40f92f9c","d6d02b6ef04e4f17805504500b8ce441",22857747,1,275,0,1721,169,375,206
"d6d02b6ef04e4f17805504500b8ce441","d646286c8051419bbc2e31dd1db55ca8",22857747,1,-407,0,1723,375,67,-308
"d646286c8051419bbc2e31dd1db55ca8","6a9f0ef185fb47f0937e29daa1c71ed5",22857747,1,27,0,1724,67,90,23
"67a089198fcb4e1c8f2385786c2b296f","67a089198fcb4e1c8f2385786c2b296f",22859334,2,0,1,1,39,39,0
"67a089198fcb4e1c8f2385786c2b296f","e2911e79efc2420eac45d9f671463d4b",22859334,1,-69,0,2,39,2,-37
"b613861cecf84ffcab01afb23f660475","e2911e79efc2420eac45d9f671463d4b",22859334,2,3,0,10,1,2,1
"e2911e79efc2420eac45d9f671463d4b","b613861cecf84ffcab01afb23f660475",22859334,2,-3,0,11,2,1,-1
"b613861cecf84ffcab01afb23f660475","b613861cecf84ffcab01afb23f660475",22859334,7,0,1,12,1,1,0
"e2911e79efc2420eac45d9f671463d4b","e2911e79efc2420eac45d9f671463d4b",22859334,4,0,1,15,2,2,0
"e2911e79efc2420eac45d9f671463d4b","519d1b8c59404d67b54e96c5c8a830b2",22859334,1,1,0,18,2,3,1
"519d1b8c59404d67b54e96c5c8a830b2","519d1b8c59404d67b54e96c5c8a830b2",22859334,1,0,1,19,3,3,0
"519d1b8c59404d67b54e96c5c8a830b2","531db53f81f646edb0cdcfe0085b03b7",22859334,2,1,0,20,3,4,1
"531db53f81f646edb0cdcfe0085b03b7","531db53f81f646edb0cdcfe0085b03b7",22859334,1,0,1,21,4,4,0
"531db53f81f646edb0cdcfe0085b03b7","4f5f94b2f95141e0a9d53a61da2276da",22859334,1,1,0,22,4,5,1
"4f5f94b2f95141e0a9d53a61da2276da","4f5f94b2f95141e0a9d53a61da2276da",22859334,1,0,1,23,5,5,0
"4f5f94b2f95141e0a9d53a61da2276da","519d1b8c59404d67b54e96c5c8a830b2",22859334,1,-2,0,24,5,3,-2
"531db53f81f646edb0cdcfe0085b03b7","6d541c89590949f99af293c4f2333f67",22859334,1,2,0,26,4,6,2
"6d541c89590949f99af293c4f2333f67","6d541c89590949f99af293c4f2333f67",22859334,1,0,1,27,6,6,0
"6d541c89590949f99af293c4f2333f67","dd5cf0b9fe4c4f1d8f5ff8e4c04879cb",22859334,1,1,0,28,6,7,1
"dd5cf0b9fe4c4f1d8f5ff8e4c04879cb","dd5cf0b9fe4c4f1d8f5ff8e4c04879cb",22859334,1,0,1,29,7,7,0
"dd5cf0b9fe4c4f1d8f5ff8e4c04879cb","f96261861edc426abe2248be4f0a709a",22859334,1,1,0,30,7,8,1
"f96261861edc426abe2248be4f0a709a","f96261861edc426abe2248be4f0a709a",22859334,2,0,1,31,8,8,0
"f96261861edc426abe2248be4f0a709a","66b5e16f4f75454fb5b8172079f0fa83",22859334,1,1,0,33,8,9,1
"66b5e16f4f75454fb5b8172079f0fa83","66b5e16f4f75454fb5b8172079f0fa83",22859334,1,0,1,34,9,9,0
"66b5e16f4f75454fb5b8172079f0fa83","0680571d4698477995e41842c36a54b2",22859334,1,1,0,35,9,10,1
"0680571d4698477995e41842c36a54b2","0680571d4698477995e41842c36a54b2",22859334,3,0,1,36,10,10,0
"0680571d4698477995e41842c36a54b2","9112f2bffece48e08c6d2287be204085",22859334,1,1,0,38,10,11,1
"9112f2bffece48e08c6d2287be204085","9112f2bffece48e08c6d2287be204085",22859334,4,0,1,39,11,11,0
"9112f2bffece48e08c6d2287be204085","0680571d4698477995e41842c36a54b2",22859334,1,-1,0,43,11,10,-1
"0680571d4698477995e41842c36a54b2","56586aa865414f538729c7f7735d2bc6",22859334,1,4,0,45,10,12,2
"56586aa865414f538729c7f7735d2bc6","e2911e79efc2420eac45d9f671463d4b",22859334,1,-12,0,46,12,2,-10
"e2911e79efc2420eac45d9f671463d4b","56586aa865414f538729c7f7735d2bc6",22859334,1,12,0,47,2,12,10
"56586aa865414f538729c7f7735d2bc6","56586aa865414f538729c7f7735d2bc6",22859334,5,0,1,48,12,12,0
"56586aa865414f538729c7f7735d2bc6","b7f2b31585d94eb3bf86376714aa7070",22859334,2,2,0,53,12,13,1
"b7f2b31585d94eb3bf86376714aa7070","56586aa865414f538729c7f7735d2bc6",22859334,1,-2,0,54,13,12,-1
"b7f2b31585d94eb3bf86376714aa7070","b7f2b31585d94eb3bf86376714aa7070",22859334,1,0,1,56,13,13,0
"b7f2b31585d94eb3bf86376714aa7070","3f1c815879794b929260d224becaff7e",22859334,1,2,0,57,13,14,1
"3f1c815879794b929260d224becaff7e","81c864a886d54a6b8ff85f7d736f4f95",22859334,1,2,0,58,14,15,1
"81c864a886d54a6b8ff85f7d736f4f95","5c5ceeee4562457ba6d41515aeebfbb1",22859334,1,4,0,59,15,17,2
"5c5ceeee4562457ba6d41515aeebfbb1","5c5ceeee4562457ba6d41515aeebfbb1",22859334,1,0,1,60,17,17,0
"5c5ceeee4562457ba6d41515aeebfbb1","56586aa865414f538729c7f7735d2bc6",22859334,1,-10,0,61,17,12,-5
"56586aa865414f538729c7f7735d2bc6","9afd71a5298d4333b6849dfce1b9422c",22859334,1,13,0,62,12,18,6
"9afd71a5298d4333b6849dfce1b9422c","9afd71a5298d4333b6849dfce1b9422c",22859334,1,0,1,63,18,18,0
"9afd71a5298d4333b6849dfce1b9422c","b7719e26494940efa49512aedd0aac79",22859334,1,4,0,64,18,20,2
"b7719e26494940efa49512aedd0aac79","9afd71a5298d4333b6849dfce1b9422c",22859334,1,-4,0,65,20,18,-2
"9afd71a5298d4333b6849dfce1b9422c","d4f45188d3c84a02ba08454e6403a818",22859334,1,9,0,66,18,24,6
"d4c3b003e8274e429d2fa688d73fde6d","d4c3b003e8274e429d2fa688d73fde6d",22859334,4,0,1,68,22,22,0
"b7719e26494940efa49512aedd0aac79","b7719e26494940efa49512aedd0aac79",22859334,5,0,1,73,20,20,0
"4e51676dc72045d99c19b9fa7b22f8bc","afbf7250b99d47bea07172749483ca97",22859334,2,-3,0,76,29,28,-1
"c33c17be71ae4d588da7369472e5bb1b","4e51676dc72045d99c19b9fa7b22f8bc",22859334,1,-9,0,80,34,29,-5
"4e51676dc72045d99c19b9fa7b22f8bc","93679be414554a11b1893002f2229a93",22859334,1,12,0,81,29,35,6
"fc0e049d56024bc9a02c9a9c435c3df7","fc0e049d56024bc9a02c9a9c435c3df7",22859334,1,0,1,89,38,38,0
"b534b89233134e30a9b5645138bfa9ee","b7719e26494940efa49512aedd0aac79",22859334,1,-44,0,96,41,20,-21
"afbf7250b99d47bea07172749483ca97","afbf7250b99d47bea07172749483ca97",22859334,1,0,1,99,28,28,0
"afbf7250b99d47bea07172749483ca97","4e51676dc72045d99c19b9fa7b22f8bc",22859334,6,3,0,100,28,29,1
"4e51676dc72045d99c19b9fa7b22f8bc","4e51676dc72045d99c19b9fa7b22f8bc",22859334,3,0,1,101,29,29,0
"4e51676dc72045d99c19b9fa7b22f8bc","c33c17be71ae4d588da7369472e5bb1b",22859334,3,9,0,103,29,34,5
"c33c17be71ae4d588da7369472e5bb1b","51970cfa30e643e894e66ae85c8024cc",22859334,1,-6,0,104,34,31,-3
"51970cfa30e643e894e66ae85c8024cc","c33c17be71ae4d588da7369472e5bb1b",22859334,2,6,0,105,31,34,3
"c33c17be71ae4d588da7369472e5bb1b","93679be414554a11b1893002f2229a93",22859334,5,3,0,106,34,35,1
"93679be414554a11b1893002f2229a93","b7719e26494940efa49512aedd0aac79",22859334,1,-27,0,107,35,20,-15
"b7719e26494940efa49512aedd0aac79","93679be414554a11b1893002f2229a93",22859334,1,27,0,108,20,35,15
"93679be414554a11b1893002f2229a93","7040a13096d746ac84b8fac8d9752058",22859334,5,3,0,109,35,36,1
"7040a13096d746ac84b8fac8d9752058","93679be414554a11b1893002f2229a93",22859334,2,-3,0,110,36,35,-1
"93679be414554a11b1893002f2229a93","9a0dc646f934470daf08c4b56ccf73db",22859334,2,6,0,111,35,37,2
"9a0dc646f934470daf08c4b56ccf73db","7040a13096d746ac84b8fac8d9752058",22859334,3,-3,0,112,37,36,-1
"7040a13096d746ac84b8fac8d9752058","9a0dc646f934470daf08c4b56ccf73db",22859334,4,3,0,113,36,37,1
"9a0dc646f934470daf08c4b56ccf73db","fc0e049d56024bc9a02c9a9c435c3df7",22859334,3,3,0,114,37,38,1
"fc0e049d56024bc9a02c9a9c435c3df7","67a089198fcb4e1c8f2385786c2b296f",22859334,3,4,0,115,38,39,1
"67a089198fcb4e1c8f2385786c2b296f","fc0e049d56024bc9a02c9a9c435c3df7",22859334,3,-4,0,116,39,38,-1
"fc0e049d56024bc9a02c9a9c435c3df7","64d48c6c9c7940639a932219a6c87198",22859334,3,5,0,117,38,40,2
"64d48c6c9c7940639a932219a6c87198","93679be414554a11b1893002f2229a93",22859334,1,-14,0,118,40,35,-5
"7040a13096d746ac84b8fac8d9752058","67a089198fcb4e1c8f2385786c2b296f",22859334,1,10,0,123,36,39,3
"67a089198fcb4e1c8f2385786c2b296f","64d48c6c9c7940639a932219a6c87198",22859334,2,1,0,124,39,40,1
"64d48c6c9c7940639a932219a6c87198","64d48c6c9c7940639a932219a6c87198",22859334,2,0,1,125,40,40,0
"64d48c6c9c7940639a932219a6c87198","b534b89233134e30a9b5645138bfa9ee",22859334,3,3,0,126,40,41,1
"b534b89233134e30a9b5645138bfa9ee","67a089198fcb4e1c8f2385786c2b296f",22859334,3,-4,0,127,41,39,-2
"67a089198fcb4e1c8f2385786c2b296f","0e37b720d23b4e7f8b313e79313fd107",22859334,1,7,0,128,39,44,5
"0e37b720d23b4e7f8b313e79313fd107","0e37b720d23b4e7f8b313e79313fd107",22859334,1,0,1,129,44,44,0
"0e37b720d23b4e7f8b313e79313fd107","6875d67fdd5f48168b62719df449bebd",22859334,1,1,0,130,44,45,1
"6875d67fdd5f48168b62719df449bebd","6875d67fdd5f48168b62719df449bebd",22859334,1,0,1,131,45,45,0
"6875d67fdd5f48168b62719df449bebd","6e13d61a7bdb44bca949c9f86fab3be5",22859334,1,3,0,132,45,47,2
"6e13d61a7bdb44bca949c9f86fab3be5","b534b89233134e30a9b5645138bfa9ee",22859334,1,-7,0,133,47,41,-6
"b534b89233134e30a9b5645138bfa9ee","6e13d61a7bdb44bca949c9f86fab3be5",22859334,2,7,0,134,41,47,6
"6e13d61a7bdb44bca949c9f86fab3be5","195f78799f984cc2b06c48dfe36be751",22859334,1,2,0,135,47,49,2
"195f78799f984cc2b06c48dfe36be751","195f78799f984cc2b06c48dfe36be751",22859334,2,0,1,136,49,49,0
"195f78799f984cc2b06c48dfe36be751","d0c74f735e024943943e40333d6d337f",22859334,1,3,0,138,49,51,2
"d0c74f735e024943943e40333d6d337f","d9c8d8c444a64dadbbb508652c721e17",22859334,1,-6,0,139,51,46,-5
"d9c8d8c444a64dadbbb508652c721e17","d0c74f735e024943943e40333d6d337f",22859334,2,6,0,140,46,51,5
"d0c74f735e024943943e40333d6d337f","983f8ff320594b279a7f4a6fe132f9c5",22859334,1,2,0,141,51,53,2
"983f8ff320594b279a7f4a6fe132f9c5","983f8ff320594b279a7f4a6fe132f9c5",22859334,2,0,1,142,53,53,0
"983f8ff320594b279a7f4a6fe132f9c5","35adfa5d923046aebabfefd98f35ff05",22859334,1,1,0,144,53,54,1
"35adfa5d923046aebabfefd98f35ff05","35adfa5d923046aebabfefd98f35ff05",22859334,8,0,1,145,54,54,0
"35adfa5d923046aebabfefd98f35ff05","b6f8a98476224da1b40e555ececc7ed8",22859334,1,1,0,153,54,55,1
"b6f8a98476224da1b40e555ececc7ed8","b6f8a98476224da1b40e555ececc7ed8",22859334,2,0,1,154,55,55,0
"b6f8a98476224da1b40e555ececc7ed8","86e22cb5fe0e4b47a9489ecddf7ed78f",22859334,1,1,0,156,55,56,1
"86e22cb5fe0e4b47a9489ecddf7ed78f","86e22cb5fe0e4b47a9489ecddf7ed78f",22859334,2,0,1,157,56,56,0
"86e22cb5fe0e4b47a9489ecddf7ed78f","f924752d8a1149668870b1e7698486f7",22859334,1,-6,0,159,56,50,-6
"f924752d8a1149668870b1e7698486f7","78f30e4dcac84e3cbea8b2cc6e0d62b3",22859334,1,10,0,160,50,59,9
"78f30e4dcac84e3cbea8b2cc6e0d62b3","a1f2f12debe5432fb7a70bcd12bacfb9",22859334,2,-1,0,161,59,58,-1
"a1f2f12debe5432fb7a70bcd12bacfb9","b534b89233134e30a9b5645138bfa9ee",22859334,1,-20,0,162,58,41,-17
"b534b89233134e30a9b5645138bfa9ee","78f30e4dcac84e3cbea8b2cc6e0d62b3",22859334,1,21,0,163,41,59,18
"a1f2f12debe5432fb7a70bcd12bacfb9","a1f2f12debe5432fb7a70bcd12bacfb9",22859334,14,0,1,165,58,58,0
"a1f2f12debe5432fb7a70bcd12bacfb9","78f30e4dcac84e3cbea8b2cc6e0d62b3",22859334,1,1,0,179,58,59,1
"78f30e4dcac84e3cbea8b2cc6e0d62b3","78f30e4dcac84e3cbea8b2cc6e0d62b3",22859334,7,0,1,180,59,59,0
"78f30e4dcac84e3cbea8b2cc6e0d62b3","12aa6e1672ac4e7aa6449a7a8609cd72",22859334,1,-2,0,187,59,57,-2
"12aa6e1672ac4e7aa6449a7a8609cd72","bc42d26810654ea9a1df1efe1e58c7d5",22859334,1,7,0,188,57,63,6
"bc42d26810654ea9a1df1efe1e58c7d5","a0a418b8540d479fa6e0f653b701da8b",22859334,2,1,0,189,63,64,1
"a0a418b8540d479fa6e0f653b701da8b","4c943503763e4e349906eea3ed3c8e86",22859334,1,-3,0,190,64,61,-3
"4c943503763e4e349906eea3ed3c8e86","4c943503763e4e349906eea3ed3c8e86",22859334,1,0,1,191,61,61,0
"4c943503763e4e349906eea3ed3c8e86","bc42d26810654ea9a1df1efe1e58c7d5",22859334,1,2,0,192,61,63,2
"bc42d26810654ea9a1df1efe1e58c7d5","bc42d26810654ea9a1df1efe1e58c7d5",22859334,3,0,1,193,63,63,0
"a0a418b8540d479fa6e0f653b701da8b","a0a418b8540d479fa6e0f653b701da8b",22859334,3,0,1,197,64,64,0
"a0a418b8540d479fa6e0f653b701da8b","309ccf3cc4fe429d9bfbaef53d3fa479",22859334,1,-4,0,200,64,60,-4
"309ccf3cc4fe429d9bfbaef53d3fa479","b534b89233134e30a9b5645138bfa9ee",22859334,1,-23,0,201,60,41,-19
"b534b89233134e30a9b5645138bfa9ee","d646286c8051419bbc2e31dd1db55ca8",22859334,2,33,0,202,41,67,26
"d646286c8051419bbc2e31dd1db55ca8","d646286c8051419bbc2e31dd1db55ca8",22859334,2,0,1,203,67,67,0
"d646286c8051419bbc2e31dd1db55ca8","267f883678b24aed855fde42524975d9",22859334,1,4,0,205,67,71,4
"267f883678b24aed855fde42524975d9","267f883678b24aed855fde42524975d9",22859334,1,0,1,206,71,71,0
"267f883678b24aed855fde42524975d9","88fff56d0342490dbef9040750a20f6c",22859334,1,1,0,207,71,72,1
"88fff56d0342490dbef9040750a20f6c","88fff56d0342490dbef9040750a20f6c",22859334,1,0,1,208,72,72,0
"88fff56d0342490dbef9040750a20f6c","adb17b12b66c4a49a85fd34322f7df70",22859334,1,1,0,209,72,73,1
"adb17b12b66c4a49a85fd34322f7df70","adb17b12b66c4a49a85fd34322f7df70",22859334,1,0,1,210,73,73,0
"adb17b12b66c4a49a85fd34322f7df70","a2becd407db34b189200a32546d9d569",22859334,1,3,0,211,73,75,2
"a2becd407db34b189200a32546d9d569","d646286c8051419bbc2e31dd1db55ca8",22859334,1,-9,0,212,75,67,-8
"d646286c8051419bbc2e31dd1db55ca8","a2becd407db34b189200a32546d9d569",22859334,2,9,0,213,67,75,8
"a2becd407db34b189200a32546d9d569","a2becd407db34b189200a32546d9d569",22859334,1,0,1,214,75,75,0
"a2becd407db34b189200a32546d9d569","58c22b011d0f4c2ea6d13615edbb9eeb",22859334,1,2,0,215,75,77,2
"58c22b011d0f4c2ea6d13615edbb9eeb","58c22b011d0f4c2ea6d13615edbb9eeb",22859334,2,0,1,216,77,77,0
"58c22b011d0f4c2ea6d13615edbb9eeb","dd76e1861dc9461c830888729d091ee0",22859334,1,1,0,218,77,78,1
"dd76e1861dc9461c830888729d091ee0","dd76e1861dc9461c830888729d091ee0",22859334,8,0,1,219,78,78,0
"dd76e1861dc9461c830888729d091ee0","cd1d828f1a694b87913a7ea66c23803e",22859334,1,1,0,227,78,79,1
"cd1d828f1a694b87913a7ea66c23803e","cd1d828f1a694b87913a7ea66c23803e",22859334,2,0,1,228,79,79,0
"cd1d828f1a694b87913a7ea66c23803e","9176a3c2b4d2465fa8b0c67096c2a97e",22859334,1,1,0,230,79,80,1
"9176a3c2b4d2465fa8b0c67096c2a97e","9176a3c2b4d2465fa8b0c67096c2a97e",22859334,5,0,1,231,80,80,0
"9176a3c2b4d2465fa8b0c67096c2a97e","f8ec6445f7194e25b9101d4fbcb07a18",22859334,1,1,0,236,80,81,1
"f8ec6445f7194e25b9101d4fbcb07a18","f8ec6445f7194e25b9101d4fbcb07a18",22859334,2,0,1,237,81,81,0
"f8ec6445f7194e25b9101d4fbcb07a18","140d5b27b8574befad82c0a013b59dfa",22859334,1,-7,0,239,81,74,-7
"140d5b27b8574befad82c0a013b59dfa","d18a9ea32855445f8736581f5cb119ce",22859334,3,9,0,240,74,82,8
"d18a9ea32855445f8736581f5cb119ce","f564483cbd7a407681aa2fcca518cf5f",22859334,2,4,0,241,82,85,3
"f564483cbd7a407681aa2fcca518cf5f","f564483cbd7a407681aa2fcca518cf5f",22859334,2,0,1,242,85,85,0
"f564483cbd7a407681aa2fcca518cf5f","18fd01350bd5434ca636d59a599d768a",22859334,5,1,0,243,85,86,1
"18fd01350bd5434ca636d59a599d768a","18fd01350bd5434ca636d59a599d768a",22859334,9,0,1,244,86,86,0
"18fd01350bd5434ca636d59a599d768a","6a9f0ef185fb47f0937e29daa1c71ed5",22859334,4,5,0,252,86,90,4
"6a9f0ef185fb47f0937e29daa1c71ed5","ae5ac430ea254e708a6f5deaaf7464ae",22859334,5,-7,0,253,90,84,-6
"ae5ac430ea254e708a6f5deaaf7464ae","c681290961c94c4caf23b529d1ae6b9a",22859334,3,5,0,254,84,88,4
"c681290961c94c4caf23b529d1ae6b9a","c681290961c94c4caf23b529d1ae6b9a",22859334,2,0,1,255,88,88,0
"c681290961c94c4caf23b529d1ae6b9a","6a9f0ef185fb47f0937e29daa1c71ed5",22859334,1,2,0,256,88,90,2
"6a9f0ef185fb47f0937e29daa1c71ed5","6a9f0ef185fb47f0937e29daa1c71ed5",22859334,15,0,1,257,90,90,0
"6a9f0ef185fb47f0937e29daa1c71ed5","d646286c8051419bbc2e31dd1db55ca8",22859334,2,-27,0,260,90,67,-23
"d646286c8051419bbc2e31dd1db55ca8","e20db35ced8544ddac5bc3839145e463",22859334,5,30,0,261,67,91,24
"e20db35ced8544ddac5bc3839145e463","1febb706d7a34005ae8711ed49c76e64",22859334,3,3,0,262,91,94,3
"1febb706d7a34005ae8711ed49c76e64","1febb706d7a34005ae8711ed49c76e64",22859334,2,0,1,263,94,94,0
"1febb706d7a34005ae8711ed49c76e64","8f73ba6f5a0042f2850356ac38ac6f24",22859334,3,1,0,265,94,95,1
"8f73ba6f5a0042f2850356ac38ac6f24","8f73ba6f5a0042f2850356ac38ac6f24",22859334,5,0,1,266,95,95,0
"8f73ba6f5a0042f2850356ac38ac6f24","e2260b86653c46d7b14a41fb419dbf8c",22859334,3,1,0,271,95,96,1
"e2260b86653c46d7b14a41fb419dbf8c","e2260b86653c46d7b14a41fb419dbf8c",22859334,2,0,1,272,96,96,0
"e2260b86653c46d7b14a41fb419dbf8c","35eb641ad1d845bbba54915bce75a962",22859334,3,1,0,274,96,97,1
"35eb641ad1d845bbba54915bce75a962","35eb641ad1d845bbba54915bce75a962",22859334,5,0,1,275,97,97,0
"35eb641ad1d845bbba54915bce75a962","08be90ffbeea4795a138cd42ed8db56f",22859334,1,1,0,280,97,98,1
"08be90ffbeea4795a138cd42ed8db56f","08be90ffbeea4795a138cd42ed8db56f",22859334,5,0,1,281,98,98,0
"08be90ffbeea4795a138cd42ed8db56f","3007433c8f584dcbb5ac159c1c5f2be3",22859334,1,1,0,286,98,99,1
"3007433c8f584dcbb5ac159c1c5f2be3","3007433c8f584dcbb5ac159c1c5f2be3",22859334,5,0,1,287,99,99,0
"3007433c8f584dcbb5ac159c1c5f2be3","d391c8b6e56a43a7b654e9dee02d904b",22859334,1,5,0,292,99,103,4
"d391c8b6e56a43a7b654e9dee02d904b","00ae5f0c51874a73a41ebea838d95682",22859334,6,-2,0,293,103,101,-2
"00ae5f0c51874a73a41ebea838d95682","e20db35ced8544ddac5bc3839145e463",22859334,4,-11,0,294,101,91,-10
"00ae5f0c51874a73a41ebea838d95682","00ae5f0c51874a73a41ebea838d95682",22859334,1,0,1,296,101,101,0
"d391c8b6e56a43a7b654e9dee02d904b","d391c8b6e56a43a7b654e9dee02d904b",22859334,20,0,1,298,103,103,0
"d391c8b6e56a43a7b654e9dee02d904b","6111116566fc4fd9abba409322bea245",22859334,2,1,0,318,103,104,1
"6111116566fc4fd9abba409322bea245","6111116566fc4fd9abba409322bea245",22859334,8,0,1,319,104,104,0
"6111116566fc4fd9abba409322bea245","a81b2235cb9c499eb9ea8ee0a8dd9725",22859334,2,1,0,324,104,105,1
"a81b2235cb9c499eb9ea8ee0a8dd9725","a81b2235cb9c499eb9ea8ee0a8dd9725",22859334,7,0,1,325,105,105,0
"a81b2235cb9c499eb9ea8ee0a8dd9725","2d4e0ab0ef3b4d73b82c72d4621a7579",22859334,2,1,0,330,105,106,1
"2d4e0ab0ef3b4d73b82c72d4621a7579","2d4e0ab0ef3b4d73b82c72d4621a7579",22859334,11,0,1,331,106,106,0
"2d4e0ab0ef3b4d73b82c72d4621a7579","8bdebf492ebd4e62b0d522e8ab5e5197",22859334,3,1,0,333,106,107,1
"8bdebf492ebd4e62b0d522e8ab5e5197","8bdebf492ebd4e62b0d522e8ab5e5197",22859334,7,0,1,334,107,107,0
"8bdebf492ebd4e62b0d522e8ab5e5197","73039f8c1eb9409cb4caee2cf968001e",22859334,1,-7,0,336,107,100,-7
"4280927ec4d643238aa49c32f9e06c6c","4280927ec4d643238aa49c32f9e06c6c",22859334,1,0,1,338,109,109,0
"4280927ec4d643238aa49c32f9e06c6c","fc44e6a5f7654430af1227838224dceb",22859334,1,2,0,339,109,111,2
"fc44e6a5f7654430af1227838224dceb","fc44e6a5f7654430af1227838224dceb",22859334,2,0,1,340,111,111,0
"fc44e6a5f7654430af1227838224dceb","08111f75e22d409998cf8b85bd431f0a",22859334,1,-3,0,342,111,108,-3
"a9ae0a3c070d455bb4369a8996313336","a9ae0a3c070d455bb4369a8996313336",22859334,1,0,1,344,114,114,0
"a9ae0a3c070d455bb4369a8996313336","e20db35ced8544ddac5bc3839145e463",22859334,1,-26,0,345,114,91,-23
"e20db35ced8544ddac5bc3839145e463","d391c8b6e56a43a7b654e9dee02d904b",22859334,3,13,0,346,91,103,12
"e20db35ced8544ddac5bc3839145e463","4280927ec4d643238aa49c32f9e06c6c",22859334,1,20,0,349,91,109,18
"4280927ec4d643238aa49c32f9e06c6c","73039f8c1eb9409cb4caee2cf968001e",22859334,2,-10,0,350,109,100,-9
"73039f8c1eb9409cb4caee2cf968001e","08111f75e22d409998cf8b85bd431f0a",22859334,2,9,0,351,100,108,8
"a9ae0a3c070d455bb4369a8996313336","71cec822bcff4f30a20e75dc63ef7b65",22859334,1,2,0,353,114,116,2
"71cec822bcff4f30a20e75dc63ef7b65","71cec822bcff4f30a20e75dc63ef7b65",22859334,1,0,1,354,116,116,0
"71cec822bcff4f30a20e75dc63ef7b65","62bff51286ef4f348717a3cf6fe2318f",22859334,1,5,0,355,116,120,4
"37319e88176d4aefa91d7a9980dbae91","b1cd0e7dc3ad4a8eb91a4bfdbeb025b0",22859334,1,7,0,357,112,118,6
"b1cd0e7dc3ad4a8eb91a4bfdbeb025b0","b1cd0e7dc3ad4a8eb91a4bfdbeb025b0",22859334,1,0,1,358,118,118,0
"b1cd0e7dc3ad4a8eb91a4bfdbeb025b0","62bff51286ef4f348717a3cf6fe2318f",22859334,1,2,0,359,118,120,2
"62bff51286ef4f348717a3cf6fe2318f","779f9ddd1fd14d1e9e69f72219a1fdbd",22859334,1,3,0,363,120,121,1
"779f9ddd1fd14d1e9e69f72219a1fdbd","e20db35ced8544ddac5bc3839145e463",22859334,2,-36,0,364,121,91,-30
"e20db35ced8544ddac5bc3839145e463","ae26e6cda8ad4a3f81bd347560d9579f",22859334,1,40,0,365,91,125,34
"ae26e6cda8ad4a3f81bd347560d9579f","ae26e6cda8ad4a3f81bd347560d9579f",22859334,4,0,1,366,125,125,0
"ae26e6cda8ad4a3f81bd347560d9579f","ee48df95832b4374aa273ceb27ec1315",22859334,2,1,0,369,125,126,1
"ee48df95832b4374aa273ceb27ec1315","ee48df95832b4374aa273ceb27ec1315",22859334,5,0,1,370,126,126,0
"ee48df95832b4374aa273ceb27ec1315","7a439da90b394756ad1777fc4c6dead5",22859334,2,1,0,371,126,127,1
"7a439da90b394756ad1777fc4c6dead5","7a439da90b394756ad1777fc4c6dead5",22859334,5,0,1,372,127,127,0
"7a439da90b394756ad1777fc4c6dead5","a8dd5213034441ac92724b4e83eb0bb2",22859334,1,3,0,373,127,129,2
"a8dd5213034441ac92724b4e83eb0bb2","a8dd5213034441ac92724b4e83eb0bb2",22859334,1,0,1,376,129,129,0
"a8dd5213034441ac92724b4e83eb0bb2","8115eab6556b45f5b415c3b8c26a12e5",22859334,4,2,0,377,129,131,2
"8115eab6556b45f5b415c3b8c26a12e5","8115eab6556b45f5b415c3b8c26a12e5",22859334,10,0,1,378,131,131,0
"8115eab6556b45f5b415c3b8c26a12e5","ec34b06efd844b46a4c4818ecdb9b8f4",22859334,4,1,0,380,131,132,1
"ec34b06efd844b46a4c4818ecdb9b8f4","ec34b06efd844b46a4c4818ecdb9b8f4",22859334,6,0,1,381,132,132,0
"ec34b06efd844b46a4c4818ecdb9b8f4","c2e1c2b9eac64109b343a088584b576b",22859334,4,1,0,383,132,133,1
"c2e1c2b9eac64109b343a088584b576b","c2e1c2b9eac64109b343a088584b576b",22859334,6,0,1,384,133,133,0
"c2e1c2b9eac64109b343a088584b576b","579338175e0b4bbb8ef3b712b5d8b54e",22859334,6,-5,0,386,133,128,-5
"579338175e0b4bbb8ef3b712b5d8b54e","8bc5795d6a984a3eace4e2811e52dd4f",22859334,1,8,0,387,128,135,7
"8bc5795d6a984a3eace4e2811e52dd4f","8bc5795d6a984a3eace4e2811e52dd4f",22859334,3,0,1,388,135,135,0
"8bc5795d6a984a3eace4e2811e52dd4f","b416d47c56a742199b5d7c7f19d6503a",22859334,2,-1,0,391,135,134,-1
"b416d47c56a742199b5d7c7f19d6503a","cd4532ad48034873ba8bce2aac0c9808",22859334,1,4,0,392,134,137,3
"cd4532ad48034873ba8bce2aac0c9808","cd4532ad48034873ba8bce2aac0c9808",22859334,1,0,1,393,137,137,0
"cd4532ad48034873ba8bce2aac0c9808","779f9ddd1fd14d1e9e69f72219a1fdbd",22859334,1,-19,0,394,137,121,-16
"779f9ddd1fd14d1e9e69f72219a1fdbd","df1de691dafe4549a18a4398ee9dfaf9",22859334,2,23,0,395,121,139,18
"df1de691dafe4549a18a4398ee9dfaf9","6c5ad271a44743479bfaea29b1db8d02",22859334,3,4,0,396,139,143,4
"6c5ad271a44743479bfaea29b1db8d02","6c5ad271a44743479bfaea29b1db8d02",22859334,2,0,1,397,143,143,0
"6c5ad271a44743479bfaea29b1db8d02","83d311bed5374fee83d8d67a7d9d82dc",22859334,3,1,0,399,143,144,1
"83d311bed5374fee83d8d67a7d9d82dc","83d311bed5374fee83d8d67a7d9d82dc",22859334,7,0,1,400,144,144,0
"83d311bed5374fee83d8d67a7d9d82dc","402bba41861d43acb52a5abb89e8831e",22859334,3,1,0,401,144,145,1
"402bba41861d43acb52a5abb89e8831e","402bba41861d43acb52a5abb89e8831e",22859334,10,0,1,402,145,145,0
"402bba41861d43acb52a5abb89e8831e","8aae34f5ddbb4052a709b12e6b0d40fa",22859334,3,3,0,404,145,147,2
"8aae34f5ddbb4052a709b12e6b0d40fa","df1de691dafe4549a18a4398ee9dfaf9",22859334,4,-9,0,405,147,139,-8
"8aae34f5ddbb4052a709b12e6b0d40fa","645b3f0249f64f76af2e19eb4d0e55b7",22859334,1,2,0,407,147,149,2
"645b3f0249f64f76af2e19eb4d0e55b7","645b3f0249f64f76af2e19eb4d0e55b7",22859334,9,0,1,408,149,149,0
"645b3f0249f64f76af2e19eb4d0e55b7","7e7b8db5064d4369805ab370aac5ddfb",22859334,2,1,0,416,149,150,1
"7e7b8db5064d4369805ab370aac5ddfb","7e7b8db5064d4369805ab370aac5ddfb",22859334,8,0,1,417,150,150,0
"7e7b8db5064d4369805ab370aac5ddfb","f902b0f41b544d4dbf79664fd233648d",22859334,1,-4,0,419,150,146,-4
"f902b0f41b544d4dbf79664fd233648d","df1de691dafe4549a18a4398ee9dfaf9",22859334,2,-8,0,420,146,139,-7
"df1de691dafe4549a18a4398ee9dfaf9","df1de691dafe4549a18a4398ee9dfaf9",22859334,3,0,1,421,139,139,0
"df1de691dafe4549a18a4398ee9dfaf9","f03480cf4eba413194d7af52fc0e7f28",22859334,2,15,0,422,139,152,13
"f03480cf4eba413194d7af52fc0e7f28","f03480cf4eba413194d7af52fc0e7f28",22859334,1,0,1,423,152,152,0
"f03480cf4eba413194d7af52fc0e7f28","8aae34f5ddbb4052a709b12e6b0d40fa",22859334,1,-6,0,424,152,147,-5
"8aae34f5ddbb4052a709b12e6b0d40fa","8956d210ae7f41968fada86d4c979d6a",22859334,1,4,0,425,147,151,4
"8956d210ae7f41968fada86d4c979d6a","8956d210ae7f41968fada86d4c979d6a",22859334,6,0,1,426,151,151,0
"8956d210ae7f41968fada86d4c979d6a","f902b0f41b544d4dbf79664fd233648d",22859334,2,-5,0,429,151,146,-5
"f902b0f41b544d4dbf79664fd233648d","6c5ad271a44743479bfaea29b1db8d02",22859334,1,-4,0,430,146,143,-3
"6c5ad271a44743479bfaea29b1db8d02","f03480cf4eba413194d7af52fc0e7f28",22859334,1,11,0,431,143,152,9
"f03480cf4eba413194d7af52fc0e7f28","402bba41861d43acb52a5abb89e8831e",22859334,1,-9,0,432,152,145,-7
"402bba41861d43acb52a5abb89e8831e","df1de691dafe4549a18a4398ee9dfaf9",22859334,1,-6,0,433,145,139,-6
"779f9ddd1fd14d1e9e69f72219a1fdbd","f661500307d74c908e9207d949ceb4aa",22859334,1,18,0,436,121,136,15
"f661500307d74c908e9207d949ceb4aa","a8dd5213034441ac92724b4e83eb0bb2",22859334,1,-9,0,437,136,129,-7
"a8dd5213034441ac92724b4e83eb0bb2","c2e1c2b9eac64109b343a088584b576b",22859334,1,4,0,438,129,133,4
"579338175e0b4bbb8ef3b712b5d8b54e","a8dd5213034441ac92724b4e83eb0bb2",22859334,1,1,0,440,128,129,1
"779f9ddd1fd14d1e9e69f72219a1fdbd","c2e1c2b9eac64109b343a088584b576b",22859334,1,13,0,442,121,133,12
"579338175e0b4bbb8ef3b712b5d8b54e","779f9ddd1fd14d1e9e69f72219a1fdbd",22859334,2,-8,0,444,128,121,-7
"e20db35ced8544ddac5bc3839145e463","62bff51286ef4f348717a3cf6fe2318f",22859334,2,33,0,446,91,120,29
"62bff51286ef4f348717a3cf6fe2318f","d646286c8051419bbc2e31dd1db55ca8",22859334,1,-63,0,450,120,67,-53
"d646286c8051419bbc2e31dd1db55ca8","140d5b27b8574befad82c0a013b59dfa",22859334,1,8,0,451,67,74,7
"140d5b27b8574befad82c0a013b59dfa","a2becd407db34b189200a32546d9d569",22859334,1,1,0,452,74,75,1
"a2becd407db34b189200a32546d9d569","f8ec6445f7194e25b9101d4fbcb07a18",22859334,1,6,0,453,75,81,6
"f8ec6445f7194e25b9101d4fbcb07a18","9176a3c2b4d2465fa8b0c67096c2a97e",22859334,1,-1,0,454,81,80,-1
"9176a3c2b4d2465fa8b0c67096c2a97e","cd1d828f1a694b87913a7ea66c23803e",22859334,1,-1,0,455,80,79,-1
"cd1d828f1a694b87913a7ea66c23803e","dd76e1861dc9461c830888729d091ee0",22859334,1,-1,0,456,79,78,-1
"dd76e1861dc9461c830888729d091ee0","58c22b011d0f4c2ea6d13615edbb9eeb",22859334,1,-1,0,457,78,77,-1
"58c22b011d0f4c2ea6d13615edbb9eeb","140d5b27b8574befad82c0a013b59dfa",22859334,1,-3,0,458,77,74,-3
"140d5b27b8574befad82c0a013b59dfa","140d5b27b8574befad82c0a013b59dfa",22859334,2,0,1,459,74,74,0
"f564483cbd7a407681aa2fcca518cf5f","ae5ac430ea254e708a6f5deaaf7464ae",22859334,1,-1,0,463,85,84,-1
"ae5ac430ea254e708a6f5deaaf7464ae","6a9f0ef185fb47f0937e29daa1c71ed5",22859334,2,7,0,464,84,90,6
"6a9f0ef185fb47f0937e29daa1c71ed5","42fb58708eaf4e5daa82bfca61b6f5fd",22859334,1,-3,0,467,90,87,-3
"42fb58708eaf4e5daa82bfca61b6f5fd","f564483cbd7a407681aa2fcca518cf5f",22859334,2,-3,0,468,87,85,-2
"ae5ac430ea254e708a6f5deaaf7464ae","42fb58708eaf4e5daa82bfca61b6f5fd",22859334,1,4,0,474,84,87,3
"35eb641ad1d845bbba54915bce75a962","d391c8b6e56a43a7b654e9dee02d904b",22859334,1,7,0,488,97,103,6
"e20db35ced8544ddac5bc3839145e463","67a089198fcb4e1c8f2385786c2b296f",22859334,1,-67,0,491,91,39,-52
"67a089198fcb4e1c8f2385786c2b296f","d646286c8051419bbc2e31dd1db55ca8",22859334,1,37,0,492,39,67,28
"d646286c8051419bbc2e31dd1db55ca8","ae5ac430ea254e708a6f5deaaf7464ae",22859334,1,20,0,493,67,84,17
"ae5ac430ea254e708a6f5deaaf7464ae","f564483cbd7a407681aa2fcca518cf5f",22859334,1,1,0,494,84,85,1
"18fd01350bd5434ca636d59a599d768a","ae5ac430ea254e708a6f5deaaf7464ae",22859334,1,-2,0,497,86,84,-2
"35eb641ad1d845bbba54915bce75a962","e20db35ced8544ddac5bc3839145e463",22859334,1,-6,0,507,97,91,-6
"a81b2235cb9c499eb9ea8ee0a8dd9725","8bdebf492ebd4e62b0d522e8ab5e5197",22859334,1,2,0,512,105,107,2
"8bdebf492ebd4e62b0d522e8ab5e5197","2d4e0ab0ef3b4d73b82c72d4621a7579",22859334,2,-1,0,513,107,106,-1
"2d4e0ab0ef3b4d73b82c72d4621a7579","73039f8c1eb9409cb4caee2cf968001e",22859334,1,-6,0,514,106,100,-6
"08111f75e22d409998cf8b85bd431f0a","00ae5f0c51874a73a41ebea838d95682",22859334,2,-8,0,517,108,101,-7
"d391c8b6e56a43a7b654e9dee02d904b","a81b2235cb9c499eb9ea8ee0a8dd9725",22859334,1,2,0,519,103,105,2
"2d4e0ab0ef3b4d73b82c72d4621a7579","6111116566fc4fd9abba409322bea245",22859334,1,-2,0,530,106,104,-2
"6111116566fc4fd9abba409322bea245","73039f8c1eb9409cb4caee2cf968001e",22859334,1,-4,0,534,104,100,-4
"4280927ec4d643238aa49c32f9e06c6c","a9ae0a3c070d455bb4369a8996313336",22859334,2,6,0,536,109,114,5
"a9ae0a3c070d455bb4369a8996313336","08111f75e22d409998cf8b85bd431f0a",22859334,2,-7,0,537,114,108,-6
"08111f75e22d409998cf8b85bd431f0a","d391c8b6e56a43a7b654e9dee02d904b",22859334,2,-6,0,538,108,103,-5
"00ae5f0c51874a73a41ebea838d95682","37319e88176d4aefa91d7a9980dbae91",22859334,1,13,0,540,101,112,11
"37319e88176d4aefa91d7a9980dbae91","2d4e0ab0ef3b4d73b82c72d4621a7579",22859334,1,-8,0,541,112,106,-6
"8bdebf492ebd4e62b0d522e8ab5e5197","4280927ec4d643238aa49c32f9e06c6c",22859334,1,3,0,552,107,109,2
"73039f8c1eb9409cb4caee2cf968001e","73039f8c1eb9409cb4caee2cf968001e",22859334,1,0,1,558,100,100,0
"73039f8c1eb9409cb4caee2cf968001e","e20db35ced8544ddac5bc3839145e463",22859334,2,-10,0,559,100,91,-9
"d391c8b6e56a43a7b654e9dee02d904b","e20db35ced8544ddac5bc3839145e463",22859334,1,-13,0,565,103,91,-12
"e20db35ced8544ddac5bc3839145e463","73039f8c1eb9409cb4caee2cf968001e",22859334,1,10,0,566,91,100,9
"08111f75e22d409998cf8b85bd431f0a","62bff51286ef4f348717a3cf6fe2318f",22859334,1,14,0,570,108,120,12
"779f9ddd1fd14d1e9e69f72219a1fdbd","ae26e6cda8ad4a3f81bd347560d9579f",22859334,1,4,0,576,121,125,4
"7a439da90b394756ad1777fc4c6dead5","779f9ddd1fd14d1e9e69f72219a1fdbd",22859334,1,-6,0,588,127,121,-6
"b416d47c56a742199b5d7c7f19d6503a","a8dd5213034441ac92724b4e83eb0bb2",22859334,3,-6,0,595,134,129,-5
"779f9ddd1fd14d1e9e69f72219a1fdbd","8bc5795d6a984a3eace4e2811e52dd4f",22859334,1,16,0,623,121,135,14
"a8dd5213034441ac92724b4e83eb0bb2","f661500307d74c908e9207d949ceb4aa",22859334,1,9,0,626,129,136,7
"f661500307d74c908e9207d949ceb4aa","579338175e0b4bbb8ef3b712b5d8b54e",22859334,1,-10,0,627,136,128,-8
"b416d47c56a742199b5d7c7f19d6503a","779f9ddd1fd14d1e9e69f72219a1fdbd",22859334,1,-15,0,629,134,121,-13
"df1de691dafe4549a18a4398ee9dfaf9","645b3f0249f64f76af2e19eb4d0e55b7",22859334,1,11,0,641,139,149,10
"7e7b8db5064d4369805ab370aac5ddfb","8956d210ae7f41968fada86d4c979d6a",22859334,1,1,0,650,150,151,1
"f902b0f41b544d4dbf79664fd233648d","f03480cf4eba413194d7af52fc0e7f28",22859334,1,7,0,655,146,152,6
"f03480cf4eba413194d7af52fc0e7f28","6c5ad271a44743479bfaea29b1db8d02",22859334,2,-11,0,656,152,143,-9
"6c5ad271a44743479bfaea29b1db8d02","f902b0f41b544d4dbf79664fd233648d",22859334,1,4,0,671,143,146,3
"df1de691dafe4549a18a4398ee9dfaf9","f902b0f41b544d4dbf79664fd233648d",22859334,1,8,0,679,139,146,7
"f902b0f41b544d4dbf79664fd233648d","ae781e8b775e4ccd93bc800dad5c8376",22859334,1,8,0,680,146,153,7
"ae781e8b775e4ccd93bc800dad5c8376","ae781e8b775e4ccd93bc800dad5c8376",22859334,6,0,1,681,153,153,0
"ae781e8b775e4ccd93bc800dad5c8376","06882a8492d9499aa31555567f575ecb",22859334,1,1,0,687,153,154,1
"06882a8492d9499aa31555567f575ecb","06882a8492d9499aa31555567f575ecb",22859334,1,0,1,688,154,154,0
"06882a8492d9499aa31555567f575ecb","f293c508f409466a8f27ddd7d1e40b20",22859334,1,1,0,689,154,155,1
"f293c508f409466a8f27ddd7d1e40b20","f293c508f409466a8f27ddd7d1e40b20",22859334,2,0,1,690,155,155,0
"f293c508f409466a8f27ddd7d1e40b20","cc4ddef5bbbe48ebb605141b347c4ed1",22859334,1,1,0,692,155,156,1
"cc4ddef5bbbe48ebb605141b347c4ed1","cc4ddef5bbbe48ebb605141b347c4ed1",22859334,6,0,1,693,156,156,0
"cc4ddef5bbbe48ebb605141b347c4ed1","f03480cf4eba413194d7af52fc0e7f28",22859334,1,-4,0,699,156,152,-4
"f03480cf4eba413194d7af52fc0e7f28","d313cec988a84645bee413e8d4724a4b",22859334,1,7,0,700,152,158,6
"d313cec988a84645bee413e8d4724a4b","dc60696c76a74368a60f72246e47700d",22859334,1,1,0,705,158,159,1
"dc60696c76a74368a60f72246e47700d","dc60696c76a74368a60f72246e47700d",22859334,3,0,1,706,159,159,0
"dc60696c76a74368a60f72246e47700d","78adeee1fa2c4fe0bc73f7bca9fcee86",22859334,1,3,0,709,159,160,1
"df1de691dafe4549a18a4398ee9dfaf9","78adeee1fa2c4fe0bc73f7bca9fcee86",22859334,1,26,0,711,139,160,21
"b2275c3fad834f8d90737a2d9a6927d6","b2275c3fad834f8d90737a2d9a6927d6",22859334,26,0,1,737,172,172,0
"b2275c3fad834f8d90737a2d9a6927d6","eb515a26030b41f8a82a1e6114420bad",22859334,1,1,0,763,172,173,1
"eb515a26030b41f8a82a1e6114420bad","eb515a26030b41f8a82a1e6114420bad",22859334,2,0,1,764,173,173,0
"eb515a26030b41f8a82a1e6114420bad","0c7262dff33c4087bc660ccf40f92f9c",22859334,1,-4,0,766,173,169,-4
"b42cc17b7de840f181a704558d0bc845","0c7262dff33c4087bc660ccf40f92f9c",22859334,1,-7,0,768,175,169,-6
"0c7262dff33c4087bc660ccf40f92f9c","0c7262dff33c4087bc660ccf40f92f9c",22859334,3,0,1,769,169,169,0
"0c7262dff33c4087bc660ccf40f92f9c","ae5ac430ea254e708a6f5deaaf7464ae",22859334,1,-112,0,770,169,84,-85
"ae5ac430ea254e708a6f5deaaf7464ae","d646286c8051419bbc2e31dd1db55ca8",22859334,2,-20,0,771,84,67,-17
"d646286c8051419bbc2e31dd1db55ca8","f564483cbd7a407681aa2fcca518cf5f",22859334,1,21,0,772,67,85,18
"4280927ec4d643238aa49c32f9e06c6c","00ae5f0c51874a73a41ebea838d95682",22859334,1,-9,0,786,109,101,-8
"00ae5f0c51874a73a41ebea838d95682","08111f75e22d409998cf8b85bd431f0a",22859334,1,8,0,787,101,108,7
"73039f8c1eb9409cb4caee2cf968001e","67a089198fcb4e1c8f2385786c2b296f",22859334,1,-77,0,790,100,39,-61
"67a089198fcb4e1c8f2385786c2b296f","78adeee1fa2c4fe0bc73f7bca9fcee86",22859334,2,152,0,792,39,160,121
"78adeee1fa2c4fe0bc73f7bca9fcee86","b7719e26494940efa49512aedd0aac79",22859334,1,-192,0,802,160,20,-140
"93679be414554a11b1893002f2229a93","c33c17be71ae4d588da7369472e5bb1b",22859334,2,-3,0,816,35,34,-1
"7040a13096d746ac84b8fac8d9752058","7040a13096d746ac84b8fac8d9752058",22859334,2,0,1,819,36,36,0
"9a0dc646f934470daf08c4b56ccf73db","9a0dc646f934470daf08c4b56ccf73db",22859334,2,0,1,821,37,37,0
"64d48c6c9c7940639a932219a6c87198","73039f8c1eb9409cb4caee2cf968001e",22859334,1,76,0,826,40,100,60
"00ae5f0c51874a73a41ebea838d95682","67a089198fcb4e1c8f2385786c2b296f",22859334,1,-78,0,830,101,39,-62
"65202579580f4ad38d734b4ee39d22a8","0c7262dff33c4087bc660ccf40f92f9c",22859334,1,12,0,842,164,169,5
"b42cc17b7de840f181a704558d0bc845","b42cc17b7de840f181a704558d0bc845",22859334,4,0,1,844,175,175,0
"b42cc17b7de840f181a704558d0bc845","801f9e9135034f49bf5f8b4bdefedb41",22859334,1,2,0,848,175,177,2
"801f9e9135034f49bf5f8b4bdefedb41","801f9e9135034f49bf5f8b4bdefedb41",22859334,11,0,1,849,177,177,0
"801f9e9135034f49bf5f8b4bdefedb41","362fcb0699a14845ab29b2340093e528",22859334,1,-3,0,860,177,174,-3
"362fcb0699a14845ab29b2340093e528","ea38cc0e6e6e41edbabf210220808bf9",22859334,1,6,0,861,174,179,5
"ea38cc0e6e6e41edbabf210220808bf9","b87c552dd247427abe6ab5795b9c9d43",22859334,3,2,0,862,179,181,2
"b87c552dd247427abe6ab5795b9c9d43","b87c552dd247427abe6ab5795b9c9d43",22859334,9,0,1,865,181,181,0
"b87c552dd247427abe6ab5795b9c9d43","0c7262dff33c4087bc660ccf40f92f9c",22859334,1,-14,0,874,181,169,-12
"0c7262dff33c4087bc660ccf40f92f9c","2024b4885bd14338a39b7b509acbbd02",22859334,1,16,0,877,169,182,13
"2024b4885bd14338a39b7b509acbbd02","ea38cc0e6e6e41edbabf210220808bf9",22859334,2,-4,0,878,182,179,-3
"b87c552dd247427abe6ab5795b9c9d43","2024b4885bd14338a39b7b509acbbd02",22859334,1,2,0,880,181,182,1
"ea38cc0e6e6e41edbabf210220808bf9","ea38cc0e6e6e41edbabf210220808bf9",22859334,2,0,1,882,179,179,0
"139b097acfca451689d80c9c6eebdf7b","30f660a1feb34582a739722532524f79",22859334,1,6,0,885,178,183,5
"30f660a1feb34582a739722532524f79","30f660a1feb34582a739722532524f79",22859334,8,0,1,886,183,183,0
"30f660a1feb34582a739722532524f79","2024b4885bd14338a39b7b509acbbd02",22859334,1,-1,0,894,183,182,-1
"2024b4885bd14338a39b7b509acbbd02","c3f63fe50d8e487c86bf8ef76c9cadd3",22859334,1,4,0,895,182,185,3
"c3f63fe50d8e487c86bf8ef76c9cadd3","c3f63fe50d8e487c86bf8ef76c9cadd3",22859334,1,0,1,896,185,185,0
"c3f63fe50d8e487c86bf8ef76c9cadd3","c8e371568a0c4391b25796ae4e91952e",22859334,1,3,0,897,185,186,1
"c8e371568a0c4391b25796ae4e91952e","0c7262dff33c4087bc660ccf40f92f9c",22859334,1,-23,0,898,186,169,-17
"0c7262dff33c4087bc660ccf40f92f9c","7d932b23e1c84326ae5aa4d3c0d813d1",22859334,1,25,0,899,169,188,19
"7d932b23e1c84326ae5aa4d3c0d813d1","7d932b23e1c84326ae5aa4d3c0d813d1",22859334,1,0,1,900,188,188,0
"7d932b23e1c84326ae5aa4d3c0d813d1","c8e371568a0c4391b25796ae4e91952e",22859334,1,-2,0,901,188,186,-2
"ab11d94c6c8948ea90b88f19d2cd502b","0c7262dff33c4087bc660ccf40f92f9c",22859334,1,-28,0,903,190,169,-21
"ab11d94c6c8948ea90b88f19d2cd502b","ab11d94c6c8948ea90b88f19d2cd502b",22859334,2,0,1,906,190,190,0
"ab11d94c6c8948ea90b88f19d2cd502b","f992451ed6ad4e68bb9e68ad6be7c4be",22859334,1,2,0,908,190,192,2
"f992451ed6ad4e68bb9e68ad6be7c4be","f992451ed6ad4e68bb9e68ad6be7c4be",22859334,5,0,1,909,192,192,0
"f992451ed6ad4e68bb9e68ad6be7c4be","07b44a7a51e94c78b411c753fc39dab0",22859334,1,-3,0,914,192,189,-3
"6cd2dcaac46847d4a0bc53f296d90375","6cd2dcaac46847d4a0bc53f296d90375",22859334,8,0,1,916,194,194,0
"6cd2dcaac46847d4a0bc53f296d90375","c8e371568a0c4391b25796ae4e91952e",22859334,1,-10,0,921,194,186,-8
"c8e371568a0c4391b25796ae4e91952e","6cd2dcaac46847d4a0bc53f296d90375",22859334,1,10,0,922,186,194,8
"6cd2dcaac46847d4a0bc53f296d90375","2d2580c9411c4972909db508d6956a58",22859334,1,2,0,926,194,196,2
"2d2580c9411c4972909db508d6956a58","2d2580c9411c4972909db508d6956a58",22859334,8,0,1,927,196,196,0
"2d2580c9411c4972909db508d6956a58","5bddb3d9ed264f3984702f048c7e5340",22859334,1,1,0,935,196,197,1
"5bddb3d9ed264f3984702f048c7e5340","5bddb3d9ed264f3984702f048c7e5340",22859334,2,0,1,936,197,197,0
"5bddb3d9ed264f3984702f048c7e5340","d5e8e2bd12a2466b9d6d90855f0eb079",22859334,1,1,0,938,197,198,1
"d5e8e2bd12a2466b9d6d90855f0eb079","d5e8e2bd12a2466b9d6d90855f0eb079",22859334,2,0,1,939,198,198,0
"d5e8e2bd12a2466b9d6d90855f0eb079","017d7ca8e0394b91aaadc9574df2202c",22859334,1,-5,0,941,198,193,-5
"017d7ca8e0394b91aaadc9574df2202c","54e8e9f0ea3e45c4bf3b8ac799ee31b1",22859334,1,8,0,942,193,200,7
"54e8e9f0ea3e45c4bf3b8ac799ee31b1","54e8e9f0ea3e45c4bf3b8ac799ee31b1",22859334,1,0,1,943,200,200,0
"54e8e9f0ea3e45c4bf3b8ac799ee31b1","c614a00911be4877a075f19315530fb0",22859334,1,1,0,944,200,201,1
"c614a00911be4877a075f19315530fb0","c614a00911be4877a075f19315530fb0",22859334,6,0,1,945,201,201,0
"c614a00911be4877a075f19315530fb0","a6c21bd8b95249c7972820a7a7d76aff",22859334,1,1,0,951,201,202,1
"a6c21bd8b95249c7972820a7a7d76aff","a6c21bd8b95249c7972820a7a7d76aff",22859334,1,0,1,952,202,202,0
"a6c21bd8b95249c7972820a7a7d76aff","bb329d880ab54120adaf203a693bb203",22859334,1,1,0,953,202,203,1
"bb329d880ab54120adaf203a693bb203","bb329d880ab54120adaf203a693bb203",22859334,2,0,1,954,203,203,0
"bb329d880ab54120adaf203a693bb203","f9170dd6bc6442b4acd832747609b09a",22859334,1,-4,0,956,203,199,-4
"f9170dd6bc6442b4acd832747609b09a","334c2344009840079b1d0e1b7ce3d5a7",22859334,1,7,0,957,199,205,6
"334c2344009840079b1d0e1b7ce3d5a7","334c2344009840079b1d0e1b7ce3d5a7",22859334,1,0,1,958,205,205,0
"334c2344009840079b1d0e1b7ce3d5a7","d7f13c8d63ec4e2aa673fbb9cf9c6933",22859334,1,3,0,959,205,206,1
"c8e371568a0c4391b25796ae4e91952e","b9e80f77c3a44349863b19875725c384",22859334,1,27,0,961,186,207,21
"b9e80f77c3a44349863b19875725c384","b9e80f77c3a44349863b19875725c384",22859334,35,0,1,964,207,207,0
"7108f0e4c2584f1f9c471689ae4c885c","7108f0e4c2584f1f9c471689ae4c885c",22859334,17,0,1,1000,208,208,0
"7108f0e4c2584f1f9c471689ae4c885c","d7f13c8d63ec4e2aa673fbb9cf9c6933",22859334,2,-2,0,1017,208,206,-2
"d7f13c8d63ec4e2aa673fbb9cf9c6933","09400e101c5d4b439cf9a26b03aae558",22859334,3,5,0,1018,206,210,4
"09400e101c5d4b439cf9a26b03aae558","0c7262dff33c4087bc660ccf40f92f9c",22859334,1,-54,0,1019,210,169,-41
"0c7262dff33c4087bc660ccf40f92f9c","7108f0e4c2584f1f9c471689ae4c885c",22859334,1,51,0,1020,169,208,39
"d7f13c8d63ec4e2aa673fbb9cf9c6933","7108f0e4c2584f1f9c471689ae4c885c",22859334,1,2,0,1022,206,208,2
"7108f0e4c2584f1f9c471689ae4c885c","b9e80f77c3a44349863b19875725c384",22859334,4,-1,0,1023,208,207,-1
"b9e80f77c3a44349863b19875725c384","7108f0e4c2584f1f9c471689ae4c885c",22859334,3,1,0,1024,207,208,1
"7108f0e4c2584f1f9c471689ae4c885c","09400e101c5d4b439cf9a26b03aae558",22859334,1,3,0,1025,208,210,2
"09400e101c5d4b439cf9a26b03aae558","d7f13c8d63ec4e2aa673fbb9cf9c6933",22859334,1,-5,0,1026,210,206,-4
"09400e101c5d4b439cf9a26b03aae558","09400e101c5d4b439cf9a26b03aae558",22859334,5,0,1,1028,210,210,0
"09400e101c5d4b439cf9a26b03aae558","a88efa7e50ce47159810ab553afa6d3a",22859334,1,2,0,1033,210,212,2
"a88efa7e50ce47159810ab553afa6d3a","a88efa7e50ce47159810ab553afa6d3a",22859334,20,0,1,1034,212,212,0
"a88efa7e50ce47159810ab553afa6d3a","a875096404ef4a9984b62d74cda916f9",22859334,1,-3,0,1054,212,209,-3
"a875096404ef4a9984b62d74cda916f9","be502a7a43c44bf7b682698de79d9369",22859334,2,6,0,1055,209,214,5
"be502a7a43c44bf7b682698de79d9369","f7fb1952f56b4189b86a9f8b7862d2b8",22859334,5,1,0,1056,214,215,1
"f7fb1952f56b4189b86a9f8b7862d2b8","be502a7a43c44bf7b682698de79d9369",22859334,1,-1,0,1057,215,214,-1
"be502a7a43c44bf7b682698de79d9369","be502a7a43c44bf7b682698de79d9369",22859334,1,0,1,1058,214,214,0
"f7fb1952f56b4189b86a9f8b7862d2b8","f7fb1952f56b4189b86a9f8b7862d2b8",22859334,18,0,1,1060,215,215,0
"f7fb1952f56b4189b86a9f8b7862d2b8","b860ee85d8bc4a2f97958cfb71be3533",22859334,3,1,0,1078,215,216,1
"b860ee85d8bc4a2f97958cfb71be3533","b860ee85d8bc4a2f97958cfb71be3533",22859334,9,0,1,1079,216,216,0
"b860ee85d8bc4a2f97958cfb71be3533","ec341f459285443b8361f7f15638ff08",22859334,3,-3,0,1081,216,213,-3
"ec341f459285443b8361f7f15638ff08","363837c182e04711840d896ae1e0339c",22859334,4,6,0,1082,213,218,5
"363837c182e04711840d896ae1e0339c","363837c182e04711840d896ae1e0339c",22859334,50,0,1,1083,218,218,0
"363837c182e04711840d896ae1e0339c","01b2051f8941460d89945e3b02d1ce78",22859334,3,-1,0,1133,218,217,-1
"01b2051f8941460d89945e3b02d1ce78","be95c065e45447c1bd8215ea6f130c7a",22859334,1,3,0,1134,217,219,2
"be95c065e45447c1bd8215ea6f130c7a","be502a7a43c44bf7b682698de79d9369",22859334,1,-7,0,1135,219,214,-5
"f7fb1952f56b4189b86a9f8b7862d2b8","ec341f459285443b8361f7f15638ff08",22859334,1,-2,0,1137,215,213,-2
"01b2051f8941460d89945e3b02d1ce78","91125ca626c5470eb145501f8c37f8db",22859334,1,4,0,1140,217,220,3
"91125ca626c5470eb145501f8c37f8db","91125ca626c5470eb145501f8c37f8db",22859334,1,0,1,1141,220,220,0
"91125ca626c5470eb145501f8c37f8db","1c6721b1f63f4d30ba7746ea8af02a52",22859334,1,3,0,1142,220,221,1
"1c6721b1f63f4d30ba7746ea8af02a52","d7f13c8d63ec4e2aa673fbb9cf9c6933",22859334,3,-21,0,1143,221,206,-15
"d7f13c8d63ec4e2aa673fbb9cf9c6933","77ecef8eff6b4a2caea7707669bf7475",22859334,3,22,0,1144,206,222,16
"77ecef8eff6b4a2caea7707669bf7475","77ecef8eff6b4a2caea7707669bf7475",22859334,14,0,1,1145,222,222,0
"77ecef8eff6b4a2caea7707669bf7475","d03cb855c70044cf8c35d9ec0de696e3",22859334,2,3,0,1159,222,224,2
"d03cb855c70044cf8c35d9ec0de696e3","1c6721b1f63f4d30ba7746ea8af02a52",22859334,1,-4,0,1160,224,221,-3
"1c6721b1f63f4d30ba7746ea8af02a52","8b9ae98743bd4d4a8a87dff1c1244211",22859334,1,7,0,1161,221,227,6
"8b9ae98743bd4d4a8a87dff1c1244211","0c7262dff33c4087bc660ccf40f92f9c",22859334,1,-77,0,1162,227,169,-58
"0c7262dff33c4087bc660ccf40f92f9c","1c6721b1f63f4d30ba7746ea8af02a52",22859334,2,70,0,1163,169,221,52
"1c6721b1f63f4d30ba7746ea8af02a52","f7906d6f59b9489a91d2ef40db5a474d",22859334,1,3,0,1164,221,223,2
"f7906d6f59b9489a91d2ef40db5a474d","d03cb855c70044cf8c35d9ec0de696e3",22859334,1,1,0,1165,223,224,1
"d03cb855c70044cf8c35d9ec0de696e3","8b9ae98743bd4d4a8a87dff1c1244211",22859334,5,3,0,1166,224,227,3
"8b9ae98743bd4d4a8a87dff1c1244211","ec341f459285443b8361f7f15638ff08",22859334,1,-19,0,1167,227,213,-14
"ec341f459285443b8361f7f15638ff08","d7f13c8d63ec4e2aa673fbb9cf9c6933",22859334,1,-9,0,1168,213,206,-7
"d7f13c8d63ec4e2aa673fbb9cf9c6933","be502a7a43c44bf7b682698de79d9369",22859334,1,10,0,1169,206,214,8
"363837c182e04711840d896ae1e0339c","be502a7a43c44bf7b682698de79d9369",22859334,1,-5,0,1176,218,214,-4
"be502a7a43c44bf7b682698de79d9369","01b2051f8941460d89945e3b02d1ce78",22859334,1,4,0,1177,214,217,3
"01b2051f8941460d89945e3b02d1ce78","f7fb1952f56b4189b86a9f8b7862d2b8",22859334,1,-3,0,1178,217,215,-2
"01b2051f8941460d89945e3b02d1ce78","d7f13c8d63ec4e2aa673fbb9cf9c6933",22859334,1,-14,0,1188,217,206,-11
"d7f13c8d63ec4e2aa673fbb9cf9c6933","1c6721b1f63f4d30ba7746ea8af02a52",22859334,2,21,0,1189,206,221,15
"1c6721b1f63f4d30ba7746ea8af02a52","77ecef8eff6b4a2caea7707669bf7475",22859334,1,1,0,1190,221,222,1
"8b9ae98743bd4d4a8a87dff1c1244211","1c6721b1f63f4d30ba7746ea8af02a52",22859334,1,-7,0,1193,227,221,-6
"1c6721b1f63f4d30ba7746ea8af02a52","0c7262dff33c4087bc660ccf40f92f9c",22859334,1,-70,0,1194,221,169,-52
"0c7262dff33c4087bc660ccf40f92f9c","f7906d6f59b9489a91d2ef40db5a474d",22859334,1,73,0,1195,169,223,54
"f7906d6f59b9489a91d2ef40db5a474d","1c6721b1f63f4d30ba7746ea8af02a52",22859334,1,-3,0,1196,223,221,-2
"1c6721b1f63f4d30ba7746ea8af02a52","d03cb855c70044cf8c35d9ec0de696e3",22859334,2,4,0,1197,221,224,3
"8b9ae98743bd4d4a8a87dff1c1244211","d03cb855c70044cf8c35d9ec0de696e3",22859334,1,-3,0,1199,227,224,-3
"d03cb855c70044cf8c35d9ec0de696e3","d03cb855c70044cf8c35d9ec0de696e3",22859334,1,0,1,1200,224,224,0
"d03cb855c70044cf8c35d9ec0de696e3","a49a937d6896486d9a5396654abcf2e1",22859334,1,2,0,1201,224,226,2
"a49a937d6896486d9a5396654abcf2e1","a49a937d6896486d9a5396654abcf2e1",22859334,1,0,1,1202,226,226,0
"a49a937d6896486d9a5396654abcf2e1","d03cb855c70044cf8c35d9ec0de696e3",22859334,1,-2,0,1203,226,224,-2
"8b9ae98743bd4d4a8a87dff1c1244211","8b9ae98743bd4d4a8a87dff1c1244211",22859334,33,0,1,1205,227,227,0
"8b9ae98743bd4d4a8a87dff1c1244211","f7906d6f59b9489a91d2ef40db5a474d",22859334,2,-4,0,1238,227,223,-4
"f7906d6f59b9489a91d2ef40db5a474d","2ab1535aac1346ba8801535bf729ef37",22859334,2,7,0,1239,223,229,6
"2ab1535aac1346ba8801535bf729ef37","0c7262dff33c4087bc660ccf40f92f9c",22859334,1,-80,0,1240,229,169,-60
"0c7262dff33c4087bc660ccf40f92f9c","5152833676bf4c6cb317060be10f68db",22859334,1,79,0,1241,169,228,59
"5152833676bf4c6cb317060be10f68db","1c6721b1f63f4d30ba7746ea8af02a52",22859334,1,-9,0,1242,228,221,-7
"1c6721b1f63f4d30ba7746ea8af02a52","2ab1535aac1346ba8801535bf729ef37",22859334,2,10,0,1243,221,229,8
"2ab1535aac1346ba8801535bf729ef37","1c6721b1f63f4d30ba7746ea8af02a52",22859334,1,-10,0,1244,229,221,-8
"2ab1535aac1346ba8801535bf729ef37","2ab1535aac1346ba8801535bf729ef37",22859334,3,0,1,1246,229,229,0
"2ab1535aac1346ba8801535bf729ef37","a4f40fb48a8542c8949bae1f002cd9bc",22859334,1,2,0,1249,229,231,2
"a4f40fb48a8542c8949bae1f002cd9bc","a4f40fb48a8542c8949bae1f002cd9bc",22859334,2,0,1,1250,231,231,0
"a4f40fb48a8542c8949bae1f002cd9bc","2ab1535aac1346ba8801535bf729ef37",22859334,1,-2,0,1252,231,229,-2
"2ab1535aac1346ba8801535bf729ef37","8972c23e32044edb8a78fa1eed4e5947",22859334,1,3,0,1253,229,232,3
"8972c23e32044edb8a78fa1eed4e5947","8972c23e32044edb8a78fa1eed4e5947",22859334,3,0,1,1254,232,232,0
"8972c23e32044edb8a78fa1eed4e5947","92feb4a40f8344d38b6f722e42a53295",22859334,1,1,0,1257,232,233,1
"92feb4a40f8344d38b6f722e42a53295","92feb4a40f8344d38b6f722e42a53295",22859334,2,0,1,1258,233,233,0
"92feb4a40f8344d38b6f722e42a53295","5152833676bf4c6cb317060be10f68db",22859334,1,-5,0,1260,233,228,-5
"5152833676bf4c6cb317060be10f68db","0c7262dff33c4087bc660ccf40f92f9c",22859334,1,-79,0,1261,228,169,-59
"1c6721b1f63f4d30ba7746ea8af02a52","0b04c8e2f86d48c7aeb7e225819cd32b",22859334,1,16,0,1263,221,234,13
"0b04c8e2f86d48c7aeb7e225819cd32b","ca3e28f290354c08aefe5b0f769604e6",22859334,1,1,0,1264,234,235,1
"ca3e28f290354c08aefe5b0f769604e6","ca3e28f290354c08aefe5b0f769604e6",22859334,14,0,1,1265,235,235,0
"ca3e28f290354c08aefe5b0f769604e6","79a35eea833e4c2c9d22fc53c3c6445c",22859334,1,1,0,1279,235,236,1
"79a35eea833e4c2c9d22fc53c3c6445c","79a35eea833e4c2c9d22fc53c3c6445c",22859334,4,0,1,1280,236,236,0
"79a35eea833e4c2c9d22fc53c3c6445c","8f68228b1518449e9615cdafee41a2bd",22859334,1,1,0,1284,236,237,1
"8f68228b1518449e9615cdafee41a2bd","8f68228b1518449e9615cdafee41a2bd",22859334,1,0,1,1285,237,237,0
"8f68228b1518449e9615cdafee41a2bd","cab89fa5c3ed45a5aa550fc0352d6a42",22859334,1,1,0,1286,237,238,1
"cab89fa5c3ed45a5aa550fc0352d6a42","cab89fa5c3ed45a5aa550fc0352d6a42",22859334,5,0,1,1287,238,238,0
"cab89fa5c3ed45a5aa550fc0352d6a42","66d4fad4f1cf4b46be0750a99ad7a35a",22859334,1,1,0,1292,238,239,1
"66d4fad4f1cf4b46be0750a99ad7a35a","66d4fad4f1cf4b46be0750a99ad7a35a",22859334,1,0,1,1293,239,239,0
"66d4fad4f1cf4b46be0750a99ad7a35a","0b04c8e2f86d48c7aeb7e225819cd32b",22859334,1,-5,0,1294,239,234,-5
"0b04c8e2f86d48c7aeb7e225819cd32b","f53da5fd9bfe412da4b80d4742563b6c",22859334,1,8,0,1295,234,241,7
"f53da5fd9bfe412da4b80d4742563b6c","f53da5fd9bfe412da4b80d4742563b6c",22859334,1,0,1,1296,241,241,0
"f53da5fd9bfe412da4b80d4742563b6c","2ae94c0cea4d480a9d5dca8fb1d7b542",22859334,1,3,0,1297,241,242,1
"2ae94c0cea4d480a9d5dca8fb1d7b542","1c6721b1f63f4d30ba7746ea8af02a52",22859334,2,-27,0,1298,242,221,-21
"1c6721b1f63f4d30ba7746ea8af02a52","1ebf23f9d994469a85206e4c7b1bf5f5",22859334,2,30,0,1299,221,245,24
"1ebf23f9d994469a85206e4c7b1bf5f5","1ebf23f9d994469a85206e4c7b1bf5f5",22859334,11,0,1,1300,245,245,0
"1ebf23f9d994469a85206e4c7b1bf5f5","0c7262dff33c4087bc660ccf40f92f9c",22859334,1,-100,0,1301,245,169,-76
"0c7262dff33c4087bc660ccf40f92f9c","94cecc3f1e7d484b8e068e79241dfd73",22859334,1,148,0,1302,169,281,112
"94cecc3f1e7d484b8e068e79241dfd73","94cecc3f1e7d484b8e068e79241dfd73",22859334,1,0,1,1303,281,281,0
"94cecc3f1e7d484b8e068e79241dfd73","a37477c4e4c14169ad44b06b493007f6",22859334,4,2,0,1304,281,283,2
"a37477c4e4c14169ad44b06b493007f6","0c7262dff33c4087bc660ccf40f92f9c",22859334,1,-150,0,1305,283,169,-114
"0c7262dff33c4087bc660ccf40f92f9c","2ae94c0cea4d480a9d5dca8fb1d7b542",22859334,2,97,0,1306,169,242,73
"2ae94c0cea4d480a9d5dca8fb1d7b542","2ae94c0cea4d480a9d5dca8fb1d7b542",22859334,8,0,1,1307,242,242,0
"2ae94c0cea4d480a9d5dca8fb1d7b542","1ebf23f9d994469a85206e4c7b1bf5f5",22859334,6,3,0,1308,242,245,3
"1ebf23f9d994469a85206e4c7b1bf5f5","64dbedb3ce544f6aae8e10e0cf10f16d",22859334,1,-7,0,1309,245,240,-5
"64dbedb3ce544f6aae8e10e0cf10f16d","1c6721b1f63f4d30ba7746ea8af02a52",22859334,2,-23,0,1310,240,221,-19
"1c6721b1f63f4d30ba7746ea8af02a52","f53da5fd9bfe412da4b80d4742563b6c",22859334,1,24,0,1311,221,241,20
"f53da5fd9bfe412da4b80d4742563b6c","1c6721b1f63f4d30ba7746ea8af02a52",22859334,1,-24,0,1312,241,221,-20
"1c6721b1f63f4d30ba7746ea8af02a52","2ae94c0cea4d480a9d5dca8fb1d7b542",22859334,4,27,0,1313,221,242,21
"1ebf23f9d994469a85206e4c7b1bf5f5","2ae94c0cea4d480a9d5dca8fb1d7b542",22859334,5,-3,0,1315,245,242,-3
"1ebf23f9d994469a85206e4c7b1bf5f5","85ae675b83e8422da842cfd25596af99",22859334,1,1,0,1328,245,246,1
"85ae675b83e8422da842cfd25596af99","85ae675b83e8422da842cfd25596af99",22859334,1,0,1,1329,246,246,0
"85ae675b83e8422da842cfd25596af99","fa235f0f364d47e4ae1c87f47bf8e6ba",22859334,1,8,0,1330,246,252,6
"fa235f0f364d47e4ae1c87f47bf8e6ba","2ae94c0cea4d480a9d5dca8fb1d7b542",22859334,1,-12,0,1331,252,242,-10
"2ae94c0cea4d480a9d5dca8fb1d7b542","0c7262dff33c4087bc660ccf40f92f9c",22859334,1,-97,0,1332,242,169,-73
"2ae94c0cea4d480a9d5dca8fb1d7b542","d546341988904f069cfa86b21457d9d9",22859334,1,11,0,1334,242,251,9
"d546341988904f069cfa86b21457d9d9","00f61990949545828dd12f1303d47504",22859334,1,6,0,1335,251,256,5
"00f61990949545828dd12f1303d47504","00f61990949545828dd12f1303d47504",22859334,2,0,1,1336,256,256,0
"00f61990949545828dd12f1303d47504","ead7bb4b64e247d2ae632ab8a296b091",22859334,1,2,0,1338,256,258,2
"ead7bb4b64e247d2ae632ab8a296b091","ead7bb4b64e247d2ae632ab8a296b091",22859334,2,0,1,1339,258,258,0
"ead7bb4b64e247d2ae632ab8a296b091","41b0048dde734bb280bac6116baa8e27",22859334,1,1,0,1341,258,259,1
"41b0048dde734bb280bac6116baa8e27","41b0048dde734bb280bac6116baa8e27",22859334,2,0,1,1342,259,259,0
"41b0048dde734bb280bac6116baa8e27","b41c5a094a604ee0915327da5cc0beb7",22859334,1,1,0,1344,259,260,1
"b41c5a094a604ee0915327da5cc0beb7","b41c5a094a604ee0915327da5cc0beb7",22859334,2,0,1,1345,260,260,0
"b41c5a094a604ee0915327da5cc0beb7","d546341988904f069cfa86b21457d9d9",22859334,1,-10,0,1347,260,251,-9
"d546341988904f069cfa86b21457d9d9","28c171777c52431ab6b925073bd63d46",22859334,1,15,0,1348,251,264,13
"28c171777c52431ab6b925073bd63d46","28c171777c52431ab6b925073bd63d46",22859334,3,0,1,1349,264,264,0
"28c171777c52431ab6b925073bd63d46","ac160db940cb49ae8579162b1d52bb5d",22859334,1,2,0,1352,264,266,2
"ac160db940cb49ae8579162b1d52bb5d","ac160db940cb49ae8579162b1d52bb5d",22859334,3,0,1,1353,266,266,0
"ac160db940cb49ae8579162b1d52bb5d","d989ebcfc12a4b669f0100dc1aa14f1e",22859334,1,-12,0,1356,266,255,-11
"d989ebcfc12a4b669f0100dc1aa14f1e","c6fd49b485cc4874b0bbdd9c6171e09c",22859334,1,15,0,1357,255,268,13
"c6fd49b485cc4874b0bbdd9c6171e09c","c6fd49b485cc4874b0bbdd9c6171e09c",22859334,7,0,1,1358,268,268,0
"c6fd49b485cc4874b0bbdd9c6171e09c","44240778a97c4af0937817499b75707b",22859334,1,1,0,1365,268,269,1
"44240778a97c4af0937817499b75707b","44240778a97c4af0937817499b75707b",22859334,2,0,1,1366,269,269,0
"44240778a97c4af0937817499b75707b","7aa76d3e993840d8805f097cbdbcd44b",22859334,1,-9,0,1368,269,261,-8
"7aa76d3e993840d8805f097cbdbcd44b","865a4d3b43374da7944dc7d397f566d9",22859334,1,12,0,1369,261,271,10
"865a4d3b43374da7944dc7d397f566d9","865a4d3b43374da7944dc7d397f566d9",22859334,1,0,1,1370,271,271,0
"865a4d3b43374da7944dc7d397f566d9","2ae94c0cea4d480a9d5dca8fb1d7b542",22859334,1,-35,0,1371,271,242,-29
"2ae94c0cea4d480a9d5dca8fb1d7b542","0d987bed3ffa4ed0b9a2e62e97b7b30f",22859334,15,38,0,1372,242,272,30
"0d987bed3ffa4ed0b9a2e62e97b7b30f","78adeee1fa2c4fe0bc73f7bca9fcee86",22859334,1,-152,0,1373,272,160,-112
"78adeee1fa2c4fe0bc73f7bca9fcee86","78adeee1fa2c4fe0bc73f7bca9fcee86",22859334,10,0,1,1374,160,160,0
"78adeee1fa2c4fe0bc73f7bca9fcee86","65202579580f4ad38d734b4ee39d22a8",22859334,9,5,0,1376,160,164,4
"65202579580f4ad38d734b4ee39d22a8","65202579580f4ad38d734b4ee39d22a8",22859334,94,0,1,1377,164,164,0
"65202579580f4ad38d734b4ee39d22a8","0d987bed3ffa4ed0b9a2e62e97b7b30f",22859334,1,147,0,1408,164,272,108
"0d987bed3ffa4ed0b9a2e62e97b7b30f","0c7262dff33c4087bc660ccf40f92f9c",22859334,1,-135,0,1409,272,169,-103
"0c7262dff33c4087bc660ccf40f92f9c","78adeee1fa2c4fe0bc73f7bca9fcee86",22859334,1,-17,0,1410,169,160,-9
"65202579580f4ad38d734b4ee39d22a8","78adeee1fa2c4fe0bc73f7bca9fcee86",22859334,7,-5,0,1418,164,160,-4
"65202579580f4ad38d734b4ee39d22a8","3cbcea2be0984e7dbd5a48195af10ce7",22859334,1,3,0,1443,164,165,1
"3cbcea2be0984e7dbd5a48195af10ce7","78adeee1fa2c4fe0bc73f7bca9fcee86",22859334,1,-8,0,1444,165,160,-5
"78adeee1fa2c4fe0bc73f7bca9fcee86","82e6285962b8400d9d6fc32436022a94",22859334,1,10,0,1445,160,167,7
"82e6285962b8400d9d6fc32436022a94","64dbedb3ce544f6aae8e10e0cf10f16d",22859334,1,100,0,1446,167,240,73
"1c6721b1f63f4d30ba7746ea8af02a52","1c6721b1f63f4d30ba7746ea8af02a52",22859334,1,0,1,1448,221,221,0
"2ae94c0cea4d480a9d5dca8fb1d7b542","30c9ba177afc49a695625d2bdec40207",22859334,1,9,0,1455,242,250,8
"30c9ba177afc49a695625d2bdec40207","30c9ba177afc49a695625d2bdec40207",22859334,5,0,1,1456,250,250,0
"30c9ba177afc49a695625d2bdec40207","6e83e23f56544a19b94067c1c558d9c0",22859334,1,-3,0,1461,250,247,-3
"6e83e23f56544a19b94067c1c558d9c0","00f61990949545828dd12f1303d47504",22859334,1,11,0,1462,247,256,9
"00f61990949545828dd12f1303d47504","d546341988904f069cfa86b21457d9d9",22859334,1,-6,0,1463,256,251,-5
"d546341988904f069cfa86b21457d9d9","d989ebcfc12a4b669f0100dc1aa14f1e",22859334,2,5,0,1464,251,255,4
"d989ebcfc12a4b669f0100dc1aa14f1e","0c7262dff33c4087bc660ccf40f92f9c",22859334,1,-113,0,1465,255,169,-86
"0c7262dff33c4087bc660ccf40f92f9c","7028800abe7d4e27b613d1d6cbe26bf7",22859334,1,127,0,1466,169,267,98
"7028800abe7d4e27b613d1d6cbe26bf7","2ae94c0cea4d480a9d5dca8fb1d7b542",22859334,1,-30,0,1467,267,242,-25
"0d987bed3ffa4ed0b9a2e62e97b7b30f","2ae94c0cea4d480a9d5dca8fb1d7b542",22859334,8,-38,0,1469,272,242,-30
"0d987bed3ffa4ed0b9a2e62e97b7b30f","bb5a47f5ea01454a8b79455422d3b9da",22859334,8,10,0,1471,272,280,8
"bb5a47f5ea01454a8b79455422d3b9da","82ae07bc0c9b4570a41799290d1ef399",22859334,5,-6,0,1472,280,275,-5
"82ae07bc0c9b4570a41799290d1ef399","bb5a47f5ea01454a8b79455422d3b9da",22859334,5,6,0,1473,275,280,5
"bb5a47f5ea01454a8b79455422d3b9da","bb5a47f5ea01454a8b79455422d3b9da",22859334,108,0,1,1474,280,280,0
"bb5a47f5ea01454a8b79455422d3b9da","bc5524e78a8544e2ae2fdc2f3462bbec",22859334,2,-1,0,1480,280,279,-1
"bc5524e78a8544e2ae2fdc2f3462bbec","82ae07bc0c9b4570a41799290d1ef399",22859334,1,-5,0,1481,279,275,-4
"82ae07bc0c9b4570a41799290d1ef399","78adeee1fa2c4fe0bc73f7bca9fcee86",22859334,1,-156,0,1482,275,160,-115
"78adeee1fa2c4fe0bc73f7bca9fcee86","3cbcea2be0984e7dbd5a48195af10ce7",22859334,3,8,0,1492,160,165,5
"3cbcea2be0984e7dbd5a48195af10ce7","82e6285962b8400d9d6fc32436022a94",22859334,4,2,0,1493,165,167,2
"82e6285962b8400d9d6fc32436022a94","3cbcea2be0984e7dbd5a48195af10ce7",22859334,3,-2,0,1494,167,165,-2
"3cbcea2be0984e7dbd5a48195af10ce7","a9ac840f098c4bd0a2ee896214ce29cd",22859334,2,5,0,1495,165,168,3
"a9ac840f098c4bd0a2ee896214ce29cd","a9ac840f098c4bd0a2ee896214ce29cd",22859334,3,0,1,1496,168,168,0
"a9ac840f098c4bd0a2ee896214ce29cd","0c7262dff33c4087bc660ccf40f92f9c",22859334,2,4,0,1497,168,169,1
"0c7262dff33c4087bc660ccf40f92f9c","b2275c3fad834f8d90737a2d9a6927d6",22859334,2,3,0,1498,169,172,3
"b2275c3fad834f8d90737a2d9a6927d6","0c7262dff33c4087bc660ccf40f92f9c",22859334,2,-3,0,1499,172,169,-3
"0c7262dff33c4087bc660ccf40f92f9c","b42cc17b7de840f181a704558d0bc845",22859334,4,7,0,1500,169,175,6
"b42cc17b7de840f181a704558d0bc845","ea38cc0e6e6e41edbabf210220808bf9",22859334,1,5,0,1501,175,179,4
"ea38cc0e6e6e41edbabf210220808bf9","362fcb0699a14845ab29b2340093e528",22859334,1,-6,0,1502,179,174,-5
"362fcb0699a14845ab29b2340093e528","b87c552dd247427abe6ab5795b9c9d43",22859334,2,8,0,1503,174,181,7
"b87c552dd247427abe6ab5795b9c9d43","139b097acfca451689d80c9c6eebdf7b",22859334,1,-3,0,1504,181,178,-3
"139b097acfca451689d80c9c6eebdf7b","2024b4885bd14338a39b7b509acbbd02",22859334,1,5,0,1505,178,182,4
"2024b4885bd14338a39b7b509acbbd02","0c7262dff33c4087bc660ccf40f92f9c",22859334,1,-16,0,1506,182,169,-13
"0c7262dff33c4087bc660ccf40f92f9c","c8e371568a0c4391b25796ae4e91952e",22859334,3,23,0,1507,169,186,17
"c8e371568a0c4391b25796ae4e91952e","c8e371568a0c4391b25796ae4e91952e",22859334,2,0,1,1508,186,186,0
"c8e371568a0c4391b25796ae4e91952e","ab11d94c6c8948ea90b88f19d2cd502b",22859334,3,5,0,1509,186,190,4
"ab11d94c6c8948ea90b88f19d2cd502b","07b44a7a51e94c78b411c753fc39dab0",22859334,1,-1,0,1510,190,189,-1
"07b44a7a51e94c78b411c753fc39dab0","6cd2dcaac46847d4a0bc53f296d90375",22859334,2,6,0,1511,189,194,5
"6cd2dcaac46847d4a0bc53f296d90375","017d7ca8e0394b91aaadc9574df2202c",22859334,1,-1,0,1512,194,193,-1
"017d7ca8e0394b91aaadc9574df2202c","f9170dd6bc6442b4acd832747609b09a",22859334,1,7,0,1513,193,199,6
"f9170dd6bc6442b4acd832747609b09a","d7f13c8d63ec4e2aa673fbb9cf9c6933",22859334,1,10,0,1514,199,206,7
"d7f13c8d63ec4e2aa673fbb9cf9c6933","c8e371568a0c4391b25796ae4e91952e",22859334,3,-26,0,1515,206,186,-20
"c8e371568a0c4391b25796ae4e91952e","7108f0e4c2584f1f9c471689ae4c885c",22859334,2,28,0,1516,186,208,22
"b9e80f77c3a44349863b19875725c384","d7f13c8d63ec4e2aa673fbb9cf9c6933",22859334,2,-1,0,1518,207,206,-1
"09400e101c5d4b439cf9a26b03aae558","a875096404ef4a9984b62d74cda916f9",22859334,1,-1,0,1520,210,209,-1
"f7fb1952f56b4189b86a9f8b7862d2b8","363837c182e04711840d896ae1e0339c",22859334,1,4,0,1523,215,218,3
"363837c182e04711840d896ae1e0339c","ec341f459285443b8361f7f15638ff08",22859334,1,-6,0,1524,218,213,-5
"ec341f459285443b8361f7f15638ff08","01b2051f8941460d89945e3b02d1ce78",22859334,1,5,0,1525,213,217,4
"01b2051f8941460d89945e3b02d1ce78","1c6721b1f63f4d30ba7746ea8af02a52",22859334,1,7,0,1526,217,221,4
"77ecef8eff6b4a2caea7707669bf7475","1c6721b1f63f4d30ba7746ea8af02a52",22859334,2,-1,0,1529,222,221,-1
"2ab1535aac1346ba8801535bf729ef37","5152833676bf4c6cb317060be10f68db",22859334,1,-1,0,1534,229,228,-1
"5152833676bf4c6cb317060be10f68db","0b04c8e2f86d48c7aeb7e225819cd32b",22859334,1,7,0,1535,228,234,6
"0b04c8e2f86d48c7aeb7e225819cd32b","1c6721b1f63f4d30ba7746ea8af02a52",22859334,1,-16,0,1536,234,221,-13
"2ae94c0cea4d480a9d5dca8fb1d7b542","00f61990949545828dd12f1303d47504",22859334,1,17,0,1540,242,256,14
"00f61990949545828dd12f1303d47504","6e83e23f56544a19b94067c1c558d9c0",22859334,1,-11,0,1541,256,247,-9
"6e83e23f56544a19b94067c1c558d9c0","d546341988904f069cfa86b21457d9d9",22859334,1,5,0,1542,247,251,4
"d989ebcfc12a4b669f0100dc1aa14f1e","7aa76d3e993840d8805f097cbdbcd44b",22859334,1,7,0,1544,255,261,6
"7aa76d3e993840d8805f097cbdbcd44b","2ae94c0cea4d480a9d5dca8fb1d7b542",22859334,1,-23,0,1545,261,242,-19
"0d987bed3ffa4ed0b9a2e62e97b7b30f","0d987bed3ffa4ed0b9a2e62e97b7b30f",22859334,7,0,1,1547,272,272,0
"bb5a47f5ea01454a8b79455422d3b9da","2ae94c0cea4d480a9d5dca8fb1d7b542",22859334,1,-48,0,1564,280,242,-38
"bc5524e78a8544e2ae2fdc2f3462bbec","2ae94c0cea4d480a9d5dca8fb1d7b542",22859334,1,-47,0,1578,279,242,-37
"bb5a47f5ea01454a8b79455422d3b9da","0d987bed3ffa4ed0b9a2e62e97b7b30f",22859334,4,-10,0,1665,280,272,-8
"0d987bed3ffa4ed0b9a2e62e97b7b30f","94cecc3f1e7d484b8e068e79241dfd73",22859334,3,13,0,1666,272,281,9
"a37477c4e4c14169ad44b06b493007f6","2ae94c0cea4d480a9d5dca8fb1d7b542",22859334,1,-53,0,1668,283,242,-41
"a37477c4e4c14169ad44b06b493007f6","94cecc3f1e7d484b8e068e79241dfd73",22859334,2,-2,0,1684,283,281,-2
"94cecc3f1e7d484b8e068e79241dfd73","fab84b4fab5940efb4ea868ef8d09396",22859334,2,5,0,1685,281,284,3
"fab84b4fab5940efb4ea868ef8d09396","4a29443515bb404cb8924e1c60a63b73",22859334,2,4,0,1686,284,285,1
"4a29443515bb404cb8924e1c60a63b73","fab84b4fab5940efb4ea868ef8d09396",22859334,3,-4,0,1687,285,284,-1
"fab84b4fab5940efb4ea868ef8d09396","208c9b2796c944db8dacaa96082520ea",22859334,3,7,0,1688,284,288,4
"208c9b2796c944db8dacaa96082520ea","208c9b2796c944db8dacaa96082520ea",22859334,5,0,1,1689,288,288,0
"208c9b2796c944db8dacaa96082520ea","4a29443515bb404cb8924e1c60a63b73",22859334,2,-3,0,1694,288,285,-3
"4a29443515bb404cb8924e1c60a63b73","7669a956527947d0add87455277e80b4",22859334,1,7,0,1695,285,291,6
"7669a956527947d0add87455277e80b4","7669a956527947d0add87455277e80b4",22859334,1,0,1,1696,291,291,0
"7669a956527947d0add87455277e80b4","6a9a3b5bde4a48daa896fe8c06eca56f",22859334,1,-2,0,1697,291,289,-2
"6a9a3b5bde4a48daa896fe8c06eca56f","869e967078f04da18dd0b0b9389a7424",22859334,1,5,0,1698,289,293,4
"869e967078f04da18dd0b0b9389a7424","869e967078f04da18dd0b0b9389a7424",22859334,2,0,1,1699,293,293,0
"869e967078f04da18dd0b0b9389a7424","51ab6291537748fab90d519aa09889d6",22859334,1,2,0,1701,293,295,2
"51ab6291537748fab90d519aa09889d6","51ab6291537748fab90d519aa09889d6",22859334,5,0,1,1702,295,295,0
"51ab6291537748fab90d519aa09889d6","34a6e49023fc4465bd5ca604330bbd1c",22859334,1,-3,0,1707,295,292,-3
"34a6e49023fc4465bd5ca604330bbd1c","21592f2a9e9c4b2f8c66ec5dbcbf6a2b",22859334,1,5,0,1708,292,296,4
"21592f2a9e9c4b2f8c66ec5dbcbf6a2b","ba0e59461bfb4a44b7b1c28a01f8d3b3",22859334,1,4,0,1709,296,299,3
"ba0e59461bfb4a44b7b1c28a01f8d3b3","4a29443515bb404cb8924e1c60a63b73",22859334,1,-18,0,1710,299,285,-14
"4a29443515bb404cb8924e1c60a63b73","ba0e59461bfb4a44b7b1c28a01f8d3b3",22859334,1,18,0,1711,285,299,14
"ba0e59461bfb4a44b7b1c28a01f8d3b3","ba0e59461bfb4a44b7b1c28a01f8d3b3",22859334,5,0,1,1712,299,299,0
"ba0e59461bfb4a44b7b1c28a01f8d3b3","0e0b36e731a645e7b1b8a88f5031ca38",22859334,1,2,0,1717,299,301,2
"0e0b36e731a645e7b1b8a88f5031ca38","0e0b36e731a645e7b1b8a88f5031ca38",22859334,2,0,1,1718,301,301,0
"0e0b36e731a645e7b1b8a88f5031ca38","a66a144637284c21afc6de17fea4bfb8",22859334,1,1,0,1720,301,302,1
"a66a144637284c21afc6de17fea4bfb8","a66a144637284c21afc6de17fea4bfb8",22859334,2,0,1,1721,302,302,0
"a66a144637284c21afc6de17fea4bfb8","7646a919d7e64fa990bca9b024ff089d",22859334,1,-4,0,1723,302,298,-4
"7646a919d7e64fa990bca9b024ff089d","e390b575229748ea8aac9364efe2bf00",22859334,1,7,0,1724,298,304,6
"e390b575229748ea8aac9364efe2bf00","e390b575229748ea8aac9364efe2bf00",22859334,1,0,1,1725,304,304,0
"e390b575229748ea8aac9364efe2bf00","4a29443515bb404cb8924e1c60a63b73",22859334,1,-24,0,1726,304,285,-19
"4a29443515bb404cb8924e1c60a63b73","3434c10e561d488a914e0f7d71907abd",22859334,2,27,0,1727,285,305,20
"3434c10e561d488a914e0f7d71907abd","53e7e900392747ccad52e711ab0f80d8",22859334,2,2,0,1728,305,307,2
"53e7e900392747ccad52e711ab0f80d8","53e7e900392747ccad52e711ab0f80d8",22859334,2,0,1,1729,307,307,0
"53e7e900392747ccad52e711ab0f80d8","3434c10e561d488a914e0f7d71907abd",22859334,4,-2,0,1731,307,305,-2
"3434c10e561d488a914e0f7d71907abd","130acc2aeb0448fdbb2de63bc5cebe5b",22859334,2,5,0,1732,305,309,4
"130acc2aeb0448fdbb2de63bc5cebe5b","130acc2aeb0448fdbb2de63bc5cebe5b",22859334,2,0,1,1733,309,309,0
"130acc2aeb0448fdbb2de63bc5cebe5b","9c062b3251034ebe90f5054e2a3b5120",22859334,1,2,0,1735,309,311,2
"9c062b3251034ebe90f5054e2a3b5120","9c062b3251034ebe90f5054e2a3b5120",22859334,2,0,1,1736,311,311,0
"9c062b3251034ebe90f5054e2a3b5120","ea859f8207e44537889daeaba13ac2e8",22859334,1,1,0,1738,311,312,1
"ea859f8207e44537889daeaba13ac2e8","ea859f8207e44537889daeaba13ac2e8",22859334,1,0,1,1739,312,312,0
"ea859f8207e44537889daeaba13ac2e8","56d94971a7a94257aa330183a8ebd0ea",22859334,1,1,0,1740,312,313,1
"56d94971a7a94257aa330183a8ebd0ea","56d94971a7a94257aa330183a8ebd0ea",22859334,1,0,1,1741,313,313,0
"56d94971a7a94257aa330183a8ebd0ea","141c0df6cd1946539aadd1c9b7068cd4",22859334,1,-5,0,1742,313,308,-5
"141c0df6cd1946539aadd1c9b7068cd4","13255e63e0aa4abf85e5211bf613d43e",22859334,1,10,0,1743,308,317,9
"13255e63e0aa4abf85e5211bf613d43e","13255e63e0aa4abf85e5211bf613d43e",22859334,3,0,1,1744,317,317,0
"13255e63e0aa4abf85e5211bf613d43e","86c27d40179e419c8e9d150fb6afa5d0",22859334,1,3,0,1747,317,319,2
"86c27d40179e419c8e9d150fb6afa5d0","0c787d16c9504873b1a4d903cec09948",22859334,1,-6,0,1748,319,314,-5
"0c787d16c9504873b1a4d903cec09948","86c27d40179e419c8e9d150fb6afa5d0",22859334,2,6,0,1749,314,319,5
"86c27d40179e419c8e9d150fb6afa5d0","86c27d40179e419c8e9d150fb6afa5d0",22859334,2,0,1,1750,319,319,0
"86c27d40179e419c8e9d150fb6afa5d0","47edbb64109243e6b0f8f64cdef90c6c",22859334,2,8,0,1752,319,326,7
"47edbb64109243e6b0f8f64cdef90c6c","8d7e0b55cf9849cda222a0f2440cec55",22859334,1,-9,0,1753,326,318,-8
"8d7e0b55cf9849cda222a0f2440cec55","24f1363179ad4aaa965484a78471912b",22859334,1,6,0,1754,318,323,5
"24f1363179ad4aaa965484a78471912b","24f1363179ad4aaa965484a78471912b",22859334,2,0,1,1755,323,323,0
"24f1363179ad4aaa965484a78471912b","3628bdce1dd2429ba924d2d4d09448d2",22859334,1,-1,0,1757,323,322,-1
"3628bdce1dd2429ba924d2d4d09448d2","56b3fd1a212a4764be39d979fde3326e",22859334,1,7,0,1758,322,328,6
"56b3fd1a212a4764be39d979fde3326e","56b3fd1a212a4764be39d979fde3326e",22859334,1,0,1,1759,328,328,0
"56b3fd1a212a4764be39d979fde3326e","3434c10e561d488a914e0f7d71907abd",22859334,1,-28,0,1760,328,305,-23
"3434c10e561d488a914e0f7d71907abd","0c4079457ede49e3aeb5e86ed84bdf35",22859334,3,31,0,1761,305,329,24
"0c4079457ede49e3aeb5e86ed84bdf35","38aea304b4fa46e1b29bb72f5cea4c93",22859334,4,2,0,1762,329,331,2
"38aea304b4fa46e1b29bb72f5cea4c93","0c4079457ede49e3aeb5e86ed84bdf35",22859334,4,-2,0,1763,331,329,-2
"38aea304b4fa46e1b29bb72f5cea4c93","38aea304b4fa46e1b29bb72f5cea4c93",22859334,3,0,1,1765,331,331,0
"38aea304b4fa46e1b29bb72f5cea4c93","e36d261332f14e79bb4b467aceaeb9b5",22859334,1,2,0,1768,331,333,2
"e36d261332f14e79bb4b467aceaeb9b5","e36d261332f14e79bb4b467aceaeb9b5",22859334,1,0,1,1769,333,333,0
"e36d261332f14e79bb4b467aceaeb9b5","c7e89b9d04744d2eab742fc24e3ef1ae",22859334,1,1,0,1770,333,334,1
"c7e89b9d04744d2eab742fc24e3ef1ae","c7e89b9d04744d2eab742fc24e3ef1ae",22859334,2,0,1,1771,334,334,0
"c7e89b9d04744d2eab742fc24e3ef1ae","fe49f8054b374a0ea4bb266ed135ff62",22859334,1,1,0,1773,334,335,1
"fe49f8054b374a0ea4bb266ed135ff62","fe49f8054b374a0ea4bb266ed135ff62",22859334,2,0,1,1774,335,335,0
"fe49f8054b374a0ea4bb266ed135ff62","d0a8f74af98642fe8360d22c42e45117",22859334,1,1,0,1776,335,336,1
"d0a8f74af98642fe8360d22c42e45117","d0a8f74af98642fe8360d22c42e45117",22859334,2,0,1,1777,336,336,0
"d0a8f74af98642fe8360d22c42e45117","0c4079457ede49e3aeb5e86ed84bdf35",22859334,1,-7,0,1779,336,329,-7
"0c4079457ede49e3aeb5e86ed84bdf35","a7c6339ca1da4368a18d471f0519f877",22859334,1,11,0,1780,329,339,10
"a7c6339ca1da4368a18d471f0519f877","a7c6339ca1da4368a18d471f0519f877",22859334,1,0,1,1781,339,339,0
"a7c6339ca1da4368a18d471f0519f877","b8b9418ab322418d9db9b40d96af873a",22859334,2,-2,0,1782,339,337,-2
"b8b9418ab322418d9db9b40d96af873a","bbc5139ca9024389a94db3a6f47dcff6",22859334,5,5,0,1783,337,341,4
"bbc5139ca9024389a94db3a6f47dcff6","bbc5139ca9024389a94db3a6f47dcff6",22859334,5,0,1,1784,341,341,0
"bbc5139ca9024389a94db3a6f47dcff6","4ee6ca9019ab4a1ab323f98094a9bd77",22859334,1,2,0,1789,341,343,2
"4ee6ca9019ab4a1ab323f98094a9bd77","4ee6ca9019ab4a1ab323f98094a9bd77",22859334,2,0,1,1790,343,343,0
"4ee6ca9019ab4a1ab323f98094a9bd77","b37947176785476f8b29d49a851366dc",22859334,1,1,0,1792,343,344,1
"b37947176785476f8b29d49a851366dc","b37947176785476f8b29d49a851366dc",22859334,2,0,1,1793,344,344,0
"b37947176785476f8b29d49a851366dc","fcea5b10d5a14a3b9324ffece8f6e1e5",22859334,1,1,0,1795,344,345,1
"fcea5b10d5a14a3b9324ffece8f6e1e5","fcea5b10d5a14a3b9324ffece8f6e1e5",22859334,8,0,1,1796,345,345,0
"fcea5b10d5a14a3b9324ffece8f6e1e5","c2490bc612d146edbe786556fab3651b",22859334,1,-5,0,1804,345,340,-5
"c2490bc612d146edbe786556fab3651b","6ac8bb048b854999a47edb35fe627f11",22859334,1,8,0,1805,340,347,7
"6ac8bb048b854999a47edb35fe627f11","6ac8bb048b854999a47edb35fe627f11",22859334,1,0,1,1806,347,347,0
"6ac8bb048b854999a47edb35fe627f11","30ead9794d4847abaf222ca966cc8630",22859334,1,3,0,1807,347,348,1
"30ead9794d4847abaf222ca966cc8630","0c4079457ede49e3aeb5e86ed84bdf35",22859334,3,-24,0,1808,348,329,-19
"0c4079457ede49e3aeb5e86ed84bdf35","897b7f51242c44aab2205c72fdcbf4cd",22859334,1,28,0,1809,329,352,23
"897b7f51242c44aab2205c72fdcbf4cd","c20993c944444fe085345591a8bd837e",22859334,5,-1,0,1810,352,351,-1
"c20993c944444fe085345591a8bd837e","eff0de7f2dbb42dfa1a2e686efab5b6d",22859334,4,3,0,1811,351,354,3
"eff0de7f2dbb42dfa1a2e686efab5b6d","09b9678ddc3d452ea4a3d46e15826065",22859334,4,-1,0,1812,354,353,-1
"09b9678ddc3d452ea4a3d46e15826065","30ead9794d4847abaf222ca966cc8630",22859334,1,-5,0,1813,353,348,-5
"0c4079457ede49e3aeb5e86ed84bdf35","4a92daef4d504e1792575a26502bb7b7",22859334,1,20,0,1815,329,346,17
"4a92daef4d504e1792575a26502bb7b7","a7c6339ca1da4368a18d471f0519f877",22859334,1,-9,0,1816,346,339,-7
"bbc5139ca9024389a94db3a6f47dcff6","c2490bc612d146edbe786556fab3651b",22859334,4,-1,0,1819,341,340,-1
"c2490bc612d146edbe786556fab3651b","b8b9418ab322418d9db9b40d96af873a",22859334,1,-4,0,1820,340,337,-3
"c2490bc612d146edbe786556fab3651b","0c4079457ede49e3aeb5e86ed84bdf35",22859334,2,-13,0,1823,340,329,-11
"0c4079457ede49e3aeb5e86ed84bdf35","30ead9794d4847abaf222ca966cc8630",22859334,3,24,0,1824,329,348,19
"30ead9794d4847abaf222ca966cc8630","c20993c944444fe085345591a8bd837e",22859334,2,3,0,1825,348,351,3
"09b9678ddc3d452ea4a3d46e15826065","897b7f51242c44aab2205c72fdcbf4cd",22859334,4,-1,0,1828,353,352,-1
"c20993c944444fe085345591a8bd837e","c20993c944444fe085345591a8bd837e",22859334,9,0,1,1830,351,351,0
"c20993c944444fe085345591a8bd837e","897b7f51242c44aab2205c72fdcbf4cd",22859334,2,1,0,1833,351,352,1
"897b7f51242c44aab2205c72fdcbf4cd","897b7f51242c44aab2205c72fdcbf4cd",22859334,8,0,1,1834,352,352,0
"897b7f51242c44aab2205c72fdcbf4cd","09b9678ddc3d452ea4a3d46e15826065",22859334,2,1,0,1837,352,353,1
"09b9678ddc3d452ea4a3d46e15826065","09b9678ddc3d452ea4a3d46e15826065",22859334,7,0,1,1838,353,353,0
"09b9678ddc3d452ea4a3d46e15826065","eff0de7f2dbb42dfa1a2e686efab5b6d",22859334,3,1,0,1841,353,354,1
"eff0de7f2dbb42dfa1a2e686efab5b6d","eff0de7f2dbb42dfa1a2e686efab5b6d",22859334,9,0,1,1842,354,354,0
"eff0de7f2dbb42dfa1a2e686efab5b6d","30ead9794d4847abaf222ca966cc8630",22859334,2,-6,0,1845,354,348,-6
"30ead9794d4847abaf222ca966cc8630","2fe14166dc9642c3bc666b86a57f943d",22859334,5,10,0,1846,348,357,9
"2fe14166dc9642c3bc666b86a57f943d","2fe14166dc9642c3bc666b86a57f943d",22859334,7,0,1,1847,357,357,0
"2fe14166dc9642c3bc666b86a57f943d","44421dd1e13a47a388c4a19834b744c7",22859334,2,2,0,1850,357,359,2
"44421dd1e13a47a388c4a19834b744c7","44421dd1e13a47a388c4a19834b744c7",22859334,7,0,1,1851,359,359,0
"44421dd1e13a47a388c4a19834b744c7","cb5fc7ef85d547c4be1a7439d0bf6052",22859334,2,1,0,1853,359,360,1
"cb5fc7ef85d547c4be1a7439d0bf6052","cb5fc7ef85d547c4be1a7439d0bf6052",22859334,4,0,1,1854,360,360,0
"cb5fc7ef85d547c4be1a7439d0bf6052","0a8f150a4cf747acbde62f4721823da3",22859334,2,1,0,1856,360,361,1
"0a8f150a4cf747acbde62f4721823da3","0a8f150a4cf747acbde62f4721823da3",22859334,4,0,1,1857,361,361,0
"0a8f150a4cf747acbde62f4721823da3","ab8fdad974ae471f9f24c3f9dd04462e",22859334,2,1,0,1859,361,362,1
"ab8fdad974ae471f9f24c3f9dd04462e","ab8fdad974ae471f9f24c3f9dd04462e",22859334,4,0,1,1860,362,362,0
"ab8fdad974ae471f9f24c3f9dd04462e","1ba8fef685d74a8194b9db252eb704fb",22859334,2,-7,0,1862,362,355,-7
"1ba8fef685d74a8194b9db252eb704fb","52580888dadb4fe3baa795683ea227bd",22859334,5,10,0,1863,355,364,9
"52580888dadb4fe3baa795683ea227bd","52580888dadb4fe3baa795683ea227bd",22859334,7,0,1,1864,364,364,0
"52580888dadb4fe3baa795683ea227bd","492a3bc6a1254f23a7998587961b22a4",22859334,1,3,0,1868,364,366,2
"492a3bc6a1254f23a7998587961b22a4","f00179e251a045b39c3f7a54f9aa4acc",22859334,1,-4,0,1869,366,363,-3
"f00179e251a045b39c3f7a54f9aa4acc","4a29443515bb404cb8924e1c60a63b73",22859334,1,-99,0,1870,363,285,-78
"4a29443515bb404cb8924e1c60a63b73","30ead9794d4847abaf222ca966cc8630",22859334,1,82,0,1871,285,348,63
"30ead9794d4847abaf222ca966cc8630","f00179e251a045b39c3f7a54f9aa4acc",22859334,1,17,0,1872,348,363,15
"f00179e251a045b39c3f7a54f9aa4acc","52580888dadb4fe3baa795683ea227bd",22859334,1,1,0,1873,363,364,1
"52580888dadb4fe3baa795683ea227bd","f00179e251a045b39c3f7a54f9aa4acc",22859334,2,-1,0,1877,364,363,-1
"f00179e251a045b39c3f7a54f9aa4acc","492a3bc6a1254f23a7998587961b22a4",22859334,4,4,0,1878,363,366,3
"492a3bc6a1254f23a7998587961b22a4","492a3bc6a1254f23a7998587961b22a4",22859334,2,0,1,1879,366,366,0
"492a3bc6a1254f23a7998587961b22a4","072a190fd302456290895f9f04d6940a",22859334,3,-1,0,1881,366,365,-1
"072a190fd302456290895f9f04d6940a","52580888dadb4fe3baa795683ea227bd",22859334,1,-2,0,1882,365,364,-1
"52580888dadb4fe3baa795683ea227bd","c76574d21bc14aeea7ecd0b027f39858",22859334,2,5,0,1883,364,367,3
"c76574d21bc14aeea7ecd0b027f39858","2fe14166dc9642c3bc666b86a57f943d",22859334,1,-13,0,1884,367,357,-10
"2fe14166dc9642c3bc666b86a57f943d","f00179e251a045b39c3f7a54f9aa4acc",22859334,2,7,0,1885,357,363,6
"f00179e251a045b39c3f7a54f9aa4acc","2fe14166dc9642c3bc666b86a57f943d",22859334,2,-7,0,1886,363,357,-6
"2fe14166dc9642c3bc666b86a57f943d","1ba8fef685d74a8194b9db252eb704fb",22859334,4,-2,0,1891,357,355,-2
"c76574d21bc14aeea7ecd0b027f39858","09b9678ddc3d452ea4a3d46e15826065",22859334,1,-18,0,1894,367,353,-14
"09b9678ddc3d452ea4a3d46e15826065","f00179e251a045b39c3f7a54f9aa4acc",22859334,1,12,0,1895,353,363,10
"f00179e251a045b39c3f7a54f9aa4acc","897b7f51242c44aab2205c72fdcbf4cd",22859334,1,-13,0,1896,363,352,-11
"897b7f51242c44aab2205c72fdcbf4cd","2fe14166dc9642c3bc666b86a57f943d",22859334,1,6,0,1907,352,357,5
"2fe14166dc9642c3bc666b86a57f943d","30ead9794d4847abaf222ca966cc8630",22859334,2,-10,0,1908,357,348,-9
"1ba8fef685d74a8194b9db252eb704fb","cfa457d1743848e4bb5e4beced6448ed",22859334,1,17,0,1911,355,369,14
"cfa457d1743848e4bb5e4beced6448ed","cfa457d1743848e4bb5e4beced6448ed",22859334,1,0,1,1912,369,369,0
"cfa457d1743848e4bb5e4beced6448ed","b71bac264efb4abd97015447bd490db6",22859334,1,3,0,1913,369,370,1
"b71bac264efb4abd97015447bd490db6","30ead9794d4847abaf222ca966cc8630",22859334,3,-28,0,1914,370,348,-22
"30ead9794d4847abaf222ca966cc8630","4a29443515bb404cb8924e1c60a63b73",22859334,1,-82,0,1915,348,285,-63
"4a29443515bb404cb8924e1c60a63b73","0d987bed3ffa4ed0b9a2e62e97b7b30f",22859334,1,-22,0,1916,285,272,-13
"208c9b2796c944db8dacaa96082520ea","869e967078f04da18dd0b0b9389a7424",22859334,1,7,0,1935,288,293,5
"869e967078f04da18dd0b0b9389a7424","4a29443515bb404cb8924e1c60a63b73",22859334,1,-10,0,1936,293,285,-8
"4a29443515bb404cb8924e1c60a63b73","34a6e49023fc4465bd5ca604330bbd1c",22859334,1,9,0,1937,285,292,7
"34a6e49023fc4465bd5ca604330bbd1c","ba0e59461bfb4a44b7b1c28a01f8d3b3",22859334,1,9,0,1938,292,299,7
"ba0e59461bfb4a44b7b1c28a01f8d3b3","21592f2a9e9c4b2f8c66ec5dbcbf6a2b",22859334,1,-4,0,1939,299,296,-3
"21592f2a9e9c4b2f8c66ec5dbcbf6a2b","7646a919d7e64fa990bca9b024ff089d",22859334,1,3,0,1940,296,298,2
"7646a919d7e64fa990bca9b024ff089d","3434c10e561d488a914e0f7d71907abd",22859334,1,10,0,1941,298,305,7
"3434c10e561d488a914e0f7d71907abd","4a29443515bb404cb8924e1c60a63b73",22859334,2,-27,0,1942,305,285,-20
"4a29443515bb404cb8924e1c60a63b73","53e7e900392747ccad52e711ab0f80d8",22859334,2,29,0,1943,285,307,22
"130acc2aeb0448fdbb2de63bc5cebe5b","141c0df6cd1946539aadd1c9b7068cd4",22859334,1,-1,0,1946,309,308,-1
"141c0df6cd1946539aadd1c9b7068cd4","0c787d16c9504873b1a4d903cec09948",22859334,1,7,0,1947,308,314,6
"47edbb64109243e6b0f8f64cdef90c6c","24f1363179ad4aaa965484a78471912b",22859334,1,-3,0,1950,326,323,-3
"24f1363179ad4aaa965484a78471912b","8d7e0b55cf9849cda222a0f2440cec55",22859334,1,-6,0,1951,323,318,-5
"8d7e0b55cf9849cda222a0f2440cec55","3628bdce1dd2429ba924d2d4d09448d2",22859334,1,5,0,1952,318,322,4
"3628bdce1dd2429ba924d2d4d09448d2","0c4079457ede49e3aeb5e86ed84bdf35",22859334,1,10,0,1953,322,329,7
"0c4079457ede49e3aeb5e86ed84bdf35","3434c10e561d488a914e0f7d71907abd",22859334,1,-31,0,1954,329,305,-24
"3434c10e561d488a914e0f7d71907abd","38aea304b4fa46e1b29bb72f5cea4c93",22859334,1,33,0,1955,305,331,26
"0c4079457ede49e3aeb5e86ed84bdf35","b8b9418ab322418d9db9b40d96af873a",22859334,2,9,0,1957,329,337,8
"c2490bc612d146edbe786556fab3651b","30ead9794d4847abaf222ca966cc8630",22859334,1,11,0,1960,340,348,8
"0c4079457ede49e3aeb5e86ed84bdf35","09b9678ddc3d452ea4a3d46e15826065",22859334,1,29,0,1962,329,353,24
"897b7f51242c44aab2205c72fdcbf4cd","eff0de7f2dbb42dfa1a2e686efab5b6d",22859334,2,2,0,1966,352,354,2
"eff0de7f2dbb42dfa1a2e686efab5b6d","c20993c944444fe085345591a8bd837e",22859334,1,-3,0,1969,354,351,-3
"c20993c944444fe085345591a8bd837e","09b9678ddc3d452ea4a3d46e15826065",22859334,2,2,0,1972,351,353,2
"09b9678ddc3d452ea4a3d46e15826065","2fe14166dc9642c3bc666b86a57f943d",22859334,1,5,0,1974,353,357,4
"30ead9794d4847abaf222ca966cc8630","1ba8fef685d74a8194b9db252eb704fb",22859334,1,8,0,1976,348,355,7
"1ba8fef685d74a8194b9db252eb704fb","f00179e251a045b39c3f7a54f9aa4acc",22859334,3,9,0,1977,355,363,8
"492a3bc6a1254f23a7998587961b22a4","52580888dadb4fe3baa795683ea227bd",22859334,1,-3,0,1979,366,364,-2
"52580888dadb4fe3baa795683ea227bd","072a190fd302456290895f9f04d6940a",22859334,1,2,0,1980,364,365,1
"072a190fd302456290895f9f04d6940a","30ead9794d4847abaf222ca966cc8630",22859334,1,-20,0,1981,365,348,-17
"30ead9794d4847abaf222ca966cc8630","b71bac264efb4abd97015447bd490db6",22859334,3,28,0,1982,348,370,22
"b71bac264efb4abd97015447bd490db6","3434c10e561d488a914e0f7d71907abd",22859334,1,-83,0,1983,370,305,-65
"3434c10e561d488a914e0f7d71907abd","3434c10e561d488a914e0f7d71907abd",22859334,2,0,1,1986,305,305,0
"30ead9794d4847abaf222ca966cc8630","30ead9794d4847abaf222ca966cc8630",22859334,1,0,1,2008,348,348,0
"b71bac264efb4abd97015447bd490db6","8d448d625b024c82a5eb240bbd7431d6",22859334,5,5,0,2010,370,374,4
"8d448d625b024c82a5eb240bbd7431d6","8d448d625b024c82a5eb240bbd7431d6",22859334,80,0,1,2011,374,374,0
"8d448d625b024c82a5eb240bbd7431d6","b71bac264efb4abd97015447bd490db6",22859334,7,-5,0,2018,374,370,-4
"b71bac264efb4abd97015447bd490db6","d6d02b6ef04e4f17805504500b8ce441",22859334,5,8,0,2074,370,375,5
"d6d02b6ef04e4f17805504500b8ce441","d6d02b6ef04e4f17805504500b8ce441",22859334,10,0,1,2075,375,375,0
"d6d02b6ef04e4f17805504500b8ce441","b71bac264efb4abd97015447bd490db6",22859334,1,-8,0,2076,375,370,-5
"d6d02b6ef04e4f17805504500b8ce441","8d448d625b024c82a5eb240bbd7431d6",22859334,1,-3,0,2078,375,374,-1
"d6d02b6ef04e4f17805504500b8ce441","66baf19b6b904b70922329068c63746d",22859334,3,4,0,2090,375,376,1
"66baf19b6b904b70922329068c63746d","7f544639412e40a9ba27f43b415362ab",22859334,3,2,0,2091,376,378,2
"7f544639412e40a9ba27f43b415362ab","7f544639412e40a9ba27f43b415362ab",22859334,3,0,1,2092,378,378,0
"7f544639412e40a9ba27f43b415362ab","d5ae8642e15b46b8bd298b02274d4e9c",22859334,1,2,0,2095,378,380,2
"d5ae8642e15b46b8bd298b02274d4e9c","d5ae8642e15b46b8bd298b02274d4e9c",22859334,1,0,1,2096,380,380,0
"d5ae8642e15b46b8bd298b02274d4e9c","a0d10309a2dd456289147f84be9d37f9",22859334,1,1,0,2097,380,381,1
"a0d10309a2dd456289147f84be9d37f9","a0d10309a2dd456289147f84be9d37f9",22859334,2,0,1,2098,381,381,0
"a0d10309a2dd456289147f84be9d37f9","0fcbc3ca07b144138b8d85da581f09a8",22859334,1,1,0,2100,381,382,1
"0fcbc3ca07b144138b8d85da581f09a8","0fcbc3ca07b144138b8d85da581f09a8",22859334,2,0,1,2101,382,382,0
"0fcbc3ca07b144138b8d85da581f09a8","66baf19b6b904b70922329068c63746d",22859334,1,-6,0,2103,382,376,-6
"66baf19b6b904b70922329068c63746d","c2fca3669923477ab966ded303dea31c",22859334,1,8,0,2104,376,383,7
"c2fca3669923477ab966ded303dea31c","4890121ce5d74576b4632b77cfc23398",22859334,1,6,0,2105,383,388,5
"4890121ce5d74576b4632b77cfc23398","4890121ce5d74576b4632b77cfc23398",22859334,2,0,1,2106,388,388,0
"4890121ce5d74576b4632b77cfc23398","96bb2b3e85a34d8b9544514e89f6fe97",22859334,1,3,0,2108,388,390,2
"96bb2b3e85a34d8b9544514e89f6fe97","18d3b836dd804224883cc9180b60a8e1",22859334,1,-4,0,2109,390,387,-3
"18d3b836dd804224883cc9180b60a8e1","96bb2b3e85a34d8b9544514e89f6fe97",22859334,2,4,0,2110,387,390,3
"96bb2b3e85a34d8b9544514e89f6fe97","96bb2b3e85a34d8b9544514e89f6fe97",22859334,1,0,1,2111,390,390,0
"96bb2b3e85a34d8b9544514e89f6fe97","ac4e9b54acfe4670b4634859c7263cb5",22859334,1,2,0,2112,390,392,2
"ac4e9b54acfe4670b4634859c7263cb5","ac4e9b54acfe4670b4634859c7263cb5",22859334,1,0,1,2113,392,392,0
"ac4e9b54acfe4670b4634859c7263cb5","6f8881a745ac4c358a68b92c3b4abe81",22859334,1,3,0,2114,392,394,2
"6f8881a745ac4c358a68b92c3b4abe81","17f95d18bab743888e1736033dc3384d",22859334,1,-6,0,2115,394,389,-5
"17f95d18bab743888e1736033dc3384d","6f8881a745ac4c358a68b92c3b4abe81",22859334,2,6,0,2116,389,394,5
"6f8881a745ac4c358a68b92c3b4abe81","6f8881a745ac4c358a68b92c3b4abe81",22859334,2,0,1,2117,394,394,0
"6f8881a745ac4c358a68b92c3b4abe81","f7002c8484354eceac57bc7bd62c76c1",22859334,4,-1,0,2118,394,393,-1
"f7002c8484354eceac57bc7bd62c76c1","44a277ea44dc4ae689fab4b82f0b4098",22859334,1,5,0,2119,393,397,4
"44a277ea44dc4ae689fab4b82f0b4098","44a277ea44dc4ae689fab4b82f0b4098",22859334,1,0,1,2120,397,397,0
"44a277ea44dc4ae689fab4b82f0b4098","0c12af0a4e7f4002852cf84b2537c161",22859334,1,-2,0,2121,397,395,-2
"0c12af0a4e7f4002852cf84b2537c161","859e0b8d71694b12befb69ee698138f9",22859334,1,5,0,2122,395,399,4
"859e0b8d71694b12befb69ee698138f9","859e0b8d71694b12befb69ee698138f9",22859334,1,0,1,2123,399,399,0
"859e0b8d71694b12befb69ee698138f9","2b09a08242b54983aec7063990fb3f66",22859334,1,3,0,2124,399,400,1
"2b09a08242b54983aec7063990fb3f66","66baf19b6b904b70922329068c63746d",22859334,5,-32,0,2125,400,376,-24
"66baf19b6b904b70922329068c63746d","2b09a08242b54983aec7063990fb3f66",22859334,8,32,0,2126,376,400,24
"66baf19b6b904b70922329068c63746d","66baf19b6b904b70922329068c63746d",22859334,3,0,1,2128,376,376,0
"66baf19b6b904b70922329068c63746d","f7002c8484354eceac57bc7bd62c76c1",22859334,1,21,0,2129,376,393,17
"f7002c8484354eceac57bc7bd62c76c1","6f8881a745ac4c358a68b92c3b4abe81",22859334,2,1,0,2130,393,394,1
"f7002c8484354eceac57bc7bd62c76c1","0c12af0a4e7f4002852cf84b2537c161",22859334,2,3,0,2133,393,395,2
"0c12af0a4e7f4002852cf84b2537c161","6f8881a745ac4c358a68b92c3b4abe81",22859334,1,-2,0,2134,395,394,-1
"f7002c8484354eceac57bc7bd62c76c1","f7002c8484354eceac57bc7bd62c76c1",22859334,2,0,1,2136,393,393,0
"0c12af0a4e7f4002852cf84b2537c161","66baf19b6b904b70922329068c63746d",22859334,1,-24,0,2141,395,376,-19
"2b09a08242b54983aec7063990fb3f66","2b09a08242b54983aec7063990fb3f66",22859334,10,0,1,2143,400,400,0
"66baf19b6b904b70922329068c63746d","1ba8fef685d74a8194b9db252eb704fb",22859334,1,-32,0,2145,376,355,-21
"1ba8fef685d74a8194b9db252eb704fb","30ead9794d4847abaf222ca966cc8630",22859334,2,-8,0,2146,355,348,-7
"2fe14166dc9642c3bc666b86a57f943d","52580888dadb4fe3baa795683ea227bd",22859334,1,8,0,2148,357,364,7
"52580888dadb4fe3baa795683ea227bd","1ba8fef685d74a8194b9db252eb704fb",22859334,2,-10,0,2149,364,355,-9
"1ba8fef685d74a8194b9db252eb704fb","1ba8fef685d74a8194b9db252eb704fb",22859334,1,0,1,2153,355,355,0
"072a190fd302456290895f9f04d6940a","b71bac264efb4abd97015447bd490db6",22859334,2,8,0,2159,365,370,5
"7f544639412e40a9ba27f43b415362ab","66baf19b6b904b70922329068c63746d",22859334,2,-2,0,2178,378,376,-2
"66baf19b6b904b70922329068c63746d","18d3b836dd804224883cc9180b60a8e1",22859334,1,13,0,2179,376,387,11
"96bb2b3e85a34d8b9544514e89f6fe97","4890121ce5d74576b4632b77cfc23398",22859334,1,-3,0,2181,390,388,-2
"4890121ce5d74576b4632b77cfc23398","c2fca3669923477ab966ded303dea31c",22859334,1,-6,0,2182,388,383,-5
"c2fca3669923477ab966ded303dea31c","17f95d18bab743888e1736033dc3384d",22859334,1,8,0,2183,383,389,6
"6f8881a745ac4c358a68b92c3b4abe81","0c12af0a4e7f4002852cf84b2537c161",22859334,1,2,0,2185,394,395,1
"0c12af0a4e7f4002852cf84b2537c161","f7002c8484354eceac57bc7bd62c76c1",22859334,1,-3,0,2186,395,393,-2
"f7002c8484354eceac57bc7bd62c76c1","66baf19b6b904b70922329068c63746d",22859334,1,-21,0,2187,393,376,-17
"2b09a08242b54983aec7063990fb3f66","1f471b7a883a4df48211e8c6a81b59a7",22859334,1,1,0,2200,400,401,1
"1f471b7a883a4df48211e8c6a81b59a7","1f471b7a883a4df48211e8c6a81b59a7",22859334,1,0,1,2201,401,401,0
"1f471b7a883a4df48211e8c6a81b59a7","2b09a08242b54983aec7063990fb3f66",22859334,1,-1,0,2202,401,400,-1
"2b09a08242b54983aec7063990fb3f66","9de0d567bfa84fe5b77cb76f4a76a5d1",22859334,1,5,0,2203,400,404,4
"9de0d567bfa84fe5b77cb76f4a76a5d1","9de0d567bfa84fe5b77cb76f4a76a5d1",22859334,3,0,1,2204,404,404,0
"9de0d567bfa84fe5b77cb76f4a76a5d1","1157bd665ec4472fb58b751dc5099355",22859334,2,-1,0,2205,404,403,-1
"1157bd665ec4472fb58b751dc5099355","3c8a22d2f9c146ea956609e3ed4f2559",22859334,2,3,0,2206,403,405,2
"3c8a22d2f9c146ea956609e3ed4f2559","58fc9094275e4c49be3f4ba6d4acc0a4",22859334,2,2,0,2207,405,406,1
"58fc9094275e4c49be3f4ba6d4acc0a4","58fc9094275e4c49be3f4ba6d4acc0a4",22859334,4,0,1,2208,406,406,0
"58fc9094275e4c49be3f4ba6d4acc0a4","c1c1be90b2b14c1ab4a5e1ee3c241902",22859334,1,1,0,2210,406,407,1
"c1c1be90b2b14c1ab4a5e1ee3c241902","c1c1be90b2b14c1ab4a5e1ee3c241902",22859334,5,0,1,2211,407,407,0
"c1c1be90b2b14c1ab4a5e1ee3c241902","58fc9094275e4c49be3f4ba6d4acc0a4",22859334,1,-1,0,2216,407,406,-1
"58fc9094275e4c49be3f4ba6d4acc0a4","02b3a1bead9244c1ba2f857c7da8f82a",22859334,2,3,0,2217,406,408,2
"02b3a1bead9244c1ba2f857c7da8f82a","02b3a1bead9244c1ba2f857c7da8f82a",22859334,6,0,1,2218,408,408,0
"02b3a1bead9244c1ba2f857c7da8f82a","6206fc6479014bb193084c32409dc1b9",22859334,2,1,0,2220,408,409,1
"6206fc6479014bb193084c32409dc1b9","6206fc6479014bb193084c32409dc1b9",22859334,3,0,1,2221,409,409,0
"6206fc6479014bb193084c32409dc1b9","6a5f020451db426dacba9e2ea3fcc62a",22859334,1,2,0,2222,409,410,1
"6a5f020451db426dacba9e2ea3fcc62a","02b3a1bead9244c1ba2f857c7da8f82a",22859334,2,-3,0,2223,410,408,-2
"02b3a1bead9244c1ba2f857c7da8f82a","6a5f020451db426dacba9e2ea3fcc62a",22859334,4,3,0,2224,408,410,2
"6a5f020451db426dacba9e2ea3fcc62a","6a5f020451db426dacba9e2ea3fcc62a",22859334,4,0,1,2225,410,410,0
"6a5f020451db426dacba9e2ea3fcc62a","33a9d248b2e44588a5b07fc1342b9bc2",22859334,5,2,0,2227,410,411,1
"33a9d248b2e44588a5b07fc1342b9bc2","33a9d248b2e44588a5b07fc1342b9bc2",22859334,2,0,1,2228,411,411,0
"33a9d248b2e44588a5b07fc1342b9bc2","c6f26bd420634f1cb7989e76fe6b16c0",22859334,1,1,0,2229,411,412,1
"c6f26bd420634f1cb7989e76fe6b16c0","c6f26bd420634f1cb7989e76fe6b16c0",22859334,5,0,1,2230,412,412,0
"c6f26bd420634f1cb7989e76fe6b16c0","2a65ee6e2ac64f6a8a55fbe5373ec763",22859334,1,1,0,2235,412,413,1
"2a65ee6e2ac64f6a8a55fbe5373ec763","2a65ee6e2ac64f6a8a55fbe5373ec763",22859334,2,0,1,2236,413,413,0
"2a65ee6e2ac64f6a8a55fbe5373ec763","33a9d248b2e44588a5b07fc1342b9bc2",22859334,1,-2,0,2238,413,411,-2
"33a9d248b2e44588a5b07fc1342b9bc2","66baf19b6b904b70922329068c63746d",22859334,1,-49,0,2239,411,376,-35
"66baf19b6b904b70922329068c63746d","687055dad9fc40c3982478fe33ec01bf",22859334,1,53,0,2240,376,414,38
"687055dad9fc40c3982478fe33ec01bf","2b09a08242b54983aec7063990fb3f66",22859334,3,-21,0,2241,414,400,-14
"2b09a08242b54983aec7063990fb3f66","1fd0f6dadbc14ebc965faf6122190b96",22859334,1,22,0,2242,400,415,15
"1fd0f6dadbc14ebc965faf6122190b96","1fd0f6dadbc14ebc965faf6122190b96",22859334,1,0,1,2243,415,415,0
"1fd0f6dadbc14ebc965faf6122190b96","687055dad9fc40c3982478fe33ec01bf",22859334,1,-1,0,2244,415,414,-1
"687055dad9fc40c3982478fe33ec01bf","2add1669f08d4101913db15f8c23b3b7",22859334,1,3,0,2245,414,416,2
"2add1669f08d4101913db15f8c23b3b7","2add1669f08d4101913db15f8c23b3b7",22859334,1,0,1,2246,416,416,0
"2add1669f08d4101913db15f8c23b3b7","2b09a08242b54983aec7063990fb3f66",22859334,1,-24,0,2247,416,400,-16
"2b09a08242b54983aec7063990fb3f66","a2b4bd40cee2481ebd3fc179d6a5cd62",22859334,7,27,0,2248,400,417,17
"a2b4bd40cee2481ebd3fc179d6a5cd62","66baf19b6b904b70922329068c63746d",22859334,1,-59,0,2249,417,376,-41
"2b09a08242b54983aec7063990fb3f66","02b3a1bead9244c1ba2f857c7da8f82a",22859334,2,12,0,2251,400,408,8
"6206fc6479014bb193084c32409dc1b9","02b3a1bead9244c1ba2f857c7da8f82a",22859334,1,-1,0,2256,409,408,-1
"6a5f020451db426dacba9e2ea3fcc62a","9de0d567bfa84fe5b77cb76f4a76a5d1",22859334,1,-10,0,2259,410,404,-6
"1157bd665ec4472fb58b751dc5099355","58fc9094275e4c49be3f4ba6d4acc0a4",22859334,1,5,0,2263,403,406,3
"58fc9094275e4c49be3f4ba6d4acc0a4","3c8a22d2f9c146ea956609e3ed4f2559",22859334,2,-2,0,2264,406,405,-1
"3c8a22d2f9c146ea956609e3ed4f2559","66baf19b6b904b70922329068c63746d",22859334,1,-39,0,2265,405,376,-29
"33a9d248b2e44588a5b07fc1342b9bc2","687055dad9fc40c3982478fe33ec01bf",22859334,2,4,0,2273,411,414,3
"a2b4bd40cee2481ebd3fc179d6a5cd62","2b09a08242b54983aec7063990fb3f66",22859334,4,-27,0,2276,417,400,-17
"a2b4bd40cee2481ebd3fc179d6a5cd62","a2b4bd40cee2481ebd3fc179d6a5cd62",22859334,2,0,1,2280,417,417,0
"2b09a08242b54983aec7063990fb3f66","2add1669f08d4101913db15f8c23b3b7",22859334,1,24,0,2282,400,416,16
"2add1669f08d4101913db15f8c23b3b7","687055dad9fc40c3982478fe33ec01bf",22859334,1,-3,0,2283,416,414,-2
"687055dad9fc40c3982478fe33ec01bf","33a9d248b2e44588a5b07fc1342b9bc2",22859334,1,-4,0,2284,414,411,-3
"33a9d248b2e44588a5b07fc1342b9bc2","6a5f020451db426dacba9e2ea3fcc62a",22859334,3,-2,0,2285,411,410,-1
"02b3a1bead9244c1ba2f857c7da8f82a","58fc9094275e4c49be3f4ba6d4acc0a4",22859334,1,-3,0,2290,408,406,-2
"3c8a22d2f9c146ea956609e3ed4f2559","a2b4bd40cee2481ebd3fc179d6a5cd62",22859334,1,20,0,2293,405,417,12
"a2b4bd40cee2481ebd3fc179d6a5cd62","e34e59dce2204f228f3a84b6725df60f",22859334,1,2,0,2296,417,419,2
"e34e59dce2204f228f3a84b6725df60f","e34e59dce2204f228f3a84b6725df60f",22859334,1,0,1,2297,419,419,0
"e34e59dce2204f228f3a84b6725df60f","a2b4bd40cee2481ebd3fc179d6a5cd62",22859334,1,-2,0,2298,419,417,-2
"a2b4bd40cee2481ebd3fc179d6a5cd62","bec48fc2e1294c7eb3d0aca780d731b8",22859334,5,4,0,2299,417,420,3
"bec48fc2e1294c7eb3d0aca780d731b8","66baf19b6b904b70922329068c63746d",22859334,1,-63,0,2300,420,376,-44
"66baf19b6b904b70922329068c63746d","a2b4bd40cee2481ebd3fc179d6a5cd62",22859334,1,59,0,2301,376,417,41
"bec48fc2e1294c7eb3d0aca780d731b8","bec48fc2e1294c7eb3d0aca780d731b8",22859334,7,0,1,2303,420,420,0
"bec48fc2e1294c7eb3d0aca780d731b8","dbde19fcce2a4c1abdc7f685c293a23f",22859334,2,3,0,2308,420,422,2
"dbde19fcce2a4c1abdc7f685c293a23f","bec48fc2e1294c7eb3d0aca780d731b8",22859334,1,-3,0,2309,422,420,-2
"dbde19fcce2a4c1abdc7f685c293a23f","a24600b0e49245f6bdba8c893cfeddb0",22859334,2,4,0,2312,422,425,3
"a24600b0e49245f6bdba8c893cfeddb0","a24600b0e49245f6bdba8c893cfeddb0",22859334,5,0,1,2313,425,425,0
"a24600b0e49245f6bdba8c893cfeddb0","24cf8786024543f19b89bc20034e60d7",22859334,2,7,0,2317,425,428,3
"24cf8786024543f19b89bc20034e60d7","a2b4bd40cee2481ebd3fc179d6a5cd62",22859334,2,-18,0,2318,428,417,-11
"a2b4bd40cee2481ebd3fc179d6a5cd62","f2a73be2f46840b182d7bd095378004e",22859334,2,19,0,2319,417,429,12
"f2a73be2f46840b182d7bd095378004e","66baf19b6b904b70922329068c63746d",22859334,2,-78,0,2320,429,376,-53
"66baf19b6b904b70922329068c63746d","24cf8786024543f19b89bc20034e60d7",22859334,1,77,0,2321,376,428,52
"24cf8786024543f19b89bc20034e60d7","f2a73be2f46840b182d7bd095378004e",22859334,4,1,0,2322,428,429,1
"f2a73be2f46840b182d7bd095378004e","24cf8786024543f19b89bc20034e60d7",22859334,2,-1,0,2323,429,428,-1
"66baf19b6b904b70922329068c63746d","a24600b0e49245f6bdba8c893cfeddb0",22859334,1,70,0,2326,376,425,49
"a24600b0e49245f6bdba8c893cfeddb0","a2b4bd40cee2481ebd3fc179d6a5cd62",22859334,2,-11,0,2327,425,417,-8
"a2b4bd40cee2481ebd3fc179d6a5cd62","a24600b0e49245f6bdba8c893cfeddb0",22859334,1,11,0,2328,417,425,8
"a2b4bd40cee2481ebd3fc179d6a5cd62","24cf8786024543f19b89bc20034e60d7",22859334,2,18,0,2331,417,428,11
"f2a73be2f46840b182d7bd095378004e","f2a73be2f46840b182d7bd095378004e",22859334,2,0,1,2333,429,429,0
"f2a73be2f46840b182d7bd095378004e","604551fd4266430cb860fef58fa7dd61",22859334,1,1,0,2335,429,430,1
"604551fd4266430cb860fef58fa7dd61","604551fd4266430cb860fef58fa7dd61",22859334,9,0,1,2336,430,430,0
"604551fd4266430cb860fef58fa7dd61","24cf8786024543f19b89bc20034e60d7",22859334,1,-2,0,2345,430,428,-2
"24cf8786024543f19b89bc20034e60d7","dce46f8904594a62a6377a3587aaa663",22859334,4,4,0,2346,428,431,3
"dce46f8904594a62a6377a3587aaa663","dce46f8904594a62a6377a3587aaa663",22859334,5,0,1,2347,431,431,0
"dce46f8904594a62a6377a3587aaa663","9b9d0a249052413c869753b99682b0ac",22859334,1,1,0,2349,431,432,1
"9b9d0a249052413c869753b99682b0ac","9b9d0a249052413c869753b99682b0ac",22859334,1,0,1,2350,432,432,0
"9b9d0a249052413c869753b99682b0ac","061c175cc90f45fbad883025394e78dd",22859334,1,1,0,2351,432,433,1
"061c175cc90f45fbad883025394e78dd","061c175cc90f45fbad883025394e78dd",22859334,5,0,1,2352,433,433,0
"061c175cc90f45fbad883025394e78dd","dce46f8904594a62a6377a3587aaa663",22859334,2,-2,0,2357,433,431,-2
"dce46f8904594a62a6377a3587aaa663","66ada10dde9f43018588f1ced9d477fc",22859334,3,4,0,2359,431,434,3
"66ada10dde9f43018588f1ced9d477fc","061c175cc90f45fbad883025394e78dd",22859334,1,-2,0,2360,434,433,-1
"dce46f8904594a62a6377a3587aaa663","66baf19b6b904b70922329068c63746d",22859334,1,-81,0,2362,431,376,-55
"66baf19b6b904b70922329068c63746d","dce46f8904594a62a6377a3587aaa663",22859334,1,81,0,2363,376,431,55
"dce46f8904594a62a6377a3587aaa663","24cf8786024543f19b89bc20034e60d7",22859334,2,-4,0,2364,431,428,-3
"dce46f8904594a62a6377a3587aaa663","74a7f8712e5449c2bc0b43c6f90dafed",22859334,1,5,0,2367,431,435,4
"74a7f8712e5449c2bc0b43c6f90dafed","74a7f8712e5449c2bc0b43c6f90dafed",22859334,1,0,1,2368,435,435,0
"74a7f8712e5449c2bc0b43c6f90dafed","66ada10dde9f43018588f1ced9d477fc",22859334,1,-1,0,2369,435,434,-1
"66ada10dde9f43018588f1ced9d477fc","bf12c96466d840a69bed7020b3f18bb8",22859334,1,3,0,2370,434,436,2
"bf12c96466d840a69bed7020b3f18bb8","bf12c96466d840a69bed7020b3f18bb8",22859334,1,0,1,2371,436,436,0
"bf12c96466d840a69bed7020b3f18bb8","070600601c4c439288445d2f0724807d",22859334,1,3,0,2372,436,437,1
"070600601c4c439288445d2f0724807d","24cf8786024543f19b89bc20034e60d7",22859334,1,-14,0,2373,437,428,-9
"24cf8786024543f19b89bc20034e60d7","1823b6de7d334a7aaabc4570719af4d9",22859334,1,16,0,2374,428,439,11
"1823b6de7d334a7aaabc4570719af4d9","66baf19b6b904b70922329068c63746d",22859334,1,-93,0,2375,439,376,-63
"66baf19b6b904b70922329068c63746d","070600601c4c439288445d2f0724807d",22859334,3,91,0,2377,376,437,61
"070600601c4c439288445d2f0724807d","1823b6de7d334a7aaabc4570719af4d9",22859334,4,2,0,2378,437,439,2
"1823b6de7d334a7aaabc4570719af4d9","1823b6de7d334a7aaabc4570719af4d9",22859334,13,0,1,2379,439,439,0
"1823b6de7d334a7aaabc4570719af4d9","0380cd76a7d44bc3a4da1f15e4d68f89",22859334,1,2,0,2392,439,440,1
"0380cd76a7d44bc3a4da1f15e4d68f89","070600601c4c439288445d2f0724807d",22859334,4,-4,0,2393,440,437,-3
"070600601c4c439288445d2f0724807d","0380cd76a7d44bc3a4da1f15e4d68f89",22859334,6,4,0,2394,437,440,3
"0380cd76a7d44bc3a4da1f15e4d68f89","0380cd76a7d44bc3a4da1f15e4d68f89",22859334,8,0,1,2395,440,440,0
"0380cd76a7d44bc3a4da1f15e4d68f89","23b7673c8b5443108c2ef09382834a86",22859334,5,2,0,2399,440,441,1
"23b7673c8b5443108c2ef09382834a86","0380cd76a7d44bc3a4da1f15e4d68f89",22859334,2,-2,0,2400,441,440,-1
"23b7673c8b5443108c2ef09382834a86","66baf19b6b904b70922329068c63746d",22859334,1,-97,0,2402,441,376,-65
"66baf19b6b904b70922329068c63746d","0380cd76a7d44bc3a4da1f15e4d68f89",22859334,2,95,0,2403,376,440,64
"0380cd76a7d44bc3a4da1f15e4d68f89","66baf19b6b904b70922329068c63746d",22859334,1,-95,0,2408,440,376,-64
"070600601c4c439288445d2f0724807d","23b7673c8b5443108c2ef09382834a86",22859334,1,6,0,2410,437,441,4
"23b7673c8b5443108c2ef09382834a86","23b7673c8b5443108c2ef09382834a86",22859334,8,0,1,2411,441,441,0
"23b7673c8b5443108c2ef09382834a86","901e92500aea43c79f19f1b279050668",22859334,4,2,0,2414,441,442,1
"901e92500aea43c79f19f1b279050668","23b7673c8b5443108c2ef09382834a86",22859334,3,-2,0,2415,442,441,-1
"901e92500aea43c79f19f1b279050668","901e92500aea43c79f19f1b279050668",22859334,1,0,1,2417,442,442,0
"901e92500aea43c79f19f1b279050668","001339db8ced4cf78829ebe8b145449d",22859334,1,1,0,2418,442,443,1
"001339db8ced4cf78829ebe8b145449d","001339db8ced4cf78829ebe8b145449d",22859334,6,0,1,2419,443,443,0
"001339db8ced4cf78829ebe8b145449d","452745e0366e42ae81561bfddebcc6c3",22859334,1,1,0,2425,443,444,1
"452745e0366e42ae81561bfddebcc6c3","452745e0366e42ae81561bfddebcc6c3",22859334,3,0,1,2426,444,444,0
"452745e0366e42ae81561bfddebcc6c3","4660ff2089114e8db82ceb26a4f329e3",22859334,1,2,0,2429,444,445,1
"4660ff2089114e8db82ceb26a4f329e3","901e92500aea43c79f19f1b279050668",22859334,2,-4,0,2430,445,442,-3
"901e92500aea43c79f19f1b279050668","4660ff2089114e8db82ceb26a4f329e3",22859334,3,4,0,2431,442,445,3
"4660ff2089114e8db82ceb26a4f329e3","4660ff2089114e8db82ceb26a4f329e3",22859334,2,0,1,2432,445,445,0
"4660ff2089114e8db82ceb26a4f329e3","7bd5586eb9d8484eb74a433ee7bfe499",22859334,6,2,0,2433,445,446,1
"7bd5586eb9d8484eb74a433ee7bfe499","4660ff2089114e8db82ceb26a4f329e3",22859334,2,-2,0,2434,446,445,-1
"7bd5586eb9d8484eb74a433ee7bfe499","7bd5586eb9d8484eb74a433ee7bfe499",22859334,16,0,1,2436,446,446,0
"7bd5586eb9d8484eb74a433ee7bfe499","8a7f26e690f34dda97be16904518ca99",22859334,2,2,0,2449,446,447,1
"8a7f26e690f34dda97be16904518ca99","8a7f26e690f34dda97be16904518ca99",22859334,1,0,1,2450,447,447,0
"8a7f26e690f34dda97be16904518ca99","070600601c4c439288445d2f0724807d",22859334,1,-16,0,2451,447,437,-10
"070600601c4c439288445d2f0724807d","b2f0d654738f48158edff28e8d3a546e",22859334,2,21,0,2452,437,449,12
"b2f0d654738f48158edff28e8d3a546e","66baf19b6b904b70922329068c63746d",22859334,3,-112,0,2453,449,376,-73
"66baf19b6b904b70922329068c63746d","b2f0d654738f48158edff28e8d3a546e",22859334,5,112,0,2454,376,449,73
"b2f0d654738f48158edff28e8d3a546e","b2f0d654738f48158edff28e8d3a546e",22859334,7,0,1,2455,449,449,0
"b2f0d654738f48158edff28e8d3a546e","f60ee41ec635499abd48168342d32c2f",22859334,8,5,0,2457,449,453,4
"f60ee41ec635499abd48168342d32c2f","f60ee41ec635499abd48168342d32c2f",22859334,117,0,1,2458,453,453,0
"f60ee41ec635499abd48168342d32c2f","9428d8bd9c5a47b2a235b254e5e27ded",22859334,2,-1,0,2465,453,452,-1
"9428d8bd9c5a47b2a235b254e5e27ded","66baf19b6b904b70922329068c63746d",22859334,1,-116,0,2466,452,376,-76
"f60ee41ec635499abd48168342d32c2f","b2f0d654738f48158edff28e8d3a546e",22859334,4,-5,0,2476,453,449,-4
"9428d8bd9c5a47b2a235b254e5e27ded","b2f0d654738f48158edff28e8d3a546e",22859334,1,-4,0,2482,452,449,-3
"f60ee41ec635499abd48168342d32c2f","66baf19b6b904b70922329068c63746d",22859334,2,-117,0,2491,453,376,-77
"0380cd76a7d44bc3a4da1f15e4d68f89","901e92500aea43c79f19f1b279050668",22859334,1,4,0,2511,440,442,2
"23b7673c8b5443108c2ef09382834a86","4660ff2089114e8db82ceb26a4f329e3",22859334,1,6,0,2513,441,445,4
"7bd5586eb9d8484eb74a433ee7bfe499","b2f0d654738f48158edff28e8d3a546e",22859334,2,7,0,2518,446,449,3
"b2f0d654738f48158edff28e8d3a546e","070600601c4c439288445d2f0724807d",22859334,2,-21,0,2519,449,437,-12
"070600601c4c439288445d2f0724807d","f60ee41ec635499abd48168342d32c2f",22859334,2,26,0,2520,437,453,16
"b2f0d654738f48158edff28e8d3a546e","f67fbf45a5f146ed866965bc57c7c001",22859334,2,8,0,2599,449,454,5
"f67fbf45a5f146ed866965bc57c7c001","f67fbf45a5f146ed866965bc57c7c001",22859334,8,0,1,2600,454,454,0
"f67fbf45a5f146ed866965bc57c7c001","d937afe49bd24a07a550dda1c1155122",22859334,1,1,0,2608,454,455,1
"d937afe49bd24a07a550dda1c1155122","d937afe49bd24a07a550dda1c1155122",22859334,3,0,1,2609,455,455,0
"d937afe49bd24a07a550dda1c1155122","3628b3f7823443d0912a339096b69943",22859334,1,1,0,2612,455,456,1
"3628b3f7823443d0912a339096b69943","3628b3f7823443d0912a339096b69943",22859334,1,0,1,2613,456,456,0
"3628b3f7823443d0912a339096b69943","9e049ee647cf43ecbcb5ed792a8e7588",22859334,1,1,0,2614,456,457,1
"9e049ee647cf43ecbcb5ed792a8e7588","9e049ee647cf43ecbcb5ed792a8e7588",22859334,1,0,1,2615,457,457,0
"9e049ee647cf43ecbcb5ed792a8e7588","5256a214faaf410b93f76cea06428334",22859334,1,1,0,2616,457,458,1
"5256a214faaf410b93f76cea06428334","5256a214faaf410b93f76cea06428334",22859334,1,0,1,2617,458,458,0
"5256a214faaf410b93f76cea06428334","25c32b120fce40fa9b6c85133aeb4716",22859334,1,1,0,2618,458,459,1
"25c32b120fce40fa9b6c85133aeb4716","25c32b120fce40fa9b6c85133aeb4716",22859334,5,0,1,2619,459,459,0
"25c32b120fce40fa9b6c85133aeb4716","11bc14f2204949008b7d511b933363c1",22859334,1,1,0,2624,459,460,1
"11bc14f2204949008b7d511b933363c1","11bc14f2204949008b7d511b933363c1",22859334,1,0,1,2625,460,460,0
"11bc14f2204949008b7d511b933363c1","42de338840a34d15adb66e7b14fb9d2c",22859334,1,1,0,2626,460,461,1
"42de338840a34d15adb66e7b14fb9d2c","42de338840a34d15adb66e7b14fb9d2c",22859334,1,0,1,2627,461,461,0
"42de338840a34d15adb66e7b14fb9d2c","9da37c6210b1416b8079c274f70bf600",22859334,1,1,0,2628,461,462,1
"9da37c6210b1416b8079c274f70bf600","9da37c6210b1416b8079c274f70bf600",22859334,3,0,1,2629,462,462,0
"9da37c6210b1416b8079c274f70bf600","519119f1deac45ff9ab4f13529be5c6e",22859334,1,1,0,2632,462,463,1
"519119f1deac45ff9ab4f13529be5c6e","519119f1deac45ff9ab4f13529be5c6e",22859334,1,0,1,2633,463,463,0
"519119f1deac45ff9ab4f13529be5c6e","f67fbf45a5f146ed866965bc57c7c001",22859334,1,-9,0,2634,463,454,-9
"f67fbf45a5f146ed866965bc57c7c001","c5df9f40ec14463b9dcfdc73df3e9285",22859334,3,12,0,2635,454,464,10
"c5df9f40ec14463b9dcfdc73df3e9285","c5df9f40ec14463b9dcfdc73df3e9285",22859334,4,0,1,2636,464,464,0
"c5df9f40ec14463b9dcfdc73df3e9285","83d42d95cd844fc093fc09cee250edb8",22859334,6,3,0,2637,464,465,1
"83d42d95cd844fc093fc09cee250edb8","c5df9f40ec14463b9dcfdc73df3e9285",22859334,3,-3,0,2638,465,464,-1
"83d42d95cd844fc093fc09cee250edb8","66baf19b6b904b70922329068c63746d",22859334,2,-135,0,2640,465,376,-89
"66baf19b6b904b70922329068c63746d","c5df9f40ec14463b9dcfdc73df3e9285",22859334,1,132,0,2641,376,464,88
"83d42d95cd844fc093fc09cee250edb8","83d42d95cd844fc093fc09cee250edb8",22859334,7,0,1,2647,465,465,0
"66baf19b6b904b70922329068c63746d","d6d02b6ef04e4f17805504500b8ce441",22859334,1,-4,0,2654,376,375,-1
"d6d02b6ef04e4f17805504500b8ce441","4a29443515bb404cb8924e1c60a63b73",22859334,1,-118,0,2658,375,285,-90
"4a29443515bb404cb8924e1c60a63b73","1ba8fef685d74a8194b9db252eb704fb",22859334,1,90,0,2659,285,355,70
"52580888dadb4fe3baa795683ea227bd","2fe14166dc9642c3bc666b86a57f943d",22859334,1,-8,0,2679,364,357,-7
"f00179e251a045b39c3f7a54f9aa4acc","b7719e26494940efa49512aedd0aac79",22859334,1,-465,0,2681,363,20,-343
"b7719e26494940efa49512aedd0aac79","a49d1bb4328949299686242fd0be5584",22859334,1,2,0,2682,20,21,1
"a49d1bb4328949299686242fd0be5584","a49d1bb4328949299686242fd0be5584",22859334,1,0,1,2683,21,21,0
"a49d1bb4328949299686242fd0be5584","d4c3b003e8274e429d2fa688d73fde6d",22859334,1,1,0,2684,21,22,1
"d4c3b003e8274e429d2fa688d73fde6d","d4f45188d3c84a02ba08454e6403a818",22859334,1,2,0,2685,22,24,2
"d4f45188d3c84a02ba08454e6403a818","d4c3b003e8274e429d2fa688d73fde6d",22859334,2,-2,0,2686,24,22,-2
"d4c3b003e8274e429d2fa688d73fde6d","b7719e26494940efa49512aedd0aac79",22859334,2,-3,0,2687,22,20,-2
"b7719e26494940efa49512aedd0aac79","afbf7250b99d47bea07172749483ca97",22859334,6,12,0,2688,20,28,8
"afbf7250b99d47bea07172749483ca97","b7719e26494940efa49512aedd0aac79",22859334,2,-12,0,2689,28,20,-8
"4e51676dc72045d99c19b9fa7b22f8bc","51970cfa30e643e894e66ae85c8024cc",22859334,3,3,0,2693,29,31,2
"51970cfa30e643e894e66ae85c8024cc","4e51676dc72045d99c19b9fa7b22f8bc",22859334,2,-3,0,2694,31,29,-2
"c33c17be71ae4d588da7369472e5bb1b","c33c17be71ae4d588da7369472e5bb1b",22859334,1,0,1,2696,34,34,0
"93679be414554a11b1893002f2229a93","93679be414554a11b1893002f2229a93",22859334,1,0,1,2698,35,35,0
"7040a13096d746ac84b8fac8d9752058","fc0e049d56024bc9a02c9a9c435c3df7",22859334,1,6,0,2702,36,38,2
"fc0e049d56024bc9a02c9a9c435c3df7","9a0dc646f934470daf08c4b56ccf73db",22859334,1,-3,0,2703,38,37,-1
"9a0dc646f934470daf08c4b56ccf73db","67a089198fcb4e1c8f2385786c2b296f",22859334,1,7,0,2704,37,39,2
"67a089198fcb4e1c8f2385786c2b296f","b534b89233134e30a9b5645138bfa9ee",22859334,2,4,0,2709,39,41,2
"6e13d61a7bdb44bca949c9f86fab3be5","d9c8d8c444a64dadbbb508652c721e17",22859334,1,-1,0,2711,47,46,-1
"d0c74f735e024943943e40333d6d337f","f924752d8a1149668870b1e7698486f7",22859334,1,-1,0,2713,51,50,-1
"f924752d8a1149668870b1e7698486f7","b534b89233134e30a9b5645138bfa9ee",22859334,1,-11,0,2714,50,41,-9
"a2becd407db34b189200a32546d9d569","140d5b27b8574befad82c0a013b59dfa",22859334,1,-1,0,2717,75,74,-1
"d18a9ea32855445f8736581f5cb119ce","d646286c8051419bbc2e31dd1db55ca8",22859334,1,-17,0,2719,82,67,-15
"d646286c8051419bbc2e31dd1db55ca8","6a9f0ef185fb47f0937e29daa1c71ed5",22859334,1,27,0,2720,67,90,23
"c681290961c94c4caf23b529d1ae6b9a","d646286c8051419bbc2e31dd1db55ca8",22859334,2,-25,0,2726,88,67,-21
"e20db35ced8544ddac5bc3839145e463","e20db35ced8544ddac5bc3839145e463",22859334,2,0,1,2728,91,91,0
"e20db35ced8544ddac5bc3839145e463","00ae5f0c51874a73a41ebea838d95682",22859334,5,11,0,2729,91,101,10
"00ae5f0c51874a73a41ebea838d95682","d391c8b6e56a43a7b654e9dee02d904b",22859334,7,2,0,2730,101,103,2
"d391c8b6e56a43a7b654e9dee02d904b","73039f8c1eb9409cb4caee2cf968001e",22859334,4,-3,0,2731,103,100,-3
"73039f8c1eb9409cb4caee2cf968001e","4280927ec4d643238aa49c32f9e06c6c",22859334,6,10,0,2732,100,109,9
"4280927ec4d643238aa49c32f9e06c6c","08111f75e22d409998cf8b85bd431f0a",22859334,2,-1,0,2733,109,108,-1
"08111f75e22d409998cf8b85bd431f0a","a9ae0a3c070d455bb4369a8996313336",22859334,3,7,0,2734,108,114,6
"a9ae0a3c070d455bb4369a8996313336","62bff51286ef4f348717a3cf6fe2318f",22859334,1,7,0,2735,114,120,6
"62bff51286ef4f348717a3cf6fe2318f","37319e88176d4aefa91d7a9980dbae91",22859334,3,-9,0,2736,120,112,-8
"37319e88176d4aefa91d7a9980dbae91","62bff51286ef4f348717a3cf6fe2318f",22859334,2,9,0,2737,112,120,8
"62bff51286ef4f348717a3cf6fe2318f","62bff51286ef4f348717a3cf6fe2318f",22859334,6,0,1,2738,120,120,0
"62bff51286ef4f348717a3cf6fe2318f","e20db35ced8544ddac5bc3839145e463",22859334,3,-33,0,2739,120,91,-29
"e20db35ced8544ddac5bc3839145e463","779f9ddd1fd14d1e9e69f72219a1fdbd",22859334,2,36,0,2740,91,121,30
"779f9ddd1fd14d1e9e69f72219a1fdbd","a8dd5213034441ac92724b4e83eb0bb2",22859334,3,9,0,2741,121,129,8
"a8dd5213034441ac92724b4e83eb0bb2","779f9ddd1fd14d1e9e69f72219a1fdbd",22859334,3,-9,0,2742,129,121,-8
"779f9ddd1fd14d1e9e69f72219a1fdbd","579338175e0b4bbb8ef3b712b5d8b54e",22859334,1,8,0,2743,121,128,7
"579338175e0b4bbb8ef3b712b5d8b54e","b416d47c56a742199b5d7c7f19d6503a",22859334,4,7,0,2744,128,134,6
"b416d47c56a742199b5d7c7f19d6503a","df1de691dafe4549a18a4398ee9dfaf9",22859334,1,8,0,2745,134,139,5
"df1de691dafe4549a18a4398ee9dfaf9","779f9ddd1fd14d1e9e69f72219a1fdbd",22859334,2,-23,0,2746,139,121,-18
"779f9ddd1fd14d1e9e69f72219a1fdbd","6c5ad271a44743479bfaea29b1db8d02",22859334,1,27,0,2747,121,143,22
"6c5ad271a44743479bfaea29b1db8d02","df1de691dafe4549a18a4398ee9dfaf9",22859334,2,-4,0,2748,143,139,-4
"df1de691dafe4549a18a4398ee9dfaf9","8aae34f5ddbb4052a709b12e6b0d40fa",22859334,3,9,0,2749,139,147,8
"8aae34f5ddbb4052a709b12e6b0d40fa","d313cec988a84645bee413e8d4724a4b",22859334,1,13,0,2750,147,158,11
"d313cec988a84645bee413e8d4724a4b","f902b0f41b544d4dbf79664fd233648d",22859334,1,-14,0,2751,158,146,-12
"f902b0f41b544d4dbf79664fd233648d","d313cec988a84645bee413e8d4724a4b",22859334,1,14,0,2752,146,158,12
"d313cec988a84645bee413e8d4724a4b","d313cec988a84645bee413e8d4724a4b",22859334,5,0,1,2753,158,158,0
"d313cec988a84645bee413e8d4724a4b","78adeee1fa2c4fe0bc73f7bca9fcee86",22859334,1,4,0,2754,158,160,2
"78adeee1fa2c4fe0bc73f7bca9fcee86","df1de691dafe4549a18a4398ee9dfaf9",22859334,2,-26,0,2755,160,139,-21
"df1de691dafe4549a18a4398ee9dfaf9","65202579580f4ad38d734b4ee39d22a8",22859334,1,31,0,2756,139,164,25
"82e6285962b8400d9d6fc32436022a94","a9ac840f098c4bd0a2ee896214ce29cd",22859334,1,3,0,2770,167,168,1
"a9ac840f098c4bd0a2ee896214ce29cd","3cbcea2be0984e7dbd5a48195af10ce7",22859334,1,-5,0,2771,168,165,-3
"3cbcea2be0984e7dbd5a48195af10ce7","0c7262dff33c4087bc660ccf40f92f9c",22859334,1,9,0,2772,165,169,4
"0c7262dff33c4087bc660ccf40f92f9c","a9ac840f098c4bd0a2ee896214ce29cd",22859334,1,-4,0,2773,169,168,-1
"a9ac840f098c4bd0a2ee896214ce29cd","b2275c3fad834f8d90737a2d9a6927d6",22859334,1,7,0,2774,168,172,4
"b42cc17b7de840f181a704558d0bc845","362fcb0699a14845ab29b2340093e528",22859334,1,-1,0,2777,175,174,-1
"b87c552dd247427abe6ab5795b9c9d43","ea38cc0e6e6e41edbabf210220808bf9",22859334,2,-2,0,2779,181,179,-2
"ea38cc0e6e6e41edbabf210220808bf9","139b097acfca451689d80c9c6eebdf7b",22859334,2,-1,0,2780,179,178,-1
"139b097acfca451689d80c9c6eebdf7b","0c7262dff33c4087bc660ccf40f92f9c",22859334,1,-11,0,2781,178,169,-9
"c8e371568a0c4391b25796ae4e91952e","d7f13c8d63ec4e2aa673fbb9cf9c6933",22859334,1,26,0,2784,186,206,20
"bb5a47f5ea01454a8b79455422d3b9da","94cecc3f1e7d484b8e068e79241dfd73",22859334,1,3,0,2808,280,281,1
"94cecc3f1e7d484b8e068e79241dfd73","bb5a47f5ea01454a8b79455422d3b9da",22859334,1,-3,0,2809,281,280,-1
"bb5a47f5ea01454a8b79455422d3b9da","a37477c4e4c14169ad44b06b493007f6",22859334,1,5,0,2810,280,283,3
"a37477c4e4c14169ad44b06b493007f6","fab84b4fab5940efb4ea868ef8d09396",22859334,1,3,0,2811,283,284,1
"fab84b4fab5940efb4ea868ef8d09396","94cecc3f1e7d484b8e068e79241dfd73",22859334,1,-5,0,2812,284,281,-3
"94cecc3f1e7d484b8e068e79241dfd73","4a29443515bb404cb8924e1c60a63b73",22859334,1,9,0,2813,281,285,4
"0c4079457ede49e3aeb5e86ed84bdf35","0c4079457ede49e3aeb5e86ed84bdf35",22859334,1,0,1,2825,329,329,0
"30ead9794d4847abaf222ca966cc8630","09b9678ddc3d452ea4a3d46e15826065",22859334,1,5,0,2827,348,353,5
"eff0de7f2dbb42dfa1a2e686efab5b6d","897b7f51242c44aab2205c72fdcbf4cd",22859334,2,-2,0,2830,354,352,-2
"09b9678ddc3d452ea4a3d46e15826065","c20993c944444fe085345591a8bd837e",22859334,1,-2,0,2837,353,351,-2
"c20993c944444fe085345591a8bd837e","30ead9794d4847abaf222ca966cc8630",22859334,1,-3,0,2839,351,348,-3
"30ead9794d4847abaf222ca966cc8630","8d448d625b024c82a5eb240bbd7431d6",22859334,1,33,0,2848,348,374,26
"2b09a08242b54983aec7063990fb3f66","1157bd665ec4472fb58b751dc5099355",22859334,2,4,0,2868,400,403,3
"1157bd665ec4472fb58b751dc5099355","2b09a08242b54983aec7063990fb3f66",22859334,1,-4,0,2869,403,400,-3
"bec48fc2e1294c7eb3d0aca780d731b8","a2b4bd40cee2481ebd3fc179d6a5cd62",22859334,2,-4,0,2874,420,417,-3
"f2a73be2f46840b182d7bd095378004e","dce46f8904594a62a6377a3587aaa663",22859334,1,3,0,2877,429,431,2
"66ada10dde9f43018588f1ced9d477fc","24cf8786024543f19b89bc20034e60d7",22859334,2,-8,0,2881,434,428,-6
"24cf8786024543f19b89bc20034e60d7","070600601c4c439288445d2f0724807d",22859334,2,14,0,2882,428,437,9
"1823b6de7d334a7aaabc4570719af4d9","070600601c4c439288445d2f0724807d",22859334,3,-2,0,2884,439,437,-2
"070600601c4c439288445d2f0724807d","4660ff2089114e8db82ceb26a4f329e3",22859334,1,12,0,2885,437,445,8
"8a7f26e690f34dda97be16904518ca99","7bd5586eb9d8484eb74a433ee7bfe499",22859334,1,-2,0,2891,447,446,-1
"f60ee41ec635499abd48168342d32c2f","f67fbf45a5f146ed866965bc57c7c001",22859334,2,3,0,2905,453,454,1
"f67fbf45a5f146ed866965bc57c7c001","b2f0d654738f48158edff28e8d3a546e",22859334,2,-8,0,2906,454,449,-5
"b2f0d654738f48158edff28e8d3a546e","c5df9f40ec14463b9dcfdc73df3e9285",22859334,1,20,0,2907,449,464,15
"c5df9f40ec14463b9dcfdc73df3e9285","f67fbf45a5f146ed866965bc57c7c001",22859334,1,-12,0,2908,464,454,-10
"83d42d95cd844fc093fc09cee250edb8","2b09a08242b54983aec7063990fb3f66",22859334,1,-103,0,2914,465,400,-65
"bec48fc2e1294c7eb3d0aca780d731b8","a24600b0e49245f6bdba8c893cfeddb0",22859334,1,7,0,2931,420,425,5
"a24600b0e49245f6bdba8c893cfeddb0","dbde19fcce2a4c1abdc7f685c293a23f",22859334,1,-4,0,2932,425,422,-3
"7bd5586eb9d8484eb74a433ee7bfe499","070600601c4c439288445d2f0724807d",22859334,1,-14,0,2955,446,437,-9
"c5df9f40ec14463b9dcfdc73df3e9285","66baf19b6b904b70922329068c63746d",22859334,1,-132,0,2971,464,376,-88
"070600601c4c439288445d2f0724807d","070600601c4c439288445d2f0724807d",22859334,1,0,1,2973,437,437,0
"b7719e26494940efa49512aedd0aac79","b7719e26494940efa49512aedd0aac79",22860435,4,0,1,1,20,20,0
"b7719e26494940efa49512aedd0aac79","b613861cecf84ffcab01afb23f660475",22860435,1,-32,0,2,20,1,-19
"b613861cecf84ffcab01afb23f660475","b613861cecf84ffcab01afb23f660475",22860435,4,0,1,3,1,1,0
"b613861cecf84ffcab01afb23f660475","e2911e79efc2420eac45d9f671463d4b",22860435,1,3,0,7,1,2,1
"e2911e79efc2420eac45d9f671463d4b","519d1b8c59404d67b54e96c5c8a830b2",22860435,1,1,0,10,2,3,1
"519d1b8c59404d67b54e96c5c8a830b2","519d1b8c59404d67b54e96c5c8a830b2",22860435,2,0,1,11,3,3,0
"519d1b8c59404d67b54e96c5c8a830b2","531db53f81f646edb0cdcfe0085b03b7",22860435,1,1,0,13,3,4,1
"531db53f81f646edb0cdcfe0085b03b7","531db53f81f646edb0cdcfe0085b03b7",22860435,2,0,1,14,4,4,0
"531db53f81f646edb0cdcfe0085b03b7","4f5f94b2f95141e0a9d53a61da2276da",22860435,1,1,0,16,4,5,1
"4f5f94b2f95141e0a9d53a61da2276da","4f5f94b2f95141e0a9d53a61da2276da",22860435,1,0,1,17,5,5,0
"4f5f94b2f95141e0a9d53a61da2276da","6d541c89590949f99af293c4f2333f67",22860435,1,1,0,18,5,6,1
"6d541c89590949f99af293c4f2333f67","6d541c89590949f99af293c4f2333f67",22860435,1,0,1,19,6,6,0
"6d541c89590949f99af293c4f2333f67","dd5cf0b9fe4c4f1d8f5ff8e4c04879cb",22860435,1,1,0,20,6,7,1
"dd5cf0b9fe4c4f1d8f5ff8e4c04879cb","dd5cf0b9fe4c4f1d8f5ff8e4c04879cb",22860435,1,0,1,21,7,7,0
"dd5cf0b9fe4c4f1d8f5ff8e4c04879cb","f96261861edc426abe2248be4f0a709a",22860435,1,1,0,22,7,8,1
"f96261861edc426abe2248be4f0a709a","f96261861edc426abe2248be4f0a709a",22860435,2,0,1,23,8,8,0
"f96261861edc426abe2248be4f0a709a","66b5e16f4f75454fb5b8172079f0fa83",22860435,1,1,0,25,8,9,1
"66b5e16f4f75454fb5b8172079f0fa83","66b5e16f4f75454fb5b8172079f0fa83",22860435,2,0,1,26,9,9,0
"66b5e16f4f75454fb5b8172079f0fa83","0680571d4698477995e41842c36a54b2",22860435,1,1,0,28,9,10,1
"0680571d4698477995e41842c36a54b2","0680571d4698477995e41842c36a54b2",22860435,2,0,1,29,10,10,0
"0680571d4698477995e41842c36a54b2","9112f2bffece48e08c6d2287be204085",22860435,1,1,0,31,10,11,1
"9112f2bffece48e08c6d2287be204085","9112f2bffece48e08c6d2287be204085",22860435,2,0,1,32,11,11,0
"9112f2bffece48e08c6d2287be204085","e2911e79efc2420eac45d9f671463d4b",22860435,1,-9,0,34,11,2,-9
"b7f2b31585d94eb3bf86376714aa7070","b7f2b31585d94eb3bf86376714aa7070",22860435,5,0,1,43,13,13,0
"3f1c815879794b929260d224becaff7e","56586aa865414f538729c7f7735d2bc6",22860435,1,-4,0,45,14,12,-2
"56586aa865414f538729c7f7735d2bc6","5c5ceeee4562457ba6d41515aeebfbb1",22860435,10,10,0,49,12,17,5
"5c5ceeee4562457ba6d41515aeebfbb1","eb2a0eb537344a9e891c761662e400b6",22860435,7,-2,0,50,17,16,-1
"eb2a0eb537344a9e891c761662e400b6","56586aa865414f538729c7f7735d2bc6",22860435,7,-8,0,51,16,12,-4
"5c5ceeee4562457ba6d41515aeebfbb1","5c5ceeee4562457ba6d41515aeebfbb1",22860435,3,0,1,62,17,17,0
"5c5ceeee4562457ba6d41515aeebfbb1","56586aa865414f538729c7f7735d2bc6",22860435,3,-10,0,74,17,12,-5
"56586aa865414f538729c7f7735d2bc6","9afd71a5298d4333b6849dfce1b9422c",22860435,2,13,0,75,12,18,6
"d4c3b003e8274e429d2fa688d73fde6d","d4c3b003e8274e429d2fa688d73fde6d",22860435,2,0,1,81,22,22,0
"afbf7250b99d47bea07172749483ca97","afbf7250b99d47bea07172749483ca97",22860435,1,0,1,86,28,28,0
"93679be414554a11b1893002f2229a93","c33c17be71ae4d588da7369472e5bb1b",22860435,1,-3,0,93,35,34,-1
"c33c17be71ae4d588da7369472e5bb1b","7040a13096d746ac84b8fac8d9752058",22860435,1,6,0,94,34,36,2
"7040a13096d746ac84b8fac8d9752058","93679be414554a11b1893002f2229a93",22860435,1,-3,0,95,36,35,-1
"9a0dc646f934470daf08c4b56ccf73db","fc0e049d56024bc9a02c9a9c435c3df7",22860435,5,3,0,100,37,38,1
"fc0e049d56024bc9a02c9a9c435c3df7","9a0dc646f934470daf08c4b56ccf73db",22860435,3,-3,0,101,38,37,-1
"fc0e049d56024bc9a02c9a9c435c3df7","9afd71a5298d4333b6849dfce1b9422c",22860435,1,-40,0,105,38,18,-20
"9afd71a5298d4333b6849dfce1b9422c","9afd71a5298d4333b6849dfce1b9422c",22860435,6,0,1,106,18,18,0
"9afd71a5298d4333b6849dfce1b9422c","b7719e26494940efa49512aedd0aac79",22860435,4,4,0,107,18,20,2
"b7719e26494940efa49512aedd0aac79","9afd71a5298d4333b6849dfce1b9422c",22860435,7,-4,0,108,20,18,-2
"9afd71a5298d4333b6849dfce1b9422c","d4f45188d3c84a02ba08454e6403a818",22860435,5,9,0,109,18,24,6
"d4f45188d3c84a02ba08454e6403a818","d4c3b003e8274e429d2fa688d73fde6d",22860435,5,-2,0,110,24,22,-2
"d4c3b003e8274e429d2fa688d73fde6d","b7719e26494940efa49512aedd0aac79",22860435,4,-3,0,111,22,20,-2
"9afd71a5298d4333b6849dfce1b9422c","daf8890a3c354459b8a962529aceb072",22860435,7,1,0,114,18,19,1
"daf8890a3c354459b8a962529aceb072","b7719e26494940efa49512aedd0aac79",22860435,2,3,0,115,19,20,1
"d4c3b003e8274e429d2fa688d73fde6d","daf8890a3c354459b8a962529aceb072",22860435,1,-6,0,119,22,19,-3
"daf8890a3c354459b8a962529aceb072","9afd71a5298d4333b6849dfce1b9422c",22860435,8,-1,0,120,19,18,-1
"b7719e26494940efa49512aedd0aac79","afbf7250b99d47bea07172749483ca97",22860435,10,12,0,127,20,28,8
"afbf7250b99d47bea07172749483ca97","b7719e26494940efa49512aedd0aac79",22860435,5,-12,0,128,28,20,-8
"b7719e26494940efa49512aedd0aac79","d4c3b003e8274e429d2fa688d73fde6d",22860435,4,3,0,130,20,22,2
"d4c3b003e8274e429d2fa688d73fde6d","d4f45188d3c84a02ba08454e6403a818",22860435,4,2,0,131,22,24,2
"d4f45188d3c84a02ba08454e6403a818","b7719e26494940efa49512aedd0aac79",22860435,4,-5,0,132,24,20,-4
"afbf7250b99d47bea07172749483ca97","4e51676dc72045d99c19b9fa7b22f8bc",22860435,3,3,0,149,28,29,1
"4e51676dc72045d99c19b9fa7b22f8bc","4e51676dc72045d99c19b9fa7b22f8bc",22860435,3,0,1,150,29,29,0
"4e51676dc72045d99c19b9fa7b22f8bc","51970cfa30e643e894e66ae85c8024cc",22860435,3,3,0,151,29,31,2
"51970cfa30e643e894e66ae85c8024cc","c33c17be71ae4d588da7369472e5bb1b",22860435,1,6,0,152,31,34,3
"c33c17be71ae4d588da7369472e5bb1b","4e51676dc72045d99c19b9fa7b22f8bc",22860435,1,-9,0,153,34,29,-5
"4e51676dc72045d99c19b9fa7b22f8bc","c33c17be71ae4d588da7369472e5bb1b",22860435,3,9,0,154,29,34,5
"c33c17be71ae4d588da7369472e5bb1b","93679be414554a11b1893002f2229a93",22860435,3,3,0,155,34,35,1
"93679be414554a11b1893002f2229a93","93679be414554a11b1893002f2229a93",22860435,2,0,1,156,35,35,0
"93679be414554a11b1893002f2229a93","7040a13096d746ac84b8fac8d9752058",22860435,3,3,0,157,35,36,1
"7040a13096d746ac84b8fac8d9752058","daf8890a3c354459b8a962529aceb072",22860435,1,-33,0,158,36,19,-17
"daf8890a3c354459b8a962529aceb072","daf8890a3c354459b8a962529aceb072",22860435,3,0,1,161,19,19,0
"51970cfa30e643e894e66ae85c8024cc","4e51676dc72045d99c19b9fa7b22f8bc",22860435,2,-3,0,177,31,29,-2
"c33c17be71ae4d588da7369472e5bb1b","c33c17be71ae4d588da7369472e5bb1b",22860435,1,0,1,179,34,34,0
"7040a13096d746ac84b8fac8d9752058","9a0dc646f934470daf08c4b56ccf73db",22860435,3,3,0,183,36,37,1
"9a0dc646f934470daf08c4b56ccf73db","7040a13096d746ac84b8fac8d9752058",22860435,1,-3,0,184,37,36,-1
"fc0e049d56024bc9a02c9a9c435c3df7","daf8890a3c354459b8a962529aceb072",22860435,1,-39,0,187,38,19,-19
"9afd71a5298d4333b6849dfce1b9422c","67a089198fcb4e1c8f2385786c2b296f",22860435,1,44,0,197,18,39,21
"67a089198fcb4e1c8f2385786c2b296f","64d48c6c9c7940639a932219a6c87198",22860435,3,1,0,198,39,40,1
"64d48c6c9c7940639a932219a6c87198","64d48c6c9c7940639a932219a6c87198",22860435,4,0,1,199,40,40,0
"64d48c6c9c7940639a932219a6c87198","67a089198fcb4e1c8f2385786c2b296f",22860435,2,-1,0,200,40,39,-1
"67a089198fcb4e1c8f2385786c2b296f","b534b89233134e30a9b5645138bfa9ee",22860435,2,4,0,201,39,41,2
"b534b89233134e30a9b5645138bfa9ee","0e37b720d23b4e7f8b313e79313fd107",22860435,1,3,0,202,41,44,3
"0e37b720d23b4e7f8b313e79313fd107","0e37b720d23b4e7f8b313e79313fd107",22860435,2,0,1,203,44,44,0
"0e37b720d23b4e7f8b313e79313fd107","6875d67fdd5f48168b62719df449bebd",22860435,1,1,0,205,44,45,1
"6875d67fdd5f48168b62719df449bebd","6875d67fdd5f48168b62719df449bebd",22860435,2,0,1,206,45,45,0
"6875d67fdd5f48168b62719df449bebd","b534b89233134e30a9b5645138bfa9ee",22860435,1,-4,0,208,45,41,-4
"b534b89233134e30a9b5645138bfa9ee","6e13d61a7bdb44bca949c9f86fab3be5",22860435,3,7,0,209,41,47,6
"6e13d61a7bdb44bca949c9f86fab3be5","6e13d61a7bdb44bca949c9f86fab3be5",22860435,8,0,1,210,47,47,0
"6e13d61a7bdb44bca949c9f86fab3be5","195f78799f984cc2b06c48dfe36be751",22860435,1,2,0,212,47,49,2
"195f78799f984cc2b06c48dfe36be751","195f78799f984cc2b06c48dfe36be751",22860435,2,0,1,213,49,49,0
"195f78799f984cc2b06c48dfe36be751","d9c8d8c444a64dadbbb508652c721e17",22860435,1,-3,0,215,49,46,-3
"d9c8d8c444a64dadbbb508652c721e17","d0c74f735e024943943e40333d6d337f",22860435,3,6,0,216,46,51,5
"d0c74f735e024943943e40333d6d337f","d0c74f735e024943943e40333d6d337f",22860435,3,0,1,217,51,51,0
"d0c74f735e024943943e40333d6d337f","983f8ff320594b279a7f4a6fe132f9c5",22860435,1,2,0,218,51,53,2
"983f8ff320594b279a7f4a6fe132f9c5","983f8ff320594b279a7f4a6fe132f9c5",22860435,2,0,1,219,53,53,0
"983f8ff320594b279a7f4a6fe132f9c5","35adfa5d923046aebabfefd98f35ff05",22860435,1,1,0,221,53,54,1
"35adfa5d923046aebabfefd98f35ff05","35adfa5d923046aebabfefd98f35ff05",22860435,5,0,1,222,54,54,0
"35adfa5d923046aebabfefd98f35ff05","b6f8a98476224da1b40e555ececc7ed8",22860435,1,1,0,227,54,55,1
"b6f8a98476224da1b40e555ececc7ed8","b6f8a98476224da1b40e555ececc7ed8",22860435,2,0,1,228,55,55,0
"b6f8a98476224da1b40e555ececc7ed8","86e22cb5fe0e4b47a9489ecddf7ed78f",22860435,1,1,0,230,55,56,1
"86e22cb5fe0e4b47a9489ecddf7ed78f","86e22cb5fe0e4b47a9489ecddf7ed78f",22860435,2,0,1,231,56,56,0
"86e22cb5fe0e4b47a9489ecddf7ed78f","78f30e4dcac84e3cbea8b2cc6e0d62b3",22860435,1,4,0,233,56,59,3
"78f30e4dcac84e3cbea8b2cc6e0d62b3","a1f2f12debe5432fb7a70bcd12bacfb9",22860435,4,-1,0,234,59,58,-1
"a1f2f12debe5432fb7a70bcd12bacfb9","f924752d8a1149668870b1e7698486f7",22860435,2,-9,0,235,58,50,-8
"f924752d8a1149668870b1e7698486f7","a1f2f12debe5432fb7a70bcd12bacfb9",22860435,3,9,0,236,50,58,8
"a1f2f12debe5432fb7a70bcd12bacfb9","a1f2f12debe5432fb7a70bcd12bacfb9",22860435,21,0,1,237,58,58,0
"a1f2f12debe5432fb7a70bcd12bacfb9","12aa6e1672ac4e7aa6449a7a8609cd72",22860435,3,-1,0,238,58,57,-1
"12aa6e1672ac4e7aa6449a7a8609cd72","d0c74f735e024943943e40333d6d337f",22860435,1,-7,0,239,57,51,-6
"d0c74f735e024943943e40333d6d337f","6e13d61a7bdb44bca949c9f86fab3be5",22860435,1,-5,0,241,51,47,-4
"6e13d61a7bdb44bca949c9f86fab3be5","f924752d8a1149668870b1e7698486f7",22860435,1,4,0,242,47,50,3
"f924752d8a1149668870b1e7698486f7","6e13d61a7bdb44bca949c9f86fab3be5",22860435,1,-4,0,243,50,47,-3
"6e13d61a7bdb44bca949c9f86fab3be5","d0c74f735e024943943e40333d6d337f",22860435,1,5,0,246,47,51,4
"d0c74f735e024943943e40333d6d337f","d9c8d8c444a64dadbbb508652c721e17",22860435,1,-6,0,247,51,46,-5
"d9c8d8c444a64dadbbb508652c721e17","78f30e4dcac84e3cbea8b2cc6e0d62b3",22860435,1,15,0,248,46,59,13
"12aa6e1672ac4e7aa6449a7a8609cd72","6e13d61a7bdb44bca949c9f86fab3be5",22860435,1,-12,0,262,57,47,-10
"a1f2f12debe5432fb7a70bcd12bacfb9","78f30e4dcac84e3cbea8b2cc6e0d62b3",22860435,2,1,0,269,58,59,1
"78f30e4dcac84e3cbea8b2cc6e0d62b3","78f30e4dcac84e3cbea8b2cc6e0d62b3",22860435,19,0,1,283,59,59,0
"78f30e4dcac84e3cbea8b2cc6e0d62b3","bc42d26810654ea9a1df1efe1e58c7d5",22860435,1,5,0,302,59,63,4
"bc42d26810654ea9a1df1efe1e58c7d5","12aa6e1672ac4e7aa6449a7a8609cd72",22860435,1,-7,0,303,63,57,-6
"a0a418b8540d479fa6e0f653b701da8b","4c943503763e4e349906eea3ed3c8e86",22860435,1,-3,0,305,64,61,-3
"4c943503763e4e349906eea3ed3c8e86","4c943503763e4e349906eea3ed3c8e86",22860435,1,0,1,306,61,61,0
"4c943503763e4e349906eea3ed3c8e86","bc42d26810654ea9a1df1efe1e58c7d5",22860435,1,2,0,307,61,63,2
"d646286c8051419bbc2e31dd1db55ca8","267f883678b24aed855fde42524975d9",22860435,1,4,0,314,67,71,4
"267f883678b24aed855fde42524975d9","267f883678b24aed855fde42524975d9",22860435,1,0,1,315,71,71,0
"267f883678b24aed855fde42524975d9","88fff56d0342490dbef9040750a20f6c",22860435,1,1,0,316,71,72,1
"88fff56d0342490dbef9040750a20f6c","88fff56d0342490dbef9040750a20f6c",22860435,1,0,1,317,72,72,0
"88fff56d0342490dbef9040750a20f6c","adb17b12b66c4a49a85fd34322f7df70",22860435,1,1,0,318,72,73,1
"adb17b12b66c4a49a85fd34322f7df70","adb17b12b66c4a49a85fd34322f7df70",22860435,1,0,1,319,73,73,0
"adb17b12b66c4a49a85fd34322f7df70","d646286c8051419bbc2e31dd1db55ca8",22860435,1,-6,0,320,73,67,-6
"a2becd407db34b189200a32546d9d569","58c22b011d0f4c2ea6d13615edbb9eeb",22860435,1,2,0,325,75,77,2
"58c22b011d0f4c2ea6d13615edbb9eeb","58c22b011d0f4c2ea6d13615edbb9eeb",22860435,2,0,1,326,77,77,0
"58c22b011d0f4c2ea6d13615edbb9eeb","dd76e1861dc9461c830888729d091ee0",22860435,1,1,0,328,77,78,1
"dd76e1861dc9461c830888729d091ee0","dd76e1861dc9461c830888729d091ee0",22860435,5,0,1,329,78,78,0
"dd76e1861dc9461c830888729d091ee0","cd1d828f1a694b87913a7ea66c23803e",22860435,1,1,0,334,78,79,1
"cd1d828f1a694b87913a7ea66c23803e","cd1d828f1a694b87913a7ea66c23803e",22860435,2,0,1,335,79,79,0
"cd1d828f1a694b87913a7ea66c23803e","a2becd407db34b189200a32546d9d569",22860435,1,-4,0,337,79,75,-4
"a2becd407db34b189200a32546d9d569","9176a3c2b4d2465fa8b0c67096c2a97e",22860435,1,5,0,339,75,80,5
"9176a3c2b4d2465fa8b0c67096c2a97e","9176a3c2b4d2465fa8b0c67096c2a97e",22860435,5,0,1,340,80,80,0
"9176a3c2b4d2465fa8b0c67096c2a97e","f8ec6445f7194e25b9101d4fbcb07a18",22860435,1,1,0,345,80,81,1
"f8ec6445f7194e25b9101d4fbcb07a18","f8ec6445f7194e25b9101d4fbcb07a18",22860435,2,0,1,346,81,81,0
"f8ec6445f7194e25b9101d4fbcb07a18","140d5b27b8574befad82c0a013b59dfa",22860435,1,-7,0,348,81,74,-7
"d18a9ea32855445f8736581f5cb119ce","f564483cbd7a407681aa2fcca518cf5f",22860435,1,4,0,350,82,85,3
"f564483cbd7a407681aa2fcca518cf5f","f564483cbd7a407681aa2fcca518cf5f",22860435,4,0,1,351,85,85,0
"f564483cbd7a407681aa2fcca518cf5f","18fd01350bd5434ca636d59a599d768a",22860435,1,1,0,355,85,86,1
"18fd01350bd5434ca636d59a599d768a","18fd01350bd5434ca636d59a599d768a",22860435,8,0,1,356,86,86,0
"18fd01350bd5434ca636d59a599d768a","6a9f0ef185fb47f0937e29daa1c71ed5",22860435,1,5,0,364,86,90,4
"ae5ac430ea254e708a6f5deaaf7464ae","42fb58708eaf4e5daa82bfca61b6f5fd",22860435,1,4,0,366,84,87,3
"42fb58708eaf4e5daa82bfca61b6f5fd","d18a9ea32855445f8736581f5cb119ce",22860435,1,-7,0,367,87,82,-5
"6a9f0ef185fb47f0937e29daa1c71ed5","c681290961c94c4caf23b529d1ae6b9a",22860435,1,-2,0,369,90,88,-2
"c681290961c94c4caf23b529d1ae6b9a","c681290961c94c4caf23b529d1ae6b9a",22860435,1,0,1,370,88,88,0
"c681290961c94c4caf23b529d1ae6b9a","e20db35ced8544ddac5bc3839145e463",22860435,1,5,0,371,88,91,3
"e20db35ced8544ddac5bc3839145e463","d646286c8051419bbc2e31dd1db55ca8",22860435,3,-30,0,372,91,67,-24
"d646286c8051419bbc2e31dd1db55ca8","6a9f0ef185fb47f0937e29daa1c71ed5",22860435,1,27,0,376,67,90,23
"6a9f0ef185fb47f0937e29daa1c71ed5","e20db35ced8544ddac5bc3839145e463",22860435,1,3,0,381,90,91,1
"d646286c8051419bbc2e31dd1db55ca8","1febb706d7a34005ae8711ed49c76e64",22860435,1,33,0,383,67,94,27
"1febb706d7a34005ae8711ed49c76e64","1febb706d7a34005ae8711ed49c76e64",22860435,2,0,1,384,94,94,0
"1febb706d7a34005ae8711ed49c76e64","8f73ba6f5a0042f2850356ac38ac6f24",22860435,1,1,0,386,94,95,1
"8f73ba6f5a0042f2850356ac38ac6f24","8f73ba6f5a0042f2850356ac38ac6f24",22860435,5,0,1,387,95,95,0
"8f73ba6f5a0042f2850356ac38ac6f24","e2260b86653c46d7b14a41fb419dbf8c",22860435,1,1,0,392,95,96,1
"e2260b86653c46d7b14a41fb419dbf8c","e2260b86653c46d7b14a41fb419dbf8c",22860435,2,0,1,393,96,96,0
"e2260b86653c46d7b14a41fb419dbf8c","35eb641ad1d845bbba54915bce75a962",22860435,1,1,0,395,96,97,1
"35eb641ad1d845bbba54915bce75a962","35eb641ad1d845bbba54915bce75a962",22860435,2,0,1,396,97,97,0
"35eb641ad1d845bbba54915bce75a962","08be90ffbeea4795a138cd42ed8db56f",22860435,1,1,0,398,97,98,1
"08be90ffbeea4795a138cd42ed8db56f","08be90ffbeea4795a138cd42ed8db56f",22860435,5,0,1,399,98,98,0
"08be90ffbeea4795a138cd42ed8db56f","3007433c8f584dcbb5ac159c1c5f2be3",22860435,1,1,0,404,98,99,1
"3007433c8f584dcbb5ac159c1c5f2be3","3007433c8f584dcbb5ac159c1c5f2be3",22860435,2,0,1,405,99,99,0
"3007433c8f584dcbb5ac159c1c5f2be3","00ae5f0c51874a73a41ebea838d95682",22860435,1,3,0,407,99,101,2
"00ae5f0c51874a73a41ebea838d95682","e20db35ced8544ddac5bc3839145e463",22860435,1,-11,0,408,101,91,-10
"e20db35ced8544ddac5bc3839145e463","d391c8b6e56a43a7b654e9dee02d904b",22860435,1,13,0,409,91,103,12
"00ae5f0c51874a73a41ebea838d95682","00ae5f0c51874a73a41ebea838d95682",22860435,8,0,1,411,101,101,0
"d391c8b6e56a43a7b654e9dee02d904b","d391c8b6e56a43a7b654e9dee02d904b",22860435,12,0,1,415,103,103,0
"00ae5f0c51874a73a41ebea838d95682","6111116566fc4fd9abba409322bea245",22860435,1,3,0,435,101,104,3
"6111116566fc4fd9abba409322bea245","6111116566fc4fd9abba409322bea245",22860435,2,0,1,436,104,104,0
"6111116566fc4fd9abba409322bea245","00ae5f0c51874a73a41ebea838d95682",22860435,1,-3,0,438,104,101,-3
"00ae5f0c51874a73a41ebea838d95682","2d4e0ab0ef3b4d73b82c72d4621a7579",22860435,1,5,0,439,101,106,5
"2d4e0ab0ef3b4d73b82c72d4621a7579","2d4e0ab0ef3b4d73b82c72d4621a7579",22860435,2,0,1,440,106,106,0
"2d4e0ab0ef3b4d73b82c72d4621a7579","00ae5f0c51874a73a41ebea838d95682",22860435,1,-5,0,442,106,101,-5
"00ae5f0c51874a73a41ebea838d95682","a81b2235cb9c499eb9ea8ee0a8dd9725",22860435,1,4,0,443,101,105,4
"a81b2235cb9c499eb9ea8ee0a8dd9725","a81b2235cb9c499eb9ea8ee0a8dd9725",22860435,2,0,1,444,105,105,0
"a81b2235cb9c499eb9ea8ee0a8dd9725","00ae5f0c51874a73a41ebea838d95682",22860435,1,-4,0,446,105,101,-4
"00ae5f0c51874a73a41ebea838d95682","8bdebf492ebd4e62b0d522e8ab5e5197",22860435,1,6,0,447,101,107,6
"8bdebf492ebd4e62b0d522e8ab5e5197","8bdebf492ebd4e62b0d522e8ab5e5197",22860435,2,0,1,448,107,107,0
"8bdebf492ebd4e62b0d522e8ab5e5197","73039f8c1eb9409cb4caee2cf968001e",22860435,1,-7,0,450,107,100,-7
"4280927ec4d643238aa49c32f9e06c6c","00ae5f0c51874a73a41ebea838d95682",22860435,3,-9,0,452,109,101,-8
"00ae5f0c51874a73a41ebea838d95682","08111f75e22d409998cf8b85bd431f0a",22860435,3,8,0,453,101,108,7
"08111f75e22d409998cf8b85bd431f0a","d391c8b6e56a43a7b654e9dee02d904b",22860435,3,-6,0,454,108,103,-5
"d391c8b6e56a43a7b654e9dee02d904b","73039f8c1eb9409cb4caee2cf968001e",22860435,2,-3,0,455,103,100,-3
"4280927ec4d643238aa49c32f9e06c6c","fc44e6a5f7654430af1227838224dceb",22860435,1,2,0,458,109,111,2
"fc44e6a5f7654430af1227838224dceb","fc44e6a5f7654430af1227838224dceb",22860435,8,0,1,459,111,111,0
"fc44e6a5f7654430af1227838224dceb","08111f75e22d409998cf8b85bd431f0a",22860435,1,-3,0,467,111,108,-3
"a9ae0a3c070d455bb4369a8996313336","e20db35ced8544ddac5bc3839145e463",22860435,5,-26,0,470,114,91,-23
"e20db35ced8544ddac5bc3839145e463","a9ae0a3c070d455bb4369a8996313336",22860435,6,26,0,471,91,114,23
"37319e88176d4aefa91d7a9980dbae91","4280927ec4d643238aa49c32f9e06c6c",22860435,4,-4,0,475,112,109,-3
"08111f75e22d409998cf8b85bd431f0a","d646286c8051419bbc2e31dd1db55ca8",22860435,1,-49,0,477,108,67,-41
"e20db35ced8544ddac5bc3839145e463","6a9f0ef185fb47f0937e29daa1c71ed5",22860435,1,-3,0,479,91,90,-1
"a9ae0a3c070d455bb4369a8996313336","71cec822bcff4f30a20e75dc63ef7b65",22860435,1,2,0,500,114,116,2
"71cec822bcff4f30a20e75dc63ef7b65","71cec822bcff4f30a20e75dc63ef7b65",22860435,3,0,1,501,116,116,0
"71cec822bcff4f30a20e75dc63ef7b65","37319e88176d4aefa91d7a9980dbae91",22860435,1,-4,0,504,116,112,-4
"62bff51286ef4f348717a3cf6fe2318f","37319e88176d4aefa91d7a9980dbae91",22860435,1,-9,0,506,120,112,-8
"00ae5f0c51874a73a41ebea838d95682","b1cd0e7dc3ad4a8eb91a4bfdbeb025b0",22860435,1,20,0,516,101,118,17
"b1cd0e7dc3ad4a8eb91a4bfdbeb025b0","b1cd0e7dc3ad4a8eb91a4bfdbeb025b0",22860435,1,0,1,517,118,118,0
"b1cd0e7dc3ad4a8eb91a4bfdbeb025b0","62bff51286ef4f348717a3cf6fe2318f",22860435,1,2,0,518,118,120,2
"e20db35ced8544ddac5bc3839145e463","73039f8c1eb9409cb4caee2cf968001e",22860435,1,10,0,524,91,100,9
"73039f8c1eb9409cb4caee2cf968001e","62bff51286ef4f348717a3cf6fe2318f",22860435,2,23,0,525,100,120,20
"e20db35ced8544ddac5bc3839145e463","ae26e6cda8ad4a3f81bd347560d9579f",22860435,1,40,0,530,91,125,34
"ae26e6cda8ad4a3f81bd347560d9579f","ae26e6cda8ad4a3f81bd347560d9579f",22860435,1,0,1,531,125,125,0
"ae26e6cda8ad4a3f81bd347560d9579f","ee48df95832b4374aa273ceb27ec1315",22860435,1,1,0,532,125,126,1
"ee48df95832b4374aa273ceb27ec1315","ee48df95832b4374aa273ceb27ec1315",22860435,1,0,1,533,126,126,0
"ee48df95832b4374aa273ceb27ec1315","7a439da90b394756ad1777fc4c6dead5",22860435,1,1,0,534,126,127,1
"7a439da90b394756ad1777fc4c6dead5","7a439da90b394756ad1777fc4c6dead5",22860435,1,0,1,535,127,127,0
"7a439da90b394756ad1777fc4c6dead5","a8dd5213034441ac92724b4e83eb0bb2",22860435,1,3,0,536,127,129,2
"a8dd5213034441ac92724b4e83eb0bb2","779f9ddd1fd14d1e9e69f72219a1fdbd",22860435,1,-9,0,537,129,121,-8
"779f9ddd1fd14d1e9e69f72219a1fdbd","779f9ddd1fd14d1e9e69f72219a1fdbd",22860435,1,0,1,538,121,121,0
"a8dd5213034441ac92724b4e83eb0bb2","8115eab6556b45f5b415c3b8c26a12e5",22860435,1,2,0,542,129,131,2
"8115eab6556b45f5b415c3b8c26a12e5","8115eab6556b45f5b415c3b8c26a12e5",22860435,2,0,1,543,131,131,0
"8115eab6556b45f5b415c3b8c26a12e5","ec34b06efd844b46a4c4818ecdb9b8f4",22860435,1,1,0,545,131,132,1
"ec34b06efd844b46a4c4818ecdb9b8f4","ec34b06efd844b46a4c4818ecdb9b8f4",22860435,4,0,1,546,132,132,0
"ec34b06efd844b46a4c4818ecdb9b8f4","a8dd5213034441ac92724b4e83eb0bb2",22860435,1,-3,0,548,132,129,-3
"a8dd5213034441ac92724b4e83eb0bb2","ec34b06efd844b46a4c4818ecdb9b8f4",22860435,1,3,0,549,129,132,3
"ec34b06efd844b46a4c4818ecdb9b8f4","c2e1c2b9eac64109b343a088584b576b",22860435,1,1,0,552,132,133,1
"c2e1c2b9eac64109b343a088584b576b","c2e1c2b9eac64109b343a088584b576b",22860435,2,0,1,553,133,133,0
"c2e1c2b9eac64109b343a088584b576b","579338175e0b4bbb8ef3b712b5d8b54e",22860435,1,-5,0,555,133,128,-5
"579338175e0b4bbb8ef3b712b5d8b54e","579338175e0b4bbb8ef3b712b5d8b54e",22860435,1,0,1,556,128,128,0
"579338175e0b4bbb8ef3b712b5d8b54e","a8dd5213034441ac92724b4e83eb0bb2",22860435,1,1,0,557,128,129,1
"a8dd5213034441ac92724b4e83eb0bb2","b416d47c56a742199b5d7c7f19d6503a",22860435,1,6,0,558,129,134,5
"b416d47c56a742199b5d7c7f19d6503a","a8dd5213034441ac92724b4e83eb0bb2",22860435,2,-6,0,559,134,129,-5
"579338175e0b4bbb8ef3b712b5d8b54e","8bc5795d6a984a3eace4e2811e52dd4f",22860435,1,8,0,561,128,135,7
"8bc5795d6a984a3eace4e2811e52dd4f","8bc5795d6a984a3eace4e2811e52dd4f",22860435,1,0,1,562,135,135,0
"8bc5795d6a984a3eace4e2811e52dd4f","b416d47c56a742199b5d7c7f19d6503a",22860435,1,-1,0,563,135,134,-1
"b416d47c56a742199b5d7c7f19d6503a","b416d47c56a742199b5d7c7f19d6503a",22860435,1,0,1,564,134,134,0
"6c5ad271a44743479bfaea29b1db8d02","779f9ddd1fd14d1e9e69f72219a1fdbd",22860435,3,-27,0,568,143,121,-22
"779f9ddd1fd14d1e9e69f72219a1fdbd","df1de691dafe4549a18a4398ee9dfaf9",22860435,2,23,0,569,121,139,18
"df1de691dafe4549a18a4398ee9dfaf9","cd4532ad48034873ba8bce2aac0c9808",22860435,1,-4,0,570,139,137,-2
"cd4532ad48034873ba8bce2aac0c9808","cd4532ad48034873ba8bce2aac0c9808",22860435,1,0,1,571,137,137,0
"cd4532ad48034873ba8bce2aac0c9808","df1de691dafe4549a18a4398ee9dfaf9",22860435,1,4,0,572,137,139,2
"6c5ad271a44743479bfaea29b1db8d02","83d311bed5374fee83d8d67a7d9d82dc",22860435,1,1,0,576,143,144,1
"83d311bed5374fee83d8d67a7d9d82dc","83d311bed5374fee83d8d67a7d9d82dc",22860435,1,0,1,577,144,144,0
"83d311bed5374fee83d8d67a7d9d82dc","402bba41861d43acb52a5abb89e8831e",22860435,1,1,0,578,144,145,1
"402bba41861d43acb52a5abb89e8831e","402bba41861d43acb52a5abb89e8831e",22860435,2,0,1,579,145,145,0
"402bba41861d43acb52a5abb89e8831e","8aae34f5ddbb4052a709b12e6b0d40fa",22860435,1,3,0,581,145,147,2
"8aae34f5ddbb4052a709b12e6b0d40fa","8aae34f5ddbb4052a709b12e6b0d40fa",22860435,3,0,1,584,147,147,0
"8aae34f5ddbb4052a709b12e6b0d40fa","645b3f0249f64f76af2e19eb4d0e55b7",22860435,1,2,0,585,147,149,2
"645b3f0249f64f76af2e19eb4d0e55b7","645b3f0249f64f76af2e19eb4d0e55b7",22860435,2,0,1,586,149,149,0
"645b3f0249f64f76af2e19eb4d0e55b7","df1de691dafe4549a18a4398ee9dfaf9",22860435,1,-11,0,588,149,139,-10
"8aae34f5ddbb4052a709b12e6b0d40fa","8956d210ae7f41968fada86d4c979d6a",22860435,1,4,0,596,147,151,4
"8956d210ae7f41968fada86d4c979d6a","8956d210ae7f41968fada86d4c979d6a",22860435,2,0,1,597,151,151,0
"8956d210ae7f41968fada86d4c979d6a","7e7b8db5064d4369805ab370aac5ddfb",22860435,1,-1,0,599,151,150,-1
"7e7b8db5064d4369805ab370aac5ddfb","7e7b8db5064d4369805ab370aac5ddfb",22860435,2,0,1,600,150,150,0
"7e7b8db5064d4369805ab370aac5ddfb","f902b0f41b544d4dbf79664fd233648d",22860435,1,-4,0,602,150,146,-4
"f902b0f41b544d4dbf79664fd233648d","ae781e8b775e4ccd93bc800dad5c8376",22860435,1,8,0,603,146,153,7
"ae781e8b775e4ccd93bc800dad5c8376","ae781e8b775e4ccd93bc800dad5c8376",22860435,2,0,1,604,153,153,0
"ae781e8b775e4ccd93bc800dad5c8376","f902b0f41b544d4dbf79664fd233648d",22860435,1,-8,0,606,153,146,-7
"f902b0f41b544d4dbf79664fd233648d","06882a8492d9499aa31555567f575ecb",22860435,1,9,0,607,146,154,8
"06882a8492d9499aa31555567f575ecb","06882a8492d9499aa31555567f575ecb",22860435,1,0,1,608,154,154,0
"06882a8492d9499aa31555567f575ecb","f293c508f409466a8f27ddd7d1e40b20",22860435,1,1,0,609,154,155,1
"f293c508f409466a8f27ddd7d1e40b20","f293c508f409466a8f27ddd7d1e40b20",22860435,5,0,1,610,155,155,0
"f293c508f409466a8f27ddd7d1e40b20","cc4ddef5bbbe48ebb605141b347c4ed1",22860435,1,1,0,615,155,156,1
"cc4ddef5bbbe48ebb605141b347c4ed1","cc4ddef5bbbe48ebb605141b347c4ed1",22860435,3,0,1,616,156,156,0
"cc4ddef5bbbe48ebb605141b347c4ed1","f03480cf4eba413194d7af52fc0e7f28",22860435,1,-4,0,619,156,152,-4
"f03480cf4eba413194d7af52fc0e7f28","d313cec988a84645bee413e8d4724a4b",22860435,2,7,0,620,152,158,6
"d313cec988a84645bee413e8d4724a4b","dc60696c76a74368a60f72246e47700d",22860435,1,1,0,625,158,159,1
"dc60696c76a74368a60f72246e47700d","dc60696c76a74368a60f72246e47700d",22860435,1,0,1,626,159,159,0
"dc60696c76a74368a60f72246e47700d","78adeee1fa2c4fe0bc73f7bca9fcee86",22860435,1,3,0,627,159,160,1
"df1de691dafe4549a18a4398ee9dfaf9","78adeee1fa2c4fe0bc73f7bca9fcee86",22860435,3,26,0,629,139,160,21
"65202579580f4ad38d734b4ee39d22a8","8959e6304a0348309a771e4d08d1b64a",22860435,3,-1,0,638,164,163,-1
"8959e6304a0348309a771e4d08d1b64a","78adeee1fa2c4fe0bc73f7bca9fcee86",22860435,3,-4,0,639,163,160,-3
"3cbcea2be0984e7dbd5a48195af10ce7","78adeee1fa2c4fe0bc73f7bca9fcee86",22860435,4,-8,0,652,165,160,-5
"65202579580f4ad38d734b4ee39d22a8","d313cec988a84645bee413e8d4724a4b",22860435,1,-9,0,661,164,158,-6
"d313cec988a84645bee413e8d4724a4b","df1de691dafe4549a18a4398ee9dfaf9",22860435,2,-22,0,665,158,139,-19
"78adeee1fa2c4fe0bc73f7bca9fcee86","8959e6304a0348309a771e4d08d1b64a",22860435,1,4,0,667,160,163,3
"8959e6304a0348309a771e4d08d1b64a","3cbcea2be0984e7dbd5a48195af10ce7",22860435,1,4,0,668,163,165,2
"82e6285962b8400d9d6fc32436022a94","78adeee1fa2c4fe0bc73f7bca9fcee86",22860435,3,-10,0,670,167,160,-7
"3cbcea2be0984e7dbd5a48195af10ce7","65202579580f4ad38d734b4ee39d22a8",22860435,2,-3,0,672,165,164,-1
"65202579580f4ad38d734b4ee39d22a8","3cbcea2be0984e7dbd5a48195af10ce7",22860435,2,3,0,680,164,165,1
"78adeee1fa2c4fe0bc73f7bca9fcee86","82e6285962b8400d9d6fc32436022a94",22860435,2,10,0,682,160,167,7
"df1de691dafe4549a18a4398ee9dfaf9","d313cec988a84645bee413e8d4724a4b",22860435,4,22,0,708,139,158,19
"d313cec988a84645bee413e8d4724a4b","f4ce60b4a944484082ccb701b48b3da1",22860435,3,-1,0,711,158,157,-1
"f4ce60b4a944484082ccb701b48b3da1","f03480cf4eba413194d7af52fc0e7f28",22860435,2,-6,0,712,157,152,-5
"f03480cf4eba413194d7af52fc0e7f28","6c5ad271a44743479bfaea29b1db8d02",22860435,1,-11,0,713,152,143,-9
"df1de691dafe4549a18a4398ee9dfaf9","a8dd5213034441ac92724b4e83eb0bb2",22860435,1,-14,0,716,139,129,-10
"a8dd5213034441ac92724b4e83eb0bb2","f661500307d74c908e9207d949ceb4aa",22860435,1,9,0,717,129,136,7
"f661500307d74c908e9207d949ceb4aa","a8dd5213034441ac92724b4e83eb0bb2",22860435,1,-9,0,718,136,129,-7
"579338175e0b4bbb8ef3b712b5d8b54e","779f9ddd1fd14d1e9e69f72219a1fdbd",22860435,1,-8,0,720,128,121,-7
"e20db35ced8544ddac5bc3839145e463","62bff51286ef4f348717a3cf6fe2318f",22860435,3,33,0,722,91,120,29
"62bff51286ef4f348717a3cf6fe2318f","3ec3a3563847406fa73338f9e9999cf3",22860435,2,-3,0,725,120,117,-3
"3ec3a3563847406fa73338f9e9999cf3","a9ae0a3c070d455bb4369a8996313336",22860435,2,-4,0,726,117,114,-3
"73039f8c1eb9409cb4caee2cf968001e","00ae5f0c51874a73a41ebea838d95682",22860435,1,1,0,733,100,101,1
"62bff51286ef4f348717a3cf6fe2318f","e20db35ced8544ddac5bc3839145e463",22860435,1,-33,0,736,120,91,-29
"779f9ddd1fd14d1e9e69f72219a1fdbd","b416d47c56a742199b5d7c7f19d6503a",22860435,1,15,0,742,121,134,13
"6c5ad271a44743479bfaea29b1db8d02","df1de691dafe4549a18a4398ee9dfaf9",22860435,1,-4,0,746,143,139,-4
"78adeee1fa2c4fe0bc73f7bca9fcee86","78adeee1fa2c4fe0bc73f7bca9fcee86",22860435,1,0,1,752,160,160,0
"82e6285962b8400d9d6fc32436022a94","a9ac840f098c4bd0a2ee896214ce29cd",22860435,3,3,0,818,167,168,1
"a9ac840f098c4bd0a2ee896214ce29cd","3cbcea2be0984e7dbd5a48195af10ce7",22860435,4,-5,0,819,168,165,-3
"f4ce60b4a944484082ccb701b48b3da1","8aae34f5ddbb4052a709b12e6b0d40fa",22860435,1,-12,0,843,157,147,-10
"f03480cf4eba413194d7af52fc0e7f28","f902b0f41b544d4dbf79664fd233648d",22860435,1,-7,0,851,152,146,-6
"f902b0f41b544d4dbf79664fd233648d","8aae34f5ddbb4052a709b12e6b0d40fa",22860435,1,1,0,852,146,147,1
"df1de691dafe4549a18a4398ee9dfaf9","6c5ad271a44743479bfaea29b1db8d02",22860435,1,4,0,854,139,143,4
"779f9ddd1fd14d1e9e69f72219a1fdbd","f661500307d74c908e9207d949ceb4aa",22860435,1,18,0,856,121,136,15
"f661500307d74c908e9207d949ceb4aa","b416d47c56a742199b5d7c7f19d6503a",22860435,1,-3,0,857,136,134,-2
"a8dd5213034441ac92724b4e83eb0bb2","e20db35ced8544ddac5bc3839145e463",22860435,1,-45,0,859,129,91,-38
"779f9ddd1fd14d1e9e69f72219a1fdbd","579338175e0b4bbb8ef3b712b5d8b54e",22860435,1,8,0,861,121,128,7
"579338175e0b4bbb8ef3b712b5d8b54e","e20db35ced8544ddac5bc3839145e463",22860435,1,-44,0,862,128,91,-37
"37319e88176d4aefa91d7a9980dbae91","56586aa865414f538729c7f7735d2bc6",22860435,1,-148,0,871,112,12,-100
"3f1c815879794b929260d224becaff7e","b7f2b31585d94eb3bf86376714aa7070",22860435,1,-2,0,892,14,13,-1
"56586aa865414f538729c7f7735d2bc6","3f1c815879794b929260d224becaff7e",22860435,1,4,0,898,12,14,2
"3f1c815879794b929260d224becaff7e","81c864a886d54a6b8ff85f7d736f4f95",22860435,1,2,0,899,14,15,1
"81c864a886d54a6b8ff85f7d736f4f95","3f1c815879794b929260d224becaff7e",22860435,1,-2,0,900,15,14,-1
"3f1c815879794b929260d224becaff7e","5c5ceeee4562457ba6d41515aeebfbb1",22860435,1,6,0,901,14,17,3
"5c5ceeee4562457ba6d41515aeebfbb1","81c864a886d54a6b8ff85f7d736f4f95",22860435,1,-4,0,902,17,15,-2
"81c864a886d54a6b8ff85f7d736f4f95","56586aa865414f538729c7f7735d2bc6",22860435,1,-6,0,903,15,12,-3
"9afd71a5298d4333b6849dfce1b9422c","78adeee1fa2c4fe0bc73f7bca9fcee86",22860435,1,196,0,905,18,160,142
"3cbcea2be0984e7dbd5a48195af10ce7","3cbcea2be0984e7dbd5a48195af10ce7",22860435,1,0,1,921,165,165,0
"a9ac840f098c4bd0a2ee896214ce29cd","78adeee1fa2c4fe0bc73f7bca9fcee86",22860435,1,-13,0,925,168,160,-8
"a9ac840f098c4bd0a2ee896214ce29cd","a49d1bb4328949299686242fd0be5584",22860435,1,-203,0,941,168,21,-147
"b7719e26494940efa49512aedd0aac79","78adeee1fa2c4fe0bc73f7bca9fcee86",22860435,1,192,0,947,20,160,140
"65202579580f4ad38d734b4ee39d22a8","0c7262dff33c4087bc660ccf40f92f9c",22860435,1,12,0,956,164,169,5
"b2275c3fad834f8d90737a2d9a6927d6","b2275c3fad834f8d90737a2d9a6927d6",22860435,214,0,1,1000,172,172,0
"b2275c3fad834f8d90737a2d9a6927d6","a9ac840f098c4bd0a2ee896214ce29cd",22860435,1,-7,0,1015,172,168,-4
"a9ac840f098c4bd0a2ee896214ce29cd","0c7262dff33c4087bc660ccf40f92f9c",22860435,5,4,0,1016,168,169,1
"0c7262dff33c4087bc660ccf40f92f9c","a9ac840f098c4bd0a2ee896214ce29cd",22860435,3,-4,0,1017,169,168,-1
"0c7262dff33c4087bc660ccf40f92f9c","b2275c3fad834f8d90737a2d9a6927d6",22860435,12,3,0,1019,169,172,3
"b2275c3fad834f8d90737a2d9a6927d6","0c7262dff33c4087bc660ccf40f92f9c",22860435,8,-3,0,1020,172,169,-3
"a9ac840f098c4bd0a2ee896214ce29cd","a9ac840f098c4bd0a2ee896214ce29cd",22860435,6,0,1,1024,168,168,0
"b2275c3fad834f8d90737a2d9a6927d6","eb515a26030b41f8a82a1e6114420bad",22860435,1,1,0,1092,172,173,1
"eb515a26030b41f8a82a1e6114420bad","eb515a26030b41f8a82a1e6114420bad",22860435,2,0,1,1093,173,173,0
"eb515a26030b41f8a82a1e6114420bad","b2275c3fad834f8d90737a2d9a6927d6",22860435,1,-1,0,1095,173,172,-1
"b2275c3fad834f8d90737a2d9a6927d6","b42cc17b7de840f181a704558d0bc845",22860435,4,4,0,1115,172,175,3
"b42cc17b7de840f181a704558d0bc845","0c7262dff33c4087bc660ccf40f92f9c",22860435,7,-7,0,1116,175,169,-6
"0c7262dff33c4087bc660ccf40f92f9c","b42cc17b7de840f181a704558d0bc845",22860435,9,7,0,1117,169,175,6
"b42cc17b7de840f181a704558d0bc845","362fcb0699a14845ab29b2340093e528",22860435,3,-1,0,1129,175,174,-1
"362fcb0699a14845ab29b2340093e528","b2275c3fad834f8d90737a2d9a6927d6",22860435,2,-3,0,1130,174,172,-2
"b42cc17b7de840f181a704558d0bc845","b42cc17b7de840f181a704558d0bc845",22860435,3,0,1,1177,175,175,0
"b42cc17b7de840f181a704558d0bc845","801f9e9135034f49bf5f8b4bdefedb41",22860435,1,2,0,1180,175,177,2
"801f9e9135034f49bf5f8b4bdefedb41","801f9e9135034f49bf5f8b4bdefedb41",22860435,8,0,1,1181,177,177,0
"801f9e9135034f49bf5f8b4bdefedb41","ea38cc0e6e6e41edbabf210220808bf9",22860435,1,3,0,1189,177,179,2
"ea38cc0e6e6e41edbabf210220808bf9","362fcb0699a14845ab29b2340093e528",22860435,3,-6,0,1190,179,174,-5
"362fcb0699a14845ab29b2340093e528","b87c552dd247427abe6ab5795b9c9d43",22860435,3,8,0,1191,174,181,7
"b87c552dd247427abe6ab5795b9c9d43","ea38cc0e6e6e41edbabf210220808bf9",22860435,2,-2,0,1192,181,179,-2
"ea38cc0e6e6e41edbabf210220808bf9","ea38cc0e6e6e41edbabf210220808bf9",22860435,1,0,1,1193,179,179,0
"ea38cc0e6e6e41edbabf210220808bf9","b87c552dd247427abe6ab5795b9c9d43",22860435,2,2,0,1194,179,181,2
"b87c552dd247427abe6ab5795b9c9d43","b87c552dd247427abe6ab5795b9c9d43",22860435,7,0,1,1195,181,181,0
"b87c552dd247427abe6ab5795b9c9d43","139b097acfca451689d80c9c6eebdf7b",22860435,3,-3,0,1202,181,178,-3
"139b097acfca451689d80c9c6eebdf7b","30f660a1feb34582a739722532524f79",22860435,1,6,0,1203,178,183,5
"30f660a1feb34582a739722532524f79","30f660a1feb34582a739722532524f79",22860435,5,0,1,1204,183,183,0
"30f660a1feb34582a739722532524f79","2024b4885bd14338a39b7b509acbbd02",22860435,1,-1,0,1209,183,182,-1
"2024b4885bd14338a39b7b509acbbd02","c3f63fe50d8e487c86bf8ef76c9cadd3",22860435,1,4,0,1210,182,185,3
"c3f63fe50d8e487c86bf8ef76c9cadd3","c3f63fe50d8e487c86bf8ef76c9cadd3",22860435,1,0,1,1211,185,185,0
"c3f63fe50d8e487c86bf8ef76c9cadd3","c8e371568a0c4391b25796ae4e91952e",22860435,1,3,0,1212,185,186,1
"c8e371568a0c4391b25796ae4e91952e","0c7262dff33c4087bc660ccf40f92f9c",22860435,1,-23,0,1213,186,169,-17
"0c7262dff33c4087bc660ccf40f92f9c","7d932b23e1c84326ae5aa4d3c0d813d1",22860435,1,25,0,1214,169,188,19
"7d932b23e1c84326ae5aa4d3c0d813d1","7d932b23e1c84326ae5aa4d3c0d813d1",22860435,1,0,1,1215,188,188,0
"7d932b23e1c84326ae5aa4d3c0d813d1","c8e371568a0c4391b25796ae4e91952e",22860435,1,-2,0,1216,188,186,-2
"c8e371568a0c4391b25796ae4e91952e","ab11d94c6c8948ea90b88f19d2cd502b",22860435,4,5,0,1217,186,190,4
"ab11d94c6c8948ea90b88f19d2cd502b","ab11d94c6c8948ea90b88f19d2cd502b",22860435,2,0,1,1218,190,190,0
"ab11d94c6c8948ea90b88f19d2cd502b","f992451ed6ad4e68bb9e68ad6be7c4be",22860435,1,2,0,1219,190,192,2
"f992451ed6ad4e68bb9e68ad6be7c4be","f992451ed6ad4e68bb9e68ad6be7c4be",22860435,1,0,1,1220,192,192,0
"f992451ed6ad4e68bb9e68ad6be7c4be","6cd2dcaac46847d4a0bc53f296d90375",22860435,1,3,0,1221,192,194,2
"6cd2dcaac46847d4a0bc53f296d90375","07b44a7a51e94c78b411c753fc39dab0",22860435,2,-6,0,1222,194,189,-5
"07b44a7a51e94c78b411c753fc39dab0","6cd2dcaac46847d4a0bc53f296d90375",22860435,4,6,0,1223,189,194,5
"6cd2dcaac46847d4a0bc53f296d90375","2d2580c9411c4972909db508d6956a58",22860435,1,2,0,1224,194,196,2
"2d2580c9411c4972909db508d6956a58","2d2580c9411c4972909db508d6956a58",22860435,8,0,1,1225,196,196,0
"2d2580c9411c4972909db508d6956a58","5bddb3d9ed264f3984702f048c7e5340",22860435,1,1,0,1233,196,197,1
"5bddb3d9ed264f3984702f048c7e5340","5bddb3d9ed264f3984702f048c7e5340",22860435,2,0,1,1234,197,197,0
"5bddb3d9ed264f3984702f048c7e5340","d5e8e2bd12a2466b9d6d90855f0eb079",22860435,1,1,0,1236,197,198,1
"d5e8e2bd12a2466b9d6d90855f0eb079","d5e8e2bd12a2466b9d6d90855f0eb079",22860435,2,0,1,1237,198,198,0
"d5e8e2bd12a2466b9d6d90855f0eb079","017d7ca8e0394b91aaadc9574df2202c",22860435,1,-5,0,1239,198,193,-5
"017d7ca8e0394b91aaadc9574df2202c","54e8e9f0ea3e45c4bf3b8ac799ee31b1",22860435,1,8,0,1240,193,200,7
"54e8e9f0ea3e45c4bf3b8ac799ee31b1","54e8e9f0ea3e45c4bf3b8ac799ee31b1",22860435,1,0,1,1241,200,200,0
"54e8e9f0ea3e45c4bf3b8ac799ee31b1","c614a00911be4877a075f19315530fb0",22860435,1,1,0,1242,200,201,1
"c614a00911be4877a075f19315530fb0","c614a00911be4877a075f19315530fb0",22860435,6,0,1,1243,201,201,0
"c614a00911be4877a075f19315530fb0","a6c21bd8b95249c7972820a7a7d76aff",22860435,1,1,0,1249,201,202,1
"a6c21bd8b95249c7972820a7a7d76aff","a6c21bd8b95249c7972820a7a7d76aff",22860435,1,0,1,1250,202,202,0
"a6c21bd8b95249c7972820a7a7d76aff","bb329d880ab54120adaf203a693bb203",22860435,1,1,0,1251,202,203,1
"bb329d880ab54120adaf203a693bb203","bb329d880ab54120adaf203a693bb203",22860435,1,0,1,1252,203,203,0
"bb329d880ab54120adaf203a693bb203","f9170dd6bc6442b4acd832747609b09a",22860435,1,-4,0,1253,203,199,-4
"f9170dd6bc6442b4acd832747609b09a","b54257a550b94ebc9538f3a90eee9d7e",22860435,1,6,0,1254,199,204,5
"b54257a550b94ebc9538f3a90eee9d7e","f9170dd6bc6442b4acd832747609b09a",22860435,2,-6,0,1255,204,199,-5
"f9170dd6bc6442b4acd832747609b09a","6cd2dcaac46847d4a0bc53f296d90375",22860435,2,-6,0,1256,199,194,-5
"6cd2dcaac46847d4a0bc53f296d90375","ab11d94c6c8948ea90b88f19d2cd502b",22860435,1,-5,0,1257,194,190,-4
"ab11d94c6c8948ea90b88f19d2cd502b","017d7ca8e0394b91aaadc9574df2202c",22860435,1,4,0,1258,190,193,3
"017d7ca8e0394b91aaadc9574df2202c","07b44a7a51e94c78b411c753fc39dab0",22860435,1,-5,0,1259,193,189,-4
"07b44a7a51e94c78b411c753fc39dab0","c8e371568a0c4391b25796ae4e91952e",22860435,1,-4,0,1260,189,186,-3
"c8e371568a0c4391b25796ae4e91952e","b54257a550b94ebc9538f3a90eee9d7e",22860435,1,22,0,1261,186,204,18
"6cd2dcaac46847d4a0bc53f296d90375","6cd2dcaac46847d4a0bc53f296d90375",22860435,1,0,1,1264,194,194,0
"6cd2dcaac46847d4a0bc53f296d90375","017d7ca8e0394b91aaadc9574df2202c",22860435,4,-1,0,1265,194,193,-1
"017d7ca8e0394b91aaadc9574df2202c","334c2344009840079b1d0e1b7ce3d5a7",22860435,1,14,0,1266,193,205,12
"334c2344009840079b1d0e1b7ce3d5a7","334c2344009840079b1d0e1b7ce3d5a7",22860435,1,0,1,1267,205,205,0
"334c2344009840079b1d0e1b7ce3d5a7","d7f13c8d63ec4e2aa673fbb9cf9c6933",22860435,1,3,0,1268,205,206,1
"d7f13c8d63ec4e2aa673fbb9cf9c6933","c8e371568a0c4391b25796ae4e91952e",22860435,2,-26,0,1269,206,186,-20
"c8e371568a0c4391b25796ae4e91952e","7108f0e4c2584f1f9c471689ae4c885c",22860435,2,28,0,1270,186,208,22
"7108f0e4c2584f1f9c471689ae4c885c","b9e80f77c3a44349863b19875725c384",22860435,3,-1,0,1271,208,207,-1
"b9e80f77c3a44349863b19875725c384","b9e80f77c3a44349863b19875725c384",22860435,16,0,1,1272,207,207,0
"b9e80f77c3a44349863b19875725c384","7108f0e4c2584f1f9c471689ae4c885c",22860435,1,1,0,1288,207,208,1
"7108f0e4c2584f1f9c471689ae4c885c","7108f0e4c2584f1f9c471689ae4c885c",22860435,10,0,1,1289,208,208,0
"7108f0e4c2584f1f9c471689ae4c885c","09400e101c5d4b439cf9a26b03aae558",22860435,1,3,0,1299,208,210,2
"09400e101c5d4b439cf9a26b03aae558","d7f13c8d63ec4e2aa673fbb9cf9c6933",22860435,1,-5,0,1300,210,206,-4
"d7f13c8d63ec4e2aa673fbb9cf9c6933","09400e101c5d4b439cf9a26b03aae558",22860435,5,5,0,1301,206,210,4
"09400e101c5d4b439cf9a26b03aae558","09400e101c5d4b439cf9a26b03aae558",22860435,8,0,1,1302,210,210,0
"09400e101c5d4b439cf9a26b03aae558","a88efa7e50ce47159810ab553afa6d3a",22860435,2,2,0,1308,210,212,2
"a88efa7e50ce47159810ab553afa6d3a","a88efa7e50ce47159810ab553afa6d3a",22860435,7,0,1,1309,212,212,0
"a88efa7e50ce47159810ab553afa6d3a","be502a7a43c44bf7b682698de79d9369",22860435,2,3,0,1314,212,214,2
"be502a7a43c44bf7b682698de79d9369","f7fb1952f56b4189b86a9f8b7862d2b8",22860435,4,1,0,1315,214,215,1
"f7fb1952f56b4189b86a9f8b7862d2b8","a875096404ef4a9984b62d74cda916f9",22860435,1,-7,0,1316,215,209,-6
"a875096404ef4a9984b62d74cda916f9","be502a7a43c44bf7b682698de79d9369",22860435,3,6,0,1317,209,214,5
"f7fb1952f56b4189b86a9f8b7862d2b8","f7fb1952f56b4189b86a9f8b7862d2b8",22860435,11,0,1,1319,215,215,0
"f7fb1952f56b4189b86a9f8b7862d2b8","b860ee85d8bc4a2f97958cfb71be3533",22860435,1,1,0,1330,215,216,1
"b860ee85d8bc4a2f97958cfb71be3533","b860ee85d8bc4a2f97958cfb71be3533",22860435,2,0,1,1331,216,216,0
"b860ee85d8bc4a2f97958cfb71be3533","ec341f459285443b8361f7f15638ff08",22860435,1,-3,0,1333,216,213,-3
"ec341f459285443b8361f7f15638ff08","363837c182e04711840d896ae1e0339c",22860435,2,6,0,1334,213,218,5
"363837c182e04711840d896ae1e0339c","363837c182e04711840d896ae1e0339c",22860435,13,0,1,1335,218,218,0
"363837c182e04711840d896ae1e0339c","01b2051f8941460d89945e3b02d1ce78",22860435,2,-1,0,1348,218,217,-1
"01b2051f8941460d89945e3b02d1ce78","09400e101c5d4b439cf9a26b03aae558",22860435,1,-9,0,1349,217,210,-7
"09400e101c5d4b439cf9a26b03aae558","be95c065e45447c1bd8215ea6f130c7a",22860435,1,12,0,1350,210,219,9
"be95c065e45447c1bd8215ea6f130c7a","a875096404ef4a9984b62d74cda916f9",22860435,1,-13,0,1351,219,209,-10
"a875096404ef4a9984b62d74cda916f9","f7fb1952f56b4189b86a9f8b7862d2b8",22860435,2,7,0,1352,209,215,6
"f7fb1952f56b4189b86a9f8b7862d2b8","be502a7a43c44bf7b682698de79d9369",22860435,2,-1,0,1353,215,214,-1
"be502a7a43c44bf7b682698de79d9369","ec341f459285443b8361f7f15638ff08",22860435,1,-1,0,1354,214,213,-1
"ec341f459285443b8361f7f15638ff08","91125ca626c5470eb145501f8c37f8db",22860435,1,9,0,1355,213,220,7
"91125ca626c5470eb145501f8c37f8db","91125ca626c5470eb145501f8c37f8db",22860435,1,0,1,1356,220,220,0
"91125ca626c5470eb145501f8c37f8db","1c6721b1f63f4d30ba7746ea8af02a52",22860435,1,3,0,1357,220,221,1
"1c6721b1f63f4d30ba7746ea8af02a52","d7f13c8d63ec4e2aa673fbb9cf9c6933",22860435,6,-21,0,1358,221,206,-15
"d7f13c8d63ec4e2aa673fbb9cf9c6933","77ecef8eff6b4a2caea7707669bf7475",22860435,4,22,0,1359,206,222,16
"77ecef8eff6b4a2caea7707669bf7475","1c6721b1f63f4d30ba7746ea8af02a52",22860435,2,-1,0,1360,222,221,-1
"d7f13c8d63ec4e2aa673fbb9cf9c6933","d7f13c8d63ec4e2aa673fbb9cf9c6933",22860435,1,0,1,1362,206,206,0
"d7f13c8d63ec4e2aa673fbb9cf9c6933","1c6721b1f63f4d30ba7746ea8af02a52",22860435,5,21,0,1363,206,221,15
"1c6721b1f63f4d30ba7746ea8af02a52","77ecef8eff6b4a2caea7707669bf7475",22860435,3,1,0,1364,221,222,1
"77ecef8eff6b4a2caea7707669bf7475","77ecef8eff6b4a2caea7707669bf7475",22860435,12,0,1,1365,222,222,0
"1c6721b1f63f4d30ba7746ea8af02a52","8b9ae98743bd4d4a8a87dff1c1244211",22860435,2,7,0,1378,221,227,6
"8b9ae98743bd4d4a8a87dff1c1244211","d03cb855c70044cf8c35d9ec0de696e3",22860435,6,-3,0,1379,227,224,-3
"d03cb855c70044cf8c35d9ec0de696e3","d03cb855c70044cf8c35d9ec0de696e3",22860435,3,0,1,1380,224,224,0
"d03cb855c70044cf8c35d9ec0de696e3","a49a937d6896486d9a5396654abcf2e1",22860435,1,2,0,1381,224,226,2
"a49a937d6896486d9a5396654abcf2e1","a49a937d6896486d9a5396654abcf2e1",22860435,5,0,1,1382,226,226,0
"a49a937d6896486d9a5396654abcf2e1","8b9ae98743bd4d4a8a87dff1c1244211",22860435,1,1,0,1387,226,227,1
"8b9ae98743bd4d4a8a87dff1c1244211","8b9ae98743bd4d4a8a87dff1c1244211",22860435,20,0,1,1388,227,227,0
"d03cb855c70044cf8c35d9ec0de696e3","8b9ae98743bd4d4a8a87dff1c1244211",22860435,2,3,0,1394,224,227,3
"8b9ae98743bd4d4a8a87dff1c1244211","f7906d6f59b9489a91d2ef40db5a474d",22860435,2,-4,0,1414,227,223,-4
"f7906d6f59b9489a91d2ef40db5a474d","2ab1535aac1346ba8801535bf729ef37",22860435,4,7,0,1415,223,229,6
"2ab1535aac1346ba8801535bf729ef37","2ab1535aac1346ba8801535bf729ef37",22860435,3,0,1,1416,229,229,0
"2ab1535aac1346ba8801535bf729ef37","a4f40fb48a8542c8949bae1f002cd9bc",22860435,1,2,0,1418,229,231,2
"a4f40fb48a8542c8949bae1f002cd9bc","a4f40fb48a8542c8949bae1f002cd9bc",22860435,8,0,1,1419,231,231,0
"a4f40fb48a8542c8949bae1f002cd9bc","2ab1535aac1346ba8801535bf729ef37",22860435,1,-2,0,1427,231,229,-2
"2ab1535aac1346ba8801535bf729ef37","8972c23e32044edb8a78fa1eed4e5947",22860435,1,3,0,1429,229,232,3
"8972c23e32044edb8a78fa1eed4e5947","8972c23e32044edb8a78fa1eed4e5947",22860435,1,0,1,1430,232,232,0
"8972c23e32044edb8a78fa1eed4e5947","92feb4a40f8344d38b6f722e42a53295",22860435,1,1,0,1431,232,233,1
"92feb4a40f8344d38b6f722e42a53295","92feb4a40f8344d38b6f722e42a53295",22860435,2,0,1,1432,233,233,0
"92feb4a40f8344d38b6f722e42a53295","5152833676bf4c6cb317060be10f68db",22860435,1,-5,0,1434,233,228,-5
"5152833676bf4c6cb317060be10f68db","79a35eea833e4c2c9d22fc53c3c6445c",22860435,1,9,0,1435,228,236,8
"79a35eea833e4c2c9d22fc53c3c6445c","79a35eea833e4c2c9d22fc53c3c6445c",22860435,4,0,1,1436,236,236,0
"79a35eea833e4c2c9d22fc53c3c6445c","ca3e28f290354c08aefe5b0f769604e6",22860435,1,-1,0,1440,236,235,-1
"ca3e28f290354c08aefe5b0f769604e6","ca3e28f290354c08aefe5b0f769604e6",22860435,9,0,1,1441,235,235,0
"ca3e28f290354c08aefe5b0f769604e6","2ab1535aac1346ba8801535bf729ef37",22860435,1,-7,0,1450,235,229,-6
"2ab1535aac1346ba8801535bf729ef37","0b04c8e2f86d48c7aeb7e225819cd32b",22860435,3,6,0,1451,229,234,5
"0b04c8e2f86d48c7aeb7e225819cd32b","2ab1535aac1346ba8801535bf729ef37",22860435,1,-6,0,1452,234,229,-5
"2ab1535aac1346ba8801535bf729ef37","5152833676bf4c6cb317060be10f68db",22860435,3,-1,0,1453,229,228,-1
"5152833676bf4c6cb317060be10f68db","8f68228b1518449e9615cdafee41a2bd",22860435,1,10,0,1454,228,237,9
"8f68228b1518449e9615cdafee41a2bd","8f68228b1518449e9615cdafee41a2bd",22860435,1,0,1,1455,237,237,0
"8f68228b1518449e9615cdafee41a2bd","cab89fa5c3ed45a5aa550fc0352d6a42",22860435,1,1,0,1456,237,238,1
"cab89fa5c3ed45a5aa550fc0352d6a42","cab89fa5c3ed45a5aa550fc0352d6a42",22860435,3,0,1,1457,238,238,0
"cab89fa5c3ed45a5aa550fc0352d6a42","66d4fad4f1cf4b46be0750a99ad7a35a",22860435,1,1,0,1460,238,239,1
"66d4fad4f1cf4b46be0750a99ad7a35a","66d4fad4f1cf4b46be0750a99ad7a35a",22860435,1,0,1,1461,239,239,0
"66d4fad4f1cf4b46be0750a99ad7a35a","0b04c8e2f86d48c7aeb7e225819cd32b",22860435,1,-5,0,1462,239,234,-5
"0b04c8e2f86d48c7aeb7e225819cd32b","f53da5fd9bfe412da4b80d4742563b6c",22860435,1,8,0,1463,234,241,7
"f53da5fd9bfe412da4b80d4742563b6c","f53da5fd9bfe412da4b80d4742563b6c",22860435,1,0,1,1464,241,241,0
"f53da5fd9bfe412da4b80d4742563b6c","1c6721b1f63f4d30ba7746ea8af02a52",22860435,1,-24,0,1465,241,221,-20
"1c6721b1f63f4d30ba7746ea8af02a52","2ae94c0cea4d480a9d5dca8fb1d7b542",22860435,3,27,0,1466,221,242,21
"2ae94c0cea4d480a9d5dca8fb1d7b542","1ebf23f9d994469a85206e4c7b1bf5f5",22860435,4,3,0,1467,242,245,3
"1ebf23f9d994469a85206e4c7b1bf5f5","0c7262dff33c4087bc660ccf40f92f9c",22860435,1,-100,0,1468,245,169,-76
"b2275c3fad834f8d90737a2d9a6927d6","a875096404ef4a9984b62d74cda916f9",22860435,1,50,0,1470,172,209,37
"a875096404ef4a9984b62d74cda916f9","d7f13c8d63ec4e2aa673fbb9cf9c6933",22860435,2,-4,0,1471,209,206,-3
"be502a7a43c44bf7b682698de79d9369","a875096404ef4a9984b62d74cda916f9",22860435,1,-6,0,1478,214,209,-5
"f7fb1952f56b4189b86a9f8b7862d2b8","ec341f459285443b8361f7f15638ff08",22860435,2,-2,0,1480,215,213,-2
"ec341f459285443b8361f7f15638ff08","d7f13c8d63ec4e2aa673fbb9cf9c6933",22860435,1,-9,0,1481,213,206,-7
"77ecef8eff6b4a2caea7707669bf7475","d03cb855c70044cf8c35d9ec0de696e3",22860435,1,3,0,1484,222,224,2
"d03cb855c70044cf8c35d9ec0de696e3","1c6721b1f63f4d30ba7746ea8af02a52",22860435,4,-4,0,1485,224,221,-3
"5152833676bf4c6cb317060be10f68db","0b04c8e2f86d48c7aeb7e225819cd32b",22860435,3,7,0,1490,228,234,6
"0b04c8e2f86d48c7aeb7e225819cd32b","2ae94c0cea4d480a9d5dca8fb1d7b542",22860435,2,11,0,1491,234,242,8
"2ae94c0cea4d480a9d5dca8fb1d7b542","1c6721b1f63f4d30ba7746ea8af02a52",22860435,2,-27,0,1492,242,221,-21
"1c6721b1f63f4d30ba7746ea8af02a52","1ebf23f9d994469a85206e4c7b1bf5f5",22860435,2,30,0,1493,221,245,24
"1ebf23f9d994469a85206e4c7b1bf5f5","d7f13c8d63ec4e2aa673fbb9cf9c6933",22860435,1,-51,0,1494,245,206,-39
"09400e101c5d4b439cf9a26b03aae558","a875096404ef4a9984b62d74cda916f9",22860435,3,-1,0,1496,210,209,-1
"77ecef8eff6b4a2caea7707669bf7475","8b9ae98743bd4d4a8a87dff1c1244211",22860435,4,6,0,1500,222,227,5
"1c6721b1f63f4d30ba7746ea8af02a52","f7906d6f59b9489a91d2ef40db5a474d",22860435,1,3,0,1503,221,223,2
"f7906d6f59b9489a91d2ef40db5a474d","5152833676bf4c6cb317060be10f68db",22860435,2,6,0,1504,223,228,5
"5152833676bf4c6cb317060be10f68db","2ab1535aac1346ba8801535bf729ef37",22860435,1,1,0,1505,228,229,1
"0b04c8e2f86d48c7aeb7e225819cd32b","1c6721b1f63f4d30ba7746ea8af02a52",22860435,2,-16,0,1507,234,221,-13
"1ebf23f9d994469a85206e4c7b1bf5f5","1ebf23f9d994469a85206e4c7b1bf5f5",22860435,10,0,1,1510,245,245,0
"1ebf23f9d994469a85206e4c7b1bf5f5","85ae675b83e8422da842cfd25596af99",22860435,1,1,0,1520,245,246,1
"85ae675b83e8422da842cfd25596af99","85ae675b83e8422da842cfd25596af99",22860435,1,0,1,1521,246,246,0
"85ae675b83e8422da842cfd25596af99","2ae94c0cea4d480a9d5dca8fb1d7b542",22860435,1,-4,0,1522,246,242,-4
"2ae94c0cea4d480a9d5dca8fb1d7b542","fa235f0f364d47e4ae1c87f47bf8e6ba",22860435,1,12,0,1523,242,252,10
"fa235f0f364d47e4ae1c87f47bf8e6ba","fa235f0f364d47e4ae1c87f47bf8e6ba",22860435,7,0,1,1524,252,252,0
"fa235f0f364d47e4ae1c87f47bf8e6ba","79f7845465cc4ed19d8e4f1429541be0",22860435,1,2,0,1526,252,254,2
"79f7845465cc4ed19d8e4f1429541be0","79f7845465cc4ed19d8e4f1429541be0",22860435,2,0,1,1527,254,254,0
"79f7845465cc4ed19d8e4f1429541be0","00f61990949545828dd12f1303d47504",22860435,1,3,0,1529,254,256,2
"00f61990949545828dd12f1303d47504","6e83e23f56544a19b94067c1c558d9c0",22860435,2,-11,0,1530,256,247,-9
"6e83e23f56544a19b94067c1c558d9c0","00f61990949545828dd12f1303d47504",22860435,6,11,0,1531,247,256,9
"00f61990949545828dd12f1303d47504","ead7bb4b64e247d2ae632ab8a296b091",22860435,1,2,0,1532,256,258,2
"ead7bb4b64e247d2ae632ab8a296b091","ead7bb4b64e247d2ae632ab8a296b091",22860435,2,0,1,1533,258,258,0
"ead7bb4b64e247d2ae632ab8a296b091","41b0048dde734bb280bac6116baa8e27",22860435,1,1,0,1535,258,259,1
"41b0048dde734bb280bac6116baa8e27","41b0048dde734bb280bac6116baa8e27",22860435,2,0,1,1536,259,259,0
"41b0048dde734bb280bac6116baa8e27","b41c5a094a604ee0915327da5cc0beb7",22860435,1,1,0,1538,259,260,1
"b41c5a094a604ee0915327da5cc0beb7","b41c5a094a604ee0915327da5cc0beb7",22860435,8,0,1,1539,260,260,0
"b41c5a094a604ee0915327da5cc0beb7","d546341988904f069cfa86b21457d9d9",22860435,1,-10,0,1547,260,251,-9
"d546341988904f069cfa86b21457d9d9","28c171777c52431ab6b925073bd63d46",22860435,1,15,0,1548,251,264,13
"28c171777c52431ab6b925073bd63d46","28c171777c52431ab6b925073bd63d46",22860435,3,0,1,1549,264,264,0
"28c171777c52431ab6b925073bd63d46","ac160db940cb49ae8579162b1d52bb5d",22860435,1,2,0,1552,264,266,2
"ac160db940cb49ae8579162b1d52bb5d","ac160db940cb49ae8579162b1d52bb5d",22860435,3,0,1,1553,266,266,0
"ac160db940cb49ae8579162b1d52bb5d","d989ebcfc12a4b669f0100dc1aa14f1e",22860435,1,-12,0,1556,266,255,-11
"d989ebcfc12a4b669f0100dc1aa14f1e","c6fd49b485cc4874b0bbdd9c6171e09c",22860435,1,15,0,1557,255,268,13
"c6fd49b485cc4874b0bbdd9c6171e09c","c6fd49b485cc4874b0bbdd9c6171e09c",22860435,7,0,1,1558,268,268,0
"c6fd49b485cc4874b0bbdd9c6171e09c","44240778a97c4af0937817499b75707b",22860435,1,1,0,1565,268,269,1
"44240778a97c4af0937817499b75707b","44240778a97c4af0937817499b75707b",22860435,2,0,1,1566,269,269,0
"44240778a97c4af0937817499b75707b","7aa76d3e993840d8805f097cbdbcd44b",22860435,1,-9,0,1568,269,261,-8
"7aa76d3e993840d8805f097cbdbcd44b","7028800abe7d4e27b613d1d6cbe26bf7",22860435,3,7,0,1569,261,267,6
"7028800abe7d4e27b613d1d6cbe26bf7","00f61990949545828dd12f1303d47504",22860435,1,-13,0,1570,267,256,-11
"00f61990949545828dd12f1303d47504","d546341988904f069cfa86b21457d9d9",22860435,7,-6,0,1571,256,251,-5
"d546341988904f069cfa86b21457d9d9","d989ebcfc12a4b669f0100dc1aa14f1e",22860435,6,5,0,1572,251,255,4
"d989ebcfc12a4b669f0100dc1aa14f1e","7aa76d3e993840d8805f097cbdbcd44b",22860435,10,7,0,1573,255,261,6
"7028800abe7d4e27b613d1d6cbe26bf7","7aa76d3e993840d8805f097cbdbcd44b",22860435,4,-7,0,1575,267,261,-6
"7aa76d3e993840d8805f097cbdbcd44b","865a4d3b43374da7944dc7d397f566d9",22860435,1,12,0,1576,261,271,10
"865a4d3b43374da7944dc7d397f566d9","2ae94c0cea4d480a9d5dca8fb1d7b542",22860435,2,-35,0,1577,271,242,-29
"2ae94c0cea4d480a9d5dca8fb1d7b542","7028800abe7d4e27b613d1d6cbe26bf7",22860435,1,30,0,1578,242,267,25
"7aa76d3e993840d8805f097cbdbcd44b","d989ebcfc12a4b669f0100dc1aa14f1e",22860435,2,-7,0,1582,261,255,-6
"d989ebcfc12a4b669f0100dc1aa14f1e","865a4d3b43374da7944dc7d397f566d9",22860435,1,19,0,1583,255,271,16
"865a4d3b43374da7944dc7d397f566d9","865a4d3b43374da7944dc7d397f566d9",22860435,1,0,1,1584,271,271,0
"2ae94c0cea4d480a9d5dca8fb1d7b542","0d987bed3ffa4ed0b9a2e62e97b7b30f",22860435,14,38,0,1586,242,272,30
"0d987bed3ffa4ed0b9a2e62e97b7b30f","2ae94c0cea4d480a9d5dca8fb1d7b542",22860435,10,-38,0,1587,272,242,-30
"0d987bed3ffa4ed0b9a2e62e97b7b30f","0d987bed3ffa4ed0b9a2e62e97b7b30f",22860435,5,0,1,1591,272,272,0
"0d987bed3ffa4ed0b9a2e62e97b7b30f","bb5a47f5ea01454a8b79455422d3b9da",22860435,14,10,0,1592,272,280,8
"bb5a47f5ea01454a8b79455422d3b9da","bb5a47f5ea01454a8b79455422d3b9da",22860435,168,0,1,1593,280,280,0
"bb5a47f5ea01454a8b79455422d3b9da","82ae07bc0c9b4570a41799290d1ef399",22860435,11,-6,0,1600,280,275,-5
"82ae07bc0c9b4570a41799290d1ef399","bc5524e78a8544e2ae2fdc2f3462bbec",22860435,1,5,0,1601,275,279,4
"bc5524e78a8544e2ae2fdc2f3462bbec","82ae07bc0c9b4570a41799290d1ef399",22860435,2,-5,0,1602,279,275,-4
"82ae07bc0c9b4570a41799290d1ef399","0d987bed3ffa4ed0b9a2e62e97b7b30f",22860435,1,-4,0,1603,275,272,-3
"82ae07bc0c9b4570a41799290d1ef399","bb5a47f5ea01454a8b79455422d3b9da",22860435,11,6,0,1612,275,280,5
"bb5a47f5ea01454a8b79455422d3b9da","bc5524e78a8544e2ae2fdc2f3462bbec",22860435,4,-1,0,1613,280,279,-1
"bc5524e78a8544e2ae2fdc2f3462bbec","0d987bed3ffa4ed0b9a2e62e97b7b30f",22860435,2,-9,0,1614,279,272,-7
"0d987bed3ffa4ed0b9a2e62e97b7b30f","fa235f0f364d47e4ae1c87f47bf8e6ba",22860435,1,-26,0,1627,272,252,-20
"fa235f0f364d47e4ae1c87f47bf8e6ba","7028800abe7d4e27b613d1d6cbe26bf7",22860435,1,18,0,1628,252,267,15
"7028800abe7d4e27b613d1d6cbe26bf7","fa235f0f364d47e4ae1c87f47bf8e6ba",22860435,1,-18,0,1629,267,252,-15
"fa235f0f364d47e4ae1c87f47bf8e6ba","6e83e23f56544a19b94067c1c558d9c0",22860435,2,-6,0,1635,252,247,-5
"6e83e23f56544a19b94067c1c558d9c0","2ae94c0cea4d480a9d5dca8fb1d7b542",22860435,2,-6,0,1636,247,242,-5
"bc5524e78a8544e2ae2fdc2f3462bbec","bb5a47f5ea01454a8b79455422d3b9da",22860435,1,1,0,1656,279,280,1
"bb5a47f5ea01454a8b79455422d3b9da","0d987bed3ffa4ed0b9a2e62e97b7b30f",22860435,5,-10,0,1681,280,272,-8
"bb5a47f5ea01454a8b79455422d3b9da","2ae94c0cea4d480a9d5dca8fb1d7b542",22860435,2,-48,0,1691,280,242,-38
"2ae94c0cea4d480a9d5dca8fb1d7b542","d989ebcfc12a4b669f0100dc1aa14f1e",22860435,4,16,0,1692,242,255,13
"d989ebcfc12a4b669f0100dc1aa14f1e","d989ebcfc12a4b669f0100dc1aa14f1e",22860435,1,0,1,1693,255,255,0
"7aa76d3e993840d8805f097cbdbcd44b","0d987bed3ffa4ed0b9a2e62e97b7b30f",22860435,7,15,0,1695,261,272,11
"bb5a47f5ea01454a8b79455422d3b9da","94cecc3f1e7d484b8e068e79241dfd73",22860435,6,3,0,1752,280,281,1
"94cecc3f1e7d484b8e068e79241dfd73","0d987bed3ffa4ed0b9a2e62e97b7b30f",22860435,6,-13,0,1753,281,272,-9
"0d987bed3ffa4ed0b9a2e62e97b7b30f","a37477c4e4c14169ad44b06b493007f6",22860435,6,15,0,1754,272,283,11
"a37477c4e4c14169ad44b06b493007f6","94cecc3f1e7d484b8e068e79241dfd73",22860435,2,-2,0,1755,283,281,-2
"94cecc3f1e7d484b8e068e79241dfd73","d989ebcfc12a4b669f0100dc1aa14f1e",22860435,1,-35,0,1756,281,255,-26
"d989ebcfc12a4b669f0100dc1aa14f1e","2ae94c0cea4d480a9d5dca8fb1d7b542",22860435,1,-16,0,1757,255,242,-13
"2ae94c0cea4d480a9d5dca8fb1d7b542","28c171777c52431ab6b925073bd63d46",22860435,1,26,0,1758,242,264,22
"28c171777c52431ab6b925073bd63d46","d989ebcfc12a4b669f0100dc1aa14f1e",22860435,1,-10,0,1759,264,255,-9
"d989ebcfc12a4b669f0100dc1aa14f1e","00f61990949545828dd12f1303d47504",22860435,2,1,0,1760,255,256,1
"7aa76d3e993840d8805f097cbdbcd44b","2ae94c0cea4d480a9d5dca8fb1d7b542",22860435,2,-23,0,1764,261,242,-19
"0d987bed3ffa4ed0b9a2e62e97b7b30f","94cecc3f1e7d484b8e068e79241dfd73",22860435,3,13,0,1777,272,281,9
"94cecc3f1e7d484b8e068e79241dfd73","a37477c4e4c14169ad44b06b493007f6",22860435,2,2,0,1778,281,283,2
"a37477c4e4c14169ad44b06b493007f6","0d987bed3ffa4ed0b9a2e62e97b7b30f",22860435,1,-15,0,1779,283,272,-11
"94cecc3f1e7d484b8e068e79241dfd73","bb5a47f5ea01454a8b79455422d3b9da",22860435,1,-3,0,1781,281,280,-1
"82ae07bc0c9b4570a41799290d1ef399","2ae94c0cea4d480a9d5dca8fb1d7b542",22860435,1,-42,0,1791,275,242,-33
"0d987bed3ffa4ed0b9a2e62e97b7b30f","7028800abe7d4e27b613d1d6cbe26bf7",22860435,1,-8,0,1793,272,267,-5
"d546341988904f069cfa86b21457d9d9","d546341988904f069cfa86b21457d9d9",22860435,1,0,1,1798,251,251,0
"d546341988904f069cfa86b21457d9d9","00f61990949545828dd12f1303d47504",22860435,2,6,0,1799,251,256,5
"00f61990949545828dd12f1303d47504","d989ebcfc12a4b669f0100dc1aa14f1e",22860435,3,-1,0,1800,256,255,-1
"d989ebcfc12a4b669f0100dc1aa14f1e","fa235f0f364d47e4ae1c87f47bf8e6ba",22860435,2,-4,0,1801,255,252,-3
"fa235f0f364d47e4ae1c87f47bf8e6ba","d546341988904f069cfa86b21457d9d9",22860435,2,-1,0,1802,252,251,-1
"d546341988904f069cfa86b21457d9d9","6e83e23f56544a19b94067c1c558d9c0",22860435,2,-5,0,1803,251,247,-4
"6e83e23f56544a19b94067c1c558d9c0","1ebf23f9d994469a85206e4c7b1bf5f5",22860435,1,-3,0,1804,247,245,-2
"1ebf23f9d994469a85206e4c7b1bf5f5","fa235f0f364d47e4ae1c87f47bf8e6ba",22860435,2,9,0,1805,245,252,7
"00f61990949545828dd12f1303d47504","2ae94c0cea4d480a9d5dca8fb1d7b542",22860435,1,-17,0,1808,256,242,-14
"2ae94c0cea4d480a9d5dca8fb1d7b542","d546341988904f069cfa86b21457d9d9",22860435,1,11,0,1809,242,251,9
"a37477c4e4c14169ad44b06b493007f6","2ae94c0cea4d480a9d5dca8fb1d7b542",22860435,3,-53,0,1828,283,242,-41
"2ae94c0cea4d480a9d5dca8fb1d7b542","bb5a47f5ea01454a8b79455422d3b9da",22860435,1,48,0,1833,242,280,38
"2ae94c0cea4d480a9d5dca8fb1d7b542","2ae94c0cea4d480a9d5dca8fb1d7b542",22860435,1,0,1,1861,242,242,0
"2ae94c0cea4d480a9d5dca8fb1d7b542","a9ac840f098c4bd0a2ee896214ce29cd",22860435,1,-101,0,1862,242,168,-74
"0c7262dff33c4087bc660ccf40f92f9c","b87c552dd247427abe6ab5795b9c9d43",22860435,1,14,0,1868,169,181,12
"b87c552dd247427abe6ab5795b9c9d43","362fcb0699a14845ab29b2340093e528",22860435,1,-8,0,1869,181,174,-7
"362fcb0699a14845ab29b2340093e528","ea38cc0e6e6e41edbabf210220808bf9",22860435,2,6,0,1870,174,179,5
"ea38cc0e6e6e41edbabf210220808bf9","139b097acfca451689d80c9c6eebdf7b",22860435,2,-1,0,1871,179,178,-1
"139b097acfca451689d80c9c6eebdf7b","2ae94c0cea4d480a9d5dca8fb1d7b542",22860435,1,86,0,1872,178,242,64
"2ae94c0cea4d480a9d5dca8fb1d7b542","00f61990949545828dd12f1303d47504",22860435,2,17,0,1873,242,256,14
"1ebf23f9d994469a85206e4c7b1bf5f5","1c6721b1f63f4d30ba7746ea8af02a52",22860435,1,-30,0,1880,245,221,-24
"1c6721b1f63f4d30ba7746ea8af02a52","64dbedb3ce544f6aae8e10e0cf10f16d",22860435,1,23,0,1881,221,240,19
"64dbedb3ce544f6aae8e10e0cf10f16d","2ab1535aac1346ba8801535bf729ef37",22860435,1,-13,0,1882,240,229,-11
"0b04c8e2f86d48c7aeb7e225819cd32b","d03cb855c70044cf8c35d9ec0de696e3",22860435,1,-12,0,1884,234,224,-10
"d03cb855c70044cf8c35d9ec0de696e3","5152833676bf4c6cb317060be10f68db",22860435,1,5,0,1885,224,228,4
"5152833676bf4c6cb317060be10f68db","f7906d6f59b9489a91d2ef40db5a474d",22860435,1,-6,0,1886,228,223,-5
"f7906d6f59b9489a91d2ef40db5a474d","8b9ae98743bd4d4a8a87dff1c1244211",22860435,1,4,0,1887,223,227,4
"8b9ae98743bd4d4a8a87dff1c1244211","77ecef8eff6b4a2caea7707669bf7475",22860435,1,-6,0,1888,227,222,-5
"77ecef8eff6b4a2caea7707669bf7475","d7f13c8d63ec4e2aa673fbb9cf9c6933",22860435,1,-22,0,1889,222,206,-16
"1c6721b1f63f4d30ba7746ea8af02a52","2ab1535aac1346ba8801535bf729ef37",22860435,1,10,0,1898,221,229,8
"2ab1535aac1346ba8801535bf729ef37","f7906d6f59b9489a91d2ef40db5a474d",22860435,2,-7,0,1899,229,223,-6
"fa235f0f364d47e4ae1c87f47bf8e6ba","2ae94c0cea4d480a9d5dca8fb1d7b542",22860435,1,-12,0,1906,252,242,-10
"2ae94c0cea4d480a9d5dca8fb1d7b542","6e83e23f56544a19b94067c1c558d9c0",22860435,3,6,0,1907,242,247,5
"d989ebcfc12a4b669f0100dc1aa14f1e","d546341988904f069cfa86b21457d9d9",22860435,1,-5,0,1930,255,251,-4
"d546341988904f069cfa86b21457d9d9","fa235f0f364d47e4ae1c87f47bf8e6ba",22860435,1,1,0,1931,251,252,1
"fa235f0f364d47e4ae1c87f47bf8e6ba","1ebf23f9d994469a85206e4c7b1bf5f5",22860435,1,-9,0,1932,252,245,-7
"1ebf23f9d994469a85206e4c7b1bf5f5","2ae94c0cea4d480a9d5dca8fb1d7b542",22860435,2,-3,0,1933,245,242,-3
"6e83e23f56544a19b94067c1c558d9c0","1c6721b1f63f4d30ba7746ea8af02a52",22860435,1,-33,0,1935,247,221,-26
"1c6721b1f63f4d30ba7746ea8af02a52","1c6721b1f63f4d30ba7746ea8af02a52",22860435,1,0,1,1936,221,221,0
"1c6721b1f63f4d30ba7746ea8af02a52","0c7262dff33c4087bc660ccf40f92f9c",22860435,1,-70,0,1937,221,169,-52
"b42cc17b7de840f181a704558d0bc845","ea38cc0e6e6e41edbabf210220808bf9",22860435,2,5,0,1969,175,179,4
"139b097acfca451689d80c9c6eebdf7b","2024b4885bd14338a39b7b509acbbd02",22860435,3,5,0,1973,178,182,4
"2024b4885bd14338a39b7b509acbbd02","0c7262dff33c4087bc660ccf40f92f9c",22860435,3,-16,0,1974,182,169,-13
"0c7262dff33c4087bc660ccf40f92f9c","c8e371568a0c4391b25796ae4e91952e",22860435,3,23,0,1975,169,186,17
"ab11d94c6c8948ea90b88f19d2cd502b","c8e371568a0c4391b25796ae4e91952e",22860435,2,-5,0,1977,190,186,-4
"c8e371568a0c4391b25796ae4e91952e","07b44a7a51e94c78b411c753fc39dab0",22860435,2,4,0,1978,186,189,3
"017d7ca8e0394b91aaadc9574df2202c","f9170dd6bc6442b4acd832747609b09a",22860435,3,7,0,1981,193,199,6
"f9170dd6bc6442b4acd832747609b09a","c8e371568a0c4391b25796ae4e91952e",22860435,1,-16,0,1982,199,186,-13
"c8e371568a0c4391b25796ae4e91952e","d7f13c8d63ec4e2aa673fbb9cf9c6933",22860435,2,26,0,1983,186,206,20
"d7f13c8d63ec4e2aa673fbb9cf9c6933","7108f0e4c2584f1f9c471689ae4c885c",22860435,2,2,0,1984,206,208,2
"b9e80f77c3a44349863b19875725c384","d7f13c8d63ec4e2aa673fbb9cf9c6933",22860435,2,-1,0,1986,207,206,-1
"01b2051f8941460d89945e3b02d1ce78","1c6721b1f63f4d30ba7746ea8af02a52",22860435,2,7,0,1994,217,221,4
"8b9ae98743bd4d4a8a87dff1c1244211","1c6721b1f63f4d30ba7746ea8af02a52",22860435,1,-7,0,1998,227,221,-6
"1c6721b1f63f4d30ba7746ea8af02a52","d03cb855c70044cf8c35d9ec0de696e3",22860435,2,4,0,1999,221,224,3
"d03cb855c70044cf8c35d9ec0de696e3","f7906d6f59b9489a91d2ef40db5a474d",22860435,1,-1,0,2000,224,223,-1
"2ab1535aac1346ba8801535bf729ef37","2ae94c0cea4d480a9d5dca8fb1d7b542",22860435,1,17,0,2002,229,242,13
"0d987bed3ffa4ed0b9a2e62e97b7b30f","82ae07bc0c9b4570a41799290d1ef399",22860435,1,4,0,2008,272,275,3
"94cecc3f1e7d484b8e068e79241dfd73","fab84b4fab5940efb4ea868ef8d09396",22860435,2,5,0,2021,281,284,3
"fab84b4fab5940efb4ea868ef8d09396","fab84b4fab5940efb4ea868ef8d09396",22860435,1,0,1,2022,284,284,0
"fab84b4fab5940efb4ea868ef8d09396","4a29443515bb404cb8924e1c60a63b73",22860435,2,4,0,2023,284,285,1
"4a29443515bb404cb8924e1c60a63b73","208c9b2796c944db8dacaa96082520ea",22860435,5,3,0,2024,285,288,3
"208c9b2796c944db8dacaa96082520ea","4a29443515bb404cb8924e1c60a63b73",22860435,5,-3,0,2025,288,285,-3
"208c9b2796c944db8dacaa96082520ea","208c9b2796c944db8dacaa96082520ea",22860435,4,0,1,2027,288,288,0
"4a29443515bb404cb8924e1c60a63b73","7669a956527947d0add87455277e80b4",22860435,1,7,0,2030,285,291,6
"7669a956527947d0add87455277e80b4","7669a956527947d0add87455277e80b4",22860435,1,0,1,2031,291,291,0
"7669a956527947d0add87455277e80b4","6a9a3b5bde4a48daa896fe8c06eca56f",22860435,1,-2,0,2032,291,289,-2
"6a9a3b5bde4a48daa896fe8c06eca56f","869e967078f04da18dd0b0b9389a7424",22860435,3,5,0,2033,289,293,4
"869e967078f04da18dd0b0b9389a7424","869e967078f04da18dd0b0b9389a7424",22860435,3,0,1,2034,293,293,0
"869e967078f04da18dd0b0b9389a7424","51ab6291537748fab90d519aa09889d6",22860435,1,2,0,2036,293,295,2
"51ab6291537748fab90d519aa09889d6","51ab6291537748fab90d519aa09889d6",22860435,5,0,1,2037,295,295,0
"51ab6291537748fab90d519aa09889d6","34a6e49023fc4465bd5ca604330bbd1c",22860435,1,-3,0,2042,295,292,-3
"34a6e49023fc4465bd5ca604330bbd1c","ba0e59461bfb4a44b7b1c28a01f8d3b3",22860435,3,9,0,2043,292,299,7
"ba0e59461bfb4a44b7b1c28a01f8d3b3","21592f2a9e9c4b2f8c66ec5dbcbf6a2b",22860435,4,-4,0,2044,299,296,-3
"21592f2a9e9c4b2f8c66ec5dbcbf6a2b","ba0e59461bfb4a44b7b1c28a01f8d3b3",22860435,2,4,0,2045,296,299,3
"ba0e59461bfb4a44b7b1c28a01f8d3b3","ba0e59461bfb4a44b7b1c28a01f8d3b3",22860435,3,0,1,2046,299,299,0
"ba0e59461bfb4a44b7b1c28a01f8d3b3","0e0b36e731a645e7b1b8a88f5031ca38",22860435,2,2,0,2049,299,301,2
"0e0b36e731a645e7b1b8a88f5031ca38","0e0b36e731a645e7b1b8a88f5031ca38",22860435,5,0,1,2050,301,301,0
"0e0b36e731a645e7b1b8a88f5031ca38","4a29443515bb404cb8924e1c60a63b73",22860435,1,-20,0,2052,301,285,-16
"4a29443515bb404cb8924e1c60a63b73","ba0e59461bfb4a44b7b1c28a01f8d3b3",22860435,1,18,0,2053,285,299,14
"0e0b36e731a645e7b1b8a88f5031ca38","a66a144637284c21afc6de17fea4bfb8",22860435,1,1,0,2056,301,302,1
"a66a144637284c21afc6de17fea4bfb8","a66a144637284c21afc6de17fea4bfb8",22860435,2,0,1,2057,302,302,0
"a66a144637284c21afc6de17fea4bfb8","7646a919d7e64fa990bca9b024ff089d",22860435,1,-4,0,2059,302,298,-4
"7646a919d7e64fa990bca9b024ff089d","e390b575229748ea8aac9364efe2bf00",22860435,1,7,0,2060,298,304,6
"e390b575229748ea8aac9364efe2bf00","e390b575229748ea8aac9364efe2bf00",22860435,1,0,1,2061,304,304,0
"e390b575229748ea8aac9364efe2bf00","3434c10e561d488a914e0f7d71907abd",22860435,1,3,0,2062,304,305,1
"3434c10e561d488a914e0f7d71907abd","4a29443515bb404cb8924e1c60a63b73",22860435,3,-27,0,2063,305,285,-20
"4a29443515bb404cb8924e1c60a63b73","53e7e900392747ccad52e711ab0f80d8",22860435,3,29,0,2064,285,307,22
"53e7e900392747ccad52e711ab0f80d8","0c7262dff33c4087bc660ccf40f92f9c",22860435,1,-186,0,2065,307,169,-138
"0c7262dff33c4087bc660ccf40f92f9c","0c7262dff33c4087bc660ccf40f92f9c",22860435,5,0,1,2066,169,169,0
"b2275c3fad834f8d90737a2d9a6927d6","3434c10e561d488a914e0f7d71907abd",22860435,1,181,0,2076,172,305,133
"3434c10e561d488a914e0f7d71907abd","53e7e900392747ccad52e711ab0f80d8",22860435,3,2,0,2077,305,307,2
"53e7e900392747ccad52e711ab0f80d8","3434c10e561d488a914e0f7d71907abd",22860435,2,-2,0,2078,307,305,-2
"53e7e900392747ccad52e711ab0f80d8","4a29443515bb404cb8924e1c60a63b73",22860435,1,-29,0,2080,307,285,-22
"4a29443515bb404cb8924e1c60a63b73","3434c10e561d488a914e0f7d71907abd",22860435,3,27,0,2081,285,305,20
"3434c10e561d488a914e0f7d71907abd","3434c10e561d488a914e0f7d71907abd",22860435,1,0,1,2082,305,305,0
"53e7e900392747ccad52e711ab0f80d8","53e7e900392747ccad52e711ab0f80d8",22860435,7,0,1,2085,307,307,0
"53e7e900392747ccad52e711ab0f80d8","130acc2aeb0448fdbb2de63bc5cebe5b",22860435,2,3,0,2091,307,309,2
"130acc2aeb0448fdbb2de63bc5cebe5b","3434c10e561d488a914e0f7d71907abd",22860435,2,-5,0,2092,309,305,-4
"3434c10e561d488a914e0f7d71907abd","130acc2aeb0448fdbb2de63bc5cebe5b",22860435,3,5,0,2093,305,309,4
"130acc2aeb0448fdbb2de63bc5cebe5b","130acc2aeb0448fdbb2de63bc5cebe5b",22860435,1,0,1,2094,309,309,0
"130acc2aeb0448fdbb2de63bc5cebe5b","9c062b3251034ebe90f5054e2a3b5120",22860435,1,2,0,2095,309,311,2
"9c062b3251034ebe90f5054e2a3b5120","9c062b3251034ebe90f5054e2a3b5120",22860435,2,0,1,2096,311,311,0
"9c062b3251034ebe90f5054e2a3b5120","ea859f8207e44537889daeaba13ac2e8",22860435,1,1,0,2098,311,312,1
"ea859f8207e44537889daeaba13ac2e8","ea859f8207e44537889daeaba13ac2e8",22860435,2,0,1,2099,312,312,0
"ea859f8207e44537889daeaba13ac2e8","56d94971a7a94257aa330183a8ebd0ea",22860435,1,1,0,2100,312,313,1
"56d94971a7a94257aa330183a8ebd0ea","56d94971a7a94257aa330183a8ebd0ea",22860435,1,0,1,2101,313,313,0
"56d94971a7a94257aa330183a8ebd0ea","141c0df6cd1946539aadd1c9b7068cd4",22860435,1,-5,0,2102,313,308,-5
"141c0df6cd1946539aadd1c9b7068cd4","13255e63e0aa4abf85e5211bf613d43e",22860435,1,10,0,2103,308,317,9
"13255e63e0aa4abf85e5211bf613d43e","13255e63e0aa4abf85e5211bf613d43e",22860435,1,0,1,2104,317,317,0
"13255e63e0aa4abf85e5211bf613d43e","0c787d16c9504873b1a4d903cec09948",22860435,1,-3,0,2105,317,314,-3
"0c787d16c9504873b1a4d903cec09948","86c27d40179e419c8e9d150fb6afa5d0",22860435,2,6,0,2106,314,319,5
"86c27d40179e419c8e9d150fb6afa5d0","86c27d40179e419c8e9d150fb6afa5d0",22860435,4,0,1,2107,319,319,0
"86c27d40179e419c8e9d150fb6afa5d0","47edbb64109243e6b0f8f64cdef90c6c",22860435,2,8,0,2111,319,326,7
"47edbb64109243e6b0f8f64cdef90c6c","24f1363179ad4aaa965484a78471912b",22860435,2,-3,0,2112,326,323,-3
"24f1363179ad4aaa965484a78471912b","8d7e0b55cf9849cda222a0f2440cec55",22860435,3,-6,0,2113,323,318,-5
"8d7e0b55cf9849cda222a0f2440cec55","86c27d40179e419c8e9d150fb6afa5d0",22860435,1,1,0,2114,318,319,1
"86c27d40179e419c8e9d150fb6afa5d0","3628bdce1dd2429ba924d2d4d09448d2",22860435,2,4,0,2115,319,322,3
"3628bdce1dd2429ba924d2d4d09448d2","3434c10e561d488a914e0f7d71907abd",22860435,2,-21,0,2116,322,305,-17
"3434c10e561d488a914e0f7d71907abd","24f1363179ad4aaa965484a78471912b",22860435,1,22,0,2117,305,323,18
"8d7e0b55cf9849cda222a0f2440cec55","47edbb64109243e6b0f8f64cdef90c6c",22860435,2,9,0,2119,318,326,8
"47edbb64109243e6b0f8f64cdef90c6c","86c27d40179e419c8e9d150fb6afa5d0",22860435,1,-8,0,2120,326,319,-7
"3628bdce1dd2429ba924d2d4d09448d2","86c27d40179e419c8e9d150fb6afa5d0",22860435,1,-4,0,2122,322,319,-3
"47edbb64109243e6b0f8f64cdef90c6c","8d7e0b55cf9849cda222a0f2440cec55",22860435,1,-9,0,2124,326,318,-8
"8d7e0b55cf9849cda222a0f2440cec55","24f1363179ad4aaa965484a78471912b",22860435,1,6,0,2125,318,323,5
"24f1363179ad4aaa965484a78471912b","24f1363179ad4aaa965484a78471912b",22860435,3,0,1,2126,323,323,0
"24f1363179ad4aaa965484a78471912b","3628bdce1dd2429ba924d2d4d09448d2",22860435,2,-1,0,2128,323,322,-1
"3628bdce1dd2429ba924d2d4d09448d2","56b3fd1a212a4764be39d979fde3326e",22860435,1,7,0,2129,322,328,6
"56b3fd1a212a4764be39d979fde3326e","56b3fd1a212a4764be39d979fde3326e",22860435,1,0,1,2130,328,328,0
"56b3fd1a212a4764be39d979fde3326e","3434c10e561d488a914e0f7d71907abd",22860435,1,-28,0,2131,328,305,-23
"3434c10e561d488a914e0f7d71907abd","0c4079457ede49e3aeb5e86ed84bdf35",22860435,2,31,0,2132,305,329,24
"0c4079457ede49e3aeb5e86ed84bdf35","38aea304b4fa46e1b29bb72f5cea4c93",22860435,3,2,0,2133,329,331,2
"38aea304b4fa46e1b29bb72f5cea4c93","0c4079457ede49e3aeb5e86ed84bdf35",22860435,2,-2,0,2134,331,329,-2
"38aea304b4fa46e1b29bb72f5cea4c93","38aea304b4fa46e1b29bb72f5cea4c93",22860435,5,0,1,2136,331,331,0
"38aea304b4fa46e1b29bb72f5cea4c93","e36d261332f14e79bb4b467aceaeb9b5",22860435,1,2,0,2137,331,333,2
"e36d261332f14e79bb4b467aceaeb9b5","e36d261332f14e79bb4b467aceaeb9b5",22860435,1,0,1,2138,333,333,0
"e36d261332f14e79bb4b467aceaeb9b5","38aea304b4fa46e1b29bb72f5cea4c93",22860435,1,-2,0,2139,333,331,-2
"38aea304b4fa46e1b29bb72f5cea4c93","c7e89b9d04744d2eab742fc24e3ef1ae",22860435,1,3,0,2140,331,334,3
"c7e89b9d04744d2eab742fc24e3ef1ae","c7e89b9d04744d2eab742fc24e3ef1ae",22860435,2,0,1,2141,334,334,0
"c7e89b9d04744d2eab742fc24e3ef1ae","fe49f8054b374a0ea4bb266ed135ff62",22860435,1,1,0,2143,334,335,1
"fe49f8054b374a0ea4bb266ed135ff62","fe49f8054b374a0ea4bb266ed135ff62",22860435,2,0,1,2144,335,335,0
"fe49f8054b374a0ea4bb266ed135ff62","d0a8f74af98642fe8360d22c42e45117",22860435,1,1,0,2146,335,336,1
"d0a8f74af98642fe8360d22c42e45117","d0a8f74af98642fe8360d22c42e45117",22860435,2,0,1,2147,336,336,0
"d0a8f74af98642fe8360d22c42e45117","0c4079457ede49e3aeb5e86ed84bdf35",22860435,1,-7,0,2149,336,329,-7
"0c4079457ede49e3aeb5e86ed84bdf35","a7c6339ca1da4368a18d471f0519f877",22860435,1,11,0,2150,329,339,10
"a7c6339ca1da4368a18d471f0519f877","a7c6339ca1da4368a18d471f0519f877",22860435,1,0,1,2151,339,339,0
"a7c6339ca1da4368a18d471f0519f877","b8b9418ab322418d9db9b40d96af873a",22860435,1,-2,0,2152,339,337,-2
"b8b9418ab322418d9db9b40d96af873a","bbc5139ca9024389a94db3a6f47dcff6",22860435,3,5,0,2153,337,341,4
"bbc5139ca9024389a94db3a6f47dcff6","bbc5139ca9024389a94db3a6f47dcff6",22860435,7,0,1,2154,341,341,0
"bbc5139ca9024389a94db3a6f47dcff6","4ee6ca9019ab4a1ab323f98094a9bd77",22860435,1,2,0,2160,341,343,2
"4ee6ca9019ab4a1ab323f98094a9bd77","4ee6ca9019ab4a1ab323f98094a9bd77",22860435,2,0,1,2161,343,343,0
"4ee6ca9019ab4a1ab323f98094a9bd77","b37947176785476f8b29d49a851366dc",22860435,1,1,0,2163,343,344,1
"b37947176785476f8b29d49a851366dc","b37947176785476f8b29d49a851366dc",22860435,2,0,1,2164,344,344,0
"b37947176785476f8b29d49a851366dc","fcea5b10d5a14a3b9324ffece8f6e1e5",22860435,1,1,0,2166,344,345,1
"fcea5b10d5a14a3b9324ffece8f6e1e5","fcea5b10d5a14a3b9324ffece8f6e1e5",22860435,2,0,1,2167,345,345,0
"fcea5b10d5a14a3b9324ffece8f6e1e5","c2490bc612d146edbe786556fab3651b",22860435,1,-5,0,2169,345,340,-5
"c2490bc612d146edbe786556fab3651b","6ac8bb048b854999a47edb35fe627f11",22860435,1,8,0,2170,340,347,7
"6ac8bb048b854999a47edb35fe627f11","6ac8bb048b854999a47edb35fe627f11",22860435,1,0,1,2171,347,347,0
"6ac8bb048b854999a47edb35fe627f11","0c4079457ede49e3aeb5e86ed84bdf35",22860435,1,-21,0,2172,347,329,-18
"0c4079457ede49e3aeb5e86ed84bdf35","30ead9794d4847abaf222ca966cc8630",22860435,3,24,0,2173,329,348,19
"30ead9794d4847abaf222ca966cc8630","897b7f51242c44aab2205c72fdcbf4cd",22860435,1,4,0,2174,348,352,4
"897b7f51242c44aab2205c72fdcbf4cd","eff0de7f2dbb42dfa1a2e686efab5b6d",22860435,4,2,0,2175,352,354,2
"eff0de7f2dbb42dfa1a2e686efab5b6d","09b9678ddc3d452ea4a3d46e15826065",22860435,6,-1,0,2176,354,353,-1
"09b9678ddc3d452ea4a3d46e15826065","c20993c944444fe085345591a8bd837e",22860435,3,-2,0,2177,353,351,-2
"c20993c944444fe085345591a8bd837e","c20993c944444fe085345591a8bd837e",22860435,11,0,1,2178,351,351,0
"c20993c944444fe085345591a8bd837e","897b7f51242c44aab2205c72fdcbf4cd",22860435,6,1,0,2182,351,352,1
"897b7f51242c44aab2205c72fdcbf4cd","897b7f51242c44aab2205c72fdcbf4cd",22860435,10,0,1,2183,352,352,0
"897b7f51242c44aab2205c72fdcbf4cd","09b9678ddc3d452ea4a3d46e15826065",22860435,2,1,0,2186,352,353,1
"09b9678ddc3d452ea4a3d46e15826065","09b9678ddc3d452ea4a3d46e15826065",22860435,11,0,1,2187,353,353,0
"09b9678ddc3d452ea4a3d46e15826065","eff0de7f2dbb42dfa1a2e686efab5b6d",22860435,2,1,0,2190,353,354,1
"eff0de7f2dbb42dfa1a2e686efab5b6d","eff0de7f2dbb42dfa1a2e686efab5b6d",22860435,12,0,1,2191,354,354,0
"eff0de7f2dbb42dfa1a2e686efab5b6d","2fe14166dc9642c3bc666b86a57f943d",22860435,1,4,0,2194,354,357,3
"2fe14166dc9642c3bc666b86a57f943d","30ead9794d4847abaf222ca966cc8630",22860435,3,-10,0,2195,357,348,-9
"30ead9794d4847abaf222ca966cc8630","c20993c944444fe085345591a8bd837e",22860435,1,3,0,2196,348,351,3
"c20993c944444fe085345591a8bd837e","eff0de7f2dbb42dfa1a2e686efab5b6d",22860435,3,3,0,2198,351,354,3
"eff0de7f2dbb42dfa1a2e686efab5b6d","c20993c944444fe085345591a8bd837e",22860435,3,-3,0,2201,354,351,-3
"09b9678ddc3d452ea4a3d46e15826065","1ba8fef685d74a8194b9db252eb704fb",22860435,1,3,0,2206,353,355,2
"1ba8fef685d74a8194b9db252eb704fb","897b7f51242c44aab2205c72fdcbf4cd",22860435,1,-4,0,2207,355,352,-3
"897b7f51242c44aab2205c72fdcbf4cd","2fe14166dc9642c3bc666b86a57f943d",22860435,1,6,0,2209,352,357,5
"30ead9794d4847abaf222ca966cc8630","2fe14166dc9642c3bc666b86a57f943d",22860435,3,10,0,2211,348,357,9
"2fe14166dc9642c3bc666b86a57f943d","44421dd1e13a47a388c4a19834b744c7",22860435,1,2,0,2212,357,359,2
"44421dd1e13a47a388c4a19834b744c7","44421dd1e13a47a388c4a19834b744c7",22860435,2,0,1,2213,359,359,0
"44421dd1e13a47a388c4a19834b744c7","cb5fc7ef85d547c4be1a7439d0bf6052",22860435,1,1,0,2215,359,360,1
"cb5fc7ef85d547c4be1a7439d0bf6052","cb5fc7ef85d547c4be1a7439d0bf6052",22860435,2,0,1,2216,360,360,0
"cb5fc7ef85d547c4be1a7439d0bf6052","0a8f150a4cf747acbde62f4721823da3",22860435,1,1,0,2218,360,361,1
"0a8f150a4cf747acbde62f4721823da3","0a8f150a4cf747acbde62f4721823da3",22860435,2,0,1,2219,361,361,0
"0a8f150a4cf747acbde62f4721823da3","ab8fdad974ae471f9f24c3f9dd04462e",22860435,1,1,0,2221,361,362,1
"ab8fdad974ae471f9f24c3f9dd04462e","ab8fdad974ae471f9f24c3f9dd04462e",22860435,2,0,1,2222,362,362,0
"ab8fdad974ae471f9f24c3f9dd04462e","52580888dadb4fe3baa795683ea227bd",22860435,1,3,0,2224,362,364,2
"52580888dadb4fe3baa795683ea227bd","1ba8fef685d74a8194b9db252eb704fb",22860435,3,-10,0,2225,364,355,-9
"1ba8fef685d74a8194b9db252eb704fb","30ead9794d4847abaf222ca966cc8630",22860435,1,-8,0,2226,355,348,-7
"30ead9794d4847abaf222ca966cc8630","52580888dadb4fe3baa795683ea227bd",22860435,2,18,0,2227,348,364,16
"52580888dadb4fe3baa795683ea227bd","52580888dadb4fe3baa795683ea227bd",22860435,4,0,1,2228,364,364,0
"52580888dadb4fe3baa795683ea227bd","492a3bc6a1254f23a7998587961b22a4",22860435,1,3,0,2232,364,366,2
"492a3bc6a1254f23a7998587961b22a4","f00179e251a045b39c3f7a54f9aa4acc",22860435,1,-4,0,2233,366,363,-3
"f00179e251a045b39c3f7a54f9aa4acc","52580888dadb4fe3baa795683ea227bd",22860435,1,1,0,2234,363,364,1
"52580888dadb4fe3baa795683ea227bd","072a190fd302456290895f9f04d6940a",22860435,2,2,0,2235,364,365,1
"072a190fd302456290895f9f04d6940a","f00179e251a045b39c3f7a54f9aa4acc",22860435,3,-3,0,2236,365,363,-2
"f00179e251a045b39c3f7a54f9aa4acc","492a3bc6a1254f23a7998587961b22a4",22860435,4,4,0,2237,363,366,3
"492a3bc6a1254f23a7998587961b22a4","52580888dadb4fe3baa795683ea227bd",22860435,1,-3,0,2238,366,364,-2
"492a3bc6a1254f23a7998587961b22a4","492a3bc6a1254f23a7998587961b22a4",22860435,2,0,1,2242,366,366,0
"492a3bc6a1254f23a7998587961b22a4","072a190fd302456290895f9f04d6940a",22860435,3,-1,0,2244,366,365,-1
"072a190fd302456290895f9f04d6940a","cfa457d1743848e4bb5e4beced6448ed",22860435,1,5,0,2245,365,369,4
"cfa457d1743848e4bb5e4beced6448ed","cfa457d1743848e4bb5e4beced6448ed",22860435,1,0,1,2246,369,369,0
"cfa457d1743848e4bb5e4beced6448ed","30ead9794d4847abaf222ca966cc8630",22860435,1,-25,0,2247,369,348,-21
"30ead9794d4847abaf222ca966cc8630","b71bac264efb4abd97015447bd490db6",22860435,5,28,0,2248,348,370,22
"b71bac264efb4abd97015447bd490db6","8d448d625b024c82a5eb240bbd7431d6",22860435,17,5,0,2249,370,374,4
"8d448d625b024c82a5eb240bbd7431d6","8d448d625b024c82a5eb240bbd7431d6",22860435,180,0,1,2250,374,374,0
"8d448d625b024c82a5eb240bbd7431d6","b71bac264efb4abd97015447bd490db6",22860435,10,-5,0,2256,374,370,-4
"8d448d625b024c82a5eb240bbd7431d6","1b4550d0dab04078b3bf08a655345bdc",22860435,3,-1,0,2258,374,373,-1
"1b4550d0dab04078b3bf08a655345bdc","30ead9794d4847abaf222ca966cc8630",22860435,2,-32,0,2259,373,348,-25
"b71bac264efb4abd97015447bd490db6","492a3bc6a1254f23a7998587961b22a4",22860435,1,-7,0,2261,370,366,-4
"492a3bc6a1254f23a7998587961b22a4","c76574d21bc14aeea7ecd0b027f39858",22860435,1,2,0,2262,366,367,1
"c76574d21bc14aeea7ecd0b027f39858","072a190fd302456290895f9f04d6940a",22860435,1,-3,0,2263,367,365,-2
"072a190fd302456290895f9f04d6940a","52580888dadb4fe3baa795683ea227bd",22860435,1,-2,0,2264,365,364,-1
"52580888dadb4fe3baa795683ea227bd","f00179e251a045b39c3f7a54f9aa4acc",22860435,2,-1,0,2265,364,363,-1
"f00179e251a045b39c3f7a54f9aa4acc","2fe14166dc9642c3bc666b86a57f943d",22860435,1,-7,0,2266,363,357,-6
"2fe14166dc9642c3bc666b86a57f943d","eff0de7f2dbb42dfa1a2e686efab5b6d",22860435,1,-4,0,2267,357,354,-3
"09b9678ddc3d452ea4a3d46e15826065","897b7f51242c44aab2205c72fdcbf4cd",22860435,3,-1,0,2271,353,352,-1
"897b7f51242c44aab2205c72fdcbf4cd","c20993c944444fe085345591a8bd837e",22860435,3,-1,0,2273,352,351,-1
"c20993c944444fe085345591a8bd837e","1ba8fef685d74a8194b9db252eb704fb",22860435,1,5,0,2274,351,355,4
"1ba8fef685d74a8194b9db252eb704fb","09b9678ddc3d452ea4a3d46e15826065",22860435,1,-3,0,2275,355,353,-2
"897b7f51242c44aab2205c72fdcbf4cd","0c4079457ede49e3aeb5e86ed84bdf35",22860435,1,-28,0,2280,352,329,-23
"30ead9794d4847abaf222ca966cc8630","4a92daef4d504e1792575a26502bb7b7",22860435,1,-4,0,2282,348,346,-2
"4a92daef4d504e1792575a26502bb7b7","bbc5139ca9024389a94db3a6f47dcff6",22860435,2,-6,0,2283,346,341,-5
"bbc5139ca9024389a94db3a6f47dcff6","c2490bc612d146edbe786556fab3651b",22860435,4,-1,0,2284,341,340,-1
"c2490bc612d146edbe786556fab3651b","b8b9418ab322418d9db9b40d96af873a",22860435,2,-4,0,2285,340,337,-3
"b8b9418ab322418d9db9b40d96af873a","38aea304b4fa46e1b29bb72f5cea4c93",22860435,1,-7,0,2286,337,331,-6
"38aea304b4fa46e1b29bb72f5cea4c93","bbc5139ca9024389a94db3a6f47dcff6",22860435,1,12,0,2290,331,341,10
"bbc5139ca9024389a94db3a6f47dcff6","b8b9418ab322418d9db9b40d96af873a",22860435,1,-5,0,2291,341,337,-4
"b8b9418ab322418d9db9b40d96af873a","0c4079457ede49e3aeb5e86ed84bdf35",22860435,1,-9,0,2292,337,329,-8
"0c4079457ede49e3aeb5e86ed84bdf35","c2490bc612d146edbe786556fab3651b",22860435,1,13,0,2293,329,340,11
"c2490bc612d146edbe786556fab3651b","0c4079457ede49e3aeb5e86ed84bdf35",22860435,1,-13,0,2294,340,329,-11
"30ead9794d4847abaf222ca966cc8630","30ead9794d4847abaf222ca966cc8630",22860435,1,0,1,2296,348,348,0
"30ead9794d4847abaf222ca966cc8630","0c4079457ede49e3aeb5e86ed84bdf35",22860435,4,-24,0,2297,348,329,-19
"0c4079457ede49e3aeb5e86ed84bdf35","c20993c944444fe085345591a8bd837e",22860435,1,27,0,2298,329,351,22
"c20993c944444fe085345591a8bd837e","09b9678ddc3d452ea4a3d46e15826065",22860435,2,2,0,2308,351,353,2
"09b9678ddc3d452ea4a3d46e15826065","2fe14166dc9642c3bc666b86a57f943d",22860435,1,5,0,2310,353,357,4
"1ba8fef685d74a8194b9db252eb704fb","072a190fd302456290895f9f04d6940a",22860435,1,12,0,2314,355,365,10
"492a3bc6a1254f23a7998587961b22a4","b71bac264efb4abd97015447bd490db6",22860435,1,7,0,2317,366,370,4
"b71bac264efb4abd97015447bd490db6","30ead9794d4847abaf222ca966cc8630",22860435,3,-28,0,2318,370,348,-22
"30ead9794d4847abaf222ca966cc8630","8d448d625b024c82a5eb240bbd7431d6",22860435,1,33,0,2319,348,374,26
"8d448d625b024c82a5eb240bbd7431d6","d6d02b6ef04e4f17805504500b8ce441",22860435,5,3,0,2384,374,375,1
"d6d02b6ef04e4f17805504500b8ce441","b71bac264efb4abd97015447bd490db6",22860435,8,-8,0,2385,375,370,-5
"b71bac264efb4abd97015447bd490db6","d6d02b6ef04e4f17805504500b8ce441",22860435,9,8,0,2386,370,375,5
"d6d02b6ef04e4f17805504500b8ce441","4a29443515bb404cb8924e1c60a63b73",22860435,3,-118,0,2387,375,285,-90
"4a29443515bb404cb8924e1c60a63b73","d6d02b6ef04e4f17805504500b8ce441",22860435,1,118,0,2388,285,375,90
"d6d02b6ef04e4f17805504500b8ce441","d6d02b6ef04e4f17805504500b8ce441",22860435,28,0,1,2389,375,375,0
"d6d02b6ef04e4f17805504500b8ce441","8d448d625b024c82a5eb240bbd7431d6",22860435,3,-3,0,2395,375,374,-1
"4a29443515bb404cb8924e1c60a63b73","6a9a3b5bde4a48daa896fe8c06eca56f",22860435,3,5,0,2412,285,289,4
"869e967078f04da18dd0b0b9389a7424","34a6e49023fc4465bd5ca604330bbd1c",22860435,2,-1,0,2414,293,292,-1
"21592f2a9e9c4b2f8c66ec5dbcbf6a2b","0e0b36e731a645e7b1b8a88f5031ca38",22860435,1,6,0,2417,296,301,5
"0e0b36e731a645e7b1b8a88f5031ca38","7646a919d7e64fa990bca9b024ff089d",22860435,1,-3,0,2420,301,298,-3
"7646a919d7e64fa990bca9b024ff089d","b71bac264efb4abd97015447bd490db6",22860435,1,93,0,2421,298,370,72
"4a29443515bb404cb8924e1c60a63b73","4a29443515bb404cb8924e1c60a63b73",22860435,2,0,1,2523,285,285,0
"6a9a3b5bde4a48daa896fe8c06eca56f","34a6e49023fc4465bd5ca604330bbd1c",22860435,2,4,0,2525,289,292,3
"34a6e49023fc4465bd5ca604330bbd1c","21592f2a9e9c4b2f8c66ec5dbcbf6a2b",22860435,1,5,0,2526,292,296,4
"21592f2a9e9c4b2f8c66ec5dbcbf6a2b","7646a919d7e64fa990bca9b024ff089d",22860435,1,3,0,2527,296,298,2
"7646a919d7e64fa990bca9b024ff089d","4a29443515bb404cb8924e1c60a63b73",22860435,1,-17,0,2528,298,285,-13
"3434c10e561d488a914e0f7d71907abd","b71bac264efb4abd97015447bd490db6",22860435,1,83,0,2530,305,370,65
"8d448d625b024c82a5eb240bbd7431d6","e2911e79efc2420eac45d9f671463d4b",22860435,1,-510,0,2539,374,2,-372
"e2911e79efc2420eac45d9f671463d4b","e2911e79efc2420eac45d9f671463d4b",22860435,4,0,1,2540,2,2,0
"e2911e79efc2420eac45d9f671463d4b","56586aa865414f538729c7f7735d2bc6",22860435,2,12,0,2542,2,12,10
"56586aa865414f538729c7f7735d2bc6","56586aa865414f538729c7f7735d2bc6",22860435,16,0,1,2543,12,12,0
"56586aa865414f538729c7f7735d2bc6","b7f2b31585d94eb3bf86376714aa7070",22860435,8,2,0,2544,12,13,1
"b7f2b31585d94eb3bf86376714aa7070","56586aa865414f538729c7f7735d2bc6",22860435,6,-2,0,2545,13,12,-1
"b7f2b31585d94eb3bf86376714aa7070","3f1c815879794b929260d224becaff7e",22860435,3,2,0,2547,13,14,1
"3f1c815879794b929260d224becaff7e","b71bac264efb4abd97015447bd490db6",22860435,1,489,0,2548,14,370,356
"1b4550d0dab04078b3bf08a655345bdc","b71bac264efb4abd97015447bd490db6",22860435,1,-4,0,2558,373,370,-3
"30ead9794d4847abaf222ca966cc8630","c76574d21bc14aeea7ecd0b027f39858",22860435,1,23,0,2560,348,367,19
"c76574d21bc14aeea7ecd0b027f39858","492a3bc6a1254f23a7998587961b22a4",22860435,1,-2,0,2561,367,366,-1
"072a190fd302456290895f9f04d6940a","2fe14166dc9642c3bc666b86a57f943d",22860435,1,-10,0,2563,365,357,-8
"2fe14166dc9642c3bc666b86a57f943d","897b7f51242c44aab2205c72fdcbf4cd",22860435,1,-6,0,2564,357,352,-5
"897b7f51242c44aab2205c72fdcbf4cd","1ba8fef685d74a8194b9db252eb704fb",22860435,1,4,0,2565,352,355,3
"1ba8fef685d74a8194b9db252eb704fb","c20993c944444fe085345591a8bd837e",22860435,1,-5,0,2566,355,351,-4
"09b9678ddc3d452ea4a3d46e15826065","30ead9794d4847abaf222ca966cc8630",22860435,2,-5,0,2577,353,348,-5
"0c4079457ede49e3aeb5e86ed84bdf35","4a92daef4d504e1792575a26502bb7b7",22860435,1,20,0,2579,329,346,17
"c2490bc612d146edbe786556fab3651b","30ead9794d4847abaf222ca966cc8630",22860435,2,11,0,2585,340,348,8
"0c4079457ede49e3aeb5e86ed84bdf35","09b9678ddc3d452ea4a3d46e15826065",22860435,1,29,0,2587,329,353,24
"897b7f51242c44aab2205c72fdcbf4cd","30ead9794d4847abaf222ca966cc8630",22860435,1,-4,0,2599,352,348,-4
"2fe14166dc9642c3bc666b86a57f943d","b71bac264efb4abd97015447bd490db6",22860435,1,18,0,2601,357,370,13
"8d448d625b024c82a5eb240bbd7431d6","4a29443515bb404cb8924e1c60a63b73",22860435,1,-115,0,2610,374,285,-89
"208c9b2796c944db8dacaa96082520ea","b71bac264efb4abd97015447bd490db6",22860435,1,107,0,2613,288,370,82
"8d448d625b024c82a5eb240bbd7431d6","67a089198fcb4e1c8f2385786c2b296f",22860435,1,-441,0,2634,374,39,-335
"b534b89233134e30a9b5645138bfa9ee","b534b89233134e30a9b5645138bfa9ee",22860435,1,0,1,2640,41,41,0
"6e13d61a7bdb44bca949c9f86fab3be5","d9c8d8c444a64dadbbb508652c721e17",22860435,2,-1,0,2643,47,46,-1
"d0c74f735e024943943e40333d6d337f","f924752d8a1149668870b1e7698486f7",22860435,2,-1,0,2646,51,50,-1
"f924752d8a1149668870b1e7698486f7","78f30e4dcac84e3cbea8b2cc6e0d62b3",22860435,1,10,0,2647,50,59,9
"12aa6e1672ac4e7aa6449a7a8609cd72","a0a418b8540d479fa6e0f653b701da8b",22860435,2,8,0,2650,57,64,7
"a0a418b8540d479fa6e0f653b701da8b","bc42d26810654ea9a1df1efe1e58c7d5",22860435,1,-1,0,2651,64,63,-1
"bc42d26810654ea9a1df1efe1e58c7d5","bc42d26810654ea9a1df1efe1e58c7d5",22860435,5,0,1,2652,63,63,0
"bc42d26810654ea9a1df1efe1e58c7d5","309ccf3cc4fe429d9bfbaef53d3fa479",22860435,2,-3,0,2654,63,60,-3
"309ccf3cc4fe429d9bfbaef53d3fa479","b534b89233134e30a9b5645138bfa9ee",22860435,2,-23,0,2655,60,41,-19
"b534b89233134e30a9b5645138bfa9ee","d646286c8051419bbc2e31dd1db55ca8",22860435,2,33,0,2656,41,67,26
"d646286c8051419bbc2e31dd1db55ca8","d646286c8051419bbc2e31dd1db55ca8",22860435,1,0,1,2657,67,67,0
"d646286c8051419bbc2e31dd1db55ca8","a2becd407db34b189200a32546d9d569",22860435,2,9,0,2658,67,75,8
"a2becd407db34b189200a32546d9d569","a2becd407db34b189200a32546d9d569",22860435,5,0,1,2659,75,75,0
"a2becd407db34b189200a32546d9d569","140d5b27b8574befad82c0a013b59dfa",22860435,1,-1,0,2660,75,74,-1
"140d5b27b8574befad82c0a013b59dfa","d18a9ea32855445f8736581f5cb119ce",22860435,2,9,0,2661,74,82,8
"d18a9ea32855445f8736581f5cb119ce","6a9f0ef185fb47f0937e29daa1c71ed5",22860435,2,10,0,2662,82,90,8
"6a9f0ef185fb47f0937e29daa1c71ed5","ae5ac430ea254e708a6f5deaaf7464ae",22860435,2,-7,0,2663,90,84,-6
"ae5ac430ea254e708a6f5deaaf7464ae","6a9f0ef185fb47f0937e29daa1c71ed5",22860435,1,7,0,2664,84,90,6
"6a9f0ef185fb47f0937e29daa1c71ed5","6a9f0ef185fb47f0937e29daa1c71ed5",22860435,7,0,1,2665,90,90,0
"6a9f0ef185fb47f0937e29daa1c71ed5","d646286c8051419bbc2e31dd1db55ca8",22860435,2,-27,0,2666,90,67,-23
"d646286c8051419bbc2e31dd1db55ca8","e20db35ced8544ddac5bc3839145e463",22860435,4,30,0,2667,67,91,24
"e20db35ced8544ddac5bc3839145e463","e20db35ced8544ddac5bc3839145e463",22860435,7,0,1,2668,91,91,0
"e20db35ced8544ddac5bc3839145e463","00ae5f0c51874a73a41ebea838d95682",22860435,2,11,0,2669,91,101,10
"00ae5f0c51874a73a41ebea838d95682","d391c8b6e56a43a7b654e9dee02d904b",22860435,6,2,0,2670,101,103,2
"d391c8b6e56a43a7b654e9dee02d904b","e20db35ced8544ddac5bc3839145e463",22860435,1,-13,0,2671,103,91,-12
"d391c8b6e56a43a7b654e9dee02d904b","00ae5f0c51874a73a41ebea838d95682",22860435,7,-2,0,2674,103,101,-2
"00ae5f0c51874a73a41ebea838d95682","73039f8c1eb9409cb4caee2cf968001e",22860435,2,-1,0,2675,101,100,-1
"73039f8c1eb9409cb4caee2cf968001e","4280927ec4d643238aa49c32f9e06c6c",22860435,3,10,0,2676,100,109,9
"4280927ec4d643238aa49c32f9e06c6c","4280927ec4d643238aa49c32f9e06c6c",22860435,2,0,1,2677,109,109,0
"4280927ec4d643238aa49c32f9e06c6c","08111f75e22d409998cf8b85bd431f0a",22860435,3,-1,0,2678,109,108,-1
"08111f75e22d409998cf8b85bd431f0a","a9ae0a3c070d455bb4369a8996313336",22860435,3,7,0,2679,108,114,6
"a9ae0a3c070d455bb4369a8996313336","a9ae0a3c070d455bb4369a8996313336",22860435,4,0,1,2680,114,114,0
"a9ae0a3c070d455bb4369a8996313336","37319e88176d4aefa91d7a9980dbae91",22860435,5,-2,0,2681,114,112,-2
"37319e88176d4aefa91d7a9980dbae91","62bff51286ef4f348717a3cf6fe2318f",22860435,2,9,0,2682,112,120,8
"62bff51286ef4f348717a3cf6fe2318f","62bff51286ef4f348717a3cf6fe2318f",22860435,12,0,1,2683,120,120,0
"62bff51286ef4f348717a3cf6fe2318f","779f9ddd1fd14d1e9e69f72219a1fdbd",22860435,4,3,0,2685,120,121,1
"779f9ddd1fd14d1e9e69f72219a1fdbd","e20db35ced8544ddac5bc3839145e463",22860435,5,-36,0,2686,121,91,-30
"e20db35ced8544ddac5bc3839145e463","779f9ddd1fd14d1e9e69f72219a1fdbd",22860435,3,36,0,2687,91,121,30
"779f9ddd1fd14d1e9e69f72219a1fdbd","a8dd5213034441ac92724b4e83eb0bb2",22860435,2,9,0,2688,121,129,8
"a8dd5213034441ac92724b4e83eb0bb2","a8dd5213034441ac92724b4e83eb0bb2",22860435,3,0,1,2689,129,129,0
"a8dd5213034441ac92724b4e83eb0bb2","579338175e0b4bbb8ef3b712b5d8b54e",22860435,3,-1,0,2690,129,128,-1
"579338175e0b4bbb8ef3b712b5d8b54e","b416d47c56a742199b5d7c7f19d6503a",22860435,1,7,0,2691,128,134,6
"b416d47c56a742199b5d7c7f19d6503a","df1de691dafe4549a18a4398ee9dfaf9",22860435,3,8,0,2692,134,139,5
"df1de691dafe4549a18a4398ee9dfaf9","779f9ddd1fd14d1e9e69f72219a1fdbd",22860435,5,-23,0,2693,139,121,-18
"779f9ddd1fd14d1e9e69f72219a1fdbd","6c5ad271a44743479bfaea29b1db8d02",22860435,5,27,0,2694,121,143,22
"6c5ad271a44743479bfaea29b1db8d02","6c5ad271a44743479bfaea29b1db8d02",22860435,3,0,1,2695,143,143,0
"6c5ad271a44743479bfaea29b1db8d02","8aae34f5ddbb4052a709b12e6b0d40fa",22860435,2,5,0,2696,143,147,4
"8aae34f5ddbb4052a709b12e6b0d40fa","df1de691dafe4549a18a4398ee9dfaf9",22860435,5,-9,0,2697,147,139,-8
"df1de691dafe4549a18a4398ee9dfaf9","8aae34f5ddbb4052a709b12e6b0d40fa",22860435,3,9,0,2698,139,147,8
"8aae34f5ddbb4052a709b12e6b0d40fa","f902b0f41b544d4dbf79664fd233648d",22860435,1,-1,0,2699,147,146,-1
"f902b0f41b544d4dbf79664fd233648d","d313cec988a84645bee413e8d4724a4b",22860435,1,14,0,2700,146,158,12
"d313cec988a84645bee413e8d4724a4b","d313cec988a84645bee413e8d4724a4b",22860435,15,0,1,2701,158,158,0
"d313cec988a84645bee413e8d4724a4b","f03480cf4eba413194d7af52fc0e7f28",22860435,2,-7,0,2703,158,152,-6
"f03480cf4eba413194d7af52fc0e7f28","78adeee1fa2c4fe0bc73f7bca9fcee86",22860435,1,11,0,2704,152,160,8
"78adeee1fa2c4fe0bc73f7bca9fcee86","df1de691dafe4549a18a4398ee9dfaf9",22860435,4,-26,0,2705,160,139,-21
"df1de691dafe4549a18a4398ee9dfaf9","65202579580f4ad38d734b4ee39d22a8",22860435,1,31,0,2706,139,164,25
"65202579580f4ad38d734b4ee39d22a8","65202579580f4ad38d734b4ee39d22a8",22860435,137,0,1,2707,164,164,0
"65202579580f4ad38d734b4ee39d22a8","78adeee1fa2c4fe0bc73f7bca9fcee86",22860435,7,-5,0,2709,164,160,-4
"78adeee1fa2c4fe0bc73f7bca9fcee86","65202579580f4ad38d734b4ee39d22a8",22860435,11,5,0,2710,160,164,4
"78adeee1fa2c4fe0bc73f7bca9fcee86","3cbcea2be0984e7dbd5a48195af10ce7",22860435,7,8,0,2716,160,165,5
"3cbcea2be0984e7dbd5a48195af10ce7","82e6285962b8400d9d6fc32436022a94",22860435,8,2,0,2717,165,167,2
"82e6285962b8400d9d6fc32436022a94","3cbcea2be0984e7dbd5a48195af10ce7",22860435,4,-2,0,2718,167,165,-2
"3cbcea2be0984e7dbd5a48195af10ce7","a9ac840f098c4bd0a2ee896214ce29cd",22860435,4,5,0,2719,165,168,3
"a9ac840f098c4bd0a2ee896214ce29cd","b2275c3fad834f8d90737a2d9a6927d6",22860435,1,7,0,2722,168,172,4
"c8e371568a0c4391b25796ae4e91952e","c8e371568a0c4391b25796ae4e91952e",22860435,1,0,1,2737,186,186,0
"ab11d94c6c8948ea90b88f19d2cd502b","6cd2dcaac46847d4a0bc53f296d90375",22860435,1,5,0,2740,190,194,4
"f9170dd6bc6442b4acd832747609b09a","d7f13c8d63ec4e2aa673fbb9cf9c6933",22860435,1,10,0,2745,199,206,7
"be502a7a43c44bf7b682698de79d9369","363837c182e04711840d896ae1e0339c",22860435,1,5,0,2756,214,218,4
"363837c182e04711840d896ae1e0339c","ec341f459285443b8361f7f15638ff08",22860435,1,-6,0,2757,218,213,-5
"ec341f459285443b8361f7f15638ff08","01b2051f8941460d89945e3b02d1ce78",22860435,1,5,0,2758,213,217,4
"d03cb855c70044cf8c35d9ec0de696e3","2ab1535aac1346ba8801535bf729ef37",22860435,1,6,0,2766,224,229,5
"2ae94c0cea4d480a9d5dca8fb1d7b542","30c9ba177afc49a695625d2bdec40207",22860435,1,9,0,2775,242,250,8
"30c9ba177afc49a695625d2bdec40207","30c9ba177afc49a695625d2bdec40207",22860435,2,0,1,2776,250,250,0
"30c9ba177afc49a695625d2bdec40207","6e83e23f56544a19b94067c1c558d9c0",22860435,1,-3,0,2778,250,247,-3
"a37477c4e4c14169ad44b06b493007f6","fab84b4fab5940efb4ea868ef8d09396",22860435,2,3,0,2802,283,284,1
"fab84b4fab5940efb4ea868ef8d09396","94cecc3f1e7d484b8e068e79241dfd73",22860435,2,-5,0,2803,284,281,-3
"94cecc3f1e7d484b8e068e79241dfd73","4a29443515bb404cb8924e1c60a63b73",22860435,1,9,0,2804,281,285,4
"4a29443515bb404cb8924e1c60a63b73","fab84b4fab5940efb4ea868ef8d09396",22860435,1,-4,0,2805,285,284,-1
"fab84b4fab5940efb4ea868ef8d09396","208c9b2796c944db8dacaa96082520ea",22860435,1,7,0,2806,284,288,4
"ba0e59461bfb4a44b7b1c28a01f8d3b3","7646a919d7e64fa990bca9b024ff089d",22860435,1,-1,0,2816,299,298,-1
"7646a919d7e64fa990bca9b024ff089d","3434c10e561d488a914e0f7d71907abd",22860435,1,10,0,2817,298,305,7
"130acc2aeb0448fdbb2de63bc5cebe5b","141c0df6cd1946539aadd1c9b7068cd4",22860435,1,-1,0,2824,309,308,-1
"141c0df6cd1946539aadd1c9b7068cd4","86c27d40179e419c8e9d150fb6afa5d0",22860435,1,13,0,2825,308,319,11
"86c27d40179e419c8e9d150fb6afa5d0","0c787d16c9504873b1a4d903cec09948",22860435,1,-6,0,2826,319,314,-5
"86c27d40179e419c8e9d150fb6afa5d0","24f1363179ad4aaa965484a78471912b",22860435,1,5,0,2828,319,323,4
"47edbb64109243e6b0f8f64cdef90c6c","2ae94c0cea4d480a9d5dca8fb1d7b542",22860435,1,-112,0,2831,326,242,-84
"4a29443515bb404cb8924e1c60a63b73","869e967078f04da18dd0b0b9389a7424",22860435,1,10,0,2859,285,293,8
"869e967078f04da18dd0b0b9389a7424","6a9a3b5bde4a48daa896fe8c06eca56f",22860435,1,-5,0,2860,293,289,-4
"34a6e49023fc4465bd5ca604330bbd1c","7646a919d7e64fa990bca9b024ff089d",22860435,1,8,0,2862,292,298,6
"7646a919d7e64fa990bca9b024ff089d","ba0e59461bfb4a44b7b1c28a01f8d3b3",22860435,1,1,0,2863,298,299,1
"21592f2a9e9c4b2f8c66ec5dbcbf6a2b","4a29443515bb404cb8924e1c60a63b73",22860435,1,-14,0,2865,296,285,-11
"3434c10e561d488a914e0f7d71907abd","47edbb64109243e6b0f8f64cdef90c6c",22860435,1,25,0,2869,305,326,21
"0c4079457ede49e3aeb5e86ed84bdf35","b8b9418ab322418d9db9b40d96af873a",22860435,1,9,0,2878,329,337,8
"0c4079457ede49e3aeb5e86ed84bdf35","eff0de7f2dbb42dfa1a2e686efab5b6d",22860435,1,30,0,2884,329,354,25
"eff0de7f2dbb42dfa1a2e686efab5b6d","897b7f51242c44aab2205c72fdcbf4cd",22860435,1,-2,0,2886,354,352,-2
"2fe14166dc9642c3bc666b86a57f943d","2fe14166dc9642c3bc666b86a57f943d",22860435,1,0,1,2898,357,357,0
"2fe14166dc9642c3bc666b86a57f943d","52580888dadb4fe3baa795683ea227bd",22860435,1,8,0,2899,357,364,7
"1ba8fef685d74a8194b9db252eb704fb","52580888dadb4fe3baa795683ea227bd",22860435,1,10,0,2901,355,364,9
"072a190fd302456290895f9f04d6940a","30ead9794d4847abaf222ca966cc8630",22860435,1,-20,0,2905,365,348,-17
"b71bac264efb4abd97015447bd490db6","b71bac264efb4abd97015447bd490db6",22860435,1,0,1,2907,370,370,0
"d6d02b6ef04e4f17805504500b8ce441","3434c10e561d488a914e0f7d71907abd",22860435,1,-91,0,2921,375,305,-70
"3434c10e561d488a914e0f7d71907abd","2ae94c0cea4d480a9d5dca8fb1d7b542",22860435,1,-87,0,2922,305,242,-63
"2ae94c0cea4d480a9d5dca8fb1d7b542","d6d02b6ef04e4f17805504500b8ce441",22860435,1,178,0,2923,242,375,133
"d6d02b6ef04e4f17805504500b8ce441","66baf19b6b904b70922329068c63746d",22860435,2,4,0,2927,375,376,1
"66baf19b6b904b70922329068c63746d","66baf19b6b904b70922329068c63746d",22860435,9,0,1,2928,376,376,0
"66baf19b6b904b70922329068c63746d","83d42d95cd844fc093fc09cee250edb8",22860435,2,135,0,2929,376,465,89
"83d42d95cd844fc093fc09cee250edb8","83d42d95cd844fc093fc09cee250edb8",22860435,14,0,1,2930,465,465,0
"83d42d95cd844fc093fc09cee250edb8","66baf19b6b904b70922329068c63746d",22860435,1,-135,0,2932,465,376,-89
"66baf19b6b904b70922329068c63746d","c2fca3669923477ab966ded303dea31c",22860435,6,8,0,2937,376,383,7
"c2fca3669923477ab966ded303dea31c","66baf19b6b904b70922329068c63746d",22860435,2,-8,0,2938,383,376,-7
"66baf19b6b904b70922329068c63746d","d5ae8642e15b46b8bd298b02274d4e9c",22860435,1,4,0,2940,376,380,4
"d5ae8642e15b46b8bd298b02274d4e9c","d5ae8642e15b46b8bd298b02274d4e9c",22860435,1,0,1,2941,380,380,0
"d5ae8642e15b46b8bd298b02274d4e9c","a0d10309a2dd456289147f84be9d37f9",22860435,1,1,0,2942,380,381,1
"a0d10309a2dd456289147f84be9d37f9","a0d10309a2dd456289147f84be9d37f9",22860435,2,0,1,2943,381,381,0
"a0d10309a2dd456289147f84be9d37f9","0fcbc3ca07b144138b8d85da581f09a8",22860435,1,1,0,2945,381,382,1
"0fcbc3ca07b144138b8d85da581f09a8","0fcbc3ca07b144138b8d85da581f09a8",22860435,2,0,1,2946,382,382,0
"0fcbc3ca07b144138b8d85da581f09a8","66baf19b6b904b70922329068c63746d",22860435,1,-6,0,2948,382,376,-6
"c2fca3669923477ab966ded303dea31c","18d3b836dd804224883cc9180b60a8e1",22860435,3,5,0,2952,383,387,4
"18d3b836dd804224883cc9180b60a8e1","66baf19b6b904b70922329068c63746d",22860435,1,-13,0,2953,387,376,-11
"18d3b836dd804224883cc9180b60a8e1","ac4e9b54acfe4670b4634859c7263cb5",22860435,1,6,0,2956,387,392,5
"ac4e9b54acfe4670b4634859c7263cb5","ac4e9b54acfe4670b4634859c7263cb5",22860435,1,0,1,2957,392,392,0
"ac4e9b54acfe4670b4634859c7263cb5","17f95d18bab743888e1736033dc3384d",22860435,1,-3,0,2958,392,389,-3
"17f95d18bab743888e1736033dc3384d","66baf19b6b904b70922329068c63746d",22860435,1,-16,0,2959,389,376,-13
"66baf19b6b904b70922329068c63746d","6f8881a745ac4c358a68b92c3b4abe81",22860435,1,22,0,2960,376,394,18
"6f8881a745ac4c358a68b92c3b4abe81","66baf19b6b904b70922329068c63746d",22860435,1,-22,0,2961,394,376,-18
"66baf19b6b904b70922329068c63746d","7f544639412e40a9ba27f43b415362ab",22860435,7,2,0,2962,376,378,2
"7f544639412e40a9ba27f43b415362ab","66baf19b6b904b70922329068c63746d",22860435,5,-2,0,2963,378,376,-2
"7f544639412e40a9ba27f43b415362ab","7f544639412e40a9ba27f43b415362ab",22860435,1,0,1,2967,378,378,0
"c2fca3669923477ab966ded303dea31c","4890121ce5d74576b4632b77cfc23398",22860435,2,6,0,2970,383,388,5
"4890121ce5d74576b4632b77cfc23398","4890121ce5d74576b4632b77cfc23398",22860435,1,0,1,2971,388,388,0
"4890121ce5d74576b4632b77cfc23398","18d3b836dd804224883cc9180b60a8e1",22860435,2,-1,0,2972,388,387,-1
"18d3b836dd804224883cc9180b60a8e1","96bb2b3e85a34d8b9544514e89f6fe97",22860435,3,4,0,2973,387,390,3
"96bb2b3e85a34d8b9544514e89f6fe97","96bb2b3e85a34d8b9544514e89f6fe97",22860435,1,0,1,2974,390,390,0
"96bb2b3e85a34d8b9544514e89f6fe97","6f8881a745ac4c358a68b92c3b4abe81",22860435,2,5,0,2975,390,394,4
"6f8881a745ac4c358a68b92c3b4abe81","17f95d18bab743888e1736033dc3384d",22860435,3,-6,0,2976,394,389,-5
"17f95d18bab743888e1736033dc3384d","6f8881a745ac4c358a68b92c3b4abe81",22860435,2,6,0,2977,389,394,5
"6f8881a745ac4c358a68b92c3b4abe81","f7002c8484354eceac57bc7bd62c76c1",22860435,3,-1,0,2978,394,393,-1
"f7002c8484354eceac57bc7bd62c76c1","f7002c8484354eceac57bc7bd62c76c1",22860435,1,0,1,2979,393,393,0
"f7002c8484354eceac57bc7bd62c76c1","6f8881a745ac4c358a68b92c3b4abe81",22860435,2,1,0,2980,393,394,1
"6f8881a745ac4c358a68b92c3b4abe81","0c12af0a4e7f4002852cf84b2537c161",22860435,2,2,0,2981,394,395,1
"0c12af0a4e7f4002852cf84b2537c161","96bb2b3e85a34d8b9544514e89f6fe97",22860435,1,-7,0,2982,395,390,-5
"96bb2b3e85a34d8b9544514e89f6fe97","f7002c8484354eceac57bc7bd62c76c1",22860435,1,4,0,2983,390,393,3
"f7002c8484354eceac57bc7bd62c76c1","4890121ce5d74576b4632b77cfc23398",22860435,1,-7,0,2984,393,388,-5
"4890121ce5d74576b4632b77cfc23398","17f95d18bab743888e1736033dc3384d",22860435,1,2,0,2985,388,389,1
"17f95d18bab743888e1736033dc3384d","18d3b836dd804224883cc9180b60a8e1",22860435,1,-3,0,2986,389,387,-2
"18d3b836dd804224883cc9180b60a8e1","c2fca3669923477ab966ded303dea31c",22860435,1,-5,0,2987,387,383,-4
"c2fca3669923477ab966ded303dea31c","7f544639412e40a9ba27f43b415362ab",22860435,1,-6,0,2988,383,378,-5
"7f544639412e40a9ba27f43b415362ab","44a277ea44dc4ae689fab4b82f0b4098",22860435,1,24,0,2989,378,397,19
"44a277ea44dc4ae689fab4b82f0b4098","44a277ea44dc4ae689fab4b82f0b4098",22860435,1,0,1,2990,397,397,0
"44a277ea44dc4ae689fab4b82f0b4098","0c12af0a4e7f4002852cf84b2537c161",22860435,1,-2,0,2991,397,395,-2
"0c12af0a4e7f4002852cf84b2537c161","66baf19b6b904b70922329068c63746d",22860435,3,-24,0,2992,395,376,-19
"66baf19b6b904b70922329068c63746d","4890121ce5d74576b4632b77cfc23398",22860435,2,14,0,2993,376,388,12
"4890121ce5d74576b4632b77cfc23398","c2fca3669923477ab966ded303dea31c",22860435,2,-6,0,2994,388,383,-5
"17f95d18bab743888e1736033dc3384d","f7002c8484354eceac57bc7bd62c76c1",22860435,2,5,0,2999,389,393,4
"f7002c8484354eceac57bc7bd62c76c1","0c12af0a4e7f4002852cf84b2537c161",22860435,4,3,0,3000,393,395,2
"0c12af0a4e7f4002852cf84b2537c161","6f8881a745ac4c358a68b92c3b4abe81",22860435,1,-2,0,3001,395,394,-1
"0c12af0a4e7f4002852cf84b2537c161","f7002c8484354eceac57bc7bd62c76c1",22860435,1,-3,0,3005,395,393,-2
"0c12af0a4e7f4002852cf84b2537c161","859e0b8d71694b12befb69ee698138f9",22860435,1,5,0,3007,395,399,4
"859e0b8d71694b12befb69ee698138f9","859e0b8d71694b12befb69ee698138f9",22860435,1,0,1,3008,399,399,0
"859e0b8d71694b12befb69ee698138f9","66baf19b6b904b70922329068c63746d",22860435,1,-29,0,3009,399,376,-23
"66baf19b6b904b70922329068c63746d","2b09a08242b54983aec7063990fb3f66",22860435,4,32,0,3010,376,400,24
"2b09a08242b54983aec7063990fb3f66","2b09a08242b54983aec7063990fb3f66",22860435,7,0,1,3011,400,400,0
"2b09a08242b54983aec7063990fb3f66","df8191ec5e584c838a899c378941a566",22860435,1,-4,0,3012,400,398,-2
"df8191ec5e584c838a899c378941a566","0c12af0a4e7f4002852cf84b2537c161",22860435,1,-4,0,3013,398,395,-3
"2b09a08242b54983aec7063990fb3f66","1f471b7a883a4df48211e8c6a81b59a7",22860435,1,1,0,3019,400,401,1
"1f471b7a883a4df48211e8c6a81b59a7","1f471b7a883a4df48211e8c6a81b59a7",22860435,1,0,1,3020,401,401,0
"1f471b7a883a4df48211e8c6a81b59a7","2b09a08242b54983aec7063990fb3f66",22860435,1,-1,0,3021,401,400,-1
"2b09a08242b54983aec7063990fb3f66","9de0d567bfa84fe5b77cb76f4a76a5d1",22860435,1,5,0,3023,400,404,4
"9de0d567bfa84fe5b77cb76f4a76a5d1","9de0d567bfa84fe5b77cb76f4a76a5d1",22860435,2,0,1,3024,404,404,0
"9de0d567bfa84fe5b77cb76f4a76a5d1","1157bd665ec4472fb58b751dc5099355",22860435,1,-1,0,3026,404,403,-1
"1157bd665ec4472fb58b751dc5099355","3c8a22d2f9c146ea956609e3ed4f2559",22860435,1,3,0,3027,403,405,2
"3c8a22d2f9c146ea956609e3ed4f2559","58fc9094275e4c49be3f4ba6d4acc0a4",22860435,3,2,0,3028,405,406,1
"58fc9094275e4c49be3f4ba6d4acc0a4","1157bd665ec4472fb58b751dc5099355",22860435,1,-5,0,3029,406,403,-3
"1157bd665ec4472fb58b751dc5099355","58fc9094275e4c49be3f4ba6d4acc0a4",22860435,2,5,0,3030,403,406,3
"58fc9094275e4c49be3f4ba6d4acc0a4","3c8a22d2f9c146ea956609e3ed4f2559",22860435,2,-2,0,3031,406,405,-1
"58fc9094275e4c49be3f4ba6d4acc0a4","c1c1be90b2b14c1ab4a5e1ee3c241902",22860435,1,1,0,3033,406,407,1
"c1c1be90b2b14c1ab4a5e1ee3c241902","c1c1be90b2b14c1ab4a5e1ee3c241902",22860435,5,0,1,3034,407,407,0
"c1c1be90b2b14c1ab4a5e1ee3c241902","02b3a1bead9244c1ba2f857c7da8f82a",22860435,1,2,0,3039,407,408,1
"02b3a1bead9244c1ba2f857c7da8f82a","58fc9094275e4c49be3f4ba6d4acc0a4",22860435,2,-3,0,3040,408,406,-2
"58fc9094275e4c49be3f4ba6d4acc0a4","02b3a1bead9244c1ba2f857c7da8f82a",22860435,2,3,0,3041,406,408,2
"58fc9094275e4c49be3f4ba6d4acc0a4","6206fc6479014bb193084c32409dc1b9",22860435,1,4,0,3043,406,409,3
"6206fc6479014bb193084c32409dc1b9","6206fc6479014bb193084c32409dc1b9",22860435,5,0,1,3044,409,409,0
"6206fc6479014bb193084c32409dc1b9","02b3a1bead9244c1ba2f857c7da8f82a",22860435,1,-1,0,3049,409,408,-1
"02b3a1bead9244c1ba2f857c7da8f82a","6a5f020451db426dacba9e2ea3fcc62a",22860435,2,3,0,3050,408,410,2
"6a5f020451db426dacba9e2ea3fcc62a","6a5f020451db426dacba9e2ea3fcc62a",22860435,1,0,1,3051,410,410,0
"6a5f020451db426dacba9e2ea3fcc62a","33a9d248b2e44588a5b07fc1342b9bc2",22860435,4,2,0,3052,410,411,1
"33a9d248b2e44588a5b07fc1342b9bc2","6a5f020451db426dacba9e2ea3fcc62a",22860435,2,-2,0,3053,411,410,-1
"33a9d248b2e44588a5b07fc1342b9bc2","c6f26bd420634f1cb7989e76fe6b16c0",22860435,1,1,0,3055,411,412,1
"c6f26bd420634f1cb7989e76fe6b16c0","c6f26bd420634f1cb7989e76fe6b16c0",22860435,5,0,1,3056,412,412,0
"c6f26bd420634f1cb7989e76fe6b16c0","2a65ee6e2ac64f6a8a55fbe5373ec763",22860435,1,1,0,3061,412,413,1
"2a65ee6e2ac64f6a8a55fbe5373ec763","2a65ee6e2ac64f6a8a55fbe5373ec763",22860435,2,0,1,3062,413,413,0
"2a65ee6e2ac64f6a8a55fbe5373ec763","33a9d248b2e44588a5b07fc1342b9bc2",22860435,1,-2,0,3064,413,411,-2
"33a9d248b2e44588a5b07fc1342b9bc2","2b09a08242b54983aec7063990fb3f66",22860435,1,-17,0,3065,411,400,-11
"2b09a08242b54983aec7063990fb3f66","1fd0f6dadbc14ebc965faf6122190b96",22860435,1,22,0,3066,400,415,15
"1fd0f6dadbc14ebc965faf6122190b96","1fd0f6dadbc14ebc965faf6122190b96",22860435,1,0,1,3067,415,415,0
"1fd0f6dadbc14ebc965faf6122190b96","687055dad9fc40c3982478fe33ec01bf",22860435,1,-1,0,3068,415,414,-1
"687055dad9fc40c3982478fe33ec01bf","2add1669f08d4101913db15f8c23b3b7",22860435,2,3,0,3069,414,416,2
"2add1669f08d4101913db15f8c23b3b7","2add1669f08d4101913db15f8c23b3b7",22860435,1,0,1,3070,416,416,0
"2add1669f08d4101913db15f8c23b3b7","a2b4bd40cee2481ebd3fc179d6a5cd62",22860435,1,3,0,3071,416,417,1
"a2b4bd40cee2481ebd3fc179d6a5cd62","2b09a08242b54983aec7063990fb3f66",22860435,2,-27,0,3072,417,400,-17
"2b09a08242b54983aec7063990fb3f66","e34e59dce2204f228f3a84b6725df60f",22860435,1,29,0,3073,400,419,19
"e34e59dce2204f228f3a84b6725df60f","e34e59dce2204f228f3a84b6725df60f",22860435,1,0,1,3074,419,419,0
"e34e59dce2204f228f3a84b6725df60f","a2b4bd40cee2481ebd3fc179d6a5cd62",22860435,1,-2,0,3075,419,417,-2
"a2b4bd40cee2481ebd3fc179d6a5cd62","bec48fc2e1294c7eb3d0aca780d731b8",22860435,3,4,0,3076,417,420,3
"bec48fc2e1294c7eb3d0aca780d731b8","687055dad9fc40c3982478fe33ec01bf",22860435,1,-10,0,3077,420,414,-6
"687055dad9fc40c3982478fe33ec01bf","687055dad9fc40c3982478fe33ec01bf",22860435,1,0,1,3078,414,414,0
"2add1669f08d4101913db15f8c23b3b7","687055dad9fc40c3982478fe33ec01bf",22860435,1,-3,0,3080,416,414,-2
"687055dad9fc40c3982478fe33ec01bf","2b09a08242b54983aec7063990fb3f66",22860435,1,-21,0,3081,414,400,-14
"2b09a08242b54983aec7063990fb3f66","a2b4bd40cee2481ebd3fc179d6a5cd62",22860435,2,27,0,3082,400,417,17
"a2b4bd40cee2481ebd3fc179d6a5cd62","a2b4bd40cee2481ebd3fc179d6a5cd62",22860435,2,0,1,3083,417,417,0
"bec48fc2e1294c7eb3d0aca780d731b8","bec48fc2e1294c7eb3d0aca780d731b8",22860435,3,0,1,3085,420,420,0
"bec48fc2e1294c7eb3d0aca780d731b8","a24600b0e49245f6bdba8c893cfeddb0",22860435,2,7,0,3087,420,425,5
"a24600b0e49245f6bdba8c893cfeddb0","dbde19fcce2a4c1abdc7f685c293a23f",22860435,2,-4,0,3088,425,422,-3
"dbde19fcce2a4c1abdc7f685c293a23f","a24600b0e49245f6bdba8c893cfeddb0",22860435,3,4,0,3089,422,425,3
"a24600b0e49245f6bdba8c893cfeddb0","a24600b0e49245f6bdba8c893cfeddb0",22860435,2,0,1,3090,425,425,0
"a24600b0e49245f6bdba8c893cfeddb0","bec48fc2e1294c7eb3d0aca780d731b8",22860435,1,-7,0,3091,425,420,-5
"a24600b0e49245f6bdba8c893cfeddb0","a2b4bd40cee2481ebd3fc179d6a5cd62",22860435,1,-11,0,3095,425,417,-8
"a2b4bd40cee2481ebd3fc179d6a5cd62","24cf8786024543f19b89bc20034e60d7",22860435,3,18,0,3096,417,428,11
"24cf8786024543f19b89bc20034e60d7","f2a73be2f46840b182d7bd095378004e",22860435,3,1,0,3097,428,429,1
"f2a73be2f46840b182d7bd095378004e","24cf8786024543f19b89bc20034e60d7",22860435,2,-1,0,3098,429,428,-1
"24cf8786024543f19b89bc20034e60d7","a2b4bd40cee2481ebd3fc179d6a5cd62",22860435,3,-18,0,3099,428,417,-11
"a2b4bd40cee2481ebd3fc179d6a5cd62","f2a73be2f46840b182d7bd095378004e",22860435,1,19,0,3100,417,429,12
"f2a73be2f46840b182d7bd095378004e","f2a73be2f46840b182d7bd095378004e",22860435,2,0,1,3101,429,429,0
"f2a73be2f46840b182d7bd095378004e","604551fd4266430cb860fef58fa7dd61",22860435,1,1,0,3108,429,430,1
"604551fd4266430cb860fef58fa7dd61","604551fd4266430cb860fef58fa7dd61",22860435,9,0,1,3109,430,430,0
"604551fd4266430cb860fef58fa7dd61","24cf8786024543f19b89bc20034e60d7",22860435,1,-2,0,3118,430,428,-2
"24cf8786024543f19b89bc20034e60d7","dce46f8904594a62a6377a3587aaa663",22860435,3,4,0,3119,428,431,3
"dce46f8904594a62a6377a3587aaa663","dce46f8904594a62a6377a3587aaa663",22860435,14,0,1,3120,431,431,0
"dce46f8904594a62a6377a3587aaa663","24cf8786024543f19b89bc20034e60d7",22860435,3,-4,0,3122,431,428,-3
"24cf8786024543f19b89bc20034e60d7","9b9d0a249052413c869753b99682b0ac",22860435,1,5,0,3123,428,432,4
"9b9d0a249052413c869753b99682b0ac","9b9d0a249052413c869753b99682b0ac",22860435,6,0,1,3124,432,432,0
"9b9d0a249052413c869753b99682b0ac","061c175cc90f45fbad883025394e78dd",22860435,1,1,0,3130,432,433,1
"061c175cc90f45fbad883025394e78dd","061c175cc90f45fbad883025394e78dd",22860435,5,0,1,3131,433,433,0
"061c175cc90f45fbad883025394e78dd","dce46f8904594a62a6377a3587aaa663",22860435,1,-2,0,3136,433,431,-2
"dce46f8904594a62a6377a3587aaa663","66ada10dde9f43018588f1ced9d477fc",22860435,3,4,0,3139,431,434,3
"66ada10dde9f43018588f1ced9d477fc","f2a73be2f46840b182d7bd095378004e",22860435,1,-7,0,3140,434,429,-5
"f2a73be2f46840b182d7bd095378004e","dce46f8904594a62a6377a3587aaa663",22860435,2,3,0,3141,429,431,2
"dce46f8904594a62a6377a3587aaa663","74a7f8712e5449c2bc0b43c6f90dafed",22860435,1,5,0,3145,431,435,4
"74a7f8712e5449c2bc0b43c6f90dafed","74a7f8712e5449c2bc0b43c6f90dafed",22860435,1,0,1,3146,435,435,0
"74a7f8712e5449c2bc0b43c6f90dafed","66ada10dde9f43018588f1ced9d477fc",22860435,1,-1,0,3147,435,434,-1
"66ada10dde9f43018588f1ced9d477fc","bf12c96466d840a69bed7020b3f18bb8",22860435,1,3,0,3148,434,436,2
"bf12c96466d840a69bed7020b3f18bb8","bf12c96466d840a69bed7020b3f18bb8",22860435,1,0,1,3149,436,436,0
"bf12c96466d840a69bed7020b3f18bb8","24cf8786024543f19b89bc20034e60d7",22860435,1,-11,0,3150,436,428,-8
"24cf8786024543f19b89bc20034e60d7","070600601c4c439288445d2f0724807d",22860435,4,14,0,3151,428,437,9
"070600601c4c439288445d2f0724807d","1823b6de7d334a7aaabc4570719af4d9",22860435,2,2,0,3152,437,439,2
"1823b6de7d334a7aaabc4570719af4d9","1823b6de7d334a7aaabc4570719af4d9",22860435,13,0,1,3153,439,439,0
"1823b6de7d334a7aaabc4570719af4d9","070600601c4c439288445d2f0724807d",22860435,2,-2,0,3166,439,437,-2
"070600601c4c439288445d2f0724807d","0380cd76a7d44bc3a4da1f15e4d68f89",22860435,4,4,0,3167,437,440,3
"0380cd76a7d44bc3a4da1f15e4d68f89","66ada10dde9f43018588f1ced9d477fc",22860435,1,-10,0,3168,440,434,-6
"66ada10dde9f43018588f1ced9d477fc","070600601c4c439288445d2f0724807d",22860435,3,6,0,3169,434,437,3
"070600601c4c439288445d2f0724807d","24cf8786024543f19b89bc20034e60d7",22860435,4,-14,0,3170,437,428,-9
"24cf8786024543f19b89bc20034e60d7","1823b6de7d334a7aaabc4570719af4d9",22860435,2,16,0,3171,428,439,11
"0380cd76a7d44bc3a4da1f15e4d68f89","0380cd76a7d44bc3a4da1f15e4d68f89",22860435,3,0,1,3174,440,440,0
"0380cd76a7d44bc3a4da1f15e4d68f89","23b7673c8b5443108c2ef09382834a86",22860435,5,2,0,3175,440,441,1
"23b7673c8b5443108c2ef09382834a86","0380cd76a7d44bc3a4da1f15e4d68f89",22860435,3,-2,0,3176,441,440,-1
"23b7673c8b5443108c2ef09382834a86","23b7673c8b5443108c2ef09382834a86",22860435,3,0,1,3179,441,441,0
"23b7673c8b5443108c2ef09382834a86","901e92500aea43c79f19f1b279050668",22860435,7,2,0,3184,441,442,1
"901e92500aea43c79f19f1b279050668","23b7673c8b5443108c2ef09382834a86",22860435,4,-2,0,3185,442,441,-1
"901e92500aea43c79f19f1b279050668","001339db8ced4cf78829ebe8b145449d",22860435,1,1,0,3189,442,443,1
"001339db8ced4cf78829ebe8b145449d","001339db8ced4cf78829ebe8b145449d",22860435,8,0,1,3190,443,443,0
"001339db8ced4cf78829ebe8b145449d","452745e0366e42ae81561bfddebcc6c3",22860435,1,1,0,3198,443,444,1
"452745e0366e42ae81561bfddebcc6c3","452745e0366e42ae81561bfddebcc6c3",22860435,2,0,1,3199,444,444,0
"452745e0366e42ae81561bfddebcc6c3","901e92500aea43c79f19f1b279050668",22860435,1,-2,0,3201,444,442,-2
"901e92500aea43c79f19f1b279050668","4660ff2089114e8db82ceb26a4f329e3",22860435,7,4,0,3202,442,445,3
"4660ff2089114e8db82ceb26a4f329e3","4660ff2089114e8db82ceb26a4f329e3",22860435,5,0,1,3203,445,445,0
"4660ff2089114e8db82ceb26a4f329e3","901e92500aea43c79f19f1b279050668",22860435,4,-4,0,3205,445,442,-3
"4660ff2089114e8db82ceb26a4f329e3","7bd5586eb9d8484eb74a433ee7bfe499",22860435,11,2,0,3207,445,446,1
"7bd5586eb9d8484eb74a433ee7bfe499","7bd5586eb9d8484eb74a433ee7bfe499",22860435,14,0,1,3208,446,446,0
"7bd5586eb9d8484eb74a433ee7bfe499","4660ff2089114e8db82ceb26a4f329e3",22860435,9,-2,0,3209,446,445,-1
"7bd5586eb9d8484eb74a433ee7bfe499","8a7f26e690f34dda97be16904518ca99",22860435,1,2,0,3233,446,447,1
"8a7f26e690f34dda97be16904518ca99","8a7f26e690f34dda97be16904518ca99",22860435,1,0,1,3234,447,447,0
"8a7f26e690f34dda97be16904518ca99","070600601c4c439288445d2f0724807d",22860435,1,-16,0,3235,447,437,-10
"070600601c4c439288445d2f0724807d","b2f0d654738f48158edff28e8d3a546e",22860435,5,21,0,3236,437,449,12
"b2f0d654738f48158edff28e8d3a546e","f60ee41ec635499abd48168342d32c2f",22860435,11,5,0,3237,449,453,4
"f60ee41ec635499abd48168342d32c2f","f60ee41ec635499abd48168342d32c2f",22860435,119,0,1,3238,453,453,0
"f60ee41ec635499abd48168342d32c2f","b2f0d654738f48158edff28e8d3a546e",22860435,5,-5,0,3240,453,449,-4
"f60ee41ec635499abd48168342d32c2f","9428d8bd9c5a47b2a235b254e5e27ded",22860435,3,-1,0,3255,453,452,-1
"9428d8bd9c5a47b2a235b254e5e27ded","b2f0d654738f48158edff28e8d3a546e",22860435,1,-4,0,3256,452,449,-3
"b2f0d654738f48158edff28e8d3a546e","070600601c4c439288445d2f0724807d",22860435,2,-21,0,3257,449,437,-12
"070600601c4c439288445d2f0724807d","8a7f26e690f34dda97be16904518ca99",22860435,1,16,0,3258,437,447,10
"8a7f26e690f34dda97be16904518ca99","7bd5586eb9d8484eb74a433ee7bfe499",22860435,3,-2,0,3259,447,446,-1
"7bd5586eb9d8484eb74a433ee7bfe499","b2f0d654738f48158edff28e8d3a546e",22860435,2,7,0,3262,446,449,3
"9428d8bd9c5a47b2a235b254e5e27ded","070600601c4c439288445d2f0724807d",22860435,2,-25,0,3272,452,437,-15
"b2f0d654738f48158edff28e8d3a546e","8a7f26e690f34dda97be16904518ca99",22860435,2,-5,0,3274,449,447,-2
"7bd5586eb9d8484eb74a433ee7bfe499","901e92500aea43c79f19f1b279050668",22860435,1,-6,0,3278,446,442,-4
"901e92500aea43c79f19f1b279050668","b2f0d654738f48158edff28e8d3a546e",22860435,1,13,0,3281,442,449,7
"4660ff2089114e8db82ceb26a4f329e3","23b7673c8b5443108c2ef09382834a86",22860435,1,-6,0,3299,445,441,-4
"0380cd76a7d44bc3a4da1f15e4d68f89","1823b6de7d334a7aaabc4570719af4d9",22860435,1,-2,0,3303,440,439,-1
"1823b6de7d334a7aaabc4570719af4d9","0380cd76a7d44bc3a4da1f15e4d68f89",22860435,3,2,0,3304,439,440,1
"0380cd76a7d44bc3a4da1f15e4d68f89","24cf8786024543f19b89bc20034e60d7",22860435,1,-18,0,3305,440,428,-12
"070600601c4c439288445d2f0724807d","bf12c96466d840a69bed7020b3f18bb8",22860435,1,-3,0,3307,437,436,-1
"bf12c96466d840a69bed7020b3f18bb8","66ada10dde9f43018588f1ced9d477fc",22860435,1,-3,0,3308,436,434,-2
"66ada10dde9f43018588f1ced9d477fc","dce46f8904594a62a6377a3587aaa663",22860435,1,-4,0,3309,434,431,-3
"24cf8786024543f19b89bc20034e60d7","24cf8786024543f19b89bc20034e60d7",22860435,1,0,1,3324,428,428,0
"0380cd76a7d44bc3a4da1f15e4d68f89","070600601c4c439288445d2f0724807d",22860435,2,-4,0,3328,440,437,-3
"7bd5586eb9d8484eb74a433ee7bfe499","070600601c4c439288445d2f0724807d",22860435,1,-14,0,3338,446,437,-9
"b2f0d654738f48158edff28e8d3a546e","b2f0d654738f48158edff28e8d3a546e",22860435,1,0,1,3340,449,449,0
"f60ee41ec635499abd48168342d32c2f","3434c10e561d488a914e0f7d71907abd",22860435,1,-212,0,3362,453,305,-148
"3434c10e561d488a914e0f7d71907abd","b2f0d654738f48158edff28e8d3a546e",22860435,1,207,0,3363,305,449,144
"b2f0d654738f48158edff28e8d3a546e","f67fbf45a5f146ed866965bc57c7c001",22860435,1,8,0,3428,449,454,5
"f67fbf45a5f146ed866965bc57c7c001","f67fbf45a5f146ed866965bc57c7c001",22860435,7,0,1,3429,454,454,0
"f67fbf45a5f146ed866965bc57c7c001","d937afe49bd24a07a550dda1c1155122",22860435,1,1,0,3431,454,455,1
"d937afe49bd24a07a550dda1c1155122","d937afe49bd24a07a550dda1c1155122",22860435,2,0,1,3432,455,455,0
"d937afe49bd24a07a550dda1c1155122","f67fbf45a5f146ed866965bc57c7c001",22860435,1,-1,0,3433,455,454,-1
"f67fbf45a5f146ed866965bc57c7c001","e20db35ced8544ddac5bc3839145e463",22860435,1,-501,0,3435,454,91,-363
"e20db35ced8544ddac5bc3839145e463","37319e88176d4aefa91d7a9980dbae91",22860435,1,24,0,3436,91,112,21
"37319e88176d4aefa91d7a9980dbae91","a9ae0a3c070d455bb4369a8996313336",22860435,1,2,0,3437,112,114,2
"a9ae0a3c070d455bb4369a8996313336","d937afe49bd24a07a550dda1c1155122",22860435,1,476,0,3438,114,455,341
"d937afe49bd24a07a550dda1c1155122","0c7262dff33c4087bc660ccf40f92f9c",22860435,1,-400,0,3440,455,169,-286
"f9170dd6bc6442b4acd832747609b09a","67a089198fcb4e1c8f2385786c2b296f",22860435,1,-208,0,3457,199,39,-160
"67a089198fcb4e1c8f2385786c2b296f","67a089198fcb4e1c8f2385786c2b296f",22860435,1,0,1,3458,39,39,0
"64d48c6c9c7940639a932219a6c87198","d9c8d8c444a64dadbbb508652c721e17",22860435,1,9,0,3461,40,46,6
"d9c8d8c444a64dadbbb508652c721e17","b534b89233134e30a9b5645138bfa9ee",22860435,1,-6,0,3462,46,41,-5
"6e13d61a7bdb44bca949c9f86fab3be5","f67fbf45a5f146ed866965bc57c7c001",22860435,1,557,0,3465,47,454,407
"f67fbf45a5f146ed866965bc57c7c001","c8e371568a0c4391b25796ae4e91952e",22860435,1,-376,0,3466,454,186,-268
"7108f0e4c2584f1f9c471689ae4c885c","0c7262dff33c4087bc660ccf40f92f9c",22860435,1,-51,0,3469,208,169,-39
"0c7262dff33c4087bc660ccf40f92f9c","3628b3f7823443d0912a339096b69943",22860435,1,401,0,3470,169,456,287
"3628b3f7823443d0912a339096b69943","3628b3f7823443d0912a339096b69943",22860435,1,0,1,3471,456,456,0
"3628b3f7823443d0912a339096b69943","9e049ee647cf43ecbcb5ed792a8e7588",22860435,1,1,0,3472,456,457,1
"9e049ee647cf43ecbcb5ed792a8e7588","9e049ee647cf43ecbcb5ed792a8e7588",22860435,1,0,1,3473,457,457,0
"9e049ee647cf43ecbcb5ed792a8e7588","5256a214faaf410b93f76cea06428334",22860435,1,1,0,3474,457,458,1
"5256a214faaf410b93f76cea06428334","5256a214faaf410b93f76cea06428334",22860435,3,0,1,3475,458,458,0
"5256a214faaf410b93f76cea06428334","25c32b120fce40fa9b6c85133aeb4716",22860435,1,1,0,3478,458,459,1
"25c32b120fce40fa9b6c85133aeb4716","25c32b120fce40fa9b6c85133aeb4716",22860435,6,0,1,3479,459,459,0
"25c32b120fce40fa9b6c85133aeb4716","3434c10e561d488a914e0f7d71907abd",22860435,1,-220,0,3480,459,305,-154
"130acc2aeb0448fdbb2de63bc5cebe5b","56d94971a7a94257aa330183a8ebd0ea",22860435,1,4,0,3482,309,313,4
"56d94971a7a94257aa330183a8ebd0ea","11bc14f2204949008b7d511b933363c1",22860435,1,212,0,3483,313,460,147
"11bc14f2204949008b7d511b933363c1","11bc14f2204949008b7d511b933363c1",22860435,4,0,1,3484,460,460,0
"11bc14f2204949008b7d511b933363c1","ea859f8207e44537889daeaba13ac2e8",22860435,1,-213,0,3485,460,312,-148
"ea859f8207e44537889daeaba13ac2e8","42de338840a34d15adb66e7b14fb9d2c",22860435,1,214,0,3487,312,461,149
"42de338840a34d15adb66e7b14fb9d2c","42de338840a34d15adb66e7b14fb9d2c",22860435,1,0,1,3488,461,461,0
"42de338840a34d15adb66e7b14fb9d2c","b2f0d654738f48158edff28e8d3a546e",22860435,1,-15,0,3489,461,449,-12
"f60ee41ec635499abd48168342d32c2f","66baf19b6b904b70922329068c63746d",22860435,1,-117,0,3498,453,376,-77
"7f544639412e40a9ba27f43b415362ab","9da37c6210b1416b8079c274f70bf600",22860435,1,126,0,3501,378,462,84
"9da37c6210b1416b8079c274f70bf600","9da37c6210b1416b8079c274f70bf600",22860435,1,0,1,3502,462,462,0
"9da37c6210b1416b8079c274f70bf600","66baf19b6b904b70922329068c63746d",22860435,1,-128,0,3503,462,376,-86
"96bb2b3e85a34d8b9544514e89f6fe97","17f95d18bab743888e1736033dc3384d",22860435,1,-1,0,3508,390,389,-1
"0c12af0a4e7f4002852cf84b2537c161","2b09a08242b54983aec7063990fb3f66",22860435,1,8,0,3512,395,400,5
"2b09a08242b54983aec7063990fb3f66","66baf19b6b904b70922329068c63746d",22860435,1,-32,0,3513,400,376,-24
"2b09a08242b54983aec7063990fb3f66","519119f1deac45ff9ab4f13529be5c6e",22860435,1,97,0,3515,400,463,63
"519119f1deac45ff9ab4f13529be5c6e","519119f1deac45ff9ab4f13529be5c6e",22860435,1,0,1,3516,463,463,0
"519119f1deac45ff9ab4f13529be5c6e","11bc14f2204949008b7d511b933363c1",22860435,1,-3,0,3517,463,460,-3
"11bc14f2204949008b7d511b933363c1","f67fbf45a5f146ed866965bc57c7c001",22860435,1,-6,0,3519,460,454,-6
"f67fbf45a5f146ed866965bc57c7c001","c5df9f40ec14463b9dcfdc73df3e9285",22860435,6,12,0,3520,454,464,10
"c5df9f40ec14463b9dcfdc73df3e9285","c5df9f40ec14463b9dcfdc73df3e9285",22860435,11,0,1,3521,464,464,0
"c5df9f40ec14463b9dcfdc73df3e9285","f67fbf45a5f146ed866965bc57c7c001",22860435,5,-12,0,3522,464,454,-10
"c5df9f40ec14463b9dcfdc73df3e9285","66baf19b6b904b70922329068c63746d",22860435,3,-132,0,3530,464,376,-88
"83d42d95cd844fc093fc09cee250edb8","c5df9f40ec14463b9dcfdc73df3e9285",22860435,8,-3,0,3535,465,464,-1
"c5df9f40ec14463b9dcfdc73df3e9285","83d42d95cd844fc093fc09cee250edb8",22860435,10,3,0,3538,464,465,1
"83d42d95cd844fc093fc09cee250edb8","f67fbf45a5f146ed866965bc57c7c001",22860435,2,-15,0,3541,465,454,-11
"f67fbf45a5f146ed866965bc57c7c001","11bc14f2204949008b7d511b933363c1",22860435,2,6,0,3557,454,460,6
"11bc14f2204949008b7d511b933363c1","25c32b120fce40fa9b6c85133aeb4716",22860435,1,-1,0,3560,460,459,-1
"25c32b120fce40fa9b6c85133aeb4716","83d42d95cd844fc093fc09cee250edb8",22860435,1,10,0,3565,459,465,6
"11bc14f2204949008b7d511b933363c1","d6d02b6ef04e4f17805504500b8ce441",22860435,1,-130,0,3573,460,375,-85
"7f544639412e40a9ba27f43b415362ab","c2fca3669923477ab966ded303dea31c",22860435,1,6,0,3582,378,383,5
"c2fca3669923477ab966ded303dea31c","c5df9f40ec14463b9dcfdc73df3e9285",22860435,1,124,0,3583,383,464,81
"66baf19b6b904b70922329068c63746d","c5df9f40ec14463b9dcfdc73df3e9285",22860435,1,132,0,3589,376,464,88
"83d42d95cd844fc093fc09cee250edb8","d6d02b6ef04e4f17805504500b8ce441",22860435,1,-139,0,3598,465,375,-90
"d6d02b6ef04e4f17805504500b8ce441","b7719e26494940efa49512aedd0aac79",22860435,1,-484,0,3604,375,20,-355
"afbf7250b99d47bea07172749483ca97","f67fbf45a5f146ed866965bc57c7c001",22860435,1,596,0,3607,28,454,426
"f67fbf45a5f146ed866965bc57c7c001","25c32b120fce40fa9b6c85133aeb4716",22860435,1,5,0,3608,454,459,5
"25c32b120fce40fa9b6c85133aeb4716","11bc14f2204949008b7d511b933363c1",22860435,1,1,0,3610,459,460,1
"11bc14f2204949008b7d511b933363c1","c5df9f40ec14463b9dcfdc73df3e9285",22860435,1,6,0,3611,460,464,4
"c2fca3669923477ab966ded303dea31c","96bb2b3e85a34d8b9544514e89f6fe97",22860435,1,9,0,3619,383,390,7
"96bb2b3e85a34d8b9544514e89f6fe97","18d3b836dd804224883cc9180b60a8e1",22860435,1,-4,0,3620,390,387,-3
"18d3b836dd804224883cc9180b60a8e1","6f8881a745ac4c358a68b92c3b4abe81",22860435,1,9,0,3621,387,394,7
"2b09a08242b54983aec7063990fb3f66","1157bd665ec4472fb58b751dc5099355",22860435,1,4,0,3629,400,403,3
"02b3a1bead9244c1ba2f857c7da8f82a","02b3a1bead9244c1ba2f857c7da8f82a",22860435,1,0,1,3634,408,408,0
"33a9d248b2e44588a5b07fc1342b9bc2","687055dad9fc40c3982478fe33ec01bf",22860435,1,4,0,3639,411,414,3
"687055dad9fc40c3982478fe33ec01bf","a2b4bd40cee2481ebd3fc179d6a5cd62",22860435,1,6,0,3640,414,417,3
"bec48fc2e1294c7eb3d0aca780d731b8","dbde19fcce2a4c1abdc7f685c293a23f",22860435,1,3,0,3645,420,422,2
"a24600b0e49245f6bdba8c893cfeddb0","24cf8786024543f19b89bc20034e60d7",22860435,1,7,0,3648,425,428,3
"f60ee41ec635499abd48168342d32c2f","f67fbf45a5f146ed866965bc57c7c001",22860435,1,3,0,3681,453,454,1
"f67fbf45a5f146ed866965bc57c7c001","b2f0d654738f48158edff28e8d3a546e",22860435,1,-8,0,3682,454,449,-5
"b2f0d654738f48158edff28e8d3a546e","c5df9f40ec14463b9dcfdc73df3e9285",22860435,1,20,0,3683,449,464,15
"83d42d95cd844fc093fc09cee250edb8","b7719e26494940efa49512aedd0aac79",22860435,1,-623,0,3689,465,20,-445
"b7719e26494940efa49512aedd0aac79","a49d1bb4328949299686242fd0be5584",22860435,1,2,0,3690,20,21,1
"a49d1bb4328949299686242fd0be5584","b7719e26494940efa49512aedd0aac79",22860435,2,-2,0,3691,21,20,-1
"b613861cecf84ffcab01afb23f660475","b613861cecf84ffcab01afb23f660475",22882512,9,0,1,1,1,1,0
"e2911e79efc2420eac45d9f671463d4b","b613861cecf84ffcab01afb23f660475",22882512,1,-3,0,5,2,1,-1
"b613861cecf84ffcab01afb23f660475","e2911e79efc2420eac45d9f671463d4b",22882512,2,3,0,12,1,2,1
"e2911e79efc2420eac45d9f671463d4b","e2911e79efc2420eac45d9f671463d4b",22882512,2,0,1,13,2,2,0
"e2911e79efc2420eac45d9f671463d4b","519d1b8c59404d67b54e96c5c8a830b2",22882512,1,1,0,15,2,3,1
"519d1b8c59404d67b54e96c5c8a830b2","519d1b8c59404d67b54e96c5c8a830b2",22882512,4,0,1,16,3,3,0
"519d1b8c59404d67b54e96c5c8a830b2","531db53f81f646edb0cdcfe0085b03b7",22882512,1,1,0,20,3,4,1
"531db53f81f646edb0cdcfe0085b03b7","531db53f81f646edb0cdcfe0085b03b7",22882512,4,0,1,21,4,4,0
"531db53f81f646edb0cdcfe0085b03b7","4f5f94b2f95141e0a9d53a61da2276da",22882512,1,1,0,25,4,5,1
"4f5f94b2f95141e0a9d53a61da2276da","4f5f94b2f95141e0a9d53a61da2276da",22882512,1,0,1,26,5,5,0
"4f5f94b2f95141e0a9d53a61da2276da","6d541c89590949f99af293c4f2333f67",22882512,1,1,0,27,5,6,1
"6d541c89590949f99af293c4f2333f67","6d541c89590949f99af293c4f2333f67",22882512,2,0,1,28,6,6,0
"6d541c89590949f99af293c4f2333f67","dd5cf0b9fe4c4f1d8f5ff8e4c04879cb",22882512,1,1,0,30,6,7,1
"dd5cf0b9fe4c4f1d8f5ff8e4c04879cb","dd5cf0b9fe4c4f1d8f5ff8e4c04879cb",22882512,1,0,1,31,7,7,0
"dd5cf0b9fe4c4f1d8f5ff8e4c04879cb","f96261861edc426abe2248be4f0a709a",22882512,1,1,0,32,7,8,1
"f96261861edc426abe2248be4f0a709a","f96261861edc426abe2248be4f0a709a",22882512,2,0,1,33,8,8,0
"f96261861edc426abe2248be4f0a709a","dd5cf0b9fe4c4f1d8f5ff8e4c04879cb",22882512,1,-1,0,35,8,7,-1
"dd5cf0b9fe4c4f1d8f5ff8e4c04879cb","4f5f94b2f95141e0a9d53a61da2276da",22882512,1,-2,0,36,7,5,-2
"4f5f94b2f95141e0a9d53a61da2276da","66b5e16f4f75454fb5b8172079f0fa83",22882512,1,4,0,37,5,9,4
"66b5e16f4f75454fb5b8172079f0fa83","66b5e16f4f75454fb5b8172079f0fa83",22882512,2,0,1,38,9,9,0
"66b5e16f4f75454fb5b8172079f0fa83","0680571d4698477995e41842c36a54b2",22882512,1,1,0,40,9,10,1
"0680571d4698477995e41842c36a54b2","0680571d4698477995e41842c36a54b2",22882512,1,0,1,41,10,10,0
"0680571d4698477995e41842c36a54b2","9112f2bffece48e08c6d2287be204085",22882512,1,1,0,42,10,11,1
"9112f2bffece48e08c6d2287be204085","9112f2bffece48e08c6d2287be204085",22882512,1,0,1,43,11,11,0
"9112f2bffece48e08c6d2287be204085","e2911e79efc2420eac45d9f671463d4b",22882512,1,-9,0,44,11,2,-9
"e2911e79efc2420eac45d9f671463d4b","56586aa865414f538729c7f7735d2bc6",22882512,2,12,0,45,2,12,10
"56586aa865414f538729c7f7735d2bc6","56586aa865414f538729c7f7735d2bc6",22882512,6,0,1,46,12,12,0
"56586aa865414f538729c7f7735d2bc6","e2911e79efc2420eac45d9f671463d4b",22882512,1,-12,0,47,12,2,-10
"56586aa865414f538729c7f7735d2bc6","b7f2b31585d94eb3bf86376714aa7070",22882512,1,2,0,54,12,13,1
"b7f2b31585d94eb3bf86376714aa7070","b7f2b31585d94eb3bf86376714aa7070",22882512,4,0,1,55,13,13,0
"b7f2b31585d94eb3bf86376714aa7070","3f1c815879794b929260d224becaff7e",22882512,1,2,0,59,13,14,1
"3f1c815879794b929260d224becaff7e","81c864a886d54a6b8ff85f7d736f4f95",22882512,1,2,0,60,14,15,1
"81c864a886d54a6b8ff85f7d736f4f95","5c5ceeee4562457ba6d41515aeebfbb1",22882512,1,4,0,61,15,17,2
"5c5ceeee4562457ba6d41515aeebfbb1","5c5ceeee4562457ba6d41515aeebfbb1",22882512,2,0,1,62,17,17,0
"5c5ceeee4562457ba6d41515aeebfbb1","9afd71a5298d4333b6849dfce1b9422c",22882512,1,3,0,64,17,18,1
"9afd71a5298d4333b6849dfce1b9422c","56586aa865414f538729c7f7735d2bc6",22882512,1,-13,0,65,18,12,-6
"56586aa865414f538729c7f7735d2bc6","daf8890a3c354459b8a962529aceb072",22882512,1,14,0,66,12,19,7
"daf8890a3c354459b8a962529aceb072","daf8890a3c354459b8a962529aceb072",22882512,1,0,1,67,19,19,0
"daf8890a3c354459b8a962529aceb072","9afd71a5298d4333b6849dfce1b9422c",22882512,1,-1,0,68,19,18,-1
"9afd71a5298d4333b6849dfce1b9422c","9afd71a5298d4333b6849dfce1b9422c",22882512,2,0,1,69,18,18,0
"9afd71a5298d4333b6849dfce1b9422c","b7719e26494940efa49512aedd0aac79",22882512,1,4,0,71,18,20,2
"b7719e26494940efa49512aedd0aac79","d4f45188d3c84a02ba08454e6403a818",22882512,1,5,0,72,20,24,4
"d4f45188d3c84a02ba08454e6403a818","d4c3b003e8274e429d2fa688d73fde6d",22882512,1,-2,0,73,24,22,-2
"d4c3b003e8274e429d2fa688d73fde6d","d4c3b003e8274e429d2fa688d73fde6d",22882512,5,0,1,74,22,22,0
"d4c3b003e8274e429d2fa688d73fde6d","b7719e26494940efa49512aedd0aac79",22882512,1,-3,0,79,22,20,-2
"b7719e26494940efa49512aedd0aac79","afbf7250b99d47bea07172749483ca97",22882512,2,12,0,80,20,28,8
"afbf7250b99d47bea07172749483ca97","b7719e26494940efa49512aedd0aac79",22882512,1,-12,0,81,28,20,-8
"afbf7250b99d47bea07172749483ca97","4e51676dc72045d99c19b9fa7b22f8bc",22882512,1,3,0,83,28,29,1
"4e51676dc72045d99c19b9fa7b22f8bc","4e51676dc72045d99c19b9fa7b22f8bc",22882512,1,0,1,84,29,29,0
"4e51676dc72045d99c19b9fa7b22f8bc","51970cfa30e643e894e66ae85c8024cc",22882512,1,3,0,85,29,31,2
"51970cfa30e643e894e66ae85c8024cc","4e51676dc72045d99c19b9fa7b22f8bc",22882512,1,-3,0,86,31,29,-2
"4e51676dc72045d99c19b9fa7b22f8bc","c33c17be71ae4d588da7369472e5bb1b",22882512,1,9,0,87,29,34,5
"c33c17be71ae4d588da7369472e5bb1b","c33c17be71ae4d588da7369472e5bb1b",22882512,1,0,1,88,34,34,0
"c33c17be71ae4d588da7369472e5bb1b","93679be414554a11b1893002f2229a93",22882512,1,3,0,89,34,35,1
"93679be414554a11b1893002f2229a93","93679be414554a11b1893002f2229a93",22882512,1,0,1,90,35,35,0
"93679be414554a11b1893002f2229a93","7040a13096d746ac84b8fac8d9752058",22882512,1,3,0,91,35,36,1
"7040a13096d746ac84b8fac8d9752058","9a0dc646f934470daf08c4b56ccf73db",22882512,2,3,0,92,36,37,1
"9a0dc646f934470daf08c4b56ccf73db","7040a13096d746ac84b8fac8d9752058",22882512,1,-3,0,93,37,36,-1
"9a0dc646f934470daf08c4b56ccf73db","fc0e049d56024bc9a02c9a9c435c3df7",22882512,1,3,0,95,37,38,1
"fc0e049d56024bc9a02c9a9c435c3df7","fc0e049d56024bc9a02c9a9c435c3df7",22882512,1,0,1,96,38,38,0
"fc0e049d56024bc9a02c9a9c435c3df7","67a089198fcb4e1c8f2385786c2b296f",22882512,1,4,0,97,38,39,1
"67a089198fcb4e1c8f2385786c2b296f","67a089198fcb4e1c8f2385786c2b296f",22882512,2,0,1,100,39,39,0
"67a089198fcb4e1c8f2385786c2b296f","64d48c6c9c7940639a932219a6c87198",22882512,2,1,0,102,39,40,1
"64d48c6c9c7940639a932219a6c87198","64d48c6c9c7940639a932219a6c87198",22882512,2,0,1,103,40,40,0
"64d48c6c9c7940639a932219a6c87198","67a089198fcb4e1c8f2385786c2b296f",22882512,2,-1,0,105,40,39,-1
"67a089198fcb4e1c8f2385786c2b296f","b534b89233134e30a9b5645138bfa9ee",22882512,1,4,0,106,39,41,2
"b534b89233134e30a9b5645138bfa9ee","0e37b720d23b4e7f8b313e79313fd107",22882512,1,3,0,107,41,44,3
"0e37b720d23b4e7f8b313e79313fd107","0e37b720d23b4e7f8b313e79313fd107",22882512,2,0,1,108,44,44,0
"0e37b720d23b4e7f8b313e79313fd107","6875d67fdd5f48168b62719df449bebd",22882512,1,1,0,110,44,45,1
"6875d67fdd5f48168b62719df449bebd","6875d67fdd5f48168b62719df449bebd",22882512,2,0,1,111,45,45,0
"6875d67fdd5f48168b62719df449bebd","b534b89233134e30a9b5645138bfa9ee",22882512,1,-4,0,113,45,41,-4
"b534b89233134e30a9b5645138bfa9ee","6e13d61a7bdb44bca949c9f86fab3be5",22882512,1,7,0,114,41,47,6
"6e13d61a7bdb44bca949c9f86fab3be5","6e13d61a7bdb44bca949c9f86fab3be5",22882512,2,0,1,115,47,47,0
"6e13d61a7bdb44bca949c9f86fab3be5","195f78799f984cc2b06c48dfe36be751",22882512,1,2,0,117,47,49,2
"195f78799f984cc2b06c48dfe36be751","195f78799f984cc2b06c48dfe36be751",22882512,3,0,1,118,49,49,0
"195f78799f984cc2b06c48dfe36be751","d9c8d8c444a64dadbbb508652c721e17",22882512,1,-3,0,121,49,46,-3
"d9c8d8c444a64dadbbb508652c721e17","d0c74f735e024943943e40333d6d337f",22882512,1,6,0,122,46,51,5
"d0c74f735e024943943e40333d6d337f","b534b89233134e30a9b5645138bfa9ee",22882512,1,-12,0,123,51,41,-10
"b534b89233134e30a9b5645138bfa9ee","d0c74f735e024943943e40333d6d337f",22882512,1,12,0,124,41,51,10
"d0c74f735e024943943e40333d6d337f","d0c74f735e024943943e40333d6d337f",22882512,2,0,1,125,51,51,0
"d0c74f735e024943943e40333d6d337f","35adfa5d923046aebabfefd98f35ff05",22882512,1,3,0,127,51,54,3
"35adfa5d923046aebabfefd98f35ff05","35adfa5d923046aebabfefd98f35ff05",22882512,2,0,1,128,54,54,0
"35adfa5d923046aebabfefd98f35ff05","b6f8a98476224da1b40e555ececc7ed8",22882512,1,1,0,130,54,55,1
"b6f8a98476224da1b40e555ececc7ed8","b6f8a98476224da1b40e555ececc7ed8",22882512,2,0,1,131,55,55,0
"b6f8a98476224da1b40e555ececc7ed8","86e22cb5fe0e4b47a9489ecddf7ed78f",22882512,1,1,0,133,55,56,1
"86e22cb5fe0e4b47a9489ecddf7ed78f","86e22cb5fe0e4b47a9489ecddf7ed78f",22882512,2,0,1,134,56,56,0
"86e22cb5fe0e4b47a9489ecddf7ed78f","f924752d8a1149668870b1e7698486f7",22882512,1,-6,0,136,56,50,-6
"f924752d8a1149668870b1e7698486f7","a1f2f12debe5432fb7a70bcd12bacfb9",22882512,1,9,0,137,50,58,8
"a1f2f12debe5432fb7a70bcd12bacfb9","78f30e4dcac84e3cbea8b2cc6e0d62b3",22882512,4,1,0,138,58,59,1
"78f30e4dcac84e3cbea8b2cc6e0d62b3","b534b89233134e30a9b5645138bfa9ee",22882512,1,-21,0,139,59,41,-18
"b534b89233134e30a9b5645138bfa9ee","a1f2f12debe5432fb7a70bcd12bacfb9",22882512,1,20,0,140,41,58,17
"78f30e4dcac84e3cbea8b2cc6e0d62b3","12aa6e1672ac4e7aa6449a7a8609cd72",22882512,2,-2,0,142,59,57,-2
"12aa6e1672ac4e7aa6449a7a8609cd72","b534b89233134e30a9b5645138bfa9ee",22882512,1,-19,0,143,57,41,-16
"b534b89233134e30a9b5645138bfa9ee","12aa6e1672ac4e7aa6449a7a8609cd72",22882512,1,19,0,144,41,57,16
"12aa6e1672ac4e7aa6449a7a8609cd72","a1f2f12debe5432fb7a70bcd12bacfb9",22882512,1,1,0,145,57,58,1
"78f30e4dcac84e3cbea8b2cc6e0d62b3","a1f2f12debe5432fb7a70bcd12bacfb9",22882512,1,-1,0,147,59,58,-1
"a1f2f12debe5432fb7a70bcd12bacfb9","a1f2f12debe5432fb7a70bcd12bacfb9",22882512,26,0,1,148,58,58,0
"78f30e4dcac84e3cbea8b2cc6e0d62b3","78f30e4dcac84e3cbea8b2cc6e0d62b3",22882512,13,0,1,175,59,59,0
"12aa6e1672ac4e7aa6449a7a8609cd72","bc42d26810654ea9a1df1efe1e58c7d5",22882512,1,7,0,189,57,63,6
"bc42d26810654ea9a1df1efe1e58c7d5","a0a418b8540d479fa6e0f653b701da8b",22882512,2,1,0,190,63,64,1
"a0a418b8540d479fa6e0f653b701da8b","4c943503763e4e349906eea3ed3c8e86",22882512,1,-3,0,191,64,61,-3
"4c943503763e4e349906eea3ed3c8e86","4c943503763e4e349906eea3ed3c8e86",22882512,2,0,1,192,61,61,0
"4c943503763e4e349906eea3ed3c8e86","bc42d26810654ea9a1df1efe1e58c7d5",22882512,1,2,0,194,61,63,2
"bc42d26810654ea9a1df1efe1e58c7d5","bc42d26810654ea9a1df1efe1e58c7d5",22882512,3,0,1,195,63,63,0
"a0a418b8540d479fa6e0f653b701da8b","a0a418b8540d479fa6e0f653b701da8b",22882512,3,0,1,199,64,64,0
"a0a418b8540d479fa6e0f653b701da8b","309ccf3cc4fe429d9bfbaef53d3fa479",22882512,1,-4,0,202,64,60,-4
"309ccf3cc4fe429d9bfbaef53d3fa479","b534b89233134e30a9b5645138bfa9ee",22882512,1,-23,0,203,60,41,-19
"b534b89233134e30a9b5645138bfa9ee","d646286c8051419bbc2e31dd1db55ca8",22882512,1,33,0,204,41,67,26
"d646286c8051419bbc2e31dd1db55ca8","267f883678b24aed855fde42524975d9",22882512,1,4,0,205,67,71,4
"267f883678b24aed855fde42524975d9","267f883678b24aed855fde42524975d9",22882512,2,0,1,206,71,71,0
"267f883678b24aed855fde42524975d9","88fff56d0342490dbef9040750a20f6c",22882512,1,1,0,208,71,72,1
"88fff56d0342490dbef9040750a20f6c","88fff56d0342490dbef9040750a20f6c",22882512,5,0,1,209,72,72,0
"88fff56d0342490dbef9040750a20f6c","adb17b12b66c4a49a85fd34322f7df70",22882512,1,1,0,214,72,73,1
"adb17b12b66c4a49a85fd34322f7df70","adb17b12b66c4a49a85fd34322f7df70",22882512,1,0,1,215,73,73,0
"adb17b12b66c4a49a85fd34322f7df70","d646286c8051419bbc2e31dd1db55ca8",22882512,1,-6,0,216,73,67,-6
"d646286c8051419bbc2e31dd1db55ca8","a2becd407db34b189200a32546d9d569",22882512,1,9,0,217,67,75,8
"a2becd407db34b189200a32546d9d569","a2becd407db34b189200a32546d9d569",22882512,2,0,1,218,75,75,0
"a2becd407db34b189200a32546d9d569","58c22b011d0f4c2ea6d13615edbb9eeb",22882512,1,2,0,220,75,77,2
"58c22b011d0f4c2ea6d13615edbb9eeb","58c22b011d0f4c2ea6d13615edbb9eeb",22882512,2,0,1,221,77,77,0
"58c22b011d0f4c2ea6d13615edbb9eeb","dd76e1861dc9461c830888729d091ee0",22882512,1,1,0,223,77,78,1
"dd76e1861dc9461c830888729d091ee0","dd76e1861dc9461c830888729d091ee0",22882512,5,0,1,224,78,78,0
"dd76e1861dc9461c830888729d091ee0","cd1d828f1a694b87913a7ea66c23803e",22882512,1,1,0,229,78,79,1
"cd1d828f1a694b87913a7ea66c23803e","cd1d828f1a694b87913a7ea66c23803e",22882512,2,0,1,230,79,79,0
"cd1d828f1a694b87913a7ea66c23803e","9176a3c2b4d2465fa8b0c67096c2a97e",22882512,1,1,0,232,79,80,1
"9176a3c2b4d2465fa8b0c67096c2a97e","9176a3c2b4d2465fa8b0c67096c2a97e",22882512,11,0,1,233,80,80,0
"9176a3c2b4d2465fa8b0c67096c2a97e","f8ec6445f7194e25b9101d4fbcb07a18",22882512,1,1,0,244,80,81,1
"f8ec6445f7194e25b9101d4fbcb07a18","f8ec6445f7194e25b9101d4fbcb07a18",22882512,2,0,1,245,81,81,0
"f8ec6445f7194e25b9101d4fbcb07a18","140d5b27b8574befad82c0a013b59dfa",22882512,1,-7,0,247,81,74,-7
"140d5b27b8574befad82c0a013b59dfa","d18a9ea32855445f8736581f5cb119ce",22882512,1,9,0,248,74,82,8
"d18a9ea32855445f8736581f5cb119ce","f564483cbd7a407681aa2fcca518cf5f",22882512,1,4,0,249,82,85,3
"f564483cbd7a407681aa2fcca518cf5f","f564483cbd7a407681aa2fcca518cf5f",22882512,6,0,1,250,85,85,0
"f564483cbd7a407681aa2fcca518cf5f","18fd01350bd5434ca636d59a599d768a",22882512,1,1,0,256,85,86,1
"18fd01350bd5434ca636d59a599d768a","18fd01350bd5434ca636d59a599d768a",22882512,8,0,1,257,86,86,0
"18fd01350bd5434ca636d59a599d768a","ae5ac430ea254e708a6f5deaaf7464ae",22882512,1,-2,0,265,86,84,-2
"ae5ac430ea254e708a6f5deaaf7464ae","6a9f0ef185fb47f0937e29daa1c71ed5",22882512,1,7,0,266,84,90,6
"6a9f0ef185fb47f0937e29daa1c71ed5","c681290961c94c4caf23b529d1ae6b9a",22882512,1,-2,0,267,90,88,-2
"c681290961c94c4caf23b529d1ae6b9a","c681290961c94c4caf23b529d1ae6b9a",22882512,2,0,1,268,88,88,0
"c681290961c94c4caf23b529d1ae6b9a","6a9f0ef185fb47f0937e29daa1c71ed5",22882512,1,2,0,270,88,90,2
"6a9f0ef185fb47f0937e29daa1c71ed5","6a9f0ef185fb47f0937e29daa1c71ed5",22882512,3,0,1,271,90,90,0
"6a9f0ef185fb47f0937e29daa1c71ed5","e20db35ced8544ddac5bc3839145e463",22882512,1,3,0,274,90,91,1
"e20db35ced8544ddac5bc3839145e463","d646286c8051419bbc2e31dd1db55ca8",22882512,1,-30,0,275,91,67,-24
"d646286c8051419bbc2e31dd1db55ca8","1febb706d7a34005ae8711ed49c76e64",22882512,1,33,0,276,67,94,27
"1febb706d7a34005ae8711ed49c76e64","1febb706d7a34005ae8711ed49c76e64",22882512,3,0,1,277,94,94,0
"1febb706d7a34005ae8711ed49c76e64","8f73ba6f5a0042f2850356ac38ac6f24",22882512,1,1,0,280,94,95,1
"8f73ba6f5a0042f2850356ac38ac6f24","8f73ba6f5a0042f2850356ac38ac6f24",22882512,2,0,1,281,95,95,0
"8f73ba6f5a0042f2850356ac38ac6f24","e2260b86653c46d7b14a41fb419dbf8c",22882512,1,1,0,283,95,96,1
"e2260b86653c46d7b14a41fb419dbf8c","e2260b86653c46d7b14a41fb419dbf8c",22882512,2,0,1,284,96,96,0
"e2260b86653c46d7b14a41fb419dbf8c","35eb641ad1d845bbba54915bce75a962",22882512,1,1,0,286,96,97,1
"35eb641ad1d845bbba54915bce75a962","35eb641ad1d845bbba54915bce75a962",22882512,5,0,1,287,97,97,0
"35eb641ad1d845bbba54915bce75a962","08be90ffbeea4795a138cd42ed8db56f",22882512,1,1,0,292,97,98,1
"08be90ffbeea4795a138cd42ed8db56f","08be90ffbeea4795a138cd42ed8db56f",22882512,5,0,1,293,98,98,0
"08be90ffbeea4795a138cd42ed8db56f","3007433c8f584dcbb5ac159c1c5f2be3",22882512,1,1,0,298,98,99,1
"3007433c8f584dcbb5ac159c1c5f2be3","3007433c8f584dcbb5ac159c1c5f2be3",22882512,5,0,1,299,99,99,0
"3007433c8f584dcbb5ac159c1c5f2be3","e20db35ced8544ddac5bc3839145e463",22882512,1,-8,0,304,99,91,-8
"e20db35ced8544ddac5bc3839145e463","00ae5f0c51874a73a41ebea838d95682",22882512,1,11,0,305,91,101,10
"00ae5f0c51874a73a41ebea838d95682","d391c8b6e56a43a7b654e9dee02d904b",22882512,2,2,0,306,101,103,2
"d391c8b6e56a43a7b654e9dee02d904b","00ae5f0c51874a73a41ebea838d95682",22882512,1,-2,0,307,103,101,-2
"d391c8b6e56a43a7b654e9dee02d904b","d391c8b6e56a43a7b654e9dee02d904b",22882512,15,0,1,309,103,103,0
"d391c8b6e56a43a7b654e9dee02d904b","6111116566fc4fd9abba409322bea245",22882512,1,1,0,324,103,104,1
"6111116566fc4fd9abba409322bea245","6111116566fc4fd9abba409322bea245",22882512,2,0,1,325,104,104,0
"6111116566fc4fd9abba409322bea245","a81b2235cb9c499eb9ea8ee0a8dd9725",22882512,1,1,0,327,104,105,1
"a81b2235cb9c499eb9ea8ee0a8dd9725","a81b2235cb9c499eb9ea8ee0a8dd9725",22882512,5,0,1,328,105,105,0
"a81b2235cb9c499eb9ea8ee0a8dd9725","2d4e0ab0ef3b4d73b82c72d4621a7579",22882512,1,1,0,333,105,106,1
"2d4e0ab0ef3b4d73b82c72d4621a7579","2d4e0ab0ef3b4d73b82c72d4621a7579",22882512,2,0,1,334,106,106,0
"2d4e0ab0ef3b4d73b82c72d4621a7579","8bdebf492ebd4e62b0d522e8ab5e5197",22882512,1,1,0,336,106,107,1
"8bdebf492ebd4e62b0d522e8ab5e5197","8bdebf492ebd4e62b0d522e8ab5e5197",22882512,2,0,1,337,107,107,0
"8bdebf492ebd4e62b0d522e8ab5e5197","73039f8c1eb9409cb4caee2cf968001e",22882512,1,-7,0,339,107,100,-7
"73039f8c1eb9409cb4caee2cf968001e","4280927ec4d643238aa49c32f9e06c6c",22882512,1,10,0,340,100,109,9
"4280927ec4d643238aa49c32f9e06c6c","4280927ec4d643238aa49c32f9e06c6c",22882512,1,0,1,341,109,109,0
"4280927ec4d643238aa49c32f9e06c6c","fc44e6a5f7654430af1227838224dceb",22882512,1,2,0,342,109,111,2
"fc44e6a5f7654430af1227838224dceb","fc44e6a5f7654430af1227838224dceb",22882512,5,0,1,343,111,111,0
"fc44e6a5f7654430af1227838224dceb","08111f75e22d409998cf8b85bd431f0a",22882512,1,-3,0,348,111,108,-3
"08111f75e22d409998cf8b85bd431f0a","a9ae0a3c070d455bb4369a8996313336",22882512,1,7,0,349,108,114,6
"a9ae0a3c070d455bb4369a8996313336","37319e88176d4aefa91d7a9980dbae91",22882512,1,-2,0,350,114,112,-2
"37319e88176d4aefa91d7a9980dbae91","37319e88176d4aefa91d7a9980dbae91",22882512,1,0,1,351,112,112,0
"37319e88176d4aefa91d7a9980dbae91","e20db35ced8544ddac5bc3839145e463",22882512,1,-24,0,352,112,91,-21
"e20db35ced8544ddac5bc3839145e463","a9ae0a3c070d455bb4369a8996313336",22882512,1,26,0,353,91,114,23
"a9ae0a3c070d455bb4369a8996313336","a9ae0a3c070d455bb4369a8996313336",22882512,1,0,1,354,114,114,0
"a9ae0a3c070d455bb4369a8996313336","71cec822bcff4f30a20e75dc63ef7b65",22882512,1,2,0,355,114,116,2
"71cec822bcff4f30a20e75dc63ef7b65","71cec822bcff4f30a20e75dc63ef7b65",22882512,3,0,1,356,116,116,0
"71cec822bcff4f30a20e75dc63ef7b65","37319e88176d4aefa91d7a9980dbae91",22882512,1,-4,0,359,116,112,-4
"37319e88176d4aefa91d7a9980dbae91","62bff51286ef4f348717a3cf6fe2318f",22882512,1,9,0,360,112,120,8
"62bff51286ef4f348717a3cf6fe2318f","b1cd0e7dc3ad4a8eb91a4bfdbeb025b0",22882512,1,-2,0,361,120,118,-2
"b1cd0e7dc3ad4a8eb91a4bfdbeb025b0","b1cd0e7dc3ad4a8eb91a4bfdbeb025b0",22882512,2,0,1,362,118,118,0
"b1cd0e7dc3ad4a8eb91a4bfdbeb025b0","62bff51286ef4f348717a3cf6fe2318f",22882512,1,2,0,364,118,120,2
"62bff51286ef4f348717a3cf6fe2318f","62bff51286ef4f348717a3cf6fe2318f",22882512,3,0,1,365,120,120,0
"62bff51286ef4f348717a3cf6fe2318f","e20db35ced8544ddac5bc3839145e463",22882512,1,-33,0,368,120,91,-29
"e20db35ced8544ddac5bc3839145e463","779f9ddd1fd14d1e9e69f72219a1fdbd",22882512,1,36,0,369,91,121,30
"779f9ddd1fd14d1e9e69f72219a1fdbd","ae26e6cda8ad4a3f81bd347560d9579f",22882512,1,4,0,370,121,125,4
"ae26e6cda8ad4a3f81bd347560d9579f","ae26e6cda8ad4a3f81bd347560d9579f",22882512,1,0,1,371,125,125,0
"ae26e6cda8ad4a3f81bd347560d9579f","ee48df95832b4374aa273ceb27ec1315",22882512,1,1,0,372,125,126,1
"ee48df95832b4374aa273ceb27ec1315","ee48df95832b4374aa273ceb27ec1315",22882512,1,0,1,373,126,126,0
"ee48df95832b4374aa273ceb27ec1315","7a439da90b394756ad1777fc4c6dead5",22882512,1,1,0,374,126,127,1
"7a439da90b394756ad1777fc4c6dead5","7a439da90b394756ad1777fc4c6dead5",22882512,3,0,1,375,127,127,0
"7a439da90b394756ad1777fc4c6dead5","779f9ddd1fd14d1e9e69f72219a1fdbd",22882512,1,-6,0,378,127,121,-6
"779f9ddd1fd14d1e9e69f72219a1fdbd","a8dd5213034441ac92724b4e83eb0bb2",22882512,3,9,0,379,121,129,8
"a8dd5213034441ac92724b4e83eb0bb2","a8dd5213034441ac92724b4e83eb0bb2",22882512,2,0,1,380,129,129,0
"a8dd5213034441ac92724b4e83eb0bb2","8115eab6556b45f5b415c3b8c26a12e5",22882512,1,2,0,381,129,131,2
"8115eab6556b45f5b415c3b8c26a12e5","8115eab6556b45f5b415c3b8c26a12e5",22882512,2,0,1,382,131,131,0
"8115eab6556b45f5b415c3b8c26a12e5","ec34b06efd844b46a4c4818ecdb9b8f4",22882512,1,1,0,384,131,132,1
"ec34b06efd844b46a4c4818ecdb9b8f4","ec34b06efd844b46a4c4818ecdb9b8f4",22882512,2,0,1,385,132,132,0
"ec34b06efd844b46a4c4818ecdb9b8f4","c2e1c2b9eac64109b343a088584b576b",22882512,1,1,0,387,132,133,1
"c2e1c2b9eac64109b343a088584b576b","c2e1c2b9eac64109b343a088584b576b",22882512,4,0,1,388,133,133,0
"c2e1c2b9eac64109b343a088584b576b","579338175e0b4bbb8ef3b712b5d8b54e",22882512,1,-5,0,392,133,128,-5
"579338175e0b4bbb8ef3b712b5d8b54e","c2e1c2b9eac64109b343a088584b576b",22882512,1,5,0,393,128,133,5
"c2e1c2b9eac64109b343a088584b576b","8bc5795d6a984a3eace4e2811e52dd4f",22882512,1,3,0,394,133,135,2
"8bc5795d6a984a3eace4e2811e52dd4f","8bc5795d6a984a3eace4e2811e52dd4f",22882512,7,0,1,395,135,135,0
"8bc5795d6a984a3eace4e2811e52dd4f","b416d47c56a742199b5d7c7f19d6503a",22882512,3,-1,0,400,135,134,-1
"b416d47c56a742199b5d7c7f19d6503a","cd4532ad48034873ba8bce2aac0c9808",22882512,2,4,0,401,134,137,3
"cd4532ad48034873ba8bce2aac0c9808","cd4532ad48034873ba8bce2aac0c9808",22882512,7,0,1,402,137,137,0
"cd4532ad48034873ba8bce2aac0c9808","779f9ddd1fd14d1e9e69f72219a1fdbd",22882512,1,-19,0,407,137,121,-16
"779f9ddd1fd14d1e9e69f72219a1fdbd","df1de691dafe4549a18a4398ee9dfaf9",22882512,1,23,0,408,121,139,18
"df1de691dafe4549a18a4398ee9dfaf9","cd4532ad48034873ba8bce2aac0c9808",22882512,1,-4,0,409,139,137,-2
"cd4532ad48034873ba8bce2aac0c9808","6c5ad271a44743479bfaea29b1db8d02",22882512,1,8,0,411,137,143,6
"6c5ad271a44743479bfaea29b1db8d02","df1de691dafe4549a18a4398ee9dfaf9",22882512,1,-4,0,412,143,139,-4
"df1de691dafe4549a18a4398ee9dfaf9","df1de691dafe4549a18a4398ee9dfaf9",22882512,2,0,1,413,139,139,0
"df1de691dafe4549a18a4398ee9dfaf9","6c5ad271a44743479bfaea29b1db8d02",22882512,1,4,0,415,139,143,4
"6c5ad271a44743479bfaea29b1db8d02","6c5ad271a44743479bfaea29b1db8d02",22882512,1,0,1,416,143,143,0
"6c5ad271a44743479bfaea29b1db8d02","83d311bed5374fee83d8d67a7d9d82dc",22882512,1,1,0,417,143,144,1
"83d311bed5374fee83d8d67a7d9d82dc","83d311bed5374fee83d8d67a7d9d82dc",22882512,1,0,1,418,144,144,0
"83d311bed5374fee83d8d67a7d9d82dc","402bba41861d43acb52a5abb89e8831e",22882512,1,1,0,419,144,145,1
"402bba41861d43acb52a5abb89e8831e","402bba41861d43acb52a5abb89e8831e",22882512,2,0,1,420,145,145,0
"402bba41861d43acb52a5abb89e8831e","df1de691dafe4549a18a4398ee9dfaf9",22882512,1,-6,0,422,145,139,-6
"df1de691dafe4549a18a4398ee9dfaf9","8aae34f5ddbb4052a709b12e6b0d40fa",22882512,1,9,0,423,139,147,8
"8aae34f5ddbb4052a709b12e6b0d40fa","8aae34f5ddbb4052a709b12e6b0d40fa",22882512,1,0,1,424,147,147,0
"8aae34f5ddbb4052a709b12e6b0d40fa","645b3f0249f64f76af2e19eb4d0e55b7",22882512,1,2,0,425,147,149,2
"645b3f0249f64f76af2e19eb4d0e55b7","645b3f0249f64f76af2e19eb4d0e55b7",22882512,2,0,1,426,149,149,0
"645b3f0249f64f76af2e19eb4d0e55b7","7e7b8db5064d4369805ab370aac5ddfb",22882512,1,1,0,428,149,150,1
"7e7b8db5064d4369805ab370aac5ddfb","7e7b8db5064d4369805ab370aac5ddfb",22882512,2,0,1,429,150,150,0
"7e7b8db5064d4369805ab370aac5ddfb","8956d210ae7f41968fada86d4c979d6a",22882512,1,1,0,431,150,151,1
"8956d210ae7f41968fada86d4c979d6a","8956d210ae7f41968fada86d4c979d6a",22882512,5,0,1,432,151,151,0
"8956d210ae7f41968fada86d4c979d6a","f902b0f41b544d4dbf79664fd233648d",22882512,1,-5,0,437,151,146,-5
"f902b0f41b544d4dbf79664fd233648d","ae781e8b775e4ccd93bc800dad5c8376",22882512,1,8,0,438,146,153,7
"ae781e8b775e4ccd93bc800dad5c8376","ae781e8b775e4ccd93bc800dad5c8376",22882512,5,0,1,439,153,153,0
"ae781e8b775e4ccd93bc800dad5c8376","06882a8492d9499aa31555567f575ecb",22882512,1,1,0,444,153,154,1
"06882a8492d9499aa31555567f575ecb","06882a8492d9499aa31555567f575ecb",22882512,1,0,1,445,154,154,0
"06882a8492d9499aa31555567f575ecb","f293c508f409466a8f27ddd7d1e40b20",22882512,1,1,0,446,154,155,1
"f293c508f409466a8f27ddd7d1e40b20","f293c508f409466a8f27ddd7d1e40b20",22882512,2,0,1,447,155,155,0
"f293c508f409466a8f27ddd7d1e40b20","cc4ddef5bbbe48ebb605141b347c4ed1",22882512,1,1,0,449,155,156,1
"cc4ddef5bbbe48ebb605141b347c4ed1","cc4ddef5bbbe48ebb605141b347c4ed1",22882512,1,0,1,450,156,156,0
"cc4ddef5bbbe48ebb605141b347c4ed1","f03480cf4eba413194d7af52fc0e7f28",22882512,1,-4,0,451,156,152,-4
"f03480cf4eba413194d7af52fc0e7f28","d313cec988a84645bee413e8d4724a4b",22882512,1,7,0,452,152,158,6
"d313cec988a84645bee413e8d4724a4b","d313cec988a84645bee413e8d4724a4b",22882512,4,0,1,453,158,158,0
"d313cec988a84645bee413e8d4724a4b","dc60696c76a74368a60f72246e47700d",22882512,1,1,0,457,158,159,1
"dc60696c76a74368a60f72246e47700d","dc60696c76a74368a60f72246e47700d",22882512,3,0,1,458,159,159,0
"dc60696c76a74368a60f72246e47700d","df1de691dafe4549a18a4398ee9dfaf9",22882512,1,-23,0,461,159,139,-20
"df1de691dafe4549a18a4398ee9dfaf9","78adeee1fa2c4fe0bc73f7bca9fcee86",22882512,1,26,0,462,139,160,21
"78adeee1fa2c4fe0bc73f7bca9fcee86","579338175e0b4bbb8ef3b712b5d8b54e",22882512,1,-41,0,463,160,128,-32
"579338175e0b4bbb8ef3b712b5d8b54e","779f9ddd1fd14d1e9e69f72219a1fdbd",22882512,2,-8,0,464,128,121,-7
"a8dd5213034441ac92724b4e83eb0bb2","579338175e0b4bbb8ef3b712b5d8b54e",22882512,2,-1,0,466,129,128,-1
"579338175e0b4bbb8ef3b712b5d8b54e","8bc5795d6a984a3eace4e2811e52dd4f",22882512,2,8,0,467,128,135,7
"b416d47c56a742199b5d7c7f19d6503a","8959e6304a0348309a771e4d08d1b64a",22882512,1,38,0,470,134,163,29
"8959e6304a0348309a771e4d08d1b64a","78adeee1fa2c4fe0bc73f7bca9fcee86",22882512,1,-4,0,471,163,160,-3
"78adeee1fa2c4fe0bc73f7bca9fcee86","65202579580f4ad38d734b4ee39d22a8",22882512,4,5,0,472,160,164,4
"65202579580f4ad38d734b4ee39d22a8","65202579580f4ad38d734b4ee39d22a8",22882512,79,0,1,473,164,164,0
"65202579580f4ad38d734b4ee39d22a8","78adeee1fa2c4fe0bc73f7bca9fcee86",22882512,3,-5,0,503,164,160,-4
"78adeee1fa2c4fe0bc73f7bca9fcee86","3cbcea2be0984e7dbd5a48195af10ce7",22882512,2,8,0,537,160,165,5
"3cbcea2be0984e7dbd5a48195af10ce7","82e6285962b8400d9d6fc32436022a94",22882512,1,2,0,538,165,167,2
"82e6285962b8400d9d6fc32436022a94","78adeee1fa2c4fe0bc73f7bca9fcee86",22882512,1,-10,0,539,167,160,-7
"65202579580f4ad38d734b4ee39d22a8","579338175e0b4bbb8ef3b712b5d8b54e",22882512,1,-46,0,550,164,128,-36
"cd4532ad48034873ba8bce2aac0c9808","df1de691dafe4549a18a4398ee9dfaf9",22882512,1,4,0,560,137,139,2
"df1de691dafe4549a18a4398ee9dfaf9","779f9ddd1fd14d1e9e69f72219a1fdbd",22882512,1,-23,0,561,139,121,-18
"779f9ddd1fd14d1e9e69f72219a1fdbd","6c5ad271a44743479bfaea29b1db8d02",22882512,1,27,0,562,121,143,22
"6c5ad271a44743479bfaea29b1db8d02","a9ac840f098c4bd0a2ee896214ce29cd",22882512,1,35,0,563,143,168,25
"a9ac840f098c4bd0a2ee896214ce29cd","a9ac840f098c4bd0a2ee896214ce29cd",22882512,4,0,1,564,168,168,0
"a9ac840f098c4bd0a2ee896214ce29cd","0c7262dff33c4087bc660ccf40f92f9c",22882512,2,4,0,566,168,169,1
"0c7262dff33c4087bc660ccf40f92f9c","b2275c3fad834f8d90737a2d9a6927d6",22882512,4,3,0,567,169,172,3
"b2275c3fad834f8d90737a2d9a6927d6","b2275c3fad834f8d90737a2d9a6927d6",22882512,36,0,1,568,172,172,0
"b2275c3fad834f8d90737a2d9a6927d6","eb515a26030b41f8a82a1e6114420bad",22882512,3,1,0,604,172,173,1
"eb515a26030b41f8a82a1e6114420bad","eb515a26030b41f8a82a1e6114420bad",22882512,6,0,1,605,173,173,0
"eb515a26030b41f8a82a1e6114420bad","0c7262dff33c4087bc660ccf40f92f9c",22882512,3,-4,0,607,173,169,-4
"0c7262dff33c4087bc660ccf40f92f9c","b42cc17b7de840f181a704558d0bc845",22882512,4,7,0,608,169,175,6
"b42cc17b7de840f181a704558d0bc845","0c7262dff33c4087bc660ccf40f92f9c",22882512,3,-7,0,609,175,169,-6
"0c7262dff33c4087bc660ccf40f92f9c","362fcb0699a14845ab29b2340093e528",22882512,1,6,0,610,169,174,5
"362fcb0699a14845ab29b2340093e528","362fcb0699a14845ab29b2340093e528",22882512,1,0,1,611,174,174,0
"362fcb0699a14845ab29b2340093e528","b42cc17b7de840f181a704558d0bc845",22882512,1,1,0,612,174,175,1
"b42cc17b7de840f181a704558d0bc845","78adeee1fa2c4fe0bc73f7bca9fcee86",22882512,1,-24,0,615,175,160,-15
"3cbcea2be0984e7dbd5a48195af10ce7","78adeee1fa2c4fe0bc73f7bca9fcee86",22882512,1,-8,0,628,165,160,-5
"78adeee1fa2c4fe0bc73f7bca9fcee86","82e6285962b8400d9d6fc32436022a94",22882512,1,10,0,629,160,167,7
"82e6285962b8400d9d6fc32436022a94","a9ac840f098c4bd0a2ee896214ce29cd",22882512,1,3,0,630,167,168,1
"a9ac840f098c4bd0a2ee896214ce29cd","3cbcea2be0984e7dbd5a48195af10ce7",22882512,1,-5,0,631,168,165,-3
"3cbcea2be0984e7dbd5a48195af10ce7","3cbcea2be0984e7dbd5a48195af10ce7",22882512,1,0,1,632,165,165,0
"3cbcea2be0984e7dbd5a48195af10ce7","a9ac840f098c4bd0a2ee896214ce29cd",22882512,1,5,0,633,165,168,3
"b2275c3fad834f8d90737a2d9a6927d6","0c7262dff33c4087bc660ccf40f92f9c",22882512,1,-3,0,638,172,169,-3
"0c7262dff33c4087bc660ccf40f92f9c","0c7262dff33c4087bc660ccf40f92f9c",22882512,2,0,1,639,169,169,0
"b42cc17b7de840f181a704558d0bc845","b42cc17b7de840f181a704558d0bc845",22882512,2,0,1,654,175,175,0
"b42cc17b7de840f181a704558d0bc845","801f9e9135034f49bf5f8b4bdefedb41",22882512,1,2,0,656,175,177,2
"801f9e9135034f49bf5f8b4bdefedb41","801f9e9135034f49bf5f8b4bdefedb41",22882512,4,0,1,657,177,177,0
"801f9e9135034f49bf5f8b4bdefedb41","362fcb0699a14845ab29b2340093e528",22882512,1,-3,0,661,177,174,-3
"362fcb0699a14845ab29b2340093e528","ea38cc0e6e6e41edbabf210220808bf9",22882512,1,6,0,662,174,179,5
"ea38cc0e6e6e41edbabf210220808bf9","b87c552dd247427abe6ab5795b9c9d43",22882512,2,2,0,663,179,181,2
"b87c552dd247427abe6ab5795b9c9d43","ea38cc0e6e6e41edbabf210220808bf9",22882512,1,-2,0,664,181,179,-2
"ea38cc0e6e6e41edbabf210220808bf9","ea38cc0e6e6e41edbabf210220808bf9",22882512,2,0,1,665,179,179,0
"b87c552dd247427abe6ab5795b9c9d43","b87c552dd247427abe6ab5795b9c9d43",22882512,9,0,1,668,181,181,0
"b87c552dd247427abe6ab5795b9c9d43","139b097acfca451689d80c9c6eebdf7b",22882512,1,-3,0,677,181,178,-3
"139b097acfca451689d80c9c6eebdf7b","30f660a1feb34582a739722532524f79",22882512,1,6,0,678,178,183,5
"30f660a1feb34582a739722532524f79","30f660a1feb34582a739722532524f79",22882512,9,0,1,679,183,183,0
"30f660a1feb34582a739722532524f79","2024b4885bd14338a39b7b509acbbd02",22882512,1,-1,0,688,183,182,-1
"2024b4885bd14338a39b7b509acbbd02","c3f63fe50d8e487c86bf8ef76c9cadd3",22882512,1,4,0,689,182,185,3
"c3f63fe50d8e487c86bf8ef76c9cadd3","c3f63fe50d8e487c86bf8ef76c9cadd3",22882512,1,0,1,690,185,185,0
"c3f63fe50d8e487c86bf8ef76c9cadd3","0c7262dff33c4087bc660ccf40f92f9c",22882512,1,-20,0,691,185,169,-16
"0c7262dff33c4087bc660ccf40f92f9c","c8e371568a0c4391b25796ae4e91952e",22882512,1,23,0,692,169,186,17
"c8e371568a0c4391b25796ae4e91952e","7d932b23e1c84326ae5aa4d3c0d813d1",22882512,1,2,0,693,186,188,2
"7d932b23e1c84326ae5aa4d3c0d813d1","7d932b23e1c84326ae5aa4d3c0d813d1",22882512,1,0,1,694,188,188,0
"7d932b23e1c84326ae5aa4d3c0d813d1","c8e371568a0c4391b25796ae4e91952e",22882512,1,-2,0,695,188,186,-2
"c8e371568a0c4391b25796ae4e91952e","ab11d94c6c8948ea90b88f19d2cd502b",22882512,1,5,0,696,186,190,4
"ab11d94c6c8948ea90b88f19d2cd502b","ab11d94c6c8948ea90b88f19d2cd502b",22882512,2,0,1,697,190,190,0
"ab11d94c6c8948ea90b88f19d2cd502b","f992451ed6ad4e68bb9e68ad6be7c4be",22882512,1,2,0,699,190,192,2
"f992451ed6ad4e68bb9e68ad6be7c4be","f992451ed6ad4e68bb9e68ad6be7c4be",22882512,1,0,1,700,192,192,0
"f992451ed6ad4e68bb9e68ad6be7c4be","07b44a7a51e94c78b411c753fc39dab0",22882512,1,-3,0,701,192,189,-3
"07b44a7a51e94c78b411c753fc39dab0","6cd2dcaac46847d4a0bc53f296d90375",22882512,1,6,0,702,189,194,5
"6cd2dcaac46847d4a0bc53f296d90375","6cd2dcaac46847d4a0bc53f296d90375",22882512,1,0,1,703,194,194,0
"6cd2dcaac46847d4a0bc53f296d90375","2d2580c9411c4972909db508d6956a58",22882512,1,2,0,704,194,196,2
"2d2580c9411c4972909db508d6956a58","2d2580c9411c4972909db508d6956a58",22882512,5,0,1,705,196,196,0
"2d2580c9411c4972909db508d6956a58","5bddb3d9ed264f3984702f048c7e5340",22882512,1,1,0,710,196,197,1
"5bddb3d9ed264f3984702f048c7e5340","5bddb3d9ed264f3984702f048c7e5340",22882512,2,0,1,711,197,197,0
"5bddb3d9ed264f3984702f048c7e5340","d5e8e2bd12a2466b9d6d90855f0eb079",22882512,1,1,0,713,197,198,1
"d5e8e2bd12a2466b9d6d90855f0eb079","d5e8e2bd12a2466b9d6d90855f0eb079",22882512,2,0,1,714,198,198,0
"d5e8e2bd12a2466b9d6d90855f0eb079","017d7ca8e0394b91aaadc9574df2202c",22882512,1,-5,0,716,198,193,-5
"017d7ca8e0394b91aaadc9574df2202c","54e8e9f0ea3e45c4bf3b8ac799ee31b1",22882512,1,8,0,717,193,200,7
"54e8e9f0ea3e45c4bf3b8ac799ee31b1","54e8e9f0ea3e45c4bf3b8ac799ee31b1",22882512,1,0,1,718,200,200,0
"54e8e9f0ea3e45c4bf3b8ac799ee31b1","c614a00911be4877a075f19315530fb0",22882512,1,1,0,719,200,201,1
"c614a00911be4877a075f19315530fb0","c614a00911be4877a075f19315530fb0",22882512,6,0,1,720,201,201,0
"c614a00911be4877a075f19315530fb0","a6c21bd8b95249c7972820a7a7d76aff",22882512,1,1,0,726,201,202,1
"a6c21bd8b95249c7972820a7a7d76aff","a6c21bd8b95249c7972820a7a7d76aff",22882512,2,0,1,727,202,202,0
"a6c21bd8b95249c7972820a7a7d76aff","c8e371568a0c4391b25796ae4e91952e",22882512,2,-19,0,728,202,186,-16
"c8e371568a0c4391b25796ae4e91952e","a6c21bd8b95249c7972820a7a7d76aff",22882512,1,19,0,729,186,202,16
"c8e371568a0c4391b25796ae4e91952e","c8e371568a0c4391b25796ae4e91952e",22882512,1,0,1,732,186,186,0
"c8e371568a0c4391b25796ae4e91952e","bb329d880ab54120adaf203a693bb203",22882512,1,20,0,733,186,203,17
"bb329d880ab54120adaf203a693bb203","bb329d880ab54120adaf203a693bb203",22882512,1,0,1,734,203,203,0
"bb329d880ab54120adaf203a693bb203","f9170dd6bc6442b4acd832747609b09a",22882512,1,-4,0,735,203,199,-4
"f9170dd6bc6442b4acd832747609b09a","c8e371568a0c4391b25796ae4e91952e",22882512,1,-16,0,736,199,186,-13
"c8e371568a0c4391b25796ae4e91952e","f9170dd6bc6442b4acd832747609b09a",22882512,1,16,0,737,186,199,13
"f9170dd6bc6442b4acd832747609b09a","334c2344009840079b1d0e1b7ce3d5a7",22882512,1,7,0,738,199,205,6
"334c2344009840079b1d0e1b7ce3d5a7","334c2344009840079b1d0e1b7ce3d5a7",22882512,1,0,1,739,205,205,0
"334c2344009840079b1d0e1b7ce3d5a7","c8e371568a0c4391b25796ae4e91952e",22882512,1,-23,0,740,205,186,-19
"c8e371568a0c4391b25796ae4e91952e","d7f13c8d63ec4e2aa673fbb9cf9c6933",22882512,1,26,0,741,186,206,20
"d7f13c8d63ec4e2aa673fbb9cf9c6933","7108f0e4c2584f1f9c471689ae4c885c",22882512,1,2,0,742,206,208,2
"7108f0e4c2584f1f9c471689ae4c885c","b9e80f77c3a44349863b19875725c384",22882512,1,-1,0,743,208,207,-1
"b9e80f77c3a44349863b19875725c384","b9e80f77c3a44349863b19875725c384",22882512,23,0,1,744,207,207,0
"b9e80f77c3a44349863b19875725c384","7108f0e4c2584f1f9c471689ae4c885c",22882512,1,1,0,767,207,208,1
"7108f0e4c2584f1f9c471689ae4c885c","7108f0e4c2584f1f9c471689ae4c885c",22882512,19,0,1,768,208,208,0
"7108f0e4c2584f1f9c471689ae4c885c","09400e101c5d4b439cf9a26b03aae558",22882512,1,3,0,787,208,210,2
"09400e101c5d4b439cf9a26b03aae558","d7f13c8d63ec4e2aa673fbb9cf9c6933",22882512,1,-5,0,788,210,206,-4
"d7f13c8d63ec4e2aa673fbb9cf9c6933","1998bef364384a34ad2306761033cedc",22882512,2,6,0,789,206,211,5
"1998bef364384a34ad2306761033cedc","d7f13c8d63ec4e2aa673fbb9cf9c6933",22882512,1,-6,0,790,211,206,-5
"1998bef364384a34ad2306761033cedc","09400e101c5d4b439cf9a26b03aae558",22882512,1,-1,0,792,211,210,-1
"09400e101c5d4b439cf9a26b03aae558","09400e101c5d4b439cf9a26b03aae558",22882512,2,0,1,793,210,210,0
"09400e101c5d4b439cf9a26b03aae558","a88efa7e50ce47159810ab553afa6d3a",22882512,1,2,0,795,210,212,2
"a88efa7e50ce47159810ab553afa6d3a","a88efa7e50ce47159810ab553afa6d3a",22882512,2,0,1,796,212,212,0
"a88efa7e50ce47159810ab553afa6d3a","a875096404ef4a9984b62d74cda916f9",22882512,1,-3,0,798,212,209,-3
"a875096404ef4a9984b62d74cda916f9","be502a7a43c44bf7b682698de79d9369",22882512,1,6,0,799,209,214,5
"be502a7a43c44bf7b682698de79d9369","f7fb1952f56b4189b86a9f8b7862d2b8",22882512,2,1,0,800,214,215,1
"f7fb1952f56b4189b86a9f8b7862d2b8","be502a7a43c44bf7b682698de79d9369",22882512,1,-1,0,801,215,214,-1
"f7fb1952f56b4189b86a9f8b7862d2b8","f7fb1952f56b4189b86a9f8b7862d2b8",22882512,15,0,1,803,215,215,0
"f7fb1952f56b4189b86a9f8b7862d2b8","b860ee85d8bc4a2f97958cfb71be3533",22882512,1,1,0,818,215,216,1
"b860ee85d8bc4a2f97958cfb71be3533","b860ee85d8bc4a2f97958cfb71be3533",22882512,2,0,1,819,216,216,0
"b860ee85d8bc4a2f97958cfb71be3533","ec341f459285443b8361f7f15638ff08",22882512,1,-3,0,821,216,213,-3
"ec341f459285443b8361f7f15638ff08","363837c182e04711840d896ae1e0339c",22882512,1,6,0,822,213,218,5
"363837c182e04711840d896ae1e0339c","363837c182e04711840d896ae1e0339c",22882512,12,0,1,823,218,218,0
"363837c182e04711840d896ae1e0339c","01b2051f8941460d89945e3b02d1ce78",22882512,1,-1,0,835,218,217,-1
"01b2051f8941460d89945e3b02d1ce78","91125ca626c5470eb145501f8c37f8db",22882512,1,4,0,836,217,220,3
"91125ca626c5470eb145501f8c37f8db","91125ca626c5470eb145501f8c37f8db",22882512,1,0,1,837,220,220,0
"91125ca626c5470eb145501f8c37f8db","d7f13c8d63ec4e2aa673fbb9cf9c6933",22882512,1,-18,0,838,220,206,-14
"d7f13c8d63ec4e2aa673fbb9cf9c6933","1c6721b1f63f4d30ba7746ea8af02a52",22882512,1,21,0,839,206,221,15
"1c6721b1f63f4d30ba7746ea8af02a52","77ecef8eff6b4a2caea7707669bf7475",22882512,1,1,0,840,221,222,1
"77ecef8eff6b4a2caea7707669bf7475","77ecef8eff6b4a2caea7707669bf7475",22882512,12,0,1,841,222,222,0
"77ecef8eff6b4a2caea7707669bf7475","1c6721b1f63f4d30ba7746ea8af02a52",22882512,1,-1,0,853,222,221,-1
"1c6721b1f63f4d30ba7746ea8af02a52","d03cb855c70044cf8c35d9ec0de696e3",22882512,1,4,0,854,221,224,3
"d03cb855c70044cf8c35d9ec0de696e3","8b9ae98743bd4d4a8a87dff1c1244211",22882512,1,3,0,855,224,227,3
"8b9ae98743bd4d4a8a87dff1c1244211","d03cb855c70044cf8c35d9ec0de696e3",22882512,1,-3,0,856,227,224,-3
"d03cb855c70044cf8c35d9ec0de696e3","a49a937d6896486d9a5396654abcf2e1",22882512,1,2,0,857,224,226,2
"a49a937d6896486d9a5396654abcf2e1","a49a937d6896486d9a5396654abcf2e1",22882512,3,0,1,858,226,226,0
"a49a937d6896486d9a5396654abcf2e1","8b9ae98743bd4d4a8a87dff1c1244211",22882512,1,1,0,861,226,227,1
"8b9ae98743bd4d4a8a87dff1c1244211","8b9ae98743bd4d4a8a87dff1c1244211",22882512,25,0,1,862,227,227,0
"8b9ae98743bd4d4a8a87dff1c1244211","f7906d6f59b9489a91d2ef40db5a474d",22882512,1,-4,0,887,227,223,-4
"f7906d6f59b9489a91d2ef40db5a474d","2ab1535aac1346ba8801535bf729ef37",22882512,1,7,0,888,223,229,6
"2ab1535aac1346ba8801535bf729ef37","2ab1535aac1346ba8801535bf729ef37",22882512,3,0,1,889,229,229,0
"2ab1535aac1346ba8801535bf729ef37","779143882c9042b383843beddf87b3fa",22882512,1,1,0,891,229,230,1
"779143882c9042b383843beddf87b3fa","779143882c9042b383843beddf87b3fa",22882512,1,0,1,892,230,230,0
"779143882c9042b383843beddf87b3fa","1c6721b1f63f4d30ba7746ea8af02a52",22882512,1,-11,0,893,230,221,-9
"1c6721b1f63f4d30ba7746ea8af02a52","2ab1535aac1346ba8801535bf729ef37",22882512,2,10,0,894,221,229,8
"2ab1535aac1346ba8801535bf729ef37","a4f40fb48a8542c8949bae1f002cd9bc",22882512,1,2,0,896,229,231,2
"a4f40fb48a8542c8949bae1f002cd9bc","a4f40fb48a8542c8949bae1f002cd9bc",22882512,2,0,1,897,231,231,0
"a4f40fb48a8542c8949bae1f002cd9bc","8972c23e32044edb8a78fa1eed4e5947",22882512,1,1,0,899,231,232,1
"8972c23e32044edb8a78fa1eed4e5947","8972c23e32044edb8a78fa1eed4e5947",22882512,1,0,1,900,232,232,0
"8972c23e32044edb8a78fa1eed4e5947","92feb4a40f8344d38b6f722e42a53295",22882512,1,1,0,901,232,233,1
"92feb4a40f8344d38b6f722e42a53295","92feb4a40f8344d38b6f722e42a53295",22882512,2,0,1,902,233,233,0
"92feb4a40f8344d38b6f722e42a53295","5152833676bf4c6cb317060be10f68db",22882512,1,-5,0,904,233,228,-5
"5152833676bf4c6cb317060be10f68db","ca3e28f290354c08aefe5b0f769604e6",22882512,1,8,0,905,228,235,7
"ca3e28f290354c08aefe5b0f769604e6","ca3e28f290354c08aefe5b0f769604e6",22882512,9,0,1,906,235,235,0
"ca3e28f290354c08aefe5b0f769604e6","79a35eea833e4c2c9d22fc53c3c6445c",22882512,1,1,0,915,235,236,1
"79a35eea833e4c2c9d22fc53c3c6445c","79a35eea833e4c2c9d22fc53c3c6445c",22882512,9,0,1,916,236,236,0
"79a35eea833e4c2c9d22fc53c3c6445c","8f68228b1518449e9615cdafee41a2bd",22882512,1,1,0,925,236,237,1
"8f68228b1518449e9615cdafee41a2bd","8f68228b1518449e9615cdafee41a2bd",22882512,1,0,1,926,237,237,0
"8f68228b1518449e9615cdafee41a2bd","cab89fa5c3ed45a5aa550fc0352d6a42",22882512,1,1,0,927,237,238,1
"cab89fa5c3ed45a5aa550fc0352d6a42","cab89fa5c3ed45a5aa550fc0352d6a42",22882512,5,0,1,928,238,238,0
"cab89fa5c3ed45a5aa550fc0352d6a42","1c6721b1f63f4d30ba7746ea8af02a52",22882512,1,-20,0,933,238,221,-17
"2ab1535aac1346ba8801535bf729ef37","5152833676bf4c6cb317060be10f68db",22882512,1,-1,0,935,229,228,-1
"5152833676bf4c6cb317060be10f68db","66d4fad4f1cf4b46be0750a99ad7a35a",22882512,1,12,0,936,228,239,11
"66d4fad4f1cf4b46be0750a99ad7a35a","66d4fad4f1cf4b46be0750a99ad7a35a",22882512,1,0,1,937,239,239,0
"66d4fad4f1cf4b46be0750a99ad7a35a","0b04c8e2f86d48c7aeb7e225819cd32b",22882512,1,-5,0,938,239,234,-5
"0b04c8e2f86d48c7aeb7e225819cd32b","0b04c8e2f86d48c7aeb7e225819cd32b",22882512,3,0,1,939,234,234,0
"0b04c8e2f86d48c7aeb7e225819cd32b","1c6721b1f63f4d30ba7746ea8af02a52",22882512,1,-16,0,942,234,221,-13
"1c6721b1f63f4d30ba7746ea8af02a52","64dbedb3ce544f6aae8e10e0cf10f16d",22882512,1,23,0,943,221,240,19
"64dbedb3ce544f6aae8e10e0cf10f16d","64dbedb3ce544f6aae8e10e0cf10f16d",22882512,1,0,1,944,240,240,0
"64dbedb3ce544f6aae8e10e0cf10f16d","1c6721b1f63f4d30ba7746ea8af02a52",22882512,1,-23,0,945,240,221,-19
"1c6721b1f63f4d30ba7746ea8af02a52","f53da5fd9bfe412da4b80d4742563b6c",22882512,1,24,0,946,221,241,20
"f53da5fd9bfe412da4b80d4742563b6c","f53da5fd9bfe412da4b80d4742563b6c",22882512,1,0,1,947,241,241,0
"f53da5fd9bfe412da4b80d4742563b6c","2ae94c0cea4d480a9d5dca8fb1d7b542",22882512,1,3,0,948,241,242,1
"2ae94c0cea4d480a9d5dca8fb1d7b542","1c6721b1f63f4d30ba7746ea8af02a52",22882512,1,-27,0,949,242,221,-21
"1c6721b1f63f4d30ba7746ea8af02a52","1ebf23f9d994469a85206e4c7b1bf5f5",22882512,1,30,0,950,221,245,24
"1ebf23f9d994469a85206e4c7b1bf5f5","1ebf23f9d994469a85206e4c7b1bf5f5",22882512,11,0,1,951,245,245,0
"1ebf23f9d994469a85206e4c7b1bf5f5","85ae675b83e8422da842cfd25596af99",22882512,1,1,0,962,245,246,1
"85ae675b83e8422da842cfd25596af99","85ae675b83e8422da842cfd25596af99",22882512,1,0,1,963,246,246,0
"85ae675b83e8422da842cfd25596af99","fa235f0f364d47e4ae1c87f47bf8e6ba",22882512,1,8,0,964,246,252,6
"fa235f0f364d47e4ae1c87f47bf8e6ba","2ae94c0cea4d480a9d5dca8fb1d7b542",22882512,1,-12,0,965,252,242,-10
"2ae94c0cea4d480a9d5dca8fb1d7b542","fa235f0f364d47e4ae1c87f47bf8e6ba",22882512,1,12,0,966,242,252,10
"fa235f0f364d47e4ae1c87f47bf8e6ba","79f7845465cc4ed19d8e4f1429541be0",22882512,1,2,0,967,252,254,2
"79f7845465cc4ed19d8e4f1429541be0","79f7845465cc4ed19d8e4f1429541be0",22882512,2,0,1,968,254,254,0
"79f7845465cc4ed19d8e4f1429541be0","6e83e23f56544a19b94067c1c558d9c0",22882512,1,-8,0,970,254,247,-7
"6e83e23f56544a19b94067c1c558d9c0","00f61990949545828dd12f1303d47504",22882512,1,11,0,971,247,256,9
"00f61990949545828dd12f1303d47504","00f61990949545828dd12f1303d47504",22882512,1,0,1,972,256,256,0
"00f61990949545828dd12f1303d47504","ead7bb4b64e247d2ae632ab8a296b091",22882512,1,2,0,973,256,258,2
"ead7bb4b64e247d2ae632ab8a296b091","ead7bb4b64e247d2ae632ab8a296b091",22882512,2,0,1,974,258,258,0
"ead7bb4b64e247d2ae632ab8a296b091","41b0048dde734bb280bac6116baa8e27",22882512,1,1,0,976,258,259,1
"41b0048dde734bb280bac6116baa8e27","41b0048dde734bb280bac6116baa8e27",22882512,2,0,1,977,259,259,0
"41b0048dde734bb280bac6116baa8e27","b41c5a094a604ee0915327da5cc0beb7",22882512,1,1,0,979,259,260,1
"b41c5a094a604ee0915327da5cc0beb7","b41c5a094a604ee0915327da5cc0beb7",22882512,5,0,1,980,260,260,0
"b41c5a094a604ee0915327da5cc0beb7","d546341988904f069cfa86b21457d9d9",22882512,1,-10,0,985,260,251,-9
"d546341988904f069cfa86b21457d9d9","28c171777c52431ab6b925073bd63d46",22882512,1,15,0,986,251,264,13
"28c171777c52431ab6b925073bd63d46","28c171777c52431ab6b925073bd63d46",22882512,7,0,1,987,264,264,0
"28c171777c52431ab6b925073bd63d46","ac160db940cb49ae8579162b1d52bb5d",22882512,1,2,0,994,264,266,2
"ac160db940cb49ae8579162b1d52bb5d","ac160db940cb49ae8579162b1d52bb5d",22882512,11,0,1,1000,266,266,0
"ac160db940cb49ae8579162b1d52bb5d","d989ebcfc12a4b669f0100dc1aa14f1e",22882512,1,-12,0,1006,266,255,-11
"d989ebcfc12a4b669f0100dc1aa14f1e","c6fd49b485cc4874b0bbdd9c6171e09c",22882512,1,15,0,1007,255,268,13
"c6fd49b485cc4874b0bbdd9c6171e09c","c6fd49b485cc4874b0bbdd9c6171e09c",22882512,3,0,1,1008,268,268,0
"c6fd49b485cc4874b0bbdd9c6171e09c","44240778a97c4af0937817499b75707b",22882512,1,1,0,1011,268,269,1
"44240778a97c4af0937817499b75707b","44240778a97c4af0937817499b75707b",22882512,2,0,1,1012,269,269,0
"44240778a97c4af0937817499b75707b","7aa76d3e993840d8805f097cbdbcd44b",22882512,1,-9,0,1014,269,261,-8
"7aa76d3e993840d8805f097cbdbcd44b","865a4d3b43374da7944dc7d397f566d9",22882512,1,12,0,1015,261,271,10
"865a4d3b43374da7944dc7d397f566d9","865a4d3b43374da7944dc7d397f566d9",22882512,1,0,1,1016,271,271,0
"865a4d3b43374da7944dc7d397f566d9","2ae94c0cea4d480a9d5dca8fb1d7b542",22882512,1,-35,0,1017,271,242,-29
"2ae94c0cea4d480a9d5dca8fb1d7b542","0d987bed3ffa4ed0b9a2e62e97b7b30f",22882512,1,38,0,1018,242,272,30
"0d987bed3ffa4ed0b9a2e62e97b7b30f","0d987bed3ffa4ed0b9a2e62e97b7b30f",22882512,10,0,1,1019,272,272,0
"0d987bed3ffa4ed0b9a2e62e97b7b30f","bb5a47f5ea01454a8b79455422d3b9da",22882512,6,10,0,1021,272,280,8
"bb5a47f5ea01454a8b79455422d3b9da","bb5a47f5ea01454a8b79455422d3b9da",22882512,105,0,1,1022,280,280,0
"bb5a47f5ea01454a8b79455422d3b9da","82ae07bc0c9b4570a41799290d1ef399",22882512,4,-6,0,1024,280,275,-5
"82ae07bc0c9b4570a41799290d1ef399","bb5a47f5ea01454a8b79455422d3b9da",22882512,5,6,0,1025,275,280,5
"bb5a47f5ea01454a8b79455422d3b9da","0d987bed3ffa4ed0b9a2e62e97b7b30f",22882512,6,-10,0,1030,280,272,-8
"0d987bed3ffa4ed0b9a2e62e97b7b30f","bc5524e78a8544e2ae2fdc2f3462bbec",22882512,2,9,0,1031,272,279,7
"bc5524e78a8544e2ae2fdc2f3462bbec","0d987bed3ffa4ed0b9a2e62e97b7b30f",22882512,2,-9,0,1032,279,272,-7
"bc5524e78a8544e2ae2fdc2f3462bbec","bb5a47f5ea01454a8b79455422d3b9da",22882512,1,1,0,1034,279,280,1
"bb5a47f5ea01454a8b79455422d3b9da","bc5524e78a8544e2ae2fdc2f3462bbec",22882512,1,-1,0,1051,280,279,-1
"bb5a47f5ea01454a8b79455422d3b9da","4a29443515bb404cb8924e1c60a63b73",22882512,1,12,0,1061,280,285,5
"4a29443515bb404cb8924e1c60a63b73","4a29443515bb404cb8924e1c60a63b73",22882512,2,0,1,1062,285,285,0
"4a29443515bb404cb8924e1c60a63b73","208c9b2796c944db8dacaa96082520ea",22882512,5,3,0,1063,285,288,3
"208c9b2796c944db8dacaa96082520ea","4a29443515bb404cb8924e1c60a63b73",22882512,2,-3,0,1064,288,285,-3
"4a29443515bb404cb8924e1c60a63b73","7669a956527947d0add87455277e80b4",22882512,1,7,0,1068,285,291,6
"7669a956527947d0add87455277e80b4","7669a956527947d0add87455277e80b4",22882512,1,0,1,1069,291,291,0
"7669a956527947d0add87455277e80b4","869e967078f04da18dd0b0b9389a7424",22882512,1,3,0,1070,291,293,2
"869e967078f04da18dd0b0b9389a7424","6a9a3b5bde4a48daa896fe8c06eca56f",22882512,1,-5,0,1071,293,289,-4
"6a9a3b5bde4a48daa896fe8c06eca56f","51ab6291537748fab90d519aa09889d6",22882512,1,7,0,1072,289,295,6
"51ab6291537748fab90d519aa09889d6","51ab6291537748fab90d519aa09889d6",22882512,11,0,1,1073,295,295,0
"51ab6291537748fab90d519aa09889d6","34a6e49023fc4465bd5ca604330bbd1c",22882512,1,-3,0,1084,295,292,-3
"34a6e49023fc4465bd5ca604330bbd1c","ba0e59461bfb4a44b7b1c28a01f8d3b3",22882512,1,9,0,1085,292,299,7
"ba0e59461bfb4a44b7b1c28a01f8d3b3","21592f2a9e9c4b2f8c66ec5dbcbf6a2b",22882512,1,-4,0,1086,299,296,-3
"21592f2a9e9c4b2f8c66ec5dbcbf6a2b","7646a919d7e64fa990bca9b024ff089d",22882512,1,3,0,1087,296,298,2
"7646a919d7e64fa990bca9b024ff089d","21592f2a9e9c4b2f8c66ec5dbcbf6a2b",22882512,1,-3,0,1088,298,296,-2
"21592f2a9e9c4b2f8c66ec5dbcbf6a2b","ba0e59461bfb4a44b7b1c28a01f8d3b3",22882512,1,4,0,1089,296,299,3
"ba0e59461bfb4a44b7b1c28a01f8d3b3","ba0e59461bfb4a44b7b1c28a01f8d3b3",22882512,2,0,1,1090,299,299,0
"ba0e59461bfb4a44b7b1c28a01f8d3b3","0e0b36e731a645e7b1b8a88f5031ca38",22882512,1,2,0,1092,299,301,2
"0e0b36e731a645e7b1b8a88f5031ca38","0e0b36e731a645e7b1b8a88f5031ca38",22882512,2,0,1,1093,301,301,0
"0e0b36e731a645e7b1b8a88f5031ca38","a66a144637284c21afc6de17fea4bfb8",22882512,1,1,0,1095,301,302,1
"a66a144637284c21afc6de17fea4bfb8","a66a144637284c21afc6de17fea4bfb8",22882512,2,0,1,1096,302,302,0
"a66a144637284c21afc6de17fea4bfb8","7646a919d7e64fa990bca9b024ff089d",22882512,1,-4,0,1098,302,298,-4
"7646a919d7e64fa990bca9b024ff089d","4a29443515bb404cb8924e1c60a63b73",22882512,1,-17,0,1099,298,285,-13
"208c9b2796c944db8dacaa96082520ea","2c5bb2cbd0014420ad8c95d40e38efd1",22882512,1,20,0,1101,288,303,15
"2c5bb2cbd0014420ad8c95d40e38efd1","4a29443515bb404cb8924e1c60a63b73",22882512,1,-23,0,1102,303,285,-18
"4a29443515bb404cb8924e1c60a63b73","e390b575229748ea8aac9364efe2bf00",22882512,1,24,0,1103,285,304,19
"e390b575229748ea8aac9364efe2bf00","e390b575229748ea8aac9364efe2bf00",22882512,1,0,1,1104,304,304,0
"e390b575229748ea8aac9364efe2bf00","3434c10e561d488a914e0f7d71907abd",22882512,1,3,0,1105,304,305,1
"3434c10e561d488a914e0f7d71907abd","4a29443515bb404cb8924e1c60a63b73",22882512,1,-27,0,1106,305,285,-20
"4a29443515bb404cb8924e1c60a63b73","53e7e900392747ccad52e711ab0f80d8",22882512,1,29,0,1107,285,307,22
"53e7e900392747ccad52e711ab0f80d8","53e7e900392747ccad52e711ab0f80d8",22882512,1,0,1,1108,307,307,0
"53e7e900392747ccad52e711ab0f80d8","3434c10e561d488a914e0f7d71907abd",22882512,2,-2,0,1109,307,305,-2
"3434c10e561d488a914e0f7d71907abd","3434c10e561d488a914e0f7d71907abd",22882512,1,0,1,1110,305,305,0
"3434c10e561d488a914e0f7d71907abd","53e7e900392747ccad52e711ab0f80d8",22882512,2,2,0,1111,305,307,2
"53e7e900392747ccad52e711ab0f80d8","130acc2aeb0448fdbb2de63bc5cebe5b",22882512,1,3,0,1112,307,309,2
"130acc2aeb0448fdbb2de63bc5cebe5b","3434c10e561d488a914e0f7d71907abd",22882512,1,-5,0,1113,309,305,-4
"3434c10e561d488a914e0f7d71907abd","9c062b3251034ebe90f5054e2a3b5120",22882512,1,7,0,1114,305,311,6
"9c062b3251034ebe90f5054e2a3b5120","9c062b3251034ebe90f5054e2a3b5120",22882512,2,0,1,1115,311,311,0
"9c062b3251034ebe90f5054e2a3b5120","ea859f8207e44537889daeaba13ac2e8",22882512,1,1,0,1117,311,312,1
"ea859f8207e44537889daeaba13ac2e8","ea859f8207e44537889daeaba13ac2e8",22882512,5,0,1,1118,312,312,0
"ea859f8207e44537889daeaba13ac2e8","56d94971a7a94257aa330183a8ebd0ea",22882512,2,1,0,1122,312,313,1
"56d94971a7a94257aa330183a8ebd0ea","56d94971a7a94257aa330183a8ebd0ea",22882512,5,0,1,1123,313,313,0
"56d94971a7a94257aa330183a8ebd0ea","141c0df6cd1946539aadd1c9b7068cd4",22882512,2,-5,0,1127,313,308,-5
"141c0df6cd1946539aadd1c9b7068cd4","13255e63e0aa4abf85e5211bf613d43e",22882512,1,10,0,1128,308,317,9
"13255e63e0aa4abf85e5211bf613d43e","13255e63e0aa4abf85e5211bf613d43e",22882512,1,0,1,1129,317,317,0
"13255e63e0aa4abf85e5211bf613d43e","0c787d16c9504873b1a4d903cec09948",22882512,1,-3,0,1130,317,314,-3
"0c787d16c9504873b1a4d903cec09948","86c27d40179e419c8e9d150fb6afa5d0",22882512,1,6,0,1131,314,319,5
"86c27d40179e419c8e9d150fb6afa5d0","86c27d40179e419c8e9d150fb6afa5d0",22882512,1,0,1,1132,319,319,0
"86c27d40179e419c8e9d150fb6afa5d0","8d7e0b55cf9849cda222a0f2440cec55",22882512,1,-1,0,1133,319,318,-1
"8d7e0b55cf9849cda222a0f2440cec55","47edbb64109243e6b0f8f64cdef90c6c",22882512,2,9,0,1134,318,326,8
"47edbb64109243e6b0f8f64cdef90c6c","24f1363179ad4aaa965484a78471912b",22882512,2,-3,0,1135,326,323,-3
"24f1363179ad4aaa965484a78471912b","24f1363179ad4aaa965484a78471912b",22882512,1,0,1,1136,323,323,0
"24f1363179ad4aaa965484a78471912b","3628bdce1dd2429ba924d2d4d09448d2",22882512,2,-1,0,1137,323,322,-1
"3628bdce1dd2429ba924d2d4d09448d2","3434c10e561d488a914e0f7d71907abd",22882512,1,-21,0,1138,322,305,-17
"3434c10e561d488a914e0f7d71907abd","130acc2aeb0448fdbb2de63bc5cebe5b",22882512,1,5,0,1141,305,309,4
"130acc2aeb0448fdbb2de63bc5cebe5b","ea859f8207e44537889daeaba13ac2e8",22882512,1,3,0,1142,309,312,3
"141c0df6cd1946539aadd1c9b7068cd4","86c27d40179e419c8e9d150fb6afa5d0",22882512,1,13,0,1147,308,319,11
"86c27d40179e419c8e9d150fb6afa5d0","0c787d16c9504873b1a4d903cec09948",22882512,1,-6,0,1148,319,314,-5
"0c787d16c9504873b1a4d903cec09948","8d7e0b55cf9849cda222a0f2440cec55",22882512,1,5,0,1149,314,318,4
"3628bdce1dd2429ba924d2d4d09448d2","56b3fd1a212a4764be39d979fde3326e",22882512,1,7,0,1153,322,328,6
"56b3fd1a212a4764be39d979fde3326e","56b3fd1a212a4764be39d979fde3326e",22882512,1,0,1,1154,328,328,0
"56b3fd1a212a4764be39d979fde3326e","3434c10e561d488a914e0f7d71907abd",22882512,1,-28,0,1155,328,305,-23
"3434c10e561d488a914e0f7d71907abd","0c4079457ede49e3aeb5e86ed84bdf35",22882512,1,31,0,1156,305,329,24
"0c4079457ede49e3aeb5e86ed84bdf35","38aea304b4fa46e1b29bb72f5cea4c93",22882512,2,2,0,1157,329,331,2
"38aea304b4fa46e1b29bb72f5cea4c93","38aea304b4fa46e1b29bb72f5cea4c93",22882512,1,0,1,1158,331,331,0
"38aea304b4fa46e1b29bb72f5cea4c93","e36d261332f14e79bb4b467aceaeb9b5",22882512,1,2,0,1159,331,333,2
"e36d261332f14e79bb4b467aceaeb9b5","e36d261332f14e79bb4b467aceaeb9b5",22882512,1,0,1,1160,333,333,0
"e36d261332f14e79bb4b467aceaeb9b5","c7e89b9d04744d2eab742fc24e3ef1ae",22882512,1,1,0,1161,333,334,1
"c7e89b9d04744d2eab742fc24e3ef1ae","c7e89b9d04744d2eab742fc24e3ef1ae",22882512,2,0,1,1162,334,334,0
"c7e89b9d04744d2eab742fc24e3ef1ae","fe49f8054b374a0ea4bb266ed135ff62",22882512,1,1,0,1164,334,335,1
"fe49f8054b374a0ea4bb266ed135ff62","fe49f8054b374a0ea4bb266ed135ff62",22882512,5,0,1,1165,335,335,0
"fe49f8054b374a0ea4bb266ed135ff62","d0a8f74af98642fe8360d22c42e45117",22882512,1,1,0,1170,335,336,1
"d0a8f74af98642fe8360d22c42e45117","d0a8f74af98642fe8360d22c42e45117",22882512,5,0,1,1171,336,336,0
"d0a8f74af98642fe8360d22c42e45117","0c4079457ede49e3aeb5e86ed84bdf35",22882512,1,-7,0,1176,336,329,-7
"0c4079457ede49e3aeb5e86ed84bdf35","a7c6339ca1da4368a18d471f0519f877",22882512,1,11,0,1177,329,339,10
"a7c6339ca1da4368a18d471f0519f877","a7c6339ca1da4368a18d471f0519f877",22882512,1,0,1,1178,339,339,0
"a7c6339ca1da4368a18d471f0519f877","b8b9418ab322418d9db9b40d96af873a",22882512,1,-2,0,1179,339,337,-2
"b8b9418ab322418d9db9b40d96af873a","bbc5139ca9024389a94db3a6f47dcff6",22882512,2,5,0,1180,337,341,4
"bbc5139ca9024389a94db3a6f47dcff6","bbc5139ca9024389a94db3a6f47dcff6",22882512,1,0,1,1181,341,341,0
"bbc5139ca9024389a94db3a6f47dcff6","4ee6ca9019ab4a1ab323f98094a9bd77",22882512,1,2,0,1182,341,343,2
"4ee6ca9019ab4a1ab323f98094a9bd77","4ee6ca9019ab4a1ab323f98094a9bd77",22882512,2,0,1,1183,343,343,0
"4ee6ca9019ab4a1ab323f98094a9bd77","b37947176785476f8b29d49a851366dc",22882512,1,1,0,1185,343,344,1
"b37947176785476f8b29d49a851366dc","b37947176785476f8b29d49a851366dc",22882512,2,0,1,1186,344,344,0
"b37947176785476f8b29d49a851366dc","fcea5b10d5a14a3b9324ffece8f6e1e5",22882512,1,1,0,1188,344,345,1
"fcea5b10d5a14a3b9324ffece8f6e1e5","fcea5b10d5a14a3b9324ffece8f6e1e5",22882512,5,0,1,1189,345,345,0
"fcea5b10d5a14a3b9324ffece8f6e1e5","c2490bc612d146edbe786556fab3651b",22882512,1,-5,0,1194,345,340,-5
"c2490bc612d146edbe786556fab3651b","0c4079457ede49e3aeb5e86ed84bdf35",22882512,1,-13,0,1195,340,329,-11
"38aea304b4fa46e1b29bb72f5cea4c93","0c4079457ede49e3aeb5e86ed84bdf35",22882512,1,-2,0,1197,331,329,-2
"0c4079457ede49e3aeb5e86ed84bdf35","b8b9418ab322418d9db9b40d96af873a",22882512,1,9,0,1198,329,337,8
"bbc5139ca9024389a94db3a6f47dcff6","c2490bc612d146edbe786556fab3651b",22882512,1,-1,0,1200,341,340,-1
"c2490bc612d146edbe786556fab3651b","6ac8bb048b854999a47edb35fe627f11",22882512,1,8,0,1201,340,347,7
"6ac8bb048b854999a47edb35fe627f11","6ac8bb048b854999a47edb35fe627f11",22882512,1,0,1,1202,347,347,0
"6ac8bb048b854999a47edb35fe627f11","0c4079457ede49e3aeb5e86ed84bdf35",22882512,1,-21,0,1203,347,329,-18
"0c4079457ede49e3aeb5e86ed84bdf35","30ead9794d4847abaf222ca966cc8630",22882512,1,24,0,1204,329,348,19
"30ead9794d4847abaf222ca966cc8630","09b9678ddc3d452ea4a3d46e15826065",22882512,1,5,0,1205,348,353,5
"09b9678ddc3d452ea4a3d46e15826065","897b7f51242c44aab2205c72fdcbf4cd",22882512,1,-1,0,1206,353,352,-1
"897b7f51242c44aab2205c72fdcbf4cd","c20993c944444fe085345591a8bd837e",22882512,1,-1,0,1207,352,351,-1
"c20993c944444fe085345591a8bd837e","eff0de7f2dbb42dfa1a2e686efab5b6d",22882512,1,3,0,1208,351,354,3
"eff0de7f2dbb42dfa1a2e686efab5b6d","c20993c944444fe085345591a8bd837e",22882512,1,-3,0,1209,354,351,-3
"c20993c944444fe085345591a8bd837e","c20993c944444fe085345591a8bd837e",22882512,3,0,1,1210,351,351,0
"c20993c944444fe085345591a8bd837e","897b7f51242c44aab2205c72fdcbf4cd",22882512,1,1,0,1213,351,352,1
"897b7f51242c44aab2205c72fdcbf4cd","897b7f51242c44aab2205c72fdcbf4cd",22882512,3,0,1,1214,352,352,0
"897b7f51242c44aab2205c72fdcbf4cd","09b9678ddc3d452ea4a3d46e15826065",22882512,1,1,0,1217,352,353,1
"09b9678ddc3d452ea4a3d46e15826065","09b9678ddc3d452ea4a3d46e15826065",22882512,3,0,1,1218,353,353,0
"09b9678ddc3d452ea4a3d46e15826065","eff0de7f2dbb42dfa1a2e686efab5b6d",22882512,1,1,0,1221,353,354,1
"eff0de7f2dbb42dfa1a2e686efab5b6d","eff0de7f2dbb42dfa1a2e686efab5b6d",22882512,3,0,1,1222,354,354,0
"eff0de7f2dbb42dfa1a2e686efab5b6d","30ead9794d4847abaf222ca966cc8630",22882512,1,-6,0,1225,354,348,-6
"30ead9794d4847abaf222ca966cc8630","2fe14166dc9642c3bc666b86a57f943d",22882512,1,10,0,1226,348,357,9
"2fe14166dc9642c3bc666b86a57f943d","1ba8fef685d74a8194b9db252eb704fb",22882512,1,-2,0,1227,357,355,-2
"1ba8fef685d74a8194b9db252eb704fb","30ead9794d4847abaf222ca966cc8630",22882512,1,-8,0,1228,355,348,-7
"30ead9794d4847abaf222ca966cc8630","1ba8fef685d74a8194b9db252eb704fb",22882512,1,8,0,1229,348,355,7
"1ba8fef685d74a8194b9db252eb704fb","2fe14166dc9642c3bc666b86a57f943d",22882512,1,2,0,1230,355,357,2
"2fe14166dc9642c3bc666b86a57f943d","44421dd1e13a47a388c4a19834b744c7",22882512,1,2,0,1231,357,359,2
"44421dd1e13a47a388c4a19834b744c7","44421dd1e13a47a388c4a19834b744c7",22882512,2,0,1,1232,359,359,0
"44421dd1e13a47a388c4a19834b744c7","cb5fc7ef85d547c4be1a7439d0bf6052",22882512,1,1,0,1234,359,360,1
"cb5fc7ef85d547c4be1a7439d0bf6052","cb5fc7ef85d547c4be1a7439d0bf6052",22882512,5,0,1,1235,360,360,0
"cb5fc7ef85d547c4be1a7439d0bf6052","0a8f150a4cf747acbde62f4721823da3",22882512,1,1,0,1240,360,361,1
"0a8f150a4cf747acbde62f4721823da3","0a8f150a4cf747acbde62f4721823da3",22882512,2,0,1,1241,361,361,0
"0a8f150a4cf747acbde62f4721823da3","ab8fdad974ae471f9f24c3f9dd04462e",22882512,1,1,0,1243,361,362,1
"ab8fdad974ae471f9f24c3f9dd04462e","ab8fdad974ae471f9f24c3f9dd04462e",22882512,5,0,1,1244,362,362,0
"ab8fdad974ae471f9f24c3f9dd04462e","1ba8fef685d74a8194b9db252eb704fb",22882512,1,-7,0,1249,362,355,-7
"1ba8fef685d74a8194b9db252eb704fb","52580888dadb4fe3baa795683ea227bd",22882512,1,10,0,1250,355,364,9
"52580888dadb4fe3baa795683ea227bd","492a3bc6a1254f23a7998587961b22a4",22882512,1,3,0,1251,364,366,2
"492a3bc6a1254f23a7998587961b22a4","f00179e251a045b39c3f7a54f9aa4acc",22882512,1,-4,0,1252,366,363,-3
"f00179e251a045b39c3f7a54f9aa4acc","072a190fd302456290895f9f04d6940a",22882512,1,3,0,1253,363,365,2
"072a190fd302456290895f9f04d6940a","cfa457d1743848e4bb5e4beced6448ed",22882512,1,5,0,1254,365,369,4
"cfa457d1743848e4bb5e4beced6448ed","cfa457d1743848e4bb5e4beced6448ed",22882512,1,0,1,1255,369,369,0
"cfa457d1743848e4bb5e4beced6448ed","30ead9794d4847abaf222ca966cc8630",22882512,1,-25,0,1256,369,348,-21
"30ead9794d4847abaf222ca966cc8630","b71bac264efb4abd97015447bd490db6",22882512,1,28,0,1257,348,370,22
"b71bac264efb4abd97015447bd490db6","b71bac264efb4abd97015447bd490db6",22882512,2,0,1,1258,370,370,0
"b71bac264efb4abd97015447bd490db6","8d448d625b024c82a5eb240bbd7431d6",22882512,5,5,0,1259,370,374,4
"8d448d625b024c82a5eb240bbd7431d6","8d448d625b024c82a5eb240bbd7431d6",22882512,74,0,1,1260,374,374,0
"8d448d625b024c82a5eb240bbd7431d6","b71bac264efb4abd97015447bd490db6",22882512,5,-5,0,1267,374,370,-4
"b71bac264efb4abd97015447bd490db6","d6d02b6ef04e4f17805504500b8ce441",22882512,3,8,0,1277,370,375,5
"d6d02b6ef04e4f17805504500b8ce441","d6d02b6ef04e4f17805504500b8ce441",22882512,6,0,1,1278,375,375,0
"d6d02b6ef04e4f17805504500b8ce441","66baf19b6b904b70922329068c63746d",22882512,1,4,0,1281,375,376,1
"66baf19b6b904b70922329068c63746d","7f544639412e40a9ba27f43b415362ab",22882512,5,2,0,1282,376,378,2
"7f544639412e40a9ba27f43b415362ab","66baf19b6b904b70922329068c63746d",22882512,4,-2,0,1283,378,376,-2
"7f544639412e40a9ba27f43b415362ab","7f544639412e40a9ba27f43b415362ab",22882512,3,0,1,1285,378,378,0
"7f544639412e40a9ba27f43b415362ab","d5ae8642e15b46b8bd298b02274d4e9c",22882512,1,2,0,1288,378,380,2
"d5ae8642e15b46b8bd298b02274d4e9c","d5ae8642e15b46b8bd298b02274d4e9c",22882512,4,0,1,1289,380,380,0
"d5ae8642e15b46b8bd298b02274d4e9c","a0d10309a2dd456289147f84be9d37f9",22882512,1,1,0,1293,380,381,1
"a0d10309a2dd456289147f84be9d37f9","a0d10309a2dd456289147f84be9d37f9",22882512,2,0,1,1294,381,381,0
"a0d10309a2dd456289147f84be9d37f9","0fcbc3ca07b144138b8d85da581f09a8",22882512,1,1,0,1296,381,382,1
"0fcbc3ca07b144138b8d85da581f09a8","0fcbc3ca07b144138b8d85da581f09a8",22882512,2,0,1,1297,382,382,0
"0fcbc3ca07b144138b8d85da581f09a8","66baf19b6b904b70922329068c63746d",22882512,1,-6,0,1299,382,376,-6
"66baf19b6b904b70922329068c63746d","4890121ce5d74576b4632b77cfc23398",22882512,3,14,0,1300,376,388,12
"4890121ce5d74576b4632b77cfc23398","c2fca3669923477ab966ded303dea31c",22882512,3,-6,0,1301,388,383,-5
"c2fca3669923477ab966ded303dea31c","4890121ce5d74576b4632b77cfc23398",22882512,2,6,0,1302,383,388,5
"4890121ce5d74576b4632b77cfc23398","4890121ce5d74576b4632b77cfc23398",22882512,1,0,1,1303,388,388,0
"4890121ce5d74576b4632b77cfc23398","18d3b836dd804224883cc9180b60a8e1",22882512,2,-1,0,1304,388,387,-1
"18d3b836dd804224883cc9180b60a8e1","96bb2b3e85a34d8b9544514e89f6fe97",22882512,4,4,0,1305,387,390,3
"96bb2b3e85a34d8b9544514e89f6fe97","96bb2b3e85a34d8b9544514e89f6fe97",22882512,1,0,1,1306,390,390,0
"96bb2b3e85a34d8b9544514e89f6fe97","66baf19b6b904b70922329068c63746d",22882512,1,-17,0,1307,390,376,-14
"c2fca3669923477ab966ded303dea31c","18d3b836dd804224883cc9180b60a8e1",22882512,2,5,0,1312,383,387,4
"96bb2b3e85a34d8b9544514e89f6fe97","ac4e9b54acfe4670b4634859c7263cb5",22882512,1,2,0,1314,390,392,2
"ac4e9b54acfe4670b4634859c7263cb5","ac4e9b54acfe4670b4634859c7263cb5",22882512,1,0,1,1315,392,392,0
"ac4e9b54acfe4670b4634859c7263cb5","17f95d18bab743888e1736033dc3384d",22882512,1,-3,0,1316,392,389,-3
"17f95d18bab743888e1736033dc3384d","6f8881a745ac4c358a68b92c3b4abe81",22882512,2,6,0,1317,389,394,5
"6f8881a745ac4c358a68b92c3b4abe81","6f8881a745ac4c358a68b92c3b4abe81",22882512,2,0,1,1318,394,394,0
"6f8881a745ac4c358a68b92c3b4abe81","f7002c8484354eceac57bc7bd62c76c1",22882512,2,-1,0,1320,394,393,-1
"f7002c8484354eceac57bc7bd62c76c1","66baf19b6b904b70922329068c63746d",22882512,1,-21,0,1321,393,376,-17
"66baf19b6b904b70922329068c63746d","c2fca3669923477ab966ded303dea31c",22882512,1,8,0,1324,376,383,7
"96bb2b3e85a34d8b9544514e89f6fe97","17f95d18bab743888e1736033dc3384d",22882512,1,-1,0,1328,390,389,-1
"f7002c8484354eceac57bc7bd62c76c1","44a277ea44dc4ae689fab4b82f0b4098",22882512,1,5,0,1331,393,397,4
"44a277ea44dc4ae689fab4b82f0b4098","44a277ea44dc4ae689fab4b82f0b4098",22882512,1,0,1,1332,397,397,0
"44a277ea44dc4ae689fab4b82f0b4098","0c12af0a4e7f4002852cf84b2537c161",22882512,1,-2,0,1333,397,395,-2
"0c12af0a4e7f4002852cf84b2537c161","66baf19b6b904b70922329068c63746d",22882512,1,-24,0,1334,395,376,-19
"96bb2b3e85a34d8b9544514e89f6fe97","6f8881a745ac4c358a68b92c3b4abe81",22882512,1,5,0,1341,390,394,4
"6f8881a745ac4c358a68b92c3b4abe81","17f95d18bab743888e1736033dc3384d",22882512,1,-6,0,1342,394,389,-5
"17f95d18bab743888e1736033dc3384d","f7002c8484354eceac57bc7bd62c76c1",22882512,1,5,0,1343,389,393,4
"f7002c8484354eceac57bc7bd62c76c1","0c12af0a4e7f4002852cf84b2537c161",22882512,1,3,0,1344,393,395,2
"0c12af0a4e7f4002852cf84b2537c161","859e0b8d71694b12befb69ee698138f9",22882512,1,5,0,1345,395,399,4
"859e0b8d71694b12befb69ee698138f9","859e0b8d71694b12befb69ee698138f9",22882512,1,0,1,1346,399,399,0
"859e0b8d71694b12befb69ee698138f9","66baf19b6b904b70922329068c63746d",22882512,1,-29,0,1347,399,376,-23
"66baf19b6b904b70922329068c63746d","2b09a08242b54983aec7063990fb3f66",22882512,1,32,0,1348,376,400,24
"2b09a08242b54983aec7063990fb3f66","2b09a08242b54983aec7063990fb3f66",22882512,11,0,1,1349,400,400,0
"2b09a08242b54983aec7063990fb3f66","1f471b7a883a4df48211e8c6a81b59a7",22882512,1,1,0,1352,400,401,1
"1f471b7a883a4df48211e8c6a81b59a7","1f471b7a883a4df48211e8c6a81b59a7",22882512,1,0,1,1353,401,401,0
"1f471b7a883a4df48211e8c6a81b59a7","2b09a08242b54983aec7063990fb3f66",22882512,1,-1,0,1354,401,400,-1
"2b09a08242b54983aec7063990fb3f66","9de0d567bfa84fe5b77cb76f4a76a5d1",22882512,1,5,0,1355,400,404,4
"9de0d567bfa84fe5b77cb76f4a76a5d1","9de0d567bfa84fe5b77cb76f4a76a5d1",22882512,1,0,1,1356,404,404,0
"9de0d567bfa84fe5b77cb76f4a76a5d1","1157bd665ec4472fb58b751dc5099355",22882512,1,-1,0,1357,404,403,-1
"1157bd665ec4472fb58b751dc5099355","3c8a22d2f9c146ea956609e3ed4f2559",22882512,3,3,0,1358,403,405,2
"3c8a22d2f9c146ea956609e3ed4f2559","58fc9094275e4c49be3f4ba6d4acc0a4",22882512,3,2,0,1359,405,406,1
"58fc9094275e4c49be3f4ba6d4acc0a4","58fc9094275e4c49be3f4ba6d4acc0a4",22882512,2,0,1,1360,406,406,0
"58fc9094275e4c49be3f4ba6d4acc0a4","c1c1be90b2b14c1ab4a5e1ee3c241902",22882512,1,1,0,1361,406,407,1
"c1c1be90b2b14c1ab4a5e1ee3c241902","c1c1be90b2b14c1ab4a5e1ee3c241902",22882512,5,0,1,1362,407,407,0
"c1c1be90b2b14c1ab4a5e1ee3c241902","58fc9094275e4c49be3f4ba6d4acc0a4",22882512,1,-1,0,1367,407,406,-1
"58fc9094275e4c49be3f4ba6d4acc0a4","02b3a1bead9244c1ba2f857c7da8f82a",22882512,5,3,0,1368,406,408,2
"02b3a1bead9244c1ba2f857c7da8f82a","02b3a1bead9244c1ba2f857c7da8f82a",22882512,2,0,1,1369,408,408,0
"02b3a1bead9244c1ba2f857c7da8f82a","6206fc6479014bb193084c32409dc1b9",22882512,1,1,0,1370,408,409,1
"6206fc6479014bb193084c32409dc1b9","6206fc6479014bb193084c32409dc1b9",22882512,4,0,1,1371,409,409,0
"6206fc6479014bb193084c32409dc1b9","02b3a1bead9244c1ba2f857c7da8f82a",22882512,1,-1,0,1375,409,408,-1
"02b3a1bead9244c1ba2f857c7da8f82a","6a5f020451db426dacba9e2ea3fcc62a",22882512,3,3,0,1376,408,410,2
"6a5f020451db426dacba9e2ea3fcc62a","33a9d248b2e44588a5b07fc1342b9bc2",22882512,4,2,0,1377,410,411,1
"33a9d248b2e44588a5b07fc1342b9bc2","6a5f020451db426dacba9e2ea3fcc62a",22882512,4,-2,0,1378,411,410,-1
"6a5f020451db426dacba9e2ea3fcc62a","2a65ee6e2ac64f6a8a55fbe5373ec763",22882512,1,4,0,1379,410,413,3
"2a65ee6e2ac64f6a8a55fbe5373ec763","2a65ee6e2ac64f6a8a55fbe5373ec763",22882512,2,0,1,1380,413,413,0
"2a65ee6e2ac64f6a8a55fbe5373ec763","c6f26bd420634f1cb7989e76fe6b16c0",22882512,1,-1,0,1382,413,412,-1
"c6f26bd420634f1cb7989e76fe6b16c0","c6f26bd420634f1cb7989e76fe6b16c0",22882512,11,0,1,1383,412,412,0
"c6f26bd420634f1cb7989e76fe6b16c0","33a9d248b2e44588a5b07fc1342b9bc2",22882512,1,-1,0,1394,412,411,-1
"33a9d248b2e44588a5b07fc1342b9bc2","2b09a08242b54983aec7063990fb3f66",22882512,1,-17,0,1395,411,400,-11
"2b09a08242b54983aec7063990fb3f66","1157bd665ec4472fb58b751dc5099355",22882512,3,4,0,1398,400,403,3
"1157bd665ec4472fb58b751dc5099355","58fc9094275e4c49be3f4ba6d4acc0a4",22882512,1,5,0,1399,403,406,3
"58fc9094275e4c49be3f4ba6d4acc0a4","3c8a22d2f9c146ea956609e3ed4f2559",22882512,1,-2,0,1400,406,405,-1
"02b3a1bead9244c1ba2f857c7da8f82a","33a9d248b2e44588a5b07fc1342b9bc2",22882512,3,5,0,1404,408,411,3
"6a5f020451db426dacba9e2ea3fcc62a","6a5f020451db426dacba9e2ea3fcc62a",22882512,2,0,1,1406,410,410,0
"33a9d248b2e44588a5b07fc1342b9bc2","1fd0f6dadbc14ebc965faf6122190b96",22882512,1,5,0,1408,411,415,4
"1fd0f6dadbc14ebc965faf6122190b96","1fd0f6dadbc14ebc965faf6122190b96",22882512,3,0,1,1409,415,415,0
"1fd0f6dadbc14ebc965faf6122190b96","687055dad9fc40c3982478fe33ec01bf",22882512,1,-1,0,1412,415,414,-1
"687055dad9fc40c3982478fe33ec01bf","687055dad9fc40c3982478fe33ec01bf",22882512,1,0,1,1413,414,414,0
"687055dad9fc40c3982478fe33ec01bf","2add1669f08d4101913db15f8c23b3b7",22882512,2,3,0,1414,414,416,2
"2add1669f08d4101913db15f8c23b3b7","2b09a08242b54983aec7063990fb3f66",22882512,3,-24,0,1415,416,400,-16
"3c8a22d2f9c146ea956609e3ed4f2559","02b3a1bead9244c1ba2f857c7da8f82a",22882512,1,5,0,1420,405,408,3
"33a9d248b2e44588a5b07fc1342b9bc2","58fc9094275e4c49be3f4ba6d4acc0a4",22882512,1,-8,0,1422,411,406,-5
"6a5f020451db426dacba9e2ea3fcc62a","58fc9094275e4c49be3f4ba6d4acc0a4",22882512,1,-6,0,1426,410,406,-4
"58fc9094275e4c49be3f4ba6d4acc0a4","687055dad9fc40c3982478fe33ec01bf",22882512,1,12,0,1427,406,414,8
"687055dad9fc40c3982478fe33ec01bf","33a9d248b2e44588a5b07fc1342b9bc2",22882512,1,-4,0,1428,414,411,-3
"33a9d248b2e44588a5b07fc1342b9bc2","2add1669f08d4101913db15f8c23b3b7",22882512,1,7,0,1429,411,416,5
"2add1669f08d4101913db15f8c23b3b7","2add1669f08d4101913db15f8c23b3b7",22882512,4,0,1,1430,416,416,0
"6a5f020451db426dacba9e2ea3fcc62a","02b3a1bead9244c1ba2f857c7da8f82a",22882512,1,-3,0,1440,410,408,-2
"33a9d248b2e44588a5b07fc1342b9bc2","687055dad9fc40c3982478fe33ec01bf",22882512,1,4,0,1444,411,414,3
"2b09a08242b54983aec7063990fb3f66","3c8a22d2f9c146ea956609e3ed4f2559",22882512,1,7,0,1452,400,405,5
"3c8a22d2f9c146ea956609e3ed4f2559","1157bd665ec4472fb58b751dc5099355",22882512,1,-3,0,1453,405,403,-2
"1157bd665ec4472fb58b751dc5099355","02b3a1bead9244c1ba2f857c7da8f82a",22882512,1,8,0,1454,403,408,5
"02b3a1bead9244c1ba2f857c7da8f82a","58fc9094275e4c49be3f4ba6d4acc0a4",22882512,2,-3,0,1455,408,406,-2
"58fc9094275e4c49be3f4ba6d4acc0a4","6a5f020451db426dacba9e2ea3fcc62a",22882512,1,6,0,1458,406,410,4
"33a9d248b2e44588a5b07fc1342b9bc2","33a9d248b2e44588a5b07fc1342b9bc2",22882512,1,0,1,1460,411,411,0
"6a5f020451db426dacba9e2ea3fcc62a","687055dad9fc40c3982478fe33ec01bf",22882512,1,6,0,1462,410,414,4
"687055dad9fc40c3982478fe33ec01bf","2b09a08242b54983aec7063990fb3f66",22882512,1,-21,0,1463,414,400,-14
"2b09a08242b54983aec7063990fb3f66","a2b4bd40cee2481ebd3fc179d6a5cd62",22882512,4,27,0,1464,400,417,17
"a2b4bd40cee2481ebd3fc179d6a5cd62","2b09a08242b54983aec7063990fb3f66",22882512,3,-27,0,1465,417,400,-17
"a2b4bd40cee2481ebd3fc179d6a5cd62","4112ff99f0fd4d0fb8f4cbbcb34436d4",22882512,1,1,0,1471,417,418,1
"4112ff99f0fd4d0fb8f4cbbcb34436d4","4112ff99f0fd4d0fb8f4cbbcb34436d4",22882512,1,0,1,1472,418,418,0
"4112ff99f0fd4d0fb8f4cbbcb34436d4","a2b4bd40cee2481ebd3fc179d6a5cd62",22882512,1,-1,0,1473,418,417,-1
"a2b4bd40cee2481ebd3fc179d6a5cd62","e34e59dce2204f228f3a84b6725df60f",22882512,1,2,0,1474,417,419,2
"e34e59dce2204f228f3a84b6725df60f","e34e59dce2204f228f3a84b6725df60f",22882512,1,0,1,1475,419,419,0
"e34e59dce2204f228f3a84b6725df60f","a2b4bd40cee2481ebd3fc179d6a5cd62",22882512,1,-2,0,1476,419,417,-2
"a2b4bd40cee2481ebd3fc179d6a5cd62","bec48fc2e1294c7eb3d0aca780d731b8",22882512,1,4,0,1477,417,420,3
"bec48fc2e1294c7eb3d0aca780d731b8","bec48fc2e1294c7eb3d0aca780d731b8",22882512,1,0,1,1478,420,420,0
"bec48fc2e1294c7eb3d0aca780d731b8","a24600b0e49245f6bdba8c893cfeddb0",22882512,1,7,0,1479,420,425,5
"a24600b0e49245f6bdba8c893cfeddb0","dbde19fcce2a4c1abdc7f685c293a23f",22882512,1,-4,0,1480,425,422,-3
"dbde19fcce2a4c1abdc7f685c293a23f","a24600b0e49245f6bdba8c893cfeddb0",22882512,1,4,0,1481,422,425,3
"a24600b0e49245f6bdba8c893cfeddb0","a2b4bd40cee2481ebd3fc179d6a5cd62",22882512,1,-11,0,1482,425,417,-8
"a2b4bd40cee2481ebd3fc179d6a5cd62","24cf8786024543f19b89bc20034e60d7",22882512,1,18,0,1483,417,428,11
"24cf8786024543f19b89bc20034e60d7","f2a73be2f46840b182d7bd095378004e",22882512,3,1,0,1484,428,429,1
"f2a73be2f46840b182d7bd095378004e","604551fd4266430cb860fef58fa7dd61",22882512,1,1,0,1485,429,430,1
"604551fd4266430cb860fef58fa7dd61","604551fd4266430cb860fef58fa7dd61",22882512,4,0,1,1486,430,430,0
"604551fd4266430cb860fef58fa7dd61","24cf8786024543f19b89bc20034e60d7",22882512,1,-2,0,1490,430,428,-2
"24cf8786024543f19b89bc20034e60d7","dce46f8904594a62a6377a3587aaa663",22882512,3,4,0,1491,428,431,3
"dce46f8904594a62a6377a3587aaa663","9b9d0a249052413c869753b99682b0ac",22882512,1,1,0,1492,431,432,1
"9b9d0a249052413c869753b99682b0ac","9b9d0a249052413c869753b99682b0ac",22882512,1,0,1,1493,432,432,0
"9b9d0a249052413c869753b99682b0ac","061c175cc90f45fbad883025394e78dd",22882512,1,1,0,1494,432,433,1
"061c175cc90f45fbad883025394e78dd","061c175cc90f45fbad883025394e78dd",22882512,5,0,1,1495,433,433,0
"061c175cc90f45fbad883025394e78dd","dce46f8904594a62a6377a3587aaa663",22882512,1,-2,0,1500,433,431,-2
"dce46f8904594a62a6377a3587aaa663","dce46f8904594a62a6377a3587aaa663",22882512,2,0,1,1501,431,431,0
"dce46f8904594a62a6377a3587aaa663","66ada10dde9f43018588f1ced9d477fc",22882512,2,4,0,1502,431,434,3
"66ada10dde9f43018588f1ced9d477fc","dce46f8904594a62a6377a3587aaa663",22882512,2,-4,0,1503,434,431,-3
"dce46f8904594a62a6377a3587aaa663","24cf8786024543f19b89bc20034e60d7",22882512,1,-4,0,1504,431,428,-3
"f2a73be2f46840b182d7bd095378004e","24cf8786024543f19b89bc20034e60d7",22882512,2,-1,0,1506,429,428,-1
"dce46f8904594a62a6377a3587aaa663","74a7f8712e5449c2bc0b43c6f90dafed",22882512,1,5,0,1509,431,435,4
"74a7f8712e5449c2bc0b43c6f90dafed","74a7f8712e5449c2bc0b43c6f90dafed",22882512,1,0,1,1510,435,435,0
"74a7f8712e5449c2bc0b43c6f90dafed","66ada10dde9f43018588f1ced9d477fc",22882512,1,-1,0,1511,435,434,-1
"66ada10dde9f43018588f1ced9d477fc","24cf8786024543f19b89bc20034e60d7",22882512,1,-8,0,1512,434,428,-6
"dce46f8904594a62a6377a3587aaa663","bf12c96466d840a69bed7020b3f18bb8",22882512,1,7,0,1518,431,436,5
"bf12c96466d840a69bed7020b3f18bb8","bf12c96466d840a69bed7020b3f18bb8",22882512,1,0,1,1519,436,436,0
"bf12c96466d840a69bed7020b3f18bb8","24cf8786024543f19b89bc20034e60d7",22882512,1,-11,0,1520,436,428,-8
"24cf8786024543f19b89bc20034e60d7","070600601c4c439288445d2f0724807d",22882512,1,14,0,1521,428,437,9
"070600601c4c439288445d2f0724807d","1823b6de7d334a7aaabc4570719af4d9",22882512,1,2,0,1522,437,439,2
"1823b6de7d334a7aaabc4570719af4d9","1823b6de7d334a7aaabc4570719af4d9",22882512,10,0,1,1523,439,439,0
"1823b6de7d334a7aaabc4570719af4d9","0380cd76a7d44bc3a4da1f15e4d68f89",22882512,1,2,0,1533,439,440,1
"0380cd76a7d44bc3a4da1f15e4d68f89","070600601c4c439288445d2f0724807d",22882512,1,-4,0,1534,440,437,-3
"070600601c4c439288445d2f0724807d","23b7673c8b5443108c2ef09382834a86",22882512,1,6,0,1535,437,441,4
"23b7673c8b5443108c2ef09382834a86","0380cd76a7d44bc3a4da1f15e4d68f89",22882512,1,-2,0,1536,441,440,-1
"0380cd76a7d44bc3a4da1f15e4d68f89","23b7673c8b5443108c2ef09382834a86",22882512,1,2,0,1537,440,441,1
"23b7673c8b5443108c2ef09382834a86","901e92500aea43c79f19f1b279050668",22882512,1,2,0,1538,441,442,1
"901e92500aea43c79f19f1b279050668","001339db8ced4cf78829ebe8b145449d",22882512,1,1,0,1539,442,443,1
"001339db8ced4cf78829ebe8b145449d","001339db8ced4cf78829ebe8b145449d",22882512,11,0,1,1540,443,443,0
"001339db8ced4cf78829ebe8b145449d","452745e0366e42ae81561bfddebcc6c3",22882512,1,1,0,1551,443,444,1
"452745e0366e42ae81561bfddebcc6c3","452745e0366e42ae81561bfddebcc6c3",22882512,5,0,1,1552,444,444,0
"452745e0366e42ae81561bfddebcc6c3","901e92500aea43c79f19f1b279050668",22882512,1,-2,0,1557,444,442,-2
"901e92500aea43c79f19f1b279050668","4660ff2089114e8db82ceb26a4f329e3",22882512,1,4,0,1558,442,445,3
"4660ff2089114e8db82ceb26a4f329e3","7bd5586eb9d8484eb74a433ee7bfe499",22882512,4,2,0,1559,445,446,1
"7bd5586eb9d8484eb74a433ee7bfe499","4660ff2089114e8db82ceb26a4f329e3",22882512,2,-2,0,1560,446,445,-1
"7bd5586eb9d8484eb74a433ee7bfe499","7bd5586eb9d8484eb74a433ee7bfe499",22882512,25,0,1,1562,446,446,0
"7bd5586eb9d8484eb74a433ee7bfe499","070600601c4c439288445d2f0724807d",22882512,2,-14,0,1577,446,437,-9
"070600601c4c439288445d2f0724807d","7bd5586eb9d8484eb74a433ee7bfe499",22882512,2,14,0,1578,437,446,9
"7bd5586eb9d8484eb74a433ee7bfe499","8a7f26e690f34dda97be16904518ca99",22882512,2,2,0,1587,446,447,1
"8a7f26e690f34dda97be16904518ca99","4660ff2089114e8db82ceb26a4f329e3",22882512,1,-4,0,1588,447,445,-2
"8a7f26e690f34dda97be16904518ca99","8a7f26e690f34dda97be16904518ca99",22882512,1,0,1,1597,447,447,0
"8a7f26e690f34dda97be16904518ca99","070600601c4c439288445d2f0724807d",22882512,1,-16,0,1598,447,437,-10
"070600601c4c439288445d2f0724807d","b2f0d654738f48158edff28e8d3a546e",22882512,1,21,0,1599,437,449,12
"b2f0d654738f48158edff28e8d3a546e","b2f0d654738f48158edff28e8d3a546e",22882512,2,0,1,1600,449,449,0
"b2f0d654738f48158edff28e8d3a546e","f60ee41ec635499abd48168342d32c2f",22882512,3,5,0,1602,449,453,4
"f60ee41ec635499abd48168342d32c2f","f60ee41ec635499abd48168342d32c2f",22882512,58,0,1,1603,453,453,0
"f60ee41ec635499abd48168342d32c2f","b2f0d654738f48158edff28e8d3a546e",22882512,2,-5,0,1607,453,449,-4
"b2f0d654738f48158edff28e8d3a546e","f67fbf45a5f146ed866965bc57c7c001",22882512,1,8,0,1657,449,454,5
"f67fbf45a5f146ed866965bc57c7c001","f67fbf45a5f146ed866965bc57c7c001",22882512,2,0,1,1658,454,454,0
"f67fbf45a5f146ed866965bc57c7c001","d937afe49bd24a07a550dda1c1155122",22882512,1,1,0,1660,454,455,1
"d937afe49bd24a07a550dda1c1155122","d937afe49bd24a07a550dda1c1155122",22882512,5,0,1,1661,455,455,0
"d937afe49bd24a07a550dda1c1155122","3628b3f7823443d0912a339096b69943",22882512,1,1,0,1666,455,456,1
"3628b3f7823443d0912a339096b69943","3628b3f7823443d0912a339096b69943",22882512,3,0,1,1667,456,456,0
"3628b3f7823443d0912a339096b69943","9e049ee647cf43ecbcb5ed792a8e7588",22882512,1,1,0,1670,456,457,1
"9e049ee647cf43ecbcb5ed792a8e7588","9e049ee647cf43ecbcb5ed792a8e7588",22882512,1,0,1,1671,457,457,0
"9e049ee647cf43ecbcb5ed792a8e7588","5256a214faaf410b93f76cea06428334",22882512,1,1,0,1672,457,458,1
"5256a214faaf410b93f76cea06428334","5256a214faaf410b93f76cea06428334",22882512,1,0,1,1673,458,458,0
"5256a214faaf410b93f76cea06428334","25c32b120fce40fa9b6c85133aeb4716",22882512,1,1,0,1674,458,459,1
"25c32b120fce40fa9b6c85133aeb4716","25c32b120fce40fa9b6c85133aeb4716",22882512,1,0,1,1675,459,459,0
"25c32b120fce40fa9b6c85133aeb4716","11bc14f2204949008b7d511b933363c1",22882512,1,1,0,1676,459,460,1
"11bc14f2204949008b7d511b933363c1","11bc14f2204949008b7d511b933363c1",22882512,5,0,1,1677,460,460,0
"11bc14f2204949008b7d511b933363c1","42de338840a34d15adb66e7b14fb9d2c",22882512,1,1,0,1682,460,461,1
"42de338840a34d15adb66e7b14fb9d2c","42de338840a34d15adb66e7b14fb9d2c",22882512,3,0,1,1683,461,461,0
"42de338840a34d15adb66e7b14fb9d2c","9da37c6210b1416b8079c274f70bf600",22882512,1,1,0,1686,461,462,1
"9da37c6210b1416b8079c274f70bf600","9da37c6210b1416b8079c274f70bf600",22882512,3,0,1,1687,462,462,0
"9da37c6210b1416b8079c274f70bf600","519119f1deac45ff9ab4f13529be5c6e",22882512,1,1,0,1690,462,463,1
"519119f1deac45ff9ab4f13529be5c6e","519119f1deac45ff9ab4f13529be5c6e",22882512,3,0,1,1691,463,463,0
"519119f1deac45ff9ab4f13529be5c6e","f67fbf45a5f146ed866965bc57c7c001",22882512,1,-9,0,1694,463,454,-9
"f67fbf45a5f146ed866965bc57c7c001","c5df9f40ec14463b9dcfdc73df3e9285",22882512,1,12,0,1695,454,464,10
"c5df9f40ec14463b9dcfdc73df3e9285","c5df9f40ec14463b9dcfdc73df3e9285",22882512,1,0,1,1696,464,464,0
"c5df9f40ec14463b9dcfdc73df3e9285","f67fbf45a5f146ed866965bc57c7c001",22882512,1,-12,0,1697,464,454,-10
"f67fbf45a5f146ed866965bc57c7c001","b71bac264efb4abd97015447bd490db6",22882512,1,-132,0,1698,454,370,-84
"d6d02b6ef04e4f17805504500b8ce441","b2f0d654738f48158edff28e8d3a546e",22882512,1,116,0,1758,375,449,74
"f60ee41ec635499abd48168342d32c2f","0d987bed3ffa4ed0b9a2e62e97b7b30f",22882512,1,-261,0,1767,453,272,-181
"0d987bed3ffa4ed0b9a2e62e97b7b30f","b71bac264efb4abd97015447bd490db6",22882512,1,132,0,1771,272,370,98
"d6d02b6ef04e4f17805504500b8ce441","0d987bed3ffa4ed0b9a2e62e97b7b30f",22882512,1,-140,0,1785,375,272,-103
"0d987bed3ffa4ed0b9a2e62e97b7b30f","82ae07bc0c9b4570a41799290d1ef399",22882512,1,4,0,1863,272,275,3
"0d987bed3ffa4ed0b9a2e62e97b7b30f","94cecc3f1e7d484b8e068e79241dfd73",22882512,1,13,0,1884,272,281,9
"94cecc3f1e7d484b8e068e79241dfd73","a37477c4e4c14169ad44b06b493007f6",22882512,1,2,0,1885,281,283,2
"a37477c4e4c14169ad44b06b493007f6","94cecc3f1e7d484b8e068e79241dfd73",22882512,1,-2,0,1886,283,281,-2
"94cecc3f1e7d484b8e068e79241dfd73","94cecc3f1e7d484b8e068e79241dfd73",22882512,3,0,1,1887,281,281,0
"94cecc3f1e7d484b8e068e79241dfd73","fab84b4fab5940efb4ea868ef8d09396",22882512,3,5,0,1889,281,284,3
"fab84b4fab5940efb4ea868ef8d09396","fab84b4fab5940efb4ea868ef8d09396",22882512,6,0,1,1890,284,284,0
"fab84b4fab5940efb4ea868ef8d09396","94cecc3f1e7d484b8e068e79241dfd73",22882512,2,-5,0,1891,284,281,-3
"fab84b4fab5940efb4ea868ef8d09396","4a29443515bb404cb8924e1c60a63b73",22882512,2,4,0,1898,284,285,1
"208c9b2796c944db8dacaa96082520ea","fab84b4fab5940efb4ea868ef8d09396",22882512,1,-7,0,1900,288,284,-4
"b613861cecf84ffcab01afb23f660475","b613861cecf84ffcab01afb23f660475",22886652,6,0,1,1,1,1,0
"b613861cecf84ffcab01afb23f660475","e2911e79efc2420eac45d9f671463d4b",22886652,1,3,0,7,1,2,1
"e2911e79efc2420eac45d9f671463d4b","e2911e79efc2420eac45d9f671463d4b",22886652,2,0,1,8,2,2,0
"e2911e79efc2420eac45d9f671463d4b","519d1b8c59404d67b54e96c5c8a830b2",22886652,1,1,0,10,2,3,1
"519d1b8c59404d67b54e96c5c8a830b2","519d1b8c59404d67b54e96c5c8a830b2",22886652,1,0,1,11,3,3,0
"519d1b8c59404d67b54e96c5c8a830b2","531db53f81f646edb0cdcfe0085b03b7",22886652,1,1,0,12,3,4,1
"531db53f81f646edb0cdcfe0085b03b7","531db53f81f646edb0cdcfe0085b03b7",22886652,1,0,1,13,4,4,0
"531db53f81f646edb0cdcfe0085b03b7","4f5f94b2f95141e0a9d53a61da2276da",22886652,1,1,0,14,4,5,1
"4f5f94b2f95141e0a9d53a61da2276da","4f5f94b2f95141e0a9d53a61da2276da",22886652,1,0,1,15,5,5,0
"4f5f94b2f95141e0a9d53a61da2276da","6d541c89590949f99af293c4f2333f67",22886652,1,1,0,16,5,6,1
"6d541c89590949f99af293c4f2333f67","6d541c89590949f99af293c4f2333f67",22886652,1,0,1,17,6,6,0
"6d541c89590949f99af293c4f2333f67","dd5cf0b9fe4c4f1d8f5ff8e4c04879cb",22886652,1,1,0,18,6,7,1
"dd5cf0b9fe4c4f1d8f5ff8e4c04879cb","dd5cf0b9fe4c4f1d8f5ff8e4c04879cb",22886652,2,0,1,19,7,7,0
"dd5cf0b9fe4c4f1d8f5ff8e4c04879cb","f96261861edc426abe2248be4f0a709a",22886652,1,1,0,21,7,8,1
"f96261861edc426abe2248be4f0a709a","f96261861edc426abe2248be4f0a709a",22886652,2,0,1,22,8,8,0
"f96261861edc426abe2248be4f0a709a","66b5e16f4f75454fb5b8172079f0fa83",22886652,1,1,0,24,8,9,1
"66b5e16f4f75454fb5b8172079f0fa83","66b5e16f4f75454fb5b8172079f0fa83",22886652,2,0,1,25,9,9,0
"66b5e16f4f75454fb5b8172079f0fa83","0680571d4698477995e41842c36a54b2",22886652,1,1,0,27,9,10,1
"0680571d4698477995e41842c36a54b2","0680571d4698477995e41842c36a54b2",22886652,2,0,1,28,10,10,0
"0680571d4698477995e41842c36a54b2","9112f2bffece48e08c6d2287be204085",22886652,1,1,0,30,10,11,1
"9112f2bffece48e08c6d2287be204085","9112f2bffece48e08c6d2287be204085",22886652,2,0,1,31,11,11,0
"9112f2bffece48e08c6d2287be204085","56586aa865414f538729c7f7735d2bc6",22886652,1,3,0,33,11,12,1
"56586aa865414f538729c7f7735d2bc6","e2911e79efc2420eac45d9f671463d4b",22886652,1,-12,0,34,12,2,-10
"e2911e79efc2420eac45d9f671463d4b","56586aa865414f538729c7f7735d2bc6",22886652,1,12,0,35,2,12,10
"56586aa865414f538729c7f7735d2bc6","56586aa865414f538729c7f7735d2bc6",22886652,2,0,1,36,12,12,0
"56586aa865414f538729c7f7735d2bc6","b7f2b31585d94eb3bf86376714aa7070",22886652,1,2,0,38,12,13,1
"b7f2b31585d94eb3bf86376714aa7070","b7f2b31585d94eb3bf86376714aa7070",22886652,2,0,1,39,13,13,0
"b7f2b31585d94eb3bf86376714aa7070","3f1c815879794b929260d224becaff7e",22886652,1,2,0,41,13,14,1
"3f1c815879794b929260d224becaff7e","5c5ceeee4562457ba6d41515aeebfbb1",22886652,1,6,0,42,14,17,3
"5c5ceeee4562457ba6d41515aeebfbb1","81c864a886d54a6b8ff85f7d736f4f95",22886652,1,-4,0,43,17,15,-2
"81c864a886d54a6b8ff85f7d736f4f95","5c5ceeee4562457ba6d41515aeebfbb1",22886652,1,4,0,44,15,17,2
"5c5ceeee4562457ba6d41515aeebfbb1","56586aa865414f538729c7f7735d2bc6",22886652,1,-10,0,45,17,12,-5
"56586aa865414f538729c7f7735d2bc6","9afd71a5298d4333b6849dfce1b9422c",22886652,1,13,0,46,12,18,6
"9afd71a5298d4333b6849dfce1b9422c","b7719e26494940efa49512aedd0aac79",22886652,1,4,0,47,18,20,2
"b7719e26494940efa49512aedd0aac79","9afd71a5298d4333b6849dfce1b9422c",22886652,1,-4,0,48,20,18,-2
"9afd71a5298d4333b6849dfce1b9422c","d4f45188d3c84a02ba08454e6403a818",22886652,1,9,0,49,18,24,6
"d4f45188d3c84a02ba08454e6403a818","d4c3b003e8274e429d2fa688d73fde6d",22886652,2,-2,0,50,24,22,-2
"d4c3b003e8274e429d2fa688d73fde6d","b7719e26494940efa49512aedd0aac79",22886652,2,-3,0,51,22,20,-2
"b7719e26494940efa49512aedd0aac79","d4f45188d3c84a02ba08454e6403a818",22886652,1,5,0,52,20,24,4
"d4c3b003e8274e429d2fa688d73fde6d","d4c3b003e8274e429d2fa688d73fde6d",22886652,1,0,1,54,22,22,0
"afbf7250b99d47bea07172749483ca97","afbf7250b99d47bea07172749483ca97",22886652,1,0,1,58,28,28,0
"afbf7250b99d47bea07172749483ca97","4e51676dc72045d99c19b9fa7b22f8bc",22886652,1,3,0,59,28,29,1
"4e51676dc72045d99c19b9fa7b22f8bc","4e51676dc72045d99c19b9fa7b22f8bc",22886652,1,0,1,60,29,29,0
"4e51676dc72045d99c19b9fa7b22f8bc","51970cfa30e643e894e66ae85c8024cc",22886652,1,3,0,61,29,31,2
"51970cfa30e643e894e66ae85c8024cc","4e51676dc72045d99c19b9fa7b22f8bc",22886652,1,-3,0,62,31,29,-2
"4e51676dc72045d99c19b9fa7b22f8bc","c33c17be71ae4d588da7369472e5bb1b",22886652,1,9,0,63,29,34,5
"c33c17be71ae4d588da7369472e5bb1b","c33c17be71ae4d588da7369472e5bb1b",22886652,2,0,1,64,34,34,0
"c33c17be71ae4d588da7369472e5bb1b","93679be414554a11b1893002f2229a93",22886652,2,3,0,65,34,35,1
"93679be414554a11b1893002f2229a93","93679be414554a11b1893002f2229a93",22886652,2,0,1,66,35,35,0
"93679be414554a11b1893002f2229a93","c33c17be71ae4d588da7369472e5bb1b",22886652,1,-3,0,67,35,34,-1
"93679be414554a11b1893002f2229a93","7040a13096d746ac84b8fac8d9752058",22886652,1,3,0,71,35,36,1
"7040a13096d746ac84b8fac8d9752058","9a0dc646f934470daf08c4b56ccf73db",22886652,1,3,0,72,36,37,1
"9a0dc646f934470daf08c4b56ccf73db","7040a13096d746ac84b8fac8d9752058",22886652,1,-3,0,73,37,36,-1
"7040a13096d746ac84b8fac8d9752058","fc0e049d56024bc9a02c9a9c435c3df7",22886652,1,6,0,74,36,38,2
"fc0e049d56024bc9a02c9a9c435c3df7","9a0dc646f934470daf08c4b56ccf73db",22886652,1,-3,0,75,38,37,-1
"9a0dc646f934470daf08c4b56ccf73db","67a089198fcb4e1c8f2385786c2b296f",22886652,1,7,0,76,37,39,2
"67a089198fcb4e1c8f2385786c2b296f","fc0e049d56024bc9a02c9a9c435c3df7",22886652,1,-4,0,77,39,38,-1
"fc0e049d56024bc9a02c9a9c435c3df7","64d48c6c9c7940639a932219a6c87198",22886652,1,5,0,78,38,40,2
"64d48c6c9c7940639a932219a6c87198","64d48c6c9c7940639a932219a6c87198",22886652,4,0,1,79,40,40,0
"67a089198fcb4e1c8f2385786c2b296f","b534b89233134e30a9b5645138bfa9ee",22886652,1,4,0,88,39,41,2
"b534b89233134e30a9b5645138bfa9ee","0e37b720d23b4e7f8b313e79313fd107",22886652,1,3,0,89,41,44,3
"0e37b720d23b4e7f8b313e79313fd107","0e37b720d23b4e7f8b313e79313fd107",22886652,1,0,1,90,44,44,0
"0e37b720d23b4e7f8b313e79313fd107","6875d67fdd5f48168b62719df449bebd",22886652,1,1,0,91,44,45,1
"6875d67fdd5f48168b62719df449bebd","6875d67fdd5f48168b62719df449bebd",22886652,1,0,1,92,45,45,0
"6875d67fdd5f48168b62719df449bebd","b534b89233134e30a9b5645138bfa9ee",22886652,1,-4,0,93,45,41,-4
"6e13d61a7bdb44bca949c9f86fab3be5","b534b89233134e30a9b5645138bfa9ee",22886652,2,-7,0,96,47,41,-6
"b534b89233134e30a9b5645138bfa9ee","b534b89233134e30a9b5645138bfa9ee",22886652,1,0,1,97,41,41,0
"b534b89233134e30a9b5645138bfa9ee","6e13d61a7bdb44bca949c9f86fab3be5",22886652,3,7,0,100,41,47,6
"6e13d61a7bdb44bca949c9f86fab3be5","6e13d61a7bdb44bca949c9f86fab3be5",22886652,2,0,1,101,47,47,0
"6e13d61a7bdb44bca949c9f86fab3be5","195f78799f984cc2b06c48dfe36be751",22886652,1,2,0,102,47,49,2
"195f78799f984cc2b06c48dfe36be751","195f78799f984cc2b06c48dfe36be751",22886652,2,0,1,103,49,49,0
"195f78799f984cc2b06c48dfe36be751","d0c74f735e024943943e40333d6d337f",22886652,1,3,0,105,49,51,2
"d0c74f735e024943943e40333d6d337f","d9c8d8c444a64dadbbb508652c721e17",22886652,1,-6,0,106,51,46,-5
"d9c8d8c444a64dadbbb508652c721e17","d0c74f735e024943943e40333d6d337f",22886652,1,6,0,107,46,51,5
"d0c74f735e024943943e40333d6d337f","d0c74f735e024943943e40333d6d337f",22886652,2,0,1,108,51,51,0
"d0c74f735e024943943e40333d6d337f","983f8ff320594b279a7f4a6fe132f9c5",22886652,1,2,0,110,51,53,2
"983f8ff320594b279a7f4a6fe132f9c5","983f8ff320594b279a7f4a6fe132f9c5",22886652,2,0,1,111,53,53,0
"983f8ff320594b279a7f4a6fe132f9c5","35adfa5d923046aebabfefd98f35ff05",22886652,1,1,0,113,53,54,1
"35adfa5d923046aebabfefd98f35ff05","35adfa5d923046aebabfefd98f35ff05",22886652,3,0,1,114,54,54,0
"35adfa5d923046aebabfefd98f35ff05","b6f8a98476224da1b40e555ececc7ed8",22886652,1,1,0,117,54,55,1
"b6f8a98476224da1b40e555ececc7ed8","b6f8a98476224da1b40e555ececc7ed8",22886652,2,0,1,118,55,55,0
"b6f8a98476224da1b40e555ececc7ed8","86e22cb5fe0e4b47a9489ecddf7ed78f",22886652,1,1,0,120,55,56,1
"86e22cb5fe0e4b47a9489ecddf7ed78f","86e22cb5fe0e4b47a9489ecddf7ed78f",22886652,2,0,1,121,56,56,0
"86e22cb5fe0e4b47a9489ecddf7ed78f","f924752d8a1149668870b1e7698486f7",22886652,1,-6,0,123,56,50,-6
"f924752d8a1149668870b1e7698486f7","a1f2f12debe5432fb7a70bcd12bacfb9",22886652,1,9,0,124,50,58,8
"a1f2f12debe5432fb7a70bcd12bacfb9","78f30e4dcac84e3cbea8b2cc6e0d62b3",22886652,2,1,0,125,58,59,1
"78f30e4dcac84e3cbea8b2cc6e0d62b3","a1f2f12debe5432fb7a70bcd12bacfb9",22886652,1,-1,0,126,59,58,-1
"a1f2f12debe5432fb7a70bcd12bacfb9","a1f2f12debe5432fb7a70bcd12bacfb9",22886652,19,0,1,127,58,58,0
"78f30e4dcac84e3cbea8b2cc6e0d62b3","78f30e4dcac84e3cbea8b2cc6e0d62b3",22886652,19,0,1,147,59,59,0
"78f30e4dcac84e3cbea8b2cc6e0d62b3","12aa6e1672ac4e7aa6449a7a8609cd72",22886652,1,-2,0,166,59,57,-2
"12aa6e1672ac4e7aa6449a7a8609cd72","bc42d26810654ea9a1df1efe1e58c7d5",22886652,1,7,0,167,57,63,6
"bc42d26810654ea9a1df1efe1e58c7d5","a0a418b8540d479fa6e0f653b701da8b",22886652,2,1,0,168,63,64,1
"a0a418b8540d479fa6e0f653b701da8b","4c943503763e4e349906eea3ed3c8e86",22886652,1,-3,0,169,64,61,-3
"4c943503763e4e349906eea3ed3c8e86","4c943503763e4e349906eea3ed3c8e86",22886652,2,0,1,170,61,61,0
"4c943503763e4e349906eea3ed3c8e86","bc42d26810654ea9a1df1efe1e58c7d5",22886652,1,2,0,172,61,63,2
"bc42d26810654ea9a1df1efe1e58c7d5","bc42d26810654ea9a1df1efe1e58c7d5",22886652,3,0,1,173,63,63,0
"a0a418b8540d479fa6e0f653b701da8b","a0a418b8540d479fa6e0f653b701da8b",22886652,3,0,1,177,64,64,0
"a0a418b8540d479fa6e0f653b701da8b","309ccf3cc4fe429d9bfbaef53d3fa479",22886652,1,-4,0,180,64,60,-4
"309ccf3cc4fe429d9bfbaef53d3fa479","d646286c8051419bbc2e31dd1db55ca8",22886652,1,10,0,181,60,67,7
"d646286c8051419bbc2e31dd1db55ca8","b534b89233134e30a9b5645138bfa9ee",22886652,1,-33,0,182,67,41,-26
"b534b89233134e30a9b5645138bfa9ee","267f883678b24aed855fde42524975d9",22886652,1,37,0,183,41,71,30
"267f883678b24aed855fde42524975d9","267f883678b24aed855fde42524975d9",22886652,1,0,1,184,71,71,0
"267f883678b24aed855fde42524975d9","88fff56d0342490dbef9040750a20f6c",22886652,1,1,0,185,71,72,1
"88fff56d0342490dbef9040750a20f6c","88fff56d0342490dbef9040750a20f6c",22886652,1,0,1,186,72,72,0
"88fff56d0342490dbef9040750a20f6c","adb17b12b66c4a49a85fd34322f7df70",22886652,1,1,0,187,72,73,1
"adb17b12b66c4a49a85fd34322f7df70","adb17b12b66c4a49a85fd34322f7df70",22886652,1,0,1,188,73,73,0
"adb17b12b66c4a49a85fd34322f7df70","a2becd407db34b189200a32546d9d569",22886652,1,3,0,189,73,75,2
"a2becd407db34b189200a32546d9d569","d646286c8051419bbc2e31dd1db55ca8",22886652,1,-9,0,190,75,67,-8
"d646286c8051419bbc2e31dd1db55ca8","a2becd407db34b189200a32546d9d569",22886652,1,9,0,191,67,75,8
"a2becd407db34b189200a32546d9d569","a2becd407db34b189200a32546d9d569",22886652,1,0,1,192,75,75,0
"a2becd407db34b189200a32546d9d569","58c22b011d0f4c2ea6d13615edbb9eeb",22886652,1,2,0,193,75,77,2
"58c22b011d0f4c2ea6d13615edbb9eeb","58c22b011d0f4c2ea6d13615edbb9eeb",22886652,12,0,1,194,77,77,0
"58c22b011d0f4c2ea6d13615edbb9eeb","dd76e1861dc9461c830888729d091ee0",22886652,1,1,0,206,77,78,1
"dd76e1861dc9461c830888729d091ee0","dd76e1861dc9461c830888729d091ee0",22886652,5,0,1,207,78,78,0
"dd76e1861dc9461c830888729d091ee0","cd1d828f1a694b87913a7ea66c23803e",22886652,1,1,0,212,78,79,1
"cd1d828f1a694b87913a7ea66c23803e","cd1d828f1a694b87913a7ea66c23803e",22886652,2,0,1,213,79,79,0
"cd1d828f1a694b87913a7ea66c23803e","9176a3c2b4d2465fa8b0c67096c2a97e",22886652,1,1,0,215,79,80,1
"9176a3c2b4d2465fa8b0c67096c2a97e","9176a3c2b4d2465fa8b0c67096c2a97e",22886652,5,0,1,216,80,80,0
"9176a3c2b4d2465fa8b0c67096c2a97e","f8ec6445f7194e25b9101d4fbcb07a18",22886652,1,1,0,221,80,81,1
"f8ec6445f7194e25b9101d4fbcb07a18","f8ec6445f7194e25b9101d4fbcb07a18",22886652,2,0,1,222,81,81,0
"f8ec6445f7194e25b9101d4fbcb07a18","140d5b27b8574befad82c0a013b59dfa",22886652,1,-7,0,224,81,74,-7
"140d5b27b8574befad82c0a013b59dfa","d18a9ea32855445f8736581f5cb119ce",22886652,1,9,0,225,74,82,8
"d18a9ea32855445f8736581f5cb119ce","f564483cbd7a407681aa2fcca518cf5f",22886652,1,4,0,226,82,85,3
"f564483cbd7a407681aa2fcca518cf5f","f564483cbd7a407681aa2fcca518cf5f",22886652,1,0,1,227,85,85,0
"f564483cbd7a407681aa2fcca518cf5f","18fd01350bd5434ca636d59a599d768a",22886652,1,1,0,228,85,86,1
"18fd01350bd5434ca636d59a599d768a","18fd01350bd5434ca636d59a599d768a",22886652,9,0,1,229,86,86,0
"18fd01350bd5434ca636d59a599d768a","ae5ac430ea254e708a6f5deaaf7464ae",22886652,1,-2,0,238,86,84,-2
"ae5ac430ea254e708a6f5deaaf7464ae","6a9f0ef185fb47f0937e29daa1c71ed5",22886652,1,7,0,239,84,90,6
"6a9f0ef185fb47f0937e29daa1c71ed5","c681290961c94c4caf23b529d1ae6b9a",22886652,1,-2,0,240,90,88,-2
"c681290961c94c4caf23b529d1ae6b9a","c681290961c94c4caf23b529d1ae6b9a",22886652,1,0,1,241,88,88,0
"c681290961c94c4caf23b529d1ae6b9a","6a9f0ef185fb47f0937e29daa1c71ed5",22886652,1,2,0,242,88,90,2
"6a9f0ef185fb47f0937e29daa1c71ed5","6a9f0ef185fb47f0937e29daa1c71ed5",22886652,3,0,1,243,90,90,0
"6a9f0ef185fb47f0937e29daa1c71ed5","e20db35ced8544ddac5bc3839145e463",22886652,1,3,0,246,90,91,1
"e20db35ced8544ddac5bc3839145e463","d646286c8051419bbc2e31dd1db55ca8",22886652,1,-30,0,247,91,67,-24
"d646286c8051419bbc2e31dd1db55ca8","1febb706d7a34005ae8711ed49c76e64",22886652,1,33,0,248,67,94,27
"1febb706d7a34005ae8711ed49c76e64","1febb706d7a34005ae8711ed49c76e64",22886652,2,0,1,249,94,94,0
"1febb706d7a34005ae8711ed49c76e64","8f73ba6f5a0042f2850356ac38ac6f24",22886652,1,1,0,251,94,95,1
"8f73ba6f5a0042f2850356ac38ac6f24","8f73ba6f5a0042f2850356ac38ac6f24",22886652,5,0,1,252,95,95,0
"8f73ba6f5a0042f2850356ac38ac6f24","e2260b86653c46d7b14a41fb419dbf8c",22886652,1,1,0,257,95,96,1
"e2260b86653c46d7b14a41fb419dbf8c","e2260b86653c46d7b14a41fb419dbf8c",22886652,2,0,1,258,96,96,0
"e2260b86653c46d7b14a41fb419dbf8c","35eb641ad1d845bbba54915bce75a962",22886652,1,1,0,260,96,97,1
"35eb641ad1d845bbba54915bce75a962","35eb641ad1d845bbba54915bce75a962",22886652,5,0,1,261,97,97,0
"35eb641ad1d845bbba54915bce75a962","08be90ffbeea4795a138cd42ed8db56f",22886652,1,1,0,266,97,98,1
"08be90ffbeea4795a138cd42ed8db56f","08be90ffbeea4795a138cd42ed8db56f",22886652,6,0,1,267,98,98,0
"08be90ffbeea4795a138cd42ed8db56f","3007433c8f584dcbb5ac159c1c5f2be3",22886652,1,1,0,273,98,99,1
"3007433c8f584dcbb5ac159c1c5f2be3","3007433c8f584dcbb5ac159c1c5f2be3",22886652,5,0,1,274,99,99,0
"3007433c8f584dcbb5ac159c1c5f2be3","d391c8b6e56a43a7b654e9dee02d904b",22886652,1,5,0,279,99,103,4
"d391c8b6e56a43a7b654e9dee02d904b","e20db35ced8544ddac5bc3839145e463",22886652,1,-13,0,280,103,91,-12
"e20db35ced8544ddac5bc3839145e463","00ae5f0c51874a73a41ebea838d95682",22886652,1,11,0,281,91,101,10
"00ae5f0c51874a73a41ebea838d95682","00ae5f0c51874a73a41ebea838d95682",22886652,2,0,1,282,101,101,0
"00ae5f0c51874a73a41ebea838d95682","d391c8b6e56a43a7b654e9dee02d904b",22886652,1,2,0,284,101,103,2
"d391c8b6e56a43a7b654e9dee02d904b","d391c8b6e56a43a7b654e9dee02d904b",22886652,32,0,1,285,103,103,0
"d391c8b6e56a43a7b654e9dee02d904b","6111116566fc4fd9abba409322bea245",22886652,1,1,0,317,103,104,1
"6111116566fc4fd9abba409322bea245","6111116566fc4fd9abba409322bea245",22886652,2,0,1,318,104,104,0
"6111116566fc4fd9abba409322bea245","a81b2235cb9c499eb9ea8ee0a8dd9725",22886652,1,1,0,320,104,105,1
"a81b2235cb9c499eb9ea8ee0a8dd9725","a81b2235cb9c499eb9ea8ee0a8dd9725",22886652,2,0,1,321,105,105,0
"a81b2235cb9c499eb9ea8ee0a8dd9725","2d4e0ab0ef3b4d73b82c72d4621a7579",22886652,1,1,0,323,105,106,1
"2d4e0ab0ef3b4d73b82c72d4621a7579","2d4e0ab0ef3b4d73b82c72d4621a7579",22886652,2,0,1,324,106,106,0
"2d4e0ab0ef3b4d73b82c72d4621a7579","8bdebf492ebd4e62b0d522e8ab5e5197",22886652,1,1,0,326,106,107,1
"8bdebf492ebd4e62b0d522e8ab5e5197","8bdebf492ebd4e62b0d522e8ab5e5197",22886652,5,0,1,327,107,107,0
"8bdebf492ebd4e62b0d522e8ab5e5197","73039f8c1eb9409cb4caee2cf968001e",22886652,1,-7,0,332,107,100,-7
"73039f8c1eb9409cb4caee2cf968001e","4280927ec4d643238aa49c32f9e06c6c",22886652,1,10,0,333,100,109,9
"4280927ec4d643238aa49c32f9e06c6c","67a089198fcb4e1c8f2385786c2b296f",22886652,1,-87,0,334,109,39,-70
"67a089198fcb4e1c8f2385786c2b296f","67a089198fcb4e1c8f2385786c2b296f",22886652,1,0,1,335,39,39,0
"67a089198fcb4e1c8f2385786c2b296f","64d48c6c9c7940639a932219a6c87198",22886652,3,1,0,336,39,40,1
"64d48c6c9c7940639a932219a6c87198","67a089198fcb4e1c8f2385786c2b296f",22886652,4,-1,0,337,40,39,-1
"67a089198fcb4e1c8f2385786c2b296f","e20db35ced8544ddac5bc3839145e463",22886652,1,67,0,338,39,91,52
"e20db35ced8544ddac5bc3839145e463","08111f75e22d409998cf8b85bd431f0a",22886652,1,19,0,339,91,108,17
"08111f75e22d409998cf8b85bd431f0a","4280927ec4d643238aa49c32f9e06c6c",22886652,1,1,0,340,108,109,1
"4280927ec4d643238aa49c32f9e06c6c","4280927ec4d643238aa49c32f9e06c6c",22886652,2,0,1,341,109,109,0
"4280927ec4d643238aa49c32f9e06c6c","fc44e6a5f7654430af1227838224dceb",22886652,1,2,0,343,109,111,2
"fc44e6a5f7654430af1227838224dceb","fc44e6a5f7654430af1227838224dceb",22886652,5,0,1,344,111,111,0
"fc44e6a5f7654430af1227838224dceb","a9ae0a3c070d455bb4369a8996313336",22886652,1,4,0,349,111,114,3
"a9ae0a3c070d455bb4369a8996313336","08111f75e22d409998cf8b85bd431f0a",22886652,1,-7,0,350,114,108,-6
"08111f75e22d409998cf8b85bd431f0a","a9ae0a3c070d455bb4369a8996313336",22886652,1,7,0,351,108,114,6
"a9ae0a3c070d455bb4369a8996313336","71cec822bcff4f30a20e75dc63ef7b65",22886652,1,2,0,352,114,116,2
"71cec822bcff4f30a20e75dc63ef7b65","71cec822bcff4f30a20e75dc63ef7b65",22886652,5,0,1,353,116,116,0
"71cec822bcff4f30a20e75dc63ef7b65","37319e88176d4aefa91d7a9980dbae91",22886652,1,-4,0,358,116,112,-4
"37319e88176d4aefa91d7a9980dbae91","62bff51286ef4f348717a3cf6fe2318f",22886652,1,9,0,359,112,120,8
"62bff51286ef4f348717a3cf6fe2318f","b1cd0e7dc3ad4a8eb91a4bfdbeb025b0",22886652,1,-2,0,360,120,118,-2
"b1cd0e7dc3ad4a8eb91a4bfdbeb025b0","b1cd0e7dc3ad4a8eb91a4bfdbeb025b0",22886652,1,0,1,361,118,118,0
"b1cd0e7dc3ad4a8eb91a4bfdbeb025b0","62bff51286ef4f348717a3cf6fe2318f",22886652,1,2,0,362,118,120,2
"62bff51286ef4f348717a3cf6fe2318f","62bff51286ef4f348717a3cf6fe2318f",22886652,3,0,1,363,120,120,0
"62bff51286ef4f348717a3cf6fe2318f","779f9ddd1fd14d1e9e69f72219a1fdbd",22886652,1,3,0,366,120,121,1
"779f9ddd1fd14d1e9e69f72219a1fdbd","e20db35ced8544ddac5bc3839145e463",22886652,1,-36,0,367,121,91,-30
"e20db35ced8544ddac5bc3839145e463","779f9ddd1fd14d1e9e69f72219a1fdbd",22886652,1,36,0,368,91,121,30
"779f9ddd1fd14d1e9e69f72219a1fdbd","b7719e26494940efa49512aedd0aac79",22886652,1,-143,0,369,121,20,-101
"b7719e26494940efa49512aedd0aac79","b7719e26494940efa49512aedd0aac79",22886652,5,0,1,370,20,20,0
"b7719e26494940efa49512aedd0aac79","afbf7250b99d47bea07172749483ca97",22886652,2,12,0,371,20,28,8
"afbf7250b99d47bea07172749483ca97","b7719e26494940efa49512aedd0aac79",22886652,1,-12,0,372,28,20,-8
"b7719e26494940efa49512aedd0aac79","779f9ddd1fd14d1e9e69f72219a1fdbd",22886652,1,143,0,376,20,121,101
"779f9ddd1fd14d1e9e69f72219a1fdbd","ae26e6cda8ad4a3f81bd347560d9579f",22886652,1,4,0,377,121,125,4
"ae26e6cda8ad4a3f81bd347560d9579f","ae26e6cda8ad4a3f81bd347560d9579f",22886652,3,0,1,378,125,125,0
"ae26e6cda8ad4a3f81bd347560d9579f","ee48df95832b4374aa273ceb27ec1315",22886652,1,1,0,381,125,126,1
"ee48df95832b4374aa273ceb27ec1315","ee48df95832b4374aa273ceb27ec1315",22886652,1,0,1,382,126,126,0
"ee48df95832b4374aa273ceb27ec1315","7a439da90b394756ad1777fc4c6dead5",22886652,1,1,0,383,126,127,1
"7a439da90b394756ad1777fc4c6dead5","7a439da90b394756ad1777fc4c6dead5",22886652,1,0,1,384,127,127,0
"7a439da90b394756ad1777fc4c6dead5","779f9ddd1fd14d1e9e69f72219a1fdbd",22886652,1,-6,0,385,127,121,-6
"779f9ddd1fd14d1e9e69f72219a1fdbd","a8dd5213034441ac92724b4e83eb0bb2",22886652,1,9,0,386,121,129,8
"a8dd5213034441ac92724b4e83eb0bb2","a8dd5213034441ac92724b4e83eb0bb2",22886652,2,0,1,387,129,129,0
"a8dd5213034441ac92724b4e83eb0bb2","8115eab6556b45f5b415c3b8c26a12e5",22886652,1,2,0,389,129,131,2
"8115eab6556b45f5b415c3b8c26a12e5","8115eab6556b45f5b415c3b8c26a12e5",22886652,2,0,1,390,131,131,0
"8115eab6556b45f5b415c3b8c26a12e5","ec34b06efd844b46a4c4818ecdb9b8f4",22886652,1,1,0,392,131,132,1
"ec34b06efd844b46a4c4818ecdb9b8f4","ec34b06efd844b46a4c4818ecdb9b8f4",22886652,8,0,1,393,132,132,0
"ec34b06efd844b46a4c4818ecdb9b8f4","c2e1c2b9eac64109b343a088584b576b",22886652,1,1,0,401,132,133,1
"c2e1c2b9eac64109b343a088584b576b","c2e1c2b9eac64109b343a088584b576b",22886652,2,0,1,402,133,133,0
"c2e1c2b9eac64109b343a088584b576b","579338175e0b4bbb8ef3b712b5d8b54e",22886652,1,-5,0,404,133,128,-5
"579338175e0b4bbb8ef3b712b5d8b54e","8bc5795d6a984a3eace4e2811e52dd4f",22886652,1,8,0,405,128,135,7
"8bc5795d6a984a3eace4e2811e52dd4f","8bc5795d6a984a3eace4e2811e52dd4f",22886652,1,0,1,406,135,135,0
"8bc5795d6a984a3eace4e2811e52dd4f","b416d47c56a742199b5d7c7f19d6503a",22886652,1,-1,0,407,135,134,-1
"b416d47c56a742199b5d7c7f19d6503a","cd4532ad48034873ba8bce2aac0c9808",22886652,1,4,0,408,134,137,3
"cd4532ad48034873ba8bce2aac0c9808","cd4532ad48034873ba8bce2aac0c9808",22886652,1,0,1,409,137,137,0
"cd4532ad48034873ba8bce2aac0c9808","779f9ddd1fd14d1e9e69f72219a1fdbd",22886652,1,-19,0,410,137,121,-16
"779f9ddd1fd14d1e9e69f72219a1fdbd","df1de691dafe4549a18a4398ee9dfaf9",22886652,1,23,0,411,121,139,18
"df1de691dafe4549a18a4398ee9dfaf9","6c5ad271a44743479bfaea29b1db8d02",22886652,1,4,0,412,139,143,4
"6c5ad271a44743479bfaea29b1db8d02","6c5ad271a44743479bfaea29b1db8d02",22886652,1,0,1,413,143,143,0
"6c5ad271a44743479bfaea29b1db8d02","83d311bed5374fee83d8d67a7d9d82dc",22886652,1,1,0,414,143,144,1
"83d311bed5374fee83d8d67a7d9d82dc","83d311bed5374fee83d8d67a7d9d82dc",22886652,1,0,1,415,144,144,0
"83d311bed5374fee83d8d67a7d9d82dc","402bba41861d43acb52a5abb89e8831e",22886652,1,1,0,416,144,145,1
"402bba41861d43acb52a5abb89e8831e","402bba41861d43acb52a5abb89e8831e",22886652,2,0,1,417,145,145,0
"402bba41861d43acb52a5abb89e8831e","8aae34f5ddbb4052a709b12e6b0d40fa",22886652,1,3,0,419,145,147,2
"8aae34f5ddbb4052a709b12e6b0d40fa","df1de691dafe4549a18a4398ee9dfaf9",22886652,1,-9,0,420,147,139,-8
"df1de691dafe4549a18a4398ee9dfaf9","8aae34f5ddbb4052a709b12e6b0d40fa",22886652,1,9,0,421,139,147,8
"8aae34f5ddbb4052a709b12e6b0d40fa","8aae34f5ddbb4052a709b12e6b0d40fa",22886652,1,0,1,422,147,147,0
"8aae34f5ddbb4052a709b12e6b0d40fa","645b3f0249f64f76af2e19eb4d0e55b7",22886652,1,2,0,423,147,149,2
"645b3f0249f64f76af2e19eb4d0e55b7","645b3f0249f64f76af2e19eb4d0e55b7",22886652,5,0,1,424,149,149,0
"645b3f0249f64f76af2e19eb4d0e55b7","7e7b8db5064d4369805ab370aac5ddfb",22886652,1,1,0,429,149,150,1
"7e7b8db5064d4369805ab370aac5ddfb","7e7b8db5064d4369805ab370aac5ddfb",22886652,5,0,1,430,150,150,0
"7e7b8db5064d4369805ab370aac5ddfb","8956d210ae7f41968fada86d4c979d6a",22886652,1,1,0,435,150,151,1
"8956d210ae7f41968fada86d4c979d6a","8956d210ae7f41968fada86d4c979d6a",22886652,2,0,1,436,151,151,0
"8956d210ae7f41968fada86d4c979d6a","f902b0f41b544d4dbf79664fd233648d",22886652,1,-5,0,438,151,146,-5
"f902b0f41b544d4dbf79664fd233648d","ae781e8b775e4ccd93bc800dad5c8376",22886652,1,8,0,439,146,153,7
"ae781e8b775e4ccd93bc800dad5c8376","ae781e8b775e4ccd93bc800dad5c8376",22886652,2,0,1,440,153,153,0
"ae781e8b775e4ccd93bc800dad5c8376","06882a8492d9499aa31555567f575ecb",22886652,1,1,0,442,153,154,1
"06882a8492d9499aa31555567f575ecb","06882a8492d9499aa31555567f575ecb",22886652,1,0,1,443,154,154,0
"06882a8492d9499aa31555567f575ecb","f293c508f409466a8f27ddd7d1e40b20",22886652,1,1,0,444,154,155,1
"f293c508f409466a8f27ddd7d1e40b20","f293c508f409466a8f27ddd7d1e40b20",22886652,2,0,1,445,155,155,0
"f293c508f409466a8f27ddd7d1e40b20","cc4ddef5bbbe48ebb605141b347c4ed1",22886652,1,1,0,447,155,156,1
"cc4ddef5bbbe48ebb605141b347c4ed1","cc4ddef5bbbe48ebb605141b347c4ed1",22886652,3,0,1,448,156,156,0
"cc4ddef5bbbe48ebb605141b347c4ed1","f03480cf4eba413194d7af52fc0e7f28",22886652,1,-4,0,451,156,152,-4
"f03480cf4eba413194d7af52fc0e7f28","d313cec988a84645bee413e8d4724a4b",22886652,1,7,0,452,152,158,6
"d313cec988a84645bee413e8d4724a4b","d313cec988a84645bee413e8d4724a4b",22886652,6,0,1,453,158,158,0
"d313cec988a84645bee413e8d4724a4b","dc60696c76a74368a60f72246e47700d",22886652,1,1,0,457,158,159,1
"dc60696c76a74368a60f72246e47700d","dc60696c76a74368a60f72246e47700d",22886652,1,0,1,458,159,159,0
"dc60696c76a74368a60f72246e47700d","78adeee1fa2c4fe0bc73f7bca9fcee86",22886652,1,3,0,459,159,160,1
"78adeee1fa2c4fe0bc73f7bca9fcee86","df1de691dafe4549a18a4398ee9dfaf9",22886652,2,-26,0,460,160,139,-21
"df1de691dafe4549a18a4398ee9dfaf9","78adeee1fa2c4fe0bc73f7bca9fcee86",22886652,1,26,0,461,139,160,21
"78adeee1fa2c4fe0bc73f7bca9fcee86","78adeee1fa2c4fe0bc73f7bca9fcee86",22886652,1,0,1,462,160,160,0
"df1de691dafe4549a18a4398ee9dfaf9","d313cec988a84645bee413e8d4724a4b",22886652,1,22,0,464,139,158,19
"d313cec988a84645bee413e8d4724a4b","67a089198fcb4e1c8f2385786c2b296f",22886652,1,-148,0,467,158,39,-119
"67a089198fcb4e1c8f2385786c2b296f","779f9ddd1fd14d1e9e69f72219a1fdbd",22886652,1,103,0,468,39,121,82
"779f9ddd1fd14d1e9e69f72219a1fdbd","b416d47c56a742199b5d7c7f19d6503a",22886652,1,15,0,469,121,134,13
"b416d47c56a742199b5d7c7f19d6503a","b416d47c56a742199b5d7c7f19d6503a",22886652,1,0,1,470,134,134,0
"b416d47c56a742199b5d7c7f19d6503a","78adeee1fa2c4fe0bc73f7bca9fcee86",22886652,1,34,0,471,134,160,26
"65202579580f4ad38d734b4ee39d22a8","78adeee1fa2c4fe0bc73f7bca9fcee86",22886652,3,-5,0,474,164,160,-4
"78adeee1fa2c4fe0bc73f7bca9fcee86","3cbcea2be0984e7dbd5a48195af10ce7",22886652,1,8,0,527,160,165,5
"3cbcea2be0984e7dbd5a48195af10ce7","82e6285962b8400d9d6fc32436022a94",22886652,1,2,0,528,165,167,2
"82e6285962b8400d9d6fc32436022a94","3cbcea2be0984e7dbd5a48195af10ce7",22886652,1,-2,0,529,167,165,-2
"3cbcea2be0984e7dbd5a48195af10ce7","a9ac840f098c4bd0a2ee896214ce29cd",22886652,1,5,0,530,165,168,3
"a9ac840f098c4bd0a2ee896214ce29cd","0c7262dff33c4087bc660ccf40f92f9c",22886652,1,4,0,531,168,169,1
"0c7262dff33c4087bc660ccf40f92f9c","b2275c3fad834f8d90737a2d9a6927d6",22886652,2,3,0,532,169,172,3
"b2275c3fad834f8d90737a2d9a6927d6","78adeee1fa2c4fe0bc73f7bca9fcee86",22886652,1,-20,0,533,172,160,-12
"65202579580f4ad38d734b4ee39d22a8","0c7262dff33c4087bc660ccf40f92f9c",22886652,1,12,0,542,164,169,5
"b2275c3fad834f8d90737a2d9a6927d6","b2275c3fad834f8d90737a2d9a6927d6",22886652,26,0,1,544,172,172,0
"b2275c3fad834f8d90737a2d9a6927d6","eb515a26030b41f8a82a1e6114420bad",22886652,1,1,0,570,172,173,1
"eb515a26030b41f8a82a1e6114420bad","eb515a26030b41f8a82a1e6114420bad",22886652,2,0,1,571,173,173,0
"eb515a26030b41f8a82a1e6114420bad","0c7262dff33c4087bc660ccf40f92f9c",22886652,1,-4,0,573,173,169,-4
"0c7262dff33c4087bc660ccf40f92f9c","b42cc17b7de840f181a704558d0bc845",22886652,1,7,0,574,169,175,6
"b42cc17b7de840f181a704558d0bc845","b42cc17b7de840f181a704558d0bc845",22886652,4,0,1,575,175,175,0
"b42cc17b7de840f181a704558d0bc845","801f9e9135034f49bf5f8b4bdefedb41",22886652,1,2,0,579,175,177,2
"801f9e9135034f49bf5f8b4bdefedb41","801f9e9135034f49bf5f8b4bdefedb41",22886652,7,0,1,580,177,177,0
"801f9e9135034f49bf5f8b4bdefedb41","ea38cc0e6e6e41edbabf210220808bf9",22886652,1,3,0,587,177,179,2
"ea38cc0e6e6e41edbabf210220808bf9","362fcb0699a14845ab29b2340093e528",22886652,1,-6,0,588,179,174,-5
"362fcb0699a14845ab29b2340093e528","b87c552dd247427abe6ab5795b9c9d43",22886652,1,8,0,589,174,181,7
"b87c552dd247427abe6ab5795b9c9d43","ea38cc0e6e6e41edbabf210220808bf9",22886652,1,-2,0,590,181,179,-2
"ea38cc0e6e6e41edbabf210220808bf9","ea38cc0e6e6e41edbabf210220808bf9",22886652,1,0,1,591,179,179,0
"ea38cc0e6e6e41edbabf210220808bf9","b87c552dd247427abe6ab5795b9c9d43",22886652,1,2,0,592,179,181,2
"b87c552dd247427abe6ab5795b9c9d43","b87c552dd247427abe6ab5795b9c9d43",22886652,7,0,1,593,181,181,0
"b87c552dd247427abe6ab5795b9c9d43","139b097acfca451689d80c9c6eebdf7b",22886652,1,-3,0,600,181,178,-3
"139b097acfca451689d80c9c6eebdf7b","30f660a1feb34582a739722532524f79",22886652,1,6,0,601,178,183,5
"30f660a1feb34582a739722532524f79","30f660a1feb34582a739722532524f79",22886652,7,0,1,602,183,183,0
"30f660a1feb34582a739722532524f79","2024b4885bd14338a39b7b509acbbd02",22886652,1,-1,0,609,183,182,-1
"2024b4885bd14338a39b7b509acbbd02","c3f63fe50d8e487c86bf8ef76c9cadd3",22886652,1,4,0,610,182,185,3
"c3f63fe50d8e487c86bf8ef76c9cadd3","c3f63fe50d8e487c86bf8ef76c9cadd3",22886652,1,0,1,611,185,185,0
"c3f63fe50d8e487c86bf8ef76c9cadd3","0c7262dff33c4087bc660ccf40f92f9c",22886652,1,-20,0,612,185,169,-16
"0c7262dff33c4087bc660ccf40f92f9c","c8e371568a0c4391b25796ae4e91952e",22886652,1,23,0,613,169,186,17
"c8e371568a0c4391b25796ae4e91952e","7d932b23e1c84326ae5aa4d3c0d813d1",22886652,1,2,0,614,186,188,2
"7d932b23e1c84326ae5aa4d3c0d813d1","7d932b23e1c84326ae5aa4d3c0d813d1",22886652,1,0,1,615,188,188,0
"7d932b23e1c84326ae5aa4d3c0d813d1","c8e371568a0c4391b25796ae4e91952e",22886652,1,-2,0,616,188,186,-2
"c8e371568a0c4391b25796ae4e91952e","ab11d94c6c8948ea90b88f19d2cd502b",22886652,1,5,0,617,186,190,4
"ab11d94c6c8948ea90b88f19d2cd502b","ab11d94c6c8948ea90b88f19d2cd502b",22886652,2,0,1,618,190,190,0
"ab11d94c6c8948ea90b88f19d2cd502b","f992451ed6ad4e68bb9e68ad6be7c4be",22886652,1,2,0,620,190,192,2
"f992451ed6ad4e68bb9e68ad6be7c4be","f992451ed6ad4e68bb9e68ad6be7c4be",22886652,1,0,1,621,192,192,0
"f992451ed6ad4e68bb9e68ad6be7c4be","07b44a7a51e94c78b411c753fc39dab0",22886652,1,-3,0,622,192,189,-3
"07b44a7a51e94c78b411c753fc39dab0","6cd2dcaac46847d4a0bc53f296d90375",22886652,1,6,0,623,189,194,5
"6cd2dcaac46847d4a0bc53f296d90375","6cd2dcaac46847d4a0bc53f296d90375",22886652,2,0,1,624,194,194,0
"6cd2dcaac46847d4a0bc53f296d90375","2d2580c9411c4972909db508d6956a58",22886652,1,2,0,626,194,196,2
"2d2580c9411c4972909db508d6956a58","2d2580c9411c4972909db508d6956a58",22886652,2,0,1,627,196,196,0
"2d2580c9411c4972909db508d6956a58","5bddb3d9ed264f3984702f048c7e5340",22886652,1,1,0,629,196,197,1
"5bddb3d9ed264f3984702f048c7e5340","5bddb3d9ed264f3984702f048c7e5340",22886652,2,0,1,630,197,197,0
"5bddb3d9ed264f3984702f048c7e5340","d5e8e2bd12a2466b9d6d90855f0eb079",22886652,1,1,0,632,197,198,1
"d5e8e2bd12a2466b9d6d90855f0eb079","d5e8e2bd12a2466b9d6d90855f0eb079",22886652,2,0,1,633,198,198,0
"d5e8e2bd12a2466b9d6d90855f0eb079","017d7ca8e0394b91aaadc9574df2202c",22886652,1,-5,0,635,198,193,-5
"017d7ca8e0394b91aaadc9574df2202c","54e8e9f0ea3e45c4bf3b8ac799ee31b1",22886652,1,8,0,636,193,200,7
"54e8e9f0ea3e45c4bf3b8ac799ee31b1","54e8e9f0ea3e45c4bf3b8ac799ee31b1",22886652,1,0,1,637,200,200,0
"54e8e9f0ea3e45c4bf3b8ac799ee31b1","c614a00911be4877a075f19315530fb0",22886652,1,1,0,638,200,201,1
"c614a00911be4877a075f19315530fb0","c614a00911be4877a075f19315530fb0",22886652,6,0,1,639,201,201,0
"c614a00911be4877a075f19315530fb0","a6c21bd8b95249c7972820a7a7d76aff",22886652,1,1,0,645,201,202,1
"a6c21bd8b95249c7972820a7a7d76aff","a6c21bd8b95249c7972820a7a7d76aff",22886652,1,0,1,646,202,202,0
"a6c21bd8b95249c7972820a7a7d76aff","bb329d880ab54120adaf203a693bb203",22886652,1,1,0,647,202,203,1
"bb329d880ab54120adaf203a693bb203","bb329d880ab54120adaf203a693bb203",22886652,1,0,1,648,203,203,0
"bb329d880ab54120adaf203a693bb203","f9170dd6bc6442b4acd832747609b09a",22886652,1,-4,0,649,203,199,-4
"f9170dd6bc6442b4acd832747609b09a","334c2344009840079b1d0e1b7ce3d5a7",22886652,1,7,0,650,199,205,6
"334c2344009840079b1d0e1b7ce3d5a7","334c2344009840079b1d0e1b7ce3d5a7",22886652,1,0,1,651,205,205,0
"334c2344009840079b1d0e1b7ce3d5a7","c8e371568a0c4391b25796ae4e91952e",22886652,1,-23,0,652,205,186,-19
"c8e371568a0c4391b25796ae4e91952e","d7f13c8d63ec4e2aa673fbb9cf9c6933",22886652,2,26,0,653,186,206,20
"d7f13c8d63ec4e2aa673fbb9cf9c6933","b9e80f77c3a44349863b19875725c384",22886652,2,1,0,654,206,207,1
"b9e80f77c3a44349863b19875725c384","7108f0e4c2584f1f9c471689ae4c885c",22886652,3,1,0,655,207,208,1
"7108f0e4c2584f1f9c471689ae4c885c","d7f13c8d63ec4e2aa673fbb9cf9c6933",22886652,2,-2,0,656,208,206,-2
"d7f13c8d63ec4e2aa673fbb9cf9c6933","78adeee1fa2c4fe0bc73f7bca9fcee86",22886652,1,-66,0,657,206,160,-46
"65202579580f4ad38d734b4ee39d22a8","d7f13c8d63ec4e2aa673fbb9cf9c6933",22886652,1,61,0,675,164,206,42
"d7f13c8d63ec4e2aa673fbb9cf9c6933","d7f13c8d63ec4e2aa673fbb9cf9c6933",22886652,3,0,1,676,206,206,0
"d7f13c8d63ec4e2aa673fbb9cf9c6933","7108f0e4c2584f1f9c471689ae4c885c",22886652,2,2,0,677,206,208,2
"7108f0e4c2584f1f9c471689ae4c885c","b9e80f77c3a44349863b19875725c384",22886652,2,-1,0,678,208,207,-1
"b9e80f77c3a44349863b19875725c384","b9e80f77c3a44349863b19875725c384",22886652,22,0,1,679,207,207,0
"7108f0e4c2584f1f9c471689ae4c885c","7108f0e4c2584f1f9c471689ae4c885c",22886652,10,0,1,702,208,208,0
"7108f0e4c2584f1f9c471689ae4c885c","09400e101c5d4b439cf9a26b03aae558",22886652,1,3,0,712,208,210,2
"09400e101c5d4b439cf9a26b03aae558","d7f13c8d63ec4e2aa673fbb9cf9c6933",22886652,1,-5,0,713,210,206,-4
"d7f13c8d63ec4e2aa673fbb9cf9c6933","09400e101c5d4b439cf9a26b03aae558",22886652,2,5,0,714,206,210,4
"09400e101c5d4b439cf9a26b03aae558","09400e101c5d4b439cf9a26b03aae558",22886652,4,0,1,715,210,210,0
"09400e101c5d4b439cf9a26b03aae558","a88efa7e50ce47159810ab553afa6d3a",22886652,1,2,0,719,210,212,2
"a88efa7e50ce47159810ab553afa6d3a","a88efa7e50ce47159810ab553afa6d3a",22886652,5,0,1,720,212,212,0
"a88efa7e50ce47159810ab553afa6d3a","a875096404ef4a9984b62d74cda916f9",22886652,1,-3,0,725,212,209,-3
"a875096404ef4a9984b62d74cda916f9","be502a7a43c44bf7b682698de79d9369",22886652,2,6,0,726,209,214,5
"be502a7a43c44bf7b682698de79d9369","f7fb1952f56b4189b86a9f8b7862d2b8",22886652,3,1,0,727,214,215,1
"f7fb1952f56b4189b86a9f8b7862d2b8","be502a7a43c44bf7b682698de79d9369",22886652,1,-1,0,728,215,214,-1
"be502a7a43c44bf7b682698de79d9369","be502a7a43c44bf7b682698de79d9369",22886652,1,0,1,729,214,214,0
"f7fb1952f56b4189b86a9f8b7862d2b8","f7fb1952f56b4189b86a9f8b7862d2b8",22886652,21,0,1,731,215,215,0
"f7fb1952f56b4189b86a9f8b7862d2b8","b860ee85d8bc4a2f97958cfb71be3533",22886652,1,1,0,750,215,216,1
"b860ee85d8bc4a2f97958cfb71be3533","b860ee85d8bc4a2f97958cfb71be3533",22886652,2,0,1,751,216,216,0
"b860ee85d8bc4a2f97958cfb71be3533","ec341f459285443b8361f7f15638ff08",22886652,1,-3,0,753,216,213,-3
"ec341f459285443b8361f7f15638ff08","d7f13c8d63ec4e2aa673fbb9cf9c6933",22886652,1,-9,0,754,213,206,-7
"b9e80f77c3a44349863b19875725c384","d7f13c8d63ec4e2aa673fbb9cf9c6933",22886652,1,-1,0,757,207,206,-1
"d7f13c8d63ec4e2aa673fbb9cf9c6933","c8e371568a0c4391b25796ae4e91952e",22886652,1,-26,0,758,206,186,-20
"09400e101c5d4b439cf9a26b03aae558","a875096404ef4a9984b62d74cda916f9",22886652,1,-1,0,765,210,209,-1
"f7fb1952f56b4189b86a9f8b7862d2b8","ec341f459285443b8361f7f15638ff08",22886652,1,-2,0,770,215,213,-2
"ec341f459285443b8361f7f15638ff08","363837c182e04711840d896ae1e0339c",22886652,1,6,0,771,213,218,5
"363837c182e04711840d896ae1e0339c","363837c182e04711840d896ae1e0339c",22886652,16,0,1,772,218,218,0
"363837c182e04711840d896ae1e0339c","01b2051f8941460d89945e3b02d1ce78",22886652,1,-1,0,788,218,217,-1
"01b2051f8941460d89945e3b02d1ce78","91125ca626c5470eb145501f8c37f8db",22886652,1,4,0,789,217,220,3
"91125ca626c5470eb145501f8c37f8db","91125ca626c5470eb145501f8c37f8db",22886652,1,0,1,790,220,220,0
"91125ca626c5470eb145501f8c37f8db","d7f13c8d63ec4e2aa673fbb9cf9c6933",22886652,1,-18,0,791,220,206,-14
"d7f13c8d63ec4e2aa673fbb9cf9c6933","1c6721b1f63f4d30ba7746ea8af02a52",22886652,2,21,0,792,206,221,15
"1c6721b1f63f4d30ba7746ea8af02a52","77ecef8eff6b4a2caea7707669bf7475",22886652,3,1,0,793,221,222,1
"77ecef8eff6b4a2caea7707669bf7475","77ecef8eff6b4a2caea7707669bf7475",22886652,12,0,1,794,222,222,0
"77ecef8eff6b4a2caea7707669bf7475","1c6721b1f63f4d30ba7746ea8af02a52",22886652,3,-1,0,806,222,221,-1
"1c6721b1f63f4d30ba7746ea8af02a52","d03cb855c70044cf8c35d9ec0de696e3",22886652,2,4,0,807,221,224,3
"d03cb855c70044cf8c35d9ec0de696e3","8b9ae98743bd4d4a8a87dff1c1244211",22886652,2,3,0,808,224,227,3
"8b9ae98743bd4d4a8a87dff1c1244211","d03cb855c70044cf8c35d9ec0de696e3",22886652,1,-3,0,809,227,224,-3
"d03cb855c70044cf8c35d9ec0de696e3","d03cb855c70044cf8c35d9ec0de696e3",22886652,1,0,1,810,224,224,0
"d03cb855c70044cf8c35d9ec0de696e3","a49a937d6896486d9a5396654abcf2e1",22886652,1,2,0,811,224,226,2
"a49a937d6896486d9a5396654abcf2e1","a49a937d6896486d9a5396654abcf2e1",22886652,6,0,1,812,226,226,0
"a49a937d6896486d9a5396654abcf2e1","8b9ae98743bd4d4a8a87dff1c1244211",22886652,1,1,0,818,226,227,1
"8b9ae98743bd4d4a8a87dff1c1244211","8b9ae98743bd4d4a8a87dff1c1244211",22886652,17,0,1,819,227,227,0
"8b9ae98743bd4d4a8a87dff1c1244211","f7906d6f59b9489a91d2ef40db5a474d",22886652,1,-4,0,836,227,223,-4
"f7906d6f59b9489a91d2ef40db5a474d","2ab1535aac1346ba8801535bf729ef37",22886652,2,7,0,837,223,229,6
"2ab1535aac1346ba8801535bf729ef37","1c6721b1f63f4d30ba7746ea8af02a52",22886652,1,-10,0,838,229,221,-8
"1c6721b1f63f4d30ba7746ea8af02a52","d7f13c8d63ec4e2aa673fbb9cf9c6933",22886652,1,-21,0,839,221,206,-15
"8b9ae98743bd4d4a8a87dff1c1244211","2ab1535aac1346ba8801535bf729ef37",22886652,1,3,0,848,227,229,2
"2ab1535aac1346ba8801535bf729ef37","f7906d6f59b9489a91d2ef40db5a474d",22886652,1,-7,0,849,229,223,-6
"2ab1535aac1346ba8801535bf729ef37","2ab1535aac1346ba8801535bf729ef37",22886652,1,0,1,851,229,229,0
"2ab1535aac1346ba8801535bf729ef37","a4f40fb48a8542c8949bae1f002cd9bc",22886652,1,2,0,852,229,231,2
"a4f40fb48a8542c8949bae1f002cd9bc","a4f40fb48a8542c8949bae1f002cd9bc",22886652,2,0,1,853,231,231,0
"a4f40fb48a8542c8949bae1f002cd9bc","8972c23e32044edb8a78fa1eed4e5947",22886652,1,1,0,855,231,232,1
"8972c23e32044edb8a78fa1eed4e5947","8972c23e32044edb8a78fa1eed4e5947",22886652,1,0,1,856,232,232,0
"8972c23e32044edb8a78fa1eed4e5947","92feb4a40f8344d38b6f722e42a53295",22886652,1,1,0,857,232,233,1
"92feb4a40f8344d38b6f722e42a53295","92feb4a40f8344d38b6f722e42a53295",22886652,2,0,1,858,233,233,0
"92feb4a40f8344d38b6f722e42a53295","5152833676bf4c6cb317060be10f68db",22886652,1,-5,0,860,233,228,-5
"5152833676bf4c6cb317060be10f68db","ca3e28f290354c08aefe5b0f769604e6",22886652,1,8,0,861,228,235,7
"ca3e28f290354c08aefe5b0f769604e6","ca3e28f290354c08aefe5b0f769604e6",22886652,9,0,1,862,235,235,0
"ca3e28f290354c08aefe5b0f769604e6","79a35eea833e4c2c9d22fc53c3c6445c",22886652,1,1,0,871,235,236,1
"79a35eea833e4c2c9d22fc53c3c6445c","79a35eea833e4c2c9d22fc53c3c6445c",22886652,4,0,1,872,236,236,0
"79a35eea833e4c2c9d22fc53c3c6445c","8f68228b1518449e9615cdafee41a2bd",22886652,1,1,0,876,236,237,1
"8f68228b1518449e9615cdafee41a2bd","8f68228b1518449e9615cdafee41a2bd",22886652,1,0,1,877,237,237,0
"8f68228b1518449e9615cdafee41a2bd","cab89fa5c3ed45a5aa550fc0352d6a42",22886652,1,1,0,878,237,238,1
"cab89fa5c3ed45a5aa550fc0352d6a42","cab89fa5c3ed45a5aa550fc0352d6a42",22886652,3,0,1,879,238,238,0
"cab89fa5c3ed45a5aa550fc0352d6a42","66d4fad4f1cf4b46be0750a99ad7a35a",22886652,1,1,0,882,238,239,1
"66d4fad4f1cf4b46be0750a99ad7a35a","66d4fad4f1cf4b46be0750a99ad7a35a",22886652,1,0,1,883,239,239,0
"66d4fad4f1cf4b46be0750a99ad7a35a","0b04c8e2f86d48c7aeb7e225819cd32b",22886652,1,-5,0,884,239,234,-5
"0b04c8e2f86d48c7aeb7e225819cd32b","f53da5fd9bfe412da4b80d4742563b6c",22886652,1,8,0,885,234,241,7
"f53da5fd9bfe412da4b80d4742563b6c","f53da5fd9bfe412da4b80d4742563b6c",22886652,1,0,1,886,241,241,0
"f53da5fd9bfe412da4b80d4742563b6c","2ae94c0cea4d480a9d5dca8fb1d7b542",22886652,1,3,0,887,241,242,1
"2ae94c0cea4d480a9d5dca8fb1d7b542","1c6721b1f63f4d30ba7746ea8af02a52",22886652,1,-27,0,888,242,221,-21
"1c6721b1f63f4d30ba7746ea8af02a52","1ebf23f9d994469a85206e4c7b1bf5f5",22886652,1,30,0,889,221,245,24
"1ebf23f9d994469a85206e4c7b1bf5f5","1ebf23f9d994469a85206e4c7b1bf5f5",22886652,17,0,1,890,245,245,0
"1ebf23f9d994469a85206e4c7b1bf5f5","85ae675b83e8422da842cfd25596af99",22886652,1,1,0,907,245,246,1
"85ae675b83e8422da842cfd25596af99","85ae675b83e8422da842cfd25596af99",22886652,1,0,1,908,246,246,0
"85ae675b83e8422da842cfd25596af99","fa235f0f364d47e4ae1c87f47bf8e6ba",22886652,1,8,0,909,246,252,6
"fa235f0f364d47e4ae1c87f47bf8e6ba","2ae94c0cea4d480a9d5dca8fb1d7b542",22886652,1,-12,0,910,252,242,-10
"2ae94c0cea4d480a9d5dca8fb1d7b542","fa235f0f364d47e4ae1c87f47bf8e6ba",22886652,1,12,0,911,242,252,10
"fa235f0f364d47e4ae1c87f47bf8e6ba","fa235f0f364d47e4ae1c87f47bf8e6ba",22886652,1,0,1,912,252,252,0
"fa235f0f364d47e4ae1c87f47bf8e6ba","79f7845465cc4ed19d8e4f1429541be0",22886652,1,2,0,913,252,254,2
"79f7845465cc4ed19d8e4f1429541be0","79f7845465cc4ed19d8e4f1429541be0",22886652,2,0,1,914,254,254,0
"79f7845465cc4ed19d8e4f1429541be0","6e83e23f56544a19b94067c1c558d9c0",22886652,1,-8,0,916,254,247,-7
"6e83e23f56544a19b94067c1c558d9c0","00f61990949545828dd12f1303d47504",22886652,1,11,0,917,247,256,9
"00f61990949545828dd12f1303d47504","00f61990949545828dd12f1303d47504",22886652,3,0,1,918,256,256,0
"00f61990949545828dd12f1303d47504","ead7bb4b64e247d2ae632ab8a296b091",22886652,1,2,0,921,256,258,2
"ead7bb4b64e247d2ae632ab8a296b091","ead7bb4b64e247d2ae632ab8a296b091",22886652,2,0,1,922,258,258,0
"ead7bb4b64e247d2ae632ab8a296b091","41b0048dde734bb280bac6116baa8e27",22886652,1,1,0,924,258,259,1
"41b0048dde734bb280bac6116baa8e27","41b0048dde734bb280bac6116baa8e27",22886652,2,0,1,925,259,259,0
"41b0048dde734bb280bac6116baa8e27","b41c5a094a604ee0915327da5cc0beb7",22886652,1,1,0,927,259,260,1
"b41c5a094a604ee0915327da5cc0beb7","b41c5a094a604ee0915327da5cc0beb7",22886652,2,0,1,928,260,260,0
"b41c5a094a604ee0915327da5cc0beb7","d546341988904f069cfa86b21457d9d9",22886652,1,-10,0,930,260,251,-9
"d546341988904f069cfa86b21457d9d9","28c171777c52431ab6b925073bd63d46",22886652,1,15,0,931,251,264,13
"28c171777c52431ab6b925073bd63d46","28c171777c52431ab6b925073bd63d46",22886652,7,0,1,932,264,264,0
"28c171777c52431ab6b925073bd63d46","ac160db940cb49ae8579162b1d52bb5d",22886652,1,2,0,939,264,266,2
"ac160db940cb49ae8579162b1d52bb5d","ac160db940cb49ae8579162b1d52bb5d",22886652,7,0,1,940,266,266,0
"ac160db940cb49ae8579162b1d52bb5d","d989ebcfc12a4b669f0100dc1aa14f1e",22886652,1,-12,0,947,266,255,-11
"d989ebcfc12a4b669f0100dc1aa14f1e","c6fd49b485cc4874b0bbdd9c6171e09c",22886652,1,15,0,948,255,268,13
"c6fd49b485cc4874b0bbdd9c6171e09c","c6fd49b485cc4874b0bbdd9c6171e09c",22886652,11,0,1,949,268,268,0
"c6fd49b485cc4874b0bbdd9c6171e09c","44240778a97c4af0937817499b75707b",22886652,1,1,0,960,268,269,1
"44240778a97c4af0937817499b75707b","44240778a97c4af0937817499b75707b",22886652,2,0,1,961,269,269,0
"44240778a97c4af0937817499b75707b","7aa76d3e993840d8805f097cbdbcd44b",22886652,1,-9,0,963,269,261,-8
"7aa76d3e993840d8805f097cbdbcd44b","865a4d3b43374da7944dc7d397f566d9",22886652,1,12,0,964,261,271,10
"865a4d3b43374da7944dc7d397f566d9","865a4d3b43374da7944dc7d397f566d9",22886652,1,0,1,965,271,271,0
"865a4d3b43374da7944dc7d397f566d9","2ae94c0cea4d480a9d5dca8fb1d7b542",22886652,1,-35,0,966,271,242,-29
"2ae94c0cea4d480a9d5dca8fb1d7b542","0d987bed3ffa4ed0b9a2e62e97b7b30f",22886652,1,38,0,967,242,272,30
"bb5a47f5ea01454a8b79455422d3b9da","82ae07bc0c9b4570a41799290d1ef399",22886652,1,-6,0,971,280,275,-5
"82ae07bc0c9b4570a41799290d1ef399","bb5a47f5ea01454a8b79455422d3b9da",22886652,1,6,0,972,275,280,5
"bb5a47f5ea01454a8b79455422d3b9da","bb5a47f5ea01454a8b79455422d3b9da",22886652,135,0,1,1000,280,280,0
"bb5a47f5ea01454a8b79455422d3b9da","0d987bed3ffa4ed0b9a2e62e97b7b30f",22886652,9,-10,0,1007,280,272,-8
"0d987bed3ffa4ed0b9a2e62e97b7b30f","94cecc3f1e7d484b8e068e79241dfd73",22886652,3,13,0,1008,272,281,9
"94cecc3f1e7d484b8e068e79241dfd73","a37477c4e4c14169ad44b06b493007f6",22886652,3,2,0,1009,281,283,2
"a37477c4e4c14169ad44b06b493007f6","0d987bed3ffa4ed0b9a2e62e97b7b30f",22886652,1,-15,0,1010,283,272,-11
"0d987bed3ffa4ed0b9a2e62e97b7b30f","bb5a47f5ea01454a8b79455422d3b9da",22886652,12,10,0,1011,272,280,8
"bb5a47f5ea01454a8b79455422d3b9da","94cecc3f1e7d484b8e068e79241dfd73",22886652,1,3,0,1062,280,281,1
"94cecc3f1e7d484b8e068e79241dfd73","0d987bed3ffa4ed0b9a2e62e97b7b30f",22886652,2,-13,0,1063,281,272,-9
"0d987bed3ffa4ed0b9a2e62e97b7b30f","a37477c4e4c14169ad44b06b493007f6",22886652,1,15,0,1064,272,283,11
"a37477c4e4c14169ad44b06b493007f6","78adeee1fa2c4fe0bc73f7bca9fcee86",22886652,1,-167,0,1065,283,160,-123
"78adeee1fa2c4fe0bc73f7bca9fcee86","65202579580f4ad38d734b4ee39d22a8",22886652,6,5,0,1066,160,164,4
"65202579580f4ad38d734b4ee39d22a8","65202579580f4ad38d734b4ee39d22a8",22886652,79,0,1,1067,164,164,0
"65202579580f4ad38d734b4ee39d22a8","0d987bed3ffa4ed0b9a2e62e97b7b30f",22886652,1,147,0,1074,164,272,108
"0d987bed3ffa4ed0b9a2e62e97b7b30f","0d987bed3ffa4ed0b9a2e62e97b7b30f",22886652,2,0,1,1084,272,272,0
"bb5a47f5ea01454a8b79455422d3b9da","0c7262dff33c4087bc660ccf40f92f9c",22886652,1,-145,0,1093,280,169,-111
"0c7262dff33c4087bc660ccf40f92f9c","0d987bed3ffa4ed0b9a2e62e97b7b30f",22886652,1,135,0,1094,169,272,103
"a37477c4e4c14169ad44b06b493007f6","94cecc3f1e7d484b8e068e79241dfd73",22886652,2,-2,0,1144,283,281,-2
"94cecc3f1e7d484b8e068e79241dfd73","fab84b4fab5940efb4ea868ef8d09396",22886652,1,5,0,1145,281,284,3
"fab84b4fab5940efb4ea868ef8d09396","4a29443515bb404cb8924e1c60a63b73",22886652,1,4,0,1146,284,285,1
"4a29443515bb404cb8924e1c60a63b73","fab84b4fab5940efb4ea868ef8d09396",22886652,1,-4,0,1147,285,284,-1
"fab84b4fab5940efb4ea868ef8d09396","208c9b2796c944db8dacaa96082520ea",22886652,1,7,0,1148,284,288,4
"208c9b2796c944db8dacaa96082520ea","208c9b2796c944db8dacaa96082520ea",22886652,2,0,1,1149,288,288,0
"208c9b2796c944db8dacaa96082520ea","4a29443515bb404cb8924e1c60a63b73",22886652,1,-3,0,1151,288,285,-3
"4a29443515bb404cb8924e1c60a63b73","7669a956527947d0add87455277e80b4",22886652,1,7,0,1152,285,291,6
"7669a956527947d0add87455277e80b4","7669a956527947d0add87455277e80b4",22886652,1,0,1,1153,291,291,0
"7669a956527947d0add87455277e80b4","6a9a3b5bde4a48daa896fe8c06eca56f",22886652,1,-2,0,1154,291,289,-2
"6a9a3b5bde4a48daa896fe8c06eca56f","869e967078f04da18dd0b0b9389a7424",22886652,1,5,0,1155,289,293,4
"869e967078f04da18dd0b0b9389a7424","869e967078f04da18dd0b0b9389a7424",22886652,2,0,1,1156,293,293,0
"869e967078f04da18dd0b0b9389a7424","51ab6291537748fab90d519aa09889d6",22886652,1,2,0,1158,293,295,2
"51ab6291537748fab90d519aa09889d6","51ab6291537748fab90d519aa09889d6",22886652,5,0,1,1159,295,295,0
"51ab6291537748fab90d519aa09889d6","34a6e49023fc4465bd5ca604330bbd1c",22886652,1,-3,0,1164,295,292,-3
"34a6e49023fc4465bd5ca604330bbd1c","21592f2a9e9c4b2f8c66ec5dbcbf6a2b",22886652,1,5,0,1165,292,296,4
"21592f2a9e9c4b2f8c66ec5dbcbf6a2b","ba0e59461bfb4a44b7b1c28a01f8d3b3",22886652,1,4,0,1166,296,299,3
"ba0e59461bfb4a44b7b1c28a01f8d3b3","ba0e59461bfb4a44b7b1c28a01f8d3b3",22886652,2,0,1,1167,299,299,0
"ba0e59461bfb4a44b7b1c28a01f8d3b3","0e0b36e731a645e7b1b8a88f5031ca38",22886652,1,2,0,1169,299,301,2
"0e0b36e731a645e7b1b8a88f5031ca38","0e0b36e731a645e7b1b8a88f5031ca38",22886652,2,0,1,1170,301,301,0
"0e0b36e731a645e7b1b8a88f5031ca38","a66a144637284c21afc6de17fea4bfb8",22886652,1,1,0,1172,301,302,1
"a66a144637284c21afc6de17fea4bfb8","a66a144637284c21afc6de17fea4bfb8",22886652,2,0,1,1173,302,302,0
"a66a144637284c21afc6de17fea4bfb8","7646a919d7e64fa990bca9b024ff089d",22886652,1,-4,0,1175,302,298,-4
"7646a919d7e64fa990bca9b024ff089d","e390b575229748ea8aac9364efe2bf00",22886652,1,7,0,1176,298,304,6
"e390b575229748ea8aac9364efe2bf00","e390b575229748ea8aac9364efe2bf00",22886652,1,0,1,1177,304,304,0
"e390b575229748ea8aac9364efe2bf00","3434c10e561d488a914e0f7d71907abd",22886652,1,3,0,1178,304,305,1
"3434c10e561d488a914e0f7d71907abd","4a29443515bb404cb8924e1c60a63b73",22886652,1,-27,0,1179,305,285,-20
"4a29443515bb404cb8924e1c60a63b73","53e7e900392747ccad52e711ab0f80d8",22886652,1,29,0,1180,285,307,22
"53e7e900392747ccad52e711ab0f80d8","53e7e900392747ccad52e711ab0f80d8",22886652,5,0,1,1181,307,307,0
"53e7e900392747ccad52e711ab0f80d8","130acc2aeb0448fdbb2de63bc5cebe5b",22886652,1,3,0,1186,307,309,2
"130acc2aeb0448fdbb2de63bc5cebe5b","3434c10e561d488a914e0f7d71907abd",22886652,1,-5,0,1187,309,305,-4
"3434c10e561d488a914e0f7d71907abd","130acc2aeb0448fdbb2de63bc5cebe5b",22886652,1,5,0,1188,305,309,4
"130acc2aeb0448fdbb2de63bc5cebe5b","130acc2aeb0448fdbb2de63bc5cebe5b",22886652,1,0,1,1189,309,309,0
"130acc2aeb0448fdbb2de63bc5cebe5b","9c062b3251034ebe90f5054e2a3b5120",22886652,1,2,0,1190,309,311,2
"9c062b3251034ebe90f5054e2a3b5120","9c062b3251034ebe90f5054e2a3b5120",22886652,2,0,1,1191,311,311,0
"9c062b3251034ebe90f5054e2a3b5120","ea859f8207e44537889daeaba13ac2e8",22886652,1,1,0,1193,311,312,1
"ea859f8207e44537889daeaba13ac2e8","ea859f8207e44537889daeaba13ac2e8",22886652,1,0,1,1194,312,312,0
"ea859f8207e44537889daeaba13ac2e8","56d94971a7a94257aa330183a8ebd0ea",22886652,1,1,0,1195,312,313,1
"56d94971a7a94257aa330183a8ebd0ea","56d94971a7a94257aa330183a8ebd0ea",22886652,4,0,1,1196,313,313,0
"56d94971a7a94257aa330183a8ebd0ea","141c0df6cd1946539aadd1c9b7068cd4",22886652,1,-5,0,1200,313,308,-5
"141c0df6cd1946539aadd1c9b7068cd4","13255e63e0aa4abf85e5211bf613d43e",22886652,1,10,0,1201,308,317,9
"13255e63e0aa4abf85e5211bf613d43e","13255e63e0aa4abf85e5211bf613d43e",22886652,1,0,1,1202,317,317,0
"13255e63e0aa4abf85e5211bf613d43e","0c787d16c9504873b1a4d903cec09948",22886652,1,-3,0,1203,317,314,-3
"0c787d16c9504873b1a4d903cec09948","86c27d40179e419c8e9d150fb6afa5d0",22886652,1,6,0,1204,314,319,5
"86c27d40179e419c8e9d150fb6afa5d0","86c27d40179e419c8e9d150fb6afa5d0",22886652,2,0,1,1205,319,319,0
"86c27d40179e419c8e9d150fb6afa5d0","8d7e0b55cf9849cda222a0f2440cec55",22886652,1,-1,0,1207,319,318,-1
"8d7e0b55cf9849cda222a0f2440cec55","47edbb64109243e6b0f8f64cdef90c6c",22886652,1,9,0,1208,318,326,8
"47edbb64109243e6b0f8f64cdef90c6c","24f1363179ad4aaa965484a78471912b",22886652,1,-3,0,1209,326,323,-3
"24f1363179ad4aaa965484a78471912b","24f1363179ad4aaa965484a78471912b",22886652,2,0,1,1210,323,323,0
"24f1363179ad4aaa965484a78471912b","3628bdce1dd2429ba924d2d4d09448d2",22886652,1,-1,0,1212,323,322,-1
"3628bdce1dd2429ba924d2d4d09448d2","56b3fd1a212a4764be39d979fde3326e",22886652,1,7,0,1213,322,328,6
"56b3fd1a212a4764be39d979fde3326e","56b3fd1a212a4764be39d979fde3326e",22886652,1,0,1,1214,328,328,0
"56b3fd1a212a4764be39d979fde3326e","3434c10e561d488a914e0f7d71907abd",22886652,1,-28,0,1215,328,305,-23
"3434c10e561d488a914e0f7d71907abd","0c4079457ede49e3aeb5e86ed84bdf35",22886652,1,31,0,1216,305,329,24
"0c4079457ede49e3aeb5e86ed84bdf35","38aea304b4fa46e1b29bb72f5cea4c93",22886652,2,2,0,1217,329,331,2
"38aea304b4fa46e1b29bb72f5cea4c93","4a29443515bb404cb8924e1c60a63b73",22886652,1,-60,0,1218,331,285,-46
"4a29443515bb404cb8924e1c60a63b73","0c4079457ede49e3aeb5e86ed84bdf35",22886652,1,58,0,1219,285,329,44
"0c4079457ede49e3aeb5e86ed84bdf35","0c4079457ede49e3aeb5e86ed84bdf35",22886652,1,0,1,1220,329,329,0
"38aea304b4fa46e1b29bb72f5cea4c93","38aea304b4fa46e1b29bb72f5cea4c93",22886652,3,0,1,1222,331,331,0
"38aea304b4fa46e1b29bb72f5cea4c93","e36d261332f14e79bb4b467aceaeb9b5",22886652,1,2,0,1225,331,333,2
"e36d261332f14e79bb4b467aceaeb9b5","e36d261332f14e79bb4b467aceaeb9b5",22886652,1,0,1,1226,333,333,0
"e36d261332f14e79bb4b467aceaeb9b5","c7e89b9d04744d2eab742fc24e3ef1ae",22886652,1,1,0,1227,333,334,1
"c7e89b9d04744d2eab742fc24e3ef1ae","c7e89b9d04744d2eab742fc24e3ef1ae",22886652,2,0,1,1228,334,334,0
"c7e89b9d04744d2eab742fc24e3ef1ae","fe49f8054b374a0ea4bb266ed135ff62",22886652,1,1,0,1230,334,335,1
"fe49f8054b374a0ea4bb266ed135ff62","fe49f8054b374a0ea4bb266ed135ff62",22886652,5,0,1,1231,335,335,0
"fe49f8054b374a0ea4bb266ed135ff62","d0a8f74af98642fe8360d22c42e45117",22886652,1,1,0,1236,335,336,1
"d0a8f74af98642fe8360d22c42e45117","d0a8f74af98642fe8360d22c42e45117",22886652,5,0,1,1237,336,336,0
"d0a8f74af98642fe8360d22c42e45117","0c4079457ede49e3aeb5e86ed84bdf35",22886652,1,-7,0,1242,336,329,-7
"0c4079457ede49e3aeb5e86ed84bdf35","a7c6339ca1da4368a18d471f0519f877",22886652,1,11,0,1243,329,339,10
"a7c6339ca1da4368a18d471f0519f877","a7c6339ca1da4368a18d471f0519f877",22886652,1,0,1,1244,339,339,0
"a7c6339ca1da4368a18d471f0519f877","b8b9418ab322418d9db9b40d96af873a",22886652,1,-2,0,1245,339,337,-2
"b8b9418ab322418d9db9b40d96af873a","bbc5139ca9024389a94db3a6f47dcff6",22886652,1,5,0,1246,337,341,4
"bbc5139ca9024389a94db3a6f47dcff6","bbc5139ca9024389a94db3a6f47dcff6",22886652,2,0,1,1247,341,341,0
"bbc5139ca9024389a94db3a6f47dcff6","4ee6ca9019ab4a1ab323f98094a9bd77",22886652,1,2,0,1249,341,343,2
"4ee6ca9019ab4a1ab323f98094a9bd77","4ee6ca9019ab4a1ab323f98094a9bd77",22886652,2,0,1,1250,343,343,0
"4ee6ca9019ab4a1ab323f98094a9bd77","b37947176785476f8b29d49a851366dc",22886652,1,1,0,1252,343,344,1
"b37947176785476f8b29d49a851366dc","b37947176785476f8b29d49a851366dc",22886652,2,0,1,1253,344,344,0
"b37947176785476f8b29d49a851366dc","fcea5b10d5a14a3b9324ffece8f6e1e5",22886652,1,1,0,1255,344,345,1
"fcea5b10d5a14a3b9324ffece8f6e1e5","fcea5b10d5a14a3b9324ffece8f6e1e5",22886652,2,0,1,1256,345,345,0
"fcea5b10d5a14a3b9324ffece8f6e1e5","c2490bc612d146edbe786556fab3651b",22886652,1,-5,0,1258,345,340,-5
"c2490bc612d146edbe786556fab3651b","6ac8bb048b854999a47edb35fe627f11",22886652,1,8,0,1259,340,347,7
"6ac8bb048b854999a47edb35fe627f11","6ac8bb048b854999a47edb35fe627f11",22886652,1,0,1,1260,347,347,0
"6ac8bb048b854999a47edb35fe627f11","0c4079457ede49e3aeb5e86ed84bdf35",22886652,1,-21,0,1261,347,329,-18
"0c4079457ede49e3aeb5e86ed84bdf35","30ead9794d4847abaf222ca966cc8630",22886652,1,24,0,1262,329,348,19
"30ead9794d4847abaf222ca966cc8630","897b7f51242c44aab2205c72fdcbf4cd",22886652,1,4,0,1263,348,352,4
"897b7f51242c44aab2205c72fdcbf4cd","09b9678ddc3d452ea4a3d46e15826065",22886652,4,1,0,1264,352,353,1
"09b9678ddc3d452ea4a3d46e15826065","c20993c944444fe085345591a8bd837e",22886652,1,-2,0,1265,353,351,-2
"c20993c944444fe085345591a8bd837e","eff0de7f2dbb42dfa1a2e686efab5b6d",22886652,2,3,0,1266,351,354,3
"eff0de7f2dbb42dfa1a2e686efab5b6d","c20993c944444fe085345591a8bd837e",22886652,3,-3,0,1267,354,351,-3
"c20993c944444fe085345591a8bd837e","c20993c944444fe085345591a8bd837e",22886652,5,0,1,1268,351,351,0
"c20993c944444fe085345591a8bd837e","897b7f51242c44aab2205c72fdcbf4cd",22886652,3,1,0,1271,351,352,1
"897b7f51242c44aab2205c72fdcbf4cd","897b7f51242c44aab2205c72fdcbf4cd",22886652,4,0,1,1272,352,352,0
"09b9678ddc3d452ea4a3d46e15826065","09b9678ddc3d452ea4a3d46e15826065",22886652,5,0,1,1276,353,353,0
"09b9678ddc3d452ea4a3d46e15826065","eff0de7f2dbb42dfa1a2e686efab5b6d",22886652,3,1,0,1279,353,354,1
"eff0de7f2dbb42dfa1a2e686efab5b6d","eff0de7f2dbb42dfa1a2e686efab5b6d",22886652,5,0,1,1280,354,354,0
"eff0de7f2dbb42dfa1a2e686efab5b6d","30ead9794d4847abaf222ca966cc8630",22886652,2,-6,0,1283,354,348,-6
"30ead9794d4847abaf222ca966cc8630","2fe14166dc9642c3bc666b86a57f943d",22886652,3,10,0,1284,348,357,9
"2fe14166dc9642c3bc666b86a57f943d","30ead9794d4847abaf222ca966cc8630",22886652,2,-10,0,1285,357,348,-9
"30ead9794d4847abaf222ca966cc8630","09b9678ddc3d452ea4a3d46e15826065",22886652,2,5,0,1286,348,353,5
"09b9678ddc3d452ea4a3d46e15826065","897b7f51242c44aab2205c72fdcbf4cd",22886652,2,-1,0,1288,353,352,-1
"897b7f51242c44aab2205c72fdcbf4cd","eff0de7f2dbb42dfa1a2e686efab5b6d",22886652,1,2,0,1289,352,354,2
"2fe14166dc9642c3bc666b86a57f943d","2fe14166dc9642c3bc666b86a57f943d",22886652,3,0,1,1300,357,357,0
"2fe14166dc9642c3bc666b86a57f943d","44421dd1e13a47a388c4a19834b744c7",22886652,1,2,0,1302,357,359,2
"44421dd1e13a47a388c4a19834b744c7","44421dd1e13a47a388c4a19834b744c7",22886652,2,0,1,1303,359,359,0
"44421dd1e13a47a388c4a19834b744c7","cb5fc7ef85d547c4be1a7439d0bf6052",22886652,1,1,0,1305,359,360,1
"cb5fc7ef85d547c4be1a7439d0bf6052","cb5fc7ef85d547c4be1a7439d0bf6052",22886652,2,0,1,1306,360,360,0
"cb5fc7ef85d547c4be1a7439d0bf6052","0a8f150a4cf747acbde62f4721823da3",22886652,1,1,0,1308,360,361,1
"0a8f150a4cf747acbde62f4721823da3","0a8f150a4cf747acbde62f4721823da3",22886652,2,0,1,1309,361,361,0
"0a8f150a4cf747acbde62f4721823da3","ab8fdad974ae471f9f24c3f9dd04462e",22886652,1,1,0,1311,361,362,1
"ab8fdad974ae471f9f24c3f9dd04462e","ab8fdad974ae471f9f24c3f9dd04462e",22886652,2,0,1,1312,362,362,0
"ab8fdad974ae471f9f24c3f9dd04462e","52580888dadb4fe3baa795683ea227bd",22886652,1,3,0,1314,362,364,2
"52580888dadb4fe3baa795683ea227bd","1ba8fef685d74a8194b9db252eb704fb",22886652,1,-10,0,1315,364,355,-9
"1ba8fef685d74a8194b9db252eb704fb","52580888dadb4fe3baa795683ea227bd",22886652,2,10,0,1316,355,364,9
"52580888dadb4fe3baa795683ea227bd","30ead9794d4847abaf222ca966cc8630",22886652,1,-18,0,1317,364,348,-16
"897b7f51242c44aab2205c72fdcbf4cd","c20993c944444fe085345591a8bd837e",22886652,2,-1,0,1320,352,351,-1
"eff0de7f2dbb42dfa1a2e686efab5b6d","897b7f51242c44aab2205c72fdcbf4cd",22886652,1,-2,0,1322,354,352,-2
"c20993c944444fe085345591a8bd837e","2fe14166dc9642c3bc666b86a57f943d",22886652,1,7,0,1330,351,357,6
"2fe14166dc9642c3bc666b86a57f943d","1ba8fef685d74a8194b9db252eb704fb",22886652,1,-2,0,1334,357,355,-2
"52580888dadb4fe3baa795683ea227bd","52580888dadb4fe3baa795683ea227bd",22886652,2,0,1,1336,364,364,0
"52580888dadb4fe3baa795683ea227bd","f00179e251a045b39c3f7a54f9aa4acc",22886652,1,-1,0,1338,364,363,-1
"f00179e251a045b39c3f7a54f9aa4acc","492a3bc6a1254f23a7998587961b22a4",22886652,1,4,0,1339,363,366,3
"492a3bc6a1254f23a7998587961b22a4","492a3bc6a1254f23a7998587961b22a4",22886652,2,0,1,1340,366,366,0
"492a3bc6a1254f23a7998587961b22a4","072a190fd302456290895f9f04d6940a",22886652,1,-1,0,1342,366,365,-1
"072a190fd302456290895f9f04d6940a","cfa457d1743848e4bb5e4beced6448ed",22886652,1,5,0,1343,365,369,4
"cfa457d1743848e4bb5e4beced6448ed","cfa457d1743848e4bb5e4beced6448ed",22886652,1,0,1,1344,369,369,0
"cfa457d1743848e4bb5e4beced6448ed","b71bac264efb4abd97015447bd490db6",22886652,1,3,0,1345,369,370,1
"b71bac264efb4abd97015447bd490db6","30ead9794d4847abaf222ca966cc8630",22886652,1,-28,0,1346,370,348,-22
"30ead9794d4847abaf222ca966cc8630","b71bac264efb4abd97015447bd490db6",22886652,1,28,0,1347,348,370,22
"b71bac264efb4abd97015447bd490db6","8d448d625b024c82a5eb240bbd7431d6",22886652,3,5,0,1348,370,374,4
"8d448d625b024c82a5eb240bbd7431d6","8d448d625b024c82a5eb240bbd7431d6",22886652,66,0,1,1349,374,374,0
"8d448d625b024c82a5eb240bbd7431d6","b71bac264efb4abd97015447bd490db6",22886652,2,-5,0,1399,374,370,-4
"b71bac264efb4abd97015447bd490db6","d6d02b6ef04e4f17805504500b8ce441",22886652,3,8,0,1400,370,375,5
"d6d02b6ef04e4f17805504500b8ce441","d6d02b6ef04e4f17805504500b8ce441",22886652,13,0,1,1401,375,375,0
"d6d02b6ef04e4f17805504500b8ce441","0d987bed3ffa4ed0b9a2e62e97b7b30f",22886652,1,-140,0,1406,375,272,-103
"bb5a47f5ea01454a8b79455422d3b9da","b71bac264efb4abd97015447bd490db6",22886652,1,122,0,1415,280,370,90
"d6d02b6ef04e4f17805504500b8ce441","b71bac264efb4abd97015447bd490db6",22886652,2,-8,0,1435,375,370,-5
"8d448d625b024c82a5eb240bbd7431d6","d6d02b6ef04e4f17805504500b8ce441",22886652,1,3,0,1444,374,375,1
"d6d02b6ef04e4f17805504500b8ce441","66baf19b6b904b70922329068c63746d",22886652,1,4,0,1448,375,376,1
"66baf19b6b904b70922329068c63746d","7f544639412e40a9ba27f43b415362ab",22886652,1,2,0,1449,376,378,2
"7f544639412e40a9ba27f43b415362ab","7f544639412e40a9ba27f43b415362ab",22886652,3,0,1,1450,378,378,0
"7f544639412e40a9ba27f43b415362ab","d5ae8642e15b46b8bd298b02274d4e9c",22886652,1,2,0,1453,378,380,2
"d5ae8642e15b46b8bd298b02274d4e9c","d5ae8642e15b46b8bd298b02274d4e9c",22886652,1,0,1,1454,380,380,0
"d5ae8642e15b46b8bd298b02274d4e9c","a0d10309a2dd456289147f84be9d37f9",22886652,1,1,0,1455,380,381,1
"a0d10309a2dd456289147f84be9d37f9","a0d10309a2dd456289147f84be9d37f9",22886652,2,0,1,1456,381,381,0
"a0d10309a2dd456289147f84be9d37f9","0fcbc3ca07b144138b8d85da581f09a8",22886652,1,1,0,1458,381,382,1
"0fcbc3ca07b144138b8d85da581f09a8","0fcbc3ca07b144138b8d85da581f09a8",22886652,2,0,1,1459,382,382,0
"0fcbc3ca07b144138b8d85da581f09a8","66baf19b6b904b70922329068c63746d",22886652,1,-6,0,1461,382,376,-6
"66baf19b6b904b70922329068c63746d","4890121ce5d74576b4632b77cfc23398",22886652,1,14,0,1462,376,388,12
"4890121ce5d74576b4632b77cfc23398","c2fca3669923477ab966ded303dea31c",22886652,1,-6,0,1463,388,383,-5
"c2fca3669923477ab966ded303dea31c","4890121ce5d74576b4632b77cfc23398",22886652,1,6,0,1464,383,388,5
"4890121ce5d74576b4632b77cfc23398","4890121ce5d74576b4632b77cfc23398",22886652,1,0,1,1465,388,388,0
"4890121ce5d74576b4632b77cfc23398","96bb2b3e85a34d8b9544514e89f6fe97",22886652,1,3,0,1466,388,390,2
"96bb2b3e85a34d8b9544514e89f6fe97","18d3b836dd804224883cc9180b60a8e1",22886652,1,-4,0,1467,390,387,-3
"18d3b836dd804224883cc9180b60a8e1","96bb2b3e85a34d8b9544514e89f6fe97",22886652,1,4,0,1468,387,390,3
"96bb2b3e85a34d8b9544514e89f6fe97","96bb2b3e85a34d8b9544514e89f6fe97",22886652,1,0,1,1469,390,390,0
"96bb2b3e85a34d8b9544514e89f6fe97","ac4e9b54acfe4670b4634859c7263cb5",22886652,1,2,0,1470,390,392,2
"ac4e9b54acfe4670b4634859c7263cb5","ac4e9b54acfe4670b4634859c7263cb5",22886652,1,0,1,1471,392,392,0
"ac4e9b54acfe4670b4634859c7263cb5","17f95d18bab743888e1736033dc3384d",22886652,1,-3,0,1472,392,389,-3
"17f95d18bab743888e1736033dc3384d","6f8881a745ac4c358a68b92c3b4abe81",22886652,1,6,0,1473,389,394,5
"6f8881a745ac4c358a68b92c3b4abe81","6f8881a745ac4c358a68b92c3b4abe81",22886652,2,0,1,1474,394,394,0
"6f8881a745ac4c358a68b92c3b4abe81","f7002c8484354eceac57bc7bd62c76c1",22886652,1,-1,0,1476,394,393,-1
"f7002c8484354eceac57bc7bd62c76c1","44a277ea44dc4ae689fab4b82f0b4098",22886652,1,5,0,1477,393,397,4
"44a277ea44dc4ae689fab4b82f0b4098","44a277ea44dc4ae689fab4b82f0b4098",22886652,1,0,1,1478,397,397,0
"44a277ea44dc4ae689fab4b82f0b4098","0c12af0a4e7f4002852cf84b2537c161",22886652,1,-2,0,1479,397,395,-2
"0c12af0a4e7f4002852cf84b2537c161","859e0b8d71694b12befb69ee698138f9",22886652,1,5,0,1480,395,399,4
"859e0b8d71694b12befb69ee698138f9","859e0b8d71694b12befb69ee698138f9",22886652,1,0,1,1481,399,399,0
"859e0b8d71694b12befb69ee698138f9","66baf19b6b904b70922329068c63746d",22886652,1,-29,0,1482,399,376,-23
"66baf19b6b904b70922329068c63746d","2b09a08242b54983aec7063990fb3f66",22886652,1,32,0,1483,376,400,24
"2b09a08242b54983aec7063990fb3f66","2b09a08242b54983aec7063990fb3f66",22886652,4,0,1,1484,400,400,0
"2b09a08242b54983aec7063990fb3f66","1f471b7a883a4df48211e8c6a81b59a7",22886652,1,1,0,1488,400,401,1
"1f471b7a883a4df48211e8c6a81b59a7","1f471b7a883a4df48211e8c6a81b59a7",22886652,1,0,1,1489,401,401,0
"1f471b7a883a4df48211e8c6a81b59a7","2b09a08242b54983aec7063990fb3f66",22886652,1,-1,0,1490,401,400,-1
"2b09a08242b54983aec7063990fb3f66","9de0d567bfa84fe5b77cb76f4a76a5d1",22886652,1,5,0,1491,400,404,4
"9de0d567bfa84fe5b77cb76f4a76a5d1","9de0d567bfa84fe5b77cb76f4a76a5d1",22886652,1,0,1,1492,404,404,0
"9de0d567bfa84fe5b77cb76f4a76a5d1","1157bd665ec4472fb58b751dc5099355",22886652,1,-1,0,1493,404,403,-1
"1157bd665ec4472fb58b751dc5099355","58fc9094275e4c49be3f4ba6d4acc0a4",22886652,1,5,0,1494,403,406,3
"58fc9094275e4c49be3f4ba6d4acc0a4","3c8a22d2f9c146ea956609e3ed4f2559",22886652,1,-2,0,1495,406,405,-1
"3c8a22d2f9c146ea956609e3ed4f2559","58fc9094275e4c49be3f4ba6d4acc0a4",22886652,1,2,0,1496,405,406,1
"58fc9094275e4c49be3f4ba6d4acc0a4","58fc9094275e4c49be3f4ba6d4acc0a4",22886652,1,0,1,1497,406,406,0
"58fc9094275e4c49be3f4ba6d4acc0a4","c1c1be90b2b14c1ab4a5e1ee3c241902",22886652,1,1,0,1498,406,407,1
"c1c1be90b2b14c1ab4a5e1ee3c241902","c1c1be90b2b14c1ab4a5e1ee3c241902",22886652,5,0,1,1499,407,407,0
"c1c1be90b2b14c1ab4a5e1ee3c241902","02b3a1bead9244c1ba2f857c7da8f82a",22886652,1,2,0,1504,407,408,1
"02b3a1bead9244c1ba2f857c7da8f82a","58fc9094275e4c49be3f4ba6d4acc0a4",22886652,1,-3,0,1505,408,406,-2
"58fc9094275e4c49be3f4ba6d4acc0a4","02b3a1bead9244c1ba2f857c7da8f82a",22886652,1,3,0,1506,406,408,2
"02b3a1bead9244c1ba2f857c7da8f82a","02b3a1bead9244c1ba2f857c7da8f82a",22886652,1,0,1,1507,408,408,0
"02b3a1bead9244c1ba2f857c7da8f82a","6206fc6479014bb193084c32409dc1b9",22886652,1,1,0,1508,408,409,1
"6206fc6479014bb193084c32409dc1b9","6206fc6479014bb193084c32409dc1b9",22886652,1,0,1,1509,409,409,0
"6206fc6479014bb193084c32409dc1b9","6a5f020451db426dacba9e2ea3fcc62a",22886652,1,2,0,1510,409,410,1
"6a5f020451db426dacba9e2ea3fcc62a","02b3a1bead9244c1ba2f857c7da8f82a",22886652,1,-3,0,1511,410,408,-2
"02b3a1bead9244c1ba2f857c7da8f82a","6a5f020451db426dacba9e2ea3fcc62a",22886652,1,3,0,1512,408,410,2
"6a5f020451db426dacba9e2ea3fcc62a","6a5f020451db426dacba9e2ea3fcc62a",22886652,2,0,1,1513,410,410,0
"6a5f020451db426dacba9e2ea3fcc62a","33a9d248b2e44588a5b07fc1342b9bc2",22886652,1,2,0,1515,410,411,1
"33a9d248b2e44588a5b07fc1342b9bc2","33a9d248b2e44588a5b07fc1342b9bc2",22886652,2,0,1,1516,411,411,0
"33a9d248b2e44588a5b07fc1342b9bc2","c6f26bd420634f1cb7989e76fe6b16c0",22886652,1,1,0,1518,411,412,1
"c6f26bd420634f1cb7989e76fe6b16c0","c6f26bd420634f1cb7989e76fe6b16c0",22886652,5,0,1,1519,412,412,0
"c6f26bd420634f1cb7989e76fe6b16c0","2a65ee6e2ac64f6a8a55fbe5373ec763",22886652,1,1,0,1524,412,413,1
"2a65ee6e2ac64f6a8a55fbe5373ec763","2a65ee6e2ac64f6a8a55fbe5373ec763",22886652,2,0,1,1525,413,413,0
"2a65ee6e2ac64f6a8a55fbe5373ec763","33a9d248b2e44588a5b07fc1342b9bc2",22886652,1,-2,0,1527,413,411,-2
"33a9d248b2e44588a5b07fc1342b9bc2","1fd0f6dadbc14ebc965faf6122190b96",22886652,1,5,0,1528,411,415,4
"1fd0f6dadbc14ebc965faf6122190b96","1fd0f6dadbc14ebc965faf6122190b96",22886652,1,0,1,1529,415,415,0
"1fd0f6dadbc14ebc965faf6122190b96","687055dad9fc40c3982478fe33ec01bf",22886652,1,-1,0,1530,415,414,-1
"687055dad9fc40c3982478fe33ec01bf","2add1669f08d4101913db15f8c23b3b7",22886652,1,3,0,1531,414,416,2
"2add1669f08d4101913db15f8c23b3b7","2add1669f08d4101913db15f8c23b3b7",22886652,1,0,1,1532,416,416,0
"2add1669f08d4101913db15f8c23b3b7","2b09a08242b54983aec7063990fb3f66",22886652,1,-24,0,1533,416,400,-16
"2b09a08242b54983aec7063990fb3f66","a2b4bd40cee2481ebd3fc179d6a5cd62",22886652,1,27,0,1534,400,417,17
"a2b4bd40cee2481ebd3fc179d6a5cd62","a2b4bd40cee2481ebd3fc179d6a5cd62",22886652,1,0,1,1535,417,417,0
"a2b4bd40cee2481ebd3fc179d6a5cd62","e34e59dce2204f228f3a84b6725df60f",22886652,1,2,0,1536,417,419,2
"e34e59dce2204f228f3a84b6725df60f","e34e59dce2204f228f3a84b6725df60f",22886652,1,0,1,1537,419,419,0
"e34e59dce2204f228f3a84b6725df60f","a2b4bd40cee2481ebd3fc179d6a5cd62",22886652,1,-2,0,1538,419,417,-2
"a2b4bd40cee2481ebd3fc179d6a5cd62","bec48fc2e1294c7eb3d0aca780d731b8",22886652,1,4,0,1539,417,420,3
"bec48fc2e1294c7eb3d0aca780d731b8","bec48fc2e1294c7eb3d0aca780d731b8",22886652,4,0,1,1540,420,420,0
"bec48fc2e1294c7eb3d0aca780d731b8","a24600b0e49245f6bdba8c893cfeddb0",22886652,1,7,0,1544,420,425,5
"a24600b0e49245f6bdba8c893cfeddb0","dbde19fcce2a4c1abdc7f685c293a23f",22886652,1,-4,0,1545,425,422,-3
"dbde19fcce2a4c1abdc7f685c293a23f","a24600b0e49245f6bdba8c893cfeddb0",22886652,1,4,0,1546,422,425,3
"a24600b0e49245f6bdba8c893cfeddb0","a24600b0e49245f6bdba8c893cfeddb0",22886652,3,0,1,1547,425,425,0
"a24600b0e49245f6bdba8c893cfeddb0","a2b4bd40cee2481ebd3fc179d6a5cd62",22886652,1,-11,0,1550,425,417,-8
"a2b4bd40cee2481ebd3fc179d6a5cd62","24cf8786024543f19b89bc20034e60d7",22886652,1,18,0,1551,417,428,11
"24cf8786024543f19b89bc20034e60d7","f2a73be2f46840b182d7bd095378004e",22886652,1,1,0,1552,428,429,1
"f2a73be2f46840b182d7bd095378004e","f2a73be2f46840b182d7bd095378004e",22886652,3,0,1,1553,429,429,0
"f2a73be2f46840b182d7bd095378004e","604551fd4266430cb860fef58fa7dd61",22886652,1,1,0,1556,429,430,1
"604551fd4266430cb860fef58fa7dd61","604551fd4266430cb860fef58fa7dd61",22886652,4,0,1,1557,430,430,0
"604551fd4266430cb860fef58fa7dd61","24cf8786024543f19b89bc20034e60d7",22886652,1,-2,0,1561,430,428,-2
"24cf8786024543f19b89bc20034e60d7","dce46f8904594a62a6377a3587aaa663",22886652,1,4,0,1562,428,431,3
"dce46f8904594a62a6377a3587aaa663","dce46f8904594a62a6377a3587aaa663",22886652,2,0,1,1563,431,431,0
"dce46f8904594a62a6377a3587aaa663","9b9d0a249052413c869753b99682b0ac",22886652,1,1,0,1565,431,432,1
"9b9d0a249052413c869753b99682b0ac","9b9d0a249052413c869753b99682b0ac",22886652,5,0,1,1566,432,432,0
"9b9d0a249052413c869753b99682b0ac","061c175cc90f45fbad883025394e78dd",22886652,1,1,0,1571,432,433,1
"061c175cc90f45fbad883025394e78dd","061c175cc90f45fbad883025394e78dd",22886652,5,0,1,1572,433,433,0
"061c175cc90f45fbad883025394e78dd","dce46f8904594a62a6377a3587aaa663",22886652,1,-2,0,1577,433,431,-2
"dce46f8904594a62a6377a3587aaa663","74a7f8712e5449c2bc0b43c6f90dafed",22886652,1,5,0,1578,431,435,4
"74a7f8712e5449c2bc0b43c6f90dafed","74a7f8712e5449c2bc0b43c6f90dafed",22886652,1,0,1,1579,435,435,0
"74a7f8712e5449c2bc0b43c6f90dafed","66ada10dde9f43018588f1ced9d477fc",22886652,1,-1,0,1580,435,434,-1
"66ada10dde9f43018588f1ced9d477fc","bf12c96466d840a69bed7020b3f18bb8",22886652,1,3,0,1581,434,436,2
"bf12c96466d840a69bed7020b3f18bb8","bf12c96466d840a69bed7020b3f18bb8",22886652,1,0,1,1582,436,436,0
"bf12c96466d840a69bed7020b3f18bb8","24cf8786024543f19b89bc20034e60d7",22886652,1,-11,0,1583,436,428,-8
"24cf8786024543f19b89bc20034e60d7","070600601c4c439288445d2f0724807d",22886652,1,14,0,1584,428,437,9
"070600601c4c439288445d2f0724807d","1823b6de7d334a7aaabc4570719af4d9",22886652,2,2,0,1585,437,439,2
"1823b6de7d334a7aaabc4570719af4d9","070600601c4c439288445d2f0724807d",22886652,2,-2,0,1586,439,437,-2
"070600601c4c439288445d2f0724807d","070600601c4c439288445d2f0724807d",22886652,2,0,1,1587,437,437,0
"1823b6de7d334a7aaabc4570719af4d9","1823b6de7d334a7aaabc4570719af4d9",22886652,14,0,1,1590,439,439,0
"070600601c4c439288445d2f0724807d","0380cd76a7d44bc3a4da1f15e4d68f89",22886652,1,4,0,1605,437,440,3
"0380cd76a7d44bc3a4da1f15e4d68f89","0380cd76a7d44bc3a4da1f15e4d68f89",22886652,2,0,1,1606,440,440,0
"0380cd76a7d44bc3a4da1f15e4d68f89","23b7673c8b5443108c2ef09382834a86",22886652,2,2,0,1608,440,441,1
"23b7673c8b5443108c2ef09382834a86","0380cd76a7d44bc3a4da1f15e4d68f89",22886652,1,-2,0,1609,441,440,-1
"23b7673c8b5443108c2ef09382834a86","23b7673c8b5443108c2ef09382834a86",22886652,2,0,1,1611,441,441,0
"23b7673c8b5443108c2ef09382834a86","901e92500aea43c79f19f1b279050668",22886652,1,2,0,1613,441,442,1
"901e92500aea43c79f19f1b279050668","901e92500aea43c79f19f1b279050668",22886652,2,0,1,1614,442,442,0
"901e92500aea43c79f19f1b279050668","001339db8ced4cf78829ebe8b145449d",22886652,1,1,0,1616,442,443,1
"001339db8ced4cf78829ebe8b145449d","001339db8ced4cf78829ebe8b145449d",22886652,2,0,1,1617,443,443,0
"001339db8ced4cf78829ebe8b145449d","452745e0366e42ae81561bfddebcc6c3",22886652,1,1,0,1619,443,444,1
"452745e0366e42ae81561bfddebcc6c3","452745e0366e42ae81561bfddebcc6c3",22886652,2,0,1,1620,444,444,0
"452745e0366e42ae81561bfddebcc6c3","901e92500aea43c79f19f1b279050668",22886652,1,-2,0,1622,444,442,-2
"901e92500aea43c79f19f1b279050668","4660ff2089114e8db82ceb26a4f329e3",22886652,1,4,0,1623,442,445,3
"4660ff2089114e8db82ceb26a4f329e3","4660ff2089114e8db82ceb26a4f329e3",22886652,3,0,1,1624,445,445,0
"4660ff2089114e8db82ceb26a4f329e3","7bd5586eb9d8484eb74a433ee7bfe499",22886652,1,2,0,1627,445,446,1
"7bd5586eb9d8484eb74a433ee7bfe499","7bd5586eb9d8484eb74a433ee7bfe499",22886652,9,0,1,1628,446,446,0
"7bd5586eb9d8484eb74a433ee7bfe499","8a7f26e690f34dda97be16904518ca99",22886652,1,2,0,1637,446,447,1
"8a7f26e690f34dda97be16904518ca99","8a7f26e690f34dda97be16904518ca99",22886652,1,0,1,1638,447,447,0
"8a7f26e690f34dda97be16904518ca99","b2f0d654738f48158edff28e8d3a546e",22886652,1,5,0,1639,447,449,2
"b2f0d654738f48158edff28e8d3a546e","070600601c4c439288445d2f0724807d",22886652,1,-21,0,1640,449,437,-12
"070600601c4c439288445d2f0724807d","b2f0d654738f48158edff28e8d3a546e",22886652,1,21,0,1641,437,449,12
"b2f0d654738f48158edff28e8d3a546e","f60ee41ec635499abd48168342d32c2f",22886652,2,5,0,1642,449,453,4
"f60ee41ec635499abd48168342d32c2f","f60ee41ec635499abd48168342d32c2f",22886652,61,0,1,1643,453,453,0
"f60ee41ec635499abd48168342d32c2f","b2f0d654738f48158edff28e8d3a546e",22886652,1,-5,0,1695,453,449,-4
"b2f0d654738f48158edff28e8d3a546e","f67fbf45a5f146ed866965bc57c7c001",22886652,1,8,0,1696,449,454,5
"f67fbf45a5f146ed866965bc57c7c001","f67fbf45a5f146ed866965bc57c7c001",22886652,2,0,1,1697,454,454,0
"f67fbf45a5f146ed866965bc57c7c001","d937afe49bd24a07a550dda1c1155122",22886652,1,1,0,1699,454,455,1
"d937afe49bd24a07a550dda1c1155122","d937afe49bd24a07a550dda1c1155122",22886652,3,0,1,1700,455,455,0
"d937afe49bd24a07a550dda1c1155122","3628b3f7823443d0912a339096b69943",22886652,1,1,0,1703,455,456,1
"3628b3f7823443d0912a339096b69943","3628b3f7823443d0912a339096b69943",22886652,1,0,1,1704,456,456,0
"3628b3f7823443d0912a339096b69943","9e049ee647cf43ecbcb5ed792a8e7588",22886652,1,1,0,1705,456,457,1
"9e049ee647cf43ecbcb5ed792a8e7588","9e049ee647cf43ecbcb5ed792a8e7588",22886652,1,0,1,1706,457,457,0
"9e049ee647cf43ecbcb5ed792a8e7588","5256a214faaf410b93f76cea06428334",22886652,1,1,0,1707,457,458,1
"5256a214faaf410b93f76cea06428334","5256a214faaf410b93f76cea06428334",22886652,1,0,1,1708,458,458,0
"5256a214faaf410b93f76cea06428334","25c32b120fce40fa9b6c85133aeb4716",22886652,1,1,0,1709,458,459,1
"25c32b120fce40fa9b6c85133aeb4716","25c32b120fce40fa9b6c85133aeb4716",22886652,6,0,1,1710,459,459,0
"25c32b120fce40fa9b6c85133aeb4716","11bc14f2204949008b7d511b933363c1",22886652,1,1,0,1716,459,460,1
"11bc14f2204949008b7d511b933363c1","11bc14f2204949008b7d511b933363c1",22886652,6,0,1,1717,460,460,0
"11bc14f2204949008b7d511b933363c1","42de338840a34d15adb66e7b14fb9d2c",22886652,1,1,0,1723,460,461,1
"42de338840a34d15adb66e7b14fb9d2c","42de338840a34d15adb66e7b14fb9d2c",22886652,1,0,1,1724,461,461,0
"42de338840a34d15adb66e7b14fb9d2c","9da37c6210b1416b8079c274f70bf600",22886652,1,1,0,1725,461,462,1
"9da37c6210b1416b8079c274f70bf600","9da37c6210b1416b8079c274f70bf600",22886652,3,0,1,1726,462,462,0
"9da37c6210b1416b8079c274f70bf600","519119f1deac45ff9ab4f13529be5c6e",22886652,1,1,0,1729,462,463,1
"519119f1deac45ff9ab4f13529be5c6e","519119f1deac45ff9ab4f13529be5c6e",22886652,1,0,1,1730,463,463,0
"519119f1deac45ff9ab4f13529be5c6e","f67fbf45a5f146ed866965bc57c7c001",22886652,1,-9,0,1731,463,454,-9
"f67fbf45a5f146ed866965bc57c7c001","c5df9f40ec14463b9dcfdc73df3e9285",22886652,1,12,0,1732,454,464,10
"c5df9f40ec14463b9dcfdc73df3e9285","c5df9f40ec14463b9dcfdc73df3e9285",22886652,1,0,1,1733,464,464,0
"c5df9f40ec14463b9dcfdc73df3e9285","83d42d95cd844fc093fc09cee250edb8",22886652,2,3,0,1734,464,465,1
"83d42d95cd844fc093fc09cee250edb8","c5df9f40ec14463b9dcfdc73df3e9285",22886652,1,-3,0,1735,465,464,-1
"83d42d95cd844fc093fc09cee250edb8","83d42d95cd844fc093fc09cee250edb8",22886652,1,0,1,1737,465,465,0
"83d42d95cd844fc093fc09cee250edb8","f67fbf45a5f146ed866965bc57c7c001",22886652,1,-15,0,1738,465,454,-11
"f67fbf45a5f146ed866965bc57c7c001","b2f0d654738f48158edff28e8d3a546e",22886652,1,-8,0,1739,454,449,-5
"67a089198fcb4e1c8f2385786c2b296f","e2911e79efc2420eac45d9f671463d4b",22887498,1,-69,0,1,39,2,-37
"e2911e79efc2420eac45d9f671463d4b","b613861cecf84ffcab01afb23f660475",22887498,1,-3,0,3,2,1,-1
"b613861cecf84ffcab01afb23f660475","b613861cecf84ffcab01afb23f660475",22887498,4,0,1,4,1,1,0
"b613861cecf84ffcab01afb23f660475","e2911e79efc2420eac45d9f671463d4b",22887498,1,3,0,8,1,2,1
"e2911e79efc2420eac45d9f671463d4b","e2911e79efc2420eac45d9f671463d4b",22887498,3,0,1,10,2,2,0
"e2911e79efc2420eac45d9f671463d4b","519d1b8c59404d67b54e96c5c8a830b2",22887498,1,1,0,11,2,3,1
"519d1b8c59404d67b54e96c5c8a830b2","519d1b8c59404d67b54e96c5c8a830b2",22887498,1,0,1,12,3,3,0
"519d1b8c59404d67b54e96c5c8a830b2","531db53f81f646edb0cdcfe0085b03b7",22887498,1,1,0,13,3,4,1
"531db53f81f646edb0cdcfe0085b03b7","531db53f81f646edb0cdcfe0085b03b7",22887498,1,0,1,14,4,4,0
"531db53f81f646edb0cdcfe0085b03b7","4f5f94b2f95141e0a9d53a61da2276da",22887498,1,1,0,15,4,5,1
"4f5f94b2f95141e0a9d53a61da2276da","4f5f94b2f95141e0a9d53a61da2276da",22887498,1,0,1,16,5,5,0
"4f5f94b2f95141e0a9d53a61da2276da","6d541c89590949f99af293c4f2333f67",22887498,1,1,0,17,5,6,1
"6d541c89590949f99af293c4f2333f67","6d541c89590949f99af293c4f2333f67",22887498,1,0,1,18,6,6,0
"6d541c89590949f99af293c4f2333f67","dd5cf0b9fe4c4f1d8f5ff8e4c04879cb",22887498,1,1,0,19,6,7,1
"dd5cf0b9fe4c4f1d8f5ff8e4c04879cb","dd5cf0b9fe4c4f1d8f5ff8e4c04879cb",22887498,1,0,1,20,7,7,0
"dd5cf0b9fe4c4f1d8f5ff8e4c04879cb","f96261861edc426abe2248be4f0a709a",22887498,1,1,0,21,7,8,1
"f96261861edc426abe2248be4f0a709a","f96261861edc426abe2248be4f0a709a",22887498,1,0,1,22,8,8,0
"f96261861edc426abe2248be4f0a709a","66b5e16f4f75454fb5b8172079f0fa83",22887498,1,1,0,23,8,9,1
"66b5e16f4f75454fb5b8172079f0fa83","66b5e16f4f75454fb5b8172079f0fa83",22887498,1,0,1,24,9,9,0
"66b5e16f4f75454fb5b8172079f0fa83","0680571d4698477995e41842c36a54b2",22887498,1,1,0,25,9,10,1
"0680571d4698477995e41842c36a54b2","0680571d4698477995e41842c36a54b2",22887498,1,0,1,26,10,10,0
"0680571d4698477995e41842c36a54b2","9112f2bffece48e08c6d2287be204085",22887498,1,1,0,27,10,11,1
"9112f2bffece48e08c6d2287be204085","9112f2bffece48e08c6d2287be204085",22887498,1,0,1,28,11,11,0
"9112f2bffece48e08c6d2287be204085","56586aa865414f538729c7f7735d2bc6",22887498,1,3,0,29,11,12,1
"56586aa865414f538729c7f7735d2bc6","e2911e79efc2420eac45d9f671463d4b",22887498,1,-12,0,30,12,2,-10
"e2911e79efc2420eac45d9f671463d4b","56586aa865414f538729c7f7735d2bc6",22887498,1,12,0,31,2,12,10
"56586aa865414f538729c7f7735d2bc6","67a089198fcb4e1c8f2385786c2b296f",22887498,1,57,0,32,12,39,27
"67a089198fcb4e1c8f2385786c2b296f","0e37b720d23b4e7f8b313e79313fd107",22887498,1,7,0,37,39,44,5
"0e37b720d23b4e7f8b313e79313fd107","0e37b720d23b4e7f8b313e79313fd107",22887498,2,0,1,38,44,44,0
"0e37b720d23b4e7f8b313e79313fd107","6875d67fdd5f48168b62719df449bebd",22887498,1,1,0,40,44,45,1
"6875d67fdd5f48168b62719df449bebd","6875d67fdd5f48168b62719df449bebd",22887498,2,0,1,41,45,45,0
"6875d67fdd5f48168b62719df449bebd","6e13d61a7bdb44bca949c9f86fab3be5",22887498,1,3,0,43,45,47,2
"6e13d61a7bdb44bca949c9f86fab3be5","195f78799f984cc2b06c48dfe36be751",22887498,1,2,0,46,47,49,2
"195f78799f984cc2b06c48dfe36be751","195f78799f984cc2b06c48dfe36be751",22887498,2,0,1,47,49,49,0
"195f78799f984cc2b06c48dfe36be751","d0c74f735e024943943e40333d6d337f",22887498,1,3,0,49,49,51,2
"d0c74f735e024943943e40333d6d337f","d9c8d8c444a64dadbbb508652c721e17",22887498,1,-6,0,50,51,46,-5
"d0c74f735e024943943e40333d6d337f","983f8ff320594b279a7f4a6fe132f9c5",22887498,1,2,0,52,51,53,2
"983f8ff320594b279a7f4a6fe132f9c5","983f8ff320594b279a7f4a6fe132f9c5",22887498,2,0,1,53,53,53,0
"983f8ff320594b279a7f4a6fe132f9c5","35adfa5d923046aebabfefd98f35ff05",22887498,1,1,0,55,53,54,1
"35adfa5d923046aebabfefd98f35ff05","35adfa5d923046aebabfefd98f35ff05",22887498,5,0,1,56,54,54,0
"35adfa5d923046aebabfefd98f35ff05","b6f8a98476224da1b40e555ececc7ed8",22887498,1,1,0,61,54,55,1
"b6f8a98476224da1b40e555ececc7ed8","b6f8a98476224da1b40e555ececc7ed8",22887498,2,0,1,62,55,55,0
"b6f8a98476224da1b40e555ececc7ed8","86e22cb5fe0e4b47a9489ecddf7ed78f",22887498,1,1,0,64,55,56,1
"86e22cb5fe0e4b47a9489ecddf7ed78f","86e22cb5fe0e4b47a9489ecddf7ed78f",22887498,2,0,1,65,56,56,0
"86e22cb5fe0e4b47a9489ecddf7ed78f","f924752d8a1149668870b1e7698486f7",22887498,1,-6,0,67,56,50,-6
"f924752d8a1149668870b1e7698486f7","a1f2f12debe5432fb7a70bcd12bacfb9",22887498,1,9,0,68,50,58,8
"a1f2f12debe5432fb7a70bcd12bacfb9","78f30e4dcac84e3cbea8b2cc6e0d62b3",22887498,2,1,0,69,58,59,1
"78f30e4dcac84e3cbea8b2cc6e0d62b3","a1f2f12debe5432fb7a70bcd12bacfb9",22887498,1,-1,0,70,59,58,-1
"a1f2f12debe5432fb7a70bcd12bacfb9","a1f2f12debe5432fb7a70bcd12bacfb9",22887498,9,0,1,71,58,58,0
"78f30e4dcac84e3cbea8b2cc6e0d62b3","78f30e4dcac84e3cbea8b2cc6e0d62b3",22887498,11,0,1,81,59,59,0
"78f30e4dcac84e3cbea8b2cc6e0d62b3","bc42d26810654ea9a1df1efe1e58c7d5",22887498,1,5,0,92,59,63,4
"a0a418b8540d479fa6e0f653b701da8b","12aa6e1672ac4e7aa6449a7a8609cd72",22887498,1,-8,0,94,64,57,-7
"12aa6e1672ac4e7aa6449a7a8609cd72","4c943503763e4e349906eea3ed3c8e86",22887498,1,5,0,95,57,61,4
"4c943503763e4e349906eea3ed3c8e86","4c943503763e4e349906eea3ed3c8e86",22887498,1,0,1,96,61,61,0
"4c943503763e4e349906eea3ed3c8e86","bc42d26810654ea9a1df1efe1e58c7d5",22887498,1,2,0,97,61,63,2
"bc42d26810654ea9a1df1efe1e58c7d5","bc42d26810654ea9a1df1efe1e58c7d5",22887498,3,0,1,100,63,63,0
"bc42d26810654ea9a1df1efe1e58c7d5","a0a418b8540d479fa6e0f653b701da8b",22887498,2,1,0,101,63,64,1
"a0a418b8540d479fa6e0f653b701da8b","a0a418b8540d479fa6e0f653b701da8b",22887498,3,0,1,102,64,64,0
"a0a418b8540d479fa6e0f653b701da8b","309ccf3cc4fe429d9bfbaef53d3fa479",22887498,1,-4,0,105,64,60,-4
"309ccf3cc4fe429d9bfbaef53d3fa479","b534b89233134e30a9b5645138bfa9ee",22887498,1,-23,0,106,60,41,-19
"b534b89233134e30a9b5645138bfa9ee","d646286c8051419bbc2e31dd1db55ca8",22887498,1,33,0,107,41,67,26
"d646286c8051419bbc2e31dd1db55ca8","267f883678b24aed855fde42524975d9",22887498,1,4,0,108,67,71,4
"267f883678b24aed855fde42524975d9","267f883678b24aed855fde42524975d9",22887498,1,0,1,109,71,71,0
"267f883678b24aed855fde42524975d9","88fff56d0342490dbef9040750a20f6c",22887498,1,1,0,110,71,72,1
"88fff56d0342490dbef9040750a20f6c","88fff56d0342490dbef9040750a20f6c",22887498,1,0,1,111,72,72,0
"88fff56d0342490dbef9040750a20f6c","adb17b12b66c4a49a85fd34322f7df70",22887498,1,1,0,112,72,73,1
"adb17b12b66c4a49a85fd34322f7df70","adb17b12b66c4a49a85fd34322f7df70",22887498,1,0,1,113,73,73,0
"adb17b12b66c4a49a85fd34322f7df70","d646286c8051419bbc2e31dd1db55ca8",22887498,1,-6,0,114,73,67,-6
"d646286c8051419bbc2e31dd1db55ca8","a2becd407db34b189200a32546d9d569",22887498,1,9,0,115,67,75,8
"a2becd407db34b189200a32546d9d569","a2becd407db34b189200a32546d9d569",22887498,1,0,1,116,75,75,0
"a2becd407db34b189200a32546d9d569","58c22b011d0f4c2ea6d13615edbb9eeb",22887498,1,2,0,117,75,77,2
"58c22b011d0f4c2ea6d13615edbb9eeb","58c22b011d0f4c2ea6d13615edbb9eeb",22887498,2,0,1,118,77,77,0
"58c22b011d0f4c2ea6d13615edbb9eeb","dd76e1861dc9461c830888729d091ee0",22887498,1,1,0,120,77,78,1
"dd76e1861dc9461c830888729d091ee0","dd76e1861dc9461c830888729d091ee0",22887498,5,0,1,121,78,78,0
"dd76e1861dc9461c830888729d091ee0","cd1d828f1a694b87913a7ea66c23803e",22887498,1,1,0,126,78,79,1
"cd1d828f1a694b87913a7ea66c23803e","cd1d828f1a694b87913a7ea66c23803e",22887498,2,0,1,127,79,79,0
"cd1d828f1a694b87913a7ea66c23803e","9176a3c2b4d2465fa8b0c67096c2a97e",22887498,1,1,0,129,79,80,1
"9176a3c2b4d2465fa8b0c67096c2a97e","9176a3c2b4d2465fa8b0c67096c2a97e",22887498,5,0,1,130,80,80,0
"9176a3c2b4d2465fa8b0c67096c2a97e","f8ec6445f7194e25b9101d4fbcb07a18",22887498,1,1,0,135,80,81,1
"f8ec6445f7194e25b9101d4fbcb07a18","f8ec6445f7194e25b9101d4fbcb07a18",22887498,2,0,1,136,81,81,0
"f8ec6445f7194e25b9101d4fbcb07a18","140d5b27b8574befad82c0a013b59dfa",22887498,1,-7,0,138,81,74,-7
"140d5b27b8574befad82c0a013b59dfa","d18a9ea32855445f8736581f5cb119ce",22887498,1,9,0,139,74,82,8
"d18a9ea32855445f8736581f5cb119ce","f564483cbd7a407681aa2fcca518cf5f",22887498,1,4,0,140,82,85,3
"f564483cbd7a407681aa2fcca518cf5f","f564483cbd7a407681aa2fcca518cf5f",22887498,1,0,1,141,85,85,0
"f564483cbd7a407681aa2fcca518cf5f","18fd01350bd5434ca636d59a599d768a",22887498,1,1,0,142,85,86,1
"18fd01350bd5434ca636d59a599d768a","18fd01350bd5434ca636d59a599d768a",22887498,9,0,1,143,86,86,0
"18fd01350bd5434ca636d59a599d768a","ae5ac430ea254e708a6f5deaaf7464ae",22887498,1,-2,0,152,86,84,-2
"ae5ac430ea254e708a6f5deaaf7464ae","6a9f0ef185fb47f0937e29daa1c71ed5",22887498,1,7,0,153,84,90,6
"6a9f0ef185fb47f0937e29daa1c71ed5","c681290961c94c4caf23b529d1ae6b9a",22887498,1,-2,0,154,90,88,-2
"c681290961c94c4caf23b529d1ae6b9a","c681290961c94c4caf23b529d1ae6b9a",22887498,1,0,1,155,88,88,0
"c681290961c94c4caf23b529d1ae6b9a","6a9f0ef185fb47f0937e29daa1c71ed5",22887498,1,2,0,156,88,90,2
"e20db35ced8544ddac5bc3839145e463","1febb706d7a34005ae8711ed49c76e64",22887498,1,3,0,162,91,94,3
"1febb706d7a34005ae8711ed49c76e64","1febb706d7a34005ae8711ed49c76e64",22887498,2,0,1,163,94,94,0
"1febb706d7a34005ae8711ed49c76e64","8f73ba6f5a0042f2850356ac38ac6f24",22887498,1,1,0,165,94,95,1
"8f73ba6f5a0042f2850356ac38ac6f24","8f73ba6f5a0042f2850356ac38ac6f24",22887498,5,0,1,166,95,95,0
"8f73ba6f5a0042f2850356ac38ac6f24","e2260b86653c46d7b14a41fb419dbf8c",22887498,1,1,0,171,95,96,1
"e2260b86653c46d7b14a41fb419dbf8c","e2260b86653c46d7b14a41fb419dbf8c",22887498,2,0,1,172,96,96,0
"e2260b86653c46d7b14a41fb419dbf8c","35eb641ad1d845bbba54915bce75a962",22887498,1,1,0,174,96,97,1
"35eb641ad1d845bbba54915bce75a962","35eb641ad1d845bbba54915bce75a962",22887498,5,0,1,175,97,97,0
"35eb641ad1d845bbba54915bce75a962","08be90ffbeea4795a138cd42ed8db56f",22887498,1,1,0,180,97,98,1
"08be90ffbeea4795a138cd42ed8db56f","08be90ffbeea4795a138cd42ed8db56f",22887498,5,0,1,181,98,98,0
"08be90ffbeea4795a138cd42ed8db56f","3007433c8f584dcbb5ac159c1c5f2be3",22887498,1,1,0,186,98,99,1
"3007433c8f584dcbb5ac159c1c5f2be3","3007433c8f584dcbb5ac159c1c5f2be3",22887498,2,0,1,187,99,99,0
"3007433c8f584dcbb5ac159c1c5f2be3","e20db35ced8544ddac5bc3839145e463",22887498,1,-8,0,189,99,91,-8
"d391c8b6e56a43a7b654e9dee02d904b","00ae5f0c51874a73a41ebea838d95682",22887498,1,-2,0,192,103,101,-2
"d391c8b6e56a43a7b654e9dee02d904b","d391c8b6e56a43a7b654e9dee02d904b",22887498,16,0,1,194,103,103,0
"d391c8b6e56a43a7b654e9dee02d904b","6111116566fc4fd9abba409322bea245",22887498,1,1,0,210,103,104,1
"6111116566fc4fd9abba409322bea245","6111116566fc4fd9abba409322bea245",22887498,2,0,1,211,104,104,0
"6111116566fc4fd9abba409322bea245","a81b2235cb9c499eb9ea8ee0a8dd9725",22887498,1,1,0,213,104,105,1
"a81b2235cb9c499eb9ea8ee0a8dd9725","a81b2235cb9c499eb9ea8ee0a8dd9725",22887498,5,0,1,214,105,105,0
"a81b2235cb9c499eb9ea8ee0a8dd9725","2d4e0ab0ef3b4d73b82c72d4621a7579",22887498,1,1,0,219,105,106,1
"2d4e0ab0ef3b4d73b82c72d4621a7579","2d4e0ab0ef3b4d73b82c72d4621a7579",22887498,2,0,1,220,106,106,0
"2d4e0ab0ef3b4d73b82c72d4621a7579","8bdebf492ebd4e62b0d522e8ab5e5197",22887498,1,1,0,222,106,107,1
"8bdebf492ebd4e62b0d522e8ab5e5197","8bdebf492ebd4e62b0d522e8ab5e5197",22887498,2,0,1,223,107,107,0
"8bdebf492ebd4e62b0d522e8ab5e5197","73039f8c1eb9409cb4caee2cf968001e",22887498,1,-7,0,225,107,100,-7
"08111f75e22d409998cf8b85bd431f0a","e20db35ced8544ddac5bc3839145e463",22887498,1,-19,0,228,108,91,-17
"e20db35ced8544ddac5bc3839145e463","4280927ec4d643238aa49c32f9e06c6c",22887498,1,20,0,229,91,109,18
"4280927ec4d643238aa49c32f9e06c6c","4280927ec4d643238aa49c32f9e06c6c",22887498,1,0,1,230,109,109,0
"4280927ec4d643238aa49c32f9e06c6c","fc44e6a5f7654430af1227838224dceb",22887498,1,2,0,231,109,111,2
"fc44e6a5f7654430af1227838224dceb","fc44e6a5f7654430af1227838224dceb",22887498,2,0,1,232,111,111,0
"fc44e6a5f7654430af1227838224dceb","08111f75e22d409998cf8b85bd431f0a",22887498,1,-3,0,234,111,108,-3
"a9ae0a3c070d455bb4369a8996313336","a9ae0a3c070d455bb4369a8996313336",22887498,1,0,1,236,114,114,0
"a9ae0a3c070d455bb4369a8996313336","71cec822bcff4f30a20e75dc63ef7b65",22887498,1,2,0,237,114,116,2
"71cec822bcff4f30a20e75dc63ef7b65","71cec822bcff4f30a20e75dc63ef7b65",22887498,1,0,1,238,116,116,0
"71cec822bcff4f30a20e75dc63ef7b65","37319e88176d4aefa91d7a9980dbae91",22887498,1,-4,0,239,116,112,-4
"62bff51286ef4f348717a3cf6fe2318f","b1cd0e7dc3ad4a8eb91a4bfdbeb025b0",22887498,1,-2,0,241,120,118,-2
"b1cd0e7dc3ad4a8eb91a4bfdbeb025b0","62bff51286ef4f348717a3cf6fe2318f",22887498,1,2,0,242,118,120,2
"62bff51286ef4f348717a3cf6fe2318f","e20db35ced8544ddac5bc3839145e463",22887498,1,-33,0,246,120,91,-29
"e20db35ced8544ddac5bc3839145e463","779f9ddd1fd14d1e9e69f72219a1fdbd",22887498,1,36,0,247,91,121,30
"779f9ddd1fd14d1e9e69f72219a1fdbd","ae26e6cda8ad4a3f81bd347560d9579f",22887498,1,4,0,248,121,125,4
"ae26e6cda8ad4a3f81bd347560d9579f","ae26e6cda8ad4a3f81bd347560d9579f",22887498,3,0,1,249,125,125,0
"ae26e6cda8ad4a3f81bd347560d9579f","ee48df95832b4374aa273ceb27ec1315",22887498,1,1,0,252,125,126,1
"ee48df95832b4374aa273ceb27ec1315","ee48df95832b4374aa273ceb27ec1315",22887498,1,0,1,253,126,126,0
"ee48df95832b4374aa273ceb27ec1315","7a439da90b394756ad1777fc4c6dead5",22887498,1,1,0,254,126,127,1
"7a439da90b394756ad1777fc4c6dead5","7a439da90b394756ad1777fc4c6dead5",22887498,1,0,1,255,127,127,0
"7a439da90b394756ad1777fc4c6dead5","779f9ddd1fd14d1e9e69f72219a1fdbd",22887498,1,-6,0,256,127,121,-6
"779f9ddd1fd14d1e9e69f72219a1fdbd","a8dd5213034441ac92724b4e83eb0bb2",22887498,1,9,0,257,121,129,8
"a8dd5213034441ac92724b4e83eb0bb2","a8dd5213034441ac92724b4e83eb0bb2",22887498,1,0,1,258,129,129,0
"a8dd5213034441ac92724b4e83eb0bb2","8115eab6556b45f5b415c3b8c26a12e5",22887498,1,2,0,259,129,131,2
"8115eab6556b45f5b415c3b8c26a12e5","8115eab6556b45f5b415c3b8c26a12e5",22887498,2,0,1,260,131,131,0
"8115eab6556b45f5b415c3b8c26a12e5","ec34b06efd844b46a4c4818ecdb9b8f4",22887498,1,1,0,262,131,132,1
"ec34b06efd844b46a4c4818ecdb9b8f4","ec34b06efd844b46a4c4818ecdb9b8f4",22887498,9,0,1,263,132,132,0
"ec34b06efd844b46a4c4818ecdb9b8f4","c2e1c2b9eac64109b343a088584b576b",22887498,1,1,0,272,132,133,1
"c2e1c2b9eac64109b343a088584b576b","c2e1c2b9eac64109b343a088584b576b",22887498,5,0,1,273,133,133,0
"c2e1c2b9eac64109b343a088584b576b","579338175e0b4bbb8ef3b712b5d8b54e",22887498,1,-5,0,278,133,128,-5
"579338175e0b4bbb8ef3b712b5d8b54e","8bc5795d6a984a3eace4e2811e52dd4f",22887498,1,8,0,279,128,135,7
"8bc5795d6a984a3eace4e2811e52dd4f","8bc5795d6a984a3eace4e2811e52dd4f",22887498,1,0,1,280,135,135,0
"8bc5795d6a984a3eace4e2811e52dd4f","b416d47c56a742199b5d7c7f19d6503a",22887498,1,-1,0,281,135,134,-1
"b416d47c56a742199b5d7c7f19d6503a","cd4532ad48034873ba8bce2aac0c9808",22887498,1,4,0,282,134,137,3
"cd4532ad48034873ba8bce2aac0c9808","cd4532ad48034873ba8bce2aac0c9808",22887498,1,0,1,283,137,137,0
"cd4532ad48034873ba8bce2aac0c9808","df1de691dafe4549a18a4398ee9dfaf9",22887498,1,4,0,284,137,139,2
"df1de691dafe4549a18a4398ee9dfaf9","779f9ddd1fd14d1e9e69f72219a1fdbd",22887498,1,-23,0,285,139,121,-18
"779f9ddd1fd14d1e9e69f72219a1fdbd","6c5ad271a44743479bfaea29b1db8d02",22887498,1,27,0,286,121,143,22
"6c5ad271a44743479bfaea29b1db8d02","6c5ad271a44743479bfaea29b1db8d02",22887498,1,0,1,287,143,143,0
"6c5ad271a44743479bfaea29b1db8d02","83d311bed5374fee83d8d67a7d9d82dc",22887498,1,1,0,288,143,144,1
"83d311bed5374fee83d8d67a7d9d82dc","83d311bed5374fee83d8d67a7d9d82dc",22887498,1,0,1,289,144,144,0
"83d311bed5374fee83d8d67a7d9d82dc","402bba41861d43acb52a5abb89e8831e",22887498,1,1,0,290,144,145,1
"402bba41861d43acb52a5abb89e8831e","402bba41861d43acb52a5abb89e8831e",22887498,2,0,1,291,145,145,0
"402bba41861d43acb52a5abb89e8831e","8aae34f5ddbb4052a709b12e6b0d40fa",22887498,1,3,0,293,145,147,2
"8aae34f5ddbb4052a709b12e6b0d40fa","645b3f0249f64f76af2e19eb4d0e55b7",22887498,1,2,0,296,147,149,2
"645b3f0249f64f76af2e19eb4d0e55b7","645b3f0249f64f76af2e19eb4d0e55b7",22887498,8,0,1,297,149,149,0
"645b3f0249f64f76af2e19eb4d0e55b7","7e7b8db5064d4369805ab370aac5ddfb",22887498,1,1,0,305,149,150,1
"7e7b8db5064d4369805ab370aac5ddfb","7e7b8db5064d4369805ab370aac5ddfb",22887498,2,0,1,306,150,150,0
"7e7b8db5064d4369805ab370aac5ddfb","8956d210ae7f41968fada86d4c979d6a",22887498,1,1,0,308,150,151,1
"8956d210ae7f41968fada86d4c979d6a","8956d210ae7f41968fada86d4c979d6a",22887498,2,0,1,309,151,151,0
"8956d210ae7f41968fada86d4c979d6a","f902b0f41b544d4dbf79664fd233648d",22887498,1,-5,0,311,151,146,-5
"f902b0f41b544d4dbf79664fd233648d","f902b0f41b544d4dbf79664fd233648d",22887498,1,0,1,312,146,146,0
"f902b0f41b544d4dbf79664fd233648d","df1de691dafe4549a18a4398ee9dfaf9",22887498,1,-8,0,313,146,139,-7
"8aae34f5ddbb4052a709b12e6b0d40fa","f902b0f41b544d4dbf79664fd233648d",22887498,1,-1,0,315,147,146,-1
"f902b0f41b544d4dbf79664fd233648d","f03480cf4eba413194d7af52fc0e7f28",22887498,1,7,0,316,146,152,6
"f03480cf4eba413194d7af52fc0e7f28","ae781e8b775e4ccd93bc800dad5c8376",22887498,1,1,0,317,152,153,1
"ae781e8b775e4ccd93bc800dad5c8376","ae781e8b775e4ccd93bc800dad5c8376",22887498,2,0,1,318,153,153,0
"ae781e8b775e4ccd93bc800dad5c8376","06882a8492d9499aa31555567f575ecb",22887498,1,1,0,320,153,154,1
"06882a8492d9499aa31555567f575ecb","06882a8492d9499aa31555567f575ecb",22887498,2,0,1,321,154,154,0
"06882a8492d9499aa31555567f575ecb","f293c508f409466a8f27ddd7d1e40b20",22887498,1,1,0,323,154,155,1
"f293c508f409466a8f27ddd7d1e40b20","f293c508f409466a8f27ddd7d1e40b20",22887498,2,0,1,324,155,155,0
"f293c508f409466a8f27ddd7d1e40b20","cc4ddef5bbbe48ebb605141b347c4ed1",22887498,1,1,0,326,155,156,1
"cc4ddef5bbbe48ebb605141b347c4ed1","cc4ddef5bbbe48ebb605141b347c4ed1",22887498,1,0,1,327,156,156,0
"cc4ddef5bbbe48ebb605141b347c4ed1","d313cec988a84645bee413e8d4724a4b",22887498,1,3,0,328,156,158,2
"d313cec988a84645bee413e8d4724a4b","f03480cf4eba413194d7af52fc0e7f28",22887498,1,-7,0,329,158,152,-6
"f03480cf4eba413194d7af52fc0e7f28","d313cec988a84645bee413e8d4724a4b",22887498,1,7,0,330,152,158,6
"d313cec988a84645bee413e8d4724a4b","d313cec988a84645bee413e8d4724a4b",22887498,3,0,1,331,158,158,0
"d313cec988a84645bee413e8d4724a4b","dc60696c76a74368a60f72246e47700d",22887498,1,1,0,334,158,159,1
"dc60696c76a74368a60f72246e47700d","dc60696c76a74368a60f72246e47700d",22887498,1,0,1,335,159,159,0
"dc60696c76a74368a60f72246e47700d","78adeee1fa2c4fe0bc73f7bca9fcee86",22887498,1,3,0,336,159,160,1
"78adeee1fa2c4fe0bc73f7bca9fcee86","df1de691dafe4549a18a4398ee9dfaf9",22887498,1,-26,0,337,160,139,-21
"df1de691dafe4549a18a4398ee9dfaf9","78adeee1fa2c4fe0bc73f7bca9fcee86",22887498,1,26,0,338,139,160,21
"78adeee1fa2c4fe0bc73f7bca9fcee86","78adeee1fa2c4fe0bc73f7bca9fcee86",22887498,3,0,1,339,160,160,0
"78adeee1fa2c4fe0bc73f7bca9fcee86","65202579580f4ad38d734b4ee39d22a8",22887498,3,5,0,341,160,164,4
"65202579580f4ad38d734b4ee39d22a8","65202579580f4ad38d734b4ee39d22a8",22887498,62,0,1,342,164,164,0
"65202579580f4ad38d734b4ee39d22a8","78adeee1fa2c4fe0bc73f7bca9fcee86",22887498,2,-5,0,344,164,160,-4
"78adeee1fa2c4fe0bc73f7bca9fcee86","3cbcea2be0984e7dbd5a48195af10ce7",22887498,1,8,0,399,160,165,5
"3cbcea2be0984e7dbd5a48195af10ce7","3cbcea2be0984e7dbd5a48195af10ce7",22887498,2,0,1,400,165,165,0
"82e6285962b8400d9d6fc32436022a94","3cbcea2be0984e7dbd5a48195af10ce7",22887498,2,-2,0,406,167,165,-2
"a9ac840f098c4bd0a2ee896214ce29cd","0c7262dff33c4087bc660ccf40f92f9c",22887498,2,4,0,408,168,169,1
"0c7262dff33c4087bc660ccf40f92f9c","a9ac840f098c4bd0a2ee896214ce29cd",22887498,1,-4,0,409,169,168,-1
"a9ac840f098c4bd0a2ee896214ce29cd","b2275c3fad834f8d90737a2d9a6927d6",22887498,1,7,0,410,168,172,4
"b2275c3fad834f8d90737a2d9a6927d6","78adeee1fa2c4fe0bc73f7bca9fcee86",22887498,1,-20,0,411,172,160,-12
"65202579580f4ad38d734b4ee39d22a8","3cbcea2be0984e7dbd5a48195af10ce7",22887498,1,3,0,422,164,165,1
"3cbcea2be0984e7dbd5a48195af10ce7","78adeee1fa2c4fe0bc73f7bca9fcee86",22887498,1,-8,0,423,165,160,-5
"78adeee1fa2c4fe0bc73f7bca9fcee86","82e6285962b8400d9d6fc32436022a94",22887498,1,10,0,424,160,167,7
"0c7262dff33c4087bc660ccf40f92f9c","b2275c3fad834f8d90737a2d9a6927d6",22887498,1,3,0,428,169,172,3
"b2275c3fad834f8d90737a2d9a6927d6","b2275c3fad834f8d90737a2d9a6927d6",22887498,24,0,1,429,172,172,0
"b2275c3fad834f8d90737a2d9a6927d6","eb515a26030b41f8a82a1e6114420bad",22887498,1,1,0,453,172,173,1
"eb515a26030b41f8a82a1e6114420bad","eb515a26030b41f8a82a1e6114420bad",22887498,2,0,1,454,173,173,0
"eb515a26030b41f8a82a1e6114420bad","b42cc17b7de840f181a704558d0bc845",22887498,1,3,0,456,173,175,2
"b42cc17b7de840f181a704558d0bc845","0c7262dff33c4087bc660ccf40f92f9c",22887498,1,-7,0,457,175,169,-6
"0c7262dff33c4087bc660ccf40f92f9c","b42cc17b7de840f181a704558d0bc845",22887498,1,7,0,458,169,175,6
"b42cc17b7de840f181a704558d0bc845","801f9e9135034f49bf5f8b4bdefedb41",22887498,1,2,0,459,175,177,2
"801f9e9135034f49bf5f8b4bdefedb41","801f9e9135034f49bf5f8b4bdefedb41",22887498,8,0,1,460,177,177,0
"801f9e9135034f49bf5f8b4bdefedb41","362fcb0699a14845ab29b2340093e528",22887498,1,-3,0,468,177,174,-3
"362fcb0699a14845ab29b2340093e528","ea38cc0e6e6e41edbabf210220808bf9",22887498,1,6,0,469,174,179,5
"ea38cc0e6e6e41edbabf210220808bf9","b87c552dd247427abe6ab5795b9c9d43",22887498,2,2,0,470,179,181,2
"b87c552dd247427abe6ab5795b9c9d43","ea38cc0e6e6e41edbabf210220808bf9",22887498,1,-2,0,471,181,179,-2
"ea38cc0e6e6e41edbabf210220808bf9","ea38cc0e6e6e41edbabf210220808bf9",22887498,2,0,1,472,179,179,0
"b87c552dd247427abe6ab5795b9c9d43","b87c552dd247427abe6ab5795b9c9d43",22887498,7,0,1,475,181,181,0
"b87c552dd247427abe6ab5795b9c9d43","139b097acfca451689d80c9c6eebdf7b",22887498,1,-3,0,482,181,178,-3
"139b097acfca451689d80c9c6eebdf7b","30f660a1feb34582a739722532524f79",22887498,1,6,0,483,178,183,5
"30f660a1feb34582a739722532524f79","30f660a1feb34582a739722532524f79",22887498,5,0,1,484,183,183,0
"30f660a1feb34582a739722532524f79","2024b4885bd14338a39b7b509acbbd02",22887498,1,-1,0,489,183,182,-1
"2024b4885bd14338a39b7b509acbbd02","c3f63fe50d8e487c86bf8ef76c9cadd3",22887498,1,4,0,490,182,185,3
"c3f63fe50d8e487c86bf8ef76c9cadd3","c3f63fe50d8e487c86bf8ef76c9cadd3",22887498,1,0,1,491,185,185,0
"c3f63fe50d8e487c86bf8ef76c9cadd3","0c7262dff33c4087bc660ccf40f92f9c",22887498,1,-20,0,492,185,169,-16
"0c7262dff33c4087bc660ccf40f92f9c","c8e371568a0c4391b25796ae4e91952e",22887498,1,23,0,493,169,186,17
"c8e371568a0c4391b25796ae4e91952e","7d932b23e1c84326ae5aa4d3c0d813d1",22887498,1,2,0,494,186,188,2
"7d932b23e1c84326ae5aa4d3c0d813d1","7d932b23e1c84326ae5aa4d3c0d813d1",22887498,1,0,1,495,188,188,0
"7d932b23e1c84326ae5aa4d3c0d813d1","c8e371568a0c4391b25796ae4e91952e",22887498,1,-2,0,496,188,186,-2
"c8e371568a0c4391b25796ae4e91952e","ab11d94c6c8948ea90b88f19d2cd502b",22887498,1,5,0,497,186,190,4
"ab11d94c6c8948ea90b88f19d2cd502b","ab11d94c6c8948ea90b88f19d2cd502b",22887498,1,0,1,498,190,190,0
"ab11d94c6c8948ea90b88f19d2cd502b","f992451ed6ad4e68bb9e68ad6be7c4be",22887498,1,2,0,499,190,192,2
"f992451ed6ad4e68bb9e68ad6be7c4be","f992451ed6ad4e68bb9e68ad6be7c4be",22887498,1,0,1,500,192,192,0
"f992451ed6ad4e68bb9e68ad6be7c4be","07b44a7a51e94c78b411c753fc39dab0",22887498,1,-3,0,501,192,189,-3
"07b44a7a51e94c78b411c753fc39dab0","6cd2dcaac46847d4a0bc53f296d90375",22887498,1,6,0,502,189,194,5
"6cd2dcaac46847d4a0bc53f296d90375","6cd2dcaac46847d4a0bc53f296d90375",22887498,1,0,1,503,194,194,0
"6cd2dcaac46847d4a0bc53f296d90375","2d2580c9411c4972909db508d6956a58",22887498,1,2,0,504,194,196,2
"2d2580c9411c4972909db508d6956a58","2d2580c9411c4972909db508d6956a58",22887498,5,0,1,505,196,196,0
"2d2580c9411c4972909db508d6956a58","5bddb3d9ed264f3984702f048c7e5340",22887498,1,1,0,510,196,197,1
"5bddb3d9ed264f3984702f048c7e5340","5bddb3d9ed264f3984702f048c7e5340",22887498,2,0,1,511,197,197,0
"5bddb3d9ed264f3984702f048c7e5340","d5e8e2bd12a2466b9d6d90855f0eb079",22887498,1,1,0,513,197,198,1
"d5e8e2bd12a2466b9d6d90855f0eb079","d5e8e2bd12a2466b9d6d90855f0eb079",22887498,2,0,1,514,198,198,0
"d5e8e2bd12a2466b9d6d90855f0eb079","017d7ca8e0394b91aaadc9574df2202c",22887498,1,-5,0,516,198,193,-5
"017d7ca8e0394b91aaadc9574df2202c","54e8e9f0ea3e45c4bf3b8ac799ee31b1",22887498,1,8,0,517,193,200,7
"54e8e9f0ea3e45c4bf3b8ac799ee31b1","54e8e9f0ea3e45c4bf3b8ac799ee31b1",22887498,1,0,1,518,200,200,0
"54e8e9f0ea3e45c4bf3b8ac799ee31b1","c614a00911be4877a075f19315530fb0",22887498,1,1,0,519,200,201,1
"c614a00911be4877a075f19315530fb0","c614a00911be4877a075f19315530fb0",22887498,6,0,1,520,201,201,0
"c614a00911be4877a075f19315530fb0","a6c21bd8b95249c7972820a7a7d76aff",22887498,1,1,0,526,201,202,1
"a6c21bd8b95249c7972820a7a7d76aff","a6c21bd8b95249c7972820a7a7d76aff",22887498,1,0,1,527,202,202,0
"a6c21bd8b95249c7972820a7a7d76aff","bb329d880ab54120adaf203a693bb203",22887498,1,1,0,528,202,203,1
"bb329d880ab54120adaf203a693bb203","bb329d880ab54120adaf203a693bb203",22887498,1,0,1,529,203,203,0
"bb329d880ab54120adaf203a693bb203","f9170dd6bc6442b4acd832747609b09a",22887498,1,-4,0,530,203,199,-4
"f9170dd6bc6442b4acd832747609b09a","334c2344009840079b1d0e1b7ce3d5a7",22887498,1,7,0,531,199,205,6
"334c2344009840079b1d0e1b7ce3d5a7","334c2344009840079b1d0e1b7ce3d5a7",22887498,1,0,1,532,205,205,0
"334c2344009840079b1d0e1b7ce3d5a7","d7f13c8d63ec4e2aa673fbb9cf9c6933",22887498,1,3,0,533,205,206,1
"d7f13c8d63ec4e2aa673fbb9cf9c6933","c8e371568a0c4391b25796ae4e91952e",22887498,1,-26,0,534,206,186,-20
"c8e371568a0c4391b25796ae4e91952e","b9e80f77c3a44349863b19875725c384",22887498,1,27,0,535,186,207,21
"b9e80f77c3a44349863b19875725c384","7108f0e4c2584f1f9c471689ae4c885c",22887498,2,1,0,536,207,208,1
"7108f0e4c2584f1f9c471689ae4c885c","d7f13c8d63ec4e2aa673fbb9cf9c6933",22887498,1,-2,0,537,208,206,-2
"d7f13c8d63ec4e2aa673fbb9cf9c6933","7108f0e4c2584f1f9c471689ae4c885c",22887498,1,2,0,538,206,208,2
"7108f0e4c2584f1f9c471689ae4c885c","b9e80f77c3a44349863b19875725c384",22887498,1,-1,0,539,208,207,-1
"b9e80f77c3a44349863b19875725c384","b9e80f77c3a44349863b19875725c384",22887498,14,0,1,540,207,207,0
"7108f0e4c2584f1f9c471689ae4c885c","7108f0e4c2584f1f9c471689ae4c885c",22887498,31,0,1,555,208,208,0
"7108f0e4c2584f1f9c471689ae4c885c","09400e101c5d4b439cf9a26b03aae558",22887498,1,3,0,586,208,210,2
"09400e101c5d4b439cf9a26b03aae558","d7f13c8d63ec4e2aa673fbb9cf9c6933",22887498,1,-5,0,587,210,206,-4
"d7f13c8d63ec4e2aa673fbb9cf9c6933","09400e101c5d4b439cf9a26b03aae558",22887498,1,5,0,588,206,210,4
"09400e101c5d4b439cf9a26b03aae558","a88efa7e50ce47159810ab553afa6d3a",22887498,1,2,0,589,210,212,2
"a88efa7e50ce47159810ab553afa6d3a","a88efa7e50ce47159810ab553afa6d3a",22887498,5,0,1,590,212,212,0
"a88efa7e50ce47159810ab553afa6d3a","be502a7a43c44bf7b682698de79d9369",22887498,1,3,0,595,212,214,2
"be502a7a43c44bf7b682698de79d9369","a875096404ef4a9984b62d74cda916f9",22887498,1,-6,0,596,214,209,-5
"a875096404ef4a9984b62d74cda916f9","f7fb1952f56b4189b86a9f8b7862d2b8",22887498,1,7,0,597,209,215,6
"f7fb1952f56b4189b86a9f8b7862d2b8","be502a7a43c44bf7b682698de79d9369",22887498,1,-1,0,598,215,214,-1
"be502a7a43c44bf7b682698de79d9369","f7fb1952f56b4189b86a9f8b7862d2b8",22887498,1,1,0,599,214,215,1
"f7fb1952f56b4189b86a9f8b7862d2b8","f7fb1952f56b4189b86a9f8b7862d2b8",22887498,11,0,1,600,215,215,0
"f7fb1952f56b4189b86a9f8b7862d2b8","b860ee85d8bc4a2f97958cfb71be3533",22887498,1,1,0,611,215,216,1
"b860ee85d8bc4a2f97958cfb71be3533","b860ee85d8bc4a2f97958cfb71be3533",22887498,2,0,1,612,216,216,0
"b860ee85d8bc4a2f97958cfb71be3533","363837c182e04711840d896ae1e0339c",22887498,1,3,0,614,216,218,2
"363837c182e04711840d896ae1e0339c","ec341f459285443b8361f7f15638ff08",22887498,1,-6,0,615,218,213,-5
"ec341f459285443b8361f7f15638ff08","363837c182e04711840d896ae1e0339c",22887498,1,6,0,616,213,218,5
"363837c182e04711840d896ae1e0339c","363837c182e04711840d896ae1e0339c",22887498,13,0,1,617,218,218,0
"363837c182e04711840d896ae1e0339c","01b2051f8941460d89945e3b02d1ce78",22887498,1,-1,0,630,218,217,-1
"01b2051f8941460d89945e3b02d1ce78","91125ca626c5470eb145501f8c37f8db",22887498,1,4,0,631,217,220,3
"91125ca626c5470eb145501f8c37f8db","91125ca626c5470eb145501f8c37f8db",22887498,1,0,1,632,220,220,0
"91125ca626c5470eb145501f8c37f8db","d7f13c8d63ec4e2aa673fbb9cf9c6933",22887498,1,-18,0,633,220,206,-14
"d7f13c8d63ec4e2aa673fbb9cf9c6933","1c6721b1f63f4d30ba7746ea8af02a52",22887498,1,21,0,634,206,221,15
"1c6721b1f63f4d30ba7746ea8af02a52","77ecef8eff6b4a2caea7707669bf7475",22887498,2,1,0,635,221,222,1
"77ecef8eff6b4a2caea7707669bf7475","77ecef8eff6b4a2caea7707669bf7475",22887498,12,0,1,636,222,222,0
"77ecef8eff6b4a2caea7707669bf7475","d03cb855c70044cf8c35d9ec0de696e3",22887498,3,3,0,648,222,224,2
"d03cb855c70044cf8c35d9ec0de696e3","1c6721b1f63f4d30ba7746ea8af02a52",22887498,4,-4,0,649,224,221,-3
"1c6721b1f63f4d30ba7746ea8af02a52","8b9ae98743bd4d4a8a87dff1c1244211",22887498,3,7,0,650,221,227,6
"8b9ae98743bd4d4a8a87dff1c1244211","d03cb855c70044cf8c35d9ec0de696e3",22887498,3,-3,0,651,227,224,-3
"d03cb855c70044cf8c35d9ec0de696e3","a49a937d6896486d9a5396654abcf2e1",22887498,1,2,0,652,224,226,2
"a49a937d6896486d9a5396654abcf2e1","a49a937d6896486d9a5396654abcf2e1",22887498,1,0,1,653,226,226,0
"a49a937d6896486d9a5396654abcf2e1","8b9ae98743bd4d4a8a87dff1c1244211",22887498,1,1,0,654,226,227,1
"8b9ae98743bd4d4a8a87dff1c1244211","8b9ae98743bd4d4a8a87dff1c1244211",22887498,34,0,1,655,227,227,0
"d03cb855c70044cf8c35d9ec0de696e3","8b9ae98743bd4d4a8a87dff1c1244211",22887498,1,3,0,689,224,227,3
"8b9ae98743bd4d4a8a87dff1c1244211","f7906d6f59b9489a91d2ef40db5a474d",22887498,1,-4,0,697,227,223,-4
"f7906d6f59b9489a91d2ef40db5a474d","2ab1535aac1346ba8801535bf729ef37",22887498,1,7,0,698,223,229,6
"2ab1535aac1346ba8801535bf729ef37","2ab1535aac1346ba8801535bf729ef37",22887498,2,0,1,699,229,229,0
"2ab1535aac1346ba8801535bf729ef37","a4f40fb48a8542c8949bae1f002cd9bc",22887498,1,2,0,701,229,231,2
"a4f40fb48a8542c8949bae1f002cd9bc","a4f40fb48a8542c8949bae1f002cd9bc",22887498,3,0,1,702,231,231,0
"a4f40fb48a8542c8949bae1f002cd9bc","8972c23e32044edb8a78fa1eed4e5947",22887498,1,1,0,705,231,232,1
"8972c23e32044edb8a78fa1eed4e5947","8972c23e32044edb8a78fa1eed4e5947",22887498,3,0,1,706,232,232,0
"8972c23e32044edb8a78fa1eed4e5947","92feb4a40f8344d38b6f722e42a53295",22887498,1,1,0,709,232,233,1
"92feb4a40f8344d38b6f722e42a53295","92feb4a40f8344d38b6f722e42a53295",22887498,2,0,1,710,233,233,0
"92feb4a40f8344d38b6f722e42a53295","5152833676bf4c6cb317060be10f68db",22887498,1,-5,0,712,233,228,-5
"5152833676bf4c6cb317060be10f68db","ca3e28f290354c08aefe5b0f769604e6",22887498,1,8,0,713,228,235,7
"ca3e28f290354c08aefe5b0f769604e6","ca3e28f290354c08aefe5b0f769604e6",22887498,9,0,1,714,235,235,0
"ca3e28f290354c08aefe5b0f769604e6","79a35eea833e4c2c9d22fc53c3c6445c",22887498,1,1,0,723,235,236,1
"79a35eea833e4c2c9d22fc53c3c6445c","79a35eea833e4c2c9d22fc53c3c6445c",22887498,9,0,1,724,236,236,0
"79a35eea833e4c2c9d22fc53c3c6445c","8f68228b1518449e9615cdafee41a2bd",22887498,1,1,0,733,236,237,1
"8f68228b1518449e9615cdafee41a2bd","8f68228b1518449e9615cdafee41a2bd",22887498,3,0,1,734,237,237,0
"8f68228b1518449e9615cdafee41a2bd","1c6721b1f63f4d30ba7746ea8af02a52",22887498,1,-19,0,736,237,221,-16
"1c6721b1f63f4d30ba7746ea8af02a52","d03cb855c70044cf8c35d9ec0de696e3",22887498,1,4,0,737,221,224,3
"d03cb855c70044cf8c35d9ec0de696e3","77ecef8eff6b4a2caea7707669bf7475",22887498,1,-3,0,738,224,222,-2
"8b9ae98743bd4d4a8a87dff1c1244211","2ab1535aac1346ba8801535bf729ef37",22887498,1,3,0,742,227,229,2
"2ab1535aac1346ba8801535bf729ef37","f7906d6f59b9489a91d2ef40db5a474d",22887498,1,-7,0,743,229,223,-6
"f7906d6f59b9489a91d2ef40db5a474d","5152833676bf4c6cb317060be10f68db",22887498,1,6,0,744,223,228,5
"5152833676bf4c6cb317060be10f68db","8f68228b1518449e9615cdafee41a2bd",22887498,1,10,0,745,228,237,9
"8f68228b1518449e9615cdafee41a2bd","cab89fa5c3ed45a5aa550fc0352d6a42",22887498,1,1,0,747,237,238,1
"cab89fa5c3ed45a5aa550fc0352d6a42","cab89fa5c3ed45a5aa550fc0352d6a42",22887498,5,0,1,748,238,238,0
"cab89fa5c3ed45a5aa550fc0352d6a42","66d4fad4f1cf4b46be0750a99ad7a35a",22887498,1,1,0,753,238,239,1
"66d4fad4f1cf4b46be0750a99ad7a35a","66d4fad4f1cf4b46be0750a99ad7a35a",22887498,1,0,1,754,239,239,0
"66d4fad4f1cf4b46be0750a99ad7a35a","0b04c8e2f86d48c7aeb7e225819cd32b",22887498,1,-5,0,755,239,234,-5
"0b04c8e2f86d48c7aeb7e225819cd32b","f53da5fd9bfe412da4b80d4742563b6c",22887498,1,8,0,756,234,241,7
"f53da5fd9bfe412da4b80d4742563b6c","f53da5fd9bfe412da4b80d4742563b6c",22887498,1,0,1,757,241,241,0
"f53da5fd9bfe412da4b80d4742563b6c","1c6721b1f63f4d30ba7746ea8af02a52",22887498,1,-24,0,758,241,221,-20
"1c6721b1f63f4d30ba7746ea8af02a52","2ae94c0cea4d480a9d5dca8fb1d7b542",22887498,1,27,0,759,221,242,21
"2ae94c0cea4d480a9d5dca8fb1d7b542","1ebf23f9d994469a85206e4c7b1bf5f5",22887498,4,3,0,760,242,245,3
"1ebf23f9d994469a85206e4c7b1bf5f5","2ae94c0cea4d480a9d5dca8fb1d7b542",22887498,2,-3,0,761,245,242,-3
"1ebf23f9d994469a85206e4c7b1bf5f5","1ebf23f9d994469a85206e4c7b1bf5f5",22887498,13,0,1,765,245,245,0
"1ebf23f9d994469a85206e4c7b1bf5f5","85ae675b83e8422da842cfd25596af99",22887498,1,1,0,778,245,246,1
"85ae675b83e8422da842cfd25596af99","85ae675b83e8422da842cfd25596af99",22887498,1,0,1,779,246,246,0
"85ae675b83e8422da842cfd25596af99","2ae94c0cea4d480a9d5dca8fb1d7b542",22887498,1,-4,0,780,246,242,-4
"2ae94c0cea4d480a9d5dca8fb1d7b542","fa235f0f364d47e4ae1c87f47bf8e6ba",22887498,1,12,0,781,242,252,10
"fa235f0f364d47e4ae1c87f47bf8e6ba","79f7845465cc4ed19d8e4f1429541be0",22887498,1,2,0,782,252,254,2
"79f7845465cc4ed19d8e4f1429541be0","79f7845465cc4ed19d8e4f1429541be0",22887498,2,0,1,783,254,254,0
"79f7845465cc4ed19d8e4f1429541be0","00f61990949545828dd12f1303d47504",22887498,1,3,0,785,254,256,2
"00f61990949545828dd12f1303d47504","6e83e23f56544a19b94067c1c558d9c0",22887498,1,-11,0,786,256,247,-9
"6e83e23f56544a19b94067c1c558d9c0","00f61990949545828dd12f1303d47504",22887498,1,11,0,787,247,256,9
"00f61990949545828dd12f1303d47504","ead7bb4b64e247d2ae632ab8a296b091",22887498,1,2,0,788,256,258,2
"ead7bb4b64e247d2ae632ab8a296b091","ead7bb4b64e247d2ae632ab8a296b091",22887498,2,0,1,789,258,258,0
"ead7bb4b64e247d2ae632ab8a296b091","41b0048dde734bb280bac6116baa8e27",22887498,1,1,0,791,258,259,1
"41b0048dde734bb280bac6116baa8e27","41b0048dde734bb280bac6116baa8e27",22887498,2,0,1,792,259,259,0
"41b0048dde734bb280bac6116baa8e27","b41c5a094a604ee0915327da5cc0beb7",22887498,1,1,0,794,259,260,1
"b41c5a094a604ee0915327da5cc0beb7","b41c5a094a604ee0915327da5cc0beb7",22887498,2,0,1,795,260,260,0
"b41c5a094a604ee0915327da5cc0beb7","d546341988904f069cfa86b21457d9d9",22887498,1,-10,0,797,260,251,-9
"d546341988904f069cfa86b21457d9d9","28c171777c52431ab6b925073bd63d46",22887498,1,15,0,798,251,264,13
"28c171777c52431ab6b925073bd63d46","28c171777c52431ab6b925073bd63d46",22887498,3,0,1,799,264,264,0
"28c171777c52431ab6b925073bd63d46","ac160db940cb49ae8579162b1d52bb5d",22887498,1,2,0,802,264,266,2
"ac160db940cb49ae8579162b1d52bb5d","ac160db940cb49ae8579162b1d52bb5d",22887498,7,0,1,803,266,266,0
"ac160db940cb49ae8579162b1d52bb5d","d989ebcfc12a4b669f0100dc1aa14f1e",22887498,1,-12,0,810,266,255,-11
"d989ebcfc12a4b669f0100dc1aa14f1e","c6fd49b485cc4874b0bbdd9c6171e09c",22887498,1,15,0,811,255,268,13
"c6fd49b485cc4874b0bbdd9c6171e09c","c6fd49b485cc4874b0bbdd9c6171e09c",22887498,3,0,1,812,268,268,0
"c6fd49b485cc4874b0bbdd9c6171e09c","44240778a97c4af0937817499b75707b",22887498,1,1,0,815,268,269,1
"44240778a97c4af0937817499b75707b","44240778a97c4af0937817499b75707b",22887498,2,0,1,816,269,269,0
"44240778a97c4af0937817499b75707b","7aa76d3e993840d8805f097cbdbcd44b",22887498,1,-9,0,818,269,261,-8
"7aa76d3e993840d8805f097cbdbcd44b","865a4d3b43374da7944dc7d397f566d9",22887498,1,12,0,819,261,271,10
"865a4d3b43374da7944dc7d397f566d9","865a4d3b43374da7944dc7d397f566d9",22887498,1,0,1,820,271,271,0
"865a4d3b43374da7944dc7d397f566d9","2ae94c0cea4d480a9d5dca8fb1d7b542",22887498,1,-35,0,821,271,242,-29
"2ae94c0cea4d480a9d5dca8fb1d7b542","0d987bed3ffa4ed0b9a2e62e97b7b30f",22887498,1,38,0,822,242,272,30
"0d987bed3ffa4ed0b9a2e62e97b7b30f","0d987bed3ffa4ed0b9a2e62e97b7b30f",22887498,1,0,1,823,272,272,0
"0d987bed3ffa4ed0b9a2e62e97b7b30f","bb5a47f5ea01454a8b79455422d3b9da",22887498,4,10,0,824,272,280,8
"bb5a47f5ea01454a8b79455422d3b9da","bb5a47f5ea01454a8b79455422d3b9da",22887498,80,0,1,825,280,280,0
"bb5a47f5ea01454a8b79455422d3b9da","82ae07bc0c9b4570a41799290d1ef399",22887498,2,-6,0,830,280,275,-5
"82ae07bc0c9b4570a41799290d1ef399","bb5a47f5ea01454a8b79455422d3b9da",22887498,2,6,0,831,275,280,5
"bb5a47f5ea01454a8b79455422d3b9da","0d987bed3ffa4ed0b9a2e62e97b7b30f",22887498,3,-10,0,833,280,272,-8
"bb5a47f5ea01454a8b79455422d3b9da","bc5524e78a8544e2ae2fdc2f3462bbec",22887498,1,-1,0,842,280,279,-1
"bc5524e78a8544e2ae2fdc2f3462bbec","82ae07bc0c9b4570a41799290d1ef399",22887498,1,-5,0,843,279,275,-4
"82ae07bc0c9b4570a41799290d1ef399","0d987bed3ffa4ed0b9a2e62e97b7b30f",22887498,1,-4,0,844,275,272,-3
"0d987bed3ffa4ed0b9a2e62e97b7b30f","94cecc3f1e7d484b8e068e79241dfd73",22887498,2,13,0,907,272,281,9
"94cecc3f1e7d484b8e068e79241dfd73","fab84b4fab5940efb4ea868ef8d09396",22887498,1,5,0,910,281,284,3
"fab84b4fab5940efb4ea868ef8d09396","4a29443515bb404cb8924e1c60a63b73",22887498,1,4,0,911,284,285,1
"4a29443515bb404cb8924e1c60a63b73","fab84b4fab5940efb4ea868ef8d09396",22887498,1,-4,0,912,285,284,-1
"fab84b4fab5940efb4ea868ef8d09396","208c9b2796c944db8dacaa96082520ea",22887498,1,7,0,913,284,288,4
"208c9b2796c944db8dacaa96082520ea","2ae94c0cea4d480a9d5dca8fb1d7b542",22887498,1,-63,0,914,288,242,-46
"1ebf23f9d994469a85206e4c7b1bf5f5","1c6721b1f63f4d30ba7746ea8af02a52",22887498,1,-30,0,916,245,221,-24
"1c6721b1f63f4d30ba7746ea8af02a52","0d987bed3ffa4ed0b9a2e62e97b7b30f",22887498,1,65,0,917,221,272,51
"a37477c4e4c14169ad44b06b493007f6","4a29443515bb404cb8924e1c60a63b73",22887498,1,7,0,931,283,285,2
"4a29443515bb404cb8924e1c60a63b73","4a29443515bb404cb8924e1c60a63b73",22887498,1,0,1,932,285,285,0
"4a29443515bb404cb8924e1c60a63b73","208c9b2796c944db8dacaa96082520ea",22887498,1,3,0,933,285,288,3
"208c9b2796c944db8dacaa96082520ea","208c9b2796c944db8dacaa96082520ea",22887498,1,0,1,934,288,288,0
"208c9b2796c944db8dacaa96082520ea","4a29443515bb404cb8924e1c60a63b73",22887498,1,-3,0,935,288,285,-3
"4a29443515bb404cb8924e1c60a63b73","7669a956527947d0add87455277e80b4",22887498,1,7,0,936,285,291,6
"7669a956527947d0add87455277e80b4","7669a956527947d0add87455277e80b4",22887498,1,0,1,937,291,291,0
"7669a956527947d0add87455277e80b4","6a9a3b5bde4a48daa896fe8c06eca56f",22887498,1,-2,0,938,291,289,-2
"6a9a3b5bde4a48daa896fe8c06eca56f","869e967078f04da18dd0b0b9389a7424",22887498,1,5,0,939,289,293,4
"869e967078f04da18dd0b0b9389a7424","869e967078f04da18dd0b0b9389a7424",22887498,2,0,1,940,293,293,0
"869e967078f04da18dd0b0b9389a7424","51ab6291537748fab90d519aa09889d6",22887498,1,2,0,942,293,295,2
"51ab6291537748fab90d519aa09889d6","51ab6291537748fab90d519aa09889d6",22887498,5,0,1,943,295,295,0
"51ab6291537748fab90d519aa09889d6","34a6e49023fc4465bd5ca604330bbd1c",22887498,1,-3,0,948,295,292,-3
"34a6e49023fc4465bd5ca604330bbd1c","21592f2a9e9c4b2f8c66ec5dbcbf6a2b",22887498,1,5,0,949,292,296,4
"21592f2a9e9c4b2f8c66ec5dbcbf6a2b","ba0e59461bfb4a44b7b1c28a01f8d3b3",22887498,2,4,0,950,296,299,3
"ba0e59461bfb4a44b7b1c28a01f8d3b3","7646a919d7e64fa990bca9b024ff089d",22887498,1,-1,0,951,299,298,-1
"7646a919d7e64fa990bca9b024ff089d","21592f2a9e9c4b2f8c66ec5dbcbf6a2b",22887498,1,-3,0,952,298,296,-2
"ba0e59461bfb4a44b7b1c28a01f8d3b3","ba0e59461bfb4a44b7b1c28a01f8d3b3",22887498,1,0,1,954,299,299,0
"ba0e59461bfb4a44b7b1c28a01f8d3b3","0e0b36e731a645e7b1b8a88f5031ca38",22887498,1,2,0,955,299,301,2
"0e0b36e731a645e7b1b8a88f5031ca38","0e0b36e731a645e7b1b8a88f5031ca38",22887498,2,0,1,956,301,301,0
"0e0b36e731a645e7b1b8a88f5031ca38","a66a144637284c21afc6de17fea4bfb8",22887498,1,1,0,958,301,302,1
"a66a144637284c21afc6de17fea4bfb8","a66a144637284c21afc6de17fea4bfb8",22887498,2,0,1,959,302,302,0
"a66a144637284c21afc6de17fea4bfb8","7646a919d7e64fa990bca9b024ff089d",22887498,1,-4,0,961,302,298,-4
"7646a919d7e64fa990bca9b024ff089d","4a29443515bb404cb8924e1c60a63b73",22887498,1,-17,0,962,298,285,-13
"4a29443515bb404cb8924e1c60a63b73","3434c10e561d488a914e0f7d71907abd",22887498,3,27,0,963,285,305,20
"3434c10e561d488a914e0f7d71907abd","4a29443515bb404cb8924e1c60a63b73",22887498,1,-27,0,966,305,285,-20
"53e7e900392747ccad52e711ab0f80d8","4a29443515bb404cb8924e1c60a63b73",22887498,1,-29,0,969,307,285,-22
"4a29443515bb404cb8924e1c60a63b73","e390b575229748ea8aac9364efe2bf00",22887498,1,24,0,970,285,304,19
"e390b575229748ea8aac9364efe2bf00","e390b575229748ea8aac9364efe2bf00",22887498,1,0,1,971,304,304,0
"e390b575229748ea8aac9364efe2bf00","4a29443515bb404cb8924e1c60a63b73",22887498,1,-24,0,972,304,285,-19
"53e7e900392747ccad52e711ab0f80d8","53e7e900392747ccad52e711ab0f80d8",22887498,1,0,1,975,307,307,0
"53e7e900392747ccad52e711ab0f80d8","130acc2aeb0448fdbb2de63bc5cebe5b",22887498,1,3,0,976,307,309,2
"130acc2aeb0448fdbb2de63bc5cebe5b","3434c10e561d488a914e0f7d71907abd",22887498,1,-5,0,977,309,305,-4
"3434c10e561d488a914e0f7d71907abd","9c062b3251034ebe90f5054e2a3b5120",22887498,1,7,0,978,305,311,6
"9c062b3251034ebe90f5054e2a3b5120","9c062b3251034ebe90f5054e2a3b5120",22887498,2,0,1,979,311,311,0
"9c062b3251034ebe90f5054e2a3b5120","ea859f8207e44537889daeaba13ac2e8",22887498,1,1,0,981,311,312,1
"ea859f8207e44537889daeaba13ac2e8","ea859f8207e44537889daeaba13ac2e8",22887498,1,0,1,982,312,312,0
"ea859f8207e44537889daeaba13ac2e8","56d94971a7a94257aa330183a8ebd0ea",22887498,1,1,0,983,312,313,1
"56d94971a7a94257aa330183a8ebd0ea","56d94971a7a94257aa330183a8ebd0ea",22887498,1,0,1,984,313,313,0
"56d94971a7a94257aa330183a8ebd0ea","141c0df6cd1946539aadd1c9b7068cd4",22887498,1,-5,0,985,313,308,-5
"141c0df6cd1946539aadd1c9b7068cd4","13255e63e0aa4abf85e5211bf613d43e",22887498,1,10,0,986,308,317,9
"13255e63e0aa4abf85e5211bf613d43e","13255e63e0aa4abf85e5211bf613d43e",22887498,1,0,1,987,317,317,0
"13255e63e0aa4abf85e5211bf613d43e","0c787d16c9504873b1a4d903cec09948",22887498,1,-3,0,988,317,314,-3
"86c27d40179e419c8e9d150fb6afa5d0","86c27d40179e419c8e9d150fb6afa5d0",22887498,1,0,1,990,319,319,0
"86c27d40179e419c8e9d150fb6afa5d0","8d7e0b55cf9849cda222a0f2440cec55",22887498,1,-1,0,991,319,318,-1
"47edbb64109243e6b0f8f64cdef90c6c","24f1363179ad4aaa965484a78471912b",22887498,1,-3,0,993,326,323,-3
"24f1363179ad4aaa965484a78471912b","3628bdce1dd2429ba924d2d4d09448d2",22887498,1,-1,0,995,323,322,-1
"3628bdce1dd2429ba924d2d4d09448d2","24f1363179ad4aaa965484a78471912b",22887498,1,1,0,996,322,323,1
"24f1363179ad4aaa965484a78471912b","43ea1b823a4b4e51b7c694c10725db82",22887498,1,5,0,997,323,327,4
"43ea1b823a4b4e51b7c694c10725db82","47edbb64109243e6b0f8f64cdef90c6c",22887498,1,-2,0,998,327,326,-1
"47edbb64109243e6b0f8f64cdef90c6c","3434c10e561d488a914e0f7d71907abd",22887498,1,-25,0,999,326,305,-21
"3434c10e561d488a914e0f7d71907abd","53e7e900392747ccad52e711ab0f80d8",22887498,5,2,0,1000,305,307,2
"53e7e900392747ccad52e711ab0f80d8","3434c10e561d488a914e0f7d71907abd",22887498,3,-2,0,1001,307,305,-2
"3434c10e561d488a914e0f7d71907abd","130acc2aeb0448fdbb2de63bc5cebe5b",22887498,2,5,0,1002,305,309,4
"130acc2aeb0448fdbb2de63bc5cebe5b","141c0df6cd1946539aadd1c9b7068cd4",22887498,2,-1,0,1003,309,308,-1
"141c0df6cd1946539aadd1c9b7068cd4","0c787d16c9504873b1a4d903cec09948",22887498,2,7,0,1004,308,314,6
"0c787d16c9504873b1a4d903cec09948","86c27d40179e419c8e9d150fb6afa5d0",22887498,3,6,0,1005,314,319,5
"86c27d40179e419c8e9d150fb6afa5d0","47edbb64109243e6b0f8f64cdef90c6c",22887498,1,8,0,1006,319,326,7
"47edbb64109243e6b0f8f64cdef90c6c","8d7e0b55cf9849cda222a0f2440cec55",22887498,1,-9,0,1007,326,318,-8
"8d7e0b55cf9849cda222a0f2440cec55","24f1363179ad4aaa965484a78471912b",22887498,1,6,0,1008,318,323,5
"24f1363179ad4aaa965484a78471912b","24f1363179ad4aaa965484a78471912b",22887498,2,0,1,1009,323,323,0
"24f1363179ad4aaa965484a78471912b","3434c10e561d488a914e0f7d71907abd",22887498,1,-22,0,1010,323,305,-18
"86c27d40179e419c8e9d150fb6afa5d0","24f1363179ad4aaa965484a78471912b",22887498,1,5,0,1017,319,323,4
"24f1363179ad4aaa965484a78471912b","8d7e0b55cf9849cda222a0f2440cec55",22887498,1,-6,0,1018,323,318,-5
"8d7e0b55cf9849cda222a0f2440cec55","47edbb64109243e6b0f8f64cdef90c6c",22887498,2,9,0,1019,318,326,8
"47edbb64109243e6b0f8f64cdef90c6c","3628bdce1dd2429ba924d2d4d09448d2",22887498,1,-4,0,1020,326,322,-4
"3628bdce1dd2429ba924d2d4d09448d2","3628bdce1dd2429ba924d2d4d09448d2",22887498,1,0,1,1021,322,322,0
"3628bdce1dd2429ba924d2d4d09448d2","56b3fd1a212a4764be39d979fde3326e",22887498,1,7,0,1022,322,328,6
"56b3fd1a212a4764be39d979fde3326e","56b3fd1a212a4764be39d979fde3326e",22887498,1,0,1,1023,328,328,0
"56b3fd1a212a4764be39d979fde3326e","3434c10e561d488a914e0f7d71907abd",22887498,1,-28,0,1024,328,305,-23
"3434c10e561d488a914e0f7d71907abd","0c4079457ede49e3aeb5e86ed84bdf35",22887498,1,31,0,1025,305,329,24
"0c4079457ede49e3aeb5e86ed84bdf35","38aea304b4fa46e1b29bb72f5cea4c93",22887498,2,2,0,1026,329,331,2
"38aea304b4fa46e1b29bb72f5cea4c93","38aea304b4fa46e1b29bb72f5cea4c93",22887498,1,0,1,1027,331,331,0
"38aea304b4fa46e1b29bb72f5cea4c93","e36d261332f14e79bb4b467aceaeb9b5",22887498,1,2,0,1028,331,333,2
"e36d261332f14e79bb4b467aceaeb9b5","e36d261332f14e79bb4b467aceaeb9b5",22887498,1,0,1,1029,333,333,0
"e36d261332f14e79bb4b467aceaeb9b5","c7e89b9d04744d2eab742fc24e3ef1ae",22887498,1,1,0,1030,333,334,1
"c7e89b9d04744d2eab742fc24e3ef1ae","c7e89b9d04744d2eab742fc24e3ef1ae",22887498,5,0,1,1031,334,334,0
"c7e89b9d04744d2eab742fc24e3ef1ae","fe49f8054b374a0ea4bb266ed135ff62",22887498,1,1,0,1036,334,335,1
"fe49f8054b374a0ea4bb266ed135ff62","fe49f8054b374a0ea4bb266ed135ff62",22887498,2,0,1,1037,335,335,0
"fe49f8054b374a0ea4bb266ed135ff62","d0a8f74af98642fe8360d22c42e45117",22887498,1,1,0,1039,335,336,1
"d0a8f74af98642fe8360d22c42e45117","d0a8f74af98642fe8360d22c42e45117",22887498,2,0,1,1040,336,336,0
"d0a8f74af98642fe8360d22c42e45117","0c4079457ede49e3aeb5e86ed84bdf35",22887498,1,-7,0,1042,336,329,-7
"0c4079457ede49e3aeb5e86ed84bdf35","0c4079457ede49e3aeb5e86ed84bdf35",22887498,2,0,1,1043,329,329,0
"0c4079457ede49e3aeb5e86ed84bdf35","a7c6339ca1da4368a18d471f0519f877",22887498,1,11,0,1044,329,339,10
"a7c6339ca1da4368a18d471f0519f877","a7c6339ca1da4368a18d471f0519f877",22887498,1,0,1,1045,339,339,0
"a7c6339ca1da4368a18d471f0519f877","bbc5139ca9024389a94db3a6f47dcff6",22887498,1,3,0,1046,339,341,2
"bbc5139ca9024389a94db3a6f47dcff6","b8b9418ab322418d9db9b40d96af873a",22887498,1,-5,0,1047,341,337,-4
"b8b9418ab322418d9db9b40d96af873a","0c4079457ede49e3aeb5e86ed84bdf35",22887498,1,-9,0,1048,337,329,-8
"0c4079457ede49e3aeb5e86ed84bdf35","c2490bc612d146edbe786556fab3651b",22887498,1,13,0,1049,329,340,11
"c2490bc612d146edbe786556fab3651b","bbc5139ca9024389a94db3a6f47dcff6",22887498,1,1,0,1050,340,341,1
"bbc5139ca9024389a94db3a6f47dcff6","bbc5139ca9024389a94db3a6f47dcff6",22887498,3,0,1,1051,341,341,0
"bbc5139ca9024389a94db3a6f47dcff6","4ee6ca9019ab4a1ab323f98094a9bd77",22887498,1,2,0,1054,341,343,2
"4ee6ca9019ab4a1ab323f98094a9bd77","4ee6ca9019ab4a1ab323f98094a9bd77",22887498,2,0,1,1055,343,343,0
"4ee6ca9019ab4a1ab323f98094a9bd77","b37947176785476f8b29d49a851366dc",22887498,1,1,0,1057,343,344,1
"b37947176785476f8b29d49a851366dc","b37947176785476f8b29d49a851366dc",22887498,2,0,1,1058,344,344,0
"b37947176785476f8b29d49a851366dc","fcea5b10d5a14a3b9324ffece8f6e1e5",22887498,1,1,0,1060,344,345,1
"fcea5b10d5a14a3b9324ffece8f6e1e5","fcea5b10d5a14a3b9324ffece8f6e1e5",22887498,5,0,1,1061,345,345,0
"fcea5b10d5a14a3b9324ffece8f6e1e5","c2490bc612d146edbe786556fab3651b",22887498,1,-5,0,1066,345,340,-5
"c2490bc612d146edbe786556fab3651b","6ac8bb048b854999a47edb35fe627f11",22887498,1,8,0,1067,340,347,7
"6ac8bb048b854999a47edb35fe627f11","6ac8bb048b854999a47edb35fe627f11",22887498,1,0,1,1068,347,347,0
"6ac8bb048b854999a47edb35fe627f11","0c4079457ede49e3aeb5e86ed84bdf35",22887498,1,-21,0,1069,347,329,-18
"0c4079457ede49e3aeb5e86ed84bdf35","30ead9794d4847abaf222ca966cc8630",22887498,2,24,0,1070,329,348,19
"30ead9794d4847abaf222ca966cc8630","897b7f51242c44aab2205c72fdcbf4cd",22887498,1,4,0,1071,348,352,4
"897b7f51242c44aab2205c72fdcbf4cd","09b9678ddc3d452ea4a3d46e15826065",22887498,6,1,0,1072,352,353,1
"09b9678ddc3d452ea4a3d46e15826065","eff0de7f2dbb42dfa1a2e686efab5b6d",22887498,5,1,0,1073,353,354,1
"eff0de7f2dbb42dfa1a2e686efab5b6d","c20993c944444fe085345591a8bd837e",22887498,1,-3,0,1074,354,351,-3
"c20993c944444fe085345591a8bd837e","c20993c944444fe085345591a8bd837e",22887498,8,0,1,1075,351,351,0
"c20993c944444fe085345591a8bd837e","897b7f51242c44aab2205c72fdcbf4cd",22887498,3,1,0,1079,351,352,1
"897b7f51242c44aab2205c72fdcbf4cd","897b7f51242c44aab2205c72fdcbf4cd",22887498,6,0,1,1080,352,352,0
"09b9678ddc3d452ea4a3d46e15826065","09b9678ddc3d452ea4a3d46e15826065",22887498,6,0,1,1084,353,353,0
"eff0de7f2dbb42dfa1a2e686efab5b6d","eff0de7f2dbb42dfa1a2e686efab5b6d",22887498,7,0,1,1088,354,354,0
"eff0de7f2dbb42dfa1a2e686efab5b6d","2fe14166dc9642c3bc666b86a57f943d",22887498,1,4,0,1091,354,357,3
"2fe14166dc9642c3bc666b86a57f943d","30ead9794d4847abaf222ca966cc8630",22887498,1,-10,0,1092,357,348,-9
"30ead9794d4847abaf222ca966cc8630","2fe14166dc9642c3bc666b86a57f943d",22887498,3,10,0,1093,348,357,9
"2fe14166dc9642c3bc666b86a57f943d","2fe14166dc9642c3bc666b86a57f943d",22887498,1,0,1,1094,357,357,0
"2fe14166dc9642c3bc666b86a57f943d","44421dd1e13a47a388c4a19834b744c7",22887498,1,2,0,1095,357,359,2
"44421dd1e13a47a388c4a19834b744c7","44421dd1e13a47a388c4a19834b744c7",22887498,5,0,1,1096,359,359,0
"44421dd1e13a47a388c4a19834b744c7","cb5fc7ef85d547c4be1a7439d0bf6052",22887498,1,1,0,1101,359,360,1
"cb5fc7ef85d547c4be1a7439d0bf6052","cb5fc7ef85d547c4be1a7439d0bf6052",22887498,2,0,1,1102,360,360,0
"cb5fc7ef85d547c4be1a7439d0bf6052","0a8f150a4cf747acbde62f4721823da3",22887498,1,1,0,1104,360,361,1
"0a8f150a4cf747acbde62f4721823da3","0a8f150a4cf747acbde62f4721823da3",22887498,5,0,1,1105,361,361,0
"0a8f150a4cf747acbde62f4721823da3","ab8fdad974ae471f9f24c3f9dd04462e",22887498,1,1,0,1110,361,362,1
"ab8fdad974ae471f9f24c3f9dd04462e","ab8fdad974ae471f9f24c3f9dd04462e",22887498,2,0,1,1111,362,362,0
"ab8fdad974ae471f9f24c3f9dd04462e","1ba8fef685d74a8194b9db252eb704fb",22887498,1,-7,0,1113,362,355,-7
"1ba8fef685d74a8194b9db252eb704fb","52580888dadb4fe3baa795683ea227bd",22887498,2,10,0,1114,355,364,9
"52580888dadb4fe3baa795683ea227bd","52580888dadb4fe3baa795683ea227bd",22887498,2,0,1,1115,364,364,0
"52580888dadb4fe3baa795683ea227bd","f00179e251a045b39c3f7a54f9aa4acc",22887498,2,-1,0,1116,364,363,-1
"f00179e251a045b39c3f7a54f9aa4acc","492a3bc6a1254f23a7998587961b22a4",22887498,1,4,0,1117,363,366,3
"492a3bc6a1254f23a7998587961b22a4","492a3bc6a1254f23a7998587961b22a4",22887498,2,0,1,1118,366,366,0
"492a3bc6a1254f23a7998587961b22a4","072a190fd302456290895f9f04d6940a",22887498,1,-1,0,1119,366,365,-1
"072a190fd302456290895f9f04d6940a","c76574d21bc14aeea7ecd0b027f39858",22887498,1,3,0,1120,365,367,2
"c76574d21bc14aeea7ecd0b027f39858","492a3bc6a1254f23a7998587961b22a4",22887498,1,-2,0,1121,367,366,-1
"492a3bc6a1254f23a7998587961b22a4","30ead9794d4847abaf222ca966cc8630",22887498,1,-21,0,1123,366,348,-18
"30ead9794d4847abaf222ca966cc8630","0c4079457ede49e3aeb5e86ed84bdf35",22887498,2,-24,0,1124,348,329,-19
"0c4079457ede49e3aeb5e86ed84bdf35","bbc5139ca9024389a94db3a6f47dcff6",22887498,1,14,0,1125,329,341,12
"bbc5139ca9024389a94db3a6f47dcff6","30ead9794d4847abaf222ca966cc8630",22887498,1,10,0,1126,341,348,7
"30ead9794d4847abaf222ca966cc8630","c20993c944444fe085345591a8bd837e",22887498,3,3,0,1127,348,351,3
"c20993c944444fe085345591a8bd837e","09b9678ddc3d452ea4a3d46e15826065",22887498,3,2,0,1129,351,353,2
"09b9678ddc3d452ea4a3d46e15826065","c20993c944444fe085345591a8bd837e",22887498,3,-2,0,1130,353,351,-2
"897b7f51242c44aab2205c72fdcbf4cd","eff0de7f2dbb42dfa1a2e686efab5b6d",22887498,4,2,0,1133,352,354,2
"eff0de7f2dbb42dfa1a2e686efab5b6d","897b7f51242c44aab2205c72fdcbf4cd",22887498,4,-2,0,1134,354,352,-2
"eff0de7f2dbb42dfa1a2e686efab5b6d","30ead9794d4847abaf222ca966cc8630",22887498,2,-6,0,1139,354,348,-6
"2fe14166dc9642c3bc666b86a57f943d","1ba8fef685d74a8194b9db252eb704fb",22887498,1,-2,0,1141,357,355,-2
"1ba8fef685d74a8194b9db252eb704fb","c76574d21bc14aeea7ecd0b027f39858",22887498,1,15,0,1142,355,367,12
"c76574d21bc14aeea7ecd0b027f39858","2fe14166dc9642c3bc666b86a57f943d",22887498,1,-13,0,1143,367,357,-10
"2fe14166dc9642c3bc666b86a57f943d","0a8f150a4cf747acbde62f4721823da3",22887498,1,4,0,1144,357,361,4
"0a8f150a4cf747acbde62f4721823da3","1ba8fef685d74a8194b9db252eb704fb",22887498,1,-6,0,1145,361,355,-6
"52580888dadb4fe3baa795683ea227bd","30ead9794d4847abaf222ca966cc8630",22887498,1,-18,0,1148,364,348,-16
"30ead9794d4847abaf222ca966cc8630","52580888dadb4fe3baa795683ea227bd",22887498,1,18,0,1149,348,364,16
"f00179e251a045b39c3f7a54f9aa4acc","cfa457d1743848e4bb5e4beced6448ed",22887498,1,8,0,1151,363,369,6
"cfa457d1743848e4bb5e4beced6448ed","cfa457d1743848e4bb5e4beced6448ed",22887498,3,0,1,1152,369,369,0
"cfa457d1743848e4bb5e4beced6448ed","30ead9794d4847abaf222ca966cc8630",22887498,1,-25,0,1155,369,348,-21
"30ead9794d4847abaf222ca966cc8630","b71bac264efb4abd97015447bd490db6",22887498,2,28,0,1156,348,370,22
"b71bac264efb4abd97015447bd490db6","b71bac264efb4abd97015447bd490db6",22887498,2,0,1,1157,370,370,0
"b71bac264efb4abd97015447bd490db6","8d448d625b024c82a5eb240bbd7431d6",22887498,4,5,0,1158,370,374,4
"8d448d625b024c82a5eb240bbd7431d6","8d448d625b024c82a5eb240bbd7431d6",22887498,76,0,1,1159,374,374,0
"8d448d625b024c82a5eb240bbd7431d6","b71bac264efb4abd97015447bd490db6",22887498,3,-5,0,1166,374,370,-4
"b71bac264efb4abd97015447bd490db6","30ead9794d4847abaf222ca966cc8630",22887498,2,-28,0,1167,370,348,-22
"c20993c944444fe085345591a8bd837e","c76574d21bc14aeea7ecd0b027f39858",22887498,1,20,0,1171,351,367,16
"c76574d21bc14aeea7ecd0b027f39858","897b7f51242c44aab2205c72fdcbf4cd",22887498,1,-19,0,1172,367,352,-15
"09b9678ddc3d452ea4a3d46e15826065","897b7f51242c44aab2205c72fdcbf4cd",22887498,1,-1,0,1174,353,352,-1
"897b7f51242c44aab2205c72fdcbf4cd","c20993c944444fe085345591a8bd837e",22887498,1,-1,0,1176,352,351,-1
"c20993c944444fe085345591a8bd837e","eff0de7f2dbb42dfa1a2e686efab5b6d",22887498,1,3,0,1178,351,354,3
"eff0de7f2dbb42dfa1a2e686efab5b6d","09b9678ddc3d452ea4a3d46e15826065",22887498,2,-1,0,1181,354,353,-1
"09b9678ddc3d452ea4a3d46e15826065","30ead9794d4847abaf222ca966cc8630",22887498,1,-5,0,1183,353,348,-5
"2fe14166dc9642c3bc666b86a57f943d","897b7f51242c44aab2205c72fdcbf4cd",22887498,1,-6,0,1185,357,352,-5
"09b9678ddc3d452ea4a3d46e15826065","1ba8fef685d74a8194b9db252eb704fb",22887498,1,3,0,1187,353,355,2
"1ba8fef685d74a8194b9db252eb704fb","c20993c944444fe085345591a8bd837e",22887498,1,-5,0,1188,355,351,-4
"38aea304b4fa46e1b29bb72f5cea4c93","4a92daef4d504e1792575a26502bb7b7",22887498,1,18,0,1201,331,346,15
"4a92daef4d504e1792575a26502bb7b7","38aea304b4fa46e1b29bb72f5cea4c93",22887498,1,-18,0,1202,346,331,-15
"38aea304b4fa46e1b29bb72f5cea4c93","0c4079457ede49e3aeb5e86ed84bdf35",22887498,1,-2,0,1203,331,329,-2
"c20993c944444fe085345591a8bd837e","b71bac264efb4abd97015447bd490db6",22887498,1,25,0,1218,351,370,19
"b71bac264efb4abd97015447bd490db6","d6d02b6ef04e4f17805504500b8ce441",22887498,3,8,0,1242,370,375,5
"d6d02b6ef04e4f17805504500b8ce441","d6d02b6ef04e4f17805504500b8ce441",22887498,4,0,1,1243,375,375,0
"d6d02b6ef04e4f17805504500b8ce441","66baf19b6b904b70922329068c63746d",22887498,2,4,0,1245,375,376,1
"66baf19b6b904b70922329068c63746d","7f544639412e40a9ba27f43b415362ab",22887498,3,2,0,1246,376,378,2
"7f544639412e40a9ba27f43b415362ab","67a089198fcb4e1c8f2385786c2b296f",22887498,1,-450,0,1247,378,39,-339
"67a089198fcb4e1c8f2385786c2b296f","64d48c6c9c7940639a932219a6c87198",22887498,8,1,0,1248,39,40,1
"64d48c6c9c7940639a932219a6c87198","67a089198fcb4e1c8f2385786c2b296f",22887498,4,-1,0,1249,40,39,-1
"67a089198fcb4e1c8f2385786c2b296f","3cbcea2be0984e7dbd5a48195af10ce7",22887498,1,160,0,1250,39,165,126
"3cbcea2be0984e7dbd5a48195af10ce7","82e6285962b8400d9d6fc32436022a94",22887498,4,2,0,1251,165,167,2
"82e6285962b8400d9d6fc32436022a94","a9ac840f098c4bd0a2ee896214ce29cd",22887498,2,3,0,1252,167,168,1
"a9ac840f098c4bd0a2ee896214ce29cd","3cbcea2be0984e7dbd5a48195af10ce7",22887498,3,-5,0,1253,168,165,-3
"3cbcea2be0984e7dbd5a48195af10ce7","a9ac840f098c4bd0a2ee896214ce29cd",22887498,3,5,0,1254,165,168,3
"82e6285962b8400d9d6fc32436022a94","66baf19b6b904b70922329068c63746d",22887498,1,286,0,1257,167,376,209
"7f544639412e40a9ba27f43b415362ab","b7719e26494940efa49512aedd0aac79",22887498,1,-490,0,1259,378,20,-358
"b7719e26494940efa49512aedd0aac79","d4f45188d3c84a02ba08454e6403a818",22887498,1,5,0,1260,20,24,4
"d4f45188d3c84a02ba08454e6403a818","d4c3b003e8274e429d2fa688d73fde6d",22887498,1,-2,0,1261,24,22,-2
"d4c3b003e8274e429d2fa688d73fde6d","94cecc3f1e7d484b8e068e79241dfd73",22887498,1,354,0,1262,22,281,259
"94cecc3f1e7d484b8e068e79241dfd73","a37477c4e4c14169ad44b06b493007f6",22887498,5,2,0,1263,281,283,2
"a37477c4e4c14169ad44b06b493007f6","94cecc3f1e7d484b8e068e79241dfd73",22887498,2,-2,0,1264,283,281,-2
"94cecc3f1e7d484b8e068e79241dfd73","94cecc3f1e7d484b8e068e79241dfd73",22887498,1,0,1,1265,281,281,0
"a37477c4e4c14169ad44b06b493007f6","5bc03c8f16354d04bd51f5bb93559ad3",22887498,1,-352,0,1267,283,26,-257
"5bc03c8f16354d04bd51f5bb93559ad3","b7719e26494940efa49512aedd0aac79",22887498,1,-7,0,1268,26,20,-6
"b7719e26494940efa49512aedd0aac79","b7719e26494940efa49512aedd0aac79",22887498,1,0,1,1269,20,20,0
"b7719e26494940efa49512aedd0aac79","d6d02b6ef04e4f17805504500b8ce441",22887498,1,484,0,1270,20,375,355
"d6d02b6ef04e4f17805504500b8ce441","67a089198fcb4e1c8f2385786c2b296f",22887498,1,-444,0,1272,375,39,-336
"64d48c6c9c7940639a932219a6c87198","b71bac264efb4abd97015447bd490db6",22887498,1,435,0,1274,40,370,330
"8d448d625b024c82a5eb240bbd7431d6","d6d02b6ef04e4f17805504500b8ce441",22887498,1,3,0,1318,374,375,1
"d6d02b6ef04e4f17805504500b8ce441","b71bac264efb4abd97015447bd490db6",22887498,2,-8,0,1319,375,370,-5
"7f544639412e40a9ba27f43b415362ab","7f544639412e40a9ba27f43b415362ab",22887498,1,0,1,1335,378,378,0
"7f544639412e40a9ba27f43b415362ab","d5ae8642e15b46b8bd298b02274d4e9c",22887498,1,2,0,1336,378,380,2
"d5ae8642e15b46b8bd298b02274d4e9c","d5ae8642e15b46b8bd298b02274d4e9c",22887498,1,0,1,1337,380,380,0
"d5ae8642e15b46b8bd298b02274d4e9c","a0d10309a2dd456289147f84be9d37f9",22887498,1,1,0,1338,380,381,1
"a0d10309a2dd456289147f84be9d37f9","a0d10309a2dd456289147f84be9d37f9",22887498,2,0,1,1339,381,381,0
"a0d10309a2dd456289147f84be9d37f9","0fcbc3ca07b144138b8d85da581f09a8",22887498,1,1,0,1341,381,382,1
"0fcbc3ca07b144138b8d85da581f09a8","0fcbc3ca07b144138b8d85da581f09a8",22887498,2,0,1,1342,382,382,0
"0fcbc3ca07b144138b8d85da581f09a8","66baf19b6b904b70922329068c63746d",22887498,1,-6,0,1344,382,376,-6
"66baf19b6b904b70922329068c63746d","c2fca3669923477ab966ded303dea31c",22887498,1,8,0,1345,376,383,7
"c2fca3669923477ab966ded303dea31c","4890121ce5d74576b4632b77cfc23398",22887498,1,6,0,1346,383,388,5
"4890121ce5d74576b4632b77cfc23398","4890121ce5d74576b4632b77cfc23398",22887498,2,0,1,1347,388,388,0
"4890121ce5d74576b4632b77cfc23398","18d3b836dd804224883cc9180b60a8e1",22887498,1,-1,0,1349,388,387,-1
"18d3b836dd804224883cc9180b60a8e1","96bb2b3e85a34d8b9544514e89f6fe97",22887498,1,4,0,1350,387,390,3
"96bb2b3e85a34d8b9544514e89f6fe97","96bb2b3e85a34d8b9544514e89f6fe97",22887498,1,0,1,1351,390,390,0
"96bb2b3e85a34d8b9544514e89f6fe97","4890121ce5d74576b4632b77cfc23398",22887498,1,-3,0,1352,390,388,-2
"4890121ce5d74576b4632b77cfc23398","17f95d18bab743888e1736033dc3384d",22887498,1,2,0,1353,388,389,1
"17f95d18bab743888e1736033dc3384d","96bb2b3e85a34d8b9544514e89f6fe97",22887498,1,1,0,1354,389,390,1
"96bb2b3e85a34d8b9544514e89f6fe97","18d3b836dd804224883cc9180b60a8e1",22887498,1,-4,0,1355,390,387,-3
"18d3b836dd804224883cc9180b60a8e1","ac4e9b54acfe4670b4634859c7263cb5",22887498,1,6,0,1356,387,392,5
"ac4e9b54acfe4670b4634859c7263cb5","ac4e9b54acfe4670b4634859c7263cb5",22887498,4,0,1,1357,392,392,0
"ac4e9b54acfe4670b4634859c7263cb5","17f95d18bab743888e1736033dc3384d",22887498,1,-3,0,1361,392,389,-3
"17f95d18bab743888e1736033dc3384d","6f8881a745ac4c358a68b92c3b4abe81",22887498,1,6,0,1362,389,394,5
"6f8881a745ac4c358a68b92c3b4abe81","6f8881a745ac4c358a68b92c3b4abe81",22887498,1,0,1,1363,394,394,0
"6f8881a745ac4c358a68b92c3b4abe81","f7002c8484354eceac57bc7bd62c76c1",22887498,1,-1,0,1364,394,393,-1
"f7002c8484354eceac57bc7bd62c76c1","44a277ea44dc4ae689fab4b82f0b4098",22887498,1,5,0,1365,393,397,4
"44a277ea44dc4ae689fab4b82f0b4098","d646286c8051419bbc2e31dd1db55ca8",22887498,1,-437,0,1366,397,67,-330
"d646286c8051419bbc2e31dd1db55ca8","6a9f0ef185fb47f0937e29daa1c71ed5",22887498,1,27,0,1367,67,90,23
"6a9f0ef185fb47f0937e29daa1c71ed5","6a9f0ef185fb47f0937e29daa1c71ed5",22887498,5,0,1,1368,90,90,0
"6a9f0ef185fb47f0937e29daa1c71ed5","d646286c8051419bbc2e31dd1db55ca8",22887498,2,-27,0,1370,90,67,-23
"d646286c8051419bbc2e31dd1db55ca8","e20db35ced8544ddac5bc3839145e463",22887498,2,30,0,1371,67,91,24
"e20db35ced8544ddac5bc3839145e463","e20db35ced8544ddac5bc3839145e463",22887498,1,0,1,1372,91,91,0
"e20db35ced8544ddac5bc3839145e463","00ae5f0c51874a73a41ebea838d95682",22887498,2,11,0,1373,91,101,10
"00ae5f0c51874a73a41ebea838d95682","d391c8b6e56a43a7b654e9dee02d904b",22887498,3,2,0,1374,101,103,2
"d391c8b6e56a43a7b654e9dee02d904b","73039f8c1eb9409cb4caee2cf968001e",22887498,1,-3,0,1375,103,100,-3
"73039f8c1eb9409cb4caee2cf968001e","4280927ec4d643238aa49c32f9e06c6c",22887498,2,10,0,1376,100,109,9
"4280927ec4d643238aa49c32f9e06c6c","08111f75e22d409998cf8b85bd431f0a",22887498,2,-1,0,1377,109,108,-1
"08111f75e22d409998cf8b85bd431f0a","a9ae0a3c070d455bb4369a8996313336",22887498,2,7,0,1378,108,114,6
"a9ae0a3c070d455bb4369a8996313336","37319e88176d4aefa91d7a9980dbae91",22887498,1,-2,0,1379,114,112,-2
"37319e88176d4aefa91d7a9980dbae91","62bff51286ef4f348717a3cf6fe2318f",22887498,2,9,0,1380,112,120,8
"62bff51286ef4f348717a3cf6fe2318f","62bff51286ef4f348717a3cf6fe2318f",22887498,5,0,1,1381,120,120,0
"62bff51286ef4f348717a3cf6fe2318f","779f9ddd1fd14d1e9e69f72219a1fdbd",22887498,1,3,0,1383,120,121,1
"779f9ddd1fd14d1e9e69f72219a1fdbd","e20db35ced8544ddac5bc3839145e463",22887498,1,-36,0,1384,121,91,-30
"e20db35ced8544ddac5bc3839145e463","a8dd5213034441ac92724b4e83eb0bb2",22887498,1,45,0,1385,91,129,38
"a8dd5213034441ac92724b4e83eb0bb2","779f9ddd1fd14d1e9e69f72219a1fdbd",22887498,1,-9,0,1386,129,121,-8
"779f9ddd1fd14d1e9e69f72219a1fdbd","579338175e0b4bbb8ef3b712b5d8b54e",22887498,1,8,0,1387,121,128,7
"579338175e0b4bbb8ef3b712b5d8b54e","b416d47c56a742199b5d7c7f19d6503a",22887498,1,7,0,1388,128,134,6
"b416d47c56a742199b5d7c7f19d6503a","779f9ddd1fd14d1e9e69f72219a1fdbd",22887498,1,-15,0,1389,134,121,-13
"779f9ddd1fd14d1e9e69f72219a1fdbd","df1de691dafe4549a18a4398ee9dfaf9",22887498,1,23,0,1390,121,139,18
"df1de691dafe4549a18a4398ee9dfaf9","6c5ad271a44743479bfaea29b1db8d02",22887498,2,4,0,1391,139,143,4
"6c5ad271a44743479bfaea29b1db8d02","df1de691dafe4549a18a4398ee9dfaf9",22887498,1,-4,0,1392,143,139,-4
"df1de691dafe4549a18a4398ee9dfaf9","8aae34f5ddbb4052a709b12e6b0d40fa",22887498,3,9,0,1393,139,147,8
"8aae34f5ddbb4052a709b12e6b0d40fa","8aae34f5ddbb4052a709b12e6b0d40fa",22887498,1,0,1,1394,147,147,0
"8aae34f5ddbb4052a709b12e6b0d40fa","df1de691dafe4549a18a4398ee9dfaf9",22887498,2,-9,0,1395,147,139,-8
"6c5ad271a44743479bfaea29b1db8d02","67a089198fcb4e1c8f2385786c2b296f",22887498,1,-130,0,1397,143,39,-104
"67a089198fcb4e1c8f2385786c2b296f","67a089198fcb4e1c8f2385786c2b296f",22887498,2,0,1,1398,39,39,0
"64d48c6c9c7940639a932219a6c87198","64d48c6c9c7940639a932219a6c87198",22887498,7,0,1,1401,40,40,0
"64d48c6c9c7940639a932219a6c87198","d9c8d8c444a64dadbbb508652c721e17",22887498,1,9,0,1409,40,46,6
"d9c8d8c444a64dadbbb508652c721e17","b534b89233134e30a9b5645138bfa9ee",22887498,1,-6,0,1410,46,41,-5
"b534b89233134e30a9b5645138bfa9ee","6e13d61a7bdb44bca949c9f86fab3be5",22887498,3,7,0,1411,41,47,6
"6e13d61a7bdb44bca949c9f86fab3be5","66baf19b6b904b70922329068c63746d",22887498,1,437,0,1412,47,376,329
"66baf19b6b904b70922329068c63746d","44a277ea44dc4ae689fab4b82f0b4098",22887498,1,26,0,1413,376,397,21
"44a277ea44dc4ae689fab4b82f0b4098","44a277ea44dc4ae689fab4b82f0b4098",22887498,1,0,1,1414,397,397,0
"44a277ea44dc4ae689fab4b82f0b4098","0c12af0a4e7f4002852cf84b2537c161",22887498,1,-2,0,1415,397,395,-2
"0c12af0a4e7f4002852cf84b2537c161","859e0b8d71694b12befb69ee698138f9",22887498,1,5,0,1416,395,399,4
"859e0b8d71694b12befb69ee698138f9","859e0b8d71694b12befb69ee698138f9",22887498,1,0,1,1417,399,399,0
"859e0b8d71694b12befb69ee698138f9","66baf19b6b904b70922329068c63746d",22887498,1,-29,0,1418,399,376,-23
"66baf19b6b904b70922329068c63746d","2b09a08242b54983aec7063990fb3f66",22887498,1,32,0,1419,376,400,24
"2b09a08242b54983aec7063990fb3f66","2b09a08242b54983aec7063990fb3f66",22887498,3,0,1,1420,400,400,0
"2b09a08242b54983aec7063990fb3f66","1f471b7a883a4df48211e8c6a81b59a7",22887498,1,1,0,1422,400,401,1
"1f471b7a883a4df48211e8c6a81b59a7","1f471b7a883a4df48211e8c6a81b59a7",22887498,1,0,1,1423,401,401,0
"1f471b7a883a4df48211e8c6a81b59a7","2b09a08242b54983aec7063990fb3f66",22887498,1,-1,0,1424,401,400,-1
"2b09a08242b54983aec7063990fb3f66","9de0d567bfa84fe5b77cb76f4a76a5d1",22887498,1,5,0,1425,400,404,4
"9de0d567bfa84fe5b77cb76f4a76a5d1","9de0d567bfa84fe5b77cb76f4a76a5d1",22887498,3,0,1,1426,404,404,0
"9de0d567bfa84fe5b77cb76f4a76a5d1","1157bd665ec4472fb58b751dc5099355",22887498,1,-1,0,1429,404,403,-1
"1157bd665ec4472fb58b751dc5099355","2b09a08242b54983aec7063990fb3f66",22887498,1,-4,0,1430,403,400,-3
"2b09a08242b54983aec7063990fb3f66","3c8a22d2f9c146ea956609e3ed4f2559",22887498,1,7,0,1431,400,405,5
"3c8a22d2f9c146ea956609e3ed4f2559","58fc9094275e4c49be3f4ba6d4acc0a4",22887498,1,2,0,1432,405,406,1
"58fc9094275e4c49be3f4ba6d4acc0a4","58fc9094275e4c49be3f4ba6d4acc0a4",22887498,1,0,1,1433,406,406,0
"58fc9094275e4c49be3f4ba6d4acc0a4","c1c1be90b2b14c1ab4a5e1ee3c241902",22887498,1,1,0,1434,406,407,1
"c1c1be90b2b14c1ab4a5e1ee3c241902","c1c1be90b2b14c1ab4a5e1ee3c241902",22887498,5,0,1,1435,407,407,0
"c1c1be90b2b14c1ab4a5e1ee3c241902","58fc9094275e4c49be3f4ba6d4acc0a4",22887498,1,-1,0,1440,407,406,-1
"58fc9094275e4c49be3f4ba6d4acc0a4","02b3a1bead9244c1ba2f857c7da8f82a",22887498,1,3,0,1441,406,408,2
"02b3a1bead9244c1ba2f857c7da8f82a","02b3a1bead9244c1ba2f857c7da8f82a",22887498,4,0,1,1442,408,408,0
"02b3a1bead9244c1ba2f857c7da8f82a","6206fc6479014bb193084c32409dc1b9",22887498,1,1,0,1446,408,409,1
"6206fc6479014bb193084c32409dc1b9","6206fc6479014bb193084c32409dc1b9",22887498,1,0,1,1447,409,409,0
"6206fc6479014bb193084c32409dc1b9","02b3a1bead9244c1ba2f857c7da8f82a",22887498,1,-1,0,1448,409,408,-1
"02b3a1bead9244c1ba2f857c7da8f82a","6a5f020451db426dacba9e2ea3fcc62a",22887498,1,3,0,1449,408,410,2
"6a5f020451db426dacba9e2ea3fcc62a","6a5f020451db426dacba9e2ea3fcc62a",22887498,4,0,1,1450,410,410,0
"6a5f020451db426dacba9e2ea3fcc62a","33a9d248b2e44588a5b07fc1342b9bc2",22887498,1,2,0,1452,410,411,1
"33a9d248b2e44588a5b07fc1342b9bc2","33a9d248b2e44588a5b07fc1342b9bc2",22887498,6,0,1,1453,411,411,0
"33a9d248b2e44588a5b07fc1342b9bc2","c6f26bd420634f1cb7989e76fe6b16c0",22887498,1,1,0,1457,411,412,1
"c6f26bd420634f1cb7989e76fe6b16c0","c6f26bd420634f1cb7989e76fe6b16c0",22887498,5,0,1,1458,412,412,0
"c6f26bd420634f1cb7989e76fe6b16c0","2a65ee6e2ac64f6a8a55fbe5373ec763",22887498,1,1,0,1463,412,413,1
"2a65ee6e2ac64f6a8a55fbe5373ec763","2a65ee6e2ac64f6a8a55fbe5373ec763",22887498,2,0,1,1464,413,413,0
"2a65ee6e2ac64f6a8a55fbe5373ec763","33a9d248b2e44588a5b07fc1342b9bc2",22887498,1,-2,0,1466,413,411,-2
"33a9d248b2e44588a5b07fc1342b9bc2","687055dad9fc40c3982478fe33ec01bf",22887498,1,4,0,1467,411,414,3
"687055dad9fc40c3982478fe33ec01bf","6a5f020451db426dacba9e2ea3fcc62a",22887498,1,-6,0,1468,414,410,-4
"6a5f020451db426dacba9e2ea3fcc62a","2b09a08242b54983aec7063990fb3f66",22887498,1,-15,0,1470,410,400,-10
"2b09a08242b54983aec7063990fb3f66","6a5f020451db426dacba9e2ea3fcc62a",22887498,1,15,0,1471,400,410,10
"6a5f020451db426dacba9e2ea3fcc62a","1fd0f6dadbc14ebc965faf6122190b96",22887498,1,7,0,1473,410,415,5
"1fd0f6dadbc14ebc965faf6122190b96","687055dad9fc40c3982478fe33ec01bf",22887498,2,-1,0,1474,415,414,-1
"687055dad9fc40c3982478fe33ec01bf","33a9d248b2e44588a5b07fc1342b9bc2",22887498,1,-4,0,1475,414,411,-3
"33a9d248b2e44588a5b07fc1342b9bc2","2b09a08242b54983aec7063990fb3f66",22887498,3,-17,0,1477,411,400,-11
"2b09a08242b54983aec7063990fb3f66","33a9d248b2e44588a5b07fc1342b9bc2",22887498,3,17,0,1478,400,411,11
"33a9d248b2e44588a5b07fc1342b9bc2","1fd0f6dadbc14ebc965faf6122190b96",22887498,1,5,0,1485,411,415,4
"1fd0f6dadbc14ebc965faf6122190b96","1fd0f6dadbc14ebc965faf6122190b96",22887498,1,0,1,1486,415,415,0
"687055dad9fc40c3982478fe33ec01bf","2add1669f08d4101913db15f8c23b3b7",22887498,1,3,0,1488,414,416,2
"2add1669f08d4101913db15f8c23b3b7","2b09a08242b54983aec7063990fb3f66",22887498,1,-24,0,1489,416,400,-16
"2b09a08242b54983aec7063990fb3f66","a2b4bd40cee2481ebd3fc179d6a5cd62",22887498,1,27,0,1490,400,417,17
"a2b4bd40cee2481ebd3fc179d6a5cd62","a2b4bd40cee2481ebd3fc179d6a5cd62",22887498,2,0,1,1491,417,417,0
"a2b4bd40cee2481ebd3fc179d6a5cd62","e34e59dce2204f228f3a84b6725df60f",22887498,1,2,0,1492,417,419,2
"e34e59dce2204f228f3a84b6725df60f","e34e59dce2204f228f3a84b6725df60f",22887498,1,0,1,1493,419,419,0
"e34e59dce2204f228f3a84b6725df60f","a2b4bd40cee2481ebd3fc179d6a5cd62",22887498,1,-2,0,1494,419,417,-2
"a2b4bd40cee2481ebd3fc179d6a5cd62","bec48fc2e1294c7eb3d0aca780d731b8",22887498,1,4,0,1495,417,420,3
"bec48fc2e1294c7eb3d0aca780d731b8","bec48fc2e1294c7eb3d0aca780d731b8",22887498,3,0,1,1496,420,420,0
"bec48fc2e1294c7eb3d0aca780d731b8","dbde19fcce2a4c1abdc7f685c293a23f",22887498,1,3,0,1498,420,422,2
"dbde19fcce2a4c1abdc7f685c293a23f","a24600b0e49245f6bdba8c893cfeddb0",22887498,1,4,0,1499,422,425,3
"a24600b0e49245f6bdba8c893cfeddb0","a24600b0e49245f6bdba8c893cfeddb0",22887498,4,0,1,1500,425,425,0
"a24600b0e49245f6bdba8c893cfeddb0","a2b4bd40cee2481ebd3fc179d6a5cd62",22887498,1,-11,0,1504,425,417,-8
"a2b4bd40cee2481ebd3fc179d6a5cd62","24cf8786024543f19b89bc20034e60d7",22887498,2,18,0,1505,417,428,11
"24cf8786024543f19b89bc20034e60d7","f2a73be2f46840b182d7bd095378004e",22887498,5,1,0,1506,428,429,1
"f2a73be2f46840b182d7bd095378004e","24cf8786024543f19b89bc20034e60d7",22887498,4,-1,0,1507,429,428,-1
"f2a73be2f46840b182d7bd095378004e","f2a73be2f46840b182d7bd095378004e",22887498,1,0,1,1509,429,429,0
"f2a73be2f46840b182d7bd095378004e","604551fd4266430cb860fef58fa7dd61",22887498,1,1,0,1510,429,430,1
"604551fd4266430cb860fef58fa7dd61","604551fd4266430cb860fef58fa7dd61",22887498,4,0,1,1511,430,430,0
"604551fd4266430cb860fef58fa7dd61","24cf8786024543f19b89bc20034e60d7",22887498,1,-2,0,1515,430,428,-2
"24cf8786024543f19b89bc20034e60d7","dce46f8904594a62a6377a3587aaa663",22887498,5,4,0,1516,428,431,3
"dce46f8904594a62a6377a3587aaa663","dce46f8904594a62a6377a3587aaa663",22887498,2,0,1,1517,431,431,0
"dce46f8904594a62a6377a3587aaa663","9b9d0a249052413c869753b99682b0ac",22887498,1,1,0,1518,431,432,1
"9b9d0a249052413c869753b99682b0ac","9b9d0a249052413c869753b99682b0ac",22887498,5,0,1,1519,432,432,0
"9b9d0a249052413c869753b99682b0ac","061c175cc90f45fbad883025394e78dd",22887498,1,1,0,1524,432,433,1
"061c175cc90f45fbad883025394e78dd","061c175cc90f45fbad883025394e78dd",22887498,6,0,1,1525,433,433,0
"061c175cc90f45fbad883025394e78dd","dce46f8904594a62a6377a3587aaa663",22887498,1,-2,0,1531,433,431,-2
"dce46f8904594a62a6377a3587aaa663","66ada10dde9f43018588f1ced9d477fc",22887498,1,4,0,1532,431,434,3
"66ada10dde9f43018588f1ced9d477fc","f2a73be2f46840b182d7bd095378004e",22887498,2,-7,0,1533,434,429,-5
"f2a73be2f46840b182d7bd095378004e","dce46f8904594a62a6377a3587aaa663",22887498,2,3,0,1534,429,431,2
"dce46f8904594a62a6377a3587aaa663","24cf8786024543f19b89bc20034e60d7",22887498,5,-4,0,1535,431,428,-3
"dce46f8904594a62a6377a3587aaa663","f2a73be2f46840b182d7bd095378004e",22887498,1,-3,0,1540,431,429,-2
"f2a73be2f46840b182d7bd095378004e","66ada10dde9f43018588f1ced9d477fc",22887498,2,7,0,1541,429,434,5
"24cf8786024543f19b89bc20034e60d7","a2b4bd40cee2481ebd3fc179d6a5cd62",22887498,1,-18,0,1546,428,417,-11
"a2b4bd40cee2481ebd3fc179d6a5cd62","a24600b0e49245f6bdba8c893cfeddb0",22887498,1,11,0,1547,417,425,8
"a24600b0e49245f6bdba8c893cfeddb0","5d290f75e44b4bdb8256c600debbb44d",22887498,1,2,0,1548,425,426,1
"5d290f75e44b4bdb8256c600debbb44d","a24600b0e49245f6bdba8c893cfeddb0",22887498,1,-2,0,1549,426,425,-1
"a24600b0e49245f6bdba8c893cfeddb0","bec48fc2e1294c7eb3d0aca780d731b8",22887498,1,-7,0,1550,425,420,-5
"bec48fc2e1294c7eb3d0aca780d731b8","a2b4bd40cee2481ebd3fc179d6a5cd62",22887498,1,-4,0,1552,420,417,-3
"24cf8786024543f19b89bc20034e60d7","74a7f8712e5449c2bc0b43c6f90dafed",22887498,1,9,0,1557,428,435,7
"74a7f8712e5449c2bc0b43c6f90dafed","f2a73be2f46840b182d7bd095378004e",22887498,1,-8,0,1558,435,429,-6
"66ada10dde9f43018588f1ced9d477fc","dce46f8904594a62a6377a3587aaa663",22887498,1,-4,0,1560,434,431,-3
"dce46f8904594a62a6377a3587aaa663","74a7f8712e5449c2bc0b43c6f90dafed",22887498,1,5,0,1568,431,435,4
"74a7f8712e5449c2bc0b43c6f90dafed","74a7f8712e5449c2bc0b43c6f90dafed",22887498,1,0,1,1569,435,435,0
"74a7f8712e5449c2bc0b43c6f90dafed","66ada10dde9f43018588f1ced9d477fc",22887498,1,-1,0,1570,435,434,-1
"66ada10dde9f43018588f1ced9d477fc","bf12c96466d840a69bed7020b3f18bb8",22887498,1,3,0,1571,434,436,2
"bf12c96466d840a69bed7020b3f18bb8","bf12c96466d840a69bed7020b3f18bb8",22887498,1,0,1,1572,436,436,0
"bf12c96466d840a69bed7020b3f18bb8","070600601c4c439288445d2f0724807d",22887498,1,3,0,1573,436,437,1
"070600601c4c439288445d2f0724807d","24cf8786024543f19b89bc20034e60d7",22887498,1,-14,0,1574,437,428,-9
"24cf8786024543f19b89bc20034e60d7","1823b6de7d334a7aaabc4570719af4d9",22887498,1,16,0,1575,428,439,11
"1823b6de7d334a7aaabc4570719af4d9","070600601c4c439288445d2f0724807d",22887498,4,-2,0,1576,439,437,-2
"070600601c4c439288445d2f0724807d","1823b6de7d334a7aaabc4570719af4d9",22887498,3,2,0,1577,437,439,2
"1823b6de7d334a7aaabc4570719af4d9","1823b6de7d334a7aaabc4570719af4d9",22887498,59,0,1,1578,439,439,0
"070600601c4c439288445d2f0724807d","0380cd76a7d44bc3a4da1f15e4d68f89",22887498,3,4,0,1608,437,440,3
"0380cd76a7d44bc3a4da1f15e4d68f89","070600601c4c439288445d2f0724807d",22887498,2,-4,0,1609,440,437,-3
"0380cd76a7d44bc3a4da1f15e4d68f89","23b7673c8b5443108c2ef09382834a86",22887498,3,2,0,1611,440,441,1
"23b7673c8b5443108c2ef09382834a86","901e92500aea43c79f19f1b279050668",22887498,2,2,0,1612,441,442,1
"901e92500aea43c79f19f1b279050668","1823b6de7d334a7aaabc4570719af4d9",22887498,1,-6,0,1613,442,439,-3
"070600601c4c439288445d2f0724807d","070600601c4c439288445d2f0724807d",22887498,2,0,1,1645,437,437,0
"1823b6de7d334a7aaabc4570719af4d9","0380cd76a7d44bc3a4da1f15e4d68f89",22887498,1,2,0,1649,439,440,1
"23b7673c8b5443108c2ef09382834a86","0380cd76a7d44bc3a4da1f15e4d68f89",22887498,1,-2,0,1653,441,440,-1
"23b7673c8b5443108c2ef09382834a86","23b7673c8b5443108c2ef09382834a86",22887498,1,0,1,1655,441,441,0
"901e92500aea43c79f19f1b279050668","901e92500aea43c79f19f1b279050668",22887498,3,0,1,1657,442,442,0
"901e92500aea43c79f19f1b279050668","001339db8ced4cf78829ebe8b145449d",22887498,1,1,0,1660,442,443,1
"001339db8ced4cf78829ebe8b145449d","001339db8ced4cf78829ebe8b145449d",22887498,2,0,1,1661,443,443,0
"001339db8ced4cf78829ebe8b145449d","452745e0366e42ae81561bfddebcc6c3",22887498,1,1,0,1663,443,444,1
"452745e0366e42ae81561bfddebcc6c3","452745e0366e42ae81561bfddebcc6c3",22887498,2,0,1,1664,444,444,0
"452745e0366e42ae81561bfddebcc6c3","901e92500aea43c79f19f1b279050668",22887498,1,-2,0,1666,444,442,-2
"901e92500aea43c79f19f1b279050668","4660ff2089114e8db82ceb26a4f329e3",22887498,1,4,0,1667,442,445,3
"4660ff2089114e8db82ceb26a4f329e3","4660ff2089114e8db82ceb26a4f329e3",22887498,2,0,1,1668,445,445,0
"4660ff2089114e8db82ceb26a4f329e3","7bd5586eb9d8484eb74a433ee7bfe499",22887498,1,2,0,1670,445,446,1
"7bd5586eb9d8484eb74a433ee7bfe499","7bd5586eb9d8484eb74a433ee7bfe499",22887498,10,0,1,1671,446,446,0
"7bd5586eb9d8484eb74a433ee7bfe499","8a7f26e690f34dda97be16904518ca99",22887498,1,2,0,1681,446,447,1
"8a7f26e690f34dda97be16904518ca99","8a7f26e690f34dda97be16904518ca99",22887498,1,0,1,1682,447,447,0
"8a7f26e690f34dda97be16904518ca99","b2f0d654738f48158edff28e8d3a546e",22887498,1,5,0,1683,447,449,2
"b2f0d654738f48158edff28e8d3a546e","070600601c4c439288445d2f0724807d",22887498,1,-21,0,1684,449,437,-12
"070600601c4c439288445d2f0724807d","f67fbf45a5f146ed866965bc57c7c001",22887498,1,29,0,1685,437,454,17
"f67fbf45a5f146ed866965bc57c7c001","f67fbf45a5f146ed866965bc57c7c001",22887498,2,0,1,1686,454,454,0
"f67fbf45a5f146ed866965bc57c7c001","d937afe49bd24a07a550dda1c1155122",22887498,1,1,0,1688,454,455,1
"d937afe49bd24a07a550dda1c1155122","d937afe49bd24a07a550dda1c1155122",22887498,1,0,1,1689,455,455,0
"d937afe49bd24a07a550dda1c1155122","3628b3f7823443d0912a339096b69943",22887498,1,1,0,1690,455,456,1
"3628b3f7823443d0912a339096b69943","3628b3f7823443d0912a339096b69943",22887498,1,0,1,1691,456,456,0
"3628b3f7823443d0912a339096b69943","9e049ee647cf43ecbcb5ed792a8e7588",22887498,1,1,0,1692,456,457,1
"9e049ee647cf43ecbcb5ed792a8e7588","9e049ee647cf43ecbcb5ed792a8e7588",22887498,1,0,1,1693,457,457,0
"9e049ee647cf43ecbcb5ed792a8e7588","5256a214faaf410b93f76cea06428334",22887498,1,1,0,1694,457,458,1
"5256a214faaf410b93f76cea06428334","5256a214faaf410b93f76cea06428334",22887498,1,0,1,1695,458,458,0
"5256a214faaf410b93f76cea06428334","25c32b120fce40fa9b6c85133aeb4716",22887498,1,1,0,1696,458,459,1
"25c32b120fce40fa9b6c85133aeb4716","25c32b120fce40fa9b6c85133aeb4716",22887498,1,0,1,1697,459,459,0
"25c32b120fce40fa9b6c85133aeb4716","11bc14f2204949008b7d511b933363c1",22887498,1,1,0,1698,459,460,1
"11bc14f2204949008b7d511b933363c1","11bc14f2204949008b7d511b933363c1",22887498,1,0,1,1699,460,460,0
"11bc14f2204949008b7d511b933363c1","42de338840a34d15adb66e7b14fb9d2c",22887498,1,1,0,1700,460,461,1
"42de338840a34d15adb66e7b14fb9d2c","42de338840a34d15adb66e7b14fb9d2c",22887498,3,0,1,1701,461,461,0
"42de338840a34d15adb66e7b14fb9d2c","9da37c6210b1416b8079c274f70bf600",22887498,1,1,0,1704,461,462,1
"9da37c6210b1416b8079c274f70bf600","9da37c6210b1416b8079c274f70bf600",22887498,1,0,1,1705,462,462,0
"9da37c6210b1416b8079c274f70bf600","519119f1deac45ff9ab4f13529be5c6e",22887498,1,1,0,1706,462,463,1
"519119f1deac45ff9ab4f13529be5c6e","519119f1deac45ff9ab4f13529be5c6e",22887498,1,0,1,1707,463,463,0
"519119f1deac45ff9ab4f13529be5c6e","c5df9f40ec14463b9dcfdc73df3e9285",22887498,1,3,0,1708,463,464,1
"c5df9f40ec14463b9dcfdc73df3e9285","f67fbf45a5f146ed866965bc57c7c001",22887498,1,-12,0,1709,464,454,-10
"f67fbf45a5f146ed866965bc57c7c001","c5df9f40ec14463b9dcfdc73df3e9285",22887498,1,12,0,1710,454,464,10
"c5df9f40ec14463b9dcfdc73df3e9285","c5df9f40ec14463b9dcfdc73df3e9285",22887498,1,0,1,1711,464,464,0
"c5df9f40ec14463b9dcfdc73df3e9285","83d42d95cd844fc093fc09cee250edb8",22887498,1,3,0,1712,464,465,1
"83d42d95cd844fc093fc09cee250edb8","83d42d95cd844fc093fc09cee250edb8",22887498,1,0,1,1713,465,465,0
"83d42d95cd844fc093fc09cee250edb8","94cecc3f1e7d484b8e068e79241dfd73",22887498,1,-266,0,1714,465,281,-184
"a37477c4e4c14169ad44b06b493007f6","2b09a08242b54983aec7063990fb3f66",22887498,1,161,0,1716,283,400,117
"2b09a08242b54983aec7063990fb3f66","2add1669f08d4101913db15f8c23b3b7",22887498,1,24,0,1717,400,416,16
"2add1669f08d4101913db15f8c23b3b7","2add1669f08d4101913db15f8c23b3b7",22887498,1,0,1,1718,416,416,0
"2add1669f08d4101913db15f8c23b3b7","070600601c4c439288445d2f0724807d",22887498,1,35,0,1719,416,437,21
"070600601c4c439288445d2f0724807d","67a089198fcb4e1c8f2385786c2b296f",22887498,1,-539,0,1721,437,39,-398
"64d48c6c9c7940639a932219a6c87198","b534b89233134e30a9b5645138bfa9ee",22887498,2,3,0,1725,40,41,1
"b534b89233134e30a9b5645138bfa9ee","67a089198fcb4e1c8f2385786c2b296f",22887498,2,-4,0,1726,41,39,-2
"67a089198fcb4e1c8f2385786c2b296f","6e13d61a7bdb44bca949c9f86fab3be5",22887498,1,11,0,1727,39,47,8
"6e13d61a7bdb44bca949c9f86fab3be5","b534b89233134e30a9b5645138bfa9ee",22887498,2,-7,0,1728,47,41,-6
"b534b89233134e30a9b5645138bfa9ee","d9c8d8c444a64dadbbb508652c721e17",22887498,1,6,0,1729,41,46,5
"d9c8d8c444a64dadbbb508652c721e17","d0c74f735e024943943e40333d6d337f",22887498,3,6,0,1730,46,51,5
"d0c74f735e024943943e40333d6d337f","67a089198fcb4e1c8f2385786c2b296f",22887498,1,-16,0,1731,51,39,-12
"67a089198fcb4e1c8f2385786c2b296f","b534b89233134e30a9b5645138bfa9ee",22887498,1,4,0,1734,39,41,2
"b534b89233134e30a9b5645138bfa9ee","b534b89233134e30a9b5645138bfa9ee",22887498,1,0,1,1735,41,41,0
"6e13d61a7bdb44bca949c9f86fab3be5","d9c8d8c444a64dadbbb508652c721e17",22887498,1,-1,0,1737,47,46,-1
"d0c74f735e024943943e40333d6d337f","6e13d61a7bdb44bca949c9f86fab3be5",22887498,1,-5,0,1739,51,47,-4
"6e13d61a7bdb44bca949c9f86fab3be5","f924752d8a1149668870b1e7698486f7",22887498,1,4,0,1740,47,50,3
"f924752d8a1149668870b1e7698486f7","d9c8d8c444a64dadbbb508652c721e17",22887498,1,-5,0,1741,50,46,-4
"b613861cecf84ffcab01afb23f660475","b613861cecf84ffcab01afb23f660475",22899628,4,0,1,1,1,1,0
"b613861cecf84ffcab01afb23f660475","e2911e79efc2420eac45d9f671463d4b",22899628,1,3,0,5,1,2,1
"e2911e79efc2420eac45d9f671463d4b","e2911e79efc2420eac45d9f671463d4b",22899628,2,0,1,6,2,2,0
"e2911e79efc2420eac45d9f671463d4b","519d1b8c59404d67b54e96c5c8a830b2",22899628,1,1,0,8,2,3,1
"519d1b8c59404d67b54e96c5c8a830b2","519d1b8c59404d67b54e96c5c8a830b2",22899628,1,0,1,9,3,3,0
"519d1b8c59404d67b54e96c5c8a830b2","531db53f81f646edb0cdcfe0085b03b7",22899628,1,1,0,10,3,4,1
"531db53f81f646edb0cdcfe0085b03b7","531db53f81f646edb0cdcfe0085b03b7",22899628,1,0,1,11,4,4,0
"531db53f81f646edb0cdcfe0085b03b7","4f5f94b2f95141e0a9d53a61da2276da",22899628,1,1,0,12,4,5,1
"4f5f94b2f95141e0a9d53a61da2276da","4f5f94b2f95141e0a9d53a61da2276da",22899628,1,0,1,13,5,5,0
"4f5f94b2f95141e0a9d53a61da2276da","6d541c89590949f99af293c4f2333f67",22899628,1,1,0,14,5,6,1
"6d541c89590949f99af293c4f2333f67","6d541c89590949f99af293c4f2333f67",22899628,1,0,1,15,6,6,0
"6d541c89590949f99af293c4f2333f67","dd5cf0b9fe4c4f1d8f5ff8e4c04879cb",22899628,1,1,0,16,6,7,1
"dd5cf0b9fe4c4f1d8f5ff8e4c04879cb","dd5cf0b9fe4c4f1d8f5ff8e4c04879cb",22899628,2,0,1,17,7,7,0
"dd5cf0b9fe4c4f1d8f5ff8e4c04879cb","f96261861edc426abe2248be4f0a709a",22899628,1,1,0,19,7,8,1
"f96261861edc426abe2248be4f0a709a","f96261861edc426abe2248be4f0a709a",22899628,1,0,1,20,8,8,0
"f96261861edc426abe2248be4f0a709a","66b5e16f4f75454fb5b8172079f0fa83",22899628,1,1,0,21,8,9,1
"66b5e16f4f75454fb5b8172079f0fa83","66b5e16f4f75454fb5b8172079f0fa83",22899628,2,0,1,22,9,9,0
"66b5e16f4f75454fb5b8172079f0fa83","0680571d4698477995e41842c36a54b2",22899628,1,1,0,24,9,10,1
"0680571d4698477995e41842c36a54b2","0680571d4698477995e41842c36a54b2",22899628,2,0,1,25,10,10,0
"0680571d4698477995e41842c36a54b2","e2911e79efc2420eac45d9f671463d4b",22899628,1,-8,0,26,10,2,-8
"e2911e79efc2420eac45d9f671463d4b","56586aa865414f538729c7f7735d2bc6",22899628,2,12,0,27,2,12,10
"56586aa865414f538729c7f7735d2bc6","56586aa865414f538729c7f7735d2bc6",22899628,4,0,1,28,12,12,0
"56586aa865414f538729c7f7735d2bc6","e2911e79efc2420eac45d9f671463d4b",22899628,1,-12,0,29,12,2,-10
"e2911e79efc2420eac45d9f671463d4b","0680571d4698477995e41842c36a54b2",22899628,1,8,0,30,2,10,8
"0680571d4698477995e41842c36a54b2","9112f2bffece48e08c6d2287be204085",22899628,1,1,0,32,10,11,1
"9112f2bffece48e08c6d2287be204085","9112f2bffece48e08c6d2287be204085",22899628,1,0,1,33,11,11,0
"9112f2bffece48e08c6d2287be204085","e2911e79efc2420eac45d9f671463d4b",22899628,1,-9,0,34,11,2,-9
"56586aa865414f538729c7f7735d2bc6","b7f2b31585d94eb3bf86376714aa7070",22899628,1,2,0,39,12,13,1
"b7f2b31585d94eb3bf86376714aa7070","b7f2b31585d94eb3bf86376714aa7070",22899628,3,0,1,40,13,13,0
"b7f2b31585d94eb3bf86376714aa7070","3f1c815879794b929260d224becaff7e",22899628,2,2,0,43,13,14,1
"3f1c815879794b929260d224becaff7e","b7f2b31585d94eb3bf86376714aa7070",22899628,1,-2,0,44,14,13,-1
"3f1c815879794b929260d224becaff7e","5c5ceeee4562457ba6d41515aeebfbb1",22899628,1,6,0,46,14,17,3
"5c5ceeee4562457ba6d41515aeebfbb1","81c864a886d54a6b8ff85f7d736f4f95",22899628,1,-4,0,47,17,15,-2
"81c864a886d54a6b8ff85f7d736f4f95","5c5ceeee4562457ba6d41515aeebfbb1",22899628,1,4,0,48,15,17,2
"5c5ceeee4562457ba6d41515aeebfbb1","9afd71a5298d4333b6849dfce1b9422c",22899628,1,3,0,49,17,18,1
"9afd71a5298d4333b6849dfce1b9422c","56586aa865414f538729c7f7735d2bc6",22899628,1,-13,0,50,18,12,-6
"56586aa865414f538729c7f7735d2bc6","9afd71a5298d4333b6849dfce1b9422c",22899628,1,13,0,51,12,18,6
"9afd71a5298d4333b6849dfce1b9422c","b7719e26494940efa49512aedd0aac79",22899628,1,4,0,52,18,20,2
"b7719e26494940efa49512aedd0aac79","d4f45188d3c84a02ba08454e6403a818",22899628,1,5,0,53,20,24,4
"d4f45188d3c84a02ba08454e6403a818","d4c3b003e8274e429d2fa688d73fde6d",22899628,1,-2,0,54,24,22,-2
"d4c3b003e8274e429d2fa688d73fde6d","b613861cecf84ffcab01afb23f660475",22899628,1,-35,0,55,22,1,-21
"b613861cecf84ffcab01afb23f660475","a49d1bb4328949299686242fd0be5584",22899628,1,34,0,56,1,21,20
"a49d1bb4328949299686242fd0be5584","b7719e26494940efa49512aedd0aac79",22899628,1,-2,0,57,21,20,-1
"b7719e26494940efa49512aedd0aac79","afbf7250b99d47bea07172749483ca97",22899628,2,12,0,58,20,28,8
"afbf7250b99d47bea07172749483ca97","b7719e26494940efa49512aedd0aac79",22899628,1,-12,0,59,28,20,-8
"afbf7250b99d47bea07172749483ca97","4e51676dc72045d99c19b9fa7b22f8bc",22899628,1,3,0,61,28,29,1
"4e51676dc72045d99c19b9fa7b22f8bc","4e51676dc72045d99c19b9fa7b22f8bc",22899628,1,0,1,62,29,29,0
"4e51676dc72045d99c19b9fa7b22f8bc","51970cfa30e643e894e66ae85c8024cc",22899628,1,3,0,63,29,31,2
"51970cfa30e643e894e66ae85c8024cc","4e51676dc72045d99c19b9fa7b22f8bc",22899628,1,-3,0,64,31,29,-2
"4e51676dc72045d99c19b9fa7b22f8bc","c33c17be71ae4d588da7369472e5bb1b",22899628,1,9,0,65,29,34,5
"c33c17be71ae4d588da7369472e5bb1b","93679be414554a11b1893002f2229a93",22899628,2,3,0,66,34,35,1
"93679be414554a11b1893002f2229a93","c33c17be71ae4d588da7369472e5bb1b",22899628,1,-3,0,67,35,34,-1
"93679be414554a11b1893002f2229a93","7040a13096d746ac84b8fac8d9752058",22899628,1,3,0,69,35,36,1
"7040a13096d746ac84b8fac8d9752058","7040a13096d746ac84b8fac8d9752058",22899628,1,0,1,70,36,36,0
"7040a13096d746ac84b8fac8d9752058","9a0dc646f934470daf08c4b56ccf73db",22899628,1,3,0,71,36,37,1
"9a0dc646f934470daf08c4b56ccf73db","9a0dc646f934470daf08c4b56ccf73db",22899628,1,0,1,72,37,37,0
"9a0dc646f934470daf08c4b56ccf73db","fc0e049d56024bc9a02c9a9c435c3df7",22899628,1,3,0,73,37,38,1
"fc0e049d56024bc9a02c9a9c435c3df7","67a089198fcb4e1c8f2385786c2b296f",22899628,1,4,0,74,38,39,1
"67a089198fcb4e1c8f2385786c2b296f","fc0e049d56024bc9a02c9a9c435c3df7",22899628,1,-4,0,75,39,38,-1
"fc0e049d56024bc9a02c9a9c435c3df7","64d48c6c9c7940639a932219a6c87198",22899628,1,5,0,76,38,40,2
"64d48c6c9c7940639a932219a6c87198","67a089198fcb4e1c8f2385786c2b296f",22899628,1,-1,0,77,40,39,-1
"67a089198fcb4e1c8f2385786c2b296f","64d48c6c9c7940639a932219a6c87198",22899628,1,1,0,79,39,40,1
"64d48c6c9c7940639a932219a6c87198","64d48c6c9c7940639a932219a6c87198",22899628,1,0,1,80,40,40,0
"64d48c6c9c7940639a932219a6c87198","b534b89233134e30a9b5645138bfa9ee",22899628,1,3,0,81,40,41,1
"b534b89233134e30a9b5645138bfa9ee","67a089198fcb4e1c8f2385786c2b296f",22899628,1,-4,0,82,41,39,-2
"67a089198fcb4e1c8f2385786c2b296f","0e37b720d23b4e7f8b313e79313fd107",22899628,1,7,0,83,39,44,5
"0e37b720d23b4e7f8b313e79313fd107","0e37b720d23b4e7f8b313e79313fd107",22899628,1,0,1,84,44,44,0
"0e37b720d23b4e7f8b313e79313fd107","6875d67fdd5f48168b62719df449bebd",22899628,1,1,0,85,44,45,1
"6875d67fdd5f48168b62719df449bebd","6875d67fdd5f48168b62719df449bebd",22899628,1,0,1,86,45,45,0
"6875d67fdd5f48168b62719df449bebd","b534b89233134e30a9b5645138bfa9ee",22899628,1,-4,0,87,45,41,-4
"b534b89233134e30a9b5645138bfa9ee","6e13d61a7bdb44bca949c9f86fab3be5",22899628,1,7,0,88,41,47,6
"6e13d61a7bdb44bca949c9f86fab3be5","6e13d61a7bdb44bca949c9f86fab3be5",22899628,1,0,1,89,47,47,0
"6e13d61a7bdb44bca949c9f86fab3be5","195f78799f984cc2b06c48dfe36be751",22899628,1,2,0,90,47,49,2
"195f78799f984cc2b06c48dfe36be751","195f78799f984cc2b06c48dfe36be751",22899628,2,0,1,91,49,49,0
"195f78799f984cc2b06c48dfe36be751","d9c8d8c444a64dadbbb508652c721e17",22899628,1,-3,0,93,49,46,-3
"d9c8d8c444a64dadbbb508652c721e17","d0c74f735e024943943e40333d6d337f",22899628,1,6,0,94,46,51,5
"d0c74f735e024943943e40333d6d337f","d0c74f735e024943943e40333d6d337f",22899628,2,0,1,95,51,51,0
"d0c74f735e024943943e40333d6d337f","f924752d8a1149668870b1e7698486f7",22899628,1,-1,0,96,51,50,-1
"f924752d8a1149668870b1e7698486f7","b534b89233134e30a9b5645138bfa9ee",22899628,1,-11,0,97,50,41,-9
"d0c74f735e024943943e40333d6d337f","983f8ff320594b279a7f4a6fe132f9c5",22899628,1,2,0,100,51,53,2
"983f8ff320594b279a7f4a6fe132f9c5","983f8ff320594b279a7f4a6fe132f9c5",22899628,2,0,1,101,53,53,0
"983f8ff320594b279a7f4a6fe132f9c5","35adfa5d923046aebabfefd98f35ff05",22899628,1,1,0,103,53,54,1
"35adfa5d923046aebabfefd98f35ff05","35adfa5d923046aebabfefd98f35ff05",22899628,2,0,1,104,54,54,0
"35adfa5d923046aebabfefd98f35ff05","b6f8a98476224da1b40e555ececc7ed8",22899628,1,1,0,106,54,55,1
"b6f8a98476224da1b40e555ececc7ed8","b6f8a98476224da1b40e555ececc7ed8",22899628,2,0,1,107,55,55,0
"b6f8a98476224da1b40e555ececc7ed8","86e22cb5fe0e4b47a9489ecddf7ed78f",22899628,1,1,0,109,55,56,1
"86e22cb5fe0e4b47a9489ecddf7ed78f","86e22cb5fe0e4b47a9489ecddf7ed78f",22899628,5,0,1,110,56,56,0
"86e22cb5fe0e4b47a9489ecddf7ed78f","f924752d8a1149668870b1e7698486f7",22899628,1,-6,0,115,56,50,-6
"f924752d8a1149668870b1e7698486f7","78f30e4dcac84e3cbea8b2cc6e0d62b3",22899628,1,10,0,116,50,59,9
"78f30e4dcac84e3cbea8b2cc6e0d62b3","a1f2f12debe5432fb7a70bcd12bacfb9",22899628,1,-1,0,117,59,58,-1
"a1f2f12debe5432fb7a70bcd12bacfb9","a1f2f12debe5432fb7a70bcd12bacfb9",22899628,36,0,1,118,58,58,0
"a1f2f12debe5432fb7a70bcd12bacfb9","78f30e4dcac84e3cbea8b2cc6e0d62b3",22899628,1,1,0,154,58,59,1
"78f30e4dcac84e3cbea8b2cc6e0d62b3","78f30e4dcac84e3cbea8b2cc6e0d62b3",22899628,15,0,1,155,59,59,0
"78f30e4dcac84e3cbea8b2cc6e0d62b3","a0a418b8540d479fa6e0f653b701da8b",22899628,1,6,0,170,59,64,5
"a0a418b8540d479fa6e0f653b701da8b","12aa6e1672ac4e7aa6449a7a8609cd72",22899628,1,-8,0,171,64,57,-7
"12aa6e1672ac4e7aa6449a7a8609cd72","bc42d26810654ea9a1df1efe1e58c7d5",22899628,1,7,0,172,57,63,6
"bc42d26810654ea9a1df1efe1e58c7d5","4c943503763e4e349906eea3ed3c8e86",22899628,1,-2,0,173,63,61,-2
"4c943503763e4e349906eea3ed3c8e86","4c943503763e4e349906eea3ed3c8e86",22899628,1,0,1,174,61,61,0
"4c943503763e4e349906eea3ed3c8e86","309ccf3cc4fe429d9bfbaef53d3fa479",22899628,1,-1,0,175,61,60,-1
"309ccf3cc4fe429d9bfbaef53d3fa479","b534b89233134e30a9b5645138bfa9ee",22899628,1,-23,0,176,60,41,-19
"b534b89233134e30a9b5645138bfa9ee","d646286c8051419bbc2e31dd1db55ca8",22899628,1,33,0,177,41,67,26
"d646286c8051419bbc2e31dd1db55ca8","0c7262dff33c4087bc660ccf40f92f9c",22899628,1,132,0,178,67,169,102
"0c7262dff33c4087bc660ccf40f92f9c","b2275c3fad834f8d90737a2d9a6927d6",22899628,2,3,0,179,169,172,3
"b2275c3fad834f8d90737a2d9a6927d6","b534b89233134e30a9b5645138bfa9ee",22899628,1,-168,0,180,172,41,-131
"b534b89233134e30a9b5645138bfa9ee","d0c74f735e024943943e40333d6d337f",22899628,2,12,0,181,41,51,10
"d0c74f735e024943943e40333d6d337f","67a089198fcb4e1c8f2385786c2b296f",22899628,1,-16,0,182,51,39,-12
"67a089198fcb4e1c8f2385786c2b296f","67a089198fcb4e1c8f2385786c2b296f",22899628,2,0,1,183,39,39,0
"67a089198fcb4e1c8f2385786c2b296f","d646286c8051419bbc2e31dd1db55ca8",22899628,1,37,0,184,39,67,28
"d646286c8051419bbc2e31dd1db55ca8","d646286c8051419bbc2e31dd1db55ca8",22899628,1,0,1,185,67,67,0
"d646286c8051419bbc2e31dd1db55ca8","267f883678b24aed855fde42524975d9",22899628,1,4,0,186,67,71,4
"267f883678b24aed855fde42524975d9","267f883678b24aed855fde42524975d9",22899628,1,0,1,187,71,71,0
"267f883678b24aed855fde42524975d9","88fff56d0342490dbef9040750a20f6c",22899628,1,1,0,188,71,72,1
"88fff56d0342490dbef9040750a20f6c","88fff56d0342490dbef9040750a20f6c",22899628,1,0,1,189,72,72,0
"88fff56d0342490dbef9040750a20f6c","adb17b12b66c4a49a85fd34322f7df70",22899628,1,1,0,190,72,73,1
"adb17b12b66c4a49a85fd34322f7df70","adb17b12b66c4a49a85fd34322f7df70",22899628,3,0,1,191,73,73,0
"adb17b12b66c4a49a85fd34322f7df70","d646286c8051419bbc2e31dd1db55ca8",22899628,1,-6,0,194,73,67,-6
"d646286c8051419bbc2e31dd1db55ca8","a2becd407db34b189200a32546d9d569",22899628,3,9,0,195,67,75,8
"a2becd407db34b189200a32546d9d569","a2becd407db34b189200a32546d9d569",22899628,2,0,1,196,75,75,0
"a2becd407db34b189200a32546d9d569","58c22b011d0f4c2ea6d13615edbb9eeb",22899628,1,2,0,197,75,77,2
"58c22b011d0f4c2ea6d13615edbb9eeb","58c22b011d0f4c2ea6d13615edbb9eeb",22899628,2,0,1,198,77,77,0
"58c22b011d0f4c2ea6d13615edbb9eeb","dd76e1861dc9461c830888729d091ee0",22899628,1,1,0,200,77,78,1
"dd76e1861dc9461c830888729d091ee0","dd76e1861dc9461c830888729d091ee0",22899628,5,0,1,201,78,78,0
"dd76e1861dc9461c830888729d091ee0","cd1d828f1a694b87913a7ea66c23803e",22899628,1,1,0,206,78,79,1
"cd1d828f1a694b87913a7ea66c23803e","cd1d828f1a694b87913a7ea66c23803e",22899628,2,0,1,207,79,79,0
"cd1d828f1a694b87913a7ea66c23803e","9176a3c2b4d2465fa8b0c67096c2a97e",22899628,1,1,0,209,79,80,1
"9176a3c2b4d2465fa8b0c67096c2a97e","9176a3c2b4d2465fa8b0c67096c2a97e",22899628,11,0,1,210,80,80,0
"9176a3c2b4d2465fa8b0c67096c2a97e","140d5b27b8574befad82c0a013b59dfa",22899628,1,-6,0,221,80,74,-6
"140d5b27b8574befad82c0a013b59dfa","d18a9ea32855445f8736581f5cb119ce",22899628,3,9,0,222,74,82,8
"d18a9ea32855445f8736581f5cb119ce","d646286c8051419bbc2e31dd1db55ca8",22899628,1,-17,0,223,82,67,-15
"d646286c8051419bbc2e31dd1db55ca8","140d5b27b8574befad82c0a013b59dfa",22899628,1,8,0,224,67,74,7
"140d5b27b8574befad82c0a013b59dfa","d646286c8051419bbc2e31dd1db55ca8",22899628,1,-8,0,225,74,67,-7
"a2becd407db34b189200a32546d9d569","f8ec6445f7194e25b9101d4fbcb07a18",22899628,1,6,0,228,75,81,6
"f8ec6445f7194e25b9101d4fbcb07a18","f8ec6445f7194e25b9101d4fbcb07a18",22899628,2,0,1,229,81,81,0
"f8ec6445f7194e25b9101d4fbcb07a18","140d5b27b8574befad82c0a013b59dfa",22899628,1,-7,0,231,81,74,-7
"d18a9ea32855445f8736581f5cb119ce","f564483cbd7a407681aa2fcca518cf5f",22899628,1,4,0,233,82,85,3
"f564483cbd7a407681aa2fcca518cf5f","f564483cbd7a407681aa2fcca518cf5f",22899628,1,0,1,234,85,85,0
"f564483cbd7a407681aa2fcca518cf5f","18fd01350bd5434ca636d59a599d768a",22899628,1,1,0,235,85,86,1
"18fd01350bd5434ca636d59a599d768a","18fd01350bd5434ca636d59a599d768a",22899628,5,0,1,236,86,86,0
"18fd01350bd5434ca636d59a599d768a","d646286c8051419bbc2e31dd1db55ca8",22899628,1,-22,0,241,86,67,-19
"a2becd407db34b189200a32546d9d569","140d5b27b8574befad82c0a013b59dfa",22899628,1,-1,0,243,75,74,-1
"d18a9ea32855445f8736581f5cb119ce","ae5ac430ea254e708a6f5deaaf7464ae",22899628,1,3,0,245,82,84,2
"ae5ac430ea254e708a6f5deaaf7464ae","6a9f0ef185fb47f0937e29daa1c71ed5",22899628,1,7,0,246,84,90,6
"6a9f0ef185fb47f0937e29daa1c71ed5","c681290961c94c4caf23b529d1ae6b9a",22899628,1,-2,0,247,90,88,-2
"c681290961c94c4caf23b529d1ae6b9a","c681290961c94c4caf23b529d1ae6b9a",22899628,1,0,1,248,88,88,0
"c681290961c94c4caf23b529d1ae6b9a","6a9f0ef185fb47f0937e29daa1c71ed5",22899628,1,2,0,249,88,90,2
"6a9f0ef185fb47f0937e29daa1c71ed5","6a9f0ef185fb47f0937e29daa1c71ed5",22899628,3,0,1,250,90,90,0
"6a9f0ef185fb47f0937e29daa1c71ed5","e20db35ced8544ddac5bc3839145e463",22899628,1,3,0,253,90,91,1
"e20db35ced8544ddac5bc3839145e463","d646286c8051419bbc2e31dd1db55ca8",22899628,1,-30,0,254,91,67,-24
"d646286c8051419bbc2e31dd1db55ca8","1febb706d7a34005ae8711ed49c76e64",22899628,1,33,0,255,67,94,27
"1febb706d7a34005ae8711ed49c76e64","1febb706d7a34005ae8711ed49c76e64",22899628,2,0,1,256,94,94,0
"1febb706d7a34005ae8711ed49c76e64","8f73ba6f5a0042f2850356ac38ac6f24",22899628,1,1,0,258,94,95,1
"8f73ba6f5a0042f2850356ac38ac6f24","8f73ba6f5a0042f2850356ac38ac6f24",22899628,5,0,1,259,95,95,0
"8f73ba6f5a0042f2850356ac38ac6f24","e2260b86653c46d7b14a41fb419dbf8c",22899628,1,1,0,264,95,96,1
"e2260b86653c46d7b14a41fb419dbf8c","e2260b86653c46d7b14a41fb419dbf8c",22899628,2,0,1,265,96,96,0
"e2260b86653c46d7b14a41fb419dbf8c","35eb641ad1d845bbba54915bce75a962",22899628,1,1,0,267,96,97,1
"35eb641ad1d845bbba54915bce75a962","35eb641ad1d845bbba54915bce75a962",22899628,6,0,1,268,97,97,0
"35eb641ad1d845bbba54915bce75a962","08be90ffbeea4795a138cd42ed8db56f",22899628,1,1,0,274,97,98,1
"08be90ffbeea4795a138cd42ed8db56f","08be90ffbeea4795a138cd42ed8db56f",22899628,6,0,1,275,98,98,0
"08be90ffbeea4795a138cd42ed8db56f","3007433c8f584dcbb5ac159c1c5f2be3",22899628,1,1,0,281,98,99,1
"3007433c8f584dcbb5ac159c1c5f2be3","3007433c8f584dcbb5ac159c1c5f2be3",22899628,5,0,1,282,99,99,0
"3007433c8f584dcbb5ac159c1c5f2be3","00ae5f0c51874a73a41ebea838d95682",22899628,1,3,0,287,99,101,2
"00ae5f0c51874a73a41ebea838d95682","e20db35ced8544ddac5bc3839145e463",22899628,4,-11,0,288,101,91,-10
"e20db35ced8544ddac5bc3839145e463","d391c8b6e56a43a7b654e9dee02d904b",22899628,4,13,0,289,91,103,12
"d391c8b6e56a43a7b654e9dee02d904b","00ae5f0c51874a73a41ebea838d95682",22899628,3,-2,0,290,103,101,-2
"00ae5f0c51874a73a41ebea838d95682","d391c8b6e56a43a7b654e9dee02d904b",22899628,6,2,0,291,101,103,2
"d391c8b6e56a43a7b654e9dee02d904b","d391c8b6e56a43a7b654e9dee02d904b",22899628,27,0,1,292,103,103,0
"d391c8b6e56a43a7b654e9dee02d904b","67a089198fcb4e1c8f2385786c2b296f",22899628,2,-80,0,293,103,39,-64
"67a089198fcb4e1c8f2385786c2b296f","e20db35ced8544ddac5bc3839145e463",22899628,5,67,0,294,39,91,52
"e20db35ced8544ddac5bc3839145e463","e20db35ced8544ddac5bc3839145e463",22899628,10,0,1,295,91,91,0
"e20db35ced8544ddac5bc3839145e463","00ae5f0c51874a73a41ebea838d95682",22899628,5,11,0,297,91,101,10
"00ae5f0c51874a73a41ebea838d95682","a81b2235cb9c499eb9ea8ee0a8dd9725",22899628,1,4,0,300,101,105,4
"a81b2235cb9c499eb9ea8ee0a8dd9725","a81b2235cb9c499eb9ea8ee0a8dd9725",22899628,5,0,1,301,105,105,0
"a81b2235cb9c499eb9ea8ee0a8dd9725","6111116566fc4fd9abba409322bea245",22899628,1,-1,0,306,105,104,-1
"6111116566fc4fd9abba409322bea245","6111116566fc4fd9abba409322bea245",22899628,2,0,1,307,104,104,0
"6111116566fc4fd9abba409322bea245","2d4e0ab0ef3b4d73b82c72d4621a7579",22899628,1,2,0,309,104,106,2
"2d4e0ab0ef3b4d73b82c72d4621a7579","2d4e0ab0ef3b4d73b82c72d4621a7579",22899628,2,0,1,310,106,106,0
"2d4e0ab0ef3b4d73b82c72d4621a7579","8bdebf492ebd4e62b0d522e8ab5e5197",22899628,1,1,0,312,106,107,1
"8bdebf492ebd4e62b0d522e8ab5e5197","8bdebf492ebd4e62b0d522e8ab5e5197",22899628,2,0,1,313,107,107,0
"8bdebf492ebd4e62b0d522e8ab5e5197","73039f8c1eb9409cb4caee2cf968001e",22899628,1,-7,0,315,107,100,-7
"73039f8c1eb9409cb4caee2cf968001e","4280927ec4d643238aa49c32f9e06c6c",22899628,1,10,0,316,100,109,9
"4280927ec4d643238aa49c32f9e06c6c","e20db35ced8544ddac5bc3839145e463",22899628,2,-20,0,317,109,91,-18
"e20db35ced8544ddac5bc3839145e463","4280927ec4d643238aa49c32f9e06c6c",22899628,2,20,0,320,91,109,18
"d391c8b6e56a43a7b654e9dee02d904b","4280927ec4d643238aa49c32f9e06c6c",22899628,1,7,0,353,103,109,6
"4280927ec4d643238aa49c32f9e06c6c","73039f8c1eb9409cb4caee2cf968001e",22899628,1,-10,0,354,109,100,-9
"73039f8c1eb9409cb4caee2cf968001e","fc44e6a5f7654430af1227838224dceb",22899628,1,12,0,355,100,111,11
"fc44e6a5f7654430af1227838224dceb","fc44e6a5f7654430af1227838224dceb",22899628,10,0,1,356,111,111,0
"fc44e6a5f7654430af1227838224dceb","08111f75e22d409998cf8b85bd431f0a",22899628,2,-3,0,366,111,108,-3
"08111f75e22d409998cf8b85bd431f0a","37319e88176d4aefa91d7a9980dbae91",22899628,1,5,0,367,108,112,4
"37319e88176d4aefa91d7a9980dbae91","4280927ec4d643238aa49c32f9e06c6c",22899628,1,-4,0,368,112,109,-3
"4280927ec4d643238aa49c32f9e06c6c","08111f75e22d409998cf8b85bd431f0a",22899628,1,-1,0,369,109,108,-1
"08111f75e22d409998cf8b85bd431f0a","71cec822bcff4f30a20e75dc63ef7b65",22899628,1,9,0,370,108,116,8
"71cec822bcff4f30a20e75dc63ef7b65","71cec822bcff4f30a20e75dc63ef7b65",22899628,8,0,1,371,116,116,0
"71cec822bcff4f30a20e75dc63ef7b65","37319e88176d4aefa91d7a9980dbae91",22899628,1,-4,0,377,116,112,-4
"37319e88176d4aefa91d7a9980dbae91","62bff51286ef4f348717a3cf6fe2318f",22899628,3,9,0,378,112,120,8
"62bff51286ef4f348717a3cf6fe2318f","3ec3a3563847406fa73338f9e9999cf3",22899628,2,-3,0,379,120,117,-3
"3ec3a3563847406fa73338f9e9999cf3","a9ae0a3c070d455bb4369a8996313336",22899628,1,-4,0,380,117,114,-3
"a9ae0a3c070d455bb4369a8996313336","a9ae0a3c070d455bb4369a8996313336",22899628,3,0,1,381,114,114,0
"a9ae0a3c070d455bb4369a8996313336","37319e88176d4aefa91d7a9980dbae91",22899628,2,-2,0,383,114,112,-2
"37319e88176d4aefa91d7a9980dbae91","00ae5f0c51874a73a41ebea838d95682",22899628,1,-13,0,384,112,101,-11
"d391c8b6e56a43a7b654e9dee02d904b","73039f8c1eb9409cb4caee2cf968001e",22899628,2,-3,0,387,103,100,-3
"73039f8c1eb9409cb4caee2cf968001e","62bff51286ef4f348717a3cf6fe2318f",22899628,1,23,0,388,100,120,20
"3ec3a3563847406fa73338f9e9999cf3","00ae5f0c51874a73a41ebea838d95682",22899628,1,-19,0,390,117,101,-16
"d391c8b6e56a43a7b654e9dee02d904b","e20db35ced8544ddac5bc3839145e463",22899628,1,-13,0,392,103,91,-12
"d391c8b6e56a43a7b654e9dee02d904b","62bff51286ef4f348717a3cf6fe2318f",22899628,1,20,0,395,103,120,17
"62bff51286ef4f348717a3cf6fe2318f","73039f8c1eb9409cb4caee2cf968001e",22899628,1,-23,0,396,120,100,-20
"73039f8c1eb9409cb4caee2cf968001e","b1cd0e7dc3ad4a8eb91a4bfdbeb025b0",22899628,1,21,0,397,100,118,18
"b1cd0e7dc3ad4a8eb91a4bfdbeb025b0","b1cd0e7dc3ad4a8eb91a4bfdbeb025b0",22899628,1,0,1,398,118,118,0
"b1cd0e7dc3ad4a8eb91a4bfdbeb025b0","62bff51286ef4f348717a3cf6fe2318f",22899628,1,2,0,399,118,120,2
"62bff51286ef4f348717a3cf6fe2318f","62bff51286ef4f348717a3cf6fe2318f",22899628,6,0,1,400,120,120,0
"62bff51286ef4f348717a3cf6fe2318f","e20db35ced8544ddac5bc3839145e463",22899628,1,-33,0,403,120,91,-29
"e20db35ced8544ddac5bc3839145e463","779f9ddd1fd14d1e9e69f72219a1fdbd",22899628,1,36,0,404,91,121,30
"779f9ddd1fd14d1e9e69f72219a1fdbd","67a089198fcb4e1c8f2385786c2b296f",22899628,1,-103,0,405,121,39,-82
"67a089198fcb4e1c8f2385786c2b296f","779f9ddd1fd14d1e9e69f72219a1fdbd",22899628,1,103,0,406,39,121,82
"779f9ddd1fd14d1e9e69f72219a1fdbd","ae26e6cda8ad4a3f81bd347560d9579f",22899628,1,4,0,407,121,125,4
"ae26e6cda8ad4a3f81bd347560d9579f","ae26e6cda8ad4a3f81bd347560d9579f",22899628,3,0,1,408,125,125,0
"ae26e6cda8ad4a3f81bd347560d9579f","ee48df95832b4374aa273ceb27ec1315",22899628,1,1,0,411,125,126,1
"ee48df95832b4374aa273ceb27ec1315","ee48df95832b4374aa273ceb27ec1315",22899628,1,0,1,412,126,126,0
"ee48df95832b4374aa273ceb27ec1315","7a439da90b394756ad1777fc4c6dead5",22899628,1,1,0,413,126,127,1
"7a439da90b394756ad1777fc4c6dead5","7a439da90b394756ad1777fc4c6dead5",22899628,1,0,1,414,127,127,0
"7a439da90b394756ad1777fc4c6dead5","a8dd5213034441ac92724b4e83eb0bb2",22899628,1,3,0,415,127,129,2
"a8dd5213034441ac92724b4e83eb0bb2","779f9ddd1fd14d1e9e69f72219a1fdbd",22899628,1,-9,0,416,129,121,-8
"779f9ddd1fd14d1e9e69f72219a1fdbd","a8dd5213034441ac92724b4e83eb0bb2",22899628,1,9,0,417,121,129,8
"a8dd5213034441ac92724b4e83eb0bb2","8115eab6556b45f5b415c3b8c26a12e5",22899628,1,2,0,418,129,131,2
"8115eab6556b45f5b415c3b8c26a12e5","8115eab6556b45f5b415c3b8c26a12e5",22899628,5,0,1,419,131,131,0
"8115eab6556b45f5b415c3b8c26a12e5","ec34b06efd844b46a4c4818ecdb9b8f4",22899628,1,1,0,424,131,132,1
"ec34b06efd844b46a4c4818ecdb9b8f4","ec34b06efd844b46a4c4818ecdb9b8f4",22899628,8,0,1,425,132,132,0
"ec34b06efd844b46a4c4818ecdb9b8f4","c2e1c2b9eac64109b343a088584b576b",22899628,1,1,0,433,132,133,1
"c2e1c2b9eac64109b343a088584b576b","c2e1c2b9eac64109b343a088584b576b",22899628,2,0,1,434,133,133,0
"c2e1c2b9eac64109b343a088584b576b","579338175e0b4bbb8ef3b712b5d8b54e",22899628,1,-5,0,436,133,128,-5
"579338175e0b4bbb8ef3b712b5d8b54e","8bc5795d6a984a3eace4e2811e52dd4f",22899628,1,8,0,437,128,135,7
"8bc5795d6a984a3eace4e2811e52dd4f","8bc5795d6a984a3eace4e2811e52dd4f",22899628,3,0,1,438,135,135,0
"8bc5795d6a984a3eace4e2811e52dd4f","b416d47c56a742199b5d7c7f19d6503a",22899628,1,-1,0,441,135,134,-1
"b416d47c56a742199b5d7c7f19d6503a","779f9ddd1fd14d1e9e69f72219a1fdbd",22899628,1,-15,0,442,134,121,-13
"779f9ddd1fd14d1e9e69f72219a1fdbd","779f9ddd1fd14d1e9e69f72219a1fdbd",22899628,1,0,1,443,121,121,0
"779f9ddd1fd14d1e9e69f72219a1fdbd","cd4532ad48034873ba8bce2aac0c9808",22899628,1,19,0,444,121,137,16
"cd4532ad48034873ba8bce2aac0c9808","cd4532ad48034873ba8bce2aac0c9808",22899628,1,0,1,445,137,137,0
"cd4532ad48034873ba8bce2aac0c9808","779f9ddd1fd14d1e9e69f72219a1fdbd",22899628,1,-19,0,446,137,121,-16
"779f9ddd1fd14d1e9e69f72219a1fdbd","df1de691dafe4549a18a4398ee9dfaf9",22899628,1,23,0,447,121,139,18
"df1de691dafe4549a18a4398ee9dfaf9","6c5ad271a44743479bfaea29b1db8d02",22899628,3,4,0,448,139,143,4
"6c5ad271a44743479bfaea29b1db8d02","67a089198fcb4e1c8f2385786c2b296f",22899628,1,-130,0,449,143,39,-104
"73039f8c1eb9409cb4caee2cf968001e","67a089198fcb4e1c8f2385786c2b296f",22899628,1,-77,0,456,100,39,-61
"e20db35ced8544ddac5bc3839145e463","37319e88176d4aefa91d7a9980dbae91",22899628,1,24,0,458,91,112,21
"37319e88176d4aefa91d7a9980dbae91","a9ae0a3c070d455bb4369a8996313336",22899628,1,2,0,459,112,114,2
"a9ae0a3c070d455bb4369a8996313336","71cec822bcff4f30a20e75dc63ef7b65",22899628,1,2,0,461,114,116,2
"71cec822bcff4f30a20e75dc63ef7b65","62bff51286ef4f348717a3cf6fe2318f",22899628,1,5,0,464,116,120,4
"62bff51286ef4f348717a3cf6fe2318f","37319e88176d4aefa91d7a9980dbae91",22899628,1,-9,0,466,120,112,-8
"62bff51286ef4f348717a3cf6fe2318f","779f9ddd1fd14d1e9e69f72219a1fdbd",22899628,2,3,0,468,120,121,1
"779f9ddd1fd14d1e9e69f72219a1fdbd","e20db35ced8544ddac5bc3839145e463",22899628,2,-36,0,469,121,91,-30
"e20db35ced8544ddac5bc3839145e463","67a089198fcb4e1c8f2385786c2b296f",22899628,3,-67,0,470,91,39,-52
"67a089198fcb4e1c8f2385786c2b296f","08111f75e22d409998cf8b85bd431f0a",22899628,1,86,0,471,39,108,69
"08111f75e22d409998cf8b85bd431f0a","e20db35ced8544ddac5bc3839145e463",22899628,1,-19,0,472,108,91,-17
"4280927ec4d643238aa49c32f9e06c6c","4280927ec4d643238aa49c32f9e06c6c",22899628,1,0,1,474,109,109,0
"4280927ec4d643238aa49c32f9e06c6c","fc44e6a5f7654430af1227838224dceb",22899628,1,2,0,475,109,111,2
"08111f75e22d409998cf8b85bd431f0a","a9ae0a3c070d455bb4369a8996313336",22899628,1,7,0,477,108,114,6
"67a089198fcb4e1c8f2385786c2b296f","df1de691dafe4549a18a4398ee9dfaf9",22899628,1,126,0,496,39,139,100
"df1de691dafe4549a18a4398ee9dfaf9","df1de691dafe4549a18a4398ee9dfaf9",22899628,1,0,1,497,139,139,0
"6c5ad271a44743479bfaea29b1db8d02","6c5ad271a44743479bfaea29b1db8d02",22899628,4,0,1,499,143,143,0
"6c5ad271a44743479bfaea29b1db8d02","df1de691dafe4549a18a4398ee9dfaf9",22899628,1,-4,0,503,143,139,-4
"6c5ad271a44743479bfaea29b1db8d02","83d311bed5374fee83d8d67a7d9d82dc",22899628,1,1,0,505,143,144,1
"83d311bed5374fee83d8d67a7d9d82dc","83d311bed5374fee83d8d67a7d9d82dc",22899628,1,0,1,506,144,144,0
"83d311bed5374fee83d8d67a7d9d82dc","402bba41861d43acb52a5abb89e8831e",22899628,1,1,0,507,144,145,1
"402bba41861d43acb52a5abb89e8831e","402bba41861d43acb52a5abb89e8831e",22899628,2,0,1,508,145,145,0
"402bba41861d43acb52a5abb89e8831e","df1de691dafe4549a18a4398ee9dfaf9",22899628,1,-6,0,510,145,139,-6
"df1de691dafe4549a18a4398ee9dfaf9","8aae34f5ddbb4052a709b12e6b0d40fa",22899628,1,9,0,511,139,147,8
"8aae34f5ddbb4052a709b12e6b0d40fa","8aae34f5ddbb4052a709b12e6b0d40fa",22899628,1,0,1,512,147,147,0
"8aae34f5ddbb4052a709b12e6b0d40fa","645b3f0249f64f76af2e19eb4d0e55b7",22899628,1,2,0,513,147,149,2
"645b3f0249f64f76af2e19eb4d0e55b7","645b3f0249f64f76af2e19eb4d0e55b7",22899628,2,0,1,514,149,149,0
"645b3f0249f64f76af2e19eb4d0e55b7","7e7b8db5064d4369805ab370aac5ddfb",22899628,1,1,0,516,149,150,1
"7e7b8db5064d4369805ab370aac5ddfb","7e7b8db5064d4369805ab370aac5ddfb",22899628,5,0,1,517,150,150,0
"7e7b8db5064d4369805ab370aac5ddfb","8956d210ae7f41968fada86d4c979d6a",22899628,1,1,0,522,150,151,1
"8956d210ae7f41968fada86d4c979d6a","8956d210ae7f41968fada86d4c979d6a",22899628,2,0,1,523,151,151,0
"8956d210ae7f41968fada86d4c979d6a","f902b0f41b544d4dbf79664fd233648d",22899628,1,-5,0,525,151,146,-5
"f902b0f41b544d4dbf79664fd233648d","ae781e8b775e4ccd93bc800dad5c8376",22899628,1,8,0,526,146,153,7
"ae781e8b775e4ccd93bc800dad5c8376","ae781e8b775e4ccd93bc800dad5c8376",22899628,2,0,1,527,153,153,0
"ae781e8b775e4ccd93bc800dad5c8376","06882a8492d9499aa31555567f575ecb",22899628,1,1,0,529,153,154,1
"06882a8492d9499aa31555567f575ecb","06882a8492d9499aa31555567f575ecb",22899628,1,0,1,530,154,154,0
"06882a8492d9499aa31555567f575ecb","f293c508f409466a8f27ddd7d1e40b20",22899628,1,1,0,531,154,155,1
"f293c508f409466a8f27ddd7d1e40b20","f293c508f409466a8f27ddd7d1e40b20",22899628,2,0,1,532,155,155,0
"f293c508f409466a8f27ddd7d1e40b20","cc4ddef5bbbe48ebb605141b347c4ed1",22899628,1,1,0,534,155,156,1
"cc4ddef5bbbe48ebb605141b347c4ed1","cc4ddef5bbbe48ebb605141b347c4ed1",22899628,3,0,1,535,156,156,0
"cc4ddef5bbbe48ebb605141b347c4ed1","d313cec988a84645bee413e8d4724a4b",22899628,1,3,0,538,156,158,2
"d313cec988a84645bee413e8d4724a4b","f03480cf4eba413194d7af52fc0e7f28",22899628,1,-7,0,539,158,152,-6
"f03480cf4eba413194d7af52fc0e7f28","d313cec988a84645bee413e8d4724a4b",22899628,1,7,0,540,152,158,6
"d313cec988a84645bee413e8d4724a4b","d313cec988a84645bee413e8d4724a4b",22899628,3,0,1,541,158,158,0
"d313cec988a84645bee413e8d4724a4b","dc60696c76a74368a60f72246e47700d",22899628,1,1,0,544,158,159,1
"dc60696c76a74368a60f72246e47700d","dc60696c76a74368a60f72246e47700d",22899628,1,0,1,545,159,159,0
"dc60696c76a74368a60f72246e47700d","78adeee1fa2c4fe0bc73f7bca9fcee86",22899628,1,3,0,546,159,160,1
"78adeee1fa2c4fe0bc73f7bca9fcee86","df1de691dafe4549a18a4398ee9dfaf9",22899628,1,-26,0,547,160,139,-21
"df1de691dafe4549a18a4398ee9dfaf9","78adeee1fa2c4fe0bc73f7bca9fcee86",22899628,1,26,0,548,139,160,21
"65202579580f4ad38d734b4ee39d22a8","3cbcea2be0984e7dbd5a48195af10ce7",22899628,1,3,0,557,164,165,1
"3cbcea2be0984e7dbd5a48195af10ce7","78adeee1fa2c4fe0bc73f7bca9fcee86",22899628,1,-8,0,558,165,160,-5
"78adeee1fa2c4fe0bc73f7bca9fcee86","82e6285962b8400d9d6fc32436022a94",22899628,1,10,0,559,160,167,7
"82e6285962b8400d9d6fc32436022a94","a9ac840f098c4bd0a2ee896214ce29cd",22899628,1,3,0,560,167,168,1
"a9ac840f098c4bd0a2ee896214ce29cd","a9ac840f098c4bd0a2ee896214ce29cd",22899628,2,0,1,561,168,168,0
"a9ac840f098c4bd0a2ee896214ce29cd","0c7262dff33c4087bc660ccf40f92f9c",22899628,1,4,0,563,168,169,1
"b2275c3fad834f8d90737a2d9a6927d6","b2275c3fad834f8d90737a2d9a6927d6",22899628,30,0,1,565,172,172,0
"b2275c3fad834f8d90737a2d9a6927d6","eb515a26030b41f8a82a1e6114420bad",22899628,1,1,0,595,172,173,1
"eb515a26030b41f8a82a1e6114420bad","eb515a26030b41f8a82a1e6114420bad",22899628,2,0,1,596,173,173,0
"eb515a26030b41f8a82a1e6114420bad","0c7262dff33c4087bc660ccf40f92f9c",22899628,1,-4,0,598,173,169,-4
"0c7262dff33c4087bc660ccf40f92f9c","b42cc17b7de840f181a704558d0bc845",22899628,2,7,0,599,169,175,6
"b42cc17b7de840f181a704558d0bc845","b42cc17b7de840f181a704558d0bc845",22899628,1,0,1,600,175,175,0
"b42cc17b7de840f181a704558d0bc845","801f9e9135034f49bf5f8b4bdefedb41",22899628,1,2,0,601,175,177,2
"801f9e9135034f49bf5f8b4bdefedb41","801f9e9135034f49bf5f8b4bdefedb41",22899628,7,0,1,602,177,177,0
"801f9e9135034f49bf5f8b4bdefedb41","362fcb0699a14845ab29b2340093e528",22899628,1,-3,0,609,177,174,-3
"362fcb0699a14845ab29b2340093e528","b87c552dd247427abe6ab5795b9c9d43",22899628,1,8,0,610,174,181,7
"b87c552dd247427abe6ab5795b9c9d43","ea38cc0e6e6e41edbabf210220808bf9",22899628,1,-2,0,611,181,179,-2
"ea38cc0e6e6e41edbabf210220808bf9","b87c552dd247427abe6ab5795b9c9d43",22899628,2,2,0,612,179,181,2
"b87c552dd247427abe6ab5795b9c9d43","b87c552dd247427abe6ab5795b9c9d43",22899628,7,0,1,613,181,181,0
"b87c552dd247427abe6ab5795b9c9d43","139b097acfca451689d80c9c6eebdf7b",22899628,2,-3,0,620,181,178,-3
"139b097acfca451689d80c9c6eebdf7b","30f660a1feb34582a739722532524f79",22899628,1,6,0,621,178,183,5
"30f660a1feb34582a739722532524f79","30f660a1feb34582a739722532524f79",22899628,5,0,1,622,183,183,0
"30f660a1feb34582a739722532524f79","2024b4885bd14338a39b7b509acbbd02",22899628,1,-1,0,627,183,182,-1
"2024b4885bd14338a39b7b509acbbd02","c3f63fe50d8e487c86bf8ef76c9cadd3",22899628,1,4,0,628,182,185,3
"c3f63fe50d8e487c86bf8ef76c9cadd3","c3f63fe50d8e487c86bf8ef76c9cadd3",22899628,1,0,1,629,185,185,0
"c3f63fe50d8e487c86bf8ef76c9cadd3","0c7262dff33c4087bc660ccf40f92f9c",22899628,1,-20,0,630,185,169,-16
"0c7262dff33c4087bc660ccf40f92f9c","c8e371568a0c4391b25796ae4e91952e",22899628,1,23,0,631,169,186,17
"c8e371568a0c4391b25796ae4e91952e","0c7262dff33c4087bc660ccf40f92f9c",22899628,1,-23,0,632,186,169,-17
"0c7262dff33c4087bc660ccf40f92f9c","0c7262dff33c4087bc660ccf40f92f9c",22899628,2,0,1,633,169,169,0
"78adeee1fa2c4fe0bc73f7bca9fcee86","3cbcea2be0984e7dbd5a48195af10ce7",22899628,3,8,0,692,160,165,5
"3cbcea2be0984e7dbd5a48195af10ce7","82e6285962b8400d9d6fc32436022a94",22899628,2,2,0,693,165,167,2
"82e6285962b8400d9d6fc32436022a94","78adeee1fa2c4fe0bc73f7bca9fcee86",22899628,1,-10,0,694,167,160,-7
"3cbcea2be0984e7dbd5a48195af10ce7","65202579580f4ad38d734b4ee39d22a8",22899628,1,-3,0,696,165,164,-1
"82e6285962b8400d9d6fc32436022a94","c8e371568a0c4391b25796ae4e91952e",22899628,1,30,0,707,167,186,19
"c8e371568a0c4391b25796ae4e91952e","c8e371568a0c4391b25796ae4e91952e",22899628,1,0,1,708,186,186,0
"c8e371568a0c4391b25796ae4e91952e","7d932b23e1c84326ae5aa4d3c0d813d1",22899628,1,2,0,709,186,188,2
"7d932b23e1c84326ae5aa4d3c0d813d1","7d932b23e1c84326ae5aa4d3c0d813d1",22899628,1,0,1,710,188,188,0
"7d932b23e1c84326ae5aa4d3c0d813d1","ab11d94c6c8948ea90b88f19d2cd502b",22899628,1,3,0,711,188,190,2
"ab11d94c6c8948ea90b88f19d2cd502b","c8e371568a0c4391b25796ae4e91952e",22899628,1,-5,0,712,190,186,-4
"c8e371568a0c4391b25796ae4e91952e","ab11d94c6c8948ea90b88f19d2cd502b",22899628,1,5,0,713,186,190,4
"ab11d94c6c8948ea90b88f19d2cd502b","ab11d94c6c8948ea90b88f19d2cd502b",22899628,1,0,1,714,190,190,0
"ab11d94c6c8948ea90b88f19d2cd502b","f992451ed6ad4e68bb9e68ad6be7c4be",22899628,1,2,0,715,190,192,2
"f992451ed6ad4e68bb9e68ad6be7c4be","f992451ed6ad4e68bb9e68ad6be7c4be",22899628,5,0,1,716,192,192,0
"f992451ed6ad4e68bb9e68ad6be7c4be","07b44a7a51e94c78b411c753fc39dab0",22899628,1,-3,0,721,192,189,-3
"07b44a7a51e94c78b411c753fc39dab0","6cd2dcaac46847d4a0bc53f296d90375",22899628,1,6,0,722,189,194,5
"6cd2dcaac46847d4a0bc53f296d90375","6cd2dcaac46847d4a0bc53f296d90375",22899628,1,0,1,723,194,194,0
"6cd2dcaac46847d4a0bc53f296d90375","2d2580c9411c4972909db508d6956a58",22899628,1,2,0,724,194,196,2
"2d2580c9411c4972909db508d6956a58","2d2580c9411c4972909db508d6956a58",22899628,9,0,1,725,196,196,0
"2d2580c9411c4972909db508d6956a58","5bddb3d9ed264f3984702f048c7e5340",22899628,1,1,0,734,196,197,1
"5bddb3d9ed264f3984702f048c7e5340","5bddb3d9ed264f3984702f048c7e5340",22899628,2,0,1,735,197,197,0
"5bddb3d9ed264f3984702f048c7e5340","d5e8e2bd12a2466b9d6d90855f0eb079",22899628,1,1,0,737,197,198,1
"d5e8e2bd12a2466b9d6d90855f0eb079","d5e8e2bd12a2466b9d6d90855f0eb079",22899628,2,0,1,738,198,198,0
"d5e8e2bd12a2466b9d6d90855f0eb079","017d7ca8e0394b91aaadc9574df2202c",22899628,1,-5,0,740,198,193,-5
"017d7ca8e0394b91aaadc9574df2202c","54e8e9f0ea3e45c4bf3b8ac799ee31b1",22899628,1,8,0,741,193,200,7
"54e8e9f0ea3e45c4bf3b8ac799ee31b1","54e8e9f0ea3e45c4bf3b8ac799ee31b1",22899628,1,0,1,742,200,200,0
"54e8e9f0ea3e45c4bf3b8ac799ee31b1","c614a00911be4877a075f19315530fb0",22899628,1,1,0,743,200,201,1
"c614a00911be4877a075f19315530fb0","c614a00911be4877a075f19315530fb0",22899628,6,0,1,744,201,201,0
"c614a00911be4877a075f19315530fb0","bb329d880ab54120adaf203a693bb203",22899628,1,2,0,750,201,203,2
"bb329d880ab54120adaf203a693bb203","bb329d880ab54120adaf203a693bb203",22899628,1,0,1,751,203,203,0
"bb329d880ab54120adaf203a693bb203","f9170dd6bc6442b4acd832747609b09a",22899628,1,-4,0,752,203,199,-4
"f9170dd6bc6442b4acd832747609b09a","334c2344009840079b1d0e1b7ce3d5a7",22899628,1,7,0,753,199,205,6
"334c2344009840079b1d0e1b7ce3d5a7","334c2344009840079b1d0e1b7ce3d5a7",22899628,1,0,1,754,205,205,0
"334c2344009840079b1d0e1b7ce3d5a7","d7f13c8d63ec4e2aa673fbb9cf9c6933",22899628,1,3,0,755,205,206,1
"d7f13c8d63ec4e2aa673fbb9cf9c6933","c8e371568a0c4391b25796ae4e91952e",22899628,1,-26,0,756,206,186,-20
"c8e371568a0c4391b25796ae4e91952e","b9e80f77c3a44349863b19875725c384",22899628,1,27,0,757,186,207,21
"b9e80f77c3a44349863b19875725c384","7108f0e4c2584f1f9c471689ae4c885c",22899628,2,1,0,758,207,208,1
"7108f0e4c2584f1f9c471689ae4c885c","b9e80f77c3a44349863b19875725c384",22899628,1,-1,0,759,208,207,-1
"b9e80f77c3a44349863b19875725c384","b9e80f77c3a44349863b19875725c384",22899628,19,0,1,760,207,207,0
"7108f0e4c2584f1f9c471689ae4c885c","7108f0e4c2584f1f9c471689ae4c885c",22899628,14,0,1,780,208,208,0
"7108f0e4c2584f1f9c471689ae4c885c","09400e101c5d4b439cf9a26b03aae558",22899628,1,3,0,794,208,210,2
"09400e101c5d4b439cf9a26b03aae558","d7f13c8d63ec4e2aa673fbb9cf9c6933",22899628,1,-5,0,795,210,206,-4
"d7f13c8d63ec4e2aa673fbb9cf9c6933","09400e101c5d4b439cf9a26b03aae558",22899628,1,5,0,796,206,210,4
"09400e101c5d4b439cf9a26b03aae558","a88efa7e50ce47159810ab553afa6d3a",22899628,1,2,0,797,210,212,2
"a88efa7e50ce47159810ab553afa6d3a","a88efa7e50ce47159810ab553afa6d3a",22899628,5,0,1,798,212,212,0
"a88efa7e50ce47159810ab553afa6d3a","a875096404ef4a9984b62d74cda916f9",22899628,1,-3,0,803,212,209,-3
"a875096404ef4a9984b62d74cda916f9","be502a7a43c44bf7b682698de79d9369",22899628,1,6,0,804,209,214,5
"f7fb1952f56b4189b86a9f8b7862d2b8","0c7262dff33c4087bc660ccf40f92f9c",22899628,1,-60,0,806,215,169,-46
"0c7262dff33c4087bc660ccf40f92f9c","d7f13c8d63ec4e2aa673fbb9cf9c6933",22899628,1,49,0,807,169,206,37
"d7f13c8d63ec4e2aa673fbb9cf9c6933","ec341f459285443b8361f7f15638ff08",22899628,1,9,0,808,206,213,7
"ec341f459285443b8361f7f15638ff08","be502a7a43c44bf7b682698de79d9369",22899628,1,1,0,809,213,214,1
"f7fb1952f56b4189b86a9f8b7862d2b8","be502a7a43c44bf7b682698de79d9369",22899628,3,-1,0,811,215,214,-1
"f7fb1952f56b4189b86a9f8b7862d2b8","f7fb1952f56b4189b86a9f8b7862d2b8",22899628,18,0,1,813,215,215,0
"f7fb1952f56b4189b86a9f8b7862d2b8","b860ee85d8bc4a2f97958cfb71be3533",22899628,1,1,0,831,215,216,1
"b860ee85d8bc4a2f97958cfb71be3533","b860ee85d8bc4a2f97958cfb71be3533",22899628,8,0,1,832,216,216,0
"b860ee85d8bc4a2f97958cfb71be3533","ec341f459285443b8361f7f15638ff08",22899628,1,-3,0,840,216,213,-3
"363837c182e04711840d896ae1e0339c","363837c182e04711840d896ae1e0339c",22899628,13,0,1,842,218,218,0
"01b2051f8941460d89945e3b02d1ce78","be95c065e45447c1bd8215ea6f130c7a",22899628,1,3,0,856,217,219,2
"363837c182e04711840d896ae1e0339c","f7fb1952f56b4189b86a9f8b7862d2b8",22899628,1,-4,0,858,218,215,-3
"be502a7a43c44bf7b682698de79d9369","01b2051f8941460d89945e3b02d1ce78",22899628,1,4,0,860,214,217,3
"01b2051f8941460d89945e3b02d1ce78","be502a7a43c44bf7b682698de79d9369",22899628,3,-4,0,861,217,214,-3
"be502a7a43c44bf7b682698de79d9369","ec341f459285443b8361f7f15638ff08",22899628,1,-1,0,862,214,213,-1
"01b2051f8941460d89945e3b02d1ce78","91125ca626c5470eb145501f8c37f8db",22899628,3,4,0,865,217,220,3
"91125ca626c5470eb145501f8c37f8db","be95c065e45447c1bd8215ea6f130c7a",22899628,2,-1,0,866,220,219,-1
"be502a7a43c44bf7b682698de79d9369","be502a7a43c44bf7b682698de79d9369",22899628,1,0,1,870,214,214,0
"f7fb1952f56b4189b86a9f8b7862d2b8","ec341f459285443b8361f7f15638ff08",22899628,1,-2,0,872,215,213,-2
"be502a7a43c44bf7b682698de79d9369","363837c182e04711840d896ae1e0339c",22899628,1,5,0,882,214,218,4
"363837c182e04711840d896ae1e0339c","ec341f459285443b8361f7f15638ff08",22899628,1,-6,0,883,218,213,-5
"ec341f459285443b8361f7f15638ff08","01b2051f8941460d89945e3b02d1ce78",22899628,1,5,0,884,213,217,4
"91125ca626c5470eb145501f8c37f8db","91125ca626c5470eb145501f8c37f8db",22899628,1,0,1,886,220,220,0
"91125ca626c5470eb145501f8c37f8db","d7f13c8d63ec4e2aa673fbb9cf9c6933",22899628,1,-18,0,887,220,206,-14
"d7f13c8d63ec4e2aa673fbb9cf9c6933","1c6721b1f63f4d30ba7746ea8af02a52",22899628,1,21,0,888,206,221,15
"1c6721b1f63f4d30ba7746ea8af02a52","77ecef8eff6b4a2caea7707669bf7475",22899628,2,1,0,889,221,222,1
"77ecef8eff6b4a2caea7707669bf7475","77ecef8eff6b4a2caea7707669bf7475",22899628,12,0,1,890,222,222,0
"77ecef8eff6b4a2caea7707669bf7475","1c6721b1f63f4d30ba7746ea8af02a52",22899628,2,-1,0,902,222,221,-1
"1c6721b1f63f4d30ba7746ea8af02a52","d03cb855c70044cf8c35d9ec0de696e3",22899628,1,4,0,903,221,224,3
"8b9ae98743bd4d4a8a87dff1c1244211","0c7262dff33c4087bc660ccf40f92f9c",22899628,1,-77,0,905,227,169,-58
"65202579580f4ad38d734b4ee39d22a8","362fcb0699a14845ab29b2340093e528",22899628,1,18,0,915,164,174,10
"362fcb0699a14845ab29b2340093e528","0c7262dff33c4087bc660ccf40f92f9c",22899628,1,-6,0,916,174,169,-5
"b42cc17b7de840f181a704558d0bc845","362fcb0699a14845ab29b2340093e528",22899628,1,-1,0,918,175,174,-1
"362fcb0699a14845ab29b2340093e528","ea38cc0e6e6e41edbabf210220808bf9",22899628,1,6,0,919,174,179,5
"139b097acfca451689d80c9c6eebdf7b","0c7262dff33c4087bc660ccf40f92f9c",22899628,1,-11,0,922,178,169,-9
"0c7262dff33c4087bc660ccf40f92f9c","1c6721b1f63f4d30ba7746ea8af02a52",22899628,1,70,0,923,169,221,52
"1c6721b1f63f4d30ba7746ea8af02a52","1c6721b1f63f4d30ba7746ea8af02a52",22899628,1,0,1,924,221,221,0
"1c6721b1f63f4d30ba7746ea8af02a52","8b9ae98743bd4d4a8a87dff1c1244211",22899628,1,7,0,927,221,227,6
"8b9ae98743bd4d4a8a87dff1c1244211","d03cb855c70044cf8c35d9ec0de696e3",22899628,1,-3,0,928,227,224,-3
"d03cb855c70044cf8c35d9ec0de696e3","d03cb855c70044cf8c35d9ec0de696e3",22899628,1,0,1,929,224,224,0
"d03cb855c70044cf8c35d9ec0de696e3","a49a937d6896486d9a5396654abcf2e1",22899628,1,2,0,930,224,226,2
"a49a937d6896486d9a5396654abcf2e1","a49a937d6896486d9a5396654abcf2e1",22899628,1,0,1,931,226,226,0
"a49a937d6896486d9a5396654abcf2e1","8b9ae98743bd4d4a8a87dff1c1244211",22899628,1,1,0,932,226,227,1
"8b9ae98743bd4d4a8a87dff1c1244211","8b9ae98743bd4d4a8a87dff1c1244211",22899628,27,0,1,933,227,227,0
"8b9ae98743bd4d4a8a87dff1c1244211","2ab1535aac1346ba8801535bf729ef37",22899628,1,3,0,960,227,229,2
"f7906d6f59b9489a91d2ef40db5a474d","2ab1535aac1346ba8801535bf729ef37",22899628,1,7,0,962,223,229,6
"2ab1535aac1346ba8801535bf729ef37","a4f40fb48a8542c8949bae1f002cd9bc",22899628,1,2,0,963,229,231,2
"a4f40fb48a8542c8949bae1f002cd9bc","a4f40fb48a8542c8949bae1f002cd9bc",22899628,2,0,1,964,231,231,0
"a4f40fb48a8542c8949bae1f002cd9bc","8972c23e32044edb8a78fa1eed4e5947",22899628,1,1,0,966,231,232,1
"8972c23e32044edb8a78fa1eed4e5947","8972c23e32044edb8a78fa1eed4e5947",22899628,1,0,1,967,232,232,0
"8972c23e32044edb8a78fa1eed4e5947","92feb4a40f8344d38b6f722e42a53295",22899628,1,1,0,968,232,233,1
"92feb4a40f8344d38b6f722e42a53295","92feb4a40f8344d38b6f722e42a53295",22899628,2,0,1,969,233,233,0
"92feb4a40f8344d38b6f722e42a53295","5152833676bf4c6cb317060be10f68db",22899628,1,-5,0,971,233,228,-5
"5152833676bf4c6cb317060be10f68db","ca3e28f290354c08aefe5b0f769604e6",22899628,1,8,0,972,228,235,7
"ca3e28f290354c08aefe5b0f769604e6","ca3e28f290354c08aefe5b0f769604e6",22899628,13,0,1,973,235,235,0
"ca3e28f290354c08aefe5b0f769604e6","79a35eea833e4c2c9d22fc53c3c6445c",22899628,2,1,0,977,235,236,1
"79a35eea833e4c2c9d22fc53c3c6445c","79a35eea833e4c2c9d22fc53c3c6445c",22899628,8,0,1,978,236,236,0
"79a35eea833e4c2c9d22fc53c3c6445c","ca3e28f290354c08aefe5b0f769604e6",22899628,1,-1,0,982,236,235,-1
"79a35eea833e4c2c9d22fc53c3c6445c","8f68228b1518449e9615cdafee41a2bd",22899628,1,1,0,997,236,237,1
"8f68228b1518449e9615cdafee41a2bd","8f68228b1518449e9615cdafee41a2bd",22899628,1,0,1,998,237,237,0
"8f68228b1518449e9615cdafee41a2bd","cab89fa5c3ed45a5aa550fc0352d6a42",22899628,1,1,0,999,237,238,1
"cab89fa5c3ed45a5aa550fc0352d6a42","cab89fa5c3ed45a5aa550fc0352d6a42",22899628,6,0,1,1000,238,238,0
"cab89fa5c3ed45a5aa550fc0352d6a42","66d4fad4f1cf4b46be0750a99ad7a35a",22899628,1,1,0,1006,238,239,1
"66d4fad4f1cf4b46be0750a99ad7a35a","66d4fad4f1cf4b46be0750a99ad7a35a",22899628,1,0,1,1007,239,239,0
"66d4fad4f1cf4b46be0750a99ad7a35a","0b04c8e2f86d48c7aeb7e225819cd32b",22899628,1,-5,0,1008,239,234,-5
"0b04c8e2f86d48c7aeb7e225819cd32b","f53da5fd9bfe412da4b80d4742563b6c",22899628,1,8,0,1009,234,241,7
"f53da5fd9bfe412da4b80d4742563b6c","f53da5fd9bfe412da4b80d4742563b6c",22899628,1,0,1,1010,241,241,0
"f53da5fd9bfe412da4b80d4742563b6c","1c6721b1f63f4d30ba7746ea8af02a52",22899628,1,-24,0,1011,241,221,-20
"1c6721b1f63f4d30ba7746ea8af02a52","2ae94c0cea4d480a9d5dca8fb1d7b542",22899628,2,27,0,1012,221,242,21
"2ae94c0cea4d480a9d5dca8fb1d7b542","1ebf23f9d994469a85206e4c7b1bf5f5",22899628,2,3,0,1013,242,245,3
"1ebf23f9d994469a85206e4c7b1bf5f5","1ebf23f9d994469a85206e4c7b1bf5f5",22899628,10,0,1,1014,245,245,0
"1ebf23f9d994469a85206e4c7b1bf5f5","85ae675b83e8422da842cfd25596af99",22899628,1,1,0,1024,245,246,1
"85ae675b83e8422da842cfd25596af99","85ae675b83e8422da842cfd25596af99",22899628,1,0,1,1025,246,246,0
"85ae675b83e8422da842cfd25596af99","fa235f0f364d47e4ae1c87f47bf8e6ba",22899628,1,8,0,1026,246,252,6
"fa235f0f364d47e4ae1c87f47bf8e6ba","2ae94c0cea4d480a9d5dca8fb1d7b542",22899628,1,-12,0,1027,252,242,-10
"2ae94c0cea4d480a9d5dca8fb1d7b542","fa235f0f364d47e4ae1c87f47bf8e6ba",22899628,2,12,0,1028,242,252,10
"fa235f0f364d47e4ae1c87f47bf8e6ba","79f7845465cc4ed19d8e4f1429541be0",22899628,1,2,0,1029,252,254,2
"79f7845465cc4ed19d8e4f1429541be0","79f7845465cc4ed19d8e4f1429541be0",22899628,2,0,1,1030,254,254,0
"79f7845465cc4ed19d8e4f1429541be0","6e83e23f56544a19b94067c1c558d9c0",22899628,1,-8,0,1032,254,247,-7
"6e83e23f56544a19b94067c1c558d9c0","00f61990949545828dd12f1303d47504",22899628,1,11,0,1033,247,256,9
"00f61990949545828dd12f1303d47504","00f61990949545828dd12f1303d47504",22899628,1,0,1,1034,256,256,0
"00f61990949545828dd12f1303d47504","ead7bb4b64e247d2ae632ab8a296b091",22899628,1,2,0,1035,256,258,2
"ead7bb4b64e247d2ae632ab8a296b091","ead7bb4b64e247d2ae632ab8a296b091",22899628,2,0,1,1036,258,258,0
"ead7bb4b64e247d2ae632ab8a296b091","41b0048dde734bb280bac6116baa8e27",22899628,1,1,0,1038,258,259,1
"41b0048dde734bb280bac6116baa8e27","41b0048dde734bb280bac6116baa8e27",22899628,2,0,1,1039,259,259,0
"41b0048dde734bb280bac6116baa8e27","b41c5a094a604ee0915327da5cc0beb7",22899628,1,1,0,1041,259,260,1
"b41c5a094a604ee0915327da5cc0beb7","b41c5a094a604ee0915327da5cc0beb7",22899628,2,0,1,1042,260,260,0
"b41c5a094a604ee0915327da5cc0beb7","d546341988904f069cfa86b21457d9d9",22899628,1,-10,0,1044,260,251,-9
"d546341988904f069cfa86b21457d9d9","28c171777c52431ab6b925073bd63d46",22899628,1,15,0,1045,251,264,13
"28c171777c52431ab6b925073bd63d46","28c171777c52431ab6b925073bd63d46",22899628,11,0,1,1046,264,264,0
"28c171777c52431ab6b925073bd63d46","ac160db940cb49ae8579162b1d52bb5d",22899628,1,2,0,1057,264,266,2
"ac160db940cb49ae8579162b1d52bb5d","ac160db940cb49ae8579162b1d52bb5d",22899628,7,0,1,1058,266,266,0
"ac160db940cb49ae8579162b1d52bb5d","d989ebcfc12a4b669f0100dc1aa14f1e",22899628,1,-12,0,1065,266,255,-11
"d989ebcfc12a4b669f0100dc1aa14f1e","c6fd49b485cc4874b0bbdd9c6171e09c",22899628,1,15,0,1066,255,268,13
"c6fd49b485cc4874b0bbdd9c6171e09c","c6fd49b485cc4874b0bbdd9c6171e09c",22899628,7,0,1,1067,268,268,0
"c6fd49b485cc4874b0bbdd9c6171e09c","44240778a97c4af0937817499b75707b",22899628,1,1,0,1074,268,269,1
"44240778a97c4af0937817499b75707b","44240778a97c4af0937817499b75707b",22899628,2,0,1,1075,269,269,0
"44240778a97c4af0937817499b75707b","7aa76d3e993840d8805f097cbdbcd44b",22899628,1,-9,0,1077,269,261,-8
"7aa76d3e993840d8805f097cbdbcd44b","7028800abe7d4e27b613d1d6cbe26bf7",22899628,1,7,0,1078,261,267,6
"7028800abe7d4e27b613d1d6cbe26bf7","7aa76d3e993840d8805f097cbdbcd44b",22899628,1,-7,0,1079,267,261,-6
"7aa76d3e993840d8805f097cbdbcd44b","865a4d3b43374da7944dc7d397f566d9",22899628,1,12,0,1080,261,271,10
"865a4d3b43374da7944dc7d397f566d9","865a4d3b43374da7944dc7d397f566d9",22899628,1,0,1,1081,271,271,0
"865a4d3b43374da7944dc7d397f566d9","2ae94c0cea4d480a9d5dca8fb1d7b542",22899628,1,-35,0,1082,271,242,-29
"2ae94c0cea4d480a9d5dca8fb1d7b542","0d987bed3ffa4ed0b9a2e62e97b7b30f",22899628,2,38,0,1083,242,272,30
"0d987bed3ffa4ed0b9a2e62e97b7b30f","0d987bed3ffa4ed0b9a2e62e97b7b30f",22899628,1,0,1,1084,272,272,0
"0d987bed3ffa4ed0b9a2e62e97b7b30f","2ae94c0cea4d480a9d5dca8fb1d7b542",22899628,2,-38,0,1085,272,242,-30
"2ae94c0cea4d480a9d5dca8fb1d7b542","2ae94c0cea4d480a9d5dca8fb1d7b542",22899628,1,0,1,1086,242,242,0
"2ae94c0cea4d480a9d5dca8fb1d7b542","d7f13c8d63ec4e2aa673fbb9cf9c6933",22899628,1,-48,0,1087,242,206,-36
"d7f13c8d63ec4e2aa673fbb9cf9c6933","be95c065e45447c1bd8215ea6f130c7a",22899628,1,17,0,1088,206,219,13
"be95c065e45447c1bd8215ea6f130c7a","be95c065e45447c1bd8215ea6f130c7a",22899628,1,0,1,1089,219,219,0
"be95c065e45447c1bd8215ea6f130c7a","363837c182e04711840d896ae1e0339c",22899628,4,-2,0,1090,219,218,-1
"363837c182e04711840d896ae1e0339c","be502a7a43c44bf7b682698de79d9369",22899628,1,-5,0,1091,218,214,-4
"be502a7a43c44bf7b682698de79d9369","f7fb1952f56b4189b86a9f8b7862d2b8",22899628,6,1,0,1092,214,215,1
"f7fb1952f56b4189b86a9f8b7862d2b8","01b2051f8941460d89945e3b02d1ce78",22899628,1,3,0,1093,215,217,2
"01b2051f8941460d89945e3b02d1ce78","ec341f459285443b8361f7f15638ff08",22899628,1,-5,0,1094,217,213,-4
"ec341f459285443b8361f7f15638ff08","363837c182e04711840d896ae1e0339c",22899628,4,6,0,1095,213,218,5
"363837c182e04711840d896ae1e0339c","01b2051f8941460d89945e3b02d1ce78",22899628,6,-1,0,1096,218,217,-1
"01b2051f8941460d89945e3b02d1ce78","1c6721b1f63f4d30ba7746ea8af02a52",22899628,1,7,0,1097,217,221,4
"1c6721b1f63f4d30ba7746ea8af02a52","d7f13c8d63ec4e2aa673fbb9cf9c6933",22899628,1,-21,0,1098,221,206,-15
"d7f13c8d63ec4e2aa673fbb9cf9c6933","77ecef8eff6b4a2caea7707669bf7475",22899628,1,22,0,1099,206,222,16
"77ecef8eff6b4a2caea7707669bf7475","d03cb855c70044cf8c35d9ec0de696e3",22899628,1,3,0,1100,222,224,2
"d03cb855c70044cf8c35d9ec0de696e3","8b9ae98743bd4d4a8a87dff1c1244211",22899628,2,3,0,1101,224,227,3
"8b9ae98743bd4d4a8a87dff1c1244211","1c6721b1f63f4d30ba7746ea8af02a52",22899628,1,-7,0,1102,227,221,-6
"1c6721b1f63f4d30ba7746ea8af02a52","2ab1535aac1346ba8801535bf729ef37",22899628,1,10,0,1103,221,229,8
"2ab1535aac1346ba8801535bf729ef37","f7906d6f59b9489a91d2ef40db5a474d",22899628,2,-7,0,1104,229,223,-6
"f7906d6f59b9489a91d2ef40db5a474d","5152833676bf4c6cb317060be10f68db",22899628,1,6,0,1105,223,228,5
"5152833676bf4c6cb317060be10f68db","0b04c8e2f86d48c7aeb7e225819cd32b",22899628,1,7,0,1106,228,234,6
"0b04c8e2f86d48c7aeb7e225819cd32b","1c6721b1f63f4d30ba7746ea8af02a52",22899628,1,-16,0,1107,234,221,-13
"1ebf23f9d994469a85206e4c7b1bf5f5","2ae94c0cea4d480a9d5dca8fb1d7b542",22899628,1,-3,0,1110,245,242,-3
"fa235f0f364d47e4ae1c87f47bf8e6ba","00f61990949545828dd12f1303d47504",22899628,1,5,0,1112,252,256,4
"00f61990949545828dd12f1303d47504","6e83e23f56544a19b94067c1c558d9c0",22899628,1,-11,0,1113,256,247,-9
"6e83e23f56544a19b94067c1c558d9c0","d546341988904f069cfa86b21457d9d9",22899628,1,5,0,1114,247,251,4
"d546341988904f069cfa86b21457d9d9","d989ebcfc12a4b669f0100dc1aa14f1e",22899628,1,5,0,1115,251,255,4
"d989ebcfc12a4b669f0100dc1aa14f1e","7aa76d3e993840d8805f097cbdbcd44b",22899628,1,7,0,1116,255,261,6
"7aa76d3e993840d8805f097cbdbcd44b","0d987bed3ffa4ed0b9a2e62e97b7b30f",22899628,1,15,0,1117,261,272,11
"0d987bed3ffa4ed0b9a2e62e97b7b30f","bb5a47f5ea01454a8b79455422d3b9da",22899628,2,10,0,1120,272,280,8
"bb5a47f5ea01454a8b79455422d3b9da","bb5a47f5ea01454a8b79455422d3b9da",22899628,78,0,1,1121,280,280,0
"bb5a47f5ea01454a8b79455422d3b9da","82ae07bc0c9b4570a41799290d1ef399",22899628,1,-6,0,1124,280,275,-5
"82ae07bc0c9b4570a41799290d1ef399","bb5a47f5ea01454a8b79455422d3b9da",22899628,4,6,0,1125,275,280,5
"bb5a47f5ea01454a8b79455422d3b9da","bc5524e78a8544e2ae2fdc2f3462bbec",22899628,2,-1,0,1129,280,279,-1
"bc5524e78a8544e2ae2fdc2f3462bbec","82ae07bc0c9b4570a41799290d1ef399",22899628,2,-5,0,1130,279,275,-4
"82ae07bc0c9b4570a41799290d1ef399","0d987bed3ffa4ed0b9a2e62e97b7b30f",22899628,3,-4,0,1131,275,272,-3
"0d987bed3ffa4ed0b9a2e62e97b7b30f","82ae07bc0c9b4570a41799290d1ef399",22899628,4,4,0,1132,272,275,3
"bb5a47f5ea01454a8b79455422d3b9da","0d987bed3ffa4ed0b9a2e62e97b7b30f",22899628,1,-10,0,1141,280,272,-8
"82ae07bc0c9b4570a41799290d1ef399","82ae07bc0c9b4570a41799290d1ef399",22899628,1,0,1,1143,275,275,0
"bb5a47f5ea01454a8b79455422d3b9da","0c7262dff33c4087bc660ccf40f92f9c",22899628,1,-145,0,1208,280,169,-111
"0c7262dff33c4087bc660ccf40f92f9c","78adeee1fa2c4fe0bc73f7bca9fcee86",22899628,3,-17,0,1209,169,160,-9
"78adeee1fa2c4fe0bc73f7bca9fcee86","78adeee1fa2c4fe0bc73f7bca9fcee86",22899628,3,0,1,1210,160,160,0
"78adeee1fa2c4fe0bc73f7bca9fcee86","65202579580f4ad38d734b4ee39d22a8",22899628,5,5,0,1211,160,164,4
"65202579580f4ad38d734b4ee39d22a8","78adeee1fa2c4fe0bc73f7bca9fcee86",22899628,3,-5,0,1212,164,160,-4
"65202579580f4ad38d734b4ee39d22a8","65202579580f4ad38d734b4ee39d22a8",22899628,81,0,1,1214,164,164,0
"65202579580f4ad38d734b4ee39d22a8","67a089198fcb4e1c8f2385786c2b296f",22899628,1,-157,0,1222,164,39,-125
"67a089198fcb4e1c8f2385786c2b296f","94cecc3f1e7d484b8e068e79241dfd73",22899628,1,317,0,1223,39,281,242
"94cecc3f1e7d484b8e068e79241dfd73","94cecc3f1e7d484b8e068e79241dfd73",22899628,1,0,1,1224,281,281,0
"94cecc3f1e7d484b8e068e79241dfd73","a37477c4e4c14169ad44b06b493007f6",22899628,1,2,0,1225,281,283,2
"a37477c4e4c14169ad44b06b493007f6","0d987bed3ffa4ed0b9a2e62e97b7b30f",22899628,1,-15,0,1226,283,272,-11
"bb5a47f5ea01454a8b79455422d3b9da","4a29443515bb404cb8924e1c60a63b73",22899628,1,12,0,1237,280,285,5
"4a29443515bb404cb8924e1c60a63b73","4a29443515bb404cb8924e1c60a63b73",22899628,1,0,1,1238,285,285,0
"4a29443515bb404cb8924e1c60a63b73","208c9b2796c944db8dacaa96082520ea",22899628,1,3,0,1239,285,288,3
"208c9b2796c944db8dacaa96082520ea","208c9b2796c944db8dacaa96082520ea",22899628,1,0,1,1240,288,288,0
"208c9b2796c944db8dacaa96082520ea","4a29443515bb404cb8924e1c60a63b73",22899628,1,-3,0,1241,288,285,-3
"4a29443515bb404cb8924e1c60a63b73","6a9a3b5bde4a48daa896fe8c06eca56f",22899628,1,5,0,1242,285,289,4
"6a9a3b5bde4a48daa896fe8c06eca56f","869e967078f04da18dd0b0b9389a7424",22899628,2,5,0,1243,289,293,4
"869e967078f04da18dd0b0b9389a7424","34a6e49023fc4465bd5ca604330bbd1c",22899628,1,-1,0,1244,293,292,-1
"34a6e49023fc4465bd5ca604330bbd1c","7669a956527947d0add87455277e80b4",22899628,1,-2,0,1245,292,291,-1
"7669a956527947d0add87455277e80b4","7669a956527947d0add87455277e80b4",22899628,1,0,1,1246,291,291,0
"7669a956527947d0add87455277e80b4","6a9a3b5bde4a48daa896fe8c06eca56f",22899628,1,-2,0,1247,291,289,-2
"869e967078f04da18dd0b0b9389a7424","869e967078f04da18dd0b0b9389a7424",22899628,1,0,1,1249,293,293,0
"869e967078f04da18dd0b0b9389a7424","51ab6291537748fab90d519aa09889d6",22899628,1,2,0,1250,293,295,2
"51ab6291537748fab90d519aa09889d6","51ab6291537748fab90d519aa09889d6",22899628,5,0,1,1251,295,295,0
"51ab6291537748fab90d519aa09889d6","34a6e49023fc4465bd5ca604330bbd1c",22899628,1,-3,0,1256,295,292,-3
"34a6e49023fc4465bd5ca604330bbd1c","ba0e59461bfb4a44b7b1c28a01f8d3b3",22899628,1,9,0,1257,292,299,7
"ba0e59461bfb4a44b7b1c28a01f8d3b3","21592f2a9e9c4b2f8c66ec5dbcbf6a2b",22899628,1,-4,0,1258,299,296,-3
"21592f2a9e9c4b2f8c66ec5dbcbf6a2b","ba0e59461bfb4a44b7b1c28a01f8d3b3",22899628,1,4,0,1259,296,299,3
"ba0e59461bfb4a44b7b1c28a01f8d3b3","0e0b36e731a645e7b1b8a88f5031ca38",22899628,1,2,0,1260,299,301,2
"0e0b36e731a645e7b1b8a88f5031ca38","0e0b36e731a645e7b1b8a88f5031ca38",22899628,5,0,1,1261,301,301,0
"0e0b36e731a645e7b1b8a88f5031ca38","a66a144637284c21afc6de17fea4bfb8",22899628,1,1,0,1266,301,302,1
"a66a144637284c21afc6de17fea4bfb8","a66a144637284c21afc6de17fea4bfb8",22899628,2,0,1,1267,302,302,0
"a66a144637284c21afc6de17fea4bfb8","7646a919d7e64fa990bca9b024ff089d",22899628,1,-4,0,1269,302,298,-4
"7646a919d7e64fa990bca9b024ff089d","ba0e59461bfb4a44b7b1c28a01f8d3b3",22899628,1,1,0,1270,298,299,1
"ba0e59461bfb4a44b7b1c28a01f8d3b3","2c5bb2cbd0014420ad8c95d40e38efd1",22899628,1,5,0,1271,299,303,4
"2c5bb2cbd0014420ad8c95d40e38efd1","7646a919d7e64fa990bca9b024ff089d",22899628,1,-6,0,1272,303,298,-5
"7646a919d7e64fa990bca9b024ff089d","e390b575229748ea8aac9364efe2bf00",22899628,1,7,0,1273,298,304,6
"e390b575229748ea8aac9364efe2bf00","e390b575229748ea8aac9364efe2bf00",22899628,1,0,1,1274,304,304,0
"e390b575229748ea8aac9364efe2bf00","3434c10e561d488a914e0f7d71907abd",22899628,1,3,0,1275,304,305,1
"3434c10e561d488a914e0f7d71907abd","4a29443515bb404cb8924e1c60a63b73",22899628,1,-27,0,1276,305,285,-20
"4a29443515bb404cb8924e1c60a63b73","53e7e900392747ccad52e711ab0f80d8",22899628,1,29,0,1277,285,307,22
"53e7e900392747ccad52e711ab0f80d8","4a29443515bb404cb8924e1c60a63b73",22899628,1,-29,0,1278,307,285,-22
"4a29443515bb404cb8924e1c60a63b73","3434c10e561d488a914e0f7d71907abd",22899628,1,27,0,1279,285,305,20
"3434c10e561d488a914e0f7d71907abd","3434c10e561d488a914e0f7d71907abd",22899628,2,0,1,1280,305,305,0
"3434c10e561d488a914e0f7d71907abd","53e7e900392747ccad52e711ab0f80d8",22899628,2,2,0,1281,305,307,2
"53e7e900392747ccad52e711ab0f80d8","53e7e900392747ccad52e711ab0f80d8",22899628,1,0,1,1282,307,307,0
"53e7e900392747ccad52e711ab0f80d8","130acc2aeb0448fdbb2de63bc5cebe5b",22899628,1,3,0,1283,307,309,2
"130acc2aeb0448fdbb2de63bc5cebe5b","3434c10e561d488a914e0f7d71907abd",22899628,1,-5,0,1284,309,305,-4
"3434c10e561d488a914e0f7d71907abd","130acc2aeb0448fdbb2de63bc5cebe5b",22899628,2,5,0,1285,305,309,4
"130acc2aeb0448fdbb2de63bc5cebe5b","9c062b3251034ebe90f5054e2a3b5120",22899628,1,2,0,1286,309,311,2
"9c062b3251034ebe90f5054e2a3b5120","9c062b3251034ebe90f5054e2a3b5120",22899628,2,0,1,1287,311,311,0
"9c062b3251034ebe90f5054e2a3b5120","ea859f8207e44537889daeaba13ac2e8",22899628,1,1,0,1289,311,312,1
"ea859f8207e44537889daeaba13ac2e8","ea859f8207e44537889daeaba13ac2e8",22899628,10,0,1,1290,312,312,0
"ea859f8207e44537889daeaba13ac2e8","56d94971a7a94257aa330183a8ebd0ea",22899628,1,1,0,1300,312,313,1
"56d94971a7a94257aa330183a8ebd0ea","56d94971a7a94257aa330183a8ebd0ea",22899628,4,0,1,1301,313,313,0
"56d94971a7a94257aa330183a8ebd0ea","141c0df6cd1946539aadd1c9b7068cd4",22899628,1,-5,0,1305,313,308,-5
"141c0df6cd1946539aadd1c9b7068cd4","13255e63e0aa4abf85e5211bf613d43e",22899628,1,10,0,1306,308,317,9
"13255e63e0aa4abf85e5211bf613d43e","13255e63e0aa4abf85e5211bf613d43e",22899628,3,0,1,1307,317,317,0
"13255e63e0aa4abf85e5211bf613d43e","0c787d16c9504873b1a4d903cec09948",22899628,1,-3,0,1310,317,314,-3
"0c787d16c9504873b1a4d903cec09948","86c27d40179e419c8e9d150fb6afa5d0",22899628,2,6,0,1311,314,319,5
"86c27d40179e419c8e9d150fb6afa5d0","4a29443515bb404cb8924e1c60a63b73",22899628,1,-44,0,1312,319,285,-34
"4a29443515bb404cb8924e1c60a63b73","8d7e0b55cf9849cda222a0f2440cec55",22899628,1,43,0,1313,285,318,33
"8d7e0b55cf9849cda222a0f2440cec55","3434c10e561d488a914e0f7d71907abd",22899628,1,-16,0,1314,318,305,-13
"3434c10e561d488a914e0f7d71907abd","86c27d40179e419c8e9d150fb6afa5d0",22899628,2,17,0,1315,305,319,14
"86c27d40179e419c8e9d150fb6afa5d0","86c27d40179e419c8e9d150fb6afa5d0",22899628,1,0,1,1316,319,319,0
"86c27d40179e419c8e9d150fb6afa5d0","8d7e0b55cf9849cda222a0f2440cec55",22899628,2,-1,0,1317,319,318,-1
"8d7e0b55cf9849cda222a0f2440cec55","47edbb64109243e6b0f8f64cdef90c6c",22899628,1,9,0,1318,318,326,8
"47edbb64109243e6b0f8f64cdef90c6c","24f1363179ad4aaa965484a78471912b",22899628,1,-3,0,1319,326,323,-3
"24f1363179ad4aaa965484a78471912b","24f1363179ad4aaa965484a78471912b",22899628,1,0,1,1320,323,323,0
"24f1363179ad4aaa965484a78471912b","3434c10e561d488a914e0f7d71907abd",22899628,1,-22,0,1321,323,305,-18
"8d7e0b55cf9849cda222a0f2440cec55","24f1363179ad4aaa965484a78471912b",22899628,1,6,0,1324,318,323,5
"24f1363179ad4aaa965484a78471912b","47edbb64109243e6b0f8f64cdef90c6c",22899628,2,3,0,1325,323,326,3
"47edbb64109243e6b0f8f64cdef90c6c","3628bdce1dd2429ba924d2d4d09448d2",22899628,1,-4,0,1326,326,322,-4
"3628bdce1dd2429ba924d2d4d09448d2","56b3fd1a212a4764be39d979fde3326e",22899628,1,7,0,1327,322,328,6
"56b3fd1a212a4764be39d979fde3326e","56b3fd1a212a4764be39d979fde3326e",22899628,1,0,1,1328,328,328,0
"56b3fd1a212a4764be39d979fde3326e","0c4079457ede49e3aeb5e86ed84bdf35",22899628,1,3,0,1329,328,329,1
"0c4079457ede49e3aeb5e86ed84bdf35","3434c10e561d488a914e0f7d71907abd",22899628,2,-31,0,1330,329,305,-24
"3434c10e561d488a914e0f7d71907abd","38aea304b4fa46e1b29bb72f5cea4c93",22899628,2,33,0,1331,305,331,26
"38aea304b4fa46e1b29bb72f5cea4c93","38aea304b4fa46e1b29bb72f5cea4c93",22899628,1,0,1,1332,331,331,0
"38aea304b4fa46e1b29bb72f5cea4c93","e36d261332f14e79bb4b467aceaeb9b5",22899628,1,2,0,1333,331,333,2
"e36d261332f14e79bb4b467aceaeb9b5","e36d261332f14e79bb4b467aceaeb9b5",22899628,1,0,1,1334,333,333,0
"e36d261332f14e79bb4b467aceaeb9b5","c7e89b9d04744d2eab742fc24e3ef1ae",22899628,1,1,0,1335,333,334,1
"c7e89b9d04744d2eab742fc24e3ef1ae","c7e89b9d04744d2eab742fc24e3ef1ae",22899628,2,0,1,1336,334,334,0
"c7e89b9d04744d2eab742fc24e3ef1ae","fe49f8054b374a0ea4bb266ed135ff62",22899628,1,1,0,1338,334,335,1
"fe49f8054b374a0ea4bb266ed135ff62","fe49f8054b374a0ea4bb266ed135ff62",22899628,5,0,1,1339,335,335,0
"fe49f8054b374a0ea4bb266ed135ff62","d0a8f74af98642fe8360d22c42e45117",22899628,1,1,0,1344,335,336,1
"d0a8f74af98642fe8360d22c42e45117","d0a8f74af98642fe8360d22c42e45117",22899628,2,0,1,1345,336,336,0
"d0a8f74af98642fe8360d22c42e45117","0c4079457ede49e3aeb5e86ed84bdf35",22899628,1,-7,0,1347,336,329,-7
"0c4079457ede49e3aeb5e86ed84bdf35","a7c6339ca1da4368a18d471f0519f877",22899628,1,11,0,1348,329,339,10
"a7c6339ca1da4368a18d471f0519f877","a7c6339ca1da4368a18d471f0519f877",22899628,1,0,1,1349,339,339,0
"a7c6339ca1da4368a18d471f0519f877","bbc5139ca9024389a94db3a6f47dcff6",22899628,1,3,0,1350,339,341,2
"bbc5139ca9024389a94db3a6f47dcff6","b8b9418ab322418d9db9b40d96af873a",22899628,2,-5,0,1351,341,337,-4
"b8b9418ab322418d9db9b40d96af873a","4a29443515bb404cb8924e1c60a63b73",22899628,1,-67,0,1352,337,285,-52
"4a29443515bb404cb8924e1c60a63b73","0c4079457ede49e3aeb5e86ed84bdf35",22899628,1,58,0,1353,285,329,44
"0c4079457ede49e3aeb5e86ed84bdf35","c2490bc612d146edbe786556fab3651b",22899628,1,13,0,1354,329,340,11
"c2490bc612d146edbe786556fab3651b","bbc5139ca9024389a94db3a6f47dcff6",22899628,1,1,0,1355,340,341,1
"bbc5139ca9024389a94db3a6f47dcff6","bbc5139ca9024389a94db3a6f47dcff6",22899628,1,0,1,1356,341,341,0
"bbc5139ca9024389a94db3a6f47dcff6","4ee6ca9019ab4a1ab323f98094a9bd77",22899628,1,2,0,1357,341,343,2
"4ee6ca9019ab4a1ab323f98094a9bd77","4ee6ca9019ab4a1ab323f98094a9bd77",22899628,2,0,1,1358,343,343,0
"4ee6ca9019ab4a1ab323f98094a9bd77","b37947176785476f8b29d49a851366dc",22899628,1,1,0,1360,343,344,1
"b37947176785476f8b29d49a851366dc","b37947176785476f8b29d49a851366dc",22899628,2,0,1,1361,344,344,0
"b37947176785476f8b29d49a851366dc","fcea5b10d5a14a3b9324ffece8f6e1e5",22899628,1,1,0,1363,344,345,1
"fcea5b10d5a14a3b9324ffece8f6e1e5","fcea5b10d5a14a3b9324ffece8f6e1e5",22899628,2,0,1,1364,345,345,0
"fcea5b10d5a14a3b9324ffece8f6e1e5","c2490bc612d146edbe786556fab3651b",22899628,1,-5,0,1366,345,340,-5
"c2490bc612d146edbe786556fab3651b","6ac8bb048b854999a47edb35fe627f11",22899628,1,8,0,1367,340,347,7
"6ac8bb048b854999a47edb35fe627f11","6ac8bb048b854999a47edb35fe627f11",22899628,1,0,1,1368,347,347,0
"6ac8bb048b854999a47edb35fe627f11","0c4079457ede49e3aeb5e86ed84bdf35",22899628,1,-21,0,1369,347,329,-18
"0c4079457ede49e3aeb5e86ed84bdf35","30ead9794d4847abaf222ca966cc8630",22899628,1,24,0,1370,329,348,19
"30ead9794d4847abaf222ca966cc8630","09b9678ddc3d452ea4a3d46e15826065",22899628,1,5,0,1371,348,353,5
"09b9678ddc3d452ea4a3d46e15826065","897b7f51242c44aab2205c72fdcbf4cd",22899628,1,-1,0,1372,353,352,-1
"897b7f51242c44aab2205c72fdcbf4cd","eff0de7f2dbb42dfa1a2e686efab5b6d",22899628,2,2,0,1373,352,354,2
"eff0de7f2dbb42dfa1a2e686efab5b6d","c20993c944444fe085345591a8bd837e",22899628,2,-3,0,1374,354,351,-3
"c20993c944444fe085345591a8bd837e","c20993c944444fe085345591a8bd837e",22899628,5,0,1,1375,351,351,0
"c20993c944444fe085345591a8bd837e","897b7f51242c44aab2205c72fdcbf4cd",22899628,1,1,0,1379,351,352,1
"897b7f51242c44aab2205c72fdcbf4cd","897b7f51242c44aab2205c72fdcbf4cd",22899628,5,0,1,1380,352,352,0
"897b7f51242c44aab2205c72fdcbf4cd","09b9678ddc3d452ea4a3d46e15826065",22899628,1,1,0,1383,352,353,1
"09b9678ddc3d452ea4a3d46e15826065","09b9678ddc3d452ea4a3d46e15826065",22899628,4,0,1,1384,353,353,0
"09b9678ddc3d452ea4a3d46e15826065","eff0de7f2dbb42dfa1a2e686efab5b6d",22899628,2,1,0,1387,353,354,1
"eff0de7f2dbb42dfa1a2e686efab5b6d","eff0de7f2dbb42dfa1a2e686efab5b6d",22899628,4,0,1,1388,354,354,0
"eff0de7f2dbb42dfa1a2e686efab5b6d","30ead9794d4847abaf222ca966cc8630",22899628,1,-6,0,1391,354,348,-6
"30ead9794d4847abaf222ca966cc8630","2fe14166dc9642c3bc666b86a57f943d",22899628,3,10,0,1392,348,357,9
"2fe14166dc9642c3bc666b86a57f943d","2fe14166dc9642c3bc666b86a57f943d",22899628,2,0,1,1393,357,357,0
"2fe14166dc9642c3bc666b86a57f943d","44421dd1e13a47a388c4a19834b744c7",22899628,2,2,0,1394,357,359,2
"44421dd1e13a47a388c4a19834b744c7","44421dd1e13a47a388c4a19834b744c7",22899628,4,0,1,1395,359,359,0
"44421dd1e13a47a388c4a19834b744c7","1ba8fef685d74a8194b9db252eb704fb",22899628,1,-4,0,1397,359,355,-4
"1ba8fef685d74a8194b9db252eb704fb","30ead9794d4847abaf222ca966cc8630",22899628,2,-8,0,1398,355,348,-7
"44421dd1e13a47a388c4a19834b744c7","cb5fc7ef85d547c4be1a7439d0bf6052",22899628,1,1,0,1404,359,360,1
"cb5fc7ef85d547c4be1a7439d0bf6052","cb5fc7ef85d547c4be1a7439d0bf6052",22899628,5,0,1,1405,360,360,0
"cb5fc7ef85d547c4be1a7439d0bf6052","0a8f150a4cf747acbde62f4721823da3",22899628,1,1,0,1410,360,361,1
"0a8f150a4cf747acbde62f4721823da3","0a8f150a4cf747acbde62f4721823da3",22899628,2,0,1,1411,361,361,0
"0a8f150a4cf747acbde62f4721823da3","ab8fdad974ae471f9f24c3f9dd04462e",22899628,1,1,0,1413,361,362,1
"ab8fdad974ae471f9f24c3f9dd04462e","ab8fdad974ae471f9f24c3f9dd04462e",22899628,2,0,1,1414,362,362,0
"ab8fdad974ae471f9f24c3f9dd04462e","52580888dadb4fe3baa795683ea227bd",22899628,1,3,0,1416,362,364,2
"52580888dadb4fe3baa795683ea227bd","1ba8fef685d74a8194b9db252eb704fb",22899628,1,-10,0,1417,364,355,-9
"1ba8fef685d74a8194b9db252eb704fb","52580888dadb4fe3baa795683ea227bd",22899628,2,10,0,1418,355,364,9
"52580888dadb4fe3baa795683ea227bd","f00179e251a045b39c3f7a54f9aa4acc",22899628,2,-1,0,1419,364,363,-1
"f00179e251a045b39c3f7a54f9aa4acc","492a3bc6a1254f23a7998587961b22a4",22899628,2,4,0,1420,363,366,3
"492a3bc6a1254f23a7998587961b22a4","492a3bc6a1254f23a7998587961b22a4",22899628,1,0,1,1421,366,366,0
"492a3bc6a1254f23a7998587961b22a4","072a190fd302456290895f9f04d6940a",22899628,2,-1,0,1422,366,365,-1
"072a190fd302456290895f9f04d6940a","1ba8fef685d74a8194b9db252eb704fb",22899628,1,-12,0,1423,365,355,-10
"2fe14166dc9642c3bc666b86a57f943d","cfa457d1743848e4bb5e4beced6448ed",22899628,1,15,0,1426,357,369,12
"cfa457d1743848e4bb5e4beced6448ed","cfa457d1743848e4bb5e4beced6448ed",22899628,1,0,1,1427,369,369,0
"cfa457d1743848e4bb5e4beced6448ed","30ead9794d4847abaf222ca966cc8630",22899628,1,-25,0,1428,369,348,-21
"30ead9794d4847abaf222ca966cc8630","b71bac264efb4abd97015447bd490db6",22899628,2,28,0,1429,348,370,22
"b71bac264efb4abd97015447bd490db6","8d448d625b024c82a5eb240bbd7431d6",22899628,3,5,0,1430,370,374,4
"8d448d625b024c82a5eb240bbd7431d6","8d448d625b024c82a5eb240bbd7431d6",22899628,56,0,1,1431,374,374,0
"8d448d625b024c82a5eb240bbd7431d6","b71bac264efb4abd97015447bd490db6",22899628,3,-5,0,1433,374,370,-4
"b71bac264efb4abd97015447bd490db6","d6d02b6ef04e4f17805504500b8ce441",22899628,2,8,0,1483,370,375,5
"d6d02b6ef04e4f17805504500b8ce441","d6d02b6ef04e4f17805504500b8ce441",22899628,6,0,1,1484,375,375,0
"d6d02b6ef04e4f17805504500b8ce441","66baf19b6b904b70922329068c63746d",22899628,2,4,0,1486,375,376,1
"66baf19b6b904b70922329068c63746d","7f544639412e40a9ba27f43b415362ab",22899628,3,2,0,1487,376,378,2
"7f544639412e40a9ba27f43b415362ab","66baf19b6b904b70922329068c63746d",22899628,1,-2,0,1488,378,376,-2
"7f544639412e40a9ba27f43b415362ab","7f544639412e40a9ba27f43b415362ab",22899628,2,0,1,1490,378,378,0
"7f544639412e40a9ba27f43b415362ab","d5ae8642e15b46b8bd298b02274d4e9c",22899628,1,2,0,1491,378,380,2
"d5ae8642e15b46b8bd298b02274d4e9c","d5ae8642e15b46b8bd298b02274d4e9c",22899628,1,0,1,1492,380,380,0
"d5ae8642e15b46b8bd298b02274d4e9c","a0d10309a2dd456289147f84be9d37f9",22899628,1,1,0,1493,380,381,1
"a0d10309a2dd456289147f84be9d37f9","a0d10309a2dd456289147f84be9d37f9",22899628,2,0,1,1494,381,381,0
"a0d10309a2dd456289147f84be9d37f9","0fcbc3ca07b144138b8d85da581f09a8",22899628,1,1,0,1496,381,382,1
"0fcbc3ca07b144138b8d85da581f09a8","0fcbc3ca07b144138b8d85da581f09a8",22899628,5,0,1,1497,382,382,0
"0fcbc3ca07b144138b8d85da581f09a8","66baf19b6b904b70922329068c63746d",22899628,1,-6,0,1502,382,376,-6
"66baf19b6b904b70922329068c63746d","4890121ce5d74576b4632b77cfc23398",22899628,1,14,0,1503,376,388,12
"4890121ce5d74576b4632b77cfc23398","c2fca3669923477ab966ded303dea31c",22899628,1,-6,0,1504,388,383,-5
"c2fca3669923477ab966ded303dea31c","4890121ce5d74576b4632b77cfc23398",22899628,2,6,0,1505,383,388,5
"4890121ce5d74576b4632b77cfc23398","18d3b836dd804224883cc9180b60a8e1",22899628,1,-1,0,1506,388,387,-1
"18d3b836dd804224883cc9180b60a8e1","96bb2b3e85a34d8b9544514e89f6fe97",22899628,1,4,0,1507,387,390,3
"96bb2b3e85a34d8b9544514e89f6fe97","96bb2b3e85a34d8b9544514e89f6fe97",22899628,1,0,1,1508,390,390,0
"96bb2b3e85a34d8b9544514e89f6fe97","ac4e9b54acfe4670b4634859c7263cb5",22899628,1,2,0,1509,390,392,2
"ac4e9b54acfe4670b4634859c7263cb5","ac4e9b54acfe4670b4634859c7263cb5",22899628,1,0,1,1510,392,392,0
"ac4e9b54acfe4670b4634859c7263cb5","17f95d18bab743888e1736033dc3384d",22899628,1,-3,0,1511,392,389,-3
"17f95d18bab743888e1736033dc3384d","6f8881a745ac4c358a68b92c3b4abe81",22899628,1,6,0,1512,389,394,5
"6f8881a745ac4c358a68b92c3b4abe81","6f8881a745ac4c358a68b92c3b4abe81",22899628,1,0,1,1513,394,394,0
"6f8881a745ac4c358a68b92c3b4abe81","f7002c8484354eceac57bc7bd62c76c1",22899628,1,-1,0,1514,394,393,-1
"f7002c8484354eceac57bc7bd62c76c1","0c12af0a4e7f4002852cf84b2537c161",22899628,1,3,0,1515,393,395,2
"0c12af0a4e7f4002852cf84b2537c161","859e0b8d71694b12befb69ee698138f9",22899628,1,5,0,1516,395,399,4
"859e0b8d71694b12befb69ee698138f9","859e0b8d71694b12befb69ee698138f9",22899628,1,0,1,1517,399,399,0
"859e0b8d71694b12befb69ee698138f9","2b09a08242b54983aec7063990fb3f66",22899628,1,3,0,1518,399,400,1
"2b09a08242b54983aec7063990fb3f66","66baf19b6b904b70922329068c63746d",22899628,1,-32,0,1519,400,376,-24
"66baf19b6b904b70922329068c63746d","2b09a08242b54983aec7063990fb3f66",22899628,2,32,0,1520,376,400,24
"2b09a08242b54983aec7063990fb3f66","2b09a08242b54983aec7063990fb3f66",22899628,3,0,1,1521,400,400,0
"2b09a08242b54983aec7063990fb3f66","1f471b7a883a4df48211e8c6a81b59a7",22899628,1,1,0,1522,400,401,1
"1f471b7a883a4df48211e8c6a81b59a7","1f471b7a883a4df48211e8c6a81b59a7",22899628,1,0,1,1523,401,401,0
"1f471b7a883a4df48211e8c6a81b59a7","2b09a08242b54983aec7063990fb3f66",22899628,1,-1,0,1524,401,400,-1
"2b09a08242b54983aec7063990fb3f66","9de0d567bfa84fe5b77cb76f4a76a5d1",22899628,1,5,0,1525,400,404,4
"9de0d567bfa84fe5b77cb76f4a76a5d1","9de0d567bfa84fe5b77cb76f4a76a5d1",22899628,1,0,1,1526,404,404,0
"9de0d567bfa84fe5b77cb76f4a76a5d1","1157bd665ec4472fb58b751dc5099355",22899628,1,-1,0,1527,404,403,-1
"1157bd665ec4472fb58b751dc5099355","3c8a22d2f9c146ea956609e3ed4f2559",22899628,1,3,0,1528,403,405,2
"3c8a22d2f9c146ea956609e3ed4f2559","58fc9094275e4c49be3f4ba6d4acc0a4",22899628,1,2,0,1529,405,406,1
"58fc9094275e4c49be3f4ba6d4acc0a4","58fc9094275e4c49be3f4ba6d4acc0a4",22899628,1,0,1,1530,406,406,0
"58fc9094275e4c49be3f4ba6d4acc0a4","c1c1be90b2b14c1ab4a5e1ee3c241902",22899628,1,1,0,1531,406,407,1
"c1c1be90b2b14c1ab4a5e1ee3c241902","c1c1be90b2b14c1ab4a5e1ee3c241902",22899628,5,0,1,1532,407,407,0
"c1c1be90b2b14c1ab4a5e1ee3c241902","02b3a1bead9244c1ba2f857c7da8f82a",22899628,1,2,0,1537,407,408,1
"02b3a1bead9244c1ba2f857c7da8f82a","58fc9094275e4c49be3f4ba6d4acc0a4",22899628,2,-3,0,1538,408,406,-2
"58fc9094275e4c49be3f4ba6d4acc0a4","02b3a1bead9244c1ba2f857c7da8f82a",22899628,1,3,0,1539,406,408,2
"02b3a1bead9244c1ba2f857c7da8f82a","6206fc6479014bb193084c32409dc1b9",22899628,1,1,0,1540,408,409,1
"6206fc6479014bb193084c32409dc1b9","6206fc6479014bb193084c32409dc1b9",22899628,4,0,1,1541,409,409,0
"6206fc6479014bb193084c32409dc1b9","6a5f020451db426dacba9e2ea3fcc62a",22899628,1,2,0,1545,409,410,1
"6a5f020451db426dacba9e2ea3fcc62a","02b3a1bead9244c1ba2f857c7da8f82a",22899628,1,-3,0,1546,410,408,-2
"02b3a1bead9244c1ba2f857c7da8f82a","6a5f020451db426dacba9e2ea3fcc62a",22899628,1,3,0,1547,408,410,2
"6a5f020451db426dacba9e2ea3fcc62a","6a5f020451db426dacba9e2ea3fcc62a",22899628,1,0,1,1548,410,410,0
"6a5f020451db426dacba9e2ea3fcc62a","33a9d248b2e44588a5b07fc1342b9bc2",22899628,1,2,0,1549,410,411,1
"33a9d248b2e44588a5b07fc1342b9bc2","33a9d248b2e44588a5b07fc1342b9bc2",22899628,1,0,1,1550,411,411,0
"33a9d248b2e44588a5b07fc1342b9bc2","c6f26bd420634f1cb7989e76fe6b16c0",22899628,1,1,0,1551,411,412,1
"c6f26bd420634f1cb7989e76fe6b16c0","c6f26bd420634f1cb7989e76fe6b16c0",22899628,5,0,1,1552,412,412,0
"c6f26bd420634f1cb7989e76fe6b16c0","2a65ee6e2ac64f6a8a55fbe5373ec763",22899628,1,1,0,1557,412,413,1
"2a65ee6e2ac64f6a8a55fbe5373ec763","2a65ee6e2ac64f6a8a55fbe5373ec763",22899628,5,0,1,1558,413,413,0
"2a65ee6e2ac64f6a8a55fbe5373ec763","33a9d248b2e44588a5b07fc1342b9bc2",22899628,1,-2,0,1563,413,411,-2
"33a9d248b2e44588a5b07fc1342b9bc2","1fd0f6dadbc14ebc965faf6122190b96",22899628,1,5,0,1564,411,415,4
"1fd0f6dadbc14ebc965faf6122190b96","1fd0f6dadbc14ebc965faf6122190b96",22899628,1,0,1,1565,415,415,0
"1fd0f6dadbc14ebc965faf6122190b96","687055dad9fc40c3982478fe33ec01bf",22899628,1,-1,0,1566,415,414,-1
"687055dad9fc40c3982478fe33ec01bf","2add1669f08d4101913db15f8c23b3b7",22899628,1,3,0,1567,414,416,2
"2add1669f08d4101913db15f8c23b3b7","2add1669f08d4101913db15f8c23b3b7",22899628,1,0,1,1568,416,416,0
"2add1669f08d4101913db15f8c23b3b7","2b09a08242b54983aec7063990fb3f66",22899628,2,-24,0,1569,416,400,-16
"2b09a08242b54983aec7063990fb3f66","a2b4bd40cee2481ebd3fc179d6a5cd62",22899628,2,27,0,1570,400,417,17
"a2b4bd40cee2481ebd3fc179d6a5cd62","a2b4bd40cee2481ebd3fc179d6a5cd62",22899628,1,0,1,1571,417,417,0
"a2b4bd40cee2481ebd3fc179d6a5cd62","2b09a08242b54983aec7063990fb3f66",22899628,1,-27,0,1572,417,400,-17
"2b09a08242b54983aec7063990fb3f66","2add1669f08d4101913db15f8c23b3b7",22899628,1,24,0,1573,400,416,16
"a2b4bd40cee2481ebd3fc179d6a5cd62","e34e59dce2204f228f3a84b6725df60f",22899628,1,2,0,1576,417,419,2
"e34e59dce2204f228f3a84b6725df60f","e34e59dce2204f228f3a84b6725df60f",22899628,1,0,1,1577,419,419,0
"e34e59dce2204f228f3a84b6725df60f","a2b4bd40cee2481ebd3fc179d6a5cd62",22899628,1,-2,0,1578,419,417,-2
"a2b4bd40cee2481ebd3fc179d6a5cd62","bec48fc2e1294c7eb3d0aca780d731b8",22899628,1,4,0,1579,417,420,3
"bec48fc2e1294c7eb3d0aca780d731b8","bec48fc2e1294c7eb3d0aca780d731b8",22899628,2,0,1,1580,420,420,0
"bec48fc2e1294c7eb3d0aca780d731b8","dbde19fcce2a4c1abdc7f685c293a23f",22899628,1,3,0,1582,420,422,2
"dbde19fcce2a4c1abdc7f685c293a23f","a24600b0e49245f6bdba8c893cfeddb0",22899628,1,4,0,1583,422,425,3
"a24600b0e49245f6bdba8c893cfeddb0","a24600b0e49245f6bdba8c893cfeddb0",22899628,2,0,1,1584,425,425,0
"a24600b0e49245f6bdba8c893cfeddb0","a2b4bd40cee2481ebd3fc179d6a5cd62",22899628,1,-11,0,1586,425,417,-8
"a2b4bd40cee2481ebd3fc179d6a5cd62","24cf8786024543f19b89bc20034e60d7",22899628,1,18,0,1587,417,428,11
"24cf8786024543f19b89bc20034e60d7","f2a73be2f46840b182d7bd095378004e",22899628,1,1,0,1588,428,429,1
"f2a73be2f46840b182d7bd095378004e","f2a73be2f46840b182d7bd095378004e",22899628,1,0,1,1589,429,429,0
"f2a73be2f46840b182d7bd095378004e","604551fd4266430cb860fef58fa7dd61",22899628,1,1,0,1590,429,430,1
"604551fd4266430cb860fef58fa7dd61","604551fd4266430cb860fef58fa7dd61",22899628,1,0,1,1591,430,430,0
"604551fd4266430cb860fef58fa7dd61","24cf8786024543f19b89bc20034e60d7",22899628,1,-2,0,1592,430,428,-2
"24cf8786024543f19b89bc20034e60d7","dce46f8904594a62a6377a3587aaa663",22899628,1,4,0,1593,428,431,3
"dce46f8904594a62a6377a3587aaa663","dce46f8904594a62a6377a3587aaa663",22899628,1,0,1,1594,431,431,0
"dce46f8904594a62a6377a3587aaa663","9b9d0a249052413c869753b99682b0ac",22899628,1,1,0,1595,431,432,1
"9b9d0a249052413c869753b99682b0ac","9b9d0a249052413c869753b99682b0ac",22899628,1,0,1,1596,432,432,0
"9b9d0a249052413c869753b99682b0ac","061c175cc90f45fbad883025394e78dd",22899628,1,1,0,1597,432,433,1
"061c175cc90f45fbad883025394e78dd","061c175cc90f45fbad883025394e78dd",22899628,4,0,1,1598,433,433,0
"061c175cc90f45fbad883025394e78dd","dce46f8904594a62a6377a3587aaa663",22899628,2,-2,0,1601,433,431,-2
"dce46f8904594a62a6377a3587aaa663","66ada10dde9f43018588f1ced9d477fc",22899628,1,4,0,1602,431,434,3
"66ada10dde9f43018588f1ced9d477fc","dce46f8904594a62a6377a3587aaa663",22899628,1,-4,0,1603,434,431,-3
"dce46f8904594a62a6377a3587aaa663","061c175cc90f45fbad883025394e78dd",22899628,1,2,0,1604,431,433,2
"dce46f8904594a62a6377a3587aaa663","74a7f8712e5449c2bc0b43c6f90dafed",22899628,1,5,0,1607,431,435,4
"74a7f8712e5449c2bc0b43c6f90dafed","74a7f8712e5449c2bc0b43c6f90dafed",22899628,1,0,1,1608,435,435,0
"74a7f8712e5449c2bc0b43c6f90dafed","66ada10dde9f43018588f1ced9d477fc",22899628,1,-1,0,1609,435,434,-1
"66ada10dde9f43018588f1ced9d477fc","24cf8786024543f19b89bc20034e60d7",22899628,1,-8,0,1610,434,428,-6
"24cf8786024543f19b89bc20034e60d7","070600601c4c439288445d2f0724807d",22899628,2,14,0,1611,428,437,9
"070600601c4c439288445d2f0724807d","1823b6de7d334a7aaabc4570719af4d9",22899628,1,2,0,1612,437,439,2
"1823b6de7d334a7aaabc4570719af4d9","24cf8786024543f19b89bc20034e60d7",22899628,1,-16,0,1613,439,428,-11
"070600601c4c439288445d2f0724807d","bf12c96466d840a69bed7020b3f18bb8",22899628,1,-3,0,1615,437,436,-1
"bf12c96466d840a69bed7020b3f18bb8","bf12c96466d840a69bed7020b3f18bb8",22899628,1,0,1,1616,436,436,0
"bf12c96466d840a69bed7020b3f18bb8","070600601c4c439288445d2f0724807d",22899628,1,3,0,1617,436,437,1
"070600601c4c439288445d2f0724807d","24cf8786024543f19b89bc20034e60d7",22899628,1,-14,0,1618,437,428,-9
"24cf8786024543f19b89bc20034e60d7","1823b6de7d334a7aaabc4570719af4d9",22899628,1,16,0,1619,428,439,11
"1823b6de7d334a7aaabc4570719af4d9","1823b6de7d334a7aaabc4570719af4d9",22899628,13,0,1,1620,439,439,0
"1823b6de7d334a7aaabc4570719af4d9","070600601c4c439288445d2f0724807d",22899628,1,-2,0,1633,439,437,-2
"070600601c4c439288445d2f0724807d","0380cd76a7d44bc3a4da1f15e4d68f89",22899628,1,4,0,1634,437,440,3
"0380cd76a7d44bc3a4da1f15e4d68f89","0380cd76a7d44bc3a4da1f15e4d68f89",22899628,3,0,1,1635,440,440,0
"0380cd76a7d44bc3a4da1f15e4d68f89","23b7673c8b5443108c2ef09382834a86",22899628,1,2,0,1638,440,441,1
"23b7673c8b5443108c2ef09382834a86","23b7673c8b5443108c2ef09382834a86",22899628,3,0,1,1639,441,441,0
"23b7673c8b5443108c2ef09382834a86","901e92500aea43c79f19f1b279050668",22899628,1,2,0,1642,441,442,1
"901e92500aea43c79f19f1b279050668","901e92500aea43c79f19f1b279050668",22899628,1,0,1,1643,442,442,0
"901e92500aea43c79f19f1b279050668","001339db8ced4cf78829ebe8b145449d",22899628,1,1,0,1644,442,443,1
"001339db8ced4cf78829ebe8b145449d","001339db8ced4cf78829ebe8b145449d",22899628,13,0,1,1645,443,443,0
"001339db8ced4cf78829ebe8b145449d","452745e0366e42ae81561bfddebcc6c3",22899628,1,1,0,1658,443,444,1
"452745e0366e42ae81561bfddebcc6c3","452745e0366e42ae81561bfddebcc6c3",22899628,2,0,1,1659,444,444,0
"452745e0366e42ae81561bfddebcc6c3","901e92500aea43c79f19f1b279050668",22899628,1,-2,0,1661,444,442,-2
"901e92500aea43c79f19f1b279050668","4660ff2089114e8db82ceb26a4f329e3",22899628,1,4,0,1662,442,445,3
"4660ff2089114e8db82ceb26a4f329e3","4660ff2089114e8db82ceb26a4f329e3",22899628,2,0,1,1663,445,445,0
"4660ff2089114e8db82ceb26a4f329e3","7bd5586eb9d8484eb74a433ee7bfe499",22899628,1,2,0,1665,445,446,1
"7bd5586eb9d8484eb74a433ee7bfe499","7bd5586eb9d8484eb74a433ee7bfe499",22899628,31,0,1,1666,446,446,0
"7bd5586eb9d8484eb74a433ee7bfe499","8a7f26e690f34dda97be16904518ca99",22899628,1,2,0,1697,446,447,1
"8a7f26e690f34dda97be16904518ca99","8a7f26e690f34dda97be16904518ca99",22899628,1,0,1,1698,447,447,0
"8a7f26e690f34dda97be16904518ca99","070600601c4c439288445d2f0724807d",22899628,1,-16,0,1699,447,437,-10
"070600601c4c439288445d2f0724807d","b2f0d654738f48158edff28e8d3a546e",22899628,1,21,0,1700,437,449,12
"b2f0d654738f48158edff28e8d3a546e","f60ee41ec635499abd48168342d32c2f",22899628,2,5,0,1701,449,453,4
"f60ee41ec635499abd48168342d32c2f","b2f0d654738f48158edff28e8d3a546e",22899628,1,-5,0,1702,453,449,-4
"f60ee41ec635499abd48168342d32c2f","f60ee41ec635499abd48168342d32c2f",22899628,49,0,1,1704,453,453,0
"f60ee41ec635499abd48168342d32c2f","f67fbf45a5f146ed866965bc57c7c001",22899628,1,3,0,1753,453,454,1
"f67fbf45a5f146ed866965bc57c7c001","b2f0d654738f48158edff28e8d3a546e",22899628,1,-8,0,1754,454,449,-5
"b2f0d654738f48158edff28e8d3a546e","f67fbf45a5f146ed866965bc57c7c001",22899628,1,8,0,1755,449,454,5
"f67fbf45a5f146ed866965bc57c7c001","f67fbf45a5f146ed866965bc57c7c001",22899628,4,0,1,1756,454,454,0
"f67fbf45a5f146ed866965bc57c7c001","d937afe49bd24a07a550dda1c1155122",22899628,1,1,0,1760,454,455,1
"d937afe49bd24a07a550dda1c1155122","d937afe49bd24a07a550dda1c1155122",22899628,1,0,1,1761,455,455,0
"d937afe49bd24a07a550dda1c1155122","3628b3f7823443d0912a339096b69943",22899628,1,1,0,1762,455,456,1
"3628b3f7823443d0912a339096b69943","3628b3f7823443d0912a339096b69943",22899628,1,0,1,1763,456,456,0
"3628b3f7823443d0912a339096b69943","9e049ee647cf43ecbcb5ed792a8e7588",22899628,1,1,0,1764,456,457,1
"9e049ee647cf43ecbcb5ed792a8e7588","9e049ee647cf43ecbcb5ed792a8e7588",22899628,1,0,1,1765,457,457,0
"9e049ee647cf43ecbcb5ed792a8e7588","5256a214faaf410b93f76cea06428334",22899628,1,1,0,1766,457,458,1
"5256a214faaf410b93f76cea06428334","5256a214faaf410b93f76cea06428334",22899628,1,0,1,1767,458,458,0
"5256a214faaf410b93f76cea06428334","25c32b120fce40fa9b6c85133aeb4716",22899628,1,1,0,1768,458,459,1
"25c32b120fce40fa9b6c85133aeb4716","25c32b120fce40fa9b6c85133aeb4716",22899628,3,0,1,1769,459,459,0
"25c32b120fce40fa9b6c85133aeb4716","11bc14f2204949008b7d511b933363c1",22899628,1,1,0,1772,459,460,1
"11bc14f2204949008b7d511b933363c1","11bc14f2204949008b7d511b933363c1",22899628,4,0,1,1773,460,460,0
"11bc14f2204949008b7d511b933363c1","3434c10e561d488a914e0f7d71907abd",22899628,1,-221,0,1776,460,305,-155
"53e7e900392747ccad52e711ab0f80d8","3434c10e561d488a914e0f7d71907abd",22899628,1,-2,0,1779,307,305,-2
"130acc2aeb0448fdbb2de63bc5cebe5b","ea859f8207e44537889daeaba13ac2e8",22899628,1,3,0,1781,309,312,3
"ea859f8207e44537889daeaba13ac2e8","11bc14f2204949008b7d511b933363c1",22899628,1,213,0,1782,312,460,148
"11bc14f2204949008b7d511b933363c1","141c0df6cd1946539aadd1c9b7068cd4",22899628,1,-217,0,1784,460,308,-152
"141c0df6cd1946539aadd1c9b7068cd4","0c787d16c9504873b1a4d903cec09948",22899628,1,7,0,1785,308,314,6
"86c27d40179e419c8e9d150fb6afa5d0","24f1363179ad4aaa965484a78471912b",22899628,1,5,0,1787,319,323,4
"47edbb64109243e6b0f8f64cdef90c6c","8d7e0b55cf9849cda222a0f2440cec55",22899628,1,-9,0,1789,326,318,-8
"8d7e0b55cf9849cda222a0f2440cec55","3628bdce1dd2429ba924d2d4d09448d2",22899628,1,5,0,1790,318,322,4
"3628bdce1dd2429ba924d2d4d09448d2","0c4079457ede49e3aeb5e86ed84bdf35",22899628,1,10,0,1791,322,329,7
"38aea304b4fa46e1b29bb72f5cea4c93","42de338840a34d15adb66e7b14fb9d2c",22899628,1,189,0,1794,331,461,130
"42de338840a34d15adb66e7b14fb9d2c","42de338840a34d15adb66e7b14fb9d2c",22899628,1,0,1,1795,461,461,0
"42de338840a34d15adb66e7b14fb9d2c","0c4079457ede49e3aeb5e86ed84bdf35",22899628,1,-191,0,1796,461,329,-132
"0c4079457ede49e3aeb5e86ed84bdf35","bbc5139ca9024389a94db3a6f47dcff6",22899628,1,14,0,1797,329,341,12
"b8b9418ab322418d9db9b40d96af873a","c2490bc612d146edbe786556fab3651b",22899628,1,4,0,1799,337,340,3
"c2490bc612d146edbe786556fab3651b","30ead9794d4847abaf222ca966cc8630",22899628,1,11,0,1800,340,348,8
"30ead9794d4847abaf222ca966cc8630","0c4079457ede49e3aeb5e86ed84bdf35",22899628,1,-24,0,1801,348,329,-19
"0c4079457ede49e3aeb5e86ed84bdf35","897b7f51242c44aab2205c72fdcbf4cd",22899628,1,28,0,1802,329,352,23
"c20993c944444fe085345591a8bd837e","09b9678ddc3d452ea4a3d46e15826065",22899628,2,2,0,1808,351,353,2
"09b9678ddc3d452ea4a3d46e15826065","c20993c944444fe085345591a8bd837e",22899628,1,-2,0,1809,353,351,-2
"eff0de7f2dbb42dfa1a2e686efab5b6d","2fe14166dc9642c3bc666b86a57f943d",22899628,1,4,0,1814,354,357,3
"2fe14166dc9642c3bc666b86a57f943d","30ead9794d4847abaf222ca966cc8630",22899628,1,-10,0,1815,357,348,-9
"30ead9794d4847abaf222ca966cc8630","1ba8fef685d74a8194b9db252eb704fb",22899628,1,8,0,1816,348,355,7
"072a190fd302456290895f9f04d6940a","30ead9794d4847abaf222ca966cc8630",22899628,1,-20,0,1821,365,348,-17
"b71bac264efb4abd97015447bd490db6","b71bac264efb4abd97015447bd490db6",22899628,1,0,1,1823,370,370,0
"7f544639412e40a9ba27f43b415362ab","9da37c6210b1416b8079c274f70bf600",22899628,1,126,0,1839,378,462,84
"9da37c6210b1416b8079c274f70bf600","9da37c6210b1416b8079c274f70bf600",22899628,2,0,1,1840,462,462,0
"9da37c6210b1416b8079c274f70bf600","d5ae8642e15b46b8bd298b02274d4e9c",22899628,1,-124,0,1841,462,380,-82
"d5ae8642e15b46b8bd298b02274d4e9c","9da37c6210b1416b8079c274f70bf600",22899628,1,124,0,1842,380,462,82
"9da37c6210b1416b8079c274f70bf600","66baf19b6b904b70922329068c63746d",22899628,1,-128,0,1844,462,376,-86
"66baf19b6b904b70922329068c63746d","c2fca3669923477ab966ded303dea31c",22899628,1,8,0,1845,376,383,7
"4890121ce5d74576b4632b77cfc23398","96bb2b3e85a34d8b9544514e89f6fe97",22899628,1,3,0,1847,388,390,2
"96bb2b3e85a34d8b9544514e89f6fe97","18d3b836dd804224883cc9180b60a8e1",22899628,1,-4,0,1848,390,387,-3
"18d3b836dd804224883cc9180b60a8e1","6f8881a745ac4c358a68b92c3b4abe81",22899628,1,9,0,1849,387,394,7
"6f8881a745ac4c358a68b92c3b4abe81","17f95d18bab743888e1736033dc3384d",22899628,1,-6,0,1850,394,389,-5
"17f95d18bab743888e1736033dc3384d","f7002c8484354eceac57bc7bd62c76c1",22899628,1,5,0,1851,389,393,4
"f7002c8484354eceac57bc7bd62c76c1","44a277ea44dc4ae689fab4b82f0b4098",22899628,1,5,0,1852,393,397,4
"44a277ea44dc4ae689fab4b82f0b4098","44a277ea44dc4ae689fab4b82f0b4098",22899628,1,0,1,1853,397,397,0
"44a277ea44dc4ae689fab4b82f0b4098","0c12af0a4e7f4002852cf84b2537c161",22899628,1,-2,0,1854,397,395,-2
"0c12af0a4e7f4002852cf84b2537c161","519119f1deac45ff9ab4f13529be5c6e",22899628,1,105,0,1855,395,463,68
"519119f1deac45ff9ab4f13529be5c6e","519119f1deac45ff9ab4f13529be5c6e",22899628,2,0,1,1856,463,463,0
"519119f1deac45ff9ab4f13529be5c6e","66baf19b6b904b70922329068c63746d",22899628,1,-129,0,1857,463,376,-87
"2b09a08242b54983aec7063990fb3f66","1157bd665ec4472fb58b751dc5099355",22899628,1,4,0,1861,400,403,3
"1157bd665ec4472fb58b751dc5099355","58fc9094275e4c49be3f4ba6d4acc0a4",22899628,1,5,0,1862,403,406,3
"58fc9094275e4c49be3f4ba6d4acc0a4","3c8a22d2f9c146ea956609e3ed4f2559",22899628,1,-2,0,1863,406,405,-1
"3c8a22d2f9c146ea956609e3ed4f2559","02b3a1bead9244c1ba2f857c7da8f82a",22899628,1,5,0,1864,405,408,3
"58fc9094275e4c49be3f4ba6d4acc0a4","519119f1deac45ff9ab4f13529be5c6e",22899628,1,88,0,1866,406,463,57
"519119f1deac45ff9ab4f13529be5c6e","f67fbf45a5f146ed866965bc57c7c001",22899628,1,-9,0,1868,463,454,-9
"f67fbf45a5f146ed866965bc57c7c001","c5df9f40ec14463b9dcfdc73df3e9285",22899628,1,12,0,1869,454,464,10
"c5df9f40ec14463b9dcfdc73df3e9285","c5df9f40ec14463b9dcfdc73df3e9285",22899628,1,0,1,1870,464,464,0
"c5df9f40ec14463b9dcfdc73df3e9285","83d42d95cd844fc093fc09cee250edb8",22899628,2,3,0,1871,464,465,1
"83d42d95cd844fc093fc09cee250edb8","c5df9f40ec14463b9dcfdc73df3e9285",22899628,1,-3,0,1872,465,464,-1
"83d42d95cd844fc093fc09cee250edb8","83d42d95cd844fc093fc09cee250edb8",22899628,8,0,1,1874,465,465,0
"83d42d95cd844fc093fc09cee250edb8","d6d02b6ef04e4f17805504500b8ce441",22899628,1,-139,0,1882,465,375,-90
"b613861cecf84ffcab01afb23f660475","b613861cecf84ffcab01afb23f660475",22900437,4,0,1,1,1,1,0
"b613861cecf84ffcab01afb23f660475","e2911e79efc2420eac45d9f671463d4b",22900437,1,3,0,5,1,2,1
"e2911e79efc2420eac45d9f671463d4b","e2911e79efc2420eac45d9f671463d4b",22900437,2,0,1,6,2,2,0
"e2911e79efc2420eac45d9f671463d4b","519d1b8c59404d67b54e96c5c8a830b2",22900437,1,1,0,8,2,3,1
"519d1b8c59404d67b54e96c5c8a830b2","519d1b8c59404d67b54e96c5c8a830b2",22900437,1,0,1,9,3,3,0
"519d1b8c59404d67b54e96c5c8a830b2","531db53f81f646edb0cdcfe0085b03b7",22900437,1,1,0,10,3,4,1
"531db53f81f646edb0cdcfe0085b03b7","531db53f81f646edb0cdcfe0085b03b7",22900437,1,0,1,11,4,4,0
"531db53f81f646edb0cdcfe0085b03b7","4f5f94b2f95141e0a9d53a61da2276da",22900437,1,1,0,12,4,5,1
"4f5f94b2f95141e0a9d53a61da2276da","4f5f94b2f95141e0a9d53a61da2276da",22900437,1,0,1,13,5,5,0
"4f5f94b2f95141e0a9d53a61da2276da","6d541c89590949f99af293c4f2333f67",22900437,1,1,0,14,5,6,1
"6d541c89590949f99af293c4f2333f67","6d541c89590949f99af293c4f2333f67",22900437,1,0,1,15,6,6,0
"6d541c89590949f99af293c4f2333f67","dd5cf0b9fe4c4f1d8f5ff8e4c04879cb",22900437,1,1,0,16,6,7,1
"dd5cf0b9fe4c4f1d8f5ff8e4c04879cb","dd5cf0b9fe4c4f1d8f5ff8e4c04879cb",22900437,1,0,1,17,7,7,0
"dd5cf0b9fe4c4f1d8f5ff8e4c04879cb","f96261861edc426abe2248be4f0a709a",22900437,1,1,0,18,7,8,1
"f96261861edc426abe2248be4f0a709a","f96261861edc426abe2248be4f0a709a",22900437,1,0,1,19,8,8,0
"f96261861edc426abe2248be4f0a709a","66b5e16f4f75454fb5b8172079f0fa83",22900437,1,1,0,20,8,9,1
"66b5e16f4f75454fb5b8172079f0fa83","66b5e16f4f75454fb5b8172079f0fa83",22900437,2,0,1,21,9,9,0
"66b5e16f4f75454fb5b8172079f0fa83","0680571d4698477995e41842c36a54b2",22900437,1,1,0,23,9,10,1
"0680571d4698477995e41842c36a54b2","0680571d4698477995e41842c36a54b2",22900437,1,0,1,24,10,10,0
"0680571d4698477995e41842c36a54b2","9112f2bffece48e08c6d2287be204085",22900437,1,1,0,25,10,11,1
"9112f2bffece48e08c6d2287be204085","9112f2bffece48e08c6d2287be204085",22900437,1,0,1,26,11,11,0
"9112f2bffece48e08c6d2287be204085","e2911e79efc2420eac45d9f671463d4b",22900437,1,-9,0,27,11,2,-9
"e2911e79efc2420eac45d9f671463d4b","56586aa865414f538729c7f7735d2bc6",22900437,1,12,0,28,2,12,10
"56586aa865414f538729c7f7735d2bc6","56586aa865414f538729c7f7735d2bc6",22900437,3,0,1,29,12,12,0
"56586aa865414f538729c7f7735d2bc6","b7f2b31585d94eb3bf86376714aa7070",22900437,1,2,0,32,12,13,1
"b7f2b31585d94eb3bf86376714aa7070","b7f2b31585d94eb3bf86376714aa7070",22900437,2,0,1,33,13,13,0
"b7f2b31585d94eb3bf86376714aa7070","3f1c815879794b929260d224becaff7e",22900437,1,2,0,35,13,14,1
"3f1c815879794b929260d224becaff7e","5c5ceeee4562457ba6d41515aeebfbb1",22900437,1,6,0,36,14,17,3
"5c5ceeee4562457ba6d41515aeebfbb1","81c864a886d54a6b8ff85f7d736f4f95",22900437,2,-4,0,37,17,15,-2
"81c864a886d54a6b8ff85f7d736f4f95","eb2a0eb537344a9e891c761662e400b6",22900437,1,2,0,38,15,16,1
"eb2a0eb537344a9e891c761662e400b6","5c5ceeee4562457ba6d41515aeebfbb1",22900437,1,2,0,39,16,17,1
"81c864a886d54a6b8ff85f7d736f4f95","56586aa865414f538729c7f7735d2bc6",22900437,1,-6,0,41,15,12,-3
"56586aa865414f538729c7f7735d2bc6","9afd71a5298d4333b6849dfce1b9422c",22900437,3,13,0,42,12,18,6
"9afd71a5298d4333b6849dfce1b9422c","56586aa865414f538729c7f7735d2bc6",22900437,2,-13,0,43,18,12,-6
"9afd71a5298d4333b6849dfce1b9422c","5c5ceeee4562457ba6d41515aeebfbb1",22900437,1,-3,0,45,18,17,-1
"5c5ceeee4562457ba6d41515aeebfbb1","5c5ceeee4562457ba6d41515aeebfbb1",22900437,1,0,1,46,17,17,0
"5c5ceeee4562457ba6d41515aeebfbb1","9afd71a5298d4333b6849dfce1b9422c",22900437,1,3,0,47,17,18,1
"9afd71a5298d4333b6849dfce1b9422c","b7719e26494940efa49512aedd0aac79",22900437,1,4,0,53,18,20,2
"b7719e26494940efa49512aedd0aac79","9afd71a5298d4333b6849dfce1b9422c",22900437,1,-4,0,54,20,18,-2
"9afd71a5298d4333b6849dfce1b9422c","d4f45188d3c84a02ba08454e6403a818",22900437,1,9,0,55,18,24,6
"d4f45188d3c84a02ba08454e6403a818","d4c3b003e8274e429d2fa688d73fde6d",22900437,1,-2,0,56,24,22,-2
"d4c3b003e8274e429d2fa688d73fde6d","d4c3b003e8274e429d2fa688d73fde6d",22900437,1,0,1,57,22,22,0
"d4c3b003e8274e429d2fa688d73fde6d","5bc03c8f16354d04bd51f5bb93559ad3",22900437,1,4,0,58,22,26,4
"5bc03c8f16354d04bd51f5bb93559ad3","b7719e26494940efa49512aedd0aac79",22900437,1,-7,0,59,26,20,-6
"b7719e26494940efa49512aedd0aac79","afbf7250b99d47bea07172749483ca97",22900437,2,12,0,60,20,28,8
"afbf7250b99d47bea07172749483ca97","b7719e26494940efa49512aedd0aac79",22900437,1,-12,0,61,28,20,-8
"afbf7250b99d47bea07172749483ca97","4e51676dc72045d99c19b9fa7b22f8bc",22900437,1,3,0,63,28,29,1
"4e51676dc72045d99c19b9fa7b22f8bc","4e51676dc72045d99c19b9fa7b22f8bc",22900437,1,0,1,64,29,29,0
"4e51676dc72045d99c19b9fa7b22f8bc","51970cfa30e643e894e66ae85c8024cc",22900437,1,3,0,65,29,31,2
"51970cfa30e643e894e66ae85c8024cc","4e51676dc72045d99c19b9fa7b22f8bc",22900437,1,-3,0,66,31,29,-2
"4e51676dc72045d99c19b9fa7b22f8bc","c33c17be71ae4d588da7369472e5bb1b",22900437,1,9,0,67,29,34,5
"c33c17be71ae4d588da7369472e5bb1b","93679be414554a11b1893002f2229a93",22900437,2,3,0,68,34,35,1
"93679be414554a11b1893002f2229a93","c33c17be71ae4d588da7369472e5bb1b",22900437,1,-3,0,69,35,34,-1
"93679be414554a11b1893002f2229a93","7040a13096d746ac84b8fac8d9752058",22900437,1,3,0,71,35,36,1
"7040a13096d746ac84b8fac8d9752058","9a0dc646f934470daf08c4b56ccf73db",22900437,2,3,0,72,36,37,1
"9a0dc646f934470daf08c4b56ccf73db","7040a13096d746ac84b8fac8d9752058",22900437,1,-3,0,73,37,36,-1
"9a0dc646f934470daf08c4b56ccf73db","fc0e049d56024bc9a02c9a9c435c3df7",22900437,1,3,0,75,37,38,1
"fc0e049d56024bc9a02c9a9c435c3df7","67a089198fcb4e1c8f2385786c2b296f",22900437,1,4,0,76,38,39,1
"67a089198fcb4e1c8f2385786c2b296f","fc0e049d56024bc9a02c9a9c435c3df7",22900437,1,-4,0,77,39,38,-1
"fc0e049d56024bc9a02c9a9c435c3df7","64d48c6c9c7940639a932219a6c87198",22900437,1,5,0,78,38,40,2
"64d48c6c9c7940639a932219a6c87198","b7719e26494940efa49512aedd0aac79",22900437,1,-41,0,79,40,20,-20
"b7719e26494940efa49512aedd0aac79","67a089198fcb4e1c8f2385786c2b296f",22900437,1,40,0,80,20,39,19
"67a089198fcb4e1c8f2385786c2b296f","64d48c6c9c7940639a932219a6c87198",22900437,1,1,0,81,39,40,1
"64d48c6c9c7940639a932219a6c87198","64d48c6c9c7940639a932219a6c87198",22900437,2,0,1,82,40,40,0
"64d48c6c9c7940639a932219a6c87198","67a089198fcb4e1c8f2385786c2b296f",22900437,1,-1,0,84,40,39,-1
"67a089198fcb4e1c8f2385786c2b296f","b534b89233134e30a9b5645138bfa9ee",22900437,1,4,0,85,39,41,2
"b534b89233134e30a9b5645138bfa9ee","0e37b720d23b4e7f8b313e79313fd107",22900437,1,3,0,86,41,44,3
"0e37b720d23b4e7f8b313e79313fd107","0e37b720d23b4e7f8b313e79313fd107",22900437,1,0,1,87,44,44,0
"0e37b720d23b4e7f8b313e79313fd107","6875d67fdd5f48168b62719df449bebd",22900437,1,1,0,88,44,45,1
"6875d67fdd5f48168b62719df449bebd","6875d67fdd5f48168b62719df449bebd",22900437,1,0,1,89,45,45,0
"6875d67fdd5f48168b62719df449bebd","6e13d61a7bdb44bca949c9f86fab3be5",22900437,1,3,0,90,45,47,2
"6e13d61a7bdb44bca949c9f86fab3be5","b534b89233134e30a9b5645138bfa9ee",22900437,1,-7,0,91,47,41,-6
"b534b89233134e30a9b5645138bfa9ee","6e13d61a7bdb44bca949c9f86fab3be5",22900437,1,7,0,92,41,47,6
"6e13d61a7bdb44bca949c9f86fab3be5","195f78799f984cc2b06c48dfe36be751",22900437,1,2,0,93,47,49,2
"195f78799f984cc2b06c48dfe36be751","195f78799f984cc2b06c48dfe36be751",22900437,2,0,1,94,49,49,0
"195f78799f984cc2b06c48dfe36be751","d0c74f735e024943943e40333d6d337f",22900437,1,3,0,96,49,51,2
"d0c74f735e024943943e40333d6d337f","d9c8d8c444a64dadbbb508652c721e17",22900437,1,-6,0,97,51,46,-5
"d9c8d8c444a64dadbbb508652c721e17","d0c74f735e024943943e40333d6d337f",22900437,1,6,0,98,46,51,5
"d0c74f735e024943943e40333d6d337f","983f8ff320594b279a7f4a6fe132f9c5",22900437,1,2,0,99,51,53,2
"983f8ff320594b279a7f4a6fe132f9c5","983f8ff320594b279a7f4a6fe132f9c5",22900437,8,0,1,100,53,53,0
"983f8ff320594b279a7f4a6fe132f9c5","35adfa5d923046aebabfefd98f35ff05",22900437,1,1,0,108,53,54,1
"35adfa5d923046aebabfefd98f35ff05","35adfa5d923046aebabfefd98f35ff05",22900437,2,0,1,109,54,54,0
"35adfa5d923046aebabfefd98f35ff05","b6f8a98476224da1b40e555ececc7ed8",22900437,1,1,0,111,54,55,1
"b6f8a98476224da1b40e555ececc7ed8","b6f8a98476224da1b40e555ececc7ed8",22900437,2,0,1,112,55,55,0
"b6f8a98476224da1b40e555ececc7ed8","86e22cb5fe0e4b47a9489ecddf7ed78f",22900437,1,1,0,114,55,56,1
"86e22cb5fe0e4b47a9489ecddf7ed78f","86e22cb5fe0e4b47a9489ecddf7ed78f",22900437,2,0,1,115,56,56,0
"86e22cb5fe0e4b47a9489ecddf7ed78f","f924752d8a1149668870b1e7698486f7",22900437,1,-6,0,117,56,50,-6
"f924752d8a1149668870b1e7698486f7","78f30e4dcac84e3cbea8b2cc6e0d62b3",22900437,1,10,0,118,50,59,9
"78f30e4dcac84e3cbea8b2cc6e0d62b3","a1f2f12debe5432fb7a70bcd12bacfb9",22900437,3,-1,0,119,59,58,-1
"a1f2f12debe5432fb7a70bcd12bacfb9","a1f2f12debe5432fb7a70bcd12bacfb9",22900437,24,0,1,120,58,58,0
"a1f2f12debe5432fb7a70bcd12bacfb9","12aa6e1672ac4e7aa6449a7a8609cd72",22900437,2,-1,0,124,58,57,-1
"12aa6e1672ac4e7aa6449a7a8609cd72","6e13d61a7bdb44bca949c9f86fab3be5",22900437,2,-12,0,125,57,47,-10
"6e13d61a7bdb44bca949c9f86fab3be5","6e13d61a7bdb44bca949c9f86fab3be5",22900437,7,0,1,126,47,47,0
"6e13d61a7bdb44bca949c9f86fab3be5","d9c8d8c444a64dadbbb508652c721e17",22900437,1,-1,0,129,47,46,-1
"d9c8d8c444a64dadbbb508652c721e17","78f30e4dcac84e3cbea8b2cc6e0d62b3",22900437,2,15,0,130,46,59,13
"6e13d61a7bdb44bca949c9f86fab3be5","a1f2f12debe5432fb7a70bcd12bacfb9",22900437,1,13,0,145,47,58,11
"a1f2f12debe5432fb7a70bcd12bacfb9","d9c8d8c444a64dadbbb508652c721e17",22900437,1,-14,0,146,58,46,-12
"a1f2f12debe5432fb7a70bcd12bacfb9","78f30e4dcac84e3cbea8b2cc6e0d62b3",22900437,1,1,0,162,58,59,1
"78f30e4dcac84e3cbea8b2cc6e0d62b3","78f30e4dcac84e3cbea8b2cc6e0d62b3",22900437,7,0,1,163,59,59,0
"78f30e4dcac84e3cbea8b2cc6e0d62b3","12aa6e1672ac4e7aa6449a7a8609cd72",22900437,1,-2,0,170,59,57,-2
"12aa6e1672ac4e7aa6449a7a8609cd72","a0a418b8540d479fa6e0f653b701da8b",22900437,1,8,0,171,57,64,7
"a0a418b8540d479fa6e0f653b701da8b","bc42d26810654ea9a1df1efe1e58c7d5",22900437,1,-1,0,172,64,63,-1
"bc42d26810654ea9a1df1efe1e58c7d5","4c943503763e4e349906eea3ed3c8e86",22900437,1,-2,0,173,63,61,-2
"4c943503763e4e349906eea3ed3c8e86","4c943503763e4e349906eea3ed3c8e86",22900437,1,0,1,174,61,61,0
"4c943503763e4e349906eea3ed3c8e86","bc42d26810654ea9a1df1efe1e58c7d5",22900437,1,2,0,175,61,63,2
"bc42d26810654ea9a1df1efe1e58c7d5","bc42d26810654ea9a1df1efe1e58c7d5",22900437,3,0,1,176,63,63,0
"bc42d26810654ea9a1df1efe1e58c7d5","a0a418b8540d479fa6e0f653b701da8b",22900437,1,1,0,179,63,64,1
"a0a418b8540d479fa6e0f653b701da8b","a0a418b8540d479fa6e0f653b701da8b",22900437,3,0,1,180,64,64,0
"a0a418b8540d479fa6e0f653b701da8b","309ccf3cc4fe429d9bfbaef53d3fa479",22900437,1,-4,0,183,64,60,-4
"309ccf3cc4fe429d9bfbaef53d3fa479","b534b89233134e30a9b5645138bfa9ee",22900437,1,-23,0,184,60,41,-19
"b534b89233134e30a9b5645138bfa9ee","d646286c8051419bbc2e31dd1db55ca8",22900437,2,33,0,185,41,67,26
"d646286c8051419bbc2e31dd1db55ca8","d646286c8051419bbc2e31dd1db55ca8",22900437,1,0,1,186,67,67,0
"d646286c8051419bbc2e31dd1db55ca8","267f883678b24aed855fde42524975d9",22900437,1,4,0,187,67,71,4
"267f883678b24aed855fde42524975d9","267f883678b24aed855fde42524975d9",22900437,1,0,1,188,71,71,0
"267f883678b24aed855fde42524975d9","88fff56d0342490dbef9040750a20f6c",22900437,1,1,0,189,71,72,1
"88fff56d0342490dbef9040750a20f6c","88fff56d0342490dbef9040750a20f6c",22900437,1,0,1,190,72,72,0
"88fff56d0342490dbef9040750a20f6c","adb17b12b66c4a49a85fd34322f7df70",22900437,1,1,0,191,72,73,1
"adb17b12b66c4a49a85fd34322f7df70","adb17b12b66c4a49a85fd34322f7df70",22900437,1,0,1,192,73,73,0
"adb17b12b66c4a49a85fd34322f7df70","d646286c8051419bbc2e31dd1db55ca8",22900437,1,-6,0,193,73,67,-6
"d646286c8051419bbc2e31dd1db55ca8","a2becd407db34b189200a32546d9d569",22900437,2,9,0,194,67,75,8
"a2becd407db34b189200a32546d9d569","a2becd407db34b189200a32546d9d569",22900437,1,0,1,195,75,75,0
"a2becd407db34b189200a32546d9d569","58c22b011d0f4c2ea6d13615edbb9eeb",22900437,1,2,0,196,75,77,2
"58c22b011d0f4c2ea6d13615edbb9eeb","58c22b011d0f4c2ea6d13615edbb9eeb",22900437,4,0,1,197,77,77,0
"58c22b011d0f4c2ea6d13615edbb9eeb","140d5b27b8574befad82c0a013b59dfa",22900437,1,-3,0,199,77,74,-3
"140d5b27b8574befad82c0a013b59dfa","d646286c8051419bbc2e31dd1db55ca8",22900437,1,-8,0,200,74,67,-7
"d646286c8051419bbc2e31dd1db55ca8","b534b89233134e30a9b5645138bfa9ee",22900437,1,-33,0,201,67,41,-26
"b534b89233134e30a9b5645138bfa9ee","b534b89233134e30a9b5645138bfa9ee",22900437,1,0,1,202,41,41,0
"a2becd407db34b189200a32546d9d569","d646286c8051419bbc2e31dd1db55ca8",22900437,1,-9,0,205,75,67,-8
"d646286c8051419bbc2e31dd1db55ca8","58c22b011d0f4c2ea6d13615edbb9eeb",22900437,1,11,0,206,67,77,10
"58c22b011d0f4c2ea6d13615edbb9eeb","dd76e1861dc9461c830888729d091ee0",22900437,1,1,0,209,77,78,1
"dd76e1861dc9461c830888729d091ee0","dd76e1861dc9461c830888729d091ee0",22900437,5,0,1,210,78,78,0
"dd76e1861dc9461c830888729d091ee0","cd1d828f1a694b87913a7ea66c23803e",22900437,1,1,0,215,78,79,1
"cd1d828f1a694b87913a7ea66c23803e","cd1d828f1a694b87913a7ea66c23803e",22900437,2,0,1,216,79,79,0
"cd1d828f1a694b87913a7ea66c23803e","9176a3c2b4d2465fa8b0c67096c2a97e",22900437,1,1,0,218,79,80,1
"9176a3c2b4d2465fa8b0c67096c2a97e","9176a3c2b4d2465fa8b0c67096c2a97e",22900437,5,0,1,219,80,80,0
"9176a3c2b4d2465fa8b0c67096c2a97e","f8ec6445f7194e25b9101d4fbcb07a18",22900437,1,1,0,224,80,81,1
"f8ec6445f7194e25b9101d4fbcb07a18","f8ec6445f7194e25b9101d4fbcb07a18",22900437,2,0,1,225,81,81,0
"f8ec6445f7194e25b9101d4fbcb07a18","140d5b27b8574befad82c0a013b59dfa",22900437,1,-7,0,227,81,74,-7
"140d5b27b8574befad82c0a013b59dfa","d18a9ea32855445f8736581f5cb119ce",22900437,1,9,0,228,74,82,8
"d18a9ea32855445f8736581f5cb119ce","f564483cbd7a407681aa2fcca518cf5f",22900437,1,4,0,229,82,85,3
"f564483cbd7a407681aa2fcca518cf5f","f564483cbd7a407681aa2fcca518cf5f",22900437,4,0,1,230,85,85,0
"f564483cbd7a407681aa2fcca518cf5f","18fd01350bd5434ca636d59a599d768a",22900437,1,1,0,234,85,86,1
"18fd01350bd5434ca636d59a599d768a","18fd01350bd5434ca636d59a599d768a",22900437,5,0,1,235,86,86,0
"18fd01350bd5434ca636d59a599d768a","6a9f0ef185fb47f0937e29daa1c71ed5",22900437,1,5,0,240,86,90,4
"6a9f0ef185fb47f0937e29daa1c71ed5","ae5ac430ea254e708a6f5deaaf7464ae",22900437,1,-7,0,241,90,84,-6
"ae5ac430ea254e708a6f5deaaf7464ae","c681290961c94c4caf23b529d1ae6b9a",22900437,1,5,0,242,84,88,4
"c681290961c94c4caf23b529d1ae6b9a","c681290961c94c4caf23b529d1ae6b9a",22900437,1,0,1,243,88,88,0
"c681290961c94c4caf23b529d1ae6b9a","6a9f0ef185fb47f0937e29daa1c71ed5",22900437,1,2,0,244,88,90,2
"6a9f0ef185fb47f0937e29daa1c71ed5","6a9f0ef185fb47f0937e29daa1c71ed5",22900437,3,0,1,245,90,90,0
"6a9f0ef185fb47f0937e29daa1c71ed5","d646286c8051419bbc2e31dd1db55ca8",22900437,1,-27,0,248,90,67,-23
"d646286c8051419bbc2e31dd1db55ca8","e20db35ced8544ddac5bc3839145e463",22900437,1,30,0,249,67,91,24
"e20db35ced8544ddac5bc3839145e463","1febb706d7a34005ae8711ed49c76e64",22900437,1,3,0,250,91,94,3
"1febb706d7a34005ae8711ed49c76e64","1febb706d7a34005ae8711ed49c76e64",22900437,2,0,1,251,94,94,0
"1febb706d7a34005ae8711ed49c76e64","8f73ba6f5a0042f2850356ac38ac6f24",22900437,1,1,0,253,94,95,1
"8f73ba6f5a0042f2850356ac38ac6f24","8f73ba6f5a0042f2850356ac38ac6f24",22900437,5,0,1,254,95,95,0
"8f73ba6f5a0042f2850356ac38ac6f24","e2260b86653c46d7b14a41fb419dbf8c",22900437,1,1,0,259,95,96,1
"e2260b86653c46d7b14a41fb419dbf8c","e2260b86653c46d7b14a41fb419dbf8c",22900437,2,0,1,260,96,96,0
"e2260b86653c46d7b14a41fb419dbf8c","35eb641ad1d845bbba54915bce75a962",22900437,1,1,0,262,96,97,1
"35eb641ad1d845bbba54915bce75a962","35eb641ad1d845bbba54915bce75a962",22900437,2,0,1,263,97,97,0
"35eb641ad1d845bbba54915bce75a962","08be90ffbeea4795a138cd42ed8db56f",22900437,1,1,0,265,97,98,1
"08be90ffbeea4795a138cd42ed8db56f","08be90ffbeea4795a138cd42ed8db56f",22900437,5,0,1,266,98,98,0
"08be90ffbeea4795a138cd42ed8db56f","3007433c8f584dcbb5ac159c1c5f2be3",22900437,1,1,0,271,98,99,1
"3007433c8f584dcbb5ac159c1c5f2be3","3007433c8f584dcbb5ac159c1c5f2be3",22900437,2,0,1,272,99,99,0
"3007433c8f584dcbb5ac159c1c5f2be3","e20db35ced8544ddac5bc3839145e463",22900437,1,-8,0,274,99,91,-8
"e20db35ced8544ddac5bc3839145e463","00ae5f0c51874a73a41ebea838d95682",22900437,1,11,0,275,91,101,10
"00ae5f0c51874a73a41ebea838d95682","d391c8b6e56a43a7b654e9dee02d904b",22900437,2,2,0,276,101,103,2
"d391c8b6e56a43a7b654e9dee02d904b","00ae5f0c51874a73a41ebea838d95682",22900437,1,-2,0,277,103,101,-2
"d391c8b6e56a43a7b654e9dee02d904b","d391c8b6e56a43a7b654e9dee02d904b",22900437,15,0,1,279,103,103,0
"d391c8b6e56a43a7b654e9dee02d904b","6111116566fc4fd9abba409322bea245",22900437,1,1,0,294,103,104,1
"6111116566fc4fd9abba409322bea245","6111116566fc4fd9abba409322bea245",22900437,2,0,1,295,104,104,0
"6111116566fc4fd9abba409322bea245","a81b2235cb9c499eb9ea8ee0a8dd9725",22900437,1,1,0,297,104,105,1
"a81b2235cb9c499eb9ea8ee0a8dd9725","a81b2235cb9c499eb9ea8ee0a8dd9725",22900437,2,0,1,298,105,105,0
"a81b2235cb9c499eb9ea8ee0a8dd9725","2d4e0ab0ef3b4d73b82c72d4621a7579",22900437,1,1,0,300,105,106,1
"2d4e0ab0ef3b4d73b82c72d4621a7579","2d4e0ab0ef3b4d73b82c72d4621a7579",22900437,2,0,1,301,106,106,0
"2d4e0ab0ef3b4d73b82c72d4621a7579","8bdebf492ebd4e62b0d522e8ab5e5197",22900437,1,1,0,303,106,107,1
"8bdebf492ebd4e62b0d522e8ab5e5197","8bdebf492ebd4e62b0d522e8ab5e5197",22900437,2,0,1,304,107,107,0
"8bdebf492ebd4e62b0d522e8ab5e5197","73039f8c1eb9409cb4caee2cf968001e",22900437,1,-7,0,306,107,100,-7
"73039f8c1eb9409cb4caee2cf968001e","4280927ec4d643238aa49c32f9e06c6c",22900437,1,10,0,307,100,109,9
"4280927ec4d643238aa49c32f9e06c6c","4280927ec4d643238aa49c32f9e06c6c",22900437,1,0,1,308,109,109,0
"4280927ec4d643238aa49c32f9e06c6c","fc44e6a5f7654430af1227838224dceb",22900437,1,2,0,309,109,111,2
"fc44e6a5f7654430af1227838224dceb","fc44e6a5f7654430af1227838224dceb",22900437,2,0,1,310,111,111,0
"fc44e6a5f7654430af1227838224dceb","a9ae0a3c070d455bb4369a8996313336",22900437,1,4,0,312,111,114,3
"a9ae0a3c070d455bb4369a8996313336","08111f75e22d409998cf8b85bd431f0a",22900437,1,-7,0,313,114,108,-6
"08111f75e22d409998cf8b85bd431f0a","a9ae0a3c070d455bb4369a8996313336",22900437,1,7,0,314,108,114,6
"a9ae0a3c070d455bb4369a8996313336","71cec822bcff4f30a20e75dc63ef7b65",22900437,1,2,0,315,114,116,2
"71cec822bcff4f30a20e75dc63ef7b65","71cec822bcff4f30a20e75dc63ef7b65",22900437,1,0,1,316,116,116,0
"71cec822bcff4f30a20e75dc63ef7b65","37319e88176d4aefa91d7a9980dbae91",22900437,1,-4,0,317,116,112,-4
"37319e88176d4aefa91d7a9980dbae91","62bff51286ef4f348717a3cf6fe2318f",22900437,1,9,0,318,112,120,8
"62bff51286ef4f348717a3cf6fe2318f","b1cd0e7dc3ad4a8eb91a4bfdbeb025b0",22900437,1,-2,0,319,120,118,-2
"b1cd0e7dc3ad4a8eb91a4bfdbeb025b0","b1cd0e7dc3ad4a8eb91a4bfdbeb025b0",22900437,1,0,1,320,118,118,0
"b1cd0e7dc3ad4a8eb91a4bfdbeb025b0","62bff51286ef4f348717a3cf6fe2318f",22900437,1,2,0,321,118,120,2
"62bff51286ef4f348717a3cf6fe2318f","62bff51286ef4f348717a3cf6fe2318f",22900437,3,0,1,322,120,120,0
"62bff51286ef4f348717a3cf6fe2318f","e20db35ced8544ddac5bc3839145e463",22900437,1,-33,0,325,120,91,-29
"e20db35ced8544ddac5bc3839145e463","779f9ddd1fd14d1e9e69f72219a1fdbd",22900437,1,36,0,326,91,121,30
"779f9ddd1fd14d1e9e69f72219a1fdbd","779f9ddd1fd14d1e9e69f72219a1fdbd",22900437,1,0,1,327,121,121,0
"779f9ddd1fd14d1e9e69f72219a1fdbd","ae26e6cda8ad4a3f81bd347560d9579f",22900437,1,4,0,328,121,125,4
"ae26e6cda8ad4a3f81bd347560d9579f","ae26e6cda8ad4a3f81bd347560d9579f",22900437,1,0,1,329,125,125,0
"ae26e6cda8ad4a3f81bd347560d9579f","ee48df95832b4374aa273ceb27ec1315",22900437,1,1,0,330,125,126,1
"ee48df95832b4374aa273ceb27ec1315","ee48df95832b4374aa273ceb27ec1315",22900437,1,0,1,331,126,126,0
"ee48df95832b4374aa273ceb27ec1315","7a439da90b394756ad1777fc4c6dead5",22900437,1,1,0,332,126,127,1
"7a439da90b394756ad1777fc4c6dead5","7a439da90b394756ad1777fc4c6dead5",22900437,1,0,1,333,127,127,0
"7a439da90b394756ad1777fc4c6dead5","a8dd5213034441ac92724b4e83eb0bb2",22900437,1,3,0,334,127,129,2
"a8dd5213034441ac92724b4e83eb0bb2","779f9ddd1fd14d1e9e69f72219a1fdbd",22900437,1,-9,0,335,129,121,-8
"779f9ddd1fd14d1e9e69f72219a1fdbd","a8dd5213034441ac92724b4e83eb0bb2",22900437,1,9,0,336,121,129,8
"a8dd5213034441ac92724b4e83eb0bb2","8115eab6556b45f5b415c3b8c26a12e5",22900437,1,2,0,337,129,131,2
"8115eab6556b45f5b415c3b8c26a12e5","8115eab6556b45f5b415c3b8c26a12e5",22900437,5,0,1,338,131,131,0
"8115eab6556b45f5b415c3b8c26a12e5","ec34b06efd844b46a4c4818ecdb9b8f4",22900437,1,1,0,343,131,132,1
"ec34b06efd844b46a4c4818ecdb9b8f4","ec34b06efd844b46a4c4818ecdb9b8f4",22900437,2,0,1,344,132,132,0
"ec34b06efd844b46a4c4818ecdb9b8f4","c2e1c2b9eac64109b343a088584b576b",22900437,1,1,0,346,132,133,1
"c2e1c2b9eac64109b343a088584b576b","c2e1c2b9eac64109b343a088584b576b",22900437,2,0,1,347,133,133,0
"c2e1c2b9eac64109b343a088584b576b","579338175e0b4bbb8ef3b712b5d8b54e",22900437,1,-5,0,349,133,128,-5
"579338175e0b4bbb8ef3b712b5d8b54e","8bc5795d6a984a3eace4e2811e52dd4f",22900437,1,8,0,350,128,135,7
"8bc5795d6a984a3eace4e2811e52dd4f","8bc5795d6a984a3eace4e2811e52dd4f",22900437,1,0,1,351,135,135,0
"8bc5795d6a984a3eace4e2811e52dd4f","b416d47c56a742199b5d7c7f19d6503a",22900437,1,-1,0,352,135,134,-1
"b416d47c56a742199b5d7c7f19d6503a","cd4532ad48034873ba8bce2aac0c9808",22900437,1,4,0,353,134,137,3
"cd4532ad48034873ba8bce2aac0c9808","cd4532ad48034873ba8bce2aac0c9808",22900437,2,0,1,354,137,137,0
"cd4532ad48034873ba8bce2aac0c9808","779f9ddd1fd14d1e9e69f72219a1fdbd",22900437,1,-19,0,355,137,121,-16
"779f9ddd1fd14d1e9e69f72219a1fdbd","df1de691dafe4549a18a4398ee9dfaf9",22900437,1,23,0,356,121,139,18
"df1de691dafe4549a18a4398ee9dfaf9","6c5ad271a44743479bfaea29b1db8d02",22900437,1,4,0,357,139,143,4
"6c5ad271a44743479bfaea29b1db8d02","6c5ad271a44743479bfaea29b1db8d02",22900437,1,0,1,358,143,143,0
"6c5ad271a44743479bfaea29b1db8d02","83d311bed5374fee83d8d67a7d9d82dc",22900437,1,1,0,359,143,144,1
"83d311bed5374fee83d8d67a7d9d82dc","83d311bed5374fee83d8d67a7d9d82dc",22900437,3,0,1,360,144,144,0
"83d311bed5374fee83d8d67a7d9d82dc","402bba41861d43acb52a5abb89e8831e",22900437,1,1,0,363,144,145,1
"402bba41861d43acb52a5abb89e8831e","402bba41861d43acb52a5abb89e8831e",22900437,2,0,1,364,145,145,0
"402bba41861d43acb52a5abb89e8831e","df1de691dafe4549a18a4398ee9dfaf9",22900437,1,-6,0,366,145,139,-6
"df1de691dafe4549a18a4398ee9dfaf9","8aae34f5ddbb4052a709b12e6b0d40fa",22900437,1,9,0,367,139,147,8
"8aae34f5ddbb4052a709b12e6b0d40fa","8aae34f5ddbb4052a709b12e6b0d40fa",22900437,1,0,1,368,147,147,0
"8aae34f5ddbb4052a709b12e6b0d40fa","645b3f0249f64f76af2e19eb4d0e55b7",22900437,1,2,0,369,147,149,2
"645b3f0249f64f76af2e19eb4d0e55b7","645b3f0249f64f76af2e19eb4d0e55b7",22900437,5,0,1,370,149,149,0
"645b3f0249f64f76af2e19eb4d0e55b7","7e7b8db5064d4369805ab370aac5ddfb",22900437,1,1,0,375,149,150,1
"7e7b8db5064d4369805ab370aac5ddfb","7e7b8db5064d4369805ab370aac5ddfb",22900437,2,0,1,376,150,150,0
"7e7b8db5064d4369805ab370aac5ddfb","8956d210ae7f41968fada86d4c979d6a",22900437,1,1,0,378,150,151,1
"8956d210ae7f41968fada86d4c979d6a","8956d210ae7f41968fada86d4c979d6a",22900437,2,0,1,379,151,151,0
"8956d210ae7f41968fada86d4c979d6a","f902b0f41b544d4dbf79664fd233648d",22900437,1,-5,0,381,151,146,-5
"f902b0f41b544d4dbf79664fd233648d","ae781e8b775e4ccd93bc800dad5c8376",22900437,1,8,0,382,146,153,7
"ae781e8b775e4ccd93bc800dad5c8376","ae781e8b775e4ccd93bc800dad5c8376",22900437,2,0,1,383,153,153,0
"ae781e8b775e4ccd93bc800dad5c8376","06882a8492d9499aa31555567f575ecb",22900437,1,1,0,385,153,154,1
"06882a8492d9499aa31555567f575ecb","06882a8492d9499aa31555567f575ecb",22900437,1,0,1,386,154,154,0
"06882a8492d9499aa31555567f575ecb","f293c508f409466a8f27ddd7d1e40b20",22900437,1,1,0,387,154,155,1
"f293c508f409466a8f27ddd7d1e40b20","f293c508f409466a8f27ddd7d1e40b20",22900437,2,0,1,388,155,155,0
"f293c508f409466a8f27ddd7d1e40b20","cc4ddef5bbbe48ebb605141b347c4ed1",22900437,1,1,0,390,155,156,1
"cc4ddef5bbbe48ebb605141b347c4ed1","cc4ddef5bbbe48ebb605141b347c4ed1",22900437,1,0,1,391,156,156,0
"cc4ddef5bbbe48ebb605141b347c4ed1","f03480cf4eba413194d7af52fc0e7f28",22900437,1,-4,0,392,156,152,-4
"f03480cf4eba413194d7af52fc0e7f28","d313cec988a84645bee413e8d4724a4b",22900437,1,7,0,393,152,158,6
"d313cec988a84645bee413e8d4724a4b","d313cec988a84645bee413e8d4724a4b",22900437,4,0,1,394,158,158,0
"d313cec988a84645bee413e8d4724a4b","dc60696c76a74368a60f72246e47700d",22900437,1,1,0,398,158,159,1
"dc60696c76a74368a60f72246e47700d","dc60696c76a74368a60f72246e47700d",22900437,1,0,1,399,159,159,0
"dc60696c76a74368a60f72246e47700d","df1de691dafe4549a18a4398ee9dfaf9",22900437,1,-23,0,400,159,139,-20
"df1de691dafe4549a18a4398ee9dfaf9","78adeee1fa2c4fe0bc73f7bca9fcee86",22900437,1,26,0,401,139,160,21
"78adeee1fa2c4fe0bc73f7bca9fcee86","78adeee1fa2c4fe0bc73f7bca9fcee86",22900437,1,0,1,402,160,160,0
"78adeee1fa2c4fe0bc73f7bca9fcee86","f661500307d74c908e9207d949ceb4aa",22900437,1,-31,0,403,160,136,-24
"f661500307d74c908e9207d949ceb4aa","779f9ddd1fd14d1e9e69f72219a1fdbd",22900437,1,-18,0,404,136,121,-15
"779f9ddd1fd14d1e9e69f72219a1fdbd","cd4532ad48034873ba8bce2aac0c9808",22900437,1,19,0,405,121,137,16
"cd4532ad48034873ba8bce2aac0c9808","78adeee1fa2c4fe0bc73f7bca9fcee86",22900437,1,30,0,407,137,160,23
"78adeee1fa2c4fe0bc73f7bca9fcee86","65202579580f4ad38d734b4ee39d22a8",22900437,3,5,0,408,160,164,4
"65202579580f4ad38d734b4ee39d22a8","65202579580f4ad38d734b4ee39d22a8",22900437,60,0,1,409,164,164,0
"65202579580f4ad38d734b4ee39d22a8","78adeee1fa2c4fe0bc73f7bca9fcee86",22900437,2,-5,0,410,164,160,-4
"78adeee1fa2c4fe0bc73f7bca9fcee86","3cbcea2be0984e7dbd5a48195af10ce7",22900437,1,8,0,463,160,165,5
"3cbcea2be0984e7dbd5a48195af10ce7","82e6285962b8400d9d6fc32436022a94",22900437,1,2,0,464,165,167,2
"82e6285962b8400d9d6fc32436022a94","9afd71a5298d4333b6849dfce1b9422c",22900437,1,-206,0,465,167,18,-149
"9afd71a5298d4333b6849dfce1b9422c","a9ac840f098c4bd0a2ee896214ce29cd",22900437,2,209,0,466,18,168,150
"a9ac840f098c4bd0a2ee896214ce29cd","9afd71a5298d4333b6849dfce1b9422c",22900437,1,-209,0,467,168,18,-150
"a9ac840f098c4bd0a2ee896214ce29cd","a9ac840f098c4bd0a2ee896214ce29cd",22900437,3,0,1,469,168,168,0
"a9ac840f098c4bd0a2ee896214ce29cd","0c7262dff33c4087bc660ccf40f92f9c",22900437,3,4,0,470,168,169,1
"0c7262dff33c4087bc660ccf40f92f9c","b2275c3fad834f8d90737a2d9a6927d6",22900437,2,3,0,471,169,172,3
"b2275c3fad834f8d90737a2d9a6927d6","b2275c3fad834f8d90737a2d9a6927d6",22900437,24,0,1,472,172,172,0
"b2275c3fad834f8d90737a2d9a6927d6","eb515a26030b41f8a82a1e6114420bad",22900437,1,1,0,496,172,173,1
"eb515a26030b41f8a82a1e6114420bad","eb515a26030b41f8a82a1e6114420bad",22900437,2,0,1,497,173,173,0
"eb515a26030b41f8a82a1e6114420bad","b42cc17b7de840f181a704558d0bc845",22900437,1,3,0,499,173,175,2
"b42cc17b7de840f181a704558d0bc845","0c7262dff33c4087bc660ccf40f92f9c",22900437,1,-7,0,500,175,169,-6
"0c7262dff33c4087bc660ccf40f92f9c","b42cc17b7de840f181a704558d0bc845",22900437,1,7,0,501,169,175,6
"b42cc17b7de840f181a704558d0bc845","801f9e9135034f49bf5f8b4bdefedb41",22900437,1,2,0,502,175,177,2
"801f9e9135034f49bf5f8b4bdefedb41","801f9e9135034f49bf5f8b4bdefedb41",22900437,11,0,1,503,177,177,0
"801f9e9135034f49bf5f8b4bdefedb41","362fcb0699a14845ab29b2340093e528",22900437,1,-3,0,514,177,174,-3
"362fcb0699a14845ab29b2340093e528","ea38cc0e6e6e41edbabf210220808bf9",22900437,1,6,0,515,174,179,5
"ea38cc0e6e6e41edbabf210220808bf9","b87c552dd247427abe6ab5795b9c9d43",22900437,2,2,0,516,179,181,2
"b87c552dd247427abe6ab5795b9c9d43","ea38cc0e6e6e41edbabf210220808bf9",22900437,1,-2,0,517,181,179,-2
"b87c552dd247427abe6ab5795b9c9d43","b87c552dd247427abe6ab5795b9c9d43",22900437,7,0,1,519,181,181,0
"b87c552dd247427abe6ab5795b9c9d43","139b097acfca451689d80c9c6eebdf7b",22900437,1,-3,0,526,181,178,-3
"139b097acfca451689d80c9c6eebdf7b","30f660a1feb34582a739722532524f79",22900437,1,6,0,527,178,183,5
"30f660a1feb34582a739722532524f79","30f660a1feb34582a739722532524f79",22900437,3,0,1,528,183,183,0
"30f660a1feb34582a739722532524f79","2024b4885bd14338a39b7b509acbbd02",22900437,1,-1,0,531,183,182,-1
"2024b4885bd14338a39b7b509acbbd02","a9ac840f098c4bd0a2ee896214ce29cd",22900437,1,-20,0,532,182,168,-14
"0c7262dff33c4087bc660ccf40f92f9c","a9ac840f098c4bd0a2ee896214ce29cd",22900437,1,-4,0,536,169,168,-1
"b2275c3fad834f8d90737a2d9a6927d6","0c7262dff33c4087bc660ccf40f92f9c",22900437,1,-3,0,539,172,169,-3
"0c7262dff33c4087bc660ccf40f92f9c","c3f63fe50d8e487c86bf8ef76c9cadd3",22900437,1,20,0,540,169,185,16
"c3f63fe50d8e487c86bf8ef76c9cadd3","c3f63fe50d8e487c86bf8ef76c9cadd3",22900437,1,0,1,541,185,185,0
"c3f63fe50d8e487c86bf8ef76c9cadd3","c8e371568a0c4391b25796ae4e91952e",22900437,1,3,0,542,185,186,1
"c8e371568a0c4391b25796ae4e91952e","0c7262dff33c4087bc660ccf40f92f9c",22900437,1,-23,0,543,186,169,-17
"0c7262dff33c4087bc660ccf40f92f9c","7d932b23e1c84326ae5aa4d3c0d813d1",22900437,1,25,0,544,169,188,19
"7d932b23e1c84326ae5aa4d3c0d813d1","7d932b23e1c84326ae5aa4d3c0d813d1",22900437,3,0,1,545,188,188,0
"7d932b23e1c84326ae5aa4d3c0d813d1","ab11d94c6c8948ea90b88f19d2cd502b",22900437,1,3,0,548,188,190,2
"ab11d94c6c8948ea90b88f19d2cd502b","c8e371568a0c4391b25796ae4e91952e",22900437,1,-5,0,549,190,186,-4
"c8e371568a0c4391b25796ae4e91952e","ab11d94c6c8948ea90b88f19d2cd502b",22900437,1,5,0,550,186,190,4
"ab11d94c6c8948ea90b88f19d2cd502b","f992451ed6ad4e68bb9e68ad6be7c4be",22900437,1,2,0,551,190,192,2
"f992451ed6ad4e68bb9e68ad6be7c4be","f992451ed6ad4e68bb9e68ad6be7c4be",22900437,1,0,1,552,192,192,0
"f992451ed6ad4e68bb9e68ad6be7c4be","6cd2dcaac46847d4a0bc53f296d90375",22900437,1,3,0,553,192,194,2
"6cd2dcaac46847d4a0bc53f296d90375","07b44a7a51e94c78b411c753fc39dab0",22900437,1,-6,0,554,194,189,-5
"07b44a7a51e94c78b411c753fc39dab0","6cd2dcaac46847d4a0bc53f296d90375",22900437,1,6,0,555,189,194,5
"6cd2dcaac46847d4a0bc53f296d90375","2d2580c9411c4972909db508d6956a58",22900437,1,2,0,556,194,196,2
"2d2580c9411c4972909db508d6956a58","2d2580c9411c4972909db508d6956a58",22900437,2,0,1,557,196,196,0
"2d2580c9411c4972909db508d6956a58","5bddb3d9ed264f3984702f048c7e5340",22900437,1,1,0,559,196,197,1
"5bddb3d9ed264f3984702f048c7e5340","5bddb3d9ed264f3984702f048c7e5340",22900437,2,0,1,560,197,197,0
"5bddb3d9ed264f3984702f048c7e5340","d5e8e2bd12a2466b9d6d90855f0eb079",22900437,1,1,0,562,197,198,1
"d5e8e2bd12a2466b9d6d90855f0eb079","d5e8e2bd12a2466b9d6d90855f0eb079",22900437,2,0,1,563,198,198,0
"d5e8e2bd12a2466b9d6d90855f0eb079","017d7ca8e0394b91aaadc9574df2202c",22900437,1,-5,0,565,198,193,-5
"017d7ca8e0394b91aaadc9574df2202c","54e8e9f0ea3e45c4bf3b8ac799ee31b1",22900437,1,8,0,566,193,200,7
"54e8e9f0ea3e45c4bf3b8ac799ee31b1","54e8e9f0ea3e45c4bf3b8ac799ee31b1",22900437,1,0,1,567,200,200,0
"54e8e9f0ea3e45c4bf3b8ac799ee31b1","c614a00911be4877a075f19315530fb0",22900437,1,1,0,568,200,201,1
"c614a00911be4877a075f19315530fb0","c614a00911be4877a075f19315530fb0",22900437,6,0,1,569,201,201,0
"c614a00911be4877a075f19315530fb0","a6c21bd8b95249c7972820a7a7d76aff",22900437,1,1,0,575,201,202,1
"a6c21bd8b95249c7972820a7a7d76aff","a6c21bd8b95249c7972820a7a7d76aff",22900437,1,0,1,576,202,202,0
"a6c21bd8b95249c7972820a7a7d76aff","bb329d880ab54120adaf203a693bb203",22900437,1,1,0,577,202,203,1
"bb329d880ab54120adaf203a693bb203","bb329d880ab54120adaf203a693bb203",22900437,1,0,1,578,203,203,0
"bb329d880ab54120adaf203a693bb203","f9170dd6bc6442b4acd832747609b09a",22900437,1,-4,0,579,203,199,-4
"f9170dd6bc6442b4acd832747609b09a","334c2344009840079b1d0e1b7ce3d5a7",22900437,1,7,0,580,199,205,6
"334c2344009840079b1d0e1b7ce3d5a7","334c2344009840079b1d0e1b7ce3d5a7",22900437,1,0,1,581,205,205,0
"334c2344009840079b1d0e1b7ce3d5a7","d7f13c8d63ec4e2aa673fbb9cf9c6933",22900437,1,3,0,582,205,206,1
"d7f13c8d63ec4e2aa673fbb9cf9c6933","c8e371568a0c4391b25796ae4e91952e",22900437,1,-26,0,583,206,186,-20
"c8e371568a0c4391b25796ae4e91952e","b9e80f77c3a44349863b19875725c384",22900437,1,27,0,584,186,207,21
"b9e80f77c3a44349863b19875725c384","7108f0e4c2584f1f9c471689ae4c885c",22900437,3,1,0,585,207,208,1
"7108f0e4c2584f1f9c471689ae4c885c","d7f13c8d63ec4e2aa673fbb9cf9c6933",22900437,2,-2,0,586,208,206,-2
"d7f13c8d63ec4e2aa673fbb9cf9c6933","b9e80f77c3a44349863b19875725c384",22900437,1,1,0,587,206,207,1
"7108f0e4c2584f1f9c471689ae4c885c","b9e80f77c3a44349863b19875725c384",22900437,1,-1,0,589,208,207,-1
"b9e80f77c3a44349863b19875725c384","b9e80f77c3a44349863b19875725c384",22900437,14,0,1,590,207,207,0
"7108f0e4c2584f1f9c471689ae4c885c","7108f0e4c2584f1f9c471689ae4c885c",22900437,12,0,1,605,208,208,0
"d7f13c8d63ec4e2aa673fbb9cf9c6933","09400e101c5d4b439cf9a26b03aae558",22900437,1,5,0,618,206,210,4
"09400e101c5d4b439cf9a26b03aae558","09400e101c5d4b439cf9a26b03aae558",22900437,1,0,1,619,210,210,0
"09400e101c5d4b439cf9a26b03aae558","a88efa7e50ce47159810ab553afa6d3a",22900437,1,2,0,620,210,212,2
"a88efa7e50ce47159810ab553afa6d3a","a88efa7e50ce47159810ab553afa6d3a",22900437,5,0,1,621,212,212,0
"a88efa7e50ce47159810ab553afa6d3a","be502a7a43c44bf7b682698de79d9369",22900437,1,3,0,626,212,214,2
"be502a7a43c44bf7b682698de79d9369","a875096404ef4a9984b62d74cda916f9",22900437,1,-6,0,627,214,209,-5
"a875096404ef4a9984b62d74cda916f9","f7fb1952f56b4189b86a9f8b7862d2b8",22900437,1,7,0,628,209,215,6
"f7fb1952f56b4189b86a9f8b7862d2b8","be502a7a43c44bf7b682698de79d9369",22900437,1,-1,0,629,215,214,-1
"be502a7a43c44bf7b682698de79d9369","f7fb1952f56b4189b86a9f8b7862d2b8",22900437,1,1,0,630,214,215,1
"f7fb1952f56b4189b86a9f8b7862d2b8","f7fb1952f56b4189b86a9f8b7862d2b8",22900437,11,0,1,631,215,215,0
"f7fb1952f56b4189b86a9f8b7862d2b8","b860ee85d8bc4a2f97958cfb71be3533",22900437,1,1,0,642,215,216,1
"b860ee85d8bc4a2f97958cfb71be3533","b860ee85d8bc4a2f97958cfb71be3533",22900437,2,0,1,643,216,216,0
"b860ee85d8bc4a2f97958cfb71be3533","ec341f459285443b8361f7f15638ff08",22900437,1,-3,0,645,216,213,-3
"ec341f459285443b8361f7f15638ff08","363837c182e04711840d896ae1e0339c",22900437,1,6,0,646,213,218,5
"363837c182e04711840d896ae1e0339c","363837c182e04711840d896ae1e0339c",22900437,20,0,1,647,218,218,0
"363837c182e04711840d896ae1e0339c","01b2051f8941460d89945e3b02d1ce78",22900437,1,-1,0,667,218,217,-1
"01b2051f8941460d89945e3b02d1ce78","91125ca626c5470eb145501f8c37f8db",22900437,1,4,0,668,217,220,3
"91125ca626c5470eb145501f8c37f8db","91125ca626c5470eb145501f8c37f8db",22900437,1,0,1,669,220,220,0
"91125ca626c5470eb145501f8c37f8db","d7f13c8d63ec4e2aa673fbb9cf9c6933",22900437,1,-18,0,670,220,206,-14
"d7f13c8d63ec4e2aa673fbb9cf9c6933","1c6721b1f63f4d30ba7746ea8af02a52",22900437,1,21,0,671,206,221,15
"1c6721b1f63f4d30ba7746ea8af02a52","77ecef8eff6b4a2caea7707669bf7475",22900437,2,1,0,672,221,222,1
"77ecef8eff6b4a2caea7707669bf7475","9afd71a5298d4333b6849dfce1b9422c",22900437,1,-284,0,673,222,18,-204
"9afd71a5298d4333b6849dfce1b9422c","1c6721b1f63f4d30ba7746ea8af02a52",22900437,1,283,0,674,18,221,203
"77ecef8eff6b4a2caea7707669bf7475","77ecef8eff6b4a2caea7707669bf7475",22900437,13,0,1,676,222,222,0
"77ecef8eff6b4a2caea7707669bf7475","d03cb855c70044cf8c35d9ec0de696e3",22900437,1,3,0,689,222,224,2
"d03cb855c70044cf8c35d9ec0de696e3","1c6721b1f63f4d30ba7746ea8af02a52",22900437,1,-4,0,690,224,221,-3
"1c6721b1f63f4d30ba7746ea8af02a52","8b9ae98743bd4d4a8a87dff1c1244211",22900437,1,7,0,691,221,227,6
"8b9ae98743bd4d4a8a87dff1c1244211","d03cb855c70044cf8c35d9ec0de696e3",22900437,1,-3,0,692,227,224,-3
"d03cb855c70044cf8c35d9ec0de696e3","d03cb855c70044cf8c35d9ec0de696e3",22900437,1,0,1,693,224,224,0
"d03cb855c70044cf8c35d9ec0de696e3","a49a937d6896486d9a5396654abcf2e1",22900437,1,2,0,694,224,226,2
"a49a937d6896486d9a5396654abcf2e1","a49a937d6896486d9a5396654abcf2e1",22900437,3,0,1,695,226,226,0
"a49a937d6896486d9a5396654abcf2e1","8b9ae98743bd4d4a8a87dff1c1244211",22900437,1,1,0,698,226,227,1
"8b9ae98743bd4d4a8a87dff1c1244211","8b9ae98743bd4d4a8a87dff1c1244211",22900437,25,0,1,699,227,227,0
"8b9ae98743bd4d4a8a87dff1c1244211","2ab1535aac1346ba8801535bf729ef37",22900437,1,3,0,724,227,229,2
"2ab1535aac1346ba8801535bf729ef37","f7906d6f59b9489a91d2ef40db5a474d",22900437,1,-7,0,725,229,223,-6
"f7906d6f59b9489a91d2ef40db5a474d","2ab1535aac1346ba8801535bf729ef37",22900437,1,7,0,726,223,229,6
"2ab1535aac1346ba8801535bf729ef37","a4f40fb48a8542c8949bae1f002cd9bc",22900437,1,2,0,727,229,231,2
"a4f40fb48a8542c8949bae1f002cd9bc","a4f40fb48a8542c8949bae1f002cd9bc",22900437,2,0,1,728,231,231,0
"a4f40fb48a8542c8949bae1f002cd9bc","8972c23e32044edb8a78fa1eed4e5947",22900437,1,1,0,730,231,232,1
"8972c23e32044edb8a78fa1eed4e5947","8972c23e32044edb8a78fa1eed4e5947",22900437,1,0,1,731,232,232,0
"8972c23e32044edb8a78fa1eed4e5947","92feb4a40f8344d38b6f722e42a53295",22900437,1,1,0,732,232,233,1
"92feb4a40f8344d38b6f722e42a53295","92feb4a40f8344d38b6f722e42a53295",22900437,2,0,1,733,233,233,0
"92feb4a40f8344d38b6f722e42a53295","5152833676bf4c6cb317060be10f68db",22900437,1,-5,0,735,233,228,-5
"5152833676bf4c6cb317060be10f68db","ca3e28f290354c08aefe5b0f769604e6",22900437,1,8,0,736,228,235,7
"ca3e28f290354c08aefe5b0f769604e6","ca3e28f290354c08aefe5b0f769604e6",22900437,4,0,1,737,235,235,0
"ca3e28f290354c08aefe5b0f769604e6","79a35eea833e4c2c9d22fc53c3c6445c",22900437,1,1,0,741,235,236,1
"79a35eea833e4c2c9d22fc53c3c6445c","79a35eea833e4c2c9d22fc53c3c6445c",22900437,4,0,1,742,236,236,0
"79a35eea833e4c2c9d22fc53c3c6445c","8f68228b1518449e9615cdafee41a2bd",22900437,1,1,0,746,236,237,1
"8f68228b1518449e9615cdafee41a2bd","8f68228b1518449e9615cdafee41a2bd",22900437,1,0,1,747,237,237,0
"8f68228b1518449e9615cdafee41a2bd","cab89fa5c3ed45a5aa550fc0352d6a42",22900437,1,1,0,748,237,238,1
"cab89fa5c3ed45a5aa550fc0352d6a42","cab89fa5c3ed45a5aa550fc0352d6a42",22900437,3,0,1,749,238,238,0
"cab89fa5c3ed45a5aa550fc0352d6a42","66d4fad4f1cf4b46be0750a99ad7a35a",22900437,1,1,0,752,238,239,1
"66d4fad4f1cf4b46be0750a99ad7a35a","66d4fad4f1cf4b46be0750a99ad7a35a",22900437,1,0,1,753,239,239,0
"66d4fad4f1cf4b46be0750a99ad7a35a","0b04c8e2f86d48c7aeb7e225819cd32b",22900437,1,-5,0,754,239,234,-5
"0b04c8e2f86d48c7aeb7e225819cd32b","f53da5fd9bfe412da4b80d4742563b6c",22900437,1,8,0,755,234,241,7
"f53da5fd9bfe412da4b80d4742563b6c","f53da5fd9bfe412da4b80d4742563b6c",22900437,1,0,1,756,241,241,0
"f53da5fd9bfe412da4b80d4742563b6c","2ae94c0cea4d480a9d5dca8fb1d7b542",22900437,1,3,0,757,241,242,1
"2ae94c0cea4d480a9d5dca8fb1d7b542","1c6721b1f63f4d30ba7746ea8af02a52",22900437,1,-27,0,758,242,221,-21
"1c6721b1f63f4d30ba7746ea8af02a52","1ebf23f9d994469a85206e4c7b1bf5f5",22900437,1,30,0,759,221,245,24
"1ebf23f9d994469a85206e4c7b1bf5f5","2ae94c0cea4d480a9d5dca8fb1d7b542",22900437,1,-3,0,760,245,242,-3
"2ae94c0cea4d480a9d5dca8fb1d7b542","1ebf23f9d994469a85206e4c7b1bf5f5",22900437,1,3,0,761,242,245,3
"1ebf23f9d994469a85206e4c7b1bf5f5","1ebf23f9d994469a85206e4c7b1bf5f5",22900437,12,0,1,762,245,245,0
"1ebf23f9d994469a85206e4c7b1bf5f5","85ae675b83e8422da842cfd25596af99",22900437,1,1,0,774,245,246,1
"85ae675b83e8422da842cfd25596af99","85ae675b83e8422da842cfd25596af99",22900437,1,0,1,775,246,246,0
"85ae675b83e8422da842cfd25596af99","fa235f0f364d47e4ae1c87f47bf8e6ba",22900437,1,8,0,776,246,252,6
"fa235f0f364d47e4ae1c87f47bf8e6ba","2ae94c0cea4d480a9d5dca8fb1d7b542",22900437,1,-12,0,777,252,242,-10
"2ae94c0cea4d480a9d5dca8fb1d7b542","fa235f0f364d47e4ae1c87f47bf8e6ba",22900437,1,12,0,778,242,252,10
"fa235f0f364d47e4ae1c87f47bf8e6ba","79f7845465cc4ed19d8e4f1429541be0",22900437,1,2,0,779,252,254,2
"79f7845465cc4ed19d8e4f1429541be0","79f7845465cc4ed19d8e4f1429541be0",22900437,2,0,1,780,254,254,0
"79f7845465cc4ed19d8e4f1429541be0","6e83e23f56544a19b94067c1c558d9c0",22900437,1,-8,0,782,254,247,-7
"6e83e23f56544a19b94067c1c558d9c0","00f61990949545828dd12f1303d47504",22900437,1,11,0,783,247,256,9
"00f61990949545828dd12f1303d47504","00f61990949545828dd12f1303d47504",22900437,1,0,1,784,256,256,0
"00f61990949545828dd12f1303d47504","ead7bb4b64e247d2ae632ab8a296b091",22900437,1,2,0,785,256,258,2
"ead7bb4b64e247d2ae632ab8a296b091","ead7bb4b64e247d2ae632ab8a296b091",22900437,2,0,1,786,258,258,0
"ead7bb4b64e247d2ae632ab8a296b091","41b0048dde734bb280bac6116baa8e27",22900437,1,1,0,788,258,259,1
"41b0048dde734bb280bac6116baa8e27","41b0048dde734bb280bac6116baa8e27",22900437,2,0,1,789,259,259,0
"41b0048dde734bb280bac6116baa8e27","b41c5a094a604ee0915327da5cc0beb7",22900437,1,1,0,791,259,260,1
"b41c5a094a604ee0915327da5cc0beb7","b41c5a094a604ee0915327da5cc0beb7",22900437,2,0,1,792,260,260,0
"b41c5a094a604ee0915327da5cc0beb7","d546341988904f069cfa86b21457d9d9",22900437,1,-10,0,794,260,251,-9
"d546341988904f069cfa86b21457d9d9","28c171777c52431ab6b925073bd63d46",22900437,1,15,0,795,251,264,13
"28c171777c52431ab6b925073bd63d46","28c171777c52431ab6b925073bd63d46",22900437,7,0,1,796,264,264,0
"28c171777c52431ab6b925073bd63d46","ac160db940cb49ae8579162b1d52bb5d",22900437,1,2,0,803,264,266,2
"ac160db940cb49ae8579162b1d52bb5d","ac160db940cb49ae8579162b1d52bb5d",22900437,3,0,1,804,266,266,0
"ac160db940cb49ae8579162b1d52bb5d","d989ebcfc12a4b669f0100dc1aa14f1e",22900437,1,-12,0,807,266,255,-11
"d989ebcfc12a4b669f0100dc1aa14f1e","c6fd49b485cc4874b0bbdd9c6171e09c",22900437,1,15,0,808,255,268,13
"c6fd49b485cc4874b0bbdd9c6171e09c","c6fd49b485cc4874b0bbdd9c6171e09c",22900437,3,0,1,809,268,268,0
"c6fd49b485cc4874b0bbdd9c6171e09c","44240778a97c4af0937817499b75707b",22900437,1,1,0,812,268,269,1
"44240778a97c4af0937817499b75707b","44240778a97c4af0937817499b75707b",22900437,2,0,1,813,269,269,0
"44240778a97c4af0937817499b75707b","7aa76d3e993840d8805f097cbdbcd44b",22900437,1,-9,0,815,269,261,-8
"7aa76d3e993840d8805f097cbdbcd44b","865a4d3b43374da7944dc7d397f566d9",22900437,1,12,0,816,261,271,10
"865a4d3b43374da7944dc7d397f566d9","865a4d3b43374da7944dc7d397f566d9",22900437,1,0,1,817,271,271,0
"865a4d3b43374da7944dc7d397f566d9","0d987bed3ffa4ed0b9a2e62e97b7b30f",22900437,1,3,0,818,271,272,1
"0d987bed3ffa4ed0b9a2e62e97b7b30f","2ae94c0cea4d480a9d5dca8fb1d7b542",22900437,3,-38,0,819,272,242,-30
"2ae94c0cea4d480a9d5dca8fb1d7b542","0d987bed3ffa4ed0b9a2e62e97b7b30f",22900437,3,38,0,820,242,272,30
"0d987bed3ffa4ed0b9a2e62e97b7b30f","bb5a47f5ea01454a8b79455422d3b9da",22900437,4,10,0,821,272,280,8
"bb5a47f5ea01454a8b79455422d3b9da","bb5a47f5ea01454a8b79455422d3b9da",22900437,82,0,1,822,280,280,0
"bb5a47f5ea01454a8b79455422d3b9da","82ae07bc0c9b4570a41799290d1ef399",22900437,3,-6,0,823,280,275,-5
"82ae07bc0c9b4570a41799290d1ef399","bb5a47f5ea01454a8b79455422d3b9da",22900437,3,6,0,824,275,280,5
"bb5a47f5ea01454a8b79455422d3b9da","bc5524e78a8544e2ae2fdc2f3462bbec",22900437,2,-1,0,830,280,279,-1
"bc5524e78a8544e2ae2fdc2f3462bbec","82ae07bc0c9b4570a41799290d1ef399",22900437,1,-5,0,831,279,275,-4
"82ae07bc0c9b4570a41799290d1ef399","0d987bed3ffa4ed0b9a2e62e97b7b30f",22900437,4,-4,0,832,275,272,-3
"bb5a47f5ea01454a8b79455422d3b9da","0d987bed3ffa4ed0b9a2e62e97b7b30f",22900437,3,-10,0,842,280,272,-8
"0d987bed3ffa4ed0b9a2e62e97b7b30f","94cecc3f1e7d484b8e068e79241dfd73",22900437,4,13,0,843,272,281,9
"94cecc3f1e7d484b8e068e79241dfd73","a37477c4e4c14169ad44b06b493007f6",22900437,4,2,0,844,281,283,2
"a37477c4e4c14169ad44b06b493007f6","94cecc3f1e7d484b8e068e79241dfd73",22900437,2,-2,0,845,283,281,-2
"94cecc3f1e7d484b8e068e79241dfd73","fab84b4fab5940efb4ea868ef8d09396",22900437,2,5,0,846,281,284,3
"fab84b4fab5940efb4ea868ef8d09396","fab84b4fab5940efb4ea868ef8d09396",22900437,2,0,1,847,284,284,0
"fab84b4fab5940efb4ea868ef8d09396","4a29443515bb404cb8924e1c60a63b73",22900437,2,4,0,848,284,285,1
"4a29443515bb404cb8924e1c60a63b73","208c9b2796c944db8dacaa96082520ea",22900437,3,3,0,849,285,288,3
"208c9b2796c944db8dacaa96082520ea","9afd71a5298d4333b6849dfce1b9422c",22900437,2,-373,0,850,288,18,-270
"9afd71a5298d4333b6849dfce1b9422c","0d987bed3ffa4ed0b9a2e62e97b7b30f",22900437,2,348,0,852,18,272,254
"bc5524e78a8544e2ae2fdc2f3462bbec","0d987bed3ffa4ed0b9a2e62e97b7b30f",22900437,1,-9,0,862,279,272,-7
"0d987bed3ffa4ed0b9a2e62e97b7b30f","82ae07bc0c9b4570a41799290d1ef399",22900437,3,4,0,863,272,275,3
"0d987bed3ffa4ed0b9a2e62e97b7b30f","9afd71a5298d4333b6849dfce1b9422c",22900437,1,-348,0,865,272,18,-254
"a37477c4e4c14169ad44b06b493007f6","78adeee1fa2c4fe0bc73f7bca9fcee86",22900437,1,-167,0,937,283,160,-123
"65202579580f4ad38d734b4ee39d22a8","94cecc3f1e7d484b8e068e79241dfd73",22900437,1,160,0,948,164,281,117
"a37477c4e4c14169ad44b06b493007f6","0d987bed3ffa4ed0b9a2e62e97b7b30f",22900437,1,-15,0,950,283,272,-11
"94cecc3f1e7d484b8e068e79241dfd73","bb5a47f5ea01454a8b79455422d3b9da",22900437,1,-3,0,952,281,280,-1
"9afd71a5298d4333b6849dfce1b9422c","4a29443515bb404cb8924e1c60a63b73",22900437,1,370,0,969,18,285,267
"208c9b2796c944db8dacaa96082520ea","208c9b2796c944db8dacaa96082520ea",22900437,1,0,1,971,288,288,0
"208c9b2796c944db8dacaa96082520ea","4a29443515bb404cb8924e1c60a63b73",22900437,1,-3,0,972,288,285,-3
"4a29443515bb404cb8924e1c60a63b73","7669a956527947d0add87455277e80b4",22900437,1,7,0,973,285,291,6
"7669a956527947d0add87455277e80b4","7669a956527947d0add87455277e80b4",22900437,1,0,1,974,291,291,0
"7669a956527947d0add87455277e80b4","6a9a3b5bde4a48daa896fe8c06eca56f",22900437,1,-2,0,975,291,289,-2
"6a9a3b5bde4a48daa896fe8c06eca56f","869e967078f04da18dd0b0b9389a7424",22900437,1,5,0,976,289,293,4
"869e967078f04da18dd0b0b9389a7424","869e967078f04da18dd0b0b9389a7424",22900437,1,0,1,977,293,293,0
"869e967078f04da18dd0b0b9389a7424","51ab6291537748fab90d519aa09889d6",22900437,1,2,0,978,293,295,2
"51ab6291537748fab90d519aa09889d6","51ab6291537748fab90d519aa09889d6",22900437,5,0,1,979,295,295,0
"51ab6291537748fab90d519aa09889d6","34a6e49023fc4465bd5ca604330bbd1c",22900437,1,-3,0,984,295,292,-3
"34a6e49023fc4465bd5ca604330bbd1c","ba0e59461bfb4a44b7b1c28a01f8d3b3",22900437,1,9,0,985,292,299,7
"ba0e59461bfb4a44b7b1c28a01f8d3b3","21592f2a9e9c4b2f8c66ec5dbcbf6a2b",22900437,1,-4,0,986,299,296,-3
"21592f2a9e9c4b2f8c66ec5dbcbf6a2b","ba0e59461bfb4a44b7b1c28a01f8d3b3",22900437,1,4,0,987,296,299,3
"ba0e59461bfb4a44b7b1c28a01f8d3b3","0e0b36e731a645e7b1b8a88f5031ca38",22900437,1,2,0,988,299,301,2
"0e0b36e731a645e7b1b8a88f5031ca38","0e0b36e731a645e7b1b8a88f5031ca38",22900437,2,0,1,989,301,301,0
"0e0b36e731a645e7b1b8a88f5031ca38","a66a144637284c21afc6de17fea4bfb8",22900437,1,1,0,991,301,302,1
"a66a144637284c21afc6de17fea4bfb8","a66a144637284c21afc6de17fea4bfb8",22900437,2,0,1,992,302,302,0
"a66a144637284c21afc6de17fea4bfb8","7646a919d7e64fa990bca9b024ff089d",22900437,1,-4,0,994,302,298,-4
"7646a919d7e64fa990bca9b024ff089d","e390b575229748ea8aac9364efe2bf00",22900437,1,7,0,995,298,304,6
"e390b575229748ea8aac9364efe2bf00","e390b575229748ea8aac9364efe2bf00",22900437,1,0,1,996,304,304,0
"e390b575229748ea8aac9364efe2bf00","3434c10e561d488a914e0f7d71907abd",22900437,1,3,0,997,304,305,1
"3434c10e561d488a914e0f7d71907abd","4a29443515bb404cb8924e1c60a63b73",22900437,1,-27,0,998,305,285,-20
"4a29443515bb404cb8924e1c60a63b73","53e7e900392747ccad52e711ab0f80d8",22900437,1,29,0,999,285,307,22
"53e7e900392747ccad52e711ab0f80d8","53e7e900392747ccad52e711ab0f80d8",22900437,2,0,1,1000,307,307,0
"53e7e900392747ccad52e711ab0f80d8","130acc2aeb0448fdbb2de63bc5cebe5b",22900437,1,3,0,1002,307,309,2
"130acc2aeb0448fdbb2de63bc5cebe5b","3434c10e561d488a914e0f7d71907abd",22900437,1,-5,0,1003,309,305,-4
"3434c10e561d488a914e0f7d71907abd","130acc2aeb0448fdbb2de63bc5cebe5b",22900437,1,5,0,1004,305,309,4
"130acc2aeb0448fdbb2de63bc5cebe5b","9c062b3251034ebe90f5054e2a3b5120",22900437,1,2,0,1005,309,311,2
"9c062b3251034ebe90f5054e2a3b5120","9c062b3251034ebe90f5054e2a3b5120",22900437,2,0,1,1006,311,311,0
"9c062b3251034ebe90f5054e2a3b5120","ea859f8207e44537889daeaba13ac2e8",22900437,1,1,0,1008,311,312,1
"ea859f8207e44537889daeaba13ac2e8","ea859f8207e44537889daeaba13ac2e8",22900437,1,0,1,1009,312,312,0
"ea859f8207e44537889daeaba13ac2e8","56d94971a7a94257aa330183a8ebd0ea",22900437,1,1,0,1010,312,313,1
"56d94971a7a94257aa330183a8ebd0ea","56d94971a7a94257aa330183a8ebd0ea",22900437,1,0,1,1011,313,313,0
"56d94971a7a94257aa330183a8ebd0ea","141c0df6cd1946539aadd1c9b7068cd4",22900437,1,-5,0,1012,313,308,-5
"141c0df6cd1946539aadd1c9b7068cd4","13255e63e0aa4abf85e5211bf613d43e",22900437,1,10,0,1013,308,317,9
"13255e63e0aa4abf85e5211bf613d43e","13255e63e0aa4abf85e5211bf613d43e",22900437,1,0,1,1014,317,317,0
"13255e63e0aa4abf85e5211bf613d43e","0c787d16c9504873b1a4d903cec09948",22900437,1,-3,0,1015,317,314,-3
"0c787d16c9504873b1a4d903cec09948","86c27d40179e419c8e9d150fb6afa5d0",22900437,1,6,0,1016,314,319,5
"86c27d40179e419c8e9d150fb6afa5d0","86c27d40179e419c8e9d150fb6afa5d0",22900437,1,0,1,1017,319,319,0
"86c27d40179e419c8e9d150fb6afa5d0","24f1363179ad4aaa965484a78471912b",22900437,1,5,0,1018,319,323,4
"24f1363179ad4aaa965484a78471912b","47edbb64109243e6b0f8f64cdef90c6c",22900437,1,3,0,1019,323,326,3
"47edbb64109243e6b0f8f64cdef90c6c","8d7e0b55cf9849cda222a0f2440cec55",22900437,1,-9,0,1020,326,318,-8
"8d7e0b55cf9849cda222a0f2440cec55","24f1363179ad4aaa965484a78471912b",22900437,1,6,0,1021,318,323,5
"24f1363179ad4aaa965484a78471912b","3628bdce1dd2429ba924d2d4d09448d2",22900437,1,-1,0,1022,323,322,-1
"3628bdce1dd2429ba924d2d4d09448d2","56b3fd1a212a4764be39d979fde3326e",22900437,1,7,0,1023,322,328,6
"56b3fd1a212a4764be39d979fde3326e","56b3fd1a212a4764be39d979fde3326e",22900437,1,0,1,1024,328,328,0
"56b3fd1a212a4764be39d979fde3326e","3434c10e561d488a914e0f7d71907abd",22900437,1,-28,0,1025,328,305,-23
"3434c10e561d488a914e0f7d71907abd","0c4079457ede49e3aeb5e86ed84bdf35",22900437,2,31,0,1026,305,329,24
"0c4079457ede49e3aeb5e86ed84bdf35","38aea304b4fa46e1b29bb72f5cea4c93",22900437,3,2,0,1027,329,331,2
"38aea304b4fa46e1b29bb72f5cea4c93","0c4079457ede49e3aeb5e86ed84bdf35",22900437,3,-2,0,1028,331,329,-2
"38aea304b4fa46e1b29bb72f5cea4c93","38aea304b4fa46e1b29bb72f5cea4c93",22900437,4,0,1,1030,331,331,0
"38aea304b4fa46e1b29bb72f5cea4c93","e36d261332f14e79bb4b467aceaeb9b5",22900437,1,2,0,1031,331,333,2
"e36d261332f14e79bb4b467aceaeb9b5","e36d261332f14e79bb4b467aceaeb9b5",22900437,1,0,1,1032,333,333,0
"e36d261332f14e79bb4b467aceaeb9b5","c7e89b9d04744d2eab742fc24e3ef1ae",22900437,1,1,0,1033,333,334,1
"c7e89b9d04744d2eab742fc24e3ef1ae","c7e89b9d04744d2eab742fc24e3ef1ae",22900437,2,0,1,1034,334,334,0
"c7e89b9d04744d2eab742fc24e3ef1ae","38aea304b4fa46e1b29bb72f5cea4c93",22900437,1,-3,0,1036,334,331,-3
"38aea304b4fa46e1b29bb72f5cea4c93","fe49f8054b374a0ea4bb266ed135ff62",22900437,1,4,0,1040,331,335,4
"fe49f8054b374a0ea4bb266ed135ff62","fe49f8054b374a0ea4bb266ed135ff62",22900437,2,0,1,1041,335,335,0
"fe49f8054b374a0ea4bb266ed135ff62","d0a8f74af98642fe8360d22c42e45117",22900437,1,1,0,1043,335,336,1
"d0a8f74af98642fe8360d22c42e45117","d0a8f74af98642fe8360d22c42e45117",22900437,2,0,1,1044,336,336,0
"d0a8f74af98642fe8360d22c42e45117","0c4079457ede49e3aeb5e86ed84bdf35",22900437,1,-7,0,1046,336,329,-7
"0c4079457ede49e3aeb5e86ed84bdf35","a7c6339ca1da4368a18d471f0519f877",22900437,1,11,0,1047,329,339,10
"a7c6339ca1da4368a18d471f0519f877","a7c6339ca1da4368a18d471f0519f877",22900437,1,0,1,1048,339,339,0
"a7c6339ca1da4368a18d471f0519f877","b8b9418ab322418d9db9b40d96af873a",22900437,1,-2,0,1049,339,337,-2
"b8b9418ab322418d9db9b40d96af873a","bbc5139ca9024389a94db3a6f47dcff6",22900437,1,5,0,1050,337,341,4
"bbc5139ca9024389a94db3a6f47dcff6","bbc5139ca9024389a94db3a6f47dcff6",22900437,1,0,1,1051,341,341,0
"bbc5139ca9024389a94db3a6f47dcff6","4ee6ca9019ab4a1ab323f98094a9bd77",22900437,1,2,0,1052,341,343,2
"4ee6ca9019ab4a1ab323f98094a9bd77","4ee6ca9019ab4a1ab323f98094a9bd77",22900437,2,0,1,1053,343,343,0
"4ee6ca9019ab4a1ab323f98094a9bd77","b37947176785476f8b29d49a851366dc",22900437,1,1,0,1055,343,344,1
"b37947176785476f8b29d49a851366dc","b37947176785476f8b29d49a851366dc",22900437,2,0,1,1056,344,344,0
"b37947176785476f8b29d49a851366dc","fcea5b10d5a14a3b9324ffece8f6e1e5",22900437,1,1,0,1058,344,345,1
"fcea5b10d5a14a3b9324ffece8f6e1e5","fcea5b10d5a14a3b9324ffece8f6e1e5",22900437,2,0,1,1059,345,345,0
"fcea5b10d5a14a3b9324ffece8f6e1e5","c2490bc612d146edbe786556fab3651b",22900437,1,-5,0,1061,345,340,-5
"c2490bc612d146edbe786556fab3651b","6ac8bb048b854999a47edb35fe627f11",22900437,1,8,0,1062,340,347,7
"6ac8bb048b854999a47edb35fe627f11","6ac8bb048b854999a47edb35fe627f11",22900437,1,0,1,1063,347,347,0
"6ac8bb048b854999a47edb35fe627f11","0c4079457ede49e3aeb5e86ed84bdf35",22900437,1,-21,0,1064,347,329,-18
"0c4079457ede49e3aeb5e86ed84bdf35","30ead9794d4847abaf222ca966cc8630",22900437,2,24,0,1065,329,348,19
"30ead9794d4847abaf222ca966cc8630","c20993c944444fe085345591a8bd837e",22900437,1,3,0,1066,348,351,3
"c20993c944444fe085345591a8bd837e","09b9678ddc3d452ea4a3d46e15826065",22900437,1,2,0,1067,351,353,2
"09b9678ddc3d452ea4a3d46e15826065","eff0de7f2dbb42dfa1a2e686efab5b6d",22900437,2,1,0,1068,353,354,1
"eff0de7f2dbb42dfa1a2e686efab5b6d","897b7f51242c44aab2205c72fdcbf4cd",22900437,1,-2,0,1069,354,352,-2
"897b7f51242c44aab2205c72fdcbf4cd","c20993c944444fe085345591a8bd837e",22900437,1,-1,0,1070,352,351,-1
"c20993c944444fe085345591a8bd837e","c20993c944444fe085345591a8bd837e",22900437,7,0,1,1071,351,351,0
"c20993c944444fe085345591a8bd837e","897b7f51242c44aab2205c72fdcbf4cd",22900437,3,1,0,1074,351,352,1
"897b7f51242c44aab2205c72fdcbf4cd","897b7f51242c44aab2205c72fdcbf4cd",22900437,5,0,1,1075,352,352,0
"897b7f51242c44aab2205c72fdcbf4cd","09b9678ddc3d452ea4a3d46e15826065",22900437,2,1,0,1078,352,353,1
"09b9678ddc3d452ea4a3d46e15826065","09b9678ddc3d452ea4a3d46e15826065",22900437,7,0,1,1079,353,353,0
"eff0de7f2dbb42dfa1a2e686efab5b6d","eff0de7f2dbb42dfa1a2e686efab5b6d",22900437,6,0,1,1083,354,354,0
"eff0de7f2dbb42dfa1a2e686efab5b6d","30ead9794d4847abaf222ca966cc8630",22900437,2,-6,0,1086,354,348,-6
"30ead9794d4847abaf222ca966cc8630","2fe14166dc9642c3bc666b86a57f943d",22900437,2,10,0,1087,348,357,9
"2fe14166dc9642c3bc666b86a57f943d","2fe14166dc9642c3bc666b86a57f943d",22900437,7,0,1,1088,357,357,0
"2fe14166dc9642c3bc666b86a57f943d","44421dd1e13a47a388c4a19834b744c7",22900437,1,2,0,1095,357,359,2
"44421dd1e13a47a388c4a19834b744c7","44421dd1e13a47a388c4a19834b744c7",22900437,2,0,1,1096,359,359,0
"44421dd1e13a47a388c4a19834b744c7","cb5fc7ef85d547c4be1a7439d0bf6052",22900437,1,1,0,1098,359,360,1
"cb5fc7ef85d547c4be1a7439d0bf6052","cb5fc7ef85d547c4be1a7439d0bf6052",22900437,2,0,1,1099,360,360,0
"cb5fc7ef85d547c4be1a7439d0bf6052","0a8f150a4cf747acbde62f4721823da3",22900437,1,1,0,1101,360,361,1
"0a8f150a4cf747acbde62f4721823da3","0a8f150a4cf747acbde62f4721823da3",22900437,2,0,1,1102,361,361,0
"0a8f150a4cf747acbde62f4721823da3","ab8fdad974ae471f9f24c3f9dd04462e",22900437,1,1,0,1104,361,362,1
"ab8fdad974ae471f9f24c3f9dd04462e","ab8fdad974ae471f9f24c3f9dd04462e",22900437,2,0,1,1105,362,362,0
"ab8fdad974ae471f9f24c3f9dd04462e","1ba8fef685d74a8194b9db252eb704fb",22900437,1,-7,0,1107,362,355,-7
"1ba8fef685d74a8194b9db252eb704fb","52580888dadb4fe3baa795683ea227bd",22900437,1,10,0,1108,355,364,9
"52580888dadb4fe3baa795683ea227bd","52580888dadb4fe3baa795683ea227bd",22900437,1,0,1,1109,364,364,0
"52580888dadb4fe3baa795683ea227bd","f00179e251a045b39c3f7a54f9aa4acc",22900437,1,-1,0,1110,364,363,-1
"f00179e251a045b39c3f7a54f9aa4acc","492a3bc6a1254f23a7998587961b22a4",22900437,1,4,0,1111,363,366,3
"492a3bc6a1254f23a7998587961b22a4","492a3bc6a1254f23a7998587961b22a4",22900437,1,0,1,1112,366,366,0
"492a3bc6a1254f23a7998587961b22a4","072a190fd302456290895f9f04d6940a",22900437,2,-1,0,1113,366,365,-1
"072a190fd302456290895f9f04d6940a","c76574d21bc14aeea7ecd0b027f39858",22900437,1,3,0,1114,365,367,2
"c76574d21bc14aeea7ecd0b027f39858","2fe14166dc9642c3bc666b86a57f943d",22900437,1,-13,0,1115,367,357,-10
"2fe14166dc9642c3bc666b86a57f943d","1ba8fef685d74a8194b9db252eb704fb",22900437,2,-2,0,1116,357,355,-2
"1ba8fef685d74a8194b9db252eb704fb","cfa457d1743848e4bb5e4beced6448ed",22900437,1,17,0,1117,355,369,14
"cfa457d1743848e4bb5e4beced6448ed","cfa457d1743848e4bb5e4beced6448ed",22900437,1,0,1,1118,369,369,0
"cfa457d1743848e4bb5e4beced6448ed","b71bac264efb4abd97015447bd490db6",22900437,1,3,0,1119,369,370,1
"b71bac264efb4abd97015447bd490db6","30ead9794d4847abaf222ca966cc8630",22900437,1,-28,0,1120,370,348,-22
"30ead9794d4847abaf222ca966cc8630","8d448d625b024c82a5eb240bbd7431d6",22900437,1,33,0,1121,348,374,26
"8d448d625b024c82a5eb240bbd7431d6","b71bac264efb4abd97015447bd490db6",22900437,3,-5,0,1122,374,370,-4
"b71bac264efb4abd97015447bd490db6","8d448d625b024c82a5eb240bbd7431d6",22900437,4,5,0,1123,370,374,4
"8d448d625b024c82a5eb240bbd7431d6","8d448d625b024c82a5eb240bbd7431d6",22900437,64,0,1,1124,374,374,0
"8d448d625b024c82a5eb240bbd7431d6","9afd71a5298d4333b6849dfce1b9422c",22900437,1,-485,0,1130,374,18,-356
"9afd71a5298d4333b6849dfce1b9422c","b71bac264efb4abd97015447bd490db6",22900437,1,480,0,1131,18,370,352
"8d448d625b024c82a5eb240bbd7431d6","1b4550d0dab04078b3bf08a655345bdc",22900437,1,-1,0,1140,374,373,-1
"1b4550d0dab04078b3bf08a655345bdc","30ead9794d4847abaf222ca966cc8630",22900437,1,-32,0,1141,373,348,-25
"30ead9794d4847abaf222ca966cc8630","b71bac264efb4abd97015447bd490db6",22900437,2,28,0,1142,348,370,22
"b71bac264efb4abd97015447bd490db6","c76574d21bc14aeea7ecd0b027f39858",22900437,1,-5,0,1143,370,367,-3
"c76574d21bc14aeea7ecd0b027f39858","492a3bc6a1254f23a7998587961b22a4",22900437,1,-2,0,1144,367,366,-1
"072a190fd302456290895f9f04d6940a","52580888dadb4fe3baa795683ea227bd",22900437,1,-2,0,1146,365,364,-1
"52580888dadb4fe3baa795683ea227bd","2fe14166dc9642c3bc666b86a57f943d",22900437,1,-8,0,1147,364,357,-7
"2fe14166dc9642c3bc666b86a57f943d","f00179e251a045b39c3f7a54f9aa4acc",22900437,1,7,0,1148,357,363,6
"f00179e251a045b39c3f7a54f9aa4acc","1ba8fef685d74a8194b9db252eb704fb",22900437,1,-9,0,1149,363,355,-8
"1ba8fef685d74a8194b9db252eb704fb","897b7f51242c44aab2205c72fdcbf4cd",22900437,1,-4,0,1150,355,352,-3
"897b7f51242c44aab2205c72fdcbf4cd","eff0de7f2dbb42dfa1a2e686efab5b6d",22900437,3,2,0,1151,352,354,2
"eff0de7f2dbb42dfa1a2e686efab5b6d","c20993c944444fe085345591a8bd837e",22900437,1,-3,0,1154,354,351,-3
"09b9678ddc3d452ea4a3d46e15826065","30ead9794d4847abaf222ca966cc8630",22900437,1,-5,0,1162,353,348,-5
"30ead9794d4847abaf222ca966cc8630","0c4079457ede49e3aeb5e86ed84bdf35",22900437,1,-24,0,1163,348,329,-19
"0c4079457ede49e3aeb5e86ed84bdf35","bbc5139ca9024389a94db3a6f47dcff6",22900437,2,14,0,1164,329,341,12
"bbc5139ca9024389a94db3a6f47dcff6","4a92daef4d504e1792575a26502bb7b7",22900437,1,6,0,1165,341,346,5
"4a92daef4d504e1792575a26502bb7b7","c2490bc612d146edbe786556fab3651b",22900437,1,-7,0,1166,346,340,-6
"c2490bc612d146edbe786556fab3651b","b8b9418ab322418d9db9b40d96af873a",22900437,1,-4,0,1167,340,337,-3
"b8b9418ab322418d9db9b40d96af873a","38aea304b4fa46e1b29bb72f5cea4c93",22900437,1,-7,0,1168,337,331,-6
"0c4079457ede49e3aeb5e86ed84bdf35","3434c10e561d488a914e0f7d71907abd",22900437,1,-31,0,1170,329,305,-24
"3434c10e561d488a914e0f7d71907abd","3434c10e561d488a914e0f7d71907abd",22900437,1,0,1,1171,305,305,0
"bbc5139ca9024389a94db3a6f47dcff6","b8b9418ab322418d9db9b40d96af873a",22900437,1,-5,0,1176,341,337,-4
"b8b9418ab322418d9db9b40d96af873a","c2490bc612d146edbe786556fab3651b",22900437,1,4,0,1177,337,340,3
"c2490bc612d146edbe786556fab3651b","0c4079457ede49e3aeb5e86ed84bdf35",22900437,1,-13,0,1178,340,329,-11
"30ead9794d4847abaf222ca966cc8630","897b7f51242c44aab2205c72fdcbf4cd",22900437,1,4,0,1180,348,352,4
"eff0de7f2dbb42dfa1a2e686efab5b6d","09b9678ddc3d452ea4a3d46e15826065",22900437,1,-1,0,1182,354,353,-1
"09b9678ddc3d452ea4a3d46e15826065","c20993c944444fe085345591a8bd837e",22900437,1,-2,0,1185,353,351,-2
"1ba8fef685d74a8194b9db252eb704fb","30ead9794d4847abaf222ca966cc8630",22900437,1,-8,0,1195,355,348,-7
"b71bac264efb4abd97015447bd490db6","d6d02b6ef04e4f17805504500b8ce441",22900437,1,8,0,1252,370,375,5
"d6d02b6ef04e4f17805504500b8ce441","d6d02b6ef04e4f17805504500b8ce441",22900437,2,0,1,1253,375,375,0
"d6d02b6ef04e4f17805504500b8ce441","66baf19b6b904b70922329068c63746d",22900437,1,4,0,1255,375,376,1
"66baf19b6b904b70922329068c63746d","7f544639412e40a9ba27f43b415362ab",22900437,2,2,0,1256,376,378,2
"7f544639412e40a9ba27f43b415362ab","7f544639412e40a9ba27f43b415362ab",22900437,1,0,1,1257,378,378,0
"7f544639412e40a9ba27f43b415362ab","d5ae8642e15b46b8bd298b02274d4e9c",22900437,1,2,0,1258,378,380,2
"d5ae8642e15b46b8bd298b02274d4e9c","d5ae8642e15b46b8bd298b02274d4e9c",22900437,1,0,1,1259,380,380,0
"d5ae8642e15b46b8bd298b02274d4e9c","a0d10309a2dd456289147f84be9d37f9",22900437,1,1,0,1260,380,381,1
"a0d10309a2dd456289147f84be9d37f9","a0d10309a2dd456289147f84be9d37f9",22900437,2,0,1,1261,381,381,0
"a0d10309a2dd456289147f84be9d37f9","0fcbc3ca07b144138b8d85da581f09a8",22900437,1,1,0,1263,381,382,1
"0fcbc3ca07b144138b8d85da581f09a8","0fcbc3ca07b144138b8d85da581f09a8",22900437,2,0,1,1264,382,382,0
"0fcbc3ca07b144138b8d85da581f09a8","66baf19b6b904b70922329068c63746d",22900437,1,-6,0,1266,382,376,-6
"66baf19b6b904b70922329068c63746d","c2fca3669923477ab966ded303dea31c",22900437,1,8,0,1267,376,383,7
"c2fca3669923477ab966ded303dea31c","4890121ce5d74576b4632b77cfc23398",22900437,1,6,0,1268,383,388,5
"4890121ce5d74576b4632b77cfc23398","4890121ce5d74576b4632b77cfc23398",22900437,2,0,1,1269,388,388,0
"4890121ce5d74576b4632b77cfc23398","18d3b836dd804224883cc9180b60a8e1",22900437,1,-1,0,1271,388,387,-1
"18d3b836dd804224883cc9180b60a8e1","96bb2b3e85a34d8b9544514e89f6fe97",22900437,1,4,0,1272,387,390,3
"96bb2b3e85a34d8b9544514e89f6fe97","96bb2b3e85a34d8b9544514e89f6fe97",22900437,1,0,1,1273,390,390,0
"96bb2b3e85a34d8b9544514e89f6fe97","17f95d18bab743888e1736033dc3384d",22900437,1,-1,0,1274,390,389,-1
"17f95d18bab743888e1736033dc3384d","7f544639412e40a9ba27f43b415362ab",22900437,1,-14,0,1275,389,378,-11
"7f544639412e40a9ba27f43b415362ab","66baf19b6b904b70922329068c63746d",22900437,2,-2,0,1276,378,376,-2
"66baf19b6b904b70922329068c63746d","96bb2b3e85a34d8b9544514e89f6fe97",22900437,2,17,0,1277,376,390,14
"96bb2b3e85a34d8b9544514e89f6fe97","ac4e9b54acfe4670b4634859c7263cb5",22900437,1,2,0,1278,390,392,2
"ac4e9b54acfe4670b4634859c7263cb5","ac4e9b54acfe4670b4634859c7263cb5",22900437,1,0,1,1279,392,392,0
"ac4e9b54acfe4670b4634859c7263cb5","17f95d18bab743888e1736033dc3384d",22900437,1,-3,0,1280,392,389,-3
"17f95d18bab743888e1736033dc3384d","6f8881a745ac4c358a68b92c3b4abe81",22900437,1,6,0,1281,389,394,5
"6f8881a745ac4c358a68b92c3b4abe81","6f8881a745ac4c358a68b92c3b4abe81",22900437,1,0,1,1282,394,394,0
"6f8881a745ac4c358a68b92c3b4abe81","f7002c8484354eceac57bc7bd62c76c1",22900437,2,-1,0,1283,394,393,-1
"f7002c8484354eceac57bc7bd62c76c1","44a277ea44dc4ae689fab4b82f0b4098",22900437,1,5,0,1284,393,397,4
"44a277ea44dc4ae689fab4b82f0b4098","44a277ea44dc4ae689fab4b82f0b4098",22900437,1,0,1,1285,397,397,0
"44a277ea44dc4ae689fab4b82f0b4098","0c12af0a4e7f4002852cf84b2537c161",22900437,1,-2,0,1286,397,395,-2
"0c12af0a4e7f4002852cf84b2537c161","859e0b8d71694b12befb69ee698138f9",22900437,1,5,0,1287,395,399,4
"859e0b8d71694b12befb69ee698138f9","859e0b8d71694b12befb69ee698138f9",22900437,1,0,1,1288,399,399,0
"859e0b8d71694b12befb69ee698138f9","66baf19b6b904b70922329068c63746d",22900437,1,-29,0,1289,399,376,-23
"66baf19b6b904b70922329068c63746d","2b09a08242b54983aec7063990fb3f66",22900437,1,32,0,1290,376,400,24
"2b09a08242b54983aec7063990fb3f66","2b09a08242b54983aec7063990fb3f66",22900437,6,0,1,1291,400,400,0
"2b09a08242b54983aec7063990fb3f66","0c4079457ede49e3aeb5e86ed84bdf35",22900437,1,-96,0,1294,400,329,-71
"0c4079457ede49e3aeb5e86ed84bdf35","2b09a08242b54983aec7063990fb3f66",22900437,1,96,0,1295,329,400,71
"2b09a08242b54983aec7063990fb3f66","1f471b7a883a4df48211e8c6a81b59a7",22900437,1,1,0,1298,400,401,1
"1f471b7a883a4df48211e8c6a81b59a7","1f471b7a883a4df48211e8c6a81b59a7",22900437,1,0,1,1299,401,401,0
"1f471b7a883a4df48211e8c6a81b59a7","2b09a08242b54983aec7063990fb3f66",22900437,1,-1,0,1300,401,400,-1
"2b09a08242b54983aec7063990fb3f66","9de0d567bfa84fe5b77cb76f4a76a5d1",22900437,1,5,0,1301,400,404,4
"9de0d567bfa84fe5b77cb76f4a76a5d1","9de0d567bfa84fe5b77cb76f4a76a5d1",22900437,1,0,1,1302,404,404,0
"9de0d567bfa84fe5b77cb76f4a76a5d1","1157bd665ec4472fb58b751dc5099355",22900437,1,-1,0,1303,404,403,-1
"1157bd665ec4472fb58b751dc5099355","58fc9094275e4c49be3f4ba6d4acc0a4",22900437,1,5,0,1304,403,406,3
"58fc9094275e4c49be3f4ba6d4acc0a4","3c8a22d2f9c146ea956609e3ed4f2559",22900437,1,-2,0,1305,406,405,-1
"3c8a22d2f9c146ea956609e3ed4f2559","58fc9094275e4c49be3f4ba6d4acc0a4",22900437,1,2,0,1306,405,406,1
"58fc9094275e4c49be3f4ba6d4acc0a4","58fc9094275e4c49be3f4ba6d4acc0a4",22900437,3,0,1,1307,406,406,0
"58fc9094275e4c49be3f4ba6d4acc0a4","c1c1be90b2b14c1ab4a5e1ee3c241902",22900437,1,1,0,1310,406,407,1
"c1c1be90b2b14c1ab4a5e1ee3c241902","c1c1be90b2b14c1ab4a5e1ee3c241902",22900437,5,0,1,1311,407,407,0
"c1c1be90b2b14c1ab4a5e1ee3c241902","58fc9094275e4c49be3f4ba6d4acc0a4",22900437,1,-1,0,1316,407,406,-1
"58fc9094275e4c49be3f4ba6d4acc0a4","02b3a1bead9244c1ba2f857c7da8f82a",22900437,1,3,0,1317,406,408,2
"02b3a1bead9244c1ba2f857c7da8f82a","02b3a1bead9244c1ba2f857c7da8f82a",22900437,1,0,1,1318,408,408,0
"02b3a1bead9244c1ba2f857c7da8f82a","6206fc6479014bb193084c32409dc1b9",22900437,1,1,0,1319,408,409,1
"6206fc6479014bb193084c32409dc1b9","6206fc6479014bb193084c32409dc1b9",22900437,1,0,1,1320,409,409,0
"6206fc6479014bb193084c32409dc1b9","02b3a1bead9244c1ba2f857c7da8f82a",22900437,1,-1,0,1321,409,408,-1
"02b3a1bead9244c1ba2f857c7da8f82a","6a5f020451db426dacba9e2ea3fcc62a",22900437,1,3,0,1322,408,410,2
"6a5f020451db426dacba9e2ea3fcc62a","6a5f020451db426dacba9e2ea3fcc62a",22900437,1,0,1,1323,410,410,0
"6a5f020451db426dacba9e2ea3fcc62a","33a9d248b2e44588a5b07fc1342b9bc2",22900437,2,2,0,1324,410,411,1
"33a9d248b2e44588a5b07fc1342b9bc2","6a5f020451db426dacba9e2ea3fcc62a",22900437,1,-2,0,1325,411,410,-1
"33a9d248b2e44588a5b07fc1342b9bc2","c6f26bd420634f1cb7989e76fe6b16c0",22900437,1,1,0,1327,411,412,1
"c6f26bd420634f1cb7989e76fe6b16c0","c6f26bd420634f1cb7989e76fe6b16c0",22900437,5,0,1,1328,412,412,0
"c6f26bd420634f1cb7989e76fe6b16c0","2a65ee6e2ac64f6a8a55fbe5373ec763",22900437,1,1,0,1333,412,413,1
"2a65ee6e2ac64f6a8a55fbe5373ec763","2a65ee6e2ac64f6a8a55fbe5373ec763",22900437,2,0,1,1334,413,413,0
"2a65ee6e2ac64f6a8a55fbe5373ec763","33a9d248b2e44588a5b07fc1342b9bc2",22900437,1,-2,0,1336,413,411,-2
"33a9d248b2e44588a5b07fc1342b9bc2","1fd0f6dadbc14ebc965faf6122190b96",22900437,1,5,0,1337,411,415,4
"1fd0f6dadbc14ebc965faf6122190b96","1fd0f6dadbc14ebc965faf6122190b96",22900437,1,0,1,1338,415,415,0
"1fd0f6dadbc14ebc965faf6122190b96","687055dad9fc40c3982478fe33ec01bf",22900437,1,-1,0,1339,415,414,-1
"687055dad9fc40c3982478fe33ec01bf","2add1669f08d4101913db15f8c23b3b7",22900437,1,3,0,1340,414,416,2
"2add1669f08d4101913db15f8c23b3b7","2add1669f08d4101913db15f8c23b3b7",22900437,1,0,1,1341,416,416,0
"2add1669f08d4101913db15f8c23b3b7","a2b4bd40cee2481ebd3fc179d6a5cd62",22900437,1,3,0,1342,416,417,1
"a2b4bd40cee2481ebd3fc179d6a5cd62","2b09a08242b54983aec7063990fb3f66",22900437,1,-27,0,1343,417,400,-17
"2b09a08242b54983aec7063990fb3f66","9afd71a5298d4333b6849dfce1b9422c",22900437,1,-524,0,1344,400,18,-382
"9afd71a5298d4333b6849dfce1b9422c","a2b4bd40cee2481ebd3fc179d6a5cd62",22900437,1,551,0,1345,18,417,399
"a2b4bd40cee2481ebd3fc179d6a5cd62","e34e59dce2204f228f3a84b6725df60f",22900437,1,2,0,1346,417,419,2
"e34e59dce2204f228f3a84b6725df60f","e34e59dce2204f228f3a84b6725df60f",22900437,1,0,1,1347,419,419,0
"e34e59dce2204f228f3a84b6725df60f","a2b4bd40cee2481ebd3fc179d6a5cd62",22900437,1,-2,0,1348,419,417,-2
"a2b4bd40cee2481ebd3fc179d6a5cd62","bec48fc2e1294c7eb3d0aca780d731b8",22900437,2,4,0,1349,417,420,3
"bec48fc2e1294c7eb3d0aca780d731b8","bec48fc2e1294c7eb3d0aca780d731b8",22900437,2,0,1,1350,420,420,0
"bec48fc2e1294c7eb3d0aca780d731b8","a24600b0e49245f6bdba8c893cfeddb0",22900437,1,7,0,1352,420,425,5
"a24600b0e49245f6bdba8c893cfeddb0","dbde19fcce2a4c1abdc7f685c293a23f",22900437,1,-4,0,1353,425,422,-3
"dbde19fcce2a4c1abdc7f685c293a23f","a24600b0e49245f6bdba8c893cfeddb0",22900437,1,4,0,1354,422,425,3
"a24600b0e49245f6bdba8c893cfeddb0","a24600b0e49245f6bdba8c893cfeddb0",22900437,1,0,1,1355,425,425,0
"a24600b0e49245f6bdba8c893cfeddb0","a2b4bd40cee2481ebd3fc179d6a5cd62",22900437,1,-11,0,1356,425,417,-8
"a2b4bd40cee2481ebd3fc179d6a5cd62","24cf8786024543f19b89bc20034e60d7",22900437,1,18,0,1357,417,428,11
"24cf8786024543f19b89bc20034e60d7","f2a73be2f46840b182d7bd095378004e",22900437,1,1,0,1358,428,429,1
"f2a73be2f46840b182d7bd095378004e","f2a73be2f46840b182d7bd095378004e",22900437,1,0,1,1359,429,429,0
"f2a73be2f46840b182d7bd095378004e","604551fd4266430cb860fef58fa7dd61",22900437,1,1,0,1360,429,430,1
"604551fd4266430cb860fef58fa7dd61","604551fd4266430cb860fef58fa7dd61",22900437,1,0,1,1361,430,430,0
"604551fd4266430cb860fef58fa7dd61","dce46f8904594a62a6377a3587aaa663",22900437,1,2,0,1362,430,431,1
"dce46f8904594a62a6377a3587aaa663","24cf8786024543f19b89bc20034e60d7",22900437,1,-4,0,1363,431,428,-3
"24cf8786024543f19b89bc20034e60d7","dce46f8904594a62a6377a3587aaa663",22900437,1,4,0,1364,428,431,3
"dce46f8904594a62a6377a3587aaa663","9b9d0a249052413c869753b99682b0ac",22900437,1,1,0,1365,431,432,1
"9b9d0a249052413c869753b99682b0ac","9b9d0a249052413c869753b99682b0ac",22900437,1,0,1,1366,432,432,0
"9b9d0a249052413c869753b99682b0ac","061c175cc90f45fbad883025394e78dd",22900437,1,1,0,1367,432,433,1
"061c175cc90f45fbad883025394e78dd","061c175cc90f45fbad883025394e78dd",22900437,1,0,1,1368,433,433,0
"061c175cc90f45fbad883025394e78dd","dce46f8904594a62a6377a3587aaa663",22900437,1,-2,0,1369,433,431,-2
"dce46f8904594a62a6377a3587aaa663","74a7f8712e5449c2bc0b43c6f90dafed",22900437,1,5,0,1370,431,435,4
"74a7f8712e5449c2bc0b43c6f90dafed","74a7f8712e5449c2bc0b43c6f90dafed",22900437,1,0,1,1371,435,435,0
"74a7f8712e5449c2bc0b43c6f90dafed","66ada10dde9f43018588f1ced9d477fc",22900437,1,-1,0,1372,435,434,-1
"66ada10dde9f43018588f1ced9d477fc","dce46f8904594a62a6377a3587aaa663",22900437,1,-4,0,1373,434,431,-3
"dce46f8904594a62a6377a3587aaa663","bf12c96466d840a69bed7020b3f18bb8",22900437,2,7,0,1374,431,436,5
"bf12c96466d840a69bed7020b3f18bb8","dce46f8904594a62a6377a3587aaa663",22900437,1,-7,0,1375,436,431,-5
"bf12c96466d840a69bed7020b3f18bb8","bf12c96466d840a69bed7020b3f18bb8",22900437,1,0,1,1377,436,436,0
"bf12c96466d840a69bed7020b3f18bb8","070600601c4c439288445d2f0724807d",22900437,1,3,0,1378,436,437,1
"070600601c4c439288445d2f0724807d","24cf8786024543f19b89bc20034e60d7",22900437,1,-14,0,1379,437,428,-9
"24cf8786024543f19b89bc20034e60d7","1823b6de7d334a7aaabc4570719af4d9",22900437,1,16,0,1380,428,439,11
"1823b6de7d334a7aaabc4570719af4d9","070600601c4c439288445d2f0724807d",22900437,1,-2,0,1381,439,437,-2
"070600601c4c439288445d2f0724807d","1823b6de7d334a7aaabc4570719af4d9",22900437,2,2,0,1382,437,439,2
"1823b6de7d334a7aaabc4570719af4d9","1823b6de7d334a7aaabc4570719af4d9",22900437,13,0,1,1383,439,439,0
"1823b6de7d334a7aaabc4570719af4d9","9afd71a5298d4333b6849dfce1b9422c",22900437,1,-585,0,1394,439,18,-421
"9afd71a5298d4333b6849dfce1b9422c","070600601c4c439288445d2f0724807d",22900437,1,583,0,1395,18,437,419
"1823b6de7d334a7aaabc4570719af4d9","0380cd76a7d44bc3a4da1f15e4d68f89",22900437,1,2,0,1399,439,440,1
"0380cd76a7d44bc3a4da1f15e4d68f89","070600601c4c439288445d2f0724807d",22900437,1,-4,0,1400,440,437,-3
"070600601c4c439288445d2f0724807d","0380cd76a7d44bc3a4da1f15e4d68f89",22900437,1,4,0,1401,437,440,3
"0380cd76a7d44bc3a4da1f15e4d68f89","0380cd76a7d44bc3a4da1f15e4d68f89",22900437,1,0,1,1402,440,440,0
"0380cd76a7d44bc3a4da1f15e4d68f89","23b7673c8b5443108c2ef09382834a86",22900437,1,2,0,1403,440,441,1
"23b7673c8b5443108c2ef09382834a86","23b7673c8b5443108c2ef09382834a86",22900437,2,0,1,1404,441,441,0
"23b7673c8b5443108c2ef09382834a86","901e92500aea43c79f19f1b279050668",22900437,1,2,0,1406,441,442,1
"901e92500aea43c79f19f1b279050668","901e92500aea43c79f19f1b279050668",22900437,1,0,1,1407,442,442,0
"901e92500aea43c79f19f1b279050668","001339db8ced4cf78829ebe8b145449d",22900437,1,1,0,1408,442,443,1
"001339db8ced4cf78829ebe8b145449d","001339db8ced4cf78829ebe8b145449d",22900437,2,0,1,1409,443,443,0
"001339db8ced4cf78829ebe8b145449d","452745e0366e42ae81561bfddebcc6c3",22900437,1,1,0,1411,443,444,1
"452745e0366e42ae81561bfddebcc6c3","452745e0366e42ae81561bfddebcc6c3",22900437,2,0,1,1412,444,444,0
"452745e0366e42ae81561bfddebcc6c3","901e92500aea43c79f19f1b279050668",22900437,1,-2,0,1414,444,442,-2
"901e92500aea43c79f19f1b279050668","4660ff2089114e8db82ceb26a4f329e3",22900437,1,4,0,1415,442,445,3
"4660ff2089114e8db82ceb26a4f329e3","4660ff2089114e8db82ceb26a4f329e3",22900437,2,0,1,1416,445,445,0
"4660ff2089114e8db82ceb26a4f329e3","7bd5586eb9d8484eb74a433ee7bfe499",22900437,1,2,0,1418,445,446,1
"7bd5586eb9d8484eb74a433ee7bfe499","7bd5586eb9d8484eb74a433ee7bfe499",22900437,14,0,1,1419,446,446,0
"7bd5586eb9d8484eb74a433ee7bfe499","8a7f26e690f34dda97be16904518ca99",22900437,1,2,0,1433,446,447,1
"8a7f26e690f34dda97be16904518ca99","8a7f26e690f34dda97be16904518ca99",22900437,1,0,1,1434,447,447,0
"8a7f26e690f34dda97be16904518ca99","b2f0d654738f48158edff28e8d3a546e",22900437,1,5,0,1435,447,449,2
"b2f0d654738f48158edff28e8d3a546e","070600601c4c439288445d2f0724807d",22900437,1,-21,0,1436,449,437,-12
"070600601c4c439288445d2f0724807d","b2f0d654738f48158edff28e8d3a546e",22900437,1,21,0,1437,437,449,12
"b2f0d654738f48158edff28e8d3a546e","66baf19b6b904b70922329068c63746d",22900437,1,-112,0,1438,449,376,-73
"66baf19b6b904b70922329068c63746d","66baf19b6b904b70922329068c63746d",22900437,1,0,1,1439,376,376,0
"96bb2b3e85a34d8b9544514e89f6fe97","6f8881a745ac4c358a68b92c3b4abe81",22900437,1,5,0,1443,390,394,4
"f7002c8484354eceac57bc7bd62c76c1","0c12af0a4e7f4002852cf84b2537c161",22900437,1,3,0,1445,393,395,2
"0c12af0a4e7f4002852cf84b2537c161","66baf19b6b904b70922329068c63746d",22900437,1,-24,0,1446,395,376,-19
"66baf19b6b904b70922329068c63746d","18d3b836dd804224883cc9180b60a8e1",22900437,1,13,0,1447,376,387,11
"18d3b836dd804224883cc9180b60a8e1","4890121ce5d74576b4632b77cfc23398",22900437,1,1,0,1448,387,388,1
"4890121ce5d74576b4632b77cfc23398","17f95d18bab743888e1736033dc3384d",22900437,1,2,0,1449,388,389,1
"17f95d18bab743888e1736033dc3384d","c2fca3669923477ab966ded303dea31c",22900437,1,-8,0,1450,389,383,-6
"c2fca3669923477ab966ded303dea31c","2b09a08242b54983aec7063990fb3f66",22900437,1,24,0,1451,383,400,17
"2b09a08242b54983aec7063990fb3f66","66baf19b6b904b70922329068c63746d",22900437,1,-32,0,1453,400,376,-24
"66baf19b6b904b70922329068c63746d","f67fbf45a5f146ed866965bc57c7c001",22900437,1,120,0,1454,376,454,78
"f67fbf45a5f146ed866965bc57c7c001","f67fbf45a5f146ed866965bc57c7c001",22900437,2,0,1,1455,454,454,0
"f67fbf45a5f146ed866965bc57c7c001","b2f0d654738f48158edff28e8d3a546e",22900437,2,-8,0,1456,454,449,-5
"b2f0d654738f48158edff28e8d3a546e","b2f0d654738f48158edff28e8d3a546e",22900437,2,0,1,1457,449,449,0
"b2f0d654738f48158edff28e8d3a546e","a2b4bd40cee2481ebd3fc179d6a5cd62",22900437,1,-53,0,1458,449,417,-32
"a2b4bd40cee2481ebd3fc179d6a5cd62","a2b4bd40cee2481ebd3fc179d6a5cd62",22900437,1,0,1,1459,417,417,0
"bec48fc2e1294c7eb3d0aca780d731b8","a2b4bd40cee2481ebd3fc179d6a5cd62",22900437,1,-4,0,1461,420,417,-3
"a2b4bd40cee2481ebd3fc179d6a5cd62","b2f0d654738f48158edff28e8d3a546e",22900437,1,53,0,1462,417,449,32
"b2f0d654738f48158edff28e8d3a546e","f60ee41ec635499abd48168342d32c2f",22900437,2,5,0,1464,449,453,4
"f60ee41ec635499abd48168342d32c2f","f60ee41ec635499abd48168342d32c2f",22900437,51,0,1,1465,453,453,0
"f60ee41ec635499abd48168342d32c2f","b2f0d654738f48158edff28e8d3a546e",22900437,1,-5,0,1467,453,449,-4
"f60ee41ec635499abd48168342d32c2f","f67fbf45a5f146ed866965bc57c7c001",22900437,1,3,0,1518,453,454,1
"b2f0d654738f48158edff28e8d3a546e","3628b3f7823443d0912a339096b69943",22900437,1,10,0,1520,449,456,7
"3628b3f7823443d0912a339096b69943","3628b3f7823443d0912a339096b69943",22900437,1,0,1,1521,456,456,0
"3628b3f7823443d0912a339096b69943","9e049ee647cf43ecbcb5ed792a8e7588",22900437,1,1,0,1522,456,457,1
"9e049ee647cf43ecbcb5ed792a8e7588","9e049ee647cf43ecbcb5ed792a8e7588",22900437,3,0,1,1523,457,457,0
"9e049ee647cf43ecbcb5ed792a8e7588","5256a214faaf410b93f76cea06428334",22900437,1,1,0,1526,457,458,1
"5256a214faaf410b93f76cea06428334","5256a214faaf410b93f76cea06428334",22900437,1,0,1,1527,458,458,0
"5256a214faaf410b93f76cea06428334","25c32b120fce40fa9b6c85133aeb4716",22900437,1,1,0,1528,458,459,1
"25c32b120fce40fa9b6c85133aeb4716","25c32b120fce40fa9b6c85133aeb4716",22900437,1,0,1,1529,459,459,0
"25c32b120fce40fa9b6c85133aeb4716","11bc14f2204949008b7d511b933363c1",22900437,1,1,0,1530,459,460,1
"11bc14f2204949008b7d511b933363c1","11bc14f2204949008b7d511b933363c1",22900437,1,0,1,1531,460,460,0
"11bc14f2204949008b7d511b933363c1","42de338840a34d15adb66e7b14fb9d2c",22900437,1,1,0,1532,460,461,1
"42de338840a34d15adb66e7b14fb9d2c","42de338840a34d15adb66e7b14fb9d2c",22900437,1,0,1,1533,461,461,0
"42de338840a34d15adb66e7b14fb9d2c","9da37c6210b1416b8079c274f70bf600",22900437,1,1,0,1534,461,462,1
"9da37c6210b1416b8079c274f70bf600","9da37c6210b1416b8079c274f70bf600",22900437,1,0,1,1535,462,462,0
"9da37c6210b1416b8079c274f70bf600","519119f1deac45ff9ab4f13529be5c6e",22900437,1,1,0,1536,462,463,1
"519119f1deac45ff9ab4f13529be5c6e","519119f1deac45ff9ab4f13529be5c6e",22900437,1,0,1,1537,463,463,0
"519119f1deac45ff9ab4f13529be5c6e","d937afe49bd24a07a550dda1c1155122",22900437,1,-8,0,1538,463,455,-8
"d937afe49bd24a07a550dda1c1155122","d937afe49bd24a07a550dda1c1155122",22900437,1,0,1,1539,455,455,0
"d937afe49bd24a07a550dda1c1155122","f67fbf45a5f146ed866965bc57c7c001",22900437,1,-1,0,1540,455,454,-1
"f67fbf45a5f146ed866965bc57c7c001","c5df9f40ec14463b9dcfdc73df3e9285",22900437,2,12,0,1542,454,464,10
"c5df9f40ec14463b9dcfdc73df3e9285","f67fbf45a5f146ed866965bc57c7c001",22900437,1,-12,0,1543,464,454,-10
"c5df9f40ec14463b9dcfdc73df3e9285","c5df9f40ec14463b9dcfdc73df3e9285",22900437,1,0,1,1545,464,464,0
"c5df9f40ec14463b9dcfdc73df3e9285","83d42d95cd844fc093fc09cee250edb8",22900437,1,3,0,1546,464,465,1
"83d42d95cd844fc093fc09cee250edb8","83d42d95cd844fc093fc09cee250edb8",22900437,3,0,1,1547,465,465,0
"83d42d95cd844fc093fc09cee250edb8","9afd71a5298d4333b6849dfce1b9422c",22900437,1,-627,0,1550,465,18,-447
"9afd71a5298d4333b6849dfce1b9422c","9afd71a5298d4333b6849dfce1b9422c",22900437,5,0,1,1551,18,18,0
